team,n,rank,w,d,l,gf,ga,gd,pts
Brondby,0,1,20,7,3,70,33,37,67
FC Midtjylla,0,2,19,4,7,63,44,19,61
FC Nords,0,3,14,7,9,70,51,19,49
Copenhagen,0,4,14,4,12,59,48,11,46
AaB,0,5,9,11,10,45,41,4,38
AC Horsens,0,6,7,13,10,37,53,-16,34
Sonderjyske,0,7,8,6,10,28,29,-1,30
Lyngby,0,8,4,9,11,27,44,-17,21
Randers FC,0,9,5,6,13,23,40,-17,21
Silkeborg IF,0,10,6,3,13,30,48,-18,21
AGF Aarhus,0,11,4,6,12,20,41,-21,18
Brondby,1,1,20,6,4,69,34,35,66
FC Midtjylla,1,2,18,6,6,63,40,23,60
FC Nords,1,3,15,7,8,70,49,21,52
Copenhagen,1,4,14,5,11,61,45,16,47
AaB,1,5,8,12,10,35,39,-4,36
AC Horsens,1,6,6,14,10,36,53,-17,32
Sonderjyske,1,7,8,6,10,28,29,-1,30
Lyngby,1,8,4,9,11,29,44,-15,21
Randers FC,1,9,5,6,13,23,42,-19,21
AGF Aarhus,1,10,5,6,11,18,37,-19,21
Silkeborg IF,1,11,5,3,14,26,46,-20,18
Brondby,2,1,20,8,2,75,33,42,68
FC Midtjylla,2,2,20,6,4,68,36,32,66
FC Nords,2,3,12,11,7,71,50,21,47
Copenhagen,2,4,14,5,11,60,47,13,47
AaB,2,5,7,13,10,37,42,-5,34
Sonderjyske,2,6,8,6,10,28,29,-1,30
AC Horsens,2,7,5,13,12,33,62,-29,28
Randers FC,2,8,6,6,12,26,39,-13,24
Silkeborg IF,2,9,6,3,13,27,44,-17,21
Lyngby,2,10,3,9,12,26,47,-21,18
AGF Aarhus,2,11,4,6,12,16,38,-22,18
Brondby,3,1,20,7,3,74,34,40,67
FC Midtjylla,3,2,19,6,5,63,39,24,63
Copenhagen,3,3,13,8,9,58,43,15,47
FC Nords,3,4,13,7,10,74,53,21,46
AC Horsens,3,5,7,14,9,38,52,-14,35
AaB,3,6,6,14,10,33,45,-12,32
Sonderjyske,3,7,8,6,10,28,29,-1,30
Lyngby,3,8,4,9,11,27,44,-17,21
Randers FC,3,9,5,6,13,23,40,-17,21
Silkeborg IF,3,10,5,4,13,26,45,-19,19
AGF Aarhus,3,11,4,7,11,17,37,-20,19
Brondby,4,1,21,5,4,74,36,38,68
FC Midtjylla,4,2,19,4,7,62,42,20,61
Copenhagen,4,3,17,4,9,63,43,20,55
FC Nords,4,4,15,6,9,72,52,20,51
AC Horsens,4,5,6,13,11,41,56,-15,31
Sonderjyske,4,6,8,6,10,28,29,-1,30
AaB,4,7,6,12,12,36,45,-9,30
Randers FC,4,8,5,7,12,25,41,-16,22
AGF Aarhus,4,9,5,6,11,17,36,-19,21
Lyngby,4,10,3,10,11,28,46,-18,19
Silkeborg IF,4,11,5,3,14,25,45,-20,18
Brondby,5,1,21,6,3,68,29,39,69
FC Midtjylla,5,2,20,5,5,66,38,28,65
FC Nords,5,3,14,7,9,76,52,24,49
Copenhagen,5,4,15,4,11,59,46,13,49
AaB,5,5,7,13,10,36,42,-6,34
Sonderjyske,5,6,8,6,10,28,29,-1,30
AC Horsens,5,7,5,13,12,31,55,-24,28
Lyngby,5,8,4,9,11,30,47,-17,21
Randers FC,5,9,5,6,13,26,43,-17,21
Silkeborg IF,5,10,5,4,13,25,44,-19,19
AGF Aarhus,5,11,4,7,11,16,36,-20,19
Brondby,6,1,22,5,3,76,31,45,71
FC Midtjylla,6,2,19,4,7,63,44,19,61
Copenhagen,6,3,16,4,10,60,40,20,52
FC Nords,6,4,13,7,10,72,55,17,46
AaB,6,5,8,12,10,36,44,-8,36
Sonderjyske,6,6,8,6,10,28,29,-1,30
AC Horsens,6,7,5,14,11,33,52,-19,29
Randers FC,6,8,5,7,12,24,40,-16,22
AGF Aarhus,6,9,5,6,11,17,36,-19,21
Lyngby,6,10,3,10,11,27,45,-18,19
Silkeborg IF,6,11,5,3,14,25,45,-20,18
Brondby,7,1,21,6,3,72,30,42,69
FC Midtjylla,7,2,21,4,5,70,40,30,67
FC Nords,7,3,14,6,10,73,52,21,48
Copenhagen,7,4,14,5,11,61,44,17,47
AaB,7,5,9,11,10,35,44,-9,38
Sonderjyske,7,6,8,6,10,28,29,-1,30
AC Horsens,7,7,5,12,13,30,57,-27,27
Lyngby,7,8,4,9,11,28,45,-17,21
Silkeborg IF,7,8,6,3,13,28,45,-17,21
Randers FC,7,10,5,6,13,24,41,-17,21
AGF Aarhus,7,11,4,6,12,17,39,-22,18
FC Midtjylla,8,1,20,5,5,66,39,27,65
Brondby,8,2,18,9,3,68,34,34,63
FC Nords,8,3,14,9,7,76,49,27,51
Copenhagen,8,4,12,6,12,53,45,8,42
AaB,8,5,8,12,10,41,45,-4,36
AC Horsens,8,6,7,13,10,36,54,-18,34
Sonderjyske,8,7,8,6,10,28,29,-1,30
Lyngby,8,8,4,9,11,29,45,-16,21
Silkeborg IF,8,9,6,3,13,27,44,-17,21
Randers FC,8,10,5,6,13,24,42,-18,21
AGF Aarhus,8,11,4,6,12,16,38,-22,18
Brondby,9,1,20,8,2,72,32,40,68
FC Midtjylla,9,2,20,4,6,70,41,29,64
Copenhagen,9,3,15,6,9,59,43,16,51
FC Nords,9,4,14,7,9,74,56,18,49
AaB,9,5,7,12,11,35,41,-6,33
Sonderjyske,9,6,8,6,10,28,29,-1,30
AC Horsens,9,7,5,13,12,35,58,-23,28
Lyngby,9,8,4,9,11,28,44,-16,21
Silkeborg IF,9,9,6,3,13,28,45,-17,21
Randers FC,9,10,5,6,13,23,41,-18,21
AGF Aarhus,9,11,4,6,12,17,39,-22,18
Brondby,10,1,21,5,4,72,35,37,68
FC Midtjylla,10,2,19,5,6,64,42,22,62
FC Nords,10,3,16,6,8,75,48,27,54
Copenhagen,10,4,14,4,12,55,44,11,46
AaB,10,5,7,13,10,41,45,-4,34
AC Horsens,10,6,6,13,11,36,55,-19,31
Sonderjyske,10,7,8,6,10,28,29,-1,30
Randers FC,10,8,5,7,12,25,41,-16,22
Lyngby,10,9,3,10,11,28,46,-18,19
Silkeborg IF,10,10,5,4,13,25,44,-19,19
AGF Aarhus,10,11,4,7,11,16,36,-20,19
Brondby,11,1,21,7,2,69,30,39,70
FC Midtjylla,11,2,19,5,6,68,41,27,62
FC Nords,11,3,16,6,8,76,49,27,54
Copenhagen,11,4,13,5,12,54,44,10,44
AC Horsens,11,5,6,15,9,34,49,-15,33
Sonderjyske,11,6,8,6,10,28,29,-1,30
AaB,11,7,6,12,12,34,48,-14,30
Randers FC,11,8,5,7,12,25,41,-16,22
Lyngby,11,9,3,10,11,28,46,-18,19
Silkeborg IF,11,10,5,4,13,26,45,-19,19
AGF Aarhus,11,11,4,7,11,17,37,-20,19
Brondby,12,1,22,5,3,72,30,42,71
FC Midtjylla,12,2,19,6,5,66,40,26,63
FC Nords,12,3,14,7,9,72,53,19,49
Copenhagen,12,4,12,5,13,55,50,5,41
AC Horsens,12,5,8,13,9,38,49,-11,37
AaB,12,6,6,14,10,34,41,-7,32
Sonderjyske,12,7,8,6,10,28,29,-1,30
Lyngby,12,8,4,9,11,27,44,-17,21
Randers FC,12,9,5,6,13,23,40,-17,21
AGF Aarhus,12,10,5,6,11,19,36,-17,21
Silkeborg IF,12,11,5,3,14,25,47,-22,18
Brondby,13,1,21,5,4,70,32,38,68
FC Midtjylla,13,2,19,5,6,65,37,28,62
FC Nords,13,3,15,7,8,73,48,25,52
Copenhagen,13,4,14,5,11,57,43,14,47
AC Horsens,13,5,7,12,11,36,58,-22,33
AaB,13,6,6,14,10,33,42,-9,32
Sonderjyske,13,7,8,6,10,28,29,-1,30
Randers FC,13,8,5,7,12,24,40,-16,22
Lyngby,13,9,3,10,11,27,45,-18,19
Silkeborg IF,13,10,5,4,13,26,45,-19,19
AGF Aarhus,13,11,4,7,11,17,37,-20,19
FC Midtjylla,14,1,19,6,5,65,39,26,63
Brondby,14,2,18,8,4,67,35,32,62
FC Nords,14,3,16,6,8,77,49,28,54
Copenhagen,14,4,14,5,11,57,43,14,47
AaB,14,5,7,13,10,35,40,-5,34
AC Horsens,14,6,6,14,10,31,52,-21,32
Sonderjyske,14,7,8,6,10,28,29,-1,30
Lyngby,14,8,4,9,11,28,45,-17,21
Randers FC,14,9,5,6,13,24,41,-17,21
Silkeborg IF,14,10,5,4,13,26,45,-19,19
AGF Aarhus,14,11,4,7,11,17,37,-20,19
Brondby,15,1,22,5,3,73,31,42,71
FC Midtjylla,15,2,21,4,5,68,38,30,67
FC Nords,15,3,15,6,9,76,51,25,51
Copenhagen,15,4,13,5,12,54,45,9,44
AaB,15,5,7,12,11,35,44,-9,33
Sonderjyske,15,6,8,6,10,28,29,-1,30
AC Horsens,15,7,5,14,11,34,57,-23,29
Lyngby,15,8,4,9,11,27,44,-17,21
Randers FC,15,9,5,6,13,23,40,-17,21
Silkeborg IF,15,10,6,3,13,26,44,-18,21
AGF Aarhus,15,11,4,6,12,16,37,-21,18
Brondby,16,1,19,8,3,70,35,35,65
FC Midtjylla,16,2,19,6,5,65,40,25,63
FC Nords,16,3,15,6,9,71,50,21,51
Copenhagen,16,4,15,5,10,57,41,16,50
AC Horsens,16,5,7,13,10,34,49,-15,34
Sonderjyske,16,6,8,6,10,28,29,-1,30
AaB,16,7,6,12,12,34,42,-8,30
Randers FC,16,8,6,6,12,26,41,-15,24
Silkeborg IF,16,9,6,3,13,27,45,-18,21
Lyngby,16,10,3,9,12,28,47,-19,18
AGF Aarhus,16,11,4,6,12,17,38,-21,18
Brondby,17,1,21,6,3,70,33,37,69
FC Midtjylla,17,2,20,5,5,67,37,30,65
FC Nords,17,3,14,7,9,73,53,20,49
Copenhagen,17,4,13,5,12,57,50,7,44
AC Horsens,17,5,8,12,10,42,52,-10,36
AaB,17,6,7,11,12,35,45,-10,32
Sonderjyske,17,7,8,6,10,28,29,-1,30
Lyngby,17,8,4,9,11,30,45,-15,21
Silkeborg IF,17,8,6,3,13,30,45,-15,21
Randers FC,17,10,5,6,13,24,43,-19,21
AGF Aarhus,17,11,4,6,12,17,41,-24,18
Brondby,18,1,22,5,3,70,33,37,71
FC Midtjylla,18,2,20,5,5,71,40,31,65
FC Nords,18,3,16,6,8,76,53,23,54
Copenhagen,18,4,12,6,12,59,51,8,42
AC Horsens,18,5,6,14,10,37,52,-15,32
Sonderjyske,18,6,8,6,10,28,29,-1,30
AaB,18,7,6,12,12,34,44,-10,30
Randers FC,18,8,5,7,12,23,39,-16,22
AGF Aarhus,18,9,5,6,11,18,37,-19,21
Lyngby,18,10,3,10,11,26,44,-18,19
Silkeborg IF,18,11,5,3,14,26,46,-20,18
Brondby,19,1,20,6,4,70,35,35,66
FC Midtjylla,19,2,20,4,6,61,36,25,64
Copenhagen,19,3,15,4,11,59,45,14,49
FC Nords,19,4,14,6,10,77,55,22,48
AC Horsens,19,5,8,12,10,35,52,-17,36
AaB,19,6,7,12,11,39,44,-5,33
Sonderjyske,19,7,8,6,10,28,29,-1,30
Lyngby,19,8,4,9,11,29,45,-16,21
Silkeborg IF,19,9,6,3,13,27,45,-18,21
Randers FC,19,10,5,6,13,24,42,-18,21
AGF Aarhus,19,11,4,6,12,17,38,-21,18
Brondby,20,1,20,6,4,68,34,34,66
FC Midtjylla,20,2,20,4,6,69,42,27,64
FC Nords,20,3,15,6,9,77,55,22,51
Copenhagen,20,4,14,6,10,61,47,14,48
AaB,20,5,8,12,10,42,42,0,36
Sonderjyske,20,6,8,6,10,28,29,-1,30
AC Horsens,20,7,5,14,11,35,58,-23,29
Randers FC,20,8,6,6,12,25,39,-14,24
Silkeborg IF,20,9,5,4,13,25,44,-19,19
AGF Aarhus,20,10,4,7,11,16,36,-20,19
Lyngby,20,11,3,9,12,26,46,-20,18
Brondby,21,1,21,5,4,70,33,37,68
FC Midtjylla,21,2,20,6,4,65,35,30,66
FC Nords,21,3,14,7,9,74,53,21,49
Copenhagen,21,4,13,5,12,59,47,12,44
AaB,21,5,8,13,9,35,38,-3,37
Sonderjyske,21,6,8,6,10,28,29,-1,30
AC Horsens,21,7,6,12,12,35,58,-23,30
Lyngby,21,8,4,9,11,28,44,-16,21
Silkeborg IF,21,9,6,3,13,27,45,-18,21
Randers FC,21,10,5,6,13,23,41,-18,21
AGF Aarhus,21,11,4,6,12,17,38,-21,18
Brondby,22,1,20,6,4,71,33,38,66
FC Midtjylla,22,2,20,5,5,65,37,28,65
Copenhagen,22,3,16,4,10,61,42,19,52
FC Nords,22,4,14,8,8,74,49,25,50
AaB,22,5,6,13,11,34,48,-14,31
Sonderjyske,22,6,8,6,10,28,29,-1,30
AC Horsens,22,7,5,14,11,33,55,-22,29
Lyngby,22,8,4,9,11,29,46,-17,21
Randers FC,22,9,5,6,13,25,42,-17,21
Silkeborg IF,22,10,6,3,13,27,45,-18,21
AGF Aarhus,22,11,4,6,12,17,38,-21,18
Brondby,23,1,21,6,3,71,32,39,69
FC Midtjylla,23,2,21,5,4,72,41,31,68
FC Nords,23,3,15,6,9,78,52,26,51
Copenhagen,23,4,12,5,13,56,55,1,41
AC Horsens,23,5,7,13,10,40,56,-16,34
AaB,23,6,7,11,12,39,46,-7,32
Sonderjyske,23,7,8,6,10,28,29,-1,30
Randers FC,23,8,5,7,12,24,40,-16,22
Silkeborg IF,23,9,6,3,13,26,44,-18,21
Lyngby,23,10,3,10,11,27,45,-18,19
AGF Aarhus,23,11,4,6,12,16,37,-21,18
Brondby,24,1,20,7,3,70,36,34,67
FC Midtjylla,24,2,19,5,6,60,37,23,62
FC Nords,24,3,14,7,9,74,51,23,49
Copenhagen,24,4,13,6,11,54,44,10,45
AaB,24,5,8,12,10,40,41,-1,36
AC Horsens,24,6,6,15,9,36,51,-15,33
Sonderjyske,24,7,8,6,10,28,29,-1,30
Lyngby,24,8,4,9,11,29,45,-16,21
Randers FC,24,9,5,6,13,24,42,-18,21
Silkeborg IF,24,10,5,4,13,26,45,-19,19
AGF Aarhus,24,11,4,7,11,17,37,-20,19
Brondby,25,1,22,5,3,72,31,41,71
FC Midtjylla,25,2,18,7,5,65,40,25,61
FC Nords,25,3,14,8,8,73,51,22,50
Copenhagen,25,4,13,5,12,53,43,10,44
AaB,25,5,6,15,9,38,45,-7,33
AC Horsens,25,6,6,14,10,35,52,-17,32
Sonderjyske,25,7,8,6,10,28,29,-1,30
Randers FC,25,8,6,6,12,24,39,-15,24
Silkeborg IF,25,9,5,4,13,27,46,-19,19
AGF Aarhus,25,10,4,7,11,18,38,-20,19
Lyngby,25,11,3,9,12,26,45,-19,18
Brondby,26,1,21,6,3,76,31,45,69
FC Midtjylla,26,2,19,4,7,63,40,23,61
FC Nords,26,3,15,6,9,74,50,24,51
Copenhagen,26,4,12,5,13,55,50,5,41
AC Horsens,26,5,8,13,9,35,48,-13,37
AaB,26,6,8,12,10,37,47,-10,36
Sonderjyske,26,7,8,6,10,28,29,-1,30
Lyngby,26,8,4,9,11,28,44,-16,21
Randers FC,26,9,5,6,13,23,41,-18,21
AGF Aarhus,26,10,5,6,11,20,38,-18,21
Silkeborg IF,26,11,5,3,14,27,48,-21,18
Brondby,27,1,21,6,3,70,32,38,69
FC Midtjylla,27,2,19,5,6,68,40,28,62
FC Nords,27,3,13,7,10,73,53,20,46
Copenhagen,27,4,12,8,10,58,46,12,44
AaB,27,5,9,11,10,37,43,-6,38
AC Horsens,27,6,7,13,10,34,52,-18,34
Sonderjyske,27,7,8,6,10,28,29,-1,30
Randers FC,27,8,5,7,12,24,40,-16,22
Silkeborg IF,27,9,6,3,13,29,44,-15,21
Lyngby,27,10,3,10,11,27,45,-18,19
AGF Aarhus,27,11,4,6,12,16,40,-24,18
Brondby,28,1,21,6,3,73,33,40,69
FC Midtjylla,28,2,18,6,6,68,40,28,60
Copenhagen,28,3,15,6,9,58,42,16,51
FC Nords,28,4,14,8,8,76,57,19,50
AaB,28,5,7,12,11,36,43,-7,33
Sonderjyske,28,6,8,6,10,28,29,-1,30
AC Horsens,28,7,5,14,11,31,53,-22,29
Randers FC,28,8,5,7,12,23,39,-16,22
AGF Aarhus,28,9,5,6,11,18,37,-19,21
Lyngby,28,10,3,10,11,26,44,-18,19
Silkeborg IF,28,11,5,3,14,26,46,-20,18
Brondby,29,1,21,5,4,69,31,38,68
FC Midtjylla,29,2,20,5,5,67,38,29,65
FC Nords,29,3,16,7,7,77,49,28,55
Copenhagen,29,4,13,4,13,56,50,6,43
AC Horsens,29,5,8,12,10,39,54,-15,36
Sonderjyske,29,6,8,6,10,28,29,-1,30
AaB,29,7,6,11,13,33,45,-12,29
Randers FC,29,8,6,6,12,25,40,-15,24
Silkeborg IF,29,9,6,3,13,27,44,-17,21
Lyngby,29,10,3,9,12,27,46,-19,18
AGF Aarhus,29,11,4,6,12,16,38,-22,18
Brondby,30,1,22,6,2,75,33,42,72
FC Midtjylla,30,2,19,5,6,66,39,27,62
FC Nords,30,3,16,6,8,80,52,28,54
Copenhagen,30,4,13,4,13,57,49,8,43
AaB,30,5,8,12,10,40,46,-6,36
Sonderjyske,30,6,8,6,10,28,29,-1,30
AC Horsens,30,7,5,13,12,35,60,-25,28
Randers FC,30,8,6,6,12,24,39,-15,24
AGF Aarhus,30,9,5,6,11,18,37,-19,21
Lyngby,30,10,3,9,12,26,45,-19,18
Silkeborg IF,30,11,5,3,14,26,46,-20,18
Brondby,31,1,21,7,2,70,29,41,70
FC Midtjylla,31,2,19,6,5,66,39,27,63
FC Nords,31,3,15,6,9,72,50,22,51
Copenhagen,31,4,12,4,14,54,49,5,40
AaB,31,5,8,11,11,39,46,-7,35
AC Horsens,31,6,7,14,9,35,49,-14,35
Sonderjyske,31,7,8,6,10,28,29,-1,30
Randers FC,31,8,6,6,12,25,39,-14,24
Silkeborg IF,31,9,5,4,13,25,44,-19,19
AGF Aarhus,31,10,4,7,11,16,36,-20,19
Lyngby,31,11,3,9,12,26,46,-20,18
Brondby,32,1,23,5,2,79,32,47,74
FC Midtjylla,32,2,19,6,5,70,44,26,63
FC Nords,32,3,15,7,8,76,52,24,52
Copenhagen,32,4,13,4,13,53,50,3,43
AaB,32,5,8,12,10,43,44,-1,36
Sonderjyske,32,6,8,6,10,28,29,-1,30
AC Horsens,32,7,5,12,13,32,57,-25,27
Lyngby,32,8,4,9,11,28,44,-16,21
Silkeborg IF,32,9,6,3,13,26,44,-18,21
Randers FC,32,10,5,6,13,23,41,-18,21
AGF Aarhus,32,11,4,6,12,16,37,-21,18
Brondby,33,1,19,7,4,68,33,35,64
FC Midtjylla,33,2,19,6,5,66,39,27,63
FC Nords,33,3,14,6,10,70,52,18,48
Copenhagen,33,4,14,4,12,58,46,12,46
AaB,33,5,10,11,9,37,39,-2,41
AC Horsens,33,6,6,14,10,38,54,-16,32
Sonderjyske,33,7,8,6,10,28,29,-1,30
Lyngby,33,8,4,9,11,30,45,-15,21
Randers FC,33,9,5,6,13,24,43,-19,21
AGF Aarhus,33,10,5,6,11,17,36,-19,21
Silkeborg IF,33,11,5,3,14,25,45,-20,18
Brondby,34,1,22,5,3,80,32,48,71
FC Midtjylla,34,2,18,5,7,59,40,19,59
Copenhagen,34,3,16,5,9,62,45,17,53
FC Nords,34,4,14,7,9,77,54,23,49
AC Horsens,34,5,7,12,11,34,56,-22,33
Sonderjyske,34,6,8,6,10,28,29,-1,30
AaB,34,7,6,12,12,37,48,-11,30
Randers FC,34,8,6,6,12,24,39,-15,24
Silkeborg IF,34,9,6,3,13,27,44,-17,21
Lyngby,34,10,3,9,12,26,45,-19,18
AGF Aarhus,34,11,4,6,12,16,38,-22,18
Brondby,35,1,21,7,2,68,30,38,70
FC Midtjylla,35,2,19,5,6,62,41,21,62
FC Nords,35,3,15,6,9,78,48,30,51
Copenhagen,35,4,12,7,11,53,45,8,43
AaB,35,5,9,12,9,43,42,1,39
Sonderjyske,35,6,8,6,10,28,29,-1,30
AC Horsens,35,7,5,13,12,32,56,-24,28
Randers FC,35,8,6,6,12,24,39,-15,24
Silkeborg IF,35,9,5,4,13,25,44,-19,19
AGF Aarhus,35,10,4,7,11,16,36,-20,19
Lyngby,35,11,3,9,12,26,45,-19,18
Brondby,36,1,22,5,3,72,32,40,71
FC Midtjylla,36,2,20,4,6,70,41,29,64
FC Nords,36,3,13,8,9,70,50,20,47
Copenhagen,36,4,13,5,12,54,46,8,44
AC Horsens,36,5,8,12,10,40,55,-15,36
AaB,36,6,7,12,11,36,44,-8,33
Sonderjyske,36,7,8,6,10,28,29,-1,30
Lyngby,36,8,4,9,11,27,44,-17,21
Randers FC,36,9,5,6,13,23,40,-17,21
AGF Aarhus,36,10,5,6,11,17,36,-19,21
Silkeborg IF,36,11,5,3,14,25,45,-20,18
Brondby,37,1,19,6,5,66,33,33,63
FC Midtjylla,37,2,19,5,6,64,41,23,62
Copenhagen,37,3,16,5,9,64,43,21,53
FC Nords,37,4,13,6,11,70,54,16,45
AC Horsens,37,5,8,13,9,42,54,-12,37
AaB,37,6,8,11,11,36,43,-7,35
Sonderjyske,37,7,8,6,10,28,29,-1,30
Randers FC,37,8,6,6,12,28,42,-14,24
Silkeborg IF,37,9,6,3,13,28,45,-17,21
Lyngby,37,10,3,9,12,29,49,-20,18
AGF Aarhus,37,11,4,6,12,17,39,-22,18
Brondby,38,1,22,6,2,74,29,45,72
FC Midtjylla,38,2,19,5,6,63,38,25,62
FC Nords,38,3,15,6,9,74,53,21,51
Copenhagen,38,4,12,7,11,55,47,8,43
AaB,38,5,8,12,10,37,42,-5,36
Sonderjyske,38,6,8,6,10,28,29,-1,30
AC Horsens,38,7,6,12,12,33,53,-20,30
Lyngby,38,8,4,9,11,29,45,-16,21
Silkeborg IF,38,8,6,3,13,29,45,-16,21
Randers FC,38,10,5,6,13,24,42,-18,21
AGF Aarhus,38,11,4,6,12,17,40,-23,18
Brondby,39,1,19,7,4,66,33,33,64
FC Midtjylla,39,2,17,6,7,62,43,19,57
Copenhagen,39,3,15,4,11,59,44,15,49
FC Nords,39,4,13,8,9,74,54,20,47
AaB,39,5,9,12,9,35,37,-2,39
AC Horsens,39,6,8,13,9,40,51,-11,37
Sonderjyske,39,7,8,6,10,28,29,-1,30
Randers FC,39,8,5,7,12,23,39,-16,22
Lyngby,39,9,3,10,11,26,44,-18,19
Silkeborg IF,39,10,5,4,13,27,46,-19,19
AGF Aarhus,39,11,4,7,11,18,38,-20,19
Brondby,40,1,19,7,4,70,36,34,64
FC Midtjylla,40,2,20,4,6,65,41,24,64
FC Nords,40,3,15,6,9,77,51,26,51
Copenhagen,40,4,14,5,11,55,43,12,47
AaB,40,5,8,12,10,40,44,-4,36
AC Horsens,40,6,6,14,10,33,51,-18,32
Sonderjyske,40,7,8,6,10,28,29,-1,30
Randers FC,40,8,6,6,12,25,40,-15,24
Silkeborg IF,40,9,6,3,13,29,46,-17,21
Lyngby,40,10,3,9,12,27,46,-19,18
AGF Aarhus,40,11,4,6,12,18,40,-22,18
Brondby,41,1,21,6,3,68,31,37,69
FC Midtjylla,41,2,20,5,5,69,37,32,65
Copenhagen,41,3,14,6,10,58,43,15,48
FC Nords,41,4,13,8,9,72,52,20,47
AaB,41,5,7,13,10,34,43,-9,34
Sonderjyske,41,6,8,6,10,28,29,-1,30
AC Horsens,41,7,5,14,11,36,57,-21,29
Randers FC,41,8,6,6,12,25,40,-15,24
Silkeborg IF,41,9,6,3,13,26,44,-18,21
Lyngby,41,10,3,9,12,27,46,-19,18
AGF Aarhus,41,11,4,6,12,16,37,-21,18
Brondby,42,1,19,8,3,69,36,33,65
FC Midtjylla,42,2,18,7,5,62,37,25,61
FC Nords,42,3,15,7,8,75,46,29,52
Copenhagen,42,4,12,5,13,55,49,6,41
AC Horsens,42,5,8,13,9,38,52,-14,37
AaB,42,6,8,12,10,36,41,-5,36
Sonderjyske,42,7,8,6,10,28,29,-1,30
Randers FC,42,8,5,7,12,25,41,-16,22
AGF Aarhus,42,9,5,6,11,17,36,-19,21
Lyngby,42,10,3,10,11,28,46,-18,19
Silkeborg IF,42,11,5,3,14,25,45,-20,18
Brondby,43,1,21,5,4,77,36,41,68
FC Midtjylla,43,2,21,4,5,67,36,31,67
Copenhagen,43,3,15,4,11,61,47,14,49
FC Nords,43,4,13,7,10,73,58,15,46
AaB,43,5,8,12,10,38,42,-4,36
Sonderjyske,43,6,8,6,10,28,29,-1,30
AC Horsens,43,7,6,12,12,33,56,-23,30
Randers FC,43,8,5,7,12,26,42,-16,22
Silkeborg IF,43,9,6,3,13,27,45,-18,21
Lyngby,43,10,3,10,11,29,47,-18,19
AGF Aarhus,43,11,4,6,12,17,38,-21,18
FC Midtjylla,44,1,21,4,5,67,40,27,67
Brondby,44,2,20,6,4,72,36,36,66
FC Nords,44,3,15,7,8,77,46,31,52
Copenhagen,44,4,14,5,11,63,46,17,47
AaB,44,5,7,12,11,37,51,-14,33
Sonderjyske,44,6,8,6,10,28,29,-1,30
AC Horsens,44,7,5,14,11,33,56,-23,29
Randers FC,44,8,6,6,12,27,41,-14,24
Silkeborg IF,44,9,5,4,13,27,46,-19,19
AGF Aarhus,44,10,4,7,11,18,38,-20,19
Lyngby,44,11,3,9,12,28,48,-20,18
FC Midtjylla,45,1,21,4,5,67,38,29,67
Brondby,45,2,20,5,5,71,35,36,65
FC Nords,45,3,15,7,8,77,52,25,52
Copenhagen,45,4,16,4,10,57,42,15,52
Sonderjyske,45,5,8,6,10,28,29,-1,30
AaB,45,6,6,12,12,37,48,-11,30
AC Horsens,45,7,6,12,12,35,55,-20,30
Lyngby,45,8,4,9,11,30,44,-14,21
Silkeborg IF,45,9,6,3,13,29,45,-16,21
Randers FC,45,10,5,6,13,23,43,-20,21
AGF Aarhus,45,11,4,6,12,17,40,-23,18
Brondby,46,1,22,6,2,73,29,44,72
FC Midtjylla,46,2,18,6,6,62,39,23,60
Copenhagen,46,3,14,5,11,55,45,10,47
FC Nords,46,4,12,6,12,67,57,10,42
AaB,46,5,9,12,9,40,38,2,39
AC Horsens,46,6,7,13,10,34,49,-15,34
Sonderjyske,46,7,8,6,10,28,29,-1,30
Randers FC,46,8,5,7,12,25,41,-16,22
AGF Aarhus,46,9,5,6,11,19,37,-18,21
Lyngby,46,10,3,10,11,28,46,-18,19
Silkeborg IF,46,11,5,3,14,26,47,-21,18
Brondby,47,1,21,6,3,70,29,41,69
FC Midtjylla,47,2,21,5,4,66,35,31,68
FC Nords,47,3,13,6,11,69,55,14,45
Copenhagen,47,4,13,6,11,56,46,10,45
AaB,47,5,7,13,10,37,44,-7,34
AC Horsens,47,6,7,12,11,37,52,-15,33
Sonderjyske,47,7,8,6,10,28,29,-1,30
Randers FC,47,8,5,7,12,24,40,-16,22
Lyngby,47,9,3,10,11,27,45,-18,19
Silkeborg IF,47,10,5,4,13,26,45,-19,19
AGF Aarhus,47,11,4,7,11,17,37,-20,19
FC Midtjylla,48,1,21,4,5,70,40,30,67
Brondby,48,2,20,6,4,71,35,36,66
FC Nords,48,3,15,7,8,72,49,23,52
Copenhagen,48,4,14,7,9,57,39,18,49
Sonderjyske,48,5,8,6,10,28,29,-1,30
AaB,48,6,6,12,12,35,46,-11,30
AC Horsens,48,7,6,12,12,34,56,-22,30
Randers FC,48,8,6,6,12,25,40,-15,24
Silkeborg IF,48,9,5,4,13,27,46,-19,19
AGF Aarhus,48,10,4,7,11,18,38,-20,19
Lyngby,48,11,3,9,12,27,46,-19,18
FC Midtjylla,49,1,19,5,6,69,42,27,62
Brondby,49,2,18,6,6,66,35,31,60
FC Nords,49,3,16,6,8,78,50,28,54
Copenhagen,49,4,15,4,11,58,47,11,49
AaB,49,5,9,12,9,40,42,-2,39
AC Horsens,49,6,6,13,11,37,58,-21,31
Sonderjyske,49,7,8,6,10,28,29,-1,30
Randers FC,49,8,5,7,12,25,41,-16,22
Lyngby,49,9,3,10,11,28,46,-18,19
Silkeborg IF,49,10,5,4,13,26,45,-19,19
AGF Aarhus,49,11,4,7,11,17,37,-20,19
FC Midtjylla,50,1,21,4,5,68,36,32,67
Brondby,50,2,19,6,5,67,36,31,63
FC Nords,50,3,15,6,9,74,50,24,51
Copenhagen,50,4,13,5,12,53,43,10,44
AaB,50,5,9,12,9,36,37,-1,39
AC Horsens,50,6,6,13,11,31,53,-22,31
Sonderjyske,50,7,8,6,10,28,29,-1,30
Lyngby,50,8,4,9,11,28,45,-17,21
Silkeborg IF,50,8,6,3,13,28,45,-17,21
Randers FC,50,10,5,6,13,24,41,-17,21
AGF Aarhus,50,11,4,6,12,17,39,-22,18
Brondby,51,1,20,6,4,70,33,37,66
FC Midtjylla,51,2,20,4,6,66,37,29,64
Copenhagen,51,3,16,4,10,60,42,18,52
FC Nords,51,4,14,7,9,76,55,21,49
AaB,51,5,8,11,11,38,48,-10,35
Sonderjyske,51,6,8,6,10,28,29,-1,30
AC Horsens,51,7,6,12,12,33,54,-21,30
Randers FC,51,8,6,6,12,24,39,-15,24
AGF Aarhus,51,9,5,6,11,18,36,-18,21
Lyngby,51,10,3,9,12,26,45,-19,18
Silkeborg IF,51,11,5,3,14,25,46,-21,18
Brondby,52,1,22,6,2,72,28,44,72
FC Midtjylla,52,2,18,4,8,61,43,18,58
FC Nords,52,3,14,7,9,70,49,21,49
Copenhagen,52,4,14,6,10,58,45,13,48
AaB,52,5,7,13,10,37,43,-6,34
AC Horsens,52,6,6,14,10,34,50,-16,32
Sonderjyske,52,7,8,6,10,28,29,-1,30
Lyngby,52,8,4,9,11,28,45,-17,21
Randers FC,52,9,5,6,13,24,41,-17,21
Silkeborg IF,52,10,6,3,13,27,45,-18,21
AGF Aarhus,52,11,4,6,12,17,38,-21,18
FC Midtjylla,53,1,21,5,4,68,36,32,68
Brondby,53,2,19,7,4,71,35,36,64
FC Nords,53,3,14,6,10,73,54,19,48
Copenhagen,53,4,13,6,11,56,46,10,45
AC Horsens,53,5,7,14,9,34,49,-15,35
AaB,53,6,6,14,10,34,42,-8,32
Sonderjyske,53,7,8,6,10,28,29,-1,30
Lyngby,53,8,4,9,11,28,45,-17,21
Randers FC,53,9,5,6,13,24,41,-17,21
AGF Aarhus,53,10,5,6,11,18,37,-19,21
Silkeborg IF,53,11,5,3,14,26,46,-20,18
Brondby,54,1,20,6,4,73,38,35,66
FC Midtjylla,54,2,19,5,6,70,41,29,62
FC Nords,54,3,15,6,9,82,52,30,51
Copenhagen,54,4,15,5,10,56,43,13,50
AaB,54,5,7,13,10,36,48,-12,34
AC Horsens,54,6,6,13,11,36,57,-21,31
Sonderjyske,54,7,8,6,10,28,29,-1,30
Silkeborg IF,54,8,6,3,13,28,44,-16,21
Lyngby,54,9,4,9,11,27,44,-17,21
Randers FC,54,10,5,6,13,23,40,-17,21
AGF Aarhus,54,11,4,6,12,16,39,-23,18
Brondby,55,1,20,7,3,68,30,38,67
FC Midtjylla,55,2,18,5,7,63,42,21,59
FC Nords,55,3,15,8,7,76,47,29,53
Copenhagen,55,4,13,5,12,55,48,7,44
AC Horsens,55,5,8,12,10,37,51,-14,36
AaB,55,6,8,11,11,39,46,-7,35
Sonderjyske,55,7,8,6,10,28,29,-1,30
Lyngby,55,8,4,9,11,29,44,-15,21
Silkeborg IF,55,9,6,3,13,28,46,-18,21
Randers FC,55,10,5,6,13,23,42,-19,21
AGF Aarhus,55,11,4,6,12,18,39,-21,18
Brondby,56,1,23,5,2,78,30,48,74
FC Midtjylla,56,2,19,5,6,61,38,23,62
FC Nords,56,3,14,6,10,72,56,16,48
Copenhagen,56,4,14,5,11,56,47,9,47
AaB,56,5,7,11,12,34,40,-6,32
AC Horsens,56,6,6,14,10,34,50,-16,32
Sonderjyske,56,7,8,6,10,28,29,-1,30
Randers FC,56,8,5,7,12,24,40,-16,22
Lyngby,56,9,3,10,11,27,45,-18,19
Silkeborg IF,56,10,5,4,13,26,45,-19,19
AGF Aarhus,56,11,4,7,11,17,37,-20,19
Brondby,57,1,21,5,4,75,35,40,68
FC Midtjylla,57,2,20,5,5,66,40,26,65
FC Nords,57,3,14,7,9,73,52,21,49
Copenhagen,57,4,14,5,11,55,43,12,47
AC Horsens,57,5,7,14,9,32,46,-14,35
Sonderjyske,57,6,8,6,10,28,29,-1,30
AaB,57,7,6,12,12,33,44,-11,30
Lyngby,57,8,4,9,11,27,44,-17,21
Randers FC,57,9,5,6,13,23,40,-17,21
Silkeborg IF,57,10,6,3,13,26,44,-18,21
AGF Aarhus,57,11,4,6,12,16,37,-21,18
Brondby,58,1,21,5,4,69,32,37,68
FC Midtjylla,58,2,20,4,6,65,39,26,64
FC Nords,58,3,15,7,8,78,54,24,52
Copenhagen,58,4,15,4,11,60,45,15,49
AaB,58,5,7,12,11,37,45,-8,33
Sonderjyske,58,6,8,6,10,28,29,-1,30
AC Horsens,58,7,5,14,11,32,52,-20,29
Lyngby,58,8,4,9,11,29,44,-15,21
Randers FC,58,9,5,6,13,23,42,-19,21
AGF Aarhus,58,10,5,6,11,18,37,-19,21
Silkeborg IF,58,11,5,3,14,26,46,-20,18
Brondby,59,1,19,7,4,68,34,34,64
FC Midtjylla,59,2,19,5,6,68,41,27,62
FC Nords,59,3,14,6,10,70,52,18,48
Copenhagen,59,4,14,6,10,62,46,16,48
AaB,59,5,8,12,10,38,47,-9,36
AC Horsens,59,6,7,14,9,36,48,-12,35
Sonderjyske,59,7,8,6,10,28,29,-1,30
Randers FC,59,8,6,6,12,27,40,-13,24
Silkeborg IF,59,9,6,3,13,27,45,-18,21
Lyngby,59,10,3,9,12,27,48,-21,18
AGF Aarhus,59,11,4,6,12,17,38,-21,18
FC Midtjylla,60,1,20,4,6,65,38,27,64
Brondby,60,2,19,6,5,66,33,33,63
Copenhagen,60,3,15,4,11,58,43,15,49
FC Nords,60,4,13,6,11,69,55,14,45
AaB,60,5,8,13,9,41,45,-4,37
AC Horsens,60,6,8,13,9,36,47,-11,37
Sonderjyske,60,7,8,6,10,28,29,-1,30
Lyngby,60,8,4,9,11,27,44,-17,21
Randers FC,60,9,5,6,13,23,40,-17,21
Silkeborg IF,60,10,6,3,13,26,44,-18,21
AGF Aarhus,60,11,4,6,12,16,37,-21,18
Brondby,61,1,20,6,4,73,37,36,66
FC Midtjylla,61,2,19,6,5,64,40,24,63
Copenhagen,61,3,14,6,10,61,44,17,48
FC Nords,61,4,13,6,11,70,54,16,45
AaB,61,5,7,14,9,37,42,-5,35
AC Horsens,61,6,6,16,8,35,49,-14,34
Sonderjyske,61,7,8,6,10,28,29,-1,30
Randers FC,61,8,6,6,12,24,39,-15,24
AGF Aarhus,61,9,5,6,11,20,36,-16,21
Lyngby,61,10,3,9,12,26,45,-19,18
Silkeborg IF,61,11,5,3,14,25,48,-23,18
Brondby,62,1,20,6,4,68,31,37,66
FC Midtjylla,62,2,20,6,4,67,37,30,66
FC Nords,62,3,13,9,8,73,53,20,48
Copenhagen,62,4,13,5,12,55,46,9,44
AaB,62,5,9,11,10,38,43,-5,38
AC Horsens,62,6,6,13,11,34,51,-17,31
Sonderjyske,62,7,8,6,10,28,29,-1,30
Randers FC,62,8,6,6,12,24,39,-15,24
Silkeborg IF,62,9,5,4,13,25,44,-19,19
AGF Aarhus,62,10,4,7,11,16,36,-20,19
Lyngby,62,11,3,9,12,26,45,-19,18
Brondby,63,1,20,8,2,67,29,38,68
FC Midtjylla,63,2,19,4,7,63,40,23,61
FC Nords,63,3,14,8,8,75,54,21,50
Copenhagen,63,4,13,6,11,56,46,10,45
AaB,63,5,8,12,10,40,41,-1,36
AC Horsens,63,6,5,16,9,35,52,-17,31
Sonderjyske,63,7,8,6,10,28,29,-1,30
Silkeborg IF,63,8,6,3,13,29,44,-15,21
Lyngby,63,9,4,9,11,28,44,-16,21
Randers FC,63,10,5,6,13,23,41,-18,21
AGF Aarhus,63,11,4,6,12,16,40,-24,18
Brondby,64,1,21,6,3,70,30,40,69
FC Midtjylla,64,2,18,5,7,61,40,21,59
FC Nords,64,3,13,9,8,74,53,21,48
Copenhagen,64,4,14,5,11,58,48,10,47
AC Horsens,64,5,8,12,10,38,49,-11,36
AaB,64,6,7,13,10,35,42,-7,34
Sonderjyske,64,7,8,6,10,28,29,-1,30
Randers FC,64,8,6,6,12,25,39,-14,24
Silkeborg IF,64,9,6,3,13,27,45,-18,21
Lyngby,64,10,3,9,12,26,46,-20,18
AGF Aarhus,64,11,4,6,12,17,38,-21,18
Brondby,65,1,19,7,4,70,36,34,64
FC Midtjylla,65,2,20,4,6,68,40,28,64
FC Nords,65,3,16,6,8,79,48,31,54
Copenhagen,65,4,15,5,10,56,44,12,50
AC Horsens,65,5,6,14,10,32,54,-22,32
Sonderjyske,65,6,8,6,10,28,29,-1,30
AaB,65,7,6,12,12,31,40,-9,30
Lyngby,65,8,4,9,11,29,44,-15,21
Randers FC,65,9,5,6,13,23,42,-19,21
Silkeborg IF,65,10,5,4,13,26,45,-19,19
AGF Aarhus,65,11,4,7,11,17,37,-20,19
Brondby,66,1,20,7,3,69,33,36,67
FC Midtjylla,66,2,20,6,4,66,38,28,66
Copenhagen,66,3,14,7,9,58,40,18,49
FC Nords,66,4,12,9,9,71,54,17,45
AaB,66,5,8,11,11,39,45,-6,35
Sonderjyske,66,6,8,6,10,28,29,-1,30
AC Horsens,66,7,5,14,11,34,53,-19,29
Lyngby,66,8,4,9,11,27,44,-17,21
Randers FC,66,9,5,6,13,23,40,-17,21
AGF Aarhus,66,10,5,6,11,19,38,-19,21
Silkeborg IF,66,11,5,3,14,27,47,-20,18
Brondby,67,1,21,6,3,69,29,40,69
FC Midtjylla,67,2,19,7,4,63,36,27,64
FC Nords,67,3,16,6,8,77,47,30,54
Copenhagen,67,4,13,5,12,55,48,7,44
AaB,67,5,7,11,12,38,46,-8,32
AC Horsens,67,6,6,13,11,34,56,-22,31
Sonderjyske,67,7,8,6,10,28,29,-1,30
Randers FC,67,8,5,7,12,25,41,-16,22
Silkeborg IF,67,9,6,3,13,27,44,-17,21
Lyngby,67,10,3,10,11,28,46,-18,19
AGF Aarhus,67,11,4,6,12,16,38,-22,18
Brondby,68,1,21,6,3,73,31,42,69
FC Midtjylla,68,2,21,4,5,66,39,27,67
FC Nords,68,3,14,6,10,75,54,21,48
Copenhagen,68,4,12,6,12,53,44,9,42
AC Horsens,68,5,8,12,10,36,54,-18,36
AaB,68,6,7,12,11,37,44,-7,33
Sonderjyske,68,7,8,6,10,28,29,-1,30
Lyngby,68,8,4,9,11,29,44,-15,21
Randers FC,68,9,5,6,13,23,42,-19,21
AGF Aarhus,68,10,5,6,11,18,37,-19,21
Silkeborg IF,68,11,5,3,14,26,46,-20,18
Brondby,69,1,21,7,2,74,33,41,70
FC Midtjylla,69,2,19,5,6,68,40,28,62
Copenhagen,69,3,15,6,9,59,41,18,51
FC Nords,69,4,13,6,11,70,55,15,45
AaB,69,5,7,13,10,36,42,-6,34
AC Horsens,69,6,6,13,11,33,55,-22,31
Sonderjyske,69,7,8,6,10,28,29,-1,30
Lyngby,69,8,4,9,11,29,45,-16,21
Randers FC,69,9,5,6,13,24,42,-18,21
Silkeborg IF,69,10,5,4,13,26,45,-19,19
AGF Aarhus,69,11,4,7,11,17,37,-20,19
Brondby,70,1,21,7,2,72,33,39,70
FC Midtjylla,70,2,20,6,4,63,35,28,66
Copenhagen,70,3,15,5,10,63,42,21,50
FC Nords,70,4,14,7,9,73,52,21,49
Sonderjyske,70,5,8,6,10,28,29,-1,30
AaB,70,6,6,12,12,35,49,-14,30
AC Horsens,70,7,5,13,12,33,54,-21,28
Randers FC,70,8,6,6,12,25,40,-15,24
Silkeborg IF,70,9,6,3,13,27,44,-17,21
Lyngby,70,10,3,9,12,27,46,-19,18
AGF Aarhus,70,11,4,6,12,16,38,-22,18
Brondby,71,1,22,5,3,73,30,43,71
FC Midtjylla,71,2,21,4,5,66,37,29,67
Copenhagen,71,3,15,4,11,56,47,9,49
FC Nords,71,4,14,6,10,74,50,24,48
AaB,71,5,7,11,12,32,41,-9,32
Sonderjyske,71,6,8,6,10,28,29,-1,30
AC Horsens,71,7,6,12,12,32,54,-22,30
Lyngby,71,8,4,9,11,29,44,-15,21
Randers FC,71,9,5,6,13,23,42,-19,21
AGF Aarhus,71,10,5,6,11,18,37,-19,21
Silkeborg IF,71,11,5,3,14,26,46,-20,18
Brondby,72,1,20,7,3,71,31,40,67
FC Midtjylla,72,2,20,6,4,69,38,31,66
FC Nords,72,3,13,7,10,74,59,15,46
Copenhagen,72,4,13,6,11,57,46,11,45
AaB,72,5,8,12,10,39,43,-4,36
AC Horsens,72,6,6,14,10,32,51,-19,32
Sonderjyske,72,7,8,6,10,28,29,-1,30
Randers FC,72,8,5,7,12,25,41,-16,22
Lyngby,72,9,3,10,11,28,46,-18,19
Silkeborg IF,72,10,5,4,13,27,46,-19,19
AGF Aarhus,72,11,4,7,11,18,38,-20,19
Brondby,73,1,21,6,3,74,30,44,69
FC Midtjylla,73,2,18,6,6,62,45,17,60
FC Nords,73,3,15,7,8,78,55,23,52
Copenhagen,73,4,15,4,11,60,45,15,49
AaB,73,5,7,12,11,36,45,-9,33
AC Horsens,73,6,6,13,11,35,51,-16,31
Sonderjyske,73,7,8,6,10,28,29,-1,30
Randers FC,73,8,6,6,12,25,40,-15,24
Silkeborg IF,73,9,6,3,13,26,44,-18,21
Lyngby,73,10,3,9,12,27,46,-19,18
AGF Aarhus,73,11,4,6,12,16,37,-21,18
Brondby,74,1,20,7,3,71,33,38,67
FC Midtjylla,74,2,20,5,5,68,41,27,65
Copenhagen,74,3,15,5,10,58,47,11,50
FC Nords,74,4,14,6,10,76,53,23,48
AC Horsens,74,5,6,14,10,38,56,-18,32
AaB,74,6,6,13,11,36,43,-7,31
Sonderjyske,74,7,8,6,10,28,29,-1,30
Lyngby,74,8,4,9,11,30,45,-15,21
Silkeborg IF,74,9,6,3,13,27,44,-17,21
Randers FC,74,10,5,6,13,24,43,-19,21
AGF Aarhus,74,11,4,6,12,16,38,-22,18
Brondby,75,1,21,6,3,72,31,41,69
FC Midtjylla,75,2,20,5,5,70,41,29,65
FC Nords,75,3,15,7,8,76,49,27,52
Copenhagen,75,4,13,6,11,59,51,8,45
AaB,75,5,7,13,10,39,46,-7,34
Sonderjyske,75,6,8,6,10,28,29,-1,30
AC Horsens,75,7,5,13,12,33,57,-24,28
Lyngby,75,8,4,9,11,27,44,-17,21
Randers FC,75,9,5,6,13,23,40,-17,21
AGF Aarhus,75,10,5,6,11,18,37,-19,21
Silkeborg IF,75,11,5,3,14,26,46,-20,18
FC Midtjylla,76,1,21,5,4,68,34,34,68
Brondby,76,2,18,9,3,68,34,34,63
FC Nords,76,3,15,7,8,74,54,20,52
Copenhagen,76,4,14,5,11,59,46,13,47
AaB,76,5,7,12,11,38,46,-8,33
Sonderjyske,76,6,8,6,10,28,29,-1,30
AC Horsens,76,7,5,14,11,38,57,-19,29
Randers FC,76,8,6,6,12,25,39,-14,24
Silkeborg IF,76,9,6,3,13,28,44,-16,21
Lyngby,76,10,3,9,12,26,46,-20,18
AGF Aarhus,76,11,4,6,12,16,39,-23,18
Brondby,77,1,21,6,3,71,32,39,69
FC Midtjylla,77,2,20,5,5,70,36,34,65
FC Nords,77,3,14,7,9,73,59,14,49
Copenhagen,77,4,12,6,12,56,46,10,42
AaB,77,5,6,15,9,34,41,-7,33
AC Horsens,77,6,6,15,9,33,49,-16,33
Sonderjyske,77,7,8,6,10,28,29,-1,30
Randers FC,77,8,6,6,12,26,39,-13,24
Silkeborg IF,77,9,5,4,13,26,45,-19,19
AGF Aarhus,77,10,4,7,11,17,37,-20,19
Lyngby,77,11,3,9,12,26,47,-21,18
Brondby,78,1,21,7,2,72,31,41,70
FC Midtjylla,78,2,19,4,7,63,37,26,61
FC Nords,78,3,15,7,8,77,51,26,52
Copenhagen,78,4,13,6,11,56,48,8,45
AaB,78,5,7,13,10,38,43,-5,34
AC Horsens,78,6,6,13,11,33,55,-22,31
Sonderjyske,78,7,8,6,10,28,29,-1,30
Lyngby,78,8,4,9,11,28,44,-16,21
Randers FC,78,9,5,6,13,23,41,-18,21
AGF Aarhus,78,10,5,6,11,17,36,-19,21
Silkeborg IF,78,11,5,3,14,25,45,-20,18
Brondby,79,1,20,5,5,71,34,37,65
FC Midtjylla,79,2,19,6,5,66,41,25,63
Copenhagen,79,3,15,5,10,58,42,16,50
FC Nords,79,4,13,8,9,70,52,18,47
AC Horsens,79,5,8,12,10,36,49,-13,36
AaB,79,6,6,14,10,35,44,-9,32
Sonderjyske,79,7,8,6,10,28,29,-1,30
Randers FC,79,8,6,6,12,26,40,-14,24
Silkeborg IF,79,9,6,3,13,28,46,-18,21
Lyngby,79,10,3,9,12,27,47,-20,18
AGF Aarhus,79,11,4,6,12,18,39,-21,18
Brondby,80,1,21,7,2,71,32,39,70
FC Midtjylla,80,2,18,6,6,64,42,22,60
FC Nords,80,3,15,7,8,74,49,25,52
Copenhagen,80,4,14,5,11,59,45,14,47
AaB,80,5,6,16,8,36,40,-4,34
Sonderjyske,80,6,8,6,10,28,29,-1,30
AC Horsens,80,7,5,13,12,35,57,-22,28
Randers FC,80,8,6,6,12,26,40,-14,24
Silkeborg IF,80,9,6,3,13,28,44,-16,21
Lyngby,80,10,3,9,12,27,47,-20,18
AGF Aarhus,80,11,4,6,12,16,39,-23,18
Brondby,81,1,20,7,3,67,30,37,67
FC Midtjylla,81,2,20,4,6,66,37,29,64
FC Nords,81,3,15,7,8,72,52,20,52
Copenhagen,81,4,14,5,11,59,43,16,47
AaB,81,5,7,12,11,35,44,-9,33
AC Horsens,81,6,6,13,11,32,51,-19,31
Sonderjyske,81,7,8,6,10,28,29,-1,30
Randers FC,81,8,5,7,12,24,40,-16,22
Lyngby,81,9,3,10,11,27,45,-18,19
Silkeborg IF,81,10,5,4,13,26,45,-19,19
AGF Aarhus,81,11,4,7,11,17,37,-20,19
Brondby,82,1,22,6,2,75,33,42,72
FC Midtjylla,82,2,18,6,6,68,42,26,60
FC Nords,82,3,13,8,9,76,55,21,47
Copenhagen,82,4,14,5,11,59,45,14,47
AC Horsens,82,5,8,12,10,43,55,-12,36
AaB,82,6,6,13,11,32,49,-17,31
Sonderjyske,82,7,8,6,10,28,29,-1,30
Lyngby,82,8,4,9,11,29,44,-15,21
AGF Aarhus,82,9,5,6,11,18,36,-18,21
Randers FC,82,10,5,6,13,23,42,-19,21
Silkeborg IF,82,11,5,3,14,25,46,-21,18
Brondby,83,1,21,6,3,76,32,44,69
FC Midtjylla,83,2,19,5,6,62,38,24,62
Copenhagen,83,3,14,5,11,59,47,12,47
FC Nords,83,4,12,9,9,68,51,17,45
AC Horsens,83,5,8,12,10,39,53,-14,36
AaB,83,6,8,11,11,35,44,-9,35
Sonderjyske,83,7,8,6,10,28,29,-1,30
Randers FC,83,8,5,7,12,24,40,-16,22
Silkeborg IF,83,9,6,3,13,29,44,-15,21
Lyngby,83,10,3,10,11,27,45,-18,19
AGF Aarhus,83,11,4,6,12,16,40,-24,18
Brondby,84,1,20,6,4,70,33,37,66
FC Midtjylla,84,2,20,5,5,66,38,28,65
Copenhagen,84,3,15,5,10,58,43,15,50
FC Nords,84,4,14,7,9,77,51,26,49
AC Horsens,84,5,7,13,10,40,56,-16,34
Sonderjyske,84,6,8,6,10,28,29,-1,30
AaB,84,7,6,12,12,33,49,-16,30
Lyngby,84,8,4,9,11,28,45,-17,21
Randers FC,84,9,5,6,13,24,41,-17,21
Silkeborg IF,84,10,6,3,13,26,44,-18,21
AGF Aarhus,84,11,4,6,12,16,37,-21,18
Brondby,85,1,22,6,2,76,30,46,72
FC Midtjylla,85,2,19,5,6,62,39,23,62
Copenhagen,85,3,15,6,9,56,40,16,51
FC Nords,85,4,13,8,9,73,56,17,47
AaB,85,5,7,12,11,37,42,-5,33
Sonderjyske,85,6,8,6,10,28,29,-1,30
AC Horsens,85,7,5,13,12,32,55,-23,28
Randers FC,85,8,6,6,12,24,39,-15,24
Silkeborg IF,85,9,6,3,13,28,46,-18,21
Lyngby,85,10,3,9,12,26,45,-19,18
AGF Aarhus,85,11,4,6,12,18,39,-21,18
Brondby,86,1,21,5,4,69,32,37,68
FC Midtjylla,86,2,20,5,5,68,40,28,65
FC Nords,86,3,16,6,8,75,47,28,54
Copenhagen,86,4,14,5,11,54,41,13,47
AaB,86,5,7,12,11,37,47,-10,33
Sonderjyske,86,6,8,6,10,28,29,-1,30
AC Horsens,86,7,5,13,12,35,57,-22,28
Randers FC,86,8,6,6,12,26,40,-14,24
Silkeborg IF,86,9,6,3,13,27,44,-17,21
Lyngby,86,10,3,9,12,27,47,-20,18
AGF Aarhus,86,11,4,6,12,16,38,-22,18
FC Midtjylla,87,1,20,4,6,69,44,25,64
Brondby,87,2,19,6,5,66,34,32,63
Copenhagen,87,3,16,5,9,61,43,18,53
FC Nords,87,4,13,7,10,71,53,18,46
AaB,87,5,9,12,9,38,39,-1,39
Sonderjyske,87,6,8,6,10,28,29,-1,30
AC Horsens,87,7,5,14,11,32,50,-18,29
Randers FC,87,8,5,7,12,24,40,-16,22
AGF Aarhus,87,9,5,6,11,17,36,-19,21
Lyngby,87,10,3,10,11,27,45,-18,19
Silkeborg IF,87,11,5,3,14,25,45,-20,18
Brondby,88,1,20,8,2,69,29,40,68
FC Midtjylla,88,2,17,6,7,62,43,19,57
Copenhagen,88,3,14,6,10,56,42,14,48
FC Nords,88,4,13,8,9,70,51,19,47
AaB,88,5,9,12,9,40,39,1,39
AC Horsens,88,6,7,12,11,36,55,-19,33
Sonderjyske,88,7,8,6,10,28,29,-1,30
Lyngby,88,8,4,9,11,27,44,-17,21
Randers FC,88,9,5,6,13,23,40,-17,21
Silkeborg IF,88,10,5,4,13,25,44,-19,19
AGF Aarhus,88,11,4,7,11,16,36,-20,19
Brondby,89,1,19,8,3,66,30,36,65
FC Midtjylla,89,2,19,6,5,64,38,26,63
FC Nords,89,3,14,8,8,72,49,23,50
Copenhagen,89,4,13,5,12,53,43,10,44
AaB,89,5,8,11,11,35,42,-7,35
AC Horsens,89,6,7,14,9,36,50,-14,35
Sonderjyske,89,7,8,6,10,28,29,-1,30
Lyngby,89,8,4,9,11,28,44,-16,21
Randers FC,89,9,5,6,13,23,41,-18,21
AGF Aarhus,89,10,5,6,11,18,37,-19,21
Silkeborg IF,89,11,5,3,14,26,46,-20,18
Brondby,90,1,21,6,3,70,31,39,69
FC Midtjylla,90,2,20,5,5,69,40,29,65
Copenhagen,90,3,14,5,11,62,46,16,47
FC Nords,90,4,13,7,10,71,56,15,46
AC Horsens,90,5,7,13,10,35,52,-17,34
AaB,90,6,7,12,11,38,46,-8,33
Sonderjyske,90,7,8,6,10,28,29,-1,30
Lyngby,90,8,4,9,11,28,45,-17,21
Randers FC,90,9,5,6,13,24,41,-17,21
Silkeborg IF,90,10,5,4,13,26,45,-19,19
AGF Aarhus,90,11,4,7,11,17,37,-20,19
Brondby,91,1,19,8,3,67,32,35,65
FC Midtjylla,91,2,19,6,5,63,37,26,63
FC Nords,91,3,13,9,8,74,54,20,48
Copenhagen,91,4,13,6,11,54,43,11,45
AaB,91,5,8,11,11,34,41,-7,35
AC Horsens,91,6,7,14,9,38,49,-11,35
Sonderjyske,91,7,8,6,10,28,29,-1,30
Lyngby,91,8,4,9,11,28,45,-17,21
Silkeborg IF,91,9,6,3,13,27,44,-17,21
Randers FC,91,10,5,6,13,24,41,-17,21
AGF Aarhus,91,11,4,6,12,16,38,-22,18
Brondby,92,1,21,5,4,74,34,40,68
FC Midtjylla,92,2,18,5,7,67,44,23,59
Copenhagen,92,3,15,5,10,57,43,14,50
FC Nords,92,4,14,7,9,71,51,20,49
AC Horsens,92,5,8,13,9,37,51,-14,37
AaB,92,6,6,13,11,33,42,-9,31
Sonderjyske,92,7,8,6,10,28,29,-1,30
Randers FC,92,8,5,7,12,24,40,-16,22
Silkeborg IF,92,9,6,3,13,29,46,-17,21
Lyngby,92,10,3,10,11,27,45,-18,19
AGF Aarhus,92,11,4,6,12,18,40,-22,18
Brondby,93,1,19,8,3,67,32,35,65
FC Midtjylla,93,2,20,5,5,65,39,26,65
FC Nords,93,3,14,8,8,79,53,26,50
Copenhagen,93,4,13,6,11,56,49,7,45
AC Horsens,93,5,6,15,9,36,49,-13,33
AaB,93,6,6,14,10,36,43,-7,32
Sonderjyske,93,7,8,6,10,28,29,-1,30
Randers FC,93,8,6,6,12,25,40,-15,24
AGF Aarhus,93,9,5,6,11,17,36,-19,21
Lyngby,93,10,3,9,12,27,46,-19,18
Silkeborg IF,93,11,5,3,14,25,45,-20,18
Brondby,94,1,22,5,3,71,31,40,71
FC Midtjylla,94,2,20,4,6,67,42,25,64
FC Nords,94,3,14,7,9,71,48,23,49
Copenhagen,94,4,14,5,11,57,43,14,47
AC Horsens,94,5,7,12,11,37,56,-19,33
AaB,94,6,6,13,11,33,42,-9,31
Sonderjyske,94,7,8,6,10,28,29,-1,30
Randers FC,94,8,5,7,12,25,41,-16,22
Silkeborg IF,94,9,6,3,13,28,45,-17,21
Lyngby,94,10,3,10,11,28,46,-18,19
AGF Aarhus,94,11,4,6,12,17,39,-22,18
Brondby,95,1,21,6,3,70,30,40,69
FC Midtjylla,95,2,19,6,5,62,36,26,63
FC Nords,95,3,15,6,9,73,50,23,51
Copenhagen,95,4,13,6,11,58,48,10,45
AaB,95,5,7,12,11,35,44,-9,33
AC Horsens,95,6,6,14,10,34,50,-16,32
Sonderjyske,95,7,8,6,10,28,29,-1,30
Silkeborg IF,95,8,6,3,13,29,45,-16,21
Lyngby,95,9,4,9,11,28,45,-17,21
Randers FC,95,10,5,6,13,24,41,-17,21
AGF Aarhus,95,11,4,6,12,17,40,-23,18
Brondby,96,1,23,5,2,73,27,46,74
FC Midtjylla,96,2,20,4,6,66,43,23,64
FC Nords,96,3,14,6,10,73,53,20,48
Copenhagen,96,4,13,4,13,55,44,11,43
AaB,96,5,9,11,10,40,42,-2,38
Sonderjyske,96,6,8,6,10,28,29,-1,30
AC Horsens,96,7,6,12,12,33,57,-24,30
Lyngby,96,8,4,9,11,28,44,-16,21
Randers FC,96,9,5,6,13,23,41,-18,21
Silkeborg IF,96,10,5,4,13,26,45,-19,19
AGF Aarhus,96,11,4,7,11,17,37,-20,19
Brondby,97,1,21,6,3,74,34,40,69
FC Midtjylla,97,2,18,4,8,61,42,19,58
Copenhagen,97,3,14,7,9,63,47,16,49
FC Nords,97,4,13,7,10,71,55,16,46
AaB,97,5,9,12,9,41,42,-1,39
AC Horsens,97,6,7,12,11,35,51,-16,33
Sonderjyske,97,7,8,6,10,28,29,-1,30
Lyngby,97,8,4,9,11,30,45,-15,21
Randers FC,97,9,5,6,13,24,43,-19,21
Silkeborg IF,97,10,5,4,13,26,45,-19,19
AGF Aarhus,97,11,4,7,11,17,37,-20,19
Brondby,98,1,21,6,3,70,31,39,69
FC Midtjylla,98,2,18,5,7,62,41,21,59
FC Nords,98,3,15,6,9,78,51,27,51
Copenhagen,98,4,13,5,12,55,46,9,44
AaB,98,5,9,12,9,42,43,-1,39
AC Horsens,98,6,6,14,10,34,55,-21,32
Sonderjyske,98,7,8,6,10,28,29,-1,30
Randers FC,98,8,6,6,12,24,39,-15,24
AGF Aarhus,98,9,5,6,11,18,37,-19,21
Lyngby,98,10,3,9,12,26,45,-19,18
Silkeborg IF,98,11,5,3,14,26,46,-20,18
Brondby,99,1,21,5,4,70,34,36,68
FC Midtjylla,99,2,21,4,5,64,35,29,67
FC Nords,99,3,14,8,8,73,50,23,50
Copenhagen,99,4,13,4,13,57,48,9,43
AC Horsens,99,5,7,13,10,37,52,-15,34
AaB,99,6,7,12,11,34,42,-8,33
Sonderjyske,99,7,8,6,10,28,29,-1,30
Lyngby,99,8,4,9,11,28,44,-16,21
Randers FC,99,9,5,6,13,23,41,-18,21
AGF Aarhus,99,10,5,6,11,19,37,-18,21
Silkeborg IF,99,11,5,3,14,26,47,-21,18
Brondby,100,1,21,5,4,72,33,39,68
FC Midtjylla,100,2,18,6,6,65,40,25,60
FC Nords,100,3,15,8,7,74,49,25,53
Copenhagen,100,4,12,7,11,56,46,10,43
AaB,100,5,7,13,10,37,42,-5,34
AC Horsens,100,6,7,13,10,37,57,-20,34
Sonderjyske,100,7,8,6,10,28,29,-1,30
Randers FC,100,8,5,7,12,25,41,-16,22
Silkeborg IF,100,9,6,3,13,30,46,-16,21
Lyngby,100,10,3,10,11,28,46,-18,19
AGF Aarhus,100,11,4,6,12,18,41,-23,18
Brondby,101,1,22,6,2,77,34,43,72
FC Midtjylla,101,2,18,5,7,69,44,25,59
Copenhagen,101,3,14,5,11,57,47,10,47
FC Nords,101,4,12,9,9,69,51,18,45
AaB,101,5,9,11,10,42,45,-3,38
AC Horsens,101,6,7,12,11,41,60,-19,33
Sonderjyske,101,7,8,6,10,28,29,-1,30
Lyngby,101,8,4,9,11,31,46,-15,21
Silkeborg IF,101,9,6,3,13,26,44,-18,21
Randers FC,101,10,5,6,13,25,44,-19,21
AGF Aarhus,101,11,4,6,12,16,37,-21,18
Brondby,102,1,20,7,3,67,30,37,67
FC Midtjylla,102,2,19,5,6,64,40,24,62
FC Nords,102,3,13,8,9,73,56,17,47
Copenhagen,102,4,14,5,11,57,45,12,47
AC Horsens,102,5,8,12,10,39,51,-12,36
AaB,102,6,7,13,10,36,40,-4,34
Sonderjyske,102,7,8,6,10,28,29,-1,30
Lyngby,102,8,4,9,11,28,45,-17,21
Randers FC,102,9,5,6,13,24,41,-17,21
AGF Aarhus,102,10,5,6,11,18,37,-19,21
Silkeborg IF,102,11,5,3,14,26,46,-20,18
Brondby,103,1,23,5,2,76,31,45,74
FC Midtjylla,103,2,19,6,5,66,39,27,63
FC Nords,103,3,13,8,9,72,55,17,47
Copenhagen,103,4,12,5,13,58,54,4,41
AaB,103,5,8,12,10,41,43,-2,36
AC Horsens,103,6,6,14,10,36,53,-17,32
Sonderjyske,103,7,8,6,10,28,29,-1,30
Randers FC,103,8,6,6,12,25,40,-15,24
AGF Aarhus,103,9,5,6,11,18,37,-19,21
Lyngby,103,10,3,9,12,27,46,-19,18
Silkeborg IF,103,11,5,3,14,26,46,-20,18
FC Midtjylla,104,1,21,4,5,71,39,32,67
Brondby,104,2,20,5,5,67,33,34,65
FC Nords,104,3,14,6,10,69,56,13,48
Copenhagen,104,4,14,5,11,58,44,14,47
AaB,104,5,9,11,10,42,42,0,38
AC Horsens,104,6,6,13,11,32,51,-19,31
Sonderjyske,104,7,8,6,10,28,29,-1,30
Randers FC,104,8,5,7,12,25,41,-16,22
AGF Aarhus,104,9,5,6,11,18,37,-19,21
Lyngby,104,10,3,10,11,28,46,-18,19
Silkeborg IF,104,11,5,3,14,26,46,-20,18
FC Midtjylla,105,1,20,6,4,72,38,34,66
Brondby,105,2,20,6,4,70,36,34,66
Copenhagen,105,3,14,7,9,62,46,16,49
FC Nords,105,4,13,7,10,72,56,16,46
AaB,105,5,8,13,9,36,40,-4,37
Sonderjyske,105,6,8,6,10,28,29,-1,30
AC Horsens,105,7,5,13,12,32,54,-22,28
Lyngby,105,8,4,9,11,28,44,-16,21
Randers FC,105,9,5,6,13,23,41,-18,21
AGF Aarhus,105,10,5,6,11,19,37,-18,21
Silkeborg IF,105,11,5,3,14,26,47,-21,18
Brondby,106,1,21,6,3,71,34,37,69
FC Midtjylla,106,2,19,4,7,66,47,19,61
FC Nords,106,3,15,6,9,74,51,23,51
Copenhagen,106,4,14,4,12,61,49,12,46
AaB,106,5,8,11,11,43,43,0,35
AC Horsens,106,6,7,13,10,35,52,-17,34
Sonderjyske,106,7,8,6,10,28,29,-1,30
Lyngby,106,8,4,9,11,28,44,-16,21
Silkeborg IF,106,9,6,3,13,26,44,-18,21
Randers FC,106,10,5,6,13,23,41,-18,21
AGF Aarhus,106,11,4,6,12,16,37,-21,18
Brondby,107,1,20,6,4,69,32,37,66
FC Midtjylla,107,2,20,5,5,64,38,26,65
FC Nords,107,3,15,7,8,77,53,24,52
Copenhagen,107,4,14,5,11,62,46,16,47
AaB,107,5,8,12,10,37,44,-7,36
Sonderjyske,107,6,8,6,10,28,29,-1,30
AC Horsens,107,7,5,13,12,32,54,-22,28
Randers FC,107,8,6,6,12,25,39,-14,24
Silkeborg IF,107,9,6,3,13,26,44,-18,21
Lyngby,107,10,3,9,12,26,46,-20,18
AGF Aarhus,107,11,4,6,12,16,37,-21,18
Brondby,108,1,21,5,4,70,34,36,68
FC Midtjylla,108,2,21,4,5,69,42,27,67
FC Nords,108,3,15,6,9,77,55,22,51
Copenhagen,108,4,14,4,12,60,46,14,46
AaB,108,5,7,12,11,36,43,-7,33
AC Horsens,108,6,6,13,11,34,52,-18,31
Sonderjyske,108,7,8,6,10,28,29,-1,30
Randers FC,108,8,6,6,12,26,40,-14,24
Silkeborg IF,108,9,6,3,13,27,45,-18,21
Lyngby,108,10,3,9,12,27,47,-20,18
AGF Aarhus,108,11,4,6,12,17,38,-21,18
Brondby,109,1,20,6,4,68,32,36,66
FC Midtjylla,109,2,20,4,6,70,41,29,64
FC Nords,109,3,13,9,8,74,55,19,48
Copenhagen,109,4,13,6,11,59,49,10,45
AaB,109,5,8,12,10,40,44,-4,36
AC Horsens,109,6,7,13,10,41,57,-16,34
Sonderjyske,109,7,8,6,10,28,29,-1,30
Lyngby,109,8,4,9,11,27,44,-17,21
Randers FC,109,9,5,6,13,23,40,-17,21
Silkeborg IF,109,10,5,4,13,26,45,-19,19
AGF Aarhus,109,11,4,7,11,17,37,-20,19
Brondby,110,1,20,8,2,73,34,39,68
FC Midtjylla,110,2,20,6,4,72,38,34,66
FC Nords,110,3,14,6,10,74,55,19,48
Copenhagen,110,4,14,5,11,58,46,12,47
AaB,110,5,6,14,10,36,43,-7,32
AC Horsens,110,6,6,13,11,36,59,-23,31
Sonderjyske,110,7,8,6,10,28,29,-1,30
Randers FC,110,8,5,7,12,24,40,-16,22
AGF Aarhus,110,9,5,6,11,17,36,-19,21
Lyngby,110,10,3,10,11,27,45,-18,19
Silkeborg IF,110,11,5,3,14,25,45,-20,18
Brondby,111,1,19,7,4,67,34,33,64
FC Midtjylla,111,2,19,5,6,65,39,26,62
FC Nords,111,3,17,6,7,74,47,27,57
Copenhagen,111,4,15,4,11,62,46,16,49
AaB,111,5,6,13,11,33,42,-9,31
AC Horsens,111,6,6,13,11,34,53,-19,31
Sonderjyske,111,7,8,6,10,28,29,-1,30
Randers FC,111,8,5,7,12,24,40,-16,22
Lyngby,111,9,3,10,11,27,45,-18,19
Silkeborg IF,111,10,5,4,13,26,45,-19,19
AGF Aarhus,111,11,4,7,11,17,37,-20,19
Brondby,112,1,21,5,4,72,33,39,68
FC Midtjylla,112,2,20,5,5,66,40,26,65
FC Nords,112,3,15,6,9,74,51,23,51
Copenhagen,112,4,14,6,10,58,42,16,48
AaB,112,5,7,12,11,35,42,-7,33
Sonderjyske,112,6,8,6,10,28,29,-1,30
AC Horsens,112,7,6,12,12,30,53,-23,30
Randers FC,112,8,6,6,12,26,41,-15,24
Silkeborg IF,112,9,5,4,13,25,44,-19,19
AGF Aarhus,112,10,4,7,11,16,36,-20,19
Lyngby,112,11,3,9,12,28,47,-19,18
Brondby,113,1,20,8,2,71,32,39,68
FC Midtjylla,113,2,19,5,6,67,41,26,62
Copenhagen,113,3,15,4,11,58,45,13,49
FC Nords,113,4,12,7,11,68,56,12,43
AC Horsens,113,5,8,13,9,40,51,-11,37
AaB,113,6,7,13,10,37,42,-5,34
Sonderjyske,113,7,8,6,10,28,29,-1,30
Randers FC,113,8,6,6,12,24,39,-15,24
AGF Aarhus,113,9,5,6,11,19,38,-19,21
Lyngby,113,10,3,9,12,26,45,-19,18
Silkeborg IF,113,11,5,3,14,27,47,-20,18
FC Midtjylla,114,1,21,4,5,69,40,29,67
Brondby,114,2,18,6,6,65,34,31,60
FC Nords,114,3,15,6,9,79,55,24,51
Copenhagen,114,4,13,6,11,57,43,14,45
AaB,114,5,10,11,9,42,41,1,41
AC Horsens,114,6,6,13,11,32,57,-25,31
Sonderjyske,114,7,8,6,10,28,29,-1,30
Lyngby,114,8,4,9,11,29,44,-15,21
Silkeborg IF,114,9,6,3,13,28,45,-17,21
Randers FC,114,10,5,6,13,23,42,-19,21
AGF Aarhus,114,11,4,6,12,17,39,-22,18
Brondby,115,1,21,6,3,76,33,43,69
FC Midtjylla,115,2,18,6,6,60,38,22,60
FC Nords,115,3,15,6,9,76,52,24,51
Copenhagen,115,4,14,6,10,57,44,13,48
AaB,115,5,6,14,10,35,42,-7,32
AC Horsens,115,6,6,14,10,36,57,-21,32
Sonderjyske,115,7,8,6,10,28,29,-1,30
Silkeborg IF,115,8,6,3,13,28,45,-17,21
Lyngby,115,9,4,9,11,27,44,-17,21
Randers FC,115,10,5,6,13,23,40,-17,21
AGF Aarhus,115,11,4,6,12,17,39,-22,18
FC Midtjylla,116,1,21,5,4,69,39,30,68
Brondby,116,2,19,6,5,67,35,32,63
FC Nords,116,3,15,6,9,76,52,24,51
Copenhagen,116,4,13,6,11,57,46,11,45
AaB,116,5,8,12,10,36,40,-4,36
Sonderjyske,116,6,8,6,10,28,29,-1,30
AC Horsens,116,7,5,15,10,34,53,-19,30
Lyngby,116,8,4,9,11,28,45,-17,21
Randers FC,116,9,5,6,13,24,41,-17,21
AGF Aarhus,116,10,5,6,11,20,37,-17,21
Silkeborg IF,116,11,5,3,14,26,48,-22,18
Brondby,117,1,21,5,4,71,34,37,68
FC Midtjylla,117,2,19,5,6,64,38,26,62
Copenhagen,117,3,16,5,9,60,38,22,53
FC Nords,117,4,12,9,9,68,51,17,45
AaB,117,5,8,11,11,36,46,-10,35
AC Horsens,117,6,6,13,11,32,50,-18,31
Sonderjyske,117,7,8,6,10,28,29,-1,30
Lyngby,117,8,4,9,11,29,45,-16,21
Randers FC,117,9,5,6,13,24,42,-18,21
AGF Aarhus,117,10,5,6,11,17,36,-19,21
Silkeborg IF,117,11,5,3,14,25,45,-20,18
Brondby,118,1,22,5,3,71,27,44,71
FC Midtjylla,118,2,21,4,5,66,38,28,67
FC Nords,118,3,13,8,9,70,53,17,47
Copenhagen,118,4,14,5,11,57,46,11,47
AaB,118,5,7,11,12,38,47,-9,32
AC Horsens,118,6,6,13,11,31,48,-17,31
Sonderjyske,118,7,8,6,10,28,29,-1,30
Lyngby,118,8,4,9,11,29,44,-15,21
Silkeborg IF,118,9,6,3,13,28,46,-18,21
Randers FC,118,10,5,6,13,23,42,-19,21
AGF Aarhus,118,11,4,6,12,18,39,-21,18
Brondby,119,1,21,6,3,72,32,40,69
FC Midtjylla,119,2,19,4,7,63,41,22,61
FC Nords,119,3,17,6,7,78,47,31,57
Copenhagen,119,4,13,6,11,56,45,11,45
AaB,119,5,7,12,11,35,43,-8,33
Sonderjyske,119,6,8,6,10,28,29,-1,30
AC Horsens,119,7,6,12,12,35,57,-22,30
Randers FC,119,8,5,7,12,25,41,-16,22
Lyngby,119,9,3,10,11,28,46,-18,19
Silkeborg IF,119,10,5,4,13,27,46,-19,19
AGF Aarhus,119,11,4,7,11,18,38,-20,19
FC Midtjylla,120,1,20,5,5,70,41,29,65
Brondby,120,2,19,5,6,69,40,29,62
Copenhagen,120,3,16,5,9,60,40,20,53
FC Nords,120,4,14,8,8,75,50,25,50
AC Horsens,120,5,7,12,11,35,54,-19,33
AaB,120,6,7,11,12,35,45,-10,32
Sonderjyske,120,7,8,6,10,28,29,-1,30
Randers FC,120,8,5,7,12,24,40,-16,22
Lyngby,120,9,3,10,11,27,45,-18,19
Silkeborg IF,120,10,5,4,13,27,46,-19,19
AGF Aarhus,120,11,4,7,11,18,38,-20,19
Brondby,121,1,22,5,3,73,31,42,71
FC Midtjylla,121,2,20,6,4,68,38,30,66
Copenhagen,121,3,15,5,10,59,41,18,50
FC Nords,121,4,12,6,12,67,58,9,42
AaB,121,5,8,11,11,39,44,-5,35
AC Horsens,121,6,6,13,11,35,55,-20,31
Sonderjyske,121,7,8,6,10,28,29,-1,30
Randers FC,121,8,5,7,12,25,41,-16,22
Lyngby,121,9,3,10,11,28,46,-18,19
Silkeborg IF,121,10,5,4,13,27,46,-19,19
AGF Aarhus,121,11,4,7,11,18,38,-20,19
Brondby,122,1,21,6,3,70,31,39,69
FC Midtjylla,122,2,18,4,8,60,44,16,58
FC Nords,122,3,14,8,8,71,47,24,50
Copenhagen,122,4,13,6,11,53,42,11,45
AC Horsens,122,5,9,12,9,40,50,-10,39
AaB,122,6,7,12,11,34,40,-6,33
Sonderjyske,122,7,8,6,10,28,29,-1,30
Randers FC,122,8,6,6,12,25,40,-15,24
Silkeborg IF,122,9,5,4,13,27,46,-19,19
AGF Aarhus,122,10,4,7,11,18,38,-20,19
Lyngby,122,11,3,9,12,27,46,-19,18
Brondby,123,1,20,7,3,72,34,38,67
FC Midtjylla,123,2,20,5,5,65,35,30,65
FC Nords,123,3,15,7,8,72,50,22,52
Copenhagen,123,4,13,6,11,55,44,11,45
AaB,123,5,8,11,11,36,44,-8,35
Sonderjyske,123,6,8,6,10,28,29,-1,30
AC Horsens,123,7,6,12,12,35,54,-19,30
Randers FC,123,8,6,6,12,26,39,-13,24
Silkeborg IF,123,9,6,3,13,26,44,-18,21
Lyngby,123,10,3,9,12,26,47,-21,18
AGF Aarhus,123,11,4,6,12,16,37,-21,18
Brondby,124,1,21,6,3,70,33,37,69
FC Midtjylla,124,2,19,5,6,63,43,20,62
FC Nords,124,3,14,7,9,74,50,24,49
Copenhagen,124,4,14,7,9,57,41,16,49
AC Horsens,124,5,6,14,10,32,48,-16,32
AaB,124,6,6,13,11,34,41,-7,31
Sonderjyske,124,7,8,6,10,28,29,-1,30
Randers FC,124,8,6,6,12,26,39,-13,24
AGF Aarhus,124,9,5,6,11,22,37,-15,21
Lyngby,124,10,3,9,12,26,47,-21,18
Silkeborg IF,124,11,5,3,14,26,50,-24,18
Brondby,125,1,21,6,3,73,32,41,69
FC Midtjylla,125,2,21,4,5,71,44,27,67
FC Nords,125,3,14,8,8,73,50,23,50
Copenhagen,125,4,13,6,11,58,46,12,45
AC Horsens,125,5,6,14,10,37,55,-18,32
Sonderjyske,125,6,8,6,10,28,29,-1,30
AaB,125,7,6,12,12,37,48,-11,30
Randers FC,125,8,5,7,12,24,40,-16,22
Silkeborg IF,125,9,6,3,13,30,44,-14,21
Lyngby,125,10,3,10,11,27,45,-18,19
AGF Aarhus,125,11,4,6,12,16,41,-25,18
Brondby,126,1,20,7,3,70,33,37,67
FC Midtjylla,126,2,19,6,5,62,35,27,63
FC Nords,126,3,14,7,9,71,48,23,49
Copenhagen,126,4,13,5,12,56,45,11,44
AaB,126,5,8,12,10,37,45,-8,36
AC Horsens,126,6,7,13,10,36,52,-16,34
Sonderjyske,126,7,8,6,10,28,29,-1,30
Lyngby,126,8,4,9,11,28,45,-17,21
Randers FC,126,9,5,6,13,24,41,-17,21
AGF Aarhus,126,10,5,6,11,17,36,-19,21
Silkeborg IF,126,11,5,3,14,25,45,-20,18
Brondby,127,1,20,7,3,67,30,37,67
FC Midtjylla,127,2,20,5,5,63,37,26,65
FC Nords,127,3,14,8,8,74,50,24,50
Copenhagen,127,4,14,6,10,58,44,14,48
AaB,127,5,7,12,11,39,47,-8,33
Sonderjyske,127,6,8,6,10,28,29,-1,30
AC Horsens,127,7,5,14,11,33,52,-19,29
Silkeborg IF,127,8,6,3,13,28,44,-16,21
Lyngby,127,9,4,9,11,29,46,-17,21
Randers FC,127,10,5,6,13,25,42,-17,21
AGF Aarhus,127,11,4,6,12,16,39,-23,18
Brondby,128,1,19,9,2,69,31,38,66
FC Midtjylla,128,2,20,5,5,66,39,27,65
Copenhagen,128,3,16,5,9,63,45,18,53
FC Nords,128,4,14,6,10,76,55,21,48
AC Horsens,128,5,6,13,11,35,56,-21,31
Sonderjyske,128,6,8,6,10,28,29,-1,30
AaB,128,7,6,12,12,38,47,-9,30
Lyngby,128,8,4,9,11,30,45,-15,21
Randers FC,128,9,5,6,13,24,43,-19,21
AGF Aarhus,128,10,5,6,11,18,37,-19,21
Silkeborg IF,128,11,5,3,14,26,46,-20,18
Brondby,129,1,21,5,4,72,37,35,68
FC Midtjylla,129,2,19,4,7,64,43,21,61
FC Nords,129,3,16,6,8,77,49,28,54
Copenhagen,129,4,13,4,13,54,46,8,43
AC Horsens,129,5,9,12,9,39,50,-11,39
AaB,129,6,7,11,12,36,43,-7,32
Sonderjyske,129,7,8,6,10,28,29,-1,30
Randers FC,129,8,6,6,12,25,39,-14,24
Silkeborg IF,129,9,6,3,13,27,45,-18,21
Lyngby,129,10,3,9,12,26,46,-20,18
AGF Aarhus,129,11,4,6,12,17,38,-21,18
Brondby,130,1,22,6,2,69,27,42,72
FC Midtjylla,130,2,20,4,6,64,38,26,64
FC Nords,130,3,16,6,8,75,49,26,54
Copenhagen,130,4,12,4,14,55,50,5,40
AaB,130,5,8,11,11,39,45,-6,35
AC Horsens,130,6,6,13,11,34,53,-19,31
Sonderjyske,130,7,8,6,10,28,29,-1,30
Lyngby,130,8,4,9,11,27,44,-17,21
Silkeborg IF,130,8,6,3,13,27,44,-17,21
Randers FC,130,10,5,6,13,23,40,-17,21
AGF Aarhus,130,11,4,6,12,16,38,-22,18
Brondby,131,1,21,5,4,73,33,40,68
FC Midtjylla,131,2,21,5,4,71,34,37,68
FC Nords,131,3,16,6,8,72,50,22,54
Copenhagen,131,4,14,4,12,53,43,10,46
AC Horsens,131,5,6,13,11,36,53,-17,31
Sonderjyske,131,6,8,6,10,28,29,-1,30
AaB,131,7,6,11,13,35,53,-18,29
Randers FC,131,8,6,6,12,25,40,-15,24
Silkeborg IF,131,9,6,3,13,28,44,-16,21
Lyngby,131,10,3,9,12,27,46,-19,18
AGF Aarhus,131,11,4,6,12,16,39,-23,18
Brondby,132,1,21,6,3,72,30,42,69
FC Midtjylla,132,2,19,5,6,64,39,25,62
FC Nords,132,3,15,6,9,74,50,24,51
Copenhagen,132,4,14,4,12,57,44,13,46
AaB,132,5,9,11,10,37,42,-5,38
Sonderjyske,132,6,8,6,10,28,29,-1,30
AC Horsens,132,7,6,12,12,36,61,-25,30
Lyngby,132,8,4,9,11,27,44,-17,21
Randers FC,132,9,5,6,13,23,40,-17,21
AGF Aarhus,132,10,5,6,11,18,36,-18,21
Silkeborg IF,132,11,5,3,14,25,46,-21,18
Brondby,133,1,21,6,3,69,31,38,69
FC Midtjylla,133,2,18,6,6,63,41,22,60
FC Nords,133,3,14,8,8,75,51,24,50
Copenhagen,133,4,14,4,12,56,46,10,46
AaB,133,5,8,13,9,38,40,-2,37
Sonderjyske,133,6,8,6,10,28,29,-1,30
AC Horsens,133,7,5,15,10,35,53,-18,30
Randers FC,133,8,5,7,12,23,39,-16,22
Silkeborg IF,133,9,6,3,13,26,44,-18,21
Lyngby,133,10,3,10,11,26,44,-18,19
AGF Aarhus,133,11,4,6,12,16,37,-21,18
Brondby,134,1,21,6,3,75,33,42,69
FC Midtjylla,134,2,20,4,6,65,39,26,64
Copenhagen,134,3,15,4,11,61,47,14,49
FC Nords,134,4,13,6,11,78,61,17,45
AaB,134,5,8,11,11,38,45,-7,35
AC Horsens,134,6,7,13,10,37,55,-18,34
Sonderjyske,134,7,8,6,10,28,29,-1,30
Lyngby,134,8,4,9,11,27,44,-17,21
Randers FC,134,9,5,6,13,23,40,-17,21
Silkeborg IF,134,10,6,3,13,27,45,-18,21
AGF Aarhus,134,11,4,6,12,17,38,-21,18
Brondby,135,1,22,5,3,69,29,40,71
FC Midtjylla,135,2,19,5,6,66,41,25,62
FC Nords,135,3,14,8,8,77,54,23,50
Copenhagen,135,4,13,6,11,54,43,11,45
AC Horsens,135,5,7,12,11,37,55,-18,33
AaB,135,6,6,14,10,37,44,-7,32
Sonderjyske,135,7,8,6,10,28,29,-1,30
Lyngby,135,8,4,9,11,27,44,-17,21
Randers FC,135,9,5,6,13,23,40,-17,21
Silkeborg IF,135,10,5,4,13,27,46,-19,19
AGF Aarhus,135,11,4,7,11,18,38,-20,19
Brondby,136,1,22,5,3,74,31,43,71
FC Midtjylla,136,2,18,6,6,64,43,21,60
FC Nords,136,3,15,8,7,78,51,27,53
Copenhagen,136,4,15,4,11,56,42,14,49
AaB,136,5,7,12,11,36,45,-9,33
Sonderjyske,136,6,8,6,10,28,29,-1,30
AC Horsens,136,7,5,13,12,31,53,-22,28
Lyngby,136,8,4,9,11,27,44,-17,21
Randers FC,136,9,5,6,13,23,40,-17,21
AGF Aarhus,136,10,5,6,11,19,37,-18,21
Silkeborg IF,136,11,5,3,14,26,47,-21,18
Brondby,137,1,20,7,3,72,34,38,67
FC Midtjylla,137,2,20,5,5,65,38,27,65
FC Nords,137,3,14,9,7,75,51,24,51
Copenhagen,137,4,13,6,11,60,45,15,45
AC Horsens,137,5,6,14,10,34,51,-17,32
AaB,137,6,6,13,11,34,47,-13,31
Sonderjyske,137,7,8,6,10,28,29,-1,30
Lyngby,137,8,4,9,11,28,45,-17,21
Randers FC,137,9,5,6,13,24,41,-17,21
Silkeborg IF,137,10,6,3,13,26,44,-18,21
AGF Aarhus,137,11,4,6,12,16,37,-21,18
Brondby,138,1,23,5,2,73,26,47,74
FC Midtjylla,138,2,20,5,5,68,39,29,65
FC Nords,138,3,14,6,10,76,52,24,48
Copenhagen,138,4,14,4,12,56,48,8,46
AC Horsens,138,5,7,12,11,35,59,-24,33
Sonderjyske,138,6,8,6,10,28,29,-1,30
AaB,138,7,6,12,12,33,43,-10,30
Lyngby,138,8,4,9,11,28,44,-16,21
Silkeborg IF,138,9,6,3,13,28,45,-17,21
Randers FC,138,10,5,6,13,23,41,-18,21
AGF Aarhus,138,11,4,6,12,17,39,-22,18
Brondby,139,1,20,7,3,73,34,39,67
FC Midtjylla,139,2,20,5,5,68,40,28,65
FC Nords,139,3,14,6,10,72,52,20,48
Copenhagen,139,4,13,6,11,58,46,12,45
AaB,139,5,8,13,9,38,43,-5,37
AC Horsens,139,6,6,13,11,33,53,-20,31
Sonderjyske,139,7,8,6,10,28,29,-1,30
Lyngby,139,8,4,9,11,30,46,-16,21
Randers FC,139,9,5,6,13,25,43,-18,21
AGF Aarhus,139,10,5,6,11,20,39,-19,21
Silkeborg IF,139,11,5,3,14,28,48,-20,18
FC Midtjylla,140,1,20,6,4,74,40,34,66
Brondby,140,2,19,8,3,70,36,34,65
FC Nords,140,3,14,7,9,74,53,21,49
Copenhagen,140,4,14,5,11,60,49,11,47
AC Horsens,140,5,7,14,9,36,50,-14,35
Sonderjyske,140,6,8,6,10,28,29,-1,30
AaB,140,7,6,12,12,39,51,-12,30
Lyngby,140,8,4,9,11,30,44,-14,21
Silkeborg IF,140,9,6,3,13,29,45,-16,21
Randers FC,140,10,5,6,13,23,43,-20,21
AGF Aarhus,140,11,4,6,12,17,40,-23,18
FC Midtjylla,141,1,22,4,4,64,34,30,70
Brondby,141,2,20,6,4,69,32,37,66
FC Nords,141,3,14,7,9,73,52,21,49
Copenhagen,141,4,13,5,12,57,45,12,44
AaB,141,5,8,13,9,38,41,-3,37
Sonderjyske,141,6,8,6,10,28,29,-1,30
AC Horsens,141,7,5,13,12,30,53,-23,28
Lyngby,141,8,4,9,11,28,44,-16,21
Silkeborg IF,141,9,6,3,13,28,45,-17,21
Randers FC,141,10,5,6,13,23,41,-18,21
AGF Aarhus,141,11,4,6,12,17,39,-22,18
Brondby,142,1,21,7,2,72,31,41,70
FC Midtjylla,142,2,20,4,6,62,39,23,64
Copenhagen,142,3,15,5,10,60,42,18,50
FC Nords,142,4,13,6,11,71,57,14,45
AC Horsens,142,5,7,13,10,38,52,-14,34
AaB,142,6,7,11,12,36,44,-8,32
Sonderjyske,142,7,8,6,10,28,29,-1,30
Randers FC,142,8,5,7,12,24,40,-16,22
Lyngby,142,9,3,10,11,27,45,-18,19
Silkeborg IF,142,10,5,4,13,26,45,-19,19
AGF Aarhus,142,11,4,7,11,17,37,-20,19
Brondby,143,1,20,7,3,70,32,38,67
FC Midtjylla,143,2,19,5,6,61,35,26,62
FC Nords,143,3,14,9,7,71,46,25,51
Copenhagen,143,4,14,5,11,57,46,11,47
AaB,143,5,7,14,9,36,40,-4,35
Sonderjyske,143,6,8,6,10,28,29,-1,30
AC Horsens,143,7,5,14,11,32,54,-22,29
Randers FC,143,8,6,6,12,26,40,-14,24
Silkeborg IF,143,9,6,3,13,27,45,-18,21
Lyngby,143,10,3,9,12,27,47,-20,18
AGF Aarhus,143,11,4,6,12,17,38,-21,18
Brondby,144,1,21,5,4,70,33,37,68
FC Midtjylla,144,2,20,5,5,71,42,29,65
Copenhagen,144,3,15,5,10,58,46,12,50
FC Nords,144,4,12,6,12,73,60,13,42
AaB,144,5,8,12,10,41,43,-2,36
AC Horsens,144,6,7,13,10,34,49,-15,34
Sonderjyske,144,7,8,6,10,28,29,-1,30
Randers FC,144,8,5,7,12,24,40,-16,22
Silkeborg IF,144,9,6,3,13,28,44,-16,21
Lyngby,144,10,3,10,11,27,45,-18,19
AGF Aarhus,144,11,4,6,12,16,39,-23,18
Brondby,145,1,21,7,2,70,31,39,70
FC Midtjylla,145,2,19,4,7,68,44,24,61
FC Nords,145,3,14,7,9,78,49,29,49
Copenhagen,145,4,14,7,9,58,42,16,49
AaB,145,5,8,11,11,37,42,-5,35
Sonderjyske,145,6,8,6,10,28,29,-1,30
AC Horsens,145,7,5,14,11,35,64,-29,29
Randers FC,145,8,5,7,12,24,40,-16,22
Silkeborg IF,145,9,6,3,13,26,44,-18,21
Lyngby,145,10,3,10,11,27,45,-18,19
AGF Aarhus,145,11,4,6,12,16,37,-21,18
Brondby,146,1,23,5,2,77,31,46,74
FC Midtjylla,146,2,18,5,7,61,41,20,59
FC Nords,146,3,15,6,9,75,51,24,51
Copenhagen,146,4,12,6,12,52,45,7,42
AC Horsens,146,5,8,12,10,36,51,-15,36
AaB,146,6,7,12,11,39,47,-8,33
Sonderjyske,146,7,8,6,10,28,29,-1,30
Lyngby,146,8,4,9,11,30,45,-15,21
Silkeborg IF,146,9,6,3,13,26,44,-18,21
Randers FC,146,10,5,6,13,24,43,-19,21
AGF Aarhus,146,11,4,6,12,16,37,-21,18
Brondby,147,1,21,6,3,73,33,40,69
FC Midtjylla,147,2,19,6,5,67,39,28,63
FC Nords,147,3,15,6,9,73,51,22,51
Copenhagen,147,4,12,5,13,54,48,6,41
AaB,147,5,7,14,9,39,43,-4,35
AC Horsens,147,6,7,13,10,38,56,-18,34
Sonderjyske,147,7,8,6,10,28,29,-1,30
Lyngby,147,8,4,9,11,27,44,-17,21
Randers FC,147,9,5,6,13,23,40,-17,21
Silkeborg IF,147,10,5,4,13,26,45,-19,19
AGF Aarhus,147,11,4,7,11,17,37,-20,19
Brondby,148,1,22,6,2,73,31,42,72
FC Midtjylla,148,2,19,6,5,66,39,27,63
Copenhagen,148,3,15,4,11,58,43,15,49
FC Nords,148,4,13,8,9,69,51,18,47
AaB,148,5,7,12,11,39,47,-8,33
Sonderjyske,148,6,8,6,10,28,29,-1,30
AC Horsens,148,7,5,14,11,33,53,-20,29
Randers FC,148,8,6,6,12,25,39,-14,24
AGF Aarhus,148,9,5,6,11,19,36,-17,21
Lyngby,148,10,3,9,12,26,46,-20,18
Silkeborg IF,148,11,5,3,14,25,47,-22,18
Brondby,149,1,21,5,4,71,35,36,68
FC Midtjylla,149,2,19,5,6,65,42,23,62
FC Nords,149,3,16,7,7,77,46,31,55
Copenhagen,149,4,14,5,11,58,43,15,47
AaB,149,5,6,14,10,34,41,-7,32
Sonderjyske,149,6,8,6,10,28,29,-1,30
AC Horsens,149,7,6,12,12,33,57,-24,30
Randers FC,149,8,5,7,12,24,40,-16,22
Silkeborg IF,149,9,6,3,13,26,44,-18,21
Lyngby,149,10,3,10,11,27,45,-18,19
AGF Aarhus,149,11,4,6,12,16,37,-21,18
Brondby,150,1,19,9,2,72,36,36,66
FC Midtjylla,150,2,19,5,6,67,40,27,62
FC Nords,150,3,15,7,8,78,53,25,52
Copenhagen,150,4,13,6,11,55,48,7,45
AC Horsens,150,5,7,14,9,40,53,-13,35
AaB,150,6,7,11,12,35,43,-8,32
Sonderjyske,150,7,8,6,10,28,29,-1,30
Randers FC,150,8,5,7,12,24,40,-16,22
Lyngby,150,9,3,10,11,27,45,-18,19
Silkeborg IF,150,10,5,4,13,25,44,-19,19
AGF Aarhus,150,11,4,7,11,16,36,-20,19
Brondby,151,1,19,8,3,72,36,36,65
FC Midtjylla,151,2,20,5,5,72,44,28,65
FC Nords,151,3,12,9,9,73,55,18,45
Copenhagen,151,4,13,6,11,59,48,11,45
AC Horsens,151,5,9,12,9,38,49,-11,39
AaB,151,6,6,14,10,35,43,-8,32
Sonderjyske,151,7,8,6,10,28,29,-1,30
Randers FC,151,8,6,6,12,25,40,-15,24
Silkeborg IF,151,9,6,3,13,27,45,-18,21
Lyngby,151,10,3,9,12,27,46,-19,18
AGF Aarhus,151,11,4,6,12,17,38,-21,18
FC Midtjylla,152,1,21,4,5,71,37,34,67
Brondby,152,2,19,8,3,70,35,35,65
Copenhagen,152,3,16,4,10,62,44,18,52
FC Nords,152,4,12,8,10,68,53,15,44
AaB,152,5,7,13,10,37,45,-8,34
AC Horsens,152,6,6,13,11,32,52,-20,31
Sonderjyske,152,7,8,6,10,28,29,-1,30
Randers FC,152,8,5,7,12,24,40,-16,22
Silkeborg IF,152,9,6,3,13,27,45,-18,21
Lyngby,152,10,3,10,11,27,45,-18,19
AGF Aarhus,152,11,4,6,12,17,38,-21,18
Brondby,153,1,22,6,2,73,27,46,72
FC Midtjylla,153,2,20,4,6,66,39,27,64
FC Nords,153,3,13,8,9,70,53,17,47
Copenhagen,153,4,12,5,13,56,50,6,41
AaB,153,5,8,13,9,38,42,-4,37
AC Horsens,153,6,7,12,11,37,55,-18,33
Sonderjyske,153,7,8,6,10,28,29,-1,30
Randers FC,153,8,5,7,12,24,40,-16,22
Silkeborg IF,153,9,6,3,13,27,45,-18,21
Lyngby,153,10,3,10,11,27,45,-18,19
AGF Aarhus,153,11,4,6,12,17,38,-21,18
Brondby,154,1,21,6,3,72,34,38,69
FC Midtjylla,154,2,19,4,7,60,39,21,61
FC Nords,154,3,14,8,8,78,52,26,50
Copenhagen,154,4,14,5,11,55,45,10,47
AaB,154,5,7,12,11,40,47,-7,33
AC Horsens,154,6,6,15,9,38,52,-14,33
Sonderjyske,154,7,8,6,10,28,29,-1,30
Randers FC,154,8,6,6,12,24,39,-15,24
Silkeborg IF,154,9,6,3,13,26,44,-18,21
Lyngby,154,10,3,9,12,26,45,-19,18
AGF Aarhus,154,11,4,6,12,16,37,-21,18
Brondby,155,1,22,5,3,77,33,44,71
FC Midtjylla,155,2,20,5,5,67,39,28,65
FC Nords,155,3,14,6,10,68,48,20,48
Copenhagen,155,4,14,5,11,59,43,16,47
AC Horsens,155,5,7,12,11,35,55,-20,33
AaB,155,6,7,11,12,36,50,-14,32
Sonderjyske,155,7,8,6,10,28,29,-1,30
Randers FC,155,8,6,6,12,25,40,-15,24
Silkeborg IF,155,9,6,3,13,27,44,-17,21
Lyngby,155,10,3,9,12,27,46,-19,18
AGF Aarhus,155,11,4,6,12,16,38,-22,18
Brondby,156,1,21,5,4,70,35,35,68
FC Midtjylla,156,2,20,4,6,65,38,27,64
FC Nords,156,3,15,6,9,72,49,23,51
Copenhagen,156,4,15,4,11,57,40,17,49
AC Horsens,156,5,7,12,11,35,55,-20,33
AaB,156,6,7,11,12,37,45,-8,32
Sonderjyske,156,7,8,6,10,28,29,-1,30
Randers FC,156,8,5,7,12,25,41,-16,22
AGF Aarhus,156,9,5,6,11,17,36,-19,21
Lyngby,156,10,3,10,11,28,46,-18,19
Silkeborg IF,156,11,5,3,14,25,45,-20,18
Brondby,157,1,21,6,3,75,34,41,69
FC Midtjylla,157,2,19,5,6,67,41,26,62
Copenhagen,157,3,14,6,10,59,45,14,48
FC Nords,157,4,12,7,11,72,57,15,43
AaB,157,5,9,12,9,43,45,-2,39
AC Horsens,157,6,7,12,11,37,57,-20,33
Sonderjyske,157,7,8,6,10,28,29,-1,30
Randers FC,157,8,6,6,12,24,39,-15,24
Silkeborg IF,157,9,5,4,13,25,44,-19,19
AGF Aarhus,157,10,4,7,11,16,36,-20,19
Lyngby,157,11,3,9,12,26,45,-19,18
Brondby,158,1,21,5,4,72,34,38,68
FC Midtjylla,158,2,18,6,6,66,41,25,60
Copenhagen,158,3,14,6,10,55,40,15,48
FC Nords,158,4,13,7,10,67,55,12,46
AaB,158,5,9,11,10,41,44,-3,38
AC Horsens,158,6,7,13,10,40,53,-13,34
Sonderjyske,158,7,8,6,10,28,29,-1,30
Lyngby,158,8,4,9,11,28,44,-16,21
Silkeborg IF,158,9,6,3,13,29,46,-17,21
Randers FC,158,10,5,6,13,23,41,-18,21
AGF Aarhus,158,11,4,6,12,18,40,-22,18
Brondby,159,1,20,6,4,71,34,37,66
FC Midtjylla,159,2,19,5,6,63,36,27,62
Copenhagen,159,3,15,5,10,57,42,15,50
FC Nords,159,4,14,6,10,79,56,23,48
AaB,159,5,9,12,9,37,39,-2,39
Sonderjyske,159,6,8,6,10,28,29,-1,30
AC Horsens,159,7,6,12,12,34,60,-26,30
Randers FC,159,8,6,6,12,24,39,-15,24
AGF Aarhus,159,9,5,6,11,18,36,-18,21
Lyngby,159,10,3,9,12,26,45,-19,18
Silkeborg IF,159,11,5,3,14,25,46,-21,18
Brondby,160,1,20,7,3,71,34,37,67
FC Midtjylla,160,2,19,5,6,62,37,25,62
FC Nords,160,3,14,7,9,71,51,20,49
Copenhagen,160,4,15,4,11,63,50,13,49
AC Horsens,160,5,7,15,8,39,50,-11,36
Sonderjyske,160,6,8,6,10,28,29,-1,30
AaB,160,7,6,12,12,39,49,-10,30
Randers FC,160,8,6,6,12,26,39,-13,24
AGF Aarhus,160,9,5,6,11,19,37,-18,21
Lyngby,160,10,3,9,12,26,47,-21,18
Silkeborg IF,160,10,5,3,14,26,47,-21,18
Brondby,161,1,21,5,4,70,34,36,68
FC Midtjylla,161,2,20,4,6,64,37,27,64
FC Nords,161,3,15,6,9,73,47,26,51
Copenhagen,161,4,15,4,11,58,42,16,49
AaB,161,5,8,11,11,38,45,-7,35
Sonderjyske,161,6,8,6,10,28,29,-1,30
AC Horsens,161,7,6,12,12,34,58,-24,30
Lyngby,161,8,4,9,11,29,45,-16,21
Randers FC,161,9,5,6,13,24,42,-18,21
Silkeborg IF,161,10,5,4,13,25,44,-19,19
AGF Aarhus,161,11,4,7,11,16,36,-20,19
Brondby,162,1,21,5,4,72,35,37,68
FC Midtjylla,162,2,21,5,4,69,35,34,68
Copenhagen,162,3,15,5,10,57,43,14,50
FC Nords,162,4,14,6,10,73,55,18,48
AaB,162,5,7,12,11,34,39,-5,33
Sonderjyske,162,6,8,6,10,28,29,-1,30
AC Horsens,162,7,5,13,12,32,56,-24,28
Randers FC,162,8,6,6,12,24,39,-15,24
Silkeborg IF,162,9,5,4,13,26,45,-19,19
AGF Aarhus,162,10,4,7,11,17,37,-20,19
Lyngby,162,11,3,9,12,26,45,-19,18
Brondby,163,1,22,5,3,75,32,43,71
FC Midtjylla,163,2,19,5,6,65,43,22,62
FC Nords,163,3,15,7,8,77,50,27,52
Copenhagen,163,4,14,4,12,61,48,13,46
AC Horsens,163,5,7,12,11,36,54,-18,33
AaB,163,6,7,11,12,36,49,-13,32
Sonderjyske,163,7,8,6,10,28,29,-1,30
Randers FC,163,8,6,6,12,25,40,-15,24
Silkeborg IF,163,9,5,4,13,28,47,-19,19
AGF Aarhus,163,10,4,7,11,19,39,-20,19
Lyngby,163,11,3,9,12,27,46,-19,18
Brondby,164,1,22,6,2,72,32,40,72
FC Midtjylla,164,2,19,5,6,67,41,26,62
FC Nords,164,3,16,6,8,76,51,25,54
Copenhagen,164,4,12,5,13,54,48,6,41
AaB,164,5,7,12,11,34,41,-7,33
AC Horsens,164,6,7,12,11,41,57,-16,33
Sonderjyske,164,7,8,6,10,28,29,-1,30
Lyngby,164,8,4,9,11,28,45,-17,21
Randers FC,164,9,5,6,13,24,41,-17,21
AGF Aarhus,164,10,5,6,11,18,36,-18,21
Silkeborg IF,164,11,5,3,14,25,46,-21,18
FC Midtjylla,165,1,20,5,5,65,37,28,65
Brondby,165,2,19,7,4,66,32,34,64
FC Nords,165,3,16,6,8,74,48,26,54
Copenhagen,165,4,14,6,10,57,43,14,48
AaB,165,5,7,12,11,38,44,-6,33
Sonderjyske,165,6,8,6,10,28,29,-1,30
AC Horsens,165,7,5,14,11,35,57,-22,29
Lyngby,165,8,4,9,11,28,45,-17,21
Silkeborg IF,165,9,6,3,13,27,44,-17,21
Randers FC,165,10,5,6,13,24,41,-17,21
AGF Aarhus,165,11,4,6,12,16,38,-22,18
FC Midtjylla,166,1,21,5,4,72,35,37,68
Brondby,166,2,18,7,5,68,38,30,61
FC Nords,166,3,14,8,8,73,51,22,50
Copenhagen,166,4,15,4,11,59,46,13,49
AaB,166,5,7,13,10,36,43,-7,34
AC Horsens,166,6,6,13,11,32,53,-21,31
Sonderjyske,166,7,8,6,10,28,29,-1,30
Lyngby,166,8,4,9,11,27,44,-17,21
Randers FC,166,9,5,6,13,23,40,-17,21
Silkeborg IF,166,10,6,3,13,26,44,-18,21
AGF Aarhus,166,11,4,6,12,16,37,-21,18
Brondby,167,1,21,7,2,76,34,42,70
FC Midtjylla,167,2,20,4,6,66,42,24,64
Copenhagen,167,3,15,5,10,62,45,17,50
FC Nords,167,4,13,6,11,73,59,14,45
AaB,167,5,8,13,9,44,42,2,37
Sonderjyske,167,6,8,6,10,28,29,-1,30
AC Horsens,167,7,5,13,12,33,58,-25,28
Lyngby,167,8,4,9,11,27,44,-17,21
Randers FC,167,9,5,6,13,23,40,-17,21
Silkeborg IF,167,10,6,3,13,27,45,-18,21
AGF Aarhus,167,11,4,6,12,17,38,-21,18
FC Midtjylla,168,1,21,4,5,67,37,30,67
Brondby,168,2,20,6,4,71,32,39,66
FC Nords,168,3,15,7,8,75,50,25,52
Copenhagen,168,4,13,5,12,54,47,7,44
AaB,168,5,7,12,11,34,45,-11,33
AC Horsens,168,6,7,12,11,35,51,-16,33
Sonderjyske,168,7,8,6,10,28,29,-1,30
Randers FC,168,8,6,6,12,25,40,-15,24
Silkeborg IF,168,9,5,4,13,25,44,-19,19
AGF Aarhus,168,10,4,7,11,16,36,-20,19
Lyngby,168,11,3,9,12,27,46,-19,18
Brondby,169,1,21,5,4,71,33,38,68
FC Midtjylla,169,2,20,4,6,63,39,24,64
FC Nords,169,3,16,6,8,76,50,26,54
Copenhagen,169,4,13,6,11,57,45,12,45
AaB,169,5,8,12,10,35,40,-5,36
Sonderjyske,169,6,8,6,10,28,29,-1,30
AC Horsens,169,7,5,13,12,32,53,-21,28
Lyngby,169,8,4,9,11,29,44,-15,21
Silkeborg IF,169,9,6,3,13,27,45,-18,21
Randers FC,169,10,5,6,13,23,42,-19,21
AGF Aarhus,169,11,4,6,12,17,38,-21,18
Brondby,170,1,20,7,3,69,31,38,67
FC Midtjylla,170,2,19,5,6,65,42,23,62
FC Nords,170,3,14,8,8,71,48,23,50
Copenhagen,170,4,14,6,10,60,45,15,48
AaB,170,5,8,12,10,37,42,-5,36
Sonderjyske,170,6,8,6,10,28,29,-1,30
AC Horsens,170,7,5,14,11,33,53,-20,29
Randers FC,170,8,5,7,12,25,41,-16,22
Lyngby,170,9,3,10,11,28,46,-18,19
Silkeborg IF,170,10,5,4,13,26,45,-19,19
AGF Aarhus,170,11,4,7,11,17,37,-20,19
FC Midtjylla,171,1,21,5,4,65,34,31,68
Brondby,171,2,20,7,3,68,32,36,67
FC Nords,171,3,14,8,8,73,50,23,50
Copenhagen,171,4,12,6,12,55,47,8,42
AaB,171,5,7,12,11,37,44,-7,33
AC Horsens,171,6,6,14,10,35,52,-17,32
Sonderjyske,171,7,8,6,10,28,29,-1,30
Randers FC,171,8,6,6,12,26,39,-13,24
Silkeborg IF,171,9,6,3,13,28,46,-18,21
Lyngby,171,10,3,9,12,26,47,-21,18
AGF Aarhus,171,11,4,6,12,18,39,-21,18
Brondby,172,1,20,6,4,68,33,35,66
FC Midtjylla,172,2,20,6,4,69,37,32,66
FC Nords,172,3,14,8,8,74,48,26,50
Copenhagen,172,4,12,5,13,56,48,8,41
AC Horsens,172,5,8,12,10,34,52,-18,36
AaB,172,6,8,11,11,35,44,-9,35
Sonderjyske,172,7,8,6,10,28,29,-1,30
Lyngby,172,8,4,9,11,30,47,-17,21
Randers FC,172,9,5,6,13,26,43,-17,21
AGF Aarhus,172,10,5,6,11,18,37,-19,21
Silkeborg IF,172,11,5,3,14,26,46,-20,18
Brondby,173,1,20,6,4,66,35,31,66
FC Midtjylla,173,2,20,5,5,67,35,32,65
FC Nords,173,3,15,7,8,75,51,24,52
Copenhagen,173,4,14,5,11,60,43,17,47
AC Horsens,173,5,7,12,11,36,53,-17,33
AaB,173,6,7,11,12,34,47,-13,32
Sonderjyske,173,7,8,6,10,28,29,-1,30
Lyngby,173,8,4,9,11,29,44,-15,21
Silkeborg IF,173,9,6,3,13,28,46,-18,21
Randers FC,173,10,5,6,13,23,42,-19,21
AGF Aarhus,173,11,4,6,12,18,39,-21,18
FC Midtjylla,174,1,19,6,5,65,38,27,63
Brondby,174,2,19,5,6,68,39,29,62
FC Nords,174,3,15,7,8,77,51,26,52
Copenhagen,174,4,14,4,12,57,47,10,46
AaB,174,5,9,12,9,40,40,0,39
AC Horsens,174,6,6,14,10,34,52,-18,32
Sonderjyske,174,7,8,6,10,28,29,-1,30
Lyngby,174,8,4,9,11,28,45,-17,21
Randers FC,174,9,5,6,13,24,41,-17,21
Silkeborg IF,174,10,6,3,13,26,44,-18,21
AGF Aarhus,174,11,4,6,12,16,37,-21,18
Brondby,175,1,21,6,3,73,33,40,69
FC Midtjylla,175,2,17,6,7,62,43,19,57
FC Nords,175,3,16,6,8,74,50,24,54
Copenhagen,175,4,15,4,11,60,42,18,49
AaB,175,5,8,13,9,41,44,-3,37
Sonderjyske,175,6,8,6,10,28,29,-1,30
AC Horsens,175,7,5,13,12,35,59,-24,28
Lyngby,175,8,4,9,11,29,45,-16,21
Silkeborg IF,175,8,6,3,13,29,45,-16,21
Randers FC,175,10,5,6,13,24,42,-18,21
AGF Aarhus,175,11,4,6,12,17,40,-23,18
Brondby,176,1,22,6,2,77,33,44,72
FC Midtjylla,176,2,20,4,6,69,41,28,64
FC Nords,176,3,15,7,8,72,49,23,52
Copenhagen,176,4,13,6,11,57,46,11,45
AaB,176,5,7,12,11,38,45,-7,33
Sonderjyske,176,6,8,6,10,28,29,-1,30
AC Horsens,176,7,5,13,12,32,57,-25,28
Randers FC,176,8,5,7,12,25,41,-16,22
AGF Aarhus,176,9,5,6,11,19,37,-18,21
Lyngby,176,10,3,10,11,28,46,-18,19
Silkeborg IF,176,11,5,3,14,26,47,-21,18
Brondby,177,1,21,7,2,75,30,45,70
FC Midtjylla,177,2,20,4,6,66,40,26,64
FC Nords,177,3,14,6,10,69,53,16,48
Copenhagen,177,4,14,4,12,59,46,13,46
AaB,177,5,8,12,10,36,42,-6,36
AC Horsens,177,6,6,13,11,33,53,-20,31
Sonderjyske,177,7,8,6,10,28,29,-1,30
Lyngby,177,8,4,9,11,28,44,-16,21
Randers FC,177,9,5,6,13,23,41,-18,21
AGF Aarhus,177,10,5,6,11,17,36,-19,21
Silkeborg IF,177,11,5,3,14,25,45,-20,18
Brondby,178,1,19,7,4,66,33,33,64
FC Midtjylla,178,2,19,5,6,63,38,25,62
Copenhagen,178,3,15,6,9,60,44,16,51
FC Nords,178,4,14,7,9,70,49,21,49
AaB,178,5,6,15,9,34,39,-5,33
AC Horsens,178,6,6,14,10,31,47,-16,32
Sonderjyske,178,7,8,6,10,28,29,-1,30
Randers FC,178,8,6,6,12,24,39,-15,24
Silkeborg IF,178,9,6,3,13,27,45,-18,21
Lyngby,178,10,3,9,12,26,45,-19,18
AGF Aarhus,178,11,4,6,12,17,38,-21,18
Brondby,179,1,20,6,4,69,30,39,66
FC Midtjylla,179,2,20,4,6,62,38,24,64
FC Nords,179,3,15,8,7,74,47,27,53
Copenhagen,179,4,13,6,11,54,44,10,45
AaB,179,5,7,12,11,35,42,-7,33
AC Horsens,179,6,6,14,10,31,50,-19,32
Sonderjyske,179,7,8,6,10,28,29,-1,30
Lyngby,179,8,4,9,11,27,44,-17,21
Randers FC,179,9,5,6,13,23,40,-17,21
Silkeborg IF,179,10,6,3,13,27,45,-18,21
AGF Aarhus,179,11,4,6,12,17,38,-21,18
Brondby,180,1,19,6,5,68,37,31,63
FC Midtjylla,180,2,18,6,6,65,39,26,60
Copenhagen,180,3,16,4,10,59,40,19,52
FC Nords,180,4,13,8,9,73,58,15,47
AC Horsens,180,5,8,13,9,37,49,-12,37
AaB,180,6,7,13,10,37,42,-5,34
Sonderjyske,180,7,8,6,10,28,29,-1,30
Randers FC,180,8,5,7,12,24,40,-16,22
Lyngby,180,9,3,10,11,27,45,-18,19
Silkeborg IF,180,10,5,4,13,25,44,-19,19
AGF Aarhus,180,11,4,7,11,16,36,-20,19
Brondby,181,1,22,5,3,71,29,42,71
FC Midtjylla,181,2,19,5,6,67,42,25,62
Copenhagen,181,3,15,4,11,61,47,14,49
FC Nords,181,4,13,7,10,74,57,17,46
AaB,181,5,8,11,11,41,47,-6,35
AC Horsens,181,6,7,12,11,34,52,-18,33
Sonderjyske,181,7,8,6,10,28,29,-1,30
Randers FC,181,8,5,7,12,25,41,-16,22
Silkeborg IF,181,9,6,3,13,27,44,-17,21
Lyngby,181,10,3,10,11,28,46,-18,19
AGF Aarhus,181,11,4,6,12,16,38,-22,18
Brondby,182,1,21,5,4,65,30,35,68
FC Midtjylla,182,2,19,5,6,68,41,27,62
FC Nords,182,3,17,6,7,78,50,28,57
Copenhagen,182,4,13,5,12,56,44,12,44
AaB,182,5,8,11,11,36,44,-8,35
Sonderjyske,182,6,8,6,10,28,29,-1,30
AC Horsens,182,7,5,14,11,30,50,-20,29
Randers FC,182,8,6,6,12,25,39,-14,24
Silkeborg IF,182,9,6,3,13,27,44,-17,21
Lyngby,182,10,3,9,12,26,46,-20,18
AGF Aarhus,182,11,4,6,12,16,38,-22,18
Brondby,183,1,21,7,2,73,32,41,70
FC Midtjylla,183,2,21,5,4,68,38,30,68
FC Nords,183,3,15,6,9,73,51,22,51
Copenhagen,183,4,13,4,13,55,48,7,43
AaB,183,5,7,12,11,34,43,-9,33
Sonderjyske,183,6,8,6,10,28,29,-1,30
AC Horsens,183,7,6,12,12,35,52,-17,30
Randers FC,183,8,6,6,12,25,40,-15,24
Silkeborg IF,183,9,6,3,13,27,45,-18,21
Lyngby,183,10,3,9,12,27,46,-19,18
AGF Aarhus,183,11,4,6,12,17,38,-21,18
Brondby,184,1,20,7,3,72,33,39,67
FC Midtjylla,184,2,19,6,5,69,40,29,63
FC Nords,184,3,15,6,9,77,54,23,51
Copenhagen,184,4,14,6,10,59,45,14,48
AaB,184,5,7,13,10,37,44,-7,34
Sonderjyske,184,6,8,6,10,28,29,-1,30
AC Horsens,184,7,6,12,12,32,56,-24,30
Lyngby,184,8,4,9,11,28,45,-17,21
Randers FC,184,9,5,6,13,24,41,-17,21
Silkeborg IF,184,10,5,4,13,27,46,-19,19
AGF Aarhus,184,11,4,7,11,18,38,-20,19
Brondby,185,1,21,7,2,76,34,42,70
FC Midtjylla,185,2,19,5,6,65,39,26,62
FC Nords,185,3,15,6,9,75,54,21,51
Copenhagen,185,4,13,6,11,57,46,11,45
AC Horsens,185,5,7,13,10,39,54,-15,34
AaB,185,6,7,11,12,34,45,-11,32
Sonderjyske,185,7,8,6,10,28,29,-1,30
Randers FC,185,8,5,7,12,24,40,-16,22
AGF Aarhus,185,9,5,6,11,17,36,-19,21
Lyngby,185,10,3,10,11,27,45,-18,19
Silkeborg IF,185,11,5,3,14,25,45,-20,18
Brondby,186,1,22,5,3,69,29,40,71
FC Midtjylla,186,2,20,4,6,69,43,26,64
Copenhagen,186,3,14,5,11,58,42,16,47
FC Nords,186,4,13,7,10,73,56,17,46
AaB,186,5,7,13,10,39,46,-7,34
AC Horsens,186,6,6,14,10,31,49,-18,32
Sonderjyske,186,7,8,6,10,28,29,-1,30
Lyngby,186,8,4,9,11,28,44,-16,21
Silkeborg IF,186,9,6,3,13,27,45,-18,21
Randers FC,186,10,5,6,13,23,41,-18,21
AGF Aarhus,186,11,4,6,12,17,38,-21,18
FC Midtjylla,187,1,21,4,5,69,39,30,67
Brondby,187,2,20,6,4,69,35,34,66
FC Nords,187,3,15,7,8,74,51,23,52
Copenhagen,187,4,14,5,11,58,42,16,47
AaB,187,5,7,12,11,39,46,-7,33
Sonderjyske,187,6,8,6,10,28,29,-1,30
AC Horsens,187,7,6,12,12,32,54,-22,30
Randers FC,187,8,5,7,12,25,41,-16,22
AGF Aarhus,187,9,5,6,11,18,36,-18,21
Lyngby,187,10,3,10,11,28,46,-18,19
Silkeborg IF,187,11,5,3,14,25,46,-21,18
Brondby,188,1,19,7,4,71,35,36,64
FC Midtjylla,188,2,18,5,7,63,44,19,59
FC Nords,188,3,16,7,7,75,48,27,55
Copenhagen,188,4,13,6,11,56,45,11,45
AaB,188,5,7,14,9,35,40,-5,35
AC Horsens,188,6,6,15,9,36,50,-14,33
Sonderjyske,188,7,8,6,10,28,29,-1,30
Lyngby,188,8,4,9,11,28,44,-16,21
Randers FC,188,9,5,6,13,23,41,-18,21
AGF Aarhus,188,10,5,6,11,17,36,-19,21
Silkeborg IF,188,11,5,3,14,25,45,-20,18
Brondby,189,1,22,6,2,76,31,45,72
FC Midtjylla,189,2,19,5,6,63,37,26,62
FC Nords,189,3,14,7,9,72,50,22,49
Copenhagen,189,4,12,7,11,52,42,10,43
AC Horsens,189,5,6,15,9,35,49,-14,33
AaB,189,6,7,12,11,35,50,-15,33
Sonderjyske,189,7,8,6,10,28,29,-1,30
Randers FC,189,8,6,6,12,25,40,-15,24
Silkeborg IF,189,9,5,4,13,27,46,-19,19
AGF Aarhus,189,10,4,7,11,18,38,-20,19
Lyngby,189,11,3,9,12,27,46,-19,18
Brondby,190,1,20,6,4,66,33,33,66
FC Midtjylla,190,2,17,7,6,62,41,21,58
FC Nords,190,3,14,9,7,70,46,24,51
Copenhagen,190,4,15,5,10,58,41,17,50
AC Horsens,190,5,7,13,10,37,52,-15,34
AaB,190,6,7,12,11,36,42,-6,33
Sonderjyske,190,7,8,6,10,28,29,-1,30
Lyngby,190,8,4,9,11,29,45,-16,21
Silkeborg IF,190,9,6,3,13,26,44,-18,21
Randers FC,190,10,5,6,13,24,42,-18,21
AGF Aarhus,190,11,4,6,12,16,37,-21,18
Brondby,191,1,20,6,4,68,33,35,66
FC Midtjylla,191,2,20,4,6,68,41,27,64
FC Nords,191,3,15,7,8,76,53,23,52
Copenhagen,191,4,15,4,11,59,47,12,49
AC Horsens,191,5,7,12,11,36,51,-15,33
AaB,191,6,7,11,12,36,44,-8,32
Sonderjyske,191,7,8,6,10,28,29,-1,30
Lyngby,191,8,4,9,11,27,44,-17,21
Randers FC,191,9,5,6,13,23,40,-17,21
AGF Aarhus,191,10,5,6,11,18,37,-19,21
Silkeborg IF,191,11,5,3,14,26,46,-20,18
Brondby,192,1,21,6,3,69,27,42,69
FC Midtjylla,192,2,20,5,5,63,36,27,65
Copenhagen,192,3,15,5,10,58,42,16,50
FC Nords,192,4,12,7,11,73,58,15,43
AC Horsens,192,5,7,13,10,34,50,-16,34
AaB,192,6,7,12,11,39,49,-10,33
Sonderjyske,192,7,8,6,10,28,29,-1,30
Randers FC,192,8,6,6,12,24,39,-15,24
Silkeborg IF,192,9,6,3,13,28,46,-18,21
Lyngby,192,10,3,9,12,26,45,-19,18
AGF Aarhus,192,11,4,6,12,18,39,-21,18
Brondby,193,1,21,6,3,66,29,37,69
FC Midtjylla,193,2,20,6,4,64,36,28,66
Copenhagen,193,3,13,7,10,58,45,13,46
FC Nords,193,4,12,7,11,66,50,16,43
AaB,193,5,8,12,10,38,42,-4,36
AC Horsens,193,6,5,16,9,33,49,-16,31
Sonderjyske,193,7,8,6,10,28,29,-1,30
Lyngby,193,8,4,9,11,28,45,-17,21
Silkeborg IF,193,9,6,3,13,27,44,-17,21
Randers FC,193,10,5,6,13,24,41,-17,21
AGF Aarhus,193,11,4,6,12,16,38,-22,18
Brondby,194,1,21,7,2,73,29,44,70
FC Midtjylla,194,2,21,4,5,69,42,27,67
FC Nords,194,3,14,6,10,77,60,17,48
Copenhagen,194,4,13,6,11,56,46,10,45
AC Horsens,194,5,7,12,11,39,56,-17,33
AaB,194,6,6,13,11,42,49,-7,31
Sonderjyske,194,7,8,6,10,28,29,-1,30
Randers FC,194,8,5,7,12,24,40,-16,22
AGF Aarhus,194,9,5,6,11,18,37,-19,21
Lyngby,194,10,3,10,11,27,45,-18,19
Silkeborg IF,194,11,5,3,14,26,46,-20,18
FC Midtjylla,195,1,19,6,5,65,37,28,63
Brondby,195,2,18,6,6,66,38,28,60
FC Nords,195,3,16,6,8,73,48,25,54
Copenhagen,195,4,14,6,10,57,41,16,48
AaB,195,5,8,11,11,37,45,-8,35
AC Horsens,195,6,7,13,10,36,51,-15,34
Sonderjyske,195,7,8,6,10,28,29,-1,30
Randers FC,195,8,6,6,12,25,40,-15,24
AGF Aarhus,195,9,5,6,11,18,37,-19,21
Lyngby,195,10,3,9,12,27,46,-19,18
Silkeborg IF,195,11,5,3,14,26,46,-20,18
Brondby,196,1,22,5,3,76,32,44,71
FC Midtjylla,196,2,21,4,5,67,38,29,67
FC Nords,196,3,15,6,9,70,48,22,51
Copenhagen,196,4,13,4,13,55,49,6,43
AaB,196,5,8,11,11,36,43,-7,35
Sonderjyske,196,6,8,6,10,28,29,-1,30
AC Horsens,196,7,6,12,12,33,53,-20,30
Lyngby,196,8,4,9,11,29,45,-16,21
Randers FC,196,9,5,6,13,24,42,-18,21
AGF Aarhus,196,10,5,6,11,18,37,-19,21
Silkeborg IF,196,11,5,3,14,26,46,-20,18
FC Midtjylla,197,1,21,5,4,69,37,32,68
Brondby,197,2,20,5,5,70,40,30,65
Copenhagen,197,3,15,4,11,59,45,14,49
FC Nords,197,4,12,7,11,71,56,15,43
AaB,197,5,8,11,11,39,43,-4,35
AC Horsens,197,6,7,14,9,36,49,-13,35
Sonderjyske,197,7,8,6,10,28,29,-1,30
Randers FC,197,8,6,6,12,24,39,-15,24
AGF Aarhus,197,9,5,6,11,17,36,-19,21
Lyngby,197,10,3,9,12,26,45,-19,18
Silkeborg IF,197,11,5,3,14,25,45,-20,18
Brondby,198,1,22,5,3,77,33,44,71
FC Midtjylla,198,2,20,4,6,66,44,22,64
FC Nords,198,3,15,6,9,74,49,25,51
Copenhagen,198,4,15,5,10,66,50,16,50
AaB,198,5,7,11,12,38,49,-11,32
Sonderjyske,198,6,8,6,10,28,29,-1,30
AC Horsens,198,7,5,13,12,34,56,-22,28
Lyngby,198,8,4,9,11,28,45,-17,21
Randers FC,198,9,5,6,13,24,41,-17,21
Silkeborg IF,198,10,6,3,13,27,45,-18,21
AGF Aarhus,198,11,4,6,12,17,38,-21,18
Brondby,199,1,20,7,3,70,31,39,67
FC Midtjylla,199,2,19,7,4,63,37,26,64
FC Nords,199,3,13,7,10,74,57,17,46
Copenhagen,199,4,13,4,13,62,51,11,43
AaB,199,5,8,13,9,38,42,-4,37
AC Horsens,199,6,8,12,10,39,54,-15,36
Sonderjyske,199,7,8,6,10,28,29,-1,30
Lyngby,199,8,4,9,11,29,45,-16,21
Randers FC,199,9,5,6,13,24,42,-18,21
Silkeborg IF,199,10,5,4,13,25,44,-19,19
AGF Aarhus,199,11,4,7,11,16,36,-20,19
Brondby,200,1,20,6,4,64,30,34,66
FC Midtjylla,200,2,20,4,6,62,37,25,64
Copenhagen,200,3,16,4,10,59,41,18,52
FC Nords,200,4,14,7,9,70,50,20,49
AC Horsens,200,5,7,12,11,35,51,-16,33
AaB,200,6,7,11,12,38,45,-7,32
Sonderjyske,200,7,8,6,10,28,29,-1,30
Lyngby,200,8,4,9,11,33,45,-12,21
Silkeborg IF,200,9,6,3,13,26,44,-18,21
Randers FC,200,10,5,6,13,24,46,-22,21
AGF Aarhus,200,11,4,6,12,16,37,-21,18
Brondby,201,1,22,5,3,76,29,47,71
FC Midtjylla,201,2,17,5,8,62,50,12,56
FC Nords,201,3,15,7,8,76,50,26,52
Copenhagen,201,4,13,6,11,54,43,11,45
AaB,201,5,9,11,10,40,44,-4,38
AC Horsens,201,6,7,12,11,35,53,-18,33
Sonderjyske,201,7,8,6,10,28,29,-1,30
Lyngby,201,8,4,9,11,27,44,-17,21
Silkeborg IF,201,8,6,3,13,27,44,-17,21
Randers FC,201,10,5,6,13,23,40,-17,21
AGF Aarhus,201,11,4,6,12,16,38,-22,18
Brondby,202,1,20,6,4,69,32,37,66
FC Midtjylla,202,2,18,6,6,67,41,26,60
FC Nords,202,3,13,7,10,69,55,14,46
Copenhagen,202,4,14,4,12,62,49,13,46
AaB,202,5,8,14,8,38,40,-2,38
AC Horsens,202,6,8,13,9,35,49,-14,37
Sonderjyske,202,7,8,6,10,28,29,-1,30
Lyngby,202,8,4,9,11,29,44,-15,21
Silkeborg IF,202,9,6,3,13,29,46,-17,21
Randers FC,202,10,5,6,13,23,42,-19,21
AGF Aarhus,202,11,4,6,12,18,40,-22,18
Brondby,203,1,20,6,4,69,35,34,66
FC Midtjylla,203,2,18,5,7,61,39,22,59
FC Nords,203,3,17,6,7,75,47,28,57
Copenhagen,203,4,15,5,10,59,41,18,50
AaB,203,5,6,13,11,35,42,-7,31
AC Horsens,203,6,6,13,11,33,54,-21,31
Sonderjyske,203,7,8,6,10,28,29,-1,30
Randers FC,203,8,6,6,12,26,40,-14,24
Silkeborg IF,203,9,6,3,13,27,45,-18,21
Lyngby,203,10,3,9,12,27,47,-20,18
AGF Aarhus,203,11,4,6,12,17,38,-21,18
Brondby,204,1,20,7,3,74,36,38,67
FC Midtjylla,204,2,20,5,5,64,37,27,65
FC Nords,204,3,14,6,10,76,56,20,48
Copenhagen,204,4,14,5,11,57,45,12,47
AaB,204,5,8,14,8,37,39,-2,38
Sonderjyske,204,6,8,6,10,28,29,-1,30
AC Horsens,204,7,5,13,12,31,52,-21,28
Randers FC,204,8,5,7,12,23,39,-16,22
Silkeborg IF,204,9,6,3,13,28,44,-16,21
Lyngby,204,10,3,10,11,26,44,-18,19
AGF Aarhus,204,11,4,6,12,16,39,-23,18
Brondby,205,1,21,6,3,70,30,40,69
FC Midtjylla,205,2,18,6,6,61,37,24,60
Copenhagen,205,3,14,5,11,59,48,11,47
FC Nords,205,4,12,7,11,65,51,14,43
AaB,205,5,8,13,9,34,40,-6,37
AC Horsens,205,6,8,13,9,38,47,-9,37
Sonderjyske,205,7,8,6,10,28,29,-1,30
Randers FC,205,8,6,6,12,25,40,-15,24
Silkeborg IF,205,9,5,4,13,26,45,-19,19
AGF Aarhus,205,10,4,7,11,17,37,-20,19
Lyngby,205,11,3,9,12,27,46,-19,18
Brondby,206,1,21,5,4,68,31,37,68
FC Midtjylla,206,2,19,5,6,66,40,26,62
FC Nords,206,3,15,6,9,77,51,26,51
Copenhagen,206,4,13,5,12,55,48,7,44
AC Horsens,206,5,9,12,9,36,51,-15,39
AaB,206,6,7,11,12,37,44,-7,32
Sonderjyske,206,7,8,6,10,28,29,-1,30
Lyngby,206,8,4,9,11,27,44,-17,21
Silkeborg IF,206,8,6,3,13,27,44,-17,21
Randers FC,206,10,5,6,13,23,40,-17,21
AGF Aarhus,206,11,4,6,12,16,38,-22,18
Brondby,207,1,23,5,2,74,30,44,74
FC Midtjylla,207,2,18,4,8,66,44,22,58
FC Nords,207,3,14,7,9,75,52,23,49
Copenhagen,207,4,14,5,11,59,46,13,47
AaB,207,5,9,11,10,39,44,-5,38
Sonderjyske,207,6,8,6,10,28,29,-1,30
AC Horsens,207,7,6,12,12,33,56,-23,30
Randers FC,207,8,6,6,12,25,40,-15,24
Silkeborg IF,207,9,6,3,13,28,45,-17,21
Lyngby,207,10,3,9,12,27,46,-19,18
AGF Aarhus,207,11,4,6,12,17,39,-22,18
Brondby,208,1,21,5,4,72,34,38,68
FC Midtjylla,208,2,21,4,5,73,43,30,67
FC Nords,208,3,14,7,9,77,56,21,49
Copenhagen,208,4,13,5,12,60,48,12,44
AaB,208,5,7,12,11,34,43,-9,33
AC Horsens,208,6,6,15,9,36,54,-18,33
Sonderjyske,208,7,8,6,10,28,29,-1,30
Randers FC,208,8,6,6,12,25,40,-15,24
Silkeborg IF,208,9,6,3,13,31,44,-13,21
Lyngby,208,10,3,9,12,27,46,-19,18
AGF Aarhus,208,11,4,6,12,16,42,-26,18
Brondby,209,1,23,5,2,74,29,45,74
FC Midtjylla,209,2,19,5,6,68,42,26,62
FC Nords,209,3,15,6,9,76,57,19,51
Copenhagen,209,4,14,5,11,59,46,13,47
AaB,209,5,7,11,12,35,43,-8,32
Sonderjyske,209,6,8,6,10,28,29,-1,30
AC Horsens,209,7,6,12,12,38,59,-21,30
Lyngby,209,8,4,9,11,29,44,-15,21
Silkeborg IF,209,9,6,3,13,26,44,-18,21
Randers FC,209,10,5,6,13,23,42,-19,21
AGF Aarhus,209,11,4,6,12,16,37,-21,18
Brondby,210,1,21,7,2,73,34,39,70
FC Midtjylla,210,2,19,4,7,66,44,22,61
FC Nords,210,3,14,8,8,77,56,21,50
Copenhagen,210,4,14,6,10,64,46,18,48
AC Horsens,210,5,6,15,9,38,52,-14,33
Sonderjyske,210,6,8,6,10,28,29,-1,30
AaB,210,7,6,12,12,35,47,-12,30
Randers FC,210,8,5,7,12,24,40,-16,22
Silkeborg IF,210,9,6,3,13,28,46,-18,21
Lyngby,210,10,3,10,11,27,45,-18,19
AGF Aarhus,210,11,4,6,12,18,39,-21,18
Brondby,211,1,21,7,2,74,33,41,70
FC Midtjylla,211,2,19,5,6,66,40,26,62
Copenhagen,211,3,15,6,9,57,41,16,51
FC Nords,211,4,14,7,9,74,51,23,49
AaB,211,5,7,11,12,35,46,-11,32
Sonderjyske,211,6,8,6,10,28,29,-1,30
AC Horsens,211,7,6,12,12,35,56,-21,30
Randers FC,211,8,6,6,12,24,39,-15,24
Silkeborg IF,211,9,6,3,13,30,44,-14,21
Lyngby,211,10,3,9,12,26,45,-19,18
AGF Aarhus,211,11,4,6,12,16,41,-25,18
FC Midtjylla,212,1,21,4,5,70,39,31,67
Brondby,212,2,19,6,5,67,35,32,63
FC Nords,212,3,15,7,8,77,50,27,52
Copenhagen,212,4,13,4,13,57,52,5,43
AaB,212,5,9,12,9,39,40,-1,39
AC Horsens,212,6,6,13,11,39,59,-20,31
Sonderjyske,212,7,8,6,10,28,29,-1,30
Randers FC,212,8,5,7,12,24,40,-16,22
Silkeborg IF,212,9,6,3,13,28,44,-16,21
Lyngby,212,10,3,10,11,27,45,-18,19
AGF Aarhus,212,11,4,6,12,16,39,-23,18
Brondby,213,1,19,6,5,69,37,32,63
FC Midtjylla,213,2,19,5,6,65,40,25,62
FC Nords,213,3,15,8,7,73,47,26,53
Copenhagen,213,4,14,6,10,60,43,17,48
AaB,213,5,7,14,9,39,42,-3,35
AC Horsens,213,6,6,13,11,34,57,-23,31
Sonderjyske,213,7,8,6,10,28,29,-1,30
Silkeborg IF,213,8,6,3,13,29,45,-16,21
Lyngby,213,9,4,9,11,28,44,-16,21
Randers FC,213,10,5,6,13,23,41,-18,21
AGF Aarhus,213,11,4,6,12,17,40,-23,18
Brondby,214,1,21,6,3,73,31,42,69
FC Midtjylla,214,2,18,7,5,64,41,23,61
FC Nords,214,3,14,7,9,73,53,20,49
Copenhagen,214,4,13,6,11,57,45,12,45
AC Horsens,214,5,7,14,9,42,56,-14,35
AaB,214,6,7,12,11,37,46,-9,33
Sonderjyske,214,7,8,6,10,28,29,-1,30
Lyngby,214,8,4,9,11,28,44,-16,21
Randers FC,214,9,5,6,13,23,41,-18,21
AGF Aarhus,214,10,5,6,11,18,37,-19,21
Silkeborg IF,214,11,5,3,14,26,46,-20,18
Brondby,215,1,20,6,4,68,32,36,66
FC Midtjylla,215,2,20,5,5,68,40,28,65
FC Nords,215,3,12,9,9,73,54,19,45
Copenhagen,215,4,13,6,11,57,46,11,45
AaB,215,5,9,11,10,37,45,-8,38
AC Horsens,215,6,6,15,9,39,51,-12,33
Sonderjyske,215,7,8,6,10,28,29,-1,30
Silkeborg IF,215,8,6,3,13,29,44,-15,21
Lyngby,215,9,4,9,11,28,45,-17,21
Randers FC,215,10,5,6,13,24,41,-17,21
AGF Aarhus,215,11,4,6,12,16,40,-24,18
Brondby,216,1,23,5,2,76,29,47,74
FC Midtjylla,216,2,19,4,7,67,41,26,61
FC Nords,216,3,15,7,8,76,54,22,52
Copenhagen,216,4,14,5,11,56,45,11,47
AaB,216,5,6,13,11,34,47,-13,31
Sonderjyske,216,6,8,6,10,28,29,-1,30
AC Horsens,216,7,6,12,12,36,55,-19,30
Lyngby,216,8,4,9,11,27,44,-17,21
Randers FC,216,9,5,6,13,23,40,-17,21
Silkeborg IF,216,10,6,3,13,27,45,-18,21
AGF Aarhus,216,11,4,6,12,17,38,-21,18
Brondby,217,1,20,6,4,66,34,32,66
FC Midtjylla,217,2,19,5,6,61,39,22,62
FC Nords,217,3,15,8,7,75,46,29,53
Copenhagen,217,4,12,5,13,57,48,9,41
AaB,217,5,8,12,10,35,39,-4,36
AC Horsens,217,6,8,12,10,37,51,-14,36
Sonderjyske,217,7,8,6,10,28,29,-1,30
Randers FC,217,8,6,6,12,26,40,-14,24
Silkeborg IF,217,9,5,4,13,25,44,-19,19
AGF Aarhus,217,10,4,7,11,16,36,-20,19
Lyngby,217,11,3,9,12,27,47,-20,18
Brondby,218,1,21,6,3,72,36,36,69
FC Midtjylla,218,2,19,6,5,68,43,25,63
Copenhagen,218,3,15,5,10,61,43,18,50
FC Nords,218,4,14,7,9,72,49,23,49
AaB,218,5,7,12,11,36,45,-9,33
Sonderjyske,218,6,8,6,10,28,29,-1,30
AC Horsens,218,7,5,14,11,35,54,-19,29
Lyngby,218,8,4,9,11,28,45,-17,21
Silkeborg IF,218,8,6,3,13,28,45,-17,21
Randers FC,218,10,5,6,13,24,41,-17,21
AGF Aarhus,218,11,4,6,12,17,39,-22,18
Brondby,219,1,20,5,5,67,34,33,65
FC Midtjylla,219,2,19,6,5,66,39,27,63
FC Nords,219,3,14,8,8,74,52,22,50
Copenhagen,219,4,13,7,10,55,43,12,46
AaB,219,5,8,12,10,37,40,-3,36
AC Horsens,219,6,6,14,10,41,58,-17,32
Sonderjyske,219,7,8,6,10,28,29,-1,30
Randers FC,219,8,5,7,12,23,39,-16,22
Silkeborg IF,219,9,6,3,13,28,44,-16,21
Lyngby,219,10,3,10,11,26,44,-18,19
AGF Aarhus,219,11,4,6,12,16,39,-23,18
Brondby,220,1,22,5,3,67,30,37,71
FC Midtjylla,220,2,19,5,6,65,41,24,62
FC Nords,220,3,14,6,10,70,48,22,48
Copenhagen,220,4,14,4,12,57,44,13,46
AaB,220,5,9,11,10,37,41,-4,38
AC Horsens,220,6,6,13,11,34,52,-18,31
Sonderjyske,220,7,8,6,10,28,29,-1,30
Randers FC,220,8,5,7,12,24,40,-16,22
Silkeborg IF,220,9,6,3,13,26,44,-18,21
Lyngby,220,10,3,10,11,27,45,-18,19
AGF Aarhus,220,11,4,6,12,16,37,-21,18
Brondby,221,1,21,5,4,72,34,38,68
FC Midtjylla,221,2,20,4,6,70,44,26,64
FC Nords,221,3,15,7,8,78,55,23,52
Copenhagen,221,4,15,5,10,65,45,20,50
AaB,221,5,7,12,11,36,47,-11,33
Sonderjyske,221,6,8,6,10,28,29,-1,30
AC Horsens,221,7,5,13,12,35,57,-22,28
Randers FC,221,8,5,7,12,23,39,-16,22
Silkeborg IF,221,9,6,3,13,28,45,-17,21
Lyngby,221,10,3,10,11,26,44,-18,19
AGF Aarhus,221,11,4,6,12,17,39,-22,18
Brondby,222,1,21,7,2,75,35,40,70
FC Midtjylla,222,2,19,6,5,68,39,29,63
Copenhagen,222,3,14,6,10,64,51,13,48
FC Nords,222,4,13,7,10,69,54,15,46
AaB,222,5,7,12,11,42,44,-2,33
AC Horsens,222,6,6,14,10,34,55,-21,32
Sonderjyske,222,7,8,6,10,28,29,-1,30
Lyngby,222,8,4,9,11,28,44,-16,21
Silkeborg IF,222,9,6,3,13,27,45,-18,21
Randers FC,222,10,5,6,13,23,41,-18,21
AGF Aarhus,222,11,4,6,12,17,38,-21,18
FC Midtjylla,223,1,20,5,5,62,37,25,65
Brondby,223,2,19,5,6,64,35,29,62
FC Nords,223,3,15,7,8,74,51,23,52
Copenhagen,223,4,12,7,11,57,47,10,43
AC Horsens,223,5,8,13,9,40,50,-10,37
AaB,223,6,7,13,10,35,38,-3,34
Sonderjyske,223,7,8,6,10,28,29,-1,30
Lyngby,223,8,4,9,11,27,44,-17,21
Silkeborg IF,223,8,6,3,13,27,44,-17,21
Randers FC,223,10,5,6,13,23,40,-17,21
AGF Aarhus,223,11,4,6,12,16,38,-22,18
Brondby,224,1,20,6,4,66,31,35,66
FC Midtjylla,224,2,19,6,5,67,41,26,63
FC Nords,224,3,15,7,8,77,48,29,52
Copenhagen,224,4,12,6,12,53,46,7,42
AC Horsens,224,5,9,12,9,39,51,-12,39
AaB,224,6,6,13,11,35,46,-11,31
Sonderjyske,224,7,8,6,10,28,29,-1,30
Randers FC,224,8,5,7,12,24,40,-16,22
AGF Aarhus,224,9,5,6,11,18,36,-18,21
Lyngby,224,10,3,10,11,27,45,-18,19
Silkeborg IF,224,11,5,3,14,25,46,-21,18
Brondby,225,1,22,5,3,75,34,41,71
FC Midtjylla,225,2,20,5,5,67,39,28,65
FC Nords,225,3,14,7,9,74,53,21,49
Copenhagen,225,4,13,6,11,60,48,12,45
AaB,225,5,8,11,11,35,42,-7,35
Sonderjyske,225,6,8,6,10,28,29,-1,30
AC Horsens,225,7,6,12,12,31,52,-21,30
Randers FC,225,8,6,6,12,26,40,-14,24
Silkeborg IF,225,9,5,4,13,26,45,-19,19
AGF Aarhus,225,10,4,7,11,17,37,-20,19
Lyngby,225,11,3,9,12,27,47,-20,18
Brondby,226,1,22,6,2,73,32,41,72
FC Midtjylla,226,2,19,6,5,67,42,25,63
FC Nords,226,3,13,8,9,76,57,19,47
Copenhagen,226,4,13,5,12,59,48,11,44
AC Horsens,226,5,7,13,10,35,51,-16,34
AaB,226,6,7,12,11,39,45,-6,33
Sonderjyske,226,7,8,6,10,28,29,-1,30
Randers FC,226,8,6,6,12,24,39,-15,24
AGF Aarhus,226,9,5,6,11,18,36,-18,21
Lyngby,226,10,3,9,12,26,45,-19,18
Silkeborg IF,226,11,5,3,14,25,46,-21,18
Brondby,227,1,21,5,4,72,35,37,68
FC Midtjylla,227,2,17,6,7,61,40,21,57
Copenhagen,227,3,17,4,9,66,44,22,55
FC Nords,227,4,16,6,8,74,49,25,54
AC Horsens,227,5,6,13,11,34,55,-21,31
Sonderjyske,227,6,8,6,10,28,29,-1,30
AaB,227,7,6,12,12,37,47,-10,30
Randers FC,227,8,5,7,12,25,41,-16,22
AGF Aarhus,227,9,5,6,11,18,37,-19,21
Lyngby,227,10,3,10,11,28,46,-18,19
Silkeborg IF,227,11,5,3,14,26,46,-20,18
Brondby,228,1,20,6,4,67,32,35,66
FC Midtjylla,228,2,18,7,5,67,41,26,61
Copenhagen,228,3,14,6,10,61,44,17,48
FC Nords,228,4,13,7,10,69,51,18,46
AaB,228,5,8,13,9,36,39,-3,37
AC Horsens,228,6,7,13,10,35,54,-19,34
Sonderjyske,228,7,8,6,10,28,29,-1,30
Lyngby,228,8,4,9,11,28,44,-16,21
Silkeborg IF,228,9,6,3,13,26,44,-18,21
Randers FC,228,10,5,6,13,23,41,-18,21
AGF Aarhus,228,11,4,6,12,16,37,-21,18
Brondby,229,1,19,6,5,65,35,30,63
FC Midtjylla,229,2,17,6,7,63,47,16,57
FC Nords,229,3,16,7,7,77,48,29,55
Copenhagen,229,4,13,7,10,60,44,16,46
AaB,229,5,8,12,10,43,45,-2,36
AC Horsens,229,6,7,14,9,35,50,-15,35
Sonderjyske,229,7,8,6,10,28,29,-1,30
Randers FC,229,8,6,6,12,25,40,-15,24
Silkeborg IF,229,9,6,3,13,27,44,-17,21
Lyngby,229,10,3,9,12,27,46,-19,18
AGF Aarhus,229,11,4,6,12,16,38,-22,18
Brondby,230,1,19,7,4,67,33,34,64
FC Midtjylla,230,2,18,6,6,63,42,21,60
FC Nords,230,3,15,8,7,77,49,28,53
Copenhagen,230,4,13,5,12,59,49,10,44
AC Horsens,230,5,8,13,9,37,51,-14,37
AaB,230,6,7,13,10,40,45,-5,34
Sonderjyske,230,7,8,6,10,28,29,-1,30
Lyngby,230,8,4,9,11,28,44,-16,21
Randers FC,230,9,5,6,13,23,41,-18,21
AGF Aarhus,230,10,5,6,11,18,36,-18,21
Silkeborg IF,230,11,5,3,14,25,46,-21,18
Brondby,231,1,21,5,4,71,32,39,68
FC Midtjylla,231,2,21,5,4,66,35,31,68
FC Nords,231,3,14,7,9,74,53,21,49
Copenhagen,231,4,13,5,12,56,47,9,44
AC Horsens,231,5,8,12,10,34,49,-15,36
Sonderjyske,231,6,8,6,10,28,29,-1,30
AaB,231,7,6,12,12,33,44,-11,30
Lyngby,231,8,4,9,11,28,44,-16,21
Randers FC,231,9,5,6,13,23,41,-18,21
AGF Aarhus,231,10,5,6,11,17,36,-19,21
Silkeborg IF,231,11,5,3,14,25,45,-20,18
Brondby,232,1,21,5,4,66,31,35,68
FC Midtjylla,232,2,20,4,6,65,36,29,64
FC Nords,232,3,14,6,10,71,50,21,48
Copenhagen,232,4,14,4,12,57,49,8,46
AC Horsens,232,5,8,12,10,34,49,-15,36
AaB,232,6,8,11,11,37,41,-4,35
Sonderjyske,232,7,8,6,10,28,29,-1,30
Lyngby,232,8,4,9,11,27,44,-17,21
Randers FC,232,9,5,6,13,23,40,-17,21
Silkeborg IF,232,10,6,3,13,27,45,-18,21
AGF Aarhus,232,11,4,6,12,17,38,-21,18
FC Midtjylla,233,1,21,5,4,70,38,32,68
Brondby,233,2,20,5,5,68,34,34,65
FC Nords,233,3,14,6,10,77,54,23,48
Copenhagen,233,4,12,4,14,55,50,5,40
AaB,233,5,9,11,10,40,44,-4,38
AC Horsens,233,6,8,13,9,38,54,-16,37
Sonderjyske,233,7,8,6,10,28,29,-1,30
Lyngby,233,8,4,9,11,28,45,-17,21
Randers FC,233,9,5,6,13,24,41,-17,21
AGF Aarhus,233,10,5,6,11,18,36,-18,21
Silkeborg IF,233,11,5,3,14,25,46,-21,18
Brondby,234,1,22,5,3,73,29,44,71
FC Midtjylla,234,2,18,6,6,61,39,22,60
FC Nords,234,3,16,7,7,78,47,31,55
Copenhagen,234,4,13,4,13,54,45,9,43
AaB,234,5,7,12,11,33,43,-10,33
AC Horsens,234,6,6,14,10,30,52,-22,32
Sonderjyske,234,7,8,6,10,28,29,-1,30
Lyngby,234,8,4,9,11,30,46,-16,21
Randers FC,234,9,5,6,13,25,43,-18,21
Silkeborg IF,234,10,5,4,13,26,45,-19,19
AGF Aarhus,234,11,4,7,11,17,37,-20,19
Brondby,235,1,21,6,3,71,34,37,69
FC Midtjylla,235,2,20,4,6,66,41,25,64
FC Nords,235,3,15,6,9,77,53,24,51
Copenhagen,235,4,14,5,11,57,44,13,47
AaB,235,5,8,11,11,36,43,-7,35
Sonderjyske,235,6,8,6,10,28,29,-1,30
AC Horsens,235,7,6,12,12,37,55,-18,30
Randers FC,235,8,6,6,12,25,39,-14,24
Silkeborg IF,235,9,6,3,13,26,44,-18,21
Lyngby,235,10,3,9,12,26,46,-20,18
AGF Aarhus,235,11,4,6,12,16,37,-21,18
Brondby,236,1,23,5,2,78,29,49,74
FC Midtjylla,236,2,18,5,7,60,43,17,59
FC Nords,236,3,14,8,8,72,51,21,50
Copenhagen,236,4,14,6,10,57,43,14,48
AaB,236,5,6,13,11,34,43,-9,31
AC Horsens,236,6,6,13,11,36,54,-18,31
Sonderjyske,236,7,8,6,10,28,29,-1,30
Randers FC,236,8,5,7,12,24,40,-16,22
AGF Aarhus,236,9,5,6,11,19,37,-18,21
Lyngby,236,10,3,10,11,27,45,-18,19
Silkeborg IF,236,11,5,3,14,26,47,-21,18
Brondby,237,1,21,5,4,75,35,40,68
FC Midtjylla,237,2,19,5,6,66,40,26,62
FC Nords,237,3,14,8,8,74,50,24,50
Copenhagen,237,4,15,4,11,61,48,13,49
AaB,237,5,8,11,11,38,47,-9,35
AC Horsens,237,6,6,13,11,33,53,-20,31
Sonderjyske,237,7,8,6,10,28,29,-1,30
Randers FC,237,8,6,6,12,25,40,-15,24
AGF Aarhus,237,9,5,6,11,18,37,-19,21
Lyngby,237,10,3,9,12,27,46,-19,18
Silkeborg IF,237,11,5,3,14,26,46,-20,18
Brondby,238,1,22,6,2,72,29,43,72
FC Midtjylla,238,2,20,5,5,65,35,30,65
FC Nords,238,3,14,8,8,72,50,22,50
Copenhagen,238,4,13,6,11,57,46,11,45
AaB,238,5,6,13,11,39,50,-11,31
Sonderjyske,238,6,8,6,10,28,29,-1,30
AC Horsens,238,7,6,12,12,34,55,-21,30
Randers FC,238,8,5,7,12,24,40,-16,22
Lyngby,238,9,3,10,11,27,45,-18,19
Silkeborg IF,238,10,5,4,13,26,45,-19,19
AGF Aarhus,238,11,4,7,11,17,37,-20,19
Brondby,239,1,21,5,4,69,33,36,68
FC Midtjylla,239,2,21,4,5,69,35,34,67
Copenhagen,239,3,14,5,11,60,47,13,47
FC Nords,239,4,13,7,10,71,54,17,46
AaB,239,5,9,11,10,35,39,-4,38
Sonderjyske,239,6,8,6,10,28,29,-1,30
AC Horsens,239,7,6,12,12,34,56,-22,30
Randers FC,239,8,6,6,12,24,39,-15,24
AGF Aarhus,239,9,5,6,11,18,37,-19,21
Lyngby,239,10,3,9,12,26,45,-19,18
Silkeborg IF,239,11,5,3,14,26,46,-20,18
Brondby,240,1,20,6,4,68,30,38,66
FC Midtjylla,240,2,20,4,6,66,40,26,64
Copenhagen,240,3,15,5,10,62,42,20,50
FC Nords,240,4,13,6,11,71,59,12,45
AaB,240,5,9,13,8,38,38,0,40
Sonderjyske,240,6,8,6,10,28,29,-1,30
AC Horsens,240,7,6,12,12,33,55,-22,30
Lyngby,240,8,4,9,11,28,45,-17,21
Randers FC,240,9,5,6,13,24,41,-17,21
Silkeborg IF,240,10,5,4,13,27,46,-19,19
AGF Aarhus,240,11,4,7,11,18,38,-20,19
Brondby,241,1,21,6,3,71,32,39,69
FC Midtjylla,241,2,19,5,6,62,38,24,62
FC Nords,241,3,14,8,8,75,47,28,50
Copenhagen,241,4,13,6,11,57,46,11,45
AaB,241,5,8,12,10,35,41,-6,36
Sonderjyske,241,6,8,6,10,28,29,-1,30
AC Horsens,241,7,5,15,10,31,53,-22,30
Lyngby,241,8,4,9,11,31,44,-13,21
Silkeborg IF,241,9,6,3,13,28,44,-16,21
Randers FC,241,10,5,6,13,23,44,-21,21
AGF Aarhus,241,11,4,6,12,16,39,-23,18
FC Midtjylla,242,1,20,5,5,66,37,29,65
Brondby,242,2,18,7,5,62,34,28,61
FC Nords,242,3,16,6,8,77,50,27,54
Copenhagen,242,4,14,5,11,62,46,16,47
AaB,242,5,8,12,10,35,43,-8,36
Sonderjyske,242,6,8,6,10,28,29,-1,30
AC Horsens,242,7,5,15,10,35,53,-18,30
Lyngby,242,8,4,9,11,29,46,-17,21
Randers FC,242,9,5,6,13,25,42,-17,21
Silkeborg IF,242,10,5,4,13,26,45,-19,19
AGF Aarhus,242,11,4,7,11,17,37,-20,19
Brondby,243,1,21,5,4,70,32,38,68
FC Midtjylla,243,2,19,6,5,65,38,27,63
FC Nords,243,3,15,7,8,79,51,28,52
Copenhagen,243,4,15,6,9,62,45,17,51
Sonderjyske,243,5,8,6,10,28,29,-1,30
AaB,243,6,6,12,12,34,47,-13,30
AC Horsens,243,7,6,12,12,36,59,-23,30
Randers FC,243,8,5,7,12,23,39,-16,22
Lyngby,243,9,3,10,11,26,44,-18,19
Silkeborg IF,243,10,5,4,13,27,46,-19,19
AGF Aarhus,243,11,4,7,11,18,38,-20,19
FC Midtjylla,244,1,21,4,5,70,40,30,67
Brondby,244,2,20,6,4,70,34,36,66
Copenhagen,244,3,14,7,9,61,45,16,49
FC Nords,244,4,14,6,10,75,54,21,48
AaB,244,5,7,12,11,36,43,-7,33
AC Horsens,244,6,6,13,11,35,57,-22,31
Sonderjyske,244,7,8,6,10,28,29,-1,30
Lyngby,244,8,4,9,11,27,44,-17,21
Randers FC,244,9,5,6,13,23,40,-17,21
AGF Aarhus,244,10,5,6,11,18,36,-18,21
Silkeborg IF,244,11,5,3,14,25,46,-21,18
Brondby,245,1,21,5,4,77,38,39,68
FC Midtjylla,245,2,20,5,5,65,42,23,65
FC Nords,245,3,15,7,8,75,49,26,52
Copenhagen,245,4,14,5,11,62,46,16,47
AC Horsens,245,5,7,12,11,37,56,-19,33
Sonderjyske,245,6,8,6,10,28,29,-1,30
AaB,245,7,6,12,12,32,43,-11,30
Randers FC,245,8,5,7,12,23,39,-16,22
Silkeborg IF,245,9,6,3,13,27,44,-17,21
Lyngby,245,10,3,10,11,26,44,-18,19
AGF Aarhus,245,11,4,6,12,16,38,-22,18
Brondby,246,1,21,6,3,72,33,39,69
FC Midtjylla,246,2,19,6,5,64,39,25,63
Copenhagen,246,3,15,5,10,63,46,17,50
FC Nords,246,4,13,8,9,72,48,24,47
AaB,246,5,6,14,10,36,46,-10,32
AC Horsens,246,6,6,13,11,36,57,-21,31
Sonderjyske,246,7,8,6,10,28,29,-1,30
Lyngby,246,8,4,9,11,27,44,-17,21
Randers FC,246,9,5,6,13,23,40,-17,21
Silkeborg IF,246,10,5,4,13,25,44,-19,19
AGF Aarhus,246,11,4,7,11,16,36,-20,19
Brondby,247,1,20,6,4,67,32,35,66
FC Midtjylla,247,2,19,5,6,63,39,24,62
Copenhagen,247,3,15,5,10,59,43,16,50
FC Nords,247,4,14,7,9,70,49,21,49
AC Horsens,247,5,8,12,10,35,49,-14,36
AaB,247,6,7,11,12,34,42,-8,32
Sonderjyske,247,7,8,6,10,28,29,-1,30
Randers FC,247,8,5,7,12,25,41,-16,22
Lyngby,247,9,3,10,11,28,46,-18,19
Silkeborg IF,247,10,5,4,13,27,46,-19,19
AGF Aarhus,247,11,4,7,11,18,38,-20,19
Brondby,248,1,22,5,3,72,31,41,71
FC Midtjylla,248,2,18,7,5,66,42,24,61
FC Nords,248,3,13,7,10,71,52,19,46
Copenhagen,248,4,13,5,12,59,51,8,44
AaB,248,5,8,12,10,36,40,-4,36
AC Horsens,248,6,8,12,10,40,54,-14,36
Sonderjyske,248,7,8,6,10,28,29,-1,30
Randers FC,248,8,5,7,12,23,39,-16,22
Lyngby,248,9,3,10,11,26,44,-18,19
Silkeborg IF,248,10,5,4,13,25,44,-19,19
AGF Aarhus,248,11,4,7,11,16,36,-20,19
Brondby,249,1,20,7,3,69,32,37,67
FC Midtjylla,249,2,19,6,5,64,36,28,63
Copenhagen,249,3,14,7,9,59,44,15,49
FC Nords,249,4,12,9,9,70,54,16,45
AaB,249,5,8,13,9,39,42,-3,37
Sonderjyske,249,6,8,6,10,28,29,-1,30
AC Horsens,249,7,5,14,11,32,51,-19,29
Randers FC,249,8,5,7,12,23,39,-16,22
AGF Aarhus,249,9,5,6,11,17,36,-19,21
Lyngby,249,10,3,10,11,26,44,-18,19
Silkeborg IF,249,11,5,3,14,25,45,-20,18
Brondby,250,1,19,8,3,68,33,35,65
FC Midtjylla,250,2,20,5,5,66,39,27,65
FC Nords,250,3,14,7,9,72,52,20,49
Copenhagen,250,4,13,7,10,54,41,13,46
AC Horsens,250,5,7,13,10,38,53,-15,34
AaB,250,6,7,12,11,38,44,-6,33
Sonderjyske,250,7,8,6,10,28,29,-1,30
Lyngby,250,8,4,9,11,28,45,-17,21
Randers FC,250,9,5,6,13,24,41,-17,21
AGF Aarhus,250,10,5,6,11,18,36,-18,21
Silkeborg IF,250,11,5,3,14,25,46,-21,18
FC Midtjylla,251,1,21,5,4,66,36,30,68
Brondby,251,2,19,8,3,68,32,36,65
FC Nords,251,3,15,6,9,77,53,24,51
Copenhagen,251,4,14,6,10,56,43,13,48
Sonderjyske,251,5,8,6,10,28,29,-1,30
AaB,251,6,6,12,12,34,44,-10,30
AC Horsens,251,7,5,15,10,35,54,-19,30
Randers FC,251,8,5,7,12,24,40,-16,22
Lyngby,251,9,3,10,11,27,45,-18,19
Silkeborg IF,251,10,5,4,13,26,45,-19,19
AGF Aarhus,251,11,4,7,11,17,37,-20,19
Brondby,252,1,21,6,3,72,32,40,69
FC Midtjylla,252,2,17,5,8,59,42,17,56
FC Nords,252,3,15,7,8,77,49,28,52
Copenhagen,252,4,15,4,11,60,47,13,49
AaB,252,5,8,14,8,40,40,0,38
Sonderjyske,252,6,8,6,10,28,29,-1,30
AC Horsens,252,7,6,12,12,33,57,-24,30
Randers FC,252,8,6,6,12,24,39,-15,24
Silkeborg IF,252,9,6,3,13,26,44,-18,21
Lyngby,252,10,3,9,12,26,45,-19,18
AGF Aarhus,252,11,4,6,12,16,37,-21,18
FC Midtjylla,253,1,22,4,4,68,36,32,70
Brondby,253,2,20,5,5,69,36,33,65
Copenhagen,253,3,14,5,11,58,44,14,47
FC Nords,253,4,13,6,11,70,55,15,45
AaB,253,5,10,11,9,42,41,1,41
Sonderjyske,253,6,8,6,10,28,29,-1,30
AC Horsens,253,7,5,13,12,34,55,-21,28
Randers FC,253,8,6,6,12,27,39,-12,24
AGF Aarhus,253,9,5,6,11,17,36,-19,21
Silkeborg IF,253,10,5,3,14,25,45,-20,18
Lyngby,253,11,3,9,12,26,48,-22,18
Brondby,254,1,22,6,2,74,31,43,72
FC Midtjylla,254,2,19,6,5,67,41,26,63
FC Nords,254,3,16,6,8,74,51,23,54
Copenhagen,254,4,13,5,12,55,45,10,44
AaB,254,5,7,11,12,37,45,-8,32
Sonderjyske,254,6,8,6,10,28,29,-1,30
AC Horsens,254,7,6,12,12,33,53,-20,30
Lyngby,254,8,4,9,11,28,44,-16,21
Silkeborg IF,254,9,6,3,13,28,46,-18,21
Randers FC,254,10,5,6,13,23,41,-18,21
AGF Aarhus,254,11,4,6,12,18,39,-21,18
Brondby,255,1,20,7,3,67,28,39,67
FC Midtjylla,255,2,19,5,6,66,37,29,62
FC Nords,255,3,15,6,9,73,48,25,51
Copenhagen,255,4,14,6,10,57,44,13,48
AaB,255,5,8,11,11,38,43,-5,35
AC Horsens,255,6,6,13,11,33,60,-27,31
Sonderjyske,255,7,8,6,10,28,29,-1,30
Lyngby,255,8,4,9,11,28,44,-16,21
Randers FC,255,9,5,6,13,23,41,-18,21
Silkeborg IF,255,10,5,4,13,26,45,-19,19
AGF Aarhus,255,11,4,7,11,17,37,-20,19
Brondby,256,1,21,6,3,73,34,39,69
FC Midtjylla,256,2,19,6,5,69,40,29,63
FC Nords,256,3,15,6,9,74,51,23,51
Copenhagen,256,4,13,5,12,57,50,7,44
AaB,256,5,7,13,10,38,47,-9,34
AC Horsens,256,6,6,14,10,36,51,-15,32
Sonderjyske,256,7,8,6,10,28,29,-1,30
Lyngby,256,8,4,9,11,30,45,-15,21
Silkeborg IF,256,9,6,3,13,29,44,-15,21
Randers FC,256,10,5,6,13,24,43,-19,21
AGF Aarhus,256,11,4,6,12,16,40,-24,18
Brondby,257,1,21,5,4,70,35,35,68
FC Midtjylla,257,2,20,5,5,72,39,33,65
FC Nords,257,3,15,6,9,75,55,20,51
Copenhagen,257,4,14,6,10,60,43,17,48
AaB,257,5,8,11,11,37,46,-9,35
Sonderjyske,257,6,8,6,10,28,29,-1,30
AC Horsens,257,7,5,13,12,34,56,-22,28
Randers FC,257,8,6,6,12,25,39,-14,24
Silkeborg IF,257,9,6,3,13,27,45,-18,21
Lyngby,257,10,3,9,12,26,46,-20,18
AGF Aarhus,257,11,4,6,12,17,38,-21,18
Brondby,258,1,21,5,4,70,33,37,68
FC Midtjylla,258,2,20,6,4,70,40,30,66
FC Nords,258,3,14,7,9,71,49,22,49
Copenhagen,258,4,14,5,11,62,48,14,47
AaB,258,5,8,13,9,38,40,-2,37
Sonderjyske,258,6,8,6,10,28,29,-1,30
AC Horsens,258,7,5,12,13,31,58,-27,27
Lyngby,258,8,4,9,11,29,45,-16,21
Randers FC,258,9,5,6,13,24,42,-18,21
AGF Aarhus,258,10,5,6,11,19,37,-18,21
Silkeborg IF,258,11,5,3,14,26,47,-21,18
FC Midtjylla,259,1,21,4,5,71,37,34,67
Brondby,259,2,18,9,3,72,40,32,63
FC Nords,259,3,13,8,9,73,58,15,47
Copenhagen,259,4,13,7,10,56,43,13,46
AaB,259,5,7,14,9,40,42,-2,35
AC Horsens,259,6,6,14,10,33,51,-18,32
Sonderjyske,259,7,8,6,10,28,29,-1,30
Randers FC,259,8,6,6,12,27,42,-15,24
Silkeborg IF,259,9,6,3,13,27,45,-18,21
Lyngby,259,10,3,9,12,29,48,-19,18
AGF Aarhus,259,11,4,6,12,17,38,-21,18
FC Midtjylla,260,1,20,5,5,69,38,31,65
Brondby,260,2,19,6,5,65,33,32,63
FC Nords,260,3,15,8,7,77,52,25,53
Copenhagen,260,4,15,5,10,57,41,16,50
AaB,260,5,6,13,11,35,45,-10,31
AC Horsens,260,6,6,13,11,35,55,-20,31
Sonderjyske,260,7,8,6,10,28,29,-1,30
Lyngby,260,8,4,9,11,29,44,-15,21
Silkeborg IF,260,9,6,3,13,28,44,-16,21
Randers FC,260,10,5,6,13,23,42,-19,21
AGF Aarhus,260,11,4,6,12,16,39,-23,18
Brondby,261,1,21,6,3,74,32,42,69
FC Midtjylla,261,2,19,4,7,65,43,22,61
FC Nords,261,3,14,8,8,70,48,22,50
Copenhagen,261,4,14,4,12,58,49,9,46
AaB,261,5,8,14,8,36,38,-2,38
Sonderjyske,261,6,8,6,10,28,29,-1,30
AC Horsens,261,7,5,14,11,33,52,-19,29
Lyngby,261,8,4,9,11,29,46,-17,21
Silkeborg IF,261,9,6,3,13,27,44,-17,21
Randers FC,261,10,5,6,13,25,42,-17,21
AGF Aarhus,261,11,4,6,12,16,38,-22,18
Brondby,262,1,23,5,2,75,30,45,74
FC Midtjylla,262,2,20,4,6,65,36,29,64
FC Nords,262,3,14,7,9,80,54,26,49
Copenhagen,262,4,14,6,10,57,41,16,48
Sonderjyske,262,5,8,6,10,28,29,-1,30
AaB,262,6,6,12,12,33,49,-16,30
AC Horsens,262,7,6,12,12,35,61,-26,30
Lyngby,262,8,4,9,11,29,45,-16,21
Randers FC,262,9,5,6,13,24,42,-18,21
AGF Aarhus,262,10,5,6,11,18,37,-19,21
Silkeborg IF,262,11,5,3,14,26,46,-20,18
Brondby,263,1,22,5,3,77,34,43,71
FC Midtjylla,263,2,18,5,7,63,44,19,59
Copenhagen,263,3,16,5,9,65,42,23,53
FC Nords,263,4,13,6,11,72,54,18,45
AaB,263,5,8,11,11,35,48,-13,35
AC Horsens,263,6,7,12,11,40,56,-16,33
Sonderjyske,263,7,8,6,10,28,29,-1,30
Randers FC,263,8,6,6,12,24,39,-15,24
Silkeborg IF,263,9,6,3,13,27,44,-17,21
Lyngby,263,10,3,9,12,26,45,-19,18
AGF Aarhus,263,11,4,6,12,16,38,-22,18
Brondby,264,1,21,7,2,71,31,40,70
FC Midtjylla,264,2,20,5,5,65,37,28,65
FC Nords,264,3,13,7,10,73,56,17,46
Copenhagen,264,4,12,7,11,56,46,10,43
AaB,264,5,8,12,10,39,43,-4,36
AC Horsens,264,6,7,12,11,34,51,-17,33
Sonderjyske,264,7,8,6,10,28,29,-1,30
Randers FC,264,8,5,7,12,23,39,-16,22
Lyngby,264,9,3,10,11,26,44,-18,19
Silkeborg IF,264,10,5,4,13,25,44,-19,19
AGF Aarhus,264,11,4,7,11,16,36,-20,19
Brondby,265,1,20,7,3,65,29,36,67
FC Midtjylla,265,2,20,5,5,70,42,28,65
FC Nords,265,3,14,8,8,79,55,24,50
Copenhagen,265,4,15,4,11,61,46,15,49
AaB,265,5,8,12,10,38,42,-4,36
Sonderjyske,265,6,8,6,10,28,29,-1,30
AC Horsens,265,7,5,12,13,33,58,-25,27
Lyngby,265,8,4,9,11,27,44,-17,21
Randers FC,265,9,5,6,13,23,40,-17,21
Silkeborg IF,265,10,6,3,13,27,45,-18,21
AGF Aarhus,265,11,4,6,12,17,38,-21,18
Brondby,266,1,21,5,4,69,32,37,68
FC Midtjylla,266,2,18,5,7,64,44,20,59
FC Nords,266,3,15,7,8,79,51,28,52
Copenhagen,266,4,14,5,11,58,46,12,47
AC Horsens,266,5,8,13,9,39,49,-10,37
AaB,266,6,6,13,11,34,47,-13,31
Sonderjyske,266,7,8,6,10,28,29,-1,30
Lyngby,266,8,4,9,11,30,45,-15,21
Randers FC,266,9,5,6,13,24,43,-19,21
Silkeborg IF,266,10,5,4,13,27,46,-19,19
AGF Aarhus,266,11,4,7,11,18,38,-20,19
Brondby,267,1,20,7,3,72,35,37,67
FC Midtjylla,267,2,19,4,7,63,43,20,61
FC Nords,267,3,14,8,8,74,50,24,50
Copenhagen,267,4,14,6,10,62,45,17,48
AC Horsens,267,5,7,13,10,35,50,-15,34
AaB,267,6,6,14,10,36,45,-9,32
Sonderjyske,267,7,8,6,10,28,29,-1,30
Randers FC,267,8,6,6,12,25,40,-15,24
Silkeborg IF,267,9,5,4,13,25,44,-19,19
AGF Aarhus,267,10,4,7,11,16,36,-20,19
Lyngby,267,11,3,9,12,27,46,-19,18
FC Midtjylla,268,1,22,4,4,71,34,37,70
Brondby,268,2,21,6,3,68,30,38,69
Copenhagen,268,3,15,4,11,58,47,11,49
FC Nords,268,4,14,6,10,73,55,18,48
Sonderjyske,268,5,8,6,10,28,29,-1,30
AaB,268,6,6,12,12,32,43,-11,30
AC Horsens,268,7,6,12,12,35,54,-19,30
Randers FC,268,8,5,7,12,24,40,-16,22
Silkeborg IF,268,9,6,3,13,26,44,-18,21
Lyngby,268,10,3,10,11,27,45,-18,19
AGF Aarhus,268,11,4,6,12,16,37,-21,18
Brondby,269,1,20,7,3,70,33,37,67
FC Midtjylla,269,2,21,4,5,67,38,29,67
FC Nords,269,3,15,6,9,76,52,24,51
Copenhagen,269,4,12,5,13,53,46,7,41
AaB,269,5,9,11,10,38,42,-4,38
AC Horsens,269,6,6,13,11,33,52,-19,31
Sonderjyske,269,7,8,6,10,28,29,-1,30
Randers FC,269,8,6,6,12,26,41,-15,24
Silkeborg IF,269,9,6,3,13,27,45,-18,21
Lyngby,269,10,3,9,12,28,47,-19,18
AGF Aarhus,269,11,4,6,12,17,38,-21,18
Brondby,270,1,20,8,2,70,33,37,68
FC Midtjylla,270,2,19,6,5,64,38,26,63
FC Nords,270,3,15,8,7,72,46,26,53
Copenhagen,270,4,15,5,10,59,41,18,50
AaB,270,5,7,11,12,37,46,-9,32
Sonderjyske,270,6,8,6,10,28,29,-1,30
AC Horsens,270,7,5,12,13,32,56,-24,27
Randers FC,270,8,5,7,12,23,39,-16,22
Silkeborg IF,270,9,6,3,13,28,45,-17,21
Lyngby,270,10,3,10,11,26,44,-18,19
AGF Aarhus,270,11,4,6,12,17,39,-22,18
FC Midtjylla,271,1,20,5,5,71,42,29,65
Brondby,271,2,19,5,6,64,34,30,62
FC Nords,271,3,16,6,8,77,48,29,54
Copenhagen,271,4,15,4,11,64,51,13,49
AaB,271,5,7,12,11,36,41,-5,33
AC Horsens,271,6,7,12,11,35,57,-22,33
Sonderjyske,271,7,8,6,10,28,29,-1,30
Randers FC,271,8,5,7,12,25,41,-16,22
Lyngby,271,9,3,10,11,28,46,-18,19
Silkeborg IF,271,10,5,4,13,25,44,-19,19
AGF Aarhus,271,11,4,7,11,16,36,-20,19
FC Midtjylla,272,1,22,4,4,69,36,33,70
Brondby,272,2,21,6,3,68,29,39,69
FC Nords,272,3,15,6,9,77,51,26,51
Copenhagen,272,4,13,5,12,58,52,6,44
AC Horsens,272,5,6,13,11,36,56,-20,31
Sonderjyske,272,6,8,6,10,28,29,-1,30
AaB,272,7,6,12,12,38,48,-10,30
Randers FC,272,8,6,6,12,26,39,-13,24
Silkeborg IF,272,9,5,4,13,25,44,-19,19
AGF Aarhus,272,10,4,7,11,16,36,-20,19
Lyngby,272,11,3,9,12,26,47,-21,18
Brondby,273,1,22,6,2,71,26,45,72
FC Midtjylla,273,2,20,4,6,67,40,27,64
FC Nords,273,3,14,7,9,69,53,16,49
Copenhagen,273,4,13,6,11,58,43,15,45
AaB,273,5,7,13,10,36,41,-5,34
Sonderjyske,273,6,8,6,10,28,29,-1,30
AC Horsens,273,7,6,12,12,34,58,-24,30
Randers FC,273,8,6,6,12,26,41,-15,24
Silkeborg IF,273,9,6,3,13,26,44,-18,21
Lyngby,273,10,3,9,12,28,47,-19,18
AGF Aarhus,273,11,4,6,12,16,37,-21,18
Brondby,274,1,20,5,5,73,40,33,65
FC Midtjylla,274,2,20,4,6,66,39,27,64
FC Nords,274,3,15,6,9,77,56,21,51
Copenhagen,274,4,13,5,12,54,44,10,44
AaB,274,5,8,12,10,39,42,-3,36
AC Horsens,274,6,8,12,10,38,52,-14,36
Sonderjyske,274,7,8,6,10,28,29,-1,30
Lyngby,274,8,4,9,11,27,44,-17,21
Randers FC,274,9,5,6,13,23,40,-17,21
AGF Aarhus,274,10,5,6,11,18,37,-19,21
Silkeborg IF,274,11,5,3,14,26,46,-20,18
Brondby,275,1,21,6,3,71,31,40,69
FC Midtjylla,275,2,20,4,6,62,38,24,64
FC Nords,275,3,15,8,7,80,49,31,53
Copenhagen,275,4,13,5,12,51,44,7,44
AaB,275,5,8,12,10,37,41,-4,36
Sonderjyske,275,6,8,6,10,28,29,-1,30
AC Horsens,275,7,5,13,12,31,55,-24,28
Lyngby,275,8,4,9,11,29,44,-15,21
Randers FC,275,9,5,6,13,23,42,-19,21
Silkeborg IF,275,10,5,4,13,25,44,-19,19
AGF Aarhus,275,11,4,7,11,16,36,-20,19
Brondby,276,1,21,6,3,68,29,39,69
FC Midtjylla,276,2,19,6,5,68,38,30,63
FC Nords,276,3,15,8,7,78,52,26,53
Copenhagen,276,4,12,7,11,57,46,11,43
AC Horsens,276,5,7,12,11,31,53,-22,33
AaB,276,6,6,13,11,34,44,-10,31
Sonderjyske,276,7,8,6,10,28,29,-1,30
Lyngby,276,8,4,9,11,29,46,-17,21
Randers FC,276,9,5,6,13,25,42,-17,21
AGF Aarhus,276,10,5,6,11,18,37,-19,21
Silkeborg IF,276,11,5,3,14,26,46,-20,18
Brondby,277,1,19,8,3,65,32,33,65
FC Midtjylla,277,2,20,5,5,64,34,30,65
FC Nords,277,3,13,7,10,67,48,19,46
Copenhagen,277,4,14,4,12,58,47,11,46
AaB,277,5,8,13,9,39,45,-6,37
AC Horsens,277,6,7,13,10,37,50,-13,34
Sonderjyske,277,7,8,6,10,28,29,-1,30
Lyngby,277,8,4,9,11,28,44,-16,21
Silkeborg IF,277,9,6,3,13,28,45,-17,21
Randers FC,277,10,5,6,13,23,41,-18,21
AGF Aarhus,277,11,4,6,12,17,39,-22,18
FC Midtjylla,278,1,21,4,5,68,40,28,67
Brondby,278,2,20,5,5,69,32,37,65
FC Nords,278,3,14,6,10,72,51,21,48
Copenhagen,278,4,14,4,12,58,51,7,46
AC Horsens,278,5,8,12,10,39,52,-13,36
AaB,278,6,8,11,11,39,45,-6,35
Sonderjyske,278,7,8,6,10,28,29,-1,30
Randers FC,278,8,6,6,12,25,40,-15,24
Silkeborg IF,278,9,6,3,13,28,45,-17,21
Lyngby,278,10,3,9,12,27,46,-19,18
AGF Aarhus,278,11,4,6,12,17,39,-22,18
Brondby,279,1,20,6,4,69,34,35,66
FC Midtjylla,279,2,20,5,5,63,36,27,65
FC Nords,279,3,15,6,9,76,56,20,51
Copenhagen,279,4,15,4,11,61,45,16,49
AaB,279,5,7,13,10,37,42,-5,34
Sonderjyske,279,6,8,6,10,28,29,-1,30
AC Horsens,279,7,5,14,11,34,53,-19,29
Randers FC,279,8,6,6,12,25,40,-15,24
Silkeborg IF,279,9,6,3,13,26,44,-18,21
Lyngby,279,10,3,9,12,27,46,-19,18
AGF Aarhus,279,11,4,6,12,16,37,-21,18
Brondby,280,1,21,7,2,74,30,44,70
FC Midtjylla,280,2,20,5,5,70,42,28,65
FC Nords,280,3,13,7,10,72,58,14,46
Copenhagen,280,4,12,5,13,59,52,7,41
AaB,280,5,9,13,8,39,40,-1,40
AC Horsens,280,6,6,13,11,39,57,-18,31
Sonderjyske,280,7,8,6,10,28,29,-1,30
Lyngby,280,8,4,9,11,29,46,-17,21
Randers FC,280,9,5,6,13,25,42,-17,21
Silkeborg IF,280,10,6,3,13,26,44,-18,21
AGF Aarhus,280,11,4,6,12,16,37,-21,18
Brondby,281,1,21,6,3,71,32,39,69
FC Midtjylla,281,2,18,7,5,64,40,24,61
FC Nords,281,3,14,7,9,71,52,19,49
Copenhagen,281,4,13,7,10,60,49,11,46
AC Horsens,281,5,7,13,10,44,54,-10,34
AaB,281,6,7,12,11,37,46,-9,33
Sonderjyske,281,7,8,6,10,28,29,-1,30
Lyngby,281,8,4,9,11,28,44,-16,21
Silkeborg IF,281,9,6,3,13,27,44,-17,21
Randers FC,281,10,5,6,13,23,41,-18,21
AGF Aarhus,281,11,4,6,12,16,38,-22,18
Brondby,282,1,20,7,3,69,29,40,67
FC Midtjylla,282,2,20,5,5,61,37,24,65
FC Nords,282,3,12,7,11,70,55,15,43
Copenhagen,282,4,12,7,11,59,48,11,43
AaB,282,5,9,13,8,39,40,-1,40
AC Horsens,282,6,6,15,9,36,51,-15,33
Sonderjyske,282,7,8,6,10,28,29,-1,30
Lyngby,282,8,4,9,11,29,44,-15,21
AGF Aarhus,282,9,5,6,11,19,37,-18,21
Randers FC,282,10,5,6,13,23,42,-19,21
Silkeborg IF,282,11,5,3,14,26,47,-21,18
FC Midtjylla,283,1,19,7,4,70,39,31,64
Brondby,283,2,18,7,5,63,33,30,61
FC Nords,283,3,14,8,8,76,54,22,50
Copenhagen,283,4,14,5,11,58,44,14,47
AC Horsens,283,5,9,13,8,40,48,-8,40
Sonderjyske,283,6,8,6,10,28,29,-1,30
AaB,283,7,6,12,12,33,48,-15,30
Lyngby,283,8,4,9,11,28,44,-16,21
Silkeborg IF,283,9,6,3,13,27,45,-18,21
Randers FC,283,10,5,6,13,23,41,-18,21
AGF Aarhus,283,11,4,6,12,17,38,-21,18
Brondby,284,1,21,5,4,75,34,41,68
FC Midtjylla,284,2,21,5,4,63,34,29,68
FC Nords,284,3,14,6,10,73,54,19,48
Copenhagen,284,4,14,5,11,58,45,13,47
AaB,284,5,7,13,10,37,42,-5,34
Sonderjyske,284,6,8,6,10,28,29,-1,30
AC Horsens,284,7,5,14,11,35,58,-23,29
Lyngby,284,8,4,9,11,29,45,-16,21
Silkeborg IF,284,9,6,3,13,28,45,-17,21
Randers FC,284,10,5,6,13,24,42,-18,21
AGF Aarhus,284,11,4,6,12,17,39,-22,18
Brondby,285,1,21,5,4,71,32,39,68
FC Midtjylla,285,2,21,4,5,71,41,30,67
FC Nords,285,3,16,6,8,80,49,31,54
Copenhagen,285,4,13,4,13,57,49,8,43
AaB,285,5,8,11,11,39,48,-9,35
Sonderjyske,285,6,8,6,10,28,29,-1,30
AC Horsens,285,7,6,12,12,34,59,-25,30
Randers FC,285,8,6,6,12,24,39,-15,24
AGF Aarhus,285,9,5,6,11,17,36,-19,21
Lyngby,285,10,3,9,12,26,45,-19,18
Silkeborg IF,285,11,5,3,14,25,45,-20,18
Brondby,286,1,21,6,3,72,32,40,69
FC Midtjylla,286,2,17,5,8,59,44,15,56
Copenhagen,286,3,15,5,10,59,42,17,50
FC Nords,286,4,14,6,10,71,52,19,48
AC Horsens,286,5,8,13,9,38,49,-11,37
AaB,286,6,8,11,11,37,43,-6,35
Sonderjyske,286,7,8,6,10,28,29,-1,30
Lyngby,286,8,4,9,11,27,44,-17,21
Randers FC,286,9,5,6,13,23,40,-17,21
Silkeborg IF,286,10,5,4,13,28,47,-19,19
AGF Aarhus,286,11,4,7,11,19,39,-20,19
FC Midtjylla,287,1,20,6,4,68,36,32,66
Brondby,287,2,19,6,5,68,38,30,63
FC Nords,287,3,14,8,8,78,51,27,50
Copenhagen,287,4,14,6,10,60,46,14,48
AaB,287,5,7,12,11,34,42,-8,33
AC Horsens,287,6,7,12,11,38,59,-21,33
Sonderjyske,287,7,8,6,10,28,29,-1,30
Lyngby,287,8,4,9,11,29,46,-17,21
Randers FC,287,9,5,6,13,25,42,-17,21
AGF Aarhus,287,10,5,6,11,18,36,-18,21
Silkeborg IF,287,11,5,3,14,25,46,-21,18
Brondby,288,1,21,6,3,67,32,35,69
FC Midtjylla,288,2,21,5,4,68,37,31,68
FC Nords,288,3,13,7,10,72,54,18,46
Copenhagen,288,4,13,6,11,57,44,13,45
AaB,288,5,8,12,10,37,39,-2,36
Sonderjyske,288,6,8,6,10,28,29,-1,30
AC Horsens,288,7,5,14,11,31,52,-21,29
Lyngby,288,8,4,9,11,28,45,-17,21
Randers FC,288,9,5,6,13,24,41,-17,21
AGF Aarhus,288,10,5,6,11,17,36,-19,21
Silkeborg IF,288,11,5,3,14,25,45,-20,18
Brondby,289,1,21,6,3,69,31,38,69
FC Midtjylla,289,2,21,4,5,67,36,31,67
Copenhagen,289,3,15,5,10,60,42,18,50
FC Nords,289,4,12,6,12,68,57,11,42
AaB,289,5,8,11,11,35,41,-6,35
AC Horsens,289,6,7,12,11,36,54,-18,33
Sonderjyske,289,7,8,6,10,28,29,-1,30
Lyngby,289,8,4,9,11,27,44,-17,21
Randers FC,289,9,5,6,13,23,40,-17,21
Silkeborg IF,289,10,5,4,13,27,46,-19,19
AGF Aarhus,289,11,4,7,11,18,38,-20,19
Brondby,290,1,20,6,4,67,32,35,66
FC Midtjylla,290,2,20,4,6,66,38,28,64
FC Nords,290,3,16,7,7,76,50,26,55
Copenhagen,290,4,12,5,13,56,50,6,41
AaB,290,5,9,12,9,41,41,0,39
Sonderjyske,290,6,8,6,10,28,29,-1,30
AC Horsens,290,7,6,12,12,33,54,-21,30
Randers FC,290,8,5,7,12,23,39,-16,22
Silkeborg IF,290,9,6,3,13,27,44,-17,21
Lyngby,290,10,3,10,11,26,44,-18,19
AGF Aarhus,290,11,4,6,12,16,38,-22,18
Brondby,291,1,21,5,4,68,32,36,68
FC Midtjylla,291,2,18,6,6,63,39,24,60
FC Nords,291,3,14,8,8,74,50,24,50
Copenhagen,291,4,15,5,10,62,40,22,50
AaB,291,5,8,12,10,38,43,-5,36
Sonderjyske,291,6,8,6,10,28,29,-1,30
AC Horsens,291,7,6,12,12,34,61,-27,30
Randers FC,291,8,5,7,12,24,40,-16,22
Silkeborg IF,291,9,6,3,13,27,44,-17,21
Lyngby,291,10,3,10,11,27,45,-18,19
AGF Aarhus,291,11,4,6,12,16,38,-22,18
Brondby,292,1,22,5,3,75,30,45,71
FC Midtjylla,292,2,19,4,7,63,38,25,61
Copenhagen,292,3,16,4,10,58,41,17,52
FC Nords,292,4,12,6,12,66,53,13,42
AC Horsens,292,5,8,12,10,32,50,-18,36
AaB,292,6,8,11,11,37,45,-8,35
Sonderjyske,292,7,8,6,10,28,29,-1,30
Randers FC,292,8,6,6,12,25,40,-15,24
AGF Aarhus,292,9,5,6,11,18,37,-19,21
Lyngby,292,10,3,9,12,27,46,-19,18
Silkeborg IF,292,11,5,3,14,26,46,-20,18
Brondby,293,1,21,6,3,69,30,39,69
FC Midtjylla,293,2,17,5,8,63,51,12,56
FC Nords,293,3,16,7,7,79,52,27,55
Copenhagen,293,4,13,6,11,58,44,14,45
AaB,293,5,7,13,10,38,43,-5,34
AC Horsens,293,6,7,13,10,39,52,-13,34
Sonderjyske,293,7,8,6,10,28,29,-1,30
Randers FC,293,8,6,6,12,25,40,-15,24
Silkeborg IF,293,9,6,3,13,27,45,-18,21
Lyngby,293,10,3,9,12,27,46,-19,18
AGF Aarhus,293,11,4,6,12,17,38,-21,18
Brondby,294,1,19,8,3,67,33,34,65
FC Midtjylla,294,2,17,7,6,64,42,22,58
FC Nords,294,3,14,8,8,74,51,23,50
Copenhagen,294,4,15,5,10,59,45,14,50
AC Horsens,294,5,7,14,9,38,49,-11,35
AaB,294,6,7,12,11,36,44,-8,33
Sonderjyske,294,7,8,6,10,28,29,-1,30
Lyngby,294,8,4,9,11,27,44,-17,21
Randers FC,294,9,5,6,13,23,40,-17,21
AGF Aarhus,294,10,5,6,11,17,36,-19,21
Silkeborg IF,294,11,5,3,14,25,45,-20,18
FC Midtjylla,295,1,21,5,4,70,38,32,68
Brondby,295,2,20,5,5,74,36,38,65
Copenhagen,295,3,15,6,9,61,43,18,51
FC Nords,295,4,14,6,10,74,55,19,48
AaB,295,5,6,13,11,35,49,-14,31
AC Horsens,295,6,6,13,11,35,54,-19,31
Sonderjyske,295,7,8,6,10,28,29,-1,30
Lyngby,295,8,4,9,11,28,45,-17,21
Randers FC,295,9,5,6,13,24,41,-17,21
Silkeborg IF,295,10,5,4,13,25,44,-19,19
AGF Aarhus,295,11,4,7,11,16,36,-20,19
Brondby,296,1,21,5,4,71,34,37,68
FC Midtjylla,296,2,20,4,6,64,37,27,64
FC Nords,296,3,14,8,8,71,49,22,50
Copenhagen,296,4,13,4,13,58,50,8,43
AC Horsens,296,5,8,13,9,36,50,-14,37
AaB,296,6,7,12,11,38,44,-6,33
Sonderjyske,296,7,8,6,10,28,29,-1,30
Randers FC,296,8,5,7,12,25,41,-16,22
Silkeborg IF,296,9,6,3,13,27,44,-17,21
Lyngby,296,10,3,10,11,28,46,-18,19
AGF Aarhus,296,11,4,6,12,16,38,-22,18
Brondby,297,1,21,5,4,69,31,38,68
FC Midtjylla,297,2,20,5,5,66,38,28,65
Copenhagen,297,3,15,4,11,56,43,13,49
FC Nords,297,4,13,6,11,71,54,17,45
AaB,297,5,8,12,10,39,45,-6,36
AC Horsens,297,6,6,14,10,38,54,-16,32
Sonderjyske,297,7,8,6,10,28,29,-1,30
Lyngby,297,8,4,9,11,31,46,-15,21
Silkeborg IF,297,9,6,3,13,27,44,-17,21
Randers FC,297,10,5,6,13,25,44,-19,21
AGF Aarhus,297,11,4,6,12,16,38,-22,18
Brondby,298,1,20,6,4,70,34,36,66
FC Midtjylla,298,2,20,5,5,63,36,27,65
FC Nords,298,3,14,8,8,71,49,22,50
Copenhagen,298,4,14,5,11,61,45,16,47
AaB,298,5,9,12,9,39,38,1,39
Sonderjyske,298,6,8,6,10,28,29,-1,30
AC Horsens,298,7,5,12,13,30,58,-28,27
Randers FC,298,8,6,6,12,25,40,-15,24
AGF Aarhus,298,9,5,6,11,18,36,-18,21
Lyngby,298,10,3,9,12,27,46,-19,18
Silkeborg IF,298,11,5,3,14,25,46,-21,18
Brondby,299,1,20,6,4,70,36,34,66
FC Midtjylla,299,2,18,4,8,62,46,16,58
FC Nords,299,3,14,7,9,74,51,23,49
Copenhagen,299,4,13,6,11,59,48,11,45
AC Horsens,299,5,9,13,8,43,50,-7,40
AaB,299,6,8,12,10,40,43,-3,36
Sonderjyske,299,7,8,6,10,28,29,-1,30
Lyngby,299,8,4,9,11,28,44,-16,21
Randers FC,299,9,5,6,13,23,41,-18,21
Silkeborg IF,299,10,5,4,13,25,44,-19,19
AGF Aarhus,299,11,4,7,11,16,36,-20,19
Brondby,300,1,19,6,5,69,36,33,63
FC Midtjylla,300,2,19,5,6,68,42,26,62
FC Nords,300,3,15,6,9,74,50,24,51
Copenhagen,300,4,14,5,11,59,46,13,47
AaB,300,5,9,13,8,42,43,-1,40
AC Horsens,300,6,6,13,11,33,54,-21,31
Sonderjyske,300,7,8,6,10,28,29,-1,30
Lyngby,300,8,4,9,11,27,44,-17,21
Randers FC,300,9,5,6,13,23,40,-17,21
Silkeborg IF,300,10,6,3,13,26,44,-18,21
AGF Aarhus,300,11,4,6,12,16,37,-21,18
Brondby,301,1,21,7,2,71,29,42,70
FC Midtjylla,301,2,19,4,7,63,42,21,61
FC Nords,301,3,15,8,7,78,51,27,53
Copenhagen,301,4,14,5,11,54,43,11,47
AaB,301,5,7,12,11,38,44,-6,33
Sonderjyske,301,6,8,6,10,28,29,-1,30
AC Horsens,301,7,6,12,12,36,57,-21,30
Randers FC,301,8,5,7,12,24,40,-16,22
Lyngby,301,9,3,10,11,27,45,-18,19
Silkeborg IF,301,10,5,4,13,25,44,-19,19
AGF Aarhus,301,11,4,7,11,16,36,-20,19
Brondby,302,1,20,6,4,69,33,36,66
FC Midtjylla,302,2,18,7,5,62,37,25,61
Copenhagen,302,3,15,6,9,61,40,21,51
FC Nords,302,4,13,9,8,75,56,19,48
AaB,302,5,7,12,11,38,48,-10,33
AC Horsens,302,6,6,14,10,34,51,-17,32
Sonderjyske,302,7,8,6,10,28,29,-1,30
Lyngby,302,8,4,9,11,30,45,-15,21
Silkeborg IF,302,9,6,3,13,26,44,-18,21
Randers FC,302,10,5,6,13,24,43,-19,21
AGF Aarhus,302,11,4,6,12,16,37,-21,18
Brondby,303,1,21,6,3,72,32,40,69
FC Midtjylla,303,2,21,4,5,67,36,31,67
FC Nords,303,3,15,6,9,73,49,24,51
Copenhagen,303,4,13,4,13,54,45,9,43
AaB,303,5,7,12,11,39,50,-11,33
AC Horsens,303,6,6,14,10,33,52,-19,32
Sonderjyske,303,7,8,6,10,28,29,-1,30
Randers FC,303,8,5,7,12,24,40,-16,22
AGF Aarhus,303,9,5,6,11,19,37,-18,21
Lyngby,303,10,3,10,11,27,45,-18,19
Silkeborg IF,303,11,5,3,14,26,47,-21,18
Brondby,304,1,22,5,3,75,34,41,71
FC Midtjylla,304,2,17,6,7,62,42,20,57
FC Nords,304,3,14,7,9,74,52,22,49
Copenhagen,304,4,14,4,12,57,47,10,46
AaB,304,5,8,12,10,35,38,-3,36
AC Horsens,304,6,8,12,10,37,53,-16,36
Sonderjyske,304,7,8,6,10,28,29,-1,30
Lyngby,304,8,4,9,11,29,45,-16,21
Silkeborg IF,304,9,6,3,13,27,45,-18,21
Randers FC,304,10,5,6,13,24,42,-18,21
AGF Aarhus,304,11,4,6,12,17,38,-21,18
FC Midtjylla,305,1,20,5,5,70,41,29,65
Brondby,305,2,19,7,4,67,33,34,64
FC Nords,305,3,14,8,8,75,50,25,50
Copenhagen,305,4,14,5,11,63,47,16,47
AaB,305,5,9,12,9,35,37,-2,39
Sonderjyske,305,6,8,6,10,28,29,-1,30
AC Horsens,305,7,5,13,12,33,61,-28,28
Lyngby,305,8,4,9,11,27,44,-17,21
Randers FC,305,9,5,6,13,23,40,-17,21
Silkeborg IF,305,10,5,4,13,26,45,-19,19
AGF Aarhus,305,11,4,7,11,17,37,-20,19
Brondby,306,1,21,6,3,72,31,41,69
FC Midtjylla,306,2,18,5,7,68,48,20,59
FC Nords,306,3,15,7,8,74,51,23,52
Copenhagen,306,4,13,6,11,57,46,11,45
AaB,306,5,7,13,10,39,44,-5,34
AC Horsens,306,6,7,13,10,38,54,-16,34
Sonderjyske,306,7,8,6,10,28,29,-1,30
Randers FC,306,8,5,7,12,23,39,-16,22
AGF Aarhus,306,9,5,6,11,17,36,-19,21
Lyngby,306,10,3,10,11,26,44,-18,19
Silkeborg IF,306,11,5,3,14,25,45,-20,18
Brondby,307,1,21,7,2,74,30,44,70
FC Midtjylla,307,2,19,5,6,65,39,26,62
Copenhagen,307,3,16,4,10,64,47,17,52
FC Nords,307,4,13,7,10,70,52,18,46
AaB,307,5,7,12,11,33,41,-8,33
AC Horsens,307,6,6,13,11,33,56,-23,31
Sonderjyske,307,7,8,6,10,28,29,-1,30
Randers FC,307,8,6,6,12,27,40,-13,24
Silkeborg IF,307,9,6,3,13,26,44,-18,21
Lyngby,307,10,3,9,12,27,48,-21,18
AGF Aarhus,307,11,4,6,12,16,37,-21,18
Brondby,308,1,21,6,3,71,32,39,69
FC Midtjylla,308,2,20,4,6,63,39,24,64
FC Nords,308,3,13,6,11,73,54,19,45
Copenhagen,308,4,13,4,13,56,48,8,43
AaB,308,5,10,11,9,39,39,0,41
AC Horsens,308,6,7,13,10,35,51,-16,34
Sonderjyske,308,7,8,6,10,28,29,-1,30
Randers FC,308,8,6,6,12,24,39,-15,24
Silkeborg IF,308,9,6,3,13,27,45,-18,21
Lyngby,308,10,3,9,12,26,45,-19,18
AGF Aarhus,308,11,4,6,12,17,38,-21,18
Brondby,309,1,21,6,3,71,31,40,69
FC Midtjylla,309,2,19,5,6,64,40,24,62
FC Nords,309,3,13,8,9,70,51,19,47
Copenhagen,309,4,14,4,12,61,48,13,46
AaB,309,5,9,11,10,41,45,-4,38
AC Horsens,309,6,6,14,10,33,51,-18,32
Sonderjyske,309,7,8,6,10,28,29,-1,30
Randers FC,309,8,6,6,12,25,39,-14,24
Silkeborg IF,309,9,6,3,13,28,44,-16,21
Lyngby,309,10,3,9,12,26,46,-20,18
AGF Aarhus,309,11,4,6,12,16,39,-23,18
Brondby,310,1,23,5,2,73,29,44,74
FC Midtjylla,310,2,19,6,5,67,41,26,63
FC Nords,310,3,13,8,9,71,53,18,47
Copenhagen,310,4,12,5,13,53,48,5,41
AC Horsens,310,5,8,12,10,42,54,-12,36
AaB,310,6,7,12,11,36,43,-7,33
Sonderjyske,310,7,8,6,10,28,29,-1,30
Randers FC,310,8,6,6,12,25,40,-15,24
Silkeborg IF,310,9,6,3,13,26,44,-18,21
Lyngby,310,10,3,9,12,27,46,-19,18
AGF Aarhus,310,11,4,6,12,16,37,-21,18
Brondby,311,1,22,5,3,75,32,43,71
FC Midtjylla,311,2,18,7,5,67,42,25,61
FC Nords,311,3,14,8,8,80,54,26,50
Copenhagen,311,4,12,6,12,54,51,3,42
AaB,311,5,8,12,10,42,48,-6,36
AC Horsens,311,6,5,16,9,33,50,-17,31
Sonderjyske,311,7,8,6,10,28,29,-1,30
Randers FC,311,8,5,7,12,25,41,-16,22
Silkeborg IF,311,9,6,3,13,27,45,-18,21
Lyngby,311,10,3,10,11,28,46,-18,19
AGF Aarhus,311,11,4,6,12,17,38,-21,18
Brondby,312,1,22,6,2,74,35,39,72
FC Midtjylla,312,2,19,4,7,65,42,23,61
FC Nords,312,3,15,7,8,78,51,27,52
Copenhagen,312,4,15,4,11,56,42,14,49
AaB,312,5,7,11,12,34,42,-8,32
Sonderjyske,312,6,8,6,10,28,29,-1,30
AC Horsens,312,7,6,12,12,35,56,-21,30
Randers FC,312,8,6,6,12,25,40,-15,24
Silkeborg IF,312,9,6,3,13,28,46,-18,21
Lyngby,312,10,3,9,12,27,46,-19,18
AGF Aarhus,312,11,4,6,12,18,39,-21,18
Brondby,313,1,21,6,3,68,29,39,69
FC Midtjylla,313,2,19,6,5,66,36,30,63
FC Nords,313,3,14,9,7,69,45,24,51
Copenhagen,313,4,14,6,10,56,45,11,48
AaB,313,5,7,13,10,37,45,-8,34
Sonderjyske,313,6,8,6,10,28,29,-1,30
AC Horsens,313,7,5,12,13,31,53,-22,27
Lyngby,313,8,4,9,11,28,45,-17,21
Silkeborg IF,313,9,6,3,13,27,44,-17,21
Randers FC,313,10,5,6,13,24,41,-17,21
AGF Aarhus,313,11,4,6,12,16,38,-22,18
Brondby,314,1,21,6,3,71,33,38,69
FC Midtjylla,314,2,19,5,6,68,40,28,62
FC Nords,314,3,14,8,8,72,48,24,50
Copenhagen,314,4,13,7,10,55,42,13,46
AaB,314,5,8,13,9,35,38,-3,37
Sonderjyske,314,6,8,6,10,28,29,-1,30
AC Horsens,314,7,5,13,12,29,55,-26,28
Lyngby,314,8,4,9,11,29,44,-15,21
AGF Aarhus,314,9,5,6,11,19,37,-18,21
Randers FC,314,10,5,6,13,23,42,-19,21
Silkeborg IF,314,11,5,3,14,26,47,-21,18
Brondby,315,1,20,8,2,73,30,43,68
FC Midtjylla,315,2,18,5,7,65,44,21,59
Copenhagen,315,3,15,6,9,62,44,18,51
FC Nords,315,4,12,7,11,71,62,9,43
AC Horsens,315,5,8,14,8,39,48,-9,38
AaB,315,6,6,14,10,39,47,-8,32
Sonderjyske,315,7,8,6,10,28,29,-1,30
Lyngby,315,8,4,9,11,28,44,-16,21
Silkeborg IF,315,9,6,3,13,27,45,-18,21
Randers FC,315,10,5,6,13,23,41,-18,21
AGF Aarhus,315,11,4,6,12,17,38,-21,18
Brondby,316,1,20,5,5,68,39,29,65
FC Midtjylla,316,2,20,4,6,64,38,26,64
FC Nords,316,3,15,7,8,77,52,25,52
Copenhagen,316,4,14,7,9,63,42,21,49
AaB,316,5,7,13,10,37,44,-7,34
Sonderjyske,316,6,8,6,10,28,29,-1,30
AC Horsens,316,7,5,14,11,35,55,-20,29
Randers FC,316,8,5,7,12,24,40,-16,22
Silkeborg IF,316,9,6,3,13,28,44,-16,21
Lyngby,316,10,3,10,11,27,45,-18,19
AGF Aarhus,316,11,4,6,12,16,39,-23,18
Brondby,317,1,22,6,2,68,28,40,72
FC Midtjylla,317,2,20,5,5,68,39,29,65
FC Nords,317,3,14,6,10,74,55,19,48
Copenhagen,317,4,13,4,13,56,47,9,43
AC Horsens,317,5,7,14,9,38,52,-14,35
AaB,317,6,6,13,11,36,45,-9,31
Sonderjyske,317,7,8,6,10,28,29,-1,30
Lyngby,317,8,4,9,11,28,45,-17,21
Randers FC,317,9,5,6,13,24,41,-17,21
Silkeborg IF,317,10,6,3,13,27,45,-18,21
AGF Aarhus,317,11,4,6,12,17,38,-21,18
Brondby,318,1,22,6,2,76,34,42,72
FC Midtjylla,318,2,20,5,5,65,37,28,65
Copenhagen,318,3,14,6,10,60,45,15,48
FC Nords,318,4,13,6,11,73,59,14,45
AaB,318,5,7,11,12,34,43,-9,32
AC Horsens,318,6,6,14,10,37,53,-16,32
Sonderjyske,318,7,8,6,10,28,29,-1,30
Lyngby,318,8,4,9,11,28,45,-17,21
Randers FC,318,9,5,6,13,24,41,-17,21
Silkeborg IF,318,10,6,3,13,26,44,-18,21
AGF Aarhus,318,11,4,6,12,16,37,-21,18
Brondby,319,1,22,6,2,76,33,43,72
FC Midtjylla,319,2,19,5,6,72,40,32,62
FC Nords,319,3,15,6,9,72,48,24,51
Copenhagen,319,4,13,4,13,58,50,8,43
AaB,319,5,8,11,11,38,46,-8,35
AC Horsens,319,6,7,12,11,34,59,-25,33
Sonderjyske,319,7,8,6,10,28,29,-1,30
Randers FC,319,8,6,6,12,24,39,-15,24
Silkeborg IF,319,9,6,3,13,29,44,-15,21
Lyngby,319,10,3,9,12,26,45,-19,18
AGF Aarhus,319,11,4,6,12,16,40,-24,18
Brondby,320,1,21,5,4,72,32,40,68
FC Midtjylla,320,2,20,6,4,68,36,32,66
FC Nords,320,3,14,7,9,72,54,18,49
Copenhagen,320,4,13,6,11,57,46,11,45
AaB,320,5,7,13,10,35,44,-9,34
Sonderjyske,320,6,8,6,10,28,29,-1,30
AC Horsens,320,7,5,15,10,31,49,-18,30
Lyngby,320,8,4,9,11,27,44,-17,21
Randers FC,320,9,5,6,13,23,40,-17,21
Silkeborg IF,320,10,5,4,13,26,45,-19,19
AGF Aarhus,320,11,4,7,11,17,37,-20,19
Brondby,321,1,20,7,3,67,33,34,67
FC Midtjylla,321,2,20,5,5,68,40,28,65
FC Nords,321,3,13,8,9,73,53,20,47
Copenhagen,321,4,13,6,11,57,44,13,45
AaB,321,5,8,12,10,39,41,-2,36
AC Horsens,321,6,5,16,9,31,50,-19,31
Sonderjyske,321,7,8,6,10,28,29,-1,30
Lyngby,321,8,4,9,11,29,45,-16,21
AGF Aarhus,321,9,5,6,11,20,36,-16,21
Randers FC,321,10,5,6,13,24,42,-18,21
Silkeborg IF,321,11,5,3,14,25,48,-23,18
Brondby,322,1,21,6,3,68,31,37,69
FC Midtjylla,322,2,20,6,4,66,38,28,66
Copenhagen,322,3,15,5,10,59,41,18,50
FC Nords,322,4,14,7,9,72,52,20,49
AaB,322,5,7,12,11,36,43,-7,33
Sonderjyske,322,6,8,6,10,28,29,-1,30
AC Horsens,322,7,5,12,13,33,55,-22,27
Lyngby,322,8,4,9,11,28,44,-16,21
Silkeborg IF,322,8,6,3,13,28,44,-16,21
Randers FC,322,10,5,6,13,23,41,-18,21
AGF Aarhus,322,11,4,6,12,16,39,-23,18
Brondby,323,1,22,6,2,74,34,40,72
FC Midtjylla,323,2,20,4,6,70,42,28,64
FC Nords,323,3,14,7,9,75,52,23,49
Copenhagen,323,4,13,5,12,59,51,8,44
AC Horsens,323,5,7,13,10,34,50,-16,34
AaB,323,6,7,11,12,35,44,-9,32
Sonderjyske,323,7,8,6,10,28,29,-1,30
Randers FC,323,8,5,7,12,24,40,-16,22
AGF Aarhus,323,9,5,6,11,17,36,-19,21
Lyngby,323,10,3,10,11,27,45,-18,19
Silkeborg IF,323,11,5,3,14,25,45,-20,18
FC Midtjylla,324,1,21,4,5,66,38,28,67
Brondby,324,2,20,5,5,71,37,34,65
FC Nords,324,3,16,6,8,80,50,30,54
Copenhagen,324,4,13,5,12,56,45,11,44
AC Horsens,324,5,7,13,10,37,55,-18,34
AaB,324,6,7,11,12,37,48,-11,32
Sonderjyske,324,7,8,6,10,28,29,-1,30
Randers FC,324,8,6,6,12,24,39,-15,24
AGF Aarhus,324,9,5,6,11,19,38,-19,21
Lyngby,324,10,3,9,12,26,45,-19,18
Silkeborg IF,324,11,5,3,14,27,47,-20,18
Brondby,325,1,21,5,4,74,36,38,68
FC Midtjylla,325,2,20,4,6,69,40,29,64
Copenhagen,325,3,15,5,10,60,44,16,50
FC Nords,325,4,13,7,10,72,58,14,46
AC Horsens,325,5,8,12,10,39,53,-14,36
AaB,325,6,7,11,12,37,46,-9,32
Sonderjyske,325,7,8,6,10,28,29,-1,30
Randers FC,325,8,5,7,12,23,39,-16,22
Silkeborg IF,325,9,6,3,13,28,46,-18,21
Lyngby,325,10,3,10,11,26,44,-18,19
AGF Aarhus,325,11,4,6,12,18,39,-21,18
Brondby,326,1,19,8,3,68,33,35,65
FC Midtjylla,326,2,20,5,5,68,40,28,65
FC Nords,326,3,14,8,8,74,52,22,50
Copenhagen,326,4,15,5,10,59,39,20,50
AaB,326,5,7,12,11,37,47,-10,33
Sonderjyske,326,6,8,6,10,28,29,-1,30
AC Horsens,326,7,5,14,11,34,55,-21,29
Randers FC,326,8,5,7,12,23,39,-16,22
Silkeborg IF,326,9,6,3,13,27,45,-18,21
Lyngby,326,10,3,10,11,26,44,-18,19
AGF Aarhus,326,11,4,6,12,17,38,-21,18
Brondby,327,1,21,7,2,74,31,43,70
FC Midtjylla,327,2,20,5,5,64,38,26,65
FC Nords,327,3,15,6,9,72,54,18,51
Copenhagen,327,4,12,6,12,55,45,10,42
AaB,327,5,8,11,11,34,40,-6,35
AC Horsens,327,6,6,13,11,35,52,-17,31
Sonderjyske,327,7,8,6,10,28,29,-1,30
Randers FC,327,8,5,7,12,24,40,-16,22
Silkeborg IF,327,9,6,3,13,27,45,-18,21
Lyngby,327,10,3,10,11,27,45,-18,19
AGF Aarhus,327,11,4,6,12,17,38,-21,18
Brondby,328,1,22,5,3,73,31,42,71
FC Midtjylla,328,2,21,4,5,69,41,28,67
FC Nords,328,3,15,6,9,73,50,23,51
Copenhagen,328,4,13,4,13,57,50,7,43
AC Horsens,328,5,7,12,11,40,56,-16,33
AaB,328,6,7,11,12,37,47,-10,32
Sonderjyske,328,7,8,6,10,28,29,-1,30
Randers FC,328,8,5,7,12,25,41,-16,22
Lyngby,328,9,3,10,11,28,46,-18,19
Silkeborg IF,328,10,5,4,13,26,45,-19,19
AGF Aarhus,328,11,4,7,11,17,37,-20,19
Brondby,329,1,20,6,4,70,36,34,66
FC Midtjylla,329,2,20,5,5,70,38,32,65
Copenhagen,329,3,14,4,12,60,46,14,46
FC Nords,329,4,12,7,11,71,58,13,43
AaB,329,5,9,12,9,39,39,0,39
AC Horsens,329,6,8,12,10,37,56,-19,36
Sonderjyske,329,7,8,6,10,28,29,-1,30
Lyngby,329,8,4,9,11,29,46,-17,21
Randers FC,329,9,5,6,13,25,42,-17,21
Silkeborg IF,329,10,5,4,13,26,45,-19,19
AGF Aarhus,329,11,4,7,11,17,37,-20,19
Brondby,330,1,22,5,3,75,30,45,71
FC Midtjylla,330,2,20,4,6,66,42,24,64
FC Nords,330,3,14,8,8,72,49,23,50
Copenhagen,330,4,14,5,11,57,41,16,47
AC Horsens,330,5,6,14,10,34,54,-20,32
Sonderjyske,330,6,8,6,10,28,29,-1,30
AaB,330,7,6,12,12,34,48,-14,30
Lyngby,330,8,4,9,11,31,44,-13,21
Silkeborg IF,330,9,6,3,13,27,44,-17,21
Randers FC,330,10,5,6,13,23,44,-21,21
AGF Aarhus,330,11,4,6,12,16,38,-22,18
Brondby,331,1,21,6,3,75,34,41,69
FC Midtjylla,331,2,21,4,5,69,38,31,67
FC Nords,331,3,16,6,8,76,52,24,54
Copenhagen,331,4,14,5,11,55,44,11,47
Sonderjyske,331,5,8,6,10,28,29,-1,30
AC Horsens,331,6,6,12,12,32,54,-22,30
AaB,331,7,6,11,13,36,47,-11,29
Lyngby,331,8,4,9,11,28,44,-16,21
Silkeborg IF,331,8,6,3,13,28,44,-16,21
Randers FC,331,10,5,6,13,23,41,-18,21
AGF Aarhus,331,11,4,6,12,16,39,-23,18
Brondby,332,1,22,5,3,71,30,41,71
FC Midtjylla,332,2,20,5,5,66,38,28,65
FC Nords,332,3,15,6,9,72,48,24,51
Copenhagen,332,4,13,5,12,57,47,10,44
AaB,332,5,7,12,11,35,41,-6,33
AC Horsens,332,6,6,13,11,37,60,-23,31
Sonderjyske,332,7,8,6,10,28,29,-1,30
Randers FC,332,8,5,7,12,26,42,-16,22
Lyngby,332,9,3,10,11,29,47,-18,19
Silkeborg IF,332,10,5,4,13,27,46,-19,19
AGF Aarhus,332,11,4,7,11,18,38,-20,19
Brondby,333,1,21,7,2,72,28,44,70
FC Midtjylla,333,2,21,5,4,73,39,34,68
FC Nords,333,3,13,8,9,73,51,22,47
Copenhagen,333,4,13,5,12,55,46,9,44
AaB,333,5,7,13,10,36,45,-9,34
Sonderjyske,333,6,8,6,10,28,29,-1,30
AC Horsens,333,7,5,14,11,33,59,-26,29
Randers FC,333,8,6,6,12,26,41,-15,24
Silkeborg IF,333,9,6,3,13,30,46,-16,21
Lyngby,333,10,3,9,12,28,47,-19,18
AGF Aarhus,333,11,4,6,12,18,41,-23,18
Brondby,334,1,22,5,3,72,33,39,71
FC Midtjylla,334,2,19,4,7,67,40,27,61
FC Nords,334,3,15,6,9,77,51,26,51
Copenhagen,334,4,13,5,12,59,51,8,44
AC Horsens,334,5,8,12,10,36,54,-18,36
AaB,334,6,7,12,11,35,43,-8,33
Sonderjyske,334,7,8,6,10,28,29,-1,30
Randers FC,334,8,6,6,12,26,40,-14,24
AGF Aarhus,334,9,5,6,11,17,36,-19,21
Lyngby,334,10,3,9,12,27,47,-20,18
Silkeborg IF,334,11,5,3,14,25,45,-20,18
Brondby,335,1,21,6,3,67,31,36,69
FC Midtjylla,335,2,21,5,4,73,39,34,68
FC Nords,335,3,14,6,10,74,52,22,48
Copenhagen,335,4,13,4,13,55,50,5,43
AaB,335,5,8,12,10,41,44,-3,36
AC Horsens,335,6,6,13,11,33,53,-20,31
Sonderjyske,335,7,8,6,10,28,29,-1,30
Randers FC,335,8,5,7,12,23,39,-16,22
Lyngby,335,9,3,10,11,26,44,-18,19
Silkeborg IF,335,10,5,4,13,26,45,-19,19
AGF Aarhus,335,11,4,7,11,17,37,-20,19
Brondby,336,1,23,5,2,78,30,48,74
FC Midtjylla,336,2,20,4,6,68,44,24,64
FC Nords,336,3,15,6,9,76,49,27,51
Copenhagen,336,4,13,4,13,55,52,3,43
AaB,336,5,8,11,11,39,47,-8,35
Sonderjyske,336,6,8,6,10,28,29,-1,30
AC Horsens,336,7,6,12,12,35,55,-20,30
Randers FC,336,8,5,7,12,26,42,-16,22
Silkeborg IF,336,9,6,3,13,29,44,-15,21
Lyngby,336,10,3,10,11,29,47,-18,19
AGF Aarhus,336,11,4,6,12,16,40,-24,18
Brondby,337,1,21,6,3,71,31,40,69
FC Midtjylla,337,2,19,5,6,65,42,23,62
Copenhagen,337,3,14,4,12,55,49,6,46
FC Nords,337,4,13,6,11,72,52,20,45
AaB,337,5,9,12,9,39,42,-3,39
AC Horsens,337,6,7,13,10,39,51,-12,34
Sonderjyske,337,7,8,6,10,28,29,-1,30
Lyngby,337,8,4,9,11,27,44,-17,21
Silkeborg IF,337,8,6,3,13,27,44,-17,21
Randers FC,337,10,5,6,13,23,40,-17,21
AGF Aarhus,337,11,4,6,12,16,38,-22,18
Brondby,338,1,22,5,3,73,32,41,71
FC Midtjylla,338,2,21,4,5,69,40,29,67
FC Nords,338,3,16,6,8,79,52,27,54
Copenhagen,338,4,12,5,13,58,50,8,41
AC Horsens,338,5,7,12,11,34,52,-18,33
Sonderjyske,338,6,8,6,10,28,29,-1,30
AaB,338,7,6,12,12,35,48,-13,30
Lyngby,338,8,4,9,11,30,47,-17,21
Randers FC,338,9,5,6,13,26,43,-17,21
AGF Aarhus,338,10,5,6,11,18,37,-19,21
Silkeborg IF,338,11,5,3,14,26,46,-20,18
Brondby,339,1,21,6,3,70,31,39,69
FC Midtjylla,339,2,19,4,7,63,40,23,61
FC Nords,339,3,15,6,9,75,53,22,51
Copenhagen,339,4,14,4,12,59,47,12,46
AaB,339,5,8,11,11,38,45,-7,35
AC Horsens,339,6,7,13,10,36,51,-15,34
Sonderjyske,339,7,8,6,10,28,29,-1,30
Lyngby,339,8,4,9,11,28,45,-17,21
Randers FC,339,9,5,6,13,24,41,-17,21
Silkeborg IF,339,10,5,4,13,26,45,-19,19
AGF Aarhus,339,11,4,7,11,17,37,-20,19
Brondby,340,1,21,6,3,72,33,39,69
FC Midtjylla,340,2,18,5,7,59,39,20,59
FC Nords,340,3,14,7,9,73,52,21,49
Copenhagen,340,4,13,6,11,53,41,12,45
AC Horsens,340,5,8,14,8,36,48,-12,38
AaB,340,6,7,12,11,36,42,-6,33
Sonderjyske,340,7,8,6,10,28,29,-1,30
Lyngby,340,8,4,9,11,29,45,-16,21
Randers FC,340,9,5,6,13,24,42,-18,21
AGF Aarhus,340,10,5,6,11,19,37,-18,21
Silkeborg IF,340,11,5,3,14,26,47,-21,18
Brondby,341,1,19,7,4,74,36,38,64
FC Midtjylla,341,2,19,4,7,62,42,20,61
FC Nords,341,3,13,8,9,71,54,17,47
Copenhagen,341,4,13,6,11,55,45,10,45
AC Horsens,341,5,9,12,9,39,47,-8,39
AaB,341,6,8,13,9,37,40,-3,37
Sonderjyske,341,7,8,6,10,28,29,-1,30
Randers FC,341,8,6,6,12,24,39,-15,24
Silkeborg IF,341,9,5,4,13,26,45,-19,19
AGF Aarhus,341,10,4,7,11,17,37,-20,19
Lyngby,341,11,3,9,12,26,45,-19,18
FC Midtjylla,342,1,20,6,4,64,36,28,66
Brondby,342,2,20,5,5,69,35,34,65
FC Nords,342,3,14,7,9,74,56,18,49
Copenhagen,342,4,13,7,10,60,47,13,46
AaB,342,5,7,13,10,42,45,-3,34
AC Horsens,342,6,6,14,10,37,53,-16,32
Sonderjyske,342,7,8,6,10,28,29,-1,30
Lyngby,342,8,4,9,11,28,45,-17,21
Randers FC,342,9,5,6,13,24,41,-17,21
AGF Aarhus,342,10,5,6,11,19,37,-18,21
Silkeborg IF,342,11,5,3,14,26,47,-21,18
Brondby,343,1,19,6,5,68,36,32,63
FC Midtjylla,343,2,19,6,5,63,37,26,63
FC Nords,343,3,14,6,10,76,57,19,48
Copenhagen,343,4,13,7,10,60,48,12,46
AaB,343,5,9,12,9,43,40,3,39
AC Horsens,343,6,6,15,9,36,54,-18,33
Sonderjyske,343,7,8,6,10,28,29,-1,30
Silkeborg IF,343,8,6,3,13,30,45,-15,21
Lyngby,343,9,4,9,11,28,45,-17,21
Randers FC,343,10,5,6,13,24,41,-17,21
AGF Aarhus,343,11,4,6,12,17,41,-24,18
Brondby,344,1,23,5,2,74,31,43,74
FC Midtjylla,344,2,18,5,7,67,49,18,59
Copenhagen,344,3,15,5,10,66,45,21,50
FC Nords,344,4,13,8,9,71,52,19,47
AaB,344,5,7,13,10,35,42,-7,34
Sonderjyske,344,6,8,6,10,28,29,-1,30
AC Horsens,344,7,6,12,12,37,57,-20,30
Lyngby,344,8,4,9,11,30,44,-14,21
AGF Aarhus,344,9,5,6,11,19,36,-17,21
Randers FC,344,10,5,6,13,23,43,-20,21
Silkeborg IF,344,11,5,3,14,25,47,-22,18
Brondby,345,1,21,5,4,68,33,35,68
FC Midtjylla,345,2,19,4,7,61,39,22,61
Copenhagen,345,3,14,5,11,60,43,17,47
FC Nords,345,4,13,7,10,69,55,14,46
AC Horsens,345,5,9,12,9,42,51,-9,39
AaB,345,6,7,13,10,36,41,-5,34
Sonderjyske,345,7,8,6,10,28,29,-1,30
Randers FC,345,8,5,7,12,23,39,-16,22
Silkeborg IF,345,9,6,3,13,26,44,-18,21
Lyngby,345,10,3,10,11,26,44,-18,19
AGF Aarhus,345,11,4,6,12,16,37,-21,18
Brondby,346,1,22,6,2,70,29,41,72
FC Midtjylla,346,2,19,4,7,69,44,25,61
FC Nords,346,3,14,7,9,74,57,17,49
Copenhagen,346,4,14,4,12,57,45,12,46
AaB,346,5,8,11,11,37,42,-5,35
AC Horsens,346,6,7,12,11,37,53,-16,33
Sonderjyske,346,7,8,6,10,28,29,-1,30
Randers FC,346,8,6,6,12,25,39,-14,24
Silkeborg IF,346,9,5,4,13,26,45,-19,19
AGF Aarhus,346,10,4,7,11,17,37,-20,19
Lyngby,346,11,3,9,12,26,46,-20,18
Brondby,347,1,21,5,4,72,35,37,68
FC Midtjylla,347,2,20,4,6,65,40,25,64
Copenhagen,347,3,16,4,10,66,45,21,52
FC Nords,347,4,14,6,10,75,57,18,48
AC Horsens,347,5,7,12,11,36,52,-16,33
AaB,347,6,7,11,12,36,47,-11,32
Sonderjyske,347,7,8,6,10,28,29,-1,30
Lyngby,347,8,4,9,11,27,44,-17,21
Silkeborg IF,347,8,6,3,13,27,44,-17,21
Randers FC,347,10,5,6,13,23,40,-17,21
AGF Aarhus,347,11,4,6,12,16,38,-22,18
FC Midtjylla,348,1,21,4,5,67,37,30,67
Brondby,348,2,19,6,5,67,41,26,63
FC Nords,348,3,14,7,9,71,50,21,49
Copenhagen,348,4,15,4,11,63,46,17,49
AaB,348,5,9,11,10,42,40,2,38
Sonderjyske,348,6,8,6,10,28,29,-1,30
AC Horsens,348,7,5,14,11,35,57,-22,29
Randers FC,348,8,6,6,12,25,40,-15,24
Silkeborg IF,348,9,6,3,13,26,44,-18,21
Lyngby,348,10,3,9,12,27,46,-19,18
AGF Aarhus,348,11,4,6,12,16,37,-21,18
Brondby,349,1,21,7,2,72,30,42,70
FC Midtjylla,349,2,19,6,5,66,38,28,63
FC Nords,349,3,14,6,10,73,55,18,48
Copenhagen,349,4,13,7,10,55,43,12,46
AaB,349,5,7,13,10,41,46,-5,34
Sonderjyske,349,6,8,6,10,28,29,-1,30
AC Horsens,349,7,5,15,10,34,55,-21,30
Randers FC,349,8,5,7,12,24,40,-16,22
Lyngby,349,9,3,10,11,27,45,-18,19
Silkeborg IF,349,10,5,4,13,25,44,-19,19
AGF Aarhus,349,11,4,7,11,16,36,-20,19
Brondby,350,1,22,6,2,74,33,41,72
FC Midtjylla,350,2,18,6,6,67,43,24,60
FC Nords,350,3,15,6,9,75,51,24,51
Copenhagen,350,4,14,5,11,54,43,11,47
AaB,350,5,7,11,12,37,47,-10,32
AC Horsens,350,6,6,14,10,38,54,-16,32
Sonderjyske,350,7,8,6,10,28,29,-1,30
Randers FC,350,8,6,6,12,25,39,-14,24
AGF Aarhus,350,9,5,6,11,18,36,-18,21
Lyngby,350,10,3,9,12,26,46,-20,18
Silkeborg IF,350,11,5,3,14,25,46,-21,18
Brondby,351,1,22,6,2,73,31,42,72
FC Midtjylla,351,2,20,5,5,62,36,26,65
FC Nords,351,3,12,8,10,71,54,17,44
Copenhagen,351,4,13,5,12,58,47,11,44
AC Horsens,351,5,8,12,10,34,50,-16,36
AaB,351,6,6,14,10,36,42,-6,32
Sonderjyske,351,7,8,6,10,28,29,-1,30
Lyngby,351,8,4,9,11,31,45,-14,21
AGF Aarhus,351,9,5,6,11,19,38,-19,21
Randers FC,351,10,5,6,13,24,44,-20,21
Silkeborg IF,351,11,5,3,14,27,47,-20,18
FC Midtjylla,352,1,20,6,4,68,36,32,66
Brondby,352,2,18,8,4,68,35,33,62
FC Nords,352,3,16,6,8,80,54,26,54
Copenhagen,352,4,13,5,12,51,44,7,44
AC Horsens,352,5,7,13,10,34,52,-18,34
AaB,352,6,6,14,10,35,41,-6,32
Sonderjyske,352,7,8,6,10,28,29,-1,30
Randers FC,352,8,5,7,12,24,40,-16,22
AGF Aarhus,352,9,5,6,11,17,36,-19,21
Lyngby,352,10,3,10,11,27,45,-18,19
Silkeborg IF,352,11,5,3,14,25,45,-20,18
Brondby,353,1,21,5,4,72,33,39,68
FC Midtjylla,353,2,19,4,7,66,42,24,61
FC Nords,353,3,15,6,9,79,53,26,51
Copenhagen,353,4,14,5,11,59,45,14,47
AaB,353,5,9,11,10,39,44,-5,38
AC Horsens,353,6,6,13,11,34,58,-24,31
Sonderjyske,353,7,8,6,10,28,29,-1,30
Lyngby,353,8,4,9,11,29,46,-17,21
Silkeborg IF,353,9,6,3,13,27,44,-17,21
Randers FC,353,10,5,6,13,25,42,-17,21
AGF Aarhus,353,11,4,6,12,16,38,-22,18
Brondby,354,1,22,6,2,77,35,42,72
FC Midtjylla,354,2,19,6,5,65,39,26,63
FC Nords,354,3,14,6,10,76,53,23,48
Copenhagen,354,4,13,7,10,58,44,14,46
AC Horsens,354,5,7,13,10,36,53,-17,34
Sonderjyske,354,6,8,6,10,28,29,-1,30
AaB,354,7,6,12,12,33,47,-14,30
Randers FC,354,8,6,6,12,26,39,-13,24
AGF Aarhus,354,9,5,6,11,19,37,-18,21
Lyngby,354,10,3,9,12,26,47,-21,18
Silkeborg IF,354,10,5,3,14,26,47,-21,18
Brondby,355,1,20,6,4,67,32,35,66
FC Midtjylla,355,2,19,4,7,65,41,24,61
FC Nords,355,3,15,7,8,76,51,25,52
Copenhagen,355,4,14,5,11,56,45,11,47
AaB,355,5,8,12,10,40,44,-4,36
AC Horsens,355,6,7,12,11,40,57,-17,33
Sonderjyske,355,7,8,6,10,28,29,-1,30
Randers FC,355,8,5,7,12,23,39,-16,22
AGF Aarhus,355,9,5,6,11,19,37,-18,21
Lyngby,355,10,3,10,11,26,44,-18,19
Silkeborg IF,355,11,5,3,14,26,47,-21,18
Brondby,356,1,22,6,2,73,31,42,72
FC Midtjylla,356,2,19,5,6,68,43,25,62
FC Nords,356,3,15,7,8,78,52,26,52
Copenhagen,356,4,15,4,11,55,43,12,49
AaB,356,5,7,12,11,35,42,-7,33
Sonderjyske,356,6,8,6,10,28,29,-1,30
AC Horsens,356,7,5,12,13,33,57,-24,27
Randers FC,356,8,6,6,12,25,39,-14,24
Silkeborg IF,356,9,6,3,13,26,44,-18,21
Lyngby,356,10,3,9,12,26,46,-20,18
AGF Aarhus,356,11,4,6,12,16,37,-21,18
Brondby,357,1,21,6,3,73,34,39,69
FC Midtjylla,357,2,20,4,6,66,43,23,64
FC Nords,357,3,14,6,10,72,53,19,48
Copenhagen,357,4,14,4,12,61,48,13,46
AaB,357,5,8,12,10,37,41,-4,36
AC Horsens,357,6,6,14,10,34,50,-16,32
Sonderjyske,357,7,8,6,10,28,29,-1,30
Randers FC,357,8,5,7,12,23,39,-16,22
Silkeborg IF,357,9,6,3,13,28,46,-18,21
Lyngby,357,10,3,10,11,26,44,-18,19
AGF Aarhus,357,11,4,6,12,18,39,-21,18
Brondby,358,1,21,6,3,66,27,39,69
FC Midtjylla,358,2,20,5,5,64,38,26,65
FC Nords,358,3,15,6,9,75,50,25,51
Copenhagen,358,4,12,6,12,51,45,6,42
AaB,358,5,9,11,10,36,39,-3,38
Sonderjyske,358,6,8,6,10,28,29,-1,30
AC Horsens,358,7,5,14,11,32,51,-19,29
Lyngby,358,8,4,9,11,28,44,-16,21
Silkeborg IF,358,9,6,3,13,27,45,-18,21
Randers FC,358,10,5,6,13,23,41,-18,21
AGF Aarhus,358,11,4,6,12,17,38,-21,18
FC Midtjylla,359,1,20,4,6,66,40,26,64
Brondby,359,2,19,6,5,66,33,33,63
FC Nords,359,3,13,8,9,71,52,19,47
Copenhagen,359,4,14,5,11,58,48,10,47
AaB,359,5,10,11,9,42,42,0,41
AC Horsens,359,6,6,14,10,35,49,-14,32
Sonderjyske,359,7,8,6,10,28,29,-1,30
Silkeborg IF,359,8,6,3,13,28,44,-16,21
Lyngby,359,9,4,9,11,29,46,-17,21
Randers FC,359,10,5,6,13,25,42,-17,21
AGF Aarhus,359,11,4,6,12,16,39,-23,18
Brondby,360,1,21,6,3,75,35,40,69
FC Midtjylla,360,2,20,4,6,69,42,27,64
FC Nords,360,3,14,6,10,69,54,15,48
Copenhagen,360,4,14,6,10,56,41,15,48
AaB,360,5,7,12,11,37,44,-7,33
AC Horsens,360,6,6,14,10,37,53,-16,32
Sonderjyske,360,7,8,6,10,28,29,-1,30
Randers FC,360,8,6,6,12,25,40,-15,24
AGF Aarhus,360,9,5,6,11,18,37,-19,21
Lyngby,360,10,3,9,12,27,46,-19,18
Silkeborg IF,360,11,5,3,14,26,46,-20,18
Brondby,361,1,19,7,4,67,36,31,64
FC Midtjylla,361,2,19,5,6,66,40,26,62
FC Nords,361,3,15,8,7,72,46,26,53
Copenhagen,361,4,13,4,13,59,50,9,43
AaB,361,5,9,13,8,39,39,0,40
Sonderjyske,361,6,8,6,10,28,29,-1,30
AC Horsens,361,7,5,15,10,33,51,-18,30
Lyngby,361,8,4,9,11,28,44,-16,21
Randers FC,361,9,5,6,13,23,41,-18,21
Silkeborg IF,361,10,5,4,13,26,45,-19,19
AGF Aarhus,361,11,4,7,11,17,37,-20,19
Brondby,362,1,21,6,3,69,30,39,69
FC Midtjylla,362,2,19,4,7,64,42,22,61
FC Nords,362,3,15,7,8,79,56,23,52
Copenhagen,362,4,14,5,11,60,46,14,47
AaB,362,5,7,13,10,35,41,-6,34
AC Horsens,362,6,6,13,11,34,52,-18,31
Sonderjyske,362,7,8,6,10,28,29,-1,30
Lyngby,362,8,4,9,11,30,44,-14,21
Silkeborg IF,362,9,6,3,13,27,45,-18,21
Randers FC,362,10,5,6,13,23,43,-20,21
AGF Aarhus,362,11,4,6,12,17,38,-21,18
Brondby,363,1,22,5,3,70,31,39,71
FC Midtjylla,363,2,21,4,5,66,37,29,67
FC Nords,363,3,13,7,10,71,54,17,46
Copenhagen,363,4,14,4,12,57,45,12,46
AC Horsens,363,5,8,13,9,38,49,-11,37
Sonderjyske,363,6,8,6,10,28,29,-1,30
AaB,363,7,6,11,13,37,49,-12,29
Randers FC,363,8,5,7,12,23,39,-16,22
Lyngby,363,9,3,10,11,26,44,-18,19
Silkeborg IF,363,10,5,4,13,26,45,-19,19
AGF Aarhus,363,11,4,7,11,17,37,-20,19
Brondby,364,1,19,7,4,68,35,33,64
FC Midtjylla,364,2,19,6,5,68,40,28,63
FC Nords,364,3,14,8,8,78,52,26,50
Copenhagen,364,4,13,5,12,54,44,10,44
AC Horsens,364,5,9,12,9,41,52,-11,39
AaB,364,6,7,12,11,35,47,-12,33
Sonderjyske,364,7,8,6,10,28,29,-1,30
Lyngby,364,8,4,9,11,28,45,-17,21
Randers FC,364,9,5,6,13,24,41,-17,21
AGF Aarhus,364,10,5,6,11,20,37,-17,21
Silkeborg IF,364,11,5,3,14,26,48,-22,18
Brondby,365,1,20,6,4,69,33,36,66
FC Midtjylla,365,2,20,6,4,73,43,30,66
FC Nords,365,3,15,6,9,74,50,24,51
Copenhagen,365,4,13,7,10,58,45,13,46
AaB,365,5,7,14,9,39,42,-3,35
Sonderjyske,365,6,8,6,10,28,29,-1,30
AC Horsens,365,7,5,13,12,35,61,-26,28
Randers FC,365,8,5,7,12,23,39,-16,22
Silkeborg IF,365,9,6,3,13,30,44,-14,21
Lyngby,365,10,3,10,11,26,44,-18,19
AGF Aarhus,365,11,4,6,12,16,41,-25,18
Brondby,366,1,22,5,3,73,33,40,71
FC Midtjylla,366,2,19,4,7,61,40,21,61
FC Nords,366,3,16,7,7,79,48,31,55
Copenhagen,366,4,13,5,12,59,50,9,44
AC Horsens,366,5,6,14,10,34,54,-20,32
AaB,366,6,6,13,11,36,43,-7,31
Sonderjyske,366,7,8,6,10,28,29,-1,30
Lyngby,366,8,4,9,11,27,44,-17,21
Randers FC,366,9,5,6,13,23,40,-17,21
Silkeborg IF,366,10,5,4,13,26,45,-19,19
AGF Aarhus,366,11,4,7,11,17,37,-20,19
Brondby,367,1,21,6,3,75,32,43,69
FC Midtjylla,367,2,19,6,5,63,38,25,63
FC Nords,367,3,15,7,8,75,54,21,52
Copenhagen,367,4,15,4,11,63,49,14,49
AC Horsens,367,5,7,12,11,35,54,-19,33
Sonderjyske,367,6,8,6,10,28,29,-1,30
AaB,367,7,6,11,13,34,44,-10,29
Randers FC,367,8,5,7,12,24,40,-16,22
Lyngby,367,9,3,10,11,27,45,-18,19
Silkeborg IF,367,10,5,4,13,26,45,-19,19
AGF Aarhus,367,11,4,7,11,17,37,-20,19
Brondby,368,1,21,6,3,69,30,39,69
FC Midtjylla,368,2,20,5,5,67,40,27,65
FC Nords,368,3,14,6,10,73,50,23,48
Copenhagen,368,4,13,5,12,55,46,9,44
AaB,368,5,8,11,11,37,43,-6,35
AC Horsens,368,6,7,13,10,31,49,-18,34
Sonderjyske,368,7,8,6,10,28,29,-1,30
Randers FC,368,8,5,7,12,26,42,-16,22
Silkeborg IF,368,9,6,3,13,26,44,-18,21
Lyngby,368,10,3,10,11,29,47,-18,19
AGF Aarhus,368,11,4,6,12,16,37,-21,18
Brondby,369,1,21,7,2,73,31,42,70
FC Midtjylla,369,2,19,4,7,65,42,23,61
FC Nords,369,3,15,6,9,70,50,20,51
Copenhagen,369,4,14,6,10,56,42,14,48
AaB,369,5,8,11,11,36,42,-6,35
Sonderjyske,369,6,8,6,10,28,29,-1,30
AC Horsens,369,7,5,14,11,32,51,-19,29
Lyngby,369,8,4,9,11,29,45,-16,21
Silkeborg IF,369,9,6,3,13,26,44,-18,21
Randers FC,369,10,5,6,13,24,42,-18,21
AGF Aarhus,369,11,4,6,12,16,37,-21,18
Brondby,370,1,20,7,3,69,33,36,67
FC Midtjylla,370,2,18,5,7,64,40,24,59
FC Nords,370,3,16,6,8,81,52,29,54
Copenhagen,370,4,13,7,10,59,46,13,46
AaB,370,5,8,12,10,35,42,-7,36
Sonderjyske,370,6,8,6,10,28,29,-1,30
AC Horsens,370,7,5,15,10,34,55,-21,30
Randers FC,370,8,6,6,12,24,39,-15,24
AGF Aarhus,370,9,5,6,11,19,37,-18,21
Lyngby,370,10,3,9,12,26,45,-19,18
Silkeborg IF,370,11,5,3,14,26,47,-21,18
Brondby,371,1,21,6,3,72,32,40,69
FC Midtjylla,371,2,19,5,6,63,38,25,62
FC Nords,371,3,15,6,9,75,52,23,51
Copenhagen,371,4,14,6,10,57,46,11,48
AC Horsens,371,5,7,14,9,33,46,-13,35
Sonderjyske,371,6,8,6,10,28,29,-1,30
AaB,371,7,6,11,13,35,47,-12,29
Lyngby,371,8,4,9,11,30,46,-16,21
Randers FC,371,9,5,6,13,25,43,-18,21
Silkeborg IF,371,10,5,4,13,26,45,-19,19
AGF Aarhus,371,11,4,7,11,17,37,-20,19
Brondby,372,1,23,5,2,76,32,44,74
FC Midtjylla,372,2,19,4,7,61,39,22,61
FC Nords,372,3,14,7,9,70,49,21,49
Copenhagen,372,4,14,6,10,58,44,14,48
AaB,372,5,7,12,11,38,46,-8,33
Sonderjyske,372,6,8,6,10,28,29,-1,30
AC Horsens,372,7,6,12,12,34,53,-19,30
Randers FC,372,8,5,7,12,24,40,-16,22
Silkeborg IF,372,9,6,3,13,28,44,-16,21
Lyngby,372,10,3,10,11,27,45,-18,19
AGF Aarhus,372,11,4,6,12,16,39,-23,18
Brondby,373,1,21,6,3,72,31,41,69
FC Midtjylla,373,2,18,5,7,61,42,19,59
Copenhagen,373,3,15,4,11,60,47,13,49
FC Nords,373,4,13,8,9,71,53,18,47
AaB,373,5,9,12,9,40,41,-1,39
AC Horsens,373,6,6,13,11,38,54,-16,31
Sonderjyske,373,7,8,6,10,28,29,-1,30
Randers FC,373,8,6,6,12,25,40,-15,24
Silkeborg IF,373,9,6,3,13,27,45,-18,21
Lyngby,373,10,3,9,12,27,46,-19,18
AGF Aarhus,373,11,4,6,12,17,38,-21,18
Brondby,374,1,20,5,5,68,35,33,65
FC Midtjylla,374,2,19,6,5,65,40,25,63
Copenhagen,374,3,16,4,10,61,43,18,52
FC Nords,374,4,12,9,9,71,54,17,45
AaB,374,5,9,13,8,42,41,1,40
Sonderjyske,374,6,8,6,10,28,29,-1,30
AC Horsens,374,7,5,13,12,35,55,-20,28
Randers FC,374,8,5,7,12,26,42,-16,22
Silkeborg IF,374,9,6,3,13,26,44,-18,21
Lyngby,374,10,3,10,11,29,47,-18,19
AGF Aarhus,374,11,4,6,12,16,37,-21,18
FC Midtjylla,375,1,20,6,4,69,36,33,66
Brondby,375,2,20,6,4,71,39,32,66
FC Nords,375,3,13,9,8,69,50,19,48
Copenhagen,375,4,13,5,12,58,48,10,44
AaB,375,5,7,13,10,36,41,-5,34
AC Horsens,375,6,7,13,10,41,56,-15,34
Sonderjyske,375,7,8,6,10,28,29,-1,30
Lyngby,375,8,4,9,11,29,44,-15,21
Randers FC,375,9,5,6,13,23,42,-19,21
AGF Aarhus,375,10,5,6,11,18,37,-19,21
Silkeborg IF,375,11,5,3,14,26,46,-20,18
Brondby,376,1,21,5,4,69,31,38,68
FC Midtjylla,376,2,19,5,6,62,37,25,62
FC Nords,376,3,16,6,8,77,49,28,54
Copenhagen,376,4,14,4,12,56,44,12,46
AaB,376,5,8,11,11,37,41,-4,35
AC Horsens,376,6,6,13,11,35,60,-25,31
Sonderjyske,376,7,8,6,10,28,29,-1,30
Lyngby,376,8,4,9,11,31,44,-13,21
Silkeborg IF,376,9,6,3,13,27,45,-18,21
Randers FC,376,10,5,6,13,23,44,-21,21
AGF Aarhus,376,11,4,6,12,17,38,-21,18
Brondby,377,1,21,5,4,71,35,36,68
FC Midtjylla,377,2,19,6,5,66,38,28,63
FC Nords,377,3,15,7,8,75,50,25,52
Copenhagen,377,4,13,4,13,53,44,9,43
AaB,377,5,9,11,10,37,46,-9,38
AC Horsens,377,6,6,13,11,37,52,-15,31
Sonderjyske,377,7,8,6,10,28,29,-1,30
Randers FC,377,8,5,7,12,24,40,-16,22
AGF Aarhus,377,9,5,6,11,17,36,-19,21
Lyngby,377,10,3,10,11,27,45,-18,19
Silkeborg IF,377,11,5,3,14,25,45,-20,18
FC Midtjylla,378,1,21,4,5,67,37,30,67
Brondby,378,2,20,6,4,69,33,36,66
FC Nords,378,3,13,9,8,74,52,22,48
Copenhagen,378,4,13,7,10,57,46,11,46
AaB,378,5,6,14,10,36,43,-7,32
AC Horsens,378,6,6,14,10,33,51,-18,32
Sonderjyske,378,7,8,6,10,28,29,-1,30
Randers FC,378,8,6,6,12,25,39,-14,24
AGF Aarhus,378,9,5,6,11,19,36,-17,21
Lyngby,378,10,3,9,12,26,46,-20,18
Silkeborg IF,378,11,5,3,14,25,47,-22,18
Brondby,379,1,21,6,3,73,33,40,69
FC Midtjylla,379,2,19,5,6,64,44,20,62
FC Nords,379,3,15,6,9,79,55,24,51
Copenhagen,379,4,13,5,12,60,47,13,44
AaB,379,5,8,11,11,38,44,-6,35
AC Horsens,379,6,7,13,10,36,53,-17,34
Sonderjyske,379,7,8,6,10,28,29,-1,30
Randers FC,379,8,5,7,12,24,40,-16,22
Lyngby,379,9,3,10,11,27,45,-18,19
Silkeborg IF,379,10,5,4,13,25,44,-19,19
AGF Aarhus,379,11,4,7,11,16,36,-20,19
Brondby,380,1,22,6,2,71,29,42,72
FC Midtjylla,380,2,20,6,4,65,38,27,66
Copenhagen,380,3,15,5,10,58,43,15,50
FC Nords,380,4,14,6,10,71,51,20,48
AaB,380,5,7,11,12,38,45,-7,32
Sonderjyske,380,6,8,6,10,28,29,-1,30
AC Horsens,380,7,5,12,13,33,56,-23,27
Lyngby,380,8,4,9,11,27,44,-17,21
Randers FC,380,9,5,6,13,23,40,-17,21
Silkeborg IF,380,10,6,3,13,26,44,-18,21
AGF Aarhus,380,11,4,6,12,16,37,-21,18
Brondby,381,1,21,5,4,67,30,37,68
FC Midtjylla,381,2,19,4,7,62,38,24,61
FC Nords,381,3,14,7,9,74,50,24,49
Copenhagen,381,4,14,5,11,58,47,11,47
AC Horsens,381,5,8,12,10,35,51,-16,36
AaB,381,6,7,13,10,40,46,-6,34
Sonderjyske,381,7,8,6,10,28,29,-1,30
Lyngby,381,8,4,9,11,29,45,-16,21
Randers FC,381,9,5,6,13,24,42,-18,21
AGF Aarhus,381,10,5,6,11,18,37,-19,21
Silkeborg IF,381,11,5,3,14,26,46,-20,18
Brondby,382,1,21,6,3,69,32,37,69
FC Midtjylla,382,2,18,6,6,61,38,23,60
FC Nords,382,3,14,7,9,72,50,22,49
Copenhagen,382,4,14,6,10,58,43,15,48
AC Horsens,382,5,8,12,10,33,49,-16,36
AaB,382,6,6,13,11,34,41,-7,31
Sonderjyske,382,7,8,6,10,28,29,-1,30
Silkeborg IF,382,8,6,3,13,28,45,-17,21
Lyngby,382,9,4,9,11,27,44,-17,21
Randers FC,382,10,5,6,13,23,40,-17,21
AGF Aarhus,382,11,4,6,12,17,39,-22,18
Brondby,383,1,21,5,4,73,35,38,68
FC Midtjylla,383,2,17,7,6,63,45,18,58
FC Nords,383,3,15,7,8,74,50,24,52
Copenhagen,383,4,15,4,11,60,45,15,49
AaB,383,5,8,12,10,39,41,-2,36
AC Horsens,383,6,6,13,11,34,53,-19,31
Sonderjyske,383,7,8,6,10,28,29,-1,30
Randers FC,383,8,6,6,12,25,40,-15,24
AGF Aarhus,383,9,5,6,11,18,37,-19,21
Lyngby,383,10,3,9,12,27,46,-19,18
Silkeborg IF,383,11,5,3,14,26,46,-20,18
Brondby,384,1,21,7,2,72,29,43,70
FC Midtjylla,384,2,20,6,4,69,37,32,66
Copenhagen,384,3,14,7,9,59,42,17,49
FC Nords,384,4,13,7,10,73,55,18,46
AaB,384,5,8,11,11,38,45,-7,35
Sonderjyske,384,6,8,6,10,28,29,-1,30
AC Horsens,384,7,5,12,13,32,61,-29,27
Randers FC,384,8,6,6,12,24,39,-15,24
AGF Aarhus,384,9,5,6,11,17,36,-19,21
Lyngby,384,10,3,9,12,26,45,-19,18
Silkeborg IF,384,11,5,3,14,25,45,-20,18
Brondby,385,1,19,8,3,72,38,34,65
FC Midtjylla,385,2,19,5,6,59,36,23,62
Copenhagen,385,3,17,4,9,66,41,25,55
FC Nords,385,4,14,8,8,75,54,21,50
AaB,385,5,7,11,12,42,50,-8,32
Sonderjyske,385,6,8,6,10,28,29,-1,30
AC Horsens,385,7,5,14,11,32,53,-21,29
Lyngby,385,8,4,9,11,28,45,-17,21
Randers FC,385,9,5,6,13,24,41,-17,21
Silkeborg IF,385,10,6,3,13,26,44,-18,21
AGF Aarhus,385,11,4,6,12,16,37,-21,18
Brondby,386,1,20,7,3,70,33,37,67
FC Midtjylla,386,2,19,6,5,65,40,25,63
Copenhagen,386,3,15,5,10,60,46,14,50
FC Nords,386,4,14,7,9,75,52,23,49
AaB,386,5,7,12,11,37,44,-7,33
AC Horsens,386,6,6,13,11,38,56,-18,31
Sonderjyske,386,7,8,6,10,28,29,-1,30
Randers FC,386,8,6,6,12,26,39,-13,24
Silkeborg IF,386,9,6,3,13,28,45,-17,21
Lyngby,386,10,3,9,12,26,47,-21,18
AGF Aarhus,386,11,4,6,12,17,39,-22,18
Brondby,387,1,21,5,4,69,33,36,68
FC Midtjylla,387,2,18,5,7,65,42,23,59
FC Nords,387,3,15,7,8,74,50,24,52
Copenhagen,387,4,13,5,12,55,45,10,44
AC Horsens,387,5,8,13,9,38,53,-15,37
AaB,387,6,8,11,11,37,41,-4,35
Sonderjyske,387,7,8,6,10,28,29,-1,30
Randers FC,387,8,6,6,12,24,39,-15,24
AGF Aarhus,387,9,5,6,11,20,36,-16,21
Lyngby,387,10,3,9,12,26,45,-19,18
Silkeborg IF,387,11,5,3,14,25,48,-23,18
Brondby,388,1,21,7,2,72,32,40,70
FC Midtjylla,388,2,20,6,4,68,38,30,66
Copenhagen,388,3,13,7,10,56,43,13,46
FC Nords,388,4,13,6,11,71,59,12,45
AaB,388,5,8,12,10,39,43,-4,36
Sonderjyske,388,6,8,6,10,28,29,-1,30
AC Horsens,388,7,6,12,12,36,53,-17,30
Lyngby,388,8,4,9,11,29,46,-17,21
Randers FC,388,9,5,6,13,25,42,-17,21
Silkeborg IF,388,10,6,3,13,26,44,-18,21
AGF Aarhus,388,11,4,6,12,16,37,-21,18
Brondby,389,1,21,6,3,69,32,37,69
FC Midtjylla,389,2,20,5,5,65,34,31,65
FC Nords,389,3,14,8,8,72,51,21,50
Copenhagen,389,4,12,5,13,55,47,8,41
AaB,389,5,8,12,10,35,43,-8,36
AC Horsens,389,6,6,14,10,35,50,-15,32
Sonderjyske,389,7,8,6,10,28,29,-1,30
Lyngby,389,8,4,9,11,28,45,-17,21
Randers FC,389,9,5,6,13,24,41,-17,21
Silkeborg IF,389,10,5,4,13,27,46,-19,19
AGF Aarhus,389,11,4,7,11,18,38,-20,19
Brondby,390,1,21,5,4,68,34,34,68
FC Midtjylla,390,2,20,4,6,68,39,29,64
FC Nords,390,3,15,7,8,76,48,28,52
Copenhagen,390,4,13,5,12,58,49,9,44
AaB,390,5,8,13,9,40,42,-2,37
Sonderjyske,390,6,8,6,10,28,29,-1,30
AC Horsens,390,7,5,14,11,35,59,-24,29
Randers FC,390,8,6,6,12,24,39,-15,24
AGF Aarhus,390,9,5,6,11,18,37,-19,21
Lyngby,390,10,3,9,12,26,45,-19,18
Silkeborg IF,390,11,5,3,14,26,46,-20,18
Brondby,391,1,21,6,3,74,35,39,69
FC Midtjylla,391,2,19,4,7,63,41,22,61
FC Nords,391,3,14,7,9,77,57,20,49
Copenhagen,391,4,14,5,11,59,48,11,47
AaB,391,5,9,13,8,41,40,1,40
Sonderjyske,391,6,8,6,10,28,29,-1,30
AC Horsens,391,7,5,13,12,35,54,-19,28
Lyngby,391,8,4,9,11,32,44,-12,21
AGF Aarhus,391,9,5,6,11,19,36,-17,21
Randers FC,391,10,5,6,13,23,45,-22,21
Silkeborg IF,391,11,5,3,14,25,47,-22,18
Brondby,392,1,20,7,3,71,32,39,67
FC Midtjylla,392,2,20,5,5,66,38,28,65
FC Nords,392,3,14,6,10,69,52,17,48
Copenhagen,392,4,13,6,11,57,44,13,45
AaB,392,5,8,12,10,35,39,-4,36
AC Horsens,392,6,7,12,11,37,56,-19,33
Sonderjyske,392,7,8,6,10,28,29,-1,30
Lyngby,392,8,4,9,11,28,45,-17,21
Randers FC,392,9,5,6,13,24,41,-17,21
Silkeborg IF,392,10,6,3,13,26,44,-18,21
AGF Aarhus,392,11,4,6,12,16,37,-21,18
Brondby,393,1,20,7,3,70,33,37,67
FC Midtjylla,393,2,18,5,7,66,43,23,59
FC Nords,393,3,14,7,9,75,53,22,49
Copenhagen,393,4,14,6,10,57,43,14,48
AaB,393,5,10,11,9,43,42,1,41
Sonderjyske,393,6,8,6,10,28,29,-1,30
AC Horsens,393,7,5,14,11,34,57,-23,29
Lyngby,393,8,4,9,11,28,44,-16,21
Randers FC,393,9,5,6,13,23,41,-18,21
Silkeborg IF,393,10,5,4,13,25,44,-19,19
AGF Aarhus,393,11,4,7,11,16,36,-20,19
Brondby,394,1,22,5,3,77,31,46,71
FC Midtjylla,394,2,19,6,5,65,39,26,63
Copenhagen,394,3,14,5,11,59,45,14,47
FC Nords,394,4,13,7,10,71,57,14,46
AaB,394,5,8,11,11,35,40,-5,35
AC Horsens,394,6,7,12,11,32,53,-21,33
Sonderjyske,394,7,8,6,10,28,29,-1,30
Lyngby,394,8,4,9,11,28,44,-16,21
Randers FC,394,9,5,6,13,23,41,-18,21
AGF Aarhus,394,10,5,6,11,17,36,-19,21
Silkeborg IF,394,11,5,3,14,25,45,-20,18
Brondby,395,1,23,5,2,75,29,46,74
FC Midtjylla,395,2,18,6,6,63,41,22,60
FC Nords,395,3,14,8,8,74,52,22,50
Copenhagen,395,4,15,4,11,60,46,14,49
AaB,395,5,6,13,11,35,45,-10,31
Sonderjyske,395,6,8,6,10,28,29,-1,30
AC Horsens,395,7,5,14,11,35,55,-20,29
Lyngby,395,8,4,9,11,27,44,-17,21
Randers FC,395,9,5,6,13,23,40,-17,21
AGF Aarhus,395,10,5,6,11,18,37,-19,21
Silkeborg IF,395,11,5,3,14,26,46,-20,18
Brondby,396,1,21,7,2,73,33,40,70
FC Midtjylla,396,2,20,4,6,65,39,26,64
FC Nords,396,3,13,7,10,73,60,13,46
Copenhagen,396,4,13,6,11,59,45,14,45
AaB,396,5,8,13,9,39,39,0,37
AC Horsens,396,6,6,13,11,32,51,-19,31
Sonderjyske,396,7,8,6,10,28,29,-1,30
Randers FC,396,8,5,7,12,26,42,-16,22
Lyngby,396,9,3,10,11,29,47,-18,19
Silkeborg IF,396,10,5,4,13,26,45,-19,19
AGF Aarhus,396,11,4,7,11,17,37,-20,19
Brondby,397,1,22,6,2,80,30,50,72
FC Midtjylla,397,2,19,4,7,64,40,24,61
Copenhagen,397,3,16,5,9,61,41,20,53
FC Nords,397,4,13,6,11,72,61,11,45
AaB,397,5,8,11,11,39,47,-8,35
Sonderjyske,397,6,8,6,10,28,29,-1,30
AC Horsens,397,7,6,12,12,33,56,-23,30
Randers FC,397,8,5,7,12,24,40,-16,22
Lyngby,397,9,3,10,11,27,45,-18,19
Silkeborg IF,397,10,5,4,13,25,44,-19,19
AGF Aarhus,397,11,4,7,11,16,36,-20,19
Brondby,398,1,21,7,2,78,33,45,70
FC Midtjylla,398,2,20,5,5,73,42,31,65
FC Nords,398,3,14,7,9,72,50,22,49
Copenhagen,398,4,12,5,13,53,44,9,41
AaB,398,5,8,11,11,36,49,-13,35
AC Horsens,398,6,7,13,10,34,54,-20,34
Sonderjyske,398,7,8,6,10,28,29,-1,30
Lyngby,398,8,4,9,11,27,44,-17,21
Randers FC,398,9,5,6,13,23,40,-17,21
AGF Aarhus,398,10,5,6,11,18,37,-19,21
Silkeborg IF,398,11,5,3,14,26,46,-20,18
Brondby,399,1,22,6,2,73,29,44,72
FC Midtjylla,399,2,20,4,6,67,41,26,64
Copenhagen,399,3,15,5,10,57,43,14,50
FC Nords,399,4,14,6,10,74,56,18,48
AaB,399,5,7,11,12,41,50,-9,32
Sonderjyske,399,6,8,6,10,28,29,-1,30
AC Horsens,399,7,6,12,12,35,54,-19,30
Lyngby,399,8,4,9,11,31,45,-14,21
AGF Aarhus,399,9,5,6,11,18,36,-18,21
Randers FC,399,10,5,6,13,24,44,-20,21
Silkeborg IF,399,11,5,3,14,25,46,-21,18
Brondby,400,1,20,6,4,69,34,35,66
FC Midtjylla,400,2,20,5,5,64,38,26,65
FC Nords,400,3,15,6,9,76,50,26,51
Copenhagen,400,4,13,6,11,55,43,12,45
AaB,400,5,8,12,10,37,42,-5,36
AC Horsens,400,6,6,13,11,34,54,-20,31
Sonderjyske,400,7,8,6,10,28,29,-1,30
Randers FC,400,8,6,6,12,25,39,-14,24
AGF Aarhus,400,9,5,6,11,18,36,-18,21
Lyngby,400,10,3,9,12,26,46,-20,18
Silkeborg IF,400,11,5,3,14,25,46,-21,18
Brondby,401,1,21,5,4,68,34,34,68
FC Midtjylla,401,2,19,4,7,68,43,25,61
FC Nords,401,3,15,6,9,79,54,25,51
Copenhagen,401,4,14,5,11,57,48,9,47
AC Horsens,401,5,8,12,10,44,53,-9,36
AaB,401,6,7,12,11,36,46,-10,33
Sonderjyske,401,7,8,6,10,28,29,-1,30
Randers FC,401,8,5,7,12,23,39,-16,22
Lyngby,401,9,3,10,11,26,44,-18,19
Silkeborg IF,401,10,5,4,13,26,45,-19,19
AGF Aarhus,401,11,4,7,11,17,37,-20,19
Brondby,402,1,20,6,4,69,35,34,66
FC Midtjylla,402,2,18,7,5,62,39,23,61
Copenhagen,402,3,16,5,9,61,39,22,53
FC Nords,402,4,14,7,9,78,54,24,49
AaB,402,5,7,12,11,37,42,-5,33
AC Horsens,402,6,6,13,11,32,56,-24,31
Sonderjyske,402,7,8,6,10,28,29,-1,30
Lyngby,402,8,4,9,11,31,46,-15,21
AGF Aarhus,402,9,5,6,11,19,36,-17,21
Randers FC,402,10,5,6,13,25,44,-19,21
Silkeborg IF,402,11,5,3,14,25,47,-22,18
Brondby,403,1,20,7,3,72,33,39,67
FC Midtjylla,403,2,18,5,7,66,44,22,59
FC Nords,403,3,15,7,8,78,49,29,52
Copenhagen,403,4,13,5,12,57,50,7,44
AaB,403,5,9,13,8,41,40,1,40
AC Horsens,403,6,6,13,11,33,57,-24,31
Sonderjyske,403,7,8,6,10,28,29,-1,30
Lyngby,403,8,4,9,11,27,44,-17,21
Randers FC,403,9,5,6,13,23,40,-17,21
AGF Aarhus,403,10,5,6,11,19,38,-19,21
Silkeborg IF,403,11,5,3,14,27,47,-20,18
Brondby,404,1,20,6,4,71,36,35,66
FC Midtjylla,404,2,17,6,7,58,42,16,57
FC Nords,404,3,16,6,8,75,49,26,54
Copenhagen,404,4,13,5,12,58,48,10,44
AaB,404,5,9,12,9,43,41,2,39
AC Horsens,404,6,6,15,9,40,55,-15,33
Sonderjyske,404,7,8,6,10,28,29,-1,30
Lyngby,404,8,4,9,11,27,44,-17,21
Randers FC,404,9,5,6,13,23,40,-17,21
AGF Aarhus,404,10,5,6,11,17,36,-19,21
Silkeborg IF,404,11,5,3,14,25,45,-20,18
Brondby,405,1,21,5,4,70,33,37,68
FC Midtjylla,405,2,18,6,6,61,39,22,60
FC Nords,405,3,15,7,8,76,51,25,52
Copenhagen,405,4,14,5,11,58,46,12,47
AaB,405,5,7,13,10,38,44,-6,34
AC Horsens,405,6,7,12,11,38,54,-16,33
Sonderjyske,405,7,8,6,10,28,29,-1,30
Lyngby,405,8,4,9,11,27,44,-17,21
Randers FC,405,9,5,6,13,23,40,-17,21
Silkeborg IF,405,10,6,3,13,27,45,-18,21
AGF Aarhus,405,11,4,6,12,17,38,-21,18
Brondby,406,1,22,6,2,75,34,41,72
FC Midtjylla,406,2,18,5,7,63,42,21,59
FC Nords,406,3,15,6,9,76,53,23,51
Copenhagen,406,4,13,5,12,56,47,9,44
AC Horsens,406,5,8,13,9,38,47,-9,37
AaB,406,6,7,11,12,35,46,-11,32
Sonderjyske,406,7,8,6,10,28,29,-1,30
Randers FC,406,8,5,7,12,24,40,-16,22
Silkeborg IF,406,9,6,3,13,27,44,-17,21
Lyngby,406,10,3,10,11,27,45,-18,19
AGF Aarhus,406,11,4,6,12,16,38,-22,18
Brondby,407,1,19,7,4,64,31,33,64
FC Midtjylla,407,2,18,6,6,63,40,23,60
FC Nords,407,3,15,6,9,71,48,23,51
Copenhagen,407,4,15,4,11,58,44,14,49
AC Horsens,407,5,8,13,9,38,49,-11,37
AaB,407,6,7,12,11,34,42,-8,33
Sonderjyske,407,7,8,6,10,28,29,-1,30
Randers FC,407,8,5,7,12,23,39,-16,22
Silkeborg IF,407,9,6,3,13,27,45,-18,21
Lyngby,407,10,3,10,11,26,44,-18,19
AGF Aarhus,407,11,4,6,12,17,38,-21,18
Brondby,408,1,21,6,3,71,30,41,69
FC Midtjylla,408,2,20,4,6,66,42,24,64
FC Nords,408,3,13,8,9,72,53,19,47
Copenhagen,408,4,14,5,11,55,43,12,47
AC Horsens,408,5,6,15,9,37,53,-16,33
AaB,408,6,6,14,10,37,43,-6,32
Sonderjyske,408,7,8,6,10,28,29,-1,30
Lyngby,408,8,4,9,11,29,45,-16,21
Silkeborg IF,408,9,6,3,13,28,45,-17,21
Randers FC,408,10,5,6,13,24,42,-18,21
AGF Aarhus,408,11,4,6,12,17,39,-22,18
Brondby,409,1,22,6,2,72,31,41,72
FC Midtjylla,409,2,20,4,6,64,36,28,64
FC Nords,409,3,14,6,10,72,54,18,48
Copenhagen,409,4,14,5,11,56,45,11,47
AaB,409,5,8,12,10,34,38,-4,36
Sonderjyske,409,6,8,6,10,28,29,-1,30
AC Horsens,409,7,5,13,12,29,49,-20,28
Lyngby,409,8,4,9,11,28,44,-16,21
Randers FC,409,9,5,6,13,23,41,-18,21
Silkeborg IF,409,10,5,4,13,25,44,-19,19
AGF Aarhus,409,11,4,7,11,16,36,-20,19
Brondby,410,1,21,6,3,72,32,40,69
FC Midtjylla,410,2,19,4,7,63,43,20,61
FC Nords,410,3,16,6,8,79,47,32,54
Copenhagen,410,4,13,4,13,59,49,10,43
AaB,410,5,8,11,11,35,46,-11,35
AC Horsens,410,6,7,13,10,39,56,-17,34
Sonderjyske,410,7,8,6,10,28,29,-1,30
Randers FC,410,8,5,7,12,23,39,-16,22
Lyngby,410,9,3,10,11,26,44,-18,19
Silkeborg IF,410,10,5,4,13,27,46,-19,19
AGF Aarhus,410,11,4,7,11,18,38,-20,19
Brondby,411,1,21,6,3,70,31,39,69
FC Midtjylla,411,2,20,5,5,69,35,34,65
FC Nords,411,3,14,7,9,71,49,22,49
Copenhagen,411,4,15,4,11,60,47,13,49
AaB,411,5,7,12,11,36,47,-11,33
Sonderjyske,411,6,8,6,10,28,29,-1,30
AC Horsens,411,7,5,14,11,31,54,-23,29
Lyngby,411,8,4,9,11,29,45,-16,21
Silkeborg IF,411,9,6,3,13,27,44,-17,21
Randers FC,411,10,5,6,13,24,42,-18,21
AGF Aarhus,411,11,4,6,12,16,38,-22,18
Brondby,412,1,20,7,3,68,31,37,67
FC Midtjylla,412,2,19,7,4,65,39,26,64
FC Nords,412,3,14,8,8,72,49,23,50
Copenhagen,412,4,12,9,9,55,42,13,45
AC Horsens,412,5,6,15,9,35,50,-15,33
Sonderjyske,412,6,8,6,10,28,29,-1,30
AaB,412,7,6,12,12,36,46,-10,30
Randers FC,412,8,6,6,12,25,39,-14,24
Silkeborg IF,412,9,6,3,13,27,45,-18,21
Lyngby,412,10,3,9,12,26,46,-20,18
AGF Aarhus,412,11,4,6,12,17,38,-21,18
FC Midtjylla,413,1,21,5,4,72,36,36,68
Brondby,413,2,20,6,4,73,35,38,66
FC Nords,413,3,13,8,9,71,55,16,47
Copenhagen,413,4,13,6,11,58,46,12,45
AaB,413,5,8,12,10,37,42,-5,36
AC Horsens,413,6,6,13,11,33,56,-23,31
Sonderjyske,413,7,8,6,10,28,29,-1,30
Randers FC,413,8,5,7,12,23,39,-16,22
Silkeborg IF,413,9,6,3,13,30,45,-15,21
Lyngby,413,10,3,10,11,26,44,-18,19
AGF Aarhus,413,11,4,6,12,17,41,-24,18
Brondby,414,1,21,6,3,72,31,41,69
FC Midtjylla,414,2,18,7,5,62,39,23,61
FC Nords,414,3,15,6,9,77,53,24,51
Copenhagen,414,4,14,4,12,59,48,11,46
AaB,414,5,8,12,10,37,44,-7,36
AC Horsens,414,6,6,13,11,36,54,-18,31
Sonderjyske,414,7,8,6,10,28,29,-1,30
Randers FC,414,8,6,6,12,26,40,-14,24
Silkeborg IF,414,9,6,3,13,26,44,-18,21
Lyngby,414,10,3,9,12,27,47,-20,18
AGF Aarhus,414,11,4,6,12,16,37,-21,18
Brondby,415,1,21,7,2,68,29,39,70
FC Midtjylla,415,2,19,5,6,64,40,24,62
FC Nords,415,3,16,6,8,72,48,24,54
Copenhagen,415,4,12,7,11,55,45,10,43
AC Horsens,415,5,6,14,10,35,51,-16,32
AaB,415,6,6,13,11,39,46,-7,31
Sonderjyske,415,7,8,6,10,28,29,-1,30
Randers FC,415,8,6,6,12,24,39,-15,24
AGF Aarhus,415,9,5,6,11,18,37,-19,21
Lyngby,415,10,3,9,12,26,45,-19,18
Silkeborg IF,415,11,5,3,14,26,46,-20,18
Brondby,416,1,22,5,3,75,32,43,71
FC Midtjylla,416,2,19,6,5,62,37,25,63
Copenhagen,416,3,14,5,11,57,45,12,47
FC Nords,416,4,13,7,10,70,53,17,46
AaB,416,5,8,12,10,36,43,-7,36
AC Horsens,416,6,6,13,11,36,52,-16,31
Sonderjyske,416,7,8,6,10,28,29,-1,30
Lyngby,416,8,4,9,11,27,44,-17,21
Randers FC,416,9,5,6,13,23,40,-17,21
Silkeborg IF,416,10,6,3,13,27,45,-18,21
AGF Aarhus,416,11,4,6,12,17,38,-21,18
Brondby,417,1,20,7,3,70,31,39,67
FC Midtjylla,417,2,19,5,6,65,40,25,62
FC Nords,417,3,16,6,8,74,48,26,54
Copenhagen,417,4,13,7,10,56,43,13,46
AaB,417,5,7,11,12,35,46,-11,32
AC Horsens,417,6,6,14,10,31,49,-18,32
Sonderjyske,417,7,8,6,10,28,29,-1,30
Randers FC,417,8,6,6,12,25,40,-15,24
Silkeborg IF,417,9,6,3,13,28,44,-16,21
Lyngby,417,10,3,9,12,27,46,-19,18
AGF Aarhus,417,11,4,6,12,16,39,-23,18
Brondby,418,1,20,6,4,70,33,37,66
FC Midtjylla,418,2,19,4,7,66,40,26,61
Copenhagen,418,3,16,4,10,58,41,17,52
FC Nords,418,4,14,8,8,74,55,19,50
AaB,418,5,7,12,11,34,40,-6,33
AC Horsens,418,6,7,12,11,32,51,-19,33
Sonderjyske,418,7,8,6,10,28,29,-1,30
Lyngby,418,8,4,9,11,28,44,-16,21
Silkeborg IF,418,9,6,3,13,27,45,-18,21
Randers FC,418,10,5,6,13,23,41,-18,21
AGF Aarhus,418,11,4,6,12,17,38,-21,18
Brondby,419,1,22,5,3,71,29,42,71
FC Midtjylla,419,2,19,5,6,61,39,22,62
FC Nords,419,3,15,6,9,78,54,24,51
Copenhagen,419,4,14,4,12,55,43,12,46
AaB,419,5,7,12,11,38,45,-7,33
AC Horsens,419,6,7,12,11,36,55,-19,33
Sonderjyske,419,7,8,6,10,28,29,-1,30
Randers FC,419,8,5,7,12,25,41,-16,22
Silkeborg IF,419,9,6,3,13,28,44,-16,21
Lyngby,419,10,3,10,11,28,46,-18,19
AGF Aarhus,419,11,4,6,12,16,39,-23,18
Brondby,420,1,21,6,3,70,31,39,69
FC Midtjylla,420,2,20,6,4,65,34,31,66
Copenhagen,420,3,14,5,11,57,47,10,47
FC Nords,420,4,13,6,11,69,55,14,45
AaB,420,5,8,11,11,37,40,-3,35
AC Horsens,420,6,7,12,11,32,49,-17,33
Sonderjyske,420,7,8,6,10,28,29,-1,30
Lyngby,420,8,4,9,11,28,44,-16,21
AGF Aarhus,420,9,5,6,11,20,36,-16,21
Randers FC,420,10,5,6,13,23,41,-18,21
Silkeborg IF,420,11,5,3,14,25,48,-23,18
Brondby,421,1,21,6,3,73,32,41,69
FC Nords,421,2,17,6,7,86,50,36,57
FC Midtjylla,421,3,17,5,8,63,45,18,56
Copenhagen,421,4,14,5,11,61,53,8,47
AaB,421,5,6,15,9,36,41,-5,33
AC Horsens,421,6,6,13,11,36,60,-24,31
Sonderjyske,421,7,8,6,10,28,29,-1,30
Randers FC,421,8,6,6,12,26,40,-14,24
Silkeborg IF,421,9,5,4,13,26,45,-19,19
AGF Aarhus,421,10,4,7,11,17,37,-20,19
Lyngby,421,11,3,9,12,27,47,-20,18
FC Midtjylla,422,1,20,5,5,66,40,26,65
Brondby,422,2,19,6,5,67,35,32,63
Copenhagen,422,3,14,5,11,59,45,14,47
FC Nords,422,4,12,10,8,72,52,20,46
AC Horsens,422,5,8,14,8,35,47,-12,38
AaB,422,6,7,12,11,35,41,-6,33
Sonderjyske,422,7,8,6,10,28,29,-1,30
Randers FC,422,8,5,7,12,24,40,-16,22
AGF Aarhus,422,9,5,6,11,18,37,-19,21
Lyngby,422,10,3,10,11,27,45,-18,19
Silkeborg IF,422,11,5,3,14,26,46,-20,18
Brondby,423,1,21,6,3,71,32,39,69
FC Midtjylla,423,2,20,4,6,75,38,37,64
FC Nords,423,3,13,8,9,70,56,14,47
Copenhagen,423,4,14,4,12,57,49,8,46
AaB,423,5,7,13,10,36,44,-8,34
AC Horsens,423,6,7,13,10,38,54,-16,34
Sonderjyske,423,7,8,6,10,28,29,-1,30
Lyngby,423,8,4,9,11,29,44,-15,21
Silkeborg IF,423,8,6,3,13,29,44,-15,21
Randers FC,423,10,5,6,13,23,42,-19,21
AGF Aarhus,423,11,4,6,12,16,40,-24,18
Brondby,424,1,21,6,3,70,28,42,69
FC Midtjylla,424,2,21,5,4,68,36,32,68
FC Nords,424,3,14,8,8,75,52,23,50
Copenhagen,424,4,13,6,11,53,45,8,45
AaB,424,5,7,12,11,36,42,-6,33
Sonderjyske,424,6,8,6,10,28,29,-1,30
AC Horsens,424,7,5,13,12,33,58,-25,28
Lyngby,424,8,4,9,11,28,44,-16,21
Randers FC,424,9,5,6,13,23,41,-18,21
AGF Aarhus,424,10,5,6,11,19,37,-18,21
Silkeborg IF,424,11,5,3,14,26,47,-21,18
FC Midtjylla,425,1,21,4,5,66,36,30,67
Brondby,425,2,19,6,5,67,32,35,63
FC Nords,425,3,14,7,9,69,49,20,49
Copenhagen,425,4,14,5,11,54,42,12,47
AC Horsens,425,5,8,12,10,35,51,-16,36
AaB,425,6,7,12,11,36,43,-7,33
Sonderjyske,425,7,8,6,10,28,29,-1,30
Lyngby,425,8,4,9,11,28,45,-17,21
Randers FC,425,9,5,6,13,24,41,-17,21
Silkeborg IF,425,10,6,3,13,26,44,-18,21
AGF Aarhus,425,11,4,6,12,16,37,-21,18
FC Midtjylla,426,1,21,5,4,68,37,31,68
Brondby,426,2,20,6,4,70,38,32,66
FC Nords,426,3,15,6,9,76,49,27,51
Copenhagen,426,4,13,6,11,61,51,10,45
AaB,426,5,9,11,10,41,44,-3,38
Sonderjyske,426,6,8,6,10,28,29,-1,30
AC Horsens,426,7,5,12,13,32,55,-23,27
Lyngby,426,8,4,9,11,28,44,-16,21
Randers FC,426,9,5,6,13,23,41,-18,21
Silkeborg IF,426,10,5,4,13,26,45,-19,19
AGF Aarhus,426,11,4,7,11,17,37,-20,19
Brondby,427,1,20,7,3,69,34,35,67
FC Midtjylla,427,2,19,5,6,64,38,26,62
FC Nords,427,3,14,6,10,71,54,17,48
Copenhagen,427,4,13,7,10,56,44,12,46
AaB,427,5,9,12,9,42,38,4,39
Sonderjyske,427,6,8,6,10,28,29,-1,30
AC Horsens,427,7,5,15,10,35,55,-20,30
Randers FC,427,8,6,6,12,27,39,-12,24
AGF Aarhus,427,9,5,6,11,18,37,-19,21
Silkeborg IF,427,10,5,3,14,26,46,-20,18
Lyngby,427,11,3,9,12,26,48,-22,18
Brondby,428,1,21,6,3,73,30,43,69
FC Midtjylla,428,2,21,4,5,73,40,33,67
Copenhagen,428,3,14,5,11,58,50,8,47
FC Nords,428,4,13,6,11,69,56,13,45
AC Horsens,428,5,9,12,9,41,50,-9,39
Sonderjyske,428,6,8,6,10,28,29,-1,30
AaB,428,7,6,11,13,35,49,-14,29
Lyngby,428,8,4,9,11,27,44,-17,21
Randers FC,428,9,5,6,13,23,40,-17,21
Silkeborg IF,428,10,5,4,13,26,45,-19,19
AGF Aarhus,428,11,4,7,11,17,37,-20,19
Brondby,429,1,20,7,3,69,32,37,67
FC Midtjylla,429,2,19,7,4,66,37,29,64
FC Nords,429,3,15,7,8,78,53,25,52
Copenhagen,429,4,13,4,13,57,49,8,43
AC Horsens,429,5,7,14,9,36,51,-15,35
AaB,429,6,7,11,12,41,51,-10,32
Sonderjyske,429,7,8,6,10,28,29,-1,30
Randers FC,429,8,6,6,12,27,40,-13,24
AGF Aarhus,429,9,5,6,11,19,38,-19,21
Silkeborg IF,429,10,5,3,14,27,47,-20,18
Lyngby,429,11,3,9,12,27,48,-21,18
Brondby,430,1,19,6,5,72,36,36,63
FC Midtjylla,430,2,19,5,6,67,42,25,62
FC Nords,430,3,15,7,8,78,53,25,52
Copenhagen,430,4,15,4,11,60,44,16,49
AC Horsens,430,5,9,12,9,39,50,-11,39
Sonderjyske,430,6,8,6,10,28,29,-1,30
AaB,430,7,6,12,12,35,52,-17,30
Lyngby,430,8,4,9,11,29,45,-16,21
Silkeborg IF,430,9,6,3,13,28,45,-17,21
Randers FC,430,10,5,6,13,24,42,-18,21
AGF Aarhus,430,11,4,6,12,17,39,-22,18
Brondby,431,1,21,5,4,66,30,36,68
FC Midtjylla,431,2,19,5,6,63,38,25,62
Copenhagen,431,3,15,5,10,58,42,16,50
FC Nords,431,4,12,8,10,66,54,12,44
AaB,431,5,8,12,10,37,39,-2,36
AC Horsens,431,6,7,13,10,36,49,-13,34
Sonderjyske,431,7,8,6,10,28,29,-1,30
Silkeborg IF,431,8,6,3,13,29,44,-15,21
Lyngby,431,9,4,9,11,28,45,-17,21
Randers FC,431,10,5,6,13,24,41,-17,21
AGF Aarhus,431,11,4,6,12,16,40,-24,18
FC Midtjylla,432,1,22,4,4,72,37,35,70
Brondby,432,2,20,6,4,71,34,37,66
FC Nords,432,3,13,6,11,67,56,11,45
Copenhagen,432,4,13,5,12,55,46,9,44
AaB,432,5,8,12,10,39,43,-4,36
AC Horsens,432,6,7,13,10,37,51,-14,34
Sonderjyske,432,7,8,6,10,28,29,-1,30
Randers FC,432,8,6,6,12,28,40,-12,24
Silkeborg IF,432,9,6,3,13,29,45,-16,21
Lyngby,432,10,3,9,12,27,49,-22,18
AGF Aarhus,432,11,4,6,12,17,40,-23,18
Brondby,433,1,19,7,4,67,33,34,64
FC Midtjylla,433,2,18,6,6,69,42,27,60
FC Nords,433,3,16,7,7,78,50,28,55
Copenhagen,433,4,14,5,11,58,45,13,47
AaB,433,5,7,12,11,37,48,-11,33
AC Horsens,433,6,6,15,9,38,55,-17,33
Sonderjyske,433,7,8,6,10,28,29,-1,30
Lyngby,433,8,4,9,11,31,44,-13,21
AGF Aarhus,433,9,5,6,11,18,36,-18,21
Randers FC,433,10,5,6,13,23,44,-21,21
Silkeborg IF,433,11,5,3,14,25,46,-21,18
Brondby,434,1,22,5,3,70,32,38,71
FC Midtjylla,434,2,20,5,5,64,36,28,65
FC Nords,434,3,13,8,9,72,53,19,47
Copenhagen,434,4,12,6,12,53,44,9,42
AaB,434,5,9,11,10,38,39,-1,38
Sonderjyske,434,6,8,6,10,28,29,-1,30
AC Horsens,434,7,5,15,10,33,52,-19,30
Randers FC,434,8,5,7,12,24,40,-16,22
AGF Aarhus,434,9,5,6,11,20,38,-18,21
Lyngby,434,10,3,10,11,27,45,-18,19
Silkeborg IF,434,11,5,3,14,27,48,-21,18
Brondby,435,1,21,5,4,69,30,39,68
FC Midtjylla,435,2,19,5,6,68,43,25,62
FC Nords,435,3,15,8,7,74,50,24,53
Copenhagen,435,4,14,5,11,57,44,13,47
AaB,435,5,7,12,11,37,46,-9,33
AC Horsens,435,6,6,13,11,38,56,-18,31
Sonderjyske,435,7,8,6,10,28,29,-1,30
Randers FC,435,8,5,7,12,24,40,-16,22
Lyngby,435,9,3,10,11,27,45,-18,19
Silkeborg IF,435,10,5,4,13,27,46,-19,19
AGF Aarhus,435,11,4,7,11,18,38,-20,19
Brondby,436,1,21,5,4,70,34,36,68
FC Midtjylla,436,2,21,5,4,64,36,28,68
FC Nords,436,3,15,6,9,73,50,23,51
Copenhagen,436,4,12,6,12,53,44,9,42
AaB,436,5,7,12,11,38,44,-6,33
AC Horsens,436,6,7,12,11,36,52,-16,33
Sonderjyske,436,7,8,6,10,28,29,-1,30
Silkeborg IF,436,8,6,3,13,29,44,-15,21
Lyngby,436,9,4,9,11,29,45,-16,21
Randers FC,436,10,5,6,13,24,42,-18,21
AGF Aarhus,436,11,4,6,12,16,40,-24,18
Brondby,437,1,21,7,2,73,35,38,70
FC Midtjylla,437,2,19,5,6,70,41,29,62
FC Nords,437,3,14,8,8,78,56,22,50
Copenhagen,437,4,12,6,12,53,45,8,42
AaB,437,5,9,12,9,37,39,-2,39
Sonderjyske,437,6,8,6,10,28,29,-1,30
AC Horsens,437,7,6,12,12,33,54,-21,30
Randers FC,437,8,6,6,12,25,40,-15,24
AGF Aarhus,437,9,5,6,11,18,37,-19,21
Lyngby,437,10,3,9,12,27,46,-19,18
Silkeborg IF,437,11,5,3,14,26,46,-20,18
Brondby,438,1,21,6,3,70,33,37,69
FC Midtjylla,438,2,20,5,5,72,40,32,65
Copenhagen,438,3,14,5,11,58,43,15,47
FC Nords,438,4,12,7,11,72,59,13,43
AC Horsens,438,5,7,14,9,39,53,-14,35
AaB,438,6,7,13,10,34,43,-9,34
Sonderjyske,438,7,8,6,10,28,29,-1,30
Lyngby,438,8,4,9,11,30,44,-14,21
Silkeborg IF,438,9,6,3,13,26,44,-18,21
Randers FC,438,10,5,6,13,23,43,-20,21
AGF Aarhus,438,11,4,6,12,16,37,-21,18
FC Midtjylla,439,1,19,7,4,66,39,27,64
Brondby,439,2,19,6,5,69,35,34,63
FC Nords,439,3,14,8,8,77,52,25,50
Copenhagen,439,4,13,7,10,55,42,13,46
AaB,439,5,7,13,10,33,39,-6,34
AC Horsens,439,6,7,13,10,35,54,-19,34
Sonderjyske,439,7,8,6,10,28,29,-1,30
Randers FC,439,8,6,6,12,26,40,-14,24
AGF Aarhus,439,9,5,6,11,19,37,-18,21
Lyngby,439,10,3,9,12,27,47,-20,18
Silkeborg IF,439,11,5,3,14,26,47,-21,18
Brondby,440,1,20,7,3,68,32,36,67
FC Midtjylla,440,2,20,5,5,70,40,30,65
Copenhagen,440,3,15,6,9,59,43,16,51
FC Nords,440,4,13,8,9,76,56,20,47
AaB,440,5,7,12,11,35,41,-6,33
Sonderjyske,440,6,8,6,10,28,29,-1,30
AC Horsens,440,7,5,14,11,29,51,-22,29
Lyngby,440,8,4,9,11,28,44,-16,21
Silkeborg IF,440,9,6,3,13,26,44,-18,21
Randers FC,440,10,5,6,13,23,41,-18,21
AGF Aarhus,440,11,4,6,12,16,37,-21,18
FC Midtjylla,441,1,21,5,4,69,35,34,68
Brondby,441,2,19,6,5,67,35,32,63
FC Nords,441,3,14,7,9,73,54,19,49
Copenhagen,441,4,13,5,12,57,45,12,44
AC Horsens,441,5,7,14,9,36,52,-16,35
AaB,441,6,7,13,10,35,42,-7,34
Sonderjyske,441,7,8,6,10,28,29,-1,30
Randers FC,441,8,5,7,12,23,39,-16,22
Silkeborg IF,441,9,6,3,13,28,45,-17,21
Lyngby,441,10,3,10,11,26,44,-18,19
AGF Aarhus,441,11,4,6,12,17,39,-22,18
Brondby,442,1,21,5,4,72,32,40,68
FC Midtjylla,442,2,20,4,6,66,39,27,64
Copenhagen,442,3,15,4,11,62,47,15,49
FC Nords,442,4,12,7,11,66,57,9,43
AaB,442,5,9,11,10,38,40,-2,38
AC Horsens,442,6,7,13,10,34,49,-15,34
Sonderjyske,442,7,8,6,10,28,29,-1,30
Lyngby,442,8,4,9,11,28,44,-16,21
Silkeborg IF,442,9,6,3,13,27,44,-17,21
Randers FC,442,10,5,6,13,23,41,-18,21
AGF Aarhus,442,11,4,6,12,16,38,-22,18
Brondby,443,1,21,6,3,74,29,45,69
FC Midtjylla,443,2,19,6,5,67,39,28,63
FC Nords,443,3,14,7,9,73,54,19,49
Copenhagen,443,4,13,7,10,60,48,12,46
AaB,443,5,8,12,10,38,45,-7,36
Sonderjyske,443,6,8,6,10,28,29,-1,30
AC Horsens,443,7,6,12,12,35,58,-23,30
Randers FC,443,8,5,7,12,24,40,-16,22
Silkeborg IF,443,9,6,3,13,27,45,-18,21
Lyngby,443,10,3,10,11,27,45,-18,19
AGF Aarhus,443,11,4,6,12,17,38,-21,18
Brondby,444,1,19,8,3,66,31,35,65
FC Midtjylla,444,2,19,4,7,63,39,24,61
FC Nords,444,3,16,6,8,77,50,27,54
Copenhagen,444,4,13,6,11,54,44,10,45
AaB,444,5,7,13,10,36,42,-6,34
AC Horsens,444,6,7,13,10,35,51,-16,34
Sonderjyske,444,7,8,6,10,28,29,-1,30
Randers FC,444,8,6,6,12,25,39,-14,24
Silkeborg IF,444,9,6,3,13,26,44,-18,21
Lyngby,444,10,3,9,12,26,46,-20,18
AGF Aarhus,444,11,4,6,12,16,37,-21,18
Brondby,445,1,22,5,3,75,31,44,71
FC Midtjylla,445,2,21,4,5,75,37,38,67
FC Nords,445,3,15,6,9,77,54,23,51
Copenhagen,445,4,12,5,13,56,56,0,41
AC Horsens,445,5,7,13,10,37,57,-20,34
AaB,445,6,6,13,11,37,48,-11,31
Sonderjyske,445,7,8,6,10,28,29,-1,30
Randers FC,445,8,6,6,12,26,40,-14,24
Silkeborg IF,445,9,5,4,13,26,45,-19,19
AGF Aarhus,445,10,4,7,11,17,37,-20,19
Lyngby,445,11,3,9,12,27,47,-20,18
Brondby,446,1,20,6,4,68,31,37,66
FC Midtjylla,446,2,18,4,8,62,42,20,58
Copenhagen,446,3,15,4,11,60,45,15,49
FC Nords,446,4,14,6,10,72,54,18,48
AC Horsens,446,5,9,12,9,35,48,-13,39
AaB,446,6,8,12,10,38,41,-3,36
Sonderjyske,446,7,8,6,10,28,29,-1,30
Lyngby,446,8,4,9,11,27,44,-17,21
Randers FC,446,9,5,6,13,23,40,-17,21
Silkeborg IF,446,10,6,3,13,27,45,-18,21
AGF Aarhus,446,11,4,6,12,17,38,-21,18
Brondby,447,1,21,6,3,72,36,36,69
FC Midtjylla,447,2,19,6,5,73,40,33,63
Copenhagen,447,3,15,5,10,60,43,17,50
FC Nords,447,4,12,7,11,72,60,12,43
AC Horsens,447,5,6,16,8,39,53,-14,34
AaB,447,6,7,12,11,38,48,-10,33
Sonderjyske,447,7,8,6,10,28,29,-1,30
Lyngby,447,8,4,9,11,27,44,-17,21
Randers FC,447,9,5,6,13,23,40,-17,21
Silkeborg IF,447,10,5,4,13,27,46,-19,19
AGF Aarhus,447,11,4,7,11,18,38,-20,19
Brondby,448,1,22,6,2,73,32,41,72
FC Midtjylla,448,2,21,4,5,66,38,28,67
FC Nords,448,3,14,7,9,73,49,24,49
Copenhagen,448,4,13,5,12,56,49,7,44
AaB,448,5,7,11,12,34,40,-6,32
AC Horsens,448,6,6,13,11,33,53,-20,31
Sonderjyske,448,7,8,6,10,28,29,-1,30
Randers FC,448,8,5,7,12,25,41,-16,22
AGF Aarhus,448,9,5,6,11,17,36,-19,21
Lyngby,448,10,3,10,11,28,46,-18,19
Silkeborg IF,448,11,5,3,14,25,45,-20,18
Brondby,449,1,21,6,3,74,33,41,69
FC Midtjylla,449,2,21,4,5,65,36,29,67
FC Nords,449,3,15,6,9,75,52,23,51
Copenhagen,449,4,13,6,11,53,43,10,45
AC Horsens,449,5,7,12,11,34,51,-17,33
Sonderjyske,449,6,8,6,10,28,29,-1,30
AaB,449,7,6,12,12,37,49,-12,30
Silkeborg IF,449,8,6,3,13,28,44,-16,21
Lyngby,449,9,4,9,11,27,44,-17,21
Randers FC,449,10,5,6,13,23,40,-17,21
AGF Aarhus,449,11,4,6,12,16,39,-23,18
Brondby,450,1,23,5,2,69,29,40,74
FC Midtjylla,450,2,20,4,6,67,36,31,64
FC Nords,450,3,14,6,10,72,54,18,48
Copenhagen,450,4,12,5,13,54,46,8,41
AaB,450,5,9,11,10,38,41,-3,38
AC Horsens,450,6,6,13,11,33,53,-20,31
Sonderjyske,450,7,8,6,10,28,29,-1,30
Randers FC,450,8,5,7,12,23,39,-16,22
AGF Aarhus,450,9,5,6,11,17,36,-19,21
Lyngby,450,10,3,10,11,26,44,-18,19
Silkeborg IF,450,11,5,3,14,25,45,-20,18
Brondby,451,1,22,6,2,76,31,45,72
FC Midtjylla,451,2,19,5,6,65,42,23,62
FC Nords,451,3,14,8,8,80,53,27,50
Copenhagen,451,4,13,6,11,55,42,13,45
AaB,451,5,8,12,10,38,45,-7,36
Sonderjyske,451,6,8,6,10,28,29,-1,30
AC Horsens,451,7,5,13,12,32,59,-27,28
Randers FC,451,8,5,7,12,25,41,-16,22
Silkeborg IF,451,9,6,3,13,29,45,-16,21
Lyngby,451,10,3,10,11,28,46,-18,19
AGF Aarhus,451,11,4,6,12,17,40,-23,18
Brondby,452,1,20,6,4,69,35,34,66
FC Midtjylla,452,2,19,4,7,65,41,24,61
FC Nords,452,3,16,6,8,76,53,23,54
Copenhagen,452,4,14,5,11,56,42,14,47
AaB,452,5,9,12,9,40,41,-1,39
Sonderjyske,452,6,8,6,10,28,29,-1,30
AC Horsens,452,7,5,13,12,36,56,-20,28
Lyngby,452,8,4,9,11,28,44,-16,21
Randers FC,452,9,5,6,13,23,41,-18,21
Silkeborg IF,452,10,5,4,13,26,45,-19,19
AGF Aarhus,452,11,4,7,11,17,37,-20,19
Brondby,453,1,21,6,3,71,32,39,69
FC Midtjylla,453,2,19,4,7,66,41,25,61
FC Nords,453,3,16,6,8,74,49,25,54
Copenhagen,453,4,14,6,10,60,46,14,48
AaB,453,5,7,12,11,36,45,-9,33
Sonderjyske,453,6,8,6,10,28,29,-1,30
AC Horsens,453,7,6,12,12,36,56,-20,30
Randers FC,453,8,6,6,12,25,40,-15,24
Silkeborg IF,453,9,6,3,13,29,45,-16,21
Lyngby,453,10,3,9,12,27,46,-19,18
AGF Aarhus,453,11,4,6,12,17,40,-23,18
FC Midtjylla,454,1,22,4,4,73,36,37,70
Brondby,454,2,20,6,4,66,31,35,66
FC Nords,454,3,16,6,8,75,46,29,54
Copenhagen,454,4,12,5,13,53,51,2,41
AC Horsens,454,5,7,13,10,34,54,-20,34
Sonderjyske,454,6,8,6,10,28,29,-1,30
AaB,454,7,6,12,12,34,43,-9,30
Randers FC,454,8,5,7,12,24,40,-16,22
AGF Aarhus,454,9,5,6,11,18,37,-19,21
Lyngby,454,10,3,10,11,27,45,-18,19
Silkeborg IF,454,11,5,3,14,26,46,-20,18
Brondby,455,1,21,6,3,69,32,37,69
FC Midtjylla,455,2,20,4,6,66,40,26,64
Copenhagen,455,3,15,6,9,61,40,21,51
FC Nords,455,4,12,8,10,70,56,14,44
AaB,455,5,7,12,11,37,44,-7,33
AC Horsens,455,6,7,12,11,37,54,-17,33
Sonderjyske,455,7,8,6,10,28,29,-1,30
Lyngby,455,8,4,9,11,31,46,-15,21
AGF Aarhus,455,9,5,6,11,19,37,-18,21
Randers FC,455,10,5,6,13,25,44,-19,21
Silkeborg IF,455,11,5,3,14,26,47,-21,18
Brondby,456,1,21,6,3,72,32,40,69
FC Midtjylla,456,2,19,6,5,72,40,32,63
FC Nords,456,3,14,8,8,72,54,18,50
Copenhagen,456,4,13,6,11,54,43,11,45
AaB,456,5,7,13,10,40,45,-5,34
AC Horsens,456,6,6,13,11,35,57,-22,31
Sonderjyske,456,7,8,6,10,28,29,-1,30
Randers FC,456,8,6,6,12,24,39,-15,24
Silkeborg IF,456,9,5,4,13,27,46,-19,19
AGF Aarhus,456,10,4,7,11,18,38,-20,19
Lyngby,456,11,3,9,12,26,45,-19,18
Brondby,457,1,20,7,3,68,30,38,67
FC Midtjylla,457,2,20,5,5,68,37,31,65
FC Nords,457,3,15,8,7,75,47,28,53
Copenhagen,457,4,12,6,12,55,48,7,42
AaB,457,5,8,11,11,34,44,-10,35
AC Horsens,457,6,6,13,11,36,56,-20,31
Sonderjyske,457,7,8,6,10,28,29,-1,30
Randers FC,457,8,6,6,12,26,40,-14,24
Silkeborg IF,457,9,5,4,13,26,45,-19,19
AGF Aarhus,457,10,4,7,11,17,37,-20,19
Lyngby,457,11,3,9,12,27,47,-20,18
Brondby,458,1,22,5,3,75,31,44,71
FC Midtjylla,458,2,17,6,7,62,47,15,57
Copenhagen,458,3,15,6,9,58,40,18,51
FC Nords,458,4,13,8,9,72,53,19,47
AaB,458,5,6,15,9,35,42,-7,33
AC Horsens,458,6,6,14,10,37,52,-15,32
Sonderjyske,458,7,8,6,10,28,29,-1,30
Randers FC,458,8,6,6,12,24,39,-15,24
AGF Aarhus,458,9,5,6,11,18,37,-19,21
Lyngby,458,10,3,9,12,26,45,-19,18
Silkeborg IF,458,11,5,3,14,26,46,-20,18
Brondby,459,1,23,5,2,78,30,48,74
FC Midtjylla,459,2,19,4,7,63,40,23,61
Copenhagen,459,3,15,5,10,63,46,17,50
FC Nords,459,4,14,6,10,71,57,14,48
AaB,459,5,7,13,10,36,41,-5,34
Sonderjyske,459,6,8,6,10,28,29,-1,30
AC Horsens,459,7,5,13,12,34,57,-23,28
Lyngby,459,8,4,9,11,28,44,-16,21
Silkeborg IF,459,9,6,3,13,26,44,-18,21
Randers FC,459,10,5,6,13,23,41,-18,21
AGF Aarhus,459,11,4,6,12,16,37,-21,18
Brondby,460,1,20,7,3,75,35,40,67
FC Midtjylla,460,2,18,6,6,63,41,22,60
FC Nords,460,3,14,6,10,72,52,20,48
Copenhagen,460,4,13,7,10,61,50,11,46
AaB,460,5,8,13,9,38,44,-6,37
AC Horsens,460,6,7,13,10,38,51,-13,34
Sonderjyske,460,7,8,6,10,28,29,-1,30
Randers FC,460,8,6,6,12,25,39,-14,24
AGF Aarhus,460,9,5,6,11,18,37,-19,21
Lyngby,460,10,3,9,12,26,46,-20,18
Silkeborg IF,460,10,5,3,14,26,46,-20,18
FC Midtjylla,461,1,21,4,5,67,38,29,67
Brondby,461,2,18,7,5,64,33,31,61
FC Nords,461,3,15,7,8,74,51,23,52
Copenhagen,461,4,13,7,10,57,45,12,46
AaB,461,5,9,11,10,40,41,-1,38
Sonderjyske,461,6,8,6,10,28,29,-1,30
AC Horsens,461,7,5,14,11,31,51,-20,29
Lyngby,461,8,4,9,11,28,44,-16,21
Silkeborg IF,461,8,6,3,13,28,44,-16,21
Randers FC,461,10,5,6,13,23,41,-18,21
AGF Aarhus,461,11,4,6,12,16,39,-23,18
Brondby,462,1,20,7,3,69,29,40,67
FC Midtjylla,462,2,20,5,5,69,37,32,65
FC Nords,462,3,14,6,10,68,49,19,48
Copenhagen,462,4,14,4,12,54,46,8,46
AaB,462,5,9,13,8,35,36,-1,40
Sonderjyske,462,6,8,6,10,28,29,-1,30
AC Horsens,462,7,5,13,12,32,56,-24,28
Lyngby,462,8,4,9,11,29,44,-15,21
Randers FC,462,9,5,6,13,23,42,-19,21
AGF Aarhus,462,10,5,6,11,18,37,-19,21
Silkeborg IF,462,11,5,3,14,26,46,-20,18
Brondby,463,1,21,6,3,75,34,41,69
FC Midtjylla,463,2,19,4,7,66,41,25,61
FC Nords,463,3,14,8,8,73,51,22,50
Copenhagen,463,4,14,5,11,57,48,9,47
AaB,463,5,8,13,9,42,45,-3,37
Sonderjyske,463,6,8,6,10,28,29,-1,30
AC Horsens,463,7,6,12,12,34,54,-20,30
Silkeborg IF,463,8,6,3,13,28,44,-16,21
Lyngby,463,9,4,9,11,28,45,-17,21
Randers FC,463,10,5,6,13,24,41,-17,21
AGF Aarhus,463,11,4,6,12,16,39,-23,18
Brondby,464,1,19,7,4,66,33,33,64
FC Midtjylla,464,2,19,4,7,65,43,22,61
FC Nords,464,3,16,6,8,77,46,31,54
Copenhagen,464,4,14,6,10,54,41,13,48
AaB,464,5,8,12,10,38,43,-5,36
AC Horsens,464,6,6,13,11,34,54,-20,31
Sonderjyske,464,7,8,6,10,28,29,-1,30
Randers FC,464,8,6,6,12,24,39,-15,24
Silkeborg IF,464,9,6,3,13,29,46,-17,21
Lyngby,464,10,3,9,12,26,45,-19,18
AGF Aarhus,464,11,4,6,12,18,40,-22,18
Brondby,465,1,22,5,3,77,33,44,71
FC Midtjylla,465,2,19,5,6,70,42,28,62
FC Nords,465,3,15,7,8,79,50,29,52
Copenhagen,465,4,12,7,11,54,47,7,43
AC Horsens,465,5,7,14,9,39,53,-14,35
Sonderjyske,465,6,8,6,10,28,29,-1,30
AaB,465,7,6,12,12,34,54,-20,30
Randers FC,465,8,5,7,12,24,40,-16,22
Lyngby,465,9,3,10,11,27,45,-18,19
Silkeborg IF,465,10,5,4,13,25,44,-19,19
AGF Aarhus,465,11,4,7,11,16,36,-20,19
Brondby,466,1,21,6,3,71,31,40,69
FC Midtjylla,466,2,19,5,6,66,41,25,62
FC Nords,466,3,15,7,8,75,50,25,52
Copenhagen,466,4,14,5,11,53,44,9,47
AC Horsens,466,5,7,12,11,35,51,-16,33
AaB,466,6,6,13,11,35,44,-9,31
Sonderjyske,466,7,8,6,10,28,29,-1,30
Randers FC,466,8,6,6,12,26,40,-14,24
Silkeborg IF,466,9,6,3,13,27,45,-18,21
Lyngby,466,10,3,9,12,27,47,-20,18
AGF Aarhus,466,11,4,6,12,17,38,-21,18
Brondby,467,1,23,5,2,73,26,47,74
FC Midtjylla,467,2,19,6,5,68,44,24,63
FC Nords,467,3,14,7,9,75,51,24,49
Copenhagen,467,4,14,6,10,55,41,14,48
Sonderjyske,467,5,8,6,10,28,29,-1,30
AaB,467,6,6,12,12,36,48,-12,30
AC Horsens,467,7,6,12,12,34,57,-23,30
Lyngby,467,8,4,9,11,27,44,-17,21
Randers FC,467,9,5,6,13,23,40,-17,21
Silkeborg IF,467,10,5,4,13,26,45,-19,19
AGF Aarhus,467,11,4,7,11,17,37,-20,19
FC Midtjylla,468,1,20,6,4,74,41,33,66
Brondby,468,2,20,6,4,71,38,33,66
FC Nords,468,3,14,6,10,71,56,15,48
Copenhagen,468,4,14,4,12,59,45,14,46
AaB,468,5,7,13,10,42,47,-5,34
AC Horsens,468,6,6,15,9,40,56,-16,33
Sonderjyske,468,7,8,6,10,28,29,-1,30
Randers FC,468,8,5,7,12,23,39,-16,22
Lyngby,468,9,3,10,11,26,44,-18,19
Silkeborg IF,468,10,5,4,13,27,46,-19,19
AGF Aarhus,468,11,4,7,11,18,38,-20,19
Brondby,469,1,21,5,4,72,37,35,68
FC Midtjylla,469,2,19,4,7,62,39,23,61
FC Nords,469,3,14,8,8,73,51,22,50
Copenhagen,469,4,15,5,10,63,44,19,50
AaB,469,5,7,13,10,39,45,-6,34
AC Horsens,469,6,6,13,11,35,54,-19,31
Sonderjyske,469,7,8,6,10,28,29,-1,30
Lyngby,469,8,4,9,11,30,45,-15,21
Randers FC,469,9,5,6,13,24,43,-19,21
Silkeborg IF,469,10,5,4,13,27,46,-19,19
AGF Aarhus,469,11,4,7,11,18,38,-20,19
Brondby,470,1,22,5,3,78,28,50,71
FC Midtjylla,470,2,20,5,5,67,39,28,65
Copenhagen,470,3,14,6,10,59,47,12,48
FC Nords,470,4,13,7,10,69,54,15,46
AaB,470,5,7,13,10,36,46,-10,34
Sonderjyske,470,6,8,6,10,28,29,-1,30
AC Horsens,470,7,6,12,12,38,59,-21,30
Lyngby,470,8,4,9,11,27,44,-17,21
Randers FC,470,9,5,6,13,23,40,-17,21
Silkeborg IF,470,10,6,3,13,26,44,-18,21
AGF Aarhus,470,11,4,6,12,16,37,-21,18
Brondby,471,1,21,7,2,77,35,42,70
FC Midtjylla,471,2,18,5,7,66,45,21,59
FC Nords,471,3,14,8,8,75,55,20,50
Copenhagen,471,4,12,6,12,55,47,8,42
AaB,471,5,7,15,8,35,38,-3,36
AC Horsens,471,6,7,13,10,36,50,-14,34
Sonderjyske,471,7,8,6,10,28,29,-1,30
Randers FC,471,8,5,7,12,24,40,-16,22
AGF Aarhus,471,9,5,6,11,17,36,-19,21
Lyngby,471,10,3,10,11,27,45,-18,19
Silkeborg IF,471,11,5,3,14,25,45,-20,18
Brondby,472,1,20,6,4,68,33,35,66
FC Midtjylla,472,2,20,5,5,66,42,24,65
FC Nords,472,3,14,8,8,83,54,29,50
Copenhagen,472,4,13,4,13,55,47,8,43
AC Horsens,472,5,8,12,10,40,55,-15,36
AaB,472,6,8,11,11,34,41,-7,35
Sonderjyske,472,7,8,6,10,28,29,-1,30
Lyngby,472,8,4,9,11,29,44,-15,21
Randers FC,472,9,5,6,13,23,42,-19,21
Silkeborg IF,472,10,5,4,13,25,44,-19,19
AGF Aarhus,472,11,4,7,11,16,36,-20,19
Brondby,473,1,22,5,3,76,34,42,71
FC Midtjylla,473,2,19,5,6,60,36,24,62
FC Nords,473,3,14,8,8,72,49,23,50
Copenhagen,473,4,14,5,11,57,45,12,47
AaB,473,5,8,11,11,37,43,-6,35
Sonderjyske,473,6,8,6,10,28,29,-1,30
AC Horsens,473,7,6,12,12,35,56,-21,30
Lyngby,473,8,4,9,11,28,45,-17,21
Randers FC,473,9,5,6,13,24,41,-17,21
AGF Aarhus,473,10,5,6,11,18,37,-19,21
Silkeborg IF,473,11,5,3,14,26,46,-20,18
Brondby,474,1,19,8,3,68,32,36,65
FC Midtjylla,474,2,19,7,4,68,41,27,64
Copenhagen,474,3,15,5,10,63,45,18,50
FC Nords,474,4,13,9,8,76,52,24,48
AC Horsens,474,5,7,12,11,37,57,-20,33
AaB,474,6,6,13,11,36,47,-11,31
Sonderjyske,474,7,8,6,10,28,29,-1,30
Randers FC,474,8,5,7,12,23,39,-16,22
Lyngby,474,9,3,10,11,26,44,-18,19
Silkeborg IF,474,10,5,4,13,28,47,-19,19
AGF Aarhus,474,11,4,7,11,19,39,-20,19
FC Midtjylla,475,1,21,5,4,68,38,30,68
Brondby,475,2,20,7,3,75,37,38,67
FC Nords,475,3,14,7,9,75,54,21,49
Copenhagen,475,4,13,5,12,56,48,8,44
AC Horsens,475,5,7,14,9,36,50,-14,35
Sonderjyske,475,6,8,6,10,28,29,-1,30
AaB,475,7,6,12,12,36,45,-9,30
Lyngby,475,8,4,9,11,28,44,-16,21
Silkeborg IF,475,8,6,3,13,28,44,-16,21
Randers FC,475,10,5,6,13,23,41,-18,21
AGF Aarhus,475,11,4,6,12,16,39,-23,18
Brondby,476,1,21,6,3,68,29,39,69
FC Midtjylla,476,2,21,5,4,67,38,29,68
FC Nords,476,3,14,8,8,79,51,28,50
Copenhagen,476,4,13,6,11,55,44,11,45
AaB,476,5,7,11,12,37,47,-10,32
Sonderjyske,476,6,8,6,10,28,29,-1,30
AC Horsens,476,7,6,12,12,35,58,-23,30
Randers FC,476,8,6,6,12,25,39,-14,24
Silkeborg IF,476,9,6,3,13,30,45,-15,21
Lyngby,476,10,3,9,12,26,46,-20,18
AGF Aarhus,476,11,4,6,12,17,41,-24,18
Brondby,477,1,22,5,3,74,33,41,71
FC Midtjylla,477,2,20,4,6,66,43,23,64
FC Nords,477,3,15,6,9,76,51,25,51
Copenhagen,477,4,14,5,11,62,47,15,47
AaB,477,5,7,11,12,36,48,-12,32
AC Horsens,477,6,6,13,11,37,55,-18,31
Sonderjyske,477,7,8,6,10,28,29,-1,30
Lyngby,477,8,4,9,11,27,44,-17,21
Randers FC,477,9,5,6,13,23,40,-17,21
AGF Aarhus,477,10,5,6,11,20,38,-18,21
Silkeborg IF,477,11,5,3,14,27,48,-21,18
Brondby,478,1,21,5,4,74,38,36,68
FC Midtjylla,478,2,19,4,7,67,43,24,61
FC Nords,478,3,15,6,9,76,55,21,51
Copenhagen,478,4,13,4,13,55,51,4,43
AC Horsens,478,5,9,12,9,43,47,-4,39
AaB,478,6,8,11,11,37,44,-7,35
Sonderjyske,478,7,8,6,10,28,29,-1,30
Lyngby,478,8,4,9,11,28,45,-17,21
Randers FC,478,9,5,6,13,24,41,-17,21
AGF Aarhus,478,10,5,6,11,20,39,-19,21
Silkeborg IF,478,11,5,3,14,28,48,-20,18
Brondby,479,1,21,5,4,69,32,37,68
FC Midtjylla,479,2,19,4,7,63,39,24,61
FC Nords,479,3,16,6,8,79,53,26,54
Copenhagen,479,4,14,5,11,55,43,12,47
AaB,479,5,8,12,10,37,40,-3,36
Sonderjyske,479,6,8,6,10,28,29,-1,30
AC Horsens,479,7,6,12,12,32,54,-22,30
Lyngby,479,8,4,9,11,28,44,-16,21
Silkeborg IF,479,9,6,3,13,27,44,-17,21
Randers FC,479,10,5,6,13,23,41,-18,21
AGF Aarhus,479,11,4,6,12,16,38,-22,18
Brondby,480,1,22,6,2,75,33,42,72
FC Midtjylla,480,2,19,5,6,66,42,24,62
FC Nords,480,3,14,8,8,74,51,23,50
Copenhagen,480,4,12,6,12,55,48,7,42
AaB,480,5,8,13,9,40,43,-3,37
Sonderjyske,480,6,8,6,10,28,29,-1,30
AC Horsens,480,7,5,14,11,35,54,-19,29
Randers FC,480,8,6,6,12,25,40,-15,24
Silkeborg IF,480,9,5,4,13,28,47,-19,19
AGF Aarhus,480,10,4,7,11,19,39,-20,19
Lyngby,480,11,3,9,12,27,46,-19,18
Brondby,481,1,19,7,4,70,35,35,64
FC Midtjylla,481,2,18,5,7,62,43,19,59
Copenhagen,481,3,16,4,10,59,42,17,52
FC Nords,481,4,14,8,8,72,47,25,50
AC Horsens,481,5,8,13,9,40,49,-9,37
AaB,481,6,7,11,12,35,48,-13,32
Sonderjyske,481,7,8,6,10,28,29,-1,30
Randers FC,481,8,6,6,12,28,42,-14,24
Silkeborg IF,481,9,5,4,13,27,46,-19,19
AGF Aarhus,481,10,4,7,11,18,38,-20,19
Lyngby,481,11,3,9,12,29,49,-20,18
Brondby,482,1,21,5,4,70,33,37,68
FC Midtjylla,482,2,19,5,6,67,42,25,62
FC Nords,482,3,14,6,10,75,54,21,48
Copenhagen,482,4,14,5,11,58,48,10,47
AaB,482,5,8,13,9,38,40,-2,37
AC Horsens,482,6,7,12,11,37,54,-17,33
Sonderjyske,482,7,8,6,10,28,29,-1,30
Lyngby,482,8,4,9,11,28,44,-16,21
Silkeborg IF,482,9,6,3,13,28,46,-18,21
Randers FC,482,10,5,6,13,23,41,-18,21
AGF Aarhus,482,11,4,6,12,18,39,-21,18
Brondby,483,1,21,5,4,71,36,35,68
FC Midtjylla,483,2,20,4,6,70,39,31,64
FC Nords,483,3,14,7,9,70,48,22,49
Copenhagen,483,4,13,5,12,56,46,10,44
AaB,483,5,8,12,10,34,42,-8,36
AC Horsens,483,6,7,13,10,37,53,-16,34
Sonderjyske,483,7,8,6,10,28,29,-1,30
Randers FC,483,8,5,7,12,24,40,-16,22
AGF Aarhus,483,9,5,6,11,18,37,-19,21
Lyngby,483,10,3,10,11,27,45,-18,19
Silkeborg IF,483,11,5,3,14,26,46,-20,18
FC Midtjylla,484,1,21,5,4,70,36,34,68
Brondby,484,2,20,5,5,70,33,37,65
Copenhagen,484,3,16,4,10,65,46,19,52
FC Nords,484,4,12,7,11,70,58,12,43
AaB,484,5,7,12,11,36,47,-11,33
AC Horsens,484,6,6,15,9,34,51,-17,33
Sonderjyske,484,7,8,6,10,28,29,-1,30
Randers FC,484,8,6,6,12,25,40,-15,24
AGF Aarhus,484,9,5,6,11,18,37,-19,21
Lyngby,484,10,3,9,12,27,46,-19,18
Silkeborg IF,484,11,5,3,14,26,46,-20,18
Brondby,485,1,21,7,2,68,29,39,70
FC Midtjylla,485,2,18,7,5,60,37,23,61
FC Nords,485,3,15,7,8,73,45,28,52
Copenhagen,485,4,14,5,11,53,40,13,47
AC Horsens,485,5,7,12,11,34,50,-16,33
Sonderjyske,485,6,8,6,10,28,29,-1,30
AaB,485,7,6,12,12,32,45,-13,30
Lyngby,485,8,4,9,11,28,44,-16,21
Randers FC,485,9,5,6,13,23,41,-18,21
Silkeborg IF,485,10,5,4,13,25,44,-19,19
AGF Aarhus,485,11,4,7,11,16,36,-20,19
Brondby,486,1,22,6,2,76,30,46,72
FC Midtjylla,486,2,20,4,6,64,40,24,64
Copenhagen,486,3,13,6,11,53,44,9,45
FC Nords,486,4,12,7,11,69,53,16,43
AC Horsens,486,5,8,12,10,35,48,-13,36
AaB,486,6,8,11,11,34,42,-8,35
Sonderjyske,486,7,8,6,10,28,29,-1,30
Randers FC,486,8,6,6,12,25,40,-15,24
Silkeborg IF,486,9,5,4,13,27,46,-19,19
AGF Aarhus,486,10,4,7,11,18,38,-20,19
Lyngby,486,11,3,9,12,27,46,-19,18
Brondby,487,1,21,6,3,73,31,42,69
FC Midtjylla,487,2,19,5,6,63,42,21,62
FC Nords,487,3,14,9,7,75,50,25,51
Copenhagen,487,4,15,4,11,61,46,15,49
AaB,487,5,7,12,11,35,44,-9,33
Sonderjyske,487,6,8,6,10,28,29,-1,30
AC Horsens,487,7,6,12,12,33,53,-20,30
Randers FC,487,8,5,7,12,23,39,-16,22
Lyngby,487,9,3,10,11,26,44,-18,19
Silkeborg IF,487,10,5,4,13,27,46,-19,19
AGF Aarhus,487,11,4,7,11,18,38,-20,19
Brondby,488,1,19,7,4,69,35,34,64
FC Midtjylla,488,2,19,5,6,67,43,24,62
FC Nords,488,3,15,8,7,74,47,27,53
Copenhagen,488,4,14,5,11,61,47,14,47
AaB,488,5,7,13,10,34,40,-6,34
AC Horsens,488,6,6,14,10,38,57,-19,32
Sonderjyske,488,7,8,6,10,28,29,-1,30
Lyngby,488,8,4,9,11,28,44,-16,21
Silkeborg IF,488,9,6,3,13,28,45,-17,21
Randers FC,488,10,5,6,13,23,41,-18,21
AGF Aarhus,488,11,4,6,12,17,39,-22,18
Brondby,489,1,20,7,3,68,30,38,67
FC Midtjylla,489,2,20,5,5,64,38,26,65
FC Nords,489,3,15,7,8,76,49,27,52
Copenhagen,489,4,13,7,10,57,44,13,46
AaB,489,5,6,15,9,36,42,-6,33
Sonderjyske,489,6,8,6,10,28,29,-1,30
AC Horsens,489,7,5,13,12,31,55,-24,28
Randers FC,489,8,6,6,12,27,40,-13,24
Silkeborg IF,489,9,6,3,13,26,44,-18,21
Lyngby,489,10,3,9,12,27,48,-21,18
AGF Aarhus,489,11,4,6,12,16,37,-21,18
FC Midtjylla,490,1,21,5,4,66,36,30,68
Brondby,490,2,20,7,3,68,31,37,67
FC Nords,490,3,13,8,9,71,53,18,47
Copenhagen,490,4,14,5,11,58,46,12,47
AC Horsens,490,5,7,13,10,37,48,-11,34
Sonderjyske,490,6,8,6,10,28,29,-1,30
AaB,490,7,6,12,12,38,50,-12,30
Randers FC,490,8,5,7,12,25,41,-16,22
Silkeborg IF,490,9,6,3,13,29,45,-16,21
Lyngby,490,10,3,10,11,28,46,-18,19
AGF Aarhus,490,11,4,6,12,17,40,-23,18
Brondby,491,1,20,6,4,66,31,35,66
FC Midtjylla,491,2,19,5,6,66,40,26,62
FC Nords,491,3,14,8,8,72,51,21,50
Copenhagen,491,4,14,5,11,57,43,14,47
AC Horsens,491,5,8,14,8,39,49,-10,38
Sonderjyske,491,6,8,6,10,28,29,-1,30
AaB,491,7,6,12,12,35,47,-12,30
Randers FC,491,8,6,6,12,24,39,-15,24
Silkeborg IF,491,9,5,4,13,25,44,-19,19
AGF Aarhus,491,10,4,7,11,16,36,-20,19
Lyngby,491,11,3,9,12,26,45,-19,18
FC Midtjylla,492,1,21,5,4,68,40,28,68
Brondby,492,2,19,8,3,69,34,35,65
FC Nords,492,3,14,8,8,68,46,22,50
Copenhagen,492,4,14,5,11,61,47,14,47
AaB,492,5,7,11,12,37,44,-7,32
AC Horsens,492,6,6,13,11,34,52,-18,31
Sonderjyske,492,7,8,6,10,28,29,-1,30
Randers FC,492,8,5,7,12,25,41,-16,22
Lyngby,492,9,3,10,11,28,46,-18,19
Silkeborg IF,492,10,5,4,13,27,46,-19,19
AGF Aarhus,492,11,4,7,11,18,38,-20,19
Brondby,493,1,19,8,3,71,37,34,65
FC Midtjylla,493,2,20,5,5,61,36,25,65
FC Nords,493,3,14,7,9,76,55,21,49
Copenhagen,493,4,15,4,11,64,48,16,49
AaB,493,5,7,14,9,39,41,-2,35
Sonderjyske,493,6,8,6,10,28,29,-1,30
AC Horsens,493,7,5,14,11,37,57,-20,29
Randers FC,493,8,6,6,12,25,39,-14,24
AGF Aarhus,493,9,5,6,11,19,37,-18,21
Lyngby,493,10,3,9,12,26,46,-20,18
Silkeborg IF,493,11,5,3,14,26,47,-21,18
Brondby,494,1,22,6,2,73,29,44,72
FC Midtjylla,494,2,19,4,7,67,45,22,61
Copenhagen,494,3,15,4,11,62,45,17,49
FC Nords,494,4,13,7,10,67,52,15,46
AaB,494,5,7,13,10,39,46,-7,34
AC Horsens,494,6,7,12,11,33,50,-17,33
Sonderjyske,494,7,8,6,10,28,29,-1,30
Lyngby,494,8,4,9,11,28,45,-17,21
Randers FC,494,9,5,6,13,24,41,-17,21
AGF Aarhus,494,10,5,6,11,17,36,-19,21
Silkeborg IF,494,11,5,3,14,25,45,-20,18
Brondby,495,1,21,6,3,72,32,40,69
FC Midtjylla,495,2,21,4,5,72,40,32,67
FC Nords,495,3,14,8,8,78,54,24,50
Copenhagen,495,4,13,4,13,58,49,9,43
AaB,495,5,7,13,10,36,48,-12,34
AC Horsens,495,6,6,13,11,34,53,-19,31
Sonderjyske,495,7,8,6,10,28,29,-1,30
Lyngby,495,8,4,9,11,28,45,-17,21
Randers FC,495,9,5,6,13,24,41,-17,21
Silkeborg IF,495,10,5,4,13,26,45,-19,19
AGF Aarhus,495,11,4,7,11,17,37,-20,19
FC Midtjylla,496,1,22,4,4,74,37,37,70
Brondby,496,2,20,5,5,66,35,31,65
Copenhagen,496,3,16,4,10,58,41,17,52
FC Nords,496,4,14,6,10,71,49,22,48
AaB,496,5,7,11,12,37,49,-12,32
Sonderjyske,496,6,8,6,10,28,29,-1,30
AC Horsens,496,7,6,12,12,32,53,-21,30
Lyngby,496,8,4,9,11,30,45,-15,21
Randers FC,496,9,5,6,13,24,43,-19,21
AGF Aarhus,496,10,5,6,11,19,38,-19,21
Silkeborg IF,496,11,5,3,14,27,47,-20,18
Brondby,497,1,20,7,3,71,33,38,67
FC Midtjylla,497,2,20,6,4,68,38,30,66
FC Nords,497,3,13,8,9,72,51,21,47
Copenhagen,497,4,12,6,12,54,47,7,42
AaB,497,5,8,13,9,38,43,-5,37
AC Horsens,497,6,6,14,10,33,50,-17,32
Sonderjyske,497,7,8,6,10,28,29,-1,30
Randers FC,497,8,6,6,12,24,39,-15,24
AGF Aarhus,497,9,5,6,11,19,38,-19,21
Lyngby,497,10,3,9,12,26,45,-19,18
Silkeborg IF,497,11,5,3,14,27,47,-20,18
FC Midtjylla,498,1,22,4,4,72,37,35,70
Brondby,498,2,19,6,5,72,41,31,63
FC Nords,498,3,15,7,8,77,50,27,52
Copenhagen,498,4,12,7,11,55,48,7,43
AaB,498,5,7,12,11,36,44,-8,33
AC Horsens,498,6,6,14,10,34,52,-18,32
Sonderjyske,498,7,8,6,10,28,29,-1,30
Lyngby,498,8,4,9,11,28,45,-17,21
Randers FC,498,9,5,6,13,24,41,-17,21
AGF Aarhus,498,10,5,6,11,17,36,-19,21
Silkeborg IF,498,11,5,3,14,25,45,-20,18
FC Midtjylla,499,1,21,4,5,68,36,32,67
Brondby,499,2,19,6,5,70,37,33,63
FC Nords,499,3,15,6,9,79,56,23,51
Copenhagen,499,4,13,5,12,57,51,6,44
AaB,499,5,9,11,10,39,41,-2,38
AC Horsens,499,6,6,14,10,38,56,-18,32
Sonderjyske,499,7,8,6,10,28,29,-1,30
Randers FC,499,8,5,7,12,24,40,-16,22
Silkeborg IF,499,9,6,3,13,28,45,-17,21
Lyngby,499,10,3,10,11,27,45,-18,19
AGF Aarhus,499,11,4,6,12,17,39,-22,18
Brondby,500,1,21,6,3,72,31,41,69
FC Midtjylla,500,2,20,4,6,67,41,26,64
FC Nords,500,3,14,6,10,73,55,18,48
Copenhagen,500,4,13,6,11,57,45,12,45
AaB,500,5,8,11,11,37,47,-10,35
AC Horsens,500,6,7,13,10,36,49,-13,34
Sonderjyske,500,7,8,6,10,28,29,-1,30
Lyngby,500,8,4,9,11,29,45,-16,21
Randers FC,500,9,5,6,13,24,42,-18,21
Silkeborg IF,500,10,5,4,13,25,44,-19,19
AGF Aarhus,500,11,4,7,11,16,36,-20,19
Brondby,501,1,21,6,3,72,31,41,69
FC Midtjylla,501,2,19,4,7,65,43,22,61
Copenhagen,501,3,15,6,9,65,44,21,51
FC Nords,501,4,15,6,9,75,55,20,51
AaB,501,5,7,12,11,38,47,-9,33
Sonderjyske,501,6,8,6,10,28,29,-1,30
AC Horsens,501,7,6,12,12,34,55,-21,30
Randers FC,501,8,5,7,12,24,40,-16,22
AGF Aarhus,501,9,5,6,11,19,36,-17,21
Lyngby,501,10,3,10,11,27,45,-18,19
Silkeborg IF,501,11,5,3,14,25,47,-22,18
Brondby,502,1,20,7,3,72,33,39,67
FC Midtjylla,502,2,20,4,6,65,44,21,64
FC Nords,502,3,16,6,8,83,50,33,54
Copenhagen,502,4,14,5,11,59,45,14,47
AC Horsens,502,5,6,14,10,35,54,-19,32
Sonderjyske,502,6,8,6,10,28,29,-1,30
AaB,502,7,6,12,12,34,48,-14,30
Randers FC,502,8,6,6,12,26,41,-15,24
Silkeborg IF,502,9,6,3,13,26,44,-18,21
Lyngby,502,10,3,9,12,28,47,-19,18
AGF Aarhus,502,11,4,6,12,16,37,-21,18
Brondby,503,1,22,6,2,78,31,47,72
FC Midtjylla,503,2,18,4,8,68,47,21,58
FC Nords,503,3,15,7,8,77,51,26,52
Copenhagen,503,4,13,5,12,56,50,6,44
AaB,503,5,8,13,9,39,43,-4,37
AC Horsens,503,6,6,13,11,34,56,-22,31
Sonderjyske,503,7,8,6,10,28,29,-1,30
Randers FC,503,8,6,6,12,24,39,-15,24
Silkeborg IF,503,9,6,3,13,27,45,-18,21
Lyngby,503,10,3,9,12,26,45,-19,18
AGF Aarhus,503,11,4,6,12,17,38,-21,18
Brondby,504,1,20,7,3,76,35,41,67
FC Midtjylla,504,2,19,6,5,61,35,26,63
FC Nords,504,3,13,7,10,70,53,17,46
Copenhagen,504,4,12,7,11,53,47,6,43
AaB,504,5,9,12,9,41,39,2,39
AC Horsens,504,6,7,13,10,35,53,-18,34
Sonderjyske,504,7,8,6,10,28,29,-1,30
Randers FC,504,8,6,6,12,24,39,-15,24
Silkeborg IF,504,9,6,3,13,28,45,-17,21
Lyngby,504,10,3,9,12,26,45,-19,18
AGF Aarhus,504,11,4,6,12,17,39,-22,18
Brondby,505,1,21,7,2,75,30,45,70
FC Midtjylla,505,2,17,6,7,62,44,18,57
FC Nords,505,3,14,8,8,72,55,17,50
Copenhagen,505,4,13,8,9,56,42,14,47
AaB,505,5,6,15,9,35,40,-5,33
AC Horsens,505,6,6,14,10,34,49,-15,32
Sonderjyske,505,7,8,6,10,28,29,-1,30
Randers FC,505,8,6,6,12,25,39,-14,24
Silkeborg IF,505,9,5,4,13,27,46,-19,19
AGF Aarhus,505,10,4,7,11,18,38,-20,19
Lyngby,505,11,3,9,12,26,46,-20,18
Brondby,506,1,20,6,4,67,34,33,66
FC Midtjylla,506,2,19,4,7,65,42,23,61
Copenhagen,506,3,15,5,10,61,44,17,50
FC Nords,506,4,13,6,11,69,52,17,45
AaB,506,5,9,11,10,40,42,-2,38
AC Horsens,506,6,8,12,10,35,49,-14,36
Sonderjyske,506,7,8,6,10,28,29,-1,30
Randers FC,506,8,5,7,12,24,40,-16,22
Lyngby,506,9,3,10,11,27,45,-18,19
Silkeborg IF,506,10,5,4,13,26,45,-19,19
AGF Aarhus,506,11,4,7,11,17,37,-20,19
Brondby,507,1,20,6,4,69,34,35,66
FC Midtjylla,507,2,20,5,5,66,37,29,65
FC Nords,507,3,15,7,8,79,51,28,52
Copenhagen,507,4,12,5,13,53,49,4,41
AaB,507,5,8,12,10,37,41,-4,36
AC Horsens,507,6,7,13,10,33,51,-18,34
Sonderjyske,507,7,8,6,10,28,29,-1,30
Randers FC,507,8,5,7,12,24,40,-16,22
AGF Aarhus,507,9,5,6,11,17,36,-19,21
Lyngby,507,10,3,10,11,27,45,-18,19
Silkeborg IF,507,11,5,3,14,25,45,-20,18
Brondby,508,1,21,6,3,71,33,38,69
FC Midtjylla,508,2,19,5,6,65,40,25,62
Copenhagen,508,3,14,5,11,56,44,12,47
FC Nords,508,4,13,6,11,74,53,21,45
AaB,508,5,9,11,10,37,41,-4,38
AC Horsens,508,6,7,13,10,36,54,-18,34
Sonderjyske,508,7,8,6,10,28,29,-1,30
Randers FC,508,8,5,7,12,24,40,-16,22
Silkeborg IF,508,9,6,3,13,28,46,-18,21
Lyngby,508,10,3,10,11,27,45,-18,19
AGF Aarhus,508,11,4,6,12,18,39,-21,18
Brondby,509,1,20,6,4,69,34,35,66
FC Midtjylla,509,2,19,5,6,64,42,22,62
FC Nords,509,3,14,9,7,74,49,25,51
Copenhagen,509,4,14,5,11,54,43,11,47
AaB,509,5,7,13,10,39,43,-4,34
AC Horsens,509,6,6,14,10,36,51,-15,32
Sonderjyske,509,7,8,6,10,28,29,-1,30
Lyngby,509,8,4,9,11,29,45,-16,21
Randers FC,509,9,5,6,13,24,42,-18,21
Silkeborg IF,509,10,5,4,13,26,45,-19,19
AGF Aarhus,509,11,4,7,11,17,37,-20,19
Brondby,510,1,19,8,3,69,34,35,65
FC Midtjylla,510,2,19,5,6,66,39,27,62
FC Nords,510,3,14,8,8,83,54,29,50
Copenhagen,510,4,13,7,10,57,45,12,46
AaB,510,5,9,13,8,40,41,-1,40
Sonderjyske,510,6,8,6,10,28,29,-1,30
AC Horsens,510,7,5,13,12,32,60,-28,28
Lyngby,510,8,4,9,11,27,44,-17,21
Randers FC,510,9,5,6,13,23,40,-17,21
Silkeborg IF,510,10,6,3,13,26,44,-18,21
AGF Aarhus,510,11,4,6,12,16,37,-21,18
Brondby,511,1,20,7,3,68,33,35,67
FC Midtjylla,511,2,20,5,5,70,40,30,65
Copenhagen,511,3,15,6,9,61,44,17,51
FC Nords,511,4,14,7,9,80,53,27,49
AaB,511,5,6,14,10,35,43,-8,32
Sonderjyske,511,6,8,6,10,28,29,-1,30
AC Horsens,511,7,5,13,12,34,61,-27,28
Lyngby,511,8,4,9,11,28,44,-16,21
Randers FC,511,9,5,6,13,23,41,-18,21
Silkeborg IF,511,10,5,4,13,25,44,-19,19
AGF Aarhus,511,11,4,7,11,16,36,-20,19
Brondby,512,1,22,6,2,77,29,48,72
FC Midtjylla,512,2,19,5,6,63,39,24,62
FC Nords,512,3,15,7,8,72,48,24,52
Copenhagen,512,4,14,4,12,57,47,10,46
AC Horsens,512,5,7,12,11,36,53,-17,33
Sonderjyske,512,6,8,6,10,28,29,-1,30
AaB,512,7,6,12,12,37,52,-15,30
Randers FC,512,8,5,7,12,23,39,-16,22
Silkeborg IF,512,9,6,3,13,28,44,-16,21
Lyngby,512,10,3,10,11,26,44,-18,19
AGF Aarhus,512,11,4,6,12,16,39,-23,18
Brondby,513,1,21,5,4,68,32,36,68
FC Midtjylla,513,2,18,5,7,62,41,21,59
Copenhagen,513,3,14,7,9,56,40,16,49
FC Nords,513,4,13,8,9,73,53,20,47
AC Horsens,513,5,8,13,9,33,46,-13,37
AaB,513,6,6,14,10,35,41,-6,32
Sonderjyske,513,7,8,6,10,28,29,-1,30
Lyngby,513,8,4,9,11,29,45,-16,21
Randers FC,513,9,5,6,13,24,42,-18,21
Silkeborg IF,513,10,5,4,13,27,46,-19,19
AGF Aarhus,513,11,4,7,11,18,38,-20,19
Brondby,514,1,22,5,3,74,29,45,71
FC Midtjylla,514,2,19,5,6,66,42,24,62
Copenhagen,514,3,15,5,10,58,42,16,50
FC Nords,514,4,14,7,9,75,57,18,49
AaB,514,5,7,11,12,38,48,-10,32
AC Horsens,514,6,6,13,11,37,56,-19,31
Sonderjyske,514,7,8,6,10,28,29,-1,30
Randers FC,514,8,6,6,12,24,39,-15,24
Silkeborg IF,514,9,6,3,13,27,44,-17,21
Lyngby,514,10,3,9,12,26,45,-19,18
AGF Aarhus,514,11,4,6,12,16,38,-22,18
Brondby,515,1,19,7,4,68,35,33,64
FC Midtjylla,515,2,19,5,6,68,40,28,62
Copenhagen,515,3,14,6,10,58,45,13,48
FC Nords,515,4,12,7,11,67,51,16,43
AaB,515,5,10,12,8,40,39,1,42
AC Horsens,515,6,6,15,9,36,53,-17,33
Sonderjyske,515,7,8,6,10,28,29,-1,30
Randers FC,515,8,6,6,12,27,40,-13,24
AGF Aarhus,515,9,5,6,11,17,36,-19,21
Silkeborg IF,515,10,5,3,14,25,45,-20,18
Lyngby,515,11,3,9,12,27,48,-21,18
Brondby,516,1,22,5,3,75,35,40,71
FC Midtjylla,516,2,19,5,6,63,39,24,62
FC Nords,516,3,14,7,9,76,53,23,49
Copenhagen,516,4,14,4,12,59,47,12,46
AaB,516,5,8,12,10,39,42,-3,36
Sonderjyske,516,6,8,6,10,28,29,-1,30
AC Horsens,516,7,5,15,10,33,55,-22,30
Lyngby,516,8,4,9,11,28,44,-16,21
Silkeborg IF,516,9,6,3,13,27,45,-18,21
Randers FC,516,10,5,6,13,23,41,-18,21
AGF Aarhus,516,11,4,6,12,17,38,-21,18
Brondby,517,1,21,6,3,74,33,41,69
FC Midtjylla,517,2,20,4,6,69,38,31,64
FC Nords,517,3,15,6,9,75,56,19,51
Copenhagen,517,4,15,4,11,62,46,16,49
AaB,517,5,7,12,11,40,49,-9,33
Sonderjyske,517,6,8,6,10,28,29,-1,30
AC Horsens,517,7,6,12,12,38,62,-24,30
Randers FC,517,8,5,7,12,23,39,-16,22
Silkeborg IF,517,9,6,3,13,29,47,-18,21
Lyngby,517,10,3,10,11,26,44,-18,19
AGF Aarhus,517,11,4,6,12,19,40,-21,18
Brondby,518,1,21,5,4,70,33,37,68
FC Midtjylla,518,2,21,4,5,70,41,29,67
Copenhagen,518,3,14,5,11,57,46,11,47
FC Nords,518,4,13,6,11,72,55,17,45
AaB,518,5,10,11,9,42,42,0,41
Sonderjyske,518,6,8,6,10,28,29,-1,30
AC Horsens,518,7,5,13,12,31,51,-20,28
Randers FC,518,8,6,6,12,24,39,-15,24
Silkeborg IF,518,9,6,3,13,28,44,-16,21
Lyngby,518,10,3,9,12,26,45,-19,18
AGF Aarhus,518,11,4,6,12,16,39,-23,18
Brondby,519,1,22,6,2,71,31,40,72
FC Midtjylla,519,2,20,5,5,64,37,27,65
FC Nords,519,3,13,7,10,77,55,22,46
Copenhagen,519,4,14,4,12,53,41,12,46
AaB,519,5,9,12,9,38,40,-2,39
Sonderjyske,519,6,8,6,10,28,29,-1,30
AC Horsens,519,7,5,12,13,33,58,-25,27
Lyngby,519,8,4,9,11,28,44,-16,21
Randers FC,519,9,5,6,13,23,41,-18,21
AGF Aarhus,519,10,5,6,11,18,37,-19,21
Silkeborg IF,519,11,5,3,14,26,46,-20,18
Brondby,520,1,20,8,2,72,32,40,68
FC Midtjylla,520,2,21,4,5,63,37,26,67
FC Nords,520,3,13,9,8,73,53,20,48
Copenhagen,520,4,13,6,11,57,44,13,45
AC Horsens,520,5,7,13,10,36,51,-15,34
Sonderjyske,520,6,8,6,10,28,29,-1,30
AaB,520,7,6,12,12,34,44,-10,30
Randers FC,520,8,5,7,12,23,39,-16,22
Silkeborg IF,520,9,6,3,13,28,46,-18,21
Lyngby,520,10,3,10,11,26,44,-18,19
AGF Aarhus,520,11,4,6,12,18,39,-21,18
Brondby,521,1,22,5,3,73,32,41,71
FC Midtjylla,521,2,20,5,5,67,38,29,65
FC Nords,521,3,14,7,9,75,51,24,49
Copenhagen,521,4,13,6,11,58,44,14,45
AaB,521,5,7,14,9,37,42,-5,35
Sonderjyske,521,6,8,6,10,28,29,-1,30
AC Horsens,521,7,5,13,12,32,61,-29,28
Silkeborg IF,521,8,6,3,13,29,45,-16,21
Lyngby,521,9,4,9,11,28,45,-17,21
Randers FC,521,10,5,6,13,24,41,-17,21
AGF Aarhus,521,11,4,6,12,17,40,-23,18
Brondby,522,1,22,6,2,74,31,43,72
FC Midtjylla,522,2,19,6,5,66,40,26,63
FC Nords,522,3,14,7,9,79,58,21,49
Copenhagen,522,4,12,8,10,53,42,11,44
AaB,522,5,7,12,11,39,42,-3,33
AC Horsens,522,6,6,13,11,36,60,-24,31
Sonderjyske,522,7,8,6,10,28,29,-1,30
Lyngby,522,8,4,9,11,31,45,-14,21
AGF Aarhus,522,9,5,6,11,19,38,-19,21
Randers FC,522,10,5,6,13,24,44,-20,21
Silkeborg IF,522,11,5,3,14,27,47,-20,18
Brondby,523,1,20,6,4,70,32,38,66
FC Midtjylla,523,2,19,5,6,64,39,25,62
FC Nords,523,3,16,6,8,77,46,31,54
Copenhagen,523,4,14,6,10,58,45,13,48
AC Horsens,523,5,7,14,9,36,52,-16,35
Sonderjyske,523,6,8,6,10,28,29,-1,30
AaB,523,7,6,11,13,34,51,-17,29
Randers FC,523,8,6,6,12,26,40,-14,24
AGF Aarhus,523,9,5,6,11,19,36,-17,21
Lyngby,523,10,3,9,12,27,47,-20,18
Silkeborg IF,523,11,5,3,14,25,47,-22,18
Brondby,524,1,21,5,4,67,33,34,68
FC Midtjylla,524,2,19,6,5,69,40,29,63
FC Nords,524,3,14,7,9,74,52,22,49
Copenhagen,524,4,12,5,13,53,46,7,41
AC Horsens,524,5,8,14,8,37,47,-10,38
AaB,524,6,8,11,11,37,45,-8,35
Sonderjyske,524,7,8,6,10,28,29,-1,30
Randers FC,524,8,6,6,12,26,41,-15,24
Silkeborg IF,524,9,6,3,13,29,46,-17,21
Lyngby,524,10,3,9,12,28,47,-19,18
AGF Aarhus,524,11,4,6,12,18,40,-22,18
Brondby,525,1,22,5,3,76,29,47,71
FC Midtjylla,525,2,21,4,5,69,36,33,67
Copenhagen,525,3,15,4,11,58,43,15,49
FC Nords,525,4,12,8,10,67,55,12,44
AaB,525,5,7,12,11,35,45,-10,33
AC Horsens,525,6,6,13,11,35,58,-23,31
Sonderjyske,525,7,8,6,10,28,29,-1,30
Randers FC,525,8,5,7,12,25,41,-16,22
Silkeborg IF,525,9,6,3,13,27,45,-18,21
Lyngby,525,10,3,10,11,28,46,-18,19
AGF Aarhus,525,11,4,6,12,17,38,-21,18
Brondby,526,1,21,5,4,70,32,38,68
FC Midtjylla,526,2,20,4,6,65,41,24,64
Copenhagen,526,3,15,4,11,56,43,13,49
FC Nords,526,4,14,6,10,72,49,23,48
AaB,526,5,8,11,11,34,40,-6,35
AC Horsens,526,6,7,12,11,35,53,-18,33
Sonderjyske,526,7,8,6,10,28,29,-1,30
Lyngby,526,8,4,9,11,28,44,-16,21
Randers FC,526,9,5,6,13,23,41,-18,21
AGF Aarhus,526,10,5,6,11,18,37,-19,21
Silkeborg IF,526,11,5,3,14,26,46,-20,18
Brondby,527,1,19,7,4,66,32,34,64
FC Midtjylla,527,2,20,4,6,65,41,24,64
Copenhagen,527,3,16,4,10,59,40,19,52
FC Nords,527,4,14,6,10,71,53,18,48
AaB,527,5,7,13,10,34,40,-6,34
AC Horsens,527,6,6,14,10,37,52,-15,32
Sonderjyske,527,7,8,6,10,28,29,-1,30
Randers FC,527,8,5,7,12,23,39,-16,22
Lyngby,527,9,3,10,11,26,44,-18,19
Silkeborg IF,527,10,5,4,13,27,46,-19,19
AGF Aarhus,527,11,4,7,11,18,38,-20,19
Brondby,528,1,21,7,2,73,32,41,70
FC Midtjylla,528,2,18,6,6,61,38,23,60
Copenhagen,528,3,15,5,10,59,45,14,50
FC Nords,528,4,14,7,9,75,51,24,49
AC Horsens,528,5,7,14,9,38,52,-14,35
Sonderjyske,528,6,8,6,10,28,29,-1,30
AaB,528,7,6,11,13,32,46,-14,29
Randers FC,528,8,6,6,12,26,40,-14,24
AGF Aarhus,528,9,5,6,11,17,36,-19,21
Lyngby,528,10,3,9,12,27,47,-20,18
Silkeborg IF,528,11,5,3,14,25,45,-20,18
Brondby,529,1,21,7,2,76,31,45,70
FC Midtjylla,529,2,17,7,6,63,41,22,58
Copenhagen,529,3,14,7,9,57,42,15,49
FC Nords,529,4,13,9,8,72,52,20,48
AaB,529,5,7,13,10,41,47,-6,34
AC Horsens,529,6,6,13,11,35,57,-22,31
Sonderjyske,529,7,8,6,10,28,29,-1,30
Randers FC,529,8,5,7,12,24,40,-16,22
Silkeborg IF,529,9,6,3,13,27,45,-18,21
Lyngby,529,10,3,10,11,27,45,-18,19
AGF Aarhus,529,11,4,6,12,17,38,-21,18
Brondby,530,1,22,5,3,74,33,41,71
FC Midtjylla,530,2,19,4,7,64,42,22,61
FC Nords,530,3,14,6,10,75,49,26,48
Copenhagen,530,4,14,4,12,55,43,12,46
AaB,530,5,8,12,10,38,44,-6,36
AC Horsens,530,6,7,13,10,35,56,-21,34
Sonderjyske,530,7,8,6,10,28,29,-1,30
Randers FC,530,8,5,7,12,24,40,-16,22
Lyngby,530,9,3,10,11,27,45,-18,19
Silkeborg IF,530,10,5,4,13,28,47,-19,19
AGF Aarhus,530,11,4,7,11,19,39,-20,19
FC Midtjylla,531,1,21,5,4,68,36,32,68
Brondby,531,2,19,7,4,69,40,29,64
FC Nords,531,3,15,7,8,77,49,28,52
Copenhagen,531,4,13,5,12,60,50,10,44
AaB,531,5,8,11,11,38,48,-10,35
AC Horsens,531,6,6,13,11,36,51,-15,31
Sonderjyske,531,7,8,6,10,28,29,-1,30
Randers FC,531,8,6,6,12,25,40,-15,24
Silkeborg IF,531,9,6,3,13,27,44,-17,21
Lyngby,531,10,3,9,12,27,46,-19,18
AGF Aarhus,531,11,4,6,12,16,38,-22,18
Brondby,532,1,20,5,5,69,34,35,65
FC Midtjylla,532,2,19,5,6,62,40,22,62
FC Nords,532,3,15,6,9,72,49,23,51
Copenhagen,532,4,14,6,10,56,42,14,48
AaB,532,5,8,12,10,36,40,-4,36
AC Horsens,532,6,6,14,10,32,48,-16,32
Sonderjyske,532,7,8,6,10,28,29,-1,30
Randers FC,532,8,6,6,12,26,39,-13,24
Silkeborg IF,532,9,6,3,13,26,44,-18,21
Lyngby,532,10,3,9,12,26,47,-21,18
AGF Aarhus,532,11,4,6,12,16,37,-21,18
FC Midtjylla,533,1,20,5,5,69,40,29,65
Brondby,533,2,18,6,6,68,38,30,60
FC Nords,533,3,14,8,8,74,51,23,50
Copenhagen,533,4,14,7,9,61,43,18,49
AaB,533,5,7,13,10,36,44,-8,34
AC Horsens,533,6,7,13,10,36,54,-18,34
Sonderjyske,533,7,8,6,10,28,29,-1,30
Randers FC,533,8,6,6,12,25,40,-15,24
Silkeborg IF,533,9,6,3,13,28,45,-17,21
Lyngby,533,10,3,9,12,27,46,-19,18
AGF Aarhus,533,11,4,6,12,17,39,-22,18
FC Midtjylla,534,1,20,4,6,67,38,29,64
Brondby,534,2,19,5,6,66,36,30,62
Copenhagen,534,3,15,5,10,60,43,17,50
FC Nords,534,4,14,6,10,74,54,20,48
AaB,534,5,8,12,10,41,46,-5,36
AC Horsens,534,6,8,12,10,35,52,-17,36
Sonderjyske,534,7,8,6,10,28,29,-1,30
Lyngby,534,8,4,9,11,28,45,-17,21
Randers FC,534,9,5,6,13,24,41,-17,21
Silkeborg IF,534,10,6,3,13,27,45,-18,21
AGF Aarhus,534,11,4,6,12,17,38,-21,18
Brondby,535,1,23,5,2,79,29,50,74
FC Midtjylla,535,2,17,5,8,61,43,18,56
FC Nords,535,3,15,6,9,78,55,23,51
Copenhagen,535,4,14,4,12,58,54,4,46
AaB,535,5,8,11,11,36,48,-12,35
AC Horsens,535,6,7,13,10,40,49,-9,34
Sonderjyske,535,7,8,6,10,28,29,-1,30
Randers FC,535,8,6,6,12,27,39,-12,24
Silkeborg IF,535,9,6,3,13,26,44,-18,21
AGF Aarhus,535,10,4,6,12,16,37,-21,18
Lyngby,535,11,3,9,12,26,48,-22,18
Brondby,536,1,20,6,4,72,35,37,66
FC Midtjylla,536,2,19,6,5,63,38,25,63
FC Nords,536,3,14,7,9,73,50,23,49
Copenhagen,536,4,14,5,11,57,44,13,47
AaB,536,5,8,11,11,37,45,-8,35
AC Horsens,536,6,7,13,10,38,54,-16,34
Sonderjyske,536,7,8,6,10,28,29,-1,30
Lyngby,536,8,4,9,11,30,46,-16,21
Randers FC,536,9,5,6,13,25,43,-18,21
AGF Aarhus,536,10,5,6,11,17,36,-19,21
Silkeborg IF,536,11,5,3,14,25,45,-20,18
Brondby,537,1,20,6,4,69,35,34,66
FC Midtjylla,537,2,19,4,7,65,43,22,61
FC Nords,537,3,14,6,10,71,50,21,48
Copenhagen,537,4,14,4,12,61,50,11,46
AaB,537,5,9,11,10,36,39,-3,38
AC Horsens,537,6,8,13,9,42,53,-11,37
Sonderjyske,537,7,8,6,10,28,29,-1,30
Lyngby,537,8,4,9,11,30,46,-16,21
Randers FC,537,9,5,6,13,25,43,-18,21
AGF Aarhus,537,10,5,6,11,17,36,-19,21
Silkeborg IF,537,11,5,3,14,25,45,-20,18
Brondby,538,1,20,5,5,67,35,32,65
FC Midtjylla,538,2,17,6,7,63,44,19,57
FC Nords,538,3,15,8,7,74,47,27,53
Copenhagen,538,4,15,4,11,57,45,12,49
AC Horsens,538,5,8,12,10,41,53,-12,36
AaB,538,6,7,13,10,37,41,-4,34
Sonderjyske,538,7,8,6,10,28,29,-1,30
Randers FC,538,8,6,6,12,27,42,-15,24
AGF Aarhus,538,9,5,6,11,17,36,-19,21
Lyngby,538,10,3,9,12,29,48,-19,18
Silkeborg IF,538,11,5,3,14,25,45,-20,18
Brondby,539,1,22,5,3,75,34,41,71
FC Midtjylla,539,2,18,5,7,62,40,22,59
Copenhagen,539,3,15,5,10,58,44,14,50
FC Nords,539,4,13,7,10,72,56,16,46
AC Horsens,539,5,7,15,8,37,49,-12,36
AaB,539,6,7,11,12,39,46,-7,32
Sonderjyske,539,7,8,6,10,28,29,-1,30
Lyngby,539,8,4,9,11,28,44,-16,21
Randers FC,539,9,5,6,13,23,41,-18,21
Silkeborg IF,539,10,5,4,13,26,45,-19,19
AGF Aarhus,539,11,4,7,11,17,37,-20,19
Brondby,540,1,20,7,3,68,32,36,67
FC Midtjylla,540,2,18,7,5,64,39,25,61
FC Nords,540,3,16,6,8,73,48,25,54
Copenhagen,540,4,15,5,10,62,45,17,50
AaB,540,5,6,13,11,36,46,-10,31
Sonderjyske,540,6,8,6,10,28,29,-1,30
AC Horsens,540,7,6,12,12,34,53,-19,30
Randers FC,540,8,6,6,12,24,39,-15,24
Silkeborg IF,540,9,6,3,13,29,45,-16,21
Lyngby,540,10,3,9,12,26,45,-19,18
AGF Aarhus,540,11,4,6,12,17,40,-23,18
FC Midtjylla,541,1,22,4,4,69,34,35,70
Brondby,541,2,21,6,3,73,35,38,69
FC Nords,541,3,14,6,10,72,55,17,48
Copenhagen,541,4,12,5,13,57,48,9,41
AaB,541,5,8,12,10,36,41,-5,36
AC Horsens,541,6,6,13,11,35,55,-20,31
Sonderjyske,541,7,8,6,10,28,29,-1,30
Randers FC,541,8,5,7,12,24,40,-16,22
Silkeborg IF,541,9,6,3,13,28,46,-18,21
Lyngby,541,10,3,10,11,27,45,-18,19
AGF Aarhus,541,11,4,6,12,18,39,-21,18
Brondby,542,1,22,6,2,73,33,40,72
FC Midtjylla,542,2,19,4,7,65,43,22,61
FC Nords,542,3,15,7,8,77,50,27,52
Copenhagen,542,4,15,5,10,57,41,16,50
AaB,542,5,7,12,11,38,47,-9,33
Sonderjyske,542,6,8,6,10,28,29,-1,30
AC Horsens,542,7,5,12,13,31,53,-22,27
Lyngby,542,8,4,9,11,28,45,-17,21
Randers FC,542,9,5,6,13,24,41,-17,21
Silkeborg IF,542,10,6,3,13,27,45,-18,21
AGF Aarhus,542,11,4,6,12,17,38,-21,18
Brondby,543,1,21,5,4,72,34,38,68
FC Midtjylla,543,2,19,5,6,62,40,22,62
Copenhagen,543,3,16,4,10,59,40,19,52
FC Nords,543,4,14,7,9,69,48,21,49
AaB,543,5,7,11,12,35,44,-9,32
AC Horsens,543,6,6,14,10,34,51,-17,32
Sonderjyske,543,7,8,6,10,28,29,-1,30
Randers FC,543,8,5,7,12,24,40,-16,22
AGF Aarhus,543,9,5,6,11,18,36,-18,21
Lyngby,543,10,3,10,11,27,45,-18,19
Silkeborg IF,543,11,5,3,14,25,46,-21,18
Brondby,544,1,20,7,3,70,34,36,67
FC Midtjylla,544,2,19,5,6,63,39,24,62
Copenhagen,544,3,15,5,10,63,46,17,50
FC Nords,544,4,14,7,9,75,55,20,49
AaB,544,5,7,12,11,37,46,-9,33
AC Horsens,544,6,7,12,11,36,50,-14,33
Sonderjyske,544,7,8,6,10,28,29,-1,30
Randers FC,544,8,5,7,12,25,41,-16,22
AGF Aarhus,544,9,5,6,11,17,36,-19,21
Lyngby,544,10,3,10,11,28,46,-18,19
Silkeborg IF,544,11,5,3,14,25,45,-20,18
Brondby,545,1,21,5,4,66,32,34,68
FC Midtjylla,545,2,20,4,6,65,43,22,64
FC Nords,545,3,14,7,9,75,53,22,49
Copenhagen,545,4,13,7,10,58,42,16,46
AC Horsens,545,5,7,13,10,36,51,-15,34
AaB,545,6,7,12,11,36,41,-5,33
Sonderjyske,545,7,8,6,10,28,29,-1,30
Randers FC,545,8,5,7,12,23,39,-16,22
Lyngby,545,9,3,10,11,26,44,-18,19
Silkeborg IF,545,10,5,4,13,25,44,-19,19
AGF Aarhus,545,11,4,7,11,16,36,-20,19
Brondby,546,1,22,5,3,69,29,40,71
FC Midtjylla,546,2,19,6,5,69,43,26,63
FC Nords,546,3,14,7,9,77,52,25,49
Copenhagen,546,4,14,6,10,57,43,14,48
AaB,546,5,6,13,11,34,46,-12,31
AC Horsens,546,6,6,13,11,36,55,-19,31
Sonderjyske,546,7,8,6,10,28,29,-1,30
Lyngby,546,8,4,9,11,28,44,-16,21
Silkeborg IF,546,9,6,3,13,27,44,-17,21
Randers FC,546,10,5,6,13,23,41,-18,21
AGF Aarhus,546,11,4,6,12,16,38,-22,18
Brondby,547,1,19,8,3,69,36,33,65
FC Midtjylla,547,2,20,5,5,69,39,30,65
FC Nords,547,3,14,8,8,76,51,25,50
Copenhagen,547,4,13,6,11,56,46,10,45
AaB,547,5,8,13,9,39,42,-3,37
Sonderjyske,547,6,8,6,10,28,29,-1,30
AC Horsens,547,7,5,14,11,35,56,-21,29
Lyngby,547,8,4,9,11,28,44,-16,21
Randers FC,547,9,5,6,13,23,41,-18,21
AGF Aarhus,547,10,5,6,11,19,37,-18,21
Silkeborg IF,547,11,5,3,14,26,47,-21,18
FC Midtjylla,548,1,20,5,5,69,39,30,65
Brondby,548,2,19,7,4,69,35,34,64
FC Nords,548,3,14,8,8,72,52,20,50
Copenhagen,548,4,14,6,10,56,42,14,48
AaB,548,5,7,12,11,37,46,-9,33
AC Horsens,548,6,7,12,11,42,57,-15,33
Sonderjyske,548,7,8,6,10,28,29,-1,30
Randers FC,548,8,5,7,12,23,39,-16,22
Lyngby,548,9,3,10,11,26,44,-18,19
Silkeborg IF,548,10,5,4,13,28,47,-19,19
AGF Aarhus,548,11,4,7,11,19,39,-20,19
Brondby,549,1,21,6,3,68,28,40,69
FC Midtjylla,549,2,20,4,6,64,35,29,64
Copenhagen,549,3,14,6,10,56,43,13,48
FC Nords,549,4,13,7,10,68,52,16,46
AaB,549,5,8,12,10,35,40,-5,36
AC Horsens,549,6,6,13,11,35,54,-19,31
Sonderjyske,549,7,8,6,10,28,29,-1,30
Silkeborg IF,549,8,6,3,13,31,46,-15,21
Lyngby,549,9,4,9,11,27,44,-17,21
Randers FC,549,10,5,6,13,23,40,-17,21
AGF Aarhus,549,11,4,6,12,18,42,-24,18
Brondby,550,1,20,5,5,67,31,36,65
FC Midtjylla,550,2,19,5,6,64,41,23,62
FC Nords,550,3,14,6,10,74,53,21,48
Copenhagen,550,4,14,5,11,55,44,11,47
AC Horsens,550,5,8,13,9,35,48,-13,37
AaB,550,6,8,12,10,38,42,-4,36
Sonderjyske,550,7,8,6,10,28,29,-1,30
Randers FC,550,8,5,7,12,25,41,-16,22
Lyngby,550,9,3,10,11,28,46,-18,19
Silkeborg IF,550,10,5,4,13,27,46,-19,19
AGF Aarhus,550,11,4,7,11,18,38,-20,19
Brondby,551,1,21,6,3,69,32,37,69
FC Midtjylla,551,2,21,4,5,69,36,33,67
Copenhagen,551,3,14,6,10,55,40,15,48
FC Nords,551,4,12,9,9,68,50,18,45
AaB,551,5,6,14,10,32,40,-8,32
Sonderjyske,551,6,8,6,10,28,29,-1,30
AC Horsens,551,7,5,15,10,31,52,-21,30
Randers FC,551,8,5,7,12,25,41,-16,22
Lyngby,551,9,3,10,11,28,46,-18,19
Silkeborg IF,551,10,5,4,13,26,45,-19,19
AGF Aarhus,551,11,4,7,11,17,37,-20,19
Brondby,552,1,21,6,3,72,35,37,69
FC Midtjylla,552,2,19,4,7,64,40,24,61
FC Nords,552,3,15,7,8,77,54,23,52
Copenhagen,552,4,14,7,9,64,45,19,49
AaB,552,5,8,11,11,40,46,-6,35
Sonderjyske,552,6,8,6,10,28,29,-1,30
AC Horsens,552,7,5,13,12,33,56,-23,28
Silkeborg IF,552,8,6,3,13,28,44,-16,21
Lyngby,552,9,4,9,11,28,45,-17,21
Randers FC,552,10,5,6,13,24,41,-17,21
AGF Aarhus,552,11,4,6,12,16,39,-23,18
FC Midtjylla,553,1,20,4,6,65,39,26,64
Brondby,553,2,18,5,7,63,35,28,59
FC Nords,553,3,15,7,8,76,50,26,52
Copenhagen,553,4,15,5,10,56,41,15,50
AaB,553,5,8,11,11,37,44,-7,35
AC Horsens,553,6,7,14,9,37,51,-14,35
Sonderjyske,553,7,8,6,10,28,29,-1,30
Lyngby,553,8,4,9,11,29,44,-15,21
Silkeborg IF,553,9,6,3,13,27,45,-18,21
Randers FC,553,10,5,6,13,23,42,-19,21
AGF Aarhus,553,11,4,6,12,17,38,-21,18
Brondby,554,1,21,5,4,71,30,41,68
FC Midtjylla,554,2,21,4,5,68,37,31,67
FC Nords,554,3,15,6,9,72,50,22,51
Copenhagen,554,4,15,5,10,63,49,14,50
AaB,554,5,7,11,12,35,47,-12,32
Sonderjyske,554,6,8,6,10,28,29,-1,30
AC Horsens,554,7,5,13,12,34,56,-22,28
Lyngby,554,8,4,9,11,27,44,-17,21
Silkeborg IF,554,8,6,3,13,27,44,-17,21
Randers FC,554,10,5,6,13,23,40,-17,21
AGF Aarhus,554,11,4,6,12,16,38,-22,18
FC Midtjylla,555,1,21,4,5,68,40,28,67
Brondby,555,2,20,6,4,71,37,34,66
FC Nords,555,3,14,6,10,70,50,20,48
Copenhagen,555,4,13,6,11,56,43,13,45
AaB,555,5,8,12,10,38,44,-6,36
AC Horsens,555,6,6,14,10,35,50,-15,32
Sonderjyske,555,7,8,6,10,28,29,-1,30
Randers FC,555,8,5,7,12,24,40,-16,22
Silkeborg IF,555,9,6,3,13,27,44,-17,21
Lyngby,555,10,3,10,11,27,45,-18,19
AGF Aarhus,555,11,4,6,12,16,38,-22,18
FC Midtjylla,556,1,21,4,5,66,38,28,67
Brondby,556,2,20,6,4,67,31,36,66
FC Nords,556,3,15,6,9,76,55,21,51
Copenhagen,556,4,14,5,11,60,45,15,47
AC Horsens,556,5,7,12,11,38,56,-18,33
AaB,556,6,7,11,12,38,46,-8,32
Sonderjyske,556,7,8,6,10,28,29,-1,30
Lyngby,556,8,4,9,11,29,46,-17,21
Randers FC,556,9,5,6,13,25,42,-17,21
Silkeborg IF,556,10,6,3,13,27,45,-18,21
AGF Aarhus,556,11,4,6,12,17,38,-21,18
Brondby,557,1,19,7,4,67,32,35,64
FC Midtjylla,557,2,20,4,6,67,38,29,64
FC Nords,557,3,14,8,8,76,55,21,50
Copenhagen,557,4,14,4,12,57,45,12,46
AC Horsens,557,5,8,12,10,37,52,-15,36
AaB,557,6,7,13,10,38,46,-8,34
Sonderjyske,557,7,8,6,10,28,29,-1,30
Lyngby,557,8,4,9,11,28,44,-16,21
Silkeborg IF,557,9,6,3,13,27,44,-17,21
Randers FC,557,10,5,6,13,23,41,-18,21
AGF Aarhus,557,11,4,6,12,16,38,-22,18
Brondby,558,1,21,6,3,71,33,38,69
FC Midtjylla,558,2,18,7,5,66,43,23,61
FC Nords,558,3,15,6,9,76,51,25,51
Copenhagen,558,4,13,7,10,56,46,10,46
AC Horsens,558,5,7,13,10,37,52,-15,34
AaB,558,6,6,13,11,40,47,-7,31
Sonderjyske,558,7,8,6,10,28,29,-1,30
Randers FC,558,8,5,7,12,25,41,-16,22
Silkeborg IF,558,9,6,3,13,29,45,-16,21
Lyngby,558,10,3,10,11,28,46,-18,19
AGF Aarhus,558,11,4,6,12,17,40,-23,18
Brondby,559,1,21,7,2,75,35,40,70
FC Midtjylla,559,2,18,7,5,67,43,24,61
FC Nords,559,3,13,9,8,75,55,20,48
Copenhagen,559,4,13,6,11,58,46,12,45
AaB,559,5,9,12,9,44,43,1,39
Sonderjyske,559,6,8,6,10,28,29,-1,30
AC Horsens,559,7,5,13,12,33,56,-23,28
Lyngby,559,8,4,9,11,28,44,-16,21
Silkeborg IF,559,9,6,3,13,27,44,-17,21
Randers FC,559,10,5,6,13,23,41,-18,21
AGF Aarhus,559,11,4,6,12,16,38,-22,18
Brondby,560,1,20,6,4,68,36,32,66
FC Midtjylla,560,2,20,5,5,69,42,27,65
FC Nords,560,3,14,7,9,73,51,22,49
Copenhagen,560,4,14,6,10,59,42,17,48
AaB,560,5,7,12,11,38,46,-8,33
AC Horsens,560,6,7,12,11,36,52,-16,33
Sonderjyske,560,7,8,6,10,28,29,-1,30
Lyngby,560,8,4,9,11,29,44,-15,21
Randers FC,560,9,5,6,13,23,42,-19,21
Silkeborg IF,560,10,5,4,13,25,44,-19,19
AGF Aarhus,560,11,4,7,11,16,36,-20,19
Brondby,561,1,20,8,2,73,32,41,68
FC Midtjylla,561,2,18,7,5,68,42,26,61
FC Nords,561,3,14,7,9,73,53,20,49
Copenhagen,561,4,13,6,11,60,48,12,45
AC Horsens,561,5,7,14,9,37,54,-17,35
AaB,561,6,6,14,10,35,43,-8,32
Sonderjyske,561,7,8,6,10,28,29,-1,30
Randers FC,561,8,5,7,12,24,40,-16,22
Lyngby,561,9,3,10,11,27,45,-18,19
Silkeborg IF,561,10,5,4,13,25,44,-19,19
AGF Aarhus,561,11,4,7,11,16,36,-20,19
Brondby,562,1,21,6,3,72,33,39,69
FC Midtjylla,562,2,20,5,5,71,40,31,65
FC Nords,562,3,15,7,8,81,54,27,52
Copenhagen,562,4,14,5,11,57,46,11,47
AaB,562,5,7,11,12,34,47,-13,32
Sonderjyske,562,6,8,6,10,28,29,-1,30
AC Horsens,562,7,6,12,12,35,56,-21,30
Randers FC,562,8,6,6,12,29,40,-11,24
Silkeborg IF,562,9,5,4,13,25,44,-19,19
AGF Aarhus,562,10,4,7,11,16,36,-20,19
Lyngby,562,11,3,9,12,27,50,-23,18
Brondby,563,1,20,6,4,67,30,37,66
FC Midtjylla,563,2,20,5,5,69,36,33,65
Copenhagen,563,3,16,4,10,59,42,17,52
FC Nords,563,4,13,6,11,69,59,10,45
AaB,563,5,8,11,11,38,45,-7,35
AC Horsens,563,6,7,12,11,36,52,-16,33
Sonderjyske,563,7,8,6,10,28,29,-1,30
Lyngby,563,8,4,9,11,30,45,-15,21
Silkeborg IF,563,9,6,3,13,27,44,-17,21
Randers FC,563,10,5,6,13,24,43,-19,21
AGF Aarhus,563,11,4,6,12,16,38,-22,18
Brondby,564,1,22,5,3,73,31,42,71
FC Midtjylla,564,2,19,6,5,65,38,27,63
FC Nords,564,3,15,7,8,77,54,23,52
Copenhagen,564,4,12,5,13,54,49,5,41
AaB,564,5,7,13,10,36,41,-5,34
AC Horsens,564,6,7,12,11,37,55,-18,33
Sonderjyske,564,7,8,6,10,28,29,-1,30
Randers FC,564,8,6,6,12,24,39,-15,24
Silkeborg IF,564,9,5,4,13,25,44,-19,19
AGF Aarhus,564,10,4,7,11,16,36,-20,19
Lyngby,564,11,3,9,12,26,45,-19,18
Brondby,565,1,21,6,3,70,30,40,69
FC Midtjylla,565,2,20,5,5,65,37,28,65
FC Nords,565,3,15,6,9,72,49,23,51
Copenhagen,565,4,14,5,11,56,46,10,47
AaB,565,5,7,11,12,37,45,-8,32
AC Horsens,565,6,6,13,11,40,59,-19,31
Sonderjyske,565,7,8,6,10,28,29,-1,30
Randers FC,565,8,6,6,12,24,39,-15,24
AGF Aarhus,565,9,5,6,11,18,36,-18,21
Lyngby,565,10,3,9,12,26,45,-19,18
Silkeborg IF,565,11,5,3,14,25,46,-21,18
Brondby,566,1,20,7,3,70,31,39,67
FC Midtjylla,566,2,20,6,4,65,38,27,66
Copenhagen,566,3,14,6,10,56,42,14,48
FC Nords,566,4,13,8,9,77,53,24,47
AC Horsens,566,5,7,12,11,35,58,-23,33
AaB,566,6,6,13,11,35,42,-7,31
Sonderjyske,566,7,8,6,10,28,29,-1,30
Randers FC,566,8,5,7,12,24,40,-16,22
AGF Aarhus,566,9,5,6,11,21,37,-16,21
Lyngby,566,10,3,10,11,27,45,-18,19
Silkeborg IF,566,11,5,3,14,26,49,-23,18
FC Midtjylla,567,1,21,5,4,69,37,32,68
Brondby,567,2,20,5,5,67,34,33,65
FC Nords,567,3,15,6,9,74,52,22,51
Copenhagen,567,4,14,5,11,56,43,13,47
AaB,567,5,8,13,9,39,40,-1,37
Sonderjyske,567,6,8,6,10,28,29,-1,30
AC Horsens,567,7,5,12,13,31,56,-25,27
Lyngby,567,8,4,9,11,28,45,-17,21
Randers FC,567,9,5,6,13,24,41,-17,21
Silkeborg IF,567,10,6,3,13,27,45,-18,21
AGF Aarhus,567,11,4,6,12,17,38,-21,18
Brondby,568,1,20,7,3,71,31,40,67
FC Midtjylla,568,2,18,7,5,71,45,26,61
FC Nords,568,3,15,7,8,74,50,24,52
Copenhagen,568,4,12,6,12,57,52,5,42
AC Horsens,568,5,7,14,9,36,51,-15,35
AaB,568,6,7,13,10,40,46,-6,34
Sonderjyske,568,7,8,6,10,28,29,-1,30
Randers FC,568,8,6,6,12,25,40,-15,24
Silkeborg IF,568,9,6,3,13,29,46,-17,21
Lyngby,568,10,3,9,12,27,46,-19,18
AGF Aarhus,568,11,4,6,12,18,40,-22,18
Brondby,569,1,21,5,4,66,33,33,68
FC Midtjylla,569,2,21,5,4,66,34,32,68
FC Nords,569,3,14,6,10,75,49,26,48
Copenhagen,569,4,14,4,12,57,42,15,46
AaB,569,5,8,11,11,34,41,-7,35
AC Horsens,569,6,6,13,11,32,57,-25,31
Sonderjyske,569,7,8,6,10,28,29,-1,30
Randers FC,569,8,5,7,12,23,39,-16,22
Silkeborg IF,569,9,6,3,13,27,44,-17,21
Lyngby,569,10,3,10,11,26,44,-18,19
AGF Aarhus,569,11,4,6,12,16,38,-22,18
Brondby,570,1,19,6,5,65,32,33,63
FC Midtjylla,570,2,18,7,5,61,37,24,61
FC Nords,570,3,13,9,8,71,49,22,48
Copenhagen,570,4,14,5,11,56,42,14,47
AaB,570,5,9,12,9,40,43,-3,39
AC Horsens,570,6,7,13,10,37,53,-16,34
Sonderjyske,570,7,8,6,10,28,29,-1,30
Randers FC,570,8,5,7,12,24,40,-16,22
AGF Aarhus,570,9,5,6,11,17,36,-19,21
Lyngby,570,10,3,10,11,27,45,-18,19
Silkeborg IF,570,11,5,3,14,25,45,-20,18
Brondby,571,1,22,5,3,70,27,43,71
FC Midtjylla,571,2,19,4,7,60,44,16,61
FC Nords,571,3,15,6,9,72,48,24,51
Copenhagen,571,4,14,4,12,57,43,14,46
AaB,571,5,8,11,11,35,40,-5,35
AC Horsens,571,6,7,12,11,32,50,-18,33
Sonderjyske,571,7,8,6,10,28,29,-1,30
Lyngby,571,8,4,9,11,29,44,-15,21
Randers FC,571,9,5,6,13,23,42,-19,21
Silkeborg IF,571,10,5,4,13,25,44,-19,19
AGF Aarhus,571,11,4,7,11,16,36,-20,19
Brondby,572,1,21,6,3,72,35,37,69
FC Midtjylla,572,2,19,4,7,67,39,28,61
FC Nords,572,3,17,6,7,76,48,28,57
Copenhagen,572,4,14,4,12,56,44,12,46
AaB,572,5,7,11,12,35,45,-10,32
AC Horsens,572,6,6,13,11,38,59,-21,31
Sonderjyske,572,7,8,6,10,28,29,-1,30
Randers FC,572,8,6,6,12,25,39,-14,24
AGF Aarhus,572,9,5,6,11,20,37,-17,21
Lyngby,572,10,3,9,12,26,46,-20,18
Silkeborg IF,572,11,5,3,14,26,48,-22,18
FC Midtjylla,573,1,21,4,5,68,39,29,67
Brondby,573,2,20,6,4,68,34,34,66
FC Nords,573,3,15,7,8,74,48,26,52
Copenhagen,573,4,14,4,12,56,47,9,46
AaB,573,5,6,14,10,36,42,-6,32
AC Horsens,573,6,6,13,11,36,54,-18,31
Sonderjyske,573,7,8,6,10,28,29,-1,30
Randers FC,573,8,5,7,12,24,40,-16,22
Silkeborg IF,573,9,6,3,13,27,44,-17,21
Lyngby,573,10,3,10,11,27,45,-18,19
AGF Aarhus,573,11,4,6,12,16,38,-22,18
Brondby,574,1,21,7,2,72,30,42,70
FC Midtjylla,574,2,21,5,4,72,43,29,68
FC Nords,574,3,14,6,10,70,50,20,48
Copenhagen,574,4,12,6,12,54,47,7,42
AC Horsens,574,5,7,13,10,36,51,-15,34
AaB,574,6,6,13,11,36,45,-9,31
Sonderjyske,574,7,8,6,10,28,29,-1,30
Lyngby,574,8,4,9,11,27,44,-17,21
Silkeborg IF,574,8,6,3,13,27,44,-17,21
Randers FC,574,10,5,6,13,23,40,-17,21
AGF Aarhus,574,11,4,6,12,16,38,-22,18
Brondby,575,1,22,5,3,76,35,41,71
FC Midtjylla,575,2,19,6,5,65,40,25,63
FC Nords,575,3,14,7,9,72,50,22,49
Copenhagen,575,4,13,5,12,52,43,9,44
AaB,575,5,7,14,9,36,40,-4,35
AC Horsens,575,6,6,13,11,32,51,-19,31
Sonderjyske,575,7,8,6,10,28,29,-1,30
Lyngby,575,8,4,9,11,28,45,-17,21
Randers FC,575,9,5,6,13,24,41,-17,21
Silkeborg IF,575,10,5,4,13,27,46,-19,19
AGF Aarhus,575,11,4,7,11,18,38,-20,19
Brondby,576,1,21,7,2,74,32,42,70
FC Midtjylla,576,2,19,4,7,62,42,20,61
FC Nords,576,3,14,7,9,74,48,26,49
Copenhagen,576,4,14,5,11,58,48,10,47
AaB,576,5,8,11,11,36,42,-6,35
AC Horsens,576,6,7,12,11,34,52,-18,33
Sonderjyske,576,7,8,6,10,28,29,-1,30
Randers FC,576,8,5,7,12,26,42,-16,22
Lyngby,576,9,3,10,11,29,47,-18,19
Silkeborg IF,576,10,5,4,13,28,47,-19,19
AGF Aarhus,576,11,4,7,11,19,39,-20,19
FC Midtjylla,577,1,20,6,4,67,37,30,66
Brondby,577,2,19,7,4,69,37,32,64
FC Nords,577,3,16,6,8,76,47,29,54
Copenhagen,577,4,13,5,12,58,49,9,44
AC Horsens,577,5,7,14,9,37,54,-17,35
Sonderjyske,577,6,8,6,10,28,29,-1,30
AaB,577,7,6,12,12,38,47,-9,30
Randers FC,577,8,5,7,12,23,39,-16,22
Silkeborg IF,577,9,6,3,13,28,44,-16,21
Lyngby,577,10,3,10,11,26,44,-18,19
AGF Aarhus,577,11,4,6,12,16,39,-23,18
Brondby,578,1,23,5,2,72,29,43,74
FC Midtjylla,578,2,20,5,5,64,37,27,65
FC Nords,578,3,15,6,9,81,56,25,51
Copenhagen,578,4,12,6,12,54,49,5,42
AaB,578,5,6,14,10,36,43,-7,32
Sonderjyske,578,6,8,6,10,28,29,-1,30
AC Horsens,578,7,5,14,11,31,50,-19,29
Randers FC,578,8,6,6,12,25,40,-15,24
Silkeborg IF,578,9,6,3,13,30,44,-14,21
Lyngby,578,10,3,9,12,27,46,-19,18
AGF Aarhus,578,11,4,6,12,16,41,-25,18
FC Midtjylla,579,1,22,4,4,78,40,38,70
Brondby,579,2,19,7,4,67,34,33,64
FC Nords,579,3,15,6,9,77,54,23,51
Copenhagen,579,4,12,5,13,56,51,5,41
AaB,579,5,9,12,9,40,44,-4,39
Sonderjyske,579,6,8,6,10,28,29,-1,30
AC Horsens,579,7,5,14,11,33,54,-21,29
Randers FC,579,8,5,7,12,24,40,-16,22
AGF Aarhus,579,9,5,6,11,19,37,-18,21
Lyngby,579,10,3,10,11,27,45,-18,19
Silkeborg IF,579,11,5,3,14,26,47,-21,18
Brondby,580,1,19,7,4,70,37,33,64
FC Midtjylla,580,2,19,7,4,64,38,26,64
FC Nords,580,3,15,6,9,84,56,28,51
Copenhagen,580,4,13,4,13,57,50,7,43
AaB,580,5,7,14,9,41,46,-5,35
AC Horsens,580,6,7,14,9,39,54,-15,35
Sonderjyske,580,7,8,6,10,28,29,-1,30
Lyngby,580,8,4,9,11,28,45,-17,21
Randers FC,580,9,5,6,13,24,41,-17,21
AGF Aarhus,580,10,5,6,11,19,36,-17,21
Silkeborg IF,580,11,5,3,14,25,47,-22,18
Brondby,581,1,19,7,4,69,34,35,64
FC Midtjylla,581,2,18,6,6,62,40,22,60
FC Nords,581,3,17,6,7,79,45,34,57
Copenhagen,581,4,15,5,10,58,43,15,50
AC Horsens,581,5,6,14,10,33,53,-20,32
Sonderjyske,581,6,8,6,10,28,29,-1,30
AaB,581,7,6,12,12,34,46,-12,30
Randers FC,581,8,6,6,12,24,39,-15,24
Silkeborg IF,581,9,6,3,13,28,45,-17,21
Lyngby,581,10,3,9,12,26,45,-19,18
AGF Aarhus,581,11,4,6,12,17,39,-22,18
Brondby,582,1,21,6,3,74,31,43,69
FC Midtjylla,582,2,20,4,6,66,41,25,64
FC Nords,582,3,14,7,9,74,55,19,49
Copenhagen,582,4,14,6,10,59,43,16,48
AC Horsens,582,5,7,14,9,36,47,-11,35
Sonderjyske,582,6,8,6,10,28,29,-1,30
AaB,582,7,6,11,13,32,50,-18,29
Randers FC,582,8,6,6,12,25,39,-14,24
Silkeborg IF,582,9,5,4,13,26,45,-19,19
AGF Aarhus,582,10,4,7,11,17,37,-20,19
Lyngby,582,11,3,9,12,26,46,-20,18
FC Midtjylla,583,1,21,5,4,69,35,34,68
Brondby,583,2,20,7,3,69,32,37,67
FC Nords,583,3,15,7,8,76,49,27,52
Copenhagen,583,4,13,6,11,56,47,9,45
AC Horsens,583,5,6,13,11,34,53,-19,31
Sonderjyske,583,6,8,6,10,28,29,-1,30
AaB,583,7,6,12,12,36,50,-14,30
Lyngby,583,8,4,9,11,29,45,-16,21
Silkeborg IF,583,9,6,3,13,28,45,-17,21
Randers FC,583,10,5,6,13,24,42,-18,21
AGF Aarhus,583,11,4,6,12,17,39,-22,18
FC Midtjylla,584,1,21,5,4,70,32,38,68
Brondby,584,2,18,7,5,66,36,30,61
FC Nords,584,3,15,6,9,72,52,20,51
Copenhagen,584,4,13,7,10,57,46,11,46
AaB,584,5,7,13,10,37,46,-9,34
AC Horsens,584,6,6,14,10,35,51,-16,32
Sonderjyske,584,7,8,6,10,28,29,-1,30
Randers FC,584,8,5,7,12,23,39,-16,22
Silkeborg IF,584,9,6,3,13,28,44,-16,21
Lyngby,584,10,3,10,11,26,44,-18,19
AGF Aarhus,584,11,4,6,12,16,39,-23,18
Brondby,585,1,20,6,4,70,34,36,66
FC Midtjylla,585,2,20,5,5,70,40,30,65
FC Nords,585,3,13,9,8,72,54,18,48
Copenhagen,585,4,14,6,10,60,46,14,48
AaB,585,5,8,11,11,43,47,-4,35
Sonderjyske,585,6,8,6,10,28,29,-1,30
AC Horsens,585,7,5,15,10,35,55,-20,30
Lyngby,585,8,4,9,11,28,44,-16,21
Silkeborg IF,585,9,6,3,13,27,45,-18,21
Randers FC,585,10,5,6,13,23,41,-18,21
AGF Aarhus,585,11,4,6,12,17,38,-21,18
FC Midtjylla,586,1,21,5,4,72,35,37,68
Brondby,586,2,21,5,4,70,37,33,68
FC Nords,586,3,14,6,10,75,52,23,48
Copenhagen,586,4,14,4,12,59,46,13,46
AaB,586,5,8,12,10,38,44,-6,36
Sonderjyske,586,6,8,6,10,28,29,-1,30
AC Horsens,586,7,5,14,11,30,56,-26,29
Lyngby,586,8,4,9,11,28,44,-16,21
Silkeborg IF,586,9,6,3,13,26,44,-18,21
Randers FC,586,10,5,6,13,23,41,-18,21
AGF Aarhus,586,11,4,6,12,16,37,-21,18
Brondby,587,1,22,6,2,76,33,43,72
FC Midtjylla,587,2,19,6,5,67,42,25,63
FC Nords,587,3,13,8,9,70,50,20,47
Copenhagen,587,4,12,7,11,56,48,8,43
AaB,587,5,8,12,10,39,41,-2,36
AC Horsens,587,6,6,13,11,33,53,-20,31
Sonderjyske,587,7,8,6,10,28,29,-1,30
Randers FC,587,8,6,6,12,25,39,-14,24
Silkeborg IF,587,9,5,4,13,26,45,-19,19
AGF Aarhus,587,10,4,7,11,17,37,-20,19
Lyngby,587,11,3,9,12,26,46,-20,18
Brondby,588,1,21,6,3,72,32,40,69
FC Midtjylla,588,2,21,5,4,72,38,34,68
FC Nords,588,3,14,7,9,69,50,19,49
Copenhagen,588,4,13,4,13,54,47,7,43
AaB,588,5,8,12,10,38,43,-5,36
Sonderjyske,588,6,8,6,10,28,29,-1,30
AC Horsens,588,7,5,14,11,35,56,-21,29
Lyngby,588,8,4,9,11,28,44,-16,21
Silkeborg IF,588,9,6,3,13,26,44,-18,21
Randers FC,588,10,5,6,13,23,41,-18,21
AGF Aarhus,588,11,4,6,12,16,37,-21,18
Brondby,589,1,20,7,3,70,32,38,67
FC Midtjylla,589,2,17,6,7,63,44,19,57
FC Nords,589,3,15,8,7,72,47,25,53
Copenhagen,589,4,14,5,11,56,43,13,47
AaB,589,5,8,11,11,38,43,-5,35
AC Horsens,589,6,7,13,10,34,50,-16,34
Sonderjyske,589,7,8,6,10,28,29,-1,30
Lyngby,589,8,4,9,11,28,45,-17,21
Randers FC,589,9,5,6,13,24,41,-17,21
Silkeborg IF,589,10,6,3,13,26,44,-18,21
AGF Aarhus,589,11,4,6,12,16,37,-21,18
Brondby,590,1,23,5,2,72,29,43,74
FC Midtjylla,590,2,19,6,5,64,39,25,63
FC Nords,590,3,14,6,10,74,53,21,48
Copenhagen,590,4,12,6,12,57,48,9,42
AaB,590,5,7,14,9,36,40,-4,35
AC Horsens,590,6,6,13,11,36,56,-20,31
Sonderjyske,590,7,8,6,10,28,29,-1,30
Randers FC,590,8,6,6,12,24,39,-15,24
AGF Aarhus,590,9,5,6,11,19,36,-17,21
Lyngby,590,10,3,9,12,26,45,-19,18
Silkeborg IF,590,11,5,3,14,25,47,-22,18
FC Midtjylla,591,1,21,5,4,73,42,31,68
Brondby,591,2,18,7,5,69,40,29,61
FC Nords,591,3,16,6,8,78,50,28,54
Copenhagen,591,4,13,5,12,57,50,7,44
AC Horsens,591,5,7,13,10,36,52,-16,34
AaB,591,6,7,12,11,39,44,-5,33
Sonderjyske,591,7,8,6,10,28,29,-1,30
Randers FC,591,8,6,6,12,24,39,-15,24
Silkeborg IF,591,9,6,3,13,26,44,-18,21
Lyngby,591,10,3,9,12,26,45,-19,18
AGF Aarhus,591,11,4,6,12,16,37,-21,18
Brondby,592,1,21,6,3,72,31,41,69
FC Midtjylla,592,2,20,4,6,64,36,28,64
Copenhagen,592,3,14,6,10,57,45,12,48
FC Nords,592,4,12,7,11,68,54,14,43
AaB,592,5,9,12,9,38,40,-2,39
AC Horsens,592,6,6,13,11,33,52,-19,31
Sonderjyske,592,7,8,6,10,28,29,-1,30
Randers FC,592,8,6,6,12,25,39,-14,24
Silkeborg IF,592,9,5,4,13,26,45,-19,19
AGF Aarhus,592,10,4,7,11,17,37,-20,19
Lyngby,592,11,3,9,12,26,46,-20,18
FC Midtjylla,593,1,22,4,4,70,37,33,70
Brondby,593,2,21,6,3,72,32,40,69
FC Nords,593,3,14,7,9,72,52,20,49
Copenhagen,593,4,12,7,11,55,45,10,43
AaB,593,5,7,13,10,35,42,-7,34
Sonderjyske,593,6,8,6,10,28,29,-1,30
AC Horsens,593,7,5,13,12,32,54,-22,28
Randers FC,593,8,5,7,12,23,39,-16,22
Silkeborg IF,593,9,6,3,13,27,45,-18,21
Lyngby,593,10,3,10,11,26,44,-18,19
AGF Aarhus,593,11,4,6,12,17,38,-21,18
Brondby,594,1,21,5,4,74,37,37,68
FC Midtjylla,594,2,21,4,5,70,40,30,67
FC Nords,594,3,14,7,9,71,53,18,49
Copenhagen,594,4,13,5,12,56,49,7,44
AaB,594,5,9,11,10,43,41,2,38
Sonderjyske,594,6,8,6,10,28,29,-1,30
AC Horsens,594,7,5,14,11,33,53,-20,29
Randers FC,594,8,5,7,12,26,42,-16,22
AGF Aarhus,594,9,5,6,11,18,36,-18,21
Lyngby,594,10,3,10,11,29,47,-18,19
Silkeborg IF,594,11,5,3,14,25,46,-21,18
Brondby,595,1,21,6,3,71,33,38,69
FC Midtjylla,595,2,20,4,6,70,39,31,64
Copenhagen,595,3,14,6,10,54,40,14,48
FC Nords,595,4,13,7,10,71,56,15,46
AaB,595,5,8,12,10,39,42,-3,36
AC Horsens,595,6,6,13,11,35,56,-21,31
Sonderjyske,595,7,8,6,10,28,29,-1,30
Randers FC,595,8,6,6,12,26,40,-14,24
AGF Aarhus,595,9,5,6,11,17,36,-19,21
Lyngby,595,10,3,9,12,27,47,-20,18
Silkeborg IF,595,11,5,3,14,25,45,-20,18
FC Midtjylla,596,1,21,4,5,69,40,29,67
Brondby,596,2,20,6,4,70,33,37,66
FC Nords,596,3,14,8,8,78,53,25,50
Copenhagen,596,4,14,5,11,61,47,14,47
AaB,596,5,7,12,11,35,42,-7,33
AC Horsens,596,6,6,13,11,33,57,-24,31
Sonderjyske,596,7,8,6,10,28,29,-1,30
Lyngby,596,8,4,9,11,29,44,-15,21
Silkeborg IF,596,9,6,3,13,26,44,-18,21
Randers FC,596,10,5,6,13,23,42,-19,21
AGF Aarhus,596,11,4,6,12,16,37,-21,18
Brondby,597,1,22,5,3,73,30,43,71
FC Midtjylla,597,2,19,5,6,67,41,26,62
Copenhagen,597,3,15,5,10,57,41,16,50
FC Nords,597,4,13,6,11,72,59,13,45
AaB,597,5,9,12,9,38,41,-3,39
Sonderjyske,597,6,8,6,10,28,29,-1,30
AC Horsens,597,7,5,13,12,34,55,-21,28
Lyngby,597,8,4,9,11,27,44,-17,21
Randers FC,597,9,5,6,13,23,40,-17,21
Silkeborg IF,597,10,6,3,13,26,44,-18,21
AGF Aarhus,597,11,4,6,12,16,37,-21,18
Brondby,598,1,19,8,3,69,34,35,65
FC Midtjylla,598,2,18,6,6,62,40,22,60
FC Nords,598,3,14,8,8,73,52,21,50
Copenhagen,598,4,13,5,12,54,43,11,44
AaB,598,5,8,13,9,38,39,-1,37
AC Horsens,598,6,7,14,9,39,53,-14,35
Sonderjyske,598,7,8,6,10,28,29,-1,30
Lyngby,598,8,4,9,11,28,45,-17,21
Randers FC,598,9,5,6,13,24,41,-17,21
AGF Aarhus,598,10,5,6,11,19,37,-18,21
Silkeborg IF,598,11,5,3,14,26,47,-21,18
Brondby,599,1,21,5,4,72,33,39,68
FC Midtjylla,599,2,20,5,5,68,43,25,65
FC Nords,599,3,15,6,9,72,51,21,51
Copenhagen,599,4,15,4,11,60,41,19,49
AC Horsens,599,5,7,12,11,35,53,-18,33
Sonderjyske,599,6,8,6,10,28,29,-1,30
AaB,599,7,6,12,12,35,47,-12,30
Randers FC,599,8,5,7,12,24,40,-16,22
Lyngby,599,9,3,10,11,27,45,-18,19
Silkeborg IF,599,10,5,4,13,27,46,-19,19
AGF Aarhus,599,11,4,7,11,18,38,-20,19
FC Midtjylla,600,1,21,4,5,71,36,35,67
Brondby,600,2,19,5,6,67,42,25,62
FC Nords,600,3,15,7,8,78,48,30,52
Copenhagen,600,4,14,5,11,56,48,8,47
AC Horsens,600,5,8,13,9,34,48,-14,37
Sonderjyske,600,6,8,6,10,28,29,-1,30
AaB,600,7,6,12,12,34,44,-10,30
Randers FC,600,8,5,7,12,25,41,-16,22
AGF Aarhus,600,9,5,6,11,18,37,-19,21
Lyngby,600,10,3,10,11,28,46,-18,19
Silkeborg IF,600,11,5,3,14,26,46,-20,18
Brondby,601,1,21,6,3,68,29,39,69
FC Midtjylla,601,2,21,4,5,71,36,35,67
FC Nords,601,3,14,7,9,72,54,18,49
Copenhagen,601,4,15,4,11,59,46,13,49
AC Horsens,601,5,6,13,11,32,52,-20,31
Sonderjyske,601,6,8,6,10,28,29,-1,30
AaB,601,7,6,12,12,33,44,-11,30
Randers FC,601,8,6,6,12,24,39,-15,24
AGF Aarhus,601,9,5,6,11,18,36,-18,21
Lyngby,601,10,3,9,12,26,45,-19,18
Silkeborg IF,601,11,5,3,14,25,46,-21,18
Brondby,602,1,19,6,5,67,41,26,63
FC Midtjylla,602,2,19,6,5,66,41,25,63
Copenhagen,602,3,15,5,10,63,43,20,50
FC Nords,602,4,14,6,10,77,57,20,48
AC Horsens,602,5,7,14,9,38,49,-11,35
AaB,602,6,7,13,10,39,45,-6,34
Sonderjyske,602,7,8,6,10,28,29,-1,30
Randers FC,602,8,6,6,12,24,39,-15,24
AGF Aarhus,602,9,5,6,11,17,36,-19,21
Lyngby,602,10,3,9,12,26,45,-19,18
Silkeborg IF,602,11,5,3,14,25,45,-20,18
Brondby,603,1,19,8,3,71,36,35,65
FC Midtjylla,603,2,19,5,6,67,40,27,62
FC Nords,603,3,15,7,8,81,55,26,52
Copenhagen,603,4,14,5,11,57,44,13,47
AaB,603,5,7,13,10,35,44,-9,34
AC Horsens,603,6,6,14,10,36,54,-18,32
Sonderjyske,603,7,8,6,10,28,29,-1,30
Randers FC,603,8,5,7,12,24,40,-16,22
Lyngby,603,9,3,10,11,27,45,-18,19
Silkeborg IF,603,10,5,4,13,26,45,-19,19
AGF Aarhus,603,11,4,7,11,17,37,-20,19
Brondby,604,1,22,5,3,70,30,40,71
FC Midtjylla,604,2,19,5,6,64,39,25,62
FC Nords,604,3,16,6,8,73,49,24,54
Copenhagen,604,4,12,5,13,53,46,7,41
AC Horsens,604,5,7,13,10,34,47,-13,34
AaB,604,6,7,12,11,33,42,-9,33
Sonderjyske,604,7,8,6,10,28,29,-1,30
Randers FC,604,8,5,7,12,23,39,-16,22
Silkeborg IF,604,9,6,3,13,26,44,-18,21
Lyngby,604,10,3,10,11,26,44,-18,19
AGF Aarhus,604,11,4,6,12,16,37,-21,18
Brondby,605,1,21,6,3,69,32,37,69
FC Midtjylla,605,2,18,6,6,62,38,24,60
Copenhagen,605,3,14,6,10,55,42,13,48
FC Nords,605,4,12,9,9,69,51,18,45
AC Horsens,605,5,7,14,9,35,48,-13,35
AaB,605,6,7,13,10,39,44,-5,34
Sonderjyske,605,7,8,6,10,28,29,-1,30
Randers FC,605,8,6,6,12,25,40,-15,24
Silkeborg IF,605,9,5,4,13,25,44,-19,19
AGF Aarhus,605,10,4,7,11,16,36,-20,19
Lyngby,605,11,3,9,12,27,46,-19,18
FC Midtjylla,606,1,20,4,6,64,39,25,64
Brondby,606,2,19,6,5,65,33,32,63
Copenhagen,606,3,16,5,9,60,40,20,53
FC Nords,606,4,14,7,9,72,50,22,49
AaB,606,5,8,12,10,36,41,-5,36
Sonderjyske,606,6,8,6,10,28,29,-1,30
AC Horsens,606,7,5,14,11,31,51,-20,29
Randers FC,606,8,6,6,12,24,39,-15,24
Silkeborg IF,606,9,6,3,13,28,45,-17,21
Lyngby,606,10,3,9,12,26,45,-19,18
AGF Aarhus,606,11,4,6,12,17,39,-22,18
Brondby,607,1,21,5,4,70,34,36,68
FC Midtjylla,607,2,21,4,5,71,36,35,67
FC Nords,607,3,15,6,9,76,52,24,51
Copenhagen,607,4,13,4,13,56,51,5,43
AC Horsens,607,5,8,12,10,39,54,-15,36
AaB,607,6,7,11,12,33,44,-11,32
Sonderjyske,607,7,8,6,10,28,29,-1,30
Lyngby,607,8,4,9,11,28,45,-17,21
Randers FC,607,9,5,6,13,24,41,-17,21
AGF Aarhus,607,10,5,6,11,17,36,-19,21
Silkeborg IF,607,11,5,3,14,25,45,-20,18
FC Midtjylla,608,1,20,5,5,68,41,27,65
Brondby,608,2,19,7,4,71,33,38,64
FC Nords,608,3,13,8,9,73,53,20,47
Copenhagen,608,4,14,4,12,58,46,12,46
AaB,608,5,10,11,9,40,43,-3,41
AC Horsens,608,6,6,13,11,36,56,-20,31
Sonderjyske,608,7,8,6,10,28,29,-1,30
Randers FC,608,8,5,7,12,25,41,-16,22
AGF Aarhus,608,9,5,6,11,19,36,-17,21
Lyngby,608,10,3,10,11,28,46,-18,19
Silkeborg IF,608,11,5,3,14,25,47,-22,18
Brondby,609,1,20,7,3,70,34,36,67
FC Midtjylla,609,2,18,6,6,70,44,26,60
FC Nords,609,3,14,7,9,75,53,22,49
Copenhagen,609,4,14,6,10,60,45,15,48
AaB,609,5,7,14,9,37,41,-4,35
AC Horsens,609,6,7,12,11,34,55,-21,33
Sonderjyske,609,7,8,6,10,28,29,-1,30
Lyngby,609,8,4,9,11,28,44,-16,21
Randers FC,609,9,5,6,13,23,41,-18,21
Silkeborg IF,609,10,5,4,13,25,44,-19,19
AGF Aarhus,609,11,4,7,11,16,36,-20,19
Brondby,610,1,21,7,2,77,32,45,70
FC Midtjylla,610,2,19,5,6,68,47,21,62
Copenhagen,610,3,15,5,10,59,43,16,50
FC Nords,610,4,14,7,9,82,58,24,49
AaB,610,5,7,11,12,38,46,-8,32
AC Horsens,610,6,6,13,11,37,61,-24,31
Sonderjyske,610,7,8,6,10,28,29,-1,30
Lyngby,610,8,4,9,11,28,44,-16,21
Randers FC,610,9,5,6,13,23,41,-18,21
AGF Aarhus,610,10,5,6,11,19,37,-18,21
Silkeborg IF,610,11,5,3,14,26,47,-21,18
Brondby,611,1,22,5,3,69,31,38,71
FC Midtjylla,611,2,22,4,4,67,35,32,70
FC Nords,611,3,14,6,10,70,52,18,48
Copenhagen,611,4,13,5,12,59,49,10,44
AaB,611,5,7,12,11,35,42,-7,33
Sonderjyske,611,6,8,6,10,28,29,-1,30
AC Horsens,611,7,6,12,12,35,52,-17,30
Lyngby,611,8,4,9,11,28,45,-17,21
Randers FC,611,9,5,6,13,24,41,-17,21
AGF Aarhus,611,10,5,6,11,19,38,-19,21
Silkeborg IF,611,11,5,3,14,27,47,-20,18
FC Midtjylla,612,1,20,5,5,70,40,30,65
Brondby,612,2,18,7,5,72,42,30,61
FC Nords,612,3,16,7,7,77,47,30,55
Copenhagen,612,4,13,5,12,58,46,12,44
AaB,612,5,8,13,9,36,43,-7,37
AC Horsens,612,6,6,13,11,36,57,-21,31
Sonderjyske,612,7,8,6,10,28,29,-1,30
Lyngby,612,8,4,9,11,27,44,-17,21
Randers FC,612,9,5,6,13,23,40,-17,21
Silkeborg IF,612,10,5,4,13,25,44,-19,19
AGF Aarhus,612,11,4,7,11,16,36,-20,19
Brondby,613,1,20,7,3,69,32,37,67
FC Midtjylla,613,2,19,4,7,62,41,21,61
Copenhagen,613,3,15,6,9,59,41,18,51
FC Nords,613,4,14,7,9,74,52,22,49
AC Horsens,613,5,7,13,10,37,53,-16,34
AaB,613,6,6,13,11,34,42,-8,31
Sonderjyske,613,7,8,6,10,28,29,-1,30
Lyngby,613,8,4,9,11,28,44,-16,21
Randers FC,613,9,5,6,13,23,41,-18,21
Silkeborg IF,613,10,5,4,13,25,44,-19,19
AGF Aarhus,613,11,4,7,11,16,36,-20,19
Brondby,614,1,21,5,4,74,32,42,68
FC Midtjylla,614,2,20,5,5,65,37,28,65
FC Nords,614,3,15,6,9,73,55,18,51
Copenhagen,614,4,13,5,12,54,44,10,44
AaB,614,5,8,12,10,40,42,-2,36
AC Horsens,614,6,6,13,11,33,55,-22,31
Sonderjyske,614,7,8,6,10,28,29,-1,30
Randers FC,614,8,5,7,12,26,42,-16,22
Lyngby,614,9,3,10,11,29,47,-18,19
Silkeborg IF,614,10,5,4,13,25,44,-19,19
AGF Aarhus,614,11,4,7,11,16,36,-20,19
Brondby,615,1,20,8,2,72,29,43,68
FC Midtjylla,615,2,20,5,5,67,38,29,65
Copenhagen,615,3,15,5,10,61,45,16,50
FC Nords,615,4,12,6,12,69,59,10,42
AaB,615,5,8,11,11,38,46,-8,35
AC Horsens,615,6,7,13,10,33,49,-16,34
Sonderjyske,615,7,8,6,10,28,29,-1,30
Lyngby,615,8,4,9,11,29,45,-16,21
Randers FC,615,9,5,6,13,24,42,-18,21
Silkeborg IF,615,10,5,4,13,25,44,-19,19
AGF Aarhus,615,11,4,7,11,16,36,-20,19
Brondby,616,1,21,6,3,70,30,40,69
FC Midtjylla,616,2,19,5,6,64,39,25,62
FC Nords,616,3,15,6,9,73,52,21,51
Copenhagen,616,4,15,5,10,59,43,16,50
AaB,616,5,8,11,11,39,47,-8,35
Sonderjyske,616,6,8,6,10,28,29,-1,30
AC Horsens,616,7,5,13,12,33,53,-20,28
Silkeborg IF,616,8,6,3,13,29,44,-15,21
Lyngby,616,9,4,9,11,28,44,-16,21
Randers FC,616,10,5,6,13,23,41,-18,21
AGF Aarhus,616,11,4,6,12,16,40,-24,18
Brondby,617,1,21,7,2,68,30,38,70
FC Midtjylla,617,2,20,4,6,67,39,28,64
FC Nords,617,3,14,6,10,72,51,21,48
Copenhagen,617,4,14,5,11,55,44,11,47
AaB,617,5,7,13,10,40,47,-7,34
Sonderjyske,617,6,8,6,10,28,29,-1,30
AC Horsens,617,7,5,15,10,33,50,-17,30
Randers FC,617,8,5,7,12,24,40,-16,22
Silkeborg IF,617,9,6,3,13,27,44,-17,21
Lyngby,617,10,3,10,11,27,45,-18,19
AGF Aarhus,617,11,4,6,12,16,38,-22,18
Brondby,618,1,19,7,4,67,34,33,64
FC Midtjylla,618,2,20,4,6,62,41,21,64
Copenhagen,618,3,16,5,9,66,43,23,53
FC Nords,618,4,13,7,10,72,53,19,46
AaB,618,5,8,14,8,41,40,1,38
Sonderjyske,618,6,8,6,10,28,29,-1,30
AC Horsens,618,7,5,13,12,33,56,-23,28
Lyngby,618,8,4,9,11,27,44,-17,21
Silkeborg IF,618,8,6,3,13,27,44,-17,21
Randers FC,618,10,5,6,13,23,40,-17,21
AGF Aarhus,618,11,4,6,12,16,38,-22,18
Brondby,619,1,21,6,3,75,34,41,69
FC Midtjylla,619,2,19,6,5,69,40,29,63
FC Nords,619,3,14,8,8,75,52,23,50
Copenhagen,619,4,15,5,10,58,39,19,50
AaB,619,5,7,12,11,37,50,-13,33
Sonderjyske,619,6,8,6,10,28,29,-1,30
AC Horsens,619,7,5,13,12,33,58,-25,28
Randers FC,619,8,6,6,12,24,39,-15,24
Silkeborg IF,619,9,6,3,13,28,45,-17,21
Lyngby,619,10,3,9,12,26,45,-19,18
AGF Aarhus,619,11,4,6,12,17,39,-22,18
Brondby,620,1,20,6,4,71,32,39,66
FC Midtjylla,620,2,20,6,4,65,35,30,66
FC Nords,620,3,14,8,8,74,54,20,50
Copenhagen,620,4,14,4,12,59,52,7,46
AaB,620,5,6,14,10,41,47,-6,32
AC Horsens,620,6,6,14,10,35,51,-16,32
Sonderjyske,620,7,8,6,10,28,29,-1,30
Randers FC,620,8,5,7,12,26,42,-16,22
AGF Aarhus,620,9,5,6,11,21,36,-15,21
Lyngby,620,10,3,10,11,29,47,-18,19
Silkeborg IF,620,11,5,3,14,25,49,-24,18
Brondby,621,1,23,5,2,73,28,45,74
FC Midtjylla,621,2,19,6,5,64,37,27,63
FC Nords,621,3,13,8,9,69,51,18,47
Copenhagen,621,4,13,7,10,58,46,12,46
AaB,621,5,6,13,11,34,42,-8,31
AC Horsens,621,6,6,13,11,35,55,-20,31
Sonderjyske,621,7,8,6,10,28,29,-1,30
Randers FC,621,8,6,6,12,25,40,-15,24
AGF Aarhus,621,9,5,6,11,19,37,-18,21
Lyngby,621,10,3,9,12,27,46,-19,18
Silkeborg IF,621,11,5,3,14,26,47,-21,18
FC Midtjylla,622,1,20,4,6,69,41,28,64
Brondby,622,2,19,6,5,67,35,32,63
FC Nords,622,3,16,6,8,80,51,29,54
Copenhagen,622,4,16,4,10,62,43,19,52
AaB,622,5,7,11,12,34,46,-12,32
AC Horsens,622,6,6,13,11,34,56,-22,31
Sonderjyske,622,7,8,6,10,28,29,-1,30
Randers FC,622,8,5,7,12,24,40,-16,22
Silkeborg IF,622,9,6,3,13,27,44,-17,21
Lyngby,622,10,3,10,11,27,45,-18,19
AGF Aarhus,622,11,4,6,12,16,38,-22,18
Brondby,623,1,19,7,4,66,32,34,64
FC Midtjylla,623,2,18,6,6,62,38,24,60
FC Nords,623,3,14,8,8,73,51,22,50
Copenhagen,623,4,13,6,11,56,44,12,45
AaB,623,5,8,14,8,40,40,0,38
AC Horsens,623,6,6,15,9,33,51,-18,33
Sonderjyske,623,7,8,6,10,28,29,-1,30
Randers FC,623,8,6,6,12,25,39,-14,24
Silkeborg IF,623,9,6,3,13,27,45,-18,21
Lyngby,623,10,3,9,12,26,46,-20,18
AGF Aarhus,623,11,4,6,12,17,38,-21,18
Brondby,624,1,20,7,3,69,32,37,67
FC Midtjylla,624,2,18,5,7,61,47,14,59
FC Nords,624,3,14,9,7,78,50,28,51
Copenhagen,624,4,14,6,10,61,44,17,48
AC Horsens,624,5,7,14,9,40,52,-12,35
AaB,624,6,6,13,11,35,45,-10,31
Sonderjyske,624,7,8,6,10,28,29,-1,30
Randers FC,624,8,6,6,12,24,39,-15,24
AGF Aarhus,624,9,5,6,11,17,36,-19,21
Lyngby,624,10,3,9,12,26,45,-19,18
Silkeborg IF,624,11,5,3,14,25,45,-20,18
Brondby,625,1,21,7,2,73,30,43,70
FC Midtjylla,625,2,19,6,5,66,35,31,63
FC Nords,625,3,14,8,8,73,53,20,50
Copenhagen,625,4,14,4,12,56,48,8,46
AaB,625,5,6,14,10,34,44,-10,32
AC Horsens,625,6,6,13,11,33,51,-18,31
Sonderjyske,625,7,8,6,10,28,29,-1,30
Lyngby,625,8,4,9,11,29,45,-16,21
Randers FC,625,9,5,6,13,24,42,-18,21
Silkeborg IF,625,10,5,4,13,27,46,-19,19
AGF Aarhus,625,11,4,7,11,18,38,-20,19
Brondby,626,1,21,6,3,72,35,37,69
FC Midtjylla,626,2,19,6,5,66,40,26,63
FC Nords,626,3,14,8,8,73,50,23,50
Copenhagen,626,4,14,6,10,60,43,17,48
AaB,626,5,6,14,10,34,42,-8,32
Sonderjyske,626,6,8,6,10,28,29,-1,30
AC Horsens,626,7,5,14,11,32,53,-21,29
Lyngby,626,8,4,9,11,28,45,-17,21
Randers FC,626,9,5,6,13,24,41,-17,21
Silkeborg IF,626,10,5,4,13,27,46,-19,19
AGF Aarhus,626,11,4,7,11,18,38,-20,19
Brondby,627,1,21,6,3,68,30,38,69
FC Midtjylla,627,2,17,6,7,66,46,20,57
FC Nords,627,3,14,8,8,71,50,21,50
Copenhagen,627,4,13,5,12,55,45,10,44
AaB,627,5,9,11,10,41,42,-1,38
AC Horsens,627,6,8,12,10,39,53,-14,36
Sonderjyske,627,7,8,6,10,28,29,-1,30
Randers FC,627,8,5,7,12,25,41,-16,22
Silkeborg IF,627,9,6,3,13,28,45,-17,21
Lyngby,627,10,3,10,11,28,46,-18,19
AGF Aarhus,627,11,4,6,12,17,39,-22,18
FC Midtjylla,628,1,20,5,5,66,39,27,65
Brondby,628,2,19,7,4,67,35,32,64
Copenhagen,628,3,15,6,9,61,41,20,51
FC Nords,628,4,12,8,10,68,51,17,44
AaB,628,5,7,14,9,41,47,-6,35
AC Horsens,628,6,6,14,10,41,57,-16,32
Sonderjyske,628,7,8,6,10,28,29,-1,30
Lyngby,628,8,4,9,11,30,44,-14,21
Silkeborg IF,628,9,6,3,13,28,45,-17,21
Randers FC,628,10,5,6,13,23,43,-20,21
AGF Aarhus,628,11,4,6,12,17,39,-22,18
Brondby,629,1,21,6,3,70,31,39,69
FC Midtjylla,629,2,21,4,5,66,40,26,67
FC Nords,629,3,13,7,10,70,52,18,46
Copenhagen,629,4,12,7,11,54,43,11,43
AaB,629,5,8,12,10,39,43,-4,36
AC Horsens,629,6,7,12,11,35,51,-16,33
Sonderjyske,629,7,8,6,10,28,29,-1,30
Randers FC,629,8,5,7,12,25,41,-16,22
Lyngby,629,9,3,10,11,28,46,-18,19
Silkeborg IF,629,10,5,4,13,27,46,-19,19
AGF Aarhus,629,11,4,7,11,18,38,-20,19
Brondby,630,1,19,7,4,67,33,34,64
FC Midtjylla,630,2,19,4,7,67,45,22,61
FC Nords,630,3,14,7,9,75,54,21,49
Copenhagen,630,4,13,5,12,56,46,10,44
AC Horsens,630,5,9,12,9,40,50,-10,39
AaB,630,6,9,11,10,38,41,-3,38
Sonderjyske,630,7,8,6,10,28,29,-1,30
Lyngby,630,8,4,9,11,29,46,-17,21
Randers FC,630,9,5,6,13,25,42,-17,21
AGF Aarhus,630,10,5,6,11,19,37,-18,21
Silkeborg IF,630,11,5,3,14,26,47,-21,18
Brondby,631,1,21,5,4,68,32,36,68
FC Midtjylla,631,2,18,5,7,62,39,23,59
FC Nords,631,3,16,7,7,76,49,27,55
Copenhagen,631,4,14,5,11,60,46,14,47
AaB,631,5,7,12,11,35,45,-10,33
AC Horsens,631,6,7,12,11,34,50,-16,33
Sonderjyske,631,7,8,6,10,28,29,-1,30
Randers FC,631,8,5,7,12,24,40,-16,22
Lyngby,631,9,3,10,11,27,45,-18,19
Silkeborg IF,631,10,5,4,13,26,45,-19,19
AGF Aarhus,631,11,4,7,11,17,37,-20,19
Brondby,632,1,20,6,4,65,31,34,66
FC Midtjylla,632,2,19,4,7,63,37,26,61
Copenhagen,632,3,16,4,10,61,45,16,52
FC Nords,632,4,13,7,10,72,53,19,46
AC Horsens,632,5,8,13,9,38,51,-13,37
AaB,632,6,7,12,11,36,44,-8,33
Sonderjyske,632,7,8,6,10,28,29,-1,30
Lyngby,632,8,4,9,11,29,46,-17,21
Randers FC,632,9,5,6,13,25,42,-17,21
Silkeborg IF,632,10,6,3,13,26,44,-18,21
AGF Aarhus,632,11,4,6,12,16,37,-21,18
Brondby,633,1,21,7,2,74,35,39,70
FC Midtjylla,633,2,19,6,5,65,41,24,63
FC Nords,633,3,15,8,7,79,50,29,53
Copenhagen,633,4,12,5,13,51,47,4,41
AaB,633,5,7,13,10,37,40,-3,34
AC Horsens,633,6,6,13,11,35,54,-19,31
Sonderjyske,633,7,8,6,10,28,29,-1,30
Lyngby,633,8,4,9,11,27,44,-17,21
Randers FC,633,9,5,6,13,23,40,-17,21
AGF Aarhus,633,10,5,6,11,17,36,-19,21
Silkeborg IF,633,11,5,3,14,25,45,-20,18
Brondby,634,1,19,9,2,67,28,39,66
FC Midtjylla,634,2,17,7,6,59,41,18,58
FC Nords,634,3,14,8,8,71,49,22,50
Copenhagen,634,4,13,6,11,53,41,12,45
AaB,634,5,9,12,9,38,39,-1,39
AC Horsens,634,6,6,14,10,31,47,-16,32
Sonderjyske,634,7,8,6,10,28,29,-1,30
Lyngby,634,8,4,9,11,27,44,-17,21
Randers FC,634,9,5,6,13,23,40,-17,21
AGF Aarhus,634,10,5,6,11,17,36,-19,21
Silkeborg IF,634,11,5,3,14,25,45,-20,18
FC Midtjylla,635,1,20,4,6,67,40,27,64
Brondby,635,2,19,5,6,65,37,28,62
Copenhagen,635,3,16,4,10,57,40,17,52
FC Nords,635,4,13,7,10,71,51,20,46
AC Horsens,635,5,8,13,9,37,48,-11,37
AaB,635,6,8,11,11,37,44,-7,35
Sonderjyske,635,7,8,6,10,28,29,-1,30
Randers FC,635,8,6,6,12,26,39,-13,24
AGF Aarhus,635,9,5,6,11,17,36,-19,21
Silkeborg IF,635,10,5,3,14,25,45,-20,18
Lyngby,635,11,3,9,12,26,47,-21,18
Brondby,636,1,20,5,5,72,38,34,65
FC Midtjylla,636,2,19,4,7,60,38,22,61
FC Nords,636,3,16,7,7,77,47,30,55
Copenhagen,636,4,14,4,12,58,43,15,46
AaB,636,5,9,12,9,38,44,-6,39
Sonderjyske,636,6,8,6,10,28,29,-1,30
AC Horsens,636,7,6,12,12,31,52,-21,30
Randers FC,636,8,6,6,12,26,41,-15,24
Silkeborg IF,636,9,5,4,13,26,45,-19,19
AGF Aarhus,636,10,4,7,11,17,37,-20,19
Lyngby,636,11,3,9,12,28,47,-19,18
Brondby,637,1,21,7,2,70,32,38,70
FC Midtjylla,637,2,20,4,6,68,39,29,64
Copenhagen,637,3,14,6,10,62,48,14,48
FC Nords,637,4,13,8,9,73,54,19,47
AaB,637,5,7,13,10,40,47,-7,34
Sonderjyske,637,6,8,6,10,28,29,-1,30
AC Horsens,637,7,6,12,12,35,54,-19,30
Randers FC,637,8,6,6,12,24,39,-15,24
AGF Aarhus,637,9,5,6,11,17,36,-19,21
Lyngby,637,10,3,9,12,26,45,-19,18
Silkeborg IF,637,11,5,3,14,25,45,-20,18
Brondby,638,1,21,6,3,69,33,36,69
FC Midtjylla,638,2,18,6,6,63,37,26,60
FC Nords,638,3,17,6,7,79,46,33,57
Copenhagen,638,4,13,6,11,53,42,11,45
AaB,638,5,6,13,11,33,43,-10,31
Sonderjyske,638,6,8,6,10,28,29,-1,30
AC Horsens,638,7,5,15,10,31,53,-22,30
Randers FC,638,8,5,7,12,23,39,-16,22
Lyngby,638,9,3,10,11,26,44,-18,19
Silkeborg IF,638,10,5,4,13,28,47,-19,19
AGF Aarhus,638,11,4,7,11,19,39,-20,19
FC Midtjylla,639,1,22,4,4,71,38,33,70
Brondby,639,2,20,7,3,73,34,39,67
FC Nords,639,3,14,7,9,74,52,22,49
Copenhagen,639,4,12,8,10,60,48,12,44
AC Horsens,639,5,6,14,10,36,54,-18,32
Sonderjyske,639,6,8,6,10,28,29,-1,30
AaB,639,7,6,12,12,35,49,-14,30
Lyngby,639,8,4,9,11,29,45,-16,21
Randers FC,639,9,5,6,13,24,42,-18,21
AGF Aarhus,639,10,5,6,11,17,36,-19,21
Silkeborg IF,639,11,5,3,14,25,45,-20,18
Brondby,640,1,23,5,2,72,30,42,74
FC Midtjylla,640,2,19,4,7,67,41,26,61
FC Nords,640,3,15,6,9,74,53,21,51
Copenhagen,640,4,14,4,12,59,50,9,46
AC Horsens,640,5,7,12,11,34,52,-18,33
AaB,640,6,7,11,12,38,44,-6,32
Sonderjyske,640,7,8,6,10,28,29,-1,30
Randers FC,640,8,5,7,12,23,39,-16,22
Silkeborg IF,640,9,6,3,13,27,45,-18,21
Lyngby,640,10,3,10,11,26,44,-18,19
AGF Aarhus,640,11,4,6,12,17,38,-21,18
Brondby,641,1,22,5,3,77,33,44,71
FC Midtjylla,641,2,18,5,7,64,38,26,59
FC Nords,641,3,13,7,10,71,55,16,46
Copenhagen,641,4,13,5,12,53,46,7,44
AC Horsens,641,5,9,13,8,39,49,-10,40
AaB,641,6,8,11,11,38,47,-9,35
Sonderjyske,641,7,8,6,10,28,29,-1,30
Randers FC,641,8,5,7,12,24,40,-16,22
AGF Aarhus,641,9,5,6,11,18,36,-18,21
Lyngby,641,10,3,10,11,27,45,-18,19
Silkeborg IF,641,11,5,3,14,25,46,-21,18
Brondby,642,1,21,6,3,69,30,39,69
FC Midtjylla,642,2,19,6,5,64,37,27,63
FC Nords,642,3,14,7,9,69,49,20,49
Copenhagen,642,4,13,8,9,57,42,15,47
AaB,642,5,7,12,11,36,44,-8,33
AC Horsens,642,6,6,13,11,34,53,-19,31
Sonderjyske,642,7,8,6,10,28,29,-1,30
Randers FC,642,8,5,7,12,24,40,-16,22
Lyngby,642,9,3,10,11,27,45,-18,19
Silkeborg IF,642,10,5,4,13,27,46,-19,19
AGF Aarhus,642,11,4,7,11,18,38,-20,19
Brondby,643,1,21,5,4,74,38,36,68
FC Midtjylla,643,2,18,5,7,65,44,21,59
FC Nords,643,3,15,7,8,79,51,28,52
Copenhagen,643,4,16,4,10,60,42,18,52
AaB,643,5,8,12,10,39,42,-3,36
Sonderjyske,643,6,8,6,10,28,29,-1,30
AC Horsens,643,7,5,13,12,33,59,-26,28
Lyngby,643,8,4,9,11,28,45,-17,21
Randers FC,643,9,5,6,13,24,41,-17,21
AGF Aarhus,643,10,5,6,11,18,36,-18,21
Silkeborg IF,643,11,5,3,14,25,46,-21,18
Brondby,644,1,22,5,3,74,34,40,71
FC Midtjylla,644,2,21,4,5,66,38,28,67
FC Nords,644,3,14,6,10,73,54,19,48
Copenhagen,644,4,14,5,11,60,46,14,47
AaB,644,5,7,11,12,39,50,-11,32
AC Horsens,644,6,6,13,11,38,54,-16,31
Sonderjyske,644,7,8,6,10,28,29,-1,30
Randers FC,644,8,6,6,12,24,39,-15,24
Silkeborg IF,644,9,6,3,13,28,44,-16,21
Lyngby,644,10,3,9,12,26,45,-19,18
AGF Aarhus,644,11,4,6,12,16,39,-23,18
Brondby,645,1,21,7,2,68,29,39,70
FC Midtjylla,645,2,18,8,4,59,34,25,62
FC Nords,645,3,15,6,9,81,51,30,51
Copenhagen,645,4,12,7,11,56,50,6,43
AC Horsens,645,5,7,13,10,38,53,-15,34
AaB,645,6,6,13,11,38,49,-11,31
Sonderjyske,645,7,8,6,10,28,29,-1,30
Lyngby,645,8,4,9,11,28,45,-17,21
Randers FC,645,9,5,6,13,24,41,-17,21
Silkeborg IF,645,10,6,3,13,27,45,-18,21
AGF Aarhus,645,11,4,6,12,17,38,-21,18
Brondby,646,1,22,5,3,73,31,42,71
FC Midtjylla,646,2,19,4,7,62,41,21,61
Copenhagen,646,3,17,4,9,63,42,21,55
FC Nords,646,4,13,7,10,70,54,16,46
AaB,646,5,7,12,11,36,44,-8,33
Sonderjyske,646,6,8,6,10,28,29,-1,30
AC Horsens,646,7,6,12,12,35,53,-18,30
Randers FC,646,8,5,7,12,25,41,-16,22
Silkeborg IF,646,9,6,3,13,27,45,-18,21
Lyngby,646,10,3,10,11,28,46,-18,19
AGF Aarhus,646,11,4,6,12,17,38,-21,18
FC Midtjylla,647,1,20,5,5,68,39,29,65
Brondby,647,2,19,6,5,68,39,29,63
FC Nords,647,3,14,6,10,71,50,21,48
Copenhagen,647,4,14,5,11,61,45,16,47
AC Horsens,647,5,8,12,10,36,53,-17,36
AaB,647,6,7,14,9,38,42,-4,35
Sonderjyske,647,7,8,6,10,28,29,-1,30
Randers FC,647,8,5,7,12,24,40,-16,22
Silkeborg IF,647,9,6,3,13,27,45,-18,21
Lyngby,647,10,3,10,11,27,45,-18,19
AGF Aarhus,647,11,4,6,12,17,38,-21,18
Brondby,648,1,22,6,2,68,27,41,72
FC Midtjylla,648,2,19,5,6,62,40,22,62
FC Nords,648,3,15,7,8,75,48,27,52
Copenhagen,648,4,14,5,11,59,48,11,47
AC Horsens,648,5,6,14,10,34,49,-15,32
Sonderjyske,648,6,8,6,10,28,29,-1,30
AaB,648,7,6,11,13,36,48,-12,29
Randers FC,648,8,6,6,12,25,40,-15,24
Silkeborg IF,648,9,5,4,13,26,45,-19,19
AGF Aarhus,648,10,4,7,11,17,37,-20,19
Lyngby,648,11,3,9,12,27,46,-19,18
Brondby,649,1,20,6,4,68,34,34,66
FC Midtjylla,649,2,20,4,6,65,37,28,64
FC Nords,649,3,15,6,9,76,53,23,51
Copenhagen,649,4,13,4,13,55,46,9,43
AaB,649,5,8,13,9,41,42,-1,37
AC Horsens,649,6,7,13,10,36,55,-19,34
Sonderjyske,649,7,8,6,10,28,29,-1,30
Lyngby,649,8,4,9,11,30,45,-15,21
Silkeborg IF,649,9,6,3,13,29,44,-15,21
Randers FC,649,10,5,6,13,24,43,-19,21
AGF Aarhus,649,11,4,6,12,16,40,-24,18
Brondby,650,1,19,6,5,68,38,30,63
FC Midtjylla,650,2,17,5,8,63,44,19,56
FC Nords,650,3,15,7,8,74,48,26,52
Copenhagen,650,4,16,4,10,60,44,16,52
AC Horsens,650,5,8,13,9,37,47,-10,37
AaB,650,6,7,13,10,39,46,-7,34
Sonderjyske,650,7,8,6,10,28,29,-1,30
Randers FC,650,8,6,6,12,24,39,-15,24
Silkeborg IF,650,9,6,3,13,27,45,-18,21
Lyngby,650,10,3,9,12,26,45,-19,18
AGF Aarhus,650,11,4,6,12,17,38,-21,18
Brondby,651,1,20,7,3,72,34,38,67
FC Midtjylla,651,2,17,8,5,63,42,21,59
FC Nords,651,3,14,8,8,81,51,30,50
Copenhagen,651,4,14,6,10,61,49,12,48
AaB,651,5,8,12,10,38,44,-6,36
Sonderjyske,651,6,8,6,10,28,29,-1,30
AC Horsens,651,7,5,15,10,33,54,-21,30
Randers FC,651,8,6,6,12,27,41,-14,24
Silkeborg IF,651,9,6,3,13,28,44,-16,21
Lyngby,651,10,3,9,12,28,48,-20,18
AGF Aarhus,651,11,4,6,12,16,39,-23,18
Brondby,652,1,19,8,3,65,30,35,65
FC Midtjylla,652,2,20,5,5,63,38,25,65
Copenhagen,652,3,15,5,10,58,42,16,50
FC Nords,652,4,13,7,10,70,52,18,46
AaB,652,5,10,11,9,38,36,2,41
Sonderjyske,652,6,8,6,10,28,29,-1,30
AC Horsens,652,7,5,12,13,32,54,-22,27
Lyngby,652,8,4,9,11,30,45,-15,21
Randers FC,652,9,5,6,13,24,43,-19,21
Silkeborg IF,652,10,5,4,13,26,45,-19,19
AGF Aarhus,652,11,4,7,11,17,37,-20,19
Brondby,653,1,23,5,2,73,28,45,74
FC Midtjylla,653,2,20,4,6,66,37,29,64
FC Nords,653,3,15,6,9,74,53,21,51
Copenhagen,653,4,13,5,12,57,45,12,44
AaB,653,5,7,12,11,35,44,-9,33
Sonderjyske,653,6,8,6,10,28,29,-1,30
AC Horsens,653,7,6,12,12,32,56,-24,30
Randers FC,653,8,5,7,12,24,40,-16,22
Silkeborg IF,653,9,6,3,13,26,44,-18,21
Lyngby,653,10,3,10,11,27,45,-18,19
AGF Aarhus,653,11,4,6,12,16,37,-21,18
FC Midtjylla,654,1,21,4,5,69,43,26,67
Brondby,654,2,20,6,4,75,35,40,66
FC Nords,654,3,17,6,7,85,54,31,57
Copenhagen,654,4,13,6,11,56,44,12,45
AaB,654,5,7,12,11,37,46,-9,33
Sonderjyske,654,6,8,6,10,28,29,-1,30
AC Horsens,654,7,5,12,13,36,62,-26,27
Randers FC,654,8,5,7,12,24,40,-16,22
Silkeborg IF,654,9,6,3,13,27,44,-17,21
Lyngby,654,10,3,10,11,27,45,-18,19
AGF Aarhus,654,11,4,6,12,16,38,-22,18
Brondby,655,1,21,6,3,66,30,36,69
FC Midtjylla,655,2,19,5,6,67,40,27,62
Copenhagen,655,3,16,5,9,61,40,21,53
FC Nords,655,4,14,7,9,74,53,21,49
AaB,655,5,7,12,11,38,47,-9,33
Sonderjyske,655,6,8,6,10,28,29,-1,30
AC Horsens,655,7,5,13,12,35,57,-22,28
Lyngby,655,8,4,9,11,28,44,-16,21
Randers FC,655,9,5,6,13,23,41,-18,21
Silkeborg IF,655,10,5,4,13,25,44,-19,19
AGF Aarhus,655,11,4,7,11,16,36,-20,19
Brondby,656,1,18,7,5,65,34,31,61
FC Midtjylla,656,2,19,4,7,64,43,21,61
FC Nords,656,3,16,7,7,78,49,29,55
Copenhagen,656,4,15,4,11,63,43,20,49
AaB,656,5,8,12,10,38,45,-7,36
AC Horsens,656,6,7,12,11,37,57,-20,33
Sonderjyske,656,7,8,6,10,28,29,-1,30
Randers FC,656,8,5,7,12,24,40,-16,22
Lyngby,656,9,3,10,11,27,45,-18,19
Silkeborg IF,656,10,5,4,13,27,46,-19,19
AGF Aarhus,656,11,4,7,11,18,38,-20,19
FC Midtjylla,657,1,21,5,4,67,36,31,68
Brondby,657,2,19,7,4,68,33,35,64
Copenhagen,657,3,15,5,10,58,41,17,50
FC Nords,657,4,12,8,10,71,57,14,44
AC Horsens,657,5,7,13,10,39,54,-15,34
AaB,657,6,6,14,10,36,44,-8,32
Sonderjyske,657,7,8,6,10,28,29,-1,30
Randers FC,657,8,5,7,12,24,40,-16,22
Lyngby,657,9,3,10,11,27,45,-18,19
Silkeborg IF,657,10,5,4,13,25,44,-19,19
AGF Aarhus,657,11,4,7,11,16,36,-20,19
Brondby,658,1,22,5,3,71,30,41,71
FC Midtjylla,658,2,17,6,7,63,44,19,57
FC Nords,658,3,16,7,7,79,48,31,55
Copenhagen,658,4,13,5,12,54,44,10,44
AaB,658,5,9,11,10,37,40,-3,38
Sonderjyske,658,6,8,6,10,28,29,-1,30
AC Horsens,658,7,6,12,12,31,55,-24,30
Randers FC,658,8,5,7,12,25,41,-16,22
Silkeborg IF,658,9,6,3,13,26,44,-18,21
Lyngby,658,10,3,10,11,28,46,-18,19
AGF Aarhus,658,11,4,6,12,16,37,-21,18
Brondby,659,1,22,5,3,69,29,40,71
FC Midtjylla,659,2,20,5,5,67,39,28,65
FC Nords,659,3,14,7,9,75,53,22,49
Copenhagen,659,4,13,5,12,53,46,7,44
AaB,659,5,7,12,11,38,42,-4,33
AC Horsens,659,6,7,12,11,36,55,-19,33
Sonderjyske,659,7,8,6,10,28,29,-1,30
Lyngby,659,8,4,9,11,27,44,-17,21
Randers FC,659,9,5,6,13,23,40,-17,21
Silkeborg IF,659,10,5,4,13,26,45,-19,19
AGF Aarhus,659,11,4,7,11,17,37,-20,19
Brondby,660,1,23,5,2,74,31,43,74
FC Midtjylla,660,2,20,4,6,66,40,26,64
Copenhagen,660,3,14,5,11,56,42,14,47
FC Nords,660,4,13,7,10,72,54,18,46
AaB,660,5,9,11,10,40,41,-1,38
Sonderjyske,660,6,8,6,10,28,29,-1,30
AC Horsens,660,7,5,12,13,31,57,-26,27
Lyngby,660,8,4,9,11,28,45,-17,21
Randers FC,660,9,5,6,13,24,41,-17,21
Silkeborg IF,660,10,5,4,13,25,44,-19,19
AGF Aarhus,660,11,4,7,11,16,36,-20,19
Brondby,661,1,21,7,2,70,30,40,70
FC Midtjylla,661,2,18,6,6,64,42,22,60
FC Nords,661,3,14,7,9,70,48,22,49
Copenhagen,661,4,14,6,10,57,43,14,48
AC Horsens,661,5,8,13,9,36,49,-13,37
Sonderjyske,661,6,8,6,10,28,29,-1,30
AaB,661,7,6,11,13,36,47,-11,29
Silkeborg IF,661,8,6,3,13,28,45,-17,21
Lyngby,661,9,4,9,11,27,44,-17,21
Randers FC,661,10,5,6,13,23,40,-17,21
AGF Aarhus,661,11,4,6,12,17,39,-22,18
Brondby,662,1,22,6,2,73,30,43,72
FC Midtjylla,662,2,20,5,5,67,40,27,65
FC Nords,662,3,14,7,9,77,56,21,49
Copenhagen,662,4,14,5,11,60,47,13,47
AC Horsens,662,5,6,13,11,38,58,-20,31
Sonderjyske,662,6,8,6,10,28,29,-1,30
AaB,662,7,6,12,12,35,45,-10,30
Randers FC,662,8,6,6,12,26,41,-15,24
Silkeborg IF,662,9,6,3,13,29,46,-17,21
Lyngby,662,10,3,9,12,28,47,-19,18
AGF Aarhus,662,11,4,6,12,18,40,-22,18
Brondby,663,1,23,5,2,77,30,47,74
FC Midtjylla,663,2,19,5,6,61,39,22,62
FC Nords,663,3,13,7,10,70,52,18,46
Copenhagen,663,4,12,7,11,55,44,11,43
AaB,663,5,9,11,10,36,41,-5,38
AC Horsens,663,6,6,13,11,35,54,-19,31
Sonderjyske,663,7,8,6,10,28,29,-1,30
Randers FC,663,8,5,7,12,24,40,-16,22
Lyngby,663,9,3,10,11,27,45,-18,19
Silkeborg IF,663,10,5,4,13,26,45,-19,19
AGF Aarhus,663,11,4,7,11,17,37,-20,19
Brondby,664,1,22,6,2,73,30,43,72
FC Midtjylla,664,2,19,4,7,66,42,24,61
FC Nords,664,3,14,8,8,77,50,27,50
Copenhagen,664,4,15,4,11,56,46,10,49
AaB,664,5,6,13,11,35,46,-11,31
AC Horsens,664,6,6,13,11,33,52,-19,31
Sonderjyske,664,7,8,6,10,28,29,-1,30
Randers FC,664,8,5,7,12,24,40,-16,22
Silkeborg IF,664,9,6,3,13,26,44,-18,21
Lyngby,664,10,3,10,11,27,45,-18,19
AGF Aarhus,664,11,4,6,12,16,37,-21,18
Brondby,665,1,19,7,4,65,31,34,64
FC Midtjylla,665,2,19,5,6,63,38,25,62
FC Nords,665,3,14,8,8,74,53,21,50
Copenhagen,665,4,14,5,11,54,41,13,47
AaB,665,5,8,13,9,37,43,-6,37
AC Horsens,665,6,6,14,10,36,49,-13,32
Sonderjyske,665,7,8,6,10,28,29,-1,30
Randers FC,665,8,6,6,12,25,40,-15,24
Silkeborg IF,665,9,6,3,13,27,45,-18,21
Lyngby,665,10,3,9,12,27,46,-19,18
AGF Aarhus,665,11,4,6,12,17,38,-21,18
FC Midtjylla,666,1,20,6,4,66,36,30,66
Brondby,666,2,19,7,4,68,33,35,64
FC Nords,666,3,15,7,8,74,50,24,52
Copenhagen,666,4,12,6,12,57,51,6,42
AC Horsens,666,5,7,13,10,37,53,-16,34
AaB,666,6,6,15,9,34,39,-5,33
Sonderjyske,666,7,8,6,10,28,29,-1,30
Randers FC,666,8,5,7,12,25,41,-16,22
Silkeborg IF,666,9,6,3,13,27,45,-18,21
Lyngby,666,10,3,10,11,28,46,-18,19
AGF Aarhus,666,11,4,6,12,17,38,-21,18
Brondby,667,1,19,8,3,70,33,37,65
FC Midtjylla,667,2,19,6,5,66,41,25,63
Copenhagen,667,3,16,5,9,62,41,21,53
FC Nords,667,4,15,6,9,72,52,20,51
AC Horsens,667,5,6,13,11,34,52,-18,31
Sonderjyske,667,6,8,6,10,28,29,-1,30
AaB,667,7,6,12,12,35,46,-11,30
Lyngby,667,8,4,9,11,28,44,-16,21
Randers FC,667,9,5,6,13,23,41,-18,21
Silkeborg IF,667,10,5,4,13,27,46,-19,19
AGF Aarhus,667,11,4,7,11,18,38,-20,19
Brondby,668,1,22,6,2,73,32,41,72
FC Midtjylla,668,2,17,5,8,62,45,17,56
Copenhagen,668,3,14,5,11,59,44,15,47
FC Nords,668,4,13,6,11,73,56,17,45
AaB,668,5,9,12,9,40,43,-3,39
AC Horsens,668,6,7,14,9,41,54,-13,35
Sonderjyske,668,7,8,6,10,28,29,-1,30
Randers FC,668,8,6,6,12,24,39,-15,24
Silkeborg IF,668,9,6,3,13,28,45,-17,21
Lyngby,668,10,3,9,12,26,45,-19,18
AGF Aarhus,668,11,4,6,12,17,39,-22,18
Brondby,669,1,21,7,2,73,33,40,70
FC Midtjylla,669,2,17,7,6,66,44,22,58
FC Nords,669,3,13,8,9,75,57,18,47
Copenhagen,669,4,12,7,11,57,47,10,43
AC Horsens,669,5,8,13,9,39,51,-12,37
AaB,669,6,8,12,10,37,41,-4,36
Sonderjyske,669,7,8,6,10,28,29,-1,30
Randers FC,669,8,5,7,12,25,41,-16,22
Silkeborg IF,669,9,6,3,13,28,46,-18,21
Lyngby,669,10,3,10,11,28,46,-18,19
AGF Aarhus,669,11,4,6,12,18,39,-21,18
Brondby,670,1,21,6,3,72,34,38,69
FC Midtjylla,670,2,20,6,4,67,35,32,66
FC Nords,670,3,14,7,9,78,57,21,49
Copenhagen,670,4,13,6,11,58,49,9,45
AaB,670,5,7,12,11,39,45,-6,33
AC Horsens,670,6,6,13,11,36,56,-20,31
Sonderjyske,670,7,8,6,10,28,29,-1,30
Randers FC,670,8,6,6,12,24,39,-15,24
Silkeborg IF,670,9,6,3,13,26,44,-18,21
Lyngby,670,10,3,9,12,26,45,-19,18
AGF Aarhus,670,11,4,6,12,16,37,-21,18
Brondby,671,1,21,6,3,70,30,40,69
FC Midtjylla,671,2,19,5,6,64,43,21,62
Copenhagen,671,3,16,5,9,58,38,20,53
FC Nords,671,4,13,9,8,73,51,22,48
AaB,671,5,7,12,11,36,46,-10,33
Sonderjyske,671,6,8,6,10,28,29,-1,30
AC Horsens,671,7,5,13,12,33,52,-19,28
Randers FC,671,8,6,6,12,26,39,-13,24
Silkeborg IF,671,9,6,3,13,29,44,-15,21
Lyngby,671,10,3,9,12,26,47,-21,18
AGF Aarhus,671,11,4,6,12,16,40,-24,18
Brondby,672,1,19,7,4,71,38,33,64
FC Midtjylla,672,2,18,5,7,67,46,21,59
Copenhagen,672,3,17,4,9,66,43,23,55
FC Nords,672,4,14,7,9,77,52,25,49
AaB,672,5,7,13,10,37,42,-5,34
AC Horsens,672,6,7,12,11,39,62,-23,33
Sonderjyske,672,7,8,6,10,28,29,-1,30
Lyngby,672,8,4,9,11,27,44,-17,21
Randers FC,672,9,5,6,13,23,40,-17,21
Silkeborg IF,672,10,5,4,13,26,45,-19,19
AGF Aarhus,672,11,4,7,11,17,37,-20,19
Brondby,673,1,20,7,3,71,32,39,67
FC Midtjylla,673,2,21,4,5,75,43,32,67
Copenhagen,673,3,15,5,10,61,48,13,50
FC Nords,673,4,13,6,11,69,57,12,45
AaB,673,5,7,12,11,41,47,-6,33
AC Horsens,673,6,7,12,11,36,52,-16,33
Sonderjyske,673,7,8,6,10,28,29,-1,30
Lyngby,673,8,4,9,11,29,46,-17,21
Randers FC,673,9,5,6,13,25,42,-17,21
AGF Aarhus,673,10,5,6,11,19,36,-17,21
Silkeborg IF,673,11,5,3,14,25,47,-22,18
Brondby,674,1,19,8,3,74,36,38,65
FC Midtjylla,674,2,19,6,5,66,42,24,63
FC Nords,674,3,15,7,8,75,51,24,52
Copenhagen,674,4,13,5,12,61,51,10,44
AaB,674,5,8,12,10,35,43,-8,36
AC Horsens,674,6,7,12,11,42,56,-14,33
Sonderjyske,674,7,8,6,10,28,29,-1,30
Randers FC,674,8,5,7,12,23,39,-16,22
Silkeborg IF,674,9,6,3,13,27,44,-17,21
Lyngby,674,10,3,10,11,26,44,-18,19
AGF Aarhus,674,11,4,6,12,16,38,-22,18
Brondby,675,1,20,8,2,68,29,39,68
FC Midtjylla,675,2,19,4,7,62,42,20,61
FC Nords,675,3,15,7,8,80,50,30,52
Copenhagen,675,4,12,5,13,55,49,6,41
AaB,675,5,8,13,9,37,42,-5,37
AC Horsens,675,6,7,13,10,35,51,-16,34
Sonderjyske,675,7,8,6,10,28,29,-1,30
Randers FC,675,8,5,7,12,26,42,-16,22
Silkeborg IF,675,9,6,3,13,28,46,-18,21
Lyngby,675,10,3,10,11,29,47,-18,19
AGF Aarhus,675,11,4,6,12,18,39,-21,18
Brondby,676,1,20,7,3,70,32,38,67
FC Midtjylla,676,2,21,4,5,69,39,30,67
Copenhagen,676,3,14,6,10,64,47,17,48
FC Nords,676,4,12,7,11,71,58,13,43
AaB,676,5,7,13,10,35,43,-8,34
AC Horsens,676,6,6,15,9,40,56,-16,33
Sonderjyske,676,7,8,6,10,28,29,-1,30
Randers FC,676,8,6,6,12,27,39,-12,24
AGF Aarhus,676,9,5,6,11,18,37,-19,21
Silkeborg IF,676,10,5,3,14,26,46,-20,18
Lyngby,676,11,3,9,12,26,48,-22,18
Brondby,677,1,21,6,3,77,34,43,69
FC Midtjylla,677,2,20,4,6,64,39,25,64
FC Nords,677,3,14,8,8,76,52,24,50
Copenhagen,677,4,14,6,10,56,43,13,48
AaB,677,5,8,11,11,39,46,-7,35
Sonderjyske,677,6,8,6,10,28,29,-1,30
AC Horsens,677,7,5,13,12,33,57,-24,28
Randers FC,677,8,6,6,12,26,40,-14,24
Silkeborg IF,677,9,5,4,13,27,46,-19,19
AGF Aarhus,677,10,4,7,11,18,38,-20,19
Lyngby,677,11,3,9,12,27,47,-20,18
Brondby,678,1,19,6,5,70,35,35,63
FC Midtjylla,678,2,19,5,6,64,40,24,62
Copenhagen,678,3,16,4,10,59,45,14,52
FC Nords,678,4,13,6,11,72,57,15,45
AC Horsens,678,5,8,14,8,39,48,-9,38
AaB,678,6,8,11,11,38,43,-5,35
Sonderjyske,678,7,8,6,10,28,29,-1,30
Randers FC,678,8,5,7,12,24,40,-16,22
Lyngby,678,9,3,10,11,27,45,-18,19
Silkeborg IF,678,10,5,4,13,29,48,-19,19
AGF Aarhus,678,11,4,7,11,20,40,-20,19
Brondby,679,1,19,7,4,68,32,36,64
FC Midtjylla,679,2,19,5,6,66,42,24,62
FC Nords,679,3,13,7,10,70,57,13,46
Copenhagen,679,4,13,6,11,58,46,12,45
AC Horsens,679,5,9,13,8,40,49,-9,40
AaB,679,6,7,14,9,35,37,-2,35
Sonderjyske,679,7,8,6,10,28,29,-1,30
Lyngby,679,8,4,9,11,28,45,-17,21
Randers FC,679,9,5,6,13,24,41,-17,21
AGF Aarhus,679,10,5,6,11,19,37,-18,21
Silkeborg IF,679,11,5,3,14,26,47,-21,18
Brondby,680,1,22,6,2,78,31,47,72
FC Midtjylla,680,2,19,4,7,63,42,21,61
FC Nords,680,3,15,6,9,73,51,22,51
Copenhagen,680,4,13,5,12,57,49,8,44
AaB,680,5,8,12,10,38,44,-6,36
AC Horsens,680,6,6,13,11,35,53,-18,31
Sonderjyske,680,7,8,6,10,28,29,-1,30
Silkeborg IF,680,8,6,3,13,28,45,-17,21
Lyngby,680,9,4,9,11,27,44,-17,21
Randers FC,680,10,5,6,13,23,40,-17,21
AGF Aarhus,680,11,4,6,12,17,39,-22,18
Brondby,681,1,22,5,3,77,33,44,71
FC Midtjylla,681,2,19,6,5,67,40,27,63
FC Nords,681,3,15,8,7,77,52,25,53
Copenhagen,681,4,13,6,11,59,49,10,45
AC Horsens,681,5,6,13,11,38,58,-20,31
Sonderjyske,681,6,8,6,10,28,29,-1,30
AaB,681,7,6,12,12,35,47,-12,30
Lyngby,681,8,4,9,11,28,45,-17,21
Silkeborg IF,681,8,6,3,13,28,45,-17,21
Randers FC,681,10,5,6,13,24,41,-17,21
AGF Aarhus,681,11,4,6,12,17,39,-22,18
Brondby,682,1,22,5,3,77,29,48,71
FC Midtjylla,682,2,20,4,6,68,42,26,64
FC Nords,682,3,14,7,9,77,55,22,49
Copenhagen,682,4,13,4,13,56,55,1,43
AC Horsens,682,5,8,13,9,38,51,-13,37
AaB,682,6,7,11,12,38,48,-10,32
Sonderjyske,682,7,8,6,10,28,29,-1,30
Lyngby,682,8,4,9,11,29,46,-17,21
Randers FC,682,9,5,6,13,25,42,-17,21
Silkeborg IF,682,10,5,4,13,26,45,-19,19
AGF Aarhus,682,11,4,7,11,17,37,-20,19
Brondby,683,1,21,7,2,71,32,39,70
FC Midtjylla,683,2,18,4,8,62,42,20,58
Copenhagen,683,3,15,5,10,60,47,13,50
FC Nords,683,4,14,6,10,80,53,27,48
AaB,683,5,8,12,10,38,42,-4,36
AC Horsens,683,6,7,12,11,32,53,-21,33
Sonderjyske,683,7,8,6,10,28,29,-1,30
Randers FC,683,8,5,7,12,23,39,-16,22
AGF Aarhus,683,9,5,6,11,18,36,-18,21
Lyngby,683,10,3,10,11,26,44,-18,19
Silkeborg IF,683,11,5,3,14,25,46,-21,18
Brondby,684,1,21,5,4,73,34,39,68
FC Midtjylla,684,2,18,4,8,63,43,20,58
FC Nords,684,3,15,7,8,80,52,28,52
Copenhagen,684,4,16,4,10,60,44,16,52
AaB,684,5,7,13,10,38,44,-6,34
AC Horsens,684,6,6,13,11,37,60,-23,31
Sonderjyske,684,7,8,6,10,28,29,-1,30
Lyngby,684,8,4,9,11,31,46,-15,21
Silkeborg IF,684,9,6,3,13,28,46,-18,21
Randers FC,684,10,5,6,13,25,44,-19,21
AGF Aarhus,684,11,4,6,12,18,39,-21,18
Brondby,685,1,21,6,3,72,33,39,69
FC Midtjylla,685,2,19,4,7,67,39,28,61
FC Nords,685,3,16,6,8,79,53,26,54
Copenhagen,685,4,13,5,12,56,49,7,44
AaB,685,5,8,12,10,37,39,-2,36
AC Horsens,685,6,6,13,11,33,57,-24,31
Sonderjyske,685,7,8,6,10,28,29,-1,30
Lyngby,685,8,4,9,11,27,44,-17,21
Randers FC,685,9,5,6,13,23,40,-17,21
Silkeborg IF,685,10,5,4,13,26,45,-19,19
AGF Aarhus,685,11,4,7,11,17,37,-20,19
Brondby,686,1,22,5,3,70,29,41,71
FC Midtjylla,686,2,19,5,6,63,38,25,62
Copenhagen,686,3,15,4,11,59,48,11,49
FC Nords,686,4,13,8,9,76,56,20,47
AaB,686,5,7,13,10,41,45,-4,34
AC Horsens,686,6,6,13,11,36,55,-19,31
Sonderjyske,686,7,8,6,10,28,29,-1,30
Randers FC,686,8,6,6,12,25,39,-14,24
Silkeborg IF,686,9,6,3,13,27,44,-17,21
Lyngby,686,10,3,9,12,26,46,-20,18
AGF Aarhus,686,11,4,6,12,16,38,-22,18
Brondby,687,1,19,8,3,70,31,39,65
FC Midtjylla,687,2,19,5,6,65,38,27,62
FC Nords,687,3,14,6,10,70,56,14,48
Copenhagen,687,4,13,6,11,56,44,12,45
AaB,687,5,8,14,8,37,39,-2,38
AC Horsens,687,6,7,13,10,36,52,-16,34
Sonderjyske,687,7,8,6,10,28,29,-1,30
Randers FC,687,8,6,6,12,26,41,-15,24
Silkeborg IF,687,9,6,3,13,26,44,-18,21
Lyngby,687,10,3,9,12,28,47,-19,18
AGF Aarhus,687,11,4,6,12,16,37,-21,18
Brondby,688,1,21,5,4,72,33,39,68
FC Midtjylla,688,2,21,5,4,70,40,30,68
Copenhagen,688,3,15,4,11,62,48,14,49
FC Nords,688,4,13,6,11,75,61,14,45
AaB,688,5,7,12,11,37,44,-7,33
AC Horsens,688,6,7,12,11,39,55,-16,33
Sonderjyske,688,7,8,6,10,28,29,-1,30
Randers FC,688,8,6,6,12,27,41,-14,24
Silkeborg IF,688,9,6,3,13,26,44,-18,21
Lyngby,688,10,3,9,12,28,48,-20,18
AGF Aarhus,688,11,4,6,12,16,37,-21,18
Brondby,689,1,23,5,2,76,33,43,74
FC Midtjylla,689,2,20,4,6,71,40,31,64
FC Nords,689,3,14,7,9,75,53,22,49
Copenhagen,689,4,13,5,12,59,51,8,44
AaB,689,5,7,12,11,38,48,-10,33
AC Horsens,689,6,6,13,11,35,55,-20,31
Sonderjyske,689,7,8,6,10,28,29,-1,30
Randers FC,689,8,6,6,12,26,39,-13,24
Silkeborg IF,689,9,6,3,13,28,45,-17,21
Lyngby,689,10,3,9,12,26,47,-21,18
AGF Aarhus,689,11,4,6,12,17,39,-22,18
Brondby,690,1,21,5,4,70,34,36,68
FC Midtjylla,690,2,20,5,5,68,37,31,65
FC Nords,690,3,14,6,10,76,51,25,48
Copenhagen,690,4,14,5,11,60,47,13,47
AaB,690,5,8,11,11,39,47,-8,35
AC Horsens,690,6,7,12,11,34,57,-23,33
Sonderjyske,690,7,8,6,10,28,29,-1,30
Lyngby,690,8,4,9,11,29,45,-16,21
Silkeborg IF,690,9,6,3,13,27,44,-17,21
Randers FC,690,10,5,6,13,24,42,-18,21
AGF Aarhus,690,11,4,6,12,16,38,-22,18
Brondby,691,1,21,5,4,72,33,39,68
FC Midtjylla,691,2,20,5,5,65,41,24,65
Copenhagen,691,3,15,5,10,62,42,20,50
FC Nords,691,4,13,8,9,74,55,19,47
AaB,691,5,7,12,11,38,46,-8,33
AC Horsens,691,6,6,13,11,33,53,-20,31
Sonderjyske,691,7,8,6,10,28,29,-1,30
Randers FC,691,8,6,6,12,25,40,-15,24
Silkeborg IF,691,9,5,4,13,25,44,-19,19
AGF Aarhus,691,10,4,7,11,16,36,-20,19
Lyngby,691,11,3,9,12,27,46,-19,18
Brondby,692,1,20,5,5,77,40,37,65
FC Midtjylla,692,2,18,5,7,60,42,18,59
Copenhagen,692,3,16,4,10,62,43,19,52
FC Nords,692,4,15,6,9,78,56,22,51
AaB,692,5,9,11,10,42,46,-4,38
AC Horsens,692,6,6,13,11,34,52,-18,31
Sonderjyske,692,7,8,6,10,28,29,-1,30
Randers FC,692,8,5,7,12,24,40,-16,22
Silkeborg IF,692,9,6,3,13,28,44,-16,21
Lyngby,692,10,3,10,11,27,45,-18,19
AGF Aarhus,692,11,4,6,12,16,39,-23,18
FC Midtjylla,693,1,19,6,5,68,40,28,63
Brondby,693,2,18,8,4,70,38,32,62
Copenhagen,693,3,16,5,9,65,44,21,53
FC Nords,693,4,13,8,9,74,52,22,47
AaB,693,5,8,13,9,37,40,-3,37
Sonderjyske,693,6,8,6,10,28,29,-1,30
AC Horsens,693,7,6,12,12,34,60,-26,30
Randers FC,693,8,5,7,12,23,39,-16,22
AGF Aarhus,693,9,5,6,11,20,39,-19,21
Lyngby,693,10,3,10,11,26,44,-18,19
Silkeborg IF,693,11,5,3,14,28,48,-20,18
Brondby,694,1,20,7,3,69,31,38,67
FC Midtjylla,694,2,19,6,5,67,39,28,63
Copenhagen,694,3,15,5,10,60,42,18,50
FC Nords,694,4,14,6,10,74,51,23,48
AaB,694,5,8,11,11,37,47,-10,35
AC Horsens,694,6,6,13,11,33,56,-23,31
Sonderjyske,694,7,8,6,10,28,29,-1,30
Randers FC,694,8,6,6,12,25,40,-15,24
Silkeborg IF,694,9,6,3,13,27,44,-17,21
Lyngby,694,10,3,9,12,27,46,-19,18
AGF Aarhus,694,11,4,6,12,16,38,-22,18
Brondby,695,1,21,6,3,70,33,37,69
FC Midtjylla,695,2,21,4,5,71,40,31,67
FC Nords,695,3,15,6,9,70,51,19,51
Copenhagen,695,4,12,6,12,54,45,9,42
AaB,695,5,8,13,9,41,42,-1,37
Sonderjyske,695,6,8,6,10,28,29,-1,30
AC Horsens,695,7,5,13,12,34,55,-21,28
Randers FC,695,8,5,7,12,23,39,-16,22
Lyngby,695,9,3,10,11,26,44,-18,19
Silkeborg IF,695,10,5,4,13,25,44,-19,19
AGF Aarhus,695,11,4,7,11,16,36,-20,19
Brondby,696,1,21,5,4,72,34,38,68
FC Midtjylla,696,2,20,6,4,65,35,30,66
Copenhagen,696,3,15,6,9,58,40,18,51
FC Nords,696,4,13,6,11,70,57,13,45
AaB,696,5,7,14,9,37,42,-5,35
Sonderjyske,696,6,8,6,10,28,29,-1,30
AC Horsens,696,7,5,13,12,31,51,-20,28
AGF Aarhus,696,8,5,6,11,20,36,-16,21
Lyngby,696,9,4,9,11,27,44,-17,21
Randers FC,696,10,5,6,13,23,40,-17,21
Silkeborg IF,696,11,5,3,14,25,48,-23,18
Brondby,697,1,21,6,3,73,32,41,69
FC Midtjylla,697,2,17,7,6,63,41,22,58
FC Nords,697,3,16,7,7,75,48,27,55
Copenhagen,697,4,12,6,12,55,50,5,42
AaB,697,5,7,14,9,36,40,-4,35
AC Horsens,697,6,6,14,10,34,51,-17,32
Sonderjyske,697,7,8,6,10,28,29,-1,30
Randers FC,697,8,5,7,12,23,39,-16,22
AGF Aarhus,697,9,5,6,11,18,36,-18,21
Lyngby,697,10,3,10,11,26,44,-18,19
Silkeborg IF,697,11,5,3,14,25,46,-21,18
Brondby,698,1,20,6,4,70,37,33,66
FC Midtjylla,698,2,18,6,6,66,43,23,60
FC Nords,698,3,12,9,9,69,54,15,45
Copenhagen,698,4,13,6,11,62,50,12,45
AaB,698,5,9,13,8,44,41,3,40
AC Horsens,698,6,7,14,9,37,49,-12,35
Sonderjyske,698,7,8,6,10,28,29,-1,30
Lyngby,698,8,4,9,11,30,46,-16,21
Randers FC,698,9,5,6,13,25,43,-18,21
Silkeborg IF,698,10,5,4,13,27,46,-19,19
AGF Aarhus,698,11,4,7,11,18,38,-20,19
FC Midtjylla,699,1,20,5,5,66,35,31,65
Brondby,699,2,19,7,4,72,39,33,64
FC Nords,699,3,12,7,11,67,55,12,43
Copenhagen,699,4,12,7,11,54,43,11,43
AC Horsens,699,5,9,13,8,36,46,-10,40
AaB,699,6,8,13,9,35,38,-3,37
Sonderjyske,699,7,8,6,10,28,29,-1,30
Lyngby,699,8,4,9,11,29,44,-15,21
Randers FC,699,9,5,6,13,23,42,-19,21
Silkeborg IF,699,10,5,4,13,26,45,-19,19
AGF Aarhus,699,11,4,7,11,17,37,-20,19
Brondby,700,1,21,6,3,69,29,40,69
FC Midtjylla,700,2,20,6,4,72,40,32,66
Copenhagen,700,3,14,5,11,61,45,16,47
FC Nords,700,4,13,7,10,72,55,17,46
AaB,700,5,9,12,9,40,44,-4,39
Sonderjyske,700,6,8,6,10,28,29,-1,30
AC Horsens,700,7,5,12,13,30,57,-27,27
Randers FC,700,8,5,7,12,25,41,-16,22
Lyngby,700,9,3,10,11,28,46,-18,19
Silkeborg IF,700,10,5,4,13,27,46,-19,19
AGF Aarhus,700,11,4,7,11,18,38,-20,19
Brondby,701,1,21,5,4,70,32,38,68
FC Midtjylla,701,2,19,6,5,64,39,25,63
FC Nords,701,3,14,8,8,72,48,24,50
Copenhagen,701,4,13,5,12,54,47,7,44
AaB,701,5,8,13,9,40,42,-2,37
AC Horsens,701,6,6,13,11,33,51,-18,31
Sonderjyske,701,7,8,6,10,28,29,-1,30
Randers FC,701,8,5,7,12,24,40,-16,22
Silkeborg IF,701,9,6,3,13,26,44,-18,21
Lyngby,701,10,3,10,11,27,45,-18,19
AGF Aarhus,701,11,4,6,12,16,37,-21,18
Brondby,702,1,22,6,2,74,33,41,72
FC Midtjylla,702,2,19,5,6,65,40,25,62
Copenhagen,702,3,14,6,10,58,45,13,48
FC Nords,702,4,13,8,9,73,53,20,47
AC Horsens,702,5,7,12,11,38,54,-16,33
AaB,702,6,6,13,11,31,40,-9,31
Sonderjyske,702,7,8,6,10,28,29,-1,30
Randers FC,702,8,6,6,12,25,40,-15,24
Silkeborg IF,702,9,6,3,13,26,44,-18,21
Lyngby,702,10,3,9,12,27,46,-19,18
AGF Aarhus,702,11,4,6,12,16,37,-21,18
Brondby,703,1,20,6,4,73,36,37,66
FC Midtjylla,703,2,19,6,5,66,38,28,63
Copenhagen,703,3,15,5,10,59,43,16,50
FC Nords,703,4,14,6,10,71,54,17,48
AaB,703,5,9,12,9,41,42,-1,39
Sonderjyske,703,6,8,6,10,28,29,-1,30
AC Horsens,703,7,5,13,12,36,59,-23,28
Lyngby,703,8,4,9,11,28,44,-16,21
Silkeborg IF,703,9,6,3,13,28,45,-17,21
Randers FC,703,10,5,6,13,23,41,-18,21
AGF Aarhus,703,11,4,6,12,17,39,-22,18
FC Midtjylla,704,1,20,5,5,67,37,30,65
Brondby,704,2,19,7,4,68,34,34,64
FC Nords,704,3,14,8,8,74,53,21,50
Copenhagen,704,4,12,5,13,56,49,7,41
AC Horsens,704,5,8,13,9,38,50,-12,37
AaB,704,6,8,12,10,37,43,-6,36
Sonderjyske,704,7,8,6,10,28,29,-1,30
Lyngby,704,8,4,9,11,28,45,-17,21
Randers FC,704,9,5,6,13,24,41,-17,21
Silkeborg IF,704,10,6,3,13,26,44,-18,21
AGF Aarhus,704,11,4,6,12,16,37,-21,18
Brondby,705,1,19,8,3,71,33,38,65
FC Nords,705,2,17,6,7,77,49,28,57
FC Midtjylla,705,3,17,6,7,58,40,18,57
Copenhagen,705,4,13,6,11,57,47,10,45
AC Horsens,705,5,7,14,9,34,47,-13,35
AaB,705,6,7,12,11,38,45,-7,33
Sonderjyske,705,7,8,6,10,28,29,-1,30
Lyngby,705,8,4,9,11,28,45,-17,21
Randers FC,705,9,5,6,13,24,41,-17,21
Silkeborg IF,705,10,6,3,13,26,44,-18,21
AGF Aarhus,705,11,4,6,12,16,37,-21,18
Brondby,706,1,23,5,2,73,28,45,74
FC Midtjylla,706,2,21,4,5,67,40,27,67
FC Nords,706,3,13,7,10,69,51,18,46
Copenhagen,706,4,13,4,13,55,52,3,43
AC Horsens,706,5,7,13,10,39,52,-13,34
AaB,706,6,7,11,12,37,43,-6,32
Sonderjyske,706,7,8,6,10,28,29,-1,30
Lyngby,706,8,4,9,11,27,44,-17,21
Randers FC,706,9,5,6,13,23,40,-17,21
Silkeborg IF,706,10,5,4,13,27,46,-19,19
AGF Aarhus,706,11,4,7,11,18,38,-20,19
Brondby,707,1,21,6,3,73,32,41,69
FC Midtjylla,707,2,19,5,6,71,46,25,62
Copenhagen,707,3,14,5,11,60,45,15,47
FC Nords,707,4,13,7,10,73,57,16,46
AaB,707,5,9,12,9,38,43,-5,39
AC Horsens,707,6,6,13,11,38,56,-18,31
Sonderjyske,707,7,8,6,10,28,29,-1,30
Lyngby,707,8,4,9,11,30,45,-15,21
Silkeborg IF,707,9,6,3,13,27,44,-17,21
Randers FC,707,10,5,6,13,24,43,-19,21
AGF Aarhus,707,11,4,6,12,16,38,-22,18
Brondby,708,1,23,5,2,74,31,43,74
FC Midtjylla,708,2,18,6,6,62,39,23,60
Copenhagen,708,3,14,6,10,58,42,16,48
FC Nords,708,4,13,7,10,73,56,17,46
AaB,708,5,7,12,11,36,46,-10,33
AC Horsens,708,6,6,14,10,38,53,-15,32
Sonderjyske,708,7,8,6,10,28,29,-1,30
Randers FC,708,8,5,7,12,25,41,-16,22
Lyngby,708,9,3,10,11,28,46,-18,19
Silkeborg IF,708,10,5,4,13,27,46,-19,19
AGF Aarhus,708,11,4,7,11,18,38,-20,19
Brondby,709,1,21,7,2,74,32,42,70
FC Midtjylla,709,2,20,5,5,67,40,27,65
FC Nords,709,3,14,6,10,76,58,18,48
Copenhagen,709,4,14,4,12,58,44,14,46
AC Horsens,709,5,8,12,10,36,52,-16,36
Sonderjyske,709,6,8,6,10,28,29,-1,30
AaB,709,7,6,12,12,34,45,-11,30
Lyngby,709,8,4,9,11,29,45,-16,21
Silkeborg IF,709,9,6,3,13,26,44,-18,21
Randers FC,709,10,5,6,13,24,42,-18,21
AGF Aarhus,709,11,4,6,12,16,37,-21,18
Brondby,710,1,23,5,2,72,29,43,74
FC Midtjylla,710,2,19,4,7,64,41,23,61
FC Nords,710,3,15,6,9,72,48,24,51
Copenhagen,710,4,14,4,12,57,47,10,46
AC Horsens,710,5,7,12,11,36,53,-17,33
AaB,710,6,7,11,12,36,45,-9,32
Sonderjyske,710,7,8,6,10,28,29,-1,30
Lyngby,710,8,4,9,11,29,45,-16,21
Silkeborg IF,710,9,6,3,13,28,45,-17,21
Randers FC,710,10,5,6,13,24,42,-18,21
AGF Aarhus,710,11,4,6,12,17,39,-22,18
FC Midtjylla,711,1,20,6,4,68,39,29,66
Brondby,711,2,20,5,5,68,36,32,65
FC Nords,711,3,15,6,9,75,52,23,51
Copenhagen,711,4,14,6,10,59,45,14,48
AaB,711,5,8,12,10,35,40,-5,36
Sonderjyske,711,6,8,6,10,28,29,-1,30
AC Horsens,711,7,5,13,12,32,51,-19,28
Randers FC,711,8,6,6,12,24,39,-15,24
Silkeborg IF,711,9,5,4,13,26,45,-19,19
AGF Aarhus,711,10,4,7,11,17,37,-20,19
Lyngby,711,11,3,9,12,26,45,-19,18
Brondby,712,1,22,6,2,75,31,44,72
FC Midtjylla,712,2,21,4,5,74,46,28,67
Copenhagen,712,3,13,7,10,61,46,15,46
FC Nords,712,4,12,6,12,70,61,9,42
AaB,712,5,8,12,10,37,41,-4,36
AC Horsens,712,6,6,13,11,38,56,-18,31
Sonderjyske,712,7,8,6,10,28,29,-1,30
Lyngby,712,8,4,9,11,27,44,-17,21
Randers FC,712,9,5,6,13,23,40,-17,21
AGF Aarhus,712,10,5,6,11,17,36,-19,21
Silkeborg IF,712,11,5,3,14,25,45,-20,18
Brondby,713,1,20,6,4,68,34,34,66
FC Midtjylla,713,2,20,5,5,67,39,28,65
FC Nords,713,3,13,9,8,73,52,21,48
Copenhagen,713,4,14,5,11,56,43,13,47
AC Horsens,713,5,7,14,9,36,50,-14,35
AaB,713,6,6,13,11,36,44,-8,31
Sonderjyske,713,7,8,6,10,28,29,-1,30
Lyngby,713,8,4,9,11,28,45,-17,21
Randers FC,713,9,5,6,13,24,41,-17,21
Silkeborg IF,713,10,5,4,13,26,45,-19,19
AGF Aarhus,713,11,4,7,11,17,37,-20,19
Brondby,714,1,19,6,5,68,35,33,63
FC Midtjylla,714,2,18,7,5,66,39,27,61
FC Nords,714,3,15,7,8,73,53,20,52
Copenhagen,714,4,14,7,9,56,40,16,49
AaB,714,5,7,13,10,34,40,-6,34
AC Horsens,714,6,6,14,10,36,52,-16,32
Sonderjyske,714,7,8,6,10,28,29,-1,30
Lyngby,714,8,4,9,11,30,45,-15,21
AGF Aarhus,714,9,5,6,11,19,37,-18,21
Randers FC,714,10,5,6,13,24,43,-19,21
Silkeborg IF,714,11,5,3,14,26,47,-21,18
FC Midtjylla,715,1,21,5,4,66,36,30,68
Brondby,715,2,20,7,3,72,33,39,67
FC Nords,715,3,13,7,10,72,55,17,46
Copenhagen,715,4,13,6,11,54,44,10,45
AaB,715,5,8,13,9,35,38,-3,37
Sonderjyske,715,6,8,6,10,28,29,-1,30
AC Horsens,715,7,6,12,12,36,55,-19,30
Randers FC,715,8,6,6,12,24,39,-15,24
Silkeborg IF,715,9,6,3,13,29,44,-15,21
Lyngby,715,10,3,9,12,26,45,-19,18
AGF Aarhus,715,11,4,6,12,16,40,-24,18
Brondby,716,1,20,7,3,68,29,39,67
FC Midtjylla,716,2,20,5,5,65,37,28,65
FC Nords,716,3,14,6,10,72,51,21,48
Copenhagen,716,4,13,7,10,58,43,15,46
AaB,716,5,8,12,10,37,45,-8,36
Sonderjyske,716,6,8,6,10,28,29,-1,30
AC Horsens,716,7,5,15,10,32,53,-21,30
Randers FC,716,8,6,6,12,25,39,-14,24
Silkeborg IF,716,9,6,3,13,28,46,-18,21
Lyngby,716,10,3,9,12,26,46,-20,18
AGF Aarhus,716,11,4,6,12,18,39,-21,18
Brondby,717,1,22,6,2,77,31,46,72
FC Midtjylla,717,2,19,4,7,65,45,20,61
FC Nords,717,3,14,6,10,73,56,17,48
Copenhagen,717,4,13,5,12,62,50,12,44
AC Horsens,717,5,7,14,9,37,51,-14,35
AaB,717,6,7,13,10,38,45,-7,34
Sonderjyske,717,7,8,6,10,28,29,-1,30
Randers FC,717,8,5,7,12,23,39,-16,22
Silkeborg IF,717,9,6,3,13,28,44,-16,21
Lyngby,717,10,3,10,11,26,44,-18,19
AGF Aarhus,717,11,4,6,12,16,39,-23,18
Brondby,718,1,21,7,2,73,30,43,70
FC Midtjylla,718,2,21,4,5,70,37,33,67
FC Nords,718,3,15,6,9,70,52,18,51
Copenhagen,718,4,12,5,13,54,50,4,41
AaB,718,5,8,11,11,38,43,-5,35
AC Horsens,718,6,6,13,11,34,53,-19,31
Sonderjyske,718,7,8,6,10,28,29,-1,30
Lyngby,718,8,4,9,11,27,44,-17,21
Randers FC,718,9,5,6,13,23,40,-17,21
AGF Aarhus,718,10,5,6,11,17,36,-19,21
Silkeborg IF,718,11,5,3,14,25,45,-20,18
Brondby,719,1,20,7,3,69,31,38,67
FC Midtjylla,719,2,18,5,7,61,41,20,59
FC Nords,719,3,13,9,8,75,53,22,48
Copenhagen,719,4,14,5,11,54,41,13,47
AaB,719,5,8,14,8,41,43,-2,38
AC Horsens,719,6,7,12,11,34,51,-17,33
Sonderjyske,719,7,8,6,10,28,29,-1,30
Lyngby,719,8,4,9,11,29,46,-17,21
Randers FC,719,9,5,6,13,25,42,-17,21
Silkeborg IF,719,10,5,4,13,28,47,-19,19
AGF Aarhus,719,11,4,7,11,19,39,-20,19
FC Midtjylla,720,1,19,6,5,68,36,32,63
Brondby,720,2,18,8,4,66,33,33,62
FC Nords,720,3,14,8,8,76,50,26,50
Copenhagen,720,4,13,4,13,53,49,4,43
AaB,720,5,9,13,8,40,38,2,40
AC Horsens,720,6,7,13,10,33,56,-23,34
Sonderjyske,720,7,8,6,10,28,29,-1,30
Lyngby,720,8,4,9,11,28,44,-16,21
Silkeborg IF,720,8,6,3,13,28,44,-16,21
Randers FC,720,10,5,6,13,23,41,-18,21
AGF Aarhus,720,11,4,6,12,16,39,-23,18
FC Midtjylla,721,1,21,5,4,70,36,34,68
Brondby,721,2,19,6,5,67,34,33,63
FC Nords,721,3,15,8,7,78,47,31,53
Copenhagen,721,4,12,5,13,53,52,1,41
AaB,721,5,9,11,10,40,47,-7,38
Sonderjyske,721,6,8,6,10,28,29,-1,30
AC Horsens,721,7,5,15,10,37,55,-18,30
Lyngby,721,8,4,9,11,27,44,-17,21
Randers FC,721,9,5,6,13,23,40,-17,21
AGF Aarhus,721,10,5,6,11,19,36,-17,21
Silkeborg IF,721,11,5,3,14,25,47,-22,18
Brondby,722,1,20,8,2,73,33,40,68
FC Midtjylla,722,2,19,4,7,61,41,20,61
FC Nords,722,3,14,7,9,78,56,22,49
Copenhagen,722,4,14,6,10,57,42,15,48
AaB,722,5,8,13,9,41,43,-2,37
Sonderjyske,722,6,8,6,10,28,29,-1,30
AC Horsens,722,7,5,14,11,33,54,-21,29
Lyngby,722,8,4,9,11,29,46,-17,21
Randers FC,722,9,5,6,13,25,42,-17,21
Silkeborg IF,722,10,5,4,13,25,44,-19,19
AGF Aarhus,722,11,4,7,11,16,36,-20,19
Brondby,723,1,23,5,2,76,33,43,74
FC Midtjylla,723,2,18,5,7,66,42,24,59
FC Nords,723,3,14,8,8,76,54,22,50
Copenhagen,723,4,15,4,11,59,44,15,49
AaB,723,5,7,12,11,41,47,-6,33
Sonderjyske,723,6,8,6,10,28,29,-1,30
AC Horsens,723,7,6,12,12,33,57,-24,30
Lyngby,723,8,4,9,11,29,44,-15,21
Randers FC,723,9,5,6,13,23,42,-19,21
AGF Aarhus,723,10,5,6,11,18,37,-19,21
Silkeborg IF,723,11,5,3,14,26,46,-20,18
FC Midtjylla,724,1,22,4,4,72,37,35,70
Brondby,724,2,20,7,3,67,33,34,67
FC Nords,724,3,13,8,9,70,53,17,47
Copenhagen,724,4,14,5,11,57,44,13,47
AaB,724,5,7,12,11,37,45,-8,33
Sonderjyske,724,6,8,6,10,28,29,-1,30
AC Horsens,724,7,6,12,12,36,53,-17,30
Lyngby,724,8,4,9,11,28,44,-16,21
Silkeborg IF,724,9,6,3,13,28,45,-17,21
Randers FC,724,10,5,6,13,23,41,-18,21
AGF Aarhus,724,11,4,6,12,17,39,-22,18
Brondby,725,1,23,5,2,77,29,48,74
FC Midtjylla,725,2,19,5,6,63,42,21,62
FC Nords,725,3,16,6,8,72,47,25,54
Copenhagen,725,4,14,5,11,56,41,15,47
AaB,725,5,7,11,12,34,42,-8,32
Sonderjyske,725,6,8,6,10,28,29,-1,30
AC Horsens,725,7,5,12,13,30,57,-27,27
Randers FC,725,8,6,6,12,24,39,-15,24
Silkeborg IF,725,9,6,3,13,27,45,-18,21
Lyngby,725,10,3,9,12,26,45,-19,18
AGF Aarhus,725,11,4,6,12,17,38,-21,18
Brondby,726,1,20,6,4,66,31,35,66
FC Midtjylla,726,2,20,5,5,66,38,28,65
FC Nords,726,3,14,7,9,74,53,21,49
Copenhagen,726,4,13,6,11,58,46,12,45
AaB,726,5,8,12,10,36,42,-6,36
AC Horsens,726,6,6,14,10,35,51,-16,32
Sonderjyske,726,7,8,6,10,28,29,-1,30
Randers FC,726,8,6,6,12,25,39,-14,24
Silkeborg IF,726,9,6,3,13,28,45,-17,21
Lyngby,726,10,3,9,12,26,46,-20,18
AGF Aarhus,726,11,4,6,12,17,39,-22,18
Brondby,727,1,19,8,3,68,32,36,65
FC Midtjylla,727,2,19,5,6,63,40,23,62
FC Nords,727,3,14,8,8,78,51,27,50
Copenhagen,727,4,14,6,10,59,43,16,48
AaB,727,5,8,11,11,33,39,-6,35
AC Horsens,727,6,6,14,10,33,55,-22,32
Sonderjyske,727,7,8,6,10,28,29,-1,30
Lyngby,727,8,4,9,11,27,44,-17,21
Randers FC,727,9,5,6,13,23,40,-17,21
Silkeborg IF,727,10,5,4,13,25,44,-19,19
AGF Aarhus,727,11,4,7,11,16,36,-20,19
Brondby,728,1,20,6,4,72,35,37,66
FC Midtjylla,728,2,19,4,7,67,43,24,61
FC Nords,728,3,15,7,8,73,50,23,52
Copenhagen,728,4,15,5,10,59,44,15,50
AaB,728,5,7,13,10,35,42,-7,34
AC Horsens,728,6,6,13,11,36,54,-18,31
Sonderjyske,728,7,8,6,10,28,29,-1,30
Randers FC,728,8,6,6,12,28,41,-13,24
AGF Aarhus,728,9,5,6,11,19,36,-17,21
Lyngby,728,10,3,9,12,28,49,-21,18
Silkeborg IF,728,11,5,3,14,25,47,-22,18
Brondby,729,1,22,5,3,73,30,43,71
FC Midtjylla,729,2,20,5,5,72,41,31,65
FC Nords,729,3,15,6,9,76,54,22,51
Copenhagen,729,4,13,4,13,59,51,8,43
AC Horsens,729,5,7,13,10,36,55,-19,34
AaB,729,6,7,11,12,38,49,-11,32
Sonderjyske,729,7,8,6,10,28,29,-1,30
Randers FC,729,8,6,6,12,24,39,-15,24
AGF Aarhus,729,9,5,6,11,19,38,-19,21
Lyngby,729,10,3,9,12,26,45,-19,18
Silkeborg IF,729,11,5,3,14,27,47,-20,18
FC Midtjylla,730,1,21,5,4,66,33,33,68
Brondby,730,2,18,8,4,64,32,32,62
Copenhagen,730,3,16,4,10,59,42,17,52
FC Nords,730,4,13,7,10,69,53,16,46
AaB,730,5,7,13,10,39,42,-3,34
AC Horsens,730,6,6,13,11,35,56,-21,31
Sonderjyske,730,7,8,6,10,28,29,-1,30
Randers FC,730,8,6,6,12,26,39,-13,24
Silkeborg IF,730,9,6,3,13,27,44,-17,21
Lyngby,730,10,3,9,12,26,47,-21,18
AGF Aarhus,730,11,4,6,12,16,38,-22,18
Brondby,731,1,21,6,3,69,32,37,69
FC Midtjylla,731,2,19,5,6,63,38,25,62
FC Nords,731,3,14,6,10,72,51,21,48
Copenhagen,731,4,13,5,12,57,48,9,44
AaB,731,5,8,12,10,36,41,-5,36
AC Horsens,731,6,7,14,9,36,49,-13,35
Sonderjyske,731,7,8,6,10,28,29,-1,30
Lyngby,731,8,4,9,11,29,45,-16,21
Randers FC,731,9,5,6,13,24,42,-18,21
AGF Aarhus,731,10,5,6,11,17,36,-19,21
Silkeborg IF,731,11,5,3,14,25,45,-20,18
Brondby,732,1,22,5,3,73,33,40,71
FC Midtjylla,732,2,20,5,5,68,41,27,65
FC Nords,732,3,14,7,9,73,50,23,49
Copenhagen,732,4,13,5,12,55,45,10,44
AaB,732,5,8,11,11,38,45,-7,35
Sonderjyske,732,6,8,6,10,28,29,-1,30
AC Horsens,732,7,5,15,10,34,53,-19,30
Randers FC,732,8,6,6,12,28,43,-15,24
Silkeborg IF,732,9,6,3,13,27,45,-18,21
Lyngby,732,10,3,9,12,30,49,-19,18
AGF Aarhus,732,11,4,6,12,17,38,-21,18
Brondby,733,1,21,6,3,72,32,40,69
FC Midtjylla,733,2,20,4,6,66,39,27,64
Copenhagen,733,3,17,4,9,62,42,20,55
FC Nords,733,4,13,7,10,79,59,20,46
AC Horsens,733,5,6,13,11,36,60,-24,31
Sonderjyske,733,6,8,6,10,28,29,-1,30
AaB,733,7,6,12,12,36,45,-9,30
Randers FC,733,8,5,7,12,25,41,-16,22
AGF Aarhus,733,9,5,6,11,18,36,-18,21
Lyngby,733,10,3,10,11,28,46,-18,19
Silkeborg IF,733,11,5,3,14,25,46,-21,18
Brondby,734,1,20,6,4,72,34,38,66
FC Midtjylla,734,2,20,5,5,69,40,29,65
FC Nords,734,3,13,8,9,70,51,19,47
Copenhagen,734,4,13,6,11,56,44,12,45
AaB,734,5,8,13,9,38,42,-4,37
AC Horsens,734,6,7,12,11,36,56,-20,33
Sonderjyske,734,7,8,6,10,28,29,-1,30
Lyngby,734,8,4,9,11,30,45,-15,21
Randers FC,734,9,5,6,13,24,43,-19,21
Silkeborg IF,734,10,5,4,13,27,46,-19,19
AGF Aarhus,734,11,4,7,11,18,38,-20,19
Brondby,735,1,21,6,3,72,32,40,69
FC Midtjylla,735,2,18,6,6,67,42,25,60
Copenhagen,735,3,15,5,10,58,43,15,50
FC Nords,735,4,13,6,11,72,56,16,45
AaB,735,5,8,12,10,38,42,-4,36
AC Horsens,735,6,7,13,10,33,51,-18,34
Sonderjyske,735,7,8,6,10,28,29,-1,30
Randers FC,735,8,5,7,12,24,40,-16,22
Silkeborg IF,735,9,6,3,13,28,46,-18,21
Lyngby,735,10,3,10,11,27,45,-18,19
AGF Aarhus,735,11,4,6,12,18,39,-21,18
Brondby,736,1,21,6,3,71,32,39,69
FC Midtjylla,736,2,20,5,5,65,38,27,65
FC Nords,736,3,15,7,8,82,51,31,52
Copenhagen,736,4,14,6,10,60,45,15,48
AaB,736,5,7,12,11,35,47,-12,33
Sonderjyske,736,6,8,6,10,28,29,-1,30
AC Horsens,736,7,5,12,13,36,62,-26,27
Randers FC,736,8,5,7,12,26,42,-16,22
Silkeborg IF,736,9,6,3,13,26,44,-18,21
Lyngby,736,10,3,10,11,29,47,-18,19
AGF Aarhus,736,11,4,6,12,16,37,-21,18
Brondby,737,1,20,5,5,71,35,36,65
FC Midtjylla,737,2,20,5,5,66,41,25,65
FC Nords,737,3,15,7,8,76,50,26,52
Copenhagen,737,4,15,4,11,58,44,14,49
AaB,737,5,8,12,10,36,42,-6,36
Sonderjyske,737,6,8,6,10,28,29,-1,30
AC Horsens,737,7,5,13,12,34,55,-21,28
Lyngby,737,8,4,9,11,31,46,-15,21
Randers FC,737,9,5,6,13,25,44,-19,21
AGF Aarhus,737,10,5,6,11,18,37,-19,21
Silkeborg IF,737,11,5,3,14,26,46,-20,18
Brondby,738,1,22,5,3,76,28,48,71
FC Midtjylla,738,2,20,5,5,66,44,22,65
Copenhagen,738,3,15,4,11,60,44,16,49
FC Nords,738,4,14,6,10,72,55,17,48
AaB,738,5,7,11,12,39,52,-13,32
AC Horsens,738,6,6,13,11,40,56,-16,31
Sonderjyske,738,7,8,6,10,28,29,-1,30
Randers FC,738,8,6,6,12,25,40,-15,24
Silkeborg IF,738,9,6,3,13,26,44,-18,21
Lyngby,738,10,3,9,12,27,46,-19,18
AGF Aarhus,738,11,4,6,12,16,37,-21,18
Brondby,739,1,21,6,3,69,33,36,69
FC Midtjylla,739,2,18,6,6,65,45,20,60
FC Nords,739,3,15,7,8,77,48,29,52
Copenhagen,739,4,14,6,10,63,46,17,48
AC Horsens,739,5,7,13,10,38,55,-17,34
Sonderjyske,739,6,8,6,10,28,29,-1,30
AaB,739,7,6,12,12,36,47,-11,30
Lyngby,739,8,4,9,11,27,44,-17,21
Randers FC,739,9,5,6,13,23,40,-17,21
Silkeborg IF,739,10,5,4,13,26,45,-19,19
AGF Aarhus,739,11,4,7,11,17,37,-20,19
Brondby,740,1,20,7,3,72,31,41,67
FC Midtjylla,740,2,20,5,5,66,40,26,65
Copenhagen,740,3,15,5,10,57,41,16,50
FC Nords,740,4,12,7,11,69,53,16,43
AaB,740,5,9,11,10,37,44,-7,38
AC Horsens,740,6,6,13,11,34,52,-18,31
Sonderjyske,740,7,8,6,10,28,29,-1,30
Randers FC,740,8,5,7,12,25,41,-16,22
Lyngby,740,9,3,10,11,28,46,-18,19
Silkeborg IF,740,10,5,4,13,26,45,-19,19
AGF Aarhus,740,11,4,7,11,17,37,-20,19
Brondby,741,1,21,7,2,72,29,43,70
FC Midtjylla,741,2,18,5,7,61,42,19,59
FC Nords,741,3,14,8,8,73,50,23,50
Copenhagen,741,4,14,6,10,60,47,13,48
AaB,741,5,6,14,10,35,41,-6,32
AC Horsens,741,6,6,14,10,35,53,-18,32
Sonderjyske,741,7,8,6,10,28,29,-1,30
Randers FC,741,8,6,6,12,24,39,-15,24
AGF Aarhus,741,9,5,6,11,18,37,-19,21
Lyngby,741,10,3,9,12,26,45,-19,18
Silkeborg IF,741,11,5,3,14,26,46,-20,18
Brondby,742,1,21,6,3,75,35,40,69
FC Midtjylla,742,2,20,5,5,70,38,32,65
FC Nords,742,3,14,7,9,78,54,24,49
Copenhagen,742,4,14,5,11,60,46,14,47
AaB,742,5,8,11,11,37,47,-10,35
Sonderjyske,742,6,8,6,10,28,29,-1,30
AC Horsens,742,7,6,12,12,32,58,-26,30
Lyngby,742,8,4,9,11,30,45,-15,21
Silkeborg IF,742,9,6,3,13,27,44,-17,21
Randers FC,742,10,5,6,13,24,43,-19,21
AGF Aarhus,742,11,4,6,12,16,38,-22,18
Brondby,743,1,22,6,2,77,35,42,72
FC Midtjylla,743,2,18,7,5,62,39,23,61
FC Nords,743,3,16,6,8,79,52,27,54
Copenhagen,743,4,14,5,11,58,44,14,47
AaB,743,5,7,11,12,37,45,-8,32
Sonderjyske,743,6,8,6,10,28,29,-1,30
AC Horsens,743,7,5,13,12,33,57,-24,28
Lyngby,743,8,4,9,11,27,44,-17,21
Randers FC,743,9,5,6,13,23,40,-17,21
AGF Aarhus,743,10,5,6,11,18,36,-18,21
Silkeborg IF,743,11,5,3,14,25,46,-21,18
Brondby,744,1,21,5,4,79,34,45,68
FC Midtjylla,744,2,18,6,6,65,44,21,60
FC Nords,744,3,16,7,7,77,48,29,55
Copenhagen,744,4,14,4,12,55,50,5,46
AaB,744,5,7,12,11,37,43,-6,33
AC Horsens,744,6,7,12,11,36,56,-20,33
Sonderjyske,744,7,8,6,10,28,29,-1,30
Randers FC,744,8,5,7,12,25,41,-16,22
Silkeborg IF,744,9,6,3,13,29,46,-17,21
Lyngby,744,10,3,10,11,28,46,-18,19
AGF Aarhus,744,11,4,6,12,18,40,-22,18
Brondby,745,1,23,5,2,74,28,46,74
FC Midtjylla,745,2,18,5,7,61,39,22,59
FC Nords,745,3,14,7,9,71,49,22,49
Copenhagen,745,4,14,5,11,53,41,12,47
AaB,745,5,7,12,11,35,45,-10,33
AC Horsens,745,6,7,12,11,33,51,-18,33
Sonderjyske,745,7,8,6,10,28,29,-1,30
Randers FC,745,8,6,6,12,25,40,-15,24
Silkeborg IF,745,9,6,3,13,27,44,-17,21
Lyngby,745,10,3,9,12,27,46,-19,18
AGF Aarhus,745,11,4,6,12,16,38,-22,18
Brondby,746,1,20,6,4,68,31,37,66
FC Midtjylla,746,2,18,6,6,61,42,19,60
FC Nords,746,3,16,6,8,76,48,28,54
Copenhagen,746,4,15,4,11,62,44,18,49
AaB,746,5,7,13,10,34,40,-6,34
Sonderjyske,746,6,8,6,10,28,29,-1,30
AC Horsens,746,7,5,15,10,32,54,-22,30
Randers FC,746,8,6,6,12,24,39,-15,24
Silkeborg IF,746,9,6,3,13,27,45,-18,21
Lyngby,746,10,3,9,12,26,45,-19,18
AGF Aarhus,746,11,4,6,12,17,38,-21,18
Brondby,747,1,20,8,2,72,34,38,68
FC Midtjylla,747,2,19,5,6,67,43,24,62
Copenhagen,747,3,16,4,10,64,40,24,52
FC Nords,747,4,12,9,9,71,56,15,45
AC Horsens,747,5,7,13,10,37,52,-15,34
AaB,747,6,6,13,11,33,45,-12,31
Sonderjyske,747,7,8,6,10,28,29,-1,30
Lyngby,747,8,4,9,11,27,44,-17,21
Randers FC,747,9,5,6,13,23,40,-17,21
Silkeborg IF,747,10,6,3,13,26,44,-18,21
AGF Aarhus,747,11,4,6,12,16,37,-21,18
FC Midtjylla,748,1,21,4,5,69,37,32,67
Brondby,748,2,19,6,5,65,33,32,63
FC Nords,748,3,14,7,9,71,48,23,49
Copenhagen,748,4,15,4,11,54,40,14,49
AC Horsens,748,5,7,14,9,35,49,-14,35
AaB,748,6,7,11,12,32,45,-13,32
Sonderjyske,748,7,8,6,10,28,29,-1,30
Randers FC,748,8,5,7,12,24,40,-16,22
Silkeborg IF,748,9,6,3,13,29,47,-18,21
Lyngby,748,10,3,10,11,27,45,-18,19
AGF Aarhus,748,11,4,6,12,19,40,-21,18
Brondby,749,1,22,5,3,77,38,39,71
FC Midtjylla,749,2,20,5,5,68,41,27,65
FC Nords,749,3,14,7,9,71,51,20,49
Copenhagen,749,4,15,4,11,60,46,14,49
AaB,749,5,7,12,11,42,48,-6,33
Sonderjyske,749,6,8,6,10,28,29,-1,30
AC Horsens,749,7,5,13,12,36,56,-20,28
Randers FC,749,8,6,6,12,25,40,-15,24
AGF Aarhus,749,9,5,6,11,19,37,-18,21
Lyngby,749,10,3,9,12,27,46,-19,18
Silkeborg IF,749,11,5,3,14,26,47,-21,18
Brondby,750,1,22,6,2,70,31,39,72
FC Midtjylla,750,2,20,5,5,66,39,27,65
FC Nords,750,3,13,8,9,73,54,19,47
Copenhagen,750,4,13,5,12,57,46,11,44
AaB,750,5,7,13,10,35,41,-6,34
AC Horsens,750,6,6,13,11,35,51,-16,31
Sonderjyske,750,7,8,6,10,28,29,-1,30
Randers FC,750,8,5,7,12,24,40,-16,22
AGF Aarhus,750,9,5,6,11,17,36,-19,21
Lyngby,750,10,3,10,11,27,45,-18,19
Silkeborg IF,750,11,5,3,14,25,45,-20,18
FC Midtjylla,751,1,21,5,4,65,34,31,68
Brondby,751,2,20,7,3,69,33,36,67
Copenhagen,751,3,14,6,10,59,46,13,48
FC Nords,751,4,13,7,10,71,53,18,46
AaB,751,5,7,12,11,34,43,-9,33
AC Horsens,751,6,6,13,11,36,51,-15,31
Sonderjyske,751,7,8,6,10,28,29,-1,30
Lyngby,751,8,4,9,11,28,45,-17,21
Randers FC,751,9,5,6,13,24,41,-17,21
Silkeborg IF,751,10,6,3,13,26,44,-18,21
AGF Aarhus,751,11,4,6,12,16,37,-21,18
Brondby,752,1,23,5,2,75,29,46,74
FC Midtjylla,752,2,20,4,6,66,44,22,64
Copenhagen,752,3,14,5,11,62,42,20,47
FC Nords,752,4,13,7,10,73,59,14,46
AaB,752,5,7,12,11,37,46,-9,33
AC Horsens,752,6,6,13,11,33,52,-19,31
Sonderjyske,752,7,8,6,10,28,29,-1,30
Lyngby,752,8,4,9,11,27,44,-17,21
Randers FC,752,9,5,6,13,23,40,-17,21
Silkeborg IF,752,10,6,3,13,26,44,-18,21
AGF Aarhus,752,11,4,6,12,16,37,-21,18
Brondby,753,1,22,5,3,79,32,47,71
FC Midtjylla,753,2,20,5,5,67,38,29,65
FC Nords,753,3,15,7,8,77,59,18,52
Copenhagen,753,4,13,4,13,55,47,8,43
AaB,753,5,8,11,11,34,42,-8,35
Sonderjyske,753,6,8,6,10,28,29,-1,30
AC Horsens,753,7,6,12,12,34,54,-20,30
AGF Aarhus,753,8,5,6,11,21,37,-16,21
Lyngby,753,9,4,9,11,27,44,-17,21
Randers FC,753,10,5,6,13,23,40,-17,21
Silkeborg IF,753,11,5,3,14,26,49,-23,18
Brondby,754,1,20,7,3,69,30,39,67
FC Midtjylla,754,2,20,5,5,67,39,28,65
FC Nords,754,3,14,7,9,75,52,23,49
Copenhagen,754,4,13,4,13,59,51,8,43
AaB,754,5,8,14,8,37,39,-2,38
AC Horsens,754,6,6,13,11,37,59,-22,31
Sonderjyske,754,7,8,6,10,28,29,-1,30
Randers FC,754,8,6,6,12,26,41,-15,24
AGF Aarhus,754,9,5,6,11,18,36,-18,21
Lyngby,754,10,3,9,12,28,47,-19,18
Silkeborg IF,754,11,5,3,14,25,46,-21,18
Brondby,755,1,21,7,2,69,30,39,70
FC Midtjylla,755,2,20,4,6,66,38,28,64
FC Nords,755,3,13,7,10,71,53,18,46
Copenhagen,755,4,13,5,12,55,45,10,44
AaB,755,5,9,12,9,38,40,-2,39
Sonderjyske,755,6,8,6,10,28,29,-1,30
AC Horsens,755,7,5,15,10,34,53,-19,30
Silkeborg IF,755,8,6,3,13,29,44,-15,21
Lyngby,755,9,4,9,11,28,44,-16,21
Randers FC,755,10,5,6,13,23,41,-18,21
AGF Aarhus,755,11,4,6,12,16,40,-24,18
Brondby,756,1,21,7,2,75,30,45,70
FC Midtjylla,756,2,20,5,5,64,37,27,65
FC Nords,756,3,15,6,9,73,51,22,51
Copenhagen,756,4,13,4,13,56,47,9,43
AaB,756,5,8,12,10,35,38,-3,36
Sonderjyske,756,6,8,6,10,28,29,-1,30
AC Horsens,756,7,6,12,12,36,62,-26,30
Lyngby,756,8,4,9,11,27,44,-17,21
Randers FC,756,9,5,6,13,23,40,-17,21
Silkeborg IF,756,10,6,3,13,26,44,-18,21
AGF Aarhus,756,11,4,6,12,16,37,-21,18
Brondby,757,1,22,6,2,72,28,44,72
FC Midtjylla,757,2,21,4,5,70,38,32,67
FC Nords,757,3,13,6,11,72,55,17,45
Copenhagen,757,4,12,4,14,51,51,0,40
AaB,757,5,9,11,10,37,41,-4,38
AC Horsens,757,6,7,13,10,33,48,-15,34
Sonderjyske,757,7,8,6,10,28,29,-1,30
Randers FC,757,8,6,6,12,26,41,-15,24
Silkeborg IF,757,9,6,3,13,27,44,-17,21
Lyngby,757,10,3,9,12,28,47,-19,18
AGF Aarhus,757,11,4,6,12,16,38,-22,18
Brondby,758,1,21,5,4,79,35,44,68
FC Midtjylla,758,2,19,5,6,65,39,26,62
FC Nords,758,3,15,7,8,76,52,24,52
Copenhagen,758,4,16,4,10,60,44,16,52
AC Horsens,758,5,7,12,11,35,53,-18,33
Sonderjyske,758,6,8,6,10,28,29,-1,30
AaB,758,7,6,11,13,33,51,-18,29
Lyngby,758,8,4,9,11,30,45,-15,21
Silkeborg IF,758,9,6,3,13,26,44,-18,21
Randers FC,758,10,5,6,13,24,43,-19,21
AGF Aarhus,758,11,4,6,12,16,37,-21,18
Brondby,759,1,21,6,3,68,29,39,69
FC Midtjylla,759,2,19,5,6,67,41,26,62
FC Nords,759,3,13,9,8,75,54,21,48
Copenhagen,759,4,14,5,11,61,45,16,47
AC Horsens,759,5,8,12,10,38,54,-16,36
AaB,759,6,6,13,11,38,50,-12,31
Sonderjyske,759,7,8,6,10,28,29,-1,30
Randers FC,759,8,5,7,12,24,40,-16,22
Silkeborg IF,759,9,6,3,13,27,44,-17,21
Lyngby,759,10,3,10,11,27,45,-18,19
AGF Aarhus,759,11,4,6,12,16,38,-22,18
Brondby,760,1,20,6,4,66,30,36,66
FC Midtjylla,760,2,20,6,4,66,38,28,66
FC Nords,760,3,13,8,9,74,54,20,47
Copenhagen,760,4,14,5,11,55,42,13,47
AaB,760,5,7,13,10,35,40,-5,34
AC Horsens,760,6,6,14,10,33,51,-18,32
Sonderjyske,760,7,8,6,10,28,29,-1,30
Randers FC,760,8,6,6,12,26,41,-15,24
AGF Aarhus,760,9,5,6,11,21,38,-17,21
Lyngby,760,10,3,9,12,28,47,-19,18
Silkeborg IF,760,11,5,3,14,27,49,-22,18
Brondby,761,1,21,5,4,76,36,40,68
FC Midtjylla,761,2,19,5,6,68,42,26,62
FC Nords,761,3,15,8,7,75,49,26,53
Copenhagen,761,4,14,4,12,60,45,15,46
AC Horsens,761,5,7,13,10,39,58,-19,34
AaB,761,6,6,13,11,33,47,-14,31
Sonderjyske,761,7,8,6,10,28,29,-1,30
Silkeborg IF,761,8,6,3,13,29,44,-15,21
Lyngby,761,9,4,9,11,29,45,-16,21
Randers FC,761,10,5,6,13,24,42,-18,21
AGF Aarhus,761,11,4,6,12,16,40,-24,18
Brondby,762,1,20,7,3,70,33,37,67
FC Midtjylla,762,2,21,4,5,68,38,30,67
Copenhagen,762,3,16,5,9,66,45,21,53
FC Nords,762,4,13,7,10,72,56,16,46
AaB,762,5,6,13,11,35,44,-9,31
Sonderjyske,762,6,8,6,10,28,29,-1,30
AC Horsens,762,7,6,12,12,35,56,-21,30
Lyngby,762,8,4,9,11,29,44,-15,21
Randers FC,762,9,5,6,13,23,42,-19,21
AGF Aarhus,762,10,5,6,11,17,36,-19,21
Silkeborg IF,762,11,5,3,14,25,45,-20,18
Brondby,763,1,21,6,3,72,32,40,69
FC Midtjylla,763,2,18,7,5,64,43,21,61
Copenhagen,763,3,14,5,11,58,44,14,47
FC Nords,763,4,12,9,9,76,58,18,45
AaB,763,5,9,11,10,37,39,-2,38
AC Horsens,763,6,6,14,10,35,52,-17,32
Sonderjyske,763,7,8,6,10,28,29,-1,30
Randers FC,763,8,6,6,12,24,39,-15,24
Silkeborg IF,763,9,6,3,13,29,46,-17,21
Lyngby,763,10,3,9,12,26,45,-19,18
AGF Aarhus,763,11,4,6,12,18,40,-22,18
Brondby,764,1,20,6,4,72,36,36,66
FC Midtjylla,764,2,20,4,6,68,43,25,64
FC Nords,764,3,15,7,8,83,53,30,52
Copenhagen,764,4,13,6,11,54,44,10,45
AC Horsens,764,5,7,13,10,37,57,-20,34
AaB,764,6,7,12,11,38,45,-7,33
Sonderjyske,764,7,8,6,10,28,29,-1,30
Randers FC,764,8,6,6,12,24,39,-15,24
AGF Aarhus,764,9,5,6,11,18,37,-19,21
Lyngby,764,10,3,9,12,26,45,-19,18
Silkeborg IF,764,11,5,3,14,26,46,-20,18
FC Midtjylla,765,1,20,5,5,68,35,33,65
Brondby,765,2,18,8,4,65,32,33,62
FC Nords,765,3,15,6,9,70,47,23,51
Copenhagen,765,4,14,5,11,56,45,11,47
AaB,765,5,8,13,9,36,43,-7,37
AC Horsens,765,6,6,13,11,34,53,-19,31
Sonderjyske,765,7,8,6,10,28,29,-1,30
Lyngby,765,8,4,9,11,29,45,-16,21
Randers FC,765,9,5,6,13,24,42,-18,21
AGF Aarhus,765,10,5,6,11,19,37,-18,21
Silkeborg IF,765,11,5,3,14,26,47,-21,18
Brondby,766,1,20,6,4,69,31,38,66
FC Midtjylla,766,2,19,5,6,68,41,27,62
FC Nords,766,3,15,8,7,76,52,24,53
Copenhagen,766,4,13,7,10,59,46,13,46
AaB,766,5,7,13,10,38,46,-8,34
AC Horsens,766,6,6,13,11,38,58,-20,31
Sonderjyske,766,7,8,6,10,28,29,-1,30
Randers FC,766,8,6,6,12,24,39,-15,24
Silkeborg IF,766,9,5,4,13,25,44,-19,19
AGF Aarhus,766,10,4,7,11,16,36,-20,19
Lyngby,766,11,3,9,12,26,45,-19,18
Brondby,767,1,21,7,2,69,29,40,70
FC Midtjylla,767,2,19,6,5,65,39,26,63
FC Nords,767,3,13,7,10,68,48,20,46
Copenhagen,767,4,13,5,12,57,47,10,44
AaB,767,5,7,14,9,35,39,-4,35
AC Horsens,767,6,6,15,9,36,54,-18,33
Sonderjyske,767,7,8,6,10,28,29,-1,30
Randers FC,767,8,5,7,12,23,39,-16,22
AGF Aarhus,767,9,5,6,11,17,36,-19,21
Lyngby,767,10,3,10,11,26,44,-18,19
Silkeborg IF,767,11,5,3,14,25,45,-20,18
Brondby,768,1,21,5,4,71,35,36,68
FC Midtjylla,768,2,18,5,7,64,41,23,59
FC Nords,768,3,14,7,9,75,56,19,49
Copenhagen,768,4,14,4,12,54,43,11,46
AaB,768,5,8,13,9,39,40,-1,37
AC Horsens,768,6,7,14,9,37,51,-14,35
Sonderjyske,768,7,8,6,10,28,29,-1,30
Randers FC,768,8,6,6,12,25,40,-15,24
AGF Aarhus,768,9,5,6,11,20,39,-19,21
Lyngby,768,10,3,9,12,27,46,-19,18
Silkeborg IF,768,11,5,3,14,28,48,-20,18
Brondby,769,1,21,6,3,67,30,37,69
FC Midtjylla,769,2,20,5,5,66,38,28,65
FC Nords,769,3,15,7,8,76,51,25,52
Copenhagen,769,4,12,6,12,55,47,8,42
AaB,769,5,8,12,10,39,45,-6,36
Sonderjyske,769,6,8,6,10,28,29,-1,30
AC Horsens,769,7,6,12,12,36,54,-18,30
Lyngby,769,8,4,9,11,28,44,-16,21
Silkeborg IF,769,9,6,3,13,28,45,-17,21
Randers FC,769,10,5,6,13,23,41,-18,21
AGF Aarhus,769,11,4,6,12,17,39,-22,18
Brondby,770,1,21,6,3,67,31,36,69
FC Midtjylla,770,2,21,4,5,62,35,27,67
FC Nords,770,3,15,7,8,79,50,29,52
Copenhagen,770,4,14,4,12,56,45,11,46
AC Horsens,770,5,6,13,11,34,54,-20,31
Sonderjyske,770,6,8,6,10,28,29,-1,30
AaB,770,7,6,12,12,33,42,-9,30
Lyngby,770,8,4,9,11,31,45,-14,21
Randers FC,770,9,5,6,13,24,44,-20,21
Silkeborg IF,770,10,5,4,13,26,45,-19,19
AGF Aarhus,770,11,4,7,11,17,37,-20,19
Brondby,771,1,20,6,4,69,35,34,66
FC Midtjylla,771,2,19,5,6,68,39,29,62
Copenhagen,771,3,16,5,9,61,43,18,53
FC Nords,771,4,14,7,9,75,53,22,49
AaB,771,5,7,12,11,38,50,-12,33
AC Horsens,771,6,6,13,11,35,52,-17,31
Sonderjyske,771,7,8,6,10,28,29,-1,30
Lyngby,771,8,4,9,11,28,45,-17,21
Randers FC,771,9,5,6,13,24,41,-17,21
AGF Aarhus,771,10,5,6,11,17,36,-19,21
Silkeborg IF,771,11,5,3,14,25,45,-20,18
Brondby,772,1,20,8,2,73,31,42,68
FC Midtjylla,772,2,21,5,4,70,36,34,68
Copenhagen,772,3,14,6,10,57,42,15,48
FC Nords,772,4,12,8,10,73,58,15,44
AaB,772,5,7,12,11,37,47,-10,33
Sonderjyske,772,6,8,6,10,28,29,-1,30
AC Horsens,772,7,5,15,10,34,56,-22,30
Lyngby,772,8,4,9,11,27,44,-17,21
Randers FC,772,9,5,6,13,23,40,-17,21
AGF Aarhus,772,10,5,6,11,17,36,-19,21
Silkeborg IF,772,11,5,3,14,25,45,-20,18
Brondby,773,1,21,5,4,69,33,36,68
FC Midtjylla,773,2,21,5,4,67,35,32,68
FC Nords,773,3,14,7,9,73,50,23,49
Copenhagen,773,4,13,6,11,56,47,9,45
AaB,773,5,7,12,11,35,41,-6,33
AC Horsens,773,6,6,13,11,37,57,-20,31
Sonderjyske,773,7,8,6,10,28,29,-1,30
Lyngby,773,8,4,9,11,27,44,-17,21
Randers FC,773,9,5,6,13,23,40,-17,21
Silkeborg IF,773,10,5,4,13,25,44,-19,19
AGF Aarhus,773,11,4,7,11,16,36,-20,19
Brondby,774,1,20,6,4,69,33,36,66
FC Midtjylla,774,2,20,4,6,67,38,29,64
FC Nords,774,3,16,6,8,81,49,32,54
Copenhagen,774,4,15,5,10,62,45,17,50
AaB,774,5,6,13,11,34,48,-14,31
Sonderjyske,774,6,8,6,10,28,29,-1,30
AC Horsens,774,7,5,14,11,30,56,-26,29
Randers FC,774,8,6,6,12,25,39,-14,24
Silkeborg IF,774,9,6,3,13,31,45,-14,21
Lyngby,774,10,3,9,12,26,46,-20,18
AGF Aarhus,774,11,4,6,12,17,42,-25,18
Brondby,775,1,22,5,3,76,32,44,71
FC Midtjylla,775,2,20,5,5,64,37,27,65
FC Nords,775,3,16,7,7,77,48,29,55
Copenhagen,775,4,12,4,14,51,49,2,40
AC Horsens,775,5,7,12,11,32,52,-20,33
AaB,775,6,7,11,12,35,43,-8,32
Sonderjyske,775,7,8,6,10,28,29,-1,30
Lyngby,775,8,4,9,11,29,44,-15,21
Randers FC,775,9,5,6,13,23,42,-19,21
Silkeborg IF,775,10,5,4,13,26,45,-19,19
AGF Aarhus,775,11,4,7,11,17,37,-20,19
Brondby,776,1,22,5,3,79,34,45,71
FC Midtjylla,776,2,20,5,5,66,39,27,65
Copenhagen,776,3,14,7,9,57,41,16,49
FC Nords,776,4,13,8,9,74,54,20,47
AaB,776,5,7,12,11,35,46,-11,33
Sonderjyske,776,6,8,6,10,28,29,-1,30
AC Horsens,776,7,5,13,12,34,57,-23,28
Lyngby,776,8,4,9,11,27,44,-17,21
Randers FC,776,9,5,6,13,23,40,-17,21
Silkeborg IF,776,10,5,4,13,28,47,-19,19
AGF Aarhus,776,11,4,7,11,19,39,-20,19
Brondby,777,1,23,5,2,75,31,44,74
FC Midtjylla,777,2,19,5,6,66,45,21,62
FC Nords,777,3,14,7,9,76,53,23,49
Copenhagen,777,4,15,4,11,58,46,12,49
AaB,777,5,7,11,12,37,45,-8,32
Sonderjyske,777,6,8,6,10,28,29,-1,30
AC Horsens,777,7,6,12,12,33,51,-18,30
Lyngby,777,8,4,9,11,28,45,-17,21
Randers FC,777,9,5,6,13,24,41,-17,21
Silkeborg IF,777,10,5,4,13,26,45,-19,19
AGF Aarhus,777,11,4,7,11,17,37,-20,19
Brondby,778,1,22,5,3,76,29,47,71
FC Midtjylla,778,2,20,4,6,68,43,25,64
FC Nords,778,3,15,6,9,79,51,28,51
Copenhagen,778,4,13,4,13,54,50,4,43
AaB,778,5,8,11,11,36,43,-7,35
AC Horsens,778,6,7,12,11,37,60,-23,33
Sonderjyske,778,7,8,6,10,28,29,-1,30
Lyngby,778,8,4,9,11,28,45,-17,21
Randers FC,778,9,5,6,13,24,41,-17,21
Silkeborg IF,778,10,6,3,13,27,45,-18,21
AGF Aarhus,778,11,4,6,12,17,38,-21,18
Brondby,779,1,21,7,2,75,34,41,70
FC Midtjylla,779,2,17,8,5,64,42,22,59
FC Nords,779,3,14,9,7,74,47,27,51
Copenhagen,779,4,12,7,11,58,49,9,43
AaB,779,5,7,14,9,34,39,-5,35
Sonderjyske,779,6,8,6,10,28,29,-1,30
AC Horsens,779,7,5,15,10,37,57,-20,30
Randers FC,779,8,5,7,12,24,40,-16,22
Silkeborg IF,779,9,6,3,13,28,46,-18,21
Lyngby,779,10,3,10,11,27,45,-18,19
AGF Aarhus,779,11,4,6,12,18,39,-21,18
Brondby,780,1,19,8,3,69,32,37,65
FC Midtjylla,780,2,19,5,6,69,44,25,62
FC Nords,780,3,15,8,7,74,48,26,53
Copenhagen,780,4,13,7,10,60,47,13,46
AC Horsens,780,5,8,13,9,35,49,-14,37
Sonderjyske,780,6,8,6,10,28,29,-1,30
AaB,780,7,6,11,13,33,46,-13,29
Randers FC,780,8,5,7,12,23,39,-16,22
Lyngby,780,9,3,10,11,26,44,-18,19
Silkeborg IF,780,10,5,4,13,28,47,-19,19
AGF Aarhus,780,11,4,7,11,19,39,-20,19
Brondby,781,1,21,6,3,75,32,43,69
FC Midtjylla,781,2,18,6,6,65,46,19,60
FC Nords,781,3,16,7,7,72,45,27,55
Copenhagen,781,4,12,7,11,54,45,9,43
AC Horsens,781,5,7,12,11,38,55,-17,33
AaB,781,6,6,14,10,33,40,-7,32
Sonderjyske,781,7,8,6,10,28,29,-1,30
Lyngby,781,8,4,9,11,28,44,-16,21
Silkeborg IF,781,9,6,3,13,28,46,-18,21
Randers FC,781,10,5,6,13,23,41,-18,21
AGF Aarhus,781,11,4,6,12,18,39,-21,18
Brondby,782,1,22,5,3,72,29,43,71
FC Midtjylla,782,2,18,7,5,63,39,24,61
FC Nords,782,3,13,7,10,67,53,14,46
Copenhagen,782,4,13,6,11,56,44,12,45
AaB,782,5,8,13,9,40,45,-5,37
AC Horsens,782,6,7,12,11,36,50,-14,33
Sonderjyske,782,7,8,6,10,28,29,-1,30
Lyngby,782,8,4,9,11,29,44,-15,21
Silkeborg IF,782,9,6,3,13,29,45,-16,21
Randers FC,782,10,5,6,13,23,42,-19,21
AGF Aarhus,782,11,4,6,12,17,40,-23,18
Brondby,783,1,22,5,3,73,30,43,71
FC Midtjylla,783,2,19,5,6,61,38,23,62
FC Nords,783,3,16,6,8,77,49,28,54
Copenhagen,783,4,13,5,12,57,48,9,44
AC Horsens,783,5,6,14,10,36,54,-18,32
AaB,783,6,6,13,11,36,47,-11,31
Sonderjyske,783,7,8,6,10,28,29,-1,30
Randers FC,783,8,6,6,12,26,39,-13,24
Silkeborg IF,783,9,5,4,13,28,47,-19,19
AGF Aarhus,783,10,4,7,11,19,39,-20,19
Lyngby,783,11,3,9,12,26,47,-21,18
Brondby,784,1,21,5,4,73,37,36,68
FC Midtjylla,784,2,21,4,5,70,38,32,67
Copenhagen,784,3,15,4,11,63,49,14,49
FC Nords,784,4,13,8,9,74,54,20,47
AC Horsens,784,5,7,13,10,38,53,-15,34
Sonderjyske,784,6,8,6,10,28,29,-1,30
AaB,784,7,6,12,12,37,50,-13,30
Randers FC,784,8,5,7,12,24,40,-16,22
AGF Aarhus,784,9,5,6,11,18,37,-19,21
Lyngby,784,10,3,10,11,27,45,-18,19
Silkeborg IF,784,11,5,3,14,26,46,-20,18
Brondby,785,1,21,7,2,74,35,39,70
FC Midtjylla,785,2,20,6,4,70,42,28,66
FC Nords,785,3,14,7,9,74,52,22,49
Copenhagen,785,4,14,5,11,58,44,14,47
AC Horsens,785,5,6,13,11,33,51,-18,31
Sonderjyske,785,6,8,6,10,28,29,-1,30
AaB,785,7,6,12,12,34,45,-11,30
Lyngby,785,8,4,9,11,29,45,-16,21
Randers FC,785,9,5,6,13,24,42,-18,21
Silkeborg IF,785,10,5,4,13,26,45,-19,19
AGF Aarhus,785,11,4,7,11,17,37,-20,19
Brondby,786,1,20,6,4,70,34,36,66
FC Midtjylla,786,2,20,6,4,67,37,30,66
FC Nords,786,3,15,8,7,75,48,27,53
Copenhagen,786,4,13,5,12,57,46,11,44
AaB,786,5,7,12,11,35,45,-10,33
AC Horsens,786,6,6,13,11,34,54,-20,31
Sonderjyske,786,7,8,6,10,28,29,-1,30
Randers FC,786,8,6,6,12,27,40,-13,24
Silkeborg IF,786,9,6,3,13,27,44,-17,21
Lyngby,786,10,3,9,12,27,48,-21,18
AGF Aarhus,786,11,4,6,12,16,38,-22,18
Brondby,787,1,22,5,3,75,32,43,71
FC Midtjylla,787,2,19,5,6,66,44,22,62
FC Nords,787,3,15,6,9,79,54,25,51
Copenhagen,787,4,14,5,11,57,46,11,47
AC Horsens,787,5,7,12,11,40,55,-15,33
AaB,787,6,7,11,12,35,47,-12,32
Sonderjyske,787,7,8,6,10,28,29,-1,30
Randers FC,787,8,6,6,12,25,40,-15,24
Silkeborg IF,787,9,5,4,13,28,47,-19,19
AGF Aarhus,787,10,4,7,11,19,39,-20,19
Lyngby,787,11,3,9,12,27,46,-19,18
Brondby,788,1,20,7,3,70,31,39,67
FC Midtjylla,788,2,20,5,5,67,40,27,65
FC Nords,788,3,15,7,8,76,51,25,52
Copenhagen,788,4,14,4,12,56,46,10,46
AaB,788,5,7,13,10,35,40,-5,34
Sonderjyske,788,6,8,6,10,28,29,-1,30
AC Horsens,788,7,5,14,11,36,58,-22,29
Randers FC,788,8,6,6,12,25,40,-15,24
AGF Aarhus,788,9,5,6,11,18,37,-19,21
Lyngby,788,10,3,9,12,27,46,-19,18
Silkeborg IF,788,11,5,3,14,26,46,-20,18
Brondby,789,1,21,6,3,74,31,43,69
FC Midtjylla,789,2,20,5,5,66,35,31,65
FC Nords,789,3,14,7,9,73,56,17,49
Copenhagen,789,4,14,4,12,58,44,14,46
AaB,789,5,9,11,10,37,40,-3,38
Sonderjyske,789,6,8,6,10,28,29,-1,30
AC Horsens,789,7,5,13,12,32,60,-28,28
Lyngby,789,8,4,9,11,29,45,-16,21
Randers FC,789,9,5,6,13,24,42,-18,21
AGF Aarhus,789,10,5,6,11,18,37,-19,21
Silkeborg IF,789,11,5,3,14,26,46,-20,18
Brondby,790,1,20,6,4,69,32,37,66
FC Midtjylla,790,2,20,6,4,68,38,30,66
Copenhagen,790,3,14,7,9,58,42,16,49
FC Nords,790,4,13,9,8,69,50,19,48
AC Horsens,790,5,6,14,10,37,55,-18,32
Sonderjyske,790,6,8,6,10,28,29,-1,30
AaB,790,7,6,12,12,33,43,-10,30
Randers FC,790,8,5,7,12,24,40,-16,22
Silkeborg IF,790,9,6,3,13,26,44,-18,21
Lyngby,790,10,3,10,11,27,45,-18,19
AGF Aarhus,790,11,4,6,12,16,37,-21,18
Brondby,791,1,22,5,3,74,31,43,71
FC Midtjylla,791,2,19,5,6,64,41,23,62
Copenhagen,791,3,15,5,10,60,42,18,50
FC Nords,791,4,13,9,8,72,48,24,48
AaB,791,5,7,13,10,35,44,-9,34
Sonderjyske,791,6,8,6,10,28,29,-1,30
AC Horsens,791,7,5,13,12,33,58,-25,28
Randers FC,791,8,6,6,12,25,40,-15,24
Silkeborg IF,791,9,5,4,13,25,44,-19,19
AGF Aarhus,791,10,4,7,11,16,36,-20,19
Lyngby,791,11,3,9,12,27,46,-19,18
Brondby,792,1,22,5,3,69,31,38,71
FC Midtjylla,792,2,20,4,6,65,45,20,64
Copenhagen,792,3,15,4,11,66,47,19,49
FC Nords,792,4,14,6,10,74,57,17,48
AaB,792,5,8,11,11,39,42,-3,35
Sonderjyske,792,6,8,6,10,28,29,-1,30
AC Horsens,792,7,6,12,12,37,54,-17,30
Lyngby,792,8,4,9,11,29,44,-15,21
Randers FC,792,9,5,6,13,23,42,-19,21
AGF Aarhus,792,10,5,6,11,19,38,-19,21
Silkeborg IF,792,11,5,3,14,27,47,-20,18
Brondby,793,1,21,7,2,75,34,41,70
FC Midtjylla,793,2,19,6,5,66,39,27,63
FC Nords,793,3,13,9,8,72,52,20,48
Copenhagen,793,4,13,4,13,56,48,8,43
AC Horsens,793,5,7,14,9,33,49,-16,35
AaB,793,6,7,12,11,35,41,-6,33
Sonderjyske,793,7,8,6,10,28,29,-1,30
Randers FC,793,8,5,7,12,25,41,-16,22
Silkeborg IF,793,9,6,3,13,28,45,-17,21
Lyngby,793,10,3,10,11,28,46,-18,19
AGF Aarhus,793,11,4,6,12,17,39,-22,18
Brondby,794,1,21,5,4,73,31,42,68
FC Midtjylla,794,2,19,5,6,65,42,23,62
FC Nords,794,3,13,8,9,71,55,16,47
Copenhagen,794,4,14,4,12,56,44,12,46
AaB,794,5,9,12,9,39,41,-2,39
AC Horsens,794,6,6,14,10,36,53,-17,32
Sonderjyske,794,7,8,6,10,28,29,-1,30
Lyngby,794,8,4,9,11,28,44,-16,21
Randers FC,794,9,5,6,13,23,41,-18,21
Silkeborg IF,794,10,5,4,13,27,46,-19,19
AGF Aarhus,794,11,4,7,11,18,38,-20,19
Brondby,795,1,20,6,4,66,32,34,66
FC Midtjylla,795,2,20,5,5,71,37,34,65
Copenhagen,795,3,15,4,11,60,47,13,49
FC Nords,795,4,13,8,9,71,56,15,47
AaB,795,5,8,13,9,39,40,-1,37
Sonderjyske,795,6,8,6,10,28,29,-1,30
AC Horsens,795,7,5,14,11,32,53,-21,29
Randers FC,795,8,6,6,12,25,40,-15,24
Silkeborg IF,795,9,5,4,13,26,45,-19,19
AGF Aarhus,795,10,4,7,11,17,37,-20,19
Lyngby,795,11,3,9,12,27,46,-19,18
Brondby,796,1,20,7,3,70,31,39,67
FC Midtjylla,796,2,19,7,4,68,42,26,64
FC Nords,796,3,14,8,8,75,51,24,50
Copenhagen,796,4,12,6,12,56,48,8,42
AaB,796,5,7,13,10,39,46,-7,34
AC Horsens,796,6,6,15,9,37,53,-16,33
Sonderjyske,796,7,8,6,10,28,29,-1,30
Randers FC,796,8,6,6,12,25,40,-15,24
Silkeborg IF,796,9,6,3,13,29,47,-18,21
Lyngby,796,10,3,9,12,27,46,-19,18
AGF Aarhus,796,11,4,6,12,19,40,-21,18
Brondby,797,1,22,5,3,74,31,43,71
FC Midtjylla,797,2,20,5,5,69,43,26,65
FC Nords,797,3,14,8,8,78,53,25,50
Copenhagen,797,4,12,6,12,53,45,8,42
AC Horsens,797,5,7,13,10,35,56,-21,34
AaB,797,6,6,13,11,34,41,-7,31
Sonderjyske,797,7,8,6,10,28,29,-1,30
Lyngby,797,8,4,9,11,29,44,-15,21
Silkeborg IF,797,9,6,3,13,27,45,-18,21
Randers FC,797,10,5,6,13,23,42,-19,21
AGF Aarhus,797,11,4,6,12,17,38,-21,18
Brondby,798,1,20,7,3,75,34,41,67
FC Midtjylla,798,2,20,5,5,68,40,28,65
FC Nords,798,3,15,7,8,75,52,23,52
Copenhagen,798,4,13,7,10,57,44,13,46
AaB,798,5,7,12,11,35,46,-11,33
Sonderjyske,798,6,8,6,10,28,29,-1,30
AC Horsens,798,7,6,12,12,37,57,-20,30
Lyngby,798,8,4,9,11,27,44,-17,21
Randers FC,798,9,5,6,13,23,40,-17,21
Silkeborg IF,798,10,5,4,13,25,44,-19,19
AGF Aarhus,798,11,4,7,11,16,36,-20,19
Brondby,799,1,23,5,2,77,27,50,74
FC Midtjylla,799,2,19,5,6,66,42,24,62
FC Nords,799,3,14,6,10,72,50,22,48
Copenhagen,799,4,13,7,10,56,44,12,46
AaB,799,5,7,12,11,38,50,-12,33
AC Horsens,799,6,6,13,11,32,54,-22,31
Sonderjyske,799,7,8,6,10,28,29,-1,30
Lyngby,799,8,4,9,11,30,45,-15,21
Randers FC,799,9,5,6,13,24,43,-19,21
Silkeborg IF,799,10,5,4,13,27,46,-19,19
AGF Aarhus,799,11,4,7,11,18,38,-20,19
Brondby,800,1,21,5,4,70,35,35,68
FC Midtjylla,800,2,20,4,6,70,40,30,64
FC Nords,800,3,15,6,9,74,57,17,51
Copenhagen,800,4,14,6,10,59,44,15,48
AaB,800,5,7,12,11,35,41,-6,33
AC Horsens,800,6,6,13,11,38,55,-17,31
Sonderjyske,800,7,8,6,10,28,29,-1,30
Randers FC,800,8,5,7,12,23,39,-16,22
Silkeborg IF,800,9,6,3,13,28,44,-16,21
Lyngby,800,10,3,10,11,26,44,-18,19
AGF Aarhus,800,11,4,6,12,16,39,-23,18
Brondby,801,1,22,6,2,73,33,40,72
FC Midtjylla,801,2,18,4,8,58,38,20,58
FC Nords,801,3,15,6,9,73,51,22,51
Copenhagen,801,4,14,4,12,59,46,13,46
AC Horsens,801,5,7,14,9,35,49,-14,35
AaB,801,6,7,12,11,33,40,-7,33
Sonderjyske,801,7,8,6,10,28,29,-1,30
Randers FC,801,8,6,6,12,24,39,-15,24
Silkeborg IF,801,9,6,3,13,28,46,-18,21
Lyngby,801,10,3,9,12,26,45,-19,18
AGF Aarhus,801,11,4,6,12,18,39,-21,18
Brondby,802,1,22,6,2,75,31,44,72
FC Midtjylla,802,2,20,4,6,64,36,28,64
Copenhagen,802,3,14,5,11,58,46,12,47
FC Nords,802,4,13,6,11,72,56,16,45
AC Horsens,802,5,7,13,10,38,51,-13,34
AaB,802,6,7,12,11,34,47,-13,33
Sonderjyske,802,7,8,6,10,28,29,-1,30
Randers FC,802,8,5,7,12,24,40,-16,22
Silkeborg IF,802,9,6,3,13,28,45,-17,21
Lyngby,802,10,3,10,11,27,45,-18,19
AGF Aarhus,802,11,4,6,12,17,39,-22,18
Brondby,803,1,20,5,5,69,37,32,65
FC Midtjylla,803,2,20,4,6,63,39,24,64
Copenhagen,803,3,16,4,10,58,41,17,52
FC Nords,803,4,14,7,9,74,54,20,49
AaB,803,5,8,11,11,38,40,-2,35
AC Horsens,803,6,6,13,11,36,53,-17,31
Sonderjyske,803,7,8,6,10,28,29,-1,30
Randers FC,803,8,6,6,12,24,39,-15,24
Silkeborg IF,803,9,5,4,13,25,44,-19,19
AGF Aarhus,803,10,4,7,11,16,36,-20,19
Lyngby,803,11,3,9,12,26,45,-19,18
Brondby,804,1,22,6,2,76,31,45,72
FC Midtjylla,804,2,20,5,5,69,38,31,65
FC Nords,804,3,15,6,9,74,55,19,51
Copenhagen,804,4,14,4,12,62,49,13,46
AC Horsens,804,5,6,13,11,38,55,-17,31
Sonderjyske,804,6,8,6,10,28,29,-1,30
AaB,804,7,6,12,12,35,52,-17,30
Lyngby,804,8,4,9,11,29,44,-15,21
Randers FC,804,9,5,6,13,23,42,-19,21
Silkeborg IF,804,10,5,4,13,26,45,-19,19
AGF Aarhus,804,11,4,7,11,17,37,-20,19
Brondby,805,1,19,8,3,69,33,36,65
FC Midtjylla,805,2,19,5,6,64,39,25,62
FC Nords,805,3,13,9,8,71,50,21,48
Copenhagen,805,4,13,7,10,56,43,13,46
AC Horsens,805,5,8,12,10,37,51,-14,36
AaB,805,6,6,15,9,37,44,-7,33
Sonderjyske,805,7,8,6,10,28,29,-1,30
Randers FC,805,8,6,6,12,25,39,-14,24
AGF Aarhus,805,9,5,6,11,19,37,-18,21
Lyngby,805,10,3,9,12,26,46,-20,18
Silkeborg IF,805,11,5,3,14,26,47,-21,18
Brondby,806,1,19,7,4,72,38,34,64
FC Midtjylla,806,2,19,7,4,66,38,28,64
FC Nords,806,3,14,7,9,75,54,21,49
Copenhagen,806,4,14,6,10,61,45,16,48
AaB,806,5,8,13,9,39,43,-4,37
Sonderjyske,806,6,8,6,10,28,29,-1,30
AC Horsens,806,7,5,14,11,31,52,-21,29
Lyngby,806,8,4,9,11,29,44,-15,21
AGF Aarhus,806,9,5,6,11,19,37,-18,21
Randers FC,806,10,5,6,13,23,42,-19,21
Silkeborg IF,806,11,5,3,14,26,47,-21,18
Brondby,807,1,21,7,2,75,33,42,70
FC Midtjylla,807,2,19,4,7,61,40,21,61
FC Nords,807,3,16,7,7,81,51,30,55
Copenhagen,807,4,13,5,12,58,47,11,44
AaB,807,5,8,11,11,37,46,-9,35
Sonderjyske,807,6,8,6,10,28,29,-1,30
AC Horsens,807,7,5,14,11,34,55,-21,29
Lyngby,807,8,4,9,11,28,44,-16,21
Silkeborg IF,807,9,6,3,13,27,44,-17,21
Randers FC,807,10,5,6,13,23,41,-18,21
AGF Aarhus,807,11,4,6,12,16,38,-22,18
Brondby,808,1,20,5,5,71,34,37,65
FC Midtjylla,808,2,20,5,5,66,38,28,65
FC Nords,808,3,14,7,9,71,51,20,49
Copenhagen,808,4,12,7,11,58,48,10,43
AaB,808,5,9,11,10,37,44,-7,38
AC Horsens,808,6,7,13,10,37,51,-14,34
Sonderjyske,808,7,8,6,10,28,29,-1,30
Randers FC,808,8,5,7,12,23,39,-16,22
AGF Aarhus,808,9,5,6,11,17,36,-19,21
Lyngby,808,10,3,10,11,26,44,-18,19
Silkeborg IF,808,11,5,3,14,25,45,-20,18
FC Midtjylla,809,1,22,4,4,68,35,33,70
Brondby,809,2,21,6,3,71,31,40,69
FC Nords,809,3,14,6,10,77,57,20,48
Copenhagen,809,4,13,5,12,56,45,11,44
AaB,809,5,6,14,10,36,43,-7,32
AC Horsens,809,6,6,13,11,32,55,-23,31
Sonderjyske,809,7,8,6,10,28,29,-1,30
Randers FC,809,8,6,6,12,27,41,-14,24
Silkeborg IF,809,9,6,3,13,30,47,-17,21
Lyngby,809,10,3,9,12,28,48,-20,18
AGF Aarhus,809,11,4,6,12,19,41,-22,18
Brondby,810,1,19,6,5,68,35,33,63
FC Midtjylla,810,2,19,5,6,64,41,23,62
Copenhagen,810,3,15,5,10,59,41,18,50
FC Nords,810,4,13,7,10,73,56,17,46
AC Horsens,810,5,8,13,9,36,49,-13,37
AaB,810,6,7,14,9,38,42,-4,35
Sonderjyske,810,7,8,6,10,28,29,-1,30
Lyngby,810,8,4,9,11,27,44,-17,21
Randers FC,810,9,5,6,13,23,40,-17,21
Silkeborg IF,810,10,6,3,13,26,44,-18,21
AGF Aarhus,810,11,4,6,12,16,37,-21,18
Brondby,811,1,20,8,2,69,30,39,68
FC Midtjylla,811,2,18,5,7,63,41,22,59
FC Nords,811,3,16,7,7,74,46,28,55
Copenhagen,811,4,12,7,11,56,45,11,43
AC Horsens,811,5,7,13,10,34,53,-19,34
AaB,811,6,7,12,11,35,42,-7,33
Sonderjyske,811,7,8,6,10,28,29,-1,30
Lyngby,811,8,4,9,11,28,45,-17,21
Randers FC,811,9,5,6,13,24,41,-17,21
Silkeborg IF,811,10,6,3,13,27,45,-18,21
AGF Aarhus,811,11,4,6,12,17,38,-21,18
Brondby,812,1,22,5,3,75,32,43,71
FC Midtjylla,812,2,21,4,5,70,40,30,67
FC Nords,812,3,14,7,9,70,50,20,49
Copenhagen,812,4,13,5,12,56,46,10,44
AC Horsens,812,5,7,12,11,31,51,-20,33
AaB,812,6,7,11,12,36,45,-9,32
Sonderjyske,812,7,8,6,10,28,29,-1,30
Randers FC,812,8,5,7,12,24,40,-16,22
Lyngby,812,9,3,10,11,27,45,-18,19
Silkeborg IF,812,10,5,4,13,25,44,-19,19
AGF Aarhus,812,11,4,7,11,16,36,-20,19
Brondby,813,1,22,6,2,72,29,43,72
FC Midtjylla,813,2,19,5,6,62,39,23,62
FC Nords,813,3,14,8,8,75,50,25,50
Copenhagen,813,4,14,5,11,56,43,13,47
AaB,813,5,7,12,11,37,45,-8,33
Sonderjyske,813,6,8,6,10,28,29,-1,30
AC Horsens,813,7,5,14,11,32,54,-22,29
Lyngby,813,8,4,9,11,27,44,-17,21
Randers FC,813,9,5,6,13,23,40,-17,21
Silkeborg IF,813,10,5,4,13,27,46,-19,19
AGF Aarhus,813,11,4,7,11,18,38,-20,19
Brondby,814,1,23,5,2,81,31,50,74
FC Midtjylla,814,2,18,4,8,63,43,20,58
FC Nords,814,3,14,7,9,75,57,18,49
Copenhagen,814,4,13,5,12,56,50,6,44
AaB,814,5,9,11,10,42,43,-1,38
AC Horsens,814,6,7,12,11,35,54,-19,33
Sonderjyske,814,7,8,6,10,28,29,-1,30
Randers FC,814,8,6,6,12,26,39,-13,24
Silkeborg IF,814,9,6,3,13,27,44,-17,21
Lyngby,814,10,3,9,12,26,47,-21,18
AGF Aarhus,814,11,4,6,12,16,38,-22,18
Brondby,815,1,21,6,3,69,30,39,69
FC Midtjylla,815,2,19,5,6,65,40,25,62
FC Nords,815,3,14,7,9,74,53,21,49
Copenhagen,815,4,13,6,11,55,44,11,45
AaB,815,5,8,13,9,40,43,-3,37
AC Horsens,815,6,6,13,11,33,52,-19,31
Sonderjyske,815,7,8,6,10,28,29,-1,30
Lyngby,815,8,4,9,11,27,44,-17,21
Randers FC,815,9,5,6,13,23,40,-17,21
AGF Aarhus,815,10,5,6,11,18,36,-18,21
Silkeborg IF,815,11,5,3,14,25,46,-21,18
Brondby,816,1,20,6,4,66,34,32,66
FC Midtjylla,816,2,19,5,6,69,41,28,62
FC Nords,816,3,15,7,8,75,51,24,52
Copenhagen,816,4,14,5,11,58,44,14,47
AaB,816,5,7,13,10,39,46,-7,34
AC Horsens,816,6,6,14,10,35,52,-17,32
Sonderjyske,816,7,8,6,10,28,29,-1,30
Lyngby,816,8,4,9,11,30,47,-17,21
Randers FC,816,9,5,6,13,26,43,-17,21
Silkeborg IF,816,10,6,3,13,27,45,-18,21
AGF Aarhus,816,11,4,6,12,17,38,-21,18
Brondby,817,1,21,7,2,71,27,44,70
FC Midtjylla,817,2,20,5,5,67,41,26,65
FC Nords,817,3,13,7,10,73,58,15,46
Copenhagen,817,4,13,5,12,57,47,10,44
AaB,817,5,8,12,10,36,41,-5,36
AC Horsens,817,6,5,16,9,37,53,-16,31
Sonderjyske,817,7,8,6,10,28,29,-1,30
Randers FC,817,8,6,6,12,25,39,-14,24
Silkeborg IF,817,9,6,3,13,26,44,-18,21
Lyngby,817,10,3,9,12,26,46,-20,18
AGF Aarhus,817,11,4,6,12,16,37,-21,18
Brondby,818,1,21,5,4,71,33,38,68
FC Midtjylla,818,2,19,4,7,64,40,24,61
FC Nords,818,3,14,8,8,72,48,24,50
Copenhagen,818,4,14,6,10,58,44,14,48
AC Horsens,818,5,7,14,9,36,48,-12,35
AaB,818,6,6,13,11,34,48,-14,31
Sonderjyske,818,7,8,6,10,28,29,-1,30
Randers FC,818,8,5,7,12,23,39,-16,22
Silkeborg IF,818,9,6,3,13,27,44,-17,21
Lyngby,818,10,3,10,11,26,44,-18,19
AGF Aarhus,818,11,4,6,12,16,38,-22,18
Brondby,819,1,19,7,4,67,37,30,64
FC Midtjylla,819,2,19,4,7,65,41,24,61
Copenhagen,819,3,16,5,9,64,43,21,53
FC Nords,819,4,15,7,8,74,50,24,52
AaB,819,5,7,14,9,36,40,-4,35
Sonderjyske,819,6,8,6,10,28,29,-1,30
AC Horsens,819,7,5,13,12,36,57,-21,28
Randers FC,819,8,5,7,12,26,42,-16,22
AGF Aarhus,819,9,5,6,11,19,36,-17,21
Lyngby,819,10,3,10,11,29,47,-18,19
Silkeborg IF,819,11,5,3,14,25,47,-22,18
Brondby,820,1,21,6,3,73,33,40,69
FC Midtjylla,820,2,19,6,5,66,41,25,63
FC Nords,820,3,15,6,9,74,53,21,51
Copenhagen,820,4,14,5,11,62,50,12,47
AaB,820,5,7,12,11,39,45,-6,33
Sonderjyske,820,6,8,6,10,28,29,-1,30
AC Horsens,820,7,5,15,10,36,54,-18,30
Lyngby,820,8,4,9,11,29,44,-15,21
Silkeborg IF,820,9,6,3,13,27,44,-17,21
Randers FC,820,10,5,6,13,23,42,-19,21
AGF Aarhus,820,11,4,6,12,16,38,-22,18
Brondby,821,1,22,5,3,72,34,38,71
FC Midtjylla,821,2,18,6,6,63,41,22,60
FC Nords,821,3,13,7,10,72,51,21,46
Copenhagen,821,4,13,7,10,58,45,13,46
AaB,821,5,8,14,8,41,41,0,38
Sonderjyske,821,6,8,6,10,28,29,-1,30
AC Horsens,821,7,5,15,10,35,55,-20,30
Lyngby,821,8,4,9,11,31,46,-15,21
Silkeborg IF,821,9,6,3,13,28,45,-17,21
Randers FC,821,10,5,6,13,25,44,-19,21
AGF Aarhus,821,11,4,6,12,17,39,-22,18
Brondby,822,1,21,7,2,72,32,40,70
FC Midtjylla,822,2,18,4,8,63,45,18,58
FC Nords,822,3,15,7,8,80,54,26,52
Copenhagen,822,4,13,4,13,57,47,10,43
AaB,822,5,10,11,9,42,40,2,41
AC Horsens,822,6,6,13,11,32,54,-22,31
Sonderjyske,822,7,8,6,10,28,29,-1,30
Randers FC,822,8,5,7,12,24,40,-16,22
AGF Aarhus,822,9,5,6,11,17,36,-19,21
Lyngby,822,10,3,10,11,27,45,-18,19
Silkeborg IF,822,11,5,3,14,25,45,-20,18
Brondby,823,1,22,5,3,72,32,40,71
FC Midtjylla,823,2,19,6,5,65,39,26,63
FC Nords,823,3,15,7,8,77,48,29,52
Copenhagen,823,4,14,5,11,57,44,13,47
AaB,823,5,6,14,10,36,44,-8,32
Sonderjyske,823,6,8,6,10,28,29,-1,30
AC Horsens,823,7,5,13,12,34,60,-26,28
Randers FC,823,8,5,7,12,24,40,-16,22
Silkeborg IF,823,9,6,3,13,27,44,-17,21
Lyngby,823,10,3,10,11,27,45,-18,19
AGF Aarhus,823,11,4,6,12,16,38,-22,18
Brondby,824,1,19,6,5,69,35,34,63
FC Midtjylla,824,2,18,6,6,64,42,22,60
FC Nords,824,3,17,6,7,81,51,30,57
Copenhagen,824,4,13,4,13,61,52,9,43
AaB,824,5,8,12,10,37,41,-4,36
AC Horsens,824,6,8,12,10,40,57,-17,36
Sonderjyske,824,7,8,6,10,28,29,-1,30
Randers FC,824,8,6,6,12,27,41,-14,24
AGF Aarhus,824,9,5,6,11,18,37,-19,21
Lyngby,824,10,3,9,12,28,48,-20,18
Silkeborg IF,824,11,5,3,14,26,46,-20,18
Brondby,825,1,22,5,3,75,31,44,71
FC Midtjylla,825,2,20,4,6,68,41,27,64
FC Nords,825,3,15,6,9,80,56,24,51
Copenhagen,825,4,14,6,10,58,44,14,48
AC Horsens,825,5,6,13,11,34,57,-23,31
Sonderjyske,825,6,8,6,10,28,29,-1,30
AaB,825,7,6,12,12,33,45,-12,30
Lyngby,825,8,4,9,11,28,44,-16,21
Randers FC,825,9,5,6,13,23,41,-18,21
Silkeborg IF,825,10,5,4,13,27,46,-19,19
AGF Aarhus,825,11,4,7,11,18,38,-20,19
Brondby,826,1,21,7,2,69,30,39,70
FC Midtjylla,826,2,21,4,5,67,36,31,67
FC Nords,826,3,13,7,10,72,54,18,46
Copenhagen,826,4,13,5,12,55,47,8,44
AaB,826,5,8,11,11,37,43,-6,35
AC Horsens,826,6,6,14,10,34,50,-16,32
Sonderjyske,826,7,8,6,10,28,29,-1,30
Lyngby,826,8,4,9,11,28,44,-16,21
Silkeborg IF,826,9,6,3,13,28,46,-18,21
Randers FC,826,10,5,6,13,23,41,-18,21
AGF Aarhus,826,11,4,6,12,18,39,-21,18
Brondby,827,1,21,6,3,67,30,37,69
FC Midtjylla,827,2,18,7,5,64,37,27,61
Copenhagen,827,3,15,5,10,59,43,16,50
FC Nords,827,4,14,7,9,77,52,25,49
AaB,827,5,7,12,11,37,46,-9,33
AC Horsens,827,6,6,13,11,31,53,-22,31
Sonderjyske,827,7,8,6,10,28,29,-1,30
Randers FC,827,8,6,6,12,24,39,-15,24
AGF Aarhus,827,9,5,6,11,19,37,-18,21
Lyngby,827,10,3,9,12,26,45,-19,18
Silkeborg IF,827,11,5,3,14,26,47,-21,18
Brondby,828,1,21,5,4,69,33,36,68
FC Midtjylla,828,2,19,5,6,62,41,21,62
FC Nords,828,3,14,7,9,73,49,24,49
Copenhagen,828,4,12,8,10,55,43,12,44
AaB,828,5,8,12,10,38,40,-2,36
AC Horsens,828,6,7,13,10,34,51,-17,34
Sonderjyske,828,7,8,6,10,28,29,-1,30
Lyngby,828,8,4,9,11,27,44,-17,21
Randers FC,828,9,5,6,13,23,40,-17,21
AGF Aarhus,828,10,5,6,11,17,36,-19,21
Silkeborg IF,828,11,5,3,14,25,45,-20,18
Brondby,829,1,22,6,2,77,31,46,72
FC Midtjylla,829,2,19,5,6,68,46,22,62
FC Nords,829,3,15,6,9,75,53,22,51
Copenhagen,829,4,13,5,12,61,50,11,44
AC Horsens,829,5,6,15,9,35,50,-15,33
AaB,829,6,7,11,12,35,47,-12,32
Sonderjyske,829,7,8,6,10,28,29,-1,30
Randers FC,829,8,5,7,12,25,41,-16,22
Lyngby,829,9,3,10,11,28,46,-18,19
Silkeborg IF,829,10,5,4,13,26,45,-19,19
AGF Aarhus,829,11,4,7,11,17,37,-20,19
Brondby,830,1,21,6,3,70,33,37,69
FC Midtjylla,830,2,19,4,7,62,39,23,61
Copenhagen,830,3,16,4,10,60,42,18,52
FC Nords,830,4,13,8,9,72,54,18,47
AaB,830,5,7,12,11,38,45,-7,33
AC Horsens,830,6,7,12,11,39,54,-15,33
Sonderjyske,830,7,8,6,10,28,29,-1,30
Lyngby,830,8,4,9,11,29,45,-16,21
Silkeborg IF,830,9,6,3,13,27,44,-17,21
Randers FC,830,10,5,6,13,24,42,-18,21
AGF Aarhus,830,11,4,6,12,16,38,-22,18
Brondby,831,1,21,6,3,67,29,38,69
FC Midtjylla,831,2,19,6,5,62,37,25,63
FC Nords,831,3,13,7,10,74,57,17,46
Copenhagen,831,4,14,4,12,58,47,11,46
AaB,831,5,8,12,10,38,40,-2,36
AC Horsens,831,6,7,13,10,36,51,-15,34
Sonderjyske,831,7,8,6,10,28,29,-1,30
Lyngby,831,8,4,9,11,28,44,-16,21
Silkeborg IF,831,9,6,3,13,26,44,-18,21
Randers FC,831,10,5,6,13,23,41,-18,21
AGF Aarhus,831,11,4,6,12,16,37,-21,18
Brondby,832,1,21,7,2,71,31,40,70
FC Midtjylla,832,2,21,5,4,72,38,34,68
FC Nords,832,3,14,6,10,69,47,22,48
Copenhagen,832,4,12,4,14,53,51,2,40
AaB,832,5,9,12,9,39,41,-2,39
Sonderjyske,832,6,8,6,10,28,29,-1,30
AC Horsens,832,7,6,12,12,33,55,-22,30
Lyngby,832,8,4,9,11,29,46,-17,21
Silkeborg IF,832,8,6,3,13,29,46,-17,21
Randers FC,832,10,5,6,13,25,42,-17,21
AGF Aarhus,832,11,4,6,12,18,40,-22,18
Brondby,833,1,20,5,5,66,35,31,65
FC Midtjylla,833,2,20,4,6,66,39,27,64
FC Nords,833,3,16,6,8,77,50,27,54
Copenhagen,833,4,14,5,11,60,45,15,47
AaB,833,5,8,12,10,39,46,-7,36
Sonderjyske,833,6,8,6,10,28,29,-1,30
AC Horsens,833,7,6,12,12,32,51,-19,30
Lyngby,833,8,4,9,11,27,44,-17,21
Randers FC,833,9,5,6,13,23,40,-17,21
Silkeborg IF,833,10,6,3,13,27,45,-18,21
AGF Aarhus,833,11,4,6,12,17,38,-21,18
FC Midtjylla,834,1,21,5,4,72,40,32,68
Brondby,834,2,20,6,4,74,39,35,66
Copenhagen,834,3,14,6,10,61,47,14,48
FC Nords,834,4,12,8,10,72,56,16,44
AaB,834,5,8,11,11,39,42,-3,35
AC Horsens,834,6,6,14,10,34,54,-20,32
Sonderjyske,834,7,8,6,10,28,29,-1,30
Randers FC,834,8,5,7,12,23,39,-16,22
AGF Aarhus,834,9,5,6,11,20,39,-19,21
Lyngby,834,10,3,10,11,26,44,-18,19
Silkeborg IF,834,11,5,3,14,28,48,-20,18
Brondby,835,1,19,8,3,72,35,37,65
FC Midtjylla,835,2,20,5,5,70,42,28,65
FC Nords,835,3,15,6,9,74,55,19,51
Copenhagen,835,4,14,5,11,54,42,12,47
AaB,835,5,7,13,10,37,42,-5,34
Sonderjyske,835,6,8,6,10,28,29,-1,30
AC Horsens,835,7,5,15,10,35,52,-17,30
Lyngby,835,8,4,9,11,29,45,-16,21
Silkeborg IF,835,9,6,3,13,26,44,-18,21
Randers FC,835,10,5,6,13,24,42,-18,21
AGF Aarhus,835,11,4,6,12,16,37,-21,18
Brondby,836,1,23,5,2,76,28,48,74
FC Midtjylla,836,2,20,5,5,70,38,32,65
Copenhagen,836,3,15,4,11,61,45,16,49
FC Nords,836,4,13,6,11,68,57,11,45
AaB,836,5,7,12,11,36,48,-12,33
Sonderjyske,836,6,8,6,10,28,29,-1,30
AC Horsens,836,7,5,14,11,31,52,-21,29
Randers FC,836,8,6,6,12,27,40,-13,24
AGF Aarhus,836,9,5,6,11,18,36,-18,21
Lyngby,836,10,3,9,12,27,48,-21,18
Silkeborg IF,836,11,5,3,14,25,46,-21,18
Brondby,837,1,22,5,3,77,36,41,71
FC Midtjylla,837,2,21,5,4,69,37,32,68
FC Nords,837,3,13,8,9,74,52,22,47
Copenhagen,837,4,12,5,13,54,48,6,41
AaB,837,5,8,12,10,41,47,-6,36
AC Horsens,837,6,6,13,11,36,57,-21,31
Sonderjyske,837,7,8,6,10,28,29,-1,30
Randers FC,837,8,6,6,12,26,41,-15,24
Silkeborg IF,837,9,6,3,13,26,44,-18,21
Lyngby,837,10,3,9,12,28,47,-19,18
AGF Aarhus,837,11,4,6,12,16,37,-21,18
Brondby,838,1,22,6,2,71,27,44,72
FC Midtjylla,838,2,20,5,5,67,39,28,65
FC Nords,838,3,15,6,9,73,51,22,51
Copenhagen,838,4,13,5,12,58,47,11,44
AC Horsens,838,5,7,13,10,36,53,-17,34
Sonderjyske,838,6,8,6,10,28,29,-1,30
AaB,838,7,6,11,13,33,47,-14,29
Lyngby,838,8,4,9,11,28,44,-16,21
Randers FC,838,9,5,6,13,23,41,-18,21
AGF Aarhus,838,10,5,6,11,17,36,-19,21
Silkeborg IF,838,11,5,3,14,25,45,-20,18
Brondby,839,1,21,5,4,72,36,36,68
FC Midtjylla,839,2,20,5,5,74,41,33,65
Copenhagen,839,3,15,4,11,60,46,14,49
FC Nords,839,4,13,7,10,76,64,12,46
AaB,839,5,8,13,9,43,43,0,37
Sonderjyske,839,6,8,6,10,28,29,-1,30
AC Horsens,839,7,5,14,11,36,57,-21,29
Randers FC,839,8,6,6,12,25,39,-14,24
Silkeborg IF,839,9,6,3,13,26,44,-18,21
Lyngby,839,10,3,9,12,26,46,-20,18
AGF Aarhus,839,11,4,6,12,16,37,-21,18
Brondby,840,1,20,5,5,64,32,32,65
FC Midtjylla,840,2,20,4,6,66,41,25,64
Copenhagen,840,3,15,5,10,63,43,20,50
FC Nords,840,4,14,7,9,73,54,19,49
AaB,840,5,8,12,10,39,43,-4,36
AC Horsens,840,6,6,13,11,37,55,-18,31
Sonderjyske,840,7,8,6,10,28,29,-1,30
Randers FC,840,8,6,6,12,24,39,-15,24
AGF Aarhus,840,9,5,6,11,21,40,-19,21
Lyngby,840,10,3,9,12,26,45,-19,18
Silkeborg IF,840,11,5,3,14,29,49,-20,18
FC Midtjylla,841,1,22,4,4,72,37,35,70
Brondby,841,2,21,6,3,69,33,36,69
FC Nords,841,3,15,6,9,77,55,22,51
Copenhagen,841,4,13,5,12,59,50,9,44
AaB,841,5,7,11,12,35,44,-9,32
Sonderjyske,841,6,8,6,10,28,29,-1,30
AC Horsens,841,7,6,12,12,35,54,-19,30
Randers FC,841,8,5,7,12,23,39,-16,22
Silkeborg IF,841,9,6,3,13,27,44,-17,21
Lyngby,841,10,3,10,11,26,44,-18,19
AGF Aarhus,841,11,4,6,12,16,38,-22,18
FC Midtjylla,842,1,21,5,4,66,38,28,68
Brondby,842,2,20,6,4,74,33,41,66
Copenhagen,842,3,15,5,10,62,45,17,50
FC Nords,842,4,13,9,8,72,51,21,48
AaB,842,5,6,13,11,35,45,-10,31
Sonderjyske,842,6,8,6,10,28,29,-1,30
AC Horsens,842,7,5,14,11,32,55,-23,29
Randers FC,842,8,5,7,12,23,39,-16,22
Lyngby,842,9,3,10,11,26,44,-18,19
Silkeborg IF,842,10,5,4,13,25,44,-19,19
AGF Aarhus,842,11,4,7,11,16,36,-20,19
Brondby,843,1,21,7,2,69,30,39,70
FC Midtjylla,843,2,20,4,6,63,37,26,64
Copenhagen,843,3,16,5,9,63,42,21,53
FC Nords,843,4,12,8,10,70,53,17,44
AaB,843,5,6,14,10,33,41,-8,32
Sonderjyske,843,6,8,6,10,28,29,-1,30
AC Horsens,843,7,5,14,11,30,51,-21,29
Randers FC,843,8,5,7,12,25,41,-16,22
Silkeborg IF,843,9,6,3,13,27,44,-17,21
Lyngby,843,10,3,10,11,28,46,-18,19
AGF Aarhus,843,11,4,6,12,16,38,-22,18
Brondby,844,1,20,5,5,72,33,39,65
FC Midtjylla,844,2,18,5,7,62,43,19,59
FC Nords,844,3,16,6,8,76,49,27,54
Copenhagen,844,4,14,4,12,58,51,7,46
AaB,844,5,10,11,9,40,39,1,41
AC Horsens,844,6,6,13,11,35,54,-19,31
Sonderjyske,844,7,8,6,10,28,29,-1,30
Randers FC,844,8,6,6,12,28,40,-12,24
Silkeborg IF,844,9,5,4,13,25,44,-19,19
AGF Aarhus,844,10,4,7,11,16,36,-20,19
Lyngby,844,11,3,9,12,27,49,-22,18
Brondby,845,1,20,7,3,69,33,36,67
FC Midtjylla,845,2,19,6,5,65,36,29,63
FC Nords,845,3,14,8,8,78,53,25,50
Copenhagen,845,4,14,5,11,58,45,13,47
AaB,845,5,8,12,10,39,44,-5,36
Sonderjyske,845,6,8,6,10,28,29,-1,30
AC Horsens,845,7,6,12,12,34,58,-24,30
Randers FC,845,8,6,6,12,26,39,-13,24
Silkeborg IF,845,9,6,3,13,26,44,-18,21
Lyngby,845,10,3,9,12,26,47,-21,18
AGF Aarhus,845,11,4,6,12,16,37,-21,18
Brondby,846,1,21,6,3,72,35,37,69
FC Midtjylla,846,2,21,5,4,72,39,33,68
Copenhagen,846,3,14,5,11,59,47,12,47
FC Nords,846,4,12,7,11,69,54,15,43
AC Horsens,846,5,7,14,9,37,52,-15,35
AaB,846,6,7,11,12,37,45,-8,32
Sonderjyske,846,7,8,6,10,28,29,-1,30
Randers FC,846,8,5,7,12,24,40,-16,22
Lyngby,846,9,3,10,11,27,45,-18,19
Silkeborg IF,846,10,5,4,13,26,45,-19,19
AGF Aarhus,846,11,4,7,11,17,37,-20,19
Brondby,847,1,20,5,5,67,31,36,65
FC Midtjylla,847,2,19,6,5,66,38,28,63
Copenhagen,847,3,15,5,10,58,42,16,50
FC Nords,847,4,12,7,11,67,56,11,43
AC Horsens,847,5,9,13,8,39,49,-10,40
AaB,847,6,7,12,11,37,44,-7,33
Sonderjyske,847,7,8,6,10,28,29,-1,30
Randers FC,847,8,6,6,12,27,41,-14,24
Silkeborg IF,847,9,6,3,13,27,44,-17,21
Lyngby,847,10,3,9,12,28,48,-20,18
AGF Aarhus,847,11,4,6,12,16,38,-22,18
Brondby,848,1,20,6,4,71,38,33,66
FC Midtjylla,848,2,17,8,5,62,40,22,59
Copenhagen,848,3,15,6,9,64,43,21,51
FC Nords,848,4,13,9,8,71,50,21,48
AC Horsens,848,5,7,15,8,36,49,-13,36
Sonderjyske,848,6,8,6,10,28,29,-1,30
AaB,848,7,6,12,12,35,45,-10,30
Lyngby,848,8,4,9,11,27,44,-17,21
Randers FC,848,9,5,6,13,23,40,-17,21
AGF Aarhus,848,10,5,6,11,18,37,-19,21
Silkeborg IF,848,11,5,3,14,26,46,-20,18
Brondby,849,1,19,8,3,71,35,36,65
FC Midtjylla,849,2,19,6,5,67,38,29,63
Copenhagen,849,3,15,5,10,61,46,15,50
FC Nords,849,4,14,7,9,70,52,18,49
AaB,849,5,7,12,11,37,41,-4,33
AC Horsens,849,6,6,14,10,33,53,-20,32
Sonderjyske,849,7,8,6,10,28,29,-1,30
Randers FC,849,8,5,7,12,23,39,-16,22
Lyngby,849,9,3,10,11,26,44,-18,19
Silkeborg IF,849,10,5,4,13,25,44,-19,19
AGF Aarhus,849,11,4,7,11,16,36,-20,19
Brondby,850,1,20,6,4,68,34,34,66
FC Midtjylla,850,2,20,4,6,65,40,25,64
Copenhagen,850,3,15,4,11,57,40,17,49
FC Nords,850,4,13,7,10,70,52,18,46
AaB,850,5,9,13,8,40,41,-1,40
Sonderjyske,850,6,8,6,10,28,29,-1,30
AC Horsens,850,7,6,12,12,34,53,-19,30
Randers FC,850,8,6,6,12,24,39,-15,24
Silkeborg IF,850,9,5,4,13,28,47,-19,19
AGF Aarhus,850,10,4,7,11,19,39,-20,19
Lyngby,850,11,3,9,12,26,45,-19,18
FC Midtjylla,851,1,21,5,4,70,36,34,68
Brondby,851,2,20,7,3,72,35,37,67
Copenhagen,851,3,15,5,10,61,49,12,50
FC Nords,851,4,13,6,11,79,58,21,45
AaB,851,5,7,11,12,39,50,-11,32
AC Horsens,851,6,6,14,10,34,53,-19,32
Sonderjyske,851,7,8,6,10,28,29,-1,30
Randers FC,851,8,6,6,12,25,40,-15,24
Silkeborg IF,851,9,5,4,13,26,45,-19,19
AGF Aarhus,851,10,4,7,11,17,37,-20,19
Lyngby,851,11,3,9,12,27,46,-19,18
FC Midtjylla,852,1,19,7,4,62,35,27,64
Brondby,852,2,19,6,5,69,38,31,63
FC Nords,852,3,15,7,8,77,51,26,52
Copenhagen,852,4,14,6,10,55,43,12,48
AaB,852,5,9,11,10,38,41,-3,38
Sonderjyske,852,6,8,6,10,28,29,-1,30
AC Horsens,852,7,5,13,12,31,50,-19,28
Lyngby,852,8,4,9,11,28,44,-16,21
Randers FC,852,9,5,6,13,23,41,-18,21
Silkeborg IF,852,10,5,4,13,27,46,-19,19
AGF Aarhus,852,11,4,7,11,18,38,-20,19
Brondby,853,1,22,6,2,78,32,46,72
FC Midtjylla,853,2,20,6,4,65,37,28,66
FC Nords,853,3,14,6,10,74,51,23,48
Copenhagen,853,4,13,5,12,56,49,7,44
AaB,853,5,7,12,11,36,45,-9,33
AC Horsens,853,6,6,13,11,32,53,-21,31
Sonderjyske,853,7,8,6,10,28,29,-1,30
Lyngby,853,8,4,9,11,27,44,-17,21
Randers FC,853,9,5,6,13,23,40,-17,21
AGF Aarhus,853,10,5,6,11,20,37,-17,21
Silkeborg IF,853,11,5,3,14,26,48,-22,18
Brondby,854,1,21,5,4,71,32,39,68
FC Midtjylla,854,2,20,6,4,69,38,31,66
FC Nords,854,3,13,7,10,71,56,15,46
Copenhagen,854,4,13,5,12,56,45,11,44
AaB,854,5,7,14,9,39,43,-4,35
AC Horsens,854,6,7,13,10,34,52,-18,34
Sonderjyske,854,7,8,6,10,28,29,-1,30
Randers FC,854,8,5,7,12,23,39,-16,22
Silkeborg IF,854,9,6,3,13,26,44,-18,21
Lyngby,854,10,3,10,11,26,44,-18,19
AGF Aarhus,854,11,4,6,12,16,37,-21,18
Brondby,855,1,20,7,3,68,31,37,67
FC Midtjylla,855,2,19,6,5,63,38,25,63
Copenhagen,855,3,14,6,10,61,45,16,48
FC Nords,855,4,13,7,10,70,54,16,46
AC Horsens,855,5,7,14,9,38,49,-11,35
AaB,855,6,6,14,10,34,43,-9,32
Sonderjyske,855,7,8,6,10,28,29,-1,30
Randers FC,855,8,5,7,12,25,41,-16,22
AGF Aarhus,855,9,5,6,11,18,37,-19,21
Lyngby,855,10,3,10,11,28,46,-18,19
Silkeborg IF,855,11,5,3,14,26,46,-20,18
Brondby,856,1,23,5,2,74,32,42,74
FC Midtjylla,856,2,20,4,6,62,35,27,64
FC Nords,856,3,15,6,9,74,54,20,51
Copenhagen,856,4,14,4,12,58,46,12,46
AaB,856,5,7,11,12,38,46,-8,32
Sonderjyske,856,6,8,6,10,28,29,-1,30
AC Horsens,856,7,6,12,12,33,52,-19,30
Lyngby,856,8,4,9,11,29,44,-15,21
Randers FC,856,9,5,6,13,23,42,-19,21
Silkeborg IF,856,10,5,4,13,26,45,-19,19
AGF Aarhus,856,11,4,7,11,17,37,-20,19
Brondby,857,1,21,5,4,71,36,35,68
FC Midtjylla,857,2,19,5,6,63,42,21,62
FC Nords,857,3,16,6,8,80,46,34,54
Copenhagen,857,4,14,5,11,57,46,11,47
AaB,857,5,8,13,9,42,42,0,37
Sonderjyske,857,6,8,6,10,28,29,-1,30
AC Horsens,857,7,5,12,13,34,61,-27,27
Lyngby,857,8,4,9,11,28,45,-17,21
Randers FC,857,9,5,6,13,24,41,-17,21
Silkeborg IF,857,10,5,4,13,27,46,-19,19
AGF Aarhus,857,11,4,7,11,18,38,-20,19
Brondby,858,1,19,7,4,68,38,30,64
FC Midtjylla,858,2,19,7,4,64,37,27,64
FC Nords,858,3,13,8,9,71,50,21,47
Copenhagen,858,4,13,5,12,58,48,10,44
AaB,858,5,9,12,9,37,37,0,39
AC Horsens,858,6,7,13,10,36,50,-14,34
Sonderjyske,858,7,8,6,10,28,29,-1,30
Randers FC,858,8,6,6,12,25,40,-15,24
AGF Aarhus,858,9,5,6,11,19,38,-19,21
Lyngby,858,10,3,9,12,27,46,-19,18
Silkeborg IF,858,11,5,3,14,27,47,-20,18
FC Midtjylla,859,1,19,6,5,65,36,29,63
Brondby,859,2,19,5,6,68,36,32,62
FC Nords,859,3,14,7,9,68,53,15,49
Copenhagen,859,4,13,7,10,54,41,13,46
AaB,859,5,9,11,10,37,39,-2,38
AC Horsens,859,6,7,14,9,34,47,-13,35
Sonderjyske,859,7,8,6,10,28,29,-1,30
Lyngby,859,8,4,9,11,27,44,-17,21
Randers FC,859,9,5,6,13,23,40,-17,21
Silkeborg IF,859,10,5,4,13,27,46,-19,19
AGF Aarhus,859,11,4,7,11,18,38,-20,19
Brondby,860,1,21,7,2,70,30,40,70
FC Midtjylla,860,2,20,4,6,63,38,25,64
Copenhagen,860,3,15,5,10,60,41,19,50
FC Nords,860,4,14,6,10,72,53,19,48
AaB,860,5,7,12,11,34,41,-7,33
Sonderjyske,860,6,8,6,10,28,29,-1,30
AC Horsens,860,7,6,12,12,32,54,-22,30
Randers FC,860,8,5,7,12,24,40,-16,22
AGF Aarhus,860,9,5,6,11,17,36,-19,21
Lyngby,860,10,3,10,11,27,45,-18,19
Silkeborg IF,860,11,5,3,14,25,45,-20,18
FC Midtjylla,861,1,20,6,4,70,37,33,66
Brondby,861,2,19,6,5,68,38,30,63
FC Nords,861,3,16,6,8,78,50,28,54
Copenhagen,861,4,13,6,11,56,45,11,45
AaB,861,5,7,12,11,38,48,-10,33
AC Horsens,861,6,7,12,11,37,55,-18,33
Sonderjyske,861,7,8,6,10,28,29,-1,30
Randers FC,861,8,6,6,12,26,40,-14,24
Silkeborg IF,861,9,6,3,13,28,44,-16,21
Lyngby,861,10,3,9,12,27,47,-20,18
AGF Aarhus,861,11,4,6,12,16,39,-23,18
Brondby,862,1,22,5,3,73,33,40,71
FC Midtjylla,862,2,19,5,6,69,43,26,62
Copenhagen,862,3,14,5,11,63,49,14,47
FC Nords,862,4,13,6,11,69,54,15,45
AaB,862,5,8,13,9,42,45,-3,37
AC Horsens,862,6,7,12,11,37,55,-18,33
Sonderjyske,862,7,8,6,10,28,29,-1,30
Randers FC,862,8,6,6,12,28,43,-15,24
Silkeborg IF,862,9,6,3,13,27,44,-17,21
Lyngby,862,10,3,9,12,30,49,-19,18
AGF Aarhus,862,11,4,6,12,16,38,-22,18
Brondby,863,1,21,7,2,76,30,46,70
FC Midtjylla,863,2,20,5,5,70,45,25,65
FC Nords,863,3,14,6,10,79,58,21,48
Copenhagen,863,4,13,6,11,59,53,6,45
AaB,863,5,8,11,11,44,47,-3,35
AC Horsens,863,6,6,13,11,36,57,-21,31
Sonderjyske,863,7,8,6,10,28,29,-1,30
Randers FC,863,8,6,6,12,26,40,-14,24
Silkeborg IF,863,9,6,3,13,26,44,-18,21
Lyngby,863,10,3,9,12,27,47,-20,18
AGF Aarhus,863,11,4,6,12,16,37,-21,18
FC Midtjylla,864,1,21,5,4,67,37,30,68
Brondby,864,2,20,7,3,68,32,36,67
Copenhagen,864,3,15,4,11,62,46,16,49
FC Nords,864,4,14,6,10,70,50,20,48
AaB,864,5,7,12,11,36,44,-8,33
Sonderjyske,864,6,8,6,10,28,29,-1,30
AC Horsens,864,7,5,14,11,33,53,-20,29
Lyngby,864,8,4,9,11,28,45,-17,21
Randers FC,864,9,5,6,13,24,41,-17,21
Silkeborg IF,864,10,5,4,13,27,46,-19,19
AGF Aarhus,864,11,4,7,11,18,38,-20,19
Brondby,865,1,20,7,3,70,33,37,67
FC Midtjylla,865,2,21,4,5,73,40,33,67
FC Nords,865,3,14,7,9,77,54,23,49
Copenhagen,865,4,12,6,12,56,51,5,42
AaB,865,5,7,13,10,40,49,-9,34
AC Horsens,865,6,7,13,10,40,55,-15,34
Sonderjyske,865,7,8,6,10,28,29,-1,30
Randers FC,865,8,6,6,12,25,40,-15,24
Silkeborg IF,865,9,6,3,13,28,46,-18,21
Lyngby,865,10,3,9,12,27,46,-19,18
AGF Aarhus,865,11,4,6,12,18,39,-21,18
Brondby,866,1,20,5,5,66,35,31,65
FC Midtjylla,866,2,20,4,6,67,44,23,64
Copenhagen,866,3,15,4,11,61,44,17,49
FC Nords,866,4,13,7,10,68,52,16,46
AC Horsens,866,5,8,14,8,41,49,-8,38
AaB,866,6,7,12,11,38,43,-5,33
Sonderjyske,866,7,8,6,10,28,29,-1,30
Randers FC,866,8,5,7,12,24,40,-16,22
Lyngby,866,9,3,10,11,27,45,-18,19
Silkeborg IF,866,10,5,4,13,26,45,-19,19
AGF Aarhus,866,11,4,7,11,17,37,-20,19
Brondby,867,1,22,5,3,71,30,41,71
FC Midtjylla,867,2,20,5,5,65,36,29,65
FC Nords,867,3,14,7,9,76,51,25,49
Copenhagen,867,4,14,5,11,55,44,11,47
AaB,867,5,6,13,11,34,47,-13,31
AC Horsens,867,6,6,13,11,33,52,-19,31
Sonderjyske,867,7,8,6,10,28,29,-1,30
Lyngby,867,8,4,9,11,28,45,-17,21
Randers FC,867,9,5,6,13,24,41,-17,21
AGF Aarhus,867,10,5,6,11,19,38,-19,21
Silkeborg IF,867,11,5,3,14,27,47,-20,18
Brondby,868,1,21,5,4,71,33,38,68
FC Midtjylla,868,2,20,5,5,62,35,27,65
FC Nords,868,3,15,6,9,74,52,22,51
Copenhagen,868,4,13,6,11,56,44,12,45
AC Horsens,868,5,8,12,10,37,50,-13,36
Sonderjyske,868,6,8,6,10,28,29,-1,30
AaB,868,7,6,12,12,34,46,-12,30
Randers FC,868,8,6,6,12,24,39,-15,24
Silkeborg IF,868,9,5,4,13,26,45,-19,19
AGF Aarhus,868,10,4,7,11,17,37,-20,19
Lyngby,868,11,3,9,12,26,45,-19,18
Brondby,869,1,22,5,3,74,30,44,71
FC Midtjylla,869,2,20,4,6,66,44,22,64
Copenhagen,869,3,15,5,10,58,45,13,50
FC Nords,869,4,14,6,10,74,52,22,48
AaB,869,5,7,12,11,34,40,-6,33
Sonderjyske,869,6,8,6,10,28,29,-1,30
AC Horsens,869,7,6,12,12,37,58,-21,30
Silkeborg IF,869,8,6,3,13,32,44,-12,21
Lyngby,869,9,4,9,11,28,45,-17,21
Randers FC,869,10,5,6,13,24,41,-17,21
AGF Aarhus,869,11,4,6,12,16,43,-27,18
Brondby,870,1,21,6,3,75,35,40,69
FC Midtjylla,870,2,20,5,5,73,43,30,65
FC Nords,870,3,14,6,10,75,53,22,48
Copenhagen,870,4,13,6,11,54,45,9,45
AaB,870,5,8,11,11,38,46,-8,35
AC Horsens,870,6,7,12,11,34,53,-19,33
Sonderjyske,870,7,8,6,10,28,29,-1,30
Lyngby,870,8,4,9,11,27,44,-17,21
Randers FC,870,9,5,6,13,23,40,-17,21
Silkeborg IF,870,10,6,3,13,26,44,-18,21
AGF Aarhus,870,11,4,6,12,16,37,-21,18
Brondby,871,1,21,7,2,71,27,44,70
FC Midtjylla,871,2,19,7,4,63,36,27,64
FC Nords,871,3,13,7,10,73,53,20,46
Copenhagen,871,4,12,7,11,55,46,9,43
AaB,871,5,7,13,10,38,45,-7,34
AC Horsens,871,6,7,13,10,34,53,-19,34
Sonderjyske,871,7,8,6,10,28,29,-1,30
Randers FC,871,8,5,7,12,24,40,-16,22
Silkeborg IF,871,9,6,3,13,26,44,-18,21
Lyngby,871,10,3,10,11,27,45,-18,19
AGF Aarhus,871,11,4,6,12,16,37,-21,18
Brondby,872,1,21,5,4,75,32,43,68
FC Midtjylla,872,2,18,6,6,65,42,23,60
Copenhagen,872,3,15,5,10,56,41,15,50
FC Nords,872,4,14,7,9,77,55,22,49
AaB,872,5,8,12,10,38,43,-5,36
AC Horsens,872,6,6,13,11,32,56,-24,31
Sonderjyske,872,7,8,6,10,28,29,-1,30
Lyngby,872,8,4,9,11,29,46,-17,21
Randers FC,872,9,5,6,13,25,42,-17,21
Silkeborg IF,872,10,5,4,13,26,45,-19,19
AGF Aarhus,872,11,4,7,11,17,37,-20,19
Brondby,873,1,21,5,4,72,33,39,68
FC Midtjylla,873,2,20,5,5,69,43,26,65
FC Nords,873,3,14,6,10,72,53,19,48
Copenhagen,873,4,14,5,11,58,46,12,47
AC Horsens,873,5,7,13,10,39,51,-12,34
AaB,873,6,7,12,11,37,47,-10,33
Sonderjyske,873,7,8,6,10,28,29,-1,30
Lyngby,873,8,4,9,11,27,44,-17,21
Randers FC,873,9,5,6,13,23,40,-17,21
AGF Aarhus,873,10,5,6,11,20,37,-17,21
Silkeborg IF,873,11,5,3,14,26,48,-22,18
Brondby,874,1,21,6,3,73,36,37,69
FC Midtjylla,874,2,20,5,5,70,39,31,65
FC Nords,874,3,14,8,8,83,54,29,50
Copenhagen,874,4,14,4,12,58,57,1,46
AC Horsens,874,5,7,13,10,41,56,-15,34
Sonderjyske,874,6,8,6,10,28,29,-1,30
AaB,874,7,6,12,12,35,44,-9,30
Randers FC,874,8,6,6,12,25,40,-15,24
Silkeborg IF,874,9,5,4,13,25,44,-19,19
AGF Aarhus,874,10,4,7,11,16,36,-20,19
Lyngby,874,11,3,9,12,27,46,-19,18
FC Midtjylla,875,1,20,5,5,66,35,31,65
Brondby,875,2,19,7,4,68,33,35,64
FC Nords,875,3,15,6,9,81,52,29,51
Copenhagen,875,4,13,5,12,58,56,2,44
AC Horsens,875,5,8,13,9,37,52,-15,37
AaB,875,6,7,12,11,37,45,-8,33
Sonderjyske,875,7,8,6,10,28,29,-1,30
Silkeborg IF,875,8,6,3,13,31,46,-15,21
Lyngby,875,9,4,9,11,28,45,-17,21
Randers FC,875,10,5,6,13,24,41,-17,21
AGF Aarhus,875,11,4,6,12,18,42,-24,18
Brondby,876,1,23,5,2,76,33,43,74
FC Midtjylla,876,2,19,5,6,66,39,27,62
FC Nords,876,3,15,7,8,76,49,27,52
Copenhagen,876,4,14,4,12,56,48,8,46
AaB,876,5,7,13,10,38,44,-6,34
Sonderjyske,876,6,8,6,10,28,29,-1,30
AC Horsens,876,7,5,12,13,33,58,-25,27
Lyngby,876,8,4,9,11,29,44,-15,21
Randers FC,876,9,5,6,13,23,42,-19,21
AGF Aarhus,876,10,5,6,11,17,36,-19,21
Silkeborg IF,876,11,5,3,14,25,45,-20,18
Brondby,877,1,21,6,3,72,33,39,69
FC Midtjylla,877,2,19,6,5,68,41,27,63
FC Nords,877,3,14,9,7,78,54,24,51
Copenhagen,877,4,15,6,9,61,42,19,51
AaB,877,5,7,11,12,39,51,-12,32
Sonderjyske,877,6,8,6,10,28,29,-1,30
AC Horsens,877,7,5,12,13,32,55,-23,27
Randers FC,877,8,5,7,12,24,40,-16,22
Lyngby,877,9,3,10,11,27,45,-18,19
Silkeborg IF,877,10,5,4,13,26,45,-19,19
AGF Aarhus,877,11,4,7,11,17,37,-20,19
Brondby,878,1,20,6,4,68,32,36,66
FC Midtjylla,878,2,20,4,6,74,39,35,64
Copenhagen,878,3,14,5,11,56,44,12,47
FC Nords,878,4,13,6,11,69,58,11,45
AaB,878,5,9,12,9,41,41,0,39
AC Horsens,878,6,7,13,10,38,58,-20,34
Sonderjyske,878,7,8,6,10,28,29,-1,30
Silkeborg IF,878,8,6,3,13,30,45,-15,21
Lyngby,878,9,4,9,11,28,45,-17,21
Randers FC,878,10,5,6,13,24,41,-17,21
AGF Aarhus,878,11,4,6,12,17,41,-24,18
FC Midtjylla,879,1,21,5,4,69,36,33,68
Brondby,879,2,20,7,3,74,39,35,67
FC Nords,879,3,14,6,10,74,55,19,48
Copenhagen,879,4,13,5,12,58,47,11,44
AaB,879,5,9,11,10,39,42,-3,38
Sonderjyske,879,6,8,6,10,28,29,-1,30
AC Horsens,879,7,5,14,11,34,55,-21,29
Randers FC,879,8,6,6,12,27,40,-13,24
Silkeborg IF,879,9,6,3,13,28,44,-16,21
Lyngby,879,10,3,9,12,27,48,-21,18
AGF Aarhus,879,11,4,6,12,16,39,-23,18
Brondby,880,1,22,5,3,67,28,39,71
FC Midtjylla,880,2,19,6,5,63,38,25,63
Copenhagen,880,3,14,5,11,55,42,13,47
FC Nords,880,4,13,7,10,72,53,19,46
AaB,880,5,7,13,10,34,39,-5,34
AC Horsens,880,6,7,12,11,35,52,-17,33
Sonderjyske,880,7,8,6,10,28,29,-1,30
Randers FC,880,8,5,7,12,24,40,-16,22
Silkeborg IF,880,9,6,3,13,28,46,-18,21
Lyngby,880,10,3,10,11,27,45,-18,19
AGF Aarhus,880,11,4,6,12,18,39,-21,18
Brondby,881,1,22,6,2,71,29,42,72
FC Midtjylla,881,2,20,6,4,65,34,31,66
FC Nords,881,3,14,6,10,70,50,20,48
Copenhagen,881,4,12,6,12,55,46,9,42
AaB,881,5,7,13,10,35,44,-9,34
AC Horsens,881,6,6,13,11,31,50,-19,31
Sonderjyske,881,7,8,6,10,28,29,-1,30
Randers FC,881,8,5,7,12,23,39,-16,22
Lyngby,881,9,3,10,11,26,44,-18,19
Silkeborg IF,881,10,5,4,13,25,44,-19,19
AGF Aarhus,881,11,4,7,11,16,36,-20,19
Brondby,882,1,21,5,4,66,33,33,68
FC Midtjylla,882,2,20,4,6,65,39,26,64
FC Nords,882,3,16,7,7,80,48,32,55
Copenhagen,882,4,13,5,12,58,49,9,44
AaB,882,5,6,14,10,35,41,-6,32
AC Horsens,882,6,6,13,11,35,55,-20,31
Sonderjyske,882,7,8,6,10,28,29,-1,30
Lyngby,882,8,4,9,11,27,44,-17,21
Randers FC,882,9,5,6,13,23,40,-17,21
AGF Aarhus,882,10,5,6,11,19,37,-18,21
Silkeborg IF,882,11,5,3,14,26,47,-21,18
Brondby,883,1,22,6,2,73,28,45,72
FC Midtjylla,883,2,19,4,7,59,36,23,61
FC Nords,883,3,15,7,8,76,51,25,52
Copenhagen,883,4,14,4,12,57,47,10,46
AaB,883,5,7,13,10,35,40,-5,34
Sonderjyske,883,6,8,6,10,28,29,-1,30
AC Horsens,883,7,6,12,12,34,58,-24,30
Randers FC,883,8,5,7,12,23,39,-16,22
AGF Aarhus,883,9,5,6,11,19,36,-17,21
Lyngby,883,10,3,10,11,26,44,-18,19
Silkeborg IF,883,11,5,3,14,25,47,-22,18
Brondby,884,1,21,6,3,72,31,41,69
FC Midtjylla,884,2,21,5,4,67,37,30,68
Copenhagen,884,3,14,5,11,58,42,16,47
FC Nords,884,4,12,7,11,70,58,12,43
AaB,884,5,8,12,10,37,45,-8,36
AC Horsens,884,6,6,13,11,33,50,-17,31
Sonderjyske,884,7,8,6,10,28,29,-1,30
Randers FC,884,8,6,6,12,26,41,-15,24
Silkeborg IF,884,9,6,3,13,29,45,-16,21
Lyngby,884,10,3,9,12,28,47,-19,18
AGF Aarhus,884,11,4,6,12,17,40,-23,18
Brondby,885,1,20,6,4,72,34,38,66
FC Midtjylla,885,2,18,7,5,60,37,23,61
Copenhagen,885,3,16,4,10,61,43,18,52
FC Nords,885,4,14,7,9,71,49,22,49
AaB,885,5,7,12,11,33,43,-10,33
AC Horsens,885,6,6,14,10,35,52,-17,32
Sonderjyske,885,7,8,6,10,28,29,-1,30
Lyngby,885,8,4,9,11,28,44,-16,21
Silkeborg IF,885,9,6,3,13,28,45,-17,21
Randers FC,885,10,5,6,13,23,41,-18,21
AGF Aarhus,885,11,4,6,12,17,39,-22,18
Brondby,886,1,21,6,3,70,32,38,69
FC Midtjylla,886,2,19,4,7,62,41,21,61
FC Nords,886,3,15,8,7,78,50,28,53
Copenhagen,886,4,15,6,9,63,46,17,51
Sonderjyske,886,5,8,6,10,28,29,-1,30
AaB,886,6,6,12,12,37,47,-10,30
AC Horsens,886,7,6,12,12,35,55,-20,30
Randers FC,886,8,5,7,12,24,40,-16,22
Lyngby,886,9,3,10,11,27,45,-18,19
Silkeborg IF,886,10,5,4,13,25,44,-19,19
AGF Aarhus,886,11,4,7,11,16,36,-20,19
Brondby,887,1,21,5,4,73,34,39,68
FC Midtjylla,887,2,19,5,6,65,42,23,62
FC Nords,887,3,15,6,9,77,53,24,51
Copenhagen,887,4,14,5,11,57,44,13,47
AaB,887,5,8,12,10,38,42,-4,36
AC Horsens,887,6,6,13,11,33,54,-21,31
Sonderjyske,887,7,8,6,10,28,29,-1,30
Lyngby,887,8,4,9,11,28,45,-17,21
Randers FC,887,9,5,6,13,24,41,-17,21
Silkeborg IF,887,10,6,3,13,26,44,-18,21
AGF Aarhus,887,11,4,6,12,16,37,-21,18
Brondby,888,1,20,6,4,67,34,33,66
FC Midtjylla,888,2,19,5,6,65,40,25,62
FC Nords,888,3,16,6,8,76,50,26,54
Copenhagen,888,4,13,6,11,58,45,13,45
AaB,888,5,8,11,11,40,46,-6,35
AC Horsens,888,6,6,14,10,37,54,-17,32
Sonderjyske,888,7,8,6,10,28,29,-1,30
Randers FC,888,8,6,6,12,25,40,-15,24
AGF Aarhus,888,9,5,6,11,19,36,-17,21
Lyngby,888,10,3,9,12,27,46,-19,18
Silkeborg IF,888,11,5,3,14,25,47,-22,18
Brondby,889,1,19,8,3,72,37,35,65
FC Midtjylla,889,2,20,5,5,69,40,29,65
FC Nords,889,3,14,6,10,75,56,19,48
Copenhagen,889,4,14,5,11,57,47,10,47
AaB,889,5,7,13,10,43,50,-7,34
AC Horsens,889,6,7,13,10,40,52,-12,34
Sonderjyske,889,7,8,6,10,28,29,-1,30
Lyngby,889,8,4,9,11,31,47,-16,21
Randers FC,889,9,5,6,13,26,44,-18,21
Silkeborg IF,889,10,5,4,13,27,46,-19,19
AGF Aarhus,889,11,4,7,11,18,38,-20,19
Brondby,890,1,21,7,2,77,34,43,70
FC Midtjylla,890,2,20,4,6,67,41,26,64
Copenhagen,890,3,14,6,10,62,47,15,48
FC Nords,890,4,13,8,9,74,55,19,47
AaB,890,5,6,15,9,39,45,-6,33
Sonderjyske,890,6,8,6,10,28,29,-1,30
AC Horsens,890,7,5,14,11,34,57,-23,29
Randers FC,890,8,6,6,12,25,40,-15,24
Silkeborg IF,890,9,6,3,13,31,44,-13,21
Lyngby,890,10,3,9,12,27,46,-19,18
AGF Aarhus,890,11,4,6,12,16,42,-26,18
Brondby,891,1,21,6,3,74,33,41,69
FC Midtjylla,891,2,19,5,6,65,38,27,62
FC Nords,891,3,15,6,9,72,52,20,51
Copenhagen,891,4,14,5,11,61,45,16,47
AaB,891,5,7,13,10,37,45,-8,34
AC Horsens,891,6,6,13,11,31,53,-22,31
Sonderjyske,891,7,8,6,10,28,29,-1,30
Lyngby,891,8,4,9,11,27,44,-17,21
Randers FC,891,9,5,6,13,23,40,-17,21
Silkeborg IF,891,10,5,4,13,26,45,-19,19
AGF Aarhus,891,11,4,7,11,17,37,-20,19
Brondby,892,1,20,6,4,73,34,39,66
FC Midtjylla,892,2,19,7,4,73,42,31,64
Copenhagen,892,3,15,6,9,60,44,16,51
FC Nords,892,4,12,9,9,70,55,15,45
AC Horsens,892,5,7,13,10,37,54,-17,34
AaB,892,6,6,13,11,33,43,-10,31
Sonderjyske,892,7,8,6,10,28,29,-1,30
Lyngby,892,8,4,9,11,28,44,-16,21
Randers FC,892,9,5,6,13,23,41,-18,21
AGF Aarhus,892,10,5,6,11,18,37,-19,21
Silkeborg IF,892,11,5,3,14,26,46,-20,18
Brondby,893,1,21,7,2,68,29,39,70
FC Midtjylla,893,2,20,4,6,69,38,31,64
FC Nords,893,3,13,9,8,73,54,19,48
Copenhagen,893,4,14,5,11,61,43,18,47
AaB,893,5,8,12,10,38,43,-5,36
Sonderjyske,893,6,8,6,10,28,29,-1,30
AC Horsens,893,7,5,13,12,32,60,-28,28
Lyngby,893,8,4,9,11,31,45,-14,21
Randers FC,893,9,5,6,13,24,44,-20,21
Silkeborg IF,893,10,5,4,13,25,44,-19,19
AGF Aarhus,893,11,4,7,11,16,36,-20,19
Brondby,894,1,22,5,3,70,34,36,71
FC Midtjylla,894,2,19,7,4,68,39,29,64
FC Nords,894,3,15,7,8,76,49,27,52
Copenhagen,894,4,14,4,12,53,44,9,46
AC Horsens,894,5,6,13,11,39,54,-15,31
Sonderjyske,894,6,8,6,10,28,29,-1,30
AaB,894,7,6,12,12,34,46,-12,30
Lyngby,894,8,4,9,11,27,44,-17,21
Randers FC,894,9,5,6,13,23,40,-17,21
Silkeborg IF,894,10,5,4,13,26,45,-19,19
AGF Aarhus,894,11,4,7,11,17,37,-20,19
Brondby,895,1,22,6,2,72,33,39,72
FC Midtjylla,895,2,18,5,7,62,40,22,59
FC Nords,895,3,15,6,9,74,49,25,51
AaB,895,4,10,12,8,40,38,2,42
Copenhagen,895,5,12,5,13,52,46,6,41
Sonderjyske,895,6,8,6,10,28,29,-1,30
AC Horsens,895,7,5,14,11,32,52,-20,29
Lyngby,895,8,4,9,11,30,45,-15,21
Silkeborg IF,895,9,6,3,13,27,45,-18,21
Randers FC,895,10,5,6,13,24,43,-19,21
AGF Aarhus,895,11,4,6,12,17,38,-21,18
FC Midtjylla,896,1,20,4,6,67,40,27,64
Brondby,896,2,19,5,6,69,38,31,62
Copenhagen,896,3,15,4,11,58,44,14,49
FC Nords,896,4,14,6,10,70,54,16,48
AaB,896,5,10,11,9,41,40,1,41
AC Horsens,896,6,7,12,11,41,56,-15,33
Sonderjyske,896,7,8,6,10,28,29,-1,30
Silkeborg IF,896,8,6,3,13,30,45,-15,21
Lyngby,896,9,4,9,11,29,45,-16,21
Randers FC,896,10,5,6,13,24,42,-18,21
AGF Aarhus,896,11,4,6,12,17,41,-24,18
Brondby,897,1,20,6,4,68,32,36,66
FC Midtjylla,897,2,20,5,5,65,40,25,65
FC Nords,897,3,15,7,8,75,47,28,52
Copenhagen,897,4,14,7,9,57,41,16,49
AC Horsens,897,5,6,13,11,35,53,-18,31
Sonderjyske,897,6,8,6,10,28,29,-1,30
AaB,897,7,6,12,12,35,48,-13,30
Randers FC,897,8,6,6,12,24,39,-15,24
Silkeborg IF,897,9,5,4,13,26,45,-19,19
AGF Aarhus,897,10,4,7,11,17,37,-20,19
Lyngby,897,11,3,9,12,26,45,-19,18
Brondby,898,1,22,6,2,76,31,45,72
FC Midtjylla,898,2,21,4,5,69,39,30,67
FC Nords,898,3,13,7,10,69,53,16,46
Copenhagen,898,4,12,5,13,54,45,9,41
AC Horsens,898,5,7,14,9,36,53,-17,35
AaB,898,6,7,12,11,34,43,-9,33
Sonderjyske,898,7,8,6,10,28,29,-1,30
Lyngby,898,8,4,9,11,28,44,-16,21
Silkeborg IF,898,9,6,3,13,26,44,-18,21
Randers FC,898,10,5,6,13,23,41,-18,21
AGF Aarhus,898,11,4,6,12,16,37,-21,18
Brondby,899,1,21,6,3,73,33,40,69
FC Midtjylla,899,2,20,4,6,65,41,24,64
FC Nords,899,3,15,7,8,76,48,28,52
Copenhagen,899,4,12,5,13,52,50,2,41
AaB,899,5,8,13,9,38,41,-3,37
AC Horsens,899,6,6,13,11,38,55,-17,31
Sonderjyske,899,7,8,6,10,28,29,-1,30
Randers FC,899,8,6,6,12,24,39,-15,24
Silkeborg IF,899,9,6,3,13,27,45,-18,21
Lyngby,899,10,3,9,12,26,45,-19,18
AGF Aarhus,899,11,4,6,12,17,38,-21,18
Brondby,900,1,21,5,4,69,35,34,68
FC Midtjylla,900,2,20,5,5,69,41,28,65
FC Nords,900,3,14,6,10,73,50,23,48
Copenhagen,900,4,14,6,10,61,48,13,48
AC Horsens,900,5,7,14,9,36,50,-14,35
Sonderjyske,900,6,8,6,10,28,29,-1,30
AaB,900,7,6,12,12,34,44,-10,30
Lyngby,900,8,4,9,11,28,44,-16,21
Randers FC,900,9,5,6,13,23,41,-18,21
AGF Aarhus,900,10,5,6,11,18,37,-19,21
Silkeborg IF,900,11,5,3,14,26,46,-20,18
Brondby,901,1,20,6,4,73,35,38,66
FC Midtjylla,901,2,19,7,4,66,39,27,64
FC Nords,901,3,14,7,9,70,49,21,49
Copenhagen,901,4,13,8,9,59,45,14,47
AaB,901,5,7,13,10,39,45,-6,34
Sonderjyske,901,6,8,6,10,28,29,-1,30
AC Horsens,901,7,5,15,10,37,57,-20,30
Lyngby,901,8,4,9,11,29,45,-16,21
Randers FC,901,9,5,6,13,24,42,-18,21
AGF Aarhus,901,10,5,6,11,20,39,-19,21
Silkeborg IF,901,11,5,3,14,28,48,-20,18
Brondby,902,1,22,6,2,74,31,43,72
FC Midtjylla,902,2,18,7,5,63,40,23,61
FC Nords,902,3,14,8,8,75,49,26,50
Copenhagen,902,4,13,6,11,54,42,12,45
AaB,902,5,7,14,9,36,40,-4,35
Sonderjyske,902,6,8,6,10,28,29,-1,30
AC Horsens,902,7,5,13,12,33,59,-26,28
Randers FC,902,8,6,6,12,25,39,-14,24
Silkeborg IF,902,9,6,3,13,27,44,-17,21
Lyngby,902,10,3,9,12,26,46,-20,18
AGF Aarhus,902,11,4,6,12,16,38,-22,18
Brondby,903,1,21,7,2,75,31,44,70
FC Midtjylla,903,2,19,4,7,70,44,26,61
FC Nords,903,3,15,7,8,80,53,27,52
Copenhagen,903,4,14,5,11,56,47,9,47
AaB,903,5,8,11,11,38,48,-10,35
Sonderjyske,903,6,8,6,10,28,29,-1,30
AC Horsens,903,7,5,14,11,33,55,-22,29
Randers FC,903,8,6,6,12,28,40,-12,24
Silkeborg IF,903,9,6,3,13,27,45,-18,21
AGF Aarhus,903,10,4,6,12,17,38,-21,18
Lyngby,903,11,3,9,12,27,49,-22,18
Brondby,904,1,19,6,5,68,36,32,63
FC Midtjylla,904,2,19,4,7,65,39,26,61
FC Nords,904,3,14,7,9,73,51,22,49
Copenhagen,904,4,13,7,10,59,44,15,46
AaB,904,5,11,11,8,40,38,2,44
AC Horsens,904,6,6,13,11,36,59,-23,31
Sonderjyske,904,7,8,6,10,28,29,-1,30
Randers FC,904,8,6,6,12,25,40,-15,24
Silkeborg IF,904,9,6,3,13,27,45,-18,21
Lyngby,904,10,3,9,12,27,46,-19,18
AGF Aarhus,904,11,4,6,12,17,38,-21,18
Brondby,905,1,20,6,4,72,36,36,66
FC Midtjylla,905,2,20,5,5,68,40,28,65
FC Nords,905,3,15,6,9,72,48,24,51
Copenhagen,905,4,15,4,11,60,47,13,49
AaB,905,5,9,11,10,40,42,-2,38
Sonderjyske,905,6,8,6,10,28,29,-1,30
AC Horsens,905,7,5,12,13,33,58,-25,27
Lyngby,905,8,4,9,11,29,45,-16,21
Silkeborg IF,905,9,6,3,13,27,44,-17,21
Randers FC,905,10,5,6,13,24,42,-18,21
AGF Aarhus,905,11,4,6,12,16,38,-22,18
Brondby,906,1,19,7,4,67,33,34,64
FC Midtjylla,906,2,18,7,5,63,39,24,61
Copenhagen,906,3,14,6,10,60,47,13,48
FC Nords,906,4,13,7,10,74,55,19,46
AaB,906,5,7,15,8,36,38,-2,36
AC Horsens,906,6,7,14,9,38,52,-14,35
Sonderjyske,906,7,8,6,10,28,29,-1,30
Randers FC,906,8,6,6,12,26,40,-14,24
Silkeborg IF,906,9,5,4,13,25,44,-19,19
AGF Aarhus,906,10,4,7,11,16,36,-20,19
Lyngby,906,11,3,9,12,27,47,-20,18
Brondby,907,1,20,6,4,71,37,34,66
FC Midtjylla,907,2,18,5,7,63,40,23,59
FC Nords,907,3,15,6,9,74,53,21,51
Copenhagen,907,4,14,5,11,61,48,13,47
AC Horsens,907,5,8,12,10,36,51,-15,36
AaB,907,6,7,14,9,37,39,-2,35
Sonderjyske,907,7,8,6,10,28,29,-1,30
Randers FC,907,8,6,6,12,27,39,-12,24
Silkeborg IF,907,9,5,4,13,27,46,-19,19
AGF Aarhus,907,10,4,7,11,18,38,-20,19
Lyngby,907,11,3,9,12,26,48,-22,18
Brondby,908,1,19,6,5,70,39,31,63
FC Midtjylla,908,2,19,4,7,65,44,21,61
FC Nords,908,3,16,7,7,74,46,28,55
Copenhagen,908,4,15,5,10,61,44,17,50
AaB,908,5,8,11,11,37,42,-5,35
AC Horsens,908,6,6,13,11,37,55,-18,31
Sonderjyske,908,7,8,6,10,28,29,-1,30
Lyngby,908,8,4,9,11,27,44,-17,21
Randers FC,908,9,5,6,13,23,40,-17,21
Silkeborg IF,908,10,6,3,13,27,45,-18,21
AGF Aarhus,908,11,4,6,12,17,38,-21,18
FC Midtjylla,909,1,20,5,5,67,42,25,65
Brondby,909,2,18,8,4,67,35,32,62
Copenhagen,909,3,15,5,10,61,43,18,50
FC Nords,909,4,14,7,9,74,53,21,49
AaB,909,5,8,13,9,38,40,-2,37
Sonderjyske,909,6,8,6,10,28,29,-1,30
AC Horsens,909,7,5,14,11,32,52,-20,29
Lyngby,909,8,4,9,11,28,45,-17,21
Randers FC,909,9,5,6,13,24,41,-17,21
Silkeborg IF,909,10,6,3,13,27,45,-18,21
AGF Aarhus,909,11,4,6,12,17,38,-21,18
Brondby,910,1,20,6,4,68,35,33,66
FC Midtjylla,910,2,20,5,5,66,41,25,65
FC Nords,910,3,16,6,8,74,46,28,54
Copenhagen,910,4,14,4,12,60,47,13,46
AaB,910,5,8,11,11,37,42,-5,35
Sonderjyske,910,6,8,6,10,28,29,-1,30
AC Horsens,910,7,6,12,12,34,54,-20,30
Randers FC,910,8,5,7,12,23,39,-16,22
Lyngby,910,9,3,10,11,26,44,-18,19
Silkeborg IF,910,10,5,4,13,25,44,-19,19
AGF Aarhus,910,11,4,7,11,16,36,-20,19
FC Midtjylla,911,1,20,4,6,68,40,28,64
Brondby,911,2,18,7,5,66,35,31,61
FC Nords,911,3,15,7,8,79,54,25,52
Copenhagen,911,4,14,4,12,59,48,11,46
AaB,911,5,8,13,9,38,43,-5,37
AC Horsens,911,6,7,13,10,35,51,-16,34
Sonderjyske,911,7,8,6,10,28,29,-1,30
Randers FC,911,8,5,7,12,24,40,-16,22
AGF Aarhus,911,9,5,6,11,17,36,-19,21
Lyngby,911,10,3,10,11,27,45,-18,19
Silkeborg IF,911,11,5,3,14,25,45,-20,18
Brondby,912,1,21,6,3,73,35,38,69
FC Midtjylla,912,2,20,4,6,66,36,30,64
Copenhagen,912,3,14,6,10,56,42,14,48
FC Nords,912,4,13,7,10,76,60,16,46
AaB,912,5,8,13,9,38,41,-3,37
Sonderjyske,912,6,8,6,10,28,29,-1,30
AC Horsens,912,7,5,14,11,35,56,-21,29
Lyngby,912,8,4,9,11,27,44,-17,21
Silkeborg IF,912,8,6,3,13,27,44,-17,21
Randers FC,912,10,5,6,13,23,40,-17,21
AGF Aarhus,912,11,4,6,12,16,38,-22,18
Brondby,913,1,20,7,3,67,31,36,67
FC Midtjylla,913,2,19,5,6,66,41,25,62
FC Nords,913,3,14,7,9,73,55,18,49
Copenhagen,913,4,13,6,11,62,50,12,45
AaB,913,5,8,13,9,41,42,-1,37
AC Horsens,913,6,6,14,10,38,54,-16,32
Sonderjyske,913,7,8,6,10,28,29,-1,30
Lyngby,913,8,4,9,11,28,45,-17,21
Silkeborg IF,913,8,6,3,13,28,45,-17,21
Randers FC,913,10,5,6,13,24,41,-17,21
AGF Aarhus,913,11,4,6,12,17,39,-22,18
Brondby,914,1,21,6,3,69,29,40,69
FC Midtjylla,914,2,20,4,6,71,39,32,64
FC Nords,914,3,13,8,9,69,53,16,47
Copenhagen,914,4,14,4,12,57,45,12,46
AaB,914,5,9,11,10,38,46,-8,38
AC Horsens,914,6,6,13,11,34,52,-18,31
Sonderjyske,914,7,8,6,10,28,29,-1,30
Randers FC,914,8,6,6,12,25,40,-15,24
Silkeborg IF,914,9,5,4,13,26,45,-19,19
AGF Aarhus,914,10,4,7,11,17,37,-20,19
Lyngby,914,11,3,9,12,27,46,-19,18
Brondby,915,1,22,6,2,71,30,41,72
FC Midtjylla,915,2,20,5,5,68,38,30,65
FC Nords,915,3,15,6,9,76,52,24,51
Copenhagen,915,4,12,6,12,53,46,7,42
AaB,915,5,7,12,11,36,44,-8,33
AC Horsens,915,6,6,13,11,35,55,-20,31
Sonderjyske,915,7,8,6,10,28,29,-1,30
Lyngby,915,8,4,9,11,31,45,-14,21
Silkeborg IF,915,9,6,3,13,27,45,-18,21
Randers FC,915,10,5,6,13,24,44,-20,21
AGF Aarhus,915,11,4,6,12,17,38,-21,18
Brondby,916,1,20,6,4,66,31,35,66
FC Midtjylla,916,2,20,4,6,67,42,25,64
FC Nords,916,3,13,8,9,72,55,17,47
Copenhagen,916,4,14,5,11,57,43,14,47
AC Horsens,916,5,8,12,10,39,51,-12,36
AaB,916,6,7,13,10,37,42,-5,34
Sonderjyske,916,7,8,6,10,28,29,-1,30
Randers FC,916,8,5,7,12,24,40,-16,22
AGF Aarhus,916,9,5,6,11,17,36,-19,21
Lyngby,916,10,3,10,11,27,45,-18,19
Silkeborg IF,916,11,5,3,14,25,45,-20,18
FC Midtjylla,917,1,21,4,5,65,37,28,67
Brondby,917,2,19,6,5,65,34,31,63
FC Nords,917,3,15,6,9,73,50,23,51
Copenhagen,917,4,15,5,10,55,39,16,50
AC Horsens,917,5,7,13,10,37,51,-14,34
Sonderjyske,917,6,8,6,10,28,29,-1,30
AaB,917,7,6,12,12,35,45,-10,30
Randers FC,917,8,6,6,12,24,39,-15,24
AGF Aarhus,917,9,5,6,11,20,36,-16,21
Lyngby,917,10,3,9,12,26,45,-19,18
Silkeborg IF,917,11,5,3,14,25,48,-23,18
Brondby,918,1,20,6,4,67,31,36,66
FC Midtjylla,918,2,20,5,5,77,40,37,65
Copenhagen,918,3,15,5,10,60,43,17,50
FC Nords,918,4,14,7,9,75,59,16,49
AaB,918,5,7,12,11,39,48,-9,33
AC Horsens,918,6,6,13,11,33,56,-23,31
Sonderjyske,918,7,8,6,10,28,29,-1,30
Lyngby,918,8,4,9,11,27,44,-17,21
Randers FC,918,9,5,6,13,23,40,-17,21
AGF Aarhus,918,10,5,6,11,17,36,-19,21
Silkeborg IF,918,11,5,3,14,25,45,-20,18
Brondby,919,1,21,6,3,70,33,37,69
FC Midtjylla,919,2,19,5,6,67,40,27,62
FC Nords,919,3,13,9,8,69,48,21,48
Copenhagen,919,4,14,4,12,55,45,10,46
AC Horsens,919,5,8,12,10,36,50,-14,36
AaB,919,6,7,12,11,38,45,-7,33
Sonderjyske,919,7,8,6,10,28,29,-1,30
Randers FC,919,8,5,7,12,23,39,-16,22
Silkeborg IF,919,9,6,3,13,27,45,-18,21
Lyngby,919,10,3,10,11,26,44,-18,19
AGF Aarhus,919,11,4,6,12,17,38,-21,18
FC Midtjylla,920,1,21,5,4,71,38,33,68
Brondby,920,2,20,7,3,73,31,42,67
FC Nords,920,3,15,6,9,71,49,22,51
Copenhagen,920,4,12,6,12,57,50,7,42
AaB,920,5,7,12,11,37,49,-12,33
AC Horsens,920,6,6,14,10,33,51,-18,32
Sonderjyske,920,7,8,6,10,28,29,-1,30
Randers FC,920,8,6,6,12,25,40,-15,24
Silkeborg IF,920,9,6,3,13,28,44,-16,21
Lyngby,920,10,3,9,12,27,46,-19,18
AGF Aarhus,920,11,4,6,12,16,39,-23,18
FC Midtjylla,921,1,20,6,4,70,38,32,66
Brondby,921,2,19,7,4,73,39,34,64
FC Nords,921,3,15,8,7,81,52,29,53
Copenhagen,921,4,12,6,12,54,46,8,42
AaB,921,5,8,12,10,35,44,-9,36
AC Horsens,921,6,6,13,11,35,55,-20,31
Sonderjyske,921,7,8,6,10,28,29,-1,30
Lyngby,921,8,4,9,11,30,45,-15,21
Silkeborg IF,921,9,6,3,13,27,44,-17,21
Randers FC,921,10,5,6,13,24,43,-19,21
AGF Aarhus,921,11,4,6,12,16,38,-22,18
Brondby,922,1,21,7,2,70,31,39,70
FC Midtjylla,922,2,19,5,6,66,41,25,62
Copenhagen,922,3,15,5,10,63,41,22,50
FC Nords,922,4,14,8,8,73,53,20,50
AaB,922,5,7,12,11,38,47,-9,33
Sonderjyske,922,6,8,6,10,28,29,-1,30
AC Horsens,922,7,5,13,12,37,60,-23,28
Lyngby,922,8,4,9,11,27,44,-17,21
Randers FC,922,9,5,6,13,23,40,-17,21
Silkeborg IF,922,10,6,3,13,28,46,-18,21
AGF Aarhus,922,11,4,6,12,18,39,-21,18
Brondby,923,1,21,5,4,73,35,38,68
FC Midtjylla,923,2,20,5,5,69,42,27,65
FC Nords,923,3,15,6,9,76,51,25,51
Copenhagen,923,4,14,4,12,57,46,11,46
AaB,923,5,7,12,11,36,45,-9,33
AC Horsens,923,6,6,14,10,36,54,-18,32
Sonderjyske,923,7,8,6,10,28,29,-1,30
Lyngby,923,8,4,9,11,29,45,-16,21
Silkeborg IF,923,9,6,3,13,26,44,-18,21
Randers FC,923,10,5,6,13,24,42,-18,21
AGF Aarhus,923,11,4,6,12,16,37,-21,18
Brondby,924,1,21,5,4,73,35,38,68
FC Midtjylla,924,2,20,4,6,67,41,26,64
Copenhagen,924,3,14,6,10,63,49,14,48
FC Nords,924,4,12,7,11,73,59,14,43
AaB,924,5,9,12,9,37,38,-1,39
AC Horsens,924,6,7,12,11,36,53,-17,33
Sonderjyske,924,7,8,6,10,28,29,-1,30
Randers FC,924,8,5,7,12,24,40,-16,22
AGF Aarhus,924,9,5,6,11,17,36,-19,21
Lyngby,924,10,3,10,11,27,45,-18,19
Silkeborg IF,924,11,5,3,14,25,45,-20,18
Brondby,925,1,21,5,4,71,37,34,68
FC Midtjylla,925,2,21,4,5,68,37,31,67
FC Nords,925,3,15,7,8,77,49,28,52
Copenhagen,925,4,13,5,12,57,48,9,44
AaB,925,5,7,13,10,37,40,-3,34
Sonderjyske,925,6,8,6,10,28,29,-1,30
AC Horsens,925,7,6,12,12,34,59,-25,30
Lyngby,925,8,4,9,11,29,44,-15,21
Silkeborg IF,925,9,6,3,13,27,45,-18,21
Randers FC,925,10,5,6,13,23,42,-19,21
AGF Aarhus,925,11,4,6,12,17,38,-21,18
Brondby,926,1,20,6,4,68,31,37,66
FC Midtjylla,926,2,20,5,5,71,39,32,65
FC Nords,926,3,13,7,10,71,54,17,46
Copenhagen,926,4,12,6,12,55,48,7,42
AaB,926,5,10,11,9,42,46,-4,41
AC Horsens,926,6,6,15,9,36,51,-15,33
Sonderjyske,926,7,8,6,10,28,29,-1,30
Lyngby,926,8,4,9,11,28,44,-16,21
Silkeborg IF,926,9,6,3,13,27,45,-18,21
Randers FC,926,10,5,6,13,23,41,-18,21
AGF Aarhus,926,11,4,6,12,17,38,-21,18
Brondby,927,1,21,5,4,73,33,40,68
FC Midtjylla,927,2,20,5,5,66,38,28,65
Copenhagen,927,3,15,5,10,62,42,20,50
FC Nords,927,4,12,7,11,67,57,10,43
AC Horsens,927,5,7,14,9,36,49,-13,35
AaB,927,6,6,14,10,37,48,-11,32
Sonderjyske,927,7,8,6,10,28,29,-1,30
Lyngby,927,8,4,9,11,27,44,-17,21
Silkeborg IF,927,8,6,3,13,27,44,-17,21
Randers FC,927,10,5,6,13,23,40,-17,21
AGF Aarhus,927,11,4,6,12,16,38,-22,18
Brondby,928,1,21,6,3,69,32,37,69
FC Midtjylla,928,2,19,5,6,68,42,26,62
FC Nords,928,3,14,6,10,73,51,22,48
Copenhagen,928,4,14,6,10,58,45,13,48
AaB,928,5,8,12,10,39,42,-3,36
AC Horsens,928,6,6,13,11,31,52,-21,31
Sonderjyske,928,7,8,6,10,28,29,-1,30
Randers FC,928,8,6,6,12,26,39,-13,24
Silkeborg IF,928,9,5,4,13,26,45,-19,19
AGF Aarhus,928,10,4,7,11,17,37,-20,19
Lyngby,928,11,3,9,12,26,47,-21,18
Brondby,929,1,21,6,3,71,31,40,69
FC Midtjylla,929,2,21,4,5,66,36,30,67
FC Nords,929,3,14,7,9,74,55,19,49
Copenhagen,929,4,14,5,11,56,46,10,47
AC Horsens,929,5,6,14,10,34,50,-16,32
Sonderjyske,929,6,8,6,10,28,29,-1,30
AaB,929,7,6,12,12,34,43,-9,30
Randers FC,929,8,5,7,12,24,40,-16,22
Silkeborg IF,929,9,6,3,13,28,46,-18,21
Lyngby,929,10,3,10,11,27,45,-18,19
AGF Aarhus,929,11,4,6,12,18,39,-21,18
Brondby,930,1,21,7,2,76,34,42,70
FC Midtjylla,930,2,19,5,6,67,40,27,62
FC Nords,930,3,13,7,10,73,57,16,46
Copenhagen,930,4,13,6,11,58,47,11,45
AaB,930,5,8,13,9,37,41,-4,37
AC Horsens,930,6,6,14,10,37,55,-18,32
Sonderjyske,930,7,8,6,10,28,29,-1,30
Randers FC,930,8,5,7,12,25,41,-16,22
Silkeborg IF,930,9,6,3,13,26,44,-18,21
Lyngby,930,10,3,10,11,28,46,-18,19
AGF Aarhus,930,11,4,6,12,16,37,-21,18
Brondby,931,1,21,5,4,73,37,36,68
FC Midtjylla,931,2,19,5,6,68,41,27,62
FC Nords,931,3,15,6,9,75,53,22,51
Copenhagen,931,4,13,6,11,60,48,12,45
AC Horsens,931,5,7,14,9,37,53,-16,35
AaB,931,6,7,12,11,35,42,-7,33
Sonderjyske,931,7,8,6,10,28,29,-1,30
Lyngby,931,8,4,9,11,27,44,-17,21
Randers FC,931,9,5,6,13,23,40,-17,21
AGF Aarhus,931,10,5,6,11,18,37,-19,21
Silkeborg IF,931,11,5,3,14,26,46,-20,18
Brondby,932,1,20,6,4,70,35,35,66
FC Midtjylla,932,2,20,5,5,69,39,30,65
FC Nords,932,3,15,7,8,74,50,24,52
Copenhagen,932,4,15,6,9,63,45,18,51
AC Horsens,932,5,6,13,11,36,57,-21,31
Sonderjyske,932,6,8,6,10,28,29,-1,30
AaB,932,7,6,11,13,36,48,-12,29
Silkeborg IF,932,8,6,3,13,29,44,-15,21
Lyngby,932,9,4,9,11,29,46,-17,21
Randers FC,932,10,5,6,13,25,42,-17,21
AGF Aarhus,932,11,4,6,12,16,40,-24,18
Brondby,933,1,19,7,4,69,36,33,64
FC Midtjylla,933,2,19,6,5,66,37,29,63
FC Nords,933,3,16,7,7,77,48,29,55
Copenhagen,933,4,14,5,11,54,43,11,47
AaB,933,5,8,11,11,35,42,-7,35
Sonderjyske,933,6,8,6,10,28,29,-1,30
AC Horsens,933,7,5,14,11,33,54,-21,29
Lyngby,933,8,4,9,11,29,45,-16,21
Randers FC,933,9,5,6,13,24,42,-18,21
AGF Aarhus,933,10,5,6,11,18,37,-19,21
Silkeborg IF,933,11,5,3,14,26,46,-20,18
FC Midtjylla,934,1,22,4,4,67,37,30,70
Brondby,934,2,20,6,4,70,35,35,66
FC Nords,934,3,14,8,8,74,49,25,50
Copenhagen,934,4,12,6,12,57,50,7,42
AaB,934,5,7,13,10,41,43,-2,34
AC Horsens,934,6,6,13,11,35,56,-21,31
Sonderjyske,934,7,8,6,10,28,29,-1,30
Randers FC,934,8,6,6,12,25,40,-15,24
Silkeborg IF,934,9,6,3,13,27,45,-18,21
Lyngby,934,10,3,9,12,27,46,-19,18
AGF Aarhus,934,11,4,6,12,17,38,-21,18
Brondby,935,1,21,6,3,74,33,41,69
FC Midtjylla,935,2,20,4,6,67,42,25,64
FC Nords,935,3,15,7,8,74,48,26,52
Copenhagen,935,4,14,4,12,59,48,11,46
AC Horsens,935,5,8,12,10,40,54,-14,36
Sonderjyske,935,6,8,6,10,28,29,-1,30
AaB,935,7,6,11,13,36,51,-15,29
Lyngby,935,8,4,9,11,28,45,-17,21
Randers FC,935,9,5,6,13,24,41,-17,21
Silkeborg IF,935,10,5,4,13,26,45,-19,19
AGF Aarhus,935,11,4,7,11,17,37,-20,19
Brondby,936,1,20,6,4,69,36,33,66
FC Midtjylla,936,2,20,5,5,71,41,30,65
Copenhagen,936,3,15,5,10,60,45,15,50
FC Nords,936,4,14,6,10,81,51,30,48
AaB,936,5,9,11,10,39,46,-7,38
Sonderjyske,936,6,8,6,10,28,29,-1,30
AC Horsens,936,7,5,13,12,32,59,-27,28
Randers FC,936,8,5,7,12,24,40,-16,22
Silkeborg IF,936,9,6,3,13,28,45,-17,21
Lyngby,936,10,3,10,11,27,45,-18,19
AGF Aarhus,936,11,4,6,12,17,39,-22,18
FC Midtjylla,937,1,21,5,4,74,35,39,68
Brondby,937,2,20,6,4,70,37,33,66
FC Nords,937,3,14,7,9,73,52,21,49
Copenhagen,937,4,14,4,12,56,44,12,46
AaB,937,5,8,12,10,38,44,-6,36
Sonderjyske,937,6,8,6,10,28,29,-1,30
AC Horsens,937,7,6,12,12,32,57,-25,30
Lyngby,937,8,4,9,11,29,45,-16,21
Randers FC,937,9,5,6,13,24,42,-18,21
AGF Aarhus,937,10,5,6,11,18,36,-18,21
Silkeborg IF,937,11,5,3,14,25,46,-21,18
Brondby,938,1,21,7,2,74,30,44,70
FC Midtjylla,938,2,18,4,8,65,46,19,58
FC Nords,938,3,15,7,8,75,54,21,52
Copenhagen,938,4,14,5,11,64,49,15,47
AaB,938,5,9,12,9,41,45,-4,39
Sonderjyske,938,6,8,6,10,28,29,-1,30
AC Horsens,938,7,5,13,12,34,55,-21,28
Randers FC,938,8,5,7,12,24,40,-16,22
Silkeborg IF,938,9,6,3,13,28,46,-18,21
Lyngby,938,10,3,10,11,27,45,-18,19
AGF Aarhus,938,11,4,6,12,18,39,-21,18
Brondby,939,1,20,7,3,72,35,37,67
FC Midtjylla,939,2,20,6,4,70,36,34,66
FC Nords,939,3,14,8,8,74,53,21,50
Copenhagen,939,4,14,5,11,57,45,12,47
AC Horsens,939,5,7,12,11,36,57,-21,33
Sonderjyske,939,6,8,6,10,28,29,-1,30
AaB,939,7,6,12,12,36,45,-9,30
Randers FC,939,8,6,6,12,26,39,-13,24
Silkeborg IF,939,9,6,3,13,27,45,-18,21
Lyngby,939,10,3,9,12,26,47,-21,18
AGF Aarhus,939,11,4,6,12,17,38,-21,18
Brondby,940,1,22,5,3,83,35,48,71
FC Midtjylla,940,2,20,5,5,62,36,26,65
Copenhagen,940,3,15,5,10,55,40,15,50
FC Nords,940,4,13,7,10,71,56,15,46
AaB,940,5,7,11,12,38,51,-13,32
AC Horsens,940,6,6,13,11,36,53,-17,31
Sonderjyske,940,7,8,6,10,28,29,-1,30
Lyngby,940,8,4,9,11,29,45,-16,21
Randers FC,940,9,5,6,13,24,42,-18,21
Silkeborg IF,940,10,5,4,13,27,46,-19,19
AGF Aarhus,940,11,4,7,11,18,38,-20,19
Brondby,941,1,21,7,2,72,30,42,70
FC Midtjylla,941,2,19,4,7,63,42,21,61
Copenhagen,941,3,15,5,10,61,45,16,50
FC Nords,941,4,13,7,10,75,56,19,46
AC Horsens,941,5,7,14,9,41,53,-12,35
AaB,941,6,7,11,12,32,44,-12,32
Sonderjyske,941,7,8,6,10,28,29,-1,30
Randers FC,941,8,6,6,12,27,39,-12,24
AGF Aarhus,941,9,5,6,11,18,36,-18,21
Silkeborg IF,941,10,5,3,14,25,46,-21,18
Lyngby,941,11,3,9,12,26,48,-22,18
Brondby,942,1,20,5,5,68,33,35,65
FC Midtjylla,942,2,20,5,5,67,38,29,65
FC Nords,942,3,16,6,8,76,49,27,54
Copenhagen,942,4,13,5,12,54,44,10,44
AaB,942,5,8,12,10,38,48,-10,36
AC Horsens,942,6,6,13,11,34,51,-17,31
Sonderjyske,942,7,8,6,10,28,29,-1,30
Randers FC,942,8,5,7,12,24,40,-16,22
Silkeborg IF,942,9,6,3,13,27,44,-17,21
Lyngby,942,10,3,10,11,27,45,-18,19
AGF Aarhus,942,11,4,6,12,16,38,-22,18
Brondby,943,1,22,5,3,77,33,44,71
FC Midtjylla,943,2,19,6,5,64,40,24,63
FC Nords,943,3,14,6,10,73,52,21,48
Copenhagen,943,4,13,6,11,57,48,9,45
AC Horsens,943,5,7,14,9,35,51,-16,35
AaB,943,6,7,11,12,38,46,-8,32
Sonderjyske,943,7,8,6,10,28,29,-1,30
Randers FC,943,8,5,7,12,24,40,-16,22
AGF Aarhus,943,9,5,6,11,18,37,-19,21
Lyngby,943,10,3,10,11,27,45,-18,19
Silkeborg IF,943,11,5,3,14,26,46,-20,18
Brondby,944,1,22,5,3,74,31,43,71
FC Midtjylla,944,2,19,4,7,67,43,24,61
FC Nords,944,3,16,7,7,81,49,32,55
Copenhagen,944,4,13,7,10,59,47,12,46
AaB,944,5,6,13,11,34,46,-12,31
Sonderjyske,944,6,8,6,10,28,29,-1,30
AC Horsens,944,7,5,14,11,34,59,-25,29
Randers FC,944,8,5,7,12,24,40,-16,22
Silkeborg IF,944,9,6,3,13,27,45,-18,21
Lyngby,944,10,3,10,11,27,45,-18,19
AGF Aarhus,944,11,4,6,12,17,38,-21,18
Brondby,945,1,22,5,3,73,32,41,71
FC Midtjylla,945,2,21,4,5,68,38,30,67
FC Nords,945,3,14,6,10,69,50,19,48
Copenhagen,945,4,13,5,12,56,44,12,44
AaB,945,5,8,12,10,37,44,-7,36
Sonderjyske,945,6,8,6,10,28,29,-1,30
AC Horsens,945,7,6,12,12,34,55,-21,30
Randers FC,945,8,6,6,12,24,39,-15,24
Silkeborg IF,945,9,6,3,13,26,44,-18,21
Lyngby,945,10,3,9,12,26,45,-19,18
AGF Aarhus,945,11,4,6,12,16,37,-21,18
FC Midtjylla,946,1,20,4,6,65,39,26,64
Brondby,946,2,19,6,5,68,38,30,63
FC Nords,946,3,14,8,8,76,52,24,50
Copenhagen,946,4,14,4,12,58,48,10,46
AaB,946,5,9,11,10,38,40,-2,38
AC Horsens,946,6,7,13,10,38,52,-14,34
Sonderjyske,946,7,8,6,10,28,29,-1,30
Lyngby,946,8,4,9,11,28,44,-16,21
Randers FC,946,9,5,6,13,23,41,-18,21
AGF Aarhus,946,10,5,6,11,18,37,-19,21
Silkeborg IF,946,11,5,3,14,26,46,-20,18
Brondby,947,1,21,7,2,74,30,44,70
FC Midtjylla,947,2,20,6,4,67,37,30,66
FC Nords,947,3,14,7,9,76,53,23,49
Copenhagen,947,4,12,6,12,54,51,3,42
AaB,947,5,8,13,9,38,43,-5,37
Sonderjyske,947,6,8,6,10,28,29,-1,30
AC Horsens,947,7,5,13,12,33,54,-21,28
Lyngby,947,8,4,9,11,29,44,-15,21
Silkeborg IF,947,9,6,3,13,26,44,-18,21
Randers FC,947,10,5,6,13,23,42,-19,21
AGF Aarhus,947,11,4,6,12,16,37,-21,18
Brondby,948,1,20,7,3,75,36,39,67
FC Midtjylla,948,2,20,4,6,67,39,28,64
Copenhagen,948,3,16,4,10,61,42,19,52
FC Nords,948,4,14,8,8,80,56,24,50
AaB,948,5,6,14,10,35,45,-10,32
Sonderjyske,948,6,8,6,10,28,29,-1,30
AC Horsens,948,7,5,13,12,35,61,-26,28
Randers FC,948,8,5,7,12,25,41,-16,22
Silkeborg IF,948,9,6,3,13,26,44,-18,21
Lyngby,948,10,3,10,11,28,46,-18,19
AGF Aarhus,948,11,4,6,12,16,37,-21,18
Brondby,949,1,23,5,2,73,28,45,74
FC Midtjylla,949,2,21,4,5,68,36,32,67
FC Nords,949,3,13,6,11,70,56,14,45
Copenhagen,949,4,13,4,13,55,52,3,43
AaB,949,5,8,12,10,40,41,-1,36
AC Horsens,949,6,6,13,11,36,55,-19,31
Sonderjyske,949,7,8,6,10,28,29,-1,30
Randers FC,949,8,6,6,12,24,39,-15,24
Silkeborg IF,949,9,6,3,13,28,45,-17,21
Lyngby,949,10,3,9,12,26,45,-19,18
AGF Aarhus,949,11,4,6,12,17,39,-22,18
Brondby,950,1,22,5,3,72,31,41,71
FC Midtjylla,950,2,19,5,6,63,37,26,62
FC Nords,950,3,14,6,10,75,56,19,48
Copenhagen,950,4,13,6,11,53,43,10,45
AaB,950,5,8,13,9,38,40,-2,37
AC Horsens,950,6,6,13,11,34,54,-20,31
Sonderjyske,950,7,8,6,10,28,29,-1,30
Lyngby,950,8,4,9,11,30,45,-15,21
Randers FC,950,9,5,6,13,24,43,-19,21
Silkeborg IF,950,10,5,4,13,26,45,-19,19
AGF Aarhus,950,11,4,7,11,17,37,-20,19
Brondby,951,1,22,6,2,70,28,42,72
FC Midtjylla,951,2,19,5,6,66,41,25,62
Copenhagen,951,3,14,6,10,60,47,13,48
FC Nords,951,4,13,8,9,77,54,23,47
AaB,951,5,7,14,9,38,44,-6,35
Sonderjyske,951,6,8,6,10,28,29,-1,30
AC Horsens,951,7,5,13,12,33,56,-23,28
Randers FC,951,8,5,7,12,23,39,-16,22
Silkeborg IF,951,9,6,3,13,31,48,-17,21
Lyngby,951,10,3,10,11,26,44,-18,19
AGF Aarhus,951,11,4,6,12,20,42,-22,18
Brondby,952,1,21,5,4,71,35,36,68
FC Midtjylla,952,2,21,4,5,71,36,35,67
FC Nords,952,3,14,6,10,71,57,14,48
Copenhagen,952,4,14,5,11,58,44,14,47
AaB,952,5,7,12,11,36,45,-9,33
AC Horsens,952,6,7,12,11,39,55,-16,33
Sonderjyske,952,7,8,6,10,28,29,-1,30
Lyngby,952,8,4,9,11,27,44,-17,21
Randers FC,952,9,5,6,13,23,40,-17,21
AGF Aarhus,952,10,5,6,11,19,37,-18,21
Silkeborg IF,952,11,5,3,14,26,47,-21,18
Brondby,953,1,20,6,4,69,32,37,66
FC Midtjylla,953,2,18,6,6,60,39,21,60
FC Nords,953,3,14,8,8,73,50,23,50
Copenhagen,953,4,12,7,11,55,46,9,43
AaB,953,5,9,11,10,40,43,-3,38
AC Horsens,953,6,7,14,9,39,52,-13,35
Sonderjyske,953,7,8,6,10,28,29,-1,30
Lyngby,953,8,4,9,11,28,44,-16,21
Randers FC,953,9,5,6,13,23,41,-18,21
AGF Aarhus,953,10,5,6,11,18,36,-18,21
Silkeborg IF,953,11,5,3,14,25,46,-21,18
Brondby,954,1,20,6,4,68,33,35,66
FC Midtjylla,954,2,19,5,6,65,41,24,62
FC Nords,954,3,16,7,7,82,49,33,55
Copenhagen,954,4,12,5,13,52,49,3,41
AC Horsens,954,5,8,12,10,38,54,-16,36
AaB,954,6,7,13,10,40,45,-5,34
Sonderjyske,954,7,8,6,10,28,29,-1,30
Randers FC,954,8,6,6,12,25,40,-15,24
Silkeborg IF,954,9,6,3,13,29,46,-17,21
Lyngby,954,10,3,9,12,27,46,-19,18
AGF Aarhus,954,11,4,6,12,18,40,-22,18
Brondby,955,1,19,6,5,65,33,32,63
FC Midtjylla,955,2,19,4,7,62,36,26,61
FC Nords,955,3,14,6,10,70,52,18,48
Copenhagen,955,4,14,5,11,54,46,8,47
AaB,955,5,9,12,9,36,36,0,39
AC Horsens,955,6,8,13,9,39,49,-10,37
Sonderjyske,955,7,8,6,10,28,29,-1,30
Randers FC,955,8,6,6,12,25,39,-14,24
Silkeborg IF,955,9,6,3,13,28,45,-17,21
Lyngby,955,10,3,9,12,26,46,-20,18
AGF Aarhus,955,11,4,6,12,17,39,-22,18
Brondby,956,1,21,5,4,67,31,36,68
FC Midtjylla,956,2,21,5,4,67,34,33,68
FC Nords,956,3,15,6,9,76,50,26,51
Copenhagen,956,4,12,6,12,52,42,10,42
AaB,956,5,7,12,11,35,47,-12,33
AC Horsens,956,6,7,12,11,34,53,-19,33
Sonderjyske,956,7,8,6,10,28,29,-1,30
Silkeborg IF,956,8,6,3,13,28,44,-16,21
Lyngby,956,9,4,9,11,28,45,-17,21
Randers FC,956,10,5,6,13,24,41,-17,21
AGF Aarhus,956,11,4,6,12,16,39,-23,18
Brondby,957,1,20,6,4,68,33,35,66
FC Midtjylla,957,2,18,5,7,61,39,22,59
Copenhagen,957,3,14,5,11,58,50,8,47
FC Nords,957,4,12,8,10,68,51,17,44
AaB,957,5,9,13,8,39,38,1,40
AC Horsens,957,6,8,13,9,39,48,-9,37
Sonderjyske,957,7,8,6,10,28,29,-1,30
Lyngby,957,8,4,9,11,29,44,-15,21
Randers FC,957,9,5,6,13,23,42,-19,21
Silkeborg IF,957,10,5,4,13,26,45,-19,19
AGF Aarhus,957,11,4,7,11,17,37,-20,19
Brondby,958,1,19,7,4,66,32,34,64
FC Midtjylla,958,2,19,6,5,67,36,31,63
FC Nords,958,3,13,9,8,73,55,18,48
Copenhagen,958,4,14,6,10,62,47,15,48
AaB,958,5,8,13,9,39,43,-4,37
AC Horsens,958,6,6,13,11,35,55,-20,31
Sonderjyske,958,7,8,6,10,28,29,-1,30
Lyngby,958,8,4,9,11,27,44,-17,21
Randers FC,958,9,5,6,13,23,40,-17,21
Silkeborg IF,958,10,6,3,13,27,45,-18,21
AGF Aarhus,958,11,4,6,12,17,38,-21,18
Brondby,959,1,21,5,4,71,36,35,68
FC Midtjylla,959,2,21,5,4,72,40,32,68
FC Nords,959,3,13,8,9,73,53,20,47
Copenhagen,959,4,14,5,11,63,48,15,47
AaB,959,5,7,13,10,39,46,-7,34
Sonderjyske,959,6,8,6,10,28,29,-1,30
AC Horsens,959,7,5,14,11,34,55,-21,29
Lyngby,959,8,4,9,11,28,44,-16,21
Randers FC,959,9,5,6,13,23,41,-18,21
AGF Aarhus,959,10,5,6,11,17,36,-19,21
Silkeborg IF,959,11,5,3,14,25,45,-20,18
Brondby,960,1,20,7,3,64,28,36,67
FC Midtjylla,960,2,20,4,6,64,38,26,64
FC Nords,960,3,14,6,10,72,51,21,48
Copenhagen,960,4,13,4,13,51,44,7,43
AaB,960,5,8,13,9,36,37,-1,37
AC Horsens,960,6,7,14,9,34,49,-15,35
Sonderjyske,960,7,8,6,10,28,29,-1,30
Randers FC,960,8,5,7,12,24,40,-16,22
Silkeborg IF,960,9,6,3,13,27,45,-18,21
Lyngby,960,10,3,10,11,27,45,-18,19
AGF Aarhus,960,11,4,6,12,17,38,-21,18
Brondby,961,1,20,7,3,69,31,38,67
FC Midtjylla,961,2,19,5,6,62,37,25,62
FC Nords,961,3,14,6,10,74,55,19,48
Copenhagen,961,4,14,5,11,58,43,15,47
AaB,961,5,7,14,9,37,43,-6,35
AC Horsens,961,6,7,13,10,38,55,-17,34
Sonderjyske,961,7,8,6,10,28,29,-1,30
Lyngby,961,8,4,9,11,27,44,-17,21
Randers FC,961,9,5,6,13,23,40,-17,21
Silkeborg IF,961,10,6,3,13,26,44,-18,21
AGF Aarhus,961,11,4,6,12,16,37,-21,18
Brondby,962,1,22,5,3,70,32,38,71
FC Midtjylla,962,2,21,4,5,73,38,35,67
FC Nords,962,3,15,6,9,75,54,21,51
Copenhagen,962,4,14,4,12,56,45,11,46
AaB,962,5,7,11,12,37,49,-12,32
Sonderjyske,962,6,8,6,10,28,29,-1,30
AC Horsens,962,7,6,12,12,33,52,-19,30
Lyngby,962,8,4,9,11,27,44,-17,21
Randers FC,962,9,5,6,13,23,40,-17,21
Silkeborg IF,962,10,6,3,13,27,45,-18,21
AGF Aarhus,962,11,4,6,12,17,38,-21,18
Brondby,963,1,19,9,2,68,31,37,66
FC Midtjylla,963,2,18,6,6,62,40,22,60
FC Nords,963,3,15,8,7,75,50,25,53
Copenhagen,963,4,14,6,10,58,44,14,48
AaB,963,5,7,13,10,40,45,-5,34
Sonderjyske,963,6,8,6,10,28,29,-1,30
AC Horsens,963,7,5,14,11,32,51,-19,29
Randers FC,963,8,6,6,12,25,39,-14,24
Silkeborg IF,963,9,5,4,13,26,45,-19,19
AGF Aarhus,963,10,4,7,11,17,37,-20,19
Lyngby,963,11,3,9,12,26,46,-20,18
Brondby,964,1,21,6,3,69,29,40,69
FC Midtjylla,964,2,19,5,6,65,39,26,62
FC Nords,964,3,15,7,8,73,50,23,52
Copenhagen,964,4,15,4,11,59,45,14,49
AC Horsens,964,5,7,13,10,36,53,-17,34
Sonderjyske,964,6,8,6,10,28,29,-1,30
AaB,964,7,6,11,13,32,44,-12,29
Lyngby,964,8,4,9,11,28,44,-16,21
Silkeborg IF,964,9,6,3,13,26,44,-18,21
Randers FC,964,10,5,6,13,23,41,-18,21
AGF Aarhus,964,11,4,6,12,16,37,-21,18
Brondby,965,1,21,5,4,70,34,36,68
FC Midtjylla,965,2,21,4,5,67,40,27,67
Copenhagen,965,3,15,4,11,57,43,14,49
FC Nords,965,4,14,6,10,76,55,21,48
AaB,965,5,7,12,11,39,43,-4,33
AC Horsens,965,6,6,13,11,34,54,-20,31
Sonderjyske,965,7,8,6,10,28,29,-1,30
Randers FC,965,8,5,7,12,25,41,-16,22
Silkeborg IF,965,9,6,3,13,27,44,-17,21
Lyngby,965,10,3,10,11,28,46,-18,19
AGF Aarhus,965,11,4,6,12,16,38,-22,18
Brondby,966,1,21,6,3,71,34,37,69
FC Midtjylla,966,2,21,4,5,69,41,28,67
FC Nords,966,3,16,6,8,85,55,30,54
Copenhagen,966,4,12,4,14,55,51,4,40
AaB,966,5,8,12,10,38,45,-7,36
Sonderjyske,966,6,8,6,10,28,29,-1,30
AC Horsens,966,7,6,12,12,38,56,-18,30
Randers FC,966,8,6,6,12,24,39,-15,24
Silkeborg IF,966,9,6,3,13,28,45,-17,21
Lyngby,966,10,3,9,12,26,45,-19,18
AGF Aarhus,966,11,4,6,12,17,39,-22,18
Brondby,967,1,22,6,2,75,29,46,72
FC Midtjylla,967,2,18,6,6,62,43,19,60
FC Nords,967,3,14,8,8,76,51,25,50
Copenhagen,967,4,14,5,11,62,46,16,47
AaB,967,5,7,13,10,35,41,-6,34
Sonderjyske,967,6,8,6,10,28,29,-1,30
AC Horsens,967,7,6,12,12,31,57,-26,30
Lyngby,967,8,4,9,11,27,44,-17,21
Randers FC,967,9,5,6,13,23,40,-17,21
Silkeborg IF,967,10,6,3,13,26,44,-18,21
AGF Aarhus,967,11,4,6,12,16,37,-21,18
Brondby,968,1,20,6,4,69,37,32,66
FC Midtjylla,968,2,19,6,5,67,38,29,63
FC Nords,968,3,14,7,9,77,52,25,49
Copenhagen,968,4,13,5,12,57,50,7,44
AaB,968,5,10,11,9,42,40,2,41
AC Horsens,968,6,6,13,11,37,58,-21,31
Sonderjyske,968,7,8,6,10,28,29,-1,30
Randers FC,968,8,5,7,12,23,39,-16,22
Silkeborg IF,968,9,6,3,13,27,44,-17,21
Lyngby,968,10,3,10,11,26,44,-18,19
AGF Aarhus,968,11,4,6,12,16,38,-22,18
Brondby,969,1,22,6,2,74,31,43,72
FC Midtjylla,969,2,18,6,6,63,41,22,60
FC Nords,969,3,14,7,9,72,51,21,49
Copenhagen,969,4,13,6,11,56,45,11,45
AC Horsens,969,5,7,13,10,36,53,-17,34
AaB,969,6,6,14,10,38,44,-6,32
Sonderjyske,969,7,8,6,10,28,29,-1,30
Randers FC,969,8,5,7,12,24,40,-16,22
Silkeborg IF,969,9,6,3,13,30,45,-15,21
Lyngby,969,10,3,10,11,27,45,-18,19
AGF Aarhus,969,11,4,6,12,17,41,-24,18
Brondby,970,1,19,7,4,66,32,34,64
FC Midtjylla,970,2,18,6,6,62,39,23,60
FC Nords,970,3,14,9,7,71,47,24,51
Copenhagen,970,4,13,7,10,55,41,14,46
AaB,970,5,8,14,8,40,40,0,38
Sonderjyske,970,6,8,6,10,28,29,-1,30
AC Horsens,970,7,5,15,10,34,55,-21,30
Randers FC,970,8,6,6,12,26,41,-15,24
Silkeborg IF,970,9,6,3,13,26,44,-18,21
Lyngby,970,10,3,9,12,28,47,-19,18
AGF Aarhus,970,11,4,6,12,16,37,-21,18
Brondby,971,1,19,9,2,71,33,38,66
FC Midtjylla,971,2,20,4,6,70,40,30,64
FC Nords,971,3,13,8,9,71,53,18,47
Copenhagen,971,4,14,5,11,59,44,15,47
AaB,971,5,8,13,9,36,41,-5,37
Sonderjyske,971,6,8,6,10,28,29,-1,30
AC Horsens,971,7,5,15,10,33,55,-22,30
Lyngby,971,8,4,9,11,29,44,-15,21
Randers FC,971,9,5,6,13,23,42,-19,21
Silkeborg IF,971,10,5,4,13,27,46,-19,19
AGF Aarhus,971,11,4,7,11,18,38,-20,19
Brondby,972,1,20,7,3,69,31,38,67
FC Midtjylla,972,2,18,6,6,62,40,22,60
Copenhagen,972,3,15,6,9,62,42,20,51
FC Nords,972,4,12,7,11,69,56,13,43
AaB,972,5,9,13,8,41,40,1,40
AC Horsens,972,6,6,13,11,32,52,-20,31
Sonderjyske,972,7,8,6,10,28,29,-1,30
Lyngby,972,8,4,9,11,28,44,-16,21
Randers FC,972,9,5,6,13,23,41,-18,21
Silkeborg IF,972,10,5,4,13,25,44,-19,19
AGF Aarhus,972,11,4,7,11,16,36,-20,19
Brondby,973,1,21,6,3,68,29,39,69
FC Midtjylla,973,2,20,4,6,67,37,30,64
Copenhagen,973,3,14,5,11,56,45,11,47
FC Nords,973,4,13,6,11,73,55,18,45
AC Horsens,973,5,8,14,8,36,48,-12,38
AaB,973,6,7,11,12,35,47,-12,32
Sonderjyske,973,7,8,6,10,28,29,-1,30
Randers FC,973,8,5,7,12,24,40,-16,22
AGF Aarhus,973,9,5,6,11,18,37,-19,21
Lyngby,973,10,3,10,11,27,45,-18,19
Silkeborg IF,973,11,5,3,14,26,46,-20,18
Brondby,974,1,22,5,3,69,30,39,71
FC Midtjylla,974,2,21,5,4,66,34,32,68
FC Nords,974,3,13,8,9,74,54,20,47
Copenhagen,974,4,13,4,13,57,48,9,43
AC Horsens,974,5,7,13,10,34,50,-16,34
AaB,974,6,7,11,12,34,44,-10,32
Sonderjyske,974,7,8,6,10,28,29,-1,30
Silkeborg IF,974,8,6,3,13,29,45,-16,21
Lyngby,974,9,4,9,11,29,46,-17,21
Randers FC,974,10,5,6,13,25,42,-17,21
AGF Aarhus,974,11,4,6,12,17,40,-23,18
Brondby,975,1,20,6,4,73,36,37,66
FC Midtjylla,975,2,20,4,6,70,44,26,64
FC Nords,975,3,15,6,9,72,49,23,51
Copenhagen,975,4,15,5,10,60,45,15,50
AaB,975,5,8,11,11,38,45,-7,35
Sonderjyske,975,6,8,6,10,28,29,-1,30
AC Horsens,975,7,5,14,11,34,54,-20,29
Randers FC,975,8,6,6,12,25,39,-14,24
Silkeborg IF,975,9,5,4,13,26,45,-19,19
AGF Aarhus,975,10,4,7,11,17,37,-20,19
Lyngby,975,11,3,9,12,26,46,-20,18
Brondby,976,1,22,5,3,73,31,42,71
FC Midtjylla,976,2,19,6,5,66,38,28,63
Copenhagen,976,3,14,5,11,59,46,13,47
FC Nords,976,4,13,6,11,69,56,13,45
AaB,976,5,8,12,10,40,42,-2,36
AC Horsens,976,6,6,14,10,36,56,-20,32
Sonderjyske,976,7,8,6,10,28,29,-1,30
Randers FC,976,8,6,6,12,25,39,-14,24
Silkeborg IF,976,9,6,3,13,26,44,-18,21
Lyngby,976,10,3,9,12,26,46,-20,18
AGF Aarhus,976,11,4,6,12,16,37,-21,18
Brondby,977,1,21,6,3,70,31,39,69
FC Midtjylla,977,2,19,6,5,65,38,27,63
Copenhagen,977,3,15,4,11,60,46,14,49
FC Nords,977,4,12,8,10,71,54,17,44
AC Horsens,977,5,8,12,10,39,53,-14,36
AaB,977,6,7,12,11,35,44,-9,33
Sonderjyske,977,7,8,6,10,28,29,-1,30
Lyngby,977,8,4,9,11,28,44,-16,21
Randers FC,977,9,5,6,13,23,41,-18,21
AGF Aarhus,977,10,5,6,11,20,38,-18,21
Silkeborg IF,977,11,5,3,14,27,48,-21,18
Brondby,978,1,20,6,4,72,34,38,66
FC Midtjylla,978,2,20,4,6,65,43,22,64
FC Nords,978,3,14,7,9,72,52,20,49
Copenhagen,978,4,14,5,11,58,46,12,47
AaB,978,5,8,12,10,40,43,-3,36
AC Horsens,978,6,6,14,10,38,53,-15,32
Sonderjyske,978,7,8,6,10,28,29,-1,30
Lyngby,978,8,4,9,11,28,45,-17,21
Randers FC,978,9,5,6,13,24,41,-17,21
AGF Aarhus,978,10,5,6,11,19,38,-19,21
Silkeborg IF,978,11,5,3,14,27,47,-20,18
Brondby,979,1,21,6,3,72,34,38,69
FC Midtjylla,979,2,20,4,6,71,42,29,64
FC Nords,979,3,15,6,9,75,52,23,51
Copenhagen,979,4,13,4,13,54,47,7,43
AaB,979,5,9,11,10,37,40,-3,38
AC Horsens,979,6,6,13,11,34,54,-20,31
Sonderjyske,979,7,8,6,10,28,29,-1,30
Randers FC,979,8,5,7,12,23,39,-16,22
Lyngby,979,9,3,10,11,26,44,-18,19
Silkeborg IF,979,10,5,4,13,26,45,-19,19
AGF Aarhus,979,11,4,7,11,17,37,-20,19
Brondby,980,1,21,6,3,70,32,38,69
FC Midtjylla,980,2,20,4,6,63,37,26,64
FC Nords,980,3,14,6,10,72,52,20,48
Copenhagen,980,4,14,6,10,58,43,15,48
AaB,980,5,7,14,9,41,45,-4,35
Sonderjyske,980,6,8,6,10,28,29,-1,30
AC Horsens,980,7,5,14,11,32,53,-21,29
Randers FC,980,8,5,7,12,23,39,-16,22
Silkeborg IF,980,9,6,3,13,28,46,-18,21
Lyngby,980,10,3,10,11,26,44,-18,19
AGF Aarhus,980,11,4,6,12,18,39,-21,18
Brondby,981,1,20,6,4,74,36,38,66
FC Midtjylla,981,2,19,4,7,63,41,22,61
FC Nords,981,3,16,7,7,75,45,30,55
Copenhagen,981,4,13,4,13,56,50,6,43
AaB,981,5,8,12,10,38,44,-6,36
AC Horsens,981,6,7,13,10,38,54,-16,34
Sonderjyske,981,7,8,6,10,28,29,-1,30
Randers FC,981,8,5,7,12,25,41,-16,22
AGF Aarhus,981,9,5,6,11,19,38,-19,21
Lyngby,981,10,3,10,11,28,46,-18,19
Silkeborg IF,981,11,5,3,14,27,47,-20,18
Brondby,982,1,23,5,2,79,33,46,74
FC Midtjylla,982,2,19,4,7,69,47,22,61
FC Nords,982,3,15,6,9,71,53,18,51
Copenhagen,982,4,13,5,12,59,48,11,44
AaB,982,5,8,11,11,42,46,-4,35
AC Horsens,982,6,6,13,11,36,55,-19,31
Sonderjyske,982,7,8,6,10,28,29,-1,30
Randers FC,982,8,6,6,12,27,40,-13,24
Silkeborg IF,982,9,6,3,13,29,44,-15,21
Lyngby,982,10,3,9,12,27,48,-21,18
AGF Aarhus,982,11,4,6,12,16,40,-24,18
Brondby,983,1,21,6,3,75,29,46,69
FC Midtjylla,983,2,18,7,5,64,42,22,61
FC Nords,983,3,14,7,9,77,59,18,49
Copenhagen,983,4,13,7,10,56,44,12,46
AaB,983,5,6,15,9,35,40,-5,33
AC Horsens,983,6,6,14,10,36,55,-19,32
Sonderjyske,983,7,8,6,10,28,29,-1,30
Randers FC,983,8,6,6,12,25,40,-15,24
Silkeborg IF,983,9,5,4,13,26,45,-19,19
AGF Aarhus,983,10,4,7,11,17,37,-20,19
Lyngby,983,11,3,9,12,27,46,-19,18
Brondby,984,1,21,6,3,73,34,39,69
FC Midtjylla,984,2,19,6,5,66,40,26,63
FC Nords,984,3,14,6,10,74,53,21,48
Copenhagen,984,4,13,6,11,55,46,9,45
AC Horsens,984,5,7,14,9,36,49,-13,35
AaB,984,6,7,12,11,35,43,-8,33
Sonderjyske,984,7,8,6,10,28,29,-1,30
Randers FC,984,8,6,6,12,25,39,-14,24
Silkeborg IF,984,9,5,4,13,26,45,-19,19
AGF Aarhus,984,10,4,7,11,17,37,-20,19
Lyngby,984,11,3,9,12,26,46,-20,18
Brondby,985,1,23,5,2,75,34,41,74
FC Midtjylla,985,2,19,6,5,65,40,25,63
FC Nords,985,3,14,7,9,77,54,23,49
Copenhagen,985,4,12,7,11,55,47,8,43
AC Horsens,985,5,6,14,10,36,52,-16,32
AaB,985,6,6,13,11,35,42,-7,31
Sonderjyske,985,7,8,6,10,28,29,-1,30
Randers FC,985,8,6,6,12,25,39,-14,24
Silkeborg IF,985,9,6,3,13,27,45,-18,21
Lyngby,985,10,3,9,12,26,46,-20,18
AGF Aarhus,985,11,4,6,12,17,38,-21,18
Brondby,986,1,21,7,2,71,32,39,70
FC Midtjylla,986,2,19,5,6,66,41,25,62
Copenhagen,986,3,14,5,11,59,45,14,47
FC Nords,986,4,12,9,9,72,54,18,45
AaB,986,5,7,14,9,35,40,-5,35
AC Horsens,986,6,6,14,10,35,52,-17,32
Sonderjyske,986,7,8,6,10,28,29,-1,30
Randers FC,986,8,6,6,12,25,40,-15,24
AGF Aarhus,986,9,5,6,11,19,37,-18,21
Lyngby,986,10,3,9,12,27,46,-19,18
Silkeborg IF,986,11,5,3,14,26,47,-21,18
Brondby,987,1,22,5,3,73,32,41,71
FC Midtjylla,987,2,18,5,7,61,45,16,59
Copenhagen,987,3,16,4,10,60,42,18,52
FC Nords,987,4,13,8,9,75,54,21,47
AaB,987,5,7,14,9,37,41,-4,35
Sonderjyske,987,6,8,6,10,28,29,-1,30
AC Horsens,987,7,5,14,11,33,51,-18,29
Randers FC,987,8,5,7,12,23,39,-16,22
Silkeborg IF,987,9,6,3,13,28,45,-17,21
Lyngby,987,10,3,10,11,26,44,-18,19
AGF Aarhus,987,11,4,6,12,17,39,-22,18
Brondby,988,1,22,5,3,76,29,47,71
FC Midtjylla,988,2,20,4,6,69,39,30,64
FC Nords,988,3,15,6,9,72,51,21,51
Copenhagen,988,4,13,5,12,56,50,6,44
AaB,988,5,7,12,11,35,48,-13,33
AC Horsens,988,6,7,12,11,37,54,-17,33
Sonderjyske,988,7,8,6,10,28,29,-1,30
Randers FC,988,8,6,6,12,25,40,-15,24
Silkeborg IF,988,9,6,3,13,28,45,-17,21
Lyngby,988,10,3,9,12,27,46,-19,18
AGF Aarhus,988,11,4,6,12,17,39,-22,18
Brondby,989,1,20,7,3,70,32,38,67
FC Midtjylla,989,2,21,4,5,69,38,31,67
FC Nords,989,3,14,7,9,76,53,23,49
Copenhagen,989,4,14,4,12,56,44,12,46
AaB,989,5,8,12,10,36,42,-6,36
Sonderjyske,989,6,8,6,10,28,29,-1,30
AC Horsens,989,7,6,12,12,32,56,-24,30
Randers FC,989,8,5,7,12,24,40,-16,22
Silkeborg IF,989,9,6,3,13,26,44,-18,21
Lyngby,989,10,3,10,11,27,45,-18,19
AGF Aarhus,989,11,4,6,12,16,37,-21,18
FC Midtjylla,990,1,21,4,5,62,34,28,67
Brondby,990,2,20,6,4,70,34,36,66
FC Nords,990,3,15,7,8,72,48,24,52
Copenhagen,990,4,14,6,10,63,49,14,48
AaB,990,5,7,12,11,39,48,-9,33
Sonderjyske,990,6,8,6,10,28,29,-1,30
AC Horsens,990,7,5,13,12,34,53,-19,28
Lyngby,990,8,4,9,11,28,44,-16,21
Silkeborg IF,990,9,6,3,13,27,44,-17,21
Randers FC,990,10,5,6,13,23,41,-18,21
AGF Aarhus,990,11,4,6,12,16,38,-22,18
Brondby,991,1,23,5,2,73,29,44,74
FC Midtjylla,991,2,20,5,5,66,38,28,65
Copenhagen,991,3,14,6,10,56,42,14,48
FC Nords,991,4,12,7,11,67,54,13,43
AC Horsens,991,5,6,14,10,34,50,-16,32
AaB,991,6,6,13,11,34,43,-9,31
Sonderjyske,991,7,8,6,10,28,29,-1,30
Lyngby,991,8,4,9,11,28,44,-16,21
Randers FC,991,9,5,6,13,23,41,-18,21
AGF Aarhus,991,10,5,6,11,19,38,-19,21
Silkeborg IF,991,11,5,3,14,27,47,-20,18
Brondby,992,1,22,6,2,71,29,42,72
FC Midtjylla,992,2,18,6,6,62,38,24,60
FC Nords,992,3,14,7,9,77,53,24,49
Copenhagen,992,4,12,4,14,55,51,4,40
AaB,992,5,9,11,10,39,41,-2,38
AC Horsens,992,6,8,12,10,36,54,-18,36
Sonderjyske,992,7,8,6,10,28,29,-1,30
Randers FC,992,8,5,7,12,24,40,-16,22
Silkeborg IF,992,9,6,3,13,30,45,-15,21
Lyngby,992,10,3,10,11,27,45,-18,19
AGF Aarhus,992,11,4,6,12,17,41,-24,18
Brondby,993,1,20,7,3,70,32,38,67
FC Midtjylla,993,2,20,5,5,67,37,30,65
Copenhagen,993,3,15,5,10,59,43,16,50
FC Nords,993,4,13,6,11,70,55,15,45
AaB,993,5,8,12,10,39,45,-6,36
AC Horsens,993,6,6,13,11,35,54,-19,31
Sonderjyske,993,7,8,6,10,28,29,-1,30
Randers FC,993,8,6,6,12,25,39,-14,24
Silkeborg IF,993,9,5,4,13,27,46,-19,19
AGF Aarhus,993,10,4,7,11,18,38,-20,19
Lyngby,993,11,3,9,12,26,46,-20,18
Brondby,994,1,21,6,3,72,33,39,69
FC Midtjylla,994,2,19,6,5,67,38,29,63
FC Nords,994,3,15,8,7,76,47,29,53
Copenhagen,994,4,14,5,11,58,47,11,47
AaB,994,5,8,11,11,39,42,-3,35
Sonderjyske,994,6,8,6,10,28,29,-1,30
AC Horsens,994,7,5,12,13,30,61,-31,27
Lyngby,994,8,4,9,11,30,46,-16,21
Silkeborg IF,994,9,6,3,13,27,44,-17,21
Randers FC,994,10,5,6,13,25,43,-18,21
AGF Aarhus,994,11,4,6,12,16,38,-22,18
Brondby,995,1,20,8,2,70,32,38,68
FC Midtjylla,995,2,18,7,5,67,41,26,61
Copenhagen,995,3,14,7,9,58,42,16,49
FC Nords,995,4,13,7,10,75,59,16,46
AaB,995,5,7,15,8,39,40,-1,36
Sonderjyske,995,6,8,6,10,28,29,-1,30
AC Horsens,995,7,5,14,11,36,57,-21,29
Randers FC,995,8,5,7,12,23,39,-16,22
Silkeborg IF,995,9,6,3,13,27,45,-18,21
Lyngby,995,10,3,10,11,26,44,-18,19
AGF Aarhus,995,11,4,6,12,17,38,-21,18
Brondby,996,1,22,5,3,77,31,46,71
FC Midtjylla,996,2,20,5,5,71,42,29,65
FC Nords,996,3,13,8,9,71,54,17,47
Copenhagen,996,4,14,4,12,55,45,10,46
AaB,996,5,7,13,10,36,44,-8,34
AC Horsens,996,6,6,13,11,37,57,-20,31
Sonderjyske,996,7,8,6,10,28,29,-1,30
Randers FC,996,8,5,7,12,25,41,-16,22
Silkeborg IF,996,9,6,3,13,28,44,-16,21
Lyngby,996,10,3,10,11,28,46,-18,19
AGF Aarhus,996,11,4,6,12,16,39,-23,18
Brondby,997,1,21,7,2,72,32,40,70
FC Midtjylla,997,2,19,5,6,61,37,24,62
FC Nords,997,3,15,7,8,74,53,21,52
Copenhagen,997,4,12,5,13,56,47,9,41
AaB,997,5,7,15,8,39,42,-3,36
AC Horsens,997,6,6,13,11,33,50,-17,31
Sonderjyske,997,7,8,6,10,28,29,-1,30
Lyngby,997,8,4,9,11,28,45,-17,21
Randers FC,997,9,5,6,13,24,41,-17,21
Silkeborg IF,997,10,6,3,13,28,46,-18,21
AGF Aarhus,997,11,4,6,12,18,39,-21,18
Brondby,998,1,20,8,2,71,33,38,68
FC Midtjylla,998,2,18,5,7,65,41,24,59
FC Nords,998,3,15,7,8,77,53,24,52
Copenhagen,998,4,13,7,10,56,44,12,46
AaB,998,5,6,15,9,39,44,-5,33
AC Horsens,998,6,5,16,9,37,56,-19,31
Sonderjyske,998,7,8,6,10,28,29,-1,30
Randers FC,998,8,5,7,12,24,40,-16,22
Lyngby,998,9,3,10,11,27,45,-18,19
Silkeborg IF,998,10,5,4,13,25,44,-19,19
AGF Aarhus,998,11,4,7,11,16,36,-20,19
FC Midtjylla,999,1,21,4,5,65,38,27,67
Brondby,999,2,20,5,5,69,36,33,65
Copenhagen,999,3,15,5,10,61,46,15,50
FC Nords,999,4,14,6,10,76,54,22,48
AaB,999,5,8,11,11,39,46,-7,35
AC Horsens,999,6,6,13,11,36,52,-16,31
Sonderjyske,999,7,8,6,10,28,29,-1,30
Lyngby,999,8,4,9,11,29,45,-16,21
Randers FC,999,9,5,6,13,24,42,-18,21
Silkeborg IF,999,10,5,4,13,27,46,-19,19
AGF Aarhus,999,11,4,7,11,18,38,-20,19
FC Midtjylla,1000,1,20,6,4,65,37,28,66
Brondby,1000,2,19,8,3,73,34,39,65
FC Nords,1000,3,16,7,7,74,47,27,55
Copenhagen,1000,4,13,5,12,59,49,10,44
AaB,1000,5,7,11,12,36,47,-11,32
AC Horsens,1000,6,6,13,11,33,52,-19,31
Sonderjyske,1000,7,8,6,10,28,29,-1,30
Randers FC,1000,8,6,6,12,25,40,-15,24
Silkeborg IF,1000,9,5,4,13,26,45,-19,19
AGF Aarhus,1000,10,4,7,11,17,37,-20,19
Lyngby,1000,11,3,9,12,27,46,-19,18
Brondby,1001,1,19,8,3,68,31,37,65
FC Midtjylla,1001,2,18,5,7,62,42,20,59
FC Nords,1001,3,15,8,7,75,49,26,53
Copenhagen,1001,4,13,5,12,56,47,9,44
AaB,1001,5,7,14,9,34,38,-4,35
AC Horsens,1001,6,7,14,9,36,50,-14,35
Sonderjyske,1001,7,8,6,10,28,29,-1,30
Lyngby,1001,8,4,9,11,27,44,-17,21
Randers FC,1001,9,5,6,13,23,40,-17,21
Silkeborg IF,1001,10,5,4,13,25,44,-19,19
AGF Aarhus,1001,11,4,7,11,16,36,-20,19
FC Midtjylla,1002,1,21,5,4,71,38,33,68
Brondby,1002,2,20,5,5,67,33,34,65
FC Nords,1002,3,14,7,9,71,50,21,49
Copenhagen,1002,4,14,4,12,54,42,12,46
AaB,1002,5,9,11,10,39,43,-4,38
Sonderjyske,1002,6,8,6,10,28,29,-1,30
AC Horsens,1002,7,6,12,12,33,55,-22,30
Lyngby,1002,8,4,9,11,31,45,-14,21
Silkeborg IF,1002,9,6,3,13,26,44,-18,21
Randers FC,1002,10,5,6,13,24,44,-20,21
AGF Aarhus,1002,11,4,6,12,16,37,-21,18
Brondby,1003,1,22,6,2,78,30,48,72
FC Midtjylla,1003,2,20,5,5,67,41,26,65
FC Nords,1003,3,14,7,9,73,55,18,49
Copenhagen,1003,4,12,4,14,54,50,4,40
AC Horsens,1003,5,8,13,9,37,50,-13,37
AaB,1003,6,7,11,12,37,46,-9,32
Sonderjyske,1003,7,8,6,10,28,29,-1,30
Randers FC,1003,8,6,6,12,24,39,-15,24
Silkeborg IF,1003,9,6,3,13,28,45,-17,21
Lyngby,1003,10,3,9,12,26,45,-19,18
AGF Aarhus,1003,11,4,6,12,17,39,-22,18
Brondby,1004,1,22,6,2,81,32,49,72
FC Midtjylla,1004,2,18,4,8,62,42,20,58
FC Nords,1004,3,14,8,8,74,54,20,50
Copenhagen,1004,4,13,6,11,54,44,10,45
AaB,1004,5,7,13,10,37,46,-9,34
AC Horsens,1004,6,7,13,10,37,53,-16,34
Sonderjyske,1004,7,8,6,10,28,29,-1,30
Randers FC,1004,8,6,6,12,25,40,-15,24
Silkeborg IF,1004,9,6,3,13,28,44,-16,21
Lyngby,1004,10,3,9,12,27,46,-19,18
AGF Aarhus,1004,11,4,6,12,16,39,-23,18
Brondby,1005,1,20,6,4,66,33,33,66
FC Midtjylla,1005,2,20,5,5,73,45,28,65
FC Nords,1005,3,14,8,8,72,51,21,50
Copenhagen,1005,4,14,6,10,64,45,19,48
AaB,1005,5,7,13,10,36,43,-7,34
Sonderjyske,1005,6,8,6,10,28,29,-1,30
AC Horsens,1005,7,6,12,12,35,55,-20,30
Lyngby,1005,8,4,9,11,28,45,-17,21
Silkeborg IF,1005,9,6,3,13,27,44,-17,21
Randers FC,1005,10,5,6,13,24,41,-17,21
AGF Aarhus,1005,11,4,6,12,16,38,-22,18
Brondby,1006,1,20,7,3,70,34,36,67
FC Midtjylla,1006,2,18,7,5,65,40,25,61
Copenhagen,1006,3,15,5,10,60,45,15,50
FC Nords,1006,4,14,7,9,74,52,22,49
AC Horsens,1006,5,7,12,11,34,51,-17,33
AaB,1006,6,6,14,10,37,44,-7,32
Sonderjyske,1006,7,8,6,10,28,29,-1,30
Lyngby,1006,8,4,9,11,30,44,-14,21
Randers FC,1006,9,5,6,13,23,43,-20,21
Silkeborg IF,1006,10,5,4,13,26,45,-19,19
AGF Aarhus,1006,11,4,7,11,17,37,-20,19
Brondby,1007,1,21,6,3,67,29,38,69
FC Midtjylla,1007,2,21,4,5,67,36,31,67
FC Nords,1007,3,13,7,10,73,55,18,46
Copenhagen,1007,4,12,7,11,55,45,10,43
AaB,1007,5,8,11,11,42,46,-4,35
AC Horsens,1007,6,7,13,10,38,57,-19,34
Sonderjyske,1007,7,8,6,10,28,29,-1,30
Randers FC,1007,8,5,7,12,24,40,-16,22
AGF Aarhus,1007,9,5,6,11,18,37,-19,21
Lyngby,1007,10,3,10,11,27,45,-18,19
Silkeborg IF,1007,11,5,3,14,26,46,-20,18
Brondby,1008,1,21,6,3,72,33,39,69
FC Midtjylla,1008,2,20,4,6,67,40,27,64
FC Nords,1008,3,15,6,9,75,52,23,51
Copenhagen,1008,4,14,5,11,55,45,10,47
AC Horsens,1008,5,6,14,10,37,52,-15,32
AaB,1008,6,6,13,11,35,45,-10,31
Sonderjyske,1008,7,8,6,10,28,29,-1,30
Lyngby,1008,8,4,9,11,27,44,-17,21
Randers FC,1008,9,5,6,13,23,40,-17,21
Silkeborg IF,1008,10,6,3,13,26,44,-18,21
AGF Aarhus,1008,11,4,6,12,16,37,-21,18
Brondby,1009,1,20,8,2,70,33,37,68
FC Midtjylla,1009,2,19,4,7,63,44,19,61
FC Nords,1009,3,15,7,8,76,50,26,52
Copenhagen,1009,4,14,5,11,60,44,16,47
AaB,1009,5,9,12,9,38,41,-3,39
Sonderjyske,1009,6,8,6,10,28,29,-1,30
AC Horsens,1009,7,5,12,13,33,54,-21,27
Randers FC,1009,8,6,6,12,26,40,-14,24
Silkeborg IF,1009,9,5,4,13,26,45,-19,19
AGF Aarhus,1009,10,4,7,11,17,37,-20,19
Lyngby,1009,11,3,9,12,27,47,-20,18
Brondby,1010,1,22,5,3,76,30,46,71
FC Midtjylla,1010,2,19,4,7,64,40,24,61
Copenhagen,1010,3,16,4,10,59,42,17,52
FC Nords,1010,4,14,7,9,71,52,19,49
AaB,1010,5,6,13,11,37,48,-11,31
AC Horsens,1010,6,6,13,11,35,56,-21,31
Sonderjyske,1010,7,8,6,10,28,29,-1,30
Randers FC,1010,8,5,7,12,23,39,-16,22
AGF Aarhus,1010,9,5,6,11,17,36,-19,21
Lyngby,1010,10,3,10,11,26,44,-18,19
Silkeborg IF,1010,11,5,3,14,25,45,-20,18
Brondby,1011,1,19,7,4,67,35,32,64
FC Midtjylla,1011,2,19,7,4,63,35,28,64
Copenhagen,1011,3,14,7,9,56,40,16,49
FC Nords,1011,4,13,7,10,69,47,22,46
AaB,1011,5,7,13,10,36,41,-5,34
AC Horsens,1011,6,7,13,10,36,55,-19,34
Sonderjyske,1011,7,8,6,10,28,29,-1,30
Randers FC,1011,8,6,6,12,24,39,-15,24
Silkeborg IF,1011,9,5,4,13,25,44,-19,19
AGF Aarhus,1011,10,4,7,11,16,36,-20,19
Lyngby,1011,11,3,9,12,26,45,-19,18
Brondby,1012,1,20,6,4,71,38,33,66
FC Midtjylla,1012,2,19,5,6,64,41,23,62
FC Nords,1012,3,15,7,8,76,51,25,52
Copenhagen,1012,4,16,4,10,66,45,21,52
AaB,1012,5,7,12,11,37,45,-8,33
Sonderjyske,1012,6,8,6,10,28,29,-1,30
AC Horsens,1012,7,6,12,12,35,55,-20,30
Lyngby,1012,8,4,9,11,28,45,-17,21
Randers FC,1012,9,5,6,13,24,41,-17,21
Silkeborg IF,1012,10,6,3,13,27,45,-18,21
AGF Aarhus,1012,11,4,6,12,17,38,-21,18
Brondby,1013,1,21,5,4,73,36,37,68
FC Midtjylla,1013,2,21,4,5,72,37,35,67
FC Nords,1013,3,14,8,8,75,52,23,50
Copenhagen,1013,4,14,5,11,59,46,13,47
AaB,1013,5,8,12,10,40,44,-4,36
Sonderjyske,1013,6,8,6,10,28,29,-1,30
AC Horsens,1013,7,5,12,13,32,62,-30,27
Lyngby,1013,8,4,9,11,27,44,-17,21
Randers FC,1013,9,5,6,13,23,40,-17,21
Silkeborg IF,1013,10,5,4,13,26,45,-19,19
AGF Aarhus,1013,11,4,7,11,17,37,-20,19
Brondby,1014,1,18,8,4,65,34,31,62
FC Midtjylla,1014,2,19,5,6,63,37,26,62
FC Nords,1014,3,15,7,8,73,48,25,52
Copenhagen,1014,4,13,6,11,55,44,11,45
AaB,1014,5,9,13,8,39,38,1,40
AC Horsens,1014,6,6,13,11,32,52,-20,31
Sonderjyske,1014,7,8,6,10,28,29,-1,30
Silkeborg IF,1014,8,6,3,13,28,45,-17,21
Lyngby,1014,9,4,9,11,27,44,-17,21
Randers FC,1014,10,5,6,13,23,40,-17,21
AGF Aarhus,1014,11,4,6,12,17,39,-22,18
Brondby,1015,1,20,6,4,71,35,36,66
FC Midtjylla,1015,2,20,5,5,66,37,29,65
Copenhagen,1015,3,15,4,11,59,44,15,49
FC Nords,1015,4,14,6,10,73,56,17,48
AaB,1015,5,8,11,11,39,48,-9,35
AC Horsens,1015,6,6,14,10,37,51,-14,32
Sonderjyske,1015,7,8,6,10,28,29,-1,30
Lyngby,1015,8,4,9,11,29,44,-15,21
Silkeborg IF,1015,9,6,3,13,26,44,-18,21
Randers FC,1015,10,5,6,13,23,42,-19,21
AGF Aarhus,1015,11,4,6,12,16,37,-21,18
Brondby,1016,1,19,7,4,67,33,34,64
FC Midtjylla,1016,2,19,6,5,61,35,26,63
FC Nords,1016,3,14,8,8,74,50,24,50
Copenhagen,1016,4,14,6,10,58,44,14,48
AaB,1016,5,7,14,9,35,41,-6,35
AC Horsens,1016,6,6,13,11,37,55,-18,31
Sonderjyske,1016,7,8,6,10,28,29,-1,30
Randers FC,1016,8,6,6,12,24,39,-15,24
Silkeborg IF,1016,9,6,3,13,26,44,-18,21
Lyngby,1016,10,3,9,12,26,45,-19,18
AGF Aarhus,1016,11,4,6,12,16,37,-21,18
Brondby,1017,1,20,6,4,72,34,38,66
FC Midtjylla,1017,2,18,5,7,64,43,21,59
FC Nords,1017,3,15,7,8,74,51,23,52
Copenhagen,1017,4,13,5,12,58,48,10,44
AaB,1017,5,9,12,9,46,44,2,39
AC Horsens,1017,6,7,13,10,37,57,-20,34
Sonderjyske,1017,7,8,6,10,28,29,-1,30
Lyngby,1017,8,4,9,11,28,44,-16,21
Randers FC,1017,9,5,6,13,23,41,-18,21
Silkeborg IF,1017,10,5,4,13,27,46,-19,19
AGF Aarhus,1017,11,4,7,11,18,38,-20,19
Brondby,1018,1,21,6,3,70,31,39,69
FC Midtjylla,1018,2,18,5,7,66,44,22,59
FC Nords,1018,3,15,7,8,74,50,24,52
Copenhagen,1018,4,12,6,12,58,50,8,42
AC Horsens,1018,5,7,15,8,37,49,-12,36
AaB,1018,6,7,13,10,39,46,-7,34
Sonderjyske,1018,7,8,6,10,28,29,-1,30
Randers FC,1018,8,6,6,12,25,39,-14,24
AGF Aarhus,1018,9,5,6,11,18,37,-19,21
Lyngby,1018,10,3,9,12,26,46,-20,18
Silkeborg IF,1018,10,5,3,14,26,46,-20,18
Brondby,1019,1,22,6,2,72,29,43,72
FC Midtjylla,1019,2,19,5,6,67,38,29,62
FC Nords,1019,3,15,7,8,76,52,24,52
Copenhagen,1019,4,14,4,12,54,49,5,46
AC Horsens,1019,5,7,13,10,39,51,-12,34
Sonderjyske,1019,6,8,6,10,28,29,-1,30
AaB,1019,7,6,11,13,35,50,-15,29
Lyngby,1019,8,4,9,11,27,44,-17,21
Randers FC,1019,9,5,6,13,23,40,-17,21
Silkeborg IF,1019,10,5,4,13,26,45,-19,19
AGF Aarhus,1019,11,4,7,11,17,37,-20,19
Brondby,1020,1,22,6,2,71,30,41,72
FC Midtjylla,1020,2,20,5,5,66,36,30,65
FC Nords,1020,3,13,9,8,72,52,20,48
Copenhagen,1020,4,13,4,13,54,48,6,43
AaB,1020,5,8,13,9,40,39,1,37
Sonderjyske,1020,6,8,6,10,28,29,-1,30
AC Horsens,1020,7,5,13,12,31,55,-24,28
Lyngby,1020,8,4,9,11,27,44,-17,21
Randers FC,1020,9,5,6,13,23,40,-17,21
AGF Aarhus,1020,10,5,6,11,19,36,-17,21
Silkeborg IF,1020,11,5,3,14,25,47,-22,18
Brondby,1021,1,20,6,4,71,33,38,66
FC Midtjylla,1021,2,20,5,5,65,38,27,65
FC Nords,1021,3,14,8,8,72,50,22,50
Copenhagen,1021,4,12,6,12,56,46,10,42
AaB,1021,5,9,11,10,36,41,-5,38
AC Horsens,1021,6,6,14,10,33,51,-18,32
Sonderjyske,1021,7,8,6,10,28,29,-1,30
Lyngby,1021,8,4,9,11,28,45,-17,21
Randers FC,1021,9,5,6,13,24,41,-17,21
Silkeborg IF,1021,10,6,3,13,27,45,-18,21
AGF Aarhus,1021,11,4,6,12,17,38,-21,18
Brondby,1022,1,21,7,2,71,29,42,70
FC Midtjylla,1022,2,20,5,5,68,41,27,65
FC Nords,1022,3,14,7,9,76,53,23,49
Copenhagen,1022,4,13,7,10,57,47,10,46
AaB,1022,5,7,12,11,36,44,-8,33
Sonderjyske,1022,6,8,6,10,28,29,-1,30
AC Horsens,1022,7,5,14,11,32,52,-20,29
Randers FC,1022,8,6,6,12,25,40,-15,24
Silkeborg IF,1022,9,5,4,13,25,44,-19,19
AGF Aarhus,1022,10,4,7,11,16,36,-20,19
Lyngby,1022,11,3,9,12,27,46,-19,18
Brondby,1023,1,21,5,4,71,34,37,68
FC Midtjylla,1023,2,20,4,6,61,37,24,64
FC Nords,1023,3,15,6,9,71,48,23,51
Copenhagen,1023,4,14,5,11,62,46,16,47
AC Horsens,1023,5,7,13,10,33,51,-18,34
AaB,1023,6,6,13,11,34,42,-8,31
Sonderjyske,1023,7,8,6,10,28,29,-1,30
Lyngby,1023,8,4,9,11,28,45,-17,21
Randers FC,1023,9,5,6,13,24,41,-17,21
Silkeborg IF,1023,10,6,3,13,26,44,-18,21
AGF Aarhus,1023,11,4,6,12,16,37,-21,18
Brondby,1024,1,20,6,4,70,35,35,66
FC Midtjylla,1024,2,19,5,6,68,43,25,62
FC Nords,1024,3,14,7,9,74,52,22,49
Copenhagen,1024,4,14,5,11,61,48,13,47
AaB,1024,5,8,12,10,42,51,-9,36
AC Horsens,1024,6,7,13,10,38,50,-12,34
Sonderjyske,1024,7,8,6,10,28,29,-1,30
Lyngby,1024,8,4,9,11,28,44,-16,21
Randers FC,1024,9,5,6,13,23,41,-18,21
Silkeborg IF,1024,10,5,4,13,26,45,-19,19
AGF Aarhus,1024,11,4,7,11,17,37,-20,19
Brondby,1025,1,21,7,2,72,30,42,70
FC Midtjylla,1025,2,17,5,8,59,41,18,56
FC Nords,1025,3,15,7,8,76,50,26,52
Copenhagen,1025,4,14,6,10,56,45,11,48
AaB,1025,5,8,13,9,36,39,-3,37
Sonderjyske,1025,6,8,6,10,28,29,-1,30
AC Horsens,1025,7,5,14,11,31,51,-20,29
Randers FC,1025,8,5,7,12,23,39,-16,22
Silkeborg IF,1025,9,6,3,13,26,44,-18,21
Lyngby,1025,10,3,10,11,26,44,-18,19
AGF Aarhus,1025,11,4,6,12,16,37,-21,18
Brondby,1026,1,23,5,2,73,30,43,74
FC Midtjylla,1026,2,19,5,6,65,42,23,62
FC Nords,1026,3,14,6,10,75,57,18,48
Copenhagen,1026,4,13,6,11,58,44,14,45
AaB,1026,5,8,12,10,42,47,-5,36
Sonderjyske,1026,6,8,6,10,28,29,-1,30
AC Horsens,1026,7,5,14,11,33,52,-19,29
Randers FC,1026,8,6,6,12,24,39,-15,24
Silkeborg IF,1026,9,5,4,13,25,44,-19,19
AGF Aarhus,1026,10,4,7,11,16,36,-20,19
Lyngby,1026,11,3,9,12,26,45,-19,18
Brondby,1027,1,22,6,2,73,29,44,72
FC Midtjylla,1027,2,19,5,6,71,45,26,62
Copenhagen,1027,3,15,5,10,58,44,14,50
FC Nords,1027,4,13,8,9,70,50,20,47
AaB,1027,5,7,13,10,36,41,-5,34
Sonderjyske,1027,6,8,6,10,28,29,-1,30
AC Horsens,1027,7,5,13,12,32,57,-25,28
Randers FC,1027,8,6,6,12,26,41,-15,24
Silkeborg IF,1027,9,5,4,13,26,45,-19,19
AGF Aarhus,1027,10,4,7,11,17,37,-20,19
Lyngby,1027,11,3,9,12,28,47,-19,18
Brondby,1028,1,21,5,4,70,33,37,68
FC Midtjylla,1028,2,20,4,6,64,39,25,64
FC Nords,1028,3,15,6,9,73,51,22,51
Copenhagen,1028,4,14,4,12,58,45,13,46
AaB,1028,5,9,11,10,36,40,-4,38
Sonderjyske,1028,6,8,6,10,28,29,-1,30
AC Horsens,1028,7,6,12,12,36,55,-19,30
Randers FC,1028,8,6,6,12,24,39,-15,24
Silkeborg IF,1028,9,5,4,13,25,44,-19,19
AGF Aarhus,1028,10,4,7,11,16,36,-20,19
Lyngby,1028,11,3,9,12,26,45,-19,18
Brondby,1029,1,19,7,4,69,37,32,64
FC Midtjylla,1029,2,19,7,4,66,40,26,64
FC Nords,1029,3,13,9,8,74,52,22,48
Copenhagen,1029,4,13,4,13,55,45,10,43
AaB,1029,5,8,14,8,39,41,-2,38
AC Horsens,1029,6,6,15,9,36,50,-14,33
Sonderjyske,1029,7,8,6,10,28,29,-1,30
Lyngby,1029,8,4,9,11,28,44,-16,21
Randers FC,1029,9,5,6,13,23,41,-18,21
Silkeborg IF,1029,10,5,4,13,25,44,-19,19
AGF Aarhus,1029,11,4,7,11,16,36,-20,19
Brondby,1030,1,22,5,3,77,31,46,71
FC Midtjylla,1030,2,20,5,5,62,36,26,65
FC Nords,1030,3,14,7,9,73,54,19,49
Copenhagen,1030,4,13,5,12,58,48,10,44
AaB,1030,5,7,13,10,37,43,-6,34
AC Horsens,1030,6,6,13,11,31,52,-21,31
Sonderjyske,1030,7,8,6,10,28,29,-1,30
Randers FC,1030,8,5,7,12,25,41,-16,22
AGF Aarhus,1030,9,5,6,11,20,39,-19,21
Lyngby,1030,10,3,10,11,28,46,-18,19
Silkeborg IF,1030,11,5,3,14,28,48,-20,18
Brondby,1031,1,20,6,4,73,37,36,66
FC Midtjylla,1031,2,19,6,5,67,41,26,63
Copenhagen,1031,3,16,5,9,64,40,24,53
FC Nords,1031,4,12,10,8,73,55,18,46
AC Horsens,1031,5,7,13,10,38,55,-17,34
Sonderjyske,1031,6,8,6,10,28,29,-1,30
AaB,1031,7,6,12,12,36,49,-13,30
Randers FC,1031,8,6,6,12,25,40,-15,24
AGF Aarhus,1031,9,5,6,11,19,36,-17,21
Lyngby,1031,10,3,9,12,27,46,-19,18
Silkeborg IF,1031,11,5,3,14,25,47,-22,18
Brondby,1032,1,20,7,3,71,33,38,67
FC Midtjylla,1032,2,19,5,6,63,40,23,62
FC Nords,1032,3,14,9,7,72,46,26,51
Copenhagen,1032,4,13,5,12,55,50,5,44
AaB,1032,5,9,11,10,40,40,0,38
Sonderjyske,1032,6,8,6,10,28,29,-1,30
AC Horsens,1032,7,5,15,10,36,54,-18,30
Lyngby,1032,8,4,9,11,28,45,-17,21
Randers FC,1032,9,5,6,13,24,41,-17,21
AGF Aarhus,1032,10,5,6,11,19,36,-17,21
Silkeborg IF,1032,11,5,3,14,25,47,-22,18
FC Midtjylla,1033,1,22,4,4,71,37,34,70
Brondby,1033,2,21,5,4,70,33,37,68
FC Nords,1033,3,13,7,10,76,54,22,46
Copenhagen,1033,4,13,6,11,58,48,10,45
AaB,1033,5,7,12,11,36,46,-10,33
AC Horsens,1033,6,7,12,11,35,54,-19,33
Sonderjyske,1033,7,8,6,10,28,29,-1,30
Randers FC,1033,8,6,6,12,24,39,-15,24
AGF Aarhus,1033,9,5,6,11,17,36,-19,21
Lyngby,1033,10,3,9,12,26,45,-19,18
Silkeborg IF,1033,11,5,3,14,25,45,-20,18
FC Midtjylla,1034,1,21,4,5,68,37,31,67
Brondby,1034,2,20,6,4,67,29,38,66
FC Nords,1034,3,13,7,10,67,52,15,46
Copenhagen,1034,4,13,5,12,53,43,10,44
AaB,1034,5,10,11,9,36,37,-1,41
AC Horsens,1034,6,6,13,11,32,51,-19,31
Sonderjyske,1034,7,8,6,10,28,29,-1,30
Randers FC,1034,8,5,7,12,23,39,-16,22
AGF Aarhus,1034,9,5,6,11,18,37,-19,21
Lyngby,1034,10,3,10,11,26,44,-18,19
Silkeborg IF,1034,11,5,3,14,26,46,-20,18
Brondby,1035,1,22,5,3,83,36,47,71
FC Midtjylla,1035,2,19,7,4,77,46,31,64
FC Nords,1035,3,15,6,9,77,56,21,51
Copenhagen,1035,4,13,6,11,58,52,6,45
AaB,1035,5,6,13,11,35,48,-13,31
AC Horsens,1035,6,6,13,11,41,59,-18,31
Sonderjyske,1035,7,8,6,10,28,29,-1,30
Lyngby,1035,8,4,9,11,30,46,-16,21
Randers FC,1035,9,5,6,13,25,43,-18,21
Silkeborg IF,1035,10,5,4,13,25,44,-19,19
AGF Aarhus,1035,11,4,7,11,16,36,-20,19
Brondby,1036,1,22,6,2,76,34,42,72
FC Midtjylla,1036,2,20,4,6,61,34,27,64
Copenhagen,1036,3,14,6,10,63,45,18,48
FC Nords,1036,4,13,8,9,73,54,19,47
AC Horsens,1036,5,7,12,11,36,53,-17,33
Sonderjyske,1036,6,8,6,10,28,29,-1,30
AaB,1036,7,6,12,12,36,51,-15,30
Randers FC,1036,8,6,6,12,25,40,-15,24
Silkeborg IF,1036,9,6,3,13,28,45,-17,21
Lyngby,1036,10,3,9,12,27,46,-19,18
AGF Aarhus,1036,11,4,6,12,17,39,-22,18
Brondby,1037,1,23,5,2,81,33,48,74
FC Midtjylla,1037,2,20,4,6,62,37,25,64
FC Nords,1037,3,15,7,8,82,55,27,52
Copenhagen,1037,4,13,4,13,58,56,2,43
AC Horsens,1037,5,7,13,10,37,51,-14,34
Sonderjyske,1037,6,8,6,10,28,29,-1,30
AaB,1037,7,6,11,13,36,50,-14,29
Randers FC,1037,8,5,7,12,24,40,-16,22
Silkeborg IF,1037,9,6,3,13,26,44,-18,21
Lyngby,1037,10,3,10,11,27,45,-18,19
AGF Aarhus,1037,11,4,6,12,16,37,-21,18
Brondby,1038,1,22,5,3,70,30,40,71
FC Midtjylla,1038,2,19,5,6,61,34,27,62
FC Nords,1038,3,16,6,8,73,47,26,54
Copenhagen,1038,4,15,5,10,59,44,15,50
AaB,1038,5,7,11,12,36,49,-13,32
Sonderjyske,1038,6,8,6,10,28,29,-1,30
AC Horsens,1038,7,5,12,13,29,50,-21,27
Lyngby,1038,8,4,9,11,29,44,-15,21
Randers FC,1038,9,5,6,13,23,42,-19,21
AGF Aarhus,1038,10,5,6,11,18,37,-19,21
Silkeborg IF,1038,11,5,3,14,26,46,-20,18
Brondby,1039,1,21,6,3,67,28,39,69
FC Midtjylla,1039,2,19,6,5,66,38,28,63
FC Nords,1039,3,16,6,8,76,50,26,54
Copenhagen,1039,4,12,6,12,54,47,7,42
AaB,1039,5,7,12,11,38,48,-10,33
AC Horsens,1039,6,6,14,10,34,50,-16,32
Sonderjyske,1039,7,8,6,10,28,29,-1,30
Lyngby,1039,8,4,9,11,31,44,-13,21
Silkeborg IF,1039,9,6,3,13,26,44,-18,21
Randers FC,1039,10,5,6,13,23,44,-21,21
AGF Aarhus,1039,11,4,6,12,16,37,-21,18
Brondby,1040,1,20,6,4,67,35,32,66
FC Midtjylla,1040,2,20,5,5,71,39,32,65
FC Nords,1040,3,15,7,8,76,52,24,52
Copenhagen,1040,4,12,7,11,54,43,11,43
AaB,1040,5,8,12,10,39,42,-3,36
AC Horsens,1040,6,6,13,11,32,54,-22,31
Sonderjyske,1040,7,8,6,10,28,29,-1,30
Randers FC,1040,8,6,6,12,26,39,-13,24
Silkeborg IF,1040,9,5,4,13,28,47,-19,19
AGF Aarhus,1040,10,4,7,11,19,39,-20,19
Lyngby,1040,11,3,9,12,26,47,-21,18
Brondby,1041,1,21,6,3,69,30,39,69
FC Midtjylla,1041,2,21,4,5,68,39,29,67
FC Nords,1041,3,13,7,10,70,53,17,46
Copenhagen,1041,4,14,4,12,54,48,6,46
AaB,1041,5,8,12,10,40,41,-1,36
AC Horsens,1041,6,6,13,11,36,52,-16,31
Sonderjyske,1041,7,8,6,10,28,29,-1,30
Lyngby,1041,8,4,9,11,28,44,-16,21
Randers FC,1041,9,5,6,13,23,41,-18,21
AGF Aarhus,1041,10,5,6,11,17,36,-19,21
Silkeborg IF,1041,11,5,3,14,25,45,-20,18
Brondby,1042,1,21,6,3,76,34,42,69
FC Midtjylla,1042,2,18,6,6,69,46,23,60
FC Nords,1042,3,14,8,8,73,53,20,50
Copenhagen,1042,4,15,5,10,61,45,16,50
AaB,1042,5,7,13,10,40,46,-6,34
Sonderjyske,1042,6,8,6,10,28,29,-1,30
AC Horsens,1042,7,5,14,11,34,55,-21,29
Randers FC,1042,8,5,7,12,23,39,-16,22
Silkeborg IF,1042,9,6,3,13,26,44,-18,21
Lyngby,1042,10,3,10,11,26,44,-18,19
AGF Aarhus,1042,11,4,6,12,16,37,-21,18
Brondby,1043,1,20,6,4,70,35,35,66
FC Midtjylla,1043,2,19,5,6,70,44,26,62
Copenhagen,1043,3,15,5,10,63,47,16,50
FC Nords,1043,4,14,7,9,78,52,26,49
AaB,1043,5,10,11,9,42,42,0,41
Sonderjyske,1043,6,8,6,10,28,29,-1,30
AC Horsens,1043,7,5,12,13,36,65,-29,27
Lyngby,1043,8,4,9,11,28,45,-17,21
Randers FC,1043,9,5,6,13,24,41,-17,21
Silkeborg IF,1043,10,6,3,13,26,44,-18,21
AGF Aarhus,1043,11,4,6,12,16,37,-21,18
FC Midtjylla,1044,1,22,4,4,72,36,36,70
Brondby,1044,2,21,5,4,71,34,37,68
FC Nords,1044,3,14,6,10,75,57,18,48
Copenhagen,1044,4,13,5,12,55,47,8,44
AC Horsens,1044,5,7,13,10,37,53,-16,34
AaB,1044,6,7,11,12,39,48,-9,32
Sonderjyske,1044,7,8,6,10,28,29,-1,30
Lyngby,1044,8,4,9,11,29,44,-15,21
Silkeborg IF,1044,9,6,3,13,28,44,-16,21
Randers FC,1044,10,5,6,13,23,42,-19,21
AGF Aarhus,1044,11,4,6,12,16,39,-23,18
Brondby,1045,1,20,6,4,68,34,34,66
FC Midtjylla,1045,2,19,5,6,64,38,26,62
FC Nords,1045,3,12,11,7,72,51,21,47
Copenhagen,1045,4,13,6,11,55,44,11,45
AaB,1045,5,9,13,8,39,40,-1,40
Sonderjyske,1045,6,8,6,10,28,29,-1,30
AC Horsens,1045,7,5,15,10,36,53,-17,30
Lyngby,1045,8,4,9,11,28,44,-16,21
Randers FC,1045,9,5,6,13,23,41,-18,21
AGF Aarhus,1045,10,5,6,11,17,36,-19,21
Silkeborg IF,1045,11,5,3,14,25,45,-20,18
Brondby,1046,1,21,7,2,73,31,42,70
FC Midtjylla,1046,2,19,5,6,63,42,21,62
FC Nords,1046,3,14,6,10,76,53,23,48
Copenhagen,1046,4,14,4,12,57,43,14,46
AaB,1046,5,8,12,10,37,45,-8,36
AC Horsens,1046,6,6,14,10,36,54,-18,32
Sonderjyske,1046,7,8,6,10,28,29,-1,30
Randers FC,1046,8,5,7,12,25,41,-16,22
AGF Aarhus,1046,9,5,6,11,17,36,-19,21
Lyngby,1046,10,3,10,11,28,46,-18,19
Silkeborg IF,1046,11,5,3,14,25,45,-20,18
Brondby,1047,1,19,7,4,68,34,34,64
FC Midtjylla,1047,2,18,5,7,67,42,25,59
FC Nords,1047,3,15,7,8,77,54,23,52
Copenhagen,1047,4,13,6,11,56,45,11,45
AaB,1047,5,8,13,9,39,44,-5,37
AC Horsens,1047,6,7,14,9,40,54,-14,35
Sonderjyske,1047,7,8,6,10,28,29,-1,30
Randers FC,1047,8,6,6,12,26,39,-13,24
AGF Aarhus,1047,9,5,6,11,18,36,-18,21
Lyngby,1047,10,3,9,12,26,47,-21,18
Silkeborg IF,1047,11,5,3,14,25,46,-21,18
Brondby,1048,1,20,6,4,67,33,34,66
FC Midtjylla,1048,2,19,5,6,64,37,27,62
FC Nords,1048,3,16,7,7,78,48,30,55
Copenhagen,1048,4,13,4,13,56,49,7,43
AaB,1048,5,9,12,9,40,44,-4,39
Sonderjyske,1048,6,8,6,10,28,29,-1,30
AC Horsens,1048,7,6,12,12,34,54,-20,30
Randers FC,1048,8,6,6,12,26,39,-13,24
Silkeborg IF,1048,9,6,3,13,26,44,-18,21
Lyngby,1048,10,3,9,12,26,47,-21,18
AGF Aarhus,1048,11,4,6,12,16,37,-21,18
Brondby,1049,1,21,5,4,70,33,37,68
FC Midtjylla,1049,2,18,4,8,62,44,18,58
FC Nords,1049,3,16,6,8,77,48,29,54
Copenhagen,1049,4,14,4,12,57,45,12,46
AC Horsens,1049,5,8,12,10,36,49,-13,36
AaB,1049,6,8,11,11,39,48,-9,35
Sonderjyske,1049,7,8,6,10,28,29,-1,30
Randers FC,1049,8,5,7,12,24,40,-16,22
Silkeborg IF,1049,9,6,3,13,28,45,-17,21
Lyngby,1049,10,3,10,11,27,45,-18,19
AGF Aarhus,1049,11,4,6,12,17,39,-22,18
Brondby,1050,1,21,7,2,69,30,39,70
FC Midtjylla,1050,2,19,6,5,60,34,26,63
FC Nords,1050,3,15,8,7,74,47,27,53
Copenhagen,1050,4,12,6,12,51,46,5,42
AC Horsens,1050,5,7,13,10,38,51,-13,34
Sonderjyske,1050,6,8,6,10,28,29,-1,30
AaB,1050,7,6,12,12,34,44,-10,30
Lyngby,1050,8,4,9,11,28,44,-16,21
Silkeborg IF,1050,9,6,3,13,26,44,-18,21
Randers FC,1050,10,5,6,13,23,41,-18,21
AGF Aarhus,1050,11,4,6,12,16,37,-21,18
Brondby,1051,1,22,5,3,73,28,45,71
FC Midtjylla,1051,2,18,6,6,62,43,19,60
FC Nords,1051,3,14,8,8,76,53,23,50
Copenhagen,1051,4,12,7,11,56,48,8,43
AaB,1051,5,7,13,10,39,42,-3,34
AC Horsens,1051,6,6,15,9,35,53,-18,33
Sonderjyske,1051,7,8,6,10,28,29,-1,30
Randers FC,1051,8,5,7,12,24,40,-16,22
Silkeborg IF,1051,9,6,3,13,27,45,-18,21
Lyngby,1051,10,3,10,11,27,45,-18,19
AGF Aarhus,1051,11,4,6,12,17,38,-21,18
Brondby,1052,1,21,6,3,68,31,37,69
FC Midtjylla,1052,2,19,4,7,67,39,28,61
FC Nords,1052,3,15,6,9,75,51,24,51
Copenhagen,1052,4,14,5,11,57,46,11,47
AC Horsens,1052,5,8,12,10,37,54,-17,36
AaB,1052,6,7,11,12,34,43,-9,32
Sonderjyske,1052,7,8,6,10,28,29,-1,30
Randers FC,1052,8,6,6,12,26,40,-14,24
Silkeborg IF,1052,9,6,3,13,30,45,-15,21
Lyngby,1052,10,3,9,12,27,47,-20,18
AGF Aarhus,1052,11,4,6,12,17,41,-24,18
Brondby,1053,1,22,5,3,74,31,43,71
FC Midtjylla,1053,2,20,5,5,68,42,26,65
FC Nords,1053,3,14,6,10,73,52,21,48
Copenhagen,1053,4,13,5,12,58,50,8,44
AC Horsens,1053,5,8,12,10,36,51,-15,36
AaB,1053,6,7,11,12,35,44,-9,32
Sonderjyske,1053,7,8,6,10,28,29,-1,30
Randers FC,1053,8,5,7,12,24,40,-16,22
AGF Aarhus,1053,9,5,6,11,18,36,-18,21
Lyngby,1053,10,3,10,11,27,45,-18,19
Silkeborg IF,1053,11,5,3,14,25,46,-21,18
Brondby,1054,1,20,7,3,77,38,39,67
FC Midtjylla,1054,2,20,4,6,71,45,26,64
FC Nords,1054,3,13,9,8,76,51,25,48
Copenhagen,1054,4,13,5,12,57,47,10,44
AaB,1054,5,8,13,9,44,48,-4,37
AC Horsens,1054,6,7,12,11,36,58,-22,33
Sonderjyske,1054,7,8,6,10,28,29,-1,30
Randers FC,1054,8,5,7,12,24,40,-16,22
Silkeborg IF,1054,9,6,3,13,27,45,-18,21
Lyngby,1054,10,3,10,11,27,45,-18,19
AGF Aarhus,1054,11,4,6,12,17,38,-21,18
Brondby,1055,1,20,7,3,71,33,38,67
FC Midtjylla,1055,2,19,5,6,67,41,26,62
Copenhagen,1055,3,16,5,9,67,46,21,53
FC Nords,1055,4,14,6,10,79,61,18,48
AC Horsens,1055,5,7,12,11,36,54,-18,33
AaB,1055,6,7,11,12,40,51,-11,32
Sonderjyske,1055,7,8,6,10,28,29,-1,30
Lyngby,1055,8,4,9,11,29,46,-17,21
Silkeborg IF,1055,9,6,3,13,27,44,-17,21
Randers FC,1055,10,5,6,13,25,42,-17,21
AGF Aarhus,1055,11,4,6,12,16,38,-22,18
Brondby,1056,1,20,6,4,75,38,37,66
FC Midtjylla,1056,2,20,6,4,74,42,32,66
FC Nords,1056,3,15,7,8,74,50,24,52
Copenhagen,1056,4,13,4,13,55,48,7,43
AaB,1056,5,9,11,10,39,45,-6,38
Sonderjyske,1056,6,8,6,10,28,29,-1,30
AC Horsens,1056,7,6,12,12,33,53,-20,30
Lyngby,1056,8,4,9,11,27,44,-17,21
Randers FC,1056,9,5,6,13,23,40,-17,21
Silkeborg IF,1056,10,6,3,13,27,45,-18,21
AGF Aarhus,1056,11,4,6,12,17,38,-21,18
Brondby,1057,1,20,7,3,70,32,38,67
FC Midtjylla,1057,2,21,4,5,71,40,31,67
Copenhagen,1057,3,15,4,11,61,49,12,49
FC Nords,1057,4,12,7,11,74,58,16,43
AaB,1057,5,8,11,11,37,45,-8,35
AC Horsens,1057,6,7,13,10,39,54,-15,34
Sonderjyske,1057,7,8,6,10,28,29,-1,30
Randers FC,1057,8,6,6,12,25,39,-14,24
AGF Aarhus,1057,9,5,6,11,17,36,-19,21
Lyngby,1057,10,3,9,12,26,46,-20,18
Silkeborg IF,1057,11,5,3,14,25,45,-20,18
Brondby,1058,1,21,6,3,72,34,38,69
FC Midtjylla,1058,2,19,6,5,65,38,27,63
FC Nords,1058,3,15,6,9,76,50,26,51
Copenhagen,1058,4,13,4,13,55,47,8,43
AC Horsens,1058,5,8,12,10,40,57,-17,36
AaB,1058,6,7,12,11,36,44,-8,33
Sonderjyske,1058,7,8,6,10,28,29,-1,30
Randers FC,1058,8,5,7,12,24,40,-16,22
Silkeborg IF,1058,9,6,3,13,26,44,-18,21
Lyngby,1058,10,3,10,11,27,45,-18,19
AGF Aarhus,1058,11,4,6,12,16,37,-21,18
Brondby,1059,1,22,5,3,76,33,43,71
FC Midtjylla,1059,2,20,4,6,71,42,29,64
Copenhagen,1059,3,14,5,11,62,47,15,47
FC Nords,1059,4,12,7,11,70,56,14,43
AaB,1059,5,8,12,10,38,45,-7,36
AC Horsens,1059,6,7,13,10,37,57,-20,34
Sonderjyske,1059,7,8,6,10,28,29,-1,30
Randers FC,1059,8,6,6,12,24,39,-15,24
Silkeborg IF,1059,9,6,3,13,26,44,-18,21
Lyngby,1059,10,3,9,12,26,45,-19,18
AGF Aarhus,1059,11,4,6,12,16,37,-21,18
Brondby,1060,1,21,6,3,73,31,42,69
FC Midtjylla,1060,2,21,4,5,72,41,31,67
FC Nords,1060,3,15,6,9,79,55,24,51
Copenhagen,1060,4,12,7,11,59,48,11,43
AaB,1060,5,8,12,10,41,49,-8,36
Sonderjyske,1060,6,8,6,10,28,29,-1,30
AC Horsens,1060,7,5,13,12,34,60,-26,28
Randers FC,1060,8,5,7,12,24,40,-16,22
AGF Aarhus,1060,9,5,6,11,18,36,-18,21
Lyngby,1060,10,3,10,11,27,45,-18,19
Silkeborg IF,1060,11,5,3,14,25,46,-21,18
Brondby,1061,1,23,5,2,76,33,43,74
FC Midtjylla,1061,2,18,6,6,62,39,23,60
FC Nords,1061,3,14,7,9,74,54,20,49
Copenhagen,1061,4,13,5,12,54,45,9,44
AC Horsens,1061,5,7,14,9,37,50,-13,35
AaB,1061,6,6,13,11,37,45,-8,31
Sonderjyske,1061,7,8,6,10,28,29,-1,30
Randers FC,1061,8,5,7,12,24,40,-16,22
Silkeborg IF,1061,9,6,3,13,28,45,-17,21
Lyngby,1061,10,3,10,11,27,45,-18,19
AGF Aarhus,1061,11,4,6,12,17,39,-22,18
Brondby,1062,1,20,7,3,69,33,36,67
FC Midtjylla,1062,2,19,7,4,67,40,27,64
FC Nords,1062,3,13,7,10,68,50,18,46
Copenhagen,1062,4,12,6,12,57,47,10,42
AC Horsens,1062,5,8,13,9,35,48,-13,37
AaB,1062,6,8,12,10,36,40,-4,36
Sonderjyske,1062,7,8,6,10,28,29,-1,30
Randers FC,1062,8,6,6,12,25,39,-14,24
AGF Aarhus,1062,9,5,6,11,17,36,-19,21
Lyngby,1062,10,3,9,12,26,46,-20,18
Silkeborg IF,1062,11,5,3,14,25,45,-20,18
Brondby,1063,1,22,6,2,78,32,46,72
FC Midtjylla,1063,2,19,5,6,65,44,21,62
FC Nords,1063,3,15,7,8,76,49,27,52
Copenhagen,1063,4,13,5,12,56,48,8,44
AC Horsens,1063,5,7,12,11,35,56,-21,33
AaB,1063,6,7,11,12,35,42,-7,32
Sonderjyske,1063,7,8,6,10,28,29,-1,30
Lyngby,1063,8,4,9,11,28,44,-16,21
Silkeborg IF,1063,8,6,3,13,28,44,-16,21
Randers FC,1063,10,5,6,13,23,41,-18,21
AGF Aarhus,1063,11,4,6,12,16,39,-23,18
Brondby,1064,1,23,5,2,77,31,46,74
FC Midtjylla,1064,2,19,6,5,64,37,27,63
Copenhagen,1064,3,15,5,10,57,44,13,50
FC Nords,1064,4,12,8,10,71,54,17,44
AaB,1064,5,7,11,12,37,46,-9,32
AC Horsens,1064,6,6,13,11,35,55,-20,31
Sonderjyske,1064,7,8,6,10,28,29,-1,30
Randers FC,1064,8,6,6,12,24,39,-15,24
Silkeborg IF,1064,9,5,4,13,25,44,-19,19
AGF Aarhus,1064,10,4,7,11,16,36,-20,19
Lyngby,1064,11,3,9,12,26,45,-19,18
Brondby,1065,1,21,7,2,71,33,38,70
FC Midtjylla,1065,2,18,7,5,63,38,25,61
FC Nords,1065,3,14,8,8,73,49,24,50
Copenhagen,1065,4,13,6,11,57,45,12,45
AaB,1065,5,8,13,9,37,39,-2,37
Sonderjyske,1065,6,8,6,10,28,29,-1,30
AC Horsens,1065,7,5,13,12,33,56,-23,28
Lyngby,1065,8,4,9,11,28,44,-16,21
Silkeborg IF,1065,9,6,3,13,28,46,-18,21
Randers FC,1065,10,5,6,13,23,41,-18,21
AGF Aarhus,1065,11,4,6,12,18,39,-21,18
Brondby,1066,1,20,6,4,71,33,38,66
FC Midtjylla,1066,2,20,4,6,63,38,25,64
FC Nords,1066,3,14,6,10,71,54,17,48
Copenhagen,1066,4,14,5,11,57,43,14,47
AaB,1066,5,8,13,9,37,40,-3,37
AC Horsens,1066,6,6,14,10,37,54,-17,32
Sonderjyske,1066,7,8,6,10,28,29,-1,30
Lyngby,1066,8,4,9,11,27,44,-17,21
Randers FC,1066,9,5,6,13,23,40,-17,21
Silkeborg IF,1066,10,6,3,13,26,44,-18,21
AGF Aarhus,1066,11,4,6,12,16,37,-21,18
Brondby,1067,1,21,7,2,75,33,42,70
FC Midtjylla,1067,2,20,5,5,68,42,26,65
FC Nords,1067,3,13,7,10,69,51,18,46
Copenhagen,1067,4,13,5,12,61,56,5,44
AaB,1067,5,8,12,10,38,41,-3,36
AC Horsens,1067,6,7,12,11,39,53,-14,33
Sonderjyske,1067,7,8,6,10,28,29,-1,30
Lyngby,1067,8,4,9,11,29,45,-16,21
Silkeborg IF,1067,9,6,3,13,26,44,-18,21
Randers FC,1067,10,5,6,13,24,42,-18,21
AGF Aarhus,1067,11,4,6,12,16,37,-21,18
FC Midtjylla,1068,1,21,4,5,68,36,32,67
Brondby,1068,2,20,5,5,67,34,33,65
FC Nords,1068,3,15,6,9,75,52,23,51
Copenhagen,1068,4,13,5,12,54,45,9,44
AC Horsens,1068,5,8,12,10,36,52,-16,36
AaB,1068,6,7,12,11,35,42,-7,33
Sonderjyske,1068,7,8,6,10,28,29,-1,30
Lyngby,1068,8,4,9,11,27,44,-17,21
Randers FC,1068,9,5,6,13,23,40,-17,21
Silkeborg IF,1068,10,6,3,13,26,44,-18,21
AGF Aarhus,1068,11,4,6,12,16,37,-21,18
Brondby,1069,1,20,6,4,67,31,36,66
FC Midtjylla,1069,2,18,5,7,62,42,20,59
FC Nords,1069,3,15,7,8,74,45,29,52
Copenhagen,1069,4,13,5,12,59,51,8,44
AC Horsens,1069,5,8,13,9,36,51,-15,37
AaB,1069,6,8,12,10,39,43,-4,36
Sonderjyske,1069,7,8,6,10,28,29,-1,30
Randers FC,1069,8,5,7,12,24,40,-16,22
Silkeborg IF,1069,9,6,3,13,27,45,-18,21
Lyngby,1069,10,3,10,11,27,45,-18,19
AGF Aarhus,1069,11,4,6,12,17,38,-21,18
Brondby,1070,1,20,6,4,76,34,42,66
FC Midtjylla,1070,2,19,5,6,66,45,21,62
FC Nords,1070,3,14,9,7,76,51,25,51
Copenhagen,1070,4,13,6,11,57,44,13,45
AaB,1070,5,7,13,10,35,47,-12,34
AC Horsens,1070,6,6,15,9,36,51,-15,33
Sonderjyske,1070,7,8,6,10,28,29,-1,30
Lyngby,1070,8,4,9,11,27,44,-17,21
Randers FC,1070,9,5,6,13,23,40,-17,21
AGF Aarhus,1070,10,5,6,11,19,37,-18,21
Silkeborg IF,1070,11,5,3,14,26,47,-21,18
Brondby,1071,1,22,5,3,69,31,38,71
FC Midtjylla,1071,2,19,6,5,65,39,26,63
FC Nords,1071,3,15,7,8,75,51,24,52
Copenhagen,1071,4,14,6,10,58,43,15,48
AC Horsens,1071,5,6,13,11,33,50,-17,31
Sonderjyske,1071,6,8,6,10,28,29,-1,30
AaB,1071,7,6,11,13,35,47,-12,29
Lyngby,1071,8,4,9,11,28,45,-17,21
Randers FC,1071,9,5,6,13,24,41,-17,21
Silkeborg IF,1071,10,5,4,13,26,45,-19,19
AGF Aarhus,1071,11,4,7,11,17,37,-20,19
Brondby,1072,1,21,6,3,72,33,39,69
FC Midtjylla,1072,2,18,6,6,65,41,24,60
Copenhagen,1072,3,16,4,10,59,45,14,52
FC Nords,1072,4,14,8,8,78,48,30,50
AC Horsens,1072,5,7,12,11,36,57,-21,33
Sonderjyske,1072,6,8,6,10,28,29,-1,30
AaB,1072,7,6,12,12,34,46,-12,30
Randers FC,1072,8,6,6,12,25,40,-15,24
Silkeborg IF,1072,9,6,3,13,28,45,-17,21
Lyngby,1072,10,3,9,12,27,46,-19,18
AGF Aarhus,1072,11,4,6,12,17,39,-22,18
Brondby,1073,1,21,6,3,73,35,38,69
FC Midtjylla,1073,2,19,5,6,68,39,29,62
FC Nords,1073,3,14,7,9,71,54,17,49
Copenhagen,1073,4,14,6,10,56,41,15,48
AaB,1073,5,8,13,9,40,44,-4,37
Sonderjyske,1073,6,8,6,10,28,29,-1,30
AC Horsens,1073,7,5,13,12,31,52,-21,28
Lyngby,1073,8,4,9,11,29,44,-15,21
AGF Aarhus,1073,9,5,6,11,18,36,-18,21
Randers FC,1073,10,5,6,13,23,42,-19,21
Silkeborg IF,1073,11,5,3,14,25,46,-21,18
Brondby,1074,1,21,6,3,72,34,38,69
FC Midtjylla,1074,2,20,5,5,70,41,29,65
FC Nords,1074,3,15,7,8,74,49,25,52
Copenhagen,1074,4,14,5,11,62,49,13,47
AC Horsens,1074,5,6,14,10,35,51,-16,32
Sonderjyske,1074,6,8,6,10,28,29,-1,30
AaB,1074,7,6,11,13,33,48,-15,29
Lyngby,1074,8,4,9,11,27,44,-17,21
Randers FC,1074,9,5,6,13,23,40,-17,21
Silkeborg IF,1074,10,6,3,13,27,45,-18,21
AGF Aarhus,1074,11,4,6,12,17,38,-21,18
Brondby,1075,1,22,5,3,73,30,43,71
FC Midtjylla,1075,2,21,4,5,70,38,32,67
FC Nords,1075,3,13,8,9,69,52,17,47
Copenhagen,1075,4,13,4,13,52,44,8,43
AC Horsens,1075,5,7,13,10,37,53,-16,34
AaB,1075,6,7,12,11,37,47,-10,33
Sonderjyske,1075,7,8,6,10,28,29,-1,30
Randers FC,1075,8,6,6,12,24,39,-15,24
Silkeborg IF,1075,9,5,4,13,26,45,-19,19
AGF Aarhus,1075,10,4,7,11,17,37,-20,19
Lyngby,1075,11,3,9,12,26,45,-19,18
Brondby,1076,1,23,5,2,81,35,46,74
FC Midtjylla,1076,2,19,6,5,65,38,27,63
FC Nords,1076,3,13,8,9,73,54,19,47
Copenhagen,1076,4,13,6,11,59,50,9,45
AaB,1076,5,6,14,10,39,46,-7,32
AC Horsens,1076,6,6,13,11,34,54,-20,31
Sonderjyske,1076,7,8,6,10,28,29,-1,30
Randers FC,1076,8,6,6,12,26,40,-14,24
AGF Aarhus,1076,9,5,6,11,17,36,-19,21
Lyngby,1076,10,3,9,12,27,47,-20,18
Silkeborg IF,1076,11,5,3,14,25,45,-20,18
Brondby,1077,1,19,8,3,70,35,35,65
FC Midtjylla,1077,2,20,5,5,68,38,30,65
FC Nords,1077,3,16,7,7,73,46,27,55
Copenhagen,1077,4,13,6,11,56,46,10,45
AaB,1077,5,8,12,10,36,42,-6,36
Sonderjyske,1077,6,8,6,10,28,29,-1,30
AC Horsens,1077,7,5,12,13,32,54,-22,27
Lyngby,1077,8,4,9,11,28,45,-17,21
Randers FC,1077,9,5,6,13,24,41,-17,21
AGF Aarhus,1077,10,5,6,11,17,36,-19,21
Silkeborg IF,1077,11,5,3,14,25,45,-20,18
Brondby,1078,1,20,6,4,72,37,35,66
FC Midtjylla,1078,2,20,5,5,67,38,29,65
FC Nords,1078,3,14,7,9,73,54,19,49
Copenhagen,1078,4,15,4,11,59,48,11,49
AaB,1078,5,7,12,11,39,42,-3,33
AC Horsens,1078,6,6,14,10,36,53,-17,32
Sonderjyske,1078,7,8,6,10,28,29,-1,30
Randers FC,1078,8,6,6,12,25,40,-15,24
Silkeborg IF,1078,9,6,3,13,27,45,-18,21
Lyngby,1078,10,3,9,12,27,46,-19,18
AGF Aarhus,1078,11,4,6,12,17,38,-21,18
Brondby,1079,1,20,5,5,66,34,32,65
FC Midtjylla,1079,2,20,5,5,66,39,27,65
FC Nords,1079,3,14,6,10,73,55,18,48
Copenhagen,1079,4,14,6,10,59,44,15,48
AC Horsens,1079,5,8,13,9,42,55,-13,37
AaB,1079,6,7,11,12,38,43,-5,32
Sonderjyske,1079,7,8,6,10,28,29,-1,30
Lyngby,1079,8,4,9,11,27,44,-17,21
Randers FC,1079,9,5,6,13,23,40,-17,21
Silkeborg IF,1079,10,6,3,13,27,45,-18,21
AGF Aarhus,1079,11,4,6,12,17,38,-21,18
Brondby,1080,1,20,7,3,68,29,39,67
FC Midtjylla,1080,2,20,5,5,68,41,27,65
FC Nords,1080,3,14,7,9,75,48,27,49
Copenhagen,1080,4,13,5,12,54,47,7,44
AaB,1080,5,7,15,8,37,40,-3,36
AC Horsens,1080,6,6,13,11,37,60,-23,31
Sonderjyske,1080,7,8,6,10,28,29,-1,30
Randers FC,1080,8,6,6,12,26,41,-15,24
Silkeborg IF,1080,9,6,3,13,27,44,-17,21
Lyngby,1080,10,3,9,12,28,47,-19,18
AGF Aarhus,1080,11,4,6,12,16,38,-22,18
FC Midtjylla,1081,1,21,4,5,72,40,32,67
Brondby,1081,2,20,6,4,69,34,35,66
Copenhagen,1081,3,16,4,10,66,44,22,52
FC Nords,1081,4,14,7,9,76,55,21,49
AC Horsens,1081,5,6,14,10,38,58,-20,32
Sonderjyske,1081,6,8,6,10,28,29,-1,30
AaB,1081,7,6,11,13,37,53,-16,29
Randers FC,1081,8,5,7,12,24,40,-16,22
Silkeborg IF,1081,9,6,3,13,26,44,-18,21
Lyngby,1081,10,3,10,11,27,45,-18,19
AGF Aarhus,1081,11,4,6,12,16,37,-21,18
Brondby,1082,1,21,5,4,71,30,41,68
FC Midtjylla,1082,2,19,4,7,66,42,24,61
Copenhagen,1082,3,15,5,10,58,43,15,50
FC Nords,1082,4,14,7,9,73,50,23,49
AC Horsens,1082,5,8,12,10,34,51,-17,36
AaB,1082,6,6,13,11,37,49,-12,31
Sonderjyske,1082,7,8,6,10,28,29,-1,30
Randers FC,1082,8,5,7,12,23,39,-16,22
AGF Aarhus,1082,9,5,6,11,18,36,-18,21
Lyngby,1082,10,3,10,11,26,44,-18,19
Silkeborg IF,1082,11,5,3,14,25,46,-21,18
Brondby,1083,1,21,7,2,72,33,39,70
FC Midtjylla,1083,2,20,4,6,69,45,24,64
FC Nords,1083,3,14,8,8,74,51,23,50
Copenhagen,1083,4,13,6,11,56,42,14,45
AC Horsens,1083,5,6,14,10,33,52,-19,32
AaB,1083,6,6,13,11,35,42,-7,31
Sonderjyske,1083,7,8,6,10,28,29,-1,30
Randers FC,1083,8,6,6,12,25,39,-14,24
AGF Aarhus,1083,9,5,6,11,19,38,-19,21
Silkeborg IF,1083,10,5,3,14,27,47,-20,18
Lyngby,1083,11,3,9,12,26,46,-20,18
Brondby,1084,1,21,6,3,72,30,42,69
FC Midtjylla,1084,2,19,6,5,65,41,24,63
FC Nords,1084,3,14,8,8,74,55,19,50
Copenhagen,1084,4,13,5,12,55,44,11,44
AaB,1084,5,7,13,10,39,44,-5,34
AC Horsens,1084,6,6,14,10,39,56,-17,32
Sonderjyske,1084,7,8,6,10,28,29,-1,30
Randers FC,1084,8,5,7,12,24,40,-16,22
AGF Aarhus,1084,9,5,6,11,18,36,-18,21
Lyngby,1084,10,3,10,11,27,45,-18,19
Silkeborg IF,1084,11,5,3,14,25,46,-21,18
Brondby,1085,1,20,6,4,71,35,36,66
FC Midtjylla,1085,2,20,4,6,63,39,24,64
FC Nords,1085,3,16,6,8,79,49,30,54
Copenhagen,1085,4,13,5,12,54,45,9,44
AC Horsens,1085,5,8,12,10,38,53,-15,36
AaB,1085,6,6,13,11,36,46,-10,31
Sonderjyske,1085,7,8,6,10,28,29,-1,30
Lyngby,1085,8,4,9,11,29,45,-16,21
Randers FC,1085,9,5,6,13,24,42,-18,21
AGF Aarhus,1085,10,5,6,11,18,37,-19,21
Silkeborg IF,1085,11,5,3,14,26,46,-20,18
Brondby,1086,1,20,6,4,71,36,35,66
FC Midtjylla,1086,2,20,5,5,68,38,30,65
FC Nords,1086,3,14,8,8,73,52,21,50
Copenhagen,1086,4,14,6,10,58,43,15,48
AC Horsens,1086,5,7,12,11,38,56,-18,33
AaB,1086,6,6,13,11,34,43,-9,31
Sonderjyske,1086,7,8,6,10,28,29,-1,30
Randers FC,1086,8,5,7,12,24,40,-16,22
Silkeborg IF,1086,9,6,3,13,28,44,-16,21
Lyngby,1086,10,3,10,11,27,45,-18,19
AGF Aarhus,1086,11,4,6,12,16,39,-23,18
Brondby,1087,1,21,5,4,71,34,37,68
FC Midtjylla,1087,2,19,5,6,65,38,27,62
FC Nords,1087,3,15,6,9,77,53,24,51
Copenhagen,1087,4,13,5,12,55,46,9,44
AaB,1087,5,9,13,8,38,39,-1,40
Sonderjyske,1087,6,8,6,10,28,29,-1,30
AC Horsens,1087,7,5,14,11,34,56,-22,29
Randers FC,1087,8,5,7,12,24,40,-16,22
AGF Aarhus,1087,9,5,6,11,17,36,-19,21
Lyngby,1087,10,3,10,11,27,45,-18,19
Silkeborg IF,1087,11,5,3,14,25,45,-20,18
Brondby,1088,1,20,6,4,70,37,33,66
FC Midtjylla,1088,2,20,4,6,63,37,26,64
Copenhagen,1088,3,17,4,9,62,42,20,55
FC Nords,1088,4,13,7,10,73,50,23,46
AaB,1088,5,8,11,11,36,42,-6,35
Sonderjyske,1088,6,8,6,10,28,29,-1,30
AC Horsens,1088,7,6,12,12,34,56,-22,30
Randers FC,1088,8,6,6,12,26,39,-13,24
Silkeborg IF,1088,9,5,4,13,27,46,-19,19
AGF Aarhus,1088,10,4,7,11,18,38,-20,19
Lyngby,1088,11,3,9,12,26,47,-21,18
Brondby,1089,1,20,7,3,71,34,37,67
FC Midtjylla,1089,2,20,5,5,70,42,28,65
Copenhagen,1089,3,15,5,10,60,46,14,50
FC Nords,1089,4,13,6,11,74,58,16,45
AaB,1089,5,7,13,10,39,44,-5,34
AC Horsens,1089,6,6,14,10,36,52,-16,32
Sonderjyske,1089,7,8,6,10,28,29,-1,30
Randers FC,1089,8,5,7,12,24,40,-16,22
Lyngby,1089,9,3,10,11,27,45,-18,19
Silkeborg IF,1089,10,5,4,13,26,45,-19,19
AGF Aarhus,1089,11,4,7,11,17,37,-20,19
Brondby,1090,1,22,5,3,75,35,40,71
FC Midtjylla,1090,2,19,5,6,66,42,24,62
Copenhagen,1090,3,15,5,10,63,45,18,50
FC Nords,1090,4,13,7,10,74,54,20,46
AaB,1090,5,8,12,10,38,42,-4,36
Sonderjyske,1090,6,8,6,10,28,29,-1,30
AC Horsens,1090,7,6,12,12,31,55,-24,30
Randers FC,1090,8,5,7,12,24,40,-16,22
AGF Aarhus,1090,9,5,6,11,17,36,-19,21
Lyngby,1090,10,3,10,11,27,45,-18,19
Silkeborg IF,1090,11,5,3,14,25,45,-20,18
FC Midtjylla,1091,1,20,6,4,67,38,29,66
Brondby,1091,2,19,7,4,71,39,32,64
Copenhagen,1091,3,14,5,11,57,45,12,47
FC Nords,1091,4,13,7,10,74,56,18,46
AaB,1091,5,8,13,9,39,41,-2,37
AC Horsens,1091,6,7,12,11,37,52,-15,33
Sonderjyske,1091,7,8,6,10,28,29,-1,30
Randers FC,1091,8,6,6,12,28,41,-13,24
AGF Aarhus,1091,9,5,6,11,19,36,-17,21
Lyngby,1091,10,3,9,12,28,49,-21,18
Silkeborg IF,1091,11,5,3,14,25,47,-22,18
Brondby,1092,1,20,6,4,71,34,37,66
FC Midtjylla,1092,2,18,7,5,64,40,24,61
Copenhagen,1092,3,14,6,10,55,40,15,48
FC Nords,1092,4,12,9,9,70,54,16,45
AC Horsens,1092,5,7,15,8,38,49,-11,36
AaB,1092,6,7,13,10,37,44,-7,34
Sonderjyske,1092,7,8,6,10,28,29,-1,30
Randers FC,1092,8,6,6,12,24,39,-15,24
AGF Aarhus,1092,9,5,6,11,19,37,-18,21
Lyngby,1092,10,3,9,12,26,45,-19,18
Silkeborg IF,1092,11,5,3,14,26,47,-21,18
FC Midtjylla,1093,1,21,5,4,66,35,31,68
Brondby,1093,2,20,6,4,70,34,36,66
Copenhagen,1093,3,15,5,10,57,41,16,50
FC Nords,1093,4,12,7,11,66,52,14,43
AaB,1093,5,9,11,10,40,42,-2,38
Sonderjyske,1093,6,8,6,10,28,29,-1,30
AC Horsens,1093,7,5,14,11,31,52,-21,29
Randers FC,1093,8,6,6,12,25,40,-15,24
Silkeborg IF,1093,9,6,3,13,29,47,-18,21
Lyngby,1093,10,3,9,12,27,46,-19,18
AGF Aarhus,1093,11,4,6,12,19,40,-21,18
Brondby,1094,1,20,7,3,71,33,38,67
FC Midtjylla,1094,2,18,4,8,62,44,18,58
FC Nords,1094,3,16,7,7,80,48,32,55
Copenhagen,1094,4,13,7,10,60,48,12,46
AaB,1094,5,7,13,10,34,43,-9,34
AC Horsens,1094,6,6,14,10,36,53,-17,32
Sonderjyske,1094,7,8,6,10,28,29,-1,30
Lyngby,1094,8,4,9,11,29,46,-17,21
Randers FC,1094,9,5,6,13,25,42,-17,21
Silkeborg IF,1094,10,6,3,13,27,45,-18,21
AGF Aarhus,1094,11,4,6,12,17,38,-21,18
Brondby,1095,1,22,5,3,71,31,40,71
FC Midtjylla,1095,2,19,4,7,65,40,25,61
FC Nords,1095,3,15,6,9,75,56,19,51
Copenhagen,1095,4,15,4,11,61,43,18,49
AC Horsens,1095,5,7,12,11,35,54,-19,33
AaB,1095,6,7,11,12,35,44,-9,32
Sonderjyske,1095,7,8,6,10,28,29,-1,30
Randers FC,1095,8,5,7,12,24,40,-16,22
Silkeborg IF,1095,9,6,3,13,26,44,-18,21
Lyngby,1095,10,3,10,11,27,45,-18,19
AGF Aarhus,1095,11,4,6,12,16,37,-21,18
Brondby,1096,1,21,6,3,72,31,41,69
FC Midtjylla,1096,2,18,5,7,63,42,21,59
FC Nords,1096,3,13,8,9,77,58,19,47
Copenhagen,1096,4,14,5,11,57,46,11,47
AC Horsens,1096,5,9,12,9,40,50,-10,39
AaB,1096,6,6,14,10,34,42,-8,32
Sonderjyske,1096,7,8,6,10,28,29,-1,30
Randers FC,1096,8,5,7,12,24,40,-16,22
AGF Aarhus,1096,9,5,6,11,17,36,-19,21
Lyngby,1096,10,3,10,11,27,45,-18,19
Silkeborg IF,1096,11,5,3,14,25,45,-20,18
Brondby,1097,1,21,6,3,73,31,42,69
FC Midtjylla,1097,2,21,4,5,68,39,29,67
FC Nords,1097,3,15,6,9,78,53,25,51
Copenhagen,1097,4,14,5,11,56,42,14,47
AaB,1097,5,7,12,11,34,45,-11,33
Sonderjyske,1097,6,8,6,10,28,29,-1,30
AC Horsens,1097,7,5,13,12,33,58,-25,28
Lyngby,1097,8,4,9,11,27,44,-17,21
Randers FC,1097,9,5,6,13,23,40,-17,21
Silkeborg IF,1097,10,6,3,13,26,44,-18,21
AGF Aarhus,1097,11,4,6,12,16,37,-21,18
Brondby,1098,1,19,8,3,67,32,35,65
FC Midtjylla,1098,2,20,5,5,64,36,28,65
FC Nords,1098,3,16,6,8,77,53,24,54
Copenhagen,1098,4,13,6,11,59,46,13,45
AaB,1098,5,8,12,10,37,42,-5,36
Sonderjyske,1098,6,8,6,10,28,29,-1,30
AC Horsens,1098,7,5,13,12,35,56,-21,28
Lyngby,1098,8,4,9,11,29,45,-16,21
Randers FC,1098,9,5,6,13,24,42,-18,21
Silkeborg IF,1098,10,5,4,13,27,46,-19,19
AGF Aarhus,1098,11,4,7,11,18,38,-20,19
Brondby,1099,1,21,5,4,70,33,37,68
FC Midtjylla,1099,2,19,5,6,64,38,26,62
FC Nords,1099,3,16,6,8,72,50,22,54
Copenhagen,1099,4,14,5,11,58,43,15,47
AaB,1099,5,8,11,11,38,44,-6,35
Sonderjyske,1099,6,8,6,10,28,29,-1,30
AC Horsens,1099,7,6,12,12,34,54,-20,30
Randers FC,1099,8,5,7,12,24,40,-16,22
Lyngby,1099,9,3,10,11,27,45,-18,19
Silkeborg IF,1099,10,5,4,13,25,44,-19,19
AGF Aarhus,1099,11,4,7,11,16,36,-20,19
Brondby,1100,1,21,5,4,69,32,37,68
FC Midtjylla,1100,2,19,6,5,62,38,24,63
Copenhagen,1100,3,13,7,10,58,44,14,46
FC Nords,1100,4,12,8,10,68,51,17,44
AaB,1100,5,9,12,9,38,39,-1,39
AC Horsens,1100,6,6,14,10,33,50,-17,32
Sonderjyske,1100,7,8,6,10,28,29,-1,30
Lyngby,1100,8,4,9,11,29,46,-17,21
Randers FC,1100,9,5,6,13,25,42,-17,21
AGF Aarhus,1100,10,5,6,11,20,38,-18,21
Silkeborg IF,1100,11,5,3,14,27,48,-21,18
Brondby,1101,1,23,5,2,76,29,47,74
FC Midtjylla,1101,2,20,4,6,64,38,26,64
FC Nords,1101,3,15,6,9,76,52,24,51
Copenhagen,1101,4,12,4,14,55,52,3,40
AaB,1101,5,8,11,11,37,43,-6,35
AC Horsens,1101,6,7,12,11,35,55,-20,33
Sonderjyske,1101,7,8,6,10,28,29,-1,30
Randers FC,1101,8,5,7,12,24,40,-16,22
AGF Aarhus,1101,9,5,6,11,18,36,-18,21
Lyngby,1101,10,3,10,11,27,45,-18,19
Silkeborg IF,1101,11,5,3,14,25,46,-21,18
Brondby,1102,1,21,6,3,71,32,39,69
FC Midtjylla,1102,2,19,5,6,70,42,28,62
FC Nords,1102,3,14,7,9,72,50,22,49
Copenhagen,1102,4,14,6,10,58,44,14,48
AaB,1102,5,8,13,9,34,38,-4,37
Sonderjyske,1102,6,8,6,10,28,29,-1,30
AC Horsens,1102,7,5,13,12,31,56,-25,28
Silkeborg IF,1102,8,6,3,13,28,44,-16,21
Lyngby,1102,9,4,9,11,28,45,-17,21
Randers FC,1102,10,5,6,13,24,41,-17,21
AGF Aarhus,1102,11,4,6,12,16,39,-23,18
Brondby,1103,1,21,6,3,73,33,40,69
FC Midtjylla,1103,2,19,5,6,65,41,24,62
Copenhagen,1103,3,15,6,9,62,43,19,51
FC Nords,1103,4,14,6,10,77,59,18,48
AaB,1103,5,7,12,11,39,47,-8,33
AC Horsens,1103,6,6,13,11,37,56,-19,31
Sonderjyske,1103,7,8,6,10,28,29,-1,30
Randers FC,1103,8,6,6,12,26,41,-15,24
Silkeborg IF,1103,9,6,3,13,26,44,-18,21
Lyngby,1103,10,3,9,12,28,47,-19,18
AGF Aarhus,1103,11,4,6,12,16,37,-21,18
Brondby,1104,1,21,6,3,73,34,39,69
FC Midtjylla,1104,2,18,7,5,66,42,24,61
FC Nords,1104,3,13,9,8,73,50,23,48
Copenhagen,1104,4,13,6,11,59,49,10,45
AaB,1104,5,7,13,10,38,43,-5,34
AC Horsens,1104,6,6,15,9,34,51,-17,33
Sonderjyske,1104,7,8,6,10,28,29,-1,30
Randers FC,1104,8,5,7,12,25,41,-16,22
Silkeborg IF,1104,9,6,3,13,27,44,-17,21
Lyngby,1104,10,3,10,11,28,46,-18,19
AGF Aarhus,1104,11,4,6,12,16,38,-22,18
Brondby,1105,1,22,5,3,74,33,41,71
FC Midtjylla,1105,2,18,5,7,62,41,21,59
FC Nords,1105,3,14,8,8,77,52,25,50
Copenhagen,1105,4,14,6,10,61,45,16,48
AaB,1105,5,9,12,9,40,44,-4,39
Sonderjyske,1105,6,8,6,10,28,29,-1,30
AC Horsens,1105,7,5,12,13,30,55,-25,27
Lyngby,1105,8,4,9,11,29,44,-15,21
Silkeborg IF,1105,9,6,3,13,27,44,-17,21
Randers FC,1105,10,5,6,13,23,42,-19,21
AGF Aarhus,1105,11,4,6,12,16,38,-22,18
Brondby,1106,1,22,5,3,74,31,43,71
FC Midtjylla,1106,2,18,6,6,61,38,23,60
Copenhagen,1106,3,16,4,10,61,43,18,52
FC Nords,1106,4,13,7,10,71,53,18,46
AaB,1106,5,7,13,10,35,45,-10,34
AC Horsens,1106,6,6,13,11,34,52,-18,31
Sonderjyske,1106,7,8,6,10,28,29,-1,30
Randers FC,1106,8,6,6,12,25,39,-14,24
Silkeborg IF,1106,9,5,4,13,27,46,-19,19
AGF Aarhus,1106,10,4,7,11,18,38,-20,19
Lyngby,1106,11,3,9,12,26,46,-20,18
Brondby,1107,1,21,6,3,71,33,38,69
FC Midtjylla,1107,2,18,7,5,63,40,23,61
FC Nords,1107,3,16,6,8,78,51,27,54
Copenhagen,1107,4,12,5,13,57,50,7,41
AaB,1107,5,8,12,10,41,45,-4,36
AC Horsens,1107,6,6,14,10,34,51,-17,32
Sonderjyske,1107,7,8,6,10,28,29,-1,30
Randers FC,1107,8,6,6,12,25,40,-15,24
AGF Aarhus,1107,9,5,6,11,18,36,-18,21
Lyngby,1107,10,3,9,12,27,46,-19,18
Silkeborg IF,1107,11,5,3,14,25,46,-21,18
Brondby,1108,1,20,6,4,71,29,42,66
FC Midtjylla,1108,2,20,4,6,65,40,25,64
FC Nords,1108,3,15,6,9,75,53,22,51
Copenhagen,1108,4,12,5,13,55,52,3,41
AC Horsens,1108,5,9,12,9,38,48,-10,39
AaB,1108,6,8,11,11,37,45,-8,35
Sonderjyske,1108,7,8,6,10,28,29,-1,30
Randers FC,1108,8,6,6,12,25,39,-14,24
Silkeborg IF,1108,9,6,3,13,29,45,-16,21
Lyngby,1108,10,3,9,12,26,46,-20,18
AGF Aarhus,1108,11,4,6,12,17,40,-23,18
Brondby,1109,1,22,5,3,73,34,39,71
FC Midtjylla,1109,2,18,4,8,63,43,20,58
Copenhagen,1109,3,16,4,10,64,44,20,52
FC Nords,1109,4,14,6,10,70,55,15,48
AC Horsens,1109,5,7,13,10,38,54,-16,34
AaB,1109,6,7,12,11,35,39,-4,33
Sonderjyske,1109,7,8,6,10,28,29,-1,30
Randers FC,1109,8,5,7,12,24,40,-16,22
AGF Aarhus,1109,9,5,6,11,20,36,-16,21
Lyngby,1109,10,3,10,11,27,45,-18,19
Silkeborg IF,1109,11,5,3,14,25,48,-23,18
Brondby,1110,1,20,8,2,70,32,38,68
FC Midtjylla,1110,2,21,5,4,65,34,31,68
Copenhagen,1110,3,14,5,11,57,45,12,47
FC Nords,1110,4,13,7,10,71,52,19,46
AaB,1110,5,7,11,12,35,44,-9,32
AC Horsens,1110,6,6,14,10,34,51,-17,32
Sonderjyske,1110,7,8,6,10,28,29,-1,30
Lyngby,1110,8,4,9,11,29,44,-15,21
AGF Aarhus,1110,9,5,6,11,19,37,-18,21
Randers FC,1110,10,5,6,13,23,42,-19,21
Silkeborg IF,1110,11,5,3,14,26,47,-21,18
Brondby,1111,1,21,5,4,70,32,38,68
FC Midtjylla,1111,2,19,5,6,67,39,28,62
FC Nords,1111,3,16,6,8,73,48,25,54
Copenhagen,1111,4,15,5,10,58,44,14,50
AC Horsens,1111,5,7,12,11,37,54,-17,33
Sonderjyske,1111,6,8,6,10,28,29,-1,30
AaB,1111,7,6,11,13,34,48,-14,29
Randers FC,1111,8,5,7,12,25,41,-16,22
Silkeborg IF,1111,9,6,3,13,27,45,-18,21
Lyngby,1111,10,3,10,11,28,46,-18,19
AGF Aarhus,1111,11,4,6,12,17,38,-21,18
FC Midtjylla,1112,1,20,5,5,66,39,27,65
Brondby,1112,2,19,6,5,70,36,34,63
FC Nords,1112,3,15,6,9,74,49,25,51
Copenhagen,1112,4,15,4,11,58,49,9,49
AaB,1112,5,7,13,10,38,43,-5,34
AC Horsens,1112,6,6,14,10,40,56,-16,32
Sonderjyske,1112,7,8,6,10,28,29,-1,30
Lyngby,1112,8,4,9,11,29,46,-17,21
Randers FC,1112,9,5,6,13,25,42,-17,21
Silkeborg IF,1112,10,5,4,13,25,44,-19,19
AGF Aarhus,1112,11,4,7,11,16,36,-20,19
Brondby,1113,1,22,5,3,74,34,40,71
FC Midtjylla,1113,2,21,4,5,72,40,32,67
FC Nords,1113,3,14,6,10,71,57,14,48
Copenhagen,1113,4,12,5,13,57,50,7,41
AaB,1113,5,8,13,9,41,41,0,37
AC Horsens,1113,6,6,13,11,34,53,-19,31
Sonderjyske,1113,7,8,6,10,28,29,-1,30
Randers FC,1113,8,6,6,12,24,39,-15,24
AGF Aarhus,1113,9,5,6,11,18,37,-19,21
Lyngby,1113,10,3,9,12,26,45,-19,18
Silkeborg IF,1113,11,5,3,14,26,46,-20,18
Brondby,1114,1,21,6,3,72,31,41,69
FC Midtjylla,1114,2,20,4,6,66,43,23,64
Copenhagen,1114,3,14,4,12,58,44,14,46
FC Nords,1114,4,13,6,11,70,58,12,45
AaB,1114,5,8,13,9,37,39,-2,37
AC Horsens,1114,6,7,13,10,35,49,-14,34
Sonderjyske,1114,7,8,6,10,28,29,-1,30
Randers FC,1114,8,6,6,12,27,42,-15,24
Silkeborg IF,1114,9,5,4,13,26,45,-19,19
AGF Aarhus,1114,10,4,7,11,17,37,-20,19
Lyngby,1114,11,3,9,12,29,48,-19,18
Brondby,1115,1,21,5,4,70,35,35,68
FC Midtjylla,1115,2,18,6,6,63,41,22,60
Copenhagen,1115,3,16,5,9,65,40,25,53
FC Nords,1115,4,13,8,9,70,51,19,47
AaB,1115,5,8,12,10,39,43,-4,36
Sonderjyske,1115,6,8,6,10,28,29,-1,30
AC Horsens,1115,7,5,14,11,32,55,-23,29
Randers FC,1115,8,5,7,12,23,39,-16,22
Lyngby,1115,9,3,10,11,26,44,-18,19
Silkeborg IF,1115,10,5,4,13,27,46,-19,19
AGF Aarhus,1115,11,4,7,11,18,38,-20,19
Brondby,1116,1,22,5,3,72,33,39,71
FC Midtjylla,1116,2,21,5,4,68,36,32,68
FC Nords,1116,3,13,7,10,70,53,17,46
Copenhagen,1116,4,12,7,11,52,44,8,43
AaB,1116,5,8,11,11,40,44,-4,35
AC Horsens,1116,6,6,13,11,33,51,-18,31
Sonderjyske,1116,7,8,6,10,28,29,-1,30
Lyngby,1116,8,4,9,11,28,45,-17,21
Silkeborg IF,1116,9,6,3,13,27,44,-17,21
Randers FC,1116,10,5,6,13,24,41,-17,21
AGF Aarhus,1116,11,4,6,12,16,38,-22,18
Brondby,1117,1,23,5,2,76,31,45,74
FC Midtjylla,1117,2,20,5,5,68,41,27,65
FC Nords,1117,3,13,6,11,77,62,15,45
Copenhagen,1117,4,13,6,11,63,51,12,45
AaB,1117,5,7,12,11,40,44,-4,33
AC Horsens,1117,6,7,12,11,35,56,-21,33
Sonderjyske,1117,7,8,6,10,28,29,-1,30
Lyngby,1117,8,4,9,11,27,44,-17,21
Silkeborg IF,1117,8,6,3,13,27,44,-17,21
Randers FC,1117,10,5,6,13,23,40,-17,21
AGF Aarhus,1117,11,4,6,12,16,38,-22,18
FC Midtjylla,1118,1,21,4,5,69,38,31,67
Brondby,1118,2,19,7,4,66,37,29,64
FC Nords,1118,3,14,6,10,76,53,23,48
Copenhagen,1118,4,14,6,10,59,43,16,48
AaB,1118,5,7,13,10,38,44,-6,34
AC Horsens,1118,6,6,14,10,34,53,-19,32
Sonderjyske,1118,7,8,6,10,28,29,-1,30
Randers FC,1118,8,5,7,12,23,39,-16,22
AGF Aarhus,1118,9,5,6,11,17,36,-19,21
Lyngby,1118,10,3,10,11,26,44,-18,19
Silkeborg IF,1118,11,5,3,14,25,45,-20,18
Brondby,1119,1,20,6,4,71,34,37,66
FC Midtjylla,1119,2,19,5,6,65,37,28,62
FC Nords,1119,3,16,6,8,77,51,26,54
Copenhagen,1119,4,14,5,11,59,50,9,47
AaB,1119,5,7,12,11,34,44,-10,33
AC Horsens,1119,6,7,12,11,32,48,-16,33
Sonderjyske,1119,7,8,6,10,28,29,-1,30
Randers FC,1119,8,6,6,12,24,39,-15,24
AGF Aarhus,1119,9,5,6,11,21,39,-18,21
Lyngby,1119,10,3,9,12,26,45,-19,18
Silkeborg IF,1119,11,5,3,14,28,49,-21,18
FC Midtjylla,1120,1,21,5,4,65,35,30,68
Brondby,1120,2,18,6,6,64,35,29,60
FC Nords,1120,3,15,8,7,77,49,28,53
Copenhagen,1120,4,13,4,13,56,48,8,43
AaB,1120,5,8,13,9,38,40,-2,37
AC Horsens,1120,6,7,12,11,34,53,-19,33
Sonderjyske,1120,7,8,6,10,28,29,-1,30
Lyngby,1120,8,4,9,11,28,45,-17,21
Randers FC,1120,9,5,6,13,24,41,-17,21
AGF Aarhus,1120,10,5,6,11,17,36,-19,21
Silkeborg IF,1120,11,5,3,14,25,45,-20,18
Brondby,1121,1,20,6,4,72,33,39,66
FC Midtjylla,1121,2,19,4,7,65,45,20,61
FC Nords,1121,3,17,6,7,77,47,30,57
Copenhagen,1121,4,16,4,10,61,41,20,52
Sonderjyske,1121,5,8,6,10,28,29,-1,30
AaB,1121,6,6,12,12,37,47,-10,30
AC Horsens,1121,7,6,12,12,34,59,-25,30
Randers FC,1121,8,6,6,12,26,40,-14,24
AGF Aarhus,1121,9,5,6,11,18,37,-19,21
Lyngby,1121,10,3,9,12,27,47,-20,18
Silkeborg IF,1121,11,5,3,14,26,46,-20,18
Brondby,1122,1,22,6,2,76,30,46,72
FC Midtjylla,1122,2,19,5,6,65,44,21,62
FC Nords,1122,3,14,7,9,71,51,20,49
Copenhagen,1122,4,14,5,11,63,45,18,47
AC Horsens,1122,5,7,12,11,34,54,-20,33
AaB,1122,6,7,11,12,34,45,-11,32
Sonderjyske,1122,7,8,6,10,28,29,-1,30
Randers FC,1122,8,6,6,12,27,39,-12,24
Silkeborg IF,1122,9,6,3,13,28,46,-18,21
AGF Aarhus,1122,10,4,6,12,18,39,-21,18
Lyngby,1122,11,3,9,12,26,48,-22,18
Brondby,1123,1,21,5,4,70,34,36,68
FC Midtjylla,1123,2,19,4,7,67,41,26,61
FC Nords,1123,3,15,7,8,80,51,29,52
Copenhagen,1123,4,14,4,12,56,48,8,46
AaB,1123,5,7,13,10,36,42,-6,34
AC Horsens,1123,6,7,13,10,34,53,-19,34
Sonderjyske,1123,7,8,6,10,28,29,-1,30
Randers FC,1123,8,5,7,12,23,39,-16,22
Lyngby,1123,9,3,10,11,26,44,-18,19
Silkeborg IF,1123,10,5,4,13,26,45,-19,19
AGF Aarhus,1123,11,4,7,11,17,37,-20,19
Brondby,1124,1,21,6,3,70,30,40,69
FC Midtjylla,1124,2,19,5,6,65,41,24,62
FC Nords,1124,3,14,8,8,79,54,25,50
Copenhagen,1124,4,14,5,11,58,47,11,47
AaB,1124,5,6,14,10,37,44,-7,32
AC Horsens,1124,6,6,14,10,36,55,-19,32
Sonderjyske,1124,7,8,6,10,28,29,-1,30
Lyngby,1124,8,4,9,11,29,44,-15,21
Silkeborg IF,1124,9,6,3,13,28,45,-17,21
Randers FC,1124,10,5,6,13,23,42,-19,21
AGF Aarhus,1124,11,4,6,12,17,39,-22,18
Brondby,1125,1,18,6,6,66,38,28,60
FC Midtjylla,1125,2,17,6,7,63,43,20,57
FC Nords,1125,3,15,7,8,74,49,25,52
Copenhagen,1125,4,14,4,12,59,46,13,46
AC Horsens,1125,5,9,13,8,39,50,-11,40
AaB,1125,6,8,14,8,37,38,-1,38
Sonderjyske,1125,7,8,6,10,28,29,-1,30
Randers FC,1125,8,6,6,12,26,41,-15,24
Silkeborg IF,1125,9,5,4,13,26,45,-19,19
AGF Aarhus,1125,10,4,7,11,17,37,-20,19
Lyngby,1125,11,3,9,12,28,47,-19,18
Brondby,1126,1,21,6,3,70,33,37,69
FC Midtjylla,1126,2,20,4,6,62,35,27,64
FC Nords,1126,3,16,6,8,76,47,29,54
Copenhagen,1126,4,13,5,12,58,50,8,44
AaB,1126,5,8,12,10,42,42,0,36
Sonderjyske,1126,6,8,6,10,28,29,-1,30
AC Horsens,1126,7,5,13,12,32,59,-27,28
Lyngby,1126,8,4,9,11,30,46,-16,21
Randers FC,1126,9,5,6,13,25,43,-18,21
Silkeborg IF,1126,10,5,4,13,26,45,-19,19
AGF Aarhus,1126,11,4,7,11,17,37,-20,19
Brondby,1127,1,22,5,3,78,32,46,71
FC Midtjylla,1127,2,18,4,8,62,44,18,58
Copenhagen,1127,3,17,4,9,61,40,21,55
FC Nords,1127,4,13,6,11,68,56,12,45
AaB,1127,5,9,11,10,36,39,-3,38
Sonderjyske,1127,6,8,6,10,28,29,-1,30
AC Horsens,1127,7,6,12,12,32,52,-20,30
Lyngby,1127,8,4,9,11,29,46,-17,21
Randers FC,1127,9,5,6,13,25,42,-17,21
Silkeborg IF,1127,10,5,4,13,26,45,-19,19
AGF Aarhus,1127,11,4,7,11,17,37,-20,19
Brondby,1128,1,21,5,4,68,31,37,68
FC Midtjylla,1128,2,20,6,4,66,36,30,66
Copenhagen,1128,3,13,5,12,56,45,11,44
FC Nords,1128,4,12,7,11,70,56,14,43
AC Horsens,1128,5,8,13,9,36,50,-14,37
AaB,1128,6,7,14,9,38,42,-4,35
Sonderjyske,1128,7,8,6,10,28,29,-1,30
Lyngby,1128,8,4,9,11,28,45,-17,21
Randers FC,1128,9,5,6,13,24,41,-17,21
AGF Aarhus,1128,10,5,6,11,19,38,-19,21
Silkeborg IF,1128,11,5,3,14,27,47,-20,18
Brondby,1129,1,21,6,3,73,32,41,69
FC Midtjylla,1129,2,20,5,5,65,39,26,65
FC Nords,1129,3,14,9,7,71,48,23,51
Copenhagen,1129,4,14,4,12,56,44,12,46
AaB,1129,5,7,11,12,37,46,-9,32
AC Horsens,1129,6,6,13,11,30,49,-19,31
Sonderjyske,1129,7,8,6,10,28,29,-1,30
Lyngby,1129,8,4,9,11,28,45,-17,21
Silkeborg IF,1129,9,6,3,13,27,44,-17,21
Randers FC,1129,10,5,6,13,24,41,-17,21
AGF Aarhus,1129,11,4,6,12,16,38,-22,18
Brondby,1130,1,21,6,3,73,30,43,69
FC Midtjylla,1130,2,20,4,6,68,40,28,64
FC Nords,1130,3,16,6,8,75,48,27,54
Copenhagen,1130,4,13,4,13,53,52,1,43
AaB,1130,5,7,12,11,35,40,-5,33
AC Horsens,1130,6,7,12,11,36,56,-20,33
Sonderjyske,1130,7,8,6,10,28,29,-1,30
Lyngby,1130,8,4,9,11,30,44,-14,21
Silkeborg IF,1130,9,6,3,13,28,44,-16,21
Randers FC,1130,10,5,6,13,23,43,-20,21
AGF Aarhus,1130,11,4,6,12,16,39,-23,18
Brondby,1131,1,20,7,3,69,34,35,67
FC Midtjylla,1131,2,19,7,4,63,36,27,64
Copenhagen,1131,3,14,6,10,58,41,17,48
FC Nords,1131,4,13,6,11,68,55,13,45
AC Horsens,1131,5,7,14,9,35,48,-13,35
AaB,1131,6,7,12,11,35,40,-5,33
Sonderjyske,1131,7,8,6,10,28,29,-1,30
Lyngby,1131,8,4,9,11,27,44,-17,21
Silkeborg IF,1131,8,6,3,13,27,44,-17,21
Randers FC,1131,10,5,6,13,23,40,-17,21
AGF Aarhus,1131,11,4,6,12,16,38,-22,18
Brondby,1132,1,22,5,3,70,31,39,71
FC Midtjylla,1132,2,20,5,5,64,38,26,65
FC Nords,1132,3,15,7,8,79,49,30,52
Copenhagen,1132,4,13,4,13,55,54,1,43
AaB,1132,5,8,11,11,40,44,-4,35
Sonderjyske,1132,6,8,6,10,28,29,-1,30
AC Horsens,1132,7,5,14,11,36,54,-18,29
Silkeborg IF,1132,8,6,3,13,29,45,-16,21
Lyngby,1132,9,4,9,11,28,45,-17,21
Randers FC,1132,10,5,6,13,24,41,-17,21
AGF Aarhus,1132,11,4,6,12,17,40,-23,18
Brondby,1133,1,21,6,3,69,29,40,69
FC Midtjylla,1133,2,20,5,5,65,35,30,65
FC Nords,1133,3,15,6,9,77,49,28,51
Copenhagen,1133,4,15,4,11,61,46,15,49
AC Horsens,1133,5,7,12,11,33,53,-20,33
Sonderjyske,1133,6,8,6,10,28,29,-1,30
AaB,1133,7,6,11,13,32,51,-19,29
Randers FC,1133,8,5,7,12,24,40,-16,22
Lyngby,1133,9,3,10,11,27,45,-18,19
Silkeborg IF,1133,10,5,4,13,27,46,-19,19
AGF Aarhus,1133,11,4,7,11,18,38,-20,19
Brondby,1134,1,20,7,3,74,38,36,67
FC Midtjylla,1134,2,18,6,6,65,43,22,60
FC Nords,1134,3,14,9,7,79,54,25,51
Copenhagen,1134,4,13,5,12,55,45,10,44
AC Horsens,1134,5,8,12,10,39,52,-13,36
AaB,1134,6,7,13,10,41,47,-6,34
Sonderjyske,1134,7,8,6,10,28,29,-1,30
Randers FC,1134,8,6,6,12,25,40,-15,24
AGF Aarhus,1134,9,5,6,11,17,36,-19,21
Lyngby,1134,10,3,9,12,27,46,-19,18
Silkeborg IF,1134,11,5,3,14,25,45,-20,18
Brondby,1135,1,22,6,2,76,31,45,72
FC Midtjylla,1135,2,20,5,5,67,39,28,65
FC Nords,1135,3,15,6,9,76,54,22,51
Copenhagen,1135,4,13,4,13,57,50,7,43
AaB,1135,5,7,14,9,37,39,-2,35
Sonderjyske,1135,6,8,6,10,28,29,-1,30
AC Horsens,1135,7,5,13,12,32,58,-26,28
Silkeborg IF,1135,8,6,3,13,28,45,-17,21
Lyngby,1135,9,4,9,11,27,44,-17,21
Randers FC,1135,10,5,6,13,23,40,-17,21
AGF Aarhus,1135,11,4,6,12,17,39,-22,18
Brondby,1136,1,20,6,4,68,33,35,66
FC Midtjylla,1136,2,19,5,6,61,38,23,62
FC Nords,1136,3,16,6,8,77,47,30,54
Copenhagen,1136,4,12,8,10,58,49,9,44
AC Horsens,1136,5,7,13,10,38,53,-15,34
AaB,1136,6,7,12,11,35,43,-8,33
Sonderjyske,1136,7,8,6,10,28,29,-1,30
Randers FC,1136,8,6,6,12,24,39,-15,24
Silkeborg IF,1136,9,6,3,13,33,44,-11,21
Lyngby,1136,10,3,9,12,26,45,-19,18
AGF Aarhus,1136,11,4,6,12,16,44,-28,18
Brondby,1137,1,20,7,3,67,29,38,67
FC Midtjylla,1137,2,20,5,5,61,35,26,65
Copenhagen,1137,3,16,5,9,61,40,21,53
FC Nords,1137,4,12,8,10,69,52,17,44
AaB,1137,5,8,11,11,34,43,-9,35
Sonderjyske,1137,6,8,6,10,28,29,-1,30
AC Horsens,1137,7,5,14,11,32,51,-19,29
Lyngby,1137,8,4,9,11,28,45,-17,21
Randers FC,1137,9,5,6,13,24,41,-17,21
AGF Aarhus,1137,10,5,6,11,19,36,-17,21
Silkeborg IF,1137,11,5,3,14,25,47,-22,18
Brondby,1138,1,20,7,3,67,31,36,67
FC Midtjylla,1138,2,18,6,6,62,39,23,60
FC Nords,1138,3,15,6,9,77,52,25,51
Copenhagen,1138,4,14,4,12,56,44,12,46
AaB,1138,5,8,13,9,38,41,-3,37
AC Horsens,1138,6,6,14,10,38,57,-19,32
Sonderjyske,1138,7,8,6,10,28,29,-1,30
Lyngby,1138,8,4,9,11,28,45,-17,21
Randers FC,1138,9,5,6,13,24,41,-17,21
AGF Aarhus,1138,10,5,6,11,19,36,-17,21
Silkeborg IF,1138,11,5,3,14,25,47,-22,18
Brondby,1139,1,21,6,3,73,33,40,69
FC Midtjylla,1139,2,20,5,5,71,39,32,65
FC Nords,1139,3,15,6,9,77,55,22,51
Copenhagen,1139,4,14,6,10,59,45,14,48
AaB,1139,5,7,11,12,38,50,-12,32
Sonderjyske,1139,6,8,6,10,28,29,-1,30
AC Horsens,1139,7,5,14,11,33,55,-22,29
Randers FC,1139,8,5,7,12,23,39,-16,22
AGF Aarhus,1139,9,5,6,11,18,36,-18,21
Lyngby,1139,10,3,10,11,26,44,-18,19
Silkeborg IF,1139,11,5,3,14,25,46,-21,18
FC Midtjylla,1140,1,19,5,6,63,38,25,62
Brondby,1140,2,18,6,6,65,35,30,60
FC Nords,1140,3,15,7,8,76,53,23,52
Copenhagen,1140,4,15,5,10,57,41,16,50
AaB,1140,5,7,14,9,38,44,-6,35
AC Horsens,1140,6,7,13,10,36,50,-14,34
Sonderjyske,1140,7,8,6,10,28,29,-1,30
Randers FC,1140,8,5,7,12,25,41,-16,22
Lyngby,1140,9,3,10,11,28,46,-18,19
Silkeborg IF,1140,10,5,4,13,26,45,-19,19
AGF Aarhus,1140,11,4,7,11,17,37,-20,19
FC Midtjylla,1141,1,20,5,5,66,39,27,65
Brondby,1141,2,19,7,4,68,34,34,64
FC Nords,1141,3,15,7,8,85,51,34,52
Copenhagen,1141,4,13,7,10,56,50,6,46
AaB,1141,5,8,12,10,37,41,-4,36
Sonderjyske,1141,6,8,6,10,28,29,-1,30
AC Horsens,1141,7,5,14,11,35,58,-23,29
Randers FC,1141,8,5,7,12,26,42,-16,22
AGF Aarhus,1141,9,5,6,11,18,36,-18,21
Lyngby,1141,10,3,10,11,29,47,-18,19
Silkeborg IF,1141,11,5,3,14,25,46,-21,18
Brondby,1142,1,20,7,3,72,35,37,67
FC Midtjylla,1142,2,19,7,4,68,41,27,64
FC Nords,1142,3,14,7,9,71,50,21,49
Copenhagen,1142,4,14,5,11,59,47,12,47
AaB,1142,5,8,11,11,38,45,-7,35
AC Horsens,1142,6,6,13,11,38,54,-16,31
Sonderjyske,1142,7,8,6,10,28,29,-1,30
Silkeborg IF,1142,8,6,3,13,28,44,-16,21
Lyngby,1142,9,4,9,11,27,44,-17,21
Randers FC,1142,10,5,6,13,23,40,-17,21
AGF Aarhus,1142,11,4,6,12,16,39,-23,18
Brondby,1143,1,19,7,4,68,33,35,64
FC Midtjylla,1143,2,18,8,4,65,39,26,62
FC Nords,1143,3,14,7,9,75,51,24,49
Copenhagen,1143,4,14,6,10,56,44,12,48
AaB,1143,5,7,13,10,35,40,-5,34
AC Horsens,1143,6,7,13,10,35,53,-18,34
Sonderjyske,1143,7,8,6,10,28,29,-1,30
Silkeborg IF,1143,8,6,3,13,29,44,-15,21
Lyngby,1143,9,4,9,11,27,44,-17,21
Randers FC,1143,10,5,6,13,23,40,-17,21
AGF Aarhus,1143,11,4,6,12,16,40,-24,18
Brondby,1144,1,21,5,4,68,35,33,68
FC Midtjylla,1144,2,21,4,5,69,40,29,67
FC Nords,1144,3,15,6,9,70,49,21,51
Copenhagen,1144,4,14,4,12,60,42,18,46
AaB,1144,5,7,12,11,35,43,-8,33
AC Horsens,1144,6,6,13,11,34,53,-19,31
Sonderjyske,1144,7,8,6,10,28,29,-1,30
Randers FC,1144,8,5,7,12,23,39,-16,22
Silkeborg IF,1144,9,6,3,13,27,44,-17,21
Lyngby,1144,10,3,10,11,26,44,-18,19
AGF Aarhus,1144,11,4,6,12,16,38,-22,18
Brondby,1145,1,19,7,4,68,32,36,64
FC Midtjylla,1145,2,18,5,7,59,39,20,59
FC Nords,1145,3,16,6,8,73,47,26,54
Copenhagen,1145,4,13,5,12,55,44,11,44
AaB,1145,5,9,11,10,37,42,-5,38
AC Horsens,1145,6,8,12,10,36,50,-14,36
Sonderjyske,1145,7,8,6,10,28,29,-1,30
Lyngby,1145,8,4,9,11,29,46,-17,21
Randers FC,1145,9,5,6,13,25,42,-17,21
Silkeborg IF,1145,10,6,3,13,26,44,-18,21
AGF Aarhus,1145,11,4,6,12,16,37,-21,18
Brondby,1146,1,21,7,2,78,33,45,70
FC Midtjylla,1146,2,20,5,5,70,40,30,65
FC Nords,1146,3,14,6,10,75,63,12,48
Copenhagen,1146,4,12,6,12,56,50,6,42
AC Horsens,1146,5,7,14,9,39,50,-11,35
AaB,1146,6,6,14,10,37,45,-8,32
Sonderjyske,1146,7,8,6,10,28,29,-1,30
Lyngby,1146,8,4,9,11,28,45,-17,21
Silkeborg IF,1146,8,6,3,13,28,45,-17,21
Randers FC,1146,10,5,6,13,24,41,-17,21
AGF Aarhus,1146,11,4,6,12,17,39,-22,18
Brondby,1147,1,21,6,3,74,32,42,69
FC Midtjylla,1147,2,19,5,6,63,44,19,62
Copenhagen,1147,3,16,5,9,62,41,21,53
FC Nords,1147,4,14,6,10,68,47,21,48
AaB,1147,5,6,13,11,37,48,-11,31
Sonderjyske,1147,6,8,6,10,28,29,-1,30
AC Horsens,1147,7,5,15,10,36,54,-18,30
Randers FC,1147,8,6,6,12,25,39,-14,24
Silkeborg IF,1147,9,6,3,13,28,44,-16,21
Lyngby,1147,10,3,9,12,26,46,-20,18
AGF Aarhus,1147,11,4,6,12,16,39,-23,18
Brondby,1148,1,22,5,3,76,30,46,71
FC Midtjylla,1148,2,20,4,6,64,40,24,64
Copenhagen,1148,3,16,4,10,61,43,18,52
FC Nords,1148,4,13,6,11,70,60,10,45
AaB,1148,5,8,12,10,36,40,-4,36
Sonderjyske,1148,6,8,6,10,28,29,-1,30
AC Horsens,1148,7,5,13,12,37,57,-20,28
Randers FC,1148,8,6,6,12,24,39,-15,24
Silkeborg IF,1148,9,5,4,13,27,46,-19,19
AGF Aarhus,1148,10,4,7,11,18,38,-20,19
Lyngby,1148,11,3,9,12,26,45,-19,18
Brondby,1149,1,19,8,3,68,35,33,65
FC Midtjylla,1149,2,19,5,6,65,41,24,62
Copenhagen,1149,3,15,6,9,62,43,19,51
FC Nords,1149,4,14,8,8,76,49,27,50
AC Horsens,1149,5,7,12,11,36,57,-21,33
AaB,1149,6,6,13,11,35,43,-8,31
Sonderjyske,1149,7,8,6,10,28,29,-1,30
Lyngby,1149,8,4,9,11,30,44,-14,21
AGF Aarhus,1149,9,5,6,11,17,36,-19,21
Randers FC,1149,10,5,6,13,23,43,-20,21
Silkeborg IF,1149,11,5,3,14,25,45,-20,18
Brondby,1150,1,21,6,3,68,32,36,69
FC Midtjylla,1150,2,20,4,6,69,39,30,64
FC Nords,1150,3,15,8,7,79,50,29,53
Copenhagen,1150,4,13,4,13,56,52,4,43
AaB,1150,5,8,12,10,37,41,-4,36
Sonderjyske,1150,6,8,6,10,28,29,-1,30
AC Horsens,1150,7,5,14,11,34,55,-21,29
Lyngby,1150,8,4,9,11,27,44,-17,21
Randers FC,1150,9,5,6,13,23,40,-17,21
Silkeborg IF,1150,10,5,4,13,26,45,-19,19
AGF Aarhus,1150,11,4,7,11,17,37,-20,19
Brondby,1151,1,19,7,4,67,32,35,64
FC Midtjylla,1151,2,19,6,5,68,40,28,63
FC Nords,1151,3,15,8,7,76,47,29,53
Copenhagen,1151,4,12,7,11,54,46,8,43
AC Horsens,1151,5,7,14,9,36,50,-14,35
AaB,1151,6,7,12,11,35,47,-12,33
Sonderjyske,1151,7,8,6,10,28,29,-1,30
Lyngby,1151,8,4,9,11,29,45,-16,21
Randers FC,1151,9,5,6,13,24,42,-18,21
Silkeborg IF,1151,10,5,4,13,26,45,-19,19
AGF Aarhus,1151,11,4,7,11,17,37,-20,19
Brondby,1152,1,21,6,3,72,31,41,69
FC Midtjylla,1152,2,19,5,6,65,42,23,62
FC Nords,1152,3,13,6,11,70,53,17,45
Copenhagen,1152,4,13,5,12,57,48,9,44
AaB,1152,5,10,12,8,40,40,0,42
AC Horsens,1152,6,7,12,11,39,55,-16,33
Sonderjyske,1152,7,8,6,10,28,29,-1,30
Lyngby,1152,8,4,9,11,28,45,-17,21
Randers FC,1152,9,5,6,13,24,41,-17,21
Silkeborg IF,1152,10,5,4,13,26,45,-19,19
AGF Aarhus,1152,11,4,7,11,17,37,-20,19
Brondby,1153,1,21,5,4,76,38,38,68
FC Midtjylla,1153,2,21,4,5,73,38,35,67
Copenhagen,1153,3,16,5,9,65,42,23,53
FC Nords,1153,4,13,6,11,73,60,13,45
AaB,1153,5,8,11,11,37,45,-8,35
Sonderjyske,1153,6,8,6,10,28,29,-1,30
AC Horsens,1153,7,5,13,12,32,59,-27,28
Lyngby,1153,8,4,9,11,30,45,-15,21
AGF Aarhus,1153,9,5,6,11,19,36,-17,21
Randers FC,1153,10,5,6,13,24,43,-19,21
Silkeborg IF,1153,11,5,3,14,25,47,-22,18
Brondby,1154,1,21,5,4,68,29,39,68
FC Midtjylla,1154,2,20,6,4,68,40,28,66
FC Nords,1154,3,14,7,9,73,51,22,49
Copenhagen,1154,4,13,6,11,53,42,11,45
AaB,1154,5,7,12,11,35,42,-7,33
AC Horsens,1154,6,7,12,11,37,56,-19,33
Sonderjyske,1154,7,8,6,10,28,29,-1,30
Randers FC,1154,8,5,7,12,24,40,-16,22
Silkeborg IF,1154,9,6,3,13,27,44,-17,21
Lyngby,1154,10,3,10,11,27,45,-18,19
AGF Aarhus,1154,11,4,6,12,16,38,-22,18
FC Midtjylla,1155,1,20,5,5,67,40,27,65
Brondby,1155,2,19,5,6,69,41,28,62
FC Nords,1155,3,14,7,9,74,55,19,49
Copenhagen,1155,4,15,4,11,61,42,19,49
AaB,1155,5,9,11,10,40,43,-3,38
AC Horsens,1155,6,6,14,10,39,55,-16,32
Sonderjyske,1155,7,8,6,10,28,29,-1,30
Randers FC,1155,8,6,6,12,26,39,-13,24
Silkeborg IF,1155,9,5,4,13,26,45,-19,19
AGF Aarhus,1155,10,4,7,11,17,37,-20,19
Lyngby,1155,11,3,9,12,26,47,-21,18
Brondby,1156,1,21,5,4,71,32,39,68
FC Midtjylla,1156,2,21,4,5,64,36,28,67
FC Nords,1156,3,14,6,10,75,54,21,48
Copenhagen,1156,4,14,4,12,54,42,12,46
AaB,1156,5,9,11,10,39,43,-4,38
Sonderjyske,1156,6,8,6,10,28,29,-1,30
AC Horsens,1156,7,6,12,12,37,59,-22,30
Randers FC,1156,8,6,6,12,25,39,-14,24
AGF Aarhus,1156,9,5,6,11,18,36,-18,21
Lyngby,1156,10,3,9,12,26,46,-20,18
Silkeborg IF,1156,11,5,3,14,25,46,-21,18
Brondby,1157,1,20,5,5,72,39,33,65
FC Midtjylla,1157,2,20,4,6,65,41,24,64
FC Nords,1157,3,14,8,8,79,51,28,50
Copenhagen,1157,4,15,5,10,59,42,17,50
AC Horsens,1157,5,8,12,10,38,56,-18,36
Sonderjyske,1157,6,8,6,10,28,29,-1,30
AaB,1157,7,6,12,12,38,48,-10,30
Lyngby,1157,8,4,9,11,27,44,-17,21
Randers FC,1157,9,5,6,13,23,40,-17,21
Silkeborg IF,1157,10,5,4,13,26,45,-19,19
AGF Aarhus,1157,11,4,7,11,17,37,-20,19
Brondby,1158,1,19,8,3,68,34,34,65
FC Midtjylla,1158,2,19,7,4,62,34,28,64
FC Nords,1158,3,14,7,9,69,50,19,49
Copenhagen,1158,4,12,5,13,53,46,7,41
AaB,1158,5,9,12,9,37,38,-1,39
AC Horsens,1158,6,7,13,10,35,48,-13,34
Sonderjyske,1158,7,8,6,10,28,29,-1,30
Lyngby,1158,8,4,9,11,27,44,-17,21
Randers FC,1158,9,5,6,13,23,40,-17,21
AGF Aarhus,1158,10,5,6,11,17,36,-19,21
Silkeborg IF,1158,11,5,3,14,25,45,-20,18
Brondby,1159,1,21,5,4,73,35,38,68
FC Midtjylla,1159,2,20,6,4,66,38,28,66
FC Nords,1159,3,15,6,9,78,55,23,51
Copenhagen,1159,4,13,5,12,54,45,9,44
AaB,1159,5,7,13,10,37,42,-5,34
Sonderjyske,1159,6,8,6,10,28,29,-1,30
AC Horsens,1159,7,5,15,10,34,53,-19,30
Lyngby,1159,8,4,9,11,30,45,-15,21
Randers FC,1159,9,5,6,13,24,43,-19,21
Silkeborg IF,1159,10,5,4,13,26,45,-19,19
AGF Aarhus,1159,11,4,7,11,17,37,-20,19
Brondby,1160,1,20,7,3,70,31,39,67
FC Midtjylla,1160,2,19,5,6,70,44,26,62
Copenhagen,1160,3,15,6,9,60,41,19,51
FC Nords,1160,4,14,8,8,71,50,21,50
AaB,1160,5,7,12,11,33,39,-6,33
Sonderjyske,1160,6,8,6,10,28,29,-1,30
AC Horsens,1160,7,6,12,12,34,59,-25,30
Lyngby,1160,8,4,9,11,29,45,-16,21
Randers FC,1160,9,5,6,13,24,42,-18,21
AGF Aarhus,1160,10,5,6,11,18,37,-19,21
Silkeborg IF,1160,11,5,3,14,26,46,-20,18
Brondby,1161,1,21,5,4,68,36,32,68
FC Midtjylla,1161,2,20,5,5,63,35,28,65
FC Nords,1161,3,15,8,7,76,47,29,53
Copenhagen,1161,4,12,5,13,54,48,6,41
AC Horsens,1161,5,7,14,9,36,47,-11,35
AaB,1161,6,6,13,11,37,47,-10,31
Sonderjyske,1161,7,8,6,10,28,29,-1,30
Randers FC,1161,8,6,6,12,25,39,-14,24
AGF Aarhus,1161,9,5,6,11,18,37,-19,21
Lyngby,1161,10,3,9,12,26,46,-20,18
Silkeborg IF,1161,10,5,3,14,26,46,-20,18
Brondby,1162,1,19,8,3,69,34,35,65
FC Midtjylla,1162,2,19,5,6,66,39,27,62
Copenhagen,1162,3,13,7,10,57,46,11,46
FC Nords,1162,4,12,9,9,72,53,19,45
AC Horsens,1162,5,8,13,9,35,51,-16,37
AaB,1162,6,8,12,10,36,38,-2,36
Sonderjyske,1162,7,8,6,10,28,29,-1,30
Lyngby,1162,8,4,9,11,28,45,-17,21
Randers FC,1162,9,5,6,13,24,41,-17,21
Silkeborg IF,1162,10,5,4,13,27,46,-19,19
AGF Aarhus,1162,11,4,7,11,18,38,-20,19
Brondby,1163,1,21,5,4,72,32,40,68
FC Midtjylla,1163,2,20,5,5,67,38,29,65
Copenhagen,1163,3,16,4,10,56,42,14,52
FC Nords,1163,4,15,6,9,69,49,20,51
Sonderjyske,1163,5,8,6,10,28,29,-1,30
AaB,1163,6,6,12,12,37,45,-8,30
AC Horsens,1163,7,6,12,12,33,54,-21,30
Lyngby,1163,8,4,9,11,28,45,-17,21
Silkeborg IF,1163,8,6,3,13,28,45,-17,21
Randers FC,1163,10,5,6,13,24,41,-17,21
AGF Aarhus,1163,11,4,6,12,17,39,-22,18
Brondby,1164,1,21,6,3,74,32,42,69
FC Midtjylla,1164,2,18,6,6,68,46,22,60
FC Nords,1164,3,16,7,7,83,50,33,55
Copenhagen,1164,4,14,4,12,57,48,9,46
AaB,1164,5,7,13,10,34,43,-9,34
Sonderjyske,1164,6,8,6,10,28,29,-1,30
AC Horsens,1164,7,6,12,12,36,59,-23,30
Lyngby,1164,8,4,9,11,29,44,-15,21
Randers FC,1164,9,5,6,13,23,42,-19,21
Silkeborg IF,1164,10,5,4,13,26,45,-19,19
AGF Aarhus,1164,11,4,7,11,17,37,-20,19
Brondby,1165,1,22,5,3,70,31,39,71
FC Midtjylla,1165,2,21,5,4,70,36,34,68
FC Nords,1165,3,14,7,9,74,51,23,49
Copenhagen,1165,4,14,5,11,59,47,12,47
AaB,1165,5,7,12,11,36,45,-9,33
Sonderjyske,1165,6,8,6,10,28,29,-1,30
AC Horsens,1165,7,5,12,13,33,58,-25,27
Randers FC,1165,8,5,7,12,24,40,-16,22
AGF Aarhus,1165,9,5,6,11,17,36,-19,21
Lyngby,1165,10,3,10,11,27,45,-18,19
Silkeborg IF,1165,11,5,3,14,25,45,-20,18
Brondby,1166,1,20,6,4,68,35,33,66
FC Midtjylla,1166,2,18,8,4,62,34,28,62
Copenhagen,1166,3,14,6,10,60,44,16,48
FC Nords,1166,4,12,8,10,68,53,15,44
AC Horsens,1166,5,7,15,8,36,48,-12,36
AaB,1166,6,6,15,9,35,41,-6,33
Sonderjyske,1166,7,8,6,10,28,29,-1,30
Randers FC,1166,8,6,6,12,27,40,-13,24
Silkeborg IF,1166,9,6,3,13,27,45,-18,21
Lyngby,1166,10,3,9,12,27,48,-21,18
AGF Aarhus,1166,11,4,6,12,17,38,-21,18
Brondby,1167,1,21,6,3,69,33,36,69
FC Midtjylla,1167,2,18,6,6,64,39,25,60
FC Nords,1167,3,14,6,10,72,52,20,48
Copenhagen,1167,4,13,5,12,53,42,11,44
AaB,1167,5,9,13,8,40,39,1,40
AC Horsens,1167,6,7,12,11,33,52,-19,33
Sonderjyske,1167,7,8,6,10,28,29,-1,30
Lyngby,1167,8,4,9,11,30,44,-14,21
AGF Aarhus,1167,9,5,6,11,17,36,-19,21
Randers FC,1167,10,5,6,13,23,43,-20,21
Silkeborg IF,1167,11,5,3,14,25,45,-20,18
Brondby,1168,1,21,6,3,72,29,43,69
FC Midtjylla,1168,2,20,5,5,66,38,28,65
Copenhagen,1168,3,14,4,12,62,44,18,46
FC Nords,1168,4,12,7,11,68,59,9,43
AC Horsens,1168,5,8,13,9,36,51,-15,37
AaB,1168,6,8,11,11,36,45,-9,35
Sonderjyske,1168,7,8,6,10,28,29,-1,30
Lyngby,1168,8,4,9,11,28,45,-17,21
Randers FC,1168,9,5,6,13,24,41,-17,21
Silkeborg IF,1168,10,5,4,13,27,46,-19,19
AGF Aarhus,1168,11,4,7,11,18,38,-20,19
Brondby,1169,1,21,6,3,70,29,41,69
FC Midtjylla,1169,2,19,5,6,64,40,24,62
Copenhagen,1169,3,14,4,12,59,45,14,46
FC Nords,1169,4,13,6,11,73,59,14,45
AC Horsens,1169,5,9,12,9,37,51,-14,39
AaB,1169,6,8,11,11,35,40,-5,35
Sonderjyske,1169,7,8,6,10,28,29,-1,30
Lyngby,1169,8,4,9,11,28,44,-16,21
Randers FC,1169,9,5,6,13,23,41,-18,21
Silkeborg IF,1169,10,5,4,13,26,45,-19,19
AGF Aarhus,1169,11,4,7,11,17,37,-20,19
Brondby,1170,1,21,6,3,70,31,39,69
FC Midtjylla,1170,2,19,7,4,68,40,28,64
FC Nords,1170,3,13,7,10,72,57,15,46
Copenhagen,1170,4,13,5,12,55,45,10,44
AaB,1170,5,9,11,10,39,40,-1,38
AC Horsens,1170,6,6,14,10,37,54,-17,32
Sonderjyske,1170,7,8,6,10,28,29,-1,30
Lyngby,1170,8,4,9,11,29,45,-16,21
Silkeborg IF,1170,9,6,3,13,26,44,-18,21
Randers FC,1170,10,5,6,13,24,42,-18,21
AGF Aarhus,1170,11,4,6,12,16,37,-21,18
Brondby,1171,1,22,6,2,80,33,47,72
FC Midtjylla,1171,2,19,6,5,65,40,25,63
FC Nords,1171,3,15,7,8,75,54,21,52
Copenhagen,1171,4,12,6,12,55,47,8,42
AC Horsens,1171,5,7,12,11,38,52,-14,33
AaB,1171,6,7,11,12,34,47,-13,32
Sonderjyske,1171,7,8,6,10,28,29,-1,30
Randers FC,1171,8,6,6,12,25,40,-15,24
Silkeborg IF,1171,9,5,4,13,26,45,-19,19
AGF Aarhus,1171,10,4,7,11,17,37,-20,19
Lyngby,1171,11,3,9,12,27,46,-19,18
Brondby,1172,1,21,6,3,71,32,39,69
FC Midtjylla,1172,2,18,6,6,62,41,21,60
FC Nords,1172,3,14,7,9,79,56,23,49
Copenhagen,1172,4,15,4,11,55,41,14,49
AC Horsens,1172,5,8,12,10,38,54,-16,36
AaB,1172,6,6,13,11,36,43,-7,31
Sonderjyske,1172,7,8,6,10,28,29,-1,30
Randers FC,1172,8,5,7,12,24,40,-16,22
Silkeborg IF,1172,9,6,3,13,29,44,-15,21
Lyngby,1172,10,3,10,11,27,45,-18,19
AGF Aarhus,1172,11,4,6,12,16,40,-24,18
Brondby,1173,1,22,6,2,73,31,42,72
FC Midtjylla,1173,2,20,5,5,69,37,32,65
Copenhagen,1173,3,15,4,11,65,49,16,49
FC Nords,1173,4,13,6,11,79,64,15,45
AaB,1173,5,7,12,11,40,46,-6,33
AC Horsens,1173,6,6,13,11,34,59,-25,31
Sonderjyske,1173,7,8,6,10,28,29,-1,30
Randers FC,1173,8,5,7,12,23,39,-16,22
Silkeborg IF,1173,9,6,3,13,28,46,-18,21
Lyngby,1173,10,3,10,11,26,44,-18,19
AGF Aarhus,1173,11,4,6,12,18,39,-21,18
Brondby,1174,1,21,6,3,70,29,41,69
FC Midtjylla,1174,2,19,7,4,66,37,29,64
FC Nords,1174,3,14,7,9,69,48,21,49
Copenhagen,1174,4,14,5,11,55,44,11,47
AaB,1174,5,7,11,12,34,45,-11,32
AC Horsens,1174,6,6,14,10,32,49,-17,32
Sonderjyske,1174,7,8,6,10,28,29,-1,30
Randers FC,1174,8,6,6,12,24,39,-15,24
Silkeborg IF,1174,9,5,4,13,26,45,-19,19
AGF Aarhus,1174,10,4,7,11,17,37,-20,19
Lyngby,1174,11,3,9,12,26,45,-19,18
FC Midtjylla,1175,1,20,6,4,67,37,30,66
Brondby,1175,2,19,7,4,70,36,34,64
Copenhagen,1175,3,14,5,11,56,44,12,47
FC Nords,1175,4,13,7,10,73,55,18,46
AaB,1175,5,7,15,8,37,40,-3,36
AC Horsens,1175,6,6,14,10,33,50,-17,32
Sonderjyske,1175,7,8,6,10,28,29,-1,30
Randers FC,1175,8,6,6,12,25,39,-14,24
AGF Aarhus,1175,9,5,6,11,18,36,-18,21
Lyngby,1175,10,3,9,12,26,46,-20,18
Silkeborg IF,1175,11,5,3,14,25,46,-21,18
Brondby,1176,1,21,6,3,73,30,43,69
FC Midtjylla,1176,2,18,5,7,61,42,19,59
FC Nords,1176,3,15,7,8,77,51,26,52
Copenhagen,1176,4,14,6,10,56,42,14,48
AaB,1176,5,7,12,11,37,45,-8,33
AC Horsens,1176,6,6,14,10,33,53,-20,32
Sonderjyske,1176,7,8,6,10,28,29,-1,30
Randers FC,1176,8,6,6,12,26,39,-13,24
Silkeborg IF,1176,9,6,3,13,28,45,-17,21
Lyngby,1176,10,3,9,12,26,47,-21,18
AGF Aarhus,1176,11,4,6,12,17,39,-22,18
Brondby,1177,1,22,5,3,74,32,42,71
FC Midtjylla,1177,2,20,4,6,63,38,25,64
FC Nords,1177,3,15,6,9,76,49,27,51
Copenhagen,1177,4,14,4,12,54,42,12,46
AaB,1177,5,7,12,11,34,44,-10,33
AC Horsens,1177,6,6,13,11,35,57,-22,31
Sonderjyske,1177,7,8,6,10,28,29,-1,30
Randers FC,1177,8,5,7,12,25,41,-16,22
AGF Aarhus,1177,9,5,6,11,18,37,-19,21
Lyngby,1177,10,3,10,11,28,46,-18,19
Silkeborg IF,1177,11,5,3,14,26,46,-20,18
Brondby,1178,1,21,6,3,77,36,41,69
FC Midtjylla,1178,2,21,5,4,74,39,35,68
FC Nords,1178,3,14,7,9,72,53,19,49
Copenhagen,1178,4,13,7,10,61,48,13,46
AC Horsens,1178,5,6,13,11,38,58,-20,31
Sonderjyske,1178,6,8,6,10,28,29,-1,30
AaB,1178,7,6,12,12,38,52,-14,30
Lyngby,1178,8,4,9,11,30,46,-16,21
Randers FC,1178,9,5,6,13,25,43,-18,21
Silkeborg IF,1178,10,5,4,13,27,46,-19,19
AGF Aarhus,1178,11,4,7,11,18,38,-20,19
Brondby,1179,1,23,5,2,70,27,43,74
FC Midtjylla,1179,2,19,6,5,66,38,28,63
FC Nords,1179,3,13,7,10,71,55,16,46
Copenhagen,1179,4,13,4,13,55,47,8,43
AaB,1179,5,9,11,10,41,43,-2,38
AC Horsens,1179,6,6,13,11,34,53,-19,31
Sonderjyske,1179,7,8,6,10,28,29,-1,30
Randers FC,1179,8,6,6,12,26,40,-14,24
Silkeborg IF,1179,9,6,3,13,26,44,-18,21
Lyngby,1179,10,3,9,12,27,47,-20,18
AGF Aarhus,1179,11,4,6,12,16,37,-21,18
Brondby,1180,1,20,5,5,71,36,35,65
FC Midtjylla,1180,2,20,5,5,64,38,26,65
FC Nords,1180,3,14,7,9,71,50,21,49
Copenhagen,1180,4,15,4,11,56,42,14,49
AaB,1180,5,8,11,11,36,41,-5,35
AC Horsens,1180,6,7,12,11,35,52,-17,33
Sonderjyske,1180,7,8,6,10,28,29,-1,30
Lyngby,1180,8,4,9,11,29,45,-16,21
Randers FC,1180,9,5,6,13,24,42,-18,21
Silkeborg IF,1180,10,5,4,13,26,45,-19,19
AGF Aarhus,1180,11,4,7,11,17,37,-20,19
Brondby,1181,1,21,7,2,71,31,40,70
FC Midtjylla,1181,2,19,6,5,65,38,27,63
FC Nords,1181,3,15,6,9,76,53,23,51
Copenhagen,1181,4,14,4,12,59,47,12,46
AaB,1181,5,8,12,10,39,45,-6,36
Sonderjyske,1181,6,8,6,10,28,29,-1,30
AC Horsens,1181,7,5,13,12,36,58,-22,28
Randers FC,1181,8,5,7,12,23,39,-16,22
Silkeborg IF,1181,9,6,3,13,26,44,-18,21
Lyngby,1181,10,3,10,11,26,44,-18,19
AGF Aarhus,1181,11,4,6,12,16,37,-21,18
Brondby,1182,1,21,6,3,72,31,41,69
FC Midtjylla,1182,2,20,4,6,68,40,28,64
FC Nords,1182,3,15,7,8,75,52,23,52
Copenhagen,1182,4,14,5,11,56,46,10,47
AaB,1182,5,7,11,12,35,43,-8,32
AC Horsens,1182,6,6,13,11,34,54,-20,31
Sonderjyske,1182,7,8,6,10,28,29,-1,30
Randers FC,1182,8,6,6,12,25,40,-15,24
Silkeborg IF,1182,9,6,3,13,27,45,-18,21
Lyngby,1182,10,3,9,12,27,46,-19,18
AGF Aarhus,1182,11,4,6,12,17,38,-21,18
Brondby,1183,1,21,6,3,68,31,37,69
FC Midtjylla,1183,2,21,4,5,68,38,30,67
FC Nords,1183,3,14,7,9,73,48,25,49
Copenhagen,1183,4,14,6,10,56,42,14,48
AaB,1183,5,6,13,11,37,51,-14,31
Sonderjyske,1183,6,8,6,10,28,29,-1,30
AC Horsens,1183,7,5,14,11,32,50,-18,29
Randers FC,1183,8,6,6,12,25,40,-15,24
Silkeborg IF,1183,9,6,3,13,28,45,-17,21
Lyngby,1183,10,3,9,12,27,46,-19,18
AGF Aarhus,1183,11,4,6,12,17,39,-22,18
Brondby,1184,1,22,5,3,74,31,43,71
FC Midtjylla,1184,2,20,5,5,67,40,27,65
FC Nords,1184,3,14,7,9,78,53,25,49
Copenhagen,1184,4,14,5,11,60,49,11,47
AaB,1184,5,8,11,11,39,45,-6,35
Sonderjyske,1184,6,8,6,10,28,29,-1,30
AC Horsens,1184,7,5,13,12,33,59,-26,28
Randers FC,1184,8,5,7,12,24,40,-16,22
Lyngby,1184,9,3,10,11,27,45,-18,19
Silkeborg IF,1184,10,5,4,13,25,44,-19,19
AGF Aarhus,1184,11,4,7,11,16,36,-20,19
Brondby,1185,1,22,5,3,77,33,44,71
FC Midtjylla,1185,2,18,4,8,63,44,19,58
Copenhagen,1185,3,15,5,10,61,46,15,50
FC Nords,1185,4,14,6,10,74,56,18,48
AaB,1185,5,8,13,9,38,41,-3,37
AC Horsens,1185,6,6,13,11,35,54,-19,31
Sonderjyske,1185,7,8,6,10,28,29,-1,30
Lyngby,1185,8,4,9,11,28,45,-17,21
Randers FC,1185,9,5,6,13,24,41,-17,21
AGF Aarhus,1185,10,5,6,11,17,36,-19,21
Silkeborg IF,1185,11,5,3,14,25,45,-20,18
Brondby,1186,1,21,6,3,66,30,36,69
FC Midtjylla,1186,2,19,5,6,66,40,26,62
FC Nords,1186,3,14,6,10,69,51,18,48
Copenhagen,1186,4,14,4,12,56,45,11,46
AaB,1186,5,8,12,10,37,39,-2,36
AC Horsens,1186,6,7,13,10,36,51,-15,34
Sonderjyske,1186,7,8,6,10,28,29,-1,30
Randers FC,1186,8,6,6,12,25,40,-15,24
Silkeborg IF,1186,9,6,3,13,27,44,-17,21
Lyngby,1186,10,3,9,12,27,46,-19,18
AGF Aarhus,1186,11,4,6,12,16,38,-22,18
Brondby,1187,1,20,7,3,71,32,39,67
FC Midtjylla,1187,2,20,6,4,65,38,27,66
FC Nords,1187,3,13,7,10,72,53,19,46
Copenhagen,1187,4,14,4,12,55,45,10,46
AaB,1187,5,8,11,11,36,41,-5,35
AC Horsens,1187,6,7,13,10,34,50,-16,34
Sonderjyske,1187,7,8,6,10,28,29,-1,30
Randers FC,1187,8,6,6,12,24,39,-15,24
Silkeborg IF,1187,9,6,3,13,27,45,-18,21
Lyngby,1187,10,3,9,12,26,45,-19,18
AGF Aarhus,1187,11,4,6,12,17,38,-21,18
Brondby,1188,1,21,6,3,71,29,42,69
FC Midtjylla,1188,2,18,5,7,63,41,22,59
FC Nords,1188,3,14,9,7,70,47,23,51
Copenhagen,1188,4,14,6,10,60,44,16,48
AaB,1188,5,7,13,10,37,47,-10,34
Sonderjyske,1188,6,8,6,10,28,29,-1,30
AC Horsens,1188,7,5,15,10,31,50,-19,30
Randers FC,1188,8,5,7,12,24,40,-16,22
Silkeborg IF,1188,9,6,3,13,26,44,-18,21
Lyngby,1188,10,3,10,11,27,45,-18,19
AGF Aarhus,1188,11,4,6,12,16,37,-21,18
Brondby,1189,1,21,7,2,76,36,40,70
FC Midtjylla,1189,2,18,6,6,69,41,28,60
FC Nords,1189,3,13,10,7,71,48,23,49
Copenhagen,1189,4,13,5,12,56,48,8,44
AaB,1189,5,7,13,10,36,44,-8,34
AC Horsens,1189,6,6,15,9,38,55,-17,33
Sonderjyske,1189,7,8,6,10,28,29,-1,30
Lyngby,1189,8,4,9,11,28,44,-16,21
Silkeborg IF,1189,9,6,3,13,27,44,-17,21
Randers FC,1189,10,5,6,13,23,41,-18,21
AGF Aarhus,1189,11,4,6,12,16,38,-22,18
Brondby,1190,1,20,6,4,69,34,35,66
FC Midtjylla,1190,2,20,5,5,65,38,27,65
FC Nords,1190,3,16,7,7,80,51,29,55
Copenhagen,1190,4,13,5,12,59,48,11,44
AaB,1190,5,8,11,11,37,45,-8,35
Sonderjyske,1190,6,8,6,10,28,29,-1,30
AC Horsens,1190,7,5,14,11,34,54,-20,29
Lyngby,1190,8,4,9,11,28,44,-16,21
Randers FC,1190,9,5,6,13,23,41,-18,21
AGF Aarhus,1190,10,5,6,11,17,36,-19,21
Silkeborg IF,1190,11,5,3,14,25,45,-20,18
Brondby,1191,1,20,6,4,68,32,36,66
FC Midtjylla,1191,2,20,5,5,67,39,28,65
FC Nords,1191,3,15,7,8,74,48,26,52
Copenhagen,1191,4,15,4,11,64,49,15,49
AaB,1191,5,7,11,12,34,46,-12,32
AC Horsens,1191,6,6,13,11,35,54,-19,31
Sonderjyske,1191,7,8,6,10,28,29,-1,30
Randers FC,1191,8,6,6,12,24,39,-15,24
AGF Aarhus,1191,9,5,6,11,18,36,-18,21
Lyngby,1191,10,3,9,12,26,45,-19,18
Silkeborg IF,1191,11,5,3,14,25,46,-21,18
Brondby,1192,1,20,7,3,69,33,36,67
FC Midtjylla,1192,2,18,6,6,66,41,25,60
FC Nords,1192,3,15,8,7,81,53,28,53
Copenhagen,1192,4,14,5,11,60,48,12,47
AC Horsens,1192,5,8,12,10,42,58,-16,36
Sonderjyske,1192,6,8,6,10,28,29,-1,30
AaB,1192,7,6,12,12,35,46,-11,30
Randers FC,1192,8,5,7,12,25,41,-16,22
Silkeborg IF,1192,9,6,3,13,26,44,-18,21
Lyngby,1192,10,3,10,11,28,46,-18,19
AGF Aarhus,1192,11,4,6,12,16,37,-21,18
Brondby,1193,1,20,6,4,70,36,34,66
FC Midtjylla,1193,2,18,6,6,64,43,21,60
FC Nords,1193,3,16,6,8,80,49,31,54
Copenhagen,1193,4,14,6,10,56,41,15,48
AaB,1193,5,7,12,11,37,44,-7,33
AC Horsens,1193,6,7,12,11,34,54,-20,33
Sonderjyske,1193,7,8,6,10,28,29,-1,30
Randers FC,1193,8,5,7,12,23,39,-16,22
Silkeborg IF,1193,9,6,3,13,26,44,-18,21
Lyngby,1193,10,3,10,11,26,44,-18,19
AGF Aarhus,1193,11,4,6,12,16,37,-21,18
Brondby,1194,1,19,6,5,67,33,34,63
FC Midtjylla,1194,2,19,5,6,64,41,23,62
Copenhagen,1194,3,15,6,9,62,42,20,51
FC Nords,1194,4,14,7,9,74,55,19,49
AaB,1194,5,9,12,9,42,40,2,39
Sonderjyske,1194,6,8,6,10,28,29,-1,30
AC Horsens,1194,7,6,12,12,33,57,-24,30
Randers FC,1194,8,5,7,12,24,40,-16,22
Silkeborg IF,1194,9,6,3,13,28,46,-18,21
Lyngby,1194,10,3,10,11,27,45,-18,19
AGF Aarhus,1194,11,4,6,12,18,39,-21,18
Brondby,1195,1,21,6,3,72,32,40,69
FC Midtjylla,1195,2,18,4,8,61,41,20,58
FC Nords,1195,3,12,8,10,70,57,13,44
Copenhagen,1195,4,13,5,12,55,45,10,44
AaB,1195,5,10,11,9,43,42,1,41
AC Horsens,1195,6,9,12,9,39,49,-10,39
Sonderjyske,1195,7,8,6,10,28,29,-1,30
Lyngby,1195,8,4,9,11,27,44,-17,21
Randers FC,1195,9,5,6,13,23,40,-17,21
Silkeborg IF,1195,10,5,4,13,27,46,-19,19
AGF Aarhus,1195,11,4,7,11,18,38,-20,19
Brondby,1196,1,20,7,3,74,33,41,67
FC Midtjylla,1196,2,18,5,7,62,44,18,59
FC Nords,1196,3,14,8,8,75,51,24,50
Copenhagen,1196,4,14,6,10,56,40,16,48
AC Horsens,1196,5,9,12,9,36,46,-10,39
Sonderjyske,1196,6,8,6,10,28,29,-1,30
AaB,1196,7,6,12,12,35,50,-15,30
Randers FC,1196,8,6,6,12,25,40,-15,24
Silkeborg IF,1196,9,6,3,13,27,44,-17,21
Lyngby,1196,10,3,9,12,27,46,-19,18
AGF Aarhus,1196,11,4,6,12,16,38,-22,18
Brondby,1197,1,21,7,2,68,30,38,70
FC Midtjylla,1197,2,17,5,8,63,47,16,56
FC Nords,1197,3,14,9,7,78,49,29,51
Copenhagen,1197,4,14,6,10,57,43,14,48
AaB,1197,5,7,13,10,35,40,-5,34
AC Horsens,1197,6,6,14,10,33,51,-18,32
Sonderjyske,1197,7,8,6,10,28,29,-1,30
Randers FC,1197,8,5,7,12,24,40,-16,22
Silkeborg IF,1197,9,6,3,13,27,44,-17,21
Lyngby,1197,10,3,10,11,27,45,-18,19
AGF Aarhus,1197,11,4,6,12,16,38,-22,18
Brondby,1198,1,20,6,4,71,33,38,66
FC Midtjylla,1198,2,17,8,5,60,39,21,59
FC Nords,1198,3,13,8,9,70,53,17,47
Copenhagen,1198,4,14,4,12,57,49,8,46
AaB,1198,5,9,12,9,43,40,3,39
AC Horsens,1198,6,7,14,9,35,48,-13,35
Sonderjyske,1198,7,8,6,10,28,29,-1,30
Lyngby,1198,8,4,9,11,27,44,-17,21
Randers FC,1198,9,5,6,13,23,40,-17,21
Silkeborg IF,1198,10,5,4,13,26,45,-19,19
AGF Aarhus,1198,11,4,7,11,17,37,-20,19
Brondby,1199,1,22,5,3,76,33,43,71
FC Midtjylla,1199,2,18,7,5,62,40,22,61
FC Nords,1199,3,14,7,9,76,52,24,49
Copenhagen,1199,4,13,5,12,59,52,7,44
AaB,1199,5,8,12,10,40,48,-8,36
AC Horsens,1199,6,7,12,11,38,52,-14,33
Sonderjyske,1199,7,8,6,10,28,29,-1,30
Lyngby,1199,8,4,9,11,29,44,-15,21
Silkeborg IF,1199,9,6,3,13,27,45,-18,21
Randers FC,1199,10,5,6,13,23,42,-19,21
AGF Aarhus,1199,11,4,6,12,17,38,-21,18
Brondby,1200,1,19,7,4,71,36,35,64
FC Midtjylla,1200,2,19,6,5,68,41,27,63
FC Nords,1200,3,14,7,9,78,56,22,49
Copenhagen,1200,4,15,4,11,60,46,14,49
AC Horsens,1200,5,7,14,9,39,51,-12,35
AaB,1200,6,6,14,10,34,46,-12,32
Sonderjyske,1200,7,8,6,10,28,29,-1,30
Randers FC,1200,8,5,7,12,26,42,-16,22
Silkeborg IF,1200,9,6,3,13,28,46,-18,21
Lyngby,1200,10,3,10,11,29,47,-18,19
AGF Aarhus,1200,11,4,6,12,18,39,-21,18
Brondby,1201,1,19,9,2,70,32,38,66
FC Midtjylla,1201,2,19,7,4,66,37,29,64
Copenhagen,1201,3,14,7,9,58,42,16,49
FC Nords,1201,4,13,7,10,71,52,19,46
AaB,1201,5,8,13,9,36,41,-5,37
Sonderjyske,1201,6,8,6,10,28,29,-1,30
AC Horsens,1201,7,5,13,12,32,55,-23,28
Lyngby,1201,8,4,9,11,28,45,-17,21
Randers FC,1201,9,5,6,13,24,41,-17,21
Silkeborg IF,1201,10,5,4,13,26,45,-19,19
AGF Aarhus,1201,11,4,7,11,17,37,-20,19
Brondby,1202,1,22,6,2,80,33,47,72
FC Midtjylla,1202,2,19,6,5,67,37,30,63
FC Nords,1202,3,14,8,8,78,56,22,50
Copenhagen,1202,4,13,4,13,58,54,4,43
AaB,1202,5,7,12,11,35,45,-10,33
AC Horsens,1202,6,7,12,11,35,54,-19,33
Sonderjyske,1202,7,8,6,10,28,29,-1,30
Lyngby,1202,8,4,9,11,29,46,-17,21
Randers FC,1202,9,5,6,13,25,42,-17,21
Silkeborg IF,1202,10,5,4,13,26,45,-19,19
AGF Aarhus,1202,11,4,7,11,17,37,-20,19
Brondby,1203,1,22,5,3,71,30,41,71
FC Midtjylla,1203,2,18,5,7,62,44,18,59
FC Nords,1203,3,14,6,10,72,51,21,48
Copenhagen,1203,4,14,5,11,57,43,14,47
AaB,1203,5,8,12,10,37,42,-5,36
AC Horsens,1203,6,7,13,10,36,51,-15,34
Sonderjyske,1203,7,8,6,10,28,29,-1,30
Randers FC,1203,8,5,7,12,25,41,-16,22
Silkeborg IF,1203,9,6,3,13,26,44,-18,21
Lyngby,1203,10,3,10,11,28,46,-18,19
AGF Aarhus,1203,11,4,6,12,16,37,-21,18
Brondby,1204,1,20,5,5,69,33,36,65
FC Midtjylla,1204,2,19,6,5,66,39,27,63
Copenhagen,1204,3,17,4,9,64,44,20,55
FC Nords,1204,4,14,8,8,75,54,21,50
AC Horsens,1204,5,6,14,10,34,51,-17,32
Sonderjyske,1204,6,8,6,10,28,29,-1,30
AaB,1204,7,6,11,13,34,47,-13,29
Randers FC,1204,8,5,7,12,24,40,-16,22
AGF Aarhus,1204,9,5,6,11,17,36,-19,21
Lyngby,1204,10,3,10,11,27,45,-18,19
Silkeborg IF,1204,11,5,3,14,25,45,-20,18
Brondby,1205,1,20,7,3,73,35,38,67
FC Midtjylla,1205,2,19,7,4,71,41,30,64
FC Nords,1205,3,14,7,9,72,52,20,49
Copenhagen,1205,4,12,6,12,56,48,8,42
AaB,1205,5,8,11,11,36,44,-8,35
AC Horsens,1205,6,7,14,9,38,52,-14,35
Sonderjyske,1205,7,8,6,10,28,29,-1,30
Randers FC,1205,8,5,7,12,24,40,-16,22
Silkeborg IF,1205,9,6,3,13,27,45,-18,21
Lyngby,1205,10,3,10,11,27,45,-18,19
AGF Aarhus,1205,11,4,6,12,17,38,-21,18
Brondby,1206,1,20,6,4,70,33,37,66
FC Midtjylla,1206,2,18,7,5,66,41,25,61
FC Nords,1206,3,16,7,7,76,47,29,55
Copenhagen,1206,4,13,6,11,56,43,13,45
AaB,1206,5,7,13,10,35,44,-9,34
AC Horsens,1206,6,6,13,11,33,54,-21,31
Sonderjyske,1206,7,8,6,10,28,29,-1,30
Randers FC,1206,8,6,6,12,26,41,-15,24
Silkeborg IF,1206,9,6,3,13,27,45,-18,21
Lyngby,1206,10,3,9,12,28,47,-19,18
AGF Aarhus,1206,11,4,6,12,17,38,-21,18
Brondby,1207,1,21,6,3,70,32,38,69
FC Midtjylla,1207,2,18,5,7,66,43,23,59
FC Nords,1207,3,14,8,8,74,52,22,50
Copenhagen,1207,4,13,5,12,57,44,13,44
AaB,1207,5,9,12,9,39,42,-3,39
AC Horsens,1207,6,7,12,11,31,50,-19,33
Sonderjyske,1207,7,8,6,10,28,29,-1,30
Randers FC,1207,8,6,6,12,24,39,-15,24
Silkeborg IF,1207,9,6,3,13,26,44,-18,21
Lyngby,1207,10,3,9,12,26,45,-19,18
AGF Aarhus,1207,11,4,6,12,16,37,-21,18
Brondby,1208,1,21,6,3,78,33,45,69
FC Midtjylla,1208,2,17,6,7,62,48,14,57
FC Nords,1208,3,13,9,8,70,53,17,48
Copenhagen,1208,4,14,6,10,60,45,15,48
AaB,1208,5,8,14,8,40,39,1,38
AC Horsens,1208,6,6,13,11,34,52,-18,31
Sonderjyske,1208,7,8,6,10,28,29,-1,30
Randers FC,1208,8,5,7,12,24,40,-16,22
Silkeborg IF,1208,9,6,3,13,27,44,-17,21
Lyngby,1208,10,3,10,11,27,45,-18,19
AGF Aarhus,1208,11,4,6,12,16,38,-22,18
Brondby,1209,1,21,7,2,68,29,39,70
FC Midtjylla,1209,2,20,5,5,65,37,28,65
FC Nords,1209,3,13,8,9,73,51,22,47
Copenhagen,1209,4,14,5,11,60,49,11,47
AaB,1209,5,8,12,10,39,42,-3,36
Sonderjyske,1209,6,8,6,10,28,29,-1,30
AC Horsens,1209,7,5,13,12,33,56,-23,28
Randers FC,1209,8,5,7,12,25,41,-16,22
Lyngby,1209,9,3,10,11,28,46,-18,19
Silkeborg IF,1209,10,5,4,13,25,44,-19,19
AGF Aarhus,1209,11,4,7,11,16,36,-20,19
Brondby,1210,1,19,7,4,68,37,31,64
FC Midtjylla,1210,2,20,4,6,65,41,24,64
FC Nords,1210,3,14,7,9,71,49,22,49
Copenhagen,1210,4,14,5,11,58,43,15,47
AC Horsens,1210,5,9,12,9,38,47,-9,39
AaB,1210,6,7,11,12,38,47,-9,32
Sonderjyske,1210,7,8,6,10,28,29,-1,30
Lyngby,1210,8,4,9,11,27,44,-17,21
Randers FC,1210,9,5,6,13,23,40,-17,21
AGF Aarhus,1210,10,5,6,11,17,36,-19,21
Silkeborg IF,1210,11,5,3,14,25,45,-20,18
FC Midtjylla,1211,1,21,4,5,65,40,25,67
Brondby,1211,2,19,8,3,69,33,36,65
FC Nords,1211,3,15,6,9,77,51,26,51
Copenhagen,1211,4,12,6,12,51,42,9,42
AaB,1211,5,8,12,10,38,43,-5,36
AC Horsens,1211,6,6,14,10,37,54,-17,32
Sonderjyske,1211,7,8,6,10,28,29,-1,30
Lyngby,1211,8,4,9,11,28,44,-16,21
Randers FC,1211,9,5,6,13,23,41,-18,21
AGF Aarhus,1211,10,5,6,11,18,37,-19,21
Silkeborg IF,1211,11,5,3,14,26,46,-20,18
Brondby,1212,1,20,7,3,68,31,37,67
FC Midtjylla,1212,2,18,6,6,61,39,22,60
FC Nords,1212,3,15,6,9,73,51,22,51
Copenhagen,1212,4,15,5,10,60,43,17,50
AaB,1212,5,8,12,10,35,38,-3,36
Sonderjyske,1212,6,8,6,10,28,29,-1,30
AC Horsens,1212,7,5,14,11,32,53,-21,29
Lyngby,1212,8,4,9,11,28,45,-17,21
Randers FC,1212,9,5,6,13,24,41,-17,21
Silkeborg IF,1212,10,6,3,13,26,44,-18,21
AGF Aarhus,1212,11,4,6,12,16,37,-21,18
Brondby,1213,1,22,5,3,75,30,45,71
FC Midtjylla,1213,2,19,6,5,63,36,27,63
FC Nords,1213,3,12,9,9,71,59,12,45
Copenhagen,1213,4,13,5,12,60,51,9,44
AC Horsens,1213,5,7,15,8,38,50,-12,36
AaB,1213,6,6,14,10,35,42,-7,32
Sonderjyske,1213,7,8,6,10,28,29,-1,30
Lyngby,1213,8,4,9,11,28,44,-16,21
Randers FC,1213,9,5,6,13,23,41,-18,21
AGF Aarhus,1213,10,5,6,11,18,36,-18,21
Silkeborg IF,1213,11,5,3,14,25,46,-21,18
Brondby,1214,1,21,5,4,69,34,35,68
FC Midtjylla,1214,2,21,4,5,70,36,34,67
FC Nords,1214,3,15,6,9,72,51,21,51
Copenhagen,1214,4,13,5,12,55,46,9,44
AaB,1214,5,7,13,10,34,39,-5,34
AC Horsens,1214,6,6,13,11,32,52,-20,31
Sonderjyske,1214,7,8,6,10,28,29,-1,30
Randers FC,1214,8,5,7,12,24,40,-16,22
Lyngby,1214,9,3,10,11,27,45,-18,19
Silkeborg IF,1214,10,5,4,13,26,45,-19,19
AGF Aarhus,1214,11,4,7,11,17,37,-20,19
Brondby,1215,1,21,7,2,73,30,43,70
FC Midtjylla,1215,2,20,6,4,65,37,28,66
FC Nords,1215,3,14,6,10,71,55,16,48
Copenhagen,1215,4,12,5,13,52,48,4,41
AaB,1215,5,8,13,9,42,41,1,37
AC Horsens,1215,6,6,13,11,37,55,-18,31
Sonderjyske,1215,7,8,6,10,28,29,-1,30
Lyngby,1215,8,4,9,11,28,44,-16,21
Randers FC,1215,9,5,6,13,23,41,-18,21
AGF Aarhus,1215,10,5,6,11,18,37,-19,21
Silkeborg IF,1215,11,5,3,14,26,46,-20,18
Brondby,1216,1,21,6,3,71,31,40,69
FC Midtjylla,1216,2,21,4,5,68,40,28,67
FC Nords,1216,3,14,7,9,79,55,24,49
Copenhagen,1216,4,15,4,11,58,43,15,49
AC Horsens,1216,5,6,13,11,35,57,-22,31
Sonderjyske,1216,6,8,6,10,28,29,-1,30
AaB,1216,7,6,12,12,34,45,-11,30
Randers FC,1216,8,5,7,12,24,40,-16,22
AGF Aarhus,1216,9,5,6,11,18,37,-19,21
Lyngby,1216,10,3,10,11,27,45,-18,19
Silkeborg IF,1216,11,5,3,14,26,46,-20,18
FC Midtjylla,1217,1,21,5,4,72,39,33,68
Brondby,1217,2,20,5,5,74,37,37,65
FC Nords,1217,3,16,6,8,76,50,26,54
Copenhagen,1217,4,14,6,10,61,46,15,48
Sonderjyske,1217,5,8,6,10,28,29,-1,30
AaB,1217,6,6,12,12,36,51,-15,30
AC Horsens,1217,7,5,14,11,31,53,-22,29
Lyngby,1217,8,4,9,11,27,44,-17,21
Randers FC,1217,9,5,6,13,23,40,-17,21
Silkeborg IF,1217,10,5,4,13,25,44,-19,19
AGF Aarhus,1217,11,4,7,11,16,36,-20,19
Brondby,1218,1,20,7,3,75,34,41,67
FC Midtjylla,1218,2,20,5,5,67,38,29,65
FC Nords,1218,3,13,7,10,74,56,18,46
Copenhagen,1218,4,13,7,10,58,45,13,46
AaB,1218,5,8,11,11,34,44,-10,35
AC Horsens,1218,6,7,13,10,37,54,-17,34
Sonderjyske,1218,7,8,6,10,28,29,-1,30
Randers FC,1218,8,5,7,12,24,40,-16,22
AGF Aarhus,1218,9,5,6,11,17,36,-19,21
Lyngby,1218,10,3,10,11,27,45,-18,19
Silkeborg IF,1218,11,5,3,14,25,45,-20,18
Brondby,1219,1,20,7,3,70,33,37,67
FC Midtjylla,1219,2,19,6,5,64,36,28,63
FC Nords,1219,3,14,8,8,72,50,22,50
Copenhagen,1219,4,15,5,10,57,41,16,50
AaB,1219,5,8,11,11,36,41,-5,35
Sonderjyske,1219,6,8,6,10,28,29,-1,30
AC Horsens,1219,7,5,13,12,35,59,-24,28
Randers FC,1219,8,6,6,12,25,39,-14,24
Silkeborg IF,1219,9,5,4,13,26,45,-19,19
AGF Aarhus,1219,10,4,7,11,17,37,-20,19
Lyngby,1219,11,3,9,12,26,46,-20,18
Brondby,1220,1,20,7,3,68,32,36,67
FC Midtjylla,1220,2,18,6,6,70,46,24,60
Copenhagen,1220,3,16,5,9,64,47,17,53
FC Nords,1220,4,14,8,8,73,51,22,50
AaB,1220,5,6,14,10,39,45,-6,32
Sonderjyske,1220,6,8,6,10,28,29,-1,30
AC Horsens,1220,7,5,14,11,31,50,-19,29
Lyngby,1220,8,4,9,11,29,45,-16,21
Randers FC,1220,9,5,6,13,24,42,-18,21
Silkeborg IF,1220,10,5,4,13,27,46,-19,19
AGF Aarhus,1220,11,4,7,11,18,38,-20,19
Brondby,1221,1,20,6,4,68,30,38,66
FC Midtjylla,1221,2,17,6,7,60,41,19,57
FC Nords,1221,3,14,8,8,70,51,19,50
Copenhagen,1221,4,13,8,9,57,42,15,47
AaB,1221,5,7,14,9,38,41,-3,35
AC Horsens,1221,6,7,14,9,37,51,-14,35
Sonderjyske,1221,7,8,6,10,28,29,-1,30
Randers FC,1221,8,5,7,12,24,40,-16,22
Silkeborg IF,1221,9,6,3,13,27,44,-17,21
Lyngby,1221,10,3,10,11,27,45,-18,19
AGF Aarhus,1221,11,4,6,12,16,38,-22,18
Brondby,1222,1,20,5,5,67,32,35,65
FC Midtjylla,1222,2,18,6,6,63,41,22,60
FC Nords,1222,3,14,7,9,71,49,22,49
Copenhagen,1222,4,14,5,11,57,47,10,47
AaB,1222,5,9,13,8,41,42,-1,40
AC Horsens,1222,6,7,12,11,35,49,-14,33
Sonderjyske,1222,7,8,6,10,28,29,-1,30
Randers FC,1222,8,6,6,12,25,40,-15,24
Silkeborg IF,1222,9,5,4,13,25,44,-19,19
AGF Aarhus,1222,10,4,7,11,16,36,-20,19
Lyngby,1222,11,3,9,12,27,46,-19,18
FC Midtjylla,1223,1,20,6,4,66,35,31,66
Brondby,1223,2,19,8,3,67,32,35,65
FC Nords,1223,3,14,7,9,75,50,25,49
Copenhagen,1223,4,13,5,12,57,49,8,44
AaB,1223,5,8,12,10,38,42,-4,36
AC Horsens,1223,6,6,14,10,33,54,-21,32
Sonderjyske,1223,7,8,6,10,28,29,-1,30
Randers FC,1223,8,5,7,12,24,40,-16,22
Silkeborg IF,1223,9,6,3,13,26,44,-18,21
Lyngby,1223,10,3,10,11,27,45,-18,19
AGF Aarhus,1223,11,4,6,12,16,37,-21,18
Brondby,1224,1,22,5,3,72,30,42,71
FC Midtjylla,1224,2,21,4,5,66,36,30,67
Copenhagen,1224,3,14,4,12,58,43,15,46
FC Nords,1224,4,13,6,11,70,57,13,45
AaB,1224,5,9,11,10,37,43,-6,38
Sonderjyske,1224,6,8,6,10,28,29,-1,30
AC Horsens,1224,7,6,12,12,34,54,-20,30
Lyngby,1224,8,4,9,11,28,45,-17,21
Randers FC,1224,9,5,6,13,24,41,-17,21
Silkeborg IF,1224,10,6,3,13,27,45,-18,21
AGF Aarhus,1224,11,4,6,12,17,38,-21,18
Brondby,1225,1,20,7,3,69,32,37,67
FC Midtjylla,1225,2,20,5,5,63,37,26,65
FC Nords,1225,3,14,6,10,75,53,22,48
Copenhagen,1225,4,12,7,11,57,49,8,43
AaB,1225,5,8,11,11,35,40,-5,35
AC Horsens,1225,6,7,14,9,38,52,-14,35
Sonderjyske,1225,7,8,6,10,28,29,-1,30
Lyngby,1225,8,4,9,11,27,44,-17,21
Randers FC,1225,9,5,6,13,23,40,-17,21
AGF Aarhus,1225,10,5,6,11,17,36,-19,21
Silkeborg IF,1225,11,5,3,14,25,45,-20,18
Brondby,1226,1,20,6,4,70,34,36,66
FC Midtjylla,1226,2,19,6,5,65,40,25,63
Copenhagen,1226,3,15,5,10,60,41,19,50
FC Nords,1226,4,13,7,10,71,56,15,46
AaB,1226,5,7,14,9,41,43,-2,35
AC Horsens,1226,6,6,14,10,36,55,-19,32
Sonderjyske,1226,7,8,6,10,28,29,-1,30
Randers FC,1226,8,5,7,12,26,42,-16,22
Lyngby,1226,9,3,10,11,29,47,-18,19
Silkeborg IF,1226,10,5,4,13,25,44,-19,19
AGF Aarhus,1226,11,4,7,11,16,36,-20,19
FC Midtjylla,1227,1,21,4,5,68,42,26,67
Brondby,1227,2,20,5,5,73,38,35,65
Copenhagen,1227,3,15,4,11,61,45,16,49
FC Nords,1227,4,14,6,10,71,50,21,48
AaB,1227,5,9,11,10,39,43,-4,38
Sonderjyske,1227,6,8,6,10,28,29,-1,30
AC Horsens,1227,7,6,12,12,33,53,-20,30
Lyngby,1227,8,4,9,11,30,44,-14,21
AGF Aarhus,1227,9,5,6,11,18,36,-18,21
Randers FC,1227,10,5,6,13,23,43,-20,21
Silkeborg IF,1227,11,5,3,14,25,46,-21,18
Brondby,1228,1,20,6,4,73,37,36,66
FC Midtjylla,1228,2,19,5,6,63,40,23,62
FC Nords,1228,3,15,8,7,78,49,29,53
Copenhagen,1228,4,14,4,12,61,50,11,46
AaB,1228,5,9,11,10,39,42,-3,38
Sonderjyske,1228,6,8,6,10,28,29,-1,30
AC Horsens,1228,7,6,12,12,32,54,-22,30
Silkeborg IF,1228,8,6,3,13,29,44,-15,21
Lyngby,1228,9,4,9,11,28,45,-17,21
Randers FC,1228,10,5,6,13,24,41,-17,21
AGF Aarhus,1228,11,4,6,12,16,40,-24,18
Brondby,1229,1,22,6,2,72,29,43,72
FC Midtjylla,1229,2,19,4,7,62,43,19,61
FC Nords,1229,3,14,7,9,72,53,19,49
Copenhagen,1229,4,14,6,10,56,42,14,48
AaB,1229,5,7,12,11,37,41,-4,33
Sonderjyske,1229,6,8,6,10,28,29,-1,30
AC Horsens,1229,7,5,15,10,30,47,-17,30
Randers FC,1229,8,6,6,12,24,39,-15,24
Silkeborg IF,1229,9,5,4,13,26,45,-19,19
AGF Aarhus,1229,10,4,7,11,17,37,-20,19
Lyngby,1229,11,3,9,12,26,45,-19,18
Brondby,1230,1,20,8,2,72,33,39,68
FC Midtjylla,1230,2,19,5,6,66,42,24,62
FC Nords,1230,3,15,7,8,80,54,26,52
Copenhagen,1230,4,13,6,11,58,52,6,45
AaB,1230,5,7,12,11,45,47,-2,33
AC Horsens,1230,6,6,14,10,37,56,-19,32
Sonderjyske,1230,7,8,6,10,28,29,-1,30
Randers FC,1230,8,5,7,12,25,41,-16,22
Silkeborg IF,1230,9,6,3,13,27,44,-17,21
Lyngby,1230,10,3,10,11,28,46,-18,19
AGF Aarhus,1230,11,4,6,12,16,38,-22,18
Brondby,1231,1,20,7,3,70,33,37,67
FC Midtjylla,1231,2,18,4,8,62,42,20,58
Copenhagen,1231,3,14,7,9,61,43,18,49
FC Nords,1231,4,13,8,9,69,50,19,47
AaB,1231,5,8,12,10,39,45,-6,36
AC Horsens,1231,6,8,12,10,40,54,-14,36
Sonderjyske,1231,7,8,6,10,28,29,-1,30
Randers FC,1231,8,6,6,12,25,39,-14,24
AGF Aarhus,1231,9,5,6,11,17,36,-19,21
Lyngby,1231,10,3,9,12,26,46,-20,18
Silkeborg IF,1231,11,5,3,14,25,45,-20,18
Brondby,1232,1,20,7,3,72,30,42,67
FC Midtjylla,1232,2,21,4,5,64,36,28,67
FC Nords,1232,3,15,7,8,71,47,24,52
Copenhagen,1232,4,14,5,11,57,45,12,47
AaB,1232,5,7,11,12,34,45,-11,32
Sonderjyske,1232,6,8,6,10,28,29,-1,30
AC Horsens,1232,7,6,12,12,32,53,-21,30
Lyngby,1232,8,4,9,11,27,44,-17,21
Randers FC,1232,9,5,6,13,23,40,-17,21
Silkeborg IF,1232,10,5,4,13,26,45,-19,19
AGF Aarhus,1232,11,4,7,11,17,37,-20,19
Brondby,1233,1,22,5,3,74,32,42,71
FC Midtjylla,1233,2,20,4,6,71,40,31,64
FC Nords,1233,3,13,8,9,74,53,21,47
Copenhagen,1233,4,14,5,11,59,46,13,47
AaB,1233,5,7,12,11,36,45,-9,33
AC Horsens,1233,6,7,12,11,34,58,-24,33
Sonderjyske,1233,7,8,6,10,28,29,-1,30
Randers FC,1233,8,6,6,12,26,41,-15,24
Silkeborg IF,1233,9,5,4,13,25,44,-19,19
AGF Aarhus,1233,10,4,7,11,16,36,-20,19
Lyngby,1233,11,3,9,12,28,47,-19,18
Brondby,1234,1,21,6,3,72,33,39,69
FC Midtjylla,1234,2,18,5,7,63,43,20,59
FC Nords,1234,3,14,6,10,76,55,21,48
Copenhagen,1234,4,14,6,10,58,43,15,48
AaB,1234,5,9,13,8,39,40,-1,40
Sonderjyske,1234,6,8,6,10,28,29,-1,30
AC Horsens,1234,7,5,14,11,32,52,-20,29
Lyngby,1234,8,4,9,11,27,44,-17,21
Randers FC,1234,9,5,6,13,23,40,-17,21
Silkeborg IF,1234,10,6,3,13,27,45,-18,21
AGF Aarhus,1234,11,4,6,12,17,38,-21,18
Brondby,1235,1,22,5,3,68,27,41,71
FC Midtjylla,1235,2,18,6,6,61,42,19,60
FC Nords,1235,3,15,7,8,78,49,29,52
Copenhagen,1235,4,12,8,10,56,45,11,44
AaB,1235,5,7,13,10,36,42,-6,34
Sonderjyske,1235,6,8,6,10,28,29,-1,30
AC Horsens,1235,7,5,15,10,31,51,-20,30
Randers FC,1235,8,5,7,12,24,40,-16,22
AGF Aarhus,1235,9,5,6,11,18,37,-19,21
Lyngby,1235,10,3,10,11,27,45,-18,19
Silkeborg IF,1235,11,5,3,14,26,46,-20,18
Brondby,1236,1,20,7,3,67,32,35,67
FC Midtjylla,1236,2,20,5,5,69,41,28,65
Copenhagen,1236,3,15,5,10,63,43,20,50
FC Nords,1236,4,14,7,9,71,52,19,49
AaB,1236,5,7,11,12,35,44,-9,32
AC Horsens,1236,6,6,13,11,33,52,-19,31
Sonderjyske,1236,7,8,6,10,28,29,-1,30
Randers FC,1236,8,6,6,12,25,40,-15,24
Silkeborg IF,1236,9,5,4,13,25,44,-19,19
AGF Aarhus,1236,10,4,7,11,16,36,-20,19
Lyngby,1236,11,3,9,12,27,46,-19,18
Brondby,1237,1,19,8,3,71,35,36,65
FC Midtjylla,1237,2,18,6,6,61,39,22,60
FC Nords,1237,3,16,6,8,81,52,29,54
Copenhagen,1237,4,14,6,10,57,45,12,48
AaB,1237,5,7,12,11,35,44,-9,33
AC Horsens,1237,6,6,14,10,38,54,-16,32
Sonderjyske,1237,7,8,6,10,28,29,-1,30
Randers FC,1237,8,5,7,12,24,40,-16,22
Lyngby,1237,9,3,10,11,27,45,-18,19
Silkeborg IF,1237,10,5,4,13,26,45,-19,19
AGF Aarhus,1237,11,4,7,11,17,37,-20,19
Brondby,1238,1,22,5,3,73,33,40,71
FC Midtjylla,1238,2,19,4,7,63,43,20,61
FC Nords,1238,3,15,6,9,75,50,25,51
Copenhagen,1238,4,14,4,12,56,45,11,46
AaB,1238,5,8,12,10,41,42,-1,36
AC Horsens,1238,6,6,13,11,34,55,-21,31
Sonderjyske,1238,7,8,6,10,28,29,-1,30
Lyngby,1238,8,4,9,11,28,44,-16,21
Randers FC,1238,9,5,6,13,23,41,-18,21
Silkeborg IF,1238,10,5,4,13,26,45,-19,19
AGF Aarhus,1238,11,4,7,11,17,37,-20,19
Brondby,1239,1,21,6,3,75,33,42,69
FC Midtjylla,1239,2,19,4,7,64,43,21,61
FC Nords,1239,3,16,7,7,79,50,29,55
Copenhagen,1239,4,14,5,11,56,44,12,47
AaB,1239,5,7,13,10,38,44,-6,34
Sonderjyske,1239,6,8,6,10,28,29,-1,30
AC Horsens,1239,7,5,13,12,31,55,-24,28
Lyngby,1239,8,4,9,11,27,44,-17,21
Randers FC,1239,9,5,6,13,23,40,-17,21
Silkeborg IF,1239,10,6,3,13,26,44,-18,21
AGF Aarhus,1239,11,4,6,12,16,37,-21,18
FC Midtjylla,1240,1,21,4,5,64,36,28,67
Brondby,1240,2,20,6,4,69,33,36,66
FC Nords,1240,3,16,7,7,77,48,29,55
Copenhagen,1240,4,14,5,11,57,45,12,47
Sonderjyske,1240,5,8,6,10,28,29,-1,30
AaB,1240,6,6,12,12,34,44,-10,30
AC Horsens,1240,7,6,12,12,36,57,-21,30
Lyngby,1240,8,4,9,11,29,45,-16,21
Randers FC,1240,9,5,6,13,24,42,-18,21
Silkeborg IF,1240,10,5,4,13,25,44,-19,19
AGF Aarhus,1240,11,4,7,11,16,36,-20,19
Brondby,1241,1,21,5,4,75,35,40,68
FC Midtjylla,1241,2,18,4,8,65,47,18,58
FC Nords,1241,3,14,8,8,71,47,24,50
Copenhagen,1241,4,14,5,11,58,47,11,47
AC Horsens,1241,5,7,15,8,37,48,-11,36
AaB,1241,6,7,13,10,37,45,-8,34
Sonderjyske,1241,7,8,6,10,28,29,-1,30
Randers FC,1241,8,5,7,12,25,41,-16,22
Silkeborg IF,1241,9,6,3,13,27,44,-17,21
Lyngby,1241,10,3,10,11,28,46,-18,19
AGF Aarhus,1241,11,4,6,12,16,38,-22,18
Brondby,1242,1,20,7,3,74,36,38,67
FC Midtjylla,1242,2,19,5,6,65,39,26,62
Copenhagen,1242,3,16,5,9,65,41,24,53
FC Nords,1242,4,13,8,9,71,53,18,47
AaB,1242,5,7,13,10,37,46,-9,34
Sonderjyske,1242,6,8,6,10,28,29,-1,30
AC Horsens,1242,7,5,14,11,34,57,-23,29
Randers FC,1242,8,6,6,12,25,40,-15,24
Silkeborg IF,1242,9,6,3,13,27,45,-18,21
Lyngby,1242,10,3,9,12,27,46,-19,18
AGF Aarhus,1242,11,4,6,12,17,38,-21,18
Brondby,1243,1,22,6,2,78,30,48,72
FC Midtjylla,1243,2,18,6,6,67,43,24,60
FC Nords,1243,3,14,6,10,69,58,11,48
Copenhagen,1243,4,13,5,12,55,45,10,44
AaB,1243,5,9,12,9,41,44,-3,39
AC Horsens,1243,6,6,13,11,35,51,-16,31
Sonderjyske,1243,7,8,6,10,28,29,-1,30
Lyngby,1243,8,4,9,11,29,45,-16,21
Silkeborg IF,1243,9,6,3,13,26,44,-18,21
Randers FC,1243,10,5,6,13,24,42,-18,21
AGF Aarhus,1243,11,4,6,12,16,37,-21,18
FC Midtjylla,1244,1,20,6,4,65,35,30,66
Brondby,1244,2,19,7,4,65,35,30,64
FC Nords,1244,3,13,8,9,70,52,18,47
Copenhagen,1244,4,14,4,12,62,44,18,46
AaB,1244,5,9,11,10,37,43,-6,38
AC Horsens,1244,6,7,12,11,36,52,-16,33
Sonderjyske,1244,7,8,6,10,28,29,-1,30
Randers FC,1244,8,6,6,12,25,40,-15,24
Silkeborg IF,1244,9,6,3,13,27,44,-17,21
Lyngby,1244,10,3,9,12,27,46,-19,18
AGF Aarhus,1244,11,4,6,12,16,38,-22,18
Brondby,1245,1,23,5,2,77,34,43,74
FC Midtjylla,1245,2,20,4,6,63,40,23,64
Copenhagen,1245,3,14,4,12,60,49,11,46
FC Nords,1245,4,12,8,10,71,53,18,44
AaB,1245,5,7,13,10,38,42,-4,34
AC Horsens,1245,6,6,14,10,37,54,-17,32
Sonderjyske,1245,7,8,6,10,28,29,-1,30
Lyngby,1245,8,4,9,11,29,46,-17,21
Randers FC,1245,9,5,6,13,25,42,-17,21
Silkeborg IF,1245,10,5,4,13,26,45,-19,19
AGF Aarhus,1245,11,4,7,11,17,37,-20,19
Brondby,1246,1,20,5,5,67,32,35,65
FC Midtjylla,1246,2,20,5,5,66,38,28,65
Copenhagen,1246,3,16,4,10,59,43,16,52
FC Nords,1246,4,14,8,8,74,48,26,50
AaB,1246,5,8,12,10,37,43,-6,36
Sonderjyske,1246,6,8,6,10,28,29,-1,30
AC Horsens,1246,7,5,12,13,31,56,-25,27
Randers FC,1246,8,5,7,12,23,39,-16,22
Silkeborg IF,1246,9,6,3,13,26,44,-18,21
Lyngby,1246,10,3,10,11,26,44,-18,19
AGF Aarhus,1246,11,4,6,12,16,37,-21,18
FC Midtjylla,1247,1,21,4,5,67,40,27,67
Brondby,1247,2,20,6,4,72,33,39,66
Copenhagen,1247,3,15,5,10,58,41,17,50
FC Nords,1247,4,13,8,9,71,53,18,47
AC Horsens,1247,5,6,14,10,36,53,-17,32
AaB,1247,6,6,13,11,35,45,-10,31
Sonderjyske,1247,7,8,6,10,28,29,-1,30
Randers FC,1247,8,5,7,12,24,40,-16,22
AGF Aarhus,1247,9,5,6,11,17,36,-19,21
Lyngby,1247,10,3,10,11,27,45,-18,19
Silkeborg IF,1247,11,5,3,14,25,45,-20,18
Brondby,1248,1,21,6,3,72,34,38,69
FC Midtjylla,1248,2,19,7,4,67,39,28,64
FC Nords,1248,3,13,8,9,73,54,19,47
Copenhagen,1248,4,12,7,11,54,47,7,43
AaB,1248,5,7,13,10,41,44,-3,34
AC Horsens,1248,6,6,15,9,37,52,-15,33
Sonderjyske,1248,7,8,6,10,28,29,-1,30
Lyngby,1248,8,4,9,11,28,44,-16,21
Randers FC,1248,9,5,6,13,23,41,-18,21
AGF Aarhus,1248,10,5,6,11,18,37,-19,21
Silkeborg IF,1248,11,5,3,14,26,46,-20,18
FC Midtjylla,1249,1,21,5,4,67,38,29,68
Brondby,1249,2,20,6,4,68,32,36,66
FC Nords,1249,3,15,6,9,74,52,22,51
Copenhagen,1249,4,13,5,12,56,45,11,44
AC Horsens,1249,5,8,13,9,37,49,-12,37
Sonderjyske,1249,6,8,6,10,28,29,-1,30
AaB,1249,7,6,11,13,37,49,-12,29
Randers FC,1249,8,6,6,12,25,39,-14,24
Silkeborg IF,1249,9,5,4,13,25,44,-19,19
AGF Aarhus,1249,10,4,7,11,16,36,-20,19
Lyngby,1249,11,3,9,12,26,46,-20,18
Brondby,1250,1,21,5,4,69,34,35,68
FC Midtjylla,1250,2,20,5,5,66,38,28,65
FC Nords,1250,3,14,7,9,71,49,22,49
Copenhagen,1250,4,13,6,11,58,45,13,45
AaB,1250,5,8,14,8,39,40,-1,38
Sonderjyske,1250,6,8,6,10,28,29,-1,30
AC Horsens,1250,7,5,13,12,35,58,-23,28
Lyngby,1250,8,4,9,11,27,44,-17,21
Randers FC,1250,9,5,6,13,23,40,-17,21
AGF Aarhus,1250,10,5,6,11,18,36,-18,21
Silkeborg IF,1250,11,5,3,14,25,46,-21,18
Brondby,1251,1,22,5,3,70,31,39,71
FC Midtjylla,1251,2,19,4,7,61,39,22,61
Copenhagen,1251,3,15,5,10,61,43,18,50
FC Nords,1251,4,14,6,10,75,49,26,48
AC Horsens,1251,5,7,13,10,35,56,-21,34
AaB,1251,6,7,11,12,35,45,-10,32
Sonderjyske,1251,7,8,6,10,28,29,-1,30
Randers FC,1251,8,6,6,12,27,39,-12,24
Silkeborg IF,1251,9,6,3,13,27,45,-18,21
AGF Aarhus,1251,10,4,6,12,17,38,-21,18
Lyngby,1251,11,3,9,12,26,48,-22,18
FC Midtjylla,1252,1,20,5,5,68,35,33,65
Brondby,1252,2,19,7,4,67,34,33,64
FC Nords,1252,3,14,7,9,75,55,20,49
Copenhagen,1252,4,13,6,11,57,45,12,45
AaB,1252,5,8,13,9,40,44,-4,37
AC Horsens,1252,6,6,14,10,36,56,-20,32
Sonderjyske,1252,7,8,6,10,28,29,-1,30
Lyngby,1252,8,4,9,11,27,44,-17,21
Randers FC,1252,9,5,6,13,23,40,-17,21
Silkeborg IF,1252,10,5,4,13,27,46,-19,19
AGF Aarhus,1252,11,4,7,11,18,38,-20,19
Brondby,1253,1,20,5,5,71,36,35,65
FC Midtjylla,1253,2,19,5,6,65,40,25,62
FC Nords,1253,3,14,9,7,71,47,24,51
Copenhagen,1253,4,14,7,9,59,44,15,49
AaB,1253,5,6,14,10,35,43,-8,32
AC Horsens,1253,6,6,14,10,32,49,-17,32
Sonderjyske,1253,7,8,6,10,28,29,-1,30
Randers FC,1253,8,6,6,12,25,39,-14,24
Silkeborg IF,1253,9,6,3,13,27,45,-18,21
Lyngby,1253,10,3,9,12,26,46,-20,18
AGF Aarhus,1253,11,4,6,12,17,38,-21,18
FC Midtjylla,1254,1,21,4,5,68,36,32,67
Brondby,1254,2,19,6,5,68,36,32,63
FC Nords,1254,3,14,8,8,76,51,25,50
Copenhagen,1254,4,13,5,12,56,47,9,44
AaB,1254,5,8,13,9,38,41,-3,37
AC Horsens,1254,6,6,14,10,33,54,-21,32
Sonderjyske,1254,7,8,6,10,28,29,-1,30
Randers FC,1254,8,5,7,12,24,40,-16,22
Lyngby,1254,9,3,10,11,27,45,-18,19
Silkeborg IF,1254,10,5,4,13,26,45,-19,19
AGF Aarhus,1254,11,4,7,11,17,37,-20,19
Brondby,1255,1,22,6,2,80,31,49,72
FC Midtjylla,1255,2,19,4,7,65,40,25,61
FC Nords,1255,3,14,7,9,76,55,21,49
Copenhagen,1255,4,13,6,11,56,47,9,45
AaB,1255,5,9,11,10,39,47,-8,38
Sonderjyske,1255,6,8,6,10,28,29,-1,30
AC Horsens,1255,7,6,12,12,33,55,-22,30
Randers FC,1255,8,6,6,12,25,39,-14,24
AGF Aarhus,1255,9,5,6,11,19,37,-18,21
Lyngby,1255,10,3,9,12,26,46,-20,18
Silkeborg IF,1255,11,5,3,14,26,47,-21,18
Brondby,1256,1,21,5,4,71,38,33,68
FC Midtjylla,1256,2,19,5,6,62,35,27,62
Copenhagen,1256,3,15,4,11,59,41,18,49
FC Nords,1256,4,13,6,11,70,53,17,45
AaB,1256,5,8,12,10,35,42,-7,36
AC Horsens,1256,6,7,14,9,34,48,-14,35
Sonderjyske,1256,7,8,6,10,28,29,-1,30
Randers FC,1256,8,6,6,12,24,39,-15,24
AGF Aarhus,1256,9,5,6,11,18,37,-19,21
Lyngby,1256,10,3,9,12,26,45,-19,18
Silkeborg IF,1256,11,5,3,14,26,46,-20,18
FC Midtjylla,1257,1,21,5,4,65,36,29,68
Brondby,1257,2,20,6,4,68,34,34,66
FC Nords,1257,3,15,6,9,76,52,24,51
Copenhagen,1257,4,14,5,11,56,43,13,47
AaB,1257,5,7,13,10,37,43,-6,34
Sonderjyske,1257,6,8,6,10,28,29,-1,30
AC Horsens,1257,7,5,13,12,30,50,-20,28
Lyngby,1257,8,4,9,11,27,44,-17,21
Randers FC,1257,9,5,6,13,23,40,-17,21
AGF Aarhus,1257,10,5,6,11,18,36,-18,21
Silkeborg IF,1257,11,5,3,14,25,46,-21,18
Brondby,1258,1,19,7,4,67,34,33,64
FC Midtjylla,1258,2,20,4,6,62,37,25,64
Copenhagen,1258,3,16,4,10,62,43,19,52
FC Nords,1258,4,13,7,10,70,53,17,46
AaB,1258,5,9,11,10,40,40,0,38
AC Horsens,1258,6,6,13,11,33,53,-20,31
Sonderjyske,1258,7,8,6,10,28,29,-1,30
Randers FC,1258,8,6,6,12,26,40,-14,24
Silkeborg IF,1258,9,5,4,13,28,47,-19,19
AGF Aarhus,1258,10,4,7,11,19,39,-20,19
Lyngby,1258,11,3,9,12,27,47,-20,18
Brondby,1259,1,22,5,3,72,31,41,71
FC Midtjylla,1259,2,20,5,5,66,37,29,65
Copenhagen,1259,3,14,5,11,61,46,15,47
FC Nords,1259,4,13,6,11,72,62,10,45
AaB,1259,5,8,11,11,42,43,-1,35
AC Horsens,1259,6,7,12,11,36,56,-20,33
Sonderjyske,1259,7,8,6,10,28,29,-1,30
Lyngby,1259,8,4,9,11,29,44,-15,21
AGF Aarhus,1259,9,5,6,11,21,37,-16,21
Randers FC,1259,10,5,6,13,23,42,-19,21
Silkeborg IF,1259,11,5,3,14,26,49,-23,18
Brondby,1260,1,21,6,3,73,31,42,69
FC Midtjylla,1260,2,20,6,4,69,41,28,66
FC Nords,1260,3,14,7,9,75,51,24,49
Copenhagen,1260,4,14,4,12,55,44,11,46
AaB,1260,5,8,12,10,37,41,-4,36
Sonderjyske,1260,6,8,6,10,28,29,-1,30
AC Horsens,1260,7,5,13,12,33,60,-27,28
Randers FC,1260,8,5,7,12,23,39,-16,22
Silkeborg IF,1260,9,6,3,13,27,44,-17,21
Lyngby,1260,10,3,10,11,26,44,-18,19
AGF Aarhus,1260,11,4,6,12,16,38,-22,18
Brondby,1261,1,21,6,3,73,31,42,69
FC Midtjylla,1261,2,17,5,8,59,44,15,56
Copenhagen,1261,3,16,4,10,60,46,14,52
FC Nords,1261,4,15,6,9,74,51,23,51
AC Horsens,1261,5,7,13,10,38,50,-12,34
AaB,1261,6,7,12,11,37,45,-8,33
Sonderjyske,1261,7,8,6,10,28,29,-1,30
Lyngby,1261,8,4,9,11,27,44,-17,21
Silkeborg IF,1261,8,6,3,13,27,44,-17,21
Randers FC,1261,10,5,6,13,23,40,-17,21
AGF Aarhus,1261,11,4,6,12,16,38,-22,18
Brondby,1262,1,21,7,2,73,31,42,70
FC Midtjylla,1262,2,19,4,7,66,47,19,61
FC Nords,1262,3,16,6,8,78,51,27,54
Copenhagen,1262,4,14,5,11,56,44,12,47
AC Horsens,1262,5,7,13,10,41,57,-16,34
Sonderjyske,1262,6,8,6,10,28,29,-1,30
AaB,1262,7,6,11,13,33,43,-10,29
Randers FC,1262,8,6,6,12,25,40,-15,24
Silkeborg IF,1262,9,6,3,13,27,44,-17,21
Lyngby,1262,10,3,9,12,27,46,-19,18
AGF Aarhus,1262,11,4,6,12,16,38,-22,18
Brondby,1263,1,21,7,2,68,29,39,70
FC Midtjylla,1263,2,19,4,7,67,43,24,61
Copenhagen,1263,3,15,5,10,60,40,20,50
FC Nords,1263,4,14,6,10,69,53,16,48
AaB,1263,5,9,11,10,38,42,-4,38
Sonderjyske,1263,6,8,6,10,28,29,-1,30
AC Horsens,1263,7,5,13,12,30,51,-21,28
Lyngby,1263,8,4,9,11,27,44,-17,21
Randers FC,1263,9,5,6,13,23,40,-17,21
Silkeborg IF,1263,10,6,3,13,27,45,-18,21
AGF Aarhus,1263,11,4,6,12,17,38,-21,18
Brondby,1264,1,21,5,4,71,35,36,68
FC Midtjylla,1264,2,20,4,6,70,38,32,64
Copenhagen,1264,3,16,5,9,59,41,18,53
FC Nords,1264,4,13,6,11,74,61,13,45
AaB,1264,5,7,12,11,35,45,-10,33
AC Horsens,1264,6,7,12,11,38,53,-15,33
Sonderjyske,1264,7,8,6,10,28,29,-1,30
Lyngby,1264,8,4,9,11,28,44,-16,21
Randers FC,1264,9,5,6,13,23,41,-18,21
AGF Aarhus,1264,10,5,6,11,19,37,-18,21
Silkeborg IF,1264,11,5,3,14,26,47,-21,18
Brondby,1265,1,21,6,3,70,32,38,69
FC Midtjylla,1265,2,20,5,5,64,35,29,65
FC Nords,1265,3,14,6,10,75,56,19,48
Copenhagen,1265,4,14,6,10,59,45,14,48
AC Horsens,1265,5,6,15,9,36,50,-14,33
Sonderjyske,1265,6,8,6,10,28,29,-1,30
AaB,1265,7,6,12,12,33,45,-12,30
Lyngby,1265,8,4,9,11,28,45,-17,21
Randers FC,1265,9,5,6,13,24,41,-17,21
AGF Aarhus,1265,10,5,6,11,17,36,-19,21
Silkeborg IF,1265,11,5,3,14,25,45,-20,18
Brondby,1266,1,21,5,4,74,32,42,68
FC Midtjylla,1266,2,20,4,6,67,37,30,64
FC Nords,1266,3,15,7,8,74,49,25,52
Copenhagen,1266,4,14,5,11,58,45,13,47
AC Horsens,1266,5,7,12,11,34,55,-21,33
AaB,1266,6,6,13,11,36,51,-15,31
Sonderjyske,1266,7,8,6,10,28,29,-1,30
Randers FC,1266,8,5,7,12,23,39,-16,22
Lyngby,1266,9,3,10,11,26,44,-18,19
Silkeborg IF,1266,10,5,4,13,26,45,-19,19
AGF Aarhus,1266,11,4,7,11,17,37,-20,19
Brondby,1267,1,20,7,3,68,31,37,67
FC Midtjylla,1267,2,19,4,7,67,43,24,61
FC Nords,1267,3,15,7,8,74,50,24,52
Copenhagen,1267,4,15,4,11,61,48,13,49
AC Horsens,1267,5,8,12,10,37,51,-14,36
Sonderjyske,1267,6,8,6,10,28,29,-1,30
AaB,1267,7,6,12,12,38,48,-10,30
Randers FC,1267,8,5,7,12,24,40,-16,22
Lyngby,1267,9,3,10,11,27,45,-18,19
Silkeborg IF,1267,10,5,4,13,26,45,-19,19
AGF Aarhus,1267,11,4,7,11,17,37,-20,19
Brondby,1268,1,21,5,4,69,30,39,68
FC Midtjylla,1268,2,19,4,7,64,40,24,61
Copenhagen,1268,3,17,4,9,60,41,19,55
FC Nords,1268,4,14,6,10,74,56,18,48
AaB,1268,5,9,11,10,45,43,2,38
Sonderjyske,1268,6,8,6,10,28,29,-1,30
AC Horsens,1268,7,5,12,13,32,60,-28,27
Randers FC,1268,8,5,7,12,24,40,-16,22
Silkeborg IF,1268,9,6,3,13,28,44,-16,21
Lyngby,1268,10,3,10,11,27,45,-18,19
AGF Aarhus,1268,11,4,6,12,16,39,-23,18
Brondby,1269,1,21,6,3,70,31,39,69
FC Midtjylla,1269,2,18,5,7,62,44,18,59
FC Nords,1269,3,14,7,9,70,47,23,49
Copenhagen,1269,4,15,4,11,56,39,17,49
AaB,1269,5,7,13,10,34,41,-7,34
AC Horsens,1269,6,7,13,10,39,55,-16,34
Sonderjyske,1269,7,8,6,10,28,29,-1,30
Randers FC,1269,8,6,6,12,25,39,-14,24
Silkeborg IF,1269,9,6,3,13,27,44,-17,21
Lyngby,1269,10,3,9,12,26,46,-20,18
AGF Aarhus,1269,11,4,6,12,16,38,-22,18
FC Midtjylla,1270,1,21,4,5,74,39,35,67
Brondby,1270,2,20,6,4,72,33,39,66
FC Nords,1270,3,14,8,8,73,53,20,50
Copenhagen,1270,4,14,6,10,52,39,13,48
AaB,1270,5,7,12,11,33,45,-12,33
Sonderjyske,1270,6,8,6,10,28,29,-1,30
AC Horsens,1270,7,6,12,12,35,56,-21,30
Lyngby,1270,8,4,9,11,29,45,-16,21
Silkeborg IF,1270,9,6,3,13,27,44,-17,21
Randers FC,1270,10,5,6,13,24,42,-18,21
AGF Aarhus,1270,11,4,6,12,16,38,-22,18
Brondby,1271,1,19,7,4,70,36,34,64
FC Midtjylla,1271,2,19,6,5,64,37,27,63
Copenhagen,1271,3,14,5,11,55,42,13,47
FC Nords,1271,4,12,8,10,72,58,14,44
AC Horsens,1271,5,8,14,8,38,49,-11,38
AaB,1271,6,8,12,10,37,40,-3,36
Sonderjyske,1271,7,8,6,10,28,29,-1,30
Lyngby,1271,8,4,9,11,28,44,-16,21
Randers FC,1271,9,5,6,13,23,41,-18,21
AGF Aarhus,1271,10,5,6,11,17,36,-19,21
Silkeborg IF,1271,11,5,3,14,25,45,-20,18
FC Midtjylla,1272,1,21,4,5,76,38,38,67
Brondby,1272,2,18,7,5,66,34,32,61
FC Nords,1272,3,16,6,8,72,47,25,54
Copenhagen,1272,4,13,6,11,55,48,7,45
AC Horsens,1272,5,7,14,9,37,51,-14,35
AaB,1272,6,6,13,11,34,48,-14,31
Sonderjyske,1272,7,8,6,10,28,29,-1,30
Lyngby,1272,8,4,9,11,28,45,-17,21
Randers FC,1272,9,5,6,13,24,41,-17,21
AGF Aarhus,1272,10,5,6,11,17,36,-19,21
Silkeborg IF,1272,11,5,3,14,25,45,-20,18
Brondby,1273,1,21,6,3,72,32,40,69
FC Midtjylla,1273,2,18,6,6,66,40,26,60
FC Nords,1273,3,13,9,8,70,49,21,48
Copenhagen,1273,4,14,5,11,55,43,12,47
AaB,1273,5,8,13,9,39,39,0,37
AC Horsens,1273,6,6,13,11,32,57,-25,31
Sonderjyske,1273,7,8,6,10,28,29,-1,30
Lyngby,1273,8,4,9,11,28,44,-16,21
Randers FC,1273,9,5,6,13,23,41,-18,21
Silkeborg IF,1273,10,5,4,13,25,44,-19,19
AGF Aarhus,1273,11,4,7,11,16,36,-20,19
FC Midtjylla,1274,1,21,4,5,70,34,36,67
Brondby,1274,2,19,7,4,72,37,35,64
FC Nords,1274,3,14,7,9,70,50,20,49
Copenhagen,1274,4,13,6,11,55,45,10,45
AaB,1274,5,9,12,9,41,45,-4,39
Sonderjyske,1274,6,8,6,10,28,29,-1,30
AC Horsens,1274,7,5,14,11,34,57,-23,29
Randers FC,1274,8,5,7,12,25,41,-16,22
Lyngby,1274,9,3,10,11,28,46,-18,19
Silkeborg IF,1274,10,5,4,13,25,44,-19,19
AGF Aarhus,1274,11,4,7,11,16,36,-20,19
Brondby,1275,1,21,5,4,72,32,40,68
FC Midtjylla,1275,2,20,5,5,66,37,29,65
FC Nords,1275,3,15,7,8,77,52,25,52
Copenhagen,1275,4,13,7,10,58,45,13,46
AaB,1275,5,6,13,11,35,46,-11,31
AC Horsens,1275,6,6,13,11,34,56,-22,31
Sonderjyske,1275,7,8,6,10,28,29,-1,30
Randers FC,1275,8,5,7,12,25,41,-16,22
Silkeborg IF,1275,9,6,3,13,29,45,-16,21
Lyngby,1275,10,3,10,11,28,46,-18,19
AGF Aarhus,1275,11,4,6,12,17,40,-23,18
Brondby,1276,1,22,6,2,73,29,44,72
FC Midtjylla,1276,2,21,4,5,68,40,28,67
FC Nords,1276,3,13,7,10,69,52,17,46
Copenhagen,1276,4,13,4,13,57,48,9,43
AC Horsens,1276,5,8,12,10,37,55,-18,36
AaB,1276,6,7,11,12,35,41,-6,32
Sonderjyske,1276,7,8,6,10,28,29,-1,30
Lyngby,1276,8,4,9,11,27,44,-17,21
Randers FC,1276,9,5,6,13,23,40,-17,21
Silkeborg IF,1276,10,5,4,13,25,44,-19,19
AGF Aarhus,1276,11,4,7,11,16,36,-20,19
FC Midtjylla,1277,1,20,4,6,73,45,28,64
Brondby,1277,2,19,5,6,69,37,32,62
Copenhagen,1277,3,15,5,10,57,42,15,50
FC Nords,1277,4,14,6,10,73,56,17,48
AaB,1277,5,9,12,9,38,39,-1,39
AC Horsens,1277,6,6,14,10,35,52,-17,32
Sonderjyske,1277,7,8,6,10,28,29,-1,30
Randers FC,1277,8,5,7,12,24,40,-16,22
AGF Aarhus,1277,9,5,6,11,18,37,-19,21
Lyngby,1277,10,3,10,11,27,45,-18,19
Silkeborg IF,1277,11,5,3,14,26,46,-20,18
Brondby,1278,1,21,7,2,73,32,41,70
FC Midtjylla,1278,2,18,6,6,63,41,22,60
FC Nords,1278,3,15,7,8,75,50,25,52
Copenhagen,1278,4,14,5,11,56,45,11,47
AaB,1278,5,8,13,9,36,38,-2,37
Sonderjyske,1278,6,8,6,10,28,29,-1,30
AC Horsens,1278,7,5,12,13,35,58,-23,27
Lyngby,1278,8,4,9,11,28,44,-16,21
Randers FC,1278,9,5,6,13,23,41,-18,21
Silkeborg IF,1278,10,5,4,13,26,45,-19,19
AGF Aarhus,1278,11,4,7,11,17,37,-20,19
Brondby,1279,1,21,7,2,68,30,38,70
FC Midtjylla,1279,2,20,4,6,65,40,25,64
Copenhagen,1279,3,14,7,9,63,42,21,49
FC Nords,1279,4,12,7,11,68,52,16,43
AaB,1279,5,8,11,11,36,46,-10,35
AC Horsens,1279,6,6,14,10,34,50,-16,32
Sonderjyske,1279,7,8,6,10,28,29,-1,30
Lyngby,1279,8,4,9,11,31,44,-13,21
AGF Aarhus,1279,9,5,6,11,19,38,-19,21
Randers FC,1279,10,5,6,13,23,44,-21,21
Silkeborg IF,1279,11,5,3,14,27,47,-20,18
Brondby,1280,1,22,6,2,76,32,44,72
FC Midtjylla,1280,2,20,5,5,65,36,29,65
Copenhagen,1280,3,14,5,11,57,49,8,47
FC Nords,1280,4,13,7,10,73,52,21,46
AaB,1280,5,7,11,12,37,45,-8,32
AC Horsens,1280,6,6,14,10,32,52,-20,32
Sonderjyske,1280,7,8,6,10,28,29,-1,30
Randers FC,1280,8,5,7,12,24,40,-16,22
Silkeborg IF,1280,9,6,3,13,31,45,-14,21
Lyngby,1280,10,3,10,11,27,45,-18,19
AGF Aarhus,1280,11,4,6,12,17,42,-25,18
Brondby,1281,1,22,6,2,84,33,51,72
FC Midtjylla,1281,2,21,4,5,69,42,27,67
FC Nords,1281,3,13,8,9,70,58,12,47
Copenhagen,1281,4,12,5,13,57,48,9,41
AaB,1281,5,7,13,10,39,48,-9,34
AC Horsens,1281,6,6,14,10,35,51,-16,32
Sonderjyske,1281,7,8,6,10,28,29,-1,30
Randers FC,1281,8,6,6,12,26,40,-14,24
AGF Aarhus,1281,9,5,6,11,17,36,-19,21
Lyngby,1281,10,3,9,12,27,47,-20,18
Silkeborg IF,1281,11,5,3,14,25,45,-20,18
Brondby,1282,1,22,5,3,73,31,42,71
FC Midtjylla,1282,2,20,4,6,66,41,25,64
FC Nords,1282,3,14,7,9,71,53,18,49
Copenhagen,1282,4,14,6,10,59,43,16,48
AaB,1282,5,7,11,12,35,45,-10,32
AC Horsens,1282,6,6,13,11,33,50,-17,31
Sonderjyske,1282,7,8,6,10,28,29,-1,30
Lyngby,1282,8,4,9,11,28,44,-16,21
Silkeborg IF,1282,9,6,3,13,27,44,-17,21
Randers FC,1282,10,5,6,13,23,41,-18,21
AGF Aarhus,1282,11,4,6,12,16,38,-22,18
Brondby,1283,1,21,6,3,70,30,40,69
FC Midtjylla,1283,2,20,6,4,65,35,30,66
FC Nords,1283,3,14,7,9,73,53,20,49
Copenhagen,1283,4,13,6,11,55,44,11,45
AC Horsens,1283,5,7,12,11,35,55,-20,33
AaB,1283,6,7,11,12,34,41,-7,32
Sonderjyske,1283,7,8,6,10,28,29,-1,30
Randers FC,1283,8,6,6,12,25,39,-14,24
Silkeborg IF,1283,9,6,3,13,27,45,-18,21
Lyngby,1283,10,3,9,12,26,46,-20,18
AGF Aarhus,1283,11,4,6,12,17,38,-21,18
Brondby,1284,1,21,6,3,75,31,44,69
FC Midtjylla,1284,2,17,6,7,60,40,20,57
FC Nords,1284,3,15,8,7,78,51,27,53
Copenhagen,1284,4,14,6,10,63,46,17,48
AaB,1284,5,8,12,10,42,50,-8,36
Sonderjyske,1284,6,8,6,10,28,29,-1,30
AC Horsens,1284,7,6,12,12,33,59,-26,30
Lyngby,1284,8,4,9,11,28,45,-17,21
Randers FC,1284,9,5,6,13,24,41,-17,21
AGF Aarhus,1284,10,5,6,11,19,37,-18,21
Silkeborg IF,1284,11,5,3,14,26,47,-21,18
Brondby,1285,1,22,6,2,72,27,45,72
FC Midtjylla,1285,2,20,4,6,65,41,24,64
FC Nords,1285,3,14,7,9,73,53,20,49
Copenhagen,1285,4,12,4,14,58,53,5,40
AaB,1285,5,8,11,11,36,42,-6,35
AC Horsens,1285,6,7,14,9,34,48,-14,35
Sonderjyske,1285,7,8,6,10,28,29,-1,30
Randers FC,1285,8,5,7,12,23,39,-16,22
Silkeborg IF,1285,9,6,3,13,27,45,-18,21
Lyngby,1285,10,3,10,11,26,44,-18,19
AGF Aarhus,1285,11,4,6,12,17,38,-21,18
Brondby,1286,1,20,7,3,67,30,37,67
FC Midtjylla,1286,2,19,5,6,64,41,23,62
FC Nords,1286,3,14,6,10,73,55,18,48
Copenhagen,1286,4,13,5,12,58,46,12,44
AC Horsens,1286,5,9,12,9,37,48,-11,39
AaB,1286,6,7,13,10,35,40,-5,34
Sonderjyske,1286,7,8,6,10,28,29,-1,30
Lyngby,1286,8,4,9,11,28,45,-17,21
Randers FC,1286,9,5,6,13,24,41,-17,21
Silkeborg IF,1286,10,5,4,13,26,45,-19,19
AGF Aarhus,1286,11,4,7,11,17,37,-20,19
Brondby,1287,1,22,5,3,75,34,41,71
FC Midtjylla,1287,2,19,5,6,67,44,23,62
FC Nords,1287,3,15,7,8,77,50,27,52
Copenhagen,1287,4,13,4,13,54,50,4,43
AC Horsens,1287,5,8,12,10,43,52,-9,36
AaB,1287,6,7,11,12,34,46,-12,32
Sonderjyske,1287,7,8,6,10,28,29,-1,30
Randers FC,1287,8,6,6,12,24,39,-15,24
Silkeborg IF,1287,9,5,4,13,25,44,-19,19
AGF Aarhus,1287,10,4,7,11,16,36,-20,19
Lyngby,1287,11,3,9,12,26,45,-19,18
Brondby,1288,1,21,6,3,78,39,39,69
FC Midtjylla,1288,2,17,5,8,63,48,15,56
Copenhagen,1288,3,17,4,9,63,41,22,55
FC Nords,1288,4,14,7,9,72,52,20,49
AaB,1288,5,7,12,11,37,45,-8,33
AC Horsens,1288,6,6,14,10,37,51,-14,32
Sonderjyske,1288,7,8,6,10,28,29,-1,30
Randers FC,1288,8,6,6,12,26,39,-13,24
Silkeborg IF,1288,9,6,3,13,27,45,-18,21
Lyngby,1288,10,3,9,12,26,47,-21,18
AGF Aarhus,1288,11,4,6,12,17,38,-21,18
Brondby,1289,1,22,5,3,69,29,40,71
FC Midtjylla,1289,2,18,7,5,63,38,25,61
Copenhagen,1289,3,15,6,9,60,44,16,51
FC Nords,1289,4,13,8,9,71,49,22,47
AaB,1289,5,6,14,10,34,43,-9,32
Sonderjyske,1289,6,8,6,10,28,29,-1,30
AC Horsens,1289,7,6,12,12,34,54,-20,30
Lyngby,1289,8,4,9,11,28,44,-16,21
Randers FC,1289,9,5,6,13,23,41,-18,21
AGF Aarhus,1289,10,5,6,11,19,37,-18,21
Silkeborg IF,1289,11,5,3,14,26,47,-21,18
Brondby,1290,1,19,7,4,64,30,34,64
FC Midtjylla,1290,2,19,7,4,63,37,26,64
FC Nords,1290,3,14,6,10,74,55,19,48
Copenhagen,1290,4,14,5,11,59,43,16,47
AaB,1290,5,8,13,9,41,42,-1,37
AC Horsens,1290,6,7,12,11,35,55,-20,33
Sonderjyske,1290,7,8,6,10,28,29,-1,30
Randers FC,1290,8,6,6,12,25,40,-15,24
Silkeborg IF,1290,9,6,3,13,28,45,-17,21
Lyngby,1290,10,3,9,12,27,46,-19,18
AGF Aarhus,1290,11,4,6,12,17,39,-22,18
FC Midtjylla,1291,1,21,5,4,68,36,32,68
Brondby,1291,2,20,6,4,69,34,35,66
FC Nords,1291,3,14,7,9,76,53,23,49
Copenhagen,1291,4,14,4,12,59,48,11,46
AaB,1291,5,7,13,10,40,46,-6,34
AC Horsens,1291,6,6,13,11,37,58,-21,31
Sonderjyske,1291,7,8,6,10,28,29,-1,30
Lyngby,1291,8,4,9,11,27,44,-17,21
Randers FC,1291,9,5,6,13,23,40,-17,21
AGF Aarhus,1291,10,5,6,11,19,38,-19,21
Silkeborg IF,1291,11,5,3,14,27,47,-20,18
Brondby,1292,1,22,5,3,72,33,39,71
FC Midtjylla,1292,2,20,6,4,71,41,30,66
FC Nords,1292,3,13,7,10,70,51,19,46
Copenhagen,1292,4,13,5,12,57,47,10,44
AaB,1292,5,7,13,10,39,43,-4,34
AC Horsens,1292,6,6,14,10,35,55,-20,32
Sonderjyske,1292,7,8,6,10,28,29,-1,30
Lyngby,1292,8,4,9,11,27,44,-17,21
Randers FC,1292,9,5,6,13,23,40,-17,21
Silkeborg IF,1292,10,5,4,13,26,45,-19,19
AGF Aarhus,1292,11,4,7,11,17,37,-20,19
FC Midtjylla,1293,1,20,4,6,65,42,23,64
Brondby,1293,2,19,6,5,66,36,30,63
Copenhagen,1293,3,15,5,10,67,44,23,50
FC Nords,1293,4,13,7,10,72,52,20,46
AaB,1293,5,9,13,8,41,41,0,40
AC Horsens,1293,6,6,13,11,34,56,-22,31
Sonderjyske,1293,7,8,6,10,28,29,-1,30
Randers FC,1293,8,6,6,12,28,40,-12,24
Silkeborg IF,1293,9,6,3,13,27,45,-18,21
AGF Aarhus,1293,10,4,6,12,17,38,-21,18
Lyngby,1293,11,3,9,12,27,49,-22,18
Brondby,1294,1,22,6,2,79,33,46,72
FC Midtjylla,1294,2,19,5,6,69,45,24,62
FC Nords,1294,3,15,6,9,77,54,23,51
Copenhagen,1294,4,13,4,13,59,55,4,43
AC Horsens,1294,5,7,13,10,36,53,-17,34
AaB,1294,6,7,12,11,36,42,-6,33
Sonderjyske,1294,7,8,6,10,28,29,-1,30
Lyngby,1294,8,4,9,11,27,44,-17,21
Silkeborg IF,1294,8,6,3,13,27,44,-17,21
Randers FC,1294,10,5,6,13,23,40,-17,21
AGF Aarhus,1294,11,4,6,12,16,38,-22,18
Brondby,1295,1,21,5,4,76,36,40,68
FC Midtjylla,1295,2,20,5,5,64,40,24,65
FC Nords,1295,3,13,7,10,72,51,21,46
Copenhagen,1295,4,14,4,12,57,48,9,46
AaB,1295,5,10,11,9,46,41,5,41
Sonderjyske,1295,6,8,6,10,28,29,-1,30
AC Horsens,1295,7,6,12,12,32,57,-25,30
Lyngby,1295,8,4,9,11,30,44,-14,21
Silkeborg IF,1295,9,6,3,13,28,45,-17,21
Randers FC,1295,10,5,6,13,23,43,-20,21
AGF Aarhus,1295,11,4,6,12,17,39,-22,18
Brondby,1296,1,22,5,3,74,33,41,71
FC Midtjylla,1296,2,21,4,5,65,36,29,67
FC Nords,1296,3,14,6,10,73,55,18,48
Copenhagen,1296,4,13,5,12,58,49,9,44
AaB,1296,5,8,12,10,36,40,-4,36
Sonderjyske,1296,6,8,6,10,28,29,-1,30
AC Horsens,1296,7,6,12,12,35,54,-19,30
Randers FC,1296,8,6,6,12,25,39,-14,24
Silkeborg IF,1296,9,5,4,13,27,46,-19,19
AGF Aarhus,1296,10,4,7,11,18,38,-20,19
Lyngby,1296,11,3,9,12,26,46,-20,18
Brondby,1297,1,20,6,4,67,34,33,66
FC Midtjylla,1297,2,17,7,6,61,40,21,58
FC Nords,1297,3,16,7,7,77,47,30,55
Copenhagen,1297,4,14,5,11,58,45,13,47
AC Horsens,1297,5,7,13,10,35,52,-17,34
AaB,1297,6,7,12,11,37,43,-6,33
Sonderjyske,1297,7,8,6,10,28,29,-1,30
Randers FC,1297,8,5,7,12,24,40,-16,22
Silkeborg IF,1297,9,6,3,13,28,44,-16,21
Lyngby,1297,10,3,10,11,27,45,-18,19
AGF Aarhus,1297,11,4,6,12,16,39,-23,18
Brondby,1298,1,20,6,4,73,30,43,66
FC Midtjylla,1298,2,20,5,5,66,42,24,65
FC Nords,1298,3,14,7,9,74,54,20,49
Copenhagen,1298,4,13,7,10,55,42,13,46
AaB,1298,5,7,13,10,36,44,-8,34
AC Horsens,1298,6,6,14,10,30,48,-18,32
Sonderjyske,1298,7,8,6,10,28,29,-1,30
Randers FC,1298,8,5,7,12,25,41,-16,22
Lyngby,1298,9,3,10,11,28,46,-18,19
Silkeborg IF,1298,10,5,4,13,25,44,-19,19
AGF Aarhus,1298,11,4,7,11,16,36,-20,19
Brondby,1299,1,20,5,5,70,34,36,65
FC Midtjylla,1299,2,19,4,7,66,41,25,61
FC Nords,1299,3,15,7,8,74,48,26,52
Copenhagen,1299,4,15,5,10,58,44,14,50
AaB,1299,5,8,11,11,38,46,-8,35
AC Horsens,1299,6,7,12,11,37,56,-19,33
Sonderjyske,1299,7,8,6,10,28,29,-1,30
Randers FC,1299,8,5,7,12,23,39,-16,22
AGF Aarhus,1299,9,5,6,11,17,36,-19,21
Lyngby,1299,10,3,10,11,26,44,-18,19
Silkeborg IF,1299,11,5,3,14,25,45,-20,18
Brondby,1300,1,21,6,3,70,30,40,69
FC Midtjylla,1300,2,19,6,5,66,37,29,63
FC Nords,1300,3,14,7,9,73,54,19,49
Copenhagen,1300,4,14,4,12,59,48,11,46
AaB,1300,5,7,13,10,34,42,-8,34
AC Horsens,1300,6,6,14,10,37,54,-17,32
Sonderjyske,1300,7,8,6,10,28,29,-1,30
Randers FC,1300,8,5,7,12,23,39,-16,22
Silkeborg IF,1300,9,6,3,13,28,45,-17,21
Lyngby,1300,10,3,10,11,26,44,-18,19
AGF Aarhus,1300,11,4,6,12,17,39,-22,18
Brondby,1301,1,19,7,4,69,35,34,64
FC Midtjylla,1301,2,18,5,7,61,41,20,59
FC Nords,1301,3,15,7,8,72,51,21,52
Copenhagen,1301,4,14,5,11,59,44,15,47
AC Horsens,1301,5,9,12,9,42,52,-10,39
AaB,1301,6,7,12,11,35,41,-6,33
Sonderjyske,1301,7,8,6,10,28,29,-1,30
Lyngby,1301,8,4,9,11,29,45,-16,21
Silkeborg IF,1301,9,6,3,13,27,45,-18,21
Randers FC,1301,10,5,6,13,24,42,-18,21
AGF Aarhus,1301,11,4,6,12,17,38,-21,18
FC Midtjylla,1302,1,21,4,5,66,38,28,67
Brondby,1302,2,19,5,6,68,34,34,62
FC Nords,1302,3,15,6,9,74,50,24,51
Copenhagen,1302,4,15,5,10,57,45,12,50
AaB,1302,5,8,11,11,38,44,-6,35
AC Horsens,1302,6,6,13,11,33,51,-18,31
Sonderjyske,1302,7,8,6,10,28,29,-1,30
Lyngby,1302,8,4,9,11,31,46,-15,21
Randers FC,1302,9,5,6,13,25,44,-19,21
Silkeborg IF,1302,10,5,4,13,26,45,-19,19
AGF Aarhus,1302,11,4,7,11,17,37,-20,19
Brondby,1303,1,21,6,3,74,31,43,69
FC Midtjylla,1303,2,19,4,7,64,43,21,61
FC Nords,1303,3,16,7,7,76,51,25,55
Copenhagen,1303,4,13,5,12,58,47,11,44
AC Horsens,1303,5,7,13,10,40,54,-14,34
AaB,1303,6,7,11,12,34,46,-12,32
Sonderjyske,1303,7,8,6,10,28,29,-1,30
Lyngby,1303,8,4,9,11,28,45,-17,21
Randers FC,1303,9,5,6,13,24,41,-17,21
Silkeborg IF,1303,10,6,3,13,26,44,-18,21
AGF Aarhus,1303,11,4,6,12,16,37,-21,18
Brondby,1304,1,20,6,4,67,32,35,66
FC Midtjylla,1304,2,19,6,5,62,38,24,63
Copenhagen,1304,3,15,6,9,61,40,21,51
FC Nords,1304,4,13,7,10,66,47,19,46
AaB,1304,5,8,11,11,37,45,-8,35
AC Horsens,1304,6,6,14,10,35,52,-17,32
Sonderjyske,1304,7,8,6,10,28,29,-1,30
Lyngby,1304,8,4,9,11,29,44,-15,21
Silkeborg IF,1304,9,6,3,13,26,44,-18,21
Randers FC,1304,10,5,6,13,23,42,-19,21
AGF Aarhus,1304,11,4,6,12,16,37,-21,18
Brondby,1305,1,20,7,3,72,33,39,67
FC Midtjylla,1305,2,20,5,5,70,44,26,65
FC Nords,1305,3,14,8,8,76,55,21,50
Copenhagen,1305,4,12,9,9,58,45,13,45
AaB,1305,5,7,13,10,38,44,-6,34
Sonderjyske,1305,6,8,6,10,28,29,-1,30
AC Horsens,1305,7,5,14,11,33,52,-19,29
Randers FC,1305,8,6,6,12,24,39,-15,24
Silkeborg IF,1305,9,5,4,13,25,44,-19,19
AGF Aarhus,1305,10,4,7,11,16,36,-20,19
Lyngby,1305,11,3,9,12,26,45,-19,18
Brondby,1306,1,21,6,3,74,33,41,69
FC Midtjylla,1306,2,19,4,7,63,41,22,61
Copenhagen,1306,3,15,5,10,63,46,17,50
FC Nords,1306,4,13,6,11,76,57,19,45
AaB,1306,5,9,11,10,37,42,-5,38
AC Horsens,1306,6,7,12,11,37,57,-20,33
Sonderjyske,1306,7,8,6,10,28,29,-1,30
Randers FC,1306,8,5,7,12,25,41,-16,22
Lyngby,1306,9,3,10,11,28,46,-18,19
Silkeborg IF,1306,10,5,4,13,26,45,-19,19
AGF Aarhus,1306,11,4,7,11,17,37,-20,19
Brondby,1307,1,20,7,3,69,32,37,67
FC Midtjylla,1307,2,19,5,6,66,44,22,62
Copenhagen,1307,3,16,5,9,64,44,20,53
FC Nords,1307,4,14,7,9,74,50,24,49
AaB,1307,5,7,12,11,37,45,-8,33
Sonderjyske,1307,6,8,6,10,28,29,-1,30
AC Horsens,1307,7,6,12,12,33,54,-21,30
Randers FC,1307,8,5,7,12,23,39,-16,22
AGF Aarhus,1307,9,5,6,11,18,37,-19,21
Lyngby,1307,10,3,10,11,26,44,-18,19
Silkeborg IF,1307,11,5,3,14,26,46,-20,18
Brondby,1308,1,22,6,2,74,27,47,72
FC Midtjylla,1308,2,20,5,5,62,38,24,65
FC Nords,1308,3,15,6,9,73,52,21,51
Copenhagen,1308,4,13,5,12,54,45,9,44
AaB,1308,5,8,12,10,39,43,-4,36
Sonderjyske,1308,6,8,6,10,28,29,-1,30
AC Horsens,1308,7,5,12,13,30,53,-23,27
Lyngby,1308,8,4,9,11,30,47,-17,21
Randers FC,1308,9,5,6,13,26,43,-17,21
Silkeborg IF,1308,10,6,3,13,26,44,-18,21
AGF Aarhus,1308,11,4,6,12,16,37,-21,18
FC Midtjylla,1309,1,21,5,4,70,39,31,68
Brondby,1309,2,19,6,5,69,37,32,63
Copenhagen,1309,3,14,7,9,57,42,15,49
FC Nords,1309,4,13,7,10,73,54,19,46
AaB,1309,5,8,12,10,37,41,-4,36
AC Horsens,1309,6,6,13,11,34,53,-19,31
Sonderjyske,1309,7,8,6,10,28,29,-1,30
Randers FC,1309,8,5,7,12,25,41,-16,22
Silkeborg IF,1309,9,6,3,13,28,45,-17,21
Lyngby,1309,10,3,10,11,28,46,-18,19
AGF Aarhus,1309,11,4,6,12,17,39,-22,18
Brondby,1310,1,20,7,3,71,33,38,67
FC Midtjylla,1310,2,18,5,7,62,43,19,59
FC Nords,1310,3,13,10,7,73,51,22,49
Copenhagen,1310,4,13,6,11,57,42,15,45
AaB,1310,5,7,14,9,36,42,-6,35
AC Horsens,1310,6,7,14,9,36,50,-14,35
Sonderjyske,1310,7,8,6,10,28,29,-1,30
Silkeborg IF,1310,8,6,3,13,28,44,-16,21
Lyngby,1310,9,4,9,11,27,44,-17,21
Randers FC,1310,10,5,6,13,23,40,-17,21
AGF Aarhus,1310,11,4,6,12,16,39,-23,18
Brondby,1311,1,20,6,4,67,31,36,66
FC Midtjylla,1311,2,19,5,6,65,40,25,62
FC Nords,1311,3,14,8,8,74,54,20,50
Copenhagen,1311,4,13,6,11,58,43,15,45
AaB,1311,5,8,12,10,39,44,-5,36
AC Horsens,1311,6,7,13,10,34,51,-17,34
Sonderjyske,1311,7,8,6,10,28,29,-1,30
Lyngby,1311,8,4,9,11,27,44,-17,21
Randers FC,1311,9,5,6,13,23,40,-17,21
AGF Aarhus,1311,10,5,6,11,18,36,-18,21
Silkeborg IF,1311,11,5,3,14,25,46,-21,18
Brondby,1312,1,18,8,4,69,38,31,62
FC Midtjylla,1312,2,18,6,6,59,36,23,60
Copenhagen,1312,3,16,5,9,63,43,20,53
FC Nords,1312,4,13,9,8,70,49,21,48
AaB,1312,5,7,14,9,35,40,-5,35
AC Horsens,1312,6,5,16,9,38,54,-16,31
Sonderjyske,1312,7,8,6,10,28,29,-1,30
Lyngby,1312,8,4,9,11,30,46,-16,21
Silkeborg IF,1312,9,6,3,13,27,44,-17,21
Randers FC,1312,10,5,6,13,25,43,-18,21
AGF Aarhus,1312,11,4,6,12,16,38,-22,18
Brondby,1313,1,21,6,3,72,36,36,69
FC Midtjylla,1313,2,19,5,6,68,43,25,62
FC Nords,1313,3,14,7,9,75,54,21,49
Copenhagen,1313,4,13,5,12,60,53,7,44
AC Horsens,1313,5,8,12,10,40,53,-13,36
AaB,1313,6,7,13,10,45,47,-2,34
Sonderjyske,1313,7,8,6,10,28,29,-1,30
Randers FC,1313,8,5,7,12,23,39,-16,22
Lyngby,1313,9,3,10,11,26,44,-18,19
Silkeborg IF,1313,10,5,4,13,26,45,-19,19
AGF Aarhus,1313,11,4,7,11,17,37,-20,19
Brondby,1314,1,22,5,3,75,36,39,71
FC Midtjylla,1314,2,18,5,7,63,40,23,59
FC Nords,1314,3,13,9,8,67,47,20,48
Copenhagen,1314,4,14,6,10,61,44,17,48
AC Horsens,1314,5,7,13,10,46,60,-14,34
AaB,1314,6,6,14,10,38,49,-11,32
Sonderjyske,1314,7,8,6,10,28,29,-1,30
Randers FC,1314,8,6,6,12,24,39,-15,24
Silkeborg IF,1314,9,6,3,13,26,44,-18,21
Lyngby,1314,10,3,9,12,26,45,-19,18
AGF Aarhus,1314,11,4,6,12,16,37,-21,18
Brondby,1315,1,20,6,4,74,37,37,66
FC Midtjylla,1315,2,19,5,6,61,41,20,62
FC Nords,1315,3,15,8,7,79,51,28,53
Copenhagen,1315,4,15,6,9,63,42,21,51
AaB,1315,5,7,12,11,35,43,-8,33
Sonderjyske,1315,6,8,6,10,28,29,-1,30
AC Horsens,1315,7,5,13,12,30,54,-24,28
Randers FC,1315,8,5,7,12,24,40,-16,22
Silkeborg IF,1315,9,6,3,13,27,45,-18,21
Lyngby,1315,10,3,10,11,27,45,-18,19
AGF Aarhus,1315,11,4,6,12,17,38,-21,18
Brondby,1316,1,21,6,3,73,33,40,69
FC Midtjylla,1316,2,18,6,6,62,39,23,60
FC Nords,1316,3,14,8,8,72,47,25,50
Copenhagen,1316,4,14,4,12,53,45,8,46
AC Horsens,1316,5,8,13,9,40,52,-12,37
AaB,1316,6,7,11,12,37,47,-10,32
Sonderjyske,1316,7,8,6,10,28,29,-1,30
Lyngby,1316,8,4,9,11,29,44,-15,21
Randers FC,1316,9,5,6,13,23,42,-19,21
Silkeborg IF,1316,10,5,4,13,25,44,-19,19
AGF Aarhus,1316,11,4,7,11,16,36,-20,19
FC Midtjylla,1317,1,21,4,5,67,36,31,67
Brondby,1317,2,19,6,5,67,35,32,63
FC Nords,1317,3,15,6,9,74,50,24,51
Copenhagen,1317,4,13,4,13,54,46,8,43
AaB,1317,5,9,12,9,36,38,-2,39
AC Horsens,1317,6,6,14,10,35,54,-19,32
Sonderjyske,1317,7,8,6,10,28,29,-1,30
Randers FC,1317,8,6,6,12,25,40,-15,24
Silkeborg IF,1317,9,6,3,13,29,44,-15,21
Lyngby,1317,10,3,9,12,27,46,-19,18
AGF Aarhus,1317,11,4,6,12,16,40,-24,18
Brondby,1318,1,20,8,2,69,32,37,68
FC Midtjylla,1318,2,19,4,7,65,41,24,61
Copenhagen,1318,3,15,6,9,63,42,21,51
FC Nords,1318,4,13,9,8,71,52,19,48
AaB,1318,5,6,14,10,34,44,-10,32
AC Horsens,1318,6,6,13,11,33,50,-17,31
Sonderjyske,1318,7,8,6,10,28,29,-1,30
Randers FC,1318,8,6,6,12,26,41,-15,24
Silkeborg IF,1318,9,5,4,13,26,45,-19,19
AGF Aarhus,1318,10,4,7,11,17,37,-20,19
Lyngby,1318,11,3,9,12,28,47,-19,18
Brondby,1319,1,19,6,5,68,35,33,63
FC Midtjylla,1319,2,18,6,6,61,37,24,60
FC Nords,1319,3,14,7,9,73,53,20,49
Copenhagen,1319,4,15,4,11,57,44,13,49
AaB,1319,5,8,14,8,36,37,-1,38
AC Horsens,1319,6,6,15,9,38,53,-15,33
Sonderjyske,1319,7,8,6,10,28,29,-1,30
Randers FC,1319,8,6,6,12,26,40,-14,24
Silkeborg IF,1319,9,6,3,13,29,47,-18,21
Lyngby,1319,10,3,9,12,27,47,-20,18
AGF Aarhus,1319,11,4,6,12,19,40,-21,18
Brondby,1320,1,21,6,3,77,35,42,69
FC Midtjylla,1320,2,19,6,5,65,41,24,63
Copenhagen,1320,3,15,5,10,64,49,15,50
FC Nords,1320,4,13,9,8,73,51,22,48
AaB,1320,5,6,13,11,35,45,-10,31
AC Horsens,1320,6,6,13,11,36,55,-19,31
Sonderjyske,1320,7,8,6,10,28,29,-1,30
Randers FC,1320,8,6,6,12,25,39,-14,24
Silkeborg IF,1320,9,6,3,13,27,45,-18,21
Lyngby,1320,10,3,9,12,26,46,-20,18
AGF Aarhus,1320,11,4,6,12,17,38,-21,18
FC Midtjylla,1321,1,21,4,5,72,38,34,67
Brondby,1321,2,20,6,4,71,36,35,66
FC Nords,1321,3,14,8,8,72,49,23,50
Copenhagen,1321,4,13,5,12,57,49,8,44
AaB,1321,5,8,13,9,38,43,-5,37
Sonderjyske,1321,6,8,6,10,28,29,-1,30
AC Horsens,1321,7,6,12,12,36,57,-21,30
Randers FC,1321,8,6,6,12,25,39,-14,24
Silkeborg IF,1321,9,6,3,13,27,44,-17,21
Lyngby,1321,10,3,9,12,26,46,-20,18
AGF Aarhus,1321,11,4,6,12,16,38,-22,18
Brondby,1322,1,19,6,5,71,38,33,63
FC Midtjylla,1322,2,19,5,6,62,41,21,62
Copenhagen,1322,3,15,5,10,60,43,17,50
FC Nords,1322,4,13,9,8,72,50,22,48
AaB,1322,5,8,13,9,42,42,0,37
AC Horsens,1322,6,7,12,11,36,55,-19,33
Sonderjyske,1322,7,8,6,10,28,29,-1,30
Randers FC,1322,8,5,7,12,23,39,-16,22
AGF Aarhus,1322,9,5,6,11,18,36,-18,21
Lyngby,1322,10,3,10,11,26,44,-18,19
Silkeborg IF,1322,11,5,3,14,25,46,-21,18
Brondby,1323,1,20,7,3,65,29,36,67
FC Midtjylla,1323,2,17,6,7,62,42,20,57
Copenhagen,1323,3,16,4,10,58,41,17,52
FC Nords,1323,4,14,8,8,74,49,25,50
AaB,1323,5,7,14,9,34,38,-4,35
AC Horsens,1323,6,6,13,11,37,57,-20,31
Sonderjyske,1323,7,8,6,10,28,29,-1,30
Randers FC,1323,8,5,7,12,24,40,-16,22
Silkeborg IF,1323,9,6,3,13,27,44,-17,21
Lyngby,1323,10,3,10,11,27,45,-18,19
AGF Aarhus,1323,11,4,6,12,16,38,-22,18
Brondby,1324,1,22,5,3,73,31,42,71
FC Midtjylla,1324,2,19,4,7,64,42,22,61
FC Nords,1324,3,15,6,9,73,49,24,51
Copenhagen,1324,4,15,5,10,59,42,17,50
AaB,1324,5,8,12,10,38,43,-5,36
Sonderjyske,1324,6,8,6,10,28,29,-1,30
AC Horsens,1324,7,5,12,13,33,59,-26,27
Randers FC,1324,8,6,6,12,24,39,-15,24
Silkeborg IF,1324,9,6,3,13,28,45,-17,21
Lyngby,1324,10,3,9,12,26,45,-19,18
AGF Aarhus,1324,11,4,6,12,17,39,-22,18
FC Midtjylla,1325,1,22,4,4,70,36,34,70
Brondby,1325,2,19,6,5,67,37,30,63
FC Nords,1325,3,13,7,10,71,52,19,46
Copenhagen,1325,4,14,4,12,56,45,11,46
AC Horsens,1325,5,8,13,9,36,50,-14,37
AaB,1325,6,7,12,11,34,40,-6,33
Sonderjyske,1325,7,8,6,10,28,29,-1,30
Randers FC,1325,8,6,6,12,24,39,-15,24
AGF Aarhus,1325,9,5,6,11,18,37,-19,21
Lyngby,1325,10,3,9,12,26,45,-19,18
Silkeborg IF,1325,11,5,3,14,26,46,-20,18
Brondby,1326,1,21,6,3,77,39,38,69
FC Midtjylla,1326,2,20,5,5,76,46,30,65
FC Nords,1326,3,15,6,9,80,55,25,51
Copenhagen,1326,4,14,5,11,60,47,13,47
AC Horsens,1326,5,7,13,10,38,54,-16,34
Sonderjyske,1326,6,8,6,10,28,29,-1,30
AaB,1326,7,6,11,13,37,53,-16,29
Randers FC,1326,8,6,6,12,24,39,-15,24
Silkeborg IF,1326,9,5,4,13,27,46,-19,19
AGF Aarhus,1326,10,4,7,11,18,38,-20,19
Lyngby,1326,11,3,9,12,26,45,-19,18
Brondby,1327,1,21,5,4,74,37,37,68
FC Midtjylla,1327,2,18,5,7,60,42,18,59
FC Nords,1327,3,16,7,7,80,49,31,55
Copenhagen,1327,4,12,5,13,57,53,4,41
AaB,1327,5,9,13,8,41,40,1,40
AC Horsens,1327,6,6,13,11,37,54,-17,31
Sonderjyske,1327,7,8,6,10,28,29,-1,30
Lyngby,1327,8,4,9,11,27,44,-17,21
Randers FC,1327,9,5,6,13,23,40,-17,21
AGF Aarhus,1327,10,5,6,11,19,36,-17,21
Silkeborg IF,1327,11,5,3,14,25,47,-22,18
Brondby,1328,1,21,5,4,72,31,41,68
FC Midtjylla,1328,2,18,6,6,62,41,21,60
Copenhagen,1328,3,16,5,9,61,41,20,53
FC Nords,1328,4,13,6,11,73,57,16,45
AaB,1328,5,8,11,11,35,44,-9,35
AC Horsens,1328,6,7,13,10,35,50,-15,34
Sonderjyske,1328,7,8,6,10,28,29,-1,30
Randers FC,1328,8,6,6,12,24,39,-15,24
Silkeborg IF,1328,9,5,4,13,26,45,-19,19
AGF Aarhus,1328,10,4,7,11,17,37,-20,19
Lyngby,1328,11,3,9,12,26,45,-19,18
Brondby,1329,1,21,5,4,74,33,41,68
FC Midtjylla,1329,2,20,4,6,65,40,25,64
Copenhagen,1329,3,14,5,11,59,45,14,47
FC Nords,1329,4,13,6,11,70,55,15,45
AC Horsens,1329,5,9,12,9,39,49,-10,39
AaB,1329,6,7,12,11,34,45,-11,33
Sonderjyske,1329,7,8,6,10,28,29,-1,30
Lyngby,1329,8,4,9,11,27,44,-17,21
Randers FC,1329,9,5,6,13,23,40,-17,21
AGF Aarhus,1329,10,5,6,11,17,36,-19,21
Silkeborg IF,1329,11,5,3,14,25,45,-20,18
Brondby,1330,1,22,5,3,76,32,44,71
FC Midtjylla,1330,2,20,4,6,67,40,27,64
FC Nords,1330,3,15,7,8,76,52,24,52
Copenhagen,1330,4,13,5,12,53,43,10,44
AaB,1330,5,8,12,10,35,42,-7,36
Sonderjyske,1330,6,8,6,10,28,29,-1,30
AC Horsens,1330,7,5,13,12,32,56,-24,28
Randers FC,1330,8,5,7,12,23,39,-16,22
Lyngby,1330,9,3,10,11,26,44,-18,19
Silkeborg IF,1330,10,5,4,13,26,45,-19,19
AGF Aarhus,1330,11,4,7,11,17,37,-20,19
Brondby,1331,1,20,7,3,74,35,39,67
FC Midtjylla,1331,2,20,6,4,69,39,30,66
Copenhagen,1331,3,15,4,11,61,44,17,49
FC Nords,1331,4,13,6,11,69,54,15,45
AaB,1331,5,9,11,10,39,44,-5,38
Sonderjyske,1331,6,8,6,10,28,29,-1,30
AC Horsens,1331,7,5,14,11,35,57,-22,29
Randers FC,1331,8,6,6,12,25,39,-14,24
Silkeborg IF,1331,9,5,4,13,25,44,-19,19
AGF Aarhus,1331,10,4,7,11,16,36,-20,19
Lyngby,1331,11,3,9,12,26,46,-20,18
Brondby,1332,1,21,6,3,72,34,38,69
FC Midtjylla,1332,2,20,5,5,64,38,26,65
FC Nords,1332,3,15,6,9,76,49,27,51
Copenhagen,1332,4,14,5,11,60,46,14,47
AaB,1332,5,7,12,11,37,48,-11,33
Sonderjyske,1332,6,8,6,10,28,29,-1,30
AC Horsens,1332,7,5,14,11,33,53,-20,29
Lyngby,1332,8,4,9,11,29,45,-16,21
Randers FC,1332,9,5,6,13,24,42,-18,21
AGF Aarhus,1332,10,5,6,11,18,36,-18,21
Silkeborg IF,1332,11,5,3,14,25,46,-21,18
Brondby,1333,1,20,7,3,66,29,37,67
FC Midtjylla,1333,2,19,4,7,66,41,25,61
FC Nords,1333,3,15,7,8,74,51,23,52
Copenhagen,1333,4,15,6,9,62,42,20,51
AaB,1333,5,7,13,10,34,41,-7,34
Sonderjyske,1333,6,8,6,10,28,29,-1,30
AC Horsens,1333,7,5,13,12,33,57,-24,28
Randers FC,1333,8,6,6,12,25,40,-15,24
AGF Aarhus,1333,9,5,6,11,19,38,-19,21
Lyngby,1333,10,3,9,12,27,46,-19,18
Silkeborg IF,1333,11,5,3,14,27,47,-20,18
Brondby,1334,1,20,6,4,71,32,39,66
FC Midtjylla,1334,2,19,5,6,59,37,22,62
FC Nords,1334,3,15,8,7,72,46,26,53
Copenhagen,1334,4,14,6,10,58,40,18,48
AC Horsens,1334,5,7,12,11,35,53,-18,33
AaB,1334,6,6,13,11,32,45,-13,31
Sonderjyske,1334,7,8,6,10,28,29,-1,30
Lyngby,1334,8,4,9,11,30,44,-14,21
Silkeborg IF,1334,9,6,3,13,28,45,-17,21
Randers FC,1334,10,5,6,13,23,43,-20,21
AGF Aarhus,1334,11,4,6,12,17,39,-22,18
Brondby,1335,1,21,7,2,74,31,43,70
FC Midtjylla,1335,2,20,6,4,70,39,31,66
FC Nords,1335,3,15,6,9,72,53,19,51
Copenhagen,1335,4,12,6,12,56,50,6,42
AaB,1335,5,7,12,11,37,46,-9,33
AC Horsens,1335,6,6,13,11,40,56,-16,31
Sonderjyske,1335,7,8,6,10,28,29,-1,30
Lyngby,1335,8,4,9,11,28,45,-17,21
Silkeborg IF,1335,8,6,3,13,28,45,-17,21
Randers FC,1335,10,5,6,13,24,41,-17,21
AGF Aarhus,1335,11,4,6,12,17,39,-22,18
Brondby,1336,1,21,7,2,72,31,41,70
FC Midtjylla,1336,2,18,6,6,67,43,24,60
FC Nords,1336,3,14,8,8,73,48,25,50
Copenhagen,1336,4,13,6,11,56,45,11,45
AaB,1336,5,7,12,11,34,44,-10,33
AC Horsens,1336,6,6,15,9,34,51,-17,33
Sonderjyske,1336,7,8,6,10,28,29,-1,30
Randers FC,1336,8,5,7,12,24,40,-16,22
Silkeborg IF,1336,9,6,3,13,28,44,-16,21
Lyngby,1336,10,3,10,11,27,45,-18,19
AGF Aarhus,1336,11,4,6,12,16,39,-23,18
Brondby,1337,1,21,6,3,75,37,38,69
FC Midtjylla,1337,2,20,4,6,71,40,31,64
FC Nords,1337,3,14,6,10,73,56,17,48
Copenhagen,1337,4,13,5,12,55,46,9,44
AaB,1337,5,9,11,10,39,42,-3,38
AC Horsens,1337,6,7,12,11,38,56,-18,33
Sonderjyske,1337,7,8,6,10,28,29,-1,30
Lyngby,1337,8,4,9,11,29,46,-17,21
Randers FC,1337,9,5,6,13,25,42,-17,21
AGF Aarhus,1337,10,5,6,11,18,37,-19,21
Silkeborg IF,1337,11,5,3,14,26,46,-20,18
FC Midtjylla,1338,1,21,5,4,71,39,32,68
Brondby,1338,2,19,5,6,66,37,29,62
FC Nords,1338,3,14,6,10,75,56,19,48
Copenhagen,1338,4,14,4,12,59,47,12,46
AaB,1338,5,8,13,9,39,42,-3,37
AC Horsens,1338,6,7,13,10,39,54,-15,34
Sonderjyske,1338,7,8,6,10,28,29,-1,30
Lyngby,1338,8,4,9,11,30,45,-15,21
Randers FC,1338,9,5,6,13,24,43,-19,21
Silkeborg IF,1338,10,5,4,13,27,46,-19,19
AGF Aarhus,1338,11,4,7,11,18,38,-20,19
Brondby,1339,1,22,6,2,74,28,46,72
FC Midtjylla,1339,2,20,5,5,71,42,29,65
FC Nords,1339,3,13,6,11,72,58,14,45
Copenhagen,1339,4,13,4,13,57,51,6,43
AaB,1339,5,9,11,10,40,44,-4,38
AC Horsens,1339,6,7,12,11,34,51,-17,33
Sonderjyske,1339,7,8,6,10,28,29,-1,30
Randers FC,1339,8,6,6,12,27,41,-14,24
Silkeborg IF,1339,9,6,3,13,29,45,-16,21
Lyngby,1339,10,3,9,12,28,48,-20,18
AGF Aarhus,1339,11,4,6,12,17,40,-23,18
Brondby,1340,1,22,6,2,72,28,44,72
FC Midtjylla,1340,2,18,8,4,63,38,25,62
FC Nords,1340,3,14,8,8,74,53,21,50
Copenhagen,1340,4,13,4,13,56,47,9,43
AC Horsens,1340,5,7,13,10,35,50,-15,34
AaB,1340,6,6,13,11,37,47,-10,31
Sonderjyske,1340,7,8,6,10,28,29,-1,30
Randers FC,1340,8,5,7,12,25,41,-16,22
AGF Aarhus,1340,9,5,6,11,18,37,-19,21
Lyngby,1340,10,3,10,11,28,46,-18,19
Silkeborg IF,1340,11,5,3,14,26,46,-20,18
Brondby,1341,1,20,7,3,71,33,38,67
FC Midtjylla,1341,2,18,4,8,61,46,15,58
FC Nords,1341,3,14,8,8,73,47,26,50
Copenhagen,1341,4,15,5,10,60,40,20,50
AaB,1341,5,8,12,10,37,42,-5,36
AC Horsens,1341,6,7,12,11,34,54,-20,33
Sonderjyske,1341,7,8,6,10,28,29,-1,30
Randers FC,1341,8,5,7,12,29,45,-16,22
Silkeborg IF,1341,9,6,3,13,29,45,-16,21
Lyngby,1341,10,3,10,11,32,50,-18,19
AGF Aarhus,1341,11,4,6,12,17,40,-23,18
Brondby,1342,1,22,6,2,70,30,40,72
FC Midtjylla,1342,2,18,4,8,61,45,16,58
Copenhagen,1342,3,15,5,10,60,41,19,50
FC Nords,1342,4,14,6,10,73,50,23,48
AaB,1342,5,8,13,9,41,42,-1,37
Sonderjyske,1342,6,8,6,10,28,29,-1,30
AC Horsens,1342,7,6,12,12,35,58,-23,30
Randers FC,1342,8,6,6,12,26,40,-14,24
Silkeborg IF,1342,9,5,4,13,27,46,-19,19
AGF Aarhus,1342,10,4,7,11,18,38,-20,19
Lyngby,1342,11,3,9,12,27,47,-20,18
Brondby,1343,1,20,5,5,71,36,35,65
FC Midtjylla,1343,2,19,5,6,64,39,25,62
Copenhagen,1343,3,16,4,10,59,43,16,52
FC Nords,1343,4,14,8,8,71,50,21,50
AaB,1343,5,8,12,10,36,39,-3,36
Sonderjyske,1343,6,8,6,10,28,29,-1,30
AC Horsens,1343,7,5,14,11,31,51,-20,29
Randers FC,1343,8,5,7,12,25,41,-16,22
Silkeborg IF,1343,9,6,3,13,27,44,-17,21
Lyngby,1343,10,3,10,11,28,46,-18,19
AGF Aarhus,1343,11,4,6,12,16,38,-22,18
Brondby,1344,1,20,8,2,73,34,39,68
FC Midtjylla,1344,2,19,5,6,64,38,26,62
FC Nords,1344,3,14,8,8,73,49,24,50
Copenhagen,1344,4,13,6,11,56,44,12,45
AaB,1344,5,10,11,9,41,40,1,41
Sonderjyske,1344,6,8,6,10,28,29,-1,30
AC Horsens,1344,7,5,12,13,34,62,-28,27
Randers FC,1344,8,6,6,12,25,39,-14,24
Silkeborg IF,1344,9,6,3,13,27,45,-18,21
Lyngby,1344,10,3,9,12,26,46,-20,18
AGF Aarhus,1344,11,4,6,12,17,38,-21,18
Brondby,1345,1,21,5,4,67,31,36,68
FC Midtjylla,1345,2,19,5,6,65,37,28,62
FC Nords,1345,3,16,6,8,71,47,24,54
Copenhagen,1345,4,13,5,12,56,46,10,44
AaB,1345,5,7,13,10,37,43,-6,34
AC Horsens,1345,6,6,14,10,33,51,-18,32
Sonderjyske,1345,7,8,6,10,28,29,-1,30
Randers FC,1345,8,6,6,12,25,40,-15,24
Silkeborg IF,1345,9,6,3,13,27,44,-17,21
Lyngby,1345,10,3,9,12,27,46,-19,18
AGF Aarhus,1345,11,4,6,12,16,38,-22,18
Brondby,1346,1,20,8,2,69,30,39,68
FC Midtjylla,1346,2,19,5,6,64,43,21,62
Copenhagen,1346,3,15,6,9,60,41,19,51
FC Nords,1346,4,12,7,11,70,54,16,43
AaB,1346,5,8,13,9,40,42,-2,37
Sonderjyske,1346,6,8,6,10,28,29,-1,30
AC Horsens,1346,7,5,15,10,30,49,-19,30
Lyngby,1346,8,4,9,11,27,44,-17,21
Randers FC,1346,9,5,6,13,23,40,-17,21
AGF Aarhus,1346,10,5,6,11,18,37,-19,21
Silkeborg IF,1346,11,5,3,14,26,46,-20,18
Brondby,1347,1,22,6,2,70,29,41,72
FC Midtjylla,1347,2,18,7,5,62,38,24,61
Copenhagen,1347,3,14,6,10,55,42,13,48
FC Nords,1347,4,12,7,11,72,56,16,43
AaB,1347,5,7,14,9,35,37,-2,35
AC Horsens,1347,6,6,14,10,35,53,-18,32
Sonderjyske,1347,7,8,6,10,28,29,-1,30
Lyngby,1347,8,4,9,11,29,45,-16,21
Silkeborg IF,1347,9,6,3,13,27,44,-17,21
Randers FC,1347,10,5,6,13,24,42,-18,21
AGF Aarhus,1347,11,4,6,12,16,38,-22,18
Brondby,1348,1,22,6,2,67,28,39,72
FC Midtjylla,1348,2,20,5,5,67,38,29,65
FC Nords,1348,3,14,7,9,70,49,21,49
Copenhagen,1348,4,13,5,12,55,44,11,44
AaB,1348,5,7,13,10,37,42,-5,34
Sonderjyske,1348,6,8,6,10,28,29,-1,30
AC Horsens,1348,7,6,12,12,33,54,-21,30
Randers FC,1348,8,6,6,12,25,40,-15,24
Silkeborg IF,1348,9,5,4,13,26,45,-19,19
AGF Aarhus,1348,10,4,7,11,17,37,-20,19
Lyngby,1348,11,3,9,12,27,46,-19,18
Brondby,1349,1,20,7,3,72,33,39,67
FC Midtjylla,1349,2,19,4,7,70,42,28,61
FC Nords,1349,3,15,7,8,76,50,26,52
Copenhagen,1349,4,14,5,11,60,47,13,47
AC Horsens,1349,5,8,12,10,37,51,-14,36
AaB,1349,6,7,11,12,33,51,-18,32
Sonderjyske,1349,7,8,6,10,28,29,-1,30
Lyngby,1349,8,4,9,11,29,45,-16,21
Randers FC,1349,9,5,6,13,24,42,-18,21
AGF Aarhus,1349,10,5,6,11,19,37,-18,21
Silkeborg IF,1349,11,5,3,14,26,47,-21,18
Brondby,1350,1,21,5,4,68,30,38,68
FC Midtjylla,1350,2,21,4,5,69,40,29,67
Copenhagen,1350,3,16,4,10,61,42,19,52
FC Nords,1350,4,14,7,9,69,52,17,49
AC Horsens,1350,5,6,13,11,35,54,-19,31
Sonderjyske,1350,6,8,6,10,28,29,-1,30
AaB,1350,7,6,11,13,34,44,-10,29
Lyngby,1350,8,4,9,11,28,45,-17,21
Randers FC,1350,9,5,6,13,24,41,-17,21
Silkeborg IF,1350,10,6,3,13,27,45,-18,21
AGF Aarhus,1350,11,4,6,12,17,38,-21,18
Brondby,1351,1,19,6,5,66,32,34,63
FC Midtjylla,1351,2,19,5,6,64,44,20,62
Copenhagen,1351,3,14,7,9,60,42,18,49
FC Nords,1351,4,13,9,8,73,51,22,48
AaB,1351,5,7,14,9,36,39,-3,35
AC Horsens,1351,6,7,13,10,36,53,-17,34
Sonderjyske,1351,7,8,6,10,28,29,-1,30
Randers FC,1351,8,5,7,12,24,40,-16,22
Silkeborg IF,1351,9,6,3,13,29,46,-17,21
Lyngby,1351,10,3,10,11,27,45,-18,19
AGF Aarhus,1351,11,4,6,12,18,40,-22,18
FC Midtjylla,1352,1,20,6,4,67,38,29,66
Brondby,1352,2,19,5,6,69,37,32,62
FC Nords,1352,3,14,7,9,75,55,20,49
Copenhagen,1352,4,14,6,10,58,46,12,48
AaB,1352,5,8,12,10,38,42,-4,36
AC Horsens,1352,6,7,12,11,36,51,-15,33
Sonderjyske,1352,7,8,6,10,28,29,-1,30
Lyngby,1352,8,4,9,11,29,44,-15,21
Randers FC,1352,9,5,6,13,23,42,-19,21
Silkeborg IF,1352,10,5,4,13,27,46,-19,19
AGF Aarhus,1352,11,4,7,11,18,38,-20,19
Brondby,1353,1,21,6,3,72,34,38,69
FC Midtjylla,1353,2,20,5,5,64,37,27,65
Copenhagen,1353,3,16,5,9,63,39,24,53
FC Nords,1353,4,12,6,12,68,58,10,42
AaB,1353,5,7,13,10,40,45,-5,34
AC Horsens,1353,6,6,13,11,34,54,-20,31
Sonderjyske,1353,7,8,6,10,28,29,-1,30
Silkeborg IF,1353,8,6,3,13,30,45,-15,21
Lyngby,1353,9,4,9,11,28,44,-16,21
Randers FC,1353,10,5,6,13,23,41,-18,21
AGF Aarhus,1353,11,4,6,12,17,41,-24,18
Brondby,1354,1,22,6,2,71,31,40,72
FC Midtjylla,1354,2,18,6,6,64,43,21,60
FC Nords,1354,3,14,8,8,73,51,22,50
Copenhagen,1354,4,12,6,12,57,47,10,42
AaB,1354,5,8,12,10,38,41,-3,36
AC Horsens,1354,6,6,14,10,35,51,-16,32
Sonderjyske,1354,7,8,6,10,28,29,-1,30
Lyngby,1354,8,4,9,11,29,46,-17,21
Randers FC,1354,9,5,6,13,25,42,-17,21
Silkeborg IF,1354,10,5,4,13,25,44,-19,19
AGF Aarhus,1354,11,4,7,11,16,36,-20,19
FC Midtjylla,1355,1,21,5,4,71,39,32,68
Brondby,1355,2,20,6,4,70,35,35,66
FC Nords,1355,3,14,7,9,77,54,23,49
Copenhagen,1355,4,13,4,13,59,52,7,43
AC Horsens,1355,5,7,15,8,35,47,-12,36
AaB,1355,6,7,11,12,34,45,-11,32
Sonderjyske,1355,7,8,6,10,28,29,-1,30
Lyngby,1355,8,4,9,11,28,45,-17,21
Randers FC,1355,9,5,6,13,24,41,-17,21
AGF Aarhus,1355,10,5,6,11,17,36,-19,21
Silkeborg IF,1355,11,5,3,14,25,45,-20,18
Brondby,1356,1,21,5,4,75,35,40,68
FC Midtjylla,1356,2,21,5,4,70,37,33,68
FC Nords,1356,3,14,6,10,74,58,16,48
Copenhagen,1356,4,14,4,12,59,47,12,46
AaB,1356,5,9,11,10,40,42,-2,38
Sonderjyske,1356,6,8,6,10,28,29,-1,30
AC Horsens,1356,7,5,13,12,34,59,-25,28
Randers FC,1356,8,6,6,12,25,40,-15,24
AGF Aarhus,1356,9,5,6,11,17,36,-19,21
Lyngby,1356,10,3,9,12,27,46,-19,18
Silkeborg IF,1356,11,5,3,14,25,45,-20,18
Brondby,1357,1,21,6,3,71,32,39,69
FC Midtjylla,1357,2,20,5,5,63,36,27,65
FC Nords,1357,3,15,7,8,76,49,27,52
Copenhagen,1357,4,12,8,10,56,46,10,44
AaB,1357,5,7,12,11,36,43,-7,33
Sonderjyske,1357,6,8,6,10,28,29,-1,30
AC Horsens,1357,7,5,14,11,32,54,-22,29
Lyngby,1357,8,4,9,11,28,44,-16,21
Silkeborg IF,1357,9,6,3,13,26,44,-18,21
Randers FC,1357,10,5,6,13,23,41,-18,21
AGF Aarhus,1357,11,4,6,12,16,37,-21,18
Brondby,1358,1,20,6,4,71,34,37,66
FC Midtjylla,1358,2,19,6,5,62,39,23,63
FC Nords,1358,3,14,7,9,71,47,24,49
Copenhagen,1358,4,14,6,10,57,42,15,48
AC Horsens,1358,5,7,13,10,31,47,-16,34
AaB,1358,6,6,14,10,33,42,-9,32
Sonderjyske,1358,7,8,6,10,28,29,-1,30
Randers FC,1358,8,6,6,12,25,40,-15,24
Silkeborg IF,1358,9,6,3,13,26,44,-18,21
Lyngby,1358,10,3,9,12,27,46,-19,18
AGF Aarhus,1358,11,4,6,12,16,37,-21,18
Brondby,1359,1,21,5,4,69,33,36,68
FC Midtjylla,1359,2,20,5,5,65,36,29,65
FC Nords,1359,3,15,7,8,73,50,23,52
Copenhagen,1359,4,14,5,11,58,46,12,47
AaB,1359,5,6,13,11,34,45,-11,31
AC Horsens,1359,6,6,13,11,36,51,-15,31
Sonderjyske,1359,7,8,6,10,28,29,-1,30
Randers FC,1359,8,5,7,12,23,39,-16,22
Lyngby,1359,9,3,10,11,26,44,-18,19
Silkeborg IF,1359,10,5,4,13,27,46,-19,19
AGF Aarhus,1359,11,4,7,11,18,38,-20,19
Brondby,1360,1,21,5,4,68,31,37,68
FC Midtjylla,1360,2,20,5,5,67,38,29,65
FC Nords,1360,3,13,8,9,70,49,21,47
Copenhagen,1360,4,14,5,11,57,45,12,47
AaB,1360,5,8,13,9,36,37,-1,37
Sonderjyske,1360,6,8,6,10,28,29,-1,30
AC Horsens,1360,7,6,12,12,32,56,-24,30
Randers FC,1360,8,5,7,12,25,41,-16,22
Silkeborg IF,1360,9,6,3,13,31,44,-13,21
Lyngby,1360,10,3,10,11,28,46,-18,19
AGF Aarhus,1360,11,4,6,12,16,42,-26,18
Brondby,1361,1,21,5,4,70,33,37,68
FC Midtjylla,1361,2,19,5,6,66,41,25,62
FC Nords,1361,3,16,6,8,79,49,30,54
Copenhagen,1361,4,13,6,11,55,43,12,45
AC Horsens,1361,5,7,13,10,35,53,-18,34
AaB,1361,6,6,13,11,34,46,-12,31
Sonderjyske,1361,7,8,6,10,28,29,-1,30
Randers FC,1361,8,6,6,12,25,40,-15,24
Silkeborg IF,1361,9,6,3,13,28,45,-17,21
Lyngby,1361,10,3,9,12,27,46,-19,18
AGF Aarhus,1361,11,4,6,12,17,39,-22,18
Brondby,1362,1,22,6,2,78,28,50,72
FC Midtjylla,1362,2,18,4,8,59,43,16,58
Copenhagen,1362,3,15,5,10,60,43,17,50
FC Nords,1362,4,12,7,11,68,55,13,43
AaB,1362,5,8,12,10,38,45,-7,36
AC Horsens,1362,6,7,14,9,34,49,-15,35
Sonderjyske,1362,7,8,6,10,28,29,-1,30
Randers FC,1362,8,6,6,12,24,39,-15,24
Silkeborg IF,1362,9,6,3,13,27,45,-18,21
Lyngby,1362,10,3,9,12,26,45,-19,18
AGF Aarhus,1362,11,4,6,12,17,38,-21,18
Brondby,1363,1,21,6,3,71,32,39,69
FC Midtjylla,1363,2,19,5,6,66,38,28,62
FC Nords,1363,3,16,6,8,72,47,25,54
Copenhagen,1363,4,15,5,10,58,40,18,50
AaB,1363,5,7,11,12,34,45,-11,32
Sonderjyske,1363,6,8,6,10,28,29,-1,30
AC Horsens,1363,7,5,13,12,32,57,-25,28
Lyngby,1363,8,4,9,11,27,44,-17,21
Randers FC,1363,9,5,6,13,23,40,-17,21
Silkeborg IF,1363,10,5,4,13,26,45,-19,19
AGF Aarhus,1363,11,4,7,11,17,37,-20,19
Brondby,1364,1,22,5,3,73,31,42,71
FC Midtjylla,1364,2,17,5,8,60,45,15,56
FC Nords,1364,3,15,6,9,79,49,30,51
Copenhagen,1364,4,13,4,13,53,47,6,43
AaB,1364,5,10,11,9,39,39,0,41
AC Horsens,1364,6,7,13,10,33,52,-19,34
Sonderjyske,1364,7,8,6,10,28,29,-1,30
Lyngby,1364,8,4,9,11,29,45,-16,21
Randers FC,1364,9,5,6,13,24,42,-18,21
AGF Aarhus,1364,10,5,6,11,19,37,-18,21
Silkeborg IF,1364,11,5,3,14,26,47,-21,18
Brondby,1365,1,20,7,3,71,34,37,67
FC Midtjylla,1365,2,19,5,6,62,39,23,62
FC Nords,1365,3,16,6,8,76,46,30,54
Copenhagen,1365,4,13,4,13,55,48,7,43
AaB,1365,5,10,12,8,39,38,1,42
Sonderjyske,1365,6,8,6,10,28,29,-1,30
AC Horsens,1365,7,5,12,13,31,55,-24,27
Randers FC,1365,8,5,7,12,23,39,-16,22
AGF Aarhus,1365,9,5,6,11,18,37,-19,21
Lyngby,1365,10,3,10,11,26,44,-18,19
Silkeborg IF,1365,11,5,3,14,26,46,-20,18
FC Midtjylla,1366,1,21,5,4,67,35,32,68
Brondby,1366,2,19,6,5,65,32,33,63
FC Nords,1366,3,13,7,10,67,50,17,46
Copenhagen,1366,4,13,7,10,57,43,14,46
AaB,1366,5,8,13,9,37,42,-5,37
AC Horsens,1366,6,5,16,9,34,51,-17,31
Sonderjyske,1366,7,8,6,10,28,29,-1,30
Randers FC,1366,8,6,6,12,27,39,-12,24
Silkeborg IF,1366,9,6,3,13,28,44,-16,21
Lyngby,1366,10,3,9,12,26,48,-22,18
AGF Aarhus,1366,11,4,6,12,16,39,-23,18
Brondby,1367,1,21,6,3,71,31,40,69
FC Midtjylla,1367,2,20,5,5,64,40,24,65
FC Nords,1367,3,13,6,11,69,53,16,45
Copenhagen,1367,4,13,5,12,58,45,13,44
AaB,1367,5,7,14,9,37,41,-4,35
AC Horsens,1367,6,7,14,9,35,50,-15,35
Sonderjyske,1367,7,8,6,10,28,29,-1,30
Randers FC,1367,8,5,7,12,24,40,-16,22
Silkeborg IF,1367,9,6,3,13,26,44,-18,21
Lyngby,1367,10,3,10,11,27,45,-18,19
AGF Aarhus,1367,11,4,6,12,16,37,-21,18
Brondby,1368,1,22,6,2,71,31,40,72
FC Midtjylla,1368,2,19,5,6,64,40,24,62
Copenhagen,1368,3,14,5,11,57,43,14,47
FC Nords,1368,4,13,7,10,75,54,21,46
AaB,1368,5,8,11,11,38,42,-4,35
AC Horsens,1368,6,7,12,11,33,54,-21,33
Sonderjyske,1368,7,8,6,10,28,29,-1,30
Lyngby,1368,8,4,9,11,27,44,-17,21
Silkeborg IF,1368,8,6,3,13,27,44,-17,21
Randers FC,1368,10,5,6,13,23,40,-17,21
AGF Aarhus,1368,11,4,6,12,16,38,-22,18
Brondby,1369,1,21,6,3,75,35,40,69
FC Midtjylla,1369,2,19,5,6,65,39,26,62
Copenhagen,1369,3,15,4,11,59,43,16,49
FC Nords,1369,4,13,7,10,66,51,15,46
AaB,1369,5,8,13,9,38,42,-4,37
AC Horsens,1369,6,6,13,11,36,55,-19,31
Sonderjyske,1369,7,8,6,10,28,29,-1,30
Randers FC,1369,8,5,7,12,23,39,-16,22
Lyngby,1369,9,3,10,11,26,44,-18,19
Silkeborg IF,1369,10,5,4,13,27,46,-19,19
AGF Aarhus,1369,11,4,7,11,18,38,-20,19
FC Midtjylla,1370,1,21,4,5,74,42,32,67
Brondby,1370,2,19,5,6,66,35,31,62
Copenhagen,1370,3,16,5,9,63,41,22,53
FC Nords,1370,4,14,6,10,69,54,15,48
AaB,1370,5,8,12,10,40,44,-4,36
Sonderjyske,1370,6,8,6,10,28,29,-1,30
AC Horsens,1370,7,6,12,12,36,58,-22,30
Randers FC,1370,8,5,7,12,26,42,-16,22
Silkeborg IF,1370,9,6,3,13,26,44,-18,21
Lyngby,1370,10,3,10,11,29,47,-18,19
AGF Aarhus,1370,11,4,6,12,16,37,-21,18
Brondby,1371,1,21,7,2,69,31,38,70
FC Midtjylla,1371,2,20,4,6,68,41,27,64
FC Nords,1371,3,14,6,10,73,50,23,48
Copenhagen,1371,4,14,6,10,58,42,16,48
AaB,1371,5,7,13,10,39,44,-5,34
Sonderjyske,1371,6,8,6,10,28,29,-1,30
AC Horsens,1371,7,6,12,12,33,58,-25,30
Randers FC,1371,8,6,6,12,26,40,-14,24
Silkeborg IF,1371,9,6,3,13,28,45,-17,21
Lyngby,1371,10,3,9,12,27,47,-20,18
AGF Aarhus,1371,11,4,6,12,17,39,-22,18
Brondby,1372,1,22,6,2,76,30,46,72
FC Midtjylla,1372,2,20,4,6,64,38,26,64
FC Nords,1372,3,14,8,8,72,51,21,50
Copenhagen,1372,4,13,6,11,55,44,11,45
AaB,1372,5,7,11,12,37,47,-10,32
AC Horsens,1372,6,6,13,11,35,55,-20,31
Sonderjyske,1372,7,8,6,10,28,29,-1,30
Randers FC,1372,8,5,7,12,23,39,-16,22
Silkeborg IF,1372,9,6,3,13,26,44,-18,21
Lyngby,1372,10,3,10,11,26,44,-18,19
AGF Aarhus,1372,11,4,6,12,16,37,-21,18
Brondby,1373,1,22,6,2,74,28,46,72
FC Midtjylla,1373,2,18,5,7,62,39,23,59
Copenhagen,1373,3,15,4,11,58,46,12,49
FC Nords,1373,4,13,7,10,72,56,16,46
AC Horsens,1373,5,8,13,9,41,52,-11,37
AaB,1373,6,6,13,11,34,46,-12,31
Sonderjyske,1373,7,8,6,10,28,29,-1,30
Randers FC,1373,8,6,6,12,26,40,-14,24
Silkeborg IF,1373,9,6,3,13,27,45,-18,21
Lyngby,1373,10,3,9,12,27,47,-20,18
AGF Aarhus,1373,11,4,6,12,17,38,-21,18
Brondby,1374,1,22,6,2,72,31,41,72
FC Midtjylla,1374,2,21,4,5,68,39,29,67
FC Nords,1374,3,14,7,9,74,52,22,49
Copenhagen,1374,4,12,6,12,55,47,8,42
AC Horsens,1374,5,7,13,10,37,53,-16,34
Sonderjyske,1374,6,8,6,10,28,29,-1,30
AaB,1374,7,6,12,12,36,46,-10,30
Lyngby,1374,8,4,9,11,28,44,-16,21
Randers FC,1374,9,5,6,13,23,41,-18,21
AGF Aarhus,1374,10,5,6,11,18,37,-19,21
Silkeborg IF,1374,11,5,3,14,26,46,-20,18
Brondby,1375,1,19,8,3,69,35,34,65
FC Midtjylla,1375,2,20,5,5,63,38,25,65
Copenhagen,1375,3,14,6,10,57,42,15,48
FC Nords,1375,4,13,7,10,67,48,19,46
AC Horsens,1375,5,8,12,10,38,50,-12,36
AaB,1375,6,7,12,11,34,41,-7,33
Sonderjyske,1375,7,8,6,10,28,29,-1,30
Lyngby,1375,8,4,9,11,29,45,-16,21
Randers FC,1375,9,5,6,13,24,42,-18,21
Silkeborg IF,1375,10,5,4,13,26,45,-19,19
AGF Aarhus,1375,11,4,7,11,17,37,-20,19
Brondby,1376,1,21,5,4,71,34,37,68
FC Midtjylla,1376,2,19,4,7,64,42,22,61
FC Nords,1376,3,15,7,8,80,55,25,52
Copenhagen,1376,4,14,4,12,61,50,11,46
AaB,1376,5,8,12,10,37,40,-3,36
AC Horsens,1376,6,7,12,11,37,55,-18,33
Sonderjyske,1376,7,8,6,10,28,29,-1,30
Randers FC,1376,8,5,7,12,23,39,-16,22
Lyngby,1376,9,3,10,11,26,44,-18,19
Silkeborg IF,1376,10,5,4,13,25,44,-19,19
AGF Aarhus,1376,11,4,7,11,16,36,-20,19
FC Midtjylla,1377,1,20,4,6,63,40,23,64
Brondby,1377,2,19,6,5,68,34,34,63
FC Nords,1377,3,15,6,9,76,54,22,51
Copenhagen,1377,4,15,4,11,60,47,13,49
AC Horsens,1377,5,8,13,9,37,48,-11,37
AaB,1377,6,6,13,11,35,42,-7,31
Sonderjyske,1377,7,8,6,10,28,29,-1,30
Lyngby,1377,8,4,9,11,28,44,-16,21
Silkeborg IF,1377,9,6,3,13,26,44,-18,21
Randers FC,1377,10,5,6,13,23,41,-18,21
AGF Aarhus,1377,11,4,6,12,16,37,-21,18
Brondby,1378,1,19,8,3,68,33,35,65
FC Midtjylla,1378,2,18,7,5,64,41,23,61
FC Nords,1378,3,14,9,7,75,51,24,51
Copenhagen,1378,4,13,7,10,60,48,12,46
AaB,1378,5,7,13,10,38,42,-4,34
AC Horsens,1378,6,5,16,9,36,52,-16,31
Sonderjyske,1378,7,8,6,10,28,29,-1,30
Randers FC,1378,8,6,6,12,25,40,-15,24
AGF Aarhus,1378,9,5,6,11,18,36,-18,21
Lyngby,1378,10,3,9,12,27,46,-19,18
Silkeborg IF,1378,11,5,3,14,25,46,-21,18
Brondby,1379,1,19,6,5,66,38,28,63
FC Midtjylla,1379,2,19,5,6,66,39,27,62
Copenhagen,1379,3,16,5,9,59,41,18,53
FC Nords,1379,4,14,6,10,76,55,21,48
AC Horsens,1379,5,8,12,10,38,50,-12,36
AaB,1379,6,7,12,11,37,45,-8,33
Sonderjyske,1379,7,8,6,10,28,29,-1,30
Randers FC,1379,8,5,7,12,23,39,-16,22
Lyngby,1379,9,3,10,11,26,44,-18,19
Silkeborg IF,1379,10,5,4,13,25,44,-19,19
AGF Aarhus,1379,11,4,7,11,16,36,-20,19
Brondby,1380,1,20,8,2,69,30,39,68
FC Midtjylla,1380,2,20,5,5,65,39,26,65
FC Nords,1380,3,14,7,9,67,50,17,49
Copenhagen,1380,4,12,5,13,54,45,9,41
AaB,1380,5,9,12,9,40,39,1,39
AC Horsens,1380,6,6,13,11,34,52,-18,31
Sonderjyske,1380,7,8,6,10,28,29,-1,30
Randers FC,1380,8,6,6,12,24,39,-15,24
Silkeborg IF,1380,9,6,3,13,28,46,-18,21
Lyngby,1380,10,3,9,12,26,45,-19,18
AGF Aarhus,1380,11,4,6,12,18,39,-21,18
Brondby,1381,1,21,5,4,70,34,36,68
FC Midtjylla,1381,2,18,5,7,63,41,22,59
FC Nords,1381,3,17,6,7,80,48,32,57
Copenhagen,1381,4,14,4,12,53,40,13,46
AC Horsens,1381,5,7,13,10,36,56,-20,34
AaB,1381,6,7,11,12,34,43,-9,32
Sonderjyske,1381,7,8,6,10,28,29,-1,30
Randers FC,1381,8,6,6,12,25,40,-15,24
AGF Aarhus,1381,9,5,6,11,20,37,-17,21
Lyngby,1381,10,3,9,12,27,46,-19,18
Silkeborg IF,1381,11,5,3,14,26,48,-22,18
Brondby,1382,1,22,5,3,73,30,43,71
FC Midtjylla,1382,2,19,5,6,64,39,25,62
FC Nords,1382,3,14,6,10,72,50,22,48
Copenhagen,1382,4,14,5,11,58,51,7,47
AC Horsens,1382,5,8,12,10,38,50,-12,36
AaB,1382,6,7,11,12,33,44,-11,32
Sonderjyske,1382,7,8,6,10,28,29,-1,30
Randers FC,1382,8,6,6,12,25,39,-14,24
Silkeborg IF,1382,9,5,4,13,26,45,-19,19
AGF Aarhus,1382,10,4,7,11,17,37,-20,19
Lyngby,1382,11,3,9,12,26,46,-20,18
Brondby,1383,1,21,6,3,73,29,44,69
FC Midtjylla,1383,2,19,5,6,66,42,24,62
Copenhagen,1383,3,15,5,10,59,44,15,50
FC Nords,1383,4,14,6,10,77,54,23,48
AC Horsens,1383,5,7,14,9,36,51,-15,35
Sonderjyske,1383,6,8,6,10,28,29,-1,30
AaB,1383,7,6,12,12,33,50,-17,30
Lyngby,1383,8,4,9,11,27,44,-17,21
Randers FC,1383,9,5,6,13,23,40,-17,21
Silkeborg IF,1383,10,6,3,13,26,44,-18,21
AGF Aarhus,1383,11,4,6,12,16,37,-21,18
Brondby,1384,1,20,7,3,70,33,37,67
FC Midtjylla,1384,2,20,6,4,70,37,33,66
FC Nords,1384,3,13,8,9,72,56,16,47
Copenhagen,1384,4,13,5,12,58,45,13,44
AC Horsens,1384,5,7,14,9,36,52,-16,35
AaB,1384,6,7,12,11,36,45,-9,33
Sonderjyske,1384,7,8,6,10,28,29,-1,30
Lyngby,1384,8,4,9,11,28,44,-16,21
Randers FC,1384,9,5,6,13,23,41,-18,21
AGF Aarhus,1384,10,5,6,11,17,36,-19,21
Silkeborg IF,1384,11,5,3,14,25,45,-20,18
Brondby,1385,1,21,6,3,75,35,40,69
FC Midtjylla,1385,2,17,6,7,62,41,21,57
FC Nords,1385,3,15,7,8,76,50,26,52
Copenhagen,1385,4,14,7,9,60,45,15,49
AaB,1385,5,8,11,11,36,43,-7,35
AC Horsens,1385,6,6,13,11,33,54,-21,31
Sonderjyske,1385,7,8,6,10,28,29,-1,30
Randers FC,1385,8,6,6,12,25,40,-15,24
AGF Aarhus,1385,9,5,6,11,18,37,-19,21
Lyngby,1385,10,3,9,12,27,46,-19,18
Silkeborg IF,1385,11,5,3,14,26,46,-20,18
Brondby,1386,1,20,5,5,69,35,34,65
FC Midtjylla,1386,2,20,4,6,66,39,27,64
FC Nords,1386,3,16,7,7,77,48,29,55
Copenhagen,1386,4,12,6,12,55,47,8,42
AaB,1386,5,7,13,10,38,45,-7,34
AC Horsens,1386,6,7,13,10,36,53,-17,34
Sonderjyske,1386,7,8,6,10,28,29,-1,30
Lyngby,1386,8,4,9,11,27,44,-17,21
Randers FC,1386,9,5,6,13,23,40,-17,21
Silkeborg IF,1386,10,6,3,13,27,45,-18,21
AGF Aarhus,1386,11,4,6,12,17,38,-21,18
Brondby,1387,1,22,6,2,73,29,44,72
FC Midtjylla,1387,2,20,5,5,66,36,30,65
FC Nords,1387,3,13,8,9,70,50,20,47
Copenhagen,1387,4,13,7,10,58,46,12,46
AaB,1387,5,7,12,11,39,47,-8,33
Sonderjyske,1387,6,8,6,10,28,29,-1,30
AC Horsens,1387,7,6,12,12,35,59,-24,30
Lyngby,1387,8,4,9,11,31,44,-13,21
AGF Aarhus,1387,9,5,6,11,17,36,-19,21
Randers FC,1387,10,5,6,13,23,44,-21,21
Silkeborg IF,1387,11,5,3,14,25,45,-20,18
Brondby,1388,1,22,6,2,74,31,43,72
FC Midtjylla,1388,2,19,6,5,66,38,28,63
FC Nords,1388,3,14,6,10,71,54,17,48
Copenhagen,1388,4,12,8,10,53,44,9,44
AaB,1388,5,8,13,9,38,41,-3,37
Sonderjyske,1388,6,8,6,10,28,29,-1,30
AC Horsens,1388,7,5,13,12,31,51,-20,28
Randers FC,1388,8,5,7,12,23,39,-16,22
AGF Aarhus,1388,9,5,6,11,18,37,-19,21
Lyngby,1388,10,3,10,11,26,44,-18,19
Silkeborg IF,1388,11,5,3,14,26,46,-20,18
Brondby,1389,1,21,7,2,75,31,44,70
FC Midtjylla,1389,2,20,5,5,64,38,26,65
FC Nords,1389,3,14,6,10,70,51,19,48
Copenhagen,1389,4,13,5,12,58,47,11,44
AC Horsens,1389,5,8,12,10,38,56,-18,36
AaB,1389,6,6,13,11,36,44,-8,31
Sonderjyske,1389,7,8,6,10,28,29,-1,30
Lyngby,1389,8,4,9,11,28,44,-16,21
Randers FC,1389,9,5,6,13,23,41,-18,21
AGF Aarhus,1389,10,5,6,11,18,36,-18,21
Silkeborg IF,1389,11,5,3,14,25,46,-21,18
Brondby,1390,1,20,6,4,66,33,33,66
FC Midtjylla,1390,2,19,5,6,66,37,29,62
FC Nords,1390,3,15,7,8,73,47,26,52
Copenhagen,1390,4,14,6,10,62,48,14,48
AaB,1390,5,7,12,11,36,43,-7,33
AC Horsens,1390,6,7,12,11,32,53,-21,33
Sonderjyske,1390,7,8,6,10,28,29,-1,30
Lyngby,1390,8,4,9,11,28,45,-17,21
Randers FC,1390,9,5,6,13,24,41,-17,21
AGF Aarhus,1390,10,5,6,11,18,37,-19,21
Silkeborg IF,1390,11,5,3,14,26,46,-20,18
FC Midtjylla,1391,1,21,5,4,73,38,35,68
Brondby,1391,2,19,6,5,70,36,34,63
FC Nords,1391,3,14,7,9,75,54,21,49
Copenhagen,1391,4,13,5,12,54,45,9,44
AC Horsens,1391,5,8,12,10,35,54,-19,36
AaB,1391,6,6,15,9,38,44,-6,33
Sonderjyske,1391,7,8,6,10,28,29,-1,30
Lyngby,1391,8,4,9,11,30,45,-15,21
Silkeborg IF,1391,9,6,3,13,28,44,-16,21
Randers FC,1391,10,5,6,13,24,43,-19,21
AGF Aarhus,1391,11,4,6,12,16,39,-23,18
Brondby,1392,1,21,5,4,69,35,34,68
FC Midtjylla,1392,2,20,4,6,68,39,29,64
Copenhagen,1392,3,17,4,9,64,38,26,55
FC Nords,1392,4,14,6,10,76,53,23,48
AaB,1392,5,7,12,11,35,48,-13,33
Sonderjyske,1392,6,8,6,10,28,29,-1,30
AC Horsens,1392,7,5,13,12,34,59,-25,28
Randers FC,1392,8,5,7,12,25,41,-16,22
Lyngby,1392,9,3,10,11,28,46,-18,19
Silkeborg IF,1392,10,5,4,13,27,46,-19,19
AGF Aarhus,1392,11,4,7,11,18,38,-20,19
Brondby,1393,1,22,5,3,73,31,42,71
FC Midtjylla,1393,2,18,5,7,62,41,21,59
Copenhagen,1393,3,15,5,10,62,46,16,50
FC Nords,1393,4,13,6,11,69,52,17,45
AaB,1393,5,8,13,9,40,44,-4,37
AC Horsens,1393,6,6,14,10,31,49,-18,32
Sonderjyske,1393,7,8,6,10,28,29,-1,30
Randers FC,1393,8,6,6,12,26,40,-14,24
Silkeborg IF,1393,9,5,4,13,26,45,-19,19
AGF Aarhus,1393,10,4,7,11,17,37,-20,19
Lyngby,1393,11,3,9,12,27,47,-20,18
Brondby,1394,1,20,7,3,69,35,34,67
FC Midtjylla,1394,2,20,5,5,72,38,34,65
Copenhagen,1394,3,16,4,10,61,41,20,52
FC Nords,1394,4,12,8,10,73,62,11,44
AaB,1394,5,6,14,10,33,41,-8,32
AC Horsens,1394,6,6,14,10,33,50,-17,32
Sonderjyske,1394,7,8,6,10,28,29,-1,30
Lyngby,1394,8,4,9,11,29,44,-15,21
Randers FC,1394,9,5,6,13,23,42,-19,21
AGF Aarhus,1394,10,5,6,11,17,36,-19,21
Silkeborg IF,1394,11,5,3,14,25,45,-20,18
Brondby,1395,1,21,7,2,74,30,44,70
FC Midtjylla,1395,2,19,7,4,65,38,27,64
FC Nords,1395,3,14,8,8,76,52,24,50
Copenhagen,1395,4,13,7,10,57,43,14,46
Sonderjyske,1395,5,8,6,10,28,29,-1,30
AaB,1395,6,6,12,12,33,48,-15,30
AC Horsens,1395,7,5,15,10,34,54,-20,30
Randers FC,1395,8,5,7,12,24,40,-16,22
Lyngby,1395,9,3,10,11,27,45,-18,19
Silkeborg IF,1395,10,5,4,13,26,45,-19,19
AGF Aarhus,1395,11,4,7,11,17,37,-20,19
Brondby,1396,1,20,6,4,68,31,37,66
FC Midtjylla,1396,2,20,4,6,67,41,26,64
Copenhagen,1396,3,15,6,9,65,44,21,51
FC Nords,1396,4,14,7,9,74,54,20,49
AC Horsens,1396,5,7,12,11,36,54,-18,33
AaB,1396,6,7,11,12,35,47,-12,32
Sonderjyske,1396,7,8,6,10,28,29,-1,30
Lyngby,1396,8,4,9,11,31,44,-13,21
AGF Aarhus,1396,9,5,6,11,20,38,-18,21
Randers FC,1396,10,5,6,13,23,44,-21,21
Silkeborg IF,1396,11,5,3,14,27,48,-21,18
Brondby,1397,1,19,7,4,69,34,35,64
FC Midtjylla,1397,2,19,5,6,65,37,28,62
FC Nords,1397,3,15,7,8,71,48,23,52
Copenhagen,1397,4,14,6,10,55,43,12,48
AaB,1397,5,8,12,10,40,46,-6,36
AC Horsens,1397,6,6,13,11,37,55,-18,31
Sonderjyske,1397,7,8,6,10,28,29,-1,30
Lyngby,1397,8,4,9,11,28,45,-17,21
Randers FC,1397,9,5,6,13,24,41,-17,21
AGF Aarhus,1397,10,5,6,11,19,36,-17,21
Silkeborg IF,1397,11,5,3,14,25,47,-22,18
Brondby,1398,1,21,5,4,70,31,39,68
FC Midtjylla,1398,2,20,5,5,62,35,27,65
FC Nords,1398,3,16,6,8,73,54,19,54
Copenhagen,1398,4,12,5,13,51,42,9,41
AC Horsens,1398,5,7,14,9,36,49,-13,35
AaB,1398,6,7,11,12,35,42,-7,32
Sonderjyske,1398,7,8,6,10,28,29,-1,30
Silkeborg IF,1398,8,6,3,13,30,45,-15,21
Lyngby,1398,9,4,9,11,28,44,-16,21
Randers FC,1398,10,5,6,13,23,41,-18,21
AGF Aarhus,1398,11,4,6,12,17,41,-24,18
Brondby,1399,1,21,5,4,66,28,38,68
FC Midtjylla,1399,2,20,4,6,69,42,27,64
FC Nords,1399,3,16,6,8,77,49,28,54
Copenhagen,1399,4,14,4,12,57,51,6,46
AaB,1399,5,8,12,10,44,45,-1,36
Sonderjyske,1399,6,8,6,10,28,29,-1,30
AC Horsens,1399,7,5,13,12,32,56,-24,28
Randers FC,1399,8,6,6,12,26,40,-14,24
Silkeborg IF,1399,9,5,4,13,25,44,-19,19
AGF Aarhus,1399,10,4,7,11,16,36,-20,19
Lyngby,1399,11,3,9,12,27,47,-20,18
Brondby,1400,1,21,6,3,76,35,41,69
FC Midtjylla,1400,2,19,6,5,66,40,26,63
Copenhagen,1400,3,14,6,10,57,44,13,48
FC Nords,1400,4,13,8,9,72,51,21,47
AaB,1400,5,9,11,10,40,42,-2,38
Sonderjyske,1400,6,8,6,10,28,29,-1,30
AC Horsens,1400,7,5,13,12,29,54,-25,28
Randers FC,1400,8,6,6,12,24,39,-15,24
AGF Aarhus,1400,9,5,6,11,20,37,-17,21
Lyngby,1400,10,3,9,12,26,45,-19,18
Silkeborg IF,1400,11,5,3,14,26,48,-22,18
Brondby,1401,1,19,6,5,67,34,33,63
FC Midtjylla,1401,2,18,5,7,63,42,21,59
FC Nords,1401,3,14,8,8,68,47,21,50
Copenhagen,1401,4,15,5,10,59,45,14,50
AaB,1401,5,10,11,9,39,38,1,41
AC Horsens,1401,6,6,13,11,37,53,-16,31
Sonderjyske,1401,7,8,6,10,28,29,-1,30
Randers FC,1401,8,6,6,12,25,40,-15,24
AGF Aarhus,1401,9,5,6,11,17,36,-19,21
Lyngby,1401,10,3,9,12,27,46,-19,18
Silkeborg IF,1401,11,5,3,14,25,45,-20,18
Brondby,1402,1,21,7,2,71,29,42,70
FC Midtjylla,1402,2,18,5,7,60,43,17,59
FC Nords,1402,3,15,6,9,71,49,22,51
Copenhagen,1402,4,13,6,11,58,45,13,45
AaB,1402,5,8,13,9,40,43,-3,37
Sonderjyske,1402,6,8,6,10,28,29,-1,30
AC Horsens,1402,7,5,15,10,34,51,-17,30
Randers FC,1402,8,5,7,12,24,40,-16,22
Silkeborg IF,1402,9,6,3,13,29,46,-17,21
Lyngby,1402,10,3,10,11,27,45,-18,19
AGF Aarhus,1402,11,4,6,12,18,40,-22,18
Brondby,1403,1,21,6,3,73,34,39,69
FC Midtjylla,1403,2,21,5,4,72,41,31,68
FC Nords,1403,3,14,7,9,77,54,23,49
Copenhagen,1403,4,13,6,11,61,49,12,45
AaB,1403,5,6,13,11,35,44,-9,31
AC Horsens,1403,6,6,13,11,36,58,-22,31
Sonderjyske,1403,7,8,6,10,28,29,-1,30
Randers FC,1403,8,6,6,12,26,40,-14,24
AGF Aarhus,1403,9,5,6,11,19,37,-18,21
Lyngby,1403,10,3,9,12,27,47,-20,18
Silkeborg IF,1403,11,5,3,14,26,47,-21,18
Brondby,1404,1,21,7,2,79,35,44,70
FC Midtjylla,1404,2,18,6,6,69,46,23,60
Copenhagen,1404,3,14,7,9,63,45,18,49
FC Nords,1404,4,14,7,9,70,53,17,49
AC Horsens,1404,5,7,13,10,36,52,-16,34
Sonderjyske,1404,6,8,6,10,28,29,-1,30
AaB,1404,7,6,12,12,38,50,-12,30
Lyngby,1404,8,4,9,11,27,44,-17,21
Randers FC,1404,9,5,6,13,23,40,-17,21
AGF Aarhus,1404,10,5,6,11,18,36,-18,21
Silkeborg IF,1404,11,5,3,14,25,46,-21,18
Brondby,1405,1,21,7,2,75,31,44,70
FC Midtjylla,1405,2,20,5,5,66,38,28,65
FC Nords,1405,3,14,7,9,74,58,16,49
Copenhagen,1405,4,13,7,10,58,45,13,46
AaB,1405,5,8,11,11,39,45,-6,35
Sonderjyske,1405,6,8,6,10,28,29,-1,30
AC Horsens,1405,7,5,13,12,32,53,-21,28
Lyngby,1405,8,4,9,11,29,44,-15,21
Randers FC,1405,9,5,6,13,23,42,-19,21
AGF Aarhus,1405,10,5,6,11,18,37,-19,21
Silkeborg IF,1405,11,5,3,14,26,46,-20,18
Brondby,1406,1,21,5,4,74,35,39,68
FC Midtjylla,1406,2,21,5,4,71,37,34,68
FC Nords,1406,3,13,8,9,72,53,19,47
Copenhagen,1406,4,12,5,13,53,51,2,41
AC Horsens,1406,5,7,14,9,37,51,-14,35
AaB,1406,6,6,15,9,34,40,-6,33
Sonderjyske,1406,7,8,6,10,28,29,-1,30
Lyngby,1406,8,4,9,11,30,44,-14,21
Randers FC,1406,9,5,6,13,23,43,-20,21
Silkeborg IF,1406,10,5,4,13,26,45,-19,19
AGF Aarhus,1406,11,4,7,11,17,37,-20,19
Brondby,1407,1,19,6,5,65,33,32,63
FC Midtjylla,1407,2,19,4,7,64,40,24,61
Copenhagen,1407,3,16,5,9,60,38,22,53
FC Nords,1407,4,13,8,9,68,53,15,47
AaB,1407,5,8,13,9,37,41,-4,37
AC Horsens,1407,6,6,14,10,34,49,-15,32
Sonderjyske,1407,7,8,6,10,28,29,-1,30
Randers FC,1407,8,6,6,12,24,39,-15,24
Silkeborg IF,1407,9,6,3,13,27,44,-17,21
Lyngby,1407,10,3,9,12,26,45,-19,18
AGF Aarhus,1407,11,4,6,12,16,38,-22,18
Brondby,1408,1,21,5,4,69,34,35,68
FC Midtjylla,1408,2,20,4,6,67,38,29,64
FC Nords,1408,3,14,7,9,79,52,27,49
Copenhagen,1408,4,14,4,12,59,56,3,46
AaB,1408,5,8,12,10,35,39,-4,36
AC Horsens,1408,6,6,14,10,34,50,-16,32
Sonderjyske,1408,7,8,6,10,28,29,-1,30
Randers FC,1408,8,6,6,12,25,40,-15,24
AGF Aarhus,1408,9,5,6,11,17,36,-19,21
Lyngby,1408,10,3,9,12,27,46,-19,18
Silkeborg IF,1408,11,5,3,14,25,45,-20,18
Brondby,1409,1,20,7,3,71,31,40,67
FC Midtjylla,1409,2,19,5,6,64,39,25,62
FC Nords,1409,3,14,8,8,72,50,22,50
Copenhagen,1409,4,14,5,11,59,47,12,47
AC Horsens,1409,5,7,13,10,36,51,-15,34
AaB,1409,6,7,12,11,36,46,-10,33
Sonderjyske,1409,7,8,6,10,28,29,-1,30
Lyngby,1409,8,4,9,11,28,45,-17,21
Randers FC,1409,9,5,6,13,24,41,-17,21
Silkeborg IF,1409,10,6,3,13,28,46,-18,21
AGF Aarhus,1409,11,4,6,12,18,39,-21,18
Brondby,1410,1,22,5,3,73,32,41,71
FC Midtjylla,1410,2,18,6,6,64,40,24,60
FC Nords,1410,3,13,9,8,72,52,20,48
Copenhagen,1410,4,13,6,11,56,45,11,45
AaB,1410,5,9,11,10,41,42,-1,38
AC Horsens,1410,6,6,13,11,36,57,-21,31
Sonderjyske,1410,7,8,6,10,28,29,-1,30
Randers FC,1410,8,5,7,12,25,41,-16,22
Silkeborg IF,1410,9,6,3,13,26,44,-18,21
Lyngby,1410,10,3,10,11,28,46,-18,19
AGF Aarhus,1410,11,4,6,12,16,37,-21,18
FC Midtjylla,1411,1,21,4,5,63,34,29,67
Brondby,1411,2,20,5,5,72,39,33,65
FC Nords,1411,3,15,6,9,77,54,23,51
Copenhagen,1411,4,14,4,12,61,49,12,46
AaB,1411,5,8,11,11,39,43,-4,35
AC Horsens,1411,6,7,12,11,36,55,-19,33
Sonderjyske,1411,7,8,6,10,28,29,-1,30
Lyngby,1411,8,4,9,11,30,44,-14,21
Silkeborg IF,1411,9,6,3,13,27,44,-17,21
Randers FC,1411,10,5,6,13,23,43,-20,21
AGF Aarhus,1411,11,4,6,12,16,38,-22,18
Brondby,1412,1,21,6,3,74,31,43,69
FC Midtjylla,1412,2,18,7,5,64,39,25,61
FC Nords,1412,3,15,7,8,74,53,21,52
Copenhagen,1412,4,15,4,11,58,44,14,49
AaB,1412,5,8,11,11,36,42,-6,35
Sonderjyske,1412,6,8,6,10,28,29,-1,30
AC Horsens,1412,7,5,13,12,32,55,-23,28
Randers FC,1412,8,6,6,12,25,40,-15,24
Silkeborg IF,1412,9,6,3,13,26,44,-18,21
Lyngby,1412,10,3,9,12,27,46,-19,18
AGF Aarhus,1412,11,4,6,12,16,37,-21,18
Brondby,1413,1,20,7,3,70,34,36,67
FC Midtjylla,1413,2,19,4,7,67,41,26,61
FC Nords,1413,3,16,6,8,74,45,29,54
Copenhagen,1413,4,14,6,10,58,44,14,48
AC Horsens,1413,5,6,14,10,35,56,-21,32
AaB,1413,6,6,13,11,36,46,-10,31
Sonderjyske,1413,7,8,6,10,28,29,-1,30
Lyngby,1413,8,4,9,11,28,44,-16,21
Silkeborg IF,1413,9,6,3,13,27,45,-18,21
Randers FC,1413,10,5,6,13,23,41,-18,21
AGF Aarhus,1413,11,4,6,12,17,38,-21,18
Brondby,1414,1,22,5,3,74,32,42,71
FC Midtjylla,1414,2,18,5,7,65,43,22,59
FC Nords,1414,3,15,6,9,77,52,25,51
Copenhagen,1414,4,14,4,12,59,48,11,46
AC Horsens,1414,5,8,12,10,36,50,-14,36
AaB,1414,6,7,12,11,37,49,-12,33
Sonderjyske,1414,7,8,6,10,28,29,-1,30
Lyngby,1414,8,4,9,11,27,44,-17,21
Randers FC,1414,9,5,6,13,23,40,-17,21
AGF Aarhus,1414,10,5,6,11,17,36,-19,21
Silkeborg IF,1414,11,5,3,14,25,45,-20,18
Brondby,1415,1,21,7,2,71,30,41,70
FC Midtjylla,1415,2,19,5,6,70,41,29,62
Copenhagen,1415,3,15,5,10,61,45,16,50
FC Nords,1415,4,13,6,11,72,59,13,45
AC Horsens,1415,5,7,13,10,36,52,-16,34
AaB,1415,6,7,12,11,40,49,-9,33
Sonderjyske,1415,7,8,6,10,28,29,-1,30
Lyngby,1415,8,4,9,11,29,45,-16,21
Silkeborg IF,1415,9,6,3,13,27,44,-17,21
Randers FC,1415,10,5,6,13,24,42,-18,21
AGF Aarhus,1415,11,4,6,12,16,38,-22,18
Brondby,1416,1,19,6,5,65,34,31,63
FC Midtjylla,1416,2,17,6,7,60,39,21,57
FC Nords,1416,3,15,6,9,74,49,25,51
Copenhagen,1416,4,14,6,10,59,45,14,48
AaB,1416,5,10,12,8,41,39,2,42
AC Horsens,1416,6,7,12,11,38,57,-19,33
Sonderjyske,1416,7,8,6,10,28,29,-1,30
Lyngby,1416,8,4,9,11,28,45,-17,21
Randers FC,1416,9,5,6,13,24,41,-17,21
AGF Aarhus,1416,10,5,6,11,18,36,-18,21
Silkeborg IF,1416,11,5,3,14,25,46,-21,18
Brondby,1417,1,22,5,3,77,29,48,71
FC Midtjylla,1417,2,20,4,6,62,38,24,64
FC Nords,1417,3,15,6,9,73,54,19,51
Copenhagen,1417,4,13,4,13,53,46,7,43
AaB,1417,5,10,11,9,39,37,2,41
Sonderjyske,1417,6,8,6,10,28,29,-1,30
AC Horsens,1417,7,5,12,13,32,58,-26,27
Lyngby,1417,8,4,9,11,31,46,-15,21
AGF Aarhus,1417,9,5,6,11,18,36,-18,21
Randers FC,1417,10,5,6,13,25,44,-19,21
Silkeborg IF,1417,11,5,3,14,25,46,-21,18
Brondby,1418,1,20,5,5,65,33,32,65
FC Midtjylla,1418,2,19,4,7,63,39,24,61
FC Nords,1418,3,15,6,9,76,50,26,51
Copenhagen,1418,4,14,5,11,59,45,14,47
AaB,1418,5,9,12,9,36,41,-5,39
AC Horsens,1418,6,7,12,11,35,52,-17,33
Sonderjyske,1418,7,8,6,10,28,29,-1,30
Lyngby,1418,8,4,9,11,29,45,-16,21
Randers FC,1418,9,5,6,13,24,42,-18,21
Silkeborg IF,1418,10,5,4,13,26,45,-19,19
AGF Aarhus,1418,11,4,7,11,17,37,-20,19
Brondby,1419,1,21,6,3,69,31,38,69
FC Midtjylla,1419,2,18,4,8,62,43,19,58
FC Nords,1419,3,15,7,8,75,52,23,52
Copenhagen,1419,4,14,6,10,56,41,15,48
AaB,1419,5,8,13,9,38,40,-2,37
Sonderjyske,1419,6,8,6,10,28,29,-1,30
AC Horsens,1419,7,5,14,11,33,52,-19,29
Lyngby,1419,8,4,9,11,31,45,-14,21
AGF Aarhus,1419,9,5,6,11,17,36,-19,21
Randers FC,1419,10,5,6,13,24,44,-20,21
Silkeborg IF,1419,11,5,3,14,25,45,-20,18
Brondby,1420,1,21,5,4,72,34,38,68
FC Midtjylla,1420,2,20,5,5,69,42,27,65
Copenhagen,1420,3,15,5,10,58,45,13,50
FC Nords,1420,4,12,8,10,73,57,16,44
AC Horsens,1420,5,7,13,10,36,51,-15,34
AaB,1420,6,7,12,11,37,42,-5,33
Sonderjyske,1420,7,8,6,10,28,29,-1,30
Lyngby,1420,8,4,9,11,28,44,-16,21
Randers FC,1420,9,5,6,13,23,41,-18,21
AGF Aarhus,1420,10,5,6,11,18,36,-18,21
Silkeborg IF,1420,11,5,3,14,25,46,-21,18
FC Midtjylla,1421,1,22,4,4,69,36,33,70
Brondby,1421,2,21,5,4,72,33,39,68
FC Nords,1421,3,13,7,10,69,53,16,46
Copenhagen,1421,4,13,6,11,58,47,11,45
AaB,1421,5,7,12,11,36,45,-9,33
AC Horsens,1421,6,6,14,10,38,54,-16,32
Sonderjyske,1421,7,8,6,10,28,29,-1,30
Lyngby,1421,8,4,9,11,28,45,-17,21
Silkeborg IF,1421,8,6,3,13,28,45,-17,21
Randers FC,1421,10,5,6,13,24,41,-17,21
AGF Aarhus,1421,11,4,6,12,17,39,-22,18
Brondby,1422,1,22,5,3,72,32,40,71
FC Midtjylla,1422,2,19,6,5,64,38,26,63
FC Nords,1422,3,15,6,9,72,51,21,51
Copenhagen,1422,4,12,6,12,53,44,9,42
AC Horsens,1422,5,7,13,10,33,48,-15,34
AaB,1422,6,7,12,11,38,45,-7,33
Sonderjyske,1422,7,8,6,10,28,29,-1,30
Randers FC,1422,8,6,6,12,25,40,-15,24
Silkeborg IF,1422,9,6,3,13,28,45,-17,21
Lyngby,1422,10,3,9,12,27,46,-19,18
AGF Aarhus,1422,11,4,6,12,17,39,-22,18
Brondby,1423,1,20,7,3,73,35,38,67
FC Midtjylla,1423,2,20,5,5,67,40,27,65
FC Nords,1423,3,14,8,8,78,54,24,50
Copenhagen,1423,4,13,6,11,56,45,11,45
AaB,1423,5,7,13,10,35,43,-8,34
AC Horsens,1423,6,6,13,11,37,55,-18,31
Sonderjyske,1423,7,8,6,10,28,29,-1,30
Randers FC,1423,8,5,7,12,23,39,-16,22
Silkeborg IF,1423,9,6,3,13,27,44,-17,21
Lyngby,1423,10,3,10,11,26,44,-18,19
AGF Aarhus,1423,11,4,6,12,16,38,-22,18
Brondby,1424,1,20,5,5,67,34,33,65
FC Midtjylla,1424,2,19,5,6,64,39,25,62
FC Nords,1424,3,17,6,7,76,46,30,57
Copenhagen,1424,4,14,4,12,56,43,13,46
AaB,1424,5,7,13,10,37,44,-7,34
AC Horsens,1424,6,6,13,11,32,52,-20,31
Sonderjyske,1424,7,8,6,10,28,29,-1,30
Lyngby,1424,8,4,9,11,29,45,-16,21
Silkeborg IF,1424,9,6,3,13,26,44,-18,21
Randers FC,1424,10,5,6,13,24,42,-18,21
AGF Aarhus,1424,11,4,6,12,16,37,-21,18
Brondby,1425,1,22,5,3,71,31,40,71
FC Midtjylla,1425,2,21,4,5,63,37,26,67
FC Nords,1425,3,15,6,9,73,48,25,51
Copenhagen,1425,4,14,4,12,58,45,13,46
AaB,1425,5,7,11,12,41,48,-7,32
Sonderjyske,1425,6,8,6,10,28,29,-1,30
AC Horsens,1425,7,6,12,12,36,59,-23,30
Randers FC,1425,8,6,6,12,26,41,-15,24
Silkeborg IF,1425,9,6,3,13,27,44,-17,21
Lyngby,1425,10,3,9,12,28,47,-19,18
AGF Aarhus,1425,11,4,6,12,16,38,-22,18
Brondby,1426,1,21,5,4,68,33,35,68
FC Midtjylla,1426,2,20,5,5,65,37,28,65
Copenhagen,1426,3,14,5,11,57,45,12,47
FC Nords,1426,4,13,7,10,73,52,21,46
AC Horsens,1426,5,7,14,9,34,47,-13,35
AaB,1426,6,7,12,11,34,43,-9,33
Sonderjyske,1426,7,8,6,10,28,29,-1,30
Lyngby,1426,8,4,9,11,27,44,-17,21
Randers FC,1426,9,5,6,13,23,40,-17,21
AGF Aarhus,1426,10,5,6,11,19,36,-17,21
Silkeborg IF,1426,11,5,3,14,25,47,-22,18
Brondby,1427,1,22,5,3,77,35,42,71
FC Midtjylla,1427,2,19,5,6,70,45,25,62
Copenhagen,1427,3,15,5,10,64,46,18,50
FC Nords,1427,4,14,7,9,73,54,19,49
AaB,1427,5,7,12,11,34,42,-8,33
Sonderjyske,1427,6,8,6,10,28,29,-1,30
AC Horsens,1427,7,5,14,11,34,56,-22,29
Randers FC,1427,8,5,7,12,25,41,-16,22
Lyngby,1427,9,3,10,11,28,46,-18,19
Silkeborg IF,1427,10,5,4,13,25,44,-19,19
AGF Aarhus,1427,11,4,7,11,16,36,-20,19
Brondby,1428,1,20,7,3,68,31,37,67
FC Midtjylla,1428,2,20,5,5,64,39,25,65
FC Nords,1428,3,14,6,10,72,54,18,48
Copenhagen,1428,4,14,5,11,58,44,14,47
AaB,1428,5,8,11,11,38,43,-5,35
AC Horsens,1428,6,7,12,11,35,50,-15,33
Sonderjyske,1428,7,8,6,10,28,29,-1,30
Lyngby,1428,8,4,9,11,28,45,-17,21
Randers FC,1428,9,5,6,13,24,41,-17,21
Silkeborg IF,1428,10,6,3,13,27,45,-18,21
AGF Aarhus,1428,11,4,6,12,17,38,-21,18
Brondby,1429,1,22,6,2,75,33,42,72
FC Midtjylla,1429,2,19,5,6,65,39,26,62
Copenhagen,1429,3,15,5,10,63,45,18,50
FC Nords,1429,4,14,6,10,73,58,15,48
AaB,1429,5,6,13,11,39,48,-9,31
AC Horsens,1429,6,6,13,11,33,51,-18,31
Sonderjyske,1429,7,8,6,10,28,29,-1,30
Randers FC,1429,8,6,6,12,25,39,-14,24
Silkeborg IF,1429,9,5,4,13,26,45,-19,19
AGF Aarhus,1429,10,4,7,11,17,37,-20,19
Lyngby,1429,11,3,9,12,26,46,-20,18
Brondby,1430,1,22,5,3,79,33,46,71
FC Midtjylla,1430,2,20,4,6,69,40,29,64
FC Nords,1430,3,14,7,9,75,52,23,49
Copenhagen,1430,4,13,5,12,52,45,7,44
AaB,1430,5,8,11,11,35,46,-11,35
AC Horsens,1430,6,7,12,11,35,55,-20,33
Sonderjyske,1430,7,8,6,10,28,29,-1,30
Lyngby,1430,8,4,9,11,27,44,-17,21
Randers FC,1430,9,5,6,13,23,40,-17,21
Silkeborg IF,1430,10,6,3,13,27,45,-18,21
AGF Aarhus,1430,11,4,6,12,17,38,-21,18
Brondby,1431,1,22,5,3,70,31,39,71
FC Midtjylla,1431,2,19,4,7,63,40,23,61
FC Nords,1431,3,14,7,9,73,51,22,49
Copenhagen,1431,4,13,6,11,55,45,10,45
AC Horsens,1431,5,7,14,9,39,53,-14,35
AaB,1431,6,7,12,11,36,42,-6,33
Sonderjyske,1431,7,8,6,10,28,29,-1,30
Lyngby,1431,8,4,9,11,27,44,-17,21
Randers FC,1431,9,5,6,13,23,40,-17,21
Silkeborg IF,1431,10,6,3,13,27,45,-18,21
AGF Aarhus,1431,11,4,6,12,17,38,-21,18
Brondby,1432,1,22,6,2,71,32,39,72
FC Midtjylla,1432,2,20,4,6,68,36,32,64
FC Nords,1432,3,14,6,10,71,49,22,48
Copenhagen,1432,4,14,5,11,59,47,12,47
AaB,1432,5,7,12,11,33,40,-7,33
AC Horsens,1432,6,6,13,11,31,55,-24,31
Sonderjyske,1432,7,8,6,10,28,29,-1,30
Lyngby,1432,8,4,9,11,27,44,-17,21
Randers FC,1432,9,5,6,13,23,40,-17,21
Silkeborg IF,1432,10,5,4,13,25,44,-19,19
AGF Aarhus,1432,11,4,7,11,16,36,-20,19
Brondby,1433,1,20,7,3,70,31,39,67
FC Midtjylla,1433,2,20,5,5,64,36,28,65
FC Nords,1433,3,14,6,10,76,61,15,48
Copenhagen,1433,4,14,5,11,56,43,13,47
AC Horsens,1433,5,8,12,10,41,53,-12,36
AaB,1433,6,7,11,12,36,45,-9,32
Sonderjyske,1433,7,8,6,10,28,29,-1,30
Randers FC,1433,8,6,6,12,25,39,-14,24
Silkeborg IF,1433,9,6,3,13,27,45,-18,21
Lyngby,1433,10,3,9,12,26,46,-20,18
AGF Aarhus,1433,11,4,6,12,17,38,-21,18
Brondby,1434,1,20,6,4,66,35,31,66
FC Midtjylla,1434,2,20,4,6,72,38,34,64
FC Nords,1434,3,16,7,7,83,50,33,55
Copenhagen,1434,4,14,5,11,59,47,12,47
AaB,1434,5,7,13,10,37,43,-6,34
Sonderjyske,1434,6,8,6,10,28,29,-1,30
AC Horsens,1434,7,5,13,12,31,61,-30,28
Lyngby,1434,8,4,9,11,29,45,-16,21
Silkeborg IF,1434,9,6,3,13,28,45,-17,21
Randers FC,1434,10,5,6,13,24,42,-18,21
AGF Aarhus,1434,11,4,6,12,17,39,-22,18
Brondby,1435,1,22,6,2,73,31,42,72
FC Midtjylla,1435,2,19,5,6,61,39,22,62
FC Nords,1435,3,15,6,9,74,50,24,51
Copenhagen,1435,4,15,4,11,60,42,18,49
AC Horsens,1435,5,6,13,11,33,50,-17,31
Sonderjyske,1435,6,8,6,10,28,29,-1,30
AaB,1435,7,6,12,12,32,47,-15,30
Lyngby,1435,8,4,9,11,27,44,-17,21
Silkeborg IF,1435,8,6,3,13,27,44,-17,21
Randers FC,1435,10,5,6,13,23,40,-17,21
AGF Aarhus,1435,11,4,6,12,16,38,-22,18
FC Midtjylla,1436,1,21,4,5,70,39,31,67
Brondby,1436,2,20,5,5,68,38,30,65
FC Nords,1436,3,15,6,9,72,50,22,51
Copenhagen,1436,4,13,6,11,55,47,8,45
AaB,1436,5,8,12,10,44,42,2,36
AC Horsens,1436,6,6,13,11,35,54,-19,31
Sonderjyske,1436,7,8,6,10,28,29,-1,30
Lyngby,1436,8,4,9,11,27,44,-17,21
Randers FC,1436,9,5,6,13,23,40,-17,21
Silkeborg IF,1436,10,5,4,13,25,44,-19,19
AGF Aarhus,1436,11,4,7,11,16,36,-20,19
Brondby,1437,1,20,6,4,70,35,35,66
FC Midtjylla,1437,2,20,4,6,69,41,28,64
Copenhagen,1437,3,15,5,10,57,43,14,50
FC Nords,1437,4,13,7,10,70,52,18,46
AaB,1437,5,7,13,10,40,45,-5,34
AC Horsens,1437,6,7,13,10,35,51,-16,34
Sonderjyske,1437,7,8,6,10,28,29,-1,30
Randers FC,1437,8,6,6,12,25,40,-15,24
Silkeborg IF,1437,9,6,3,13,26,44,-18,21
Lyngby,1437,10,3,9,12,27,46,-19,18
AGF Aarhus,1437,11,4,6,12,16,37,-21,18
Brondby,1438,1,21,7,2,72,33,39,70
FC Midtjylla,1438,2,17,6,7,61,44,17,57
FC Nords,1438,3,14,8,8,76,48,28,50
Copenhagen,1438,4,13,4,13,53,45,8,43
AaB,1438,5,8,13,9,36,40,-4,37
AC Horsens,1438,6,6,16,8,35,49,-14,34
Sonderjyske,1438,7,8,6,10,28,29,-1,30
Lyngby,1438,8,4,9,11,30,44,-14,21
Silkeborg IF,1438,9,6,3,13,26,44,-18,21
Randers FC,1438,10,5,6,13,23,43,-20,21
AGF Aarhus,1438,11,4,6,12,16,37,-21,18
FC Midtjylla,1439,1,20,6,4,67,35,32,66
Brondby,1439,2,19,6,5,66,35,31,63
FC Nords,1439,3,13,7,10,71,50,21,46
Copenhagen,1439,4,13,5,12,53,42,11,44
AaB,1439,5,8,13,9,36,42,-6,37
AC Horsens,1439,6,8,13,9,34,49,-15,37
Sonderjyske,1439,7,8,6,10,28,29,-1,30
Randers FC,1439,8,5,7,12,24,40,-16,22
Lyngby,1439,9,3,10,11,27,45,-18,19
Silkeborg IF,1439,10,5,4,13,25,44,-19,19
AGF Aarhus,1439,11,4,7,11,16,36,-20,19
FC Midtjylla,1440,1,21,5,4,73,39,34,68
Brondby,1440,2,20,6,4,73,38,35,66
Copenhagen,1440,3,14,5,11,59,47,12,47
FC Nords,1440,4,13,7,10,73,55,18,46
AaB,1440,5,6,15,9,37,42,-5,33
AC Horsens,1440,6,7,12,11,38,58,-20,33
Sonderjyske,1440,7,8,6,10,28,29,-1,30
Lyngby,1440,8,4,9,11,29,44,-15,21
Silkeborg IF,1440,9,6,3,13,26,44,-18,21
Randers FC,1440,10,5,6,13,23,42,-19,21
AGF Aarhus,1440,11,4,6,12,16,37,-21,18
Brondby,1441,1,21,5,4,69,32,37,68
FC Midtjylla,1441,2,20,5,5,68,38,30,65
FC Nords,1441,3,13,7,10,70,55,15,46
Copenhagen,1441,4,13,4,13,54,47,7,43
AaB,1441,5,8,13,9,39,41,-2,37
AC Horsens,1441,6,7,14,9,34,47,-13,35
Sonderjyske,1441,7,8,6,10,28,29,-1,30
Silkeborg IF,1441,8,6,3,13,29,46,-17,21
Lyngby,1441,9,4,9,11,27,44,-17,21
Randers FC,1441,10,5,6,13,23,40,-17,21
AGF Aarhus,1441,11,4,6,12,18,40,-22,18
Brondby,1442,1,21,6,3,69,31,38,69
FC Midtjylla,1442,2,19,5,6,63,37,26,62
FC Nords,1442,3,15,7,8,75,51,24,52
Copenhagen,1442,4,15,4,11,59,44,15,49
AaB,1442,5,7,11,12,33,43,-10,32
AC Horsens,1442,6,6,13,11,34,53,-19,31
Sonderjyske,1442,7,8,6,10,28,29,-1,30
Randers FC,1442,8,6,6,12,25,39,-14,24
Silkeborg IF,1442,9,6,3,13,29,45,-16,21
Lyngby,1442,10,3,9,12,26,46,-20,18
AGF Aarhus,1442,11,4,6,12,17,40,-23,18
Brondby,1443,1,21,6,3,71,31,40,69
FC Midtjylla,1443,2,21,4,5,67,40,27,67
FC Nords,1443,3,15,7,8,77,49,28,52
Copenhagen,1443,4,13,4,13,55,52,3,43
AC Horsens,1443,5,7,12,11,39,52,-13,33
AaB,1443,6,7,11,12,35,46,-11,32
Sonderjyske,1443,7,8,6,10,28,29,-1,30
Randers FC,1443,8,6,6,12,24,39,-15,24
AGF Aarhus,1443,9,5,6,11,17,36,-19,21
Lyngby,1443,10,3,9,12,26,45,-19,18
Silkeborg IF,1443,11,5,3,14,25,45,-20,18
Brondby,1444,1,21,6,3,69,35,34,69
FC Midtjylla,1444,2,18,5,7,64,43,21,59
FC Nords,1444,3,14,7,9,74,53,21,49
Copenhagen,1444,4,13,5,12,57,47,10,44
AaB,1444,5,10,11,9,44,41,3,41
AC Horsens,1444,6,6,14,10,37,52,-15,32
Sonderjyske,1444,7,8,6,10,28,29,-1,30
Lyngby,1444,8,4,9,11,29,45,-16,21
Randers FC,1444,9,5,6,13,24,42,-18,21
AGF Aarhus,1444,10,5,6,11,19,37,-18,21
Silkeborg IF,1444,11,5,3,14,26,47,-21,18
Brondby,1445,1,21,6,3,72,33,39,69
FC Midtjylla,1445,2,20,5,5,70,41,29,65
FC Nords,1445,3,15,6,9,75,53,22,51
Copenhagen,1445,4,13,5,12,55,45,10,44
AC Horsens,1445,5,7,14,9,39,53,-14,35
Sonderjyske,1445,6,8,6,10,28,29,-1,30
AaB,1445,7,6,12,12,33,45,-12,30
Lyngby,1445,8,4,9,11,29,46,-17,21
Randers FC,1445,9,5,6,13,25,42,-17,21
AGF Aarhus,1445,10,5,6,11,17,36,-19,21
Silkeborg IF,1445,11,5,3,14,25,45,-20,18
FC Midtjylla,1446,1,20,5,5,69,41,28,65
Brondby,1446,2,19,7,4,69,36,33,64
FC Nords,1446,3,14,6,10,75,55,20,48
Copenhagen,1446,4,13,5,12,56,46,10,44
AaB,1446,5,8,13,9,43,43,0,37
AC Horsens,1446,6,8,12,10,37,54,-17,36
Sonderjyske,1446,7,8,6,10,28,29,-1,30
Randers FC,1446,8,6,6,12,25,40,-15,24
Silkeborg IF,1446,9,6,3,13,29,45,-16,21
Lyngby,1446,10,3,9,12,27,46,-19,18
AGF Aarhus,1446,11,4,6,12,17,40,-23,18
Brondby,1447,1,20,8,2,66,28,38,68
FC Midtjylla,1447,2,17,8,5,60,37,23,59
FC Nords,1447,3,13,8,9,70,51,19,47
Copenhagen,1447,4,12,7,11,56,48,8,43
AaB,1447,5,8,13,9,41,43,-2,37
AC Horsens,1447,6,8,12,10,38,50,-12,36
Sonderjyske,1447,7,8,6,10,28,29,-1,30
Lyngby,1447,8,4,9,11,27,44,-17,21
Randers FC,1447,9,5,6,13,23,40,-17,21
AGF Aarhus,1447,10,5,6,11,19,38,-19,21
Silkeborg IF,1447,11,5,3,14,27,47,-20,18
Brondby,1448,1,21,5,4,76,36,40,68
FC Midtjylla,1448,2,20,6,4,73,40,33,66
FC Nords,1448,3,14,6,10,79,55,24,48
Copenhagen,1448,4,13,6,11,55,48,7,45
AC Horsens,1448,5,7,13,10,38,58,-20,34
AaB,1448,6,7,12,11,39,49,-10,33
Sonderjyske,1448,7,8,6,10,28,29,-1,30
Randers FC,1448,8,5,7,12,28,44,-16,22
AGF Aarhus,1448,9,5,6,11,19,38,-19,21
Lyngby,1448,10,3,10,11,31,49,-18,19
Silkeborg IF,1448,11,5,3,14,27,47,-20,18
Brondby,1449,1,21,5,4,68,34,34,68
FC Midtjylla,1449,2,20,5,5,62,37,25,65
FC Nords,1449,3,16,6,8,77,48,29,54
Copenhagen,1449,4,12,5,13,55,50,5,41
AC Horsens,1449,5,7,14,9,40,51,-11,35
AaB,1449,6,7,11,12,37,45,-8,32
Sonderjyske,1449,7,8,6,10,28,29,-1,30
Randers FC,1449,8,5,7,12,24,40,-16,22
Silkeborg IF,1449,9,6,3,13,26,44,-18,21
Lyngby,1449,10,3,10,11,27,45,-18,19
AGF Aarhus,1449,11,4,6,12,16,37,-21,18
Brondby,1450,1,20,6,4,67,33,34,66
FC Midtjylla,1450,2,20,4,6,65,39,26,64
FC Nords,1450,3,14,6,10,77,52,25,48
Copenhagen,1450,4,13,6,11,56,48,8,45
AaB,1450,5,8,12,10,38,43,-5,36
AC Horsens,1450,6,8,12,10,36,50,-14,36
Sonderjyske,1450,7,8,6,10,28,29,-1,30
Randers FC,1450,8,6,6,12,27,40,-13,24
Silkeborg IF,1450,9,5,4,13,26,45,-19,19
AGF Aarhus,1450,10,4,7,11,17,37,-20,19
Lyngby,1450,11,3,9,12,27,48,-21,18
Brondby,1451,1,20,5,5,67,33,34,65
FC Midtjylla,1451,2,19,5,6,67,41,26,62
FC Nords,1451,3,14,7,9,73,51,22,49
Copenhagen,1451,4,15,4,11,59,45,14,49
AC Horsens,1451,5,8,14,8,35,46,-11,38
AaB,1451,6,7,11,12,35,46,-11,32
Sonderjyske,1451,7,8,6,10,28,29,-1,30
Randers FC,1451,8,6,6,12,25,39,-14,24
AGF Aarhus,1451,9,5,6,11,19,38,-19,21
Silkeborg IF,1451,10,5,3,14,27,47,-20,18
Lyngby,1451,11,3,9,12,26,46,-20,18
Brondby,1452,1,21,5,4,73,38,35,68
FC Midtjylla,1452,2,21,5,4,68,37,31,68
FC Nords,1452,3,14,7,9,73,52,21,49
Copenhagen,1452,4,14,5,11,63,49,14,47
AC Horsens,1452,5,7,13,10,37,53,-16,34
Sonderjyske,1452,6,8,6,10,28,29,-1,30
AaB,1452,7,6,11,13,34,45,-11,29
Silkeborg IF,1452,8,6,3,13,29,44,-15,21
Lyngby,1452,9,4,9,11,28,45,-17,21
Randers FC,1452,10,5,6,13,24,41,-17,21
AGF Aarhus,1452,11,4,6,12,16,40,-24,18
Brondby,1453,1,21,6,3,72,37,35,69
FC Midtjylla,1453,2,19,5,6,66,42,24,62
FC Nords,1453,3,14,7,9,73,51,22,49
Copenhagen,1453,4,14,5,11,61,45,16,47
AaB,1453,5,8,13,9,38,39,-1,37
Sonderjyske,1453,6,8,6,10,28,29,-1,30
AC Horsens,1453,7,6,12,12,33,55,-22,30
Lyngby,1453,8,4,9,11,29,45,-16,21
Silkeborg IF,1453,9,6,3,13,28,44,-16,21
Randers FC,1453,10,5,6,13,24,42,-18,21
AGF Aarhus,1453,11,4,6,12,16,39,-23,18
FC Midtjylla,1454,1,22,4,4,69,37,32,70
Brondby,1454,2,19,7,4,65,34,31,64
Copenhagen,1454,3,14,6,10,60,41,19,48
FC Nords,1454,4,13,7,10,72,57,15,46
AaB,1454,5,7,13,10,36,42,-6,34
Sonderjyske,1454,6,8,6,10,28,29,-1,30
AC Horsens,1454,7,5,15,10,39,56,-17,30
Randers FC,1454,8,6,6,12,26,40,-14,24
Silkeborg IF,1454,9,6,3,13,28,44,-16,21
Lyngby,1454,10,3,9,12,27,47,-20,18
AGF Aarhus,1454,11,4,6,12,16,39,-23,18
Brondby,1455,1,22,6,2,82,36,46,72
FC Midtjylla,1455,2,18,6,6,64,44,20,60
FC Nords,1455,3,14,7,9,73,54,19,49
Copenhagen,1455,4,14,6,10,61,48,13,48
AaB,1455,5,8,11,11,39,42,-3,35
Sonderjyske,1455,6,8,6,10,28,29,-1,30
AC Horsens,1455,7,6,12,12,34,55,-21,30
Randers FC,1455,8,5,7,12,24,40,-16,22
AGF Aarhus,1455,9,5,6,11,20,37,-17,21
Lyngby,1455,10,3,10,11,27,45,-18,19
Silkeborg IF,1455,11,5,3,14,26,48,-22,18
FC Midtjylla,1456,1,21,5,4,69,38,31,68
Brondby,1456,2,20,5,5,67,33,34,65
Copenhagen,1456,3,15,5,10,58,39,19,50
FC Nords,1456,4,14,6,10,72,54,18,48
AC Horsens,1456,5,7,12,11,36,52,-16,33
AaB,1456,6,7,11,12,34,46,-12,32
Sonderjyske,1456,7,8,6,10,28,29,-1,30
Randers FC,1456,8,6,6,12,26,41,-15,24
Silkeborg IF,1456,9,5,4,13,26,45,-19,19
AGF Aarhus,1456,10,4,7,11,17,37,-20,19
Lyngby,1456,11,3,9,12,28,47,-19,18
Brondby,1457,1,19,7,4,69,36,33,64
FC Midtjylla,1457,2,18,6,6,63,39,24,60
FC Nords,1457,3,15,8,7,80,51,29,53
Copenhagen,1457,4,15,4,11,59,45,14,49
AaB,1457,5,8,12,10,39,42,-3,36
AC Horsens,1457,6,6,13,11,34,57,-23,31
Sonderjyske,1457,7,8,6,10,28,29,-1,30
Silkeborg IF,1457,8,6,3,13,29,45,-16,21
Lyngby,1457,9,4,9,11,29,46,-17,21
Randers FC,1457,10,5,6,13,25,42,-17,21
AGF Aarhus,1457,11,4,6,12,17,40,-23,18
Brondby,1458,1,21,6,3,73,34,39,69
FC Midtjylla,1458,2,20,5,5,69,40,29,65
Copenhagen,1458,3,15,5,10,64,46,18,50
FC Nords,1458,4,13,7,10,74,56,18,46
AaB,1458,5,7,12,11,37,45,-8,33
AC Horsens,1458,6,6,13,11,37,59,-22,31
Sonderjyske,1458,7,8,6,10,28,29,-1,30
Randers FC,1458,8,6,6,12,25,39,-14,24
AGF Aarhus,1458,9,5,6,11,20,38,-18,21
Lyngby,1458,10,3,9,12,26,46,-20,18
Silkeborg IF,1458,11,5,3,14,27,48,-21,18
Brondby,1459,1,22,6,2,71,29,42,72
FC Midtjylla,1459,2,18,6,6,62,41,21,60
FC Nords,1459,3,15,7,8,74,47,27,52
Copenhagen,1459,4,13,4,13,57,48,9,43
AC Horsens,1459,5,7,13,10,33,51,-18,34
AaB,1459,6,7,12,11,39,46,-7,33
Sonderjyske,1459,7,8,6,10,28,29,-1,30
Randers FC,1459,8,6,6,12,25,40,-15,24
Silkeborg IF,1459,9,6,3,13,27,45,-18,21
Lyngby,1459,10,3,9,12,27,46,-19,18
AGF Aarhus,1459,11,4,6,12,17,38,-21,18
FC Midtjylla,1460,1,21,4,5,67,38,29,67
Brondby,1460,2,20,6,4,65,32,33,66
FC Nords,1460,3,14,6,10,74,48,26,48
Copenhagen,1460,4,14,4,12,58,47,11,46
AaB,1460,5,8,12,10,38,45,-7,36
AC Horsens,1460,6,7,12,11,36,54,-18,33
Sonderjyske,1460,7,8,6,10,28,29,-1,30
Randers FC,1460,8,6,6,12,26,41,-15,24
AGF Aarhus,1460,9,5,6,11,19,36,-17,21
Lyngby,1460,10,3,9,12,28,47,-19,18
Silkeborg IF,1460,11,5,3,14,25,47,-22,18
Brondby,1461,1,22,5,3,75,27,48,71
FC Midtjylla,1461,2,20,4,6,69,42,27,64
Copenhagen,1461,3,17,4,9,58,40,18,55
FC Nords,1461,4,13,6,11,68,54,14,45
AaB,1461,5,7,11,12,33,45,-12,32
Sonderjyske,1461,6,8,6,10,28,29,-1,30
AC Horsens,1461,7,6,12,12,32,53,-21,30
Randers FC,1461,8,5,7,12,24,40,-16,22
Lyngby,1461,9,3,10,11,27,45,-18,19
Silkeborg IF,1461,10,5,4,13,25,44,-19,19
AGF Aarhus,1461,11,4,7,11,16,36,-20,19
Brondby,1462,1,20,6,4,72,36,36,66
FC Midtjylla,1462,2,18,5,7,65,45,20,59
FC Nords,1462,3,15,7,8,74,49,25,52
Copenhagen,1462,4,15,6,9,57,39,18,51
AaB,1462,5,7,12,11,37,46,-9,33
AC Horsens,1462,6,6,14,10,35,51,-16,32
Sonderjyske,1462,7,8,6,10,28,29,-1,30
Randers FC,1462,8,6,6,12,26,40,-14,24
Silkeborg IF,1462,9,6,3,13,27,45,-18,21
Lyngby,1462,10,3,9,12,27,47,-20,18
AGF Aarhus,1462,11,4,6,12,17,38,-21,18
Brondby,1463,1,21,5,4,72,33,39,68
FC Midtjylla,1463,2,20,4,6,68,40,28,64
FC Nords,1463,3,14,7,9,73,54,19,49
Copenhagen,1463,4,14,5,11,56,45,11,47
AaB,1463,5,8,12,10,39,44,-5,36
AC Horsens,1463,6,6,13,11,33,51,-18,31
Sonderjyske,1463,7,8,6,10,28,29,-1,30
Randers FC,1463,8,6,6,12,24,39,-15,24
Silkeborg IF,1463,9,5,4,13,26,45,-19,19
AGF Aarhus,1463,10,4,7,11,17,37,-20,19
Lyngby,1463,11,3,9,12,26,45,-19,18
Brondby,1464,1,21,6,3,73,33,40,69
FC Midtjylla,1464,2,19,5,6,68,42,26,62
FC Nords,1464,3,14,6,10,74,54,20,48
Copenhagen,1464,4,14,4,12,57,45,12,46
AaB,1464,5,10,11,9,40,40,0,41
Sonderjyske,1464,6,8,6,10,28,29,-1,30
AC Horsens,1464,7,6,12,12,34,58,-24,30
Lyngby,1464,8,4,9,11,27,44,-17,21
Randers FC,1464,9,5,6,13,23,40,-17,21
AGF Aarhus,1464,10,5,6,11,18,36,-18,21
Silkeborg IF,1464,11,5,3,14,25,46,-21,18
Brondby,1465,1,20,7,3,71,34,37,67
FC Midtjylla,1465,2,20,5,5,67,37,30,65
FC Nords,1465,3,16,6,8,70,46,24,54
Copenhagen,1465,4,12,5,13,54,45,9,41
AC Horsens,1465,5,7,13,10,37,55,-18,34
AaB,1465,6,6,14,10,35,43,-8,32
Sonderjyske,1465,7,8,6,10,28,29,-1,30
Lyngby,1465,8,4,9,11,27,44,-17,21
Randers FC,1465,9,5,6,13,23,40,-17,21
AGF Aarhus,1465,10,5,6,11,18,37,-19,21
Silkeborg IF,1465,11,5,3,14,26,46,-20,18
Brondby,1466,1,22,6,2,74,31,43,72
FC Midtjylla,1466,2,21,5,4,67,34,33,68
FC Nords,1466,3,13,7,10,70,53,17,46
Copenhagen,1466,4,12,5,13,52,45,7,41
AaB,1466,5,8,12,10,39,45,-6,36
AC Horsens,1466,6,6,13,11,32,52,-20,31
Sonderjyske,1466,7,8,6,10,28,29,-1,30
Randers FC,1466,8,6,6,12,24,39,-15,24
Silkeborg IF,1466,9,5,4,13,25,44,-19,19
AGF Aarhus,1466,10,4,7,11,16,36,-20,19
Lyngby,1466,11,3,9,12,26,45,-19,18
Brondby,1467,1,21,5,4,70,34,36,68
FC Midtjylla,1467,2,20,5,5,67,40,27,65
FC Nords,1467,3,15,6,9,79,55,24,51
Copenhagen,1467,4,14,5,11,56,45,11,47
AaB,1467,5,7,11,12,35,43,-8,32
AC Horsens,1467,6,6,14,10,38,54,-16,32
Sonderjyske,1467,7,8,6,10,28,29,-1,30
Randers FC,1467,8,5,7,12,24,40,-16,22
Lyngby,1467,9,3,10,11,27,45,-18,19
Silkeborg IF,1467,10,5,4,13,26,45,-19,19
AGF Aarhus,1467,11,4,7,11,17,37,-20,19
Brondby,1468,1,22,6,2,75,30,45,72
FC Midtjylla,1468,2,19,4,7,66,45,21,61
FC Nords,1468,3,14,6,10,70,57,13,48
Copenhagen,1468,4,13,5,12,56,48,8,44
AC Horsens,1468,5,7,15,8,39,48,-9,36
AaB,1468,6,7,12,11,37,41,-4,33
Sonderjyske,1468,7,8,6,10,28,29,-1,30
Randers FC,1468,8,6,6,12,24,39,-15,24
AGF Aarhus,1468,9,5,6,11,20,37,-17,21
Lyngby,1468,10,3,9,12,26,45,-19,18
Silkeborg IF,1468,11,5,3,14,26,48,-22,18
Brondby,1469,1,20,6,4,71,32,39,66
FC Midtjylla,1469,2,17,8,5,62,39,23,59
FC Nords,1469,3,14,7,9,76,57,19,49
Copenhagen,1469,4,14,5,11,55,47,8,47
AC Horsens,1469,5,8,14,8,44,51,-7,38
AaB,1469,6,7,12,11,38,46,-8,33
Sonderjyske,1469,7,8,6,10,28,29,-1,30
Lyngby,1469,8,4,9,11,28,45,-17,21
Randers FC,1469,9,5,6,13,24,41,-17,21
Silkeborg IF,1469,10,6,3,13,28,46,-18,21
AGF Aarhus,1469,11,4,6,12,18,39,-21,18
Brondby,1470,1,21,6,3,70,31,39,69
FC Midtjylla,1470,2,19,5,6,63,39,24,62
Copenhagen,1470,3,16,4,10,60,40,20,52
FC Nords,1470,4,13,7,10,73,57,16,46
AaB,1470,5,7,12,11,39,45,-6,33
AC Horsens,1470,6,7,12,11,35,54,-19,33
Sonderjyske,1470,7,8,6,10,28,29,-1,30
Lyngby,1470,8,4,9,11,28,44,-16,21
Silkeborg IF,1470,8,6,3,13,28,44,-16,21
Randers FC,1470,10,5,6,13,23,41,-18,21
AGF Aarhus,1470,11,4,6,12,16,39,-23,18
Brondby,1471,1,21,5,4,69,35,34,68
FC Midtjylla,1471,2,19,6,5,68,38,30,63
FC Nords,1471,3,15,8,7,75,47,28,53
Copenhagen,1471,4,14,5,11,55,46,9,47
AC Horsens,1471,5,7,13,10,35,48,-13,34
Sonderjyske,1471,6,8,6,10,28,29,-1,30
AaB,1471,7,6,11,13,36,50,-14,29
Lyngby,1471,8,4,9,11,28,44,-16,21
Randers FC,1471,9,5,6,13,23,41,-18,21
AGF Aarhus,1471,10,5,6,11,18,37,-19,21
Silkeborg IF,1471,11,5,3,14,26,46,-20,18
Brondby,1472,1,21,6,3,71,35,36,69
FC Midtjylla,1472,2,20,4,6,69,44,25,64
FC Nords,1472,3,14,6,10,73,50,23,48
Copenhagen,1472,4,14,5,11,58,44,14,47
AaB,1472,5,8,13,9,41,47,-6,37
Sonderjyske,1472,6,8,6,10,28,29,-1,30
AC Horsens,1472,7,6,12,12,36,54,-18,30
Lyngby,1472,8,4,9,11,30,44,-14,21
AGF Aarhus,1472,9,5,6,11,17,36,-19,21
Randers FC,1472,10,5,6,13,23,43,-20,21
Silkeborg IF,1472,11,5,3,14,25,45,-20,18
Brondby,1473,1,20,6,4,72,34,38,66
FC Midtjylla,1473,2,19,5,6,66,38,28,62
Copenhagen,1473,3,16,4,10,59,43,16,52
FC Nords,1473,4,13,6,11,70,59,11,45
AaB,1473,5,7,14,9,37,41,-4,35
AC Horsens,1473,6,7,13,10,35,50,-15,34
Sonderjyske,1473,7,8,6,10,28,29,-1,30
Randers FC,1473,8,5,7,12,25,41,-16,22
Silkeborg IF,1473,9,6,3,13,28,44,-16,21
Lyngby,1473,10,3,10,11,28,46,-18,19
AGF Aarhus,1473,11,4,6,12,16,39,-23,18
Brondby,1474,1,20,6,4,69,36,33,66
FC Midtjylla,1474,2,19,5,6,68,43,25,62
Copenhagen,1474,3,15,6,9,65,45,20,51
FC Nords,1474,4,14,8,8,81,56,25,50
AaB,1474,5,8,11,11,38,44,-6,35
Sonderjyske,1474,6,8,6,10,28,29,-1,30
AC Horsens,1474,7,6,12,12,32,55,-23,30
Randers FC,1474,8,6,6,12,27,41,-14,24
Silkeborg IF,1474,9,5,4,13,26,45,-19,19
AGF Aarhus,1474,10,4,7,11,17,37,-20,19
Lyngby,1474,11,3,9,12,28,48,-20,18
Brondby,1475,1,21,6,3,74,32,42,69
FC Midtjylla,1475,2,19,4,7,67,46,21,61
FC Nords,1475,3,15,6,9,74,51,23,51
Copenhagen,1475,4,14,5,11,63,46,17,47
AaB,1475,5,7,13,10,35,40,-5,34
AC Horsens,1475,6,7,12,11,35,59,-24,33
Sonderjyske,1475,7,8,6,10,28,29,-1,30
Lyngby,1475,8,4,9,11,27,44,-17,21
Silkeborg IF,1475,8,6,3,13,27,44,-17,21
Randers FC,1475,10,5,6,13,23,40,-17,21
AGF Aarhus,1475,11,4,6,12,16,38,-22,18
Brondby,1476,1,21,5,4,69,31,38,68
FC Midtjylla,1476,2,21,4,5,71,37,34,67
Copenhagen,1476,3,15,5,10,60,42,18,50
FC Nords,1476,4,14,6,10,72,53,19,48
AaB,1476,5,7,13,10,35,45,-10,34
Sonderjyske,1476,6,8,6,10,28,29,-1,30
AC Horsens,1476,7,5,13,12,33,58,-25,28
Lyngby,1476,8,4,9,11,28,44,-16,21
Randers FC,1476,9,5,6,13,23,41,-18,21
Silkeborg IF,1476,10,5,4,13,25,44,-19,19
AGF Aarhus,1476,11,4,7,11,16,36,-20,19
Brondby,1477,1,20,5,5,68,34,34,65
FC Midtjylla,1477,2,19,5,6,61,36,25,62
Copenhagen,1477,3,15,5,10,59,44,15,50
FC Nords,1477,4,13,7,10,68,50,18,46
AaB,1477,5,8,12,10,38,41,-3,36
AC Horsens,1477,6,7,14,9,34,49,-15,35
Sonderjyske,1477,7,8,6,10,28,29,-1,30
Randers FC,1477,8,6,6,12,26,41,-15,24
Silkeborg IF,1477,9,6,3,13,26,44,-18,21
Lyngby,1477,10,3,9,12,28,47,-19,18
AGF Aarhus,1477,11,4,6,12,16,37,-21,18
FC Midtjylla,1478,1,21,4,5,67,38,29,67
Brondby,1478,2,20,5,5,71,36,35,65
Copenhagen,1478,3,14,4,12,57,48,9,46
FC Nords,1478,4,12,6,12,73,61,12,42
AC Horsens,1478,5,9,12,9,36,47,-11,39
AaB,1478,6,9,11,10,40,40,0,38
Sonderjyske,1478,7,8,6,10,28,29,-1,30
Randers FC,1478,8,5,7,12,24,40,-16,22
AGF Aarhus,1478,9,5,6,11,17,36,-19,21
Lyngby,1478,10,3,10,11,27,45,-18,19
Silkeborg IF,1478,11,5,3,14,25,45,-20,18
Brondby,1479,1,20,6,4,69,31,38,66
FC Midtjylla,1479,2,19,4,7,66,38,28,61
FC Nords,1479,3,16,6,8,75,47,28,54
Copenhagen,1479,4,14,4,12,53,42,11,46
AaB,1479,5,7,13,10,36,46,-10,34
AC Horsens,1479,6,7,13,10,33,54,-21,34
Sonderjyske,1479,7,8,6,10,28,29,-1,30
Randers FC,1479,8,6,6,12,25,39,-14,24
Silkeborg IF,1479,9,6,3,13,27,44,-17,21
Lyngby,1479,10,3,9,12,26,46,-20,18
AGF Aarhus,1479,11,4,6,12,16,38,-22,18
Brondby,1480,1,21,6,3,71,33,38,69
FC Midtjylla,1480,2,20,4,6,65,40,25,64
FC Nords,1480,3,15,7,8,81,49,32,52
Copenhagen,1480,4,14,5,11,64,48,16,47
AaB,1480,5,8,11,11,42,53,-11,35
Sonderjyske,1480,6,8,6,10,28,29,-1,30
AC Horsens,1480,7,5,13,12,33,59,-26,28
AGF Aarhus,1480,8,5,6,11,20,36,-16,21
Lyngby,1480,9,4,9,11,27,44,-17,21
Randers FC,1480,10,5,6,13,23,40,-17,21
Silkeborg IF,1480,11,5,3,14,25,48,-23,18
Brondby,1481,1,21,6,3,69,30,39,69
FC Midtjylla,1481,2,20,5,5,67,38,29,65
Copenhagen,1481,3,13,6,11,56,45,11,45
FC Nords,1481,4,12,7,11,69,54,15,43
AaB,1481,5,9,11,10,38,43,-5,38
AC Horsens,1481,6,7,13,10,38,53,-15,34
Sonderjyske,1481,7,8,6,10,28,29,-1,30
Lyngby,1481,8,4,9,11,29,45,-16,21
Randers FC,1481,9,5,6,13,24,42,-18,21
AGF Aarhus,1481,10,5,6,11,18,37,-19,21
Silkeborg IF,1481,11,5,3,14,26,46,-20,18
Brondby,1482,1,22,5,3,73,32,41,71
FC Midtjylla,1482,2,19,5,6,65,44,21,62
Copenhagen,1482,3,16,4,10,69,41,28,52
FC Nords,1482,4,15,6,9,76,55,21,51
Sonderjyske,1482,5,8,6,10,28,29,-1,30
AaB,1482,6,6,12,12,34,45,-11,30
AC Horsens,1482,7,6,12,12,32,58,-26,30
Lyngby,1482,8,4,9,11,27,44,-17,21
Randers FC,1482,9,5,6,13,23,40,-17,21
Silkeborg IF,1482,10,5,4,13,26,45,-19,19
AGF Aarhus,1482,11,4,7,11,17,37,-20,19
Brondby,1483,1,21,6,3,72,32,40,69
FC Midtjylla,1483,2,18,5,7,65,45,20,59
FC Nords,1483,3,15,7,8,75,50,25,52
Copenhagen,1483,4,13,5,12,55,43,12,44
AaB,1483,5,8,12,10,38,44,-6,36
AC Horsens,1483,6,7,13,10,37,54,-17,34
Sonderjyske,1483,7,8,6,10,28,29,-1,30
Randers FC,1483,8,6,6,12,26,40,-14,24
AGF Aarhus,1483,9,5,6,11,18,36,-18,21
Lyngby,1483,10,3,9,12,27,47,-20,18
Silkeborg IF,1483,11,5,3,14,25,46,-21,18
Brondby,1484,1,21,6,3,74,34,40,69
FC Midtjylla,1484,2,19,5,6,66,41,25,62
Copenhagen,1484,3,16,4,10,64,47,17,52
FC Nords,1484,4,13,7,10,75,57,18,46
AaB,1484,5,7,12,11,38,44,-6,33
AC Horsens,1484,6,7,12,11,35,55,-20,33
Sonderjyske,1484,7,8,6,10,28,29,-1,30
Lyngby,1484,8,4,9,11,29,45,-16,21
AGF Aarhus,1484,9,5,6,11,19,36,-17,21
Randers FC,1484,10,5,6,13,24,42,-18,21
Silkeborg IF,1484,11,5,3,14,25,47,-22,18
Brondby,1485,1,20,6,4,67,33,34,66
FC Midtjylla,1485,2,19,5,6,65,38,27,62
FC Nords,1485,3,16,7,7,77,49,28,55
Copenhagen,1485,4,13,6,11,58,46,12,45
AaB,1485,5,8,11,11,40,47,-7,35
AC Horsens,1485,6,6,13,11,35,55,-20,31
Sonderjyske,1485,7,8,6,10,28,29,-1,30
Lyngby,1485,8,4,9,11,27,44,-17,21
Randers FC,1485,9,5,6,13,23,40,-17,21
Silkeborg IF,1485,10,6,3,13,27,45,-18,21
AGF Aarhus,1485,11,4,6,12,17,38,-21,18
Brondby,1486,1,19,6,5,67,34,33,63
FC Midtjylla,1486,2,19,6,5,62,38,24,63
FC Nords,1486,3,14,7,9,77,51,26,49
Copenhagen,1486,4,13,5,12,57,51,6,44
AaB,1486,5,9,12,9,41,42,-1,39
AC Horsens,1486,6,8,12,10,39,53,-14,36
Sonderjyske,1486,7,8,6,10,28,29,-1,30
Randers FC,1486,8,5,7,12,24,40,-16,22
AGF Aarhus,1486,9,5,6,11,18,37,-19,21
Lyngby,1486,10,3,10,11,27,45,-18,19
Silkeborg IF,1486,11,5,3,14,26,46,-20,18
Brondby,1487,1,20,6,4,69,35,34,66
FC Midtjylla,1487,2,20,4,6,64,40,24,64
FC Nords,1487,3,15,8,7,77,50,27,53
Copenhagen,1487,4,16,4,10,62,44,18,52
AaB,1487,5,7,12,11,39,46,-7,33
Sonderjyske,1487,6,8,6,10,28,29,-1,30
AC Horsens,1487,7,5,12,13,32,54,-22,27
Lyngby,1487,8,4,9,11,28,44,-16,21
Silkeborg IF,1487,9,6,3,13,26,44,-18,21
Randers FC,1487,10,5,6,13,23,41,-18,21
AGF Aarhus,1487,11,4,6,12,16,37,-21,18
Brondby,1488,1,20,6,4,72,36,36,66
FC Midtjylla,1488,2,20,5,5,68,41,27,65
FC Nords,1488,3,13,6,11,74,58,16,45
Copenhagen,1488,4,13,6,11,58,47,11,45
AaB,1488,5,9,12,9,37,38,-1,39
AC Horsens,1488,6,7,13,10,37,52,-15,34
Sonderjyske,1488,7,8,6,10,28,29,-1,30
Lyngby,1488,8,4,9,11,28,44,-16,21
Silkeborg IF,1488,9,6,3,13,29,46,-17,21
Randers FC,1488,10,5,6,13,23,41,-18,21
AGF Aarhus,1488,11,4,6,12,18,40,-22,18
FC Midtjylla,1489,1,21,4,5,67,39,28,67
Brondby,1489,2,19,7,4,66,34,32,64
FC Nords,1489,3,15,7,8,73,46,27,52
Copenhagen,1489,4,14,5,11,58,44,14,47
AaB,1489,5,7,11,12,36,45,-9,32
AC Horsens,1489,6,6,14,10,35,53,-18,32
Sonderjyske,1489,7,8,6,10,28,29,-1,30
Lyngby,1489,8,4,9,11,29,46,-17,21
Randers FC,1489,9,5,6,13,25,42,-17,21
Silkeborg IF,1489,10,5,4,13,27,46,-19,19
AGF Aarhus,1489,11,4,7,11,18,38,-20,19
Brondby,1490,1,21,6,3,74,38,36,69
FC Midtjylla,1490,2,19,4,7,65,41,24,61
FC Nords,1490,3,15,7,8,75,51,24,52
Copenhagen,1490,4,13,6,11,61,47,14,45
AaB,1490,5,9,12,9,37,40,-3,39
Sonderjyske,1490,6,8,6,10,28,29,-1,30
AC Horsens,1490,7,5,13,12,36,57,-21,28
Randers FC,1490,8,5,7,12,24,40,-16,22
Silkeborg IF,1490,9,6,3,13,27,45,-18,21
Lyngby,1490,10,3,10,11,27,45,-18,19
AGF Aarhus,1490,11,4,6,12,17,38,-21,18
Brondby,1491,1,21,6,3,70,31,39,69
FC Midtjylla,1491,2,19,4,7,67,37,30,61
FC Nords,1491,3,16,6,8,78,50,28,54
Copenhagen,1491,4,13,6,11,59,49,10,45
AaB,1491,5,8,13,9,37,40,-3,37
Sonderjyske,1491,6,8,6,10,28,29,-1,30
AC Horsens,1491,7,5,13,12,30,60,-30,28
Lyngby,1491,8,4,9,11,28,44,-16,21
Randers FC,1491,9,5,6,13,23,41,-18,21
Silkeborg IF,1491,10,5,4,13,27,46,-19,19
AGF Aarhus,1491,11,4,7,11,18,38,-20,19
Brondby,1492,1,21,7,2,73,33,40,70
FC Midtjylla,1492,2,18,5,7,65,46,19,59
FC Nords,1492,3,14,7,9,78,55,23,49
Copenhagen,1492,4,14,6,10,65,49,16,48
AaB,1492,5,8,12,10,40,44,-4,36
Sonderjyske,1492,6,8,6,10,28,29,-1,30
AC Horsens,1492,7,5,15,10,38,58,-20,30
Lyngby,1492,8,4,9,11,27,44,-17,21
Randers FC,1492,9,5,6,13,23,40,-17,21
Silkeborg IF,1492,10,5,4,13,26,45,-19,19
AGF Aarhus,1492,11,4,7,11,17,37,-20,19
FC Midtjylla,1493,1,22,4,4,71,36,35,70
Brondby,1493,2,19,7,4,68,35,33,64
FC Nords,1493,3,14,8,8,74,52,22,50
Copenhagen,1493,4,13,6,11,58,47,11,45
AC Horsens,1493,5,7,12,11,34,53,-19,33
AaB,1493,6,6,13,11,33,41,-8,31
Sonderjyske,1493,7,8,6,10,28,29,-1,30
Randers FC,1493,8,5,7,12,23,39,-16,22
Silkeborg IF,1493,9,6,3,13,27,44,-17,21
Lyngby,1493,10,3,10,11,26,44,-18,19
AGF Aarhus,1493,11,4,6,12,16,38,-22,18
Brondby,1494,1,23,5,2,75,30,45,74
FC Midtjylla,1494,2,19,5,6,66,38,28,62
FC Nords,1494,3,14,7,9,75,53,22,49
Copenhagen,1494,4,12,5,13,56,53,3,41
AaB,1494,5,8,11,11,37,49,-12,35
AC Horsens,1494,6,6,15,9,40,52,-12,33
Sonderjyske,1494,7,8,6,10,28,29,-1,30
Lyngby,1494,8,4,9,11,28,44,-16,21
Randers FC,1494,9,5,6,13,23,41,-18,21
AGF Aarhus,1494,10,5,6,11,18,36,-18,21
Silkeborg IF,1494,11,5,3,14,25,46,-21,18
Brondby,1495,1,19,7,4,64,32,32,64
FC Midtjylla,1495,2,19,5,6,66,38,28,62
FC Nords,1495,3,14,9,7,69,46,23,51
Copenhagen,1495,4,13,6,11,55,44,11,45
AaB,1495,5,8,14,8,36,38,-2,38
AC Horsens,1495,6,6,13,11,35,53,-18,31
Sonderjyske,1495,7,8,6,10,28,29,-1,30
Lyngby,1495,8,4,9,11,29,46,-17,21
Randers FC,1495,9,5,6,13,25,42,-17,21
AGF Aarhus,1495,10,5,6,11,18,36,-18,21
Silkeborg IF,1495,11,5,3,14,25,46,-21,18
Brondby,1496,1,20,8,2,72,31,41,68
FC Midtjylla,1496,2,19,5,6,64,40,24,62
Copenhagen,1496,3,14,7,9,62,43,19,49
FC Nords,1496,4,14,6,10,71,55,16,48
AaB,1496,5,7,13,10,40,45,-5,34
AC Horsens,1496,6,6,13,11,35,56,-21,31
Sonderjyske,1496,7,8,6,10,28,29,-1,30
Lyngby,1496,8,4,9,11,28,44,-16,21
Randers FC,1496,9,5,6,13,23,41,-18,21
Silkeborg IF,1496,10,5,4,13,26,45,-19,19
AGF Aarhus,1496,11,4,7,11,17,37,-20,19
Brondby,1497,1,22,6,2,76,34,42,72
FC Midtjylla,1497,2,19,5,6,66,37,29,62
Copenhagen,1497,3,14,6,10,57,43,14,48
FC Nords,1497,4,13,6,11,70,57,13,45
AaB,1497,5,8,12,10,40,43,-3,36
AC Horsens,1497,6,6,13,11,33,54,-21,31
Sonderjyske,1497,7,8,6,10,28,29,-1,30
Randers FC,1497,8,6,6,12,24,39,-15,24
Silkeborg IF,1497,9,5,4,13,26,45,-19,19
AGF Aarhus,1497,10,4,7,11,17,37,-20,19
Lyngby,1497,11,3,9,12,26,45,-19,18
Brondby,1498,1,20,7,3,68,32,36,67
FC Midtjylla,1498,2,19,6,5,62,35,27,63
FC Nords,1498,3,15,8,7,74,49,25,53
Copenhagen,1498,4,12,6,12,50,41,9,42
AC Horsens,1498,5,7,13,10,35,52,-17,34
AaB,1498,6,6,14,10,34,40,-6,32
Sonderjyske,1498,7,8,6,10,28,29,-1,30
Randers FC,1498,8,6,6,12,24,39,-15,24
Silkeborg IF,1498,9,5,4,13,26,45,-19,19
AGF Aarhus,1498,10,4,7,11,17,37,-20,19
Lyngby,1498,11,3,9,12,26,45,-19,18
Brondby,1499,1,21,5,4,70,39,31,68
FC Midtjylla,1499,2,19,4,7,63,43,20,61
FC Nords,1499,3,15,6,9,81,53,28,51
Copenhagen,1499,4,15,6,9,63,42,21,51
AaB,1499,5,7,12,11,37,43,-6,33
AC Horsens,1499,6,6,13,11,34,54,-20,31
Sonderjyske,1499,7,8,6,10,28,29,-1,30
Lyngby,1499,8,4,9,11,29,44,-15,21
Silkeborg IF,1499,9,6,3,13,27,44,-17,21
Randers FC,1499,10,5,6,13,23,42,-19,21
AGF Aarhus,1499,11,4,6,12,16,38,-22,18
Brondby,1500,1,21,7,2,73,32,41,70
FC Midtjylla,1500,2,19,6,5,70,41,29,63
FC Nords,1500,3,13,6,11,72,57,15,45
Copenhagen,1500,4,12,6,12,56,50,6,42
AaB,1500,5,10,11,9,40,38,2,41
AC Horsens,1500,6,7,12,11,34,53,-19,33
Sonderjyske,1500,7,8,6,10,28,29,-1,30
Randers FC,1500,8,6,6,12,24,39,-15,24
Silkeborg IF,1500,9,6,3,13,27,45,-18,21
Lyngby,1500,10,3,9,12,26,45,-19,18
AGF Aarhus,1500,11,4,6,12,17,38,-21,18
Brondby,1501,1,21,6,3,76,34,42,69
FC Midtjylla,1501,2,20,4,6,65,39,26,64
Copenhagen,1501,3,14,5,11,58,50,8,47
FC Nords,1501,4,12,7,11,71,57,14,43
AaB,1501,5,8,12,10,39,43,-4,36
AC Horsens,1501,6,7,14,9,38,50,-12,35
Sonderjyske,1501,7,8,6,10,28,29,-1,30
Lyngby,1501,8,4,9,11,29,46,-17,21
Randers FC,1501,9,5,6,13,25,42,-17,21
AGF Aarhus,1501,10,5,6,11,18,37,-19,21
Silkeborg IF,1501,11,5,3,14,26,46,-20,18
Brondby,1502,1,21,6,3,73,30,43,69
FC Midtjylla,1502,2,20,6,4,62,35,27,66
FC Nords,1502,3,14,8,8,75,52,23,50
Copenhagen,1502,4,12,6,12,51,48,3,42
AaB,1502,5,7,13,10,37,41,-4,34
AC Horsens,1502,6,6,13,11,34,52,-18,31
Sonderjyske,1502,7,8,6,10,28,29,-1,30
Lyngby,1502,8,4,9,11,28,45,-17,21
Randers FC,1502,9,5,6,13,24,41,-17,21
Silkeborg IF,1502,10,5,4,13,27,46,-19,19
AGF Aarhus,1502,11,4,7,11,18,38,-20,19
Brondby,1503,1,20,6,4,66,34,32,66
FC Midtjylla,1503,2,19,6,5,65,39,26,63
FC Nords,1503,3,16,7,7,76,47,29,55
Copenhagen,1503,4,13,6,11,55,43,12,45
AaB,1503,5,7,13,10,35,39,-4,34
Sonderjyske,1503,6,8,6,10,28,29,-1,30
AC Horsens,1503,7,5,14,11,33,54,-21,29
Randers FC,1503,8,5,7,12,25,41,-16,22
AGF Aarhus,1503,9,5,6,11,19,38,-19,21
Lyngby,1503,10,3,10,11,28,46,-18,19
Silkeborg IF,1503,11,5,3,14,27,47,-20,18
Brondby,1504,1,20,6,4,73,35,38,66
FC Midtjylla,1504,2,18,7,5,64,40,24,61
Copenhagen,1504,3,16,4,10,59,43,16,52
FC Nords,1504,4,14,9,7,74,51,23,51
AaB,1504,5,7,13,10,40,43,-3,34
Sonderjyske,1504,6,8,6,10,28,29,-1,30
AC Horsens,1504,7,5,13,12,33,57,-24,28
Randers FC,1504,8,5,7,12,24,40,-16,22
AGF Aarhus,1504,9,5,6,11,18,36,-18,21
Lyngby,1504,10,3,10,11,27,45,-18,19
Silkeborg IF,1504,11,5,3,14,25,46,-21,18
FC Midtjylla,1505,1,21,4,5,69,43,26,67
Brondby,1505,2,20,5,5,70,35,35,65
Copenhagen,1505,3,15,5,10,60,44,16,50
FC Nords,1505,4,14,7,9,74,54,20,49
AC Horsens,1505,5,7,12,11,37,54,-17,33
AaB,1505,6,7,11,12,39,45,-6,32
Sonderjyske,1505,7,8,6,10,28,29,-1,30
Lyngby,1505,8,4,9,11,28,44,-16,21
Randers FC,1505,9,5,6,13,23,41,-18,21
AGF Aarhus,1505,10,5,6,11,17,36,-19,21
Silkeborg IF,1505,11,5,3,14,25,45,-20,18
FC Midtjylla,1506,1,21,4,5,66,41,25,67
Brondby,1506,2,20,5,5,65,33,32,65
Copenhagen,1506,3,15,5,10,66,42,24,50
FC Nords,1506,4,13,7,10,71,56,15,46
AaB,1506,5,8,11,11,39,43,-4,35
AC Horsens,1506,6,6,14,10,34,52,-18,32
Sonderjyske,1506,7,8,6,10,28,29,-1,30
Randers FC,1506,8,6,6,12,25,40,-15,24
Silkeborg IF,1506,9,6,3,13,26,44,-18,21
Lyngby,1506,10,3,9,12,27,46,-19,18
AGF Aarhus,1506,11,4,6,12,16,37,-21,18
Brondby,1507,1,21,7,2,66,27,39,70
FC Midtjylla,1507,2,20,5,5,62,37,25,65
FC Nords,1507,3,14,6,10,71,51,20,48
Copenhagen,1507,4,14,4,12,59,42,17,46
AaB,1507,5,9,11,10,36,38,-2,38
Sonderjyske,1507,6,8,6,10,28,29,-1,30
AC Horsens,1507,7,5,13,12,30,55,-25,28
Lyngby,1507,8,4,9,11,28,45,-17,21
Randers FC,1507,9,5,6,13,24,41,-17,21
Silkeborg IF,1507,10,6,3,13,26,44,-18,21
AGF Aarhus,1507,11,4,6,12,16,37,-21,18
Brondby,1508,1,23,5,2,74,29,45,74
FC Midtjylla,1508,2,19,4,7,59,39,20,61
FC Nords,1508,3,15,6,9,73,51,22,51
Copenhagen,1508,4,13,4,13,52,43,9,43
AaB,1508,5,8,11,11,37,43,-6,35
AC Horsens,1508,6,7,12,11,33,49,-16,33
Sonderjyske,1508,7,8,6,10,28,29,-1,30
Randers FC,1508,8,5,7,12,24,40,-16,22
Lyngby,1508,9,3,10,11,27,45,-18,19
Silkeborg IF,1508,10,5,4,13,25,44,-19,19
AGF Aarhus,1508,11,4,7,11,16,36,-20,19
Brondby,1509,1,22,6,2,74,30,44,72
FC Midtjylla,1509,2,20,4,6,66,40,26,64
FC Nords,1509,3,14,7,9,74,53,21,49
Copenhagen,1509,4,13,6,11,57,47,10,45
AaB,1509,5,8,11,11,39,43,-4,35
Sonderjyske,1509,6,8,6,10,28,29,-1,30
AC Horsens,1509,7,6,12,12,36,59,-23,30
Lyngby,1509,8,4,9,11,28,45,-17,21
Randers FC,1509,9,5,6,13,24,41,-17,21
Silkeborg IF,1509,10,6,3,13,27,45,-18,21
AGF Aarhus,1509,11,4,6,12,17,38,-21,18
Brondby,1510,1,22,6,2,76,33,43,72
FC Midtjylla,1510,2,19,4,7,64,39,25,61
FC Nords,1510,3,15,7,8,78,51,27,52
Copenhagen,1510,4,13,4,13,54,50,4,43
AC Horsens,1510,5,8,12,10,38,50,-12,36
AaB,1510,6,7,11,12,37,50,-13,32
Sonderjyske,1510,7,8,6,10,28,29,-1,30
Lyngby,1510,8,4,9,11,29,45,-16,21
Silkeborg IF,1510,9,6,3,13,27,45,-18,21
Randers FC,1510,10,5,6,13,24,42,-18,21
AGF Aarhus,1510,11,4,6,12,17,38,-21,18
Brondby,1511,1,21,6,3,71,35,36,69
FC Midtjylla,1511,2,18,6,6,64,40,24,60
Copenhagen,1511,3,15,5,10,59,44,15,50
FC Nords,1511,4,12,7,11,71,56,15,43
AaB,1511,5,8,13,9,34,37,-3,37
AC Horsens,1511,6,7,13,10,38,51,-13,34
Sonderjyske,1511,7,8,6,10,28,29,-1,30
Lyngby,1511,8,4,9,11,29,44,-15,21
Randers FC,1511,9,5,6,13,23,42,-19,21
AGF Aarhus,1511,10,5,6,11,19,38,-19,21
Silkeborg IF,1511,11,5,3,14,27,47,-20,18
Brondby,1512,1,21,5,4,69,35,34,68
FC Midtjylla,1512,2,20,6,4,66,36,30,66
Copenhagen,1512,3,13,6,11,54,43,11,45
FC Nords,1512,4,12,8,10,70,54,16,44
AC Horsens,1512,5,7,15,8,38,48,-10,36
AaB,1512,6,6,14,10,34,41,-7,32
Sonderjyske,1512,7,8,6,10,28,29,-1,30
Lyngby,1512,8,4,9,11,27,44,-17,21
Randers FC,1512,9,5,6,13,23,40,-17,21
AGF Aarhus,1512,10,5,6,11,17,36,-19,21
Silkeborg IF,1512,11,5,3,14,25,45,-20,18
Brondby,1513,1,22,5,3,76,35,41,71
FC Midtjylla,1513,2,20,4,6,68,39,29,64
Copenhagen,1513,3,15,4,11,62,46,16,49
FC Nords,1513,4,12,6,12,68,61,7,42
AaB,1513,5,10,11,9,41,40,1,41
Sonderjyske,1513,6,8,6,10,28,29,-1,30
AC Horsens,1513,7,6,12,12,33,53,-20,30
Randers FC,1513,8,6,6,12,24,39,-15,24
AGF Aarhus,1513,9,5,6,11,18,37,-19,21
Lyngby,1513,10,3,9,12,26,45,-19,18
Silkeborg IF,1513,11,5,3,14,26,46,-20,18
Brondby,1514,1,20,6,4,71,33,38,66
FC Midtjylla,1514,2,18,5,7,64,43,21,59
FC Nords,1514,3,15,7,8,73,51,22,52
Copenhagen,1514,4,15,5,10,63,48,15,50
AaB,1514,5,8,12,10,39,43,-4,36
AC Horsens,1514,6,6,13,11,34,52,-18,31
Sonderjyske,1514,7,8,6,10,28,29,-1,30
Lyngby,1514,8,4,9,11,28,45,-17,21
Randers FC,1514,9,5,6,13,24,41,-17,21
AGF Aarhus,1514,10,5,6,11,19,38,-19,21
Silkeborg IF,1514,11,5,3,14,27,47,-20,18
Brondby,1515,1,21,6,3,76,32,44,69
FC Midtjylla,1515,2,20,5,5,69,40,29,65
FC Nords,1515,3,15,7,8,74,50,24,52
Copenhagen,1515,4,13,6,11,59,47,12,45
AaB,1515,5,8,12,10,35,48,-13,36
Sonderjyske,1515,6,8,6,10,28,29,-1,30
AC Horsens,1515,7,5,12,13,36,58,-22,27
Lyngby,1515,8,4,9,11,28,44,-16,21
Silkeborg IF,1515,8,6,3,13,28,44,-16,21
Randers FC,1515,10,5,6,13,23,41,-18,21
AGF Aarhus,1515,11,4,6,12,16,39,-23,18
FC Midtjylla,1516,1,21,4,5,67,37,30,67
Brondby,1516,2,20,6,4,72,34,38,66
Copenhagen,1516,3,14,5,11,56,49,7,47
FC Nords,1516,4,13,7,10,75,57,18,46
AC Horsens,1516,5,7,14,9,40,49,-9,35
AaB,1516,6,7,12,11,40,50,-10,33
Sonderjyske,1516,7,8,6,10,28,29,-1,30
Lyngby,1516,8,4,9,11,27,44,-17,21
Randers FC,1516,9,5,6,13,23,40,-17,21
Silkeborg IF,1516,10,6,3,13,26,44,-18,21
AGF Aarhus,1516,11,4,6,12,16,37,-21,18
FC Midtjylla,1517,1,22,4,4,66,33,33,70
Brondby,1517,2,20,6,4,71,32,39,66
Copenhagen,1517,3,15,4,11,62,45,17,49
FC Nords,1517,4,14,6,10,74,57,17,48
AaB,1517,5,8,11,11,34,44,-10,35
Sonderjyske,1517,6,8,6,10,28,29,-1,30
AC Horsens,1517,7,5,13,12,32,54,-22,28
Lyngby,1517,8,4,9,11,29,45,-16,21
Randers FC,1517,9,5,6,13,24,42,-18,21
AGF Aarhus,1517,10,5,6,11,19,37,-18,21
Silkeborg IF,1517,11,5,3,14,26,47,-21,18
Brondby,1518,1,20,8,2,73,28,45,68
FC Midtjylla,1518,2,19,5,6,62,42,20,62
FC Nords,1518,3,14,7,9,72,51,21,49
Copenhagen,1518,4,14,6,10,59,44,15,48
AaB,1518,5,7,12,11,36,46,-10,33
AC Horsens,1518,6,5,16,9,33,50,-17,31
Sonderjyske,1518,7,8,6,10,28,29,-1,30
Lyngby,1518,8,4,9,11,28,44,-16,21
Randers FC,1518,9,5,6,13,23,41,-18,21
Silkeborg IF,1518,10,5,4,13,26,45,-19,19
AGF Aarhus,1518,11,4,7,11,17,37,-20,19
Brondby,1519,1,20,8,2,66,28,38,68
FC Midtjylla,1519,2,20,5,5,67,38,29,65
Copenhagen,1519,3,15,6,9,64,45,19,51
FC Nords,1519,4,12,9,9,73,58,15,45
AaB,1519,5,7,12,11,36,44,-8,33
Sonderjyske,1519,6,8,6,10,28,29,-1,30
AC Horsens,1519,7,5,14,11,32,51,-19,29
Randers FC,1519,8,5,7,12,26,42,-16,22
AGF Aarhus,1519,9,5,6,11,18,37,-19,21
Lyngby,1519,10,3,10,11,29,47,-18,19
Silkeborg IF,1519,11,5,3,14,26,46,-20,18
FC Midtjylla,1520,1,20,4,6,65,43,22,64
Brondby,1520,2,19,5,6,67,34,33,62
Copenhagen,1520,3,17,4,9,62,41,21,55
FC Nords,1520,4,14,6,10,74,55,19,48
AaB,1520,5,8,11,11,39,45,-6,35
AC Horsens,1520,6,7,12,11,40,55,-15,33
Sonderjyske,1520,7,8,6,10,28,29,-1,30
Randers FC,1520,8,5,7,12,24,40,-16,22
Silkeborg IF,1520,9,6,3,13,26,44,-18,21
Lyngby,1520,10,3,10,11,27,45,-18,19
AGF Aarhus,1520,11,4,6,12,16,37,-21,18
Brondby,1521,1,19,9,2,71,34,37,66
FC Midtjylla,1521,2,20,5,5,74,41,33,65
Copenhagen,1521,3,15,5,10,60,43,17,50
FC Nords,1521,4,13,8,9,75,58,17,47
AaB,1521,5,7,12,11,38,49,-11,33
AC Horsens,1521,6,6,13,11,35,54,-19,31
Sonderjyske,1521,7,8,6,10,28,29,-1,30
Lyngby,1521,8,4,9,11,27,44,-17,21
Silkeborg IF,1521,8,6,3,13,27,44,-17,21
Randers FC,1521,10,5,6,13,23,40,-17,21
AGF Aarhus,1521,11,4,6,12,16,38,-22,18
Brondby,1522,1,20,6,4,68,33,35,66
FC Midtjylla,1522,2,20,6,4,68,37,31,66
FC Nords,1522,3,14,7,9,72,51,21,49
Copenhagen,1522,4,12,6,12,53,43,10,42
AaB,1522,5,8,11,11,35,44,-9,35
AC Horsens,1522,6,7,14,9,39,53,-14,35
Sonderjyske,1522,7,8,6,10,28,29,-1,30
Randers FC,1522,8,5,7,12,23,39,-16,22
Lyngby,1522,9,3,10,11,26,44,-18,19
Silkeborg IF,1522,10,5,4,13,26,45,-19,19
AGF Aarhus,1522,11,4,7,11,17,37,-20,19
Brondby,1523,1,20,6,4,70,33,37,66
FC Midtjylla,1523,2,19,5,6,64,40,24,62
FC Nords,1523,3,15,6,9,73,52,21,51
Copenhagen,1523,4,14,6,10,61,44,17,48
AaB,1523,5,7,13,10,39,45,-6,34
AC Horsens,1523,6,7,12,11,36,55,-19,33
Sonderjyske,1523,7,8,6,10,28,29,-1,30
Randers FC,1523,8,5,7,12,25,41,-16,22
Silkeborg IF,1523,9,6,3,13,27,44,-17,21
Lyngby,1523,10,3,10,11,28,46,-18,19
AGF Aarhus,1523,11,4,6,12,16,38,-22,18
Brondby,1524,1,21,6,3,72,33,39,69
FC Midtjylla,1524,2,20,5,5,68,39,29,65
Copenhagen,1524,3,14,5,11,59,48,11,47
FC Nords,1524,4,13,6,11,69,56,13,45
AaB,1524,5,8,13,9,44,45,-1,37
AC Horsens,1524,6,6,13,11,37,54,-17,31
Sonderjyske,1524,7,8,6,10,28,29,-1,30
Lyngby,1524,8,4,9,11,29,46,-17,21
Randers FC,1524,9,5,6,13,25,42,-17,21
Silkeborg IF,1524,10,6,3,13,27,45,-18,21
AGF Aarhus,1524,11,4,6,12,17,38,-21,18
Brondby,1525,1,19,7,4,71,38,33,64
FC Midtjylla,1525,2,19,6,5,68,41,27,63
FC Nords,1525,3,16,6,8,83,53,30,54
Copenhagen,1525,4,13,5,12,55,47,8,44
AaB,1525,5,8,11,11,42,45,-3,35
AC Horsens,1525,6,7,13,10,39,60,-21,34
Sonderjyske,1525,7,8,6,10,28,29,-1,30
Randers FC,1525,8,5,7,12,24,40,-16,22
AGF Aarhus,1525,9,5,6,11,18,37,-19,21
Lyngby,1525,10,3,10,11,27,45,-18,19
Silkeborg IF,1525,11,5,3,14,26,46,-20,18
Brondby,1526,1,22,6,2,79,32,47,72
FC Midtjylla,1526,2,19,6,5,68,39,29,63
FC Nords,1526,3,15,6,9,78,58,20,51
Copenhagen,1526,4,13,5,12,59,54,5,44
AaB,1526,5,8,11,11,39,47,-8,35
Sonderjyske,1526,6,8,6,10,28,29,-1,30
AC Horsens,1526,7,5,14,11,36,55,-19,29
Silkeborg IF,1526,8,6,3,13,31,45,-14,21
Lyngby,1526,9,4,9,11,28,44,-16,21
Randers FC,1526,10,5,6,13,23,41,-18,21
AGF Aarhus,1526,11,4,6,12,17,42,-25,18
Brondby,1527,1,20,7,3,70,30,40,67
FC Midtjylla,1527,2,21,4,5,68,36,32,67
FC Nords,1527,3,15,6,9,71,49,22,51
Copenhagen,1527,4,13,5,12,53,45,8,44
AaB,1527,5,7,12,11,35,46,-11,33
AC Horsens,1527,6,6,14,10,33,50,-17,32
Sonderjyske,1527,7,8,6,10,28,29,-1,30
Randers FC,1527,8,6,6,12,25,40,-15,24
AGF Aarhus,1527,9,5,6,11,18,37,-19,21
Lyngby,1527,10,3,9,12,27,46,-19,18
Silkeborg IF,1527,11,5,3,14,26,46,-20,18
Brondby,1528,1,21,5,4,72,33,39,68
FC Midtjylla,1528,2,21,5,4,68,38,30,68
Copenhagen,1528,3,14,7,9,59,43,16,49
FC Nords,1528,4,12,7,11,70,54,16,43
AaB,1528,5,7,13,10,40,47,-7,34
AC Horsens,1528,6,6,13,11,34,54,-20,31
Sonderjyske,1528,7,8,6,10,28,29,-1,30
Randers FC,1528,8,5,7,12,24,40,-16,22
AGF Aarhus,1528,9,5,6,11,17,36,-19,21
Lyngby,1528,10,3,10,11,27,45,-18,19
Silkeborg IF,1528,11,5,3,14,25,45,-20,18
Brondby,1529,1,19,7,4,68,35,33,64
FC Midtjylla,1529,2,18,6,6,64,41,23,60
FC Nords,1529,3,14,6,10,73,53,20,48
Copenhagen,1529,4,14,6,10,57,40,17,48
AaB,1529,5,8,13,9,38,41,-3,37
AC Horsens,1529,6,7,14,9,36,52,-16,35
Sonderjyske,1529,7,8,6,10,28,29,-1,30
Randers FC,1529,8,5,7,12,23,39,-16,22
AGF Aarhus,1529,9,5,6,11,19,37,-18,21
Lyngby,1529,10,3,10,11,26,44,-18,19
Silkeborg IF,1529,11,5,3,14,26,47,-21,18
FC Midtjylla,1530,1,20,4,6,67,38,29,64
Brondby,1530,2,19,6,5,68,37,31,63
FC Nords,1530,3,15,7,8,82,52,30,52
Copenhagen,1530,4,15,5,10,58,46,12,50
AaB,1530,5,8,14,8,38,39,-1,38
Sonderjyske,1530,6,8,6,10,28,29,-1,30
AC Horsens,1530,7,5,12,13,32,59,-27,27
Randers FC,1530,8,6,6,12,25,40,-15,24
Silkeborg IF,1530,9,6,3,13,27,45,-18,21
Lyngby,1530,10,3,9,12,27,46,-19,18
AGF Aarhus,1530,11,4,6,12,17,38,-21,18
FC Midtjylla,1531,1,21,4,5,71,37,34,67
Brondby,1531,2,20,5,5,69,37,32,65
FC Nords,1531,3,15,7,8,76,49,27,52
Copenhagen,1531,4,15,6,9,61,42,19,51
AaB,1531,5,7,11,12,34,49,-15,32
Sonderjyske,1531,6,8,6,10,28,29,-1,30
AC Horsens,1531,7,5,13,12,32,55,-23,28
Lyngby,1531,8,4,9,11,28,44,-16,21
Randers FC,1531,9,5,6,13,23,41,-18,21
Silkeborg IF,1531,10,5,4,13,26,45,-19,19
AGF Aarhus,1531,11,4,7,11,17,37,-20,19
Brondby,1532,1,21,6,3,70,31,39,69
FC Midtjylla,1532,2,20,4,6,64,41,23,64
FC Nords,1532,3,14,6,10,78,56,22,48
Copenhagen,1532,4,14,4,12,57,46,11,46
AaB,1532,5,9,11,10,40,44,-4,38
AC Horsens,1532,6,6,13,11,34,51,-17,31
Sonderjyske,1532,7,8,6,10,28,29,-1,30
Randers FC,1532,8,6,6,12,26,40,-14,24
Silkeborg IF,1532,9,6,3,13,26,44,-18,21
Lyngby,1532,10,3,9,12,27,47,-20,18
AGF Aarhus,1532,11,4,6,12,16,37,-21,18
Brondby,1533,1,21,7,2,75,34,41,70
FC Midtjylla,1533,2,18,5,7,63,42,21,59
FC Nords,1533,3,15,8,7,73,47,26,53
Copenhagen,1533,4,14,4,12,57,48,9,46
AC Horsens,1533,5,8,13,9,35,48,-13,37
Sonderjyske,1533,6,8,6,10,28,29,-1,30
AaB,1533,7,6,11,13,35,45,-10,29
Randers FC,1533,8,5,7,12,24,40,-16,22
Silkeborg IF,1533,9,6,3,13,28,45,-17,21
Lyngby,1533,10,3,10,11,27,45,-18,19
AGF Aarhus,1533,11,4,6,12,17,39,-22,18
Brondby,1534,1,20,6,4,72,36,36,66
FC Midtjylla,1534,2,20,4,6,66,43,23,64
FC Nords,1534,3,16,6,8,81,49,32,54
Copenhagen,1534,4,14,4,12,59,47,12,46
AaB,1534,5,9,12,9,45,47,-2,39
Sonderjyske,1534,6,8,6,10,28,29,-1,30
AC Horsens,1534,7,5,12,13,33,60,-27,27
Randers FC,1534,8,6,6,12,25,40,-15,24
Silkeborg IF,1534,9,5,4,13,27,46,-19,19
AGF Aarhus,1534,10,4,7,11,18,38,-20,19
Lyngby,1534,11,3,9,12,27,46,-19,18
FC Midtjylla,1535,1,21,4,5,71,40,31,67
Brondby,1535,2,20,5,5,68,35,33,65
Copenhagen,1535,3,16,5,9,61,41,20,53
FC Nords,1535,4,14,6,10,75,56,19,48
AaB,1535,5,6,13,11,35,43,-8,31
AC Horsens,1535,6,6,13,11,36,57,-21,31
Sonderjyske,1535,7,8,6,10,28,29,-1,30
Randers FC,1535,8,6,6,12,24,39,-15,24
Silkeborg IF,1535,9,6,3,13,28,45,-17,21
Lyngby,1535,10,3,9,12,26,45,-19,18
AGF Aarhus,1535,11,4,6,12,17,39,-22,18
Brondby,1536,1,20,7,3,70,34,36,67
FC Midtjylla,1536,2,19,6,5,62,37,25,63
Copenhagen,1536,3,16,5,9,63,46,17,53
FC Nords,1536,4,14,6,10,76,54,22,48
AaB,1536,5,7,12,11,40,46,-6,33
Sonderjyske,1536,6,8,6,10,28,29,-1,30
AC Horsens,1536,7,5,14,11,31,51,-20,29
Lyngby,1536,8,4,9,11,28,45,-17,21
Randers FC,1536,9,5,6,13,24,41,-17,21
Silkeborg IF,1536,10,5,4,13,26,45,-19,19
AGF Aarhus,1536,11,4,7,11,17,37,-20,19
Brondby,1537,1,20,7,3,70,32,38,67
FC Midtjylla,1537,2,19,6,5,65,42,23,63
Copenhagen,1537,3,14,5,11,58,42,16,47
FC Nords,1537,4,13,6,11,71,57,14,45
AaB,1537,5,8,12,10,39,43,-4,36
AC Horsens,1537,6,8,12,10,37,50,-13,36
Sonderjyske,1537,7,8,6,10,28,29,-1,30
Lyngby,1537,8,4,9,11,28,45,-17,21
Randers FC,1537,9,5,6,13,24,41,-17,21
AGF Aarhus,1537,10,5,6,11,19,38,-19,21
Silkeborg IF,1537,11,5,3,14,27,47,-20,18
Brondby,1538,1,20,6,4,68,32,36,66
FC Midtjylla,1538,2,19,5,6,67,41,26,62
Copenhagen,1538,3,14,7,9,55,39,16,49
FC Nords,1538,4,13,8,9,70,53,17,47
AaB,1538,5,7,13,10,37,40,-3,34
AC Horsens,1538,6,7,13,10,34,52,-18,34
Sonderjyske,1538,7,8,6,10,28,29,-1,30
Lyngby,1538,8,4,9,11,30,45,-15,21
Silkeborg IF,1538,9,6,3,13,27,45,-18,21
Randers FC,1538,10,5,6,13,24,43,-19,21
AGF Aarhus,1538,11,4,6,12,17,38,-21,18
Brondby,1539,1,22,5,3,73,29,44,71
FC Midtjylla,1539,2,20,4,6,66,40,26,64
Copenhagen,1539,3,15,4,11,61,46,15,49
FC Nords,1539,4,14,6,10,71,58,13,48
AaB,1539,5,8,11,11,37,40,-3,35
Sonderjyske,1539,6,8,6,10,28,29,-1,30
AC Horsens,1539,7,6,12,12,32,53,-21,30
Randers FC,1539,8,5,7,12,25,41,-16,22
Silkeborg IF,1539,9,6,3,13,28,44,-16,21
Lyngby,1539,10,3,10,11,28,46,-18,19
AGF Aarhus,1539,11,4,6,12,16,39,-23,18
Brondby,1540,1,21,5,4,70,30,40,68
FC Midtjylla,1540,2,20,5,5,72,43,29,65
FC Nords,1540,3,15,6,9,76,51,25,51
Copenhagen,1540,4,14,4,12,57,51,6,46
AaB,1540,5,8,13,9,40,42,-2,37
Sonderjyske,1540,6,8,6,10,28,29,-1,30
AC Horsens,1540,7,5,13,12,33,57,-24,28
Lyngby,1540,8,4,9,11,28,45,-17,21
Randers FC,1540,9,5,6,13,24,41,-17,21
AGF Aarhus,1540,10,5,6,11,19,37,-18,21
Silkeborg IF,1540,11,5,3,14,26,47,-21,18
Brondby,1541,1,22,5,3,71,30,41,71
FC Midtjylla,1541,2,20,4,6,69,40,29,64
Copenhagen,1541,3,15,4,11,61,43,18,49
FC Nords,1541,4,14,6,10,71,54,17,48
AaB,1541,5,7,12,11,36,48,-12,33
AC Horsens,1541,6,6,13,11,33,52,-19,31
Sonderjyske,1541,7,8,6,10,28,29,-1,30
Randers FC,1541,8,6,6,12,26,39,-13,24
AGF Aarhus,1541,9,5,6,11,17,36,-19,21
Silkeborg IF,1541,10,5,3,14,25,45,-20,18
Lyngby,1541,11,3,9,12,26,47,-21,18
Brondby,1542,1,21,6,3,72,33,39,69
FC Midtjylla,1542,2,18,4,8,65,45,20,58
FC Nords,1542,3,14,8,8,74,52,22,50
Copenhagen,1542,4,14,7,9,61,45,16,49
AaB,1542,5,7,13,10,38,42,-4,34
AC Horsens,1542,6,6,14,10,38,57,-19,32
Sonderjyske,1542,7,8,6,10,28,29,-1,30
Randers FC,1542,8,5,7,12,25,41,-16,22
AGF Aarhus,1542,9,5,6,11,17,36,-19,21
Lyngby,1542,10,3,10,11,28,46,-18,19
Silkeborg IF,1542,11,5,3,14,25,45,-20,18
Brondby,1543,1,23,5,2,75,31,44,74
FC Midtjylla,1543,2,20,5,5,73,39,34,65
FC Nords,1543,3,13,6,11,74,55,19,45
Copenhagen,1543,4,12,5,13,51,47,4,41
AaB,1543,5,9,11,10,38,44,-6,38
AC Horsens,1543,6,7,12,11,34,55,-21,33
Sonderjyske,1543,7,8,6,10,28,29,-1,30
Lyngby,1543,8,4,9,11,30,47,-17,21
Randers FC,1543,9,5,6,13,26,43,-17,21
Silkeborg IF,1543,10,5,4,13,25,44,-19,19
AGF Aarhus,1543,11,4,7,11,16,36,-20,19
Brondby,1544,1,23,5,2,74,28,46,74
FC Midtjylla,1544,2,19,4,7,63,44,19,61
FC Nords,1544,3,14,7,9,71,51,20,49
Copenhagen,1544,4,15,4,11,59,45,14,49
AaB,1544,5,7,12,11,36,42,-6,33
Sonderjyske,1544,6,8,6,10,28,29,-1,30
AC Horsens,1544,7,5,14,11,33,52,-19,29
Randers FC,1544,8,5,7,12,23,39,-16,22
AGF Aarhus,1544,9,5,6,11,18,36,-18,21
Lyngby,1544,10,3,10,11,26,44,-18,19
Silkeborg IF,1544,11,5,3,14,25,46,-21,18
Brondby,1545,1,20,7,3,71,31,40,67
FC Midtjylla,1545,2,20,4,6,68,38,30,64
Copenhagen,1545,3,16,4,10,60,42,18,52
FC Nords,1545,4,14,7,9,72,55,17,49
AaB,1545,5,6,14,10,32,44,-12,32
Sonderjyske,1545,6,8,6,10,28,29,-1,30
AC Horsens,1545,7,5,14,11,31,50,-19,29
Randers FC,1545,8,6,6,12,25,39,-14,24
Silkeborg IF,1545,9,5,4,13,26,45,-19,19
AGF Aarhus,1545,10,4,7,11,17,37,-20,19
Lyngby,1545,11,3,9,12,26,46,-20,18
Brondby,1546,1,22,6,2,73,30,43,72
FC Midtjylla,1546,2,19,5,6,64,43,21,62
FC Nords,1546,3,14,7,9,72,50,22,49
Copenhagen,1546,4,13,5,12,57,45,12,44
AaB,1546,5,8,11,11,35,42,-7,35
AC Horsens,1546,6,7,12,11,35,52,-17,33
Sonderjyske,1546,7,8,6,10,28,29,-1,30
Randers FC,1546,8,5,7,12,23,39,-16,22
Silkeborg IF,1546,9,6,3,13,28,44,-16,21
Lyngby,1546,10,3,10,11,26,44,-18,19
AGF Aarhus,1546,11,4,6,12,16,39,-23,18
Brondby,1547,1,20,6,4,66,31,35,66
FC Midtjylla,1547,2,19,7,4,65,37,28,64
FC Nords,1547,3,15,7,8,71,48,23,52
Copenhagen,1547,4,15,5,10,60,43,17,50
AaB,1547,5,6,14,10,37,45,-8,32
Sonderjyske,1547,6,8,6,10,28,29,-1,30
AC Horsens,1547,7,5,13,12,31,52,-21,28
Lyngby,1547,8,4,9,11,29,46,-17,21
Randers FC,1547,9,5,6,13,25,42,-17,21
Silkeborg IF,1547,10,6,3,13,27,45,-18,21
AGF Aarhus,1547,11,4,6,12,17,38,-21,18
Brondby,1548,1,20,7,3,68,31,37,67
FC Midtjylla,1548,2,20,6,4,67,35,32,66
FC Nords,1548,3,14,7,9,71,50,21,49
Copenhagen,1548,4,14,5,11,55,43,12,47
AaB,1548,5,8,11,11,36,43,-7,35
Sonderjyske,1548,6,8,6,10,28,29,-1,30
AC Horsens,1548,7,5,14,11,31,52,-21,29
Lyngby,1548,8,4,9,11,28,44,-16,21
Silkeborg IF,1548,9,6,3,13,27,45,-18,21
Randers FC,1548,10,5,6,13,23,41,-18,21
AGF Aarhus,1548,11,4,6,12,17,38,-21,18
Brondby,1549,1,22,6,2,74,30,44,72
FC Midtjylla,1549,2,18,5,7,62,42,20,59
FC Nords,1549,3,15,7,8,73,50,23,52
Copenhagen,1549,4,14,6,10,57,44,13,48
AC Horsens,1549,5,6,14,10,32,50,-18,32
Sonderjyske,1549,6,8,6,10,28,29,-1,30
AaB,1549,7,6,12,12,33,41,-8,30
Randers FC,1549,8,5,7,12,24,40,-16,22
Silkeborg IF,1549,9,6,3,13,28,46,-18,21
Lyngby,1549,10,3,10,11,27,45,-18,19
AGF Aarhus,1549,11,4,6,12,18,39,-21,18
Brondby,1550,1,21,5,4,75,36,39,68
FC Midtjylla,1550,2,20,5,5,67,39,28,65
FC Nords,1550,3,14,6,10,76,56,20,48
Copenhagen,1550,4,13,4,13,56,49,7,43
AaB,1550,5,8,12,10,37,45,-8,36
AC Horsens,1550,6,8,12,10,38,50,-12,36
Sonderjyske,1550,7,8,6,10,28,29,-1,30
Randers FC,1550,8,5,7,12,23,39,-16,22
Silkeborg IF,1550,9,6,3,13,28,45,-17,21
Lyngby,1550,10,3,10,11,26,44,-18,19
AGF Aarhus,1550,11,4,6,12,17,39,-22,18
Brondby,1551,1,22,6,2,71,30,41,72
FC Midtjylla,1551,2,18,6,6,63,39,24,60
FC Nords,1551,3,14,6,10,74,54,20,48
Copenhagen,1551,4,13,5,12,57,50,7,44
AC Horsens,1551,5,8,12,10,38,51,-13,36
AaB,1551,6,7,13,10,37,42,-5,34
Sonderjyske,1551,7,8,6,10,28,29,-1,30
Randers FC,1551,8,5,7,12,25,41,-16,22
Silkeborg IF,1551,9,6,3,13,28,44,-16,21
Lyngby,1551,10,3,10,11,28,46,-18,19
AGF Aarhus,1551,11,4,6,12,16,39,-23,18
FC Midtjylla,1552,1,22,4,4,69,34,35,70
Brondby,1552,2,19,7,4,65,32,33,64
FC Nords,1552,3,15,7,8,77,50,27,52
Copenhagen,1552,4,14,4,12,59,46,13,46
AaB,1552,5,8,11,11,36,46,-10,35
Sonderjyske,1552,6,8,6,10,28,29,-1,30
AC Horsens,1552,7,5,13,12,35,59,-24,28
Randers FC,1552,8,5,7,12,24,40,-16,22
Silkeborg IF,1552,9,6,3,13,26,44,-18,21
Lyngby,1552,10,3,10,11,27,45,-18,19
AGF Aarhus,1552,11,4,6,12,16,37,-21,18
Brondby,1553,1,23,5,2,80,32,48,74
FC Midtjylla,1553,2,19,4,7,64,45,19,61
FC Nords,1553,3,13,7,10,70,58,12,46
Copenhagen,1553,4,13,5,12,59,46,13,44
AaB,1553,5,9,11,10,43,47,-4,38
AC Horsens,1553,6,6,14,10,40,54,-14,32
Sonderjyske,1553,7,8,6,10,28,29,-1,30
Randers FC,1553,8,6,6,12,25,40,-15,24
Silkeborg IF,1553,9,5,4,13,26,45,-19,19
AGF Aarhus,1553,10,4,7,11,17,37,-20,19
Lyngby,1553,11,3,9,12,27,46,-19,18
Brondby,1554,1,21,6,3,69,31,38,69
FC Midtjylla,1554,2,20,5,5,64,37,27,65
Copenhagen,1554,3,14,5,11,54,41,13,47
FC Nords,1554,4,12,7,11,71,56,15,43
AC Horsens,1554,5,8,12,10,37,51,-14,36
AaB,1554,6,7,13,10,41,46,-5,34
Sonderjyske,1554,7,8,6,10,28,29,-1,30
Randers FC,1554,8,5,7,12,24,40,-16,22
AGF Aarhus,1554,9,5,6,11,17,36,-19,21
Lyngby,1554,10,3,10,11,27,45,-18,19
Silkeborg IF,1554,11,5,3,14,25,45,-20,18
Brondby,1555,1,21,6,3,73,33,40,69
FC Midtjylla,1555,2,20,4,6,66,41,25,64
Copenhagen,1555,3,15,5,10,59,42,17,50
FC Nords,1555,4,14,6,10,72,51,21,48
AaB,1555,5,8,12,10,36,43,-7,36
Sonderjyske,1555,6,8,6,10,28,29,-1,30
AC Horsens,1555,7,5,13,12,34,56,-22,28
Randers FC,1555,8,6,6,12,24,39,-15,24
Silkeborg IF,1555,9,6,3,13,28,45,-17,21
Lyngby,1555,10,3,9,12,26,45,-19,18
AGF Aarhus,1555,11,4,6,12,17,39,-22,18
Brondby,1556,1,20,6,4,69,34,35,66
FC Midtjylla,1556,2,19,6,5,63,39,24,63
FC Nords,1556,3,13,9,8,73,51,22,48
Copenhagen,1556,4,14,5,11,58,45,13,47
AaB,1556,5,8,12,10,38,45,-7,36
AC Horsens,1556,6,7,12,11,38,51,-13,33
Sonderjyske,1556,7,8,6,10,28,29,-1,30
Lyngby,1556,8,4,9,11,29,44,-15,21
Randers FC,1556,9,5,6,13,23,42,-19,21
Silkeborg IF,1556,10,5,4,13,27,46,-19,19
AGF Aarhus,1556,11,4,7,11,18,38,-20,19
Brondby,1557,1,20,6,4,71,34,37,66
FC Midtjylla,1557,2,19,7,4,67,38,29,64
Copenhagen,1557,3,15,5,10,58,46,12,50
FC Nords,1557,4,14,6,10,73,55,18,48
AC Horsens,1557,5,7,14,9,37,49,-12,35
Sonderjyske,1557,6,8,6,10,28,29,-1,30
AaB,1557,7,6,12,12,33,43,-10,30
Lyngby,1557,8,4,9,11,28,45,-17,21
Silkeborg IF,1557,9,6,3,13,27,44,-17,21
Randers FC,1557,10,5,6,13,24,41,-17,21
AGF Aarhus,1557,11,4,6,12,16,38,-22,18
Brondby,1558,1,21,5,4,73,33,40,68
FC Midtjylla,1558,2,20,5,5,69,39,30,65
Copenhagen,1558,3,16,4,10,62,45,17,52
FC Nords,1558,4,13,7,10,72,55,17,46
AaB,1558,5,7,12,11,35,45,-10,33
AC Horsens,1558,6,6,13,11,35,55,-20,31
Sonderjyske,1558,7,8,6,10,28,29,-1,30
Lyngby,1558,8,4,9,11,27,44,-17,21
Randers FC,1558,9,5,6,13,23,40,-17,21
Silkeborg IF,1558,10,6,3,13,27,45,-18,21
AGF Aarhus,1558,11,4,6,12,17,38,-21,18
Brondby,1559,1,22,5,3,72,30,42,71
FC Midtjylla,1559,2,22,4,4,70,35,35,70
FC Nords,1559,3,13,7,10,67,49,18,46
Copenhagen,1559,4,12,4,14,53,48,5,40
AaB,1559,5,8,12,10,39,47,-8,36
AC Horsens,1559,6,7,12,11,33,51,-18,33
Sonderjyske,1559,7,8,6,10,28,29,-1,30
Lyngby,1559,8,4,9,11,28,45,-17,21
Randers FC,1559,9,5,6,13,24,41,-17,21
AGF Aarhus,1559,10,5,6,11,19,36,-17,21
Silkeborg IF,1559,11,5,3,14,25,47,-22,18
Brondby,1560,1,22,6,2,78,33,45,72
FC Midtjylla,1560,2,20,5,5,71,41,30,65
FC Nords,1560,3,15,6,9,75,52,23,51
Copenhagen,1560,4,12,5,13,54,49,5,41
AaB,1560,5,8,12,10,35,38,-3,36
Sonderjyske,1560,6,8,6,10,28,29,-1,30
AC Horsens,1560,7,5,14,11,32,58,-26,29
Lyngby,1560,8,4,9,11,28,44,-16,21
Randers FC,1560,9,5,6,13,23,41,-18,21
Silkeborg IF,1560,10,5,4,13,25,44,-19,19
AGF Aarhus,1560,11,4,7,11,16,36,-20,19
Brondby,1561,1,22,6,2,75,30,45,72
FC Midtjylla,1561,2,21,4,5,67,35,32,67
FC Nords,1561,3,15,6,9,72,54,18,51
Copenhagen,1561,4,14,4,12,58,47,11,46
AaB,1561,5,6,13,11,34,45,-11,31
Sonderjyske,1561,6,8,6,10,28,29,-1,30
AC Horsens,1561,7,5,13,12,35,56,-21,28
Lyngby,1561,8,4,9,11,27,44,-17,21
Randers FC,1561,9,5,6,13,23,40,-17,21
Silkeborg IF,1561,10,6,3,13,27,45,-18,21
AGF Aarhus,1561,11,4,6,12,17,38,-21,18
Brondby,1562,1,22,6,2,73,29,44,72
FC Midtjylla,1562,2,20,4,6,71,40,31,64
FC Nords,1562,3,13,7,10,73,56,17,46
Copenhagen,1562,4,13,7,10,58,44,14,46
AaB,1562,5,8,11,11,35,44,-9,35
AC Horsens,1562,6,6,13,11,34,57,-23,31
Sonderjyske,1562,7,8,6,10,28,29,-1,30
Randers FC,1562,8,5,7,12,24,40,-16,22
Silkeborg IF,1562,9,6,3,13,27,45,-18,21
Lyngby,1562,10,3,10,11,27,45,-18,19
AGF Aarhus,1562,11,4,6,12,17,38,-21,18
Brondby,1563,1,20,7,3,68,28,40,67
FC Midtjylla,1563,2,19,5,6,63,40,23,62
FC Nords,1563,3,13,9,8,74,51,23,48
Copenhagen,1563,4,13,7,10,55,42,13,46
AaB,1563,5,7,13,10,36,46,-10,34
AC Horsens,1563,6,7,13,10,34,49,-15,34
Sonderjyske,1563,7,8,6,10,28,29,-1,30
Lyngby,1563,8,4,9,11,28,45,-17,21
Randers FC,1563,9,5,6,13,24,41,-17,21
Silkeborg IF,1563,10,5,4,13,26,45,-19,19
AGF Aarhus,1563,11,4,7,11,17,37,-20,19
Brondby,1564,1,21,5,4,69,32,37,68
FC Midtjylla,1564,2,19,6,5,65,38,27,63
FC Nords,1564,3,15,7,8,75,50,25,52
Copenhagen,1564,4,13,6,11,56,45,11,45
AaB,1564,5,8,12,10,36,43,-7,36
Sonderjyske,1564,6,8,6,10,28,29,-1,30
AC Horsens,1564,7,6,12,12,32,51,-19,30
Silkeborg IF,1564,8,6,3,13,28,44,-16,21
Lyngby,1564,9,4,9,11,27,44,-17,21
Randers FC,1564,10,5,6,13,23,40,-17,21
AGF Aarhus,1564,11,4,6,12,16,39,-23,18
Brondby,1565,1,23,5,2,74,29,45,74
FC Midtjylla,1565,2,19,5,6,63,41,22,62
Copenhagen,1565,3,14,5,11,58,44,14,47
FC Nords,1565,4,13,7,10,71,55,16,46
AC Horsens,1565,5,6,15,9,39,53,-14,33
AaB,1565,6,7,11,12,37,46,-9,32
Sonderjyske,1565,7,8,6,10,28,29,-1,30
Lyngby,1565,8,4,9,11,29,44,-15,21
Silkeborg IF,1565,9,6,3,13,27,45,-18,21
Randers FC,1565,10,5,6,13,23,42,-19,21
AGF Aarhus,1565,11,4,6,12,17,38,-21,18
Brondby,1566,1,20,6,4,71,37,34,66
FC Midtjylla,1566,2,19,5,6,66,43,23,62
Copenhagen,1566,3,15,6,9,59,40,19,51
FC Nords,1566,4,13,7,10,74,57,17,46
AaB,1566,5,8,13,9,37,41,-4,37
AC Horsens,1566,6,6,13,11,38,53,-15,31
Sonderjyske,1566,7,8,6,10,28,29,-1,30
Randers FC,1566,8,5,7,12,23,39,-16,22
AGF Aarhus,1566,9,5,6,11,18,36,-18,21
Lyngby,1566,10,3,10,11,26,44,-18,19
Silkeborg IF,1566,11,5,3,14,25,46,-21,18
Brondby,1567,1,19,6,5,68,36,32,63
FC Midtjylla,1567,2,19,5,6,69,39,30,62
Copenhagen,1567,3,16,5,9,62,44,18,53
FC Nords,1567,4,13,9,8,73,51,22,48
AaB,1567,5,8,13,9,36,40,-4,37
Sonderjyske,1567,6,8,6,10,28,29,-1,30
AC Horsens,1567,7,5,14,11,36,60,-24,29
Lyngby,1567,8,4,9,11,27,44,-17,21
Randers FC,1567,9,5,6,13,23,40,-17,21
Silkeborg IF,1567,10,6,3,13,28,46,-18,21
AGF Aarhus,1567,11,4,6,12,18,39,-21,18
Brondby,1568,1,22,5,3,71,29,42,71
FC Midtjylla,1568,2,20,5,5,64,37,27,65
FC Nords,1568,3,14,7,9,75,53,22,49
Copenhagen,1568,4,13,5,12,57,51,6,44
AC Horsens,1568,5,8,12,10,38,51,-13,36
Sonderjyske,1568,6,8,6,10,28,29,-1,30
AaB,1568,7,6,12,12,35,45,-10,30
Lyngby,1568,8,4,9,11,28,45,-17,21
Silkeborg IF,1568,9,6,3,13,27,44,-17,21
Randers FC,1568,10,5,6,13,24,41,-17,21
AGF Aarhus,1568,11,4,6,12,16,38,-22,18
Brondby,1569,1,21,5,4,70,33,37,68
FC Midtjylla,1569,2,18,6,6,66,43,23,60
FC Nords,1569,3,15,7,8,76,50,26,52
Copenhagen,1569,4,14,5,11,56,44,12,47
AaB,1569,5,7,13,10,39,47,-8,34
AC Horsens,1569,6,6,14,10,35,51,-16,32
Sonderjyske,1569,7,8,6,10,28,29,-1,30
Randers FC,1569,8,6,6,12,24,39,-15,24
Silkeborg IF,1569,9,6,3,13,27,44,-17,21
Lyngby,1569,10,3,9,12,26,45,-19,18
AGF Aarhus,1569,11,4,6,12,16,38,-22,18
Brondby,1570,1,21,5,4,68,30,38,68
FC Midtjylla,1570,2,21,4,5,66,37,29,67
FC Nords,1570,3,13,7,10,69,52,17,46
Copenhagen,1570,4,14,4,12,59,45,14,46
AaB,1570,5,7,13,10,35,42,-7,34
AC Horsens,1570,6,7,13,10,31,48,-17,34
Sonderjyske,1570,7,8,6,10,28,29,-1,30
Lyngby,1570,8,4,9,11,28,44,-16,21
Randers FC,1570,9,5,6,13,23,41,-18,21
AGF Aarhus,1570,10,5,6,11,18,37,-19,21
Silkeborg IF,1570,11,5,3,14,26,46,-20,18
Brondby,1571,1,20,6,4,69,32,37,66
FC Midtjylla,1571,2,20,5,5,66,39,27,65
FC Nords,1571,3,14,6,10,71,50,21,48
Copenhagen,1571,4,14,4,12,55,43,12,46
AaB,1571,5,8,12,10,37,43,-6,36
AC Horsens,1571,6,7,13,10,34,51,-17,34
Sonderjyske,1571,7,8,6,10,28,29,-1,30
Randers FC,1571,8,6,6,12,25,39,-14,24
Silkeborg IF,1571,9,5,4,13,26,45,-19,19
AGF Aarhus,1571,10,4,7,11,17,37,-20,19
Lyngby,1571,11,3,9,12,26,46,-20,18
Brondby,1572,1,20,8,2,74,34,40,68
FC Midtjylla,1572,2,18,6,6,70,45,25,60
Copenhagen,1572,3,13,7,10,58,46,12,46
FC Nords,1572,4,12,9,9,71,56,15,45
AaB,1572,5,8,12,10,39,43,-4,36
AC Horsens,1572,6,6,16,8,36,50,-14,34
Sonderjyske,1572,7,8,6,10,28,29,-1,30
Lyngby,1572,8,4,9,11,28,44,-16,21
Randers FC,1572,9,5,6,13,23,41,-18,21
AGF Aarhus,1572,10,5,6,11,18,36,-18,21
Silkeborg IF,1572,11,5,3,14,25,46,-21,18
Brondby,1573,1,20,6,4,68,32,36,66
FC Midtjylla,1573,2,20,5,5,65,38,27,65
FC Nords,1573,3,13,8,9,70,53,17,47
Copenhagen,1573,4,14,5,11,58,46,12,47
AaB,1573,5,7,13,10,35,39,-4,34
AC Horsens,1573,6,6,15,9,39,53,-14,33
Sonderjyske,1573,7,8,6,10,28,29,-1,30
Randers FC,1573,8,5,7,12,24,40,-16,22
AGF Aarhus,1573,9,5,6,11,17,36,-19,21
Lyngby,1573,10,3,10,11,27,45,-18,19
Silkeborg IF,1573,11,5,3,14,25,45,-20,18
Brondby,1574,1,21,6,3,67,28,39,69
FC Midtjylla,1574,2,20,4,6,63,38,25,64
FC Nords,1574,3,14,7,9,73,49,24,49
Copenhagen,1574,4,13,5,12,57,45,12,44
AaB,1574,5,8,12,10,35,43,-8,36
AC Horsens,1574,6,6,14,10,34,52,-18,32
Sonderjyske,1574,7,8,6,10,28,29,-1,30
Randers FC,1574,8,5,7,12,25,41,-16,22
Silkeborg IF,1574,9,6,3,13,26,44,-18,21
Lyngby,1574,10,3,10,11,28,46,-18,19
AGF Aarhus,1574,11,4,6,12,16,37,-21,18
Brondby,1575,1,20,7,3,70,33,37,67
FC Midtjylla,1575,2,20,4,6,66,40,26,64
FC Nords,1575,3,16,7,7,80,52,28,55
Copenhagen,1575,4,14,5,11,60,46,14,47
AaB,1575,5,7,13,10,41,47,-6,34
Sonderjyske,1575,6,8,6,10,28,29,-1,30
AC Horsens,1575,7,5,12,13,36,61,-25,27
Lyngby,1575,8,4,9,11,30,46,-16,21
Silkeborg IF,1575,9,6,3,13,29,45,-16,21
Randers FC,1575,10,5,6,13,25,43,-18,21
AGF Aarhus,1575,11,4,6,12,17,40,-23,18
Brondby,1576,1,20,6,4,69,32,37,66
FC Midtjylla,1576,2,20,4,6,65,39,26,64
FC Nords,1576,3,15,6,9,76,51,25,51
Copenhagen,1576,4,14,6,10,57,44,13,48
AC Horsens,1576,5,7,13,10,39,57,-18,34
AaB,1576,6,7,11,12,36,45,-9,32
Sonderjyske,1576,7,8,6,10,28,29,-1,30
Randers FC,1576,8,6,6,12,26,40,-14,24
Silkeborg IF,1576,9,6,3,13,28,45,-17,21
Lyngby,1576,10,3,9,12,27,47,-20,18
AGF Aarhus,1576,11,4,6,12,17,39,-22,18
Brondby,1577,1,20,8,2,71,33,38,68
FC Midtjylla,1577,2,20,5,5,65,36,29,65
FC Nords,1577,3,13,8,9,74,52,22,47
Copenhagen,1577,4,13,5,12,57,48,9,44
AaB,1577,5,9,12,9,42,42,0,39
Sonderjyske,1577,6,8,6,10,28,29,-1,30
AC Horsens,1577,7,6,12,12,31,55,-24,30
Randers FC,1577,8,6,6,12,25,40,-15,24
AGF Aarhus,1577,9,5,6,11,19,38,-19,21
Lyngby,1577,10,3,9,12,27,46,-19,18
Silkeborg IF,1577,11,5,3,14,27,47,-20,18
Brondby,1578,1,21,5,4,78,39,39,68
FC Midtjylla,1578,2,21,4,5,81,40,41,67
FC Nords,1578,3,14,7,9,77,58,19,49
Copenhagen,1578,4,14,6,10,61,45,16,48
AaB,1578,5,7,12,11,39,54,-15,33
Sonderjyske,1578,6,8,6,10,28,29,-1,30
AC Horsens,1578,7,6,12,12,33,59,-26,30
Lyngby,1578,8,4,9,11,28,44,-16,21
Silkeborg IF,1578,9,6,3,13,27,45,-18,21
Randers FC,1578,10,5,6,13,23,41,-18,21
AGF Aarhus,1578,11,4,6,12,17,38,-21,18
FC Midtjylla,1579,1,21,5,4,69,34,35,68
Brondby,1579,2,19,6,5,67,37,30,63
FC Nords,1579,3,13,10,7,76,53,23,49
Copenhagen,1579,4,14,5,11,58,42,16,47
AaB,1579,5,8,11,11,35,45,-10,35
AC Horsens,1579,6,6,13,11,34,54,-20,31
Sonderjyske,1579,7,8,6,10,28,29,-1,30
Randers FC,1579,8,5,7,12,24,40,-16,22
Silkeborg IF,1579,9,6,3,13,28,45,-17,21
Lyngby,1579,10,3,10,11,27,45,-18,19
AGF Aarhus,1579,11,4,6,12,17,39,-22,18
Brondby,1580,1,20,6,4,68,32,36,66
FC Midtjylla,1580,2,19,5,6,64,41,23,62
FC Nords,1580,3,12,10,8,70,50,20,46
Copenhagen,1580,4,13,6,11,56,45,11,45
AaB,1580,5,8,13,9,37,39,-2,37
AC Horsens,1580,6,7,14,9,38,52,-14,35
Sonderjyske,1580,7,8,6,10,28,29,-1,30
Silkeborg IF,1580,8,6,3,13,29,46,-17,21
Lyngby,1580,9,4,9,11,27,44,-17,21
Randers FC,1580,10,5,6,13,23,40,-17,21
AGF Aarhus,1580,11,4,6,12,18,40,-22,18
Brondby,1581,1,21,6,3,70,31,39,69
FC Midtjylla,1581,2,20,4,6,67,41,26,64
FC Nords,1581,3,14,7,9,76,52,24,49
Copenhagen,1581,4,14,4,12,58,48,10,46
AC Horsens,1581,5,7,13,10,36,55,-19,34
AaB,1581,6,7,12,11,36,42,-6,33
Sonderjyske,1581,7,8,6,10,28,29,-1,30
Lyngby,1581,8,4,9,11,27,44,-17,21
Randers FC,1581,9,5,6,13,23,40,-17,21
Silkeborg IF,1581,10,6,3,13,27,45,-18,21
AGF Aarhus,1581,11,4,6,12,17,38,-21,18
Brondby,1582,1,19,8,3,74,38,36,65
FC Midtjylla,1582,2,18,6,6,59,38,21,60
Copenhagen,1582,3,15,6,9,62,45,17,51
FC Nords,1582,4,14,7,9,73,51,22,49
AC Horsens,1582,5,6,15,9,38,52,-14,33
AaB,1582,6,6,14,10,39,47,-8,32
Sonderjyske,1582,7,8,6,10,28,29,-1,30
Randers FC,1582,8,6,6,12,24,39,-15,24
Silkeborg IF,1582,9,5,4,13,27,46,-19,19
AGF Aarhus,1582,10,4,7,11,18,38,-20,19
Lyngby,1582,11,3,9,12,26,45,-19,18
Brondby,1583,1,20,7,3,71,33,38,67
FC Midtjylla,1583,2,20,5,5,69,39,30,65
FC Nords,1583,3,14,7,9,72,48,24,49
Copenhagen,1583,4,14,6,10,57,46,11,48
AaB,1583,5,7,12,11,36,44,-8,33
AC Horsens,1583,6,6,13,11,32,53,-21,31
Sonderjyske,1583,7,8,6,10,28,29,-1,30
Randers FC,1583,8,6,6,12,24,39,-15,24
AGF Aarhus,1583,9,5,6,11,18,37,-19,21
Lyngby,1583,10,3,9,12,26,45,-19,18
Silkeborg IF,1583,11,5,3,14,26,46,-20,18
FC Midtjylla,1584,1,21,5,4,69,36,33,68
Brondby,1584,2,20,6,4,73,34,39,66
FC Nords,1584,3,14,6,10,75,57,18,48
Copenhagen,1584,4,13,4,13,56,51,5,43
AC Horsens,1584,5,8,12,10,37,53,-16,36
AaB,1584,6,8,11,11,42,47,-5,35
Sonderjyske,1584,7,8,6,10,28,29,-1,30
Randers FC,1584,8,6,6,12,26,40,-14,24
Silkeborg IF,1584,9,5,4,13,26,45,-19,19
AGF Aarhus,1584,10,4,7,11,17,37,-20,19
Lyngby,1584,11,3,9,12,27,47,-20,18
Brondby,1585,1,19,9,2,67,29,38,66
FC Midtjylla,1585,2,18,8,4,61,36,25,62
FC Nords,1585,3,14,9,7,74,51,23,51
Copenhagen,1585,4,12,6,12,55,49,6,42
AaB,1585,5,8,12,10,38,37,1,36
AC Horsens,1585,6,6,14,10,33,52,-19,32
Sonderjyske,1585,7,8,6,10,28,29,-1,30
Lyngby,1585,8,4,9,11,28,45,-17,21
Randers FC,1585,9,5,6,13,24,41,-17,21
Silkeborg IF,1585,10,5,4,13,26,45,-19,19
AGF Aarhus,1585,11,4,7,11,17,37,-20,19
Brondby,1586,1,20,6,4,69,37,32,66
FC Midtjylla,1586,2,19,5,6,67,39,28,62
Copenhagen,1586,3,15,5,10,60,45,15,50
FC Nords,1586,4,14,7,9,80,51,29,49
AaB,1586,5,7,13,10,35,43,-8,34
AC Horsens,1586,6,7,12,11,40,62,-22,33
Sonderjyske,1586,7,8,6,10,28,29,-1,30
Lyngby,1586,8,4,9,11,28,45,-17,21
Randers FC,1586,9,5,6,13,24,41,-17,21
Silkeborg IF,1586,10,6,3,13,27,45,-18,21
AGF Aarhus,1586,11,4,6,12,17,38,-21,18
Brondby,1587,1,23,5,2,75,30,45,74
FC Midtjylla,1587,2,20,5,5,67,37,30,65
FC Nords,1587,3,13,8,9,74,57,17,47
Copenhagen,1587,4,13,7,10,62,46,16,46
AaB,1587,5,7,12,11,38,46,-8,33
Sonderjyske,1587,6,8,6,10,28,29,-1,30
AC Horsens,1587,7,5,13,12,31,57,-26,28
Randers FC,1587,8,6,6,12,25,40,-15,24
AGF Aarhus,1587,9,5,6,11,19,37,-18,21
Lyngby,1587,10,3,9,12,27,46,-19,18
Silkeborg IF,1587,11,5,3,14,26,47,-21,18
Brondby,1588,1,21,6,3,75,38,37,69
FC Midtjylla,1588,2,20,4,6,69,41,28,64
Copenhagen,1588,3,16,4,10,63,45,18,52
FC Nords,1588,4,13,7,10,76,56,20,46
AC Horsens,1588,5,7,13,10,34,52,-18,34
Sonderjyske,1588,6,8,6,10,28,29,-1,30
AaB,1588,7,6,12,12,36,47,-11,30
Randers FC,1588,8,5,7,12,23,39,-16,22
Lyngby,1588,9,3,10,11,26,44,-18,19
Silkeborg IF,1588,10,5,4,13,27,46,-19,19
AGF Aarhus,1588,11,4,7,11,18,38,-20,19
Brondby,1589,1,20,8,2,70,29,41,68
FC Midtjylla,1589,2,19,6,5,62,34,28,63
Copenhagen,1589,3,15,5,10,60,44,16,50
FC Nords,1589,4,13,8,9,74,52,22,47
AaB,1589,5,7,12,11,33,41,-8,33
AC Horsens,1589,6,6,13,11,33,58,-25,31
Sonderjyske,1589,7,8,6,10,28,29,-1,30
Randers FC,1589,8,5,7,12,24,40,-16,22
Silkeborg IF,1589,9,6,3,13,27,44,-17,21
Lyngby,1589,10,3,10,11,27,45,-18,19
AGF Aarhus,1589,11,4,6,12,16,38,-22,18
Brondby,1590,1,21,5,4,71,32,39,68
FC Midtjylla,1590,2,20,6,4,70,40,30,66
Copenhagen,1590,3,16,5,9,64,44,20,53
FC Nords,1590,4,13,6,11,73,57,16,45
AaB,1590,5,7,13,10,38,44,-6,34
Sonderjyske,1590,6,8,6,10,28,29,-1,30
AC Horsens,1590,7,5,13,12,36,61,-25,28
Randers FC,1590,8,6,6,12,26,40,-14,24
Silkeborg IF,1590,9,6,3,13,27,45,-18,21
Lyngby,1590,10,3,9,12,27,47,-20,18
AGF Aarhus,1590,11,4,6,12,17,38,-21,18
Brondby,1591,1,21,6,3,72,31,41,69
FC Midtjylla,1591,2,19,6,5,62,39,23,63
Copenhagen,1591,3,15,5,10,59,40,19,50
FC Nords,1591,4,13,7,10,69,55,14,46
AC Horsens,1591,5,7,13,10,38,52,-14,34
AaB,1591,6,7,11,12,34,43,-9,32
Sonderjyske,1591,7,8,6,10,28,29,-1,30
Lyngby,1591,8,4,9,11,27,44,-17,21
Randers FC,1591,9,5,6,13,23,40,-17,21
Silkeborg IF,1591,10,5,4,13,25,44,-19,19
AGF Aarhus,1591,11,4,7,11,16,36,-20,19
Brondby,1592,1,22,5,3,70,28,42,71
FC Midtjylla,1592,2,21,4,5,64,36,28,67
FC Nords,1592,3,14,6,10,71,49,22,48
Copenhagen,1592,4,14,4,12,56,46,10,46
AC Horsens,1592,5,7,12,11,33,50,-17,33
AaB,1592,6,7,11,12,37,48,-11,32
Sonderjyske,1592,7,8,6,10,28,29,-1,30
Randers FC,1592,8,6,6,12,26,40,-14,24
Silkeborg IF,1592,9,6,3,13,29,44,-15,21
Lyngby,1592,10,3,9,12,27,47,-20,18
AGF Aarhus,1592,11,4,6,12,16,40,-24,18
Brondby,1593,1,22,6,2,70,31,39,72
FC Midtjylla,1593,2,19,5,6,61,38,23,62
Copenhagen,1593,3,14,5,11,58,46,12,47
FC Nords,1593,4,13,7,10,65,46,19,46
AaB,1593,5,9,12,9,38,38,0,39
Sonderjyske,1593,6,8,6,10,28,29,-1,30
AC Horsens,1593,7,5,13,12,31,50,-19,28
Lyngby,1593,8,4,9,11,29,45,-16,21
Randers FC,1593,9,5,6,13,24,42,-18,21
Silkeborg IF,1593,10,5,4,13,25,44,-19,19
AGF Aarhus,1593,11,4,7,11,16,36,-20,19
Brondby,1594,1,21,6,3,77,35,42,69
FC Midtjylla,1594,2,19,5,6,65,40,25,62
Copenhagen,1594,3,15,5,10,59,42,17,50
FC Nords,1594,4,14,7,9,73,55,18,49
AC Horsens,1594,5,7,12,11,38,56,-18,33
AaB,1594,6,7,11,12,37,47,-10,32
Sonderjyske,1594,7,8,6,10,28,29,-1,30
Randers FC,1594,8,6,6,12,24,39,-15,24
Silkeborg IF,1594,9,6,3,13,27,44,-17,21
Lyngby,1594,10,3,9,12,26,45,-19,18
AGF Aarhus,1594,11,4,6,12,16,38,-22,18
Brondby,1595,1,22,5,3,76,28,48,71
FC Midtjylla,1595,2,20,6,4,67,36,31,66
FC Nords,1595,3,13,8,9,71,59,12,47
Copenhagen,1595,4,13,5,12,55,47,8,44
AaB,1595,5,7,12,11,36,43,-7,33
AC Horsens,1595,6,6,14,10,34,52,-18,32
Sonderjyske,1595,7,8,6,10,28,29,-1,30
Randers FC,1595,8,5,7,12,24,40,-16,22
AGF Aarhus,1595,9,5,6,11,18,37,-19,21
Lyngby,1595,10,3,10,11,27,45,-18,19
Silkeborg IF,1595,11,5,3,14,26,46,-20,18
Brondby,1596,1,21,7,2,74,33,41,70
FC Midtjylla,1596,2,19,5,6,64,40,24,62
FC Nords,1596,3,14,8,8,71,47,24,50
Copenhagen,1596,4,12,5,13,55,48,7,41
AaB,1596,5,10,11,9,40,40,0,41
Sonderjyske,1596,6,8,6,10,28,29,-1,30
AC Horsens,1596,7,5,14,11,35,57,-22,29
Randers FC,1596,8,5,7,12,24,40,-16,22
Lyngby,1596,9,3,10,11,27,45,-18,19
Silkeborg IF,1596,10,5,4,13,25,44,-19,19
AGF Aarhus,1596,11,4,7,11,16,36,-20,19
Brondby,1597,1,21,6,3,73,33,40,69
FC Midtjylla,1597,2,19,6,5,66,39,27,63
FC Nords,1597,3,16,6,8,81,51,30,54
Copenhagen,1597,4,14,5,11,62,52,10,47
AaB,1597,5,7,13,10,38,43,-5,34
Sonderjyske,1597,6,8,6,10,28,29,-1,30
AC Horsens,1597,7,5,12,13,33,61,-28,27
Lyngby,1597,8,4,9,11,28,45,-17,21
Randers FC,1597,9,5,6,13,24,41,-17,21
Silkeborg IF,1597,10,6,3,13,26,44,-18,21
AGF Aarhus,1597,11,4,6,12,16,37,-21,18
Brondby,1598,1,20,7,3,69,35,34,67
FC Midtjylla,1598,2,17,7,6,61,39,22,58
FC Nords,1598,3,14,6,10,68,50,18,48
Copenhagen,1598,4,14,5,11,58,40,18,47
AaB,1598,5,8,14,8,35,37,-2,38
AC Horsens,1598,6,6,15,9,36,52,-16,33
Sonderjyske,1598,7,8,6,10,28,29,-1,30
Randers FC,1598,8,6,6,12,26,41,-15,24
Silkeborg IF,1598,9,6,3,13,27,44,-17,21
Lyngby,1598,10,3,9,12,28,47,-19,18
AGF Aarhus,1598,11,4,6,12,16,38,-22,18
Brondby,1599,1,20,7,3,69,33,36,67
FC Midtjylla,1599,2,17,6,7,62,47,15,57
FC Nords,1599,3,15,6,9,80,49,31,51
Copenhagen,1599,4,15,5,10,59,44,15,50
AaB,1599,5,7,13,10,38,43,-5,34
AC Horsens,1599,6,6,15,9,36,54,-18,33
Sonderjyske,1599,7,8,6,10,28,29,-1,30
Randers FC,1599,8,6,6,12,25,40,-15,24
Silkeborg IF,1599,9,5,4,13,26,45,-19,19
AGF Aarhus,1599,10,4,7,11,17,37,-20,19
Lyngby,1599,11,3,9,12,27,46,-19,18
Brondby,1600,1,21,5,4,70,34,36,68
FC Midtjylla,1600,2,20,5,5,70,40,30,65
Copenhagen,1600,3,16,4,10,59,40,19,52
FC Nords,1600,4,13,6,11,71,57,14,45
AC Horsens,1600,5,7,13,10,34,50,-16,34
AaB,1600,6,6,13,11,34,43,-9,31
Sonderjyske,1600,7,8,6,10,28,29,-1,30
Lyngby,1600,8,4,9,11,29,46,-17,21
Randers FC,1600,9,5,6,13,25,42,-17,21
AGF Aarhus,1600,10,5,6,11,18,37,-19,21
Silkeborg IF,1600,11,5,3,14,26,46,-20,18
Brondby,1601,1,22,6,2,71,28,43,72
FC Midtjylla,1601,2,18,5,7,62,41,21,59
Copenhagen,1601,3,14,6,10,61,44,17,48
FC Nords,1601,4,13,8,9,74,54,20,47
AaB,1601,5,7,13,10,37,45,-8,34
AC Horsens,1601,6,7,12,11,33,52,-19,33
Sonderjyske,1601,7,8,6,10,28,29,-1,30
Randers FC,1601,8,5,7,12,24,40,-16,22
AGF Aarhus,1601,9,5,6,11,19,38,-19,21
Lyngby,1601,10,3,10,11,27,45,-18,19
Silkeborg IF,1601,11,5,3,14,27,47,-20,18
Brondby,1602,1,22,6,2,74,32,42,72
FC Midtjylla,1602,2,18,5,7,59,37,22,59
FC Nords,1602,3,15,7,8,73,49,24,52
Copenhagen,1602,4,13,4,13,54,47,7,43
AC Horsens,1602,5,7,14,9,38,49,-11,35
AaB,1602,6,7,12,11,34,44,-10,33
Sonderjyske,1602,7,8,6,10,28,29,-1,30
Lyngby,1602,8,4,9,11,28,44,-16,21
Silkeborg IF,1602,9,6,3,13,26,44,-18,21
Randers FC,1602,10,5,6,13,23,41,-18,21
AGF Aarhus,1602,11,4,6,12,16,37,-21,18
Brondby,1603,1,21,7,2,72,30,42,70
FC Midtjylla,1603,2,19,6,5,65,41,24,63
Copenhagen,1603,3,14,7,9,59,43,16,49
FC Nords,1603,4,13,7,10,74,57,17,46
AaB,1603,5,6,14,10,37,44,-7,32
Sonderjyske,1603,6,8,6,10,28,29,-1,30
AC Horsens,1603,7,5,15,10,35,53,-18,30
Randers FC,1603,8,6,6,12,24,39,-15,24
Silkeborg IF,1603,9,6,3,13,30,46,-16,21
Lyngby,1603,10,3,9,12,26,45,-19,18
AGF Aarhus,1603,11,4,6,12,18,41,-23,18
Brondby,1604,1,20,5,5,67,34,33,65
FC Midtjylla,1604,2,18,5,7,65,43,22,59
FC Nords,1604,3,15,7,8,75,49,26,52
Copenhagen,1604,4,14,4,12,57,46,11,46
AC Horsens,1604,5,9,13,8,39,49,-10,40
AaB,1604,6,7,12,11,38,46,-8,33
Sonderjyske,1604,7,8,6,10,28,29,-1,30
Lyngby,1604,8,4,9,11,27,44,-17,21
Randers FC,1604,9,5,6,13,23,40,-17,21
Silkeborg IF,1604,10,5,4,13,27,46,-19,19
AGF Aarhus,1604,11,4,7,11,18,38,-20,19
Brondby,1605,1,21,6,3,72,33,39,69
FC Midtjylla,1605,2,18,6,6,62,42,20,60
FC Nords,1605,3,13,9,8,76,55,21,48
Copenhagen,1605,4,14,4,12,60,46,14,46
AC Horsens,1605,5,7,14,9,36,49,-13,35
AaB,1605,6,7,13,10,39,46,-7,34
Sonderjyske,1605,7,8,6,10,28,29,-1,30
Randers FC,1605,8,5,7,12,24,40,-16,22
Lyngby,1605,9,3,10,11,27,45,-18,19
Silkeborg IF,1605,10,5,4,13,26,45,-19,19
AGF Aarhus,1605,11,4,7,11,17,37,-20,19
Brondby,1606,1,21,7,2,74,33,41,70
FC Midtjylla,1606,2,18,5,7,64,40,24,59
FC Nords,1606,3,16,7,7,79,53,26,55
Copenhagen,1606,4,14,4,12,53,46,7,46
AaB,1606,5,7,13,10,40,45,-5,34
Sonderjyske,1606,6,8,6,10,28,29,-1,30
AC Horsens,1606,7,6,12,12,35,54,-19,30
Randers FC,1606,8,5,7,12,25,41,-16,22
AGF Aarhus,1606,9,5,6,11,17,36,-19,21
Lyngby,1606,10,3,10,11,28,46,-18,19
Silkeborg IF,1606,11,5,3,14,25,45,-20,18
FC Midtjylla,1607,1,22,4,4,72,38,34,70
Brondby,1607,2,21,6,3,77,35,42,69
FC Nords,1607,3,15,7,8,76,53,23,52
Copenhagen,1607,4,13,4,13,55,50,5,43
AC Horsens,1607,5,7,12,11,36,52,-16,33
Sonderjyske,1607,6,8,6,10,28,29,-1,30
AaB,1607,7,6,11,13,36,50,-14,29
Lyngby,1607,8,4,9,11,27,44,-17,21
Silkeborg IF,1607,8,6,3,13,27,44,-17,21
Randers FC,1607,10,5,6,13,23,40,-17,21
AGF Aarhus,1607,11,4,6,12,16,38,-22,18
Brondby,1608,1,21,6,3,72,33,39,69
FC Midtjylla,1608,2,18,5,7,63,40,23,59
FC Nords,1608,3,14,8,8,70,49,21,50
Copenhagen,1608,4,13,6,11,54,46,8,45
AaB,1608,5,8,12,10,38,41,-3,36
AC Horsens,1608,6,7,13,10,35,49,-14,34
Sonderjyske,1608,7,8,6,10,28,29,-1,30
Lyngby,1608,8,4,9,11,27,44,-17,21
Randers FC,1608,9,5,6,13,23,40,-17,21
Silkeborg IF,1608,10,6,3,13,27,45,-18,21
AGF Aarhus,1608,11,4,6,12,17,38,-21,18
Brondby,1609,1,19,8,3,72,37,35,65
FC Midtjylla,1609,2,19,6,5,70,45,25,63
FC Nords,1609,3,15,7,8,78,52,26,52
Copenhagen,1609,4,14,5,11,57,46,11,47
AaB,1609,5,8,13,9,41,43,-2,37
Sonderjyske,1609,6,8,6,10,28,29,-1,30
AC Horsens,1609,7,5,13,12,34,55,-21,28
Lyngby,1609,8,4,9,11,27,44,-17,21
Randers FC,1609,9,5,6,13,23,40,-17,21
AGF Aarhus,1609,10,5,6,11,19,37,-18,21
Silkeborg IF,1609,11,5,3,14,26,47,-21,18
Brondby,1610,1,20,7,3,71,35,36,67
FC Midtjylla,1610,2,19,4,7,64,41,23,61
Copenhagen,1610,3,15,5,10,57,42,15,50
FC Nords,1610,4,13,9,8,71,50,21,48
AC Horsens,1610,5,6,15,9,34,49,-15,33
AaB,1610,6,6,14,10,35,41,-6,32
Sonderjyske,1610,7,8,6,10,28,29,-1,30
Randers FC,1610,8,5,7,12,23,39,-16,22
Silkeborg IF,1610,9,6,3,13,27,45,-18,21
Lyngby,1610,10,3,10,11,26,44,-18,19
AGF Aarhus,1610,11,4,6,12,17,38,-21,18
Brondby,1611,1,21,6,3,73,37,36,69
FC Midtjylla,1611,2,20,5,5,68,38,30,65
FC Nords,1611,3,13,9,8,73,50,23,48
Copenhagen,1611,4,14,4,12,58,46,12,46
AaB,1611,5,9,12,9,43,40,3,39
Sonderjyske,1611,6,8,6,10,28,29,-1,30
AC Horsens,1611,7,5,12,13,30,60,-30,27
Randers FC,1611,8,5,7,12,24,40,-16,22
Silkeborg IF,1611,9,6,3,13,28,46,-18,21
Lyngby,1611,10,3,10,11,27,45,-18,19
AGF Aarhus,1611,11,4,6,12,18,39,-21,18
Brondby,1612,1,22,5,3,70,31,39,71
FC Midtjylla,1612,2,19,4,7,63,39,24,61
FC Nords,1612,3,14,6,10,73,53,20,48
Copenhagen,1612,4,14,5,11,59,45,14,47
AaB,1612,5,9,12,9,39,40,-1,39
Sonderjyske,1612,6,8,6,10,28,29,-1,30
AC Horsens,1612,7,5,14,11,33,55,-22,29
Randers FC,1612,8,5,7,12,23,39,-16,22
Lyngby,1612,9,3,10,11,26,44,-18,19
Silkeborg IF,1612,10,5,4,13,27,46,-19,19
AGF Aarhus,1612,11,4,7,11,18,38,-20,19
Brondby,1613,1,21,6,3,70,33,37,69
FC Midtjylla,1613,2,19,6,5,64,39,25,63
FC Nords,1613,3,14,8,8,74,49,25,50
Copenhagen,1613,4,13,5,12,56,47,9,44
AaB,1613,5,8,12,10,36,42,-6,36
AC Horsens,1613,6,6,13,11,35,51,-16,31
Sonderjyske,1613,7,8,6,10,28,29,-1,30
Randers FC,1613,8,5,7,12,23,39,-16,22
Silkeborg IF,1613,9,6,3,13,28,45,-17,21
Lyngby,1613,10,3,10,11,26,44,-18,19
AGF Aarhus,1613,11,4,6,12,17,39,-22,18
Brondby,1614,1,19,7,4,71,39,32,64
FC Midtjylla,1614,2,20,4,6,69,43,26,64
FC Nords,1614,3,15,7,8,79,53,26,52
Copenhagen,1614,4,13,6,11,57,47,10,45
AC Horsens,1614,5,8,12,10,38,51,-13,36
AaB,1614,6,7,12,11,37,44,-7,33
Sonderjyske,1614,7,8,6,10,28,29,-1,30
Randers FC,1614,8,6,6,12,27,41,-14,24
AGF Aarhus,1614,9,5,6,11,18,37,-19,21
Lyngby,1614,10,3,9,12,28,48,-20,18
Silkeborg IF,1614,11,5,3,14,26,46,-20,18
Brondby,1615,1,21,6,3,67,29,38,69
FC Midtjylla,1615,2,18,5,7,62,42,20,59
FC Nords,1615,3,14,7,9,73,51,22,49
Copenhagen,1615,4,13,5,12,58,47,11,44
AaB,1615,5,10,12,8,39,38,1,42
AC Horsens,1615,6,6,13,11,33,51,-18,31
Sonderjyske,1615,7,8,6,10,28,29,-1,30
Lyngby,1615,8,4,9,11,30,45,-15,21
Randers FC,1615,9,5,6,13,24,43,-19,21
AGF Aarhus,1615,10,5,6,11,18,37,-19,21
Silkeborg IF,1615,11,5,3,14,26,46,-20,18
Brondby,1616,1,21,6,3,75,34,41,69
FC Midtjylla,1616,2,21,4,5,71,41,30,67
FC Nords,1616,3,14,6,10,80,57,23,48
Copenhagen,1616,4,14,6,10,58,45,13,48
AC Horsens,1616,5,7,12,11,38,59,-21,33
Sonderjyske,1616,6,8,6,10,28,29,-1,30
AaB,1616,7,6,12,12,34,46,-12,30
Lyngby,1616,8,4,9,11,29,44,-15,21
Randers FC,1616,9,5,6,13,23,42,-19,21
AGF Aarhus,1616,10,5,6,11,17,36,-19,21
Silkeborg IF,1616,11,5,3,14,25,45,-20,18
Brondby,1617,1,21,5,4,73,32,41,68
FC Midtjylla,1617,2,20,5,5,67,40,27,65
FC Nords,1617,3,14,6,10,73,55,18,48
Copenhagen,1617,4,13,4,13,54,46,8,43
AC Horsens,1617,5,9,13,8,38,47,-9,40
AaB,1617,6,7,11,12,36,47,-11,32
Sonderjyske,1617,7,8,6,10,28,29,-1,30
Lyngby,1617,8,4,9,11,29,44,-15,21
Silkeborg IF,1617,9,6,3,13,27,45,-18,21
Randers FC,1617,10,5,6,13,23,42,-19,21
AGF Aarhus,1617,11,4,6,12,17,38,-21,18
Brondby,1618,1,21,6,3,67,32,35,69
FC Midtjylla,1618,2,20,5,5,68,37,31,65
Copenhagen,1618,3,15,5,10,56,39,17,50
FC Nords,1618,4,13,8,9,70,49,21,47
AaB,1618,5,7,11,12,37,47,-10,32
AC Horsens,1618,6,6,13,11,34,54,-20,31
Sonderjyske,1618,7,8,6,10,28,29,-1,30
Silkeborg IF,1618,8,6,3,13,29,45,-16,21
Lyngby,1618,9,4,9,11,30,47,-17,21
Randers FC,1618,10,5,6,13,26,43,-17,21
AGF Aarhus,1618,11,4,6,12,17,40,-23,18
FC Midtjylla,1619,1,21,5,4,68,35,33,68
Brondby,1619,2,20,5,5,68,38,30,65
Copenhagen,1619,3,14,4,12,60,45,15,46
FC Nords,1619,4,12,6,12,71,62,9,42
AC Horsens,1619,5,8,14,8,39,47,-8,38
AaB,1619,6,8,12,10,38,43,-5,36
Sonderjyske,1619,7,8,6,10,28,29,-1,30
Randers FC,1619,8,6,6,12,25,40,-15,24
Silkeborg IF,1619,9,6,3,13,27,44,-17,21
Lyngby,1619,10,3,9,12,27,46,-19,18
AGF Aarhus,1619,11,4,6,12,16,38,-22,18
Brondby,1620,1,21,6,3,68,30,38,69
FC Midtjylla,1620,2,20,5,5,68,41,27,65
FC Nords,1620,3,15,6,9,73,52,21,51
Copenhagen,1620,4,14,5,11,59,46,13,47
AC Horsens,1620,5,6,14,10,35,51,-16,32
Sonderjyske,1620,6,8,6,10,28,29,-1,30
AaB,1620,7,6,12,12,33,42,-9,30
Lyngby,1620,8,4,9,11,29,45,-16,21
Silkeborg IF,1620,9,6,3,13,28,45,-17,21
Randers FC,1620,10,5,6,13,24,42,-18,21
AGF Aarhus,1620,11,4,6,12,17,39,-22,18
Brondby,1621,1,20,7,3,69,30,39,67
FC Midtjylla,1621,2,18,8,4,65,39,26,62
FC Nords,1621,3,13,9,8,69,51,18,48
Copenhagen,1621,4,13,7,10,52,39,13,46
AC Horsens,1621,5,7,14,9,39,50,-11,35
AaB,1621,6,7,11,12,37,48,-11,32
Sonderjyske,1621,7,8,6,10,28,29,-1,30
Lyngby,1621,8,4,9,11,29,45,-16,21
Silkeborg IF,1621,9,6,3,13,27,45,-18,21
Randers FC,1621,10,5,6,13,24,42,-18,21
AGF Aarhus,1621,11,4,6,12,17,38,-21,18
FC Midtjylla,1622,1,20,6,4,71,40,31,66
Brondby,1622,2,19,6,5,68,35,33,63
FC Nords,1622,3,14,7,9,78,57,21,49
Copenhagen,1622,4,12,6,12,56,47,9,42
AaB,1622,5,9,11,10,41,49,-8,38
AC Horsens,1622,6,8,12,10,42,54,-12,36
Sonderjyske,1622,7,8,6,10,28,29,-1,30
Randers FC,1622,8,5,7,12,24,40,-16,22
Silkeborg IF,1622,9,6,3,13,27,45,-18,21
Lyngby,1622,10,3,10,11,27,45,-18,19
AGF Aarhus,1622,11,4,6,12,17,38,-21,18
Brondby,1623,1,22,6,2,75,33,42,72
FC Midtjylla,1623,2,19,6,5,67,37,30,63
FC Nords,1623,3,14,7,9,73,54,19,49
Copenhagen,1623,4,13,6,11,54,46,8,45
AaB,1623,5,9,11,10,44,46,-2,38
Sonderjyske,1623,6,8,6,10,28,29,-1,30
AC Horsens,1623,7,5,12,13,31,54,-23,27
Randers FC,1623,8,5,7,12,23,39,-16,22
AGF Aarhus,1623,9,5,6,11,17,36,-19,21
Lyngby,1623,10,3,10,11,26,44,-18,19
Silkeborg IF,1623,11,5,3,14,25,45,-20,18
FC Midtjylla,1624,1,21,4,5,67,37,30,67
Brondby,1624,2,20,6,4,67,32,35,66
FC Nords,1624,3,14,8,8,73,52,21,50
Copenhagen,1624,4,13,5,12,55,44,11,44
AaB,1624,5,7,13,10,35,42,-7,34
AC Horsens,1624,6,6,14,10,38,54,-16,32
Sonderjyske,1624,7,8,6,10,28,29,-1,30
Randers FC,1624,8,6,6,12,24,39,-15,24
Silkeborg IF,1624,9,5,4,13,27,46,-19,19
AGF Aarhus,1624,10,4,7,11,18,38,-20,19
Lyngby,1624,11,3,9,12,26,45,-19,18
Brondby,1625,1,21,7,2,73,33,40,70
FC Midtjylla,1625,2,20,5,5,66,39,27,65
FC Nords,1625,3,15,6,9,73,53,20,51
Copenhagen,1625,4,14,5,11,57,44,13,47
AaB,1625,5,7,12,11,39,44,-5,33
Sonderjyske,1625,6,8,6,10,28,29,-1,30
AC Horsens,1625,7,5,13,12,35,56,-21,28
Randers FC,1625,8,5,7,12,24,40,-16,22
Silkeborg IF,1625,9,6,3,13,28,44,-16,21
Lyngby,1625,10,3,10,11,27,45,-18,19
AGF Aarhus,1625,11,4,6,12,16,39,-23,18
FC Midtjylla,1626,1,21,5,4,69,35,34,68
Brondby,1626,2,20,7,3,70,34,36,67
FC Nords,1626,3,15,6,9,78,55,23,51
Copenhagen,1626,4,12,6,12,60,51,9,42
AC Horsens,1626,5,7,13,10,42,58,-16,34
AaB,1626,6,7,11,12,40,52,-12,32
Sonderjyske,1626,7,8,6,10,28,29,-1,30
Randers FC,1626,8,6,6,12,27,41,-14,24
Silkeborg IF,1626,9,5,4,13,25,44,-19,19
AGF Aarhus,1626,10,4,7,11,16,36,-20,19
Lyngby,1626,11,3,9,12,28,48,-20,18
Brondby,1627,1,20,7,3,70,33,37,67
FC Midtjylla,1627,2,20,5,5,67,41,26,65
FC Nords,1627,3,15,7,8,72,50,22,52
Copenhagen,1627,4,13,6,11,58,46,12,45
AC Horsens,1627,5,7,12,11,39,53,-14,33
AaB,1627,6,6,13,11,38,47,-9,31
Sonderjyske,1627,7,8,6,10,28,29,-1,30
Randers FC,1627,8,6,6,12,26,40,-14,24
AGF Aarhus,1627,9,5,6,11,17,36,-19,21
Lyngby,1627,10,3,9,12,27,47,-20,18
Silkeborg IF,1627,11,5,3,14,25,45,-20,18
Brondby,1628,1,21,7,2,75,32,43,70
FC Midtjylla,1628,2,18,6,6,63,41,22,60
Copenhagen,1628,3,15,5,10,60,42,18,50
FC Nords,1628,4,13,7,10,73,58,15,46
AaB,1628,5,9,12,9,41,42,-1,39
Sonderjyske,1628,6,8,6,10,28,29,-1,30
AC Horsens,1628,7,5,13,12,34,57,-23,28
Randers FC,1628,8,5,7,12,23,39,-16,22
Silkeborg IF,1628,9,6,3,13,29,47,-18,21
Lyngby,1628,10,3,10,11,26,44,-18,19
AGF Aarhus,1628,11,4,6,12,19,40,-21,18
Brondby,1629,1,20,7,3,72,36,36,67
FC Midtjylla,1629,2,19,6,5,65,38,27,63
Copenhagen,1629,3,14,5,11,58,45,13,47
FC Nords,1629,4,13,7,10,68,50,18,46
AC Horsens,1629,5,8,12,10,36,50,-14,36
AaB,1629,6,8,11,11,36,42,-6,35
Sonderjyske,1629,7,8,6,10,28,29,-1,30
Randers FC,1629,8,6,6,12,24,39,-15,24
Silkeborg IF,1629,9,6,3,13,27,45,-18,21
Lyngby,1629,10,3,9,12,26,45,-19,18
AGF Aarhus,1629,11,4,6,12,17,38,-21,18
Brondby,1630,1,21,5,4,70,31,39,68
FC Midtjylla,1630,2,20,6,4,64,35,29,66
FC Nords,1630,3,15,6,9,74,49,25,51
Copenhagen,1630,4,13,6,11,55,43,12,45
AaB,1630,5,8,12,10,40,44,-4,36
Sonderjyske,1630,6,8,6,10,28,29,-1,30
AC Horsens,1630,7,5,13,12,33,60,-27,28
Randers FC,1630,8,5,7,12,25,41,-16,22
Lyngby,1630,9,3,10,11,28,46,-18,19
Silkeborg IF,1630,10,5,4,13,26,45,-19,19
AGF Aarhus,1630,11,4,7,11,17,37,-20,19
Brondby,1631,1,22,5,3,70,29,41,71
FC Midtjylla,1631,2,20,4,6,63,39,24,64
FC Nords,1631,3,15,6,9,73,47,26,51
Copenhagen,1631,4,15,5,10,58,44,14,50
AaB,1631,5,7,12,11,34,44,-10,33
Sonderjyske,1631,6,8,6,10,28,29,-1,30
AC Horsens,1631,7,5,12,13,31,52,-21,27
Randers FC,1631,8,5,7,12,24,40,-16,22
Silkeborg IF,1631,9,6,3,13,28,44,-16,21
Lyngby,1631,10,3,10,11,27,45,-18,19
AGF Aarhus,1631,11,4,6,12,16,39,-23,18
FC Midtjylla,1632,1,20,5,5,64,37,27,65
Brondby,1632,2,19,7,4,68,33,35,64
FC Nords,1632,3,14,8,8,70,50,20,50
Copenhagen,1632,4,13,7,10,57,44,13,46
AaB,1632,5,8,11,11,39,44,-5,35
AC Horsens,1632,6,7,12,11,36,52,-16,33
Sonderjyske,1632,7,8,6,10,28,29,-1,30
Lyngby,1632,8,4,9,11,28,44,-16,21
Randers FC,1632,9,5,6,13,23,41,-18,21
Silkeborg IF,1632,10,5,4,13,27,46,-19,19
AGF Aarhus,1632,11,4,7,11,18,38,-20,19
Brondby,1633,1,22,5,3,71,32,39,71
FC Midtjylla,1633,2,21,4,5,69,38,31,67
FC Nords,1633,3,13,8,9,71,54,17,47
Copenhagen,1633,4,14,5,11,55,43,12,47
AaB,1633,5,8,11,11,38,43,-5,35
Sonderjyske,1633,6,8,6,10,28,29,-1,30
AC Horsens,1633,7,5,13,12,34,54,-20,28
Lyngby,1633,8,4,9,11,28,45,-17,21
Randers FC,1633,9,5,6,13,24,41,-17,21
Silkeborg IF,1633,10,6,3,13,26,44,-18,21
AGF Aarhus,1633,11,4,6,12,16,37,-21,18
FC Midtjylla,1634,1,20,5,5,71,41,30,65
Brondby,1634,2,19,7,4,68,35,33,64
FC Nords,1634,3,14,7,9,73,56,17,49
Copenhagen,1634,4,13,7,10,62,48,14,46
AaB,1634,5,8,14,8,40,42,-2,38
Sonderjyske,1634,6,8,6,10,28,29,-1,30
AC Horsens,1634,7,5,14,11,36,54,-18,29
Lyngby,1634,8,4,9,11,27,44,-17,21
Randers FC,1634,9,5,6,13,23,40,-17,21
Silkeborg IF,1634,10,5,4,13,25,44,-19,19
AGF Aarhus,1634,11,4,7,11,16,36,-20,19
FC Midtjylla,1635,1,21,4,5,66,37,29,67
Brondby,1635,2,20,6,4,70,35,35,66
FC Nords,1635,3,14,7,9,77,54,23,49
Copenhagen,1635,4,14,6,10,57,43,14,48
AC Horsens,1635,5,7,13,10,36,52,-16,34
Sonderjyske,1635,6,8,6,10,28,29,-1,30
AaB,1635,7,6,12,12,33,44,-11,30
Randers FC,1635,8,6,6,12,25,40,-15,24
Silkeborg IF,1635,9,5,4,13,26,45,-19,19
AGF Aarhus,1635,10,4,7,11,17,37,-20,19
Lyngby,1635,11,3,9,12,27,46,-19,18
Brondby,1636,1,22,6,2,77,33,44,72
FC Midtjylla,1636,2,20,5,5,74,38,36,65
Copenhagen,1636,3,14,7,9,60,45,15,49
FC Nords,1636,4,13,6,11,71,58,13,45
AaB,1636,5,7,12,11,35,46,-11,33
Sonderjyske,1636,6,8,6,10,28,29,-1,30
AC Horsens,1636,7,6,12,12,34,57,-23,30
Lyngby,1636,8,4,9,11,27,44,-17,21
Randers FC,1636,9,5,6,13,23,40,-17,21
Silkeborg IF,1636,10,5,4,13,26,45,-19,19
AGF Aarhus,1636,11,4,7,11,17,37,-20,19
Brondby,1637,1,20,5,5,68,36,32,65
FC Midtjylla,1637,2,20,5,5,64,39,25,65
FC Nords,1637,3,14,7,9,75,53,22,49
Copenhagen,1637,4,14,5,11,57,42,15,47
AaB,1637,5,8,12,10,36,40,-4,36
AC Horsens,1637,6,6,14,10,34,50,-16,32
Sonderjyske,1637,7,8,6,10,28,29,-1,30
Randers FC,1637,8,5,7,12,25,41,-16,22
AGF Aarhus,1637,9,5,6,11,17,36,-19,21
Lyngby,1637,10,3,10,11,28,46,-18,19
Silkeborg IF,1637,11,5,3,14,25,45,-20,18
Brondby,1638,1,21,6,3,71,32,39,69
FC Midtjylla,1638,2,21,5,4,66,33,33,68
FC Nords,1638,3,14,7,9,77,55,22,49
Copenhagen,1638,4,13,5,12,59,51,8,44
AC Horsens,1638,5,6,14,10,38,58,-20,32
AaB,1638,6,6,13,11,37,45,-8,31
Sonderjyske,1638,7,8,6,10,28,29,-1,30
Randers FC,1638,8,6,6,12,24,39,-15,24
Silkeborg IF,1638,9,5,4,13,26,45,-19,19
AGF Aarhus,1638,10,4,7,11,17,37,-20,19
Lyngby,1638,11,3,9,12,26,45,-19,18
Brondby,1639,1,21,7,2,72,29,43,70
FC Midtjylla,1639,2,19,5,6,63,37,26,62
FC Nords,1639,3,13,9,8,72,52,20,48
Copenhagen,1639,4,14,6,10,55,41,14,48
AC Horsens,1639,5,6,15,9,34,52,-18,33
Sonderjyske,1639,6,8,6,10,28,29,-1,30
AaB,1639,7,6,12,12,35,46,-11,30
Lyngby,1639,8,4,9,11,28,44,-16,21
Randers FC,1639,9,5,6,13,23,41,-18,21
Silkeborg IF,1639,10,5,4,13,26,45,-19,19
AGF Aarhus,1639,11,4,7,11,17,37,-20,19
Brondby,1640,1,21,6,3,69,33,36,69
FC Midtjylla,1640,2,18,5,7,64,42,22,59
FC Nords,1640,3,14,7,9,73,49,24,49
Copenhagen,1640,4,14,5,11,61,49,12,47
AaB,1640,5,8,11,11,39,45,-6,35
AC Horsens,1640,6,7,14,9,35,49,-14,35
Sonderjyske,1640,7,8,6,10,28,29,-1,30
Lyngby,1640,8,4,9,11,31,44,-13,21
Randers FC,1640,9,5,6,13,23,44,-21,21
Silkeborg IF,1640,10,5,4,13,25,44,-19,19
AGF Aarhus,1640,11,4,7,11,16,36,-20,19
Brondby,1641,1,21,5,4,72,36,36,68
FC Midtjylla,1641,2,17,6,7,64,47,17,57
FC Nords,1641,3,15,7,8,75,53,22,52
Copenhagen,1641,4,15,4,11,61,44,17,49
AaB,1641,5,8,12,10,38,40,-2,36
AC Horsens,1641,6,6,14,10,37,53,-16,32
Sonderjyske,1641,7,8,6,10,28,29,-1,30
Lyngby,1641,8,4,9,11,28,44,-16,21
Randers FC,1641,9,5,6,13,23,41,-18,21
Silkeborg IF,1641,10,5,4,13,27,46,-19,19
AGF Aarhus,1641,11,4,7,11,18,38,-20,19
Brondby,1642,1,20,6,4,72,34,38,66
FC Midtjylla,1642,2,19,5,6,64,40,24,62
FC Nords,1642,3,15,6,9,73,50,23,51
Copenhagen,1642,4,13,5,12,58,49,9,44
AaB,1642,5,8,12,10,37,44,-7,36
AC Horsens,1642,6,8,12,10,40,53,-13,36
Sonderjyske,1642,7,8,6,10,28,29,-1,30
Lyngby,1642,8,4,9,11,28,45,-17,21
Randers FC,1642,9,5,6,13,24,41,-17,21
Silkeborg IF,1642,10,6,3,13,26,44,-18,21
AGF Aarhus,1642,11,4,6,12,16,37,-21,18
Brondby,1643,1,23,5,2,80,28,52,74
FC Midtjylla,1643,2,20,4,6,68,41,27,64
FC Nords,1643,3,14,7,9,73,54,19,49
Copenhagen,1643,4,15,4,11,61,48,13,49
AC Horsens,1643,5,6,13,11,38,55,-17,31
Sonderjyske,1643,6,8,6,10,28,29,-1,30
AaB,1643,7,6,11,13,37,57,-20,29
Randers FC,1643,8,5,7,12,23,39,-16,22
AGF Aarhus,1643,9,5,6,11,19,38,-19,21
Lyngby,1643,10,3,10,11,26,44,-18,19
Silkeborg IF,1643,11,5,3,14,27,47,-20,18
Brondby,1644,1,21,5,4,73,32,41,68
FC Midtjylla,1644,2,18,5,7,65,42,23,59
Copenhagen,1644,3,15,5,10,62,45,17,50
FC Nords,1644,4,14,7,9,70,53,17,49
AC Horsens,1644,5,7,14,9,35,52,-17,35
AaB,1644,6,7,12,11,39,46,-7,33
Sonderjyske,1644,7,8,6,10,28,29,-1,30
Randers FC,1644,8,6,6,12,24,39,-15,24
Silkeborg IF,1644,9,5,4,13,26,45,-19,19
AGF Aarhus,1644,10,4,7,11,17,37,-20,19
Lyngby,1644,11,3,9,12,26,45,-19,18
Brondby,1645,1,20,7,3,70,33,37,67
FC Midtjylla,1645,2,20,4,6,65,40,25,64
FC Nords,1645,3,14,7,9,73,50,23,49
Copenhagen,1645,4,14,5,11,54,44,10,47
AaB,1645,5,9,11,10,39,41,-2,38
Sonderjyske,1645,6,8,6,10,28,29,-1,30
AC Horsens,1645,7,6,12,12,35,54,-19,30
Lyngby,1645,8,4,9,11,28,45,-17,21
Randers FC,1645,9,5,6,13,24,41,-17,21
AGF Aarhus,1645,10,5,6,11,17,36,-19,21
Silkeborg IF,1645,11,5,3,14,25,45,-20,18
Brondby,1646,1,19,9,2,70,32,38,66
FC Midtjylla,1646,2,19,6,5,67,39,28,63
FC Nords,1646,3,15,6,9,83,57,26,51
Copenhagen,1646,4,12,8,10,56,45,11,44
AaB,1646,5,7,13,10,36,43,-7,34
AC Horsens,1646,6,6,14,10,35,57,-22,32
Sonderjyske,1646,7,8,6,10,28,29,-1,30
Lyngby,1646,8,4,9,11,28,44,-16,21
Randers FC,1646,9,5,6,13,23,41,-18,21
AGF Aarhus,1646,10,5,6,11,17,36,-19,21
Silkeborg IF,1646,11,5,3,14,25,45,-20,18
Brondby,1647,1,23,5,2,78,29,49,74
FC Midtjylla,1647,2,19,4,7,67,46,21,61
FC Nords,1647,3,14,7,9,73,58,15,49
Copenhagen,1647,4,13,5,12,55,45,10,44
AaB,1647,5,7,14,9,38,42,-4,35
AC Horsens,1647,6,6,13,11,37,54,-17,31
Sonderjyske,1647,7,8,6,10,28,29,-1,30
Lyngby,1647,8,4,9,11,28,45,-17,21
Silkeborg IF,1647,9,6,3,13,27,44,-17,21
Randers FC,1647,10,5,6,13,24,41,-17,21
AGF Aarhus,1647,11,4,6,12,16,38,-22,18
FC Midtjylla,1648,1,21,4,5,63,36,27,67
Brondby,1648,2,20,6,4,69,31,38,66
Copenhagen,1648,3,14,6,10,56,42,14,48
FC Nords,1648,4,12,9,9,72,53,19,45
AaB,1648,5,7,13,10,37,44,-7,34
AC Horsens,1648,6,6,14,10,31,48,-17,32
Sonderjyske,1648,7,8,6,10,28,29,-1,30
Randers FC,1648,8,5,7,12,24,40,-16,22
Silkeborg IF,1648,9,6,3,13,26,44,-18,21
Lyngby,1648,10,3,10,11,27,45,-18,19
AGF Aarhus,1648,11,4,6,12,16,37,-21,18
Brondby,1649,1,20,7,3,72,36,36,67
FC Midtjylla,1649,2,20,4,6,69,40,29,64
FC Nords,1649,3,15,6,9,76,52,24,51
Copenhagen,1649,4,13,5,12,59,50,9,44
AaB,1649,5,8,11,11,36,41,-5,35
AC Horsens,1649,6,7,13,10,39,58,-19,34
Sonderjyske,1649,7,8,6,10,28,29,-1,30
Lyngby,1649,8,4,9,11,28,45,-17,21
Silkeborg IF,1649,8,6,3,13,28,45,-17,21
Randers FC,1649,10,5,6,13,24,41,-17,21
AGF Aarhus,1649,11,4,6,12,17,39,-22,18
Brondby,1650,1,22,5,3,71,29,42,71
FC Midtjylla,1650,2,20,4,6,64,41,23,64
FC Nords,1650,3,16,6,8,81,52,29,54
Copenhagen,1650,4,14,5,11,63,48,15,47
AaB,1650,5,7,12,11,36,44,-8,33
Sonderjyske,1650,6,8,6,10,28,29,-1,30
AC Horsens,1650,7,5,12,13,33,60,-27,27
Lyngby,1650,8,4,9,11,28,45,-17,21
Silkeborg IF,1650,8,6,3,13,28,45,-17,21
Randers FC,1650,10,5,6,13,24,41,-17,21
AGF Aarhus,1650,11,4,6,12,17,39,-22,18
Brondby,1651,1,20,6,4,70,33,37,66
FC Midtjylla,1651,2,20,5,5,66,42,24,65
FC Nords,1651,3,15,6,9,78,49,29,51
Copenhagen,1651,4,14,4,12,56,52,4,46
AaB,1651,5,8,11,11,36,44,-8,35
AC Horsens,1651,6,7,12,11,37,49,-12,33
Sonderjyske,1651,7,8,6,10,28,29,-1,30
Randers FC,1651,8,5,7,12,24,40,-16,22
AGF Aarhus,1651,9,5,6,11,17,36,-19,21
Lyngby,1651,10,3,10,11,27,45,-18,19
Silkeborg IF,1651,11,5,3,14,25,45,-20,18
Brondby,1652,1,21,5,4,70,31,39,68
FC Midtjylla,1652,2,20,4,6,65,39,26,64
FC Nords,1652,3,14,7,9,70,51,19,49
Copenhagen,1652,4,13,6,11,56,45,11,45
AaB,1652,5,9,11,10,41,42,-1,38
AC Horsens,1652,6,6,13,11,36,56,-20,31
Sonderjyske,1652,7,8,6,10,28,29,-1,30
Randers FC,1652,8,5,7,12,23,39,-16,22
Lyngby,1652,9,3,10,11,26,44,-18,19
Silkeborg IF,1652,10,5,4,13,26,45,-19,19
AGF Aarhus,1652,11,4,7,11,17,37,-20,19
Brondby,1653,1,23,5,2,76,29,47,74
FC Midtjylla,1653,2,19,5,6,66,40,26,62
FC Nords,1653,3,14,7,9,75,53,22,49
Copenhagen,1653,4,13,4,13,55,47,8,43
AaB,1653,5,8,12,10,36,44,-8,36
Sonderjyske,1653,6,8,6,10,28,29,-1,30
AC Horsens,1653,7,5,15,10,34,55,-21,30
Lyngby,1653,8,4,9,11,27,44,-17,21
Randers FC,1653,9,5,6,13,23,40,-17,21
Silkeborg IF,1653,10,5,4,13,26,45,-19,19
AGF Aarhus,1653,11,4,7,11,17,37,-20,19
Brondby,1654,1,23,5,2,73,30,43,74
FC Midtjylla,1654,2,20,5,5,70,42,28,65
FC Nords,1654,3,15,7,8,76,52,24,52
Copenhagen,1654,4,14,4,12,59,48,11,46
Sonderjyske,1654,5,8,6,10,28,29,-1,30
AaB,1654,6,6,12,12,36,46,-10,30
AC Horsens,1654,7,5,13,12,37,59,-22,28
Randers FC,1654,8,5,7,12,25,41,-16,22
AGF Aarhus,1654,9,5,6,11,17,36,-19,21
Lyngby,1654,10,3,10,11,28,46,-18,19
Silkeborg IF,1654,11,5,3,14,25,45,-20,18
FC Midtjylla,1655,1,21,4,5,72,38,34,67
Brondby,1655,2,20,6,4,70,34,36,66
Copenhagen,1655,3,15,4,11,55,42,13,49
FC Nords,1655,4,13,8,9,69,50,19,47
AaB,1655,5,8,12,10,41,44,-3,36
Sonderjyske,1655,6,8,6,10,28,29,-1,30
AC Horsens,1655,7,5,14,11,32,57,-25,29
Randers FC,1655,8,5,7,12,24,40,-16,22
Lyngby,1655,9,3,10,11,27,45,-18,19
Silkeborg IF,1655,10,5,4,13,28,47,-19,19
AGF Aarhus,1655,11,4,7,11,19,39,-20,19
Brondby,1656,1,21,6,3,74,32,42,69
FC Midtjylla,1656,2,19,5,6,65,40,25,62
FC Nords,1656,3,15,6,9,76,53,23,51
Copenhagen,1656,4,13,4,13,55,51,4,43
AaB,1656,5,9,11,10,40,43,-3,38
AC Horsens,1656,6,7,12,11,35,52,-17,33
Sonderjyske,1656,7,8,6,10,28,29,-1,30
Randers FC,1656,8,5,7,12,26,42,-16,22
Silkeborg IF,1656,9,6,3,13,26,44,-18,21
Lyngby,1656,10,3,10,11,29,47,-18,19
AGF Aarhus,1656,11,4,6,12,16,37,-21,18
Brondby,1657,1,20,7,3,68,30,38,67
FC Midtjylla,1657,2,20,4,6,67,41,26,64
FC Nords,1657,3,14,7,9,71,52,19,49
Copenhagen,1657,4,13,6,11,56,44,12,45
AC Horsens,1657,5,8,13,9,40,52,-12,37
AaB,1657,6,6,13,11,35,44,-9,31
Sonderjyske,1657,7,8,6,10,28,29,-1,30
Randers FC,1657,8,6,6,12,25,39,-14,24
AGF Aarhus,1657,9,5,6,11,18,36,-18,21
Lyngby,1657,10,3,9,12,26,46,-20,18
Silkeborg IF,1657,11,5,3,14,25,46,-21,18
Brondby,1658,1,21,7,2,69,29,40,70
FC Midtjylla,1658,2,19,6,5,65,38,27,63
FC Nords,1658,3,14,6,10,72,54,18,48
Copenhagen,1658,4,14,6,10,58,42,16,48
AC Horsens,1658,5,7,12,11,35,52,-17,33
AaB,1658,6,6,13,11,38,48,-10,31
Sonderjyske,1658,7,8,6,10,28,29,-1,30
Randers FC,1658,8,6,6,12,26,40,-14,24
Silkeborg IF,1658,9,6,3,13,28,45,-17,21
Lyngby,1658,10,3,9,12,27,47,-20,18
AGF Aarhus,1658,11,4,6,12,17,39,-22,18
Brondby,1659,1,21,6,3,77,36,41,69
FC Midtjylla,1659,2,20,5,5,69,41,28,65
FC Nords,1659,3,15,7,8,79,53,26,52
Copenhagen,1659,4,14,4,12,60,48,12,46
AaB,1659,5,7,11,12,34,48,-14,32
AC Horsens,1659,6,6,13,11,38,57,-19,31
Sonderjyske,1659,7,8,6,10,28,29,-1,30
Randers FC,1659,8,6,6,12,26,40,-14,24
Silkeborg IF,1659,9,6,3,13,28,44,-16,21
Lyngby,1659,10,3,9,12,27,47,-20,18
AGF Aarhus,1659,11,4,6,12,16,39,-23,18
Brondby,1660,1,21,6,3,69,31,38,69
FC Midtjylla,1660,2,19,6,5,67,40,27,63
Copenhagen,1660,3,15,5,10,58,43,15,50
FC Nords,1660,4,13,8,9,72,52,20,47
AC Horsens,1660,5,6,14,10,34,50,-16,32
AaB,1660,6,6,13,11,33,43,-10,31
Sonderjyske,1660,7,8,6,10,28,29,-1,30
Randers FC,1660,8,6,6,12,26,40,-14,24
Silkeborg IF,1660,9,6,3,13,27,44,-17,21
Lyngby,1660,10,3,9,12,27,47,-20,18
AGF Aarhus,1660,11,4,6,12,16,38,-22,18
Brondby,1661,1,22,6,2,78,30,48,72
FC Midtjylla,1661,2,19,5,6,67,43,24,62
Copenhagen,1661,3,13,8,9,58,44,14,47
FC Nords,1661,4,12,8,10,73,60,13,44
AaB,1661,5,8,12,10,37,43,-6,36
AC Horsens,1661,6,6,13,11,34,53,-19,31
Sonderjyske,1661,7,8,6,10,28,29,-1,30
Randers FC,1661,8,6,6,12,28,40,-12,24
Silkeborg IF,1661,9,6,3,13,26,44,-18,21
AGF Aarhus,1661,10,4,6,12,16,37,-21,18
Lyngby,1661,11,3,9,12,27,49,-22,18
Brondby,1662,1,19,8,3,70,37,33,65
FC Midtjylla,1662,2,19,6,5,63,40,23,63
Copenhagen,1662,3,15,6,9,63,41,22,51
FC Nords,1662,4,14,7,9,72,50,22,49
AaB,1662,5,8,12,10,37,42,-5,36
Sonderjyske,1662,6,8,6,10,28,29,-1,30
AC Horsens,1662,7,5,13,12,33,54,-21,28
Silkeborg IF,1662,8,6,3,13,28,44,-16,21
Lyngby,1662,9,4,9,11,28,45,-17,21
Randers FC,1662,10,5,6,13,24,41,-17,21
AGF Aarhus,1662,11,4,6,12,16,39,-23,18
Brondby,1663,1,19,6,5,70,39,31,63
FC Midtjylla,1663,2,19,4,7,61,40,21,61
FC Nords,1663,3,15,8,7,74,47,27,53
Copenhagen,1663,4,15,5,10,58,44,14,50
AaB,1663,5,7,12,11,41,45,-4,33
AC Horsens,1663,6,6,15,9,39,54,-15,33
Sonderjyske,1663,7,8,6,10,28,29,-1,30
Lyngby,1663,8,4,9,11,27,44,-17,21
Randers FC,1663,9,5,6,13,23,40,-17,21
Silkeborg IF,1663,10,5,4,13,28,47,-19,19
AGF Aarhus,1663,11,4,7,11,19,39,-20,19
Brondby,1664,1,22,5,3,73,31,42,71
FC Midtjylla,1664,2,18,5,7,63,41,22,59
FC Nords,1664,3,15,6,9,73,49,24,51
Copenhagen,1664,4,14,5,11,58,49,9,47
AaB,1664,5,8,12,10,40,44,-4,36
AC Horsens,1664,6,6,13,11,33,52,-19,31
Sonderjyske,1664,7,8,6,10,28,29,-1,30
Randers FC,1664,8,5,7,12,25,41,-16,22
Lyngby,1664,9,3,10,11,28,46,-18,19
Silkeborg IF,1664,10,5,4,13,25,44,-19,19
AGF Aarhus,1664,11,4,7,11,16,36,-20,19
Brondby,1665,1,23,5,2,77,29,48,74
FC Midtjylla,1665,2,19,4,7,61,40,21,61
FC Nords,1665,3,14,7,9,77,52,25,49
Copenhagen,1665,4,14,4,12,55,46,9,46
AaB,1665,5,8,13,9,35,39,-4,37
Sonderjyske,1665,6,8,6,10,28,29,-1,30
AC Horsens,1665,7,5,13,12,30,55,-25,28
Randers FC,1665,8,6,6,12,24,39,-15,24
Silkeborg IF,1665,9,6,3,13,27,44,-17,21
Lyngby,1665,10,3,9,12,26,45,-19,18
AGF Aarhus,1665,11,4,6,12,16,38,-22,18
Brondby,1666,1,21,7,2,71,29,42,70
FC Midtjylla,1666,2,20,5,5,65,39,26,65
FC Nords,1666,3,14,8,8,72,48,24,50
Copenhagen,1666,4,13,4,13,57,48,9,43
AaB,1666,5,8,13,9,36,41,-5,37
Sonderjyske,1666,6,8,6,10,28,29,-1,30
AC Horsens,1666,7,5,13,12,32,54,-22,28
Silkeborg IF,1666,8,6,3,13,30,45,-15,21
Lyngby,1666,9,4,9,11,29,44,-15,21
Randers FC,1666,10,5,6,13,23,42,-19,21
AGF Aarhus,1666,11,4,6,12,17,41,-24,18
Brondby,1667,1,21,7,2,74,33,41,70
FC Midtjylla,1667,2,19,5,6,67,44,23,62
Copenhagen,1667,3,14,6,10,63,47,16,48
FC Nords,1667,4,13,7,10,75,58,17,46
AC Horsens,1667,5,7,14,9,37,53,-16,35
AaB,1667,6,7,11,12,39,46,-7,32
Sonderjyske,1667,7,8,6,10,28,29,-1,30
Randers FC,1667,8,6,6,12,25,39,-14,24
AGF Aarhus,1667,9,5,6,11,17,36,-19,21
Lyngby,1667,10,3,9,12,26,46,-20,18
Silkeborg IF,1667,11,5,3,14,25,45,-20,18
Brondby,1668,1,22,5,3,74,32,42,71
FC Midtjylla,1668,2,21,4,5,68,39,29,67
FC Nords,1668,3,13,7,10,72,56,16,46
AaB,1668,4,10,11,9,42,39,3,41
Copenhagen,1668,5,12,4,14,55,53,2,40
AC Horsens,1668,6,6,13,11,34,52,-18,31
Sonderjyske,1668,7,8,6,10,28,29,-1,30
Silkeborg IF,1668,8,6,3,13,29,45,-16,21
Lyngby,1668,9,4,9,11,27,44,-17,21
Randers FC,1668,10,5,6,13,23,40,-17,21
AGF Aarhus,1668,11,4,6,12,17,40,-23,18
FC Midtjylla,1669,1,20,5,5,66,40,26,65
Brondby,1669,2,19,6,5,70,34,36,63
Copenhagen,1669,3,16,5,9,64,45,19,53
FC Nords,1669,4,13,6,11,70,55,15,45
AaB,1669,5,7,13,10,37,42,-5,34
AC Horsens,1669,6,6,15,9,31,48,-17,33
Sonderjyske,1669,7,8,6,10,28,29,-1,30
Lyngby,1669,8,4,9,11,28,45,-17,21
Randers FC,1669,9,5,6,13,24,41,-17,21
AGF Aarhus,1669,10,5,6,11,20,37,-17,21
Silkeborg IF,1669,11,5,3,14,26,48,-22,18
Brondby,1670,1,23,5,2,75,29,46,74
FC Midtjylla,1670,2,20,5,5,65,37,28,65
FC Nords,1670,3,14,6,10,73,53,20,48
Copenhagen,1670,4,13,5,12,53,44,9,44
AaB,1670,5,8,12,10,36,39,-3,36
Sonderjyske,1670,6,8,6,10,28,29,-1,30
AC Horsens,1670,7,5,13,12,30,56,-26,28
Silkeborg IF,1670,8,6,3,13,29,44,-15,21
Lyngby,1670,9,4,9,11,28,45,-17,21
Randers FC,1670,10,5,6,13,24,41,-17,21
AGF Aarhus,1670,11,4,6,12,16,40,-24,18
Brondby,1671,1,21,6,3,72,31,41,69
FC Midtjylla,1671,2,19,5,6,66,42,24,62
FC Nords,1671,3,14,7,9,74,52,22,49
Copenhagen,1671,4,15,4,11,58,46,12,49
AaB,1671,5,7,12,11,39,45,-6,33
AC Horsens,1671,6,7,12,11,38,57,-19,33
Sonderjyske,1671,7,8,6,10,28,29,-1,30
Lyngby,1671,8,4,9,11,28,44,-16,21
Randers FC,1671,9,5,6,13,23,41,-18,21
AGF Aarhus,1671,10,5,6,11,18,37,-19,21
Silkeborg IF,1671,11,5,3,14,26,46,-20,18
Brondby,1672,1,22,5,3,81,33,48,71
FC Midtjylla,1672,2,18,7,5,65,40,25,61
FC Nords,1672,3,15,7,8,78,51,27,52
Copenhagen,1672,4,14,5,11,58,51,7,47
AaB,1672,5,6,14,10,34,48,-14,32
Sonderjyske,1672,6,8,6,10,28,29,-1,30
AC Horsens,1672,7,5,14,11,36,55,-19,29
Randers FC,1672,8,6,6,12,26,41,-15,24
Silkeborg IF,1672,9,6,3,13,26,44,-18,21
Lyngby,1672,10,3,9,12,28,47,-19,18
AGF Aarhus,1672,11,4,6,12,16,37,-21,18
Brondby,1673,1,21,6,3,71,32,39,69
FC Midtjylla,1673,2,19,4,7,66,42,24,61
FC Nords,1673,3,14,8,8,73,50,23,50
Copenhagen,1673,4,13,6,11,60,50,10,45
AaB,1673,5,9,11,10,37,41,-4,38
Sonderjyske,1673,6,8,6,10,28,29,-1,30
AC Horsens,1673,7,5,15,10,32,50,-18,30
Lyngby,1673,8,4,9,11,28,45,-17,21
Randers FC,1673,9,5,6,13,24,41,-17,21
Silkeborg IF,1673,10,6,3,13,27,45,-18,21
AGF Aarhus,1673,11,4,6,12,17,38,-21,18
FC Midtjylla,1674,1,21,4,5,65,37,28,67
Brondby,1674,2,20,6,4,71,31,40,66
Copenhagen,1674,3,14,6,10,56,41,15,48
FC Nords,1674,4,13,6,11,67,52,15,45
AaB,1674,5,8,12,10,37,41,-4,36
AC Horsens,1674,6,6,14,10,36,56,-20,32
Sonderjyske,1674,7,8,6,10,28,29,-1,30
Randers FC,1674,8,6,6,12,25,40,-15,24
Silkeborg IF,1674,9,6,3,13,27,45,-18,21
Lyngby,1674,10,3,9,12,27,46,-19,18
AGF Aarhus,1674,11,4,6,12,17,38,-21,18
Brondby,1675,1,22,5,3,69,30,39,71
FC Midtjylla,1675,2,20,5,5,63,39,24,65
FC Nords,1675,3,14,6,10,75,52,23,48
Copenhagen,1675,4,13,6,11,59,47,12,45
AaB,1675,5,7,12,11,35,42,-7,33
AC Horsens,1675,6,7,12,11,36,53,-17,33
Sonderjyske,1675,7,8,6,10,28,29,-1,30
Randers FC,1675,8,6,6,12,25,40,-15,24
AGF Aarhus,1675,9,5,6,11,19,37,-18,21
Lyngby,1675,10,3,9,12,27,46,-19,18
Silkeborg IF,1675,11,5,3,14,26,47,-21,18
Brondby,1676,1,20,5,5,69,39,30,65
FC Midtjylla,1676,2,18,6,6,61,39,22,60
FC Nords,1676,3,14,8,8,81,54,27,50
Copenhagen,1676,4,15,4,11,56,44,12,49
AaB,1676,5,8,11,11,40,43,-3,35
AC Horsens,1676,6,7,14,9,36,50,-14,35
Sonderjyske,1676,7,8,6,10,28,29,-1,30
Randers FC,1676,8,6,6,12,25,40,-15,24
Silkeborg IF,1676,9,6,3,13,28,44,-16,21
Lyngby,1676,10,3,9,12,27,46,-19,18
AGF Aarhus,1676,11,4,6,12,16,39,-23,18
FC Midtjylla,1677,1,20,6,4,66,37,29,66
Brondby,1677,2,19,7,4,66,35,31,64
FC Nords,1677,3,13,7,10,73,51,22,46
Copenhagen,1677,4,13,7,10,59,43,16,46
AaB,1677,5,7,14,9,33,37,-4,35
AC Horsens,1677,6,6,15,9,33,53,-20,33
Sonderjyske,1677,7,8,6,10,28,29,-1,30
Lyngby,1677,8,4,9,11,30,44,-14,21
Silkeborg IF,1677,9,6,3,13,26,44,-18,21
Randers FC,1677,10,5,6,13,23,43,-20,21
AGF Aarhus,1677,11,4,6,12,16,37,-21,18
Brondby,1678,1,21,7,2,80,32,48,70
FC Midtjylla,1678,2,18,6,6,67,46,21,60
Copenhagen,1678,3,15,4,11,62,44,18,49
FC Nords,1678,4,13,7,10,70,59,11,46
AaB,1678,5,8,14,8,39,39,0,38
Sonderjyske,1678,6,8,6,10,28,29,-1,30
AC Horsens,1678,7,5,14,11,33,57,-24,29
Randers FC,1678,8,5,7,12,27,43,-16,22
AGF Aarhus,1678,9,5,6,11,18,37,-19,21
Lyngby,1678,10,3,10,11,30,48,-18,19
Silkeborg IF,1678,11,5,3,14,26,46,-20,18
Brondby,1679,1,21,6,3,70,30,40,69
FC Midtjylla,1679,2,18,7,5,60,35,25,61
FC Nords,1679,3,16,6,8,77,52,25,54
Copenhagen,1679,4,13,5,12,57,45,12,44
AaB,1679,5,6,14,10,37,45,-8,32
AC Horsens,1679,6,6,14,10,34,54,-20,32
Sonderjyske,1679,7,8,6,10,28,29,-1,30
Silkeborg IF,1679,8,6,3,13,30,44,-14,21
Lyngby,1679,9,4,9,11,30,45,-15,21
Randers FC,1679,10,5,6,13,24,43,-19,21
AGF Aarhus,1679,11,4,6,12,16,41,-25,18
Brondby,1680,1,20,8,2,69,29,40,68
FC Midtjylla,1680,2,19,6,5,65,37,28,63
FC Nords,1680,3,15,7,8,75,49,26,52
Copenhagen,1680,4,13,4,13,55,48,7,43
AC Horsens,1680,5,7,15,8,36,48,-12,36
Sonderjyske,1680,6,8,6,10,28,29,-1,30
AaB,1680,7,6,12,12,33,48,-15,30
Lyngby,1680,8,4,9,11,29,45,-16,21
Randers FC,1680,9,5,6,13,24,42,-18,21
AGF Aarhus,1680,10,5,6,11,19,38,-19,21
Silkeborg IF,1680,11,5,3,14,27,47,-20,18
Brondby,1681,1,21,6,3,72,30,42,69
FC Midtjylla,1681,2,20,6,4,67,38,29,66
FC Nords,1681,3,14,7,9,71,49,22,49
Copenhagen,1681,4,14,5,11,57,44,13,47
AaB,1681,5,7,13,10,38,48,-10,34
Sonderjyske,1681,6,8,6,10,28,29,-1,30
AC Horsens,1681,7,5,13,12,31,53,-22,28
Lyngby,1681,8,4,9,11,29,46,-17,21
Randers FC,1681,9,5,6,13,25,42,-17,21
AGF Aarhus,1681,10,5,6,11,17,36,-19,21
Silkeborg IF,1681,11,5,3,14,25,45,-20,18
Brondby,1682,1,19,8,3,68,33,35,65
FC Midtjylla,1682,2,20,5,5,64,35,29,65
FC Nords,1682,3,14,7,9,72,53,19,49
Copenhagen,1682,4,12,7,11,56,45,11,43
AC Horsens,1682,5,8,14,8,39,50,-11,38
AaB,1682,6,6,13,11,35,44,-9,31
Sonderjyske,1682,7,8,6,10,28,29,-1,30
Randers FC,1682,8,5,7,12,24,40,-16,22
AGF Aarhus,1682,9,5,6,11,18,36,-18,21
Lyngby,1682,10,3,10,11,27,45,-18,19
Silkeborg IF,1682,11,5,3,14,25,46,-21,18
FC Midtjylla,1683,1,22,4,4,68,35,33,70
Brondby,1683,2,20,6,4,71,34,37,66
Copenhagen,1683,3,16,4,10,56,41,15,52
FC Nords,1683,4,14,6,10,73,51,22,48
AaB,1683,5,7,11,12,34,45,-11,32
Sonderjyske,1683,6,8,6,10,28,29,-1,30
AC Horsens,1683,7,5,13,12,32,54,-22,28
Randers FC,1683,8,6,6,12,26,40,-14,24
Silkeborg IF,1683,9,6,3,13,27,45,-18,21
Lyngby,1683,10,3,9,12,27,47,-20,18
AGF Aarhus,1683,11,4,6,12,17,38,-21,18
Brondby,1684,1,22,6,2,76,28,48,72
FC Midtjylla,1684,2,17,7,6,62,42,20,58
FC Nords,1684,3,13,8,9,74,56,18,47
Copenhagen,1684,4,12,8,10,54,45,9,44
AC Horsens,1684,5,7,14,9,35,50,-15,35
AaB,1684,6,7,13,10,36,42,-6,34
Sonderjyske,1684,7,8,6,10,28,29,-1,30
Lyngby,1684,8,4,9,11,29,44,-15,21
Silkeborg IF,1684,9,6,3,13,27,44,-17,21
Randers FC,1684,10,5,6,13,23,42,-19,21
AGF Aarhus,1684,11,4,6,12,16,38,-22,18
Brondby,1685,1,22,6,2,69,29,40,72
FC Midtjylla,1685,2,19,4,7,61,37,24,61
FC Nords,1685,3,16,6,8,78,48,30,54
Copenhagen,1685,4,14,5,11,55,42,13,47
AaB,1685,5,7,11,12,36,44,-8,32
Sonderjyske,1685,6,8,6,10,28,29,-1,30
AC Horsens,1685,7,6,12,12,31,56,-25,30
Randers FC,1685,8,6,6,12,24,39,-15,24
AGF Aarhus,1685,9,5,6,11,19,38,-19,21
Lyngby,1685,10,3,9,12,26,45,-19,18
Silkeborg IF,1685,11,5,3,14,27,47,-20,18
Brondby,1686,1,20,6,4,69,34,35,66
FC Midtjylla,1686,2,17,6,7,62,42,20,57
Copenhagen,1686,3,14,7,9,57,41,16,49
FC Nords,1686,4,12,10,8,75,55,20,46
AC Horsens,1686,5,8,13,9,40,53,-13,37
AaB,1686,6,8,12,10,41,45,-4,36
Sonderjyske,1686,7,8,6,10,28,29,-1,30
Lyngby,1686,8,4,9,11,27,44,-17,21
Randers FC,1686,9,5,6,13,23,40,-17,21
Silkeborg IF,1686,10,6,3,13,27,45,-18,21
AGF Aarhus,1686,11,4,6,12,17,38,-21,18
Brondby,1687,1,20,5,5,74,38,36,65
FC Midtjylla,1687,2,18,5,7,60,39,21,59
FC Nords,1687,3,16,6,8,77,50,27,54
AaB,1687,4,10,12,8,41,39,2,42
Copenhagen,1687,5,12,5,13,56,50,6,41
AC Horsens,1687,6,7,13,10,41,59,-18,34
Sonderjyske,1687,7,8,6,10,28,29,-1,30
Randers FC,1687,8,5,7,12,24,40,-16,22
Silkeborg IF,1687,9,6,3,13,27,45,-18,21
Lyngby,1687,10,3,10,11,27,45,-18,19
AGF Aarhus,1687,11,4,6,12,17,38,-21,18
FC Midtjylla,1688,1,21,4,5,67,40,27,67
Brondby,1688,2,20,5,5,68,36,32,65
FC Nords,1688,3,15,6,9,79,54,25,51
Copenhagen,1688,4,13,4,13,52,44,8,43
AC Horsens,1688,5,9,12,9,38,48,-10,39
AaB,1688,6,7,11,12,35,43,-8,32
Sonderjyske,1688,7,8,6,10,28,29,-1,30
Lyngby,1688,8,4,9,11,28,44,-16,21
AGF Aarhus,1688,9,5,6,11,21,37,-16,21
Randers FC,1688,10,5,6,13,23,41,-18,21
Silkeborg IF,1688,11,5,3,14,26,49,-23,18
Brondby,1689,1,21,5,4,74,32,42,68
FC Midtjylla,1689,2,20,4,6,68,44,24,64
FC Nords,1689,3,15,7,8,73,51,22,52
Copenhagen,1689,4,15,5,10,57,42,15,50
AaB,1689,5,7,11,12,35,48,-13,32
Sonderjyske,1689,6,8,6,10,28,29,-1,30
AC Horsens,1689,7,6,12,12,37,53,-16,30
Lyngby,1689,8,4,9,11,28,44,-16,21
Silkeborg IF,1689,8,6,3,13,28,44,-16,21
Randers FC,1689,10,5,6,13,23,41,-18,21
AGF Aarhus,1689,11,4,6,12,16,39,-23,18
Brondby,1690,1,21,5,4,67,33,34,68
FC Midtjylla,1690,2,19,5,6,65,39,26,62
FC Nords,1690,3,15,6,9,74,52,22,51
Copenhagen,1690,4,13,4,13,54,48,6,43
AC Horsens,1690,5,8,13,9,38,49,-11,37
AaB,1690,6,8,11,11,37,40,-3,35
Sonderjyske,1690,7,8,6,10,28,29,-1,30
Randers FC,1690,8,5,7,12,25,41,-16,22
Silkeborg IF,1690,9,6,3,13,27,44,-17,21
Lyngby,1690,10,3,10,11,28,46,-18,19
AGF Aarhus,1690,11,4,6,12,16,38,-22,18
Brondby,1691,1,21,6,3,74,32,42,69
FC Midtjylla,1691,2,19,6,5,66,39,27,63
FC Nords,1691,3,14,6,10,70,53,17,48
Copenhagen,1691,4,14,5,11,62,51,11,47
AC Horsens,1691,5,7,13,10,35,50,-15,34
AaB,1691,6,7,12,11,36,44,-8,33
Sonderjyske,1691,7,8,6,10,28,29,-1,30
Randers FC,1691,8,6,6,12,25,40,-15,24
Silkeborg IF,1691,9,5,4,13,25,44,-19,19
AGF Aarhus,1691,10,4,7,11,16,36,-20,19
Lyngby,1691,11,3,9,12,27,46,-19,18
Brondby,1692,1,20,7,3,70,34,36,67
FC Midtjylla,1692,2,20,5,5,67,38,29,65
FC Nords,1692,3,14,8,8,77,51,26,50
Copenhagen,1692,4,14,5,11,56,44,12,47
AaB,1692,5,7,12,11,33,43,-10,33
Sonderjyske,1692,6,8,6,10,28,29,-1,30
AC Horsens,1692,7,5,15,10,35,54,-19,30
Randers FC,1692,8,6,6,12,26,40,-14,24
Silkeborg IF,1692,9,6,3,13,28,44,-16,21
Lyngby,1692,10,3,9,12,27,47,-20,18
AGF Aarhus,1692,11,4,6,12,16,39,-23,18
Brondby,1693,1,20,7,3,77,34,43,67
FC Midtjylla,1693,2,18,5,7,69,45,24,59
Copenhagen,1693,3,15,5,10,65,47,18,50
FC Nords,1693,4,14,7,9,74,55,19,49
AC Horsens,1693,5,8,13,9,41,54,-13,37
AaB,1693,6,6,13,11,35,52,-17,31
Sonderjyske,1693,7,8,6,10,28,29,-1,30
Lyngby,1693,8,4,9,11,29,45,-16,21
Silkeborg IF,1693,9,6,3,13,27,44,-17,21
Randers FC,1693,10,5,6,13,24,42,-18,21
AGF Aarhus,1693,11,4,6,12,16,38,-22,18
Brondby,1694,1,21,5,4,68,34,34,68
FC Midtjylla,1694,2,18,6,6,68,43,25,60
Copenhagen,1694,3,15,4,11,59,43,16,49
FC Nords,1694,4,14,6,10,72,55,17,48
AC Horsens,1694,5,7,14,9,40,53,-13,35
AaB,1694,6,7,13,10,38,43,-5,34
Sonderjyske,1694,7,8,6,10,28,29,-1,30
Randers FC,1694,8,6,6,12,24,39,-15,24
Silkeborg IF,1694,9,6,3,13,27,45,-18,21
Lyngby,1694,10,3,9,12,26,45,-19,18
AGF Aarhus,1694,11,4,6,12,17,38,-21,18
Brondby,1695,1,22,6,2,77,32,45,72
FC Midtjylla,1695,2,19,5,6,70,46,24,62
FC Nords,1695,3,15,6,9,78,51,27,51
Copenhagen,1695,4,13,5,12,55,46,9,44
AaB,1695,5,7,13,10,37,47,-10,34
Sonderjyske,1695,6,8,6,10,28,29,-1,30
AC Horsens,1695,7,5,15,10,35,56,-21,30
Randers FC,1695,8,5,7,12,24,40,-16,22
Silkeborg IF,1695,9,6,3,13,28,45,-17,21
Lyngby,1695,10,3,10,11,27,45,-18,19
AGF Aarhus,1695,11,4,6,12,17,39,-22,18
Brondby,1696,1,23,5,2,72,30,42,74
FC Midtjylla,1696,2,20,5,5,67,37,30,65
FC Nords,1696,3,13,7,10,74,57,17,46
Copenhagen,1696,4,12,7,11,56,48,8,43
AaB,1696,5,7,13,10,35,40,-5,34
Sonderjyske,1696,6,8,6,10,28,29,-1,30
AC Horsens,1696,7,5,15,10,34,52,-18,30
Lyngby,1696,8,4,9,11,30,44,-14,21
Randers FC,1696,9,5,6,13,23,43,-20,21
Silkeborg IF,1696,10,5,4,13,25,44,-19,19
AGF Aarhus,1696,11,4,7,11,16,36,-20,19
FC Midtjylla,1697,1,21,4,5,68,37,31,67
Brondby,1697,2,20,5,5,71,31,40,65
FC Nords,1697,3,13,7,10,70,56,14,46
Copenhagen,1697,4,13,5,12,53,47,6,44
AaB,1697,5,9,11,10,36,41,-5,38
AC Horsens,1697,6,7,14,9,36,48,-12,35
Sonderjyske,1697,7,8,6,10,28,29,-1,30
Lyngby,1697,8,4,9,11,29,45,-16,21
Randers FC,1697,9,5,6,13,24,42,-18,21
Silkeborg IF,1697,10,5,4,13,27,46,-19,19
AGF Aarhus,1697,11,4,7,11,18,38,-20,19
Brondby,1698,1,23,5,2,72,29,43,74
FC Midtjylla,1698,2,20,4,6,65,40,25,64
Copenhagen,1698,3,14,5,11,58,46,12,47
FC Nords,1698,4,13,7,10,71,53,18,46
AaB,1698,5,7,13,10,37,41,-4,34
Sonderjyske,1698,6,8,6,10,28,29,-1,30
AC Horsens,1698,7,5,14,11,35,55,-20,29
Lyngby,1698,8,4,9,11,27,44,-17,21
Randers FC,1698,9,5,6,13,23,40,-17,21
Silkeborg IF,1698,10,5,4,13,26,45,-19,19
AGF Aarhus,1698,11,4,7,11,17,37,-20,19
Brondby,1699,1,21,6,3,74,32,42,69
FC Midtjylla,1699,2,21,4,5,69,39,30,67
FC Nords,1699,3,14,7,9,76,56,20,49
Copenhagen,1699,4,14,6,10,61,46,15,48
AaB,1699,5,7,11,12,36,47,-11,32
Sonderjyske,1699,6,8,6,10,28,29,-1,30
AC Horsens,1699,7,6,12,12,32,54,-22,30
Lyngby,1699,8,4,9,11,30,45,-15,21
AGF Aarhus,1699,9,5,6,11,18,36,-18,21
Randers FC,1699,10,5,6,13,24,43,-19,21
Silkeborg IF,1699,11,5,3,14,25,46,-21,18
Brondby,1700,1,19,7,4,65,31,34,64
FC Midtjylla,1700,2,17,6,7,64,45,19,57
Copenhagen,1700,3,15,6,9,60,44,16,51
FC Nords,1700,4,14,8,8,75,51,24,50
AaB,1700,5,8,13,9,38,41,-3,37
AC Horsens,1700,6,5,16,9,35,51,-16,31
Sonderjyske,1700,7,8,6,10,28,29,-1,30
Randers FC,1700,8,6,6,12,26,40,-14,24
Silkeborg IF,1700,9,5,4,13,26,45,-19,19
AGF Aarhus,1700,10,4,7,11,17,37,-20,19
Lyngby,1700,11,3,9,12,27,47,-20,18
Brondby,1701,1,21,7,2,72,32,40,70
FC Midtjylla,1701,2,20,5,5,66,38,28,65
Copenhagen,1701,3,14,5,11,57,46,11,47
FC Nords,1701,4,12,8,10,72,58,14,44
AC Horsens,1701,5,7,13,10,39,51,-12,34
AaB,1701,6,7,12,11,34,41,-7,33
Sonderjyske,1701,7,8,6,10,28,29,-1,30
Randers FC,1701,8,5,7,12,24,40,-16,22
Silkeborg IF,1701,9,6,3,13,26,44,-18,21
Lyngby,1701,10,3,10,11,27,45,-18,19
AGF Aarhus,1701,11,4,6,12,16,37,-21,18
Brondby,1702,1,22,5,3,77,32,45,71
FC Midtjylla,1702,2,19,6,5,66,40,26,63
Copenhagen,1702,3,15,4,11,57,42,15,49
FC Nords,1702,4,13,7,10,73,53,20,46
AaB,1702,5,8,12,10,37,47,-10,36
Sonderjyske,1702,6,8,6,10,28,29,-1,30
AC Horsens,1702,7,6,12,12,32,54,-22,30
Randers FC,1702,8,6,6,12,24,39,-15,24
Silkeborg IF,1702,9,5,4,13,28,47,-19,19
AGF Aarhus,1702,10,4,7,11,19,39,-20,19
Lyngby,1702,11,3,9,12,26,45,-19,18
FC Midtjylla,1703,1,21,4,5,70,40,30,67
Brondby,1703,2,20,5,5,67,35,32,65
FC Nords,1703,3,15,6,9,72,46,26,51
Copenhagen,1703,4,14,5,11,59,48,11,47
AaB,1703,5,7,12,11,37,44,-7,33
AC Horsens,1703,6,7,12,11,35,53,-18,33
Sonderjyske,1703,7,8,6,10,28,29,-1,30
Lyngby,1703,8,4,9,11,28,44,-16,21
Randers FC,1703,9,5,6,13,23,41,-18,21
Silkeborg IF,1703,10,5,4,13,26,45,-19,19
AGF Aarhus,1703,11,4,7,11,17,37,-20,19
Brondby,1704,1,23,5,2,80,29,51,74
FC Midtjylla,1704,2,18,5,7,63,40,23,59
FC Nords,1704,3,15,7,8,73,49,24,52
Copenhagen,1704,4,14,6,10,58,47,11,48
AaB,1704,5,8,11,11,37,45,-8,35
Sonderjyske,1704,6,8,6,10,28,29,-1,30
AC Horsens,1704,7,5,12,13,30,57,-27,27
Randers FC,1704,8,5,7,12,26,42,-16,22
AGF Aarhus,1704,9,5,6,11,19,37,-18,21
Lyngby,1704,10,3,10,11,29,47,-18,19
Silkeborg IF,1704,11,5,3,14,26,47,-21,18
Brondby,1705,1,22,6,2,69,29,40,72
FC Midtjylla,1705,2,20,4,6,68,39,29,64
Copenhagen,1705,3,15,4,11,58,42,16,49
FC Nords,1705,4,13,9,8,70,50,20,48
AaB,1705,5,6,13,11,33,43,-10,31
Sonderjyske,1705,6,8,6,10,28,29,-1,30
AC Horsens,1705,7,5,14,11,36,57,-21,29
Randers FC,1705,8,6,6,12,24,39,-15,24
AGF Aarhus,1705,9,5,6,11,19,37,-18,21
Lyngby,1705,10,3,9,12,26,45,-19,18
Silkeborg IF,1705,11,5,3,14,26,47,-21,18
FC Midtjylla,1706,1,19,7,4,68,41,27,64
Brondby,1706,2,19,6,5,71,38,33,63
FC Nords,1706,3,14,8,8,79,52,27,50
Copenhagen,1706,4,12,6,12,55,49,6,42
AaB,1706,5,9,12,9,39,39,0,39
AC Horsens,1706,6,7,13,10,37,56,-19,34
Sonderjyske,1706,7,8,6,10,28,29,-1,30
Lyngby,1706,8,4,9,11,28,44,-16,21
Silkeborg IF,1706,9,6,3,13,26,44,-18,21
Randers FC,1706,10,5,6,13,23,41,-18,21
AGF Aarhus,1706,11,4,6,12,16,37,-21,18
FC Midtjylla,1707,1,22,4,4,70,35,35,70
Brondby,1707,2,20,5,5,70,35,35,65
FC Nords,1707,3,15,7,8,72,53,19,52
Copenhagen,1707,4,15,5,10,61,45,16,50
AaB,1707,5,7,11,12,38,47,-9,32
Sonderjyske,1707,6,8,6,10,28,29,-1,30
AC Horsens,1707,7,5,12,13,33,55,-22,27
Randers FC,1707,8,5,7,12,24,40,-16,22
Silkeborg IF,1707,9,6,3,13,27,45,-18,21
Lyngby,1707,10,3,10,11,27,45,-18,19
AGF Aarhus,1707,11,4,6,12,17,38,-21,18
Brondby,1708,1,21,6,3,72,34,38,69
FC Midtjylla,1708,2,18,5,7,63,41,22,59
FC Nords,1708,3,14,8,8,72,49,23,50
Copenhagen,1708,4,14,6,10,56,44,12,48
AaB,1708,5,8,11,11,41,46,-5,35
AC Horsens,1708,6,6,14,10,35,51,-16,32
Sonderjyske,1708,7,8,6,10,28,29,-1,30
Randers FC,1708,8,5,7,12,23,39,-16,22
Silkeborg IF,1708,9,6,3,13,32,47,-15,21
Lyngby,1708,10,3,10,11,26,44,-18,19
AGF Aarhus,1708,11,4,6,12,19,43,-24,18
Brondby,1709,1,21,7,2,71,31,40,70
FC Midtjylla,1709,2,18,6,6,61,42,19,60
FC Nords,1709,3,15,7,8,73,51,22,52
Copenhagen,1709,4,15,4,11,63,43,20,49
AaB,1709,5,7,13,10,37,44,-7,34
Sonderjyske,1709,6,8,6,10,28,29,-1,30
AC Horsens,1709,7,5,13,12,36,56,-20,28
Randers FC,1709,8,5,7,12,24,40,-16,22
Silkeborg IF,1709,9,6,3,13,26,44,-18,21
Lyngby,1709,10,3,10,11,27,45,-18,19
AGF Aarhus,1709,11,4,6,12,16,37,-21,18
Brondby,1710,1,23,5,2,74,27,47,74
FC Midtjylla,1710,2,20,4,6,67,39,28,64
FC Nords,1710,3,14,6,10,73,53,20,48
Copenhagen,1710,4,13,5,12,57,49,8,44
AaB,1710,5,8,11,11,37,48,-11,35
AC Horsens,1710,6,6,13,11,35,53,-18,31
Sonderjyske,1710,7,8,6,10,28,29,-1,30
Lyngby,1710,8,4,9,11,29,45,-16,21
Randers FC,1710,9,5,6,13,24,42,-18,21
Silkeborg IF,1710,10,5,4,13,26,45,-19,19
AGF Aarhus,1710,11,4,7,11,17,37,-20,19
Brondby,1711,1,23,5,2,76,30,46,74
FC Midtjylla,1711,2,19,4,7,64,40,24,61
Copenhagen,1711,3,15,4,11,55,41,14,49
FC Nords,1711,4,13,6,11,68,54,14,45
AaB,1711,5,8,11,11,38,44,-6,35
AC Horsens,1711,6,7,12,11,35,53,-18,33
Sonderjyske,1711,7,8,6,10,28,29,-1,30
Lyngby,1711,8,4,9,11,28,45,-17,21
Randers FC,1711,9,5,6,13,24,41,-17,21
AGF Aarhus,1711,10,5,6,11,18,37,-19,21
Silkeborg IF,1711,11,5,3,14,26,46,-20,18
Brondby,1712,1,19,8,3,67,34,33,65
FC Midtjylla,1712,2,18,6,6,62,41,21,60
Copenhagen,1712,3,14,6,10,57,41,16,48
FC Nords,1712,4,13,7,10,70,49,21,46
AaB,1712,5,8,14,8,41,41,0,38
AC Horsens,1712,6,7,13,10,35,52,-17,34
Sonderjyske,1712,7,8,6,10,28,29,-1,30
Lyngby,1712,8,4,9,11,27,44,-17,21
Randers FC,1712,9,5,6,13,23,40,-17,21
Silkeborg IF,1712,10,5,4,13,26,45,-19,19
AGF Aarhus,1712,11,4,7,11,17,37,-20,19
FC Midtjylla,1713,1,21,4,5,70,42,28,67
Brondby,1713,2,19,5,6,66,35,31,62
FC Nords,1713,3,16,6,8,74,50,24,54
Copenhagen,1713,4,15,4,11,60,50,10,49
AaB,1713,5,7,12,11,38,41,-3,33
AC Horsens,1713,6,6,13,11,36,52,-16,31
Sonderjyske,1713,7,8,6,10,28,29,-1,30
Lyngby,1713,8,4,9,11,28,45,-17,21
Randers FC,1713,9,5,6,13,24,41,-17,21
Silkeborg IF,1713,10,5,4,13,26,45,-19,19
AGF Aarhus,1713,11,4,7,11,17,37,-20,19
Brondby,1714,1,21,7,2,72,33,39,70
FC Midtjylla,1714,2,20,6,4,69,35,34,66
FC Nords,1714,3,13,8,9,74,55,19,47
Copenhagen,1714,4,13,6,11,59,52,7,45
AC Horsens,1714,5,6,14,10,37,54,-17,32
AaB,1714,6,6,13,11,35,43,-8,31
Sonderjyske,1714,7,8,6,10,28,29,-1,30
Randers FC,1714,8,6,6,12,25,40,-15,24
Silkeborg IF,1714,9,6,3,13,26,44,-18,21
Lyngby,1714,10,3,9,12,27,46,-19,18
AGF Aarhus,1714,11,4,6,12,16,37,-21,18
Brondby,1715,1,21,6,3,73,31,42,69
FC Midtjylla,1715,2,20,4,6,66,42,24,64
FC Nords,1715,3,14,6,10,72,56,16,48
Copenhagen,1715,4,14,5,11,57,46,11,47
AC Horsens,1715,5,8,12,10,37,49,-12,36
AaB,1715,6,7,11,12,39,46,-7,32
Sonderjyske,1715,7,8,6,10,28,29,-1,30
Lyngby,1715,8,4,9,11,28,44,-16,21
Silkeborg IF,1715,9,6,3,13,27,44,-17,21
Randers FC,1715,10,5,6,13,23,41,-18,21
AGF Aarhus,1715,11,4,6,12,16,38,-22,18
Brondby,1716,1,20,6,4,69,37,32,66
FC Midtjylla,1716,2,20,6,4,69,38,31,66
FC Nords,1716,3,15,6,9,75,51,24,51
Copenhagen,1716,4,12,5,13,54,47,7,41
AaB,1716,5,8,11,11,37,43,-6,35
AC Horsens,1716,6,7,14,9,37,51,-14,35
Sonderjyske,1716,7,8,6,10,28,29,-1,30
Randers FC,1716,8,6,6,12,24,39,-15,24
Silkeborg IF,1716,9,5,4,13,25,44,-19,19
AGF Aarhus,1716,10,4,7,11,16,36,-20,19
Lyngby,1716,11,3,9,12,26,45,-19,18
Brondby,1717,1,21,6,3,66,29,37,69
FC Midtjylla,1717,2,19,4,7,64,44,20,61
FC Nords,1717,3,14,6,10,72,50,22,48
Copenhagen,1717,4,14,5,11,61,47,14,47
AaB,1717,5,10,11,9,41,39,2,41
Sonderjyske,1717,6,8,6,10,28,29,-1,30
AC Horsens,1717,7,6,12,12,37,58,-21,30
Randers FC,1717,8,6,6,12,25,39,-14,24
Silkeborg IF,1717,9,6,3,13,27,45,-18,21
Lyngby,1717,10,3,9,12,26,46,-20,18
AGF Aarhus,1717,11,4,6,12,17,38,-21,18
Brondby,1718,1,20,6,4,71,35,36,66
FC Midtjylla,1718,2,19,5,6,66,41,25,62
FC Nords,1718,3,14,6,10,73,55,18,48
Copenhagen,1718,4,13,5,12,57,48,9,44
AaB,1718,5,9,13,8,40,39,1,40
AC Horsens,1718,6,7,13,10,38,53,-15,34
Sonderjyske,1718,7,8,6,10,28,29,-1,30
Lyngby,1718,8,4,9,11,27,44,-17,21
Silkeborg IF,1718,8,6,3,13,27,44,-17,21
Randers FC,1718,10,5,6,13,23,40,-17,21
AGF Aarhus,1718,11,4,6,12,16,38,-22,18
Brondby,1719,1,22,5,3,73,30,43,71
FC Midtjylla,1719,2,18,5,7,62,42,20,59
FC Nords,1719,3,14,7,9,69,50,19,49
Copenhagen,1719,4,13,6,11,57,45,12,45
AaB,1719,5,9,13,8,36,36,0,40
Sonderjyske,1719,6,8,6,10,28,29,-1,30
AC Horsens,1719,7,5,14,11,32,52,-20,29
Silkeborg IF,1719,8,6,3,13,29,44,-15,21
Lyngby,1719,9,4,9,11,28,44,-16,21
Randers FC,1719,10,5,6,13,23,41,-18,21
AGF Aarhus,1719,11,4,6,12,16,40,-24,18
Brondby,1720,1,23,5,2,79,29,50,74
FC Midtjylla,1720,2,21,4,5,70,40,30,67
FC Nords,1720,3,13,7,10,68,53,15,46
Copenhagen,1720,4,14,4,12,55,43,12,46
AaB,1720,5,8,12,10,36,42,-6,36
Sonderjyske,1720,6,8,6,10,28,29,-1,30
AC Horsens,1720,7,5,12,13,30,57,-27,27
Lyngby,1720,8,4,9,11,28,45,-17,21
Silkeborg IF,1720,9,6,3,13,27,44,-17,21
Randers FC,1720,10,5,6,13,24,41,-17,21
AGF Aarhus,1720,11,4,6,12,16,38,-22,18
Brondby,1721,1,21,6,3,68,32,36,69
FC Midtjylla,1721,2,19,5,6,67,41,26,62
FC Nords,1721,3,13,8,9,70,51,19,47
Copenhagen,1721,4,13,5,12,54,42,12,44
AC Horsens,1721,5,8,13,9,37,50,-13,37
AaB,1721,6,7,13,10,34,40,-6,34
Sonderjyske,1721,7,8,6,10,28,29,-1,30
Randers FC,1721,8,6,6,12,25,40,-15,24
Silkeborg IF,1721,9,6,3,13,29,45,-16,21
Lyngby,1721,10,3,9,12,27,46,-19,18
AGF Aarhus,1721,11,4,6,12,17,40,-23,18
Brondby,1722,1,22,5,3,71,30,41,71
FC Midtjylla,1722,2,19,4,7,64,38,26,61
Copenhagen,1722,3,15,4,11,63,46,17,49
FC Nords,1722,4,14,6,10,75,53,22,48
AaB,1722,5,8,12,10,39,46,-7,36
AC Horsens,1722,6,6,13,11,33,58,-25,31
Sonderjyske,1722,7,8,6,10,28,29,-1,30
Lyngby,1722,8,4,9,11,27,44,-17,21
Randers FC,1722,9,5,6,13,23,40,-17,21
AGF Aarhus,1722,10,5,6,11,17,36,-19,21
Silkeborg IF,1722,11,5,3,14,25,45,-20,18
Brondby,1723,1,22,5,3,71,31,40,71
FC Midtjylla,1723,2,20,4,6,66,39,27,64
FC Nords,1723,3,14,7,9,74,53,21,49
Copenhagen,1723,4,13,5,12,55,46,9,44
AC Horsens,1723,5,8,12,10,35,49,-14,36
AaB,1723,6,7,11,12,37,46,-9,32
Sonderjyske,1723,7,8,6,10,28,29,-1,30
Randers FC,1723,8,5,7,12,24,40,-16,22
Silkeborg IF,1723,9,6,3,13,27,45,-18,21
Lyngby,1723,10,3,10,11,27,45,-18,19
AGF Aarhus,1723,11,4,6,12,17,38,-21,18
Brondby,1724,1,22,5,3,75,33,42,71
FC Midtjylla,1724,2,19,5,6,64,40,24,62
FC Nords,1724,3,13,7,10,73,56,17,46
Copenhagen,1724,4,13,4,13,58,53,5,43
AC Horsens,1724,5,8,13,9,39,49,-10,37
AaB,1724,6,8,12,10,38,42,-4,36
Sonderjyske,1724,7,8,6,10,28,29,-1,30
Lyngby,1724,8,4,9,11,29,45,-16,21
Randers FC,1724,9,5,6,13,24,42,-18,21
AGF Aarhus,1724,10,5,6,11,18,37,-19,21
Silkeborg IF,1724,11,5,3,14,26,46,-20,18
Brondby,1725,1,21,6,3,72,32,40,69
FC Midtjylla,1725,2,18,6,6,66,41,25,60
Copenhagen,1725,3,16,5,9,58,41,17,53
FC Nords,1725,4,13,7,10,71,53,18,46
AaB,1725,5,7,12,11,38,44,-6,33
AC Horsens,1725,6,7,12,11,33,53,-20,33
Sonderjyske,1725,7,8,6,10,28,29,-1,30
Randers FC,1725,8,6,6,12,24,39,-15,24
AGF Aarhus,1725,9,5,6,11,17,36,-19,21
Lyngby,1725,10,3,9,12,26,45,-19,18
Silkeborg IF,1725,11,5,3,14,25,45,-20,18
Brondby,1726,1,21,6,3,68,29,39,69
FC Midtjylla,1726,2,19,5,6,63,37,26,62
FC Nords,1726,3,15,7,8,76,50,26,52
Copenhagen,1726,4,15,4,11,64,48,16,49
AC Horsens,1726,5,6,14,10,33,52,-19,32
Sonderjyske,1726,6,8,6,10,28,29,-1,30
AaB,1726,7,6,12,12,33,47,-14,30
Lyngby,1726,8,4,9,11,28,45,-17,21
Silkeborg IF,1726,8,6,3,13,28,45,-17,21
Randers FC,1726,10,5,6,13,24,41,-17,21
AGF Aarhus,1726,11,4,6,12,17,39,-22,18
Brondby,1727,1,21,6,3,73,34,39,69
FC Midtjylla,1727,2,21,5,4,71,36,35,68
FC Nords,1727,3,15,6,9,72,51,21,51
Copenhagen,1727,4,14,4,12,60,45,15,46
AaB,1727,5,8,11,11,37,44,-7,35
Sonderjyske,1727,6,8,6,10,28,29,-1,30
AC Horsens,1727,7,5,12,13,33,62,-29,27
Randers FC,1727,8,5,7,12,25,41,-16,22
Silkeborg IF,1727,9,6,3,13,27,44,-17,21
Lyngby,1727,10,3,10,11,28,46,-18,19
AGF Aarhus,1727,11,4,6,12,16,38,-22,18
Brondby,1728,1,22,5,3,77,34,43,71
FC Midtjylla,1728,2,20,4,6,65,42,23,64
FC Nords,1728,3,14,7,9,73,54,19,49
Copenhagen,1728,4,15,4,11,60,44,16,49
AaB,1728,5,7,12,11,40,48,-8,33
Sonderjyske,1728,6,8,6,10,28,29,-1,30
AC Horsens,1728,7,6,12,12,34,53,-19,30
Lyngby,1728,8,4,9,11,29,44,-15,21
Randers FC,1728,9,5,6,13,23,42,-19,21
Silkeborg IF,1728,10,5,4,13,26,45,-19,19
AGF Aarhus,1728,11,4,7,11,17,37,-20,19
Brondby,1729,1,19,8,3,63,28,35,65
FC Midtjylla,1729,2,19,5,6,62,39,23,62
FC Nords,1729,3,14,9,7,71,45,26,51
Copenhagen,1729,4,15,6,9,57,39,18,51
AaB,1729,5,6,13,11,35,43,-8,31
AC Horsens,1729,6,6,13,11,32,52,-20,31
Sonderjyske,1729,7,8,6,10,28,29,-1,30
Lyngby,1729,8,4,9,11,29,45,-16,21
Silkeborg IF,1729,9,6,3,13,28,44,-16,21
Randers FC,1729,10,5,6,13,24,42,-18,21
AGF Aarhus,1729,11,4,6,12,16,39,-23,18
Brondby,1730,1,22,6,2,75,32,43,72
FC Midtjylla,1730,2,20,5,5,66,39,27,65
Copenhagen,1730,3,14,5,11,58,46,12,47
FC Nords,1730,4,12,9,9,71,52,19,45
AaB,1730,5,7,13,10,34,43,-9,34
Sonderjyske,1730,6,8,6,10,28,29,-1,30
AC Horsens,1730,7,5,14,11,36,54,-18,29
Randers FC,1730,8,5,7,12,23,39,-16,22
Lyngby,1730,9,3,10,11,26,44,-18,19
Silkeborg IF,1730,10,5,4,13,26,45,-19,19
AGF Aarhus,1730,11,4,7,11,17,37,-20,19
Brondby,1731,1,20,7,3,69,36,33,67
FC Midtjylla,1731,2,19,4,7,65,40,25,61
FC Nords,1731,3,14,7,9,76,54,22,49
Copenhagen,1731,4,13,5,12,56,46,10,44
AaB,1731,5,8,13,9,35,39,-4,37
AC Horsens,1731,6,8,12,10,42,54,-12,36
Sonderjyske,1731,7,8,6,10,28,29,-1,30
Lyngby,1731,8,4,9,11,29,46,-17,21
Randers FC,1731,9,5,6,13,25,42,-17,21
AGF Aarhus,1731,10,5,6,11,19,36,-17,21
Silkeborg IF,1731,11,5,3,14,25,47,-22,18
Brondby,1732,1,21,7,2,72,30,42,70
FC Midtjylla,1732,2,20,5,5,68,38,30,65
FC Nords,1732,3,15,6,9,78,55,23,51
Copenhagen,1732,4,13,4,13,54,52,2,43
AC Horsens,1732,5,7,13,10,35,53,-18,34
AaB,1732,6,7,11,12,37,42,-5,32
Sonderjyske,1732,7,8,6,10,28,29,-1,30
Randers FC,1732,8,6,6,12,24,39,-15,24
Silkeborg IF,1732,9,5,4,13,25,44,-19,19
AGF Aarhus,1732,10,4,7,11,16,36,-20,19
Lyngby,1732,11,3,9,12,26,45,-19,18
FC Midtjylla,1733,1,21,5,4,69,35,34,68
Brondby,1733,2,20,7,3,69,32,37,67
Copenhagen,1733,3,14,5,11,55,42,13,47
FC Nords,1733,4,13,6,11,72,57,15,45
AC Horsens,1733,5,7,14,9,36,51,-15,35
AaB,1733,6,7,11,12,35,45,-10,32
Sonderjyske,1733,7,8,6,10,28,29,-1,30
Lyngby,1733,8,4,9,11,30,44,-14,21
Randers FC,1733,9,5,6,13,23,43,-20,21
Silkeborg IF,1733,10,5,4,13,25,44,-19,19
AGF Aarhus,1733,11,4,7,11,16,36,-20,19
Brondby,1734,1,21,6,3,73,31,42,69
FC Midtjylla,1734,2,19,5,6,71,47,24,62
Copenhagen,1734,3,15,6,9,58,41,17,51
FC Nords,1734,4,13,9,8,77,56,21,48
AaB,1734,5,6,14,10,32,41,-9,32
Sonderjyske,1734,6,8,6,10,28,29,-1,30
AC Horsens,1734,7,5,14,11,32,53,-21,29
Randers FC,1734,8,5,7,12,25,41,-16,22
Lyngby,1734,9,3,10,11,28,46,-18,19
Silkeborg IF,1734,10,5,4,13,26,45,-19,19
AGF Aarhus,1734,11,4,7,11,17,37,-20,19
Brondby,1735,1,21,7,2,72,30,42,70
FC Midtjylla,1735,2,20,4,6,65,43,22,64
FC Nords,1735,3,15,6,9,79,52,27,51
Copenhagen,1735,4,13,4,13,58,51,7,43
AaB,1735,5,7,13,10,36,43,-7,34
AC Horsens,1735,6,6,14,10,36,53,-17,32
Sonderjyske,1735,7,8,6,10,28,29,-1,30
Lyngby,1735,8,4,9,11,28,44,-16,21
Silkeborg IF,1735,9,6,3,13,26,44,-18,21
Randers FC,1735,10,5,6,13,23,41,-18,21
AGF Aarhus,1735,11,4,6,12,16,37,-21,18
Brondby,1736,1,21,6,3,71,33,38,69
FC Midtjylla,1736,2,21,4,5,76,40,36,67
FC Nords,1736,3,14,8,8,77,52,25,50
Copenhagen,1736,4,12,5,13,55,53,2,41
AaB,1736,5,7,13,10,35,43,-8,34
AC Horsens,1736,6,6,14,10,36,55,-19,32
Sonderjyske,1736,7,8,6,10,28,29,-1,30
Randers FC,1736,8,5,7,12,25,41,-16,22
Silkeborg IF,1736,9,6,3,13,26,44,-18,21
Lyngby,1736,10,3,10,11,28,46,-18,19
AGF Aarhus,1736,11,4,6,12,16,37,-21,18
Brondby,1737,1,21,7,2,73,32,41,70
FC Midtjylla,1737,2,19,5,6,67,39,28,62
FC Nords,1737,3,14,7,9,71,51,20,49
Copenhagen,1737,4,13,7,10,58,45,13,46
AaB,1737,5,7,12,11,36,43,-7,33
AC Horsens,1737,6,7,12,11,36,57,-21,33
Sonderjyske,1737,7,8,6,10,28,29,-1,30
Lyngby,1737,8,4,9,11,31,44,-13,21
Silkeborg IF,1737,9,6,3,13,28,45,-17,21
Randers FC,1737,10,5,6,13,23,44,-21,21
AGF Aarhus,1737,11,4,6,12,17,39,-22,18
Brondby,1738,1,20,7,3,71,35,36,67
FC Midtjylla,1738,2,18,5,7,62,44,18,59
FC Nords,1738,3,16,7,7,76,46,30,55
Copenhagen,1738,4,14,4,12,58,44,14,46
AaB,1738,5,8,12,10,40,46,-6,36
AC Horsens,1738,6,6,13,11,35,53,-18,31
Sonderjyske,1738,7,8,6,10,28,29,-1,30
Lyngby,1738,8,4,9,11,27,44,-17,21
Randers FC,1738,9,5,6,13,23,40,-17,21
AGF Aarhus,1738,10,5,6,11,18,36,-18,21
Silkeborg IF,1738,11,5,3,14,25,46,-21,18
Brondby,1739,1,22,5,3,75,32,43,71
FC Midtjylla,1739,2,20,4,6,66,41,25,64
FC Nords,1739,3,14,7,9,72,56,16,49
Copenhagen,1739,4,14,5,11,59,42,17,47
AaB,1739,5,8,11,11,34,42,-8,35
Sonderjyske,1739,6,8,6,10,28,29,-1,30
AC Horsens,1739,7,5,14,11,35,54,-19,29
Lyngby,1739,8,4,9,11,32,44,-12,21
Silkeborg IF,1739,9,6,3,13,26,44,-18,21
Randers FC,1739,10,5,6,13,23,45,-22,21
AGF Aarhus,1739,11,4,6,12,16,37,-21,18
Brondby,1740,1,21,7,2,69,30,39,70
FC Midtjylla,1740,2,21,4,5,76,38,38,67
FC Nords,1740,3,14,6,10,73,53,20,48
Copenhagen,1740,4,14,4,12,55,44,11,46
AaB,1740,5,7,12,11,37,50,-13,33
AC Horsens,1740,6,6,13,11,35,56,-21,31
Sonderjyske,1740,7,8,6,10,28,29,-1,30
Lyngby,1740,8,4,9,11,31,45,-14,21
Silkeborg IF,1740,9,6,3,13,27,45,-18,21
Randers FC,1740,10,5,6,13,24,44,-20,21
AGF Aarhus,1740,11,4,6,12,17,38,-21,18
Brondby,1741,1,22,6,2,73,32,41,72
FC Midtjylla,1741,2,19,4,7,67,41,26,61
Copenhagen,1741,3,14,6,10,59,47,12,48
FC Nords,1741,4,13,6,11,68,55,13,45
AaB,1741,5,9,11,10,39,38,1,38
AC Horsens,1741,6,6,13,11,34,53,-19,31
Sonderjyske,1741,7,8,6,10,28,29,-1,30
Silkeborg IF,1741,8,6,3,13,29,44,-15,21
Lyngby,1741,9,4,9,11,28,44,-16,21
Randers FC,1741,10,5,6,13,23,41,-18,21
AGF Aarhus,1741,11,4,6,12,16,40,-24,18
Brondby,1742,1,21,6,3,75,31,44,69
FC Midtjylla,1742,2,21,4,5,67,37,30,67
FC Nords,1742,3,14,7,9,73,52,21,49
Copenhagen,1742,4,13,4,13,53,47,6,43
AaB,1742,5,9,12,9,37,40,-3,39
Sonderjyske,1742,6,8,6,10,28,29,-1,30
AC Horsens,1742,7,5,13,12,33,57,-24,28
Randers FC,1742,8,6,6,12,26,40,-14,24
Silkeborg IF,1742,9,6,3,13,27,45,-18,21
Lyngby,1742,10,3,9,12,27,47,-20,18
AGF Aarhus,1742,11,4,6,12,17,38,-21,18
Brondby,1743,1,20,7,3,72,34,38,67
FC Midtjylla,1743,2,19,5,6,64,38,26,62
Copenhagen,1743,3,14,5,11,58,47,11,47
FC Nords,1743,4,13,7,10,69,53,16,46
AC Horsens,1743,5,8,13,9,36,47,-11,37
AaB,1743,6,8,11,11,38,44,-6,35
Sonderjyske,1743,7,8,6,10,28,29,-1,30
Randers FC,1743,8,5,7,12,24,40,-16,22
Lyngby,1743,9,3,10,11,27,45,-18,19
Silkeborg IF,1743,10,5,4,13,27,46,-19,19
AGF Aarhus,1743,11,4,7,11,18,38,-20,19
Brondby,1744,1,22,6,2,74,31,43,72
FC Midtjylla,1744,2,21,4,5,72,42,30,67
FC Nords,1744,3,15,6,9,77,51,26,51
Copenhagen,1744,4,14,4,12,57,45,12,46
Sonderjyske,1744,5,8,6,10,28,29,-1,30
AaB,1744,6,6,12,12,35,50,-15,30
AC Horsens,1744,7,5,14,11,36,58,-22,29
Lyngby,1744,8,4,9,11,30,44,-14,21
Silkeborg IF,1744,9,6,3,13,26,44,-18,21
Randers FC,1744,10,5,6,13,23,43,-20,21
AGF Aarhus,1744,11,4,6,12,16,37,-21,18
Brondby,1745,1,20,6,4,70,34,36,66
FC Midtjylla,1745,2,19,5,6,68,43,25,62
FC Nords,1745,3,15,6,9,76,50,26,51
Copenhagen,1745,4,13,5,12,54,46,8,44
AaB,1745,5,7,15,8,37,40,-3,36
AC Horsens,1745,6,7,13,10,36,54,-18,34
Sonderjyske,1745,7,8,6,10,28,29,-1,30
Lyngby,1745,8,4,9,11,28,45,-17,21
Randers FC,1745,9,5,6,13,24,41,-17,21
Silkeborg IF,1745,10,5,4,13,26,45,-19,19
AGF Aarhus,1745,11,4,7,11,17,37,-20,19
Brondby,1746,1,22,5,3,75,32,43,71
FC Midtjylla,1746,2,19,5,6,64,40,24,62
FC Nords,1746,3,17,6,7,77,46,31,57
Copenhagen,1746,4,13,5,12,52,44,8,44
AaB,1746,5,7,11,12,34,47,-13,32
Sonderjyske,1746,6,8,6,10,28,29,-1,30
AC Horsens,1746,7,6,12,12,35,54,-19,30
Randers FC,1746,8,6,6,12,27,41,-14,24
AGF Aarhus,1746,9,5,6,11,19,36,-17,21
Lyngby,1746,10,3,9,12,28,48,-20,18
Silkeborg IF,1746,11,5,3,14,25,47,-22,18
Brondby,1747,1,21,5,4,73,36,37,68
FC Midtjylla,1747,2,19,5,6,62,41,21,62
FC Nords,1747,3,14,7,9,74,49,25,49
Copenhagen,1747,4,14,4,12,58,47,11,46
AaB,1747,5,8,11,11,35,42,-7,35
AC Horsens,1747,6,7,14,9,38,51,-13,35
Sonderjyske,1747,7,8,6,10,28,29,-1,30
Randers FC,1747,8,6,6,12,24,39,-15,24
Silkeborg IF,1747,9,6,3,13,27,45,-18,21
Lyngby,1747,10,3,9,12,26,45,-19,18
AGF Aarhus,1747,11,4,6,12,17,38,-21,18
Brondby,1748,1,23,5,2,70,27,43,74
FC Midtjylla,1748,2,20,4,6,68,43,25,64
FC Nords,1748,3,15,6,9,70,48,22,51
Copenhagen,1748,4,14,4,12,60,46,14,46
AaB,1748,5,7,11,12,35,46,-11,32
Sonderjyske,1748,6,8,6,10,28,29,-1,30
AC Horsens,1748,7,6,12,12,36,55,-19,30
Randers FC,1748,8,6,6,12,25,39,-14,24
Silkeborg IF,1748,9,5,4,13,27,46,-19,19
AGF Aarhus,1748,10,4,7,11,18,38,-20,19
Lyngby,1748,11,3,9,12,26,46,-20,18
Brondby,1749,1,21,6,3,70,31,39,69
FC Midtjylla,1749,2,19,4,7,61,40,21,61
FC Nords,1749,3,16,6,8,75,47,28,54
Copenhagen,1749,4,16,4,10,61,43,18,52
AaB,1749,5,7,11,12,35,45,-10,32
Sonderjyske,1749,6,8,6,10,28,29,-1,30
AC Horsens,1749,7,5,13,12,33,55,-22,28
Lyngby,1749,8,4,9,11,27,44,-17,21
Randers FC,1749,9,5,6,13,23,40,-17,21
Silkeborg IF,1749,10,5,4,13,27,46,-19,19
AGF Aarhus,1749,11,4,7,11,18,38,-20,19
FC Midtjylla,1750,1,20,5,5,65,38,27,65
Brondby,1750,2,19,7,4,69,35,34,64
FC Nords,1750,3,14,8,8,71,50,21,50
Copenhagen,1750,4,14,5,11,59,45,14,47
AC Horsens,1750,5,8,12,10,38,50,-12,36
AaB,1750,6,7,11,12,35,45,-10,32
Sonderjyske,1750,7,8,6,10,28,29,-1,30
Lyngby,1750,8,4,9,11,27,44,-17,21
Randers FC,1750,9,5,6,13,23,40,-17,21
AGF Aarhus,1750,10,5,6,11,17,36,-19,21
Silkeborg IF,1750,11,5,3,14,25,45,-20,18
Brondby,1751,1,23,5,2,73,30,43,74
FC Midtjylla,1751,2,19,4,7,62,39,23,61
FC Nords,1751,3,16,6,8,77,52,25,54
Copenhagen,1751,4,14,5,11,57,44,13,47
AC Horsens,1751,5,6,13,11,33,53,-20,31
Sonderjyske,1751,6,8,6,10,28,29,-1,30
AaB,1751,7,6,11,13,38,48,-10,29
Silkeborg IF,1751,8,6,3,13,31,47,-16,21
Lyngby,1751,9,4,9,11,29,45,-16,21
Randers FC,1751,10,5,6,13,24,42,-18,21
AGF Aarhus,1751,11,4,6,12,19,42,-23,18
Brondby,1752,1,19,7,4,74,37,37,64
FC Midtjylla,1752,2,19,4,7,69,48,21,61
FC Nords,1752,3,14,8,8,78,51,27,50
Copenhagen,1752,4,14,7,9,61,45,16,49
AaB,1752,5,9,11,10,37,43,-6,38
AC Horsens,1752,6,6,13,11,35,56,-21,31
Sonderjyske,1752,7,8,6,10,28,29,-1,30
Lyngby,1752,8,4,9,11,27,44,-17,21
Randers FC,1752,9,5,6,13,23,40,-17,21
AGF Aarhus,1752,10,5,6,11,18,37,-19,21
Silkeborg IF,1752,11,5,3,14,26,46,-20,18
FC Midtjylla,1753,1,20,6,4,64,33,31,66
Brondby,1753,2,19,8,3,66,31,35,65
FC Nords,1753,3,14,9,7,74,48,26,51
Copenhagen,1753,4,12,6,12,55,49,6,42
AaB,1753,5,7,13,10,36,44,-8,34
AC Horsens,1753,6,6,14,10,35,51,-16,32
Sonderjyske,1753,7,8,6,10,28,29,-1,30
Randers FC,1753,8,6,6,12,26,40,-14,24
Silkeborg IF,1753,9,6,3,13,26,44,-18,21
Lyngby,1753,10,3,9,12,27,47,-20,18
AGF Aarhus,1753,11,4,6,12,16,37,-21,18
Brondby,1754,1,20,5,5,68,33,35,65
FC Midtjylla,1754,2,19,7,4,67,38,29,64
FC Nords,1754,3,14,8,8,73,51,22,50
Copenhagen,1754,4,14,6,10,59,42,17,48
AaB,1754,5,8,13,9,37,42,-5,37
Sonderjyske,1754,6,8,6,10,28,29,-1,30
AC Horsens,1754,7,5,13,12,33,57,-24,28
Randers FC,1754,8,5,7,12,23,39,-16,22
AGF Aarhus,1754,9,5,6,11,17,36,-19,21
Lyngby,1754,10,3,10,11,26,44,-18,19
Silkeborg IF,1754,11,5,3,14,25,45,-20,18
Brondby,1755,1,21,6,3,75,31,44,69
FC Midtjylla,1755,2,19,6,5,63,41,22,63
Copenhagen,1755,3,15,4,11,60,43,17,49
FC Nords,1755,4,14,6,10,70,56,14,48
AaB,1755,5,8,12,10,36,44,-8,36
Sonderjyske,1755,6,8,6,10,28,29,-1,30
AC Horsens,1755,7,6,12,12,36,51,-15,30
Randers FC,1755,8,6,6,12,25,39,-14,24
Silkeborg IF,1755,9,6,3,13,29,45,-16,21
Lyngby,1755,10,3,9,12,26,46,-20,18
AGF Aarhus,1755,11,4,6,12,17,40,-23,18
Brondby,1756,1,20,7,3,71,33,38,67
FC Midtjylla,1756,2,19,5,6,65,44,21,62
Copenhagen,1756,3,16,5,9,65,43,22,53
FC Nords,1756,4,14,7,9,75,51,24,49
AC Horsens,1756,5,6,14,10,33,52,-19,32
Sonderjyske,1756,6,8,6,10,28,29,-1,30
AaB,1756,7,6,12,12,39,51,-12,30
Randers FC,1756,8,5,7,12,25,41,-16,22
AGF Aarhus,1756,9,5,6,11,18,37,-19,21
Lyngby,1756,10,3,10,11,28,46,-18,19
Silkeborg IF,1756,11,5,3,14,26,46,-20,18
FC Midtjylla,1757,1,21,4,5,72,41,31,67
Brondby,1757,2,20,6,4,73,35,38,66
FC Nords,1757,3,14,7,9,75,57,18,49
Copenhagen,1757,4,15,4,11,61,47,14,49
AaB,1757,5,7,11,12,37,45,-8,32
AC Horsens,1757,6,6,14,10,35,54,-19,32
Sonderjyske,1757,7,8,6,10,28,29,-1,30
Randers FC,1757,8,6,6,12,24,39,-15,24
Silkeborg IF,1757,9,6,3,13,29,44,-15,21
Lyngby,1757,10,3,9,12,26,45,-19,18
AGF Aarhus,1757,11,4,6,12,16,40,-24,18
Brondby,1758,1,22,6,2,75,29,46,72
FC Midtjylla,1758,2,21,4,5,65,37,28,67
FC Nords,1758,3,14,6,10,71,56,15,48
Copenhagen,1758,4,12,4,14,55,51,4,40
AC Horsens,1758,5,8,13,9,37,50,-13,37
AaB,1758,6,7,11,12,35,41,-6,32
Sonderjyske,1758,7,8,6,10,28,29,-1,30
Randers FC,1758,8,6,6,12,24,39,-15,24
Silkeborg IF,1758,9,6,3,13,30,48,-18,21
Lyngby,1758,10,3,9,12,26,45,-19,18
AGF Aarhus,1758,11,4,6,12,20,41,-21,18
Brondby,1759,1,21,5,4,72,34,38,68
FC Midtjylla,1759,2,19,5,6,63,39,24,62
Copenhagen,1759,3,14,4,12,60,45,15,46
FC Nords,1759,4,13,6,11,69,57,12,45
AaB,1759,5,8,13,9,40,43,-3,37
AC Horsens,1759,6,8,13,9,40,52,-12,37
Sonderjyske,1759,7,8,6,10,28,29,-1,30
Lyngby,1759,8,4,9,11,29,45,-16,21
Randers FC,1759,9,5,6,13,24,42,-18,21
AGF Aarhus,1759,10,5,6,11,18,37,-19,21
Silkeborg IF,1759,11,5,3,14,26,46,-20,18
Brondby,1760,1,20,7,3,67,32,35,67
FC Midtjylla,1760,2,20,5,5,67,40,27,65
FC Nords,1760,3,14,7,9,75,55,20,49
Copenhagen,1760,4,14,4,12,57,47,10,46
AaB,1760,5,8,11,11,39,43,-4,35
AC Horsens,1760,6,6,14,10,35,49,-14,32
Sonderjyske,1760,7,8,6,10,28,29,-1,30
Randers FC,1760,8,5,7,12,24,40,-16,22
Silkeborg IF,1760,9,6,3,13,27,45,-18,21
Lyngby,1760,10,3,10,11,27,45,-18,19
AGF Aarhus,1760,11,4,6,12,17,38,-21,18
FC Midtjylla,1761,1,21,5,4,71,38,33,68
Brondby,1761,2,19,6,5,70,34,36,63
FC Nords,1761,3,15,8,7,75,49,26,53
Copenhagen,1761,4,13,5,12,56,46,10,44
AaB,1761,5,7,12,11,35,47,-12,33
AC Horsens,1761,6,7,12,11,34,53,-19,33
Sonderjyske,1761,7,8,6,10,28,29,-1,30
Silkeborg IF,1761,8,6,3,13,29,46,-17,21
Lyngby,1761,9,4,9,11,28,45,-17,21
Randers FC,1761,10,5,6,13,24,41,-17,21
AGF Aarhus,1761,11,4,6,12,18,40,-22,18
Brondby,1762,1,20,5,5,70,35,35,65
FC Midtjylla,1762,2,19,5,6,63,45,18,62
FC Nords,1762,3,14,8,8,75,52,23,50
Copenhagen,1762,4,14,6,10,61,43,18,48
AaB,1762,5,9,12,9,38,40,-2,39
Sonderjyske,1762,6,8,6,10,28,29,-1,30
AC Horsens,1762,7,6,12,12,33,51,-18,30
Randers FC,1762,8,6,6,12,25,40,-15,24
Silkeborg IF,1762,9,6,3,13,27,44,-17,21
Lyngby,1762,10,3,9,12,27,46,-19,18
AGF Aarhus,1762,11,4,6,12,16,38,-22,18
Brondby,1763,1,22,5,3,78,34,44,71
FC Midtjylla,1763,2,20,6,4,69,39,30,66
FC Nords,1763,3,13,8,9,76,56,20,47
Copenhagen,1763,4,13,6,11,58,47,11,45
AC Horsens,1763,5,7,12,11,40,59,-19,33
AaB,1763,6,7,11,12,34,46,-12,32
Sonderjyske,1763,7,8,6,10,28,29,-1,30
Randers FC,1763,8,5,7,12,24,40,-16,22
Silkeborg IF,1763,9,6,3,13,29,45,-16,21
Lyngby,1763,10,3,10,11,27,45,-18,19
AGF Aarhus,1763,11,4,6,12,17,40,-23,18
Brondby,1764,1,21,6,3,70,31,39,69
FC Midtjylla,1764,2,20,4,6,66,37,29,64
FC Nords,1764,3,14,6,10,73,53,20,48
Copenhagen,1764,4,13,5,12,56,50,6,44
AaB,1764,5,9,11,10,38,40,-2,38
AC Horsens,1764,6,7,12,11,34,52,-18,33
Sonderjyske,1764,7,8,6,10,28,29,-1,30
Randers FC,1764,8,6,6,12,24,39,-15,24
Silkeborg IF,1764,9,6,3,13,27,45,-18,21
Lyngby,1764,10,3,9,12,26,45,-19,18
AGF Aarhus,1764,11,4,6,12,17,38,-21,18
FC Midtjylla,1765,1,20,4,6,67,37,30,64
Brondby,1765,2,18,7,5,65,35,30,61
Copenhagen,1765,3,16,4,10,56,41,15,52
FC Nords,1765,4,15,6,9,75,51,24,51
AaB,1765,5,8,12,10,39,45,-6,36
AC Horsens,1765,6,6,13,11,32,51,-19,31
Sonderjyske,1765,7,8,6,10,28,29,-1,30
Randers FC,1765,8,5,7,12,24,40,-16,22
Lyngby,1765,9,3,10,11,27,45,-18,19
Silkeborg IF,1765,10,5,4,13,27,46,-19,19
AGF Aarhus,1765,11,4,7,11,18,38,-20,19
Brondby,1766,1,19,7,4,66,32,34,64
FC Midtjylla,1766,2,19,6,5,62,37,25,63
Copenhagen,1766,3,15,5,10,62,44,18,50
FC Nords,1766,4,14,7,9,73,54,19,49
AaB,1766,5,9,11,10,36,38,-2,38
Sonderjyske,1766,6,8,6,10,28,29,-1,30
AC Horsens,1766,7,6,12,12,36,56,-20,30
Randers FC,1766,8,5,7,12,23,39,-16,22
AGF Aarhus,1766,9,5,6,11,18,37,-19,21
Lyngby,1766,10,3,10,11,26,44,-18,19
Silkeborg IF,1766,11,5,3,14,26,46,-20,18
Brondby,1767,1,22,6,2,75,31,44,72
FC Midtjylla,1767,2,19,5,6,65,41,24,62
FC Nords,1767,3,14,8,8,73,53,20,50
Copenhagen,1767,4,13,6,11,58,46,12,45
AaB,1767,5,7,13,10,35,42,-7,34
Sonderjyske,1767,6,8,6,10,28,29,-1,30
AC Horsens,1767,7,5,14,11,33,52,-19,29
Randers FC,1767,8,6,6,12,26,39,-13,24
AGF Aarhus,1767,9,5,6,11,18,37,-19,21
Silkeborg IF,1767,10,5,3,14,26,46,-20,18
Lyngby,1767,11,3,9,12,26,47,-21,18
Brondby,1768,1,18,10,2,68,33,35,64
FC Midtjylla,1768,2,18,7,5,66,43,23,61
Copenhagen,1768,3,14,7,9,57,41,16,49
FC Nords,1768,4,12,10,8,75,55,20,46
AaB,1768,5,7,15,8,38,41,-3,36
AC Horsens,1768,6,6,13,11,35,52,-17,31
Sonderjyske,1768,7,8,6,10,28,29,-1,30
Lyngby,1768,8,4,9,11,27,44,-17,21
Randers FC,1768,9,5,6,13,23,40,-17,21
Silkeborg IF,1768,10,6,3,13,26,44,-18,21
AGF Aarhus,1768,11,4,6,12,16,37,-21,18
Brondby,1769,1,20,6,4,69,35,34,66
FC Midtjylla,1769,2,19,5,6,63,40,23,62
FC Nords,1769,3,15,7,8,76,49,27,52
Copenhagen,1769,4,15,4,11,60,47,13,49
AaB,1769,5,8,11,11,37,43,-6,35
AC Horsens,1769,6,6,13,11,33,50,-17,31
Sonderjyske,1769,7,8,6,10,28,29,-1,30
Lyngby,1769,8,4,9,11,29,46,-17,21
Randers FC,1769,9,5,6,13,25,42,-17,21
Silkeborg IF,1769,10,5,4,13,27,46,-19,19
AGF Aarhus,1769,11,4,7,11,18,38,-20,19
Brondby,1770,1,22,6,2,76,31,45,72
FC Midtjylla,1770,2,20,6,4,69,37,32,66
FC Nords,1770,3,15,6,9,74,56,18,51
Copenhagen,1770,4,13,4,13,52,43,9,43
AaB,1770,5,6,13,11,36,44,-8,31
AC Horsens,1770,6,6,13,11,33,55,-22,31
Sonderjyske,1770,7,8,6,10,28,29,-1,30
Randers FC,1770,8,6,6,12,25,40,-15,24
AGF Aarhus,1770,9,5,6,11,17,36,-19,21
Lyngby,1770,10,3,9,12,27,46,-19,18
Silkeborg IF,1770,11,5,3,14,25,45,-20,18
Brondby,1771,1,21,5,4,69,30,39,68
FC Midtjylla,1771,2,19,4,7,62,39,23,61
FC Nords,1771,3,16,6,8,73,47,26,54
Copenhagen,1771,4,14,4,12,56,47,9,46
AC Horsens,1771,5,8,12,10,33,48,-15,36
AaB,1771,6,7,11,12,34,42,-8,32
Sonderjyske,1771,7,8,6,10,28,29,-1,30
Randers FC,1771,8,5,7,12,23,39,-16,22
AGF Aarhus,1771,9,5,6,11,19,38,-19,21
Lyngby,1771,10,3,10,11,26,44,-18,19
Silkeborg IF,1771,11,5,3,14,27,47,-20,18
FC Midtjylla,1772,1,18,6,6,70,42,28,60
Brondby,1772,2,18,6,6,64,39,25,60
FC Nords,1772,3,16,7,7,79,50,29,55
Copenhagen,1772,4,14,5,11,58,45,13,47
AaB,1772,5,8,12,10,39,45,-6,36
AC Horsens,1772,6,8,12,10,39,54,-15,36
Sonderjyske,1772,7,8,6,10,28,29,-1,30
Lyngby,1772,8,4,9,11,28,45,-17,21
Randers FC,1772,9,5,6,13,24,41,-17,21
AGF Aarhus,1772,10,5,6,11,18,37,-19,21
Silkeborg IF,1772,11,5,3,14,26,46,-20,18
Brondby,1773,1,21,6,3,73,33,40,69
FC Midtjylla,1773,2,21,5,4,66,37,29,68
FC Nords,1773,3,14,7,9,72,52,20,49
Copenhagen,1773,4,13,5,12,56,45,11,44
AaB,1773,5,8,12,10,40,42,-2,36
Sonderjyske,1773,6,8,6,10,28,29,-1,30
AC Horsens,1773,7,5,13,12,31,55,-24,28
Randers FC,1773,8,6,6,12,27,42,-15,24
AGF Aarhus,1773,9,5,6,11,19,38,-19,21
Lyngby,1773,10,3,9,12,29,48,-19,18
Silkeborg IF,1773,11,5,3,14,27,47,-20,18
Brondby,1774,1,20,7,3,69,32,37,67
FC Midtjylla,1774,2,20,6,4,67,38,29,66
FC Nords,1774,3,13,8,9,71,51,20,47
Copenhagen,1774,4,14,4,12,58,47,11,46
AaB,1774,5,8,11,11,38,44,-6,35
AC Horsens,1774,6,6,14,10,34,51,-17,32
Sonderjyske,1774,7,8,6,10,28,29,-1,30
Randers FC,1774,8,6,6,12,24,39,-15,24
Silkeborg IF,1774,9,6,3,13,30,46,-16,21
Lyngby,1774,10,3,9,12,26,45,-19,18
AGF Aarhus,1774,11,4,6,12,18,41,-23,18
Brondby,1775,1,19,7,4,70,36,34,64
FC Midtjylla,1775,2,19,5,6,64,39,25,62
FC Nords,1775,3,14,8,8,70,48,22,50
Copenhagen,1775,4,14,4,12,58,45,13,46
AaB,1775,5,8,13,9,37,40,-3,37
AC Horsens,1775,6,7,13,10,36,53,-17,34
Sonderjyske,1775,7,8,6,10,28,29,-1,30
Randers FC,1775,8,5,7,12,24,40,-16,22
Silkeborg IF,1775,9,6,3,13,28,46,-18,21
Lyngby,1775,10,3,10,11,27,45,-18,19
AGF Aarhus,1775,11,4,6,12,18,39,-21,18
Brondby,1776,1,21,7,2,70,29,41,70
FC Midtjylla,1776,2,19,5,6,69,39,30,62
FC Nords,1776,3,14,7,9,73,53,20,49
Copenhagen,1776,4,15,4,11,55,41,14,49
AaB,1776,5,7,12,11,37,42,-5,33
AC Horsens,1776,6,6,13,11,35,61,-26,31
Sonderjyske,1776,7,8,6,10,28,29,-1,30
Randers FC,1776,8,6,6,12,24,39,-15,24
AGF Aarhus,1776,9,5,6,11,19,36,-17,21
Lyngby,1776,10,3,9,12,26,45,-19,18
Silkeborg IF,1776,11,5,3,14,25,47,-22,18
Brondby,1777,1,20,6,4,71,35,36,66
FC Midtjylla,1777,2,20,4,6,64,39,25,64
Copenhagen,1777,3,15,5,10,59,44,15,50
FC Nords,1777,4,13,7,10,72,54,18,46
AaB,1777,5,7,13,10,40,44,-4,34
AC Horsens,1777,6,7,13,10,39,55,-16,34
Sonderjyske,1777,7,8,6,10,28,29,-1,30
Randers FC,1777,8,6,6,12,25,40,-15,24
Silkeborg IF,1777,9,5,4,13,26,45,-19,19
AGF Aarhus,1777,10,4,7,11,17,37,-20,19
Lyngby,1777,11,3,9,12,27,46,-19,18
Brondby,1778,1,20,7,3,68,30,38,67
FC Midtjylla,1778,2,18,6,6,65,44,21,60
FC Nords,1778,3,13,8,9,68,49,19,47
Copenhagen,1778,4,14,4,12,59,46,13,46
AaB,1778,5,8,13,9,36,38,-2,37
AC Horsens,1778,6,7,14,9,35,50,-15,35
Sonderjyske,1778,7,8,6,10,28,29,-1,30
Randers FC,1778,8,6,6,12,24,39,-15,24
Silkeborg IF,1778,9,5,4,13,25,44,-19,19
AGF Aarhus,1778,10,4,7,11,16,36,-20,19
Lyngby,1778,11,3,9,12,26,45,-19,18
Brondby,1779,1,21,6,3,70,32,38,69
FC Midtjylla,1779,2,19,5,6,64,38,26,62
FC Nords,1779,3,16,6,8,81,49,32,54
Copenhagen,1779,4,13,5,12,55,46,9,44
AaB,1779,5,8,11,11,37,47,-10,35
AC Horsens,1779,6,6,13,11,37,58,-21,31
Sonderjyske,1779,7,8,6,10,28,29,-1,30
Lyngby,1779,8,4,9,11,27,44,-17,21
Randers FC,1779,9,5,6,13,23,40,-17,21
Silkeborg IF,1779,10,5,4,13,28,47,-19,19
AGF Aarhus,1779,11,4,7,11,19,39,-20,19
Brondby,1780,1,21,7,2,74,34,40,70
FC Midtjylla,1780,2,20,4,6,66,42,24,64
FC Nords,1780,3,14,7,9,76,53,23,49
Copenhagen,1780,4,14,5,11,59,45,14,47
AaB,1780,5,7,13,10,40,45,-5,34
Sonderjyske,1780,6,8,6,10,28,29,-1,30
AC Horsens,1780,7,6,12,12,34,56,-22,30
Randers FC,1780,8,6,6,12,25,39,-14,24
AGF Aarhus,1780,9,5,6,11,18,36,-18,21
Lyngby,1780,10,3,9,12,26,46,-20,18
Silkeborg IF,1780,11,5,3,14,25,46,-21,18
Brondby,1781,1,22,5,3,75,29,46,71
FC Midtjylla,1781,2,22,4,4,68,37,31,70
FC Nords,1781,3,14,6,10,72,56,16,48
Copenhagen,1781,4,13,4,13,59,50,9,43
AaB,1781,5,9,11,10,40,43,-3,38
Sonderjyske,1781,6,8,6,10,28,29,-1,30
AC Horsens,1781,7,5,12,13,35,60,-25,27
Lyngby,1781,8,4,9,11,30,46,-16,21
Randers FC,1781,9,5,6,13,25,43,-18,21
AGF Aarhus,1781,10,5,6,11,17,36,-19,21
Silkeborg IF,1781,11,5,3,14,25,45,-20,18
Brondby,1782,1,22,5,3,78,35,43,71
FC Midtjylla,1782,2,19,4,7,63,40,23,61
FC Nords,1782,3,15,6,9,74,53,21,51
Copenhagen,1782,4,13,5,12,58,48,10,44
AaB,1782,5,7,13,10,39,47,-8,34
AC Horsens,1782,6,7,13,10,36,51,-15,34
Sonderjyske,1782,7,8,6,10,28,29,-1,30
Randers FC,1782,8,5,7,12,24,40,-16,22
Silkeborg IF,1782,9,6,3,13,26,44,-18,21
Lyngby,1782,10,3,10,11,27,45,-18,19
AGF Aarhus,1782,11,4,6,12,16,37,-21,18
Brondby,1783,1,19,8,3,64,27,37,65
FC Midtjylla,1783,2,20,4,6,69,38,31,64
FC Nords,1783,3,15,7,8,77,53,24,52
Copenhagen,1783,4,13,6,11,58,49,9,45
AC Horsens,1783,5,7,13,10,35,53,-18,34
AaB,1783,6,7,12,11,37,46,-9,33
Sonderjyske,1783,7,8,6,10,28,29,-1,30
Randers FC,1783,8,6,6,12,25,40,-15,24
Silkeborg IF,1783,9,6,3,13,27,45,-18,21
Lyngby,1783,10,3,9,12,27,46,-19,18
AGF Aarhus,1783,11,4,6,12,17,38,-21,18
Brondby,1784,1,20,6,4,67,32,35,66
FC Midtjylla,1784,2,18,6,6,65,43,22,60
FC Nords,1784,3,14,7,9,74,51,23,49
Copenhagen,1784,4,13,6,11,56,43,13,45
AaB,1784,5,9,12,9,39,41,-2,39
AC Horsens,1784,6,7,13,10,32,49,-17,34
Sonderjyske,1784,7,8,6,10,28,29,-1,30
Lyngby,1784,8,4,9,11,29,46,-17,21
Randers FC,1784,9,5,6,13,25,42,-17,21
Silkeborg IF,1784,10,5,4,13,27,46,-19,19
AGF Aarhus,1784,11,4,7,11,18,38,-20,19
Brondby,1785,1,19,6,5,65,31,34,63
FC Midtjylla,1785,2,19,4,7,68,42,26,61
FC Nords,1785,3,16,6,8,74,49,25,54
Copenhagen,1785,4,14,5,11,57,47,10,47
AaB,1785,5,8,13,9,38,41,-3,37
AC Horsens,1785,6,6,14,10,34,52,-18,32
Sonderjyske,1785,7,8,6,10,28,29,-1,30
Lyngby,1785,8,4,9,11,29,44,-15,21
Randers FC,1785,9,5,6,13,23,42,-19,21
Silkeborg IF,1785,10,5,4,13,26,45,-19,19
AGF Aarhus,1785,11,4,7,11,17,37,-20,19
FC Midtjylla,1786,1,21,4,5,69,39,30,67
Brondby,1786,2,20,5,5,67,34,33,65
FC Nords,1786,3,16,6,8,82,48,34,54
Copenhagen,1786,4,12,4,14,51,52,-1,40
AC Horsens,1786,5,8,12,10,38,56,-18,36
AaB,1786,6,8,11,11,39,43,-4,35
Sonderjyske,1786,7,8,6,10,28,29,-1,30
Randers FC,1786,8,5,7,12,25,41,-16,22
Silkeborg IF,1786,9,6,3,13,29,45,-16,21
Lyngby,1786,10,3,10,11,28,46,-18,19
AGF Aarhus,1786,11,4,6,12,17,40,-23,18
Brondby,1787,1,20,6,4,68,30,38,66
FC Midtjylla,1787,2,20,4,6,69,40,29,64
FC Nords,1787,3,17,6,7,74,45,29,57
Copenhagen,1787,4,14,5,11,57,45,12,47
AaB,1787,5,7,12,11,34,47,-13,33
Sonderjyske,1787,6,8,6,10,28,29,-1,30
AC Horsens,1787,7,5,13,12,29,50,-21,28
Randers FC,1787,8,5,7,12,23,39,-16,22
AGF Aarhus,1787,9,5,6,11,18,36,-18,21
Lyngby,1787,10,3,10,11,26,44,-18,19
Silkeborg IF,1787,11,5,3,14,25,46,-21,18
Brondby,1788,1,20,5,5,72,34,38,65
FC Midtjylla,1788,2,19,5,6,64,38,26,62
FC Nords,1788,3,13,8,9,67,53,14,47
Copenhagen,1788,4,14,5,11,55,42,13,47
AC Horsens,1788,5,8,13,9,37,50,-13,37
AaB,1788,6,8,12,10,40,44,-4,36
Sonderjyske,1788,7,8,6,10,28,29,-1,30
Randers FC,1788,8,5,7,12,25,41,-16,22
Silkeborg IF,1788,9,6,3,13,27,45,-18,21
Lyngby,1788,10,3,10,11,28,46,-18,19
AGF Aarhus,1788,11,4,6,12,17,38,-21,18
Brondby,1789,1,19,6,5,64,32,32,63
FC Midtjylla,1789,2,18,6,6,63,39,24,60
FC Nords,1789,3,15,6,9,74,49,25,51
Copenhagen,1789,4,14,4,12,54,45,9,46
AaB,1789,5,9,12,9,38,40,-2,39
AC Horsens,1789,6,7,14,9,33,47,-14,35
Sonderjyske,1789,7,8,6,10,28,29,-1,30
Lyngby,1789,8,4,9,11,27,44,-17,21
Randers FC,1789,9,5,6,13,23,40,-17,21
AGF Aarhus,1789,10,5,6,11,18,37,-19,21
Silkeborg IF,1789,11,5,3,14,26,46,-20,18
Brondby,1790,1,22,6,2,76,34,42,72
FC Midtjylla,1790,2,19,5,6,65,40,25,62
FC Nords,1790,3,14,8,8,78,54,24,50
Copenhagen,1790,4,12,6,12,61,51,10,42
AaB,1790,5,7,14,9,38,42,-4,35
AC Horsens,1790,6,6,13,11,32,55,-23,31
Sonderjyske,1790,7,8,6,10,28,29,-1,30
Randers FC,1790,8,6,6,12,26,40,-14,24
Silkeborg IF,1790,9,5,4,13,25,44,-19,19
AGF Aarhus,1790,10,4,7,11,16,36,-20,19
Lyngby,1790,11,3,9,12,27,47,-20,18
FC Midtjylla,1791,1,20,5,5,66,39,27,65
Brondby,1791,2,19,6,5,67,34,33,63
FC Nords,1791,3,14,6,10,72,51,21,48
Copenhagen,1791,4,14,5,11,55,43,12,47
AaB,1791,5,8,12,10,37,40,-3,36
AC Horsens,1791,6,8,12,10,36,52,-16,36
Sonderjyske,1791,7,8,6,10,28,29,-1,30
Lyngby,1791,8,4,9,11,28,45,-17,21
Randers FC,1791,9,5,6,13,24,41,-17,21
AGF Aarhus,1791,10,5,6,11,17,36,-19,21
Silkeborg IF,1791,11,5,3,14,25,45,-20,18
Brondby,1792,1,20,5,5,70,35,35,65
FC Midtjylla,1792,2,20,4,6,64,42,22,64
FC Nords,1792,3,15,7,8,77,52,25,52
Copenhagen,1792,4,15,5,10,61,43,18,50
AC Horsens,1792,5,8,12,10,36,50,-14,36
Sonderjyske,1792,6,8,6,10,28,29,-1,30
AaB,1792,7,6,11,13,34,46,-12,29
Randers FC,1792,8,5,7,12,24,40,-16,22
Silkeborg IF,1792,9,6,3,13,26,44,-18,21
Lyngby,1792,10,3,10,11,27,45,-18,19
AGF Aarhus,1792,11,4,6,12,16,37,-21,18
Brondby,1793,1,20,7,3,71,31,40,67
FC Midtjylla,1793,2,20,4,6,68,43,25,64
Copenhagen,1793,3,14,5,11,61,47,14,47
FC Nords,1793,4,13,7,10,72,55,17,46
AaB,1793,5,8,12,10,39,43,-4,36
AC Horsens,1793,6,6,15,9,35,53,-18,33
Sonderjyske,1793,7,8,6,10,28,29,-1,30
Randers FC,1793,8,6,6,12,24,39,-15,24
Silkeborg IF,1793,9,6,3,13,27,45,-18,21
Lyngby,1793,10,3,9,12,26,45,-19,18
AGF Aarhus,1793,11,4,6,12,17,38,-21,18
Brondby,1794,1,22,5,3,73,30,43,71
FC Midtjylla,1794,2,18,5,7,64,41,23,59
FC Nords,1794,3,15,6,9,71,52,19,51
Copenhagen,1794,4,15,5,10,58,41,17,50
AaB,1794,5,7,13,10,37,43,-6,34
Sonderjyske,1794,6,8,6,10,28,29,-1,30
AC Horsens,1794,7,6,12,12,36,58,-22,30
Lyngby,1794,8,4,9,11,28,45,-17,21
Randers FC,1794,9,5,6,13,24,41,-17,21
Silkeborg IF,1794,10,5,4,13,26,45,-19,19
AGF Aarhus,1794,11,4,7,11,17,37,-20,19
Brondby,1795,1,21,7,2,71,29,42,70
FC Midtjylla,1795,2,20,5,5,68,41,27,65
FC Nords,1795,3,15,7,8,75,52,23,52
Copenhagen,1795,4,14,4,12,57,46,11,46
AaB,1795,5,6,14,10,44,51,-7,32
Sonderjyske,1795,6,8,6,10,28,29,-1,30
AC Horsens,1795,7,5,13,12,31,53,-22,28
Randers FC,1795,8,5,7,12,24,40,-16,22
Silkeborg IF,1795,9,6,3,13,28,44,-16,21
Lyngby,1795,10,3,10,11,27,45,-18,19
AGF Aarhus,1795,11,4,6,12,16,39,-23,18
Brondby,1796,1,22,5,3,74,32,42,71
FC Midtjylla,1796,2,19,5,6,67,43,24,62
FC Nords,1796,3,15,7,8,73,50,23,52
Copenhagen,1796,4,15,4,11,59,46,13,49
AaB,1796,5,7,13,10,36,44,-8,34
Sonderjyske,1796,6,8,6,10,28,29,-1,30
AC Horsens,1796,7,5,12,13,35,55,-20,27
Randers FC,1796,8,6,6,12,25,40,-15,24
Silkeborg IF,1796,9,6,3,13,27,45,-18,21
Lyngby,1796,10,3,9,12,27,46,-19,18
AGF Aarhus,1796,11,4,6,12,17,38,-21,18
Brondby,1797,1,21,7,2,69,29,40,70
FC Midtjylla,1797,2,18,5,7,65,44,21,59
FC Nords,1797,3,14,8,8,72,47,25,50
Copenhagen,1797,4,13,6,11,58,46,12,45
AaB,1797,5,8,13,9,37,41,-4,37
AC Horsens,1797,6,6,13,11,34,54,-20,31
Sonderjyske,1797,7,8,6,10,28,29,-1,30
Lyngby,1797,8,4,9,11,30,46,-16,21
Silkeborg IF,1797,9,6,3,13,29,46,-17,21
Randers FC,1797,10,5,6,13,25,43,-18,21
AGF Aarhus,1797,11,4,6,12,18,40,-22,18
Brondby,1798,1,22,5,3,73,33,40,71
FC Midtjylla,1798,2,19,5,6,63,42,21,62
Copenhagen,1798,3,14,5,11,57,46,11,47
FC Nords,1798,4,13,7,10,71,54,17,46
AC Horsens,1798,5,8,13,9,42,49,-7,37
AaB,1798,6,6,13,11,37,45,-8,31
Sonderjyske,1798,7,8,6,10,28,29,-1,30
Randers FC,1798,8,5,7,12,24,40,-16,22
Silkeborg IF,1798,9,6,3,13,27,44,-17,21
Lyngby,1798,10,3,10,11,27,45,-18,19
AGF Aarhus,1798,11,4,6,12,16,38,-22,18
Brondby,1799,1,22,5,3,74,32,42,71
FC Midtjylla,1799,2,20,4,6,64,41,23,64
FC Nords,1799,3,16,6,8,76,52,24,54
Copenhagen,1799,4,12,5,13,59,52,7,41
AaB,1799,5,9,11,10,44,47,-3,38
Sonderjyske,1799,6,8,6,10,28,29,-1,30
AC Horsens,1799,7,5,13,12,37,56,-19,28
Randers FC,1799,8,5,7,12,26,42,-16,22
Silkeborg IF,1799,9,6,3,13,26,44,-18,21
Lyngby,1799,10,3,10,11,29,47,-18,19
AGF Aarhus,1799,11,4,6,12,16,37,-21,18
Brondby,1800,1,22,6,2,72,31,41,72
FC Midtjylla,1800,2,17,8,5,60,37,23,59
Copenhagen,1800,3,15,5,10,59,42,17,50
FC Nords,1800,4,14,7,9,73,52,21,49
AaB,1800,5,6,13,11,34,44,-10,31
Sonderjyske,1800,6,8,6,10,28,29,-1,30
AC Horsens,1800,7,5,15,10,33,51,-18,30
Randers FC,1800,8,6,6,12,24,39,-15,24
Silkeborg IF,1800,9,6,3,13,28,46,-18,21
Lyngby,1800,10,3,9,12,26,45,-19,18
AGF Aarhus,1800,11,4,6,12,18,39,-21,18
Brondby,1801,1,20,6,4,69,34,35,66
FC Midtjylla,1801,2,19,5,6,67,42,25,62
FC Nords,1801,3,14,7,9,74,52,22,49
Copenhagen,1801,4,14,4,12,54,46,8,46
AaB,1801,5,8,12,10,40,42,-2,36
AC Horsens,1801,6,8,12,10,39,53,-14,36
Sonderjyske,1801,7,8,6,10,28,29,-1,30
Randers FC,1801,8,5,7,12,23,39,-16,22
Silkeborg IF,1801,9,6,3,13,27,45,-18,21
Lyngby,1801,10,3,10,11,26,44,-18,19
AGF Aarhus,1801,11,4,6,12,17,38,-21,18
Brondby,1802,1,22,5,3,76,34,42,71
FC Midtjylla,1802,2,18,7,5,67,45,22,61
FC Nords,1802,3,15,6,9,79,51,28,51
Copenhagen,1802,4,14,5,11,58,47,11,47
AC Horsens,1802,5,6,14,10,36,57,-21,32
AaB,1802,6,6,13,11,39,47,-8,31
Sonderjyske,1802,7,8,6,10,28,29,-1,30
Randers FC,1802,8,6,6,12,24,39,-15,24
Silkeborg IF,1802,9,6,3,13,28,45,-17,21
Lyngby,1802,10,3,9,12,26,45,-19,18
AGF Aarhus,1802,11,4,6,12,17,39,-22,18
Brondby,1803,1,22,6,2,73,29,44,72
FC Midtjylla,1803,2,18,4,8,66,46,20,58
Copenhagen,1803,3,15,5,10,59,43,16,50
FC Nords,1803,4,13,7,10,70,53,17,46
AaB,1803,5,8,12,10,39,41,-2,36
AC Horsens,1803,6,7,12,11,35,56,-21,33
Sonderjyske,1803,7,8,6,10,28,29,-1,30
Randers FC,1803,8,6,6,12,24,39,-15,24
Silkeborg IF,1803,9,6,3,13,29,45,-16,21
Lyngby,1803,10,3,9,12,26,45,-19,18
AGF Aarhus,1803,11,4,6,12,17,40,-23,18
Brondby,1804,1,22,5,3,71,30,41,71
FC Midtjylla,1804,2,19,5,6,65,42,23,62
FC Nords,1804,3,14,8,8,76,52,24,50
Copenhagen,1804,4,13,6,11,56,41,15,45
AaB,1804,5,7,12,11,35,46,-11,33
AC Horsens,1804,6,7,12,11,34,52,-18,33
Sonderjyske,1804,7,8,6,10,28,29,-1,30
Randers FC,1804,8,5,7,12,23,39,-16,22
Silkeborg IF,1804,9,6,3,13,26,44,-18,21
Lyngby,1804,10,3,10,11,26,44,-18,19
AGF Aarhus,1804,11,4,6,12,16,37,-21,18
Brondby,1805,1,19,5,6,72,43,29,62
FC Midtjylla,1805,2,18,6,6,67,44,23,60
FC Nords,1805,3,14,7,9,71,51,20,49
Copenhagen,1805,4,14,4,12,57,47,10,46
AaB,1805,5,9,12,9,43,44,-1,39
AC Horsens,1805,6,9,12,9,44,51,-7,39
Sonderjyske,1805,7,8,6,10,28,29,-1,30
Randers FC,1805,8,6,6,12,25,40,-15,24
Silkeborg IF,1805,9,5,4,13,26,45,-19,19
AGF Aarhus,1805,10,4,7,11,17,37,-20,19
Lyngby,1805,11,3,9,12,27,46,-19,18
FC Midtjylla,1806,1,21,5,4,66,36,30,68
Brondby,1806,2,20,7,3,71,32,39,67
Copenhagen,1806,3,15,5,10,65,45,20,50
FC Nords,1806,4,13,7,10,69,52,17,46
AaB,1806,5,7,12,11,34,48,-14,33
Sonderjyske,1806,6,8,6,10,28,29,-1,30
AC Horsens,1806,7,5,14,11,31,49,-18,29
Randers FC,1806,8,6,6,12,24,39,-15,24
AGF Aarhus,1806,9,5,6,11,17,36,-19,21
Lyngby,1806,10,3,9,12,26,45,-19,18
Silkeborg IF,1806,11,5,3,14,25,45,-20,18
FC Midtjylla,1807,1,21,5,4,72,37,35,68
Brondby,1807,2,20,6,4,69,35,34,66
Copenhagen,1807,3,14,6,10,58,44,14,48
FC Nords,1807,4,13,8,9,71,51,20,47
AaB,1807,5,7,12,11,38,45,-7,33
AC Horsens,1807,6,6,13,11,33,55,-22,31
Sonderjyske,1807,7,8,6,10,28,29,-1,30
Lyngby,1807,8,4,9,11,28,44,-16,21
Randers FC,1807,9,5,6,13,23,41,-18,21
AGF Aarhus,1807,10,5,6,11,17,36,-19,21
Silkeborg IF,1807,11,5,3,14,25,45,-20,18
FC Midtjylla,1808,1,20,5,5,65,37,28,65
Brondby,1808,2,19,7,4,67,35,32,64
FC Nords,1808,3,14,7,9,73,50,23,49
Copenhagen,1808,4,13,7,10,56,42,14,46
AaB,1808,5,7,13,10,34,40,-6,34
AC Horsens,1808,6,7,13,10,35,52,-17,34
Sonderjyske,1808,7,8,6,10,28,29,-1,30
Lyngby,1808,8,4,9,11,28,45,-17,21
Randers FC,1808,9,5,6,13,24,41,-17,21
AGF Aarhus,1808,10,5,6,11,18,36,-18,21
Silkeborg IF,1808,11,5,3,14,25,46,-21,18
Brondby,1809,1,21,6,3,72,30,42,69
FC Midtjylla,1809,2,19,5,6,66,38,28,62
FC Nords,1809,3,14,7,9,73,56,17,49
Copenhagen,1809,4,14,5,11,54,43,11,47
AaB,1809,5,9,11,10,40,44,-4,38
Sonderjyske,1809,6,8,6,10,28,29,-1,30
AC Horsens,1809,7,6,12,12,35,55,-20,30
Randers FC,1809,8,5,7,12,24,40,-16,22
Silkeborg IF,1809,9,6,3,13,28,44,-16,21
Lyngby,1809,10,3,10,11,27,45,-18,19
AGF Aarhus,1809,11,4,6,12,16,39,-23,18
Brondby,1810,1,20,7,3,71,35,36,67
FC Midtjylla,1810,2,20,4,6,65,40,25,64
FC Nords,1810,3,15,7,8,73,47,26,52
Copenhagen,1810,4,12,6,12,57,50,7,42
AC Horsens,1810,5,8,13,9,38,49,-11,37
AaB,1810,6,6,13,11,33,42,-9,31
Sonderjyske,1810,7,8,6,10,28,29,-1,30
Randers FC,1810,8,5,7,12,24,40,-16,22
Silkeborg IF,1810,9,6,3,13,26,44,-18,21
Lyngby,1810,10,3,10,11,27,45,-18,19
AGF Aarhus,1810,11,4,6,12,16,37,-21,18
Brondby,1811,1,21,6,3,72,33,39,69
FC Midtjylla,1811,2,18,6,6,65,40,25,60
FC Nords,1811,3,15,8,7,77,51,26,53
Copenhagen,1811,4,14,7,9,62,47,15,49
AaB,1811,5,6,13,11,35,47,-12,31
Sonderjyske,1811,6,8,6,10,28,29,-1,30
AC Horsens,1811,7,6,12,12,36,55,-19,30
Randers FC,1811,8,6,6,12,26,39,-13,24
AGF Aarhus,1811,9,5,6,11,19,37,-18,21
Lyngby,1811,10,3,9,12,26,47,-21,18
Silkeborg IF,1811,10,5,3,14,26,47,-21,18
FC Midtjylla,1812,1,20,4,6,67,40,27,64
Brondby,1812,2,19,5,6,66,35,31,62
FC Nords,1812,3,15,7,8,75,52,23,52
Copenhagen,1812,4,14,4,12,58,48,10,46
AaB,1812,5,10,12,8,38,37,1,42
Sonderjyske,1812,6,8,6,10,28,29,-1,30
AC Horsens,1812,7,6,12,12,36,54,-18,30
Lyngby,1812,8,4,9,11,29,46,-17,21
Silkeborg IF,1812,9,6,3,13,27,44,-17,21
Randers FC,1812,10,5,6,13,25,42,-17,21
AGF Aarhus,1812,11,4,6,12,16,38,-22,18
Brondby,1813,1,21,5,4,67,33,34,68
FC Midtjylla,1813,2,19,4,7,66,42,24,61
FC Nords,1813,3,16,6,8,74,47,27,54
Copenhagen,1813,4,15,5,10,60,43,17,50
AaB,1813,5,7,12,11,40,45,-5,33
Sonderjyske,1813,6,8,6,10,28,29,-1,30
AC Horsens,1813,7,6,12,12,35,58,-23,30
Randers FC,1813,8,6,6,12,25,39,-14,24
Silkeborg IF,1813,9,6,3,13,27,44,-17,21
Lyngby,1813,10,3,9,12,26,46,-20,18
AGF Aarhus,1813,11,4,6,12,16,38,-22,18
FC Midtjylla,1814,1,21,4,5,70,40,30,67
Brondby,1814,2,20,6,4,68,33,35,66
FC Nords,1814,3,15,7,8,72,48,24,52
Copenhagen,1814,4,15,5,10,62,44,18,50
AaB,1814,5,7,12,11,36,47,-11,33
Sonderjyske,1814,6,8,6,10,28,29,-1,30
AC Horsens,1814,7,5,12,13,33,55,-22,27
Randers FC,1814,8,5,7,12,26,42,-16,22
Silkeborg IF,1814,9,6,3,13,28,45,-17,21
Lyngby,1814,10,3,10,11,29,47,-18,19
AGF Aarhus,1814,11,4,6,12,17,39,-22,18
FC Midtjylla,1815,1,21,4,5,70,40,30,67
Brondby,1815,2,19,5,6,69,37,32,62
FC Nords,1815,3,15,6,9,74,52,22,51
Copenhagen,1815,4,14,4,12,57,46,11,46
AC Horsens,1815,5,8,12,10,36,53,-17,36
AaB,1815,6,8,11,11,36,40,-4,35
Sonderjyske,1815,7,8,6,10,28,29,-1,30
Lyngby,1815,8,4,9,11,28,44,-16,21
Silkeborg IF,1815,9,6,3,13,26,44,-18,21
Randers FC,1815,10,5,6,13,23,41,-18,21
AGF Aarhus,1815,11,4,6,12,16,37,-21,18
Brondby,1816,1,22,5,3,69,30,39,71
FC Midtjylla,1816,2,19,5,6,67,41,26,62
FC Nords,1816,3,13,7,10,70,56,14,46
Copenhagen,1816,4,13,6,11,53,41,12,45
AaB,1816,5,8,12,10,40,43,-3,36
AC Horsens,1816,6,7,13,10,37,51,-14,34
Sonderjyske,1816,7,8,6,10,28,29,-1,30
Randers FC,1816,8,6,6,12,26,41,-15,24
AGF Aarhus,1816,9,5,6,11,19,37,-18,21
Lyngby,1816,10,3,9,12,28,47,-19,18
Silkeborg IF,1816,11,5,3,14,26,47,-21,18
Brondby,1817,1,21,6,3,71,32,39,69
FC Midtjylla,1817,2,20,5,5,71,40,31,65
FC Nords,1817,3,14,7,9,71,50,21,49
Copenhagen,1817,4,13,4,13,56,48,8,43
AaB,1817,5,8,12,10,38,46,-8,36
AC Horsens,1817,6,7,12,11,37,54,-17,33
Sonderjyske,1817,7,8,6,10,28,29,-1,30
Lyngby,1817,8,4,9,11,28,44,-16,21
Randers FC,1817,9,5,6,13,23,41,-18,21
Silkeborg IF,1817,10,5,4,13,27,46,-19,19
AGF Aarhus,1817,11,4,7,11,18,38,-20,19
FC Midtjylla,1818,1,20,4,6,64,38,26,64
Brondby,1818,2,19,6,5,72,37,35,63
FC Nords,1818,3,16,6,8,74,50,24,54
Copenhagen,1818,4,14,4,12,60,46,14,46
AaB,1818,5,8,12,10,36,40,-4,36
AC Horsens,1818,6,7,12,11,33,54,-21,33
Sonderjyske,1818,7,8,6,10,28,29,-1,30
Randers FC,1818,8,5,7,12,24,40,-16,22
AGF Aarhus,1818,9,5,6,11,19,37,-18,21
Lyngby,1818,10,3,10,11,27,45,-18,19
Silkeborg IF,1818,11,5,3,14,26,47,-21,18
FC Midtjylla,1819,1,20,5,5,74,41,33,65
Brondby,1819,2,19,7,4,69,35,34,64
FC Nords,1819,3,13,9,8,70,52,18,48
Copenhagen,1819,4,13,5,12,58,51,7,44
AC Horsens,1819,5,7,15,8,34,46,-12,36
AaB,1819,6,7,13,10,35,41,-6,34
Sonderjyske,1819,7,8,6,10,28,29,-1,30
Randers FC,1819,8,6,6,12,27,40,-13,24
Silkeborg IF,1819,9,6,3,13,26,44,-18,21
Lyngby,1819,10,3,9,12,27,48,-21,18
AGF Aarhus,1819,11,4,6,12,16,37,-21,18
Brondby,1820,1,22,5,3,75,36,39,71
FC Midtjylla,1820,2,19,5,6,62,37,25,62
FC Nords,1820,3,14,6,10,77,53,24,48
Copenhagen,1820,4,14,5,11,57,48,9,47
AaB,1820,5,7,13,10,37,43,-6,34
AC Horsens,1820,6,7,12,11,39,56,-17,33
Sonderjyske,1820,7,8,6,10,28,29,-1,30
Randers FC,1820,8,5,7,12,23,39,-16,22
Lyngby,1820,9,3,10,11,26,44,-18,19
Silkeborg IF,1820,10,5,4,13,25,44,-19,19
AGF Aarhus,1820,11,4,7,11,16,36,-20,19
Brondby,1821,1,21,5,4,72,34,38,68
FC Midtjylla,1821,2,21,4,5,70,39,31,67
Copenhagen,1821,3,15,5,10,61,43,18,50
FC Nords,1821,4,13,8,9,69,52,17,47
AaB,1821,5,7,12,11,33,45,-12,33
Sonderjyske,1821,6,8,6,10,28,29,-1,30
AC Horsens,1821,7,6,12,12,36,54,-18,30
Randers FC,1821,8,5,7,12,23,39,-16,22
Silkeborg IF,1821,9,6,3,13,28,44,-16,21
Lyngby,1821,10,3,10,11,26,44,-18,19
AGF Aarhus,1821,11,4,6,12,16,39,-23,18
Brondby,1822,1,21,6,3,73,34,39,69
FC Midtjylla,1822,2,19,5,6,67,45,22,62
Copenhagen,1822,3,16,5,9,61,41,20,53
FC Nords,1822,4,13,7,10,71,51,20,46
AaB,1822,5,8,11,11,37,43,-6,35
Sonderjyske,1822,6,8,6,10,28,29,-1,30
AC Horsens,1822,7,5,14,11,33,54,-21,29
Lyngby,1822,8,4,9,11,27,44,-17,21
Randers FC,1822,9,5,6,13,23,40,-17,21
Silkeborg IF,1822,10,5,4,13,25,44,-19,19
AGF Aarhus,1822,11,4,7,11,16,36,-20,19
Brondby,1823,1,22,6,2,74,33,41,72
FC Midtjylla,1823,2,19,4,7,65,40,25,61
Copenhagen,1823,3,14,7,9,63,47,16,49
FC Nords,1823,4,14,6,10,74,55,19,48
AaB,1823,5,8,12,10,37,45,-8,36
Sonderjyske,1823,6,8,6,10,28,29,-1,30
AC Horsens,1823,7,5,13,12,35,54,-19,28
Randers FC,1823,8,5,7,12,24,40,-16,22
AGF Aarhus,1823,9,5,6,11,18,36,-18,21
Lyngby,1823,10,3,10,11,27,45,-18,19
Silkeborg IF,1823,11,5,3,14,25,46,-21,18
Brondby,1824,1,21,5,4,75,35,40,68
FC Midtjylla,1824,2,20,4,6,63,42,21,64
Copenhagen,1824,3,15,5,10,67,43,24,50
FC Nords,1824,4,13,8,9,69,52,17,47
AaB,1824,5,7,13,10,35,41,-6,34
AC Horsens,1824,6,6,13,11,37,59,-22,31
Sonderjyske,1824,7,8,6,10,28,29,-1,30
Lyngby,1824,8,4,9,11,30,45,-15,21
Silkeborg IF,1824,9,6,3,13,26,44,-18,21
Randers FC,1824,10,5,6,13,24,43,-19,21
AGF Aarhus,1824,11,4,6,12,16,37,-21,18
Brondby,1825,1,20,6,4,73,35,38,66
FC Midtjylla,1825,2,19,4,7,64,45,19,61
Copenhagen,1825,3,16,5,9,61,41,20,53
FC Nords,1825,4,15,6,9,75,52,23,51
AC Horsens,1825,5,7,12,11,37,54,-17,33
AaB,1825,6,7,11,12,35,44,-9,32
Sonderjyske,1825,7,8,6,10,28,29,-1,30
Randers FC,1825,8,5,7,12,23,39,-16,22
Silkeborg IF,1825,9,6,3,13,26,44,-18,21
Lyngby,1825,10,3,10,11,26,44,-18,19
AGF Aarhus,1825,11,4,6,12,16,37,-21,18
Brondby,1826,1,21,6,3,73,32,41,69
FC Midtjylla,1826,2,18,7,5,64,41,23,61
FC Nords,1826,3,14,7,9,73,51,22,49
Copenhagen,1826,4,13,5,12,54,44,10,44
AC Horsens,1826,5,8,13,9,37,50,-13,37
AaB,1826,6,6,14,10,36,45,-9,32
Sonderjyske,1826,7,8,6,10,28,29,-1,30
Randers FC,1826,8,6,6,12,26,41,-15,24
Silkeborg IF,1826,9,6,3,13,27,45,-18,21
Lyngby,1826,10,3,9,12,28,47,-19,18
AGF Aarhus,1826,11,4,6,12,17,38,-21,18
FC Midtjylla,1827,1,21,4,5,65,38,27,67
Brondby,1827,2,20,6,4,68,35,33,66
FC Nords,1827,3,13,7,10,74,52,22,46
Copenhagen,1827,4,14,4,12,55,44,11,46
AC Horsens,1827,5,8,13,9,33,46,-13,37
AaB,1827,6,7,12,11,38,44,-6,33
Sonderjyske,1827,7,8,6,10,28,29,-1,30
Randers FC,1827,8,6,6,12,26,41,-15,24
Silkeborg IF,1827,9,6,3,13,26,44,-18,21
Lyngby,1827,10,3,9,12,28,47,-19,18
AGF Aarhus,1827,11,4,6,12,16,37,-21,18
FC Midtjylla,1828,1,21,5,4,66,35,31,68
Brondby,1828,2,20,7,3,69,30,39,67
FC Nords,1828,3,13,8,9,68,49,19,47
Copenhagen,1828,4,12,7,11,52,41,11,43
AaB,1828,5,7,13,10,35,43,-8,34
AC Horsens,1828,6,6,14,10,32,50,-18,32
Sonderjyske,1828,7,8,6,10,28,29,-1,30
Randers FC,1828,8,6,6,12,24,39,-15,24
AGF Aarhus,1828,9,5,6,11,19,38,-19,21
Lyngby,1828,10,3,9,12,26,45,-19,18
Silkeborg IF,1828,11,5,3,14,27,47,-20,18
Brondby,1829,1,22,5,3,72,30,42,71
FC Midtjylla,1829,2,17,7,6,64,42,22,58
FC Nords,1829,3,16,6,8,75,52,23,54
Copenhagen,1829,4,12,6,12,51,44,7,42
AC Horsens,1829,5,7,14,9,37,49,-12,35
AaB,1829,6,7,12,11,39,47,-8,33
Sonderjyske,1829,7,8,6,10,28,29,-1,30
Lyngby,1829,8,4,9,11,28,44,-16,21
Silkeborg IF,1829,9,6,3,13,28,45,-17,21
Randers FC,1829,10,5,6,13,23,41,-18,21
AGF Aarhus,1829,11,4,6,12,17,39,-22,18
Brondby,1830,1,20,7,3,66,30,36,67
FC Midtjylla,1830,2,20,6,4,64,36,28,66
FC Nords,1830,3,14,7,9,73,53,20,49
Copenhagen,1830,4,13,5,12,55,44,11,44
AaB,1830,5,9,12,9,39,40,-1,39
Sonderjyske,1830,6,8,6,10,28,29,-1,30
AC Horsens,1830,7,5,13,12,31,51,-20,28
Lyngby,1830,8,4,9,11,30,45,-15,21
Randers FC,1830,9,5,6,13,24,43,-19,21
Silkeborg IF,1830,10,5,4,13,27,46,-19,19
AGF Aarhus,1830,11,4,7,11,18,38,-20,19
Brondby,1831,1,21,5,4,69,37,32,68
FC Midtjylla,1831,2,19,5,6,60,37,23,62
FC Nords,1831,3,16,6,8,79,50,29,54
Copenhagen,1831,4,16,4,10,64,41,23,52
Sonderjyske,1831,5,8,6,10,28,29,-1,30
AaB,1831,6,6,12,12,35,45,-10,30
AC Horsens,1831,7,6,12,12,34,57,-23,30
Lyngby,1831,8,4,9,11,30,44,-14,21
Silkeborg IF,1831,9,6,3,13,30,46,-16,21
Randers FC,1831,10,5,6,13,23,43,-20,21
AGF Aarhus,1831,11,4,6,12,18,41,-23,18
Brondby,1832,1,23,5,2,76,28,48,74
FC Midtjylla,1832,2,18,5,7,61,43,18,59
FC Nords,1832,3,14,6,10,72,54,18,48
Copenhagen,1832,4,13,5,12,55,44,11,44
AC Horsens,1832,5,9,12,9,43,52,-9,39
AaB,1832,6,6,13,11,33,45,-12,31
Sonderjyske,1832,7,8,6,10,28,29,-1,30
Randers FC,1832,8,6,6,12,28,41,-13,24
Silkeborg IF,1832,9,6,3,13,27,45,-18,21
Lyngby,1832,10,3,9,12,28,49,-21,18
AGF Aarhus,1832,11,4,6,12,17,38,-21,18
Brondby,1833,1,20,5,5,69,36,33,65
FC Midtjylla,1833,2,18,6,6,61,40,21,60
Copenhagen,1833,3,16,4,10,62,44,18,52
FC Nords,1833,4,14,7,9,73,50,23,49
AaB,1833,5,7,13,10,39,45,-6,34
AC Horsens,1833,6,7,13,10,33,48,-15,34
Sonderjyske,1833,7,8,6,10,28,29,-1,30
Silkeborg IF,1833,8,6,3,13,29,45,-16,21
Lyngby,1833,9,4,9,11,27,44,-17,21
Randers FC,1833,10,5,6,13,23,40,-17,21
AGF Aarhus,1833,11,4,6,12,17,40,-23,18
FC Midtjylla,1834,1,22,4,4,69,36,33,70
Brondby,1834,2,21,6,3,69,30,39,69
FC Nords,1834,3,14,6,10,71,52,19,48
Copenhagen,1834,4,14,5,11,57,43,14,47
AaB,1834,5,7,12,11,35,42,-7,33
Sonderjyske,1834,6,8,6,10,28,29,-1,30
AC Horsens,1834,7,5,13,12,30,54,-24,28
Randers FC,1834,8,5,7,12,25,41,-16,22
Silkeborg IF,1834,9,6,3,13,27,45,-18,21
Lyngby,1834,10,3,10,11,28,46,-18,19
AGF Aarhus,1834,11,4,6,12,17,38,-21,18
FC Midtjylla,1835,1,21,4,5,70,38,32,67
Brondby,1835,2,20,5,5,70,33,37,65
FC Nords,1835,3,15,6,9,71,52,19,51
Copenhagen,1835,4,15,4,11,59,48,11,49
AaB,1835,5,8,11,11,34,42,-8,35
Sonderjyske,1835,6,8,6,10,28,29,-1,30
AC Horsens,1835,7,6,12,12,35,52,-17,30
Randers FC,1835,8,6,6,12,25,39,-14,24
Silkeborg IF,1835,9,5,4,13,25,44,-19,19
AGF Aarhus,1835,10,4,7,11,16,36,-20,19
Lyngby,1835,11,3,9,12,26,46,-20,18
Brondby,1836,1,21,5,4,72,37,35,68
FC Midtjylla,1836,2,18,6,6,63,40,23,60
FC Nords,1836,3,14,9,7,74,46,28,51
Copenhagen,1836,4,15,6,9,60,41,19,51
AaB,1836,5,7,12,11,34,44,-10,33
Sonderjyske,1836,6,8,6,10,28,29,-1,30
AC Horsens,1836,7,5,14,11,32,53,-21,29
Lyngby,1836,8,4,9,11,31,44,-13,21
Silkeborg IF,1836,9,6,3,13,28,45,-17,21
Randers FC,1836,10,5,6,13,23,44,-21,21
AGF Aarhus,1836,11,4,6,12,17,39,-22,18
Brondby,1837,1,20,7,3,70,34,36,67
FC Midtjylla,1837,2,19,5,6,66,40,26,62
FC Nords,1837,3,13,7,10,72,52,20,46
Copenhagen,1837,4,14,4,12,57,48,9,46
AC Horsens,1837,5,8,14,8,40,50,-10,38
AaB,1837,6,7,13,10,39,46,-7,34
Sonderjyske,1837,7,8,6,10,28,29,-1,30
Randers FC,1837,8,6,6,12,26,39,-13,24
Silkeborg IF,1837,9,6,3,13,28,45,-17,21
Lyngby,1837,10,3,9,12,26,47,-21,18
AGF Aarhus,1837,11,4,6,12,17,39,-22,18
Brondby,1838,1,20,8,2,69,30,39,68
FC Midtjylla,1838,2,19,6,5,64,37,27,63
FC Nords,1838,3,13,9,8,75,53,22,48
Copenhagen,1838,4,13,7,10,57,46,11,46
AaB,1838,5,7,13,10,37,44,-7,34
AC Horsens,1838,6,6,13,11,35,53,-18,31
Sonderjyske,1838,7,8,6,10,28,29,-1,30
Randers FC,1838,8,5,7,12,24,40,-16,22
AGF Aarhus,1838,9,5,6,11,20,37,-17,21
Lyngby,1838,10,3,10,11,27,45,-18,19
Silkeborg IF,1838,11,5,3,14,26,48,-22,18
Brondby,1839,1,20,7,3,70,36,34,67
FC Midtjylla,1839,2,19,6,5,66,39,27,63
FC Nords,1839,3,15,8,7,80,53,27,53
Copenhagen,1839,4,14,5,11,61,46,15,47
AaB,1839,5,7,11,12,38,47,-9,32
AC Horsens,1839,6,6,13,11,34,54,-20,31
Sonderjyske,1839,7,8,6,10,28,29,-1,30
Randers FC,1839,8,5,7,12,25,41,-16,22
Lyngby,1839,9,3,10,11,28,46,-18,19
Silkeborg IF,1839,10,5,4,13,27,46,-19,19
AGF Aarhus,1839,11,4,7,11,18,38,-20,19
Brondby,1840,1,21,6,3,71,34,37,69
FC Midtjylla,1840,2,19,5,6,62,38,24,62
FC Nords,1840,3,14,7,9,71,50,21,49
Copenhagen,1840,4,14,5,11,54,40,14,47
AaB,1840,5,7,14,9,36,40,-4,35
AC Horsens,1840,6,6,13,11,32,50,-18,31
Sonderjyske,1840,7,8,6,10,28,29,-1,30
Randers FC,1840,8,5,7,12,25,41,-16,22
Silkeborg IF,1840,9,6,3,13,27,45,-18,21
Lyngby,1840,10,3,10,11,28,46,-18,19
AGF Aarhus,1840,11,4,6,12,17,38,-21,18
Brondby,1841,1,21,7,2,74,30,44,70
FC Midtjylla,1841,2,18,5,7,61,39,22,59
FC Nords,1841,3,14,7,9,73,55,18,49
Copenhagen,1841,4,14,5,11,57,44,13,47
AaB,1841,5,8,13,9,38,40,-2,37
AC Horsens,1841,6,6,13,11,36,57,-21,31
Sonderjyske,1841,7,8,6,10,28,29,-1,30
Lyngby,1841,8,4,9,11,29,45,-16,21
Randers FC,1841,9,5,6,13,24,42,-18,21
Silkeborg IF,1841,10,5,4,13,27,46,-19,19
AGF Aarhus,1841,11,4,7,11,18,38,-20,19
Brondby,1842,1,21,5,4,71,34,37,68
FC Midtjylla,1842,2,18,6,6,62,44,18,60
Copenhagen,1842,3,16,4,10,59,41,18,52
FC Nords,1842,4,13,7,10,69,52,17,46
AaB,1842,5,8,12,10,39,39,0,36
AC Horsens,1842,6,6,14,10,33,49,-16,32
Sonderjyske,1842,7,8,6,10,28,29,-1,30
Lyngby,1842,8,4,9,11,28,45,-17,21
Randers FC,1842,9,5,6,13,24,41,-17,21
Silkeborg IF,1842,10,5,4,13,25,44,-19,19
AGF Aarhus,1842,11,4,7,11,16,36,-20,19
Brondby,1843,1,19,7,4,68,34,34,64
FC Midtjylla,1843,2,19,6,5,65,38,27,63
FC Nords,1843,3,14,7,9,74,52,22,49
Copenhagen,1843,4,14,6,10,54,41,13,48
AaB,1843,5,10,12,8,41,39,2,42
Sonderjyske,1843,6,8,6,10,28,29,-1,30
AC Horsens,1843,7,5,12,13,31,55,-24,27
Randers FC,1843,8,5,7,12,23,39,-16,22
Silkeborg IF,1843,9,6,3,13,27,44,-17,21
Lyngby,1843,10,3,10,11,26,44,-18,19
AGF Aarhus,1843,11,4,6,12,16,38,-22,18
Brondby,1844,1,21,6,3,72,32,40,69
FC Midtjylla,1844,2,19,5,6,65,41,24,62
FC Nords,1844,3,14,7,9,76,53,23,49
Copenhagen,1844,4,15,4,11,61,47,14,49
AaB,1844,5,8,12,10,39,45,-6,36
Sonderjyske,1844,6,8,6,10,28,29,-1,30
AC Horsens,1844,7,6,12,12,33,54,-21,30
Randers FC,1844,8,5,7,12,24,40,-16,22
Silkeborg IF,1844,9,6,3,13,27,44,-17,21
Lyngby,1844,10,3,10,11,27,45,-18,19
AGF Aarhus,1844,11,4,6,12,16,38,-22,18
FC Midtjylla,1845,1,21,5,4,70,36,34,68
Brondby,1845,2,20,6,4,71,34,37,66
Copenhagen,1845,3,15,5,10,56,43,13,50
FC Nords,1845,4,13,8,9,69,52,17,47
AaB,1845,5,6,13,11,33,41,-8,31
Sonderjyske,1845,6,8,6,10,28,29,-1,30
AC Horsens,1845,7,5,15,10,32,51,-19,30
Lyngby,1845,8,4,9,11,29,45,-16,21
Silkeborg IF,1845,9,6,3,13,27,45,-18,21
Randers FC,1845,10,5,6,13,24,42,-18,21
AGF Aarhus,1845,11,4,6,12,17,38,-21,18
Brondby,1846,1,19,7,4,70,35,35,64
FC Midtjylla,1846,2,18,5,7,67,43,24,59
FC Nords,1846,3,16,6,8,83,54,29,54
Copenhagen,1846,4,14,4,12,59,51,8,46
AaB,1846,5,9,11,10,40,44,-4,38
AC Horsens,1846,6,7,13,10,38,56,-18,34
Sonderjyske,1846,7,8,6,10,28,29,-1,30
Lyngby,1846,8,4,9,11,28,44,-16,21
Randers FC,1846,9,5,6,13,23,41,-18,21
AGF Aarhus,1846,10,5,6,11,19,37,-18,21
Silkeborg IF,1846,11,5,3,14,26,47,-21,18
Brondby,1847,1,19,8,3,67,31,36,65
FC Midtjylla,1847,2,20,5,5,67,38,29,65
FC Nords,1847,3,15,6,9,73,47,26,51
Copenhagen,1847,4,14,6,10,56,42,14,48
AC Horsens,1847,5,6,14,10,34,55,-21,32
AaB,1847,6,6,13,11,36,46,-10,31
Sonderjyske,1847,7,8,6,10,28,29,-1,30
Lyngby,1847,8,4,9,11,30,45,-15,21
AGF Aarhus,1847,9,5,6,11,18,36,-18,21
Randers FC,1847,10,5,6,13,24,43,-19,21
Silkeborg IF,1847,11,5,3,14,25,46,-21,18
Brondby,1848,1,20,8,2,67,30,37,68
FC Midtjylla,1848,2,19,5,6,64,40,24,62
FC Nords,1848,3,15,8,7,73,48,25,53
Copenhagen,1848,4,13,5,12,55,45,10,44
AaB,1848,5,7,13,10,35,42,-7,34
AC Horsens,1848,6,6,13,11,34,49,-15,31
Sonderjyske,1848,7,8,6,10,28,29,-1,30
Randers FC,1848,8,6,6,12,25,40,-15,24
Silkeborg IF,1848,9,5,4,13,25,44,-19,19
AGF Aarhus,1848,10,4,7,11,16,36,-20,19
Lyngby,1848,11,3,9,12,27,46,-19,18
Brondby,1849,1,21,6,3,69,32,37,69
FC Midtjylla,1849,2,20,5,5,66,38,28,65
FC Nords,1849,3,15,6,9,74,52,22,51
Copenhagen,1849,4,12,7,11,56,45,11,43
AaB,1849,5,8,11,11,36,42,-6,35
AC Horsens,1849,6,6,13,11,33,51,-18,31
Sonderjyske,1849,7,8,6,10,28,29,-1,30
Randers FC,1849,8,5,7,12,26,42,-16,22
Silkeborg IF,1849,9,6,3,13,27,44,-17,21
Lyngby,1849,10,3,10,11,29,47,-18,19
AGF Aarhus,1849,11,4,6,12,16,38,-22,18
Brondby,1850,1,20,7,3,68,32,36,67
FC Midtjylla,1850,2,19,6,5,66,39,27,63
FC Nords,1850,3,14,8,8,74,52,22,50
Copenhagen,1850,4,13,5,12,58,49,9,44
AaB,1850,5,8,12,10,35,38,-3,36
AC Horsens,1850,6,7,12,11,36,53,-17,33
Sonderjyske,1850,7,8,6,10,28,29,-1,30
Randers FC,1850,8,5,7,12,24,40,-16,22
Silkeborg IF,1850,9,6,3,13,27,45,-18,21
Lyngby,1850,10,3,10,11,27,45,-18,19
AGF Aarhus,1850,11,4,6,12,17,38,-21,18
Brondby,1851,1,20,7,3,68,31,37,67
FC Midtjylla,1851,2,19,5,6,62,40,22,62
FC Nords,1851,3,16,7,7,75,46,29,55
Copenhagen,1851,4,13,7,10,57,45,12,46
AC Horsens,1851,5,7,12,11,37,53,-16,33
Sonderjyske,1851,6,8,6,10,28,29,-1,30
AaB,1851,7,6,12,12,34,44,-10,30
Randers FC,1851,8,5,7,12,24,40,-16,22
Silkeborg IF,1851,9,6,3,13,26,44,-18,21
Lyngby,1851,10,3,10,11,27,45,-18,19
AGF Aarhus,1851,11,4,6,12,16,37,-21,18
FC Midtjylla,1852,1,21,4,5,69,35,34,67
Brondby,1852,2,20,5,5,72,35,37,65
FC Nords,1852,3,15,6,9,72,52,20,51
Copenhagen,1852,4,15,5,10,57,43,14,50
AaB,1852,5,7,11,12,37,48,-11,32
AC Horsens,1852,6,6,13,11,35,55,-20,31
Sonderjyske,1852,7,8,6,10,28,29,-1,30
Randers FC,1852,8,6,6,12,25,40,-15,24
Silkeborg IF,1852,9,6,3,13,28,46,-18,21
Lyngby,1852,10,3,9,12,27,46,-19,18
AGF Aarhus,1852,11,4,6,12,18,39,-21,18
Brondby,1853,1,19,8,3,67,32,35,65
FC Midtjylla,1853,2,20,5,5,66,39,27,65
FC Nords,1853,3,14,8,8,78,54,24,50
Copenhagen,1853,4,13,8,9,59,45,14,47
AaB,1853,5,8,11,11,36,41,-5,35
Sonderjyske,1853,6,8,6,10,28,29,-1,30
AC Horsens,1853,7,5,14,11,33,54,-21,29
Randers FC,1853,8,5,7,12,24,40,-16,22
AGF Aarhus,1853,9,5,6,11,18,36,-18,21
Lyngby,1853,10,3,10,11,27,45,-18,19
Silkeborg IF,1853,11,5,3,14,25,46,-21,18
Brondby,1854,1,21,6,3,76,35,41,69
FC Midtjylla,1854,2,20,4,6,68,40,28,64
Copenhagen,1854,3,15,5,10,61,44,17,50
FC Nords,1854,4,12,8,10,73,59,14,44
AC Horsens,1854,5,7,13,10,35,54,-19,34
AaB,1854,6,7,12,11,39,46,-7,33
Sonderjyske,1854,7,8,6,10,28,29,-1,30
Lyngby,1854,8,4,9,11,30,46,-16,21
Randers FC,1854,9,5,6,13,25,43,-18,21
AGF Aarhus,1854,10,5,6,11,18,36,-18,21
Silkeborg IF,1854,11,5,3,14,25,46,-21,18
Brondby,1855,1,21,6,3,67,30,37,69
FC Midtjylla,1855,2,18,5,7,64,41,23,59
Copenhagen,1855,3,16,5,9,61,41,20,53
FC Nords,1855,4,14,7,9,67,49,18,49
AC Horsens,1855,5,7,14,9,36,50,-14,35
Sonderjyske,1855,6,8,6,10,28,29,-1,30
AaB,1855,7,6,11,13,34,44,-10,29
Lyngby,1855,8,4,9,11,28,45,-17,21
Randers FC,1855,9,5,6,13,24,41,-17,21
Silkeborg IF,1855,10,5,4,13,26,45,-19,19
AGF Aarhus,1855,11,4,7,11,17,37,-20,19
FC Midtjylla,1856,1,22,4,4,72,36,36,70
Brondby,1856,2,21,5,4,69,31,38,68
FC Nords,1856,3,13,6,11,69,55,14,45
Copenhagen,1856,4,12,5,13,51,48,3,41
AC Horsens,1856,5,8,13,9,38,52,-14,37
AaB,1856,6,7,13,10,38,41,-3,34
Sonderjyske,1856,7,8,6,10,28,29,-1,30
Randers FC,1856,8,5,7,12,24,40,-16,22
Silkeborg IF,1856,9,6,3,13,26,44,-18,21
Lyngby,1856,10,3,10,11,27,45,-18,19
AGF Aarhus,1856,11,4,6,12,16,37,-21,18
Brondby,1857,1,21,6,3,70,33,37,69
FC Midtjylla,1857,2,19,5,6,66,40,26,62
FC Nords,1857,3,14,7,9,73,51,22,49
Copenhagen,1857,4,14,4,12,57,48,9,46
AaB,1857,5,8,13,9,38,41,-3,37
AC Horsens,1857,6,6,13,11,37,54,-17,31
Sonderjyske,1857,7,8,6,10,28,29,-1,30
Lyngby,1857,8,4,9,11,29,46,-17,21
Randers FC,1857,9,5,6,13,25,42,-17,21
AGF Aarhus,1857,10,5,6,11,18,36,-18,21
Silkeborg IF,1857,11,5,3,14,25,46,-21,18
Brondby,1858,1,20,7,3,69,31,38,67
FC Midtjylla,1858,2,18,8,4,64,38,26,62
Copenhagen,1858,3,14,6,10,57,42,15,48
FC Nords,1858,4,13,8,9,76,54,22,47
AaB,1858,5,8,13,9,38,41,-3,37
Sonderjyske,1858,6,8,6,10,28,29,-1,30
AC Horsens,1858,7,6,12,12,33,57,-24,30
Randers FC,1858,8,5,7,12,24,40,-16,22
Lyngby,1858,9,3,10,11,27,45,-18,19
Silkeborg IF,1858,10,5,4,13,26,45,-19,19
AGF Aarhus,1858,11,4,7,11,17,37,-20,19
Brondby,1859,1,23,5,2,77,33,44,74
FC Midtjylla,1859,2,21,4,5,64,36,28,67
FC Nords,1859,3,14,7,9,71,51,20,49
Copenhagen,1859,4,13,5,12,57,48,9,44
AaB,1859,5,7,11,12,39,47,-8,32
Sonderjyske,1859,6,8,6,10,28,29,-1,30
AC Horsens,1859,7,6,12,12,36,55,-19,30
Lyngby,1859,8,4,9,11,28,44,-16,21
Silkeborg IF,1859,9,6,3,13,27,45,-18,21
Randers FC,1859,10,5,6,13,23,41,-18,21
AGF Aarhus,1859,11,4,6,12,17,38,-21,18
FC Midtjylla,1860,1,20,5,5,71,39,32,65
Brondby,1860,2,19,7,4,67,35,32,64
FC Nords,1860,3,13,8,9,72,52,20,47
Copenhagen,1860,4,14,5,11,57,46,11,47
AC Horsens,1860,5,8,12,10,36,51,-15,36
AaB,1860,6,7,13,10,38,44,-6,34
Sonderjyske,1860,7,8,6,10,28,29,-1,30
Lyngby,1860,8,4,9,11,29,46,-17,21
Silkeborg IF,1860,9,6,3,13,27,44,-17,21
Randers FC,1860,10,5,6,13,25,42,-17,21
AGF Aarhus,1860,11,4,6,12,16,38,-22,18
Brondby,1861,1,22,6,2,76,30,46,72
FC Midtjylla,1861,2,20,5,5,70,38,32,65
FC Nords,1861,3,15,7,8,72,49,23,52
Copenhagen,1861,4,13,6,11,55,46,9,45
AC Horsens,1861,5,6,13,11,33,58,-25,31
Sonderjyske,1861,6,8,6,10,28,29,-1,30
AaB,1861,7,6,11,13,38,49,-11,29
Randers FC,1861,8,6,6,12,25,39,-14,24
Silkeborg IF,1861,9,6,3,13,28,46,-18,21
Lyngby,1861,10,3,9,12,26,46,-20,18
AGF Aarhus,1861,11,4,6,12,18,39,-21,18
Brondby,1862,1,21,5,4,73,32,41,68
FC Midtjylla,1862,2,20,4,6,67,38,29,64
Copenhagen,1862,3,15,5,10,56,41,15,50
FC Nords,1862,4,14,6,10,73,55,18,48
AaB,1862,5,7,12,11,36,48,-12,33
AC Horsens,1862,6,7,12,11,35,52,-17,33
Sonderjyske,1862,7,8,6,10,28,29,-1,30
Lyngby,1862,8,4,9,11,28,45,-17,21
Randers FC,1862,9,5,6,13,24,41,-17,21
AGF Aarhus,1862,10,5,6,11,19,37,-18,21
Silkeborg IF,1862,11,5,3,14,26,47,-21,18
Brondby,1863,1,22,5,3,77,34,43,71
FC Midtjylla,1863,2,20,5,5,63,40,23,65
FC Nords,1863,3,14,6,10,76,53,23,48
Copenhagen,1863,4,14,5,11,61,47,14,47
AaB,1863,5,7,12,11,37,45,-8,33
AC Horsens,1863,6,6,13,11,35,56,-21,31
Sonderjyske,1863,7,8,6,10,28,29,-1,30
Lyngby,1863,8,4,9,11,28,44,-16,21
Silkeborg IF,1863,9,6,3,13,27,44,-17,21
Randers FC,1863,10,5,6,13,23,41,-18,21
AGF Aarhus,1863,11,4,6,12,16,38,-22,18
Brondby,1864,1,23,5,2,70,30,40,74
FC Midtjylla,1864,2,17,6,7,60,41,19,57
Copenhagen,1864,3,15,5,10,61,44,17,50
FC Nords,1864,4,13,6,11,67,50,17,45
AaB,1864,5,7,14,9,37,41,-4,35
AC Horsens,1864,6,6,14,10,34,49,-15,32
Sonderjyske,1864,7,8,6,10,28,29,-1,30
Lyngby,1864,8,4,9,11,28,44,-16,21
Silkeborg IF,1864,9,6,3,13,27,44,-17,21
Randers FC,1864,10,5,6,13,23,41,-18,21
AGF Aarhus,1864,11,4,6,12,16,38,-22,18
Brondby,1865,1,19,6,5,68,34,34,63
FC Midtjylla,1865,2,19,4,7,64,43,21,61
Copenhagen,1865,3,16,5,9,59,42,17,53
FC Nords,1865,4,15,7,8,74,51,23,52
AaB,1865,5,7,12,11,42,46,-4,33
AC Horsens,1865,6,7,12,11,35,52,-17,33
Sonderjyske,1865,7,8,6,10,28,29,-1,30
Randers FC,1865,8,6,6,12,26,40,-14,24
Silkeborg IF,1865,9,6,3,13,27,45,-18,21
Lyngby,1865,10,3,9,12,27,47,-20,18
AGF Aarhus,1865,11,4,6,12,17,38,-21,18
Brondby,1866,1,20,5,5,70,35,35,65
FC Midtjylla,1866,2,19,6,5,65,38,27,63
FC Nords,1866,3,15,7,8,75,52,23,52
Copenhagen,1866,4,14,5,11,60,48,12,47
AC Horsens,1866,5,7,13,10,37,49,-12,34
AaB,1866,6,6,14,10,36,47,-11,32
Sonderjyske,1866,7,8,6,10,28,29,-1,30
Lyngby,1866,8,4,9,11,27,44,-17,21
Randers FC,1866,9,5,6,13,23,40,-17,21
Silkeborg IF,1866,10,6,3,13,26,44,-18,21
AGF Aarhus,1866,11,4,6,12,16,37,-21,18
Brondby,1867,1,19,8,3,67,31,36,65
FC Midtjylla,1867,2,19,5,6,61,36,25,62
FC Nords,1867,3,16,6,8,78,51,27,54
Copenhagen,1867,4,13,5,12,56,45,11,44
AaB,1867,5,8,12,10,40,46,-6,36
AC Horsens,1867,6,6,14,10,32,51,-19,32
Sonderjyske,1867,7,8,6,10,28,29,-1,30
Randers FC,1867,8,6,6,12,25,39,-14,24
Silkeborg IF,1867,9,6,3,13,28,46,-18,21
Lyngby,1867,10,3,9,12,26,46,-20,18
AGF Aarhus,1867,11,4,6,12,18,39,-21,18
Brondby,1868,1,20,8,2,72,33,39,68
FC Midtjylla,1868,2,19,5,6,65,39,26,62
FC Nords,1868,3,15,8,7,75,47,28,53
Copenhagen,1868,4,15,5,10,60,42,18,50
AaB,1868,5,6,13,11,34,48,-14,31
Sonderjyske,1868,6,8,6,10,28,29,-1,30
AC Horsens,1868,7,5,13,12,31,54,-23,28
Lyngby,1868,8,4,9,11,29,44,-15,21
Silkeborg IF,1868,9,6,3,13,27,45,-18,21
Randers FC,1868,10,5,6,13,23,42,-19,21
AGF Aarhus,1868,11,4,6,12,17,38,-21,18
Brondby,1869,1,21,7,2,73,32,41,70
FC Midtjylla,1869,2,20,5,5,72,38,34,65
FC Nords,1869,3,15,6,9,72,52,20,51
Copenhagen,1869,4,14,5,11,56,44,12,47
AaB,1869,5,7,11,12,35,47,-12,32
Sonderjyske,1869,6,8,6,10,28,29,-1,30
AC Horsens,1869,7,6,12,12,35,56,-21,30
Randers FC,1869,8,6,6,12,25,39,-14,24
Silkeborg IF,1869,9,5,4,13,26,45,-19,19
AGF Aarhus,1869,10,4,7,11,17,37,-20,19
Lyngby,1869,11,3,9,12,26,46,-20,18
Brondby,1870,1,21,7,2,70,30,40,70
FC Midtjylla,1870,2,19,5,6,73,43,30,62
FC Nords,1870,3,14,8,8,72,52,20,50
Copenhagen,1870,4,14,4,12,56,44,12,46
AaB,1870,5,9,12,9,39,40,-1,39
Sonderjyske,1870,6,8,6,10,28,29,-1,30
AC Horsens,1870,7,5,12,13,32,59,-27,27
Randers FC,1870,8,5,7,12,24,40,-16,22
Silkeborg IF,1870,9,6,3,13,27,44,-17,21
Lyngby,1870,10,3,10,11,27,45,-18,19
AGF Aarhus,1870,11,4,6,12,16,38,-22,18
Brondby,1871,1,23,5,2,77,30,47,74
FC Midtjylla,1871,2,19,6,5,63,35,28,63
FC Nords,1871,3,13,7,10,74,60,14,46
Copenhagen,1871,4,13,5,12,54,50,4,44
AC Horsens,1871,5,7,13,10,37,50,-13,34
AaB,1871,6,7,12,11,36,42,-6,33
Sonderjyske,1871,7,8,6,10,28,29,-1,30
Randers FC,1871,8,5,7,12,25,41,-16,22
Lyngby,1871,9,3,10,11,28,46,-18,19
Silkeborg IF,1871,10,5,4,13,26,45,-19,19
AGF Aarhus,1871,11,4,7,11,17,37,-20,19
FC Midtjylla,1872,1,20,5,5,69,42,27,65
Brondby,1872,2,19,6,5,68,35,33,63
FC Nords,1872,3,14,8,8,73,51,22,50
Copenhagen,1872,4,15,5,10,57,40,17,50
AaB,1872,5,8,12,10,39,45,-6,36
Sonderjyske,1872,6,8,6,10,28,29,-1,30
AC Horsens,1872,7,6,12,12,36,55,-19,30
Lyngby,1872,8,4,9,11,29,45,-16,21
Randers FC,1872,9,5,6,13,24,42,-18,21
AGF Aarhus,1872,10,5,6,11,18,37,-19,21
Silkeborg IF,1872,11,5,3,14,26,46,-20,18
Brondby,1873,1,23,5,2,74,32,42,74
FC Midtjylla,1873,2,18,5,7,63,41,22,59
FC Nords,1873,3,14,6,10,72,53,19,48
Copenhagen,1873,4,13,6,11,58,45,13,45
AaB,1873,5,7,13,10,34,40,-6,34
AC Horsens,1873,6,7,13,10,36,52,-16,34
Sonderjyske,1873,7,8,6,10,28,29,-1,30
Randers FC,1873,8,5,7,12,24,40,-16,22
Lyngby,1873,9,3,10,11,27,45,-18,19
Silkeborg IF,1873,10,5,4,13,26,45,-19,19
AGF Aarhus,1873,11,4,7,11,17,37,-20,19
Brondby,1874,1,20,8,2,66,28,38,68
FC Midtjylla,1874,2,18,6,6,60,38,22,60
FC Nords,1874,3,15,7,8,73,48,25,52
Copenhagen,1874,4,14,6,10,57,40,17,48
AaB,1874,5,6,14,10,34,41,-7,32
AC Horsens,1874,6,6,13,11,33,54,-21,31
Sonderjyske,1874,7,8,6,10,28,29,-1,30
Randers FC,1874,8,5,7,12,24,40,-16,22
Silkeborg IF,1874,9,6,3,13,28,45,-17,21
Lyngby,1874,10,3,10,11,27,45,-18,19
AGF Aarhus,1874,11,4,6,12,17,39,-22,18
Brondby,1875,1,21,7,2,73,34,39,70
FC Midtjylla,1875,2,20,5,5,71,40,31,65
FC Nords,1875,3,13,7,10,75,58,17,46
Copenhagen,1875,4,13,4,13,57,49,8,43
AaB,1875,5,8,14,8,39,39,0,38
AC Horsens,1875,6,6,13,11,37,58,-21,31
Sonderjyske,1875,7,8,6,10,28,29,-1,30
Silkeborg IF,1875,8,6,3,13,28,45,-17,21
Lyngby,1875,9,4,9,11,27,44,-17,21
Randers FC,1875,10,5,6,13,23,40,-17,21
AGF Aarhus,1875,11,4,6,12,17,39,-22,18
FC Midtjylla,1876,1,19,5,6,64,36,28,62
Brondby,1876,2,18,6,6,68,39,29,60
Copenhagen,1876,3,15,6,9,59,41,18,51
FC Nords,1876,4,14,8,8,74,53,21,50
AC Horsens,1876,5,7,14,9,37,52,-15,35
AaB,1876,6,7,13,10,39,46,-7,34
Sonderjyske,1876,7,8,6,10,28,29,-1,30
Randers FC,1876,8,6,6,12,25,39,-14,24
Silkeborg IF,1876,9,5,4,13,26,45,-19,19
AGF Aarhus,1876,10,4,7,11,17,37,-20,19
Lyngby,1876,11,3,9,12,26,46,-20,18
Brondby,1877,1,20,7,3,68,30,38,67
FC Midtjylla,1877,2,19,5,6,67,43,24,62
Copenhagen,1877,3,16,4,10,59,41,18,52
FC Nords,1877,4,14,8,8,72,49,23,50
AaB,1877,5,8,11,11,38,44,-6,35
Sonderjyske,1877,6,8,6,10,28,29,-1,30
AC Horsens,1877,7,5,13,12,32,55,-23,28
Lyngby,1877,8,4,9,11,29,46,-17,21
Randers FC,1877,9,5,6,13,25,42,-17,21
Silkeborg IF,1877,10,6,3,13,26,44,-18,21
AGF Aarhus,1877,11,4,6,12,16,37,-21,18
Brondby,1878,1,22,5,3,74,32,42,71
FC Midtjylla,1878,2,18,4,8,64,44,20,58
FC Nords,1878,3,15,6,9,74,48,26,51
Copenhagen,1878,4,14,4,12,59,53,6,46
AC Horsens,1878,5,9,12,9,37,49,-12,39
AaB,1878,6,7,11,12,34,42,-8,32
Sonderjyske,1878,7,8,6,10,28,29,-1,30
Randers FC,1878,8,5,7,12,23,39,-16,22
AGF Aarhus,1878,9,5,6,11,18,37,-19,21
Lyngby,1878,10,3,10,11,26,44,-18,19
Silkeborg IF,1878,11,5,3,14,26,46,-20,18
Brondby,1879,1,22,5,3,74,30,44,71
FC Midtjylla,1879,2,19,6,5,65,43,22,63
Copenhagen,1879,3,16,4,10,62,42,20,52
FC Nords,1879,4,14,7,9,79,53,26,49
Sonderjyske,1879,5,8,6,10,28,29,-1,30
AaB,1879,6,6,12,12,34,50,-16,30
AC Horsens,1879,7,6,12,12,34,56,-22,30
Randers FC,1879,8,5,7,12,24,40,-16,22
Lyngby,1879,9,3,10,11,27,45,-18,19
Silkeborg IF,1879,10,5,4,13,25,44,-19,19
AGF Aarhus,1879,11,4,7,11,16,36,-20,19
Brondby,1880,1,21,7,2,68,28,40,70
FC Midtjylla,1880,2,19,6,5,63,37,26,63
FC Nords,1880,3,16,6,8,77,46,31,54
Copenhagen,1880,4,12,5,13,52,47,5,41
AaB,1880,5,8,11,11,38,46,-8,35
AC Horsens,1880,6,6,13,11,32,52,-20,31
Sonderjyske,1880,7,8,6,10,28,29,-1,30
Randers FC,1880,8,5,7,12,26,42,-16,22
AGF Aarhus,1880,9,5,6,11,18,37,-19,21
Lyngby,1880,10,3,10,11,29,47,-18,19
Silkeborg IF,1880,11,5,3,14,26,46,-20,18
Brondby,1881,1,21,6,3,72,33,39,69
FC Midtjylla,1881,2,20,5,5,67,40,27,65
Copenhagen,1881,3,15,6,9,56,40,16,51
FC Nords,1881,4,13,6,11,72,56,16,45
AaB,1881,5,7,13,10,38,42,-4,34
Sonderjyske,1881,6,8,6,10,28,29,-1,30
AC Horsens,1881,7,6,12,12,37,57,-20,30
Lyngby,1881,8,4,9,11,28,44,-16,21
Randers FC,1881,9,5,6,13,23,41,-18,21
AGF Aarhus,1881,10,5,6,11,19,38,-19,21
Silkeborg IF,1881,11,5,3,14,27,47,-20,18
Brondby,1882,1,21,5,4,72,34,38,68
FC Midtjylla,1882,2,19,6,5,67,39,28,63
FC Nords,1882,3,14,8,8,74,52,22,50
Copenhagen,1882,4,15,5,10,62,45,17,50
AaB,1882,5,7,13,10,38,44,-6,34
Sonderjyske,1882,6,8,6,10,28,29,-1,30
AC Horsens,1882,7,5,13,12,33,58,-25,28
Lyngby,1882,8,4,9,11,32,45,-13,21
Randers FC,1882,9,5,6,13,24,45,-21,21
Silkeborg IF,1882,10,5,4,13,26,45,-19,19
AGF Aarhus,1882,11,4,7,11,17,37,-20,19
Brondby,1883,1,20,7,3,68,31,37,67
FC Midtjylla,1883,2,19,6,5,65,40,25,63
FC Nords,1883,3,14,8,8,72,48,24,50
Copenhagen,1883,4,14,5,11,57,44,13,47
AaB,1883,5,7,13,10,35,40,-5,34
AC Horsens,1883,6,6,13,11,34,54,-20,31
Sonderjyske,1883,7,8,6,10,28,29,-1,30
Randers FC,1883,8,5,7,12,25,41,-16,22
Lyngby,1883,9,3,10,11,28,46,-18,19
Silkeborg IF,1883,10,5,4,13,29,48,-19,19
AGF Aarhus,1883,11,4,7,11,20,40,-20,19
Brondby,1884,1,23,5,2,73,31,42,74
FC Midtjylla,1884,2,17,6,7,58,40,18,57
FC Nords,1884,3,14,7,9,75,55,20,49
Copenhagen,1884,4,15,4,11,58,45,13,49
AC Horsens,1884,5,8,12,10,41,51,-10,36
Sonderjyske,1884,6,8,6,10,28,29,-1,30
AaB,1884,7,6,12,12,35,44,-9,30
Randers FC,1884,8,6,6,12,24,39,-15,24
Silkeborg IF,1884,9,6,3,13,27,45,-18,21
Lyngby,1884,10,3,9,12,26,45,-19,18
AGF Aarhus,1884,11,4,6,12,17,38,-21,18
Brondby,1885,1,21,6,3,71,31,40,69
FC Midtjylla,1885,2,20,5,5,65,37,28,65
FC Nords,1885,3,14,8,8,72,51,21,50
Copenhagen,1885,4,13,6,11,55,45,10,45
AC Horsens,1885,5,7,12,11,42,54,-12,33
AaB,1885,6,6,13,11,33,46,-13,31
Sonderjyske,1885,7,8,6,10,28,29,-1,30
Lyngby,1885,8,4,9,11,28,44,-16,21
Randers FC,1885,9,5,6,13,23,41,-18,21
AGF Aarhus,1885,10,5,6,11,18,36,-18,21
Silkeborg IF,1885,11,5,3,14,25,46,-21,18
Brondby,1886,1,21,6,3,73,31,42,69
FC Midtjylla,1886,2,20,5,5,67,40,27,65
Copenhagen,1886,3,16,4,10,65,46,19,52
FC Nords,1886,4,13,7,10,70,54,16,46
AaB,1886,5,7,12,11,37,46,-9,33
Sonderjyske,1886,6,8,6,10,28,29,-1,30
AC Horsens,1886,7,5,14,11,31,52,-21,29
Randers FC,1886,8,6,6,12,25,39,-14,24
Silkeborg IF,1886,9,6,3,13,28,44,-16,21
Lyngby,1886,10,3,9,12,26,46,-20,18
AGF Aarhus,1886,11,4,6,12,16,39,-23,18
Brondby,1887,1,21,6,3,71,31,40,69
FC Midtjylla,1887,2,18,7,5,68,39,29,61
Copenhagen,1887,3,15,6,9,59,43,16,51
FC Nords,1887,4,14,8,8,75,52,23,50
AaB,1887,5,7,12,11,37,46,-9,33
Sonderjyske,1887,6,8,6,10,28,29,-1,30
AC Horsens,1887,7,5,13,12,32,57,-25,28
Randers FC,1887,8,6,6,12,26,40,-14,24
Silkeborg IF,1887,9,5,4,13,26,45,-19,19
AGF Aarhus,1887,10,4,7,11,17,37,-20,19
Lyngby,1887,11,3,9,12,27,47,-20,18
Brondby,1888,1,21,6,3,74,34,40,69
FC Midtjylla,1888,2,18,5,7,63,42,21,59
FC Nords,1888,3,14,7,9,72,55,17,49
Copenhagen,1888,4,14,5,11,60,45,15,47
AaB,1888,5,10,11,9,43,42,1,41
Sonderjyske,1888,6,8,6,10,28,29,-1,30
AC Horsens,1888,7,5,14,11,34,54,-20,29
Randers FC,1888,8,6,6,12,25,39,-14,24
Silkeborg IF,1888,9,6,3,13,30,44,-14,21
Lyngby,1888,10,3,9,12,26,46,-20,18
AGF Aarhus,1888,11,4,6,12,16,41,-25,18
Brondby,1889,1,21,6,3,74,30,44,69
FC Midtjylla,1889,2,19,4,7,66,42,24,61
FC Nords,1889,3,14,8,8,71,49,22,50
Copenhagen,1889,4,13,4,13,56,49,7,43
AaB,1889,5,9,11,10,40,47,-7,38
AC Horsens,1889,6,7,13,10,37,53,-16,34
Sonderjyske,1889,7,8,6,10,28,29,-1,30
Randers FC,1889,8,6,6,12,25,39,-14,24
AGF Aarhus,1889,9,5,6,11,17,36,-19,21
Lyngby,1889,10,3,9,12,26,46,-20,18
Silkeborg IF,1889,11,5,3,14,25,45,-20,18
Brondby,1890,1,21,6,3,73,32,41,69
FC Midtjylla,1890,2,18,6,6,65,45,20,60
Copenhagen,1890,3,15,6,9,60,42,18,51
FC Nords,1890,4,14,6,10,75,49,26,48
AaB,1890,5,7,13,10,38,43,-5,34
AC Horsens,1890,6,6,13,11,36,62,-26,31
Sonderjyske,1890,7,8,6,10,28,29,-1,30
Lyngby,1890,8,4,9,11,27,44,-17,21
Randers FC,1890,9,5,6,13,23,40,-17,21
Silkeborg IF,1890,10,5,4,13,25,44,-19,19
AGF Aarhus,1890,11,4,7,11,16,36,-20,19
Brondby,1891,1,20,8,2,70,32,38,68
FC Midtjylla,1891,2,20,6,4,66,36,30,66
FC Nords,1891,3,15,7,8,72,49,23,52
Copenhagen,1891,4,13,6,11,57,44,13,45
AC Horsens,1891,5,6,14,10,32,50,-18,32
Sonderjyske,1891,6,8,6,10,28,29,-1,30
AaB,1891,7,6,11,13,35,47,-12,29
Randers FC,1891,8,6,6,12,25,40,-15,24
Silkeborg IF,1891,9,6,3,13,27,45,-18,21
Lyngby,1891,10,3,9,12,27,46,-19,18
AGF Aarhus,1891,11,4,6,12,17,38,-21,18
Brondby,1892,1,21,5,4,73,34,39,68
FC Midtjylla,1892,2,19,4,7,63,41,22,61
FC Nords,1892,3,15,7,8,73,46,27,52
Copenhagen,1892,4,13,5,12,56,48,8,44
AC Horsens,1892,5,8,12,10,35,52,-17,36
AaB,1892,6,8,11,11,36,41,-5,35
Sonderjyske,1892,7,8,6,10,28,29,-1,30
Randers FC,1892,8,5,7,12,23,39,-16,22
AGF Aarhus,1892,9,5,6,11,19,36,-17,21
Lyngby,1892,10,3,10,11,26,44,-18,19
Silkeborg IF,1892,11,5,3,14,25,47,-22,18
Brondby,1893,1,22,6,2,76,32,44,72
FC Midtjylla,1893,2,19,4,7,64,45,19,61
Copenhagen,1893,3,16,4,10,62,45,17,52
FC Nords,1893,4,14,6,10,72,50,22,48
AC Horsens,1893,5,7,12,11,37,54,-17,33
Sonderjyske,1893,6,8,6,10,28,29,-1,30
AaB,1893,7,6,12,12,38,49,-11,30
Randers FC,1893,8,6,6,12,24,39,-15,24
AGF Aarhus,1893,9,5,6,11,20,37,-17,21
Lyngby,1893,10,3,9,12,26,45,-19,18
Silkeborg IF,1893,11,5,3,14,26,48,-22,18
Brondby,1894,1,21,6,3,76,33,43,69
FC Midtjylla,1894,2,18,7,5,65,44,21,61
FC Nords,1894,3,14,7,9,76,53,23,49
Copenhagen,1894,4,14,6,10,59,43,16,48
AaB,1894,5,8,12,10,36,41,-5,36
Sonderjyske,1894,6,8,6,10,28,29,-1,30
AC Horsens,1894,7,6,12,12,32,56,-24,30
Lyngby,1894,8,4,9,11,28,45,-17,21
Randers FC,1894,9,5,6,13,24,41,-17,21
Silkeborg IF,1894,10,5,4,13,26,45,-19,19
AGF Aarhus,1894,11,4,7,11,17,37,-20,19
Brondby,1895,1,22,5,3,74,33,41,71
FC Midtjylla,1895,2,18,4,8,63,46,17,58
FC Nords,1895,3,14,8,8,77,54,23,50
Copenhagen,1895,4,15,5,10,57,41,16,50
AC Horsens,1895,5,7,14,9,36,50,-14,35
Sonderjyske,1895,6,8,6,10,28,29,-1,30
AaB,1895,7,6,12,12,33,42,-9,30
Randers FC,1895,8,6,6,12,24,39,-15,24
AGF Aarhus,1895,9,5,6,11,18,36,-18,21
Lyngby,1895,10,3,9,12,26,45,-19,18
Silkeborg IF,1895,11,5,3,14,25,46,-21,18
FC Midtjylla,1896,1,20,5,5,66,37,29,65
Brondby,1896,2,19,6,5,70,36,34,63
FC Nords,1896,3,15,6,9,75,51,24,51
Copenhagen,1896,4,15,4,11,56,43,13,49
AC Horsens,1896,5,7,13,10,35,52,-17,34
AaB,1896,6,7,12,11,33,42,-9,33
Sonderjyske,1896,7,8,6,10,28,29,-1,30
Lyngby,1896,8,4,9,11,29,44,-15,21
Randers FC,1896,9,5,6,13,23,42,-19,21
AGF Aarhus,1896,10,5,6,11,17,36,-19,21
Silkeborg IF,1896,11,5,3,14,25,45,-20,18
Brondby,1897,1,21,5,4,71,32,39,68
FC Midtjylla,1897,2,19,4,7,62,46,16,61
FC Nords,1897,3,15,8,7,77,49,28,53
Copenhagen,1897,4,13,5,12,58,46,12,44
AC Horsens,1897,5,8,13,9,40,53,-13,37
AaB,1897,6,6,13,11,36,44,-8,31
Sonderjyske,1897,7,8,6,10,28,29,-1,30
Lyngby,1897,8,4,9,11,31,44,-13,21
Silkeborg IF,1897,9,6,3,13,27,45,-18,21
Randers FC,1897,10,5,6,13,23,44,-21,21
AGF Aarhus,1897,11,4,6,12,17,38,-21,18
Brondby,1898,1,20,6,4,70,36,34,66
FC Midtjylla,1898,2,19,5,6,68,41,27,62
FC Nords,1898,3,15,7,8,78,52,26,52
Copenhagen,1898,4,13,6,11,57,47,10,45
AaB,1898,5,8,13,9,37,43,-6,37
AC Horsens,1898,6,6,13,11,37,54,-17,31
Sonderjyske,1898,7,8,6,10,28,29,-1,30
Lyngby,1898,8,4,9,11,28,45,-17,21
Randers FC,1898,9,5,6,13,24,41,-17,21
Silkeborg IF,1898,10,5,4,13,28,47,-19,19
AGF Aarhus,1898,11,4,7,11,19,39,-20,19
Brondby,1899,1,20,5,5,72,35,37,65
FC Midtjylla,1899,2,20,5,5,69,37,32,65
FC Nords,1899,3,15,6,9,77,56,21,51
Copenhagen,1899,4,13,5,12,57,47,10,44
AC Horsens,1899,5,8,12,10,37,55,-18,36
AaB,1899,6,8,11,11,37,45,-8,35
Sonderjyske,1899,7,8,6,10,28,29,-1,30
Randers FC,1899,8,6,6,12,26,39,-13,24
Silkeborg IF,1899,9,6,3,13,28,45,-17,21
Lyngby,1899,10,3,9,12,26,47,-21,18
AGF Aarhus,1899,11,4,6,12,17,39,-22,18
Brondby,1900,1,20,7,3,75,34,41,67
FC Midtjylla,1900,2,19,5,6,63,39,24,62
Copenhagen,1900,3,15,4,11,61,46,15,49
FC Nords,1900,4,13,6,11,69,55,14,45
AaB,1900,5,8,12,10,40,45,-5,36
AC Horsens,1900,6,7,14,9,38,53,-15,35
Sonderjyske,1900,7,8,6,10,28,29,-1,30
Randers FC,1900,8,5,7,12,26,42,-16,22
Lyngby,1900,9,3,10,11,29,47,-18,19
Silkeborg IF,1900,10,5,4,13,26,45,-19,19
AGF Aarhus,1900,11,4,7,11,17,37,-20,19
Brondby,1901,1,20,6,4,73,36,37,66
FC Midtjylla,1901,2,18,7,5,62,37,25,61
FC Nords,1901,3,14,7,9,74,54,20,49
Copenhagen,1901,4,13,5,12,57,48,9,44
AC Horsens,1901,5,8,13,9,35,49,-14,37
AaB,1901,6,8,12,10,41,44,-3,36
Sonderjyske,1901,7,8,6,10,28,29,-1,30
Randers FC,1901,8,6,6,12,24,39,-15,24
Silkeborg IF,1901,9,5,4,13,25,44,-19,19
AGF Aarhus,1901,10,4,7,11,16,36,-20,19
Lyngby,1901,11,3,9,12,26,45,-19,18
Brondby,1902,1,20,7,3,67,30,37,67
FC Midtjylla,1902,2,20,4,6,70,41,29,64
Copenhagen,1902,3,15,4,11,61,50,11,49
FC Nords,1902,4,13,7,10,71,52,19,46
AaB,1902,5,9,12,9,40,42,-2,39
Sonderjyske,1902,6,8,6,10,28,29,-1,30
AC Horsens,1902,7,6,12,12,33,53,-20,30
Randers FC,1902,8,5,7,12,23,39,-16,22
Silkeborg IF,1902,9,6,3,13,27,44,-17,21
Lyngby,1902,10,3,10,11,26,44,-18,19
AGF Aarhus,1902,11,4,6,12,16,38,-22,18
Brondby,1903,1,20,5,5,66,32,34,65
FC Midtjylla,1903,2,20,5,5,69,38,31,65
FC Nords,1903,3,14,6,10,73,52,21,48
Copenhagen,1903,4,14,6,10,58,45,13,48
AaB,1903,5,8,12,10,41,47,-6,36
AC Horsens,1903,6,6,14,10,36,55,-19,32
Sonderjyske,1903,7,8,6,10,28,29,-1,30
Lyngby,1903,8,4,9,11,28,45,-17,21
Randers FC,1903,9,5,6,13,24,41,-17,21
Silkeborg IF,1903,10,5,4,13,25,44,-19,19
AGF Aarhus,1903,11,4,7,11,16,36,-20,19
FC Midtjylla,1904,1,20,5,5,64,37,27,65
Brondby,1904,2,19,7,4,64,31,33,64
FC Nords,1904,3,14,7,9,74,53,21,49
Copenhagen,1904,4,14,6,10,60,42,18,48
AaB,1904,5,7,14,9,36,40,-4,35
AC Horsens,1904,6,6,13,11,34,55,-21,31
Sonderjyske,1904,7,8,6,10,28,29,-1,30
Randers FC,1904,8,6,6,12,24,39,-15,24
Silkeborg IF,1904,9,6,3,13,26,44,-18,21
Lyngby,1904,10,3,9,12,26,45,-19,18
AGF Aarhus,1904,11,4,6,12,16,37,-21,18
Brondby,1905,1,22,6,2,71,30,41,72
FC Midtjylla,1905,2,21,5,4,67,37,30,68
FC Nords,1905,3,15,6,9,78,52,26,51
Copenhagen,1905,4,13,4,13,56,51,5,43
AC Horsens,1905,5,6,13,11,35,54,-19,31
Sonderjyske,1905,6,8,6,10,28,29,-1,30
AaB,1905,7,6,12,12,33,42,-9,30
Randers FC,1905,8,5,7,12,24,40,-16,22
Silkeborg IF,1905,9,6,3,13,27,45,-18,21
Lyngby,1905,10,3,10,11,27,45,-18,19
AGF Aarhus,1905,11,4,6,12,17,38,-21,18
Brondby,1906,1,20,5,5,70,36,34,65
FC Midtjylla,1906,2,18,5,7,62,47,15,59
FC Nords,1906,3,15,6,9,76,53,23,51
Copenhagen,1906,4,15,4,11,60,42,18,49
AaB,1906,5,8,12,10,38,44,-6,36
AC Horsens,1906,6,8,12,10,42,52,-10,36
Sonderjyske,1906,7,8,6,10,28,29,-1,30
Lyngby,1906,8,4,9,11,29,44,-15,21
Silkeborg IF,1906,9,6,3,13,26,44,-18,21
Randers FC,1906,10,5,6,13,23,42,-19,21
AGF Aarhus,1906,11,4,6,12,16,37,-21,18
Brondby,1907,1,22,5,3,75,33,42,71
FC Midtjylla,1907,2,19,5,6,71,41,30,62
FC Nords,1907,3,15,6,9,77,55,22,51
Copenhagen,1907,4,15,4,11,62,46,16,49
AaB,1907,5,8,12,10,35,42,-7,36
Sonderjyske,1907,6,8,6,10,28,29,-1,30
AC Horsens,1907,7,5,12,13,33,62,-29,27
Randers FC,1907,8,5,7,12,25,41,-16,22
AGF Aarhus,1907,9,5,6,11,18,37,-19,21
Lyngby,1907,10,3,10,11,28,46,-18,19
Silkeborg IF,1907,11,5,3,14,26,46,-20,18
Brondby,1908,1,22,5,3,71,30,41,71
FC Midtjylla,1908,2,21,4,5,68,36,32,67
FC Nords,1908,3,14,8,8,70,50,20,50
Copenhagen,1908,4,12,6,12,57,49,8,42
AaB,1908,5,8,12,10,36,41,-5,36
Sonderjyske,1908,6,8,6,10,28,29,-1,30
AC Horsens,1908,7,5,13,12,32,54,-22,28
Lyngby,1908,8,4,9,11,30,44,-14,21
Silkeborg IF,1908,9,6,3,13,27,45,-18,21
Randers FC,1908,10,5,6,13,23,43,-20,21
AGF Aarhus,1908,11,4,6,12,17,38,-21,18
Brondby,1909,1,23,5,2,76,29,47,74
FC Midtjylla,1909,2,19,6,5,65,38,27,63
FC Nords,1909,3,14,6,10,69,55,14,48
Copenhagen,1909,4,12,6,12,57,49,8,42
AaB,1909,5,7,14,9,38,42,-4,35
AC Horsens,1909,6,6,13,11,38,56,-18,31
Sonderjyske,1909,7,8,6,10,28,29,-1,30
Randers FC,1909,8,6,6,12,24,39,-15,24
Silkeborg IF,1909,9,6,3,13,28,44,-16,21
Lyngby,1909,10,3,9,12,26,45,-19,18
AGF Aarhus,1909,11,4,6,12,16,39,-23,18
FC Midtjylla,1910,1,22,4,4,73,41,32,70
Brondby,1910,2,21,5,4,74,34,40,68
FC Nords,1910,3,15,7,8,76,53,23,52
Copenhagen,1910,4,12,6,12,58,53,5,42
AaB,1910,5,7,12,11,35,43,-8,33
Sonderjyske,1910,6,8,6,10,28,29,-1,30
AC Horsens,1910,7,5,14,11,34,52,-18,29
Randers FC,1910,8,6,6,12,25,40,-15,24
AGF Aarhus,1910,9,5,6,11,17,36,-19,21
Lyngby,1910,10,3,9,12,27,46,-19,18
Silkeborg IF,1910,11,5,3,14,25,45,-20,18
Brondby,1911,1,21,6,3,68,31,37,69
FC Midtjylla,1911,2,19,4,7,64,39,25,61
FC Nords,1911,3,14,7,9,70,50,20,49
Copenhagen,1911,4,14,6,10,54,40,14,48
AC Horsens,1911,5,7,13,10,35,51,-16,34
AaB,1911,6,7,12,11,37,43,-6,33
Sonderjyske,1911,7,8,6,10,28,29,-1,30
Silkeborg IF,1911,8,6,3,13,28,44,-16,21
Lyngby,1911,9,4,9,11,27,44,-17,21
Randers FC,1911,10,5,6,13,23,40,-17,21
AGF Aarhus,1911,11,4,6,12,16,39,-23,18
Brondby,1912,1,21,6,3,76,36,40,69
FC Midtjylla,1912,2,19,4,7,66,44,22,61
FC Nords,1912,3,15,6,9,76,53,23,51
Copenhagen,1912,4,15,5,10,61,46,15,50
AaB,1912,5,8,12,10,41,45,-4,36
Sonderjyske,1912,6,8,6,10,28,29,-1,30
AC Horsens,1912,7,5,13,12,32,54,-22,28
Randers FC,1912,8,6,6,12,24,39,-15,24
Silkeborg IF,1912,9,6,3,13,27,44,-17,21
Lyngby,1912,10,3,9,12,26,45,-19,18
AGF Aarhus,1912,11,4,6,12,16,38,-22,18
Brondby,1913,1,21,6,3,69,31,38,69
FC Midtjylla,1913,2,19,5,6,68,39,29,62
FC Nords,1913,3,14,7,9,74,50,24,49
Copenhagen,1913,4,14,5,11,56,47,9,47
AaB,1913,5,8,12,10,38,43,-5,36
AC Horsens,1913,6,6,13,11,37,58,-21,31
Sonderjyske,1913,7,8,6,10,28,29,-1,30
Randers FC,1913,8,6,6,12,25,40,-15,24
Silkeborg IF,1913,9,6,3,13,28,46,-18,21
Lyngby,1913,10,3,9,12,27,46,-19,18
AGF Aarhus,1913,11,4,6,12,18,39,-21,18
Brondby,1914,1,22,5,3,71,27,44,71
FC Midtjylla,1914,2,20,4,6,69,40,29,64
FC Nords,1914,3,13,7,10,68,54,14,46
Copenhagen,1914,4,13,5,12,56,46,10,44
AC Horsens,1914,5,9,12,9,37,48,-11,39
AaB,1914,6,6,13,11,35,47,-12,31
Sonderjyske,1914,7,8,6,10,28,29,-1,30
Lyngby,1914,8,4,9,11,30,47,-17,21
Randers FC,1914,9,5,6,13,26,43,-17,21
Silkeborg IF,1914,10,6,3,13,27,45,-18,21
AGF Aarhus,1914,11,4,6,12,17,38,-21,18
FC Midtjylla,1915,1,19,6,5,64,39,25,63
Brondby,1915,2,18,8,4,68,41,27,62
Copenhagen,1915,3,15,5,10,60,40,20,50
FC Nords,1915,4,13,9,8,71,50,21,48
AC Horsens,1915,5,7,13,10,38,50,-12,34
AaB,1915,6,6,15,9,35,42,-7,33
Sonderjyske,1915,7,8,6,10,28,29,-1,30
Lyngby,1915,8,4,9,11,32,46,-14,21
AGF Aarhus,1915,9,5,6,11,18,37,-19,21
Randers FC,1915,10,5,6,13,25,45,-20,21
Silkeborg IF,1915,11,5,3,14,26,46,-20,18
FC Midtjylla,1916,1,20,5,5,65,37,28,65
Brondby,1916,2,19,6,5,69,34,35,63
FC Nords,1916,3,16,6,8,75,48,27,54
Copenhagen,1916,4,15,5,10,58,42,16,50
AaB,1916,5,6,13,11,32,45,-13,31
AC Horsens,1916,6,6,13,11,31,50,-19,31
Sonderjyske,1916,7,8,6,10,28,29,-1,30
Lyngby,1916,8,4,9,11,27,44,-17,21
Randers FC,1916,9,5,6,13,23,40,-17,21
Silkeborg IF,1916,10,6,3,13,28,46,-18,21
AGF Aarhus,1916,11,4,6,12,18,39,-21,18
Brondby,1917,1,23,5,2,72,27,45,74
FC Midtjylla,1917,2,19,4,7,63,39,24,61
Copenhagen,1917,3,15,5,10,58,42,16,50
FC Nords,1917,4,13,7,10,70,53,17,46
AaB,1917,5,8,12,10,38,44,-6,36
Sonderjyske,1917,6,8,6,10,28,29,-1,30
AC Horsens,1917,7,5,13,12,32,54,-22,28
Lyngby,1917,8,4,9,11,28,45,-17,21
Randers FC,1917,9,5,6,13,24,41,-17,21
AGF Aarhus,1917,10,5,6,11,17,36,-19,21
Silkeborg IF,1917,11,5,3,14,25,45,-20,18
Brondby,1918,1,20,7,3,69,34,35,67
FC Midtjylla,1918,2,18,6,6,67,43,24,60
Copenhagen,1918,3,15,5,10,63,45,18,50
FC Nords,1918,4,12,7,11,67,54,13,43
AaB,1918,5,10,11,9,43,41,2,41
AC Horsens,1918,6,6,14,10,35,53,-18,32
Sonderjyske,1918,7,8,6,10,28,29,-1,30
Randers FC,1918,8,5,7,12,26,42,-16,22
Silkeborg IF,1918,9,6,3,13,28,45,-17,21
Lyngby,1918,10,3,10,11,29,47,-18,19
AGF Aarhus,1918,11,4,6,12,17,39,-22,18
FC Midtjylla,1919,1,20,5,5,70,37,33,65
Brondby,1919,2,18,7,5,67,36,31,61
Copenhagen,1919,3,15,6,9,59,41,18,51
FC Nords,1919,4,13,9,8,72,52,20,48
AC Horsens,1919,5,7,13,10,39,54,-15,34
AaB,1919,6,6,14,10,36,49,-13,32
Sonderjyske,1919,7,8,6,10,28,29,-1,30
Randers FC,1919,8,5,7,12,24,40,-16,22
AGF Aarhus,1919,9,5,6,11,18,37,-19,21
Lyngby,1919,10,3,10,11,27,45,-18,19
Silkeborg IF,1919,11,5,3,14,26,46,-20,18
Brondby,1920,1,20,6,4,67,31,36,66
FC Midtjylla,1920,2,20,5,5,70,38,32,65
Copenhagen,1920,3,15,5,10,57,43,14,50
FC Nords,1920,4,13,6,11,70,55,15,45
AC Horsens,1920,5,7,15,8,36,49,-13,36
AaB,1920,6,7,11,12,35,45,-10,32
Sonderjyske,1920,7,8,6,10,28,29,-1,30
Lyngby,1920,8,4,9,11,28,45,-17,21
Randers FC,1920,9,5,6,13,24,41,-17,21
Silkeborg IF,1920,10,6,3,13,26,44,-18,21
AGF Aarhus,1920,11,4,6,12,16,37,-21,18
FC Midtjylla,1921,1,22,4,4,71,35,36,70
Brondby,1921,2,19,5,6,67,41,26,62
FC Nords,1921,3,15,6,9,76,52,24,51
Copenhagen,1921,4,14,4,12,57,45,12,46
AaB,1921,5,8,12,10,39,45,-6,36
AC Horsens,1921,6,6,13,11,39,57,-18,31
Sonderjyske,1921,7,8,6,10,28,29,-1,30
Silkeborg IF,1921,8,6,3,13,30,44,-14,21
Lyngby,1921,9,4,9,11,29,45,-16,21
Randers FC,1921,10,5,6,13,24,42,-18,21
AGF Aarhus,1921,11,4,6,12,16,41,-25,18
Brondby,1922,1,21,7,2,71,31,40,70
FC Midtjylla,1922,2,21,4,5,65,36,29,67
FC Nords,1922,3,13,8,9,70,50,20,47
Copenhagen,1922,4,13,6,11,60,47,13,45
AC Horsens,1922,5,7,13,10,38,54,-16,34
Sonderjyske,1922,6,8,6,10,28,29,-1,30
AaB,1922,7,6,12,12,34,46,-12,30
Randers FC,1922,8,5,7,12,24,40,-16,22
AGF Aarhus,1922,9,5,6,11,17,36,-19,21
Lyngby,1922,10,3,10,11,27,45,-18,19
Silkeborg IF,1922,11,5,3,14,25,45,-20,18
Brondby,1923,1,22,6,2,72,31,41,72
FC Midtjylla,1923,2,18,6,6,64,42,22,60
Copenhagen,1923,3,15,5,10,62,46,16,50
FC Nords,1923,4,14,6,10,73,52,21,48
AaB,1923,5,7,12,11,38,46,-8,33
AC Horsens,1923,6,6,13,11,36,54,-18,31
Sonderjyske,1923,7,8,6,10,28,29,-1,30
Lyngby,1923,8,4,9,11,29,44,-15,21
Randers FC,1923,9,5,6,13,23,42,-19,21
AGF Aarhus,1923,10,5,6,11,19,38,-19,21
Silkeborg IF,1923,11,5,3,14,27,47,-20,18
Brondby,1924,1,20,7,3,73,37,36,67
FC Midtjylla,1924,2,21,4,5,68,41,27,67
FC Nords,1924,3,14,7,9,76,56,20,49
Copenhagen,1924,4,14,5,11,57,44,13,47
AaB,1924,5,7,13,10,40,42,-2,34
Sonderjyske,1924,6,8,6,10,28,29,-1,30
AC Horsens,1924,7,5,14,11,36,56,-20,29
Randers FC,1924,8,5,7,12,24,40,-16,22
Lyngby,1924,9,3,10,11,27,45,-18,19
Silkeborg IF,1924,10,5,4,13,25,44,-19,19
AGF Aarhus,1924,11,4,7,11,16,36,-20,19
Brondby,1925,1,21,6,3,72,36,36,69
FC Midtjylla,1925,2,20,5,5,72,38,34,65
FC Nords,1925,3,13,8,9,71,50,21,47
Copenhagen,1925,4,14,5,11,62,50,12,47
AaB,1925,5,8,11,11,39,47,-8,35
AC Horsens,1925,6,6,13,11,35,56,-21,31
Sonderjyske,1925,7,8,6,10,28,29,-1,30
Randers FC,1925,8,5,7,12,24,40,-16,22
Silkeborg IF,1925,9,6,3,13,27,45,-18,21
Lyngby,1925,10,3,10,11,27,45,-18,19
AGF Aarhus,1925,11,4,6,12,17,38,-21,18
Brondby,1926,1,20,7,3,68,31,37,67
FC Midtjylla,1926,2,20,5,5,66,40,26,65
FC Nords,1926,3,14,7,9,75,51,24,49
Copenhagen,1926,4,13,5,12,54,47,7,44
AaB,1926,5,7,13,10,37,42,-5,34
AC Horsens,1926,6,6,15,9,37,52,-15,33
Sonderjyske,1926,7,8,6,10,28,29,-1,30
Lyngby,1926,8,4,9,11,27,44,-17,21
Silkeborg IF,1926,8,6,3,13,27,44,-17,21
Randers FC,1926,10,5,6,13,23,40,-17,21
AGF Aarhus,1926,11,4,6,12,16,38,-22,18
Brondby,1927,1,21,7,2,73,31,42,70
FC Midtjylla,1927,2,20,5,5,65,39,26,65
FC Nords,1927,3,14,8,8,75,50,25,50
Copenhagen,1927,4,13,6,11,58,46,12,45
AaB,1927,5,7,12,11,36,45,-9,33
Sonderjyske,1927,6,8,6,10,28,29,-1,30
AC Horsens,1927,7,6,12,12,33,55,-22,30
Lyngby,1927,8,4,9,11,30,45,-15,21
Silkeborg IF,1927,9,6,3,13,28,46,-18,21
Randers FC,1927,10,5,6,13,24,43,-19,21
AGF Aarhus,1927,11,4,6,12,18,39,-21,18
Brondby,1928,1,23,5,2,71,29,42,74
FC Midtjylla,1928,2,19,6,5,62,37,25,63
Copenhagen,1928,3,14,5,11,58,43,15,47
FC Nords,1928,4,13,7,10,68,52,16,46
AaB,1928,5,7,12,11,37,43,-6,33
AC Horsens,1928,6,6,13,11,33,51,-18,31
Sonderjyske,1928,7,8,6,10,28,29,-1,30
Randers FC,1928,8,5,7,12,24,40,-16,22
Lyngby,1928,9,3,10,11,27,45,-18,19
Silkeborg IF,1928,10,5,4,13,28,47,-19,19
AGF Aarhus,1928,11,4,7,11,19,39,-20,19
Brondby,1929,1,19,8,3,66,31,35,65
FC Midtjylla,1929,2,20,5,5,68,41,27,65
FC Nords,1929,3,14,6,10,69,54,15,48
Copenhagen,1929,4,13,7,10,57,42,15,46
AaB,1929,5,8,12,10,40,39,1,36
AC Horsens,1929,6,6,14,10,34,53,-19,32
Sonderjyske,1929,7,8,6,10,28,29,-1,30
Lyngby,1929,8,4,9,11,28,45,-17,21
Randers FC,1929,9,5,6,13,24,41,-17,21
AGF Aarhus,1929,10,5,6,11,18,36,-18,21
Silkeborg IF,1929,11,5,3,14,25,46,-21,18
Brondby,1930,1,20,7,3,75,31,44,67
FC Midtjylla,1930,2,17,8,5,61,38,23,59
FC Nords,1930,3,17,6,7,79,46,33,57
Copenhagen,1930,4,13,7,10,55,42,13,46
AC Horsens,1930,5,6,14,10,32,55,-23,32
Sonderjyske,1930,6,8,6,10,28,29,-1,30
AaB,1930,7,6,12,12,33,49,-16,30
Lyngby,1930,8,4,9,11,29,45,-16,21
Silkeborg IF,1930,9,6,3,13,26,44,-18,21
Randers FC,1930,10,5,6,13,24,42,-18,21
AGF Aarhus,1930,11,4,6,12,16,37,-21,18
Brondby,1931,1,22,6,2,76,32,44,72
FC Midtjylla,1931,2,18,5,7,62,39,23,59
FC Nords,1931,3,16,7,7,74,48,26,55
Copenhagen,1931,4,12,6,12,57,49,8,42
AaB,1931,5,7,12,11,36,45,-9,33
AC Horsens,1931,6,6,14,10,34,52,-18,32
Sonderjyske,1931,7,8,6,10,28,29,-1,30
Lyngby,1931,8,4,9,11,28,44,-16,21
Randers FC,1931,9,5,6,13,23,41,-18,21
AGF Aarhus,1931,10,5,6,11,17,36,-19,21
Silkeborg IF,1931,11,5,3,14,25,45,-20,18
Brondby,1932,1,21,5,4,71,31,40,68
FC Midtjylla,1932,2,21,4,5,67,38,29,67
FC Nords,1932,3,16,6,8,73,49,24,54
Copenhagen,1932,4,14,4,12,61,46,15,46
AaB,1932,5,7,12,11,35,45,-10,33
Sonderjyske,1932,6,8,6,10,28,29,-1,30
AC Horsens,1932,7,5,13,12,34,58,-24,28
Randers FC,1932,8,5,7,12,25,41,-16,22
Silkeborg IF,1932,9,6,3,13,26,44,-18,21
Lyngby,1932,10,3,10,11,28,46,-18,19
AGF Aarhus,1932,11,4,6,12,16,37,-21,18
Brondby,1933,1,22,6,2,76,29,47,72
FC Midtjylla,1933,2,20,5,5,66,41,25,65
FC Nords,1933,3,13,8,9,68,52,16,47
Copenhagen,1933,4,13,5,12,57,45,12,44
AC Horsens,1933,5,7,13,10,38,51,-13,34
AaB,1933,6,6,13,11,36,49,-13,31
Sonderjyske,1933,7,8,6,10,28,29,-1,30
Lyngby,1933,8,4,9,11,29,46,-17,21
Randers FC,1933,9,5,6,13,25,42,-17,21
Silkeborg IF,1933,10,5,4,13,26,45,-19,19
AGF Aarhus,1933,11,4,7,11,17,37,-20,19
Brondby,1934,1,21,6,3,73,32,41,69
FC Midtjylla,1934,2,19,7,4,66,39,27,64
FC Nords,1934,3,14,7,9,75,54,21,49
Copenhagen,1934,4,14,4,12,57,50,7,46
AC Horsens,1934,5,7,13,10,38,52,-14,34
AaB,1934,6,7,11,12,37,45,-8,32
Sonderjyske,1934,7,8,6,10,28,29,-1,30
Randers FC,1934,8,5,7,12,24,40,-16,22
Silkeborg IF,1934,9,6,3,13,28,45,-17,21
Lyngby,1934,10,3,10,11,27,45,-18,19
AGF Aarhus,1934,11,4,6,12,17,39,-22,18
Brondby,1935,1,20,8,2,68,30,38,68
FC Midtjylla,1935,2,20,4,6,69,39,30,64
Copenhagen,1935,3,14,5,11,55,41,14,47
FC Nords,1935,4,13,7,10,68,54,14,46
AaB,1935,5,8,12,10,36,41,-5,36
AC Horsens,1935,6,6,14,10,37,54,-17,32
Sonderjyske,1935,7,8,6,10,28,29,-1,30
Lyngby,1935,8,4,9,11,29,44,-15,21
Randers FC,1935,9,5,6,13,23,42,-19,21
Silkeborg IF,1935,10,5,4,13,25,44,-19,19
AGF Aarhus,1935,11,4,7,11,16,36,-20,19
Brondby,1936,1,20,8,2,71,33,38,68
FC Midtjylla,1936,2,20,5,5,70,43,27,65
Copenhagen,1936,3,14,7,9,59,41,18,49
FC Nords,1936,4,12,8,10,67,51,16,44
AaB,1936,5,7,13,10,38,46,-8,34
AC Horsens,1936,6,6,13,11,34,51,-17,31
Sonderjyske,1936,7,8,6,10,28,29,-1,30
Lyngby,1936,8,4,9,11,29,44,-15,21
AGF Aarhus,1936,9,5,6,11,19,36,-17,21
Randers FC,1936,10,5,6,13,23,42,-19,21
Silkeborg IF,1936,11,5,3,14,25,47,-22,18
Brondby,1937,1,22,6,2,77,33,44,72
FC Midtjylla,1937,2,18,5,7,62,39,23,59
Copenhagen,1937,3,15,5,10,60,45,15,50
FC Nords,1937,4,12,9,9,73,57,16,45
AaB,1937,5,8,12,10,38,45,-7,36
AC Horsens,1937,6,6,13,11,37,54,-17,31
Sonderjyske,1937,7,8,6,10,28,29,-1,30
Lyngby,1937,8,4,9,11,28,44,-16,21
Silkeborg IF,1937,9,6,3,13,29,46,-17,21
Randers FC,1937,10,5,6,13,23,41,-18,21
AGF Aarhus,1937,11,4,6,12,18,40,-22,18
Brondby,1938,1,19,7,4,71,35,36,64
FC Midtjylla,1938,2,19,6,5,64,39,25,63
Copenhagen,1938,3,16,4,10,60,43,17,52
FC Nords,1938,4,14,7,9,73,51,22,49
AaB,1938,5,7,13,10,37,41,-4,34
AC Horsens,1938,6,6,13,11,31,53,-22,31
Sonderjyske,1938,7,8,6,10,28,29,-1,30
Randers FC,1938,8,5,7,12,26,42,-16,22
AGF Aarhus,1938,9,5,6,11,20,38,-18,21
Lyngby,1938,10,3,10,11,29,47,-18,19
Silkeborg IF,1938,11,5,3,14,27,48,-21,18
Brondby,1939,1,22,5,3,69,29,40,71
FC Midtjylla,1939,2,20,4,6,63,36,27,64
FC Nords,1939,3,15,7,8,77,52,25,52
Copenhagen,1939,4,14,5,11,59,45,14,47
AaB,1939,5,7,12,11,37,46,-9,33
Sonderjyske,1939,6,8,6,10,28,29,-1,30
AC Horsens,1939,7,5,13,12,35,58,-23,28
Lyngby,1939,8,4,9,11,29,46,-17,21
Randers FC,1939,9,5,6,13,25,42,-17,21
Silkeborg IF,1939,10,5,4,13,25,44,-19,19
AGF Aarhus,1939,11,4,7,11,16,36,-20,19
Brondby,1940,1,21,6,3,74,33,41,69
FC Midtjylla,1940,2,20,6,4,65,36,29,66
FC Nords,1940,3,14,8,8,74,50,24,50
Copenhagen,1940,4,13,5,12,56,46,10,44
AaB,1940,5,7,12,11,34,45,-11,33
Sonderjyske,1940,6,8,6,10,28,29,-1,30
AC Horsens,1940,7,5,15,10,32,51,-19,30
Randers FC,1940,8,6,6,12,24,39,-15,24
Silkeborg IF,1940,9,5,4,13,26,45,-19,19
AGF Aarhus,1940,10,4,7,11,17,37,-20,19
Lyngby,1940,11,3,9,12,26,45,-19,18
Brondby,1941,1,21,7,2,77,30,47,70
FC Midtjylla,1941,2,18,6,6,62,40,22,60
FC Nords,1941,3,14,7,9,78,53,25,49
Copenhagen,1941,4,13,5,12,52,46,6,44
AaB,1941,5,7,14,9,36,44,-8,35
AC Horsens,1941,6,6,15,9,37,55,-18,33
Sonderjyske,1941,7,8,6,10,28,29,-1,30
Lyngby,1941,8,4,9,11,29,45,-16,21
Randers FC,1941,9,5,6,13,24,42,-18,21
Silkeborg IF,1941,10,5,4,13,26,45,-19,19
AGF Aarhus,1941,11,4,7,11,17,37,-20,19
Brondby,1942,1,22,5,3,69,30,39,71
FC Midtjylla,1942,2,19,6,5,66,39,27,63
FC Nords,1942,3,14,7,9,71,49,22,49
Copenhagen,1942,4,12,5,13,54,46,8,41
AaB,1942,5,8,12,10,35,39,-4,36
AC Horsens,1942,6,7,13,10,37,55,-18,34
Sonderjyske,1942,7,8,6,10,28,29,-1,30
Lyngby,1942,8,4,9,11,27,44,-17,21
Randers FC,1942,9,5,6,13,23,40,-17,21
AGF Aarhus,1942,10,5,6,11,18,37,-19,21
Silkeborg IF,1942,11,5,3,14,26,46,-20,18
Brondby,1943,1,21,5,4,68,31,37,68
FC Midtjylla,1943,2,20,4,6,69,43,26,64
FC Nords,1943,3,14,7,9,74,52,22,49
Copenhagen,1943,4,15,4,11,54,43,11,49
AaB,1943,5,9,11,10,39,41,-2,38
Sonderjyske,1943,6,8,6,10,28,29,-1,30
AC Horsens,1943,7,5,13,12,35,55,-20,28
Randers FC,1943,8,6,6,12,25,40,-15,24
AGF Aarhus,1943,9,5,6,11,20,38,-18,21
Lyngby,1943,10,3,9,12,27,46,-19,18
Silkeborg IF,1943,11,5,3,14,27,48,-21,18
FC Midtjylla,1944,1,21,4,5,70,41,29,67
Brondby,1944,2,20,6,4,70,34,36,66
FC Nords,1944,3,14,7,9,71,51,20,49
Copenhagen,1944,4,14,5,11,58,45,13,47
AC Horsens,1944,5,8,13,9,39,49,-10,37
Sonderjyske,1944,6,8,6,10,28,29,-1,30
AaB,1944,7,6,11,13,33,47,-14,29
Silkeborg IF,1944,8,6,3,13,30,44,-14,21
Lyngby,1944,9,4,9,11,29,44,-15,21
Randers FC,1944,10,5,6,13,23,42,-19,21
AGF Aarhus,1944,11,4,6,12,16,41,-25,18
Brondby,1945,1,22,5,3,74,29,45,71
FC Midtjylla,1945,2,17,6,7,62,42,20,57
FC Nords,1945,3,14,8,8,76,55,21,50
Copenhagen,1945,4,14,5,11,54,46,8,47
AaB,1945,5,9,12,9,42,43,-1,39
Sonderjyske,1945,6,8,6,10,28,29,-1,30
AC Horsens,1945,7,5,14,11,33,52,-19,29
Lyngby,1945,8,4,9,11,28,45,-17,21
Randers FC,1945,9,5,6,13,24,41,-17,21
AGF Aarhus,1945,10,5,6,11,17,36,-19,21
Silkeborg IF,1945,11,5,3,14,25,45,-20,18
Brondby,1946,1,21,5,4,67,33,34,68
FC Midtjylla,1946,2,20,5,5,67,36,31,65
FC Nords,1946,3,14,6,10,73,55,18,48
Copenhagen,1946,4,12,7,11,54,45,9,43
AC Horsens,1946,5,8,13,9,40,49,-9,37
AaB,1946,6,7,12,11,36,45,-9,33
Sonderjyske,1946,7,8,6,10,28,29,-1,30
Randers FC,1946,8,5,7,12,24,40,-16,22
Lyngby,1946,9,3,10,11,27,45,-18,19
Silkeborg IF,1946,10,5,4,13,26,45,-19,19
AGF Aarhus,1946,11,4,7,11,17,37,-20,19
Brondby,1947,1,19,7,4,69,38,31,64
FC Midtjylla,1947,2,19,4,7,65,44,21,61
FC Nords,1947,3,17,6,7,81,51,30,57
Copenhagen,1947,4,14,5,11,63,47,16,47
AaB,1947,5,7,12,11,37,43,-6,33
AC Horsens,1947,6,6,14,10,34,52,-18,32
Sonderjyske,1947,7,8,6,10,28,29,-1,30
Randers FC,1947,8,5,7,12,23,39,-16,22
Lyngby,1947,9,3,10,11,26,44,-18,19
Silkeborg IF,1947,10,5,4,13,27,46,-19,19
AGF Aarhus,1947,11,4,7,11,18,38,-20,19
Brondby,1948,1,21,6,3,69,33,36,69
FC Midtjylla,1948,2,20,4,6,64,38,26,64
FC Nords,1948,3,15,7,8,73,48,25,52
Copenhagen,1948,4,12,5,13,51,43,8,41
AaB,1948,5,8,11,11,37,43,-6,35
AC Horsens,1948,6,7,13,10,35,50,-15,34
Sonderjyske,1948,7,8,6,10,28,29,-1,30
Lyngby,1948,8,4,9,11,29,44,-15,21
Randers FC,1948,9,5,6,13,23,42,-19,21
Silkeborg IF,1948,10,5,4,13,26,45,-19,19
AGF Aarhus,1948,11,4,7,11,17,37,-20,19
Brondby,1949,1,21,7,2,75,32,43,70
FC Midtjylla,1949,2,19,5,6,62,39,23,62
FC Nords,1949,3,14,8,8,70,50,20,50
Copenhagen,1949,4,12,7,11,54,43,11,43
AaB,1949,5,9,11,10,42,47,-5,38
Sonderjyske,1949,6,8,6,10,28,29,-1,30
AC Horsens,1949,7,5,14,11,36,54,-18,29
Randers FC,1949,8,5,7,12,24,40,-16,22
Silkeborg IF,1949,9,6,3,13,27,45,-18,21
Lyngby,1949,10,3,10,11,27,45,-18,19
AGF Aarhus,1949,11,4,6,12,17,38,-21,18
Brondby,1950,1,21,6,3,74,31,43,69
FC Midtjylla,1950,2,20,4,6,64,39,25,64
Copenhagen,1950,3,15,4,11,60,44,16,49
FC Nords,1950,4,13,6,11,70,56,14,45
AaB,1950,5,8,12,10,38,44,-6,36
AC Horsens,1950,6,6,14,10,36,54,-18,32
Sonderjyske,1950,7,8,6,10,28,29,-1,30
Lyngby,1950,8,4,9,11,27,44,-17,21
Silkeborg IF,1950,8,6,3,13,27,44,-17,21
Randers FC,1950,10,5,6,13,23,40,-17,21
AGF Aarhus,1950,11,4,6,12,16,38,-22,18
Brondby,1951,1,22,5,3,71,31,40,71
FC Midtjylla,1951,2,20,4,6,65,40,25,64
FC Nords,1951,3,13,8,9,69,50,19,47
Copenhagen,1951,4,13,7,10,57,44,13,46
AC Horsens,1951,5,6,15,9,35,50,-15,33
AaB,1951,6,6,13,11,36,44,-8,31
Sonderjyske,1951,7,8,6,10,28,29,-1,30
Randers FC,1951,8,6,6,12,24,39,-15,24
Silkeborg IF,1951,9,5,4,13,25,44,-19,19
AGF Aarhus,1951,10,4,7,11,16,36,-20,19
Lyngby,1951,11,3,9,12,26,45,-19,18
Brondby,1952,1,21,6,3,77,38,39,69
FC Midtjylla,1952,2,20,5,5,68,41,27,65
FC Nords,1952,3,14,8,8,75,53,22,50
Copenhagen,1952,4,13,5,12,60,50,10,44
AaB,1952,5,7,13,10,37,42,-5,34
AC Horsens,1952,6,6,13,11,37,56,-19,31
Sonderjyske,1952,7,8,6,10,28,29,-1,30
Randers FC,1952,8,5,7,12,23,39,-16,22
AGF Aarhus,1952,9,5,6,11,18,37,-19,21
Lyngby,1952,10,3,10,11,26,44,-18,19
Silkeborg IF,1952,11,5,3,14,26,46,-20,18
Brondby,1953,1,22,5,3,72,30,42,71
FC Midtjylla,1953,2,19,6,5,60,36,24,63
FC Nords,1953,3,15,6,9,71,52,19,51
Copenhagen,1953,4,12,6,12,51,42,9,42
AaB,1953,5,7,14,9,38,41,-3,35
Sonderjyske,1953,6,8,6,10,28,29,-1,30
AC Horsens,1953,7,5,15,10,34,51,-17,30
Randers FC,1953,8,5,7,12,23,39,-16,22
AGF Aarhus,1953,9,5,6,11,18,37,-19,21
Lyngby,1953,10,3,10,11,26,44,-18,19
Silkeborg IF,1953,11,5,3,14,26,46,-20,18
Brondby,1954,1,20,6,4,71,34,37,66
FC Midtjylla,1954,2,20,4,6,66,40,26,64
FC Nords,1954,3,15,7,8,72,49,23,52
Copenhagen,1954,4,14,4,12,58,49,9,46
AaB,1954,5,7,13,10,35,40,-5,34
AC Horsens,1954,6,6,14,10,35,51,-16,32
Sonderjyske,1954,7,8,6,10,28,29,-1,30
Lyngby,1954,8,4,9,11,27,44,-17,21
Randers FC,1954,9,5,6,13,23,40,-17,21
Silkeborg IF,1954,10,6,3,13,27,45,-18,21
AGF Aarhus,1954,11,4,6,12,17,38,-21,18
Brondby,1955,1,21,5,4,72,33,39,68
FC Midtjylla,1955,2,20,4,6,69,39,30,64
FC Nords,1955,3,14,8,8,73,52,21,50
Copenhagen,1955,4,14,5,11,55,42,13,47
AaB,1955,5,8,13,9,38,44,-6,37
Sonderjyske,1955,6,8,6,10,28,29,-1,30
AC Horsens,1955,7,5,13,12,32,55,-23,28
Randers FC,1955,8,5,7,12,24,40,-16,22
Lyngby,1955,9,3,10,11,27,45,-18,19
Silkeborg IF,1955,10,5,4,13,26,45,-19,19
AGF Aarhus,1955,11,4,7,11,17,37,-20,19
Brondby,1956,1,22,6,2,73,34,39,72
FC Midtjylla,1956,2,20,5,5,71,41,30,65
FC Nords,1956,3,14,7,9,80,55,25,49
Copenhagen,1956,4,13,5,12,59,52,7,44
AaB,1956,5,7,11,12,37,47,-10,32
AC Horsens,1956,6,6,14,10,36,53,-17,32
Sonderjyske,1956,7,8,6,10,28,29,-1,30
Randers FC,1956,8,5,7,12,24,40,-16,22
Silkeborg IF,1956,9,6,3,13,27,44,-17,21
Lyngby,1956,10,3,10,11,27,45,-18,19
AGF Aarhus,1956,11,4,6,12,16,38,-22,18
Brondby,1957,1,20,7,3,71,32,39,67
FC Midtjylla,1957,2,20,6,4,67,38,29,66
FC Nords,1957,3,13,7,10,68,52,16,46
Copenhagen,1957,4,12,8,10,57,47,10,44
AaB,1957,5,8,12,10,39,42,-3,36
AC Horsens,1957,6,6,14,10,36,53,-17,32
Sonderjyske,1957,7,8,6,10,28,29,-1,30
Randers FC,1957,8,6,6,12,24,39,-15,24
Silkeborg IF,1957,9,5,4,13,25,44,-19,19
AGF Aarhus,1957,10,4,7,11,16,36,-20,19
Lyngby,1957,11,3,9,12,26,45,-19,18
FC Midtjylla,1958,1,20,6,4,71,36,35,66
Brondby,1958,2,19,8,3,70,34,36,65
Copenhagen,1958,3,14,7,9,59,44,15,49
FC Nords,1958,4,13,8,9,69,51,18,47
AaB,1958,5,7,11,12,36,48,-12,32
AC Horsens,1958,6,6,14,10,38,56,-18,32
Sonderjyske,1958,7,8,6,10,28,29,-1,30
Lyngby,1958,8,4,9,11,29,44,-15,21
AGF Aarhus,1958,9,5,6,11,18,36,-18,21
Randers FC,1958,10,5,6,13,23,42,-19,21
Silkeborg IF,1958,11,5,3,14,25,46,-21,18
Brondby,1959,1,19,7,4,68,33,35,64
FC Midtjylla,1959,2,19,6,5,68,41,27,63
FC Nords,1959,3,16,6,8,74,49,25,54
Copenhagen,1959,4,14,5,11,62,47,15,47
AaB,1959,5,8,12,10,37,41,-4,36
Sonderjyske,1959,6,8,6,10,28,29,-1,30
AC Horsens,1959,7,6,12,12,32,56,-24,30
Randers FC,1959,8,6,6,12,27,41,-14,24
Silkeborg IF,1959,9,5,4,13,28,47,-19,19
AGF Aarhus,1959,10,4,7,11,19,39,-20,19
Lyngby,1959,11,3,9,12,28,48,-20,18
FC Midtjylla,1960,1,20,6,4,71,39,32,66
Brondby,1960,2,19,8,3,71,37,34,65
FC Nords,1960,3,14,7,9,74,52,22,49
Copenhagen,1960,4,13,7,10,59,47,12,46
AaB,1960,5,7,12,11,40,45,-5,33
AC Horsens,1960,6,7,12,11,37,58,-21,33
Sonderjyske,1960,7,8,6,10,28,29,-1,30
Lyngby,1960,8,4,9,11,29,45,-16,21
Silkeborg IF,1960,9,6,3,13,27,44,-17,21
Randers FC,1960,10,5,6,13,24,42,-18,21
AGF Aarhus,1960,11,4,6,12,16,38,-22,18
Brondby,1961,1,19,8,3,69,34,35,65
FC Midtjylla,1961,2,20,4,6,67,36,31,64
FC Nords,1961,3,14,8,8,71,51,20,50
Copenhagen,1961,4,14,6,10,59,43,16,48
AaB,1961,5,8,13,9,37,44,-7,37
Sonderjyske,1961,6,8,6,10,28,29,-1,30
AC Horsens,1961,7,5,13,12,34,55,-21,28
Lyngby,1961,8,4,9,11,27,44,-17,21
Randers FC,1961,9,5,6,13,23,40,-17,21
Silkeborg IF,1961,10,5,4,13,26,45,-19,19
AGF Aarhus,1961,11,4,7,11,17,37,-20,19
Brondby,1962,1,21,6,3,72,32,40,69
FC Midtjylla,1962,2,19,5,6,66,41,25,62
FC Nords,1962,3,14,6,10,75,54,21,48
Copenhagen,1962,4,14,6,10,60,46,14,48
AaB,1962,5,7,13,10,36,44,-8,34
AC Horsens,1962,6,6,14,10,34,52,-18,32
Sonderjyske,1962,7,8,6,10,28,29,-1,30
Lyngby,1962,8,4,9,11,30,45,-15,21
Randers FC,1962,9,5,6,13,24,43,-19,21
AGF Aarhus,1962,10,5,6,11,17,36,-19,21
Silkeborg IF,1962,11,5,3,14,25,45,-20,18
Brondby,1963,1,21,6,3,75,34,41,69
FC Midtjylla,1963,2,19,4,7,64,42,22,61
FC Nords,1963,3,15,6,9,73,52,21,51
Copenhagen,1963,4,15,4,11,59,44,15,49
AaB,1963,5,9,11,10,40,42,-2,38
Sonderjyske,1963,6,8,6,10,28,29,-1,30
AC Horsens,1963,7,5,13,12,32,55,-23,28
Lyngby,1963,8,4,9,11,28,45,-17,21
Randers FC,1963,9,5,6,13,24,41,-17,21
Silkeborg IF,1963,10,5,4,13,25,44,-19,19
AGF Aarhus,1963,11,4,7,11,16,36,-20,19
Brondby,1964,1,21,6,3,72,33,39,69
FC Midtjylla,1964,2,18,7,5,62,37,25,61
Copenhagen,1964,3,16,4,10,60,40,20,52
FC Nords,1964,4,13,8,9,69,51,18,47
AC Horsens,1964,5,7,13,10,36,51,-15,34
Sonderjyske,1964,6,8,6,10,28,29,-1,30
AaB,1964,7,6,12,12,37,50,-13,30
Randers FC,1964,8,5,7,12,25,41,-16,22
Silkeborg IF,1964,9,6,3,13,27,44,-17,21
Lyngby,1964,10,3,10,11,28,46,-18,19
AGF Aarhus,1964,11,4,6,12,16,38,-22,18
Brondby,1965,1,21,6,3,72,34,38,69
FC Midtjylla,1965,2,19,4,7,74,43,31,61
FC Nords,1965,3,14,7,9,72,57,15,49
Copenhagen,1965,4,13,4,13,54,47,7,43
AaB,1965,5,8,13,9,42,47,-5,37
AC Horsens,1965,6,8,12,10,38,50,-12,36
Sonderjyske,1965,7,8,6,10,28,29,-1,30
Randers FC,1965,8,6,6,12,25,39,-14,24
AGF Aarhus,1965,9,5,6,11,20,39,-19,21
Silkeborg IF,1965,10,5,3,14,28,48,-20,18
Lyngby,1965,11,3,9,12,26,46,-20,18
Brondby,1966,1,20,7,3,72,36,36,67
FC Midtjylla,1966,2,20,6,4,68,40,28,66
FC Nords,1966,3,15,6,9,81,55,26,51
Copenhagen,1966,4,14,5,11,59,47,12,47
AaB,1966,5,6,13,11,37,45,-8,31
AC Horsens,1966,6,6,13,11,37,57,-20,31
Sonderjyske,1966,7,8,6,10,28,29,-1,30
Randers FC,1966,8,6,6,12,24,39,-15,24
Silkeborg IF,1966,9,5,4,13,25,44,-19,19
AGF Aarhus,1966,10,4,7,11,16,36,-20,19
Lyngby,1966,11,3,9,12,26,45,-19,18
Brondby,1967,1,21,7,2,75,33,42,70
FC Midtjylla,1967,2,19,6,5,66,41,25,63
FC Nords,1967,3,14,8,8,79,53,26,50
Copenhagen,1967,4,13,7,10,62,51,11,46
AaB,1967,5,6,13,11,36,45,-9,31
Sonderjyske,1967,6,8,6,10,28,29,-1,30
AC Horsens,1967,7,5,15,10,36,57,-21,30
Lyngby,1967,8,4,9,11,31,45,-14,21
AGF Aarhus,1967,9,5,6,11,17,36,-19,21
Randers FC,1967,10,5,6,13,24,44,-20,21
Silkeborg IF,1967,11,5,3,14,25,45,-20,18
Brondby,1968,1,22,5,3,74,30,44,71
FC Midtjylla,1968,2,20,4,6,64,39,25,64
FC Nords,1968,3,15,6,9,75,52,23,51
Copenhagen,1968,4,15,5,10,55,40,15,50
AaB,1968,5,6,13,11,35,43,-8,31
Sonderjyske,1968,6,8,6,10,28,29,-1,30
AC Horsens,1968,7,5,13,12,31,56,-25,28
Randers FC,1968,8,6,6,12,24,39,-15,24
Silkeborg IF,1968,9,6,3,13,27,45,-18,21
Lyngby,1968,10,3,9,12,26,45,-19,18
AGF Aarhus,1968,11,4,6,12,17,38,-21,18
Brondby,1969,1,21,6,3,76,34,42,69
FC Midtjylla,1969,2,18,5,7,61,42,19,59
Copenhagen,1969,3,16,5,9,59,41,18,53
FC Nords,1969,4,13,6,11,71,55,16,45
AaB,1969,5,8,12,10,38,43,-5,36
AC Horsens,1969,6,6,14,10,36,52,-16,32
Sonderjyske,1969,7,8,6,10,28,29,-1,30
Randers FC,1969,8,5,7,12,23,39,-16,22
Silkeborg IF,1969,9,6,3,13,28,45,-17,21
Lyngby,1969,10,3,10,11,26,44,-18,19
AGF Aarhus,1969,11,4,6,12,17,39,-22,18
Brondby,1970,1,20,7,3,73,33,40,67
FC Midtjylla,1970,2,20,4,6,66,37,29,64
FC Nords,1970,3,16,7,7,75,47,28,55
Copenhagen,1970,4,13,5,12,53,48,5,44
AC Horsens,1970,5,7,12,11,34,54,-20,33
AaB,1970,6,6,13,11,32,40,-8,31
Sonderjyske,1970,7,8,6,10,28,29,-1,30
Silkeborg IF,1970,8,6,3,13,29,45,-16,21
Lyngby,1970,9,4,9,11,28,44,-16,21
Randers FC,1970,10,5,6,13,23,41,-18,21
AGF Aarhus,1970,11,4,6,12,17,40,-23,18
Brondby,1971,1,21,6,3,73,30,43,69
FC Midtjylla,1971,2,18,6,6,68,47,21,60
FC Nords,1971,3,15,7,8,77,51,26,52
Copenhagen,1971,4,14,5,11,56,47,9,47
AaB,1971,5,6,16,8,38,42,-4,34
Sonderjyske,1971,6,8,6,10,28,29,-1,30
AC Horsens,1971,7,5,14,11,34,55,-21,29
Lyngby,1971,8,4,9,11,28,45,-17,21
Randers FC,1971,9,5,6,13,24,41,-17,21
AGF Aarhus,1971,10,5,6,11,18,37,-19,21
Silkeborg IF,1971,11,5,3,14,26,46,-20,18
Brondby,1972,1,22,5,3,73,29,44,71
FC Midtjylla,1972,2,20,4,6,66,39,27,64
FC Nords,1972,3,14,7,9,73,51,22,49
Copenhagen,1972,4,12,6,12,51,48,3,42
AC Horsens,1972,5,8,13,9,38,50,-12,37
AaB,1972,6,7,11,12,38,48,-10,32
Sonderjyske,1972,7,8,6,10,28,29,-1,30
Randers FC,1972,8,5,7,12,24,40,-16,22
Lyngby,1972,9,3,10,11,27,45,-18,19
Silkeborg IF,1972,10,5,4,13,26,45,-19,19
AGF Aarhus,1972,11,4,7,11,17,37,-20,19
Brondby,1973,1,20,7,3,68,32,36,67
FC Midtjylla,1973,2,19,7,4,68,40,28,64
Copenhagen,1973,3,13,7,10,57,46,11,46
FC Nords,1973,4,13,6,11,72,53,19,45
AaB,1973,5,9,12,9,40,44,-4,39
AC Horsens,1973,6,6,13,11,33,49,-16,31
Sonderjyske,1973,7,8,6,10,28,29,-1,30
Randers FC,1973,8,5,7,12,24,40,-16,22
Silkeborg IF,1973,9,6,3,13,26,44,-18,21
Lyngby,1973,10,3,10,11,27,45,-18,19
AGF Aarhus,1973,11,4,6,12,16,37,-21,18
Brondby,1974,1,21,6,3,73,33,40,69
FC Midtjylla,1974,2,21,4,5,69,37,32,67
Copenhagen,1974,3,15,6,9,61,42,19,51
FC Nords,1974,4,12,6,12,70,60,10,42
AaB,1974,5,8,12,10,37,44,-7,36
Sonderjyske,1974,6,8,6,10,28,29,-1,30
AC Horsens,1974,7,6,12,12,33,53,-20,30
Randers FC,1974,8,6,6,12,25,40,-15,24
Silkeborg IF,1974,9,6,3,13,27,45,-18,21
Lyngby,1974,10,3,9,12,27,46,-19,18
AGF Aarhus,1974,11,4,6,12,17,38,-21,18
Brondby,1975,1,20,8,2,69,29,40,68
FC Midtjylla,1975,2,20,5,5,67,41,26,65
FC Nords,1975,3,14,8,8,77,56,21,50
Copenhagen,1975,4,13,7,10,59,45,14,46
AaB,1975,5,6,14,10,36,43,-7,32
Sonderjyske,1975,6,8,6,10,28,29,-1,30
AC Horsens,1975,7,5,14,11,34,54,-20,29
Lyngby,1975,8,4,9,11,32,44,-12,21
Silkeborg IF,1975,9,6,3,13,27,45,-18,21
Randers FC,1975,10,5,6,13,23,45,-22,21
AGF Aarhus,1975,11,4,6,12,17,38,-21,18
Brondby,1976,1,20,6,4,68,34,34,66
FC Midtjylla,1976,2,20,5,5,66,38,28,65
FC Nords,1976,3,14,7,9,73,52,21,49
Copenhagen,1976,4,14,4,12,59,48,11,46
AC Horsens,1976,5,7,14,9,38,48,-10,35
AaB,1976,6,7,12,11,35,45,-10,33
Sonderjyske,1976,7,8,6,10,28,29,-1,30
Randers FC,1976,8,5,7,12,24,40,-16,22
Silkeborg IF,1976,9,6,3,13,28,45,-17,21
Lyngby,1976,10,3,10,11,27,45,-18,19
AGF Aarhus,1976,11,4,6,12,17,39,-22,18
Brondby,1977,1,20,6,4,70,32,38,66
FC Midtjylla,1977,2,20,5,5,67,40,27,65
FC Nords,1977,3,15,7,8,73,48,25,52
Copenhagen,1977,4,13,4,13,55,49,6,43
AaB,1977,5,7,13,10,37,43,-6,34
AC Horsens,1977,6,7,13,10,37,53,-16,34
Sonderjyske,1977,7,8,6,10,28,29,-1,30
Lyngby,1977,8,4,9,11,27,44,-17,21
Randers FC,1977,9,5,6,13,23,40,-17,21
AGF Aarhus,1977,10,5,6,11,18,37,-19,21
Silkeborg IF,1977,11,5,3,14,26,46,-20,18
Brondby,1978,1,21,6,3,77,29,48,69
FC Midtjylla,1978,2,19,5,6,67,43,24,62
FC Nords,1978,3,17,6,7,74,48,26,57
Copenhagen,1978,4,14,5,11,59,43,16,47
AaB,1978,5,7,11,12,38,53,-15,32
Sonderjyske,1978,6,8,6,10,28,29,-1,30
AC Horsens,1978,7,5,13,12,31,56,-25,28
Randers FC,1978,8,6,6,12,25,39,-14,24
Silkeborg IF,1978,9,5,4,13,27,46,-19,19
AGF Aarhus,1978,10,4,7,11,18,38,-20,19
Lyngby,1978,11,3,9,12,26,46,-20,18
FC Midtjylla,1979,1,21,5,4,70,36,34,68
Brondby,1979,2,19,6,5,65,33,32,63
Copenhagen,1979,3,15,6,9,62,40,22,51
FC Nords,1979,4,14,6,10,75,55,20,48
AaB,1979,5,7,12,11,34,45,-11,33
AC Horsens,1979,6,6,13,11,33,56,-23,31
Sonderjyske,1979,7,8,6,10,28,29,-1,30
Randers FC,1979,8,6,6,12,24,39,-15,24
AGF Aarhus,1979,9,5,6,11,17,36,-19,21
Lyngby,1979,10,3,9,12,26,45,-19,18
Silkeborg IF,1979,11,5,3,14,25,45,-20,18
Brondby,1980,1,20,6,4,72,36,36,66
FC Midtjylla,1980,2,20,5,5,64,37,27,65
Copenhagen,1980,3,15,5,10,59,44,15,50
FC Nords,1980,4,14,6,10,73,54,19,48
AaB,1980,5,8,12,10,38,42,-4,36
Sonderjyske,1980,6,8,6,10,28,29,-1,30
AC Horsens,1980,7,6,12,12,37,56,-19,30
Randers FC,1980,8,5,7,12,23,39,-16,22
Silkeborg IF,1980,9,6,3,13,26,44,-18,21
Lyngby,1980,10,3,10,11,26,44,-18,19
AGF Aarhus,1980,11,4,6,12,16,37,-21,18
Brondby,1981,1,22,5,3,73,38,35,71
FC Midtjylla,1981,2,20,4,6,66,38,28,64
FC Nords,1981,3,14,7,9,77,56,21,49
Copenhagen,1981,4,13,6,11,62,47,15,45
AaB,1981,5,8,13,9,40,42,-2,37
Sonderjyske,1981,6,8,6,10,28,29,-1,30
AC Horsens,1981,7,5,13,12,33,56,-23,28
Randers FC,1981,8,6,6,12,26,40,-14,24
Silkeborg IF,1981,9,6,3,13,26,44,-18,21
Lyngby,1981,10,3,9,12,27,47,-20,18
AGF Aarhus,1981,11,4,6,12,16,37,-21,18
Brondby,1982,1,20,6,4,67,33,34,66
FC Midtjylla,1982,2,19,5,6,64,38,26,62
FC Nords,1982,3,16,6,8,84,52,32,54
Copenhagen,1982,4,14,5,11,59,47,12,47
AaB,1982,5,7,13,10,36,44,-8,34
Sonderjyske,1982,6,8,6,10,28,29,-1,30
AC Horsens,1982,7,5,15,10,32,54,-22,30
Randers FC,1982,8,5,7,12,24,40,-16,22
Silkeborg IF,1982,9,6,3,13,26,44,-18,21
Lyngby,1982,10,3,10,11,27,45,-18,19
AGF Aarhus,1982,11,4,6,12,16,37,-21,18
Brondby,1983,1,19,9,2,67,31,36,66
FC Midtjylla,1983,2,18,7,5,62,40,22,61
FC Nords,1983,3,14,8,8,73,49,24,50
Copenhagen,1983,4,14,6,10,59,43,16,48
AaB,1983,5,6,14,10,36,43,-7,32
AC Horsens,1983,6,6,14,10,32,49,-17,32
Sonderjyske,1983,7,8,6,10,28,29,-1,30
Lyngby,1983,8,4,9,11,30,44,-14,21
Silkeborg IF,1983,9,6,3,13,27,45,-18,21
Randers FC,1983,10,5,6,13,23,43,-20,21
AGF Aarhus,1983,11,4,6,12,17,38,-21,18
Brondby,1984,1,22,6,2,77,34,43,72
FC Midtjylla,1984,2,18,5,7,63,44,19,59
Copenhagen,1984,3,15,5,10,62,47,15,50
FC Nords,1984,4,13,7,10,70,52,18,46
AaB,1984,5,7,13,10,37,44,-7,34
AC Horsens,1984,6,6,14,10,40,54,-14,32
Sonderjyske,1984,7,8,6,10,28,29,-1,30
Randers FC,1984,8,5,7,12,24,40,-16,22
AGF Aarhus,1984,9,5,6,11,18,37,-19,21
Lyngby,1984,10,3,10,11,27,45,-18,19
Silkeborg IF,1984,11,5,3,14,26,46,-20,18
Brondby,1985,1,20,6,4,69,33,36,66
FC Midtjylla,1985,2,19,5,6,63,39,24,62
FC Nords,1985,3,14,7,9,71,53,18,49
Copenhagen,1985,4,13,5,12,58,46,12,44
AaB,1985,5,9,11,10,37,40,-3,38
AC Horsens,1985,6,7,14,9,36,49,-13,35
Sonderjyske,1985,7,8,6,10,28,29,-1,30
Lyngby,1985,8,4,9,11,28,44,-16,21
Randers FC,1985,9,5,6,13,23,41,-18,21
AGF Aarhus,1985,10,5,6,11,17,36,-19,21
Silkeborg IF,1985,11,5,3,14,25,45,-20,18
FC Midtjylla,1986,1,21,4,5,76,39,37,67
Brondby,1986,2,19,8,3,73,38,35,65
Copenhagen,1986,3,14,6,10,62,45,17,48
FC Nords,1986,4,12,8,10,71,58,13,44
AC Horsens,1986,5,7,14,9,37,57,-20,35
AaB,1986,6,6,14,10,35,43,-8,32
Sonderjyske,1986,7,8,6,10,28,29,-1,30
Randers FC,1986,8,6,6,12,24,39,-15,24
Silkeborg IF,1986,9,6,3,13,26,44,-18,21
Lyngby,1986,10,3,9,12,26,45,-19,18
AGF Aarhus,1986,11,4,6,12,16,37,-21,18
Brondby,1987,1,18,9,3,70,38,32,63
FC Midtjylla,1987,2,19,5,6,65,47,18,62
FC Nords,1987,3,15,8,7,79,47,32,53
Copenhagen,1987,4,15,5,10,63,45,18,50
AC Horsens,1987,5,6,14,10,35,49,-14,32
AaB,1987,6,6,13,11,37,49,-12,31
Sonderjyske,1987,7,8,6,10,28,29,-1,30
Randers FC,1987,8,5,7,12,24,40,-16,22
Silkeborg IF,1987,9,6,3,13,26,44,-18,21
Lyngby,1987,10,3,10,11,27,45,-18,19
AGF Aarhus,1987,11,4,6,12,16,37,-21,18
Brondby,1988,1,22,5,3,72,30,42,71
FC Midtjylla,1988,2,20,4,6,70,39,31,64
FC Nords,1988,3,15,6,9,75,54,21,51
Copenhagen,1988,4,15,4,11,58,43,15,49
AC Horsens,1988,5,6,13,11,33,54,-21,31
Sonderjyske,1988,6,8,6,10,28,29,-1,30
AaB,1988,7,6,12,12,34,48,-14,30
Lyngby,1988,8,4,9,11,31,45,-14,21
Silkeborg IF,1988,9,6,3,13,27,45,-18,21
Randers FC,1988,10,5,6,13,24,44,-20,21
AGF Aarhus,1988,11,4,6,12,17,38,-21,18
Brondby,1989,1,21,6,3,70,32,38,69
FC Midtjylla,1989,2,21,4,5,66,37,29,67
FC Nords,1989,3,14,6,10,76,52,24,48
Copenhagen,1989,4,13,5,12,54,43,11,44
AaB,1989,5,8,11,11,37,44,-7,35
AC Horsens,1989,6,6,14,10,37,58,-21,32
Sonderjyske,1989,7,8,6,10,28,29,-1,30
Lyngby,1989,8,4,9,11,30,46,-16,21
Silkeborg IF,1989,9,6,3,13,27,45,-18,21
Randers FC,1989,10,5,6,13,25,43,-18,21
AGF Aarhus,1989,11,4,6,12,17,38,-21,18
FC Midtjylla,1990,1,21,5,4,69,36,33,68
Brondby,1990,2,20,5,5,68,36,32,65
FC Nords,1990,3,16,6,8,76,47,29,54
Copenhagen,1990,4,14,5,11,56,43,13,47
AaB,1990,5,7,11,12,35,51,-16,32
Sonderjyske,1990,6,8,6,10,28,29,-1,30
AC Horsens,1990,7,6,12,12,36,53,-17,30
Randers FC,1990,8,6,6,12,24,39,-15,24
Silkeborg IF,1990,9,6,3,13,29,47,-18,21
Lyngby,1990,10,3,9,12,26,45,-19,18
AGF Aarhus,1990,11,4,6,12,19,40,-21,18
Brondby,1991,1,21,5,4,71,34,37,68
FC Midtjylla,1991,2,20,5,5,66,37,29,65
Copenhagen,1991,3,15,5,10,60,45,15,50
FC Nords,1991,4,12,9,9,74,56,18,45
AaB,1991,5,8,12,10,41,43,-2,36
Sonderjyske,1991,6,8,6,10,28,29,-1,30
AC Horsens,1991,7,5,14,11,33,56,-23,29
Randers FC,1991,8,6,6,12,25,39,-14,24
Silkeborg IF,1991,9,6,3,13,28,45,-17,21
Lyngby,1991,10,3,9,12,26,46,-20,18
AGF Aarhus,1991,11,4,6,12,17,39,-22,18
Brondby,1992,1,19,7,4,67,31,36,64
FC Midtjylla,1992,2,19,6,5,66,40,26,63
FC Nords,1992,3,15,6,9,75,55,20,51
Copenhagen,1992,4,13,6,11,58,46,12,45
AaB,1992,5,10,11,9,41,40,1,41
Sonderjyske,1992,6,8,6,10,28,29,-1,30
AC Horsens,1992,7,5,14,11,34,55,-21,29
Lyngby,1992,8,4,9,11,28,45,-17,21
Randers FC,1992,9,5,6,13,24,41,-17,21
Silkeborg IF,1992,10,5,4,13,27,46,-19,19
AGF Aarhus,1992,11,4,7,11,18,38,-20,19
Brondby,1993,1,20,8,2,75,33,42,68
FC Midtjylla,1993,2,18,5,7,62,41,21,59
FC Nords,1993,3,16,7,7,75,48,27,55
Copenhagen,1993,4,13,6,11,56,45,11,45
AaB,1993,5,8,12,10,42,51,-9,36
Sonderjyske,1993,6,8,6,10,28,29,-1,30
AC Horsens,1993,7,5,14,11,33,51,-18,29
Randers FC,1993,8,5,7,12,25,41,-16,22
Silkeborg IF,1993,9,6,3,13,26,44,-18,21
Lyngby,1993,10,3,10,11,28,46,-18,19
AGF Aarhus,1993,11,4,6,12,16,37,-21,18
Brondby,1994,1,21,5,4,74,37,37,68
FC Midtjylla,1994,2,20,4,6,66,39,27,64
FC Nords,1994,3,16,6,8,75,49,26,54
Copenhagen,1994,4,15,4,11,61,45,16,49
AaB,1994,5,7,11,12,37,47,-10,32
Sonderjyske,1994,6,8,6,10,28,29,-1,30
AC Horsens,1994,7,6,12,12,33,55,-22,30
Randers FC,1994,8,6,6,12,26,40,-14,24
Silkeborg IF,1994,9,6,3,13,30,46,-16,21
Lyngby,1994,10,3,9,12,27,47,-20,18
AGF Aarhus,1994,11,4,6,12,18,41,-23,18
Brondby,1995,1,21,6,3,70,32,38,69
FC Midtjylla,1995,2,20,4,6,66,39,27,64
FC Nords,1995,3,15,6,9,75,53,22,51
Copenhagen,1995,4,13,6,11,55,43,12,45
AaB,1995,5,7,12,11,36,44,-8,33
AC Horsens,1995,6,6,14,10,35,52,-17,32
Sonderjyske,1995,7,8,6,10,28,29,-1,30
Randers FC,1995,8,5,7,12,23,39,-16,22
Lyngby,1995,9,3,10,11,26,44,-18,19
Silkeborg IF,1995,10,5,4,13,25,44,-19,19
AGF Aarhus,1995,11,4,7,11,16,36,-20,19
Brondby,1996,1,22,5,3,73,31,42,71
FC Midtjylla,1996,2,18,5,7,63,41,22,59
FC Nords,1996,3,13,6,11,69,55,14,45
Copenhagen,1996,4,13,6,11,56,43,13,45
AaB,1996,5,9,11,10,40,43,-3,38
AC Horsens,1996,6,8,13,9,40,54,-14,37
Sonderjyske,1996,7,8,6,10,28,29,-1,30
Lyngby,1996,8,4,9,11,28,44,-16,21
Silkeborg IF,1996,8,6,3,13,28,44,-16,21
Randers FC,1996,10,5,6,13,23,41,-18,21
AGF Aarhus,1996,11,4,6,12,16,39,-23,18
Brondby,1997,1,20,7,3,72,34,38,67
FC Midtjylla,1997,2,19,5,6,65,41,24,62
FC Nords,1997,3,16,6,8,79,50,29,54
Copenhagen,1997,4,13,4,13,57,51,6,43
AaB,1997,5,8,11,11,37,44,-7,35
AC Horsens,1997,6,7,13,10,33,49,-16,34
Sonderjyske,1997,7,8,6,10,28,29,-1,30
Lyngby,1997,8,4,9,11,27,44,-17,21
Randers FC,1997,9,5,6,13,23,40,-17,21
AGF Aarhus,1997,10,5,6,11,17,36,-19,21
Silkeborg IF,1997,11,5,3,14,25,45,-20,18
Brondby,1998,1,21,5,4,70,32,38,68
FC Midtjylla,1998,2,21,4,5,67,39,28,67
FC Nords,1998,3,14,8,8,71,47,24,50
Copenhagen,1998,4,12,5,13,56,48,8,41
AaB,1998,5,8,12,10,35,40,-5,36
AC Horsens,1998,6,7,12,11,36,55,-19,33
Sonderjyske,1998,7,8,6,10,28,29,-1,30
Lyngby,1998,8,4,9,11,28,44,-16,21
Randers FC,1998,9,5,6,13,23,41,-18,21
AGF Aarhus,1998,10,5,6,11,17,36,-19,21
Silkeborg IF,1998,11,5,3,14,25,45,-20,18
Brondby,1999,1,22,5,3,72,29,43,71
FC Midtjylla,1999,2,20,4,6,64,38,26,64
FC Nords,1999,3,13,6,11,70,57,13,45
Copenhagen,1999,4,13,5,12,57,49,8,44
AaB,1999,5,8,13,9,38,41,-3,37
AC Horsens,1999,6,7,13,10,37,50,-13,34
Sonderjyske,1999,7,8,6,10,28,29,-1,30
Lyngby,1999,8,4,9,11,27,44,-17,21
Randers FC,1999,9,5,6,13,23,40,-17,21
Silkeborg IF,1999,10,6,3,13,27,45,-18,21
AGF Aarhus,1999,11,4,6,12,17,38,-21,18
FC Midtjylla,2000,1,22,4,4,75,38,37,70
Brondby,2000,2,19,7,4,70,38,32,64
Copenhagen,2000,3,15,5,10,59,46,13,50
FC Nords,2000,4,14,6,10,74,51,23,48
AaB,2000,5,6,14,10,34,45,-11,32
Sonderjyske,2000,6,8,6,10,28,29,-1,30
AC Horsens,2000,7,5,14,11,36,56,-20,29
Lyngby,2000,8,4,9,11,29,45,-16,21
Randers FC,2000,9,5,6,13,24,42,-18,21
AGF Aarhus,2000,10,5,6,11,17,36,-19,21
Silkeborg IF,2000,11,5,3,14,25,45,-20,18
Brondby,2001,1,21,5,4,74,36,38,68
FC Midtjylla,2001,2,19,5,6,66,41,25,62
FC Nords,2001,3,15,7,8,72,47,25,52
Copenhagen,2001,4,13,6,11,55,42,13,45
AC Horsens,2001,5,8,12,10,34,50,-16,36
AaB,2001,6,7,11,12,34,45,-11,32
Sonderjyske,2001,7,8,6,10,28,29,-1,30
Randers FC,2001,8,5,7,12,24,40,-16,22
Lyngby,2001,9,3,10,11,27,45,-18,19
Silkeborg IF,2001,10,5,4,13,25,44,-19,19
AGF Aarhus,2001,11,4,7,11,16,36,-20,19
Brondby,2002,1,22,5,3,74,31,43,71
FC Midtjylla,2002,2,19,4,7,63,42,21,61
FC Nords,2002,3,15,6,9,74,55,19,51
Copenhagen,2002,4,14,5,11,59,44,15,47
AaB,2002,5,7,12,11,41,46,-5,33
AC Horsens,2002,6,7,12,11,35,54,-19,33
Sonderjyske,2002,7,8,6,10,28,29,-1,30
Randers FC,2002,8,5,7,12,23,39,-16,22
Silkeborg IF,2002,9,6,3,13,28,45,-17,21
Lyngby,2002,10,3,10,11,26,44,-18,19
AGF Aarhus,2002,11,4,6,12,17,39,-22,18
Brondby,2003,1,20,6,4,69,36,33,66
FC Midtjylla,2003,2,20,5,5,66,40,26,65
FC Nords,2003,3,15,7,8,78,50,28,52
Copenhagen,2003,4,13,5,12,56,47,9,44
AaB,2003,5,8,12,10,40,42,-2,36
AC Horsens,2003,6,6,13,11,35,55,-20,31
Sonderjyske,2003,7,8,6,10,28,29,-1,30
Randers FC,2003,8,6,6,12,24,39,-15,24
Silkeborg IF,2003,9,5,4,13,28,47,-19,19
AGF Aarhus,2003,10,4,7,11,19,39,-20,19
Lyngby,2003,11,3,9,12,26,45,-19,18
Brondby,2004,1,22,5,3,75,30,45,71
FC Midtjylla,2004,2,20,5,5,66,42,24,65
FC Nords,2004,3,15,6,9,77,54,23,51
Copenhagen,2004,4,13,4,13,54,49,5,43
AaB,2004,5,7,13,10,36,43,-7,34
AC Horsens,2004,6,6,13,11,35,51,-16,31
Sonderjyske,2004,7,8,6,10,28,29,-1,30
Randers FC,2004,8,5,7,12,24,40,-16,22
Silkeborg IF,2004,9,6,3,13,29,44,-15,21
Lyngby,2004,10,3,10,11,27,45,-18,19
AGF Aarhus,2004,11,4,6,12,16,40,-24,18
Brondby,2005,1,21,6,3,74,31,43,69
FC Midtjylla,2005,2,20,4,6,65,42,23,64
FC Nords,2005,3,15,7,8,76,52,24,52
Copenhagen,2005,4,13,7,10,57,45,12,46
AaB,2005,5,7,12,11,34,44,-10,33
Sonderjyske,2005,6,8,6,10,28,29,-1,30
AC Horsens,2005,7,5,14,11,39,57,-18,29
Randers FC,2005,8,5,7,12,23,39,-16,22
Lyngby,2005,9,3,10,11,26,44,-18,19
Silkeborg IF,2005,10,5,4,13,26,45,-19,19
AGF Aarhus,2005,11,4,7,11,17,37,-20,19
FC Midtjylla,2006,1,20,5,5,66,39,27,65
Brondby,2006,2,18,8,4,67,35,32,62
FC Nords,2006,3,15,7,8,77,48,29,52
Copenhagen,2006,4,13,6,11,58,51,7,45
AC Horsens,2006,5,7,14,9,36,50,-14,35
AaB,2006,6,7,12,11,34,41,-7,33
Sonderjyske,2006,7,8,6,10,28,29,-1,30
Lyngby,2006,8,4,9,11,29,46,-17,21
Randers FC,2006,9,5,6,13,25,42,-17,21
AGF Aarhus,2006,10,5,6,11,18,37,-19,21
Silkeborg IF,2006,11,5,3,14,26,46,-20,18
Brondby,2007,1,22,5,3,76,33,43,71
FC Midtjylla,2007,2,18,5,7,67,41,26,59
FC Nords,2007,3,15,7,8,75,55,20,52
Copenhagen,2007,4,12,7,11,52,42,10,43
AaB,2007,5,7,13,10,35,42,-7,34
AC Horsens,2007,6,7,13,10,37,55,-18,34
Sonderjyske,2007,7,8,6,10,28,29,-1,30
Randers FC,2007,8,6,6,12,24,39,-15,24
AGF Aarhus,2007,9,5,6,11,18,36,-18,21
Lyngby,2007,10,3,9,12,26,45,-19,18
Silkeborg IF,2007,11,5,3,14,25,46,-21,18
Brondby,2008,1,21,6,3,71,30,41,69
FC Midtjylla,2008,2,20,6,4,69,39,30,66
Copenhagen,2008,3,14,6,10,56,41,15,48
FC Nords,2008,4,13,7,10,69,53,16,46
AaB,2008,5,7,13,10,37,45,-8,34
Sonderjyske,2008,6,8,6,10,28,29,-1,30
AC Horsens,2008,7,5,14,11,34,54,-20,29
Randers FC,2008,8,6,6,12,26,40,-14,24
Silkeborg IF,2008,9,6,3,13,28,45,-17,21
Lyngby,2008,10,3,9,12,27,47,-20,18
AGF Aarhus,2008,11,4,6,12,17,39,-22,18
Brondby,2009,1,22,6,2,80,31,49,72
FC Midtjylla,2009,2,20,6,4,69,38,31,66
Copenhagen,2009,3,14,6,10,60,44,16,48
FC Nords,2009,4,13,7,10,68,58,10,46
AaB,2009,5,7,12,11,36,46,-10,33
Sonderjyske,2009,6,8,6,10,28,29,-1,30
AC Horsens,2009,7,5,13,12,32,54,-22,28
Lyngby,2009,8,4,9,11,28,44,-16,21
Silkeborg IF,2009,9,6,3,13,26,44,-18,21
Randers FC,2009,10,5,6,13,23,41,-18,21
AGF Aarhus,2009,11,4,6,12,16,37,-21,18
Brondby,2010,1,20,7,3,67,33,34,67
FC Midtjylla,2010,2,18,8,4,67,39,28,62
FC Nords,2010,3,13,7,10,73,54,19,46
Copenhagen,2010,4,13,6,11,57,46,11,45
AaB,2010,5,9,12,9,37,40,-3,39
AC Horsens,2010,6,7,12,11,37,52,-15,33
Sonderjyske,2010,7,8,6,10,28,29,-1,30
Lyngby,2010,8,4,9,11,28,44,-16,21
Randers FC,2010,9,5,6,13,23,41,-18,21
AGF Aarhus,2010,10,5,6,11,17,36,-19,21
Silkeborg IF,2010,11,5,3,14,25,45,-20,18
Brondby,2011,1,19,7,4,67,33,34,64
FC Midtjylla,2011,2,19,5,6,65,39,26,62
FC Nords,2011,3,16,6,8,77,50,27,54
Copenhagen,2011,4,14,4,12,60,47,13,46
AC Horsens,2011,5,8,13,9,38,56,-18,37
AaB,2011,6,7,11,12,34,42,-8,32
Sonderjyske,2011,7,8,6,10,28,29,-1,30
Lyngby,2011,8,4,9,11,30,45,-15,21
AGF Aarhus,2011,9,5,6,11,18,36,-18,21
Randers FC,2011,10,5,6,13,24,43,-19,21
Silkeborg IF,2011,11,5,3,14,25,46,-21,18
Brondby,2012,1,21,5,4,70,35,35,68
FC Midtjylla,2012,2,18,6,6,65,38,27,60
Copenhagen,2012,3,15,6,9,58,41,17,51
FC Nords,2012,4,14,8,8,74,49,25,50
AC Horsens,2012,5,7,13,10,37,56,-19,34
Sonderjyske,2012,6,8,6,10,28,29,-1,30
AaB,2012,7,6,12,12,37,48,-11,30
Randers FC,2012,8,6,6,12,27,40,-13,24
AGF Aarhus,2012,9,5,6,11,18,37,-19,21
Silkeborg IF,2012,10,5,3,14,26,46,-20,18
Lyngby,2012,11,3,9,12,27,48,-21,18
Brondby,2013,1,20,7,3,68,30,38,67
FC Midtjylla,2013,2,20,5,5,69,42,27,65
FC Nords,2013,3,14,7,9,74,54,20,49
Copenhagen,2013,4,12,7,11,56,45,11,43
AC Horsens,2013,5,8,13,9,36,48,-12,37
AaB,2013,6,6,13,11,35,45,-10,31
Sonderjyske,2013,7,8,6,10,28,29,-1,30
Randers FC,2013,8,6,6,12,26,40,-14,24
Silkeborg IF,2013,9,6,3,13,27,44,-17,21
Lyngby,2013,10,3,9,12,27,47,-20,18
AGF Aarhus,2013,11,4,6,12,16,38,-22,18
Brondby,2014,1,20,7,3,71,31,40,67
FC Midtjylla,2014,2,20,5,5,67,41,26,65
Copenhagen,2014,3,15,5,10,59,42,17,50
FC Nords,2014,4,13,6,11,72,59,13,45
AaB,2014,5,9,11,10,39,42,-3,38
Sonderjyske,2014,6,8,6,10,28,29,-1,30
AC Horsens,2014,7,5,14,11,34,53,-19,29
Randers FC,2014,8,6,6,12,24,39,-15,24
Silkeborg IF,2014,9,6,3,13,27,44,-17,21
Lyngby,2014,10,3,9,12,26,45,-19,18
AGF Aarhus,2014,11,4,6,12,16,38,-22,18
Brondby,2015,1,20,5,5,66,34,32,65
FC Midtjylla,2015,2,20,5,5,65,38,27,65
FC Nords,2015,3,14,7,9,74,49,25,49
Copenhagen,2015,4,14,4,12,53,43,10,46
AaB,2015,5,10,11,9,41,38,3,41
Sonderjyske,2015,6,8,6,10,28,29,-1,30
AC Horsens,2015,7,6,12,12,34,57,-23,30
Lyngby,2015,8,4,9,11,27,44,-17,21
Randers FC,2015,9,5,6,13,23,40,-17,21
AGF Aarhus,2015,10,5,6,11,18,37,-19,21
Silkeborg IF,2015,11,5,3,14,26,46,-20,18
Brondby,2016,1,21,6,3,70,32,38,69
FC Midtjylla,2016,2,19,5,6,63,37,26,62
Copenhagen,2016,3,16,4,10,65,40,25,52
FC Nords,2016,4,13,9,8,74,54,20,48
AC Horsens,2016,5,7,12,11,36,54,-18,33
Sonderjyske,2016,6,8,6,10,28,29,-1,30
AaB,2016,7,6,12,12,34,51,-17,30
Lyngby,2016,8,4,9,11,29,44,-15,21
Silkeborg IF,2016,9,6,3,13,27,45,-18,21
Randers FC,2016,10,5,6,13,23,42,-19,21
AGF Aarhus,2016,11,4,6,12,17,38,-21,18
Brondby,2017,1,22,5,3,74,33,41,71
FC Midtjylla,2017,2,18,6,6,64,42,22,60
Copenhagen,2017,3,15,5,10,62,44,18,50
FC Nords,2017,4,14,6,10,68,50,18,48
AaB,2017,5,7,13,10,35,42,-7,34
AC Horsens,2017,6,6,13,11,34,52,-18,31
Sonderjyske,2017,7,8,6,10,28,29,-1,30
Lyngby,2017,8,4,9,11,28,44,-16,21
Randers FC,2017,9,5,6,13,23,41,-18,21
AGF Aarhus,2017,10,5,6,11,17,36,-19,21
Silkeborg IF,2017,11,5,3,14,25,45,-20,18
Brondby,2018,1,22,5,3,74,33,41,71
FC Midtjylla,2018,2,20,4,6,64,39,25,64
FC Nords,2018,3,15,7,8,80,55,25,52
Copenhagen,2018,4,13,5,12,55,47,8,44
AaB,2018,5,6,14,10,34,41,-7,32
AC Horsens,2018,6,6,13,11,32,50,-18,31
Sonderjyske,2018,7,8,6,10,28,29,-1,30
Lyngby,2018,8,4,9,11,31,45,-14,21
Randers FC,2018,9,5,6,13,24,44,-20,21
Silkeborg IF,2018,10,5,4,13,27,46,-19,19
AGF Aarhus,2018,11,4,7,11,18,38,-20,19
Brondby,2019,1,20,6,4,67,33,34,66
FC Midtjylla,2019,2,20,5,5,68,38,30,65
FC Nords,2019,3,15,6,9,70,51,19,51
Copenhagen,2019,4,15,4,11,59,43,16,49
AC Horsens,2019,5,7,12,11,34,52,-18,33
AaB,2019,6,7,11,12,36,43,-7,32
Sonderjyske,2019,7,8,6,10,28,29,-1,30
Lyngby,2019,8,4,9,11,29,45,-16,21
Randers FC,2019,9,5,6,13,24,42,-18,21
AGF Aarhus,2019,10,5,6,11,18,36,-18,21
Silkeborg IF,2019,11,5,3,14,25,46,-21,18
Brondby,2020,1,20,5,5,72,33,39,65
FC Midtjylla,2020,2,19,5,6,64,39,25,62
FC Nords,2020,3,13,9,8,70,51,19,48
Copenhagen,2020,4,13,5,12,59,56,3,44
AC Horsens,2020,5,8,14,8,35,47,-12,38
AaB,2020,6,8,12,10,42,42,0,36
Sonderjyske,2020,7,8,6,10,28,29,-1,30
Randers FC,2020,8,6,6,12,26,40,-14,24
AGF Aarhus,2020,9,5,6,11,19,37,-18,21
Lyngby,2020,10,3,9,12,27,47,-20,18
Silkeborg IF,2020,11,5,3,14,26,47,-21,18
Brondby,2021,1,21,7,2,73,29,44,70
FC Midtjylla,2021,2,19,6,5,63,35,28,63
FC Nords,2021,3,13,8,9,70,53,17,47
Copenhagen,2021,4,12,6,12,55,45,10,42
AaB,2021,5,9,11,10,38,44,-6,38
AC Horsens,2021,6,7,12,11,33,52,-19,33
Sonderjyske,2021,7,8,6,10,28,29,-1,30
Lyngby,2021,8,4,9,11,28,44,-16,21
Silkeborg IF,2021,9,6,3,13,26,44,-18,21
Randers FC,2021,10,5,6,13,23,41,-18,21
AGF Aarhus,2021,11,4,6,12,16,37,-21,18
Brondby,2022,1,21,6,3,72,35,37,69
FC Midtjylla,2022,2,20,4,6,64,37,27,64
FC Nords,2022,3,15,7,8,71,47,24,52
Copenhagen,2022,4,13,8,9,57,42,15,47
AaB,2022,5,6,13,11,34,42,-8,31
Sonderjyske,2022,6,8,6,10,28,29,-1,30
AC Horsens,2022,7,5,14,11,36,57,-21,29
Randers FC,2022,8,5,7,12,24,40,-16,22
Silkeborg IF,2022,9,6,3,13,28,44,-16,21
Lyngby,2022,10,3,10,11,27,45,-18,19
AGF Aarhus,2022,11,4,6,12,16,39,-23,18
Brondby,2023,1,21,6,3,68,31,37,69
FC Midtjylla,2023,2,19,6,5,66,40,26,63
FC Nords,2023,3,14,8,8,77,53,24,50
Copenhagen,2023,4,13,6,11,56,46,10,45
AaB,2023,5,8,12,10,37,41,-4,36
Sonderjyske,2023,6,8,6,10,28,29,-1,30
AC Horsens,2023,7,6,12,12,37,56,-19,30
Lyngby,2023,8,4,9,11,30,44,-14,21
Randers FC,2023,9,5,6,13,23,43,-20,21
Silkeborg IF,2023,10,5,4,13,28,47,-19,19
AGF Aarhus,2023,11,4,7,11,19,39,-20,19
Brondby,2024,1,22,6,2,72,29,43,72
FC Midtjylla,2024,2,19,5,6,70,41,29,62
FC Nords,2024,3,14,8,8,75,53,22,50
Copenhagen,2024,4,13,5,12,53,42,11,44
AaB,2024,5,6,15,9,39,44,-5,33
AC Horsens,2024,6,6,13,11,34,60,-26,31
Sonderjyske,2024,7,8,6,10,28,29,-1,30
Randers FC,2024,8,5,7,12,23,39,-16,22
Lyngby,2024,9,3,10,11,26,44,-18,19
Silkeborg IF,2024,10,5,4,13,25,44,-19,19
AGF Aarhus,2024,11,4,7,11,16,36,-20,19
Brondby,2025,1,21,6,3,72,34,38,69
FC Midtjylla,2025,2,19,5,6,64,40,24,62
FC Nords,2025,3,14,7,9,76,51,25,49
Copenhagen,2025,4,15,4,11,57,45,12,49
AC Horsens,2025,5,8,12,10,35,52,-17,36
Sonderjyske,2025,6,8,6,10,28,29,-1,30
AaB,2025,7,6,12,12,34,42,-8,30
Randers FC,2025,8,5,7,12,23,39,-16,22
Silkeborg IF,2025,9,6,3,13,29,45,-16,21
Lyngby,2025,10,3,10,11,26,44,-18,19
AGF Aarhus,2025,11,4,6,12,17,40,-23,18
Brondby,2026,1,20,7,3,70,34,36,67
FC Midtjylla,2026,2,19,6,5,63,38,25,63
FC Nords,2026,3,15,6,9,79,54,25,51
Copenhagen,2026,4,14,6,10,59,48,11,48
AaB,2026,5,8,12,10,43,42,1,36
Sonderjyske,2026,6,8,6,10,28,29,-1,30
AC Horsens,2026,7,5,13,12,33,57,-24,28
Lyngby,2026,8,4,9,11,31,44,-13,21
AGF Aarhus,2026,9,5,6,11,18,36,-18,21
Randers FC,2026,10,5,6,13,23,44,-21,21
Silkeborg IF,2026,11,5,3,14,25,46,-21,18
FC Midtjylla,2027,1,21,4,5,73,39,34,67
Brondby,2027,2,19,6,5,67,37,30,63
FC Nords,2027,3,15,7,8,79,56,23,52
Copenhagen,2027,4,14,6,10,59,46,13,48
AaB,2027,5,7,12,11,41,46,-5,33
AC Horsens,2027,6,6,13,11,36,57,-21,31
Sonderjyske,2027,7,8,6,10,28,29,-1,30
Randers FC,2027,8,5,7,12,24,40,-16,22
Lyngby,2027,9,3,10,11,27,45,-18,19
Silkeborg IF,2027,10,5,4,13,27,46,-19,19
AGF Aarhus,2027,11,4,7,11,18,38,-20,19
FC Midtjylla,2028,1,22,4,4,72,36,36,70
Brondby,2028,2,19,6,5,64,35,29,63
FC Nords,2028,3,14,8,8,72,49,23,50
Copenhagen,2028,4,14,4,12,55,45,10,46
AaB,2028,5,8,12,10,42,45,-3,36
Sonderjyske,2028,6,8,6,10,28,29,-1,30
AC Horsens,2028,7,6,12,12,32,53,-21,30
Randers FC,2028,8,5,7,12,24,40,-16,22
AGF Aarhus,2028,9,5,6,11,21,38,-17,21
Lyngby,2028,10,3,10,11,27,45,-18,19
Silkeborg IF,2028,11,5,3,14,27,49,-22,18
Brondby,2029,1,20,6,4,64,31,33,66
FC Midtjylla,2029,2,20,5,5,66,38,28,65
FC Nords,2029,3,15,8,7,74,48,26,53
Copenhagen,2029,4,13,5,12,52,42,10,44
AaB,2029,5,8,12,10,37,41,-4,36
Sonderjyske,2029,6,8,6,10,28,29,-1,30
AC Horsens,2029,7,6,12,12,32,51,-19,30
Lyngby,2029,8,4,9,11,28,45,-17,21
Randers FC,2029,9,5,6,13,24,41,-17,21
Silkeborg IF,2029,10,5,4,13,25,44,-19,19
AGF Aarhus,2029,11,4,7,11,16,36,-20,19
Brondby,2030,1,21,6,3,72,31,41,69
FC Midtjylla,2030,2,19,4,7,64,43,21,61
FC Nords,2030,3,15,7,8,71,47,24,52
Copenhagen,2030,4,13,6,11,59,44,15,45
AaB,2030,5,8,12,10,37,45,-8,36
AC Horsens,2030,6,6,13,11,34,53,-19,31
Sonderjyske,2030,7,8,6,10,28,29,-1,30
Lyngby,2030,8,4,9,11,29,46,-17,21
Randers FC,2030,9,5,6,13,25,42,-17,21
Silkeborg IF,2030,10,6,3,13,29,47,-18,21
AGF Aarhus,2030,11,4,6,12,19,40,-21,18
Brondby,2031,1,20,6,4,69,33,36,66
FC Midtjylla,2031,2,20,4,6,64,39,25,64
FC Nords,2031,3,15,7,8,77,52,25,52
Copenhagen,2031,4,13,6,11,55,42,13,45
AaB,2031,5,8,11,11,38,45,-7,35
AC Horsens,2031,6,6,14,10,33,51,-18,32
Sonderjyske,2031,7,8,6,10,28,29,-1,30
Lyngby,2031,8,4,9,11,29,45,-16,21
AGF Aarhus,2031,9,5,6,11,20,36,-16,21
Randers FC,2031,10,5,6,13,24,42,-18,21
Silkeborg IF,2031,11,5,3,14,25,48,-23,18
Brondby,2032,1,22,5,3,77,33,44,71
FC Midtjylla,2032,2,20,5,5,69,40,29,65
FC Nords,2032,3,14,6,10,71,55,16,48
Copenhagen,2032,4,13,5,12,61,50,11,44
AaB,2032,5,8,12,10,38,43,-5,36
AC Horsens,2032,6,6,13,11,39,60,-21,31
Sonderjyske,2032,7,8,6,10,28,29,-1,30
Randers FC,2032,8,5,7,12,24,40,-16,22
Silkeborg IF,2032,9,6,3,13,26,44,-18,21
Lyngby,2032,10,3,10,11,27,45,-18,19
AGF Aarhus,2032,11,4,6,12,16,37,-21,18
Brondby,2033,1,21,6,3,70,32,38,69
FC Midtjylla,2033,2,19,4,7,67,41,26,61
FC Nords,2033,3,14,6,10,71,51,20,48
Copenhagen,2033,4,14,4,12,56,44,12,46
AaB,2033,5,10,11,9,41,42,-1,41
AC Horsens,2033,6,6,13,11,36,57,-21,31
Sonderjyske,2033,7,8,6,10,28,29,-1,30
Lyngby,2033,8,4,9,11,27,44,-17,21
Randers FC,2033,9,5,6,13,23,40,-17,21
AGF Aarhus,2033,10,5,6,11,19,38,-19,21
Silkeborg IF,2033,11,5,3,14,27,47,-20,18
Brondby,2034,1,20,7,3,67,29,38,67
FC Midtjylla,2034,2,19,5,6,63,38,25,62
FC Nords,2034,3,14,7,9,76,54,22,49
Copenhagen,2034,4,13,5,12,60,48,12,44
AaB,2034,5,8,13,9,45,47,-2,37
AC Horsens,2034,6,7,13,10,34,55,-21,34
Sonderjyske,2034,7,8,6,10,28,29,-1,30
Randers FC,2034,8,6,6,12,24,39,-15,24
AGF Aarhus,2034,9,5,6,11,18,37,-19,21
Lyngby,2034,10,3,9,12,26,45,-19,18
Silkeborg IF,2034,11,5,3,14,26,46,-20,18
Brondby,2035,1,20,7,3,71,34,37,67
FC Midtjylla,2035,2,20,6,4,70,40,30,66
FC Nords,2035,3,13,8,9,71,52,19,47
Copenhagen,2035,4,13,7,10,57,43,14,46
AaB,2035,5,7,13,10,36,42,-6,34
AC Horsens,2035,6,6,13,11,35,55,-20,31
Sonderjyske,2035,7,8,6,10,28,29,-1,30
Lyngby,2035,8,4,9,11,28,44,-16,21
Randers FC,2035,9,5,6,13,23,41,-18,21
AGF Aarhus,2035,10,5,6,11,19,37,-18,21
Silkeborg IF,2035,11,5,3,14,26,47,-21,18
Brondby,2036,1,22,6,2,71,30,41,72
FC Midtjylla,2036,2,21,4,5,69,35,34,67
Copenhagen,2036,3,14,4,12,59,46,13,46
FC Nords,2036,4,12,7,11,69,56,13,43
AC Horsens,2036,5,7,14,9,35,51,-16,35
AaB,2036,6,7,11,12,37,48,-11,32
Sonderjyske,2036,7,8,6,10,28,29,-1,30
Lyngby,2036,8,4,9,11,28,44,-16,21
Silkeborg IF,2036,9,6,3,13,27,44,-17,21
Randers FC,2036,10,5,6,13,23,41,-18,21
AGF Aarhus,2036,11,4,6,12,16,38,-22,18
Brondby,2037,1,23,5,2,76,28,48,74
FC Midtjylla,2037,2,19,6,5,65,40,25,63
FC Nords,2037,3,14,8,8,77,51,26,50
Copenhagen,2037,4,13,5,12,56,50,6,44
AaB,2037,5,8,12,10,43,45,-2,36
Sonderjyske,2037,6,8,6,10,28,29,-1,30
AC Horsens,2037,7,5,12,13,31,60,-29,27
Lyngby,2037,8,4,9,11,29,44,-15,21
Silkeborg IF,2037,9,6,3,13,27,44,-17,21
Randers FC,2037,10,5,6,13,23,42,-19,21
AGF Aarhus,2037,11,4,6,12,16,38,-22,18
Brondby,2038,1,20,7,3,70,34,36,67
FC Midtjylla,2038,2,18,5,7,61,41,20,59
FC Nords,2038,3,15,7,8,73,48,25,52
Copenhagen,2038,4,13,7,10,63,51,12,46
AaB,2038,5,7,14,9,37,42,-5,35
AC Horsens,2038,6,6,14,10,36,50,-14,32
Sonderjyske,2038,7,8,6,10,28,29,-1,30
Randers FC,2038,8,6,6,12,25,40,-15,24
Silkeborg IF,2038,9,5,4,13,27,46,-19,19
AGF Aarhus,2038,10,4,7,11,18,38,-20,19
Lyngby,2038,11,3,9,12,27,46,-19,18
FC Midtjylla,2039,1,20,5,5,71,42,29,65
Brondby,2039,2,19,6,5,69,36,33,63
FC Nords,2039,3,15,7,8,74,53,21,52
Copenhagen,2039,4,14,5,11,65,50,15,47
AaB,2039,5,8,12,10,39,45,-6,36
Sonderjyske,2039,6,8,6,10,28,29,-1,30
AC Horsens,2039,7,5,15,10,34,52,-18,30
Lyngby,2039,8,4,9,11,27,44,-17,21
Randers FC,2039,9,5,6,13,23,40,-17,21
Silkeborg IF,2039,10,5,4,13,26,45,-19,19
AGF Aarhus,2039,11,4,7,11,17,37,-20,19
Brondby,2040,1,22,5,3,72,32,40,71
FC Midtjylla,2040,2,18,5,7,63,41,22,59
FC Nords,2040,3,14,8,8,75,51,24,50
Copenhagen,2040,4,14,6,10,59,43,16,48
AaB,2040,5,8,12,10,37,44,-7,36
Sonderjyske,2040,6,8,6,10,28,29,-1,30
AC Horsens,2040,7,5,14,11,35,56,-21,29
Lyngby,2040,8,4,9,11,29,46,-17,21
Randers FC,2040,9,5,6,13,25,42,-17,21
Silkeborg IF,2040,10,6,3,13,26,44,-18,21
AGF Aarhus,2040,11,4,6,12,16,37,-21,18
Brondby,2041,1,20,6,4,67,31,36,66
FC Midtjylla,2041,2,20,4,6,69,40,29,64
FC Nords,2041,3,14,7,9,72,52,20,49
Copenhagen,2041,4,14,5,11,61,45,16,47
AaB,2041,5,9,12,9,38,41,-3,39
Sonderjyske,2041,6,8,6,10,28,29,-1,30
AC Horsens,2041,7,6,12,12,32,56,-24,30
Lyngby,2041,8,4,9,11,28,44,-16,21
Silkeborg IF,2041,8,6,3,13,28,44,-16,21
Randers FC,2041,10,5,6,13,23,41,-18,21
AGF Aarhus,2041,11,4,6,12,16,39,-23,18
Brondby,2042,1,21,6,3,71,33,38,69
FC Midtjylla,2042,2,20,5,5,68,37,31,65
FC Nords,2042,3,14,7,9,75,56,19,49
Copenhagen,2042,4,13,4,13,56,46,10,43
AaB,2042,5,9,11,10,37,39,-2,38
AC Horsens,2042,6,6,13,11,31,53,-22,31
Sonderjyske,2042,7,8,6,10,28,29,-1,30
Randers FC,2042,8,6,6,12,24,39,-15,24
AGF Aarhus,2042,9,5,6,11,19,38,-19,21
Lyngby,2042,10,3,9,12,26,45,-19,18
Silkeborg IF,2042,11,5,3,14,27,47,-20,18
Brondby,2043,1,21,7,2,67,29,38,70
FC Midtjylla,2043,2,20,5,5,69,38,31,65
Copenhagen,2043,3,14,4,12,55,43,12,46
FC Nords,2043,4,12,8,10,69,56,13,44
AaB,2043,5,7,13,10,35,39,-4,34
AC Horsens,2043,6,6,15,9,33,49,-16,33
Sonderjyske,2043,7,8,6,10,28,29,-1,30
Randers FC,2043,8,6,6,12,26,41,-15,24
Silkeborg IF,2043,9,6,3,13,26,44,-18,21
Lyngby,2043,10,3,9,12,28,47,-19,18
AGF Aarhus,2043,11,4,6,12,16,37,-21,18
Brondby,2044,1,23,5,2,79,30,49,74
FC Midtjylla,2044,2,19,6,5,62,37,25,63
Copenhagen,2044,3,15,5,10,62,47,15,50
FC Nords,2044,4,12,9,9,69,55,14,45
AC Horsens,2044,5,6,13,11,34,52,-18,31
Sonderjyske,2044,6,8,6,10,28,29,-1,30
AaB,2044,7,6,12,12,36,47,-11,30
Lyngby,2044,8,4,9,11,27,44,-17,21
Randers FC,2044,9,5,6,13,23,40,-17,21
AGF Aarhus,2044,10,5,6,11,19,36,-17,21
Silkeborg IF,2044,11,5,3,14,25,47,-22,18
Brondby,2045,1,20,7,3,69,32,37,67
FC Midtjylla,2045,2,20,5,5,66,36,30,65
FC Nords,2045,3,14,9,7,73,49,24,51
Copenhagen,2045,4,12,6,12,52,46,6,42
AaB,2045,5,6,15,9,33,39,-6,33
AC Horsens,2045,6,5,16,9,35,52,-17,31
Sonderjyske,2045,7,8,6,10,28,29,-1,30
Lyngby,2045,8,4,9,11,30,45,-15,21
Silkeborg IF,2045,9,6,3,13,27,44,-17,21
Randers FC,2045,10,5,6,13,24,43,-19,21
AGF Aarhus,2045,11,4,6,12,16,38,-22,18
Brondby,2046,1,20,7,3,70,32,38,67
FC Midtjylla,2046,2,18,7,5,62,40,22,61
Copenhagen,2046,3,15,5,10,59,41,18,50
FC Nords,2046,4,12,10,8,70,50,20,46
AaB,2046,5,7,12,11,36,45,-9,33
AC Horsens,2046,6,6,15,9,35,50,-15,33
Sonderjyske,2046,7,8,6,10,28,29,-1,30
AGF Aarhus,2046,8,5,6,11,21,36,-15,21
Lyngby,2046,9,4,9,11,29,45,-16,21
Randers FC,2046,10,5,6,13,24,42,-18,21
Silkeborg IF,2046,11,5,3,14,25,49,-24,18
Brondby,2047,1,23,5,2,72,27,45,74
FC Midtjylla,2047,2,18,4,8,60,41,19,58
FC Nords,2047,3,15,7,8,76,49,27,52
Copenhagen,2047,4,13,6,11,56,47,9,45
AaB,2047,5,8,12,10,35,43,-8,36
Sonderjyske,2047,6,8,6,10,28,29,-1,30
AC Horsens,2047,7,5,14,11,36,54,-18,29
Randers FC,2047,8,6,6,12,24,39,-15,24
Silkeborg IF,2047,9,5,4,13,26,45,-19,19
AGF Aarhus,2047,10,4,7,11,17,37,-20,19
Lyngby,2047,11,3,9,12,26,45,-19,18
Brondby,2048,1,21,5,4,69,32,37,68
FC Midtjylla,2048,2,18,6,6,59,41,18,60
FC Nords,2048,3,14,7,9,74,51,23,49
Copenhagen,2048,4,14,5,11,60,45,15,47
AaB,2048,5,8,12,10,40,41,-1,36
AC Horsens,2048,6,6,15,9,32,50,-18,33
Sonderjyske,2048,7,8,6,10,28,29,-1,30
Randers FC,2048,8,5,7,12,24,40,-16,22
Silkeborg IF,2048,9,6,3,13,26,44,-18,21
Lyngby,2048,10,3,10,11,27,45,-18,19
AGF Aarhus,2048,11,4,6,12,16,37,-21,18
Brondby,2049,1,22,6,2,74,31,43,72
FC Midtjylla,2049,2,18,6,6,62,39,23,60
FC Nords,2049,3,14,6,10,72,55,17,48
Copenhagen,2049,4,13,6,11,56,46,10,45
AaB,2049,5,8,11,11,39,45,-6,35
AC Horsens,2049,6,7,13,10,38,51,-13,34
Sonderjyske,2049,7,8,6,10,28,29,-1,30
Randers FC,2049,8,5,7,12,24,40,-16,22
Lyngby,2049,9,3,10,11,27,45,-18,19
Silkeborg IF,2049,10,5,4,13,26,45,-19,19
AGF Aarhus,2049,11,4,7,11,17,37,-20,19
FC Midtjylla,2050,1,21,5,4,69,36,33,68
Brondby,2050,2,20,6,4,71,34,37,66
FC Nords,2050,3,15,7,8,73,48,25,52
Copenhagen,2050,4,13,5,12,54,45,9,44
AaB,2050,5,7,11,12,35,47,-12,32
AC Horsens,2050,6,6,14,10,35,53,-18,32
Sonderjyske,2050,7,8,6,10,28,29,-1,30
Randers FC,2050,8,5,7,12,23,39,-16,22
AGF Aarhus,2050,9,5,6,11,18,37,-19,21
Lyngby,2050,10,3,10,11,26,44,-18,19
Silkeborg IF,2050,11,5,3,14,26,46,-20,18
Brondby,2051,1,21,6,3,71,31,40,69
FC Midtjylla,2051,2,20,6,4,64,36,28,66
FC Nords,2051,3,14,7,9,74,51,23,49
Copenhagen,2051,4,14,5,11,59,47,12,47
AaB,2051,5,7,12,11,35,44,-9,33
Sonderjyske,2051,6,8,6,10,28,29,-1,30
AC Horsens,2051,7,6,12,12,32,52,-20,30
Randers FC,2051,8,5,7,12,25,41,-16,22
Lyngby,2051,9,3,10,11,28,46,-18,19
Silkeborg IF,2051,10,5,4,13,26,45,-19,19
AGF Aarhus,2051,11,4,7,11,17,37,-20,19
FC Midtjylla,2052,1,21,4,5,65,35,30,67
Brondby,2052,2,20,6,4,71,36,35,66
FC Nords,2052,3,14,7,9,73,51,22,49
Copenhagen,2052,4,15,4,11,62,46,16,49
AaB,2052,5,8,12,10,38,43,-5,36
Sonderjyske,2052,6,8,6,10,28,29,-1,30
AC Horsens,2052,7,5,13,12,33,57,-24,28
Randers FC,2052,8,6,6,12,24,39,-15,24
Silkeborg IF,2052,9,6,3,13,29,46,-17,21
Lyngby,2052,10,3,9,12,26,45,-19,18
AGF Aarhus,2052,11,4,6,12,18,40,-22,18
Brondby,2053,1,21,6,3,69,33,36,69
FC Midtjylla,2053,2,20,5,5,67,35,32,65
FC Nords,2053,3,14,7,9,69,51,18,49
Copenhagen,2053,4,12,5,13,52,45,7,41
AC Horsens,2053,5,8,12,10,37,52,-15,36
AaB,2053,6,8,11,11,38,42,-4,35
Sonderjyske,2053,7,8,6,10,28,29,-1,30
Randers FC,2053,8,6,6,12,26,39,-13,24
Silkeborg IF,2053,9,5,4,13,26,45,-19,19
AGF Aarhus,2053,10,4,7,11,17,37,-20,19
Lyngby,2053,11,3,9,12,26,47,-21,18
Brondby,2054,1,21,6,3,68,31,37,69
FC Midtjylla,2054,2,18,4,8,66,46,20,58
FC Nords,2054,3,14,7,9,73,51,22,49
Copenhagen,2054,4,14,6,10,57,42,15,48
AaB,2054,5,9,12,9,42,44,-2,39
AC Horsens,2054,6,6,13,11,33,51,-18,31
Sonderjyske,2054,7,8,6,10,28,29,-1,30
Lyngby,2054,8,4,9,11,29,44,-15,21
Randers FC,2054,9,5,6,13,23,42,-19,21
Silkeborg IF,2054,10,5,4,13,27,46,-19,19
AGF Aarhus,2054,11,4,7,11,18,38,-20,19
Brondby,2055,1,21,6,3,70,31,39,69
FC Midtjylla,2055,2,20,6,4,69,36,33,66
Copenhagen,2055,3,14,5,11,61,46,15,47
FC Nords,2055,4,13,7,10,71,58,13,46
AC Horsens,2055,5,7,13,10,37,51,-14,34
AaB,2055,6,7,11,12,37,49,-12,32
Sonderjyske,2055,7,8,6,10,28,29,-1,30
Lyngby,2055,8,4,9,11,28,44,-16,21
Silkeborg IF,2055,9,6,3,13,28,45,-17,21
Randers FC,2055,10,5,6,13,23,41,-18,21
AGF Aarhus,2055,11,4,6,12,17,39,-22,18
Brondby,2056,1,20,6,4,68,34,34,66
FC Midtjylla,2056,2,20,6,4,67,37,30,66
Copenhagen,2056,3,16,4,10,62,46,16,52
FC Nords,2056,4,12,7,11,67,52,15,43
AC Horsens,2056,5,7,14,9,38,49,-11,35
AaB,2056,6,6,13,11,35,45,-10,31
Sonderjyske,2056,7,8,6,10,28,29,-1,30
Randers FC,2056,8,5,7,12,23,39,-16,22
AGF Aarhus,2056,9,5,6,11,19,37,-18,21
Lyngby,2056,10,3,10,11,26,44,-18,19
Silkeborg IF,2056,11,5,3,14,26,47,-21,18
Brondby,2057,1,21,5,4,73,33,40,68
FC Midtjylla,2057,2,20,4,6,65,38,27,64
FC Nords,2057,3,15,6,9,73,50,23,51
Copenhagen,2057,4,13,5,12,55,47,8,44
AaB,2057,5,8,13,9,35,38,-3,37
AC Horsens,2057,6,6,13,11,32,53,-21,31
Sonderjyske,2057,7,8,6,10,28,29,-1,30
Randers FC,2057,8,5,7,12,23,39,-16,22
Silkeborg IF,2057,9,6,3,13,28,45,-17,21
Lyngby,2057,10,3,10,11,26,44,-18,19
AGF Aarhus,2057,11,4,6,12,17,39,-22,18
FC Midtjylla,2058,1,20,4,6,68,37,31,64
Brondby,2058,2,19,5,6,65,36,29,62
Copenhagen,2058,3,16,4,10,64,45,19,52
FC Nords,2058,4,14,7,9,75,54,21,49
AaB,2058,5,9,12,9,42,45,-3,39
Sonderjyske,2058,6,8,6,10,28,29,-1,30
AC Horsens,2058,7,6,12,12,35,58,-23,30
Randers FC,2058,8,5,7,12,25,41,-16,22
Lyngby,2058,9,3,10,11,28,46,-18,19
Silkeborg IF,2058,10,5,4,13,25,44,-19,19
AGF Aarhus,2058,11,4,7,11,16,36,-20,19
Brondby,2059,1,22,5,3,69,31,38,71
FC Midtjylla,2059,2,18,6,6,63,41,22,60
FC Nords,2059,3,14,8,8,75,53,22,50
Copenhagen,2059,4,13,5,12,57,45,12,44
AaB,2059,5,7,14,9,35,38,-3,35
AC Horsens,2059,6,6,14,10,34,51,-17,32
Sonderjyske,2059,7,8,6,10,28,29,-1,30
Randers FC,2059,8,6,6,12,24,39,-15,24
Silkeborg IF,2059,9,5,4,13,26,45,-19,19
AGF Aarhus,2059,10,4,7,11,17,37,-20,19
Lyngby,2059,11,3,9,12,26,45,-19,18
Brondby,2060,1,22,6,2,71,30,41,72
FC Midtjylla,2060,2,20,5,5,64,38,26,65
FC Nords,2060,3,13,8,9,68,50,18,47
Copenhagen,2060,4,13,7,10,56,41,15,46
AC Horsens,2060,5,7,13,10,35,50,-15,34
Sonderjyske,2060,6,8,6,10,28,29,-1,30
AaB,2060,7,6,11,13,34,45,-11,29
Randers FC,2060,8,5,7,12,23,39,-16,22
Lyngby,2060,9,3,10,11,26,44,-18,19
Silkeborg IF,2060,10,5,4,13,26,45,-19,19
AGF Aarhus,2060,11,4,7,11,17,37,-20,19
Brondby,2061,1,20,8,2,74,33,41,68
FC Midtjylla,2061,2,19,5,6,69,41,28,62
Copenhagen,2061,3,15,5,10,59,44,15,50
FC Nords,2061,4,14,7,9,74,54,20,49
AC Horsens,2061,5,6,14,10,37,55,-18,32
AaB,2061,6,6,13,11,35,47,-12,31
Sonderjyske,2061,7,8,6,10,28,29,-1,30
Silkeborg IF,2061,8,6,3,13,28,44,-16,21
Lyngby,2061,9,4,9,11,28,45,-17,21
Randers FC,2061,10,5,6,13,24,41,-17,21
AGF Aarhus,2061,11,4,6,12,16,39,-23,18
Brondby,2062,1,23,5,2,75,31,44,74
FC Midtjylla,2062,2,20,4,6,65,39,26,64
FC Nords,2062,3,15,7,8,74,51,23,52
Copenhagen,2062,4,12,5,13,54,48,6,41
AaB,2062,5,8,11,11,37,42,-5,35
Sonderjyske,2062,6,8,6,10,28,29,-1,30
AC Horsens,2062,7,6,12,12,34,54,-20,30
Randers FC,2062,8,6,6,12,24,39,-15,24
Silkeborg IF,2062,9,6,3,13,28,44,-16,21
Lyngby,2062,10,3,9,12,26,45,-19,18
AGF Aarhus,2062,11,4,6,12,16,39,-23,18
Brondby,2063,1,21,6,3,69,31,38,69
FC Midtjylla,2063,2,20,5,5,72,41,31,65
FC Nords,2063,3,15,6,9,73,51,22,51
Copenhagen,2063,4,14,5,11,55,44,11,47
AC Horsens,2063,5,6,14,10,32,50,-18,32
Sonderjyske,2063,6,8,6,10,28,29,-1,30
AaB,2063,7,6,12,12,38,48,-10,30
Randers FC,2063,8,6,6,12,25,40,-15,24
AGF Aarhus,2063,9,5,6,11,18,37,-19,21
Lyngby,2063,10,3,9,12,27,46,-19,18
Silkeborg IF,2063,11,5,3,14,26,46,-20,18
Brondby,2064,1,21,6,3,70,33,37,69
FC Midtjylla,2064,2,18,6,6,67,41,26,60
FC Nords,2064,3,14,7,9,71,52,19,49
Copenhagen,2064,4,14,5,11,60,46,14,47
AaB,2064,5,7,13,10,37,43,-6,34
AC Horsens,2064,6,7,13,10,33,49,-16,34
Sonderjyske,2064,7,8,6,10,28,29,-1,30
Lyngby,2064,8,4,9,11,27,44,-17,21
Randers FC,2064,9,5,6,13,23,40,-17,21
Silkeborg IF,2064,10,5,4,13,26,45,-19,19
AGF Aarhus,2064,11,4,7,11,17,37,-20,19
Brondby,2065,1,21,6,3,74,30,44,69
FC Midtjylla,2065,2,19,4,7,66,44,22,61
FC Nords,2065,3,16,7,7,75,47,28,55
Copenhagen,2065,4,12,7,11,52,44,8,43
AC Horsens,2065,5,7,13,10,36,50,-14,34
AaB,2065,6,7,11,12,34,48,-14,32
Sonderjyske,2065,7,8,6,10,28,29,-1,30
Lyngby,2065,8,4,9,11,29,44,-15,21
Silkeborg IF,2065,9,6,3,13,27,45,-18,21
Randers FC,2065,10,5,6,13,23,42,-19,21
AGF Aarhus,2065,11,4,6,12,17,38,-21,18
Brondby,2066,1,22,6,2,77,34,43,72
FC Midtjylla,2066,2,19,5,6,69,43,26,62
Copenhagen,2066,3,16,5,9,62,42,20,53
FC Nords,2066,4,13,6,11,71,58,13,45
AaB,2066,5,8,11,11,36,42,-6,35
Sonderjyske,2066,6,8,6,10,28,29,-1,30
AC Horsens,2066,7,5,13,12,34,56,-22,28
Randers FC,2066,8,5,7,12,26,42,-16,22
Silkeborg IF,2066,9,6,3,13,27,45,-18,21
Lyngby,2066,10,3,10,11,29,47,-18,19
AGF Aarhus,2066,11,4,6,12,17,38,-21,18
Brondby,2067,1,22,5,3,71,32,39,71
FC Midtjylla,2067,2,19,5,6,66,44,22,62
FC Nords,2067,3,14,8,8,75,51,24,50
Copenhagen,2067,4,13,6,11,56,44,12,45
AaB,2067,5,7,12,11,38,45,-7,33
AC Horsens,2067,6,5,16,9,36,52,-16,31
Sonderjyske,2067,7,8,6,10,28,29,-1,30
Lyngby,2067,8,4,9,11,30,46,-16,21
Randers FC,2067,9,5,6,13,25,43,-18,21
AGF Aarhus,2067,10,5,6,11,18,37,-19,21
Silkeborg IF,2067,11,5,3,14,26,46,-20,18
Brondby,2068,1,21,6,3,71,34,37,69
FC Midtjylla,2068,2,20,5,5,70,43,27,65
FC Nords,2068,3,14,6,10,70,52,18,48
Copenhagen,2068,4,13,6,11,58,46,12,45
AaB,2068,5,9,11,10,41,42,-1,38
Sonderjyske,2068,6,8,6,10,28,29,-1,30
AC Horsens,2068,7,5,14,11,31,50,-19,29
Randers FC,2068,8,6,6,12,25,39,-14,24
Silkeborg IF,2068,9,6,3,13,28,45,-17,21
Lyngby,2068,10,3,9,12,26,46,-20,18
AGF Aarhus,2068,11,4,6,12,17,39,-22,18
Brondby,2069,1,21,5,4,74,30,44,68
FC Midtjylla,2069,2,20,6,4,64,36,28,66
Copenhagen,2069,3,15,5,10,59,41,18,50
FC Nords,2069,4,13,7,10,71,58,13,46
AaB,2069,5,8,11,11,38,47,-9,35
Sonderjyske,2069,6,8,6,10,28,29,-1,30
AC Horsens,2069,7,5,14,11,36,56,-20,29
Randers FC,2069,8,5,7,12,24,40,-16,22
Silkeborg IF,2069,9,6,3,13,26,44,-18,21
Lyngby,2069,10,3,10,11,27,45,-18,19
AGF Aarhus,2069,11,4,6,12,16,37,-21,18
Brondby,2070,1,22,5,3,70,33,37,71
FC Midtjylla,2070,2,21,5,4,69,35,34,68
FC Nords,2070,3,13,8,9,74,51,23,47
Copenhagen,2070,4,13,6,11,54,42,12,45
AaB,2070,5,7,13,10,34,40,-6,34
Sonderjyske,2070,6,8,6,10,28,29,-1,30
AC Horsens,2070,7,5,13,12,31,57,-26,28
Randers FC,2070,8,5,7,12,25,41,-16,22
Silkeborg IF,2070,9,6,3,13,26,44,-18,21
Lyngby,2070,10,3,10,11,28,46,-18,19
AGF Aarhus,2070,11,4,6,12,16,37,-21,18
FC Midtjylla,2071,1,21,4,5,67,38,29,67
Brondby,2071,2,20,5,5,67,35,32,65
Copenhagen,2071,3,15,5,10,62,47,15,50
FC Nords,2071,4,14,6,10,75,51,24,48
AaB,2071,5,7,12,11,40,44,-4,33
AC Horsens,2071,6,7,12,11,35,57,-22,33
Sonderjyske,2071,7,8,6,10,28,29,-1,30
Lyngby,2071,8,4,9,11,28,44,-16,21
Randers FC,2071,9,5,6,13,23,41,-18,21
Silkeborg IF,2071,10,5,4,13,25,44,-19,19
AGF Aarhus,2071,11,4,7,11,16,36,-20,19
Brondby,2072,1,19,8,3,67,31,36,65
FC Midtjylla,2072,2,20,5,5,72,38,34,65
FC Nords,2072,3,15,6,9,80,55,25,51
Copenhagen,2072,4,14,4,12,54,47,7,46
AC Horsens,2072,5,7,13,10,36,54,-18,34
AaB,2072,6,7,12,11,37,47,-10,33
Sonderjyske,2072,7,8,6,10,28,29,-1,30
Lyngby,2072,8,4,9,11,28,44,-16,21
Randers FC,2072,9,5,6,13,23,41,-18,21
Silkeborg IF,2072,10,5,4,13,28,47,-19,19
AGF Aarhus,2072,11,4,7,11,19,39,-20,19
Brondby,2073,1,21,7,2,67,27,40,70
FC Midtjylla,2073,2,19,5,6,62,40,22,62
FC Nords,2073,3,15,8,7,73,46,27,53
Copenhagen,2073,4,12,5,13,50,42,8,41
AaB,2073,5,8,12,10,36,40,-4,36
Sonderjyske,2073,6,8,6,10,28,29,-1,30
AC Horsens,2073,7,5,15,10,30,49,-19,30
Randers FC,2073,8,5,7,12,24,40,-16,22
Silkeborg IF,2073,9,6,3,13,29,44,-15,21
Lyngby,2073,10,3,10,11,27,45,-18,19
AGF Aarhus,2073,11,4,6,12,16,40,-24,18
Brondby,2074,1,22,6,2,68,29,39,72
FC Midtjylla,2074,2,19,5,6,69,39,30,62
Copenhagen,2074,3,14,5,11,59,45,14,47
FC Nords,2074,4,12,6,12,66,52,14,42
AaB,2074,5,8,13,9,37,40,-3,37
AC Horsens,2074,6,7,13,10,35,55,-20,34
Sonderjyske,2074,7,8,6,10,28,29,-1,30
Lyngby,2074,8,4,9,11,28,44,-16,21
Randers FC,2074,9,5,6,13,23,41,-18,21
AGF Aarhus,2074,10,5,6,11,18,36,-18,21
Silkeborg IF,2074,11,5,3,14,25,46,-21,18
Brondby,2075,1,22,5,3,74,32,42,71
FC Midtjylla,2075,2,19,4,7,64,39,25,61
FC Nords,2075,3,16,7,7,73,46,27,55
Copenhagen,2075,4,13,5,12,55,46,9,44
AaB,2075,5,7,12,11,36,46,-10,33
AC Horsens,2075,6,6,13,11,36,55,-19,31
Sonderjyske,2075,7,8,6,10,28,29,-1,30
Randers FC,2075,8,6,6,12,25,40,-15,24
Silkeborg IF,2075,9,5,4,13,26,45,-19,19
AGF Aarhus,2075,10,4,7,11,17,37,-20,19
Lyngby,2075,11,3,9,12,27,46,-19,18
Brondby,2076,1,21,6,3,70,29,41,69
FC Midtjylla,2076,2,20,4,6,66,41,25,64
FC Nords,2076,3,15,6,9,72,50,22,51
Copenhagen,2076,4,13,6,11,57,47,10,45
AaB,2076,5,9,11,10,38,41,-3,38
Sonderjyske,2076,6,8,6,10,28,29,-1,30
AC Horsens,2076,7,5,13,12,34,55,-21,28
Randers FC,2076,8,6,6,12,25,39,-14,24
Silkeborg IF,2076,9,6,3,13,28,44,-16,21
Lyngby,2076,10,3,9,12,26,46,-20,18
AGF Aarhus,2076,11,4,6,12,16,39,-23,18
Brondby,2077,1,21,6,3,67,30,37,69
FC Midtjylla,2077,2,18,6,6,63,38,25,60
FC Nords,2077,3,15,7,8,73,49,24,52
Copenhagen,2077,4,14,6,10,59,47,12,48
AC Horsens,2077,5,7,13,10,38,54,-16,34
Sonderjyske,2077,6,8,6,10,28,29,-1,30
AaB,2077,7,6,12,12,34,42,-8,30
Randers FC,2077,8,5,7,12,24,40,-16,22
AGF Aarhus,2077,9,5,6,11,17,36,-19,21
Lyngby,2077,10,3,10,11,27,45,-18,19
Silkeborg IF,2077,11,5,3,14,25,45,-20,18
Brondby,2078,1,21,6,3,72,32,40,69
FC Midtjylla,2078,2,19,5,6,62,38,24,62
FC Nords,2078,3,15,6,9,69,51,18,51
Copenhagen,2078,4,14,5,11,55,40,15,47
AaB,2078,5,7,13,10,35,40,-5,34
Sonderjyske,2078,6,8,6,10,28,29,-1,30
AC Horsens,2078,7,5,15,10,33,51,-18,30
Randers FC,2078,8,6,6,12,25,40,-15,24
AGF Aarhus,2078,9,5,6,11,17,36,-19,21
Lyngby,2078,10,3,9,12,27,46,-19,18
Silkeborg IF,2078,11,5,3,14,25,45,-20,18
Brondby,2079,1,23,5,2,75,31,44,74
FC Midtjylla,2079,2,21,4,5,69,39,30,67
FC Nords,2079,3,14,7,9,74,51,23,49
Copenhagen,2079,4,13,5,12,58,49,9,44
AaB,2079,5,7,11,12,36,47,-11,32
Sonderjyske,2079,6,8,6,10,28,29,-1,30
AC Horsens,2079,7,6,12,12,36,57,-21,30
Randers FC,2079,8,5,7,12,23,39,-16,22
Lyngby,2079,9,3,10,11,26,44,-18,19
Silkeborg IF,2079,10,5,4,13,26,45,-19,19
AGF Aarhus,2079,11,4,7,11,17,37,-20,19
FC Midtjylla,2080,1,21,4,5,68,40,28,67
Brondby,2080,2,18,7,5,69,37,32,61
Copenhagen,2080,3,15,5,10,59,45,14,50
FC Nords,2080,4,13,8,9,72,52,20,47
AaB,2080,5,8,12,10,39,42,-3,36
AC Horsens,2080,6,7,12,11,37,54,-17,33
Sonderjyske,2080,7,8,6,10,28,29,-1,30
Randers FC,2080,8,6,6,12,24,39,-15,24
Silkeborg IF,2080,9,5,4,13,27,46,-19,19
AGF Aarhus,2080,10,4,7,11,18,38,-20,19
Lyngby,2080,11,3,9,12,26,45,-19,18
Brondby,2081,1,20,5,5,73,35,38,65
FC Midtjylla,2081,2,20,5,5,67,38,29,65
Copenhagen,2081,3,13,8,9,58,44,14,47
FC Nords,2081,4,13,7,10,73,57,16,46
AaB,2081,5,8,12,10,38,44,-6,36
AC Horsens,2081,6,7,13,10,36,53,-17,34
Sonderjyske,2081,7,8,6,10,28,29,-1,30
Randers FC,2081,8,5,7,12,23,39,-16,22
Lyngby,2081,9,3,10,11,26,44,-18,19
Silkeborg IF,2081,10,5,4,13,26,45,-19,19
AGF Aarhus,2081,11,4,7,11,17,37,-20,19
FC Midtjylla,2082,1,22,4,4,69,37,32,70
Brondby,2082,2,21,6,3,72,30,42,69
FC Nords,2082,3,13,6,11,70,62,8,45
Copenhagen,2082,4,13,5,12,54,45,9,44
AaB,2082,5,8,13,9,42,40,2,37
Sonderjyske,2082,6,8,6,10,28,29,-1,30
AC Horsens,2082,7,6,12,12,34,53,-19,30
Randers FC,2082,8,5,7,12,24,40,-16,22
AGF Aarhus,2082,9,5,6,11,18,37,-19,21
Lyngby,2082,10,3,10,11,27,45,-18,19
Silkeborg IF,2082,11,5,3,14,26,46,-20,18
Brondby,2083,1,23,5,2,78,29,49,74
FC Midtjylla,2083,2,19,5,6,65,43,22,62
FC Nords,2083,3,14,8,8,74,50,24,50
Copenhagen,2083,4,13,6,11,54,45,9,45
AaB,2083,5,7,13,10,36,41,-5,34
Sonderjyske,2083,6,8,6,10,28,29,-1,30
AC Horsens,2083,7,5,13,12,33,58,-25,28
Lyngby,2083,8,4,9,11,30,47,-17,21
Randers FC,2083,9,5,6,13,26,43,-17,21
Silkeborg IF,2083,10,5,4,13,26,45,-19,19
AGF Aarhus,2083,11,4,7,11,17,37,-20,19
Brondby,2084,1,20,7,3,72,36,36,67
FC Midtjylla,2084,2,20,5,5,72,36,36,65
Copenhagen,2084,3,14,6,10,59,43,16,48
FC Nords,2084,4,13,7,10,75,57,18,46
AaB,2084,5,8,13,9,37,45,-8,37
Sonderjyske,2084,6,8,6,10,28,29,-1,30
AC Horsens,2084,7,6,12,12,32,56,-24,30
Lyngby,2084,8,4,9,11,27,44,-17,21
Randers FC,2084,9,5,6,13,23,40,-17,21
Silkeborg IF,2084,10,5,4,13,25,44,-19,19
AGF Aarhus,2084,11,4,7,11,16,36,-20,19
Brondby,2085,1,22,6,2,77,32,45,72
FC Midtjylla,2085,2,20,4,6,69,44,25,64
FC Nords,2085,3,13,6,11,74,59,15,45
Copenhagen,2085,4,13,5,12,58,51,7,44
AC Horsens,2085,5,8,12,10,41,53,-12,36
AaB,2085,6,8,11,11,39,45,-6,35
Sonderjyske,2085,7,8,6,10,28,29,-1,30
Lyngby,2085,8,4,9,11,28,44,-16,21
Silkeborg IF,2085,9,6,3,13,26,44,-18,21
Randers FC,2085,10,5,6,13,23,41,-18,21
AGF Aarhus,2085,11,4,6,12,16,37,-21,18
Brondby,2086,1,20,7,3,75,31,44,67
FC Midtjylla,2086,2,19,6,5,66,37,29,63
FC Nords,2086,3,14,6,10,73,59,14,48
Copenhagen,2086,4,14,5,11,58,43,15,47
AC Horsens,2086,5,8,12,10,36,57,-21,36
AaB,2086,6,7,12,11,35,42,-7,33
Sonderjyske,2086,7,8,6,10,28,29,-1,30
Randers FC,2086,8,5,7,12,24,40,-16,22
Lyngby,2086,9,3,10,11,27,45,-18,19
Silkeborg IF,2086,10,5,4,13,25,44,-19,19
AGF Aarhus,2086,11,4,7,11,16,36,-20,19
Brondby,2087,1,21,5,4,73,38,35,68
FC Midtjylla,2087,2,21,5,4,70,37,33,68
FC Nords,2087,3,15,6,9,74,52,22,51
Copenhagen,2087,4,12,6,12,53,43,10,42
AaB,2087,5,7,12,11,35,45,-10,33
AC Horsens,2087,6,7,12,11,35,51,-16,33
Sonderjyske,2087,7,8,6,10,28,29,-1,30
Randers FC,2087,8,5,7,12,24,40,-16,22
AGF Aarhus,2087,9,5,6,11,17,36,-19,21
Lyngby,2087,10,3,10,11,27,45,-18,19
Silkeborg IF,2087,11,5,3,14,25,45,-20,18
Brondby,2088,1,22,5,3,72,29,43,71
FC Midtjylla,2088,2,18,7,5,60,36,24,61
FC Nords,2088,3,14,7,9,69,52,17,49
Copenhagen,2088,4,13,7,10,58,45,13,46
AaB,2088,5,7,13,10,37,42,-5,34
AC Horsens,2088,6,6,13,11,32,50,-18,31
Sonderjyske,2088,7,8,6,10,28,29,-1,30
Randers FC,2088,8,5,7,12,24,40,-16,22
Silkeborg IF,2088,9,6,3,13,26,44,-18,21
Lyngby,2088,10,3,10,11,27,45,-18,19
AGF Aarhus,2088,11,4,6,12,16,37,-21,18
Brondby,2089,1,21,6,3,73,31,42,69
FC Midtjylla,2089,2,18,6,6,65,44,21,60
Copenhagen,2089,3,14,7,9,57,42,15,49
FC Nords,2089,4,13,9,8,73,53,20,48
AaB,2089,5,7,13,10,39,45,-6,34
AC Horsens,2089,6,6,13,11,34,52,-18,31
Sonderjyske,2089,7,8,6,10,28,29,-1,30
Randers FC,2089,8,6,6,12,26,39,-13,24
Silkeborg IF,2089,9,6,3,13,27,45,-18,21
Lyngby,2089,10,3,9,12,26,47,-21,18
AGF Aarhus,2089,11,4,6,12,17,38,-21,18
Brondby,2090,1,21,7,2,78,35,43,70
FC Midtjylla,2090,2,19,6,5,71,41,30,63
Copenhagen,2090,3,14,6,10,61,44,17,48
FC Nords,2090,4,12,8,10,73,60,13,44
AaB,2090,5,9,11,10,40,47,-7,38
Sonderjyske,2090,6,8,6,10,28,29,-1,30
AC Horsens,2090,7,5,14,11,31,53,-22,29
Lyngby,2090,8,4,9,11,28,45,-17,21
Randers FC,2090,9,5,6,13,24,41,-17,21
AGF Aarhus,2090,10,5,6,11,19,38,-19,21
Silkeborg IF,2090,11,5,3,14,27,47,-20,18
Brondby,2091,1,22,6,2,76,30,46,72
FC Midtjylla,2091,2,21,4,5,64,38,26,67
FC Nords,2091,3,15,6,9,80,55,25,51
Copenhagen,2091,4,14,5,11,54,45,9,47
AaB,2091,5,7,11,12,34,44,-10,32
Sonderjyske,2091,6,8,6,10,28,29,-1,30
AC Horsens,2091,7,5,12,13,31,53,-22,27
Lyngby,2091,8,4,9,11,29,45,-16,21
Randers FC,2091,9,5,6,13,24,42,-18,21
AGF Aarhus,2091,10,5,6,11,18,36,-18,21
Silkeborg IF,2091,11,5,3,14,25,46,-21,18
Brondby,2092,1,22,5,3,73,32,41,71
FC Midtjylla,2092,2,19,5,6,63,39,24,62
FC Nords,2092,3,14,6,10,76,51,25,48
Copenhagen,2092,4,14,4,12,53,44,9,46
AaB,2092,5,8,12,10,37,45,-8,36
AC Horsens,2092,6,7,12,11,36,53,-17,33
Sonderjyske,2092,7,8,6,10,28,29,-1,30
Randers FC,2092,8,5,7,12,25,41,-16,22
Lyngby,2092,9,3,10,11,28,46,-18,19
Silkeborg IF,2092,10,5,4,13,26,45,-19,19
AGF Aarhus,2092,11,4,7,11,17,37,-20,19
Brondby,2093,1,21,5,4,72,35,37,68
FC Midtjylla,2093,2,20,5,5,68,38,30,65
FC Nords,2093,3,14,6,10,76,56,20,48
Copenhagen,2093,4,14,5,11,57,46,11,47
AaB,2093,5,8,11,11,37,42,-5,35
AC Horsens,2093,6,7,12,11,36,55,-19,33
Sonderjyske,2093,7,8,6,10,28,29,-1,30
Randers FC,2093,8,6,6,12,24,39,-15,24
Silkeborg IF,2093,9,5,4,13,26,45,-19,19
AGF Aarhus,2093,10,4,7,11,17,37,-20,19
Lyngby,2093,11,3,9,12,26,45,-19,18
Brondby,2094,1,20,6,4,67,31,36,66
FC Midtjylla,2094,2,20,4,6,67,41,26,64
Copenhagen,2094,3,14,6,10,61,46,15,48
FC Nords,2094,4,13,7,10,72,54,18,46
AaB,2094,5,9,12,9,40,39,1,39
AC Horsens,2094,6,6,13,11,37,59,-22,31
Sonderjyske,2094,7,8,6,10,28,29,-1,30
Randers FC,2094,8,5,7,12,25,41,-16,22
Silkeborg IF,2094,9,6,3,13,29,46,-17,21
Lyngby,2094,10,3,10,11,28,46,-18,19
AGF Aarhus,2094,11,4,6,12,18,40,-22,18
Brondby,2095,1,20,7,3,72,33,39,67
FC Midtjylla,2095,2,19,5,6,66,41,25,62
FC Nords,2095,3,15,7,8,76,51,25,52
Copenhagen,2095,4,16,4,10,62,43,19,52
AaB,2095,5,7,12,11,35,45,-10,33
Sonderjyske,2095,6,8,6,10,28,29,-1,30
AC Horsens,2095,7,5,13,12,30,54,-24,28
Randers FC,2095,8,6,6,12,25,40,-15,24
AGF Aarhus,2095,9,5,6,11,18,37,-19,21
Lyngby,2095,10,3,9,12,27,46,-19,18
Silkeborg IF,2095,11,5,3,14,26,46,-20,18
FC Midtjylla,2096,1,21,5,4,66,36,30,68
Brondby,2096,2,20,6,4,68,35,33,66
FC Nords,2096,3,14,7,9,77,56,21,49
Copenhagen,2096,4,13,4,13,56,46,10,43
AaB,2096,5,8,12,10,39,43,-4,36
AC Horsens,2096,6,7,12,11,37,53,-16,33
Sonderjyske,2096,7,8,6,10,28,29,-1,30
Lyngby,2096,8,4,9,11,30,44,-14,21
Randers FC,2096,9,5,6,13,23,43,-20,21
Silkeborg IF,2096,10,5,4,13,28,47,-19,19
AGF Aarhus,2096,11,4,7,11,19,39,-20,19
FC Midtjylla,2097,1,21,4,5,78,43,35,67
Brondby,2097,2,20,6,4,69,35,34,66
FC Nords,2097,3,15,7,8,78,54,24,52
Copenhagen,2097,4,14,4,12,58,46,12,46
AC Horsens,2097,5,7,14,9,37,52,-15,35
Sonderjyske,2097,6,8,6,10,28,29,-1,30
AaB,2097,7,6,11,13,37,53,-16,29
Lyngby,2097,8,4,9,11,30,44,-14,21
Silkeborg IF,2097,9,6,3,13,26,44,-18,21
Randers FC,2097,10,5,6,13,23,43,-20,21
AGF Aarhus,2097,11,4,6,12,16,37,-21,18
Brondby,2098,1,20,5,5,65,32,33,65
FC Midtjylla,2098,2,19,6,5,62,38,24,63
FC Nords,2098,3,14,6,10,73,51,22,48
Copenhagen,2098,4,14,5,11,54,42,12,47
AaB,2098,5,8,12,10,35,39,-4,36
AC Horsens,2098,6,8,12,10,39,52,-13,36
Sonderjyske,2098,7,8,6,10,28,29,-1,30
Randers FC,2098,8,6,6,12,26,40,-14,24
Silkeborg IF,2098,9,5,4,13,26,45,-19,19
AGF Aarhus,2098,10,4,7,11,17,37,-20,19
Lyngby,2098,11,3,9,12,27,47,-20,18
Brondby,2099,1,21,7,2,75,33,42,70
FC Midtjylla,2099,2,18,8,4,61,36,25,62
Copenhagen,2099,3,14,6,10,57,45,12,48
FC Nords,2099,4,13,7,10,69,51,18,46
AaB,2099,5,7,12,11,41,48,-7,33
AC Horsens,2099,6,7,12,11,34,50,-16,33
Sonderjyske,2099,7,8,6,10,28,29,-1,30
Lyngby,2099,8,4,9,11,28,44,-16,21
Silkeborg IF,2099,9,6,3,13,27,45,-18,21
Randers FC,2099,10,5,6,13,23,41,-18,21
AGF Aarhus,2099,11,4,6,12,17,38,-21,18
Brondby,2100,1,21,5,4,75,32,43,68
FC Midtjylla,2100,2,21,5,4,67,36,31,68
FC Nords,2100,3,15,6,9,71,54,17,51
Copenhagen,2100,4,14,4,12,56,47,9,46
AC Horsens,2100,5,6,14,10,36,53,-17,32
Sonderjyske,2100,6,8,6,10,28,29,-1,30
AaB,2100,7,6,12,12,32,41,-9,30
Lyngby,2100,8,4,9,11,27,44,-17,21
Randers FC,2100,9,5,6,13,23,40,-17,21
Silkeborg IF,2100,10,5,4,13,26,45,-19,19
AGF Aarhus,2100,11,4,7,11,17,37,-20,19
Brondby,2101,1,21,6,3,74,35,39,69
FC Midtjylla,2101,2,19,6,5,67,42,25,63
Copenhagen,2101,3,15,5,10,65,44,21,50
FC Nords,2101,4,13,7,10,71,53,18,46
AaB,2101,5,7,13,10,39,46,-7,34
AC Horsens,2101,6,6,13,11,34,56,-22,31
Sonderjyske,2101,7,8,6,10,28,29,-1,30
Randers FC,2101,8,6,6,12,25,40,-15,24
AGF Aarhus,2101,9,5,6,11,19,38,-19,21
Lyngby,2101,10,3,9,12,27,46,-19,18
Silkeborg IF,2101,11,5,3,14,27,47,-20,18
Brondby,2102,1,20,6,4,71,36,35,66
FC Midtjylla,2102,2,20,4,6,63,36,27,64
FC Nords,2102,3,13,7,10,72,54,18,46
Copenhagen,2102,4,13,7,10,57,44,13,46
AaB,2102,5,9,12,9,35,37,-2,39
AC Horsens,2102,6,6,14,10,34,51,-17,32
Sonderjyske,2102,7,8,6,10,28,29,-1,30
Lyngby,2102,8,4,9,11,30,45,-15,21
Randers FC,2102,9,5,6,13,24,43,-19,21
Silkeborg IF,2102,10,5,4,13,26,45,-19,19
AGF Aarhus,2102,11,4,7,11,17,37,-20,19
Brondby,2103,1,22,6,2,73,29,44,72
FC Midtjylla,2103,2,18,6,6,63,40,23,60
FC Nords,2103,3,15,7,8,82,54,28,52
Copenhagen,2103,4,13,7,10,58,45,13,46
AaB,2103,5,6,13,11,33,47,-14,31
AC Horsens,2103,6,6,13,11,34,54,-20,31
Sonderjyske,2103,7,8,6,10,28,29,-1,30
Lyngby,2103,8,4,9,11,32,44,-12,21
Silkeborg IF,2103,9,6,3,13,27,45,-18,21
Randers FC,2103,10,5,6,13,23,45,-22,21
AGF Aarhus,2103,11,4,6,12,17,38,-21,18
Brondby,2104,1,20,6,4,72,36,36,66
FC Midtjylla,2104,2,18,5,7,68,47,21,59
FC Nords,2104,3,15,8,7,80,51,29,53
Copenhagen,2104,4,14,6,10,60,44,16,48
AC Horsens,2104,5,7,14,9,38,53,-15,35
AaB,2104,6,6,13,11,33,46,-13,31
Sonderjyske,2104,7,8,6,10,28,29,-1,30
Randers FC,2104,8,6,6,12,24,39,-15,24
Silkeborg IF,2104,9,6,3,13,26,44,-18,21
Lyngby,2104,10,3,9,12,26,45,-19,18
AGF Aarhus,2104,11,4,6,12,16,37,-21,18
FC Midtjylla,2105,1,21,4,5,76,40,36,67
Brondby,2105,2,19,7,4,71,43,28,64
Copenhagen,2105,3,14,6,10,60,42,18,48
FC Nords,2105,4,13,7,10,73,55,18,46
AaB,2105,5,7,13,10,39,47,-8,34
AC Horsens,2105,6,6,15,9,35,53,-18,33
Sonderjyske,2105,7,8,6,10,28,29,-1,30
Randers FC,2105,8,5,7,12,24,40,-16,22
Silkeborg IF,2105,9,6,3,13,29,47,-18,21
Lyngby,2105,10,3,10,11,27,45,-18,19
AGF Aarhus,2105,11,4,6,12,19,40,-21,18
Brondby,2106,1,23,5,2,74,29,45,74
FC Midtjylla,2106,2,19,4,7,64,39,25,61
FC Nords,2106,3,15,7,8,71,48,23,52
Copenhagen,2106,4,15,4,11,59,43,16,49
AC Horsens,2106,5,6,13,11,34,55,-21,31
Sonderjyske,2106,6,8,6,10,28,29,-1,30
AaB,2106,7,6,11,13,33,47,-14,29
Lyngby,2106,8,4,9,11,27,44,-17,21
Randers FC,2106,9,5,6,13,23,40,-17,21
AGF Aarhus,2106,10,5,6,11,18,37,-19,21
Silkeborg IF,2106,11,5,3,14,26,46,-20,18
Brondby,2107,1,22,6,2,79,30,49,72
FC Midtjylla,2107,2,20,5,5,63,37,26,65
FC Nords,2107,3,15,6,9,76,53,23,51
Copenhagen,2107,4,13,4,13,55,51,4,43
AC Horsens,2107,5,7,12,11,33,54,-21,33
AaB,2107,6,7,11,12,35,42,-7,32
Sonderjyske,2107,7,8,6,10,28,29,-1,30
Randers FC,2107,8,6,6,12,24,39,-15,24
Silkeborg IF,2107,9,6,3,13,27,45,-18,21
Lyngby,2107,10,3,9,12,26,45,-19,18
AGF Aarhus,2107,11,4,6,12,17,38,-21,18
Brondby,2108,1,22,5,3,75,30,45,71
FC Midtjylla,2108,2,20,5,5,66,37,29,65
FC Nords,2108,3,15,7,8,73,48,25,52
Copenhagen,2108,4,12,5,13,58,50,8,41
AC Horsens,2108,5,7,13,10,38,54,-16,34
AaB,2108,6,7,11,12,37,54,-17,32
Sonderjyske,2108,7,8,6,10,28,29,-1,30
Lyngby,2108,8,4,9,11,28,45,-17,21
Silkeborg IF,2108,9,6,3,13,27,44,-17,21
Randers FC,2108,10,5,6,13,24,41,-17,21
AGF Aarhus,2108,11,4,6,12,16,38,-22,18
Brondby,2109,1,21,6,3,70,32,38,69
FC Midtjylla,2109,2,18,6,6,61,38,23,60
Copenhagen,2109,3,15,4,11,61,45,16,49
FC Nords,2109,4,13,7,10,69,53,16,46
AaB,2109,5,9,12,9,38,38,0,39
AC Horsens,2109,6,6,13,11,34,53,-19,31
Sonderjyske,2109,7,8,6,10,28,29,-1,30
Randers FC,2109,8,5,7,12,23,39,-16,22
Silkeborg IF,2109,9,6,3,13,26,44,-18,21
Lyngby,2109,10,3,10,11,26,44,-18,19
AGF Aarhus,2109,11,4,6,12,16,37,-21,18
Brondby,2110,1,20,7,3,71,37,34,67
FC Midtjylla,2110,2,20,6,4,67,38,29,66
FC Nords,2110,3,14,7,9,74,48,26,49
Copenhagen,2110,4,13,6,11,54,45,9,45
AC Horsens,2110,5,7,12,11,38,56,-18,33
AaB,2110,6,6,14,10,32,38,-6,32
Sonderjyske,2110,7,8,6,10,28,29,-1,30
Randers FC,2110,8,5,7,12,25,41,-16,22
Silkeborg IF,2110,9,6,3,13,27,44,-17,21
Lyngby,2110,10,3,10,11,28,46,-18,19
AGF Aarhus,2110,11,4,6,12,16,38,-22,18
Brondby,2111,1,21,7,2,71,30,41,70
FC Midtjylla,2111,2,18,5,7,65,42,23,59
FC Nords,2111,3,13,6,11,71,57,14,45
Copenhagen,2111,4,13,6,11,55,44,11,45
AaB,2111,5,10,12,8,44,42,2,42
AC Horsens,2111,6,6,14,10,37,54,-17,32
Sonderjyske,2111,7,8,6,10,28,29,-1,30
Randers FC,2111,8,6,6,12,25,39,-14,24
AGF Aarhus,2111,9,5,6,11,17,36,-19,21
Lyngby,2111,10,3,9,12,26,46,-20,18
Silkeborg IF,2111,11,5,3,14,25,45,-20,18
Brondby,2112,1,19,8,3,68,31,37,65
FC Midtjylla,2112,2,19,5,6,65,42,23,62
FC Nords,2112,3,16,6,8,73,50,23,54
Copenhagen,2112,4,13,6,11,56,43,13,45
AaB,2112,5,8,12,10,36,41,-5,36
AC Horsens,2112,6,6,13,11,34,51,-17,31
Sonderjyske,2112,7,8,6,10,28,29,-1,30
Lyngby,2112,8,4,9,11,28,44,-16,21
Randers FC,2112,9,5,6,13,23,41,-18,21
Silkeborg IF,2112,10,5,4,13,26,45,-19,19
AGF Aarhus,2112,11,4,7,11,17,37,-20,19
FC Midtjylla,2113,1,19,5,6,68,41,27,62
Brondby,2113,2,18,7,5,67,39,28,61
FC Nords,2113,3,14,7,9,75,53,22,49
Copenhagen,2113,4,13,6,11,61,52,9,45
AaB,2113,5,9,12,9,39,40,-1,39
AC Horsens,2113,6,8,13,9,41,52,-11,37
Sonderjyske,2113,7,8,6,10,28,29,-1,30
Lyngby,2113,8,4,9,11,28,44,-16,21
Silkeborg IF,2113,8,6,3,13,28,44,-16,21
Randers FC,2113,10,5,6,13,23,41,-18,21
AGF Aarhus,2113,11,4,6,12,16,39,-23,18
Brondby,2114,1,21,6,3,70,38,32,69
FC Midtjylla,2114,2,19,4,7,67,44,23,61
Copenhagen,2114,3,15,6,9,66,43,23,51
FC Nords,2114,4,13,8,9,78,56,22,47
AaB,2114,5,7,12,11,40,49,-9,33
AC Horsens,2114,6,5,16,9,35,52,-17,31
Sonderjyske,2114,7,8,6,10,28,29,-1,30
Randers FC,2114,8,6,6,12,25,40,-15,24
Silkeborg IF,2114,9,6,3,13,28,44,-16,21
Lyngby,2114,10,3,9,12,27,46,-19,18
AGF Aarhus,2114,11,4,6,12,16,39,-23,18
Brondby,2115,1,22,6,2,74,30,44,72
FC Midtjylla,2115,2,19,7,4,63,37,26,64
FC Nords,2115,3,13,6,11,72,56,16,45
Copenhagen,2115,4,13,5,12,55,46,9,44
AaB,2115,5,8,12,10,40,44,-4,36
AC Horsens,2115,6,7,12,11,37,54,-17,33
Sonderjyske,2115,7,8,6,10,28,29,-1,30
Lyngby,2115,8,4,9,11,28,45,-17,21
Randers FC,2115,9,5,6,13,24,41,-17,21
AGF Aarhus,2115,10,5,6,11,18,37,-19,21
Silkeborg IF,2115,11,5,3,14,26,46,-20,18
Brondby,2116,1,21,5,4,73,36,37,68
FC Midtjylla,2116,2,21,4,5,73,45,28,67
Copenhagen,2116,3,16,4,10,61,44,17,52
FC Nords,2116,4,14,6,10,73,55,18,48
AC Horsens,2116,5,6,13,11,33,49,-16,31
Sonderjyske,2116,6,8,6,10,28,29,-1,30
AaB,2116,7,6,12,12,35,45,-10,30
Lyngby,2116,8,4,9,11,29,44,-15,21
Silkeborg IF,2116,9,6,3,13,27,45,-18,21
Randers FC,2116,10,5,6,13,23,42,-19,21
AGF Aarhus,2116,11,4,6,12,17,38,-21,18
Brondby,2117,1,21,7,2,77,32,45,70
FC Midtjylla,2117,2,20,4,6,72,38,34,64
Copenhagen,2117,3,16,5,9,61,41,20,53
FC Nords,2117,4,13,6,11,71,62,9,45
AaB,2117,5,7,12,11,36,46,-10,33
Sonderjyske,2117,6,8,6,10,28,29,-1,30
AC Horsens,2117,7,6,12,12,36,60,-24,30
Randers FC,2117,8,6,6,12,25,39,-14,24
AGF Aarhus,2117,9,5,6,11,19,37,-18,21
Lyngby,2117,10,3,9,12,26,46,-20,18
Silkeborg IF,2117,11,5,3,14,26,47,-21,18
Brondby,2118,1,20,7,3,71,33,38,67
FC Midtjylla,2118,2,20,5,5,65,38,27,65
FC Nords,2118,3,16,6,8,82,54,28,54
Copenhagen,2118,4,13,5,12,60,48,12,44
AaB,2118,5,8,12,10,39,46,-7,36
Sonderjyske,2118,6,8,6,10,28,29,-1,30
AC Horsens,2118,7,5,13,12,33,57,-24,28
Lyngby,2118,8,4,9,11,28,45,-17,21
Randers FC,2118,9,5,6,13,24,41,-17,21
Silkeborg IF,2118,10,6,3,13,27,45,-18,21
AGF Aarhus,2118,11,4,6,12,17,38,-21,18
Brondby,2119,1,20,7,3,68,36,32,67
FC Midtjylla,2119,2,19,6,5,67,41,26,63
Copenhagen,2119,3,15,5,10,62,42,20,50
FC Nords,2119,4,14,7,9,75,52,23,49
AaB,2119,5,7,12,11,35,40,-5,33
AC Horsens,2119,6,6,13,11,34,56,-22,31
Sonderjyske,2119,7,8,6,10,28,29,-1,30
Randers FC,2119,8,6,6,12,26,40,-14,24
AGF Aarhus,2119,9,5,6,11,18,37,-19,21
Lyngby,2119,10,3,9,12,27,47,-20,18
Silkeborg IF,2119,11,5,3,14,26,46,-20,18
Brondby,2120,1,22,6,2,72,33,39,72
FC Midtjylla,2120,2,18,6,6,65,44,21,60
FC Nords,2120,3,14,6,10,77,56,21,48
Copenhagen,2120,4,13,5,12,60,49,11,44
AaB,2120,5,8,13,9,43,46,-3,37
AC Horsens,2120,6,6,14,10,39,54,-15,32
Sonderjyske,2120,7,8,6,10,28,29,-1,30
Randers FC,2120,8,5,7,12,23,39,-16,22
AGF Aarhus,2120,9,5,6,11,18,37,-19,21
Lyngby,2120,10,3,10,11,26,44,-18,19
Silkeborg IF,2120,11,5,3,14,26,46,-20,18
Brondby,2121,1,21,6,3,72,34,38,69
FC Midtjylla,2121,2,19,6,5,67,42,25,63
FC Nords,2121,3,16,7,7,78,48,30,55
Copenhagen,2121,4,12,5,13,56,50,6,41
AaB,2121,5,7,12,11,35,41,-6,33
AC Horsens,2121,6,7,12,11,34,53,-19,33
Sonderjyske,2121,7,8,6,10,28,29,-1,30
Randers FC,2121,8,6,6,12,24,39,-15,24
Silkeborg IF,2121,9,5,4,13,26,45,-19,19
AGF Aarhus,2121,10,4,7,11,17,37,-20,19
Lyngby,2121,11,3,9,12,26,45,-19,18
Brondby,2122,1,22,6,2,73,29,44,72
FC Midtjylla,2122,2,19,5,6,65,40,25,62
FC Nords,2122,3,16,6,8,72,52,20,54
Copenhagen,2122,4,13,6,11,56,43,13,45
AaB,2122,5,7,11,12,34,42,-8,32
Sonderjyske,2122,6,8,6,10,28,29,-1,30
AC Horsens,2122,7,6,12,12,33,53,-20,30
Randers FC,2122,8,6,6,12,24,39,-15,24
Silkeborg IF,2122,9,5,4,13,28,47,-19,19
AGF Aarhus,2122,10,4,7,11,19,39,-20,19
Lyngby,2122,11,3,9,12,26,45,-19,18
Brondby,2123,1,22,6,2,70,28,42,72
FC Midtjylla,2123,2,19,5,6,66,40,26,62
Copenhagen,2123,3,14,6,10,59,43,16,48
FC Nords,2123,4,13,6,11,69,54,15,45
AaB,2123,5,7,13,10,35,40,-5,34
AC Horsens,2123,6,7,12,11,33,53,-20,33
Sonderjyske,2123,7,8,6,10,28,29,-1,30
Randers FC,2123,8,6,6,12,26,41,-15,24
Silkeborg IF,2123,9,6,3,13,26,44,-18,21
Lyngby,2123,10,3,9,12,28,47,-19,18
AGF Aarhus,2123,11,4,6,12,16,37,-21,18
Brondby,2124,1,21,7,2,75,33,42,70
FC Midtjylla,2124,2,19,5,6,68,39,29,62
FC Nords,2124,3,15,7,8,75,50,25,52
Copenhagen,2124,4,15,4,11,64,52,12,49
AaB,2124,5,8,11,11,37,41,-4,35
Sonderjyske,2124,6,8,6,10,28,29,-1,30
AC Horsens,2124,7,5,12,13,32,62,-30,27
Randers FC,2124,8,6,6,12,26,39,-13,24
AGF Aarhus,2124,9,5,6,11,18,37,-19,21
Silkeborg IF,2124,10,5,3,14,26,46,-20,18
Lyngby,2124,11,3,9,12,26,47,-21,18
Brondby,2125,1,22,5,3,76,28,48,71
FC Midtjylla,2125,2,20,5,5,67,42,25,65
Copenhagen,2125,3,14,5,11,58,44,14,47
FC Nords,2125,4,12,6,12,65,56,9,42
AC Horsens,2125,5,8,14,8,36,47,-11,38
AaB,2125,6,7,11,12,34,45,-11,32
Sonderjyske,2125,7,8,6,10,28,29,-1,30
Lyngby,2125,8,4,9,11,31,44,-13,21
Silkeborg IF,2125,9,6,3,13,27,45,-18,21
Randers FC,2125,10,5,6,13,23,44,-21,21
AGF Aarhus,2125,11,4,6,12,17,38,-21,18
FC Midtjylla,2126,1,20,4,6,64,41,23,64
Brondby,2126,2,18,7,5,63,35,28,61
FC Nords,2126,3,16,6,8,73,46,27,54
Copenhagen,2126,4,14,5,11,57,43,14,47
AaB,2126,5,7,13,10,35,40,-5,34
AC Horsens,2126,6,7,13,10,38,51,-13,34
Sonderjyske,2126,7,8,6,10,28,29,-1,30
Randers FC,2126,8,6,6,12,25,39,-14,24
Silkeborg IF,2126,9,5,4,13,25,44,-19,19
AGF Aarhus,2126,10,4,7,11,16,36,-20,19
Lyngby,2126,11,3,9,12,26,46,-20,18
Brondby,2127,1,21,6,3,71,31,40,69
FC Midtjylla,2127,2,19,5,6,65,41,24,62
FC Nords,2127,3,15,8,7,74,48,26,53
Copenhagen,2127,4,12,6,12,54,45,9,42
AaB,2127,5,7,12,11,36,46,-10,33
AC Horsens,2127,6,6,15,9,40,55,-15,33
Sonderjyske,2127,7,8,6,10,28,29,-1,30
Randers FC,2127,8,5,7,12,24,40,-16,22
AGF Aarhus,2127,9,5,6,11,19,38,-19,21
Lyngby,2127,10,3,10,11,27,45,-18,19
Silkeborg IF,2127,11,5,3,14,27,47,-20,18
Brondby,2128,1,19,7,4,65,32,33,64
FC Midtjylla,2128,2,19,5,6,68,43,25,62
Copenhagen,2128,3,15,4,11,60,46,14,49
FC Nords,2128,4,13,8,9,75,58,17,47
AaB,2128,5,8,12,10,41,45,-4,36
AC Horsens,2128,6,7,14,9,38,49,-11,35
Sonderjyske,2128,7,8,6,10,28,29,-1,30
Randers FC,2128,8,6,6,12,25,40,-15,24
AGF Aarhus,2128,9,5,6,11,19,37,-18,21
Lyngby,2128,10,3,9,12,27,46,-19,18
Silkeborg IF,2128,11,5,3,14,26,47,-21,18
Brondby,2129,1,22,6,2,72,29,43,72
FC Midtjylla,2129,2,19,6,5,64,37,27,63
FC Nords,2129,3,14,6,10,76,54,22,48
Copenhagen,2129,4,14,5,11,60,49,11,47
AaB,2129,5,7,13,10,41,45,-4,34
Sonderjyske,2129,6,8,6,10,28,29,-1,30
AC Horsens,2129,7,5,14,11,33,58,-25,29
Randers FC,2129,8,6,6,12,24,39,-15,24
Silkeborg IF,2129,9,5,4,13,28,47,-19,19
AGF Aarhus,2129,10,4,7,11,19,39,-20,19
Lyngby,2129,11,3,9,12,26,45,-19,18
Brondby,2130,1,20,7,3,69,29,40,67
FC Midtjylla,2130,2,18,6,6,65,39,26,60
FC Nords,2130,3,14,8,8,74,52,22,50
Copenhagen,2130,4,15,4,11,61,46,15,49
AaB,2130,5,7,13,10,41,48,-7,34
AC Horsens,2130,6,7,12,11,34,56,-22,33
Sonderjyske,2130,7,8,6,10,28,29,-1,30
Lyngby,2130,8,4,9,11,28,44,-16,21
Silkeborg IF,2130,9,6,3,13,27,45,-18,21
Randers FC,2130,10,5,6,13,23,41,-18,21
AGF Aarhus,2130,11,4,6,12,17,38,-21,18
Brondby,2131,1,22,5,3,71,31,40,71
FC Midtjylla,2131,2,20,5,5,69,40,29,65
FC Nords,2131,3,14,6,10,75,56,19,48
Copenhagen,2131,4,14,6,10,58,46,12,48
AC Horsens,2131,5,6,14,10,35,51,-16,32
Sonderjyske,2131,6,8,6,10,28,29,-1,30
AaB,2131,7,6,12,12,36,46,-10,30
Randers FC,2131,8,5,7,12,24,40,-16,22
Silkeborg IF,2131,9,6,3,13,28,46,-18,21
Lyngby,2131,10,3,10,11,27,45,-18,19
AGF Aarhus,2131,11,4,6,12,18,39,-21,18
Brondby,2132,1,20,6,4,67,34,33,66
FC Midtjylla,2132,2,19,5,6,64,39,25,62
Copenhagen,2132,3,15,5,10,57,41,16,50
FC Nords,2132,4,14,7,9,76,51,25,49
AaB,2132,5,7,13,10,34,41,-7,34
AC Horsens,2132,6,5,16,9,34,52,-18,31
Sonderjyske,2132,7,8,6,10,28,29,-1,30
Randers FC,2132,8,6,6,12,25,39,-14,24
AGF Aarhus,2132,9,5,6,11,17,36,-19,21
Lyngby,2132,10,3,9,12,26,46,-20,18
Silkeborg IF,2132,11,5,3,14,25,45,-20,18
Brondby,2133,1,19,8,3,68,34,34,65
FC Midtjylla,2133,2,19,5,6,61,38,23,62
Copenhagen,2133,3,15,6,9,59,40,19,51
FC Nords,2133,4,13,9,8,71,50,21,48
AaB,2133,5,7,13,10,37,43,-6,34
AC Horsens,2133,6,6,13,11,34,51,-17,31
Sonderjyske,2133,7,8,6,10,28,29,-1,30
Randers FC,2133,8,5,7,12,24,40,-16,22
Lyngby,2133,9,3,10,11,27,45,-18,19
Silkeborg IF,2133,10,5,4,13,26,45,-19,19
AGF Aarhus,2133,11,4,7,11,17,37,-20,19
Brondby,2134,1,21,6,3,75,31,44,69
FC Midtjylla,2134,2,18,5,7,61,45,16,59
Copenhagen,2134,3,15,6,9,56,39,17,51
FC Nords,2134,4,13,9,8,72,51,21,48
AaB,2134,5,8,13,9,41,44,-3,37
Sonderjyske,2134,6,8,6,10,28,29,-1,30
AC Horsens,2134,7,5,13,12,33,54,-21,28
Randers FC,2134,8,6,6,12,26,40,-14,24
Silkeborg IF,2134,9,6,3,13,28,44,-16,21
Lyngby,2134,10,3,9,12,27,47,-20,18
AGF Aarhus,2134,11,4,6,12,16,39,-23,18
Brondby,2135,1,20,6,4,69,34,35,66
FC Midtjylla,2135,2,19,4,7,67,45,22,61
FC Nords,2135,3,14,6,10,72,53,19,48
Copenhagen,2135,4,14,5,11,63,48,15,47
AC Horsens,2135,5,8,13,9,42,54,-12,37
AaB,2135,6,8,12,10,41,46,-5,36
Sonderjyske,2135,7,8,6,10,28,29,-1,30
Randers FC,2135,8,6,6,12,25,39,-14,24
Silkeborg IF,2135,9,6,3,13,26,44,-18,21
Lyngby,2135,10,3,9,12,26,46,-20,18
AGF Aarhus,2135,11,4,6,12,16,37,-21,18
Brondby,2136,1,22,6,2,69,26,43,72
FC Midtjylla,2136,2,20,5,5,65,34,31,65
FC Nords,2136,3,14,8,8,70,49,21,50
Copenhagen,2136,4,12,5,13,52,47,5,41
AaB,2136,5,7,13,10,36,43,-7,34
AC Horsens,2136,6,6,13,11,33,52,-19,31
Sonderjyske,2136,7,8,6,10,28,29,-1,30
Randers FC,2136,8,5,7,12,24,40,-16,22
AGF Aarhus,2136,9,5,6,11,17,36,-19,21
Lyngby,2136,10,3,10,11,27,45,-18,19
Silkeborg IF,2136,11,5,3,14,25,45,-20,18
Brondby,2137,1,22,6,2,77,33,44,72
FC Midtjylla,2137,2,20,5,5,66,41,25,65
FC Nords,2137,3,13,8,9,74,55,19,47
Copenhagen,2137,4,14,5,11,59,44,15,47
AaB,2137,5,7,11,12,35,45,-10,32
AC Horsens,2137,6,6,13,11,34,53,-19,31
Sonderjyske,2137,7,8,6,10,28,29,-1,30
Lyngby,2137,8,4,9,11,27,44,-17,21
Randers FC,2137,9,5,6,13,23,40,-17,21
Silkeborg IF,2137,10,6,3,13,28,46,-18,21
AGF Aarhus,2137,11,4,6,12,18,39,-21,18
FC Midtjylla,2138,1,20,5,5,70,39,31,65
Brondby,2138,2,18,7,5,69,40,29,61
FC Nords,2138,3,15,6,9,78,55,23,51
Copenhagen,2138,4,15,4,11,61,46,15,49
AaB,2138,5,9,12,9,44,47,-3,39
Sonderjyske,2138,6,8,6,10,28,29,-1,30
AC Horsens,2138,7,6,12,12,36,57,-21,30
Randers FC,2138,8,6,6,12,27,41,-14,24
AGF Aarhus,2138,9,5,6,11,18,36,-18,21
Lyngby,2138,10,3,9,12,28,48,-20,18
Silkeborg IF,2138,11,5,3,14,25,46,-21,18
FC Midtjylla,2139,1,21,4,5,68,35,33,67
Brondby,2139,2,20,6,4,68,34,34,66
FC Nords,2139,3,15,8,7,72,47,25,53
Copenhagen,2139,4,12,4,14,53,48,5,40
AaB,2139,5,8,13,9,38,42,-4,37
AC Horsens,2139,6,6,13,11,35,54,-19,31
Sonderjyske,2139,7,8,6,10,28,29,-1,30
Lyngby,2139,8,4,9,11,28,45,-17,21
Randers FC,2139,9,5,6,13,24,41,-17,21
Silkeborg IF,2139,10,5,4,13,25,44,-19,19
AGF Aarhus,2139,11,4,7,11,16,36,-20,19
Brondby,2140,1,21,6,3,71,32,39,69
FC Midtjylla,2140,2,18,5,7,59,39,20,59
Copenhagen,2140,3,16,5,9,61,41,20,53
FC Nords,2140,4,14,8,8,74,52,22,50
AaB,2140,5,7,13,10,36,42,-6,34
Sonderjyske,2140,6,8,6,10,28,29,-1,30
AC Horsens,2140,7,5,13,12,34,55,-21,28
Silkeborg IF,2140,8,6,3,13,28,44,-16,21
Lyngby,2140,9,4,9,11,29,46,-17,21
Randers FC,2140,10,5,6,13,25,42,-17,21
AGF Aarhus,2140,11,4,6,12,16,39,-23,18
Brondby,2141,1,22,6,2,71,29,42,72
FC Midtjylla,2141,2,19,7,4,64,35,29,64
FC Nords,2141,3,14,8,8,75,53,22,50
Copenhagen,2141,4,13,4,13,56,50,6,43
AC Horsens,2141,5,7,12,11,39,56,-17,33
AaB,2141,6,6,13,11,34,42,-8,31
Sonderjyske,2141,7,8,6,10,28,29,-1,30
Lyngby,2141,8,4,9,11,28,45,-17,21
Randers FC,2141,9,5,6,13,24,41,-17,21
Silkeborg IF,2141,10,5,4,13,25,44,-19,19
AGF Aarhus,2141,11,4,7,11,16,36,-20,19
Brondby,2142,1,20,7,3,71,34,37,67
FC Midtjylla,2142,2,18,5,7,64,45,19,59
FC Nords,2142,3,13,9,8,70,48,22,48
Copenhagen,2142,4,14,5,11,61,47,14,47
AaB,2142,5,9,13,8,40,39,1,40
AC Horsens,2142,6,6,13,11,36,55,-19,31
Sonderjyske,2142,7,8,6,10,28,29,-1,30
Lyngby,2142,8,4,9,11,28,44,-16,21
Silkeborg IF,2142,9,6,3,13,28,45,-17,21
Randers FC,2142,10,5,6,13,23,41,-18,21
AGF Aarhus,2142,11,4,6,12,17,39,-22,18
Brondby,2143,1,21,5,4,66,34,32,68
FC Midtjylla,2143,2,17,6,7,61,43,18,57
FC Nords,2143,3,14,8,8,79,52,27,50
Copenhagen,2143,4,14,6,10,62,42,20,48
AaB,2143,5,8,13,9,38,41,-3,37
AC Horsens,2143,6,6,14,10,33,53,-20,32
Sonderjyske,2143,7,8,6,10,28,29,-1,30
Randers FC,2143,8,6,6,12,25,39,-14,24
Silkeborg IF,2143,9,6,3,13,27,44,-17,21
Lyngby,2143,10,3,9,12,26,46,-20,18
AGF Aarhus,2143,11,4,6,12,16,38,-22,18
Brondby,2144,1,20,7,3,72,35,37,67
FC Midtjylla,2144,2,20,4,6,64,38,26,64
FC Nords,2144,3,13,7,10,72,54,18,46
Copenhagen,2144,4,13,6,11,53,42,11,45
AC Horsens,2144,5,8,13,9,38,50,-12,37
AaB,2144,6,7,13,10,34,40,-6,34
Sonderjyske,2144,7,8,6,10,28,29,-1,30
Lyngby,2144,8,4,9,11,29,45,-16,21
AGF Aarhus,2144,9,5,6,11,20,36,-16,21
Randers FC,2144,10,5,6,13,24,42,-18,21
Silkeborg IF,2144,11,5,3,14,25,48,-23,18
Brondby,2145,1,20,7,3,70,32,38,67
FC Midtjylla,2145,2,19,6,5,69,40,29,63
FC Nords,2145,3,14,7,9,78,56,22,49
Copenhagen,2145,4,14,5,11,63,48,15,47
AaB,2145,5,8,11,11,39,48,-9,35
AC Horsens,2145,6,6,14,10,34,55,-21,32
Sonderjyske,2145,7,8,6,10,28,29,-1,30
Lyngby,2145,8,4,9,11,27,44,-17,21
Randers FC,2145,9,5,6,13,23,40,-17,21
Silkeborg IF,2145,10,5,4,13,28,47,-19,19
AGF Aarhus,2145,11,4,7,11,19,39,-20,19
Brondby,2146,1,20,7,3,72,34,38,67
FC Midtjylla,2146,2,19,5,6,65,41,24,62
FC Nords,2146,3,15,6,9,76,52,24,51
Copenhagen,2146,4,15,4,11,59,43,16,49
AaB,2146,5,8,11,11,40,47,-7,35
AC Horsens,2146,6,6,13,11,34,55,-21,31
Sonderjyske,2146,7,8,6,10,28,29,-1,30
Randers FC,2146,8,6,6,12,25,40,-15,24
Silkeborg IF,2146,9,6,3,13,27,44,-17,21
Lyngby,2146,10,3,9,12,27,46,-19,18
AGF Aarhus,2146,11,4,6,12,16,38,-22,18
Brondby,2147,1,21,6,3,70,30,40,69
FC Midtjylla,2147,2,19,5,6,65,40,25,62
FC Nords,2147,3,15,6,9,76,52,24,51
Copenhagen,2147,4,13,4,13,58,49,9,43
AaB,2147,5,9,11,10,40,45,-5,38
AC Horsens,2147,6,7,12,11,37,56,-19,33
Sonderjyske,2147,7,8,6,10,28,29,-1,30
Randers FC,2147,8,6,6,12,25,39,-14,24
Silkeborg IF,2147,9,6,3,13,26,44,-18,21
Lyngby,2147,10,3,9,12,26,46,-20,18
AGF Aarhus,2147,11,4,6,12,16,37,-21,18
Brondby,2148,1,20,7,3,69,33,36,67
FC Midtjylla,2148,2,18,6,6,62,41,21,60
FC Nords,2148,3,16,7,7,83,52,31,55
Copenhagen,2148,4,12,4,14,55,49,6,40
AaB,2148,5,9,11,10,41,44,-3,38
AC Horsens,2148,6,7,13,10,37,54,-17,34
Sonderjyske,2148,7,8,6,10,28,29,-1,30
Randers FC,2148,8,6,6,12,26,41,-15,24
Silkeborg IF,2148,9,6,3,13,26,44,-18,21
Lyngby,2148,10,3,9,12,28,47,-19,18
AGF Aarhus,2148,11,4,6,12,16,37,-21,18
Brondby,2149,1,19,6,5,65,33,32,63
FC Midtjylla,2149,2,19,4,7,63,38,25,61
FC Nords,2149,3,14,8,8,76,52,24,50
Copenhagen,2149,4,15,5,10,60,45,15,50
AaB,2149,5,9,12,9,38,39,-1,39
AC Horsens,2149,6,6,13,11,34,55,-21,31
Sonderjyske,2149,7,8,6,10,28,29,-1,30
Lyngby,2149,8,4,9,11,27,44,-17,21
Randers FC,2149,9,5,6,13,23,40,-17,21
Silkeborg IF,2149,10,5,4,13,27,46,-19,19
AGF Aarhus,2149,11,4,7,11,18,38,-20,19
Brondby,2150,1,22,5,3,71,31,40,71
FC Midtjylla,2150,2,20,4,6,66,35,31,64
FC Nords,2150,3,14,6,10,74,53,21,48
Copenhagen,2150,4,13,6,11,55,43,12,45
AaB,2150,5,8,12,10,37,45,-8,36
AC Horsens,2150,6,6,13,11,33,55,-22,31
Sonderjyske,2150,7,8,6,10,28,29,-1,30
Lyngby,2150,8,4,9,11,29,44,-15,21
Randers FC,2150,9,5,6,13,23,42,-19,21
Silkeborg IF,2150,10,5,4,13,25,44,-19,19
AGF Aarhus,2150,11,4,7,11,16,36,-20,19
Brondby,2151,1,22,6,2,75,29,46,72
FC Midtjylla,2151,2,19,5,6,67,40,27,62
Copenhagen,2151,3,15,6,9,58,41,17,51
FC Nords,2151,4,13,7,10,70,56,14,46
AaB,2151,5,8,12,10,38,45,-7,36
Sonderjyske,2151,6,8,6,10,28,29,-1,30
AC Horsens,2151,7,5,12,13,32,55,-23,27
Lyngby,2151,8,4,9,11,28,44,-16,21
Randers FC,2151,9,5,6,13,23,41,-18,21
Silkeborg IF,2151,10,5,4,13,26,45,-19,19
AGF Aarhus,2151,11,4,7,11,17,37,-20,19
Brondby,2152,1,21,6,3,70,30,40,69
FC Midtjylla,2152,2,20,6,4,66,35,31,66
FC Nords,2152,3,14,6,10,76,53,23,48
Copenhagen,2152,4,13,5,12,57,52,5,44
AaB,2152,5,8,11,11,41,46,-5,35
AC Horsens,2152,6,7,12,11,37,57,-20,33
Sonderjyske,2152,7,8,6,10,28,29,-1,30
Randers FC,2152,8,6,6,12,25,40,-15,24
AGF Aarhus,2152,9,5,6,11,20,37,-17,21
Lyngby,2152,10,3,9,12,27,46,-19,18
Silkeborg IF,2152,11,5,3,14,26,48,-22,18
Brondby,2153,1,22,6,2,76,32,44,72
FC Midtjylla,2153,2,19,4,7,62,42,20,61
Copenhagen,2153,3,15,6,9,63,45,18,51
FC Nords,2153,4,12,7,11,72,56,16,43
AaB,2153,5,8,12,10,37,41,-4,36
AC Horsens,2153,6,6,13,11,34,54,-20,31
Sonderjyske,2153,7,8,6,10,28,29,-1,30
Randers FC,2153,8,5,7,12,23,39,-16,22
Silkeborg IF,2153,9,6,3,13,27,45,-18,21
Lyngby,2153,10,3,10,11,26,44,-18,19
AGF Aarhus,2153,11,4,6,12,17,38,-21,18
Brondby,2154,1,22,6,2,73,31,42,72
FC Midtjylla,2154,2,20,4,6,63,38,25,64
FC Nords,2154,3,14,6,10,76,53,23,48
Copenhagen,2154,4,14,5,11,59,46,13,47
AC Horsens,2154,5,7,13,10,36,52,-16,34
Sonderjyske,2154,6,8,6,10,28,29,-1,30
AaB,2154,7,6,12,12,36,49,-13,30
Lyngby,2154,8,4,9,11,27,44,-17,21
Randers FC,2154,9,5,6,13,23,40,-17,21
AGF Aarhus,2154,10,5,6,11,18,37,-19,21
Silkeborg IF,2154,11,5,3,14,26,46,-20,18
Brondby,2155,1,21,6,3,72,31,41,69
FC Midtjylla,2155,2,19,5,6,63,39,24,62
FC Nords,2155,3,16,6,8,75,53,22,54
Copenhagen,2155,4,15,4,11,60,45,15,49
AC Horsens,2155,5,6,13,11,38,56,-18,31
Sonderjyske,2155,6,8,6,10,28,29,-1,30
AaB,2155,7,6,12,12,35,45,-10,30
Lyngby,2155,8,4,9,11,28,44,-16,21
AGF Aarhus,2155,9,5,6,11,20,36,-16,21
Randers FC,2155,10,5,6,13,23,41,-18,21
Silkeborg IF,2155,11,5,3,14,25,48,-23,18
Brondby,2156,1,21,6,3,70,35,35,69
FC Midtjylla,2156,2,20,4,6,66,39,27,64
FC Nords,2156,3,16,6,8,77,51,26,54
Copenhagen,2156,4,14,5,11,59,42,17,47
AaB,2156,5,6,13,11,36,45,-9,31
Sonderjyske,2156,6,8,6,10,28,29,-1,30
AC Horsens,2156,7,6,12,12,35,57,-22,30
Randers FC,2156,8,5,7,12,23,39,-16,22
Silkeborg IF,2156,9,6,3,13,27,44,-17,21
Lyngby,2156,10,3,10,11,26,44,-18,19
AGF Aarhus,2156,11,4,6,12,16,38,-22,18
Brondby,2157,1,20,6,4,68,31,37,66
FC Midtjylla,2157,2,20,6,4,70,37,33,66
FC Nords,2157,3,15,7,8,70,48,22,52
Copenhagen,2157,4,12,5,13,52,46,6,41
AaB,2157,5,7,13,10,36,44,-8,34
AC Horsens,2157,6,7,13,10,35,51,-16,34
Sonderjyske,2157,7,8,6,10,28,29,-1,30
Randers FC,2157,8,6,6,12,25,39,-14,24
AGF Aarhus,2157,9,5,6,11,18,37,-19,21
Lyngby,2157,10,3,9,12,26,46,-20,18
Silkeborg IF,2157,10,5,3,14,26,46,-20,18
FC Midtjylla,2158,1,20,5,5,65,35,30,65
Brondby,2158,2,19,6,5,71,38,33,63
Copenhagen,2158,3,16,5,9,61,42,19,53
FC Nords,2158,4,13,8,9,72,53,19,47
AaB,2158,5,7,14,9,34,39,-5,35
Sonderjyske,2158,6,8,6,10,28,29,-1,30
AC Horsens,2158,7,5,14,11,32,54,-22,29
Randers FC,2158,8,6,6,12,25,39,-14,24
Silkeborg IF,2158,9,5,4,13,25,44,-19,19
AGF Aarhus,2158,10,4,7,11,16,36,-20,19
Lyngby,2158,11,3,9,12,26,46,-20,18
FC Midtjylla,2159,1,22,4,4,72,38,34,70
Brondby,2159,2,21,5,4,69,33,36,68
FC Nords,2159,3,14,7,9,72,51,21,49
Copenhagen,2159,4,14,5,11,57,44,13,47
AaB,2159,5,7,11,12,36,45,-9,32
Sonderjyske,2159,6,8,6,10,28,29,-1,30
AC Horsens,2159,7,6,12,12,33,54,-21,30
Randers FC,2159,8,6,6,12,25,40,-15,24
Silkeborg IF,2159,9,6,3,13,27,45,-18,21
Lyngby,2159,10,3,9,12,27,46,-19,18
AGF Aarhus,2159,11,4,6,12,17,38,-21,18
Brondby,2160,1,21,5,4,70,35,35,68
FC Midtjylla,2160,2,20,6,4,70,39,31,66
FC Nords,2160,3,14,7,9,77,57,20,49
Copenhagen,2160,4,14,5,11,63,47,16,47
AaB,2160,5,7,13,10,39,42,-3,34
Sonderjyske,2160,6,8,6,10,28,29,-1,30
AC Horsens,2160,7,6,12,12,33,58,-25,30
Randers FC,2160,8,5,7,12,24,40,-16,22
Silkeborg IF,2160,9,6,3,13,28,45,-17,21
Lyngby,2160,10,3,10,11,27,45,-18,19
AGF Aarhus,2160,11,4,6,12,17,39,-22,18
Brondby,2161,1,21,5,4,71,33,38,68
FC Midtjylla,2161,2,20,6,4,72,39,33,66
FC Nords,2161,3,14,7,9,74,57,17,49
Copenhagen,2161,4,14,7,9,58,42,16,49
AC Horsens,2161,5,6,13,11,35,51,-16,31
Sonderjyske,2161,6,8,6,10,28,29,-1,30
AaB,2161,7,6,12,12,33,47,-14,30
Lyngby,2161,8,4,9,11,29,45,-16,21
Randers FC,2161,9,5,6,13,24,42,-18,21
Silkeborg IF,2161,10,5,4,13,25,44,-19,19
AGF Aarhus,2161,11,4,7,11,16,36,-20,19
FC Midtjylla,2162,1,20,4,6,64,40,24,64
Brondby,2162,2,19,6,5,66,34,32,63
FC Nords,2162,3,15,7,8,76,51,25,52
Copenhagen,2162,4,14,4,12,60,47,13,46
AaB,2162,5,9,11,10,38,39,-1,38
AC Horsens,2162,6,7,12,11,32,51,-19,33
Sonderjyske,2162,7,8,6,10,28,29,-1,30
Randers FC,2162,8,6,6,12,25,40,-15,24
Silkeborg IF,2162,9,6,3,13,27,45,-18,21
Lyngby,2162,10,3,9,12,27,46,-19,18
AGF Aarhus,2162,11,4,6,12,17,38,-21,18
Brondby,2163,1,20,7,3,73,32,41,67
FC Midtjylla,2163,2,21,4,5,69,40,29,67
FC Nords,2163,3,13,8,9,71,53,18,47
Copenhagen,2163,4,14,4,12,56,42,14,46
AC Horsens,2163,5,7,14,9,36,48,-12,35
AaB,2163,6,7,11,12,37,53,-16,32
Sonderjyske,2163,7,8,6,10,28,29,-1,30
Randers FC,2163,8,6,6,12,25,40,-15,24
Silkeborg IF,2163,9,6,3,13,28,45,-17,21
Lyngby,2163,10,3,9,12,27,46,-19,18
AGF Aarhus,2163,11,4,6,12,17,39,-22,18
Brondby,2164,1,19,7,4,73,37,36,64
FC Midtjylla,2164,2,19,5,6,69,43,26,62
FC Nords,2164,3,16,7,7,76,49,27,55
Copenhagen,2164,4,14,4,12,56,43,13,46
AaB,2164,5,7,12,11,34,46,-12,33
AC Horsens,2164,6,6,15,9,38,54,-16,33
Sonderjyske,2164,7,8,6,10,28,29,-1,30
Lyngby,2164,8,4,9,11,29,46,-17,21
Randers FC,2164,9,5,6,13,25,42,-17,21
Silkeborg IF,2164,10,6,3,13,27,45,-18,21
AGF Aarhus,2164,11,4,6,12,17,38,-21,18
Brondby,2165,1,19,8,3,68,33,35,65
FC Midtjylla,2165,2,19,7,4,62,35,27,64
FC Nords,2165,3,14,7,9,72,54,18,49
Copenhagen,2165,4,13,5,12,59,46,13,44
AaB,2165,5,8,13,9,37,38,-1,37
AC Horsens,2165,6,7,12,11,36,54,-18,33
Sonderjyske,2165,7,8,6,10,28,29,-1,30
Randers FC,2165,8,6,6,12,26,39,-13,24
Silkeborg IF,2165,9,6,3,13,27,45,-18,21
Lyngby,2165,10,3,9,12,26,47,-21,18
AGF Aarhus,2165,11,4,6,12,17,38,-21,18
Brondby,2166,1,21,6,3,75,31,44,69
FC Midtjylla,2166,2,19,5,6,66,41,25,62
FC Nords,2166,3,15,6,9,75,57,18,51
Copenhagen,2166,4,14,4,12,57,46,11,46
AaB,2166,5,7,13,10,39,45,-6,34
AC Horsens,2166,6,6,14,10,37,55,-18,32
Sonderjyske,2166,7,8,6,10,28,29,-1,30
Randers FC,2166,8,5,7,12,24,40,-16,22
Lyngby,2166,9,3,10,11,27,45,-18,19
Silkeborg IF,2166,10,5,4,13,26,45,-19,19
AGF Aarhus,2166,11,4,7,11,17,37,-20,19
Brondby,2167,1,21,6,3,69,32,37,69
FC Midtjylla,2167,2,19,7,4,63,37,26,64
FC Nords,2167,3,15,7,8,75,52,23,52
Copenhagen,2167,4,13,6,11,55,43,12,45
AaB,2167,5,7,13,10,36,41,-5,34
Sonderjyske,2167,6,8,6,10,28,29,-1,30
AC Horsens,2167,7,5,13,12,35,54,-19,28
Lyngby,2167,8,4,9,11,28,44,-16,21
Silkeborg IF,2167,9,6,3,13,26,44,-18,21
Randers FC,2167,10,5,6,13,23,41,-18,21
AGF Aarhus,2167,11,4,6,12,16,37,-21,18
Brondby,2168,1,21,7,2,70,30,40,70
FC Midtjylla,2168,2,19,5,6,64,41,23,62
FC Nords,2168,3,15,6,9,78,56,22,51
Copenhagen,2168,4,15,5,10,57,41,16,50
AC Horsens,2168,5,6,13,11,36,53,-17,31
Sonderjyske,2168,6,8,6,10,28,29,-1,30
AaB,2168,7,6,12,12,33,43,-10,30
Lyngby,2168,8,4,9,11,29,45,-16,21
Randers FC,2168,9,5,6,13,24,42,-18,21
Silkeborg IF,2168,10,5,4,13,30,49,-19,19
AGF Aarhus,2168,11,4,7,11,21,41,-20,19
Brondby,2169,1,20,6,4,71,34,37,66
FC Midtjylla,2169,2,20,5,5,75,44,31,65
FC Nords,2169,3,15,6,9,78,53,25,51
Copenhagen,2169,4,13,5,12,58,48,10,44
AaB,2169,5,8,11,11,35,48,-13,35
AC Horsens,2169,6,7,13,10,35,51,-16,34
Sonderjyske,2169,7,8,6,10,28,29,-1,30
Lyngby,2169,8,4,9,11,28,45,-17,21
Randers FC,2169,9,5,6,13,24,41,-17,21
Silkeborg IF,2169,10,6,3,13,28,46,-18,21
AGF Aarhus,2169,11,4,6,12,18,39,-21,18
Brondby,2170,1,19,8,3,75,34,41,65
FC Midtjylla,2170,2,19,6,5,64,45,19,63
FC Nords,2170,3,13,8,9,77,51,26,47
Copenhagen,2170,4,12,5,13,59,57,2,41
AaB,2170,5,8,14,8,39,40,-1,38
AC Horsens,2170,6,7,15,8,36,49,-13,36
Sonderjyske,2170,7,8,6,10,28,29,-1,30
Randers FC,2170,8,6,6,12,24,39,-15,24
Silkeborg IF,2170,9,5,4,13,26,45,-19,19
AGF Aarhus,2170,10,4,7,11,17,37,-20,19
Lyngby,2170,11,3,9,12,26,45,-19,18
Brondby,2171,1,19,9,2,68,31,37,66
FC Midtjylla,2171,2,20,5,5,67,39,28,65
Copenhagen,2171,3,15,6,9,61,44,17,51
FC Nords,2171,4,12,8,10,67,50,17,44
AaB,2171,5,7,12,11,34,42,-8,33
AC Horsens,2171,6,6,14,10,37,54,-17,32
Sonderjyske,2171,7,8,6,10,28,29,-1,30
Randers FC,2171,8,5,7,12,25,41,-16,22
Lyngby,2171,9,3,10,11,28,46,-18,19
Silkeborg IF,2171,10,5,4,13,26,45,-19,19
AGF Aarhus,2171,11,4,7,11,17,37,-20,19
Brondby,2172,1,21,7,2,74,33,41,70
FC Midtjylla,2172,2,18,5,7,60,41,19,59
FC Nords,2172,3,16,7,7,78,47,31,55
Copenhagen,2172,4,13,6,11,55,45,10,45
AaB,2172,5,7,13,10,39,43,-4,34
Sonderjyske,2172,6,8,6,10,28,29,-1,30
AC Horsens,2172,7,6,12,12,34,57,-23,30
Randers FC,2172,8,6,6,12,24,39,-15,24
AGF Aarhus,2172,9,5,6,11,18,36,-18,21
Lyngby,2172,10,3,9,12,26,45,-19,18
Silkeborg IF,2172,11,5,3,14,25,46,-21,18
Brondby,2173,1,22,6,2,71,29,42,72
FC Midtjylla,2173,2,19,5,6,64,38,26,62
FC Nords,2173,3,14,7,9,70,49,21,49
Copenhagen,2173,4,13,4,13,52,47,5,43
AaB,2173,5,8,13,9,40,40,0,37
AC Horsens,2173,6,6,13,11,36,56,-20,31
Sonderjyske,2173,7,8,6,10,28,29,-1,30
Lyngby,2173,8,4,9,11,28,45,-17,21
Randers FC,2173,9,5,6,13,24,41,-17,21
Silkeborg IF,2173,10,5,4,13,26,45,-19,19
AGF Aarhus,2173,11,4,7,11,17,37,-20,19
Brondby,2174,1,21,6,3,71,33,38,69
FC Midtjylla,2174,2,20,6,4,64,35,29,66
FC Nords,2174,3,14,7,9,76,54,22,49
Copenhagen,2174,4,12,8,10,59,49,10,44
AaB,2174,5,7,12,11,37,45,-8,33
AC Horsens,2174,6,6,13,11,39,56,-17,31
Sonderjyske,2174,7,8,6,10,28,29,-1,30
Randers FC,2174,8,6,6,12,25,40,-15,24
Silkeborg IF,2174,9,6,3,13,27,44,-17,21
Lyngby,2174,10,3,9,12,27,46,-19,18
AGF Aarhus,2174,11,4,6,12,16,38,-22,18
Brondby,2175,1,21,6,3,70,29,41,69
FC Midtjylla,2175,2,19,4,7,64,42,22,61
FC Nords,2175,3,14,8,8,70,48,22,50
Copenhagen,2175,4,13,6,11,58,51,7,45
AaB,2175,5,8,14,8,39,39,0,38
Sonderjyske,2175,6,8,6,10,28,29,-1,30
AC Horsens,2175,7,5,14,11,33,51,-18,29
Randers FC,2175,8,5,7,12,24,40,-16,22
AGF Aarhus,2175,9,5,6,11,17,36,-19,21
Lyngby,2175,10,3,10,11,27,45,-18,19
Silkeborg IF,2175,11,5,3,14,25,45,-20,18
Brondby,2176,1,21,6,3,73,33,40,69
FC Midtjylla,2176,2,20,5,5,68,40,28,65
FC Nords,2176,3,14,8,8,71,49,22,50
Copenhagen,2176,4,13,4,13,57,48,9,43
AaB,2176,5,8,13,9,39,41,-2,37
Sonderjyske,2176,6,8,6,10,28,29,-1,30
AC Horsens,2176,7,6,12,12,35,58,-23,30
Randers FC,2176,8,5,7,12,23,39,-16,22
Lyngby,2176,9,3,10,11,26,44,-18,19
Silkeborg IF,2176,10,5,4,13,25,44,-19,19
AGF Aarhus,2176,11,4,7,11,16,36,-20,19
Brondby,2177,1,20,7,3,65,28,37,67
FC Midtjylla,2177,2,19,6,5,65,37,28,63
Copenhagen,2177,3,14,5,11,56,42,14,47
FC Nords,2177,4,12,9,9,68,54,14,45
AaB,2177,5,7,14,9,35,40,-5,35
AC Horsens,2177,6,6,15,9,33,47,-14,33
Sonderjyske,2177,7,8,6,10,28,29,-1,30
Randers FC,2177,8,6,6,12,26,41,-15,24
Silkeborg IF,2177,9,5,4,13,25,44,-19,19
AGF Aarhus,2177,10,4,7,11,16,36,-20,19
Lyngby,2177,11,3,9,12,28,47,-19,18
Brondby,2178,1,20,5,5,68,32,36,65
FC Midtjylla,2178,2,20,4,6,64,39,25,64
FC Nords,2178,3,16,6,8,77,59,18,54
Copenhagen,2178,4,15,5,10,62,43,19,50
AaB,2178,5,7,12,11,40,42,-2,33
Sonderjyske,2178,6,8,6,10,28,29,-1,30
AC Horsens,2178,7,6,12,12,33,55,-22,30
Lyngby,2178,8,4,9,11,28,45,-17,21
Randers FC,2178,9,5,6,13,24,41,-17,21
AGF Aarhus,2178,10,5,6,11,19,36,-17,21
Silkeborg IF,2178,11,5,3,14,25,47,-22,18
Brondby,2179,1,22,6,2,74,32,42,72
FC Midtjylla,2179,2,20,4,6,65,40,25,64
FC Nords,2179,3,14,6,10,73,54,19,48
Copenhagen,2179,4,13,5,12,55,44,11,44
AaB,2179,5,8,11,11,38,45,-7,35
AC Horsens,2179,6,6,14,10,36,52,-16,32
Sonderjyske,2179,7,8,6,10,28,29,-1,30
Lyngby,2179,8,4,9,11,28,45,-17,21
Randers FC,2179,9,5,6,13,24,41,-17,21
Silkeborg IF,2179,10,6,3,13,26,44,-18,21
AGF Aarhus,2179,11,4,6,12,16,37,-21,18
Brondby,2180,1,23,5,2,76,31,45,74
FC Midtjylla,2180,2,19,4,7,65,45,20,61
Copenhagen,2180,3,15,5,10,61,44,17,50
FC Nords,2180,4,13,6,11,69,54,15,45
AaB,2180,5,8,13,9,40,40,0,37
Sonderjyske,2180,6,8,6,10,28,29,-1,30
AC Horsens,2180,7,5,13,12,31,54,-23,28
Randers FC,2180,8,6,6,12,26,40,-14,24
Silkeborg IF,2180,9,6,3,13,26,44,-18,21
Lyngby,2180,10,3,9,12,27,47,-20,18
AGF Aarhus,2180,11,4,6,12,16,37,-21,18
Brondby,2181,1,20,5,5,67,33,34,65
FC Midtjylla,2181,2,20,5,5,63,38,25,65
FC Nords,2181,3,15,8,7,78,51,27,53
Copenhagen,2181,4,14,6,10,57,44,13,48
AaB,2181,5,7,12,11,36,42,-6,33
Sonderjyske,2181,6,8,6,10,28,29,-1,30
AC Horsens,2181,7,6,12,12,35,54,-19,30
Randers FC,2181,8,6,6,12,24,39,-15,24
AGF Aarhus,2181,9,5,6,11,17,36,-19,21
Lyngby,2181,10,3,9,12,26,45,-19,18
Silkeborg IF,2181,11,5,3,14,25,45,-20,18
FC Midtjylla,2182,1,20,4,6,67,39,28,64
Brondby,2182,2,19,6,5,68,34,34,63
FC Nords,2182,3,15,6,9,74,51,23,51
Copenhagen,2182,4,14,6,10,55,42,13,48
AaB,2182,5,7,13,10,35,44,-9,34
AC Horsens,2182,6,6,15,9,36,51,-15,33
Sonderjyske,2182,7,8,6,10,28,29,-1,30
Randers FC,2182,8,6,6,12,26,40,-14,24
AGF Aarhus,2182,9,5,6,11,18,37,-19,21
Lyngby,2182,10,3,9,12,27,47,-20,18
Silkeborg IF,2182,11,5,3,14,26,46,-20,18
Brondby,2183,1,21,6,3,71,32,39,69
FC Midtjylla,2183,2,19,6,5,61,38,23,63
FC Nords,2183,3,15,8,7,78,48,30,53
Copenhagen,2183,4,13,6,11,57,46,11,45
AC Horsens,2183,5,7,12,11,35,52,-17,33
Sonderjyske,2183,6,8,6,10,28,29,-1,30
AaB,2183,7,6,12,12,33,45,-12,30
Randers FC,2183,8,5,7,12,24,40,-16,22
AGF Aarhus,2183,9,5,6,11,19,36,-17,21
Lyngby,2183,10,3,10,11,27,45,-18,19
Silkeborg IF,2183,11,5,3,14,25,47,-22,18
Brondby,2184,1,19,7,4,71,33,38,64
FC Midtjylla,2184,2,19,5,6,63,44,19,62
FC Nords,2184,3,15,8,7,76,49,27,53
Copenhagen,2184,4,13,8,9,56,42,14,47
AaB,2184,5,7,12,11,35,41,-6,33
AC Horsens,2184,6,6,14,10,34,52,-18,32
Sonderjyske,2184,7,8,6,10,28,29,-1,30
Randers FC,2184,8,6,6,12,25,39,-14,24
Silkeborg IF,2184,9,5,4,13,26,45,-19,19
AGF Aarhus,2184,10,4,7,11,17,37,-20,19
Lyngby,2184,11,3,9,12,26,46,-20,18
FC Midtjylla,2185,1,20,6,4,67,38,29,66
Brondby,2185,2,19,5,6,66,39,27,62
FC Nords,2185,3,15,6,9,78,58,20,51
Copenhagen,2185,4,14,6,10,59,46,13,48
AaB,2185,5,8,12,10,40,41,-1,36
AC Horsens,2185,6,6,13,11,41,55,-14,31
Sonderjyske,2185,7,8,6,10,28,29,-1,30
Randers FC,2185,8,5,7,12,24,40,-16,22
Silkeborg IF,2185,9,6,3,13,28,44,-16,21
Lyngby,2185,10,3,10,11,27,45,-18,19
AGF Aarhus,2185,11,4,6,12,16,39,-23,18
Brondby,2186,1,20,7,3,70,30,40,67
FC Midtjylla,2186,2,20,6,4,66,35,31,66
Copenhagen,2186,3,15,5,10,60,43,17,50
FC Nords,2186,4,14,6,10,75,60,15,48
AC Horsens,2186,5,7,13,10,36,50,-14,34
Sonderjyske,2186,6,8,6,10,28,29,-1,30
AaB,2186,7,6,11,13,35,50,-15,29
Lyngby,2186,8,4,9,11,28,44,-16,21
Randers FC,2186,9,5,6,13,23,41,-18,21
Silkeborg IF,2186,10,5,4,13,26,45,-19,19
AGF Aarhus,2186,11,4,7,11,17,37,-20,19
FC Midtjylla,2187,1,21,4,5,69,37,32,67
Brondby,2187,2,19,6,5,67,36,31,63
FC Nords,2187,3,16,7,7,79,51,28,55
Copenhagen,2187,4,13,6,11,58,45,13,45
AC Horsens,2187,5,7,13,10,34,53,-19,34
Sonderjyske,2187,6,8,6,10,28,29,-1,30
AaB,2187,7,6,12,12,35,46,-11,30
Randers FC,2187,8,5,7,12,23,39,-16,22
Lyngby,2187,9,3,10,11,26,44,-18,19
Silkeborg IF,2187,10,5,4,13,26,45,-19,19
AGF Aarhus,2187,11,4,7,11,17,37,-20,19
Brondby,2188,1,20,6,4,71,32,39,66
FC Midtjylla,2188,2,19,5,6,64,41,23,62
FC Nords,2188,3,15,6,9,73,46,27,51
Copenhagen,2188,4,13,6,11,57,45,12,45
AaB,2188,5,8,12,10,35,43,-8,36
AC Horsens,2188,6,7,13,10,36,55,-19,34
Sonderjyske,2188,7,8,6,10,28,29,-1,30
Randers FC,2188,8,6,6,12,25,40,-15,24
Silkeborg IF,2188,9,6,3,13,30,46,-16,21
Lyngby,2188,10,3,9,12,27,46,-19,18
AGF Aarhus,2188,11,4,6,12,18,41,-23,18
Brondby,2189,1,20,8,2,68,30,38,68
FC Midtjylla,2189,2,20,6,4,69,38,31,66
FC Nords,2189,3,14,6,10,69,50,19,48
Copenhagen,2189,4,13,5,12,56,48,8,44
AC Horsens,2189,5,7,14,9,39,51,-12,35
AaB,2189,6,6,13,11,40,50,-10,31
Sonderjyske,2189,7,8,6,10,28,29,-1,30
Lyngby,2189,8,4,9,11,27,44,-17,21
Randers FC,2189,9,5,6,13,23,40,-17,21
AGF Aarhus,2189,10,5,6,11,19,38,-19,21
Silkeborg IF,2189,11,5,3,14,27,47,-20,18
Brondby,2190,1,20,7,3,66,31,35,67
FC Midtjylla,2190,2,19,5,6,67,42,25,62
FC Nords,2190,3,14,8,8,70,45,25,50
Copenhagen,2190,4,14,4,12,58,47,11,46
AaB,2190,5,8,13,9,39,42,-3,37
AC Horsens,2190,6,6,13,11,34,53,-19,31
Sonderjyske,2190,7,8,6,10,28,29,-1,30
Randers FC,2190,8,6,6,12,25,39,-14,24
Silkeborg IF,2190,9,6,3,13,27,45,-18,21
Lyngby,2190,10,3,9,12,26,46,-20,18
AGF Aarhus,2190,11,4,6,12,17,38,-21,18
Brondby,2191,1,22,6,2,74,31,43,72
FC Midtjylla,2191,2,19,6,5,70,40,30,63
FC Nords,2191,3,13,7,10,71,57,14,46
Copenhagen,2191,4,13,5,12,55,46,9,44
AaB,2191,5,7,14,9,36,41,-5,35
AC Horsens,2191,6,6,14,10,37,54,-17,32
Sonderjyske,2191,7,8,6,10,28,29,-1,30
Lyngby,2191,8,4,9,11,28,45,-17,21
Randers FC,2191,9,5,6,13,24,41,-17,21
AGF Aarhus,2191,10,5,6,11,17,36,-19,21
Silkeborg IF,2191,11,5,3,14,25,45,-20,18
Brondby,2192,1,22,5,3,74,32,42,71
FC Midtjylla,2192,2,18,5,7,63,41,22,59
Copenhagen,2192,3,14,5,11,58,49,9,47
FC Nords,2192,4,12,7,11,75,60,15,43
AaB,2192,5,8,13,9,41,42,-1,37
AC Horsens,2192,6,7,15,8,38,51,-13,36
Sonderjyske,2192,7,8,6,10,28,29,-1,30
Randers FC,2192,8,5,7,12,25,41,-16,22
Silkeborg IF,2192,9,6,3,13,27,44,-17,21
Lyngby,2192,10,3,10,11,28,46,-18,19
AGF Aarhus,2192,11,4,6,12,16,38,-22,18
Brondby,2193,1,23,5,2,77,30,47,74
FC Midtjylla,2193,2,20,4,6,65,40,25,64
Copenhagen,2193,3,14,6,10,60,44,16,48
FC Nords,2193,4,13,6,11,68,55,13,45
AaB,2193,5,8,12,10,37,42,-5,36
Sonderjyske,2193,6,8,6,10,28,29,-1,30
AC Horsens,2193,7,5,13,12,33,55,-22,28
Randers FC,2193,8,6,6,12,26,39,-13,24
Silkeborg IF,2193,9,6,3,13,28,44,-16,21
Lyngby,2193,10,3,9,12,26,47,-21,18
AGF Aarhus,2193,11,4,6,12,16,39,-23,18
FC Midtjylla,2194,1,20,5,5,67,43,24,65
Brondby,2194,2,19,6,5,65,33,32,63
FC Nords,2194,3,14,6,10,69,51,18,48
Copenhagen,2194,4,14,5,11,59,45,14,47
AaB,2194,5,10,12,8,42,39,3,42
Sonderjyske,2194,6,8,6,10,28,29,-1,30
AC Horsens,2194,7,6,12,12,36,53,-17,30
Randers FC,2194,8,5,7,12,23,39,-16,22
Lyngby,2194,9,3,10,11,26,44,-18,19
Silkeborg IF,2194,10,5,4,13,26,45,-19,19
AGF Aarhus,2194,11,4,7,11,17,37,-20,19
Brondby,2195,1,21,5,4,74,31,43,68
FC Midtjylla,2195,2,21,4,5,69,41,28,67
FC Nords,2195,3,14,7,9,75,52,23,49
Copenhagen,2195,4,13,5,12,55,44,11,44
AaB,2195,5,9,11,10,36,44,-8,38
Sonderjyske,2195,6,8,6,10,28,29,-1,30
AC Horsens,2195,7,6,12,12,31,54,-23,30
Lyngby,2195,8,4,9,11,29,44,-15,21
Randers FC,2195,9,5,6,13,23,42,-19,21
Silkeborg IF,2195,10,5,4,13,27,46,-19,19
AGF Aarhus,2195,11,4,7,11,18,38,-20,19
Brondby,2196,1,21,6,3,76,32,44,69
FC Midtjylla,2196,2,17,6,7,60,45,15,57
FC Nords,2196,3,15,7,8,79,52,27,52
Copenhagen,2196,4,15,5,10,58,43,15,50
AaB,2196,5,8,11,11,36,42,-6,35
AC Horsens,2196,6,6,13,11,33,54,-21,31
Sonderjyske,2196,7,8,6,10,28,29,-1,30
Randers FC,2196,8,5,7,12,24,40,-16,22
Silkeborg IF,2196,9,6,3,13,29,45,-16,21
Lyngby,2196,10,3,10,11,27,45,-18,19
AGF Aarhus,2196,11,4,6,12,17,40,-23,18
Brondby,2197,1,20,5,5,68,34,34,65
FC Midtjylla,2197,2,19,5,6,70,40,30,62
FC Nords,2197,3,15,8,7,77,50,27,53
Copenhagen,2197,4,13,6,11,57,46,11,45
AaB,2197,5,8,12,10,39,49,-10,36
AC Horsens,2197,6,6,14,10,35,53,-18,32
Sonderjyske,2197,7,8,6,10,28,29,-1,30
Randers FC,2197,8,6,6,12,25,40,-15,24
AGF Aarhus,2197,9,5,6,11,17,36,-19,21
Lyngby,2197,10,3,9,12,27,46,-19,18
Silkeborg IF,2197,11,5,3,14,25,45,-20,18
Brondby,2198,1,21,5,4,74,35,39,68
FC Midtjylla,2198,2,19,7,4,70,40,30,64
FC Nords,2198,3,14,7,9,76,53,23,49
Copenhagen,2198,4,14,6,10,62,48,14,48
AaB,2198,5,8,13,9,39,44,-5,37
Sonderjyske,2198,6,8,6,10,28,29,-1,30
AC Horsens,2198,7,5,12,13,33,60,-27,27
Lyngby,2198,8,4,9,11,30,46,-16,21
Randers FC,2198,9,5,6,13,25,43,-18,21
Silkeborg IF,2198,10,5,4,13,25,44,-19,19
AGF Aarhus,2198,11,4,7,11,16,36,-20,19
Brondby,2199,1,20,8,2,72,32,40,68
FC Midtjylla,2199,2,20,4,6,74,46,28,64
FC Nords,2199,3,13,7,10,71,59,12,46
Copenhagen,2199,4,12,7,11,56,45,11,43
AaB,2199,5,8,13,9,38,40,-2,37
AC Horsens,2199,6,7,13,10,36,51,-15,34
Sonderjyske,2199,7,8,6,10,28,29,-1,30
Randers FC,2199,8,5,7,12,24,40,-16,22
Silkeborg IF,2199,9,6,3,13,28,45,-17,21
Lyngby,2199,10,3,10,11,27,45,-18,19
AGF Aarhus,2199,11,4,6,12,17,39,-22,18
Brondby,2200,1,20,6,4,70,37,33,66
FC Midtjylla,2200,2,19,5,6,64,38,26,62
FC Nords,2200,3,15,7,8,79,54,25,52
Copenhagen,2200,4,15,5,10,61,44,17,50
AaB,2200,5,8,12,10,38,43,-5,36
Sonderjyske,2200,6,8,6,10,28,29,-1,30
AC Horsens,2200,7,5,13,12,34,56,-22,28
Randers FC,2200,8,5,7,12,24,40,-16,22
AGF Aarhus,2200,9,5,6,11,20,37,-17,21
Lyngby,2200,10,3,10,11,27,45,-18,19
Silkeborg IF,2200,11,5,3,14,26,48,-22,18
Brondby,2201,1,21,6,3,72,34,38,69
FC Midtjylla,2201,2,20,5,5,63,36,27,65
FC Nords,2201,3,13,9,8,73,51,22,48
Copenhagen,2201,4,12,5,13,56,48,8,41
AaB,2201,5,9,12,9,37,40,-3,39
AC Horsens,2201,6,6,13,11,35,53,-18,31
Sonderjyske,2201,7,8,6,10,28,29,-1,30
Lyngby,2201,8,4,9,11,29,45,-16,21
Silkeborg IF,2201,9,6,3,13,26,44,-18,21
Randers FC,2201,10,5,6,13,24,42,-18,21
AGF Aarhus,2201,11,4,6,12,16,37,-21,18
Brondby,2202,1,21,6,3,73,32,41,69
FC Midtjylla,2202,2,19,6,5,66,41,25,63
FC Nords,2202,3,15,7,8,77,54,23,52
Copenhagen,2202,4,14,4,12,59,49,10,46
AC Horsens,2202,5,7,12,11,34,50,-16,33
AaB,2202,6,7,11,12,36,45,-9,32
Sonderjyske,2202,7,8,6,10,28,29,-1,30
Lyngby,2202,8,4,9,11,27,44,-17,21
Randers FC,2202,9,5,6,13,23,40,-17,21
AGF Aarhus,2202,10,5,6,11,17,36,-19,21
Silkeborg IF,2202,11,5,3,14,25,45,-20,18
FC Midtjylla,2203,1,20,5,5,66,39,27,65
Brondby,2203,2,19,5,6,73,38,35,62
Copenhagen,2203,3,15,4,11,61,45,16,49
FC Nords,2203,4,14,6,10,77,55,22,48
AaB,2203,5,9,12,9,36,42,-6,39
AC Horsens,2203,6,7,12,11,37,57,-20,33
Sonderjyske,2203,7,8,6,10,28,29,-1,30
Randers FC,2203,8,5,7,12,25,41,-16,22
Lyngby,2203,9,3,10,11,28,46,-18,19
Silkeborg IF,2203,10,5,4,13,26,45,-19,19
AGF Aarhus,2203,11,4,7,11,17,37,-20,19
Brondby,2204,1,20,7,3,72,37,35,67
FC Midtjylla,2204,2,20,5,5,69,38,31,65
FC Nords,2204,3,15,8,7,80,52,28,53
Copenhagen,2204,4,14,5,11,58,46,12,47
AC Horsens,2204,5,7,12,11,34,56,-22,33
Sonderjyske,2204,6,8,6,10,28,29,-1,30
AaB,2204,7,6,11,13,36,46,-10,29
Randers FC,2204,8,5,7,12,24,40,-16,22
Lyngby,2204,9,3,10,11,27,45,-18,19
Silkeborg IF,2204,10,5,4,13,25,44,-19,19
AGF Aarhus,2204,11,4,7,11,16,36,-20,19
Brondby,2205,1,19,6,5,69,39,30,63
FC Midtjylla,2205,2,19,6,5,69,41,28,63
Copenhagen,2205,3,14,5,11,59,44,15,47
FC Nords,2205,4,12,6,12,69,57,12,42
AC Horsens,2205,5,10,12,8,39,48,-9,42
AaB,2205,6,9,11,10,41,43,-2,38
Sonderjyske,2205,7,8,6,10,28,29,-1,30
Lyngby,2205,8,4,9,11,30,44,-14,21
Silkeborg IF,2205,9,6,3,13,29,45,-16,21
Randers FC,2205,10,5,6,13,23,43,-20,21
AGF Aarhus,2205,11,4,6,12,17,40,-23,18
Brondby,2206,1,22,6,2,74,30,44,72
FC Midtjylla,2206,2,20,4,6,67,39,28,64
FC Nords,2206,3,13,7,10,69,53,16,46
Copenhagen,2206,4,12,4,14,53,51,2,40
AaB,2206,5,9,12,9,38,37,1,39
AC Horsens,2206,6,7,13,10,39,56,-17,34
Sonderjyske,2206,7,8,6,10,28,29,-1,30
Randers FC,2206,8,6,6,12,26,41,-15,24
Silkeborg IF,2206,9,5,4,13,27,46,-19,19
AGF Aarhus,2206,10,4,7,11,18,38,-20,19
Lyngby,2206,11,3,9,12,28,47,-19,18
Brondby,2207,1,20,6,4,69,33,36,66
FC Midtjylla,2207,2,19,6,5,65,41,24,63
Copenhagen,2207,3,16,4,10,61,43,18,52
FC Nords,2207,4,14,6,10,72,50,22,48
AaB,2207,5,7,12,11,36,46,-10,33
AC Horsens,2207,6,6,14,10,35,51,-16,32
Sonderjyske,2207,7,8,6,10,28,29,-1,30
Randers FC,2207,8,5,7,12,23,39,-16,22
AGF Aarhus,2207,9,5,6,11,17,36,-19,21
Lyngby,2207,10,3,10,11,26,44,-18,19
Silkeborg IF,2207,11,5,3,14,25,45,-20,18
FC Midtjylla,2208,1,22,4,4,76,39,37,70
Brondby,2208,2,19,5,6,67,37,30,62
FC Nords,2208,3,15,6,9,77,59,18,51
Copenhagen,2208,4,14,4,12,56,44,12,46
AaB,2208,5,8,12,10,38,42,-4,36
AC Horsens,2208,6,6,13,11,35,54,-19,31
Sonderjyske,2208,7,8,6,10,28,29,-1,30
Silkeborg IF,2208,8,6,3,13,29,46,-17,21
Lyngby,2208,9,4,9,11,27,44,-17,21
Randers FC,2208,10,5,6,13,23,40,-17,21
AGF Aarhus,2208,11,4,6,12,18,40,-22,18
Brondby,2209,1,20,8,2,72,34,38,68
FC Midtjylla,2209,2,21,4,5,69,40,29,67
FC Nords,2209,3,14,7,9,73,51,22,49
Copenhagen,2209,4,13,7,10,55,42,13,46
AaB,2209,5,6,13,11,37,46,-9,31
Sonderjyske,2209,6,8,6,10,28,29,-1,30
AC Horsens,2209,7,5,15,10,34,53,-19,30
Lyngby,2209,8,4,9,11,28,44,-16,21
Randers FC,2209,9,5,6,13,23,41,-18,21
AGF Aarhus,2209,10,5,6,11,18,37,-19,21
Silkeborg IF,2209,11,5,3,14,26,46,-20,18
Brondby,2210,1,21,6,3,76,34,42,69
FC Midtjylla,2210,2,20,4,6,66,45,21,64
FC Nords,2210,3,14,7,9,77,54,23,49
Copenhagen,2210,4,13,5,12,59,51,8,44
AaB,2210,5,9,12,9,39,41,-2,39
Sonderjyske,2210,6,8,6,10,28,29,-1,30
AC Horsens,2210,7,5,14,11,36,54,-18,29
Lyngby,2210,8,4,9,11,28,45,-17,21
Randers FC,2210,9,5,6,13,24,41,-17,21
Silkeborg IF,2210,10,5,4,13,27,46,-19,19
AGF Aarhus,2210,11,4,7,11,18,38,-20,19
Brondby,2211,1,21,5,4,75,32,43,68
FC Midtjylla,2211,2,20,4,6,72,43,29,64
Copenhagen,2211,3,15,4,11,65,47,18,49
FC Nords,2211,4,14,7,9,71,55,16,49
AaB,2211,5,8,11,11,37,48,-11,35
AC Horsens,2211,6,6,13,11,31,52,-21,31
Sonderjyske,2211,7,8,6,10,28,29,-1,30
Lyngby,2211,8,4,9,11,28,45,-17,21
Silkeborg IF,2211,8,6,3,13,28,45,-17,21
Randers FC,2211,10,5,6,13,24,41,-17,21
AGF Aarhus,2211,11,4,6,12,17,39,-22,18
FC Midtjylla,2212,1,21,4,5,70,38,32,67
Brondby,2212,2,20,6,4,68,30,38,66
FC Nords,2212,3,16,6,8,76,50,26,54
Copenhagen,2212,4,14,4,12,58,47,11,46
AC Horsens,2212,5,6,14,10,33,52,-19,32
Sonderjyske,2212,6,8,6,10,28,29,-1,30
AaB,2212,7,6,12,12,31,45,-14,30
Randers FC,2212,8,5,7,12,26,42,-16,22
Silkeborg IF,2212,9,6,3,13,27,44,-17,21
Lyngby,2212,10,3,10,11,29,47,-18,19
AGF Aarhus,2212,11,4,6,12,16,38,-22,18
Brondby,2213,1,20,7,3,68,29,39,67
FC Midtjylla,2213,2,20,4,6,65,42,23,64
Copenhagen,2213,3,14,7,9,61,44,17,49
FC Nords,2213,4,13,9,8,72,50,22,48
AC Horsens,2213,5,7,13,10,38,53,-15,34
Sonderjyske,2213,6,8,6,10,28,29,-1,30
AaB,2213,7,6,12,12,35,47,-12,30
Randers FC,2213,8,5,7,12,24,40,-16,22
Lyngby,2213,9,3,10,11,27,45,-18,19
Silkeborg IF,2213,10,5,4,13,26,45,-19,19
AGF Aarhus,2213,11,4,7,11,17,37,-20,19
Brondby,2214,1,21,5,4,74,33,41,68
FC Midtjylla,2214,2,19,4,7,63,40,23,61
FC Nords,2214,3,15,6,9,71,50,21,51
Copenhagen,2214,4,14,4,12,57,48,9,46
AC Horsens,2214,5,8,13,9,39,49,-10,37
AaB,2214,6,7,12,11,36,46,-10,33
Sonderjyske,2214,7,8,6,10,28,29,-1,30
Randers FC,2214,8,5,7,12,23,39,-16,22
AGF Aarhus,2214,9,5,6,11,19,36,-17,21
Lyngby,2214,10,3,10,11,26,44,-18,19
Silkeborg IF,2214,11,5,3,14,25,47,-22,18
Brondby,2215,1,21,7,2,71,31,40,70
FC Midtjylla,2215,2,18,6,6,62,40,22,60
FC Nords,2215,3,13,9,8,70,52,18,48
Copenhagen,2215,4,12,8,10,55,46,9,44
AaB,2215,5,8,12,10,43,44,-1,36
AC Horsens,2215,6,6,14,10,38,52,-14,32
Sonderjyske,2215,7,8,6,10,28,29,-1,30
Randers FC,2215,8,5,7,12,25,41,-16,22
Lyngby,2215,9,3,10,11,28,46,-18,19
Silkeborg IF,2215,10,5,4,13,26,45,-19,19
AGF Aarhus,2215,11,4,7,11,17,37,-20,19
Brondby,2216,1,19,6,5,65,32,33,63
FC Midtjylla,2216,2,19,5,6,65,43,22,62
FC Nords,2216,3,14,8,8,75,50,25,50
Copenhagen,2216,4,15,5,10,59,44,15,50
AaB,2216,5,8,13,9,39,42,-3,37
AC Horsens,2216,6,6,13,11,35,53,-18,31
Sonderjyske,2216,7,8,6,10,28,29,-1,30
Lyngby,2216,8,4,9,11,28,44,-16,21
Randers FC,2216,9,5,6,13,23,41,-18,21
Silkeborg IF,2216,10,5,4,13,25,44,-19,19
AGF Aarhus,2216,11,4,7,11,16,36,-20,19
Brondby,2217,1,21,6,3,73,32,41,69
FC Midtjylla,2217,2,19,7,4,70,37,33,64
Copenhagen,2217,3,15,5,10,61,45,16,50
FC Nords,2217,4,13,7,10,71,57,14,46
AaB,2217,5,7,13,10,37,44,-7,34
Sonderjyske,2217,6,8,6,10,28,29,-1,30
AC Horsens,2217,7,6,12,12,36,59,-23,30
Randers FC,2217,8,6,6,12,27,40,-13,24
Silkeborg IF,2217,9,5,4,13,26,45,-19,19
AGF Aarhus,2217,10,4,7,11,17,37,-20,19
Lyngby,2217,11,3,9,12,27,48,-21,18
Brondby,2218,1,21,6,3,72,32,40,69
FC Midtjylla,2218,2,19,5,6,72,45,27,62
FC Nords,2218,3,14,8,8,76,55,21,50
Copenhagen,2218,4,15,4,11,60,46,14,49
AaB,2218,5,7,12,11,40,51,-11,33
AC Horsens,2218,6,6,13,11,36,53,-17,31
Sonderjyske,2218,7,8,6,10,28,29,-1,30
Lyngby,2218,8,4,9,11,30,45,-15,21
AGF Aarhus,2218,9,5,6,11,20,37,-17,21
Randers FC,2218,10,5,6,13,24,43,-19,21
Silkeborg IF,2218,11,5,3,14,26,48,-22,18
Brondby,2219,1,21,7,2,73,34,39,70
FC Midtjylla,2219,2,19,6,5,65,38,27,63
FC Nords,2219,3,13,10,7,73,50,23,49
Copenhagen,2219,4,13,6,11,57,45,12,45
AC Horsens,2219,5,6,15,9,35,50,-15,33
Sonderjyske,2219,6,8,6,10,28,29,-1,30
AaB,2219,7,6,12,12,33,45,-12,30
Randers FC,2219,8,5,7,12,24,40,-16,22
Silkeborg IF,2219,9,6,3,13,27,45,-18,21
Lyngby,2219,10,3,10,11,27,45,-18,19
AGF Aarhus,2219,11,4,6,12,17,38,-21,18
Brondby,2220,1,23,5,2,76,33,43,74
FC Midtjylla,2220,2,19,5,6,69,44,25,62
FC Nords,2220,3,15,6,9,73,50,23,51
Copenhagen,2220,4,14,4,12,60,47,13,46
AaB,2220,5,7,11,12,36,47,-11,32
AC Horsens,2220,6,6,13,11,37,56,-19,31
Sonderjyske,2220,7,8,6,10,28,29,-1,30
Lyngby,2220,8,4,9,11,28,45,-17,21
Randers FC,2220,9,5,6,13,24,41,-17,21
AGF Aarhus,2220,10,5,6,11,18,37,-19,21
Silkeborg IF,2220,11,5,3,14,26,46,-20,18
Brondby,2221,1,19,6,5,67,38,29,63
FC Midtjylla,2221,2,19,4,7,64,38,26,61
FC Nords,2221,3,16,7,7,80,54,26,55
Copenhagen,2221,4,15,4,11,60,42,18,49
AaB,2221,5,7,13,10,36,44,-8,34
AC Horsens,2221,6,7,12,11,35,52,-17,33
Sonderjyske,2221,7,8,6,10,28,29,-1,30
Lyngby,2221,8,4,9,11,28,45,-17,21
Randers FC,2221,9,5,6,13,24,41,-17,21
Silkeborg IF,2221,10,5,4,13,27,46,-19,19
AGF Aarhus,2221,11,4,7,11,18,38,-20,19
Brondby,2222,1,22,5,3,73,35,38,71
FC Midtjylla,2222,2,20,4,6,67,42,25,64
Copenhagen,2222,3,15,5,10,63,41,22,50
FC Nords,2222,4,14,6,10,73,54,19,48
AaB,2222,5,7,12,11,36,45,-9,33
Sonderjyske,2222,6,8,6,10,28,29,-1,30
AC Horsens,2222,7,6,12,12,33,54,-21,30
Randers FC,2222,8,6,6,12,25,40,-15,24
AGF Aarhus,2222,9,5,6,11,17,36,-19,21
Lyngby,2222,10,3,9,12,27,46,-19,18
Silkeborg IF,2222,11,5,3,14,25,45,-20,18
Brondby,2223,1,23,5,2,79,29,50,74
FC Midtjylla,2223,2,19,4,7,64,41,23,61
Copenhagen,2223,3,15,5,10,59,44,15,50
FC Nords,2223,4,12,6,12,70,60,10,42
AaB,2223,5,8,12,10,37,44,-7,36
AC Horsens,2223,6,7,12,11,33,50,-17,33
Sonderjyske,2223,7,8,6,10,28,29,-1,30
Lyngby,2223,8,4,9,11,29,44,-15,21
Randers FC,2223,9,5,6,13,23,42,-19,21
Silkeborg IF,2223,10,5,4,13,26,45,-19,19
AGF Aarhus,2223,11,4,7,11,17,37,-20,19
FC Midtjylla,2224,1,21,5,4,69,36,33,68
Brondby,2224,2,20,7,3,72,35,37,67
FC Nords,2224,3,14,7,9,72,48,24,49
Copenhagen,2224,4,13,6,11,55,45,10,45
AC Horsens,2224,5,6,14,10,35,53,-18,32
AaB,2224,6,6,13,11,33,45,-12,31
Sonderjyske,2224,7,8,6,10,28,29,-1,30
Randers FC,2224,8,6,6,12,25,40,-15,24
Silkeborg IF,2224,9,6,3,13,28,44,-16,21
Lyngby,2224,10,3,9,12,27,46,-19,18
AGF Aarhus,2224,11,4,6,12,16,39,-23,18
Brondby,2225,1,20,7,3,70,32,38,67
FC Midtjylla,2225,2,19,5,6,65,41,24,62
FC Nords,2225,3,15,7,8,74,48,26,52
Copenhagen,2225,4,13,7,10,56,45,11,46
AaB,2225,5,7,13,10,37,43,-6,34
AC Horsens,2225,6,6,13,11,35,54,-19,31
Sonderjyske,2225,7,8,6,10,28,29,-1,30
Randers FC,2225,8,6,6,12,24,39,-15,24
Silkeborg IF,2225,9,6,3,13,26,44,-18,21
Lyngby,2225,10,3,9,12,26,45,-19,18
AGF Aarhus,2225,11,4,6,12,16,37,-21,18
FC Midtjylla,2226,1,20,6,4,65,36,29,66
Brondby,2226,2,19,7,4,67,36,31,64
FC Nords,2226,3,14,8,8,74,51,23,50
Copenhagen,2226,4,15,5,10,59,40,19,50
AaB,2226,5,6,14,10,34,41,-7,32
Sonderjyske,2226,6,8,6,10,28,29,-1,30
AC Horsens,2226,7,5,14,11,33,54,-21,29
Lyngby,2226,8,4,9,11,29,45,-16,21
Randers FC,2226,9,5,6,13,24,42,-18,21
Silkeborg IF,2226,10,5,4,13,26,45,-19,19
AGF Aarhus,2226,11,4,7,11,17,37,-20,19
Brondby,2227,1,19,6,5,65,33,32,63
FC Midtjylla,2227,2,18,7,5,60,35,25,61
FC Nords,2227,3,15,7,8,71,47,24,52
Copenhagen,2227,4,14,6,10,58,41,17,48
AaB,2227,5,8,12,10,35,40,-5,36
AC Horsens,2227,6,6,14,10,32,51,-19,32
Sonderjyske,2227,7,8,6,10,28,29,-1,30
Randers FC,2227,8,5,7,12,23,39,-16,22
Silkeborg IF,2227,9,6,3,13,26,44,-18,21
Lyngby,2227,10,3,10,11,26,44,-18,19
AGF Aarhus,2227,11,4,6,12,16,37,-21,18
Brondby,2228,1,22,5,3,77,32,45,71
FC Midtjylla,2228,2,20,4,6,66,41,25,64
FC Nords,2228,3,14,7,9,73,55,18,49
Copenhagen,2228,4,13,6,11,60,48,12,45
AaB,2228,5,8,11,11,37,42,-5,35
AC Horsens,2228,6,6,13,11,32,53,-21,31
Sonderjyske,2228,7,8,6,10,28,29,-1,30
Lyngby,2228,8,4,9,11,28,45,-17,21
Randers FC,2228,9,5,6,13,24,41,-17,21
Silkeborg IF,2228,10,5,4,13,26,45,-19,19
AGF Aarhus,2228,11,4,7,11,17,37,-20,19
Brondby,2229,1,19,6,5,67,34,33,63
FC Midtjylla,2229,2,19,5,6,64,42,22,62
Copenhagen,2229,3,17,4,9,64,40,24,55
FC Nords,2229,4,16,6,8,75,52,23,54
AaB,2229,5,7,11,12,39,45,-6,32
Sonderjyske,2229,6,8,6,10,28,29,-1,30
AC Horsens,2229,7,5,14,11,36,58,-22,29
Randers FC,2229,8,5,7,12,24,40,-16,22
AGF Aarhus,2229,9,5,6,11,17,36,-19,21
Lyngby,2229,10,3,10,11,27,45,-18,19
Silkeborg IF,2229,11,5,3,14,25,45,-20,18
Brondby,2230,1,20,6,4,72,40,32,66
FC Midtjylla,2230,2,19,7,4,66,36,30,64
FC Nords,2230,3,13,8,9,73,54,19,47
Copenhagen,2230,4,13,6,11,54,41,13,45
AaB,2230,5,7,14,9,37,42,-5,35
AC Horsens,2230,6,5,17,8,32,47,-15,32
Sonderjyske,2230,7,8,6,10,28,29,-1,30
Randers FC,2230,8,5,7,12,26,42,-16,22
Silkeborg IF,2230,9,6,3,13,26,44,-18,21
Lyngby,2230,10,3,10,11,29,47,-18,19
AGF Aarhus,2230,11,4,6,12,16,37,-21,18
Brondby,2231,1,20,7,3,72,31,41,67
FC Midtjylla,2231,2,19,4,7,60,38,22,61
Copenhagen,2231,3,15,5,10,58,42,16,50
FC Nords,2231,4,14,7,9,70,56,14,49
AaB,2231,5,7,13,10,35,41,-6,34
AC Horsens,2231,6,7,12,11,39,52,-13,33
Sonderjyske,2231,7,8,6,10,28,29,-1,30
Lyngby,2231,8,4,9,11,28,45,-17,21
Randers FC,2231,9,5,6,13,24,41,-17,21
AGF Aarhus,2231,10,5,6,11,17,36,-19,21
Silkeborg IF,2231,11,5,3,14,25,45,-20,18
Brondby,2232,1,20,6,4,70,32,38,66
FC Midtjylla,2232,2,20,4,6,64,37,27,64
FC Nords,2232,3,14,6,10,71,52,19,48
Copenhagen,2232,4,14,4,12,55,44,11,46
AaB,2232,5,8,12,10,39,45,-6,36
AC Horsens,2232,6,8,12,10,35,50,-15,36
Sonderjyske,2232,7,8,6,10,28,29,-1,30
Randers FC,2232,8,5,7,12,24,40,-16,22
Silkeborg IF,2232,9,6,3,13,26,44,-18,21
Lyngby,2232,10,3,10,11,27,45,-18,19
AGF Aarhus,2232,11,4,6,12,16,37,-21,18
Brondby,2233,1,20,6,4,69,36,33,66
FC Midtjylla,2233,2,20,5,5,68,39,29,65
FC Nords,2233,3,12,10,8,72,52,20,46
Copenhagen,2233,4,13,6,11,58,44,14,45
AaB,2233,5,8,12,10,40,46,-6,36
AC Horsens,2233,6,7,13,10,36,52,-16,34
Sonderjyske,2233,7,8,6,10,28,29,-1,30
Lyngby,2233,8,4,9,11,28,45,-17,21
Randers FC,2233,9,5,6,13,24,41,-17,21
AGF Aarhus,2233,10,5,6,11,17,36,-19,21
Silkeborg IF,2233,11,5,3,14,25,45,-20,18
Brondby,2234,1,22,6,2,75,30,45,72
FC Midtjylla,2234,2,21,4,5,66,39,27,67
Copenhagen,2234,3,15,5,10,60,43,17,50
FC Nords,2234,4,12,7,11,73,61,12,43
AaB,2234,5,6,13,11,35,45,-10,31
AC Horsens,2234,6,6,13,11,40,57,-17,31
Sonderjyske,2234,7,8,6,10,28,29,-1,30
Lyngby,2234,8,4,9,11,27,44,-17,21
Randers FC,2234,9,5,6,13,23,40,-17,21
AGF Aarhus,2234,10,5,6,11,20,38,-18,21
Silkeborg IF,2234,11,5,3,14,27,48,-21,18
FC Midtjylla,2235,1,21,5,4,73,41,32,68
Brondby,2235,2,20,5,5,73,33,40,65
Copenhagen,2235,3,15,5,10,61,44,17,50
FC Nords,2235,4,13,6,11,69,55,14,45
AaB,2235,5,8,11,11,37,50,-13,35
AC Horsens,2235,6,7,12,11,37,53,-16,33
Sonderjyske,2235,7,8,6,10,28,29,-1,30
Lyngby,2235,8,4,9,11,27,44,-17,21
Randers FC,2235,9,5,6,13,23,40,-17,21
Silkeborg IF,2235,10,6,3,13,26,44,-18,21
AGF Aarhus,2235,11,4,6,12,16,37,-21,18
Brondby,2236,1,19,7,4,62,31,31,64
FC Midtjylla,2236,2,19,7,4,67,37,30,64
FC Nords,2236,3,15,8,7,80,51,29,53
Copenhagen,2236,4,14,4,12,58,45,13,46
AaB,2236,5,7,13,10,34,44,-10,34
AC Horsens,2236,6,6,13,11,37,56,-19,31
Sonderjyske,2236,7,8,6,10,28,29,-1,30
Lyngby,2236,8,4,9,11,28,44,-16,21
Silkeborg IF,2236,9,6,3,13,26,44,-18,21
Randers FC,2236,10,5,6,13,23,41,-18,21
AGF Aarhus,2236,11,4,6,12,16,37,-21,18
Brondby,2237,1,20,6,4,68,31,37,66
FC Midtjylla,2237,2,20,6,4,64,34,30,66
FC Nords,2237,3,14,7,9,72,53,19,49
Copenhagen,2237,4,13,5,12,55,47,8,44
AaB,2237,5,7,14,9,38,42,-4,35
AC Horsens,2237,6,6,14,10,34,50,-16,32
Sonderjyske,2237,7,8,6,10,28,29,-1,30
Randers FC,2237,8,5,7,12,26,42,-16,22
Silkeborg IF,2237,9,6,3,13,28,44,-16,21
Lyngby,2237,10,3,10,11,29,47,-18,19
AGF Aarhus,2237,11,4,6,12,16,39,-23,18
Brondby,2238,1,19,7,4,68,38,30,64
FC Midtjylla,2238,2,19,5,6,65,37,28,62
FC Nords,2238,3,15,6,9,75,52,23,51
Copenhagen,2238,4,14,4,12,57,46,11,46
AaB,2238,5,8,13,9,39,40,-1,37
AC Horsens,2238,6,7,13,10,33,50,-17,34
Sonderjyske,2238,7,8,6,10,28,29,-1,30
Randers FC,2238,8,6,6,12,25,39,-14,24
Silkeborg IF,2238,9,6,3,13,28,44,-16,21
Lyngby,2238,10,3,9,12,26,46,-20,18
AGF Aarhus,2238,11,4,6,12,16,39,-23,18
Brondby,2239,1,21,6,3,69,30,39,69
FC Midtjylla,2239,2,20,5,5,62,37,25,65
FC Nords,2239,3,15,6,9,75,52,23,51
Copenhagen,2239,4,14,4,12,58,42,16,46
AaB,2239,5,7,14,9,38,43,-5,35
Sonderjyske,2239,6,8,6,10,28,29,-1,30
AC Horsens,2239,7,5,13,12,30,54,-24,28
Lyngby,2239,8,4,9,11,28,45,-17,21
Randers FC,2239,9,5,6,13,24,41,-17,21
Silkeborg IF,2239,10,5,4,13,25,44,-19,19
AGF Aarhus,2239,11,4,7,11,16,36,-20,19
Brondby,2240,1,21,5,4,73,33,40,68
FC Midtjylla,2240,2,21,5,4,72,36,36,68
Copenhagen,2240,3,15,6,9,59,42,17,51
FC Nords,2240,4,14,6,10,71,51,20,48
Sonderjyske,2240,5,8,6,10,28,29,-1,30
AaB,2240,6,6,12,12,34,50,-16,30
AC Horsens,2240,7,6,12,12,37,60,-23,30
Randers FC,2240,8,5,7,12,24,40,-16,22
Lyngby,2240,9,3,10,11,27,45,-18,19
Silkeborg IF,2240,10,5,4,13,26,45,-19,19
AGF Aarhus,2240,11,4,7,11,17,37,-20,19
Brondby,2241,1,22,5,3,71,33,38,71
FC Midtjylla,2241,2,21,5,4,66,34,32,68
FC Nords,2241,3,15,6,9,74,51,23,51
Copenhagen,2241,4,13,4,13,56,47,9,43
AaB,2241,5,8,12,10,39,41,-2,36
Sonderjyske,2241,6,8,6,10,28,29,-1,30
AC Horsens,2241,7,5,12,13,33,59,-26,27
Randers FC,2241,8,6,6,12,26,41,-15,24
Silkeborg IF,2241,9,6,3,13,28,45,-17,21
Lyngby,2241,10,3,9,12,28,47,-19,18
AGF Aarhus,2241,11,4,6,12,17,39,-22,18
Brondby,2242,1,21,7,2,72,32,40,70
FC Midtjylla,2242,2,19,6,5,65,36,29,63
FC Nords,2242,3,14,6,10,76,55,21,48
Copenhagen,2242,4,14,6,10,60,49,11,48
AaB,2242,5,8,13,9,40,39,1,37
Sonderjyske,2242,6,8,6,10,28,29,-1,30
AC Horsens,2242,7,5,12,13,36,64,-28,27
Lyngby,2242,8,4,9,11,28,45,-17,21
Randers FC,2242,9,5,6,13,24,41,-17,21
AGF Aarhus,2242,10,5,6,11,19,38,-19,21
Silkeborg IF,2242,11,5,3,14,27,47,-20,18
Brondby,2243,1,20,6,4,70,34,36,66
FC Midtjylla,2243,2,20,6,4,65,38,27,66
FC Nords,2243,3,15,7,8,75,49,26,52
Copenhagen,2243,4,13,7,10,60,47,13,46
AaB,2243,5,7,12,11,37,44,-7,33
Sonderjyske,2243,6,8,6,10,28,29,-1,30
AC Horsens,2243,7,5,14,11,34,55,-21,29
Randers FC,2243,8,6,6,12,24,39,-15,24
Silkeborg IF,2243,9,6,3,13,28,46,-18,21
Lyngby,2243,10,3,9,12,26,45,-19,18
AGF Aarhus,2243,11,4,6,12,18,39,-21,18
Brondby,2244,1,19,9,2,71,34,37,66
FC Midtjylla,2244,2,20,5,5,69,41,28,65
FC Nords,2244,3,15,7,8,77,51,26,52
Copenhagen,2244,4,13,5,12,58,48,10,44
AaB,2244,5,7,13,10,41,48,-7,34
AC Horsens,2244,6,6,13,11,37,57,-20,31
Sonderjyske,2244,7,8,6,10,28,29,-1,30
Randers FC,2244,8,5,7,12,24,40,-16,22
Lyngby,2244,9,3,10,11,27,45,-18,19
Silkeborg IF,2244,10,5,4,13,26,45,-19,19
AGF Aarhus,2244,11,4,7,11,17,37,-20,19
Brondby,2245,1,20,7,3,75,31,44,67
FC Midtjylla,2245,2,20,5,5,70,38,32,65
FC Nords,2245,3,14,7,9,70,56,14,49
Copenhagen,2245,4,14,6,10,59,45,14,48
AaB,2245,5,7,12,11,36,45,-9,33
AC Horsens,2245,6,6,13,11,33,54,-21,31
Sonderjyske,2245,7,8,6,10,28,29,-1,30
Randers FC,2245,8,5,7,12,23,39,-16,22
Silkeborg IF,2245,9,6,3,13,26,44,-18,21
Lyngby,2245,10,3,10,11,26,44,-18,19
AGF Aarhus,2245,11,4,6,12,16,37,-21,18
Brondby,2246,1,21,6,3,72,32,40,69
FC Midtjylla,2246,2,18,6,6,62,41,21,60
FC Nords,2246,3,14,8,8,75,54,21,50
Copenhagen,2246,4,12,7,11,55,44,11,43
AaB,2246,5,9,13,8,40,39,1,40
Sonderjyske,2246,6,8,6,10,28,29,-1,30
AC Horsens,2246,7,5,14,11,35,55,-20,29
Lyngby,2246,8,4,9,11,28,45,-17,21
Randers FC,2246,9,5,6,13,24,41,-17,21
Silkeborg IF,2246,10,5,4,13,26,45,-19,19
AGF Aarhus,2246,11,4,7,11,17,37,-20,19
Brondby,2247,1,21,6,3,72,34,38,69
FC Midtjylla,2247,2,19,6,5,63,37,26,63
FC Nords,2247,3,15,7,8,75,49,26,52
Copenhagen,2247,4,14,6,10,59,43,16,48
AaB,2247,5,6,14,10,37,44,-7,32
Sonderjyske,2247,6,8,6,10,28,29,-1,30
AC Horsens,2247,7,5,13,12,33,58,-25,28
Lyngby,2247,8,4,9,11,28,44,-16,21
Randers FC,2247,9,5,6,13,23,41,-18,21
Silkeborg IF,2247,10,5,4,13,27,46,-19,19
AGF Aarhus,2247,11,4,7,11,18,38,-20,19
Brondby,2248,1,22,5,3,69,31,38,71
FC Midtjylla,2248,2,19,5,6,67,40,27,62
FC Nords,2248,3,12,10,8,72,52,20,46
Copenhagen,2248,4,13,6,11,56,49,7,45
AaB,2248,5,7,13,10,39,42,-3,34
AC Horsens,2248,6,6,15,9,37,52,-15,33
Sonderjyske,2248,7,8,6,10,28,29,-1,30
Randers FC,2248,8,6,6,12,25,40,-15,24
Silkeborg IF,2248,9,6,3,13,28,45,-17,21
Lyngby,2248,10,3,9,12,27,46,-19,18
AGF Aarhus,2248,11,4,6,12,17,39,-22,18
Brondby,2249,1,20,7,3,73,33,40,67
FC Midtjylla,2249,2,19,5,6,64,35,29,62
FC Nords,2249,3,13,7,10,70,55,15,46
Copenhagen,2249,4,13,7,10,55,42,13,46
AaB,2249,5,10,11,9,39,40,-1,41
AC Horsens,2249,6,6,13,11,36,58,-22,31
Sonderjyske,2249,7,8,6,10,28,29,-1,30
Randers FC,2249,8,5,7,12,26,42,-16,22
AGF Aarhus,2249,9,5,6,11,18,37,-19,21
Lyngby,2249,10,3,10,11,29,47,-18,19
Silkeborg IF,2249,11,5,3,14,26,46,-20,18
Brondby,2250,1,21,6,3,71,32,39,69
FC Midtjylla,2250,2,19,5,6,67,40,27,62
FC Nords,2250,3,15,6,9,75,56,19,51
Copenhagen,2250,4,14,4,12,65,52,13,46
AaB,2250,5,8,11,11,40,44,-4,35
AC Horsens,2250,6,7,12,11,37,57,-20,33
Sonderjyske,2250,7,8,6,10,28,29,-1,30
Randers FC,2250,8,6,6,12,24,39,-15,24
Silkeborg IF,2250,9,6,3,13,28,45,-17,21
Lyngby,2250,10,3,9,12,26,45,-19,18
AGF Aarhus,2250,11,4,6,12,17,39,-22,18
Brondby,2251,1,22,6,2,70,30,40,72
FC Midtjylla,2251,2,20,5,5,67,37,30,65
FC Nords,2251,3,14,6,10,73,52,21,48
Copenhagen,2251,4,13,4,13,56,48,8,43
AaB,2251,5,8,12,10,36,41,-5,36
AC Horsens,2251,6,6,13,11,34,54,-20,31
Sonderjyske,2251,7,8,6,10,28,29,-1,30
Lyngby,2251,8,4,9,11,28,45,-17,21
Randers FC,2251,9,5,6,13,24,41,-17,21
Silkeborg IF,2251,10,6,3,13,27,45,-18,21
AGF Aarhus,2251,11,4,6,12,17,38,-21,18
Brondby,2252,1,19,8,3,70,32,38,65
FC Midtjylla,2252,2,20,5,5,68,39,29,65
Copenhagen,2252,3,15,5,10,62,44,18,50
FC Nords,2252,4,13,7,10,72,57,15,46
AC Horsens,2252,5,7,13,10,36,49,-13,34
AaB,2252,6,7,12,11,35,48,-13,33
Sonderjyske,2252,7,8,6,10,28,29,-1,30
Silkeborg IF,2252,8,6,3,13,30,45,-15,21
Lyngby,2252,9,4,9,11,28,45,-17,21
Randers FC,2252,10,5,6,13,24,41,-17,21
AGF Aarhus,2252,11,4,6,12,17,41,-24,18
FC Midtjylla,2253,1,21,5,4,69,37,32,68
Brondby,2253,2,19,9,2,72,34,38,66
FC Nords,2253,3,13,7,10,75,54,21,46
Copenhagen,2253,4,12,5,13,54,48,6,41
AC Horsens,2253,5,8,13,9,37,51,-14,37
AaB,2253,6,8,11,11,37,46,-9,35
Sonderjyske,2253,7,8,6,10,28,29,-1,30
Randers FC,2253,8,6,6,12,26,40,-14,24
Silkeborg IF,2253,9,6,3,13,28,44,-16,21
Lyngby,2253,10,3,9,12,27,47,-20,18
AGF Aarhus,2253,11,4,6,12,16,39,-23,18
FC Midtjylla,2254,1,21,4,5,66,37,29,67
Brondby,2254,2,19,7,4,65,30,35,64
FC Nords,2254,3,14,7,9,74,54,20,49
Copenhagen,2254,4,13,6,11,56,48,8,45
AC Horsens,2254,5,7,13,10,38,50,-12,34
AaB,2254,6,6,15,9,35,41,-6,33
Sonderjyske,2254,7,8,6,10,28,29,-1,30
Randers FC,2254,8,5,7,12,25,41,-16,22
Lyngby,2254,9,3,10,11,28,46,-18,19
Silkeborg IF,2254,10,5,4,13,26,45,-19,19
AGF Aarhus,2254,11,4,7,11,17,37,-20,19
Brondby,2255,1,20,5,5,69,35,34,65
FC Midtjylla,2255,2,20,4,6,68,42,26,64
FC Nords,2255,3,15,6,9,78,55,23,51
Copenhagen,2255,4,15,5,10,63,44,19,50
AaB,2255,5,8,11,11,37,47,-10,35
AC Horsens,2255,6,6,13,11,36,54,-18,31
Sonderjyske,2255,7,8,6,10,28,29,-1,30
Lyngby,2255,8,4,9,11,27,44,-17,21
Randers FC,2255,9,5,6,13,23,40,-17,21
Silkeborg IF,2255,10,5,4,13,26,45,-19,19
AGF Aarhus,2255,11,4,7,11,17,37,-20,19
Brondby,2256,1,20,7,3,70,31,39,67
FC Midtjylla,2256,2,20,5,5,63,36,27,65
Copenhagen,2256,3,15,5,10,58,41,17,50
FC Nords,2256,4,13,8,9,71,53,18,47
AaB,2256,5,7,12,11,35,43,-8,33
AC Horsens,2256,6,6,13,11,34,53,-19,31
Sonderjyske,2256,7,8,6,10,28,29,-1,30
Lyngby,2256,8,4,9,11,28,45,-17,21
Randers FC,2256,9,5,6,13,24,41,-17,21
AGF Aarhus,2256,10,5,6,11,18,36,-18,21
Silkeborg IF,2256,11,5,3,14,25,46,-21,18
FC Midtjylla,2257,1,21,4,5,70,37,33,67
Brondby,2257,2,20,6,4,67,36,31,66
Copenhagen,2257,3,15,5,10,58,43,15,50
FC Nords,2257,4,13,8,9,74,55,19,47
AC Horsens,2257,5,7,13,10,37,53,-16,34
Sonderjyske,2257,6,8,6,10,28,29,-1,30
AaB,2257,7,6,12,12,34,42,-8,30
Randers FC,2257,8,6,6,12,26,41,-15,24
Silkeborg IF,2257,9,6,3,13,27,44,-17,21
Lyngby,2257,10,3,9,12,28,47,-19,18
AGF Aarhus,2257,11,4,6,12,16,38,-22,18
Brondby,2258,1,21,6,3,72,30,42,69
FC Midtjylla,2258,2,19,5,6,65,43,22,62
FC Nords,2258,3,14,6,10,70,51,19,48
Copenhagen,2258,4,12,6,12,57,53,4,42
AaB,2258,5,9,11,10,40,41,-1,38
AC Horsens,2258,6,7,14,9,39,51,-12,35
Sonderjyske,2258,7,8,6,10,28,29,-1,30
Lyngby,2258,8,4,9,11,28,45,-17,21
Silkeborg IF,2258,9,6,3,13,27,44,-17,21
Randers FC,2258,10,5,6,13,24,41,-17,21
AGF Aarhus,2258,11,4,6,12,16,38,-22,18
FC Midtjylla,2259,1,21,4,5,70,39,31,67
Brondby,2259,2,20,6,4,72,34,38,66
Copenhagen,2259,3,14,7,9,59,40,19,49
FC Nords,2259,4,12,8,10,69,55,14,44
AaB,2259,5,9,12,9,37,37,0,39
Sonderjyske,2259,6,8,6,10,28,29,-1,30
AC Horsens,2259,7,5,13,12,33,61,-28,28
Lyngby,2259,8,4,9,11,27,44,-17,21
Randers FC,2259,9,5,6,13,23,40,-17,21
AGF Aarhus,2259,10,5,6,11,17,36,-19,21
Silkeborg IF,2259,11,5,3,14,25,45,-20,18
Brondby,2260,1,22,6,2,75,30,45,72
FC Midtjylla,2260,2,21,4,5,68,38,30,67
Copenhagen,2260,3,15,4,11,65,46,19,49
FC Nords,2260,4,13,6,11,71,55,16,45
AaB,2260,5,7,12,11,36,44,-8,33
Sonderjyske,2260,6,8,6,10,28,29,-1,30
AC Horsens,2260,7,5,14,11,33,61,-28,29
Randers FC,2260,8,6,6,12,26,41,-15,24
Silkeborg IF,2260,9,6,3,13,27,45,-18,21
Lyngby,2260,10,3,9,12,28,47,-19,18
AGF Aarhus,2260,11,4,6,12,17,38,-21,18
Brondby,2261,1,20,6,4,70,32,38,66
FC Midtjylla,2261,2,18,7,5,63,39,24,61
FC Nords,2261,3,14,7,9,79,59,20,49
Copenhagen,2261,4,13,6,11,58,48,10,45
AaB,2261,5,8,13,9,41,42,-1,37
AC Horsens,2261,6,7,13,10,37,54,-17,34
Sonderjyske,2261,7,8,6,10,28,29,-1,30
Randers FC,2261,8,5,7,12,24,40,-16,22
AGF Aarhus,2261,9,5,6,11,18,37,-19,21
Lyngby,2261,10,3,10,11,27,45,-18,19
Silkeborg IF,2261,11,5,3,14,26,46,-20,18
Brondby,2262,1,20,6,4,67,33,34,66
FC Midtjylla,2262,2,20,4,6,64,39,25,64
FC Nords,2262,3,15,7,8,77,48,29,52
Copenhagen,2262,4,14,5,11,56,46,10,47
AaB,2262,5,7,13,10,34,40,-6,34
AC Horsens,2262,6,6,13,11,34,52,-18,31
Sonderjyske,2262,7,8,6,10,28,29,-1,30
Randers FC,2262,8,5,7,12,23,39,-16,22
Silkeborg IF,2262,9,6,3,13,27,44,-17,21
Lyngby,2262,10,3,10,11,26,44,-18,19
AGF Aarhus,2262,11,4,6,12,16,38,-22,18
FC Midtjylla,2263,1,20,5,5,69,40,29,65
Brondby,2263,2,19,7,4,67,39,28,64
FC Nords,2263,3,16,6,8,80,51,29,54
Copenhagen,2263,4,13,5,12,62,49,13,44
AaB,2263,5,7,13,10,37,43,-6,34
AC Horsens,2263,6,7,12,11,42,61,-19,33
Sonderjyske,2263,7,8,6,10,28,29,-1,30
Lyngby,2263,8,4,9,11,28,44,-16,21
Silkeborg IF,2263,8,6,3,13,28,44,-16,21
Randers FC,2263,10,5,6,13,23,41,-18,21
AGF Aarhus,2263,11,4,6,12,16,39,-23,18
Brondby,2264,1,22,5,3,74,33,41,71
FC Midtjylla,2264,2,19,6,5,65,40,25,63
Copenhagen,2264,3,15,4,11,59,44,15,49
FC Nords,2264,4,13,7,10,68,53,15,46
AC Horsens,2264,5,7,13,10,39,54,-15,34
AaB,2264,6,7,11,12,35,42,-7,32
Sonderjyske,2264,7,8,6,10,28,29,-1,30
Randers FC,2264,8,5,7,12,24,40,-16,22
Lyngby,2264,9,3,10,11,27,45,-18,19
Silkeborg IF,2264,10,5,4,13,26,45,-19,19
AGF Aarhus,2264,11,4,7,11,17,37,-20,19
Brondby,2265,1,21,5,4,71,33,38,68
FC Midtjylla,2265,2,20,5,5,68,38,30,65
FC Nords,2265,3,15,6,9,76,52,24,51
Copenhagen,2265,4,13,6,11,56,47,9,45
AaB,2265,5,7,12,11,38,48,-10,33
AC Horsens,2265,6,7,12,11,36,53,-17,33
Sonderjyske,2265,7,8,6,10,28,29,-1,30
Randers FC,2265,8,6,6,12,25,39,-14,24
AGF Aarhus,2265,9,5,6,11,18,37,-19,21
Lyngby,2265,10,3,9,12,26,46,-20,18
Silkeborg IF,2265,10,5,3,14,26,46,-20,18
Brondby,2266,1,21,6,3,68,32,36,69
FC Midtjylla,2266,2,20,4,6,63,36,27,64
Copenhagen,2266,3,14,5,11,56,42,14,47
FC Nords,2266,4,13,7,10,71,54,17,46
AaB,2266,5,8,11,11,36,41,-5,35
AC Horsens,2266,6,7,13,10,33,48,-15,34
Sonderjyske,2266,7,8,6,10,28,29,-1,30
Lyngby,2266,8,4,9,11,28,44,-16,21
Randers FC,2266,9,5,6,13,23,41,-18,21
Silkeborg IF,2266,10,5,4,13,25,44,-19,19
AGF Aarhus,2266,11,4,7,11,16,36,-20,19
Brondby,2267,1,21,5,4,69,34,35,68
FC Midtjylla,2267,2,20,4,6,70,39,31,64
FC Nords,2267,3,14,6,10,73,52,21,48
Copenhagen,2267,4,13,6,11,53,43,10,45
AC Horsens,2267,5,8,13,9,38,54,-16,37
AaB,2267,6,7,12,11,33,40,-7,33
Sonderjyske,2267,7,8,6,10,28,29,-1,30
Randers FC,2267,8,5,7,12,24,40,-16,22
Lyngby,2267,9,3,10,11,27,45,-18,19
Silkeborg IF,2267,10,5,4,13,26,45,-19,19
AGF Aarhus,2267,11,4,7,11,17,37,-20,19
Brondby,2268,1,21,5,4,72,35,37,68
FC Midtjylla,2268,2,19,5,6,63,39,24,62
FC Nords,2268,3,14,9,7,72,49,23,51
Copenhagen,2268,4,15,5,10,57,42,15,50
AaB,2268,5,7,11,12,38,45,-7,32
AC Horsens,2268,6,6,13,11,32,50,-18,31
Sonderjyske,2268,7,8,6,10,28,29,-1,30
Randers FC,2268,8,6,6,12,27,42,-15,24
Silkeborg IF,2268,9,6,3,13,27,44,-17,21
Lyngby,2268,10,3,9,12,29,48,-19,18
AGF Aarhus,2268,11,4,6,12,16,38,-22,18
Brondby,2269,1,20,8,2,71,32,39,68
FC Midtjylla,2269,2,19,7,4,62,36,26,64
FC Nords,2269,3,14,7,9,70,48,22,49
Copenhagen,2269,4,12,5,13,52,47,5,41
AaB,2269,5,8,13,9,43,45,-2,37
AC Horsens,2269,6,6,14,10,36,52,-16,32
Sonderjyske,2269,7,8,6,10,28,29,-1,30
Lyngby,2269,8,4,9,11,29,46,-17,21
Randers FC,2269,9,5,6,13,25,42,-17,21
Silkeborg IF,2269,10,6,3,13,26,44,-18,21
AGF Aarhus,2269,11,4,6,12,16,37,-21,18
Brondby,2270,1,20,7,3,69,31,38,67
FC Midtjylla,2270,2,19,5,6,65,38,27,62
Copenhagen,2270,3,16,5,9,57,40,17,53
FC Nords,2270,4,13,7,10,69,56,13,46
AaB,2270,5,7,12,11,38,46,-8,33
AC Horsens,2270,6,6,14,10,36,49,-13,32
Sonderjyske,2270,7,8,6,10,28,29,-1,30
Lyngby,2270,8,4,9,11,28,45,-17,21
Randers FC,2270,9,5,6,13,24,41,-17,21
Silkeborg IF,2270,10,6,3,13,27,45,-18,21
AGF Aarhus,2270,11,4,6,12,17,38,-21,18
FC Midtjylla,2271,1,20,4,6,67,39,28,64
Brondby,2271,2,18,7,5,69,38,31,61
FC Nords,2271,3,14,8,8,77,53,24,50
Copenhagen,2271,4,14,5,11,59,46,13,47
AaB,2271,5,7,14,9,38,43,-5,35
AC Horsens,2271,6,7,14,9,37,54,-17,35
Sonderjyske,2271,7,8,6,10,28,29,-1,30
Randers FC,2271,8,5,7,12,23,39,-16,22
Lyngby,2271,9,3,10,11,26,44,-18,19
Silkeborg IF,2271,10,5,4,13,26,45,-19,19
AGF Aarhus,2271,11,4,7,11,17,37,-20,19
Brondby,2272,1,22,6,2,71,28,43,72
FC Midtjylla,2272,2,19,5,6,68,44,24,62
Copenhagen,2272,3,14,6,10,56,42,14,48
FC Nords,2272,4,12,9,9,73,57,16,45
AC Horsens,2272,5,7,13,10,35,50,-15,34
AaB,2272,6,7,11,12,35,43,-8,32
Sonderjyske,2272,7,8,6,10,28,29,-1,30
Randers FC,2272,8,5,7,12,25,41,-16,22
AGF Aarhus,2272,9,5,6,11,18,37,-19,21
Lyngby,2272,10,3,10,11,28,46,-18,19
Silkeborg IF,2272,11,5,3,14,26,46,-20,18
Brondby,2273,1,20,7,3,71,34,37,67
FC Midtjylla,2273,2,20,5,5,65,35,30,65
FC Nords,2273,3,13,9,8,71,53,18,48
Copenhagen,2273,4,14,4,12,56,43,13,46
AaB,2273,5,7,14,9,36,40,-4,35
AC Horsens,2273,6,6,13,11,35,55,-20,31
Sonderjyske,2273,7,8,6,10,28,29,-1,30
Randers FC,2273,8,6,6,12,25,40,-15,24
Silkeborg IF,2273,9,6,3,13,28,44,-16,21
Lyngby,2273,10,3,9,12,27,46,-19,18
AGF Aarhus,2273,11,4,6,12,16,39,-23,18
Brondby,2274,1,21,6,3,75,35,40,69
FC Midtjylla,2274,2,20,5,5,69,39,30,65
FC Nords,2274,3,15,6,9,73,50,23,51
Copenhagen,2274,4,14,6,10,59,42,17,48
AaB,2274,5,7,11,12,37,46,-9,32
Sonderjyske,2274,6,8,6,10,28,29,-1,30
AC Horsens,2274,7,6,12,12,36,63,-27,30
Lyngby,2274,8,4,9,11,29,45,-16,21
Randers FC,2274,9,5,6,13,24,42,-18,21
Silkeborg IF,2274,10,5,4,13,26,45,-19,19
AGF Aarhus,2274,11,4,7,11,17,37,-20,19
Brondby,2275,1,20,7,3,70,34,36,67
FC Midtjylla,2275,2,20,6,4,73,38,35,66
FC Nords,2275,3,14,7,9,73,55,18,49
Copenhagen,2275,4,13,6,11,57,45,12,45
AC Horsens,2275,5,6,15,9,34,49,-15,33
AaB,2275,6,6,13,11,34,46,-12,31
Sonderjyske,2275,7,8,6,10,28,29,-1,30
Randers FC,2275,8,6,6,12,25,40,-15,24
AGF Aarhus,2275,9,5,6,11,17,36,-19,21
Lyngby,2275,10,3,9,12,27,46,-19,18
Silkeborg IF,2275,11,5,3,14,25,45,-20,18
Brondby,2276,1,21,7,2,73,33,40,70
FC Midtjylla,2276,2,20,5,5,66,40,26,65
FC Nords,2276,3,15,7,8,79,50,29,52
Copenhagen,2276,4,13,5,12,58,51,7,44
AaB,2276,5,6,13,11,38,47,-9,31
AC Horsens,2276,6,6,13,11,33,52,-19,31
Sonderjyske,2276,7,8,6,10,28,29,-1,30
Randers FC,2276,8,5,7,12,24,40,-16,22
Silkeborg IF,2276,9,6,3,13,28,44,-16,21
Lyngby,2276,10,3,10,11,27,45,-18,19
AGF Aarhus,2276,11,4,6,12,16,39,-23,18
Brondby,2277,1,22,5,3,76,30,46,71
FC Midtjylla,2277,2,18,6,6,62,40,22,60
FC Nords,2277,3,15,6,9,74,53,21,51
Copenhagen,2277,4,14,5,11,55,44,11,47
AC Horsens,2277,5,7,13,10,36,50,-14,34
AaB,2277,6,7,11,12,34,46,-12,32
Sonderjyske,2277,7,8,6,10,28,29,-1,30
Lyngby,2277,8,4,9,11,29,45,-16,21
Silkeborg IF,2277,9,6,3,13,27,44,-17,21
Randers FC,2277,10,5,6,13,24,42,-18,21
AGF Aarhus,2277,11,4,6,12,16,38,-22,18
FC Midtjylla,2278,1,21,5,4,66,34,32,68
Brondby,2278,2,20,7,3,70,31,39,67
FC Nords,2278,3,15,6,9,71,49,22,51
Copenhagen,2278,4,14,5,11,58,46,12,47
AC Horsens,2278,5,7,12,11,36,54,-18,33
Sonderjyske,2278,6,8,6,10,28,29,-1,30
AaB,2278,7,6,11,13,34,47,-13,29
Lyngby,2278,8,4,9,11,28,44,-16,21
Silkeborg IF,2278,9,6,3,13,27,44,-17,21
Randers FC,2278,10,5,6,13,23,41,-18,21
AGF Aarhus,2278,11,4,6,12,16,38,-22,18
Brondby,2279,1,20,6,4,69,34,35,66
FC Midtjylla,2279,2,19,7,4,62,34,28,64
FC Nords,2279,3,14,9,7,75,47,28,51
Copenhagen,2279,4,13,5,12,55,46,9,44
AaB,2279,5,8,12,10,35,41,-6,36
AC Horsens,2279,6,6,13,11,32,52,-20,31
Sonderjyske,2279,7,8,6,10,28,29,-1,30
Lyngby,2279,8,4,9,11,30,46,-16,21
Randers FC,2279,9,5,6,13,25,43,-18,21
AGF Aarhus,2279,10,5,6,11,17,36,-19,21
Silkeborg IF,2279,11,5,3,14,25,45,-20,18
Brondby,2280,1,21,6,3,73,33,40,69
FC Midtjylla,2280,2,19,5,6,63,40,23,62
FC Nords,2280,3,14,8,8,77,53,24,50
Copenhagen,2280,4,13,4,13,57,47,10,43
AaB,2280,5,8,12,10,41,46,-5,36
AC Horsens,2280,6,7,13,10,36,54,-18,34
Sonderjyske,2280,7,8,6,10,28,29,-1,30
Lyngby,2280,8,4,9,11,29,44,-15,21
Silkeborg IF,2280,9,6,3,13,28,45,-17,21
Randers FC,2280,10,5,6,13,23,42,-19,21
AGF Aarhus,2280,11,4,6,12,17,39,-22,18
FC Midtjylla,2281,1,20,6,4,65,34,31,66
Brondby,2281,2,18,7,5,64,33,31,61
FC Nords,2281,3,15,7,8,78,51,27,52
Copenhagen,2281,4,14,6,10,55,45,10,48
AaB,2281,5,7,12,11,35,43,-8,33
AC Horsens,2281,6,7,12,11,33,50,-17,33
Sonderjyske,2281,7,8,6,10,28,29,-1,30
Randers FC,2281,8,6,6,12,26,40,-14,24
AGF Aarhus,2281,9,5,6,11,19,37,-18,21
Lyngby,2281,10,3,9,12,27,47,-20,18
Silkeborg IF,2281,11,5,3,14,26,47,-21,18
Brondby,2282,1,20,7,3,70,32,38,67
FC Midtjylla,2282,2,19,5,6,69,42,27,62
Copenhagen,2282,3,17,4,9,59,40,19,55
FC Nords,2282,4,14,6,10,71,54,17,48
AC Horsens,2282,5,6,14,10,32,48,-16,32
Sonderjyske,2282,6,8,6,10,28,29,-1,30
AaB,2282,7,6,12,12,33,44,-11,30
Lyngby,2282,8,4,9,11,31,48,-17,21
Randers FC,2282,9,5,6,13,27,44,-17,21
Silkeborg IF,2282,10,5,4,13,26,45,-19,19
AGF Aarhus,2282,11,4,7,11,17,37,-20,19
Brondby,2283,1,22,6,2,72,30,42,72
FC Midtjylla,2283,2,17,5,8,61,43,18,56
Copenhagen,2283,3,13,7,10,61,47,14,46
FC Nords,2283,4,12,8,10,74,57,17,44
AaB,2283,5,8,13,9,40,43,-3,37
AC Horsens,2283,6,8,13,9,40,54,-14,37
Sonderjyske,2283,7,8,6,10,28,29,-1,30
Randers FC,2283,8,5,7,12,24,40,-16,22
Lyngby,2283,9,3,10,11,27,45,-18,19
Silkeborg IF,2283,10,5,4,13,25,44,-19,19
AGF Aarhus,2283,11,4,7,11,16,36,-20,19
Brondby,2284,1,20,8,2,69,32,37,68
FC Midtjylla,2284,2,21,4,5,68,39,29,67
Copenhagen,2284,3,13,7,10,54,41,13,46
FC Nords,2284,4,12,8,10,72,55,17,44
AC Horsens,2284,5,7,14,9,35,49,-14,35
AaB,2284,6,6,13,11,34,42,-8,31
Sonderjyske,2284,7,8,6,10,28,29,-1,30
Lyngby,2284,8,4,9,11,27,44,-17,21
Randers FC,2284,9,5,6,13,23,40,-17,21
Silkeborg IF,2284,10,6,3,13,26,44,-18,21
AGF Aarhus,2284,11,4,6,12,16,37,-21,18
Brondby,2285,1,20,6,4,70,35,35,66
FC Midtjylla,2285,1,20,6,4,70,35,35,66
FC Nords,2285,3,13,8,9,71,52,19,47
Copenhagen,2285,4,13,7,10,59,45,14,46
AaB,2285,5,7,13,10,36,42,-6,34
AC Horsens,2285,6,6,14,10,33,56,-23,32
Sonderjyske,2285,7,8,6,10,28,29,-1,30
Lyngby,2285,8,4,9,11,30,45,-15,21
Silkeborg IF,2285,9,6,3,13,29,44,-15,21
Randers FC,2285,10,5,6,13,24,43,-19,21
AGF Aarhus,2285,11,4,6,12,16,40,-24,18
Brondby,2286,1,20,6,4,67,32,35,66
FC Midtjylla,2286,2,18,4,8,60,39,21,58
FC Nords,2286,3,14,8,8,73,49,24,50
Copenhagen,2286,4,14,6,10,57,42,15,48
AaB,2286,5,8,12,10,37,42,-5,36
AC Horsens,2286,6,8,12,10,32,48,-16,36
Sonderjyske,2286,7,8,6,10,28,29,-1,30
Randers FC,2286,8,5,7,12,24,40,-16,22
Silkeborg IF,2286,9,6,3,13,27,44,-17,21
Lyngby,2286,10,3,10,11,27,45,-18,19
AGF Aarhus,2286,11,4,6,12,16,38,-22,18
Brondby,2287,1,19,9,2,67,31,36,66
FC Midtjylla,2287,2,20,5,5,69,39,30,65
Copenhagen,2287,3,15,4,11,58,44,14,49
FC Nords,2287,4,13,8,9,73,52,21,47
AaB,2287,5,6,14,10,37,44,-7,32
AC Horsens,2287,6,6,14,10,34,54,-20,32
Sonderjyske,2287,7,8,6,10,28,29,-1,30
Randers FC,2287,8,5,7,12,24,40,-16,22
AGF Aarhus,2287,9,5,6,11,19,37,-18,21
Lyngby,2287,10,3,10,11,27,45,-18,19
Silkeborg IF,2287,11,5,3,14,26,47,-21,18
Brondby,2288,1,20,7,3,73,37,36,67
FC Midtjylla,2288,2,18,6,6,66,43,23,60
Copenhagen,2288,3,16,5,9,61,40,21,53
FC Nords,2288,4,15,7,8,76,51,25,52
AC Horsens,2288,5,7,12,11,35,55,-20,33
Sonderjyske,2288,6,8,6,10,28,29,-1,30
AaB,2288,7,6,11,13,36,47,-11,29
Randers FC,2288,8,6,6,12,26,39,-13,24
AGF Aarhus,2288,9,5,6,11,18,36,-18,21
Lyngby,2288,10,3,9,12,26,47,-21,18
Silkeborg IF,2288,11,5,3,14,25,46,-21,18
Brondby,2289,1,23,5,2,77,31,46,74
FC Midtjylla,2289,2,19,5,6,64,39,25,62
FC Nords,2289,3,14,6,10,74,53,21,48
Copenhagen,2289,4,14,5,11,57,45,12,47
AaB,2289,5,8,13,9,40,45,-5,37
Sonderjyske,2289,6,8,6,10,28,29,-1,30
AC Horsens,2289,7,5,12,13,32,57,-25,27
Silkeborg IF,2289,8,6,3,13,29,44,-15,21
Lyngby,2289,9,4,9,11,28,45,-17,21
Randers FC,2289,10,5,6,13,24,41,-17,21
AGF Aarhus,2289,11,4,6,12,16,40,-24,18
FC Midtjylla,2290,1,19,7,4,66,36,30,64
Brondby,2290,2,18,6,6,64,37,27,60
FC Nords,2290,3,14,9,7,76,47,29,51
Copenhagen,2290,4,14,5,11,53,42,11,47
AaB,2290,5,8,14,8,36,36,0,38
AC Horsens,2290,6,6,13,11,33,56,-23,31
Sonderjyske,2290,7,8,6,10,28,29,-1,30
Lyngby,2290,8,4,9,11,29,45,-16,21
Silkeborg IF,2290,9,6,3,13,26,44,-18,21
Randers FC,2290,10,5,6,13,24,42,-18,21
AGF Aarhus,2290,11,4,6,12,16,37,-21,18
Brondby,2291,1,21,6,3,69,29,40,69
FC Midtjylla,2291,2,19,5,6,65,43,22,62
FC Nords,2291,3,13,9,8,78,56,22,48
Copenhagen,2291,4,13,8,9,56,42,14,47
AaB,2291,5,7,14,9,39,43,-4,35
Sonderjyske,2291,6,8,6,10,28,29,-1,30
AC Horsens,2291,7,5,14,11,33,53,-20,29
Silkeborg IF,2291,8,6,3,13,31,45,-14,21
Lyngby,2291,9,4,9,11,29,45,-16,21
Randers FC,2291,10,5,6,13,24,42,-18,21
AGF Aarhus,2291,11,4,6,12,17,42,-25,18
Brondby,2292,1,20,5,5,72,33,39,65
FC Midtjylla,2292,2,19,5,6,61,37,24,62
FC Nords,2292,3,16,6,8,77,53,24,54
Copenhagen,2292,4,15,5,10,61,46,15,50
AaB,2292,5,8,11,11,37,43,-6,35
Sonderjyske,2292,6,8,6,10,28,29,-1,30
AC Horsens,2292,7,5,14,11,33,55,-22,29
Lyngby,2292,8,4,9,11,29,45,-16,21
Silkeborg IF,2292,9,6,3,13,26,44,-18,21
Randers FC,2292,10,5,6,13,24,42,-18,21
AGF Aarhus,2292,11,4,6,12,16,37,-21,18
Brondby,2293,1,20,6,4,69,37,32,66
FC Midtjylla,2293,2,19,5,6,68,43,25,62
FC Nords,2293,3,15,7,8,74,49,25,52
Copenhagen,2293,4,14,5,11,60,46,14,47
AC Horsens,2293,5,7,13,10,41,52,-11,34
AaB,2293,6,7,12,11,39,50,-11,33
Sonderjyske,2293,7,8,6,10,28,29,-1,30
Lyngby,2293,8,4,9,11,29,44,-15,21
Randers FC,2293,9,5,6,13,23,42,-19,21
AGF Aarhus,2293,10,5,6,11,17,36,-19,21
Silkeborg IF,2293,11,5,3,14,25,45,-20,18
Brondby,2294,1,20,6,4,73,36,37,66
FC Midtjylla,2294,2,18,5,7,62,42,20,59
FC Nords,2294,3,15,6,9,70,52,18,51
Copenhagen,2294,4,15,5,10,62,43,19,50
AaB,2294,5,7,13,10,41,46,-5,34
AC Horsens,2294,6,7,13,10,35,50,-15,34
Sonderjyske,2294,7,8,6,10,28,29,-1,30
Lyngby,2294,8,4,9,11,28,45,-17,21
Randers FC,2294,9,5,6,13,24,41,-17,21
Silkeborg IF,2294,10,5,4,13,26,45,-19,19
AGF Aarhus,2294,11,4,7,11,17,37,-20,19
Brondby,2295,1,20,6,4,72,36,36,66
FC Midtjylla,2295,2,17,8,5,66,43,23,59
FC Nords,2295,3,14,8,8,75,52,23,50
Copenhagen,2295,4,14,5,11,57,45,12,47
AaB,2295,5,8,12,10,37,45,-8,36
AC Horsens,2295,6,7,13,10,41,53,-12,34
Sonderjyske,2295,7,8,6,10,28,29,-1,30
Randers FC,2295,8,6,6,12,28,41,-13,24
Silkeborg IF,2295,9,6,3,13,26,44,-18,21
Lyngby,2295,10,3,9,12,28,49,-21,18
AGF Aarhus,2295,11,4,6,12,16,37,-21,18
FC Midtjylla,2296,1,22,4,4,69,34,35,70
Brondby,2296,2,21,6,3,73,33,40,69
FC Nords,2296,3,14,7,9,72,52,20,49
Copenhagen,2296,4,12,4,14,53,49,4,40
AaB,2296,5,7,14,9,39,42,-3,35
AC Horsens,2296,6,6,13,11,34,56,-22,31
Sonderjyske,2296,7,8,6,10,28,29,-1,30
Lyngby,2296,8,4,9,11,27,44,-17,21
Randers FC,2296,9,5,6,13,23,40,-17,21
Silkeborg IF,2296,10,5,4,13,25,44,-19,19
AGF Aarhus,2296,11,4,7,11,16,36,-20,19
Brondby,2297,1,21,5,4,71,33,38,68
FC Midtjylla,2297,2,17,6,7,59,40,19,57
Copenhagen,2297,3,16,4,10,62,40,22,52
FC Nords,2297,4,14,8,8,73,51,22,50
AaB,2297,5,7,13,10,33,43,-10,34
AC Horsens,2297,6,6,14,10,32,49,-17,32
Sonderjyske,2297,7,8,6,10,28,29,-1,30
Lyngby,2297,8,4,9,11,28,44,-16,21
Randers FC,2297,9,5,6,13,23,41,-18,21
AGF Aarhus,2297,10,5,6,11,17,36,-19,21
Silkeborg IF,2297,11,5,3,14,25,45,-20,18
Brondby,2298,1,23,5,2,83,31,52,74
FC Midtjylla,2298,2,18,5,7,61,47,14,59
FC Nords,2298,3,16,6,8,77,50,27,54
Copenhagen,2298,4,14,4,12,54,44,10,46
AC Horsens,2298,5,7,12,11,33,52,-19,33
Sonderjyske,2298,6,8,6,10,28,29,-1,30
AaB,2298,7,6,12,12,35,45,-10,30
Randers FC,2298,8,5,7,12,24,40,-16,22
Silkeborg IF,2298,9,6,3,13,27,45,-18,21
Lyngby,2298,10,3,10,11,27,45,-18,19
AGF Aarhus,2298,11,4,6,12,17,38,-21,18
Brondby,2299,1,20,7,3,67,31,36,67
FC Midtjylla,2299,2,20,6,4,67,39,28,66
FC Nords,2299,3,14,7,9,77,54,23,49
Copenhagen,2299,4,13,6,11,56,46,10,45
AaB,2299,5,8,11,11,37,43,-6,35
AC Horsens,2299,6,6,13,11,35,52,-17,31
Sonderjyske,2299,7,8,6,10,28,29,-1,30
Lyngby,2299,8,4,9,11,27,44,-17,21
Randers FC,2299,9,5,6,13,23,40,-17,21
AGF Aarhus,2299,10,5,6,11,18,37,-19,21
Silkeborg IF,2299,11,5,3,14,26,46,-20,18
Brondby,2300,1,20,6,4,70,35,35,66
FC Midtjylla,2300,2,20,5,5,68,40,28,65
FC Nords,2300,3,17,6,7,79,48,31,57
Copenhagen,2300,4,13,6,11,56,47,9,45
AC Horsens,2300,5,6,13,11,33,52,-19,31
Sonderjyske,2300,6,8,6,10,28,29,-1,30
AaB,2300,7,6,12,12,35,45,-10,30
Randers FC,2300,8,6,6,12,26,41,-15,24
Silkeborg IF,2300,9,5,4,13,25,44,-19,19
AGF Aarhus,2300,10,4,7,11,16,36,-20,19
Lyngby,2300,11,3,9,12,28,47,-19,18
Brondby,2301,1,21,6,3,75,38,37,69
FC Midtjylla,2301,2,20,5,5,71,41,30,65
FC Nords,2301,3,14,8,8,80,52,28,50
Copenhagen,2301,4,14,6,10,61,47,14,48
AaB,2301,5,6,13,11,34,42,-8,31
Sonderjyske,2301,6,8,6,10,28,29,-1,30
AC Horsens,2301,7,6,12,12,32,59,-27,30
Randers FC,2301,8,5,7,12,24,40,-16,22
Silkeborg IF,2301,9,6,3,13,28,46,-18,21
Lyngby,2301,10,3,10,11,27,45,-18,19
AGF Aarhus,2301,11,4,6,12,18,39,-21,18
Brondby,2302,1,22,6,2,72,31,41,72
FC Midtjylla,2302,2,21,4,5,70,42,28,67
FC Nords,2302,3,14,6,10,72,50,22,48
Copenhagen,2302,4,14,4,12,59,48,11,46
AaB,2302,5,8,12,10,36,40,-4,36
Sonderjyske,2302,6,8,6,10,28,29,-1,30
AC Horsens,2302,7,5,12,13,29,53,-24,27
Lyngby,2302,8,4,9,11,28,45,-17,21
Randers FC,2302,9,5,6,13,24,41,-17,21
Silkeborg IF,2302,10,5,4,13,25,44,-19,19
AGF Aarhus,2302,11,4,7,11,16,36,-20,19
Brondby,2303,1,21,5,4,73,35,38,68
FC Midtjylla,2303,2,20,5,5,68,38,30,65
FC Nords,2303,3,13,9,8,71,54,17,48
Copenhagen,2303,4,14,5,11,60,44,16,47
AaB,2303,5,7,13,10,35,40,-5,34
Sonderjyske,2303,6,8,6,10,28,29,-1,30
AC Horsens,2303,7,5,15,10,30,52,-22,30
Randers FC,2303,8,6,6,12,29,39,-10,24
AGF Aarhus,2303,9,5,6,11,18,37,-19,21
Silkeborg IF,2303,10,5,3,14,26,46,-20,18
Lyngby,2303,11,3,9,12,26,50,-24,18
Brondby,2304,1,21,6,3,77,34,43,69
FC Midtjylla,2304,2,19,6,5,65,41,24,63
FC Nords,2304,3,15,7,8,77,55,22,52
Copenhagen,2304,4,14,6,10,60,46,14,48
AC Horsens,2304,5,6,13,11,35,54,-19,31
Sonderjyske,2304,6,8,6,10,28,29,-1,30
AaB,2304,7,6,12,12,37,47,-10,30
Lyngby,2304,8,4,9,11,29,46,-17,21
Randers FC,2304,9,5,6,13,25,42,-17,21
Silkeborg IF,2304,10,5,4,13,26,45,-19,19
AGF Aarhus,2304,11,4,7,11,17,37,-20,19
Brondby,2305,1,21,6,3,71,30,41,69
FC Midtjylla,2305,2,19,4,7,66,42,24,61
FC Nords,2305,3,15,6,9,76,55,21,51
Copenhagen,2305,4,14,4,12,59,48,11,46
AaB,2305,5,7,13,10,36,44,-8,34
AC Horsens,2305,6,7,13,10,34,49,-15,34
Sonderjyske,2305,7,8,6,10,28,29,-1,30
Randers FC,2305,8,6,6,12,24,39,-15,24
Silkeborg IF,2305,9,5,4,13,26,45,-19,19
AGF Aarhus,2305,10,4,7,11,17,37,-20,19
Lyngby,2305,11,3,9,12,26,45,-19,18
Brondby,2306,1,22,5,3,74,32,42,71
FC Midtjylla,2306,2,20,5,5,66,38,28,65
Copenhagen,2306,3,14,7,9,58,43,15,49
FC Nords,2306,4,13,8,9,71,53,18,47
AC Horsens,2306,5,6,13,11,35,55,-20,31
Sonderjyske,2306,6,8,6,10,28,29,-1,30
AaB,2306,7,6,12,12,36,45,-9,30
Randers FC,2306,8,5,7,12,23,39,-16,22
Lyngby,2306,9,3,10,11,26,44,-18,19
Silkeborg IF,2306,10,5,4,13,27,46,-19,19
AGF Aarhus,2306,11,4,7,11,18,38,-20,19
Brondby,2307,1,21,7,2,72,32,40,70
FC Midtjylla,2307,2,18,7,5,63,39,24,61
FC Nords,2307,3,15,7,8,77,51,26,52
Copenhagen,2307,4,13,5,12,57,47,10,44
AaB,2307,5,7,13,10,36,42,-6,34
AC Horsens,2307,6,6,13,11,38,58,-20,31
Sonderjyske,2307,7,8,6,10,28,29,-1,30
Randers FC,2307,8,6,6,12,24,39,-15,24
Silkeborg IF,2307,9,5,4,13,26,45,-19,19
AGF Aarhus,2307,10,4,7,11,17,37,-20,19
Lyngby,2307,11,3,9,12,26,45,-19,18
Brondby,2308,1,22,6,2,70,28,42,72
FC Midtjylla,2308,2,19,5,6,63,37,26,62
FC Nords,2308,3,16,6,8,74,47,27,54
Copenhagen,2308,4,12,7,11,54,43,11,43
AaB,2308,5,7,12,11,35,44,-9,33
Sonderjyske,2308,6,8,6,10,28,29,-1,30
AC Horsens,2308,7,5,14,11,34,57,-23,29
Randers FC,2308,8,5,7,12,24,40,-16,22
Lyngby,2308,9,3,10,11,27,45,-18,19
Silkeborg IF,2308,10,5,4,13,26,45,-19,19
AGF Aarhus,2308,11,4,7,11,17,37,-20,19
Brondby,2309,1,22,6,2,69,30,39,72
FC Midtjylla,2309,2,20,5,5,67,39,28,65
FC Nords,2309,3,15,7,8,80,50,30,52
Copenhagen,2309,4,12,6,12,56,48,8,42
AaB,2309,5,8,11,11,34,44,-10,35
Sonderjyske,2309,6,8,6,10,28,29,-1,30
AC Horsens,2309,7,5,13,12,33,54,-21,28
Lyngby,2309,8,4,9,11,29,44,-15,21
Randers FC,2309,9,5,6,13,23,42,-19,21
AGF Aarhus,2309,10,5,6,11,17,36,-19,21
Silkeborg IF,2309,11,5,3,14,25,45,-20,18
Brondby,2310,1,21,7,2,73,30,43,70
FC Midtjylla,2310,2,17,7,6,62,41,21,58
FC Nords,2310,3,14,7,9,72,53,19,49
Copenhagen,2310,4,13,7,10,55,44,11,46
AaB,2310,5,7,13,10,37,43,-6,34
AC Horsens,2310,6,6,15,9,35,49,-14,33
Sonderjyske,2310,7,8,6,10,28,29,-1,30
Lyngby,2310,8,4,9,11,27,44,-17,21
Randers FC,2310,9,5,6,13,23,40,-17,21
Silkeborg IF,2310,10,6,3,13,26,44,-18,21
AGF Aarhus,2310,11,4,6,12,16,37,-21,18
Brondby,2311,1,21,6,3,68,31,37,69
FC Midtjylla,2311,2,21,4,5,67,39,28,67
FC Nords,2311,3,13,7,10,72,55,17,46
Copenhagen,2311,4,13,7,10,58,43,15,46
AaB,2311,5,7,13,10,40,47,-7,34
AC Horsens,2311,6,6,13,11,36,52,-16,31
Sonderjyske,2311,7,8,6,10,28,29,-1,30
Randers FC,2311,8,5,7,12,24,40,-16,22
Lyngby,2311,9,3,10,11,27,45,-18,19
Silkeborg IF,2311,10,5,4,13,27,46,-19,19
AGF Aarhus,2311,11,4,7,11,18,38,-20,19
FC Midtjylla,2312,1,21,4,5,68,38,30,67
Brondby,2312,2,20,6,4,73,32,41,66
Copenhagen,2312,3,16,4,10,61,45,16,52
FC Nords,2312,4,15,6,9,75,50,25,51
Sonderjyske,2312,5,8,6,10,28,29,-1,30
AaB,2312,6,6,12,12,34,46,-12,30
AC Horsens,2312,7,6,12,12,34,60,-26,30
Randers FC,2312,8,5,7,12,23,39,-16,22
AGF Aarhus,2312,9,5,6,11,19,37,-18,21
Lyngby,2312,10,3,10,11,26,44,-18,19
Silkeborg IF,2312,11,5,3,14,26,47,-21,18
Brondby,2313,1,21,5,4,74,31,43,68
FC Midtjylla,2313,2,19,5,6,61,40,21,62
Copenhagen,2313,3,16,4,10,60,44,16,52
FC Nords,2313,4,13,7,10,72,55,17,46
AC Horsens,2313,5,8,12,10,34,50,-16,36
AaB,2313,6,6,13,11,34,41,-7,31
Sonderjyske,2313,7,8,6,10,28,29,-1,30
Lyngby,2313,8,4,9,11,27,44,-17,21
Randers FC,2313,9,5,6,13,23,40,-17,21
Silkeborg IF,2313,10,6,3,13,28,46,-18,21
AGF Aarhus,2313,11,4,6,12,18,39,-21,18
Brondby,2314,1,21,6,3,73,35,38,69
FC Midtjylla,2314,2,19,5,6,65,40,25,62
FC Nords,2314,3,13,8,9,76,54,22,47
Copenhagen,2314,4,12,8,10,59,47,12,44
AC Horsens,2314,5,8,12,10,40,58,-18,36
AaB,2314,6,7,13,10,35,40,-5,34
Sonderjyske,2314,7,8,6,10,28,29,-1,30
Lyngby,2314,8,4,9,11,29,44,-15,21
Silkeborg IF,2314,9,6,3,13,27,45,-18,21
Randers FC,2314,10,5,6,13,23,42,-19,21
AGF Aarhus,2314,11,4,6,12,17,38,-21,18
Brondby,2315,1,21,7,2,69,29,40,70
FC Midtjylla,2315,2,20,5,5,67,38,29,65
FC Nords,2315,3,14,8,8,74,52,22,50
Copenhagen,2315,4,12,7,11,58,47,11,43
AaB,2315,5,7,12,11,37,48,-11,33
Sonderjyske,2315,6,8,6,10,28,29,-1,30
AC Horsens,2315,7,5,15,10,35,52,-17,30
Randers FC,2315,8,6,6,12,24,39,-15,24
Silkeborg IF,2315,9,5,4,13,25,44,-19,19
AGF Aarhus,2315,10,4,7,11,16,36,-20,19
Lyngby,2315,11,3,9,12,26,45,-19,18
Brondby,2316,1,23,5,2,77,33,44,74
FC Midtjylla,2316,2,20,5,5,66,42,24,65
FC Nords,2316,3,13,8,9,74,53,21,47
Copenhagen,2316,4,13,4,13,54,46,8,43
AaB,2316,5,7,12,11,35,42,-7,33
AC Horsens,2316,6,7,12,11,34,50,-16,33
Sonderjyske,2316,7,8,6,10,28,29,-1,30
Randers FC,2316,8,6,6,12,24,39,-15,24
Silkeborg IF,2316,9,6,3,13,26,44,-18,21
Lyngby,2316,10,3,9,12,26,45,-19,18
AGF Aarhus,2316,11,4,6,12,16,37,-21,18
Brondby,2317,1,20,7,3,69,32,37,67
FC Midtjylla,2317,2,20,5,5,64,38,26,65
FC Nords,2317,3,15,8,7,72,45,27,53
Copenhagen,2317,4,14,5,11,56,43,13,47
AC Horsens,2317,5,6,14,10,35,52,-17,32
Sonderjyske,2317,6,8,6,10,28,29,-1,30
AaB,2317,7,6,11,13,34,46,-12,29
Randers FC,2317,8,6,6,12,25,39,-14,24
Silkeborg IF,2317,9,5,4,13,26,45,-19,19
AGF Aarhus,2317,10,4,7,11,17,37,-20,19
Lyngby,2317,11,3,9,12,26,46,-20,18
FC Midtjylla,2318,1,20,4,6,61,37,24,64
Brondby,2318,2,19,6,5,66,35,31,63
FC Nords,2318,3,15,7,8,73,47,26,52
Copenhagen,2318,4,15,6,9,61,40,21,51
AC Horsens,2318,5,7,12,11,33,54,-21,33
AaB,2318,6,6,13,11,34,41,-7,31
Sonderjyske,2318,7,8,6,10,28,29,-1,30
Randers FC,2318,8,5,7,12,23,39,-16,22
AGF Aarhus,2318,9,5,6,11,18,36,-18,21
Lyngby,2318,10,3,10,11,26,44,-18,19
Silkeborg IF,2318,11,5,3,14,25,46,-21,18
Brondby,2319,1,20,7,3,67,35,32,67
FC Midtjylla,2319,2,20,4,6,62,38,24,64
Copenhagen,2319,3,16,4,10,63,38,25,52
FC Nords,2319,4,12,9,9,65,49,16,45
AaB,2319,5,7,13,10,35,40,-5,34
Sonderjyske,2319,6,8,6,10,28,29,-1,30
AC Horsens,2319,7,5,15,10,35,53,-18,30
Lyngby,2319,8,4,9,11,27,44,-17,21
Randers FC,2319,9,5,6,13,23,40,-17,21
Silkeborg IF,2319,10,6,3,13,26,44,-18,21
AGF Aarhus,2319,11,4,6,12,16,37,-21,18
Brondby,2320,1,22,5,3,71,32,39,71
FC Midtjylla,2320,2,18,6,6,63,41,22,60
Copenhagen,2320,3,15,4,11,62,44,18,49
FC Nords,2320,4,12,7,11,68,55,13,43
AaB,2320,5,8,12,10,40,43,-3,36
AC Horsens,2320,6,8,12,10,36,51,-15,36
Sonderjyske,2320,7,8,6,10,28,29,-1,30
Lyngby,2320,8,4,9,11,31,47,-16,21
Silkeborg IF,2320,9,6,3,13,29,47,-18,21
Randers FC,2320,10,5,6,13,26,44,-18,21
AGF Aarhus,2320,11,4,6,12,19,40,-21,18
Brondby,2321,1,20,7,3,71,35,36,67
FC Midtjylla,2321,2,20,5,5,66,39,27,65
Copenhagen,2321,3,14,7,9,57,42,15,49
FC Nords,2321,4,13,7,10,71,54,17,46
AC Horsens,2321,5,8,12,10,38,48,-10,36
Sonderjyske,2321,6,8,6,10,28,29,-1,30
AaB,2321,7,6,12,12,35,46,-11,30
Randers FC,2321,8,5,7,12,25,41,-16,22
Lyngby,2321,9,3,10,11,28,46,-18,19
Silkeborg IF,2321,10,5,4,13,25,44,-19,19
AGF Aarhus,2321,11,4,7,11,16,36,-20,19
Brondby,2322,1,22,5,3,75,32,43,71
FC Midtjylla,2322,2,17,6,7,62,43,19,57
FC Nords,2322,3,14,7,9,72,54,18,49
Copenhagen,2322,4,13,7,10,58,45,13,46
AaB,2322,5,10,11,9,45,45,0,41
Sonderjyske,2322,6,8,6,10,28,29,-1,30
AC Horsens,2322,7,5,14,11,32,51,-19,29
Lyngby,2322,8,4,9,11,29,44,-15,21
Silkeborg IF,2322,9,6,3,13,27,44,-17,21
Randers FC,2322,10,5,6,13,23,42,-19,21
AGF Aarhus,2322,11,4,6,12,16,38,-22,18
Brondby,2323,1,22,5,3,76,30,46,71
FC Midtjylla,2323,2,20,6,4,74,39,35,66
FC Nords,2323,3,14,7,9,76,59,17,49
Copenhagen,2323,4,13,5,12,57,49,8,44
AC Horsens,2323,5,7,12,11,33,57,-24,33
AaB,2323,6,6,13,11,33,41,-8,31
Sonderjyske,2323,7,8,6,10,28,29,-1,30
Lyngby,2323,8,4,9,11,28,45,-17,21
Randers FC,2323,9,5,6,13,24,41,-17,21
Silkeborg IF,2323,10,5,4,13,25,44,-19,19
AGF Aarhus,2323,11,4,7,11,16,36,-20,19
Brondby,2324,1,22,6,2,77,29,48,72
FC Midtjylla,2324,2,18,6,6,61,40,21,60
FC Nords,2324,3,13,7,10,70,53,17,46
Copenhagen,2324,4,13,5,12,56,46,10,44
AaB,2324,5,8,12,10,38,50,-12,36
AC Horsens,2324,6,7,14,9,40,50,-10,35
Sonderjyske,2324,7,8,6,10,28,29,-1,30
Randers FC,2324,8,5,7,12,23,39,-16,22
Lyngby,2324,9,3,10,11,26,44,-18,19
Silkeborg IF,2324,10,5,4,13,26,45,-19,19
AGF Aarhus,2324,11,4,7,11,17,37,-20,19
Brondby,2325,1,20,8,2,70,32,38,68
FC Midtjylla,2325,2,19,6,5,62,38,24,63
FC Nords,2325,3,14,8,8,78,52,26,50
Copenhagen,2325,4,14,7,9,59,44,15,49
AaB,2325,5,7,12,11,35,43,-8,33
Sonderjyske,2325,6,8,6,10,28,29,-1,30
AC Horsens,2325,7,5,13,12,31,52,-21,28
Randers FC,2325,8,5,7,12,27,43,-16,22
Lyngby,2325,9,3,10,11,30,48,-18,19
Silkeborg IF,2325,10,5,4,13,25,44,-19,19
AGF Aarhus,2325,11,4,7,11,16,36,-20,19
Brondby,2326,1,23,5,2,75,30,45,74
FC Midtjylla,2326,2,19,5,6,64,43,21,62
FC Nords,2326,3,14,7,9,75,54,21,49
Copenhagen,2326,4,14,4,12,60,47,13,46
AaB,2326,5,7,13,10,35,42,-7,34
Sonderjyske,2326,6,8,6,10,28,29,-1,30
AC Horsens,2326,7,6,12,12,38,57,-19,30
Lyngby,2326,8,4,9,11,28,45,-17,21
Randers FC,2326,9,5,6,13,24,41,-17,21
Silkeborg IF,2326,10,5,4,13,28,47,-19,19
AGF Aarhus,2326,11,4,7,11,19,39,-20,19
FC Midtjylla,2327,1,21,5,4,70,35,35,68
Brondby,2327,2,18,8,4,68,37,31,62
FC Nords,2327,3,13,8,9,72,59,13,47
Copenhagen,2327,4,13,6,11,60,47,13,45
AaB,2327,5,7,15,8,37,37,0,36
AC Horsens,2327,6,6,14,10,31,49,-18,32
Sonderjyske,2327,7,8,6,10,28,29,-1,30
Randers FC,2327,8,6,6,12,24,39,-15,24
Silkeborg IF,2327,9,6,3,13,28,45,-17,21
Lyngby,2327,10,3,9,12,26,45,-19,18
AGF Aarhus,2327,11,4,6,12,17,39,-22,18
Brondby,2328,1,21,6,3,68,31,37,69
FC Midtjylla,2328,2,20,4,6,64,37,27,64
FC Nords,2328,3,14,9,7,75,51,24,51
Copenhagen,2328,4,13,5,12,54,44,10,44
AaB,2328,5,7,12,11,37,45,-8,33
AC Horsens,2328,6,7,12,11,34,50,-16,33
Sonderjyske,2328,7,8,6,10,28,29,-1,30
Randers FC,2328,8,5,7,12,25,41,-16,22
AGF Aarhus,2328,9,5,6,11,17,36,-19,21
Lyngby,2328,10,3,10,11,28,46,-18,19
Silkeborg IF,2328,11,5,3,14,25,45,-20,18
Brondby,2329,1,21,7,2,75,32,43,70
FC Midtjylla,2329,2,21,5,4,73,38,35,68
FC Nords,2329,3,13,7,10,71,60,11,46
Copenhagen,2329,4,13,6,11,53,42,11,45
AaB,2329,5,6,14,10,36,43,-7,32
AC Horsens,2329,6,6,13,11,38,57,-19,31
Sonderjyske,2329,7,8,6,10,28,29,-1,30
Lyngby,2329,8,4,9,11,27,44,-17,21
Randers FC,2329,9,5,6,13,23,40,-17,21
AGF Aarhus,2329,10,5,6,11,17,36,-19,21
Silkeborg IF,2329,11,5,3,14,25,45,-20,18
Brondby,2330,1,22,6,2,72,27,45,72
FC Midtjylla,2330,2,20,5,5,65,37,28,65
FC Nords,2330,3,13,7,10,70,51,19,46
Copenhagen,2330,4,14,4,12,55,48,7,46
AaB,2330,5,7,13,10,35,42,-7,34
AC Horsens,2330,6,6,13,11,38,56,-18,31
Sonderjyske,2330,7,8,6,10,28,29,-1,30
Randers FC,2330,8,5,7,12,24,40,-16,22
Silkeborg IF,2330,9,6,3,13,29,47,-18,21
Lyngby,2330,10,3,10,11,27,45,-18,19
AGF Aarhus,2330,11,4,6,12,19,40,-21,18
Brondby,2331,1,21,6,3,72,32,40,69
FC Midtjylla,2331,2,19,6,5,67,39,28,63
FC Nords,2331,3,15,7,8,72,47,25,52
Copenhagen,2331,4,13,5,12,55,49,6,44
AaB,2331,5,7,12,11,36,42,-6,33
AC Horsens,2331,6,7,12,11,36,55,-19,33
Sonderjyske,2331,7,8,6,10,28,29,-1,30
Lyngby,2331,8,4,9,11,27,44,-17,21
Randers FC,2331,9,5,6,13,23,40,-17,21
Silkeborg IF,2331,10,5,4,13,25,44,-19,19
AGF Aarhus,2331,11,4,7,11,16,36,-20,19
Brondby,2332,1,20,6,4,68,32,36,66
FC Midtjylla,2332,2,18,5,7,63,42,21,59
FC Nords,2332,3,15,6,9,77,52,25,51
Copenhagen,2332,4,13,5,12,58,47,11,44
AaB,2332,5,10,11,9,36,38,-2,41
AC Horsens,2332,6,7,13,10,36,53,-17,34
Sonderjyske,2332,7,8,6,10,28,29,-1,30
Randers FC,2332,8,5,7,12,25,41,-16,22
Silkeborg IF,2332,9,6,3,13,27,45,-18,21
Lyngby,2332,10,3,10,11,28,46,-18,19
AGF Aarhus,2332,11,4,6,12,17,38,-21,18
Brondby,2333,1,20,6,4,69,31,38,66
FC Midtjylla,2333,2,20,5,5,66,37,29,65
FC Nords,2333,3,15,7,8,69,49,20,52
Copenhagen,2333,4,13,5,12,57,46,11,44
AC Horsens,2333,5,7,13,10,34,52,-18,34
AaB,2333,6,7,12,11,36,42,-6,33
Sonderjyske,2333,7,8,6,10,28,29,-1,30
Lyngby,2333,8,4,9,11,30,46,-16,21
Silkeborg IF,2333,9,6,3,13,26,44,-18,21
Randers FC,2333,10,5,6,13,25,43,-18,21
AGF Aarhus,2333,11,4,6,12,16,37,-21,18
Brondby,2334,1,20,7,3,74,31,43,67
FC Midtjylla,2334,2,20,5,5,69,38,31,65
Copenhagen,2334,3,15,5,10,61,44,17,50
FC Nords,2334,4,13,7,10,71,58,13,46
AaB,2334,5,9,12,9,42,43,-1,39
Sonderjyske,2334,6,8,6,10,28,29,-1,30
AC Horsens,2334,7,5,12,13,33,62,-29,27
Randers FC,2334,8,6,6,12,25,40,-15,24
AGF Aarhus,2334,9,5,6,11,19,37,-18,21
Lyngby,2334,10,3,9,12,27,46,-19,18
Silkeborg IF,2334,11,5,3,14,26,47,-21,18
FC Midtjylla,2335,1,21,5,4,67,36,31,68
Brondby,2335,2,19,7,4,66,33,33,64
Copenhagen,2335,3,14,5,11,58,42,16,47
FC Nords,2335,4,13,6,11,72,58,14,45
AaB,2335,5,9,12,9,38,38,0,39
AC Horsens,2335,6,6,13,11,34,54,-20,31
Sonderjyske,2335,7,8,6,10,28,29,-1,30
Lyngby,2335,8,4,9,11,28,45,-17,21
Randers FC,2335,9,5,6,13,24,41,-17,21
AGF Aarhus,2335,10,5,6,11,17,36,-19,21
Silkeborg IF,2335,11,5,3,14,25,45,-20,18
Brondby,2336,1,21,5,4,67,29,38,68
FC Midtjylla,2336,2,20,6,4,65,36,29,66
Copenhagen,2336,3,14,7,9,57,42,15,49
FC Nords,2336,4,13,7,10,71,53,18,46
AaB,2336,5,6,15,9,36,42,-6,33
Sonderjyske,2336,6,8,6,10,28,29,-1,30
AC Horsens,2336,7,5,14,11,32,52,-20,29
Silkeborg IF,2336,8,6,3,13,29,45,-16,21
Lyngby,2336,9,4,9,11,28,45,-17,21
Randers FC,2336,10,5,6,13,24,41,-17,21
AGF Aarhus,2336,11,4,6,12,17,40,-23,18
Brondby,2337,1,20,6,4,69,34,35,66
FC Midtjylla,2337,2,19,4,7,65,41,24,61
FC Nords,2337,3,16,7,7,76,47,29,55
Copenhagen,2337,4,16,5,9,58,40,18,53
AC Horsens,2337,5,6,13,11,36,53,-17,31
Sonderjyske,2337,6,8,6,10,28,29,-1,30
AaB,2337,7,6,11,13,34,49,-15,29
Randers FC,2337,8,6,6,12,27,40,-13,24
AGF Aarhus,2337,9,5,6,11,20,36,-16,21
Lyngby,2337,10,3,9,12,27,48,-21,18
Silkeborg IF,2337,11,5,3,14,25,48,-23,18
Brondby,2338,1,20,7,3,70,32,38,67
FC Midtjylla,2338,2,21,4,5,69,41,28,67
FC Nords,2338,3,14,8,8,74,49,25,50
Copenhagen,2338,4,14,4,12,58,47,11,46
AaB,2338,5,7,11,12,35,43,-8,32
AC Horsens,2338,6,6,14,10,34,54,-20,32
Sonderjyske,2338,7,8,6,10,28,29,-1,30
Randers FC,2338,8,5,7,12,23,39,-16,22
Lyngby,2338,9,3,10,11,26,44,-18,19
Silkeborg IF,2338,10,5,4,13,28,47,-19,19
AGF Aarhus,2338,11,4,7,11,19,39,-20,19
Brondby,2339,1,20,6,4,69,35,34,66
FC Midtjylla,2339,2,18,6,6,66,43,23,60
FC Nords,2339,3,14,8,8,72,49,23,50
Copenhagen,2339,4,14,6,10,61,43,18,48
AC Horsens,2339,5,8,12,10,34,51,-17,36
AaB,2339,6,7,12,11,35,42,-7,33
Sonderjyske,2339,7,8,6,10,28,29,-1,30
Randers FC,2339,8,5,7,12,25,41,-16,22
Silkeborg IF,2339,9,6,3,13,30,44,-14,21
Lyngby,2339,10,3,10,11,28,46,-18,19
AGF Aarhus,2339,11,4,6,12,16,41,-25,18
Brondby,2340,1,22,6,2,72,32,40,72
FC Midtjylla,2340,2,18,5,7,63,40,23,59
FC Nords,2340,3,14,8,8,76,51,25,50
Copenhagen,2340,4,14,4,12,56,47,9,46
AaB,2340,5,7,14,9,41,44,-3,35
AC Horsens,2340,6,6,13,11,35,55,-20,31
Sonderjyske,2340,7,8,6,10,28,29,-1,30
Randers FC,2340,8,5,7,12,24,40,-16,22
AGF Aarhus,2340,9,5,6,11,19,37,-18,21
Lyngby,2340,10,3,10,11,27,45,-18,19
Silkeborg IF,2340,11,5,3,14,26,47,-21,18
Brondby,2341,1,20,6,4,72,34,38,66
FC Midtjylla,2341,2,20,5,5,69,41,28,65
Copenhagen,2341,3,14,6,10,59,43,16,48
FC Nords,2341,4,12,7,11,76,60,16,43
AaB,2341,5,9,12,9,38,40,-2,39
AC Horsens,2341,6,6,14,10,33,55,-22,32
Sonderjyske,2341,7,8,6,10,28,29,-1,30
Lyngby,2341,8,4,9,11,28,44,-16,21
Silkeborg IF,2341,9,6,3,13,27,45,-18,21
Randers FC,2341,10,5,6,13,23,41,-18,21
AGF Aarhus,2341,11,4,6,12,17,38,-21,18
Brondby,2342,1,22,6,2,72,30,42,72
FC Midtjylla,2342,2,21,4,5,63,36,27,67
FC Nords,2342,3,13,8,9,70,48,22,47
Copenhagen,2342,4,12,7,11,57,47,10,43
AaB,2342,5,7,12,11,36,44,-8,33
AC Horsens,2342,6,6,13,11,35,54,-19,31
Sonderjyske,2342,7,8,6,10,28,29,-1,30
Lyngby,2342,8,4,9,11,31,46,-15,21
Randers FC,2342,9,5,6,13,25,44,-19,21
Silkeborg IF,2342,10,5,4,13,25,44,-19,19
AGF Aarhus,2342,11,4,7,11,16,36,-20,19
Brondby,2343,1,22,6,2,72,29,43,72
FC Midtjylla,2343,2,19,5,6,63,37,26,62
FC Nords,2343,3,16,6,8,77,47,30,54
Copenhagen,2343,4,13,5,12,55,45,10,44
AaB,2343,5,7,11,12,34,48,-14,32
AC Horsens,2343,6,6,13,11,33,54,-21,31
Sonderjyske,2343,7,8,6,10,28,29,-1,30
Lyngby,2343,8,4,9,11,27,44,-17,21
Randers FC,2343,9,5,6,13,23,40,-17,21
Silkeborg IF,2343,10,5,4,13,26,45,-19,19
AGF Aarhus,2343,11,4,7,11,17,37,-20,19
Brondby,2344,1,19,8,3,70,34,36,65
FC Midtjylla,2344,2,19,7,4,66,36,30,64
FC Nords,2344,3,15,8,7,72,47,25,53
Copenhagen,2344,4,13,5,12,58,50,8,44
AC Horsens,2344,5,6,16,8,36,50,-14,34
Sonderjyske,2344,6,8,6,10,28,29,-1,30
AaB,2344,7,6,12,12,35,46,-11,30
Lyngby,2344,8,4,9,11,28,44,-16,21
Silkeborg IF,2344,9,6,3,13,27,44,-17,21
Randers FC,2344,10,5,6,13,23,41,-18,21
AGF Aarhus,2344,11,4,6,12,16,38,-22,18
Brondby,2345,1,20,7,3,68,29,39,67
FC Midtjylla,2345,2,19,6,5,65,40,25,63
FC Nords,2345,3,15,7,8,74,51,23,52
Copenhagen,2345,4,14,5,11,56,43,13,47
AaB,2345,5,7,13,10,36,41,-5,34
Sonderjyske,2345,6,8,6,10,28,29,-1,30
AC Horsens,2345,7,5,14,11,32,53,-21,29
Randers FC,2345,8,5,7,12,24,40,-16,22
Silkeborg IF,2345,9,6,3,13,26,44,-18,21
Lyngby,2345,10,3,10,11,27,45,-18,19
AGF Aarhus,2345,11,4,6,12,16,37,-21,18
FC Midtjylla,2346,1,21,4,5,69,39,30,67
Brondby,2346,2,19,6,5,69,40,29,63
FC Nords,2346,3,13,9,8,72,52,20,48
Copenhagen,2346,4,14,6,10,63,45,18,48
AaB,2346,5,8,13,9,40,43,-3,37
Sonderjyske,2346,6,8,6,10,28,29,-1,30
AC Horsens,2346,7,6,12,12,36,56,-20,30
Lyngby,2346,8,4,9,11,30,46,-16,21
Silkeborg IF,2346,9,6,3,13,26,44,-18,21
Randers FC,2346,10,5,6,13,25,43,-18,21
AGF Aarhus,2346,11,4,6,12,16,37,-21,18
Brondby,2347,1,21,5,4,74,37,37,68
FC Midtjylla,2347,2,21,4,5,65,39,26,67
FC Nords,2347,3,13,9,8,73,50,23,48
Copenhagen,2347,4,13,6,11,56,41,15,45
AaB,2347,5,8,12,10,37,42,-5,36
Sonderjyske,2347,6,8,6,10,28,29,-1,30
AC Horsens,2347,7,5,14,11,33,55,-22,29
Randers FC,2347,8,6,6,12,26,39,-13,24
Silkeborg IF,2347,9,6,3,13,29,45,-16,21
Lyngby,2347,10,3,9,12,26,47,-21,18
AGF Aarhus,2347,11,4,6,12,17,40,-23,18
FC Midtjylla,2348,1,21,5,4,67,37,30,68
Brondby,2348,2,19,7,4,67,35,32,64
FC Nords,2348,3,14,6,10,73,51,22,48
Copenhagen,2348,4,14,5,11,54,42,12,47
AaB,2348,5,7,13,10,34,40,-6,34
AC Horsens,2348,6,6,14,10,36,52,-16,32
Sonderjyske,2348,7,8,6,10,28,29,-1,30
Randers FC,2348,8,5,7,12,25,41,-16,22
AGF Aarhus,2348,9,5,6,11,18,37,-19,21
Lyngby,2348,10,3,10,11,28,46,-18,19
Silkeborg IF,2348,11,5,3,14,26,46,-20,18
Brondby,2349,1,20,7,3,66,30,36,67
FC Midtjylla,2349,2,19,6,5,67,39,28,63
FC Nords,2349,3,14,7,9,72,53,19,49
Copenhagen,2349,4,14,5,11,61,47,14,47
AaB,2349,5,8,12,10,39,44,-5,36
Sonderjyske,2349,6,8,6,10,28,29,-1,30
AC Horsens,2349,7,5,15,10,32,50,-18,30
Lyngby,2349,8,4,9,11,27,44,-17,21
Randers FC,2349,9,5,6,13,23,40,-17,21
Silkeborg IF,2349,10,6,3,13,26,44,-18,21
AGF Aarhus,2349,11,4,6,12,16,37,-21,18
Brondby,2350,1,22,6,2,78,32,46,72
FC Midtjylla,2350,2,18,5,7,65,42,23,59
FC Nords,2350,3,13,7,10,72,54,18,46
Copenhagen,2350,4,13,5,12,56,51,5,44
AaB,2350,5,9,12,9,38,42,-4,39
AC Horsens,2350,6,6,15,9,33,47,-14,33
Sonderjyske,2350,7,8,6,10,28,29,-1,30
Lyngby,2350,8,4,9,11,28,45,-17,21
Randers FC,2350,9,5,6,13,24,41,-17,21
Silkeborg IF,2350,10,6,3,13,26,44,-18,21
AGF Aarhus,2350,11,4,6,12,16,37,-21,18
Brondby,2351,1,21,6,3,71,31,40,69
FC Midtjylla,2351,2,19,5,6,69,42,27,62
FC Nords,2351,3,16,6,8,75,49,26,54
Copenhagen,2351,4,14,5,11,59,43,16,47
AC Horsens,2351,5,6,14,10,32,51,-19,32
Sonderjyske,2351,6,8,6,10,28,29,-1,30
AaB,2351,7,6,12,12,35,51,-16,30
Silkeborg IF,2351,8,6,3,13,28,45,-17,21
Lyngby,2351,9,4,9,11,27,44,-17,21
Randers FC,2351,10,5,6,13,23,40,-17,21
AGF Aarhus,2351,11,4,6,12,17,39,-22,18
Brondby,2352,1,21,5,4,73,32,41,68
FC Midtjylla,2352,2,19,4,7,65,39,26,61
Copenhagen,2352,3,16,4,10,63,44,19,52
FC Nords,2352,4,12,8,10,70,55,15,44
AaB,2352,5,8,12,10,42,50,-8,36
AC Horsens,2352,6,7,13,10,36,55,-19,34
Sonderjyske,2352,7,8,6,10,28,29,-1,30
Lyngby,2352,8,4,9,11,27,44,-17,21
Randers FC,2352,9,5,6,13,23,40,-17,21
Silkeborg IF,2352,10,5,4,13,26,45,-19,19
AGF Aarhus,2352,11,4,7,11,17,37,-20,19
Brondby,2353,1,22,6,2,75,32,43,72
FC Midtjylla,2353,2,18,6,6,62,42,20,60
FC Nords,2353,3,15,8,7,75,48,27,53
Copenhagen,2353,4,13,6,11,58,47,11,45
AaB,2353,5,7,12,11,38,45,-7,33
Sonderjyske,2353,6,8,6,10,28,29,-1,30
AC Horsens,2353,7,6,12,12,37,57,-20,30
Randers FC,2353,8,6,6,12,25,39,-14,24
Silkeborg IF,2353,9,6,3,13,26,44,-18,21
Lyngby,2353,10,3,9,12,26,46,-20,18
AGF Aarhus,2353,11,4,6,12,16,37,-21,18
Brondby,2354,1,20,7,3,66,29,37,67
FC Midtjylla,2354,2,20,5,5,67,39,28,65
FC Nords,2354,3,13,9,8,70,48,22,48
Copenhagen,2354,4,13,6,11,54,44,10,45
AC Horsens,2354,5,6,16,8,36,48,-12,34
AaB,2354,6,7,11,12,35,46,-11,32
Sonderjyske,2354,7,8,6,10,28,29,-1,30
Randers FC,2354,8,6,6,12,25,39,-14,24
Silkeborg IF,2354,9,6,3,13,27,44,-17,21
Lyngby,2354,10,3,9,12,26,46,-20,18
AGF Aarhus,2354,11,4,6,12,16,38,-22,18
Brondby,2355,1,22,5,3,71,32,39,71
FC Midtjylla,2355,2,20,4,6,64,36,28,64
Copenhagen,2355,3,15,4,11,63,45,18,49
FC Nords,2355,4,12,7,11,65,54,11,43
AaB,2355,5,8,11,11,35,43,-8,35
AC Horsens,2355,6,7,13,10,36,50,-14,34
Sonderjyske,2355,7,8,6,10,28,29,-1,30
Lyngby,2355,8,4,9,11,29,44,-15,21
Silkeborg IF,2355,8,6,3,13,29,44,-15,21
Randers FC,2355,10,5,6,13,23,42,-19,21
AGF Aarhus,2355,11,4,6,12,16,40,-24,18
Brondby,2356,1,22,6,2,67,28,39,72
FC Midtjylla,2356,2,20,5,5,70,36,34,65
FC Nords,2356,3,13,8,9,70,52,18,47
Copenhagen,2356,4,13,8,9,54,40,14,47
AC Horsens,2356,5,6,13,11,32,51,-19,31
Sonderjyske,2356,6,8,6,10,28,29,-1,30
AaB,2356,7,6,12,12,32,44,-12,30
Randers FC,2356,8,5,7,12,23,39,-16,22
Silkeborg IF,2356,9,6,3,13,26,44,-18,21
Lyngby,2356,10,3,10,11,26,44,-18,19
AGF Aarhus,2356,11,4,6,12,16,37,-21,18
Brondby,2357,1,20,5,5,68,36,32,65
FC Midtjylla,2357,2,20,4,6,64,35,29,64
FC Nords,2357,3,15,6,9,75,52,23,51
Copenhagen,2357,4,14,5,11,58,44,14,47
AaB,2357,5,9,11,10,39,42,-3,38
AC Horsens,2357,6,6,13,11,35,56,-21,31
Sonderjyske,2357,7,8,6,10,28,29,-1,30
Randers FC,2357,8,6,6,12,24,39,-15,24
Silkeborg IF,2357,9,6,3,13,26,44,-18,21
Lyngby,2357,10,3,9,12,26,45,-19,18
AGF Aarhus,2357,11,4,6,12,16,37,-21,18
Brondby,2358,1,23,5,2,74,30,44,74
FC Midtjylla,2358,2,18,6,6,61,38,23,60
Copenhagen,2358,3,15,4,11,62,50,12,49
FC Nords,2358,4,13,8,9,72,53,19,47
AaB,2358,5,6,14,10,34,41,-7,32
Sonderjyske,2358,6,8,6,10,28,29,-1,30
AC Horsens,2358,7,5,15,10,40,57,-17,30
Randers FC,2358,8,5,7,12,24,40,-16,22
Silkeborg IF,2358,9,6,3,13,26,44,-18,21
Lyngby,2358,10,3,10,11,27,45,-18,19
AGF Aarhus,2358,11,4,6,12,16,37,-21,18
Brondby,2359,1,19,7,4,66,32,34,64
FC Midtjylla,2359,2,19,4,7,63,41,22,61
Copenhagen,2359,3,16,4,10,56,38,18,52
FC Nords,2359,4,13,7,10,71,50,21,46
AC Horsens,2359,5,8,13,9,38,52,-14,37
AaB,2359,6,8,11,11,35,42,-7,35
Sonderjyske,2359,7,8,6,10,28,29,-1,30
Randers FC,2359,8,5,7,12,23,39,-16,22
Lyngby,2359,9,3,10,11,26,44,-18,19
Silkeborg IF,2359,10,5,4,13,25,44,-19,19
AGF Aarhus,2359,11,4,7,11,16,36,-20,19
Brondby,2360,1,21,6,3,69,32,37,69
FC Midtjylla,2360,2,20,5,5,69,41,28,65
FC Nords,2360,3,15,6,9,74,51,23,51
Copenhagen,2360,4,14,5,11,62,48,14,47
AaB,2360,5,6,14,10,37,46,-9,32
Sonderjyske,2360,6,8,6,10,28,29,-1,30
AC Horsens,2360,7,6,12,12,37,56,-19,30
Randers FC,2360,8,6,6,12,25,40,-15,24
Silkeborg IF,2360,9,6,3,13,28,44,-16,21
Lyngby,2360,10,3,9,12,27,46,-19,18
AGF Aarhus,2360,11,4,6,12,16,39,-23,18
Brondby,2361,1,22,6,2,79,32,47,72
FC Midtjylla,2361,2,20,6,4,72,41,31,66
FC Nords,2361,3,14,7,9,74,54,20,49
Copenhagen,2361,4,13,4,13,55,52,3,43
AaB,2361,5,7,12,11,36,45,-9,33
AC Horsens,2361,6,6,13,11,35,53,-18,31
Sonderjyske,2361,7,8,6,10,28,29,-1,30
Randers FC,2361,8,6,6,12,27,40,-13,24
Silkeborg IF,2361,9,6,3,13,27,44,-17,21
Lyngby,2361,10,3,9,12,27,48,-21,18
AGF Aarhus,2361,11,4,6,12,16,38,-22,18
FC Midtjylla,2362,1,20,6,4,64,35,29,66
Brondby,2362,2,19,7,4,73,40,33,64
FC Nords,2362,3,15,7,8,75,49,26,52
Copenhagen,2362,4,14,6,10,57,43,14,48
AC Horsens,2362,5,6,15,9,35,51,-16,33
Sonderjyske,2362,6,8,6,10,28,29,-1,30
AaB,2362,7,6,11,13,35,47,-12,29
Randers FC,2362,8,6,6,12,25,40,-15,24
AGF Aarhus,2362,9,5,6,11,18,37,-19,21
Lyngby,2362,10,3,9,12,27,46,-19,18
Silkeborg IF,2362,11,5,3,14,26,46,-20,18
Brondby,2363,1,22,6,2,77,35,42,72
FC Midtjylla,2363,2,19,5,6,69,42,27,62
FC Nords,2363,3,14,8,8,74,52,22,50
Copenhagen,2363,4,13,5,12,55,46,9,44
AaB,2363,5,7,12,11,40,48,-8,33
AC Horsens,2363,6,6,14,10,35,53,-18,32
Sonderjyske,2363,7,8,6,10,28,29,-1,30
Randers FC,2363,8,6,6,12,26,41,-15,24
Silkeborg IF,2363,9,6,3,13,27,44,-17,21
Lyngby,2363,10,3,9,12,28,47,-19,18
AGF Aarhus,2363,11,4,6,12,16,38,-22,18
Brondby,2364,1,20,7,3,74,34,40,67
FC Midtjylla,2364,2,19,7,4,68,40,28,64
FC Nords,2364,3,15,7,8,74,49,25,52
Copenhagen,2364,4,13,5,12,56,46,10,44
AC Horsens,2364,5,8,12,10,40,53,-13,36
Sonderjyske,2364,6,8,6,10,28,29,-1,30
AaB,2364,7,6,12,12,33,49,-16,30
Lyngby,2364,8,4,9,11,27,44,-17,21
Randers FC,2364,9,5,6,13,23,40,-17,21
Silkeborg IF,2364,10,6,3,13,27,45,-18,21
AGF Aarhus,2364,11,4,6,12,17,38,-21,18
Brondby,2365,1,22,6,2,72,29,43,72
FC Midtjylla,2365,2,19,6,5,66,40,26,63
Copenhagen,2365,3,14,7,9,56,41,15,49
FC Nords,2365,4,13,9,8,70,50,20,48
Sonderjyske,2365,5,8,6,10,28,29,-1,30
AaB,2365,6,6,12,12,37,48,-11,30
AC Horsens,2365,7,6,12,12,37,56,-19,30
Randers FC,2365,8,6,6,12,25,40,-15,24
Silkeborg IF,2365,9,5,4,13,26,45,-19,19
AGF Aarhus,2365,10,4,7,11,17,37,-20,19
Lyngby,2365,11,3,9,12,27,46,-19,18
Brondby,2366,1,20,6,4,73,35,38,66
FC Midtjylla,2366,2,20,5,5,66,39,27,65
Copenhagen,2366,3,16,5,9,61,42,19,53
FC Nords,2366,4,13,7,10,72,54,18,46
AC Horsens,2366,5,7,13,10,37,55,-18,34
Sonderjyske,2366,6,8,6,10,28,29,-1,30
AaB,2366,7,6,12,12,36,46,-10,30
Lyngby,2366,8,4,9,11,27,44,-17,21
Randers FC,2366,9,5,6,13,23,40,-17,21
Silkeborg IF,2366,10,5,4,13,25,44,-19,19
AGF Aarhus,2366,11,4,7,11,16,36,-20,19
Brondby,2367,1,21,5,4,69,34,35,68
FC Midtjylla,2367,2,21,4,5,65,37,28,67
FC Nords,2367,3,15,6,9,75,49,26,51
Copenhagen,2367,4,14,5,11,57,43,14,47
AaB,2367,5,8,12,10,37,40,-3,36
Sonderjyske,2367,6,8,6,10,28,29,-1,30
AC Horsens,2367,7,5,12,13,31,57,-26,27
Lyngby,2367,8,4,9,11,28,45,-17,21
Randers FC,2367,9,5,6,13,24,41,-17,21
AGF Aarhus,2367,10,5,6,11,19,36,-17,21
Silkeborg IF,2367,11,5,3,14,25,47,-22,18
Brondby,2368,1,21,6,3,75,35,40,69
FC Midtjylla,2368,2,20,5,5,67,37,30,65
Copenhagen,2368,3,15,4,11,60,44,16,49
FC Nords,2368,4,14,6,10,68,52,16,48
AC Horsens,2368,5,7,12,11,35,54,-19,33
AaB,2368,6,7,11,12,37,46,-9,32
Sonderjyske,2368,7,8,6,10,28,29,-1,30
Randers FC,2368,8,6,6,12,25,40,-15,24
AGF Aarhus,2368,9,5,6,11,18,37,-19,21
Lyngby,2368,10,3,9,12,27,46,-19,18
Silkeborg IF,2368,11,5,3,14,26,46,-20,18
Brondby,2369,1,21,5,4,71,34,37,68
FC Midtjylla,2369,2,18,5,7,62,41,21,59
FC Nords,2369,3,15,7,8,73,51,22,52
Copenhagen,2369,4,14,4,12,58,46,12,46
AC Horsens,2369,5,8,13,9,37,49,-12,37
AaB,2369,6,7,12,11,37,43,-6,33
Sonderjyske,2369,7,8,6,10,28,29,-1,30
Randers FC,2369,8,6,6,12,24,39,-15,24
Silkeborg IF,2369,9,6,3,13,29,47,-18,21
Lyngby,2369,10,3,9,12,26,45,-19,18
AGF Aarhus,2369,11,4,6,12,19,40,-21,18
Brondby,2370,1,21,5,4,75,35,40,68
FC Midtjylla,2370,2,21,4,5,72,41,31,67
Copenhagen,2370,3,14,5,11,57,46,11,47
FC Nords,2370,4,12,7,11,66,52,14,43
AaB,2370,5,8,12,10,36,43,-7,36
AC Horsens,2370,6,7,13,10,35,50,-15,34
Sonderjyske,2370,7,8,6,10,28,29,-1,30
Randers FC,2370,8,6,6,12,24,39,-15,24
AGF Aarhus,2370,9,5,6,11,17,36,-19,21
Lyngby,2370,10,3,9,12,26,45,-19,18
Silkeborg IF,2370,11,5,3,14,25,45,-20,18
FC Midtjylla,2371,1,21,4,5,70,38,32,67
Brondby,2371,2,19,6,5,66,37,29,63
Copenhagen,2371,3,15,5,10,61,45,16,50
FC Nords,2371,4,14,7,9,71,49,22,49
AaB,2371,5,7,12,11,35,42,-7,33
AC Horsens,2371,6,7,12,11,35,53,-18,33
Sonderjyske,2371,7,8,6,10,28,29,-1,30
Lyngby,2371,8,4,9,11,28,44,-16,21
Randers FC,2371,9,5,6,13,23,41,-18,21
AGF Aarhus,2371,10,5,6,11,19,37,-18,21
Silkeborg IF,2371,11,5,3,14,26,47,-21,18
Brondby,2372,1,21,5,4,67,31,36,68
FC Midtjylla,2372,2,19,4,7,65,43,22,61
Copenhagen,2372,3,16,5,9,59,40,19,53
FC Nords,2372,4,14,6,10,73,54,19,48
AaB,2372,5,7,13,10,37,42,-5,34
AC Horsens,2372,6,6,13,11,33,50,-17,31
Sonderjyske,2372,7,8,6,10,28,29,-1,30
Lyngby,2372,8,4,9,11,30,47,-17,21
Silkeborg IF,2372,9,6,3,13,28,45,-17,21
Randers FC,2372,10,5,6,13,26,43,-17,21
AGF Aarhus,2372,11,4,6,12,17,39,-22,18
Brondby,2373,1,22,6,2,75,30,45,72
FC Midtjylla,2373,2,20,4,6,69,38,31,64
FC Nords,2373,3,14,6,10,73,54,19,48
Copenhagen,2373,4,14,6,10,55,40,15,48
AaB,2373,5,7,12,11,37,49,-12,33
Sonderjyske,2373,6,8,6,10,28,29,-1,30
AC Horsens,2373,7,5,14,11,29,53,-24,29
Lyngby,2373,8,4,9,11,29,44,-15,21
Silkeborg IF,2373,9,6,3,13,26,44,-18,21
Randers FC,2373,10,5,6,13,23,42,-19,21
AGF Aarhus,2373,11,4,6,12,16,37,-21,18
FC Midtjylla,2374,1,21,5,4,68,36,32,68
Brondby,2374,2,20,6,4,70,38,32,66
FC Nords,2374,3,14,7,9,71,50,21,49
Copenhagen,2374,4,14,4,12,60,46,14,46
AaB,2374,5,7,12,11,39,44,-5,33
AC Horsens,2374,6,7,12,11,33,53,-20,33
Sonderjyske,2374,7,8,6,10,28,29,-1,30
Randers FC,2374,8,5,7,12,24,40,-16,22
AGF Aarhus,2374,9,5,6,11,18,36,-18,21
Lyngby,2374,10,3,10,11,27,45,-18,19
Silkeborg IF,2374,11,5,3,14,25,46,-21,18
Brondby,2375,1,21,6,3,69,32,37,69
FC Midtjylla,2375,2,20,4,6,71,38,33,64
Copenhagen,2375,3,15,4,11,58,45,13,49
FC Nords,2375,4,14,6,10,73,52,21,48
AC Horsens,2375,5,8,12,10,37,55,-18,36
Sonderjyske,2375,6,8,6,10,28,29,-1,30
AaB,2375,7,6,12,12,39,51,-12,30
Lyngby,2375,8,4,9,11,28,44,-16,21
Randers FC,2375,9,5,6,13,23,41,-18,21
Silkeborg IF,2375,10,5,4,13,25,44,-19,19
AGF Aarhus,2375,11,4,7,11,16,36,-20,19
Brondby,2376,1,22,5,3,75,30,45,71
FC Midtjylla,2376,2,19,7,4,64,37,27,64
FC Nords,2376,3,15,7,8,75,51,24,52
Copenhagen,2376,4,13,5,12,54,46,8,44
AaB,2376,5,6,13,11,35,45,-10,31
AC Horsens,2376,6,6,13,11,31,51,-20,31
Sonderjyske,2376,7,8,6,10,28,29,-1,30
Lyngby,2376,8,4,9,11,30,44,-14,21
Randers FC,2376,9,5,6,13,23,43,-20,21
Silkeborg IF,2376,10,5,4,13,26,45,-19,19
AGF Aarhus,2376,11,4,7,11,17,37,-20,19
Brondby,2377,1,21,5,4,75,36,39,68
FC Midtjylla,2377,2,21,4,5,69,39,30,67
FC Nords,2377,3,16,6,8,75,50,25,54
Copenhagen,2377,4,13,4,13,58,47,11,43
AaB,2377,5,7,12,11,36,45,-9,33
AC Horsens,2377,6,6,13,11,33,55,-22,31
Sonderjyske,2377,7,8,6,10,28,29,-1,30
Lyngby,2377,8,4,9,11,29,45,-16,21
Randers FC,2377,9,5,6,13,24,42,-18,21
Silkeborg IF,2377,10,5,4,13,25,44,-19,19
AGF Aarhus,2377,11,4,7,11,16,36,-20,19
Brondby,2378,1,20,6,4,69,32,37,66
FC Midtjylla,2378,2,19,4,7,62,41,21,61
FC Nords,2378,3,14,7,9,73,52,21,49
Copenhagen,2378,4,15,4,11,59,43,16,49
AaB,2378,5,8,13,9,37,39,-2,37
AC Horsens,2378,6,6,14,10,35,54,-19,32
Sonderjyske,2378,7,8,6,10,28,29,-1,30
Lyngby,2378,8,4,9,11,27,44,-17,21
Randers FC,2378,9,5,6,13,23,40,-17,21
AGF Aarhus,2378,10,5,6,11,17,36,-19,21
Silkeborg IF,2378,11,5,3,14,25,45,-20,18
Brondby,2379,1,20,6,4,69,36,33,66
FC Midtjylla,2379,2,19,5,6,65,40,25,62
Copenhagen,2379,3,15,6,9,64,45,19,51
FC Nords,2379,4,14,6,10,75,53,22,48
AaB,2379,5,8,12,10,35,40,-5,36
Sonderjyske,2379,6,8,6,10,28,29,-1,30
AC Horsens,2379,7,5,15,10,35,55,-20,30
Lyngby,2379,8,4,9,11,28,45,-17,21
Randers FC,2379,9,5,6,13,24,41,-17,21
Silkeborg IF,2379,10,6,3,13,27,45,-18,21
AGF Aarhus,2379,11,4,6,12,17,38,-21,18
Brondby,2380,1,21,7,2,76,31,45,70
FC Midtjylla,2380,2,20,6,4,71,39,32,66
FC Nords,2380,3,14,7,9,74,53,21,49
Copenhagen,2380,4,12,6,12,57,52,5,42
AaB,2380,5,8,11,11,39,48,-9,35
AC Horsens,2380,6,6,13,11,36,56,-20,31
Sonderjyske,2380,7,8,6,10,28,29,-1,30
Lyngby,2380,8,4,9,11,28,45,-17,21
Randers FC,2380,9,5,6,13,24,41,-17,21
Silkeborg IF,2380,10,6,3,13,26,44,-18,21
AGF Aarhus,2380,11,4,6,12,16,37,-21,18
Brondby,2381,1,19,7,4,69,35,34,64
FC Midtjylla,2381,2,19,5,6,67,40,27,62
FC Nords,2381,3,13,9,8,68,47,21,48
Copenhagen,2381,4,14,6,10,56,41,15,48
AaB,2381,5,11,11,8,43,40,3,44
Sonderjyske,2381,6,8,6,10,28,29,-1,30
AC Horsens,2381,7,5,12,13,33,59,-26,27
Lyngby,2381,8,4,9,11,29,45,-16,21
Randers FC,2381,9,5,6,13,24,42,-18,21
Silkeborg IF,2381,10,5,4,13,26,45,-19,19
AGF Aarhus,2381,11,4,7,11,17,37,-20,19
Brondby,2382,1,21,7,2,74,31,43,70
FC Midtjylla,2382,2,19,4,7,64,44,20,61
FC Nords,2382,3,15,7,8,79,53,26,52
Copenhagen,2382,4,12,4,14,55,49,6,40
AaB,2382,5,9,11,10,43,44,-1,38
AC Horsens,2382,6,7,13,10,36,56,-20,34
Sonderjyske,2382,7,8,6,10,28,29,-1,30
Lyngby,2382,8,4,9,11,29,44,-15,21
Silkeborg IF,2382,9,6,3,13,27,45,-18,21
Randers FC,2382,10,5,6,13,23,42,-19,21
AGF Aarhus,2382,11,4,6,12,17,38,-21,18
Brondby,2383,1,21,6,3,71,33,38,69
FC Midtjylla,2383,2,18,5,7,63,39,24,59
FC Nords,2383,3,15,6,9,76,52,24,51
Copenhagen,2383,4,14,6,10,57,42,15,48
AaB,2383,5,9,11,10,37,40,-3,38
Sonderjyske,2383,6,8,6,10,28,29,-1,30
AC Horsens,2383,7,6,12,12,31,55,-24,30
Randers FC,2383,8,5,7,12,24,40,-16,22
Silkeborg IF,2383,9,6,3,13,29,45,-16,21
Lyngby,2383,10,3,10,11,27,45,-18,19
AGF Aarhus,2383,11,4,6,12,17,40,-23,18
Brondby,2384,1,22,5,3,76,34,42,71
FC Midtjylla,2384,2,21,4,5,71,41,30,67
FC Nords,2384,3,14,7,9,74,48,26,49
Copenhagen,2384,4,13,5,12,56,49,7,44
AaB,2384,5,8,12,10,36,40,-4,36
Sonderjyske,2384,6,8,6,10,28,29,-1,30
AC Horsens,2384,7,5,13,12,32,59,-27,28
Randers FC,2384,8,6,6,12,26,40,-14,24
Silkeborg IF,2384,9,5,4,13,26,45,-19,19
AGF Aarhus,2384,10,4,7,11,17,37,-20,19
Lyngby,2384,11,3,9,12,27,47,-20,18
Brondby,2385,1,20,7,3,73,35,38,67
FC Midtjylla,2385,2,20,5,5,63,37,26,65
Copenhagen,2385,3,15,4,11,63,48,15,49
FC Nords,2385,4,14,6,10,77,55,22,48
AaB,2385,5,7,12,11,37,41,-4,33
AC Horsens,2385,6,7,12,11,35,58,-23,33
Sonderjyske,2385,7,8,6,10,28,29,-1,30
Randers FC,2385,8,6,6,12,26,41,-15,24
Silkeborg IF,2385,9,5,4,13,26,45,-19,19
AGF Aarhus,2385,10,4,7,11,17,37,-20,19
Lyngby,2385,11,3,9,12,28,47,-19,18
Brondby,2386,1,20,6,4,70,31,39,66
FC Midtjylla,2386,2,18,5,7,66,45,21,59
FC Nords,2386,3,17,6,7,75,46,29,57
Copenhagen,2386,4,13,5,12,56,45,11,44
AaB,2386,5,8,12,10,36,46,-10,36
AC Horsens,2386,6,7,12,11,37,53,-16,33
Sonderjyske,2386,7,8,6,10,28,29,-1,30
Randers FC,2386,8,5,7,12,25,41,-16,22
AGF Aarhus,2386,9,5,6,11,21,38,-17,21
Lyngby,2386,10,3,10,11,28,46,-18,19
Silkeborg IF,2386,11,5,3,14,27,49,-22,18
Brondby,2387,1,20,7,3,73,30,43,67
FC Midtjylla,2387,2,19,5,6,63,38,25,62
Copenhagen,2387,3,15,5,10,60,46,14,50
FC Nords,2387,4,13,6,11,72,58,14,45
AaB,2387,5,9,12,9,38,40,-2,39
AC Horsens,2387,6,6,13,11,34,54,-20,31
Sonderjyske,2387,7,8,6,10,28,29,-1,30
Lyngby,2387,8,4,9,11,27,44,-17,21
Randers FC,2387,9,5,6,13,23,40,-17,21
Silkeborg IF,2387,10,5,4,13,26,45,-19,19
AGF Aarhus,2387,11,4,7,11,17,37,-20,19
Brondby,2388,1,21,5,4,72,36,36,68
FC Midtjylla,2388,2,20,4,6,66,39,27,64
Copenhagen,2388,3,15,5,10,62,43,19,50
FC Nords,2388,4,13,6,11,71,57,14,45
AaB,2388,5,8,11,11,35,44,-9,35
AC Horsens,2388,6,7,13,10,38,51,-13,34
Sonderjyske,2388,7,8,6,10,28,29,-1,30
Lyngby,2388,8,4,9,11,30,44,-14,21
AGF Aarhus,2388,9,5,6,11,18,37,-19,21
Randers FC,2388,10,5,6,13,23,43,-20,21
Silkeborg IF,2388,11,5,3,14,26,46,-20,18
Brondby,2389,1,22,5,3,72,28,44,71
FC Midtjylla,2389,2,19,4,7,61,40,21,61
Copenhagen,2389,3,17,4,9,64,43,21,55
FC Nords,2389,4,14,6,10,74,55,19,48
AaB,2389,5,7,11,12,38,50,-12,32
Sonderjyske,2389,6,8,6,10,28,29,-1,30
AC Horsens,2389,7,6,12,12,31,50,-19,30
Randers FC,2389,8,5,7,12,25,41,-16,22
AGF Aarhus,2389,9,5,6,11,17,36,-19,21
Lyngby,2389,10,3,10,11,28,46,-18,19
Silkeborg IF,2389,11,5,3,14,25,45,-20,18
Brondby,2390,1,21,6,3,73,33,40,69
FC Midtjylla,2390,2,18,6,6,65,40,25,60
FC Nords,2390,3,15,6,9,75,48,27,51
Copenhagen,2390,4,13,6,11,55,49,6,45
AC Horsens,2390,5,8,12,10,37,48,-11,36
AaB,2390,6,7,12,11,33,46,-13,33
Sonderjyske,2390,7,8,6,10,28,29,-1,30
Randers FC,2390,8,5,7,12,24,40,-16,22
AGF Aarhus,2390,9,5,6,11,19,38,-19,21
Lyngby,2390,10,3,10,11,27,45,-18,19
Silkeborg IF,2390,11,5,3,14,27,47,-20,18
Brondby,2391,1,22,5,3,72,32,40,71
FC Midtjylla,2391,2,21,4,5,70,39,31,67
FC Nords,2391,3,15,6,9,72,47,25,51
Copenhagen,2391,4,13,4,13,57,50,7,43
AaB,2391,5,8,11,11,39,45,-6,35
Sonderjyske,2391,6,8,6,10,28,29,-1,30
AC Horsens,2391,7,6,12,12,33,56,-23,30
Randers FC,2391,8,6,6,12,24,39,-15,24
Silkeborg IF,2391,9,6,3,13,27,45,-18,21
Lyngby,2391,10,3,9,12,26,45,-19,18
AGF Aarhus,2391,11,4,6,12,17,38,-21,18
FC Midtjylla,2392,1,20,5,5,68,38,30,65
Brondby,2392,2,19,5,6,65,39,26,62
FC Nords,2392,3,16,7,7,81,48,33,55
Copenhagen,2392,4,15,5,10,58,42,16,50
AaB,2392,5,6,13,11,33,47,-14,31
AC Horsens,2392,6,6,13,11,35,52,-17,31
Sonderjyske,2392,7,8,6,10,28,29,-1,30
Randers FC,2392,8,5,7,12,24,40,-16,22
Silkeborg IF,2392,9,6,3,13,27,44,-17,21
Lyngby,2392,10,3,10,11,27,45,-18,19
AGF Aarhus,2392,11,4,6,12,16,38,-22,18
Brondby,2393,1,21,6,3,67,30,37,69
FC Midtjylla,2393,2,21,5,4,65,34,31,68
FC Nords,2393,3,15,6,9,79,54,25,51
Copenhagen,2393,4,14,4,12,57,48,9,46
AaB,2393,5,7,11,12,35,44,-9,32
Sonderjyske,2393,6,8,6,10,28,29,-1,30
AC Horsens,2393,7,6,12,12,36,55,-19,30
Silkeborg IF,2393,8,6,3,13,28,45,-17,21
Lyngby,2393,9,4,9,11,27,44,-17,21
Randers FC,2393,10,5,6,13,23,40,-17,21
AGF Aarhus,2393,11,4,6,12,17,39,-22,18
Brondby,2394,1,21,5,4,70,37,33,68
FC Midtjylla,2394,2,20,4,6,70,37,33,64
FC Nords,2394,3,13,7,10,71,52,19,46
Copenhagen,2394,4,14,4,12,59,49,10,46
AC Horsens,2394,5,8,13,9,38,53,-15,37
AaB,2394,6,8,11,11,37,43,-6,35
Sonderjyske,2394,7,8,6,10,28,29,-1,30
Lyngby,2394,8,4,9,11,28,44,-16,21
Silkeborg IF,2394,9,6,3,13,27,44,-17,21
Randers FC,2394,10,5,6,13,23,41,-18,21
AGF Aarhus,2394,11,4,6,12,16,38,-22,18
Brondby,2395,1,19,8,3,68,33,35,65
FC Midtjylla,2395,2,17,4,9,61,46,15,55
Copenhagen,2395,3,15,6,9,62,42,20,51
FC Nords,2395,4,14,7,9,67,49,18,49
AaB,2395,5,8,14,8,43,42,1,38
AC Horsens,2395,6,7,13,10,38,53,-15,34
Sonderjyske,2395,7,8,6,10,28,29,-1,30
Lyngby,2395,8,4,9,11,30,44,-14,21
Silkeborg IF,2395,9,6,3,13,26,44,-18,21
Randers FC,2395,10,5,6,13,23,43,-20,21
AGF Aarhus,2395,11,4,6,12,16,37,-21,18
FC Midtjylla,2396,1,20,5,5,66,40,26,65
Brondby,2396,2,19,5,6,65,35,30,62
FC Nords,2396,3,13,6,11,69,52,17,45
Copenhagen,2396,4,13,5,12,61,49,12,44
AaB,2396,5,10,12,8,41,39,2,42
AC Horsens,2396,6,7,15,8,35,48,-13,36
Sonderjyske,2396,7,8,6,10,28,29,-1,30
Randers FC,2396,8,6,6,12,25,39,-14,24
Silkeborg IF,2396,9,5,4,13,26,45,-19,19
AGF Aarhus,2396,10,4,7,11,17,37,-20,19
Lyngby,2396,11,3,9,12,26,46,-20,18
Brondby,2397,1,21,6,3,71,32,39,69
FC Midtjylla,2397,2,21,4,5,75,40,35,67
FC Nords,2397,3,15,6,9,75,51,24,51
Copenhagen,2397,4,14,4,12,56,47,9,46
AaB,2397,5,7,12,11,34,46,-12,33
Sonderjyske,2397,6,8,6,10,28,29,-1,30
AC Horsens,2397,7,5,14,11,35,56,-21,29
Randers FC,2397,8,6,6,12,26,39,-13,24
Silkeborg IF,2397,9,6,3,13,26,44,-18,21
Lyngby,2397,10,3,9,12,26,47,-21,18
AGF Aarhus,2397,11,4,6,12,16,37,-21,18
Brondby,2398,1,22,6,2,73,30,43,72
FC Midtjylla,2398,2,19,5,6,64,39,25,62
FC Nords,2398,3,16,6,8,75,47,28,54
Copenhagen,2398,4,12,6,12,54,45,9,42
AaB,2398,5,8,11,11,35,47,-12,35
Sonderjyske,2398,6,8,6,10,28,29,-1,30
AC Horsens,2398,7,6,12,12,31,50,-19,30
Lyngby,2398,8,4,9,11,29,46,-17,21
Randers FC,2398,9,5,6,13,25,42,-17,21
Silkeborg IF,2398,10,6,3,13,27,45,-18,21
AGF Aarhus,2398,11,4,6,12,17,38,-21,18
Brondby,2399,1,23,5,2,73,28,45,74
FC Midtjylla,2399,2,21,4,5,71,40,31,67
FC Nords,2399,3,13,7,10,72,56,16,46
Copenhagen,2399,4,13,5,12,56,50,6,44
AaB,2399,5,7,12,11,41,47,-6,33
Sonderjyske,2399,6,8,6,10,28,29,-1,30
AC Horsens,2399,7,5,15,10,33,51,-18,30
Randers FC,2399,8,5,7,12,23,39,-16,22
AGF Aarhus,2399,9,5,6,11,17,36,-19,21
Lyngby,2399,10,3,10,11,26,44,-18,19
Silkeborg IF,2399,11,5,3,14,25,45,-20,18
Brondby,2400,1,19,9,2,68,32,36,66
FC Midtjylla,2400,2,17,7,6,58,36,22,58
FC Nords,2400,3,15,8,7,77,50,27,53
Copenhagen,2400,4,12,6,12,54,46,8,42
AC Horsens,2400,5,8,13,9,36,51,-15,37
AaB,2400,6,7,13,10,36,40,-4,34
Sonderjyske,2400,7,8,6,10,28,29,-1,30
Lyngby,2400,8,4,9,11,29,44,-15,21
Silkeborg IF,2400,9,6,3,13,26,44,-18,21
Randers FC,2400,10,5,6,13,23,42,-19,21
AGF Aarhus,2400,11,4,6,12,16,37,-21,18
Brondby,2401,1,23,5,2,71,29,42,74
FC Midtjylla,2401,2,20,5,5,66,41,25,65
FC Nords,2401,3,14,6,10,72,53,19,48
Copenhagen,2401,4,12,6,12,57,47,10,42
AaB,2401,5,7,12,11,36,41,-5,33
AC Horsens,2401,6,6,14,10,38,55,-17,32
Sonderjyske,2401,7,8,6,10,28,29,-1,30
Lyngby,2401,8,4,9,11,28,45,-17,21
Randers FC,2401,9,5,6,13,24,41,-17,21
Silkeborg IF,2401,10,6,3,13,27,45,-18,21
AGF Aarhus,2401,11,4,6,12,17,38,-21,18
Brondby,2402,1,21,6,3,69,31,38,69
FC Midtjylla,2402,2,19,4,7,62,42,20,61
FC Nords,2402,3,15,6,9,73,50,23,51
Copenhagen,2402,4,14,5,11,58,43,15,47
AC Horsens,2402,5,7,13,10,34,49,-15,34
AaB,2402,6,6,14,10,33,40,-7,32
Sonderjyske,2402,7,8,6,10,28,29,-1,30
Randers FC,2402,8,6,6,12,27,42,-15,24
AGF Aarhus,2402,9,5,6,11,17,36,-19,21
Lyngby,2402,10,3,9,12,29,48,-19,18
Silkeborg IF,2402,11,5,3,14,25,45,-20,18
Brondby,2403,1,21,7,2,71,30,41,70
FC Midtjylla,2403,2,19,6,5,65,38,27,63
FC Nords,2403,3,13,8,9,76,55,21,47
Copenhagen,2403,4,13,6,11,59,47,12,45
AaB,2403,5,8,11,11,37,44,-7,35
AC Horsens,2403,6,6,14,10,32,52,-20,32
Sonderjyske,2403,7,8,6,10,28,29,-1,30
Lyngby,2403,8,4,9,11,28,45,-17,21
Randers FC,2403,9,5,6,13,24,41,-17,21
Silkeborg IF,2403,10,6,3,13,27,45,-18,21
AGF Aarhus,2403,11,4,6,12,17,38,-21,18
Brondby,2404,1,19,7,4,68,35,33,64
FC Midtjylla,2404,2,19,6,5,68,40,28,63
Copenhagen,2404,3,14,6,10,59,43,16,48
FC Nords,2404,4,13,8,9,71,55,16,47
AC Horsens,2404,5,8,13,9,41,52,-11,37
AaB,2404,6,7,12,11,38,46,-8,33
Sonderjyske,2404,7,8,6,10,28,29,-1,30
Lyngby,2404,8,4,9,11,29,44,-15,21
Randers FC,2404,9,5,6,13,23,42,-19,21
AGF Aarhus,2404,10,5,6,11,19,38,-19,21
Silkeborg IF,2404,11,5,3,14,27,47,-20,18
Brondby,2405,1,21,6,3,76,33,43,69
FC Midtjylla,2405,2,21,4,5,68,40,28,67
Copenhagen,2405,3,13,7,10,56,43,13,46
FC Nords,2405,4,13,6,11,72,61,11,45
AC Horsens,2405,5,8,13,9,38,48,-10,37
Sonderjyske,2405,6,8,6,10,28,29,-1,30
AaB,2405,7,6,12,12,35,46,-11,30
Silkeborg IF,2405,8,6,3,13,30,44,-14,21
Lyngby,2405,9,4,9,11,29,46,-17,21
Randers FC,2405,10,5,6,13,25,42,-17,21
AGF Aarhus,2405,11,4,6,12,16,41,-25,18
Brondby,2406,1,21,5,4,69,31,38,68
FC Midtjylla,2406,2,19,5,6,62,39,23,62
Copenhagen,2406,3,16,4,10,63,45,18,52
FC Nords,2406,4,15,6,9,75,53,22,51
AaB,2406,5,8,12,10,38,42,-4,36
Sonderjyske,2406,6,8,6,10,28,29,-1,30
AC Horsens,2406,7,5,12,13,29,52,-23,27
Randers FC,2406,8,6,6,12,27,40,-13,24
Silkeborg IF,2406,9,6,3,13,27,45,-18,21
Lyngby,2406,10,3,9,12,27,48,-21,18
AGF Aarhus,2406,11,4,6,12,17,38,-21,18
Brondby,2407,1,21,7,2,73,31,42,70
FC Midtjylla,2407,2,19,5,6,62,40,22,62
FC Nords,2407,3,15,8,7,76,47,29,53
Copenhagen,2407,4,13,5,12,56,49,7,44
AC Horsens,2407,5,7,14,9,38,52,-14,35
Sonderjyske,2407,6,8,6,10,28,29,-1,30
AaB,2407,7,6,11,13,35,47,-12,29
Lyngby,2407,8,4,9,11,27,44,-17,21
Randers FC,2407,9,5,6,13,23,40,-17,21
AGF Aarhus,2407,10,5,6,11,18,37,-19,21
Silkeborg IF,2407,11,5,3,14,26,46,-20,18
Brondby,2408,1,21,5,4,76,34,42,68
FC Midtjylla,2408,2,21,5,4,65,36,29,68
FC Nords,2408,3,13,7,10,76,59,17,46
Copenhagen,2408,4,14,4,12,56,47,9,46
AaB,2408,5,8,12,10,39,43,-4,36
AC Horsens,2408,6,6,13,11,36,55,-19,31
Sonderjyske,2408,7,8,6,10,28,29,-1,30
Lyngby,2408,8,4,9,11,28,45,-17,21
Randers FC,2408,9,5,6,13,24,41,-17,21
AGF Aarhus,2408,10,5,6,11,19,37,-18,21
Silkeborg IF,2408,11,5,3,14,26,47,-21,18
Brondby,2409,1,19,9,2,67,31,36,66
FC Midtjylla,2409,2,18,7,5,66,41,25,61
FC Nords,2409,3,15,8,7,79,47,32,53
Copenhagen,2409,4,15,5,10,62,48,14,50
AaB,2409,5,7,11,12,37,46,-9,32
Sonderjyske,2409,6,8,6,10,28,29,-1,30
AC Horsens,2409,7,5,14,11,33,57,-24,29
Randers FC,2409,8,6,6,12,26,40,-14,24
Silkeborg IF,2409,9,5,4,13,25,44,-19,19
AGF Aarhus,2409,10,4,7,11,16,36,-20,19
Lyngby,2409,11,3,9,12,27,47,-20,18
Brondby,2410,1,21,7,2,77,32,45,70
FC Midtjylla,2410,2,18,6,6,67,45,22,60
FC Nords,2410,3,14,9,7,71,48,23,51
Copenhagen,2410,4,14,5,11,57,44,13,47
AaB,2410,5,7,12,11,37,45,-8,33
AC Horsens,2410,6,6,13,11,32,53,-21,31
Sonderjyske,2410,7,8,6,10,28,29,-1,30
Lyngby,2410,8,4,9,11,28,44,-16,21
Silkeborg IF,2410,9,6,3,13,26,44,-18,21
Randers FC,2410,10,5,6,13,23,41,-18,21
AGF Aarhus,2410,11,4,6,12,16,37,-21,18
Brondby,2411,1,21,7,2,72,31,41,70
FC Midtjylla,2411,2,19,6,5,65,41,24,63
Copenhagen,2411,3,15,5,10,60,41,19,50
FC Nords,2411,4,14,7,9,80,57,23,49
AC Horsens,2411,5,6,14,10,36,55,-19,32
Sonderjyske,2411,6,8,6,10,28,29,-1,30
AaB,2411,7,6,11,13,33,47,-14,29
Lyngby,2411,8,4,9,11,30,45,-15,21
Silkeborg IF,2411,9,6,3,13,26,44,-18,21
Randers FC,2411,10,5,6,13,24,43,-19,21
AGF Aarhus,2411,11,4,6,12,16,37,-21,18
Brondby,2412,1,22,6,2,75,30,45,72
FC Midtjylla,2412,2,19,6,5,65,38,27,63
FC Nords,2412,3,15,6,9,75,53,22,51
Copenhagen,2412,4,13,6,11,55,43,12,45
AC Horsens,2412,5,6,14,10,31,50,-19,32
Sonderjyske,2412,6,8,6,10,28,29,-1,30
AaB,2412,7,6,12,12,32,45,-13,30
Lyngby,2412,8,4,9,11,28,44,-16,21
Randers FC,2412,9,5,6,13,23,41,-18,21
Silkeborg IF,2412,10,5,4,13,27,46,-19,19
AGF Aarhus,2412,11,4,7,11,18,38,-20,19
Brondby,2413,1,20,7,3,68,31,37,67
FC Midtjylla,2413,2,19,5,6,67,40,27,62
FC Nords,2413,3,15,6,9,78,52,26,51
Copenhagen,2413,4,13,4,13,57,48,9,43
AaB,2413,5,8,13,9,41,44,-3,37
AC Horsens,2413,6,7,13,10,36,58,-22,34
Sonderjyske,2413,7,8,6,10,28,29,-1,30
Lyngby,2413,8,4,9,11,27,44,-17,21
Randers FC,2413,9,5,6,13,23,40,-17,21
Silkeborg IF,2413,10,5,4,13,25,44,-19,19
AGF Aarhus,2413,11,4,7,11,16,36,-20,19
Brondby,2414,1,20,7,3,69,31,38,67
FC Midtjylla,2414,2,19,6,5,60,34,26,63
FC Nords,2414,3,14,9,7,70,47,23,51
Copenhagen,2414,4,13,5,12,55,45,10,44
AaB,2414,5,7,13,10,34,41,-7,34
AC Horsens,2414,6,5,16,9,33,49,-16,31
Sonderjyske,2414,7,8,6,10,28,29,-1,30
Randers FC,2414,8,6,6,12,27,40,-13,24
Silkeborg IF,2414,9,6,3,13,29,44,-15,21
Lyngby,2414,10,3,9,12,27,48,-21,18
AGF Aarhus,2414,11,4,6,12,16,40,-24,18
Brondby,2415,1,22,5,3,72,29,43,71
FC Midtjylla,2415,2,20,5,5,64,36,28,65
FC Nords,2415,3,15,7,8,75,53,22,52
Copenhagen,2415,4,14,4,12,55,45,10,46
AaB,2415,5,7,13,10,39,43,-4,34
Sonderjyske,2415,6,8,6,10,28,29,-1,30
AC Horsens,2415,7,5,12,13,31,56,-25,27
Lyngby,2415,8,4,9,11,30,44,-14,21
Silkeborg IF,2415,9,6,3,13,26,44,-18,21
Randers FC,2415,10,5,6,13,23,43,-20,21
AGF Aarhus,2415,11,4,6,12,16,37,-21,18
Brondby,2416,1,20,7,3,72,36,36,67
FC Midtjylla,2416,2,19,6,5,67,37,30,63
Copenhagen,2416,3,15,4,11,57,43,14,49
FC Nords,2416,4,14,6,10,71,54,17,48
AaB,2416,5,8,12,10,37,41,-4,36
AC Horsens,2416,6,6,13,11,41,60,-19,31
Sonderjyske,2416,7,8,6,10,28,29,-1,30
Randers FC,2416,8,5,7,12,26,42,-16,22
Lyngby,2416,9,3,10,11,29,47,-18,19
Silkeborg IF,2416,10,5,4,13,26,45,-19,19
AGF Aarhus,2416,11,4,7,11,17,37,-20,19
Brondby,2417,1,22,6,2,70,30,40,72
FC Midtjylla,2417,2,19,6,5,64,35,29,63
FC Nords,2417,3,15,6,9,73,52,21,51
Copenhagen,2417,4,13,4,13,54,49,5,43
AaB,2417,5,7,12,11,36,41,-5,33
AC Horsens,2417,6,7,12,11,35,51,-16,33
Sonderjyske,2417,7,8,6,10,28,29,-1,30
Randers FC,2417,8,6,6,12,24,39,-15,24
Silkeborg IF,2417,9,5,4,13,26,45,-19,19
AGF Aarhus,2417,10,4,7,11,17,37,-20,19
Lyngby,2417,11,3,9,12,26,45,-19,18
Brondby,2418,1,22,6,2,71,31,40,72
FC Midtjylla,2418,2,20,5,5,66,39,27,65
Copenhagen,2418,3,14,6,10,57,42,15,48
FC Nords,2418,4,13,6,11,69,54,15,45
AaB,2418,5,7,12,11,38,45,-7,33
AC Horsens,2418,6,6,13,11,38,54,-16,31
Sonderjyske,2418,7,8,6,10,28,29,-1,30
Lyngby,2418,8,4,9,11,27,44,-17,21
Randers FC,2418,9,5,6,13,23,40,-17,21
Silkeborg IF,2418,10,5,4,13,26,45,-19,19
AGF Aarhus,2418,11,4,7,11,17,37,-20,19
Brondby,2419,1,21,6,3,75,33,42,69
FC Midtjylla,2419,2,19,6,5,71,46,25,63
FC Nords,2419,3,15,7,8,75,53,22,52
Copenhagen,2419,4,13,6,11,60,46,14,45
AC Horsens,2419,5,7,12,11,39,60,-21,33
AaB,2419,6,6,13,11,39,47,-8,31
Sonderjyske,2419,7,8,6,10,28,29,-1,30
Randers FC,2419,8,6,6,12,25,40,-15,24
Silkeborg IF,2419,9,6,3,13,28,45,-17,21
Lyngby,2419,10,3,9,12,27,46,-19,18
AGF Aarhus,2419,11,4,6,12,17,39,-22,18
Brondby,2420,1,22,5,3,73,31,42,71
FC Midtjylla,2420,2,20,5,5,67,37,30,65
FC Nords,2420,3,14,7,9,71,53,18,49
Copenhagen,2420,4,14,5,11,58,45,13,47
AaB,2420,5,7,12,11,36,44,-8,33
Sonderjyske,2420,6,8,6,10,28,29,-1,30
AC Horsens,2420,7,6,12,12,32,53,-21,30
Lyngby,2420,8,4,9,11,33,44,-11,21
Randers FC,2420,9,5,6,13,23,46,-23,21
Silkeborg IF,2420,10,5,4,13,26,45,-19,19
AGF Aarhus,2420,11,4,7,11,17,37,-20,19
Brondby,2421,1,21,6,3,71,30,41,69
FC Midtjylla,2421,2,19,6,5,61,36,25,63
FC Nords,2421,3,15,6,9,81,53,28,51
Copenhagen,2421,4,14,5,11,55,46,9,47
AaB,2421,5,9,11,10,39,45,-6,38
Sonderjyske,2421,6,8,6,10,28,29,-1,30
AC Horsens,2421,7,5,12,13,32,55,-23,27
Randers FC,2421,8,5,7,12,23,39,-16,22
Lyngby,2421,9,3,10,11,26,44,-18,19
Silkeborg IF,2421,10,5,4,13,26,45,-19,19
AGF Aarhus,2421,11,4,7,11,17,37,-20,19
Brondby,2422,1,22,5,3,76,34,42,71
FC Midtjylla,2422,2,19,4,7,67,44,23,61
Copenhagen,2422,3,15,4,11,59,43,16,49
FC Nords,2422,4,13,8,9,69,52,17,47
AaB,2422,5,8,12,10,37,44,-7,36
AC Horsens,2422,6,6,13,11,36,53,-17,31
Sonderjyske,2422,7,8,6,10,28,29,-1,30
AGF Aarhus,2422,8,5,6,11,20,36,-16,21
Lyngby,2422,9,4,9,11,27,44,-17,21
Randers FC,2422,10,5,6,13,23,40,-17,21
Silkeborg IF,2422,11,5,3,14,25,48,-23,18
Brondby,2423,1,20,6,4,71,36,35,66
FC Midtjylla,2423,2,19,5,6,64,38,26,62
FC Nords,2423,3,15,7,8,78,55,23,52
Copenhagen,2423,4,14,4,12,61,49,12,46
AaB,2423,5,8,13,9,42,46,-4,37
AC Horsens,2423,6,6,13,11,34,52,-18,31
Sonderjyske,2423,7,8,6,10,28,29,-1,30
Randers FC,2423,8,5,7,12,23,39,-16,22
AGF Aarhus,2423,9,5,6,11,17,36,-19,21
Lyngby,2423,10,3,10,11,26,44,-18,19
Silkeborg IF,2423,11,5,3,14,25,45,-20,18
Brondby,2424,1,21,5,4,77,37,40,68
FC Midtjylla,2424,2,19,6,5,68,40,28,63
FC Nords,2424,3,14,8,8,74,54,20,50
Copenhagen,2424,4,15,4,11,58,43,15,49
AaB,2424,5,7,13,10,33,40,-7,34
Sonderjyske,2424,6,8,6,10,28,29,-1,30
AC Horsens,2424,7,5,14,11,33,55,-22,29
Lyngby,2424,8,4,9,11,28,45,-17,21
Silkeborg IF,2424,9,6,3,13,27,44,-17,21
Randers FC,2424,10,5,6,13,24,41,-17,21
AGF Aarhus,2424,11,4,6,12,16,38,-22,18
Brondby,2425,1,21,5,4,71,32,39,68
FC Midtjylla,2425,2,21,4,5,72,41,31,67
FC Nords,2425,3,14,7,9,74,51,23,49
Copenhagen,2425,4,14,6,10,58,45,13,48
AaB,2425,5,7,12,11,38,47,-9,33
Sonderjyske,2425,6,8,6,10,28,29,-1,30
AC Horsens,2425,7,5,14,11,33,56,-23,29
Randers FC,2425,8,6,6,12,29,40,-11,24
Silkeborg IF,2425,9,6,3,13,30,44,-14,21
Lyngby,2425,10,3,9,12,27,50,-23,18
AGF Aarhus,2425,11,4,6,12,16,41,-25,18
Brondby,2426,1,21,5,4,69,32,37,68
FC Midtjylla,2426,2,20,4,6,62,38,24,64
Copenhagen,2426,3,16,5,9,60,41,19,53
FC Nords,2426,4,14,7,9,69,50,19,49
AaB,2426,5,7,11,12,34,40,-6,32
Sonderjyske,2426,6,8,6,10,28,29,-1,30
AC Horsens,2426,7,6,12,12,33,52,-19,30
Randers FC,2426,8,5,7,12,25,41,-16,22
Silkeborg IF,2426,9,6,3,13,27,45,-18,21
Lyngby,2426,10,3,10,11,28,46,-18,19
AGF Aarhus,2426,11,4,6,12,17,38,-21,18
Brondby,2427,1,21,7,2,73,32,41,70
FC Midtjylla,2427,2,20,4,6,69,40,29,64
FC Nords,2427,3,14,7,9,74,53,21,49
Copenhagen,2427,4,13,6,11,56,49,7,45
AaB,2427,5,7,13,10,35,40,-5,34
AC Horsens,2427,6,6,13,11,33,52,-19,31
Sonderjyske,2427,7,8,6,10,28,29,-1,30
Randers FC,2427,8,6,6,12,25,40,-15,24
Silkeborg IF,2427,9,6,3,13,29,45,-16,21
Lyngby,2427,10,3,9,12,27,46,-19,18
AGF Aarhus,2427,11,4,6,12,17,40,-23,18
Brondby,2428,1,21,7,2,70,30,40,70
FC Midtjylla,2428,2,20,6,4,64,36,28,66
FC Nords,2428,3,13,7,10,77,57,20,46
Copenhagen,2428,4,12,7,11,56,45,11,43
AaB,2428,5,8,11,11,37,42,-5,35
AC Horsens,2428,6,7,12,11,35,55,-20,33
Sonderjyske,2428,7,8,6,10,28,29,-1,30
Randers FC,2428,8,5,7,12,23,39,-16,22
AGF Aarhus,2428,9,5,6,11,17,36,-19,21
Lyngby,2428,10,3,10,11,26,44,-18,19
Silkeborg IF,2428,11,5,3,14,25,45,-20,18
Brondby,2429,1,20,7,3,76,38,38,67
FC Midtjylla,2429,2,21,4,5,64,37,27,67
Copenhagen,2429,3,14,5,11,59,46,13,47
FC Nords,2429,4,13,7,10,68,50,18,46
AaB,2429,5,7,13,10,35,40,-5,34
AC Horsens,2429,6,6,14,10,34,51,-17,32
Sonderjyske,2429,7,8,6,10,28,29,-1,30
Randers FC,2429,8,6,6,12,27,40,-13,24
AGF Aarhus,2429,9,5,6,11,19,38,-19,21
Silkeborg IF,2429,10,5,3,14,27,47,-20,18
Lyngby,2429,11,3,9,12,27,48,-21,18
Brondby,2430,1,21,5,4,71,36,35,68
FC Midtjylla,2430,2,19,5,6,68,43,25,62
Copenhagen,2430,3,15,5,10,58,39,19,50
FC Nords,2430,4,14,7,9,77,55,22,49
AC Horsens,2430,5,6,15,9,37,54,-17,33
AaB,2430,6,6,13,11,37,47,-10,31
Sonderjyske,2430,7,8,6,10,28,29,-1,30
Randers FC,2430,8,6,6,12,26,41,-15,24
Silkeborg IF,2430,9,5,4,13,26,45,-19,19
AGF Aarhus,2430,10,4,7,11,17,37,-20,19
Lyngby,2430,11,3,9,12,28,47,-19,18
FC Midtjylla,2431,1,21,4,5,67,35,32,67
Brondby,2431,2,20,5,5,68,35,33,65
FC Nords,2431,3,16,6,8,78,50,28,54
Copenhagen,2431,4,14,4,12,56,44,12,46
AC Horsens,2431,5,7,12,11,34,53,-19,33
AaB,2431,6,7,11,12,38,50,-12,32
Sonderjyske,2431,7,8,6,10,28,29,-1,30
Lyngby,2431,8,4,9,11,27,44,-17,21
Randers FC,2431,9,5,6,13,23,40,-17,21
AGF Aarhus,2431,10,5,6,11,19,38,-19,21
Silkeborg IF,2431,11,5,3,14,27,47,-20,18
Brondby,2432,1,20,7,3,66,31,35,67
FC Midtjylla,2432,2,19,7,4,68,39,29,64
FC Nords,2432,3,15,8,7,78,49,29,53
Copenhagen,2432,4,13,6,11,58,46,12,45
AC Horsens,2432,5,7,13,10,39,56,-17,34
Sonderjyske,2432,6,8,6,10,28,29,-1,30
AaB,2432,7,6,11,13,36,50,-14,29
Randers FC,2432,8,6,6,12,26,39,-13,24
Silkeborg IF,2432,9,6,3,13,27,44,-17,21
Lyngby,2432,10,3,9,12,26,47,-21,18
AGF Aarhus,2432,11,4,6,12,16,38,-22,18
Brondby,2433,1,20,7,3,72,36,36,67
FC Midtjylla,2433,2,19,6,5,68,40,28,63
FC Nords,2433,3,15,8,7,80,51,29,53
Copenhagen,2433,4,12,5,13,59,52,7,41
AaB,2433,5,8,13,9,38,42,-4,37
AC Horsens,2433,6,6,13,11,34,56,-22,31
Sonderjyske,2433,7,8,6,10,28,29,-1,30
Lyngby,2433,8,4,9,11,28,44,-16,21
Randers FC,2433,9,5,6,13,23,41,-18,21
AGF Aarhus,2433,10,5,6,11,18,36,-18,21
Silkeborg IF,2433,11,5,3,14,25,46,-21,18
Brondby,2434,1,20,7,3,69,34,35,67
FC Midtjylla,2434,2,19,6,5,68,38,30,63
Copenhagen,2434,3,16,4,10,62,43,19,52
FC Nords,2434,4,13,7,10,70,56,14,46
AaB,2434,5,7,12,11,39,45,-6,33
AC Horsens,2434,6,7,12,11,35,53,-18,33
Sonderjyske,2434,7,8,6,10,28,29,-1,30
Silkeborg IF,2434,8,6,3,13,28,45,-17,21
Lyngby,2434,9,4,9,11,27,44,-17,21
Randers FC,2434,10,5,6,13,23,40,-17,21
AGF Aarhus,2434,11,4,6,12,17,39,-22,18
Brondby,2435,1,21,5,4,71,33,38,68
FC Midtjylla,2435,2,19,4,7,63,40,23,61
FC Nords,2435,3,15,7,8,76,51,25,52
Copenhagen,2435,4,15,6,9,57,39,18,51
AaB,2435,5,7,13,10,35,42,-7,34
Sonderjyske,2435,6,8,6,10,28,29,-1,30
AC Horsens,2435,7,5,13,12,32,55,-23,28
Randers FC,2435,8,6,6,12,25,40,-15,24
Silkeborg IF,2435,9,6,3,13,27,45,-18,21
Lyngby,2435,10,3,9,12,27,46,-19,18
AGF Aarhus,2435,11,4,6,12,17,38,-21,18
Brondby,2436,1,22,5,3,73,33,40,71
FC Midtjylla,2436,2,20,5,5,66,39,27,65
FC Nords,2436,3,13,8,9,75,53,22,47
Copenhagen,2436,4,13,6,11,59,48,11,45
AC Horsens,2436,5,7,13,10,40,55,-15,34
AaB,2436,6,6,13,11,34,45,-11,31
Sonderjyske,2436,7,8,6,10,28,29,-1,30
Randers FC,2436,8,6,6,12,24,39,-15,24
Silkeborg IF,2436,9,6,3,13,28,45,-17,21
Lyngby,2436,10,3,9,12,26,45,-19,18
AGF Aarhus,2436,11,4,6,12,17,39,-22,18
Brondby,2437,1,19,6,5,69,38,31,63
FC Midtjylla,2437,2,19,6,5,66,38,28,63
Copenhagen,2437,3,15,6,9,60,42,18,51
FC Nords,2437,4,12,9,9,69,51,18,45
AaB,2437,5,8,13,9,37,39,-2,37
AC Horsens,2437,6,6,14,10,34,53,-19,32
Sonderjyske,2437,7,8,6,10,28,29,-1,30
Lyngby,2437,8,4,9,11,27,44,-17,21
Randers FC,2437,9,5,6,13,23,40,-17,21
Silkeborg IF,2437,10,6,3,13,26,44,-18,21
AGF Aarhus,2437,11,4,6,12,16,37,-21,18
Brondby,2438,1,20,5,5,71,34,37,65
FC Midtjylla,2438,2,20,4,6,67,41,26,64
FC Nords,2438,3,16,6,8,77,50,27,54
Copenhagen,2438,4,15,5,10,58,43,15,50
AaB,2438,5,6,13,11,35,48,-13,31
AC Horsens,2438,6,6,13,11,34,52,-18,31
Sonderjyske,2438,7,8,6,10,28,29,-1,30
Lyngby,2438,8,4,9,11,28,45,-17,21
Silkeborg IF,2438,9,6,3,13,27,44,-17,21
Randers FC,2438,10,5,6,13,24,41,-17,21
AGF Aarhus,2438,11,4,6,12,16,38,-22,18
Brondby,2439,1,21,6,3,74,34,40,69
FC Midtjylla,2439,2,20,4,6,64,39,25,64
FC Nords,2439,3,13,8,9,76,55,21,47
Copenhagen,2439,4,13,6,11,58,48,10,45
AaB,2439,5,8,12,10,39,43,-4,36
AC Horsens,2439,6,7,12,11,35,53,-18,33
Sonderjyske,2439,7,8,6,10,28,29,-1,30
Randers FC,2439,8,5,7,12,23,39,-16,22
Silkeborg IF,2439,9,6,3,13,28,45,-17,21
Lyngby,2439,10,3,10,11,26,44,-18,19
AGF Aarhus,2439,11,4,6,12,17,39,-22,18
Brondby,2440,1,21,6,3,75,33,42,69
FC Midtjylla,2440,2,18,4,8,65,50,15,58
FC Nords,2440,3,14,7,9,74,53,21,49
Copenhagen,2440,4,14,4,12,59,47,12,46
AaB,2440,5,9,13,8,41,41,0,40
AC Horsens,2440,6,6,14,10,36,52,-16,32
Sonderjyske,2440,7,8,6,10,28,29,-1,30
Randers FC,2440,8,5,7,12,24,40,-16,22
Silkeborg IF,2440,9,6,3,13,26,44,-18,21
Lyngby,2440,10,3,10,11,27,45,-18,19
AGF Aarhus,2440,11,4,6,12,16,37,-21,18
Brondby,2441,1,22,5,3,71,32,39,71
FC Midtjylla,2441,2,20,5,5,70,40,30,65
FC Nords,2441,3,14,6,10,74,52,22,48
Copenhagen,2441,4,14,5,11,58,45,13,47
AC Horsens,2441,5,7,12,11,36,56,-20,33
AaB,2441,6,7,11,12,39,49,-10,32
Sonderjyske,2441,7,8,6,10,28,29,-1,30
Randers FC,2441,8,6,6,12,25,40,-15,24
Silkeborg IF,2441,9,5,4,13,27,46,-19,19
AGF Aarhus,2441,10,4,7,11,18,38,-20,19
Lyngby,2441,11,3,9,12,27,46,-19,18
Brondby,2442,1,20,6,4,67,29,38,66
FC Midtjylla,2442,2,19,7,4,62,35,27,64
FC Nords,2442,3,15,7,8,76,51,25,52
Copenhagen,2442,4,13,7,10,57,44,13,46
AaB,2442,5,8,12,10,38,45,-7,36
Sonderjyske,2442,6,8,6,10,28,29,-1,30
AC Horsens,2442,7,5,13,12,33,55,-22,28
Randers FC,2442,8,5,7,12,24,40,-16,22
Silkeborg IF,2442,9,6,3,13,30,46,-16,21
Lyngby,2442,10,3,10,11,27,45,-18,19
AGF Aarhus,2442,11,4,6,12,18,41,-23,18
Brondby,2443,1,23,5,2,78,34,44,74
FC Midtjylla,2443,2,19,5,6,62,38,24,62
FC Nords,2443,3,15,6,9,75,51,24,51
Copenhagen,2443,4,13,4,13,59,51,8,43
AaB,2443,5,8,12,10,40,46,-6,36
Sonderjyske,2443,6,8,6,10,28,29,-1,30
AC Horsens,2443,7,5,14,11,33,53,-20,29
Randers FC,2443,8,6,6,12,25,39,-14,24
AGF Aarhus,2443,9,5,6,11,18,36,-18,21
Lyngby,2443,10,3,9,12,26,46,-20,18
Silkeborg IF,2443,11,5,3,14,25,46,-21,18
Brondby,2444,1,22,5,3,68,30,38,71
FC Midtjylla,2444,2,18,6,6,59,38,21,60
FC Nords,2444,3,13,9,8,72,53,19,48
Copenhagen,2444,4,14,6,10,62,44,18,48
AaB,2444,5,6,15,9,37,42,-5,33
Sonderjyske,2444,6,8,6,10,28,29,-1,30
AC Horsens,2444,7,5,15,10,39,56,-17,30
Randers FC,2444,8,6,6,12,24,39,-15,24
Silkeborg IF,2444,9,5,4,13,26,45,-19,19
AGF Aarhus,2444,10,4,7,11,17,37,-20,19
Lyngby,2444,11,3,9,12,26,45,-19,18
Brondby,2445,1,21,6,3,69,31,38,69
FC Midtjylla,2445,2,18,6,6,67,44,23,60
FC Nords,2445,3,14,8,8,75,51,24,50
Copenhagen,2445,4,15,4,11,60,43,17,49
AaB,2445,5,7,12,11,37,47,-10,33
AC Horsens,2445,6,6,14,10,33,51,-18,32
Sonderjyske,2445,7,8,6,10,28,29,-1,30
Randers FC,2445,8,6,6,12,24,39,-15,24
Silkeborg IF,2445,9,5,4,13,25,44,-19,19
AGF Aarhus,2445,10,4,7,11,16,36,-20,19
Lyngby,2445,11,3,9,12,26,45,-19,18
Brondby,2446,1,20,7,3,73,34,39,67
FC Midtjylla,2446,2,17,7,6,61,41,20,58
FC Nords,2446,3,13,8,9,70,54,16,47
Copenhagen,2446,4,13,6,11,57,48,9,45
AaB,2446,5,9,12,9,39,40,-1,39
AC Horsens,2446,6,7,14,9,43,52,-9,35
Sonderjyske,2446,7,8,6,10,28,29,-1,30
Lyngby,2446,8,4,9,11,28,44,-16,21
Silkeborg IF,2446,8,6,3,13,28,44,-16,21
Randers FC,2446,10,5,6,13,23,41,-18,21
AGF Aarhus,2446,11,4,6,12,16,39,-23,18
Brondby,2447,1,20,6,4,71,35,36,66
FC Midtjylla,2447,2,19,5,6,65,41,24,62
FC Nords,2447,3,16,6,8,77,50,27,54
Copenhagen,2447,4,13,4,13,57,47,10,43
AaB,2447,5,8,12,10,39,43,-4,36
AC Horsens,2447,6,7,13,10,33,52,-19,34
Sonderjyske,2447,7,8,6,10,28,29,-1,30
Lyngby,2447,8,4,9,11,29,44,-15,21
Silkeborg IF,2447,9,6,3,13,26,44,-18,21
Randers FC,2447,10,5,6,13,23,42,-19,21
AGF Aarhus,2447,11,4,6,12,16,37,-21,18
Brondby,2448,1,23,5,2,74,29,45,74
FC Midtjylla,2448,2,21,4,5,70,39,31,67
Copenhagen,2448,3,14,5,11,61,49,12,47
FC Nords,2448,4,13,6,11,72,53,19,45
AaB,2448,5,7,13,10,36,44,-8,34
Sonderjyske,2448,6,8,6,10,28,29,-1,30
AC Horsens,2448,7,5,13,12,33,58,-25,28
Randers FC,2448,8,6,6,12,25,40,-15,24
Silkeborg IF,2448,9,6,3,13,27,44,-17,21
Lyngby,2448,10,3,9,12,27,46,-19,18
AGF Aarhus,2448,11,4,6,12,16,38,-22,18
Brondby,2449,1,21,7,2,70,31,39,70
FC Midtjylla,2449,2,17,6,7,61,40,21,57
FC Nords,2449,3,15,6,9,78,49,29,51
Copenhagen,2449,4,15,4,11,54,42,12,49
AaB,2449,5,9,11,10,39,42,-3,38
Sonderjyske,2449,6,8,6,10,28,29,-1,30
AC Horsens,2449,7,5,14,11,37,61,-24,29
Lyngby,2449,8,4,9,11,28,45,-17,21
Silkeborg IF,2449,8,6,3,13,28,45,-17,21
Randers FC,2449,10,5,6,13,24,41,-17,21
AGF Aarhus,2449,11,4,6,12,17,39,-22,18
Brondby,2450,1,22,6,2,79,33,46,72
FC Midtjylla,2450,2,20,4,6,72,42,30,64
FC Nords,2450,3,15,6,9,73,50,23,51
Copenhagen,2450,4,14,5,11,57,46,11,47
AC Horsens,2450,5,6,13,11,34,57,-23,31
Sonderjyske,2450,6,8,6,10,28,29,-1,30
AaB,2450,7,6,12,12,34,47,-13,30
Randers FC,2450,8,5,7,12,24,40,-16,22
Lyngby,2450,9,3,10,11,27,45,-18,19
Silkeborg IF,2450,10,5,4,13,25,44,-19,19
AGF Aarhus,2450,11,4,7,11,16,36,-20,19
Brondby,2451,1,21,5,4,73,34,39,68
FC Midtjylla,2451,2,20,6,4,65,34,31,66
FC Nords,2451,3,15,7,8,71,48,23,52
Copenhagen,2451,4,14,5,11,55,41,14,47
AaB,2451,5,7,12,11,37,45,-8,33
Sonderjyske,2451,6,8,6,10,28,29,-1,30
AC Horsens,2451,7,5,13,12,33,58,-25,28
Lyngby,2451,8,4,9,11,27,44,-17,21
Randers FC,2451,9,5,6,13,23,40,-17,21
AGF Aarhus,2451,10,5,6,11,18,36,-18,21
Silkeborg IF,2451,11,5,3,14,25,46,-21,18
Brondby,2452,1,21,5,4,71,32,39,68
FC Midtjylla,2452,2,20,5,5,72,37,35,65
Copenhagen,2452,3,15,5,10,62,44,18,50
FC Nords,2452,4,14,6,10,72,60,12,48
AC Horsens,2452,5,7,12,11,33,54,-21,33
AaB,2452,6,7,11,12,34,43,-9,32
Sonderjyske,2452,7,8,6,10,28,29,-1,30
Randers FC,2452,8,6,6,12,24,39,-15,24
Silkeborg IF,2452,9,6,3,13,27,45,-18,21
Lyngby,2452,10,3,9,12,26,45,-19,18
AGF Aarhus,2452,11,4,6,12,17,38,-21,18
Brondby,2453,1,21,5,4,73,34,39,68
FC Midtjylla,2453,2,20,5,5,64,35,29,65
FC Nords,2453,3,14,8,8,70,48,22,50
Copenhagen,2453,4,12,7,11,52,45,7,43
AC Horsens,2453,5,7,13,10,35,49,-14,34
AaB,2453,6,7,12,11,36,45,-9,33
Sonderjyske,2453,7,8,6,10,28,29,-1,30
Randers FC,2453,8,5,7,12,23,39,-16,22
Silkeborg IF,2453,9,6,3,13,29,45,-16,21
Lyngby,2453,10,3,10,11,26,44,-18,19
AGF Aarhus,2453,11,4,6,12,17,40,-23,18
FC Midtjylla,2454,1,21,5,4,69,37,32,68
Brondby,2454,2,19,7,4,67,33,34,64
FC Nords,2454,3,14,6,10,75,58,17,48
Copenhagen,2454,4,13,5,12,59,49,10,44
AC Horsens,2454,5,8,13,9,39,51,-12,37
AaB,2454,6,7,12,11,37,44,-7,33
Sonderjyske,2454,7,8,6,10,28,29,-1,30
Lyngby,2454,8,4,9,11,29,45,-16,21
Randers FC,2454,9,5,6,13,24,42,-18,21
Silkeborg IF,2454,10,5,4,13,26,45,-19,19
AGF Aarhus,2454,11,4,7,11,17,37,-20,19
Brondby,2455,1,21,5,4,76,35,41,68
FC Midtjylla,2455,2,20,5,5,69,40,29,65
Copenhagen,2455,3,15,4,11,60,47,13,49
FC Nords,2455,4,14,6,10,73,56,17,48
AaB,2455,5,7,12,11,38,44,-6,33
AC Horsens,2455,6,7,12,11,36,56,-20,33
Sonderjyske,2455,7,8,6,10,28,29,-1,30
Randers FC,2455,8,5,7,12,24,40,-16,22
Lyngby,2455,9,3,10,11,27,45,-18,19
Silkeborg IF,2455,10,5,4,13,26,45,-19,19
AGF Aarhus,2455,11,4,7,11,17,37,-20,19
Brondby,2456,1,20,6,4,69,32,37,66
FC Midtjylla,2456,2,19,6,5,62,37,25,63
FC Nords,2456,3,14,7,9,74,53,21,49
Copenhagen,2456,4,14,4,12,58,47,11,46
AaB,2456,5,8,13,9,36,40,-4,37
AC Horsens,2456,6,7,12,11,33,49,-16,33
Sonderjyske,2456,7,8,6,10,28,29,-1,30
Silkeborg IF,2456,8,6,3,13,29,44,-15,21
Lyngby,2456,9,4,9,11,27,44,-17,21
Randers FC,2456,10,5,6,13,23,40,-17,21
AGF Aarhus,2456,11,4,6,12,16,40,-24,18
Brondby,2457,1,22,6,2,75,29,46,72
FC Midtjylla,2457,2,19,5,6,64,38,26,62
FC Nords,2457,3,14,7,9,71,53,18,49
Copenhagen,2457,4,14,5,11,58,46,12,47
AaB,2457,5,6,16,8,35,39,-4,34
Sonderjyske,2457,6,8,6,10,28,29,-1,30
AC Horsens,2457,7,5,13,12,32,56,-24,28
Randers FC,2457,8,6,6,12,25,40,-15,24
Silkeborg IF,2457,9,6,3,13,27,45,-18,21
Lyngby,2457,10,3,9,12,27,46,-19,18
AGF Aarhus,2457,11,4,6,12,17,38,-21,18
Brondby,2458,1,22,5,3,70,28,42,71
FC Midtjylla,2458,2,21,4,5,69,34,35,67
Copenhagen,2458,3,13,5,12,55,44,11,44
FC Nords,2458,4,12,7,11,69,61,8,43
AC Horsens,2458,5,8,12,10,34,49,-15,36
AaB,2458,6,8,11,11,36,43,-7,35
Sonderjyske,2458,7,8,6,10,28,29,-1,30
Randers FC,2458,8,5,7,12,23,39,-16,22
Silkeborg IF,2458,9,6,3,13,26,44,-18,21
Lyngby,2458,10,3,10,11,26,44,-18,19
AGF Aarhus,2458,11,4,6,12,16,37,-21,18
Brondby,2459,1,21,5,4,72,34,38,68
FC Midtjylla,2459,2,18,5,7,61,41,20,59
FC Nords,2459,3,14,7,9,79,58,21,49
Copenhagen,2459,4,15,4,11,65,48,17,49
AaB,2459,5,8,12,10,39,43,-4,36
AC Horsens,2459,6,7,13,10,38,56,-18,34
Sonderjyske,2459,7,8,6,10,28,29,-1,30
Randers FC,2459,8,6,6,12,25,39,-14,24
Silkeborg IF,2459,9,6,3,13,26,44,-18,21
Lyngby,2459,10,3,9,12,26,46,-20,18
AGF Aarhus,2459,11,4,6,12,16,37,-21,18
Brondby,2460,1,21,6,3,72,34,38,69
FC Midtjylla,2460,2,18,6,6,66,44,22,60
Copenhagen,2460,3,16,5,9,64,43,21,53
FC Nords,2460,4,13,7,10,71,55,16,46
AaB,2460,5,8,11,11,37,40,-3,35
AC Horsens,2460,6,6,13,11,31,51,-20,31
Sonderjyske,2460,7,8,6,10,28,29,-1,30
Randers FC,2460,8,6,6,12,25,40,-15,24
Silkeborg IF,2460,9,5,4,13,27,46,-19,19
AGF Aarhus,2460,10,4,7,11,18,38,-20,19
Lyngby,2460,11,3,9,12,27,46,-19,18
Brondby,2461,1,21,6,3,74,31,43,69
FC Midtjylla,2461,2,19,6,5,67,41,26,63
FC Nords,2461,3,14,8,8,75,54,21,50
Copenhagen,2461,4,13,6,11,59,47,12,45
AaB,2461,5,7,13,10,39,46,-7,34
Sonderjyske,2461,6,8,6,10,28,29,-1,30
AC Horsens,2461,7,5,15,10,34,55,-21,30
Lyngby,2461,8,4,9,11,28,44,-16,21
Silkeborg IF,2461,9,6,3,13,28,45,-17,21
Randers FC,2461,10,5,6,13,23,41,-18,21
AGF Aarhus,2461,11,4,6,12,17,39,-22,18
FC Midtjylla,2462,1,21,4,5,67,37,30,67
Brondby,2462,2,20,6,4,73,32,41,66
FC Nords,2462,3,13,8,9,71,55,16,47
Copenhagen,2462,4,13,5,12,55,44,11,44
AaB,2462,5,8,12,10,36,44,-8,36
AC Horsens,2462,6,7,13,10,34,50,-16,34
Sonderjyske,2462,7,8,6,10,28,29,-1,30
Randers FC,2462,8,5,7,12,23,39,-16,22
Lyngby,2462,9,3,10,11,26,44,-18,19
Silkeborg IF,2462,10,5,4,13,26,45,-19,19
AGF Aarhus,2462,11,4,7,11,17,37,-20,19
Brondby,2463,1,22,5,3,72,32,40,71
FC Midtjylla,2463,2,20,6,4,69,37,32,66
FC Nords,2463,3,13,7,10,73,58,15,46
Copenhagen,2463,4,13,5,12,57,46,11,44
AaB,2463,5,8,12,10,40,44,-4,36
AC Horsens,2463,6,6,13,11,36,56,-20,31
Sonderjyske,2463,7,8,6,10,28,29,-1,30
Randers FC,2463,8,5,7,12,24,40,-16,22
Silkeborg IF,2463,9,6,3,13,27,44,-17,21
Lyngby,2463,10,3,10,11,27,45,-18,19
AGF Aarhus,2463,11,4,6,12,16,38,-22,18
Brondby,2464,1,22,5,3,71,30,41,71
FC Midtjylla,2464,2,18,6,6,64,43,21,60
Copenhagen,2464,3,15,4,11,59,45,14,49
FC Nords,2464,4,12,8,10,70,56,14,44
AC Horsens,2464,5,7,14,9,39,48,-9,35
AaB,2464,6,7,13,10,37,44,-7,34
Sonderjyske,2464,7,8,6,10,28,29,-1,30
Lyngby,2464,8,4,9,11,28,45,-17,21
Randers FC,2464,9,5,6,13,24,41,-17,21
Silkeborg IF,2464,10,5,4,13,27,46,-19,19
AGF Aarhus,2464,11,4,7,11,18,38,-20,19
Brondby,2465,1,21,6,3,70,32,38,69
FC Midtjylla,2465,2,20,4,6,66,37,29,64
Copenhagen,2465,3,16,5,9,61,41,20,53
FC Nords,2465,4,13,6,11,71,52,19,45
AaB,2465,5,7,12,11,34,47,-13,33
AC Horsens,2465,6,6,13,11,30,49,-19,31
Sonderjyske,2465,7,8,6,10,28,29,-1,30
Randers FC,2465,8,5,7,12,24,40,-16,22
Lyngby,2465,9,3,10,11,27,45,-18,19
Silkeborg IF,2465,10,5,4,13,26,45,-19,19
AGF Aarhus,2465,11,4,7,11,17,37,-20,19
Brondby,2466,1,18,9,3,68,36,32,63
FC Midtjylla,2466,2,18,5,7,63,42,21,59
FC Nords,2466,3,16,7,7,81,49,32,55
Copenhagen,2466,4,15,5,10,63,44,19,50
AC Horsens,2466,5,7,13,10,36,56,-20,34
AaB,2466,6,6,13,11,36,46,-10,31
Sonderjyske,2466,7,8,6,10,28,29,-1,30
Randers FC,2466,8,6,6,12,28,41,-13,24
Silkeborg IF,2466,9,6,3,13,26,44,-18,21
Lyngby,2466,10,3,9,12,28,49,-21,18
AGF Aarhus,2466,11,4,6,12,16,37,-21,18
Brondby,2467,1,22,5,3,70,32,38,71
FC Midtjylla,2467,2,20,4,6,65,38,27,64
FC Nords,2467,3,15,6,9,74,53,21,51
Copenhagen,2467,4,14,4,12,63,50,13,46
AaB,2467,5,8,11,11,37,43,-6,35
Sonderjyske,2467,6,8,6,10,28,29,-1,30
AC Horsens,2467,7,6,12,12,34,53,-19,30
Lyngby,2467,8,4,9,11,29,45,-16,21
Silkeborg IF,2467,9,6,3,13,28,44,-16,21
Randers FC,2467,10,5,6,13,24,42,-18,21
AGF Aarhus,2467,11,4,6,12,16,39,-23,18
Brondby,2468,1,21,5,4,73,36,37,68
FC Midtjylla,2468,2,20,4,6,66,40,26,64
FC Nords,2468,3,16,6,8,84,49,35,54
Copenhagen,2468,4,14,4,12,57,49,8,46
AC Horsens,2468,5,7,12,11,33,54,-21,33
AaB,2468,6,7,11,12,36,47,-11,32
Sonderjyske,2468,7,8,6,10,28,29,-1,30
Randers FC,2468,8,5,7,12,24,40,-16,22
AGF Aarhus,2468,9,5,6,11,18,36,-18,21
Lyngby,2468,10,3,10,11,27,45,-18,19
Silkeborg IF,2468,11,5,3,14,25,46,-21,18
Brondby,2469,1,20,6,4,68,37,31,66
FC Midtjylla,2469,2,20,5,5,67,39,28,65
FC Nords,2469,3,13,7,10,73,55,18,46
Copenhagen,2469,4,14,4,12,62,47,15,46
AaB,2469,5,9,13,8,39,39,0,40
AC Horsens,2469,6,6,13,11,36,54,-18,31
Sonderjyske,2469,7,8,6,10,28,29,-1,30
Lyngby,2469,8,4,9,11,29,45,-16,21
Randers FC,2469,9,5,6,13,24,42,-18,21
Silkeborg IF,2469,10,5,4,13,26,45,-19,19
AGF Aarhus,2469,11,4,7,11,17,37,-20,19
FC Midtjylla,2470,1,21,4,5,65,39,26,67
Brondby,2470,2,19,5,6,73,40,33,62
FC Nords,2470,3,15,7,8,79,52,27,52
Copenhagen,2470,4,14,4,12,59,50,9,46
AC Horsens,2470,5,8,12,10,37,52,-15,36
AaB,2470,6,7,12,11,39,45,-6,33
Sonderjyske,2470,7,8,6,10,28,29,-1,30
Randers FC,2470,8,6,6,12,24,39,-15,24
AGF Aarhus,2470,9,5,6,11,18,37,-19,21
Lyngby,2470,10,3,9,12,26,45,-19,18
Silkeborg IF,2470,11,5,3,14,26,46,-20,18
FC Midtjylla,2471,1,21,4,5,72,41,31,67
Brondby,2471,2,20,6,4,72,35,37,66
FC Nords,2471,3,15,6,9,78,55,23,51
Copenhagen,2471,4,14,6,10,60,45,15,48
AaB,2471,5,7,11,12,35,47,-12,32
AC Horsens,2471,6,6,13,11,32,52,-20,31
Sonderjyske,2471,7,8,6,10,28,29,-1,30
Randers FC,2471,8,5,7,12,23,39,-16,22
Silkeborg IF,2471,9,6,3,13,26,44,-18,21
Lyngby,2471,10,3,10,11,26,44,-18,19
AGF Aarhus,2471,11,4,6,12,16,37,-21,18
FC Midtjylla,2472,1,21,4,5,68,37,31,67
Brondby,2472,2,20,6,4,69,32,37,66
Copenhagen,2472,3,15,5,10,56,40,16,50
FC Nords,2472,4,14,7,9,72,53,19,49
AaB,2472,5,6,13,11,33,43,-10,31
AC Horsens,2472,6,6,13,11,36,55,-19,31
Sonderjyske,2472,7,8,6,10,28,29,-1,30
Lyngby,2472,8,4,9,11,28,44,-16,21
Silkeborg IF,2472,9,6,3,13,28,45,-17,21
Randers FC,2472,10,5,6,13,23,41,-18,21
AGF Aarhus,2472,11,4,6,12,17,39,-22,18
Brondby,2473,1,21,6,3,67,31,36,69
FC Midtjylla,2473,2,20,4,6,67,39,28,64
FC Nords,2473,3,15,7,8,75,51,24,52
Copenhagen,2473,4,14,5,11,59,46,13,47
AaB,2473,5,8,12,10,36,40,-4,36
Sonderjyske,2473,6,8,6,10,28,29,-1,30
AC Horsens,2473,7,5,12,13,32,55,-23,27
Randers FC,2473,8,5,7,12,23,39,-16,22
AGF Aarhus,2473,9,5,6,11,17,36,-19,21
Lyngby,2473,10,3,10,11,26,44,-18,19
Silkeborg IF,2473,11,5,3,14,25,45,-20,18
Brondby,2474,1,20,7,3,70,33,37,67
FC Midtjylla,2474,2,20,6,4,63,33,30,66
FC Nords,2474,3,14,6,10,69,52,17,48
Copenhagen,2474,4,13,6,11,58,48,10,45
AC Horsens,2474,5,8,12,10,42,54,-12,36
AaB,2474,6,6,13,11,34,42,-8,31
Sonderjyske,2474,7,8,6,10,28,29,-1,30
Randers FC,2474,8,5,7,12,24,40,-16,22
AGF Aarhus,2474,9,5,6,11,19,37,-18,21
Lyngby,2474,10,3,10,11,27,45,-18,19
Silkeborg IF,2474,11,5,3,14,26,47,-21,18
Brondby,2475,1,21,6,3,69,32,37,69
FC Midtjylla,2475,2,20,5,5,74,38,36,65
Copenhagen,2475,3,15,5,10,62,44,18,50
FC Nords,2475,4,13,7,10,72,60,12,46
AC Horsens,2475,5,7,12,11,36,54,-18,33
AaB,2475,6,7,11,12,35,46,-11,32
Sonderjyske,2475,7,8,6,10,28,29,-1,30
Randers FC,2475,8,6,6,12,26,40,-14,24
AGF Aarhus,2475,9,5,6,11,19,37,-18,21
Lyngby,2475,10,3,9,12,27,47,-20,18
Silkeborg IF,2475,11,5,3,14,26,47,-21,18
Brondby,2476,1,20,6,4,67,30,37,66
FC Midtjylla,2476,2,18,6,6,68,41,27,60
FC Nords,2476,3,15,7,8,75,51,24,52
Copenhagen,2476,4,12,8,10,60,49,11,44
AaB,2476,5,8,12,10,39,45,-6,36
AC Horsens,2476,6,6,15,9,38,57,-19,33
Sonderjyske,2476,7,8,6,10,28,29,-1,30
Randers FC,2476,8,6,6,12,26,41,-15,24
Silkeborg IF,2476,9,6,3,13,26,44,-18,21
Lyngby,2476,10,3,9,12,28,47,-19,18
AGF Aarhus,2476,11,4,6,12,16,37,-21,18
Brondby,2477,1,23,5,2,71,29,42,74
FC Midtjylla,2477,2,20,4,6,66,40,26,64
FC Nords,2477,3,14,6,10,73,49,24,48
Copenhagen,2477,4,13,6,11,60,49,11,45
AaB,2477,5,7,13,10,37,43,-6,34
Sonderjyske,2477,6,8,6,10,28,29,-1,30
AC Horsens,2477,7,5,14,11,33,56,-23,29
Randers FC,2477,8,6,6,12,25,39,-14,24
Silkeborg IF,2477,9,6,3,13,27,45,-18,21
Lyngby,2477,10,3,9,12,26,46,-20,18
AGF Aarhus,2477,11,4,6,12,17,38,-21,18
Brondby,2478,1,20,6,4,68,30,38,66
FC Midtjylla,2478,2,20,5,5,66,39,27,65
FC Nords,2478,3,15,6,9,73,52,21,51
Copenhagen,2478,4,13,6,11,54,44,10,45
AC Horsens,2478,5,7,13,10,38,53,-15,34
AaB,2478,6,7,12,11,33,40,-7,33
Sonderjyske,2478,7,8,6,10,28,29,-1,30
Lyngby,2478,8,4,9,11,29,45,-16,21
Randers FC,2478,9,5,6,13,24,42,-18,21
Silkeborg IF,2478,10,5,4,13,26,45,-19,19
AGF Aarhus,2478,11,4,7,11,17,37,-20,19
Brondby,2479,1,21,5,4,73,39,34,68
FC Midtjylla,2479,2,19,5,6,68,40,28,62
FC Nords,2479,3,17,6,7,81,48,33,57
Copenhagen,2479,4,14,4,12,56,46,10,46
AaB,2479,5,7,11,12,34,46,-12,32
AC Horsens,2479,6,6,13,11,37,56,-19,31
Sonderjyske,2479,7,8,6,10,28,29,-1,30
Lyngby,2479,8,4,9,11,27,44,-17,21
Randers FC,2479,9,5,6,13,23,40,-17,21
AGF Aarhus,2479,10,5,6,11,18,36,-18,21
Silkeborg IF,2479,11,5,3,14,25,46,-21,18
Brondby,2480,1,23,5,2,74,29,45,74
FC Midtjylla,2480,2,21,4,5,70,37,33,67
FC Nords,2480,3,14,7,9,71,50,21,49
Copenhagen,2480,4,12,4,14,52,49,3,40
AC Horsens,2480,5,7,13,10,39,56,-17,34
AaB,2480,6,7,11,12,33,44,-11,32
Sonderjyske,2480,7,8,6,10,28,29,-1,30
Randers FC,2480,8,5,7,12,24,40,-16,22
Silkeborg IF,2480,9,6,3,13,26,44,-18,21
Lyngby,2480,10,3,10,11,27,45,-18,19
AGF Aarhus,2480,11,4,6,12,16,37,-21,18
Brondby,2481,1,22,5,3,82,31,51,71
FC Midtjylla,2481,2,19,5,6,62,38,24,62
FC Nords,2481,3,13,7,10,74,57,17,46
Copenhagen,2481,4,14,4,12,54,45,9,46
AaB,2481,5,9,12,9,38,40,-2,39
AC Horsens,2481,6,6,13,11,32,57,-25,31
Sonderjyske,2481,7,8,6,10,28,29,-1,30
Randers FC,2481,8,5,7,12,24,40,-16,22
Silkeborg IF,2481,9,6,3,13,27,45,-18,21
Lyngby,2481,10,3,10,11,27,45,-18,19
AGF Aarhus,2481,11,4,6,12,17,38,-21,18
Brondby,2482,1,22,6,2,71,29,42,72
FC Midtjylla,2482,2,20,4,6,67,38,29,64
FC Nords,2482,3,14,7,9,73,55,18,49
Copenhagen,2482,4,13,5,12,56,46,10,44
AaB,2482,5,8,12,10,34,37,-3,36
Sonderjyske,2482,6,8,6,10,28,29,-1,30
AC Horsens,2482,7,6,12,12,33,55,-22,30
Randers FC,2482,8,5,7,12,25,41,-16,22
Silkeborg IF,2482,9,6,3,13,28,44,-16,21
Lyngby,2482,10,3,10,11,28,46,-18,19
AGF Aarhus,2482,11,4,6,12,16,39,-23,18
Brondby,2483,1,20,7,3,70,34,36,67
FC Midtjylla,2483,2,19,6,5,64,37,27,63
FC Nords,2483,3,15,7,8,75,48,27,52
Copenhagen,2483,4,13,7,10,56,44,12,46
AaB,2483,5,7,12,11,36,42,-6,33
AC Horsens,2483,6,6,13,11,34,56,-22,31
Sonderjyske,2483,7,8,6,10,28,29,-1,30
Randers FC,2483,8,6,6,12,27,41,-14,24
Silkeborg IF,2483,9,6,3,13,27,45,-18,21
Lyngby,2483,10,3,9,12,28,48,-20,18
AGF Aarhus,2483,11,4,6,12,17,38,-21,18
FC Midtjylla,2484,1,20,5,5,64,37,27,65
Brondby,2484,2,19,6,5,71,35,36,63
FC Nords,2484,3,15,6,9,71,50,21,51
Copenhagen,2484,4,15,6,9,59,41,18,51
AC Horsens,2484,5,7,13,10,37,51,-14,34
Sonderjyske,2484,6,8,6,10,28,29,-1,30
AaB,2484,7,6,12,12,31,45,-14,30
Lyngby,2484,8,4,9,11,28,45,-17,21
Silkeborg IF,2484,8,6,3,13,28,45,-17,21
Randers FC,2484,10,5,6,13,24,41,-17,21
AGF Aarhus,2484,11,4,6,12,17,39,-22,18
Brondby,2485,1,23,5,2,76,33,43,74
FC Midtjylla,2485,2,20,4,6,73,40,33,64
Copenhagen,2485,3,14,5,11,58,45,13,47
FC Nords,2485,4,13,6,11,71,59,12,45
AaB,2485,5,8,11,11,39,44,-5,35
AC Horsens,2485,6,6,13,11,34,56,-22,31
Sonderjyske,2485,7,8,6,10,28,29,-1,30
Silkeborg IF,2485,8,6,3,13,28,45,-17,21
Lyngby,2485,9,4,9,11,27,44,-17,21
Randers FC,2485,10,5,6,13,23,40,-17,21
AGF Aarhus,2485,11,4,6,12,17,39,-22,18
Brondby,2486,1,21,7,2,73,31,42,70
FC Midtjylla,2486,2,18,6,6,66,44,22,60
FC Nords,2486,3,14,8,8,74,52,22,50
Copenhagen,2486,4,14,5,11,61,49,12,47
AC Horsens,2486,5,7,15,8,40,52,-12,36
Sonderjyske,2486,6,8,6,10,28,29,-1,30
AaB,2486,7,6,11,13,35,47,-12,29
Randers FC,2486,8,5,7,12,26,42,-16,22
Lyngby,2486,9,3,10,11,29,47,-18,19
Silkeborg IF,2486,10,5,4,13,26,45,-19,19
AGF Aarhus,2486,11,4,7,11,17,37,-20,19
Brondby,2487,1,21,6,3,72,33,39,69
FC Midtjylla,2487,2,20,4,6,71,42,29,64
FC Nords,2487,3,14,6,10,77,57,20,48
Copenhagen,2487,4,13,5,12,56,47,9,44
AC Horsens,2487,5,8,12,10,33,49,-16,36
AaB,2487,6,8,11,11,35,42,-7,35
Sonderjyske,2487,7,8,6,10,28,29,-1,30
Randers FC,2487,8,5,7,12,24,40,-16,22
Lyngby,2487,9,3,10,11,27,45,-18,19
Silkeborg IF,2487,10,5,4,13,26,45,-19,19
AGF Aarhus,2487,11,4,7,11,17,37,-20,19
FC Midtjylla,2488,1,22,4,4,69,36,33,70
Brondby,2488,2,20,5,5,70,37,33,65
FC Nords,2488,3,15,6,9,75,55,20,51
Copenhagen,2488,4,14,5,11,60,44,16,47
AaB,2488,5,7,12,11,39,47,-8,33
Sonderjyske,2488,6,8,6,10,28,29,-1,30
AC Horsens,2488,7,6,12,12,35,55,-20,30
Randers FC,2488,8,5,7,12,23,39,-16,22
Silkeborg IF,2488,9,6,3,13,28,45,-17,21
Lyngby,2488,10,3,10,11,26,44,-18,19
AGF Aarhus,2488,11,4,6,12,17,39,-22,18
Brondby,2489,1,22,5,3,73,33,40,71
FC Midtjylla,2489,2,20,5,5,65,38,27,65
FC Nords,2489,3,14,7,9,71,50,21,49
Copenhagen,2489,4,14,5,11,56,42,14,47
AaB,2489,5,7,13,10,34,40,-6,34
Sonderjyske,2489,6,8,6,10,28,29,-1,30
AC Horsens,2489,7,5,13,12,33,55,-22,28
Randers FC,2489,8,6,6,12,25,39,-14,24
AGF Aarhus,2489,9,5,6,11,18,37,-19,21
Lyngby,2489,10,3,9,12,26,46,-20,18
Silkeborg IF,2489,10,5,3,14,26,46,-20,18
Brondby,2490,1,21,6,3,72,31,41,69
FC Midtjylla,2490,2,18,5,7,65,43,22,59
FC Nords,2490,3,15,6,9,78,51,27,51
Copenhagen,2490,4,15,4,11,58,45,13,49
AaB,2490,5,9,11,10,40,46,-6,38
Sonderjyske,2490,6,8,6,10,28,29,-1,30
AC Horsens,2490,7,6,12,12,34,57,-23,30
Randers FC,2490,8,5,7,12,24,40,-16,22
Lyngby,2490,9,3,10,11,27,45,-18,19
Silkeborg IF,2490,10,5,4,13,26,45,-19,19
AGF Aarhus,2490,11,4,7,11,17,37,-20,19
FC Midtjylla,2491,1,20,6,4,66,36,30,66
Brondby,2491,2,19,6,5,67,34,33,63
Copenhagen,2491,3,16,4,10,58,40,18,52
FC Nords,2491,4,12,8,10,69,54,15,44
AC Horsens,2491,5,7,14,9,35,48,-13,35
AaB,2491,6,7,12,11,38,47,-9,33
Sonderjyske,2491,7,8,6,10,28,29,-1,30
Randers FC,2491,8,5,7,12,23,39,-16,22
Silkeborg IF,2491,9,6,3,13,26,44,-18,21
Lyngby,2491,10,3,10,11,26,44,-18,19
AGF Aarhus,2491,11,4,6,12,16,37,-21,18
Brondby,2492,1,19,9,2,70,34,36,66
FC Midtjylla,2492,2,18,7,5,63,40,23,61
FC Nords,2492,3,14,8,8,76,52,24,50
Copenhagen,2492,4,13,6,11,58,47,11,45
AaB,2492,5,7,13,10,38,43,-5,34
AC Horsens,2492,6,7,13,10,36,51,-15,34
Sonderjyske,2492,7,8,6,10,28,29,-1,30
Randers FC,2492,8,5,7,12,23,39,-16,22
AGF Aarhus,2492,9,5,6,11,17,36,-19,21
Lyngby,2492,10,3,10,11,26,44,-18,19
Silkeborg IF,2492,11,5,3,14,25,45,-20,18
Brondby,2493,1,20,6,4,66,32,34,66
FC Midtjylla,2493,2,18,5,7,63,44,19,59
FC Nords,2493,3,17,6,7,76,44,32,57
Copenhagen,2493,4,15,5,10,61,45,16,50
AaB,2493,5,7,12,11,37,44,-7,33
Sonderjyske,2493,6,8,6,10,28,29,-1,30
AC Horsens,2493,7,5,14,11,37,57,-20,29
Lyngby,2493,8,4,9,11,28,45,-17,21
Randers FC,2493,9,5,6,13,24,41,-17,21
Silkeborg IF,2493,10,5,4,13,26,45,-19,19
AGF Aarhus,2493,11,4,7,11,17,37,-20,19
Brondby,2494,1,20,6,4,69,33,36,66
FC Midtjylla,2494,2,19,6,5,67,41,26,63
FC Nords,2494,3,13,8,9,72,53,19,47
Copenhagen,2494,4,14,5,11,60,47,13,47
AC Horsens,2494,5,7,14,9,36,50,-14,35
AaB,2494,6,7,13,10,35,41,-6,34
Sonderjyske,2494,7,8,6,10,28,29,-1,30
Randers FC,2494,8,6,6,12,26,40,-14,24
AGF Aarhus,2494,9,5,6,11,17,36,-19,21
Lyngby,2494,10,3,9,12,27,47,-20,18
Silkeborg IF,2494,11,5,3,14,25,45,-20,18
Brondby,2495,1,22,5,3,72,30,42,71
FC Midtjylla,2495,2,18,6,6,62,41,21,60
FC Nords,2495,3,14,7,9,71,50,21,49
Copenhagen,2495,4,13,5,12,52,44,8,44
AC Horsens,2495,5,7,14,9,36,49,-13,35
AaB,2495,6,7,13,10,35,40,-5,34
Sonderjyske,2495,7,8,6,10,28,29,-1,30
Lyngby,2495,8,4,9,11,29,44,-15,21
Randers FC,2495,9,5,6,13,23,42,-19,21
Silkeborg IF,2495,10,5,4,13,25,44,-19,19
AGF Aarhus,2495,11,4,7,11,16,36,-20,19
Brondby,2496,1,21,7,2,71,29,42,70
FC Midtjylla,2496,2,19,4,7,67,41,26,61
FC Nords,2496,3,14,7,9,77,60,17,49
Copenhagen,2496,4,14,6,10,61,46,15,48
AaB,2496,5,7,13,10,36,46,-10,34
AC Horsens,2496,6,6,13,11,38,54,-16,31
Sonderjyske,2496,7,8,6,10,28,29,-1,30
Randers FC,2496,8,5,7,12,24,40,-16,22
Lyngby,2496,9,3,10,11,27,45,-18,19
Silkeborg IF,2496,10,5,4,13,27,46,-19,19
AGF Aarhus,2496,11,4,7,11,18,38,-20,19
Brondby,2497,1,22,6,2,75,31,44,72
FC Midtjylla,2497,2,20,4,6,66,40,26,64
FC Nords,2497,3,14,7,9,71,52,19,49
Copenhagen,2497,4,14,5,11,55,44,11,47
AaB,2497,5,8,12,10,36,41,-5,36
Sonderjyske,2497,6,8,6,10,28,29,-1,30
AC Horsens,2497,7,5,12,13,30,51,-21,27
Lyngby,2497,8,4,9,11,28,44,-16,21
Randers FC,2497,9,5,6,13,23,41,-18,21
AGF Aarhus,2497,10,5,6,11,21,39,-18,21
Silkeborg IF,2497,11,5,3,14,28,49,-21,18
FC Midtjylla,2498,1,20,5,5,70,40,30,65
Brondby,2498,2,19,6,5,65,35,30,63
Copenhagen,2498,3,14,7,9,60,45,15,49
FC Nords,2498,4,12,9,9,71,53,18,45
AaB,2498,5,7,14,9,35,39,-4,35
AC Horsens,2498,6,6,15,9,33,48,-15,33
Sonderjyske,2498,7,8,6,10,28,29,-1,30
Lyngby,2498,8,4,9,11,30,45,-15,21
Silkeborg IF,2498,9,6,3,13,27,44,-17,21
Randers FC,2498,10,5,6,13,24,43,-19,21
AGF Aarhus,2498,11,4,6,12,16,38,-22,18
Brondby,2499,1,21,6,3,69,30,39,69
FC Midtjylla,2499,2,19,7,4,62,34,28,64
FC Nords,2499,3,13,8,9,69,49,20,47
Copenhagen,2499,4,13,6,11,54,44,10,45
AaB,2499,5,9,11,10,39,40,-1,38
Sonderjyske,2499,6,8,6,10,28,29,-1,30
AC Horsens,2499,7,6,12,12,34,56,-22,30
Lyngby,2499,8,4,9,11,29,45,-16,21
Silkeborg IF,2499,9,6,3,13,27,44,-17,21
Randers FC,2499,10,5,6,13,24,42,-18,21
AGF Aarhus,2499,11,4,6,12,16,38,-22,18
Brondby,2500,1,23,5,2,80,35,45,74
FC Midtjylla,2500,2,19,4,7,62,41,21,61
FC Nords,2500,3,14,6,10,71,56,15,48
Copenhagen,2500,4,14,4,12,56,45,11,46
AaB,2500,5,8,11,11,39,45,-6,35
AC Horsens,2500,6,7,12,11,40,52,-12,33
Sonderjyske,2500,7,8,6,10,28,29,-1,30
Silkeborg IF,2500,8,6,3,13,28,45,-17,21
Lyngby,2500,9,4,9,11,27,44,-17,21
Randers FC,2500,10,5,6,13,23,40,-17,21
AGF Aarhus,2500,11,4,6,12,17,39,-22,18
Brondby,2501,1,21,7,2,70,32,38,70
FC Midtjylla,2501,2,20,4,6,65,38,27,64
Copenhagen,2501,3,14,6,10,58,44,14,48
FC Nords,2501,4,13,8,9,73,53,20,47
AaB,2501,5,7,12,11,36,43,-7,33
AC Horsens,2501,6,6,13,11,34,52,-18,31
Sonderjyske,2501,7,8,6,10,28,29,-1,30
Lyngby,2501,8,4,9,11,28,44,-16,21
Randers FC,2501,9,5,6,13,23,41,-18,21
AGF Aarhus,2501,10,5,6,11,18,37,-19,21
Silkeborg IF,2501,11,5,3,14,26,46,-20,18
FC Midtjylla,2502,1,20,6,4,65,38,27,66
Brondby,2502,2,19,7,4,69,34,35,64
FC Nords,2502,3,14,8,8,72,51,21,50
Copenhagen,2502,4,13,5,12,54,43,11,44
AaB,2502,5,8,12,10,36,40,-4,36
AC Horsens,2502,6,5,16,9,34,50,-16,31
Sonderjyske,2502,7,8,6,10,28,29,-1,30
Randers FC,2502,8,5,7,12,25,41,-16,22
Silkeborg IF,2502,9,6,3,13,28,45,-17,21
Lyngby,2502,10,3,10,11,28,46,-18,19
AGF Aarhus,2502,11,4,6,12,17,39,-22,18
FC Midtjylla,2503,1,20,6,4,66,37,29,66
Brondby,2503,2,19,8,3,69,34,35,65
FC Nords,2503,3,14,7,9,78,54,24,49
Copenhagen,2503,4,13,7,10,54,44,10,46
AaB,2503,5,7,12,11,34,43,-9,33
AC Horsens,2503,6,6,14,10,34,49,-15,32
Sonderjyske,2503,7,8,6,10,28,29,-1,30
Randers FC,2503,8,5,7,12,25,41,-16,22
Lyngby,2503,9,3,10,11,28,46,-18,19
Silkeborg IF,2503,10,5,4,13,26,45,-19,19
AGF Aarhus,2503,11,4,7,11,17,37,-20,19
Brondby,2504,1,21,6,3,73,32,41,69
FC Midtjylla,2504,2,20,5,5,70,40,30,65
FC Nords,2504,3,14,7,9,72,52,20,49
Copenhagen,2504,4,13,7,10,56,44,12,46
AC Horsens,2504,5,7,13,10,39,52,-13,34
Sonderjyske,2504,6,8,6,10,28,29,-1,30
AaB,2504,7,6,12,12,33,49,-16,30
Randers FC,2504,8,6,6,12,24,39,-15,24
Silkeborg IF,2504,9,6,3,13,28,45,-17,21
Lyngby,2504,10,3,9,12,26,45,-19,18
AGF Aarhus,2504,11,4,6,12,17,39,-22,18
FC Midtjylla,2505,1,20,5,5,66,37,29,65
Brondby,2505,2,19,6,5,69,35,34,63
FC Nords,2505,3,16,6,8,74,51,23,54
Copenhagen,2505,4,14,4,12,58,47,11,46
AaB,2505,5,8,11,11,37,44,-7,35
AC Horsens,2505,6,7,12,11,35,51,-16,33
Sonderjyske,2505,7,8,6,10,28,29,-1,30
Randers FC,2505,8,5,7,12,26,42,-16,22
Lyngby,2505,9,3,10,11,29,47,-18,19
Silkeborg IF,2505,10,5,4,13,26,45,-19,19
AGF Aarhus,2505,11,4,7,11,17,37,-20,19
Brondby,2506,1,20,7,3,71,32,39,67
FC Midtjylla,2506,2,19,5,6,61,36,25,62
FC Nords,2506,3,14,7,9,70,52,18,49
Copenhagen,2506,4,13,6,11,55,43,12,45
AaB,2506,5,8,11,11,36,41,-5,35
AC Horsens,2506,6,7,14,9,34,49,-15,35
Sonderjyske,2506,7,8,6,10,28,29,-1,30
Randers FC,2506,8,5,7,12,23,39,-16,22
Silkeborg IF,2506,9,6,3,13,28,44,-16,21
Lyngby,2506,10,3,10,11,26,44,-18,19
AGF Aarhus,2506,11,4,6,12,16,39,-23,18
Brondby,2507,1,20,7,3,67,31,36,67
FC Midtjylla,2507,2,19,6,5,66,42,24,63
FC Nords,2507,3,14,8,8,71,49,22,50
Copenhagen,2507,4,15,5,10,59,42,17,50
AaB,2507,5,7,14,9,37,39,-2,35
Sonderjyske,2507,6,8,6,10,28,29,-1,30
AC Horsens,2507,7,5,12,13,32,55,-23,27
Randers FC,2507,8,6,6,12,24,39,-15,24
Silkeborg IF,2507,9,5,4,13,26,45,-19,19
AGF Aarhus,2507,10,4,7,11,17,37,-20,19
Lyngby,2507,11,3,9,12,26,45,-19,18
Brondby,2508,1,20,6,4,72,38,34,66
FC Midtjylla,2508,2,20,4,6,66,39,27,64
Copenhagen,2508,3,16,5,9,65,44,21,53
FC Nords,2508,4,13,7,10,70,55,15,46
AaB,2508,5,8,12,10,41,44,-3,36
Sonderjyske,2508,6,8,6,10,28,29,-1,30
AC Horsens,2508,7,6,12,12,32,52,-20,30
Lyngby,2508,8,4,9,11,27,44,-17,21
Randers FC,2508,9,5,6,13,23,40,-17,21
Silkeborg IF,2508,10,5,4,13,27,46,-19,19
AGF Aarhus,2508,11,4,7,11,18,38,-20,19
Brondby,2509,1,20,6,4,72,36,36,66
FC Midtjylla,2509,2,20,5,5,65,39,26,65
FC Nords,2509,3,15,7,8,81,50,31,52
Copenhagen,2509,4,14,5,11,57,44,13,47
AC Horsens,2509,5,6,14,10,34,56,-22,32
AaB,2509,6,6,13,11,34,44,-10,31
Sonderjyske,2509,7,8,6,10,28,29,-1,30
Randers FC,2509,8,5,7,12,25,41,-16,22
Silkeborg IF,2509,9,6,3,13,27,44,-17,21
Lyngby,2509,10,3,10,11,28,46,-18,19
AGF Aarhus,2509,11,4,6,12,16,38,-22,18
FC Midtjylla,2510,1,21,5,4,71,38,33,68
Brondby,2510,2,20,7,3,69,33,36,67
FC Nords,2510,3,13,6,11,71,61,10,45
Copenhagen,2510,4,13,5,12,59,48,11,44
AaB,2510,5,8,12,10,40,40,0,36
AC Horsens,2510,6,7,13,10,35,51,-16,34
Sonderjyske,2510,7,8,6,10,28,29,-1,30
Randers FC,2510,8,5,7,12,24,40,-16,22
Lyngby,2510,9,3,10,11,27,45,-18,19
Silkeborg IF,2510,10,5,4,13,27,46,-19,19
AGF Aarhus,2510,11,4,7,11,18,38,-20,19
Brondby,2511,1,21,6,3,69,32,37,69
FC Midtjylla,2511,2,18,6,6,61,38,23,60
FC Nords,2511,3,15,6,9,79,52,27,51
Copenhagen,2511,4,14,6,10,61,46,15,48
AaB,2511,5,7,13,10,39,45,-6,34
AC Horsens,2511,6,6,13,11,34,56,-22,31
Sonderjyske,2511,7,8,6,10,28,29,-1,30
Randers FC,2511,8,5,7,12,24,40,-16,22
Silkeborg IF,2511,9,6,3,13,28,45,-17,21
Lyngby,2511,10,3,10,11,27,45,-18,19
AGF Aarhus,2511,11,4,6,12,17,39,-22,18
Brondby,2512,1,22,5,3,75,35,40,71
FC Midtjylla,2512,2,19,4,7,64,43,21,61
FC Nords,2512,3,16,6,8,77,50,27,54
Copenhagen,2512,4,13,5,12,54,45,9,44
AC Horsens,2512,5,8,13,9,38,49,-11,37
Sonderjyske,2512,6,8,6,10,28,29,-1,30
AaB,2512,7,6,11,13,33,45,-12,29
Lyngby,2512,8,4,9,11,27,44,-17,21
Randers FC,2512,9,5,6,13,23,40,-17,21
AGF Aarhus,2512,10,5,6,11,17,36,-19,21
Silkeborg IF,2512,11,5,3,14,25,45,-20,18
Brondby,2513,1,19,8,3,71,32,39,65
FC Midtjylla,2513,2,18,6,6,63,41,22,60
Copenhagen,2513,3,15,4,11,59,47,12,49
FC Nords,2513,4,14,6,10,76,58,18,48
AaB,2513,5,8,13,9,42,42,0,37
AC Horsens,2513,6,7,13,10,37,54,-17,34
Sonderjyske,2513,7,8,6,10,28,29,-1,30
Lyngby,2513,8,4,9,11,27,44,-17,21
Randers FC,2513,9,5,6,13,23,40,-17,21
Silkeborg IF,2513,10,5,4,13,26,45,-19,19
AGF Aarhus,2513,11,4,7,11,17,37,-20,19
Brondby,2514,1,21,6,3,74,36,38,69
FC Midtjylla,2514,2,17,7,6,64,42,22,58
Copenhagen,2514,3,14,6,10,56,43,13,48
FC Nords,2514,4,13,7,10,72,54,18,46
AC Horsens,2514,5,8,13,9,40,52,-12,37
AaB,2514,6,7,13,10,37,42,-5,34
Sonderjyske,2514,7,8,6,10,28,29,-1,30
Randers FC,2514,8,5,7,12,24,40,-16,22
AGF Aarhus,2514,9,5,6,11,18,36,-18,21
Lyngby,2514,10,3,10,11,27,45,-18,19
Silkeborg IF,2514,11,5,3,14,25,46,-21,18
Brondby,2515,1,21,7,2,74,34,40,70
FC Midtjylla,2515,2,20,5,5,67,40,27,65
FC Nords,2515,3,14,7,9,76,50,26,49
Copenhagen,2515,4,14,6,10,59,44,15,48
AaB,2515,5,6,14,10,34,44,-10,32
Sonderjyske,2515,6,8,6,10,28,29,-1,30
AC Horsens,2515,7,5,13,12,32,56,-24,28
Randers FC,2515,8,6,6,12,26,39,-13,24
Silkeborg IF,2515,9,6,3,13,27,44,-17,21
Lyngby,2515,10,3,9,12,26,47,-21,18
AGF Aarhus,2515,11,4,6,12,16,38,-22,18
Brondby,2516,1,20,5,5,69,36,33,65
FC Midtjylla,2516,2,19,5,6,72,44,28,62
FC Nords,2516,3,14,7,9,74,52,22,49
Copenhagen,2516,4,12,7,11,55,44,11,43
AC Horsens,2516,5,9,12,9,39,52,-13,39
AaB,2516,6,8,12,10,38,45,-7,36
Sonderjyske,2516,7,8,6,10,28,29,-1,30
Randers FC,2516,8,5,7,12,23,39,-16,22
Lyngby,2516,9,3,10,11,26,44,-18,19
Silkeborg IF,2516,10,5,4,13,26,45,-19,19
AGF Aarhus,2516,11,4,7,11,17,37,-20,19
Brondby,2517,1,20,7,3,67,29,38,67
FC Midtjylla,2517,2,19,5,6,61,37,24,62
FC Nords,2517,3,13,7,10,71,56,15,46
Copenhagen,2517,4,12,5,13,52,47,5,41
AaB,2517,5,10,11,9,42,38,4,41
AC Horsens,2517,6,8,13,9,37,49,-12,37
Sonderjyske,2517,7,8,6,10,28,29,-1,30
Lyngby,2517,8,4,9,11,29,45,-16,21
Silkeborg IF,2517,9,6,3,13,26,44,-18,21
Randers FC,2517,10,5,6,13,24,42,-18,21
AGF Aarhus,2517,11,4,6,12,16,37,-21,18
Brondby,2518,1,22,5,3,74,32,42,71
FC Midtjylla,2518,2,19,5,6,67,41,26,62
Copenhagen,2518,3,17,4,9,62,41,21,55
FC Nords,2518,4,12,7,11,68,58,10,43
AaB,2518,5,8,11,11,36,42,-6,35
Sonderjyske,2518,6,8,6,10,28,29,-1,30
AC Horsens,2518,7,5,14,11,34,53,-19,29
Lyngby,2518,8,4,9,11,29,45,-16,21
Randers FC,2518,9,5,6,13,24,42,-18,21
AGF Aarhus,2518,10,5,6,11,18,37,-19,21
Silkeborg IF,2518,11,5,3,14,26,46,-20,18
Brondby,2519,1,21,7,2,74,34,40,70
FC Midtjylla,2519,2,20,4,6,70,43,27,64
Copenhagen,2519,3,16,5,9,62,43,19,53
FC Nords,2519,4,13,7,10,73,55,18,46
AC Horsens,2519,5,6,13,11,36,55,-19,31
Sonderjyske,2519,6,8,6,10,28,29,-1,30
AaB,2519,7,6,12,12,37,48,-11,30
Lyngby,2519,8,4,9,11,28,44,-16,21
Randers FC,2519,9,5,6,13,23,41,-18,21
AGF Aarhus,2519,10,5,6,11,19,37,-18,21
Silkeborg IF,2519,11,5,3,14,26,47,-21,18
Brondby,2520,1,22,5,3,73,31,42,71
FC Midtjylla,2520,2,19,6,5,67,41,26,63
Copenhagen,2520,3,15,5,10,63,45,18,50
FC Nords,2520,4,12,7,11,69,57,12,43
AaB,2520,5,8,12,10,43,49,-6,36
Sonderjyske,2520,6,8,6,10,28,29,-1,30
AC Horsens,2520,7,5,15,10,37,55,-18,30
Randers FC,2520,8,6,6,12,27,40,-13,24
AGF Aarhus,2520,9,5,6,11,17,36,-19,21
Silkeborg IF,2520,10,5,3,14,25,45,-20,18
Lyngby,2520,11,3,9,12,27,48,-21,18
FC Midtjylla,2521,1,21,4,5,68,35,33,67
Brondby,2521,2,19,7,4,66,32,34,64
FC Nords,2521,3,14,6,10,75,56,19,48
Copenhagen,2521,4,12,7,11,55,45,10,43
AaB,2521,5,8,13,9,37,42,-5,37
AC Horsens,2521,6,6,15,9,34,51,-17,33
Sonderjyske,2521,7,8,6,10,28,29,-1,30
Randers FC,2521,8,6,6,12,25,40,-15,24
Silkeborg IF,2521,9,6,3,13,28,46,-18,21
Lyngby,2521,10,3,9,12,27,46,-19,18
AGF Aarhus,2521,11,4,6,12,18,39,-21,18
Brondby,2522,1,22,5,3,73,34,39,71
FC Midtjylla,2522,2,20,4,6,69,43,26,64
FC Nords,2522,3,14,8,8,73,51,22,50
Copenhagen,2522,4,13,6,11,59,46,13,45
AaB,2522,5,7,12,11,40,46,-6,33
AC Horsens,2522,6,6,13,11,34,54,-20,31
Sonderjyske,2522,7,8,6,10,28,29,-1,30
Randers FC,2522,8,6,6,12,25,40,-15,24
Silkeborg IF,2522,9,5,4,13,26,45,-19,19
AGF Aarhus,2522,10,4,7,11,17,37,-20,19
Lyngby,2522,11,3,9,12,27,46,-19,18
Brondby,2523,1,22,5,3,72,28,44,71
FC Midtjylla,2523,2,19,5,6,64,40,24,62
FC Nords,2523,3,15,7,8,76,50,26,52
Copenhagen,2523,4,13,5,12,53,45,8,44
AaB,2523,5,8,11,11,37,44,-7,35
AC Horsens,2523,6,6,13,11,33,54,-21,31
Sonderjyske,2523,7,8,6,10,28,29,-1,30
Randers FC,2523,8,6,6,12,27,39,-12,24
AGF Aarhus,2523,9,5,6,11,18,37,-19,21
Silkeborg IF,2523,10,5,3,14,26,46,-20,18
Lyngby,2523,11,3,9,12,26,48,-22,18
Brondby,2524,1,21,6,3,72,34,38,69
FC Midtjylla,2524,2,19,6,5,68,40,28,63
FC Nords,2524,3,14,7,9,77,54,23,49
Copenhagen,2524,4,14,5,11,57,46,11,47
AaB,2524,5,8,14,8,39,41,-2,38
Sonderjyske,2524,6,8,6,10,28,29,-1,30
AC Horsens,2524,7,5,12,13,33,57,-24,27
Randers FC,2524,8,5,7,12,25,41,-16,22
Silkeborg IF,2524,9,6,3,13,27,45,-18,21
Lyngby,2524,10,3,10,11,28,46,-18,19
AGF Aarhus,2524,11,4,6,12,17,38,-21,18
Brondby,2525,1,20,7,3,72,33,39,67
FC Midtjylla,2525,2,18,6,6,64,45,19,60
FC Nords,2525,3,14,7,9,78,55,23,49
Copenhagen,2525,4,13,6,11,55,43,12,45
AaB,2525,5,8,14,8,36,38,-2,38
AC Horsens,2525,6,7,12,11,37,54,-17,33
Sonderjyske,2525,7,8,6,10,28,29,-1,30
Randers FC,2525,8,6,6,12,26,41,-15,24
Silkeborg IF,2525,9,5,4,13,26,45,-19,19
AGF Aarhus,2525,10,4,7,11,17,37,-20,19
Lyngby,2525,11,3,9,12,28,47,-19,18
Brondby,2526,1,21,7,2,73,32,41,70
FC Midtjylla,2526,2,19,6,5,69,41,28,63
Copenhagen,2526,3,14,7,9,59,44,15,49
FC Nords,2526,4,13,7,10,74,53,21,46
AaB,2526,5,7,12,11,34,41,-7,33
AC Horsens,2526,6,6,13,11,30,54,-24,31
Sonderjyske,2526,7,8,6,10,28,29,-1,30
Lyngby,2526,8,4,9,11,31,44,-13,21
AGF Aarhus,2526,9,5,6,11,19,38,-19,21
Randers FC,2526,10,5,6,13,23,44,-21,21
Silkeborg IF,2526,11,5,3,14,27,47,-20,18
Brondby,2527,1,21,6,3,71,32,39,69
FC Midtjylla,2527,2,19,6,5,65,39,26,63
FC Nords,2527,3,15,7,8,71,47,24,52
Copenhagen,2527,4,12,5,13,53,50,3,41
AC Horsens,2527,5,8,12,10,39,53,-14,36
AaB,2527,6,7,12,11,38,42,-4,33
Sonderjyske,2527,7,8,6,10,28,29,-1,30
Lyngby,2527,8,4,9,11,29,45,-16,21
Randers FC,2527,9,5,6,13,24,42,-18,21
AGF Aarhus,2527,10,5,6,11,17,36,-19,21
Silkeborg IF,2527,11,5,3,14,25,45,-20,18
Brondby,2528,1,21,7,2,71,32,39,70
FC Midtjylla,2528,2,19,5,6,65,39,26,62
Copenhagen,2528,3,15,5,10,62,46,16,50
FC Nords,2528,4,13,7,10,78,57,21,46
AaB,2528,5,8,11,11,42,43,-1,35
AC Horsens,2528,6,6,13,11,35,62,-27,31
Sonderjyske,2528,7,8,6,10,28,29,-1,30
Randers FC,2528,8,5,7,12,25,41,-16,22
AGF Aarhus,2528,9,5,6,11,20,36,-16,21
Lyngby,2528,10,3,10,11,28,46,-18,19
Silkeborg IF,2528,11,5,3,14,25,48,-23,18
Brondby,2529,1,20,6,4,69,35,34,66
FC Midtjylla,2529,2,20,4,6,67,38,29,64
FC Nords,2529,3,15,6,9,72,51,21,51
Copenhagen,2529,4,14,5,11,59,48,11,47
AaB,2529,5,8,11,11,41,44,-3,35
AC Horsens,2529,6,7,12,11,33,51,-18,33
Sonderjyske,2529,7,8,6,10,28,29,-1,30
Randers FC,2529,8,6,6,12,25,40,-15,24
Silkeborg IF,2529,9,5,4,13,26,45,-19,19
AGF Aarhus,2529,10,4,7,11,17,37,-20,19
Lyngby,2529,11,3,9,12,27,46,-19,18
Brondby,2530,1,19,6,5,68,34,34,63
FC Midtjylla,2530,2,18,6,6,62,38,24,60
FC Nords,2530,3,14,8,8,72,51,21,50
Copenhagen,2530,4,15,5,10,56,40,16,50
AaB,2530,5,8,11,11,37,44,-7,35
AC Horsens,2530,6,7,14,9,34,48,-14,35
Sonderjyske,2530,7,8,6,10,28,29,-1,30
Lyngby,2530,8,4,9,11,29,45,-16,21
Randers FC,2530,9,5,6,13,24,42,-18,21
Silkeborg IF,2530,10,5,4,13,26,45,-19,19
AGF Aarhus,2530,11,4,7,11,17,37,-20,19
Brondby,2531,1,21,6,3,74,36,38,69
FC Midtjylla,2531,2,18,6,6,65,45,20,60
FC Nords,2531,3,14,8,8,73,51,22,50
Copenhagen,2531,4,13,5,12,60,48,12,44
AC Horsens,2531,5,7,14,9,38,53,-15,35
AaB,2531,6,7,13,10,40,43,-3,34
Sonderjyske,2531,7,8,6,10,28,29,-1,30
Randers FC,2531,8,5,7,12,24,40,-16,22
AGF Aarhus,2531,9,5,6,11,18,37,-19,21
Lyngby,2531,10,3,10,11,27,45,-18,19
Silkeborg IF,2531,11,5,3,14,26,46,-20,18
Brondby,2532,1,23,5,2,75,31,44,74
FC Midtjylla,2532,2,20,5,5,67,40,27,65
Copenhagen,2532,3,13,6,11,62,49,13,45
FC Nords,2532,4,12,7,11,74,58,16,43
AaB,2532,5,8,11,11,33,41,-8,35
AC Horsens,2532,6,6,14,10,36,54,-18,32
Sonderjyske,2532,7,8,6,10,28,29,-1,30
Randers FC,2532,8,5,7,12,24,40,-16,22
Silkeborg IF,2532,9,6,3,13,26,44,-18,21
Lyngby,2532,10,3,10,11,27,45,-18,19
AGF Aarhus,2532,11,4,6,12,16,37,-21,18
Brondby,2533,1,22,6,2,75,32,43,72
FC Midtjylla,2533,2,19,5,6,70,43,27,62
FC Nords,2533,3,14,7,9,78,56,22,49
Copenhagen,2533,4,12,5,13,62,56,6,41
AaB,2533,5,9,13,8,48,41,7,40
Sonderjyske,2533,6,8,6,10,28,29,-1,30
AC Horsens,2533,7,6,12,12,33,64,-31,30
Randers FC,2533,8,6,6,12,27,41,-14,24
Silkeborg IF,2533,9,6,3,13,29,44,-15,21
Lyngby,2533,10,3,9,12,28,48,-20,18
AGF Aarhus,2533,11,4,6,12,16,40,-24,18
Brondby,2534,1,20,6,4,70,40,30,66
FC Midtjylla,2534,2,19,4,7,67,39,28,61
FC Nords,2534,3,15,7,8,76,49,27,52
Copenhagen,2534,4,13,6,11,57,45,12,45
AaB,2534,5,8,13,9,37,40,-3,37
AC Horsens,2534,6,6,14,10,35,55,-20,32
Sonderjyske,2534,7,8,6,10,28,29,-1,30
Randers FC,2534,8,6,6,12,26,39,-13,24
Silkeborg IF,2534,9,6,3,13,28,45,-17,21
Lyngby,2534,10,3,9,12,26,47,-21,18
AGF Aarhus,2534,11,4,6,12,17,39,-22,18
Brondby,2535,1,20,7,3,67,30,37,67
FC Midtjylla,2535,2,19,5,6,61,39,22,62
FC Nords,2535,3,14,8,8,72,50,22,50
Copenhagen,2535,4,14,5,11,56,41,15,47
AC Horsens,2535,5,7,13,10,36,51,-15,34
AaB,2535,6,7,12,11,37,44,-7,33
Sonderjyske,2535,7,8,6,10,28,29,-1,30
Randers FC,2535,8,5,7,12,26,42,-16,22
AGF Aarhus,2535,9,5,6,11,21,38,-17,21
Lyngby,2535,10,3,10,11,29,47,-18,19
Silkeborg IF,2535,11,5,3,14,27,49,-22,18
Brondby,2536,1,20,7,3,71,35,36,67
FC Midtjylla,2536,2,19,6,5,62,37,25,63
FC Nords,2536,3,14,8,8,74,50,24,50
Copenhagen,2536,4,14,5,11,58,45,13,47
AaB,2536,5,8,13,9,40,43,-3,37
Sonderjyske,2536,6,8,6,10,28,29,-1,30
AC Horsens,2536,7,5,13,12,32,53,-21,28
Lyngby,2536,8,4,9,11,29,46,-17,21
Randers FC,2536,9,5,6,13,25,42,-17,21
Silkeborg IF,2536,10,5,4,13,26,45,-19,19
AGF Aarhus,2536,11,4,7,11,17,37,-20,19
Brondby,2537,1,21,5,4,80,37,43,68
FC Midtjylla,2537,2,21,5,4,70,40,30,68
Copenhagen,2537,3,15,5,10,62,47,15,50
FC Nords,2537,4,14,7,9,82,63,19,49
AaB,2537,5,6,13,11,35,44,-9,31
Sonderjyske,2537,6,8,6,10,28,29,-1,30
AC Horsens,2537,7,5,13,12,34,58,-24,28
Randers FC,2537,8,6,6,12,25,40,-15,24
Silkeborg IF,2537,9,6,3,13,28,46,-18,21
Lyngby,2537,10,3,9,12,27,46,-19,18
AGF Aarhus,2537,11,4,6,12,18,39,-21,18
Brondby,2538,1,22,5,3,72,32,40,71
FC Midtjylla,2538,2,20,5,5,69,38,31,65
FC Nords,2538,3,14,8,8,77,54,23,50
Copenhagen,2538,4,14,5,11,57,45,12,47
AC Horsens,2538,5,7,12,11,34,54,-20,33
Sonderjyske,2538,6,8,6,10,28,29,-1,30
AaB,2538,7,6,11,13,36,48,-12,29
Lyngby,2538,8,4,9,11,28,44,-16,21
Silkeborg IF,2538,9,6,3,13,27,45,-18,21
Randers FC,2538,10,5,6,13,23,41,-18,21
AGF Aarhus,2538,11,4,6,12,17,38,-21,18
Brondby,2539,1,21,5,4,72,33,39,68
FC Midtjylla,2539,2,19,5,6,67,40,27,62
FC Nords,2539,3,14,6,10,75,56,19,48
Copenhagen,2539,4,14,4,12,57,45,12,46
AaB,2539,5,8,12,10,36,42,-6,36
AC Horsens,2539,6,7,14,9,34,51,-17,35
Sonderjyske,2539,7,8,6,10,28,29,-1,30
Lyngby,2539,8,4,9,11,27,44,-17,21
Randers FC,2539,9,5,6,13,23,40,-17,21
Silkeborg IF,2539,10,5,4,13,26,45,-19,19
AGF Aarhus,2539,11,4,7,11,17,37,-20,19
Brondby,2540,1,22,6,2,75,31,44,72
FC Midtjylla,2540,2,20,4,6,66,41,25,64
FC Nords,2540,3,15,6,9,72,51,21,51
Copenhagen,2540,4,13,4,13,59,50,9,43
AC Horsens,2540,5,7,13,10,39,55,-16,34
AaB,2540,6,7,11,12,35,44,-9,32
Sonderjyske,2540,7,8,6,10,28,29,-1,30
Lyngby,2540,8,4,9,11,28,45,-17,21
Randers FC,2540,9,5,6,13,24,41,-17,21
Silkeborg IF,2540,10,6,3,13,28,46,-18,21
AGF Aarhus,2540,11,4,6,12,18,39,-21,18
FC Midtjylla,2541,1,20,5,5,67,37,30,65
Brondby,2541,2,19,7,4,68,35,33,64
FC Nords,2541,3,14,8,8,76,54,22,50
Copenhagen,2541,4,12,6,12,54,44,10,42
AaB,2541,5,8,13,9,38,43,-5,37
AC Horsens,2541,6,7,13,10,39,55,-16,34
Sonderjyske,2541,7,8,6,10,28,29,-1,30
Randers FC,2541,8,5,7,12,25,41,-16,22
Silkeborg IF,2541,9,6,3,13,26,44,-18,21
Lyngby,2541,10,3,10,11,28,46,-18,19
AGF Aarhus,2541,11,4,6,12,16,37,-21,18
Brondby,2542,1,20,7,3,73,36,37,67
FC Midtjylla,2542,2,19,7,4,67,40,27,64
Copenhagen,2542,3,14,7,9,61,46,15,49
FC Nords,2542,4,14,6,10,71,51,20,48
AaB,2542,5,8,11,11,37,43,-6,35
Sonderjyske,2542,6,8,6,10,28,29,-1,30
AC Horsens,2542,7,5,14,11,34,53,-19,29
Lyngby,2542,8,4,9,11,28,45,-17,21
Randers FC,2542,9,5,6,13,24,41,-17,21
Silkeborg IF,2542,10,5,4,13,26,45,-19,19
AGF Aarhus,2542,11,4,7,11,17,37,-20,19
Brondby,2543,1,21,5,4,70,35,35,68
FC Midtjylla,2543,2,19,5,6,61,36,25,62
FC Nords,2543,3,13,7,10,73,55,18,46
Copenhagen,2543,4,13,4,13,56,48,8,43
AaB,2543,5,9,13,8,43,40,3,40
AC Horsens,2543,6,8,12,10,37,52,-15,36
Sonderjyske,2543,7,8,6,10,28,29,-1,30
Lyngby,2543,8,4,9,11,29,45,-16,21
Randers FC,2543,9,5,6,13,24,42,-18,21
Silkeborg IF,2543,10,5,4,13,27,46,-19,19
AGF Aarhus,2543,11,4,7,11,18,38,-20,19
FC Midtjylla,2544,1,22,4,4,68,33,35,70
Brondby,2544,2,20,5,5,71,37,34,65
FC Nords,2544,3,15,6,9,77,52,25,51
Copenhagen,2544,4,14,4,12,58,47,11,46
AaB,2544,5,7,12,11,37,45,-8,33
AC Horsens,2544,6,6,13,11,32,55,-23,31
Sonderjyske,2544,7,8,6,10,28,29,-1,30
Lyngby,2544,8,4,9,11,28,45,-17,21
Randers FC,2544,9,5,6,13,24,41,-17,21
Silkeborg IF,2544,10,6,3,13,28,46,-18,21
AGF Aarhus,2544,11,4,6,12,18,39,-21,18
Brondby,2545,1,21,5,4,74,31,43,68
FC Midtjylla,2545,2,20,4,6,67,41,26,64
Copenhagen,2545,3,15,6,9,61,41,20,51
FC Nords,2545,4,13,8,9,69,54,15,47
AaB,2545,5,7,13,10,35,44,-9,34
Sonderjyske,2545,6,8,6,10,28,29,-1,30
AC Horsens,2545,7,6,12,12,34,55,-21,30
Randers FC,2545,8,6,6,12,24,39,-15,24
Silkeborg IF,2545,9,6,3,13,26,44,-18,21
Lyngby,2545,10,3,9,12,26,45,-19,18
AGF Aarhus,2545,11,4,6,12,16,37,-21,18
Brondby,2546,1,22,5,3,74,31,43,71
FC Midtjylla,2546,2,21,5,4,73,38,35,68
Copenhagen,2546,3,13,6,11,61,48,13,45
FC Nords,2546,4,12,8,10,70,55,15,44
AaB,2546,5,7,12,11,36,47,-11,33
AC Horsens,2546,6,7,12,11,36,57,-21,33
Sonderjyske,2546,7,8,6,10,28,29,-1,30
Randers FC,2546,8,5,7,12,25,41,-16,22
Silkeborg IF,2546,9,6,3,13,27,45,-18,21
Lyngby,2546,10,3,10,11,28,46,-18,19
AGF Aarhus,2546,11,4,6,12,17,38,-21,18
Brondby,2547,1,21,5,4,75,38,37,68
FC Midtjylla,2547,2,18,5,7,66,44,22,59
FC Nords,2547,3,16,6,8,79,52,27,54
Copenhagen,2547,4,15,5,10,64,48,16,50
AaB,2547,5,6,14,10,36,43,-7,32
AC Horsens,2547,6,6,13,11,33,54,-21,31
Sonderjyske,2547,7,8,6,10,28,29,-1,30
Randers FC,2547,8,5,7,12,23,39,-16,22
AGF Aarhus,2547,9,5,6,11,17,36,-19,21
Lyngby,2547,10,3,10,11,26,44,-18,19
Silkeborg IF,2547,11,5,3,14,25,45,-20,18
Brondby,2548,1,20,7,3,75,36,39,67
FC Midtjylla,2548,2,20,5,5,67,38,29,65
FC Nords,2548,3,14,8,8,74,52,22,50
Copenhagen,2548,4,13,6,11,59,47,12,45
AC Horsens,2548,5,7,13,10,36,52,-16,34
AaB,2548,6,7,11,12,35,47,-12,32
Sonderjyske,2548,7,8,6,10,28,29,-1,30
Lyngby,2548,8,4,9,11,28,45,-17,21
Silkeborg IF,2548,9,6,3,13,27,44,-17,21
Randers FC,2548,10,5,6,13,24,41,-17,21
AGF Aarhus,2548,11,4,6,12,16,38,-22,18
Brondby,2549,1,21,5,4,69,31,38,68
FC Midtjylla,2549,2,20,5,5,73,38,35,65
FC Nords,2549,3,16,6,8,79,55,24,54
Copenhagen,2549,4,12,6,12,53,45,8,42
AaB,2549,5,9,11,10,36,40,-4,38
Sonderjyske,2549,6,8,6,10,28,29,-1,30
AC Horsens,2549,7,5,13,12,30,57,-27,28
Randers FC,2549,8,6,6,12,26,39,-13,24
Silkeborg IF,2549,9,5,4,13,25,44,-19,19
AGF Aarhus,2549,10,4,7,11,16,36,-20,19
Lyngby,2549,11,3,9,12,26,47,-21,18
Brondby,2550,1,21,5,4,72,33,39,68
FC Midtjylla,2550,2,19,5,6,65,41,24,62
Copenhagen,2550,3,15,5,10,58,42,16,50
FC Nords,2550,4,12,7,11,70,56,14,43
AaB,2550,5,7,14,9,39,43,-4,35
AC Horsens,2550,6,7,14,9,36,51,-15,35
Sonderjyske,2550,7,8,6,10,28,29,-1,30
Randers FC,2550,8,5,7,12,24,40,-16,22
Silkeborg IF,2550,9,6,3,13,28,45,-17,21
Lyngby,2550,10,3,10,11,27,45,-18,19
AGF Aarhus,2550,11,4,6,12,17,39,-22,18
FC Midtjylla,2551,1,20,5,5,67,39,28,65
Brondby,2551,2,19,6,5,73,37,36,63
FC Nords,2551,3,14,7,9,73,55,18,49
Copenhagen,2551,4,14,4,12,57,48,9,46
AaB,2551,5,8,12,10,37,42,-5,36
AC Horsens,2551,6,7,14,9,37,49,-12,35
Sonderjyske,2551,7,8,6,10,28,29,-1,30
Randers FC,2551,8,5,7,12,28,44,-16,22
Lyngby,2551,9,3,10,11,31,49,-18,19
Silkeborg IF,2551,10,5,4,13,26,45,-19,19
AGF Aarhus,2551,11,4,7,11,17,37,-20,19
Brondby,2552,1,22,5,3,74,28,46,71
FC Midtjylla,2552,2,18,6,6,63,40,23,60
FC Nords,2552,3,15,6,9,77,53,24,51
Copenhagen,2552,4,13,5,12,56,46,10,44
AC Horsens,2552,5,7,14,9,37,53,-16,35
AaB,2552,6,7,12,11,36,49,-13,33
Sonderjyske,2552,7,8,6,10,28,29,-1,30
Lyngby,2552,8,4,9,11,30,44,-14,21
Silkeborg IF,2552,9,6,3,13,28,44,-16,21
Randers FC,2552,10,5,6,13,23,43,-20,21
AGF Aarhus,2552,11,4,6,12,16,39,-23,18
Brondby,2553,1,21,7,2,70,31,39,70
FC Midtjylla,2553,2,19,6,5,69,41,28,63
Copenhagen,2553,3,15,6,9,61,42,19,51
FC Nords,2553,4,14,8,8,71,49,22,50
Sonderjyske,2553,5,8,6,10,28,29,-1,30
AaB,2553,6,6,12,12,33,44,-11,30
AC Horsens,2553,7,5,13,12,32,55,-23,28
Randers FC,2553,8,6,6,12,24,39,-15,24
Silkeborg IF,2553,9,5,4,13,26,45,-19,19
AGF Aarhus,2553,10,4,7,11,17,37,-20,19
Lyngby,2553,11,3,9,12,26,45,-19,18
Brondby,2554,1,21,5,4,70,31,39,68
FC Midtjylla,2554,2,20,5,5,64,37,27,65
FC Nords,2554,3,14,7,9,73,52,21,49
Copenhagen,2554,4,13,6,11,56,45,11,45
AC Horsens,2554,5,7,13,10,34,51,-17,34
AaB,2554,6,7,12,11,34,41,-7,33
Sonderjyske,2554,7,8,6,10,28,29,-1,30
Lyngby,2554,8,4,9,11,29,45,-16,21
Silkeborg IF,2554,9,6,3,13,27,44,-17,21
Randers FC,2554,10,5,6,13,24,42,-18,21
AGF Aarhus,2554,11,4,6,12,16,38,-22,18
Brondby,2555,1,20,7,3,68,32,36,67
FC Midtjylla,2555,2,20,5,5,67,41,26,65
FC Nords,2555,3,14,7,9,73,50,23,49
Copenhagen,2555,4,13,5,12,56,46,10,44
AaB,2555,5,7,13,10,34,41,-7,34
AC Horsens,2555,6,7,13,10,35,49,-14,34
Sonderjyske,2555,7,8,6,10,28,29,-1,30
Lyngby,2555,8,4,9,11,28,45,-17,21
Silkeborg IF,2555,8,6,3,13,28,45,-17,21
Randers FC,2555,10,5,6,13,24,41,-17,21
AGF Aarhus,2555,11,4,6,12,17,39,-22,18
Brondby,2556,1,21,7,2,72,30,42,70
FC Midtjylla,2556,2,21,5,4,69,36,33,68
FC Nords,2556,3,14,6,10,75,53,22,48
Copenhagen,2556,4,13,4,13,56,50,6,43
AC Horsens,2556,5,7,13,10,40,55,-15,34
AaB,2556,6,7,11,12,37,51,-14,32
Sonderjyske,2556,7,8,6,10,28,29,-1,30
Lyngby,2556,8,4,9,11,27,44,-17,21
Randers FC,2556,9,5,6,13,23,40,-17,21
Silkeborg IF,2556,10,5,4,13,26,45,-19,19
AGF Aarhus,2556,11,4,7,11,17,37,-20,19
FC Midtjylla,2557,1,21,4,5,68,37,31,67
Brondby,2557,2,20,6,4,68,34,34,66
Copenhagen,2557,3,15,5,10,61,42,19,50
FC Nords,2557,4,12,7,11,69,56,13,43
AaB,2557,5,9,11,10,38,42,-4,38
Sonderjyske,2557,6,8,6,10,28,29,-1,30
AC Horsens,2557,7,5,15,10,37,56,-19,30
Lyngby,2557,8,4,9,11,27,44,-17,21
Randers FC,2557,9,5,6,13,23,40,-17,21
AGF Aarhus,2557,10,5,6,11,18,36,-18,21
Silkeborg IF,2557,11,5,3,14,25,46,-21,18
Brondby,2558,1,20,7,3,71,33,38,67
FC Midtjylla,2558,2,19,5,6,68,42,26,62
Copenhagen,2558,3,14,6,10,59,45,14,48
FC Nords,2558,4,13,7,10,73,55,18,46
AC Horsens,2558,5,8,12,10,36,54,-18,36
AaB,2558,6,7,13,10,36,40,-4,34
Sonderjyske,2558,7,8,6,10,28,29,-1,30
Lyngby,2558,8,4,9,11,28,44,-16,21
Randers FC,2558,9,5,6,13,23,41,-18,21
AGF Aarhus,2558,10,5,6,11,17,36,-19,21
Silkeborg IF,2558,11,5,3,14,25,45,-20,18
Brondby,2559,1,20,6,4,76,40,36,66
FC Midtjylla,2559,2,20,5,5,64,38,26,65
FC Nords,2559,3,14,8,8,77,52,25,50
Copenhagen,2559,4,14,5,11,56,43,13,47
AaB,2559,5,8,12,10,43,45,-2,36
Sonderjyske,2559,6,8,6,10,28,29,-1,30
AC Horsens,2559,7,6,12,12,32,56,-24,30
Randers FC,2559,8,5,7,12,24,40,-16,22
Silkeborg IF,2559,9,6,3,13,27,44,-17,21
Lyngby,2559,10,3,10,11,27,45,-18,19
AGF Aarhus,2559,11,4,6,12,16,38,-22,18
Brondby,2560,1,21,5,4,70,32,38,68
FC Midtjylla,2560,2,20,4,6,69,43,26,64
Copenhagen,2560,3,16,4,10,62,43,19,52
FC Nords,2560,4,15,6,9,74,54,20,51
AaB,2560,5,7,11,12,36,47,-11,32
Sonderjyske,2560,6,8,6,10,28,29,-1,30
AC Horsens,2560,7,6,12,12,38,56,-18,30
Randers FC,2560,8,6,6,12,24,39,-15,24
Silkeborg IF,2560,9,6,3,13,28,44,-16,21
Lyngby,2560,10,3,9,12,26,45,-19,18
AGF Aarhus,2560,11,4,6,12,16,39,-23,18
Brondby,2561,1,21,5,4,77,35,42,68
FC Midtjylla,2561,2,19,4,7,65,45,20,61
Copenhagen,2561,3,15,5,10,61,46,15,50
FC Nords,2561,4,13,7,10,73,53,20,46
AaB,2561,5,8,13,9,35,38,-3,37
AC Horsens,2561,6,6,14,10,36,56,-20,32
Sonderjyske,2561,7,8,6,10,28,29,-1,30
Randers FC,2561,8,5,7,12,24,40,-16,22
Lyngby,2561,9,3,10,11,27,45,-18,19
Silkeborg IF,2561,10,5,4,13,26,45,-19,19
AGF Aarhus,2561,11,4,7,11,17,37,-20,19
Brondby,2562,1,21,6,3,71,29,42,69
FC Midtjylla,2562,2,20,4,6,64,39,25,64
Copenhagen,2562,3,14,7,9,60,42,18,49
FC Nords,2562,4,13,7,10,72,54,18,46
AaB,2562,5,7,13,10,38,44,-6,34
Sonderjyske,2562,6,8,6,10,28,29,-1,30
AC Horsens,2562,7,5,15,10,35,58,-23,30
Lyngby,2562,8,4,9,11,29,45,-16,21
Randers FC,2562,9,5,6,13,24,42,-18,21
AGF Aarhus,2562,10,5,6,11,18,36,-18,21
Silkeborg IF,2562,11,5,3,14,25,46,-21,18
Brondby,2563,1,19,8,3,71,32,39,65
FC Midtjylla,2563,2,19,6,5,63,37,26,63
Copenhagen,2563,3,15,5,10,59,46,13,50
FC Nords,2563,4,13,7,10,72,59,13,46
AaB,2563,5,8,12,10,39,39,0,36
AC Horsens,2563,6,6,14,10,34,51,-17,32
Sonderjyske,2563,7,8,6,10,28,29,-1,30
Lyngby,2563,8,4,9,11,28,44,-16,21
Silkeborg IF,2563,8,6,3,13,28,44,-16,21
Randers FC,2563,10,5,6,13,23,41,-18,21
AGF Aarhus,2563,11,4,6,12,16,39,-23,18
Brondby,2564,1,20,8,2,67,28,39,68
FC Midtjylla,2564,2,21,5,4,69,37,32,68
FC Nords,2564,3,12,9,9,69,50,19,45
Copenhagen,2564,4,12,7,11,54,43,11,43
AaB,2564,5,8,12,10,34,40,-6,36
AC Horsens,2564,6,6,13,11,34,55,-21,31
Sonderjyske,2564,7,8,6,10,28,29,-1,30
Lyngby,2564,8,4,9,11,28,44,-16,21
Silkeborg IF,2564,9,6,3,13,26,44,-18,21
Randers FC,2564,10,5,6,13,23,41,-18,21
AGF Aarhus,2564,11,4,6,12,16,37,-21,18
FC Midtjylla,2565,1,21,4,5,69,36,33,67
Brondby,2565,2,19,6,5,69,39,30,63
Copenhagen,2565,3,15,5,10,58,43,15,50
FC Nords,2565,4,13,7,10,77,60,17,46
AaB,2565,5,7,13,10,39,46,-7,34
AC Horsens,2565,6,7,13,10,36,50,-14,34
Sonderjyske,2565,7,8,6,10,28,29,-1,30
Lyngby,2565,8,4,9,11,29,46,-17,21
Randers FC,2565,9,5,6,13,25,42,-17,21
AGF Aarhus,2565,10,5,6,11,19,38,-19,21
Silkeborg IF,2565,11,5,3,14,27,47,-20,18
Brondby,2566,1,21,6,3,74,34,40,69
FC Midtjylla,2566,2,19,6,5,67,40,27,63
Copenhagen,2566,3,15,5,10,62,46,16,50
FC Nords,2566,4,14,7,9,79,54,25,49
AaB,2566,5,8,12,10,38,43,-5,36
Sonderjyske,2566,6,8,6,10,28,29,-1,30
AC Horsens,2566,7,5,12,13,33,62,-29,27
Lyngby,2566,8,4,9,11,31,45,-14,21
Silkeborg IF,2566,9,6,3,13,27,44,-17,21
Randers FC,2566,10,5,6,13,24,44,-20,21
AGF Aarhus,2566,11,4,6,12,16,38,-22,18
Brondby,2567,1,23,5,2,79,32,47,74
FC Midtjylla,2567,2,19,4,7,67,41,26,61
FC Nords,2567,3,14,8,8,73,54,19,50
Copenhagen,2567,4,14,6,10,59,45,14,48
AC Horsens,2567,5,6,14,10,36,53,-17,32
Sonderjyske,2567,6,8,6,10,28,29,-1,30
AaB,2567,7,6,11,13,38,53,-15,29
Randers FC,2567,8,6,6,12,24,39,-15,24
Silkeborg IF,2567,9,6,3,13,26,44,-18,21
Lyngby,2567,10,3,9,12,26,45,-19,18
AGF Aarhus,2567,11,4,6,12,16,37,-21,18
Brondby,2568,1,21,6,3,76,34,42,69
FC Midtjylla,2568,2,19,5,6,63,41,22,62
FC Nords,2568,3,15,6,9,73,52,21,51
Copenhagen,2568,4,13,5,12,58,48,10,44
AC Horsens,2568,5,8,12,10,35,49,-14,36
AaB,2568,6,7,12,11,37,44,-7,33
Sonderjyske,2568,7,8,6,10,28,29,-1,30
Lyngby,2568,8,4,9,11,27,44,-17,21
Randers FC,2568,9,5,6,13,23,40,-17,21
Silkeborg IF,2568,10,5,4,13,27,46,-19,19
AGF Aarhus,2568,11,4,7,11,18,38,-20,19
FC Midtjylla,2569,1,20,5,5,70,41,29,65
Brondby,2569,2,19,7,4,66,37,29,64
FC Nords,2569,3,14,7,9,76,54,22,49
Copenhagen,2569,4,14,5,11,60,46,14,47
AC Horsens,2569,5,7,13,10,40,53,-13,34
AaB,2569,6,6,15,9,35,42,-7,33
Sonderjyske,2569,7,8,6,10,28,29,-1,30
Lyngby,2569,8,4,9,11,28,44,-16,21
AGF Aarhus,2569,9,5,6,11,19,36,-17,21
Randers FC,2569,10,5,6,13,23,41,-18,21
Silkeborg IF,2569,11,5,3,14,25,47,-22,18
Brondby,2570,1,23,5,2,70,27,43,74
FC Midtjylla,2570,2,21,4,5,72,38,34,67
FC Nords,2570,3,14,7,9,75,51,24,49
Copenhagen,2570,4,13,4,13,55,51,4,43
AC Horsens,2570,5,7,13,10,34,52,-18,34
Sonderjyske,2570,6,8,6,10,28,29,-1,30
AaB,2570,7,6,11,13,35,48,-13,29
Randers FC,2570,8,5,7,12,24,40,-16,22
AGF Aarhus,2570,9,5,6,11,17,36,-19,21
Lyngby,2570,10,3,10,11,27,45,-18,19
Silkeborg IF,2570,11,5,3,14,25,45,-20,18
FC Midtjylla,2571,1,19,7,4,63,37,26,64
Brondby,2571,2,19,6,5,65,36,29,63
Copenhagen,2571,3,14,6,10,59,42,17,48
FC Nords,2571,4,12,7,11,67,53,14,43
AaB,2571,5,9,13,8,39,38,1,40
AC Horsens,2571,6,7,13,10,35,48,-13,34
Sonderjyske,2571,7,8,6,10,28,29,-1,30
Lyngby,2571,8,4,9,11,27,44,-17,21
Silkeborg IF,2571,8,6,3,13,27,44,-17,21
Randers FC,2571,10,5,6,13,23,40,-17,21
AGF Aarhus,2571,11,4,6,12,16,38,-22,18
Brondby,2572,1,22,5,3,76,37,39,71
FC Midtjylla,2572,2,19,5,6,65,39,26,62
Copenhagen,2572,3,15,4,11,62,46,16,49
FC Nords,2572,4,13,6,11,70,55,15,45
AaB,2572,5,8,12,10,41,46,-5,36
AC Horsens,2572,6,7,12,11,32,49,-17,33
Sonderjyske,2572,7,8,6,10,28,29,-1,30
Randers FC,2572,8,5,7,12,23,39,-16,22
Lyngby,2572,9,3,10,11,26,44,-18,19
Silkeborg IF,2572,10,5,4,13,26,45,-19,19
AGF Aarhus,2572,11,4,7,11,17,37,-20,19
Brondby,2573,1,21,7,2,70,29,41,70
FC Midtjylla,2573,2,19,6,5,66,41,25,63
Copenhagen,2573,3,15,5,10,59,43,16,50
FC Nords,2573,4,12,7,11,68,54,14,43
AaB,2573,5,9,11,10,39,41,-2,38
Sonderjyske,2573,6,8,6,10,28,29,-1,30
AC Horsens,2573,7,5,14,11,30,50,-20,29
Randers FC,2573,8,5,7,12,24,40,-16,22
AGF Aarhus,2573,9,5,6,11,18,37,-19,21
Lyngby,2573,10,3,10,11,27,45,-18,19
Silkeborg IF,2573,11,5,3,14,26,46,-20,18
Brondby,2574,1,21,6,3,71,32,39,69
FC Midtjylla,2574,2,19,5,6,63,37,26,62
FC Nords,2574,3,16,7,7,74,48,26,55
Copenhagen,2574,4,13,4,13,53,45,8,43
AaB,2574,5,8,11,11,38,46,-8,35
AC Horsens,2574,6,6,13,11,36,53,-17,31
Sonderjyske,2574,7,8,6,10,28,29,-1,30
Lyngby,2574,8,4,9,11,29,45,-16,21
Silkeborg IF,2574,9,6,3,13,27,45,-18,21
Randers FC,2574,10,5,6,13,24,42,-18,21
AGF Aarhus,2574,11,4,6,12,17,38,-21,18
Brondby,2575,1,21,5,4,69,29,40,68
FC Midtjylla,2575,2,19,6,5,67,39,28,63
FC Nords,2575,3,15,7,8,73,47,26,52
Copenhagen,2575,4,15,4,11,58,50,8,49
AaB,2575,5,6,13,11,34,41,-7,31
AC Horsens,2575,6,6,13,11,34,55,-21,31
Sonderjyske,2575,7,8,6,10,28,29,-1,30
Randers FC,2575,8,6,6,12,25,40,-15,24
Silkeborg IF,2575,9,5,4,13,27,46,-19,19
AGF Aarhus,2575,10,4,7,11,18,38,-20,19
Lyngby,2575,11,3,9,12,27,46,-19,18
Brondby,2576,1,20,5,5,69,33,36,65
FC Midtjylla,2576,2,20,4,6,65,40,25,64
Copenhagen,2576,3,16,4,10,61,39,22,52
FC Nords,2576,4,14,6,10,70,54,16,48
AaB,2576,5,8,12,10,37,43,-6,36
AC Horsens,2576,6,6,13,11,33,52,-19,31
Sonderjyske,2576,7,8,6,10,28,29,-1,30
Randers FC,2576,8,5,7,12,24,40,-16,22
Silkeborg IF,2576,9,6,3,13,27,44,-17,21
Lyngby,2576,10,3,10,11,27,45,-18,19
AGF Aarhus,2576,11,4,6,12,16,38,-22,18
Brondby,2577,1,21,5,4,74,36,38,68
FC Midtjylla,2577,2,19,5,6,64,39,25,62
FC Nords,2577,3,15,7,8,81,57,24,52
Copenhagen,2577,4,12,6,12,60,53,7,42
AC Horsens,2577,5,8,13,9,41,53,-12,37
AaB,2577,6,7,12,11,37,45,-8,33
Sonderjyske,2577,7,8,6,10,28,29,-1,30
Randers FC,2577,8,5,7,12,24,40,-16,22
Lyngby,2577,9,3,10,11,27,45,-18,19
Silkeborg IF,2577,10,5,4,13,26,45,-19,19
AGF Aarhus,2577,11,4,7,11,17,37,-20,19
Brondby,2578,1,21,7,2,73,32,41,70
FC Midtjylla,2578,2,18,6,6,65,41,24,60
FC Nords,2578,3,14,8,8,73,51,22,50
Copenhagen,2578,4,12,7,11,56,46,10,43
AaB,2578,5,9,12,9,40,41,-1,39
Sonderjyske,2578,6,8,6,10,28,29,-1,30
AC Horsens,2578,7,5,14,11,30,52,-22,29
Randers FC,2578,8,5,7,12,23,39,-16,22
AGF Aarhus,2578,9,5,6,11,18,37,-19,21
Lyngby,2578,10,3,10,11,26,44,-18,19
Silkeborg IF,2578,11,5,3,14,26,46,-20,18
FC Midtjylla,2579,1,21,5,4,69,38,31,68
Brondby,2579,2,18,7,5,67,35,32,61
FC Nords,2579,3,15,6,9,75,55,20,51
Copenhagen,2579,4,13,6,11,55,44,11,45
AaB,2579,5,9,12,9,37,38,-1,39
Sonderjyske,2579,6,8,6,10,28,29,-1,30
AC Horsens,2579,7,5,14,11,37,56,-19,29
Randers FC,2579,8,6,6,12,24,39,-15,24
AGF Aarhus,2579,9,5,6,11,19,37,-18,21
Lyngby,2579,10,3,9,12,26,45,-19,18
Silkeborg IF,2579,11,5,3,14,26,47,-21,18
FC Midtjylla,2580,1,20,6,4,69,35,34,66
Brondby,2580,2,18,8,4,62,29,33,62
FC Nords,2580,3,14,9,7,73,50,23,51
Copenhagen,2580,4,13,5,12,55,45,10,44
AaB,2580,5,8,12,10,37,41,-4,36
AC Horsens,2580,6,7,12,11,32,54,-22,33
Sonderjyske,2580,7,8,6,10,28,29,-1,30
Silkeborg IF,2580,8,6,3,13,28,44,-16,21
Lyngby,2580,9,4,9,11,28,45,-17,21
Randers FC,2580,10,5,6,13,24,41,-17,21
AGF Aarhus,2580,11,4,6,12,16,39,-23,18
FC Midtjylla,2581,1,22,4,4,71,40,31,70
Brondby,2581,2,21,5,4,75,34,41,68
FC Nords,2581,3,13,8,9,72,52,20,47
Copenhagen,2581,4,14,5,11,57,44,13,47
AaB,2581,5,7,12,11,33,44,-11,33
Sonderjyske,2581,6,8,6,10,28,29,-1,30
AC Horsens,2581,7,6,12,12,34,54,-20,30
Randers FC,2581,8,5,7,12,23,39,-16,22
Lyngby,2581,9,3,10,11,26,44,-18,19
Silkeborg IF,2581,10,5,4,13,26,45,-19,19
AGF Aarhus,2581,11,4,7,11,17,37,-20,19
Brondby,2582,1,22,5,3,70,34,36,71
FC Midtjylla,2582,2,20,4,6,69,40,29,64
FC Nords,2582,3,14,6,10,70,56,14,48
Copenhagen,2582,4,13,5,12,54,41,13,44
AaB,2582,5,8,11,11,36,42,-6,35
AC Horsens,2582,6,7,13,10,37,49,-12,34
Sonderjyske,2582,7,8,6,10,28,29,-1,30
Randers FC,2582,8,6,6,12,24,39,-15,24
AGF Aarhus,2582,9,5,6,11,17,36,-19,21
Lyngby,2582,10,3,9,12,26,45,-19,18
Silkeborg IF,2582,11,5,3,14,25,45,-20,18
Brondby,2583,1,20,7,3,71,33,38,67
FC Midtjylla,2583,2,19,6,5,67,41,26,63
FC Nords,2583,3,14,7,9,73,52,21,49
Copenhagen,2583,4,13,6,11,56,47,9,45
AaB,2583,5,8,11,11,37,41,-4,35
AC Horsens,2583,6,7,13,10,36,52,-16,34
Sonderjyske,2583,7,8,6,10,28,29,-1,30
Randers FC,2583,8,5,7,12,23,39,-16,22
Lyngby,2583,9,3,10,11,26,44,-18,19
Silkeborg IF,2583,10,5,4,13,26,45,-19,19
AGF Aarhus,2583,11,4,7,11,17,37,-20,19
Brondby,2584,1,21,5,4,71,33,38,68
FC Midtjylla,2584,2,18,7,5,64,40,24,61
FC Nords,2584,3,13,8,9,72,52,20,47
Copenhagen,2584,4,14,5,11,59,48,11,47
AaB,2584,5,9,12,9,41,41,0,39
AC Horsens,2584,6,6,13,11,35,54,-19,31
Sonderjyske,2584,7,8,6,10,28,29,-1,30
Lyngby,2584,8,4,9,11,28,45,-17,21
Randers FC,2584,9,5,6,13,24,41,-17,21
Silkeborg IF,2584,10,5,4,13,27,46,-19,19
AGF Aarhus,2584,11,4,7,11,18,38,-20,19
Brondby,2585,1,20,6,4,69,33,36,66
FC Midtjylla,2585,2,19,4,7,64,42,22,61
Copenhagen,2585,3,15,5,10,62,43,19,50
FC Nords,2585,4,14,7,9,73,54,19,49
AaB,2585,5,10,11,9,41,41,0,41
Sonderjyske,2585,6,8,6,10,28,29,-1,30
AC Horsens,2585,7,5,13,12,31,53,-22,28
Lyngby,2585,8,4,9,11,28,44,-16,21
Silkeborg IF,2585,9,6,3,13,26,44,-18,21
Randers FC,2585,10,5,6,13,23,41,-18,21
AGF Aarhus,2585,11,4,6,12,16,37,-21,18
Brondby,2586,1,18,6,6,70,41,29,60
FC Midtjylla,2586,2,18,6,6,62,39,23,60
FC Nords,2586,3,16,6,8,75,51,24,54
Copenhagen,2586,4,14,6,10,60,44,16,48
AaB,2586,5,7,14,9,35,40,-5,35
AC Horsens,2586,6,7,14,9,36,49,-13,35
Sonderjyske,2586,7,8,6,10,28,29,-1,30
Randers FC,2586,8,6,6,12,28,41,-13,24
Silkeborg IF,2586,9,6,3,13,28,44,-16,21
Lyngby,2586,10,3,9,12,28,49,-21,18
AGF Aarhus,2586,11,4,6,12,16,39,-23,18
Brondby,2587,1,23,5,2,75,29,46,74
FC Midtjylla,2587,2,19,4,7,69,44,25,61
FC Nords,2587,3,14,8,8,73,51,22,50
Copenhagen,2587,4,14,6,10,60,43,17,48
AaB,2587,5,6,13,11,33,46,-13,31
Sonderjyske,2587,6,8,6,10,28,29,-1,30
AC Horsens,2587,7,5,14,11,30,53,-23,29
Randers FC,2587,8,6,6,12,27,40,-13,24
Silkeborg IF,2587,9,6,3,13,30,45,-15,21
Lyngby,2587,10,3,9,12,27,48,-21,18
AGF Aarhus,2587,11,4,6,12,17,41,-24,18
Brondby,2588,1,21,6,3,71,29,42,69
FC Midtjylla,2588,2,21,4,5,68,39,29,67
FC Nords,2588,3,13,7,10,72,55,17,46
Copenhagen,2588,4,12,6,12,57,48,9,42
AaB,2588,5,7,14,9,38,42,-4,35
AC Horsens,2588,6,7,13,10,31,50,-19,34
Sonderjyske,2588,7,8,6,10,28,29,-1,30
Lyngby,2588,8,4,9,11,30,45,-15,21
Silkeborg IF,2588,9,6,3,13,28,44,-16,21
Randers FC,2588,10,5,6,13,24,43,-19,21
AGF Aarhus,2588,11,4,6,12,16,39,-23,18
Brondby,2589,1,21,6,3,69,32,37,69
FC Midtjylla,2589,2,19,6,5,64,38,26,63
FC Nords,2589,3,14,8,8,78,51,27,50
Copenhagen,2589,4,12,8,10,54,43,11,44
AaB,2589,5,6,15,9,36,43,-7,33
Sonderjyske,2589,6,8,6,10,28,29,-1,30
AC Horsens,2589,7,5,15,10,36,56,-20,30
Lyngby,2589,8,4,9,11,27,44,-17,21
Silkeborg IF,2589,8,6,3,13,27,44,-17,21
Randers FC,2589,10,5,6,13,23,40,-17,21
AGF Aarhus,2589,11,4,6,12,16,38,-22,18
Brondby,2590,1,20,6,4,68,30,38,66
FC Midtjylla,2590,2,20,5,5,63,37,26,65
FC Nords,2590,3,14,8,8,72,49,23,50
Copenhagen,2590,4,14,4,12,55,46,9,46
AaB,2590,5,7,12,11,36,43,-7,33
AC Horsens,2590,6,6,15,9,35,50,-15,33
Sonderjyske,2590,7,8,6,10,28,29,-1,30
Lyngby,2590,8,4,9,11,29,45,-16,21
Silkeborg IF,2590,9,6,3,13,27,45,-18,21
Randers FC,2590,10,5,6,13,24,42,-18,21
AGF Aarhus,2590,11,4,6,12,17,38,-21,18
Brondby,2591,1,20,6,4,67,31,36,66
FC Midtjylla,2591,2,20,6,4,68,40,28,66
FC Nords,2591,3,13,6,11,73,57,16,45
Copenhagen,2591,4,13,6,11,55,43,12,45
AaB,2591,5,8,13,9,38,41,-3,37
AC Horsens,2591,6,6,15,9,36,51,-15,33
Sonderjyske,2591,7,8,6,10,28,29,-1,30
Lyngby,2591,8,4,9,11,29,44,-15,21
Randers FC,2591,9,5,6,13,23,42,-19,21
Silkeborg IF,2591,10,5,4,13,26,45,-19,19
AGF Aarhus,2591,11,4,7,11,17,37,-20,19
Brondby,2592,1,22,6,2,73,30,43,72
FC Midtjylla,2592,2,18,6,6,63,40,23,60
FC Nords,2592,3,14,8,8,74,48,26,50
Copenhagen,2592,4,14,6,10,59,44,15,48
AaB,2592,5,6,13,11,36,49,-13,31
AC Horsens,2592,6,6,13,11,33,53,-20,31
Sonderjyske,2592,7,8,6,10,28,29,-1,30
Randers FC,2592,8,5,7,12,23,39,-16,22
AGF Aarhus,2592,9,5,6,11,18,36,-18,21
Lyngby,2592,10,3,10,11,26,44,-18,19
Silkeborg IF,2592,11,5,3,14,25,46,-21,18
Brondby,2593,1,21,6,3,76,37,39,69
FC Midtjylla,2593,2,18,6,6,68,43,25,60
FC Nords,2593,3,15,7,8,75,53,22,52
Copenhagen,2593,4,13,6,11,54,42,12,45
AaB,2593,5,8,11,11,38,44,-6,35
AC Horsens,2593,6,6,14,10,35,53,-18,32
Sonderjyske,2593,7,8,6,10,28,29,-1,30
Lyngby,2593,8,4,9,11,30,45,-15,21
AGF Aarhus,2593,9,5,6,11,18,36,-18,21
Randers FC,2593,10,5,6,13,24,43,-19,21
Silkeborg IF,2593,11,5,3,14,25,46,-21,18
Brondby,2594,1,22,6,2,72,28,44,72
FC Midtjylla,2594,2,18,4,8,64,40,24,58
FC Nords,2594,3,13,8,9,74,61,13,47
Copenhagen,2594,4,14,5,11,55,44,11,47
AaB,2594,5,9,11,10,39,41,-2,38
AC Horsens,2594,6,7,12,11,36,52,-16,33
Sonderjyske,2594,7,8,6,10,28,29,-1,30
Lyngby,2594,8,4,9,11,28,45,-17,21
Randers FC,2594,9,5,6,13,24,41,-17,21
AGF Aarhus,2594,10,5,6,11,17,36,-19,21
Silkeborg IF,2594,11,5,3,14,25,45,-20,18
Brondby,2595,1,21,5,4,72,31,41,68
FC Midtjylla,2595,2,21,5,4,69,34,35,68
FC Nords,2595,3,15,6,9,72,58,14,51
Copenhagen,2595,4,13,6,11,55,42,13,45
AaB,2595,5,7,11,12,34,45,-11,32
AC Horsens,2595,6,6,13,11,34,52,-18,31
Sonderjyske,2595,7,8,6,10,28,29,-1,30
Randers FC,2595,8,6,6,12,25,40,-15,24
AGF Aarhus,2595,9,5,6,11,19,36,-17,21
Lyngby,2595,10,3,9,12,27,46,-19,18
Silkeborg IF,2595,11,5,3,14,25,47,-22,18
FC Midtjylla,2596,1,22,4,4,66,34,32,70
Brondby,2596,2,21,6,3,72,36,36,69
FC Nords,2596,3,13,7,10,72,54,18,46
Copenhagen,2596,4,13,5,12,57,48,9,44
AaB,2596,5,7,12,11,38,43,-5,33
AC Horsens,2596,6,6,14,10,37,53,-16,32
Sonderjyske,2596,7,8,6,10,28,29,-1,30
Randers FC,2596,8,5,7,12,23,39,-16,22
Lyngby,2596,9,3,10,11,26,44,-18,19
Silkeborg IF,2596,10,5,4,13,26,45,-19,19
AGF Aarhus,2596,11,4,7,11,17,37,-20,19
Brondby,2597,1,21,7,2,75,34,41,70
FC Midtjylla,2597,2,19,5,6,69,46,23,62
FC Nords,2597,3,13,9,8,71,50,21,48
Copenhagen,2597,4,14,6,10,58,44,14,48
AaB,2597,5,7,11,12,34,42,-8,32
AC Horsens,2597,6,6,14,10,32,49,-17,32
Sonderjyske,2597,7,8,6,10,28,29,-1,30
Randers FC,2597,8,6,6,12,24,39,-15,24
Silkeborg IF,2597,9,5,4,13,25,44,-19,19
AGF Aarhus,2597,10,4,7,11,16,36,-20,19
Lyngby,2597,11,3,9,12,26,45,-19,18
FC Midtjylla,2598,1,20,5,5,63,39,24,65
Brondby,2598,2,19,6,5,66,33,33,63
FC Nords,2598,3,16,6,8,75,47,28,54
Copenhagen,2598,4,14,4,12,58,48,10,46
AaB,2598,5,8,12,10,36,39,-3,36
AC Horsens,2598,6,6,13,11,34,52,-18,31
Sonderjyske,2598,7,8,6,10,28,29,-1,30
Randers FC,2598,8,5,7,12,24,40,-16,22
AGF Aarhus,2598,9,5,6,11,18,36,-18,21
Lyngby,2598,10,3,10,11,27,45,-18,19
Silkeborg IF,2598,11,5,3,14,25,46,-21,18
Brondby,2599,1,20,6,4,66,31,35,66
FC Midtjylla,2599,2,19,6,5,65,38,27,63
FC Nords,2599,3,16,6,8,82,51,31,54
Copenhagen,2599,4,14,5,11,60,48,12,47
AaB,2599,5,7,12,11,35,43,-8,33
AC Horsens,2599,6,6,13,11,33,56,-23,31
Sonderjyske,2599,7,8,6,10,28,29,-1,30
Randers FC,2599,8,6,6,12,25,40,-15,24
Silkeborg IF,2599,9,6,3,13,27,45,-18,21
Lyngby,2599,10,3,9,12,27,46,-19,18
AGF Aarhus,2599,11,4,6,12,17,38,-21,18
Brondby,2600,1,21,6,3,74,31,43,69
FC Midtjylla,2600,2,18,5,7,60,39,21,59
Copenhagen,2600,3,16,4,10,59,43,16,52
FC Nords,2600,4,12,7,11,70,60,10,43
AaB,2600,5,9,11,10,41,45,-4,38
AC Horsens,2600,6,7,13,10,37,49,-12,34
Sonderjyske,2600,7,8,6,10,28,29,-1,30
Randers FC,2600,8,6,6,12,25,40,-15,24
AGF Aarhus,2600,9,5,6,11,18,37,-19,21
Lyngby,2600,10,3,9,12,27,46,-19,18
Silkeborg IF,2600,11,5,3,14,26,46,-20,18
Brondby,2601,1,22,6,2,73,31,42,72
FC Midtjylla,2601,2,19,4,7,60,43,17,61
FC Nords,2601,3,15,6,9,77,52,25,51
Copenhagen,2601,4,14,5,11,60,46,14,47
AaB,2601,5,8,12,10,38,40,-2,36
Sonderjyske,2601,6,8,6,10,28,29,-1,30
AC Horsens,2601,7,5,13,12,31,53,-22,28
Randers FC,2601,8,6,6,12,25,40,-15,24
Silkeborg IF,2601,9,6,3,13,27,45,-18,21
Lyngby,2601,10,3,9,12,27,46,-19,18
AGF Aarhus,2601,11,4,6,12,17,38,-21,18
Brondby,2602,1,21,5,4,78,38,40,68
FC Midtjylla,2602,2,18,5,7,65,42,23,59
FC Nords,2602,3,14,8,8,81,57,24,50
Copenhagen,2602,4,13,6,11,61,49,12,45
AaB,2602,5,8,12,10,39,45,-6,36
AC Horsens,2602,6,8,12,10,39,58,-19,36
Sonderjyske,2602,7,8,6,10,28,29,-1,30
Lyngby,2602,8,4,9,11,27,44,-17,21
Randers FC,2602,9,5,6,13,23,40,-17,21
Silkeborg IF,2602,10,5,4,13,26,45,-19,19
AGF Aarhus,2602,11,4,7,11,17,37,-20,19
Brondby,2603,1,19,9,2,68,30,38,66
FC Midtjylla,2603,2,18,6,6,63,41,22,60
Copenhagen,2603,3,15,6,9,63,45,18,51
FC Nords,2603,4,13,9,8,74,51,23,48
AaB,2603,5,7,15,8,39,41,-2,36
Sonderjyske,2603,6,8,6,10,28,29,-1,30
AC Horsens,2603,7,5,13,12,34,59,-25,28
Lyngby,2603,8,4,9,11,28,44,-16,21
Silkeborg IF,2603,9,6,3,13,27,45,-18,21
Randers FC,2603,10,5,6,13,23,41,-18,21
AGF Aarhus,2603,11,4,6,12,17,38,-21,18
Brondby,2604,1,22,6,2,80,31,49,72
FC Midtjylla,2604,2,19,6,5,65,39,26,63
FC Nords,2604,3,15,6,9,74,54,20,51
Copenhagen,2604,4,13,5,12,55,48,7,44
AC Horsens,2604,5,7,12,11,36,52,-16,33
AaB,2604,6,6,13,11,34,46,-12,31
Sonderjyske,2604,7,8,6,10,28,29,-1,30
Lyngby,2604,8,4,9,11,28,44,-16,21
AGF Aarhus,2604,9,5,6,11,19,36,-17,21
Randers FC,2604,10,5,6,13,23,41,-18,21
Silkeborg IF,2604,11,5,3,14,25,47,-22,18
Brondby,2605,1,22,6,2,72,31,41,72
FC Midtjylla,2605,2,18,4,8,63,45,18,58
FC Nords,2605,3,14,7,9,72,50,22,49
Copenhagen,2605,4,14,6,10,60,45,15,48
AaB,2605,5,8,11,11,37,43,-6,35
AC Horsens,2605,6,7,12,11,34,50,-16,33
Sonderjyske,2605,7,8,6,10,28,29,-1,30
Randers FC,2605,8,6,6,12,25,39,-14,24
AGF Aarhus,2605,9,5,6,11,18,37,-19,21
Lyngby,2605,10,3,9,12,26,46,-20,18
Silkeborg IF,2605,10,5,3,14,26,46,-20,18
Brondby,2606,1,20,7,3,73,34,39,67
FC Midtjylla,2606,2,19,6,5,68,38,30,63
Copenhagen,2606,3,14,5,11,55,46,9,47
FC Nords,2606,4,13,7,10,68,52,16,46
AaB,2606,5,9,12,9,44,40,4,39
AC Horsens,2606,6,6,13,11,32,56,-24,31
Sonderjyske,2606,7,8,6,10,28,29,-1,30
Randers FC,2606,8,5,7,12,24,40,-16,22
Silkeborg IF,2606,9,6,3,13,27,44,-17,21
Lyngby,2606,10,3,10,11,27,45,-18,19
AGF Aarhus,2606,11,4,6,12,16,38,-22,18
Brondby,2607,1,20,7,3,69,32,37,67
FC Midtjylla,2607,2,21,4,5,70,38,32,67
Copenhagen,2607,3,14,5,11,58,44,14,47
FC Nords,2607,4,13,7,10,70,52,18,46
AaB,2607,5,7,13,10,33,42,-9,34
AC Horsens,2607,6,7,12,11,33,51,-18,33
Sonderjyske,2607,7,8,6,10,28,29,-1,30
Randers FC,2607,8,6,6,12,25,39,-14,24
Silkeborg IF,2607,9,6,3,13,26,44,-18,21
Lyngby,2607,10,3,9,12,26,46,-20,18
AGF Aarhus,2607,11,4,6,12,16,37,-21,18
Brondby,2608,1,20,6,4,68,33,35,66
FC Midtjylla,2608,2,20,5,5,69,37,32,65
FC Nords,2608,3,16,7,7,79,47,32,55
Copenhagen,2608,4,13,4,13,53,51,2,43
AC Horsens,2608,5,7,13,10,34,51,-17,34
AaB,2608,6,7,11,12,37,47,-10,32
Sonderjyske,2608,7,8,6,10,28,29,-1,30
Lyngby,2608,8,4,9,11,27,44,-17,21
Randers FC,2608,9,5,6,13,23,40,-17,21
Silkeborg IF,2608,10,5,4,13,26,45,-19,19
AGF Aarhus,2608,11,4,7,11,17,37,-20,19
FC Midtjylla,2609,1,20,6,4,67,38,29,66
Brondby,2609,2,19,7,4,68,34,34,64
FC Nords,2609,3,14,8,8,74,52,22,50
Copenhagen,2609,4,13,6,11,57,46,11,45
AaB,2609,5,9,11,10,37,40,-3,38
Sonderjyske,2609,6,8,6,10,28,29,-1,30
AC Horsens,2609,7,6,12,12,33,52,-19,30
Lyngby,2609,8,4,9,11,29,45,-16,21
Randers FC,2609,9,5,6,13,24,42,-18,21
AGF Aarhus,2609,10,5,6,11,20,38,-18,21
Silkeborg IF,2609,11,5,3,14,27,48,-21,18
Brondby,2610,1,19,8,3,68,30,38,65
FC Midtjylla,2610,2,18,6,6,66,41,25,60
FC Nords,2610,3,14,8,8,71,48,23,50
Copenhagen,2610,4,13,6,11,56,45,11,45
AaB,2610,5,10,12,8,40,39,1,42
Sonderjyske,2610,6,8,6,10,28,29,-1,30
AC Horsens,2610,7,5,14,11,35,59,-24,29
Lyngby,2610,8,4,9,11,29,46,-17,21
Randers FC,2610,9,5,6,13,25,42,-17,21
Silkeborg IF,2610,10,6,3,13,28,46,-18,21
AGF Aarhus,2610,11,4,6,12,18,39,-21,18
Brondby,2611,1,20,5,5,74,39,35,65
FC Midtjylla,2611,2,19,6,5,65,40,25,63
FC Nords,2611,3,16,6,8,80,53,27,54
Copenhagen,2611,4,14,5,11,61,49,12,47
AaB,2611,5,7,12,11,36,43,-7,33
AC Horsens,2611,6,6,14,10,36,54,-18,32
Sonderjyske,2611,7,8,6,10,28,29,-1,30
Randers FC,2611,8,6,6,12,24,39,-15,24
Silkeborg IF,2611,9,5,4,13,27,46,-19,19
AGF Aarhus,2611,10,4,7,11,18,38,-20,19
Lyngby,2611,11,3,9,12,26,45,-19,18
Brondby,2612,1,21,5,4,70,34,36,68
FC Midtjylla,2612,2,20,6,4,64,37,27,66
FC Nords,2612,3,16,7,7,76,47,29,55
Copenhagen,2612,4,12,5,13,52,44,8,41
AaB,2612,5,7,13,10,36,42,-6,34
Sonderjyske,2612,6,8,6,10,28,29,-1,30
AC Horsens,2612,7,6,12,12,32,52,-20,30
Lyngby,2612,8,4,9,11,28,44,-16,21
Randers FC,2612,9,5,6,13,23,41,-18,21
AGF Aarhus,2612,10,5,6,11,17,36,-19,21
Silkeborg IF,2612,11,5,3,14,25,45,-20,18
Brondby,2613,1,21,6,3,71,31,40,69
FC Midtjylla,2613,2,20,4,6,66,43,23,64
FC Nords,2613,3,15,6,9,75,50,25,51
Copenhagen,2613,4,13,5,12,56,47,9,44
AaB,2613,5,9,11,10,38,40,-2,38
Sonderjyske,2613,6,8,6,10,28,29,-1,30
AC Horsens,2613,7,6,12,12,35,56,-21,30
Lyngby,2613,8,4,9,11,29,45,-16,21
Randers FC,2613,9,5,6,13,24,42,-18,21
Silkeborg IF,2613,10,5,4,13,25,44,-19,19
AGF Aarhus,2613,11,4,7,11,16,36,-20,19
Brondby,2614,1,22,6,2,74,29,45,72
FC Midtjylla,2614,2,19,5,6,65,42,23,62
Copenhagen,2614,3,15,5,10,60,42,18,50
FC Nords,2614,4,13,7,10,73,55,18,46
AaB,2614,5,8,12,10,37,43,-6,36
Sonderjyske,2614,6,8,6,10,28,29,-1,30
AC Horsens,2614,7,5,13,12,34,58,-24,28
Lyngby,2614,8,4,9,11,28,44,-16,21
Randers FC,2614,9,5,6,13,23,41,-18,21
Silkeborg IF,2614,10,5,4,13,28,47,-19,19
AGF Aarhus,2614,11,4,7,11,19,39,-20,19
Brondby,2615,1,21,5,4,73,31,42,68
FC Midtjylla,2615,2,20,5,5,67,38,29,65
FC Nords,2615,3,14,6,10,68,49,19,48
Copenhagen,2615,4,14,5,11,60,49,11,47
AaB,2615,5,7,13,10,36,43,-7,34
AC Horsens,2615,6,7,12,11,36,56,-20,33
Sonderjyske,2615,7,8,6,10,28,29,-1,30
Randers FC,2615,8,5,7,12,24,40,-16,22
Silkeborg IF,2615,9,6,3,13,28,46,-18,21
Lyngby,2615,10,3,10,11,27,45,-18,19
AGF Aarhus,2615,11,4,6,12,18,39,-21,18
FC Midtjylla,2616,1,20,6,4,70,40,30,66
Brondby,2616,2,19,7,4,71,35,36,64
FC Nords,2616,3,15,7,8,81,53,28,52
Copenhagen,2616,4,14,4,12,58,47,11,46
AaB,2616,5,8,11,11,37,47,-10,35
AC Horsens,2616,6,6,13,11,36,57,-21,31
Sonderjyske,2616,7,8,6,10,28,29,-1,30
Lyngby,2616,8,4,9,11,27,44,-17,21
Randers FC,2616,9,5,6,13,23,40,-17,21
AGF Aarhus,2616,10,5,6,11,18,37,-19,21
Silkeborg IF,2616,11,5,3,14,26,46,-20,18
Brondby,2617,1,21,6,3,72,32,40,69
FC Midtjylla,2617,2,19,4,7,60,37,23,61
Copenhagen,2617,3,16,5,9,66,48,18,53
FC Nords,2617,4,14,7,9,72,51,21,49
AaB,2617,5,7,11,12,34,45,-11,32
AC Horsens,2617,6,6,13,11,39,56,-17,31
Sonderjyske,2617,7,8,6,10,28,29,-1,30
Randers FC,2617,8,5,7,12,26,42,-16,22
Silkeborg IF,2617,9,6,3,13,28,45,-17,21
Lyngby,2617,10,3,10,11,29,47,-18,19
AGF Aarhus,2617,11,4,6,12,17,39,-22,18
Brondby,2618,1,20,7,3,73,35,38,67
FC Midtjylla,2618,2,19,5,6,66,47,19,62
FC Nords,2618,3,14,7,9,72,53,19,49
Copenhagen,2618,4,15,4,11,66,47,19,49
AaB,2618,5,7,14,9,38,41,-3,35
AC Horsens,2618,6,6,13,11,36,54,-18,31
Sonderjyske,2618,7,8,6,10,28,29,-1,30
Randers FC,2618,8,6,6,12,25,40,-15,24
Silkeborg IF,2618,9,6,3,13,29,46,-17,21
Lyngby,2618,10,3,9,12,27,46,-19,18
AGF Aarhus,2618,11,4,6,12,18,40,-22,18
Brondby,2619,1,20,5,5,67,32,35,65
FC Midtjylla,2619,2,19,6,5,65,40,25,63
FC Nords,2619,3,16,7,7,73,48,25,55
Copenhagen,2619,4,13,7,10,55,42,13,46
AC Horsens,2619,5,7,12,11,34,51,-17,33
AaB,2619,6,6,13,11,33,40,-7,31
Sonderjyske,2619,7,8,6,10,28,29,-1,30
Randers FC,2619,8,6,6,12,24,39,-15,24
Silkeborg IF,2619,9,5,4,13,26,45,-19,19
AGF Aarhus,2619,10,4,7,11,17,37,-20,19
Lyngby,2619,11,3,9,12,26,45,-19,18
Brondby,2620,1,22,5,3,73,32,41,71
FC Midtjylla,2620,2,19,5,6,64,42,22,62
FC Nords,2620,3,15,7,8,73,47,26,52
Copenhagen,2620,4,13,5,12,54,45,9,44
AaB,2620,5,8,12,10,36,40,-4,36
Sonderjyske,2620,6,8,6,10,28,29,-1,30
AC Horsens,2620,7,5,14,11,36,56,-20,29
Lyngby,2620,8,4,9,11,28,44,-16,21
Randers FC,2620,9,5,6,13,23,41,-18,21
Silkeborg IF,2620,10,5,4,13,26,45,-19,19
AGF Aarhus,2620,11,4,7,11,17,37,-20,19
Brondby,2621,1,20,6,4,71,33,38,66
FC Midtjylla,2621,2,18,5,7,63,46,17,59
Copenhagen,2621,3,16,5,9,66,44,22,53
FC Nords,2621,4,15,7,8,76,48,28,52
AaB,2621,5,7,12,11,38,47,-9,33
AC Horsens,2621,6,6,13,11,38,60,-22,31
Sonderjyske,2621,7,8,6,10,28,29,-1,30
Randers FC,2621,8,6,6,12,26,41,-15,24
AGF Aarhus,2621,9,5,6,11,17,36,-19,21
Lyngby,2621,10,3,9,12,28,47,-19,18
Silkeborg IF,2621,11,5,3,14,25,45,-20,18
Brondby,2622,1,23,5,2,75,28,47,74
FC Midtjylla,2622,2,19,4,7,63,41,22,61
FC Nords,2622,3,14,6,10,73,55,18,48
Copenhagen,2622,4,13,5,12,59,52,7,44
AaB,2622,5,9,11,10,37,41,-4,38
AC Horsens,2622,6,6,13,11,36,52,-16,31
Sonderjyske,2622,7,8,6,10,28,29,-1,30
Randers FC,2622,8,6,6,12,24,39,-15,24
Silkeborg IF,2622,9,6,3,13,28,44,-16,21
Lyngby,2622,10,3,9,12,26,45,-19,18
AGF Aarhus,2622,11,4,6,12,16,39,-23,18
Brondby,2623,1,23,5,2,68,26,42,74
FC Midtjylla,2623,2,19,5,6,62,36,26,62
Copenhagen,2623,3,15,4,11,58,44,14,49
FC Nords,2623,4,13,6,11,70,52,18,45
AaB,2623,5,8,11,11,38,45,-7,35
AC Horsens,2623,6,6,13,11,35,54,-19,31
Sonderjyske,2623,7,8,6,10,28,29,-1,30
Randers FC,2623,8,6,6,12,25,40,-15,24
Silkeborg IF,2623,9,6,3,13,28,45,-17,21
Lyngby,2623,10,3,9,12,27,46,-19,18
AGF Aarhus,2623,11,4,6,12,17,39,-22,18
Brondby,2624,1,21,6,3,73,34,39,69
FC Midtjylla,2624,2,20,5,5,69,40,29,65
FC Nords,2624,3,15,8,7,78,51,27,53
Copenhagen,2624,4,13,5,12,58,49,9,44
AaB,2624,5,7,13,10,38,44,-6,34
Sonderjyske,2624,6,8,6,10,28,29,-1,30
AC Horsens,2624,7,5,13,12,34,58,-24,28
Lyngby,2624,8,4,9,11,27,44,-17,21
Randers FC,2624,9,5,6,13,23,40,-17,21
Silkeborg IF,2624,10,5,4,13,25,44,-19,19
AGF Aarhus,2624,11,4,7,11,16,36,-20,19
Brondby,2625,1,21,7,2,73,32,41,70
FC Midtjylla,2625,2,21,4,5,63,38,25,67
FC Nords,2625,3,14,7,9,71,48,23,49
Copenhagen,2625,4,13,6,11,55,43,12,45
AaB,2625,5,6,13,11,36,44,-8,31
AC Horsens,2625,6,6,13,11,34,53,-19,31
Sonderjyske,2625,7,8,6,10,28,29,-1,30
Lyngby,2625,8,4,9,11,29,45,-16,21
Silkeborg IF,2625,9,6,3,13,28,46,-18,21
Randers FC,2625,10,5,6,13,24,42,-18,21
AGF Aarhus,2625,11,4,6,12,18,39,-21,18
Brondby,2626,1,19,8,3,68,33,35,65
FC Midtjylla,2626,2,19,5,6,62,41,21,62
FC Nords,2626,3,15,6,9,76,53,23,51
Copenhagen,2626,4,13,7,10,56,42,14,46
AC Horsens,2626,5,7,14,9,39,52,-13,35
AaB,2626,6,6,14,10,34,40,-6,32
Sonderjyske,2626,7,8,6,10,28,29,-1,30
Randers FC,2626,8,5,7,12,26,42,-16,22
Silkeborg IF,2626,9,6,3,13,28,45,-17,21
Lyngby,2626,10,3,10,11,29,47,-18,19
AGF Aarhus,2626,11,4,6,12,17,39,-22,18
Brondby,2627,1,22,6,2,72,29,43,72
FC Midtjylla,2627,2,19,6,5,63,41,22,63
FC Nords,2627,3,14,7,9,73,53,20,49
Copenhagen,2627,4,14,6,10,62,45,17,48
AaB,2627,5,7,12,11,34,43,-9,33
Sonderjyske,2627,6,8,6,10,28,29,-1,30
AC Horsens,2627,7,5,13,12,34,53,-19,28
Lyngby,2627,8,4,9,11,28,45,-17,21
Randers FC,2627,9,5,6,13,24,41,-17,21
Silkeborg IF,2627,10,5,4,13,26,45,-19,19
AGF Aarhus,2627,11,4,7,11,17,37,-20,19
Brondby,2628,1,21,6,3,74,33,41,69
FC Midtjylla,2628,2,19,5,6,61,37,24,62
FC Nords,2628,3,14,6,10,71,55,16,48
Copenhagen,2628,4,13,5,12,56,46,10,44
AaB,2628,5,9,13,8,41,39,2,40
AC Horsens,2628,6,6,13,11,38,57,-19,31
Sonderjyske,2628,7,8,6,10,28,29,-1,30
Randers FC,2628,8,6,6,12,25,40,-15,24
AGF Aarhus,2628,9,5,6,11,17,36,-19,21
Lyngby,2628,10,3,9,12,27,46,-19,18
Silkeborg IF,2628,11,5,3,14,25,45,-20,18
Brondby,2629,1,20,6,4,70,36,34,66
FC Midtjylla,2629,2,19,5,6,65,41,24,62
FC Nords,2629,3,15,8,7,69,45,24,53
Copenhagen,2629,4,15,4,11,58,42,16,49
AC Horsens,2629,5,6,14,10,33,50,-17,32
AaB,2629,6,6,13,11,38,45,-7,31
Sonderjyske,2629,7,8,6,10,28,29,-1,30
Randers FC,2629,8,5,7,12,24,40,-16,22
AGF Aarhus,2629,9,5,6,11,18,36,-18,21
Lyngby,2629,10,3,10,11,27,45,-18,19
Silkeborg IF,2629,11,5,3,14,25,46,-21,18
Brondby,2630,1,21,6,3,75,36,39,69
FC Midtjylla,2630,2,19,6,5,70,41,29,63
FC Nords,2630,3,15,6,9,76,58,18,51
Copenhagen,2630,4,12,7,11,57,48,9,43
AaB,2630,5,7,14,9,39,43,-4,35
AC Horsens,2630,6,6,13,11,37,54,-17,31
Sonderjyske,2630,7,8,6,10,28,29,-1,30
Lyngby,2630,8,4,9,11,29,44,-15,21
Silkeborg IF,2630,9,6,3,13,28,45,-17,21
Randers FC,2630,10,5,6,13,23,42,-19,21
AGF Aarhus,2630,11,4,6,12,17,39,-22,18
Brondby,2631,1,19,7,4,65,31,34,64
FC Midtjylla,2631,2,19,4,7,64,41,23,61
FC Nords,2631,3,15,7,8,71,50,21,52
Copenhagen,2631,4,14,6,10,60,42,18,48
AaB,2631,5,7,13,10,36,41,-5,34
AC Horsens,2631,6,7,13,10,33,50,-17,34
Sonderjyske,2631,7,8,6,10,28,29,-1,30
Randers FC,2631,8,5,7,12,24,40,-16,22
AGF Aarhus,2631,9,5,6,11,18,37,-19,21
Lyngby,2631,10,3,10,11,27,45,-18,19
Silkeborg IF,2631,11,5,3,14,26,46,-20,18
FC Midtjylla,2632,1,21,4,5,66,37,29,67
Brondby,2632,2,20,5,5,68,35,33,65
FC Nords,2632,3,15,6,9,75,53,22,51
Copenhagen,2632,4,15,5,10,57,42,15,50
AaB,2632,5,7,13,10,36,42,-6,34
Sonderjyske,2632,6,8,6,10,28,29,-1,30
AC Horsens,2632,7,5,13,12,34,53,-19,28
Randers FC,2632,8,6,6,12,26,41,-15,24
AGF Aarhus,2632,9,5,6,11,19,38,-19,21
Lyngby,2632,10,3,9,12,28,47,-19,18
Silkeborg IF,2632,11,5,3,14,27,47,-20,18
Brondby,2633,1,21,5,4,71,33,38,68
FC Midtjylla,2633,2,19,6,5,63,39,24,63
FC Nords,2633,3,14,8,8,77,50,27,50
Copenhagen,2633,4,14,6,10,59,48,11,48
AaB,2633,5,7,13,10,38,43,-5,34
Sonderjyske,2633,6,8,6,10,28,29,-1,30
AC Horsens,2633,7,6,12,12,33,54,-21,30
Randers FC,2633,8,6,6,12,24,39,-15,24
Silkeborg IF,2633,9,5,4,13,26,45,-19,19
AGF Aarhus,2633,10,4,7,11,17,37,-20,19
Lyngby,2633,11,3,9,12,26,45,-19,18
Brondby,2634,1,20,6,4,74,38,36,66
FC Midtjylla,2634,2,20,4,6,69,41,28,64
FC Nords,2634,3,14,7,9,73,52,21,49
Copenhagen,2634,4,15,4,11,59,45,14,49
AaB,2634,5,7,12,11,37,45,-8,33
AC Horsens,2634,6,6,15,9,35,52,-17,33
Sonderjyske,2634,7,8,6,10,28,29,-1,30
Randers FC,2634,8,5,7,12,23,39,-16,22
AGF Aarhus,2634,9,5,6,11,18,37,-19,21
Lyngby,2634,10,3,10,11,26,44,-18,19
Silkeborg IF,2634,11,5,3,14,26,46,-20,18
Brondby,2635,1,21,5,4,71,34,37,68
FC Midtjylla,2635,2,18,5,7,64,39,25,59
FC Nords,2635,3,15,6,9,77,48,29,51
Copenhagen,2635,4,12,5,13,51,48,3,41
AaB,2635,5,10,11,9,40,39,1,41
AC Horsens,2635,6,8,12,10,34,55,-21,36
Sonderjyske,2635,7,8,6,10,28,29,-1,30
Lyngby,2635,8,4,9,11,28,44,-16,21
Silkeborg IF,2635,8,6,3,13,28,44,-16,21
Randers FC,2635,10,5,6,13,23,41,-18,21
AGF Aarhus,2635,11,4,6,12,16,39,-23,18
Brondby,2636,1,21,7,2,74,31,43,70
FC Midtjylla,2636,2,19,5,6,65,42,23,62
Copenhagen,2636,3,15,6,9,59,41,18,51
FC Nords,2636,4,13,7,10,76,55,21,46
AaB,2636,5,6,14,10,33,44,-11,32
AC Horsens,2636,6,6,13,11,36,56,-20,31
Sonderjyske,2636,7,8,6,10,28,29,-1,30
Randers FC,2636,8,5,7,12,25,41,-16,22
Silkeborg IF,2636,9,6,3,13,27,45,-18,21
Lyngby,2636,10,3,10,11,28,46,-18,19
AGF Aarhus,2636,11,4,6,12,17,38,-21,18
Brondby,2637,1,21,5,4,73,34,39,68
FC Midtjylla,2637,2,21,5,4,71,39,32,68
FC Nords,2637,3,14,6,10,74,56,18,48
Copenhagen,2637,4,13,5,12,58,51,7,44
AaB,2637,5,8,11,11,36,42,-6,35
AC Horsens,2637,6,7,12,11,35,51,-16,33
Sonderjyske,2637,7,8,6,10,28,29,-1,30
Randers FC,2637,8,6,6,12,25,40,-15,24
Silkeborg IF,2637,9,6,3,13,26,44,-18,21
Lyngby,2637,10,3,9,12,27,46,-19,18
AGF Aarhus,2637,11,4,6,12,16,37,-21,18
FC Midtjylla,2638,1,22,4,4,68,35,33,70
Brondby,2638,2,20,6,4,67,35,32,66
FC Nords,2638,3,14,6,10,69,52,17,48
Copenhagen,2638,4,13,4,13,55,47,8,43
AaB,2638,5,7,13,10,38,42,-4,34
AC Horsens,2638,6,7,13,10,39,51,-12,34
Sonderjyske,2638,7,8,6,10,28,29,-1,30
Lyngby,2638,8,4,9,11,27,44,-17,21
Randers FC,2638,9,5,6,13,23,40,-17,21
Silkeborg IF,2638,10,6,3,13,27,45,-18,21
AGF Aarhus,2638,11,4,6,12,17,38,-21,18
Brondby,2639,1,23,5,2,73,27,46,74
FC Midtjylla,2639,2,19,4,7,64,38,26,61
FC Nords,2639,3,15,7,8,76,50,26,52
Copenhagen,2639,4,15,4,11,59,44,15,49
AaB,2639,5,7,12,11,35,43,-8,33
Sonderjyske,2639,6,8,6,10,28,29,-1,30
AC Horsens,2639,7,5,12,13,29,60,-31,27
Randers FC,2639,8,5,7,12,24,40,-16,22
Silkeborg IF,2639,9,6,3,13,27,45,-18,21
Lyngby,2639,10,3,10,11,27,45,-18,19
AGF Aarhus,2639,11,4,6,12,17,38,-21,18
Brondby,2640,1,21,6,3,73,33,40,69
FC Midtjylla,2640,2,18,5,7,65,45,20,59
FC Nords,2640,3,16,7,7,80,51,29,55
Copenhagen,2640,4,14,7,9,64,47,17,49
AaB,2640,5,7,11,12,35,48,-13,32
Sonderjyske,2640,6,8,6,10,28,29,-1,30
AC Horsens,2640,7,6,12,12,35,54,-19,30
Randers FC,2640,8,6,6,12,24,39,-15,24
Silkeborg IF,2640,9,6,3,13,28,44,-16,21
Lyngby,2640,10,3,9,12,26,45,-19,18
AGF Aarhus,2640,11,4,6,12,16,39,-23,18
FC Midtjylla,2641,1,21,4,5,70,38,32,67
Brondby,2641,2,19,7,4,71,32,39,64
FC Nords,2641,3,14,7,9,70,57,13,49
Copenhagen,2641,4,14,5,11,58,44,14,47
AC Horsens,2641,5,7,13,10,40,53,-13,34
AaB,2641,6,7,12,11,35,46,-11,33
Sonderjyske,2641,7,8,6,10,28,29,-1,30
Lyngby,2641,8,4,9,11,28,44,-16,21
Randers FC,2641,9,5,6,13,23,41,-18,21
Silkeborg IF,2641,10,5,4,13,26,45,-19,19
AGF Aarhus,2641,11,4,7,11,17,37,-20,19
FC Midtjylla,2642,1,20,4,6,67,40,27,64
Brondby,2642,2,19,5,6,68,38,30,62
FC Nords,2642,3,14,9,7,71,47,24,51
Copenhagen,2642,4,15,6,9,63,46,17,51
AaB,2642,5,8,12,10,37,42,-5,36
Sonderjyske,2642,6,8,6,10,28,29,-1,30
AC Horsens,2642,7,5,14,11,37,56,-19,29
Randers FC,2642,8,5,7,12,24,40,-16,22
AGF Aarhus,2642,9,5,6,11,19,36,-17,21
Lyngby,2642,10,3,10,11,27,45,-18,19
Silkeborg IF,2642,11,5,3,14,25,47,-22,18
Brondby,2643,1,21,5,4,76,36,40,68
FC Midtjylla,2643,2,20,4,6,68,38,30,64
FC Nords,2643,3,16,6,8,73,49,24,54
Copenhagen,2643,4,14,4,12,59,47,12,46
AC Horsens,2643,5,7,12,11,38,58,-20,33
AaB,2643,6,7,11,12,39,51,-12,32
Sonderjyske,2643,7,8,6,10,28,29,-1,30
Lyngby,2643,8,4,9,11,29,45,-16,21
Randers FC,2643,9,5,6,13,24,42,-18,21
Silkeborg IF,2643,10,5,4,13,26,45,-19,19
AGF Aarhus,2643,11,4,7,11,17,37,-20,19
Brondby,2644,1,22,5,3,72,29,43,71
FC Midtjylla,2644,2,20,4,6,68,41,27,64
Copenhagen,2644,3,14,5,11,57,44,13,47
FC Nords,2644,4,13,7,10,70,56,14,46
AC Horsens,2644,5,7,13,10,37,52,-15,34
AaB,2644,6,7,12,11,35,43,-8,33
Sonderjyske,2644,7,8,6,10,28,29,-1,30
Randers FC,2644,8,6,6,12,24,39,-15,24
Silkeborg IF,2644,9,5,4,13,26,45,-19,19
AGF Aarhus,2644,10,4,7,11,17,37,-20,19
Lyngby,2644,11,3,9,12,26,45,-19,18
Brondby,2645,1,19,8,3,69,31,38,65
FC Midtjylla,2645,2,19,7,4,65,39,26,64
FC Nords,2645,3,15,7,8,75,50,25,52
Copenhagen,2645,4,13,6,11,57,46,11,45
AaB,2645,5,7,13,10,34,41,-7,34
AC Horsens,2645,6,6,13,11,37,56,-19,31
Sonderjyske,2645,7,8,6,10,28,29,-1,30
Randers FC,2645,8,5,7,12,24,40,-16,22
Lyngby,2645,9,3,10,11,27,45,-18,19
Silkeborg IF,2645,10,5,4,13,28,47,-19,19
AGF Aarhus,2645,11,4,7,11,19,39,-20,19
Brondby,2646,1,19,8,3,69,33,36,65
FC Midtjylla,2646,2,20,5,5,69,41,28,65
Copenhagen,2646,3,15,5,10,62,45,17,50
FC Nords,2646,4,13,7,10,71,56,15,46
AaB,2646,5,9,12,9,42,44,-2,39
Sonderjyske,2646,6,8,6,10,28,29,-1,30
AC Horsens,2646,7,5,13,12,32,52,-20,28
Randers FC,2646,8,6,6,12,25,40,-15,24
AGF Aarhus,2646,9,5,6,11,17,36,-19,21
Lyngby,2646,10,3,9,12,27,46,-19,18
Silkeborg IF,2646,11,5,3,14,25,45,-20,18
Brondby,2647,1,21,5,4,69,34,35,68
FC Midtjylla,2647,2,20,6,4,68,37,31,66
FC Nords,2647,3,14,7,9,69,48,21,49
Copenhagen,2647,4,12,6,12,53,44,9,42
AaB,2647,5,8,12,10,37,42,-5,36
AC Horsens,2647,6,6,14,10,35,52,-17,32
Sonderjyske,2647,7,8,6,10,28,29,-1,30
Randers FC,2647,8,6,6,12,28,39,-11,24
AGF Aarhus,2647,9,5,6,11,17,36,-19,21
Silkeborg IF,2647,10,5,3,14,25,45,-20,18
Lyngby,2647,11,3,9,12,26,49,-23,18
Brondby,2648,1,23,5,2,78,32,46,74
FC Midtjylla,2648,2,19,6,5,66,42,24,63
FC Nords,2648,3,14,8,8,72,50,22,50
Copenhagen,2648,4,13,5,12,57,48,9,44
AaB,2648,5,7,12,11,39,47,-8,33
Sonderjyske,2648,6,8,6,10,28,29,-1,30
AC Horsens,2648,7,6,12,12,33,52,-19,30
Randers FC,2648,8,6,6,12,25,40,-15,24
Silkeborg IF,2648,9,6,3,13,27,44,-17,21
Lyngby,2648,10,3,9,12,27,46,-19,18
AGF Aarhus,2648,11,4,6,12,16,38,-22,18
Brondby,2649,1,21,6,3,70,31,39,69
FC Nords,2649,2,17,6,7,84,47,37,57
FC Midtjylla,2649,3,17,5,8,60,43,17,56
Copenhagen,2649,4,14,4,12,56,47,9,46
AC Horsens,2649,5,7,13,10,36,55,-19,34
AaB,2649,6,7,12,11,37,46,-9,33
Sonderjyske,2649,7,8,6,10,28,29,-1,30
Lyngby,2649,8,4,9,11,27,44,-17,21
Randers FC,2649,9,5,6,13,23,40,-17,21
Silkeborg IF,2649,10,5,4,13,25,44,-19,19
AGF Aarhus,2649,11,4,7,11,16,36,-20,19
Brondby,2650,1,20,7,3,70,34,36,67
FC Midtjylla,2650,2,19,6,5,62,35,27,63
FC Nords,2650,3,13,9,8,72,53,19,48
Copenhagen,2650,4,13,4,13,57,47,10,43
AaB,2650,5,8,13,9,41,43,-2,37
AC Horsens,2650,6,6,15,9,35,51,-16,33
Sonderjyske,2650,7,8,6,10,28,29,-1,30
Lyngby,2650,8,4,9,11,30,44,-14,21
AGF Aarhus,2650,9,5,6,11,19,37,-18,21
Randers FC,2650,10,5,6,13,23,43,-20,21
Silkeborg IF,2650,11,5,3,14,26,47,-21,18
Brondby,2651,1,20,5,5,68,33,35,65
FC Midtjylla,2651,2,20,4,6,63,36,27,64
FC Nords,2651,3,16,6,8,75,49,26,54
Copenhagen,2651,4,14,5,11,54,40,14,47
AC Horsens,2651,5,7,13,10,33,51,-18,34
AaB,2651,6,6,13,11,34,44,-10,31
Sonderjyske,2651,7,8,6,10,28,29,-1,30
Randers FC,2651,8,6,6,12,24,39,-15,24
AGF Aarhus,2651,9,5,6,11,21,37,-16,21
Lyngby,2651,10,3,9,12,26,45,-19,18
Silkeborg IF,2651,11,5,3,14,26,49,-23,18
Brondby,2652,1,19,8,3,70,33,37,65
FC Midtjylla,2652,2,18,7,5,67,39,28,61
FC Nords,2652,3,13,7,10,73,58,15,46
Copenhagen,2652,4,13,7,10,56,45,11,46
AaB,2652,5,8,13,9,39,40,-1,37
AC Horsens,2652,6,7,14,9,40,56,-16,35
Sonderjyske,2652,7,8,6,10,28,29,-1,30
Lyngby,2652,8,4,9,11,29,46,-17,21
Randers FC,2652,9,5,6,13,25,42,-17,21
Silkeborg IF,2652,10,6,3,13,26,44,-18,21
AGF Aarhus,2652,11,4,6,12,16,37,-21,18
Brondby,2653,1,22,5,3,74,33,41,71
FC Midtjylla,2653,2,22,4,4,71,38,33,70
FC Nords,2653,3,14,6,10,75,57,18,48
Copenhagen,2653,4,12,4,14,57,51,6,40
AaB,2653,5,9,11,10,38,43,-5,38
Sonderjyske,2653,6,8,6,10,28,29,-1,30
AC Horsens,2653,7,6,12,12,33,52,-19,30
Randers FC,2653,8,6,6,12,25,40,-15,24
Silkeborg IF,2653,9,6,3,13,27,45,-18,21
Lyngby,2653,10,3,9,12,27,46,-19,18
AGF Aarhus,2653,11,4,6,12,17,38,-21,18
Brondby,2654,1,19,7,4,72,38,34,64
FC Midtjylla,2654,2,19,7,4,70,39,31,64
FC Nords,2654,3,15,7,8,76,52,24,52
Copenhagen,2654,4,14,5,11,56,43,13,47
AaB,2654,5,8,11,11,39,46,-7,35
AC Horsens,2654,6,6,13,11,31,52,-21,31
Sonderjyske,2654,7,8,6,10,28,29,-1,30
Randers FC,2654,8,6,6,12,24,39,-15,24
Silkeborg IF,2654,9,5,4,13,25,44,-19,19
AGF Aarhus,2654,10,4,7,11,16,36,-20,19
Lyngby,2654,11,3,9,12,26,45,-19,18
Brondby,2655,1,21,6,3,72,31,41,69
FC Midtjylla,2655,2,20,4,6,72,40,32,64
Copenhagen,2655,3,14,5,11,58,44,14,47
FC Nords,2655,4,13,7,10,68,56,12,46
AaB,2655,5,8,12,10,38,42,-4,36
AC Horsens,2655,6,6,14,10,36,57,-21,32
Sonderjyske,2655,7,8,6,10,28,29,-1,30
Randers FC,2655,8,6,6,12,24,39,-15,24
Silkeborg IF,2655,9,6,3,13,29,45,-16,21
Lyngby,2655,10,3,9,12,26,45,-19,18
AGF Aarhus,2655,11,4,6,12,17,40,-23,18
Brondby,2656,1,21,5,4,72,33,39,68
FC Midtjylla,2656,2,18,6,6,65,46,19,60
Copenhagen,2656,3,15,5,10,64,48,16,50
FC Nords,2656,4,13,7,10,75,57,18,46
AC Horsens,2656,5,7,14,9,40,55,-15,35
AaB,2656,6,7,13,10,40,43,-3,34
Sonderjyske,2656,7,8,6,10,28,29,-1,30
Lyngby,2656,8,4,9,11,27,44,-17,21
Randers FC,2656,9,5,6,13,23,40,-17,21
Silkeborg IF,2656,10,5,4,13,26,45,-19,19
AGF Aarhus,2656,11,4,7,11,17,37,-20,19
Brondby,2657,1,19,6,5,65,32,33,63
FC Midtjylla,2657,2,18,5,7,60,39,21,59
FC Nords,2657,3,14,8,8,70,47,23,50
Copenhagen,2657,4,14,6,10,54,40,14,48
AaB,2657,5,7,15,8,35,38,-3,36
AC Horsens,2657,6,6,16,8,33,47,-14,34
Sonderjyske,2657,7,8,6,10,28,29,-1,30
Lyngby,2657,8,4,9,11,28,44,-16,21
Silkeborg IF,2657,8,6,3,13,28,44,-16,21
Randers FC,2657,10,5,6,13,23,41,-18,21
AGF Aarhus,2657,11,4,6,12,16,39,-23,18
FC Midtjylla,2658,1,21,4,5,71,41,30,67
Brondby,2658,2,19,6,5,68,35,33,63
FC Nords,2658,3,15,8,7,73,48,25,53
Copenhagen,2658,4,14,5,11,55,42,13,47
AaB,2658,5,7,13,10,34,39,-5,34
Sonderjyske,2658,6,8,6,10,28,29,-1,30
AC Horsens,2658,7,5,14,11,35,57,-22,29
Randers FC,2658,8,6,6,12,24,39,-15,24
Silkeborg IF,2658,9,5,4,13,26,45,-19,19
AGF Aarhus,2658,10,4,7,11,17,37,-20,19
Lyngby,2658,11,3,9,12,26,45,-19,18
Brondby,2659,1,21,5,4,68,33,35,68
FC Midtjylla,2659,2,19,5,6,64,39,25,62
FC Nords,2659,3,15,8,7,77,48,29,53
Copenhagen,2659,4,13,6,11,57,45,12,45
AaB,2659,5,7,14,9,40,44,-4,35
Sonderjyske,2659,6,8,6,10,28,29,-1,30
AC Horsens,2659,7,5,14,11,35,58,-23,29
Lyngby,2659,8,4,9,11,28,44,-16,21
Randers FC,2659,9,5,6,13,23,41,-18,21
AGF Aarhus,2659,10,5,6,11,17,36,-19,21
Silkeborg IF,2659,11,5,3,14,25,45,-20,18
Brondby,2660,1,21,7,2,69,30,39,70
FC Midtjylla,2660,2,18,6,6,61,40,21,60
FC Nords,2660,3,14,8,8,69,47,22,50
Copenhagen,2660,4,14,6,10,56,40,16,48
AC Horsens,2660,5,7,12,11,31,48,-17,33
AaB,2660,6,7,11,12,35,42,-7,32
Sonderjyske,2660,7,8,6,10,28,29,-1,30
Randers FC,2660,8,5,7,12,24,40,-16,22
AGF Aarhus,2660,9,5,6,11,17,36,-19,21
Lyngby,2660,10,3,10,11,27,45,-18,19
Silkeborg IF,2660,11,5,3,14,25,45,-20,18
Brondby,2661,1,21,6,3,73,35,38,69
FC Midtjylla,2661,2,21,5,4,68,36,32,68
FC Nords,2661,3,13,7,10,71,51,20,46
Copenhagen,2661,4,13,5,12,61,51,10,44
AaB,2661,5,9,12,9,39,43,-4,39
Sonderjyske,2661,6,8,6,10,28,29,-1,30
AC Horsens,2661,7,5,13,12,32,54,-22,28
Lyngby,2661,8,4,9,11,28,44,-16,21
Randers FC,2661,9,5,6,13,23,41,-18,21
Silkeborg IF,2661,10,5,4,13,27,46,-19,19
AGF Aarhus,2661,11,4,7,11,18,38,-20,19
Brondby,2662,1,21,6,3,70,31,39,69
FC Midtjylla,2662,2,20,5,5,71,42,29,65
FC Nords,2662,3,14,8,8,74,53,21,50
Copenhagen,2662,4,14,5,11,58,43,15,47
AaB,2662,5,6,13,11,34,42,-8,31
AC Horsens,2662,6,6,13,11,36,58,-22,31
Sonderjyske,2662,7,8,6,10,28,29,-1,30
Randers FC,2662,8,6,6,12,26,40,-14,24
AGF Aarhus,2662,9,5,6,11,17,36,-19,21
Lyngby,2662,10,3,9,12,27,47,-20,18
Silkeborg IF,2662,11,5,3,14,25,45,-20,18
Brondby,2663,1,19,8,3,69,35,34,65
FC Midtjylla,2663,2,19,5,6,65,43,22,62
FC Nords,2663,3,14,7,9,71,50,21,49
Copenhagen,2663,4,14,4,12,59,43,16,46
AaB,2663,5,8,14,8,38,39,-1,38
AC Horsens,2663,6,6,14,10,34,52,-18,32
Sonderjyske,2663,7,8,6,10,28,29,-1,30
Randers FC,2663,8,6,6,12,25,40,-15,24
Silkeborg IF,2663,9,6,3,13,27,45,-18,21
Lyngby,2663,10,3,9,12,27,46,-19,18
AGF Aarhus,2663,11,4,6,12,17,38,-21,18
Brondby,2664,1,22,6,2,72,31,41,72
FC Midtjylla,2664,2,18,5,7,63,41,22,59
Copenhagen,2664,3,15,5,10,60,44,16,50
FC Nords,2664,4,13,6,11,71,57,14,45
AaB,2664,5,7,13,10,39,44,-5,34
AC Horsens,2664,6,7,13,10,37,51,-14,34
Sonderjyske,2664,7,8,6,10,28,29,-1,30
Randers FC,2664,8,6,6,12,25,40,-15,24
Silkeborg IF,2664,9,5,4,13,26,45,-19,19
AGF Aarhus,2664,10,4,7,11,17,37,-20,19
Lyngby,2664,11,3,9,12,27,46,-19,18
FC Midtjylla,2665,1,21,5,4,66,38,28,68
Brondby,2665,2,20,5,5,69,36,33,65
FC Nords,2665,3,14,8,8,76,54,22,50
Copenhagen,2665,4,13,6,11,58,45,13,45
AaB,2665,5,7,13,10,35,40,-5,34
AC Horsens,2665,6,6,13,11,33,50,-17,31
Sonderjyske,2665,7,8,6,10,28,29,-1,30
Lyngby,2665,8,4,9,11,31,45,-14,21
Silkeborg IF,2665,9,6,3,13,29,44,-15,21
Randers FC,2665,10,5,6,13,24,44,-20,21
AGF Aarhus,2665,11,4,6,12,16,40,-24,18
Brondby,2666,1,20,7,3,71,34,37,67
FC Midtjylla,2666,2,20,5,5,68,38,30,65
Copenhagen,2666,3,15,4,11,60,48,12,49
FC Nords,2666,4,13,6,11,69,54,15,45
AaB,2666,5,8,12,10,39,42,-3,36
AC Horsens,2666,6,7,12,11,36,53,-17,33
Sonderjyske,2666,7,8,6,10,28,29,-1,30
Randers FC,2666,8,5,7,12,24,40,-16,22
Silkeborg IF,2666,9,6,3,13,27,44,-17,21
Lyngby,2666,10,3,10,11,27,45,-18,19
AGF Aarhus,2666,11,4,6,12,16,38,-22,18
Brondby,2667,1,22,5,3,79,32,47,71
FC Midtjylla,2667,2,19,5,6,63,38,25,62
FC Nords,2667,3,16,6,8,78,53,25,54
Copenhagen,2667,4,15,5,10,64,46,18,50
AaB,2667,5,7,11,12,35,47,-12,32
Sonderjyske,2667,6,8,6,10,28,29,-1,30
AC Horsens,2667,7,5,12,13,31,60,-29,27
Randers FC,2667,8,6,6,12,25,40,-15,24
Silkeborg IF,2667,9,5,4,13,27,46,-19,19
AGF Aarhus,2667,10,4,7,11,18,38,-20,19
Lyngby,2667,11,3,9,12,27,46,-19,18
Brondby,2668,1,20,5,5,70,32,38,65
FC Midtjylla,2668,2,19,4,7,65,42,23,61
Copenhagen,2668,3,16,4,10,61,43,18,52
FC Nords,2668,4,15,6,9,74,54,20,51
AaB,2668,5,8,11,11,35,43,-8,35
AC Horsens,2668,6,7,12,11,36,53,-17,33
Sonderjyske,2668,7,8,6,10,28,29,-1,30
Lyngby,2668,8,4,9,11,28,44,-16,21
Randers FC,2668,9,5,6,13,23,41,-18,21
AGF Aarhus,2668,10,5,6,11,17,36,-19,21
Silkeborg IF,2668,11,5,3,14,25,45,-20,18
Brondby,2669,1,19,6,5,69,36,33,63
FC Midtjylla,2669,2,19,6,5,65,39,26,63
FC Nords,2669,3,14,6,10,72,52,20,48
Copenhagen,2669,4,14,4,12,57,43,14,46
AaB,2669,5,9,11,10,37,40,-3,38
AC Horsens,2669,6,8,13,9,34,50,-16,37
Sonderjyske,2669,7,8,6,10,28,29,-1,30
Randers FC,2669,8,5,7,12,25,41,-16,22
Silkeborg IF,2669,9,6,3,13,28,44,-16,21
Lyngby,2669,10,3,10,11,28,46,-18,19
AGF Aarhus,2669,11,4,6,12,16,39,-23,18
FC Midtjylla,2670,1,21,5,4,69,38,31,68
Brondby,2670,2,19,7,4,70,35,35,64
Copenhagen,2670,3,14,6,10,58,43,15,48
FC Nords,2670,4,13,8,9,73,55,18,47
AaB,2670,5,7,13,10,36,42,-6,34
AC Horsens,2670,6,6,13,11,34,53,-19,31
Sonderjyske,2670,7,8,6,10,28,29,-1,30
Lyngby,2670,8,4,9,11,27,44,-17,21
Randers FC,2670,9,5,6,13,23,40,-17,21
AGF Aarhus,2670,10,5,6,11,17,36,-19,21
Silkeborg IF,2670,11,5,3,14,25,45,-20,18
Brondby,2671,1,21,5,4,70,35,35,68
FC Midtjylla,2671,2,20,4,6,64,36,28,64
Copenhagen,2671,3,14,6,10,59,42,17,48
FC Nords,2671,4,13,8,9,70,52,18,47
AaB,2671,5,7,13,10,35,41,-6,34
AC Horsens,2671,6,6,14,10,36,54,-18,32
Sonderjyske,2671,7,8,6,10,28,29,-1,30
Randers FC,2671,8,5,7,12,23,39,-16,22
Silkeborg IF,2671,9,6,3,13,28,45,-17,21
Lyngby,2671,10,3,10,11,26,44,-18,19
AGF Aarhus,2671,11,4,6,12,17,39,-22,18
Brondby,2672,1,20,7,3,69,31,38,67
FC Midtjylla,2672,2,19,5,6,65,38,27,62
FC Nords,2672,3,15,8,7,73,49,24,53
Copenhagen,2672,4,13,5,12,53,44,9,44
AaB,2672,5,8,11,11,36,41,-5,35
AC Horsens,2672,6,7,12,11,34,53,-19,33
Sonderjyske,2672,7,8,6,10,28,29,-1,30
Randers FC,2672,8,5,7,12,25,41,-16,22
AGF Aarhus,2672,9,5,6,11,17,36,-19,21
Lyngby,2672,10,3,10,11,28,46,-18,19
Silkeborg IF,2672,11,5,3,14,25,45,-20,18
Brondby,2673,1,22,6,2,72,30,42,72
FC Midtjylla,2673,2,19,6,5,66,38,28,63
FC Nords,2673,3,15,6,9,75,49,26,51
Copenhagen,2673,4,14,5,11,58,46,12,47
AC Horsens,2673,5,6,13,11,33,58,-25,31
Sonderjyske,2673,6,8,6,10,28,29,-1,30
AaB,2673,7,6,12,12,33,42,-9,30
Randers FC,2673,8,6,6,12,24,39,-15,24
Silkeborg IF,2673,9,6,3,13,30,46,-16,21
Lyngby,2673,10,3,9,12,26,45,-19,18
AGF Aarhus,2673,11,4,6,12,18,41,-23,18
Brondby,2674,1,20,6,4,71,33,38,66
FC Midtjylla,2674,2,19,4,7,64,43,21,61
FC Nords,2674,3,13,8,9,72,55,17,47
Copenhagen,2674,4,14,5,11,60,46,14,47
AC Horsens,2674,5,9,13,8,42,51,-9,40
AaB,2674,6,7,12,11,36,43,-7,33
Sonderjyske,2674,7,8,6,10,28,29,-1,30
Lyngby,2674,8,4,9,11,29,46,-17,21
Randers FC,2674,9,5,6,13,25,42,-17,21
AGF Aarhus,2674,10,5,6,11,18,37,-19,21
Silkeborg IF,2674,11,5,3,14,26,46,-20,18
Brondby,2675,1,21,6,3,72,31,41,69
FC Midtjylla,2675,2,19,6,5,65,41,24,63
FC Nords,2675,3,13,9,8,72,49,23,48
Copenhagen,2675,4,13,7,10,55,44,11,46
AC Horsens,2675,5,7,14,9,33,48,-15,35
Sonderjyske,2675,6,8,6,10,28,29,-1,30
AaB,2675,7,6,12,12,34,44,-10,30
Randers FC,2675,8,6,6,12,26,41,-15,24
Silkeborg IF,2675,9,6,3,13,29,44,-15,21
Lyngby,2675,10,3,9,12,28,47,-19,18
AGF Aarhus,2675,11,4,6,12,16,40,-24,18
Brondby,2676,1,20,6,4,68,35,33,66
FC Midtjylla,2676,2,19,5,6,62,41,21,62
FC Nords,2676,3,15,6,9,76,53,23,51
Copenhagen,2676,4,15,4,11,60,44,16,49
AC Horsens,2676,5,7,14,9,37,51,-14,35
AaB,2676,6,7,11,12,39,44,-5,32
Sonderjyske,2676,7,8,6,10,28,29,-1,30
Lyngby,2676,8,4,9,11,27,44,-17,21
Randers FC,2676,9,5,6,13,23,40,-17,21
Silkeborg IF,2676,10,5,4,13,25,44,-19,19
AGF Aarhus,2676,11,4,7,11,16,36,-20,19
Brondby,2677,1,19,6,5,68,39,29,63
FC Midtjylla,2677,2,19,6,5,63,38,25,63
FC Nords,2677,3,15,7,8,78,49,29,52
Copenhagen,2677,4,13,4,13,52,44,8,43
AaB,2677,5,9,11,10,38,42,-4,38
AC Horsens,2677,6,7,14,9,34,47,-13,35
Sonderjyske,2677,7,8,6,10,28,29,-1,30
Randers FC,2677,8,6,6,12,25,39,-14,24
AGF Aarhus,2677,9,5,6,11,19,36,-17,21
Lyngby,2677,10,3,9,12,26,46,-20,18
Silkeborg IF,2677,11,5,3,14,25,47,-22,18
Brondby,2678,1,21,6,3,76,37,39,69
FC Midtjylla,2678,2,21,4,5,70,38,32,67
Copenhagen,2678,3,14,6,10,59,47,12,48
FC Nords,2678,4,13,8,9,73,53,20,47
AaB,2678,5,7,12,11,41,49,-8,33
Sonderjyske,2678,6,8,6,10,28,29,-1,30
AC Horsens,2678,7,6,12,12,34,55,-21,30
Lyngby,2678,8,4,9,11,28,45,-17,21
Silkeborg IF,2678,9,6,3,13,27,44,-17,21
Randers FC,2678,10,5,6,13,24,41,-17,21
AGF Aarhus,2678,11,4,6,12,16,38,-22,18
Brondby,2679,1,21,5,4,70,31,39,68
FC Midtjylla,2679,2,19,5,6,60,37,23,62
Copenhagen,2679,3,16,5,9,62,39,23,53
FC Nords,2679,4,13,7,10,68,52,16,46
AaB,2679,5,7,12,11,36,44,-8,33
AC Horsens,2679,6,7,12,11,34,53,-19,33
Sonderjyske,2679,7,8,6,10,28,29,-1,30
Lyngby,2679,8,4,9,11,29,44,-15,21
Silkeborg IF,2679,9,6,3,13,28,44,-16,21
Randers FC,2679,10,5,6,13,23,42,-19,21
AGF Aarhus,2679,11,4,6,12,16,39,-23,18
FC Midtjylla,2680,1,20,5,5,69,37,32,65
Brondby,2680,2,19,5,6,63,33,30,62
FC Nords,2680,3,14,8,8,77,51,26,50
Copenhagen,2680,4,14,4,12,56,51,5,46
AaB,2680,5,9,11,10,42,46,-4,38
AC Horsens,2680,6,7,13,10,38,53,-15,34
Sonderjyske,2680,7,8,6,10,28,29,-1,30
Lyngby,2680,8,4,9,11,27,44,-17,21
Randers FC,2680,9,5,6,13,23,40,-17,21
Silkeborg IF,2680,10,5,4,13,26,45,-19,19
AGF Aarhus,2680,11,4,7,11,17,37,-20,19
Brondby,2681,1,22,5,3,74,35,39,71
FC Midtjylla,2681,2,19,4,7,67,43,24,61
FC Nords,2681,3,15,6,9,73,52,21,51
Copenhagen,2681,4,15,4,11,59,43,16,49
AaB,2681,5,9,11,10,41,41,0,38
Sonderjyske,2681,6,8,6,10,28,29,-1,30
AC Horsens,2681,7,5,12,13,33,59,-26,27
Randers FC,2681,8,5,7,12,24,40,-16,22
Silkeborg IF,2681,9,6,3,13,26,44,-18,21
Lyngby,2681,10,3,10,11,27,45,-18,19
AGF Aarhus,2681,11,4,6,12,16,37,-21,18
Brondby,2682,1,21,6,3,77,39,38,69
FC Midtjylla,2682,2,20,6,4,70,38,32,66
Copenhagen,2682,3,13,6,11,58,45,13,45
FC Nords,2682,4,13,6,11,68,58,10,45
AaB,2682,5,8,11,11,41,44,-3,35
AC Horsens,2682,6,7,13,10,38,54,-16,34
Sonderjyske,2682,7,8,6,10,28,29,-1,30
Randers FC,2682,8,5,7,12,23,39,-16,22
Silkeborg IF,2682,9,6,3,13,28,44,-16,21
Lyngby,2682,10,3,10,11,26,44,-18,19
AGF Aarhus,2682,11,4,6,12,16,39,-23,18
FC Midtjylla,2683,1,20,5,5,65,39,26,65
Brondby,2683,2,19,7,4,64,31,33,64
Copenhagen,2683,3,15,4,11,57,42,15,49
FC Nords,2683,4,12,7,11,69,54,15,43
AaB,2683,5,9,11,10,42,42,0,38
AC Horsens,2683,6,8,12,10,36,51,-15,36
Sonderjyske,2683,7,8,6,10,28,29,-1,30
Lyngby,2683,8,4,9,11,29,45,-16,21
Randers FC,2683,9,5,6,13,24,42,-18,21
Silkeborg IF,2683,10,5,4,13,27,46,-19,19
AGF Aarhus,2683,11,4,7,11,18,38,-20,19
Brondby,2684,1,22,6,2,78,30,48,72
FC Midtjylla,2684,2,19,4,7,65,41,24,61
FC Nords,2684,3,14,6,10,75,57,18,48
Copenhagen,2684,4,13,7,10,53,40,13,46
AaB,2684,5,7,13,10,35,45,-10,34
AC Horsens,2684,6,6,14,10,34,53,-19,32
Sonderjyske,2684,7,8,6,10,28,29,-1,30
Lyngby,2684,8,4,9,11,28,44,-16,21
Randers FC,2684,9,5,6,13,23,41,-18,21
Silkeborg IF,2684,10,5,4,13,26,45,-19,19
AGF Aarhus,2684,11,4,7,11,17,37,-20,19
Brondby,2685,1,22,5,3,72,33,39,71
FC Midtjylla,2685,2,19,6,5,65,40,25,63
Copenhagen,2685,3,15,4,11,62,45,17,49
FC Nords,2685,4,13,7,10,72,53,19,46
AaB,2685,5,8,12,10,40,43,-3,36
Sonderjyske,2685,6,8,6,10,28,29,-1,30
AC Horsens,2685,7,6,12,12,33,56,-23,30
Lyngby,2685,8,4,9,11,27,44,-17,21
Randers FC,2685,9,5,6,13,23,40,-17,21
Silkeborg IF,2685,10,5,4,13,27,46,-19,19
AGF Aarhus,2685,11,4,7,11,18,38,-20,19
Brondby,2686,1,19,6,5,67,36,31,63
FC Midtjylla,2686,2,19,6,5,65,40,25,63
FC Nords,2686,3,15,7,8,76,49,27,52
Copenhagen,2686,4,15,5,10,62,46,16,50
AaB,2686,5,8,12,10,38,41,-3,36
Sonderjyske,2686,6,8,6,10,28,29,-1,30
AC Horsens,2686,7,6,12,12,35,57,-22,30
Lyngby,2686,8,4,9,11,29,44,-15,21
Silkeborg IF,2686,9,6,3,13,27,45,-18,21
Randers FC,2686,10,5,6,13,23,42,-19,21
AGF Aarhus,2686,11,4,6,12,17,38,-21,18
Brondby,2687,1,20,7,3,70,31,39,67
FC Midtjylla,2687,2,21,4,5,63,36,27,67
FC Nords,2687,3,14,6,10,68,50,18,48
Copenhagen,2687,4,14,4,12,58,46,12,46
AaB,2687,5,8,13,9,37,40,-3,37
Sonderjyske,2687,6,8,6,10,28,29,-1,30
AC Horsens,2687,7,5,14,11,32,51,-19,29
Lyngby,2687,8,4,9,11,30,45,-15,21
AGF Aarhus,2687,9,5,6,11,19,37,-18,21
Randers FC,2687,10,5,6,13,24,43,-19,21
Silkeborg IF,2687,11,5,3,14,26,47,-21,18
Brondby,2688,1,21,5,4,72,34,38,68
FC Midtjylla,2688,2,20,5,5,69,38,31,65
FC Nords,2688,3,15,7,8,76,53,23,52
Copenhagen,2688,4,13,4,13,55,46,9,43
AaB,2688,5,8,11,11,36,42,-6,35
AC Horsens,2688,6,7,12,11,35,56,-21,33
Sonderjyske,2688,7,8,6,10,28,29,-1,30
Randers FC,2688,8,6,6,12,26,40,-14,24
AGF Aarhus,2688,9,5,6,11,19,37,-18,21
Lyngby,2688,10,3,9,12,27,47,-20,18
Silkeborg IF,2688,11,5,3,14,26,47,-21,18
Brondby,2689,1,21,5,4,67,30,37,68
FC Midtjylla,2689,2,21,4,5,67,38,29,67
FC Nords,2689,3,14,7,9,74,51,23,49
Copenhagen,2689,4,14,5,11,56,46,10,47
AaB,2689,5,8,12,10,38,42,-4,36
Sonderjyske,2689,6,8,6,10,28,29,-1,30
AC Horsens,2689,7,5,13,12,30,51,-21,28
Randers FC,2689,8,6,6,12,28,41,-13,24
Silkeborg IF,2689,9,5,4,13,25,44,-19,19
AGF Aarhus,2689,10,4,7,11,16,36,-20,19
Lyngby,2689,11,3,9,12,28,49,-21,18
Brondby,2690,1,21,6,3,70,31,39,69
FC Midtjylla,2690,2,20,4,6,65,38,27,64
FC Nords,2690,3,14,8,8,72,50,22,50
Copenhagen,2690,4,13,6,11,53,43,10,45
AaB,2690,5,8,12,10,37,41,-4,36
Sonderjyske,2690,6,8,6,10,28,29,-1,30
AC Horsens,2690,7,5,14,11,34,54,-20,29
Lyngby,2690,8,4,9,11,29,46,-17,21
Randers FC,2690,9,5,6,13,25,42,-17,21
Silkeborg IF,2690,10,5,4,13,25,44,-19,19
AGF Aarhus,2690,11,4,7,11,16,36,-20,19
Brondby,2691,1,22,6,2,73,31,42,72
FC Midtjylla,2691,2,19,5,6,66,41,25,62
FC Nords,2691,3,14,7,9,74,53,21,49
Copenhagen,2691,4,14,6,10,61,45,16,48
AaB,2691,5,6,13,11,37,45,-8,31
AC Horsens,2691,6,6,13,11,35,57,-22,31
Sonderjyske,2691,7,8,6,10,28,29,-1,30
Randers FC,2691,8,6,6,12,25,40,-15,24
Silkeborg IF,2691,9,5,4,13,27,46,-19,19
AGF Aarhus,2691,10,4,7,11,18,38,-20,19
Lyngby,2691,11,3,9,12,27,46,-19,18
FC Midtjylla,2692,1,22,4,4,71,35,36,70
Brondby,2692,2,21,5,4,69,32,37,68
FC Nords,2692,3,14,6,10,75,51,24,48
Copenhagen,2692,4,13,6,11,56,47,9,45
AaB,2692,5,8,12,10,38,41,-3,36
Sonderjyske,2692,6,8,6,10,28,29,-1,30
AC Horsens,2692,7,5,13,12,30,59,-29,28
Randers FC,2692,8,6,6,12,26,40,-14,24
Silkeborg IF,2692,9,6,3,13,27,44,-17,21
Lyngby,2692,10,3,9,12,27,47,-20,18
AGF Aarhus,2692,11,4,6,12,16,38,-22,18
Brondby,2693,1,20,6,4,71,36,35,66
FC Midtjylla,2693,2,20,4,6,64,37,27,64
FC Nords,2693,3,15,6,9,77,52,25,51
Copenhagen,2693,4,15,4,11,59,44,15,49
AaB,2693,5,7,12,11,37,46,-9,33
AC Horsens,2693,6,6,14,10,34,53,-19,32
Sonderjyske,2693,7,8,6,10,28,29,-1,30
Lyngby,2693,8,4,9,11,28,44,-16,21
Silkeborg IF,2693,9,6,3,13,27,45,-18,21
Randers FC,2693,10,5,6,13,23,41,-18,21
AGF Aarhus,2693,11,4,6,12,17,38,-21,18
Brondby,2694,1,22,6,2,72,33,39,72
FC Midtjylla,2694,2,19,5,6,65,38,27,62
Copenhagen,2694,3,15,5,10,60,45,15,50
FC Nords,2694,4,13,7,10,71,55,16,46
AC Horsens,2694,5,6,15,9,35,50,-15,33
Sonderjyske,2694,6,8,6,10,28,29,-1,30
AaB,2694,7,6,12,12,32,40,-8,30
Lyngby,2694,8,4,9,11,29,46,-17,21
Randers FC,2694,9,5,6,13,25,42,-17,21
Silkeborg IF,2694,10,5,4,13,27,46,-19,19
AGF Aarhus,2694,11,4,7,11,18,38,-20,19
Brondby,2695,1,22,5,3,71,31,40,71
FC Midtjylla,2695,2,19,5,6,62,38,24,62
FC Nords,2695,3,15,6,9,70,50,20,51
Copenhagen,2695,4,12,4,14,54,48,6,40
AaB,2695,5,9,11,10,39,40,-1,38
AC Horsens,2695,6,7,13,10,36,51,-15,34
Sonderjyske,2695,7,8,6,10,28,29,-1,30
Lyngby,2695,8,4,9,11,28,45,-17,21
Randers FC,2695,9,5,6,13,24,41,-17,21
AGF Aarhus,2695,10,5,6,11,17,36,-19,21
Silkeborg IF,2695,11,5,3,14,25,45,-20,18
Brondby,2696,1,21,5,4,70,35,35,68
FC Midtjylla,2696,2,18,5,7,67,40,27,59
FC Nords,2696,3,16,7,7,76,49,27,55
Copenhagen,2696,4,15,4,11,58,44,14,49
AaB,2696,5,7,12,11,38,48,-10,33
Sonderjyske,2696,6,8,6,10,28,29,-1,30
AC Horsens,2696,7,5,15,10,39,58,-19,30
Randers FC,2696,8,6,6,12,24,39,-15,24
Silkeborg IF,2696,9,6,3,13,27,44,-17,21
Lyngby,2696,10,3,9,12,26,45,-19,18
AGF Aarhus,2696,11,4,6,12,16,38,-22,18
Brondby,2697,1,21,5,4,72,33,39,68
FC Midtjylla,2697,2,21,4,5,66,36,30,67
FC Nords,2697,3,15,6,9,76,54,22,51
Copenhagen,2697,4,12,4,14,53,50,3,40
AC Horsens,2697,5,8,12,10,39,53,-14,36
AaB,2697,6,8,11,11,39,45,-6,35
Sonderjyske,2697,7,8,6,10,28,29,-1,30
Lyngby,2697,8,4,9,11,29,45,-16,21
Silkeborg IF,2697,9,6,3,13,28,45,-17,21
Randers FC,2697,10,5,6,13,24,42,-18,21
AGF Aarhus,2697,11,4,6,12,17,39,-22,18
Brondby,2698,1,21,5,4,69,32,37,68
FC Midtjylla,2698,2,20,5,5,70,36,34,65
FC Nords,2698,3,15,7,8,77,52,25,52
Copenhagen,2698,4,13,6,11,57,49,8,45
AaB,2698,5,8,11,11,37,46,-9,35
Sonderjyske,2698,6,8,6,10,28,29,-1,30
AC Horsens,2698,7,5,14,11,32,53,-21,29
Lyngby,2698,8,4,9,11,27,44,-17,21
Randers FC,2698,9,5,6,13,23,40,-17,21
Silkeborg IF,2698,10,6,3,13,26,44,-18,21
AGF Aarhus,2698,11,4,6,12,16,37,-21,18
Brondby,2699,1,19,7,4,71,34,37,64
FC Midtjylla,2699,2,19,4,7,65,46,19,61
Copenhagen,2699,3,17,4,9,64,42,22,55
FC Nords,2699,4,15,6,9,72,51,21,51
AaB,2699,5,8,12,10,37,41,-4,36
Sonderjyske,2699,6,8,6,10,28,29,-1,30
AC Horsens,2699,7,5,13,12,33,54,-21,28
Lyngby,2699,8,4,9,11,27,44,-17,21
Randers FC,2699,9,5,6,13,23,40,-17,21
Silkeborg IF,2699,10,6,3,13,26,44,-18,21
AGF Aarhus,2699,11,4,6,12,16,37,-21,18
FC Midtjylla,2700,1,20,4,6,69,43,26,64
Brondby,2700,2,19,5,6,65,36,29,62
FC Nords,2700,3,14,7,9,71,51,20,49
Copenhagen,2700,4,14,6,10,61,42,19,48
AaB,2700,5,9,11,10,39,41,-2,38
AC Horsens,2700,6,7,13,10,36,54,-18,34
Sonderjyske,2700,7,8,6,10,28,29,-1,30
Lyngby,2700,8,4,9,11,27,44,-17,21
Randers FC,2700,9,5,6,13,23,40,-17,21
Silkeborg IF,2700,10,6,3,13,27,45,-18,21
AGF Aarhus,2700,11,4,6,12,17,38,-21,18
Brondby,2701,1,20,8,2,73,31,42,68
FC Midtjylla,2701,2,20,5,5,65,40,25,65
FC Nords,2701,3,14,6,10,70,51,19,48
Copenhagen,2701,4,14,6,10,59,43,16,48
AaB,2701,5,7,11,12,34,46,-12,32
AC Horsens,2701,6,6,14,10,35,51,-16,32
Sonderjyske,2701,7,8,6,10,28,29,-1,30
Lyngby,2701,8,4,9,11,27,44,-17,21
Randers FC,2701,9,5,6,13,23,40,-17,21
AGF Aarhus,2701,10,5,6,11,18,36,-18,21
Silkeborg IF,2701,11,5,3,14,25,46,-21,18
Brondby,2702,1,22,6,2,74,32,42,72
FC Midtjylla,2702,2,18,5,7,64,43,21,59
FC Nords,2702,3,13,7,10,75,56,19,46
Copenhagen,2702,4,13,4,13,53,49,4,43
AC Horsens,2702,5,9,13,8,38,49,-11,40
AaB,2702,6,8,11,11,43,44,-1,35
Sonderjyske,2702,7,8,6,10,28,29,-1,30
Lyngby,2702,8,4,9,11,27,44,-17,21
Randers FC,2702,9,5,6,13,23,40,-17,21
Silkeborg IF,2702,10,6,3,13,28,46,-18,21
AGF Aarhus,2702,11,4,6,12,18,39,-21,18
Brondby,2703,1,20,7,3,72,33,39,67
FC Midtjylla,2703,2,19,5,6,67,41,26,62
FC Nords,2703,3,15,7,8,80,52,28,52
Copenhagen,2703,4,13,6,11,57,49,8,45
AaB,2703,5,7,13,10,36,46,-10,34
AC Horsens,2703,6,5,16,9,36,53,-17,31
Sonderjyske,2703,7,8,6,10,28,29,-1,30
Lyngby,2703,8,4,9,11,31,44,-13,21
Silkeborg IF,2703,9,6,3,13,26,44,-18,21
Randers FC,2703,10,5,6,13,23,44,-21,21
AGF Aarhus,2703,11,4,6,12,16,37,-21,18
Brondby,2704,1,22,6,2,78,31,47,72
FC Midtjylla,2704,2,19,5,6,60,39,21,62
FC Nords,2704,3,14,7,9,72,52,20,49
Copenhagen,2704,4,14,5,11,58,45,13,47
AaB,2704,5,8,12,10,40,45,-5,36
Sonderjyske,2704,6,8,6,10,28,29,-1,30
AC Horsens,2704,7,5,13,12,35,57,-22,28
Lyngby,2704,8,4,9,11,30,47,-17,21
Randers FC,2704,9,5,6,13,26,43,-17,21
AGF Aarhus,2704,10,5,6,11,18,37,-19,21
Silkeborg IF,2704,11,5,3,14,26,46,-20,18
Brondby,2705,1,20,7,3,70,33,37,67
FC Midtjylla,2705,2,19,6,5,64,39,25,63
Copenhagen,2705,3,15,5,10,60,44,16,50
FC Nords,2705,4,13,8,9,72,52,20,47
AaB,2705,5,7,12,11,35,42,-7,33
AC Horsens,2705,6,6,14,10,33,50,-17,32
Sonderjyske,2705,7,8,6,10,28,29,-1,30
Randers FC,2705,8,5,7,12,23,39,-16,22
Lyngby,2705,9,3,10,11,26,44,-18,19
Silkeborg IF,2705,10,5,4,13,26,45,-19,19
AGF Aarhus,2705,11,4,7,11,17,37,-20,19
Brondby,2706,1,20,6,4,66,32,34,66
FC Midtjylla,2706,2,19,6,5,64,39,25,63
FC Nords,2706,3,15,6,9,74,53,21,51
Copenhagen,2706,4,13,6,11,59,44,15,45
AaB,2706,5,9,12,9,44,43,1,39
Sonderjyske,2706,6,8,6,10,28,29,-1,30
AC Horsens,2706,7,6,12,12,35,57,-22,30
Lyngby,2706,8,4,9,11,28,45,-17,21
Randers FC,2706,9,5,6,13,24,41,-17,21
Silkeborg IF,2706,10,5,4,13,27,46,-19,19
AGF Aarhus,2706,11,4,7,11,18,38,-20,19
Brondby,2707,1,21,7,2,75,36,39,70
FC Midtjylla,2707,2,19,5,6,67,41,26,62
FC Nords,2707,3,15,6,9,73,50,23,51
Copenhagen,2707,4,13,5,12,56,47,9,44
AaB,2707,5,7,13,10,34,38,-4,34
AC Horsens,2707,6,7,12,11,37,56,-19,33
Sonderjyske,2707,7,8,6,10,28,29,-1,30
Lyngby,2707,8,4,9,11,31,44,-13,21
Randers FC,2707,9,5,6,13,23,44,-21,21
Silkeborg IF,2707,10,5,4,13,25,44,-19,19
AGF Aarhus,2707,11,4,7,11,16,36,-20,19
Brondby,2708,1,23,5,2,74,28,46,74
FC Midtjylla,2708,2,20,4,6,68,42,26,64
Copenhagen,2708,3,15,4,11,59,43,16,49
FC Nords,2708,4,14,6,10,72,54,18,48
AaB,2708,5,8,11,11,36,43,-7,35
Sonderjyske,2708,6,8,6,10,28,29,-1,30
AC Horsens,2708,7,5,12,13,32,57,-25,27
Lyngby,2708,8,4,9,11,28,44,-16,21
AGF Aarhus,2708,9,5,6,11,20,36,-16,21
Randers FC,2708,10,5,6,13,23,41,-18,21
Silkeborg IF,2708,11,5,3,14,25,48,-23,18
Brondby,2709,1,19,9,2,64,28,36,66
FC Midtjylla,2709,2,19,6,5,66,41,25,63
FC Nords,2709,3,14,7,9,72,51,21,49
Copenhagen,2709,4,14,6,10,62,43,19,48
AaB,2709,5,6,15,9,35,41,-6,33
Sonderjyske,2709,6,8,6,10,28,29,-1,30
AC Horsens,2709,7,5,15,10,34,55,-21,30
Lyngby,2709,8,4,9,11,29,45,-16,21
Silkeborg IF,2709,9,6,3,13,27,45,-18,21
Randers FC,2709,10,5,6,13,24,42,-18,21
AGF Aarhus,2709,11,4,6,12,17,38,-21,18
Brondby,2710,1,21,6,3,69,33,36,69
FC Midtjylla,2710,2,19,6,5,67,37,30,63
FC Nords,2710,3,15,7,8,77,47,30,52
Copenhagen,2710,4,14,5,11,55,41,14,47
AC Horsens,2710,5,6,14,10,32,58,-26,32
Sonderjyske,2710,6,8,6,10,28,29,-1,30
AaB,2710,7,6,12,12,33,43,-10,30
Randers FC,2710,8,5,7,12,24,40,-16,22
Silkeborg IF,2710,9,6,3,13,29,44,-15,21
Lyngby,2710,10,3,10,11,27,45,-18,19
AGF Aarhus,2710,11,4,6,12,16,40,-24,18
Brondby,2711,1,20,6,4,69,30,39,66
FC Midtjylla,2711,2,20,5,5,68,37,31,65
Copenhagen,2711,3,14,6,10,58,43,15,48
FC Nords,2711,4,13,7,10,72,58,14,46
AaB,2711,5,8,13,9,39,43,-4,37
AC Horsens,2711,6,6,13,11,34,55,-21,31
Sonderjyske,2711,7,8,6,10,28,29,-1,30
Lyngby,2711,8,4,9,11,31,46,-15,21
Silkeborg IF,2711,9,6,3,13,26,44,-18,21
Randers FC,2711,10,5,6,13,25,44,-19,21
AGF Aarhus,2711,11,4,6,12,16,37,-21,18
Brondby,2712,1,20,6,4,68,32,36,66
FC Midtjylla,2712,2,19,6,5,63,36,27,63
FC Nords,2712,3,14,7,9,74,54,20,49
Copenhagen,2712,4,14,4,12,57,46,11,46
AaB,2712,5,9,11,10,38,40,-2,38
AC Horsens,2712,6,7,12,11,36,54,-18,33
Sonderjyske,2712,7,8,6,10,28,29,-1,30
Randers FC,2712,8,5,7,12,23,39,-16,22
Lyngby,2712,9,3,10,11,26,44,-18,19
Silkeborg IF,2712,10,5,4,13,27,46,-19,19
AGF Aarhus,2712,11,4,7,11,18,38,-20,19
Brondby,2713,1,22,5,3,75,32,43,71
FC Midtjylla,2713,2,18,5,7,62,44,18,59
FC Nords,2713,3,15,6,9,76,51,25,51
Copenhagen,2713,4,14,6,10,57,47,10,48
AaB,2713,5,8,13,9,43,42,1,37
Sonderjyske,2713,6,8,6,10,28,29,-1,30
AC Horsens,2713,7,5,13,12,31,54,-23,28
Randers FC,2713,8,6,6,12,25,40,-15,24
AGF Aarhus,2713,9,5,6,11,17,36,-19,21
Lyngby,2713,10,3,9,12,27,46,-19,18
Silkeborg IF,2713,11,5,3,14,25,45,-20,18
Brondby,2714,1,22,6,2,73,32,41,72
FC Midtjylla,2714,2,19,5,6,68,42,26,62
FC Nords,2714,3,14,7,9,69,49,20,49
Copenhagen,2714,4,13,6,11,53,41,12,45
AC Horsens,2714,5,7,13,10,37,53,-16,34
AaB,2714,6,7,11,12,33,42,-9,32
Sonderjyske,2714,7,8,6,10,28,29,-1,30
Randers FC,2714,8,6,6,12,25,40,-15,24
Silkeborg IF,2714,9,5,4,13,25,44,-19,19
AGF Aarhus,2714,10,4,7,11,16,36,-20,19
Lyngby,2714,11,3,9,12,27,46,-19,18
FC Midtjylla,2715,1,21,5,4,67,37,30,68
Brondby,2715,2,20,7,3,73,35,38,67
FC Nords,2715,3,15,6,9,73,52,21,51
Copenhagen,2715,4,12,6,12,53,45,8,42
AC Horsens,2715,5,7,13,10,39,51,-12,34
AaB,2715,6,7,11,12,36,47,-11,32
Sonderjyske,2715,7,8,6,10,28,29,-1,30
Lyngby,2715,8,4,9,11,27,44,-17,21
Silkeborg IF,2715,8,6,3,13,27,44,-17,21
Randers FC,2715,10,5,6,13,23,40,-17,21
AGF Aarhus,2715,11,4,6,12,16,38,-22,18
Brondby,2716,1,21,5,4,75,37,38,68
FC Midtjylla,2716,2,20,5,5,70,41,29,65
FC Nords,2716,3,14,7,9,71,49,22,49
Copenhagen,2716,4,14,5,11,56,45,11,47
AaB,2716,5,8,12,10,37,43,-6,36
Sonderjyske,2716,6,8,6,10,28,29,-1,30
AC Horsens,2716,7,6,12,12,34,54,-20,30
Lyngby,2716,8,4,9,11,28,44,-16,21
Silkeborg IF,2716,9,6,3,13,28,45,-17,21
Randers FC,2716,10,5,6,13,23,41,-18,21
AGF Aarhus,2716,11,4,6,12,17,39,-22,18
Brondby,2717,1,20,7,3,69,31,38,67
FC Midtjylla,2717,2,19,5,6,60,37,23,62
FC Nords,2717,3,15,6,9,75,51,24,51
Copenhagen,2717,4,15,5,10,58,41,17,50
AaB,2717,5,6,14,10,35,43,-8,32
AC Horsens,2717,6,6,13,11,34,54,-20,31
Sonderjyske,2717,7,8,6,10,28,29,-1,30
Randers FC,2717,8,6,6,12,25,40,-15,24
AGF Aarhus,2717,9,5,6,11,18,36,-18,21
Lyngby,2717,10,3,9,12,27,46,-19,18
Silkeborg IF,2717,11,5,3,14,25,46,-21,18
Brondby,2718,1,21,6,3,71,33,38,69
FC Midtjylla,2718,2,19,4,7,65,42,23,61
FC Nords,2718,3,15,7,8,76,49,27,52
Copenhagen,2718,4,14,4,12,57,45,12,46
AaB,2718,5,8,12,10,36,40,-4,36
AC Horsens,2718,6,6,13,11,35,57,-22,31
Sonderjyske,2718,7,8,6,10,28,29,-1,30
Randers FC,2718,8,5,7,12,24,40,-16,22
Silkeborg IF,2718,9,6,3,13,27,44,-17,21
Lyngby,2718,10,3,10,11,27,45,-18,19
AGF Aarhus,2718,11,4,6,12,16,38,-22,18
Brondby,2719,1,21,7,2,74,31,43,70
FC Midtjylla,2719,2,17,4,9,61,46,15,55
FC Nords,2719,3,15,6,9,74,48,26,51
Copenhagen,2719,4,14,6,10,58,44,14,48
AaB,2719,5,9,13,8,38,38,0,40
Sonderjyske,2719,6,8,6,10,28,29,-1,30
AC Horsens,2719,7,6,12,12,33,57,-24,30
Randers FC,2719,8,5,7,12,24,40,-16,22
AGF Aarhus,2719,9,5,6,11,18,37,-19,21
Lyngby,2719,10,3,10,11,27,45,-18,19
Silkeborg IF,2719,11,5,3,14,26,46,-20,18
Brondby,2720,1,20,7,3,69,35,34,67
FC Midtjylla,2720,2,19,5,6,64,41,23,62
FC Nords,2720,3,13,8,9,69,49,20,47
Copenhagen,2720,4,14,5,11,60,43,17,47
AaB,2720,5,8,12,10,36,41,-5,36
AC Horsens,2720,6,7,13,10,36,51,-15,34
Sonderjyske,2720,7,8,6,10,28,29,-1,30
Silkeborg IF,2720,8,6,3,13,28,44,-16,21
Lyngby,2720,9,4,9,11,27,44,-17,21
Randers FC,2720,10,5,6,13,23,40,-17,21
AGF Aarhus,2720,11,4,6,12,16,39,-23,18
Brondby,2721,1,22,5,3,69,30,39,71
FC Midtjylla,2721,2,19,5,6,65,39,26,62
FC Nords,2721,3,13,6,11,69,54,15,45
Copenhagen,2721,4,13,4,13,56,48,8,43
AaB,2721,5,10,11,9,40,38,2,41
AC Horsens,2721,6,7,13,10,37,53,-16,34
Sonderjyske,2721,7,8,6,10,28,29,-1,30
Randers FC,2721,8,6,6,12,26,40,-14,24
Silkeborg IF,2721,9,6,3,13,26,44,-18,21
Lyngby,2721,10,3,9,12,27,47,-20,18
AGF Aarhus,2721,11,4,6,12,16,37,-21,18
Brondby,2722,1,23,5,2,75,30,45,74
FC Midtjylla,2722,2,19,5,6,67,40,27,62
FC Nords,2722,3,14,7,9,72,49,23,49
Copenhagen,2722,4,14,5,11,55,46,9,47
AaB,2722,5,8,11,11,37,45,-8,35
Sonderjyske,2722,6,8,6,10,28,29,-1,30
AC Horsens,2722,7,5,13,12,34,56,-22,28
Randers FC,2722,8,6,6,12,25,40,-15,24
Silkeborg IF,2722,9,6,3,13,28,45,-17,21
Lyngby,2722,10,3,9,12,27,46,-19,18
AGF Aarhus,2722,11,4,6,12,17,39,-22,18
FC Midtjylla,2723,1,20,4,6,66,38,28,64
Brondby,2723,2,19,6,5,66,36,30,63
FC Nords,2723,3,15,7,8,76,48,28,52
Copenhagen,2723,4,15,6,9,62,44,18,51
AaB,2723,5,9,11,10,36,42,-6,38
Sonderjyske,2723,6,8,6,10,28,29,-1,30
AC Horsens,2723,7,5,12,13,31,55,-24,27
Randers FC,2723,8,6,6,12,24,39,-15,24
Silkeborg IF,2723,9,5,4,13,25,44,-19,19
AGF Aarhus,2723,10,4,7,11,16,36,-20,19
Lyngby,2723,11,3,9,12,26,45,-19,18
Brondby,2724,1,20,6,4,73,34,39,66
FC Midtjylla,2724,2,18,5,7,63,44,19,59
Copenhagen,2724,3,16,4,10,59,44,15,52
FC Nords,2724,4,14,6,10,73,52,21,48
AaB,2724,5,9,11,10,44,44,0,38
AC Horsens,2724,6,7,12,11,36,56,-20,33
Sonderjyske,2724,7,8,6,10,28,29,-1,30
Lyngby,2724,8,4,9,11,30,45,-15,21
AGF Aarhus,2724,9,5,6,11,19,37,-18,21
Randers FC,2724,10,5,6,13,24,43,-19,21
Silkeborg IF,2724,11,5,3,14,26,47,-21,18
Brondby,2725,1,20,7,3,67,30,37,67
FC Midtjylla,2725,2,21,4,5,67,37,30,67
FC Nords,2725,3,14,7,9,75,52,23,49
Copenhagen,2725,4,14,6,10,56,41,15,48
AaB,2725,5,8,11,11,33,41,-8,35
Sonderjyske,2725,6,8,6,10,28,29,-1,30
AC Horsens,2725,7,5,13,12,32,55,-23,28
Lyngby,2725,8,4,9,11,27,44,-17,21
Randers FC,2725,9,5,6,13,23,40,-17,21
AGF Aarhus,2725,10,5,6,11,17,36,-19,21
Silkeborg IF,2725,11,5,3,14,25,45,-20,18
Brondby,2726,1,22,6,2,73,32,41,72
FC Midtjylla,2726,2,17,4,9,62,45,17,55
FC Nords,2726,3,16,6,8,80,52,28,54
Copenhagen,2726,4,13,4,13,57,49,8,43
AC Horsens,2726,5,8,13,9,44,56,-12,37
AaB,2726,6,8,11,11,38,46,-8,35
Sonderjyske,2726,7,8,6,10,28,29,-1,30
Lyngby,2726,8,4,9,11,28,45,-17,21
Randers FC,2726,9,5,6,13,24,41,-17,21
AGF Aarhus,2726,10,5,6,11,20,39,-19,21
Silkeborg IF,2726,11,5,3,14,28,48,-20,18
Brondby,2727,1,21,6,3,69,31,38,69
FC Midtjylla,2727,2,20,6,4,69,38,31,66
FC Nords,2727,3,13,9,8,74,57,17,48
Copenhagen,2727,4,13,7,10,61,48,13,46
AaB,2727,5,6,13,11,36,45,-9,31
AC Horsens,2727,6,6,13,11,37,53,-16,31
Sonderjyske,2727,7,8,6,10,28,29,-1,30
Randers FC,2727,8,6,6,12,25,39,-14,24
Silkeborg IF,2727,9,5,4,13,27,46,-19,19
AGF Aarhus,2727,10,4,7,11,18,38,-20,19
Lyngby,2727,11,3,9,12,26,46,-20,18
FC Midtjylla,2728,1,22,4,4,68,34,34,70
Brondby,2728,2,20,5,5,73,34,39,65
FC Nords,2728,3,14,7,9,76,50,26,49
Copenhagen,2728,4,14,6,10,56,43,13,48
AaB,2728,5,7,12,11,37,48,-11,33
Sonderjyske,2728,6,8,6,10,28,29,-1,30
AC Horsens,2728,7,6,12,12,32,59,-27,30
Lyngby,2728,8,4,9,11,29,44,-15,21
Randers FC,2728,9,5,6,13,23,42,-19,21
AGF Aarhus,2728,10,5,6,11,18,37,-19,21
Silkeborg IF,2728,11,5,3,14,26,46,-20,18
Brondby,2729,1,21,5,4,69,32,37,68
FC Midtjylla,2729,2,20,5,5,70,40,30,65
FC Nords,2729,3,16,6,8,72,47,25,54
Copenhagen,2729,4,12,5,13,55,49,6,41
AaB,2729,5,8,11,11,37,43,-6,35
AC Horsens,2729,6,7,12,11,36,54,-18,33
Sonderjyske,2729,7,8,6,10,28,29,-1,30
Randers FC,2729,8,6,6,12,25,40,-15,24
Silkeborg IF,2729,9,6,3,13,26,44,-18,21
Lyngby,2729,10,3,9,12,27,46,-19,18
AGF Aarhus,2729,11,4,6,12,16,37,-21,18
Brondby,2730,1,20,6,4,68,31,37,66
FC Midtjylla,2730,2,20,4,6,62,35,27,64
FC Nords,2730,3,16,6,8,77,48,29,54
Copenhagen,2730,4,13,5,12,52,44,8,44
AaB,2730,5,8,12,10,35,42,-7,36
AC Horsens,2730,6,6,13,11,32,52,-20,31
Sonderjyske,2730,7,8,6,10,28,29,-1,30
Silkeborg IF,2730,8,6,3,13,31,44,-13,21
Lyngby,2730,9,4,9,11,29,46,-17,21
Randers FC,2730,10,5,6,13,25,42,-17,21
AGF Aarhus,2730,11,4,6,12,16,42,-26,18
Brondby,2731,1,21,6,3,71,33,38,69
FC Midtjylla,2731,2,21,4,5,71,37,34,67
Copenhagen,2731,3,15,5,10,60,45,15,50
FC Nords,2731,4,13,6,11,71,54,17,45
AC Horsens,2731,5,7,12,11,35,56,-21,33
AaB,2731,6,7,11,12,39,48,-9,32
Sonderjyske,2731,7,8,6,10,28,29,-1,30
Lyngby,2731,8,4,9,11,27,44,-17,21
Randers FC,2731,9,5,6,13,23,40,-17,21
Silkeborg IF,2731,10,5,4,13,26,45,-19,19
AGF Aarhus,2731,11,4,7,11,17,37,-20,19
Brondby,2732,1,22,5,3,71,31,40,71
FC Midtjylla,2732,2,21,4,5,69,39,30,67
FC Nords,2732,3,16,6,8,73,48,25,54
Copenhagen,2732,4,12,5,13,54,49,5,41
AaB,2732,5,7,11,12,39,49,-10,32
AC Horsens,2732,6,6,13,11,36,52,-16,31
Sonderjyske,2732,7,8,6,10,28,29,-1,30
Lyngby,2732,8,4,9,11,28,45,-17,21
Randers FC,2732,9,5,6,13,24,41,-17,21
AGF Aarhus,2732,10,5,6,11,18,37,-19,21
Silkeborg IF,2732,11,5,3,14,26,46,-20,18
FC Midtjylla,2733,1,22,4,4,74,36,38,70
Brondby,2733,2,20,6,4,69,37,32,66
FC Nords,2733,3,15,6,9,73,49,24,51
Copenhagen,2733,4,13,5,12,60,49,11,44
AaB,2733,5,9,11,10,39,44,-5,38
Sonderjyske,2733,6,8,6,10,28,29,-1,30
AC Horsens,2733,7,5,12,13,32,58,-26,27
Randers FC,2733,8,6,6,12,24,39,-15,24
Silkeborg IF,2733,9,6,3,13,28,44,-16,21
Lyngby,2733,10,3,9,12,26,45,-19,18
AGF Aarhus,2733,11,4,6,12,16,39,-23,18
Brondby,2734,1,21,6,3,71,33,38,69
FC Midtjylla,2734,2,19,5,6,66,43,23,62
FC Nords,2734,3,13,8,9,75,53,22,47
Copenhagen,2734,4,13,7,10,57,43,14,46
AaB,2734,5,8,12,10,39,45,-6,36
AC Horsens,2734,6,7,12,11,36,53,-17,33
Sonderjyske,2734,7,8,6,10,28,29,-1,30
Randers FC,2734,8,5,7,12,25,41,-16,22
AGF Aarhus,2734,9,5,6,11,17,36,-19,21
Lyngby,2734,10,3,10,11,28,46,-18,19
Silkeborg IF,2734,11,5,3,14,25,45,-20,18
Brondby,2735,1,19,8,3,67,35,32,65
FC Midtjylla,2735,2,20,4,6,68,37,31,64
FC Nords,2735,3,14,8,8,73,50,23,50
Copenhagen,2735,4,14,5,11,55,44,11,47
AaB,2735,5,8,12,10,38,42,-4,36
AC Horsens,2735,6,6,13,11,33,52,-19,31
Sonderjyske,2735,7,8,6,10,28,29,-1,30
Randers FC,2735,8,5,7,12,25,41,-16,22
Lyngby,2735,9,3,10,11,28,46,-18,19
Silkeborg IF,2735,10,5,4,13,26,45,-19,19
AGF Aarhus,2735,11,4,7,11,17,37,-20,19
Brondby,2736,1,21,6,3,67,30,37,69
FC Midtjylla,2736,2,18,5,7,63,41,22,59
Copenhagen,2736,3,16,5,9,63,42,21,53
FC Nords,2736,4,15,6,9,73,53,20,51
AaB,2736,5,7,12,11,37,44,-7,33
Sonderjyske,2736,6,8,6,10,28,29,-1,30
AC Horsens,2736,7,6,12,12,33,52,-19,30
Lyngby,2736,8,4,9,11,28,44,-16,21
Randers FC,2736,9,5,6,13,23,41,-18,21
AGF Aarhus,2736,10,5,6,11,17,36,-19,21
Silkeborg IF,2736,11,5,3,14,25,45,-20,18
Brondby,2737,1,20,7,3,70,28,42,67
FC Midtjylla,2737,2,18,5,7,62,42,20,59
FC Nords,2737,3,15,7,8,74,54,20,52
Copenhagen,2737,4,15,6,9,59,42,17,51
AaB,2737,5,7,11,12,37,42,-5,32
AC Horsens,2737,6,6,14,10,37,57,-20,32
Sonderjyske,2737,7,8,6,10,28,29,-1,30
Randers FC,2737,8,5,7,12,25,41,-16,22
Lyngby,2737,9,3,10,11,28,46,-18,19
Silkeborg IF,2737,10,5,4,13,27,46,-19,19
AGF Aarhus,2737,11,4,7,11,18,38,-20,19
Brondby,2738,1,20,5,5,69,33,36,65
FC Midtjylla,2738,2,19,5,6,67,43,24,62
FC Nords,2738,3,16,6,8,80,52,28,54
Copenhagen,2738,4,15,5,10,60,44,16,50
AaB,2738,5,7,12,11,37,50,-13,33
AC Horsens,2738,6,6,13,11,35,52,-17,31
Sonderjyske,2738,7,8,6,10,28,29,-1,30
Randers FC,2738,8,5,7,12,24,40,-16,22
Lyngby,2738,9,3,10,11,27,45,-18,19
Silkeborg IF,2738,10,5,4,13,26,45,-19,19
AGF Aarhus,2738,11,4,7,11,17,37,-20,19
Brondby,2739,1,20,5,5,68,37,31,65
FC Midtjylla,2739,2,20,5,5,71,41,30,65
FC Nords,2739,3,15,7,8,72,49,23,52
Copenhagen,2739,4,15,5,10,63,44,19,50
AaB,2739,5,7,12,11,36,44,-8,33
Sonderjyske,2739,6,8,6,10,28,29,-1,30
AC Horsens,2739,7,6,12,12,36,57,-21,30
Lyngby,2739,8,4,9,11,27,44,-17,21
Randers FC,2739,9,5,6,13,23,40,-17,21
Silkeborg IF,2739,10,5,4,13,26,45,-19,19
AGF Aarhus,2739,11,4,7,11,17,37,-20,19
Brondby,2740,1,22,6,2,71,29,42,72
FC Midtjylla,2740,2,20,5,5,69,37,32,65
FC Nords,2740,3,14,6,10,76,57,19,48
Copenhagen,2740,4,14,5,11,57,46,11,47
AaB,2740,5,7,12,11,36,44,-8,33
Sonderjyske,2740,6,8,6,10,28,29,-1,30
AC Horsens,2740,7,6,12,12,33,55,-22,30
Randers FC,2740,8,5,7,12,23,39,-16,22
Silkeborg IF,2740,9,6,3,13,29,45,-16,21
Lyngby,2740,10,3,10,11,26,44,-18,19
AGF Aarhus,2740,11,4,6,12,17,40,-23,18
Brondby,2741,1,21,6,3,73,35,38,69
FC Midtjylla,2741,2,19,6,5,67,41,26,63
FC Nords,2741,3,15,8,7,78,50,28,53
Copenhagen,2741,4,12,5,13,54,46,8,41
AaB,2741,5,8,11,11,36,43,-7,35
AC Horsens,2741,6,7,12,11,37,56,-19,33
Sonderjyske,2741,7,8,6,10,28,29,-1,30
Randers FC,2741,8,5,7,12,24,40,-16,22
Silkeborg IF,2741,9,6,3,13,28,46,-18,21
Lyngby,2741,10,3,10,11,27,45,-18,19
AGF Aarhus,2741,11,4,6,12,18,39,-21,18
FC Midtjylla,2742,1,20,5,5,67,36,31,65
Brondby,2742,2,19,7,4,68,33,35,64
Copenhagen,2742,3,15,4,11,59,45,14,49
FC Nords,2742,4,13,7,10,73,56,17,46
AaB,2742,5,8,12,10,38,41,-3,36
AC Horsens,2742,6,7,13,10,37,57,-20,34
Sonderjyske,2742,7,8,6,10,28,29,-1,30
Lyngby,2742,8,4,9,11,28,44,-16,21
Randers FC,2742,9,5,6,13,23,41,-18,21
Silkeborg IF,2742,10,5,4,13,26,45,-19,19
AGF Aarhus,2742,11,4,7,11,17,37,-20,19
Brondby,2743,1,21,6,3,76,33,43,69
FC Midtjylla,2743,2,19,6,5,69,37,32,63
Copenhagen,2743,3,16,5,9,64,43,21,53
FC Nords,2743,4,14,6,10,72,57,15,48
AaB,2743,5,6,13,11,35,47,-12,31
Sonderjyske,2743,6,8,6,10,28,29,-1,30
AC Horsens,2743,7,5,14,11,34,59,-25,29
Randers FC,2743,8,5,7,12,24,40,-16,22
AGF Aarhus,2743,9,5,6,11,17,36,-19,21
Lyngby,2743,10,3,10,11,27,45,-18,19
Silkeborg IF,2743,11,5,3,14,25,45,-20,18
Brondby,2744,1,21,6,3,71,31,40,69
FC Midtjylla,2744,2,19,5,6,63,38,25,62
FC Nords,2744,3,14,7,9,72,51,21,49
Copenhagen,2744,4,14,4,12,59,44,15,46
AaB,2744,5,8,13,9,36,44,-8,37
AC Horsens,2744,6,6,13,11,33,52,-19,31
Sonderjyske,2744,7,8,6,10,28,29,-1,30
Randers FC,2744,8,6,6,12,27,42,-15,24
Silkeborg IF,2744,9,6,3,13,29,44,-15,21
Lyngby,2744,10,3,9,12,29,48,-19,18
AGF Aarhus,2744,11,4,6,12,16,40,-24,18
Brondby,2745,1,19,8,3,69,33,36,65
FC Midtjylla,2745,2,20,5,5,69,42,27,65
FC Nords,2745,3,14,8,8,76,49,27,50
Copenhagen,2745,4,15,4,11,60,50,10,49
AaB,2745,5,8,11,11,42,50,-8,35
Sonderjyske,2745,6,8,6,10,28,29,-1,30
AC Horsens,2745,7,5,14,11,35,53,-18,29
Randers FC,2745,8,5,7,12,24,40,-16,22
Silkeborg IF,2745,9,6,3,13,29,45,-16,21
Lyngby,2745,10,3,10,11,27,45,-18,19
AGF Aarhus,2745,11,4,6,12,17,40,-23,18
FC Midtjylla,2746,1,21,4,5,68,37,31,67
Brondby,2746,2,19,6,5,72,36,36,63
FC Nords,2746,3,15,6,9,76,53,23,51
Copenhagen,2746,4,14,5,11,55,41,14,47
AaB,2746,5,7,13,10,40,51,-11,34
AC Horsens,2746,6,6,14,10,34,53,-19,32
Sonderjyske,2746,7,8,6,10,28,29,-1,30
Randers FC,2746,8,5,7,12,24,40,-16,22
Silkeborg IF,2746,9,6,3,13,28,45,-17,21
Lyngby,2746,10,3,10,11,27,45,-18,19
AGF Aarhus,2746,11,4,6,12,17,39,-22,18
FC Midtjylla,2747,1,22,4,4,69,37,32,70
Brondby,2747,2,20,6,4,75,33,42,66
Copenhagen,2747,3,14,6,10,58,43,15,48
FC Nords,2747,4,13,6,11,71,57,14,45
AaB,2747,5,7,12,11,35,47,-12,33
AC Horsens,2747,6,6,14,10,37,54,-17,32
Sonderjyske,2747,7,8,6,10,28,29,-1,30
Randers FC,2747,8,5,7,12,25,41,-16,22
Silkeborg IF,2747,9,6,3,13,28,44,-16,21
Lyngby,2747,10,3,10,11,28,46,-18,19
AGF Aarhus,2747,11,4,6,12,16,39,-23,18
FC Midtjylla,2748,1,21,4,5,63,37,26,67
Brondby,2748,2,20,6,4,68,32,36,66
Copenhagen,2748,3,14,5,11,57,43,14,47
FC Nords,2748,4,13,7,10,67,49,18,46
AC Horsens,2748,5,7,14,9,35,48,-13,35
AaB,2748,6,6,14,10,36,43,-7,32
Sonderjyske,2748,7,8,6,10,28,29,-1,30
Lyngby,2748,8,4,9,11,31,47,-16,21
Silkeborg IF,2748,9,6,3,13,28,45,-17,21
Randers FC,2748,10,5,6,13,26,44,-18,21
AGF Aarhus,2748,11,4,6,12,17,39,-22,18
FC Midtjylla,2749,1,21,5,4,66,37,29,68
Brondby,2749,2,19,7,4,68,34,34,64
FC Nords,2749,3,12,10,8,69,50,19,46
Copenhagen,2749,4,13,6,11,58,46,12,45
AaB,2749,5,8,14,8,40,39,1,38
Sonderjyske,2749,6,8,6,10,28,29,-1,30
AC Horsens,2749,7,5,14,11,33,54,-21,29
Randers FC,2749,8,6,6,12,26,40,-14,24
AGF Aarhus,2749,9,5,6,11,17,36,-19,21
Lyngby,2749,10,3,9,12,27,47,-20,18
Silkeborg IF,2749,11,5,3,14,25,45,-20,18
Brondby,2750,1,21,6,3,73,33,40,69
FC Midtjylla,2750,2,19,6,5,71,41,30,63
FC Nords,2750,3,14,7,9,71,53,18,49
Copenhagen,2750,4,14,6,10,58,44,14,48
AaB,2750,5,6,15,9,38,44,-6,33
Sonderjyske,2750,6,8,6,10,28,29,-1,30
AC Horsens,2750,7,6,12,12,38,60,-22,30
Randers FC,2750,8,6,6,12,24,39,-15,24
Silkeborg IF,2750,9,5,4,13,25,44,-19,19
AGF Aarhus,2750,10,4,7,11,16,36,-20,19
Lyngby,2750,11,3,9,12,26,45,-19,18
Brondby,2751,1,22,6,2,68,27,41,72
FC Midtjylla,2751,2,20,4,6,65,40,25,64
FC Nords,2751,3,15,6,9,72,51,21,51
Copenhagen,2751,4,13,6,11,55,43,12,45
AaB,2751,5,6,13,11,36,45,-9,31
AC Horsens,2751,6,6,13,11,33,49,-16,31
Sonderjyske,2751,7,8,6,10,28,29,-1,30
Lyngby,2751,8,4,9,11,30,45,-15,21
Randers FC,2751,9,5,6,13,24,43,-19,21
AGF Aarhus,2751,10,5,6,11,17,36,-19,21
Silkeborg IF,2751,11,5,3,14,25,45,-20,18
Brondby,2752,1,20,5,5,70,38,32,65
FC Midtjylla,2752,2,20,4,6,69,39,30,64
FC Nords,2752,3,17,6,7,79,47,32,57
Copenhagen,2752,4,15,4,11,66,49,17,49
AC Horsens,2752,5,6,13,11,36,60,-24,31
Sonderjyske,2752,6,8,6,10,28,29,-1,30
AaB,2752,7,6,12,12,37,50,-13,30
Randers FC,2752,8,6,6,12,25,40,-15,24
Silkeborg IF,2752,9,6,3,13,27,45,-18,21
Lyngby,2752,10,3,9,12,27,46,-19,18
AGF Aarhus,2752,11,4,6,12,17,38,-21,18
Brondby,2753,1,21,5,4,70,32,38,68
FC Midtjylla,2753,2,20,4,6,67,40,27,64
FC Nords,2753,3,15,6,9,78,53,25,51
Copenhagen,2753,4,15,4,11,58,44,14,49
AC Horsens,2753,5,7,12,11,36,55,-19,33
AaB,2753,6,7,11,12,36,47,-11,32
Sonderjyske,2753,7,8,6,10,28,29,-1,30
Lyngby,2753,8,4,9,11,28,44,-16,21
Silkeborg IF,2753,9,6,3,13,26,44,-18,21
Randers FC,2753,10,5,6,13,23,41,-18,21
AGF Aarhus,2753,11,4,6,12,16,37,-21,18
Brondby,2754,1,21,5,4,75,33,42,68
FC Midtjylla,2754,2,19,5,6,66,48,18,62
FC Nords,2754,3,14,7,9,73,50,23,49
Copenhagen,2754,4,14,4,12,57,47,10,46
AC Horsens,2754,5,8,12,10,37,47,-10,36
AaB,2754,6,8,11,11,35,44,-9,35
Sonderjyske,2754,7,8,6,10,28,29,-1,30
Randers FC,2754,8,6,6,12,24,39,-15,24
Silkeborg IF,2754,9,6,3,13,29,45,-16,21
Lyngby,2754,10,3,9,12,26,45,-19,18
AGF Aarhus,2754,11,4,6,12,17,40,-23,18
Brondby,2755,1,20,7,3,70,34,36,67
FC Midtjylla,2755,2,18,7,5,69,42,27,61
Copenhagen,2755,3,16,4,10,67,45,22,52
FC Nords,2755,4,14,9,7,74,51,23,51
AaB,2755,5,6,13,11,35,45,-10,31
Sonderjyske,2755,6,8,6,10,28,29,-1,30
AC Horsens,2755,7,5,14,11,36,60,-24,29
Lyngby,2755,8,4,9,11,29,44,-15,21
Silkeborg IF,2755,9,6,3,13,28,44,-16,21
Randers FC,2755,10,5,6,13,23,42,-19,21
AGF Aarhus,2755,11,4,6,12,16,39,-23,18
Brondby,2756,1,22,5,3,73,33,40,71
FC Midtjylla,2756,2,20,5,5,66,38,28,65
FC Nords,2756,3,13,8,9,76,55,21,47
Copenhagen,2756,4,12,5,13,54,49,5,41
AaB,2756,5,8,14,8,39,41,-2,38
AC Horsens,2756,6,6,13,11,38,56,-18,31
Sonderjyske,2756,7,8,6,10,28,29,-1,30
Randers FC,2756,8,5,7,12,23,39,-16,22
Lyngby,2756,9,3,10,11,26,44,-18,19
Silkeborg IF,2756,10,5,4,13,26,45,-19,19
AGF Aarhus,2756,11,4,7,11,17,37,-20,19
Brondby,2757,1,23,5,2,72,30,42,74
FC Midtjylla,2757,2,19,5,6,64,41,23,62
FC Nords,2757,3,14,6,10,74,54,20,48
Copenhagen,2757,4,14,4,12,57,47,10,46
AaB,2757,5,7,12,11,35,42,-7,33
AC Horsens,2757,6,7,12,11,39,53,-14,33
Sonderjyske,2757,7,8,6,10,28,29,-1,30
Lyngby,2757,8,4,9,11,28,44,-16,21
Randers FC,2757,9,5,6,13,23,41,-18,21
Silkeborg IF,2757,10,5,4,13,25,44,-19,19
AGF Aarhus,2757,11,4,7,11,16,36,-20,19
Brondby,2758,1,20,6,4,68,35,33,66
FC Midtjylla,2758,2,20,5,5,67,43,24,65
FC Nords,2758,3,14,7,9,70,48,22,49
Copenhagen,2758,4,14,5,11,63,45,18,47
AC Horsens,2758,5,6,15,9,38,53,-15,33
AaB,2758,6,6,14,10,36,44,-8,32
Sonderjyske,2758,7,8,6,10,28,29,-1,30
Lyngby,2758,8,4,9,11,27,44,-17,21
Randers FC,2758,9,5,6,13,23,40,-17,21
Silkeborg IF,2758,10,5,4,13,28,47,-19,19
AGF Aarhus,2758,11,4,7,11,19,39,-20,19
Brondby,2759,1,20,7,3,71,32,39,67
FC Midtjylla,2759,2,20,5,5,70,40,30,65
FC Nords,2759,3,14,7,9,74,51,23,49
Copenhagen,2759,4,14,6,10,62,46,16,48
AaB,2759,5,7,12,11,38,48,-10,33
AC Horsens,2759,6,6,13,11,33,57,-24,31
Sonderjyske,2759,7,8,6,10,28,29,-1,30
Lyngby,2759,8,4,9,11,27,44,-17,21
Randers FC,2759,9,5,6,13,23,40,-17,21
Silkeborg IF,2759,10,6,3,13,26,44,-18,21
AGF Aarhus,2759,11,4,6,12,16,37,-21,18
Brondby,2760,1,22,6,2,71,30,41,72
FC Midtjylla,2760,2,19,4,7,64,38,26,61
FC Nords,2760,3,15,6,9,77,54,23,51
Copenhagen,2760,4,13,6,11,56,45,11,45
AaB,2760,5,7,12,11,36,45,-9,33
AC Horsens,2760,6,7,12,11,35,53,-18,33
Sonderjyske,2760,7,8,6,10,28,29,-1,30
Randers FC,2760,8,6,6,12,24,39,-15,24
Silkeborg IF,2760,9,6,3,13,26,44,-18,21
Lyngby,2760,10,3,9,12,26,45,-19,18
AGF Aarhus,2760,11,4,6,12,16,37,-21,18
Brondby,2761,1,22,5,3,73,29,44,71
FC Midtjylla,2761,2,20,4,6,70,43,27,64
Copenhagen,2761,3,15,5,10,61,42,19,50
FC Nords,2761,4,12,9,9,70,53,17,45
AaB,2761,5,8,12,10,38,46,-8,36
Sonderjyske,2761,6,8,6,10,28,29,-1,30
AC Horsens,2761,7,5,13,12,31,56,-25,28
Silkeborg IF,2761,8,6,3,13,28,44,-16,21
Lyngby,2761,9,4,9,11,27,44,-17,21
Randers FC,2761,10,5,6,13,23,40,-17,21
AGF Aarhus,2761,11,4,6,12,16,39,-23,18
Brondby,2762,1,21,6,3,75,32,43,69
FC Midtjylla,2762,2,19,4,7,61,40,21,61
FC Nords,2762,3,14,8,8,77,50,27,50
Copenhagen,2762,4,15,5,10,58,46,12,50
AaB,2762,5,8,12,10,36,40,-4,36
Sonderjyske,2762,6,8,6,10,28,29,-1,30
AC Horsens,2762,7,5,13,12,32,57,-25,28
Lyngby,2762,8,4,9,11,28,44,-16,21
Randers FC,2762,9,5,6,13,23,41,-18,21
AGF Aarhus,2762,10,5,6,11,18,37,-19,21
Silkeborg IF,2762,11,5,3,14,26,46,-20,18
FC Midtjylla,2763,1,20,6,4,66,37,29,66
Brondby,2763,2,18,8,4,66,34,32,62
FC Nords,2763,3,15,8,7,78,48,30,53
Copenhagen,2763,4,13,7,10,56,42,14,46
AaB,2763,5,7,14,9,36,38,-2,35
Sonderjyske,2763,6,8,6,10,28,29,-1,30
AC Horsens,2763,7,5,13,12,30,59,-29,28
Lyngby,2763,8,4,9,11,27,44,-17,21
Randers FC,2763,9,5,6,13,23,40,-17,21
Silkeborg IF,2763,10,5,4,13,26,45,-19,19
AGF Aarhus,2763,11,4,7,11,17,37,-20,19
FC Midtjylla,2764,1,20,5,5,66,34,32,65
Brondby,2764,2,19,6,5,69,38,31,63
FC Nords,2764,3,15,6,9,75,53,22,51
Copenhagen,2764,4,12,7,11,51,44,7,43
AaB,2764,5,8,13,9,42,45,-3,37
AC Horsens,2764,6,7,13,10,34,49,-15,34
Sonderjyske,2764,7,8,6,10,28,29,-1,30
Randers FC,2764,8,5,7,12,26,42,-16,22
Silkeborg IF,2764,9,6,3,13,28,44,-16,21
Lyngby,2764,10,3,10,11,29,47,-18,19
AGF Aarhus,2764,11,4,6,12,16,39,-23,18
FC Midtjylla,2765,1,21,4,5,68,38,30,67
Brondby,2765,2,20,5,5,66,32,34,65
FC Nords,2765,3,14,6,10,71,51,20,48
Copenhagen,2765,4,14,5,11,53,41,12,47
AaB,2765,5,8,11,11,36,42,-6,35
AC Horsens,2765,6,7,13,10,37,53,-16,34
Sonderjyske,2765,7,8,6,10,28,29,-1,30
Lyngby,2765,8,4,9,11,28,45,-17,21
Randers FC,2765,9,5,6,13,24,41,-17,21
AGF Aarhus,2765,10,5,6,11,19,36,-17,21
Silkeborg IF,2765,11,5,3,14,25,47,-22,18
Brondby,2766,1,21,6,3,73,32,41,69
FC Midtjylla,2766,2,19,6,5,68,43,25,63
FC Nords,2766,3,16,6,8,82,52,30,54
Copenhagen,2766,4,13,4,13,56,53,3,43
AaB,2766,5,8,11,11,38,43,-5,35
AC Horsens,2766,6,6,13,11,35,55,-20,31
Sonderjyske,2766,7,8,6,10,28,29,-1,30
Randers FC,2766,8,5,7,12,25,41,-16,22
Silkeborg IF,2766,9,6,3,13,26,44,-18,21
Lyngby,2766,10,3,10,11,28,46,-18,19
AGF Aarhus,2766,11,4,6,12,16,37,-21,18
FC Midtjylla,2767,1,21,4,5,65,35,30,67
Brondby,2767,2,20,6,4,69,34,35,66
Copenhagen,2767,3,16,4,10,60,42,18,52
FC Nords,2767,4,12,6,12,70,55,15,42
AaB,2767,5,8,12,10,36,44,-8,36
AC Horsens,2767,6,6,14,10,33,49,-16,32
Sonderjyske,2767,7,8,6,10,28,29,-1,30
Lyngby,2767,8,4,9,11,30,44,-14,21
AGF Aarhus,2767,9,5,6,11,18,36,-18,21
Randers FC,2767,10,5,6,13,23,43,-20,21
Silkeborg IF,2767,11,5,3,14,25,46,-21,18
Brondby,2768,1,18,8,4,65,33,32,62
FC Midtjylla,2768,2,19,5,6,65,39,26,62
FC Nords,2768,3,17,6,7,79,48,31,57
Copenhagen,2768,4,13,6,11,56,46,10,45
AC Horsens,2768,5,7,13,10,38,54,-16,34
AaB,2768,6,7,12,11,34,43,-9,33
Sonderjyske,2768,7,8,6,10,28,29,-1,30
Randers FC,2768,8,5,7,12,24,40,-16,22
Silkeborg IF,2768,9,6,3,13,28,46,-18,21
Lyngby,2768,10,3,10,11,27,45,-18,19
AGF Aarhus,2768,11,4,6,12,18,39,-21,18
Brondby,2769,1,23,5,2,70,29,41,74
FC Midtjylla,2769,2,21,4,5,69,38,31,67
FC Nords,2769,3,15,6,9,77,52,25,51
Copenhagen,2769,4,13,4,13,57,47,10,43
AaB,2769,5,7,11,12,34,45,-11,32
Sonderjyske,2769,6,8,6,10,28,29,-1,30
AC Horsens,2769,7,6,12,12,34,56,-22,30
Lyngby,2769,8,4,9,11,29,46,-17,21
Silkeborg IF,2769,9,6,3,13,27,44,-17,21
Randers FC,2769,10,5,6,13,25,42,-17,21
AGF Aarhus,2769,11,4,6,12,16,38,-22,18
Brondby,2770,1,19,7,4,68,34,34,64
FC Midtjylla,2770,2,19,5,6,66,41,25,62
FC Nords,2770,3,14,7,9,71,53,18,49
Copenhagen,2770,4,14,6,10,58,42,16,48
AaB,2770,5,8,13,9,37,40,-3,37
AC Horsens,2770,6,7,12,11,37,53,-16,33
Sonderjyske,2770,7,8,6,10,28,29,-1,30
Randers FC,2770,8,5,7,12,25,41,-16,22
Silkeborg IF,2770,9,6,3,13,26,44,-18,21
Lyngby,2770,10,3,10,11,28,46,-18,19
AGF Aarhus,2770,11,4,6,12,16,37,-21,18
Brondby,2771,1,21,6,3,74,31,43,69
FC Midtjylla,2771,2,17,6,7,62,44,18,57
FC Nords,2771,3,14,8,8,72,50,22,50
Copenhagen,2771,4,14,6,10,61,46,15,48
AC Horsens,2771,5,8,13,9,38,50,-12,37
AaB,2771,6,7,11,12,34,46,-12,32
Sonderjyske,2771,7,8,6,10,28,29,-1,30
Randers FC,2771,8,6,6,12,25,40,-15,24
Silkeborg IF,2771,9,6,3,13,28,45,-17,21
Lyngby,2771,10,3,9,12,27,46,-19,18
AGF Aarhus,2771,11,4,6,12,17,39,-22,18
Brondby,2772,1,19,6,5,68,36,32,63
FC Midtjylla,2772,2,19,6,5,65,36,29,63
Copenhagen,2772,3,16,4,10,63,43,20,52
FC Nords,2772,4,13,8,9,72,54,18,47
AC Horsens,2772,5,8,12,10,38,56,-18,36
AaB,2772,6,7,12,11,36,43,-7,33
Sonderjyske,2772,7,8,6,10,28,29,-1,30
Lyngby,2772,8,4,9,11,29,44,-15,21
Silkeborg IF,2772,9,6,3,13,28,44,-16,21
Randers FC,2772,10,5,6,13,23,42,-19,21
AGF Aarhus,2772,11,4,6,12,16,39,-23,18
Brondby,2773,1,21,6,3,74,33,41,69
FC Midtjylla,2773,2,20,4,6,69,37,32,64
FC Nords,2773,3,13,8,9,73,54,19,47
Copenhagen,2773,4,13,6,11,55,46,9,45
AaB,2773,5,9,12,9,38,43,-5,39
Sonderjyske,2773,6,8,6,10,28,29,-1,30
AC Horsens,2773,7,5,14,11,32,54,-22,29
Randers FC,2773,8,5,7,12,24,40,-16,22
Silkeborg IF,2773,9,6,3,13,29,45,-16,21
Lyngby,2773,10,3,10,11,27,45,-18,19
AGF Aarhus,2773,11,4,6,12,17,40,-23,18
Brondby,2774,1,22,6,2,73,31,42,72
FC Midtjylla,2774,2,20,5,5,67,40,27,65
Copenhagen,2774,3,14,6,10,64,47,17,48
FC Nords,2774,4,12,8,10,71,58,13,44
AaB,2774,5,7,12,11,40,48,-8,33
Sonderjyske,2774,6,8,6,10,28,29,-1,30
AC Horsens,2774,7,5,15,10,37,54,-17,30
Lyngby,2774,8,4,9,11,28,45,-17,21
Randers FC,2774,9,5,6,13,24,41,-17,21
Silkeborg IF,2774,10,5,4,13,25,44,-19,19
AGF Aarhus,2774,11,4,7,11,16,36,-20,19
Brondby,2775,1,20,7,3,72,33,39,67
FC Midtjylla,2775,2,20,6,4,68,40,28,66
Copenhagen,2775,3,15,5,10,64,47,17,50
FC Nords,2775,4,13,7,10,74,60,14,46
AaB,2775,5,7,13,10,41,45,-4,34
Sonderjyske,2775,6,8,6,10,28,29,-1,30
AC Horsens,2775,7,5,14,11,35,55,-20,29
Randers FC,2775,8,6,6,12,24,39,-15,24
Silkeborg IF,2775,9,6,3,13,29,44,-15,21
Lyngby,2775,10,3,9,12,26,45,-19,18
AGF Aarhus,2775,11,4,6,12,16,40,-24,18
Brondby,2776,1,22,6,2,75,28,47,72
FC Midtjylla,2776,2,20,4,6,63,39,24,64
Copenhagen,2776,3,14,4,12,57,43,14,46
FC Nords,2776,4,13,6,11,69,59,10,45
AC Horsens,2776,5,8,12,10,34,48,-14,36
AaB,2776,6,7,12,11,36,43,-7,33
Sonderjyske,2776,7,8,6,10,28,29,-1,30
Randers FC,2776,8,6,6,12,26,41,-15,24
Silkeborg IF,2776,9,6,3,13,28,46,-18,21
Lyngby,2776,10,3,9,12,28,47,-19,18
AGF Aarhus,2776,11,4,6,12,18,39,-21,18
Brondby,2777,1,23,5,2,76,30,46,74
FC Midtjylla,2777,2,18,5,7,62,43,19,59
FC Nords,2777,3,14,6,10,74,53,21,48
Copenhagen,2777,4,13,5,12,55,45,10,44
AaB,2777,5,8,11,11,37,44,-7,35
AC Horsens,2777,6,7,14,9,40,55,-15,35
Sonderjyske,2777,7,8,6,10,28,29,-1,30
Lyngby,2777,8,4,9,11,28,45,-17,21
Randers FC,2777,9,5,6,13,24,41,-17,21
Silkeborg IF,2777,10,6,3,13,26,44,-18,21
AGF Aarhus,2777,11,4,6,12,16,37,-21,18
Brondby,2778,1,20,7,3,71,34,37,67
FC Midtjylla,2778,2,20,5,5,73,41,32,65
FC Nords,2778,3,15,8,7,78,49,29,53
Copenhagen,2778,4,13,6,11,56,47,9,45
AaB,2778,5,6,14,10,37,51,-14,32
Sonderjyske,2778,6,8,6,10,28,29,-1,30
AC Horsens,2778,7,5,14,11,32,51,-19,29
Randers FC,2778,8,5,7,12,24,40,-16,22
Silkeborg IF,2778,9,6,3,13,27,44,-17,21
Lyngby,2778,10,3,10,11,27,45,-18,19
AGF Aarhus,2778,11,4,6,12,16,38,-22,18
Brondby,2779,1,21,6,3,71,32,39,69
FC Midtjylla,2779,2,20,4,6,64,39,25,64
Copenhagen,2779,3,15,4,11,57,43,14,49
FC Nords,2779,4,14,6,10,72,53,19,48
AaB,2779,5,9,11,10,42,43,-1,38
Sonderjyske,2779,6,8,6,10,28,29,-1,30
AC Horsens,2779,7,5,13,12,33,55,-22,28
Lyngby,2779,8,4,9,11,28,44,-16,21
Randers FC,2779,9,5,6,13,23,41,-18,21
AGF Aarhus,2779,10,5,6,11,17,36,-19,21
Silkeborg IF,2779,11,5,3,14,25,45,-20,18
Brondby,2780,1,22,5,3,76,32,44,71
FC Midtjylla,2780,2,21,5,4,67,35,32,68
Copenhagen,2780,3,15,4,11,62,44,18,49
FC Nords,2780,4,13,8,9,71,54,17,47
Sonderjyske,2780,5,8,6,10,28,29,-1,30
AaB,2780,6,6,12,12,34,47,-13,30
AC Horsens,2780,7,5,14,11,35,59,-24,29
Lyngby,2780,8,4,9,11,29,44,-15,21
Silkeborg IF,2780,9,6,3,13,26,44,-18,21
Randers FC,2780,10,5,6,13,23,42,-19,21
AGF Aarhus,2780,11,4,6,12,16,37,-21,18
Brondby,2781,1,21,5,4,76,34,42,68
FC Midtjylla,2781,2,20,4,6,71,43,28,64
FC Nords,2781,3,14,6,10,77,55,22,48
Copenhagen,2781,4,13,4,13,53,46,7,43
AaB,2781,5,9,12,9,38,43,-5,39
AC Horsens,2781,6,7,13,10,38,58,-20,34
Sonderjyske,2781,7,8,6,10,28,29,-1,30
Lyngby,2781,8,4,9,11,29,46,-17,21
Randers FC,2781,9,5,6,13,25,42,-17,21
Silkeborg IF,2781,10,6,3,13,27,45,-18,21
AGF Aarhus,2781,11,4,6,12,17,38,-21,18
Brondby,2782,1,19,8,3,69,35,34,65
FC Midtjylla,2782,2,19,5,6,66,41,25,62
FC Nords,2782,3,16,7,7,75,50,25,55
Copenhagen,2782,4,14,5,11,59,46,13,47
AaB,2782,5,7,12,11,40,46,-6,33
AC Horsens,2782,6,6,13,11,36,53,-17,31
Sonderjyske,2782,7,8,6,10,28,29,-1,30
Randers FC,2782,8,5,7,12,24,40,-16,22
Silkeborg IF,2782,9,6,3,13,26,44,-18,21
Lyngby,2782,10,3,10,11,27,45,-18,19
AGF Aarhus,2782,11,4,6,12,16,37,-21,18
Brondby,2783,1,23,5,2,77,27,50,74
FC Midtjylla,2783,2,20,4,6,72,43,29,64
FC Nords,2783,3,13,6,11,68,52,16,45
Copenhagen,2783,4,13,5,12,55,49,6,44
AaB,2783,5,9,11,10,40,47,-7,38
AC Horsens,2783,6,6,13,11,35,55,-20,31
Sonderjyske,2783,7,8,6,10,28,29,-1,30
Lyngby,2783,8,4,9,11,27,44,-17,21
Randers FC,2783,9,5,6,13,23,40,-17,21
Silkeborg IF,2783,10,6,3,13,26,44,-18,21
AGF Aarhus,2783,11,4,6,12,16,37,-21,18
Brondby,2784,1,20,6,4,67,31,36,66
FC Midtjylla,2784,2,19,6,5,64,37,27,63
FC Nords,2784,3,15,7,8,73,49,24,52
Copenhagen,2784,4,15,4,11,58,45,13,49
AaB,2784,5,8,12,10,37,43,-6,36
Sonderjyske,2784,6,8,6,10,28,29,-1,30
AC Horsens,2784,7,5,13,12,30,50,-20,28
Lyngby,2784,8,4,9,11,28,44,-16,21
Silkeborg IF,2784,9,6,3,13,26,44,-18,21
Randers FC,2784,10,5,6,13,23,41,-18,21
AGF Aarhus,2784,11,4,6,12,16,37,-21,18
FC Midtjylla,2785,1,19,6,5,65,38,27,63
Brondby,2785,2,18,7,5,67,37,30,61
FC Nords,2785,3,14,9,7,75,50,25,51
Copenhagen,2785,4,14,4,12,56,49,7,46
AaB,2785,5,8,13,9,44,43,1,37
AC Horsens,2785,6,6,15,9,36,52,-16,33
Sonderjyske,2785,7,8,6,10,28,29,-1,30
Randers FC,2785,8,6,6,12,24,39,-15,24
Silkeborg IF,2785,9,5,4,13,26,45,-19,19
AGF Aarhus,2785,10,4,7,11,17,37,-20,19
Lyngby,2785,11,3,9,12,26,45,-19,18
Brondby,2786,1,21,6,3,72,32,40,69
FC Midtjylla,2786,2,21,4,5,68,36,32,67
FC Nords,2786,3,15,6,9,74,53,21,51
Copenhagen,2786,4,13,5,12,55,49,6,44
AaB,2786,5,6,14,10,38,45,-7,32
AC Horsens,2786,6,6,13,11,34,52,-18,31
Sonderjyske,2786,7,8,6,10,28,29,-1,30
Randers FC,2786,8,5,7,12,23,39,-16,22
AGF Aarhus,2786,9,5,6,11,18,37,-19,21
Lyngby,2786,10,3,10,11,26,44,-18,19
Silkeborg IF,2786,11,5,3,14,26,46,-20,18
Brondby,2787,1,20,7,3,69,31,38,67
FC Midtjylla,2787,2,19,7,4,68,41,27,64
FC Nords,2787,3,15,7,8,75,49,26,52
Copenhagen,2787,4,13,4,13,55,49,6,43
AaB,2787,5,8,13,9,38,43,-5,37
Sonderjyske,2787,6,8,6,10,28,29,-1,30
AC Horsens,2787,7,6,12,12,34,52,-18,30
Lyngby,2787,8,4,9,11,27,44,-17,21
Randers FC,2787,9,5,6,13,23,40,-17,21
AGF Aarhus,2787,10,5,6,11,18,37,-19,21
Silkeborg IF,2787,11,5,3,14,26,46,-20,18
Brondby,2788,1,22,5,3,73,30,43,71
FC Midtjylla,2788,2,20,4,6,66,37,29,64
FC Nords,2788,3,14,6,10,72,53,19,48
Copenhagen,2788,4,14,4,12,57,48,9,46
AaB,2788,5,8,11,11,41,47,-6,35
AC Horsens,2788,6,7,12,11,32,52,-20,33
Sonderjyske,2788,7,8,6,10,28,29,-1,30
Randers FC,2788,8,6,6,12,27,40,-13,24
AGF Aarhus,2788,9,5,6,11,18,36,-18,21
Lyngby,2788,10,3,9,12,27,48,-21,18
Silkeborg IF,2788,11,5,3,14,25,46,-21,18
FC Midtjylla,2789,1,20,5,5,67,37,30,65
Brondby,2789,2,19,6,5,69,36,33,63
FC Nords,2789,3,15,6,9,74,54,20,51
Copenhagen,2789,4,14,6,10,58,44,14,48
AaB,2789,5,8,11,11,36,42,-6,35
AC Horsens,2789,6,6,14,10,36,53,-17,32
Sonderjyske,2789,7,8,6,10,28,29,-1,30
Randers FC,2789,8,5,7,12,25,41,-16,22
Lyngby,2789,9,3,10,11,28,46,-18,19
Silkeborg IF,2789,10,5,4,13,25,44,-19,19
AGF Aarhus,2789,11,4,7,11,16,36,-20,19
Brondby,2790,1,21,6,3,70,30,40,69
FC Midtjylla,2790,2,19,5,6,68,43,25,62
Copenhagen,2790,3,15,5,10,60,44,16,50
FC Nords,2790,4,14,6,10,70,53,17,48
AC Horsens,2790,5,7,13,10,35,49,-14,34
AaB,2790,6,7,11,12,38,48,-10,32
Sonderjyske,2790,7,8,6,10,28,29,-1,30
Randers FC,2790,8,6,6,12,25,40,-15,24
AGF Aarhus,2790,9,5,6,11,20,37,-17,21
Lyngby,2790,10,3,9,12,27,46,-19,18
Silkeborg IF,2790,11,5,3,14,26,48,-22,18
Brondby,2791,1,20,8,2,70,33,37,68
FC Midtjylla,2791,2,21,4,5,71,40,31,67
Copenhagen,2791,3,14,5,11,55,44,11,47
FC Nords,2791,4,12,7,11,69,52,17,43
AaB,2791,5,9,11,10,41,44,-3,38
AC Horsens,2791,6,6,13,11,35,54,-19,31
Sonderjyske,2791,7,8,6,10,28,29,-1,30
Randers FC,2791,8,6,6,12,24,39,-15,24
Silkeborg IF,2791,9,5,4,13,26,45,-19,19
AGF Aarhus,2791,10,4,7,11,17,37,-20,19
Lyngby,2791,11,3,9,12,26,45,-19,18
Brondby,2792,1,21,5,4,71,34,37,68
FC Midtjylla,2792,2,19,4,7,65,41,24,61
FC Nords,2792,3,15,7,8,74,50,24,52
Copenhagen,2792,4,12,6,12,57,50,7,42
AaB,2792,5,10,11,9,42,43,-1,41
AC Horsens,2792,6,6,13,11,35,52,-17,31
Sonderjyske,2792,7,8,6,10,28,29,-1,30
Randers FC,2792,8,5,7,12,24,40,-16,22
AGF Aarhus,2792,9,5,6,11,19,36,-17,21
Lyngby,2792,10,3,10,11,27,45,-18,19
Silkeborg IF,2792,11,5,3,14,25,47,-22,18
Brondby,2793,1,23,5,2,72,29,43,74
FC Midtjylla,2793,2,20,4,6,70,39,31,64
Copenhagen,2793,3,15,4,11,59,45,14,49
FC Nords,2793,4,12,8,10,70,60,10,44
AaB,2793,5,7,12,11,39,45,-6,33
AC Horsens,2793,6,6,13,11,35,53,-18,31
Sonderjyske,2793,7,8,6,10,28,29,-1,30
Randers FC,2793,8,6,6,12,25,39,-14,24
Silkeborg IF,2793,9,5,4,13,27,46,-19,19
AGF Aarhus,2793,10,4,7,11,18,38,-20,19
Lyngby,2793,11,3,9,12,26,46,-20,18
FC Midtjylla,2794,1,21,4,5,64,35,29,67
Brondby,2794,2,19,6,5,65,37,28,63
FC Nords,2794,3,16,7,7,75,48,27,55
Copenhagen,2794,4,14,5,11,56,41,15,47
AC Horsens,2794,5,7,13,10,36,50,-14,34
Sonderjyske,2794,6,8,6,10,28,29,-1,30
AaB,2794,7,6,11,13,33,44,-11,29
Randers FC,2794,8,6,6,12,25,40,-15,24
Silkeborg IF,2794,9,5,4,13,25,44,-19,19
AGF Aarhus,2794,10,4,7,11,16,36,-20,19
Lyngby,2794,11,3,9,12,27,46,-19,18
Brondby,2795,1,19,8,3,67,34,33,65
FC Midtjylla,2795,2,19,4,7,66,40,26,61
FC Nords,2795,3,14,7,9,73,48,25,49
Copenhagen,2795,4,15,4,11,59,43,16,49
AaB,2795,5,9,12,9,36,40,-4,39
AC Horsens,2795,6,6,13,11,36,58,-22,31
Sonderjyske,2795,7,8,6,10,28,29,-1,30
Randers FC,2795,8,5,7,12,24,40,-16,22
Silkeborg IF,2795,9,6,3,13,27,44,-17,21
Lyngby,2795,10,3,10,11,27,45,-18,19
AGF Aarhus,2795,11,4,6,12,16,38,-22,18
Brondby,2796,1,21,6,3,69,31,38,69
FC Midtjylla,2796,2,20,5,5,66,39,27,65
FC Nords,2796,3,14,6,10,74,53,21,48
Copenhagen,2796,4,14,5,11,53,41,12,47
AaB,2796,5,7,13,10,35,41,-6,34
Sonderjyske,2796,6,8,6,10,28,29,-1,30
AC Horsens,2796,7,5,15,10,31,49,-18,30
Randers FC,2796,8,5,7,12,27,43,-16,22
Silkeborg IF,2796,9,6,3,13,27,45,-18,21
Lyngby,2796,10,3,10,11,30,48,-18,19
AGF Aarhus,2796,11,4,6,12,17,38,-21,18
Brondby,2797,1,21,6,3,71,29,42,69
FC Midtjylla,2797,2,20,6,4,66,38,28,66
Copenhagen,2797,3,14,7,9,61,44,17,49
FC Nords,2797,4,12,7,11,69,58,11,43
AaB,2797,5,8,12,10,42,43,-1,36
Sonderjyske,2797,6,8,6,10,28,29,-1,30
AC Horsens,2797,7,6,12,12,34,57,-23,30
Randers FC,2797,8,6,6,12,25,39,-14,24
Silkeborg IF,2797,9,5,4,13,26,45,-19,19
AGF Aarhus,2797,10,4,7,11,17,37,-20,19
Lyngby,2797,11,3,9,12,26,46,-20,18
Brondby,2798,1,20,8,2,71,32,39,68
FC Midtjylla,2798,2,20,5,5,64,36,28,65
FC Nords,2798,3,13,9,8,69,49,20,48
Copenhagen,2798,4,14,6,10,59,46,13,48
AaB,2798,5,7,11,12,34,44,-10,32
AC Horsens,2798,6,6,13,11,35,51,-16,31
Sonderjyske,2798,7,8,6,10,28,29,-1,30
Randers FC,2798,8,6,6,12,26,41,-15,24
AGF Aarhus,2798,9,5,6,11,18,37,-19,21
Lyngby,2798,10,3,9,12,28,47,-19,18
Silkeborg IF,2798,11,5,3,14,26,46,-20,18
Brondby,2799,1,21,5,4,71,34,37,68
FC Midtjylla,2799,2,21,4,5,68,35,33,67
FC Nords,2799,3,14,6,10,75,52,23,48
Copenhagen,2799,4,13,5,12,53,49,4,44
AaB,2799,5,9,12,9,38,40,-2,39
Sonderjyske,2799,6,8,6,10,28,29,-1,30
AC Horsens,2799,7,5,14,11,31,52,-21,29
Randers FC,2799,8,5,7,12,25,41,-16,22
AGF Aarhus,2799,9,5,6,11,17,36,-19,21
Lyngby,2799,10,3,10,11,28,46,-18,19
Silkeborg IF,2799,11,5,3,14,25,45,-20,18
Brondby,2800,1,21,7,2,68,26,42,70
FC Midtjylla,2800,2,19,6,5,64,37,27,63
FC Nords,2800,3,16,6,8,78,53,25,54
Copenhagen,2800,4,12,6,12,60,53,7,42
AaB,2800,5,8,11,11,40,46,-6,35
Sonderjyske,2800,6,8,6,10,28,29,-1,30
AC Horsens,2800,7,5,14,11,33,54,-21,29
Randers FC,2800,8,6,6,12,24,39,-15,24
AGF Aarhus,2800,9,5,6,11,19,37,-18,21
Lyngby,2800,10,3,9,12,26,45,-19,18
Silkeborg IF,2800,11,5,3,14,26,47,-21,18
Brondby,2801,1,20,8,2,70,31,39,68
FC Midtjylla,2801,2,20,4,6,63,39,24,64
FC Nords,2801,3,15,7,8,80,53,27,52
Copenhagen,2801,4,15,5,10,57,42,15,50
AC Horsens,2801,5,6,13,11,31,51,-20,31
Sonderjyske,2801,6,8,6,10,28,29,-1,30
AaB,2801,7,6,11,13,34,45,-11,29
Randers FC,2801,8,6,6,12,24,39,-15,24
Silkeborg IF,2801,9,6,3,13,28,44,-16,21
Lyngby,2801,10,3,9,12,26,45,-19,18
AGF Aarhus,2801,11,4,6,12,16,39,-23,18
Brondby,2802,1,22,5,3,76,30,46,71
FC Midtjylla,2802,2,19,7,4,64,38,26,64
FC Nords,2802,3,13,8,9,71,59,12,47
Copenhagen,2802,4,12,6,12,55,47,8,42
AaB,2802,5,8,12,10,40,41,-1,36
AC Horsens,2802,6,6,14,10,35,52,-17,32
Sonderjyske,2802,7,8,6,10,28,29,-1,30
Randers FC,2802,8,6,6,12,25,39,-14,24
AGF Aarhus,2802,9,5,6,11,19,36,-17,21
Lyngby,2802,10,3,9,12,26,46,-20,18
Silkeborg IF,2802,11,5,3,14,25,47,-22,18
Brondby,2803,1,20,7,3,68,34,34,67
FC Midtjylla,2803,2,19,6,5,68,40,28,63
FC Nords,2803,3,14,9,7,70,47,23,51
Copenhagen,2803,4,14,6,10,61,43,18,48
AaB,2803,5,6,13,11,35,45,-10,31
AC Horsens,2803,6,6,13,11,32,51,-19,31
Sonderjyske,2803,7,8,6,10,28,29,-1,30
Randers FC,2803,8,5,7,12,25,41,-16,22
AGF Aarhus,2803,9,5,6,11,18,36,-18,21
Lyngby,2803,10,3,10,11,28,46,-18,19
Silkeborg IF,2803,11,5,3,14,25,46,-21,18
Brondby,2804,1,20,6,4,66,30,36,66
FC Midtjylla,2804,2,20,5,5,65,36,29,65
FC Nords,2804,3,15,7,8,78,49,29,52
Copenhagen,2804,4,13,5,12,60,48,12,44
AaB,2804,5,9,12,9,42,44,-2,39
Sonderjyske,2804,6,8,6,10,28,29,-1,30
AC Horsens,2804,7,5,13,12,31,61,-30,28
Lyngby,2804,8,4,9,11,29,44,-15,21
Silkeborg IF,2804,9,6,3,13,27,45,-18,21
Randers FC,2804,10,5,6,13,23,42,-19,21
AGF Aarhus,2804,11,4,6,12,17,38,-21,18
Brondby,2805,1,19,7,4,65,33,32,64
FC Midtjylla,2805,2,19,4,7,65,38,27,61
Copenhagen,2805,3,15,6,9,61,42,19,51
FC Nords,2805,4,14,6,10,73,59,14,48
AaB,2805,5,8,12,10,37,42,-5,36
AC Horsens,2805,6,7,13,10,37,50,-13,34
Sonderjyske,2805,7,8,6,10,28,29,-1,30
Silkeborg IF,2805,8,6,3,13,30,45,-15,21
Lyngby,2805,9,4,9,11,27,44,-17,21
Randers FC,2805,10,5,6,13,23,40,-17,21
AGF Aarhus,2805,11,4,6,12,17,41,-24,18
Brondby,2806,1,19,7,4,69,34,35,64
FC Midtjylla,2806,2,19,7,4,64,38,26,64
Copenhagen,2806,3,14,5,11,55,43,12,47
FC Nords,2806,4,13,7,10,73,53,20,46
AaB,2806,5,9,11,10,39,42,-3,38
AC Horsens,2806,6,7,13,10,35,51,-16,34
Sonderjyske,2806,7,8,6,10,28,29,-1,30
Lyngby,2806,8,4,9,11,30,44,-14,21
Silkeborg IF,2806,9,6,3,13,26,44,-18,21
Randers FC,2806,10,5,6,13,23,43,-20,21
AGF Aarhus,2806,11,4,6,12,16,37,-21,18
Brondby,2807,1,21,7,2,71,31,40,70
FC Midtjylla,2807,2,19,4,7,62,38,24,61
FC Nords,2807,3,15,8,7,77,48,29,53
Copenhagen,2807,4,13,4,13,54,50,4,43
AaB,2807,5,7,12,11,37,45,-8,33
AC Horsens,2807,6,6,15,9,34,49,-15,33
Sonderjyske,2807,7,8,6,10,28,29,-1,30
Lyngby,2807,8,4,9,11,27,44,-17,21
Randers FC,2807,9,5,6,13,23,40,-17,21
AGF Aarhus,2807,10,5,6,11,17,36,-19,21
Silkeborg IF,2807,11,5,3,14,25,45,-20,18
Brondby,2808,1,20,6,4,67,31,36,66
FC Midtjylla,2808,2,20,6,4,66,36,30,66
FC Nords,2808,3,14,6,10,73,55,18,48
Copenhagen,2808,4,13,4,13,54,46,8,43
AaB,2808,5,9,11,10,36,41,-5,38
AC Horsens,2808,6,7,13,10,39,52,-13,34
Sonderjyske,2808,7,8,6,10,28,29,-1,30
Lyngby,2808,8,4,9,11,28,44,-16,21
Randers FC,2808,9,5,6,13,23,41,-18,21
AGF Aarhus,2808,10,5,6,11,17,36,-19,21
Silkeborg IF,2808,11,5,3,14,25,45,-20,18
FC Midtjylla,2809,1,21,5,4,71,36,35,68
Brondby,2809,2,20,7,3,68,32,36,67
Copenhagen,2809,3,15,4,11,60,46,14,49
FC Nords,2809,4,14,6,10,75,53,22,48
AaB,2809,5,7,12,11,34,40,-6,33
Sonderjyske,2809,6,8,6,10,28,29,-1,30
AC Horsens,2809,7,5,14,11,31,58,-27,29
Lyngby,2809,8,4,9,11,30,44,-14,21
Randers FC,2809,9,5,6,13,23,43,-20,21
Silkeborg IF,2809,10,5,4,13,27,46,-19,19
AGF Aarhus,2809,11,4,7,11,18,38,-20,19
FC Midtjylla,2810,1,21,4,5,72,39,33,67
Brondby,2810,2,19,8,3,67,32,35,65
FC Nords,2810,3,14,8,8,71,48,23,50
Copenhagen,2810,4,13,5,12,59,51,8,44
AaB,2810,5,8,12,10,36,41,-5,36
Sonderjyske,2810,6,8,6,10,28,29,-1,30
AC Horsens,2810,7,5,15,10,32,52,-20,30
Randers FC,2810,8,5,7,12,23,39,-16,22
Silkeborg IF,2810,9,6,3,13,26,44,-18,21
Lyngby,2810,10,3,10,11,26,44,-18,19
AGF Aarhus,2810,11,4,6,12,16,37,-21,18
Brondby,2811,1,21,6,3,72,35,37,69
FC Midtjylla,2811,2,19,5,6,65,39,26,62
FC Nords,2811,3,14,6,10,70,53,17,48
Copenhagen,2811,4,14,4,12,60,45,15,46
AC Horsens,2811,5,8,13,9,40,52,-12,37
AaB,2811,6,7,12,11,39,48,-9,33
Sonderjyske,2811,7,8,6,10,28,29,-1,30
Lyngby,2811,8,4,9,11,27,44,-17,21
Randers FC,2811,9,5,6,13,23,40,-17,21
AGF Aarhus,2811,10,5,6,11,19,38,-19,21
Silkeborg IF,2811,11,5,3,14,27,47,-20,18
Brondby,2812,1,20,6,4,66,33,33,66
FC Midtjylla,2812,2,19,5,6,66,39,27,62
FC Nords,2812,3,16,7,7,80,51,29,55
Copenhagen,2812,4,12,5,13,55,49,6,41
AaB,2812,5,9,11,10,39,41,-2,38
AC Horsens,2812,6,6,14,10,32,51,-19,32
Sonderjyske,2812,7,8,6,10,28,29,-1,30
Lyngby,2812,8,4,9,11,27,44,-17,21
Randers FC,2812,9,5,6,13,23,40,-17,21
Silkeborg IF,2812,10,6,3,13,27,45,-18,21
AGF Aarhus,2812,11,4,6,12,17,38,-21,18
Brondby,2813,1,21,6,3,72,35,37,69
FC Midtjylla,2813,2,20,5,5,68,40,28,65
FC Nords,2813,3,15,7,8,73,47,26,52
Copenhagen,2813,4,13,7,10,58,46,12,46
AC Horsens,2813,5,6,14,10,33,50,-17,32
Sonderjyske,2813,6,8,6,10,28,29,-1,30
AaB,2813,7,6,11,13,32,44,-12,29
Randers FC,2813,8,5,7,12,25,41,-16,22
Silkeborg IF,2813,9,6,3,13,26,44,-18,21
Lyngby,2813,10,3,10,11,28,46,-18,19
AGF Aarhus,2813,11,4,6,12,16,37,-21,18
Brondby,2814,1,22,6,2,75,28,47,72
FC Midtjylla,2814,2,21,5,4,66,35,31,68
FC Nords,2814,3,14,7,9,71,50,21,49
Copenhagen,2814,4,12,4,14,52,47,5,40
AaB,2814,5,8,12,10,37,46,-9,36
Sonderjyske,2814,6,8,6,10,28,29,-1,30
AC Horsens,2814,7,6,12,12,33,54,-21,30
Lyngby,2814,8,4,9,11,29,46,-17,21
Randers FC,2814,9,5,6,13,25,42,-17,21
AGF Aarhus,2814,10,5,6,11,19,37,-18,21
Silkeborg IF,2814,11,5,3,14,26,47,-21,18
FC Midtjylla,2815,1,20,6,4,67,35,32,66
Brondby,2815,2,20,5,5,67,35,32,65
FC Nords,2815,3,14,8,8,75,52,23,50
Copenhagen,2815,4,14,6,10,57,42,15,48
AaB,2815,5,6,14,10,35,42,-7,32
Sonderjyske,2815,6,8,6,10,28,29,-1,30
AC Horsens,2815,7,5,15,10,30,51,-21,30
Randers FC,2815,8,5,7,12,23,39,-16,22
Silkeborg IF,2815,9,6,3,13,29,44,-15,21
Lyngby,2815,10,3,10,11,26,44,-18,19
AGF Aarhus,2815,11,4,6,12,16,40,-24,18
FC Midtjylla,2816,1,20,5,5,68,39,29,65
Brondby,2816,2,19,7,4,76,42,34,64
Copenhagen,2816,3,15,6,9,62,43,19,51
FC Nords,2816,4,14,7,9,76,53,23,49
AC Horsens,2816,5,7,14,9,36,51,-15,35
Sonderjyske,2816,6,8,6,10,28,29,-1,30
AaB,2816,7,6,11,13,34,50,-16,29
Lyngby,2816,8,4,9,11,27,44,-17,21
Randers FC,2816,9,5,6,13,23,40,-17,21
Silkeborg IF,2816,10,5,4,13,25,44,-19,19
AGF Aarhus,2816,11,4,7,11,16,36,-20,19
FC Midtjylla,2817,1,21,5,4,74,40,34,68
Brondby,2817,2,19,6,5,67,34,33,63
Copenhagen,2817,3,13,6,11,56,47,9,45
FC Nords,2817,4,12,7,11,70,58,12,43
AaB,2817,5,8,13,9,41,42,-1,37
AC Horsens,2817,6,7,15,8,40,53,-13,36
Sonderjyske,2817,7,8,6,10,28,29,-1,30
Randers FC,2817,8,6,6,12,24,39,-15,24
AGF Aarhus,2817,9,5,6,11,18,36,-18,21
Lyngby,2817,10,3,9,12,26,45,-19,18
Silkeborg IF,2817,11,5,3,14,25,46,-21,18
FC Midtjylla,2818,1,20,5,5,66,38,28,65
Brondby,2818,2,19,7,4,69,32,37,64
FC Nords,2818,3,14,6,10,69,50,19,48
Copenhagen,2818,4,13,6,11,53,46,7,45
AaB,2818,5,8,13,9,35,37,-2,37
AC Horsens,2818,6,7,13,10,38,53,-15,34
Sonderjyske,2818,7,8,6,10,28,29,-1,30
Lyngby,2818,8,4,9,11,30,45,-15,21
Silkeborg IF,2818,9,6,3,13,27,45,-18,21
Randers FC,2818,10,5,6,13,24,43,-19,21
AGF Aarhus,2818,11,4,6,12,17,38,-21,18
Brondby,2819,1,21,5,4,72,33,39,68
FC Midtjylla,2819,2,20,5,5,71,38,33,65
Copenhagen,2819,3,14,6,10,59,44,15,48
FC Nords,2819,4,13,7,10,73,59,14,46
AC Horsens,2819,5,8,12,10,35,52,-17,36
AaB,2819,6,7,11,12,38,48,-10,32
Sonderjyske,2819,7,8,6,10,28,29,-1,30
Lyngby,2819,8,4,9,11,29,46,-17,21
Randers FC,2819,9,5,6,13,25,42,-17,21
Silkeborg IF,2819,10,5,4,13,26,45,-19,19
AGF Aarhus,2819,11,4,7,11,17,37,-20,19
Brondby,2820,1,21,6,3,72,32,40,69
FC Midtjylla,2820,2,19,5,6,64,39,25,62
Copenhagen,2820,3,16,5,9,57,39,18,53
FC Nords,2820,4,13,9,8,71,50,21,48
AaB,2820,5,7,12,11,35,42,-7,33
Sonderjyske,2820,6,8,6,10,28,29,-1,30
AC Horsens,2820,7,5,13,12,31,54,-23,28
Lyngby,2820,8,4,9,11,27,44,-17,21
Silkeborg IF,2820,8,6,3,13,27,44,-17,21
Randers FC,2820,10,5,6,13,23,40,-17,21
AGF Aarhus,2820,11,4,6,12,16,38,-22,18
Brondby,2821,1,20,7,3,72,33,39,67
FC Midtjylla,2821,2,19,5,6,66,42,24,62
FC Nords,2821,3,16,7,7,78,48,30,55
Copenhagen,2821,4,12,7,11,55,46,9,43
AC Horsens,2821,5,7,13,10,37,57,-20,34
AaB,2821,6,6,13,11,37,45,-8,31
Sonderjyske,2821,7,8,6,10,28,29,-1,30
Randers FC,2821,8,6,6,12,24,39,-15,24
Silkeborg IF,2821,9,6,3,13,27,45,-18,21
Lyngby,2821,10,3,9,12,26,45,-19,18
AGF Aarhus,2821,11,4,6,12,17,38,-21,18
Brondby,2822,1,20,8,2,71,32,39,68
FC Midtjylla,2822,2,21,5,4,72,38,34,68
FC Nords,2822,3,13,7,10,73,56,17,46
Copenhagen,2822,4,13,6,11,56,48,8,45
AaB,2822,5,8,12,10,43,46,-3,36
Sonderjyske,2822,6,8,6,10,28,29,-1,30
AC Horsens,2822,7,5,14,11,35,56,-21,29
Lyngby,2822,8,4,9,11,27,44,-17,21
Randers FC,2822,9,5,6,13,23,40,-17,21
Silkeborg IF,2822,10,5,4,13,26,45,-19,19
AGF Aarhus,2822,11,4,7,11,17,37,-20,19
Brondby,2823,1,20,6,4,69,35,34,66
FC Midtjylla,2823,2,19,7,4,68,39,29,64
FC Nords,2823,3,15,7,8,78,48,30,52
Copenhagen,2823,4,14,6,10,57,44,13,48
AaB,2823,5,7,12,11,33,41,-8,33
Sonderjyske,2823,6,8,6,10,28,29,-1,30
AC Horsens,2823,7,6,12,12,34,58,-24,30
Randers FC,2823,8,6,6,12,25,40,-15,24
Silkeborg IF,2823,9,6,3,13,26,44,-18,21
Lyngby,2823,10,3,9,12,27,46,-19,18
AGF Aarhus,2823,11,4,6,12,16,37,-21,18
Brondby,2824,1,21,7,2,71,32,39,70
FC Midtjylla,2824,2,19,4,7,65,36,29,61
Copenhagen,2824,3,14,7,9,58,43,15,49
FC Nords,2824,4,14,6,10,76,53,23,48
AaB,2824,5,8,13,9,39,46,-7,37
Sonderjyske,2824,6,8,6,10,28,29,-1,30
AC Horsens,2824,7,5,13,12,32,57,-25,28
Randers FC,2824,8,6,6,12,24,39,-15,24
Silkeborg IF,2824,9,6,3,13,26,44,-18,21
Lyngby,2824,10,3,9,12,26,45,-19,18
AGF Aarhus,2824,11,4,6,12,16,37,-21,18
Brondby,2825,1,20,7,3,72,36,36,67
FC Midtjylla,2825,2,20,5,5,69,38,31,65
FC Nords,2825,3,15,6,9,75,52,23,51
Copenhagen,2825,4,14,5,11,57,46,11,47
AC Horsens,2825,5,8,12,10,37,49,-12,36
Sonderjyske,2825,6,8,6,10,28,29,-1,30
AaB,2825,7,6,11,13,33,48,-15,29
Randers FC,2825,8,6,6,12,24,39,-15,24
Silkeborg IF,2825,9,6,3,13,26,44,-18,21
Lyngby,2825,10,3,9,12,26,45,-19,18
AGF Aarhus,2825,11,4,6,12,16,37,-21,18
Brondby,2826,1,20,6,4,69,36,33,66
FC Midtjylla,2826,2,20,4,6,64,39,25,64
FC Nords,2826,3,15,6,9,74,52,22,51
Copenhagen,2826,4,14,4,12,61,48,13,46
AaB,2826,5,8,11,11,42,44,-2,35
AC Horsens,2826,6,7,13,10,37,54,-17,34
Sonderjyske,2826,7,8,6,10,28,29,-1,30
Randers FC,2826,8,5,7,12,23,39,-16,22
Silkeborg IF,2826,9,6,3,13,28,44,-16,21
Lyngby,2826,10,3,10,11,26,44,-18,19
AGF Aarhus,2826,11,4,6,12,16,39,-23,18
Brondby,2827,1,22,6,2,75,31,44,72
FC Midtjylla,2827,2,19,6,5,66,40,26,63
FC Nords,2827,3,15,7,8,74,48,26,52
Copenhagen,2827,4,13,5,12,54,45,9,44
AaB,2827,5,6,13,11,33,44,-11,31
Sonderjyske,2827,6,8,6,10,28,29,-1,30
AC Horsens,2827,7,5,15,10,30,50,-20,30
Randers FC,2827,8,5,7,12,25,41,-16,22
AGF Aarhus,2827,9,5,6,11,19,37,-18,21
Lyngby,2827,10,3,10,11,28,46,-18,19
Silkeborg IF,2827,11,5,3,14,26,47,-21,18
Brondby,2828,1,19,8,3,65,31,34,65
FC Midtjylla,2828,2,20,5,5,71,40,31,65
FC Nords,2828,3,12,10,8,68,48,20,46
Copenhagen,2828,4,13,7,10,56,44,12,46
AaB,2828,5,7,14,9,35,43,-8,35
AC Horsens,2828,6,6,14,10,35,50,-15,32
Sonderjyske,2828,7,8,6,10,28,29,-1,30
Silkeborg IF,2828,8,6,3,13,29,46,-17,21
Lyngby,2828,9,4,9,11,27,44,-17,21
Randers FC,2828,10,5,6,13,23,40,-17,21
AGF Aarhus,2828,11,4,6,12,18,40,-22,18
Brondby,2829,1,21,6,3,71,31,40,69
FC Midtjylla,2829,2,18,6,6,62,42,20,60
FC Nords,2829,3,15,8,7,72,47,25,53
Copenhagen,2829,4,14,6,10,60,44,16,48
AC Horsens,2829,5,7,13,10,36,52,-16,34
Sonderjyske,2829,6,8,6,10,28,29,-1,30
AaB,2829,7,6,11,13,31,42,-11,29
Lyngby,2829,8,4,9,11,31,47,-16,21
Randers FC,2829,9,5,6,13,26,44,-18,21
Silkeborg IF,2829,9,6,3,13,26,44,-18,21
AGF Aarhus,2829,11,4,6,12,16,37,-21,18
Brondby,2830,1,22,5,3,72,33,39,71
FC Midtjylla,2830,2,20,5,5,71,37,34,65
FC Nords,2830,3,15,7,8,81,54,27,52
Copenhagen,2830,4,14,4,12,56,48,8,46
AaB,2830,5,8,11,11,37,48,-11,35
Sonderjyske,2830,6,8,6,10,28,29,-1,30
AC Horsens,2830,7,5,12,13,36,59,-23,27
Lyngby,2830,8,4,9,11,29,44,-15,21
Silkeborg IF,2830,9,6,3,13,29,46,-17,21
Randers FC,2830,10,5,6,13,23,42,-19,21
AGF Aarhus,2830,11,4,6,12,18,40,-22,18
Brondby,2831,1,21,5,4,71,34,37,68
FC Midtjylla,2831,2,20,4,6,64,38,26,64
FC Nords,2831,3,14,7,9,74,54,20,49
Copenhagen,2831,4,14,6,10,57,44,13,48
AC Horsens,2831,5,7,13,10,41,54,-13,34
AaB,2831,6,6,13,11,35,44,-9,31
Sonderjyske,2831,7,8,6,10,28,29,-1,30
Randers FC,2831,8,5,7,12,24,40,-16,22
Lyngby,2831,9,3,10,11,27,45,-18,19
Silkeborg IF,2831,10,5,4,13,25,44,-19,19
AGF Aarhus,2831,11,4,7,11,16,36,-20,19
Brondby,2832,1,22,5,3,75,32,43,71
FC Midtjylla,2832,2,20,4,6,65,40,25,64
FC Nords,2832,3,16,6,8,75,50,25,54
Copenhagen,2832,4,13,5,12,53,46,7,44
AaB,2832,5,7,12,11,34,42,-8,33
Sonderjyske,2832,6,8,6,10,28,29,-1,30
AC Horsens,2832,7,6,12,12,35,53,-18,30
Lyngby,2832,8,4,9,11,27,44,-17,21
Randers FC,2832,9,5,6,13,23,40,-17,21
AGF Aarhus,2832,10,5,6,11,18,36,-18,21
Silkeborg IF,2832,11,5,3,14,25,46,-21,18
Brondby,2833,1,21,6,3,72,34,38,69
FC Midtjylla,2833,2,20,5,5,65,37,28,65
FC Nords,2833,3,14,7,9,74,54,20,49
Copenhagen,2833,4,12,4,14,54,49,5,40
AaB,2833,5,8,13,9,38,41,-3,37
AC Horsens,2833,6,7,13,10,38,52,-14,34
Sonderjyske,2833,7,8,6,10,28,29,-1,30
Lyngby,2833,8,4,9,11,29,45,-16,21
Silkeborg IF,2833,9,6,3,13,27,45,-18,21
Randers FC,2833,10,5,6,13,24,42,-18,21
AGF Aarhus,2833,11,4,6,12,17,38,-21,18
Brondby,2834,1,22,6,2,71,30,41,72
FC Midtjylla,2834,2,18,4,8,63,44,19,58
Copenhagen,2834,3,14,6,10,58,43,15,48
FC Nords,2834,4,13,8,9,73,54,19,47
AaB,2834,5,8,12,10,38,42,-4,36
AC Horsens,2834,6,7,12,11,36,52,-16,33
Sonderjyske,2834,7,8,6,10,28,29,-1,30
Lyngby,2834,8,4,9,11,29,45,-16,21
Silkeborg IF,2834,9,6,3,13,27,45,-18,21
Randers FC,2834,10,5,6,13,24,42,-18,21
AGF Aarhus,2834,11,4,6,12,17,38,-21,18
FC Midtjylla,2835,1,22,4,4,68,33,35,70
Brondby,2835,2,21,6,3,72,32,40,69
FC Nords,2835,3,13,7,10,69,57,12,46
Copenhagen,2835,4,13,5,12,54,47,7,44
AaB,2835,5,8,12,10,42,42,0,36
Sonderjyske,2835,6,8,6,10,28,29,-1,30
AC Horsens,2835,7,6,12,12,35,55,-20,30
Randers FC,2835,8,5,7,12,24,40,-16,22
AGF Aarhus,2835,9,5,6,11,17,36,-19,21
Lyngby,2835,10,3,10,11,27,45,-18,19
Silkeborg IF,2835,11,5,3,14,25,45,-20,18
Brondby,2836,1,22,6,2,75,31,44,72
FC Midtjylla,2836,2,19,5,6,64,42,22,62
FC Nords,2836,3,14,8,8,72,50,22,50
Copenhagen,2836,4,13,4,13,58,47,11,43
AaB,2836,5,8,12,10,38,46,-8,36
AC Horsens,2836,6,6,13,11,36,53,-17,31
Sonderjyske,2836,7,8,6,10,28,29,-1,30
Lyngby,2836,8,4,9,11,32,44,-12,21
Silkeborg IF,2836,9,6,3,13,30,44,-14,21
Randers FC,2836,10,5,6,13,23,45,-22,21
AGF Aarhus,2836,11,4,6,12,16,41,-25,18
Brondby,2837,1,21,7,2,75,33,42,70
FC Midtjylla,2837,2,19,7,4,70,39,31,64
FC Nords,2837,3,14,7,9,73,56,17,49
Copenhagen,2837,4,12,5,13,56,49,7,41
AaB,2837,5,7,15,8,38,40,-2,36
AC Horsens,2837,6,6,13,11,32,53,-21,31
Sonderjyske,2837,7,8,6,10,28,29,-1,30
Lyngby,2837,8,4,9,11,28,45,-17,21
Randers FC,2837,9,5,6,13,24,41,-17,21
AGF Aarhus,2837,10,5,6,11,19,38,-19,21
Silkeborg IF,2837,11,5,3,14,27,47,-20,18
Brondby,2838,1,20,8,2,70,32,38,68
FC Midtjylla,2838,2,18,6,6,62,40,22,60
FC Nords,2838,3,15,7,8,76,47,29,52
Copenhagen,2838,4,13,4,13,55,52,3,43
AaB,2838,5,7,15,8,39,41,-2,36
AC Horsens,2838,6,6,14,10,33,49,-16,32
Sonderjyske,2838,7,8,6,10,28,29,-1,30
Randers FC,2838,8,6,6,12,24,39,-15,24
Silkeborg IF,2838,9,6,3,13,30,45,-15,21
Lyngby,2838,10,3,9,12,26,45,-19,18
AGF Aarhus,2838,11,4,6,12,17,41,-24,18
Brondby,2839,1,20,5,5,68,35,33,65
FC Midtjylla,2839,2,18,5,7,60,43,17,59
FC Nords,2839,3,16,6,8,78,50,28,54
Copenhagen,2839,4,14,5,11,59,45,14,47
AaB,2839,5,8,12,10,34,39,-5,36
AC Horsens,2839,6,7,13,10,37,50,-13,34
Sonderjyske,2839,7,8,6,10,28,29,-1,30
Lyngby,2839,8,4,9,11,29,44,-15,21
Silkeborg IF,2839,9,6,3,13,29,46,-17,21
Randers FC,2839,10,5,6,13,23,42,-19,21
AGF Aarhus,2839,11,4,6,12,18,40,-22,18
Brondby,2840,1,20,7,3,70,34,36,67
FC Midtjylla,2840,2,20,5,5,67,38,29,65
FC Nords,2840,3,14,7,9,72,53,19,49
Copenhagen,2840,4,14,5,11,56,42,14,47
AaB,2840,5,7,13,10,38,43,-5,34
AC Horsens,2840,6,6,13,11,35,54,-19,31
Sonderjyske,2840,7,8,6,10,28,29,-1,30
Lyngby,2840,8,4,9,11,29,44,-15,21
Silkeborg IF,2840,9,6,3,13,27,44,-17,21
Randers FC,2840,10,5,6,13,23,42,-19,21
AGF Aarhus,2840,11,4,6,12,16,38,-22,18
FC Midtjylla,2841,1,21,5,4,68,36,32,68
Brondby,2841,2,20,6,4,68,36,32,66
Copenhagen,2841,3,14,5,11,57,42,15,47
FC Nords,2841,4,13,7,10,68,52,16,46
AaB,2841,5,8,11,11,38,43,-5,35
AC Horsens,2841,6,6,14,10,36,52,-16,32
Sonderjyske,2841,7,8,6,10,28,29,-1,30
Lyngby,2841,8,4,9,11,33,46,-13,21
Randers FC,2841,9,5,6,13,25,46,-21,21
Silkeborg IF,2841,10,5,4,13,28,47,-19,19
AGF Aarhus,2841,11,4,7,11,19,39,-20,19
FC Midtjylla,2842,1,20,6,4,69,38,31,66
Brondby,2842,2,18,7,5,66,34,32,61
Copenhagen,2842,3,16,4,10,61,45,16,52
FC Nords,2842,4,14,7,9,72,51,21,49
AaB,2842,5,9,11,10,39,42,-3,38
Sonderjyske,2842,6,8,6,10,28,29,-1,30
AC Horsens,2842,7,5,13,12,35,58,-23,28
Lyngby,2842,8,4,9,11,27,44,-17,21
Randers FC,2842,9,5,6,13,23,40,-17,21
Silkeborg IF,2842,10,5,4,13,28,47,-19,19
AGF Aarhus,2842,11,4,7,11,19,39,-20,19
Brondby,2843,1,20,5,5,70,34,36,65
FC Midtjylla,2843,2,19,4,7,64,45,19,61
FC Nords,2843,3,16,6,8,78,48,30,54
Copenhagen,2843,4,16,4,10,58,40,18,52
AC Horsens,2843,5,8,12,10,33,51,-18,36
Sonderjyske,2843,6,8,6,10,28,29,-1,30
AaB,2843,7,6,11,13,34,45,-11,29
Randers FC,2843,8,6,6,12,25,40,-15,24
AGF Aarhus,2843,9,5,6,11,18,37,-19,21
Lyngby,2843,10,3,9,12,27,46,-19,18
Silkeborg IF,2843,11,5,3,14,26,46,-20,18
Brondby,2844,1,20,7,3,69,32,37,67
FC Midtjylla,2844,2,21,4,5,70,38,32,67
FC Nords,2844,3,14,7,9,74,49,25,49
Copenhagen,2844,4,14,6,10,57,45,12,48
AaB,2844,5,7,13,10,35,40,-5,34
Sonderjyske,2844,6,8,6,10,28,29,-1,30
AC Horsens,2844,7,5,13,12,33,60,-27,28
Randers FC,2844,8,5,7,12,24,40,-16,22
Lyngby,2844,9,3,10,11,27,45,-18,19
Silkeborg IF,2844,10,5,4,13,28,47,-19,19
AGF Aarhus,2844,11,4,7,11,19,39,-20,19
Brondby,2845,1,19,8,3,72,35,37,65
FC Midtjylla,2845,2,18,6,6,65,40,25,60
FC Nords,2845,3,15,7,8,75,51,24,52
Copenhagen,2845,4,15,6,9,57,40,17,51
AaB,2845,5,7,13,10,38,43,-5,34
Sonderjyske,2845,6,8,6,10,28,29,-1,30
AC Horsens,2845,7,6,12,12,33,57,-24,30
Lyngby,2845,8,4,9,11,30,46,-16,21
Randers FC,2845,9,5,6,13,25,43,-18,21
AGF Aarhus,2845,10,5,6,11,19,38,-19,21
Silkeborg IF,2845,11,5,3,14,27,47,-20,18
Brondby,2846,1,20,7,3,68,31,37,67
FC Midtjylla,2846,2,19,4,7,61,38,23,61
Copenhagen,2846,3,14,6,10,60,45,15,48
FC Nords,2846,4,13,7,10,71,55,16,46
AaB,2846,5,9,13,8,43,43,0,40
AC Horsens,2846,6,6,13,11,34,51,-17,31
Sonderjyske,2846,7,8,6,10,28,29,-1,30
Randers FC,2846,8,6,6,12,24,39,-15,24
Silkeborg IF,2846,9,6,3,13,29,45,-16,21
Lyngby,2846,10,3,9,12,26,45,-19,18
AGF Aarhus,2846,11,4,6,12,17,40,-23,18
Brondby,2847,1,22,6,2,72,30,42,72
FC Midtjylla,2847,2,20,5,5,67,37,30,65
FC Nords,2847,3,15,6,9,72,49,23,51
Copenhagen,2847,4,12,6,12,55,48,7,42
AaB,2847,5,6,13,11,34,44,-10,31
AC Horsens,2847,6,5,16,9,35,53,-18,31
Sonderjyske,2847,7,8,6,10,28,29,-1,30
Randers FC,2847,8,5,7,12,24,40,-16,22
AGF Aarhus,2847,9,5,6,11,19,38,-19,21
Lyngby,2847,10,3,10,11,27,45,-18,19
Silkeborg IF,2847,11,5,3,14,27,47,-20,18
Brondby,2848,1,20,6,4,69,32,37,66
FC Midtjylla,2848,2,19,5,6,62,39,23,62
FC Nords,2848,3,15,8,7,79,49,30,53
Copenhagen,2848,4,13,7,10,57,46,11,46
AaB,2848,5,7,12,11,34,42,-8,33
AC Horsens,2848,6,7,12,11,33,52,-19,33
Sonderjyske,2848,7,8,6,10,28,29,-1,30
Randers FC,2848,8,6,6,12,25,39,-14,24
Silkeborg IF,2848,9,5,4,13,27,46,-19,19
AGF Aarhus,2848,10,4,7,11,18,38,-20,19
Lyngby,2848,11,3,9,12,26,46,-20,18
Brondby,2849,1,21,7,2,70,30,40,70
FC Midtjylla,2849,2,20,5,5,66,39,27,65
FC Nords,2849,3,14,6,10,71,53,18,48
Copenhagen,2849,4,13,6,11,56,45,11,45
AaB,2849,5,8,12,10,40,43,-3,36
Sonderjyske,2849,6,8,6,10,28,29,-1,30
AC Horsens,2849,7,5,14,11,33,52,-19,29
Randers FC,2849,8,5,7,12,24,40,-16,22
Lyngby,2849,9,3,10,11,27,45,-18,19
Silkeborg IF,2849,10,5,4,13,27,46,-19,19
AGF Aarhus,2849,11,4,7,11,18,38,-20,19
Brondby,2850,1,21,6,3,73,32,41,69
FC Midtjylla,2850,2,21,4,5,69,39,30,67
Copenhagen,2850,3,15,5,10,59,42,17,50
FC Nords,2850,4,14,7,9,73,51,22,49
AaB,2850,5,6,13,11,35,45,-10,31
Sonderjyske,2850,6,8,6,10,28,29,-1,30
AC Horsens,2850,7,5,13,12,31,57,-26,28
Lyngby,2850,8,4,9,11,29,46,-17,21
Randers FC,2850,9,5,6,13,25,42,-17,21
Silkeborg IF,2850,10,6,3,13,26,44,-18,21
AGF Aarhus,2850,11,4,6,12,16,37,-21,18
Brondby,2851,1,21,7,2,70,32,38,70
FC Midtjylla,2851,2,21,4,5,66,35,31,67
FC Nords,2851,3,13,7,10,72,52,20,46
Copenhagen,2851,4,13,5,12,55,48,7,44
AC Horsens,2851,5,7,13,10,33,49,-16,34
AaB,2851,6,7,12,11,38,44,-6,33
Sonderjyske,2851,7,8,6,10,28,29,-1,30
Randers FC,2851,8,5,7,12,24,40,-16,22
Silkeborg IF,2851,9,6,3,13,27,45,-18,21
Lyngby,2851,10,3,10,11,27,45,-18,19
AGF Aarhus,2851,11,4,6,12,17,38,-21,18
Brondby,2852,1,20,7,3,71,31,40,67
FC Midtjylla,2852,2,20,5,5,70,39,31,65
FC Nords,2852,3,14,7,9,71,51,20,49
Copenhagen,2852,4,14,7,9,56,39,17,49
AaB,2852,5,8,11,11,36,46,-10,35
Sonderjyske,2852,6,8,6,10,28,29,-1,30
AC Horsens,2852,7,5,13,12,35,59,-24,28
Randers FC,2852,8,5,7,12,24,40,-16,22
AGF Aarhus,2852,9,5,6,11,17,36,-19,21
Lyngby,2852,10,3,10,11,27,45,-18,19
Silkeborg IF,2852,11,5,3,14,25,45,-20,18
Brondby,2853,1,22,5,3,72,32,40,71
FC Midtjylla,2853,2,19,5,6,69,43,26,62
Copenhagen,2853,3,16,5,9,60,42,18,53
FC Nords,2853,4,14,6,10,70,52,18,48
AC Horsens,2853,5,6,14,10,33,51,-18,32
Sonderjyske,2853,6,8,6,10,28,29,-1,30
AaB,2853,7,6,11,13,35,45,-10,29
Lyngby,2853,8,4,9,11,30,47,-17,21
Randers FC,2853,9,5,6,13,26,43,-17,21
AGF Aarhus,2853,10,5,6,11,18,36,-18,21
Silkeborg IF,2853,11,5,3,14,25,46,-21,18
Brondby,2854,1,20,7,3,68,32,36,67
FC Midtjylla,2854,2,20,6,4,72,42,30,66
FC Nords,2854,3,15,6,9,73,51,22,51
Copenhagen,2854,4,13,5,12,57,45,12,44
AaB,2854,5,9,12,9,38,39,-1,39
Sonderjyske,2854,6,8,6,10,28,29,-1,30
AC Horsens,2854,7,5,12,13,33,58,-25,27
Lyngby,2854,8,4,9,11,30,44,-14,21
Silkeborg IF,2854,9,6,3,13,27,45,-18,21
Randers FC,2854,10,5,6,13,23,43,-20,21
AGF Aarhus,2854,11,4,6,12,17,38,-21,18
Brondby,2855,1,21,6,3,74,34,40,69
FC Midtjylla,2855,2,20,4,6,64,38,26,64
FC Nords,2855,3,14,7,9,72,52,20,49
Copenhagen,2855,4,14,4,12,60,53,7,46
AC Horsens,2855,5,7,13,10,37,52,-15,34
AaB,2855,6,7,12,11,40,44,-4,33
Sonderjyske,2855,7,8,6,10,28,29,-1,30
Lyngby,2855,8,4,9,11,28,44,-16,21
Randers FC,2855,9,5,6,13,23,41,-18,21
Silkeborg IF,2855,10,5,4,13,26,45,-19,19
AGF Aarhus,2855,11,4,7,11,17,37,-20,19
Brondby,2856,1,21,6,3,70,32,38,69
FC Midtjylla,2856,2,19,5,6,68,41,27,62
Copenhagen,2856,3,14,6,10,60,43,17,48
FC Nords,2856,4,13,7,10,73,59,14,46
AaB,2856,5,9,12,9,46,44,2,39
Sonderjyske,2856,6,8,6,10,28,29,-1,30
AC Horsens,2856,7,5,14,11,35,59,-24,29
Lyngby,2856,8,4,9,11,28,44,-16,21
Randers FC,2856,9,5,6,13,23,41,-18,21
Silkeborg IF,2856,10,5,4,13,26,45,-19,19
AGF Aarhus,2856,11,4,7,11,17,37,-20,19
Brondby,2857,1,21,6,3,75,33,42,69
FC Midtjylla,2857,2,18,6,6,66,45,21,60
FC Nords,2857,3,14,9,7,76,52,24,51
Copenhagen,2857,4,14,6,10,57,43,14,48
AaB,2857,5,7,12,11,41,47,-6,33
AC Horsens,2857,6,6,13,11,39,60,-21,31
Sonderjyske,2857,7,8,6,10,28,29,-1,30
Randers FC,2857,8,5,7,12,25,41,-16,22
Silkeborg IF,2857,9,6,3,13,27,44,-17,21
Lyngby,2857,10,3,10,11,28,46,-18,19
AGF Aarhus,2857,11,4,6,12,16,38,-22,18
Brondby,2858,1,22,6,2,76,31,45,72
FC Midtjylla,2858,2,19,6,5,66,38,28,63
FC Nords,2858,3,13,8,9,71,54,17,47
Copenhagen,2858,4,13,5,12,54,48,6,44
AaB,2858,5,7,13,10,42,44,-2,34
AC Horsens,2858,6,6,14,10,33,53,-20,32
Sonderjyske,2858,7,8,6,10,28,29,-1,30
Randers FC,2858,8,5,7,12,23,39,-16,22
Silkeborg IF,2858,9,6,3,13,27,45,-18,21
Lyngby,2858,10,3,10,11,26,44,-18,19
AGF Aarhus,2858,11,4,6,12,17,38,-21,18
Brondby,2859,1,22,5,3,72,34,38,71
FC Midtjylla,2859,2,22,4,4,70,34,36,70
Copenhagen,2859,3,14,4,12,56,43,13,46
FC Nords,2859,4,13,6,11,70,55,15,45
AaB,2859,5,8,11,11,39,44,-5,35
Sonderjyske,2859,6,8,6,10,28,29,-1,30
AC Horsens,2859,7,6,12,12,34,57,-23,30
Randers FC,2859,8,6,6,12,27,40,-13,24
Silkeborg IF,2859,9,6,3,13,28,44,-16,21
Lyngby,2859,10,3,9,12,27,48,-21,18
AGF Aarhus,2859,11,4,6,12,16,39,-23,18
Brondby,2860,1,20,7,3,75,35,40,67
FC Midtjylla,2860,2,19,6,5,69,43,26,63
FC Nords,2860,3,14,7,9,78,57,21,49
Copenhagen,2860,4,14,5,11,56,45,11,47
AaB,2860,5,7,13,10,39,45,-6,34
AC Horsens,2860,6,6,14,10,34,52,-18,32
Sonderjyske,2860,7,8,6,10,28,29,-1,30
Randers FC,2860,8,6,6,12,26,39,-13,24
AGF Aarhus,2860,9,5,6,11,19,36,-17,21
Lyngby,2860,10,3,9,12,26,47,-21,18
Silkeborg IF,2860,11,5,3,14,25,47,-22,18
Brondby,2861,1,21,5,4,75,37,38,68
FC Midtjylla,2861,2,18,6,6,61,41,20,60
FC Nords,2861,3,16,6,8,78,49,29,54
Copenhagen,2861,4,15,5,10,56,42,14,50
AaB,2861,5,7,12,11,37,44,-7,33
Sonderjyske,2861,6,8,6,10,28,29,-1,30
AC Horsens,2861,7,6,12,12,32,52,-20,30
Randers FC,2861,8,6,6,12,25,40,-15,24
Silkeborg IF,2861,9,6,3,13,27,44,-17,21
Lyngby,2861,10,3,9,12,27,46,-19,18
AGF Aarhus,2861,11,4,6,12,16,38,-22,18
Brondby,2862,1,20,7,3,69,32,37,67
FC Midtjylla,2862,2,20,6,4,66,37,29,66
Copenhagen,2862,3,15,4,11,56,41,15,49
FC Nords,2862,4,12,7,11,73,59,14,43
AaB,2862,5,8,13,9,37,40,-3,37
AC Horsens,2862,6,6,13,11,34,52,-18,31
Sonderjyske,2862,7,8,6,10,28,29,-1,30
Lyngby,2862,8,4,9,11,28,45,-17,21
Silkeborg IF,2862,9,6,3,13,27,44,-17,21
Randers FC,2862,10,5,6,13,24,41,-17,21
AGF Aarhus,2862,11,4,6,12,16,38,-22,18
Brondby,2863,1,20,6,4,69,34,35,66
FC Midtjylla,2863,2,18,7,5,67,43,24,61
Copenhagen,2863,3,15,6,9,64,44,20,51
FC Nords,2863,4,13,10,7,73,50,23,49
AaB,2863,5,8,11,11,34,43,-9,35
Sonderjyske,2863,6,8,6,10,28,29,-1,30
AC Horsens,2863,7,5,14,11,34,53,-19,29
Lyngby,2863,8,4,9,11,29,44,-15,21
Silkeborg IF,2863,9,6,3,13,26,44,-18,21
Randers FC,2863,10,5,6,13,23,42,-19,21
AGF Aarhus,2863,11,4,6,12,16,37,-21,18
FC Midtjylla,2864,1,20,5,5,64,37,27,65
Brondby,2864,2,19,7,4,68,35,33,64
FC Nords,2864,3,16,6,8,80,51,29,54
Copenhagen,2864,4,13,5,12,58,48,10,44
AaB,2864,5,9,11,10,39,41,-2,38
Sonderjyske,2864,6,8,6,10,28,29,-1,30
AC Horsens,2864,7,5,14,11,34,57,-23,29
Randers FC,2864,8,5,7,12,23,39,-16,22
AGF Aarhus,2864,9,5,6,11,19,38,-19,21
Lyngby,2864,10,3,10,11,26,44,-18,19
Silkeborg IF,2864,11,5,3,14,27,47,-20,18
Brondby,2865,1,22,6,2,75,30,45,72
FC Midtjylla,2865,2,19,5,6,65,40,25,62
FC Nords,2865,3,14,8,8,75,51,24,50
Copenhagen,2865,4,13,5,12,55,47,8,44
AC Horsens,2865,5,7,14,9,33,49,-16,35
Sonderjyske,2865,6,8,6,10,28,29,-1,30
AaB,2865,7,6,12,12,34,46,-12,30
Randers FC,2865,8,6,6,12,25,40,-15,24
Silkeborg IF,2865,9,6,3,13,26,44,-18,21
Lyngby,2865,10,3,9,12,27,46,-19,18
AGF Aarhus,2865,11,4,6,12,16,37,-21,18
Brondby,2866,1,21,6,3,69,29,40,69
FC Midtjylla,2866,2,19,4,7,66,44,22,61
FC Nords,2866,3,15,7,8,75,54,21,52
Copenhagen,2866,4,15,4,11,59,44,15,49
AC Horsens,2866,5,6,14,10,35,52,-17,32
AaB,2866,6,6,13,11,36,43,-7,31
Sonderjyske,2866,7,8,6,10,28,29,-1,30
Silkeborg IF,2866,8,6,3,13,28,44,-16,21
Lyngby,2866,9,4,9,11,28,45,-17,21
Randers FC,2866,10,5,6,13,24,41,-17,21
AGF Aarhus,2866,11,4,6,12,16,39,-23,18
Brondby,2867,1,20,6,4,71,34,37,66
FC Midtjylla,2867,2,20,6,4,67,37,30,66
FC Nords,2867,3,14,6,10,74,54,20,48
Copenhagen,2867,4,13,4,13,54,46,8,43
AaB,2867,5,9,11,10,36,41,-5,38
AC Horsens,2867,6,7,13,10,36,52,-16,34
Sonderjyske,2867,7,8,6,10,28,29,-1,30
Lyngby,2867,8,4,9,11,28,44,-16,21
Silkeborg IF,2867,9,6,3,13,26,44,-18,21
Randers FC,2867,10,5,6,13,23,41,-18,21
AGF Aarhus,2867,11,4,6,12,16,37,-21,18
Brondby,2868,1,21,7,2,74,32,42,70
FC Midtjylla,2868,2,18,5,7,59,38,21,59
FC Nords,2868,3,14,8,8,75,53,22,50
Copenhagen,2868,4,15,4,11,57,43,14,49
AaB,2868,5,7,13,10,35,40,-5,34
AC Horsens,2868,6,6,13,11,33,53,-20,31
Sonderjyske,2868,7,8,6,10,28,29,-1,30
Lyngby,2868,8,4,9,11,29,46,-17,21
Randers FC,2868,9,5,6,13,25,42,-17,21
AGF Aarhus,2868,10,5,6,11,18,36,-18,21
Silkeborg IF,2868,11,5,3,14,25,46,-21,18
Brondby,2869,1,19,8,3,66,28,38,65
FC Midtjylla,2869,2,19,6,5,68,37,31,63
FC Nords,2869,3,13,8,9,69,53,16,47
Copenhagen,2869,4,14,5,11,57,46,11,47
AaB,2869,5,8,12,10,39,46,-7,36
AC Horsens,2869,6,7,13,10,36,51,-15,34
Sonderjyske,2869,7,8,6,10,28,29,-1,30
Lyngby,2869,8,4,9,11,28,45,-17,21
Randers FC,2869,9,5,6,13,24,41,-17,21
Silkeborg IF,2869,10,6,3,13,28,46,-18,21
AGF Aarhus,2869,11,4,6,12,18,39,-21,18
Brondby,2870,1,21,5,4,68,32,36,68
FC Midtjylla,2870,2,21,5,4,70,38,32,68
FC Nords,2870,3,14,8,8,73,50,23,50
Copenhagen,2870,4,12,4,14,54,54,0,40
AC Horsens,2870,5,8,12,10,40,52,-12,36
AaB,2870,6,7,12,11,40,45,-5,33
Sonderjyske,2870,7,8,6,10,28,29,-1,30
Randers FC,2870,8,6,6,12,25,39,-14,24
AGF Aarhus,2870,9,5,6,11,17,36,-19,21
Lyngby,2870,10,3,9,12,26,46,-20,18
Silkeborg IF,2870,11,5,3,14,25,45,-20,18
Brondby,2871,1,23,5,2,72,31,41,74
FC Midtjylla,2871,2,19,5,6,64,41,23,62
FC Nords,2871,3,14,7,9,74,53,21,49
Copenhagen,2871,4,12,6,12,56,47,9,42
AC Horsens,2871,5,7,13,10,36,49,-13,34
AaB,2871,6,7,12,11,35,42,-7,33
Sonderjyske,2871,7,8,6,10,28,29,-1,30
Randers FC,2871,8,5,7,12,25,41,-16,22
Silkeborg IF,2871,9,6,3,13,27,45,-18,21
Lyngby,2871,10,3,10,11,28,46,-18,19
AGF Aarhus,2871,11,4,6,12,17,38,-21,18
Brondby,2872,1,21,6,3,77,36,41,69
FC Midtjylla,2872,2,18,5,7,61,44,17,59
FC Nords,2872,3,14,8,8,71,51,20,50
Copenhagen,2872,4,15,5,10,58,39,19,50
AaB,2872,5,7,12,11,36,43,-7,33
AC Horsens,2872,6,5,16,9,33,49,-16,31
Sonderjyske,2872,7,8,6,10,28,29,-1,30
Randers FC,2872,8,6,6,12,24,39,-15,24
Silkeborg IF,2872,9,6,3,13,28,46,-18,21
Lyngby,2872,10,3,9,12,26,45,-19,18
AGF Aarhus,2872,11,4,6,12,18,39,-21,18
Brondby,2873,1,20,6,4,71,37,34,66
FC Midtjylla,2873,2,20,5,5,63,36,27,65
Copenhagen,2873,3,14,5,11,61,45,16,47
FC Nords,2873,4,13,7,10,70,50,20,46
AaB,2873,5,7,14,9,34,39,-5,35
AC Horsens,2873,6,7,13,10,34,52,-18,34
Sonderjyske,2873,7,8,6,10,28,29,-1,30
Randers FC,2873,8,6,6,12,25,40,-15,24
Silkeborg IF,2873,9,6,3,13,26,44,-18,21
Lyngby,2873,10,3,9,12,27,46,-19,18
AGF Aarhus,2873,11,4,6,12,16,37,-21,18
Brondby,2874,1,22,5,3,71,29,42,71
FC Midtjylla,2874,2,19,5,6,61,38,23,62
FC Nords,2874,3,13,8,9,69,50,19,47
Copenhagen,2874,4,14,4,12,55,45,10,46
AC Horsens,2874,5,7,14,9,32,45,-13,35
AaB,2874,6,6,14,10,35,42,-7,32
Sonderjyske,2874,7,8,6,10,28,29,-1,30
Randers FC,2874,8,6,6,12,24,39,-15,24
AGF Aarhus,2874,9,5,6,11,18,37,-19,21
Lyngby,2874,10,3,9,12,26,45,-19,18
Silkeborg IF,2874,11,5,3,14,26,46,-20,18
Brondby,2875,1,21,6,3,70,29,41,69
FC Midtjylla,2875,2,19,6,5,62,38,24,63
FC Nords,2875,3,15,7,8,77,52,25,52
Copenhagen,2875,4,13,6,11,53,42,11,45
AaB,2875,5,7,14,9,35,40,-5,35
Sonderjyske,2875,6,8,6,10,28,29,-1,30
AC Horsens,2875,7,5,13,12,32,54,-22,28
Randers FC,2875,8,6,6,12,25,40,-15,24
Silkeborg IF,2875,9,5,4,13,26,45,-19,19
AGF Aarhus,2875,10,4,7,11,17,37,-20,19
Lyngby,2875,11,3,9,12,27,46,-19,18
Brondby,2876,1,21,7,2,69,29,40,70
FC Midtjylla,2876,2,21,4,5,68,36,32,67
FC Nords,2876,3,13,7,10,68,51,17,46
Copenhagen,2876,4,13,4,13,54,46,8,43
AaB,2876,5,8,12,10,34,39,-5,36
AC Horsens,2876,6,6,14,10,34,52,-18,32
Sonderjyske,2876,7,8,6,10,28,29,-1,30
Lyngby,2876,8,4,9,11,30,45,-15,21
Randers FC,2876,9,5,6,13,24,43,-19,21
AGF Aarhus,2876,10,5,6,11,19,38,-19,21
Silkeborg IF,2876,11,5,3,14,27,47,-20,18
Brondby,2877,1,22,6,2,70,27,43,72
FC Midtjylla,2877,2,20,4,6,66,38,28,64
FC Nords,2877,3,15,6,9,71,51,20,51
Copenhagen,2877,4,14,6,10,55,42,13,48
AaB,2877,5,7,11,12,33,42,-9,32
Sonderjyske,2877,6,8,6,10,28,29,-1,30
AC Horsens,2877,7,5,13,12,30,51,-21,28
Randers FC,2877,8,6,6,12,24,39,-15,24
Silkeborg IF,2877,9,5,4,13,26,45,-19,19
AGF Aarhus,2877,10,4,7,11,17,37,-20,19
Lyngby,2877,11,3,9,12,26,45,-19,18
Brondby,2878,1,20,6,4,66,33,33,66
FC Midtjylla,2878,2,20,4,6,65,37,28,64
FC Nords,2878,3,14,8,8,75,51,24,50
Copenhagen,2878,4,14,4,12,55,45,10,46
AC Horsens,2878,5,8,13,9,39,51,-12,37
AaB,2878,6,7,11,12,36,45,-9,32
Sonderjyske,2878,7,8,6,10,28,29,-1,30
Randers FC,2878,8,5,7,12,25,41,-16,22
Silkeborg IF,2878,9,6,3,13,27,45,-18,21
Lyngby,2878,10,3,10,11,28,46,-18,19
AGF Aarhus,2878,11,4,6,12,17,38,-21,18
Brondby,2879,1,21,6,3,68,28,40,69
FC Midtjylla,2879,2,19,5,6,63,39,24,62
FC Nords,2879,3,16,6,8,75,48,27,54
Copenhagen,2879,4,13,6,11,55,43,12,45
AaB,2879,5,8,11,11,36,43,-7,35
Sonderjyske,2879,6,8,6,10,28,29,-1,30
AC Horsens,2879,7,6,12,12,33,55,-22,30
Lyngby,2879,8,4,9,11,27,44,-17,21
Randers FC,2879,9,5,6,13,23,40,-17,21
Silkeborg IF,2879,10,6,3,13,29,47,-18,21
AGF Aarhus,2879,11,4,6,12,19,40,-21,18
Brondby,2880,1,19,9,2,71,34,37,66
FC Midtjylla,2880,2,19,6,5,67,37,30,63
FC Nords,2880,3,14,8,8,73,49,24,50
Copenhagen,2880,4,14,5,11,56,43,13,47
AC Horsens,2880,5,7,13,10,35,57,-22,34
AaB,2880,6,6,13,11,34,42,-8,31
Sonderjyske,2880,7,8,6,10,28,29,-1,30
Randers FC,2880,8,6,6,12,25,40,-15,24
AGF Aarhus,2880,9,5,6,11,19,37,-18,21
Lyngby,2880,10,3,9,12,27,46,-19,18
Silkeborg IF,2880,11,5,3,14,26,47,-21,18
Brondby,2881,1,20,8,2,70,30,40,68
FC Midtjylla,2881,2,18,6,6,61,38,23,60
FC Nords,2881,3,14,7,9,72,55,17,49
Copenhagen,2881,4,13,5,12,61,48,13,44
AaB,2881,5,8,12,10,39,42,-3,36
AC Horsens,2881,6,7,14,9,36,52,-16,35
Sonderjyske,2881,7,8,6,10,28,29,-1,30
Lyngby,2881,8,4,9,11,28,45,-17,21
Randers FC,2881,9,5,6,13,24,41,-17,21
Silkeborg IF,2881,10,6,3,13,27,45,-18,21
AGF Aarhus,2881,11,4,6,12,17,38,-21,18
Brondby,2882,1,21,7,2,68,30,38,70
FC Midtjylla,2882,2,19,6,5,63,38,25,63
FC Nords,2882,3,14,6,10,73,52,21,48
Copenhagen,2882,4,13,6,11,59,49,10,45
AaB,2882,5,7,12,11,40,44,-4,33
AC Horsens,2882,6,6,15,9,35,51,-16,33
Sonderjyske,2882,7,8,6,10,28,29,-1,30
Randers FC,2882,8,6,6,12,24,39,-15,24
AGF Aarhus,2882,9,5,6,11,21,39,-18,21
Lyngby,2882,10,3,9,12,26,45,-19,18
Silkeborg IF,2882,11,5,3,14,28,49,-21,18
Brondby,2883,1,20,5,5,73,36,37,65
FC Midtjylla,2883,2,20,4,6,64,41,23,64
FC Nords,2883,3,14,7,9,75,54,21,49
Copenhagen,2883,4,14,5,11,61,46,15,47
AaB,2883,5,8,14,8,39,41,-2,38
AC Horsens,2883,6,6,13,11,36,56,-20,31
Sonderjyske,2883,7,8,6,10,28,29,-1,30
Randers FC,2883,8,5,7,12,23,39,-16,22
AGF Aarhus,2883,9,5,6,11,18,37,-19,21
Lyngby,2883,10,3,10,11,26,44,-18,19
Silkeborg IF,2883,11,5,3,14,26,46,-20,18
Brondby,2884,1,21,7,2,68,28,40,70
FC Midtjylla,2884,2,19,5,6,64,39,25,62
Copenhagen,2884,3,14,4,12,57,44,13,46
FC Nords,2884,4,12,8,10,67,54,13,44
AC Horsens,2884,5,8,13,9,35,47,-12,37
AaB,2884,6,7,13,10,33,38,-5,34
Sonderjyske,2884,7,8,6,10,28,29,-1,30
Lyngby,2884,8,4,9,11,28,45,-17,21
Randers FC,2884,9,5,6,13,24,41,-17,21
AGF Aarhus,2884,10,5,6,11,17,36,-19,21
Silkeborg IF,2884,11,5,3,14,25,45,-20,18
Brondby,2885,1,19,6,5,67,35,32,63
FC Midtjylla,2885,2,18,6,6,65,44,21,60
FC Nords,2885,3,16,6,8,76,51,25,54
Copenhagen,2885,4,14,6,10,59,43,16,48
AC Horsens,2885,5,8,12,10,40,53,-13,36
AaB,2885,6,6,14,10,34,41,-7,32
Sonderjyske,2885,7,8,6,10,28,29,-1,30
Randers FC,2885,8,6,6,12,24,39,-15,24
Silkeborg IF,2885,9,5,4,13,27,46,-19,19
AGF Aarhus,2885,10,4,7,11,18,38,-20,19
Lyngby,2885,11,3,9,12,26,45,-19,18
Brondby,2886,1,21,7,2,68,29,39,70
FC Midtjylla,2886,2,21,4,5,75,37,38,67
Copenhagen,2886,3,14,6,10,55,40,15,48
FC Nords,2886,4,13,6,11,68,57,11,45
AaB,2886,5,7,12,11,35,43,-8,33
AC Horsens,2886,6,6,13,11,31,52,-21,31
Sonderjyske,2886,7,8,6,10,28,29,-1,30
Randers FC,2886,8,6,6,12,26,39,-13,24
Silkeborg IF,2886,9,6,3,13,28,44,-16,21
Lyngby,2886,10,3,9,12,26,47,-21,18
AGF Aarhus,2886,11,4,6,12,16,39,-23,18
Brondby,2887,1,21,6,3,72,37,35,69
FC Midtjylla,2887,2,19,6,5,67,41,26,63
FC Nords,2887,3,14,8,8,76,55,21,50
Copenhagen,2887,4,13,7,10,58,43,15,46
AaB,2887,5,7,13,10,38,42,-4,34
Sonderjyske,2887,6,8,6,10,28,29,-1,30
AC Horsens,2887,7,5,14,11,33,52,-19,29
Lyngby,2887,8,4,9,11,29,46,-17,21
Randers FC,2887,9,5,6,13,25,42,-17,21
Silkeborg IF,2887,10,6,3,13,26,44,-18,21
AGF Aarhus,2887,11,4,6,12,16,37,-21,18
FC Midtjylla,2888,1,21,4,5,69,36,33,67
Brondby,2888,2,20,6,4,70,34,36,66
Copenhagen,2888,3,15,4,11,63,45,18,49
FC Nords,2888,4,13,6,11,71,60,11,45
AaB,2888,5,8,13,9,40,41,-1,37
AC Horsens,2888,6,6,13,11,32,55,-23,31
Sonderjyske,2888,7,8,6,10,28,29,-1,30
Lyngby,2888,8,4,9,11,28,44,-16,21
Randers FC,2888,9,5,6,13,23,41,-18,21
AGF Aarhus,2888,10,5,6,11,17,36,-19,21
Silkeborg IF,2888,11,5,3,14,25,45,-20,18
Brondby,2889,1,21,5,4,73,34,39,68
FC Midtjylla,2889,2,20,4,6,67,41,26,64
Copenhagen,2889,3,15,5,10,63,41,22,50
FC Nords,2889,4,13,7,10,70,53,17,46
AaB,2889,5,7,13,10,38,46,-8,34
AC Horsens,2889,6,7,12,11,36,58,-22,33
Sonderjyske,2889,7,8,6,10,28,29,-1,30
Silkeborg IF,2889,8,6,3,13,29,45,-16,21
Lyngby,2889,9,4,9,11,27,44,-17,21
Randers FC,2889,10,5,6,13,23,40,-17,21
AGF Aarhus,2889,11,4,6,12,17,40,-23,18
Brondby,2890,1,23,5,2,75,29,46,74
FC Midtjylla,2890,2,20,4,6,66,38,28,64
FC Nords,2890,3,14,7,9,71,52,19,49
Copenhagen,2890,4,14,4,12,57,42,15,46
AaB,2890,5,7,11,12,36,49,-13,32
AC Horsens,2890,6,6,13,11,34,55,-21,31
Sonderjyske,2890,7,8,6,10,28,29,-1,30
Randers FC,2890,8,6,6,12,24,39,-15,24
Silkeborg IF,2890,9,6,3,13,27,45,-18,21
Lyngby,2890,10,3,9,12,26,45,-19,18
AGF Aarhus,2890,11,4,6,12,17,38,-21,18
FC Midtjylla,2891,1,21,4,5,70,37,33,67
Brondby,2891,2,19,5,6,67,36,31,62
FC Nords,2891,3,16,6,8,76,51,25,54
Copenhagen,2891,4,14,4,12,56,48,8,46
AaB,2891,5,8,11,11,37,43,-6,35
AC Horsens,2891,6,7,12,11,33,50,-17,33
Sonderjyske,2891,7,8,6,10,28,29,-1,30
Lyngby,2891,8,4,9,11,33,45,-12,21
Silkeborg IF,2891,9,6,3,13,26,44,-18,21
Randers FC,2891,10,5,6,13,24,46,-22,21
AGF Aarhus,2891,11,4,6,12,16,37,-21,18
Brondby,2892,1,22,5,3,73,32,41,71
FC Midtjylla,2892,2,20,6,4,70,39,31,66
FC Nords,2892,3,14,7,9,74,56,18,49
Copenhagen,2892,4,13,6,11,58,45,13,45
AaB,2892,5,6,14,10,37,45,-8,32
Sonderjyske,2892,6,8,6,10,28,29,-1,30
AC Horsens,2892,7,6,12,12,33,54,-21,30
Lyngby,2892,8,4,9,11,27,44,-17,21
Silkeborg IF,2892,8,6,3,13,27,44,-17,21
Randers FC,2892,10,5,6,13,23,40,-17,21
AGF Aarhus,2892,11,4,6,12,16,38,-22,18
Brondby,2893,1,20,7,3,69,31,38,67
FC Midtjylla,2893,2,19,5,6,59,38,21,62
FC Nords,2893,3,14,8,8,71,48,23,50
Copenhagen,2893,4,14,7,9,61,43,18,49
AaB,2893,5,7,12,11,36,45,-9,33
Sonderjyske,2893,6,8,6,10,28,29,-1,30
AC Horsens,2893,7,5,15,10,39,56,-17,30
Lyngby,2893,8,4,9,11,28,44,-16,21
Randers FC,2893,9,5,6,13,23,41,-18,21
AGF Aarhus,2893,10,5,6,11,17,36,-19,21
Silkeborg IF,2893,11,5,3,14,25,45,-20,18
Brondby,2894,1,21,7,2,78,34,44,70
FC Midtjylla,2894,2,18,5,7,64,45,19,59
FC Nords,2894,3,14,9,7,79,50,29,51
Copenhagen,2894,4,13,7,10,58,47,11,46
AaB,2894,5,6,14,10,36,44,-8,32
AC Horsens,2894,6,6,14,10,41,62,-21,32
Sonderjyske,2894,7,8,6,10,28,29,-1,30
Randers FC,2894,8,6,6,12,25,40,-15,24
Silkeborg IF,2894,9,5,4,13,26,45,-19,19
AGF Aarhus,2894,10,4,7,11,17,37,-20,19
Lyngby,2894,11,3,9,12,27,46,-19,18
Brondby,2895,1,21,5,4,72,36,36,68
FC Midtjylla,2895,2,18,6,6,64,41,23,60
FC Nords,2895,3,16,6,8,72,49,23,54
Copenhagen,2895,4,14,4,12,57,46,11,46
AaB,2895,5,7,13,10,35,39,-4,34
AC Horsens,2895,6,6,14,10,37,52,-15,32
Sonderjyske,2895,7,8,6,10,28,29,-1,30
Lyngby,2895,8,4,9,11,28,44,-16,21
Silkeborg IF,2895,9,6,3,13,27,45,-18,21
Randers FC,2895,10,5,6,13,23,41,-18,21
AGF Aarhus,2895,11,4,6,12,17,38,-21,18
FC Midtjylla,2896,1,21,4,5,74,40,34,67
Brondby,2896,2,20,6,4,69,32,37,66
FC Nords,2896,3,15,7,8,74,52,22,52
Copenhagen,2896,4,14,4,12,58,48,10,46
AaB,2896,5,7,12,11,37,44,-7,33
Sonderjyske,2896,6,8,6,10,28,29,-1,30
AC Horsens,2896,7,5,15,10,31,53,-22,30
Silkeborg IF,2896,8,6,3,13,28,45,-17,21
Lyngby,2896,9,4,9,11,27,44,-17,21
Randers FC,2896,10,5,6,13,23,40,-17,21
AGF Aarhus,2896,11,4,6,12,17,39,-22,18
Brondby,2897,1,20,5,5,66,33,33,65
FC Midtjylla,2897,2,20,4,6,63,40,23,64
Copenhagen,2897,3,15,5,10,60,40,20,50
FC Nords,2897,4,14,6,10,73,56,17,48
AC Horsens,2897,5,8,13,9,36,47,-11,37
AaB,2897,6,6,13,11,34,42,-8,31
Sonderjyske,2897,7,8,6,10,28,29,-1,30
Randers FC,2897,8,6,6,12,25,40,-15,24
Silkeborg IF,2897,9,6,3,13,30,47,-17,21
Lyngby,2897,10,3,9,12,27,46,-19,18
AGF Aarhus,2897,11,4,6,12,19,41,-22,18
Brondby,2898,1,20,7,3,73,35,38,67
FC Midtjylla,2898,2,20,6,4,65,38,27,66
FC Nords,2898,3,15,7,8,75,50,25,52
Copenhagen,2898,4,12,6,12,53,45,8,42
AC Horsens,2898,5,7,13,10,37,51,-14,34
AaB,2898,6,7,11,12,36,46,-10,32
Sonderjyske,2898,7,8,6,10,28,29,-1,30
Randers FC,2898,8,6,6,12,25,39,-14,24
Silkeborg IF,2898,9,6,3,13,27,45,-18,21
Lyngby,2898,10,3,9,12,26,46,-20,18
AGF Aarhus,2898,11,4,6,12,17,38,-21,18
Brondby,2899,1,20,7,3,71,35,36,67
FC Midtjylla,2899,2,19,6,5,64,39,25,63
FC Nords,2899,3,13,9,8,75,53,22,48
Copenhagen,2899,4,14,5,11,56,43,13,47
AC Horsens,2899,5,7,15,8,38,48,-10,36
Sonderjyske,2899,6,8,6,10,28,29,-1,30
AaB,2899,7,6,12,12,35,47,-12,30
Lyngby,2899,8,4,9,11,31,44,-13,21
Randers FC,2899,9,5,6,13,23,44,-21,21
Silkeborg IF,2899,10,5,4,13,27,46,-19,19
AGF Aarhus,2899,11,4,7,11,18,38,-20,19
Brondby,2900,1,20,7,3,69,31,38,67
FC Midtjylla,2900,2,18,6,6,63,41,22,60
FC Nords,2900,3,15,6,9,72,51,21,51
Copenhagen,2900,4,15,4,11,59,43,16,49
AaB,2900,5,8,12,10,37,42,-5,36
AC Horsens,2900,6,6,13,11,35,53,-18,31
Sonderjyske,2900,7,8,6,10,28,29,-1,30
Randers FC,2900,8,6,6,12,25,40,-15,24
Silkeborg IF,2900,9,6,3,13,28,46,-18,21
Lyngby,2900,10,3,9,12,27,46,-19,18
AGF Aarhus,2900,11,4,6,12,18,39,-21,18
Brondby,2901,1,21,7,2,75,28,47,70
FC Midtjylla,2901,2,19,7,4,67,40,27,64
FC Nords,2901,3,14,8,8,76,56,20,50
Copenhagen,2901,4,14,5,11,60,49,11,47
Sonderjyske,2901,5,8,6,10,28,29,-1,30
AaB,2901,6,6,12,12,35,49,-14,30
AC Horsens,2901,7,5,15,10,34,51,-17,30
Lyngby,2901,8,4,9,11,29,45,-16,21
Silkeborg IF,2901,9,6,3,13,26,44,-18,21
Randers FC,2901,10,5,6,13,24,42,-18,21
AGF Aarhus,2901,11,4,6,12,16,37,-21,18
FC Midtjylla,2902,1,21,5,4,68,34,34,68
Brondby,2902,2,18,8,4,66,34,32,62
FC Nords,2902,3,13,9,8,69,52,17,48
Copenhagen,2902,4,13,7,10,58,44,14,46
AaB,2902,5,8,12,10,36,40,-4,36
Sonderjyske,2902,6,8,6,10,28,29,-1,30
AC Horsens,2902,7,5,15,10,34,53,-19,30
Lyngby,2902,8,4,9,11,28,44,-16,21
Silkeborg IF,2902,9,6,3,13,26,44,-18,21
Randers FC,2902,10,5,6,13,23,41,-18,21
AGF Aarhus,2902,11,4,6,12,16,37,-21,18
Brondby,2903,1,20,5,5,72,35,37,65
FC Midtjylla,2903,2,18,6,6,65,42,23,60
FC Nords,2903,3,15,7,8,74,46,28,52
Copenhagen,2903,4,13,6,11,55,45,10,45
AaB,2903,5,9,12,9,40,44,-4,39
AC Horsens,2903,6,6,14,10,37,57,-20,32
Sonderjyske,2903,7,8,6,10,28,29,-1,30
Lyngby,2903,8,4,9,11,28,44,-16,21
Randers FC,2903,9,5,6,13,23,41,-18,21
Silkeborg IF,2903,10,5,4,13,26,45,-19,19
AGF Aarhus,2903,11,4,7,11,17,37,-20,19
Brondby,2904,1,19,7,4,66,33,33,64
FC Midtjylla,2904,2,19,4,7,66,44,22,61
FC Nords,2904,3,15,7,8,76,48,28,52
Copenhagen,2904,4,13,6,11,57,46,11,45
AaB,2904,5,9,11,10,39,42,-3,38
AC Horsens,2904,6,7,13,10,37,54,-17,34
Sonderjyske,2904,7,8,6,10,28,29,-1,30
Lyngby,2904,8,4,9,11,27,44,-17,21
Silkeborg IF,2904,8,6,3,13,27,44,-17,21
Randers FC,2904,10,5,6,13,23,40,-17,21
AGF Aarhus,2904,11,4,6,12,16,38,-22,18
FC Midtjylla,2905,1,21,4,5,70,38,32,67
Brondby,2905,2,20,6,4,69,33,36,66
FC Nords,2905,3,14,7,9,74,54,20,49
Copenhagen,2905,4,15,4,11,62,48,14,49
AaB,2905,5,7,12,11,36,44,-8,33
AC Horsens,2905,6,6,13,11,35,55,-20,31
Sonderjyske,2905,7,8,6,10,28,29,-1,30
Lyngby,2905,8,4,9,11,27,44,-17,21
Randers FC,2905,9,5,6,13,23,40,-17,21
AGF Aarhus,2905,10,5,6,11,17,36,-19,21
Silkeborg IF,2905,11,5,3,14,25,45,-20,18
Brondby,2906,1,21,6,3,73,35,38,69
FC Midtjylla,2906,2,21,4,5,70,39,31,67
FC Nords,2906,3,14,6,10,77,56,21,48
Copenhagen,2906,4,14,5,11,58,45,13,47
AC Horsens,2906,5,7,12,11,35,54,-19,33
AaB,2906,6,7,11,12,33,43,-10,32
Sonderjyske,2906,7,8,6,10,28,29,-1,30
Randers FC,2906,8,6,6,12,25,40,-15,24
Silkeborg IF,2906,9,6,3,13,29,45,-16,21
Lyngby,2906,10,3,9,12,27,46,-19,18
AGF Aarhus,2906,11,4,6,12,17,40,-23,18
Brondby,2907,1,21,7,2,69,30,39,70
FC Midtjylla,2907,2,20,6,4,61,33,28,66
FC Nords,2907,3,14,9,7,75,47,28,51
Copenhagen,2907,4,13,5,12,54,44,10,44
AC Horsens,2907,5,7,12,11,33,50,-17,33
Sonderjyske,2907,6,8,6,10,28,29,-1,30
AaB,2907,7,6,11,13,34,48,-14,29
Randers FC,2907,8,5,7,12,23,39,-16,22
Lyngby,2907,9,3,10,11,26,44,-18,19
Silkeborg IF,2907,10,5,4,13,26,45,-19,19
AGF Aarhus,2907,11,4,7,11,17,37,-20,19
Brondby,2908,1,19,7,4,70,34,36,64
FC Midtjylla,2908,2,19,6,5,71,42,29,63
FC Nords,2908,3,14,7,9,74,55,19,49
Copenhagen,2908,4,14,5,11,59,46,13,47
AaB,2908,5,8,11,11,37,47,-10,35
AC Horsens,2908,6,7,14,9,42,55,-13,35
Sonderjyske,2908,7,8,6,10,28,29,-1,30
Lyngby,2908,8,4,9,11,28,44,-16,21
Randers FC,2908,9,5,6,13,23,41,-18,21
AGF Aarhus,2908,10,5,6,11,18,37,-19,21
Silkeborg IF,2908,11,5,3,14,26,46,-20,18
Brondby,2909,1,21,6,3,73,32,41,69
FC Midtjylla,2909,2,19,5,6,70,38,32,62
Copenhagen,2909,3,15,5,10,59,45,14,50
FC Nords,2909,4,12,8,10,70,54,16,44
AaB,2909,5,7,13,10,38,50,-12,34
AC Horsens,2909,6,7,13,10,36,53,-17,34
Sonderjyske,2909,7,8,6,10,28,29,-1,30
Randers FC,2909,8,6,6,12,26,40,-14,24
Silkeborg IF,2909,9,6,3,13,29,45,-16,21
Lyngby,2909,10,3,9,12,27,47,-20,18
AGF Aarhus,2909,11,4,6,12,17,40,-23,18
Brondby,2910,1,22,5,3,73,31,42,71
FC Midtjylla,2910,2,19,5,6,65,42,23,62
FC Nords,2910,3,14,7,9,71,48,23,49
Copenhagen,2910,4,13,5,12,54,45,9,44
AC Horsens,2910,5,7,14,9,42,51,-9,35
AaB,2910,6,7,12,11,36,50,-14,33
Sonderjyske,2910,7,8,6,10,28,29,-1,30
Randers FC,2910,8,5,7,12,25,41,-16,22
AGF Aarhus,2910,9,5,6,11,18,37,-19,21
Lyngby,2910,10,3,10,11,28,46,-18,19
Silkeborg IF,2910,11,5,3,14,26,46,-20,18
Brondby,2911,1,21,6,3,71,33,38,69
FC Midtjylla,2911,2,19,6,5,68,40,28,63
FC Nords,2911,3,14,7,9,72,51,21,49
Copenhagen,2911,4,12,6,12,58,51,7,42
AC Horsens,2911,5,8,13,9,37,50,-13,37
AaB,2911,6,6,14,10,36,43,-7,32
Sonderjyske,2911,7,8,6,10,28,29,-1,30
Silkeborg IF,2911,8,6,3,13,29,45,-16,21
Lyngby,2911,9,4,9,11,27,44,-17,21
Randers FC,2911,10,5,6,13,23,40,-17,21
AGF Aarhus,2911,11,4,6,12,17,40,-23,18
Brondby,2912,1,20,6,4,68,32,36,66
FC Midtjylla,2912,2,19,5,6,65,41,24,62
Copenhagen,2912,3,15,5,10,62,44,18,50
FC Nords,2912,4,14,7,9,72,52,20,49
AaB,2912,5,8,12,10,38,42,-4,36
AC Horsens,2912,6,6,13,11,37,57,-20,31
Sonderjyske,2912,7,8,6,10,28,29,-1,30
Lyngby,2912,8,4,9,11,28,45,-17,21
Randers FC,2912,9,5,6,13,24,41,-17,21
AGF Aarhus,2912,10,5,6,11,17,36,-19,21
Silkeborg IF,2912,11,5,3,14,25,45,-20,18
FC Midtjylla,2913,1,21,4,5,69,40,29,67
Brondby,2913,2,20,6,4,72,34,38,66
FC Nords,2913,3,16,6,8,74,48,26,54
Copenhagen,2913,4,13,5,12,57,46,11,44
AaB,2913,5,7,12,11,36,45,-9,33
AC Horsens,2913,6,6,13,11,35,56,-21,31
Sonderjyske,2913,7,8,6,10,28,29,-1,30
Lyngby,2913,8,4,9,11,27,44,-17,21
Randers FC,2913,9,5,6,13,23,40,-17,21
Silkeborg IF,2913,10,6,3,13,26,44,-18,21
AGF Aarhus,2913,11,4,6,12,16,37,-21,18
Brondby,2914,1,20,8,2,71,32,39,68
FC Midtjylla,2914,2,19,4,7,66,42,24,61
FC Nords,2914,3,13,9,8,74,53,21,48
Copenhagen,2914,4,13,7,10,56,45,11,46
AaB,2914,5,8,11,11,39,44,-5,35
AC Horsens,2914,6,6,15,9,37,53,-16,33
Sonderjyske,2914,7,8,6,10,28,29,-1,30
Lyngby,2914,8,4,9,11,30,44,-14,21
Silkeborg IF,2914,9,6,3,13,27,45,-18,21
Randers FC,2914,10,5,6,13,23,43,-20,21
AGF Aarhus,2914,11,4,6,12,17,38,-21,18
Brondby,2915,1,20,6,4,68,36,32,66
FC Midtjylla,2915,2,20,4,6,66,38,28,64
FC Nords,2915,3,17,6,7,78,49,29,57
Copenhagen,2915,4,12,5,13,52,44,8,41
AaB,2915,5,8,13,9,36,39,-3,37
Sonderjyske,2915,6,8,6,10,28,29,-1,30
AC Horsens,2915,7,5,14,11,35,55,-20,29
Randers FC,2915,8,5,7,12,24,40,-16,22
Silkeborg IF,2915,9,6,3,13,28,44,-16,21
Lyngby,2915,10,3,10,11,27,45,-18,19
AGF Aarhus,2915,11,4,6,12,16,39,-23,18
Brondby,2916,1,20,6,4,72,34,38,66
FC Midtjylla,2916,2,19,6,5,65,41,24,63
FC Nords,2916,3,14,9,7,75,50,25,51
Copenhagen,2916,4,14,4,12,55,49,6,46
AaB,2916,5,9,13,8,41,40,1,40
Sonderjyske,2916,6,8,6,10,28,29,-1,30
AC Horsens,2916,7,5,12,13,32,52,-20,27
Lyngby,2916,8,4,9,11,31,46,-15,21
Randers FC,2916,9,5,6,13,25,44,-19,21
AGF Aarhus,2916,10,5,6,11,17,36,-19,21
Silkeborg IF,2916,11,5,3,14,25,45,-20,18
Brondby,2917,1,18,9,3,65,31,34,63
FC Midtjylla,2917,2,19,6,5,64,37,27,63
FC Nords,2917,3,15,7,8,77,49,28,52
Copenhagen,2917,4,14,6,10,56,42,14,48
AC Horsens,2917,5,7,14,9,35,52,-17,35
Sonderjyske,2917,6,8,6,10,28,29,-1,30
AaB,2917,7,6,12,12,33,45,-12,30
Randers FC,2917,8,5,7,12,23,39,-16,22
AGF Aarhus,2917,9,5,6,11,17,36,-19,21
Lyngby,2917,10,3,10,11,26,44,-18,19
Silkeborg IF,2917,11,5,3,14,25,45,-20,18
FC Midtjylla,2918,1,19,5,6,64,38,26,62
Brondby,2918,2,18,6,6,70,42,28,60
FC Nords,2918,3,16,7,7,78,50,28,55
Copenhagen,2918,4,13,5,12,56,50,6,44
AaB,2918,5,8,13,9,38,39,-1,37
AC Horsens,2918,6,8,12,10,41,54,-13,36
Sonderjyske,2918,7,8,6,10,28,29,-1,30
Lyngby,2918,8,4,9,11,27,44,-17,21
Randers FC,2918,9,5,6,13,23,40,-17,21
Silkeborg IF,2918,10,5,4,13,26,45,-19,19
AGF Aarhus,2918,11,4,7,11,17,37,-20,19
FC Midtjylla,2919,1,22,4,4,73,39,34,70
Brondby,2919,2,21,5,4,68,30,38,68
FC Nords,2919,3,14,6,10,73,54,19,48
Copenhagen,2919,4,14,4,12,59,49,10,46
AaB,2919,5,8,11,11,38,45,-7,35
Sonderjyske,2919,6,8,6,10,28,29,-1,30
AC Horsens,2919,7,6,12,12,34,54,-20,30
Randers FC,2919,8,5,7,12,23,39,-16,22
AGF Aarhus,2919,9,5,6,11,19,36,-17,21
Lyngby,2919,10,3,10,11,26,44,-18,19
Silkeborg IF,2919,11,5,3,14,25,47,-22,18
Brondby,2920,1,20,6,4,71,37,34,66
FC Midtjylla,2920,2,20,4,6,65,37,28,64
Copenhagen,2920,3,16,5,9,61,43,18,53
FC Nords,2920,4,13,6,11,70,53,17,45
AC Horsens,2920,5,7,13,10,34,51,-17,34
AaB,2920,6,7,12,11,36,42,-6,33
Sonderjyske,2920,7,8,6,10,28,29,-1,30
Randers FC,2920,8,6,6,12,26,41,-15,24
Silkeborg IF,2920,9,5,4,13,26,45,-19,19
AGF Aarhus,2920,10,4,7,11,17,37,-20,19
Lyngby,2920,11,3,9,12,28,47,-19,18
Brondby,2921,1,22,6,2,71,29,42,72
FC Midtjylla,2921,2,20,6,4,69,38,31,66
FC Nords,2921,3,13,8,9,72,52,20,47
Copenhagen,2921,4,14,5,11,59,47,12,47
AaB,2921,5,6,13,11,35,45,-10,31
Sonderjyske,2921,6,8,6,10,28,29,-1,30
AC Horsens,2921,7,5,14,11,34,55,-21,29
Lyngby,2921,8,4,9,11,29,44,-15,21
Silkeborg IF,2921,9,6,3,13,28,45,-17,21
Randers FC,2921,10,5,6,13,23,42,-19,21
AGF Aarhus,2921,11,4,6,12,17,39,-22,18
Brondby,2922,1,22,5,3,71,34,37,71
FC Midtjylla,2922,2,19,5,6,69,42,27,62
Copenhagen,2922,3,15,5,10,62,47,15,50
FC Nords,2922,4,13,8,9,75,53,22,47
AaB,2922,5,8,12,10,39,45,-6,36
Sonderjyske,2922,6,8,6,10,28,29,-1,30
AC Horsens,2922,7,5,13,12,35,56,-21,28
Randers FC,2922,8,6,6,12,24,39,-15,24
Silkeborg IF,2922,9,6,3,13,28,45,-17,21
Lyngby,2922,10,3,9,12,26,45,-19,18
AGF Aarhus,2922,11,4,6,12,17,39,-22,18
Brondby,2923,1,21,6,3,71,32,39,69
FC Midtjylla,2923,2,20,5,5,68,37,31,65
Copenhagen,2923,3,15,5,10,62,45,17,50
FC Nords,2923,4,13,9,8,70,51,19,48
AaB,2923,5,7,12,11,34,42,-8,33
Sonderjyske,2923,6,8,6,10,28,29,-1,30
AC Horsens,2923,7,5,13,12,32,56,-24,28
Randers FC,2923,8,5,7,12,25,41,-16,22
Silkeborg IF,2923,9,6,3,13,26,44,-18,21
Lyngby,2923,10,3,10,11,28,46,-18,19
AGF Aarhus,2923,11,4,6,12,16,37,-21,18
Brondby,2924,1,21,6,3,69,32,37,69
FC Midtjylla,2924,2,17,5,8,59,41,18,56
FC Nords,2924,3,13,9,8,75,52,23,48
Copenhagen,2924,4,13,6,11,60,47,13,45
AaB,2924,5,10,11,9,40,41,-1,41
AC Horsens,2924,6,7,13,10,38,54,-16,34
Sonderjyske,2924,7,8,6,10,28,29,-1,30
Lyngby,2924,8,4,9,11,27,44,-17,21
Randers FC,2924,9,5,6,13,23,40,-17,21
Silkeborg IF,2924,10,5,4,13,26,45,-19,19
AGF Aarhus,2924,11,4,7,11,17,37,-20,19
Brondby,2925,1,20,5,5,68,32,36,65
FC Midtjylla,2925,2,19,5,6,70,42,28,62
Copenhagen,2925,3,14,6,10,59,46,13,48
FC Nords,2925,4,13,8,9,73,58,15,47
AC Horsens,2925,5,8,13,9,39,53,-14,37
AaB,2925,6,7,13,10,38,42,-4,34
Sonderjyske,2925,7,8,6,10,28,29,-1,30
Lyngby,2925,8,4,9,11,30,44,-14,21
Silkeborg IF,2925,9,6,3,13,28,44,-16,21
Randers FC,2925,10,5,6,13,23,43,-20,21
AGF Aarhus,2925,11,4,6,12,16,39,-23,18
Brondby,2926,1,19,8,3,70,36,34,65
FC Midtjylla,2926,2,17,8,5,58,38,20,59
FC Nords,2926,3,17,6,7,82,49,33,57
Copenhagen,2926,4,12,6,12,54,48,6,42
AaB,2926,5,8,12,10,36,39,-3,36
AC Horsens,2926,6,6,14,10,38,54,-16,32
Sonderjyske,2926,7,8,6,10,28,29,-1,30
Lyngby,2926,8,4,9,11,28,45,-17,21
Randers FC,2926,9,5,6,13,24,41,-17,21
Silkeborg IF,2926,10,5,4,13,25,44,-19,19
AGF Aarhus,2926,11,4,7,11,16,36,-20,19
Brondby,2927,1,21,5,4,73,32,41,68
FC Midtjylla,2927,2,19,5,6,67,42,25,62
Copenhagen,2927,3,16,4,10,57,41,16,52
FC Nords,2927,4,14,8,8,70,50,20,50
AaB,2927,5,7,11,12,34,45,-11,32
AC Horsens,2927,6,6,13,11,33,50,-17,31
Sonderjyske,2927,7,8,6,10,28,29,-1,30
Randers FC,2927,8,5,7,12,24,40,-16,22
Silkeborg IF,2927,9,6,3,13,27,44,-17,21
Lyngby,2927,10,3,10,11,27,45,-18,19
AGF Aarhus,2927,11,4,6,12,16,38,-22,18
Brondby,2928,1,22,5,3,76,36,40,71
FC Midtjylla,2928,2,17,5,8,60,41,19,56
FC Nords,2928,3,14,7,9,74,53,21,49
Copenhagen,2928,4,14,6,10,60,46,14,48
AaB,2928,5,9,12,9,38,42,-4,39
AC Horsens,2928,6,6,13,11,41,57,-16,31
Sonderjyske,2928,7,8,6,10,28,29,-1,30
Randers FC,2928,8,6,6,12,24,39,-15,24
AGF Aarhus,2928,9,5,6,11,20,37,-17,21
Lyngby,2928,10,3,9,12,26,45,-19,18
Silkeborg IF,2928,11,5,3,14,26,48,-22,18
Brondby,2929,1,22,6,2,73,30,43,72
FC Midtjylla,2929,2,19,4,7,61,38,23,61
Copenhagen,2929,3,14,7,9,58,42,16,49
FC Nords,2929,4,13,8,9,72,53,19,47
AC Horsens,2929,5,7,12,11,35,52,-17,33
AaB,2929,6,6,13,11,32,42,-10,31
Sonderjyske,2929,7,8,6,10,28,29,-1,30
Randers FC,2929,8,5,7,12,24,40,-16,22
Lyngby,2929,9,3,10,11,27,45,-18,19
Silkeborg IF,2929,10,5,4,13,27,46,-19,19
AGF Aarhus,2929,11,4,7,11,18,38,-20,19
Brondby,2930,1,19,7,4,69,34,35,64
FC Midtjylla,2930,2,20,4,6,67,40,27,64
FC Nords,2930,3,15,7,8,75,52,23,52
Copenhagen,2930,4,13,5,12,55,46,9,44
AC Horsens,2930,5,8,13,9,40,53,-13,37
AaB,2930,6,7,12,11,33,40,-7,33
Sonderjyske,2930,7,8,6,10,28,29,-1,30
Lyngby,2930,8,4,9,11,28,44,-16,21
Randers FC,2930,9,5,6,13,23,41,-18,21
Silkeborg IF,2930,10,5,4,13,26,45,-19,19
AGF Aarhus,2930,11,4,7,11,17,37,-20,19
Brondby,2931,1,21,6,3,72,37,35,69
FC Midtjylla,2931,2,19,7,4,65,37,28,64
Copenhagen,2931,3,14,5,11,59,41,18,47
FC Nords,2931,4,12,7,11,68,55,13,43
AaB,2931,5,8,12,10,38,44,-6,36
AC Horsens,2931,6,7,13,10,40,54,-14,34
Sonderjyske,2931,7,8,6,10,28,29,-1,30
Lyngby,2931,8,4,9,11,29,45,-16,21
Randers FC,2931,9,5,6,13,24,42,-18,21
AGF Aarhus,2931,10,5,6,11,17,36,-19,21
Silkeborg IF,2931,11,5,3,14,25,45,-20,18
Brondby,2932,1,21,6,3,72,34,38,69
FC Midtjylla,2932,2,19,6,5,69,40,29,63
FC Nords,2932,3,15,7,8,69,50,19,52
Copenhagen,2932,4,13,6,11,55,44,11,45
AaB,2932,5,7,14,9,38,41,-3,35
Sonderjyske,2932,6,8,6,10,28,29,-1,30
AC Horsens,2932,7,5,13,12,33,53,-20,28
Lyngby,2932,8,4,9,11,28,45,-17,21
Silkeborg IF,2932,9,6,3,13,27,44,-17,21
Randers FC,2932,10,5,6,13,24,41,-17,21
AGF Aarhus,2932,11,4,6,12,16,38,-22,18
Brondby,2933,1,22,5,3,72,32,40,71
FC Midtjylla,2933,2,19,5,6,64,40,24,62
FC Nords,2933,3,15,7,8,73,50,23,52
Copenhagen,2933,4,14,5,11,60,46,14,47
AaB,2933,5,7,12,11,38,43,-5,33
Sonderjyske,2933,6,8,6,10,28,29,-1,30
AC Horsens,2933,7,6,12,12,31,53,-22,30
Randers FC,2933,8,5,7,12,24,40,-16,22
Lyngby,2933,9,3,10,11,27,45,-18,19
Silkeborg IF,2933,10,5,4,13,25,44,-19,19
AGF Aarhus,2933,11,4,7,11,16,36,-20,19
Brondby,2934,1,21,7,2,71,30,41,70
FC Midtjylla,2934,2,18,6,6,69,41,28,60
FC Nords,2934,3,14,8,8,78,53,25,50
Copenhagen,2934,4,13,5,12,55,47,8,44
AaB,2934,5,9,13,8,39,39,0,40
Sonderjyske,2934,6,8,6,10,28,29,-1,30
AC Horsens,2934,7,5,13,12,36,64,-28,28
Lyngby,2934,8,4,9,11,28,44,-16,21
Randers FC,2934,9,5,6,13,23,41,-18,21
AGF Aarhus,2934,10,5,6,11,20,38,-18,21
Silkeborg IF,2934,11,5,3,14,27,48,-21,18
Brondby,2935,1,21,6,3,74,34,40,69
FC Midtjylla,2935,2,19,7,4,62,36,26,64
Copenhagen,2935,3,15,6,9,59,41,18,51
FC Nords,2935,4,12,6,12,66,54,12,42
AC Horsens,2935,5,7,13,10,35,50,-15,34
AaB,2935,6,7,12,11,35,42,-7,33
Sonderjyske,2935,7,8,6,10,28,29,-1,30
Lyngby,2935,8,4,9,11,27,44,-17,21
Randers FC,2935,9,5,6,13,23,40,-17,21
AGF Aarhus,2935,10,5,6,11,18,36,-18,21
Silkeborg IF,2935,11,5,3,14,25,46,-21,18
Brondby,2936,1,19,9,2,71,33,38,66
FC Midtjylla,2936,2,18,8,4,61,35,26,62
FC Nords,2936,3,13,9,8,74,53,21,48
Copenhagen,2936,4,12,8,10,57,45,12,44
AaB,2936,5,7,13,10,39,45,-6,34
AC Horsens,2936,6,7,13,10,34,51,-17,34
Sonderjyske,2936,7,8,6,10,28,29,-1,30
Randers FC,2936,8,5,7,12,25,41,-16,22
Silkeborg IF,2936,9,6,3,13,27,44,-17,21
Lyngby,2936,10,3,10,11,28,46,-18,19
AGF Aarhus,2936,11,4,6,12,16,38,-22,18
Brondby,2937,1,21,6,3,71,32,39,69
FC Midtjylla,2937,2,20,4,6,62,38,24,64
FC Nords,2937,3,16,6,8,73,47,26,54
Copenhagen,2937,4,15,4,11,63,48,15,49
AC Horsens,2937,5,6,13,11,36,55,-19,31
Sonderjyske,2937,6,8,6,10,28,29,-1,30
AaB,2937,7,6,11,13,36,47,-11,29
Lyngby,2937,8,4,9,11,27,44,-17,21
Randers FC,2937,9,5,6,13,23,40,-17,21
Silkeborg IF,2937,10,6,3,13,26,44,-18,21
AGF Aarhus,2937,11,4,6,12,16,37,-21,18
Brondby,2938,1,20,7,3,65,31,34,67
FC Midtjylla,2938,2,21,4,5,65,36,29,67
Copenhagen,2938,3,15,4,11,64,46,18,49
FC Nords,2938,4,13,7,10,73,55,18,46
AaB,2938,5,7,12,11,35,42,-7,33
AC Horsens,2938,6,6,14,10,35,53,-18,32
Sonderjyske,2938,7,8,6,10,28,29,-1,30
Lyngby,2938,8,4,9,11,28,44,-16,21
Silkeborg IF,2938,9,6,3,13,28,45,-17,21
Randers FC,2938,10,5,6,13,23,41,-18,21
AGF Aarhus,2938,11,4,6,12,17,39,-22,18
Brondby,2939,1,22,5,3,69,31,38,71
FC Midtjylla,2939,2,20,5,5,65,37,28,65
Copenhagen,2939,3,14,6,10,58,43,15,48
FC Nords,2939,4,12,8,10,66,53,13,44
AC Horsens,2939,5,7,13,10,37,48,-11,34
AaB,2939,6,6,13,11,33,42,-9,31
Sonderjyske,2939,7,8,6,10,28,29,-1,30
Randers FC,2939,8,6,6,12,25,40,-15,24
Silkeborg IF,2939,9,6,3,13,26,44,-18,21
Lyngby,2939,10,3,9,12,27,46,-19,18
AGF Aarhus,2939,11,4,6,12,16,37,-21,18
Brondby,2940,1,21,6,3,69,33,36,69
FC Midtjylla,2940,2,20,6,4,65,36,29,66
FC Nords,2940,3,14,7,9,72,48,24,49
Copenhagen,2940,4,13,4,13,57,49,8,43
AaB,2940,5,8,11,11,36,42,-6,35
AC Horsens,2940,6,7,12,11,41,58,-17,33
Sonderjyske,2940,7,8,6,10,28,29,-1,30
Lyngby,2940,8,4,9,11,30,44,-14,21
AGF Aarhus,2940,9,5,6,11,17,36,-19,21
Randers FC,2940,10,5,6,13,23,43,-20,21
Silkeborg IF,2940,11,5,3,14,25,45,-20,18
Brondby,2941,1,22,5,3,75,30,45,71
FC Midtjylla,2941,2,19,6,5,68,38,30,63
Copenhagen,2941,3,15,5,10,55,41,14,50
FC Nords,2941,4,13,6,11,71,57,14,45
AaB,2941,5,8,12,10,38,45,-7,36
Sonderjyske,2941,6,8,6,10,28,29,-1,30
AC Horsens,2941,7,6,12,12,35,57,-22,30
Lyngby,2941,8,4,9,11,29,46,-17,21
Randers FC,2941,9,5,6,13,25,42,-17,21
AGF Aarhus,2941,10,5,6,11,17,36,-19,21
Silkeborg IF,2941,11,5,3,14,25,45,-20,18
Brondby,2942,1,22,6,2,72,29,43,72
FC Midtjylla,2942,2,20,4,6,65,39,26,64
FC Nords,2942,3,15,6,9,75,52,23,51
Copenhagen,2942,4,12,4,14,55,50,5,40
AaB,2942,5,8,12,10,38,44,-6,36
AC Horsens,2942,6,6,14,10,33,50,-17,32
Sonderjyske,2942,7,8,6,10,28,29,-1,30
Randers FC,2942,8,5,7,12,25,41,-16,22
Silkeborg IF,2942,9,6,3,13,27,44,-17,21
Lyngby,2942,10,3,10,11,28,46,-18,19
AGF Aarhus,2942,11,4,6,12,16,38,-22,18
Brondby,2943,1,21,6,3,73,32,41,69
FC Midtjylla,2943,2,19,5,6,64,42,22,62
FC Nords,2943,3,14,8,8,71,49,22,50
Copenhagen,2943,4,15,4,11,60,44,16,49
AaB,2943,5,7,12,11,35,42,-7,33
AC Horsens,2943,6,6,13,11,34,54,-20,31
Sonderjyske,2943,7,8,6,10,28,29,-1,30
Silkeborg IF,2943,8,6,3,13,28,44,-16,21
Lyngby,2943,9,4,9,11,28,45,-17,21
Randers FC,2943,10,5,6,13,24,41,-17,21
AGF Aarhus,2943,11,4,6,12,16,39,-23,18
Brondby,2944,1,21,6,3,70,32,38,69
FC Midtjylla,2944,2,18,5,7,64,46,18,59
FC Nords,2944,3,16,7,7,78,50,28,55
Copenhagen,2944,4,15,4,11,59,42,17,49
AaB,2944,5,7,13,10,35,40,-5,34
Sonderjyske,2944,6,8,6,10,28,29,-1,30
AC Horsens,2944,7,5,13,12,33,55,-22,28
Randers FC,2944,8,6,6,12,25,39,-14,24
Silkeborg IF,2944,9,6,3,13,28,45,-17,21
Lyngby,2944,10,3,9,12,26,46,-20,18
AGF Aarhus,2944,11,4,6,12,17,39,-22,18
FC Midtjylla,2945,1,21,5,4,74,38,36,68
Brondby,2945,2,19,7,4,75,38,37,64
FC Nords,2945,3,13,7,10,75,62,13,46
Copenhagen,2945,4,13,7,10,59,46,13,46
AaB,2945,5,7,13,10,39,45,-6,34
AC Horsens,2945,6,7,13,10,38,57,-19,34
Sonderjyske,2945,7,8,6,10,28,29,-1,30
Lyngby,2945,8,4,9,11,27,44,-17,21
Randers FC,2945,9,5,6,13,23,40,-17,21
AGF Aarhus,2945,10,5,6,11,17,36,-19,21
Silkeborg IF,2945,11,5,3,14,25,45,-20,18
Brondby,2946,1,21,5,4,71,34,37,68
FC Midtjylla,2946,2,19,4,7,66,43,23,61
FC Nords,2946,3,14,7,9,76,55,21,49
Copenhagen,2946,4,14,5,11,58,46,12,47
AC Horsens,2946,5,8,12,10,38,51,-13,36
AaB,2946,6,7,13,10,37,43,-6,34
Sonderjyske,2946,7,8,6,10,28,29,-1,30
Randers FC,2946,8,5,7,12,23,39,-16,22
AGF Aarhus,2946,9,5,6,11,18,36,-18,21
Lyngby,2946,10,3,10,11,26,44,-18,19
Silkeborg IF,2946,11,5,3,14,25,46,-21,18
Brondby,2947,1,21,6,3,75,33,42,69
FC Midtjylla,2947,2,20,5,5,66,39,27,65
FC Nords,2947,3,15,7,8,75,53,22,52
Copenhagen,2947,4,15,4,11,59,44,15,49
Sonderjyske,2947,5,8,6,10,28,29,-1,30
AaB,2947,6,6,12,12,34,44,-10,30
AC Horsens,2947,7,5,14,11,31,53,-22,29
Randers FC,2947,8,6,6,12,25,40,-15,24
Silkeborg IF,2947,9,6,3,13,26,44,-18,21
Lyngby,2947,10,3,9,12,27,46,-19,18
AGF Aarhus,2947,11,4,6,12,16,37,-21,18
Brondby,2948,1,22,6,2,74,34,40,72
FC Midtjylla,2948,2,18,5,7,63,42,21,59
FC Nords,2948,3,14,7,9,73,52,21,49
Copenhagen,2948,4,13,7,10,60,46,14,46
AaB,2948,5,7,13,10,36,44,-8,34
AC Horsens,2948,6,6,14,10,42,56,-14,32
Sonderjyske,2948,7,8,6,10,28,29,-1,30
Randers FC,2948,8,5,7,12,24,40,-16,22
Lyngby,2948,9,3,10,11,27,45,-18,19
Silkeborg IF,2948,10,5,4,13,27,46,-19,19
AGF Aarhus,2948,11,4,7,11,18,38,-20,19
Brondby,2949,1,21,6,3,75,34,41,69
FC Midtjylla,2949,2,19,5,6,70,44,26,62
Copenhagen,2949,3,15,5,10,66,47,19,50
FC Nords,2949,4,13,7,10,73,56,17,46
AaB,2949,5,8,12,10,37,44,-7,36
AC Horsens,2949,6,6,13,11,35,57,-22,31
Sonderjyske,2949,7,8,6,10,28,29,-1,30
Lyngby,2949,8,4,9,11,28,44,-16,21
Silkeborg IF,2949,9,6,3,13,27,45,-18,21
Randers FC,2949,10,5,6,13,23,41,-18,21
AGF Aarhus,2949,11,4,6,12,17,38,-21,18
Brondby,2950,1,22,6,2,77,31,46,72
FC Midtjylla,2950,2,18,7,5,62,38,24,61
FC Nords,2950,3,14,8,8,75,51,24,50
Copenhagen,2950,4,13,4,13,54,47,7,43
AaB,2950,5,7,13,10,36,46,-10,34
AC Horsens,2950,6,6,14,10,34,51,-17,32
Sonderjyske,2950,7,8,6,10,28,29,-1,30
Lyngby,2950,8,4,9,11,29,45,-16,21
Silkeborg IF,2950,9,6,3,13,28,46,-18,21
Randers FC,2950,10,5,6,13,24,42,-18,21
AGF Aarhus,2950,11,4,6,12,18,39,-21,18
Brondby,2951,1,22,6,2,71,30,41,72
FC Midtjylla,2951,2,18,4,8,63,43,20,58
FC Nords,2951,3,15,6,9,74,49,25,51
Copenhagen,2951,4,15,6,9,61,43,18,51
AaB,2951,5,7,12,11,37,45,-8,33
Sonderjyske,2951,6,8,6,10,28,29,-1,30
AC Horsens,2951,7,6,12,12,36,58,-22,30
Lyngby,2951,8,4,9,11,28,45,-17,21
Silkeborg IF,2951,8,6,3,13,28,45,-17,21
Randers FC,2951,10,5,6,13,24,41,-17,21
AGF Aarhus,2951,11,4,6,12,17,39,-22,18
Brondby,2952,1,21,6,3,69,32,37,69
FC Midtjylla,2952,2,19,5,6,67,44,23,62
FC Nords,2952,3,13,7,10,73,54,19,46
Copenhagen,2952,4,13,5,12,56,47,9,44
AaB,2952,5,8,12,10,42,44,-2,36
AC Horsens,2952,6,7,15,8,36,48,-12,36
Sonderjyske,2952,7,8,6,10,28,29,-1,30
Lyngby,2952,8,4,9,11,30,47,-17,21
Silkeborg IF,2952,9,6,3,13,27,44,-17,21
Randers FC,2952,10,5,6,13,26,43,-17,21
AGF Aarhus,2952,11,4,6,12,16,38,-22,18
Brondby,2953,1,21,6,3,71,30,41,69
FC Midtjylla,2953,2,18,6,6,62,37,25,60
Copenhagen,2953,3,15,4,11,60,43,17,49
FC Nords,2953,4,14,6,10,70,52,18,48
AaB,2953,5,9,12,9,36,41,-5,39
Sonderjyske,2953,6,8,6,10,28,29,-1,30
AC Horsens,2953,7,5,14,11,31,53,-22,29
Randers FC,2953,8,5,7,12,23,39,-16,22
Silkeborg IF,2953,9,6,3,13,27,45,-18,21
Lyngby,2953,10,3,10,11,26,44,-18,19
AGF Aarhus,2953,11,4,6,12,17,38,-21,18
FC Midtjylla,2954,1,20,6,4,70,40,30,66
Brondby,2954,2,20,5,5,75,34,41,65
Copenhagen,2954,3,15,5,10,58,45,13,50
FC Nords,2954,4,14,6,10,75,60,15,48
AaB,2954,5,7,12,11,38,46,-8,33
AC Horsens,2954,6,7,12,11,38,55,-17,33
Sonderjyske,2954,7,8,6,10,28,29,-1,30
Randers FC,2954,8,5,7,12,24,40,-16,22
Silkeborg IF,2954,9,6,3,13,27,45,-18,21
Lyngby,2954,10,3,10,11,27,45,-18,19
AGF Aarhus,2954,11,4,6,12,17,38,-21,18
Brondby,2955,1,20,7,3,70,31,39,67
FC Midtjylla,2955,2,20,4,6,68,43,25,64
Copenhagen,2955,3,15,5,10,58,41,17,50
FC Nords,2955,4,13,7,10,71,55,16,46
AaB,2955,5,8,13,9,38,41,-3,37
Sonderjyske,2955,6,8,6,10,28,29,-1,30
AC Horsens,2955,7,5,14,11,35,55,-20,29
Randers FC,2955,8,6,6,12,25,40,-15,24
Silkeborg IF,2955,9,5,4,13,26,45,-19,19
AGF Aarhus,2955,10,4,7,11,17,37,-20,19
Lyngby,2955,11,3,9,12,27,46,-19,18
Brondby,2956,1,20,7,3,71,33,38,67
FC Midtjylla,2956,2,19,6,5,69,41,28,63
Copenhagen,2956,3,16,4,10,60,43,17,52
FC Nords,2956,4,15,6,9,80,59,21,51
AC Horsens,2956,5,6,13,11,37,54,-17,31
Sonderjyske,2956,6,8,6,10,28,29,-1,30
AaB,2956,7,6,12,12,37,50,-13,30
Lyngby,2956,8,4,9,11,31,45,-14,21
AGF Aarhus,2956,9,5,6,11,18,36,-18,21
Randers FC,2956,10,5,6,13,24,44,-20,21
Silkeborg IF,2956,11,5,3,14,25,46,-21,18
Brondby,2957,1,22,5,3,75,33,42,71
FC Midtjylla,2957,2,18,5,7,62,42,20,59
FC Nords,2957,3,15,6,9,72,51,21,51
Copenhagen,2957,4,15,5,10,58,41,17,50
AC Horsens,2957,5,6,14,10,39,51,-12,32
AaB,2957,6,7,11,12,37,51,-14,32
Sonderjyske,2957,7,8,6,10,28,29,-1,30
Randers FC,2957,8,5,7,12,23,39,-16,22
Silkeborg IF,2957,9,6,3,13,26,44,-18,21
Lyngby,2957,10,3,10,11,26,44,-18,19
AGF Aarhus,2957,11,4,6,12,16,37,-21,18
Brondby,2958,1,20,5,5,70,36,34,65
FC Midtjylla,2958,2,20,4,6,69,37,32,64
Copenhagen,2958,3,15,5,10,59,43,16,50
FC Nords,2958,4,13,7,10,70,56,14,46
AaB,2958,5,10,11,9,41,38,3,41
Sonderjyske,2958,6,8,6,10,28,29,-1,30
AC Horsens,2958,7,6,12,12,36,61,-25,30
Randers FC,2958,8,6,6,12,26,40,-14,24
Silkeborg IF,2958,9,5,4,13,26,45,-19,19
AGF Aarhus,2958,10,4,7,11,17,37,-20,19
Lyngby,2958,11,3,9,12,27,47,-20,18
Brondby,2959,1,21,6,3,69,31,38,69
FC Midtjylla,2959,2,21,4,5,71,40,31,67
FC Nords,2959,3,13,6,11,73,54,19,45
Copenhagen,2959,4,13,6,11,56,47,9,45
AaB,2959,5,8,12,10,37,43,-6,36
AC Horsens,2959,6,7,12,11,36,53,-17,33
Sonderjyske,2959,7,8,6,10,28,29,-1,30
Randers FC,2959,8,5,7,12,24,40,-16,22
Silkeborg IF,2959,9,6,3,13,29,45,-16,21
Lyngby,2959,10,3,10,11,27,45,-18,19
AGF Aarhus,2959,11,4,6,12,17,40,-23,18
Brondby,2960,1,23,5,2,77,29,48,74
FC Midtjylla,2960,2,19,4,7,65,43,22,61
FC Nords,2960,3,14,7,9,71,51,20,49
Copenhagen,2960,4,14,4,12,56,50,6,46
AaB,2960,5,8,12,10,37,41,-4,36
Sonderjyske,2960,6,8,6,10,28,29,-1,30
AC Horsens,2960,7,6,12,12,36,54,-18,30
Randers FC,2960,8,6,6,12,27,39,-12,24
AGF Aarhus,2960,9,5,6,11,17,36,-19,21
Silkeborg IF,2960,10,5,3,14,25,45,-20,18
Lyngby,2960,11,3,9,12,26,48,-22,18
Brondby,2961,1,21,6,3,73,34,39,69
FC Midtjylla,2961,2,18,8,4,65,40,25,62
Copenhagen,2961,3,14,6,10,59,46,13,48
FC Nords,2961,4,13,7,10,75,52,23,46
AaB,2961,5,7,13,10,38,44,-6,34
AC Horsens,2961,6,6,14,10,37,57,-20,32
Sonderjyske,2961,7,8,6,10,28,29,-1,30
Randers FC,2961,8,6,6,12,26,41,-15,24
Silkeborg IF,2961,9,6,3,13,27,45,-18,21
Lyngby,2961,10,3,9,12,28,47,-19,18
AGF Aarhus,2961,11,4,6,12,17,38,-21,18
Brondby,2962,1,21,5,4,71,33,38,68
FC Midtjylla,2962,2,19,5,6,67,39,28,62
FC Nords,2962,3,16,6,8,77,52,25,54
Copenhagen,2962,4,14,4,12,59,49,10,46
AaB,2962,5,8,11,11,38,46,-8,35
AC Horsens,2962,6,6,13,11,34,53,-19,31
Sonderjyske,2962,7,8,6,10,28,29,-1,30
Randers FC,2962,8,6,6,12,25,40,-15,24
Silkeborg IF,2962,9,6,3,13,30,45,-15,21
Lyngby,2962,10,3,9,12,27,46,-19,18
AGF Aarhus,2962,11,4,6,12,17,41,-24,18
Brondby,2963,1,22,6,2,79,35,44,72
FC Midtjylla,2963,2,20,6,4,80,40,40,66
FC Nords,2963,3,14,7,9,74,51,23,49
Copenhagen,2963,4,14,4,12,57,49,8,46
AaB,2963,5,7,11,12,34,47,-13,32
Sonderjyske,2963,6,8,6,10,28,29,-1,30
AC Horsens,2963,7,6,12,12,30,58,-28,30
Randers FC,2963,8,6,6,12,27,39,-12,24
Silkeborg IF,2963,9,6,3,13,28,44,-16,21
Lyngby,2963,10,3,9,12,26,48,-22,18
AGF Aarhus,2963,11,4,6,12,16,39,-23,18
Brondby,2964,1,21,5,4,71,35,36,68
FC Midtjylla,2964,2,20,5,5,64,38,26,65
FC Nords,2964,3,14,7,9,77,52,25,49
Copenhagen,2964,4,13,6,11,56,48,8,45
AaB,2964,5,8,13,9,39,41,-2,37
Sonderjyske,2964,6,8,6,10,28,29,-1,30
AC Horsens,2964,7,5,14,11,34,53,-19,29
Randers FC,2964,8,6,6,12,24,39,-15,24
AGF Aarhus,2964,9,5,6,11,18,36,-18,21
Lyngby,2964,10,3,9,12,26,45,-19,18
Silkeborg IF,2964,11,5,3,14,25,46,-21,18
Brondby,2965,1,21,6,3,75,32,43,69
FC Midtjylla,2965,2,20,5,5,66,40,26,65
FC Nords,2965,3,15,6,9,79,48,31,51
Copenhagen,2965,4,14,5,11,57,46,11,47
AC Horsens,2965,5,7,12,11,34,57,-23,33
Sonderjyske,2965,6,8,6,10,28,29,-1,30
AaB,2965,7,6,12,12,33,47,-14,30
Randers FC,2965,8,6,6,12,25,40,-15,24
Silkeborg IF,2965,9,6,3,13,27,44,-17,21
Lyngby,2965,10,3,9,12,27,46,-19,18
AGF Aarhus,2965,11,4,6,12,16,38,-22,18
Brondby,2966,1,20,6,4,69,35,34,66
FC Midtjylla,2966,2,20,6,4,66,38,28,66
FC Nords,2966,3,14,7,9,75,51,24,49
Copenhagen,2966,4,14,6,10,60,45,15,48
AC Horsens,2966,5,6,14,10,36,51,-15,32
AaB,2966,6,6,13,11,36,48,-12,31
Sonderjyske,2966,7,8,6,10,28,29,-1,30
Randers FC,2966,8,5,7,12,27,43,-16,22
Silkeborg IF,2966,9,6,3,13,29,46,-17,21
Lyngby,2966,10,3,10,11,30,48,-18,19
AGF Aarhus,2966,11,4,6,12,18,40,-22,18
Brondby,2967,1,20,7,3,68,31,37,67
FC Midtjylla,2967,2,19,4,7,65,40,25,61
FC Nords,2967,3,15,6,9,76,51,25,51
Copenhagen,2967,4,14,5,11,56,45,11,47
AaB,2967,5,8,11,11,40,46,-6,35
AC Horsens,2967,6,7,13,10,36,54,-18,34
Sonderjyske,2967,7,8,6,10,28,29,-1,30
Lyngby,2967,8,4,9,11,30,47,-17,21
Silkeborg IF,2967,9,6,3,13,28,45,-17,21
Randers FC,2967,10,5,6,13,26,43,-17,21
AGF Aarhus,2967,11,4,6,12,17,39,-22,18
Brondby,2968,1,23,5,2,76,30,46,74
FC Midtjylla,2968,2,20,4,6,69,44,25,64
FC Nords,2968,3,14,6,10,77,55,22,48
Copenhagen,2968,4,13,4,13,58,50,8,43
AC Horsens,2968,5,8,12,10,37,53,-16,36
AaB,2968,6,7,11,12,35,46,-11,32
Sonderjyske,2968,7,8,6,10,28,29,-1,30
Lyngby,2968,8,4,9,11,29,45,-16,21
Randers FC,2968,9,5,6,13,24,42,-18,21
AGF Aarhus,2968,10,5,6,11,18,37,-19,21
Silkeborg IF,2968,11,5,3,14,26,46,-20,18
FC Midtjylla,2969,1,20,5,5,66,38,28,65
Brondby,2969,2,19,7,4,70,34,36,64
FC Nords,2969,3,13,8,9,71,52,19,47
Copenhagen,2969,4,12,7,11,53,44,9,43
AaB,2969,5,8,13,9,36,41,-5,37
AC Horsens,2969,6,7,14,9,36,49,-13,35
Sonderjyske,2969,7,8,6,10,28,29,-1,30
Randers FC,2969,8,5,7,12,23,39,-16,22
Silkeborg IF,2969,9,6,3,13,26,44,-18,21
Lyngby,2969,10,3,10,11,26,44,-18,19
AGF Aarhus,2969,11,4,6,12,16,37,-21,18
Brondby,2970,1,20,5,5,68,34,34,65
FC Midtjylla,2970,2,19,5,6,66,42,24,62
Copenhagen,2970,3,16,5,9,62,37,25,53
FC Nords,2970,4,13,8,9,71,53,18,47
AC Horsens,2970,5,7,14,9,37,52,-15,35
AaB,2970,6,7,11,12,37,49,-12,32
Sonderjyske,2970,7,8,6,10,28,29,-1,30
Lyngby,2970,8,4,9,11,28,45,-17,21
Randers FC,2970,9,5,6,13,24,41,-17,21
Silkeborg IF,2970,10,5,4,13,27,46,-19,19
AGF Aarhus,2970,11,4,7,11,18,38,-20,19
Brondby,2971,1,21,5,4,71,31,40,68
FC Midtjylla,2971,2,19,6,5,64,40,24,63
FC Nords,2971,3,14,8,8,74,52,22,50
Copenhagen,2971,4,14,6,10,54,40,14,48
AC Horsens,2971,5,7,13,10,34,49,-15,34
Sonderjyske,2971,6,8,6,10,28,29,-1,30
AaB,2971,7,6,12,12,34,45,-11,30
Lyngby,2971,8,4,9,11,28,45,-17,21
Silkeborg IF,2971,9,6,3,13,27,44,-17,21
Randers FC,2971,10,5,6,13,24,41,-17,21
AGF Aarhus,2971,11,4,6,12,16,38,-22,18
Brondby,2972,1,23,5,2,71,30,41,74
FC Midtjylla,2972,2,20,5,5,61,33,28,65
FC Nords,2972,3,13,8,9,70,52,18,47
Copenhagen,2972,4,13,5,12,56,43,13,44
AaB,2972,5,8,12,10,36,40,-4,36
Sonderjyske,2972,6,8,6,10,28,29,-1,30
AC Horsens,2972,7,5,13,12,33,55,-22,28
Randers FC,2972,8,6,6,12,25,40,-15,24
Silkeborg IF,2972,9,5,4,13,26,45,-19,19
AGF Aarhus,2972,10,4,7,11,17,37,-20,19
Lyngby,2972,11,3,9,12,27,46,-19,18
FC Midtjylla,2973,1,21,5,4,68,35,33,68
Brondby,2973,2,20,7,3,71,31,40,67
FC Nords,2973,3,14,8,8,73,47,26,50
Copenhagen,2973,4,13,5,12,54,44,10,44
AaB,2973,5,7,13,10,36,48,-12,34
Sonderjyske,2973,6,8,6,10,28,29,-1,30
AC Horsens,2973,7,5,14,11,32,55,-23,29
Randers FC,2973,8,5,7,12,23,39,-16,22
AGF Aarhus,2973,9,5,6,11,19,36,-17,21
Lyngby,2973,10,3,10,11,26,44,-18,19
Silkeborg IF,2973,11,5,3,14,25,47,-22,18
Brondby,2974,1,21,6,3,73,34,39,69
FC Midtjylla,2974,2,19,6,5,64,38,26,63
FC Nords,2974,3,15,6,9,73,51,22,51
Copenhagen,2974,4,14,5,11,57,43,14,47
AaB,2974,5,7,12,11,34,42,-8,33
AC Horsens,2974,6,6,13,11,34,53,-19,31
Sonderjyske,2974,7,8,6,10,28,29,-1,30
Lyngby,2974,8,4,9,11,29,44,-15,21
Silkeborg IF,2974,9,6,3,13,29,47,-18,21
Randers FC,2974,10,5,6,13,23,42,-19,21
AGF Aarhus,2974,11,4,6,12,19,40,-21,18
Brondby,2975,1,21,6,3,67,29,38,69
FC Midtjylla,2975,2,20,4,6,65,39,26,64
FC Nords,2975,3,13,8,9,74,55,19,47
Copenhagen,2975,4,14,5,11,61,47,14,47
AC Horsens,2975,5,7,14,9,35,51,-16,35
AaB,2975,6,7,11,12,38,45,-7,32
Sonderjyske,2975,7,8,6,10,28,29,-1,30
Lyngby,2975,8,4,9,11,28,45,-17,21
Randers FC,2975,9,5,6,13,24,41,-17,21
Silkeborg IF,2975,10,5,4,13,26,45,-19,19
AGF Aarhus,2975,11,4,7,11,17,37,-20,19
Brondby,2976,1,20,7,3,73,36,37,67
FC Midtjylla,2976,2,21,4,5,69,39,30,67
FC Nords,2976,3,15,8,7,74,48,26,53
Copenhagen,2976,4,13,6,11,54,42,12,45
AaB,2976,5,6,13,11,37,47,-10,31
Sonderjyske,2976,6,8,6,10,28,29,-1,30
AC Horsens,2976,7,6,12,12,34,55,-21,30
Lyngby,2976,8,4,9,11,27,44,-17,21
Randers FC,2976,9,5,6,13,23,40,-17,21
Silkeborg IF,2976,10,5,4,13,26,45,-19,19
AGF Aarhus,2976,11,4,7,11,17,37,-20,19
Brondby,2977,1,20,6,4,68,36,32,66
FC Midtjylla,2977,2,19,5,6,62,39,23,62
FC Nords,2977,3,14,9,7,72,46,26,51
Copenhagen,2977,4,14,5,11,59,43,16,47
AaB,2977,5,7,14,9,36,40,-4,35
AC Horsens,2977,6,6,13,11,35,54,-19,31
Sonderjyske,2977,7,8,6,10,28,29,-1,30
Randers FC,2977,8,6,6,12,26,41,-15,24
Silkeborg IF,2977,9,5,4,13,27,46,-19,19
AGF Aarhus,2977,10,4,7,11,18,38,-20,19
Lyngby,2977,11,3,9,12,28,47,-19,18
Brondby,2978,1,21,6,3,71,31,40,69
FC Midtjylla,2978,2,18,5,7,62,39,23,59
Copenhagen,2978,3,13,7,10,60,47,13,46
FC Nords,2978,4,12,8,10,72,58,14,44
AC Horsens,2978,5,8,14,8,39,51,-12,38
AaB,2978,6,8,12,10,41,45,-4,36
Sonderjyske,2978,7,8,6,10,28,29,-1,30
Randers FC,2978,8,6,6,12,27,41,-14,24
AGF Aarhus,2978,9,5,6,11,19,36,-17,21
Lyngby,2978,10,3,9,12,28,48,-20,18
Silkeborg IF,2978,11,5,3,14,25,47,-22,18
Brondby,2979,1,20,7,3,70,33,37,67
FC Midtjylla,2979,2,19,5,6,62,38,24,62
Copenhagen,2979,3,15,4,11,57,43,14,49
FC Nords,2979,4,13,7,10,74,55,19,46
AaB,2979,5,8,12,10,35,40,-5,36
AC Horsens,2979,6,7,13,10,35,50,-15,34
Sonderjyske,2979,7,8,6,10,28,29,-1,30
Lyngby,2979,8,4,9,11,29,46,-17,21
Randers FC,2979,9,5,6,13,25,42,-17,21
Silkeborg IF,2979,10,5,4,13,25,44,-19,19
AGF Aarhus,2979,11,4,7,11,16,36,-20,19
Brondby,2980,1,19,7,4,70,37,33,64
FC Midtjylla,2980,2,19,5,6,68,40,28,62
Copenhagen,2980,3,14,6,10,59,44,15,48
FC Nords,2980,4,13,7,10,70,54,16,46
AaB,2980,5,9,11,10,37,41,-4,38
AC Horsens,2980,6,6,16,8,35,49,-14,34
Sonderjyske,2980,7,8,6,10,28,29,-1,30
Randers FC,2980,8,6,6,12,27,41,-14,24
Silkeborg IF,2980,9,6,3,13,27,44,-17,21
Lyngby,2980,10,3,9,12,28,48,-20,18
AGF Aarhus,2980,11,4,6,12,16,38,-22,18
Brondby,2981,1,21,6,3,72,34,38,69
FC Midtjylla,2981,2,20,5,5,73,43,30,65
FC Nords,2981,3,15,7,8,75,49,26,52
Copenhagen,2981,4,12,6,12,57,51,6,42
AaB,2981,5,7,13,10,38,43,-5,34
AC Horsens,2981,6,6,13,11,34,55,-21,31
Sonderjyske,2981,7,8,6,10,28,29,-1,30
Randers FC,2981,8,5,7,12,24,40,-16,22
Lyngby,2981,9,3,10,11,27,45,-18,19
Silkeborg IF,2981,10,5,4,13,28,47,-19,19
AGF Aarhus,2981,11,4,7,11,19,39,-20,19
Brondby,2982,1,22,5,3,69,28,41,71
FC Midtjylla,2982,2,21,4,5,67,35,32,67
FC Nords,2982,3,13,8,9,70,53,17,47
Copenhagen,2982,4,14,5,11,55,42,13,47
AaB,2982,5,6,13,11,33,43,-10,31
AC Horsens,2982,6,6,13,11,36,55,-19,31
Sonderjyske,2982,7,8,6,10,28,29,-1,30
Randers FC,2982,8,5,7,12,24,40,-16,22
AGF Aarhus,2982,9,5,6,11,18,37,-19,21
Lyngby,2982,10,3,10,11,27,45,-18,19
Silkeborg IF,2982,11,5,3,14,26,46,-20,18
Brondby,2983,1,23,5,2,76,30,46,74
FC Midtjylla,2983,2,19,6,5,63,41,22,63
FC Nords,2983,3,14,6,10,73,52,21,48
Copenhagen,2983,4,13,5,12,57,45,12,44
AaB,2983,5,8,12,10,38,42,-4,36
Sonderjyske,2983,6,8,6,10,28,29,-1,30
AC Horsens,2983,7,6,12,12,33,56,-23,30
Lyngby,2983,8,4,9,11,28,45,-17,21
Randers FC,2983,9,5,6,13,24,41,-17,21
Silkeborg IF,2983,10,5,4,13,27,46,-19,19
AGF Aarhus,2983,11,4,7,11,18,38,-20,19
Brondby,2984,1,22,5,3,73,30,43,71
FC Midtjylla,2984,2,19,4,7,66,43,23,61
Copenhagen,2984,3,16,4,10,59,42,17,52
FC Nords,2984,4,14,6,10,72,55,17,48
AaB,2984,5,8,12,10,41,45,-4,36
Sonderjyske,2984,6,8,6,10,28,29,-1,30
AC Horsens,2984,7,5,13,12,32,54,-22,28
Randers FC,2984,8,5,7,12,24,40,-16,22
Lyngby,2984,9,3,10,11,27,45,-18,19
Silkeborg IF,2984,10,5,4,13,25,44,-19,19
AGF Aarhus,2984,11,4,7,11,16,36,-20,19
Brondby,2985,1,20,7,3,72,35,37,67
FC Midtjylla,2985,2,18,7,5,62,40,22,61
FC Nords,2985,3,15,7,8,77,52,25,52
Copenhagen,2985,4,13,5,12,55,44,11,44
AaB,2985,5,9,11,10,39,44,-5,38
AC Horsens,2985,6,6,13,11,35,51,-16,31
Sonderjyske,2985,7,8,6,10,28,29,-1,30
Randers FC,2985,8,6,6,12,26,41,-15,24
Silkeborg IF,2985,9,6,3,13,26,44,-18,21
Lyngby,2985,10,3,9,12,28,47,-19,18
AGF Aarhus,2985,11,4,6,12,16,37,-21,18
Brondby,2986,1,22,5,3,70,31,39,71
FC Midtjylla,2986,2,18,6,6,66,45,21,60
Copenhagen,2986,3,15,5,10,60,44,16,50
FC Nords,2986,4,14,6,10,73,54,19,48
AaB,2986,5,8,12,10,42,43,-1,36
Sonderjyske,2986,6,8,6,10,28,29,-1,30
AC Horsens,2986,7,6,12,12,33,53,-20,30
Randers FC,2986,8,5,7,12,24,40,-16,22
Silkeborg IF,2986,9,6,3,13,26,44,-18,21
Lyngby,2986,10,3,10,11,27,45,-18,19
AGF Aarhus,2986,11,4,6,12,16,37,-21,18
Brondby,2987,1,21,5,4,69,32,37,68
FC Midtjylla,2987,2,20,4,6,65,38,27,64
FC Nords,2987,3,15,7,8,70,47,23,52
Copenhagen,2987,4,14,5,11,57,44,13,47
AaB,2987,5,7,12,11,35,41,-6,33
AC Horsens,2987,6,6,13,11,32,52,-20,31
Sonderjyske,2987,7,8,6,10,28,29,-1,30
Lyngby,2987,8,4,9,11,27,44,-17,21
Randers FC,2987,9,5,6,13,23,40,-17,21
Silkeborg IF,2987,10,5,4,13,26,45,-19,19
AGF Aarhus,2987,11,4,7,11,17,37,-20,19
Brondby,2988,1,21,6,3,69,31,38,69
FC Midtjylla,2988,2,20,6,4,65,38,27,66
FC Nords,2988,3,15,8,7,72,48,24,53
Copenhagen,2988,4,12,5,13,56,48,8,41
AaB,2988,5,8,11,11,39,43,-4,35
Sonderjyske,2988,6,8,6,10,28,29,-1,30
AC Horsens,2988,7,5,14,11,40,59,-19,29
Randers FC,2988,8,5,7,12,24,40,-16,22
Silkeborg IF,2988,9,6,3,13,27,44,-17,21
Lyngby,2988,10,3,10,11,27,45,-18,19
AGF Aarhus,2988,11,4,6,12,16,38,-22,18
Brondby,2989,1,21,6,3,70,31,39,69
FC Midtjylla,2989,2,19,5,6,64,41,23,62
Copenhagen,2989,3,14,6,10,57,45,12,48
FC Nords,2989,4,13,7,10,73,52,21,46
AaB,2989,5,8,13,9,39,42,-3,37
Sonderjyske,2989,6,8,6,10,28,29,-1,30
AC Horsens,2989,7,5,15,10,32,50,-18,30
Lyngby,2989,8,4,9,11,28,45,-17,21
Randers FC,2989,9,5,6,13,24,41,-17,21
Silkeborg IF,2989,10,5,4,13,26,45,-19,19
AGF Aarhus,2989,11,4,7,11,17,37,-20,19
Brondby,2990,1,22,5,3,76,33,43,71
FC Midtjylla,2990,2,19,6,5,67,44,23,63
FC Nords,2990,3,14,6,10,78,55,23,48
Copenhagen,2990,4,13,6,11,54,46,8,45
AaB,2990,5,7,13,10,40,48,-8,34
AC Horsens,2990,6,7,12,11,42,57,-15,33
Sonderjyske,2990,7,8,6,10,28,29,-1,30
Lyngby,2990,8,4,9,11,27,44,-17,21
Randers FC,2990,9,5,6,13,23,40,-17,21
Silkeborg IF,2990,10,6,3,13,27,45,-18,21
AGF Aarhus,2990,11,4,6,12,17,38,-21,18
FC Midtjylla,2991,1,20,5,5,65,37,28,65
Brondby,2991,2,19,6,5,66,33,33,63
FC Nords,2991,3,15,6,9,74,50,24,51
Copenhagen,2991,4,14,5,11,53,41,12,47
AaB,2991,5,8,11,11,36,43,-7,35
AC Horsens,2991,6,7,13,10,33,49,-16,34
Sonderjyske,2991,7,8,6,10,28,29,-1,30
Lyngby,2991,8,4,9,11,28,44,-16,21
Silkeborg IF,2991,9,6,3,13,28,46,-18,21
Randers FC,2991,10,5,6,13,23,41,-18,21
AGF Aarhus,2991,11,4,6,12,18,39,-21,18
Brondby,2992,1,20,7,3,67,32,35,67
FC Midtjylla,2992,2,20,6,4,67,36,31,66
FC Nords,2992,3,14,8,8,75,52,23,50
Copenhagen,2992,4,12,5,13,54,47,7,41
AC Horsens,2992,5,7,14,9,33,46,-13,35
AaB,2992,6,7,12,11,37,46,-9,33
Sonderjyske,2992,7,8,6,10,28,29,-1,30
Lyngby,2992,8,4,9,11,27,44,-17,21
Randers FC,2992,9,5,6,13,23,40,-17,21
Silkeborg IF,2992,10,6,3,13,26,44,-18,21
AGF Aarhus,2992,11,4,6,12,16,37,-21,18
Brondby,2993,1,21,5,4,73,34,39,68
FC Midtjylla,2993,2,19,6,5,65,38,27,63
Copenhagen,2993,3,14,7,9,57,39,18,49
FC Nords,2993,4,14,6,10,71,53,18,48
AaB,2993,5,7,13,10,36,43,-7,34
AC Horsens,2993,6,6,13,11,35,56,-21,31
Sonderjyske,2993,7,8,6,10,28,29,-1,30
Lyngby,2993,8,4,9,11,28,45,-17,21
Randers FC,2993,9,5,6,13,24,41,-17,21
Silkeborg IF,2993,10,5,4,13,26,45,-19,19
AGF Aarhus,2993,11,4,7,11,17,37,-20,19
Brondby,2994,1,20,5,5,69,35,34,65
FC Midtjylla,2994,2,19,5,6,66,42,24,62
Copenhagen,2994,3,16,5,9,65,42,23,53
FC Nords,2994,4,15,6,9,72,49,23,51
AC Horsens,2994,5,6,15,9,34,49,-15,33
Sonderjyske,2994,6,8,6,10,28,29,-1,30
AaB,2994,7,6,12,12,33,48,-15,30
Lyngby,2994,8,4,9,11,28,44,-16,21
Silkeborg IF,2994,9,6,3,13,27,44,-17,21
Randers FC,2994,10,5,6,13,23,41,-18,21
AGF Aarhus,2994,11,4,6,12,16,38,-22,18
Brondby,2995,1,20,5,5,65,34,31,65
FC Midtjylla,2995,2,19,5,6,67,41,26,62
Copenhagen,2995,3,16,4,10,57,41,16,52
FC Nords,2995,4,15,6,9,78,53,25,51
AaB,2995,5,7,12,11,36,45,-9,33
AC Horsens,2995,6,7,12,11,36,51,-15,33
Sonderjyske,2995,7,8,6,10,28,29,-1,30
Lyngby,2995,8,4,9,11,29,45,-16,21
Silkeborg IF,2995,9,6,3,13,28,45,-17,21
Randers FC,2995,10,5,6,13,24,42,-18,21
AGF Aarhus,2995,11,4,6,12,17,39,-22,18
Brondby,2996,1,20,7,3,70,33,37,67
FC Midtjylla,2996,2,18,5,7,64,43,21,59
FC Nords,2996,3,15,6,9,74,51,23,51
Copenhagen,2996,4,14,6,10,56,44,12,48
AaB,2996,5,8,12,10,38,40,-2,36
AC Horsens,2996,6,6,14,10,37,54,-17,32
Sonderjyske,2996,7,8,6,10,28,29,-1,30
Lyngby,2996,8,4,9,11,29,46,-17,21
Randers FC,2996,9,5,6,13,25,42,-17,21
AGF Aarhus,2996,10,5,6,11,18,36,-18,21
Silkeborg IF,2996,11,5,3,14,25,46,-21,18
Brondby,2997,1,19,8,3,70,35,35,65
FC Midtjylla,2997,2,19,5,6,65,40,25,62
Copenhagen,2997,3,16,4,10,57,41,16,52
FC Nords,2997,4,13,7,10,72,55,17,46
AC Horsens,2997,5,8,13,9,37,48,-11,37
AaB,2997,6,6,13,11,35,43,-8,31
Sonderjyske,2997,7,8,6,10,28,29,-1,30
Lyngby,2997,8,4,9,11,28,45,-17,21
Silkeborg IF,2997,8,6,3,13,28,45,-17,21
Randers FC,2997,10,5,6,13,24,41,-17,21
AGF Aarhus,2997,11,4,6,12,17,39,-22,18
Brondby,2998,1,21,6,3,71,35,36,69
FC Midtjylla,2998,2,19,5,6,65,39,26,62
Copenhagen,2998,3,15,4,11,59,46,13,49
FC Nords,2998,4,14,6,10,71,49,22,48
AaB,2998,5,8,11,11,38,43,-5,35
AC Horsens,2998,6,6,14,10,37,55,-18,32
Sonderjyske,2998,7,8,6,10,28,29,-1,30
Lyngby,2998,8,4,9,11,27,44,-17,21
Randers FC,2998,9,5,6,13,23,40,-17,21
Silkeborg IF,2998,10,6,3,13,27,45,-18,21
AGF Aarhus,2998,11,4,6,12,17,38,-21,18
Brondby,2999,1,20,6,4,73,33,40,66
FC Midtjylla,2999,2,19,6,5,65,42,23,63
Copenhagen,2999,3,15,4,11,62,46,16,49
FC Nords,2999,4,13,7,10,76,59,17,46
AaB,2999,5,7,15,8,38,40,-2,36
AC Horsens,2999,6,6,14,10,38,58,-20,32
Sonderjyske,2999,7,8,6,10,28,29,-1,30
Lyngby,2999,8,4,9,11,27,44,-17,21
Randers FC,2999,9,5,6,13,23,40,-17,21
Silkeborg IF,2999,10,6,3,13,26,44,-18,21
AGF Aarhus,2999,11,4,6,12,16,37,-21,18
Brondby,3000,1,21,6,3,70,33,37,69
FC Midtjylla,3000,2,20,4,6,72,42,30,64
FC Nords,3000,3,14,7,9,73,53,20,49
Copenhagen,3000,4,14,5,11,60,48,12,47
AaB,3000,5,7,12,11,35,42,-7,33
AC Horsens,3000,6,7,12,11,36,54,-18,33
Sonderjyske,3000,7,8,6,10,28,29,-1,30
Randers FC,3000,8,5,7,12,24,40,-16,22
Silkeborg IF,3000,9,6,3,13,26,44,-18,21
Lyngby,3000,10,3,10,11,27,45,-18,19
AGF Aarhus,3000,11,4,6,12,16,37,-21,18
Brondby,3001,1,21,5,4,76,36,40,68
FC Midtjylla,3001,2,21,4,5,66,38,28,67
Copenhagen,3001,3,14,4,12,57,48,9,46
FC Nords,3001,4,13,6,11,71,55,16,45
AC Horsens,3001,5,8,12,10,38,53,-15,36
AaB,3001,6,8,11,11,37,41,-4,35
Sonderjyske,3001,7,8,6,10,28,29,-1,30
Randers FC,3001,8,5,7,12,23,39,-16,22
Lyngby,3001,9,3,10,11,26,44,-18,19
Silkeborg IF,3001,10,5,4,13,26,45,-19,19
AGF Aarhus,3001,11,4,7,11,17,37,-20,19
Brondby,3002,1,21,7,2,70,30,40,70
FC Midtjylla,3002,2,19,7,4,66,36,30,64
FC Nords,3002,3,12,10,8,67,47,20,46
Copenhagen,3002,4,13,6,11,54,43,11,45
AaB,3002,5,7,12,11,34,45,-11,33
AC Horsens,3002,6,6,14,10,34,50,-16,32
Sonderjyske,3002,7,8,6,10,28,29,-1,30
Randers FC,3002,8,6,6,12,24,39,-15,24
AGF Aarhus,3002,9,5,6,11,19,37,-18,21
Lyngby,3002,10,3,9,12,26,45,-19,18
Silkeborg IF,3002,11,5,3,14,26,47,-21,18
Brondby,3003,1,20,6,4,67,36,31,66
FC Midtjylla,3003,2,20,6,4,68,38,30,66
FC Nords,3003,3,14,7,9,74,52,22,49
Copenhagen,3003,4,14,6,10,59,44,15,48
AaB,3003,5,7,14,9,39,40,-1,35
Sonderjyske,3003,6,8,6,10,28,29,-1,30
AC Horsens,3003,7,5,13,12,33,56,-23,28
Lyngby,3003,8,4,9,11,28,44,-16,21
Silkeborg IF,3003,9,6,3,13,28,45,-17,21
Randers FC,3003,10,5,6,13,23,41,-18,21
AGF Aarhus,3003,11,4,6,12,17,39,-22,18
FC Midtjylla,3004,1,22,4,4,71,35,36,70
Brondby,3004,2,19,5,6,67,36,31,62
Copenhagen,3004,3,16,4,10,60,42,18,52
FC Nords,3004,4,15,6,9,75,49,26,51
AaB,3004,5,8,11,11,38,49,-11,35
Sonderjyske,3004,6,8,6,10,28,29,-1,30
AC Horsens,3004,7,5,12,13,32,58,-26,27
Lyngby,3004,8,4,9,11,27,44,-17,21
Randers FC,3004,9,5,6,13,23,40,-17,21
Silkeborg IF,3004,10,5,4,13,27,46,-19,19
AGF Aarhus,3004,11,4,7,11,18,38,-20,19
Brondby,3005,1,21,6,3,67,29,38,69
FC Midtjylla,3005,2,19,5,6,64,42,22,62
FC Nords,3005,3,14,9,7,72,46,26,51
Copenhagen,3005,4,14,6,10,58,43,15,48
AaB,3005,5,7,13,10,39,44,-5,34
Sonderjyske,3005,6,8,6,10,28,29,-1,30
AC Horsens,3005,7,5,13,12,34,56,-22,28
Lyngby,3005,8,4,9,11,28,44,-16,21
Silkeborg IF,3005,9,6,3,13,26,44,-18,21
Randers FC,3005,10,5,6,13,23,41,-18,21
AGF Aarhus,3005,11,4,6,12,16,37,-21,18
Brondby,3006,1,22,5,3,75,31,44,71
FC Midtjylla,3006,2,18,6,6,64,42,22,60
Copenhagen,3006,3,17,4,9,61,42,19,55
FC Nords,3006,4,12,8,10,69,52,17,44
AaB,3006,5,7,13,10,34,38,-4,34
Sonderjyske,3006,6,8,6,10,28,29,-1,30
AC Horsens,3006,7,6,12,12,32,56,-24,30
Randers FC,3006,8,5,7,12,24,40,-16,22
AGF Aarhus,3006,9,5,6,11,20,37,-17,21
Lyngby,3006,10,3,10,11,27,45,-18,19
Silkeborg IF,3006,11,5,3,14,26,48,-22,18
Brondby,3007,1,21,5,4,72,35,37,68
FC Midtjylla,3007,2,20,5,5,67,39,28,65
FC Nords,3007,3,14,7,9,70,50,20,49
Copenhagen,3007,4,13,5,12,60,51,9,44
AaB,3007,5,8,12,10,39,44,-5,36
AC Horsens,3007,6,7,12,11,37,52,-15,33
Sonderjyske,3007,7,8,6,10,28,29,-1,30
Randers FC,3007,8,5,7,12,24,40,-16,22
Lyngby,3007,9,3,10,11,27,45,-18,19
Silkeborg IF,3007,10,5,4,13,26,45,-19,19
AGF Aarhus,3007,11,4,7,11,17,37,-20,19
Brondby,3008,1,23,5,2,73,28,45,74
FC Midtjylla,3008,2,20,5,5,64,38,26,65
Copenhagen,3008,3,15,4,11,59,40,19,49
FC Nords,3008,4,12,9,9,68,52,16,45
AC Horsens,3008,5,6,13,11,36,51,-15,31
Sonderjyske,3008,6,8,6,10,28,29,-1,30
AaB,3008,7,6,12,12,32,49,-17,30
Randers FC,3008,8,6,6,12,25,39,-14,24
Silkeborg IF,3008,9,6,3,13,28,44,-16,21
Lyngby,3008,10,3,9,12,26,46,-20,18
AGF Aarhus,3008,11,4,6,12,16,39,-23,18
FC Midtjylla,3009,1,21,4,5,63,35,28,67
Brondby,3009,2,19,6,5,66,36,30,63
FC Nords,3009,3,15,7,8,75,49,26,52
Copenhagen,3009,4,14,6,10,58,44,14,48
AC Horsens,3009,5,7,13,10,36,50,-14,34
Sonderjyske,3009,6,8,6,10,28,29,-1,30
AaB,3009,7,6,12,12,36,46,-10,30
Lyngby,3009,8,4,9,11,28,44,-16,21
Randers FC,3009,9,5,6,13,23,41,-18,21
AGF Aarhus,3009,10,5,6,11,19,37,-18,21
Silkeborg IF,3009,11,5,3,14,26,47,-21,18
FC Midtjylla,3010,1,21,4,5,71,37,34,67
Brondby,3010,2,19,6,5,70,37,33,63
FC Nords,3010,3,15,7,8,75,53,22,52
Copenhagen,3010,4,13,6,11,52,44,8,45
AC Horsens,3010,5,8,12,10,35,50,-15,36
AaB,3010,6,7,11,12,34,42,-8,32
Sonderjyske,3010,7,8,6,10,28,29,-1,30
Lyngby,3010,8,4,9,11,30,44,-14,21
Silkeborg IF,3010,9,6,3,13,26,44,-18,21
Randers FC,3010,10,5,6,13,23,43,-20,21
AGF Aarhus,3010,11,4,6,12,16,37,-21,18
Brondby,3011,1,21,6,3,70,32,38,69
FC Midtjylla,3011,2,18,5,7,66,48,18,59
FC Nords,3011,3,15,7,8,73,47,26,52
Copenhagen,3011,4,14,6,10,59,45,14,48
AC Horsens,3011,5,6,16,8,38,52,-14,34
Sonderjyske,3011,6,8,6,10,28,29,-1,30
AaB,3011,7,6,12,12,33,41,-8,30
Randers FC,3011,8,6,6,12,24,39,-15,24
Silkeborg IF,3011,9,5,4,13,25,44,-19,19
AGF Aarhus,3011,10,4,7,11,16,36,-20,19
Lyngby,3011,11,3,9,12,26,45,-19,18
Brondby,3012,1,20,7,3,72,33,39,67
FC Midtjylla,3012,2,20,6,4,62,35,27,66
FC Nords,3012,3,14,8,8,74,53,21,50
Copenhagen,3012,4,14,6,10,58,42,16,48
AaB,3012,5,6,14,10,38,44,-6,32
Sonderjyske,3012,6,8,6,10,28,29,-1,30
AC Horsens,3012,7,5,13,12,31,54,-23,28
Lyngby,3012,8,4,9,11,29,44,-15,21
Silkeborg IF,3012,9,6,3,13,26,44,-18,21
Randers FC,3012,10,5,6,13,23,42,-19,21
AGF Aarhus,3012,11,4,6,12,16,37,-21,18
Brondby,3013,1,23,5,2,75,30,45,74
FC Midtjylla,3013,2,19,5,6,66,42,24,62
FC Nords,3013,3,15,7,8,73,48,25,52
Copenhagen,3013,4,14,5,11,57,44,13,47
Sonderjyske,3013,5,8,6,10,28,29,-1,30
AaB,3013,6,6,12,12,36,49,-13,30
AC Horsens,3013,7,6,12,12,35,55,-20,30
Lyngby,3013,8,4,9,11,28,45,-17,21
Randers FC,3013,9,5,6,13,24,41,-17,21
Silkeborg IF,3013,10,6,3,13,27,45,-18,21
AGF Aarhus,3013,11,4,6,12,17,38,-21,18
Brondby,3014,1,20,7,3,70,35,35,67
FC Midtjylla,3014,2,19,6,5,66,39,27,63
FC Nords,3014,3,15,7,8,77,51,26,52
Copenhagen,3014,4,13,4,13,56,49,7,43
AaB,3014,5,8,12,10,38,41,-3,36
AC Horsens,3014,6,6,14,10,33,51,-18,32
Sonderjyske,3014,7,8,6,10,28,29,-1,30
Randers FC,3014,8,6,6,12,25,39,-14,24
AGF Aarhus,3014,9,5,6,11,18,36,-18,21
Lyngby,3014,10,3,9,12,26,46,-20,18
Silkeborg IF,3014,11,5,3,14,25,46,-21,18
Brondby,3015,1,22,6,2,73,30,43,72
FC Midtjylla,3015,2,18,5,7,64,41,23,59
FC Nords,3015,3,14,7,9,72,46,26,49
Copenhagen,3015,4,14,5,11,56,46,10,47
AaB,3015,5,7,12,11,36,47,-11,33
AC Horsens,3015,6,6,15,9,32,49,-17,33
Sonderjyske,3015,7,8,6,10,28,29,-1,30
Lyngby,3015,8,4,9,11,28,45,-17,21
Randers FC,3015,9,5,6,13,24,41,-17,21
AGF Aarhus,3015,10,5,6,11,17,36,-19,21
Silkeborg IF,3015,11,5,3,14,25,45,-20,18
Brondby,3016,1,21,7,2,78,35,43,70
FC Midtjylla,3016,2,20,5,5,67,40,27,65
FC Nords,3016,3,14,6,10,78,54,24,48
Copenhagen,3016,4,13,7,10,57,45,12,46
AaB,3016,5,7,13,10,38,47,-9,34
Sonderjyske,3016,6,8,6,10,28,29,-1,30
AC Horsens,3016,7,5,14,11,30,53,-23,29
Randers FC,3016,8,6,6,12,24,39,-15,24
Silkeborg IF,3016,9,5,4,13,27,46,-19,19
AGF Aarhus,3016,10,4,7,11,18,38,-20,19
Lyngby,3016,11,3,9,12,26,45,-19,18
Brondby,3017,1,22,6,2,76,34,42,72
FC Midtjylla,3017,2,18,6,6,64,43,21,60
FC Nords,3017,3,15,6,9,78,55,23,51
Copenhagen,3017,4,14,6,10,60,46,14,48
AaB,3017,5,6,14,10,36,43,-7,32
Sonderjyske,3017,6,8,6,10,28,29,-1,30
AC Horsens,3017,7,5,14,11,36,55,-19,29
Randers FC,3017,8,5,7,12,25,41,-16,22
AGF Aarhus,3017,9,5,6,11,19,38,-19,21
Lyngby,3017,10,3,10,11,28,46,-18,19
Silkeborg IF,3017,11,5,3,14,27,47,-20,18
FC Midtjylla,3018,1,20,5,5,64,39,25,65
Brondby,3018,2,19,6,5,67,35,32,63
FC Nords,3018,3,15,7,8,72,49,23,52
Copenhagen,3018,4,15,4,11,59,42,17,49
AC Horsens,3018,5,8,13,9,38,50,-12,37
Sonderjyske,3018,6,8,6,10,28,29,-1,30
AaB,3018,7,6,11,13,36,47,-11,29
Randers FC,3018,8,5,7,12,24,40,-16,22
AGF Aarhus,3018,9,5,6,11,17,36,-19,21
Lyngby,3018,10,3,10,11,27,45,-18,19
Silkeborg IF,3018,11,5,3,14,25,45,-20,18
Brondby,3019,1,21,5,4,72,34,38,68
FC Midtjylla,3019,2,19,5,6,63,40,23,62
FC Nords,3019,3,15,6,9,74,50,24,51
Copenhagen,3019,4,13,6,11,56,44,12,45
AaB,3019,5,8,12,10,36,42,-6,36
AC Horsens,3019,6,6,14,10,37,54,-17,32
Sonderjyske,3019,7,8,6,10,28,29,-1,30
Lyngby,3019,8,4,9,11,28,45,-17,21
Randers FC,3019,9,5,6,13,24,41,-17,21
Silkeborg IF,3019,10,5,4,13,27,46,-19,19
AGF Aarhus,3019,11,4,7,11,18,38,-20,19
Brondby,3020,1,20,6,4,66,30,36,66
FC Midtjylla,3020,2,20,5,5,69,39,30,65
FC Nords,3020,3,15,6,9,76,50,26,51
Copenhagen,3020,4,12,5,13,55,56,-1,41
AaB,3020,5,8,12,10,41,42,-1,36
AC Horsens,3020,6,8,12,10,39,55,-16,36
Sonderjyske,3020,7,8,6,10,28,29,-1,30
Randers FC,3020,8,6,6,12,25,39,-14,24
Silkeborg IF,3020,9,6,3,13,28,44,-16,21
Lyngby,3020,10,3,9,12,26,46,-20,18
AGF Aarhus,3020,11,4,6,12,16,39,-23,18
FC Midtjylla,3021,1,21,5,4,65,37,28,68
Brondby,3021,2,18,6,6,69,39,30,60
FC Nords,3021,3,15,8,7,79,51,28,53
Copenhagen,3021,4,13,4,13,56,50,6,43
AC Horsens,3021,5,8,12,10,41,51,-10,36
AaB,3021,6,7,13,10,38,46,-8,34
Sonderjyske,3021,7,8,6,10,28,29,-1,30
Lyngby,3021,8,4,9,11,29,44,-15,21
Randers FC,3021,9,5,6,13,23,42,-19,21
Silkeborg IF,3021,10,5,4,13,25,44,-19,19
AGF Aarhus,3021,11,4,7,11,16,36,-20,19
Brondby,3022,1,21,7,2,69,28,41,70
FC Midtjylla,3022,2,17,5,8,58,41,17,56
FC Nords,3022,3,15,7,8,72,46,26,52
Copenhagen,3022,4,14,6,10,55,41,14,48
AaB,3022,5,9,12,9,37,38,-1,39
Sonderjyske,3022,6,8,6,10,28,29,-1,30
AC Horsens,3022,7,5,13,12,31,54,-23,28
Randers FC,3022,8,6,6,12,25,40,-15,24
Silkeborg IF,3022,9,6,3,13,27,45,-18,21
Lyngby,3022,10,3,9,12,27,46,-19,18
AGF Aarhus,3022,11,4,6,12,17,38,-21,18
Brondby,3023,1,21,7,2,72,32,40,70
FC Midtjylla,3023,2,20,5,5,67,40,27,65
FC Nords,3023,3,12,7,11,67,53,14,43
Copenhagen,3023,4,12,6,12,57,48,9,42
AaB,3023,5,8,13,9,39,40,-1,37
AC Horsens,3023,6,8,12,10,36,51,-15,36
Sonderjyske,3023,7,8,6,10,28,29,-1,30
Randers FC,3023,8,6,6,12,25,39,-14,24
AGF Aarhus,3023,9,5,6,11,19,37,-18,21
Lyngby,3023,10,3,9,12,26,46,-20,18
Silkeborg IF,3023,11,5,3,14,26,47,-21,18
Brondby,3024,1,18,7,5,67,36,31,61
FC Midtjylla,3024,2,19,4,7,68,45,23,61
FC Nords,3024,3,15,7,8,73,47,26,52
Copenhagen,3024,4,14,6,10,59,44,15,48
AaB,3024,5,9,13,8,42,43,-1,40
AC Horsens,3024,6,6,13,11,35,55,-20,31
Sonderjyske,3024,7,8,6,10,28,29,-1,30
Randers FC,3024,8,5,7,12,24,40,-16,22
Lyngby,3024,9,3,10,11,27,45,-18,19
Silkeborg IF,3024,10,5,4,13,27,46,-19,19
AGF Aarhus,3024,11,4,7,11,18,38,-20,19
FC Midtjylla,3025,1,22,4,4,70,36,34,70
Brondby,3025,2,20,7,3,69,31,38,67
FC Nords,3025,3,13,7,10,72,54,18,46
Copenhagen,3025,4,12,7,11,57,47,10,43
AC Horsens,3025,5,7,13,10,33,51,-18,34
AaB,3025,6,7,12,11,37,45,-8,33
Sonderjyske,3025,7,8,6,10,28,29,-1,30
Lyngby,3025,8,4,9,11,27,44,-17,21
Randers FC,3025,9,5,6,13,23,40,-17,21
AGF Aarhus,3025,10,5,6,11,17,36,-19,21
Silkeborg IF,3025,11,5,3,14,25,45,-20,18
Brondby,3026,1,22,6,2,77,32,45,72
FC Midtjylla,3026,2,20,4,6,67,38,29,64
FC Nords,3026,3,14,8,8,73,52,21,50
Copenhagen,3026,4,12,8,10,56,45,11,44
AaB,3026,5,6,13,11,34,46,-12,31
AC Horsens,3026,6,6,13,11,36,56,-20,31
Sonderjyske,3026,7,8,6,10,28,29,-1,30
Lyngby,3026,8,4,9,11,30,45,-15,21
Randers FC,3026,9,5,6,13,24,43,-19,21
Silkeborg IF,3026,10,5,4,13,26,45,-19,19
AGF Aarhus,3026,11,4,7,11,17,37,-20,19
Brondby,3027,1,22,5,3,76,33,43,71
FC Midtjylla,3027,2,19,4,7,68,44,24,61
FC Nords,3027,3,14,7,9,74,53,21,49
Copenhagen,3027,4,14,5,11,60,47,13,47
AC Horsens,3027,5,7,14,9,39,53,-14,35
AaB,3027,6,6,13,11,36,49,-13,31
Sonderjyske,3027,7,8,6,10,28,29,-1,30
Randers FC,3027,8,6,6,12,24,39,-15,24
Silkeborg IF,3027,9,6,3,13,27,45,-18,21
Lyngby,3027,10,3,9,12,26,45,-19,18
AGF Aarhus,3027,11,4,6,12,17,38,-21,18
Brondby,3028,1,21,6,3,73,33,40,69
FC Midtjylla,3028,2,21,4,5,68,35,33,67
FC Nords,3028,3,14,7,9,74,57,17,49
Copenhagen,3028,4,13,6,11,56,46,10,45
AaB,3028,5,8,11,11,36,43,-7,35
Sonderjyske,3028,6,8,6,10,28,29,-1,30
AC Horsens,3028,7,5,14,11,33,52,-19,29
Lyngby,3028,8,4,9,11,29,45,-16,21
Randers FC,3028,9,5,6,13,24,42,-18,21
AGF Aarhus,3028,10,5,6,11,18,37,-19,21
Silkeborg IF,3028,11,5,3,14,26,46,-20,18
Brondby,3029,1,22,6,2,77,34,43,72
FC Midtjylla,3029,2,19,5,6,68,45,23,62
FC Nords,3029,3,15,6,9,73,49,24,51
Copenhagen,3029,4,14,4,12,59,45,14,46
AC Horsens,3029,5,7,12,11,34,57,-23,33
AaB,3029,6,7,11,12,33,40,-7,32
Sonderjyske,3029,7,8,6,10,28,29,-1,30
Lyngby,3029,8,4,9,11,27,44,-17,21
Randers FC,3029,9,5,6,13,23,40,-17,21
Silkeborg IF,3029,10,6,3,13,26,44,-18,21
AGF Aarhus,3029,11,4,6,12,16,37,-21,18
Brondby,3030,1,20,7,3,71,32,39,67
FC Midtjylla,3030,2,20,4,6,67,42,25,64
FC Nords,3030,3,15,7,8,72,51,21,52
Copenhagen,3030,4,14,5,11,55,42,13,47
AaB,3030,5,8,11,11,36,40,-4,35
Sonderjyske,3030,6,8,6,10,28,29,-1,30
AC Horsens,3030,7,6,12,12,31,51,-20,30
Lyngby,3030,8,4,9,11,27,44,-17,21
Silkeborg IF,3030,8,6,3,13,27,44,-17,21
Randers FC,3030,10,5,6,13,23,40,-17,21
AGF Aarhus,3030,11,4,6,12,16,38,-22,18
Brondby,3031,1,20,6,4,71,37,34,66
FC Midtjylla,3031,2,18,5,7,64,40,24,59
FC Nords,3031,3,15,7,8,73,50,23,52
Copenhagen,3031,4,14,6,10,61,43,18,48
AaB,3031,5,8,12,10,40,47,-7,36
AC Horsens,3031,6,7,12,11,35,53,-18,33
Sonderjyske,3031,7,8,6,10,28,29,-1,30
Randers FC,3031,8,5,7,12,26,42,-16,22
Lyngby,3031,9,3,10,11,29,47,-18,19
Silkeborg IF,3031,10,5,4,13,27,46,-19,19
AGF Aarhus,3031,11,4,7,11,18,38,-20,19
Brondby,3032,1,21,5,4,72,35,37,68
FC Midtjylla,3032,2,20,4,6,67,40,27,64
FC Nords,3032,3,16,6,8,78,47,31,54
Copenhagen,3032,4,15,4,11,58,45,13,49
AaB,3032,5,7,11,12,35,45,-10,32
Sonderjyske,3032,6,8,6,10,28,29,-1,30
AC Horsens,3032,7,6,12,12,32,56,-24,30
Lyngby,3032,8,4,9,11,29,46,-17,21
Randers FC,3032,9,5,6,13,25,42,-17,21
Silkeborg IF,3032,10,6,3,13,26,44,-18,21
AGF Aarhus,3032,11,4,6,12,16,37,-21,18
Brondby,3033,1,21,6,3,73,34,39,69
FC Midtjylla,3033,2,20,5,5,67,38,29,65
FC Nords,3033,3,14,8,8,76,52,24,50
Copenhagen,3033,4,13,7,10,58,44,14,46
AaB,3033,5,7,12,11,34,44,-10,33
Sonderjyske,3033,6,8,6,10,28,29,-1,30
AC Horsens,3033,7,6,12,12,33,55,-22,30
Randers FC,3033,8,5,7,12,25,41,-16,22
AGF Aarhus,3033,9,5,6,11,18,37,-19,21
Lyngby,3033,10,3,10,11,28,46,-18,19
Silkeborg IF,3033,11,5,3,14,26,46,-20,18
Brondby,3034,1,20,7,3,67,32,35,67
FC Midtjylla,3034,2,20,5,5,63,34,29,65
FC Nords,3034,3,14,8,8,71,51,20,50
Copenhagen,3034,4,14,5,11,55,42,13,47
AaB,3034,5,7,12,11,35,41,-6,33
Sonderjyske,3034,6,8,6,10,28,29,-1,30
AC Horsens,3034,7,5,15,10,33,50,-17,30
Randers FC,3034,8,6,6,12,24,39,-15,24
Silkeborg IF,3034,9,6,3,13,27,44,-17,21
Lyngby,3034,10,3,9,12,26,45,-19,18
AGF Aarhus,3034,11,4,6,12,16,38,-22,18
Brondby,3035,1,21,6,3,70,31,39,69
FC Midtjylla,3035,2,19,4,7,62,38,24,61
Copenhagen,3035,3,15,5,10,57,45,12,50
FC Nords,3035,4,14,7,9,74,52,22,49
AaB,3035,5,8,12,10,40,43,-3,36
Sonderjyske,3035,6,8,6,10,28,29,-1,30
AC Horsens,3035,7,6,12,12,34,54,-20,30
Randers FC,3035,8,6,6,12,24,39,-15,24
AGF Aarhus,3035,9,5,6,11,18,36,-18,21
Lyngby,3035,10,3,9,12,26,45,-19,18
Silkeborg IF,3035,11,5,3,14,25,46,-21,18
Brondby,3036,1,21,7,2,72,30,42,70
FC Midtjylla,3036,2,18,6,6,63,40,23,60
Copenhagen,3036,3,14,7,9,55,40,15,49
FC Nords,3036,4,13,9,8,74,52,22,48
AC Horsens,3036,5,6,15,9,37,53,-16,33
Sonderjyske,3036,6,8,6,10,28,29,-1,30
AaB,3036,7,6,12,12,35,47,-12,30
Randers FC,3036,8,5,7,12,23,39,-16,22
Lyngby,3036,9,3,10,11,26,44,-18,19
Silkeborg IF,3036,10,5,4,13,25,44,-19,19
AGF Aarhus,3036,11,4,7,11,16,36,-20,19
Brondby,3037,1,21,6,3,73,34,39,69
FC Midtjylla,3037,2,19,4,7,65,43,22,61
FC Nords,3037,3,13,7,10,69,51,18,46
Copenhagen,3037,4,14,4,12,57,45,12,46
AaB,3037,5,10,11,9,41,41,0,41
AC Horsens,3037,6,7,12,11,36,53,-17,33
Sonderjyske,3037,7,8,6,10,28,29,-1,30
Randers FC,3037,8,5,7,12,23,39,-16,22
Silkeborg IF,3037,9,6,3,13,27,44,-17,21
Lyngby,3037,10,3,10,11,26,44,-18,19
AGF Aarhus,3037,11,4,6,12,16,38,-22,18
Brondby,3038,1,20,5,5,70,34,36,65
FC Midtjylla,3038,2,19,6,5,62,36,26,63
FC Nords,3038,3,16,6,8,78,48,30,54
Copenhagen,3038,4,14,5,11,61,53,8,47
AaB,3038,5,9,12,9,39,38,1,39
Sonderjyske,3038,6,8,6,10,28,29,-1,30
AC Horsens,3038,7,5,12,13,29,56,-27,27
Lyngby,3038,8,4,9,11,28,45,-17,21
Randers FC,3038,9,5,6,13,24,41,-17,21
Silkeborg IF,3038,10,5,4,13,25,44,-19,19
AGF Aarhus,3038,11,4,7,11,16,36,-20,19
FC Midtjylla,3039,1,20,5,5,66,38,28,65
Brondby,3039,2,19,6,5,66,35,31,63
Copenhagen,3039,3,14,7,9,58,40,18,49
FC Nords,3039,4,13,8,9,71,51,20,47
AaB,3039,5,7,13,10,34,39,-5,34
AC Horsens,3039,6,7,13,10,34,52,-18,34
Sonderjyske,3039,7,8,6,10,28,29,-1,30
Randers FC,3039,8,5,7,12,25,41,-16,22
Silkeborg IF,3039,9,6,3,13,28,46,-18,21
Lyngby,3039,10,3,10,11,28,46,-18,19
AGF Aarhus,3039,11,4,6,12,18,39,-21,18
Brondby,3040,1,20,7,3,72,32,40,67
FC Midtjylla,3040,2,20,5,5,65,37,28,65
FC Nords,3040,3,14,7,9,75,58,17,49
Copenhagen,3040,4,13,7,10,57,45,12,46
AaB,3040,5,8,11,11,39,43,-4,35
Sonderjyske,3040,6,8,6,10,28,29,-1,30
AC Horsens,3040,7,5,15,10,34,53,-19,30
Silkeborg IF,3040,8,6,3,13,29,44,-15,21
Lyngby,3040,9,4,9,11,27,44,-17,21
Randers FC,3040,10,5,6,13,23,40,-17,21
AGF Aarhus,3040,11,4,6,12,16,40,-24,18
Brondby,3041,1,21,7,2,74,33,41,70
FC Midtjylla,3041,2,19,5,6,65,39,26,62
FC Nords,3041,3,14,8,8,76,56,20,50
Copenhagen,3041,4,13,6,11,56,44,12,45
AaB,3041,5,8,11,11,38,45,-7,35
Sonderjyske,3041,6,8,6,10,28,29,-1,30
AC Horsens,3041,7,5,15,10,36,54,-18,30
Lyngby,3041,8,4,9,11,29,45,-16,21
AGF Aarhus,3041,9,5,6,11,20,37,-17,21
Randers FC,3041,10,5,6,13,24,42,-18,21
Silkeborg IF,3041,11,5,3,14,26,48,-22,18
Brondby,3042,1,20,6,4,71,35,36,66
FC Midtjylla,3042,2,20,4,6,63,38,25,64
Copenhagen,3042,3,15,4,11,59,46,13,49
FC Nords,3042,4,13,7,10,77,56,21,46
AaB,3042,5,9,11,10,38,40,-2,38
AC Horsens,3042,6,7,12,11,35,54,-19,33
Sonderjyske,3042,7,8,6,10,28,29,-1,30
Randers FC,3042,8,6,6,12,26,39,-13,24
AGF Aarhus,3042,9,5,6,11,19,37,-18,21
Lyngby,3042,10,3,9,12,26,47,-21,18
Silkeborg IF,3042,10,5,3,14,26,47,-21,18
Brondby,3043,1,21,7,2,75,28,47,70
FC Midtjylla,3043,2,21,4,5,68,37,31,67
FC Nords,3043,3,13,7,10,69,55,14,46
Copenhagen,3043,4,13,5,12,52,45,7,44
AaB,3043,5,8,12,10,39,46,-7,36
Sonderjyske,3043,6,8,6,10,28,29,-1,30
AC Horsens,3043,7,5,15,10,32,50,-18,30
Randers FC,3043,8,5,7,12,23,39,-16,22
AGF Aarhus,3043,9,5,6,11,18,37,-19,21
Lyngby,3043,10,3,10,11,26,44,-18,19
Silkeborg IF,3043,11,5,3,14,26,46,-20,18
Brondby,3044,1,20,7,3,71,36,35,67
FC Midtjylla,3044,2,18,7,5,67,39,28,61
FC Nords,3044,3,14,8,8,72,50,22,50
Copenhagen,3044,4,13,5,12,56,48,8,44
AC Horsens,3044,5,8,12,10,40,54,-14,36
AaB,3044,6,7,13,10,38,43,-5,34
Sonderjyske,3044,7,8,6,10,28,29,-1,30
Randers FC,3044,8,6,6,12,25,39,-14,24
AGF Aarhus,3044,9,5,6,11,17,36,-19,21
Lyngby,3044,10,3,9,12,26,46,-20,18
Silkeborg IF,3044,11,5,3,14,25,45,-20,18
Brondby,3045,1,20,7,3,70,34,36,67
FC Midtjylla,3045,2,19,4,7,62,38,24,61
Copenhagen,3045,3,14,7,9,62,44,18,49
FC Nords,3045,4,13,7,10,69,53,16,46
AaB,3045,5,8,13,9,37,41,-4,37
AC Horsens,3045,6,6,14,10,35,51,-16,32
Sonderjyske,3045,7,8,6,10,28,29,-1,30
Lyngby,3045,8,4,9,11,27,44,-17,21
Randers FC,3045,9,5,6,13,23,40,-17,21
AGF Aarhus,3045,10,5,6,11,19,37,-18,21
Silkeborg IF,3045,11,5,3,14,26,47,-21,18
Brondby,3046,1,21,6,3,74,32,42,69
FC Midtjylla,3046,2,18,4,8,63,47,16,58
FC Nords,3046,3,13,7,10,70,52,18,46
Copenhagen,3046,4,14,4,12,58,43,15,46
AC Horsens,3046,5,9,12,9,41,51,-10,39
AaB,3046,6,9,11,10,38,45,-7,38
Sonderjyske,3046,7,8,6,10,28,29,-1,30
Lyngby,3046,8,4,9,11,29,44,-15,21
Randers FC,3046,9,5,6,13,23,42,-19,21
Silkeborg IF,3046,10,5,4,13,25,44,-19,19
AGF Aarhus,3046,11,4,7,11,16,36,-20,19
Brondby,3047,1,21,7,2,70,31,39,70
FC Midtjylla,3047,2,18,5,7,66,44,22,59
FC Nords,3047,3,15,6,9,79,53,26,51
Copenhagen,3047,4,14,4,12,61,48,13,46
AaB,3047,5,8,13,9,34,40,-6,37
AC Horsens,3047,6,6,13,11,35,55,-20,31
Sonderjyske,3047,7,8,6,10,28,29,-1,30
Lyngby,3047,8,4,9,11,27,44,-17,21
Randers FC,3047,9,5,6,13,23,40,-17,21
AGF Aarhus,3047,10,5,6,11,20,37,-17,21
Silkeborg IF,3047,11,5,3,14,26,48,-22,18
Brondby,3048,1,21,6,3,69,32,37,69
FC Midtjylla,3048,2,20,5,5,69,42,27,65
Copenhagen,3048,3,15,6,9,64,43,21,51
FC Nords,3048,4,13,6,11,73,58,15,45
AaB,3048,5,7,12,11,39,43,-4,33
AC Horsens,3048,6,6,13,11,35,57,-22,31
Sonderjyske,3048,7,8,6,10,28,29,-1,30
Randers FC,3048,8,5,7,12,24,40,-16,22
Silkeborg IF,3048,9,6,3,13,27,45,-18,21
Lyngby,3048,10,3,10,11,27,45,-18,19
AGF Aarhus,3048,11,4,6,12,17,38,-21,18
Brondby,3049,1,21,6,3,72,32,40,69
FC Midtjylla,3049,2,20,6,4,67,36,31,66
FC Nords,3049,3,14,7,9,78,54,24,49
Copenhagen,3049,4,14,5,11,59,43,16,47
AaB,3049,5,7,12,11,35,48,-13,33
Sonderjyske,3049,6,8,6,10,28,29,-1,30
AC Horsens,3049,7,6,12,12,33,57,-24,30
Silkeborg IF,3049,8,6,3,13,30,44,-14,21
Lyngby,3049,9,4,9,11,29,44,-15,21
Randers FC,3049,10,5,6,13,23,42,-19,21
AGF Aarhus,3049,11,4,6,12,16,41,-25,18
Brondby,3050,1,20,5,5,68,38,30,65
FC Midtjylla,3050,2,19,5,6,64,41,23,62
FC Nords,3050,3,15,7,8,71,46,25,52
Copenhagen,3050,4,15,4,11,63,43,20,49
AaB,3050,5,8,13,9,37,41,-4,37
Sonderjyske,3050,6,8,6,10,28,29,-1,30
AC Horsens,3050,7,5,14,11,33,53,-20,29
Silkeborg IF,3050,8,6,3,13,29,45,-16,21
Lyngby,3050,9,4,9,11,28,44,-16,21
Randers FC,3050,10,5,6,13,23,41,-18,21
AGF Aarhus,3050,11,4,6,12,17,40,-23,18
Brondby,3051,1,23,5,2,75,29,46,74
FC Midtjylla,3051,2,18,5,7,67,48,19,59
FC Nords,3051,3,14,8,8,76,51,25,50
Copenhagen,3051,4,14,5,11,63,46,17,47
AaB,3051,5,7,13,10,38,49,-11,34
Sonderjyske,3051,6,8,6,10,28,29,-1,30
AC Horsens,3051,7,5,14,11,34,56,-22,29
Lyngby,3051,8,4,9,11,28,45,-17,21
Silkeborg IF,3051,9,6,3,13,27,44,-17,21
Randers FC,3051,10,5,6,13,24,41,-17,21
AGF Aarhus,3051,11,4,6,12,16,38,-22,18
Brondby,3052,1,20,7,3,69,31,38,67
FC Midtjylla,3052,2,17,7,6,61,41,20,58
FC Nords,3052,3,13,9,8,70,49,21,48
Copenhagen,3052,4,13,6,11,55,41,14,45
AaB,3052,5,8,12,10,37,43,-6,36
AC Horsens,3052,6,7,15,8,35,48,-13,36
Sonderjyske,3052,7,8,6,10,28,29,-1,30
Randers FC,3052,8,5,7,12,26,42,-16,22
AGF Aarhus,3052,9,5,6,11,17,36,-19,21
Lyngby,3052,10,3,10,11,29,47,-18,19
Silkeborg IF,3052,11,5,3,14,25,45,-20,18
FC Midtjylla,3053,1,21,4,5,67,41,26,67
Brondby,3053,2,20,5,5,68,36,32,65
FC Nords,3053,3,16,7,7,82,50,32,55
Copenhagen,3053,4,12,5,13,55,46,9,41
AC Horsens,3053,5,8,12,10,38,54,-16,36
AaB,3053,6,7,11,12,36,45,-9,32
Sonderjyske,3053,7,8,6,10,28,29,-1,30
Randers FC,3053,8,5,7,12,24,40,-16,22
Silkeborg IF,3053,9,6,3,13,29,44,-15,21
Lyngby,3053,10,3,10,11,27,45,-18,19
AGF Aarhus,3053,11,4,6,12,16,40,-24,18
Brondby,3054,1,21,5,4,71,33,38,68
FC Midtjylla,3054,2,18,5,7,61,40,21,59
FC Nords,3054,3,15,6,9,77,52,25,51
Copenhagen,3054,4,13,7,10,57,43,14,46
AaB,3054,5,8,12,10,36,42,-6,36
AC Horsens,3054,6,7,13,10,34,52,-18,34
Sonderjyske,3054,7,8,6,10,28,29,-1,30
Randers FC,3054,8,5,7,12,24,40,-16,22
Lyngby,3054,9,3,10,11,27,45,-18,19
Silkeborg IF,3054,10,5,4,13,25,44,-19,19
AGF Aarhus,3054,11,4,7,11,16,36,-20,19
Brondby,3055,1,21,5,4,70,36,34,68
FC Midtjylla,3055,2,21,4,5,66,37,29,67
FC Nords,3055,3,14,7,9,74,50,24,49
Copenhagen,3055,4,13,4,13,54,44,10,43
AaB,3055,5,8,12,10,35,39,-4,36
AC Horsens,3055,6,7,12,11,35,54,-19,33
Sonderjyske,3055,7,8,6,10,28,29,-1,30
Randers FC,3055,8,6,6,12,25,40,-15,24
Silkeborg IF,3055,9,5,4,13,26,45,-19,19
AGF Aarhus,3055,10,4,7,11,17,37,-20,19
Lyngby,3055,11,3,9,12,27,46,-19,18
FC Midtjylla,3056,1,21,4,5,71,41,30,67
Brondby,3056,2,19,7,4,72,36,36,64
FC Nords,3056,3,14,7,9,74,54,20,49
Copenhagen,3056,4,14,6,10,60,46,14,48
AaB,3056,5,7,13,10,36,40,-4,34
AC Horsens,3056,6,6,13,11,33,55,-22,31
Sonderjyske,3056,7,8,6,10,28,29,-1,30
Lyngby,3056,8,4,9,11,31,46,-15,21
AGF Aarhus,3056,9,5,6,11,19,37,-18,21
Randers FC,3056,10,5,6,13,25,44,-19,21
Silkeborg IF,3056,11,5,3,14,26,47,-21,18
Brondby,3057,1,19,5,6,67,32,35,62
FC Midtjylla,3057,2,19,5,6,64,41,23,62
FC Nords,3057,3,15,7,8,75,49,26,52
Copenhagen,3057,4,15,4,11,57,43,14,49
AaB,3057,5,9,12,9,39,43,-4,39
AC Horsens,3057,6,6,13,11,31,51,-20,31
Sonderjyske,3057,7,8,6,10,28,29,-1,30
Lyngby,3057,8,4,9,11,28,45,-17,21
Silkeborg IF,3057,9,6,3,13,27,44,-17,21
Randers FC,3057,10,5,6,13,24,41,-17,21
AGF Aarhus,3057,11,4,6,12,16,38,-22,18
Brondby,3058,1,19,8,3,68,32,36,65
FC Midtjylla,3058,2,18,5,7,62,40,22,59
Copenhagen,3058,3,16,5,9,60,41,19,53
FC Nords,3058,4,13,8,9,68,49,19,47
AaB,3058,5,9,13,8,38,37,1,40
Sonderjyske,3058,6,8,6,10,28,29,-1,30
AC Horsens,3058,7,5,13,12,31,54,-23,28
Randers FC,3058,8,5,7,12,23,39,-16,22
Lyngby,3058,9,3,10,11,26,44,-18,19
Silkeborg IF,3058,10,5,4,13,26,45,-19,19
AGF Aarhus,3058,11,4,7,11,17,37,-20,19
Brondby,3059,1,21,6,3,72,35,37,69
FC Midtjylla,3059,2,19,5,6,67,38,29,62
FC Nords,3059,3,13,7,10,73,56,17,46
Copenhagen,3059,4,13,6,11,60,48,12,45
AaB,3059,5,8,12,10,39,45,-6,36
AC Horsens,3059,6,7,14,9,33,48,-15,35
Sonderjyske,3059,7,8,6,10,28,29,-1,30
Lyngby,3059,8,4,9,11,27,44,-17,21
Randers FC,3059,9,5,6,13,23,40,-17,21
Silkeborg IF,3059,10,5,4,13,26,45,-19,19
AGF Aarhus,3059,11,4,7,11,17,37,-20,19
Brondby,3060,1,23,5,2,79,32,47,74
FC Midtjylla,3060,2,19,6,5,68,44,24,63
FC Nords,3060,3,14,8,8,78,54,24,50
Copenhagen,3060,4,12,5,13,56,50,6,41
AaB,3060,5,7,12,11,39,48,-9,33
AC Horsens,3060,6,7,12,11,36,54,-18,33
Sonderjyske,3060,7,8,6,10,28,29,-1,30
Lyngby,3060,8,4,9,11,28,44,-16,21
Silkeborg IF,3060,9,6,3,13,28,46,-18,21
Randers FC,3060,10,5,6,13,23,41,-18,21
AGF Aarhus,3060,11,4,6,12,18,39,-21,18
Brondby,3061,1,21,6,3,70,32,38,69
FC Midtjylla,3061,2,19,6,5,70,40,30,63
FC Nords,3061,3,15,6,9,80,54,26,51
Copenhagen,3061,4,14,4,12,54,44,10,46
AC Horsens,3061,5,8,12,10,41,59,-18,36
Sonderjyske,3061,6,8,6,10,28,29,-1,30
AaB,3061,7,6,12,12,35,47,-12,30
Randers FC,3061,8,6,6,12,24,39,-15,24
Silkeborg IF,3061,9,6,3,13,26,44,-18,21
Lyngby,3061,10,3,9,12,26,45,-19,18
AGF Aarhus,3061,11,4,6,12,16,37,-21,18
Brondby,3062,1,21,6,3,70,28,42,69
FC Midtjylla,3062,2,20,5,5,70,39,31,65
Copenhagen,3062,3,15,6,9,61,43,18,51
FC Nords,3062,4,13,8,9,73,57,16,47
AaB,3062,5,7,13,10,37,44,-7,34
Sonderjyske,3062,6,8,6,10,28,29,-1,30
AC Horsens,3062,7,5,12,13,30,56,-26,27
Randers FC,3062,8,5,7,12,24,40,-16,22
Silkeborg IF,3062,9,6,3,13,28,44,-16,21
Lyngby,3062,10,3,10,11,27,45,-18,19
AGF Aarhus,3062,11,4,6,12,16,39,-23,18
Brondby,3063,1,21,5,4,70,34,36,68
FC Midtjylla,3063,2,20,4,6,61,39,22,64
Copenhagen,3063,3,15,4,11,56,42,14,49
FC Nords,3063,4,14,6,10,73,51,22,48
AaB,3063,5,9,12,9,38,37,1,39
Sonderjyske,3063,6,8,6,10,28,29,-1,30
AC Horsens,3063,7,5,13,12,32,53,-21,28
Lyngby,3063,8,4,9,11,27,44,-17,21
Randers FC,3063,9,5,6,13,23,40,-17,21
AGF Aarhus,3063,10,5,6,11,19,36,-17,21
Silkeborg IF,3063,11,5,3,14,25,47,-22,18
Brondby,3064,1,20,7,3,70,31,39,67
FC Midtjylla,3064,2,18,7,5,63,42,21,61
FC Nords,3064,3,14,7,9,74,49,25,49
Copenhagen,3064,4,13,6,11,58,48,10,45
AaB,3064,5,8,12,10,39,43,-4,36
AC Horsens,3064,6,7,13,10,34,51,-17,34
Sonderjyske,3064,7,8,6,10,28,29,-1,30
Randers FC,3064,8,5,7,12,24,40,-16,22
Lyngby,3064,9,3,10,11,27,45,-18,19
Silkeborg IF,3064,10,5,4,13,26,45,-19,19
AGF Aarhus,3064,11,4,7,11,17,37,-20,19
Brondby,3065,1,22,6,2,72,31,41,72
FC Midtjylla,3065,2,20,5,5,64,37,27,65
FC Nords,3065,3,14,8,8,76,52,24,50
Copenhagen,3065,4,13,5,12,56,45,11,44
AaB,3065,5,7,13,10,37,43,-6,34
Sonderjyske,3065,6,8,6,10,28,29,-1,30
AC Horsens,3065,7,5,13,12,32,55,-23,28
Lyngby,3065,8,4,9,11,28,45,-17,21
Silkeborg IF,3065,9,6,3,13,27,44,-17,21
Randers FC,3065,10,5,6,13,24,41,-17,21
AGF Aarhus,3065,11,4,6,12,16,38,-22,18
Brondby,3066,1,21,6,3,74,30,44,69
FC Midtjylla,3066,2,20,5,5,68,42,26,65
Copenhagen,3066,3,14,4,12,55,45,10,46
FC Nords,3066,4,12,7,11,69,54,15,43
AaB,3066,5,9,11,10,42,48,-6,38
AC Horsens,3066,6,7,13,10,38,53,-15,34
Sonderjyske,3066,7,8,6,10,28,29,-1,30
Randers FC,3066,8,6,6,12,25,39,-14,24
Silkeborg IF,3066,9,5,4,13,26,45,-19,19
AGF Aarhus,3066,10,4,7,11,17,37,-20,19
Lyngby,3066,11,3,9,12,26,46,-20,18
Brondby,3067,1,22,5,3,71,29,42,71
FC Midtjylla,3067,2,20,4,6,67,38,29,64
Copenhagen,3067,3,15,6,9,60,44,16,51
FC Nords,3067,4,14,7,9,76,54,22,49
Sonderjyske,3067,5,8,6,10,28,29,-1,30
AaB,3067,6,6,12,12,34,46,-12,30
AC Horsens,3067,7,6,12,12,36,59,-23,30
Lyngby,3067,8,4,9,11,29,44,-15,21
Silkeborg IF,3067,9,6,3,13,28,44,-16,21
Randers FC,3067,10,5,6,13,23,42,-19,21
AGF Aarhus,3067,11,4,6,12,16,39,-23,18
Brondby,3068,1,21,7,2,72,30,42,70
FC Midtjylla,3068,2,21,5,4,66,34,32,68
Copenhagen,3068,3,15,5,10,59,43,16,50
FC Nords,3068,4,12,7,11,70,60,10,43
AaB,3068,5,7,11,12,36,45,-9,32
AC Horsens,3068,6,6,13,11,37,54,-17,31
Sonderjyske,3068,7,8,6,10,28,29,-1,30
Randers FC,3068,8,6,6,12,24,39,-15,24
Silkeborg IF,3068,9,6,3,13,27,45,-18,21
Lyngby,3068,10,3,9,12,26,45,-19,18
AGF Aarhus,3068,11,4,6,12,17,38,-21,18
Brondby,3069,1,21,6,3,78,34,44,69
FC Midtjylla,3069,2,20,6,4,65,37,28,66
FC Nords,3069,3,14,6,10,76,52,24,48
Copenhagen,3069,4,13,5,12,59,51,8,44
AC Horsens,3069,5,7,13,10,36,59,-23,34
AaB,3069,6,7,12,11,39,46,-7,33
Sonderjyske,3069,7,8,6,10,28,29,-1,30
Randers FC,3069,8,5,7,12,25,41,-16,22
AGF Aarhus,3069,9,5,6,11,19,36,-17,21
Lyngby,3069,10,3,10,11,28,46,-18,19
Silkeborg IF,3069,11,5,3,14,25,47,-22,18
Brondby,3070,1,20,6,4,69,33,36,66
FC Midtjylla,3070,2,19,6,5,67,42,25,63
FC Nords,3070,3,15,7,8,81,52,29,52
Copenhagen,3070,4,13,6,11,60,48,12,45
AaB,3070,5,8,12,10,38,42,-4,36
AC Horsens,3070,6,6,13,11,34,58,-24,31
Sonderjyske,3070,7,8,6,10,28,29,-1,30
Lyngby,3070,8,4,9,11,27,44,-17,21
Randers FC,3070,9,5,6,13,23,40,-17,21
Silkeborg IF,3070,10,5,4,13,26,45,-19,19
AGF Aarhus,3070,11,4,7,11,17,37,-20,19
Brondby,3071,1,21,5,4,72,31,41,68
FC Midtjylla,3071,2,19,5,6,69,39,30,62
Copenhagen,3071,3,16,4,10,63,45,18,52
FC Nords,3071,4,14,6,10,68,54,14,48
AaB,3071,5,8,13,9,40,44,-4,37
Sonderjyske,3071,6,8,6,10,28,29,-1,30
AC Horsens,3071,7,5,13,12,32,57,-25,28
Lyngby,3071,8,4,9,11,28,45,-17,21
Randers FC,3071,9,5,6,13,24,41,-17,21
Silkeborg IF,3071,10,6,3,13,27,45,-18,21
AGF Aarhus,3071,11,4,6,12,17,38,-21,18
Brondby,3072,1,20,7,3,65,29,36,67
FC Midtjylla,3072,2,20,6,4,66,36,30,66
FC Nords,3072,3,13,8,9,74,51,23,47
Copenhagen,3072,4,14,5,11,57,44,13,47
AaB,3072,5,7,12,11,34,41,-7,33
AC Horsens,3072,6,6,14,10,31,52,-21,32
Sonderjyske,3072,7,8,6,10,28,29,-1,30
Lyngby,3072,8,4,9,11,28,45,-17,21
Silkeborg IF,3072,8,6,3,13,28,45,-17,21
Randers FC,3072,10,5,6,13,24,41,-17,21
AGF Aarhus,3072,11,4,6,12,17,39,-22,18
Brondby,3073,1,21,5,4,72,32,40,68
FC Midtjylla,3073,2,20,4,6,68,44,24,64
FC Nords,3073,3,15,6,9,72,49,23,51
Copenhagen,3073,4,15,4,11,60,45,15,49
AC Horsens,3073,5,8,12,10,38,52,-14,36
Sonderjyske,3073,6,8,6,10,28,29,-1,30
AaB,3073,7,6,11,13,33,47,-14,29
Randers FC,3073,8,5,7,12,25,41,-16,22
Lyngby,3073,9,3,10,11,28,46,-18,19
Silkeborg IF,3073,10,5,4,13,27,46,-19,19
AGF Aarhus,3073,11,4,7,11,18,38,-20,19
Brondby,3074,1,21,6,3,70,33,37,69
FC Midtjylla,3074,2,21,5,4,71,41,30,68
FC Nords,3074,3,15,6,9,81,56,25,51
Copenhagen,3074,4,13,5,12,58,47,11,44
AaB,3074,5,7,13,10,40,46,-6,34
Sonderjyske,3074,6,8,6,10,28,29,-1,30
AC Horsens,3074,7,5,13,12,35,58,-23,28
Lyngby,3074,8,4,9,11,28,44,-16,21
Randers FC,3074,9,5,6,13,23,41,-18,21
Silkeborg IF,3074,10,5,4,13,26,45,-19,19
AGF Aarhus,3074,11,4,7,11,17,37,-20,19
Brondby,3075,1,22,5,3,74,33,41,71
FC Midtjylla,3075,2,20,5,5,66,38,28,65
FC Nords,3075,3,16,7,7,77,48,29,55
Copenhagen,3075,4,12,5,13,57,52,5,41
AaB,3075,5,7,12,11,37,43,-6,33
Sonderjyske,3075,6,8,6,10,28,29,-1,30
AC Horsens,3075,7,6,12,12,35,58,-23,30
Lyngby,3075,8,4,9,11,28,44,-16,21
Silkeborg IF,3075,8,6,3,13,28,44,-16,21
Randers FC,3075,10,5,6,13,23,41,-18,21
AGF Aarhus,3075,11,4,6,12,16,39,-23,18
FC Midtjylla,3076,1,21,4,5,72,40,32,67
Brondby,3076,2,20,5,5,68,35,33,65
Copenhagen,3076,3,15,5,10,57,42,15,50
FC Nords,3076,4,14,7,9,74,52,22,49
AaB,3076,5,7,12,11,38,44,-6,33
AC Horsens,3076,6,6,13,11,34,56,-22,31
Sonderjyske,3076,7,8,6,10,28,29,-1,30
Randers FC,3076,8,5,7,12,23,39,-16,22
AGF Aarhus,3076,9,5,6,11,18,37,-19,21
Lyngby,3076,10,3,10,11,26,44,-18,19
Silkeborg IF,3076,11,5,3,14,26,46,-20,18
Brondby,3077,1,21,5,4,72,35,37,68
FC Midtjylla,3077,2,20,4,6,63,37,26,64
FC Nords,3077,3,16,6,8,76,48,28,54
Copenhagen,3077,4,14,4,12,56,45,11,46
AaB,3077,5,7,12,11,35,43,-8,33
AC Horsens,3077,6,6,13,11,37,57,-20,31
Sonderjyske,3077,7,8,6,10,28,29,-1,30
Lyngby,3077,8,4,9,11,28,45,-17,21
Silkeborg IF,3077,8,6,3,13,28,45,-17,21
Randers FC,3077,10,5,6,13,24,41,-17,21
AGF Aarhus,3077,11,4,6,12,17,39,-22,18
FC Midtjylla,3078,1,20,6,4,64,37,27,66
Brondby,3078,2,19,5,6,68,36,32,62
Copenhagen,3078,3,15,6,9,59,41,18,51
FC Nords,3078,4,13,7,10,72,55,17,46
AaB,3078,5,8,12,10,38,42,-4,36
AC Horsens,3078,6,6,14,10,36,52,-16,32
Sonderjyske,3078,7,8,6,10,28,29,-1,30
Lyngby,3078,8,4,9,11,30,45,-15,21
Silkeborg IF,3078,9,6,3,13,28,46,-18,21
Randers FC,3078,10,5,6,13,24,43,-19,21
AGF Aarhus,3078,11,4,6,12,18,39,-21,18
Brondby,3079,1,21,5,4,74,32,42,68
FC Midtjylla,3079,2,20,4,6,67,40,27,64
FC Nords,3079,3,15,7,8,76,52,24,52
Copenhagen,3079,4,14,4,12,56,47,9,46
AaB,3079,5,7,12,11,37,46,-9,33
AC Horsens,3079,6,7,12,11,35,54,-19,33
Sonderjyske,3079,7,8,6,10,28,29,-1,30
Randers FC,3079,8,6,6,12,24,39,-15,24
Silkeborg IF,3079,9,6,3,13,27,45,-18,21
Lyngby,3079,10,3,9,12,26,45,-19,18
AGF Aarhus,3079,11,4,6,12,17,38,-21,18
Brondby,3080,1,19,7,4,66,32,34,64
FC Midtjylla,3080,2,19,4,7,61,40,21,61
FC Nords,3080,3,16,6,8,76,50,26,54
Copenhagen,3080,4,14,6,10,59,45,14,48
AC Horsens,3080,5,8,12,10,35,48,-13,36
AaB,3080,6,6,13,11,34,42,-8,31
Sonderjyske,3080,7,8,6,10,28,29,-1,30
Randers FC,3080,8,6,6,12,25,40,-15,24
Silkeborg IF,3080,9,6,3,13,26,44,-18,21
Lyngby,3080,10,3,9,12,27,46,-19,18
AGF Aarhus,3080,11,4,6,12,16,37,-21,18
Brondby,3081,1,20,6,4,66,31,35,66
FC Midtjylla,3081,2,19,5,6,64,39,25,62
FC Nords,3081,3,15,6,9,73,52,21,51
Copenhagen,3081,4,14,5,11,60,44,16,47
AaB,3081,5,7,13,10,33,42,-9,34
AC Horsens,3081,6,7,13,10,34,48,-14,34
Sonderjyske,3081,7,8,6,10,28,29,-1,30
Randers FC,3081,8,5,7,12,24,40,-16,22
Silkeborg IF,3081,9,6,3,13,27,45,-18,21
Lyngby,3081,10,3,10,11,27,45,-18,19
AGF Aarhus,3081,11,4,6,12,17,38,-21,18
Brondby,3082,1,20,6,4,69,35,34,66
FC Midtjylla,3082,2,19,4,7,66,40,26,61
Copenhagen,3082,3,16,4,10,59,42,17,52
FC Nords,3082,4,14,7,9,75,54,21,49
AC Horsens,3082,5,7,13,10,38,55,-17,34
AaB,3082,6,7,12,11,39,46,-7,33
Sonderjyske,3082,7,8,6,10,28,29,-1,30
Randers FC,3082,8,5,7,12,25,41,-16,22
Silkeborg IF,3082,9,6,3,13,28,45,-17,21
Lyngby,3082,10,3,10,11,28,46,-18,19
AGF Aarhus,3082,11,4,6,12,17,39,-22,18
FC Midtjylla,3083,1,21,5,4,75,38,37,68
Brondby,3083,2,20,6,4,70,33,37,66
Copenhagen,3083,3,15,5,10,62,48,14,50
FC Nords,3083,4,13,8,9,70,54,16,47
AaB,3083,5,7,12,11,36,45,-9,33
Sonderjyske,3083,6,8,6,10,28,29,-1,30
AC Horsens,3083,7,6,12,12,34,55,-21,30
Lyngby,3083,8,4,9,11,27,44,-17,21
Randers FC,3083,9,5,6,13,23,40,-17,21
Silkeborg IF,3083,10,5,4,13,26,45,-19,19
AGF Aarhus,3083,11,4,7,11,17,37,-20,19
Brondby,3084,1,19,8,3,71,34,37,65
FC Midtjylla,3084,2,18,8,4,63,38,25,62
FC Nords,3084,3,14,7,9,74,56,18,49
Copenhagen,3084,4,14,6,10,57,42,15,48
AaB,3084,5,7,14,9,36,37,-1,35
AC Horsens,3084,6,6,13,11,36,56,-20,31
Sonderjyske,3084,7,8,6,10,28,29,-1,30
Lyngby,3084,8,4,9,11,29,44,-15,21
Randers FC,3084,9,5,6,13,23,42,-19,21
Silkeborg IF,3084,10,5,4,13,25,44,-19,19
AGF Aarhus,3084,11,4,7,11,16,36,-20,19
Brondby,3085,1,22,5,3,79,33,46,71
FC Midtjylla,3085,2,19,5,6,71,45,26,62
FC Nords,3085,3,14,7,9,74,55,19,49
Copenhagen,3085,4,13,4,13,59,54,5,43
AaB,3085,5,8,12,10,40,48,-8,36
AC Horsens,3085,6,7,13,10,36,50,-14,34
Sonderjyske,3085,7,8,6,10,28,29,-1,30
Lyngby,3085,8,4,9,11,28,45,-17,21
Randers FC,3085,9,5,6,13,24,41,-17,21
AGF Aarhus,3085,10,5,6,11,17,36,-19,21
Silkeborg IF,3085,11,5,3,14,25,45,-20,18
Brondby,3086,1,22,6,2,70,30,40,72
FC Midtjylla,3086,2,19,5,6,70,42,28,62
FC Nords,3086,3,14,8,8,75,52,23,50
Copenhagen,3086,4,13,6,11,59,45,14,45
AaB,3086,5,7,12,11,34,45,-11,33
Sonderjyske,3086,6,8,6,10,28,29,-1,30
AC Horsens,3086,7,5,15,10,34,54,-20,30
Lyngby,3086,8,4,9,11,27,44,-17,21
Randers FC,3086,9,5,6,13,23,40,-17,21
Silkeborg IF,3086,10,5,4,13,26,45,-19,19
AGF Aarhus,3086,11,4,7,11,17,37,-20,19
Brondby,3087,1,22,6,2,75,28,47,72
FC Midtjylla,3087,2,21,4,5,71,40,31,67
FC Nords,3087,3,14,7,9,71,53,18,49
Copenhagen,3087,4,12,4,14,53,49,4,40
AaB,3087,5,7,13,10,35,44,-9,34
AC Horsens,3087,6,6,14,10,33,50,-17,32
Sonderjyske,3087,7,8,6,10,28,29,-1,30
Randers FC,3087,8,5,7,12,23,39,-16,22
AGF Aarhus,3087,9,5,6,11,18,36,-18,21
Lyngby,3087,10,3,10,11,26,44,-18,19
Silkeborg IF,3087,11,5,3,14,25,46,-21,18
Brondby,3088,1,22,5,3,72,31,41,71
FC Midtjylla,3088,2,19,5,6,63,38,25,62
Copenhagen,3088,3,16,4,10,62,44,18,52
FC Nords,3088,4,15,6,9,74,50,24,51
Sonderjyske,3088,5,8,6,10,28,29,-1,30
AC Horsens,3088,6,6,12,12,37,54,-17,30
AaB,3088,7,6,12,12,34,51,-17,30
Randers FC,3088,8,6,6,12,25,40,-15,24
AGF Aarhus,3088,9,5,6,11,17,36,-19,21
Lyngby,3088,10,3,9,12,27,46,-19,18
Silkeborg IF,3088,11,5,3,14,25,45,-20,18
Brondby,3089,1,20,5,5,70,37,33,65
FC Midtjylla,3089,2,20,4,6,69,41,28,64
FC Nords,3089,3,14,7,9,75,58,17,49
Copenhagen,3089,4,14,5,11,62,48,14,47
AaB,3089,5,8,12,10,37,40,-3,36
AC Horsens,3089,6,7,13,10,35,50,-15,34
Sonderjyske,3089,7,8,6,10,28,29,-1,30
Lyngby,3089,8,4,9,11,29,45,-16,21
Silkeborg IF,3089,9,6,3,13,30,47,-17,21
Randers FC,3089,10,5,6,13,24,42,-18,21
AGF Aarhus,3089,11,4,6,12,19,41,-22,18
Brondby,3090,1,19,8,3,67,31,36,65
FC Midtjylla,3090,2,20,5,5,67,37,30,65
FC Nords,3090,3,15,6,9,74,50,24,51
Copenhagen,3090,4,14,5,11,57,47,10,47
AaB,3090,5,8,12,10,38,45,-7,36
Sonderjyske,3090,6,8,6,10,28,29,-1,30
AC Horsens,3090,7,5,14,11,30,49,-19,29
Lyngby,3090,8,4,9,11,27,44,-17,21
Randers FC,3090,9,5,6,13,23,40,-17,21
Silkeborg IF,3090,10,5,4,13,26,45,-19,19
AGF Aarhus,3090,11,4,7,11,17,37,-20,19
FC Midtjylla,3091,1,20,6,4,69,37,32,66
Brondby,3091,2,19,6,5,68,35,33,63
Copenhagen,3091,3,15,6,9,62,44,18,51
FC Nords,3091,4,13,7,10,72,54,18,46
AaB,3091,5,8,12,10,38,44,-6,36
AC Horsens,3091,6,6,13,11,35,56,-21,31
Sonderjyske,3091,7,8,6,10,28,29,-1,30
Randers FC,3091,8,5,7,12,24,40,-16,22
AGF Aarhus,3091,9,5,6,11,20,37,-17,21
Lyngby,3091,10,3,10,11,27,45,-18,19
Silkeborg IF,3091,11,5,3,14,26,48,-22,18
Brondby,3092,1,21,5,4,70,32,38,68
FC Midtjylla,3092,2,21,5,4,66,37,29,68
FC Nords,3092,3,14,6,10,74,57,17,48
Copenhagen,3092,4,14,6,10,58,46,12,48
AaB,3092,5,8,11,11,40,43,-3,35
Sonderjyske,3092,6,8,6,10,28,29,-1,30
AC Horsens,3092,7,5,13,12,31,50,-19,28
Lyngby,3092,8,4,9,11,29,46,-17,21
Silkeborg IF,3092,9,6,3,13,28,45,-17,21
Randers FC,3092,10,5,6,13,25,42,-17,21
AGF Aarhus,3092,11,4,6,12,17,39,-22,18
FC Midtjylla,3093,1,20,5,5,64,36,28,65
Brondby,3093,2,18,7,5,65,34,31,61
Copenhagen,3093,3,15,6,9,58,40,18,51
FC Nords,3093,4,14,8,8,74,52,22,50
AaB,3093,5,8,13,9,37,42,-5,37
Sonderjyske,3093,6,8,6,10,28,29,-1,30
AC Horsens,3093,7,5,13,12,33,53,-20,28
Lyngby,3093,8,4,9,11,27,44,-17,21
Randers FC,3093,9,5,6,13,23,40,-17,21
Silkeborg IF,3093,10,5,4,13,26,45,-19,19
AGF Aarhus,3093,11,4,7,11,17,37,-20,19
Brondby,3094,1,22,6,2,70,29,41,72
FC Midtjylla,3094,2,19,5,6,65,39,26,62
FC Nords,3094,3,15,8,7,74,47,27,53
Copenhagen,3094,4,14,5,11,60,44,16,47
Sonderjyske,3094,5,8,6,10,28,29,-1,30
AaB,3094,6,6,12,12,36,48,-12,30
AC Horsens,3094,7,6,12,12,35,59,-24,30
Lyngby,3094,8,4,9,11,29,45,-16,21
AGF Aarhus,3094,9,5,6,11,20,36,-16,21
Randers FC,3094,10,5,6,13,24,42,-18,21
Silkeborg IF,3094,11,5,3,14,25,48,-23,18
Brondby,3095,1,20,6,4,70,32,38,66
FC Midtjylla,3095,2,19,5,6,70,38,32,62
FC Nords,3095,3,13,8,9,70,54,16,47
Copenhagen,3095,4,14,5,11,57,45,12,47
AC Horsens,3095,5,9,12,9,38,51,-13,39
AaB,3095,6,7,12,11,38,49,-11,33
Sonderjyske,3095,7,8,6,10,28,29,-1,30
Randers FC,3095,8,6,6,12,25,40,-15,24
Silkeborg IF,3095,9,5,4,13,25,44,-19,19
AGF Aarhus,3095,10,4,7,11,16,36,-20,19
Lyngby,3095,11,3,9,12,27,46,-19,18
Brondby,3096,1,19,7,4,69,36,33,64
FC Midtjylla,3096,2,18,7,5,65,42,23,61
FC Nords,3096,3,14,8,8,73,50,23,50
Copenhagen,3096,4,13,5,12,59,49,10,44
AC Horsens,3096,5,8,13,9,36,50,-14,37
AaB,3096,6,8,12,10,41,42,-1,36
Sonderjyske,3096,7,8,6,10,28,29,-1,30
Randers FC,3096,8,5,7,12,24,40,-16,22
Silkeborg IF,3096,9,6,3,13,28,45,-17,21
Lyngby,3096,10,3,10,11,27,45,-18,19
AGF Aarhus,3096,11,4,6,12,17,39,-22,18
Brondby,3097,1,20,5,5,66,33,33,65
FC Midtjylla,3097,2,20,5,5,66,37,29,65
Copenhagen,3097,3,15,5,10,57,43,14,50
FC Nords,3097,4,14,7,9,69,49,20,49
AaB,3097,5,9,12,9,40,38,2,39
Sonderjyske,3097,6,8,6,10,28,29,-1,30
AC Horsens,3097,7,5,12,13,31,55,-24,27
Lyngby,3097,8,4,9,11,29,44,-15,21
AGF Aarhus,3097,9,5,6,11,19,37,-18,21
Randers FC,3097,10,5,6,13,23,42,-19,21
Silkeborg IF,3097,11,5,3,14,26,47,-21,18
Brondby,3098,1,20,7,3,66,31,35,67
FC Midtjylla,3098,2,18,5,7,65,43,22,59
FC Nords,3098,3,15,7,8,75,51,24,52
Copenhagen,3098,4,13,6,11,57,45,12,45
AC Horsens,3098,5,8,12,10,39,52,-13,36
AaB,3098,6,8,11,11,34,40,-6,35
Sonderjyske,3098,7,8,6,10,28,29,-1,30
Randers FC,3098,8,5,7,12,25,41,-16,22
AGF Aarhus,3098,9,5,6,11,18,36,-18,21
Lyngby,3098,10,3,10,11,28,46,-18,19
Silkeborg IF,3098,11,5,3,14,25,46,-21,18
Brondby,3099,1,21,6,3,71,31,40,69
FC Midtjylla,3099,2,20,4,6,68,38,30,64
FC Nords,3099,3,13,6,11,72,58,14,45
Copenhagen,3099,4,13,6,11,57,51,6,45
AC Horsens,3099,5,8,13,9,38,49,-11,37
AaB,3099,6,7,13,10,38,43,-5,34
Sonderjyske,3099,7,8,6,10,28,29,-1,30
Lyngby,3099,8,4,9,11,27,44,-17,21
Randers FC,3099,9,5,6,13,23,40,-17,21
Silkeborg IF,3099,10,5,4,13,26,45,-19,19
AGF Aarhus,3099,11,4,7,11,17,37,-20,19
FC Midtjylla,3100,1,20,5,5,68,37,31,65
Brondby,3100,2,19,7,4,66,34,32,64
Copenhagen,3100,3,14,4,12,55,44,11,46
FC Nords,3100,4,12,8,10,70,54,16,44
AaB,3100,5,9,11,10,38,42,-4,38
AC Horsens,3100,6,7,15,8,35,47,-12,36
Sonderjyske,3100,7,8,6,10,28,29,-1,30
Lyngby,3100,8,4,9,11,27,44,-17,21
Randers FC,3100,9,5,6,13,23,40,-17,21
AGF Aarhus,3100,10,5,6,11,18,36,-18,21
Silkeborg IF,3100,11,5,3,14,25,46,-21,18
Brondby,3101,1,23,5,2,73,29,44,74
FC Midtjylla,3101,2,20,4,6,66,41,25,64
FC Nords,3101,3,14,7,9,75,55,20,49
Copenhagen,3101,4,14,4,12,58,46,12,46
AaB,3101,5,7,12,11,37,45,-8,33
Sonderjyske,3101,6,8,6,10,28,29,-1,30
AC Horsens,3101,7,6,12,12,33,52,-19,30
Lyngby,3101,8,4,9,11,28,45,-17,21
Randers FC,3101,9,5,6,13,24,41,-17,21
Silkeborg IF,3101,10,6,3,13,26,44,-18,21
AGF Aarhus,3101,11,4,6,12,16,37,-21,18
FC Midtjylla,3102,1,21,5,4,66,34,32,68
Brondby,3102,2,19,7,4,67,33,34,64
FC Nords,3102,3,14,6,10,71,51,20,48
Copenhagen,3102,4,14,6,10,56,42,14,48
AaB,3102,5,7,12,11,39,46,-7,33
AC Horsens,3102,6,6,14,10,33,52,-19,32
Sonderjyske,3102,7,8,6,10,28,29,-1,30
Lyngby,3102,8,4,9,11,29,44,-15,21
Randers FC,3102,9,5,6,13,23,42,-19,21
Silkeborg IF,3102,10,5,4,13,27,46,-19,19
AGF Aarhus,3102,11,4,7,11,18,38,-20,19
Brondby,3103,1,20,6,4,75,39,36,66
FC Midtjylla,3103,2,19,5,6,63,40,23,62
FC Nords,3103,3,15,7,8,76,50,26,52
Copenhagen,3103,4,13,7,10,61,48,13,46
AC Horsens,3103,5,7,13,10,34,52,-18,34
AaB,3103,6,7,12,11,35,41,-6,33
Sonderjyske,3103,7,8,6,10,28,29,-1,30
Randers FC,3103,8,5,7,12,23,39,-16,22
Silkeborg IF,3103,9,6,3,13,31,44,-13,21
Lyngby,3103,10,3,10,11,26,44,-18,19
AGF Aarhus,3103,11,4,6,12,16,42,-26,18
Brondby,3104,1,20,5,5,69,33,36,65
FC Midtjylla,3104,2,20,5,5,63,36,27,65
Copenhagen,3104,3,15,5,10,61,42,19,50
FC Nords,3104,4,14,6,10,74,53,21,48
AaB,3104,5,8,12,10,39,46,-7,36
AC Horsens,3104,6,6,13,11,32,54,-22,31
Sonderjyske,3104,7,8,6,10,28,29,-1,30
Randers FC,3104,8,5,7,12,24,40,-16,22
Silkeborg IF,3104,9,6,3,13,26,44,-18,21
Lyngby,3104,10,3,10,11,27,45,-18,19
AGF Aarhus,3104,11,4,6,12,16,37,-21,18
Brondby,3105,1,22,6,2,73,31,42,72
FC Midtjylla,3105,2,21,4,5,70,41,29,67
FC Nords,3105,3,13,8,9,76,54,22,47
Copenhagen,3105,4,12,6,12,57,48,9,42
AaB,3105,5,8,12,10,38,43,-5,36
Sonderjyske,3105,6,8,6,10,28,29,-1,30
AC Horsens,3105,7,6,12,12,32,55,-23,30
Lyngby,3105,8,4,9,11,27,44,-17,21
Randers FC,3105,9,5,6,13,23,40,-17,21
AGF Aarhus,3105,10,5,6,11,18,36,-18,21
Silkeborg IF,3105,11,5,3,14,25,46,-21,18
Brondby,3106,1,22,5,3,74,30,44,71
FC Midtjylla,3106,2,21,4,5,67,39,28,67
FC Nords,3106,3,13,6,11,72,60,12,45
Copenhagen,3106,4,13,5,12,59,47,12,44
AaB,3106,5,8,12,10,39,43,-4,36
AC Horsens,3106,6,7,12,11,37,55,-18,33
Sonderjyske,3106,7,8,6,10,28,29,-1,30
Lyngby,3106,8,4,9,11,29,44,-15,21
Silkeborg IF,3106,9,6,3,13,28,46,-18,21
Randers FC,3106,10,5,6,13,23,42,-19,21
AGF Aarhus,3106,11,4,6,12,18,39,-21,18
Brondby,3107,1,18,7,5,67,35,32,61
FC Midtjylla,3107,2,18,6,6,61,38,23,60
Copenhagen,3107,3,16,5,9,61,43,18,53
FC Nords,3107,4,15,7,8,79,48,31,52
AaB,3107,5,8,11,11,34,44,-10,35
AC Horsens,3107,6,7,12,11,36,56,-20,33
Sonderjyske,3107,7,8,6,10,28,29,-1,30
Randers FC,3107,8,5,7,12,24,40,-16,22
AGF Aarhus,3107,9,5,6,11,17,36,-19,21
Lyngby,3107,10,3,10,11,27,45,-18,19
Silkeborg IF,3107,11,5,3,14,25,45,-20,18
Brondby,3108,1,20,5,5,66,37,29,65
FC Midtjylla,3108,2,20,5,5,69,43,26,65
Copenhagen,3108,3,15,4,11,62,47,15,49
FC Nords,3108,4,14,6,10,74,49,25,48
AaB,3108,5,8,11,11,37,44,-7,35
AC Horsens,3108,6,7,13,10,36,50,-14,34
Sonderjyske,3108,7,8,6,10,28,29,-1,30
Randers FC,3108,8,6,6,12,24,39,-15,24
Silkeborg IF,3108,9,6,3,13,28,44,-16,21
Lyngby,3108,10,3,9,12,26,45,-19,18
AGF Aarhus,3108,11,4,6,12,16,39,-23,18
Brondby,3109,1,22,6,2,74,30,44,72
FC Midtjylla,3109,2,19,6,5,68,43,25,63
FC Nords,3109,3,14,6,10,73,56,17,48
Copenhagen,3109,4,14,5,11,57,42,15,47
AaB,3109,5,7,12,11,33,41,-8,33
AC Horsens,3109,6,6,13,11,33,52,-19,31
Sonderjyske,3109,7,8,6,10,28,29,-1,30
Randers FC,3109,8,6,6,12,25,40,-15,24
Silkeborg IF,3109,9,5,4,13,26,45,-19,19
AGF Aarhus,3109,10,4,7,11,17,37,-20,19
Lyngby,3109,11,3,9,12,27,46,-19,18
Brondby,3110,1,21,7,2,71,31,40,70
FC Midtjylla,3110,2,20,4,6,64,36,28,64
Copenhagen,3110,3,15,6,9,59,43,16,51
FC Nords,3110,4,13,6,11,70,53,17,45
AaB,3110,5,7,13,10,36,42,-6,34
Sonderjyske,3110,6,8,6,10,28,29,-1,30
AC Horsens,3110,7,6,12,12,35,56,-21,30
Lyngby,3110,8,4,9,11,31,45,-14,21
Silkeborg IF,3110,9,6,3,13,27,44,-17,21
Randers FC,3110,10,5,6,13,24,44,-20,21
AGF Aarhus,3110,11,4,6,12,16,38,-22,18
Brondby,3111,1,23,5,2,79,30,49,74
FC Midtjylla,3111,2,21,4,5,67,40,27,67
Copenhagen,3111,3,14,5,11,57,46,11,47
FC Nords,3111,4,12,7,11,70,58,12,43
AaB,3111,5,7,12,11,40,44,-4,33
AC Horsens,3111,6,6,13,11,34,55,-21,31
Sonderjyske,3111,7,8,6,10,28,29,-1,30
Randers FC,3111,8,5,7,12,23,39,-16,22
Lyngby,3111,9,3,10,11,26,44,-18,19
Silkeborg IF,3111,10,5,4,13,25,44,-19,19
AGF Aarhus,3111,11,4,7,11,16,36,-20,19
Brondby,3112,1,22,6,2,73,32,41,72
FC Midtjylla,3112,2,19,6,5,70,42,28,63
FC Nords,3112,3,14,7,9,81,51,30,49
Copenhagen,3112,4,13,5,12,55,54,1,44
AaB,3112,5,7,12,11,38,47,-9,33
AC Horsens,3112,6,6,14,10,35,52,-17,32
Sonderjyske,3112,7,8,6,10,28,29,-1,30
Randers FC,3112,8,5,7,12,25,41,-16,22
Silkeborg IF,3112,9,6,3,13,27,44,-17,21
Lyngby,3112,10,3,10,11,28,46,-18,19
AGF Aarhus,3112,11,4,6,12,16,38,-22,18
Brondby,3113,1,19,8,3,69,31,38,65
FC Midtjylla,3113,2,20,5,5,69,40,29,65
Copenhagen,3113,3,15,5,10,61,44,17,50
FC Nords,3113,4,14,7,9,74,55,19,49
AaB,3113,5,6,14,10,34,42,-8,32
AC Horsens,3113,6,6,13,11,33,54,-21,31
Sonderjyske,3113,7,8,6,10,28,29,-1,30
Lyngby,3113,8,4,9,11,29,45,-16,21
AGF Aarhus,3113,9,5,6,11,20,36,-16,21
Randers FC,3113,10,5,6,13,24,42,-18,21
Silkeborg IF,3113,11,5,3,14,25,48,-23,18
FC Midtjylla,3114,1,22,4,4,70,34,36,70
Brondby,3114,2,21,6,3,75,33,42,69
FC Nords,3114,3,14,6,10,71,57,14,48
Copenhagen,3114,4,14,5,11,67,47,20,47
AaB,3114,5,7,12,11,34,44,-10,33
Sonderjyske,3114,6,8,6,10,28,29,-1,30
AC Horsens,3114,7,5,13,12,31,59,-28,28
Randers FC,3114,8,5,7,12,25,41,-16,22
Silkeborg IF,3114,9,6,3,13,28,46,-18,21
Lyngby,3114,10,3,10,11,28,46,-18,19
AGF Aarhus,3114,11,4,6,12,18,39,-21,18
Brondby,3115,1,22,5,3,72,29,43,71
FC Midtjylla,3115,2,18,4,8,62,42,20,58
FC Nords,3115,3,15,7,8,72,51,21,52
Copenhagen,3115,4,15,5,10,58,42,16,50
AaB,3115,5,8,11,11,39,45,-6,35
Sonderjyske,3115,6,8,6,10,28,29,-1,30
AC Horsens,3115,7,6,12,12,34,54,-20,30
Randers FC,3115,8,5,7,12,24,40,-16,22
Silkeborg IF,3115,9,6,3,13,28,44,-16,21
Lyngby,3115,10,3,10,11,27,45,-18,19
AGF Aarhus,3115,11,4,6,12,16,39,-23,18
Brondby,3116,1,22,6,2,72,31,41,72
FC Midtjylla,3116,2,18,5,7,59,37,22,59
FC Nords,3116,3,14,8,8,73,52,21,50
Copenhagen,3116,4,13,7,10,55,42,13,46
AaB,3116,5,7,12,11,35,41,-6,33
AC Horsens,3116,6,6,14,10,35,52,-17,32
Sonderjyske,3116,7,8,6,10,28,29,-1,30
Lyngby,3116,8,4,9,11,27,44,-17,21
Randers FC,3116,9,5,6,13,23,40,-17,21
Silkeborg IF,3116,10,6,3,13,27,45,-18,21
AGF Aarhus,3116,11,4,6,12,17,38,-21,18
Brondby,3117,1,20,6,4,70,38,32,66
FC Midtjylla,3117,2,19,5,6,65,40,25,62
Copenhagen,3117,3,16,4,10,60,43,17,52
FC Nords,3117,4,13,8,9,69,52,17,47
AC Horsens,3117,5,7,13,10,39,49,-10,34
AaB,3117,6,6,14,10,35,42,-7,32
Sonderjyske,3117,7,8,6,10,28,29,-1,30
Randers FC,3117,8,5,7,12,23,39,-16,22
AGF Aarhus,3117,9,5,6,11,19,38,-19,21
Lyngby,3117,10,3,10,11,26,44,-18,19
Silkeborg IF,3117,11,5,3,14,27,47,-20,18
Brondby,3118,1,20,6,4,70,35,35,66
FC Midtjylla,3118,2,19,5,6,64,42,22,62
Copenhagen,3118,3,15,6,9,61,42,19,51
FC Nords,3118,4,14,7,9,74,52,22,49
AaB,3118,5,9,12,9,42,42,0,39
Sonderjyske,3118,6,8,6,10,28,29,-1,30
AC Horsens,3118,7,5,12,13,31,55,-24,27
Randers FC,3118,8,5,7,12,24,40,-16,22
Lyngby,3118,9,3,10,11,27,45,-18,19
Silkeborg IF,3118,10,5,4,13,26,45,-19,19
AGF Aarhus,3118,11,4,7,11,17,37,-20,19
Brondby,3119,1,21,5,4,70,31,39,68
FC Midtjylla,3119,2,21,5,4,65,36,29,68
FC Nords,3119,3,13,8,9,72,54,18,47
Copenhagen,3119,4,13,6,11,61,45,16,45
AaB,3119,5,7,12,11,36,45,-9,33
AC Horsens,3119,6,7,12,11,37,56,-19,33
Sonderjyske,3119,7,8,6,10,28,29,-1,30
Randers FC,3119,8,5,7,12,24,40,-16,22
Silkeborg IF,3119,9,6,3,13,28,44,-16,21
Lyngby,3119,10,3,10,11,27,45,-18,19
AGF Aarhus,3119,11,4,6,12,16,39,-23,18
Brondby,3120,1,20,6,4,69,33,36,66
FC Midtjylla,3120,2,18,6,6,60,39,21,60
FC Nords,3120,3,16,6,8,77,51,26,54
Copenhagen,3120,4,16,4,10,63,44,19,52
AaB,3120,5,7,13,10,38,43,-5,34
Sonderjyske,3120,6,8,6,10,28,29,-1,30
AC Horsens,3120,7,5,13,12,31,54,-23,28
Randers FC,3120,8,5,7,12,25,41,-16,22
Silkeborg IF,3120,9,6,3,13,27,44,-17,21
Lyngby,3120,10,3,10,11,28,46,-18,19
AGF Aarhus,3120,11,4,6,12,16,38,-22,18
Brondby,3121,1,22,5,3,71,31,40,71
FC Midtjylla,3121,2,19,5,6,66,40,26,62
FC Nords,3121,3,15,7,8,77,50,27,52
Copenhagen,3121,4,13,4,13,54,47,7,43
AC Horsens,3121,5,8,12,10,40,55,-15,36
AaB,3121,6,7,11,12,33,44,-11,32
Sonderjyske,3121,7,8,6,10,28,29,-1,30
Randers FC,3121,8,6,6,12,24,39,-15,24
Silkeborg IF,3121,9,6,3,13,27,45,-18,21
Lyngby,3121,10,3,9,12,26,45,-19,18
AGF Aarhus,3121,11,4,6,12,17,38,-21,18
Brondby,3122,1,21,5,4,69,32,37,68
FC Midtjylla,3122,2,19,4,7,67,47,20,61
FC Nords,3122,3,15,6,9,79,49,30,51
Copenhagen,3122,4,13,5,12,56,45,11,44
AaB,3122,5,9,12,9,39,42,-3,39
AC Horsens,3122,6,6,14,10,34,55,-21,32
Sonderjyske,3122,7,8,6,10,28,29,-1,30
Randers FC,3122,8,5,7,12,24,40,-16,22
Lyngby,3122,9,3,10,11,27,45,-18,19
Silkeborg IF,3122,10,5,4,13,26,45,-19,19
AGF Aarhus,3122,11,4,7,11,17,37,-20,19
Brondby,3123,1,22,5,3,78,34,44,71
FC Midtjylla,3123,2,18,5,7,64,43,21,59
FC Nords,3123,3,15,6,9,73,54,19,51
Copenhagen,3123,4,15,4,11,60,47,13,49
AaB,3123,5,7,12,11,37,45,-8,33
AC Horsens,3123,6,6,14,10,32,47,-15,32
Sonderjyske,3123,7,8,6,10,28,29,-1,30
Lyngby,3123,8,4,9,11,27,44,-17,21
Randers FC,3123,9,5,6,13,23,40,-17,21
Silkeborg IF,3123,10,6,3,13,27,45,-18,21
AGF Aarhus,3123,11,4,6,12,17,38,-21,18
Brondby,3124,1,22,5,3,71,30,41,71
FC Midtjylla,3124,2,19,5,6,62,41,21,62
FC Nords,3124,3,14,6,10,75,54,21,48
Copenhagen,3124,4,14,5,11,56,44,12,47
AaB,3124,5,8,12,10,39,41,-2,36
AC Horsens,3124,6,6,13,11,33,52,-19,31
Sonderjyske,3124,7,8,6,10,28,29,-1,30
Randers FC,3124,8,5,7,12,23,39,-16,22
Silkeborg IF,3124,9,6,3,13,28,46,-18,21
Lyngby,3124,10,3,10,11,26,44,-18,19
AGF Aarhus,3124,11,4,6,12,18,39,-21,18
Brondby,3125,1,20,6,4,70,32,38,66
FC Midtjylla,3125,2,20,5,5,67,39,28,65
Copenhagen,3125,3,14,7,9,59,42,17,49
FC Nords,3125,4,13,9,8,70,52,18,48
AaB,3125,5,7,13,10,36,42,-6,34
Sonderjyske,3125,6,8,6,10,28,29,-1,30
AC Horsens,3125,7,5,14,11,33,54,-21,29
Randers FC,3125,8,6,6,12,25,39,-14,24
Silkeborg IF,3125,9,5,4,13,26,45,-19,19
AGF Aarhus,3125,10,4,7,11,17,37,-20,19
Lyngby,3125,11,3,9,12,26,46,-20,18
Brondby,3126,1,22,6,2,70,29,41,72
FC Midtjylla,3126,2,19,4,7,64,39,25,61
FC Nords,3126,3,15,7,8,74,50,24,52
Copenhagen,3126,4,14,5,11,55,43,12,47
AC Horsens,3126,5,6,14,10,32,49,-17,32
Sonderjyske,3126,6,8,6,10,28,29,-1,30
AaB,3126,7,6,12,12,31,42,-11,30
Lyngby,3126,8,4,9,11,29,44,-15,21
AGF Aarhus,3126,9,5,6,11,18,36,-18,21
Randers FC,3126,10,5,6,13,23,42,-19,21
Silkeborg IF,3126,11,5,3,14,25,46,-21,18
Brondby,3127,1,21,7,2,70,30,40,70
FC Midtjylla,3127,2,20,5,5,66,37,29,65
FC Nords,3127,3,13,8,9,73,53,20,47
Copenhagen,3127,4,14,4,12,56,47,9,46
AC Horsens,3127,5,7,13,10,35,51,-16,34
AaB,3127,6,6,13,11,36,44,-8,31
Sonderjyske,3127,7,8,6,10,28,29,-1,30
Randers FC,3127,8,6,6,12,24,39,-15,24
Silkeborg IF,3127,9,6,3,13,26,44,-18,21
Lyngby,3127,10,3,9,12,26,45,-19,18
AGF Aarhus,3127,11,4,6,12,16,37,-21,18
Brondby,3128,1,20,8,2,70,32,38,68
FC Midtjylla,3128,2,19,6,5,66,37,29,63
FC Nords,3128,3,14,8,8,73,49,24,50
Copenhagen,3128,4,12,6,12,56,49,7,42
AaB,3128,5,8,12,10,38,43,-5,36
AC Horsens,3128,6,5,16,9,33,52,-19,31
Sonderjyske,3128,7,8,6,10,28,29,-1,30
Randers FC,3128,8,6,6,12,25,40,-15,24
Silkeborg IF,3128,9,5,4,13,26,45,-19,19
AGF Aarhus,3128,10,4,7,11,17,37,-20,19
Lyngby,3128,11,3,9,12,27,46,-19,18
Brondby,3129,1,22,6,2,71,28,43,72
FC Midtjylla,3129,2,20,5,5,68,40,28,65
FC Nords,3129,3,12,9,9,68,52,16,45
Copenhagen,3129,4,12,6,12,54,47,7,42
AaB,3129,5,7,13,10,36,42,-6,34
AC Horsens,3129,6,6,15,9,34,48,-14,33
Sonderjyske,3129,7,8,6,10,28,29,-1,30
Lyngby,3129,8,4,9,11,28,44,-16,21
Randers FC,3129,9,5,6,13,23,41,-18,21
AGF Aarhus,3129,10,5,6,11,18,36,-18,21
Silkeborg IF,3129,11,5,3,14,25,46,-21,18
Brondby,3130,1,22,5,3,74,33,41,71
FC Midtjylla,3130,2,18,7,5,70,46,24,61
FC Nords,3130,3,14,8,8,77,58,19,50
Copenhagen,3130,4,12,8,10,57,45,12,44
AaB,3130,5,7,13,10,40,47,-7,34
AC Horsens,3130,6,6,13,11,37,52,-15,31
Sonderjyske,3130,7,8,6,10,28,29,-1,30
Lyngby,3130,8,4,9,11,28,45,-17,21
Randers FC,3130,9,5,6,13,24,41,-17,21
Silkeborg IF,3130,10,6,3,13,28,46,-18,21
AGF Aarhus,3130,11,4,6,12,18,39,-21,18
Brondby,3131,1,20,7,3,70,33,37,67
FC Midtjylla,3131,2,19,6,5,67,42,25,63
FC Nords,3131,3,15,7,8,80,55,25,52
Copenhagen,3131,4,13,6,11,55,45,10,45
AaB,3131,5,7,12,11,40,49,-9,33
AC Horsens,3131,6,7,12,11,37,51,-14,33
Sonderjyske,3131,7,8,6,10,28,29,-1,30
Lyngby,3131,8,4,9,11,27,44,-17,21
Randers FC,3131,9,5,6,13,23,40,-17,21
Silkeborg IF,3131,10,5,4,13,27,46,-19,19
AGF Aarhus,3131,11,4,7,11,18,38,-20,19
Brondby,3132,1,21,7,2,74,35,39,70
FC Midtjylla,3132,2,18,4,8,62,47,15,58
FC Nords,3132,3,15,7,8,76,51,25,52
Copenhagen,3132,4,14,4,12,59,43,16,46
AaB,3132,5,8,12,10,40,42,-2,36
AC Horsens,3132,6,6,14,10,39,58,-19,32
Sonderjyske,3132,7,8,6,10,28,29,-1,30
Lyngby,3132,8,4,9,11,27,44,-17,21
Silkeborg IF,3132,8,6,3,13,27,44,-17,21
Randers FC,3132,10,5,6,13,23,40,-17,21
AGF Aarhus,3132,11,4,6,12,16,38,-22,18
Brondby,3133,1,19,7,4,67,33,34,64
FC Midtjylla,3133,2,20,4,6,65,39,26,64
Copenhagen,3133,3,16,4,10,64,46,18,52
FC Nords,3133,4,13,7,10,71,54,17,46
AaB,3133,5,9,12,9,44,45,-1,39
Sonderjyske,3133,6,8,6,10,28,29,-1,30
AC Horsens,3133,7,6,12,12,37,57,-20,30
Randers FC,3133,8,6,6,12,25,39,-14,24
Silkeborg IF,3133,9,6,3,13,26,44,-18,21
Lyngby,3133,10,3,9,12,26,46,-20,18
AGF Aarhus,3133,11,4,6,12,16,37,-21,18
Brondby,3134,1,22,5,3,75,30,45,71
FC Midtjylla,3134,2,19,5,6,62,38,24,62
Copenhagen,3134,3,14,5,11,58,46,12,47
FC Nords,3134,4,13,7,10,73,58,15,46
AaB,3134,5,8,11,11,40,42,-2,35
AC Horsens,3134,6,7,13,10,33,53,-20,34
Sonderjyske,3134,7,8,6,10,28,29,-1,30
Randers FC,3134,8,6,6,12,26,41,-15,24
AGF Aarhus,3134,9,5,6,11,18,36,-18,21
Lyngby,3134,10,3,9,12,28,47,-19,18
Silkeborg IF,3134,11,5,3,14,25,46,-21,18
Brondby,3135,1,19,7,4,66,34,32,64
FC Midtjylla,3135,2,20,4,6,65,38,27,64
FC Nords,3135,3,15,8,7,74,50,24,53
Copenhagen,3135,4,13,6,11,56,44,12,45
AC Horsens,3135,5,7,14,9,33,47,-14,35
AaB,3135,6,6,13,11,33,40,-7,31
Sonderjyske,3135,7,8,6,10,28,29,-1,30
Lyngby,3135,8,4,9,11,27,44,-17,21
Randers FC,3135,9,5,6,13,23,40,-17,21
Silkeborg IF,3135,10,5,4,13,26,45,-19,19
AGF Aarhus,3135,11,4,7,11,17,37,-20,19
Brondby,3136,1,22,5,3,72,31,41,71
FC Midtjylla,3136,2,20,5,5,67,39,28,65
FC Nords,3136,3,15,7,8,72,51,21,52
Copenhagen,3136,4,13,6,11,54,43,11,45
AaB,3136,5,7,11,12,36,43,-7,32
Sonderjyske,3136,6,8,6,10,28,29,-1,30
AC Horsens,3136,7,6,12,12,34,54,-20,30
Lyngby,3136,8,4,9,11,28,44,-16,21
Randers FC,3136,9,5,6,13,23,41,-18,21
AGF Aarhus,3136,10,5,6,11,17,36,-19,21
Silkeborg IF,3136,11,5,3,14,25,45,-20,18
Brondby,3137,1,22,6,2,72,30,42,72
FC Midtjylla,3137,2,18,6,6,67,39,28,60
Copenhagen,3137,3,15,5,10,59,46,13,50
FC Nords,3137,4,14,7,9,76,52,24,49
AaB,3137,5,6,14,10,37,45,-8,32
Sonderjyske,3137,6,8,6,10,28,29,-1,30
AC Horsens,3137,7,6,12,12,35,60,-25,30
Lyngby,3137,8,4,9,11,28,44,-16,21
Randers FC,3137,9,5,6,13,23,41,-18,21
AGF Aarhus,3137,10,5,6,11,18,36,-18,21
Silkeborg IF,3137,11,5,3,14,25,46,-21,18
Brondby,3138,1,20,5,5,70,33,37,65
FC Midtjylla,3138,2,20,5,5,63,36,27,65
FC Nords,3138,3,15,7,8,74,49,25,52
Copenhagen,3138,4,15,4,11,57,45,12,49
AaB,3138,5,7,12,11,36,43,-7,33
Sonderjyske,3138,6,8,6,10,28,29,-1,30
AC Horsens,3138,7,5,15,10,33,53,-20,30
Randers FC,3138,8,5,7,12,25,41,-16,22
Silkeborg IF,3138,9,6,3,13,27,44,-17,21
Lyngby,3138,10,3,10,11,28,46,-18,19
AGF Aarhus,3138,11,4,6,12,16,38,-22,18
Brondby,3139,1,20,7,3,77,36,41,67
FC Midtjylla,3139,2,19,5,6,65,44,21,62
FC Nords,3139,3,16,7,7,81,49,32,55
Copenhagen,3139,4,14,5,11,63,45,18,47
AaB,3139,5,7,13,10,37,49,-12,34
Sonderjyske,3139,6,8,6,10,28,29,-1,30
AC Horsens,3139,7,5,13,12,33,59,-26,28
Randers FC,3139,8,5,7,12,23,39,-16,22
Lyngby,3139,9,3,10,11,26,44,-18,19
Silkeborg IF,3139,10,5,4,13,25,44,-19,19
AGF Aarhus,3139,11,4,7,11,16,36,-20,19
Brondby,3140,1,19,7,4,68,36,32,64
FC Midtjylla,3140,2,19,7,4,64,37,27,64
FC Nords,3140,3,14,9,7,75,49,26,51
Copenhagen,3140,4,13,5,12,55,47,8,44
AaB,3140,5,8,13,9,38,40,-2,37
AC Horsens,3140,6,6,13,11,33,50,-17,31
Sonderjyske,3140,7,8,6,10,28,29,-1,30
Lyngby,3140,8,4,9,11,29,46,-17,21
Randers FC,3140,9,5,6,13,25,42,-17,21
Silkeborg IF,3140,10,5,4,13,26,45,-19,19
AGF Aarhus,3140,11,4,7,11,17,37,-20,19
Brondby,3141,1,21,6,3,74,32,42,69
FC Midtjylla,3141,2,19,6,5,63,38,25,63
Copenhagen,3141,3,16,4,10,60,40,20,52
FC Nords,3141,4,13,7,10,70,52,18,46
AC Horsens,3141,5,7,12,11,34,55,-21,33
AaB,3141,6,6,13,11,36,46,-10,31
Sonderjyske,3141,7,8,6,10,28,29,-1,30
Randers FC,3141,8,5,7,12,23,39,-16,22
Lyngby,3141,9,3,10,11,26,44,-18,19
Silkeborg IF,3141,10,5,4,13,26,45,-19,19
AGF Aarhus,3141,11,4,7,11,17,37,-20,19
FC Midtjylla,3142,1,20,5,5,70,38,32,65
Brondby,3142,2,19,5,6,65,37,28,62
FC Nords,3142,3,15,7,8,78,53,25,52
Copenhagen,3142,4,14,6,10,64,49,15,48
AaB,3142,5,8,11,11,39,46,-7,35
AC Horsens,3142,6,7,12,11,33,52,-19,33
Sonderjyske,3142,7,8,6,10,28,29,-1,30
Randers FC,3142,8,6,6,12,27,41,-14,24
Silkeborg IF,3142,9,6,3,13,29,46,-17,21
Lyngby,3142,10,3,9,12,28,48,-20,18
AGF Aarhus,3142,11,4,6,12,18,40,-22,18
Brondby,3143,1,21,6,3,70,29,41,69
FC Midtjylla,3143,2,19,5,6,65,42,23,62
FC Nords,3143,3,15,7,8,78,54,24,52
Copenhagen,3143,4,13,5,12,54,44,10,44
AC Horsens,3143,5,7,13,10,34,51,-17,34
AaB,3143,6,7,12,11,38,45,-7,33
Sonderjyske,3143,7,8,6,10,28,29,-1,30
Lyngby,3143,8,4,9,11,28,44,-16,21
Silkeborg IF,3143,9,6,3,13,28,45,-17,21
Randers FC,3143,10,5,6,13,23,41,-18,21
AGF Aarhus,3143,11,4,6,12,17,39,-22,18
Brondby,3144,1,21,6,3,70,32,38,69
FC Midtjylla,3144,2,19,6,5,65,40,25,63
FC Nords,3144,3,14,7,9,77,56,21,49
Copenhagen,3144,4,13,4,13,60,50,10,43
AaB,3144,5,7,14,9,35,40,-5,35
AC Horsens,3144,6,6,15,9,37,52,-15,33
Sonderjyske,3144,7,8,6,10,28,29,-1,30
Silkeborg IF,3144,8,6,3,13,28,44,-16,21
Lyngby,3144,9,4,9,11,27,44,-17,21
Randers FC,3144,10,5,6,13,23,40,-17,21
AGF Aarhus,3144,11,4,6,12,16,39,-23,18
Brondby,3145,1,23,5,2,72,30,42,74
FC Midtjylla,3145,2,20,5,5,66,37,29,65
FC Nords,3145,3,14,7,9,70,52,18,49
Copenhagen,3145,4,13,5,12,60,47,13,44
AaB,3145,5,6,13,11,32,41,-9,31
AC Horsens,3145,6,6,13,11,33,52,-19,31
Sonderjyske,3145,7,8,6,10,28,29,-1,30
Randers FC,3145,8,5,7,12,24,40,-16,22
AGF Aarhus,3145,9,5,6,11,19,37,-18,21
Lyngby,3145,10,3,10,11,27,45,-18,19
Silkeborg IF,3145,11,5,3,14,26,47,-21,18
Brondby,3146,1,22,6,2,76,33,43,72
FC Midtjylla,3146,2,18,4,8,62,46,16,58
FC Nords,3146,3,16,7,7,78,49,29,55
Copenhagen,3146,4,14,5,11,59,46,13,47
AaB,3146,5,7,13,10,43,46,-3,34
Sonderjyske,3146,6,8,6,10,28,29,-1,30
AC Horsens,3146,7,5,13,12,32,56,-24,28
Randers FC,3146,8,6,6,12,25,39,-14,24
Silkeborg IF,3146,9,5,4,13,26,45,-19,19
AGF Aarhus,3146,10,4,7,11,17,37,-20,19
Lyngby,3146,11,3,9,12,26,46,-20,18
Brondby,3147,1,18,6,6,63,34,29,60
FC Midtjylla,3147,2,18,5,7,58,39,19,59
FC Nords,3147,3,16,6,8,76,48,28,54
Copenhagen,3147,4,16,4,10,61,44,17,52
AC Horsens,3147,5,8,13,9,39,50,-11,37
AaB,3147,6,7,12,11,35,43,-8,33
Sonderjyske,3147,7,8,6,10,28,29,-1,30
Randers FC,3147,8,5,7,12,24,40,-16,22
Silkeborg IF,3147,9,6,3,13,29,45,-16,21
Lyngby,3147,10,3,10,11,27,45,-18,19
AGF Aarhus,3147,11,4,6,12,17,40,-23,18
Brondby,3148,1,21,6,3,73,33,40,69
FC Midtjylla,3148,2,19,4,7,68,44,24,61
Copenhagen,3148,3,15,5,10,60,46,14,50
FC Nords,3148,4,14,7,9,74,53,21,49
AaB,3148,5,9,11,10,37,42,-5,38
Sonderjyske,3148,6,8,6,10,28,29,-1,30
AC Horsens,3148,7,5,13,12,32,52,-20,28
Randers FC,3148,8,6,6,12,24,39,-15,24
Silkeborg IF,3148,9,6,3,13,27,45,-18,21
Lyngby,3148,10,3,9,12,26,45,-19,18
AGF Aarhus,3148,11,4,6,12,17,38,-21,18
Brondby,3149,1,21,7,2,71,31,40,70
FC Midtjylla,3149,2,20,5,5,69,41,28,65
FC Nords,3149,3,15,7,8,75,52,23,52
Copenhagen,3149,4,14,5,11,63,47,16,47
AaB,3149,5,6,13,11,34,44,-10,31
Sonderjyske,3149,6,8,6,10,28,29,-1,30
AC Horsens,3149,7,5,13,12,35,58,-23,28
Randers FC,3149,8,6,6,12,24,39,-15,24
Silkeborg IF,3149,9,5,4,13,26,45,-19,19
AGF Aarhus,3149,10,4,7,11,17,37,-20,19
Lyngby,3149,11,3,9,12,26,45,-19,18
Brondby,3150,1,19,5,6,63,34,29,62
FC Midtjylla,3150,2,19,5,6,69,41,28,62
Copenhagen,3150,3,15,5,10,63,46,17,50
FC Nords,3150,4,14,7,9,74,56,18,49
AaB,3150,5,9,12,9,41,40,1,39
AC Horsens,3150,6,7,12,11,38,57,-19,33
Sonderjyske,3150,7,8,6,10,28,29,-1,30
Randers FC,3150,8,5,7,12,23,39,-16,22
Silkeborg IF,3150,9,6,3,13,27,45,-18,21
Lyngby,3150,10,3,10,11,26,44,-18,19
AGF Aarhus,3150,11,4,6,12,17,38,-21,18
Brondby,3151,1,21,6,3,72,32,40,69
FC Midtjylla,3151,2,20,4,6,61,41,20,64
FC Nords,3151,3,15,7,8,79,49,30,52
Copenhagen,3151,4,14,6,10,56,42,14,48
AC Horsens,3151,5,6,13,11,35,53,-18,31
Sonderjyske,3151,6,8,6,10,28,29,-1,30
AaB,3151,7,6,12,12,37,49,-12,30
Randers FC,3151,8,5,7,12,24,40,-16,22
Silkeborg IF,3151,9,6,3,13,28,46,-18,21
Lyngby,3151,10,3,10,11,27,45,-18,19
AGF Aarhus,3151,11,4,6,12,18,39,-21,18
Brondby,3152,1,21,5,4,73,37,36,68
FC Midtjylla,3152,2,20,4,6,64,41,23,64
FC Nords,3152,3,14,6,10,75,55,20,48
Copenhagen,3152,4,13,6,11,56,42,14,45
AC Horsens,3152,5,8,13,9,37,52,-15,37
AaB,3152,6,7,12,11,38,42,-4,33
Sonderjyske,3152,7,8,6,10,28,29,-1,30
Randers FC,3152,8,6,6,12,25,39,-14,24
Silkeborg IF,3152,9,6,3,13,27,44,-17,21
Lyngby,3152,10,3,9,12,26,46,-20,18
AGF Aarhus,3152,11,4,6,12,16,38,-22,18
Brondby,3153,1,22,6,2,69,29,40,72
FC Midtjylla,3153,2,20,4,6,64,38,26,64
FC Nords,3153,3,15,6,9,78,52,26,51
Copenhagen,3153,4,14,4,12,57,45,12,46
AaB,3153,5,7,11,12,35,43,-8,32
AC Horsens,3153,6,6,13,11,33,55,-22,31
Sonderjyske,3153,7,8,6,10,28,29,-1,30
Randers FC,3153,8,6,6,12,26,40,-14,24
Silkeborg IF,3153,9,6,3,13,28,44,-16,21
Lyngby,3153,10,3,9,12,27,47,-20,18
AGF Aarhus,3153,11,4,6,12,16,39,-23,18
Brondby,3154,1,20,5,5,69,37,32,65
FC Midtjylla,3154,2,20,5,5,69,43,26,65
FC Nords,3154,3,13,7,10,74,57,17,46
Copenhagen,3154,4,13,6,11,58,46,12,45
AC Horsens,3154,5,9,12,9,40,47,-7,39
AaB,3154,6,7,13,10,37,43,-6,34
Sonderjyske,3154,7,8,6,10,28,29,-1,30
Randers FC,3154,8,6,6,12,27,40,-13,24
Silkeborg IF,3154,9,5,4,13,26,45,-19,19
AGF Aarhus,3154,10,4,7,11,17,37,-20,19
Lyngby,3154,11,3,9,12,27,48,-21,18
Brondby,3155,1,21,5,4,71,33,38,68
FC Midtjylla,3155,2,20,5,5,70,35,35,65
Copenhagen,3155,3,14,5,11,60,45,15,47
FC Nords,3155,4,13,7,10,71,58,13,46
AaB,3155,5,8,11,11,34,46,-12,35
AC Horsens,3155,6,6,15,9,36,51,-15,33
Sonderjyske,3155,7,8,6,10,28,29,-1,30
Lyngby,3155,8,4,9,11,28,44,-16,21
Silkeborg IF,3155,9,6,3,13,26,44,-18,21
Randers FC,3155,10,5,6,13,23,41,-18,21
AGF Aarhus,3155,11,4,6,12,16,37,-21,18
Brondby,3156,1,22,5,3,74,29,45,71
FC Midtjylla,3156,2,18,5,7,65,47,18,59
FC Nords,3156,3,14,7,9,73,55,18,49
Copenhagen,3156,4,14,6,10,56,40,16,48
AaB,3156,5,8,11,11,37,42,-5,35
AC Horsens,3156,6,7,12,11,37,55,-18,33
Sonderjyske,3156,7,8,6,10,28,29,-1,30
Randers FC,3156,8,5,7,12,25,41,-16,22
AGF Aarhus,3156,9,5,6,11,17,36,-19,21
Lyngby,3156,10,3,10,11,28,46,-18,19
Silkeborg IF,3156,11,5,3,14,25,45,-20,18
Brondby,3157,1,21,7,2,69,30,39,70
FC Midtjylla,3157,2,20,4,6,62,38,24,64
FC Nords,3157,3,15,7,8,75,50,25,52
Copenhagen,3157,4,13,5,12,56,47,9,44
AaB,3157,5,8,11,11,35,39,-4,35
Sonderjyske,3157,6,8,6,10,28,29,-1,30
AC Horsens,3157,7,6,12,12,37,56,-19,30
Randers FC,3157,8,6,6,12,24,39,-15,24
Silkeborg IF,3157,9,6,3,13,28,45,-17,21
Lyngby,3157,10,3,9,12,26,45,-19,18
AGF Aarhus,3157,11,4,6,12,17,39,-22,18
Brondby,3158,1,19,8,3,71,38,33,65
FC Midtjylla,3158,2,19,4,7,65,41,24,61
FC Nords,3158,3,14,6,10,70,50,20,48
Copenhagen,3158,4,14,5,11,55,44,11,47
AaB,3158,5,9,13,8,39,37,2,40
AC Horsens,3158,6,6,14,10,36,52,-16,32
Sonderjyske,3158,7,8,6,10,28,29,-1,30
Randers FC,3158,8,5,7,12,24,40,-16,22
Silkeborg IF,3158,9,6,3,13,26,44,-18,21
Lyngby,3158,10,3,10,11,27,45,-18,19
AGF Aarhus,3158,11,4,6,12,16,37,-21,18
Brondby,3159,1,21,6,3,74,34,40,69
FC Midtjylla,3159,2,21,4,5,74,38,36,67
FC Nords,3159,3,14,7,9,72,52,20,49
Copenhagen,3159,4,14,5,11,55,45,10,47
AaB,3159,5,6,13,11,36,47,-11,31
AC Horsens,3159,6,6,13,11,32,53,-21,31
Sonderjyske,3159,7,8,6,10,28,29,-1,30
Randers FC,3159,8,6,6,12,24,39,-15,24
Silkeborg IF,3159,9,6,3,13,30,46,-16,21
Lyngby,3159,10,3,9,12,26,45,-19,18
AGF Aarhus,3159,11,4,6,12,18,41,-23,18
Brondby,3160,1,20,5,5,67,35,32,65
FC Midtjylla,3160,2,20,4,6,71,40,31,64
FC Nords,3160,3,14,7,9,69,50,19,49
Copenhagen,3160,4,14,5,11,57,43,14,47
AaB,3160,5,9,11,10,38,41,-3,38
AC Horsens,3160,6,6,14,10,36,55,-19,32
Sonderjyske,3160,7,8,6,10,28,29,-1,30
Randers FC,3160,8,5,7,12,24,40,-16,22
AGF Aarhus,3160,9,5,6,11,19,38,-19,21
Lyngby,3160,10,3,10,11,27,45,-18,19
Silkeborg IF,3160,11,5,3,14,27,47,-20,18
Brondby,3161,1,21,6,3,72,34,38,69
FC Midtjylla,3161,2,19,5,6,66,41,25,62
Copenhagen,3161,3,15,5,10,62,43,19,50
FC Nords,3161,4,14,6,10,77,56,21,48
AaB,3161,5,7,12,11,39,45,-6,33
AC Horsens,3161,6,7,12,11,32,55,-23,33
Sonderjyske,3161,7,8,6,10,28,29,-1,30
Lyngby,3161,8,4,9,11,27,44,-17,21
Randers FC,3161,9,5,6,13,23,40,-17,21
Silkeborg IF,3161,10,5,4,13,26,45,-19,19
AGF Aarhus,3161,11,4,7,11,17,37,-20,19
FC Midtjylla,3162,1,20,5,5,62,37,25,65
Brondby,3162,2,19,7,4,70,31,39,64
FC Nords,3162,3,14,6,10,71,57,14,48
Copenhagen,3162,4,14,6,10,56,42,14,48
AaB,3162,5,8,11,11,39,43,-4,35
AC Horsens,3162,6,7,13,10,38,52,-14,34
Sonderjyske,3162,7,8,6,10,28,29,-1,30
Randers FC,3162,8,6,6,12,27,39,-12,24
Silkeborg IF,3162,9,6,3,13,26,44,-18,21
AGF Aarhus,3162,10,4,6,12,16,37,-21,18
Lyngby,3162,11,3,9,12,26,48,-22,18
Brondby,3163,1,20,6,4,68,33,35,66
FC Midtjylla,3163,2,18,5,7,64,44,20,59
FC Nords,3163,3,16,7,7,77,49,28,55
Copenhagen,3163,4,14,5,11,58,45,13,47
AaB,3163,5,9,12,9,37,38,-1,39
Sonderjyske,3163,6,8,6,10,28,29,-1,30
AC Horsens,3163,7,5,13,12,31,52,-21,28
Randers FC,3163,8,5,7,12,23,39,-16,22
AGF Aarhus,3163,9,5,6,11,17,36,-19,21
Lyngby,3163,10,3,10,11,26,44,-18,19
Silkeborg IF,3163,11,5,3,14,25,45,-20,18
Brondby,3164,1,22,5,3,75,31,44,71
FC Midtjylla,3164,2,21,5,4,69,38,31,68
FC Nords,3164,3,13,7,10,71,53,18,46
Copenhagen,3164,4,13,5,12,59,51,8,44
AaB,3164,5,8,12,10,37,45,-8,36
Sonderjyske,3164,6,8,6,10,28,29,-1,30
AC Horsens,3164,7,6,12,12,35,54,-19,30
Randers FC,3164,8,5,7,12,24,40,-16,22
Silkeborg IF,3164,9,6,3,13,26,44,-18,21
Lyngby,3164,10,3,10,11,27,45,-18,19
AGF Aarhus,3164,11,4,6,12,16,37,-21,18
Brondby,3165,1,22,5,3,73,34,39,71
FC Midtjylla,3165,2,19,6,5,65,41,24,63
FC Nords,3165,3,13,8,9,76,56,20,47
Copenhagen,3165,4,14,5,11,58,43,15,47
AaB,3165,5,7,13,10,35,40,-5,34
AC Horsens,3165,6,6,13,11,33,52,-19,31
Sonderjyske,3165,7,8,6,10,28,29,-1,30
Randers FC,3165,8,6,6,12,25,40,-15,24
Silkeborg IF,3165,9,6,3,13,27,44,-17,21
Lyngby,3165,10,3,9,12,27,46,-19,18
AGF Aarhus,3165,11,4,6,12,16,38,-22,18
Brondby,3166,1,22,6,2,75,29,46,72
FC Midtjylla,3166,2,18,7,5,61,39,22,61
FC Nords,3166,3,13,9,8,73,51,22,48
Copenhagen,3166,4,13,6,11,56,45,11,45
AaB,3166,5,6,14,10,34,42,-8,32
AC Horsens,3166,6,5,16,9,35,54,-19,31
Sonderjyske,3166,7,8,6,10,28,29,-1,30
Randers FC,3166,8,5,7,12,23,39,-16,22
AGF Aarhus,3166,9,5,6,11,20,37,-17,21
Lyngby,3166,10,3,10,11,26,44,-18,19
Silkeborg IF,3166,11,5,3,14,26,48,-22,18
Brondby,3167,1,20,6,4,70,33,37,66
FC Midtjylla,3167,2,18,5,7,65,44,21,59
Copenhagen,3167,3,17,4,9,63,44,19,55
FC Nords,3167,4,13,7,10,72,54,18,46
AaB,3167,5,7,14,9,36,40,-4,35
AC Horsens,3167,6,6,14,10,39,56,-17,32
Sonderjyske,3167,7,8,6,10,28,29,-1,30
Randers FC,3167,8,5,7,12,25,41,-16,22
Lyngby,3167,9,3,10,11,28,46,-18,19
Silkeborg IF,3167,10,5,4,13,27,46,-19,19
AGF Aarhus,3167,11,4,7,11,18,38,-20,19
Brondby,3168,1,20,6,4,67,32,35,66
FC Midtjylla,3168,2,18,6,6,63,40,23,60
FC Nords,3168,3,14,9,7,72,49,23,51
Copenhagen,3168,4,13,7,10,56,42,14,46
AC Horsens,3168,5,7,15,8,37,49,-12,36
AaB,3168,6,6,13,11,34,43,-9,31
Sonderjyske,3168,7,8,6,10,28,29,-1,30
Randers FC,3168,8,5,7,12,24,40,-16,22
AGF Aarhus,3168,9,5,6,11,19,37,-18,21
Lyngby,3168,10,3,10,11,27,45,-18,19
Silkeborg IF,3168,11,5,3,14,26,47,-21,18
Brondby,3169,1,21,6,3,72,32,40,69
FC Midtjylla,3169,2,20,5,5,64,36,28,65
FC Nords,3169,3,13,8,9,71,56,15,47
Copenhagen,3169,4,14,5,11,60,46,14,47
AaB,3169,5,8,13,9,36,39,-3,37
Sonderjyske,3169,6,8,6,10,28,29,-1,30
AC Horsens,3169,7,5,13,12,34,54,-20,28
Lyngby,3169,8,4,9,11,28,45,-17,21
Randers FC,3169,9,5,6,13,24,41,-17,21
Silkeborg IF,3169,10,5,4,13,26,45,-19,19
AGF Aarhus,3169,11,4,7,11,17,37,-20,19
Brondby,3170,1,22,6,2,72,29,43,72
FC Midtjylla,3170,2,20,5,5,68,37,31,65
FC Nords,3170,3,13,7,10,70,55,15,46
Copenhagen,3170,4,13,6,11,58,45,13,45
AC Horsens,3170,5,7,12,11,35,55,-20,33
AaB,3170,6,6,14,10,36,44,-8,32
Sonderjyske,3170,7,8,6,10,28,29,-1,30
Lyngby,3170,8,4,9,11,28,45,-17,21
Randers FC,3170,9,5,6,13,24,41,-17,21
Silkeborg IF,3170,10,6,3,13,28,46,-18,21
AGF Aarhus,3170,11,4,6,12,18,39,-21,18
Brondby,3171,1,21,5,4,68,32,36,68
FC Midtjylla,3171,2,19,4,7,63,42,21,61
FC Nords,3171,3,14,7,9,72,49,23,49
Copenhagen,3171,4,13,4,13,52,45,7,43
AaB,3171,5,9,11,10,38,41,-3,38
AC Horsens,3171,6,8,13,9,38,48,-10,37
Sonderjyske,3171,7,8,6,10,28,29,-1,30
Randers FC,3171,8,6,6,12,26,39,-13,24
Silkeborg IF,3171,9,6,3,13,27,44,-17,21
Lyngby,3171,10,3,9,12,26,47,-21,18
AGF Aarhus,3171,11,4,6,12,16,38,-22,18
Brondby,3172,1,21,5,4,73,36,37,68
FC Midtjylla,3172,2,18,5,7,66,44,22,59
FC Nords,3172,3,15,6,9,72,51,21,51
Copenhagen,3172,4,13,5,12,58,44,14,44
AaB,3172,5,9,11,10,40,43,-3,38
AC Horsens,3172,6,8,12,10,37,54,-17,36
Sonderjyske,3172,7,8,6,10,28,29,-1,30
Lyngby,3172,8,4,9,11,28,45,-17,21
Randers FC,3172,9,5,6,13,24,41,-17,21
AGF Aarhus,3172,10,5,6,11,17,36,-19,21
Silkeborg IF,3172,11,5,3,14,25,45,-20,18
Brondby,3173,1,23,5,2,77,31,46,74
FC Midtjylla,3173,2,20,5,5,69,42,27,65
FC Nords,3173,3,13,8,9,71,51,20,47
Copenhagen,3173,4,12,5,13,53,45,8,41
AaB,3173,5,7,13,10,39,48,-9,34
AC Horsens,3173,6,7,12,11,35,53,-18,33
Sonderjyske,3173,7,8,6,10,28,29,-1,30
Randers FC,3173,8,6,6,12,24,39,-15,24
Silkeborg IF,3173,9,6,3,13,27,44,-17,21
Lyngby,3173,10,3,9,12,26,45,-19,18
AGF Aarhus,3173,11,4,6,12,16,38,-22,18
Brondby,3174,1,22,5,3,74,27,47,71
FC Midtjylla,3174,2,19,6,5,69,42,27,63
FC Nords,3174,3,15,6,9,76,57,19,51
Copenhagen,3174,4,15,5,10,54,40,14,50
AC Horsens,3174,5,6,13,11,35,54,-19,31
Sonderjyske,3174,6,8,6,10,28,29,-1,30
AaB,3174,7,6,11,13,36,50,-14,29
Randers FC,3174,8,6,6,12,25,40,-15,24
Silkeborg IF,3174,9,6,3,13,26,44,-18,21
Lyngby,3174,10,3,9,12,27,46,-19,18
AGF Aarhus,3174,11,4,6,12,16,37,-21,18
Brondby,3175,1,20,7,3,73,32,41,67
FC Midtjylla,3175,2,19,5,6,64,39,25,62
FC Nords,3175,3,13,8,9,74,56,18,47
Copenhagen,3175,4,13,8,9,55,41,14,47
AaB,3175,5,8,13,9,38,41,-3,37
AC Horsens,3175,6,6,13,11,31,52,-21,31
Sonderjyske,3175,7,8,6,10,28,29,-1,30
Randers FC,3175,8,5,7,12,24,40,-16,22
AGF Aarhus,3175,9,5,6,11,20,39,-19,21
Lyngby,3175,10,3,10,11,27,45,-18,19
Silkeborg IF,3175,11,5,3,14,28,48,-20,18
Brondby,3176,1,20,6,4,71,34,37,66
FC Midtjylla,3176,2,20,5,5,72,44,28,65
FC Nords,3176,3,15,6,9,75,53,22,51
Copenhagen,3176,4,15,5,10,61,46,15,50
AaB,3176,5,7,13,10,38,43,-5,34
Sonderjyske,3176,6,8,6,10,28,29,-1,30
AC Horsens,3176,7,5,13,12,34,57,-23,28
Lyngby,3176,8,4,9,11,28,44,-16,21
Randers FC,3176,9,5,6,13,23,41,-18,21
AGF Aarhus,3176,10,5,6,11,19,37,-18,21
Silkeborg IF,3176,11,5,3,14,26,47,-21,18
Brondby,3177,1,20,7,3,70,34,36,67
FC Midtjylla,3177,2,20,5,5,69,37,32,65
Copenhagen,3177,3,14,6,10,64,46,18,48
FC Nords,3177,4,13,8,9,72,51,21,47
AaB,3177,5,8,12,10,37,41,-4,36
Sonderjyske,3177,6,8,6,10,28,29,-1,30
AC Horsens,3177,7,6,12,12,34,63,-29,30
Randers FC,3177,8,5,7,12,24,40,-16,22
Silkeborg IF,3177,9,6,3,13,30,48,-18,21
Lyngby,3177,10,3,10,11,27,45,-18,19
AGF Aarhus,3177,11,4,6,12,20,41,-21,18
FC Midtjylla,3178,1,22,4,4,72,36,36,70
Brondby,3178,2,21,6,3,78,36,42,69
FC Nords,3178,3,13,7,10,69,56,13,46
Copenhagen,3178,4,13,6,11,55,44,11,45
AC Horsens,3178,5,7,12,11,33,51,-18,33
AaB,3178,6,7,11,12,36,46,-10,32
Sonderjyske,3178,7,8,6,10,28,29,-1,30
Lyngby,3178,8,4,9,11,27,44,-17,21
Randers FC,3178,9,5,6,13,23,40,-17,21
Silkeborg IF,3178,10,6,3,13,28,46,-18,21
AGF Aarhus,3178,11,4,6,12,18,39,-21,18
Brondby,3179,1,19,7,4,68,34,34,64
FC Midtjylla,3179,2,19,5,6,63,39,24,62
FC Nords,3179,3,15,7,8,75,48,27,52
Copenhagen,3179,4,13,5,12,54,46,8,44
AaB,3179,5,8,13,9,36,40,-4,37
AC Horsens,3179,6,7,13,10,35,50,-15,34
Sonderjyske,3179,7,8,6,10,28,29,-1,30
Lyngby,3179,8,4,9,11,30,45,-15,21
Silkeborg IF,3179,9,6,3,13,26,44,-18,21
Randers FC,3179,10,5,6,13,24,43,-19,21
AGF Aarhus,3179,11,4,6,12,16,37,-21,18
Brondby,3180,1,20,6,4,71,35,36,66
FC Midtjylla,3180,2,20,5,5,66,38,28,65
FC Nords,3180,3,14,8,8,76,56,20,50
Copenhagen,3180,4,14,5,11,64,48,16,47
AC Horsens,3180,5,6,15,9,36,51,-15,33
AaB,3180,6,6,13,11,36,47,-11,31
Sonderjyske,3180,7,8,6,10,28,29,-1,30
Randers FC,3180,8,5,7,12,24,40,-16,22
AGF Aarhus,3180,9,5,6,11,18,37,-19,21
Lyngby,3180,10,3,10,11,27,45,-18,19
Silkeborg IF,3180,11,5,3,14,26,46,-20,18
Brondby,3181,1,22,6,2,79,32,47,72
FC Midtjylla,3181,2,20,5,5,68,39,29,65
FC Nords,3181,3,13,7,10,72,60,12,46
Copenhagen,3181,4,14,4,12,58,47,11,46
AaB,3181,5,7,13,10,37,44,-7,34
Sonderjyske,3181,6,8,6,10,28,29,-1,30
AC Horsens,3181,7,5,15,10,37,55,-18,30
Randers FC,3181,8,6,6,12,24,39,-15,24
Silkeborg IF,3181,9,6,3,13,27,45,-18,21
Lyngby,3181,10,3,9,12,26,45,-19,18
AGF Aarhus,3181,11,4,6,12,17,38,-21,18
Brondby,3182,1,21,7,2,70,32,38,70
FC Midtjylla,3182,2,19,5,6,63,36,27,62
Copenhagen,3182,3,15,5,10,62,43,19,50
FC Nords,3182,4,13,8,9,69,53,16,47
AaB,3182,5,6,13,11,37,45,-8,31
AC Horsens,3182,6,5,16,9,35,53,-18,31
Sonderjyske,3182,7,8,6,10,28,29,-1,30
Randers FC,3182,8,6,6,12,26,39,-13,24
Silkeborg IF,3182,9,5,4,13,26,45,-19,19
AGF Aarhus,3182,10,4,7,11,17,37,-20,19
Lyngby,3182,11,3,9,12,26,47,-21,18
Brondby,3183,1,21,6,3,72,32,40,69
FC Midtjylla,3183,2,19,5,6,66,41,25,62
FC Nords,3183,3,14,8,8,74,49,25,50
Copenhagen,3183,4,13,5,12,55,46,9,44
AaB,3183,5,9,12,9,38,41,-3,39
Sonderjyske,3183,6,8,6,10,28,29,-1,30
AC Horsens,3183,7,5,14,11,34,56,-22,29
Lyngby,3183,8,4,9,11,28,44,-16,21
Randers FC,3183,9,5,6,13,23,41,-18,21
Silkeborg IF,3183,10,5,4,13,27,46,-19,19
AGF Aarhus,3183,11,4,7,11,18,38,-20,19
Brondby,3184,1,20,7,3,70,34,36,67
FC Midtjylla,3184,2,19,6,5,65,37,28,63
FC Nords,3184,3,13,9,8,77,54,23,48
Copenhagen,3184,4,13,6,11,57,49,8,45
AaB,3184,5,8,12,10,38,43,-5,36
AC Horsens,3184,6,5,16,9,35,51,-16,31
Sonderjyske,3184,7,8,6,10,28,29,-1,30
Randers FC,3184,8,6,6,12,25,39,-14,24
Silkeborg IF,3184,9,5,4,13,26,45,-19,19
AGF Aarhus,3184,10,4,7,11,17,37,-20,19
Lyngby,3184,11,3,9,12,26,46,-20,18
FC Midtjylla,3185,1,20,6,4,67,37,30,66
Brondby,3185,2,20,5,5,68,37,31,65
FC Nords,3185,3,14,6,10,71,52,19,48
Copenhagen,3185,4,14,5,11,57,43,14,47
AC Horsens,3185,5,7,14,9,37,50,-13,35
AaB,3185,6,7,12,11,36,43,-7,33
Sonderjyske,3185,7,8,6,10,28,29,-1,30
Randers FC,3185,8,5,7,12,25,41,-16,22
Lyngby,3185,9,3,10,11,28,46,-18,19
Silkeborg IF,3185,10,5,4,13,26,45,-19,19
AGF Aarhus,3185,11,4,7,11,17,37,-20,19
Brondby,3186,1,22,6,2,70,29,41,72
FC Midtjylla,3186,2,20,5,5,68,37,31,65
FC Nords,3186,3,14,6,10,75,53,22,48
Copenhagen,3186,4,12,7,11,57,48,9,43
AC Horsens,3186,5,7,13,10,37,55,-18,34
AaB,3186,6,6,13,11,35,46,-11,31
Sonderjyske,3186,7,8,6,10,28,29,-1,30
Randers FC,3186,8,5,7,12,23,39,-16,22
Lyngby,3186,9,3,10,11,26,44,-18,19
Silkeborg IF,3186,10,5,4,13,25,44,-19,19
AGF Aarhus,3186,11,4,7,11,16,36,-20,19
Brondby,3187,1,23,5,2,77,32,45,74
FC Midtjylla,3187,2,19,5,6,66,40,26,62
FC Nords,3187,3,14,7,9,73,54,19,49
Copenhagen,3187,4,13,4,13,56,48,8,43
AC Horsens,3187,5,8,12,10,36,49,-13,36
AaB,3187,6,7,11,12,36,47,-11,32
Sonderjyske,3187,7,8,6,10,28,29,-1,30
Lyngby,3187,8,4,9,11,28,45,-17,21
Randers FC,3187,9,5,6,13,24,41,-17,21
AGF Aarhus,3187,10,5,6,11,17,36,-19,21
Silkeborg IF,3187,11,5,3,14,25,45,-20,18
Brondby,3188,1,22,5,3,73,29,44,71
FC Midtjylla,3188,2,19,6,5,65,41,24,63
FC Nords,3188,3,14,7,9,77,55,22,49
Copenhagen,3188,4,14,5,11,60,45,15,47
AaB,3188,5,7,11,12,36,46,-10,32
AC Horsens,3188,6,6,14,10,35,56,-21,32
Sonderjyske,3188,7,8,6,10,28,29,-1,30
Randers FC,3188,8,5,7,12,24,40,-16,22
Lyngby,3188,9,3,10,11,27,45,-18,19
Silkeborg IF,3188,10,5,4,13,25,44,-19,19
AGF Aarhus,3188,11,4,7,11,16,36,-20,19
Brondby,3189,1,22,5,3,70,31,39,71
FC Midtjylla,3189,2,19,4,7,68,42,26,61
FC Nords,3189,3,15,6,9,76,54,22,51
Copenhagen,3189,4,13,5,12,56,45,11,44
AaB,3189,5,8,12,10,38,44,-6,36
AC Horsens,3189,6,7,12,11,38,56,-18,33
Sonderjyske,3189,7,8,6,10,28,29,-1,30
Randers FC,3189,8,5,7,12,24,40,-16,22
AGF Aarhus,3189,9,5,6,11,17,36,-19,21
Lyngby,3189,10,3,10,11,27,45,-18,19
Silkeborg IF,3189,11,5,3,14,25,45,-20,18
FC Midtjylla,3190,1,21,5,4,75,39,36,68
Brondby,3190,2,20,5,5,70,37,33,65
FC Nords,3190,3,14,6,10,73,54,19,48
Copenhagen,3190,4,14,5,11,56,43,13,47
AC Horsens,3190,5,7,13,10,35,52,-17,34
AaB,3190,6,7,12,11,36,46,-10,33
Sonderjyske,3190,7,8,6,10,28,29,-1,30
Lyngby,3190,8,4,9,11,27,44,-17,21
Randers FC,3190,9,5,6,13,23,40,-17,21
AGF Aarhus,3190,10,5,6,11,18,36,-18,21
Silkeborg IF,3190,11,5,3,14,25,46,-21,18
Brondby,3191,1,22,5,3,71,30,41,71
FC Midtjylla,3191,2,19,5,6,64,42,22,62
FC Nords,3191,3,17,6,7,78,47,31,57
Copenhagen,3191,4,14,5,11,57,45,12,47
Sonderjyske,3191,5,8,6,10,28,29,-1,30
AaB,3191,6,6,12,12,35,45,-10,30
AC Horsens,3191,7,5,13,12,36,58,-22,28
Randers FC,3191,8,5,7,12,23,39,-16,22
Lyngby,3191,9,3,10,11,26,44,-18,19
Silkeborg IF,3191,10,5,4,13,26,45,-19,19
AGF Aarhus,3191,11,4,7,11,17,37,-20,19
Brondby,3192,1,19,6,5,68,36,32,63
FC Midtjylla,3192,2,19,5,6,64,40,24,62
FC Nords,3192,3,14,9,7,74,50,24,51
Copenhagen,3192,4,14,5,11,55,42,13,47
AC Horsens,3192,5,8,12,10,36,51,-15,36
AaB,3192,6,7,13,10,40,44,-4,34
Sonderjyske,3192,7,8,6,10,28,29,-1,30
Randers FC,3192,8,5,7,12,24,40,-16,22
Silkeborg IF,3192,9,6,3,13,28,45,-17,21
Lyngby,3192,10,3,10,11,27,45,-18,19
AGF Aarhus,3192,11,4,6,12,17,39,-22,18
Brondby,3193,1,20,6,4,69,35,34,66
FC Midtjylla,3193,2,20,5,5,65,35,30,65
FC Nords,3193,3,15,6,9,76,53,23,51
Copenhagen,3193,4,15,4,11,59,44,15,49
AaB,3193,5,9,11,10,43,46,-3,38
Sonderjyske,3193,6,8,6,10,28,29,-1,30
AC Horsens,3193,7,5,12,13,30,55,-25,27
Lyngby,3193,8,4,9,11,27,44,-17,21
Randers FC,3193,9,5,6,13,23,40,-17,21
Silkeborg IF,3193,10,5,4,13,26,45,-19,19
AGF Aarhus,3193,11,4,7,11,17,37,-20,19
Brondby,3194,1,20,6,4,72,33,39,66
FC Midtjylla,3194,2,19,6,5,68,42,26,63
FC Nords,3194,3,15,6,9,77,55,22,51
Copenhagen,3194,4,13,4,13,59,48,11,43
AaB,3194,5,9,12,9,40,45,-5,39
AC Horsens,3194,6,7,12,11,37,56,-19,33
Sonderjyske,3194,7,8,6,10,28,29,-1,30
Randers FC,3194,8,6,6,12,26,39,-13,24
Silkeborg IF,3194,9,6,3,13,28,44,-16,21
Lyngby,3194,10,3,9,12,26,47,-21,18
AGF Aarhus,3194,11,4,6,12,16,39,-23,18
Brondby,3195,1,20,7,3,72,35,37,67
FC Midtjylla,3195,2,19,4,7,63,40,23,61
FC Nords,3195,3,14,8,8,75,51,24,50
Copenhagen,3195,4,14,7,9,60,43,17,49
AaB,3195,5,8,13,9,38,39,-1,37
Sonderjyske,3195,6,8,6,10,28,29,-1,30
AC Horsens,3195,7,5,13,12,33,59,-26,28
Randers FC,3195,8,6,6,12,25,39,-14,24
AGF Aarhus,3195,9,5,6,11,17,36,-19,21
Lyngby,3195,10,3,9,12,26,46,-20,18
Silkeborg IF,3195,11,5,3,14,25,45,-20,18
FC Midtjylla,3196,1,21,5,4,67,38,29,68
Brondby,3196,2,19,7,4,72,37,35,64
FC Nords,3196,3,14,9,7,77,51,26,51
Copenhagen,3196,4,12,8,10,55,43,12,44
AC Horsens,3196,5,7,13,10,39,54,-15,34
Sonderjyske,3196,6,8,6,10,28,29,-1,30
AaB,3196,7,6,12,12,38,51,-13,30
Randers FC,3196,8,5,7,12,23,39,-16,22
Silkeborg IF,3196,9,6,3,13,27,45,-18,21
Lyngby,3196,10,3,10,11,26,44,-18,19
AGF Aarhus,3196,11,4,6,12,17,38,-21,18
Brondby,3197,1,21,6,3,74,32,42,69
FC Midtjylla,3197,2,19,5,6,64,44,20,62
Copenhagen,3197,3,15,4,11,60,44,16,49
FC Nords,3197,4,13,7,10,70,52,18,46
AaB,3197,5,8,11,11,36,42,-6,35
AC Horsens,3197,6,7,13,10,35,51,-16,34
Sonderjyske,3197,7,8,6,10,28,29,-1,30
Randers FC,3197,8,6,6,12,25,39,-14,24
Silkeborg IF,3197,9,6,3,13,26,44,-18,21
Lyngby,3197,10,3,9,12,26,46,-20,18
AGF Aarhus,3197,11,4,6,12,16,37,-21,18
Brondby,3198,1,22,5,3,70,31,39,71
FC Midtjylla,3198,2,20,4,6,70,36,34,64
FC Nords,3198,3,14,7,9,74,54,20,49
Copenhagen,3198,4,14,5,11,57,47,10,47
AaB,3198,5,8,11,11,36,41,-5,35
Sonderjyske,3198,6,8,6,10,28,29,-1,30
AC Horsens,3198,7,6,12,12,34,58,-24,30
Randers FC,3198,8,6,6,12,26,40,-14,24
AGF Aarhus,3198,9,5,6,11,19,37,-18,21
Lyngby,3198,10,3,9,12,27,47,-20,18
Silkeborg IF,3198,11,5,3,14,26,47,-21,18
Brondby,3199,1,21,5,4,73,32,41,68
FC Midtjylla,3199,2,19,5,6,67,42,25,62
Copenhagen,3199,3,15,5,10,60,43,17,50
FC Nords,3199,4,14,7,9,72,55,17,49
AC Horsens,3199,5,6,15,9,38,51,-13,33
AaB,3199,6,7,11,12,37,50,-13,32
Sonderjyske,3199,7,8,6,10,28,29,-1,30
Randers FC,3199,8,5,7,12,23,39,-16,22
Silkeborg IF,3199,9,6,3,13,26,44,-18,21
Lyngby,3199,10,3,10,11,26,44,-18,19
AGF Aarhus,3199,11,4,6,12,16,37,-21,18
Brondby,3200,1,20,8,2,69,31,38,68
FC Midtjylla,3200,2,19,6,5,66,39,27,63
FC Nords,3200,3,15,7,8,75,51,24,52
Copenhagen,3200,4,14,6,10,56,41,15,48
AaB,3200,5,6,13,11,35,45,-10,31
Sonderjyske,3200,6,8,6,10,28,29,-1,30
AC Horsens,3200,7,5,14,11,34,54,-20,29
Lyngby,3200,8,4,9,11,30,45,-15,21
Randers FC,3200,9,5,6,13,24,43,-19,21
AGF Aarhus,3200,10,5,6,11,17,36,-19,21
Silkeborg IF,3200,11,5,3,14,25,45,-20,18
Brondby,3201,1,21,6,3,71,33,38,69
FC Midtjylla,3201,2,20,6,4,68,41,27,66
Copenhagen,3201,3,15,5,10,60,44,16,50
FC Nords,3201,4,12,8,10,69,56,13,44
AaB,3201,5,8,11,11,38,42,-4,35
Sonderjyske,3201,6,8,6,10,28,29,-1,30
AC Horsens,3201,7,6,12,12,37,53,-16,30
Randers FC,3201,8,5,7,12,25,41,-16,22
AGF Aarhus,3201,9,5,6,11,24,40,-16,21
Lyngby,3201,10,3,10,11,28,46,-18,19
Silkeborg IF,3201,11,5,3,14,29,52,-23,18
Brondby,3202,1,22,5,3,77,34,43,71
FC Midtjylla,3202,2,17,6,7,63,46,17,57
Copenhagen,3202,3,16,4,10,62,43,19,52
FC Nords,3202,4,12,9,9,69,53,16,45
AaB,3202,5,7,13,10,38,44,-6,34
AC Horsens,3202,6,6,15,9,34,49,-15,33
Sonderjyske,3202,7,8,6,10,28,29,-1,30
Randers FC,3202,8,5,7,12,24,40,-16,22
Lyngby,3202,9,3,10,11,27,45,-18,19
Silkeborg IF,3202,10,5,4,13,25,44,-19,19
AGF Aarhus,3202,11,4,7,11,16,36,-20,19
Brondby,3203,1,21,5,4,71,34,37,68
FC Midtjylla,3203,2,20,4,6,68,43,25,64
Copenhagen,3203,3,14,5,11,55,44,11,47
FC Nords,3203,4,13,7,10,72,53,19,46
AaB,3203,5,10,11,9,38,39,-1,41
Sonderjyske,3203,6,8,6,10,28,29,-1,30
AC Horsens,3203,7,6,12,12,36,53,-17,30
Randers FC,3203,8,5,7,12,25,41,-16,22
Silkeborg IF,3203,9,6,3,13,28,44,-16,21
Lyngby,3203,10,3,10,11,28,46,-18,19
AGF Aarhus,3203,11,4,6,12,16,39,-23,18
Brondby,3204,1,20,6,4,67,30,37,66
FC Midtjylla,3204,2,20,5,5,62,36,26,65
FC Nords,3204,3,14,6,10,72,53,19,48
Copenhagen,3204,4,14,4,12,56,44,12,46
AaB,3204,5,8,13,9,35,38,-3,37
AC Horsens,3204,6,6,14,10,32,49,-17,32
Sonderjyske,3204,7,8,6,10,28,29,-1,30
Randers FC,3204,8,5,7,12,24,40,-16,22
Lyngby,3204,9,3,10,11,27,45,-18,19
Silkeborg IF,3204,10,5,4,13,25,44,-19,19
AGF Aarhus,3204,11,4,7,11,16,36,-20,19
Brondby,3205,1,21,6,3,72,36,36,69
FC Midtjylla,3205,2,19,5,6,63,39,24,62
FC Nords,3205,3,14,7,9,71,50,21,49
Copenhagen,3205,4,14,4,12,63,47,16,46
AaB,3205,5,9,12,9,39,40,-1,39
Sonderjyske,3205,6,8,6,10,28,29,-1,30
AC Horsens,3205,7,6,12,12,34,56,-22,30
Randers FC,3205,8,6,6,12,24,39,-15,24
AGF Aarhus,3205,9,5,6,11,19,38,-19,21
Lyngby,3205,10,3,9,12,26,45,-19,18
Silkeborg IF,3205,11,5,3,14,27,47,-20,18
Brondby,3206,1,20,6,4,68,32,36,66
FC Midtjylla,3206,2,20,4,6,69,38,31,64
FC Nords,3206,3,15,6,9,76,54,22,51
Copenhagen,3206,4,15,4,11,56,43,13,49
AaB,3206,5,7,13,10,37,41,-4,34
AC Horsens,3206,6,6,13,11,33,57,-24,31
Sonderjyske,3206,7,8,6,10,28,29,-1,30
Randers FC,3206,8,5,7,12,24,40,-16,22
Silkeborg IF,3206,9,6,3,13,27,44,-17,21
Lyngby,3206,10,3,10,11,27,45,-18,19
AGF Aarhus,3206,11,4,6,12,16,38,-22,18
Brondby,3207,1,20,7,3,70,34,36,67
FC Midtjylla,3207,2,19,5,6,67,45,22,62
FC Nords,3207,3,14,7,9,78,57,21,49
Copenhagen,3207,4,14,6,10,60,43,17,48
AaB,3207,5,9,11,10,38,39,-1,38
Sonderjyske,3207,6,8,6,10,28,29,-1,30
AC Horsens,3207,7,5,14,11,34,55,-21,29
Randers FC,3207,8,5,7,12,25,41,-16,22
AGF Aarhus,3207,9,5,6,11,17,36,-19,21
Lyngby,3207,10,3,10,11,28,46,-18,19
Silkeborg IF,3207,11,5,3,14,25,45,-20,18
Brondby,3208,1,22,6,2,69,29,40,72
FC Midtjylla,3208,2,19,4,7,64,39,25,61
Copenhagen,3208,3,15,5,10,63,46,17,50
FC Nords,3208,4,13,9,8,72,51,21,48
AaB,3208,5,6,13,11,35,43,-8,31
Sonderjyske,3208,6,8,6,10,28,29,-1,30
AC Horsens,3208,7,5,15,10,31,52,-21,30
Lyngby,3208,8,4,9,11,27,44,-17,21
Randers FC,3208,9,5,6,13,23,40,-17,21
AGF Aarhus,3208,10,5,6,11,18,37,-19,21
Silkeborg IF,3208,11,5,3,14,26,46,-20,18
Brondby,3209,1,21,7,2,73,30,43,70
FC Midtjylla,3209,2,19,6,5,63,37,26,63
FC Nords,3209,3,13,8,9,70,53,17,47
Copenhagen,3209,4,13,7,10,61,47,14,46
AaB,3209,5,8,12,10,38,43,-5,36
Sonderjyske,3209,6,8,6,10,28,29,-1,30
AC Horsens,3209,7,5,14,11,31,52,-21,29
Lyngby,3209,8,4,9,11,29,45,-16,21
Silkeborg IF,3209,9,6,3,13,28,44,-16,21
Randers FC,3209,10,5,6,13,24,42,-18,21
AGF Aarhus,3209,11,4,6,12,16,39,-23,18
Brondby,3210,1,21,6,3,75,35,40,69
FC Midtjylla,3210,2,17,5,8,59,43,16,56
FC Nords,3210,3,15,7,8,79,55,24,52
Copenhagen,3210,4,14,6,10,61,44,17,48
AaB,3210,5,7,13,10,38,43,-5,34
AC Horsens,3210,6,7,13,10,36,54,-18,34
Sonderjyske,3210,7,8,6,10,28,29,-1,30
Lyngby,3210,8,4,9,11,29,44,-15,21
Randers FC,3210,9,5,6,13,23,42,-19,21
Silkeborg IF,3210,10,5,4,13,27,46,-19,19
AGF Aarhus,3210,11,4,7,11,18,38,-20,19
Brondby,3211,1,20,8,2,74,35,39,68
FC Midtjylla,3211,2,20,5,5,72,42,30,65
FC Nords,3211,3,14,7,9,77,59,18,49
Copenhagen,3211,4,14,4,12,60,48,12,46
AC Horsens,3211,5,7,13,10,38,54,-16,34
AaB,3211,6,6,13,11,37,46,-9,31
Sonderjyske,3211,7,8,6,10,28,29,-1,30
Silkeborg IF,3211,8,6,3,13,28,44,-16,21
Lyngby,3211,9,4,9,11,28,45,-17,21
Randers FC,3211,10,5,6,13,24,41,-17,21
AGF Aarhus,3211,11,4,6,12,16,39,-23,18
Brondby,3212,1,21,6,3,73,31,42,69
FC Midtjylla,3212,2,21,4,5,67,36,31,67
FC Nords,3212,3,15,6,9,71,50,21,51
Copenhagen,3212,4,12,5,13,53,48,5,41
AC Horsens,3212,5,7,13,10,32,47,-15,34
AaB,3212,6,7,12,11,35,45,-10,33
Sonderjyske,3212,7,8,6,10,28,29,-1,30
Randers FC,3212,8,5,7,12,25,41,-16,22
Lyngby,3212,9,3,10,11,28,46,-18,19
Silkeborg IF,3212,10,5,4,13,25,44,-19,19
AGF Aarhus,3212,11,4,7,11,16,36,-20,19
Brondby,3213,1,22,6,2,76,31,45,72
FC Midtjylla,3213,2,18,6,6,63,44,19,60
FC Nords,3213,3,14,8,8,74,54,20,50
Copenhagen,3213,4,14,6,10,57,41,16,48
AaB,3213,5,7,13,10,36,42,-6,34
Sonderjyske,3213,6,8,6,10,28,29,-1,30
AC Horsens,3213,7,5,13,12,35,55,-20,28
Randers FC,3213,8,5,7,12,24,40,-16,22
Silkeborg IF,3213,9,6,3,13,26,44,-18,21
Lyngby,3213,10,3,10,11,27,45,-18,19
AGF Aarhus,3213,11,4,6,12,16,37,-21,18
Brondby,3214,1,22,5,3,77,35,42,71
FC Midtjylla,3214,2,19,5,6,67,43,24,62
FC Nords,3214,3,15,6,9,78,57,21,51
Copenhagen,3214,4,13,6,11,60,47,13,45
AaB,3214,5,7,12,11,39,46,-7,33
AC Horsens,3214,6,6,14,10,34,53,-19,32
Sonderjyske,3214,7,8,6,10,28,29,-1,30
Randers FC,3214,8,5,7,12,24,40,-16,22
Silkeborg IF,3214,9,6,3,13,27,45,-18,21
Lyngby,3214,10,3,10,11,27,45,-18,19
AGF Aarhus,3214,11,4,6,12,17,38,-21,18
Brondby,3215,1,20,6,4,67,34,33,66
FC Midtjylla,3215,2,20,5,5,72,38,34,65
FC Nords,3215,3,14,6,10,73,53,20,48
Copenhagen,3215,4,14,4,12,61,52,9,46
AaB,3215,5,9,11,10,42,47,-5,38
AC Horsens,3215,6,6,14,10,43,60,-17,32
Sonderjyske,3215,7,8,6,10,28,29,-1,30
Randers FC,3215,8,5,7,12,24,40,-16,22
Lyngby,3215,9,3,10,11,27,45,-18,19
Silkeborg IF,3215,10,5,4,13,26,45,-19,19
AGF Aarhus,3215,11,4,7,11,17,37,-20,19
Brondby,3216,1,21,7,2,74,35,39,70
FC Midtjylla,3216,2,20,6,4,67,37,30,66
FC Nords,3216,3,14,7,9,76,54,22,49
Copenhagen,3216,4,14,5,11,60,47,13,47
AC Horsens,3216,5,6,14,10,37,55,-18,32
Sonderjyske,3216,6,8,6,10,28,29,-1,30
AaB,3216,7,6,11,13,34,46,-12,29
Lyngby,3216,8,4,9,11,28,44,-16,21
Silkeborg IF,3216,9,6,3,13,27,45,-18,21
Randers FC,3216,10,5,6,13,23,41,-18,21
AGF Aarhus,3216,11,4,6,12,17,38,-21,18
Brondby,3217,1,23,5,2,76,27,49,74
FC Midtjylla,3217,2,19,6,5,68,39,29,63
FC Nords,3217,3,14,8,8,76,52,24,50
Copenhagen,3217,4,13,4,13,53,49,4,43
AC Horsens,3217,5,7,12,11,34,57,-23,33
AaB,3217,6,6,13,11,36,45,-9,31
Sonderjyske,3217,7,8,6,10,28,29,-1,30
Randers FC,3217,8,6,6,12,25,40,-15,24
Silkeborg IF,3217,9,6,3,13,28,45,-17,21
Lyngby,3217,10,3,9,12,27,46,-19,18
AGF Aarhus,3217,11,4,6,12,17,39,-22,18
FC Midtjylla,3218,1,21,5,4,67,35,32,68
Brondby,3218,2,19,7,4,69,33,36,64
FC Nords,3218,3,14,7,9,75,47,28,49
Copenhagen,3218,4,13,8,9,58,44,14,47
AaB,3218,5,7,13,10,37,47,-10,34
Sonderjyske,3218,6,8,6,10,28,29,-1,30
AC Horsens,3218,7,5,14,11,34,60,-26,29
Lyngby,3218,8,4,9,11,27,44,-17,21
Randers FC,3218,9,5,6,13,23,40,-17,21
AGF Aarhus,3218,10,5,6,11,20,37,-17,21
Silkeborg IF,3218,11,5,3,14,26,48,-22,18
Brondby,3219,1,22,5,3,72,34,38,71
FC Midtjylla,3219,2,19,5,6,62,37,25,62
Copenhagen,3219,3,16,5,9,61,43,18,53
FC Nords,3219,4,13,7,10,68,48,20,46
AaB,3219,5,7,12,11,36,44,-8,33
Sonderjyske,3219,6,8,6,10,28,29,-1,30
AC Horsens,3219,7,5,14,11,32,51,-19,29
Randers FC,3219,8,6,6,12,24,39,-15,24
Silkeborg IF,3219,9,6,3,13,26,44,-18,21
Lyngby,3219,10,3,9,12,26,45,-19,18
AGF Aarhus,3219,11,4,6,12,16,37,-21,18
Brondby,3220,1,22,6,2,73,29,44,72
FC Midtjylla,3220,2,18,7,5,62,38,24,61
FC Nords,3220,3,13,7,10,70,51,19,46
Copenhagen,3220,4,13,6,11,59,48,11,45
AaB,3220,5,8,13,9,38,42,-4,37
Sonderjyske,3220,6,8,6,10,28,29,-1,30
AC Horsens,3220,7,5,15,10,29,49,-20,30
Lyngby,3220,8,4,9,11,30,44,-14,21
Silkeborg IF,3220,9,6,3,13,26,44,-18,21
Randers FC,3220,10,5,6,13,23,43,-20,21
AGF Aarhus,3220,11,4,6,12,16,37,-21,18
Brondby,3221,1,22,5,3,75,30,45,71
FC Midtjylla,3221,2,20,4,6,63,42,21,64
FC Nords,3221,3,14,7,9,76,53,23,49
Copenhagen,3221,4,13,6,11,56,44,12,45
AaB,3221,5,8,12,10,39,42,-3,36
Sonderjyske,3221,6,8,6,10,28,29,-1,30
AC Horsens,3221,7,6,12,12,36,60,-24,30
Randers FC,3221,8,6,6,12,25,40,-15,24
AGF Aarhus,3221,9,5,6,11,18,37,-19,21
Lyngby,3221,10,3,9,12,27,46,-19,18
Silkeborg IF,3221,11,5,3,14,26,46,-20,18
Brondby,3222,1,20,5,5,71,36,35,65
FC Midtjylla,3222,2,19,5,6,64,39,25,62
FC Nords,3222,3,15,8,7,78,48,30,53
Copenhagen,3222,4,15,5,10,57,47,10,50
AC Horsens,3222,5,7,13,10,36,50,-14,34
Sonderjyske,3222,6,8,6,10,28,29,-1,30
AaB,3222,7,6,12,12,33,45,-12,30
Lyngby,3222,8,4,9,11,28,45,-17,21
Randers FC,3222,9,5,6,13,24,41,-17,21
AGF Aarhus,3222,10,5,6,11,17,36,-19,21
Silkeborg IF,3222,11,5,3,14,25,45,-20,18
Brondby,3223,1,21,6,3,72,32,40,69
FC Midtjylla,3223,2,19,4,7,70,44,26,61
Copenhagen,3223,3,16,4,10,63,45,18,52
FC Nords,3223,4,14,6,10,76,56,20,48
AaB,3223,5,9,11,10,40,47,-7,38
Sonderjyske,3223,6,8,6,10,28,29,-1,30
AC Horsens,3223,7,5,13,12,34,57,-23,28
Lyngby,3223,8,4,9,11,32,47,-15,21
Silkeborg IF,3223,9,6,3,13,26,44,-18,21
Randers FC,3223,10,5,6,13,26,45,-19,21
AGF Aarhus,3223,11,4,6,12,16,37,-21,18
Brondby,3224,1,19,7,4,67,34,33,64
FC Midtjylla,3224,2,19,6,5,64,39,25,63
FC Nords,3224,3,15,6,9,74,49,25,51
Copenhagen,3224,4,15,5,10,62,44,18,50
AaB,3224,5,8,14,8,42,43,-1,38
Sonderjyske,3224,6,8,6,10,28,29,-1,30
AC Horsens,3224,7,5,12,13,33,59,-26,27
Lyngby,3224,8,4,9,11,28,44,-16,21
Randers FC,3224,9,5,6,13,23,41,-18,21
Silkeborg IF,3224,10,5,4,13,25,44,-19,19
AGF Aarhus,3224,11,4,7,11,16,36,-20,19
Brondby,3225,1,20,7,3,68,31,37,67
FC Midtjylla,3225,2,19,4,7,59,39,20,61
FC Nords,3225,3,13,7,10,69,50,19,46
Copenhagen,3225,4,12,8,10,54,42,12,44
AaB,3225,5,9,12,9,38,39,-1,39
AC Horsens,3225,6,7,14,9,33,46,-13,35
Sonderjyske,3225,7,8,6,10,28,29,-1,30
Randers FC,3225,8,6,6,12,25,40,-15,24
AGF Aarhus,3225,9,5,6,11,19,37,-18,21
Lyngby,3225,10,3,9,12,27,46,-19,18
Silkeborg IF,3225,11,5,3,14,26,47,-21,18
Brondby,3226,1,21,7,2,70,30,40,70
FC Midtjylla,3226,2,20,5,5,63,36,27,65
FC Nords,3226,3,14,8,8,72,46,26,50
Copenhagen,3226,4,14,4,12,55,44,11,46
AaB,3226,5,7,11,12,35,47,-12,32
AC Horsens,3226,6,6,13,11,33,51,-18,31
Sonderjyske,3226,7,8,6,10,28,29,-1,30
Randers FC,3226,8,5,7,12,25,41,-16,22
AGF Aarhus,3226,9,5,6,11,19,38,-19,21
Lyngby,3226,10,3,10,11,28,46,-18,19
Silkeborg IF,3226,11,5,3,14,27,47,-20,18
Brondby,3227,1,21,5,4,70,33,37,68
FC Midtjylla,3227,2,20,4,6,64,38,26,64
FC Nords,3227,3,14,7,9,70,51,19,49
Copenhagen,3227,4,14,5,11,59,44,15,47
AaB,3227,5,7,13,10,36,42,-6,34
AC Horsens,3227,6,7,12,11,36,53,-17,33
Sonderjyske,3227,7,8,6,10,28,29,-1,30
Lyngby,3227,8,4,9,11,28,45,-17,21
Randers FC,3227,9,5,6,13,24,41,-17,21
Silkeborg IF,3227,10,5,4,13,25,44,-19,19
AGF Aarhus,3227,11,4,7,11,16,36,-20,19
FC Midtjylla,3228,1,19,5,6,63,40,23,62
Brondby,3228,2,18,7,5,69,37,32,61
FC Nords,3228,3,14,8,8,77,53,24,50
Copenhagen,3228,4,14,6,10,63,48,15,48
AaB,3228,5,8,13,9,41,47,-6,37
AC Horsens,3228,6,6,15,9,37,51,-14,33
Sonderjyske,3228,7,8,6,10,28,29,-1,30
Randers FC,3228,8,5,7,12,25,41,-16,22
Silkeborg IF,3228,9,6,3,13,26,44,-18,21
Lyngby,3228,10,3,10,11,28,46,-18,19
AGF Aarhus,3228,11,4,6,12,16,37,-21,18
Brondby,3229,1,21,5,4,69,32,37,68
FC Midtjylla,3229,2,20,4,6,62,40,22,64
FC Nords,3229,3,15,7,8,75,48,27,52
Copenhagen,3229,4,15,5,10,57,43,14,50
AaB,3229,5,6,13,11,35,42,-7,31
Sonderjyske,3229,6,8,6,10,28,29,-1,30
AC Horsens,3229,7,6,12,12,30,49,-19,30
Randers FC,3229,8,5,7,12,25,41,-16,22
Silkeborg IF,3229,9,6,3,13,28,45,-17,21
Lyngby,3229,10,3,10,11,28,46,-18,19
AGF Aarhus,3229,11,4,6,12,17,39,-22,18
Brondby,3230,1,22,5,3,70,31,39,71
FC Midtjylla,3230,2,20,5,5,65,36,29,65
Copenhagen,3230,3,15,5,10,58,43,15,50
FC Nords,3230,4,13,7,10,71,51,20,46
AaB,3230,5,8,12,10,39,42,-3,36
Sonderjyske,3230,6,8,6,10,28,29,-1,30
AC Horsens,3230,7,5,12,13,32,58,-26,27
Randers FC,3230,8,6,6,12,26,41,-15,24
AGF Aarhus,3230,9,5,6,11,19,37,-18,21
Lyngby,3230,10,3,9,12,28,47,-19,18
Silkeborg IF,3230,11,5,3,14,26,47,-21,18
Brondby,3231,1,22,6,2,75,28,47,72
FC Midtjylla,3231,2,20,4,6,69,41,28,64
Copenhagen,3231,3,14,4,12,60,47,13,46
FC Nords,3231,4,12,7,11,69,58,11,43
AaB,3231,5,8,14,8,39,40,-1,38
AC Horsens,3231,6,6,13,11,33,57,-24,31
Sonderjyske,3231,7,8,6,10,28,29,-1,30
Lyngby,3231,8,4,9,11,29,44,-15,21
Silkeborg IF,3231,9,6,3,13,28,45,-17,21
Randers FC,3231,10,5,6,13,23,42,-19,21
AGF Aarhus,3231,11,4,6,12,17,39,-22,18
Brondby,3232,1,21,6,3,71,30,41,69
FC Midtjylla,3232,2,20,6,4,65,36,29,66
Copenhagen,3232,3,14,4,12,58,48,10,46
FC Nords,3232,4,13,6,11,74,55,19,45
AaB,3232,5,8,12,10,39,44,-5,36
AC Horsens,3232,6,7,12,11,35,55,-20,33
Sonderjyske,3232,7,8,6,10,28,29,-1,30
Randers FC,3232,8,5,7,12,23,39,-16,22
Lyngby,3232,9,3,10,11,26,44,-18,19
Silkeborg IF,3232,10,5,4,13,27,46,-19,19
AGF Aarhus,3232,11,4,7,11,18,38,-20,19
Brondby,3233,1,21,6,3,72,34,38,69
FC Midtjylla,3233,2,19,5,6,67,42,25,62
Copenhagen,3233,3,14,6,10,55,41,14,48
FC Nords,3233,4,13,8,9,70,52,18,47
AC Horsens,3233,5,8,13,9,39,51,-12,37
Sonderjyske,3233,6,8,6,10,28,29,-1,30
AaB,3233,7,6,12,12,34,43,-9,30
Lyngby,3233,8,4,9,11,28,45,-17,21
Randers FC,3233,9,5,6,13,24,41,-17,21
Silkeborg IF,3233,10,5,4,13,26,45,-19,19
AGF Aarhus,3233,11,4,7,11,17,37,-20,19
Brondby,3234,1,20,6,4,67,34,33,66
FC Midtjylla,3234,2,19,7,4,63,35,28,64
FC Nords,3234,3,14,6,10,79,56,23,48
Copenhagen,3234,4,14,5,11,58,45,13,47
AaB,3234,5,7,13,10,35,40,-5,34
AC Horsens,3234,6,6,15,9,37,55,-18,33
Sonderjyske,3234,7,8,6,10,28,29,-1,30
Randers FC,3234,8,5,7,12,24,40,-16,22
Silkeborg IF,3234,9,6,3,13,28,44,-16,21
Lyngby,3234,10,3,10,11,27,45,-18,19
AGF Aarhus,3234,11,4,6,12,16,39,-23,18
Brondby,3235,1,20,6,4,70,34,36,66
FC Midtjylla,3235,2,20,5,5,68,38,30,65
FC Nords,3235,3,16,7,7,75,48,27,55
Copenhagen,3235,4,12,6,12,59,50,9,42
AaB,3235,5,7,12,11,35,45,-10,33
AC Horsens,3235,6,6,14,10,34,52,-18,32
Sonderjyske,3235,7,8,6,10,28,29,-1,30
Randers FC,3235,8,6,6,12,25,40,-15,24
Silkeborg IF,3235,9,5,4,13,27,46,-19,19
AGF Aarhus,3235,10,4,7,11,18,38,-20,19
Lyngby,3235,11,3,9,12,27,46,-19,18
Brondby,3236,1,21,7,2,72,33,39,70
FC Midtjylla,3236,2,18,6,6,63,40,23,60
FC Nords,3236,3,14,8,8,76,55,21,50
Copenhagen,3236,4,12,9,9,58,45,13,45
AaB,3236,5,7,13,10,42,45,-3,34
AC Horsens,3236,6,6,13,11,34,53,-19,31
Sonderjyske,3236,7,8,6,10,28,29,-1,30
Randers FC,3236,8,6,6,12,27,40,-13,24
AGF Aarhus,3236,9,5,6,11,18,36,-18,21
Lyngby,3236,10,3,9,12,27,48,-21,18
Silkeborg IF,3236,11,5,3,14,25,46,-21,18
Brondby,3237,1,22,5,3,68,30,38,71
FC Midtjylla,3237,2,20,4,6,61,36,25,64
FC Nords,3237,3,14,6,10,71,51,20,48
Copenhagen,3237,4,14,4,12,58,46,12,46
AC Horsens,3237,5,8,12,10,36,50,-14,36
AaB,3237,6,7,11,12,36,43,-7,32
Sonderjyske,3237,7,8,6,10,28,29,-1,30
Randers FC,3237,8,5,7,12,24,40,-16,22
AGF Aarhus,3237,9,5,6,11,19,36,-17,21
Lyngby,3237,10,3,10,11,27,45,-18,19
Silkeborg IF,3237,11,5,3,14,25,47,-22,18
Brondby,3238,1,22,5,3,74,31,43,71
FC Midtjylla,3238,2,19,5,6,62,39,23,62
FC Nords,3238,3,14,7,9,72,53,19,49
Copenhagen,3238,4,14,5,11,58,44,14,47
AaB,3238,5,7,13,10,35,43,-8,34
Sonderjyske,3238,6,8,6,10,28,29,-1,30
AC Horsens,3238,7,5,15,10,34,51,-17,30
Lyngby,3238,8,4,9,11,28,44,-16,21
Randers FC,3238,9,5,6,13,23,41,-18,21
AGF Aarhus,3238,10,5,6,11,18,36,-18,21
Silkeborg IF,3238,11,5,3,14,25,46,-21,18
Brondby,3239,1,19,8,3,68,35,33,65
FC Midtjylla,3239,2,19,5,6,64,40,24,62
FC Nords,3239,3,13,9,8,74,54,20,48
Copenhagen,3239,4,13,5,12,63,53,10,44
AaB,3239,5,8,14,8,36,37,-1,38
AC Horsens,3239,6,7,13,10,36,48,-12,34
Sonderjyske,3239,7,8,6,10,28,29,-1,30
Randers FC,3239,8,5,7,12,24,40,-16,22
AGF Aarhus,3239,9,5,6,11,18,36,-18,21
Lyngby,3239,10,3,10,11,27,45,-18,19
Silkeborg IF,3239,11,5,3,14,25,46,-21,18
Brondby,3240,1,20,6,4,73,35,38,66
FC Midtjylla,3240,2,19,6,5,69,39,30,63
FC Nords,3240,3,14,7,9,76,54,22,49
Copenhagen,3240,4,14,4,12,57,46,11,46
AaB,3240,5,9,12,9,40,43,-3,39
AC Horsens,3240,6,6,13,11,31,55,-24,31
Sonderjyske,3240,7,8,6,10,28,29,-1,30
Lyngby,3240,8,4,9,11,28,45,-17,21
Silkeborg IF,3240,8,6,3,13,28,45,-17,21
Randers FC,3240,10,5,6,13,24,41,-17,21
AGF Aarhus,3240,11,4,6,12,17,39,-22,18
Brondby,3241,1,21,6,3,73,32,41,69
FC Midtjylla,3241,2,19,6,5,66,42,24,63
FC Nords,3241,3,15,7,8,77,54,23,52
Copenhagen,3241,4,13,6,11,55,45,10,45
AaB,3241,5,6,13,11,36,44,-8,31
AC Horsens,3241,6,5,16,9,35,51,-16,31
Sonderjyske,3241,7,8,6,10,28,29,-1,30
Lyngby,3241,8,4,9,11,31,44,-13,21
Silkeborg IF,3241,9,6,3,13,27,45,-18,21
Randers FC,3241,10,5,6,13,23,44,-21,21
AGF Aarhus,3241,11,4,6,12,17,38,-21,18
Brondby,3242,1,22,5,3,71,29,42,71
FC Midtjylla,3242,2,19,5,6,68,41,27,62
FC Nords,3242,3,14,7,9,79,54,25,49
Copenhagen,3242,4,15,4,11,61,48,13,49
AaB,3242,5,6,14,10,37,46,-9,32
AC Horsens,3242,6,6,13,11,31,55,-24,31
Sonderjyske,3242,7,8,6,10,28,29,-1,30
Randers FC,3242,8,6,6,12,24,39,-15,24
AGF Aarhus,3242,9,5,6,11,18,37,-19,21
Lyngby,3242,10,3,9,12,26,45,-19,18
Silkeborg IF,3242,11,5,3,14,26,46,-20,18
Brondby,3243,1,19,8,3,66,31,35,65
FC Midtjylla,3243,2,20,5,5,65,38,27,65
Copenhagen,3243,3,15,5,10,59,44,15,50
FC Nords,3243,4,12,8,10,73,56,17,44
AaB,3243,5,7,13,10,35,40,-5,34
AC Horsens,3243,6,6,15,9,34,49,-15,33
Sonderjyske,3243,7,8,6,10,28,29,-1,30
Randers FC,3243,8,6,6,12,25,39,-14,24
Silkeborg IF,3243,9,6,3,13,28,44,-16,21
Lyngby,3243,10,3,9,12,26,46,-20,18
AGF Aarhus,3243,11,4,6,12,16,39,-23,18
Brondby,3244,1,21,6,3,72,30,42,69
FC Midtjylla,3244,2,20,4,6,63,39,24,64
FC Nords,3244,3,15,6,9,71,50,21,51
Copenhagen,3244,4,12,5,13,58,53,5,41
AaB,3244,5,9,11,10,40,42,-2,38
AC Horsens,3244,6,7,12,11,40,56,-16,33
Sonderjyske,3244,7,8,6,10,28,29,-1,30
Lyngby,3244,8,4,9,11,29,45,-16,21
Randers FC,3244,9,5,6,13,24,42,-18,21
Silkeborg IF,3244,10,5,4,13,25,44,-19,19
AGF Aarhus,3244,11,4,7,11,16,36,-20,19
Brondby,3245,1,21,5,4,70,31,39,68
FC Midtjylla,3245,2,18,6,6,62,39,23,60
FC Nords,3245,3,14,6,10,73,51,22,48
Copenhagen,3245,4,12,6,12,54,45,9,42
AaB,3245,5,9,13,8,37,38,-1,40
AC Horsens,3245,6,7,14,9,36,54,-18,35
Sonderjyske,3245,7,8,6,10,28,29,-1,30
Randers FC,3245,8,6,6,12,25,40,-15,24
Silkeborg IF,3245,9,6,3,13,26,44,-18,21
Lyngby,3245,10,3,9,12,27,46,-19,18
AGF Aarhus,3245,11,4,6,12,16,37,-21,18
Brondby,3246,1,19,7,4,68,34,34,64
FC Midtjylla,3246,2,19,4,7,63,42,21,61
FC Nords,3246,3,14,8,8,75,51,24,50
Copenhagen,3246,4,14,6,10,62,46,16,48
AC Horsens,3246,5,7,14,9,37,50,-13,35
AaB,3246,6,7,13,10,37,45,-8,34
Sonderjyske,3246,7,8,6,10,28,29,-1,30
Randers FC,3246,8,5,7,12,24,40,-16,22
Lyngby,3246,9,3,10,11,27,45,-18,19
Silkeborg IF,3246,10,5,4,13,25,44,-19,19
AGF Aarhus,3246,11,4,7,11,16,36,-20,19
Brondby,3247,1,20,6,4,67,34,33,66
FC Midtjylla,3247,2,20,6,4,70,40,30,66
FC Nords,3247,3,15,7,8,76,53,23,52
Copenhagen,3247,4,13,7,10,58,44,14,46
AaB,3247,5,6,13,11,35,44,-9,31
AC Horsens,3247,6,6,13,11,42,59,-17,31
Sonderjyske,3247,7,8,6,10,28,29,-1,30
Randers FC,3247,8,6,6,12,25,40,-15,24
AGF Aarhus,3247,9,5,6,11,18,36,-18,21
Lyngby,3247,10,3,9,12,27,46,-19,18
Silkeborg IF,3247,11,5,3,14,25,46,-21,18
Brondby,3248,1,21,6,3,80,32,48,69
FC Midtjylla,3248,2,19,6,5,68,44,24,63
FC Nords,3248,3,14,7,9,76,62,14,49
Copenhagen,3248,4,13,6,11,61,48,13,45
AaB,3248,5,9,13,8,42,42,0,40
Sonderjyske,3248,6,8,6,10,28,29,-1,30
AC Horsens,3248,7,5,12,13,33,58,-25,27
Randers FC,3248,8,6,6,12,27,39,-12,24
Silkeborg IF,3248,9,5,4,13,27,46,-19,19
AGF Aarhus,3248,10,4,7,11,18,38,-20,19
Lyngby,3248,11,3,9,12,26,48,-22,18
Brondby,3249,1,20,7,3,71,33,38,67
FC Midtjylla,3249,2,17,7,6,61,42,19,58
FC Nords,3249,3,14,9,7,72,48,24,51
Copenhagen,3249,4,13,8,9,59,45,14,47
AaB,3249,5,7,13,10,34,40,-6,34
AC Horsens,3249,6,6,14,10,34,49,-15,32
Sonderjyske,3249,7,8,6,10,28,29,-1,30
Randers FC,3249,8,5,7,12,23,39,-16,22
AGF Aarhus,3249,9,5,6,11,17,36,-19,21
Lyngby,3249,10,3,10,11,26,44,-18,19
Silkeborg IF,3249,11,5,3,14,25,45,-20,18
Brondby,3250,1,21,7,2,69,30,39,70
FC Midtjylla,3250,2,20,6,4,64,35,29,66
FC Nords,3250,3,13,6,11,72,53,19,45
Copenhagen,3250,4,13,6,11,55,42,13,45
AaB,3250,5,8,12,10,34,40,-6,36
Sonderjyske,3250,6,8,6,10,28,29,-1,30
AC Horsens,3250,7,5,15,10,32,52,-20,30
Randers FC,3250,8,5,7,12,24,40,-16,22
Lyngby,3250,9,3,10,11,27,45,-18,19
Silkeborg IF,3250,10,5,4,13,25,44,-19,19
AGF Aarhus,3250,11,4,7,11,16,36,-20,19
Brondby,3251,1,20,7,3,71,32,39,67
FC Midtjylla,3251,2,20,5,5,68,38,30,65
FC Nords,3251,3,14,7,9,73,52,21,49
Copenhagen,3251,4,15,4,11,58,44,14,49
AaB,3251,5,8,11,11,37,46,-9,35
Sonderjyske,3251,6,8,6,10,28,29,-1,30
AC Horsens,3251,7,6,12,12,33,54,-21,30
Lyngby,3251,8,4,9,11,28,45,-17,21
Randers FC,3251,9,5,6,13,24,41,-17,21
AGF Aarhus,3251,10,5,6,11,17,36,-19,21
Silkeborg IF,3251,11,5,3,14,25,45,-20,18
FC Midtjylla,3252,1,21,4,5,65,36,29,67
Brondby,3252,2,19,7,4,68,35,33,64
FC Nords,3252,3,14,7,9,73,51,22,49
Copenhagen,3252,4,13,5,12,55,46,9,44
AC Horsens,3252,5,8,12,10,36,48,-12,36
AaB,3252,6,7,13,10,34,41,-7,34
Sonderjyske,3252,7,8,6,10,28,29,-1,30
Lyngby,3252,8,4,9,11,28,44,-16,21
Silkeborg IF,3252,8,6,3,13,28,44,-16,21
Randers FC,3252,10,5,6,13,23,41,-18,21
AGF Aarhus,3252,11,4,6,12,16,39,-23,18
FC Midtjylla,3253,1,21,5,4,68,39,29,68
Brondby,3253,2,20,5,5,71,36,35,65
FC Nords,3253,3,14,7,9,75,54,21,49
Copenhagen,3253,4,13,6,11,58,46,12,45
AC Horsens,3253,5,7,14,9,39,54,-15,35
AaB,3253,6,6,13,11,37,45,-8,31
Sonderjyske,3253,7,8,6,10,28,29,-1,30
Lyngby,3253,8,4,9,11,27,44,-17,21
Randers FC,3253,9,5,6,13,23,40,-17,21
AGF Aarhus,3253,10,5,6,11,19,37,-18,21
Silkeborg IF,3253,11,5,3,14,26,47,-21,18
Brondby,3254,1,21,6,3,72,32,40,69
FC Midtjylla,3254,2,20,4,6,66,42,24,64
FC Nords,3254,3,13,7,10,71,53,18,46
Copenhagen,3254,4,12,7,11,57,47,10,43
AC Horsens,3254,5,8,13,9,36,48,-12,37
AaB,3254,6,8,11,11,37,43,-6,35
Sonderjyske,3254,7,8,6,10,28,29,-1,30
Lyngby,3254,8,4,9,11,28,45,-17,21
Randers FC,3254,9,5,6,13,24,41,-17,21
AGF Aarhus,3254,10,5,6,11,18,36,-18,21
Silkeborg IF,3254,11,5,3,14,25,46,-21,18
Brondby,3255,1,22,5,3,71,29,42,71
FC Midtjylla,3255,2,20,4,6,69,40,29,64
FC Nords,3255,3,16,6,8,79,51,28,54
Copenhagen,3255,4,14,4,12,57,50,7,46
AaB,3255,5,7,11,12,35,45,-10,32
Sonderjyske,3255,6,8,6,10,28,29,-1,30
AC Horsens,3255,7,6,12,12,33,55,-22,30
Randers FC,3255,8,5,7,12,24,40,-16,22
AGF Aarhus,3255,9,5,6,11,18,37,-19,21
Lyngby,3255,10,3,10,11,27,45,-18,19
Silkeborg IF,3255,11,5,3,14,26,46,-20,18
Brondby,3256,1,21,6,3,73,30,43,69
FC Midtjylla,3256,2,20,5,5,70,39,31,65
FC Nords,3256,3,15,7,8,78,48,30,52
Copenhagen,3256,4,14,5,11,54,45,9,47
AaB,3256,5,6,14,10,34,44,-10,32
Sonderjyske,3256,6,8,6,10,28,29,-1,30
AC Horsens,3256,7,5,13,12,32,61,-29,28
Randers FC,3256,8,5,7,12,24,40,-16,22
Silkeborg IF,3256,9,6,3,13,26,44,-18,21
Lyngby,3256,10,3,10,11,27,45,-18,19
AGF Aarhus,3256,11,4,6,12,16,37,-21,18
Brondby,3257,1,22,5,3,75,33,42,71
FC Midtjylla,3257,2,19,4,7,66,43,23,61
FC Nords,3257,3,13,7,10,73,53,20,46
Copenhagen,3257,4,14,4,12,54,45,9,46
AC Horsens,3257,5,9,12,9,38,50,-12,39
AaB,3257,6,7,12,11,39,47,-8,33
Sonderjyske,3257,7,8,6,10,28,29,-1,30
Lyngby,3257,8,4,9,11,29,45,-16,21
Randers FC,3257,9,5,6,13,24,42,-18,21
Silkeborg IF,3257,10,5,4,13,26,45,-19,19
AGF Aarhus,3257,11,4,7,11,17,37,-20,19
FC Midtjylla,3258,1,21,5,4,71,40,31,68
Brondby,3258,2,19,6,5,70,37,33,63
FC Nords,3258,3,14,7,9,74,52,22,49
Copenhagen,3258,4,14,4,12,56,47,9,46
AaB,3258,5,7,13,10,38,44,-6,34
AC Horsens,3258,6,7,13,10,39,54,-15,34
Sonderjyske,3258,7,8,6,10,28,29,-1,30
Lyngby,3258,8,4,9,11,29,45,-16,21
Silkeborg IF,3258,9,6,3,13,27,45,-18,21
Randers FC,3258,10,5,6,13,24,42,-18,21
AGF Aarhus,3258,11,4,6,12,17,38,-21,18
Brondby,3259,1,21,7,2,70,31,39,70
FC Midtjylla,3259,2,18,5,7,67,44,23,59
FC Nords,3259,3,15,8,7,78,49,29,53
Copenhagen,3259,4,13,5,12,57,49,8,44
AaB,3259,5,7,12,11,36,47,-11,33
AC Horsens,3259,6,6,15,9,39,53,-14,33
Sonderjyske,3259,7,8,6,10,28,29,-1,30
Lyngby,3259,8,4,9,11,28,45,-17,21
Randers FC,3259,9,5,6,13,24,41,-17,21
AGF Aarhus,3259,10,5,6,11,18,37,-19,21
Silkeborg IF,3259,11,5,3,14,26,46,-20,18
Brondby,3260,1,22,6,2,72,28,44,72
FC Midtjylla,3260,2,20,5,5,69,38,31,65
Copenhagen,3260,3,16,4,10,60,43,17,52
FC Nords,3260,4,12,7,11,70,59,11,43
AaB,3260,5,6,13,11,35,45,-10,31
AC Horsens,3260,6,6,13,11,36,55,-19,31
Sonderjyske,3260,7,8,6,10,28,29,-1,30
Randers FC,3260,8,5,7,12,24,40,-16,22
Silkeborg IF,3260,9,6,3,13,30,44,-14,21
Lyngby,3260,10,3,10,11,27,45,-18,19
AGF Aarhus,3260,11,4,6,12,16,41,-25,18
Brondby,3261,1,19,6,5,65,33,32,63
FC Midtjylla,3261,2,17,6,7,63,43,20,57
FC Nords,3261,3,14,8,8,71,48,23,50
Copenhagen,3261,4,14,7,9,59,43,16,49
AaB,3261,5,8,14,8,38,40,-2,38
AC Horsens,3261,6,6,15,9,34,49,-15,33
Sonderjyske,3261,7,8,6,10,28,29,-1,30
Randers FC,3261,8,5,7,12,23,39,-16,22
Lyngby,3261,9,3,10,11,26,44,-18,19
Silkeborg IF,3261,10,5,4,13,25,44,-19,19
AGF Aarhus,3261,11,4,7,11,16,36,-20,19
Brondby,3262,1,20,5,5,68,33,35,65
FC Midtjylla,3262,2,20,5,5,66,39,27,65
Copenhagen,3262,3,15,6,9,55,37,18,51
FC Nords,3262,4,12,7,11,67,54,13,43
AC Horsens,3262,5,8,12,10,36,51,-15,36
AaB,3262,6,8,11,11,41,45,-4,35
Sonderjyske,3262,7,8,6,10,28,29,-1,30
Lyngby,3262,8,4,9,11,29,45,-16,21
Silkeborg IF,3262,9,6,3,13,26,44,-18,21
Randers FC,3262,10,5,6,13,24,42,-18,21
AGF Aarhus,3262,11,4,6,12,16,37,-21,18
Brondby,3263,1,22,5,3,73,28,45,71
FC Midtjylla,3263,2,21,4,5,68,38,30,67
Copenhagen,3263,3,14,5,11,56,46,10,47
FC Nords,3263,4,12,7,11,69,57,12,43
AaB,3263,5,8,11,11,35,41,-6,35
AC Horsens,3263,6,6,14,10,37,54,-17,32
Sonderjyske,3263,7,8,6,10,28,29,-1,30
Randers FC,3263,8,6,6,12,25,39,-14,24
Silkeborg IF,3263,9,6,3,13,29,47,-18,21
Lyngby,3263,10,3,9,12,26,46,-20,18
AGF Aarhus,3263,11,4,6,12,19,40,-21,18
Brondby,3264,1,21,6,3,72,34,38,69
FC Midtjylla,3264,2,19,7,4,66,39,27,64
FC Nords,3264,3,14,8,8,78,52,26,50
Copenhagen,3264,4,13,6,11,56,48,8,45
AaB,3264,5,7,11,12,37,45,-8,32
AC Horsens,3264,6,6,14,10,37,54,-17,32
Sonderjyske,3264,7,8,6,10,28,29,-1,30
Lyngby,3264,8,4,9,11,28,45,-17,21
Randers FC,3264,9,5,6,13,24,41,-17,21
Silkeborg IF,3264,10,5,4,13,28,47,-19,19
AGF Aarhus,3264,11,4,7,11,19,39,-20,19
Brondby,3265,1,21,6,3,72,35,37,69
FC Midtjylla,3265,2,20,6,4,66,35,31,66
FC Nords,3265,3,13,7,10,70,54,16,46
Copenhagen,3265,4,13,7,10,58,42,16,46
AaB,3265,5,7,13,10,35,42,-7,34
AC Horsens,3265,6,6,13,11,37,56,-19,31
Sonderjyske,3265,7,8,6,10,28,29,-1,30
Randers FC,3265,8,5,7,12,23,39,-16,22
Silkeborg IF,3265,9,6,3,13,27,44,-17,21
Lyngby,3265,10,3,10,11,26,44,-18,19
AGF Aarhus,3265,11,4,6,12,16,38,-22,18
Brondby,3266,1,21,6,3,74,30,44,69
FC Midtjylla,3266,2,20,5,5,66,40,26,65
FC Nords,3266,3,15,7,8,74,51,23,52
Copenhagen,3266,4,13,5,12,58,45,13,44
AaB,3266,5,7,13,10,34,40,-6,34
Sonderjyske,3266,6,8,6,10,28,29,-1,30
AC Horsens,3266,7,6,12,12,35,61,-26,30
Lyngby,3266,8,4,9,11,29,46,-17,21
Randers FC,3266,9,5,6,13,25,42,-17,21
AGF Aarhus,3266,10,5,6,11,18,37,-19,21
Silkeborg IF,3266,11,5,3,14,26,46,-20,18
Brondby,3267,1,22,6,2,71,30,41,72
FC Midtjylla,3267,2,19,5,6,65,39,26,62
FC Nords,3267,3,14,6,10,69,49,20,48
Copenhagen,3267,4,13,6,11,58,48,10,45
AC Horsens,3267,5,7,13,10,36,49,-13,34
AaB,3267,6,7,12,11,36,46,-10,33
Sonderjyske,3267,7,8,6,10,28,29,-1,30
Randers FC,3267,8,6,6,12,25,39,-14,24
AGF Aarhus,3267,9,5,6,11,18,36,-18,21
Lyngby,3267,10,3,9,12,26,46,-20,18
Silkeborg IF,3267,11,5,3,14,25,46,-21,18
Brondby,3268,1,21,6,3,70,33,37,69
FC Midtjylla,3268,2,19,4,7,63,38,25,61
FC Nords,3268,3,15,7,8,78,49,29,52
Copenhagen,3268,4,15,5,10,58,41,17,50
AaB,3268,5,7,12,11,35,46,-11,33
Sonderjyske,3268,6,8,6,10,28,29,-1,30
AC Horsens,3268,7,6,12,12,32,55,-23,30
Randers FC,3268,8,5,7,12,24,40,-16,22
Lyngby,3268,9,3,10,11,27,45,-18,19
Silkeborg IF,3268,10,5,4,13,26,45,-19,19
AGF Aarhus,3268,11,4,7,11,17,37,-20,19
Brondby,3269,1,22,5,3,72,34,38,71
FC Midtjylla,3269,2,22,4,4,75,37,38,70
FC Nords,3269,3,14,6,10,76,59,17,48
Copenhagen,3269,4,14,4,12,60,49,11,46
AaB,3269,5,7,11,12,37,46,-9,32
Sonderjyske,3269,6,8,6,10,28,29,-1,30
AC Horsens,3269,7,6,12,12,33,54,-21,30
Lyngby,3269,8,4,9,11,29,45,-16,21
Silkeborg IF,3269,9,6,3,13,28,46,-18,21
Randers FC,3269,10,5,6,13,24,42,-18,21
AGF Aarhus,3269,11,4,6,12,18,39,-21,18
Brondby,3270,1,21,5,4,74,33,41,68
FC Midtjylla,3270,2,20,4,6,65,38,27,64
Copenhagen,3270,3,14,5,11,57,45,12,47
FC Nords,3270,4,13,6,11,74,58,16,45
AaB,3270,5,8,12,10,36,43,-7,36
AC Horsens,3270,6,8,12,10,37,52,-15,36
Sonderjyske,3270,7,8,6,10,28,29,-1,30
Lyngby,3270,8,4,9,11,29,45,-16,21
Silkeborg IF,3270,9,6,3,13,26,44,-18,21
Randers FC,3270,10,5,6,13,24,42,-18,21
AGF Aarhus,3270,11,4,6,12,16,37,-21,18
Brondby,3271,1,22,5,3,72,32,40,71
FC Midtjylla,3271,2,19,6,5,66,39,27,63
FC Nords,3271,3,15,7,8,73,50,23,52
Copenhagen,3271,4,13,5,12,56,48,8,44
AaB,3271,5,7,14,9,38,39,-1,35
Sonderjyske,3271,6,8,6,10,28,29,-1,30
AC Horsens,3271,7,5,13,12,31,54,-23,28
Lyngby,3271,8,4,9,11,28,45,-17,21
Silkeborg IF,3271,9,6,3,13,27,44,-17,21
Randers FC,3271,10,5,6,13,24,41,-17,21
AGF Aarhus,3271,11,4,6,12,16,38,-22,18
Brondby,3272,1,20,6,4,74,36,38,66
FC Midtjylla,3272,2,20,5,5,69,39,30,65
Copenhagen,3272,3,15,5,10,62,48,14,50
FC Nords,3272,4,12,9,9,72,58,14,45
AaB,3272,5,7,12,11,37,46,-9,33
AC Horsens,3272,6,6,15,9,37,50,-13,33
Sonderjyske,3272,7,8,6,10,28,29,-1,30
Randers FC,3272,8,5,7,12,27,43,-16,22
Lyngby,3272,9,3,10,11,30,48,-18,19
Silkeborg IF,3272,10,5,4,13,26,45,-19,19
AGF Aarhus,3272,11,4,7,11,17,37,-20,19
Brondby,3273,1,22,5,3,74,33,41,71
FC Midtjylla,3273,2,19,4,7,65,42,23,61
Copenhagen,3273,3,15,5,10,59,43,16,50
FC Nords,3273,4,14,7,9,77,54,23,49
AaB,3273,5,9,11,10,38,43,-5,38
Sonderjyske,3273,6,8,6,10,28,29,-1,30
AC Horsens,3273,7,5,12,13,34,58,-24,27
Randers FC,3273,8,5,7,12,23,39,-16,22
Silkeborg IF,3273,9,6,3,13,27,45,-18,21
Lyngby,3273,10,3,10,11,26,44,-18,19
AGF Aarhus,3273,11,4,6,12,17,38,-21,18
Brondby,3274,1,21,7,2,73,30,43,70
FC Midtjylla,3274,2,20,6,4,65,35,30,66
FC Nords,3274,3,14,7,9,74,52,22,49
Copenhagen,3274,4,13,6,11,56,47,9,45
AaB,3274,5,7,11,12,36,47,-11,32
AC Horsens,3274,6,6,13,11,36,55,-19,31
Sonderjyske,3274,7,8,6,10,28,29,-1,30
Randers FC,3274,8,6,6,12,24,39,-15,24
AGF Aarhus,3274,9,5,6,11,18,36,-18,21
Lyngby,3274,10,3,9,12,26,45,-19,18
Silkeborg IF,3274,11,5,3,14,25,46,-21,18
Brondby,3275,1,22,5,3,76,31,45,71
FC Midtjylla,3275,2,18,5,7,63,43,20,59
FC Nords,3275,3,15,7,8,74,52,22,52
Copenhagen,3275,4,13,7,10,59,46,13,46
AC Horsens,3275,5,8,12,10,36,52,-16,36
Sonderjyske,3275,6,8,6,10,28,29,-1,30
AaB,3275,7,6,12,12,36,46,-10,30
Randers FC,3275,8,5,7,12,23,39,-16,22
Lyngby,3275,9,3,10,11,26,44,-18,19
Silkeborg IF,3275,10,5,4,13,27,46,-19,19
AGF Aarhus,3275,11,4,7,11,18,38,-20,19
Brondby,3276,1,21,5,4,71,38,33,68
FC Midtjylla,3276,2,21,4,5,73,39,34,67
Copenhagen,3276,3,15,5,10,59,43,16,50
FC Nords,3276,4,12,8,10,70,54,16,44
AaB,3276,5,6,14,10,34,44,-10,32
AC Horsens,3276,6,6,14,10,35,50,-15,32
Sonderjyske,3276,7,8,6,10,28,29,-1,30
Lyngby,3276,8,4,9,11,29,45,-16,21
Silkeborg IF,3276,9,6,3,13,27,45,-18,21
Randers FC,3276,10,5,6,13,24,42,-18,21
AGF Aarhus,3276,11,4,6,12,17,38,-21,18
Brondby,3277,1,22,5,3,68,32,36,71
FC Midtjylla,3277,2,20,4,6,71,39,32,64
Copenhagen,3277,3,14,5,11,56,43,13,47
FC Nords,3277,4,13,7,10,68,51,17,46
AaB,3277,5,8,12,10,36,39,-3,36
Sonderjyske,3277,6,8,6,10,28,29,-1,30
AC Horsens,3277,7,5,15,10,32,53,-21,30
Lyngby,3277,8,4,9,11,29,45,-16,21
Randers FC,3277,9,5,6,13,24,42,-18,21
AGF Aarhus,3277,10,5,6,11,19,37,-18,21
Silkeborg IF,3277,11,5,3,14,26,47,-21,18
Brondby,3278,1,22,6,2,71,31,40,72
FC Midtjylla,3278,2,21,4,5,66,37,29,67
FC Nords,3278,3,14,7,9,72,52,20,49
Copenhagen,3278,4,12,4,14,52,46,6,40
AaB,3278,5,7,13,10,36,42,-6,34
AC Horsens,3278,6,6,14,10,37,52,-15,32
Sonderjyske,3278,7,8,6,10,28,29,-1,30
Randers FC,3278,8,6,6,12,25,40,-15,24
Silkeborg IF,3278,9,5,4,13,26,45,-19,19
AGF Aarhus,3278,10,4,7,11,17,37,-20,19
Lyngby,3278,11,3,9,12,27,46,-19,18
Brondby,3279,1,20,6,4,71,32,39,66
FC Midtjylla,3279,2,19,7,4,63,35,28,64
Copenhagen,3279,3,14,5,11,56,43,13,47
FC Nords,3279,4,13,7,10,71,51,20,46
AC Horsens,3279,5,9,12,9,35,48,-13,39
AaB,3279,6,7,11,12,35,48,-13,32
Sonderjyske,3279,7,8,6,10,28,29,-1,30
Lyngby,3279,8,4,9,11,28,45,-17,21
Silkeborg IF,3279,8,6,3,13,28,45,-17,21
Randers FC,3279,10,5,6,13,24,41,-17,21
AGF Aarhus,3279,11,4,6,12,17,39,-22,18
Brondby,3280,1,22,5,3,73,33,40,71
FC Midtjylla,3280,2,20,4,6,66,42,24,64
FC Nords,3280,3,13,7,10,72,52,20,46
Copenhagen,3280,4,13,5,12,59,51,8,44
AaB,3280,5,8,12,10,39,44,-5,36
AC Horsens,3280,6,7,13,10,36,49,-13,34
Sonderjyske,3280,7,8,6,10,28,29,-1,30
Randers FC,3280,8,5,7,12,24,40,-16,22
Silkeborg IF,3280,9,6,3,13,27,45,-18,21
Lyngby,3280,10,3,10,11,27,45,-18,19
AGF Aarhus,3280,11,4,6,12,17,38,-21,18
FC Midtjylla,3281,1,20,6,4,67,37,30,66
Brondby,3281,2,19,7,4,69,34,35,64
FC Nords,3281,3,15,6,9,75,49,26,51
Copenhagen,3281,4,13,7,10,57,46,11,46
AaB,3281,5,8,11,11,39,48,-9,35
AC Horsens,3281,6,6,13,11,35,54,-19,31
Sonderjyske,3281,7,8,6,10,28,29,-1,30
Lyngby,3281,8,4,9,11,29,44,-15,21
Silkeborg IF,3281,9,6,3,13,27,45,-18,21
Randers FC,3281,10,5,6,13,23,42,-19,21
AGF Aarhus,3281,11,4,6,12,17,38,-21,18
Brondby,3282,1,20,6,4,67,33,34,66
FC Midtjylla,3282,2,20,4,6,63,38,25,64
FC Nords,3282,3,17,6,7,79,46,33,57
Copenhagen,3282,4,13,4,13,53,46,7,43
AaB,3282,5,7,12,11,35,40,-5,33
AC Horsens,3282,6,7,12,11,32,52,-20,33
Sonderjyske,3282,7,8,6,10,28,29,-1,30
Randers FC,3282,8,6,6,12,27,42,-15,24
Silkeborg IF,3282,9,6,3,13,27,45,-18,21
Lyngby,3282,10,3,9,12,29,48,-19,18
AGF Aarhus,3282,11,4,6,12,17,38,-21,18
Brondby,3283,1,21,5,4,69,33,36,68
FC Midtjylla,3283,2,19,5,6,62,37,25,62
FC Nords,3283,3,14,7,9,69,50,19,49
Copenhagen,3283,4,13,5,12,58,45,13,44
AaB,3283,5,11,11,8,41,38,3,44
Sonderjyske,3283,6,8,6,10,28,29,-1,30
AC Horsens,3283,7,5,13,12,32,54,-22,28
Randers FC,3283,8,5,7,12,24,40,-16,22
Lyngby,3283,9,3,10,11,27,45,-18,19
Silkeborg IF,3283,10,5,4,13,25,44,-19,19
AGF Aarhus,3283,11,4,7,11,16,36,-20,19
Brondby,3284,1,20,6,4,69,35,34,66
FC Midtjylla,3284,2,20,5,5,66,40,26,65
FC Nords,3284,3,17,6,7,85,52,33,57
Copenhagen,3284,4,13,4,13,56,51,5,43
AaB,3284,5,7,12,11,36,42,-6,33
AC Horsens,3284,6,6,13,11,35,53,-18,31
Sonderjyske,3284,7,8,6,10,28,29,-1,30
Randers FC,3284,8,6,6,12,24,39,-15,24
Silkeborg IF,3284,9,6,3,13,26,44,-18,21
Lyngby,3284,10,3,9,12,26,45,-19,18
AGF Aarhus,3284,11,4,6,12,16,37,-21,18
Brondby,3285,1,20,7,3,68,31,37,67
FC Midtjylla,3285,2,18,6,6,63,40,23,60
FC Nords,3285,3,14,9,7,73,49,24,51
Copenhagen,3285,4,13,6,11,58,47,11,45
AaB,3285,5,7,13,10,37,44,-7,34
AC Horsens,3285,6,7,13,10,37,51,-14,34
Sonderjyske,3285,7,8,6,10,28,29,-1,30
Lyngby,3285,8,4,9,11,29,46,-17,21
Silkeborg IF,3285,8,6,3,13,29,46,-17,21
Randers FC,3285,10,5,6,13,25,42,-17,21
AGF Aarhus,3285,11,4,6,12,18,40,-22,18
FC Midtjylla,3286,1,21,5,4,66,36,30,68
Brondby,3286,2,19,8,3,66,31,35,65
FC Nords,3286,3,15,7,8,78,54,24,52
Copenhagen,3286,4,14,4,12,62,50,12,46
AaB,3286,5,6,13,11,35,45,-10,31
AC Horsens,3286,6,6,13,11,38,55,-17,31
Sonderjyske,3286,7,8,6,10,28,29,-1,30
Lyngby,3286,8,4,9,11,31,45,-14,21
Silkeborg IF,3286,9,6,3,13,28,44,-16,21
Randers FC,3286,10,5,6,13,24,44,-20,21
AGF Aarhus,3286,11,4,6,12,16,39,-23,18
Brondby,3287,1,21,6,3,69,31,38,69
FC Midtjylla,3287,2,20,5,5,65,37,28,65
FC Nords,3287,3,14,6,10,73,56,17,48
Copenhagen,3287,4,14,5,11,54,41,13,47
AaB,3287,5,7,14,9,39,43,-4,35
Sonderjyske,3287,6,8,6,10,28,29,-1,30
AC Horsens,3287,7,5,14,11,32,50,-18,29
Randers FC,3287,8,5,7,12,23,39,-16,22
Silkeborg IF,3287,9,6,3,13,29,46,-17,21
Lyngby,3287,10,3,10,11,26,44,-18,19
AGF Aarhus,3287,11,4,6,12,18,40,-22,18
Brondby,3288,1,21,7,2,73,30,43,70
FC Midtjylla,3288,2,18,6,6,64,42,22,60
FC Nords,3288,3,14,7,9,77,53,24,49
Copenhagen,3288,4,14,4,12,54,49,5,46
AaB,3288,5,7,14,9,38,40,-2,35
AC Horsens,3288,6,7,12,11,38,56,-18,33
Sonderjyske,3288,7,8,6,10,28,29,-1,30
Lyngby,3288,8,4,9,11,29,45,-16,21
Randers FC,3288,9,5,6,13,24,42,-18,21
Silkeborg IF,3288,10,5,4,13,26,45,-19,19
AGF Aarhus,3288,11,4,7,11,17,37,-20,19
Brondby,3289,1,20,5,5,68,34,34,65
FC Midtjylla,3289,2,19,6,5,62,38,24,63
FC Nords,3289,3,15,7,8,73,48,25,52
Copenhagen,3289,4,14,4,12,57,45,12,46
AC Horsens,3289,5,8,13,9,37,49,-12,37
AaB,3289,6,7,11,12,36,45,-9,32
Sonderjyske,3289,7,8,6,10,28,29,-1,30
Randers FC,3289,8,5,7,12,23,39,-16,22
Silkeborg IF,3289,9,6,3,13,28,44,-16,21
Lyngby,3289,10,3,10,11,26,44,-18,19
AGF Aarhus,3289,11,4,6,12,16,39,-23,18
Brondby,3290,1,22,5,3,70,32,38,71
FC Midtjylla,3290,2,19,5,6,66,41,25,62
Copenhagen,3290,3,14,6,10,61,46,15,48
FC Nords,3290,4,12,7,11,67,52,15,43
AC Horsens,3290,5,8,13,9,41,52,-11,37
AaB,3290,6,7,12,11,35,43,-8,33
Sonderjyske,3290,7,8,6,10,28,29,-1,30
Lyngby,3290,8,4,9,11,29,44,-15,21
AGF Aarhus,3290,9,5,6,11,18,36,-18,21
Randers FC,3290,10,5,6,13,23,42,-19,21
Silkeborg IF,3290,11,5,3,14,25,46,-21,18
FC Midtjylla,3291,1,21,4,5,76,43,33,67
Brondby,3291,2,19,7,4,72,36,36,64
FC Nords,3291,3,15,7,8,75,51,24,52
Copenhagen,3291,4,14,5,11,61,47,14,47
AaB,3291,5,7,13,10,37,48,-11,34
Sonderjyske,3291,6,8,6,10,28,29,-1,30
AC Horsens,3291,7,5,14,11,36,58,-22,29
Randers FC,3291,8,5,7,12,24,40,-16,22
Silkeborg IF,3291,9,6,3,13,29,44,-15,21
Lyngby,3291,10,3,10,11,27,45,-18,19
AGF Aarhus,3291,11,4,6,12,16,40,-24,18
Brondby,3292,1,21,5,4,69,33,36,68
FC Midtjylla,3292,2,18,5,7,63,42,21,59
FC Nords,3292,3,13,7,10,70,52,18,46
Copenhagen,3292,4,13,6,11,56,43,13,45
AC Horsens,3292,5,9,12,9,37,47,-10,39
AaB,3292,6,9,11,10,36,40,-4,38
Sonderjyske,3292,7,8,6,10,28,29,-1,30
Lyngby,3292,8,4,9,11,27,44,-17,21
Randers FC,3292,9,5,6,13,23,40,-17,21
AGF Aarhus,3292,10,5,6,11,17,36,-19,21
Silkeborg IF,3292,11,5,3,14,25,45,-20,18
Brondby,3293,1,22,6,2,70,31,39,72
FC Midtjylla,3293,2,18,5,7,64,42,22,59
FC Nords,3293,3,15,6,9,83,55,28,51
Copenhagen,3293,4,13,4,13,54,50,4,43
AaB,3293,5,9,11,10,42,44,-2,38
AC Horsens,3293,6,7,12,11,34,51,-17,33
Sonderjyske,3293,7,8,6,10,28,29,-1,30
Lyngby,3293,8,4,9,11,29,45,-16,21
Silkeborg IF,3293,9,6,3,13,29,47,-18,21
Randers FC,3293,10,5,6,13,24,42,-18,21
AGF Aarhus,3293,11,4,6,12,19,40,-21,18
Brondby,3294,1,22,5,3,75,31,44,71
FC Midtjylla,3294,2,19,5,6,66,43,23,62
FC Nords,3294,3,14,7,9,74,50,24,49
Copenhagen,3294,4,14,7,9,62,46,16,49
AaB,3294,5,6,13,11,36,49,-13,31
AC Horsens,3294,6,6,13,11,36,56,-20,31
Sonderjyske,3294,7,8,6,10,28,29,-1,30
Randers FC,3294,8,5,7,12,25,41,-16,22
Lyngby,3294,9,3,10,11,28,46,-18,19
Silkeborg IF,3294,10,5,4,13,26,45,-19,19
AGF Aarhus,3294,11,4,7,11,17,37,-20,19
Brondby,3295,1,20,7,3,69,33,36,67
FC Midtjylla,3295,2,20,4,6,65,41,24,64
FC Nords,3295,3,14,7,9,76,51,25,49
Copenhagen,3295,4,14,6,10,57,41,16,48
AaB,3295,5,7,12,11,34,40,-6,33
AC Horsens,3295,6,6,14,10,31,52,-21,32
Sonderjyske,3295,7,8,6,10,28,29,-1,30
Randers FC,3295,8,5,7,12,25,41,-16,22
Silkeborg IF,3295,9,6,3,13,27,44,-17,21
Lyngby,3295,10,3,10,11,28,46,-18,19
AGF Aarhus,3295,11,4,6,12,16,38,-22,18
FC Midtjylla,3296,1,22,4,4,74,36,38,70
Brondby,3296,2,19,7,4,67,33,34,64
FC Nords,3296,3,13,8,9,71,51,20,47
Copenhagen,3296,4,12,7,11,56,45,11,43
AaB,3296,5,7,14,9,38,44,-6,35
AC Horsens,3296,6,6,14,10,35,58,-23,32
Sonderjyske,3296,7,8,6,10,28,29,-1,30
Lyngby,3296,8,4,9,11,29,46,-17,21
Silkeborg IF,3296,9,6,3,13,27,44,-17,21
Randers FC,3296,10,5,6,13,25,42,-17,21
AGF Aarhus,3296,11,4,6,12,16,38,-22,18
Brondby,3297,1,22,5,3,72,29,43,71
FC Midtjylla,3297,2,19,6,5,64,37,27,63
FC Nords,3297,3,13,8,9,71,51,20,47
Copenhagen,3297,4,12,6,12,54,46,8,42
AaB,3297,5,7,14,9,39,42,-3,35
AC Horsens,3297,6,7,13,10,34,55,-21,34
Sonderjyske,3297,7,8,6,10,28,29,-1,30
Randers FC,3297,8,6,6,12,24,39,-15,24
AGF Aarhus,3297,9,5,6,11,19,37,-18,21
Lyngby,3297,10,3,9,12,26,45,-19,18
Silkeborg IF,3297,11,5,3,14,26,47,-21,18
Brondby,3298,1,21,6,3,71,32,39,69
FC Midtjylla,3298,2,20,4,6,64,36,28,64
Copenhagen,3298,3,14,6,10,59,46,13,48
FC Nords,3298,4,13,7,10,73,59,14,46
AaB,3298,5,9,11,10,42,42,0,38
Sonderjyske,3298,6,8,6,10,28,29,-1,30
AC Horsens,3298,7,6,12,12,36,56,-20,30
Lyngby,3298,8,4,9,11,28,44,-16,21
Silkeborg IF,3298,9,6,3,13,26,44,-18,21
Randers FC,3298,10,5,6,13,23,41,-18,21
AGF Aarhus,3298,11,4,6,12,16,37,-21,18
Brondby,3299,1,21,6,3,69,33,36,69
FC Midtjylla,3299,2,19,5,6,62,36,26,62
FC Nords,3299,3,14,7,9,73,52,21,49
Copenhagen,3299,4,13,6,11,54,44,10,45
AC Horsens,3299,5,8,12,10,37,48,-11,36
AaB,3299,6,7,12,11,36,44,-8,33
Sonderjyske,3299,7,8,6,10,28,29,-1,30
Randers FC,3299,8,6,6,12,25,39,-14,24
AGF Aarhus,3299,9,5,6,11,18,37,-19,21
Lyngby,3299,10,3,9,12,26,46,-20,18
Silkeborg IF,3299,10,5,3,14,26,46,-20,18
Brondby,3300,1,22,6,2,73,30,43,72
FC Midtjylla,3300,2,20,4,6,70,37,33,64
Copenhagen,3300,3,15,4,11,61,47,14,49
FC Nords,3300,4,13,7,10,70,58,12,46
AC Horsens,3300,5,6,15,9,36,50,-14,33
Sonderjyske,3300,6,8,6,10,28,29,-1,30
AaB,3300,7,6,12,12,36,50,-14,30
Randers FC,3300,8,5,7,12,25,41,-16,22
AGF Aarhus,3300,9,5,6,11,18,36,-18,21
Lyngby,3300,10,3,10,11,28,46,-18,19
Silkeborg IF,3300,11,5,3,14,25,46,-21,18
Brondby,3301,1,21,6,3,72,33,39,69
FC Midtjylla,3301,2,19,6,5,68,39,29,63
FC Nords,3301,3,14,8,8,72,48,24,50
Copenhagen,3301,4,12,5,13,54,48,6,41
AC Horsens,3301,5,8,13,9,39,50,-11,37
AaB,3301,6,7,12,11,36,49,-13,33
Sonderjyske,3301,7,8,6,10,28,29,-1,30
Randers FC,3301,8,5,7,12,24,40,-16,22
Silkeborg IF,3301,9,6,3,13,28,44,-16,21
Lyngby,3301,10,3,10,11,27,45,-18,19
AGF Aarhus,3301,11,4,6,12,16,39,-23,18
Brondby,3302,1,20,7,3,70,32,38,67
FC Midtjylla,3302,2,20,6,4,65,37,28,66
FC Nords,3302,3,15,8,7,78,50,28,53
Copenhagen,3302,4,12,5,13,54,50,4,41
AaB,3302,5,7,12,11,42,48,-6,33
AC Horsens,3302,6,6,14,10,36,54,-18,32
Sonderjyske,3302,7,8,6,10,28,29,-1,30
Lyngby,3302,8,4,9,11,29,44,-15,21
Randers FC,3302,9,5,6,13,23,42,-19,21
AGF Aarhus,3302,10,5,6,11,18,37,-19,21
Silkeborg IF,3302,11,5,3,14,26,46,-20,18
Brondby,3303,1,21,5,4,72,36,36,68
FC Midtjylla,3303,2,18,7,5,66,41,25,61
Copenhagen,3303,3,15,4,11,57,43,14,49
FC Nords,3303,4,13,8,9,73,55,18,47
AaB,3303,5,8,13,9,39,41,-2,37
AC Horsens,3303,6,6,13,11,36,53,-17,31
Sonderjyske,3303,7,8,6,10,28,29,-1,30
Randers FC,3303,8,6,6,12,25,40,-15,24
Silkeborg IF,3303,9,6,3,13,31,44,-13,21
Lyngby,3303,10,3,9,12,27,46,-19,18
AGF Aarhus,3303,11,4,6,12,16,42,-26,18
Brondby,3304,1,23,5,2,77,28,49,74
FC Midtjylla,3304,2,17,6,7,58,40,18,57
FC Nords,3304,3,15,6,9,71,47,24,51
Copenhagen,3304,4,15,5,10,58,41,17,50
AaB,3304,5,7,12,11,32,45,-13,33
Sonderjyske,3304,6,8,6,10,28,29,-1,30
AC Horsens,3304,7,5,14,11,31,52,-21,29
Lyngby,3304,8,4,9,11,28,44,-16,21
Silkeborg IF,3304,8,6,3,13,28,44,-16,21
Randers FC,3304,10,5,6,13,23,41,-18,21
AGF Aarhus,3304,11,4,6,12,16,39,-23,18
FC Midtjylla,3305,1,20,5,5,68,39,29,65
Brondby,3305,2,19,7,4,66,34,32,64
FC Nords,3305,3,14,8,8,73,50,23,50
Copenhagen,3305,4,12,7,11,55,46,9,43
AaB,3305,5,8,12,10,40,44,-4,36
AC Horsens,3305,6,7,13,10,38,53,-15,34
Sonderjyske,3305,7,8,6,10,28,29,-1,30
Randers FC,3305,8,5,7,12,25,41,-16,22
Silkeborg IF,3305,9,6,3,13,28,45,-17,21
Lyngby,3305,10,3,10,11,28,46,-18,19
AGF Aarhus,3305,11,4,6,12,17,39,-22,18
Brondby,3306,1,22,5,3,72,32,40,71
FC Midtjylla,3306,2,19,5,6,65,38,27,62
Copenhagen,3306,3,14,6,10,60,46,14,48
FC Nords,3306,4,13,7,10,69,54,15,46
AaB,3306,5,7,13,10,36,42,-6,34
AC Horsens,3306,6,5,16,9,35,51,-16,31
Sonderjyske,3306,7,8,6,10,28,29,-1,30
Silkeborg IF,3306,8,6,3,13,30,46,-16,21
Lyngby,3306,9,4,9,11,27,44,-17,21
Randers FC,3306,10,5,6,13,23,40,-17,21
AGF Aarhus,3306,11,4,6,12,18,41,-23,18
FC Midtjylla,3307,1,20,5,5,71,43,28,65
Brondby,3307,2,19,6,5,67,38,29,63
FC Nords,3307,3,13,9,8,73,53,20,48
Copenhagen,3307,4,14,5,11,64,49,15,47
AC Horsens,3307,5,7,15,8,38,51,-13,36
AaB,3307,6,7,12,11,37,42,-5,33
Sonderjyske,3307,7,8,6,10,28,29,-1,30
Lyngby,3307,8,4,9,11,27,44,-17,21
Randers FC,3307,9,5,6,13,23,40,-17,21
AGF Aarhus,3307,10,5,6,11,18,37,-19,21
Silkeborg IF,3307,11,5,3,14,26,46,-20,18
Brondby,3308,1,20,7,3,75,32,43,67
FC Midtjylla,3308,2,19,4,7,62,39,23,61
FC Nords,3308,3,14,9,7,72,48,24,51
Copenhagen,3308,4,14,6,10,60,46,14,48
AC Horsens,3308,5,6,15,9,37,55,-18,33
AaB,3308,6,6,13,11,35,47,-12,31
Sonderjyske,3308,7,8,6,10,28,29,-1,30
Lyngby,3308,8,4,9,11,29,44,-15,21
Randers FC,3308,9,5,6,13,23,42,-19,21
AGF Aarhus,3308,10,5,6,11,17,36,-19,21
Silkeborg IF,3308,11,5,3,14,25,45,-20,18
Brondby,3309,1,20,6,4,70,34,36,66
FC Midtjylla,3309,2,19,5,6,63,44,19,62
FC Nords,3309,3,13,9,8,74,53,21,48
Copenhagen,3309,4,14,4,12,58,41,17,46
AC Horsens,3309,5,8,13,9,39,52,-13,37
AaB,3309,6,8,11,11,36,42,-6,35
Sonderjyske,3309,7,8,6,10,28,29,-1,30
Randers FC,3309,8,6,6,12,26,41,-15,24
AGF Aarhus,3309,9,5,6,11,20,36,-16,21
Lyngby,3309,10,3,9,12,28,47,-19,18
Silkeborg IF,3309,11,5,3,14,25,48,-23,18
Brondby,3310,1,21,6,3,68,31,37,69
FC Midtjylla,3310,2,20,5,5,68,36,32,65
FC Nords,3310,3,15,6,9,75,53,22,51
Copenhagen,3310,4,13,4,13,57,52,5,43
AaB,3310,5,8,11,11,39,41,-2,35
AC Horsens,3310,6,7,12,11,39,59,-20,33
Sonderjyske,3310,7,8,6,10,28,29,-1,30
Randers FC,3310,8,6,6,12,26,40,-14,24
AGF Aarhus,3310,9,5,6,11,21,37,-16,21
Lyngby,3310,10,3,9,12,27,47,-20,18
Silkeborg IF,3310,11,5,3,14,26,49,-23,18
Brondby,3311,1,20,6,4,77,38,39,66
FC Midtjylla,3311,2,20,6,4,69,40,29,66
FC Nords,3311,3,15,6,9,76,57,19,51
Copenhagen,3311,4,14,5,11,65,52,13,47
AaB,3311,5,7,12,11,40,48,-8,33
AC Horsens,3311,6,6,13,11,37,55,-18,31
Sonderjyske,3311,7,8,6,10,28,29,-1,30
Randers FC,3311,8,5,7,12,24,40,-16,22
Silkeborg IF,3311,9,6,3,13,28,44,-16,21
Lyngby,3311,10,3,10,11,27,45,-18,19
AGF Aarhus,3311,11,4,6,12,16,39,-23,18
Brondby,3312,1,19,6,5,66,38,28,63
FC Midtjylla,3312,2,19,5,6,70,44,26,62
FC Nords,3312,3,13,9,8,73,52,21,48
Copenhagen,3312,4,14,4,12,57,47,10,46
AaB,3312,5,9,12,9,39,38,1,39
AC Horsens,3312,6,8,12,10,41,53,-12,36
Sonderjyske,3312,7,8,6,10,28,29,-1,30
Lyngby,3312,8,4,9,11,28,44,-16,21
Randers FC,3312,9,5,6,13,23,41,-18,21
AGF Aarhus,3312,10,5,6,11,18,36,-18,21
Silkeborg IF,3312,11,5,3,14,25,46,-21,18
Brondby,3313,1,20,6,4,67,34,33,66
FC Midtjylla,3313,2,19,6,5,63,39,24,63
Copenhagen,3313,3,15,4,11,62,44,18,49
FC Nords,3313,4,13,7,10,70,52,18,46
AaB,3313,5,9,12,9,36,38,-2,39
AC Horsens,3313,6,6,13,11,34,51,-17,31
Sonderjyske,3313,7,8,6,10,28,29,-1,30
Lyngby,3313,8,4,9,11,30,46,-16,21
Silkeborg IF,3313,9,6,3,13,27,45,-18,21
Randers FC,3313,10,5,6,13,25,43,-18,21
AGF Aarhus,3313,11,4,6,12,17,38,-21,18
Brondby,3314,1,22,5,3,73,30,43,71
FC Midtjylla,3314,2,21,5,4,65,36,29,68
FC Nords,3314,3,15,6,9,73,52,21,51
Copenhagen,3314,4,13,4,13,63,49,14,43
AaB,3314,5,7,11,12,36,45,-9,32
AC Horsens,3314,6,6,13,11,32,56,-24,31
Sonderjyske,3314,7,8,6,10,28,29,-1,30
Lyngby,3314,8,4,9,11,27,44,-17,21
Randers FC,3314,9,5,6,13,23,40,-17,21
AGF Aarhus,3314,10,5,6,11,17,36,-19,21
Silkeborg IF,3314,11,5,3,14,25,45,-20,18
Brondby,3315,1,20,7,3,68,30,38,67
FC Midtjylla,3315,2,20,5,5,67,38,29,65
FC Nords,3315,3,15,7,8,73,49,24,52
Copenhagen,3315,4,12,7,11,56,48,8,43
AaB,3315,5,7,13,10,36,43,-7,34
Sonderjyske,3315,6,8,6,10,28,29,-1,30
AC Horsens,3315,7,5,15,10,37,55,-18,30
Randers FC,3315,8,5,7,12,25,41,-16,22
Silkeborg IF,3315,9,6,3,13,28,45,-17,21
Lyngby,3315,10,3,10,11,28,46,-18,19
AGF Aarhus,3315,11,4,6,12,17,39,-22,18
Brondby,3316,1,23,5,2,73,31,42,74
FC Midtjylla,3316,2,20,5,5,65,36,29,65
Copenhagen,3316,3,13,6,11,57,44,13,45
FC Nords,3316,4,12,8,10,67,49,18,44
AaB,3316,5,8,12,10,37,43,-6,36
Sonderjyske,3316,6,8,6,10,28,29,-1,30
AC Horsens,3316,7,6,12,12,31,53,-22,30
Randers FC,3316,8,5,7,12,23,39,-16,22
Lyngby,3316,9,3,10,11,26,44,-18,19
Silkeborg IF,3316,10,5,4,13,26,45,-19,19
AGF Aarhus,3316,11,4,7,11,17,37,-20,19
Brondby,3317,1,22,5,3,75,31,44,71
FC Midtjylla,3317,2,19,4,7,68,43,25,61
FC Nords,3317,3,15,7,8,76,50,26,52
Copenhagen,3317,4,13,5,12,56,52,4,44
AaB,3317,5,7,13,10,37,46,-9,34
AC Horsens,3317,6,6,14,10,36,52,-16,32
Sonderjyske,3317,7,8,6,10,28,29,-1,30
Lyngby,3317,8,4,9,11,27,44,-17,21
Silkeborg IF,3317,8,6,3,13,27,44,-17,21
Randers FC,3317,10,5,6,13,23,40,-17,21
AGF Aarhus,3317,11,4,6,12,16,38,-22,18
Brondby,3318,1,21,6,3,69,31,38,69
FC Midtjylla,3318,2,20,6,4,64,34,30,66
Copenhagen,3318,3,14,6,10,60,46,14,48
FC Nords,3318,4,12,7,11,70,55,15,43
AC Horsens,3318,5,7,13,10,37,54,-17,34
AaB,3318,6,7,12,11,36,42,-6,33
Sonderjyske,3318,7,8,6,10,28,29,-1,30
Randers FC,3318,8,6,6,12,27,40,-13,24
Silkeborg IF,3318,9,6,3,13,28,44,-16,21
Lyngby,3318,10,3,9,12,27,48,-21,18
AGF Aarhus,3318,11,4,6,12,16,39,-23,18
Brondby,3319,1,20,7,3,70,34,36,67
FC Midtjylla,3319,2,19,6,5,63,38,25,63
FC Nords,3319,3,14,8,8,77,54,23,50
Copenhagen,3319,4,14,5,11,63,47,16,47
AaB,3319,5,7,12,11,39,48,-9,33
AC Horsens,3319,6,6,14,10,36,53,-17,32
Sonderjyske,3319,7,8,6,10,28,29,-1,30
Randers FC,3319,8,5,7,12,23,39,-16,22
Silkeborg IF,3319,9,6,3,13,26,44,-18,21
Lyngby,3319,10,3,10,11,26,44,-18,19
AGF Aarhus,3319,11,4,6,12,16,37,-21,18
Brondby,3320,1,22,5,3,69,32,37,71
FC Midtjylla,3320,2,19,6,5,62,37,25,63
FC Nords,3320,3,15,6,9,74,51,23,51
Copenhagen,3320,4,14,5,11,56,46,10,47
AaB,3320,5,7,11,12,35,42,-7,32
AC Horsens,3320,6,6,13,11,37,51,-14,31
Sonderjyske,3320,7,8,6,10,28,29,-1,30
Lyngby,3320,8,4,9,11,27,44,-17,21
Randers FC,3320,9,5,6,13,23,40,-17,21
Silkeborg IF,3320,10,5,4,13,25,44,-19,19
AGF Aarhus,3320,11,4,7,11,16,36,-20,19
Brondby,3321,1,20,5,5,68,34,34,65
FC Midtjylla,3321,2,19,5,6,65,40,25,62
Copenhagen,3321,3,15,5,10,57,40,17,50
FC Nords,3321,4,13,9,8,67,47,20,48
AaB,3321,5,8,13,9,37,39,-2,37
AC Horsens,3321,6,6,13,11,32,52,-20,31
Sonderjyske,3321,7,8,6,10,28,29,-1,30
Randers FC,3321,8,6,6,12,24,39,-15,24
AGF Aarhus,3321,9,5,6,11,18,37,-19,21
Lyngby,3321,10,3,9,12,26,45,-19,18
Silkeborg IF,3321,11,5,3,14,26,46,-20,18
Brondby,3322,1,20,6,4,71,33,38,66
FC Midtjylla,3322,2,20,6,4,65,36,29,66
Copenhagen,3322,3,14,7,9,59,44,15,49
FC Nords,3322,4,14,6,10,72,53,19,48
AC Horsens,3322,5,6,14,10,35,52,-17,32
AaB,3322,6,6,13,11,34,44,-10,31
Sonderjyske,3322,7,8,6,10,28,29,-1,30
Lyngby,3322,8,4,9,11,29,44,-15,21
Randers FC,3322,9,5,6,13,23,42,-19,21
AGF Aarhus,3322,10,5,6,11,18,37,-19,21
Silkeborg IF,3322,11,5,3,14,26,46,-20,18
Brondby,3323,1,22,5,3,76,32,44,71
FC Midtjylla,3323,2,19,6,5,64,39,25,63
FC Nords,3323,3,14,7,9,70,51,19,49
Copenhagen,3323,4,12,5,13,54,46,8,41
AaB,3323,5,9,11,10,39,45,-6,38
AC Horsens,3323,6,7,12,11,38,54,-16,33
Sonderjyske,3323,7,8,6,10,28,29,-1,30
Lyngby,3323,8,4,9,11,29,44,-15,21
Silkeborg IF,3323,8,6,3,13,29,44,-15,21
Randers FC,3323,10,5,6,13,23,42,-19,21
AGF Aarhus,3323,11,4,6,12,16,40,-24,18
Brondby,3324,1,21,6,3,71,32,39,69
FC Midtjylla,3324,2,20,4,6,69,44,25,64
FC Nords,3324,3,14,7,9,75,51,24,49
Copenhagen,3324,4,15,4,11,62,50,12,49
AaB,3324,5,7,12,11,40,48,-8,33
AC Horsens,3324,6,6,13,11,40,58,-18,31
Sonderjyske,3324,7,8,6,10,28,29,-1,30
Randers FC,3324,8,6,6,12,26,39,-13,24
Silkeborg IF,3324,9,6,3,13,27,45,-18,21
Lyngby,3324,10,3,9,12,26,47,-21,18
AGF Aarhus,3324,11,4,6,12,17,38,-21,18
Brondby,3325,1,21,6,3,74,32,42,69
FC Midtjylla,3325,2,20,4,6,71,40,31,64
Copenhagen,3325,3,15,5,10,63,47,16,50
FC Nords,3325,4,12,8,10,70,58,12,44
AaB,3325,5,8,11,11,37,45,-8,35
AC Horsens,3325,6,7,12,11,38,57,-19,33
Sonderjyske,3325,7,8,6,10,28,29,-1,30
Lyngby,3325,8,4,9,11,29,45,-16,21
Silkeborg IF,3325,9,6,3,13,28,46,-18,21
Randers FC,3325,10,5,6,13,24,42,-18,21
AGF Aarhus,3325,11,4,6,12,18,39,-21,18
Brondby,3326,1,20,6,4,70,36,34,66
FC Midtjylla,3326,2,18,5,7,65,41,24,59
FC Nords,3326,3,15,6,9,72,51,21,51
Copenhagen,3326,4,14,6,10,57,43,14,48
AaB,3326,5,8,13,9,38,40,-2,37
AC Horsens,3326,6,6,14,10,35,52,-17,32
Sonderjyske,3326,7,8,6,10,28,29,-1,30
Lyngby,3326,8,4,9,11,28,45,-17,21
Randers FC,3326,9,5,6,13,24,41,-17,21
Silkeborg IF,3326,10,5,4,13,26,45,-19,19
AGF Aarhus,3326,11,4,7,11,17,37,-20,19
FC Midtjylla,3327,1,22,4,4,70,37,33,70
Brondby,3327,2,19,7,4,70,36,34,64
FC Nords,3327,3,14,8,8,74,52,22,50
Copenhagen,3327,4,13,6,11,54,43,11,45
AaB,3327,5,8,11,11,38,44,-6,35
Sonderjyske,3327,6,8,6,10,28,29,-1,30
AC Horsens,3327,7,5,14,11,32,52,-20,29
Lyngby,3327,8,4,9,11,29,44,-15,21
Silkeborg IF,3327,9,6,3,13,26,44,-18,21
Randers FC,3327,10,5,6,13,23,42,-19,21
AGF Aarhus,3327,11,4,6,12,16,37,-21,18
Brondby,3328,1,19,8,3,64,31,33,65
FC Midtjylla,3328,2,19,6,5,66,38,28,63
FC Nords,3328,3,16,7,7,76,47,29,55
Copenhagen,3328,4,12,5,13,53,48,5,41
AaB,3328,5,8,12,10,37,40,-3,36
AC Horsens,3328,6,6,14,10,33,51,-18,32
Sonderjyske,3328,7,8,6,10,28,29,-1,30
Randers FC,3328,8,5,7,12,23,39,-16,22
Lyngby,3328,9,3,10,11,26,44,-18,19
Silkeborg IF,3328,10,5,4,13,26,45,-19,19
AGF Aarhus,3328,11,4,7,11,17,37,-20,19
Brondby,3329,1,21,5,4,71,34,37,68
FC Midtjylla,3329,2,20,4,6,65,39,26,64
Copenhagen,3329,3,14,5,11,55,45,10,47
FC Nords,3329,4,13,7,10,72,54,18,46
AaB,3329,5,8,13,9,39,40,-1,37
AC Horsens,3329,6,7,12,11,34,50,-16,33
Sonderjyske,3329,7,8,6,10,28,29,-1,30
Lyngby,3329,8,4,9,11,29,45,-16,21
Randers FC,3329,9,5,6,13,24,42,-18,21
Silkeborg IF,3329,10,5,4,13,27,46,-19,19
AGF Aarhus,3329,11,4,7,11,18,38,-20,19
Brondby,3330,1,19,9,2,70,33,37,66
FC Midtjylla,3330,2,19,7,4,67,40,27,64
FC Nords,3330,3,14,8,8,74,52,22,50
Copenhagen,3330,4,13,7,10,56,43,13,46
AaB,3330,5,7,12,11,37,45,-8,33
AC Horsens,3330,6,6,13,11,35,52,-17,31
Sonderjyske,3330,7,8,6,10,28,29,-1,30
Lyngby,3330,8,4,9,11,30,45,-15,21
Randers FC,3330,9,5,6,13,24,43,-19,21
Silkeborg IF,3330,10,5,4,13,26,45,-19,19
AGF Aarhus,3330,11,4,7,11,17,37,-20,19
FC Midtjylla,3331,1,22,4,4,70,36,34,70
Brondby,3331,2,21,6,3,68,29,39,69
FC Nords,3331,3,14,8,8,76,55,21,50
Copenhagen,3331,4,12,5,13,54,48,6,41
AaB,3331,5,6,14,10,36,44,-8,32
AC Horsens,3331,6,6,13,11,36,54,-18,31
Sonderjyske,3331,7,8,6,10,28,29,-1,30
Randers FC,3331,8,6,6,12,25,40,-15,24
Silkeborg IF,3331,9,6,3,13,28,46,-18,21
Lyngby,3331,10,3,9,12,27,46,-19,18
AGF Aarhus,3331,11,4,6,12,18,39,-21,18
FC Midtjylla,3332,1,21,5,4,70,39,31,68
Brondby,3332,2,20,5,5,70,33,37,65
Copenhagen,3332,3,13,6,11,56,46,10,45
FC Nords,3332,4,12,8,10,70,57,13,44
AC Horsens,3332,5,8,13,9,34,49,-15,37
AaB,3332,6,8,11,11,40,42,-2,35
Sonderjyske,3332,7,8,6,10,28,29,-1,30
Lyngby,3332,8,4,9,11,30,45,-15,21
Silkeborg IF,3332,9,6,3,13,30,46,-16,21
Randers FC,3332,10,5,6,13,24,43,-19,21
AGF Aarhus,3332,11,4,6,12,18,41,-23,18
Brondby,3333,1,21,6,3,75,34,41,69
FC Midtjylla,3333,2,20,4,6,63,37,26,64
Copenhagen,3333,3,14,4,12,60,50,10,46
FC Nords,3333,4,12,8,10,75,61,14,44
AC Horsens,3333,5,7,15,8,38,51,-13,36
AaB,3333,6,7,13,10,40,44,-4,34
Sonderjyske,3333,7,8,6,10,28,29,-1,30
Lyngby,3333,8,4,9,11,28,45,-17,21
Silkeborg IF,3333,9,6,3,13,27,44,-17,21
Randers FC,3333,10,5,6,13,24,41,-17,21
AGF Aarhus,3333,11,4,6,12,16,38,-22,18
Brondby,3334,1,21,5,4,70,33,37,68
FC Midtjylla,3334,2,21,4,5,72,38,34,67
FC Nords,3334,3,15,6,9,74,53,21,51
Copenhagen,3334,4,14,4,12,58,46,12,46
AaB,3334,5,8,11,11,40,47,-7,35
Sonderjyske,3334,6,8,6,10,28,29,-1,30
AC Horsens,3334,7,6,12,12,35,58,-23,30
Randers FC,3334,8,5,7,12,23,39,-16,22
Silkeborg IF,3334,9,6,3,13,28,46,-18,21
Lyngby,3334,10,3,10,11,26,44,-18,19
AGF Aarhus,3334,11,4,6,12,18,39,-21,18
Brondby,3335,1,20,7,3,69,30,39,67
FC Midtjylla,3335,2,20,4,6,67,36,31,64
Copenhagen,3335,3,16,5,9,58,40,18,53
FC Nords,3335,4,13,9,8,72,53,19,48
AC Horsens,3335,5,6,13,11,32,52,-20,31
Sonderjyske,3335,6,8,6,10,28,29,-1,30
AaB,3335,7,6,12,12,34,47,-13,30
Randers FC,3335,8,6,6,12,24,39,-15,24
Silkeborg IF,3335,9,5,4,13,26,45,-19,19
AGF Aarhus,3335,10,4,7,11,17,37,-20,19
Lyngby,3335,11,3,9,12,26,45,-19,18
Brondby,3336,1,19,6,5,68,33,35,63
FC Midtjylla,3336,2,19,4,7,62,40,22,61
Copenhagen,3336,3,15,6,9,60,42,18,51
FC Nords,3336,4,14,6,10,71,53,18,48
AaB,3336,5,8,12,10,36,42,-6,36
AC Horsens,3336,6,8,12,10,37,50,-13,36
Sonderjyske,3336,7,8,6,10,28,29,-1,30
Randers FC,3336,8,5,7,12,25,41,-16,22
Silkeborg IF,3336,9,6,3,13,26,44,-18,21
Lyngby,3336,10,3,10,11,28,46,-18,19
AGF Aarhus,3336,11,4,6,12,16,37,-21,18
Brondby,3337,1,23,5,2,80,34,46,74
FC Midtjylla,3337,2,19,5,6,65,42,23,62
FC Nords,3337,3,13,7,10,75,55,20,46
Copenhagen,3337,4,13,6,11,54,43,11,45
AC Horsens,3337,5,7,13,10,37,55,-18,34
AaB,3337,6,7,12,11,37,45,-8,33
Sonderjyske,3337,7,8,6,10,28,29,-1,30
Lyngby,3337,8,4,9,11,28,44,-16,21
Randers FC,3337,9,5,6,13,23,41,-18,21
Silkeborg IF,3337,10,5,4,13,25,44,-19,19
AGF Aarhus,3337,11,4,7,11,16,36,-20,19
Brondby,3338,1,20,6,4,70,33,37,66
FC Midtjylla,3338,2,19,5,6,68,42,26,62
Copenhagen,3338,3,16,5,9,65,43,22,53
FC Nords,3338,4,12,8,10,68,56,12,44
AC Horsens,3338,5,8,12,10,37,52,-15,36
AaB,3338,6,7,12,11,37,45,-8,33
Sonderjyske,3338,7,8,6,10,28,29,-1,30
Randers FC,3338,8,6,6,12,25,39,-14,24
Silkeborg IF,3338,9,5,4,13,25,44,-19,19
AGF Aarhus,3338,10,4,7,11,16,36,-20,19
Lyngby,3338,11,3,9,12,26,46,-20,18
Brondby,3339,1,20,6,4,67,32,35,66
FC Midtjylla,3339,2,20,4,6,75,42,33,64
FC Nords,3339,3,14,7,9,77,54,23,49
Copenhagen,3339,4,13,5,12,57,48,9,44
AC Horsens,3339,5,9,12,9,39,53,-14,39
AaB,3339,6,7,12,11,38,50,-12,33
Sonderjyske,3339,7,8,6,10,28,29,-1,30
Lyngby,3339,8,4,9,11,28,45,-17,21
Randers FC,3339,9,5,6,13,24,41,-17,21
Silkeborg IF,3339,10,6,3,13,26,44,-18,21
AGF Aarhus,3339,11,4,6,12,16,37,-21,18
Brondby,3340,1,22,6,2,77,33,44,72
FC Midtjylla,3340,2,19,5,6,68,46,22,62
FC Nords,3340,3,14,7,9,78,53,25,49
Copenhagen,3340,4,14,6,10,60,46,14,48
AC Horsens,3340,5,6,14,10,37,55,-18,32
Sonderjyske,3340,6,8,6,10,28,29,-1,30
AaB,3340,7,6,12,12,37,50,-13,30
Lyngby,3340,8,4,9,11,27,44,-17,21
Randers FC,3340,9,5,6,13,23,40,-17,21
Silkeborg IF,3340,10,6,3,13,28,46,-18,21
AGF Aarhus,3340,11,4,6,12,18,39,-21,18
Brondby,3341,1,20,7,3,74,33,41,67
FC Midtjylla,3341,2,19,4,7,65,40,25,61
Copenhagen,3341,3,17,4,9,62,42,20,55
FC Nords,3341,4,14,6,10,74,62,12,48
AC Horsens,3341,5,7,13,10,36,49,-13,34
Sonderjyske,3341,6,8,6,10,28,29,-1,30
AaB,3341,7,6,12,12,36,47,-11,30
Randers FC,3341,8,6,6,12,24,39,-15,24
AGF Aarhus,3341,9,5,6,11,17,36,-19,21
Lyngby,3341,10,3,9,12,26,45,-19,18
Silkeborg IF,3341,11,5,3,14,25,45,-20,18
Brondby,3342,1,20,8,2,74,34,40,68
FC Midtjylla,3342,2,20,6,4,65,37,28,66
FC Nords,3342,3,15,6,9,76,52,24,51
Copenhagen,3342,4,13,5,12,58,47,11,44
AC Horsens,3342,5,7,13,10,36,54,-18,34
Sonderjyske,3342,6,8,6,10,28,29,-1,30
AaB,3342,7,6,12,12,37,48,-11,30
Silkeborg IF,3342,8,6,3,13,31,44,-13,21
Lyngby,3342,9,4,9,11,27,44,-17,21
Randers FC,3342,10,5,6,13,23,40,-17,21
AGF Aarhus,3342,11,4,6,12,16,42,-26,18
Brondby,3343,1,19,8,3,65,30,35,65
FC Midtjylla,3343,2,19,6,5,64,40,24,63
FC Nords,3343,3,13,9,8,73,49,24,48
Copenhagen,3343,4,12,8,10,58,46,12,44
AC Horsens,3343,5,8,13,9,36,51,-15,37
AaB,3343,6,6,14,10,36,42,-6,32
Sonderjyske,3343,7,8,6,10,28,29,-1,30
Lyngby,3343,8,4,9,11,30,45,-15,21
Randers FC,3343,9,5,6,13,24,43,-19,21
AGF Aarhus,3343,10,5,6,11,18,37,-19,21
Silkeborg IF,3343,11,5,3,14,26,46,-20,18
Brondby,3344,1,21,6,3,70,29,41,69
FC Midtjylla,3344,2,19,4,7,63,41,22,61
Copenhagen,3344,3,15,4,11,57,43,14,49
FC Nords,3344,4,14,6,10,73,49,24,48
AaB,3344,5,8,11,11,38,47,-9,35
AC Horsens,3344,6,7,13,10,35,53,-18,34
Sonderjyske,3344,7,8,6,10,28,29,-1,30
Randers FC,3344,8,6,6,12,24,39,-15,24
Silkeborg IF,3344,9,6,3,13,26,44,-18,21
Lyngby,3344,10,3,9,12,26,45,-19,18
AGF Aarhus,3344,11,4,6,12,16,37,-21,18
Brondby,3345,1,21,6,3,69,29,40,69
FC Midtjylla,3345,2,19,5,6,65,40,25,62
FC Nords,3345,3,14,6,10,72,53,19,48
Copenhagen,3345,4,14,6,10,55,40,15,48
AaB,3345,5,7,13,10,34,40,-6,34
AC Horsens,3345,6,7,12,11,34,53,-19,33
Sonderjyske,3345,7,8,6,10,28,29,-1,30
Lyngby,3345,8,4,9,11,28,44,-16,21
Randers FC,3345,9,5,6,13,23,41,-18,21
Silkeborg IF,3345,10,5,4,13,25,44,-19,19
AGF Aarhus,3345,11,4,7,11,16,36,-20,19
Brondby,3346,1,19,8,3,67,32,35,65
FC Midtjylla,3346,2,18,7,5,62,38,24,61
Copenhagen,3346,3,15,6,9,56,40,16,51
FC Nords,3346,4,12,8,10,69,51,18,44
AC Horsens,3346,5,7,15,8,34,46,-12,36
AaB,3346,6,6,14,10,35,42,-7,32
Sonderjyske,3346,7,8,6,10,28,29,-1,30
Lyngby,3346,8,4,9,11,28,45,-17,21
Silkeborg IF,3346,9,6,3,13,27,44,-17,21
Randers FC,3346,10,5,6,13,24,41,-17,21
AGF Aarhus,3346,11,4,6,12,16,38,-22,18
FC Midtjylla,3347,1,19,6,5,76,44,32,63
Brondby,3347,2,19,6,5,69,40,29,63
FC Nords,3347,3,14,7,9,74,56,18,49
Copenhagen,3347,4,14,6,10,62,45,17,48
AaB,3347,5,8,13,9,39,43,-4,37
AC Horsens,3347,6,6,14,10,36,54,-18,32
Sonderjyske,3347,7,8,6,10,28,29,-1,30
Randers FC,3347,8,6,6,12,25,40,-15,24
AGF Aarhus,3347,9,5,6,11,17,36,-19,21
Lyngby,3347,10,3,9,12,27,46,-19,18
Silkeborg IF,3347,11,5,3,14,25,45,-20,18
Brondby,3348,1,20,5,5,71,33,38,65
FC Midtjylla,3348,2,19,4,7,62,41,21,61
FC Nords,3348,3,14,7,9,72,51,21,49
Copenhagen,3348,4,15,4,11,58,47,11,49
AaB,3348,5,9,11,10,37,38,-1,38
AC Horsens,3348,6,7,13,10,32,48,-16,34
Sonderjyske,3348,7,8,6,10,28,29,-1,30
Lyngby,3348,8,4,9,11,27,44,-17,21
Randers FC,3348,9,5,6,13,23,40,-17,21
Silkeborg IF,3348,10,5,4,13,26,45,-19,19
AGF Aarhus,3348,11,4,7,11,17,37,-20,19
Brondby,3349,1,22,6,2,75,32,43,72
FC Midtjylla,3349,2,19,6,5,62,37,25,63
FC Nords,3349,3,14,6,10,70,54,16,48
Copenhagen,3349,4,13,7,10,58,44,14,46
AaB,3349,5,8,12,10,40,44,-4,36
Sonderjyske,3349,6,8,6,10,28,29,-1,30
AC Horsens,3349,7,5,13,12,34,54,-20,28
Randers FC,3349,8,6,6,12,26,39,-13,24
Silkeborg IF,3349,9,6,3,13,26,44,-18,21
Lyngby,3349,10,3,9,12,26,47,-21,18
AGF Aarhus,3349,11,4,6,12,16,37,-21,18
Brondby,3350,1,19,7,4,66,32,34,64
FC Midtjylla,3350,2,20,4,6,69,40,29,64
FC Nords,3350,3,14,6,10,71,53,18,48
Copenhagen,3350,4,14,5,11,60,46,14,47
AaB,3350,5,8,13,9,38,42,-4,37
AC Horsens,3350,6,7,13,10,35,52,-17,34
Sonderjyske,3350,7,8,6,10,28,29,-1,30
Lyngby,3350,8,4,9,11,27,44,-17,21
Randers FC,3350,9,5,6,13,23,40,-17,21
Silkeborg IF,3350,10,6,3,13,26,44,-18,21
AGF Aarhus,3350,11,4,6,12,16,37,-21,18
Brondby,3351,1,21,6,3,70,30,40,69
FC Midtjylla,3351,2,20,4,6,62,37,25,64
FC Nords,3351,3,15,6,9,75,53,22,51
Copenhagen,3351,4,13,6,11,55,42,13,45
AaB,3351,5,7,12,11,38,46,-8,33
AC Horsens,3351,6,7,12,11,33,51,-18,33
Sonderjyske,3351,7,8,6,10,28,29,-1,30
Lyngby,3351,8,4,9,11,29,44,-15,21
Silkeborg IF,3351,9,6,3,13,28,44,-16,21
Randers FC,3351,10,5,6,13,23,42,-19,21
AGF Aarhus,3351,11,4,6,12,16,39,-23,18
Brondby,3352,1,20,7,3,73,31,42,67
FC Midtjylla,3352,2,19,4,7,63,41,22,61
Copenhagen,3352,3,15,4,11,58,45,13,49
FC Nords,3352,4,12,9,9,70,52,18,45
AC Horsens,3352,5,8,14,8,35,47,-12,38
AaB,3352,6,6,14,10,36,45,-9,32
Sonderjyske,3352,7,8,6,10,28,29,-1,30
Randers FC,3352,8,5,7,12,24,40,-16,22
AGF Aarhus,3352,9,5,6,11,18,37,-19,21
Lyngby,3352,10,3,10,11,27,45,-18,19
Silkeborg IF,3352,11,5,3,14,26,46,-20,18
Brondby,3353,1,19,7,4,67,31,36,64
FC Midtjylla,3353,2,18,7,5,66,41,25,61
Copenhagen,3353,3,15,4,11,56,45,11,49
FC Nords,3353,4,13,8,9,76,56,20,47
AC Horsens,3353,5,8,13,9,37,49,-12,37
AaB,3353,6,7,13,10,39,45,-6,34
Sonderjyske,3353,7,8,6,10,28,29,-1,30
Lyngby,3353,8,4,9,11,28,45,-17,21
Randers FC,3353,9,5,6,13,24,41,-17,21
Silkeborg IF,3353,10,5,4,13,28,47,-19,19
AGF Aarhus,3353,11,4,7,11,19,39,-20,19
Brondby,3354,1,21,5,4,73,32,41,68
FC Midtjylla,3354,2,21,4,5,67,38,29,67
FC Nords,3354,3,15,6,9,76,52,24,51
Copenhagen,3354,4,12,5,13,56,49,7,41
AaB,3354,5,8,12,10,39,48,-9,36
AC Horsens,3354,6,6,14,10,31,49,-18,32
Sonderjyske,3354,7,8,6,10,28,29,-1,30
Lyngby,3354,8,4,9,11,28,44,-16,21
Randers FC,3354,9,5,6,13,23,41,-18,21
AGF Aarhus,3354,10,5,6,11,17,36,-19,21
Silkeborg IF,3354,11,5,3,14,25,45,-20,18
Brondby,3355,1,21,5,4,76,33,43,68
FC Midtjylla,3355,2,19,4,7,63,41,22,61
Copenhagen,3355,3,15,4,11,61,43,18,49
FC Nords,3355,4,14,7,9,69,56,13,49
AaB,3355,5,10,11,9,41,39,2,41
Sonderjyske,3355,6,8,6,10,28,29,-1,30
AC Horsens,3355,7,5,13,12,35,59,-24,28
Randers FC,3355,8,6,6,12,25,40,-15,24
AGF Aarhus,3355,9,5,6,11,19,37,-18,21
Lyngby,3355,10,3,9,12,27,46,-19,18
Silkeborg IF,3355,11,5,3,14,26,47,-21,18
Brondby,3356,1,22,5,3,73,31,42,71
FC Midtjylla,3356,2,18,5,7,64,43,21,59
FC Nords,3356,3,13,8,9,71,51,20,47
Copenhagen,3356,4,13,5,12,55,48,7,44
AC Horsens,3356,5,8,13,9,42,54,-12,37
AaB,3356,6,8,12,10,41,45,-4,36
Sonderjyske,3356,7,8,6,10,28,29,-1,30
Randers FC,3356,8,5,7,12,23,39,-16,22
Lyngby,3356,9,3,10,11,26,44,-18,19
Silkeborg IF,3356,10,5,4,13,28,47,-19,19
AGF Aarhus,3356,11,4,7,11,19,39,-20,19
Brondby,3357,1,20,5,5,69,32,37,65
FC Midtjylla,3357,2,19,6,5,63,38,25,63
Copenhagen,3357,3,15,4,11,57,44,13,49
FC Nords,3357,4,13,7,10,72,55,17,46
AC Horsens,3357,5,8,14,8,35,45,-10,38
AaB,3357,6,7,12,11,39,47,-8,33
Sonderjyske,3357,7,8,6,10,28,29,-1,30
Lyngby,3357,8,4,9,11,28,45,-17,21
Randers FC,3357,9,5,6,13,24,41,-17,21
Silkeborg IF,3357,10,6,3,13,27,45,-18,21
AGF Aarhus,3357,11,4,6,12,17,38,-21,18
Brondby,3358,1,21,6,3,74,33,41,69
FC Midtjylla,3358,2,19,4,7,64,40,24,61
FC Nords,3358,3,15,6,9,79,52,27,51
Copenhagen,3358,4,13,7,10,57,47,10,46
AC Horsens,3358,5,7,13,10,36,53,-17,34
AaB,3358,6,7,12,11,35,46,-11,33
Sonderjyske,3358,7,8,6,10,28,29,-1,30
Lyngby,3358,8,4,9,11,29,45,-16,21
Silkeborg IF,3358,9,6,3,13,28,44,-16,21
Randers FC,3358,10,5,6,13,24,42,-18,21
AGF Aarhus,3358,11,4,6,12,16,39,-23,18
Brondby,3359,1,22,6,2,70,30,40,72
FC Midtjylla,3359,2,19,5,6,65,42,23,62
FC Nords,3359,3,13,8,9,73,55,18,47
Copenhagen,3359,4,14,4,12,61,46,15,46
AaB,3359,5,7,14,9,35,39,-4,35
AC Horsens,3359,6,6,13,11,39,57,-18,31
Sonderjyske,3359,7,8,6,10,28,29,-1,30
Randers FC,3359,8,6,6,12,25,39,-14,24
Silkeborg IF,3359,9,5,4,13,25,44,-19,19
AGF Aarhus,3359,10,4,7,11,16,36,-20,19
Lyngby,3359,11,3,9,12,26,46,-20,18
Brondby,3360,1,21,5,4,67,36,31,68
FC Midtjylla,3360,2,21,4,5,74,39,35,67
FC Nords,3360,3,15,6,9,75,55,20,51
Copenhagen,3360,4,15,4,11,58,43,15,49
AaB,3360,5,8,11,11,39,43,-4,35
Sonderjyske,3360,6,8,6,10,28,29,-1,30
AC Horsens,3360,7,5,12,13,31,54,-23,27
Lyngby,3360,8,4,9,11,28,44,-16,21
Silkeborg IF,3360,9,6,3,13,26,44,-18,21
Randers FC,3360,10,5,6,13,23,41,-18,21
AGF Aarhus,3360,11,4,6,12,16,37,-21,18
Brondby,3361,1,19,6,5,68,35,33,63
FC Midtjylla,3361,2,19,6,5,66,42,24,63
FC Nords,3361,3,15,7,8,72,49,23,52
Copenhagen,3361,4,15,5,10,58,42,16,50
AaB,3361,5,8,11,11,39,42,-3,35
AC Horsens,3361,6,6,13,11,33,52,-19,31
Sonderjyske,3361,7,8,6,10,28,29,-1,30
Lyngby,3361,8,4,9,11,30,46,-16,21
Randers FC,3361,9,5,6,13,25,43,-18,21
Silkeborg IF,3361,10,5,4,13,26,45,-19,19
AGF Aarhus,3361,11,4,7,11,17,37,-20,19
Brondby,3362,1,21,6,3,71,33,38,69
FC Midtjylla,3362,2,20,5,5,71,42,29,65
FC Nords,3362,3,14,6,10,73,53,20,48
Copenhagen,3362,4,14,6,10,61,48,13,48
AaB,3362,5,8,12,10,38,41,-3,36
Sonderjyske,3362,6,8,6,10,28,29,-1,30
AC Horsens,3362,7,5,13,12,33,56,-23,28
Randers FC,3362,8,5,7,12,25,41,-16,22
Lyngby,3362,9,3,10,11,28,46,-18,19
Silkeborg IF,3362,10,5,4,13,27,46,-19,19
AGF Aarhus,3362,11,4,7,11,18,38,-20,19
Brondby,3363,1,21,5,4,72,40,32,68
FC Midtjylla,3363,2,20,4,6,68,40,28,64
FC Nords,3363,3,14,7,9,76,53,23,49
Copenhagen,3363,4,14,5,11,61,45,16,47
AaB,3363,5,7,13,10,41,46,-5,34
AC Horsens,3363,6,7,12,11,39,59,-20,33
Sonderjyske,3363,7,8,6,10,28,29,-1,30
Randers FC,3363,8,6,6,12,26,40,-14,24
Silkeborg IF,3363,9,6,3,13,27,44,-17,21
Lyngby,3363,10,3,9,12,27,47,-20,18
AGF Aarhus,3363,11,4,6,12,16,38,-22,18
Brondby,3364,1,21,6,3,71,33,38,69
FC Midtjylla,3364,2,18,5,7,62,41,21,59
FC Nords,3364,3,16,6,8,77,49,28,54
Copenhagen,3364,4,13,6,11,58,44,14,45
AaB,3364,5,8,12,10,35,42,-7,36
Sonderjyske,3364,6,8,6,10,28,29,-1,30
AC Horsens,3364,7,5,15,10,33,53,-20,30
Randers FC,3364,8,6,6,12,24,39,-15,24
Silkeborg IF,3364,9,5,4,13,26,45,-19,19
AGF Aarhus,3364,10,4,7,11,17,37,-20,19
Lyngby,3364,11,3,9,12,26,45,-19,18
Brondby,3365,1,19,6,5,70,38,32,63
FC Midtjylla,3365,2,19,4,7,69,44,25,61
FC Nords,3365,3,16,6,8,79,51,28,54
Copenhagen,3365,4,14,5,11,54,43,11,47
AC Horsens,3365,5,8,12,10,36,53,-17,36
AaB,3365,6,7,13,10,35,40,-5,34
Sonderjyske,3365,7,8,6,10,28,29,-1,30
Randers FC,3365,8,6,6,12,24,39,-15,24
Silkeborg IF,3365,9,5,4,13,25,44,-19,19
AGF Aarhus,3365,10,4,7,11,16,36,-20,19
Lyngby,3365,11,3,9,12,26,45,-19,18
Brondby,3366,1,20,7,3,73,35,38,67
FC Midtjylla,3366,2,19,5,6,63,40,23,62
Copenhagen,3366,3,14,5,11,59,45,14,47
FC Nords,3366,4,12,7,11,71,60,11,43
AaB,3366,5,9,13,8,39,36,3,40
AC Horsens,3366,6,7,13,10,35,50,-15,34
Sonderjyske,3366,7,8,6,10,28,29,-1,30
Randers FC,3366,8,5,7,12,24,40,-16,22
AGF Aarhus,3366,9,5,6,11,19,38,-19,21
Lyngby,3366,10,3,10,11,27,45,-18,19
Silkeborg IF,3366,11,5,3,14,27,47,-20,18
Brondby,3367,1,22,5,3,71,31,40,71
FC Midtjylla,3367,2,21,4,5,65,39,26,67
FC Nords,3367,3,15,6,9,77,51,26,51
Copenhagen,3367,4,13,4,13,55,47,8,43
AaB,3367,5,7,12,11,34,42,-8,33
AC Horsens,3367,6,6,13,11,35,53,-18,31
Sonderjyske,3367,7,8,6,10,28,29,-1,30
Randers FC,3367,8,6,6,12,25,39,-14,24
Silkeborg IF,3367,9,6,3,13,28,45,-17,21
Lyngby,3367,10,3,9,12,26,46,-20,18
AGF Aarhus,3367,11,4,6,12,17,39,-22,18
FC Midtjylla,3368,1,20,6,4,71,38,33,66
Brondby,3368,2,18,10,2,68,33,35,64
FC Nords,3368,3,15,7,8,79,51,28,52
Copenhagen,3368,4,12,7,11,54,48,6,43
AaB,3368,5,7,13,10,37,43,-6,34
AC Horsens,3368,6,6,13,11,32,54,-22,31
Sonderjyske,3368,7,8,6,10,28,29,-1,30
Lyngby,3368,8,4,9,11,27,44,-17,21
Randers FC,3368,9,5,6,13,23,40,-17,21
Silkeborg IF,3368,10,5,4,13,25,44,-19,19
AGF Aarhus,3368,11,4,7,11,16,36,-20,19
Brondby,3369,1,21,6,3,71,30,41,69
FC Midtjylla,3369,2,20,5,5,69,41,28,65
Copenhagen,3369,3,14,6,10,58,47,11,48
FC Nords,3369,4,13,7,10,74,52,22,46
AC Horsens,3369,5,8,12,10,36,51,-15,36
Sonderjyske,3369,6,8,6,10,28,29,-1,30
AaB,3369,7,6,12,12,35,48,-13,30
Lyngby,3369,8,4,9,11,28,44,-16,21
Silkeborg IF,3369,9,6,3,13,28,46,-18,21
Randers FC,3369,10,5,6,13,23,41,-18,21
AGF Aarhus,3369,11,4,6,12,18,39,-21,18
Brondby,3370,1,22,5,3,70,31,39,71
FC Midtjylla,3370,2,20,4,6,66,37,29,64
Copenhagen,3370,3,15,4,11,61,46,15,49
FC Nords,3370,4,13,6,11,69,54,15,45
AaB,3370,5,8,11,11,37,44,-7,35
AC Horsens,3370,6,7,12,11,36,53,-17,33
Sonderjyske,3370,7,8,6,10,28,29,-1,30
Randers FC,3370,8,6,6,12,26,41,-15,24
Silkeborg IF,3370,9,6,3,13,26,44,-18,21
Lyngby,3370,10,3,9,12,28,47,-19,18
AGF Aarhus,3370,11,4,6,12,16,37,-21,18
Brondby,3371,1,21,7,2,75,33,42,70
FC Midtjylla,3371,2,20,6,4,68,39,29,66
FC Nords,3371,3,14,7,9,76,56,20,49
Copenhagen,3371,4,13,5,12,57,48,9,44
AC Horsens,3371,5,6,14,10,33,49,-16,32
AaB,3371,6,6,13,11,36,46,-10,31
Sonderjyske,3371,7,8,6,10,28,29,-1,30
Lyngby,3371,8,4,9,11,27,44,-17,21
Randers FC,3371,9,5,6,13,23,40,-17,21
Silkeborg IF,3371,10,6,3,13,26,44,-18,21
AGF Aarhus,3371,11,4,6,12,16,37,-21,18
Brondby,3372,1,22,6,2,72,28,44,72
FC Midtjylla,3372,2,21,4,5,66,36,30,67
FC Nords,3372,3,14,6,10,73,50,23,48
Copenhagen,3372,4,12,6,12,57,49,8,42
AaB,3372,5,9,11,10,39,43,-4,38
Sonderjyske,3372,6,8,6,10,28,29,-1,30
AC Horsens,3372,7,5,13,12,33,60,-27,28
Randers FC,3372,8,6,6,12,24,39,-15,24
Silkeborg IF,3372,9,5,4,13,27,46,-19,19
AGF Aarhus,3372,10,4,7,11,18,38,-20,19
Lyngby,3372,11,3,9,12,26,45,-19,18
Brondby,3373,1,21,7,2,74,34,40,70
FC Midtjylla,3373,2,20,4,6,65,40,25,64
FC Nords,3373,3,14,6,10,74,53,21,48
Copenhagen,3373,4,13,5,12,56,47,9,44
AaB,3373,5,8,12,10,43,45,-2,36
AC Horsens,3373,6,7,12,11,38,57,-19,33
Sonderjyske,3373,7,8,6,10,28,29,-1,30
Randers FC,3373,8,6,6,12,25,40,-15,24
Silkeborg IF,3373,9,6,3,13,26,44,-18,21
Lyngby,3373,10,3,9,12,27,46,-19,18
AGF Aarhus,3373,11,4,6,12,16,37,-21,18
Brondby,3374,1,21,7,2,67,28,39,70
FC Midtjylla,3374,2,20,6,4,71,39,32,66
FC Nords,3374,3,13,9,8,71,51,20,48
Copenhagen,3374,4,13,7,10,58,45,13,46
AC Horsens,3374,5,6,14,10,34,53,-19,32
Sonderjyske,3374,6,8,6,10,28,29,-1,30
AaB,3374,7,6,11,13,35,46,-11,29
Lyngby,3374,8,4,9,11,28,44,-16,21
Randers FC,3374,9,5,6,13,23,41,-18,21
AGF Aarhus,3374,10,5,6,11,19,37,-18,21
Silkeborg IF,3374,11,5,3,14,26,47,-21,18
Brondby,3375,1,20,5,5,68,34,34,65
FC Midtjylla,3375,2,19,5,6,62,37,25,62
Copenhagen,3375,3,15,5,10,62,46,16,50
FC Nords,3375,4,13,9,8,70,49,21,48
AaB,3375,5,7,13,10,40,46,-6,34
AC Horsens,3375,6,7,13,10,34,50,-16,34
Sonderjyske,3375,7,8,6,10,28,29,-1,30
Lyngby,3375,8,4,9,11,27,44,-17,21
Randers FC,3375,9,5,6,13,23,40,-17,21
Silkeborg IF,3375,10,5,4,13,26,45,-19,19
AGF Aarhus,3375,11,4,7,11,17,37,-20,19
Brondby,3376,1,19,7,4,69,37,32,64
FC Midtjylla,3376,2,19,5,6,63,38,25,62
FC Nords,3376,3,16,7,7,78,45,33,55
Copenhagen,3376,4,15,5,10,59,44,15,50
AC Horsens,3376,5,7,12,11,35,55,-20,33
Sonderjyske,3376,6,8,6,10,28,29,-1,30
AaB,3376,7,6,12,12,34,45,-11,30
Randers FC,3376,8,6,6,12,24,39,-15,24
Silkeborg IF,3376,9,6,3,13,28,44,-16,21
Lyngby,3376,10,3,9,12,26,45,-19,18
AGF Aarhus,3376,11,4,6,12,16,39,-23,18
Brondby,3377,1,21,5,4,75,32,43,68
FC Midtjylla,3377,2,19,5,6,63,42,21,62
Copenhagen,3377,3,16,5,9,62,42,20,53
FC Nords,3377,4,14,6,10,70,51,19,48
AaB,3377,5,7,11,12,35,45,-10,32
AC Horsens,3377,6,6,14,10,35,54,-19,32
Sonderjyske,3377,7,8,6,10,28,29,-1,30
Randers FC,3377,8,6,6,12,24,39,-15,24
AGF Aarhus,3377,9,5,6,11,18,36,-18,21
Lyngby,3377,10,3,9,12,26,45,-19,18
Silkeborg IF,3377,11,5,3,14,25,46,-21,18
Brondby,3378,1,22,6,2,75,30,45,72
FC Midtjylla,3378,2,19,5,6,64,39,25,62
FC Nords,3378,3,13,7,10,70,58,12,46
Copenhagen,3378,4,13,7,10,56,44,12,46
AaB,3378,5,7,12,11,40,46,-6,33
AC Horsens,3378,6,6,15,9,37,51,-14,33
Sonderjyske,3378,7,8,6,10,28,29,-1,30
Randers FC,3378,8,6,6,12,25,40,-15,24
Silkeborg IF,3378,9,6,3,13,27,44,-17,21
Lyngby,3378,10,3,9,12,27,46,-19,18
AGF Aarhus,3378,11,4,6,12,16,38,-22,18
Brondby,3379,1,21,5,4,82,33,49,68
FC Midtjylla,3379,2,19,5,6,63,45,18,62
FC Nords,3379,3,15,7,8,77,52,25,52
Copenhagen,3379,4,13,7,10,57,44,13,46
AaB,3379,5,6,14,10,37,50,-13,32
AC Horsens,3379,6,6,14,10,36,54,-18,32
Sonderjyske,3379,7,8,6,10,28,29,-1,30
Randers FC,3379,8,5,7,12,24,40,-16,22
Silkeborg IF,3379,9,6,3,13,26,44,-18,21
Lyngby,3379,10,3,10,11,27,45,-18,19
AGF Aarhus,3379,11,4,6,12,16,37,-21,18
Brondby,3380,1,22,5,3,71,33,38,71
FC Midtjylla,3380,2,20,4,6,66,43,23,64
Copenhagen,3380,3,16,5,9,64,39,25,53
FC Nords,3380,4,14,6,10,81,57,24,48
Sonderjyske,3380,5,8,6,10,28,29,-1,30
AaB,3380,6,6,12,12,34,44,-10,30
AC Horsens,3380,7,6,12,12,33,59,-26,30
Lyngby,3380,8,4,9,11,28,45,-17,21
Randers FC,3380,9,5,6,13,24,41,-17,21
AGF Aarhus,3380,10,5,6,11,17,36,-19,21
Silkeborg IF,3380,11,5,3,14,25,45,-20,18
Brondby,3381,1,20,7,3,68,30,38,67
FC Midtjylla,3381,2,19,5,6,63,40,23,62
FC Nords,3381,3,15,8,7,72,46,26,53
Copenhagen,3381,4,14,6,10,57,42,15,48
AaB,3381,5,7,13,10,37,43,-6,34
Sonderjyske,3381,6,8,6,10,28,29,-1,30
AC Horsens,3381,7,5,13,12,32,54,-22,28
Randers FC,3381,8,6,6,12,26,40,-14,24
AGF Aarhus,3381,9,5,6,11,19,37,-18,21
Lyngby,3381,10,3,9,12,27,47,-20,18
Silkeborg IF,3381,11,5,3,14,26,47,-21,18
Brondby,3382,1,22,6,2,76,34,42,72
FC Midtjylla,3382,2,19,5,6,63,38,25,62
FC Nords,3382,3,15,7,8,73,48,25,52
Copenhagen,3382,4,12,6,12,56,47,9,42
AaB,3382,5,8,11,11,37,46,-9,35
AC Horsens,3382,6,6,13,11,32,50,-18,31
Sonderjyske,3382,7,8,6,10,28,29,-1,30
Silkeborg IF,3382,8,6,3,13,28,45,-17,21
Lyngby,3382,9,4,9,11,27,44,-17,21
Randers FC,3382,10,5,6,13,23,40,-17,21
AGF Aarhus,3382,11,4,6,12,17,39,-22,18
Brondby,3383,1,20,5,5,68,38,30,65
FC Midtjylla,3383,2,18,6,6,61,38,23,60
Copenhagen,3383,3,15,5,10,64,43,21,50
FC Nords,3383,4,14,6,10,73,55,18,48
AaB,3383,5,8,12,10,39,46,-7,36
AC Horsens,3383,6,7,14,9,37,48,-11,35
Sonderjyske,3383,7,8,6,10,28,29,-1,30
Randers FC,3383,8,5,7,12,24,40,-16,22
Silkeborg IF,3383,9,6,3,13,28,46,-18,21
Lyngby,3383,10,3,10,11,27,45,-18,19
AGF Aarhus,3383,11,4,6,12,18,39,-21,18
Brondby,3384,1,22,6,2,70,28,42,72
FC Midtjylla,3384,2,18,7,5,69,44,25,61
FC Nords,3384,3,14,6,10,70,53,17,48
Copenhagen,3384,4,13,6,11,56,44,12,45
AaB,3384,5,7,13,10,35,41,-6,34
AC Horsens,3384,6,5,16,9,32,48,-16,31
Sonderjyske,3384,7,8,6,10,28,29,-1,30
Randers FC,3384,8,5,7,12,23,39,-16,22
Lyngby,3384,9,3,10,11,26,44,-18,19
Silkeborg IF,3384,10,5,4,13,26,45,-19,19
AGF Aarhus,3384,11,4,7,11,17,37,-20,19
Brondby,3385,1,21,7,2,70,27,43,70
FC Midtjylla,3385,2,19,5,6,68,41,27,62
Copenhagen,3385,3,14,5,11,61,49,12,47
FC Nords,3385,4,13,7,10,69,53,16,46
AaB,3385,5,8,11,11,38,47,-9,35
AC Horsens,3385,6,7,13,10,35,50,-15,34
Sonderjyske,3385,7,8,6,10,28,29,-1,30
Lyngby,3385,8,4,9,11,28,45,-17,21
Randers FC,3385,9,5,6,13,24,41,-17,21
Silkeborg IF,3385,10,5,4,13,25,44,-19,19
AGF Aarhus,3385,11,4,7,11,16,36,-20,19
Brondby,3386,1,21,6,3,74,30,44,69
FC Midtjylla,3386,2,21,4,5,67,37,30,67
Copenhagen,3386,3,16,4,10,61,44,17,52
FC Nords,3386,4,13,6,11,69,56,13,45
AaB,3386,5,7,12,11,33,41,-8,33
Sonderjyske,3386,6,8,6,10,28,29,-1,30
AC Horsens,3386,7,6,12,12,33,55,-22,30
Randers FC,3386,8,5,7,12,24,40,-16,22
Lyngby,3386,9,3,10,11,27,45,-18,19
Silkeborg IF,3386,10,5,4,13,25,44,-19,19
AGF Aarhus,3386,11,4,7,11,16,36,-20,19
Brondby,3387,1,21,6,3,74,32,42,69
FC Midtjylla,3387,2,20,4,6,66,40,26,64
FC Nords,3387,3,14,8,8,79,56,23,50
Copenhagen,3387,4,15,4,11,61,46,15,49
AC Horsens,3387,5,7,12,11,37,58,-21,33
Sonderjyske,3387,6,8,6,10,28,29,-1,30
AaB,3387,7,6,12,12,35,46,-11,30
Randers FC,3387,8,6,6,12,24,39,-15,24
AGF Aarhus,3387,9,5,6,11,18,37,-19,21
Lyngby,3387,10,3,9,12,26,45,-19,18
Silkeborg IF,3387,11,5,3,14,26,46,-20,18
Brondby,3388,1,21,6,3,75,34,41,69
FC Midtjylla,3388,2,21,4,5,65,37,28,67
FC Nords,3388,3,14,7,9,73,53,20,49
Copenhagen,3388,4,13,7,10,54,42,12,46
AaB,3388,5,6,13,11,36,43,-7,31
AC Horsens,3388,6,6,13,11,35,55,-20,31
Sonderjyske,3388,7,8,6,10,28,29,-1,30
Randers FC,3388,8,5,7,12,25,41,-16,22
AGF Aarhus,3388,9,5,6,11,18,36,-18,21
Lyngby,3388,10,3,10,11,28,46,-18,19
Silkeborg IF,3388,11,5,3,14,25,46,-21,18
FC Midtjylla,3389,1,21,4,5,71,39,32,67
Brondby,3389,2,20,6,4,71,33,38,66
FC Nords,3389,3,14,6,10,72,52,20,48
Copenhagen,3389,4,13,6,11,55,45,10,45
AaB,3389,5,8,11,11,38,48,-10,35
AC Horsens,3389,6,7,13,10,37,53,-16,34
Sonderjyske,3389,7,8,6,10,28,29,-1,30
Randers FC,3389,8,5,7,12,25,41,-16,22
Lyngby,3389,9,3,10,11,28,46,-18,19
Silkeborg IF,3389,10,5,4,13,27,46,-19,19
AGF Aarhus,3389,11,4,7,11,18,38,-20,19
Brondby,3390,1,21,6,3,71,34,37,69
FC Midtjylla,3390,2,18,6,6,73,50,23,60
FC Nords,3390,3,15,7,8,78,53,25,52
Copenhagen,3390,4,14,6,10,62,47,15,48
AaB,3390,5,8,11,11,37,44,-7,35
Sonderjyske,3390,6,8,6,10,28,29,-1,30
AC Horsens,3390,7,5,14,11,35,54,-19,29
Randers FC,3390,8,6,6,12,26,40,-14,24
Silkeborg IF,3390,9,6,3,13,26,44,-18,21
Lyngby,3390,10,3,9,12,27,47,-20,18
AGF Aarhus,3390,11,4,6,12,16,37,-21,18
Brondby,3391,1,21,6,3,70,31,39,69
FC Midtjylla,3391,2,20,5,5,67,38,29,65
FC Nords,3391,3,16,6,8,76,49,27,54
Copenhagen,3391,4,13,6,11,54,44,10,45
AaB,3391,5,6,13,11,37,45,-8,31
Sonderjyske,3391,6,8,6,10,28,29,-1,30
AC Horsens,3391,7,5,14,11,34,57,-23,29
Randers FC,3391,8,5,7,12,24,40,-16,22
AGF Aarhus,3391,9,5,6,11,18,37,-19,21
Lyngby,3391,10,3,10,11,27,45,-18,19
Silkeborg IF,3391,11,5,3,14,26,46,-20,18
Brondby,3392,1,21,5,4,74,30,44,68
FC Midtjylla,3392,2,20,4,6,69,48,21,64
FC Nords,3392,3,14,6,10,70,54,16,48
Copenhagen,3392,4,13,5,12,57,47,10,44
AaB,3392,5,10,11,9,41,39,2,41
AC Horsens,3392,6,6,13,11,36,55,-19,31
Sonderjyske,3392,7,8,6,10,28,29,-1,30
Lyngby,3392,8,4,9,11,28,44,-16,21
Randers FC,3392,9,5,6,13,23,41,-18,21
AGF Aarhus,3392,10,5,6,11,18,37,-19,21
Silkeborg IF,3392,11,5,3,14,26,46,-20,18
Brondby,3393,1,21,7,2,74,34,40,70
FC Midtjylla,3393,2,20,5,5,69,38,31,65
FC Nords,3393,3,14,6,10,73,54,19,48
Copenhagen,3393,4,14,6,10,59,45,14,48
AaB,3393,5,8,12,10,39,43,-4,36
Sonderjyske,3393,6,8,6,10,28,29,-1,30
AC Horsens,3393,7,5,12,13,34,60,-26,27
Randers FC,3393,8,5,7,12,25,41,-16,22
Lyngby,3393,9,3,10,11,28,46,-18,19
Silkeborg IF,3393,10,5,4,13,26,45,-19,19
AGF Aarhus,3393,11,4,7,11,17,37,-20,19
Brondby,3394,1,21,7,2,71,29,42,70
FC Midtjylla,3394,2,19,5,6,68,42,26,62
FC Nords,3394,3,14,7,9,72,51,21,49
Copenhagen,3394,4,14,5,11,58,46,12,47
AaB,3394,5,8,12,10,36,43,-7,36
Sonderjyske,3394,6,8,6,10,28,29,-1,30
AC Horsens,3394,7,6,12,12,33,53,-20,30
Lyngby,3394,8,4,9,11,30,46,-16,21
Randers FC,3394,9,5,6,13,25,43,-18,21
AGF Aarhus,3394,10,5,6,11,18,37,-19,21
Silkeborg IF,3394,11,5,3,14,26,46,-20,18
Brondby,3395,1,23,5,2,78,30,48,74
FC Midtjylla,3395,2,18,6,6,61,39,22,60
FC Nords,3395,3,16,6,8,79,49,30,54
Copenhagen,3395,4,14,5,11,59,51,8,47
AaB,3395,5,6,13,11,33,44,-11,31
Sonderjyske,3395,6,8,6,10,28,29,-1,30
AC Horsens,3395,7,5,13,12,32,55,-23,28
Lyngby,3395,8,4,9,11,30,45,-15,21
Silkeborg IF,3395,9,6,3,13,29,44,-15,21
Randers FC,3395,10,5,6,13,24,43,-19,21
AGF Aarhus,3395,11,4,6,12,16,40,-24,18
Brondby,3396,1,22,6,2,76,34,42,72
FC Midtjylla,3396,2,19,6,5,65,36,29,63
Copenhagen,3396,3,14,7,9,58,43,15,49
FC Nords,3396,4,13,6,11,76,59,17,45
AaB,3396,5,8,13,9,39,41,-2,37
Sonderjyske,3396,6,8,6,10,28,29,-1,30
AC Horsens,3396,7,5,12,13,32,59,-27,27
Randers FC,3396,8,5,7,12,24,40,-16,22
Silkeborg IF,3396,9,6,3,13,27,45,-18,21
Lyngby,3396,10,3,10,11,27,45,-18,19
AGF Aarhus,3396,11,4,6,12,17,38,-21,18
Brondby,3397,1,22,5,3,75,32,43,71
FC Midtjylla,3397,2,19,6,5,63,38,25,63
FC Nords,3397,3,14,6,10,78,53,25,48
Copenhagen,3397,4,12,5,13,52,55,-3,41
AaB,3397,5,8,13,9,40,40,0,37
AC Horsens,3397,6,7,13,10,34,50,-16,34
Sonderjyske,3397,7,8,6,10,28,29,-1,30
Randers FC,3397,8,5,7,12,24,40,-16,22
Silkeborg IF,3397,9,6,3,13,26,44,-18,21
Lyngby,3397,10,3,10,11,27,45,-18,19
AGF Aarhus,3397,11,4,6,12,16,37,-21,18
FC Midtjylla,3398,1,21,5,4,72,41,31,68
Brondby,3398,2,20,5,5,66,32,34,65
FC Nords,3398,3,14,7,9,79,55,24,49
Copenhagen,3398,4,13,5,12,55,45,10,44
AaB,3398,5,9,12,9,38,40,-2,39
Sonderjyske,3398,6,8,6,10,28,29,-1,30
AC Horsens,3398,7,6,12,12,35,58,-23,30
Lyngby,3398,8,4,9,11,31,44,-13,21
Randers FC,3398,9,5,6,13,23,44,-21,21
Silkeborg IF,3398,10,5,4,13,26,45,-19,19
AGF Aarhus,3398,11,4,7,11,17,37,-20,19
Brondby,3399,1,21,6,3,73,32,41,69
FC Midtjylla,3399,2,21,4,5,70,37,33,67
FC Nords,3399,3,14,8,8,73,56,17,50
Copenhagen,3399,4,14,5,11,59,47,12,47
AaB,3399,5,7,11,12,35,44,-9,32
Sonderjyske,3399,6,8,6,10,28,29,-1,30
AC Horsens,3399,7,6,12,12,35,55,-20,30
Randers FC,3399,8,6,6,12,25,39,-14,24
Silkeborg IF,3399,9,5,4,13,26,45,-19,19
AGF Aarhus,3399,10,4,7,11,17,37,-20,19
Lyngby,3399,11,3,9,12,26,46,-20,18
Brondby,3400,1,21,6,3,72,33,39,69
FC Midtjylla,3400,2,20,4,6,69,41,28,64
FC Nords,3400,3,14,7,9,74,52,22,49
Copenhagen,3400,4,13,7,10,59,46,13,46
AaB,3400,5,8,12,10,40,43,-3,36
Sonderjyske,3400,6,8,6,10,28,29,-1,30
AC Horsens,3400,7,6,12,12,35,60,-25,30
Randers FC,3400,8,6,6,12,25,40,-15,24
Silkeborg IF,3400,9,5,4,13,27,46,-19,19
AGF Aarhus,3400,10,4,7,11,18,38,-20,19
Lyngby,3400,11,3,9,12,27,46,-19,18
Brondby,3401,1,21,6,3,74,34,40,69
FC Midtjylla,3401,2,19,6,5,68,43,25,63
FC Nords,3401,3,15,6,9,75,50,25,51
Copenhagen,3401,4,13,5,12,60,48,12,44
AaB,3401,5,8,11,11,37,42,-5,35
AC Horsens,3401,6,7,12,11,34,57,-23,33
Sonderjyske,3401,7,8,6,10,28,29,-1,30
Randers FC,3401,8,6,6,12,26,39,-13,24
Silkeborg IF,3401,9,5,4,13,27,46,-19,19
AGF Aarhus,3401,10,4,7,11,18,38,-20,19
Lyngby,3401,11,3,9,12,26,47,-21,18
Brondby,3402,1,22,6,2,73,32,41,72
FC Midtjylla,3402,2,19,6,5,71,39,32,63
FC Nords,3402,3,14,7,9,73,50,23,49
Copenhagen,3402,4,15,4,11,59,44,15,49
AaB,3402,5,8,11,11,37,53,-16,35
Sonderjyske,3402,6,8,6,10,28,29,-1,30
AC Horsens,3402,7,5,12,13,31,52,-21,27
Lyngby,3402,8,4,9,11,29,46,-17,21
Randers FC,3402,9,5,6,13,25,42,-17,21
Silkeborg IF,3402,10,5,4,13,27,46,-19,19
AGF Aarhus,3402,11,4,7,11,18,38,-20,19
Brondby,3403,1,20,7,3,67,31,36,67
FC Midtjylla,3403,2,20,5,5,67,38,29,65
FC Nords,3403,3,15,7,8,76,50,26,52
Copenhagen,3403,4,14,5,11,57,44,13,47
AC Horsens,3403,5,6,14,10,35,53,-18,32
Sonderjyske,3403,6,8,6,10,28,29,-1,30
AaB,3403,7,6,12,12,34,46,-12,30
Lyngby,3403,8,4,9,11,28,44,-16,21
Randers FC,3403,9,5,6,13,23,41,-18,21
AGF Aarhus,3403,10,5,6,11,19,37,-18,21
Silkeborg IF,3403,11,5,3,14,26,47,-21,18
Brondby,3404,1,20,7,3,71,31,40,67
FC Midtjylla,3404,2,19,5,6,64,43,21,62
Copenhagen,3404,3,15,4,11,56,42,14,49
FC Nords,3404,4,14,6,10,70,52,18,48
AaB,3404,5,8,13,9,38,40,-2,37
Sonderjyske,3404,6,8,6,10,28,29,-1,30
AC Horsens,3404,7,5,15,10,32,49,-17,30
Lyngby,3404,8,4,9,11,28,45,-17,21
Silkeborg IF,3404,9,6,3,13,27,44,-17,21
Randers FC,3404,10,5,6,13,24,41,-17,21
AGF Aarhus,3404,11,4,6,12,16,38,-22,18
Brondby,3405,1,21,6,3,72,30,42,69
FC Midtjylla,3405,2,19,7,4,63,36,27,64
FC Nords,3405,3,15,7,8,72,51,21,52
Copenhagen,3405,4,13,5,12,56,47,9,44
AC Horsens,3405,5,6,14,10,33,49,-16,32
AaB,3405,6,6,13,11,33,42,-9,31
Sonderjyske,3405,7,8,6,10,28,29,-1,30
Randers FC,3405,8,6,6,12,24,39,-15,24
Silkeborg IF,3405,9,5,4,13,26,45,-19,19
AGF Aarhus,3405,10,4,7,11,17,37,-20,19
Lyngby,3405,11,3,9,12,26,45,-19,18
Brondby,3406,1,21,7,2,78,30,48,70
FC Midtjylla,3406,2,18,6,6,61,38,23,60
FC Nords,3406,3,14,7,9,71,54,17,49
Copenhagen,3406,4,13,5,12,57,45,12,44
AaB,3406,5,9,11,10,40,48,-8,38
AC Horsens,3406,6,7,12,11,35,53,-18,33
Sonderjyske,3406,7,8,6,10,28,29,-1,30
Lyngby,3406,8,4,9,11,29,44,-15,21
AGF Aarhus,3406,9,5,6,11,18,36,-18,21
Randers FC,3406,10,5,6,13,23,42,-19,21
Silkeborg IF,3406,11,5,3,14,25,46,-21,18
FC Midtjylla,3407,1,21,5,4,71,36,35,68
Brondby,3407,2,19,5,6,67,39,28,62
FC Nords,3407,3,14,8,8,77,53,24,50
Copenhagen,3407,4,14,5,11,58,46,12,47
AC Horsens,3407,5,8,13,9,38,52,-14,37
Sonderjyske,3407,6,8,6,10,28,29,-1,30
AaB,3407,7,6,12,12,35,46,-11,30
Randers FC,3407,8,5,7,12,23,39,-16,22
Lyngby,3407,9,3,10,11,26,44,-18,19
Silkeborg IF,3407,10,5,4,13,25,44,-19,19
AGF Aarhus,3407,11,4,7,11,16,36,-20,19
Brondby,3408,1,19,9,2,70,30,40,66
FC Midtjylla,3408,2,20,5,5,64,34,30,65
FC Nords,3408,3,14,7,9,72,55,17,49
Copenhagen,3408,4,13,6,11,55,42,13,45
AaB,3408,5,7,12,11,36,45,-9,33
AC Horsens,3408,6,6,15,9,32,49,-17,33
Sonderjyske,3408,7,8,6,10,28,29,-1,30
Lyngby,3408,8,4,9,11,27,44,-17,21
Randers FC,3408,9,5,6,13,23,40,-17,21
AGF Aarhus,3408,10,5,6,11,18,37,-19,21
Silkeborg IF,3408,11,5,3,14,26,46,-20,18
FC Midtjylla,3409,1,20,5,5,70,42,28,65
Brondby,3409,2,19,7,4,67,33,34,64
Copenhagen,3409,3,14,6,10,61,43,18,48
FC Nords,3409,4,13,7,10,71,56,15,46
AaB,3409,5,8,12,10,35,40,-5,36
AC Horsens,3409,6,7,13,10,36,52,-16,34
Sonderjyske,3409,7,8,6,10,28,29,-1,30
Randers FC,3409,8,5,7,12,25,41,-16,22
Silkeborg IF,3409,9,6,3,13,26,44,-18,21
Lyngby,3409,10,3,10,11,28,46,-18,19
AGF Aarhus,3409,11,4,6,12,16,37,-21,18
Brondby,3410,1,20,6,4,73,36,37,66
FC Midtjylla,3410,2,19,5,6,66,42,24,62
FC Nords,3410,3,14,7,9,69,51,18,49
Copenhagen,3410,4,14,7,9,60,45,15,49
AaB,3410,5,8,12,10,39,43,-4,36
AC Horsens,3410,6,6,13,11,37,53,-16,31
Sonderjyske,3410,7,8,6,10,28,29,-1,30
Randers FC,3410,8,6,6,12,24,39,-15,24
Silkeborg IF,3410,9,6,3,13,26,44,-18,21
Lyngby,3410,10,3,9,12,26,45,-19,18
AGF Aarhus,3410,11,4,6,12,16,37,-21,18
Brondby,3411,1,22,5,3,74,34,40,71
FC Midtjylla,3411,2,20,4,6,65,42,23,64
FC Nords,3411,3,15,6,9,80,51,29,51
Copenhagen,3411,4,14,4,12,56,51,5,46
AC Horsens,3411,5,7,12,11,37,53,-16,33
AaB,3411,6,7,11,12,38,45,-7,32
Sonderjyske,3411,7,8,6,10,28,29,-1,30
Lyngby,3411,8,4,9,11,29,44,-15,21
Silkeborg IF,3411,9,6,3,13,27,44,-17,21
Randers FC,3411,10,5,6,13,23,42,-19,21
AGF Aarhus,3411,11,4,6,12,16,38,-22,18
Brondby,3412,1,22,5,3,70,30,40,71
FC Midtjylla,3412,2,18,6,6,65,39,26,60
FC Nords,3412,3,15,7,8,71,47,24,52
Copenhagen,3412,4,14,5,11,59,46,13,47
AaB,3412,5,7,12,11,37,46,-9,33
AC Horsens,3412,6,6,13,11,32,52,-20,31
Sonderjyske,3412,7,8,6,10,28,29,-1,30
Lyngby,3412,8,4,9,11,28,45,-17,21
Randers FC,3412,9,5,6,13,24,41,-17,21
Silkeborg IF,3412,10,5,4,13,26,45,-19,19
AGF Aarhus,3412,11,4,7,11,17,37,-20,19
Brondby,3413,1,20,7,3,70,34,36,67
FC Midtjylla,3413,2,19,5,6,69,41,28,62
Copenhagen,3413,3,16,4,10,62,45,17,52
FC Nords,3413,4,13,7,10,70,57,13,46
AaB,3413,5,8,12,10,40,44,-4,36
AC Horsens,3413,6,6,13,11,39,55,-16,31
Sonderjyske,3413,7,8,6,10,28,29,-1,30
Randers FC,3413,8,5,7,12,23,39,-16,22
Silkeborg IF,3413,9,6,3,13,27,44,-17,21
Lyngby,3413,10,3,10,11,26,44,-18,19
AGF Aarhus,3413,11,4,6,12,16,38,-22,18
FC Midtjylla,3414,1,21,4,5,70,36,34,67
Brondby,3414,2,19,5,6,68,38,30,62
FC Nords,3414,3,16,6,8,70,45,25,54
Copenhagen,3414,4,15,4,11,59,46,13,49
AaB,3414,5,7,12,11,39,50,-11,33
AC Horsens,3414,6,6,13,11,34,51,-17,31
Sonderjyske,3414,7,8,6,10,28,29,-1,30
Randers FC,3414,8,5,7,12,23,39,-16,22
Lyngby,3414,9,3,10,11,26,44,-18,19
Silkeborg IF,3414,10,5,4,13,25,44,-19,19
AGF Aarhus,3414,11,4,7,11,16,36,-20,19
Brondby,3415,1,20,5,5,68,34,34,65
FC Midtjylla,3415,2,20,5,5,67,40,27,65
FC Nords,3415,3,14,6,10,74,53,21,48
Copenhagen,3415,4,13,5,12,59,53,6,44
AaB,3415,5,10,11,9,41,41,0,41
AC Horsens,3415,6,7,12,11,37,51,-14,33
Sonderjyske,3415,7,8,6,10,28,29,-1,30
Randers FC,3415,8,5,7,12,23,39,-16,22
AGF Aarhus,3415,9,5,6,11,18,37,-19,21
Lyngby,3415,10,3,10,11,26,44,-18,19
Silkeborg IF,3415,11,5,3,14,26,46,-20,18
Brondby,3416,1,22,5,3,73,32,41,71
FC Midtjylla,3416,2,20,5,5,70,41,29,65
FC Nords,3416,3,14,6,10,75,57,18,48
Copenhagen,3416,4,13,5,12,58,48,10,44
AaB,3416,5,8,12,10,40,44,-4,36
AC Horsens,3416,6,6,13,11,33,53,-20,31
Sonderjyske,3416,7,8,6,10,28,29,-1,30
Randers FC,3416,8,6,6,12,24,39,-15,24
Silkeborg IF,3416,9,5,4,13,25,44,-19,19
AGF Aarhus,3416,10,4,7,11,16,36,-20,19
Lyngby,3416,11,3,9,12,26,45,-19,18
Brondby,3417,1,20,6,4,68,31,37,66
FC Midtjylla,3417,2,20,6,4,69,39,30,66
FC Nords,3417,3,15,7,8,76,49,27,52
Copenhagen,3417,4,12,5,13,54,50,4,41
AaB,3417,5,7,13,10,40,46,-6,34
AC Horsens,3417,6,7,13,10,32,50,-18,34
Sonderjyske,3417,7,8,6,10,28,29,-1,30
Lyngby,3417,8,4,9,11,29,44,-15,21
Silkeborg IF,3417,9,6,3,13,27,45,-18,21
Randers FC,3417,10,5,6,13,23,42,-19,21
AGF Aarhus,3417,11,4,6,12,17,38,-21,18
Brondby,3418,1,21,6,3,70,29,41,69
FC Midtjylla,3418,2,21,5,4,64,34,30,68
FC Nords,3418,3,14,7,9,73,56,17,49
Copenhagen,3418,4,14,4,12,56,45,11,46
AC Horsens,3418,5,7,13,10,37,50,-13,34
Sonderjyske,3418,6,8,6,10,28,29,-1,30
AaB,3418,7,6,11,13,35,47,-12,29
Lyngby,3418,8,4,9,11,28,44,-16,21
Silkeborg IF,3418,9,6,3,13,28,46,-18,21
Randers FC,3418,10,5,6,13,23,41,-18,21
AGF Aarhus,3418,11,4,6,12,18,39,-21,18
Brondby,3419,1,19,7,4,67,36,31,64
FC Midtjylla,3419,2,19,7,4,63,33,30,64
FC Nords,3419,3,14,7,9,70,49,21,49
Copenhagen,3419,4,14,5,11,55,40,15,47
AC Horsens,3419,5,7,14,9,32,46,-14,35
AaB,3419,6,7,12,11,34,43,-9,33
Sonderjyske,3419,7,8,6,10,28,29,-1,30
Lyngby,3419,8,4,9,11,29,45,-16,21
Randers FC,3419,9,5,6,13,24,42,-18,21
AGF Aarhus,3419,10,5,6,11,17,36,-19,21
Silkeborg IF,3419,11,5,3,14,25,45,-20,18
Brondby,3420,1,21,5,4,71,35,36,68
FC Midtjylla,3420,2,20,5,5,69,39,30,65
Copenhagen,3420,3,15,4,11,62,46,16,49
FC Nords,3420,4,14,6,10,73,55,18,48
AaB,3420,5,7,12,11,36,41,-5,33
AC Horsens,3420,6,7,12,11,35,56,-21,33
Sonderjyske,3420,7,8,6,10,28,29,-1,30
Lyngby,3420,8,4,9,11,29,44,-15,21
Silkeborg IF,3420,9,6,3,13,26,44,-18,21
Randers FC,3420,10,5,6,13,23,42,-19,21
AGF Aarhus,3420,11,4,6,12,16,37,-21,18
FC Midtjylla,3421,1,21,4,5,68,39,29,67
Brondby,3421,2,20,6,4,70,34,36,66
FC Nords,3421,3,14,6,10,73,53,20,48
Copenhagen,3421,4,14,5,11,58,42,16,47
AaB,3421,5,8,12,10,36,43,-7,36
AC Horsens,3421,6,6,13,11,34,54,-20,31
Sonderjyske,3421,7,8,6,10,28,29,-1,30
Lyngby,3421,8,4,9,11,29,46,-17,21
Silkeborg IF,3421,9,6,3,13,27,44,-17,21
Randers FC,3421,10,5,6,13,25,42,-17,21
AGF Aarhus,3421,11,4,6,12,16,38,-22,18
Brondby,3422,1,22,5,3,70,34,36,71
FC Midtjylla,3422,2,19,5,6,67,42,25,62
FC Nords,3422,3,14,7,9,72,50,22,49
Copenhagen,3422,4,15,4,11,57,39,18,49
AaB,3422,5,7,12,11,34,45,-11,33
AC Horsens,3422,6,6,13,11,31,47,-16,31
Sonderjyske,3422,7,8,6,10,28,29,-1,30
Lyngby,3422,8,4,9,11,32,47,-15,21
Randers FC,3422,9,5,6,13,26,45,-19,21
AGF Aarhus,3422,10,5,6,11,18,37,-19,21
Silkeborg IF,3422,11,5,3,14,26,46,-20,18
Brondby,3423,1,21,5,4,74,34,40,68
FC Midtjylla,3423,2,20,4,6,64,42,22,64
FC Nords,3423,3,13,8,9,73,55,18,47
Copenhagen,3423,4,14,5,11,61,48,13,47
AC Horsens,3423,5,7,14,9,36,49,-13,35
AaB,3423,6,7,12,11,36,42,-6,33
Sonderjyske,3423,7,8,6,10,28,29,-1,30
Randers FC,3423,8,5,7,12,23,39,-16,22
Silkeborg IF,3423,9,6,3,13,27,44,-17,21
Lyngby,3423,10,3,10,11,26,44,-18,19
AGF Aarhus,3423,11,4,6,12,16,38,-22,18
Brondby,3424,1,20,7,3,69,33,36,67
FC Midtjylla,3424,2,21,4,5,69,38,31,67
FC Nords,3424,3,13,7,10,70,53,17,46
Copenhagen,3424,4,13,5,12,57,46,11,44
AC Horsens,3424,5,8,12,10,36,51,-15,36
AaB,3424,6,8,11,11,41,47,-6,35
Sonderjyske,3424,7,8,6,10,28,29,-1,30
Randers FC,3424,8,6,6,12,26,41,-15,24
Silkeborg IF,3424,9,6,3,13,27,45,-18,21
Lyngby,3424,10,3,9,12,28,47,-19,18
AGF Aarhus,3424,11,4,6,12,17,38,-21,18
Brondby,3425,1,21,5,4,69,33,36,68
FC Midtjylla,3425,2,21,5,4,71,37,34,68
FC Nords,3425,3,15,6,9,76,53,23,51
Copenhagen,3425,4,14,5,11,57,43,14,47
AaB,3425,5,6,13,11,35,45,-10,31
Sonderjyske,3425,6,8,6,10,28,29,-1,30
AC Horsens,3425,7,5,14,11,32,55,-23,29
Randers FC,3425,8,5,7,12,25,41,-16,22
Lyngby,3425,9,3,10,11,28,46,-18,19
Silkeborg IF,3425,10,5,4,13,28,47,-19,19
AGF Aarhus,3425,11,4,7,11,19,39,-20,19
Brondby,3426,1,20,6,4,68,35,33,66
FC Midtjylla,3426,2,20,5,5,74,42,32,65
FC Nords,3426,3,14,7,9,71,50,21,49
Copenhagen,3426,4,13,5,12,57,46,11,44
AaB,3426,5,8,11,11,38,44,-6,35
AC Horsens,3426,6,7,14,9,33,50,-17,35
Sonderjyske,3426,7,8,6,10,28,29,-1,30
Randers FC,3426,8,6,6,12,25,39,-14,24
Silkeborg IF,3426,9,5,4,13,26,45,-19,19
AGF Aarhus,3426,10,4,7,11,17,37,-20,19
Lyngby,3426,11,3,9,12,26,46,-20,18
Brondby,3427,1,21,5,4,67,31,36,68
FC Midtjylla,3427,2,21,4,5,64,33,31,67
FC Nords,3427,3,14,6,10,74,51,23,48
Copenhagen,3427,4,14,5,11,57,46,11,47
AaB,3427,5,8,12,10,36,39,-3,36
Sonderjyske,3427,6,8,6,10,28,29,-1,30
AC Horsens,3427,7,5,14,11,32,56,-24,29
Randers FC,3427,8,6,6,12,26,40,-14,24
Silkeborg IF,3427,9,5,4,13,26,45,-19,19
AGF Aarhus,3427,10,4,7,11,17,37,-20,19
Lyngby,3427,11,3,9,12,27,47,-20,18
Brondby,3428,1,21,6,3,72,36,36,69
FC Midtjylla,3428,2,20,4,6,69,41,28,64
FC Nords,3428,3,14,7,9,73,51,22,49
Copenhagen,3428,4,15,4,11,62,46,16,49
AaB,3428,5,8,11,11,38,47,-9,35
Sonderjyske,3428,6,8,6,10,28,29,-1,30
AC Horsens,3428,7,6,12,12,34,53,-19,30
Randers FC,3428,8,6,6,12,25,39,-14,24
Silkeborg IF,3428,9,6,3,13,26,44,-18,21
Lyngby,3428,10,3,9,12,26,46,-20,18
AGF Aarhus,3428,11,4,6,12,16,37,-21,18
Brondby,3429,1,22,6,2,71,28,43,72
FC Midtjylla,3429,2,20,4,6,66,38,28,64
Copenhagen,3429,3,14,6,10,54,43,11,48
FC Nords,3429,4,13,7,10,69,50,19,46
AaB,3429,5,8,11,11,34,44,-10,35
Sonderjyske,3429,6,8,6,10,28,29,-1,30
AC Horsens,3429,7,6,12,12,35,52,-17,30
Randers FC,3429,8,5,7,12,24,40,-16,22
Lyngby,3429,9,3,10,11,27,45,-18,19
Silkeborg IF,3429,10,5,4,13,25,44,-19,19
AGF Aarhus,3429,11,4,7,11,16,36,-20,19
Brondby,3430,1,21,6,3,73,34,39,69
FC Midtjylla,3430,2,19,5,6,64,38,26,62
FC Nords,3430,3,14,7,9,76,53,23,49
Copenhagen,3430,4,14,7,9,59,43,16,49
AC Horsens,3430,5,6,15,9,31,47,-16,33
Sonderjyske,3430,6,8,6,10,28,29,-1,30
AaB,3430,7,6,12,12,33,47,-14,30
Silkeborg IF,3430,8,6,3,13,28,44,-16,21
Lyngby,3430,9,4,9,11,29,46,-17,21
Randers FC,3430,10,5,6,13,25,42,-17,21
AGF Aarhus,3430,11,4,6,12,16,39,-23,18
Brondby,3431,1,22,6,2,74,30,44,72
FC Midtjylla,3431,2,21,4,5,69,41,28,67
FC Nords,3431,3,13,8,9,69,51,18,47
Copenhagen,3431,4,12,4,14,56,53,3,40
AaB,3431,5,8,12,10,40,44,-4,36
AC Horsens,3431,6,6,14,10,37,52,-15,32
Sonderjyske,3431,7,8,6,10,28,29,-1,30
Lyngby,3431,8,4,9,11,29,45,-16,21
Randers FC,3431,9,5,6,13,24,42,-18,21
AGF Aarhus,3431,10,5,6,11,18,37,-19,21
Silkeborg IF,3431,11,5,3,14,26,46,-20,18
Brondby,3432,1,21,7,2,79,38,41,70
FC Midtjylla,3432,2,17,7,6,61,39,22,58
FC Nords,3432,3,14,7,9,74,52,22,49
Copenhagen,3432,4,13,5,12,55,46,9,44
AaB,3432,5,9,11,10,41,46,-5,38
AC Horsens,3432,6,6,15,9,35,50,-15,33
Sonderjyske,3432,7,8,6,10,28,29,-1,30
Randers FC,3432,8,6,6,12,24,39,-15,24
Silkeborg IF,3432,9,6,3,13,29,44,-15,21
Lyngby,3432,10,3,9,12,26,45,-19,18
AGF Aarhus,3432,11,4,6,12,16,40,-24,18
Brondby,3433,1,19,8,3,70,34,36,65
FC Midtjylla,3433,2,19,6,5,65,40,25,63
FC Nords,3433,3,15,7,8,81,55,26,52
Copenhagen,3433,4,13,6,11,57,48,9,45
AaB,3433,5,8,13,9,45,44,1,37
Sonderjyske,3433,6,8,6,10,28,29,-1,30
AC Horsens,3433,7,6,12,12,35,58,-23,30
Lyngby,3433,8,4,9,11,28,44,-16,21
Silkeborg IF,3433,9,6,3,13,26,44,-18,21
Randers FC,3433,10,5,6,13,23,41,-18,21
AGF Aarhus,3433,11,4,6,12,16,37,-21,18
FC Midtjylla,3434,1,20,6,4,71,38,33,66
Brondby,3434,2,19,7,4,67,35,32,64
FC Nords,3434,3,14,6,10,77,57,20,48
Copenhagen,3434,4,13,7,10,59,46,13,46
AaB,3434,5,7,14,9,37,44,-7,35
AC Horsens,3434,6,6,14,10,35,52,-17,32
Sonderjyske,3434,7,8,6,10,28,29,-1,30
Lyngby,3434,8,4,9,11,29,44,-15,21
Randers FC,3434,9,5,6,13,23,42,-19,21
AGF Aarhus,3434,10,5,6,11,18,37,-19,21
Silkeborg IF,3434,11,5,3,14,26,46,-20,18
Brondby,3435,1,23,5,2,74,28,46,74
FC Midtjylla,3435,2,18,6,6,68,43,25,60
Copenhagen,3435,3,15,4,11,55,41,14,49
FC Nords,3435,4,13,7,10,71,55,16,46
AaB,3435,5,8,12,10,38,42,-4,36
Sonderjyske,3435,6,8,6,10,28,29,-1,30
AC Horsens,3435,7,6,12,12,32,55,-23,30
Lyngby,3435,8,4,9,11,28,45,-17,21
Randers FC,3435,9,5,6,13,24,41,-17,21
Silkeborg IF,3435,10,5,4,13,26,45,-19,19
AGF Aarhus,3435,11,4,7,11,17,37,-20,19
Brondby,3436,1,20,7,3,70,30,40,67
FC Midtjylla,3436,2,20,4,6,67,41,26,64
Copenhagen,3436,3,15,5,10,56,44,12,50
FC Nords,3436,4,13,6,11,67,53,14,45
AaB,3436,5,8,12,10,43,45,-2,36
AC Horsens,3436,6,7,12,11,37,53,-16,33
Sonderjyske,3436,7,8,6,10,28,29,-1,30
Randers FC,3436,8,6,6,12,25,40,-15,24
AGF Aarhus,3436,9,5,6,11,17,36,-19,21
Lyngby,3436,10,3,9,12,27,46,-19,18
Silkeborg IF,3436,11,5,3,14,25,45,-20,18
Brondby,3437,1,20,7,3,67,30,37,67
FC Midtjylla,3437,2,19,6,5,68,36,32,63
Copenhagen,3437,3,13,7,10,57,44,13,46
FC Nords,3437,4,12,9,9,72,53,19,45
AaB,3437,5,9,11,10,38,45,-7,38
AC Horsens,3437,6,6,14,10,34,54,-20,32
Sonderjyske,3437,7,8,6,10,28,29,-1,30
Randers FC,3437,8,6,6,12,25,40,-15,24
Silkeborg IF,3437,9,5,4,13,26,45,-19,19
AGF Aarhus,3437,10,4,7,11,17,37,-20,19
Lyngby,3437,11,3,9,12,27,46,-19,18
Brondby,3438,1,22,6,2,76,31,45,72
FC Midtjylla,3438,2,19,4,7,63,39,24,61
Copenhagen,3438,3,15,4,11,60,47,13,49
FC Nords,3438,4,14,6,10,72,52,20,48
AC Horsens,3438,5,7,13,10,37,52,-15,34
AaB,3438,6,7,11,12,36,49,-13,32
Sonderjyske,3438,7,8,6,10,28,29,-1,30
Randers FC,3438,8,6,6,12,25,40,-15,24
AGF Aarhus,3438,9,5,6,11,19,36,-17,21
Lyngby,3438,10,3,9,12,27,46,-19,18
Silkeborg IF,3438,11,5,3,14,25,47,-22,18
Brondby,3439,1,20,6,4,70,35,35,66
FC Midtjylla,3439,2,20,5,5,69,44,25,65
Copenhagen,3439,3,15,6,9,64,44,20,51
FC Nords,3439,4,14,8,8,76,53,23,50
Sonderjyske,3439,5,8,6,10,28,29,-1,30
AaB,3439,6,6,12,12,34,42,-8,30
AC Horsens,3439,7,5,15,10,34,55,-21,30
Randers FC,3439,8,6,6,12,24,39,-15,24
Silkeborg IF,3439,9,6,3,13,27,45,-18,21
Lyngby,3439,10,3,9,12,26,45,-19,18
AGF Aarhus,3439,11,4,6,12,17,38,-21,18
Brondby,3440,1,22,5,3,76,34,42,71
FC Midtjylla,3440,2,20,5,5,65,35,30,65
FC Nords,3440,3,14,6,10,72,57,15,48
Copenhagen,3440,4,13,6,11,57,46,11,45
AC Horsens,3440,5,7,13,10,39,51,-12,34
AaB,3440,6,7,11,12,37,49,-12,32
Sonderjyske,3440,7,8,6,10,28,29,-1,30
Lyngby,3440,8,4,9,11,27,44,-17,21
Randers FC,3440,9,5,6,13,23,40,-17,21
Silkeborg IF,3440,10,5,4,13,26,45,-19,19
AGF Aarhus,3440,11,4,7,11,17,37,-20,19
Brondby,3441,1,21,6,3,75,31,44,69
FC Midtjylla,3441,2,20,5,5,64,37,27,65
FC Nords,3441,3,15,7,8,73,52,21,52
Copenhagen,3441,4,13,5,12,57,46,11,44
AaB,3441,5,7,13,10,33,39,-6,34
Sonderjyske,3441,6,8,6,10,28,29,-1,30
AC Horsens,3441,7,5,14,11,36,59,-23,29
Randers FC,3441,8,5,7,12,23,39,-16,22
Lyngby,3441,9,3,10,11,26,44,-18,19
Silkeborg IF,3441,10,5,4,13,26,45,-19,19
AGF Aarhus,3441,11,4,7,11,17,37,-20,19
Brondby,3442,1,20,7,3,66,29,37,67
FC Midtjylla,3442,2,19,4,7,65,41,24,61
FC Nords,3442,3,14,9,7,74,50,24,51
Copenhagen,3442,4,12,6,12,53,47,6,42
AaB,3442,5,9,13,8,41,40,1,40
AC Horsens,3442,6,6,13,11,36,54,-18,31
Sonderjyske,3442,7,8,6,10,28,29,-1,30
Randers FC,3442,8,5,7,12,24,40,-16,22
AGF Aarhus,3442,9,5,6,11,17,36,-19,21
Lyngby,3442,10,3,10,11,27,45,-18,19
Silkeborg IF,3442,11,5,3,14,25,45,-20,18
FC Midtjylla,3443,1,22,4,4,70,38,32,70
Brondby,3443,2,19,6,5,68,39,29,63
FC Nords,3443,3,13,8,9,77,56,21,47
Copenhagen,3443,4,13,5,12,60,50,10,44
AaB,3443,5,8,12,10,42,45,-3,36
AC Horsens,3443,6,6,15,9,36,51,-15,33
Sonderjyske,3443,7,8,6,10,28,29,-1,30
Randers FC,3443,8,6,6,12,25,40,-15,24
Silkeborg IF,3443,9,6,3,13,26,44,-18,21
Lyngby,3443,10,3,9,12,27,46,-19,18
AGF Aarhus,3443,11,4,6,12,16,37,-21,18
Brondby,3444,1,22,5,3,73,31,42,71
FC Midtjylla,3444,2,20,5,5,65,37,28,65
Copenhagen,3444,3,16,4,10,58,40,18,52
FC Nords,3444,4,12,7,11,67,55,12,43
AaB,3444,5,8,11,11,42,45,-3,35
Sonderjyske,3444,6,8,6,10,28,29,-1,30
AC Horsens,3444,7,6,12,12,34,57,-23,30
Randers FC,3444,8,5,7,12,26,42,-16,22
AGF Aarhus,3444,9,5,6,11,18,36,-18,21
Lyngby,3444,10,3,10,11,29,47,-18,19
Silkeborg IF,3444,11,5,3,14,25,46,-21,18
Brondby,3445,1,20,6,4,70,34,36,66
FC Midtjylla,3445,2,20,6,4,66,37,29,66
Copenhagen,3445,3,13,8,9,55,41,14,47
FC Nords,3445,4,13,7,10,71,52,19,46
AaB,3445,5,6,15,9,37,43,-6,33
AC Horsens,3445,6,6,14,10,32,50,-18,32
Sonderjyske,3445,7,8,6,10,28,29,-1,30
Randers FC,3445,8,6,6,12,25,40,-15,24
Silkeborg IF,3445,9,6,3,13,27,44,-17,21
Lyngby,3445,10,3,9,12,27,46,-19,18
AGF Aarhus,3445,11,4,6,12,16,38,-22,18
Brondby,3446,1,20,7,3,72,35,37,67
FC Midtjylla,3446,2,20,6,4,68,36,32,66
FC Nords,3446,3,14,6,10,75,51,24,48
Copenhagen,3446,4,12,7,11,54,49,5,43
AaB,3446,5,8,12,10,38,44,-6,36
AC Horsens,3446,6,6,14,10,39,57,-18,32
Sonderjyske,3446,7,8,6,10,28,29,-1,30
Randers FC,3446,8,6,6,12,24,39,-15,24
AGF Aarhus,3446,9,5,6,11,17,36,-19,21
Lyngby,3446,10,3,9,12,26,45,-19,18
Silkeborg IF,3446,11,5,3,14,25,45,-20,18
Brondby,3447,1,22,5,3,68,29,39,71
FC Midtjylla,3447,2,20,4,6,66,38,28,64
FC Nords,3447,3,13,9,8,74,53,21,48
Copenhagen,3447,4,13,6,11,54,43,11,45
AaB,3447,5,7,13,10,36,41,-5,34
AC Horsens,3447,6,6,13,11,34,54,-20,31
Sonderjyske,3447,7,8,6,10,28,29,-1,30
Randers FC,3447,8,6,6,12,25,40,-15,24
Silkeborg IF,3447,9,6,3,13,27,44,-17,21
Lyngby,3447,10,3,9,12,27,46,-19,18
AGF Aarhus,3447,11,4,6,12,16,38,-22,18
Brondby,3448,1,20,8,2,72,30,42,68
FC Midtjylla,3448,2,19,5,6,65,39,26,62
Copenhagen,3448,3,14,7,9,57,42,15,49
FC Nords,3448,4,13,8,9,71,53,18,47
AaB,3448,5,6,14,10,37,48,-11,32
AC Horsens,3448,6,6,14,10,39,55,-16,32
Sonderjyske,3448,7,8,6,10,28,29,-1,30
Lyngby,3448,8,4,9,11,27,44,-17,21
Randers FC,3448,9,5,6,13,23,40,-17,21
Silkeborg IF,3448,10,5,4,13,26,45,-19,19
AGF Aarhus,3448,11,4,7,11,17,37,-20,19
Brondby,3449,1,21,6,3,67,32,35,69
FC Midtjylla,3449,2,19,5,6,66,39,27,62
FC Nords,3449,3,13,7,10,69,51,18,46
Copenhagen,3449,4,14,4,12,55,44,11,46
AC Horsens,3449,5,8,13,9,38,48,-10,37
AaB,3449,6,8,11,11,34,41,-7,35
Sonderjyske,3449,7,8,6,10,28,29,-1,30
Randers FC,3449,8,5,7,12,24,40,-16,22
Silkeborg IF,3449,9,6,3,13,29,44,-15,21
Lyngby,3449,10,3,10,11,27,45,-18,19
AGF Aarhus,3449,11,4,6,12,16,40,-24,18
Brondby,3450,1,20,5,5,72,37,35,65
FC Midtjylla,3450,2,20,5,5,68,38,30,65
FC Nords,3450,3,14,7,9,80,51,29,49
Copenhagen,3450,4,13,5,12,55,48,7,44
AaB,3450,5,10,11,9,39,39,0,41
AC Horsens,3450,6,6,13,11,33,60,-27,31
Sonderjyske,3450,7,8,6,10,28,29,-1,30
Randers FC,3450,8,5,7,12,25,41,-16,22
AGF Aarhus,3450,9,5,6,11,17,36,-19,21
Lyngby,3450,10,3,10,11,28,46,-18,19
Silkeborg IF,3450,11,5,3,14,25,45,-20,18
Brondby,3451,1,19,6,5,65,32,33,63
FC Midtjylla,3451,2,19,5,6,63,38,25,62
FC Nords,3451,3,14,7,9,74,52,22,49
Copenhagen,3451,4,14,6,10,57,42,15,48
AaB,3451,5,8,13,9,35,38,-3,37
AC Horsens,3451,6,7,13,10,34,52,-18,34
Sonderjyske,3451,7,8,6,10,28,29,-1,30
Randers FC,3451,8,6,6,12,24,39,-15,24
Silkeborg IF,3451,9,6,3,13,26,44,-18,21
Lyngby,3451,10,3,9,12,26,45,-19,18
AGF Aarhus,3451,11,4,6,12,16,37,-21,18
Brondby,3452,1,21,7,2,77,34,43,70
FC Midtjylla,3452,2,19,5,6,66,45,21,62
FC Nords,3452,3,14,7,9,83,55,28,49
Copenhagen,3452,4,14,6,10,61,47,14,48
AC Horsens,3452,5,7,14,9,38,56,-18,35
Sonderjyske,3452,6,8,6,10,28,29,-1,30
AaB,3452,7,6,11,13,36,50,-14,29
Silkeborg IF,3452,8,6,3,13,29,46,-17,21
Lyngby,3452,9,4,9,11,28,45,-17,21
Randers FC,3452,10,5,6,13,24,41,-17,21
AGF Aarhus,3452,11,4,6,12,18,40,-22,18
Brondby,3453,1,21,6,3,67,28,39,69
FC Midtjylla,3453,2,21,4,5,66,37,29,67
FC Nords,3453,3,14,7,9,72,49,23,49
Copenhagen,3453,4,12,6,12,54,48,6,42
AaB,3453,5,7,13,10,37,43,-6,34
AC Horsens,3453,6,6,14,10,33,50,-17,32
Sonderjyske,3453,7,8,6,10,28,29,-1,30
Randers FC,3453,8,5,7,12,23,39,-16,22
Lyngby,3453,9,3,10,11,26,44,-18,19
Silkeborg IF,3453,10,5,4,13,26,45,-19,19
AGF Aarhus,3453,11,4,7,11,17,37,-20,19
Brondby,3454,1,22,5,3,73,34,39,71
FC Midtjylla,3454,2,20,4,6,61,35,26,64
FC Nords,3454,3,14,8,8,69,48,21,50
Copenhagen,3454,4,14,5,11,61,49,12,47
AC Horsens,3454,5,6,14,10,36,52,-16,32
Sonderjyske,3454,6,8,6,10,28,29,-1,30
AaB,3454,7,6,12,12,34,42,-8,30
Randers FC,3454,8,5,7,12,25,41,-16,22
Silkeborg IF,3454,9,6,3,13,30,44,-14,21
Lyngby,3454,10,3,10,11,28,46,-18,19
AGF Aarhus,3454,11,4,6,12,16,41,-25,18
Brondby,3455,1,20,6,4,73,36,37,66
FC Midtjylla,3455,2,20,6,4,67,37,30,66
FC Nords,3455,3,14,6,10,74,55,19,48
Copenhagen,3455,4,14,5,11,60,44,16,47
AaB,3455,5,8,12,10,37,41,-4,36
AC Horsens,3455,6,6,13,11,37,61,-24,31
Sonderjyske,3455,7,8,6,10,28,29,-1,30
Randers FC,3455,8,6,6,12,25,39,-14,24
AGF Aarhus,3455,9,5,6,11,18,37,-19,21
Lyngby,3455,10,3,9,12,26,46,-20,18
Silkeborg IF,3455,10,5,3,14,26,46,-20,18
Brondby,3456,1,20,8,2,71,30,41,68
FC Midtjylla,3456,2,19,5,6,66,41,25,62
FC Nords,3456,3,14,7,9,72,52,20,49
Copenhagen,3456,4,14,4,12,56,48,8,46
AC Horsens,3456,5,8,13,9,39,49,-10,37
AaB,3456,6,7,11,12,37,47,-10,32
Sonderjyske,3456,7,8,6,10,28,29,-1,30
Lyngby,3456,8,4,9,11,30,47,-17,21
Randers FC,3456,9,5,6,13,26,43,-17,21
Silkeborg IF,3456,10,6,3,13,28,46,-18,21
AGF Aarhus,3456,11,4,6,12,18,39,-21,18
Brondby,3457,1,21,7,2,72,28,44,70
FC Midtjylla,3457,2,18,6,6,65,42,23,60
Copenhagen,3457,3,15,5,10,55,39,16,50
FC Nords,3457,4,12,8,10,70,56,14,44
AaB,3457,5,8,13,9,39,42,-3,37
Sonderjyske,3457,6,8,6,10,28,29,-1,30
AC Horsens,3457,7,5,15,10,34,54,-20,30
Randers FC,3457,8,5,7,12,24,40,-16,22
Lyngby,3457,9,3,10,11,27,45,-18,19
Silkeborg IF,3457,10,5,4,13,25,44,-19,19
AGF Aarhus,3457,11,4,7,11,16,36,-20,19
Brondby,3458,1,21,5,4,71,32,39,68
FC Midtjylla,3458,2,19,5,6,67,42,25,62
Copenhagen,3458,3,15,4,11,55,43,12,49
FC Nords,3458,4,14,6,10,71,52,19,48
AC Horsens,3458,5,8,13,9,40,50,-10,37
AaB,3458,6,7,11,12,34,45,-11,32
Sonderjyske,3458,7,8,6,10,28,29,-1,30
Lyngby,3458,8,4,9,11,27,44,-17,21
Randers FC,3458,9,5,6,13,23,40,-17,21
AGF Aarhus,3458,10,5,6,11,18,37,-19,21
Silkeborg IF,3458,11,5,3,14,26,46,-20,18
Brondby,3459,1,21,5,4,71,31,40,68
FC Midtjylla,3459,2,20,4,6,65,39,26,64
FC Nords,3459,3,15,7,8,72,49,23,52
Copenhagen,3459,4,15,4,11,56,42,14,49
AaB,3459,5,7,12,11,39,45,-6,33
Sonderjyske,3459,6,8,6,10,28,29,-1,30
AC Horsens,3459,7,6,12,12,34,57,-23,30
Randers FC,3459,8,5,7,12,24,40,-16,22
Lyngby,3459,9,3,10,11,27,45,-18,19
Silkeborg IF,3459,10,5,4,13,26,45,-19,19
AGF Aarhus,3459,11,4,7,11,17,37,-20,19
FC Midtjylla,3460,1,21,4,5,70,36,34,67
Brondby,3460,2,20,6,4,68,31,37,66
FC Nords,3460,3,14,8,8,71,49,22,50
Copenhagen,3460,4,13,6,11,56,46,10,45
AaB,3460,5,7,13,10,34,44,-10,34
AC Horsens,3460,6,6,13,11,33,52,-19,31
Sonderjyske,3460,7,8,6,10,28,29,-1,30
Randers FC,3460,8,6,6,12,24,39,-15,24
Silkeborg IF,3460,9,6,3,13,28,45,-17,21
Lyngby,3460,10,3,9,12,26,45,-19,18
AGF Aarhus,3460,11,4,6,12,17,39,-22,18
Brondby,3461,1,22,6,2,74,30,44,72
FC Midtjylla,3461,2,19,5,6,60,38,22,62
Copenhagen,3461,3,14,7,9,57,42,15,49
FC Nords,3461,4,13,8,9,70,51,19,47
AaB,3461,5,7,13,10,33,40,-7,34
Sonderjyske,3461,6,8,6,10,28,29,-1,30
AC Horsens,3461,7,5,13,12,32,51,-19,28
Randers FC,3461,8,6,6,12,24,39,-15,24
Silkeborg IF,3461,9,6,3,13,31,46,-15,21
Lyngby,3461,10,3,9,12,26,45,-19,18
AGF Aarhus,3461,11,4,6,12,18,42,-24,18
Brondby,3462,1,21,6,3,73,33,40,69
FC Midtjylla,3462,2,19,4,7,67,45,22,61
FC Nords,3462,3,13,8,9,72,52,20,47
Copenhagen,3462,4,14,4,12,61,51,10,46
AaB,3462,5,8,13,9,39,41,-2,37
AC Horsens,3462,6,7,13,10,37,53,-16,34
Sonderjyske,3462,7,8,6,10,28,29,-1,30
Randers FC,3462,8,5,7,12,23,39,-16,22
Silkeborg IF,3462,9,6,3,13,29,46,-17,21
Lyngby,3462,10,3,10,11,26,44,-18,19
AGF Aarhus,3462,11,4,6,12,18,40,-22,18
Brondby,3463,1,21,6,3,72,32,40,69
FC Midtjylla,3463,2,19,5,6,66,38,28,62
Copenhagen,3463,3,15,6,9,62,41,21,51
FC Nords,3463,4,14,7,9,73,52,21,49
AaB,3463,5,7,11,12,35,46,-11,32
AC Horsens,3463,6,6,13,11,34,59,-25,31
Sonderjyske,3463,7,8,6,10,28,29,-1,30
Lyngby,3463,8,4,9,11,30,44,-14,21
AGF Aarhus,3463,9,5,6,11,18,37,-19,21
Randers FC,3463,10,5,6,13,23,43,-20,21
Silkeborg IF,3463,11,5,3,14,26,46,-20,18
Brondby,3464,1,20,6,4,66,33,33,66
FC Midtjylla,3464,2,20,5,5,67,38,29,65
FC Nords,3464,3,14,7,9,73,50,23,49
Copenhagen,3464,4,12,6,12,54,44,10,42
AaB,3464,5,8,12,10,36,41,-5,36
AC Horsens,3464,6,8,12,10,39,55,-16,36
Sonderjyske,3464,7,8,6,10,28,29,-1,30
Lyngby,3464,8,4,9,11,27,44,-17,21
Randers FC,3464,9,5,6,13,23,40,-17,21
AGF Aarhus,3464,10,5,6,11,19,36,-17,21
Silkeborg IF,3464,11,5,3,14,25,47,-22,18
Brondby,3465,1,21,7,2,74,33,41,70
FC Midtjylla,3465,2,18,5,7,65,42,23,59
FC Nords,3465,3,14,6,10,75,59,16,48
Copenhagen,3465,4,14,6,10,61,48,13,48
AaB,3465,5,7,13,10,36,42,-6,34
AC Horsens,3465,6,7,13,10,40,53,-13,34
Sonderjyske,3465,7,8,6,10,28,29,-1,30
Lyngby,3465,8,4,9,11,28,44,-16,21
Randers FC,3465,9,5,6,13,23,41,-18,21
AGF Aarhus,3465,10,5,6,11,17,36,-19,21
Silkeborg IF,3465,11,5,3,14,25,45,-20,18
Brondby,3466,1,20,6,4,71,36,35,66
FC Midtjylla,3466,2,18,5,7,65,46,19,59
FC Nords,3466,3,15,7,8,81,53,28,52
Copenhagen,3466,4,14,5,11,61,51,10,47
AC Horsens,3466,5,8,12,10,37,49,-12,36
AaB,3466,6,8,11,11,37,43,-6,35
Sonderjyske,3466,7,8,6,10,28,29,-1,30
Lyngby,3466,8,4,9,11,29,45,-16,21
Silkeborg IF,3466,9,6,3,13,26,44,-18,21
Randers FC,3466,10,5,6,13,24,42,-18,21
AGF Aarhus,3466,11,4,6,12,16,37,-21,18
Brondby,3467,1,21,7,2,73,33,40,70
FC Midtjylla,3467,2,18,6,6,61,38,23,60
FC Nords,3467,3,15,7,8,78,51,27,52
Copenhagen,3467,4,13,5,12,56,49,7,44
AaB,3467,5,8,12,10,39,42,-3,36
AC Horsens,3467,6,6,13,11,36,56,-20,31
Sonderjyske,3467,7,8,6,10,28,29,-1,30
Lyngby,3467,8,4,9,11,27,44,-17,21
Silkeborg IF,3467,8,6,3,13,27,44,-17,21
Randers FC,3467,10,5,6,13,23,40,-17,21
AGF Aarhus,3467,11,4,6,12,16,38,-22,18
Brondby,3468,1,22,6,2,73,28,45,72
FC Midtjylla,3468,2,20,4,6,65,38,27,64
FC Nords,3468,3,14,6,10,69,55,14,48
Copenhagen,3468,4,13,4,13,53,46,7,43
AaB,3468,5,9,11,10,39,38,1,38
AC Horsens,3468,6,6,13,11,34,54,-20,31
Sonderjyske,3468,7,8,6,10,28,29,-1,30
Randers FC,3468,8,5,7,12,24,40,-16,22
Silkeborg IF,3468,9,6,3,13,27,45,-18,21
Lyngby,3468,10,3,10,11,27,45,-18,19
AGF Aarhus,3468,11,4,6,12,17,38,-21,18
FC Midtjylla,3469,1,20,5,5,72,42,30,65
Brondby,3469,2,19,7,4,72,36,36,64
FC Nords,3469,3,15,7,8,75,51,24,52
Copenhagen,3469,4,15,5,10,60,45,15,50
AaB,3469,5,8,12,10,40,45,-5,36
Sonderjyske,3469,6,8,6,10,28,29,-1,30
AC Horsens,3469,7,5,12,13,33,59,-26,27
Lyngby,3469,8,4,9,11,28,44,-16,21
Silkeborg IF,3469,9,6,3,13,28,45,-17,21
Randers FC,3469,10,5,6,13,23,41,-18,21
AGF Aarhus,3469,11,4,6,12,17,39,-22,18
Brondby,3470,1,21,5,4,68,31,37,68
FC Midtjylla,3470,2,18,5,7,62,43,19,59
FC Nords,3470,3,13,9,8,73,52,21,48
Copenhagen,3470,4,14,5,11,61,46,15,47
AC Horsens,3470,5,8,13,9,36,48,-12,37
AaB,3470,6,8,11,11,41,47,-6,35
Sonderjyske,3470,7,8,6,10,28,29,-1,30
Randers FC,3470,8,6,6,12,26,41,-15,24
Silkeborg IF,3470,9,5,4,13,26,45,-19,19
AGF Aarhus,3470,10,4,7,11,17,37,-20,19
Lyngby,3470,11,3,9,12,28,47,-19,18
FC Midtjylla,3471,1,19,6,5,63,38,25,63
Brondby,3471,2,18,8,4,67,37,30,62
FC Nords,3471,3,14,9,7,75,51,24,51
Copenhagen,3471,4,15,4,11,60,44,16,49
AaB,3471,5,7,13,10,34,40,-6,34
AC Horsens,3471,6,7,12,11,35,50,-15,33
Sonderjyske,3471,7,8,6,10,28,29,-1,30
Randers FC,3471,8,6,6,12,26,41,-15,24
Silkeborg IF,3471,9,6,3,13,28,44,-16,21
Lyngby,3471,10,3,9,12,28,47,-19,18
AGF Aarhus,3471,11,4,6,12,16,39,-23,18
Brondby,3472,1,22,6,2,74,30,44,72
FC Midtjylla,3472,2,17,5,8,59,44,15,56
FC Nords,3472,3,16,6,8,76,50,26,54
Copenhagen,3472,4,15,5,10,58,43,15,50
AaB,3472,5,6,13,11,37,45,-8,31
AC Horsens,3472,6,6,13,11,33,51,-18,31
Sonderjyske,3472,7,8,6,10,28,29,-1,30
Lyngby,3472,8,4,9,11,27,44,-17,21
Randers FC,3472,9,5,6,13,23,40,-17,21
Silkeborg IF,3472,10,6,3,13,26,44,-18,21
AGF Aarhus,3472,11,4,6,12,16,37,-21,18
Brondby,3473,1,20,7,3,72,34,38,67
FC Midtjylla,3473,2,20,5,5,73,42,31,65
Copenhagen,3473,3,13,6,11,58,49,9,45
FC Nords,3473,4,12,8,10,70,54,16,44
AC Horsens,3473,5,8,13,9,42,57,-15,37
AaB,3473,6,6,15,9,40,45,-5,33
Sonderjyske,3473,7,8,6,10,28,29,-1,30
Randers FC,3473,8,6,6,12,25,40,-15,24
Silkeborg IF,3473,9,6,3,13,28,44,-16,21
Lyngby,3473,10,3,9,12,27,46,-19,18
AGF Aarhus,3473,11,4,6,12,16,39,-23,18
Brondby,3474,1,21,5,4,72,34,38,68
FC Midtjylla,3474,2,19,5,6,66,42,24,62
FC Nords,3474,3,15,6,9,74,50,24,51
Copenhagen,3474,4,15,4,11,57,45,12,49
AaB,3474,5,8,12,10,35,39,-4,36
Sonderjyske,3474,6,8,6,10,28,29,-1,30
AC Horsens,3474,7,6,12,12,36,56,-20,30
Randers FC,3474,8,6,6,12,27,41,-14,24
Silkeborg IF,3474,9,5,4,13,28,47,-19,19
AGF Aarhus,3474,10,4,7,11,19,39,-20,19
Lyngby,3474,11,3,9,12,28,48,-20,18
Brondby,3475,1,20,6,4,72,33,39,66
FC Midtjylla,3475,2,19,4,7,64,43,21,61
FC Nords,3475,3,15,7,8,77,50,27,52
Copenhagen,3475,4,16,4,10,58,41,17,52
AC Horsens,3475,5,7,14,9,39,52,-13,35
Sonderjyske,3475,6,8,6,10,28,29,-1,30
AaB,3475,7,6,11,13,34,51,-17,29
Lyngby,3475,8,4,9,11,30,46,-16,21
Randers FC,3475,9,5,6,13,25,43,-18,21
Silkeborg IF,3475,10,5,4,13,25,44,-19,19
AGF Aarhus,3475,11,4,7,11,16,36,-20,19
Brondby,3476,1,21,6,3,71,33,38,69
FC Midtjylla,3476,2,20,5,5,64,38,26,65
FC Nords,3476,3,13,10,7,70,46,24,49
Copenhagen,3476,4,13,7,10,57,43,14,46
AaB,3476,5,6,13,11,35,44,-9,31
Sonderjyske,3476,6,8,6,10,28,29,-1,30
AC Horsens,3476,7,5,15,10,33,52,-19,30
Randers FC,3476,8,5,7,12,23,39,-16,22
Lyngby,3476,9,3,10,11,26,44,-18,19
Silkeborg IF,3476,10,5,4,13,25,44,-19,19
AGF Aarhus,3476,11,4,7,11,16,36,-20,19
FC Midtjylla,3477,1,20,4,6,66,39,27,64
Brondby,3477,2,19,6,5,67,36,31,63
FC Nords,3477,3,13,7,10,70,51,19,46
Copenhagen,3477,4,13,5,12,60,51,9,44
AaB,3477,5,10,11,9,42,42,0,41
AC Horsens,3477,6,8,13,9,40,52,-12,37
Sonderjyske,3477,7,8,6,10,28,29,-1,30
Lyngby,3477,8,4,9,11,28,44,-16,21
Randers FC,3477,9,5,6,13,23,41,-18,21
AGF Aarhus,3477,10,5,6,11,19,38,-19,21
Silkeborg IF,3477,11,5,3,14,27,47,-20,18
Brondby,3478,1,22,6,2,74,33,41,72
FC Midtjylla,3478,2,20,4,6,68,39,29,64
FC Nords,3478,3,14,7,9,73,54,19,49
Copenhagen,3478,4,14,4,12,58,47,11,46
AC Horsens,3478,5,7,13,10,35,50,-15,34
Sonderjyske,3478,6,8,6,10,28,29,-1,30
AaB,3478,7,6,12,12,35,46,-11,30
Randers FC,3478,8,6,6,12,27,41,-14,24
Silkeborg IF,3478,9,6,3,13,29,47,-18,21
Lyngby,3478,10,3,9,12,28,48,-20,18
AGF Aarhus,3478,11,4,6,12,19,40,-21,18
Brondby,3479,1,20,6,4,66,30,36,66
FC Midtjylla,3479,2,20,5,5,66,40,26,65
FC Nords,3479,3,12,10,8,71,51,20,46
Copenhagen,3479,4,13,7,10,56,42,14,46
AaB,3479,5,8,13,9,35,39,-4,37
AC Horsens,3479,6,6,13,11,33,51,-18,31
Sonderjyske,3479,7,8,6,10,28,29,-1,30
Lyngby,3479,8,4,9,11,27,44,-17,21
Randers FC,3479,9,5,6,13,23,40,-17,21
Silkeborg IF,3479,10,6,3,13,26,44,-18,21
AGF Aarhus,3479,11,4,6,12,16,37,-21,18
Brondby,3480,1,21,6,3,74,32,42,69
FC Midtjylla,3480,2,18,4,8,59,43,16,58
FC Nords,3480,3,15,7,8,79,54,25,52
Copenhagen,3480,4,15,5,10,61,45,16,50
AaB,3480,5,7,12,11,39,48,-9,33
AC Horsens,3480,6,7,12,11,38,54,-16,33
Sonderjyske,3480,7,8,6,10,28,29,-1,30
Randers FC,3480,8,6,6,12,26,41,-15,24
Silkeborg IF,3480,9,5,4,13,27,46,-19,19
AGF Aarhus,3480,10,4,7,11,18,38,-20,19
Lyngby,3480,11,3,9,12,28,47,-19,18
Brondby,3481,1,20,6,4,68,36,32,66
FC Midtjylla,3481,2,20,4,6,70,38,32,64
Copenhagen,3481,3,14,5,11,58,45,13,47
FC Nords,3481,4,13,7,10,71,55,16,46
AaB,3481,5,8,14,8,37,39,-2,38
AC Horsens,3481,6,6,14,10,34,51,-17,32
Sonderjyske,3481,7,8,6,10,28,29,-1,30
Randers FC,3481,8,5,7,12,24,40,-16,22
Lyngby,3481,9,3,10,11,27,45,-18,19
Silkeborg IF,3481,10,5,4,13,28,47,-19,19
AGF Aarhus,3481,11,4,7,11,19,39,-20,19
Brondby,3482,1,22,5,3,70,32,38,71
FC Midtjylla,3482,2,21,4,5,69,35,34,67
Copenhagen,3482,3,14,5,11,61,44,17,47
FC Nords,3482,4,13,7,10,71,56,15,46
AaB,3482,5,8,11,11,35,46,-11,35
Sonderjyske,3482,6,8,6,10,28,29,-1,30
AC Horsens,3482,7,6,12,12,33,52,-19,30
Lyngby,3482,8,4,9,11,27,44,-17,21
Silkeborg IF,3482,8,6,3,13,27,44,-17,21
Randers FC,3482,10,5,6,13,23,40,-17,21
AGF Aarhus,3482,11,4,6,12,16,38,-22,18
Brondby,3483,1,23,5,2,79,31,48,74
FC Midtjylla,3483,2,19,5,6,68,43,25,62
FC Nords,3483,3,13,8,9,69,54,15,47
Copenhagen,3483,4,14,4,12,59,46,13,46
AaB,3483,5,8,12,10,38,41,-3,36
Sonderjyske,3483,6,8,6,10,28,29,-1,30
AC Horsens,3483,7,5,14,11,35,59,-24,29
Randers FC,3483,8,6,6,12,25,40,-15,24
AGF Aarhus,3483,9,5,6,11,19,37,-18,21
Lyngby,3483,10,3,9,12,27,46,-19,18
Silkeborg IF,3483,11,5,3,14,26,47,-21,18
Brondby,3484,1,21,5,4,70,31,39,68
FC Midtjylla,3484,2,21,4,5,72,41,31,67
FC Nords,3484,3,13,8,9,72,54,18,47
Copenhagen,3484,4,14,5,11,61,47,14,47
AaB,3484,5,9,11,10,40,43,-3,38
Sonderjyske,3484,6,8,6,10,28,29,-1,30
AC Horsens,3484,7,5,13,12,34,59,-25,28
Randers FC,3484,8,5,7,12,24,40,-16,22
Silkeborg IF,3484,9,6,3,13,27,45,-18,21
Lyngby,3484,10,3,10,11,27,45,-18,19
AGF Aarhus,3484,11,4,6,12,17,38,-21,18
Brondby,3485,1,19,7,4,67,38,29,64
FC Midtjylla,3485,2,19,5,6,66,42,24,62
FC Nords,3485,3,16,7,7,76,48,28,55
Copenhagen,3485,4,13,5,12,58,47,11,44
AaB,3485,5,8,11,11,45,48,-3,35
AC Horsens,3485,6,7,13,10,38,53,-15,34
Sonderjyske,3485,7,8,6,10,28,29,-1,30
Randers FC,3485,8,6,6,12,25,40,-15,24
Silkeborg IF,3485,9,5,4,13,26,45,-19,19
AGF Aarhus,3485,10,4,7,11,17,37,-20,19
Lyngby,3485,11,3,9,12,27,46,-19,18
Brondby,3486,1,21,7,2,73,29,44,70
FC Midtjylla,3486,2,18,5,7,63,41,22,59
FC Nords,3486,3,13,8,9,71,51,20,47
Copenhagen,3486,4,12,5,13,51,45,6,41
AaB,3486,5,10,11,9,38,41,-3,41
AC Horsens,3486,6,8,12,10,35,50,-15,36
Sonderjyske,3486,7,8,6,10,28,29,-1,30
Randers FC,3486,8,5,7,12,24,40,-16,22
Silkeborg IF,3486,9,6,3,13,26,44,-18,21
Lyngby,3486,10,3,10,11,27,45,-18,19
AGF Aarhus,3486,11,4,6,12,16,37,-21,18
Brondby,3487,1,20,7,3,68,28,40,67
FC Midtjylla,3487,2,20,4,6,67,42,25,64
Copenhagen,3487,3,14,5,11,58,47,11,47
FC Nords,3487,4,13,7,10,70,53,17,46
AaB,3487,5,9,12,9,42,41,1,39
Sonderjyske,3487,6,8,6,10,28,29,-1,30
AC Horsens,3487,7,5,15,10,36,56,-20,30
Lyngby,3487,8,4,9,11,29,45,-16,21
Silkeborg IF,3487,9,6,3,13,27,45,-18,21
Randers FC,3487,10,5,6,13,24,42,-18,21
AGF Aarhus,3487,11,4,6,12,17,38,-21,18
Brondby,3488,1,20,7,3,72,31,41,67
FC Midtjylla,3488,2,20,5,5,65,34,31,65
FC Nords,3488,3,14,7,9,73,51,22,49
Copenhagen,3488,4,13,6,11,62,51,11,45
AaB,3488,5,8,11,11,36,51,-15,35
AC Horsens,3488,6,6,14,10,37,53,-16,32
Sonderjyske,3488,7,8,6,10,28,29,-1,30
Randers FC,3488,8,6,6,12,25,39,-14,24
Silkeborg IF,3488,9,6,3,13,28,45,-17,21
Lyngby,3488,10,3,9,12,26,46,-20,18
AGF Aarhus,3488,11,4,6,12,17,39,-22,18
Brondby,3489,1,21,6,3,75,33,42,69
FC Midtjylla,3489,2,21,5,4,69,38,31,68
FC Nords,3489,3,13,7,10,74,55,19,46
Copenhagen,3489,4,13,5,12,60,51,9,44
AC Horsens,3489,5,7,13,10,34,55,-21,34
AaB,3489,6,7,12,11,39,45,-6,33
Sonderjyske,3489,7,8,6,10,28,29,-1,30
Randers FC,3489,8,6,6,12,26,40,-14,24
Silkeborg IF,3489,9,5,4,13,27,46,-19,19
AGF Aarhus,3489,10,4,7,11,18,38,-20,19
Lyngby,3489,11,3,9,12,27,47,-20,18
Brondby,3490,1,22,5,3,76,31,45,71
FC Midtjylla,3490,2,20,5,5,69,40,29,65
FC Nords,3490,3,15,7,8,76,52,24,52
Copenhagen,3490,4,12,6,12,53,48,5,42
AC Horsens,3490,5,7,13,10,37,55,-18,34
Sonderjyske,3490,6,8,6,10,28,29,-1,30
AaB,3490,7,6,12,12,37,48,-11,30
Lyngby,3490,8,4,9,11,28,44,-16,21
Randers FC,3490,9,5,6,13,23,41,-18,21
Silkeborg IF,3490,10,5,4,13,27,46,-19,19
AGF Aarhus,3490,11,4,7,11,18,38,-20,19
Brondby,3491,1,21,7,2,73,29,44,70
FC Midtjylla,3491,2,17,5,8,61,44,17,56
FC Nords,3491,3,14,6,10,77,56,21,48
Copenhagen,3491,4,13,6,11,56,47,9,45
AaB,3491,5,8,13,9,38,41,-3,37
AC Horsens,3491,6,8,13,9,35,49,-14,37
Sonderjyske,3491,7,8,6,10,28,29,-1,30
Lyngby,3491,8,4,9,11,29,46,-17,21
Randers FC,3491,9,5,6,13,25,42,-17,21
Silkeborg IF,3491,10,5,4,13,27,46,-19,19
AGF Aarhus,3491,11,4,7,11,18,38,-20,19
Brondby,3492,1,21,5,4,75,37,38,68
FC Midtjylla,3492,2,18,5,7,61,40,21,59
Copenhagen,3492,3,14,6,10,57,43,14,48
FC Nords,3492,4,13,7,10,68,55,13,46
AaB,3492,5,8,13,9,41,40,1,37
AC Horsens,3492,6,7,14,9,38,51,-13,35
Sonderjyske,3492,7,8,6,10,28,29,-1,30
Randers FC,3492,8,5,7,12,24,40,-16,22
AGF Aarhus,3492,9,5,6,11,17,36,-19,21
Lyngby,3492,10,3,10,11,27,45,-18,19
Silkeborg IF,3492,11,5,3,14,25,45,-20,18
FC Midtjylla,3493,1,20,6,4,66,35,31,66
Brondby,3493,2,20,5,5,67,34,33,65
FC Nords,3493,3,15,6,9,75,50,25,51
Copenhagen,3493,4,15,5,10,59,45,14,50
AaB,3493,5,8,12,10,35,39,-4,36
Sonderjyske,3493,6,8,6,10,28,29,-1,30
AC Horsens,3493,7,5,12,13,33,58,-25,27
Randers FC,3493,8,5,7,12,25,41,-16,22
Lyngby,3493,9,3,10,11,28,46,-18,19
Silkeborg IF,3493,10,5,4,13,25,44,-19,19
AGF Aarhus,3493,11,4,7,11,16,36,-20,19
Brondby,3494,1,22,6,2,73,29,44,72
FC Midtjylla,3494,2,18,4,8,62,44,18,58
FC Nords,3494,3,15,6,9,73,51,22,51
Copenhagen,3494,4,14,5,11,55,41,14,47
AaB,3494,5,8,11,11,36,41,-5,35
AC Horsens,3494,6,7,12,11,33,52,-19,33
Sonderjyske,3494,7,8,6,10,28,29,-1,30
Silkeborg IF,3494,8,6,3,13,28,44,-16,21
Lyngby,3494,9,4,9,11,28,45,-17,21
Randers FC,3494,10,5,6,13,24,41,-17,21
AGF Aarhus,3494,11,4,6,12,16,39,-23,18
Brondby,3495,1,22,6,2,74,32,42,72
FC Midtjylla,3495,2,20,4,6,69,39,30,64
FC Nords,3495,3,13,9,8,74,52,22,48
Copenhagen,3495,4,14,4,12,56,46,10,46
AC Horsens,3495,5,7,13,10,33,47,-14,34
Sonderjyske,3495,6,8,6,10,28,29,-1,30
AaB,3495,7,6,12,12,36,52,-16,30
Randers FC,3495,8,6,6,12,24,39,-15,24
Silkeborg IF,3495,9,6,3,13,28,45,-17,21
Lyngby,3495,10,3,9,12,26,45,-19,18
AGF Aarhus,3495,11,4,6,12,17,39,-22,18
Brondby,3496,1,20,5,5,72,33,39,65
FC Midtjylla,3496,2,20,5,5,69,41,28,65
FC Nords,3496,3,15,7,8,74,51,23,52
Copenhagen,3496,4,14,4,12,59,48,11,46
AaB,3496,5,9,11,10,38,42,-4,38
Sonderjyske,3496,6,8,6,10,28,29,-1,30
AC Horsens,3496,7,6,12,12,37,60,-23,30
Lyngby,3496,8,4,9,11,29,44,-15,21
AGF Aarhus,3496,9,5,6,11,18,36,-18,21
Randers FC,3496,10,5,6,13,23,42,-19,21
Silkeborg IF,3496,11,5,3,14,25,46,-21,18
Brondby,3497,1,20,6,4,68,34,34,66
FC Midtjylla,3497,2,18,7,5,65,41,24,61
FC Nords,3497,3,12,9,9,74,55,19,45
Copenhagen,3497,4,13,6,11,56,44,12,45
AaB,3497,5,9,11,10,39,44,-5,38
AC Horsens,3497,6,8,13,9,38,48,-10,37
Sonderjyske,3497,7,8,6,10,28,29,-1,30
Lyngby,3497,8,4,9,11,30,45,-15,21
AGF Aarhus,3497,9,5,6,11,19,37,-18,21
Randers FC,3497,10,5,6,13,24,43,-19,21
Silkeborg IF,3497,11,5,3,14,26,47,-21,18
Brondby,3498,1,21,6,3,73,31,42,69
FC Midtjylla,3498,2,21,4,5,62,36,26,67
FC Nords,3498,3,15,7,8,74,50,24,52
Copenhagen,3498,4,12,6,12,54,45,9,42
AC Horsens,3498,5,7,12,11,36,54,-18,33
AaB,3498,6,7,11,12,37,46,-9,32
Sonderjyske,3498,7,8,6,10,28,29,-1,30
Lyngby,3498,8,4,9,11,28,45,-17,21
Randers FC,3498,9,5,6,13,24,41,-17,21
Silkeborg IF,3498,10,5,4,13,25,44,-19,19
AGF Aarhus,3498,11,4,7,11,16,36,-20,19
Brondby,3499,1,19,6,5,67,35,32,63
FC Midtjylla,3499,2,19,5,6,65,40,25,62
FC Nords,3499,3,16,6,8,79,52,27,54
Copenhagen,3499,4,16,5,9,62,41,21,53
AaB,3499,5,6,13,11,34,43,-9,31
Sonderjyske,3499,6,8,6,10,28,29,-1,30
AC Horsens,3499,7,5,15,10,33,55,-22,30
Lyngby,3499,8,4,9,11,29,44,-15,21
Silkeborg IF,3499,9,6,3,13,26,44,-18,21
Randers FC,3499,10,5,6,13,23,42,-19,21
AGF Aarhus,3499,11,4,6,12,16,37,-21,18
Brondby,3500,1,21,7,2,71,32,39,70
FC Midtjylla,3500,2,19,7,4,64,37,27,64
FC Nords,3500,3,14,6,10,73,55,18,48
Copenhagen,3500,4,12,5,13,54,46,8,41
AC Horsens,3500,5,7,15,8,39,51,-12,36
AaB,3500,6,7,12,11,37,43,-6,33
Sonderjyske,3500,7,8,6,10,28,29,-1,30
Lyngby,3500,8,4,9,11,30,45,-15,21
Randers FC,3500,9,5,6,13,24,43,-19,21
AGF Aarhus,3500,10,5,6,11,17,36,-19,21
Silkeborg IF,3500,11,5,3,14,25,45,-20,18
Brondby,3501,1,21,6,3,71,30,41,69
FC Midtjylla,3501,2,18,4,8,59,41,18,58
FC Nords,3501,3,15,6,9,74,54,20,51
Copenhagen,3501,4,13,5,12,56,44,12,44
AaB,3501,5,8,13,9,41,43,-2,37
AC Horsens,3501,6,8,12,10,37,52,-15,36
Sonderjyske,3501,7,8,6,10,28,29,-1,30
Lyngby,3501,8,4,9,11,29,44,-15,21
Silkeborg IF,3501,9,6,3,13,27,45,-18,21
Randers FC,3501,10,5,6,13,23,42,-19,21
AGF Aarhus,3501,11,4,6,12,17,38,-21,18
Brondby,3502,1,19,8,3,69,33,36,65
FC Midtjylla,3502,2,20,5,5,66,37,29,65
Copenhagen,3502,3,15,5,10,59,43,16,50
FC Nords,3502,4,13,8,9,71,52,19,47
AaB,3502,5,7,13,10,38,46,-8,34
AC Horsens,3502,6,6,13,11,37,55,-18,31
Sonderjyske,3502,7,8,6,10,28,29,-1,30
Randers FC,3502,8,5,7,12,24,40,-16,22
Lyngby,3502,9,3,10,11,27,45,-18,19
Silkeborg IF,3502,10,5,4,13,26,45,-19,19
AGF Aarhus,3502,11,4,7,11,17,37,-20,19
Brondby,3503,1,21,5,4,69,34,35,68
FC Midtjylla,3503,2,19,4,7,64,39,25,61
FC Nords,3503,3,15,7,8,71,48,23,52
Copenhagen,3503,4,15,4,11,58,44,14,49
AaB,3503,5,8,12,10,36,41,-5,36
Sonderjyske,3503,6,8,6,10,28,29,-1,30
AC Horsens,3503,7,6,12,12,36,54,-18,30
Randers FC,3503,8,5,7,12,24,40,-16,22
AGF Aarhus,3503,9,5,6,11,18,36,-18,21
Lyngby,3503,10,3,10,11,27,45,-18,19
Silkeborg IF,3503,11,5,3,14,25,46,-21,18
Brondby,3504,1,22,5,3,71,31,40,71
FC Midtjylla,3504,2,20,4,6,65,38,27,64
FC Nords,3504,3,14,7,9,70,48,22,49
Copenhagen,3504,4,13,5,12,54,48,6,44
AaB,3504,5,8,11,11,37,39,-2,35
AC Horsens,3504,6,7,12,11,33,52,-19,33
Sonderjyske,3504,7,8,6,10,28,29,-1,30
Lyngby,3504,8,4,9,11,27,44,-17,21
Randers FC,3504,9,5,6,13,23,40,-17,21
Silkeborg IF,3504,10,5,4,13,26,45,-19,19
AGF Aarhus,3504,11,4,7,11,17,37,-20,19
Brondby,3505,1,20,7,3,66,30,36,67
FC Midtjylla,3505,2,20,5,5,67,39,28,65
FC Nords,3505,3,15,8,7,78,50,28,53
Copenhagen,3505,4,14,4,12,56,47,9,46
AaB,3505,5,8,11,11,39,43,-4,35
Sonderjyske,3505,6,8,6,10,28,29,-1,30
AC Horsens,3505,7,5,13,12,36,59,-23,28
Randers FC,3505,8,6,6,12,25,40,-15,24
Silkeborg IF,3505,9,6,3,13,26,44,-18,21
Lyngby,3505,10,3,9,12,27,46,-19,18
AGF Aarhus,3505,11,4,6,12,16,37,-21,18
Brondby,3506,1,22,5,3,73,30,43,71
FC Midtjylla,3506,2,20,4,6,64,38,26,64
FC Nords,3506,3,13,9,8,73,53,20,48
Copenhagen,3506,4,13,6,11,58,45,13,45
AaB,3506,5,7,13,10,40,47,-7,34
AC Horsens,3506,6,6,13,11,33,54,-21,31
Sonderjyske,3506,7,8,6,10,28,29,-1,30
Randers FC,3506,8,6,6,12,24,39,-15,24
Silkeborg IF,3506,9,5,4,13,26,45,-19,19
AGF Aarhus,3506,10,4,7,11,17,37,-20,19
Lyngby,3506,11,3,9,12,26,45,-19,18
FC Midtjylla,3507,1,21,4,5,67,38,29,67
Brondby,3507,2,20,5,5,75,37,38,65
Copenhagen,3507,3,15,5,10,58,41,17,50
FC Nords,3507,4,12,7,11,69,58,11,43
AC Horsens,3507,5,8,12,10,37,50,-13,36
AaB,3507,6,8,11,11,35,43,-8,35
Sonderjyske,3507,7,8,6,10,28,29,-1,30
Randers FC,3507,8,5,7,12,24,40,-16,22
Silkeborg IF,3507,9,6,3,13,27,44,-17,21
Lyngby,3507,10,3,10,11,27,45,-18,19
AGF Aarhus,3507,11,4,6,12,16,38,-22,18
Brondby,3508,1,22,5,3,69,29,40,71
FC Midtjylla,3508,2,19,5,6,67,42,25,62
FC Nords,3508,3,14,7,9,70,53,17,49
Copenhagen,3508,4,14,5,11,62,45,17,47
AaB,3508,5,7,12,11,38,47,-9,33
AC Horsens,3508,6,7,12,11,37,53,-16,33
Sonderjyske,3508,7,8,6,10,28,29,-1,30
Randers FC,3508,8,6,6,12,26,39,-13,24
Silkeborg IF,3508,9,5,4,13,28,47,-19,19
AGF Aarhus,3508,10,4,7,11,19,39,-20,19
Lyngby,3508,11,3,9,12,26,47,-21,18
FC Midtjylla,3509,1,21,4,5,68,38,30,67
Brondby,3509,2,19,7,4,72,37,35,64
FC Nords,3509,3,14,8,8,76,54,22,50
Copenhagen,3509,4,14,5,11,60,49,11,47
AaB,3509,5,7,13,10,37,40,-3,34
AC Horsens,3509,6,6,13,11,35,56,-21,31
Sonderjyske,3509,7,8,6,10,28,29,-1,30
Lyngby,3509,8,4,9,11,29,45,-16,21
Randers FC,3509,9,5,6,13,24,42,-18,21
Silkeborg IF,3509,10,5,4,13,28,47,-19,19
AGF Aarhus,3509,11,4,7,11,19,39,-20,19
Brondby,3510,1,22,5,3,70,34,36,71
FC Midtjylla,3510,2,21,4,5,71,40,31,67
Copenhagen,3510,3,15,5,10,64,42,22,50
FC Nords,3510,4,13,7,10,72,53,19,46
AaB,3510,5,8,11,11,41,48,-7,35
Sonderjyske,3510,6,8,6,10,28,29,-1,30
AC Horsens,3510,7,5,12,13,32,59,-27,27
Lyngby,3510,8,4,9,11,28,45,-17,21
Randers FC,3510,9,5,6,13,24,41,-17,21
Silkeborg IF,3510,10,5,4,13,25,44,-19,19
AGF Aarhus,3510,11,4,7,11,16,36,-20,19
Brondby,3511,1,23,5,2,70,27,43,74
FC Midtjylla,3511,2,19,5,6,63,36,27,62
FC Nords,3511,3,14,8,8,78,53,25,50
Copenhagen,3511,4,13,5,12,57,46,11,44
AaB,3511,5,7,13,10,39,48,-9,34
Sonderjyske,3511,6,8,6,10,28,29,-1,30
AC Horsens,3511,7,6,12,12,35,58,-23,30
Lyngby,3511,8,4,9,11,29,45,-16,21
Randers FC,3511,9,5,6,13,24,42,-18,21
AGF Aarhus,3511,10,5,6,11,18,37,-19,21
Silkeborg IF,3511,11,5,3,14,26,46,-20,18
Brondby,3512,1,22,6,2,72,29,43,72
FC Midtjylla,3512,2,20,5,5,67,41,26,65
FC Nords,3512,3,14,6,10,72,52,20,48
Copenhagen,3512,4,14,5,11,58,46,12,47
AC Horsens,3512,5,7,12,11,36,53,-17,33
Sonderjyske,3512,6,8,6,10,28,29,-1,30
AaB,3512,7,6,12,12,36,46,-10,30
Randers FC,3512,8,5,7,12,24,40,-16,22
Silkeborg IF,3512,9,6,3,13,29,44,-15,21
Lyngby,3512,10,3,10,11,27,45,-18,19
AGF Aarhus,3512,11,4,6,12,16,40,-24,18
Brondby,3513,1,22,6,2,73,30,43,72
FC Midtjylla,3513,2,21,4,5,64,37,27,67
FC Nords,3513,3,14,6,10,68,50,18,48
Copenhagen,3513,4,13,5,12,55,47,8,44
AaB,3513,5,7,13,10,36,41,-5,34
Sonderjyske,3513,6,8,6,10,28,29,-1,30
AC Horsens,3513,7,6,12,12,35,52,-17,30
Lyngby,3513,8,4,9,11,27,44,-17,21
Randers FC,3513,9,5,6,13,23,40,-17,21
Silkeborg IF,3513,10,6,3,13,28,46,-18,21
AGF Aarhus,3513,11,4,6,12,18,39,-21,18
Brondby,3514,1,19,8,3,65,29,36,65
FC Midtjylla,3514,2,18,7,5,62,38,24,61
Copenhagen,3514,3,14,5,11,57,41,16,47
FC Nords,3514,4,12,8,10,70,54,16,44
AaB,3514,5,8,13,9,36,40,-4,37
AC Horsens,3514,6,8,13,9,36,50,-14,37
Sonderjyske,3514,7,8,6,10,28,29,-1,30
Randers FC,3514,8,6,6,12,25,39,-14,24
AGF Aarhus,3514,9,5,6,11,20,39,-19,21
Silkeborg IF,3514,10,5,3,14,28,48,-20,18
Lyngby,3514,11,3,9,12,26,46,-20,18
Brondby,3515,1,22,5,3,77,30,47,71
FC Midtjylla,3515,2,18,6,6,63,46,17,60
FC Nords,3515,3,14,7,9,73,53,20,49
Copenhagen,3515,4,13,5,12,59,48,11,44
AC Horsens,3515,5,7,14,9,38,50,-12,35
AaB,3515,6,7,13,10,37,46,-9,34
Sonderjyske,3515,7,8,6,10,28,29,-1,30
Lyngby,3515,8,4,9,11,28,45,-17,21
Randers FC,3515,9,5,6,13,24,41,-17,21
Silkeborg IF,3515,10,5,4,13,26,45,-19,19
AGF Aarhus,3515,11,4,7,11,17,37,-20,19
Brondby,3516,1,20,6,4,68,30,38,66
FC Midtjylla,3516,2,19,5,6,65,41,24,62
FC Nords,3516,3,14,9,7,69,46,23,51
Copenhagen,3516,4,15,4,11,58,45,13,49
AaB,3516,5,7,13,10,38,45,-7,34
AC Horsens,3516,6,6,13,11,36,53,-17,31
Sonderjyske,3516,7,8,6,10,28,29,-1,30
Lyngby,3516,8,4,9,11,27,44,-17,21
Randers FC,3516,9,5,6,13,23,40,-17,21
Silkeborg IF,3516,10,5,4,13,26,45,-19,19
AGF Aarhus,3516,11,4,7,11,17,37,-20,19
Brondby,3517,1,21,7,2,69,30,39,70
FC Midtjylla,3517,2,21,5,4,65,35,30,68
FC Nords,3517,3,14,7,9,72,52,20,49
Copenhagen,3517,4,13,4,13,56,47,9,43
AaB,3517,5,8,11,11,39,45,-6,35
Sonderjyske,3517,6,8,6,10,28,29,-1,30
AC Horsens,3517,7,6,12,12,33,51,-18,30
Lyngby,3517,8,4,9,11,27,44,-17,21
Randers FC,3517,9,5,6,13,23,40,-17,21
Silkeborg IF,3517,10,5,4,13,25,44,-19,19
AGF Aarhus,3517,11,4,7,11,16,36,-20,19
Brondby,3518,1,22,6,2,70,29,41,72
FC Midtjylla,3518,2,21,4,5,67,35,32,67
FC Nords,3518,3,12,8,10,66,53,13,44
Copenhagen,3518,4,12,6,12,54,45,9,42
AaB,3518,5,8,12,10,36,39,-3,36
AC Horsens,3518,6,5,16,9,32,50,-18,31
Sonderjyske,3518,7,8,6,10,28,29,-1,30
Randers FC,3518,8,5,7,12,24,40,-16,22
Lyngby,3518,9,3,10,11,27,45,-18,19
Silkeborg IF,3518,10,5,4,13,26,45,-19,19
AGF Aarhus,3518,11,4,7,11,17,37,-20,19
Brondby,3519,1,22,5,3,77,37,40,71
FC Midtjylla,3519,2,20,5,5,64,37,27,65
FC Nords,3519,3,13,8,9,72,51,21,47
Copenhagen,3519,4,13,7,10,59,44,15,46
AaB,3519,5,6,14,10,36,44,-8,32
AC Horsens,3519,6,6,13,11,33,54,-21,31
Sonderjyske,3519,7,8,6,10,28,29,-1,30
Lyngby,3519,8,4,9,11,30,44,-14,21
Silkeborg IF,3519,9,6,3,13,27,44,-17,21
Randers FC,3519,10,5,6,13,23,43,-20,21
AGF Aarhus,3519,11,4,6,12,16,38,-22,18
Brondby,3520,1,20,6,4,68,31,37,66
FC Midtjylla,3520,2,19,4,7,66,42,24,61
Copenhagen,3520,3,16,4,10,57,41,16,52
FC Nords,3520,4,15,6,9,77,54,23,51
AaB,3520,5,8,11,11,41,48,-7,35
AC Horsens,3520,6,6,13,11,34,53,-19,31
Sonderjyske,3520,7,8,6,10,28,29,-1,30
Randers FC,3520,8,6,6,12,26,39,-13,24
AGF Aarhus,3520,9,5,6,11,18,37,-19,21
Silkeborg IF,3520,10,5,3,14,26,46,-20,18
Lyngby,3520,11,3,9,12,26,47,-21,18
Brondby,3521,1,19,6,5,71,35,36,63
FC Midtjylla,3521,2,19,5,6,61,41,20,62
FC Nords,3521,3,16,6,8,79,49,30,54
Copenhagen,3521,4,13,7,10,57,46,11,46
AC Horsens,3521,5,8,14,8,36,46,-10,38
Sonderjyske,3521,6,8,6,10,28,29,-1,30
AaB,3521,7,6,12,12,35,48,-13,30
Lyngby,3521,8,4,9,11,30,46,-16,21
Randers FC,3521,9,5,6,13,25,43,-18,21
Silkeborg IF,3521,10,5,4,13,26,45,-19,19
AGF Aarhus,3521,11,4,7,11,17,37,-20,19
Brondby,3522,1,20,5,5,66,36,30,65
FC Midtjylla,3522,2,20,4,6,65,39,26,64
FC Nords,3522,3,14,8,8,69,47,22,50
Copenhagen,3522,4,14,5,11,57,43,14,47
AaB,3522,5,9,12,9,41,40,1,39
Sonderjyske,3522,6,8,6,10,28,29,-1,30
AC Horsens,3522,7,6,12,12,36,55,-19,30
Randers FC,3522,8,5,7,12,24,40,-16,22
Silkeborg IF,3522,9,6,3,13,27,44,-17,21
Lyngby,3522,10,3,10,11,27,45,-18,19
AGF Aarhus,3522,11,4,6,12,16,38,-22,18
Brondby,3523,1,22,5,3,74,32,42,71
FC Midtjylla,3523,2,20,4,6,69,40,29,64
FC Nords,3523,3,15,6,9,77,56,21,51
Copenhagen,3523,4,13,6,11,56,43,13,45
AaB,3523,5,7,12,11,35,46,-11,33
AC Horsens,3523,6,6,13,11,33,53,-20,31
Sonderjyske,3523,7,8,6,10,28,29,-1,30
Randers FC,3523,8,6,6,12,25,40,-15,24
Silkeborg IF,3523,9,5,4,13,25,44,-19,19
AGF Aarhus,3523,10,4,7,11,16,36,-20,19
Lyngby,3523,11,3,9,12,27,46,-19,18
Brondby,3524,1,21,7,2,70,30,40,70
FC Midtjylla,3524,2,20,4,6,65,40,25,64
Copenhagen,3524,3,15,5,10,58,42,16,50
FC Nords,3524,4,13,6,11,72,55,17,45
AaB,3524,5,8,11,11,38,43,-5,35
AC Horsens,3524,6,6,13,11,35,54,-19,31
Sonderjyske,3524,7,8,6,10,28,29,-1,30
Randers FC,3524,8,5,7,12,25,41,-16,22
Lyngby,3524,9,3,10,11,28,46,-18,19
Silkeborg IF,3524,10,5,4,13,26,45,-19,19
AGF Aarhus,3524,11,4,7,11,17,37,-20,19
Brondby,3525,1,21,6,3,72,34,38,69
FC Midtjylla,3525,2,19,6,5,70,42,28,63
FC Nords,3525,3,15,7,8,74,49,25,52
Copenhagen,3525,4,13,5,12,58,50,8,44
AaB,3525,5,8,12,10,37,43,-6,36
Sonderjyske,3525,6,8,6,10,28,29,-1,30
AC Horsens,3525,7,6,12,12,36,55,-19,30
Randers FC,3525,8,5,7,12,25,41,-16,22
Silkeborg IF,3525,9,6,3,13,27,45,-18,21
Lyngby,3525,10,3,10,11,28,46,-18,19
AGF Aarhus,3525,11,4,6,12,17,38,-21,18
Brondby,3526,1,21,7,2,72,33,39,70
FC Midtjylla,3526,2,20,4,6,67,41,26,64
FC Nords,3526,3,14,6,10,69,48,21,48
Copenhagen,3526,4,14,5,11,60,48,12,47
AaB,3526,5,7,13,10,36,42,-6,34
AC Horsens,3526,6,6,13,11,34,52,-18,31
Sonderjyske,3526,7,8,6,10,28,29,-1,30
Lyngby,3526,8,4,9,11,28,45,-17,21
Randers FC,3526,9,5,6,13,24,41,-17,21
Silkeborg IF,3526,10,6,3,13,26,44,-18,21
AGF Aarhus,3526,11,4,6,12,16,37,-21,18
Brondby,3527,1,20,7,3,73,33,40,67
FC Midtjylla,3527,2,20,4,6,67,43,24,64
FC Nords,3527,3,14,7,9,75,54,21,49
Copenhagen,3527,4,13,5,12,57,48,9,44
AaB,3527,5,8,12,10,38,42,-4,36
AC Horsens,3527,6,7,13,10,37,53,-16,34
Sonderjyske,3527,7,8,6,10,28,29,-1,30
Lyngby,3527,8,4,9,11,29,44,-15,21
Silkeborg IF,3527,9,6,3,13,26,44,-18,21
Randers FC,3527,10,5,6,13,23,42,-19,21
AGF Aarhus,3527,11,4,6,12,16,37,-21,18
FC Midtjylla,3528,1,22,4,4,70,36,34,70
Brondby,3528,2,19,6,5,69,37,32,63
FC Nords,3528,3,14,7,9,76,51,25,49
Copenhagen,3528,4,12,7,11,56,50,6,43
AaB,3528,5,7,13,10,34,43,-9,34
AC Horsens,3528,6,6,15,9,37,51,-14,33
Sonderjyske,3528,7,8,6,10,28,29,-1,30
Randers FC,3528,8,5,7,12,23,39,-16,22
Lyngby,3528,9,3,10,11,26,44,-18,19
Silkeborg IF,3528,10,5,4,13,25,44,-19,19
AGF Aarhus,3528,11,4,7,11,16,36,-20,19
Brondby,3529,1,21,6,3,74,33,41,69
FC Midtjylla,3529,2,19,5,6,62,41,21,62
FC Nords,3529,3,16,6,8,74,49,25,54
Copenhagen,3529,4,13,6,11,54,43,11,45
AaB,3529,5,8,11,11,38,43,-5,35
Sonderjyske,3529,6,8,6,10,28,29,-1,30
AC Horsens,3529,7,5,14,11,32,51,-19,29
Lyngby,3529,8,4,9,11,28,45,-17,21
Silkeborg IF,3529,8,6,3,13,28,45,-17,21
Randers FC,3529,10,5,6,13,24,41,-17,21
AGF Aarhus,3529,11,4,6,12,17,39,-22,18
Brondby,3530,1,19,8,3,68,33,35,65
FC Midtjylla,3530,2,19,7,4,67,37,30,64
FC Nords,3530,3,16,7,7,76,48,28,55
Copenhagen,3530,4,12,7,11,53,45,8,43
AaB,3530,5,8,11,11,38,41,-3,35
Sonderjyske,3530,6,8,6,10,28,29,-1,30
AC Horsens,3530,7,5,14,11,33,57,-24,29
Lyngby,3530,8,4,9,11,28,45,-17,21
Randers FC,3530,9,5,6,13,24,41,-17,21
AGF Aarhus,3530,10,5,6,11,17,36,-19,21
Silkeborg IF,3530,11,5,3,14,25,45,-20,18
Brondby,3531,1,20,6,4,71,32,39,66
FC Midtjylla,3531,2,20,5,5,68,37,31,65
FC Nords,3531,3,13,9,8,74,55,19,48
Copenhagen,3531,4,14,6,10,60,43,17,48
AaB,3531,5,7,12,11,33,46,-13,33
AC Horsens,3531,6,6,14,10,34,53,-19,32
Sonderjyske,3531,7,8,6,10,28,29,-1,30
Lyngby,3531,8,4,9,11,28,44,-16,21
Randers FC,3531,9,5,6,13,23,41,-18,21
AGF Aarhus,3531,10,5,6,11,18,37,-19,21
Silkeborg IF,3531,11,5,3,14,26,46,-20,18
Brondby,3532,1,20,7,3,69,28,41,67
FC Midtjylla,3532,2,19,6,5,64,39,25,63
Copenhagen,3532,3,14,6,10,54,40,14,48
FC Nords,3532,4,13,8,9,68,50,18,47
AC Horsens,3532,5,7,13,10,37,53,-16,34
AaB,3532,6,7,12,11,35,43,-8,33
Sonderjyske,3532,7,8,6,10,28,29,-1,30
Randers FC,3532,8,6,6,12,28,42,-14,24
AGF Aarhus,3532,9,5,6,11,18,36,-18,21
Lyngby,3532,10,3,9,12,29,49,-20,18
Silkeborg IF,3532,11,5,3,14,25,46,-21,18
Brondby,3533,1,21,6,3,72,32,40,69
FC Midtjylla,3533,2,21,4,5,66,35,31,67
FC Nords,3533,3,15,7,8,78,50,28,52
Copenhagen,3533,4,14,5,11,60,48,12,47
AaB,3533,5,6,13,11,36,47,-11,31
Sonderjyske,3533,6,8,6,10,28,29,-1,30
AC Horsens,3533,7,5,13,12,34,60,-26,28
Randers FC,3533,8,6,6,12,24,39,-15,24
Silkeborg IF,3533,9,6,3,13,28,44,-16,21
Lyngby,3533,10,3,9,12,26,45,-19,18
AGF Aarhus,3533,11,4,6,12,16,39,-23,18
Brondby,3534,1,21,5,4,70,32,38,68
FC Midtjylla,3534,2,19,5,6,64,40,24,62
Copenhagen,3534,3,15,4,11,57,42,15,49
FC Nords,3534,4,14,6,10,71,54,17,48
AaB,3534,5,9,12,9,39,41,-2,39
Sonderjyske,3534,6,8,6,10,28,29,-1,30
AC Horsens,3534,7,6,12,12,36,54,-18,30
Randers FC,3534,8,6,6,12,26,40,-14,24
AGF Aarhus,3534,9,5,6,11,17,36,-19,21
Lyngby,3534,10,3,9,12,27,47,-20,18
Silkeborg IF,3534,11,5,3,14,25,45,-20,18
Brondby,3535,1,21,6,3,75,32,43,69
FC Midtjylla,3535,2,18,6,6,64,45,19,60
FC Nords,3535,3,13,9,8,71,49,22,48
Copenhagen,3535,4,13,6,11,57,46,11,45
AC Horsens,3535,5,8,13,9,38,50,-12,37
AaB,3535,6,7,12,11,38,47,-9,33
Sonderjyske,3535,7,8,6,10,28,29,-1,30
Silkeborg IF,3535,8,6,3,13,29,45,-16,21
Lyngby,3535,9,4,9,11,28,44,-16,21
Randers FC,3535,10,5,6,13,23,41,-18,21
AGF Aarhus,3535,11,4,6,12,17,40,-23,18
Brondby,3536,1,20,6,4,74,36,38,66
FC Midtjylla,3536,2,19,4,7,67,42,25,61
FC Nords,3536,3,16,6,8,74,54,20,54
Copenhagen,3536,4,14,6,10,61,45,16,48
AaB,3536,5,7,13,10,34,39,-5,34
AC Horsens,3536,6,6,13,11,38,58,-20,31
Sonderjyske,3536,7,8,6,10,28,29,-1,30
Randers FC,3536,8,6,6,12,25,39,-14,24
Silkeborg IF,3536,9,6,3,13,27,44,-17,21
Lyngby,3536,10,3,9,12,26,46,-20,18
AGF Aarhus,3536,11,4,6,12,16,38,-22,18
Brondby,3537,1,19,6,5,73,37,36,63
FC Midtjylla,3537,2,19,6,5,67,40,27,63
Copenhagen,3537,3,15,5,10,60,49,11,50
FC Nords,3537,4,12,9,9,74,56,18,45
AaB,3537,5,7,14,9,42,46,-4,35
AC Horsens,3537,6,7,14,9,39,53,-14,35
Sonderjyske,3537,7,8,6,10,28,29,-1,30
Randers FC,3537,8,6,6,12,26,41,-15,24
Silkeborg IF,3537,9,5,4,13,25,44,-19,19
AGF Aarhus,3537,10,4,7,11,16,36,-20,19
Lyngby,3537,11,3,9,12,28,47,-19,18
Brondby,3538,1,20,6,4,70,35,35,66
FC Midtjylla,3538,2,20,5,5,66,38,28,65
FC Nords,3538,3,13,7,10,71,54,17,46
Copenhagen,3538,4,13,6,11,57,44,13,45
AC Horsens,3538,5,9,12,9,38,49,-11,39
AaB,3538,6,7,12,11,36,44,-8,33
Sonderjyske,3538,7,8,6,10,28,29,-1,30
Lyngby,3538,8,4,9,11,28,44,-16,21
Silkeborg IF,3538,8,6,3,13,28,44,-16,21
Randers FC,3538,10,5,6,13,23,41,-18,21
AGF Aarhus,3538,11,4,6,12,16,39,-23,18
Brondby,3539,1,20,8,2,69,30,39,68
FC Midtjylla,3539,2,18,5,7,65,44,21,59
FC Nords,3539,3,14,7,9,72,51,21,49
Copenhagen,3539,4,13,7,10,58,45,13,46
AC Horsens,3539,5,7,15,8,38,50,-12,36
AaB,3539,6,7,12,11,37,45,-8,33
Sonderjyske,3539,7,8,6,10,28,29,-1,30
Randers FC,3539,8,5,7,12,26,42,-16,22
Silkeborg IF,3539,9,6,3,13,27,44,-17,21
Lyngby,3539,10,3,10,11,29,47,-18,19
AGF Aarhus,3539,11,4,6,12,16,38,-22,18
Brondby,3540,1,20,8,2,74,34,40,68
FC Midtjylla,3540,2,20,5,5,68,40,28,65
FC Nords,3540,3,14,7,9,75,54,21,49
Copenhagen,3540,4,14,5,11,59,47,12,47
AC Horsens,3540,5,7,12,11,34,54,-20,33
AaB,3540,6,7,11,12,36,43,-7,32
Sonderjyske,3540,7,8,6,10,28,29,-1,30
Randers FC,3540,8,5,7,12,24,40,-16,22
AGF Aarhus,3540,9,5,6,11,18,36,-18,21
Lyngby,3540,10,3,10,11,27,45,-18,19
Silkeborg IF,3540,11,5,3,14,25,46,-21,18
Brondby,3541,1,22,6,2,77,32,45,72
FC Midtjylla,3541,2,20,5,5,67,37,30,65
FC Nords,3541,3,13,7,10,72,56,16,46
Copenhagen,3541,4,14,4,12,58,48,10,46
AaB,3541,5,7,13,10,37,44,-7,34
AC Horsens,3541,6,6,13,11,35,55,-20,31
Sonderjyske,3541,7,8,6,10,28,29,-1,30
Randers FC,3541,8,5,7,12,25,41,-16,22
Lyngby,3541,9,3,10,11,28,46,-18,19
Silkeborg IF,3541,10,5,4,13,26,45,-19,19
AGF Aarhus,3541,11,4,7,11,17,37,-20,19
Brondby,3542,1,21,7,2,73,31,42,70
FC Midtjylla,3542,2,20,5,5,69,39,30,65
FC Nords,3542,3,13,7,10,74,56,18,46
Copenhagen,3542,4,13,5,12,61,48,13,44
AaB,3542,5,8,12,10,39,45,-6,36
AC Horsens,3542,6,7,12,11,38,61,-23,33
Sonderjyske,3542,7,8,6,10,28,29,-1,30
Randers FC,3542,8,6,6,12,26,40,-14,24
AGF Aarhus,3542,9,5,6,11,20,37,-17,21
Lyngby,3542,10,3,9,12,27,47,-20,18
Silkeborg IF,3542,11,5,3,14,26,48,-22,18
FC Midtjylla,3543,1,21,5,4,65,34,31,68
Brondby,3543,2,19,6,5,70,36,34,63
Copenhagen,3543,3,14,5,11,56,48,8,47
FC Nords,3543,4,12,9,9,70,51,19,45
AaB,3543,5,8,13,9,42,42,0,37
AC Horsens,3543,6,6,14,10,35,53,-18,32
Sonderjyske,3543,7,8,6,10,28,29,-1,30
Randers FC,3543,8,6,6,12,25,40,-15,24
Silkeborg IF,3543,9,6,3,13,26,44,-18,21
Lyngby,3543,10,3,9,12,27,46,-19,18
AGF Aarhus,3543,11,4,6,12,16,37,-21,18
FC Midtjylla,3544,1,21,4,5,64,36,28,67
Brondby,3544,2,20,6,4,70,31,39,66
FC Nords,3544,3,14,7,9,74,55,19,49
Copenhagen,3544,4,15,4,11,57,45,12,49
AC Horsens,3544,5,6,14,10,34,50,-16,32
AaB,3544,6,6,13,11,34,42,-8,31
Sonderjyske,3544,7,8,6,10,28,29,-1,30
Lyngby,3544,8,4,9,11,29,46,-17,21
Randers FC,3544,9,5,6,13,25,42,-17,21
Silkeborg IF,3544,10,5,4,13,26,45,-19,19
AGF Aarhus,3544,11,4,7,11,17,37,-20,19
FC Midtjylla,3545,1,21,4,5,70,40,30,67
Brondby,3545,2,19,5,6,71,38,33,62
FC Nords,3545,3,13,8,9,73,53,20,47
Copenhagen,3545,4,13,6,11,55,43,12,45
AaB,3545,5,8,14,8,40,42,-2,38
AC Horsens,3545,6,7,13,10,36,55,-19,34
Sonderjyske,3545,7,8,6,10,28,29,-1,30
Randers FC,3545,8,6,6,12,25,40,-15,24
Silkeborg IF,3545,9,6,3,13,28,45,-17,21
Lyngby,3545,10,3,9,12,27,46,-19,18
AGF Aarhus,3545,11,4,6,12,17,39,-22,18
Brondby,3546,1,22,5,3,72,33,39,71
FC Midtjylla,3546,2,21,4,5,72,39,33,67
FC Nords,3546,3,14,8,8,75,52,23,50
Copenhagen,3546,4,13,6,11,53,43,10,45
AaB,3546,5,7,13,10,39,44,-5,34
Sonderjyske,3546,6,8,6,10,28,29,-1,30
AC Horsens,3546,7,5,12,13,32,58,-26,27
Randers FC,3546,8,6,6,12,25,39,-14,24
Silkeborg IF,3546,9,5,4,13,26,45,-19,19
AGF Aarhus,3546,10,4,7,11,17,37,-20,19
Lyngby,3546,11,3,9,12,26,46,-20,18
Brondby,3547,1,21,6,3,73,30,43,69
FC Midtjylla,3547,2,19,4,7,64,42,22,61
Copenhagen,3547,3,16,4,10,61,42,19,52
FC Nords,3547,4,14,6,10,70,49,21,48
AaB,3547,5,8,11,11,37,45,-8,35
AC Horsens,3547,6,6,13,11,32,55,-23,31
Sonderjyske,3547,7,8,6,10,28,29,-1,30
Lyngby,3547,8,4,9,11,28,45,-17,21
Randers FC,3547,9,5,6,13,24,41,-17,21
AGF Aarhus,3547,10,5,6,11,17,36,-19,21
Silkeborg IF,3547,11,5,3,14,25,45,-20,18
Brondby,3548,1,23,5,2,73,27,46,74
FC Midtjylla,3548,2,20,4,6,64,40,24,64
FC Nords,3548,3,14,7,9,77,52,25,49
Copenhagen,3548,4,14,5,11,58,44,14,47
AaB,3548,5,7,11,12,34,44,-10,32
Sonderjyske,3548,6,8,6,10,28,29,-1,30
AC Horsens,3548,7,6,12,12,32,57,-25,30
Randers FC,3548,8,6,6,12,26,40,-14,24
Silkeborg IF,3548,9,6,3,13,29,45,-16,21
Lyngby,3548,10,3,9,12,27,47,-20,18
AGF Aarhus,3548,11,4,6,12,17,40,-23,18
Brondby,3549,1,20,6,4,72,31,41,66
FC Midtjylla,3549,2,20,4,6,68,45,23,64
Copenhagen,3549,3,15,5,10,56,42,14,50
FC Nords,3549,4,14,6,10,71,52,19,48
AaB,3549,5,10,11,9,40,41,-1,41
Sonderjyske,3549,6,8,6,10,28,29,-1,30
AC Horsens,3549,7,5,12,13,32,54,-22,27
Randers FC,3549,8,6,6,12,24,39,-15,24
Silkeborg IF,3549,9,5,4,13,25,44,-19,19
AGF Aarhus,3549,10,4,7,11,16,36,-20,19
Lyngby,3549,11,3,9,12,26,45,-19,18
Brondby,3550,1,21,5,4,74,36,38,68
FC Midtjylla,3550,2,20,4,6,66,38,28,64
FC Nords,3550,3,15,7,8,76,55,21,52
Copenhagen,3550,4,13,4,13,54,45,9,43
AaB,3550,5,8,13,9,40,44,-4,37
AC Horsens,3550,6,6,13,11,36,54,-18,31
Sonderjyske,3550,7,8,6,10,28,29,-1,30
Lyngby,3550,8,4,9,11,29,45,-16,21
Randers FC,3550,9,5,6,13,24,42,-18,21
AGF Aarhus,3550,10,5,6,11,18,37,-19,21
Silkeborg IF,3550,11,5,3,14,26,46,-20,18
Brondby,3551,1,20,6,4,68,33,35,66
FC Midtjylla,3551,2,20,5,5,67,38,29,65
Copenhagen,3551,3,15,4,11,60,44,16,49
FC Nords,3551,4,12,7,11,68,55,13,43
AC Horsens,3551,5,8,13,9,37,51,-14,37
AaB,3551,6,8,11,11,37,42,-5,35
Sonderjyske,3551,7,8,6,10,28,29,-1,30
Randers FC,3551,8,6,6,12,26,39,-13,24
Silkeborg IF,3551,9,6,3,13,27,44,-17,21
Lyngby,3551,10,3,9,12,26,47,-21,18
AGF Aarhus,3551,11,4,6,12,16,38,-22,18
Brondby,3552,1,20,8,2,71,33,38,68
FC Midtjylla,3552,2,19,7,4,65,38,27,64
FC Nords,3552,3,15,8,7,78,50,28,53
Copenhagen,3552,4,13,5,12,55,49,6,44
AaB,3552,5,7,13,10,34,39,-5,34
Sonderjyske,3552,6,8,6,10,28,29,-1,30
AC Horsens,3552,7,5,13,12,32,52,-20,28
Lyngby,3552,8,4,9,11,28,44,-16,21
Silkeborg IF,3552,9,6,3,13,26,44,-18,21
Randers FC,3552,10,5,6,13,23,41,-18,21
AGF Aarhus,3552,11,4,6,12,16,37,-21,18
FC Midtjylla,3553,1,19,6,5,66,39,27,63
Brondby,3553,2,18,7,5,67,36,31,61
FC Nords,3553,3,15,7,8,74,49,25,52
Copenhagen,3553,4,16,4,10,57,39,18,52
AC Horsens,3553,5,7,14,9,37,50,-13,35
Sonderjyske,3553,6,8,6,10,28,29,-1,30
AaB,3553,7,6,12,12,34,48,-14,30
Lyngby,3553,8,4,9,11,27,44,-17,21
Randers FC,3553,9,5,6,13,23,40,-17,21
AGF Aarhus,3553,10,5,6,11,20,37,-17,21
Silkeborg IF,3553,11,5,3,14,26,48,-22,18
Brondby,3554,1,20,7,3,69,32,37,67
FC Midtjylla,3554,2,20,5,5,67,39,28,65
FC Nords,3554,3,13,8,9,73,58,15,47
Copenhagen,3554,4,14,5,11,62,47,15,47
AaB,3554,5,8,11,11,38,42,-4,35
AC Horsens,3554,6,7,12,11,36,53,-17,33
Sonderjyske,3554,7,8,6,10,28,29,-1,30
Randers FC,3554,8,6,6,12,24,39,-15,24
Silkeborg IF,3554,9,6,3,13,28,46,-18,21
Lyngby,3554,10,3,9,12,26,45,-19,18
AGF Aarhus,3554,11,4,6,12,18,39,-21,18
Brondby,3555,1,20,5,5,71,35,36,65
FC Midtjylla,3555,2,19,6,5,67,39,28,63
FC Nords,3555,3,16,6,8,78,50,28,54
Copenhagen,3555,4,15,4,11,60,45,15,49
AaB,3555,5,8,12,10,36,42,-6,36
Sonderjyske,3555,6,8,6,10,28,29,-1,30
AC Horsens,3555,7,5,13,12,34,61,-27,28
Randers FC,3555,8,5,7,12,23,39,-16,22
Silkeborg IF,3555,9,6,3,13,27,45,-18,21
Lyngby,3555,10,3,10,11,26,44,-18,19
AGF Aarhus,3555,11,4,6,12,17,38,-21,18
Brondby,3556,1,20,6,4,72,37,35,66
FC Midtjylla,3556,2,20,5,5,67,39,28,65
FC Nords,3556,3,15,7,8,75,51,24,52
Copenhagen,3556,4,12,5,13,56,51,5,41
AC Horsens,3556,5,8,12,10,37,49,-12,36
AaB,3556,6,8,11,11,42,48,-6,35
Sonderjyske,3556,7,8,6,10,28,29,-1,30
Randers FC,3556,8,5,7,12,23,39,-16,22
Lyngby,3556,9,3,10,11,26,44,-18,19
Silkeborg IF,3556,10,5,4,13,27,46,-19,19
AGF Aarhus,3556,11,4,7,11,18,38,-20,19
Brondby,3557,1,21,6,3,73,33,40,69
FC Midtjylla,3557,2,19,5,6,68,40,28,62
Copenhagen,3557,3,14,7,9,61,45,16,49
FC Nords,3557,4,13,8,9,71,52,19,47
AaB,3557,5,7,13,10,38,44,-6,34
AC Horsens,3557,6,6,13,11,31,54,-23,31
Sonderjyske,3557,7,8,6,10,28,29,-1,30
Randers FC,3557,8,5,7,12,24,40,-16,22
AGF Aarhus,3557,9,5,6,11,19,37,-18,21
Lyngby,3557,10,3,10,11,27,45,-18,19
Silkeborg IF,3557,11,5,3,14,26,47,-21,18
Brondby,3558,1,23,5,2,79,29,50,74
FC Midtjylla,3558,2,19,6,5,66,42,24,63
FC Nords,3558,3,14,7,9,76,57,19,49
Copenhagen,3558,4,12,5,13,54,49,5,41
AaB,3558,5,9,11,10,41,44,-3,38
Sonderjyske,3558,6,8,6,10,28,29,-1,30
AC Horsens,3558,7,6,12,12,32,53,-21,30
Randers FC,3558,8,5,7,12,24,40,-16,22
AGF Aarhus,3558,9,5,6,11,18,37,-19,21
Lyngby,3558,10,3,10,11,27,45,-18,19
Silkeborg IF,3558,11,5,3,14,26,46,-20,18
Brondby,3559,1,22,5,3,69,34,35,71
FC Midtjylla,3559,2,20,5,5,67,38,29,65
FC Nords,3559,3,14,7,9,71,50,21,49
Copenhagen,3559,4,14,5,11,62,46,16,47
AaB,3559,5,8,12,10,37,40,-3,36
Sonderjyske,3559,6,8,6,10,28,29,-1,30
AC Horsens,3559,7,5,12,13,32,56,-24,27
Lyngby,3559,8,4,9,11,29,45,-16,21
Randers FC,3559,9,5,6,13,24,42,-18,21
Silkeborg IF,3559,10,5,4,13,26,45,-19,19
AGF Aarhus,3559,11,4,7,11,17,37,-20,19
Brondby,3560,1,21,7,2,75,33,42,70
FC Midtjylla,3560,2,18,6,6,65,43,22,60
FC Nords,3560,3,15,6,9,78,54,24,51
Copenhagen,3560,4,14,5,11,60,50,10,47
AaB,3560,5,7,12,11,41,47,-6,33
AC Horsens,3560,6,5,16,9,38,56,-18,31
Sonderjyske,3560,7,8,6,10,28,29,-1,30
Lyngby,3560,8,4,9,11,32,45,-13,21
Randers FC,3560,9,5,6,13,24,45,-21,21
Silkeborg IF,3560,10,5,4,13,27,46,-19,19
AGF Aarhus,3560,11,4,7,11,18,38,-20,19
Brondby,3561,1,21,7,2,74,35,39,70
FC Midtjylla,3561,2,20,4,6,66,42,24,64
FC Nords,3561,3,14,7,9,74,54,20,49
Copenhagen,3561,4,12,7,11,55,44,11,43
AaB,3561,5,8,11,11,40,44,-4,35
AC Horsens,3561,6,6,14,10,34,50,-16,32
Sonderjyske,3561,7,8,6,10,28,29,-1,30
Lyngby,3561,8,4,9,11,27,44,-17,21
Randers FC,3561,9,5,6,13,23,40,-17,21
Silkeborg IF,3561,10,6,3,13,26,44,-18,21
AGF Aarhus,3561,11,4,6,12,16,37,-21,18
Brondby,3562,1,23,5,2,74,28,46,74
FC Midtjylla,3562,2,18,5,7,62,45,17,59
FC Nords,3562,3,13,8,9,74,54,20,47
Copenhagen,3562,4,14,4,12,61,47,14,46
AaB,3562,5,7,13,10,33,41,-8,34
AC Horsens,3562,6,7,13,10,36,51,-15,34
Sonderjyske,3562,7,8,6,10,28,29,-1,30
Randers FC,3562,8,5,7,12,23,39,-16,22
AGF Aarhus,3562,9,5,6,11,17,36,-19,21
Lyngby,3562,10,3,10,11,26,44,-18,19
Silkeborg IF,3562,11,5,3,14,25,45,-20,18
Brondby,3563,1,21,6,3,68,30,38,69
FC Midtjylla,3563,2,21,5,4,72,36,36,68
FC Nords,3563,3,13,8,9,69,54,15,47
Copenhagen,3563,4,14,4,12,60,46,14,46
AaB,3563,5,8,12,10,39,40,-1,36
Sonderjyske,3563,6,8,6,10,28,29,-1,30
AC Horsens,3563,7,5,13,12,32,60,-28,28
Randers FC,3563,8,6,6,12,25,39,-14,24
Silkeborg IF,3563,9,6,3,13,27,45,-18,21
Lyngby,3563,10,3,9,12,26,46,-20,18
AGF Aarhus,3563,11,4,6,12,17,38,-21,18
Brondby,3564,1,21,7,2,69,30,39,70
FC Midtjylla,3564,2,19,5,6,64,40,24,62
FC Nords,3564,3,14,7,9,72,49,23,49
Copenhagen,3564,4,12,7,11,54,43,11,43
AC Horsens,3564,5,9,12,9,34,46,-12,39
Sonderjyske,3564,6,8,6,10,28,29,-1,30
AaB,3564,7,6,12,12,35,46,-11,30
Lyngby,3564,8,4,9,11,27,44,-17,21
Randers FC,3564,9,5,6,13,23,40,-17,21
AGF Aarhus,3564,10,5,6,11,19,36,-17,21
Silkeborg IF,3564,11,5,3,14,25,47,-22,18
Brondby,3565,1,20,6,4,69,32,37,66
FC Midtjylla,3565,2,19,6,5,65,38,27,63
Copenhagen,3565,3,16,4,10,62,45,17,52
FC Nords,3565,4,14,6,10,73,55,18,48
AaB,3565,5,7,12,11,37,44,-7,33
AC Horsens,3565,6,6,14,10,36,54,-18,32
Sonderjyske,3565,7,8,6,10,28,29,-1,30
Randers FC,3565,8,5,7,12,25,41,-16,22
Silkeborg IF,3565,9,6,3,13,26,44,-18,21
Lyngby,3565,10,3,10,11,28,46,-18,19
AGF Aarhus,3565,11,4,6,12,16,37,-21,18
Brondby,3566,1,20,6,4,68,35,33,66
FC Midtjylla,3566,2,18,6,6,65,40,25,60
FC Nords,3566,3,14,8,8,73,48,25,50
Copenhagen,3566,4,14,6,10,56,44,12,48
AaB,3566,5,8,12,10,36,41,-5,36
AC Horsens,3566,6,6,14,10,38,54,-16,32
Sonderjyske,3566,7,8,6,10,28,29,-1,30
Randers FC,3566,8,6,6,12,25,40,-15,24
Silkeborg IF,3566,9,5,4,13,26,45,-19,19
AGF Aarhus,3566,10,4,7,11,17,37,-20,19
Lyngby,3566,11,3,9,12,27,46,-19,18
Brondby,3567,1,20,5,5,66,35,31,65
FC Midtjylla,3567,2,20,5,5,64,34,30,65
Copenhagen,3567,3,15,5,10,60,43,17,50
FC Nords,3567,4,12,7,11,67,54,13,43
AaB,3567,5,10,11,9,40,39,1,41
AC Horsens,3567,6,6,13,11,34,52,-18,31
Sonderjyske,3567,7,8,6,10,28,29,-1,30
Lyngby,3567,8,4,9,11,27,44,-17,21
Randers FC,3567,9,5,6,13,23,40,-17,21
Silkeborg IF,3567,10,6,3,13,27,45,-18,21
AGF Aarhus,3567,11,4,6,12,17,38,-21,18
Brondby,3568,1,20,7,3,71,33,38,67
FC Midtjylla,3568,2,19,5,6,61,37,24,62
FC Nords,3568,3,14,8,8,70,49,21,50
Copenhagen,3568,4,13,7,10,54,42,12,46
AaB,3568,5,7,13,10,36,41,-5,34
AC Horsens,3568,6,6,14,10,36,52,-16,32
Sonderjyske,3568,7,8,6,10,28,29,-1,30
Randers FC,3568,8,5,7,12,24,40,-16,22
AGF Aarhus,3568,9,5,6,11,17,36,-19,21
Lyngby,3568,10,3,10,11,27,45,-18,19
Silkeborg IF,3568,11,5,3,14,25,45,-20,18
FC Midtjylla,3569,1,20,5,5,70,42,28,65
Brondby,3569,2,19,5,6,66,32,34,62
FC Nords,3569,3,15,6,9,73,53,20,51
Copenhagen,3569,4,14,6,10,61,43,18,48
AaB,3569,5,8,11,11,34,44,-10,35
AC Horsens,3569,6,7,13,10,36,52,-16,34
Sonderjyske,3569,7,8,6,10,28,29,-1,30
Randers FC,3569,8,6,6,12,24,39,-15,24
Silkeborg IF,3569,9,5,4,13,26,45,-19,19
AGF Aarhus,3569,10,4,7,11,17,37,-20,19
Lyngby,3569,11,3,9,12,26,45,-19,18
Brondby,3570,1,23,5,2,75,28,47,74
FC Midtjylla,3570,2,20,4,6,67,42,25,64
Copenhagen,3570,3,15,5,10,62,43,19,50
FC Nords,3570,4,13,7,10,68,51,17,46
AaB,3570,5,6,14,10,35,46,-11,32
Sonderjyske,3570,6,8,6,10,28,29,-1,30
AC Horsens,3570,7,5,13,12,32,55,-23,28
Randers FC,3570,8,5,7,12,25,41,-16,22
Lyngby,3570,9,3,10,11,28,46,-18,19
Silkeborg IF,3570,10,5,4,13,25,44,-19,19
AGF Aarhus,3570,11,4,7,11,16,36,-20,19
Brondby,3571,1,22,5,3,72,29,43,71
FC Midtjylla,3571,2,21,4,5,68,38,30,67
FC Nords,3571,3,15,7,8,76,53,23,52
Copenhagen,3571,4,12,6,12,52,42,10,42
AC Horsens,3571,5,6,14,10,37,55,-18,32
Sonderjyske,3571,6,8,6,10,28,29,-1,30
AaB,3571,7,6,12,12,33,47,-14,30
Lyngby,3571,8,4,9,11,29,45,-16,21
Silkeborg IF,3571,9,6,3,13,28,45,-17,21
Randers FC,3571,10,5,6,13,24,42,-18,21
AGF Aarhus,3571,11,4,6,12,17,39,-22,18
FC Midtjylla,3572,1,22,4,4,67,35,32,70
Brondby,3572,2,21,6,3,70,33,37,69
FC Nords,3572,3,15,6,9,78,52,26,51
Copenhagen,3572,4,14,4,12,57,45,12,46
Sonderjyske,3572,5,8,6,10,28,29,-1,30
AaB,3572,6,6,12,12,34,48,-14,30
AC Horsens,3572,7,6,12,12,33,52,-19,30
Randers FC,3572,8,5,7,12,24,40,-16,22
AGF Aarhus,3572,9,5,6,11,18,36,-18,21
Lyngby,3572,10,3,10,11,27,45,-18,19
Silkeborg IF,3572,11,5,3,14,25,46,-21,18
Brondby,3573,1,21,7,2,72,32,40,70
FC Midtjylla,3573,2,19,5,6,66,42,24,62
FC Nords,3573,3,15,7,8,76,53,23,52
Copenhagen,3573,4,13,6,11,56,45,11,45
AaB,3573,5,7,12,11,35,41,-6,33
Sonderjyske,3573,6,8,6,10,28,29,-1,30
AC Horsens,3573,7,5,15,10,34,52,-18,30
Lyngby,3573,8,4,9,11,27,44,-17,21
Randers FC,3573,9,5,6,13,23,40,-17,21
Silkeborg IF,3573,10,5,4,13,28,47,-19,19
AGF Aarhus,3573,11,4,7,11,19,39,-20,19
FC Midtjylla,3574,1,20,4,6,64,37,27,64
Brondby,3574,2,19,6,5,68,35,33,63
Copenhagen,3574,3,16,4,10,56,40,16,52
FC Nords,3574,4,13,8,9,69,50,19,47
AaB,3574,5,8,11,11,36,43,-7,35
AC Horsens,3574,6,7,13,10,35,49,-14,34
Sonderjyske,3574,7,8,6,10,28,29,-1,30
Randers FC,3574,8,6,6,12,24,39,-15,24
AGF Aarhus,3574,9,5,6,11,17,36,-19,21
Lyngby,3574,10,3,9,12,26,45,-19,18
Silkeborg IF,3574,11,5,3,14,25,45,-20,18
Brondby,3575,1,21,6,3,70,31,39,69
FC Midtjylla,3575,2,18,5,7,61,44,17,59
FC Nords,3575,3,15,7,8,77,53,24,52
Copenhagen,3575,4,14,4,12,57,44,13,46
AaB,3575,5,8,12,10,40,43,-3,36
AC Horsens,3575,6,7,12,11,34,50,-16,33
Sonderjyske,3575,7,8,6,10,28,29,-1,30
Randers FC,3575,8,6,6,12,26,40,-14,24
Silkeborg IF,3575,9,5,4,13,26,45,-19,19
AGF Aarhus,3575,10,4,7,11,17,37,-20,19
Lyngby,3575,11,3,9,12,27,47,-20,18
Brondby,3576,1,20,5,5,72,37,35,65
FC Midtjylla,3576,2,20,5,5,68,42,26,65
FC Nords,3576,3,15,7,8,73,50,23,52
Copenhagen,3576,4,13,4,13,62,54,8,43
AC Horsens,3576,5,8,12,10,41,55,-14,36
AaB,3576,6,8,11,11,37,41,-4,35
Sonderjyske,3576,7,8,6,10,28,29,-1,30
Lyngby,3576,8,4,9,11,29,44,-15,21
Randers FC,3576,9,5,6,13,23,42,-19,21
AGF Aarhus,3576,10,5,6,11,18,37,-19,21
Silkeborg IF,3576,11,5,3,14,26,46,-20,18
Brondby,3577,1,21,5,4,72,31,41,68
FC Midtjylla,3577,2,21,5,4,68,38,30,68
Copenhagen,3577,3,15,4,11,55,41,14,49
FC Nords,3577,4,14,6,10,70,52,18,48
AaB,3577,5,7,11,12,32,44,-12,32
AC Horsens,3577,6,6,13,11,34,51,-17,31
Sonderjyske,3577,7,8,6,10,28,29,-1,30
Lyngby,3577,8,4,9,11,27,44,-17,21
Silkeborg IF,3577,8,6,3,13,27,44,-17,21
Randers FC,3577,10,5,6,13,23,40,-17,21
AGF Aarhus,3577,11,4,6,12,16,38,-22,18
Brondby,3578,1,21,6,3,74,33,41,69
FC Midtjylla,3578,2,18,6,6,63,38,25,60
FC Nords,3578,3,16,6,8,77,50,27,54
Copenhagen,3578,4,14,4,12,54,48,6,46
AaB,3578,5,8,11,11,34,42,-8,35
AC Horsens,3578,6,6,13,11,32,49,-17,31
Sonderjyske,3578,7,8,6,10,28,29,-1,30
Randers FC,3578,8,6,6,12,24,39,-15,24
Silkeborg IF,3578,9,5,4,13,26,45,-19,19
AGF Aarhus,3578,10,4,7,11,17,37,-20,19
Lyngby,3578,11,3,9,12,26,45,-19,18
Brondby,3579,1,23,5,2,76,30,46,74
FC Midtjylla,3579,2,19,5,6,65,40,25,62
Copenhagen,3579,3,16,4,10,59,44,15,52
FC Nords,3579,4,13,7,10,77,59,18,46
AaB,3579,5,7,12,11,37,43,-6,33
Sonderjyske,3579,6,8,6,10,28,29,-1,30
AC Horsens,3579,7,5,13,12,36,60,-24,28
Randers FC,3579,8,6,6,12,25,39,-14,24
Silkeborg IF,3579,9,5,4,13,25,44,-19,19
AGF Aarhus,3579,10,4,7,11,16,36,-20,19
Lyngby,3579,11,3,9,12,26,46,-20,18
Brondby,3580,1,19,6,5,72,39,33,63
FC Midtjylla,3580,2,19,6,5,64,40,24,63
Copenhagen,3580,3,14,7,9,59,43,16,49
FC Nords,3580,4,12,9,9,75,57,18,45
AaB,3580,5,7,15,8,35,38,-3,36
AC Horsens,3580,6,6,15,9,36,50,-14,33
Sonderjyske,3580,7,8,6,10,28,29,-1,30
Lyngby,3580,8,4,9,11,30,44,-14,21
Silkeborg IF,3580,9,6,3,13,27,44,-17,21
Randers FC,3580,10,5,6,13,23,43,-20,21
AGF Aarhus,3580,11,4,6,12,16,38,-22,18
Brondby,3581,1,20,7,3,76,34,42,67
FC Midtjylla,3581,2,20,6,4,64,37,27,66
FC Nords,3581,3,14,6,10,76,55,21,48
Copenhagen,3581,4,14,6,10,60,44,16,48
AaB,3581,5,7,12,11,38,44,-6,33
AC Horsens,3581,6,6,13,11,34,60,-26,31
Sonderjyske,3581,7,8,6,10,28,29,-1,30
Randers FC,3581,8,5,7,12,25,41,-16,22
Silkeborg IF,3581,9,6,3,13,26,44,-18,21
Lyngby,3581,10,3,10,11,28,46,-18,19
AGF Aarhus,3581,11,4,6,12,16,37,-21,18
Brondby,3582,1,22,5,3,70,28,42,71
FC Midtjylla,3582,2,18,6,6,61,40,21,60
FC Nords,3582,3,15,7,8,72,51,21,52
Copenhagen,3582,4,12,6,12,52,43,9,42
AaB,3582,5,9,11,10,38,39,-1,38
AC Horsens,3582,6,6,13,11,36,54,-18,31
Sonderjyske,3582,7,8,6,10,28,29,-1,30
Randers FC,3582,8,6,6,12,27,39,-12,24
Silkeborg IF,3582,9,6,3,13,29,47,-18,21
AGF Aarhus,3582,10,4,6,12,19,40,-21,18
Lyngby,3582,11,3,9,12,26,48,-22,18
Brondby,3583,1,19,7,4,67,34,33,64
FC Midtjylla,3583,2,18,4,8,62,42,20,58
FC Nords,3583,3,15,7,8,72,48,24,52
Copenhagen,3583,4,14,6,10,58,44,14,48
AC Horsens,3583,5,8,13,9,39,51,-12,37
AaB,3583,6,8,11,11,38,43,-5,35
Sonderjyske,3583,7,8,6,10,28,29,-1,30
Lyngby,3583,8,4,9,11,28,45,-17,21
Randers FC,3583,9,5,6,13,24,41,-17,21
Silkeborg IF,3583,10,5,4,13,26,45,-19,19
AGF Aarhus,3583,11,4,7,11,17,37,-20,19
Brondby,3584,1,21,6,3,71,32,39,69
FC Midtjylla,3584,2,20,5,5,66,40,26,65
Copenhagen,3584,3,15,4,11,57,43,14,49
FC Nords,3584,4,13,7,10,70,53,17,46
AC Horsens,3584,5,7,13,10,35,49,-14,34
AaB,3584,6,7,11,12,34,42,-8,32
Sonderjyske,3584,7,8,6,10,28,29,-1,30
Randers FC,3584,8,6,6,12,25,40,-15,24
AGF Aarhus,3584,9,5,6,11,19,36,-17,21
Lyngby,3584,10,3,9,12,27,46,-19,18
Silkeborg IF,3584,11,5,3,14,25,47,-22,18
Brondby,3585,1,21,7,2,74,29,45,70
FC Midtjylla,3585,2,19,4,7,64,41,23,61
FC Nords,3585,3,14,8,8,69,50,19,50
Copenhagen,3585,4,14,5,11,58,43,15,47
AC Horsens,3585,5,7,14,9,36,52,-16,35
Sonderjyske,3585,6,8,6,10,28,29,-1,30
AaB,3585,7,6,12,12,34,46,-12,30
Lyngby,3585,8,4,9,11,27,44,-17,21
Randers FC,3585,9,5,6,13,23,40,-17,21
Silkeborg IF,3585,10,5,4,13,28,47,-19,19
AGF Aarhus,3585,11,4,7,11,19,39,-20,19
Brondby,3586,1,20,7,3,72,32,40,67
FC Midtjylla,3586,2,20,5,5,68,39,29,65
FC Nords,3586,3,14,8,8,77,55,22,50
Copenhagen,3586,4,13,5,12,56,49,7,44
AC Horsens,3586,5,7,13,10,38,54,-16,34
AaB,3586,6,7,12,11,40,48,-8,33
Sonderjyske,3586,7,8,6,10,28,29,-1,30
Randers FC,3586,8,6,6,12,26,40,-14,24
Silkeborg IF,3586,9,5,4,13,26,45,-19,19
AGF Aarhus,3586,10,4,7,11,17,37,-20,19
Lyngby,3586,11,3,9,12,27,47,-20,18
Brondby,3587,1,22,5,3,78,34,44,71
FC Midtjylla,3587,2,20,6,4,75,39,36,66
FC Nords,3587,3,14,7,9,74,60,14,49
Copenhagen,3587,4,12,7,11,58,47,11,43
AaB,3587,5,7,14,9,38,42,-4,35
Sonderjyske,3587,6,8,6,10,28,29,-1,30
AC Horsens,3587,7,5,13,12,35,62,-27,28
Randers FC,3587,8,6,6,12,26,40,-14,24
AGF Aarhus,3587,9,5,6,11,17,36,-19,21
Lyngby,3587,10,3,9,12,27,47,-20,18
Silkeborg IF,3587,11,5,3,14,25,45,-20,18
FC Midtjylla,3588,1,21,5,4,65,35,30,68
Brondby,3588,2,20,6,4,69,32,37,66
FC Nords,3588,3,15,7,8,78,51,27,52
Copenhagen,3588,4,13,4,13,54,50,4,43
AaB,3588,5,8,13,9,39,41,-2,37
Sonderjyske,3588,6,8,6,10,28,29,-1,30
AC Horsens,3588,7,5,13,12,31,53,-22,28
Lyngby,3588,8,4,9,11,27,44,-17,21
Randers FC,3588,9,5,6,13,23,40,-17,21
AGF Aarhus,3588,10,5,6,11,19,36,-17,21
Silkeborg IF,3588,11,5,3,14,25,47,-22,18
Brondby,3589,1,22,6,2,77,31,46,72
FC Midtjylla,3589,2,18,5,7,64,43,21,59
Copenhagen,3589,3,14,5,11,59,48,11,47
FC Nords,3589,4,12,8,10,69,54,15,44
AaB,3589,5,9,12,9,38,39,-1,39
AC Horsens,3589,6,6,14,10,36,54,-18,32
Sonderjyske,3589,7,8,6,10,28,29,-1,30
Lyngby,3589,8,4,9,11,28,44,-16,21
Silkeborg IF,3589,8,6,3,13,28,44,-16,21
Randers FC,3589,10,5,6,13,23,41,-18,21
AGF Aarhus,3589,11,4,6,12,16,39,-23,18
FC Midtjylla,3590,1,22,4,4,66,34,32,70
Brondby,3590,2,20,7,3,69,29,40,67
FC Nords,3590,3,13,8,9,72,56,16,47
Copenhagen,3590,4,13,6,11,57,44,13,45
AC Horsens,3590,5,7,13,10,34,50,-16,34
Sonderjyske,3590,6,8,6,10,28,29,-1,30
AaB,3590,7,6,12,12,37,48,-11,30
Lyngby,3590,8,4,9,11,29,45,-16,21
Silkeborg IF,3590,9,6,3,13,27,44,-17,21
Randers FC,3590,10,5,6,13,24,42,-18,21
AGF Aarhus,3590,11,4,6,12,16,38,-22,18
Brondby,3591,1,20,7,3,71,31,40,67
FC Midtjylla,3591,2,19,5,6,71,43,28,62
Copenhagen,3591,3,16,4,10,60,43,17,52
FC Nords,3591,4,14,7,9,73,55,18,49
AaB,3591,5,7,12,11,35,43,-8,33
AC Horsens,3591,6,6,13,11,37,58,-21,31
Sonderjyske,3591,7,8,6,10,28,29,-1,30
Lyngby,3591,8,4,9,11,27,44,-17,21
Randers FC,3591,9,5,6,13,23,40,-17,21
Silkeborg IF,3591,10,5,4,13,26,45,-19,19
AGF Aarhus,3591,11,4,7,11,17,37,-20,19
FC Midtjylla,3592,1,22,4,4,74,34,40,70
Brondby,3592,2,21,5,4,73,35,38,68
FC Nords,3592,3,14,7,9,73,57,16,49
Copenhagen,3592,4,13,5,12,59,49,10,44
AC Horsens,3592,5,7,12,11,33,52,-19,33
AaB,3592,6,7,11,12,36,47,-11,32
Sonderjyske,3592,7,8,6,10,28,29,-1,30
Lyngby,3592,8,4,9,11,29,45,-16,21
Silkeborg IF,3592,9,6,3,13,28,45,-17,21
Randers FC,3592,10,5,6,13,24,42,-18,21
AGF Aarhus,3592,11,4,6,12,17,39,-22,18
Brondby,3593,1,22,6,2,73,31,42,72
FC Midtjylla,3593,2,19,5,6,67,40,27,62
FC Nords,3593,3,14,7,9,71,51,20,49
Copenhagen,3593,4,14,4,12,57,46,11,46
AaB,3593,5,9,11,10,39,45,-6,38
Sonderjyske,3593,6,8,6,10,28,29,-1,30
AC Horsens,3593,7,5,13,12,31,51,-20,28
Randers FC,3593,8,5,7,12,25,41,-16,22
Lyngby,3593,9,3,10,11,28,46,-18,19
Silkeborg IF,3593,10,5,4,13,25,44,-19,19
AGF Aarhus,3593,11,4,7,11,16,36,-20,19
FC Midtjylla,3594,1,21,4,5,66,35,31,67
Brondby,3594,2,19,7,4,73,36,37,64
FC Nords,3594,3,13,8,9,74,53,21,47
Copenhagen,3594,4,14,5,11,59,45,14,47
AaB,3594,5,7,13,10,37,46,-9,34
AC Horsens,3594,6,7,13,10,35,55,-20,34
Sonderjyske,3594,7,8,6,10,28,29,-1,30
Randers FC,3594,8,5,7,12,26,42,-16,22
Lyngby,3594,9,3,10,11,29,47,-18,19
Silkeborg IF,3594,10,5,4,13,26,45,-19,19
AGF Aarhus,3594,11,4,7,11,17,37,-20,19
Brondby,3595,1,20,7,3,72,36,36,67
FC Midtjylla,3595,2,18,6,6,66,43,23,60
FC Nords,3595,3,16,7,7,77,47,30,55
Copenhagen,3595,4,13,6,11,54,48,6,45
AaB,3595,5,6,14,10,33,42,-9,32
AC Horsens,3595,6,6,14,10,40,52,-12,32
Sonderjyske,3595,7,8,6,10,28,29,-1,30
Lyngby,3595,8,4,9,11,27,44,-17,21
Silkeborg IF,3595,8,6,3,13,27,44,-17,21
Randers FC,3595,10,5,6,13,23,40,-17,21
AGF Aarhus,3595,11,4,6,12,16,38,-22,18
Brondby,3596,1,20,6,4,70,33,37,66
FC Midtjylla,3596,2,19,5,6,66,42,24,62
Copenhagen,3596,3,14,7,9,59,41,18,49
FC Nords,3596,4,13,8,9,71,56,15,47
AaB,3596,5,10,11,9,42,42,0,41
Sonderjyske,3596,6,8,6,10,28,29,-1,30
AC Horsens,3596,7,5,13,12,31,51,-20,28
Lyngby,3596,8,4,9,11,30,45,-15,21
AGF Aarhus,3596,9,5,6,11,19,37,-18,21
Randers FC,3596,10,5,6,13,24,43,-19,21
Silkeborg IF,3596,11,5,3,14,26,47,-21,18
FC Midtjylla,3597,1,21,4,5,74,38,36,67
Brondby,3597,2,20,7,3,72,38,34,67
FC Nords,3597,3,15,7,8,77,51,26,52
Copenhagen,3597,4,12,6,12,57,51,6,42
AaB,3597,5,7,12,11,36,45,-9,33
AC Horsens,3597,6,7,12,11,38,57,-19,33
Sonderjyske,3597,7,8,6,10,28,29,-1,30
Lyngby,3597,8,4,9,11,28,44,-16,21
Randers FC,3597,9,5,6,13,23,41,-18,21
AGF Aarhus,3597,10,5,6,11,17,36,-19,21
Silkeborg IF,3597,11,5,3,14,25,45,-20,18
FC Midtjylla,3598,1,21,4,5,71,39,32,67
Brondby,3598,2,19,8,3,73,35,38,65
Copenhagen,3598,3,14,6,10,56,43,13,48
FC Nords,3598,4,13,7,10,71,51,20,46
AC Horsens,3598,5,7,14,9,37,54,-17,35
AaB,3598,6,7,11,12,34,46,-12,32
Sonderjyske,3598,7,8,6,10,28,29,-1,30
Lyngby,3598,8,4,9,11,28,44,-16,21
Randers FC,3598,9,5,6,13,23,41,-18,21
Silkeborg IF,3598,10,5,4,13,27,46,-19,19
AGF Aarhus,3598,11,4,7,11,18,38,-20,19
Brondby,3599,1,21,6,3,72,32,40,69
FC Midtjylla,3599,2,19,5,6,66,39,27,62
FC Nords,3599,3,15,7,8,76,52,24,52
Copenhagen,3599,4,13,6,11,58,48,10,45
AaB,3599,5,7,14,9,39,43,-4,35
Sonderjyske,3599,6,8,6,10,28,29,-1,30
AC Horsens,3599,7,6,12,12,35,58,-23,30
Randers FC,3599,8,5,7,12,24,40,-16,22
Silkeborg IF,3599,9,6,3,13,29,45,-16,21
Lyngby,3599,10,3,10,11,27,45,-18,19
AGF Aarhus,3599,11,4,6,12,17,40,-23,18
Brondby,3600,1,20,7,3,72,32,40,67
FC Midtjylla,3600,2,19,6,5,62,38,24,63
FC Nords,3600,3,14,8,8,73,49,24,50
Copenhagen,3600,4,12,5,13,56,50,6,41
AaB,3600,5,8,14,8,39,41,-2,38
AC Horsens,3600,6,6,14,10,32,50,-18,32
Sonderjyske,3600,7,8,6,10,28,29,-1,30
Randers FC,3600,8,6,6,12,25,40,-15,24
AGF Aarhus,3600,9,5,6,11,18,37,-19,21
Lyngby,3600,10,3,9,12,27,46,-19,18
Silkeborg IF,3600,11,5,3,14,26,46,-20,18
Brondby,3601,1,22,6,2,72,28,44,72
FC Midtjylla,3601,2,19,5,6,65,43,22,62
Copenhagen,3601,3,14,6,10,58,45,13,48
FC Nords,3601,4,13,7,10,75,54,21,46
AaB,3601,5,8,11,11,36,42,-6,35
Sonderjyske,3601,6,8,6,10,28,29,-1,30
AC Horsens,3601,7,5,15,10,38,58,-20,30
Lyngby,3601,8,4,9,11,27,44,-17,21
Randers FC,3601,9,5,6,13,23,40,-17,21
AGF Aarhus,3601,10,5,6,11,20,38,-18,21
Silkeborg IF,3601,11,5,3,14,27,48,-21,18
Brondby,3602,1,20,7,3,71,30,41,67
FC Midtjylla,3602,2,20,5,5,64,38,26,65
FC Nords,3602,3,14,8,8,69,48,21,50
Copenhagen,3602,4,14,7,9,60,43,17,49
AaB,3602,5,6,13,11,36,46,-10,31
Sonderjyske,3602,6,8,6,10,28,29,-1,30
AC Horsens,3602,7,5,14,11,32,53,-21,29
Lyngby,3602,8,4,9,11,28,44,-16,21
Silkeborg IF,3602,9,6,3,13,26,44,-18,21
Randers FC,3602,10,5,6,13,23,41,-18,21
AGF Aarhus,3602,11,4,6,12,16,37,-21,18
Brondby,3603,1,22,5,3,76,35,41,71
FC Midtjylla,3603,2,19,6,5,64,37,27,63
FC Nords,3603,3,13,8,9,71,53,18,47
Copenhagen,3603,4,13,7,10,55,42,13,46
AaB,3603,5,7,12,11,37,47,-10,33
AC Horsens,3603,6,6,14,10,39,54,-15,32
Sonderjyske,3603,7,8,6,10,28,29,-1,30
Randers FC,3603,8,5,7,12,24,40,-16,22
Silkeborg IF,3603,9,6,3,13,28,45,-17,21
Lyngby,3603,10,3,10,11,27,45,-18,19
AGF Aarhus,3603,11,4,6,12,17,39,-22,18
Brondby,3604,1,23,5,2,75,31,44,74
FC Midtjylla,3604,2,19,4,7,62,43,19,61
FC Nords,3604,3,15,6,9,79,50,29,51
Copenhagen,3604,4,13,5,12,56,46,10,44
AaB,3604,5,9,11,10,37,40,-3,38
Sonderjyske,3604,6,8,6,10,28,29,-1,30
AC Horsens,3604,7,5,13,12,32,57,-25,28
Lyngby,3604,8,4,9,11,27,44,-17,21
Randers FC,3604,9,5,6,13,23,40,-17,21
Silkeborg IF,3604,10,6,3,13,26,44,-18,21
AGF Aarhus,3604,11,4,6,12,16,37,-21,18
Brondby,3605,1,22,5,3,71,30,41,71
FC Midtjylla,3605,2,20,4,6,69,42,27,64
Copenhagen,3605,3,14,6,10,56,43,13,48
FC Nords,3605,4,12,8,10,70,52,18,44
AC Horsens,3605,5,8,12,10,39,52,-13,36
AaB,3605,6,6,13,11,34,46,-12,31
Sonderjyske,3605,7,8,6,10,28,29,-1,30
Lyngby,3605,8,4,9,11,28,44,-16,21
Silkeborg IF,3605,9,6,3,13,27,44,-17,21
Randers FC,3605,10,5,6,13,23,41,-18,21
AGF Aarhus,3605,11,4,6,12,16,38,-22,18
Brondby,3606,1,22,5,3,73,29,44,71
FC Midtjylla,3606,2,19,4,7,68,43,25,61
FC Nords,3606,3,15,6,9,74,55,19,51
Copenhagen,3606,4,15,4,11,58,45,13,49
AaB,3606,5,8,11,11,37,42,-5,35
Sonderjyske,3606,6,8,6,10,28,29,-1,30
AC Horsens,3606,7,6,12,12,33,55,-22,30
Randers FC,3606,8,5,7,12,23,39,-16,22
Lyngby,3606,9,3,10,11,26,44,-18,19
Silkeborg IF,3606,10,5,4,13,27,46,-19,19
AGF Aarhus,3606,11,4,7,11,18,38,-20,19
Brondby,3607,1,21,5,4,70,32,38,68
FC Midtjylla,3607,2,20,5,5,69,39,30,65
FC Nords,3607,3,15,6,9,82,58,24,51
Copenhagen,3607,4,13,5,12,59,49,10,44
AaB,3607,5,8,11,11,39,44,-5,35
AC Horsens,3607,6,7,12,11,37,60,-23,33
Sonderjyske,3607,7,8,6,10,28,29,-1,30
Randers FC,3607,8,5,7,12,23,39,-16,22
Silkeborg IF,3607,9,6,3,13,29,46,-17,21
Lyngby,3607,10,3,10,11,26,44,-18,19
AGF Aarhus,3607,11,4,6,12,18,40,-22,18
Brondby,3608,1,20,7,3,74,35,39,67
FC Midtjylla,3608,2,18,7,5,64,39,25,61
FC Nords,3608,3,13,9,8,73,52,21,48
Copenhagen,3608,4,14,6,10,57,43,14,48
AC Horsens,3608,5,7,14,9,37,52,-15,35
AaB,3608,6,6,13,11,38,48,-10,31
Sonderjyske,3608,7,8,6,10,28,29,-1,30
Lyngby,3608,8,4,9,11,29,45,-16,21
Silkeborg IF,3608,9,6,3,13,28,44,-16,21
Randers FC,3608,10,5,6,13,24,42,-18,21
AGF Aarhus,3608,11,4,6,12,16,39,-23,18
Brondby,3609,1,22,5,3,67,27,40,71
FC Midtjylla,3609,2,20,4,6,62,37,25,64
FC Nords,3609,3,15,6,9,77,54,23,51
Copenhagen,3609,4,13,5,12,60,50,10,44
AaB,3609,5,7,13,10,38,40,-2,34
AC Horsens,3609,6,6,13,11,32,54,-22,31
Sonderjyske,3609,7,8,6,10,28,29,-1,30
Lyngby,3609,8,4,9,11,29,44,-15,21
Randers FC,3609,9,5,6,13,23,42,-19,21
Silkeborg IF,3609,10,5,4,13,26,45,-19,19
AGF Aarhus,3609,11,4,7,11,17,37,-20,19
Brondby,3610,1,22,6,2,76,31,45,72
FC Midtjylla,3610,2,17,7,6,64,45,19,58
FC Nords,3610,3,14,8,8,75,54,21,50
Copenhagen,3610,4,13,5,12,57,50,7,44
AaB,3610,5,8,13,9,45,45,0,37
AC Horsens,3610,6,6,13,11,35,53,-18,31
Sonderjyske,3610,7,8,6,10,28,29,-1,30
Randers FC,3610,8,5,7,12,23,39,-16,22
AGF Aarhus,3610,9,5,6,11,18,36,-18,21
Lyngby,3610,10,3,10,11,26,44,-18,19
Silkeborg IF,3610,11,5,3,14,25,46,-21,18
Brondby,3611,1,22,5,3,71,33,38,71
FC Midtjylla,3611,2,19,6,5,67,38,29,63
FC Nords,3611,3,14,7,9,72,52,20,49
Copenhagen,3611,4,12,6,12,53,43,10,42
AaB,3611,5,8,12,10,36,43,-7,36
AC Horsens,3611,6,5,16,9,35,51,-16,31
Sonderjyske,3611,7,8,6,10,28,29,-1,30
Randers FC,3611,8,5,7,12,25,41,-16,22
Silkeborg IF,3611,9,6,3,13,27,45,-18,21
Lyngby,3611,10,3,10,11,28,46,-18,19
AGF Aarhus,3611,11,4,6,12,17,38,-21,18
FC Midtjylla,3612,1,22,4,4,68,36,32,70
Brondby,3612,2,20,6,4,69,34,35,66
Copenhagen,3612,3,14,5,11,60,45,15,47
FC Nords,3612,4,12,6,12,71,58,13,42
AaB,3612,5,9,11,10,36,39,-3,38
AC Horsens,3612,6,7,12,11,36,54,-18,33
Sonderjyske,3612,7,8,6,10,28,29,-1,30
Lyngby,3612,8,4,9,11,28,45,-17,21
Randers FC,3612,9,5,6,13,24,41,-17,21
Silkeborg IF,3612,10,5,4,13,26,45,-19,19
AGF Aarhus,3612,11,4,7,11,17,37,-20,19
FC Midtjylla,3613,1,21,5,4,70,38,32,68
Brondby,3613,2,19,7,4,66,34,32,64
FC Nords,3613,3,14,8,8,73,48,25,50
Copenhagen,3613,4,13,4,13,51,46,5,43
AaB,3613,5,9,12,9,39,38,1,39
Sonderjyske,3613,6,8,6,10,28,29,-1,30
AC Horsens,3613,7,6,12,12,33,54,-21,30
Lyngby,3613,8,4,9,11,27,44,-17,21
Randers FC,3613,9,5,6,13,23,40,-17,21
AGF Aarhus,3613,10,5,6,11,19,36,-17,21
Silkeborg IF,3613,11,5,3,14,25,47,-22,18
Brondby,3614,1,20,6,4,66,32,34,66
FC Midtjylla,3614,2,20,6,4,70,38,32,66
Copenhagen,3614,3,13,7,10,56,42,14,46
FC Nords,3614,4,12,8,10,72,56,16,44
AaB,3614,5,7,15,8,38,41,-3,36
AC Horsens,3614,6,6,14,10,35,54,-19,32
Sonderjyske,3614,7,8,6,10,28,29,-1,30
Lyngby,3614,8,4,9,11,29,45,-16,21
Randers FC,3614,9,5,6,13,24,42,-18,21
AGF Aarhus,3614,10,5,6,11,18,36,-18,21
Silkeborg IF,3614,11,5,3,14,25,46,-21,18
Brondby,3615,1,22,6,2,76,32,44,72
FC Midtjylla,3615,2,20,4,6,67,37,30,64
FC Nords,3615,3,14,8,8,72,51,21,50
Copenhagen,3615,4,13,6,11,54,42,12,45
AaB,3615,5,7,12,11,34,47,-13,33
Sonderjyske,3615,6,8,6,10,28,29,-1,30
AC Horsens,3615,7,5,14,11,31,51,-20,29
Randers FC,3615,8,5,7,12,24,40,-16,22
Lyngby,3615,9,3,10,11,27,45,-18,19
Silkeborg IF,3615,10,5,4,13,26,45,-19,19
AGF Aarhus,3615,11,4,7,11,17,37,-20,19
Brondby,3616,1,20,7,3,69,30,39,67
FC Midtjylla,3616,2,18,6,6,66,42,24,60
FC Nords,3616,3,15,8,7,76,51,25,53
Copenhagen,3616,4,14,4,12,59,46,13,46
AC Horsens,3616,5,7,13,10,35,52,-17,34
AaB,3616,6,7,12,11,38,48,-10,33
Sonderjyske,3616,7,8,6,10,28,29,-1,30
Lyngby,3616,8,4,9,11,28,44,-16,21
Silkeborg IF,3616,9,6,3,13,27,44,-17,21
Randers FC,3616,10,5,6,13,23,41,-18,21
AGF Aarhus,3616,11,4,6,12,16,38,-22,18
Brondby,3617,1,19,7,4,73,39,34,64
FC Midtjylla,3617,2,19,6,5,65,40,25,63
FC Nords,3617,3,16,6,8,78,52,26,54
Copenhagen,3617,4,14,5,11,62,47,15,47
AaB,3617,5,8,11,11,39,46,-7,35
AC Horsens,3617,6,6,13,11,36,55,-19,31
Sonderjyske,3617,7,8,6,10,28,29,-1,30
Randers FC,3617,8,6,6,12,26,40,-14,24
AGF Aarhus,3617,9,5,6,11,17,36,-19,21
Lyngby,3617,10,3,9,12,27,47,-20,18
Silkeborg IF,3617,11,5,3,14,25,45,-20,18
Brondby,3618,1,21,5,4,71,34,37,68
FC Midtjylla,3618,2,20,6,4,68,40,28,66
FC Nords,3618,3,14,6,10,70,53,17,48
Copenhagen,3618,4,13,4,13,56,45,11,43
AC Horsens,3618,5,8,13,9,43,52,-9,37
AaB,3618,6,7,12,11,35,45,-10,33
Sonderjyske,3618,7,8,6,10,28,29,-1,30
Randers FC,3618,8,5,7,12,25,41,-16,22
Lyngby,3618,9,3,10,11,28,46,-18,19
Silkeborg IF,3618,10,5,4,13,26,45,-19,19
AGF Aarhus,3618,11,4,7,11,17,37,-20,19
Brondby,3619,1,19,7,4,69,34,35,64
FC Midtjylla,3619,2,18,5,7,60,41,19,59
FC Nords,3619,3,15,6,9,80,54,26,51
Copenhagen,3619,4,15,6,9,63,42,21,51
AaB,3619,5,8,12,10,35,41,-6,36
AC Horsens,3619,6,5,16,9,35,56,-21,31
Sonderjyske,3619,7,8,6,10,28,29,-1,30
Randers FC,3619,8,6,6,12,26,41,-15,24
AGF Aarhus,3619,9,5,6,11,20,38,-18,21
Lyngby,3619,10,3,9,12,28,47,-19,18
Silkeborg IF,3619,11,5,3,14,27,48,-21,18
Brondby,3620,1,21,7,2,74,31,43,70
FC Midtjylla,3620,2,20,5,5,66,36,30,65
FC Nords,3620,3,14,8,8,76,54,22,50
Copenhagen,3620,4,14,5,11,60,49,11,47
AC Horsens,3620,5,7,12,11,37,53,-16,33
Sonderjyske,3620,6,8,6,10,28,29,-1,30
AaB,3620,7,6,11,13,33,49,-16,29
Randers FC,3620,8,5,7,12,23,39,-16,22
Silkeborg IF,3620,9,6,3,13,26,44,-18,21
Lyngby,3620,10,3,10,11,26,44,-18,19
AGF Aarhus,3620,11,4,6,12,16,37,-21,18
Brondby,3621,1,21,5,4,73,34,39,68
FC Midtjylla,3621,2,19,4,7,68,47,21,61
FC Nords,3621,3,14,6,10,74,55,19,48
Copenhagen,3621,4,14,5,11,58,44,14,47
AC Horsens,3621,5,8,13,9,38,49,-11,37
AaB,3621,6,8,11,11,36,44,-8,35
Sonderjyske,3621,7,8,6,10,28,29,-1,30
Randers FC,3621,8,5,7,12,24,40,-16,22
Silkeborg IF,3621,9,6,3,13,26,44,-18,21
Lyngby,3621,10,3,10,11,27,45,-18,19
AGF Aarhus,3621,11,4,6,12,16,37,-21,18
Brondby,3622,1,21,5,4,72,37,35,68
FC Midtjylla,3622,2,20,4,6,68,40,28,64
FC Nords,3622,3,16,6,8,77,49,28,54
Copenhagen,3622,4,14,5,11,64,48,16,47
AaB,3622,5,7,12,11,36,48,-12,33
Sonderjyske,3622,6,8,6,10,28,29,-1,30
AC Horsens,3622,7,6,12,12,34,55,-21,30
Lyngby,3622,8,4,9,11,28,44,-16,21
Silkeborg IF,3622,9,6,3,13,27,44,-17,21
Randers FC,3622,10,5,6,13,23,41,-18,21
AGF Aarhus,3622,11,4,6,12,16,38,-22,18
FC Midtjylla,3623,1,22,4,4,71,35,36,70
Brondby,3623,2,20,5,5,68,37,31,65
FC Nords,3623,3,15,7,8,79,51,28,52
Copenhagen,3623,4,14,4,12,56,44,12,46
AC Horsens,3623,5,7,12,11,35,57,-22,33
Sonderjyske,3623,6,8,6,10,28,29,-1,30
AaB,3623,7,6,12,12,34,45,-11,30
Randers FC,3623,8,5,7,12,23,39,-16,22
Silkeborg IF,3623,9,6,3,13,30,44,-14,21
Lyngby,3623,10,3,10,11,26,44,-18,19
AGF Aarhus,3623,11,4,6,12,16,41,-25,18
Brondby,3624,1,21,5,4,71,37,34,68
FC Midtjylla,3624,2,18,6,6,65,42,23,60
FC Nords,3624,3,14,7,9,73,51,22,49
Copenhagen,3624,4,15,4,11,62,46,16,49
AaB,3624,5,7,13,10,36,40,-4,34
AC Horsens,3624,6,7,13,10,36,53,-17,34
Sonderjyske,3624,7,8,6,10,28,29,-1,30
Randers FC,3624,8,6,6,12,25,40,-15,24
Silkeborg IF,3624,9,6,3,13,26,44,-18,21
Lyngby,3624,10,3,9,12,27,46,-19,18
AGF Aarhus,3624,11,4,6,12,16,37,-21,18
Brondby,3625,1,22,6,2,74,31,43,72
FC Midtjylla,3625,2,18,5,7,62,40,22,59
FC Nords,3625,3,14,7,9,73,52,21,49
Copenhagen,3625,4,12,6,12,59,49,10,42
AaB,3625,5,8,12,10,37,43,-6,36
AC Horsens,3625,6,7,14,9,37,53,-16,35
Sonderjyske,3625,7,8,6,10,28,29,-1,30
Randers FC,3625,8,6,6,12,25,40,-15,24
AGF Aarhus,3625,9,5,6,11,19,36,-17,21
Lyngby,3625,10,3,9,12,27,46,-19,18
Silkeborg IF,3625,11,5,3,14,25,47,-22,18
Brondby,3626,1,21,5,4,73,34,39,68
FC Midtjylla,3626,2,19,6,5,66,39,27,63
Copenhagen,3626,3,14,7,9,61,41,20,49
FC Nords,3626,4,13,8,9,73,55,18,47
AC Horsens,3626,5,7,13,10,37,56,-19,34
AaB,3626,6,6,13,11,36,47,-11,31
Sonderjyske,3626,7,8,6,10,28,29,-1,30
Lyngby,3626,8,4,9,11,27,44,-17,21
Randers FC,3626,9,5,6,13,23,40,-17,21
Silkeborg IF,3626,10,6,3,13,27,45,-18,21
AGF Aarhus,3626,11,4,6,12,17,38,-21,18
FC Midtjylla,3627,1,22,4,4,69,33,36,70
Brondby,3627,2,21,5,4,74,33,41,68
FC Nords,3627,3,13,7,10,70,58,12,46
Copenhagen,3627,4,12,7,11,53,44,9,43
AaB,3627,5,8,12,10,40,42,-2,36
AC Horsens,3627,6,6,13,11,33,55,-22,31
Sonderjyske,3627,7,8,6,10,28,29,-1,30
Lyngby,3627,8,4,9,11,28,44,-16,21
AGF Aarhus,3627,9,5,6,11,19,36,-17,21
Randers FC,3627,10,5,6,13,23,41,-18,21
Silkeborg IF,3627,11,5,3,14,25,47,-22,18
Brondby,3628,1,22,5,3,73,32,41,71
FC Midtjylla,3628,2,20,4,6,64,37,27,64
FC Nords,3628,3,15,6,9,75,50,25,51
Copenhagen,3628,4,15,4,11,57,44,13,49
AaB,3628,5,7,11,12,36,46,-10,32
Sonderjyske,3628,6,8,6,10,28,29,-1,30
AC Horsens,3628,7,6,12,12,33,55,-22,30
Lyngby,3628,8,4,9,11,31,45,-14,21
AGF Aarhus,3628,9,5,6,11,19,36,-17,21
Randers FC,3628,10,5,6,13,24,44,-20,21
Silkeborg IF,3628,11,5,3,14,25,47,-22,18
Brondby,3629,1,21,7,2,76,34,42,70
FC Midtjylla,3629,2,19,5,6,68,46,22,62
FC Nords,3629,3,13,7,10,75,58,17,46
Copenhagen,3629,4,14,4,12,59,50,9,46
AaB,3629,5,8,13,9,41,41,0,37
AC Horsens,3629,6,6,14,10,40,56,-16,32
Sonderjyske,3629,7,8,6,10,28,29,-1,30
Lyngby,3629,8,4,9,11,30,45,-15,21
Randers FC,3629,9,5,6,13,24,43,-19,21
AGF Aarhus,3629,10,5,6,11,18,37,-19,21
Silkeborg IF,3629,11,5,3,14,26,46,-20,18
Brondby,3630,1,19,6,5,65,35,30,63
FC Midtjylla,3630,2,17,5,8,57,39,18,56
FC Nords,3630,3,14,9,7,74,50,24,51
Copenhagen,3630,4,14,6,10,58,43,15,48
AaB,3630,5,8,13,9,36,39,-3,37
AC Horsens,3630,6,8,13,9,41,51,-10,37
Sonderjyske,3630,7,8,6,10,28,29,-1,30
Randers FC,3630,8,6,6,12,25,40,-15,24
Silkeborg IF,3630,9,5,4,13,26,45,-19,19
AGF Aarhus,3630,10,4,7,11,17,37,-20,19
Lyngby,3630,11,3,9,12,27,46,-19,18
Brondby,3631,1,21,5,4,73,33,40,68
FC Midtjylla,3631,2,20,4,6,65,40,25,64
Copenhagen,3631,3,14,5,11,59,47,12,47
FC Nords,3631,4,13,7,10,68,52,16,46
AC Horsens,3631,5,8,12,10,36,49,-13,36
AaB,3631,6,8,11,11,38,44,-6,35
Sonderjyske,3631,7,8,6,10,28,29,-1,30
Lyngby,3631,8,4,9,11,28,44,-16,21
Randers FC,3631,9,5,6,13,23,41,-18,21
AGF Aarhus,3631,10,5,6,11,17,36,-19,21
Silkeborg IF,3631,11,5,3,14,25,45,-20,18
Brondby,3632,1,19,8,3,67,32,35,65
FC Midtjylla,3632,2,20,5,5,65,39,26,65
Copenhagen,3632,3,16,5,9,61,41,20,53
FC Nords,3632,4,13,8,9,75,53,22,47
AaB,3632,5,6,14,10,33,42,-9,32
Sonderjyske,3632,6,8,6,10,28,29,-1,30
AC Horsens,3632,7,5,14,11,35,55,-20,29
Randers FC,3632,8,6,6,12,25,40,-15,24
AGF Aarhus,3632,9,5,6,11,20,39,-19,21
Lyngby,3632,10,3,9,12,27,46,-19,18
Silkeborg IF,3632,11,5,3,14,28,48,-20,18
Brondby,3633,1,20,7,3,74,34,40,67
FC Midtjylla,3633,2,19,5,6,65,43,22,62
FC Nords,3633,3,13,9,8,75,52,23,48
Copenhagen,3633,4,14,6,10,59,45,14,48
AaB,3633,5,7,13,10,38,44,-6,34
AC Horsens,3633,6,7,12,11,33,52,-19,33
Sonderjyske,3633,7,8,6,10,28,29,-1,30
Randers FC,3633,8,5,7,12,25,41,-16,22
AGF Aarhus,3633,9,5,6,11,18,36,-18,21
Lyngby,3633,10,3,10,11,28,46,-18,19
Silkeborg IF,3633,11,5,3,14,25,46,-21,18
Brondby,3634,1,23,5,2,71,28,43,74
FC Midtjylla,3634,2,20,4,6,68,38,30,64
Copenhagen,3634,3,14,4,12,57,46,11,46
FC Nords,3634,4,13,6,11,73,56,17,45
AaB,3634,5,8,11,11,36,42,-6,35
AC Horsens,3634,6,7,12,11,33,54,-21,33
Sonderjyske,3634,7,8,6,10,28,29,-1,30
Lyngby,3634,8,4,9,11,28,44,-16,21
Randers FC,3634,9,5,6,13,23,41,-18,21
Silkeborg IF,3634,10,5,4,13,25,44,-19,19
AGF Aarhus,3634,11,4,7,11,16,36,-20,19
Brondby,3635,1,20,8,2,73,35,38,68
FC Midtjylla,3635,2,19,6,5,68,42,26,63
FC Nords,3635,3,13,6,11,70,52,18,45
Copenhagen,3635,4,13,5,12,56,47,9,44
AC Horsens,3635,5,8,13,9,34,47,-13,37
AaB,3635,6,8,12,10,38,42,-4,36
Sonderjyske,3635,7,8,6,10,28,29,-1,30
Randers FC,3635,8,6,6,12,25,40,-15,24
Silkeborg IF,3635,9,5,4,13,25,44,-19,19
AGF Aarhus,3635,10,4,7,11,16,36,-20,19
Lyngby,3635,11,3,9,12,27,46,-19,18
Brondby,3636,1,21,6,3,71,32,39,69
FC Midtjylla,3636,2,21,4,5,65,38,27,67
FC Nords,3636,3,13,8,9,71,51,20,47
Copenhagen,3636,4,13,7,10,59,46,13,46
AaB,3636,5,7,13,10,39,43,-4,34
Sonderjyske,3636,6,8,6,10,28,29,-1,30
AC Horsens,3636,7,6,12,12,35,56,-21,30
Randers FC,3636,8,5,7,12,24,40,-16,22
Silkeborg IF,3636,9,6,3,13,30,45,-15,21
Lyngby,3636,10,3,10,11,27,45,-18,19
AGF Aarhus,3636,11,4,6,12,17,41,-24,18
FC Midtjylla,3637,1,20,6,4,68,37,31,66
Brondby,3637,2,18,8,4,68,36,32,62
FC Nords,3637,3,16,6,8,73,52,21,54
Copenhagen,3637,4,15,4,11,59,43,16,49
AaB,3637,5,6,13,11,34,44,-10,31
AC Horsens,3637,6,6,13,11,34,50,-16,31
Sonderjyske,3637,7,8,6,10,28,29,-1,30
Lyngby,3637,8,4,9,11,27,44,-17,21
Randers FC,3637,9,5,6,13,23,40,-17,21
Silkeborg IF,3637,10,5,4,13,26,45,-19,19
AGF Aarhus,3637,11,4,7,11,17,37,-20,19
Brondby,3638,1,21,5,4,72,34,38,68
FC Midtjylla,3638,2,20,5,5,67,40,27,65
FC Nords,3638,3,14,7,9,73,51,22,49
Copenhagen,3638,4,13,6,11,58,45,13,45
AaB,3638,5,7,13,10,38,43,-5,34
AC Horsens,3638,6,7,12,11,35,56,-21,33
Sonderjyske,3638,7,8,6,10,28,29,-1,30
Randers FC,3638,8,5,7,12,24,40,-16,22
AGF Aarhus,3638,9,5,6,11,18,37,-19,21
Lyngby,3638,10,3,10,11,27,45,-18,19
Silkeborg IF,3638,11,5,3,14,26,46,-20,18
FC Midtjylla,3639,1,21,4,5,67,39,28,67
Brondby,3639,2,20,6,4,68,32,36,66
FC Nords,3639,3,14,7,9,69,48,21,49
Copenhagen,3639,4,14,5,11,60,47,13,47
AC Horsens,3639,5,7,13,10,34,49,-15,34
AaB,3639,6,6,13,11,34,43,-9,31
Sonderjyske,3639,7,8,6,10,28,29,-1,30
Randers FC,3639,8,5,7,12,25,41,-16,22
Lyngby,3639,9,3,10,11,28,46,-18,19
Silkeborg IF,3639,10,5,4,13,25,44,-19,19
AGF Aarhus,3639,11,4,7,11,16,36,-20,19
Brondby,3640,1,21,5,4,73,35,38,68
FC Midtjylla,3640,2,21,4,5,74,38,36,67
FC Nords,3640,3,14,6,10,75,53,22,48
Copenhagen,3640,4,14,4,12,59,49,10,46
AaB,3640,5,9,11,10,37,45,-8,38
Sonderjyske,3640,6,8,6,10,28,29,-1,30
AC Horsens,3640,7,6,12,12,35,59,-24,30
Lyngby,3640,8,4,9,11,28,44,-16,21
Silkeborg IF,3640,8,6,3,13,28,44,-16,21
Randers FC,3640,10,5,6,13,23,41,-18,21
AGF Aarhus,3640,11,4,6,12,16,39,-23,18
Brondby,3641,1,21,6,3,70,35,35,69
FC Midtjylla,3641,2,21,5,4,71,37,34,68
FC Nords,3641,3,14,7,9,73,50,23,49
Copenhagen,3641,4,12,5,13,56,48,8,41
AaB,3641,5,9,11,10,40,43,-3,38
Sonderjyske,3641,6,8,6,10,28,29,-1,30
AC Horsens,3641,7,6,12,12,35,58,-23,30
Randers FC,3641,8,6,6,12,26,40,-14,24
AGF Aarhus,3641,9,5,6,11,18,37,-19,21
Lyngby,3641,10,3,9,12,27,47,-20,18
Silkeborg IF,3641,11,5,3,14,26,46,-20,18
Brondby,3642,1,21,7,2,69,30,39,70
FC Midtjylla,3642,2,19,6,5,65,39,26,63
FC Nords,3642,3,14,7,9,74,50,24,49
Copenhagen,3642,4,13,5,12,56,47,9,44
AC Horsens,3642,5,6,15,9,34,49,-15,33
AaB,3642,6,6,14,10,35,44,-9,32
Sonderjyske,3642,7,8,6,10,28,29,-1,30
Lyngby,3642,8,4,9,11,29,44,-15,21
Randers FC,3642,9,5,6,13,23,42,-19,21
Silkeborg IF,3642,10,5,4,13,26,45,-19,19
AGF Aarhus,3642,11,4,7,11,17,37,-20,19
Brondby,3643,1,20,8,2,72,32,40,68
FC Midtjylla,3643,2,21,5,4,74,37,37,68
FC Nords,3643,3,14,6,10,71,56,15,48
Copenhagen,3643,4,14,6,10,60,47,13,48
AaB,3643,5,7,12,11,35,45,-10,33
Sonderjyske,3643,6,8,6,10,28,29,-1,30
AC Horsens,3643,7,5,13,12,37,58,-21,28
Randers FC,3643,8,5,7,12,23,39,-16,22
Silkeborg IF,3643,9,6,3,13,26,44,-18,21
Lyngby,3643,10,3,10,11,26,44,-18,19
AGF Aarhus,3643,11,4,6,12,16,37,-21,18
Brondby,3644,1,20,6,4,70,31,39,66
FC Midtjylla,3644,2,19,5,6,62,39,23,62
FC Nords,3644,3,16,6,8,76,50,26,54
Copenhagen,3644,4,16,4,10,59,42,17,52
AaB,3644,5,7,12,11,34,44,-10,33
Sonderjyske,3644,6,8,6,10,28,29,-1,30
AC Horsens,3644,7,5,13,12,33,54,-21,28
Randers FC,3644,8,6,6,12,26,40,-14,24
Silkeborg IF,3644,9,6,3,13,28,44,-16,21
Lyngby,3644,10,3,9,12,27,47,-20,18
AGF Aarhus,3644,11,4,6,12,16,39,-23,18
FC Midtjylla,3645,1,20,6,4,64,34,30,66
Brondby,3645,2,20,5,5,70,35,35,65
FC Nords,3645,3,16,7,7,77,49,28,55
Copenhagen,3645,4,14,5,11,59,46,13,47
AC Horsens,3645,5,7,12,11,38,51,-13,33
Sonderjyske,3645,6,8,6,10,28,29,-1,30
AaB,3645,7,6,11,13,33,52,-19,29
Randers FC,3645,8,6,6,12,25,39,-14,24
Silkeborg IF,3645,9,5,4,13,27,46,-19,19
AGF Aarhus,3645,10,4,7,11,18,38,-20,19
Lyngby,3645,11,3,9,12,26,46,-20,18
FC Midtjylla,3646,1,21,5,4,65,34,31,68
Brondby,3646,2,19,6,5,70,37,33,63
FC Nords,3646,3,14,6,10,73,55,18,48
Copenhagen,3646,4,12,6,12,56,46,10,42
AaB,3646,5,9,13,8,39,40,-1,40
AC Horsens,3646,6,6,14,10,36,53,-17,32
Sonderjyske,3646,7,8,6,10,28,29,-1,30
Randers FC,3646,8,5,7,12,24,40,-16,22
Silkeborg IF,3646,9,6,3,13,27,45,-18,21
Lyngby,3646,10,3,10,11,27,45,-18,19
AGF Aarhus,3646,11,4,6,12,17,38,-21,18
Brondby,3647,1,19,9,2,75,35,40,66
FC Midtjylla,3647,2,18,6,6,63,43,20,60
FC Nords,3647,3,14,7,9,76,53,23,49
Copenhagen,3647,4,12,8,10,55,43,12,44
AaB,3647,5,7,15,8,37,40,-3,36
AC Horsens,3647,6,6,15,9,37,55,-18,33
Sonderjyske,3647,7,8,6,10,28,29,-1,30
Randers FC,3647,8,5,7,12,23,39,-16,22
Silkeborg IF,3647,9,6,3,13,28,44,-16,21
Lyngby,3647,10,3,10,11,26,44,-18,19
AGF Aarhus,3647,11,4,6,12,16,39,-23,18
Brondby,3648,1,23,5,2,74,28,46,74
FC Midtjylla,3648,2,19,4,7,66,43,23,61
FC Nords,3648,3,14,7,9,72,52,20,49
Copenhagen,3648,4,14,5,11,59,45,14,47
AaB,3648,5,7,12,11,35,43,-8,33
AC Horsens,3648,6,6,13,11,36,57,-21,31
Sonderjyske,3648,7,8,6,10,28,29,-1,30
Lyngby,3648,8,4,9,11,30,45,-15,21
AGF Aarhus,3648,9,5,6,11,19,37,-18,21
Randers FC,3648,10,5,6,13,24,43,-19,21
Silkeborg IF,3648,11,5,3,14,26,47,-21,18
Brondby,3649,1,20,8,2,70,30,40,68
FC Midtjylla,3649,2,19,5,6,61,37,24,62
FC Nords,3649,3,15,8,7,77,46,31,53
Copenhagen,3649,4,13,6,11,55,48,7,45
AC Horsens,3649,5,7,13,10,38,52,-14,34
Sonderjyske,3649,6,8,6,10,28,29,-1,30
AaB,3649,7,6,12,12,34,48,-14,30
Randers FC,3649,8,5,7,12,24,40,-16,22
Silkeborg IF,3649,9,6,3,13,28,45,-17,21
Lyngby,3649,10,3,10,11,27,45,-18,19
AGF Aarhus,3649,11,4,6,12,17,39,-22,18
Brondby,3650,1,21,5,4,70,32,38,68
FC Midtjylla,3650,2,19,5,6,66,41,25,62
FC Nords,3650,3,14,8,8,76,51,25,50
Copenhagen,3650,4,14,5,11,60,49,11,47
AaB,3650,5,8,12,10,40,47,-7,36
AC Horsens,3650,6,6,13,11,35,53,-18,31
Sonderjyske,3650,7,8,6,10,28,29,-1,30
Randers FC,3650,8,5,7,12,24,40,-16,22
AGF Aarhus,3650,9,5,6,11,17,36,-19,21
Lyngby,3650,10,3,10,11,27,45,-18,19
Silkeborg IF,3650,11,5,3,14,25,45,-20,18
Brondby,3651,1,22,6,2,81,34,47,72
FC Midtjylla,3651,2,20,4,6,65,37,28,64
FC Nords,3651,3,14,7,9,73,51,22,49
Copenhagen,3651,4,15,4,11,57,44,13,49
AaB,3651,5,7,12,11,34,45,-11,33
Sonderjyske,3651,6,8,6,10,28,29,-1,30
AC Horsens,3651,7,5,13,12,33,58,-25,28
Lyngby,3651,8,4,9,11,27,44,-17,21
Randers FC,3651,9,5,6,13,23,40,-17,21
Silkeborg IF,3651,10,6,3,13,27,45,-18,21
AGF Aarhus,3651,11,4,6,12,17,38,-21,18
Brondby,3652,1,20,5,5,71,36,35,65
FC Midtjylla,3652,2,19,5,6,64,40,24,62
FC Nords,3652,3,15,7,8,72,49,23,52
Copenhagen,3652,4,14,5,11,56,43,13,47
AC Horsens,3652,5,7,15,8,36,49,-13,36
AaB,3652,6,7,11,12,35,43,-8,32
Sonderjyske,3652,7,8,6,10,28,29,-1,30
Lyngby,3652,8,4,9,11,27,44,-17,21
Randers FC,3652,9,5,6,13,23,40,-17,21
Silkeborg IF,3652,10,6,3,13,26,44,-18,21
AGF Aarhus,3652,11,4,6,12,16,37,-21,18
Brondby,3653,1,22,5,3,76,35,41,71
FC Midtjylla,3653,2,19,5,6,67,43,24,62
Copenhagen,3653,3,14,6,10,57,43,14,48
FC Nords,3653,4,13,8,9,75,57,18,47
AC Horsens,3653,5,7,13,10,38,52,-14,34
AaB,3653,6,6,13,11,38,47,-9,31
Sonderjyske,3653,7,8,6,10,28,29,-1,30
Randers FC,3653,8,5,7,12,24,40,-16,22
Silkeborg IF,3653,9,6,3,13,28,45,-17,21
Lyngby,3653,10,3,10,11,27,45,-18,19
AGF Aarhus,3653,11,4,6,12,17,39,-22,18
Brondby,3654,1,22,5,3,74,31,43,71
FC Midtjylla,3654,2,20,4,6,66,39,27,64
FC Nords,3654,3,16,6,8,78,50,28,54
Copenhagen,3654,4,13,6,11,56,45,11,45
AC Horsens,3654,5,6,13,11,34,56,-22,31
Sonderjyske,3654,6,8,6,10,28,29,-1,30
AaB,3654,7,6,12,12,35,48,-13,30
Randers FC,3654,8,5,7,12,24,40,-16,22
Lyngby,3654,9,3,10,11,27,45,-18,19
Silkeborg IF,3654,10,5,4,13,26,45,-19,19
AGF Aarhus,3654,11,4,7,11,17,37,-20,19
Brondby,3655,1,19,7,4,66,34,32,64
FC Midtjylla,3655,2,17,7,6,60,38,22,58
FC Nords,3655,3,16,7,7,77,47,30,55
Copenhagen,3655,4,13,7,10,57,45,12,46
AC Horsens,3655,5,8,12,10,37,51,-14,36
AaB,3655,6,7,12,11,36,44,-8,33
Sonderjyske,3655,7,8,6,10,28,29,-1,30
Randers FC,3655,8,6,6,12,25,39,-14,24
Silkeborg IF,3655,9,5,4,13,26,45,-19,19
AGF Aarhus,3655,10,4,7,11,17,37,-20,19
Lyngby,3655,11,3,9,12,26,46,-20,18
Brondby,3656,1,20,6,4,68,32,36,66
FC Midtjylla,3656,2,19,7,4,63,36,27,64
FC Nords,3656,3,14,6,10,70,51,19,48
Copenhagen,3656,4,14,4,12,57,47,10,46
AaB,3656,5,9,12,9,40,41,-1,39
AC Horsens,3656,6,6,13,11,33,50,-17,31
Sonderjyske,3656,7,8,6,10,28,29,-1,30
Lyngby,3656,8,4,9,11,27,44,-17,21
Randers FC,3656,9,5,6,13,23,40,-17,21
Silkeborg IF,3656,10,6,3,13,27,45,-18,21
AGF Aarhus,3656,11,4,6,12,17,38,-21,18
Brondby,3657,1,22,5,3,70,32,38,71
FC Midtjylla,3657,2,21,4,5,62,34,28,67
Copenhagen,3657,3,15,4,11,53,40,13,49
FC Nords,3657,4,13,6,11,69,50,19,45
AaB,3657,5,8,11,11,37,41,-4,35
Sonderjyske,3657,6,8,6,10,28,29,-1,30
AC Horsens,3657,7,6,12,12,32,52,-20,30
Randers FC,3657,8,6,6,12,25,40,-15,24
Silkeborg IF,3657,9,6,3,13,27,45,-18,21
Lyngby,3657,10,3,9,12,27,46,-19,18
AGF Aarhus,3657,11,4,6,12,17,38,-21,18
Brondby,3658,1,19,9,2,68,31,37,66
FC Midtjylla,3658,2,18,7,5,66,40,26,61
FC Nords,3658,3,13,7,10,70,53,17,46
Copenhagen,3658,4,13,7,10,58,45,13,46
AaB,3658,5,7,14,9,38,42,-4,35
AC Horsens,3658,6,7,14,9,35,50,-15,35
Sonderjyske,3658,7,8,6,10,28,29,-1,30
Lyngby,3658,8,4,9,11,28,45,-17,21
Randers FC,3658,9,5,6,13,24,41,-17,21
AGF Aarhus,3658,10,5,6,11,17,36,-19,21
Silkeborg IF,3658,11,5,3,14,25,45,-20,18
FC Midtjylla,3659,1,20,6,4,64,35,29,66
Brondby,3659,2,20,6,4,66,38,28,66
FC Nords,3659,3,15,6,9,77,48,29,51
Copenhagen,3659,4,15,4,11,60,43,17,49
AC Horsens,3659,5,7,13,10,33,52,-19,34
Sonderjyske,3659,6,8,6,10,28,29,-1,30
AaB,3659,7,6,11,13,32,42,-10,29
Randers FC,3659,8,5,7,12,24,40,-16,22
Lyngby,3659,9,3,10,11,27,45,-18,19
Silkeborg IF,3659,10,5,4,13,25,44,-19,19
AGF Aarhus,3659,11,4,7,11,16,36,-20,19
Brondby,3660,1,22,6,2,76,30,46,72
FC Midtjylla,3660,2,20,5,5,66,41,25,65
FC Nords,3660,3,13,8,9,73,55,18,47
Copenhagen,3660,4,14,5,11,56,43,13,47
AaB,3660,5,7,12,11,34,41,-7,33
Sonderjyske,3660,6,8,6,10,28,29,-1,30
AC Horsens,3660,7,5,14,11,34,55,-21,29
AGF Aarhus,3660,8,5,6,11,20,36,-16,21
Lyngby,3660,9,4,9,11,28,45,-17,21
Randers FC,3660,10,5,6,13,24,41,-17,21
Silkeborg IF,3660,11,5,3,14,25,48,-23,18
Brondby,3661,1,21,7,2,69,30,39,70
FC Midtjylla,3661,2,18,5,7,66,41,25,59
Copenhagen,3661,3,15,6,9,58,41,17,51
FC Nords,3661,4,14,7,9,69,50,19,49
AaB,3661,5,7,13,10,37,42,-5,34
Sonderjyske,3661,6,8,6,10,28,29,-1,30
AC Horsens,3661,7,6,12,12,35,56,-21,30
Randers FC,3661,8,6,6,12,25,39,-14,24
Silkeborg IF,3661,9,5,4,13,26,45,-19,19
AGF Aarhus,3661,10,4,7,11,17,37,-20,19
Lyngby,3661,11,3,9,12,26,46,-20,18
Brondby,3662,1,21,5,4,70,31,39,68
FC Midtjylla,3662,2,21,5,4,66,36,30,68
FC Nords,3662,3,14,7,9,74,52,22,49
Copenhagen,3662,4,13,4,13,57,47,10,43
AC Horsens,3662,5,7,13,10,36,56,-20,34
AaB,3662,6,7,12,11,40,47,-7,33
Sonderjyske,3662,7,8,6,10,28,29,-1,30
Lyngby,3662,8,4,9,11,29,45,-16,21
Randers FC,3662,9,5,6,13,24,42,-18,21
AGF Aarhus,3662,10,5,6,11,18,36,-18,21
Silkeborg IF,3662,11,5,3,14,25,46,-21,18
FC Midtjylla,3663,1,21,4,5,74,37,37,67
Brondby,3663,2,20,5,5,70,36,34,65
FC Nords,3663,3,16,6,8,72,49,23,54
Copenhagen,3663,4,13,5,12,54,46,8,44
AC Horsens,3663,5,8,12,10,37,50,-13,36
Sonderjyske,3663,6,8,6,10,28,29,-1,30
AaB,3663,7,6,12,12,35,50,-15,30
Randers FC,3663,8,6,6,12,25,40,-15,24
Silkeborg IF,3663,9,6,3,13,26,44,-18,21
Lyngby,3663,10,3,9,12,27,46,-19,18
AGF Aarhus,3663,11,4,6,12,16,37,-21,18
Brondby,3664,1,20,6,4,69,40,29,66
FC Midtjylla,3664,2,19,6,5,67,42,25,63
FC Nords,3664,3,14,8,8,71,49,22,50
Copenhagen,3664,4,14,5,11,62,43,19,47
AaB,3664,5,7,12,11,36,43,-7,33
AC Horsens,3664,6,6,15,9,37,51,-14,33
Sonderjyske,3664,7,8,6,10,28,29,-1,30
Randers FC,3664,8,5,7,12,25,41,-16,22
Silkeborg IF,3664,9,6,3,13,29,46,-17,21
Lyngby,3664,10,3,10,11,28,46,-18,19
AGF Aarhus,3664,11,4,6,12,18,40,-22,18
Brondby,3665,1,22,5,3,70,30,40,71
FC Midtjylla,3665,2,17,7,6,64,42,22,58
FC Nords,3665,3,14,7,9,74,53,21,49
Copenhagen,3665,4,13,6,11,56,45,11,45
AaB,3665,5,8,13,9,41,44,-3,37
AC Horsens,3665,6,6,14,10,35,52,-17,32
Sonderjyske,3665,7,8,6,10,28,29,-1,30
Randers FC,3665,8,6,6,12,26,41,-15,24
Silkeborg IF,3665,9,5,4,13,26,45,-19,19
AGF Aarhus,3665,10,4,7,11,17,37,-20,19
Lyngby,3665,11,3,9,12,28,47,-19,18
Brondby,3666,1,20,7,3,69,32,37,67
FC Midtjylla,3666,2,19,5,6,61,39,22,62
FC Nords,3666,3,14,8,8,69,46,23,50
Copenhagen,3666,4,15,5,10,59,42,17,50
AC Horsens,3666,5,7,13,10,35,49,-14,34
Sonderjyske,3666,6,8,6,10,28,29,-1,30
AaB,3666,7,6,12,12,33,44,-11,30
Randers FC,3666,8,5,7,12,25,41,-16,22
AGF Aarhus,3666,9,5,6,11,20,36,-16,21
Lyngby,3666,10,3,10,11,28,46,-18,19
Silkeborg IF,3666,11,5,3,14,25,48,-23,18
Brondby,3667,1,20,6,4,71,33,38,66
FC Midtjylla,3667,2,19,5,6,63,41,22,62
Copenhagen,3667,3,14,5,11,54,41,13,47
FC Nords,3667,4,13,7,10,70,56,14,46
AaB,3667,5,8,13,9,37,40,-3,37
AC Horsens,3667,6,7,14,9,41,51,-10,35
Sonderjyske,3667,7,8,6,10,28,29,-1,30
Randers FC,3667,8,5,7,12,24,40,-16,22
AGF Aarhus,3667,9,5,6,11,17,36,-19,21
Lyngby,3667,10,3,10,11,27,45,-18,19
Silkeborg IF,3667,11,5,3,14,25,45,-20,18
Brondby,3668,1,18,8,4,69,40,29,62
FC Midtjylla,3668,2,18,6,6,63,40,23,60
FC Nords,3668,3,15,6,9,75,53,22,51
Copenhagen,3668,4,15,5,10,61,41,20,50
AC Horsens,3668,5,8,12,10,39,51,-12,36
AaB,3668,6,7,13,10,36,44,-8,34
Sonderjyske,3668,7,8,6,10,28,29,-1,30
Lyngby,3668,8,4,9,11,28,44,-16,21
Silkeborg IF,3668,9,6,3,13,28,46,-18,21
Randers FC,3668,10,5,6,13,23,41,-18,21
AGF Aarhus,3668,11,4,6,12,18,39,-21,18
Brondby,3669,1,20,6,4,73,36,37,66
FC Midtjylla,3669,2,20,4,6,68,39,29,64
Copenhagen,3669,3,15,5,10,60,43,17,50
FC Nords,3669,4,14,7,9,74,53,21,49
AC Horsens,3669,5,7,13,10,34,52,-18,34
AaB,3669,6,6,13,11,35,47,-12,31
Sonderjyske,3669,7,8,6,10,28,29,-1,30
Lyngby,3669,8,4,9,11,28,44,-16,21
Randers FC,3669,9,5,6,13,23,41,-18,21
Silkeborg IF,3669,10,5,4,13,25,44,-19,19
AGF Aarhus,3669,11,4,7,11,16,36,-20,19
Brondby,3670,1,22,5,3,73,32,41,71
FC Midtjylla,3670,2,20,4,6,64,40,24,64
FC Nords,3670,3,13,7,10,73,57,16,46
Copenhagen,3670,4,14,4,12,60,47,13,46
AaB,3670,5,8,11,11,36,42,-6,35
AC Horsens,3670,6,7,13,10,35,49,-14,34
Sonderjyske,3670,7,8,6,10,28,29,-1,30
Lyngby,3670,8,4,9,11,28,44,-16,21
Randers FC,3670,9,5,6,13,23,41,-18,21
AGF Aarhus,3670,10,5,6,11,20,39,-19,21
Silkeborg IF,3670,11,5,3,14,28,48,-20,18
Brondby,3671,1,19,7,4,67,34,33,64
FC Midtjylla,3671,2,18,6,6,69,44,25,60
FC Nords,3671,3,15,7,8,72,48,24,52
Copenhagen,3671,4,13,7,10,56,43,13,46
AaB,3671,5,7,14,9,39,44,-5,35
AC Horsens,3671,6,6,15,9,36,52,-16,33
Sonderjyske,3671,7,8,6,10,28,29,-1,30
Randers FC,3671,8,5,7,12,23,39,-16,22
Lyngby,3671,9,3,10,11,26,44,-18,19
Silkeborg IF,3671,10,5,4,13,27,46,-19,19
AGF Aarhus,3671,11,4,7,11,18,38,-20,19
Brondby,3672,1,22,5,3,75,33,42,71
FC Midtjylla,3672,2,19,6,5,63,39,24,63
FC Nords,3672,3,15,7,8,74,51,23,52
Copenhagen,3672,4,12,7,11,57,48,9,43
AaB,3672,5,7,11,12,38,46,-8,32
AC Horsens,3672,6,6,14,10,36,52,-16,32
Sonderjyske,3672,7,8,6,10,28,29,-1,30
Randers FC,3672,8,6,6,12,25,40,-15,24
AGF Aarhus,3672,9,5,6,11,18,37,-19,21
Lyngby,3672,10,3,9,12,27,46,-19,18
Silkeborg IF,3672,11,5,3,14,26,46,-20,18
Brondby,3673,1,21,6,3,73,30,43,69
FC Midtjylla,3673,2,19,6,5,69,42,27,63
Copenhagen,3673,3,15,6,9,63,45,18,51
FC Nords,3673,4,12,6,12,71,59,12,42
AaB,3673,5,8,13,9,39,44,-5,37
AC Horsens,3673,6,6,13,11,36,57,-21,31
Sonderjyske,3673,7,8,6,10,28,29,-1,30
Randers FC,3673,8,5,7,12,24,40,-16,22
Lyngby,3673,9,3,10,11,27,45,-18,19
Silkeborg IF,3673,10,5,4,13,25,44,-19,19
AGF Aarhus,3673,11,4,7,11,16,36,-20,19
Brondby,3674,1,19,8,3,69,34,35,65
FC Midtjylla,3674,2,19,6,5,66,40,26,63
FC Nords,3674,3,17,6,7,76,48,28,57
Copenhagen,3674,4,12,5,13,52,43,9,41
AC Horsens,3674,5,7,13,10,35,53,-18,34
AaB,3674,6,7,12,11,38,44,-6,33
Sonderjyske,3674,7,8,6,10,28,29,-1,30
Randers FC,3674,8,5,7,12,23,39,-16,22
Silkeborg IF,3674,9,6,3,13,26,44,-18,21
Lyngby,3674,10,3,10,11,26,44,-18,19
AGF Aarhus,3674,11,4,6,12,16,37,-21,18
Brondby,3675,1,21,5,4,71,32,39,68
FC Midtjylla,3675,2,21,4,5,69,37,32,67
FC Nords,3675,3,15,6,9,72,50,22,51
Copenhagen,3675,4,15,4,11,60,44,16,49
AC Horsens,3675,5,6,13,11,36,58,-22,31
Sonderjyske,3675,6,8,6,10,28,29,-1,30
AaB,3675,7,6,12,12,34,47,-13,30
Randers FC,3675,8,6,6,12,24,39,-15,24
AGF Aarhus,3675,9,5,6,11,18,37,-19,21
Lyngby,3675,10,3,9,12,26,45,-19,18
Silkeborg IF,3675,11,5,3,14,26,46,-20,18
Brondby,3676,1,22,5,3,74,34,40,71
FC Midtjylla,3676,2,21,4,5,69,39,30,67
FC Nords,3676,3,13,8,9,73,52,21,47
Copenhagen,3676,4,13,6,11,63,49,14,45
AC Horsens,3676,5,7,13,10,37,55,-18,34
Sonderjyske,3676,6,8,6,10,28,29,-1,30
AaB,3676,7,6,12,12,36,49,-13,30
Lyngby,3676,8,4,9,11,27,44,-17,21
Randers FC,3676,9,5,6,13,23,40,-17,21
Silkeborg IF,3676,10,5,4,13,27,46,-19,19
AGF Aarhus,3676,11,4,7,11,18,38,-20,19
Brondby,3677,1,22,5,3,74,30,44,71
FC Midtjylla,3677,2,19,4,7,65,44,21,61
FC Nords,3677,3,15,7,8,74,49,25,52
Copenhagen,3677,4,13,5,12,54,47,7,44
AaB,3677,5,8,13,9,39,40,-1,37
Sonderjyske,3677,6,8,6,10,28,29,-1,30
AC Horsens,3677,7,6,12,12,32,54,-22,30
Randers FC,3677,8,6,6,12,25,39,-14,24
Silkeborg IF,3677,9,6,3,13,27,45,-18,21
Lyngby,3677,10,3,9,12,26,46,-20,18
AGF Aarhus,3677,11,4,6,12,17,38,-21,18
Brondby,3678,1,21,7,2,70,31,39,70
FC Midtjylla,3678,2,17,6,7,59,40,19,57
FC Nords,3678,3,14,7,9,73,50,23,49
Copenhagen,3678,4,14,5,11,60,46,14,47
AC Horsens,3678,5,8,13,9,40,54,-14,37
AaB,3678,6,7,12,11,34,41,-7,33
Sonderjyske,3678,7,8,6,10,28,29,-1,30
Randers FC,3678,8,6,6,12,25,39,-14,24
Silkeborg IF,3678,9,6,3,13,27,45,-18,21
Lyngby,3678,10,3,9,12,26,46,-20,18
AGF Aarhus,3678,11,4,6,12,17,38,-21,18
Brondby,3679,1,23,5,2,72,29,43,74
FC Midtjylla,3679,2,20,5,5,66,36,30,65
Copenhagen,3679,3,14,4,12,55,45,10,46
FC Nords,3679,4,13,6,11,71,56,15,45
AaB,3679,5,9,12,9,44,40,4,39
Sonderjyske,3679,6,8,6,10,28,29,-1,30
AC Horsens,3679,7,5,12,13,29,57,-28,27
Lyngby,3679,8,4,9,11,28,45,-17,21
Silkeborg IF,3679,9,6,3,13,27,44,-17,21
Randers FC,3679,10,5,6,13,24,41,-17,21
AGF Aarhus,3679,11,4,6,12,16,38,-22,18
Brondby,3680,1,20,8,2,70,29,41,68
FC Midtjylla,3680,2,20,5,5,65,40,25,65
FC Nords,3680,3,15,7,8,81,53,28,52
Copenhagen,3680,4,12,6,12,54,45,9,42
AaB,3680,5,7,13,10,34,39,-5,34
AC Horsens,3680,6,6,13,11,34,58,-24,31
Sonderjyske,3680,7,8,6,10,28,29,-1,30
Lyngby,3680,8,4,9,11,29,45,-16,21
Silkeborg IF,3680,9,6,3,13,27,44,-17,21
Randers FC,3680,10,5,6,13,24,42,-18,21
AGF Aarhus,3680,11,4,6,12,16,38,-22,18
Brondby,3681,1,21,6,3,70,29,41,69
FC Midtjylla,3681,2,21,5,4,71,35,36,68
FC Nords,3681,3,14,7,9,74,54,20,49
Copenhagen,3681,4,14,5,11,55,44,11,47
AaB,3681,5,7,12,11,37,50,-13,33
Sonderjyske,3681,6,8,6,10,28,29,-1,30
AC Horsens,3681,7,5,13,12,34,55,-21,28
Randers FC,3681,8,6,6,12,24,39,-15,24
Silkeborg IF,3681,9,6,3,13,26,44,-18,21
Lyngby,3681,10,3,9,12,26,45,-19,18
AGF Aarhus,3681,11,4,6,12,16,37,-21,18
Brondby,3682,1,21,6,3,67,30,37,69
FC Midtjylla,3682,2,20,4,6,68,38,30,64
FC Nords,3682,3,15,7,8,75,53,22,52
Copenhagen,3682,4,14,5,11,58,43,15,47
AaB,3682,5,8,11,11,36,42,-6,35
Sonderjyske,3682,6,8,6,10,28,29,-1,30
AC Horsens,3682,7,5,13,12,31,55,-24,28
Silkeborg IF,3682,8,6,3,13,29,44,-15,21
Lyngby,3682,9,4,9,11,28,45,-17,21
Randers FC,3682,10,5,6,13,24,41,-17,21
AGF Aarhus,3682,11,4,6,12,16,40,-24,18
Brondby,3683,1,21,5,4,69,32,37,68
FC Midtjylla,3683,2,19,5,6,63,39,24,62
FC Nords,3683,3,15,7,8,76,51,25,52
Copenhagen,3683,4,13,6,11,57,46,11,45
AC Horsens,3683,5,7,13,10,41,55,-14,34
AaB,3683,6,7,12,11,35,44,-9,33
Sonderjyske,3683,7,8,6,10,28,29,-1,30
Silkeborg IF,3683,8,6,3,13,30,45,-15,21
Lyngby,3683,9,4,9,11,28,45,-17,21
Randers FC,3683,10,5,6,13,24,41,-17,21
AGF Aarhus,3683,11,4,6,12,17,41,-24,18
Brondby,3684,1,21,6,3,76,30,46,69
FC Midtjylla,3684,2,21,5,4,68,38,30,68
FC Nords,3684,3,14,6,10,71,57,14,48
Copenhagen,3684,4,12,4,14,54,50,4,40
AaB,3684,5,8,13,9,42,43,-1,37
AC Horsens,3684,6,6,14,10,34,53,-19,32
Sonderjyske,3684,7,8,6,10,28,29,-1,30
Silkeborg IF,3684,8,6,3,13,31,44,-13,21
Lyngby,3684,9,4,9,11,27,44,-17,21
Randers FC,3684,10,5,6,13,23,40,-17,21
AGF Aarhus,3684,11,4,6,12,16,42,-26,18
Brondby,3685,1,22,6,2,74,30,44,72
FC Midtjylla,3685,2,21,5,4,65,36,29,68
FC Nords,3685,3,15,6,9,76,49,27,51
Copenhagen,3685,4,13,4,13,54,50,4,43
AC Horsens,3685,5,7,12,11,38,52,-14,33
Sonderjyske,3685,6,8,6,10,28,29,-1,30
AaB,3685,7,6,11,13,35,51,-16,29
Randers FC,3685,8,6,6,12,24,39,-15,24
Silkeborg IF,3685,9,6,3,13,30,45,-15,21
Lyngby,3685,10,3,9,12,26,45,-19,18
AGF Aarhus,3685,11,4,6,12,17,41,-24,18
Brondby,3686,1,20,6,4,67,33,34,66
FC Midtjylla,3686,2,19,6,5,65,38,27,63
FC Nords,3686,3,15,8,7,72,46,26,53
Copenhagen,3686,4,15,4,11,60,44,16,49
AaB,3686,5,6,13,11,33,43,-10,31
AC Horsens,3686,6,6,13,11,32,51,-19,31
Sonderjyske,3686,7,8,6,10,28,29,-1,30
Randers FC,3686,8,5,7,12,23,39,-16,22
Silkeborg IF,3686,9,6,3,13,29,46,-17,21
Lyngby,3686,10,3,10,11,26,44,-18,19
AGF Aarhus,3686,11,4,6,12,18,40,-22,18
Brondby,3687,1,21,7,2,77,38,39,70
FC Midtjylla,3687,2,19,5,6,65,39,26,62
FC Nords,3687,3,14,7,9,75,53,22,49
Copenhagen,3687,4,12,6,12,57,51,6,42
AaB,3687,5,10,11,9,44,39,5,41
Sonderjyske,3687,6,8,6,10,28,29,-1,30
AC Horsens,3687,7,5,14,11,36,60,-24,29
Lyngby,3687,8,4,9,11,27,44,-17,21
Randers FC,3687,9,5,6,13,23,40,-17,21
Silkeborg IF,3687,10,5,4,13,25,44,-19,19
AGF Aarhus,3687,11,4,7,11,16,36,-20,19
Brondby,3688,1,21,6,3,70,33,37,69
FC Midtjylla,3688,2,18,8,4,65,39,26,62
FC Nords,3688,3,15,6,9,76,50,26,51
Copenhagen,3688,4,14,5,11,56,43,13,47
AaB,3688,5,8,12,10,37,40,-3,36
Sonderjyske,3688,6,8,6,10,28,29,-1,30
AC Horsens,3688,7,5,13,12,34,59,-25,28
Lyngby,3688,8,4,9,11,28,44,-16,21
Randers FC,3688,9,5,6,13,23,41,-18,21
Silkeborg IF,3688,10,5,4,13,26,45,-19,19
AGF Aarhus,3688,11,4,7,11,17,37,-20,19
Brondby,3689,1,21,6,3,70,29,41,69
FC Midtjylla,3689,2,21,4,5,74,38,36,67
Copenhagen,3689,3,15,4,11,56,42,14,49
FC Nords,3689,4,13,6,11,68,53,15,45
AaB,3689,5,7,12,11,34,48,-14,33
AC Horsens,3689,6,7,12,11,36,54,-18,33
Sonderjyske,3689,7,8,6,10,28,29,-1,30
Lyngby,3689,8,4,9,11,29,45,-16,21
Silkeborg IF,3689,9,6,3,13,27,45,-18,21
Randers FC,3689,10,5,6,13,24,42,-18,21
AGF Aarhus,3689,11,4,6,12,17,38,-21,18
Brondby,3690,1,21,7,2,74,31,43,70
FC Midtjylla,3690,2,21,4,5,70,38,32,67
FC Nords,3690,3,13,8,9,76,58,18,47
Copenhagen,3690,4,13,5,12,58,47,11,44
AaB,3690,5,7,13,10,38,46,-8,34
AC Horsens,3690,6,6,13,11,36,58,-22,31
Sonderjyske,3690,7,8,6,10,28,29,-1,30
Randers FC,3690,8,6,6,12,24,39,-15,24
AGF Aarhus,3690,9,5,6,11,21,36,-15,21
Lyngby,3690,10,3,9,12,26,45,-19,18
Silkeborg IF,3690,11,5,3,14,25,49,-24,18
Brondby,3691,1,22,6,2,76,30,46,72
FC Midtjylla,3691,2,21,4,5,73,38,35,67
FC Nords,3691,3,14,7,9,74,55,19,49
Copenhagen,3691,4,12,6,12,53,46,7,42
AaB,3691,5,7,13,10,37,51,-14,34
Sonderjyske,3691,6,8,6,10,28,29,-1,30
AC Horsens,3691,7,6,12,12,35,54,-19,30
Lyngby,3691,8,4,9,11,30,44,-14,21
AGF Aarhus,3691,9,5,6,11,19,38,-19,21
Randers FC,3691,10,5,6,13,23,43,-20,21
Silkeborg IF,3691,11,5,3,14,27,47,-20,18
Brondby,3692,1,22,6,2,72,28,44,72
FC Midtjylla,3692,2,20,4,6,71,39,32,64
Copenhagen,3692,3,15,4,11,56,44,12,49
FC Nords,3692,4,13,7,10,74,59,15,46
AaB,3692,5,7,11,12,38,49,-11,32
AC Horsens,3692,6,6,14,10,35,53,-18,32
Sonderjyske,3692,7,8,6,10,28,29,-1,30
Lyngby,3692,8,4,9,11,28,45,-17,21
Randers FC,3692,9,5,6,13,24,41,-17,21
Silkeborg IF,3692,10,6,3,13,27,45,-18,21
AGF Aarhus,3692,11,4,6,12,17,38,-21,18
Brondby,3693,1,19,6,5,73,36,37,63
FC Midtjylla,3693,2,19,5,6,63,39,24,62
Copenhagen,3693,3,16,5,9,60,39,21,53
FC Nords,3693,4,15,7,8,78,51,27,52
AaB,3693,5,7,11,12,37,50,-13,32
AC Horsens,3693,6,6,14,10,32,54,-22,32
Sonderjyske,3693,7,8,6,10,28,29,-1,30
Lyngby,3693,8,4,9,11,27,44,-17,21
Silkeborg IF,3693,8,6,3,13,27,44,-17,21
Randers FC,3693,10,5,6,13,23,40,-17,21
AGF Aarhus,3693,11,4,6,12,16,38,-22,18
Brondby,3694,1,21,5,4,65,32,33,68
FC Midtjylla,3694,2,20,5,5,67,38,29,65
FC Nords,3694,3,14,7,9,77,54,23,49
Copenhagen,3694,4,13,6,11,59,49,10,45
AaB,3694,5,7,13,10,37,44,-7,34
AC Horsens,3694,6,7,12,11,38,52,-14,33
Sonderjyske,3694,7,8,6,10,28,29,-1,30
Lyngby,3694,8,4,9,11,29,45,-16,21
Silkeborg IF,3694,9,6,3,13,28,44,-16,21
Randers FC,3694,10,5,6,13,24,42,-18,21
AGF Aarhus,3694,11,4,6,12,16,39,-23,18
Brondby,3695,1,20,6,4,71,31,40,66
FC Midtjylla,3695,2,19,4,7,68,42,26,61
FC Nords,3695,3,14,8,8,74,52,22,50
Copenhagen,3695,4,13,7,10,55,43,12,46
AaB,3695,5,8,14,8,37,39,-2,38
AC Horsens,3695,6,6,13,11,33,57,-24,31
Sonderjyske,3695,7,8,6,10,28,29,-1,30
Randers FC,3695,8,6,6,12,25,39,-14,24
Silkeborg IF,3695,9,6,3,13,27,45,-18,21
Lyngby,3695,10,3,9,12,26,46,-20,18
AGF Aarhus,3695,11,4,6,12,17,38,-21,18
FC Midtjylla,3696,1,20,6,4,66,36,30,66
Brondby,3696,2,19,7,4,66,34,32,64
FC Nords,3696,3,14,7,9,73,53,20,49
Copenhagen,3696,4,14,4,12,55,44,11,46
AaB,3696,5,8,14,8,37,38,-1,38
Sonderjyske,3696,6,8,6,10,28,29,-1,30
AC Horsens,3696,7,6,12,12,34,52,-18,30
Randers FC,3696,8,6,6,12,25,40,-15,24
Silkeborg IF,3696,9,6,3,13,29,47,-18,21
Lyngby,3696,10,3,9,12,27,46,-19,18
AGF Aarhus,3696,11,4,6,12,19,40,-21,18
Brondby,3697,1,21,5,4,71,31,40,68
FC Midtjylla,3697,2,19,5,6,61,39,22,62
FC Nords,3697,3,14,8,8,77,51,26,50
Copenhagen,3697,4,15,4,11,60,47,13,49
AaB,3697,5,9,12,9,39,40,-1,39
Sonderjyske,3697,6,8,6,10,28,29,-1,30
AC Horsens,3697,7,5,12,13,31,57,-26,27
Silkeborg IF,3697,8,6,3,13,28,45,-17,21
Lyngby,3697,9,4,9,11,27,44,-17,21
Randers FC,3697,10,5,6,13,23,40,-17,21
AGF Aarhus,3697,11,4,6,12,17,39,-22,18
Brondby,3698,1,20,7,3,71,36,35,67
FC Midtjylla,3698,2,18,5,7,60,41,19,59
Copenhagen,3698,3,15,5,10,60,41,19,50
FC Nords,3698,4,13,10,7,71,47,24,49
AC Horsens,3698,5,7,13,10,34,53,-19,34
AaB,3698,6,7,12,11,42,46,-4,33
Sonderjyske,3698,7,8,6,10,28,29,-1,30
Silkeborg IF,3698,8,6,3,13,28,45,-17,21
Lyngby,3698,9,4,9,11,27,44,-17,21
Randers FC,3698,10,5,6,13,23,40,-17,21
AGF Aarhus,3698,11,4,6,12,17,39,-22,18
Brondby,3699,1,22,6,2,72,31,41,72
FC Midtjylla,3699,2,18,5,7,67,45,22,59
FC Nords,3699,3,15,6,9,78,56,22,51
Copenhagen,3699,4,15,5,10,58,42,16,50
AaB,3699,5,6,13,11,35,42,-7,31
AC Horsens,3699,6,6,13,11,41,61,-20,31
Sonderjyske,3699,7,8,6,10,28,29,-1,30
Randers FC,3699,8,6,6,12,26,41,-15,24
Silkeborg IF,3699,9,6,3,13,29,45,-16,21
Lyngby,3699,10,3,9,12,28,47,-19,18
AGF Aarhus,3699,11,4,6,12,17,40,-23,18
Brondby,3700,1,20,6,4,71,36,35,66
FC Midtjylla,3700,2,19,5,6,65,39,26,62
FC Nords,3700,3,13,9,8,74,53,21,48
Copenhagen,3700,4,13,7,10,61,47,14,46
AaB,3700,5,9,13,8,38,37,1,40
Sonderjyske,3700,6,8,6,10,28,29,-1,30
AC Horsens,3700,7,6,12,12,34,57,-23,30
Randers FC,3700,8,5,7,12,23,39,-16,22
AGF Aarhus,3700,9,5,6,11,20,38,-18,21
Lyngby,3700,10,3,10,11,26,44,-18,19
Silkeborg IF,3700,11,5,3,14,27,48,-21,18
Brondby,3701,1,21,7,2,72,32,40,70
FC Midtjylla,3701,2,21,4,5,70,40,30,67
FC Nords,3701,3,15,7,8,77,48,29,52
Copenhagen,3701,4,12,5,13,56,54,2,41
AaB,3701,5,8,11,11,39,43,-4,35
Sonderjyske,3701,6,8,6,10,28,29,-1,30
AC Horsens,3701,7,6,12,12,34,57,-23,30
Lyngby,3701,8,4,9,11,28,45,-17,21
Randers FC,3701,9,5,6,13,24,41,-17,21
AGF Aarhus,3701,10,5,6,11,18,37,-19,21
Silkeborg IF,3701,11,5,3,14,26,46,-20,18
Brondby,3702,1,19,7,4,68,35,33,64
FC Midtjylla,3702,2,19,5,6,66,40,26,62
Copenhagen,3702,3,15,6,9,59,40,19,51
FC Nords,3702,4,13,7,10,72,58,14,46
AaB,3702,5,8,13,9,40,40,0,37
AC Horsens,3702,6,6,14,10,33,51,-18,32
Sonderjyske,3702,7,8,6,10,28,29,-1,30
Lyngby,3702,8,4,9,11,29,44,-15,21
Silkeborg IF,3702,9,6,3,13,26,44,-18,21
Randers FC,3702,10,5,6,13,23,42,-19,21
AGF Aarhus,3702,11,4,6,12,16,37,-21,18
FC Midtjylla,3703,1,21,5,4,66,36,30,68
Brondby,3703,2,18,5,7,64,34,30,59
FC Nords,3703,3,14,8,8,72,50,22,50
Copenhagen,3703,4,15,5,10,54,40,14,50
AaB,3703,5,8,11,11,36,41,-5,35
AC Horsens,3703,6,7,12,11,34,51,-17,33
Sonderjyske,3703,7,8,6,10,28,29,-1,30
Randers FC,3703,8,5,7,12,23,39,-16,22
Silkeborg IF,3703,9,6,3,13,28,45,-17,21
Lyngby,3703,10,3,10,11,26,44,-18,19
AGF Aarhus,3703,11,4,6,12,17,39,-22,18
Brondby,3704,1,20,6,4,70,34,36,66
FC Midtjylla,3704,2,20,5,5,64,40,24,65
FC Nords,3704,3,13,9,8,72,53,19,48
Copenhagen,3704,4,14,5,11,63,45,18,47
AaB,3704,5,8,11,11,39,45,-6,35
AC Horsens,3704,6,6,14,10,34,51,-17,32
Sonderjyske,3704,7,8,6,10,28,29,-1,30
Lyngby,3704,8,4,9,11,31,46,-15,21
Silkeborg IF,3704,9,6,3,13,28,45,-17,21
Randers FC,3704,10,5,6,13,25,44,-19,21
AGF Aarhus,3704,11,4,6,12,17,39,-22,18
Brondby,3705,1,22,6,2,74,30,44,72
FC Midtjylla,3705,2,18,7,5,66,43,23,61
FC Nords,3705,3,14,7,9,73,50,23,49
Copenhagen,3705,4,12,6,12,56,49,7,42
AaB,3705,5,8,12,10,40,45,-5,36
AC Horsens,3705,6,6,14,10,33,51,-18,32
Sonderjyske,3705,7,8,6,10,28,29,-1,30
Randers FC,3705,8,6,6,12,24,39,-15,24
AGF Aarhus,3705,9,5,6,11,18,37,-19,21
Lyngby,3705,10,3,9,12,26,45,-19,18
Silkeborg IF,3705,11,5,3,14,26,46,-20,18
Brondby,3706,1,20,7,3,71,34,37,67
FC Midtjylla,3706,2,19,5,6,70,42,28,62
Copenhagen,3706,3,15,5,10,60,47,13,50
FC Nords,3706,4,14,7,9,79,57,22,49
AaB,3706,5,6,16,8,38,42,-4,34
Sonderjyske,3706,6,8,6,10,28,29,-1,30
AC Horsens,3706,7,5,14,11,34,56,-22,29
Randers FC,3706,8,5,7,12,23,39,-16,22
Silkeborg IF,3706,9,6,3,13,29,46,-17,21
Lyngby,3706,10,3,10,11,26,44,-18,19
AGF Aarhus,3706,11,4,6,12,18,40,-22,18
Brondby,3707,1,21,6,3,75,35,40,69
FC Midtjylla,3707,2,19,6,5,73,41,32,63
FC Nords,3707,3,15,7,8,79,55,24,52
Copenhagen,3707,4,13,5,12,60,50,10,44
AaB,3707,5,8,12,10,40,48,-8,36
Sonderjyske,3707,6,8,6,10,28,29,-1,30
AC Horsens,3707,7,6,12,12,35,59,-24,30
Randers FC,3707,8,6,6,12,24,39,-15,24
Silkeborg IF,3707,9,6,3,13,27,44,-17,21
Lyngby,3707,10,3,9,12,26,45,-19,18
AGF Aarhus,3707,11,4,6,12,16,38,-22,18
Brondby,3708,1,22,5,3,71,28,43,71
FC Midtjylla,3708,2,19,4,7,60,39,21,61
FC Nords,3708,3,14,7,9,71,50,21,49
Copenhagen,3708,4,14,4,12,55,44,11,46
AC Horsens,3708,5,8,12,10,35,52,-17,36
AaB,3708,6,7,12,11,39,44,-5,33
Sonderjyske,3708,7,8,6,10,28,29,-1,30
Lyngby,3708,8,4,9,11,29,44,-15,21
Silkeborg IF,3708,8,6,3,13,29,44,-15,21
Randers FC,3708,10,5,6,13,23,42,-19,21
AGF Aarhus,3708,11,4,6,12,16,40,-24,18
Brondby,3709,1,21,5,4,69,31,38,68
FC Midtjylla,3709,2,21,4,5,67,37,30,67
FC Nords,3709,3,14,8,8,76,54,22,50
Copenhagen,3709,4,13,4,13,58,49,9,43
AaB,3709,5,8,12,10,39,43,-4,36
AC Horsens,3709,6,6,13,11,35,56,-21,31
Sonderjyske,3709,7,8,6,10,28,29,-1,30
Lyngby,3709,8,4,9,11,31,45,-14,21
AGF Aarhus,3709,9,5,6,11,17,36,-19,21
Randers FC,3709,10,5,6,13,24,44,-20,21
Silkeborg IF,3709,11,5,3,14,25,45,-20,18
Brondby,3710,1,19,7,4,66,33,33,64
FC Midtjylla,3710,2,19,6,5,67,36,31,63
Copenhagen,3710,3,16,5,9,60,41,19,53
FC Nords,3710,4,12,10,8,70,52,18,46
AC Horsens,3710,5,7,13,10,33,51,-18,34
AaB,3710,6,7,11,12,38,47,-9,32
Sonderjyske,3710,7,8,6,10,28,29,-1,30
Randers FC,3710,8,6,6,12,25,40,-15,24
Silkeborg IF,3710,9,6,3,13,26,44,-18,21
Lyngby,3710,10,3,9,12,27,46,-19,18
AGF Aarhus,3710,11,4,6,12,16,37,-21,18
FC Midtjylla,3711,1,21,4,5,71,38,33,67
Brondby,3711,2,20,6,4,66,32,34,66
Copenhagen,3711,3,16,4,10,61,44,17,52
FC Nords,3711,4,13,7,10,68,51,17,46
AaB,3711,5,8,12,10,38,42,-4,36
Sonderjyske,3711,6,8,6,10,28,29,-1,30
AC Horsens,3711,7,5,13,12,31,54,-23,28
Lyngby,3711,8,4,9,11,30,46,-16,21
Silkeborg IF,3711,9,6,3,13,26,44,-18,21
Randers FC,3711,10,5,6,13,25,43,-18,21
AGF Aarhus,3711,11,4,6,12,16,37,-21,18
Brondby,3712,1,20,7,3,71,34,37,67
FC Midtjylla,3712,2,20,5,5,67,39,28,65
FC Nords,3712,3,16,6,8,78,51,27,54
Copenhagen,3712,4,14,4,12,61,50,11,46
AaB,3712,5,7,11,12,37,45,-8,32
AC Horsens,3712,6,6,13,11,35,56,-21,31
Sonderjyske,3712,7,8,6,10,28,29,-1,30
Randers FC,3712,8,5,7,12,24,40,-16,22
Lyngby,3712,9,3,10,11,27,45,-18,19
Silkeborg IF,3712,10,5,4,13,27,46,-19,19
AGF Aarhus,3712,11,4,7,11,18,38,-20,19
Brondby,3713,1,20,6,4,73,37,36,66
FC Midtjylla,3713,2,18,4,8,62,41,21,58
Copenhagen,3713,3,15,5,10,61,46,15,50
FC Nords,3713,4,13,7,10,71,54,17,46
AaB,3713,5,10,11,9,41,41,0,41
AC Horsens,3713,6,7,13,10,36,51,-15,34
Sonderjyske,3713,7,8,6,10,28,29,-1,30
Randers FC,3713,8,6,6,12,25,40,-15,24
Silkeborg IF,3713,9,6,3,13,27,45,-18,21
Lyngby,3713,10,3,9,12,27,46,-19,18
AGF Aarhus,3713,11,4,6,12,17,38,-21,18
Brondby,3714,1,21,6,3,68,31,37,69
FC Midtjylla,3714,2,19,6,5,66,39,27,63
FC Nords,3714,3,14,6,10,71,51,20,48
Copenhagen,3714,4,13,7,10,55,43,12,46
AC Horsens,3714,5,7,13,10,36,51,-15,34
AaB,3714,6,7,12,11,36,43,-7,33
Sonderjyske,3714,7,8,6,10,28,29,-1,30
Randers FC,3714,8,6,6,12,25,40,-15,24
AGF Aarhus,3714,9,5,6,11,21,39,-18,21
Lyngby,3714,10,3,9,12,27,46,-19,18
Silkeborg IF,3714,11,5,3,14,28,49,-21,18
Brondby,3715,1,23,5,2,71,27,44,74
FC Midtjylla,3715,2,21,4,5,68,39,29,67
FC Nords,3715,3,14,6,10,71,50,21,48
Copenhagen,3715,4,12,5,13,55,48,7,41
AaB,3715,5,7,12,11,36,43,-7,33
AC Horsens,3715,6,7,12,11,37,57,-20,33
Sonderjyske,3715,7,8,6,10,28,29,-1,30
Lyngby,3715,8,4,9,11,29,45,-16,21
AGF Aarhus,3715,9,5,6,11,19,36,-17,21
Randers FC,3715,10,5,6,13,24,42,-18,21
Silkeborg IF,3715,11,5,3,14,25,47,-22,18
Brondby,3716,1,18,9,3,67,34,33,63
FC Midtjylla,3716,2,19,6,5,63,36,27,63
FC Nords,3716,3,14,8,8,73,51,22,50
Copenhagen,3716,4,14,7,9,56,41,15,49
AaB,3716,5,7,14,9,38,41,-3,35
Sonderjyske,3716,6,8,6,10,28,29,-1,30
AC Horsens,3716,7,5,14,11,31,51,-20,29
Lyngby,3716,8,4,9,11,27,44,-17,21
Randers FC,3716,9,5,6,13,23,40,-17,21
AGF Aarhus,3716,10,5,6,11,19,37,-18,21
Silkeborg IF,3716,11,5,3,14,26,47,-21,18
Brondby,3717,1,20,6,4,71,35,36,66
FC Midtjylla,3717,2,18,7,5,64,39,25,61
Copenhagen,3717,3,14,5,11,61,49,12,47
FC Nords,3717,4,12,7,11,69,56,13,43
AaB,3717,5,9,13,8,41,40,1,40
AC Horsens,3717,6,7,14,9,42,55,-13,35
Sonderjyske,3717,7,8,6,10,28,29,-1,30
Lyngby,3717,8,4,9,11,27,44,-17,21
Randers FC,3717,9,5,6,13,23,40,-17,21
Silkeborg IF,3717,10,6,3,13,26,44,-18,21
AGF Aarhus,3717,11,4,6,12,16,37,-21,18
Brondby,3718,1,21,6,3,71,31,40,69
FC Midtjylla,3718,2,19,5,6,63,38,25,62
FC Nords,3718,3,14,8,8,71,52,19,50
Copenhagen,3718,4,13,5,12,56,46,10,44
AaB,3718,5,8,11,11,37,40,-3,35
AC Horsens,3718,6,7,13,10,33,50,-17,34
Sonderjyske,3718,7,8,6,10,28,29,-1,30
Silkeborg IF,3718,8,6,3,13,30,46,-16,21
Lyngby,3718,9,4,9,11,28,44,-16,21
Randers FC,3718,10,5,6,13,23,41,-18,21
AGF Aarhus,3718,11,4,6,12,18,41,-23,18
FC Midtjylla,3719,1,20,6,4,66,38,28,66
Brondby,3719,2,20,5,5,67,33,34,65
FC Nords,3719,3,14,7,9,71,49,22,49
Copenhagen,3719,4,14,4,12,57,47,10,46
AaB,3719,5,7,13,10,37,42,-5,34
AC Horsens,3719,6,7,13,10,33,48,-15,34
Sonderjyske,3719,7,8,6,10,28,29,-1,30
Randers FC,3719,8,5,7,12,25,41,-16,22
Silkeborg IF,3719,9,6,3,13,26,44,-18,21
Lyngby,3719,10,3,10,11,28,46,-18,19
AGF Aarhus,3719,11,4,6,12,16,37,-21,18
Brondby,3720,1,21,7,2,71,33,38,70
FC Midtjylla,3720,2,20,5,5,66,38,28,65
FC Nords,3720,3,13,8,9,74,54,20,47
Copenhagen,3720,4,12,7,11,55,45,10,43
AaB,3720,5,6,15,9,36,42,-6,33
AC Horsens,3720,6,6,14,10,40,56,-16,32
Sonderjyske,3720,7,8,6,10,28,29,-1,30
Lyngby,3720,8,4,9,11,27,44,-17,21
Randers FC,3720,9,5,6,13,23,40,-17,21
AGF Aarhus,3720,10,5,6,11,18,37,-19,21
Silkeborg IF,3720,11,5,3,14,26,46,-20,18
Brondby,3721,1,21,6,3,73,32,41,69
FC Midtjylla,3721,2,19,5,6,64,41,23,62
FC Nords,3721,3,14,7,9,73,54,19,49
Copenhagen,3721,4,14,6,10,59,44,15,48
AaB,3721,5,8,12,10,36,41,-5,36
Sonderjyske,3721,6,8,6,10,28,29,-1,30
AC Horsens,3721,7,5,14,11,33,52,-19,29
Randers FC,3721,8,5,7,12,24,40,-16,22
AGF Aarhus,3721,9,5,6,11,18,36,-18,21
Lyngby,3721,10,3,10,11,27,45,-18,19
Silkeborg IF,3721,11,5,3,14,25,46,-21,18
Brondby,3722,1,21,6,3,74,31,43,69
FC Midtjylla,3722,2,20,4,6,67,43,24,64
Copenhagen,3722,3,16,4,10,61,43,18,52
FC Nords,3722,4,12,7,11,70,59,11,43
AC Horsens,3722,5,7,13,10,34,48,-14,34
AaB,3722,6,7,12,11,38,46,-8,33
Sonderjyske,3722,7,8,6,10,28,29,-1,30
Randers FC,3722,8,6,6,12,28,41,-13,24
Silkeborg IF,3722,9,6,3,13,27,45,-18,21
Lyngby,3722,10,3,9,12,28,49,-21,18
AGF Aarhus,3722,11,4,6,12,17,38,-21,18
Brondby,3723,1,21,7,2,75,31,44,70
FC Midtjylla,3723,2,20,4,6,72,44,28,64
Copenhagen,3723,3,15,5,10,60,44,16,50
FC Nords,3723,4,13,6,11,71,55,16,45
AaB,3723,5,8,11,11,35,44,-9,35
AC Horsens,3723,6,6,13,11,36,57,-21,31
Sonderjyske,3723,7,8,6,10,28,29,-1,30
Randers FC,3723,8,6,6,12,27,41,-14,24
Silkeborg IF,3723,9,6,3,13,26,44,-18,21
Lyngby,3723,10,3,9,12,28,48,-20,18
AGF Aarhus,3723,11,4,6,12,16,37,-21,18
FC Midtjylla,3724,1,21,4,5,71,39,32,67
Brondby,3724,2,19,7,4,71,37,34,64
FC Nords,3724,3,14,8,8,79,55,24,50
Copenhagen,3724,4,13,6,11,57,49,8,45
AaB,3724,5,8,13,9,40,44,-4,37
Sonderjyske,3724,6,8,6,10,28,29,-1,30
AC Horsens,3724,7,5,14,11,36,56,-20,29
Lyngby,3724,8,4,9,11,29,44,-15,21
Silkeborg IF,3724,9,6,3,13,28,44,-16,21
Randers FC,3724,10,5,6,13,23,42,-19,21
AGF Aarhus,3724,11,4,6,12,16,39,-23,18
Brondby,3725,1,21,6,3,76,32,44,69
FC Midtjylla,3725,2,19,4,7,67,42,25,61
FC Nords,3725,3,15,6,9,75,55,20,51
Copenhagen,3725,4,15,4,11,61,46,15,49
AC Horsens,3725,5,8,12,10,37,51,-14,36
Sonderjyske,3725,6,8,6,10,28,29,-1,30
AaB,3725,7,6,12,12,33,49,-16,30
Randers FC,3725,8,6,6,12,24,39,-15,24
Silkeborg IF,3725,9,5,4,13,26,45,-19,19
AGF Aarhus,3725,10,4,7,11,17,37,-20,19
Lyngby,3725,11,3,9,12,26,45,-19,18
Brondby,3726,1,20,8,2,73,32,41,68
FC Midtjylla,3726,2,19,4,7,70,47,23,61
FC Nords,3726,3,13,8,9,71,52,19,47
Copenhagen,3726,4,12,6,12,53,44,9,42
AC Horsens,3726,5,9,13,8,42,49,-7,40
AaB,3726,6,7,13,10,40,51,-11,34
Sonderjyske,3726,7,8,6,10,28,29,-1,30
Randers FC,3726,8,6,6,12,25,39,-14,24
Silkeborg IF,3726,9,6,3,13,26,44,-18,21
Lyngby,3726,10,3,9,12,26,46,-20,18
AGF Aarhus,3726,11,4,6,12,16,37,-21,18
Brondby,3727,1,20,7,3,67,34,33,67
FC Midtjylla,3727,2,20,4,6,65,40,25,64
FC Nords,3727,3,16,7,7,77,48,29,55
Copenhagen,3727,4,12,5,13,53,46,7,41
AaB,3727,5,8,11,11,35,41,-6,35
AC Horsens,3727,6,7,12,11,38,52,-14,33
Sonderjyske,3727,7,8,6,10,28,29,-1,30
Lyngby,3727,8,4,9,11,28,45,-17,21
Randers FC,3727,9,5,6,13,24,41,-17,21
AGF Aarhus,3727,10,5,6,11,19,38,-19,21
Silkeborg IF,3727,11,5,3,14,27,47,-20,18
Brondby,3728,1,21,6,3,75,36,39,69
FC Midtjylla,3728,2,20,5,5,63,36,27,65
FC Nords,3728,3,13,6,11,76,59,17,45
Copenhagen,3728,4,12,6,12,60,52,8,42
AC Horsens,3728,5,8,13,9,40,52,-12,37
AaB,3728,6,7,14,9,38,43,-5,35
Sonderjyske,3728,7,8,6,10,28,29,-1,30
Lyngby,3728,8,4,9,11,28,44,-16,21
Randers FC,3728,9,5,6,13,23,41,-18,21
AGF Aarhus,3728,10,5,6,11,18,37,-19,21
Silkeborg IF,3728,11,5,3,14,26,46,-20,18
Brondby,3729,1,21,5,4,77,36,41,68
FC Midtjylla,3729,2,19,4,7,69,45,24,61
Copenhagen,3729,3,17,4,9,63,40,23,55
FC Nords,3729,4,14,6,10,73,59,14,48
AaB,3729,5,9,11,10,39,43,-4,38
Sonderjyske,3729,6,8,6,10,28,29,-1,30
AC Horsens,3729,7,5,12,13,32,56,-24,27
Lyngby,3729,8,4,9,11,27,44,-17,21
Randers FC,3729,9,5,6,13,23,40,-17,21
AGF Aarhus,3729,10,5,6,11,19,37,-18,21
Silkeborg IF,3729,11,5,3,14,26,47,-21,18
Brondby,3730,1,22,5,3,70,30,40,71
FC Midtjylla,3730,2,18,4,8,62,41,21,58
FC Nords,3730,3,14,6,10,71,52,19,48
Copenhagen,3730,4,13,6,11,55,43,12,45
AaB,3730,5,9,13,8,37,37,0,40
AC Horsens,3730,6,6,14,10,34,52,-18,32
Sonderjyske,3730,7,8,6,10,28,29,-1,30
Lyngby,3730,8,4,9,11,28,44,-16,21
Silkeborg IF,3730,9,6,3,13,27,44,-17,21
Randers FC,3730,10,5,6,13,23,41,-18,21
AGF Aarhus,3730,11,4,6,12,16,38,-22,18
Brondby,3731,1,20,5,5,67,33,34,65
FC Midtjylla,3731,2,19,4,7,64,39,25,61
Copenhagen,3731,3,16,4,10,60,42,18,52
FC Nords,3731,4,14,6,10,72,51,21,48
AaB,3731,5,10,11,9,38,40,-2,41
Sonderjyske,3731,6,8,6,10,28,29,-1,30
AC Horsens,3731,7,6,12,12,33,55,-22,30
Randers FC,3731,8,6,6,12,26,40,-14,24
Silkeborg IF,3731,9,6,3,13,28,45,-17,21
Lyngby,3731,10,3,9,12,27,47,-20,18
AGF Aarhus,3731,11,4,6,12,17,39,-22,18
FC Midtjylla,3732,1,21,5,4,66,33,33,68
Brondby,3732,2,20,5,5,67,35,32,65
FC Nords,3732,3,16,6,8,75,49,26,54
Copenhagen,3732,4,13,5,12,54,45,9,44
AaB,3732,5,7,13,10,37,41,-4,34
Sonderjyske,3732,6,8,6,10,28,29,-1,30
AC Horsens,3732,7,6,12,12,33,55,-22,30
Randers FC,3732,8,5,7,12,24,40,-16,22
Lyngby,3732,9,3,10,11,27,45,-18,19
Silkeborg IF,3732,10,5,4,13,26,45,-19,19
AGF Aarhus,3732,11,4,7,11,17,37,-20,19
Brondby,3733,1,21,5,4,71,33,38,68
FC Midtjylla,3733,2,17,6,7,63,43,20,57
FC Nords,3733,3,13,8,9,71,53,18,47
Copenhagen,3733,4,14,5,11,55,42,13,47
AaB,3733,5,8,13,9,37,41,-4,37
AC Horsens,3733,6,8,13,9,37,48,-11,37
Sonderjyske,3733,7,8,6,10,28,29,-1,30
Lyngby,3733,8,4,9,11,28,44,-16,21
Silkeborg IF,3733,9,6,3,13,27,45,-18,21
Randers FC,3733,10,5,6,13,23,41,-18,21
AGF Aarhus,3733,11,4,6,12,17,38,-21,18
Brondby,3734,1,22,6,2,71,27,44,72
FC Midtjylla,3734,2,19,5,6,66,40,26,62
FC Nords,3734,3,15,7,8,72,48,24,52
Copenhagen,3734,4,13,6,11,55,47,8,45
AaB,3734,5,7,11,12,36,47,-11,32
AC Horsens,3734,6,6,13,11,37,54,-17,31
Sonderjyske,3734,7,8,6,10,28,29,-1,30
Randers FC,3734,8,6,6,12,24,39,-15,24
AGF Aarhus,3734,9,5,6,11,17,36,-19,21
Lyngby,3734,10,3,9,12,26,45,-19,18
Silkeborg IF,3734,11,5,3,14,25,45,-20,18
Brondby,3735,1,19,7,4,72,37,35,64
FC Midtjylla,3735,2,19,5,6,66,39,27,62
FC Nords,3735,3,15,8,7,75,49,26,53
Copenhagen,3735,4,15,6,9,58,42,16,51
AC Horsens,3735,5,7,13,10,38,54,-16,34
Sonderjyske,3735,6,8,6,10,28,29,-1,30
AaB,3735,7,6,11,13,35,49,-14,29
Randers FC,3735,8,6,6,12,24,39,-15,24
AGF Aarhus,3735,9,5,6,11,21,38,-17,21
Lyngby,3735,10,3,9,12,26,45,-19,18
Silkeborg IF,3735,11,5,3,14,27,49,-22,18
Brondby,3736,1,21,6,3,72,31,41,69
FC Midtjylla,3736,2,20,4,6,64,42,22,64
FC Nords,3736,3,13,8,9,72,55,17,47
Copenhagen,3736,4,14,5,11,57,44,13,47
AaB,3736,5,8,11,11,41,43,-2,35
AC Horsens,3736,6,6,14,10,39,56,-17,32
Sonderjyske,3736,7,8,6,10,28,29,-1,30
Lyngby,3736,8,4,9,11,30,44,-14,21
Randers FC,3736,9,5,6,13,23,43,-20,21
Silkeborg IF,3736,10,5,4,13,29,48,-19,19
AGF Aarhus,3736,11,4,7,11,20,40,-20,19
Brondby,3737,1,20,8,2,69,29,40,68
FC Midtjylla,3737,2,18,7,5,63,36,27,61
FC Nords,3737,3,14,7,9,76,52,24,49
Copenhagen,3737,4,13,6,11,56,49,7,45
AaB,3737,5,7,15,8,35,38,-3,36
AC Horsens,3737,6,6,13,11,33,54,-21,31
Sonderjyske,3737,7,8,6,10,28,29,-1,30
Randers FC,3737,8,5,7,12,24,40,-16,22
AGF Aarhus,3737,9,5,6,11,20,36,-16,21
Lyngby,3737,10,3,10,11,27,45,-18,19
Silkeborg IF,3737,11,5,3,14,25,48,-23,18
Brondby,3738,1,20,7,3,72,31,41,67
FC Midtjylla,3738,2,19,5,6,64,40,24,62
FC Nords,3738,3,13,8,9,70,52,18,47
Copenhagen,3738,4,14,5,11,57,46,11,47
AaB,3738,5,8,14,8,37,38,-1,38
Sonderjyske,3738,6,8,6,10,28,29,-1,30
AC Horsens,3738,7,5,15,10,35,54,-19,30
Lyngby,3738,8,4,9,11,28,45,-17,21
Randers FC,3738,9,5,6,13,24,41,-17,21
Silkeborg IF,3738,10,5,4,13,25,44,-19,19
AGF Aarhus,3738,11,4,7,11,16,36,-20,19
FC Midtjylla,3739,1,21,5,4,74,35,39,68
Brondby,3739,2,21,5,4,68,34,34,68
Copenhagen,3739,3,15,4,11,61,42,19,49
FC Nords,3739,4,14,6,10,68,53,15,48
AaB,3739,5,8,11,11,37,46,-9,35
Sonderjyske,3739,6,8,6,10,28,29,-1,30
AC Horsens,3739,7,5,13,12,32,56,-24,28
Lyngby,3739,8,4,9,11,30,45,-15,21
Silkeborg IF,3739,9,6,3,13,27,44,-17,21
Randers FC,3739,10,5,6,13,24,43,-19,21
AGF Aarhus,3739,11,4,6,12,16,38,-22,18
FC Midtjylla,3740,1,20,5,5,64,35,29,65
Brondby,3740,2,19,7,4,64,34,30,64
FC Nords,3740,3,15,7,8,72,51,21,52
Copenhagen,3740,4,14,4,12,55,44,11,46
AaB,3740,5,7,13,10,41,44,-3,34
AC Horsens,3740,6,6,14,10,36,50,-14,32
Sonderjyske,3740,7,8,6,10,28,29,-1,30
Randers FC,3740,8,6,6,12,25,40,-15,24
Silkeborg IF,3740,9,5,4,13,26,45,-19,19
AGF Aarhus,3740,10,4,7,11,17,37,-20,19
Lyngby,3740,11,3,9,12,27,46,-19,18
FC Midtjylla,3741,1,21,5,4,72,36,36,68
Brondby,3741,2,19,7,4,70,37,33,64
FC Nords,3741,3,14,7,9,69,54,15,49
Copenhagen,3741,4,12,7,11,54,43,11,43
AaB,3741,5,9,12,9,40,41,-1,39
Sonderjyske,3741,6,8,6,10,28,29,-1,30
AC Horsens,3741,7,5,14,11,34,54,-20,29
Randers FC,3741,8,5,7,12,24,40,-16,22
Silkeborg IF,3741,9,6,3,13,27,45,-18,21
Lyngby,3741,10,3,10,11,27,45,-18,19
AGF Aarhus,3741,11,4,6,12,17,38,-21,18
Brondby,3742,1,22,6,2,71,31,40,72
FC Midtjylla,3742,2,19,6,5,65,39,26,63
Copenhagen,3742,3,14,5,11,58,45,13,47
FC Nords,3742,4,13,7,10,70,52,18,46
AaB,3742,5,8,11,11,37,42,-5,35
AC Horsens,3742,6,6,13,11,34,52,-18,31
Sonderjyske,3742,7,8,6,10,28,29,-1,30
Randers FC,3742,8,5,7,12,24,40,-16,22
Silkeborg IF,3742,9,6,3,13,26,44,-18,21
Lyngby,3742,10,3,10,11,27,45,-18,19
AGF Aarhus,3742,11,4,6,12,16,37,-21,18
Brondby,3743,1,22,5,3,70,29,41,71
FC Midtjylla,3743,2,19,4,7,69,46,23,61
FC Nords,3743,3,16,6,8,72,47,25,54
Copenhagen,3743,4,15,5,10,60,46,14,50
AC Horsens,3743,5,6,13,11,36,54,-18,31
Sonderjyske,3743,6,8,6,10,28,29,-1,30
AaB,3743,7,6,11,13,31,42,-11,29
Randers FC,3743,8,5,7,12,24,40,-16,22
Lyngby,3743,9,3,10,11,27,45,-18,19
Silkeborg IF,3743,10,5,4,13,26,45,-19,19
AGF Aarhus,3743,11,4,7,11,17,37,-20,19
Brondby,3744,1,22,6,2,73,29,44,72
FC Midtjylla,3744,2,19,6,5,64,39,25,63
FC Nords,3744,3,14,7,9,80,56,24,49
Copenhagen,3744,4,13,6,11,57,46,11,45
AaB,3744,5,8,12,10,38,44,-6,36
Sonderjyske,3744,6,8,6,10,28,29,-1,30
AC Horsens,3744,7,5,13,12,32,56,-24,28
Silkeborg IF,3744,8,6,3,13,30,44,-14,21
Lyngby,3744,9,4,9,11,29,45,-16,21
Randers FC,3744,10,5,6,13,24,42,-18,21
AGF Aarhus,3744,11,4,6,12,16,41,-25,18
Brondby,3745,1,21,6,3,76,34,42,69
FC Midtjylla,3745,2,21,4,5,69,40,29,67
FC Nords,3745,3,14,7,9,72,54,18,49
Copenhagen,3745,4,13,4,13,56,47,9,43
AaB,3745,5,8,11,11,37,44,-7,35
AC Horsens,3745,6,7,12,11,34,51,-17,33
Sonderjyske,3745,7,8,6,10,28,29,-1,30
Randers FC,3745,8,6,6,12,25,40,-15,24
Silkeborg IF,3745,9,6,3,13,26,44,-18,21
Lyngby,3745,10,3,9,12,27,46,-19,18
AGF Aarhus,3745,11,4,6,12,16,37,-21,18
Brondby,3746,1,21,6,3,68,30,38,69
FC Midtjylla,3746,2,19,5,6,64,39,25,62
FC Nords,3746,3,13,8,9,74,51,23,47
Copenhagen,3746,4,12,6,12,52,48,4,42
AaB,3746,5,8,14,8,37,37,0,38
AC Horsens,3746,6,6,15,9,34,50,-16,33
Sonderjyske,3746,7,8,6,10,28,29,-1,30
Randers FC,3746,8,6,6,12,25,39,-14,24
Silkeborg IF,3746,9,6,3,13,26,44,-18,21
Lyngby,3746,10,3,9,12,26,46,-20,18
AGF Aarhus,3746,11,4,6,12,16,37,-21,18
Brondby,3747,1,23,5,2,77,31,46,74
FC Midtjylla,3747,2,19,6,5,66,40,26,63
FC Nords,3747,3,15,7,8,74,51,23,52
Copenhagen,3747,4,12,6,12,60,51,9,42
AC Horsens,3747,5,7,12,11,36,54,-18,33
Sonderjyske,3747,6,8,6,10,28,29,-1,30
AaB,3747,7,6,12,12,34,46,-12,30
Randers FC,3747,8,6,6,12,24,39,-15,24
Silkeborg IF,3747,9,6,3,13,28,44,-16,21
Lyngby,3747,10,3,9,12,26,45,-19,18
AGF Aarhus,3747,11,4,6,12,16,39,-23,18
Brondby,3748,1,19,7,4,69,35,34,64
FC Midtjylla,3748,2,19,5,6,63,40,23,62
FC Nords,3748,3,16,6,8,76,50,26,54
Copenhagen,3748,4,15,5,10,60,43,17,50
AaB,3748,5,8,12,10,38,42,-4,36
Sonderjyske,3748,6,8,6,10,28,29,-1,30
AC Horsens,3748,7,5,13,12,32,54,-22,28
Lyngby,3748,8,4,9,11,27,44,-17,21
Randers FC,3748,9,5,6,13,23,40,-17,21
AGF Aarhus,3748,10,5,6,11,17,36,-19,21
Silkeborg IF,3748,11,5,3,14,25,45,-20,18
Brondby,3749,1,21,6,3,76,34,42,69
FC Midtjylla,3749,2,19,5,6,68,43,25,62
FC Nords,3749,3,13,8,9,76,59,17,47
Copenhagen,3749,4,12,6,12,54,47,7,42
AaB,3749,5,7,15,8,38,41,-3,36
AC Horsens,3749,6,7,14,9,38,52,-14,35
Sonderjyske,3749,7,8,6,10,28,29,-1,30
Randers FC,3749,8,6,6,12,26,41,-15,24
Silkeborg IF,3749,9,6,3,13,28,44,-16,21
Lyngby,3749,10,3,9,12,28,47,-19,18
AGF Aarhus,3749,11,4,6,12,16,39,-23,18
Brondby,3750,1,20,7,3,72,37,35,67
FC Midtjylla,3750,2,19,6,5,69,44,25,63
FC Nords,3750,3,15,8,7,72,46,26,53
Copenhagen,3750,4,13,6,11,57,42,15,45
AaB,3750,5,6,14,10,41,48,-7,32
AC Horsens,3750,6,6,13,11,34,54,-20,31
Sonderjyske,3750,7,8,6,10,28,29,-1,30
Lyngby,3750,8,4,9,11,28,44,-16,21
Randers FC,3750,9,5,6,13,23,41,-18,21
Silkeborg IF,3750,10,5,4,13,27,46,-19,19
AGF Aarhus,3750,11,4,7,11,18,38,-20,19
Brondby,3751,1,21,6,3,71,34,37,69
FC Midtjylla,3751,2,20,4,6,66,39,27,64
Copenhagen,3751,3,15,5,10,58,46,12,50
FC Nords,3751,4,14,6,10,79,55,24,48
AaB,3751,5,8,13,9,39,40,-1,37
Sonderjyske,3751,6,8,6,10,28,29,-1,30
AC Horsens,3751,7,5,12,13,31,56,-25,27
Randers FC,3751,8,6,6,12,25,40,-15,24
Silkeborg IF,3751,9,5,4,13,26,45,-19,19
AGF Aarhus,3751,10,4,7,11,17,37,-20,19
Lyngby,3751,11,3,9,12,27,46,-19,18
FC Midtjylla,3752,1,21,4,5,67,36,31,67
Brondby,3752,2,19,8,3,64,28,36,65
Copenhagen,3752,3,15,5,10,57,41,16,50
FC Nords,3752,4,12,8,10,71,55,16,44
AaB,3752,5,7,12,11,36,44,-8,33
AC Horsens,3752,6,6,15,9,36,53,-17,33
Sonderjyske,3752,7,8,6,10,28,29,-1,30
Lyngby,3752,8,4,9,11,29,46,-17,21
Randers FC,3752,9,5,6,13,25,42,-17,21
AGF Aarhus,3752,10,5,6,11,18,37,-19,21
Silkeborg IF,3752,11,5,3,14,26,46,-20,18
Brondby,3753,1,22,5,3,72,29,43,71
FC Midtjylla,3753,2,20,5,5,66,38,28,65
FC Nords,3753,3,14,7,9,73,52,21,49
Copenhagen,3753,4,12,6,12,54,46,8,42
AaB,3753,5,8,12,10,35,44,-9,36
AC Horsens,3753,6,6,13,11,32,49,-17,31
Sonderjyske,3753,7,8,6,10,28,29,-1,30
Lyngby,3753,8,4,9,11,27,44,-17,21
Randers FC,3753,9,5,6,13,23,40,-17,21
Silkeborg IF,3753,10,6,3,13,26,44,-18,21
AGF Aarhus,3753,11,4,6,12,16,37,-21,18
FC Midtjylla,3754,1,22,4,4,71,34,37,70
Brondby,3754,2,21,5,4,75,33,42,68
FC Nords,3754,3,13,7,10,81,65,16,46
Copenhagen,3754,4,12,6,12,54,46,8,42
AaB,3754,5,9,11,10,42,41,1,38
AC Horsens,3754,6,6,13,11,33,63,-30,31
Sonderjyske,3754,7,8,6,10,28,29,-1,30
Randers FC,3754,8,5,7,12,24,40,-16,22
Lyngby,3754,9,3,10,11,27,45,-18,19
Silkeborg IF,3754,10,5,4,13,27,46,-19,19
AGF Aarhus,3754,11,4,7,11,18,38,-20,19
Brondby,3755,1,20,7,3,70,33,37,67
FC Midtjylla,3755,2,20,5,5,71,41,30,65
FC Nords,3755,3,15,7,8,77,52,25,52
Copenhagen,3755,4,14,5,11,56,47,9,47
AC Horsens,3755,5,6,14,10,36,53,-17,32
Sonderjyske,3755,6,8,6,10,28,29,-1,30
AaB,3755,7,6,12,12,33,43,-10,30
Randers FC,3755,8,6,6,12,25,40,-15,24
Silkeborg IF,3755,9,6,3,13,29,45,-16,21
Lyngby,3755,10,3,9,12,27,46,-19,18
AGF Aarhus,3755,11,4,6,12,17,40,-23,18
Brondby,3756,1,22,5,3,69,28,41,71
FC Midtjylla,3756,2,21,4,5,67,39,28,67
Copenhagen,3756,3,14,5,11,57,44,13,47
FC Nords,3756,4,12,6,12,67,55,12,42
AaB,3756,5,7,13,10,36,40,-4,34
AC Horsens,3756,6,7,13,10,34,50,-16,34
Sonderjyske,3756,7,8,6,10,28,29,-1,30
Lyngby,3756,8,4,9,11,27,44,-17,21
Silkeborg IF,3756,8,6,3,13,27,44,-17,21
Randers FC,3756,10,5,6,13,23,40,-17,21
AGF Aarhus,3756,11,4,6,12,16,38,-22,18
Brondby,3757,1,23,5,2,73,28,45,74
FC Midtjylla,3757,2,18,6,6,60,40,20,60
FC Nords,3757,3,14,7,9,70,50,20,49
Copenhagen,3757,4,13,5,12,57,45,12,44
AC Horsens,3757,5,7,13,10,34,49,-15,34
AaB,3757,6,7,12,11,36,44,-8,33
Sonderjyske,3757,7,8,6,10,28,29,-1,30
Randers FC,3757,8,5,7,12,24,40,-16,22
Lyngby,3757,9,3,10,11,27,45,-18,19
Silkeborg IF,3757,10,5,4,13,26,45,-19,19
AGF Aarhus,3757,11,4,7,11,17,37,-20,19
Brondby,3758,1,21,6,3,70,32,38,69
FC Midtjylla,3758,2,20,4,6,70,41,29,64
FC Nords,3758,3,14,7,9,75,54,21,49
Copenhagen,3758,4,13,5,12,55,46,9,44
AaB,3758,5,7,15,8,35,38,-3,36
AC Horsens,3758,6,6,13,11,40,60,-20,31
Sonderjyske,3758,7,8,6,10,28,29,-1,30
Randers FC,3758,8,5,7,12,24,40,-16,22
Lyngby,3758,9,3,10,11,27,45,-18,19
Silkeborg IF,3758,10,5,4,13,27,46,-19,19
AGF Aarhus,3758,11,4,7,11,18,38,-20,19
Brondby,3759,1,20,6,4,67,32,35,66
FC Midtjylla,3759,2,19,5,6,63,36,27,62
Copenhagen,3759,3,15,5,10,61,45,16,50
FC Nords,3759,4,14,7,9,71,50,21,49
AaB,3759,5,8,11,11,35,44,-9,35
AC Horsens,3759,6,6,14,10,34,50,-16,32
Sonderjyske,3759,7,8,6,10,28,29,-1,30
Randers FC,3759,8,6,6,12,25,40,-15,24
Silkeborg IF,3759,9,6,3,13,26,44,-18,21
Lyngby,3759,10,3,9,12,27,46,-19,18
AGF Aarhus,3759,11,4,6,12,16,37,-21,18
Brondby,3760,1,20,5,5,74,37,37,65
FC Midtjylla,3760,2,20,5,5,69,39,30,65
FC Nords,3760,3,13,7,10,76,57,19,46
Copenhagen,3760,4,14,4,12,57,49,8,46
AaB,3760,5,9,11,10,37,41,-4,38
AC Horsens,3760,6,8,12,10,38,54,-16,36
Sonderjyske,3760,7,8,6,10,28,29,-1,30
Randers FC,3760,8,5,7,12,24,40,-16,22
Silkeborg IF,3760,9,6,3,13,28,45,-17,21
Lyngby,3760,10,3,10,11,27,45,-18,19
AGF Aarhus,3760,11,4,6,12,17,39,-22,18
Brondby,3761,1,21,5,4,72,35,37,68
FC Midtjylla,3761,2,21,5,4,70,36,34,68
Copenhagen,3761,3,16,5,9,60,40,20,53
FC Nords,3761,4,13,7,10,72,55,17,46
Sonderjyske,3761,5,8,6,10,28,29,-1,30
AaB,3761,6,6,12,12,34,45,-11,30
AC Horsens,3761,7,6,12,12,34,57,-23,30
Randers FC,3761,8,5,7,12,25,41,-16,22
Silkeborg IF,3761,9,6,3,13,27,44,-17,21
Lyngby,3761,10,3,10,11,28,46,-18,19
AGF Aarhus,3761,11,4,6,12,16,38,-22,18
Brondby,3762,1,20,7,3,68,32,36,67
FC Midtjylla,3762,2,19,7,4,68,38,30,64
FC Nords,3762,3,14,7,9,73,54,19,49
Copenhagen,3762,4,13,6,11,56,46,10,45
AaB,3762,5,7,13,10,43,47,-4,34
AC Horsens,3762,6,6,14,10,35,52,-17,32
Sonderjyske,3762,7,8,6,10,28,29,-1,30
Randers FC,3762,8,6,6,12,25,39,-14,24
AGF Aarhus,3762,9,5,6,11,17,36,-19,21
Lyngby,3762,10,3,9,12,26,46,-20,18
Silkeborg IF,3762,11,5,3,14,25,45,-20,18
Brondby,3763,1,22,5,3,73,31,42,71
FC Midtjylla,3763,2,20,5,5,66,40,26,65
FC Nords,3763,3,15,6,9,76,54,22,51
Copenhagen,3763,4,13,5,12,55,45,10,44
AC Horsens,3763,5,8,12,10,36,51,-15,36
Sonderjyske,3763,6,8,6,10,28,29,-1,30
AaB,3763,7,6,11,13,35,46,-11,29
Randers FC,3763,8,6,6,12,26,40,-14,24
Silkeborg IF,3763,9,6,3,13,27,45,-18,21
Lyngby,3763,10,3,9,12,27,47,-20,18
AGF Aarhus,3763,11,4,6,12,17,38,-21,18
Brondby,3764,1,22,6,2,74,32,42,72
FC Midtjylla,3764,2,18,4,8,63,41,22,58
Copenhagen,3764,3,16,5,9,64,43,21,53
FC Nords,3764,4,14,7,9,72,54,18,49
AaB,3764,5,7,13,10,35,41,-6,34
Sonderjyske,3764,6,8,6,10,28,29,-1,30
AC Horsens,3764,7,5,13,12,31,54,-23,28
Randers FC,3764,8,6,6,12,27,41,-14,24
Silkeborg IF,3764,9,6,3,13,27,44,-17,21
Lyngby,3764,10,3,9,12,28,48,-20,18
AGF Aarhus,3764,11,4,6,12,16,38,-22,18
Brondby,3765,1,21,6,3,73,30,43,69
FC Midtjylla,3765,2,20,5,5,63,36,27,65
FC Nords,3765,3,15,6,9,73,46,27,51
Copenhagen,3765,4,13,5,12,56,48,8,44
AaB,3765,5,8,13,9,35,37,-2,37
Sonderjyske,3765,6,8,6,10,28,29,-1,30
AC Horsens,3765,7,5,13,12,33,62,-29,28
Randers FC,3765,8,6,6,12,25,40,-15,24
Silkeborg IF,3765,9,6,3,13,27,45,-18,21
Lyngby,3765,10,3,9,12,27,46,-19,18
AGF Aarhus,3765,11,4,6,12,17,38,-21,18
Brondby,3766,1,21,5,4,69,36,33,68
FC Midtjylla,3766,2,19,5,6,70,39,31,62
FC Nords,3766,3,14,6,10,72,55,17,48
Copenhagen,3766,4,14,4,12,54,45,9,46
AaB,3766,5,9,12,9,38,39,-1,39
AC Horsens,3766,6,6,14,10,40,55,-15,32
Sonderjyske,3766,7,8,6,10,28,29,-1,30
Randers FC,3766,8,6,6,12,25,39,-14,24
AGF Aarhus,3766,9,5,6,11,17,36,-19,21
Lyngby,3766,10,3,9,12,26,46,-20,18
Silkeborg IF,3766,11,5,3,14,25,45,-20,18
Brondby,3767,1,22,6,2,75,30,45,72
FC Midtjylla,3767,2,19,6,5,64,40,24,63
FC Nords,3767,3,13,7,10,73,54,19,46
Copenhagen,3767,4,13,6,11,56,45,11,45
AaB,3767,5,8,13,9,40,43,-3,37
Sonderjyske,3767,6,8,6,10,28,29,-1,30
AC Horsens,3767,7,5,14,11,32,54,-22,29
Randers FC,3767,8,6,6,12,24,39,-15,24
AGF Aarhus,3767,9,5,6,11,17,36,-19,21
Lyngby,3767,10,3,9,12,26,45,-19,18
Silkeborg IF,3767,11,5,3,14,25,45,-20,18
Brondby,3768,1,21,6,3,76,31,45,69
FC Midtjylla,3768,2,19,5,6,66,40,26,62
FC Nords,3768,3,16,6,8,78,49,29,54
Copenhagen,3768,4,14,6,10,59,45,14,48
AaB,3768,5,6,13,11,38,51,-13,31
Sonderjyske,3768,6,8,6,10,28,29,-1,30
AC Horsens,3768,7,5,14,11,33,60,-27,29
Randers FC,3768,8,6,6,12,26,41,-15,24
Silkeborg IF,3768,9,6,3,13,28,44,-16,21
Lyngby,3768,10,3,9,12,28,47,-19,18
AGF Aarhus,3768,11,4,6,12,16,39,-23,18
Brondby,3769,1,20,7,3,70,36,34,67
FC Midtjylla,3769,2,20,5,5,72,38,34,65
FC Nords,3769,3,13,8,9,76,52,24,47
Copenhagen,3769,4,14,5,11,57,49,8,47
AaB,3769,5,8,13,9,39,44,-5,37
Sonderjyske,3769,6,8,6,10,28,29,-1,30
AC Horsens,3769,7,5,14,11,34,55,-21,29
Randers FC,3769,8,5,7,12,24,40,-16,22
Silkeborg IF,3769,9,6,3,13,26,44,-18,21
Lyngby,3769,10,3,10,11,27,45,-18,19
AGF Aarhus,3769,11,4,6,12,16,37,-21,18
Brondby,3770,1,21,6,3,71,32,39,69
FC Midtjylla,3770,2,19,5,6,63,39,24,62
FC Nords,3770,3,14,6,10,70,54,16,48
Copenhagen,3770,4,14,5,11,56,41,15,47
AaB,3770,5,9,11,10,41,41,0,38
AC Horsens,3770,6,6,13,11,34,54,-20,31
Sonderjyske,3770,7,8,6,10,28,29,-1,30
Randers FC,3770,8,6,6,12,25,40,-15,24
Silkeborg IF,3770,9,5,4,13,27,46,-19,19
AGF Aarhus,3770,10,4,7,11,18,38,-20,19
Lyngby,3770,11,3,9,12,27,46,-19,18
Brondby,3771,1,21,5,4,69,34,35,68
FC Midtjylla,3771,2,17,5,8,58,41,17,56
FC Nords,3771,3,15,8,7,77,51,26,53
Copenhagen,3771,4,16,5,9,62,40,22,53
AC Horsens,3771,5,7,12,11,36,52,-16,33
AaB,3771,6,6,13,11,33,43,-10,31
Sonderjyske,3771,7,8,6,10,28,29,-1,30
Randers FC,3771,8,5,7,12,23,39,-16,22
AGF Aarhus,3771,9,5,6,11,17,36,-19,21
Lyngby,3771,10,3,10,11,26,44,-18,19
Silkeborg IF,3771,11,5,3,14,25,45,-20,18
Brondby,3772,1,23,5,2,79,32,47,74
FC Midtjylla,3772,2,21,4,5,70,41,29,67
FC Nords,3772,3,14,6,10,72,54,18,48
Copenhagen,3772,4,13,5,12,62,51,11,44
AaB,3772,5,6,13,11,34,44,-10,31
AC Horsens,3772,6,6,13,11,33,54,-21,31
Sonderjyske,3772,7,8,6,10,28,29,-1,30
Randers FC,3772,8,6,6,12,25,40,-15,24
AGF Aarhus,3772,9,5,6,11,18,36,-18,21
Lyngby,3772,10,3,9,12,27,46,-19,18
Silkeborg IF,3772,11,5,3,14,25,46,-21,18
Brondby,3773,1,21,6,3,76,33,43,69
FC Midtjylla,3773,2,19,6,5,63,39,24,63
FC Nords,3773,3,14,8,8,71,49,22,50
Copenhagen,3773,4,13,5,12,55,43,12,44
AaB,3773,5,7,13,10,37,45,-8,34
AC Horsens,3773,6,6,14,10,35,54,-19,32
Sonderjyske,3773,7,8,6,10,28,29,-1,30
Lyngby,3773,8,4,9,11,28,45,-17,21
Randers FC,3773,9,5,6,13,24,41,-17,21
Silkeborg IF,3773,10,5,4,13,26,45,-19,19
AGF Aarhus,3773,11,4,7,11,17,37,-20,19
FC Midtjylla,3774,1,21,5,4,72,37,35,68
Brondby,3774,2,20,5,5,68,35,33,65
Copenhagen,3774,3,14,5,11,56,49,7,47
FC Nords,3774,4,13,6,11,76,59,17,45
AC Horsens,3774,5,9,12,9,41,49,-8,39
AaB,3774,6,7,11,12,37,47,-10,32
Sonderjyske,3774,7,8,6,10,28,29,-1,30
Randers FC,3774,8,6,6,12,24,39,-15,24
AGF Aarhus,3774,9,5,6,11,18,37,-19,21
Lyngby,3774,10,3,9,12,26,45,-19,18
Silkeborg IF,3774,11,5,3,14,26,46,-20,18
Brondby,3775,1,21,6,3,71,30,41,69
FC Midtjylla,3775,2,20,5,5,65,41,24,65
FC Nords,3775,3,15,7,8,70,46,24,52
Copenhagen,3775,4,14,4,12,56,44,12,46
AaB,3775,5,8,12,10,37,40,-3,36
Sonderjyske,3775,6,8,6,10,28,29,-1,30
AC Horsens,3775,7,5,12,13,33,57,-24,27
Lyngby,3775,8,4,9,11,28,44,-16,21
Randers FC,3775,9,5,6,13,23,41,-18,21
AGF Aarhus,3775,10,5,6,11,18,37,-19,21
Silkeborg IF,3775,11,5,3,14,26,46,-20,18
Brondby,3776,1,21,6,3,75,33,42,69
FC Midtjylla,3776,2,20,5,5,64,37,27,65
FC Nords,3776,3,15,6,9,73,54,19,51
Copenhagen,3776,4,14,4,12,56,44,12,46
AaB,3776,5,7,12,11,36,43,-7,33
AC Horsens,3776,6,6,13,11,32,51,-19,31
Sonderjyske,3776,7,8,6,10,28,29,-1,30
Lyngby,3776,8,4,9,11,27,44,-17,21
Randers FC,3776,9,5,6,13,23,40,-17,21
AGF Aarhus,3776,10,5,6,11,19,37,-18,21
Silkeborg IF,3776,11,5,3,14,26,47,-21,18
Brondby,3777,1,19,8,3,67,30,37,65
FC Midtjylla,3777,2,19,5,6,67,42,25,62
FC Nords,3777,3,15,7,8,75,48,27,52
Copenhagen,3777,4,14,6,10,55,42,13,48
AaB,3777,5,7,13,10,38,46,-8,34
AC Horsens,3777,6,6,13,11,33,53,-20,31
Sonderjyske,3777,7,8,6,10,28,29,-1,30
Randers FC,3777,8,6,6,12,24,39,-15,24
Silkeborg IF,3777,9,6,3,13,27,45,-18,21
Lyngby,3777,10,3,9,12,26,45,-19,18
AGF Aarhus,3777,11,4,6,12,17,38,-21,18
Brondby,3778,1,21,6,3,71,34,37,69
FC Midtjylla,3778,2,20,4,6,69,43,26,64
Copenhagen,3778,3,15,4,11,63,44,19,49
FC Nords,3778,4,12,7,11,69,56,13,43
AC Horsens,3778,5,8,12,10,39,58,-19,36
AaB,3778,6,8,11,11,42,44,-2,35
Sonderjyske,3778,7,8,6,10,28,29,-1,30
Lyngby,3778,8,4,9,11,29,44,-15,21
Silkeborg IF,3778,9,6,3,13,28,46,-18,21
Randers FC,3778,10,5,6,13,23,42,-19,21
AGF Aarhus,3778,11,4,6,12,18,39,-21,18
Brondby,3779,1,18,9,3,67,33,34,63
FC Midtjylla,3779,2,19,6,5,61,39,22,63
FC Nords,3779,3,15,8,7,74,47,27,53
Copenhagen,3779,4,14,7,9,59,41,18,49
AaB,3779,5,6,13,11,35,42,-7,31
Sonderjyske,3779,6,8,6,10,28,29,-1,30
AC Horsens,3779,7,5,15,10,34,54,-20,30
Lyngby,3779,8,4,9,11,28,45,-17,21
Randers FC,3779,9,5,6,13,24,41,-17,21
Silkeborg IF,3779,10,6,3,13,26,44,-18,21
AGF Aarhus,3779,11,4,6,12,16,37,-21,18
Brondby,3780,1,20,7,3,66,30,36,67
FC Midtjylla,3780,2,19,6,5,68,40,28,63
FC Nords,3780,3,15,7,8,74,46,28,52
Copenhagen,3780,4,13,5,12,57,53,4,44
AaB,3780,5,8,12,10,39,44,-5,36
AC Horsens,3780,6,6,13,11,35,52,-17,31
Sonderjyske,3780,7,8,6,10,28,29,-1,30
Lyngby,3780,8,4,9,11,30,45,-15,21
Silkeborg IF,3780,9,6,3,13,26,44,-18,21
Randers FC,3780,10,5,6,13,24,43,-19,21
AGF Aarhus,3780,11,4,6,12,16,37,-21,18
Brondby,3781,1,22,6,2,76,28,48,72
FC Midtjylla,3781,2,18,6,6,65,44,21,60
FC Nords,3781,3,16,6,8,77,51,26,54
Copenhagen,3781,4,13,4,13,59,50,9,43
AaB,3781,5,8,12,10,40,45,-5,36
Sonderjyske,3781,6,8,6,10,28,29,-1,30
AC Horsens,3781,7,6,12,12,32,57,-25,30
Lyngby,3781,8,4,9,11,30,44,-14,21
Silkeborg IF,3781,9,6,3,13,28,46,-18,21
Randers FC,3781,10,5,6,13,23,43,-20,21
AGF Aarhus,3781,11,4,6,12,18,39,-21,18
FC Midtjylla,3782,1,21,5,4,68,37,31,68
Brondby,3782,2,19,7,4,71,38,33,64
FC Nords,3782,3,14,7,9,74,54,20,49
Copenhagen,3782,4,13,5,12,53,44,9,44
AaB,3782,5,8,13,9,44,45,-1,37
AC Horsens,3782,6,6,13,11,35,53,-18,31
Sonderjyske,3782,7,8,6,10,28,29,-1,30
Lyngby,3782,8,4,9,11,30,47,-17,21
Randers FC,3782,9,5,6,13,26,43,-17,21
Silkeborg IF,3782,10,6,3,13,27,45,-18,21
AGF Aarhus,3782,11,4,6,12,17,38,-21,18
Brondby,3783,1,21,5,4,74,32,42,68
FC Midtjylla,3783,2,20,5,5,69,37,32,65
FC Nords,3783,3,14,6,10,72,55,17,48
Copenhagen,3783,4,13,5,12,56,47,9,44
AC Horsens,3783,5,8,12,10,40,54,-14,36
AaB,3783,6,8,11,11,39,51,-12,35
Sonderjyske,3783,7,8,6,10,28,29,-1,30
Randers FC,3783,8,6,6,12,24,39,-15,24
AGF Aarhus,3783,9,5,6,11,18,36,-18,21
Lyngby,3783,10,3,9,12,26,45,-19,18
Silkeborg IF,3783,11,5,3,14,25,46,-21,18
Brondby,3784,1,20,7,3,71,33,38,67
FC Midtjylla,3784,2,20,5,5,66,36,30,65
FC Nords,3784,3,15,6,9,77,51,26,51
Copenhagen,3784,4,15,4,11,63,46,17,49
AaB,3784,5,7,11,12,35,48,-13,32
AC Horsens,3784,6,6,13,11,32,56,-24,31
Sonderjyske,3784,7,8,6,10,28,29,-1,30
Lyngby,3784,8,4,9,11,27,44,-17,21
Randers FC,3784,9,5,6,13,23,40,-17,21
Silkeborg IF,3784,10,5,4,13,26,45,-19,19
AGF Aarhus,3784,11,4,7,11,17,37,-20,19
Brondby,3785,1,21,7,2,75,30,45,70
FC Midtjylla,3785,2,19,5,6,67,45,22,62
FC Nords,3785,3,15,6,9,68,50,18,51
Copenhagen,3785,4,14,5,11,60,43,17,47
AaB,3785,5,8,11,11,37,44,-7,35
Sonderjyske,3785,6,8,6,10,28,29,-1,30
AC Horsens,3785,7,6,12,12,34,55,-21,30
Lyngby,3785,8,4,9,11,29,44,-15,21
Silkeborg IF,3785,9,6,3,13,27,44,-17,21
Randers FC,3785,10,5,6,13,23,42,-19,21
AGF Aarhus,3785,11,4,6,12,16,38,-22,18
Brondby,3786,1,20,7,3,74,37,37,67
FC Midtjylla,3786,2,20,5,5,71,43,28,65
FC Nords,3786,3,16,7,7,78,51,27,55
Copenhagen,3786,4,13,6,11,59,48,11,45
AaB,3786,5,6,13,11,33,42,-9,31
Sonderjyske,3786,6,8,6,10,28,29,-1,30
AC Horsens,3786,7,5,14,11,36,56,-20,29
Randers FC,3786,8,6,6,12,24,39,-15,24
AGF Aarhus,3786,9,5,6,11,20,39,-19,21
Lyngby,3786,10,3,9,12,26,45,-19,18
Silkeborg IF,3786,11,5,3,14,28,48,-20,18
Brondby,3787,1,22,5,3,75,32,43,71
FC Midtjylla,3787,2,20,6,4,70,37,33,66
FC Nords,3787,3,14,7,9,74,54,20,49
Copenhagen,3787,4,13,5,12,59,49,10,44
AaB,3787,5,7,14,9,34,39,-5,35
Sonderjyske,3787,6,8,6,10,28,29,-1,30
AC Horsens,3787,7,5,13,12,33,60,-27,28
Randers FC,3787,8,6,6,12,25,40,-15,24
Silkeborg IF,3787,9,5,4,13,25,44,-19,19
AGF Aarhus,3787,10,4,7,11,16,36,-20,19
Lyngby,3787,11,3,9,12,27,46,-19,18
Brondby,3788,1,20,6,4,71,34,37,66
FC Midtjylla,3788,2,19,6,5,64,39,25,63
FC Nords,3788,3,15,6,9,75,52,23,51
Copenhagen,3788,4,13,5,12,59,48,11,44
AC Horsens,3788,5,8,13,9,42,53,-11,37
AaB,3788,6,7,12,11,37,48,-11,33
Sonderjyske,3788,7,8,6,10,28,29,-1,30
Lyngby,3788,8,4,9,11,30,44,-14,21
AGF Aarhus,3788,9,5,6,11,17,36,-19,21
Randers FC,3788,10,5,6,13,23,43,-20,21
Silkeborg IF,3788,11,5,3,14,25,45,-20,18
Brondby,3789,1,20,6,4,76,36,40,66
FC Midtjylla,3789,2,20,4,6,70,41,29,64
Copenhagen,3789,3,15,6,9,63,46,17,51
FC Nords,3789,4,14,7,9,77,57,20,49
AaB,3789,5,7,13,10,36,45,-9,34
Sonderjyske,3789,6,8,6,10,28,29,-1,30
AC Horsens,3789,7,6,12,12,36,59,-23,30
Randers FC,3789,8,5,7,12,23,39,-16,22
Silkeborg IF,3789,9,6,3,13,27,44,-17,21
Lyngby,3789,10,3,10,11,26,44,-18,19
AGF Aarhus,3789,11,4,6,12,16,38,-22,18
FC Midtjylla,3790,1,21,5,4,69,38,31,68
Brondby,3790,2,20,6,4,71,39,32,66
FC Nords,3790,3,15,7,8,75,51,24,52
Copenhagen,3790,4,15,4,11,59,43,16,49
AaB,3790,5,7,11,12,37,43,-6,32
Sonderjyske,3790,6,8,6,10,28,29,-1,30
AC Horsens,3790,7,5,13,12,38,61,-23,28
Randers FC,3790,8,5,7,12,23,39,-16,22
Silkeborg IF,3790,9,6,3,13,27,45,-18,21
Lyngby,3790,10,3,10,11,26,44,-18,19
AGF Aarhus,3790,11,4,6,12,17,38,-21,18
Brondby,3791,1,19,8,3,69,31,38,65
FC Midtjylla,3791,2,19,6,5,64,39,25,63
FC Nords,3791,3,14,8,8,74,51,23,50
Copenhagen,3791,4,14,5,11,56,44,12,47
AaB,3791,5,7,14,9,36,40,-4,35
AC Horsens,3791,6,6,13,11,32,52,-20,31
Sonderjyske,3791,7,8,6,10,28,29,-1,30
Randers FC,3791,8,6,6,12,25,40,-15,24
Silkeborg IF,3791,9,6,3,13,28,45,-17,21
Lyngby,3791,10,3,9,12,27,46,-19,18
AGF Aarhus,3791,11,4,6,12,17,39,-22,18
FC Midtjylla,3792,1,20,4,6,64,39,25,64
Brondby,3792,2,19,5,6,68,34,34,62
FC Nords,3792,3,17,6,7,81,47,34,57
Copenhagen,3792,4,15,4,11,57,44,13,49
AaB,3792,5,8,11,11,39,47,-8,35
Sonderjyske,3792,6,8,6,10,28,29,-1,30
AC Horsens,3792,7,6,12,12,34,58,-24,30
Randers FC,3792,8,6,6,12,25,40,-15,24
Silkeborg IF,3792,9,5,4,13,26,45,-19,19
AGF Aarhus,3792,10,4,7,11,17,37,-20,19
Lyngby,3792,11,3,9,12,27,46,-19,18
FC Midtjylla,3793,1,21,4,5,70,37,33,67
Brondby,3793,2,19,7,4,66,32,34,64
FC Nords,3793,3,13,7,10,74,58,16,46
Copenhagen,3793,4,14,4,12,57,47,10,46
AaB,3793,5,8,12,10,38,43,-5,36
AC Horsens,3793,6,8,12,10,37,51,-14,36
Sonderjyske,3793,7,8,6,10,28,29,-1,30
Randers FC,3793,8,5,7,12,25,41,-16,22
Lyngby,3793,9,3,10,11,28,46,-18,19
Silkeborg IF,3793,10,5,4,13,25,44,-19,19
AGF Aarhus,3793,11,4,7,11,16,36,-20,19
FC Midtjylla,3794,1,21,5,4,68,38,30,68
Brondby,3794,2,19,6,5,65,33,32,63
FC Nords,3794,3,13,7,10,69,51,18,46
Copenhagen,3794,4,13,7,10,57,45,12,46
AC Horsens,3794,5,8,12,10,37,50,-13,36
AaB,3794,6,7,13,10,36,41,-5,34
Sonderjyske,3794,7,8,6,10,28,29,-1,30
Randers FC,3794,8,6,6,12,25,40,-15,24
Silkeborg IF,3794,9,6,3,13,28,44,-16,21
Lyngby,3794,10,3,9,12,27,46,-19,18
AGF Aarhus,3794,11,4,6,12,16,39,-23,18
Brondby,3795,1,20,6,4,71,35,36,66
FC Midtjylla,3795,2,20,5,5,70,42,28,65
FC Nords,3795,3,13,7,10,75,55,20,46
Copenhagen,3795,4,14,4,12,56,47,9,46
AaB,3795,5,9,12,9,41,43,-2,39
AC Horsens,3795,6,7,12,11,33,50,-17,33
Sonderjyske,3795,7,8,6,10,28,29,-1,30
Randers FC,3795,8,5,7,12,23,39,-16,22
AGF Aarhus,3795,9,5,6,11,19,37,-18,21
Lyngby,3795,10,3,10,11,26,44,-18,19
Silkeborg IF,3795,11,5,3,14,26,47,-21,18
Brondby,3796,1,21,6,3,71,35,36,69
FC Midtjylla,3796,2,19,5,6,67,40,27,62
FC Nords,3796,3,15,6,9,74,54,20,51
Copenhagen,3796,4,15,5,10,62,43,19,50
AaB,3796,5,7,11,12,38,45,-7,32
AC Horsens,3796,6,6,13,11,34,55,-21,31
Sonderjyske,3796,7,8,6,10,28,29,-1,30
Randers FC,3796,8,6,6,12,25,40,-15,24
Silkeborg IF,3796,9,6,3,13,30,47,-17,21
Lyngby,3796,10,3,9,12,27,46,-19,18
AGF Aarhus,3796,11,4,6,12,19,41,-22,18
Brondby,3797,1,22,5,3,79,29,50,71
FC Midtjylla,3797,2,21,5,4,66,37,29,68
FC Nords,3797,3,14,7,9,73,55,18,49
Copenhagen,3797,4,13,4,13,54,47,7,43
AaB,3797,5,8,11,11,35,43,-8,35
Sonderjyske,3797,6,8,6,10,28,29,-1,30
AC Horsens,3797,7,6,12,12,33,55,-22,30
Randers FC,3797,8,5,7,12,24,40,-16,22
Lyngby,3797,9,3,10,11,27,45,-18,19
Silkeborg IF,3797,10,5,4,13,27,46,-19,19
AGF Aarhus,3797,11,4,7,11,18,38,-20,19
Brondby,3798,1,21,7,2,72,33,39,70
FC Midtjylla,3798,2,19,4,7,65,41,24,61
FC Nords,3798,3,16,6,8,73,48,25,54
Copenhagen,3798,4,13,4,13,53,43,10,43
AaB,3798,5,8,12,10,34,41,-7,36
AC Horsens,3798,6,6,13,11,33,50,-17,31
Sonderjyske,3798,7,8,6,10,28,29,-1,30
Randers FC,3798,8,6,6,12,27,40,-13,24
AGF Aarhus,3798,9,5,6,11,20,38,-18,21
Lyngby,3798,10,3,9,12,27,48,-21,18
Silkeborg IF,3798,10,5,3,14,27,48,-21,18
Brondby,3799,1,21,5,4,72,32,40,68
FC Midtjylla,3799,2,20,4,6,68,41,27,64
FC Nords,3799,3,14,6,10,72,50,22,48
Copenhagen,3799,4,14,4,12,56,47,9,46
AaB,3799,5,9,12,9,38,41,-3,39
AC Horsens,3799,6,6,13,11,36,57,-21,31
Sonderjyske,3799,7,8,6,10,28,29,-1,30
Randers FC,3799,8,6,6,12,28,40,-12,24
AGF Aarhus,3799,9,5,6,11,19,38,-19,21
Silkeborg IF,3799,10,5,3,14,27,47,-20,18
Lyngby,3799,11,3,9,12,27,49,-22,18
Brondby,3800,1,22,5,3,70,28,42,71
FC Midtjylla,3800,2,21,4,5,66,37,29,67
Copenhagen,3800,3,14,5,11,59,45,14,47
FC Nords,3800,4,13,7,10,72,53,19,46
AaB,3800,5,6,14,10,36,45,-9,32
AC Horsens,3800,6,6,13,11,33,54,-21,31
Sonderjyske,3800,7,8,6,10,28,29,-1,30
Randers FC,3800,8,5,7,12,24,40,-16,22
Silkeborg IF,3800,9,6,3,13,27,44,-17,21
Lyngby,3800,10,3,10,11,27,45,-18,19
AGF Aarhus,3800,11,4,6,12,16,38,-22,18
Brondby,3801,1,20,7,3,71,35,36,67
FC Midtjylla,3801,2,21,4,5,68,36,32,67
FC Nords,3801,3,14,7,9,73,51,22,49
Copenhagen,3801,4,14,4,12,56,45,11,46
AaB,3801,5,9,12,9,37,40,-3,39
Sonderjyske,3801,6,8,6,10,28,29,-1,30
AC Horsens,3801,7,5,12,13,31,55,-24,27
Lyngby,3801,8,4,9,11,28,44,-16,21
Silkeborg IF,3801,9,6,3,13,28,45,-17,21
Randers FC,3801,10,5,6,13,23,41,-18,21
AGF Aarhus,3801,11,4,6,12,17,39,-22,18
Brondby,3802,1,22,5,3,73,31,42,71
FC Midtjylla,3802,2,19,5,6,64,40,24,62
FC Nords,3802,3,16,6,8,75,49,26,54
Copenhagen,3802,4,14,5,11,57,44,13,47
AaB,3802,5,8,11,11,37,43,-6,35
Sonderjyske,3802,6,8,6,10,28,29,-1,30
AC Horsens,3802,7,5,12,13,32,57,-25,27
Randers FC,3802,8,5,7,12,24,40,-16,22
Lyngby,3802,9,3,10,11,27,45,-18,19
Silkeborg IF,3802,10,5,4,13,26,45,-19,19
AGF Aarhus,3802,11,4,7,11,17,37,-20,19
FC Midtjylla,3803,1,21,4,5,69,38,31,67
Brondby,3803,2,20,5,5,70,36,34,65
Copenhagen,3803,3,15,5,10,60,42,18,50
FC Nords,3803,4,13,7,10,68,56,12,46
AaB,3803,5,8,11,11,37,43,-6,35
AC Horsens,3803,6,6,14,10,39,54,-15,32
Sonderjyske,3803,7,8,6,10,28,29,-1,30
Randers FC,3803,8,6,6,12,26,41,-15,24
AGF Aarhus,3803,9,5,6,11,17,36,-19,21
Lyngby,3803,10,3,9,12,28,47,-19,18
Silkeborg IF,3803,11,5,3,14,25,45,-20,18
FC Midtjylla,3804,1,21,5,4,72,36,36,68
Brondby,3804,2,20,6,4,72,35,37,66
Copenhagen,3804,3,14,5,11,59,45,14,47
FC Nords,3804,4,12,8,10,70,56,14,44
AaB,3804,5,10,11,9,37,41,-4,41
Sonderjyske,3804,6,8,6,10,28,29,-1,30
AC Horsens,3804,7,5,13,12,32,55,-23,28
Randers FC,3804,8,5,7,12,25,41,-16,22
Silkeborg IF,3804,9,6,3,13,31,46,-15,21
Lyngby,3804,10,3,10,11,28,46,-18,19
AGF Aarhus,3804,11,4,6,12,18,42,-24,18
Brondby,3805,1,20,8,2,68,29,39,68
FC Midtjylla,3805,2,18,6,6,63,42,21,60
FC Nords,3805,3,13,9,8,75,52,23,48
Copenhagen,3805,4,14,6,10,57,44,13,48
AaB,3805,5,7,14,9,36,40,-4,35
AC Horsens,3805,6,6,13,11,36,54,-18,31
Sonderjyske,3805,7,8,6,10,28,29,-1,30
Lyngby,3805,8,4,9,11,29,45,-16,21
Randers FC,3805,9,5,6,13,24,42,-18,21
Silkeborg IF,3805,10,5,4,13,27,46,-19,19
AGF Aarhus,3805,11,4,7,11,18,38,-20,19
Brondby,3806,1,21,7,2,73,32,41,70
FC Midtjylla,3806,2,20,6,4,67,36,31,66
FC Nords,3806,3,13,8,9,72,54,18,47
Copenhagen,3806,4,13,7,10,57,44,13,46
AC Horsens,3806,5,7,13,10,35,53,-18,34
Sonderjyske,3806,6,8,6,10,28,29,-1,30
AaB,3806,7,6,11,13,34,45,-11,29
Randers FC,3806,8,6,6,12,25,39,-14,24
AGF Aarhus,3806,9,5,6,11,18,36,-18,21
Lyngby,3806,10,3,9,12,26,46,-20,18
Silkeborg IF,3806,11,5,3,14,25,46,-21,18
Brondby,3807,1,21,6,3,73,31,42,69
FC Midtjylla,3807,2,19,5,6,64,42,22,62
FC Nords,3807,3,15,6,9,74,51,23,51
Copenhagen,3807,4,14,4,12,59,46,13,46
AaB,3807,5,8,12,10,40,46,-6,36
AC Horsens,3807,6,6,13,11,32,52,-20,31
Sonderjyske,3807,7,8,6,10,28,29,-1,30
Lyngby,3807,8,4,9,11,30,45,-15,21
Randers FC,3807,9,5,6,13,24,43,-19,21
AGF Aarhus,3807,10,5,6,11,18,37,-19,21
Silkeborg IF,3807,11,5,3,14,26,46,-20,18
Brondby,3808,1,21,6,3,73,33,40,69
FC Midtjylla,3808,2,20,5,5,64,38,26,65
Copenhagen,3808,3,15,6,9,61,43,18,51
FC Nords,3808,4,12,9,9,68,52,16,45
AC Horsens,3808,5,6,14,10,36,53,-17,32
Sonderjyske,3808,6,8,6,10,28,29,-1,30
AaB,3808,7,6,12,12,34,43,-9,30
Lyngby,3808,8,4,9,11,28,44,-16,21
Randers FC,3808,9,5,6,13,23,41,-18,21
Silkeborg IF,3808,10,5,4,13,27,46,-19,19
AGF Aarhus,3808,11,4,7,11,18,38,-20,19
Brondby,3809,1,22,5,3,72,29,43,71
FC Midtjylla,3809,2,19,5,6,66,41,25,62
FC Nords,3809,3,13,7,10,69,56,13,46
Copenhagen,3809,4,13,5,12,59,52,7,44
AaB,3809,5,9,12,9,40,42,-2,39
AC Horsens,3809,6,7,12,11,36,48,-12,33
Sonderjyske,3809,7,8,6,10,28,29,-1,30
Randers FC,3809,8,6,6,12,27,39,-12,24
Silkeborg IF,3809,9,5,4,13,28,47,-19,19
AGF Aarhus,3809,10,4,7,11,19,39,-20,19
Lyngby,3809,11,3,9,12,26,48,-22,18
Brondby,3810,1,21,6,3,70,31,39,69
FC Midtjylla,3810,2,19,5,6,63,38,25,62
FC Nords,3810,3,15,7,8,77,51,26,52
Copenhagen,3810,4,14,5,11,58,46,12,47
AC Horsens,3810,5,7,12,11,33,52,-19,33
AaB,3810,6,7,11,12,35,44,-9,32
Sonderjyske,3810,7,8,6,10,28,29,-1,30
Randers FC,3810,8,6,6,12,24,39,-15,24
Silkeborg IF,3810,9,6,3,13,26,44,-18,21
Lyngby,3810,10,3,9,12,26,45,-19,18
AGF Aarhus,3810,11,4,6,12,16,37,-21,18
Brondby,3811,1,20,8,2,71,32,39,68
FC Midtjylla,3811,2,21,5,4,69,37,32,68
FC Nords,3811,3,14,6,10,71,57,14,48
Copenhagen,3811,4,13,5,12,55,49,6,44
AaB,3811,5,8,12,10,41,41,0,36
Sonderjyske,3811,6,8,6,10,28,29,-1,30
AC Horsens,3811,7,6,12,12,34,51,-17,30
Randers FC,3811,8,6,6,12,25,40,-15,24
Silkeborg IF,3811,9,6,3,13,28,44,-16,21
Lyngby,3811,10,3,9,12,27,46,-19,18
AGF Aarhus,3811,11,4,6,12,16,39,-23,18
Brondby,3812,1,20,6,4,70,34,36,66
FC Midtjylla,3812,2,19,7,4,67,40,27,64
FC Nords,3812,3,14,8,8,74,50,24,50
Copenhagen,3812,4,13,6,11,57,48,9,45
AaB,3812,5,8,13,9,37,41,-4,37
Sonderjyske,3812,6,8,6,10,28,29,-1,30
AC Horsens,3812,7,5,14,11,35,53,-18,29
Randers FC,3812,8,5,7,12,25,41,-16,22
Lyngby,3812,9,3,10,11,28,46,-18,19
Silkeborg IF,3812,10,5,4,13,26,45,-19,19
AGF Aarhus,3812,11,4,7,11,17,37,-20,19
Brondby,3813,1,20,6,4,68,33,35,66
FC Midtjylla,3813,2,19,6,5,67,39,28,63
Copenhagen,3813,3,14,5,11,56,44,12,47
FC Nords,3813,4,13,6,11,72,56,16,45
AaB,3813,5,8,13,9,40,43,-3,37
AC Horsens,3813,6,8,12,10,38,52,-14,36
Sonderjyske,3813,7,8,6,10,28,29,-1,30
Randers FC,3813,8,6,6,12,26,40,-14,24
Silkeborg IF,3813,9,6,3,13,26,44,-18,21
Lyngby,3813,10,3,9,12,27,47,-20,18
AGF Aarhus,3813,11,4,6,12,16,37,-21,18
Brondby,3814,1,21,6,3,71,29,42,69
FC Midtjylla,3814,2,20,4,6,66,40,26,64
FC Nords,3814,3,14,8,8,73,50,23,50
Copenhagen,3814,4,13,7,10,57,44,13,46
AC Horsens,3814,5,6,15,9,35,51,-16,33
Sonderjyske,3814,6,8,6,10,28,29,-1,30
AaB,3814,7,6,12,12,34,48,-14,30
Randers FC,3814,8,6,6,12,26,39,-13,24
Silkeborg IF,3814,9,6,3,13,27,45,-18,21
Lyngby,3814,10,3,9,12,26,47,-21,18
AGF Aarhus,3814,11,4,6,12,17,38,-21,18
Brondby,3815,1,22,5,3,78,34,44,71
FC Midtjylla,3815,2,21,4,5,67,38,29,67
FC Nords,3815,3,14,6,10,70,55,15,48
Copenhagen,3815,4,13,5,12,57,44,13,44
AaB,3815,5,8,11,11,34,43,-9,35
AC Horsens,3815,6,6,13,11,38,56,-18,31
Sonderjyske,3815,7,8,6,10,28,29,-1,30
Lyngby,3815,8,4,9,11,27,44,-17,21
Randers FC,3815,9,5,6,13,23,40,-17,21
Silkeborg IF,3815,10,6,3,13,27,45,-18,21
AGF Aarhus,3815,11,4,6,12,17,38,-21,18
FC Midtjylla,3816,1,21,5,4,68,35,33,68
Brondby,3816,2,19,8,3,69,36,33,65
FC Nords,3816,3,15,7,8,78,52,26,52
Copenhagen,3816,4,13,4,13,54,47,7,43
AC Horsens,3816,5,7,14,9,34,50,-16,35
Sonderjyske,3816,6,8,6,10,28,29,-1,30
AaB,3816,7,6,12,12,33,42,-9,30
Randers FC,3816,8,6,6,12,25,40,-15,24
Silkeborg IF,3816,9,6,3,13,28,44,-16,21
Lyngby,3816,10,3,9,12,27,46,-19,18
AGF Aarhus,3816,11,4,6,12,16,39,-23,18
Brondby,3817,1,21,7,2,71,31,40,70
FC Midtjylla,3817,2,20,6,4,63,34,29,66
Copenhagen,3817,3,13,6,11,58,47,11,45
FC Nords,3817,4,12,8,10,72,56,16,44
AaB,3817,5,8,12,10,38,43,-5,36
AC Horsens,3817,6,6,13,11,35,52,-17,31
Sonderjyske,3817,7,8,6,10,28,29,-1,30
Randers FC,3817,8,6,6,12,24,39,-15,24
Silkeborg IF,3817,9,6,3,13,27,45,-18,21
Lyngby,3817,10,3,9,12,26,45,-19,18
AGF Aarhus,3817,11,4,6,12,17,38,-21,18
Brondby,3818,1,20,6,4,70,34,36,66
FC Midtjylla,3818,2,20,6,4,68,38,30,66
FC Nords,3818,3,13,8,9,72,51,21,47
Copenhagen,3818,4,14,5,11,60,45,15,47
AaB,3818,5,8,12,10,38,44,-6,36
AC Horsens,3818,6,6,13,11,31,53,-22,31
Sonderjyske,3818,7,8,6,10,28,29,-1,30
Randers FC,3818,8,6,6,12,25,40,-15,24
AGF Aarhus,3818,9,5,6,11,18,36,-18,21
Lyngby,3818,10,3,9,12,27,46,-19,18
Silkeborg IF,3818,11,5,3,14,25,46,-21,18
Brondby,3819,1,20,7,3,73,36,37,67
FC Midtjylla,3819,2,18,6,6,64,40,24,60
Copenhagen,3819,3,15,5,10,60,44,16,50
FC Nords,3819,4,13,9,8,74,53,21,48
AaB,3819,5,8,12,10,37,40,-3,36
AC Horsens,3819,6,6,13,11,32,53,-21,31
Sonderjyske,3819,7,8,6,10,28,29,-1,30
Randers FC,3819,8,5,7,12,23,39,-16,22
Silkeborg IF,3819,9,6,3,13,27,45,-18,21
Lyngby,3819,10,3,10,11,26,44,-18,19
AGF Aarhus,3819,11,4,6,12,17,38,-21,18
FC Midtjylla,3820,1,21,4,5,70,37,33,67
Brondby,3820,2,18,8,4,65,33,32,62
FC Nords,3820,3,16,6,8,74,49,25,54
Copenhagen,3820,4,14,5,11,59,49,10,47
AaB,3820,5,7,13,10,37,41,-4,34
Sonderjyske,3820,6,8,6,10,28,29,-1,30
AC Horsens,3820,7,5,14,11,38,60,-22,29
Randers FC,3820,8,6,6,12,24,39,-15,24
Silkeborg IF,3820,9,6,3,13,26,44,-18,21
Lyngby,3820,10,3,9,12,26,45,-19,18
AGF Aarhus,3820,11,4,6,12,16,37,-21,18
Brondby,3821,1,23,5,2,74,29,45,74
FC Midtjylla,3821,2,21,4,5,70,37,33,67
FC Nords,3821,3,15,6,9,76,56,20,51
Copenhagen,3821,4,13,4,13,58,52,6,43
AaB,3821,5,7,12,11,36,42,-6,33
Sonderjyske,3821,6,8,6,10,28,29,-1,30
AC Horsens,3821,7,5,13,12,34,58,-24,28
Lyngby,3821,8,4,9,11,28,44,-16,21
Silkeborg IF,3821,9,6,3,13,28,46,-18,21
Randers FC,3821,10,5,6,13,23,41,-18,21
AGF Aarhus,3821,11,4,6,12,18,39,-21,18
Brondby,3822,1,21,5,4,70,30,40,68
FC Midtjylla,3822,2,18,8,4,62,37,25,62
Copenhagen,3822,3,16,5,9,59,42,17,53
FC Nords,3822,4,14,7,9,74,49,25,49
AaB,3822,5,6,13,11,35,44,-9,31
Sonderjyske,3822,6,8,6,10,28,29,-1,30
AC Horsens,3822,7,5,14,11,33,57,-24,29
Lyngby,3822,8,4,9,11,28,44,-16,21
Randers FC,3822,9,5,6,13,23,41,-18,21
Silkeborg IF,3822,10,5,4,13,27,46,-19,19
AGF Aarhus,3822,11,4,7,11,18,38,-20,19
Brondby,3823,1,22,5,3,73,28,45,71
FC Midtjylla,3823,2,19,5,6,65,46,19,62
Copenhagen,3823,3,15,4,11,58,45,13,49
FC Nords,3823,4,14,6,10,75,54,21,48
AaB,3823,5,8,11,11,37,42,-5,35
AC Horsens,3823,6,6,13,11,36,55,-19,31
Sonderjyske,3823,7,8,6,10,28,29,-1,30
Randers FC,3823,8,6,6,12,27,41,-14,24
Silkeborg IF,3823,9,6,3,13,29,45,-16,21
Lyngby,3823,10,3,9,12,28,48,-20,18
AGF Aarhus,3823,11,4,6,12,17,40,-23,18
Brondby,3824,1,22,5,3,77,30,47,71
FC Midtjylla,3824,2,18,6,6,62,48,14,60
Copenhagen,3824,3,15,5,10,62,43,19,50
FC Nords,3824,4,13,8,9,75,53,22,47
AaB,3824,5,8,12,10,40,45,-5,36
Sonderjyske,3824,6,8,6,10,28,29,-1,30
AC Horsens,3824,7,6,12,12,31,54,-23,30
Randers FC,3824,8,6,6,12,24,39,-15,24
Silkeborg IF,3824,9,6,3,13,28,45,-17,21
Lyngby,3824,10,3,9,12,26,45,-19,18
AGF Aarhus,3824,11,4,6,12,17,39,-22,18
Brondby,3825,1,20,6,4,70,36,34,66
FC Midtjylla,3825,2,18,4,8,62,40,22,58
FC Nords,3825,3,15,6,9,72,50,22,51
Copenhagen,3825,4,15,4,11,58,44,14,49
AaB,3825,5,8,12,10,39,44,-5,36
AC Horsens,3825,6,8,12,10,37,50,-13,36
Sonderjyske,3825,7,8,6,10,28,29,-1,30
Lyngby,3825,8,4,9,11,28,45,-17,21
Randers FC,3825,9,5,6,13,24,41,-17,21
AGF Aarhus,3825,10,5,6,11,17,36,-19,21
Silkeborg IF,3825,11,5,3,14,25,45,-20,18
Brondby,3826,1,21,5,4,72,33,39,68
FC Midtjylla,3826,2,20,5,5,66,39,27,65
FC Nords,3826,3,15,6,9,73,49,24,51
Copenhagen,3826,4,12,6,12,54,48,6,42
AaB,3826,5,7,13,10,36,41,-5,34
AC Horsens,3826,6,7,13,10,34,51,-17,34
Sonderjyske,3826,7,8,6,10,28,29,-1,30
Randers FC,3826,8,5,7,12,24,40,-16,22
AGF Aarhus,3826,9,5,6,11,19,36,-17,21
Lyngby,3826,10,3,10,11,27,45,-18,19
Silkeborg IF,3826,11,5,3,14,25,47,-22,18
Brondby,3827,1,21,5,4,68,34,34,68
FC Midtjylla,3827,2,19,5,6,67,37,30,62
Copenhagen,3827,3,14,6,10,56,40,16,48
FC Nords,3827,4,13,7,10,68,60,8,46
AC Horsens,3827,5,8,13,9,40,51,-11,37
AaB,3827,6,7,12,11,39,42,-3,33
Sonderjyske,3827,7,8,6,10,28,29,-1,30
Lyngby,3827,8,4,9,11,28,45,-17,21
Randers FC,3827,9,5,6,13,24,41,-17,21
Silkeborg IF,3827,10,6,3,13,28,46,-18,21
AGF Aarhus,3827,11,4,6,12,18,39,-21,18
Brondby,3828,1,22,5,3,71,31,40,71
FC Midtjylla,3828,2,19,4,7,64,39,25,61
Copenhagen,3828,3,16,5,9,59,40,19,53
FC Nords,3828,4,14,6,10,73,54,19,48
AaB,3828,5,7,12,11,38,44,-6,33
Sonderjyske,3828,6,8,6,10,28,29,-1,30
AC Horsens,3828,7,6,12,12,32,55,-23,30
Lyngby,3828,8,4,9,11,27,44,-17,21
Randers FC,3828,9,5,6,13,23,40,-17,21
AGF Aarhus,3828,10,5,6,11,18,37,-19,21
Silkeborg IF,3828,11,5,3,14,26,46,-20,18
Brondby,3829,1,20,5,5,71,38,33,65
FC Midtjylla,3829,2,20,4,6,71,45,26,64
Copenhagen,3829,3,14,5,11,62,44,18,47
FC Nords,3829,4,13,7,10,70,54,16,46
AC Horsens,3829,5,9,12,9,35,48,-13,39
AaB,3829,6,8,11,11,39,45,-6,35
Sonderjyske,3829,7,8,6,10,28,29,-1,30
Lyngby,3829,8,4,9,11,28,45,-17,21
Silkeborg IF,3829,9,6,3,13,27,44,-17,21
Randers FC,3829,10,5,6,13,24,41,-17,21
AGF Aarhus,3829,11,4,6,12,16,38,-22,18
Brondby,3830,1,21,6,3,74,34,40,69
FC Midtjylla,3830,2,19,4,7,63,44,19,61
FC Nords,3830,3,16,7,7,75,48,27,55
Copenhagen,3830,4,14,4,12,58,45,13,46
AaB,3830,5,7,12,11,35,42,-7,33
AC Horsens,3830,6,6,13,11,33,51,-18,31
Sonderjyske,3830,7,8,6,10,28,29,-1,30
Randers FC,3830,8,5,7,12,25,41,-16,22
Silkeborg IF,3830,9,6,3,13,27,45,-18,21
Lyngby,3830,10,3,10,11,28,46,-18,19
AGF Aarhus,3830,11,4,6,12,17,38,-21,18
Brondby,3831,1,21,7,2,74,30,44,70
FC Midtjylla,3831,2,19,5,6,63,38,25,62
FC Nords,3831,3,15,6,9,74,52,22,51
Copenhagen,3831,4,14,6,10,62,47,15,48
AaB,3831,5,6,13,11,33,44,-11,31
Sonderjyske,3831,6,8,6,10,28,29,-1,30
AC Horsens,3831,7,5,15,10,31,52,-21,30
Lyngby,3831,8,4,9,11,29,46,-17,21
Randers FC,3831,9,5,6,13,25,42,-17,21
Silkeborg IF,3831,10,6,3,13,28,46,-18,21
AGF Aarhus,3831,11,4,6,12,18,39,-21,18
Brondby,3832,1,22,5,3,69,31,38,71
FC Midtjylla,3832,2,18,6,6,69,44,25,60
FC Nords,3832,3,15,6,9,75,52,23,51
Copenhagen,3832,4,13,6,11,59,47,12,45
AC Horsens,3832,5,7,14,9,42,53,-11,35
AaB,3832,6,7,11,12,39,52,-13,32
Sonderjyske,3832,7,8,6,10,28,29,-1,30
Lyngby,3832,8,4,9,11,27,44,-17,21
Randers FC,3832,9,5,6,13,23,40,-17,21
Silkeborg IF,3832,10,5,4,13,26,45,-19,19
AGF Aarhus,3832,11,4,7,11,17,37,-20,19
Brondby,3833,1,22,6,2,72,28,44,72
FC Midtjylla,3833,2,20,4,6,69,41,28,64
FC Nords,3833,3,13,7,10,71,54,17,46
Copenhagen,3833,4,13,6,11,57,45,12,45
AaB,3833,5,8,11,11,36,43,-7,35
AC Horsens,3833,6,6,14,10,35,55,-20,32
Sonderjyske,3833,7,8,6,10,28,29,-1,30
Lyngby,3833,8,4,9,11,30,46,-16,21
Silkeborg IF,3833,9,6,3,13,29,46,-17,21
Randers FC,3833,10,5,6,13,25,43,-18,21
AGF Aarhus,3833,11,4,6,12,18,40,-22,18
Brondby,3834,1,20,7,3,68,31,37,67
FC Midtjylla,3834,2,20,4,6,66,43,23,64
FC Nords,3834,3,14,8,8,77,48,29,50
Copenhagen,3834,4,14,6,10,56,43,13,48
AaB,3834,5,6,14,10,34,41,-7,32
AC Horsens,3834,6,6,13,11,34,55,-21,31
Sonderjyske,3834,7,8,6,10,28,29,-1,30
Lyngby,3834,8,4,9,11,28,44,-16,21
Randers FC,3834,9,5,6,13,23,41,-18,21
Silkeborg IF,3834,10,5,4,13,26,45,-19,19
AGF Aarhus,3834,11,4,7,11,17,37,-20,19
FC Midtjylla,3835,1,21,4,5,67,37,30,67
Brondby,3835,2,20,5,5,70,37,33,65
FC Nords,3835,3,13,8,9,70,50,20,47
Copenhagen,3835,4,14,4,12,56,46,10,46
AC Horsens,3835,5,8,13,9,38,48,-10,37
AaB,3835,6,7,12,11,36,45,-9,33
Sonderjyske,3835,7,8,6,10,28,29,-1,30
Lyngby,3835,8,4,9,11,28,45,-17,21
Randers FC,3835,9,5,6,13,24,41,-17,21
Silkeborg IF,3835,10,6,3,13,26,44,-18,21
AGF Aarhus,3835,11,4,6,12,16,37,-21,18
Brondby,3836,1,21,6,3,76,34,42,69
FC Midtjylla,3836,2,18,5,7,62,45,17,59
FC Nords,3836,3,15,7,8,72,49,23,52
Copenhagen,3836,4,12,8,10,56,47,9,44
AaB,3836,5,8,11,11,41,40,1,35
AC Horsens,3836,6,7,13,10,34,52,-18,34
Sonderjyske,3836,7,8,6,10,28,29,-1,30
Lyngby,3836,8,4,9,11,27,44,-17,21
Randers FC,3836,9,5,6,13,23,40,-17,21
Silkeborg IF,3836,10,5,4,13,26,45,-19,19
AGF Aarhus,3836,11,4,7,11,17,37,-20,19
Brondby,3837,1,21,6,3,69,33,36,69
FC Midtjylla,3837,2,18,5,7,63,45,18,59
FC Nords,3837,3,15,6,9,74,48,26,51
Copenhagen,3837,4,15,4,11,59,47,12,49
AaB,3837,5,8,11,11,43,44,-1,35
AC Horsens,3837,6,6,14,10,35,52,-17,32
Sonderjyske,3837,7,8,6,10,28,29,-1,30
Randers FC,3837,8,6,6,12,25,40,-15,24
AGF Aarhus,3837,9,5,6,11,19,37,-18,21
Lyngby,3837,10,3,9,12,27,46,-19,18
Silkeborg IF,3837,11,5,3,14,26,47,-21,18
Brondby,3838,1,21,5,4,70,35,35,68
FC Midtjylla,3838,2,21,4,5,70,41,29,67
Copenhagen,3838,3,15,4,11,59,43,16,49
FC Nords,3838,4,12,6,12,68,54,14,42
AaB,3838,5,9,12,9,41,41,0,39
AC Horsens,3838,6,6,13,11,34,54,-20,31
Sonderjyske,3838,7,8,6,10,28,29,-1,30
Randers FC,3838,8,5,7,12,25,41,-16,22
Silkeborg IF,3838,9,6,3,13,27,44,-17,21
Lyngby,3838,10,3,10,11,28,46,-18,19
AGF Aarhus,3838,11,4,6,12,16,38,-22,18
Brondby,3839,1,22,5,3,66,28,38,71
FC Midtjylla,3839,2,20,4,6,66,39,27,64
FC Nords,3839,3,15,7,8,73,50,23,52
Copenhagen,3839,4,13,4,13,54,46,8,43
AaB,3839,5,8,11,11,37,42,-5,35
AC Horsens,3839,6,6,13,11,32,49,-17,31
Sonderjyske,3839,7,8,6,10,28,29,-1,30
Lyngby,3839,8,4,9,11,29,45,-16,21
Randers FC,3839,9,5,6,13,24,42,-18,21
AGF Aarhus,3839,10,5,6,11,18,37,-19,21
Silkeborg IF,3839,11,5,3,14,26,46,-20,18
Brondby,3840,1,21,6,3,72,31,41,69
FC Midtjylla,3840,2,20,5,5,63,35,28,65
FC Nords,3840,3,15,6,9,71,50,21,51
Copenhagen,3840,4,13,5,12,54,45,9,44
AaB,3840,5,8,12,10,39,39,0,36
Sonderjyske,3840,6,8,6,10,28,29,-1,30
AC Horsens,3840,7,6,12,12,33,58,-25,30
Randers FC,3840,8,5,7,12,25,41,-16,22
Silkeborg IF,3840,9,6,3,13,27,45,-18,21
Lyngby,3840,10,3,10,11,28,46,-18,19
AGF Aarhus,3840,11,4,6,12,17,38,-21,18
Brondby,3841,1,22,5,3,73,36,37,71
FC Midtjylla,3841,2,19,5,6,69,39,30,62
Copenhagen,3841,3,13,7,10,63,50,13,46
FC Nords,3841,4,12,7,11,74,65,9,43
AC Horsens,3841,5,8,13,9,38,49,-11,37
AaB,3841,6,7,13,10,37,41,-4,34
Sonderjyske,3841,7,8,6,10,28,29,-1,30
Lyngby,3841,8,4,9,11,29,45,-16,21
Randers FC,3841,9,5,6,13,24,42,-18,21
Silkeborg IF,3841,10,5,4,13,26,45,-19,19
AGF Aarhus,3841,11,4,7,11,17,37,-20,19
Brondby,3842,1,22,6,2,76,31,45,72
FC Midtjylla,3842,2,18,5,7,65,44,21,59
FC Nords,3842,3,15,7,8,78,52,26,52
Copenhagen,3842,4,14,6,10,61,48,13,48
AaB,3842,5,7,12,11,34,42,-8,33
Sonderjyske,3842,6,8,6,10,28,29,-1,30
AC Horsens,3842,7,6,12,12,34,57,-23,30
Lyngby,3842,8,4,9,11,27,44,-17,21
Randers FC,3842,9,5,6,13,23,40,-17,21
AGF Aarhus,3842,10,5,6,11,17,36,-19,21
Silkeborg IF,3842,11,5,3,14,25,45,-20,18
Brondby,3843,1,20,7,3,73,37,36,67
FC Midtjylla,3843,2,20,4,6,70,42,28,64
Copenhagen,3843,3,16,4,10,62,44,18,52
FC Nords,3843,4,14,7,9,73,52,21,49
AaB,3843,5,7,13,10,41,46,-5,34
Sonderjyske,3843,6,8,6,10,28,29,-1,30
AC Horsens,3843,7,5,13,12,31,55,-24,28
Randers FC,3843,8,6,6,12,27,41,-14,24
Silkeborg IF,3843,9,6,3,13,27,45,-18,21
Lyngby,3843,10,3,9,12,28,48,-20,18
AGF Aarhus,3843,11,4,6,12,17,38,-21,18
Brondby,3844,1,20,6,4,70,38,32,66
FC Midtjylla,3844,2,19,6,5,67,40,27,63
Copenhagen,3844,3,15,5,10,61,42,19,50
FC Nords,3844,4,13,9,8,75,55,20,48
AaB,3844,5,7,12,11,39,49,-10,33
AC Horsens,3844,6,6,14,10,38,52,-14,32
Sonderjyske,3844,7,8,6,10,28,29,-1,30
Lyngby,3844,8,4,9,11,28,44,-16,21
Randers FC,3844,9,5,6,13,23,41,-18,21
AGF Aarhus,3844,10,5,6,11,18,36,-18,21
Silkeborg IF,3844,11,5,3,14,25,46,-21,18
Brondby,3845,1,22,6,2,71,31,40,72
FC Midtjylla,3845,2,21,4,5,72,40,32,67
FC Nords,3845,3,14,6,10,70,50,20,48
Copenhagen,3845,4,12,5,13,52,45,7,41
AC Horsens,3845,5,7,13,10,36,53,-17,34
AaB,3845,6,7,12,11,36,44,-8,33
Sonderjyske,3845,7,8,6,10,28,29,-1,30
Randers FC,3845,8,5,7,12,24,40,-16,22
AGF Aarhus,3845,9,5,6,11,19,37,-18,21
Lyngby,3845,10,3,10,11,27,45,-18,19
Silkeborg IF,3845,11,5,3,14,26,47,-21,18
FC Midtjylla,3846,1,20,5,5,65,38,27,65
Brondby,3846,2,18,7,5,64,34,30,61
FC Nords,3846,3,14,9,7,68,45,23,51
Copenhagen,3846,4,14,5,11,57,41,16,47
AaB,3846,5,8,11,11,35,42,-7,35
AC Horsens,3846,6,7,13,10,33,48,-15,34
Sonderjyske,3846,7,8,6,10,28,29,-1,30
Randers FC,3846,8,5,7,12,23,39,-16,22
Silkeborg IF,3846,9,6,3,13,30,45,-15,21
Lyngby,3846,10,3,10,11,26,44,-18,19
AGF Aarhus,3846,11,4,6,12,17,41,-24,18
FC Midtjylla,3847,1,20,4,6,65,41,24,64
Brondby,3847,2,19,6,5,73,36,37,63
FC Nords,3847,3,14,8,8,73,53,20,50
Copenhagen,3847,4,15,5,10,65,49,16,50
AaB,3847,5,7,14,9,37,41,-4,35
AC Horsens,3847,6,6,13,11,36,55,-19,31
Sonderjyske,3847,7,8,6,10,28,29,-1,30
Randers FC,3847,8,5,7,12,24,40,-16,22
Silkeborg IF,3847,9,6,3,13,27,45,-18,21
Lyngby,3847,10,3,10,11,27,45,-18,19
AGF Aarhus,3847,11,4,6,12,17,38,-21,18
Brondby,3848,1,21,6,3,74,33,41,69
FC Midtjylla,3848,2,19,5,6,65,43,22,62
Copenhagen,3848,3,16,4,10,62,45,17,52
FC Nords,3848,4,13,9,8,74,53,21,48
AC Horsens,3848,5,7,12,11,36,53,-17,33
Sonderjyske,3848,6,8,6,10,28,29,-1,30
AaB,3848,7,6,12,12,37,47,-10,30
Randers FC,3848,8,6,6,12,25,40,-15,24
AGF Aarhus,3848,9,5,6,11,18,36,-18,21
Lyngby,3848,10,3,9,12,27,46,-19,18
Silkeborg IF,3848,11,5,3,14,25,46,-21,18
FC Midtjylla,3849,1,20,6,4,67,36,31,66
Brondby,3849,2,19,8,3,69,33,36,65
FC Nords,3849,3,14,8,8,71,51,20,50
Copenhagen,3849,4,12,5,13,59,51,8,41
AaB,3849,5,8,12,10,45,46,-1,36
AC Horsens,3849,6,7,13,10,37,57,-20,34
Sonderjyske,3849,7,8,6,10,28,29,-1,30
Randers FC,3849,8,6,6,12,24,39,-15,24
AGF Aarhus,3849,9,5,6,11,18,36,-18,21
Lyngby,3849,10,3,9,12,26,45,-19,18
Silkeborg IF,3849,11,5,3,14,25,46,-21,18
Brondby,3850,1,22,5,3,73,29,44,71
FC Midtjylla,3850,2,19,4,7,63,40,23,61
Copenhagen,3850,3,16,5,9,60,41,19,53
FC Nords,3850,4,13,6,11,67,51,16,45
AaB,3850,5,9,11,10,37,42,-5,38
Sonderjyske,3850,6,8,6,10,28,29,-1,30
AC Horsens,3850,7,5,13,12,32,55,-23,28
Randers FC,3850,8,6,6,12,24,39,-15,24
Silkeborg IF,3850,9,6,3,13,28,45,-17,21
Lyngby,3850,10,3,9,12,26,45,-19,18
AGF Aarhus,3850,11,4,6,12,17,39,-22,18
Brondby,3851,1,20,7,3,67,30,37,67
FC Midtjylla,3851,2,20,5,5,64,40,24,65
FC Nords,3851,3,14,7,9,76,52,24,49
Copenhagen,3851,4,15,4,11,57,42,15,49
AaB,3851,5,8,12,10,34,39,-5,36
Sonderjyske,3851,6,8,6,10,28,29,-1,30
AC Horsens,3851,7,5,13,12,32,53,-21,28
Lyngby,3851,8,4,9,11,29,44,-15,21
Silkeborg IF,3851,9,6,3,13,27,45,-18,21
Randers FC,3851,10,5,6,13,23,42,-19,21
AGF Aarhus,3851,11,4,6,12,17,38,-21,18
FC Midtjylla,3852,1,21,4,5,72,40,32,67
Brondby,3852,2,20,5,5,69,35,34,65
FC Nords,3852,3,15,7,8,78,52,26,52
Copenhagen,3852,4,14,5,11,57,45,12,47
AaB,3852,5,7,12,11,38,46,-8,33
AC Horsens,3852,6,6,13,11,33,55,-22,31
Sonderjyske,3852,7,8,6,10,28,29,-1,30
Silkeborg IF,3852,8,6,3,13,31,46,-15,21
Lyngby,3852,9,4,9,11,27,44,-17,21
Randers FC,3852,10,5,6,13,23,40,-17,21
AGF Aarhus,3852,11,4,6,12,18,42,-24,18
FC Midtjylla,3853,1,21,5,4,67,37,30,68
Brondby,3853,2,20,5,5,68,34,34,65
FC Nords,3853,3,14,6,10,74,55,19,48
Copenhagen,3853,4,14,5,11,60,45,15,47
AaB,3853,5,8,12,10,41,45,-4,36
AC Horsens,3853,6,6,13,11,35,55,-20,31
Sonderjyske,3853,7,8,6,10,28,29,-1,30
Randers FC,3853,8,6,6,12,27,42,-15,24
AGF Aarhus,3853,9,5,6,11,17,36,-19,21
Lyngby,3853,10,3,9,12,29,48,-19,18
Silkeborg IF,3853,11,5,3,14,25,45,-20,18
Brondby,3854,1,21,6,3,71,34,37,69
FC Midtjylla,3854,2,19,6,5,63,37,26,63
FC Nords,3854,3,15,7,8,75,51,24,52
Copenhagen,3854,4,15,4,11,56,43,13,49
AaB,3854,5,7,11,12,37,43,-6,32
Sonderjyske,3854,6,8,6,10,28,29,-1,30
AC Horsens,3854,7,6,12,12,31,51,-20,30
Randers FC,3854,8,6,6,12,26,41,-15,24
Silkeborg IF,3854,9,6,3,13,29,45,-16,21
Lyngby,3854,10,3,9,12,28,47,-19,18
AGF Aarhus,3854,11,4,6,12,17,40,-23,18
Brondby,3855,1,21,5,4,70,31,39,68
FC Midtjylla,3855,2,20,5,5,69,38,31,65
FC Nords,3855,3,14,8,8,74,55,19,50
Copenhagen,3855,4,12,6,12,56,52,4,42
AaB,3855,5,8,12,10,35,39,-4,36
AC Horsens,3855,6,7,12,11,36,51,-15,33
Sonderjyske,3855,7,8,6,10,28,29,-1,30
Lyngby,3855,8,4,9,11,30,46,-16,21
Silkeborg IF,3855,9,6,3,13,28,45,-17,21
Randers FC,3855,10,5,6,13,25,43,-18,21
AGF Aarhus,3855,11,4,6,12,17,39,-22,18
Brondby,3856,1,22,5,3,73,30,43,71
FC Midtjylla,3856,2,21,4,5,70,36,34,67
Copenhagen,3856,3,15,4,11,59,46,13,49
FC Nords,3856,4,13,7,10,72,54,18,46
AaB,3856,5,7,12,11,34,44,-10,33
Sonderjyske,3856,6,8,6,10,28,29,-1,30
AC Horsens,3856,7,6,12,12,36,60,-24,30
Randers FC,3856,8,5,7,12,24,40,-16,22
AGF Aarhus,3856,9,5,6,11,18,37,-19,21
Lyngby,3856,10,3,10,11,27,45,-18,19
Silkeborg IF,3856,11,5,3,14,26,46,-20,18
Brondby,3857,1,23,5,2,72,29,43,74
FC Midtjylla,3857,2,20,5,5,66,35,31,65
Copenhagen,3857,3,15,4,11,57,44,13,49
FC Nords,3857,4,13,7,10,70,51,19,46
AaB,3857,5,8,11,11,36,44,-8,35
Sonderjyske,3857,6,8,6,10,28,29,-1,30
AC Horsens,3857,7,5,12,13,30,54,-24,27
Randers FC,3857,8,5,7,12,24,40,-16,22
AGF Aarhus,3857,9,5,6,11,20,37,-17,21
Lyngby,3857,10,3,10,11,27,45,-18,19
Silkeborg IF,3857,11,5,3,14,26,48,-22,18
Brondby,3858,1,22,5,3,73,30,43,71
FC Midtjylla,3858,2,19,5,6,63,39,24,62
Copenhagen,3858,3,14,5,11,58,43,15,47
FC Nords,3858,4,13,6,11,70,57,13,45
AC Horsens,3858,5,8,12,10,35,50,-15,36
AaB,3858,6,8,11,11,38,44,-6,35
Sonderjyske,3858,7,8,6,10,28,29,-1,30
Lyngby,3858,8,4,9,11,28,44,-16,21
Silkeborg IF,3858,9,6,3,13,27,44,-17,21
Randers FC,3858,10,5,6,13,23,41,-18,21
AGF Aarhus,3858,11,4,6,12,16,38,-22,18
FC Midtjylla,3859,1,19,6,5,69,46,23,63
Brondby,3859,2,18,8,4,67,34,33,62
FC Nords,3859,3,16,6,8,80,57,23,54
Copenhagen,3859,4,14,6,10,65,46,19,48
AC Horsens,3859,5,6,15,9,37,51,-14,33
AaB,3859,6,6,13,11,38,48,-10,31
Sonderjyske,3859,7,8,6,10,28,29,-1,30
Lyngby,3859,8,4,9,11,27,44,-17,21
Randers FC,3859,9,5,6,13,23,40,-17,21
Silkeborg IF,3859,10,6,3,13,26,44,-18,21
AGF Aarhus,3859,11,4,6,12,16,37,-21,18
FC Midtjylla,3860,1,20,5,5,64,39,25,65
Brondby,3860,2,19,7,4,67,36,31,64
FC Nords,3860,3,15,6,9,72,47,25,51
Copenhagen,3860,4,14,6,10,57,42,15,48
AC Horsens,3860,5,7,14,9,38,51,-13,35
Sonderjyske,3860,6,8,6,10,28,29,-1,30
AaB,3860,7,6,12,12,32,41,-9,30
Lyngby,3860,8,4,9,11,30,44,-14,21
Randers FC,3860,9,5,6,13,23,43,-20,21
Silkeborg IF,3860,10,5,4,13,26,45,-19,19
AGF Aarhus,3860,11,4,7,11,17,37,-20,19
Brondby,3861,1,21,7,2,76,34,42,70
FC Midtjylla,3861,2,19,6,5,63,38,25,63
Copenhagen,3861,3,15,4,11,61,44,17,49
FC Nords,3861,4,13,8,9,76,58,18,47
AaB,3861,5,7,11,12,36,45,-9,32
AC Horsens,3861,6,6,14,10,34,53,-19,32
Sonderjyske,3861,7,8,6,10,28,29,-1,30
Lyngby,3861,8,4,9,11,28,44,-16,21
Randers FC,3861,9,5,6,13,23,41,-18,21
AGF Aarhus,3861,10,5,6,11,19,37,-18,21
Silkeborg IF,3861,11,5,3,14,26,47,-21,18
Brondby,3862,1,20,8,2,71,34,37,68
FC Midtjylla,3862,2,18,7,5,62,38,24,61
Copenhagen,3862,3,14,5,11,58,45,13,47
FC Nords,3862,4,13,7,10,75,55,20,46
AaB,3862,5,9,13,8,44,40,4,40
Sonderjyske,3862,6,8,6,10,28,29,-1,30
AC Horsens,3862,7,5,14,11,35,59,-24,29
Lyngby,3862,8,4,9,11,29,45,-16,21
Randers FC,3862,9,5,6,13,24,42,-18,21
Silkeborg IF,3862,10,5,4,13,25,44,-19,19
AGF Aarhus,3862,11,4,7,11,16,36,-20,19
Brondby,3863,1,22,6,2,70,28,42,72
FC Midtjylla,3863,2,19,5,6,65,38,27,62
FC Nords,3863,3,15,7,8,75,49,26,52
Copenhagen,3863,4,14,5,11,57,45,12,47
AaB,3863,5,7,11,12,35,48,-13,32
Sonderjyske,3863,6,8,6,10,28,29,-1,30
AC Horsens,3863,7,5,14,11,34,54,-20,29
Randers FC,3863,8,6,6,12,25,40,-15,24
Silkeborg IF,3863,9,5,4,13,26,45,-19,19
AGF Aarhus,3863,10,4,7,11,17,37,-20,19
Lyngby,3863,11,3,9,12,27,46,-19,18
Brondby,3864,1,21,6,3,73,34,39,69
FC Midtjylla,3864,2,19,4,7,71,46,25,61
Copenhagen,3864,3,15,4,11,60,42,18,49
FC Nords,3864,4,14,6,10,71,51,20,48
AC Horsens,3864,5,7,14,9,38,54,-16,35
AaB,3864,6,7,12,11,34,46,-12,33
Sonderjyske,3864,7,8,6,10,28,29,-1,30
Lyngby,3864,8,4,9,11,30,44,-14,21
Silkeborg IF,3864,9,6,3,13,28,46,-18,21
Randers FC,3864,10,5,6,13,23,43,-20,21
AGF Aarhus,3864,11,4,6,12,18,39,-21,18
Brondby,3865,1,20,5,5,68,35,33,65
FC Midtjylla,3865,2,20,5,5,66,36,30,65
Copenhagen,3865,3,15,4,11,57,43,14,49
FC Nords,3865,4,13,8,9,72,51,21,47
AC Horsens,3865,5,7,14,9,34,47,-13,35
AaB,3865,6,7,12,11,36,47,-11,33
Sonderjyske,3865,7,8,6,10,28,29,-1,30
Randers FC,3865,8,6,6,12,27,40,-13,24
AGF Aarhus,3865,9,5,6,11,18,37,-19,21
Silkeborg IF,3865,10,5,3,14,26,46,-20,18
Lyngby,3865,11,3,9,12,27,48,-21,18
Brondby,3866,1,21,6,3,66,28,38,69
FC Midtjylla,3866,2,20,4,6,66,37,29,64
FC Nords,3866,3,15,6,9,71,51,20,51
Copenhagen,3866,4,14,5,11,56,41,15,47
AaB,3866,5,8,11,11,37,43,-6,35
Sonderjyske,3866,6,8,6,10,28,29,-1,30
AC Horsens,3866,7,6,12,12,36,58,-22,30
Lyngby,3866,8,4,9,11,28,45,-17,21
Randers FC,3866,9,5,6,13,24,41,-17,21
Silkeborg IF,3866,10,6,3,13,26,44,-18,21
AGF Aarhus,3866,11,4,6,12,16,37,-21,18
Brondby,3867,1,21,5,4,72,33,39,68
FC Midtjylla,3867,2,20,4,6,64,40,24,64
FC Nords,3867,3,15,7,8,75,51,24,52
Copenhagen,3867,4,15,4,11,60,46,14,49
AaB,3867,5,8,12,10,36,42,-6,36
Sonderjyske,3867,6,8,6,10,28,29,-1,30
AC Horsens,3867,7,5,12,13,33,54,-21,27
Randers FC,3867,8,6,6,12,25,40,-15,24
Silkeborg IF,3867,9,5,4,13,26,45,-19,19
AGF Aarhus,3867,10,4,7,11,17,37,-20,19
Lyngby,3867,11,3,9,12,27,46,-19,18
Brondby,3868,1,21,6,3,76,33,43,69
FC Midtjylla,3868,2,21,5,4,75,41,34,68
FC Nords,3868,3,14,7,9,69,50,19,49
Copenhagen,3868,4,14,5,11,57,45,12,47
AaB,3868,5,6,13,11,36,46,-10,31
Sonderjyske,3868,6,8,6,10,28,29,-1,30
AC Horsens,3868,7,6,12,12,32,56,-24,30
Randers FC,3868,8,6,6,12,25,40,-15,24
AGF Aarhus,3868,9,5,6,11,18,37,-19,21
Lyngby,3868,10,3,9,12,27,46,-19,18
Silkeborg IF,3868,11,5,3,14,26,46,-20,18
Brondby,3869,1,20,5,5,68,35,33,65
FC Midtjylla,3869,2,19,5,6,63,38,25,62
FC Nords,3869,3,15,6,9,75,49,26,51
Copenhagen,3869,4,15,5,10,61,45,16,50
AaB,3869,5,8,13,9,39,43,-4,37
Sonderjyske,3869,6,8,6,10,28,29,-1,30
AC Horsens,3869,7,6,12,12,35,57,-22,30
Randers FC,3869,8,6,6,12,27,42,-15,24
AGF Aarhus,3869,9,5,6,11,18,37,-19,21
Lyngby,3869,10,3,9,12,29,48,-19,18
Silkeborg IF,3869,11,5,3,14,26,46,-20,18
Brondby,3870,1,22,5,3,72,32,40,71
FC Midtjylla,3870,2,19,5,6,71,42,29,62
FC Nords,3870,3,15,7,8,75,54,21,52
Copenhagen,3870,4,13,5,12,55,46,9,44
AaB,3870,5,7,12,11,35,42,-7,33
AC Horsens,3870,6,6,14,10,36,54,-18,32
Sonderjyske,3870,7,8,6,10,28,29,-1,30
Lyngby,3870,8,4,9,11,30,44,-14,21
Randers FC,3870,9,5,6,13,23,43,-20,21
Silkeborg IF,3870,10,5,4,13,27,46,-19,19
AGF Aarhus,3870,11,4,7,11,18,38,-20,19
Brondby,3871,1,21,6,3,73,31,42,69
FC Midtjylla,3871,2,19,5,6,67,39,28,62
FC Nords,3871,3,14,6,10,70,53,17,48
Copenhagen,3871,4,13,7,10,53,40,13,46
AaB,3871,5,9,11,10,39,45,-6,38
AC Horsens,3871,6,6,13,11,34,54,-20,31
Sonderjyske,3871,7,8,6,10,28,29,-1,30
Lyngby,3871,8,4,9,11,29,45,-16,21
Silkeborg IF,3871,9,6,3,13,26,44,-18,21
Randers FC,3871,10,5,6,13,24,42,-18,21
AGF Aarhus,3871,11,4,6,12,16,37,-21,18
Brondby,3872,1,22,6,2,75,29,46,72
FC Midtjylla,3872,2,19,4,7,61,39,22,61
FC Nords,3872,3,14,7,9,75,57,18,49
Copenhagen,3872,4,14,4,12,58,47,11,46
AC Horsens,3872,5,7,13,10,39,54,-15,34
AaB,3872,6,7,12,11,37,45,-8,33
Sonderjyske,3872,7,8,6,10,28,29,-1,30
Randers FC,3872,8,5,7,12,25,41,-16,22
Lyngby,3872,9,3,10,11,28,46,-18,19
Silkeborg IF,3872,10,5,4,13,27,46,-19,19
AGF Aarhus,3872,11,4,7,11,18,38,-20,19
Brondby,3873,1,20,7,3,72,33,39,67
FC Midtjylla,3873,2,18,6,6,60,39,21,60
Copenhagen,3873,3,15,6,9,62,45,17,51
FC Nords,3873,4,14,8,8,75,53,22,50
AC Horsens,3873,5,6,14,10,38,53,-15,32
AaB,3873,6,6,13,11,38,48,-10,31
Sonderjyske,3873,7,8,6,10,28,29,-1,30
Randers FC,3873,8,5,7,12,24,40,-16,22
Silkeborg IF,3873,9,6,3,13,27,45,-18,21
Lyngby,3873,10,3,10,11,27,45,-18,19
AGF Aarhus,3873,11,4,6,12,17,38,-21,18
Brondby,3874,1,21,6,3,71,34,37,69
FC Midtjylla,3874,2,21,4,5,67,37,30,67
FC Nords,3874,3,13,7,10,73,52,21,46
Copenhagen,3874,4,12,7,11,52,43,9,43
AaB,3874,5,8,12,10,39,45,-6,36
AC Horsens,3874,6,6,14,10,33,50,-17,32
Sonderjyske,3874,7,8,6,10,28,29,-1,30
Lyngby,3874,8,4,9,11,29,46,-17,21
Randers FC,3874,9,5,6,13,25,42,-17,21
Silkeborg IF,3874,10,5,4,13,26,45,-19,19
AGF Aarhus,3874,11,4,7,11,17,37,-20,19
Brondby,3875,1,20,6,4,74,32,42,66
FC Midtjylla,3875,2,20,5,5,70,42,28,65
FC Nords,3875,3,15,7,8,77,51,26,52
Copenhagen,3875,4,14,4,12,56,48,8,46
AaB,3875,5,7,14,9,39,42,-3,35
Sonderjyske,3875,6,8,6,10,28,29,-1,30
AC Horsens,3875,7,6,12,12,34,61,-27,30
Randers FC,3875,8,5,7,12,24,40,-16,22
Silkeborg IF,3875,9,6,3,13,26,44,-18,21
Lyngby,3875,10,3,10,11,27,45,-18,19
AGF Aarhus,3875,11,4,6,12,16,37,-21,18
Brondby,3876,1,20,7,3,69,33,36,67
FC Midtjylla,3876,2,20,5,5,69,40,29,65
FC Nords,3876,3,13,8,9,73,55,18,47
Copenhagen,3876,4,13,7,10,57,44,13,46
AaB,3876,5,8,12,10,39,41,-2,36
AC Horsens,3876,6,6,13,11,36,56,-20,31
Sonderjyske,3876,7,8,6,10,28,29,-1,30
Randers FC,3876,8,6,6,12,25,40,-15,24
AGF Aarhus,3876,9,5,6,11,17,36,-19,21
Lyngby,3876,10,3,9,12,27,46,-19,18
Silkeborg IF,3876,11,5,3,14,25,45,-20,18
Brondby,3877,1,20,6,4,67,35,32,66
FC Midtjylla,3877,2,20,5,5,74,38,36,65
Copenhagen,3877,3,14,6,10,58,46,12,48
FC Nords,3877,4,13,7,10,71,59,12,46
AC Horsens,3877,5,8,13,9,39,50,-11,37
AaB,3877,6,6,13,11,34,41,-7,31
Sonderjyske,3877,7,8,6,10,28,29,-1,30
Randers FC,3877,8,6,6,12,25,40,-15,24
AGF Aarhus,3877,9,5,6,11,17,36,-19,21
Lyngby,3877,10,3,9,12,27,46,-19,18
Silkeborg IF,3877,11,5,3,14,25,45,-20,18
Brondby,3878,1,20,6,4,68,31,37,66
FC Midtjylla,3878,2,18,7,5,64,37,27,61
FC Nords,3878,3,15,8,7,75,49,26,53
Copenhagen,3878,4,15,6,9,59,41,18,51
AaB,3878,5,6,13,11,38,48,-10,31
Sonderjyske,3878,6,8,6,10,28,29,-1,30
AC Horsens,3878,7,6,12,12,32,56,-24,30
Silkeborg IF,3878,8,6,3,13,28,45,-17,21
Lyngby,3878,9,4,9,11,27,44,-17,21
Randers FC,3878,10,5,6,13,23,40,-17,21
AGF Aarhus,3878,11,4,6,12,17,39,-22,18
Brondby,3879,1,21,7,2,78,34,44,70
FC Midtjylla,3879,2,18,5,7,66,49,17,59
FC Nords,3879,3,15,6,9,77,52,25,51
Copenhagen,3879,4,13,7,10,61,50,11,46
AC Horsens,3879,5,7,14,9,37,52,-15,35
AaB,3879,6,7,11,12,38,46,-8,32
Sonderjyske,3879,7,8,6,10,28,29,-1,30
Randers FC,3879,8,5,7,12,23,39,-16,22
Silkeborg IF,3879,9,6,3,13,30,45,-15,21
Lyngby,3879,10,3,10,11,26,44,-18,19
AGF Aarhus,3879,11,4,6,12,17,41,-24,18
Brondby,3880,1,20,7,3,69,30,39,67
FC Midtjylla,3880,2,20,5,5,70,41,29,65
FC Nords,3880,3,14,8,8,73,53,20,50
Copenhagen,3880,4,15,4,11,58,41,17,49
AaB,3880,5,8,11,11,37,43,-6,35
Sonderjyske,3880,6,8,6,10,28,29,-1,30
AC Horsens,3880,7,5,13,12,33,58,-25,28
Lyngby,3880,8,4,9,11,27,44,-17,21
Randers FC,3880,9,5,6,13,23,40,-17,21
AGF Aarhus,3880,10,5,6,11,17,36,-19,21
Silkeborg IF,3880,11,5,3,14,25,45,-20,18
Brondby,3881,1,23,5,2,74,31,43,74
FC Midtjylla,3881,2,19,6,5,64,37,27,63
FC Nords,3881,3,13,8,9,71,51,20,47
Copenhagen,3881,4,14,5,11,61,48,13,47
AaB,3881,5,7,12,11,37,45,-8,33
Sonderjyske,3881,6,8,6,10,28,29,-1,30
AC Horsens,3881,7,5,14,11,34,55,-21,29
Randers FC,3881,8,5,7,12,24,40,-16,22
AGF Aarhus,3881,9,5,6,11,19,37,-18,21
Lyngby,3881,10,3,10,11,27,45,-18,19
Silkeborg IF,3881,11,5,3,14,26,47,-21,18
FC Midtjylla,3882,1,20,5,5,68,39,29,65
Brondby,3882,2,19,6,5,70,36,34,63
FC Nords,3882,3,15,7,8,74,51,23,52
Copenhagen,3882,4,14,4,12,57,49,8,46
AaB,3882,5,9,12,9,39,40,-1,39
Sonderjyske,3882,6,8,6,10,28,29,-1,30
AC Horsens,3882,7,6,12,12,36,55,-19,30
Lyngby,3882,8,4,9,11,27,44,-17,21
Randers FC,3882,9,5,6,13,23,40,-17,21
AGF Aarhus,3882,10,5,6,11,20,37,-17,21
Silkeborg IF,3882,11,5,3,14,26,48,-22,18
Brondby,3883,1,22,5,3,74,33,41,71
FC Midtjylla,3883,2,19,4,7,69,43,26,61
FC Nords,3883,3,13,7,10,71,57,14,46
Copenhagen,3883,4,14,4,12,56,46,10,46
AaB,3883,5,9,11,10,37,40,-3,38
AC Horsens,3883,6,7,13,10,36,50,-14,34
Sonderjyske,3883,7,8,6,10,28,29,-1,30
Lyngby,3883,8,4,9,11,29,44,-15,21
AGF Aarhus,3883,9,5,6,11,19,36,-17,21
Randers FC,3883,10,5,6,13,23,42,-19,21
Silkeborg IF,3883,11,5,3,14,25,47,-22,18
Brondby,3884,1,21,7,2,75,32,43,70
FC Midtjylla,3884,2,19,5,6,62,40,22,62
Copenhagen,3884,3,15,5,10,63,46,17,50
FC Nords,3884,4,12,7,11,73,57,16,43
AaB,3884,5,9,13,8,44,43,1,40
Sonderjyske,3884,6,8,6,10,28,29,-1,30
AC Horsens,3884,7,5,13,12,37,62,-25,28
Randers FC,3884,8,5,7,12,24,40,-16,22
Silkeborg IF,3884,9,6,3,13,29,45,-16,21
Lyngby,3884,10,3,10,11,27,45,-18,19
AGF Aarhus,3884,11,4,6,12,17,40,-23,18
Brondby,3885,1,23,5,2,74,30,44,74
FC Midtjylla,3885,2,18,6,6,63,40,23,60
FC Nords,3885,3,14,7,9,70,51,19,49
Copenhagen,3885,4,13,5,12,61,54,7,44
AC Horsens,3885,5,7,13,10,39,52,-13,34
AaB,3885,6,7,12,11,37,43,-6,33
Sonderjyske,3885,7,8,6,10,28,29,-1,30
Lyngby,3885,8,4,9,11,27,44,-17,21
Randers FC,3885,9,5,6,13,23,40,-17,21
Silkeborg IF,3885,10,6,3,13,27,45,-18,21
AGF Aarhus,3885,11,4,6,12,17,38,-21,18
Brondby,3886,1,21,5,4,74,38,36,68
FC Midtjylla,3886,2,20,4,6,66,39,27,64
Copenhagen,3886,3,15,5,10,59,43,16,50
FC Nords,3886,4,14,6,10,73,54,19,48
AaB,3886,5,7,12,11,36,46,-10,33
AC Horsens,3886,6,7,12,11,40,54,-14,33
Sonderjyske,3886,7,8,6,10,28,29,-1,30
Randers FC,3886,8,5,7,12,26,42,-16,22
Lyngby,3886,9,3,10,11,29,47,-18,19
Silkeborg IF,3886,10,5,4,13,28,47,-19,19
AGF Aarhus,3886,11,4,7,11,19,39,-20,19
Brondby,3887,1,22,6,2,73,30,43,72
FC Midtjylla,3887,2,19,5,6,69,43,26,62
FC Nords,3887,3,13,8,9,70,52,18,47
Copenhagen,3887,4,14,5,11,60,46,14,47
AaB,3887,5,8,13,9,35,40,-5,37
Sonderjyske,3887,6,8,6,10,28,29,-1,30
AC Horsens,3887,7,5,13,12,33,55,-22,28
Randers FC,3887,8,5,7,12,24,40,-16,22
AGF Aarhus,3887,9,5,6,11,18,36,-18,21
Lyngby,3887,10,3,10,11,27,45,-18,19
Silkeborg IF,3887,11,5,3,14,25,46,-21,18
Brondby,3888,1,21,6,3,71,32,39,69
FC Midtjylla,3888,2,19,6,5,65,40,25,63
FC Nords,3888,3,14,7,9,72,49,23,49
Copenhagen,3888,4,12,6,12,53,46,7,42
AC Horsens,3888,5,8,12,10,38,52,-14,36
AaB,3888,6,7,13,10,36,42,-6,34
Sonderjyske,3888,7,8,6,10,28,29,-1,30
Randers FC,3888,8,6,6,12,25,40,-15,24
AGF Aarhus,3888,9,5,6,11,17,36,-19,21
Lyngby,3888,10,3,9,12,27,46,-19,18
Silkeborg IF,3888,11,5,3,14,25,45,-20,18
FC Midtjylla,3889,1,20,6,4,78,42,36,66
Brondby,3889,2,19,6,5,68,35,33,63
FC Nords,3889,3,14,7,9,68,52,16,49
Copenhagen,3889,4,12,7,11,59,50,9,43
AaB,3889,5,8,14,8,40,41,-1,38
AC Horsens,3889,6,6,14,10,35,54,-19,32
Sonderjyske,3889,7,8,6,10,28,29,-1,30
Lyngby,3889,8,4,9,11,28,44,-16,21
Silkeborg IF,3889,9,6,3,13,29,46,-17,21
Randers FC,3889,10,5,6,13,23,41,-18,21
AGF Aarhus,3889,11,4,6,12,18,40,-22,18
Brondby,3890,1,21,6,3,74,33,41,69
FC Midtjylla,3890,2,19,6,5,67,40,27,63
FC Nords,3890,3,15,7,8,74,52,22,52
Copenhagen,3890,4,13,7,10,55,44,11,46
AaB,3890,5,6,14,10,35,41,-6,32
Sonderjyske,3890,6,8,6,10,28,29,-1,30
AC Horsens,3890,7,5,14,11,33,54,-21,29
Lyngby,3890,8,4,9,11,29,45,-16,21
Randers FC,3890,9,5,6,13,24,42,-18,21
Silkeborg IF,3890,10,5,4,13,27,46,-19,19
AGF Aarhus,3890,11,4,7,11,18,38,-20,19
FC Midtjylla,3891,1,21,4,5,68,41,27,67
Brondby,3891,2,20,6,4,77,34,43,66
FC Nords,3891,3,14,7,9,72,51,21,49
Copenhagen,3891,4,14,5,11,58,45,13,47
AC Horsens,3891,5,7,13,10,39,56,-17,34
AaB,3891,6,7,11,12,34,47,-13,32
Sonderjyske,3891,7,8,6,10,28,29,-1,30
Randers FC,3891,8,5,7,12,23,39,-16,22
AGF Aarhus,3891,9,5,6,11,17,36,-19,21
Lyngby,3891,10,3,10,11,26,44,-18,19
Silkeborg IF,3891,11,5,3,14,25,45,-20,18
Brondby,3892,1,21,7,2,71,31,40,70
FC Midtjylla,3892,2,17,8,5,64,42,22,59
FC Nords,3892,3,14,8,8,70,49,21,50
Copenhagen,3892,4,13,6,11,57,46,11,45
AaB,3892,5,7,13,10,40,43,-3,34
AC Horsens,3892,6,6,14,10,32,49,-17,32
Sonderjyske,3892,7,8,6,10,28,29,-1,30
Randers FC,3892,8,6,6,12,24,39,-15,24
Silkeborg IF,3892,9,6,3,13,28,44,-16,21
Lyngby,3892,10,3,9,12,26,45,-19,18
AGF Aarhus,3892,11,4,6,12,16,39,-23,18
Brondby,3893,1,19,8,3,69,34,35,65
FC Midtjylla,3893,2,20,4,6,68,40,28,64
FC Nords,3893,3,13,9,8,76,54,22,48
Copenhagen,3893,4,13,6,11,58,45,13,45
AaB,3893,5,8,13,9,38,44,-6,37
AC Horsens,3893,6,7,12,11,35,53,-18,33
Sonderjyske,3893,7,8,6,10,28,29,-1,30
Randers FC,3893,8,6,6,12,26,41,-15,24
Silkeborg IF,3893,9,6,3,13,26,44,-18,21
Lyngby,3893,10,3,9,12,28,47,-19,18
AGF Aarhus,3893,11,4,6,12,16,37,-21,18
Brondby,3894,1,22,6,2,71,28,43,72
FC Midtjylla,3894,2,20,5,5,64,38,26,65
FC Nords,3894,3,14,6,10,73,51,22,48
Copenhagen,3894,4,12,6,12,51,44,7,42
AaB,3894,5,8,11,11,35,41,-6,35
AC Horsens,3894,6,7,12,11,34,52,-18,33
Sonderjyske,3894,7,8,6,10,28,29,-1,30
Randers FC,3894,8,5,7,12,24,40,-16,22
Silkeborg IF,3894,9,6,3,13,27,44,-17,21
Lyngby,3894,10,3,10,11,27,45,-18,19
AGF Aarhus,3894,11,4,6,12,16,38,-22,18
Brondby,3895,1,21,5,4,73,38,35,68
FC Midtjylla,3895,2,21,4,5,70,37,33,67
FC Nords,3895,3,16,6,8,77,51,26,54
Copenhagen,3895,4,14,4,12,61,49,12,46
AC Horsens,3895,5,7,12,11,33,52,-19,33
Sonderjyske,3895,6,8,6,10,28,29,-1,30
AaB,3895,7,6,11,13,35,48,-13,29
Randers FC,3895,8,6,6,12,26,39,-13,24
AGF Aarhus,3895,9,5,6,11,19,36,-17,21
Lyngby,3895,10,3,9,12,26,47,-21,18
Silkeborg IF,3895,11,5,3,14,25,47,-22,18
Brondby,3896,1,22,6,2,74,31,43,72
FC Midtjylla,3896,2,18,5,7,62,40,22,59
FC Nords,3896,3,14,7,9,72,50,22,49
Copenhagen,3896,4,13,6,11,54,42,12,45
AaB,3896,5,8,11,11,36,42,-6,35
AC Horsens,3896,6,7,13,10,33,52,-19,34
Sonderjyske,3896,7,8,6,10,28,29,-1,30
Randers FC,3896,8,6,6,12,24,39,-15,24
AGF Aarhus,3896,9,5,6,11,17,36,-19,21
Lyngby,3896,10,3,9,12,26,45,-19,18
Silkeborg IF,3896,11,5,3,14,25,45,-20,18
FC Midtjylla,3897,1,21,5,4,70,40,30,68
Brondby,3897,2,19,7,4,71,39,32,64
FC Nords,3897,3,15,6,9,78,51,27,51
Copenhagen,3897,4,13,5,12,56,48,8,44
AaB,3897,5,8,12,10,37,39,-2,36
AC Horsens,3897,6,6,13,11,34,55,-21,31
Sonderjyske,3897,7,8,6,10,28,29,-1,30
Randers FC,3897,8,6,6,12,25,40,-15,24
AGF Aarhus,3897,9,5,6,11,19,37,-18,21
Lyngby,3897,10,3,9,12,27,46,-19,18
Silkeborg IF,3897,11,5,3,14,26,47,-21,18
Brondby,3898,1,21,7,2,74,31,43,70
FC Midtjylla,3898,2,18,8,4,65,39,26,62
Copenhagen,3898,3,14,6,10,61,48,13,48
FC Nords,3898,4,13,8,9,71,54,17,47
AaB,3898,5,7,12,11,39,46,-7,33
Sonderjyske,3898,6,8,6,10,28,29,-1,30
AC Horsens,3898,7,5,15,10,33,51,-18,30
Randers FC,3898,8,5,7,12,24,40,-16,22
Silkeborg IF,3898,9,6,3,13,27,45,-18,21
Lyngby,3898,10,3,10,11,27,45,-18,19
AGF Aarhus,3898,11,4,6,12,17,38,-21,18
Brondby,3899,1,20,7,3,68,31,37,67
FC Midtjylla,3899,2,19,4,7,62,40,22,61
FC Nords,3899,3,14,7,9,75,54,21,49
Copenhagen,3899,4,12,7,11,59,48,11,43
AaB,3899,5,8,13,9,41,44,-3,37
AC Horsens,3899,6,7,14,9,36,50,-14,35
Sonderjyske,3899,7,8,6,10,28,29,-1,30
Randers FC,3899,8,6,6,12,27,42,-15,24
Silkeborg IF,3899,9,6,3,13,28,45,-17,21
Lyngby,3899,10,3,9,12,29,48,-19,18
AGF Aarhus,3899,11,4,6,12,17,39,-22,18
Brondby,3900,1,21,6,3,74,32,42,69
FC Midtjylla,3900,2,19,4,7,63,43,20,61
FC Nords,3900,3,15,6,9,74,50,24,51
Copenhagen,3900,4,15,4,11,58,43,15,49
AaB,3900,5,9,11,10,39,43,-4,38
Sonderjyske,3900,6,8,6,10,28,29,-1,30
AC Horsens,3900,7,5,13,12,30,53,-23,28
Randers FC,3900,8,6,6,12,27,39,-12,24
Silkeborg IF,3900,9,6,3,13,27,44,-17,21
Lyngby,3900,10,3,9,12,26,48,-22,18
AGF Aarhus,3900,11,4,6,12,16,38,-22,18
Brondby,3901,1,22,6,2,75,31,44,72
FC Midtjylla,3901,2,19,4,7,67,43,24,61
Copenhagen,3901,3,15,4,11,61,48,13,49
FC Nords,3901,4,14,6,10,73,53,20,48
AC Horsens,3901,5,7,13,10,37,52,-15,34
AaB,3901,6,7,11,12,35,47,-12,32
Sonderjyske,3901,7,8,6,10,28,29,-1,30
Randers FC,3901,8,5,7,12,24,40,-16,22
Silkeborg IF,3901,9,6,3,13,26,44,-18,21
Lyngby,3901,10,3,10,11,27,45,-18,19
AGF Aarhus,3901,11,4,6,12,16,37,-21,18
Brondby,3902,1,21,6,3,69,32,37,69
FC Midtjylla,3902,2,21,5,4,69,37,32,68
FC Nords,3902,3,14,7,9,75,53,22,49
Copenhagen,3902,4,13,5,12,56,47,9,44
AC Horsens,3902,5,7,12,11,36,50,-14,33
AaB,3902,6,7,11,12,36,48,-12,32
Sonderjyske,3902,7,8,6,10,28,29,-1,30
Lyngby,3902,8,4,9,11,27,44,-17,21
Randers FC,3902,9,5,6,13,23,40,-17,21
Silkeborg IF,3902,10,5,4,13,26,45,-19,19
AGF Aarhus,3902,11,4,7,11,17,37,-20,19
Brondby,3903,1,22,6,2,75,35,40,72
FC Midtjylla,3903,2,19,6,5,68,40,28,63
Copenhagen,3903,3,14,5,11,58,43,15,47
FC Nords,3903,4,13,7,10,74,56,18,46
AaB,3903,5,7,12,11,37,46,-9,33
AC Horsens,3903,6,7,12,11,38,56,-18,33
Sonderjyske,3903,7,8,6,10,28,29,-1,30
Randers FC,3903,8,5,7,12,24,40,-16,22
AGF Aarhus,3903,9,5,6,11,19,38,-19,21
Lyngby,3903,10,3,10,11,27,45,-18,19
Silkeborg IF,3903,11,5,3,14,27,47,-20,18
Brondby,3904,1,20,6,4,68,30,38,66
FC Midtjylla,3904,2,19,6,5,64,39,25,63
Copenhagen,3904,3,15,5,10,58,42,16,50
FC Nords,3904,4,14,6,10,70,53,17,48
AaB,3904,5,8,11,11,36,42,-6,35
AC Horsens,3904,6,6,14,10,38,54,-16,32
Sonderjyske,3904,7,8,6,10,28,29,-1,30
Randers FC,3904,8,6,6,12,24,39,-15,24
Silkeborg IF,3904,9,6,3,13,27,44,-17,21
Lyngby,3904,10,3,9,12,26,45,-19,18
AGF Aarhus,3904,11,4,6,12,16,38,-22,18
Brondby,3905,1,20,6,4,72,38,34,66
FC Midtjylla,3905,2,20,5,5,74,43,31,65
FC Nords,3905,3,14,7,9,75,54,21,49
Copenhagen,3905,4,15,4,11,62,46,16,49
AaB,3905,5,8,12,10,42,48,-6,36
Sonderjyske,3905,6,8,6,10,28,29,-1,30
AC Horsens,3905,7,5,14,11,34,56,-22,29
Randers FC,3905,8,5,7,12,26,42,-16,22
Silkeborg IF,3905,9,6,3,13,27,44,-17,21
Lyngby,3905,10,3,10,11,29,47,-18,19
AGF Aarhus,3905,11,4,6,12,16,38,-22,18
Brondby,3906,1,20,7,3,70,35,35,67
FC Midtjylla,3906,2,20,4,6,67,40,27,64
FC Nords,3906,3,14,7,9,71,53,18,49
Copenhagen,3906,4,12,4,14,53,46,7,40
AaB,3906,5,8,13,9,41,43,-2,37
AC Horsens,3906,6,8,13,9,42,53,-11,37
Sonderjyske,3906,7,8,6,10,28,29,-1,30
Silkeborg IF,3906,8,6,3,13,29,44,-15,21
Lyngby,3906,9,4,9,11,29,46,-17,21
Randers FC,3906,10,5,6,13,25,42,-17,21
AGF Aarhus,3906,11,4,6,12,16,40,-24,18
Brondby,3907,1,20,7,3,67,30,37,67
FC Midtjylla,3907,2,18,6,6,65,41,24,60
FC Nords,3907,3,16,7,7,75,49,26,55
Copenhagen,3907,4,13,5,12,59,47,12,44
AC Horsens,3907,5,8,13,9,33,47,-14,37
Sonderjyske,3907,6,8,6,10,28,29,-1,30
AaB,3907,7,6,12,12,34,45,-11,30
Randers FC,3907,8,5,7,12,24,40,-16,22
Silkeborg IF,3907,9,6,3,13,27,45,-18,21
Lyngby,3907,10,3,10,11,27,45,-18,19
AGF Aarhus,3907,11,4,6,12,17,38,-21,18
Brondby,3908,1,21,5,4,70,33,37,68
FC Midtjylla,3908,2,20,4,6,72,43,29,64
FC Nords,3908,3,15,7,8,76,52,24,52
Copenhagen,3908,4,13,4,13,53,45,8,43
AaB,3908,5,9,12,9,41,45,-4,39
Sonderjyske,3908,6,8,6,10,28,29,-1,30
AC Horsens,3908,7,6,12,12,32,52,-20,30
Randers FC,3908,8,5,7,12,23,39,-16,22
Lyngby,3908,9,3,10,11,26,44,-18,19
Silkeborg IF,3908,10,5,4,13,25,44,-19,19
AGF Aarhus,3908,11,4,7,11,16,36,-20,19
FC Midtjylla,3909,1,21,4,5,67,36,31,67
Brondby,3909,2,19,7,4,68,36,32,64
FC Nords,3909,3,14,7,9,74,55,19,49
Copenhagen,3909,4,14,5,11,58,45,13,47
AC Horsens,3909,5,8,13,9,38,50,-12,37
Sonderjyske,3909,6,8,6,10,28,29,-1,30
AaB,3909,7,6,12,12,37,46,-9,30
Lyngby,3909,8,4,9,11,27,44,-17,21
Randers FC,3909,9,5,6,13,23,40,-17,21
Silkeborg IF,3909,10,6,3,13,27,45,-18,21
AGF Aarhus,3909,11,4,6,12,17,38,-21,18
Brondby,3910,1,22,5,3,78,38,40,71
FC Midtjylla,3910,2,20,4,6,66,39,27,64
Copenhagen,3910,3,15,5,10,63,45,18,50
FC Nords,3910,4,13,8,9,75,55,20,47
AC Horsens,3910,5,6,14,10,37,55,-18,32
Sonderjyske,3910,6,8,6,10,28,29,-1,30
AaB,3910,7,6,12,12,37,50,-13,30
Randers FC,3910,8,5,7,12,24,40,-16,22
Silkeborg IF,3910,9,6,3,13,27,45,-18,21
Lyngby,3910,10,3,10,11,27,45,-18,19
AGF Aarhus,3910,11,4,6,12,17,38,-21,18
Brondby,3911,1,21,6,3,69,30,39,69
FC Midtjylla,3911,2,21,4,5,68,38,30,67
FC Nords,3911,3,14,7,9,74,57,17,49
Copenhagen,3911,4,13,4,13,61,48,13,43
AaB,3911,5,8,12,10,37,41,-4,36
Sonderjyske,3911,6,8,6,10,28,29,-1,30
AC Horsens,3911,7,5,15,10,32,53,-21,30
Randers FC,3911,8,6,6,12,25,39,-14,24
AGF Aarhus,3911,9,5,6,11,20,37,-17,21
Lyngby,3911,10,3,9,12,26,46,-20,18
Silkeborg IF,3911,11,5,3,14,26,48,-22,18
Brondby,3912,1,21,7,2,69,30,39,70
FC Midtjylla,3912,2,18,6,6,62,41,21,60
FC Nords,3912,3,15,7,8,74,48,26,52
Copenhagen,3912,4,12,5,13,53,46,7,41
AC Horsens,3912,5,7,14,9,38,51,-13,35
AaB,3912,6,7,13,10,34,40,-6,34
Sonderjyske,3912,7,8,6,10,28,29,-1,30
Randers FC,3912,8,6,6,12,25,40,-15,24
Silkeborg IF,3912,9,5,4,13,25,44,-19,19
AGF Aarhus,3912,10,4,7,11,16,36,-20,19
Lyngby,3912,11,3,9,12,27,46,-19,18
Brondby,3913,1,20,6,4,73,39,34,66
FC Midtjylla,3913,2,19,6,5,68,42,26,63
Copenhagen,3913,3,15,5,10,61,43,18,50
FC Nords,3913,4,13,7,10,72,56,16,46
AaB,3913,5,8,12,10,39,43,-4,36
AC Horsens,3913,6,7,12,11,35,51,-16,33
Sonderjyske,3913,7,8,6,10,28,29,-1,30
Lyngby,3913,8,4,9,11,28,44,-16,21
Silkeborg IF,3913,9,6,3,13,28,45,-17,21
Randers FC,3913,10,5,6,13,23,41,-18,21
AGF Aarhus,3913,11,4,6,12,17,39,-22,18
Brondby,3914,1,20,6,4,75,37,38,66
FC Midtjylla,3914,2,20,5,5,71,40,31,65
FC Nords,3914,3,14,6,10,70,51,19,48
Copenhagen,3914,4,13,6,11,60,50,10,45
AC Horsens,3914,5,7,14,9,36,51,-15,35
AaB,3914,6,7,13,10,37,46,-9,34
Sonderjyske,3914,7,8,6,10,28,29,-1,30
Lyngby,3914,8,4,9,11,27,44,-17,21
Silkeborg IF,3914,8,6,3,13,27,44,-17,21
Randers FC,3914,10,5,6,13,23,40,-17,21
AGF Aarhus,3914,11,4,6,12,16,38,-22,18
Brondby,3915,1,22,6,2,72,30,42,72
FC Midtjylla,3915,2,19,6,5,74,41,33,63
FC Nords,3915,3,15,7,8,78,51,27,52
Copenhagen,3915,4,14,5,11,58,44,14,47
AaB,3915,5,7,12,11,36,47,-11,33
Sonderjyske,3915,6,8,6,10,28,29,-1,30
AC Horsens,3915,7,5,12,13,32,63,-31,27
Randers FC,3915,8,5,7,12,23,39,-16,22
Lyngby,3915,9,3,10,11,26,44,-18,19
Silkeborg IF,3915,10,5,4,13,26,45,-19,19
AGF Aarhus,3915,11,4,7,11,17,37,-20,19
Brondby,3916,1,21,6,3,74,36,38,69
FC Midtjylla,3916,2,19,5,6,62,37,25,62
FC Nords,3916,3,14,8,8,78,53,25,50
Copenhagen,3916,4,14,4,12,59,45,14,46
AC Horsens,3916,5,8,12,10,38,55,-17,36
AaB,3916,6,7,11,12,37,48,-11,32
Sonderjyske,3916,7,8,6,10,28,29,-1,30
Lyngby,3916,8,4,9,11,27,44,-17,21
Randers FC,3916,9,5,6,13,23,40,-17,21
Silkeborg IF,3916,10,5,4,13,26,45,-19,19
AGF Aarhus,3916,11,4,7,11,17,37,-20,19
Brondby,3917,1,21,6,3,72,33,39,69
FC Midtjylla,3917,2,19,6,5,66,42,24,63
FC Nords,3917,3,15,7,8,78,52,26,52
Copenhagen,3917,4,13,6,11,58,46,12,45
AaB,3917,5,8,11,11,37,46,-9,35
Sonderjyske,3917,6,8,6,10,28,29,-1,30
AC Horsens,3917,7,6,12,12,38,56,-18,30
Randers FC,3917,8,5,7,12,23,39,-16,22
AGF Aarhus,3917,9,5,6,11,17,36,-19,21
Lyngby,3917,10,3,10,11,26,44,-18,19
Silkeborg IF,3917,11,5,3,14,25,45,-20,18
Brondby,3918,1,20,5,5,67,35,32,65
FC Midtjylla,3918,2,19,4,7,60,37,23,61
FC Nords,3918,3,14,8,8,73,50,23,50
Copenhagen,3918,4,15,5,10,60,43,17,50
AaB,3918,5,8,12,10,34,38,-4,36
AC Horsens,3918,6,7,12,11,34,51,-17,33
Sonderjyske,3918,7,8,6,10,28,29,-1,30
Lyngby,3918,8,4,9,11,28,44,-16,21
Silkeborg IF,3918,9,6,3,13,27,44,-17,21
Randers FC,3918,10,5,6,13,23,41,-18,21
AGF Aarhus,3918,11,4,6,12,16,38,-22,18
Brondby,3919,1,21,5,4,70,35,35,68
FC Midtjylla,3919,2,20,4,6,69,41,28,64
FC Nords,3919,3,15,7,8,74,49,25,52
Copenhagen,3919,4,14,5,11,61,48,13,47
AaB,3919,5,7,12,11,37,47,-10,33
AC Horsens,3919,6,6,13,11,34,51,-17,31
Sonderjyske,3919,7,8,6,10,28,29,-1,30
Randers FC,3919,8,6,6,12,25,39,-14,24
AGF Aarhus,3919,9,5,6,11,17,36,-19,21
Lyngby,3919,10,3,9,12,26,46,-20,18
Silkeborg IF,3919,11,5,3,14,25,45,-20,18
Brondby,3920,1,22,6,2,72,31,41,72
FC Midtjylla,3920,2,19,6,5,65,38,27,63
FC Nords,3920,3,14,7,9,75,48,27,49
Copenhagen,3920,4,12,6,12,55,48,7,42
AaB,3920,5,8,11,11,35,43,-8,35
AC Horsens,3920,6,7,12,11,37,57,-20,33
Sonderjyske,3920,7,8,6,10,28,29,-1,30
Lyngby,3920,8,4,9,11,29,44,-15,21
AGF Aarhus,3920,9,5,6,11,18,36,-18,21
Randers FC,3920,10,5,6,13,23,42,-19,21
Silkeborg IF,3920,11,5,3,14,25,46,-21,18
Brondby,3921,1,21,5,4,71,36,35,68
FC Midtjylla,3921,2,20,5,5,69,39,30,65
FC Nords,3921,3,15,7,8,78,49,29,52
Copenhagen,3921,4,13,4,13,57,52,5,43
AaB,3921,5,8,11,11,36,43,-7,35
AC Horsens,3921,6,7,12,11,37,55,-18,33
Sonderjyske,3921,7,8,6,10,28,29,-1,30
Randers FC,3921,8,5,7,12,24,40,-16,22
Silkeborg IF,3921,9,6,3,13,28,46,-18,21
Lyngby,3921,10,3,10,11,27,45,-18,19
AGF Aarhus,3921,11,4,6,12,18,39,-21,18
Brondby,3922,1,20,5,5,71,38,33,65
FC Midtjylla,3922,2,19,5,6,63,38,25,62
Copenhagen,3922,3,15,6,9,62,43,19,51
FC Nords,3922,4,14,6,10,68,51,17,48
AC Horsens,3922,5,7,14,9,38,50,-12,35
AaB,3922,6,7,12,11,35,43,-8,33
Sonderjyske,3922,7,8,6,10,28,29,-1,30
Randers FC,3922,8,6,6,12,25,40,-15,24
AGF Aarhus,3922,9,5,6,11,18,36,-18,21
Lyngby,3922,10,3,9,12,27,46,-19,18
Silkeborg IF,3922,11,5,3,14,25,46,-21,18
Brondby,3923,1,21,5,4,69,35,34,68
FC Midtjylla,3923,2,21,4,5,66,39,27,67
FC Nords,3923,3,16,6,8,75,46,29,54
Copenhagen,3923,4,13,4,13,54,47,7,43
AC Horsens,3923,5,7,13,10,37,49,-12,34
Sonderjyske,3923,6,8,6,10,28,29,-1,30
AaB,3923,7,6,12,12,34,45,-11,30
Lyngby,3923,8,4,9,11,30,44,-14,21
Silkeborg IF,3923,9,6,3,13,27,44,-17,21
Randers FC,3923,10,5,6,13,23,43,-20,21
AGF Aarhus,3923,11,4,6,12,16,38,-22,18
FC Midtjylla,3924,1,20,5,5,67,36,31,65
Brondby,3924,2,18,8,4,67,36,31,62
FC Nords,3924,3,14,8,8,71,52,19,50
Copenhagen,3924,4,13,6,11,60,47,13,45
AaB,3924,5,8,12,10,40,44,-4,36
AC Horsens,3924,6,6,15,9,33,49,-16,33
Sonderjyske,3924,7,8,6,10,28,29,-1,30
Randers FC,3924,8,6,6,12,24,39,-15,24
Silkeborg IF,3924,9,6,3,13,26,44,-18,21
Lyngby,3924,10,3,9,12,26,45,-19,18
AGF Aarhus,3924,11,4,6,12,16,37,-21,18
Brondby,3925,1,20,6,4,70,37,33,66
FC Midtjylla,3925,2,18,7,5,64,39,25,61
Copenhagen,3925,3,14,6,10,56,41,15,48
FC Nords,3925,4,13,8,9,74,55,19,47
AaB,3925,5,9,13,8,42,40,2,40
Sonderjyske,3925,6,8,6,10,28,29,-1,30
AC Horsens,3925,7,5,14,11,36,56,-20,29
Randers FC,3925,8,5,7,12,24,40,-16,22
Silkeborg IF,3925,9,6,3,13,28,45,-17,21
Lyngby,3925,10,3,10,11,27,45,-18,19
AGF Aarhus,3925,11,4,6,12,17,39,-22,18
Brondby,3926,1,22,5,3,73,30,43,71
FC Midtjylla,3926,2,19,5,6,64,41,23,62
FC Nords,3926,3,15,6,9,75,53,22,51
Copenhagen,3926,4,15,5,10,58,42,16,50
AaB,3926,5,6,13,11,39,48,-9,31
Sonderjyske,3926,6,8,6,10,28,29,-1,30
AC Horsens,3926,7,6,12,12,34,55,-21,30
Randers FC,3926,8,6,6,12,27,40,-13,24
Silkeborg IF,3926,9,5,4,13,25,44,-19,19
AGF Aarhus,3926,10,4,7,11,16,36,-20,19
Lyngby,3926,11,3,9,12,27,48,-21,18
FC Midtjylla,3927,1,21,4,5,66,35,31,67
Brondby,3927,2,20,5,5,67,34,33,65
FC Nords,3927,3,15,7,8,73,50,23,52
Copenhagen,3927,4,14,5,11,56,44,12,47
AaB,3927,5,7,13,10,36,41,-5,34
Sonderjyske,3927,6,8,6,10,28,29,-1,30
AC Horsens,3927,7,5,14,11,33,53,-20,29
Randers FC,3927,8,6,6,12,26,40,-14,24
Silkeborg IF,3927,9,5,4,13,27,46,-19,19
AGF Aarhus,3927,10,4,7,11,18,38,-20,19
Lyngby,3927,11,3,9,12,27,47,-20,18
Brondby,3928,1,20,6,4,67,33,34,66
FC Midtjylla,3928,2,19,5,6,67,39,28,62
FC Nords,3928,3,16,7,7,74,49,25,55
Copenhagen,3928,4,14,4,12,59,49,10,46
AaB,3928,5,7,13,10,36,42,-6,34
AC Horsens,3928,6,6,13,11,36,53,-17,31
Sonderjyske,3928,7,8,6,10,28,29,-1,30
Randers FC,3928,8,6,6,12,24,39,-15,24
Silkeborg IF,3928,9,5,4,13,26,45,-19,19
AGF Aarhus,3928,10,4,7,11,17,37,-20,19
Lyngby,3928,11,3,9,12,26,45,-19,18
Brondby,3929,1,20,6,4,67,35,32,66
FC Midtjylla,3929,2,20,5,5,70,37,33,65
Copenhagen,3929,3,16,5,9,62,42,20,53
FC Nords,3929,4,13,6,11,68,52,16,45
AaB,3929,5,8,11,11,37,44,-7,35
AC Horsens,3929,6,6,13,11,31,51,-20,31
Sonderjyske,3929,7,8,6,10,28,29,-1,30
Randers FC,3929,8,6,6,12,25,40,-15,24
AGF Aarhus,3929,9,5,6,11,19,36,-17,21
Lyngby,3929,10,3,9,12,27,46,-19,18
Silkeborg IF,3929,11,5,3,14,25,47,-22,18
Brondby,3930,1,20,7,3,72,35,37,67
FC Midtjylla,3930,2,20,4,6,64,38,26,64
Copenhagen,3930,3,15,5,10,63,45,18,50
FC Nords,3930,4,13,7,10,75,57,18,46
AaB,3930,5,7,14,9,39,45,-6,35
AC Horsens,3930,6,6,13,11,34,53,-19,31
Sonderjyske,3930,7,8,6,10,28,29,-1,30
Silkeborg IF,3930,8,6,3,13,28,44,-16,21
Lyngby,3930,9,4,9,11,28,45,-17,21
Randers FC,3930,10,5,6,13,24,41,-17,21
AGF Aarhus,3930,11,4,6,12,16,39,-23,18
Brondby,3931,1,22,6,2,77,33,44,72
FC Midtjylla,3931,2,20,5,5,66,38,28,65
Copenhagen,3931,3,15,6,9,60,42,18,51
FC Nords,3931,4,14,6,10,75,54,21,48
Sonderjyske,3931,5,8,6,10,28,29,-1,30
AaB,3931,6,6,12,12,35,46,-11,30
AC Horsens,3931,7,5,13,12,33,59,-26,28
Lyngby,3931,8,4,9,11,29,45,-16,21
Silkeborg IF,3931,9,6,3,13,26,44,-18,21
Randers FC,3931,10,5,6,13,24,42,-18,21
AGF Aarhus,3931,11,4,6,12,16,37,-21,18
Brondby,3932,1,21,5,4,72,34,38,68
FC Midtjylla,3932,2,21,5,4,70,38,32,68
FC Nords,3932,3,14,7,9,76,54,22,49
Copenhagen,3932,4,14,4,12,59,48,11,46
AaB,3932,5,8,11,11,36,41,-5,35
Sonderjyske,3932,6,8,6,10,28,29,-1,30
AC Horsens,3932,7,6,12,12,31,55,-24,30
Randers FC,3932,8,5,7,12,26,42,-16,22
Silkeborg IF,3932,9,6,3,13,27,45,-18,21
Lyngby,3932,10,3,10,11,29,47,-18,19
AGF Aarhus,3932,11,4,6,12,17,38,-21,18
Brondby,3933,1,21,6,3,70,29,41,69
FC Midtjylla,3933,2,18,6,6,64,40,24,60
FC Nords,3933,3,14,7,9,72,51,21,49
Copenhagen,3933,4,13,6,11,56,45,11,45
AC Horsens,3933,5,7,15,8,32,45,-13,36
AaB,3933,6,7,12,11,34,44,-10,33
Sonderjyske,3933,7,8,6,10,28,29,-1,30
Randers FC,3933,8,5,7,12,23,39,-16,22
Silkeborg IF,3933,9,6,3,13,27,44,-17,21
Lyngby,3933,10,3,10,11,26,44,-18,19
AGF Aarhus,3933,11,4,6,12,16,38,-22,18
Brondby,3934,1,20,6,4,64,30,34,66
FC Midtjylla,3934,2,20,6,4,67,36,31,66
FC Nords,3934,3,14,8,8,70,47,23,50
Copenhagen,3934,4,13,6,11,54,45,9,45
AC Horsens,3934,5,6,15,9,34,49,-15,33
AaB,3934,6,7,11,12,34,42,-8,32
Sonderjyske,3934,7,8,6,10,28,29,-1,30
Randers FC,3934,8,5,7,12,23,39,-16,22
AGF Aarhus,3934,9,5,6,11,18,37,-19,21
Lyngby,3934,10,3,10,11,26,44,-18,19
Silkeborg IF,3934,11,5,3,14,26,46,-20,18
FC Midtjylla,3935,1,20,5,5,65,42,23,65
Brondby,3935,2,19,6,5,68,36,32,63
FC Nords,3935,3,16,6,8,79,51,28,54
Copenhagen,3935,4,13,4,13,58,50,8,43
AC Horsens,3935,5,8,13,9,39,50,-11,37
AaB,3935,6,6,14,10,39,45,-6,32
Sonderjyske,3935,7,8,6,10,28,29,-1,30
Randers FC,3935,8,6,6,12,25,39,-14,24
Silkeborg IF,3935,9,6,3,13,27,45,-18,21
Lyngby,3935,10,3,9,12,26,46,-20,18
AGF Aarhus,3935,11,4,6,12,17,38,-21,18
Brondby,3936,1,21,7,2,72,30,42,70
FC Midtjylla,3936,2,18,7,5,65,41,24,61
FC Nords,3936,3,14,6,10,73,54,19,48
Copenhagen,3936,4,14,6,10,60,46,14,48
AaB,3936,5,7,13,10,35,41,-6,34
AC Horsens,3936,6,6,13,11,31,50,-19,31
Sonderjyske,3936,7,8,6,10,28,29,-1,30
Lyngby,3936,8,4,9,11,28,45,-17,21
Randers FC,3936,9,5,6,13,24,41,-17,21
AGF Aarhus,3936,10,5,6,11,19,38,-19,21
Silkeborg IF,3936,11,5,3,14,27,47,-20,18
Brondby,3937,1,21,6,3,70,32,38,69
FC Midtjylla,3937,2,20,4,6,67,39,28,64
FC Nords,3937,3,15,7,8,75,52,23,52
Copenhagen,3937,4,13,6,11,56,44,12,45
AC Horsens,3937,5,7,12,11,33,51,-18,33
AaB,3937,6,7,11,12,33,42,-9,32
Sonderjyske,3937,7,8,6,10,28,29,-1,30
Silkeborg IF,3937,8,6,3,13,29,44,-15,21
Lyngby,3937,9,4,9,11,29,45,-16,21
Randers FC,3937,10,5,6,13,24,42,-18,21
AGF Aarhus,3937,11,4,6,12,16,40,-24,18
Brondby,3938,1,20,5,5,69,30,39,65
FC Midtjylla,3938,2,20,4,6,66,41,25,64
FC Nords,3938,3,15,6,9,80,57,23,51
Copenhagen,3938,4,15,4,11,60,46,14,49
AaB,3938,5,9,12,9,39,40,-1,39
Sonderjyske,3938,6,8,6,10,28,29,-1,30
AC Horsens,3938,7,5,13,12,35,61,-26,28
Randers FC,3938,8,6,6,12,26,41,-15,24
Silkeborg IF,3938,9,6,3,13,28,45,-17,21
Lyngby,3938,10,3,9,12,28,47,-19,18
AGF Aarhus,3938,11,4,6,12,17,39,-22,18
Brondby,3939,1,23,5,2,69,27,42,74
FC Midtjylla,3939,2,20,4,6,63,40,23,64
Copenhagen,3939,3,14,6,10,57,39,18,48
FC Nords,3939,4,12,7,11,71,57,14,43
AaB,3939,5,7,12,11,35,42,-7,33
AC Horsens,3939,6,6,14,10,33,49,-16,32
Sonderjyske,3939,7,8,6,10,28,29,-1,30
Lyngby,3939,8,4,9,11,30,45,-15,21
Silkeborg IF,3939,9,6,3,13,28,45,-17,21
Randers FC,3939,10,5,6,13,24,43,-19,21
AGF Aarhus,3939,11,4,6,12,17,39,-22,18
Brondby,3940,1,22,5,3,74,31,43,71
FC Midtjylla,3940,2,19,4,7,63,40,23,61
FC Nords,3940,3,14,7,9,73,50,23,49
Copenhagen,3940,4,15,4,11,60,47,13,49
AC Horsens,3940,5,7,13,10,38,53,-15,34
AaB,3940,6,7,11,12,34,47,-13,32
Sonderjyske,3940,7,8,6,10,28,29,-1,30
Randers FC,3940,8,6,6,12,25,39,-14,24
Silkeborg IF,3940,9,6,3,13,27,45,-18,21
Lyngby,3940,10,3,9,12,26,46,-20,18
AGF Aarhus,3940,11,4,6,12,17,38,-21,18
Brondby,3941,1,21,6,3,69,30,39,69
FC Midtjylla,3941,2,19,4,7,67,46,21,61
Copenhagen,3941,3,15,5,10,58,41,17,50
FC Nords,3941,4,14,6,10,75,51,24,48
AC Horsens,3941,5,7,14,9,35,53,-18,35
AaB,3941,6,7,11,12,35,44,-9,32
Sonderjyske,3941,7,8,6,10,28,29,-1,30
Randers FC,3941,8,6,6,12,25,39,-14,24
Silkeborg IF,3941,9,6,3,13,26,44,-18,21
Lyngby,3941,10,3,9,12,26,46,-20,18
AGF Aarhus,3941,11,4,6,12,16,37,-21,18
Brondby,3942,1,20,6,4,70,35,35,66
FC Midtjylla,3942,2,18,5,7,64,43,21,59
Copenhagen,3942,3,15,6,9,61,44,17,51
FC Nords,3942,4,14,7,9,76,52,24,49
AaB,3942,5,8,11,11,38,46,-8,35
AC Horsens,3942,6,7,13,10,37,52,-15,34
Sonderjyske,3942,7,8,6,10,28,29,-1,30
Randers FC,3942,8,5,7,12,24,40,-16,22
Lyngby,3942,9,3,10,11,27,45,-18,19
Silkeborg IF,3942,10,5,4,13,26,45,-19,19
AGF Aarhus,3942,11,4,7,11,17,37,-20,19
Brondby,3943,1,21,6,3,71,32,39,69
FC Midtjylla,3943,2,21,5,4,63,34,29,68
Copenhagen,3943,3,14,6,10,58,43,15,48
FC Nords,3943,4,13,6,11,73,57,16,45
AaB,3943,5,7,12,11,36,42,-6,33
AC Horsens,3943,6,6,13,11,35,54,-19,31
Sonderjyske,3943,7,8,6,10,28,29,-1,30
Lyngby,3943,8,4,9,11,30,45,-15,21
Silkeborg IF,3943,9,6,3,13,28,44,-16,21
Randers FC,3943,10,5,6,13,24,43,-19,21
AGF Aarhus,3943,11,4,6,12,16,39,-23,18
Brondby,3944,1,20,6,4,68,30,38,66
FC Midtjylla,3944,2,19,5,6,66,40,26,62
Copenhagen,3944,3,16,5,9,61,44,17,53
FC Nords,3944,4,14,7,9,71,51,20,49
AaB,3944,5,9,11,10,40,43,-3,38
Sonderjyske,3944,6,8,6,10,28,29,-1,30
AC Horsens,3944,7,5,12,13,34,58,-24,27
Lyngby,3944,8,4,9,11,27,44,-17,21
Randers FC,3944,9,5,6,13,23,40,-17,21
AGF Aarhus,3944,10,5,6,11,19,37,-18,21
Silkeborg IF,3944,11,5,3,14,26,47,-21,18
FC Midtjylla,3945,1,22,4,4,71,41,30,70
Brondby,3945,2,21,5,4,77,36,41,68
FC Nords,3945,3,14,7,9,73,55,18,49
Copenhagen,3945,4,13,4,13,60,50,10,43
AaB,3945,5,7,12,11,34,43,-9,33
AC Horsens,3945,6,6,14,10,36,52,-16,32
Sonderjyske,3945,7,8,6,10,28,29,-1,30
Lyngby,3945,8,4,9,11,29,44,-15,21
Randers FC,3945,9,5,6,13,23,42,-19,21
Silkeborg IF,3945,10,5,4,13,26,45,-19,19
AGF Aarhus,3945,11,4,7,11,17,37,-20,19
Brondby,3946,1,21,6,3,69,31,38,69
FC Midtjylla,3946,2,18,5,7,65,40,25,59
Copenhagen,3946,3,16,5,9,59,42,17,53
FC Nords,3946,4,13,8,9,75,55,20,47
AaB,3946,5,8,13,9,40,42,-2,37
Sonderjyske,3946,6,8,6,10,28,29,-1,30
AC Horsens,3946,7,5,13,12,33,57,-24,28
Lyngby,3946,8,4,9,11,28,45,-17,21
Randers FC,3946,9,5,6,13,24,41,-17,21
Silkeborg IF,3946,10,6,3,13,27,45,-18,21
AGF Aarhus,3946,11,4,6,12,17,38,-21,18
Brondby,3947,1,21,6,3,70,34,36,69
FC Midtjylla,3947,2,19,5,6,61,37,24,62
Copenhagen,3947,3,16,5,9,60,39,21,53
FC Nords,3947,4,13,7,10,71,52,19,46
AaB,3947,5,7,12,11,36,44,-8,33
Sonderjyske,3947,6,8,6,10,28,29,-1,30
AC Horsens,3947,7,5,15,10,34,52,-18,30
Lyngby,3947,8,4,9,11,27,44,-17,21
Randers FC,3947,9,5,6,13,23,40,-17,21
Silkeborg IF,3947,10,5,4,13,26,45,-19,19
AGF Aarhus,3947,11,4,7,11,17,37,-20,19
Brondby,3948,1,23,5,2,77,31,46,74
FC Midtjylla,3948,2,20,4,6,76,47,29,64
FC Nords,3948,3,14,7,9,71,51,20,49
Copenhagen,3948,4,13,5,12,55,45,10,44
AaB,3948,5,7,12,11,34,43,-9,33
AC Horsens,3948,6,6,13,11,34,56,-22,31
Sonderjyske,3948,7,8,6,10,28,29,-1,30
Randers FC,3948,8,6,6,12,26,40,-14,24
Silkeborg IF,3948,9,5,4,13,25,44,-19,19
AGF Aarhus,3948,10,4,7,11,16,36,-20,19
Lyngby,3948,11,3,9,12,27,47,-20,18
Brondby,3949,1,21,5,4,70,33,37,68
FC Midtjylla,3949,2,19,5,6,60,41,19,62
FC Nords,3949,3,16,6,8,77,48,29,54
Copenhagen,3949,4,14,5,11,58,45,13,47
AC Horsens,3949,5,7,12,11,35,50,-15,33
AaB,3949,6,6,13,11,34,43,-9,31
Sonderjyske,3949,7,8,6,10,28,29,-1,30
Randers FC,3949,8,5,7,12,24,40,-16,22
Silkeborg IF,3949,9,6,3,13,28,44,-16,21
Lyngby,3949,10,3,10,11,27,45,-18,19
AGF Aarhus,3949,11,4,6,12,16,39,-23,18
Brondby,3950,1,21,7,2,70,32,38,70
FC Midtjylla,3950,2,19,6,5,65,39,26,63
FC Nords,3950,3,13,8,9,74,55,19,47
Copenhagen,3950,4,13,7,10,58,44,14,46
AC Horsens,3950,5,8,12,10,36,48,-12,36
Sonderjyske,3950,6,8,6,10,28,29,-1,30
AaB,3950,7,6,12,12,37,48,-11,30
Lyngby,3950,8,4,9,11,29,46,-17,21
Silkeborg IF,3950,9,6,3,13,27,44,-17,21
Randers FC,3950,10,5,6,13,25,42,-17,21
AGF Aarhus,3950,11,4,6,12,16,38,-22,18
Brondby,3951,1,21,6,3,71,33,38,69
FC Midtjylla,3951,2,18,7,5,67,38,29,61
Copenhagen,3951,3,15,5,10,59,42,17,50
FC Nords,3951,4,13,7,10,67,54,13,46
AaB,3951,5,7,13,10,36,42,-6,34
AC Horsens,3951,6,7,12,11,36,53,-17,33
Sonderjyske,3951,7,8,6,10,28,29,-1,30
Lyngby,3951,8,4,9,11,28,45,-17,21
Randers FC,3951,9,5,6,13,24,41,-17,21
AGF Aarhus,3951,10,5,6,11,18,37,-19,21
Silkeborg IF,3951,11,5,3,14,26,46,-20,18
Brondby,3952,1,22,5,3,82,39,43,71
FC Midtjylla,3952,2,19,4,7,65,44,21,61
FC Nords,3952,3,14,6,10,78,61,17,48
Copenhagen,3952,4,14,6,10,61,46,15,48
AaB,3952,5,8,12,10,40,46,-6,36
AC Horsens,3952,6,6,13,11,39,55,-16,31
Sonderjyske,3952,7,8,6,10,28,29,-1,30
Lyngby,3952,8,4,9,11,27,44,-17,21
Randers FC,3952,9,5,6,13,23,40,-17,21
Silkeborg IF,3952,10,5,4,13,26,45,-19,19
AGF Aarhus,3952,11,4,7,11,17,37,-20,19
Brondby,3953,1,22,6,2,69,28,41,72
FC Midtjylla,3953,2,19,5,6,65,43,22,62
FC Nords,3953,3,13,9,8,70,49,21,48
Copenhagen,3953,4,13,4,13,55,48,7,43
AaB,3953,5,8,13,9,36,37,-1,37
AC Horsens,3953,6,6,13,11,34,50,-16,31
Sonderjyske,3953,7,8,6,10,28,29,-1,30
Randers FC,3953,8,6,6,12,25,40,-15,24
Silkeborg IF,3953,9,6,3,13,28,44,-16,21
Lyngby,3953,10,3,9,12,27,46,-19,18
AGF Aarhus,3953,11,4,6,12,16,39,-23,18
Brondby,3954,1,22,5,3,76,32,44,71
FC Midtjylla,3954,2,19,5,6,68,43,25,62
FC Nords,3954,3,14,7,9,71,50,21,49
Copenhagen,3954,4,13,5,12,60,49,11,44
AC Horsens,3954,5,8,12,10,40,57,-17,36
AaB,3954,6,7,12,11,36,46,-10,33
Sonderjyske,3954,7,8,6,10,28,29,-1,30
Silkeborg IF,3954,8,6,3,13,28,44,-16,21
Lyngby,3954,9,4,9,11,28,45,-17,21
Randers FC,3954,10,5,6,13,24,41,-17,21
AGF Aarhus,3954,11,4,6,12,16,39,-23,18
Brondby,3955,1,21,5,4,77,32,45,68
FC Midtjylla,3955,2,20,4,6,69,41,28,64
Copenhagen,3955,3,16,4,10,60,44,16,52
FC Nords,3955,4,13,6,11,73,55,18,45
AC Horsens,3955,5,7,13,10,35,53,-18,34
AaB,3955,6,7,12,11,38,53,-15,33
Sonderjyske,3955,7,8,6,10,28,29,-1,30
Randers FC,3955,8,6,6,12,27,39,-12,24
Silkeborg IF,3955,9,6,3,13,29,44,-15,21
Lyngby,3955,10,3,9,12,26,48,-22,18
AGF Aarhus,3955,11,4,6,12,16,40,-24,18
Brondby,3956,1,22,5,3,74,32,42,71
FC Midtjylla,3956,2,20,5,5,69,39,30,65
FC Nords,3956,3,14,7,9,74,53,21,49
Copenhagen,3956,4,13,4,13,54,47,7,43
AaB,3956,5,8,11,11,40,48,-8,35
AC Horsens,3956,6,7,12,11,37,55,-18,33
Sonderjyske,3956,7,8,6,10,28,29,-1,30
Lyngby,3956,8,4,9,11,27,44,-17,21
Silkeborg IF,3956,8,6,3,13,27,44,-17,21
Randers FC,3956,10,5,6,13,23,40,-17,21
AGF Aarhus,3956,11,4,6,12,16,38,-22,18
Brondby,3957,1,21,6,3,73,34,39,69
FC Midtjylla,3957,2,20,4,6,66,41,25,64
FC Nords,3957,3,16,7,7,79,50,29,55
Copenhagen,3957,4,14,4,12,61,49,12,46
AaB,3957,5,7,11,12,33,41,-8,32
Sonderjyske,3957,6,8,6,10,28,29,-1,30
AC Horsens,3957,7,6,12,12,36,59,-23,30
Randers FC,3957,8,6,6,12,27,39,-12,24
Silkeborg IF,3957,9,6,3,13,27,45,-18,21
AGF Aarhus,3957,10,4,6,12,17,38,-21,18
Lyngby,3957,11,3,9,12,26,48,-22,18
Brondby,3958,1,18,9,3,66,33,33,63
FC Midtjylla,3958,2,18,7,5,62,39,23,61
Copenhagen,3958,3,15,6,9,58,39,19,51
FC Nords,3958,4,14,8,8,71,48,23,50
AC Horsens,3958,5,6,15,9,40,55,-15,33
AaB,3958,6,6,13,11,32,41,-9,31
Sonderjyske,3958,7,8,6,10,28,29,-1,30
Lyngby,3958,8,4,9,11,29,44,-15,21
Randers FC,3958,9,5,6,13,23,42,-19,21
AGF Aarhus,3958,10,5,6,11,18,37,-19,21
Silkeborg IF,3958,11,5,3,14,26,46,-20,18
Brondby,3959,1,21,5,4,69,32,37,68
FC Midtjylla,3959,2,20,4,6,68,42,26,64
FC Nords,3959,3,14,7,9,75,54,21,49
Copenhagen,3959,4,13,4,13,54,47,7,43
AC Horsens,3959,5,9,12,9,36,48,-12,39
AaB,3959,6,7,12,11,37,42,-5,33
Sonderjyske,3959,7,8,6,10,28,29,-1,30
Lyngby,3959,8,4,9,11,27,44,-17,21
Randers FC,3959,9,5,6,13,23,40,-17,21
Silkeborg IF,3959,10,6,3,13,27,45,-18,21
AGF Aarhus,3959,11,4,6,12,17,38,-21,18
Brondby,3960,1,21,6,3,72,33,39,69
FC Midtjylla,3960,2,20,5,5,74,39,35,65
Copenhagen,3960,3,14,6,10,62,45,17,48
FC Nords,3960,4,14,6,10,73,57,16,48
AaB,3960,5,8,12,10,34,43,-9,36
Sonderjyske,3960,6,8,6,10,28,29,-1,30
AC Horsens,3960,7,5,13,12,30,54,-24,28
Lyngby,3960,8,4,9,11,28,45,-17,21
Randers FC,3960,9,5,6,13,24,41,-17,21
Silkeborg IF,3960,10,5,4,13,25,44,-19,19
AGF Aarhus,3960,11,4,7,11,16,36,-20,19
Brondby,3961,1,19,8,3,71,35,36,65
FC Midtjylla,3961,2,20,5,5,71,40,31,65
Copenhagen,3961,3,14,5,11,59,47,12,47
FC Nords,3961,4,13,6,11,68,52,16,45
AaB,3961,5,8,12,10,36,42,-6,36
AC Horsens,3961,6,8,12,10,37,52,-15,36
Sonderjyske,3961,7,8,6,10,28,29,-1,30
Lyngby,3961,8,4,9,11,28,45,-17,21
Silkeborg IF,3961,8,6,3,13,28,45,-17,21
Randers FC,3961,10,5,6,13,24,41,-17,21
AGF Aarhus,3961,11,4,6,12,17,39,-22,18
Brondby,3962,1,20,6,4,70,31,39,66
FC Midtjylla,3962,2,20,5,5,66,41,25,65
FC Nords,3962,3,15,6,9,74,53,21,51
Copenhagen,3962,4,13,4,13,58,49,9,43
AaB,3962,5,8,12,10,35,41,-6,36
AC Horsens,3962,6,7,13,10,38,52,-14,34
Sonderjyske,3962,7,8,6,10,28,29,-1,30
Lyngby,3962,8,4,9,11,29,45,-16,21
Randers FC,3962,9,5,6,13,24,42,-18,21
AGF Aarhus,3962,10,5,6,11,18,37,-19,21
Silkeborg IF,3962,11,5,3,14,26,46,-20,18
FC Midtjylla,3963,1,21,4,5,66,36,30,67
Brondby,3963,2,19,7,4,70,33,37,64
FC Nords,3963,3,15,6,9,69,51,18,51
Copenhagen,3963,4,14,5,11,55,42,13,47
AaB,3963,5,8,12,10,35,41,-6,36
Sonderjyske,3963,6,8,6,10,28,29,-1,30
AC Horsens,3963,7,5,14,11,31,49,-18,29
Randers FC,3963,8,5,7,12,25,41,-16,22
Silkeborg IF,3963,9,6,3,13,28,46,-18,21
Lyngby,3963,10,3,10,11,28,46,-18,19
AGF Aarhus,3963,11,4,6,12,18,39,-21,18
Brondby,3964,1,21,5,4,70,32,38,68
FC Midtjylla,3964,2,20,5,5,68,39,29,65
Copenhagen,3964,3,14,4,12,57,46,11,46
FC Nords,3964,4,13,6,11,72,55,17,45
AC Horsens,3964,5,8,13,9,37,50,-13,37
AaB,3964,6,8,11,11,38,46,-8,35
Sonderjyske,3964,7,8,6,10,28,29,-1,30
Lyngby,3964,8,4,9,11,27,44,-17,21
Randers FC,3964,9,5,6,13,23,40,-17,21
Silkeborg IF,3964,10,6,3,13,26,44,-18,21
AGF Aarhus,3964,11,4,6,12,16,37,-21,18
Brondby,3965,1,21,5,4,70,33,37,68
FC Midtjylla,3965,2,20,5,5,68,39,29,65
FC Nords,3965,3,13,8,9,76,55,21,47
Copenhagen,3965,4,13,5,12,57,47,10,44
AaB,3965,5,8,13,9,38,41,-3,37
AC Horsens,3965,6,6,14,10,33,53,-20,32
Sonderjyske,3965,7,8,6,10,28,29,-1,30
Randers FC,3965,8,5,7,12,23,39,-16,22
Lyngby,3965,9,3,10,11,26,44,-18,19
Silkeborg IF,3965,10,5,4,13,27,46,-19,19
AGF Aarhus,3965,11,4,7,11,18,38,-20,19
Brondby,3966,1,21,6,3,67,28,39,69
FC Midtjylla,3966,2,18,6,6,61,38,23,60
FC Nords,3966,3,14,6,10,73,55,18,48
Copenhagen,3966,4,14,6,10,58,42,16,48
AC Horsens,3966,5,9,12,9,40,51,-11,39
Sonderjyske,3966,6,8,6,10,28,29,-1,30
AaB,3966,7,6,12,12,35,46,-11,30
Randers FC,3966,8,6,6,12,25,40,-15,24
AGF Aarhus,3966,9,5,6,11,18,36,-18,21
Lyngby,3966,10,3,9,12,27,46,-19,18
Silkeborg IF,3966,11,5,3,14,25,46,-21,18
Brondby,3967,1,22,5,3,73,30,43,71
FC Midtjylla,3967,2,20,4,6,70,42,28,64
Copenhagen,3967,3,15,5,10,59,44,15,50
FC Nords,3967,4,14,7,9,75,52,23,49
AaB,3967,5,6,13,11,35,47,-12,31
Sonderjyske,3967,6,8,6,10,28,29,-1,30
AC Horsens,3967,7,6,12,12,35,58,-23,30
Randers FC,3967,8,6,6,12,25,40,-15,24
Silkeborg IF,3967,9,6,3,13,31,44,-13,21
Lyngby,3967,10,3,9,12,27,46,-19,18
AGF Aarhus,3967,11,4,6,12,16,42,-26,18
FC Midtjylla,3968,1,20,6,4,68,39,29,66
Brondby,3968,2,19,7,4,67,35,32,64
FC Nords,3968,3,15,6,9,83,53,30,51
Copenhagen,3968,4,14,5,11,60,48,12,47
AaB,3968,5,7,13,10,37,45,-8,34
Sonderjyske,3968,6,8,6,10,28,29,-1,30
AC Horsens,3968,7,5,15,10,34,55,-21,30
Lyngby,3968,8,4,9,11,28,45,-17,21
Randers FC,3968,9,5,6,13,24,41,-17,21
Silkeborg IF,3968,10,6,3,13,28,46,-18,21
AGF Aarhus,3968,11,4,6,12,18,39,-21,18
Brondby,3969,1,23,5,2,73,30,43,74
FC Midtjylla,3969,2,19,5,6,66,39,27,62
Copenhagen,3969,3,15,5,10,58,41,17,50
FC Nords,3969,4,12,6,12,68,56,12,42
AC Horsens,3969,5,7,14,9,36,50,-14,35
AaB,3969,6,7,11,12,33,44,-11,32
Sonderjyske,3969,7,8,6,10,28,29,-1,30
Randers FC,3969,8,6,6,12,26,41,-15,24
AGF Aarhus,3969,9,5,6,11,20,38,-18,21
Lyngby,3969,10,3,9,12,28,47,-19,18
Silkeborg IF,3969,11,5,3,14,27,48,-21,18
FC Midtjylla,3970,1,19,6,5,66,40,26,63
Brondby,3970,2,18,8,4,68,37,31,62
FC Nords,3970,3,15,7,8,76,52,24,52
Copenhagen,3970,4,13,6,11,56,45,11,45
AaB,3970,5,8,13,9,40,40,0,37
AC Horsens,3970,6,6,14,10,39,57,-18,32
Sonderjyske,3970,7,8,6,10,28,29,-1,30
Randers FC,3970,8,6,6,12,25,40,-15,24
Silkeborg IF,3970,9,5,4,13,26,45,-19,19
AGF Aarhus,3970,10,4,7,11,17,37,-20,19
Lyngby,3970,11,3,9,12,27,46,-19,18
Brondby,3971,1,20,5,5,74,36,38,65
FC Midtjylla,3971,2,19,5,6,64,40,24,62
FC Nords,3971,3,17,6,7,82,50,32,57
Copenhagen,3971,4,13,4,13,54,48,6,43
AC Horsens,3971,5,8,12,10,37,55,-18,36
AaB,3971,6,7,12,11,36,44,-8,33
Sonderjyske,3971,7,8,6,10,28,29,-1,30
Randers FC,3971,8,6,6,12,25,40,-15,24
AGF Aarhus,3971,9,5,6,11,19,37,-18,21
Lyngby,3971,10,3,9,12,27,46,-19,18
Silkeborg IF,3971,11,5,3,14,26,47,-21,18
Brondby,3972,1,20,5,5,68,35,33,65
FC Midtjylla,3972,2,19,5,6,63,38,25,62
FC Nords,3972,3,15,6,9,78,55,23,51
Copenhagen,3972,4,14,5,11,61,48,13,47
AC Horsens,3972,5,8,12,10,34,49,-15,36
AaB,3972,6,8,11,11,38,43,-5,35
Sonderjyske,3972,7,8,6,10,28,29,-1,30
Lyngby,3972,8,4,9,11,33,44,-11,21
Randers FC,3972,9,5,6,13,23,46,-23,21
Silkeborg IF,3972,10,5,4,13,25,44,-19,19
AGF Aarhus,3972,11,4,7,11,16,36,-20,19
Brondby,3973,1,21,7,2,72,31,41,70
FC Midtjylla,3973,2,19,5,6,62,39,23,62
Copenhagen,3973,3,15,5,10,61,44,17,50
FC Nords,3973,4,13,7,10,76,56,20,46
AaB,3973,5,9,12,9,40,39,1,39
Sonderjyske,3973,6,8,6,10,28,29,-1,30
AC Horsens,3973,7,5,12,13,35,63,-28,27
Lyngby,3973,8,4,9,11,27,44,-17,21
Randers FC,3973,9,5,6,13,23,40,-17,21
Silkeborg IF,3973,10,6,3,13,27,45,-18,21
AGF Aarhus,3973,11,4,6,12,17,38,-21,18
Brondby,3974,1,22,6,2,75,33,42,72
FC Midtjylla,3974,2,19,6,5,63,39,24,63
FC Nords,3974,3,14,7,9,75,52,23,49
Copenhagen,3974,4,13,6,11,55,44,11,45
AaB,3974,5,7,12,11,36,42,-6,33
AC Horsens,3974,6,6,13,11,33,53,-20,31
Sonderjyske,3974,7,8,6,10,28,29,-1,30
Lyngby,3974,8,4,9,11,28,44,-16,21
Randers FC,3974,9,5,6,13,23,41,-18,21
Silkeborg IF,3974,10,5,4,13,26,45,-19,19
AGF Aarhus,3974,11,4,7,11,17,37,-20,19
Brondby,3975,1,20,7,3,67,31,36,67
FC Midtjylla,3975,2,20,4,6,62,35,27,64
FC Nords,3975,3,14,7,9,70,50,20,49
Copenhagen,3975,4,14,4,12,55,44,11,46
AaB,3975,5,8,13,9,38,40,-2,37
AC Horsens,3975,6,6,13,11,36,54,-18,31
Sonderjyske,3975,7,8,6,10,28,29,-1,30
Randers FC,3975,8,5,7,12,23,39,-16,22
AGF Aarhus,3975,9,5,6,11,18,37,-19,21
Lyngby,3975,10,3,10,11,26,44,-18,19
Silkeborg IF,3975,11,5,3,14,26,46,-20,18
Brondby,3976,1,20,6,4,72,39,33,66
FC Midtjylla,3976,2,20,5,5,68,41,27,65
Copenhagen,3976,3,14,6,10,61,41,20,48
FC Nords,3976,4,13,8,9,76,58,18,47
AaB,3976,5,7,14,9,37,41,-4,35
AC Horsens,3976,6,6,13,11,35,55,-20,31
Sonderjyske,3976,7,8,6,10,28,29,-1,30
Randers FC,3976,8,6,6,12,25,39,-14,24
AGF Aarhus,3976,9,5,6,11,17,36,-19,21
Lyngby,3976,10,3,9,12,26,46,-20,18
Silkeborg IF,3976,11,5,3,14,25,45,-20,18
FC Midtjylla,3977,1,20,4,6,62,38,24,64
Brondby,3977,2,19,5,6,69,36,33,62
FC Nords,3977,3,14,8,8,74,50,24,50
Copenhagen,3977,4,14,7,9,64,46,18,49
AC Horsens,3977,5,8,13,9,39,52,-13,37
AaB,3977,6,6,13,11,37,49,-12,31
Sonderjyske,3977,7,8,6,10,28,29,-1,30
Lyngby,3977,8,4,9,11,28,44,-16,21
Silkeborg IF,3977,9,6,3,13,27,44,-17,21
Randers FC,3977,10,5,6,13,23,41,-18,21
AGF Aarhus,3977,11,4,6,12,16,38,-22,18
Brondby,3978,1,20,6,4,69,32,37,66
FC Midtjylla,3978,2,20,4,6,62,42,20,64
FC Nords,3978,3,14,7,9,80,52,28,49
Copenhagen,3978,4,12,6,12,54,48,6,42
AC Horsens,3978,5,8,14,8,40,49,-9,38
AaB,3978,6,7,13,10,38,46,-8,34
Sonderjyske,3978,7,8,6,10,28,29,-1,30
Lyngby,3978,8,4,9,11,30,44,-14,21
AGF Aarhus,3978,9,5,6,11,17,36,-19,21
Randers FC,3978,10,5,6,13,23,43,-20,21
Silkeborg IF,3978,11,5,3,14,25,45,-20,18
Brondby,3979,1,20,7,3,69,32,37,67
FC Midtjylla,3979,2,19,5,6,62,40,22,62
FC Nords,3979,3,14,8,8,76,52,24,50
Copenhagen,3979,4,14,6,10,56,40,16,48
AC Horsens,3979,5,7,12,11,37,56,-19,33
AaB,3979,6,6,14,10,39,45,-6,32
Sonderjyske,3979,7,8,6,10,28,29,-1,30
Randers FC,3979,8,5,7,12,24,40,-16,22
AGF Aarhus,3979,9,5,6,11,17,36,-19,21
Lyngby,3979,10,3,10,11,27,45,-18,19
Silkeborg IF,3979,11,5,3,14,25,45,-20,18
Brondby,3980,1,20,7,3,70,31,39,67
FC Midtjylla,3980,2,19,5,6,65,41,24,62
FC Nords,3980,3,14,8,8,76,52,24,50
Copenhagen,3980,4,13,4,13,54,46,8,43
AC Horsens,3980,5,9,12,9,40,51,-11,39
AaB,3980,6,7,12,11,35,45,-10,33
Sonderjyske,3980,7,8,6,10,28,29,-1,30
Lyngby,3980,8,4,9,11,29,45,-16,21
Silkeborg IF,3980,9,6,3,13,27,44,-17,21
Randers FC,3980,10,5,6,13,24,42,-18,21
AGF Aarhus,3980,11,4,6,12,16,38,-22,18
Brondby,3981,1,22,5,3,74,32,42,71
FC Midtjylla,3981,2,20,4,6,71,41,30,64
FC Nords,3981,3,13,7,10,76,55,21,46
Copenhagen,3981,4,13,4,13,54,48,6,43
AaB,3981,5,9,11,10,38,48,-10,38
AC Horsens,3981,6,7,13,10,38,53,-15,34
Sonderjyske,3981,7,8,6,10,28,29,-1,30
Randers FC,3981,8,5,7,12,23,39,-16,22
Lyngby,3981,9,3,10,11,26,44,-18,19
Silkeborg IF,3981,10,5,4,13,26,45,-19,19
AGF Aarhus,3981,11,4,7,11,17,37,-20,19
FC Midtjylla,3982,1,21,5,4,64,34,30,68
Brondby,3982,2,20,5,5,70,32,38,65
FC Nords,3982,3,15,7,8,70,47,23,52
Copenhagen,3982,4,13,5,12,55,50,5,44
AaB,3982,5,8,12,10,38,41,-3,36
Sonderjyske,3982,6,8,6,10,28,29,-1,30
AC Horsens,3982,7,6,12,12,36,55,-19,30
Randers FC,3982,8,5,7,12,24,40,-16,22
AGF Aarhus,3982,9,5,6,11,19,36,-17,21
Lyngby,3982,10,3,10,11,27,45,-18,19
Silkeborg IF,3982,11,5,3,14,25,47,-22,18
Brondby,3983,1,20,6,4,72,34,38,66
FC Midtjylla,3983,2,18,6,6,63,41,22,60
FC Nords,3983,3,14,8,8,78,51,27,50
Copenhagen,3983,4,14,5,11,56,45,11,47
AaB,3983,5,8,12,10,37,41,-4,36
AC Horsens,3983,6,7,13,10,35,55,-20,34
Sonderjyske,3983,7,8,6,10,28,29,-1,30
Lyngby,3983,8,4,9,11,27,44,-17,21
Randers FC,3983,9,5,6,13,23,40,-17,21
Silkeborg IF,3983,10,5,4,13,26,45,-19,19
AGF Aarhus,3983,11,4,7,11,17,37,-20,19
Brondby,3984,1,20,6,4,67,31,36,66
FC Midtjylla,3984,2,19,5,6,61,38,23,62
FC Nords,3984,3,13,7,10,69,51,18,46
Copenhagen,3984,4,13,6,11,55,45,10,45
AaB,3984,5,8,13,9,41,42,-1,37
AC Horsens,3984,6,8,13,9,37,49,-12,37
Sonderjyske,3984,7,8,6,10,28,29,-1,30
Randers FC,3984,8,6,6,12,25,40,-15,24
Silkeborg IF,3984,9,5,4,13,27,46,-19,19
AGF Aarhus,3984,10,4,7,11,18,38,-20,19
Lyngby,3984,11,3,9,12,27,46,-19,18
Brondby,3985,1,21,5,4,73,33,40,68
FC Midtjylla,3985,2,18,5,7,64,46,18,59
FC Nords,3985,3,15,6,9,79,55,24,51
Copenhagen,3985,4,15,6,9,60,42,18,51
AC Horsens,3985,5,7,14,9,35,52,-17,35
Sonderjyske,3985,6,8,6,10,28,29,-1,30
AaB,3985,7,6,12,12,36,45,-9,30
Lyngby,3985,8,4,9,11,29,46,-17,21
Silkeborg IF,3985,9,6,3,13,27,44,-17,21
Randers FC,3985,10,5,6,13,25,42,-17,21
AGF Aarhus,3985,11,4,6,12,16,38,-22,18
Brondby,3986,1,20,6,4,74,41,33,66
FC Midtjylla,3986,2,19,6,5,66,40,26,63
FC Nords,3986,3,14,7,9,71,50,21,49
Copenhagen,3986,4,14,7,9,61,44,17,49
AaB,3986,5,7,14,9,37,41,-4,35
Sonderjyske,3986,6,8,6,10,28,29,-1,30
AC Horsens,3986,7,6,12,12,37,56,-19,30
Randers FC,3986,8,6,6,12,25,40,-15,24
AGF Aarhus,3986,9,5,6,11,18,36,-18,21
Lyngby,3986,10,3,9,12,27,46,-19,18
Silkeborg IF,3986,11,5,3,14,25,46,-21,18
Brondby,3987,1,20,7,3,74,35,39,67
FC Midtjylla,3987,2,19,5,6,62,39,23,62
Copenhagen,3987,3,15,5,10,63,49,14,50
FC Nords,3987,4,13,8,9,74,54,20,47
AC Horsens,3987,5,6,15,9,35,50,-15,33
AaB,3987,6,6,14,10,36,43,-7,32
Sonderjyske,3987,7,8,6,10,28,29,-1,30
Lyngby,3987,8,4,9,11,29,44,-15,21
AGF Aarhus,3987,9,5,6,11,19,36,-17,21
Randers FC,3987,10,5,6,13,23,42,-19,21
Silkeborg IF,3987,11,5,3,14,25,47,-22,18
Brondby,3988,1,22,6,2,72,30,42,72
FC Midtjylla,3988,2,21,4,5,69,36,33,67
FC Nords,3988,3,14,7,9,71,50,21,49
Copenhagen,3988,4,13,4,13,58,48,10,43
AaB,3988,5,8,12,10,38,48,-10,36
Sonderjyske,3988,6,8,6,10,28,29,-1,30
AC Horsens,3988,7,5,13,12,33,55,-22,28
Lyngby,3988,8,4,9,11,28,45,-17,21
Randers FC,3988,9,5,6,13,24,41,-17,21
Silkeborg IF,3988,10,5,4,13,25,44,-19,19
AGF Aarhus,3988,11,4,7,11,16,36,-20,19
Brondby,3989,1,22,5,3,68,28,40,71
FC Midtjylla,3989,2,20,5,5,64,39,25,65
FC Nords,3989,3,14,7,9,71,50,21,49
Copenhagen,3989,4,13,6,11,58,44,14,45
AC Horsens,3989,5,7,12,11,36,53,-17,33
AaB,3989,6,6,13,11,35,44,-9,31
Sonderjyske,3989,7,8,6,10,28,29,-1,30
Randers FC,3989,8,5,7,12,24,40,-16,22
Lyngby,3989,9,3,10,11,27,45,-18,19
Silkeborg IF,3989,10,5,4,13,26,45,-19,19
AGF Aarhus,3989,11,4,7,11,17,37,-20,19
Brondby,3990,1,21,5,4,71,36,35,68
FC Midtjylla,3990,2,18,6,6,63,40,23,60
FC Nords,3990,3,16,6,8,76,48,28,54
Copenhagen,3990,4,14,6,10,61,44,17,48
AaB,3990,5,8,12,10,35,40,-5,36
Sonderjyske,3990,6,8,6,10,28,29,-1,30
AC Horsens,3990,7,5,13,12,33,57,-24,28
Lyngby,3990,8,4,9,11,28,44,-16,21
Silkeborg IF,3990,9,6,3,13,26,44,-18,21
Randers FC,3990,10,5,6,13,23,41,-18,21
AGF Aarhus,3990,11,4,6,12,16,37,-21,18
Brondby,3991,1,20,6,4,72,34,38,66
FC Midtjylla,3991,2,17,8,5,62,39,23,59
Copenhagen,3991,3,14,7,9,59,42,17,49
FC Nords,3991,4,13,6,11,72,60,12,45
AC Horsens,3991,5,7,15,8,35,47,-12,36
AaB,3991,6,7,14,9,39,43,-4,35
Sonderjyske,3991,7,8,6,10,28,29,-1,30
Randers FC,3991,8,6,6,12,27,40,-13,24
Silkeborg IF,3991,9,5,4,13,27,46,-19,19
AGF Aarhus,3991,10,4,7,11,18,38,-20,19
Lyngby,3991,11,3,9,12,27,48,-21,18
Brondby,3992,1,22,5,3,78,32,46,71
FC Midtjylla,3992,2,20,4,6,66,41,25,64
Copenhagen,3992,3,16,4,10,61,43,18,52
FC Nords,3992,4,14,6,10,74,52,22,48
AaB,3992,5,7,12,11,36,47,-11,33
Sonderjyske,3992,6,8,6,10,28,29,-1,30
AC Horsens,3992,7,5,13,12,30,56,-26,28
Randers FC,3992,8,6,6,12,24,39,-15,24
Silkeborg IF,3992,9,5,4,13,26,45,-19,19
AGF Aarhus,3992,10,4,7,11,17,37,-20,19
Lyngby,3992,11,3,9,12,26,45,-19,18
FC Midtjylla,3993,1,21,5,4,71,38,33,68
Brondby,3993,2,20,5,5,70,34,36,65
FC Nords,3993,3,14,8,8,73,50,23,50
Copenhagen,3993,4,13,4,13,58,51,7,43
AC Horsens,3993,5,8,12,10,38,55,-17,36
AaB,3993,6,7,12,11,36,44,-8,33
Sonderjyske,3993,7,8,6,10,28,29,-1,30
Lyngby,3993,8,4,9,11,29,45,-16,21
Randers FC,3993,9,5,6,13,24,42,-18,21
Silkeborg IF,3993,10,5,4,13,25,44,-19,19
AGF Aarhus,3993,11,4,7,11,16,36,-20,19
Brondby,3994,1,20,7,3,69,34,35,67
FC Midtjylla,3994,2,19,4,7,63,38,25,61
Copenhagen,3994,3,15,5,10,55,40,15,50
FC Nords,3994,4,14,7,9,75,53,22,49
AaB,3994,5,9,13,8,39,37,2,40
Sonderjyske,3994,6,8,6,10,28,29,-1,30
AC Horsens,3994,7,5,12,13,33,58,-25,27
Silkeborg IF,3994,8,6,3,13,28,45,-17,21
Lyngby,3994,9,4,9,11,27,44,-17,21
Randers FC,3994,10,5,6,13,23,40,-17,21
AGF Aarhus,3994,11,4,6,12,17,39,-22,18
Brondby,3995,1,21,5,4,69,31,38,68
FC Midtjylla,3995,2,21,4,5,68,39,29,67
Copenhagen,3995,3,14,4,12,63,49,14,46
FC Nords,3995,4,12,7,11,68,53,15,43
AaB,3995,5,8,12,10,38,44,-6,36
AC Horsens,3995,6,8,12,10,36,52,-16,36
Sonderjyske,3995,7,8,6,10,28,29,-1,30
Randers FC,3995,8,6,6,12,25,40,-15,24
Silkeborg IF,3995,9,6,3,13,28,45,-17,21
Lyngby,3995,10,3,9,12,27,46,-19,18
AGF Aarhus,3995,11,4,6,12,17,39,-22,18
Brondby,3996,1,22,6,2,74,32,42,72
FC Midtjylla,3996,2,17,4,9,60,41,19,55
FC Nords,3996,3,16,6,8,76,49,27,54
Copenhagen,3996,4,13,5,12,53,48,5,44
AaB,3996,5,9,11,10,38,40,-2,38
AC Horsens,3996,6,6,14,10,36,53,-17,32
Sonderjyske,3996,7,8,6,10,28,29,-1,30
Lyngby,3996,8,4,9,11,28,44,-16,21
Silkeborg IF,3996,9,6,3,13,27,45,-18,21
Randers FC,3996,10,5,6,13,23,41,-18,21
AGF Aarhus,3996,11,4,6,12,17,38,-21,18
Brondby,3997,1,21,5,4,72,34,38,68
FC Midtjylla,3997,2,19,5,6,67,36,31,62
FC Nords,3997,3,15,6,9,78,55,23,51
Copenhagen,3997,4,14,4,12,58,50,8,46
AC Horsens,3997,5,8,12,10,36,56,-20,36
AaB,3997,6,7,12,11,35,41,-6,33
Sonderjyske,3997,7,8,6,10,28,29,-1,30
Randers FC,3997,8,5,7,12,23,39,-16,22
Lyngby,3997,9,3,10,11,26,44,-18,19
Silkeborg IF,3997,10,5,4,13,26,45,-19,19
AGF Aarhus,3997,11,4,7,11,17,37,-20,19
Brondby,3998,1,19,7,4,65,30,35,64
FC Midtjylla,3998,2,19,5,6,63,41,22,62
FC Nords,3998,3,15,6,9,72,50,22,51
Copenhagen,3998,4,14,6,10,58,44,14,48
AaB,3998,5,8,13,9,35,37,-2,37
Sonderjyske,3998,6,8,6,10,28,29,-1,30
AC Horsens,3998,7,5,15,10,30,47,-17,30
Lyngby,3998,8,4,9,11,27,44,-17,21
Silkeborg IF,3998,8,6,3,13,27,44,-17,21
Randers FC,3998,10,5,6,13,23,40,-17,21
AGF Aarhus,3998,11,4,6,12,16,38,-22,18
FC Midtjylla,3999,1,21,4,5,66,38,28,67
Brondby,3999,2,20,5,5,66,34,32,65
FC Nords,3999,3,15,6,9,73,50,23,51
Copenhagen,3999,4,15,4,11,56,41,15,49
AaB,3999,5,7,12,11,39,42,-3,33
AC Horsens,3999,6,6,13,11,33,54,-21,31
Sonderjyske,3999,7,8,6,10,28,29,-1,30
Randers FC,3999,8,5,7,12,23,39,-16,22
Silkeborg IF,3999,9,6,3,13,27,45,-18,21
Lyngby,3999,10,3,10,11,26,44,-18,19
AGF Aarhus,3999,11,4,6,12,17,38,-21,18
Brondby,4000,1,21,6,3,75,35,40,69
FC Midtjylla,4000,2,20,5,5,69,38,31,65
FC Nords,4000,3,14,8,8,75,50,25,50
Copenhagen,4000,4,15,5,10,61,45,16,50
Sonderjyske,4000,5,8,6,10,28,29,-1,30
AaB,4000,6,6,12,12,36,48,-12,30
AC Horsens,4000,7,6,12,12,32,58,-26,30
Lyngby,4000,8,4,9,11,27,44,-17,21
Randers FC,4000,9,5,6,13,23,40,-17,21
AGF Aarhus,4000,10,5,6,11,18,36,-18,21
Silkeborg IF,4000,11,5,3,14,25,46,-21,18
Brondby,4001,1,21,7,2,74,33,41,70
FC Midtjylla,4001,2,18,5,7,66,44,22,59
FC Nords,4001,3,14,7,9,71,51,20,49
Copenhagen,4001,4,12,9,9,57,44,13,45
AaB,4001,5,7,13,10,36,43,-7,34
AC Horsens,4001,6,7,13,10,33,48,-15,34
Sonderjyske,4001,7,8,6,10,28,29,-1,30
Randers FC,4001,8,6,6,12,26,41,-15,24
Silkeborg IF,4001,9,6,3,13,28,44,-16,21
Lyngby,4001,10,3,9,12,28,47,-19,18
AGF Aarhus,4001,11,4,6,12,16,39,-23,18
Brondby,4002,1,21,6,3,76,34,42,69
FC Midtjylla,4002,2,20,6,4,68,40,28,66
FC Nords,4002,3,14,8,8,74,51,23,50
Copenhagen,4002,4,12,6,12,55,47,8,42
AaB,4002,5,7,13,10,36,45,-9,34
Sonderjyske,4002,6,8,6,10,28,29,-1,30
AC Horsens,4002,7,5,15,10,35,53,-18,30
Randers FC,4002,8,6,6,12,26,39,-13,24
Silkeborg IF,4002,9,6,3,13,28,46,-18,21
Lyngby,4002,10,3,9,12,26,47,-21,18
AGF Aarhus,4002,11,4,6,12,18,39,-21,18
Brondby,4003,1,21,5,4,68,32,36,68
FC Midtjylla,4003,2,20,4,6,66,43,23,64
FC Nords,4003,3,15,6,9,77,50,27,51
Copenhagen,4003,4,14,4,12,57,48,9,46
AC Horsens,4003,5,7,13,10,40,53,-13,34
AaB,4003,6,7,12,11,37,45,-8,33
Sonderjyske,4003,7,8,6,10,28,29,-1,30
Randers FC,4003,8,6,6,12,26,40,-14,24
AGF Aarhus,4003,9,5,6,11,19,38,-19,21
Lyngby,4003,10,3,9,12,27,47,-20,18
Silkeborg IF,4003,10,5,3,14,27,47,-20,18
Brondby,4004,1,21,5,4,78,31,47,68
FC Midtjylla,4004,2,19,4,7,64,42,22,61
FC Nords,4004,3,15,6,9,73,58,15,51
Copenhagen,4004,4,15,4,11,61,44,17,49
AaB,4004,5,8,11,11,36,45,-9,35
AC Horsens,4004,6,7,12,11,37,55,-18,33
Sonderjyske,4004,7,8,6,10,28,29,-1,30
Silkeborg IF,4004,8,6,3,13,29,44,-15,21
Lyngby,4004,9,4,9,11,28,44,-16,21
Randers FC,4004,10,5,6,13,23,41,-18,21
AGF Aarhus,4004,11,4,6,12,16,40,-24,18
FC Midtjylla,4005,1,21,5,4,65,36,29,68
Brondby,4005,2,20,5,5,72,36,36,65
FC Nords,4005,3,14,7,9,76,55,21,49
Copenhagen,4005,4,13,7,10,61,47,14,46
AaB,4005,5,7,12,11,38,45,-7,33
AC Horsens,4005,6,6,14,10,34,53,-19,32
Sonderjyske,4005,7,8,6,10,28,29,-1,30
Lyngby,4005,8,4,9,11,29,44,-15,21
Silkeborg IF,4005,9,6,3,13,29,46,-17,21
Randers FC,4005,10,5,6,13,23,42,-19,21
AGF Aarhus,4005,11,4,6,12,18,40,-22,18
FC Midtjylla,4006,1,21,4,5,77,41,36,67
Brondby,4006,2,20,6,4,73,35,38,66
FC Nords,4006,3,15,6,9,78,57,21,51
Copenhagen,4006,4,14,4,12,58,49,9,46
AaB,4006,5,8,12,10,37,44,-7,36
Sonderjyske,4006,6,8,6,10,28,29,-1,30
AC Horsens,4006,7,6,12,12,37,60,-23,30
Randers FC,4006,8,5,7,12,25,41,-16,22
Silkeborg IF,4006,9,6,3,13,28,45,-17,21
Lyngby,4006,10,3,10,11,28,46,-18,19
AGF Aarhus,4006,11,4,6,12,17,39,-22,18
Brondby,4007,1,21,6,3,71,31,40,69
FC Midtjylla,4007,2,19,6,5,67,41,26,63
FC Nords,4007,3,15,6,9,81,55,26,51
Copenhagen,4007,4,15,5,10,57,43,14,50
Sonderjyske,4007,5,8,6,10,28,29,-1,30
AaB,4007,6,6,12,12,38,51,-13,30
AC Horsens,4007,7,5,15,10,31,50,-19,30
Randers FC,4007,8,6,6,12,24,39,-15,24
Silkeborg IF,4007,9,5,4,13,26,45,-19,19
AGF Aarhus,4007,10,4,7,11,17,37,-20,19
Lyngby,4007,11,3,9,12,26,45,-19,18
Brondby,4008,1,20,8,2,72,33,39,68
FC Midtjylla,4008,2,19,5,6,64,41,23,62
FC Nords,4008,3,16,6,8,78,49,29,54
Copenhagen,4008,4,13,5,12,55,49,6,44
AC Horsens,4008,5,7,13,10,36,51,-15,34
AaB,4008,6,6,13,11,38,46,-8,31
Sonderjyske,4008,7,8,6,10,28,29,-1,30
Lyngby,4008,8,4,9,11,28,45,-17,21
Randers FC,4008,9,5,6,13,24,41,-17,21
Silkeborg IF,4008,10,6,3,13,28,46,-18,21
AGF Aarhus,4008,11,4,6,12,18,39,-21,18
Brondby,4009,1,22,6,2,74,30,44,72
FC Midtjylla,4009,2,21,5,4,71,39,32,68
FC Nords,4009,3,14,7,9,71,52,19,49
Copenhagen,4009,4,13,6,11,59,46,13,45
AC Horsens,4009,5,6,13,11,35,54,-19,31
Sonderjyske,4009,6,8,6,10,28,29,-1,30
AaB,4009,7,6,11,13,35,50,-15,29
Randers FC,4009,8,6,6,12,24,39,-15,24
AGF Aarhus,4009,9,5,6,11,18,36,-18,21
Lyngby,4009,10,3,9,12,26,45,-19,18
Silkeborg IF,4009,11,5,3,14,25,46,-21,18
Brondby,4010,1,21,5,4,68,33,35,68
FC Midtjylla,4010,2,19,4,7,64,42,22,61
Copenhagen,4010,3,15,6,9,60,41,19,51
FC Nords,4010,4,13,6,11,70,56,14,45
AaB,4010,5,9,12,9,41,43,-2,39
AC Horsens,4010,6,6,13,11,39,53,-14,31
Sonderjyske,4010,7,8,6,10,28,29,-1,30
Randers FC,4010,8,5,7,12,23,39,-16,22
Silkeborg IF,4010,9,6,3,13,27,44,-17,21
Lyngby,4010,10,3,10,11,26,44,-18,19
AGF Aarhus,4010,11,4,6,12,16,38,-22,18
Brondby,4011,1,20,6,4,75,35,40,66
FC Midtjylla,4011,2,19,7,4,68,41,27,64
FC Nords,4011,3,16,6,8,76,52,24,54
Copenhagen,4011,4,12,5,13,54,45,9,41
AaB,4011,5,8,12,10,39,43,-4,36
AC Horsens,4011,6,6,14,10,33,55,-22,32
Sonderjyske,4011,7,8,6,10,28,29,-1,30
Randers FC,4011,8,6,6,12,26,40,-14,24
AGF Aarhus,4011,9,5,6,11,17,36,-19,21
Lyngby,4011,10,3,9,12,27,47,-20,18
Silkeborg IF,4011,11,5,3,14,25,45,-20,18
Brondby,4012,1,22,6,2,71,29,42,72
FC Midtjylla,4012,2,19,5,6,63,40,23,62
FC Nords,4012,3,15,6,9,73,51,22,51
Copenhagen,4012,4,15,4,11,58,44,14,49
AaB,4012,5,6,13,11,35,43,-8,31
Sonderjyske,4012,6,8,6,10,28,29,-1,30
AC Horsens,4012,7,5,14,11,36,55,-19,29
Lyngby,4012,8,4,9,11,27,44,-17,21
Randers FC,4012,9,5,6,13,23,40,-17,21
Silkeborg IF,4012,10,6,3,13,26,44,-18,21
AGF Aarhus,4012,11,4,6,12,16,37,-21,18
Brondby,4013,1,22,5,3,72,35,37,71
FC Midtjylla,4013,2,20,5,5,69,42,27,65
FC Nords,4013,3,16,6,8,82,50,32,54
Copenhagen,4013,4,12,6,12,61,55,6,42
AaB,4013,5,7,12,11,36,45,-9,33
Sonderjyske,4013,6,8,6,10,28,29,-1,30
AC Horsens,4013,7,5,14,11,35,54,-19,29
Lyngby,4013,8,4,9,11,30,45,-15,21
AGF Aarhus,4013,9,5,6,11,19,37,-18,21
Randers FC,4013,10,5,6,13,24,43,-19,21
Silkeborg IF,4013,11,5,3,14,26,47,-21,18
Brondby,4014,1,21,6,3,72,30,42,69
FC Midtjylla,4014,2,20,5,5,65,37,28,65
FC Nords,4014,3,14,6,10,73,52,21,48
Copenhagen,4014,4,12,7,11,51,43,8,43
AaB,4014,5,8,12,10,37,43,-6,36
AC Horsens,4014,6,6,14,10,32,51,-19,32
Sonderjyske,4014,7,8,6,10,28,29,-1,30
Lyngby,4014,8,4,9,11,28,44,-16,21
Silkeborg IF,4014,9,6,3,13,28,45,-17,21
Randers FC,4014,10,5,6,13,23,41,-18,21
AGF Aarhus,4014,11,4,6,12,17,39,-22,18
Brondby,4015,1,22,6,2,74,32,42,72
FC Midtjylla,4015,2,19,6,5,65,39,26,63
FC Nords,4015,3,15,6,9,75,52,23,51
Copenhagen,4015,4,13,6,11,59,48,11,45
AaB,4015,5,7,12,11,36,43,-7,33
Sonderjyske,4015,6,8,6,10,28,29,-1,30
AC Horsens,4015,7,5,14,11,35,56,-21,29
Randers FC,4015,8,5,7,12,24,40,-16,22
AGF Aarhus,4015,9,5,6,11,19,38,-19,21
Lyngby,4015,10,3,10,11,27,45,-18,19
Silkeborg IF,4015,11,5,3,14,27,47,-20,18
Brondby,4016,1,19,7,4,72,37,35,64
FC Midtjylla,4016,2,18,6,6,59,42,17,60
Copenhagen,4016,3,15,5,10,65,44,21,50
FC Nords,4016,4,14,7,9,75,56,19,49
AC Horsens,4016,5,7,14,9,36,49,-13,35
AaB,4016,6,7,13,10,36,41,-5,34
Sonderjyske,4016,7,8,6,10,28,29,-1,30
Randers FC,4016,8,5,7,12,25,41,-16,22
Silkeborg IF,4016,9,6,3,13,27,45,-18,21
Lyngby,4016,10,3,10,11,28,46,-18,19
AGF Aarhus,4016,11,4,6,12,17,38,-21,18
FC Midtjylla,4017,1,22,4,4,69,36,33,70
Brondby,4017,2,19,6,5,66,34,32,63
Copenhagen,4017,3,15,5,10,59,42,17,50
FC Nords,4017,4,13,7,10,69,54,15,46
AaB,4017,5,7,14,9,35,41,-6,35
Sonderjyske,4017,6,8,6,10,28,29,-1,30
AC Horsens,4017,7,6,12,12,37,54,-17,30
Randers FC,4017,8,6,6,12,25,39,-14,24
Silkeborg IF,4017,9,6,3,13,27,44,-17,21
Lyngby,4017,10,3,9,12,26,46,-20,18
AGF Aarhus,4017,11,4,6,12,16,38,-22,18
Brondby,4018,1,20,6,4,71,30,41,66
FC Midtjylla,4018,2,20,6,4,72,39,33,66
FC Nords,4018,3,14,6,10,71,58,13,48
Copenhagen,4018,4,13,5,12,54,46,8,44
AaB,4018,5,8,12,10,39,44,-5,36
AC Horsens,4018,6,7,13,10,35,51,-16,34
Sonderjyske,4018,7,8,6,10,28,29,-1,30
Randers FC,4018,8,6,6,12,26,40,-14,24
Silkeborg IF,4018,9,6,3,13,26,44,-18,21
Lyngby,4018,10,3,9,12,27,47,-20,18
AGF Aarhus,4018,11,4,6,12,16,37,-21,18
Brondby,4019,1,21,6,3,73,33,40,69
FC Midtjylla,4019,2,21,5,4,68,37,31,68
FC Nords,4019,3,13,7,10,71,55,16,46
Copenhagen,4019,4,12,7,11,56,46,10,43
AaB,4019,5,9,11,10,39,41,-2,38
Sonderjyske,4019,6,8,6,10,28,29,-1,30
AC Horsens,4019,7,5,14,11,34,55,-21,29
Silkeborg IF,4019,8,6,3,13,30,44,-14,21
Lyngby,4019,9,4,9,11,27,44,-17,21
Randers FC,4019,10,5,6,13,23,40,-17,21
AGF Aarhus,4019,11,4,6,12,16,41,-25,18
Brondby,4020,1,21,5,4,74,31,43,68
FC Midtjylla,4020,2,21,5,4,71,41,30,68
FC Nords,4020,3,13,6,11,69,56,13,45
Copenhagen,4020,4,13,5,12,57,47,10,44
AC Horsens,4020,5,8,13,9,38,51,-13,37
AaB,4020,6,7,12,11,37,46,-9,33
Sonderjyske,4020,7,8,6,10,28,29,-1,30
Randers FC,4020,8,5,7,12,24,40,-16,22
Silkeborg IF,4020,9,6,3,13,26,44,-18,21
Lyngby,4020,10,3,10,11,27,45,-18,19
AGF Aarhus,4020,11,4,6,12,16,37,-21,18
Brondby,4021,1,20,7,3,71,35,36,67
FC Midtjylla,4021,2,21,4,5,68,37,31,67
FC Nords,4021,3,14,7,9,81,58,23,49
Copenhagen,4021,4,14,5,11,59,48,11,47
AaB,4021,5,7,13,10,36,44,-8,34
Sonderjyske,4021,6,8,6,10,28,29,-1,30
AC Horsens,4021,7,5,14,11,36,55,-19,29
Lyngby,4021,8,4,9,11,30,45,-15,21
Randers FC,4021,9,5,6,13,24,43,-19,21
AGF Aarhus,4021,10,5,6,11,17,36,-19,21
Silkeborg IF,4021,11,5,3,14,25,45,-20,18
FC Midtjylla,4022,1,21,5,4,67,36,31,68
Brondby,4022,2,19,6,5,66,34,32,63
FC Nords,4022,3,15,7,8,72,49,23,52
Copenhagen,4022,4,14,4,12,57,43,14,46
AaB,4022,5,8,12,10,34,39,-5,36
Sonderjyske,4022,6,8,6,10,28,29,-1,30
AC Horsens,4022,7,6,12,12,36,57,-21,30
Lyngby,4022,8,4,9,11,27,44,-17,21
Randers FC,4022,9,5,6,13,23,40,-17,21
AGF Aarhus,4022,10,5,6,11,17,36,-19,21
Silkeborg IF,4022,11,5,3,14,25,45,-20,18
FC Midtjylla,4023,1,20,5,5,70,37,33,65
Brondby,4023,2,20,5,5,66,37,29,65
FC Nords,4023,3,14,7,9,72,52,20,49
Copenhagen,4023,4,13,6,11,59,48,11,45
AaB,4023,5,8,13,9,43,44,-1,37
AC Horsens,4023,6,7,12,11,41,59,-18,33
Sonderjyske,4023,7,8,6,10,28,29,-1,30
Lyngby,4023,8,4,9,11,28,45,-17,21
Randers FC,4023,9,5,6,13,24,41,-17,21
Silkeborg IF,4023,10,6,3,13,28,46,-18,21
AGF Aarhus,4023,11,4,6,12,18,39,-21,18
Brondby,4024,1,20,8,2,73,34,39,68
FC Midtjylla,4024,2,19,7,4,68,40,28,64
FC Nords,4024,3,15,7,8,79,53,26,52
Copenhagen,4024,4,12,6,12,53,46,7,42
AC Horsens,4024,5,6,15,9,34,51,-17,33
AaB,4024,6,7,11,12,37,46,-9,32
Sonderjyske,4024,7,8,6,10,28,29,-1,30
Randers FC,4024,8,6,6,12,25,40,-15,24
AGF Aarhus,4024,9,5,6,11,17,36,-19,21
Lyngby,4024,10,3,9,12,27,46,-19,18
Silkeborg IF,4024,11,5,3,14,25,45,-20,18
Brondby,4025,1,21,6,3,71,30,41,69
FC Midtjylla,4025,2,21,5,4,67,36,31,68
Copenhagen,4025,3,14,6,10,56,41,15,48
FC Nords,4025,4,13,7,10,74,54,20,46
AaB,4025,5,7,12,11,34,43,-9,33
Sonderjyske,4025,6,8,6,10,28,29,-1,30
AC Horsens,4025,7,6,12,12,34,58,-24,30
Randers FC,4025,8,6,6,12,24,39,-15,24
Silkeborg IF,4025,9,6,3,13,26,44,-18,21
Lyngby,4025,10,3,9,12,26,45,-19,18
AGF Aarhus,4025,11,4,6,12,16,37,-21,18
Brondby,4026,1,21,6,3,69,31,38,69
FC Midtjylla,4026,2,20,4,6,65,40,25,64
FC Nords,4026,3,15,6,9,74,55,19,51
Copenhagen,4026,4,12,6,12,56,47,9,42
AaB,4026,5,8,13,9,45,42,3,37
AC Horsens,4026,6,6,13,11,32,52,-20,31
Sonderjyske,4026,7,8,6,10,28,29,-1,30
Randers FC,4026,8,6,6,12,27,41,-14,24
AGF Aarhus,4026,9,5,6,11,18,37,-19,21
Lyngby,4026,10,3,9,12,28,48,-20,18
Silkeborg IF,4026,11,5,3,14,26,46,-20,18
Brondby,4027,1,20,6,4,68,29,39,66
FC Midtjylla,4027,2,19,5,6,64,37,27,62
FC Nords,4027,3,15,6,9,71,55,16,51
Copenhagen,4027,4,15,4,11,57,43,14,49
AaB,4027,5,7,13,10,36,39,-3,34
AC Horsens,4027,6,7,12,11,34,53,-19,33
Sonderjyske,4027,7,8,6,10,28,29,-1,30
Randers FC,4027,8,6,6,12,24,39,-15,24
AGF Aarhus,4027,9,5,6,11,17,36,-19,21
Lyngby,4027,10,3,9,12,26,45,-19,18
Silkeborg IF,4027,11,5,3,14,25,45,-20,18
Brondby,4028,1,21,7,2,75,30,45,70
FC Midtjylla,4028,2,21,4,5,64,38,26,67
Copenhagen,4028,3,14,6,10,59,43,16,48
FC Nords,4028,4,13,8,9,73,55,18,47
AC Horsens,4028,5,6,13,11,34,55,-21,31
Sonderjyske,4028,6,8,6,10,28,29,-1,30
AaB,4028,7,6,12,12,37,47,-10,30
Randers FC,4028,8,6,6,12,25,39,-14,24
Silkeborg IF,4028,9,5,4,13,26,45,-19,19
AGF Aarhus,4028,10,4,7,11,17,37,-20,19
Lyngby,4028,11,3,9,12,26,46,-20,18
Brondby,4029,1,19,8,3,68,34,34,65
FC Midtjylla,4029,2,19,6,5,65,38,27,63
Copenhagen,4029,3,15,6,9,58,41,17,51
FC Nords,4029,4,14,7,9,73,54,19,49
AaB,4029,5,7,13,10,37,40,-3,34
Sonderjyske,4029,6,8,6,10,28,29,-1,30
AC Horsens,4029,7,5,14,11,31,51,-20,29
Randers FC,4029,8,5,7,12,23,39,-16,22
Silkeborg IF,4029,9,6,3,13,28,44,-16,21
Lyngby,4029,10,3,10,11,26,44,-18,19
AGF Aarhus,4029,11,4,6,12,16,39,-23,18
Brondby,4030,1,20,7,3,75,33,42,67
FC Midtjylla,4030,2,18,7,5,69,44,25,61
FC Nords,4030,3,15,8,7,74,48,26,53
Copenhagen,4030,4,13,6,11,59,49,10,45
AaB,4030,5,8,12,10,38,44,-6,36
Sonderjyske,4030,6,8,6,10,28,29,-1,30
AC Horsens,4030,7,6,12,12,35,58,-23,30
Lyngby,4030,8,4,9,11,29,44,-15,21
Silkeborg IF,4030,9,6,3,13,27,45,-18,21
Randers FC,4030,10,5,6,13,23,42,-19,21
AGF Aarhus,4030,11,4,6,12,17,38,-21,18
Brondby,4031,1,20,8,2,71,31,40,68
FC Midtjylla,4031,2,20,4,6,63,41,22,64
FC Nords,4031,3,16,7,7,84,52,32,55
Copenhagen,4031,4,13,6,11,57,43,14,45
Sonderjyske,4031,5,8,6,10,28,29,-1,30
AaB,4031,6,6,12,12,38,49,-11,30
AC Horsens,4031,7,5,15,10,34,57,-23,30
Lyngby,4031,8,4,9,11,28,45,-17,21
Randers FC,4031,9,5,6,13,24,41,-17,21
Silkeborg IF,4031,10,5,4,13,27,46,-19,19
AGF Aarhus,4031,11,4,7,11,18,38,-20,19
Brondby,4032,1,22,5,3,73,30,43,71
FC Midtjylla,4032,2,21,5,4,67,37,30,68
FC Nords,4032,3,14,7,9,72,52,20,49
Copenhagen,4032,4,12,4,14,56,51,5,40
AC Horsens,4032,5,7,13,10,37,52,-15,34
AaB,4032,6,7,12,11,38,47,-9,33
Sonderjyske,4032,7,8,6,10,28,29,-1,30
Randers FC,4032,8,5,7,12,24,40,-16,22
Silkeborg IF,4032,9,6,3,13,27,45,-18,21
Lyngby,4032,10,3,10,11,27,45,-18,19
AGF Aarhus,4032,11,4,6,12,17,38,-21,18
Brondby,4033,1,21,6,3,70,31,39,69
FC Midtjylla,4033,2,19,6,5,68,42,26,63
FC Nords,4033,3,13,7,10,73,55,18,46
Copenhagen,4033,4,13,6,11,61,50,11,45
AaB,4033,5,9,13,8,43,44,-1,40
Sonderjyske,4033,6,8,6,10,28,29,-1,30
AC Horsens,4033,7,5,14,11,36,55,-19,29
Lyngby,4033,8,4,9,11,29,45,-16,21
Silkeborg IF,4033,9,6,3,13,26,44,-18,21
Randers FC,4033,10,5,6,13,24,42,-18,21
AGF Aarhus,4033,11,4,6,12,16,37,-21,18
Brondby,4034,1,23,5,2,77,32,45,74
FC Midtjylla,4034,2,18,5,7,63,44,19,59
FC Nords,4034,3,15,7,8,76,53,23,52
Copenhagen,4034,4,14,5,11,59,44,15,47
AaB,4034,5,8,12,10,41,43,-2,36
Sonderjyske,4034,6,8,6,10,28,29,-1,30
AC Horsens,4034,7,5,12,13,34,60,-26,27
Randers FC,4034,8,5,7,12,23,39,-16,22
Silkeborg IF,4034,9,6,3,13,27,45,-18,21
Lyngby,4034,10,3,10,11,26,44,-18,19
AGF Aarhus,4034,11,4,6,12,17,38,-21,18
Brondby,4035,1,22,6,2,72,29,43,72
FC Midtjylla,4035,2,19,6,5,66,38,28,63
Copenhagen,4035,3,16,4,10,58,44,14,52
FC Nords,4035,4,14,7,9,73,50,23,49
Sonderjyske,4035,5,8,6,10,28,29,-1,30
AaB,4035,6,6,12,12,37,48,-11,30
AC Horsens,4035,7,5,13,12,34,57,-23,28
Randers FC,4035,8,5,7,12,25,41,-16,22
AGF Aarhus,4035,9,5,6,11,18,37,-19,21
Lyngby,4035,10,3,10,11,28,46,-18,19
Silkeborg IF,4035,11,5,3,14,26,46,-20,18
FC Midtjylla,4036,1,20,5,5,67,38,29,65
Brondby,4036,2,19,7,4,70,36,34,64
FC Nords,4036,3,15,6,9,75,54,21,51
Copenhagen,4036,4,13,7,10,59,46,13,46
AaB,4036,5,7,13,10,34,41,-7,34
AC Horsens,4036,6,6,14,10,39,55,-16,32
Sonderjyske,4036,7,8,6,10,28,29,-1,30
Lyngby,4036,8,4,9,11,29,44,-15,21
Silkeborg IF,4036,9,6,3,13,28,46,-18,21
Randers FC,4036,10,5,6,13,23,42,-19,21
AGF Aarhus,4036,11,4,6,12,18,39,-21,18
Brondby,4037,1,20,6,4,70,31,39,66
FC Midtjylla,4037,2,20,4,6,69,42,27,64
FC Nords,4037,3,14,6,10,73,55,18,48
Copenhagen,4037,4,13,6,11,54,46,8,45
AC Horsens,4037,5,9,13,8,39,47,-8,40
AaB,4037,6,7,11,12,37,47,-10,32
Sonderjyske,4037,7,8,6,10,28,29,-1,30
Lyngby,4037,8,4,9,11,28,45,-17,21
Randers FC,4037,9,5,6,13,24,41,-17,21
AGF Aarhus,4037,10,5,6,11,17,36,-19,21
Silkeborg IF,4037,11,5,3,14,25,45,-20,18
Brondby,4038,1,21,6,3,69,30,39,69
FC Midtjylla,4038,2,19,5,6,61,37,24,62
Copenhagen,4038,3,15,6,9,60,43,17,51
FC Nords,4038,4,14,6,10,71,51,20,48
AaB,4038,5,7,12,11,33,42,-9,33
AC Horsens,4038,6,6,13,11,37,54,-17,31
Sonderjyske,4038,7,8,6,10,28,29,-1,30
Lyngby,4038,8,4,9,11,29,45,-16,21
AGF Aarhus,4038,9,5,6,11,19,36,-17,21
Randers FC,4038,10,5,6,13,24,42,-18,21
Silkeborg IF,4038,11,5,3,14,25,47,-22,18
Brondby,4039,1,19,9,2,70,32,38,66
FC Midtjylla,4039,2,20,5,5,71,41,30,65
FC Nords,4039,3,14,7,9,71,52,19,49
Copenhagen,4039,4,13,5,12,56,47,9,44
AaB,4039,5,8,13,9,37,40,-3,37
AC Horsens,4039,6,6,13,11,35,54,-19,31
Sonderjyske,4039,7,8,6,10,28,29,-1,30
Lyngby,4039,8,4,9,11,29,45,-16,21
Silkeborg IF,4039,9,6,3,13,27,45,-18,21
Randers FC,4039,10,5,6,13,24,42,-18,21
AGF Aarhus,4039,11,4,6,12,17,38,-21,18
Brondby,4040,1,21,5,4,73,34,39,68
FC Midtjylla,4040,2,17,6,7,63,44,19,57
Copenhagen,4040,3,14,6,10,54,39,15,48
FC Nords,4040,4,13,7,10,75,56,19,46
AC Horsens,4040,5,8,14,8,38,49,-11,38
AaB,4040,6,7,14,9,37,44,-7,35
Sonderjyske,4040,7,8,6,10,28,29,-1,30
Randers FC,4040,8,5,7,12,24,40,-16,22
Silkeborg IF,4040,9,6,3,13,26,44,-18,21
Lyngby,4040,10,3,10,11,27,45,-18,19
AGF Aarhus,4040,11,4,6,12,16,37,-21,18
Brondby,4041,1,20,7,3,72,33,39,67
FC Midtjylla,4041,2,19,5,6,67,44,23,62
Copenhagen,4041,3,15,6,9,58,41,17,51
FC Nords,4041,4,13,9,8,76,55,21,48
AC Horsens,4041,5,6,15,9,35,49,-14,33
Sonderjyske,4041,6,8,6,10,28,29,-1,30
AaB,4041,7,6,12,12,37,49,-12,30
Lyngby,4041,8,4,9,11,31,44,-13,21
Randers FC,4041,9,5,6,13,23,44,-21,21
Silkeborg IF,4041,10,5,4,13,26,45,-19,19
AGF Aarhus,4041,11,4,7,11,17,37,-20,19
Brondby,4042,1,22,6,2,77,30,47,72
FC Midtjylla,4042,2,21,4,5,70,36,34,67
FC Nords,4042,3,14,7,9,71,52,19,49
Copenhagen,4042,4,14,5,11,57,47,10,47
AaB,4042,5,6,13,11,36,46,-10,31
Sonderjyske,4042,6,8,6,10,28,29,-1,30
AC Horsens,4042,7,5,13,12,32,58,-26,28
Randers FC,4042,8,6,6,12,25,39,-14,24
Silkeborg IF,4042,9,6,3,13,26,44,-18,21
Lyngby,4042,10,3,9,12,26,46,-20,18
AGF Aarhus,4042,11,4,6,12,16,37,-21,18
Brondby,4043,1,21,7,2,68,28,40,70
FC Midtjylla,4043,2,21,5,4,66,36,30,68
FC Nords,4043,3,15,6,9,74,54,20,51
Copenhagen,4043,4,13,5,12,57,45,12,44
AaB,4043,5,7,12,11,38,44,-6,33
Sonderjyske,4043,6,8,6,10,28,29,-1,30
AC Horsens,4043,7,5,13,12,32,54,-22,28
Lyngby,4043,8,4,9,11,28,45,-17,21
Randers FC,4043,9,5,6,13,24,41,-17,21
AGF Aarhus,4043,10,5,6,11,18,36,-18,21
Silkeborg IF,4043,11,5,3,14,25,46,-21,18
Brondby,4044,1,22,6,2,72,31,41,72
FC Midtjylla,4044,2,20,4,6,64,38,26,64
Copenhagen,4044,3,15,4,11,61,47,14,49
FC Nords,4044,4,14,6,10,73,52,21,48
AC Horsens,4044,5,7,12,11,38,54,-16,33
Sonderjyske,4044,6,8,6,10,28,29,-1,30
AaB,4044,7,6,12,12,38,50,-12,30
Randers FC,4044,8,5,7,12,24,40,-16,22
Silkeborg IF,4044,9,6,3,13,26,44,-18,21
Lyngby,4044,10,3,10,11,27,45,-18,19
AGF Aarhus,4044,11,4,6,12,16,37,-21,18
Brondby,4045,1,20,8,2,76,36,40,68
FC Midtjylla,4045,2,19,7,4,62,36,26,64
FC Nords,4045,3,14,7,9,75,53,22,49
Copenhagen,4045,4,13,6,11,59,46,13,45
AC Horsens,4045,5,7,13,10,38,56,-18,34
AaB,4045,6,7,11,12,33,42,-9,32
Sonderjyske,4045,7,8,6,10,28,29,-1,30
Randers FC,4045,8,6,6,12,24,39,-15,24
Silkeborg IF,4045,9,6,3,13,27,45,-18,21
Lyngby,4045,10,3,9,12,26,45,-19,18
AGF Aarhus,4045,11,4,6,12,17,38,-21,18
Brondby,4046,1,22,6,2,74,31,43,72
FC Midtjylla,4046,2,19,5,6,66,39,27,62
FC Nords,4046,3,15,7,8,74,48,26,52
Copenhagen,4046,4,13,5,12,54,47,7,44
AaB,4046,5,7,12,11,34,42,-8,33
Sonderjyske,4046,6,8,6,10,28,29,-1,30
AC Horsens,4046,7,5,15,10,36,57,-21,30
Randers FC,4046,8,5,7,12,26,42,-16,22
Silkeborg IF,4046,9,6,3,13,29,45,-16,21
Lyngby,4046,10,3,10,11,29,47,-18,19
AGF Aarhus,4046,11,4,6,12,17,40,-23,18
Brondby,4047,1,22,6,2,70,28,42,72
FC Midtjylla,4047,2,19,6,5,63,37,26,63
FC Nords,4047,3,14,6,10,72,51,21,48
Copenhagen,4047,4,13,5,12,56,46,10,44
AC Horsens,4047,5,9,12,9,39,49,-10,39
Sonderjyske,4047,6,8,6,10,28,29,-1,30
AaB,4047,7,6,11,13,34,49,-15,29
Lyngby,4047,8,4,9,11,28,44,-16,21
Randers FC,4047,9,5,6,13,23,41,-18,21
Silkeborg IF,4047,10,5,4,13,25,44,-19,19
AGF Aarhus,4047,11,4,7,11,16,36,-20,19
Brondby,4048,1,22,6,2,70,30,40,72
FC Midtjylla,4048,2,19,5,6,65,40,25,62
FC Nords,4048,3,14,8,8,72,51,21,50
Copenhagen,4048,4,13,6,11,59,45,14,45
AaB,4048,5,7,11,12,33,41,-8,32
AC Horsens,4048,6,6,14,10,35,53,-18,32
Sonderjyske,4048,7,8,6,10,28,29,-1,30
Randers FC,4048,8,5,7,12,23,39,-16,22
Lyngby,4048,9,3,10,11,26,44,-18,19
Silkeborg IF,4048,10,5,4,13,25,44,-19,19
AGF Aarhus,4048,11,4,7,11,16,36,-20,19
FC Midtjylla,4049,1,21,5,4,70,38,32,68
Brondby,4049,2,20,7,3,70,32,38,67
FC Nords,4049,3,15,6,9,74,51,23,51
Copenhagen,4049,4,13,5,12,56,48,8,44
AaB,4049,5,7,12,11,35,44,-9,33
Sonderjyske,4049,6,8,6,10,28,29,-1,30
AC Horsens,4049,7,5,15,10,36,54,-18,30
Lyngby,4049,8,4,9,11,27,44,-17,21
Randers FC,4049,9,5,6,13,23,40,-17,21
Silkeborg IF,4049,10,6,3,13,27,45,-18,21
AGF Aarhus,4049,11,4,6,12,17,38,-21,18
Brondby,4050,1,20,7,3,67,32,35,67
FC Midtjylla,4050,2,18,5,7,61,39,22,59
FC Nords,4050,3,17,6,7,80,50,30,57
Copenhagen,4050,4,15,5,10,58,43,15,50
AC Horsens,4050,5,6,13,11,31,50,-19,31
Sonderjyske,4050,6,8,6,10,28,29,-1,30
AaB,4050,7,6,12,12,34,43,-9,30
Lyngby,4050,8,4,9,11,31,44,-13,21
Silkeborg IF,4050,9,6,3,13,26,44,-18,21
Randers FC,4050,10,5,6,13,23,44,-21,21
AGF Aarhus,4050,11,4,6,12,16,37,-21,18
Brondby,4051,1,20,8,2,70,32,38,68
FC Midtjylla,4051,2,19,7,4,64,35,29,64
FC Nords,4051,3,14,8,8,75,52,23,50
Copenhagen,4051,4,12,6,12,54,45,9,42
AaB,4051,5,7,13,10,37,44,-7,34
AC Horsens,4051,6,5,16,9,34,52,-18,31
Sonderjyske,4051,7,8,6,10,28,29,-1,30
Randers FC,4051,8,5,7,12,23,39,-16,22
Silkeborg IF,4051,9,6,3,13,29,44,-15,21
Lyngby,4051,10,3,10,11,26,44,-18,19
AGF Aarhus,4051,11,4,6,12,16,40,-24,18
Brondby,4052,1,21,6,3,71,31,40,69
FC Midtjylla,4052,2,18,7,5,63,40,23,61
FC Nords,4052,3,15,7,8,73,48,25,52
Copenhagen,4052,4,12,5,13,54,50,4,41
AaB,4052,5,8,11,11,36,41,-5,35
AC Horsens,4052,6,7,14,9,39,52,-13,35
Sonderjyske,4052,7,8,6,10,28,29,-1,30
Lyngby,4052,8,4,9,11,27,44,-17,21
Randers FC,4052,9,5,6,13,23,40,-17,21
Silkeborg IF,4052,10,6,3,13,26,44,-18,21
AGF Aarhus,4052,11,4,6,12,16,37,-21,18
Brondby,4053,1,21,6,3,75,37,38,69
FC Midtjylla,4053,2,19,4,7,66,44,22,61
FC Nords,4053,3,15,7,8,78,52,26,52
Copenhagen,4053,4,14,4,12,57,43,14,46
AC Horsens,4053,5,7,13,10,36,53,-17,34
AaB,4053,6,7,12,11,36,45,-9,33
Sonderjyske,4053,7,8,6,10,28,29,-1,30
Lyngby,4053,8,4,9,11,30,44,-14,21
Silkeborg IF,4053,9,6,3,13,26,44,-18,21
Randers FC,4053,10,5,6,13,23,43,-20,21
AGF Aarhus,4053,11,4,6,12,16,37,-21,18
Brondby,4054,1,19,8,3,65,30,35,65
FC Midtjylla,4054,2,20,5,5,69,42,27,65
Copenhagen,4054,3,13,8,9,59,43,16,47
FC Nords,4054,4,13,7,10,70,53,17,46
AaB,4054,5,8,13,9,39,41,-2,37
Sonderjyske,4054,6,8,6,10,28,29,-1,30
AC Horsens,4054,7,5,15,10,32,51,-19,30
Lyngby,4054,8,4,9,11,28,45,-17,21
Randers FC,4054,9,5,6,13,24,41,-17,21
Silkeborg IF,4054,10,6,3,13,26,44,-18,21
AGF Aarhus,4054,11,4,6,12,16,37,-21,18
Brondby,4055,1,20,7,3,68,31,37,67
FC Midtjylla,4055,2,20,4,6,63,36,27,64
Copenhagen,4055,3,15,5,10,58,43,15,50
FC Nords,4055,4,14,7,9,73,50,23,49
AaB,4055,5,7,13,10,35,44,-9,34
Sonderjyske,4055,6,8,6,10,28,29,-1,30
AC Horsens,4055,7,6,12,12,36,55,-19,30
Randers FC,4055,8,6,6,12,25,40,-15,24
Silkeborg IF,4055,9,6,3,13,26,44,-18,21
Lyngby,4055,10,3,9,12,27,46,-19,18
AGF Aarhus,4055,11,4,6,12,16,37,-21,18
Brondby,4056,1,20,8,2,71,33,38,68
FC Midtjylla,4056,2,19,5,6,66,41,25,62
Copenhagen,4056,3,16,5,9,62,41,21,53
FC Nords,4056,4,15,6,9,73,49,24,51
Sonderjyske,4056,5,8,6,10,28,29,-1,30
AaB,4056,6,6,12,12,35,43,-8,30
AC Horsens,4056,7,6,12,12,33,59,-26,30
Randers FC,4056,8,5,7,12,25,41,-16,22
Silkeborg IF,4056,9,6,3,13,27,44,-17,21
Lyngby,4056,10,3,10,11,28,46,-18,19
AGF Aarhus,4056,11,4,6,12,16,38,-22,18
Brondby,4057,1,21,7,2,72,28,44,70
FC Midtjylla,4057,2,19,4,7,65,40,25,61
Copenhagen,4057,3,14,7,9,58,42,16,49
FC Nords,4057,4,13,8,9,70,54,16,47
AaB,4057,5,8,14,8,39,41,-2,38
Sonderjyske,4057,6,8,6,10,28,29,-1,30
AC Horsens,4057,7,5,12,13,32,57,-25,27
Randers FC,4057,8,6,6,12,25,40,-15,24
Silkeborg IF,4057,9,5,4,13,26,45,-19,19
AGF Aarhus,4057,10,4,7,11,17,37,-20,19
Lyngby,4057,11,3,9,12,27,46,-19,18
Brondby,4058,1,19,5,6,68,36,32,62
FC Midtjylla,4058,2,18,5,7,61,42,19,59
FC Nords,4058,3,16,7,7,83,53,30,55
Copenhagen,4058,4,15,4,11,60,47,13,49
AC Horsens,4058,5,9,12,9,39,51,-12,39
AaB,4058,6,7,11,12,41,49,-8,32
Sonderjyske,4058,7,8,6,10,28,29,-1,30
Randers FC,4058,8,6,6,12,25,40,-15,24
Silkeborg IF,4058,9,6,3,13,27,44,-17,21
Lyngby,4058,10,3,9,12,27,46,-19,18
AGF Aarhus,4058,11,4,6,12,16,38,-22,18
FC Midtjylla,4059,1,21,5,4,69,37,32,68
Brondby,4059,2,20,5,5,70,33,37,65
FC Nords,4059,3,14,6,10,69,53,16,48
Copenhagen,4059,4,14,4,12,58,46,12,46
AaB,4059,5,9,11,10,36,40,-4,38
AC Horsens,4059,6,6,13,11,36,55,-19,31
Sonderjyske,4059,7,8,6,10,28,29,-1,30
Randers FC,4059,8,6,6,12,26,39,-13,24
Silkeborg IF,4059,9,5,4,13,26,45,-19,19
AGF Aarhus,4059,10,4,7,11,17,37,-20,19
Lyngby,4059,11,3,9,12,26,47,-21,18
Brondby,4060,1,20,5,5,70,33,37,65
FC Midtjylla,4060,2,20,5,5,62,39,23,65
Copenhagen,4060,3,14,6,10,56,43,13,48
FC Nords,4060,4,13,8,9,69,50,19,47
AC Horsens,4060,5,8,13,9,36,47,-11,37
AaB,4060,6,7,11,12,36,43,-7,32
Sonderjyske,4060,7,8,6,10,28,29,-1,30
Randers FC,4060,8,5,7,12,25,41,-16,22
Silkeborg IF,4060,9,6,3,13,27,44,-17,21
Lyngby,4060,10,3,10,11,28,46,-18,19
AGF Aarhus,4060,11,4,6,12,16,38,-22,18
Brondby,4061,1,22,5,3,74,32,42,71
FC Midtjylla,4061,2,21,5,4,67,36,31,68
FC Nords,4061,3,14,7,9,72,52,20,49
Copenhagen,4061,4,12,7,11,56,46,10,43
AaB,4061,5,7,12,11,35,41,-6,33
Sonderjyske,4061,6,8,6,10,28,29,-1,30
AC Horsens,4061,7,6,12,12,34,57,-23,30
Randers FC,4061,8,6,6,12,26,41,-15,24
Silkeborg IF,4061,9,6,3,13,27,45,-18,21
Lyngby,4061,10,3,9,12,28,47,-19,18
AGF Aarhus,4061,11,4,6,12,17,38,-21,18
Brondby,4062,1,22,5,3,72,30,42,71
FC Midtjylla,4062,2,21,4,5,66,38,28,67
FC Nords,4062,3,14,7,9,71,49,22,49
Copenhagen,4062,4,12,5,13,55,49,6,41
AaB,4062,5,8,11,11,38,44,-6,35
AC Horsens,4062,6,7,12,11,35,53,-18,33
Sonderjyske,4062,7,8,6,10,28,29,-1,30
Randers FC,4062,8,5,7,12,23,39,-16,22
Silkeborg IF,4062,9,6,3,13,28,44,-16,21
Lyngby,4062,10,3,10,11,26,44,-18,19
AGF Aarhus,4062,11,4,6,12,16,39,-23,18
Brondby,4063,1,20,6,4,71,36,35,66
FC Midtjylla,4063,2,17,5,8,65,46,19,56
FC Nords,4063,3,15,6,9,70,48,22,51
Copenhagen,4063,4,14,5,11,58,45,13,47
AaB,4063,5,9,12,9,40,44,-4,39
AC Horsens,4063,6,8,12,10,42,53,-11,36
Sonderjyske,4063,7,8,6,10,28,29,-1,30
Lyngby,4063,8,4,9,11,30,44,-14,21
Silkeborg IF,4063,9,6,3,13,26,44,-18,21
Randers FC,4063,10,5,6,13,23,43,-20,21
AGF Aarhus,4063,11,4,6,12,16,37,-21,18
Brondby,4064,1,22,5,3,72,31,41,71
FC Midtjylla,4064,2,19,6,5,70,43,27,63
FC Nords,4064,3,14,7,9,74,54,20,49
Copenhagen,4064,4,14,5,11,62,49,13,47
AC Horsens,4064,5,7,13,10,34,48,-14,34
Sonderjyske,4064,6,8,6,10,28,29,-1,30
AaB,4064,7,6,12,12,35,48,-13,30
Lyngby,4064,8,4,9,11,28,44,-16,21
Silkeborg IF,4064,9,6,3,13,26,44,-18,21
Randers FC,4064,10,5,6,13,23,41,-18,21
AGF Aarhus,4064,11,4,6,12,16,37,-21,18
Brondby,4065,1,20,6,4,69,31,38,66
FC Midtjylla,4065,2,20,4,6,64,43,21,64
FC Nords,4065,3,16,7,7,76,47,29,55
Copenhagen,4065,4,13,6,11,56,44,12,45
AaB,4065,5,7,12,11,36,44,-8,33
AC Horsens,4065,6,6,13,11,33,51,-18,31
Sonderjyske,4065,7,8,6,10,28,29,-1,30
Randers FC,4065,8,6,6,12,25,39,-14,24
Silkeborg IF,4065,9,6,3,13,30,45,-15,21
Lyngby,4065,10,3,9,12,26,46,-20,18
AGF Aarhus,4065,11,4,6,12,17,41,-24,18
Brondby,4066,1,21,5,4,68,32,36,68
FC Midtjylla,4066,2,19,5,6,63,42,21,62
FC Nords,4066,3,14,6,10,74,51,23,48
Copenhagen,4066,4,13,6,11,58,46,12,45
AaB,4066,5,9,11,10,43,43,0,38
AC Horsens,4066,6,7,13,10,34,52,-18,34
Sonderjyske,4066,7,8,6,10,28,29,-1,30
Lyngby,4066,8,4,9,11,27,44,-17,21
Randers FC,4066,9,5,6,13,23,40,-17,21
AGF Aarhus,4066,10,5,6,11,18,37,-19,21
Silkeborg IF,4066,11,5,3,14,26,46,-20,18
FC Midtjylla,4067,1,21,4,5,67,35,32,67
Brondby,4067,2,20,6,4,68,32,36,66
FC Nords,4067,3,14,8,8,71,54,17,50
Copenhagen,4067,4,15,4,11,61,44,17,49
AaB,4067,5,8,11,11,35,43,-8,35
Sonderjyske,4067,6,8,6,10,28,29,-1,30
AC Horsens,4067,7,5,13,12,32,52,-20,28
Randers FC,4067,8,6,6,12,26,40,-14,24
AGF Aarhus,4067,9,5,6,11,18,37,-19,21
Lyngby,4067,10,3,9,12,27,47,-20,18
Silkeborg IF,4067,11,5,3,14,26,46,-20,18
Brondby,4068,1,20,6,4,69,34,35,66
FC Midtjylla,4068,2,19,6,5,66,38,28,63
FC Nords,4068,3,14,9,7,76,52,24,51
Copenhagen,4068,4,12,9,9,58,45,13,45
AC Horsens,4068,5,7,13,10,40,55,-15,34
AaB,4068,6,6,13,11,34,45,-11,31
Sonderjyske,4068,7,8,6,10,28,29,-1,30
Silkeborg IF,4068,8,6,3,13,28,44,-16,21
Lyngby,4068,9,4,9,11,29,46,-17,21
Randers FC,4068,10,5,6,13,25,42,-17,21
AGF Aarhus,4068,11,4,6,12,16,39,-23,18
Brondby,4069,1,19,9,2,74,34,40,66
FC Midtjylla,4069,2,19,6,5,68,41,27,63
FC Nords,4069,3,15,6,9,75,60,15,51
Copenhagen,4069,4,12,8,10,56,44,12,44
AaB,4069,5,7,13,10,38,43,-5,34
AC Horsens,4069,6,6,14,10,38,53,-15,32
Sonderjyske,4069,7,8,6,10,28,29,-1,30
Randers FC,4069,8,6,6,12,25,39,-14,24
Silkeborg IF,4069,9,5,4,13,27,46,-19,19
AGF Aarhus,4069,10,4,7,11,18,38,-20,19
Lyngby,4069,11,3,9,12,26,46,-20,18
Brondby,4070,1,19,8,3,73,37,36,65
FC Midtjylla,4070,2,20,4,6,66,38,28,64
Copenhagen,4070,3,15,6,9,58,42,16,51
FC Nords,4070,4,12,8,10,74,59,15,44
AaB,4070,5,8,13,9,37,40,-3,37
AC Horsens,4070,6,6,13,11,33,51,-18,31
Sonderjyske,4070,7,8,6,10,28,29,-1,30
Lyngby,4070,8,4,9,11,27,44,-17,21
Randers FC,4070,9,5,6,13,23,40,-17,21
Silkeborg IF,4070,10,5,4,13,27,46,-19,19
AGF Aarhus,4070,11,4,7,11,18,38,-20,19
Brondby,4071,1,22,5,3,77,29,48,71
FC Midtjylla,4071,2,20,5,5,67,39,28,65
Copenhagen,4071,3,13,7,10,56,45,11,46
FC Nords,4071,4,12,9,9,73,57,16,45
AC Horsens,4071,5,7,13,10,35,52,-17,34
AaB,4071,6,6,13,11,36,48,-12,31
Sonderjyske,4071,7,8,6,10,28,29,-1,30
AGF Aarhus,4071,8,5,6,11,20,36,-16,21
Lyngby,4071,9,4,9,11,28,45,-17,21
Randers FC,4071,10,5,6,13,24,41,-17,21
Silkeborg IF,4071,11,5,3,14,25,48,-23,18
Brondby,4072,1,22,5,3,75,36,39,71
FC Midtjylla,4072,2,20,4,6,65,41,24,64
FC Nords,4072,3,14,6,10,74,53,21,48
Copenhagen,4072,4,13,5,12,53,44,9,44
AaB,4072,5,9,11,10,40,39,1,38
AC Horsens,4072,6,6,13,11,33,53,-20,31
Sonderjyske,4072,7,8,6,10,28,29,-1,30
Randers FC,4072,8,5,7,12,25,41,-16,22
Silkeborg IF,4072,9,6,3,13,29,46,-17,21
Lyngby,4072,10,3,10,11,28,46,-18,19
AGF Aarhus,4072,11,4,6,12,18,40,-22,18
Brondby,4073,1,20,7,3,66,29,37,67
FC Midtjylla,4073,2,19,6,5,68,42,26,63
Copenhagen,4073,3,15,4,11,57,43,14,49
FC Nords,4073,4,14,6,10,73,54,19,48
AC Horsens,4073,5,7,13,10,34,50,-16,34
AaB,4073,6,7,12,11,36,42,-6,33
Sonderjyske,4073,7,8,6,10,28,29,-1,30
Randers FC,4073,8,5,7,12,25,41,-16,22
Lyngby,4073,9,3,10,11,28,46,-18,19
Silkeborg IF,4073,10,5,4,13,25,44,-19,19
AGF Aarhus,4073,11,4,7,11,16,36,-20,19
Brondby,4074,1,20,7,3,70,33,37,67
FC Midtjylla,4074,2,19,6,5,63,38,25,63
FC Nords,4074,3,15,7,8,75,50,25,52
Copenhagen,4074,4,12,6,12,52,44,8,42
AaB,4074,5,8,12,10,39,42,-3,36
AC Horsens,4074,6,7,12,11,33,51,-18,33
Sonderjyske,4074,7,8,6,10,28,29,-1,30
Randers FC,4074,8,5,7,12,23,39,-16,22
Silkeborg IF,4074,9,6,3,13,27,45,-18,21
Lyngby,4074,10,3,10,11,26,44,-18,19
AGF Aarhus,4074,11,4,6,12,17,38,-21,18
Brondby,4075,1,20,7,3,69,32,37,67
FC Midtjylla,4075,2,21,4,5,67,39,28,67
FC Nords,4075,3,13,9,8,69,48,21,48
Copenhagen,4075,4,14,5,11,62,48,14,47
AaB,4075,5,7,13,10,35,40,-5,34
Sonderjyske,4075,6,8,6,10,28,29,-1,30
AC Horsens,4075,7,5,14,11,35,56,-21,29
Randers FC,4075,8,5,7,12,24,40,-16,22
Silkeborg IF,4075,9,6,3,13,26,44,-18,21
Lyngby,4075,10,3,10,11,27,45,-18,19
AGF Aarhus,4075,11,4,6,12,16,37,-21,18
Brondby,4076,1,21,5,4,76,36,40,68
FC Midtjylla,4076,2,21,4,5,69,42,27,67
FC Nords,4076,3,15,7,8,77,52,25,52
Copenhagen,4076,4,13,6,11,58,45,13,45
AaB,4076,5,7,12,11,37,44,-7,33
Sonderjyske,4076,6,8,6,10,28,29,-1,30
AC Horsens,4076,7,6,12,12,32,56,-24,30
Randers FC,4076,8,5,7,12,24,40,-16,22
Silkeborg IF,4076,9,6,3,13,26,44,-18,21
Lyngby,4076,10,3,10,11,27,45,-18,19
AGF Aarhus,4076,11,4,6,12,16,37,-21,18
FC Midtjylla,4077,1,20,6,4,72,39,33,66
Brondby,4077,2,18,7,5,68,36,32,61
FC Nords,4077,3,14,9,7,74,51,23,51
Copenhagen,4077,4,14,7,9,61,46,15,49
AC Horsens,4077,5,6,14,10,36,55,-19,32
AaB,4077,6,6,13,11,34,44,-10,31
Sonderjyske,4077,7,8,6,10,28,29,-1,30
Randers FC,4077,8,6,6,12,24,39,-15,24
Silkeborg IF,4077,9,6,3,13,28,44,-16,21
Lyngby,4077,10,3,9,12,26,45,-19,18
AGF Aarhus,4077,11,4,6,12,16,39,-23,18
Brondby,4078,1,20,6,4,70,33,37,66
FC Midtjylla,4078,2,20,4,6,67,39,28,64
FC Nords,4078,3,16,6,8,78,49,29,54
Copenhagen,4078,4,12,6,12,52,47,5,42
AaB,4078,5,9,11,10,37,41,-4,38
AC Horsens,4078,6,6,13,11,33,54,-21,31
Sonderjyske,4078,7,8,6,10,28,29,-1,30
Lyngby,4078,8,4,9,11,29,44,-15,21
Silkeborg IF,4078,9,6,3,13,27,45,-18,21
Randers FC,4078,10,5,6,13,23,42,-19,21
AGF Aarhus,4078,11,4,6,12,17,38,-21,18
Brondby,4079,1,20,5,5,70,36,34,65
FC Midtjylla,4079,2,20,5,5,65,38,27,65
Copenhagen,4079,3,15,5,10,63,42,21,50
FC Nords,4079,4,14,7,9,71,56,15,49
AC Horsens,4079,5,7,13,10,39,53,-14,34
AaB,4079,6,7,11,12,38,47,-9,32
Sonderjyske,4079,7,8,6,10,28,29,-1,30
Randers FC,4079,8,5,7,12,25,41,-16,22
Silkeborg IF,4079,9,6,3,13,28,45,-17,21
Lyngby,4079,10,3,10,11,28,46,-18,19
AGF Aarhus,4079,11,4,6,12,17,39,-22,18
Brondby,4080,1,22,5,3,77,34,43,71
FC Midtjylla,4080,2,20,4,6,66,40,26,64
FC Nords,4080,3,15,6,9,74,54,20,51
Copenhagen,4080,4,15,5,10,61,45,16,50
Sonderjyske,4080,5,8,6,10,28,29,-1,30
AaB,4080,6,6,12,12,37,48,-11,30
AC Horsens,4080,7,6,12,12,35,55,-20,30
Randers FC,4080,8,6,6,12,26,41,-15,24
AGF Aarhus,4080,9,5,6,11,17,36,-19,21
Lyngby,4080,10,3,9,12,28,47,-19,18
Silkeborg IF,4080,11,5,3,14,25,45,-20,18
Brondby,4081,1,22,5,3,72,29,43,71
FC Midtjylla,4081,2,21,4,5,63,34,29,67
Copenhagen,4081,3,14,5,11,54,41,13,47
FC Nords,4081,4,13,7,10,69,51,18,46
AaB,4081,5,7,12,11,35,44,-9,33
AC Horsens,4081,6,6,13,11,33,53,-20,31
Sonderjyske,4081,7,8,6,10,28,29,-1,30
Randers FC,4081,8,5,7,12,24,40,-16,22
AGF Aarhus,4081,9,5,6,11,19,37,-18,21
Lyngby,4081,10,3,10,11,27,45,-18,19
Silkeborg IF,4081,11,5,3,14,26,47,-21,18
FC Midtjylla,4082,1,21,4,5,69,38,31,67
Brondby,4082,2,19,5,6,69,38,31,62
FC Nords,4082,3,15,7,8,74,53,21,52
Copenhagen,4082,4,15,4,11,61,45,16,49
AaB,4082,5,7,13,10,38,44,-6,34
AC Horsens,4082,6,6,13,11,39,58,-19,31
Sonderjyske,4082,7,8,6,10,28,29,-1,30
Lyngby,4082,8,4,9,11,28,44,-16,21
Silkeborg IF,4082,9,6,3,13,27,44,-17,21
Randers FC,4082,10,5,6,13,23,41,-18,21
AGF Aarhus,4082,11,4,6,12,16,38,-22,18
Brondby,4083,1,22,5,3,75,31,44,71
FC Midtjylla,4083,2,18,6,6,58,37,21,60
FC Nords,4083,3,14,8,8,73,48,25,50
Copenhagen,4083,4,14,5,11,55,42,13,47
AaB,4083,5,7,12,11,36,46,-10,33
AC Horsens,4083,6,7,12,11,34,53,-19,33
Sonderjyske,4083,7,8,6,10,28,29,-1,30
Randers FC,4083,8,5,7,12,25,41,-16,22
Lyngby,4083,9,3,10,11,28,46,-18,19
Silkeborg IF,4083,10,5,4,13,26,45,-19,19
AGF Aarhus,4083,11,4,7,11,17,37,-20,19
Brondby,4084,1,21,6,3,69,30,39,69
FC Midtjylla,4084,2,19,6,5,65,36,29,63
FC Nords,4084,3,16,7,7,74,47,27,55
Copenhagen,4084,4,12,6,12,53,46,7,42
AaB,4084,5,7,12,11,37,45,-8,33
AC Horsens,4084,6,6,13,11,33,53,-20,31
Sonderjyske,4084,7,8,6,10,28,29,-1,30
Randers FC,4084,8,5,7,12,24,40,-16,22
AGF Aarhus,4084,9,5,6,11,18,37,-19,21
Lyngby,4084,10,3,10,11,27,45,-18,19
Silkeborg IF,4084,11,5,3,14,26,46,-20,18
Brondby,4085,1,20,5,5,65,31,34,65
FC Midtjylla,4085,2,20,5,5,71,38,33,65
FC Nords,4085,3,15,6,9,77,49,28,51
Copenhagen,4085,4,15,5,10,57,43,14,50
AaB,4085,5,8,11,11,37,45,-8,35
Sonderjyske,4085,6,8,6,10,28,29,-1,30
AC Horsens,4085,7,6,12,12,33,60,-27,30
Randers FC,4085,8,5,7,12,25,41,-16,22
AGF Aarhus,4085,9,5,6,11,17,36,-19,21
Lyngby,4085,10,3,10,11,28,46,-18,19
Silkeborg IF,4085,11,5,3,14,25,45,-20,18
Brondby,4086,1,21,5,4,79,35,44,68
FC Midtjylla,4086,2,21,4,5,64,37,27,67
FC Nords,4086,3,15,6,9,76,55,21,51
Copenhagen,4086,4,13,5,12,59,47,12,44
AaB,4086,5,7,12,11,34,47,-13,33
AC Horsens,4086,6,6,14,10,36,53,-17,32
Sonderjyske,4086,7,8,6,10,28,29,-1,30
Randers FC,4086,8,5,7,12,23,39,-16,22
Silkeborg IF,4086,9,6,3,13,28,45,-17,21
Lyngby,4086,10,3,10,11,26,44,-18,19
AGF Aarhus,4086,11,4,6,12,17,39,-22,18
Brondby,4087,1,22,6,2,70,31,39,72
FC Midtjylla,4087,2,17,7,6,63,41,22,58
FC Nords,4087,3,14,8,8,77,55,22,50
Copenhagen,4087,4,14,5,11,61,45,16,47
AaB,4087,5,7,13,10,35,42,-7,34
Sonderjyske,4087,6,8,6,10,28,29,-1,30
AC Horsens,4087,7,5,15,10,35,53,-18,30
Lyngby,4087,8,4,9,11,27,44,-17,21
Randers FC,4087,9,5,6,13,23,40,-17,21
Silkeborg IF,4087,10,6,3,13,26,44,-18,21
AGF Aarhus,4087,11,4,6,12,16,37,-21,18
FC Midtjylla,4088,1,21,4,5,68,40,28,67
Brondby,4088,2,20,6,4,70,36,34,66
FC Nords,4088,3,14,7,9,73,51,22,49
Copenhagen,4088,4,14,5,11,59,46,13,47
AaB,4088,5,7,12,11,38,44,-6,33
AC Horsens,4088,6,7,12,11,35,52,-17,33
Sonderjyske,4088,7,8,6,10,28,29,-1,30
Lyngby,4088,8,4,9,11,27,44,-17,21
Silkeborg IF,4088,8,6,3,13,27,44,-17,21
Randers FC,4088,10,5,6,13,23,40,-17,21
AGF Aarhus,4088,11,4,6,12,16,38,-22,18
Brondby,4089,1,21,5,4,73,35,38,68
FC Midtjylla,4089,2,18,6,6,64,43,21,60
FC Nords,4089,3,15,7,8,76,50,26,52
Copenhagen,4089,4,14,4,12,57,46,11,46
AaB,4089,5,8,12,10,38,40,-2,36
AC Horsens,4089,6,7,12,11,36,56,-20,33
Sonderjyske,4089,7,8,6,10,28,29,-1,30
Lyngby,4089,8,4,9,11,27,44,-17,21
Randers FC,4089,9,5,6,13,23,40,-17,21
Silkeborg IF,4089,10,6,3,13,29,47,-18,21
AGF Aarhus,4089,11,4,6,12,19,40,-21,18
FC Midtjylla,4090,1,21,4,5,69,40,29,67
Brondby,4090,2,20,5,5,66,34,32,65
Copenhagen,4090,3,16,4,10,62,42,20,52
FC Nords,4090,4,13,6,11,70,51,19,45
AaB,4090,5,8,12,10,38,43,-5,36
AC Horsens,4090,6,6,13,11,33,54,-21,31
Sonderjyske,4090,7,8,6,10,28,29,-1,30
Randers FC,4090,8,5,7,12,24,40,-16,22
Silkeborg IF,4090,9,6,3,13,26,44,-18,21
Lyngby,4090,10,3,10,11,27,45,-18,19
AGF Aarhus,4090,11,4,6,12,16,37,-21,18
Brondby,4091,1,23,5,2,74,32,42,74
FC Midtjylla,4091,2,18,4,8,63,43,20,58
FC Nords,4091,3,16,6,8,78,52,26,54
Copenhagen,4091,4,14,4,12,65,50,15,46
AC Horsens,4091,5,7,12,11,34,54,-20,33
AaB,4091,6,7,11,12,36,45,-9,32
Sonderjyske,4091,7,8,6,10,28,29,-1,30
Randers FC,4091,8,5,7,12,24,40,-16,22
Lyngby,4091,9,3,10,11,27,45,-18,19
Silkeborg IF,4091,10,5,4,13,25,44,-19,19
AGF Aarhus,4091,11,4,7,11,16,36,-20,19
Brondby,4092,1,20,8,2,71,32,39,68
FC Midtjylla,4092,2,19,4,7,59,39,20,61
FC Nords,4092,3,15,6,9,79,52,27,51
Copenhagen,4092,4,14,5,11,56,45,11,47
AaB,4092,5,8,13,9,36,40,-4,37
Sonderjyske,4092,6,8,6,10,28,29,-1,30
AC Horsens,4092,7,5,14,11,34,53,-19,29
Lyngby,4092,8,4,9,11,29,44,-15,21
Silkeborg IF,4092,9,6,3,13,27,45,-18,21
Randers FC,4092,10,5,6,13,23,42,-19,21
AGF Aarhus,4092,11,4,6,12,17,38,-21,18
Brondby,4093,1,21,7,2,75,34,41,70
FC Midtjylla,4093,2,19,7,4,65,34,31,64
FC Nords,4093,3,14,7,9,75,56,19,49
Copenhagen,4093,4,13,6,11,58,46,12,45
AaB,4093,5,7,12,11,37,47,-10,33
AC Horsens,4093,6,6,13,11,40,59,-19,31
Sonderjyske,4093,7,8,6,10,28,29,-1,30
Lyngby,4093,8,4,9,11,28,44,-16,21
Randers FC,4093,9,5,6,13,23,41,-18,21
AGF Aarhus,4093,10,5,6,11,18,37,-19,21
Silkeborg IF,4093,11,5,3,14,26,46,-20,18
Brondby,4094,1,20,6,4,67,31,36,66
FC Midtjylla,4094,2,19,6,5,66,39,27,63
FC Nords,4094,3,16,7,7,77,48,29,55
Copenhagen,4094,4,13,6,11,52,42,10,45
AC Horsens,4094,5,7,13,10,32,51,-19,34
Sonderjyske,4094,6,8,6,10,28,29,-1,30
AaB,4094,7,6,12,12,31,40,-9,30
Randers FC,4094,8,5,7,12,25,41,-16,22
Lyngby,4094,9,3,10,11,28,46,-18,19
Silkeborg IF,4094,10,5,4,13,26,45,-19,19
AGF Aarhus,4094,11,4,7,11,17,37,-20,19
Brondby,4095,1,21,6,3,68,32,36,69
FC Midtjylla,4095,2,18,5,7,65,43,22,59
FC Nords,4095,3,13,7,10,72,53,19,46
Copenhagen,4095,4,14,4,12,55,45,10,46
AC Horsens,4095,5,8,14,8,41,50,-9,38
AaB,4095,6,8,12,10,36,40,-4,36
Sonderjyske,4095,7,8,6,10,28,29,-1,30
Lyngby,4095,8,4,9,11,27,44,-17,21
Silkeborg IF,4095,8,6,3,13,27,44,-17,21
Randers FC,4095,10,5,6,13,23,40,-17,21
AGF Aarhus,4095,11,4,6,12,16,38,-22,18
Brondby,4096,1,20,6,4,72,34,38,66
FC Midtjylla,4096,2,20,4,6,64,36,28,64
FC Nords,4096,3,16,6,8,72,50,22,54
Copenhagen,4096,4,14,4,12,54,43,11,46
AaB,4096,5,7,12,11,35,43,-8,33
AC Horsens,4096,6,7,12,11,35,52,-17,33
Sonderjyske,4096,7,8,6,10,28,29,-1,30
Silkeborg IF,4096,8,6,3,13,29,45,-16,21
Lyngby,4096,9,4,9,11,28,45,-17,21
Randers FC,4096,10,5,6,13,24,41,-17,21
AGF Aarhus,4096,11,4,6,12,17,40,-23,18
FC Midtjylla,4097,1,20,6,4,68,40,28,66
Brondby,4097,2,19,6,5,67,35,32,63
FC Nords,4097,3,13,8,9,70,50,20,47
Copenhagen,4097,4,12,8,10,53,42,11,44
AC Horsens,4097,5,7,15,8,38,49,-11,36
AaB,4097,6,7,13,10,36,42,-6,34
Sonderjyske,4097,7,8,6,10,28,29,-1,30
Randers FC,4097,8,6,6,12,25,40,-15,24
AGF Aarhus,4097,9,5,6,11,18,36,-18,21
Lyngby,4097,10,3,9,12,27,46,-19,18
Silkeborg IF,4097,11,5,3,14,25,46,-21,18
FC Midtjylla,4098,1,21,4,5,64,37,27,67
Brondby,4098,2,20,6,4,72,34,38,66
FC Nords,4098,3,14,7,9,73,51,22,49
Copenhagen,4098,4,14,4,12,58,45,13,46
AaB,4098,5,8,11,11,38,47,-9,35
AC Horsens,4098,6,7,12,11,34,51,-17,33
Sonderjyske,4098,7,8,6,10,28,29,-1,30
Randers FC,4098,8,6,6,12,25,40,-15,24
Silkeborg IF,4098,9,6,3,13,26,44,-18,21
Lyngby,4098,10,3,9,12,27,46,-19,18
AGF Aarhus,4098,11,4,6,12,16,37,-21,18
Brondby,4099,1,19,8,3,69,35,34,65
FC Midtjylla,4099,2,19,5,6,67,42,25,62
FC Nords,4099,3,16,6,8,78,48,30,54
Copenhagen,4099,4,14,5,11,60,46,14,47
AaB,4099,5,7,12,11,36,48,-12,33
AC Horsens,4099,6,7,12,11,38,55,-17,33
Sonderjyske,4099,7,8,6,10,28,29,-1,30
Lyngby,4099,8,4,9,11,28,44,-16,21
Silkeborg IF,4099,8,6,3,13,28,44,-16,21
Randers FC,4099,10,5,6,13,23,41,-18,21
AGF Aarhus,4099,11,4,6,12,16,39,-23,18
Brondby,4100,1,21,6,3,71,32,39,69
FC Midtjylla,4100,2,21,4,5,65,36,29,67
FC Nords,4100,3,15,6,9,75,51,24,51
Copenhagen,4100,4,13,4,13,55,48,7,43
AaB,4100,5,8,12,10,39,44,-5,36
Sonderjyske,4100,6,8,6,10,28,29,-1,30
AC Horsens,4100,7,6,12,12,38,58,-20,30
Randers FC,4100,8,6,6,12,26,40,-14,24
AGF Aarhus,4100,9,5,6,11,19,37,-18,21
Lyngby,4100,10,3,9,12,27,47,-20,18
Silkeborg IF,4100,11,5,3,14,26,47,-21,18
Brondby,4101,1,20,7,3,68,32,36,67
FC Midtjylla,4101,2,20,4,6,63,38,25,64
FC Nords,4101,3,15,7,8,74,49,25,52
Copenhagen,4101,4,13,5,12,54,46,8,44
AC Horsens,4101,5,8,13,9,37,48,-11,37
Sonderjyske,4101,6,8,6,10,28,29,-1,30
AaB,4101,7,6,12,12,33,42,-9,30
Lyngby,4101,8,4,9,11,28,44,-16,21
Silkeborg IF,4101,9,6,3,13,27,45,-18,21
Randers FC,4101,10,5,6,13,23,41,-18,21
AGF Aarhus,4101,11,4,6,12,17,38,-21,18
Brondby,4102,1,22,5,3,77,30,47,71
FC Midtjylla,4102,2,19,4,7,64,48,16,61
Copenhagen,4102,3,16,4,10,57,40,17,52
FC Nords,4102,4,15,6,9,75,49,26,51
AaB,4102,5,7,12,11,34,45,-11,33
Sonderjyske,4102,6,8,6,10,28,29,-1,30
AC Horsens,4102,7,5,13,12,34,55,-21,28
Lyngby,4102,8,4,9,11,30,45,-15,21
Randers FC,4102,9,5,6,13,24,43,-19,21
Silkeborg IF,4102,10,5,4,13,26,45,-19,19
AGF Aarhus,4102,11,4,7,11,17,37,-20,19
Brondby,4103,1,18,9,3,69,35,34,63
FC Midtjylla,4103,2,19,6,5,70,43,27,63
FC Nords,4103,3,15,7,8,77,53,24,52
Copenhagen,4103,4,15,4,11,59,46,13,49
AaB,4103,5,7,14,9,40,45,-5,35
Sonderjyske,4103,6,8,6,10,28,29,-1,30
AC Horsens,4103,7,5,14,11,40,59,-19,29
Randers FC,4103,8,5,7,12,23,39,-16,22
Silkeborg IF,4103,9,6,3,13,27,45,-18,21
Lyngby,4103,10,3,10,11,26,44,-18,19
AGF Aarhus,4103,11,4,6,12,17,38,-21,18
Brondby,4104,1,21,6,3,70,32,38,69
FC Midtjylla,4104,2,19,6,5,64,36,28,63
FC Nords,4104,3,14,8,8,75,52,23,50
Copenhagen,4104,4,13,6,11,59,46,13,45
AaB,4104,5,7,15,8,38,41,-3,36
Sonderjyske,4104,6,8,6,10,28,29,-1,30
AC Horsens,4104,7,5,13,12,32,57,-25,28
Randers FC,4104,8,6,6,12,27,39,-12,24
Silkeborg IF,4104,9,5,4,13,26,45,-19,19
AGF Aarhus,4104,10,4,7,11,17,37,-20,19
Lyngby,4104,11,3,9,12,26,48,-22,18
Brondby,4105,1,22,5,3,71,31,40,71
FC Midtjylla,4105,2,18,4,8,64,44,20,58
FC Nords,4105,3,15,7,8,77,50,27,52
Copenhagen,4105,4,16,4,10,61,42,19,52
AC Horsens,4105,5,7,12,11,35,56,-21,33
Sonderjyske,4105,6,8,6,10,28,29,-1,30
AaB,4105,7,6,12,12,34,45,-11,30
Lyngby,4105,8,4,9,11,29,45,-16,21
Randers FC,4105,9,5,6,13,24,42,-18,21
Silkeborg IF,4105,10,5,4,13,26,45,-19,19
AGF Aarhus,4105,11,4,7,11,17,37,-20,19
Brondby,4106,1,21,6,3,72,34,38,69
FC Midtjylla,4106,2,20,4,6,74,43,31,64
FC Nords,4106,3,14,7,9,77,54,23,49
Copenhagen,4106,4,14,4,12,56,48,8,46
AaB,4106,5,8,13,9,42,46,-4,37
Sonderjyske,4106,6,8,6,10,28,29,-1,30
AC Horsens,4106,7,6,12,12,35,57,-22,30
Lyngby,4106,8,4,9,11,30,46,-16,21
Silkeborg IF,4106,9,6,3,13,27,44,-17,21
Randers FC,4106,10,5,6,13,25,43,-18,21
AGF Aarhus,4106,11,4,6,12,16,38,-22,18
Brondby,4107,1,22,6,2,73,32,41,72
FC Midtjylla,4107,2,21,4,5,66,38,28,67
FC Nords,4107,3,13,7,10,73,52,21,46
Copenhagen,4107,4,13,6,11,55,46,9,45
AaB,4107,5,8,11,11,34,39,-5,35
Sonderjyske,4107,6,8,6,10,28,29,-1,30
AC Horsens,4107,7,6,12,12,33,53,-20,30
Randers FC,4107,8,5,7,12,25,41,-16,22
Lyngby,4107,9,3,10,11,28,46,-18,19
Silkeborg IF,4107,10,5,4,13,26,45,-19,19
AGF Aarhus,4107,11,4,7,11,17,37,-20,19
Brondby,4108,1,21,7,2,71,30,41,70
FC Midtjylla,4108,2,20,4,6,69,40,29,64
FC Nords,4108,3,15,6,9,75,51,24,51
Copenhagen,4108,4,13,6,11,57,45,12,45
AaB,4108,5,7,11,12,35,47,-12,32
AC Horsens,4108,6,6,14,10,32,52,-20,32
Sonderjyske,4108,7,8,6,10,28,29,-1,30
Lyngby,4108,8,4,9,11,29,45,-16,21
Randers FC,4108,9,5,6,13,24,42,-18,21
AGF Aarhus,4108,10,5,6,11,17,36,-19,21
Silkeborg IF,4108,11,5,3,14,25,45,-20,18
Brondby,4109,1,21,7,2,70,30,40,70
FC Midtjylla,4109,2,21,5,4,65,36,29,68
FC Nords,4109,3,14,7,9,76,53,23,49
Copenhagen,4109,4,12,5,13,55,50,5,41
AaB,4109,5,8,11,11,40,45,-5,35
AC Horsens,4109,6,6,13,11,35,53,-18,31
Sonderjyske,4109,7,8,6,10,28,29,-1,30
Lyngby,4109,8,4,9,11,28,45,-17,21
Randers FC,4109,9,5,6,13,24,41,-17,21
AGF Aarhus,4109,10,5,6,11,17,36,-19,21
Silkeborg IF,4109,11,5,3,14,25,45,-20,18
Brondby,4110,1,22,5,3,75,32,43,71
FC Midtjylla,4110,2,18,4,8,61,42,19,58
Copenhagen,4110,3,16,5,9,63,44,19,53
FC Nords,4110,4,14,8,8,74,53,21,50
AaB,4110,5,8,12,10,38,44,-6,36
Sonderjyske,4110,6,8,6,10,28,29,-1,30
AC Horsens,4110,7,5,12,13,32,54,-22,27
Lyngby,4110,8,4,9,11,30,45,-15,21
Silkeborg IF,4110,9,6,3,13,29,44,-15,21
Randers FC,4110,10,5,6,13,24,43,-19,21
AGF Aarhus,4110,11,4,6,12,16,40,-24,18
Brondby,4111,1,21,6,3,73,35,38,69
FC Midtjylla,4111,2,18,7,5,64,38,26,61
FC Nords,4111,3,15,7,8,72,49,23,52
Copenhagen,4111,4,14,7,9,60,43,17,49
AaB,4111,5,7,12,11,36,43,-7,33
Sonderjyske,4111,6,8,6,10,28,29,-1,30
AC Horsens,4111,7,5,13,12,33,56,-23,28
Randers FC,4111,8,6,6,12,24,39,-15,24
Silkeborg IF,4111,9,5,4,13,26,45,-19,19
AGF Aarhus,4111,10,4,7,11,17,37,-20,19
Lyngby,4111,11,3,9,12,26,45,-19,18
Brondby,4112,1,21,6,3,69,32,37,69
FC Midtjylla,4112,2,21,5,4,66,35,31,68
FC Nords,4112,3,14,7,9,76,49,27,49
Copenhagen,4112,4,12,6,12,54,49,5,42
AaB,4112,5,8,12,10,39,44,-5,36
Sonderjyske,4112,6,8,6,10,28,29,-1,30
AC Horsens,4112,7,5,14,11,33,54,-21,29
Randers FC,4112,8,5,7,12,26,42,-16,22
Silkeborg IF,4112,9,6,3,13,27,45,-18,21
Lyngby,4112,10,3,10,11,29,47,-18,19
AGF Aarhus,4112,11,4,6,12,17,38,-21,18
FC Midtjylla,4113,1,21,5,4,69,36,33,68
Brondby,4113,2,20,7,3,78,34,44,67
Copenhagen,4113,3,14,6,10,59,45,14,48
FC Nords,4113,4,13,7,10,71,56,15,46
AaB,4113,5,7,13,10,38,47,-9,34
Sonderjyske,4113,6,8,6,10,28,29,-1,30
AC Horsens,4113,7,5,14,11,33,56,-23,29
Randers FC,4113,8,6,6,12,25,40,-15,24
Silkeborg IF,4113,9,6,3,13,28,46,-18,21
Lyngby,4113,10,3,9,12,27,46,-19,18
AGF Aarhus,4113,11,4,6,12,18,39,-21,18
Brondby,4114,1,21,5,4,69,30,39,68
FC Midtjylla,4114,2,19,4,7,61,41,20,61
FC Nords,4114,3,15,6,9,71,49,22,51
Copenhagen,4114,4,15,4,11,64,45,19,49
AC Horsens,4114,5,8,12,10,34,48,-14,36
AaB,4114,6,7,11,12,33,45,-12,32
Sonderjyske,4114,7,8,6,10,28,29,-1,30
Randers FC,4114,8,6,6,12,26,40,-14,24
Silkeborg IF,4114,9,6,3,13,30,45,-15,21
Lyngby,4114,10,3,9,12,27,47,-20,18
AGF Aarhus,4114,11,4,6,12,17,41,-24,18
Brondby,4115,1,21,6,3,75,35,40,69
FC Midtjylla,4115,2,20,4,6,67,40,27,64
FC Nords,4115,3,13,8,9,72,57,15,47
Copenhagen,4115,4,14,5,11,56,42,14,47
AC Horsens,4115,5,8,12,10,40,54,-14,36
AaB,4115,6,6,13,11,39,47,-8,31
Sonderjyske,4115,7,8,6,10,28,29,-1,30
Lyngby,4115,8,4,9,11,29,45,-16,21
Randers FC,4115,9,5,6,13,24,42,-18,21
AGF Aarhus,4115,10,5,6,11,18,36,-18,21
Silkeborg IF,4115,11,5,3,14,25,46,-21,18
Brondby,4116,1,20,7,3,72,32,40,67
FC Midtjylla,4116,2,18,6,6,68,44,24,60
FC Nords,4116,3,15,7,8,76,48,28,52
Copenhagen,4116,4,14,6,10,57,42,15,48
AaB,4116,5,7,13,10,36,42,-6,34
AC Horsens,4116,6,6,13,11,35,62,-27,31
Sonderjyske,4116,7,8,6,10,28,29,-1,30
Lyngby,4116,8,4,9,11,27,44,-17,21
Randers FC,4116,9,5,6,13,23,40,-17,21
Silkeborg IF,4116,10,5,4,13,25,44,-19,19
AGF Aarhus,4116,11,4,7,11,16,36,-20,19
FC Midtjylla,4117,1,21,5,4,66,33,33,68
Brondby,4117,2,19,7,4,68,35,33,64
FC Nords,4117,3,14,8,8,73,52,21,50
Copenhagen,4117,4,13,5,12,56,45,11,44
AaB,4117,5,7,12,11,33,42,-9,33
AC Horsens,4117,6,6,15,9,34,49,-15,33
Sonderjyske,4117,7,8,6,10,28,29,-1,30
Lyngby,4117,8,4,9,11,27,44,-17,21
Silkeborg IF,4117,8,6,3,13,27,44,-17,21
Randers FC,4117,10,5,6,13,23,40,-17,21
AGF Aarhus,4117,11,4,6,12,16,38,-22,18
Brondby,4118,1,22,6,2,79,30,49,72
FC Midtjylla,4118,2,20,4,6,62,41,21,64
Copenhagen,4118,3,15,4,11,58,47,11,49
FC Nords,4118,4,14,6,10,73,54,19,48
AC Horsens,4118,5,7,13,10,38,53,-15,34
Sonderjyske,4118,6,8,6,10,28,29,-1,30
AaB,4118,7,6,11,13,36,47,-11,29
Lyngby,4118,8,4,9,11,28,44,-16,21
Randers FC,4118,9,5,6,13,23,41,-18,21
AGF Aarhus,4118,10,5,6,11,20,39,-19,21
Silkeborg IF,4118,11,5,3,14,28,48,-20,18
Brondby,4119,1,20,6,4,69,34,35,66
FC Midtjylla,4119,2,19,5,6,66,41,25,62
FC Nords,4119,3,13,7,10,71,56,15,46
Copenhagen,4119,4,13,7,10,61,48,13,46
AaB,4119,5,11,11,8,45,41,4,44
Sonderjyske,4119,6,8,6,10,28,29,-1,30
AC Horsens,4119,7,5,14,11,33,51,-18,29
Randers FC,4119,8,5,7,12,24,40,-16,22
Silkeborg IF,4119,9,6,3,13,27,45,-18,21
Lyngby,4119,10,3,10,11,27,45,-18,19
AGF Aarhus,4119,11,4,6,12,17,38,-21,18
Brondby,4120,1,20,5,5,68,34,34,65
FC Midtjylla,4120,2,19,4,7,66,41,25,61
Copenhagen,4120,3,16,4,10,62,41,21,52
FC Nords,4120,4,14,6,10,73,55,18,48
AaB,4120,5,9,11,10,38,43,-5,38
AC Horsens,4120,6,7,12,11,36,55,-19,33
Sonderjyske,4120,7,8,6,10,28,29,-1,30
Randers FC,4120,8,6,6,12,25,39,-14,24
Silkeborg IF,4120,9,6,3,13,27,44,-17,21
Lyngby,4120,10,3,9,12,26,46,-20,18
AGF Aarhus,4120,11,4,6,12,16,38,-22,18
Brondby,4121,1,20,7,3,70,34,36,67
FC Midtjylla,4121,2,20,5,5,67,35,32,65
FC Nords,4121,3,13,8,9,73,55,18,47
Copenhagen,4121,4,14,5,11,57,48,9,47
AaB,4121,5,7,13,10,38,46,-8,34
AC Horsens,4121,6,7,12,11,39,52,-13,33
Sonderjyske,4121,7,8,6,10,28,29,-1,30
Randers FC,4121,8,6,6,12,26,41,-15,24
Silkeborg IF,4121,9,6,3,13,27,44,-17,21
Lyngby,4121,10,3,9,12,28,47,-19,18
AGF Aarhus,4121,11,4,6,12,16,38,-22,18
Brondby,4122,1,21,6,3,72,32,40,69
FC Midtjylla,4122,2,19,4,7,66,40,26,61
FC Nords,4122,3,15,7,8,77,49,28,52
Copenhagen,4122,4,13,5,12,55,46,9,44
AaB,4122,5,8,12,10,37,47,-10,36
AC Horsens,4122,6,7,12,11,35,54,-19,33
Sonderjyske,4122,7,8,6,10,28,29,-1,30
Randers FC,4122,8,5,7,12,24,40,-16,22
AGF Aarhus,4122,9,5,6,11,21,38,-17,21
Lyngby,4122,10,3,10,11,27,45,-18,19
Silkeborg IF,4122,11,5,3,14,27,49,-22,18
Brondby,4123,1,20,7,3,66,30,36,67
FC Midtjylla,4123,2,19,6,5,66,42,24,63
FC Nords,4123,3,15,7,8,73,48,25,52
Copenhagen,4123,4,14,6,10,57,44,13,48
AC Horsens,4123,5,7,12,11,38,49,-11,33
Sonderjyske,4123,6,8,6,10,28,29,-1,30
AaB,4123,7,6,12,12,36,49,-13,30
Randers FC,4123,8,6,6,12,24,39,-15,24
Silkeborg IF,4123,9,5,4,13,25,44,-19,19
AGF Aarhus,4123,10,4,7,11,16,36,-20,19
Lyngby,4123,11,3,9,12,26,45,-19,18
Brondby,4124,1,21,6,3,71,34,37,69
FC Midtjylla,4124,2,18,6,6,68,45,23,60
FC Nords,4124,3,15,7,8,76,47,29,52
Copenhagen,4124,4,14,6,10,60,47,13,48
AaB,4124,5,7,15,8,35,38,-3,36
Sonderjyske,4124,6,8,6,10,28,29,-1,30
AC Horsens,4124,7,5,12,13,33,58,-25,27
Lyngby,4124,8,4,9,11,31,45,-14,21
Randers FC,4124,9,5,6,13,24,44,-20,21
Silkeborg IF,4124,10,5,4,13,25,44,-19,19
AGF Aarhus,4124,11,4,7,11,16,36,-20,19
Brondby,4125,1,21,6,3,69,31,38,69
FC Midtjylla,4125,2,20,5,5,68,38,30,65
FC Nords,4125,3,14,8,8,74,51,23,50
Copenhagen,4125,4,12,5,13,55,49,6,41
AC Horsens,4125,5,8,13,9,39,50,-11,37
AaB,4125,6,7,11,12,34,46,-12,32
Sonderjyske,4125,7,8,6,10,28,29,-1,30
Randers FC,4125,8,5,7,12,25,41,-16,22
AGF Aarhus,4125,9,5,6,11,18,37,-19,21
Lyngby,4125,10,3,10,11,28,46,-18,19
Silkeborg IF,4125,11,5,3,14,26,46,-20,18
Brondby,4126,1,22,5,3,74,32,42,71
FC Midtjylla,4126,2,20,5,5,71,40,31,65
Copenhagen,4126,3,15,5,10,61,44,17,50
FC Nords,4126,4,13,9,8,73,53,20,48
Sonderjyske,4126,5,8,6,10,28,29,-1,30
AaB,4126,6,6,12,12,34,46,-12,30
AC Horsens,4126,7,6,12,12,34,58,-24,30
Randers FC,4126,8,6,6,12,25,40,-15,24
Silkeborg IF,4126,9,6,3,13,26,44,-18,21
Lyngby,4126,10,3,9,12,27,46,-19,18
AGF Aarhus,4126,11,4,6,12,16,37,-21,18
Brondby,4127,1,21,5,4,67,30,37,68
FC Midtjylla,4127,2,18,6,6,63,39,24,60
FC Nords,4127,3,16,6,8,81,50,31,54
Copenhagen,4127,4,14,6,10,57,41,16,48
AC Horsens,4127,5,7,12,11,34,56,-22,33
AaB,4127,6,6,13,11,32,44,-12,31
Sonderjyske,4127,7,8,6,10,28,29,-1,30
Randers FC,4127,8,6,6,12,24,39,-15,24
Silkeborg IF,4127,9,6,3,13,27,44,-17,21
Lyngby,4127,10,3,9,12,26,45,-19,18
AGF Aarhus,4127,11,4,6,12,16,38,-22,18
Brondby,4128,1,22,5,3,72,29,43,71
FC Midtjylla,4128,2,19,5,6,62,36,26,62
Copenhagen,4128,3,14,5,11,56,43,13,47
FC Nords,4128,4,13,7,10,70,54,16,46
AaB,4128,5,9,11,10,36,41,-5,38
AC Horsens,4128,6,6,13,11,34,53,-19,31
Sonderjyske,4128,7,8,6,10,28,29,-1,30
Randers FC,4128,8,5,7,12,25,41,-16,22
Silkeborg IF,4128,9,6,3,13,27,45,-18,21
Lyngby,4128,10,3,10,11,28,46,-18,19
AGF Aarhus,4128,11,4,6,12,17,38,-21,18
Brondby,4129,1,22,6,2,75,31,44,72
FC Midtjylla,4129,2,19,5,6,65,44,21,62
FC Nords,4129,3,15,6,9,74,49,25,51
Copenhagen,4129,4,13,6,11,53,43,10,45
AaB,4129,5,7,14,9,36,41,-5,35
Sonderjyske,4129,6,8,6,10,28,29,-1,30
AC Horsens,4129,7,5,13,12,36,57,-21,28
Randers FC,4129,8,6,6,12,24,39,-15,24
AGF Aarhus,4129,9,5,6,11,17,36,-19,21
Lyngby,4129,10,3,9,12,26,45,-19,18
Silkeborg IF,4129,11,5,3,14,25,45,-20,18
FC Midtjylla,4130,1,21,4,5,68,41,27,67
Brondby,4130,2,20,5,5,72,33,39,65
FC Nords,4130,3,15,7,8,74,51,23,52
Copenhagen,4130,4,13,5,12,58,46,12,44
AaB,4130,5,7,13,10,39,44,-5,34
AC Horsens,4130,6,7,12,11,33,55,-22,33
Sonderjyske,4130,7,8,6,10,28,29,-1,30
Randers FC,4130,8,6,6,12,26,40,-14,24
Silkeborg IF,4130,9,5,4,13,26,45,-19,19
AGF Aarhus,4130,10,4,7,11,17,37,-20,19
Lyngby,4130,11,3,9,12,27,47,-20,18
FC Midtjylla,4131,1,21,5,4,67,37,30,68
Brondby,4131,2,20,6,4,71,37,34,66
FC Nords,4131,3,14,6,10,73,57,16,48
Copenhagen,4131,4,14,4,12,56,42,14,46
AaB,4131,5,9,12,9,43,42,1,39
Sonderjyske,4131,6,8,6,10,28,29,-1,30
AC Horsens,4131,7,5,13,12,32,53,-21,28
Randers FC,4131,8,6,6,12,26,39,-13,24
Silkeborg IF,4131,9,6,3,13,26,44,-18,21
Lyngby,4131,10,3,9,12,26,47,-21,18
AGF Aarhus,4131,11,4,6,12,16,37,-21,18
Brondby,4132,1,20,7,3,67,30,37,67
FC Midtjylla,4132,2,20,5,5,67,37,30,65
FC Nords,4132,3,14,7,9,74,51,23,49
Copenhagen,4132,4,14,5,11,57,46,11,47
AaB,4132,5,7,12,11,34,43,-9,33
AC Horsens,4132,6,6,14,10,36,54,-18,32
Sonderjyske,4132,7,8,6,10,28,29,-1,30
Randers FC,4132,8,6,6,12,25,40,-15,24
AGF Aarhus,4132,9,5,6,11,17,36,-19,21
Lyngby,4132,10,3,9,12,27,46,-19,18
Silkeborg IF,4132,11,5,3,14,25,45,-20,18
Brondby,4133,1,22,5,3,73,32,41,71
FC Midtjylla,4133,2,19,5,6,63,38,25,62
Copenhagen,4133,3,14,5,11,57,45,12,47
FC Nords,4133,4,13,7,10,71,55,16,46
AaB,4133,5,8,11,11,39,44,-5,35
AC Horsens,4133,6,7,13,10,35,50,-15,34
Sonderjyske,4133,7,8,6,10,28,29,-1,30
Lyngby,4133,8,4,9,11,29,45,-16,21
Silkeborg IF,4133,9,6,3,13,27,44,-17,21
Randers FC,4133,10,5,6,13,24,42,-18,21
AGF Aarhus,4133,11,4,6,12,16,38,-22,18
Brondby,4134,1,19,6,5,68,36,32,63
FC Midtjylla,4134,2,18,6,6,65,39,26,60
FC Nords,4134,3,15,7,8,74,50,24,52
Copenhagen,4134,4,15,4,11,58,44,14,49
AaB,4134,5,9,11,10,41,42,-1,38
AC Horsens,4134,6,7,12,11,34,55,-21,33
Sonderjyske,4134,7,8,6,10,28,29,-1,30
Lyngby,4134,8,4,9,11,29,44,-15,21
Silkeborg IF,4134,9,6,3,13,30,46,-16,21
Randers FC,4134,10,5,6,13,23,42,-19,21
AGF Aarhus,4134,11,4,6,12,18,41,-23,18
Brondby,4135,1,22,5,3,75,38,37,71
FC Midtjylla,4135,2,18,5,7,63,41,22,59
Copenhagen,4135,3,15,5,10,65,44,21,50
FC Nords,4135,4,14,7,9,75,57,18,49
AaB,4135,5,8,11,11,38,43,-5,35
Sonderjyske,4135,6,8,6,10,28,29,-1,30
AC Horsens,4135,7,5,15,10,34,53,-19,30
Randers FC,4135,8,6,6,12,25,39,-14,24
AGF Aarhus,4135,9,5,6,11,18,37,-19,21
Lyngby,4135,10,3,9,12,26,46,-20,18
Silkeborg IF,4135,10,5,3,14,26,46,-20,18
FC Midtjylla,4136,1,21,5,4,70,38,32,68
Brondby,4136,2,20,6,4,70,31,39,66
FC Nords,4136,3,13,7,10,72,54,18,46
Copenhagen,4136,4,13,6,11,58,47,11,45
AaB,4136,5,7,14,9,40,44,-4,35
AC Horsens,4136,6,6,14,10,32,54,-22,32
Sonderjyske,4136,7,8,6,10,28,29,-1,30
Lyngby,4136,8,4,9,11,32,44,-12,21
Randers FC,4136,9,5,6,13,23,45,-22,21
Silkeborg IF,4136,10,5,4,13,27,46,-19,19
AGF Aarhus,4136,11,4,7,11,18,38,-20,19
Brondby,4137,1,20,7,3,68,32,36,67
FC Midtjylla,4137,2,19,4,7,59,39,20,61
FC Nords,4137,3,14,8,8,72,47,25,50
Copenhagen,4137,4,13,6,11,55,43,12,45
AaB,4137,5,9,12,9,41,41,0,39
AC Horsens,4137,6,6,13,11,32,51,-19,31
Sonderjyske,4137,7,8,6,10,28,29,-1,30
Randers FC,4137,8,5,7,12,24,40,-16,22
Silkeborg IF,4137,9,6,3,13,30,44,-14,21
Lyngby,4137,10,3,10,11,27,45,-18,19
AGF Aarhus,4137,11,4,6,12,16,41,-25,18
Brondby,4138,1,23,5,2,80,31,49,74
FC Midtjylla,4138,2,19,4,7,63,41,22,61
FC Nords,4138,3,16,6,8,76,50,26,54
Copenhagen,4138,4,13,4,13,56,46,10,43
AC Horsens,4138,5,7,12,11,36,58,-22,33
AaB,4138,6,7,11,12,37,48,-11,32
Sonderjyske,4138,7,8,6,10,28,29,-1,30
Randers FC,4138,8,5,7,12,27,43,-16,22
AGF Aarhus,4138,9,5,6,11,18,36,-18,21
Lyngby,4138,10,3,10,11,30,48,-18,19
Silkeborg IF,4138,11,5,3,14,25,46,-21,18
Brondby,4139,1,19,7,4,71,38,33,64
FC Midtjylla,4139,2,19,4,7,67,42,25,61
FC Nords,4139,3,14,8,8,78,54,24,50
Copenhagen,4139,4,13,6,11,58,49,9,45
AaB,4139,5,10,11,9,44,40,4,41
AC Horsens,4139,6,7,12,11,36,57,-21,33
Sonderjyske,4139,7,8,6,10,28,29,-1,30
Lyngby,4139,8,4,9,11,28,45,-17,21
Silkeborg IF,4139,9,6,3,13,27,44,-17,21
Randers FC,4139,10,5,6,13,24,41,-17,21
AGF Aarhus,4139,11,4,6,12,16,38,-22,18
Brondby,4140,1,21,6,3,76,32,44,69
FC Midtjylla,4140,2,19,5,6,63,37,26,62
FC Nords,4140,3,15,7,8,75,54,21,52
Copenhagen,4140,4,14,5,11,59,46,13,47
AC Horsens,4140,5,6,15,9,36,53,-17,33
Sonderjyske,4140,6,8,6,10,28,29,-1,30
AaB,4140,7,6,12,12,33,46,-13,30
Randers FC,4140,8,5,7,12,24,40,-16,22
Silkeborg IF,4140,9,6,3,13,28,44,-16,21
Lyngby,4140,10,3,10,11,27,45,-18,19
AGF Aarhus,4140,11,4,6,12,16,39,-23,18
Brondby,4141,1,22,5,3,70,32,38,71
FC Midtjylla,4141,2,20,5,5,67,38,29,65
FC Nords,4141,3,14,7,9,73,49,24,49
Copenhagen,4141,4,14,4,12,63,49,14,46
AaB,4141,5,8,11,11,38,46,-8,35
Sonderjyske,4141,6,8,6,10,28,29,-1,30
AC Horsens,4141,7,6,12,12,31,54,-23,30
Silkeborg IF,4141,8,6,3,13,30,45,-15,21
Lyngby,4141,9,4,9,11,29,44,-15,21
Randers FC,4141,10,5,6,13,23,42,-19,21
AGF Aarhus,4141,11,4,6,12,17,41,-24,18
Brondby,4142,1,20,7,3,69,34,35,67
FC Midtjylla,4142,2,20,5,5,67,39,28,65
Copenhagen,4142,3,15,4,11,60,46,14,49
FC Nords,4142,4,13,7,10,74,53,21,46
AaB,4142,5,8,11,11,39,44,-5,35
AC Horsens,4142,6,6,14,10,35,54,-19,32
Sonderjyske,4142,7,8,6,10,28,29,-1,30
Lyngby,4142,8,4,9,11,29,45,-16,21
AGF Aarhus,4142,9,5,6,11,21,37,-16,21
Randers FC,4142,10,5,6,13,24,42,-18,21
Silkeborg IF,4142,11,5,3,14,26,49,-23,18
Brondby,4143,1,20,5,5,71,40,31,65
FC Midtjylla,4143,2,19,5,6,61,37,24,62
FC Nords,4143,3,14,7,9,71,49,22,49
Copenhagen,4143,4,14,6,10,61,46,15,48
AaB,4143,5,9,11,10,40,42,-2,38
AC Horsens,4143,6,7,12,11,38,54,-16,33
Sonderjyske,4143,7,8,6,10,28,29,-1,30
Lyngby,4143,8,4,9,11,27,44,-17,21
Randers FC,4143,9,5,6,13,23,40,-17,21
Silkeborg IF,4143,10,5,4,13,27,46,-19,19
AGF Aarhus,4143,11,4,7,11,18,38,-20,19
Brondby,4144,1,21,6,3,72,32,40,69
FC Midtjylla,4144,2,20,4,6,69,41,28,64
Copenhagen,4144,3,15,4,11,61,46,15,49
FC Nords,4144,4,13,7,10,70,54,16,46
AaB,4144,5,8,11,11,37,44,-7,35
AC Horsens,4144,6,7,12,11,37,55,-18,33
Sonderjyske,4144,7,8,6,10,28,29,-1,30
Lyngby,4144,8,4,9,11,28,45,-17,21
Randers FC,4144,9,5,6,13,24,41,-17,21
Silkeborg IF,4144,10,6,3,13,27,45,-18,21
AGF Aarhus,4144,11,4,6,12,17,38,-21,18
FC Midtjylla,4145,1,19,4,7,59,39,20,61
Brondby,4145,2,18,6,6,64,35,29,60
FC Nords,4145,3,17,6,7,81,45,36,57
Copenhagen,4145,4,15,4,11,58,44,14,49
AaB,4145,5,10,11,9,38,40,-2,41
Sonderjyske,4145,6,8,6,10,28,29,-1,30
AC Horsens,4145,7,5,13,12,33,56,-23,28
Lyngby,4145,8,4,9,11,27,44,-17,21
Randers FC,4145,9,5,6,13,23,40,-17,21
AGF Aarhus,4145,10,5,6,11,18,37,-19,21
Silkeborg IF,4145,11,5,3,14,26,46,-20,18
FC Midtjylla,4146,1,21,5,4,69,36,33,68
Brondby,4146,2,20,5,5,70,38,32,65
FC Nords,4146,3,14,7,9,75,53,22,49
Copenhagen,4146,4,14,5,11,61,47,14,47
AC Horsens,4146,5,8,13,9,37,52,-15,37
Sonderjyske,4146,6,8,6,10,28,29,-1,30
AaB,4146,7,6,11,13,34,46,-12,29
Lyngby,4146,8,4,9,11,27,44,-17,21
Randers FC,4146,9,5,6,13,23,40,-17,21
Silkeborg IF,4146,10,6,3,13,26,44,-18,21
AGF Aarhus,4146,11,4,6,12,16,37,-21,18
Brondby,4147,1,21,5,4,72,34,38,68
FC Midtjylla,4147,2,21,5,4,67,36,31,68
FC Nords,4147,3,13,8,9,72,53,19,47
Copenhagen,4147,4,14,5,11,58,46,12,47
AaB,4147,5,8,13,9,39,39,0,37
Sonderjyske,4147,6,8,6,10,28,29,-1,30
AC Horsens,4147,7,5,12,13,34,60,-26,27
Lyngby,4147,8,4,9,11,29,45,-16,21
Randers FC,4147,9,5,6,13,24,42,-18,21
Silkeborg IF,4147,10,5,4,13,25,44,-19,19
AGF Aarhus,4147,11,4,7,11,16,36,-20,19
Brondby,4148,1,23,5,2,76,31,45,74
FC Midtjylla,4148,2,18,5,7,63,41,22,59
Copenhagen,4148,3,15,4,11,63,44,19,49
FC Nords,4148,4,14,6,10,70,52,18,48
AaB,4148,5,7,12,11,36,45,-9,33
AC Horsens,4148,6,7,12,11,34,55,-21,33
Sonderjyske,4148,7,8,6,10,28,29,-1,30
Randers FC,4148,8,6,6,12,25,40,-15,24
Silkeborg IF,4148,9,6,3,13,26,44,-18,21
Lyngby,4148,10,3,9,12,27,46,-19,18
AGF Aarhus,4148,11,4,6,12,16,37,-21,18
Brondby,4149,1,20,8,2,72,30,42,68
FC Midtjylla,4149,2,21,5,4,68,37,31,68
FC Nords,4149,3,14,6,10,70,56,14,48
Copenhagen,4149,4,14,5,11,55,41,14,47
AC Horsens,4149,5,7,13,10,35,52,-17,34
Sonderjyske,4149,6,8,6,10,28,29,-1,30
AaB,4149,7,6,11,13,34,44,-10,29
Randers FC,4149,8,5,7,12,24,40,-16,22
Silkeborg IF,4149,9,6,3,13,27,45,-18,21
Lyngby,4149,10,3,10,11,27,45,-18,19
AGF Aarhus,4149,11,4,6,12,17,38,-21,18
Brondby,4150,1,22,6,2,73,33,40,72
FC Midtjylla,4150,2,18,7,5,66,41,25,61
FC Nords,4150,3,14,8,8,80,55,25,50
Copenhagen,4150,4,13,6,11,61,47,14,45
AaB,4150,5,6,16,8,39,43,-4,34
Sonderjyske,4150,6,8,6,10,28,29,-1,30
AC Horsens,4150,7,5,13,12,32,58,-26,28
Lyngby,4150,8,4,9,11,28,45,-17,21
Randers FC,4150,9,5,6,13,24,41,-17,21
AGF Aarhus,4150,10,5,6,11,18,36,-18,21
Silkeborg IF,4150,11,5,3,14,25,46,-21,18
Brondby,4151,1,22,5,3,73,35,38,71
FC Midtjylla,4151,2,21,5,4,68,38,30,68
FC Nords,4151,3,15,7,8,75,49,26,52
Copenhagen,4151,4,12,5,13,57,51,6,41
AaB,4151,5,6,13,11,38,47,-9,31
AC Horsens,4151,6,6,13,11,35,52,-17,31
Sonderjyske,4151,7,8,6,10,28,29,-1,30
Lyngby,4151,8,4,9,11,27,44,-17,21
Randers FC,4151,9,5,6,13,23,40,-17,21
Silkeborg IF,4151,10,6,3,13,28,46,-18,21
AGF Aarhus,4151,11,4,6,12,18,39,-21,18
Brondby,4152,1,20,6,4,73,35,38,66
FC Midtjylla,4152,2,20,5,5,64,37,27,65
Copenhagen,4152,3,15,5,10,61,44,17,50
FC Nords,4152,4,12,8,10,71,54,17,44
AC Horsens,4152,5,7,14,9,39,53,-14,35
AaB,4152,6,6,14,10,36,47,-11,32
Sonderjyske,4152,7,8,6,10,28,29,-1,30
Lyngby,4152,8,4,9,11,28,45,-17,21
Randers FC,4152,9,5,6,13,24,41,-17,21
Silkeborg IF,4152,10,6,3,13,26,44,-18,21
AGF Aarhus,4152,11,4,6,12,16,37,-21,18
Brondby,4153,1,20,5,5,71,36,35,65
FC Midtjylla,4153,2,20,5,5,66,34,32,65
FC Nords,4153,3,14,7,9,74,56,18,49
Copenhagen,4153,4,14,5,11,58,46,12,47
AC Horsens,4153,5,8,13,9,38,51,-13,37
AaB,4153,6,7,11,12,39,49,-10,32
Sonderjyske,4153,7,8,6,10,28,29,-1,30
Lyngby,4153,8,4,9,11,28,45,-17,21
Randers FC,4153,9,5,6,13,24,41,-17,21
Silkeborg IF,4153,10,5,4,13,27,46,-19,19
AGF Aarhus,4153,11,4,7,11,18,38,-20,19
Brondby,4154,1,20,7,3,70,30,40,67
FC Midtjylla,4154,2,21,4,5,66,35,31,67
FC Nords,4154,3,14,6,10,73,54,19,48
Copenhagen,4154,4,14,5,11,57,46,11,47
AC Horsens,4154,5,6,15,9,35,51,-16,33
AaB,4154,6,6,13,11,35,46,-11,31
Sonderjyske,4154,7,8,6,10,28,29,-1,30
Randers FC,4154,8,6,6,12,25,40,-15,24
Silkeborg IF,4154,9,6,3,13,27,45,-18,21
Lyngby,4154,10,3,9,12,27,46,-19,18
AGF Aarhus,4154,11,4,6,12,17,38,-21,18
Brondby,4155,1,20,8,2,72,32,40,68
FC Midtjylla,4155,2,18,7,5,64,40,24,61
FC Nords,4155,3,14,7,9,72,52,20,49
Copenhagen,4155,4,14,6,10,58,46,12,48
AaB,4155,5,7,13,10,39,44,-5,34
AC Horsens,4155,6,6,13,11,34,51,-17,31
Sonderjyske,4155,7,8,6,10,28,29,-1,30
Randers FC,4155,8,6,6,12,25,40,-15,24
AGF Aarhus,4155,9,5,6,11,18,37,-19,21
Lyngby,4155,10,3,9,12,27,46,-19,18
Silkeborg IF,4155,11,5,3,14,26,46,-20,18
Brondby,4156,1,23,5,2,76,30,46,74
FC Midtjylla,4156,2,18,7,5,66,41,25,61
Copenhagen,4156,3,14,6,10,56,41,15,48
FC Nords,4156,4,13,7,10,70,55,15,46
AaB,4156,5,7,12,11,35,44,-9,33
Sonderjyske,4156,6,8,6,10,28,29,-1,30
AC Horsens,4156,7,5,15,10,35,53,-18,30
Lyngby,4156,8,4,9,11,30,45,-15,21
Silkeborg IF,4156,9,6,3,13,28,46,-18,21
Randers FC,4156,10,5,6,13,24,43,-19,21
AGF Aarhus,4156,11,4,6,12,18,39,-21,18
Brondby,4157,1,21,7,2,68,30,38,70
FC Midtjylla,4157,2,18,6,6,65,42,23,60
Copenhagen,4157,3,15,4,11,58,43,15,49
FC Nords,4157,4,13,7,10,70,50,20,46
AaB,4157,5,8,11,11,36,42,-6,35
AC Horsens,4157,6,7,13,10,39,55,-16,34
Sonderjyske,4157,7,8,6,10,28,29,-1,30
Lyngby,4157,8,4,9,11,27,44,-17,21
Silkeborg IF,4157,8,6,3,13,27,44,-17,21
Randers FC,4157,10,5,6,13,23,40,-17,21
AGF Aarhus,4157,11,4,6,12,16,38,-22,18
Brondby,4158,1,20,7,3,72,33,39,67
FC Midtjylla,4158,2,18,7,5,63,39,24,61
Copenhagen,4158,3,16,5,9,65,45,20,53
FC Nords,4158,4,14,7,9,76,58,18,49
AaB,4158,5,7,12,11,39,44,-5,33
Sonderjyske,4158,6,8,6,10,28,29,-1,30
AC Horsens,4158,7,5,14,11,35,57,-22,29
Randers FC,4158,8,6,6,12,25,40,-15,24
Silkeborg IF,4158,9,6,3,13,27,45,-18,21
Lyngby,4158,10,3,9,12,27,46,-19,18
AGF Aarhus,4158,11,4,6,12,17,38,-21,18
Brondby,4159,1,23,5,2,82,33,49,74
FC Midtjylla,4159,2,20,4,6,64,39,25,64
FC Nords,4159,3,15,6,9,74,51,23,51
Copenhagen,4159,4,13,4,13,56,46,10,43
AaB,4159,5,8,11,11,40,48,-8,35
Sonderjyske,4159,6,8,6,10,28,29,-1,30
AC Horsens,4159,7,6,12,12,34,59,-25,30
Lyngby,4159,8,4,9,11,29,46,-17,21
Silkeborg IF,4159,8,6,3,13,29,46,-17,21
Randers FC,4159,10,5,6,13,25,42,-17,21
AGF Aarhus,4159,11,4,6,12,18,40,-22,18
Brondby,4160,1,20,7,3,77,36,41,67
FC Midtjylla,4160,2,19,6,5,68,38,30,63
Copenhagen,4160,3,15,5,10,57,43,14,50
FC Nords,4160,4,14,7,9,73,56,17,49
AaB,4160,5,8,12,10,39,45,-6,36
Sonderjyske,4160,6,8,6,10,28,29,-1,30
AC Horsens,4160,7,5,13,12,35,57,-22,28
Randers FC,4160,8,5,7,12,26,42,-16,22
AGF Aarhus,4160,9,5,6,11,18,36,-18,21
Lyngby,4160,10,3,10,11,29,47,-18,19
Silkeborg IF,4160,11,5,3,14,25,46,-21,18
Brondby,4161,1,22,6,2,80,31,49,72
FC Midtjylla,4161,2,18,6,6,63,40,23,60
FC Nords,4161,3,14,7,9,72,57,15,49
Copenhagen,4161,4,13,5,12,56,46,10,44
AaB,4161,5,8,12,10,35,39,-4,36
AC Horsens,4161,6,6,14,10,34,53,-19,32
Sonderjyske,4161,7,8,6,10,28,29,-1,30
Randers FC,4161,8,6,6,12,25,40,-15,24
Silkeborg IF,4161,9,5,4,13,27,46,-19,19
AGF Aarhus,4161,10,4,7,11,18,38,-20,19
Lyngby,4161,11,3,9,12,27,46,-19,18
Brondby,4162,1,22,5,3,71,32,39,71
FC Midtjylla,4162,2,19,5,6,66,38,28,62
FC Nords,4162,3,14,7,9,75,53,22,49
Copenhagen,4162,4,14,4,12,55,46,9,46
AC Horsens,4162,5,7,13,10,38,55,-17,34
AaB,4162,6,6,14,10,35,42,-7,32
Sonderjyske,4162,7,8,6,10,28,29,-1,30
Randers FC,4162,8,6,6,12,25,40,-15,24
Silkeborg IF,4162,9,6,3,13,27,45,-18,21
Lyngby,4162,10,3,9,12,27,46,-19,18
AGF Aarhus,4162,11,4,6,12,17,38,-21,18
FC Midtjylla,4163,1,22,4,4,77,39,38,70
Brondby,4163,2,19,7,4,69,33,36,64
FC Nords,4163,3,15,6,9,79,53,26,51
Copenhagen,4163,4,12,7,11,53,47,6,43
AaB,4163,5,7,13,10,40,46,-6,34
Sonderjyske,4163,6,8,6,10,28,29,-1,30
AC Horsens,4163,7,5,15,10,32,58,-26,30
Lyngby,4163,8,4,9,11,28,45,-17,21
Randers FC,4163,9,5,6,13,24,41,-17,21
Silkeborg IF,4163,10,5,4,13,27,46,-19,19
AGF Aarhus,4163,11,4,7,11,18,38,-20,19
Brondby,4164,1,21,6,3,69,31,38,69
FC Midtjylla,4164,2,18,8,4,67,39,28,62
FC Nords,4164,3,14,7,9,73,52,21,49
Copenhagen,4164,4,12,4,14,52,49,3,40
AC Horsens,4164,5,8,13,9,34,48,-14,37
AaB,4164,6,8,12,10,37,39,-2,36
Sonderjyske,4164,7,8,6,10,28,29,-1,30
Randers FC,4164,8,6,6,12,25,40,-15,24
Silkeborg IF,4164,9,6,3,13,27,45,-18,21
Lyngby,4164,10,3,9,12,27,46,-19,18
AGF Aarhus,4164,11,4,6,12,17,38,-21,18
FC Midtjylla,4165,1,21,5,4,70,34,36,68
Brondby,4165,2,20,5,5,69,33,36,65
FC Nords,4165,3,15,7,8,71,51,20,52
Copenhagen,4165,4,13,5,12,56,46,10,44
AaB,4165,5,7,12,11,34,46,-12,33
AC Horsens,4165,6,6,14,10,32,48,-16,32
Sonderjyske,4165,7,8,6,10,28,29,-1,30
Randers FC,4165,8,6,6,12,25,39,-14,24
AGF Aarhus,4165,9,5,6,11,18,36,-18,21
Lyngby,4165,10,3,9,12,26,46,-20,18
Silkeborg IF,4165,11,5,3,14,25,46,-21,18
FC Midtjylla,4166,1,21,5,4,73,33,40,68
Brondby,4166,2,20,7,3,74,34,40,67
FC Nords,4166,3,15,6,9,74,57,17,51
Copenhagen,4166,4,12,5,13,54,46,8,41
AaB,4166,5,8,11,11,34,42,-8,35
AC Horsens,4166,6,7,12,11,34,57,-23,33
Sonderjyske,4166,7,8,6,10,28,29,-1,30
Randers FC,4166,8,6,6,12,26,41,-15,24
AGF Aarhus,4166,9,5,6,11,18,37,-19,21
Lyngby,4166,10,3,9,12,28,47,-19,18
Silkeborg IF,4166,11,5,3,14,26,46,-20,18
Brondby,4167,1,20,6,4,67,33,34,66
FC Midtjylla,4167,2,18,7,5,63,39,24,61
Copenhagen,4167,3,16,5,9,62,41,21,53
FC Nords,4167,4,13,9,8,72,52,20,48
AaB,4167,5,7,12,11,36,42,-6,33
AC Horsens,4167,6,6,13,11,33,52,-19,31
Sonderjyske,4167,7,8,6,10,28,29,-1,30
Randers FC,4167,8,5,7,12,23,39,-16,22
AGF Aarhus,4167,9,5,6,11,18,37,-19,21
Lyngby,4167,10,3,10,11,26,44,-18,19
Silkeborg IF,4167,11,5,3,14,26,46,-20,18
Brondby,4168,1,19,7,4,68,32,36,64
FC Midtjylla,4168,2,19,7,4,60,33,27,64
FC Nords,4168,3,14,8,8,72,47,25,50
Copenhagen,4168,4,13,6,11,55,46,9,45
AaB,4168,5,8,12,10,36,40,-4,36
AC Horsens,4168,6,6,14,10,32,51,-19,32
Sonderjyske,4168,7,8,6,10,28,29,-1,30
Randers FC,4168,8,6,6,12,25,39,-14,24
Silkeborg IF,4168,9,6,3,13,26,44,-18,21
Lyngby,4168,10,3,9,12,26,46,-20,18
AGF Aarhus,4168,11,4,6,12,16,37,-21,18
Brondby,4169,1,22,5,3,75,34,41,71
FC Midtjylla,4169,2,21,4,5,68,38,30,67
FC Nords,4169,3,14,6,10,74,54,20,48
Copenhagen,4169,4,13,5,12,55,46,9,44
AaB,4169,5,8,13,9,35,39,-4,37
Sonderjyske,4169,6,8,6,10,28,29,-1,30
AC Horsens,4169,7,5,13,12,34,56,-22,28
Lyngby,4169,8,4,9,11,29,44,-15,21
Silkeborg IF,4169,9,6,3,13,26,44,-18,21
Randers FC,4169,10,5,6,13,23,42,-19,21
AGF Aarhus,4169,11,4,6,12,16,37,-21,18
FC Midtjylla,4170,1,20,5,5,67,38,29,65
Brondby,4170,2,19,7,4,67,34,33,64
FC Nords,4170,3,16,7,7,73,46,27,55
Copenhagen,4170,4,12,6,12,56,48,8,42
AC Horsens,4170,5,6,15,9,35,50,-15,33
AaB,4170,6,6,14,10,34,42,-8,32
Sonderjyske,4170,7,8,6,10,28,29,-1,30
Randers FC,4170,8,6,6,12,26,39,-13,24
Silkeborg IF,4170,9,6,3,13,29,44,-15,21
Lyngby,4170,10,3,9,12,26,47,-21,18
AGF Aarhus,4170,11,4,6,12,16,40,-24,18
Brondby,4171,1,19,8,3,66,30,36,65
FC Midtjylla,4171,2,20,4,6,66,37,29,64
FC Nords,4171,3,16,7,7,80,49,31,55
Copenhagen,4171,4,14,5,11,56,47,9,47
AC Horsens,4171,5,6,14,10,34,54,-20,32
Sonderjyske,4171,6,8,6,10,28,29,-1,30
AaB,4171,7,6,12,12,36,47,-11,30
Randers FC,4171,8,5,7,12,23,39,-16,22
Lyngby,4171,9,3,10,11,26,44,-18,19
Silkeborg IF,4171,10,5,4,13,25,44,-19,19
AGF Aarhus,4171,11,4,7,11,16,36,-20,19
Brondby,4172,1,21,5,4,71,35,36,68
FC Midtjylla,4172,2,19,5,6,63,41,22,62
FC Nords,4172,3,16,6,8,78,48,30,54
Copenhagen,4172,4,14,5,11,58,48,10,47
AaB,4172,5,8,13,9,40,42,-2,37
Sonderjyske,4172,6,8,6,10,28,29,-1,30
AC Horsens,4172,7,5,12,13,35,57,-22,27
Randers FC,4172,8,5,7,12,25,41,-16,22
Silkeborg IF,4172,9,6,3,13,26,44,-18,21
Lyngby,4172,10,3,10,11,28,46,-18,19
AGF Aarhus,4172,11,4,6,12,16,37,-21,18
FC Midtjylla,4173,1,20,6,4,64,35,29,66
Brondby,4173,2,19,6,5,71,38,33,63
FC Nords,4173,3,13,8,9,71,50,21,47
Copenhagen,4173,4,13,7,10,56,43,13,46
AaB,4173,5,9,11,10,40,42,-2,38
AC Horsens,4173,6,6,14,10,37,57,-20,32
Sonderjyske,4173,7,8,6,10,28,29,-1,30
Lyngby,4173,8,4,9,11,28,45,-17,21
Randers FC,4173,9,5,6,13,24,41,-17,21
Silkeborg IF,4173,10,5,4,13,27,46,-19,19
AGF Aarhus,4173,11,4,7,11,18,38,-20,19
Brondby,4174,1,23,5,2,76,30,46,74
FC Midtjylla,4174,2,18,6,6,65,45,20,60
FC Nords,4174,3,13,7,10,70,52,18,46
Copenhagen,4174,4,13,7,10,57,46,11,46
AaB,4174,5,9,11,10,40,43,-3,38
Sonderjyske,4174,6,8,6,10,28,29,-1,30
AC Horsens,4174,7,5,14,11,33,51,-18,29
Lyngby,4174,8,4,9,11,30,45,-15,21
Silkeborg IF,4174,9,6,3,13,27,45,-18,21
Randers FC,4174,10,5,6,13,24,43,-19,21
AGF Aarhus,4174,11,4,6,12,17,38,-21,18
FC Midtjylla,4175,1,21,5,4,69,35,34,68
Brondby,4175,2,19,5,6,62,36,26,62
FC Nords,4175,3,14,8,8,73,53,20,50
Copenhagen,4175,4,15,5,10,61,41,20,50
AC Horsens,4175,5,6,14,10,35,53,-18,32
AaB,4175,6,6,13,11,34,42,-8,31
Sonderjyske,4175,7,8,6,10,28,29,-1,30
Randers FC,4175,8,6,6,12,25,39,-14,24
AGF Aarhus,4175,9,5,6,11,17,36,-19,21
Lyngby,4175,10,3,9,12,26,46,-20,18
Silkeborg IF,4175,11,5,3,14,25,45,-20,18
Brondby,4176,1,22,6,2,76,33,43,72
FC Midtjylla,4176,2,18,5,7,64,41,23,59
Copenhagen,4176,3,14,6,10,55,41,14,48
FC Nords,4176,4,13,8,9,73,54,19,47
AaB,4176,5,9,11,10,38,42,-4,38
Sonderjyske,4176,6,8,6,10,28,29,-1,30
AC Horsens,4176,7,6,12,12,34,55,-21,30
Lyngby,4176,8,4,9,11,28,45,-17,21
Randers FC,4176,9,5,6,13,24,41,-17,21
Silkeborg IF,4176,10,6,3,13,26,44,-18,21
AGF Aarhus,4176,11,4,6,12,16,37,-21,18
FC Midtjylla,4177,1,20,6,4,69,36,33,66
Brondby,4177,2,19,6,5,66,34,32,63
FC Nords,4177,3,14,9,7,76,51,25,51
Copenhagen,4177,4,14,6,10,57,43,14,48
AaB,4177,5,7,13,10,40,46,-6,34
Sonderjyske,4177,6,8,6,10,28,29,-1,30
AC Horsens,4177,7,5,14,11,33,57,-24,29
Randers FC,4177,8,5,7,12,25,41,-16,22
AGF Aarhus,4177,9,5,6,11,20,36,-16,21
Lyngby,4177,10,3,10,11,28,46,-18,19
Silkeborg IF,4177,11,5,3,14,25,48,-23,18
Brondby,4178,1,21,5,4,69,33,36,68
FC Midtjylla,4178,2,20,5,5,67,39,28,65
FC Nords,4178,3,14,7,9,70,47,23,49
Copenhagen,4178,4,13,6,11,53,42,11,45
AaB,4178,5,8,11,11,36,41,-5,35
AC Horsens,4178,6,7,12,11,36,55,-19,33
Sonderjyske,4178,7,8,6,10,28,29,-1,30
Lyngby,4178,8,4,9,11,30,44,-14,21
AGF Aarhus,4178,9,5,6,11,17,36,-19,21
Randers FC,4178,10,5,6,13,23,43,-20,21
Silkeborg IF,4178,11,5,3,14,25,45,-20,18
Brondby,4179,1,21,6,3,72,34,38,69
FC Midtjylla,4179,2,20,4,6,66,38,28,64
FC Nords,4179,3,15,6,9,76,54,22,51
Copenhagen,4179,4,13,4,13,55,45,10,43
AaB,4179,5,10,11,9,36,38,-2,41
Sonderjyske,4179,6,8,6,10,28,29,-1,30
AC Horsens,4179,7,5,13,12,32,54,-22,28
Lyngby,4179,8,4,9,11,29,45,-16,21
Silkeborg IF,4179,9,6,3,13,27,44,-17,21
Randers FC,4179,10,5,6,13,24,42,-18,21
AGF Aarhus,4179,11,4,6,12,16,38,-22,18
Brondby,4180,1,22,5,3,72,32,40,71
FC Midtjylla,4180,2,17,5,8,63,45,18,56
Copenhagen,4180,3,16,5,9,63,42,21,53
FC Nords,4180,4,14,7,9,73,53,20,49
AaB,4180,5,8,12,10,41,45,-4,36
Sonderjyske,4180,6,8,6,10,28,29,-1,30
AC Horsens,4180,7,5,14,11,34,55,-21,29
Lyngby,4180,8,4,9,11,29,46,-17,21
Randers FC,4180,9,5,6,13,25,42,-17,21
Silkeborg IF,4180,10,5,4,13,26,45,-19,19
AGF Aarhus,4180,11,4,7,11,17,37,-20,19
Brondby,4181,1,20,6,4,66,33,33,66
FC Midtjylla,4181,2,20,6,4,68,36,32,66
FC Nords,4181,3,14,8,8,75,52,23,50
Copenhagen,4181,4,14,6,10,58,43,15,48
AC Horsens,4181,5,6,14,10,36,53,-17,32
Sonderjyske,4181,6,8,6,10,28,29,-1,30
AaB,4181,7,6,12,12,35,47,-12,30
Randers FC,4181,8,6,6,12,24,39,-15,24
Silkeborg IF,4181,9,5,4,13,25,44,-19,19
AGF Aarhus,4181,10,4,7,11,16,36,-20,19
Lyngby,4181,11,3,9,12,26,45,-19,18
Brondby,4182,1,22,5,3,73,31,42,71
FC Midtjylla,4182,2,20,4,6,65,38,27,64
FC Nords,4182,3,13,8,9,72,56,16,47
Copenhagen,4182,4,12,4,14,54,47,7,40
AC Horsens,4182,5,8,13,9,40,53,-13,37
AaB,4182,6,8,12,10,36,41,-5,36
Sonderjyske,4182,7,8,6,10,28,29,-1,30
Randers FC,4182,8,6,6,12,24,39,-15,24
AGF Aarhus,4182,9,5,6,11,18,37,-19,21
Lyngby,4182,10,3,9,12,26,45,-19,18
Silkeborg IF,4182,11,5,3,14,26,46,-20,18
Brondby,4183,1,23,5,2,75,31,44,74
FC Midtjylla,4183,2,20,4,6,68,41,27,64
FC Nords,4183,3,15,6,9,77,53,24,51
Copenhagen,4183,4,13,6,11,56,44,12,45
AaB,4183,5,6,13,11,37,45,-8,31
Sonderjyske,4183,6,8,6,10,28,29,-1,30
AC Horsens,4183,7,5,14,11,32,57,-25,29
Randers FC,4183,8,6,6,12,25,40,-15,24
Silkeborg IF,4183,9,5,4,13,25,44,-19,19
AGF Aarhus,4183,10,4,7,11,16,36,-20,19
Lyngby,4183,11,3,9,12,27,46,-19,18
FC Midtjylla,4184,1,19,7,4,68,38,30,64
Brondby,4184,2,19,6,5,66,35,31,63
FC Nords,4184,3,15,8,7,77,50,27,53
Copenhagen,4184,4,14,4,12,52,44,8,46
AaB,4184,5,7,13,10,36,42,-6,34
AC Horsens,4184,6,6,14,10,35,51,-16,32
Sonderjyske,4184,7,8,6,10,28,29,-1,30
Randers FC,4184,8,5,7,12,24,40,-16,22
AGF Aarhus,4184,9,5,6,11,19,36,-17,21
Lyngby,4184,10,3,10,11,27,45,-18,19
Silkeborg IF,4184,11,5,3,14,25,47,-22,18
Brondby,4185,1,22,6,2,73,31,42,72
FC Midtjylla,4185,2,19,7,4,66,37,29,64
FC Nords,4185,3,13,7,10,75,56,19,46
Copenhagen,4185,4,12,6,12,57,54,3,42
AaB,4185,5,7,13,10,38,39,-1,34
AC Horsens,4185,6,7,13,10,37,55,-18,34
Sonderjyske,4185,7,8,6,10,28,29,-1,30
Lyngby,4185,8,4,9,11,28,45,-17,21
Silkeborg IF,4185,8,6,3,13,28,45,-17,21
Randers FC,4185,10,5,6,13,24,41,-17,21
AGF Aarhus,4185,11,4,6,12,17,39,-22,18
Brondby,4186,1,20,8,2,67,30,37,68
FC Midtjylla,4186,2,18,7,5,66,42,24,61
FC Nords,4186,3,13,8,9,70,49,21,47
Copenhagen,4186,4,14,5,11,61,46,15,47
AaB,4186,5,9,12,9,37,39,-2,39
Sonderjyske,4186,6,8,6,10,28,29,-1,30
AC Horsens,4186,7,5,14,11,34,55,-21,29
Lyngby,4186,8,4,9,11,28,45,-17,21
Silkeborg IF,4186,9,6,3,13,27,44,-17,21
Randers FC,4186,10,5,6,13,24,41,-17,21
AGF Aarhus,4186,11,4,6,12,16,38,-22,18
Brondby,4187,1,19,6,5,68,35,33,63
FC Midtjylla,4187,2,19,5,6,63,42,21,62
Copenhagen,4187,3,15,6,9,60,41,19,51
FC Nords,4187,4,13,8,9,75,56,19,47
AC Horsens,4187,5,8,12,10,41,52,-11,36
AaB,4187,6,6,15,9,34,41,-7,33
Sonderjyske,4187,7,8,6,10,28,29,-1,30
Randers FC,4187,8,6,6,12,26,39,-13,24
Silkeborg IF,4187,9,6,3,13,26,44,-18,21
Lyngby,4187,10,3,9,12,26,47,-21,18
AGF Aarhus,4187,11,4,6,12,16,37,-21,18
Brondby,4188,1,19,6,5,67,33,34,63
FC Midtjylla,4188,2,18,6,6,62,41,21,60
FC Nords,4188,3,16,6,8,74,53,21,54
Copenhagen,4188,4,13,6,11,55,43,12,45
AaB,4188,5,9,12,9,43,41,2,39
AC Horsens,4188,6,7,12,11,39,55,-16,33
Sonderjyske,4188,7,8,6,10,28,29,-1,30
Lyngby,4188,8,4,9,11,28,45,-17,21
Randers FC,4188,9,5,6,13,24,41,-17,21
AGF Aarhus,4188,10,5,6,11,21,40,-19,21
Silkeborg IF,4188,11,5,3,14,29,49,-20,18
FC Midtjylla,4189,1,21,5,4,71,35,36,68
Brondby,4189,2,20,6,4,72,33,39,66
Copenhagen,4189,3,15,4,11,61,44,17,49
FC Nords,4189,4,13,7,10,67,54,13,46
AC Horsens,4189,5,7,13,10,33,53,-20,34
AaB,4189,6,6,13,11,34,45,-11,31
Sonderjyske,4189,7,8,6,10,28,29,-1,30
Lyngby,4189,8,4,9,11,28,44,-16,21
Randers FC,4189,9,5,6,13,23,41,-18,21
AGF Aarhus,4189,10,5,6,11,18,37,-19,21
Silkeborg IF,4189,11,5,3,14,26,46,-20,18
Brondby,4190,1,19,7,4,69,34,35,64
FC Midtjylla,4190,2,19,7,4,65,38,27,64
Copenhagen,4190,3,15,5,10,57,42,15,50
FC Nords,4190,4,12,8,10,69,53,16,44
AaB,4190,5,8,11,11,37,42,-5,35
AC Horsens,4190,6,7,14,9,34,48,-14,35
Sonderjyske,4190,7,8,6,10,28,29,-1,30
Lyngby,4190,8,4,9,11,28,44,-16,21
Silkeborg IF,4190,9,6,3,13,27,44,-17,21
Randers FC,4190,10,5,6,13,23,41,-18,21
AGF Aarhus,4190,11,4,6,12,16,38,-22,18
Brondby,4191,1,21,6,3,73,36,37,69
FC Midtjylla,4191,2,20,5,5,63,36,27,65
FC Nords,4191,3,14,7,9,74,52,22,49
Copenhagen,4191,4,14,6,10,64,47,17,48
AC Horsens,4191,5,7,12,11,35,53,-18,33
Sonderjyske,4191,6,8,6,10,28,29,-1,30
AaB,4191,7,6,12,12,35,46,-11,30
Lyngby,4191,8,4,9,11,31,45,-14,21
Silkeborg IF,4191,9,6,3,13,27,44,-17,21
Randers FC,4191,10,5,6,13,24,44,-20,21
AGF Aarhus,4191,11,4,6,12,16,38,-22,18
FC Midtjylla,4192,1,21,5,4,66,36,30,68
Brondby,4192,2,20,6,4,72,33,39,66
FC Nords,4192,3,14,7,9,75,53,22,49
Copenhagen,4192,4,13,4,13,52,47,5,43
AaB,4192,5,8,11,11,39,47,-8,35
AC Horsens,4192,6,7,13,10,37,51,-14,34
Sonderjyske,4192,7,8,6,10,28,29,-1,30
Randers FC,4192,8,5,7,12,23,39,-16,22
Silkeborg IF,4192,9,6,3,13,29,46,-17,21
Lyngby,4192,10,3,10,11,26,44,-18,19
AGF Aarhus,4192,11,4,6,12,18,40,-22,18
Brondby,4193,1,22,5,3,74,30,44,71
FC Midtjylla,4193,2,21,4,5,73,45,28,67
FC Nords,4193,3,14,6,10,76,59,17,48
Copenhagen,4193,4,13,5,12,58,48,10,44
AaB,4193,5,8,11,11,46,49,-3,35
AC Horsens,4193,6,6,13,11,34,56,-22,31
Sonderjyske,4193,7,8,6,10,28,29,-1,30
Lyngby,4193,8,4,9,11,27,44,-17,21
Randers FC,4193,9,5,6,13,23,40,-17,21
Silkeborg IF,4193,10,5,4,13,25,44,-19,19
AGF Aarhus,4193,11,4,7,11,16,36,-20,19
Brondby,4194,1,21,7,2,70,31,39,70
FC Midtjylla,4194,2,20,6,4,71,40,31,66
FC Nords,4194,3,14,7,9,76,53,23,49
Copenhagen,4194,4,12,8,10,58,46,12,44
AaB,4194,5,8,11,11,38,46,-8,35
Sonderjyske,4194,6,8,6,10,28,29,-1,30
AC Horsens,4194,7,5,13,12,34,57,-23,28
Randers FC,4194,8,6,6,12,25,40,-15,24
Silkeborg IF,4194,9,5,4,13,25,44,-19,19
AGF Aarhus,4194,10,4,7,11,16,36,-20,19
Lyngby,4194,11,3,9,12,27,46,-19,18
Brondby,4195,1,20,8,2,72,32,40,68
FC Midtjylla,4195,2,18,6,6,64,41,23,60
FC Nords,4195,3,15,8,7,77,51,26,53
Copenhagen,4195,4,15,5,10,60,43,17,50
AaB,4195,5,7,11,12,37,46,-9,32
Sonderjyske,4195,6,8,6,10,28,29,-1,30
AC Horsens,4195,7,5,14,11,33,56,-23,29
Lyngby,4195,8,4,9,11,28,44,-16,21
Randers FC,4195,9,5,6,13,23,41,-18,21
AGF Aarhus,4195,10,5,6,11,20,38,-18,21
Silkeborg IF,4195,11,5,3,14,27,48,-21,18
Brondby,4196,1,22,5,3,74,31,43,71
FC Midtjylla,4196,2,20,4,6,68,41,27,64
FC Nords,4196,3,14,6,10,71,57,14,48
Copenhagen,4196,4,14,5,11,57,44,13,47
AaB,4196,5,8,11,11,36,41,-5,35
AC Horsens,4196,6,6,13,11,33,51,-18,31
Sonderjyske,4196,7,8,6,10,28,29,-1,30
Randers FC,4196,8,5,7,12,23,39,-16,22
Silkeborg IF,4196,9,6,3,13,29,45,-16,21
Lyngby,4196,10,3,10,11,26,44,-18,19
AGF Aarhus,4196,11,4,6,12,17,40,-23,18
Brondby,4197,1,20,5,5,67,33,34,65
FC Midtjylla,4197,2,20,5,5,68,37,31,65
FC Nords,4197,3,16,6,8,76,50,26,54
Copenhagen,4197,4,12,5,13,59,51,8,41
AaB,4197,5,9,11,10,41,44,-3,38
AC Horsens,4197,6,7,12,11,34,56,-22,33
Sonderjyske,4197,7,8,6,10,28,29,-1,30
Randers FC,4197,8,6,6,12,27,40,-13,24
Silkeborg IF,4197,9,5,4,13,25,44,-19,19
AGF Aarhus,4197,10,4,7,11,16,36,-20,19
Lyngby,4197,11,3,9,12,27,48,-21,18
Brondby,4198,1,20,7,3,68,32,36,67
FC Midtjylla,4198,2,19,5,6,63,38,25,62
FC Nords,4198,3,14,8,8,76,52,24,50
Copenhagen,4198,4,13,7,10,58,44,14,46
AaB,4198,5,7,12,11,37,47,-10,33
AC Horsens,4198,6,6,15,9,37,52,-15,33
Sonderjyske,4198,7,8,6,10,28,29,-1,30
Lyngby,4198,8,4,9,11,30,44,-14,21
Randers FC,4198,9,5,6,13,23,43,-20,21
Silkeborg IF,4198,10,5,4,13,26,45,-19,19
AGF Aarhus,4198,11,4,7,11,17,37,-20,19
Brondby,4199,1,21,6,3,69,32,37,69
FC Midtjylla,4199,2,17,8,5,60,38,22,59
FC Nords,4199,3,13,7,10,70,53,17,46
Copenhagen,4199,4,13,6,11,59,48,11,45
AC Horsens,4199,5,8,14,8,36,45,-9,38
AaB,4199,6,7,13,10,38,42,-4,34
Sonderjyske,4199,7,8,6,10,28,29,-1,30
Lyngby,4199,8,4,9,11,29,45,-16,21
Silkeborg IF,4199,9,6,3,13,27,45,-18,21
Randers FC,4199,10,5,6,13,24,42,-18,21
AGF Aarhus,4199,11,4,6,12,17,38,-21,18
Brondby,4200,1,21,7,2,75,35,40,70
FC Midtjylla,4200,2,20,5,5,66,42,24,65
FC Nords,4200,3,14,7,9,75,53,22,49
Copenhagen,4200,4,14,5,11,63,47,16,47
AaB,4200,5,6,13,11,33,43,-10,31
AC Horsens,4200,6,6,13,11,38,56,-18,31
Sonderjyske,4200,7,8,6,10,28,29,-1,30
Randers FC,4200,8,5,7,12,24,40,-16,22
Lyngby,4200,9,3,10,11,27,45,-18,19
Silkeborg IF,4200,10,5,4,13,27,46,-19,19
AGF Aarhus,4200,11,4,7,11,18,38,-20,19
FC Midtjylla,4201,1,21,4,5,68,38,30,67
Brondby,4201,2,20,6,4,73,33,40,66
FC Nords,4201,3,13,7,10,71,55,16,46
Copenhagen,4201,4,13,7,10,60,47,13,46
AaB,4201,5,8,11,11,37,47,-10,35
AC Horsens,4201,6,7,13,10,36,51,-15,34
Sonderjyske,4201,7,8,6,10,28,29,-1,30
Randers FC,4201,8,5,7,12,26,42,-16,22
Silkeborg IF,4201,9,6,3,13,28,46,-18,21
Lyngby,4201,10,3,10,11,29,47,-18,19
AGF Aarhus,4201,11,4,6,12,18,39,-21,18
Brondby,4202,1,19,7,4,66,33,33,64
FC Midtjylla,4202,2,19,6,5,61,36,25,63
FC Nords,4202,3,15,7,8,76,48,28,52
Copenhagen,4202,4,13,5,12,54,46,8,44
AaB,4202,5,9,12,9,39,41,-2,39
AC Horsens,4202,6,6,13,11,33,51,-18,31
Sonderjyske,4202,7,8,6,10,28,29,-1,30
Randers FC,4202,8,6,6,12,24,39,-15,24
AGF Aarhus,4202,9,5,6,11,20,37,-17,21
Lyngby,4202,10,3,9,12,26,45,-19,18
Silkeborg IF,4202,11,5,3,14,26,48,-22,18
Brondby,4203,1,22,5,3,74,34,40,71
FC Midtjylla,4203,2,20,4,6,65,38,27,64
FC Nords,4203,3,14,7,9,79,59,20,49
Copenhagen,4203,4,14,5,11,62,49,13,47
AaB,4203,5,7,13,10,37,45,-8,34
Sonderjyske,4203,6,8,6,10,28,29,-1,30
AC Horsens,4203,7,5,14,11,33,51,-18,29
Silkeborg IF,4203,8,6,3,13,30,46,-16,21
Lyngby,4203,9,4,9,11,27,44,-17,21
Randers FC,4203,10,5,6,13,23,40,-17,21
AGF Aarhus,4203,11,4,6,12,18,41,-23,18
FC Midtjylla,4204,1,20,4,6,67,40,27,64
Brondby,4204,2,19,6,5,75,41,34,63
FC Nords,4204,3,16,6,8,81,54,27,54
Copenhagen,4204,4,15,5,10,61,47,14,50
AaB,4204,5,7,11,12,35,48,-13,32
AC Horsens,4204,6,6,14,10,36,51,-15,32
Sonderjyske,4204,7,8,6,10,28,29,-1,30
Lyngby,4204,8,4,9,11,28,45,-17,21
Randers FC,4204,9,5,6,13,24,41,-17,21
AGF Aarhus,4204,10,5,6,11,19,38,-19,21
Silkeborg IF,4204,11,5,3,14,27,47,-20,18
Brondby,4205,1,19,6,5,68,37,31,63
FC Midtjylla,4205,2,18,6,6,65,46,19,60
FC Nords,4205,3,16,6,8,83,52,31,54
Copenhagen,4205,4,14,6,10,59,42,17,48
AaB,4205,5,7,14,9,36,41,-5,35
AC Horsens,4205,6,6,14,10,31,50,-19,32
Sonderjyske,4205,7,8,6,10,28,29,-1,30
Randers FC,4205,8,5,7,12,23,39,-16,22
Silkeborg IF,4205,9,6,3,13,30,44,-14,21
Lyngby,4205,10,3,10,11,26,44,-18,19
AGF Aarhus,4205,11,4,6,12,16,41,-25,18
Brondby,4206,1,21,5,4,70,31,39,68
FC Midtjylla,4206,2,17,6,7,61,45,16,57
FC Nords,4206,3,15,7,8,75,49,26,52
Copenhagen,4206,4,14,5,11,61,48,13,47
AaB,4206,5,9,11,10,38,41,-3,38
AC Horsens,4206,6,6,14,10,36,53,-17,32
Sonderjyske,4206,7,8,6,10,28,29,-1,30
Randers FC,4206,8,5,7,12,23,39,-16,22
AGF Aarhus,4206,9,5,6,11,17,36,-19,21
Lyngby,4206,10,3,10,11,26,44,-18,19
Silkeborg IF,4206,11,5,3,14,25,45,-20,18
Brondby,4207,1,21,5,4,70,34,36,68
FC Midtjylla,4207,2,21,5,4,66,34,32,68
FC Nords,4207,3,13,8,9,71,52,19,47
Copenhagen,4207,4,12,7,11,53,43,10,43
AaB,4207,5,7,14,9,38,41,-3,35
Sonderjyske,4207,6,8,6,10,28,29,-1,30
AC Horsens,4207,7,5,15,10,34,54,-20,30
Lyngby,4207,8,4,9,11,27,44,-17,21
Randers FC,4207,9,5,6,13,23,40,-17,21
Silkeborg IF,4207,10,5,4,13,25,44,-19,19
AGF Aarhus,4207,11,4,7,11,16,36,-20,19
Brondby,4208,1,20,8,2,72,32,40,68
FC Midtjylla,4208,2,19,6,5,63,37,26,63
FC Nords,4208,3,13,8,9,72,53,19,47
Copenhagen,4208,4,13,7,10,57,45,12,46
AaB,4208,5,7,14,9,40,44,-4,35
AC Horsens,4208,6,6,13,11,34,53,-19,31
Sonderjyske,4208,7,8,6,10,28,29,-1,30
Lyngby,4208,8,4,9,11,27,44,-17,21
Randers FC,4208,9,5,6,13,23,40,-17,21
Silkeborg IF,4208,10,5,4,13,26,45,-19,19
AGF Aarhus,4208,11,4,7,11,17,37,-20,19
Brondby,4209,1,21,6,3,79,30,49,69
FC Midtjylla,4209,2,20,5,5,67,39,28,65
FC Nords,4209,3,13,7,10,72,59,13,46
Copenhagen,4209,4,12,8,10,55,43,12,44
AaB,4209,5,9,11,10,37,41,-4,38
AC Horsens,4209,6,6,13,11,35,59,-24,31
Sonderjyske,4209,7,8,6,10,28,29,-1,30
Lyngby,4209,8,4,9,11,29,46,-17,21
Randers FC,4209,9,5,6,13,25,42,-17,21
Silkeborg IF,4209,10,5,4,13,26,45,-19,19
AGF Aarhus,4209,11,4,7,11,17,37,-20,19
Brondby,4210,1,21,5,4,74,32,42,68
FC Midtjylla,4210,2,19,5,6,62,37,25,62
FC Nords,4210,3,16,7,7,75,48,27,55
Copenhagen,4210,4,14,4,12,55,45,10,46
AaB,4210,5,8,11,11,38,45,-7,35
Sonderjyske,4210,6,8,6,10,28,29,-1,30
AC Horsens,4210,7,6,12,12,34,57,-23,30
Silkeborg IF,4210,8,6,3,13,28,44,-16,21
Lyngby,4210,9,4,9,11,27,44,-17,21
Randers FC,4210,10,5,6,13,23,40,-17,21
AGF Aarhus,4210,11,4,6,12,16,39,-23,18
Brondby,4211,1,20,7,3,72,33,39,67
FC Midtjylla,4211,2,19,6,5,67,40,27,63
FC Nords,4211,3,15,8,7,78,52,26,53
Copenhagen,4211,4,15,4,11,58,44,14,49
AaB,4211,5,6,13,11,37,47,-10,31
Sonderjyske,4211,6,8,6,10,28,29,-1,30
AC Horsens,4211,7,6,12,12,34,56,-22,30
Lyngby,4211,8,4,9,11,28,44,-16,21
Randers FC,4211,9,5,6,13,23,41,-18,21
Silkeborg IF,4211,10,5,4,13,26,45,-19,19
AGF Aarhus,4211,11,4,7,11,17,37,-20,19
Brondby,4212,1,21,5,4,73,37,36,68
FC Midtjylla,4212,2,20,4,6,70,40,30,64
Copenhagen,4212,3,16,4,10,66,47,19,52
FC Nords,4212,4,14,7,9,78,57,21,49
AC Horsens,4212,5,7,13,10,39,55,-16,34
Sonderjyske,4212,6,8,6,10,28,29,-1,30
AaB,4212,7,6,11,13,35,51,-16,29
Lyngby,4212,8,4,9,11,27,44,-17,21
Randers FC,4212,9,5,6,13,23,40,-17,21
Silkeborg IF,4212,10,5,4,13,27,46,-19,19
AGF Aarhus,4212,11,4,7,11,18,38,-20,19
Brondby,4213,1,21,7,2,71,30,41,70
FC Midtjylla,4213,2,18,6,6,61,40,21,60
FC Nords,4213,3,13,9,8,74,52,22,48
Copenhagen,4213,4,13,6,11,53,42,11,45
AaB,4213,5,9,12,9,39,39,0,39
Sonderjyske,4213,6,8,6,10,28,29,-1,30
AC Horsens,4213,7,6,12,12,31,52,-21,30
Silkeborg IF,4213,8,6,3,13,29,44,-15,21
Lyngby,4213,9,4,9,11,29,46,-17,21
Randers FC,4213,10,5,6,13,25,42,-17,21
AGF Aarhus,4213,11,4,6,12,16,40,-24,18
Brondby,4214,1,21,6,3,71,30,41,69
FC Midtjylla,4214,2,19,5,6,65,38,27,62
FC Nords,4214,3,13,6,11,70,56,14,45
Copenhagen,4214,4,13,6,11,59,49,10,45
AaB,4214,5,7,15,8,39,42,-3,36
AC Horsens,4214,6,7,14,9,35,50,-15,35
Sonderjyske,4214,7,8,6,10,28,29,-1,30
Randers FC,4214,8,5,7,12,24,40,-16,22
Lyngby,4214,9,3,10,11,27,45,-18,19
Silkeborg IF,4214,10,5,4,13,26,45,-19,19
AGF Aarhus,4214,11,4,7,11,17,37,-20,19
FC Midtjylla,4215,1,21,4,5,66,40,26,67
Brondby,4215,2,19,7,4,69,34,35,64
FC Nords,4215,3,15,6,9,78,51,27,51
Copenhagen,4215,4,13,5,12,59,50,9,44
AaB,4215,5,7,13,10,40,44,-4,34
AC Horsens,4215,6,7,13,10,37,56,-19,34
Sonderjyske,4215,7,8,6,10,28,29,-1,30
Randers FC,4215,8,5,7,12,24,40,-16,22
AGF Aarhus,4215,9,5,6,11,17,36,-19,21
Lyngby,4215,10,3,10,11,27,45,-18,19
Silkeborg IF,4215,11,5,3,14,25,45,-20,18
Brondby,4216,1,21,6,3,72,33,39,69
FC Midtjylla,4216,2,20,4,6,67,38,29,64
Copenhagen,4216,3,16,5,9,62,40,22,53
FC Nords,4216,4,13,7,10,70,54,16,46
AaB,4216,5,7,12,11,34,46,-12,33
Sonderjyske,4216,6,8,6,10,28,29,-1,30
AC Horsens,4216,7,6,12,12,32,52,-20,30
Randers FC,4216,8,5,7,12,23,39,-16,22
AGF Aarhus,4216,9,5,6,11,18,37,-19,21
Lyngby,4216,10,3,10,11,26,44,-18,19
Silkeborg IF,4216,11,5,3,14,26,46,-20,18
Brondby,4217,1,19,7,4,71,39,32,64
FC Midtjylla,4217,2,18,6,6,60,40,20,60
FC Nords,4217,3,13,8,9,76,54,22,47
Copenhagen,4217,4,14,5,11,61,47,14,47
AC Horsens,4217,5,9,13,8,39,50,-11,40
AaB,4217,6,7,13,10,35,38,-3,34
Sonderjyske,4217,7,8,6,10,28,29,-1,30
Randers FC,4217,8,6,6,12,26,41,-15,24
Silkeborg IF,4217,9,6,3,13,26,44,-18,21
Lyngby,4217,10,3,9,12,28,47,-19,18
AGF Aarhus,4217,11,4,6,12,16,37,-21,18
Brondby,4218,1,21,6,3,73,34,39,69
FC Midtjylla,4218,2,18,4,8,64,42,22,58
Copenhagen,4218,3,15,5,10,57,41,16,50
FC Nords,4218,4,14,6,10,72,53,19,48
AC Horsens,4218,5,9,12,9,38,50,-12,39
AaB,4218,6,7,11,12,36,46,-10,32
Sonderjyske,4218,7,8,6,10,28,29,-1,30
Lyngby,4218,8,4,9,11,29,44,-15,21
Silkeborg IF,4218,9,6,3,13,26,44,-18,21
Randers FC,4218,10,5,6,13,23,42,-19,21
AGF Aarhus,4218,11,4,6,12,16,37,-21,18
Brondby,4219,1,20,5,5,68,33,35,65
FC Midtjylla,4219,2,18,7,5,62,40,22,61
Copenhagen,4219,3,15,5,10,59,42,17,50
FC Nords,4219,4,13,8,9,70,50,20,47
AaB,4219,5,9,12,9,41,41,0,39
AC Horsens,4219,6,6,13,11,31,51,-20,31
Sonderjyske,4219,7,8,6,10,28,29,-1,30
Randers FC,4219,8,6,6,12,26,40,-14,24
Silkeborg IF,4219,9,6,3,13,28,44,-16,21
Lyngby,4219,10,3,9,12,27,47,-20,18
AGF Aarhus,4219,11,4,6,12,16,39,-23,18
Brondby,4220,1,21,5,4,67,31,36,68
FC Midtjylla,4220,2,18,6,6,62,37,25,60
FC Nords,4220,3,13,9,8,69,49,20,48
Copenhagen,4220,4,14,6,10,60,47,13,48
AC Horsens,4220,5,6,16,8,33,47,-14,34
AaB,4220,6,7,12,11,37,43,-6,33
Sonderjyske,4220,7,8,6,10,28,29,-1,30
Silkeborg IF,4220,8,6,3,13,29,46,-17,21
Lyngby,4220,9,4,9,11,28,45,-17,21
Randers FC,4220,10,5,6,13,24,41,-17,21
AGF Aarhus,4220,11,4,6,12,18,40,-22,18
Brondby,4221,1,19,8,3,71,34,37,65
FC Midtjylla,4221,2,18,8,4,63,36,27,62
Copenhagen,4221,3,15,5,10,57,43,14,50
FC Nords,4221,4,13,9,8,76,49,27,48
AaB,4221,5,7,14,9,38,42,-4,35
Sonderjyske,4221,6,8,6,10,28,29,-1,30
AC Horsens,4221,7,6,12,12,35,62,-27,30
Silkeborg IF,4221,8,6,3,13,28,45,-17,21
Lyngby,4221,9,4,9,11,27,44,-17,21
Randers FC,4221,10,5,6,13,23,40,-17,21
AGF Aarhus,4221,11,4,6,12,17,39,-22,18
Brondby,4222,1,20,5,5,72,39,33,65
FC Midtjylla,4222,2,19,5,6,68,41,27,62
Copenhagen,4222,3,15,4,11,60,47,13,49
FC Nords,4222,4,13,7,10,70,52,18,46
AaB,4222,5,9,11,10,41,42,-1,38
AC Horsens,4222,6,8,12,10,36,52,-16,36
Sonderjyske,4222,7,8,6,10,28,29,-1,30
Lyngby,4222,8,4,9,11,27,44,-17,21
Randers FC,4222,9,5,6,13,23,40,-17,21
Silkeborg IF,4222,10,5,4,13,26,45,-19,19
AGF Aarhus,4222,11,4,7,11,17,37,-20,19
Brondby,4223,1,19,7,4,67,35,32,64
FC Midtjylla,4223,2,19,6,5,65,36,29,63
Copenhagen,4223,3,15,6,9,62,43,19,51
FC Nords,4223,4,14,8,8,74,53,21,50
AC Horsens,4223,5,7,12,11,32,51,-19,33
AaB,4223,6,6,13,11,35,43,-8,31
Sonderjyske,4223,7,8,6,10,28,29,-1,30
Randers FC,4223,8,5,7,12,23,39,-16,22
Silkeborg IF,4223,9,6,3,13,27,45,-18,21
Lyngby,4223,10,3,10,11,26,44,-18,19
AGF Aarhus,4223,11,4,6,12,17,38,-21,18
Brondby,4224,1,21,5,4,69,34,35,68
FC Midtjylla,4224,2,19,4,7,67,41,26,61
Copenhagen,4224,3,16,5,9,64,45,19,53
FC Nords,4224,4,14,7,9,72,51,21,49
AaB,4224,5,8,11,11,38,45,-7,35
Sonderjyske,4224,6,8,6,10,28,29,-1,30
AC Horsens,4224,7,6,12,12,32,52,-20,30
Lyngby,4224,8,4,9,11,27,44,-17,21
Randers FC,4224,9,5,6,13,23,40,-17,21
AGF Aarhus,4224,10,5,6,11,17,36,-19,21
Silkeborg IF,4224,11,5,3,14,25,45,-20,18
Brondby,4225,1,21,5,4,71,32,39,68
FC Midtjylla,4225,2,20,5,5,64,37,27,65
Copenhagen,4225,3,15,4,11,60,43,17,49
FC Nords,4225,4,14,6,10,71,50,21,48
AaB,4225,5,7,12,11,34,46,-12,33
AC Horsens,4225,6,7,12,11,35,53,-18,33
Sonderjyske,4225,7,8,6,10,28,29,-1,30
Lyngby,4225,8,4,9,11,29,46,-17,21
Randers FC,4225,9,5,6,13,25,42,-17,21
AGF Aarhus,4225,10,5,6,11,19,37,-18,21
Silkeborg IF,4225,11,5,3,14,26,47,-21,18
Brondby,4226,1,21,6,3,72,30,42,69
FC Midtjylla,4226,2,20,6,4,66,37,29,66
FC Nords,4226,3,15,6,9,74,51,23,51
Copenhagen,4226,4,12,4,14,53,50,3,40
AaB,4226,5,9,11,10,37,41,-4,38
AC Horsens,4226,6,6,13,11,34,53,-19,31
Sonderjyske,4226,7,8,6,10,28,29,-1,30
Lyngby,4226,8,4,9,11,27,44,-17,21
Randers FC,4226,9,5,6,13,23,40,-17,21
AGF Aarhus,4226,10,5,6,11,19,36,-17,21
Silkeborg IF,4226,11,5,3,14,25,47,-22,18
Brondby,4227,1,21,5,4,72,32,40,68
FC Midtjylla,4227,2,19,6,5,65,40,25,63
Copenhagen,4227,3,15,4,11,57,44,13,49
FC Nords,4227,4,14,6,10,75,55,20,48
AaB,4227,5,9,12,9,46,45,1,39
Sonderjyske,4227,6,8,6,10,28,29,-1,30
AC Horsens,4227,7,5,13,12,35,60,-25,28
Randers FC,4227,8,6,6,12,24,39,-15,24
AGF Aarhus,4227,9,5,6,11,18,37,-19,21
Lyngby,4227,10,3,9,12,26,45,-19,18
Silkeborg IF,4227,11,5,3,14,26,46,-20,18
Brondby,4228,1,20,7,3,70,34,36,67
FC Midtjylla,4228,2,20,5,5,66,40,26,65
FC Nords,4228,3,14,7,9,71,48,23,49
Copenhagen,4228,4,13,5,12,57,47,10,44
AaB,4228,5,9,12,9,38,40,-2,39
Sonderjyske,4228,6,8,6,10,28,29,-1,30
AC Horsens,4228,7,5,14,11,34,53,-19,29
Randers FC,4228,8,5,7,12,24,40,-16,22
Silkeborg IF,4228,9,6,3,13,27,45,-18,21
Lyngby,4228,10,3,10,11,27,45,-18,19
AGF Aarhus,4228,11,4,6,12,17,38,-21,18
Brondby,4229,1,20,5,5,66,34,32,65
FC Midtjylla,4229,2,19,4,7,66,41,25,61
FC Nords,4229,3,16,6,8,77,52,25,54
Copenhagen,4229,4,14,6,10,59,46,13,48
AC Horsens,4229,5,7,13,10,38,53,-15,34
AaB,4229,6,7,12,11,37,43,-6,33
Sonderjyske,4229,7,8,6,10,28,29,-1,30
Randers FC,4229,8,6,6,12,25,39,-14,24
Silkeborg IF,4229,9,6,3,13,27,45,-18,21
Lyngby,4229,10,3,9,12,26,46,-20,18
AGF Aarhus,4229,11,4,6,12,17,38,-21,18
Brondby,4230,1,19,6,5,69,38,31,63
FC Midtjylla,4230,2,19,5,6,67,40,27,62
Copenhagen,4230,3,16,4,10,62,41,21,52
FC Nords,4230,4,14,6,10,71,55,16,48
AaB,4230,5,9,13,8,36,36,0,40
Sonderjyske,4230,6,8,6,10,28,29,-1,30
AC Horsens,4230,7,6,12,12,34,55,-21,30
Randers FC,4230,8,5,7,12,24,40,-16,22
AGF Aarhus,4230,9,5,6,11,17,36,-19,21
Lyngby,4230,10,3,10,11,27,45,-18,19
Silkeborg IF,4230,11,5,3,14,25,45,-20,18
FC Midtjylla,4231,1,21,4,5,65,35,30,67
Brondby,4231,2,18,6,6,66,37,29,60
FC Nords,4231,3,14,8,8,73,50,23,50
Copenhagen,4231,4,15,4,11,60,45,15,49
AaB,4231,5,8,12,10,37,41,-4,36
AC Horsens,4231,6,7,12,11,32,51,-19,33
Sonderjyske,4231,7,8,6,10,28,29,-1,30
Randers FC,4231,8,5,7,12,23,39,-16,22
AGF Aarhus,4231,9,5,6,11,17,36,-19,21
Lyngby,4231,10,3,10,11,26,44,-18,19
Silkeborg IF,4231,11,5,3,14,25,45,-20,18
Brondby,4232,1,21,7,2,72,32,40,70
FC Midtjylla,4232,2,20,4,6,63,36,27,64
FC Nords,4232,3,14,6,10,75,55,20,48
Copenhagen,4232,4,13,7,10,57,44,13,46
AC Horsens,4232,5,7,13,10,37,53,-16,34
AaB,4232,6,6,13,11,35,45,-10,31
Sonderjyske,4232,7,8,6,10,28,29,-1,30
Lyngby,4232,8,4,9,11,28,45,-17,21
Randers FC,4232,9,5,6,13,24,41,-17,21
AGF Aarhus,4232,10,5,6,11,17,36,-19,21
Silkeborg IF,4232,11,5,3,14,25,45,-20,18
Brondby,4233,1,20,7,3,70,31,39,67
FC Midtjylla,4233,2,19,5,6,66,39,27,62
FC Nords,4233,3,14,7,9,74,54,20,49
Copenhagen,4233,4,15,4,11,62,48,14,49
AaB,4233,5,8,12,10,39,43,-4,36
AC Horsens,4233,6,6,13,11,33,55,-22,31
Sonderjyske,4233,7,8,6,10,28,29,-1,30
Randers FC,4233,8,5,7,12,24,40,-16,22
Lyngby,4233,9,3,10,11,27,45,-18,19
Silkeborg IF,4233,10,5,4,13,26,45,-19,19
AGF Aarhus,4233,11,4,7,11,17,37,-20,19
Brondby,4234,1,21,6,3,71,30,41,69
FC Midtjylla,4234,2,21,4,5,70,37,33,67
FC Nords,4234,3,15,6,9,76,51,25,51
Copenhagen,4234,4,15,4,11,61,47,14,49
AaB,4234,5,7,12,11,34,44,-10,33
Sonderjyske,4234,6,8,6,10,28,29,-1,30
AC Horsens,4234,7,5,12,13,31,60,-29,27
Lyngby,4234,8,4,9,11,28,44,-16,21
Randers FC,4234,9,5,6,13,23,41,-18,21
AGF Aarhus,4234,10,5,6,11,19,37,-18,21
Silkeborg IF,4234,11,5,3,14,26,47,-21,18
Brondby,4235,1,22,6,2,73,31,42,72
FC Midtjylla,4235,2,18,6,6,64,41,23,60
FC Nords,4235,3,14,7,9,75,52,23,49
Copenhagen,4235,4,13,6,11,60,49,11,45
AaB,4235,5,7,14,9,38,42,-4,35
Sonderjyske,4235,6,8,6,10,28,29,-1,30
AC Horsens,4235,7,5,15,10,33,54,-21,30
Randers FC,4235,8,5,7,12,26,42,-16,22
Lyngby,4235,9,3,10,11,29,47,-18,19
Silkeborg IF,4235,10,5,4,13,27,46,-19,19
AGF Aarhus,4235,11,4,7,11,18,38,-20,19
Brondby,4236,1,20,7,3,70,33,37,67
FC Midtjylla,4236,2,18,6,6,58,35,23,60
FC Nords,4236,3,15,8,7,74,48,26,53
Copenhagen,4236,4,16,4,10,56,41,15,52
AaB,4236,5,7,11,12,37,43,-6,32
Sonderjyske,4236,6,8,6,10,28,29,-1,30
AC Horsens,4236,7,5,14,11,31,52,-21,29
Randers FC,4236,8,6,6,12,24,39,-15,24
Silkeborg IF,4236,9,6,3,13,27,45,-18,21
Lyngby,4236,10,3,9,12,26,45,-19,18
AGF Aarhus,4236,11,4,6,12,17,38,-21,18
Brondby,4237,1,22,6,2,74,29,45,72
FC Midtjylla,4237,2,20,5,5,65,38,27,65
FC Nords,4237,3,14,7,9,76,53,23,49
Copenhagen,4237,4,13,7,10,56,46,10,46
AC Horsens,4237,5,6,13,11,33,49,-16,31
Sonderjyske,4237,6,8,6,10,28,29,-1,30
AaB,4237,7,6,12,12,33,48,-15,30
Randers FC,4237,8,6,6,12,26,40,-14,24
Silkeborg IF,4237,9,5,4,13,26,45,-19,19
AGF Aarhus,4237,10,4,7,11,17,37,-20,19
Lyngby,4237,11,3,9,12,27,47,-20,18
Brondby,4238,1,20,6,4,68,33,35,66
FC Midtjylla,4238,2,18,5,7,61,42,19,59
Copenhagen,4238,3,14,5,11,60,44,16,47
FC Nords,4238,4,13,7,10,71,55,16,46
AaB,4238,5,9,12,9,40,40,0,39
AC Horsens,4238,6,8,13,9,38,50,-12,37
Sonderjyske,4238,7,8,6,10,28,29,-1,30
Randers FC,4238,8,5,7,12,23,39,-16,22
Silkeborg IF,4238,9,6,3,13,28,45,-17,21
Lyngby,4238,10,3,10,11,26,44,-18,19
AGF Aarhus,4238,11,4,6,12,17,39,-22,18
Brondby,4239,1,21,6,3,72,31,41,69
FC Midtjylla,4239,2,19,6,5,65,39,26,63
Copenhagen,4239,3,15,5,10,62,47,15,50
FC Nords,4239,4,13,8,9,76,60,16,47
AaB,4239,5,7,11,12,41,48,-7,32
AC Horsens,4239,6,6,14,10,35,52,-17,32
Sonderjyske,4239,7,8,6,10,28,29,-1,30
Randers FC,4239,8,5,7,12,25,41,-16,22
AGF Aarhus,4239,9,5,6,11,18,37,-19,21
Lyngby,4239,10,3,10,11,28,46,-18,19
Silkeborg IF,4239,11,5,3,14,26,46,-20,18
Brondby,4240,1,20,7,3,71,34,37,67
FC Midtjylla,4240,2,19,6,5,60,38,22,63
Copenhagen,4240,3,15,6,9,60,40,20,51
FC Nords,4240,4,12,8,10,67,51,16,44
AaB,4240,5,7,14,9,34,38,-4,35
AC Horsens,4240,6,6,13,11,36,53,-17,31
Sonderjyske,4240,7,8,6,10,28,29,-1,30
Randers FC,4240,8,5,7,12,25,41,-16,22
Silkeborg IF,4240,9,6,3,13,29,44,-15,21
Lyngby,4240,10,3,10,11,28,46,-18,19
AGF Aarhus,4240,11,4,6,12,16,40,-24,18
Brondby,4241,1,19,8,3,74,38,36,65
FC Midtjylla,4241,2,20,5,5,68,39,29,65
FC Nords,4241,3,15,7,8,76,49,27,52
Copenhagen,4241,4,14,5,11,58,47,11,47
AaB,4241,5,6,14,10,37,44,-7,32
AC Horsens,4241,6,6,13,11,34,56,-22,31
Sonderjyske,4241,7,8,6,10,28,29,-1,30
Randers FC,4241,8,5,7,12,25,41,-16,22
Lyngby,4241,9,3,10,11,28,46,-18,19
Silkeborg IF,4241,10,5,4,13,26,45,-19,19
AGF Aarhus,4241,11,4,7,11,17,37,-20,19
Brondby,4242,1,22,6,2,68,29,39,72
FC Midtjylla,4242,2,18,6,6,64,39,25,60
Copenhagen,4242,3,15,5,10,56,40,16,50
FC Nords,4242,4,13,7,10,66,49,17,46
AaB,4242,5,7,13,10,36,41,-5,34
AC Horsens,4242,6,6,13,11,31,49,-18,31
Sonderjyske,4242,7,8,6,10,28,29,-1,30
Randers FC,4242,8,6,6,12,25,40,-15,24
Silkeborg IF,4242,9,6,3,13,26,44,-18,21
Lyngby,4242,10,3,9,12,27,46,-19,18
AGF Aarhus,4242,11,4,6,12,16,37,-21,18
FC Midtjylla,4243,1,20,5,5,68,40,28,65
Brondby,4243,2,19,6,5,69,39,30,63
FC Nords,4243,3,15,6,9,77,53,24,51
Copenhagen,4243,4,15,5,10,58,42,16,50
AaB,4243,5,7,12,11,39,45,-6,33
AC Horsens,4243,6,6,14,10,36,54,-18,32
Sonderjyske,4243,7,8,6,10,28,29,-1,30
Lyngby,4243,8,4,9,11,27,44,-17,21
Randers FC,4243,9,5,6,13,23,40,-17,21
Silkeborg IF,4243,10,6,3,13,26,44,-18,21
AGF Aarhus,4243,11,4,6,12,16,37,-21,18
Brondby,4244,1,21,6,3,71,34,37,69
FC Midtjylla,4244,2,19,7,4,70,40,30,64
Copenhagen,4244,3,14,5,11,57,43,14,47
FC Nords,4244,4,12,7,11,68,56,12,43
AC Horsens,4244,5,7,14,9,35,48,-13,35
AaB,4244,6,7,13,10,38,44,-6,34
Sonderjyske,4244,7,8,6,10,28,29,-1,30
Randers FC,4244,8,6,6,12,26,41,-15,24
AGF Aarhus,4244,9,5,6,11,18,36,-18,21
Lyngby,4244,10,3,9,12,28,47,-19,18
Silkeborg IF,4244,11,5,3,14,25,46,-21,18
Brondby,4245,1,21,5,4,72,31,41,68
FC Midtjylla,4245,2,21,5,4,67,35,32,68
FC Nords,4245,3,13,6,11,68,53,15,45
Copenhagen,4245,4,13,6,11,56,44,12,45
AaB,4245,5,8,11,11,36,46,-10,35
AC Horsens,4245,6,7,13,10,36,52,-16,34
Sonderjyske,4245,7,8,6,10,28,29,-1,30
Randers FC,4245,8,6,6,12,26,40,-14,24
Silkeborg IF,4245,9,5,4,13,26,45,-19,19
AGF Aarhus,4245,10,4,7,11,17,37,-20,19
Lyngby,4245,11,3,9,12,27,47,-20,18
Brondby,4246,1,20,6,4,67,32,35,66
FC Midtjylla,4246,2,18,5,7,65,41,24,59
FC Nords,4246,3,14,8,8,73,54,19,50
Copenhagen,4246,4,15,4,11,59,45,14,49
AaB,4246,5,9,11,10,43,43,0,38
AC Horsens,4246,6,6,14,10,36,54,-18,32
Sonderjyske,4246,7,8,6,10,28,29,-1,30
Lyngby,4246,8,4,9,11,30,46,-16,21
Silkeborg IF,4246,9,6,3,13,27,45,-18,21
Randers FC,4246,10,5,6,13,25,43,-18,21
AGF Aarhus,4246,11,4,6,12,17,38,-21,18
FC Midtjylla,4247,1,20,4,6,65,37,28,64
Brondby,4247,2,19,5,6,65,37,28,62
Copenhagen,4247,3,15,5,10,60,43,17,50
FC Nords,4247,4,12,9,9,69,52,17,45
AC Horsens,4247,5,8,13,9,40,51,-11,37
AaB,4247,6,8,12,10,36,41,-5,36
Sonderjyske,4247,7,8,6,10,28,29,-1,30
Randers FC,4247,8,5,7,12,24,40,-16,22
Silkeborg IF,4247,9,6,3,13,27,45,-18,21
Lyngby,4247,10,3,10,11,27,45,-18,19
AGF Aarhus,4247,11,4,6,12,17,38,-21,18
Brondby,4248,1,20,7,3,72,34,38,67
FC Midtjylla,4248,2,19,6,5,63,36,27,63
FC Nords,4248,3,14,7,9,72,54,18,49
Copenhagen,4248,4,14,6,10,59,43,16,48
AC Horsens,4248,5,7,13,10,35,52,-17,34
AaB,4248,6,6,13,11,37,45,-8,31
Sonderjyske,4248,7,8,6,10,28,29,-1,30
Randers FC,4248,8,5,7,12,24,40,-16,22
Lyngby,4248,9,3,10,11,27,45,-18,19
Silkeborg IF,4248,10,5,4,13,26,45,-19,19
AGF Aarhus,4248,11,4,7,11,17,37,-20,19
Brondby,4249,1,20,7,3,72,34,38,67
FC Midtjylla,4249,2,18,8,4,62,37,25,62
FC Nords,4249,3,14,9,7,78,49,29,51
Copenhagen,4249,4,13,6,11,53,44,9,45
AaB,4249,5,6,14,10,34,42,-8,32
AC Horsens,4249,6,6,14,10,34,53,-19,32
Sonderjyske,4249,7,8,6,10,28,29,-1,30
Randers FC,4249,8,6,6,12,25,40,-15,24
AGF Aarhus,4249,9,5,6,11,18,36,-18,21
Lyngby,4249,10,3,9,12,27,46,-19,18
Silkeborg IF,4249,11,5,3,14,25,46,-21,18
FC Midtjylla,4250,1,20,5,5,70,39,31,65
Brondby,4250,2,19,7,4,66,31,35,64
FC Nords,4250,3,16,6,8,76,53,23,54
Copenhagen,4250,4,15,4,11,58,46,12,49
AC Horsens,4250,5,7,12,11,36,53,-17,33
Sonderjyske,4250,6,8,6,10,28,29,-1,30
AaB,4250,7,6,12,12,35,45,-10,30
Lyngby,4250,8,4,9,11,27,44,-17,21
Silkeborg IF,4250,8,6,3,13,27,44,-17,21
Randers FC,4250,10,5,6,13,23,40,-17,21
AGF Aarhus,4250,11,4,6,12,16,38,-22,18
Brondby,4251,1,20,6,4,70,34,36,66
FC Midtjylla,4251,2,19,6,5,63,37,26,63
FC Nords,4251,3,15,7,8,76,48,28,52
Copenhagen,4251,4,13,4,13,56,52,4,43
AaB,4251,5,8,12,10,37,41,-4,36
AC Horsens,4251,6,7,13,10,37,53,-16,34
Sonderjyske,4251,7,8,6,10,28,29,-1,30
Lyngby,4251,8,4,9,11,29,45,-16,21
Randers FC,4251,9,5,6,13,24,42,-18,21
AGF Aarhus,4251,10,5,6,11,18,37,-19,21
Silkeborg IF,4251,11,5,3,14,26,46,-20,18
Brondby,4252,1,20,6,4,68,35,33,66
FC Midtjylla,4252,2,19,4,7,65,42,23,61
FC Nords,4252,3,14,6,10,74,50,24,48
Copenhagen,4252,4,13,5,12,56,46,10,44
AaB,4252,5,9,13,8,41,40,1,40
AC Horsens,4252,6,8,12,10,34,51,-17,36
Sonderjyske,4252,7,8,6,10,28,29,-1,30
Lyngby,4252,8,4,9,11,32,44,-12,21
Randers FC,4252,9,5,6,13,23,45,-22,21
Silkeborg IF,4252,10,5,4,13,26,45,-19,19
AGF Aarhus,4252,11,4,7,11,17,37,-20,19
Brondby,4253,1,22,5,3,74,33,41,71
FC Midtjylla,4253,2,21,4,5,65,40,25,67
FC Nords,4253,3,14,7,9,74,51,23,49
Copenhagen,4253,4,14,6,10,61,43,18,48
Sonderjyske,4253,5,8,6,10,28,29,-1,30
AaB,4253,6,6,12,12,35,50,-15,30
AC Horsens,4253,7,6,12,12,36,54,-18,30
Lyngby,4253,8,4,9,11,28,44,-16,21
Silkeborg IF,4253,9,6,3,13,27,45,-18,21
Randers FC,4253,10,5,6,13,23,41,-18,21
AGF Aarhus,4253,11,4,6,12,17,38,-21,18
Brondby,4254,1,21,5,4,70,33,37,68
FC Midtjylla,4254,2,20,4,6,66,39,27,64
FC Nords,4254,3,16,6,8,76,50,26,54
Copenhagen,4254,4,14,5,11,55,44,11,47
AC Horsens,4254,5,7,12,11,36,51,-15,33
Sonderjyske,4254,6,8,6,10,28,29,-1,30
AaB,4254,7,6,12,12,37,49,-12,30
Silkeborg IF,4254,8,6,3,13,30,46,-16,21
Lyngby,4254,9,4,9,11,28,44,-16,21
Randers FC,4254,10,5,6,13,23,41,-18,21
AGF Aarhus,4254,11,4,6,12,18,41,-23,18
Brondby,4255,1,21,5,4,70,35,35,68
FC Midtjylla,4255,2,18,4,8,63,44,19,58
FC Nords,4255,3,14,7,9,73,53,20,49
Copenhagen,4255,4,14,5,11,64,47,17,47
AaB,4255,5,9,11,10,38,42,-4,38
AC Horsens,4255,6,8,12,10,41,54,-13,36
Sonderjyske,4255,7,8,6,10,28,29,-1,30
Randers FC,4255,8,6,6,12,26,41,-15,24
Silkeborg IF,4255,9,6,3,13,28,44,-16,21
Lyngby,4255,10,3,9,12,28,47,-19,18
AGF Aarhus,4255,11,4,6,12,16,39,-23,18
Brondby,4256,1,20,6,4,68,29,39,66
FC Midtjylla,4256,2,20,6,4,70,39,31,66
FC Nords,4256,3,15,6,9,78,54,24,51
Copenhagen,4256,4,13,7,10,58,46,12,46
AaB,4256,5,8,12,10,44,47,-3,36
Sonderjyske,4256,6,8,6,10,28,29,-1,30
AC Horsens,4256,7,5,13,12,32,61,-29,28
Randers FC,4256,8,5,7,12,24,40,-16,22
Silkeborg IF,4256,9,6,3,13,28,44,-16,21
Lyngby,4256,10,3,10,11,27,45,-18,19
AGF Aarhus,4256,11,4,6,12,16,39,-23,18
Brondby,4257,1,19,8,3,72,37,35,65
FC Midtjylla,4257,2,19,6,5,64,38,26,63
FC Nords,4257,3,15,8,7,74,47,27,53
Copenhagen,4257,4,13,7,10,57,43,14,46
AaB,4257,5,7,12,11,35,44,-9,33
AC Horsens,4257,6,6,13,11,35,54,-19,31
Sonderjyske,4257,7,8,6,10,28,29,-1,30
Lyngby,4257,8,4,9,11,29,44,-15,21
Randers FC,4257,9,5,6,13,23,42,-19,21
Silkeborg IF,4257,10,5,4,13,27,46,-19,19
AGF Aarhus,4257,11,4,7,11,18,38,-20,19
Brondby,4258,1,20,5,5,72,39,33,65
FC Midtjylla,4258,2,20,5,5,65,37,28,65
Copenhagen,4258,3,15,4,11,58,42,16,49
FC Nords,4258,4,14,6,10,74,55,19,48
AC Horsens,4258,5,8,12,10,36,52,-16,36
AaB,4258,6,7,12,11,33,39,-6,33
Sonderjyske,4258,7,8,6,10,28,29,-1,30
Randers FC,4258,8,5,7,12,23,39,-16,22
AGF Aarhus,4258,9,5,6,11,18,36,-18,21
Lyngby,4258,10,3,10,11,26,44,-18,19
Silkeborg IF,4258,11,5,3,14,25,46,-21,18
Brondby,4259,1,23,5,2,73,27,46,74
FC Midtjylla,4259,2,20,4,6,71,38,33,64
FC Nords,4259,3,14,7,9,73,55,18,49
Copenhagen,4259,4,14,4,12,56,48,8,46
AC Horsens,4259,5,7,12,11,36,55,-19,33
Sonderjyske,4259,6,8,6,10,28,29,-1,30
AaB,4259,7,6,12,12,36,48,-12,30
Randers FC,4259,8,5,7,12,24,40,-16,22
Lyngby,4259,9,3,10,11,27,45,-18,19
Silkeborg IF,4259,10,5,4,13,25,44,-19,19
AGF Aarhus,4259,11,4,7,11,16,36,-20,19
Brondby,4260,1,20,8,2,68,31,37,68
FC Midtjylla,4260,2,20,5,5,69,41,28,65
FC Nords,4260,3,15,6,9,70,48,22,51
Copenhagen,4260,4,14,5,11,62,45,17,47
AaB,4260,5,6,13,11,36,43,-7,31
AC Horsens,4260,6,6,13,11,33,56,-23,31
Sonderjyske,4260,7,8,6,10,28,29,-1,30
Randers FC,4260,8,5,7,12,24,40,-16,22
Silkeborg IF,4260,9,6,3,13,27,45,-18,21
Lyngby,4260,10,3,10,11,27,45,-18,19
AGF Aarhus,4260,11,4,6,12,17,38,-21,18
Brondby,4261,1,20,7,3,72,34,38,67
FC Midtjylla,4261,2,19,4,7,63,41,22,61
FC Nords,4261,3,14,8,8,78,54,24,50
Copenhagen,4261,4,13,4,13,58,50,8,43
AaB,4261,5,8,14,8,39,41,-2,38
AC Horsens,4261,6,7,13,10,34,50,-16,34
Sonderjyske,4261,7,8,6,10,28,29,-1,30
Randers FC,4261,8,6,6,12,25,40,-15,24
AGF Aarhus,4261,9,5,6,11,18,36,-18,21
Lyngby,4261,10,3,9,12,27,46,-19,18
Silkeborg IF,4261,11,5,3,14,25,46,-21,18
Brondby,4262,1,21,6,3,71,29,42,69
FC Midtjylla,4262,2,18,6,6,61,41,20,60
FC Nords,4262,3,13,9,8,71,48,23,48
Copenhagen,4262,4,14,6,10,55,41,14,48
AC Horsens,4262,5,7,14,9,35,48,-13,35
AaB,4262,6,7,11,12,33,45,-12,32
Sonderjyske,4262,7,8,6,10,28,29,-1,30
Lyngby,4262,8,4,9,11,30,44,-14,21
Randers FC,4262,9,5,6,13,23,43,-20,21
Silkeborg IF,4262,10,5,4,13,26,45,-19,19
AGF Aarhus,4262,11,4,7,11,17,37,-20,19
Brondby,4263,1,20,7,3,71,32,39,67
FC Midtjylla,4263,2,20,6,4,67,36,31,66
FC Nords,4263,3,15,7,8,76,51,25,52
Copenhagen,4263,4,13,8,9,57,42,15,47
Sonderjyske,4263,5,8,6,10,28,29,-1,30
AaB,4263,6,6,12,12,33,49,-16,30
AC Horsens,4263,7,6,12,12,34,54,-20,30
Randers FC,4263,8,5,7,12,24,40,-16,22
Silkeborg IF,4263,9,6,3,13,27,44,-17,21
Lyngby,4263,10,3,10,11,27,45,-18,19
AGF Aarhus,4263,11,4,6,12,16,38,-22,18
Brondby,4264,1,22,5,3,70,31,39,71
FC Midtjylla,4264,2,19,6,5,64,39,25,63
FC Nords,4264,3,13,8,9,73,51,22,47
Copenhagen,4264,4,12,5,13,53,45,8,41
AaB,4264,5,8,13,9,38,41,-3,37
AC Horsens,4264,6,7,13,10,34,51,-17,34
Sonderjyske,4264,7,8,6,10,28,29,-1,30
Randers FC,4264,8,6,6,12,24,39,-15,24
Silkeborg IF,4264,9,6,3,13,27,44,-17,21
Lyngby,4264,10,3,9,12,26,45,-19,18
AGF Aarhus,4264,11,4,6,12,16,38,-22,18
Brondby,4265,1,20,6,4,73,34,39,66
FC Midtjylla,4265,2,20,4,6,69,40,29,64
FC Nords,4265,3,14,8,8,77,55,22,50
Copenhagen,4265,4,14,5,11,54,47,7,47
AaB,4265,5,8,12,10,42,45,-3,36
AC Horsens,4265,6,6,13,11,40,60,-20,31
Sonderjyske,4265,7,8,6,10,28,29,-1,30
Randers FC,4265,8,6,6,12,28,40,-12,24
Silkeborg IF,4265,9,6,3,13,27,45,-18,21
AGF Aarhus,4265,10,4,6,12,17,38,-21,18
Lyngby,4265,11,3,9,12,27,49,-22,18
Brondby,4266,1,19,8,3,67,31,36,65
FC Midtjylla,4266,2,20,5,5,70,36,34,65
FC Nords,4266,3,15,6,9,75,52,23,51
Copenhagen,4266,4,13,6,11,53,42,11,45
AC Horsens,4266,5,7,13,10,36,53,-17,34
AaB,4266,6,7,12,11,37,50,-13,33
Sonderjyske,4266,7,8,6,10,28,29,-1,30
Silkeborg IF,4266,8,6,3,13,28,45,-17,21
Lyngby,4266,9,4,9,11,27,44,-17,21
Randers FC,4266,10,5,6,13,23,40,-17,21
AGF Aarhus,4266,11,4,6,12,17,39,-22,18
Brondby,4267,1,21,6,3,75,35,40,69
FC Midtjylla,4267,2,20,4,6,67,42,25,64
Copenhagen,4267,3,15,4,11,59,46,13,49
FC Nords,4267,4,13,6,11,73,57,16,45
AaB,4267,5,8,13,9,39,41,-2,37
AC Horsens,4267,6,6,13,11,36,54,-18,31
Sonderjyske,4267,7,8,6,10,28,29,-1,30
Randers FC,4267,8,6,6,12,26,41,-15,24
Silkeborg IF,4267,9,5,4,13,26,45,-19,19
AGF Aarhus,4267,10,4,7,11,17,37,-20,19
Lyngby,4267,11,3,9,12,28,47,-19,18
Brondby,4268,1,20,7,3,69,33,36,67
FC Midtjylla,4268,2,19,5,6,65,41,24,62
FC Nords,4268,3,16,7,7,76,47,29,55
Copenhagen,4268,4,12,7,11,55,44,11,43
AC Horsens,4268,5,7,14,9,35,52,-17,35
Sonderjyske,4268,6,8,6,10,28,29,-1,30
AaB,4268,7,6,12,12,33,42,-9,30
Randers FC,4268,8,5,7,12,24,40,-16,22
AGF Aarhus,4268,9,5,6,11,18,37,-19,21
Lyngby,4268,10,3,10,11,27,45,-18,19
Silkeborg IF,4268,11,5,3,14,26,46,-20,18
Brondby,4269,1,22,5,3,73,33,40,71
FC Midtjylla,4269,2,19,5,6,63,39,24,62
FC Nords,4269,3,15,6,9,70,47,23,51
Copenhagen,4269,4,14,5,11,57,45,12,47
AaB,4269,5,7,12,11,36,41,-5,33
AC Horsens,4269,6,6,13,11,36,56,-20,31
Sonderjyske,4269,7,8,6,10,28,29,-1,30
Lyngby,4269,8,4,9,11,27,44,-17,21
Randers FC,4269,9,5,6,13,23,40,-17,21
Silkeborg IF,4269,10,5,4,13,27,46,-19,19
AGF Aarhus,4269,11,4,7,11,18,38,-20,19
Brondby,4270,1,20,7,3,69,33,36,67
FC Midtjylla,4270,2,18,6,6,61,40,21,60
FC Nords,4270,3,15,6,9,74,49,25,51
Copenhagen,4270,4,13,6,11,58,47,11,45
AaB,4270,5,9,12,9,38,40,-2,39
Sonderjyske,4270,6,8,6,10,28,29,-1,30
AC Horsens,4270,7,5,15,10,34,51,-17,30
Randers FC,4270,8,6,6,12,26,40,-14,24
Silkeborg IF,4270,9,5,4,13,26,45,-19,19
AGF Aarhus,4270,10,4,7,11,17,37,-20,19
Lyngby,4270,11,3,9,12,27,47,-20,18
Brondby,4271,1,21,5,4,74,34,40,68
FC Midtjylla,4271,2,20,5,5,67,38,29,65
Copenhagen,4271,3,16,5,9,62,44,18,53
FC Nords,4271,4,12,8,10,73,55,18,44
AC Horsens,4271,5,7,13,10,37,52,-15,34
Sonderjyske,4271,6,8,6,10,28,29,-1,30
AaB,4271,7,6,12,12,35,51,-16,30
Randers FC,4271,8,6,6,12,24,39,-15,24
Silkeborg IF,4271,9,6,3,13,27,44,-17,21
Lyngby,4271,10,3,9,12,26,45,-19,18
AGF Aarhus,4271,11,4,6,12,16,38,-22,18
Brondby,4272,1,20,7,3,70,35,35,67
FC Midtjylla,4272,2,20,5,5,66,38,28,65
Copenhagen,4272,3,15,4,11,57,42,15,49
FC Nords,4272,4,14,6,10,71,52,19,48
AaB,4272,5,7,12,11,36,44,-8,33
AC Horsens,4272,6,7,12,11,35,50,-15,33
Sonderjyske,4272,7,8,6,10,28,29,-1,30
Randers FC,4272,8,5,7,12,23,39,-16,22
Lyngby,4272,9,3,10,11,26,44,-18,19
Silkeborg IF,4272,10,5,4,13,25,44,-19,19
AGF Aarhus,4272,11,4,7,11,16,36,-20,19
Brondby,4273,1,20,7,3,70,31,39,67
FC Midtjylla,4273,2,19,6,5,69,38,31,63
Copenhagen,4273,3,14,5,11,54,42,12,47
FC Nords,4273,4,13,7,10,70,56,14,46
AaB,4273,5,8,13,9,37,41,-4,37
AC Horsens,4273,6,6,14,10,36,54,-18,32
Sonderjyske,4273,7,8,6,10,28,29,-1,30
Randers FC,4273,8,6,6,12,24,39,-15,24
AGF Aarhus,4273,9,5,6,11,19,36,-17,21
Lyngby,4273,10,3,9,12,26,45,-19,18
Silkeborg IF,4273,11,5,3,14,25,47,-22,18
Brondby,4274,1,21,7,2,70,29,41,70
FC Midtjylla,4274,2,21,4,5,67,36,31,67
FC Nords,4274,3,14,7,9,71,53,18,49
Copenhagen,4274,4,13,4,13,56,46,10,43
AaB,4274,5,7,13,10,36,43,-7,34
AC Horsens,4274,6,6,13,11,33,52,-19,31
Sonderjyske,4274,7,8,6,10,28,29,-1,30
Lyngby,4274,8,4,9,11,29,45,-16,21
Silkeborg IF,4274,9,6,3,13,26,44,-18,21
Randers FC,4274,10,5,6,13,24,42,-18,21
AGF Aarhus,4274,11,4,6,12,16,37,-21,18
Brondby,4275,1,20,7,3,70,33,37,67
FC Midtjylla,4275,2,20,6,4,65,34,31,66
FC Nords,4275,3,15,6,9,73,53,20,51
Copenhagen,4275,4,12,5,13,56,55,1,41
AaB,4275,5,8,13,9,41,39,2,37
AC Horsens,4275,6,6,13,11,38,55,-17,31
Sonderjyske,4275,7,8,6,10,28,29,-1,30
Lyngby,4275,8,4,9,11,27,44,-17,21
Silkeborg IF,4275,8,6,3,13,27,44,-17,21
Randers FC,4275,10,5,6,13,23,40,-17,21
AGF Aarhus,4275,11,4,6,12,16,38,-22,18
FC Midtjylla,4276,1,21,4,5,68,38,30,67
Brondby,4276,2,19,6,5,65,35,30,63
FC Nords,4276,3,14,8,8,80,49,31,50
Copenhagen,4276,4,15,5,10,56,47,9,50
AaB,4276,5,8,13,9,33,36,-3,37
Sonderjyske,4276,6,8,6,10,28,29,-1,30
AC Horsens,4276,7,5,12,13,29,52,-23,27
Lyngby,4276,8,4,9,11,30,44,-14,21
AGF Aarhus,4276,9,5,6,11,18,36,-18,21
Randers FC,4276,10,5,6,13,23,43,-20,21
Silkeborg IF,4276,11,5,3,14,25,46,-21,18
Brondby,4277,1,21,6,3,72,35,37,69
FC Midtjylla,4277,2,17,7,6,63,43,20,58
Copenhagen,4277,3,15,4,11,59,44,15,49
FC Nords,4277,4,13,8,9,70,51,19,47
AaB,4277,5,9,12,9,38,39,-1,39
AC Horsens,4277,6,6,13,11,35,51,-16,31
Sonderjyske,4277,7,8,6,10,28,29,-1,30
Lyngby,4277,8,4,9,11,28,45,-17,21
Randers FC,4277,9,5,6,13,24,41,-17,21
Silkeborg IF,4277,10,5,4,13,26,45,-19,19
AGF Aarhus,4277,11,4,7,11,17,37,-20,19
Brondby,4278,1,22,5,3,78,37,41,71
FC Midtjylla,4278,2,20,4,6,71,42,29,64
FC Nords,4278,3,15,7,8,77,52,25,52
Copenhagen,4278,4,14,5,11,58,47,11,47
AaB,4278,5,6,13,11,38,47,-9,31
Sonderjyske,4278,6,8,6,10,28,29,-1,30
AC Horsens,4278,7,5,14,11,34,57,-23,29
Randers FC,4278,8,6,6,12,24,39,-15,24
AGF Aarhus,4278,9,5,6,11,18,36,-18,21
Lyngby,4278,10,3,9,12,26,45,-19,18
Silkeborg IF,4278,11,5,3,14,25,46,-21,18
Brondby,4279,1,21,6,3,66,29,37,69
FC Midtjylla,4279,2,20,5,5,63,36,27,65
FC Nords,4279,3,15,7,8,73,45,28,52
Copenhagen,4279,4,12,7,11,54,48,6,43
AC Horsens,4279,5,7,13,10,36,49,-13,34
Sonderjyske,4279,6,8,6,10,28,29,-1,30
AaB,4279,7,6,12,12,37,48,-11,30
Randers FC,4279,8,6,6,12,26,39,-13,24
AGF Aarhus,4279,9,5,6,11,18,36,-18,21
Lyngby,4279,10,3,9,12,26,47,-21,18
Silkeborg IF,4279,11,5,3,14,25,46,-21,18
Brondby,4280,1,21,6,3,73,33,40,69
FC Midtjylla,4280,2,20,4,6,68,39,29,64
Copenhagen,4280,3,15,5,10,58,41,17,50
FC Nords,4280,4,13,6,11,71,58,13,45
AaB,4280,5,8,11,11,37,43,-6,35
AC Horsens,4280,6,6,14,10,35,54,-19,32
Sonderjyske,4280,7,8,6,10,28,29,-1,30
Randers FC,4280,8,5,7,12,26,42,-16,22
AGF Aarhus,4280,9,5,6,11,19,37,-18,21
Lyngby,4280,10,3,10,11,29,47,-18,19
Silkeborg IF,4280,11,5,3,14,26,47,-21,18
FC Midtjylla,4281,1,20,5,5,71,45,26,65
Brondby,4281,2,19,6,5,66,38,28,63
FC Nords,4281,3,16,6,8,77,47,30,54
Copenhagen,4281,4,13,6,11,60,48,12,45
AaB,4281,5,7,13,10,41,44,-3,34
AC Horsens,4281,6,7,12,11,36,55,-19,33
Sonderjyske,4281,7,8,6,10,28,29,-1,30
Lyngby,4281,8,4,9,11,29,45,-16,21
Silkeborg IF,4281,9,6,3,13,28,44,-16,21
Randers FC,4281,10,5,6,13,24,42,-18,21
AGF Aarhus,4281,11,4,6,12,16,39,-23,18
Brondby,4282,1,20,6,4,71,36,35,66
FC Midtjylla,4282,2,18,6,6,61,37,24,60
Copenhagen,4282,3,14,6,10,58,43,15,48
FC Nords,4282,4,13,8,9,72,52,20,47
AaB,4282,5,8,13,9,38,41,-3,37
AC Horsens,4282,6,6,15,9,34,51,-17,33
Sonderjyske,4282,7,8,6,10,28,29,-1,30
Lyngby,4282,8,4,9,11,31,45,-14,21
Silkeborg IF,4282,9,6,3,13,27,44,-17,21
Randers FC,4282,10,5,6,13,24,44,-20,21
AGF Aarhus,4282,11,4,6,12,16,38,-22,18
FC Midtjylla,4283,1,20,6,4,67,35,32,66
Brondby,4283,2,19,6,5,65,34,31,63
FC Nords,4283,3,15,6,9,72,55,17,51
Copenhagen,4283,4,14,5,11,58,44,14,47
AaB,4283,5,8,12,10,38,39,-1,36
AC Horsens,4283,6,6,13,11,33,52,-19,31
Sonderjyske,4283,7,8,6,10,28,29,-1,30
Randers FC,4283,8,6,6,12,25,40,-15,24
Silkeborg IF,4283,9,6,3,13,29,44,-15,21
Lyngby,4283,10,3,9,12,27,46,-19,18
AGF Aarhus,4283,11,4,6,12,16,40,-24,18
Brondby,4284,1,22,5,3,74,32,42,71
FC Midtjylla,4284,2,20,5,5,67,41,26,65
FC Nords,4284,3,13,7,10,70,55,15,46
Copenhagen,4284,4,14,4,12,58,47,11,46
AaB,4284,5,8,12,10,37,40,-3,36
AC Horsens,4284,6,6,13,11,34,51,-17,31
Sonderjyske,4284,7,8,6,10,28,29,-1,30
Randers FC,4284,8,5,7,12,23,39,-16,22
Silkeborg IF,4284,9,6,3,13,30,45,-15,21
Lyngby,4284,10,3,10,11,26,44,-18,19
AGF Aarhus,4284,11,4,6,12,17,41,-24,18
Brondby,4285,1,22,6,2,77,32,45,72
FC Midtjylla,4285,2,19,6,5,66,41,25,63
FC Nords,4285,3,13,9,8,77,54,23,48
Copenhagen,4285,4,13,5,12,54,44,10,44
AaB,4285,5,7,13,10,37,45,-8,34
AC Horsens,4285,6,6,13,11,32,53,-21,31
Sonderjyske,4285,7,8,6,10,28,29,-1,30
Randers FC,4285,8,5,7,12,24,40,-16,22
Silkeborg IF,4285,9,6,3,13,29,45,-16,21
Lyngby,4285,10,3,10,11,27,45,-18,19
AGF Aarhus,4285,11,4,6,12,17,40,-23,18
Brondby,4286,1,22,5,3,69,30,39,71
FC Midtjylla,4286,2,19,5,6,61,39,22,62
Copenhagen,4286,3,14,6,10,62,47,15,48
FC Nords,4286,4,13,6,11,72,56,16,45
AaB,4286,5,8,12,10,40,42,-2,36
AC Horsens,4286,6,6,14,10,35,51,-16,32
Sonderjyske,4286,7,8,6,10,28,29,-1,30
Randers FC,4286,8,5,7,12,24,40,-16,22
Silkeborg IF,4286,9,6,3,13,27,45,-18,21
Lyngby,4286,10,3,10,11,27,45,-18,19
AGF Aarhus,4286,11,4,6,12,17,38,-21,18
Brondby,4287,1,21,5,4,73,38,35,68
FC Midtjylla,4287,2,20,5,5,68,41,27,65
FC Nords,4287,3,13,8,9,74,55,19,47
Copenhagen,4287,4,13,6,11,60,48,12,45
AaB,4287,5,8,12,10,38,44,-6,36
AC Horsens,4287,6,7,12,11,41,54,-13,33
Sonderjyske,4287,7,8,6,10,28,29,-1,30
Randers FC,4287,8,5,7,12,23,39,-16,22
Silkeborg IF,4287,9,6,3,13,28,45,-17,21
Lyngby,4287,10,3,10,11,26,44,-18,19
AGF Aarhus,4287,11,4,6,12,17,39,-22,18
Brondby,4288,1,22,5,3,71,27,44,71
FC Midtjylla,4288,2,20,5,5,67,39,28,65
FC Nords,4288,3,15,7,8,76,50,26,52
Copenhagen,4288,4,13,6,11,56,49,7,45
AC Horsens,4288,5,6,14,10,33,53,-20,32
Sonderjyske,4288,6,8,6,10,28,29,-1,30
AaB,4288,7,6,11,13,34,45,-11,29
Randers FC,4288,8,6,6,12,25,40,-15,24
Silkeborg IF,4288,9,5,4,13,26,45,-19,19
AGF Aarhus,4288,10,4,7,11,17,37,-20,19
Lyngby,4288,11,3,9,12,27,46,-19,18
Brondby,4289,1,20,6,4,73,35,38,66
FC Midtjylla,4289,2,18,6,6,63,41,22,60
FC Nords,4289,3,16,6,8,78,47,31,54
Copenhagen,4289,4,13,5,12,57,49,8,44
AaB,4289,5,8,12,10,39,44,-5,36
AC Horsens,4289,6,7,13,10,34,54,-20,34
Sonderjyske,4289,7,8,6,10,28,29,-1,30
Randers FC,4289,8,6,6,12,25,40,-15,24
Silkeborg IF,4289,9,6,3,13,27,45,-18,21
Lyngby,4289,10,3,9,12,27,46,-19,18
AGF Aarhus,4289,11,4,6,12,17,38,-21,18
Brondby,4290,1,20,6,4,67,32,35,66
FC Midtjylla,4290,2,19,5,6,61,35,26,62
FC Nords,4290,3,15,8,7,74,48,26,53
Copenhagen,4290,4,13,8,9,54,40,14,47
AaB,4290,5,7,13,10,38,43,-5,34
Sonderjyske,4290,6,8,6,10,28,29,-1,30
AC Horsens,4290,7,5,14,11,31,53,-22,29
Randers FC,4290,8,6,6,12,26,41,-15,24
Silkeborg IF,4290,9,6,3,13,27,44,-17,21
Lyngby,4290,10,3,9,12,28,47,-19,18
AGF Aarhus,4290,11,4,6,12,16,38,-22,18
Brondby,4291,1,21,6,3,68,29,39,69
FC Midtjylla,4291,2,18,6,6,64,41,23,60
FC Nords,4291,3,14,8,8,73,52,21,50
Copenhagen,4291,4,14,6,10,57,42,15,48
AC Horsens,4291,5,6,15,9,35,49,-14,33
AaB,4291,6,6,13,11,34,44,-10,31
Sonderjyske,4291,7,8,6,10,28,29,-1,30
Randers FC,4291,8,5,7,12,25,41,-16,22
Lyngby,4291,9,3,10,11,28,46,-18,19
Silkeborg IF,4291,10,5,4,13,27,46,-19,19
AGF Aarhus,4291,11,4,7,11,18,38,-20,19
Brondby,4292,1,22,6,2,80,33,47,72
FC Midtjylla,4292,2,20,5,5,68,37,31,65
Copenhagen,4292,3,14,6,10,58,43,15,48
FC Nords,4292,4,12,7,11,69,57,12,43
AC Horsens,4292,5,7,13,10,37,54,-17,34
AaB,4292,6,7,11,12,34,48,-14,32
Sonderjyske,4292,7,8,6,10,28,29,-1,30
Randers FC,4292,8,5,7,12,24,40,-16,22
Silkeborg IF,4292,9,6,3,13,28,44,-16,21
Lyngby,4292,10,3,10,11,27,45,-18,19
AGF Aarhus,4292,11,4,6,12,16,39,-23,18
FC Midtjylla,4293,1,21,5,4,67,36,31,68
Brondby,4293,2,19,8,3,69,31,38,65
FC Nords,4293,3,15,7,8,77,50,27,52
Copenhagen,4293,4,13,7,10,57,43,14,46
AaB,4293,5,7,11,12,34,47,-13,32
Sonderjyske,4293,6,8,6,10,28,29,-1,30
AC Horsens,4293,7,5,14,11,30,53,-23,29
Randers FC,4293,8,5,7,12,25,41,-16,22
Silkeborg IF,4293,9,6,3,13,27,45,-18,21
Lyngby,4293,10,3,10,11,28,46,-18,19
AGF Aarhus,4293,11,4,6,12,17,38,-21,18
Brondby,4294,1,22,6,2,72,29,43,72
FC Midtjylla,4294,2,18,6,6,62,43,19,60
FC Nords,4294,3,15,7,8,84,53,31,52
Copenhagen,4294,4,13,4,13,59,54,5,43
AaB,4294,5,7,13,10,39,44,-5,34
AC Horsens,4294,6,6,14,10,33,52,-19,32
Sonderjyske,4294,7,8,6,10,28,29,-1,30
Lyngby,4294,8,4,9,11,28,45,-17,21
Randers FC,4294,9,5,6,13,24,41,-17,21
Silkeborg IF,4294,10,6,3,13,27,45,-18,21
AGF Aarhus,4294,11,4,6,12,17,38,-21,18
Brondby,4295,1,21,6,3,75,34,41,69
FC Midtjylla,4295,2,20,5,5,70,40,30,65
Copenhagen,4295,3,12,8,10,56,44,12,44
FC Nords,4295,4,12,7,11,72,58,14,43
AaB,4295,5,8,12,10,37,45,-8,36
AC Horsens,4295,6,8,12,10,37,52,-15,36
Sonderjyske,4295,7,8,6,10,28,29,-1,30
Lyngby,4295,8,4,9,11,29,44,-15,21
Randers FC,4295,9,5,6,13,23,42,-19,21
AGF Aarhus,4295,10,5,6,11,17,36,-19,21
Silkeborg IF,4295,11,5,3,14,25,45,-20,18
Brondby,4296,1,20,7,3,71,32,39,67
FC Midtjylla,4296,2,20,6,4,65,35,30,66
FC Nords,4296,3,15,6,9,77,54,23,51
Copenhagen,4296,4,13,7,10,54,46,8,46
AaB,4296,5,7,11,12,35,43,-8,32
AC Horsens,4296,6,6,13,11,32,50,-18,31
Sonderjyske,4296,7,8,6,10,28,29,-1,30
Randers FC,4296,8,6,6,12,24,39,-15,24
AGF Aarhus,4296,9,5,6,11,17,36,-19,21
Lyngby,4296,10,3,9,12,26,45,-19,18
Silkeborg IF,4296,11,5,3,14,25,45,-20,18
Brondby,4297,1,21,5,4,68,33,35,68
FC Midtjylla,4297,2,20,6,4,67,35,32,66
FC Nords,4297,3,13,8,9,69,50,19,47
Copenhagen,4297,4,13,6,11,55,43,12,45
AaB,4297,5,7,13,10,33,41,-8,34
AC Horsens,4297,6,5,16,9,32,48,-16,31
Sonderjyske,4297,7,8,6,10,28,29,-1,30
Lyngby,4297,8,4,9,11,28,45,-17,21
Randers FC,4297,9,5,6,13,24,41,-17,21
Silkeborg IF,4297,10,5,4,13,25,44,-19,19
AGF Aarhus,4297,11,4,7,11,16,36,-20,19
Brondby,4298,1,22,5,3,73,32,41,71
FC Midtjylla,4298,2,21,4,5,70,41,29,67
FC Nords,4298,3,15,6,9,73,50,23,51
Copenhagen,4298,4,13,5,12,57,48,9,44
AaB,4298,5,7,11,12,38,48,-10,32
AC Horsens,4298,6,6,13,11,38,56,-18,31
Sonderjyske,4298,7,8,6,10,28,29,-1,30
Randers FC,4298,8,5,7,12,24,40,-16,22
AGF Aarhus,4298,9,5,6,11,17,36,-19,21
Lyngby,4298,10,3,10,11,27,45,-18,19
Silkeborg IF,4298,11,5,3,14,25,45,-20,18
FC Midtjylla,4299,1,20,6,4,71,36,35,66
Brondby,4299,2,19,6,5,66,37,29,63
FC Nords,4299,3,14,8,8,76,52,24,50
Copenhagen,4299,4,13,5,12,57,46,11,44
AaB,4299,5,8,12,10,38,48,-10,36
AC Horsens,4299,6,7,13,10,40,55,-15,34
Sonderjyske,4299,7,8,6,10,28,29,-1,30
Randers FC,4299,8,5,7,12,23,39,-16,22
AGF Aarhus,4299,9,5,6,11,17,36,-19,21
Lyngby,4299,10,3,10,11,26,44,-18,19
Silkeborg IF,4299,11,5,3,14,25,45,-20,18
Brondby,4300,1,21,6,3,72,31,41,69
FC Midtjylla,4300,2,20,5,5,67,38,29,65
FC Nords,4300,3,13,7,10,70,51,19,46
Copenhagen,4300,4,14,4,12,55,43,12,46
AaB,4300,5,9,11,10,39,45,-6,38
Sonderjyske,4300,6,8,6,10,28,29,-1,30
AC Horsens,4300,7,5,15,10,34,55,-21,30
Randers FC,4300,8,6,6,12,26,39,-13,24
Silkeborg IF,4300,9,5,4,13,26,45,-19,19
AGF Aarhus,4300,10,4,7,11,17,37,-20,19
Lyngby,4300,11,3,9,12,26,47,-21,18
Brondby,4301,1,21,7,2,76,34,42,70
FC Midtjylla,4301,2,20,4,6,71,43,28,64
FC Nords,4301,3,15,6,9,82,58,24,51
Copenhagen,4301,4,12,6,12,58,51,7,42
AaB,4301,5,7,13,10,40,46,-6,34
AC Horsens,4301,6,6,14,10,34,55,-21,32
Sonderjyske,4301,7,8,6,10,28,29,-1,30
Randers FC,4301,8,5,7,12,24,40,-16,22
Silkeborg IF,4301,9,6,3,13,27,44,-17,21
Lyngby,4301,10,3,10,11,27,45,-18,19
AGF Aarhus,4301,11,4,6,12,16,38,-22,18
Brondby,4302,1,21,6,3,69,31,38,69
FC Midtjylla,4302,2,19,6,5,67,41,26,63
Copenhagen,4302,3,15,5,10,58,44,14,50
FC Nords,4302,4,12,7,11,67,52,15,43
AaB,4302,5,9,12,9,40,39,1,39
Sonderjyske,4302,6,8,6,10,28,29,-1,30
AC Horsens,4302,7,5,14,11,30,50,-20,29
Randers FC,4302,8,5,7,12,23,39,-16,22
Silkeborg IF,4302,9,6,3,13,27,44,-17,21
Lyngby,4302,10,3,10,11,26,44,-18,19
AGF Aarhus,4302,11,4,6,12,16,38,-22,18
Brondby,4303,1,20,8,2,68,30,38,68
FC Midtjylla,4303,2,20,5,5,69,37,32,65
FC Nords,4303,3,15,6,9,76,51,25,51
Copenhagen,4303,4,13,4,13,57,51,6,43
AC Horsens,4303,5,7,13,10,37,55,-18,34
AaB,4303,6,7,12,11,38,47,-9,33
Sonderjyske,4303,7,8,6,10,28,29,-1,30
Lyngby,4303,8,4,9,11,28,44,-16,21
Randers FC,4303,9,5,6,13,23,41,-18,21
Silkeborg IF,4303,10,5,4,13,26,45,-19,19
AGF Aarhus,4303,11,4,7,11,17,37,-20,19
Brondby,4304,1,22,6,2,76,28,48,72
FC Midtjylla,4304,2,18,5,7,64,44,20,59
FC Nords,4304,3,14,7,9,71,52,19,49
Copenhagen,4304,4,12,6,12,60,52,8,42
AaB,4304,5,8,12,10,39,45,-6,36
AC Horsens,4304,6,8,12,10,36,51,-15,36
Sonderjyske,4304,7,8,6,10,28,29,-1,30
Randers FC,4304,8,5,7,12,25,41,-16,22
Lyngby,4304,9,3,10,11,28,46,-18,19
Silkeborg IF,4304,10,5,4,13,25,44,-19,19
AGF Aarhus,4304,11,4,7,11,16,36,-20,19
Brondby,4305,1,20,6,4,69,35,34,66
FC Midtjylla,4305,2,19,4,7,68,41,27,61
Copenhagen,4305,3,14,5,11,58,45,13,47
FC Nords,4305,4,13,7,10,74,57,17,46
AaB,4305,5,9,12,9,43,43,0,39
AC Horsens,4305,6,8,12,10,37,54,-17,36
Sonderjyske,4305,7,8,6,10,28,29,-1,30
Lyngby,4305,8,4,9,11,28,44,-16,21
Randers FC,4305,9,5,6,13,23,41,-18,21
AGF Aarhus,4305,10,5,6,11,18,36,-18,21
Silkeborg IF,4305,11,5,3,14,25,46,-21,18
Brondby,4306,1,21,6,3,70,30,40,69
FC Midtjylla,4306,2,20,4,6,64,37,27,64
FC Nords,4306,3,14,6,10,72,55,17,48
AaB,4306,4,10,12,8,39,36,3,42
Copenhagen,4306,5,12,4,14,54,48,6,40
AC Horsens,4306,6,7,12,11,35,54,-19,33
Sonderjyske,4306,7,8,6,10,28,29,-1,30
Randers FC,4306,8,6,6,12,24,39,-15,24
Silkeborg IF,4306,9,6,3,13,26,44,-18,21
Lyngby,4306,10,3,9,12,26,45,-19,18
AGF Aarhus,4306,11,4,6,12,16,37,-21,18
FC Midtjylla,4307,1,22,4,4,68,36,32,70
Brondby,4307,2,21,5,4,72,34,38,68
FC Nords,4307,3,14,6,10,74,50,24,48
Copenhagen,4307,4,14,4,12,56,46,10,46
AC Horsens,4307,5,7,12,11,35,57,-22,33
AaB,4307,6,7,11,12,37,45,-8,32
Sonderjyske,4307,7,8,6,10,28,29,-1,30
Randers FC,4307,8,6,6,12,28,42,-14,24
Silkeborg IF,4307,9,5,4,13,25,44,-19,19
AGF Aarhus,4307,10,4,7,11,16,36,-20,19
Lyngby,4307,11,3,9,12,29,49,-20,18
Brondby,4308,1,22,5,3,71,29,42,71
FC Midtjylla,4308,2,19,4,7,62,43,19,61
FC Nords,4308,3,17,6,7,81,47,34,57
Copenhagen,4308,4,13,5,12,55,47,8,44
AaB,4308,5,6,13,11,34,45,-11,31
AC Horsens,4308,6,6,13,11,35,53,-18,31
Sonderjyske,4308,7,8,6,10,28,29,-1,30
Lyngby,4308,8,4,9,11,29,44,-15,21
Randers FC,4308,9,5,6,13,23,42,-19,21
Silkeborg IF,4308,10,5,4,13,26,45,-19,19
AGF Aarhus,4308,11,4,7,11,17,37,-20,19
Brondby,4309,1,20,6,4,68,36,32,66
FC Midtjylla,4309,2,18,4,8,66,46,20,58
FC Nords,4309,3,16,7,7,78,51,27,55
Copenhagen,4309,4,14,6,10,63,46,17,48
AC Horsens,4309,5,7,13,10,37,49,-12,34
AaB,4309,6,7,12,11,37,47,-10,33
Sonderjyske,4309,7,8,6,10,28,29,-1,30
Randers FC,4309,8,6,6,12,25,40,-15,24
Silkeborg IF,4309,9,5,4,13,26,45,-19,19
AGF Aarhus,4309,10,4,7,11,17,37,-20,19
Lyngby,4309,11,3,9,12,27,46,-19,18
Brondby,4310,1,19,7,4,71,34,37,64
FC Midtjylla,4310,2,18,6,6,62,43,19,60
Copenhagen,4310,3,15,4,11,59,43,16,49
FC Nords,4310,4,14,6,10,72,58,14,48
AaB,4310,5,9,12,9,45,43,2,39
AC Horsens,4310,6,7,13,10,35,49,-14,34
Sonderjyske,4310,7,8,6,10,28,29,-1,30
Lyngby,4310,8,4,9,11,28,45,-17,21
Randers FC,4310,9,5,6,13,24,41,-17,21
AGF Aarhus,4310,10,5,6,11,18,36,-18,21
Silkeborg IF,4310,11,5,3,14,25,46,-21,18
Brondby,4311,1,22,6,2,73,30,43,72
FC Midtjylla,4311,2,21,4,5,74,43,31,67
FC Nords,4311,3,13,7,10,74,55,19,46
Copenhagen,4311,4,13,4,13,57,49,8,43
AC Horsens,4311,5,8,12,10,43,58,-15,36
AaB,4311,6,7,11,12,33,45,-12,32
Sonderjyske,4311,7,8,6,10,28,29,-1,30
Randers FC,4311,8,5,7,12,25,41,-16,22
Lyngby,4311,9,3,10,11,28,46,-18,19
Silkeborg IF,4311,10,5,4,13,26,45,-19,19
AGF Aarhus,4311,11,4,7,11,17,37,-20,19
Brondby,4312,1,20,6,4,66,31,35,66
FC Midtjylla,4312,2,20,5,5,68,37,31,65
Copenhagen,4312,3,14,6,10,55,40,15,48
FC Nords,4312,4,12,7,11,72,60,12,43
AC Horsens,4312,5,8,13,9,37,48,-11,37
AaB,4312,6,7,13,10,32,40,-8,34
Sonderjyske,4312,7,8,6,10,28,29,-1,30
Randers FC,4312,8,5,7,12,24,40,-16,22
Lyngby,4312,9,3,10,11,27,45,-18,19
Silkeborg IF,4312,10,5,4,13,27,46,-19,19
AGF Aarhus,4312,11,4,7,11,18,38,-20,19
Brondby,4313,1,21,5,4,73,35,38,68
FC Midtjylla,4313,2,18,6,6,66,44,22,60
FC Nords,4313,3,15,7,8,83,51,32,52
Copenhagen,4313,4,15,4,11,55,45,10,49
AaB,4313,5,8,13,9,42,46,-4,37
Sonderjyske,4313,6,8,6,10,28,29,-1,30
AC Horsens,4313,7,5,13,12,35,59,-24,28
Randers FC,4313,8,5,7,12,23,39,-16,22
AGF Aarhus,4313,9,5,6,11,18,37,-19,21
Lyngby,4313,10,3,10,11,26,44,-18,19
Silkeborg IF,4313,11,5,3,14,26,46,-20,18
Brondby,4314,1,22,5,3,73,32,41,71
FC Midtjylla,4314,2,19,5,6,62,39,23,62
FC Nords,4314,3,14,7,9,73,51,22,49
Copenhagen,4314,4,14,5,11,58,42,16,47
AaB,4314,5,9,12,9,39,43,-4,39
Sonderjyske,4314,6,8,6,10,28,29,-1,30
AC Horsens,4314,7,5,12,13,31,55,-24,27
Randers FC,4314,8,5,7,12,24,40,-16,22
Lyngby,4314,9,3,10,11,27,45,-18,19
Silkeborg IF,4314,10,5,4,13,26,45,-19,19
AGF Aarhus,4314,11,4,7,11,17,37,-20,19
Brondby,4315,1,22,6,2,70,29,41,72
FC Midtjylla,4315,2,20,4,6,65,42,23,64
FC Nords,4315,3,14,8,8,74,49,25,50
Copenhagen,4315,4,14,4,12,57,43,14,46
AaB,4315,5,7,12,11,36,43,-7,33
Sonderjyske,4315,6,8,6,10,28,29,-1,30
AC Horsens,4315,7,6,12,12,36,58,-22,30
Lyngby,4315,8,4,9,11,29,46,-17,21
Randers FC,4315,9,5,6,13,25,42,-17,21
Silkeborg IF,4315,10,6,3,13,26,44,-18,21
AGF Aarhus,4315,11,4,6,12,16,37,-21,18
Brondby,4316,1,21,6,3,71,32,39,69
FC Midtjylla,4316,2,21,4,5,68,38,30,67
FC Nords,4316,3,13,6,11,72,54,18,45
Copenhagen,4316,4,13,5,12,57,52,5,44
AaB,4316,5,7,14,9,35,39,-4,35
AC Horsens,4316,6,7,13,10,36,50,-14,34
Sonderjyske,4316,7,8,6,10,28,29,-1,30
Lyngby,4316,8,4,9,11,28,44,-16,21
Randers FC,4316,9,5,6,13,23,41,-18,21
Silkeborg IF,4316,10,5,4,13,25,44,-19,19
AGF Aarhus,4316,11,4,7,11,16,36,-20,19
Brondby,4317,1,21,7,2,68,29,39,70
FC Midtjylla,4317,2,19,6,5,67,39,28,63
FC Nords,4317,3,16,6,8,80,50,30,54
Copenhagen,4317,4,13,6,11,56,48,8,45
AaB,4317,5,7,11,12,37,46,-9,32
Sonderjyske,4317,6,8,6,10,28,29,-1,30
AC Horsens,4317,7,6,12,12,37,59,-22,30
Randers FC,4317,8,6,6,12,26,41,-15,24
Silkeborg IF,4317,9,5,4,13,26,45,-19,19
AGF Aarhus,4317,10,4,7,11,17,37,-20,19
Lyngby,4317,11,3,9,12,28,47,-19,18
Brondby,4318,1,21,6,3,70,32,38,69
FC Midtjylla,4318,2,19,5,6,66,46,20,62
Copenhagen,4318,3,15,5,10,67,50,17,50
FC Nords,4318,4,13,9,8,73,49,24,48
AC Horsens,4318,5,6,14,10,38,54,-16,32
AaB,4318,6,6,13,11,33,42,-9,31
Sonderjyske,4318,7,8,6,10,28,29,-1,30
Randers FC,4318,8,5,7,12,23,39,-16,22
Silkeborg IF,4318,9,6,3,13,28,46,-18,21
Lyngby,4318,10,3,10,11,26,44,-18,19
AGF Aarhus,4318,11,4,6,12,18,39,-21,18
Brondby,4319,1,20,6,4,67,34,33,66
FC Midtjylla,4319,2,20,4,6,62,37,25,64
Copenhagen,4319,3,16,4,10,62,45,17,52
FC Nords,4319,4,13,6,11,72,53,19,45
AC Horsens,4319,5,8,12,10,37,51,-14,36
AaB,4319,6,7,12,11,37,43,-6,33
Sonderjyske,4319,7,8,6,10,28,29,-1,30
Randers FC,4319,8,5,7,12,23,39,-16,22
Silkeborg IF,4319,9,6,3,13,29,46,-17,21
Lyngby,4319,10,3,10,11,26,44,-18,19
AGF Aarhus,4319,11,4,6,12,18,40,-22,18
Brondby,4320,1,22,6,2,75,34,41,72
FC Midtjylla,4320,2,20,6,4,70,40,30,66
FC Nords,4320,3,15,6,9,80,51,29,51
Copenhagen,4320,4,12,6,12,56,54,2,42
AaB,4320,5,7,11,12,40,46,-6,32
AC Horsens,4320,6,6,13,11,36,58,-22,31
Sonderjyske,4320,7,8,6,10,28,29,-1,30
Randers FC,4320,8,5,7,12,25,41,-16,22
AGF Aarhus,4320,9,5,6,11,17,36,-19,21
Lyngby,4320,10,3,10,11,28,46,-18,19
Silkeborg IF,4320,11,5,3,14,25,45,-20,18
Brondby,4321,1,21,5,4,71,35,36,68
FC Midtjylla,4321,2,19,5,6,66,42,24,62
FC Nords,4321,3,14,7,9,71,54,17,49
Copenhagen,4321,4,12,7,11,55,45,10,43
AC Horsens,4321,5,9,12,9,36,46,-10,39
AaB,4321,6,7,12,11,41,44,-3,33
Sonderjyske,4321,7,8,6,10,28,29,-1,30
Lyngby,4321,8,4,9,11,28,44,-16,21
Silkeborg IF,4321,8,6,3,13,28,44,-16,21
Randers FC,4321,10,5,6,13,23,41,-18,21
AGF Aarhus,4321,11,4,6,12,16,39,-23,18
Brondby,4322,1,21,6,3,75,36,39,69
FC Midtjylla,4322,2,18,6,6,64,38,26,60
FC Nords,4322,3,14,7,9,73,54,19,49
Copenhagen,4322,4,13,6,11,59,48,11,45
AaB,4322,5,7,14,9,38,42,-4,35
AC Horsens,4322,6,7,13,10,35,52,-17,34
Sonderjyske,4322,7,8,6,10,28,29,-1,30
Lyngby,4322,8,4,9,11,28,44,-16,21
Silkeborg IF,4322,9,6,3,13,28,45,-17,21
Randers FC,4322,10,5,6,13,23,41,-18,21
AGF Aarhus,4322,11,4,6,12,17,39,-22,18
Brondby,4323,1,20,7,3,71,38,33,67
FC Midtjylla,4323,2,18,5,7,62,39,23,59
FC Nords,4323,3,16,6,8,82,49,33,54
Copenhagen,4323,4,14,6,10,56,46,10,48
AaB,4323,5,8,11,11,35,40,-5,35
AC Horsens,4323,6,6,13,11,35,55,-20,31
Sonderjyske,4323,7,8,6,10,28,29,-1,30
Randers FC,4323,8,6,6,12,25,39,-14,24
AGF Aarhus,4323,9,5,6,11,19,37,-18,21
Lyngby,4323,10,3,9,12,26,46,-20,18
Silkeborg IF,4323,11,5,3,14,26,47,-21,18
Brondby,4324,1,22,6,2,75,32,43,72
FC Midtjylla,4324,2,18,6,6,62,41,21,60
Copenhagen,4324,3,15,5,10,61,46,15,50
FC Nords,4324,4,13,6,11,71,58,13,45
AaB,4324,5,8,11,11,36,39,-3,35
AC Horsens,4324,6,6,14,10,38,53,-15,32
Sonderjyske,4324,7,8,6,10,28,29,-1,30
Randers FC,4324,8,6,6,12,27,40,-13,24
Silkeborg IF,4324,9,5,4,13,26,45,-19,19
AGF Aarhus,4324,10,4,7,11,17,37,-20,19
Lyngby,4324,11,3,9,12,27,48,-21,18
Brondby,4325,1,20,7,3,68,31,37,67
FC Midtjylla,4325,2,19,4,7,67,45,22,61
FC Nords,4325,3,16,6,8,77,51,26,54
Copenhagen,4325,4,14,5,11,57,46,11,47
AaB,4325,5,8,12,10,40,44,-4,36
Sonderjyske,4325,6,8,6,10,28,29,-1,30
AC Horsens,4325,7,5,14,11,35,53,-18,29
Randers FC,4325,8,6,6,12,26,41,-15,24
Silkeborg IF,4325,9,6,3,13,27,45,-18,21
Lyngby,4325,10,3,9,12,28,47,-19,18
AGF Aarhus,4325,11,4,6,12,17,38,-21,18
Brondby,4326,1,19,6,5,66,35,31,63
FC Midtjylla,4326,2,18,6,6,63,43,20,60
FC Nords,4326,3,14,7,9,74,52,22,49
Copenhagen,4326,4,15,4,11,62,45,17,49
AaB,4326,5,9,12,9,40,43,-3,39
AC Horsens,4326,6,7,13,10,38,51,-13,34
Sonderjyske,4326,7,8,6,10,28,29,-1,30
Randers FC,4326,8,5,7,12,26,42,-16,22
Silkeborg IF,4326,9,6,3,13,28,46,-18,21
Lyngby,4326,10,3,10,11,29,47,-18,19
AGF Aarhus,4326,11,4,6,12,18,39,-21,18
FC Midtjylla,4327,1,21,5,4,71,41,30,68
Brondby,4327,2,20,7,3,72,34,38,67
FC Nords,4327,3,13,8,9,75,48,27,47
Copenhagen,4327,4,12,5,13,56,55,1,41
AaB,4327,5,9,12,9,39,41,-2,39
AC Horsens,4327,6,6,13,11,33,53,-20,31
Sonderjyske,4327,7,8,6,10,28,29,-1,30
Randers FC,4327,8,5,7,12,23,39,-16,22
AGF Aarhus,4327,9,5,6,11,17,36,-19,21
Lyngby,4327,10,3,10,11,26,44,-18,19
Silkeborg IF,4327,11,5,3,14,25,45,-20,18
Brondby,4328,1,21,7,2,73,33,40,70
FC Midtjylla,4328,2,19,4,7,66,41,25,61
FC Nords,4328,3,13,9,8,76,54,22,48
Copenhagen,4328,4,13,5,12,56,48,8,44
AaB,4328,5,8,14,8,38,40,-2,38
Sonderjyske,4328,6,8,6,10,28,29,-1,30
AC Horsens,4328,7,5,15,10,37,56,-19,30
Randers FC,4328,8,6,6,12,25,39,-14,24
Silkeborg IF,4328,9,6,3,13,32,44,-12,21
Lyngby,4328,10,3,9,12,26,46,-20,18
AGF Aarhus,4328,11,4,6,12,16,43,-27,18
Brondby,4329,1,21,6,3,74,31,43,69
FC Midtjylla,4329,2,19,6,5,66,40,26,63
Copenhagen,4329,3,15,6,9,57,40,17,51
FC Nords,4329,4,14,7,9,74,51,23,49
AC Horsens,4329,5,6,14,10,35,57,-22,32
Sonderjyske,4329,6,8,6,10,28,29,-1,30
AaB,4329,7,6,11,13,32,45,-13,29
Randers FC,4329,8,5,7,12,23,39,-16,22
Lyngby,4329,9,3,10,11,26,44,-18,19
Silkeborg IF,4329,10,5,4,13,27,46,-19,19
AGF Aarhus,4329,11,4,7,11,18,38,-20,19
FC Midtjylla,4330,1,21,5,4,72,38,34,68
Brondby,4330,2,20,7,3,69,31,38,67
FC Nords,4330,3,14,7,9,72,53,19,49
Copenhagen,4330,4,13,5,12,56,49,7,44
AC Horsens,4330,5,6,15,9,40,54,-14,33
AaB,4330,6,7,11,12,35,45,-10,32
Sonderjyske,4330,7,8,6,10,28,29,-1,30
Lyngby,4330,8,4,9,11,29,46,-17,21
Randers FC,4330,9,5,6,13,25,42,-17,21
AGF Aarhus,4330,10,5,6,11,17,36,-19,21
Silkeborg IF,4330,11,5,3,14,25,45,-20,18
Brondby,4331,1,22,6,2,72,30,42,72
FC Midtjylla,4331,2,19,5,6,65,41,24,62
Copenhagen,4331,3,14,5,11,55,47,8,47
FC Nords,4331,4,13,7,10,69,51,18,46
AaB,4331,5,8,12,10,38,38,0,36
Sonderjyske,4331,6,8,6,10,28,29,-1,30
AC Horsens,4331,7,5,15,10,32,50,-18,30
Lyngby,4331,8,4,9,11,30,45,-15,21
Randers FC,4331,9,5,6,13,24,43,-19,21
AGF Aarhus,4331,10,5,6,11,20,39,-19,21
Silkeborg IF,4331,11,5,3,14,28,48,-20,18
FC Midtjylla,4332,1,21,4,5,66,34,32,67
Brondby,4332,2,19,7,4,67,34,33,64
FC Nords,4332,3,15,7,8,74,53,21,52
Copenhagen,4332,4,13,6,11,56,46,10,45
AaB,4332,5,7,13,10,35,40,-5,34
Sonderjyske,4332,6,8,6,10,28,29,-1,30
AC Horsens,4332,7,5,15,10,33,50,-17,30
Randers FC,4332,8,6,6,12,26,41,-15,24
Silkeborg IF,4332,9,6,3,13,27,45,-18,21
Lyngby,4332,10,3,9,12,28,47,-19,18
AGF Aarhus,4332,11,4,6,12,17,38,-21,18
Brondby,4333,1,21,5,4,75,36,39,68
FC Midtjylla,4333,2,18,5,7,62,42,20,59
FC Nords,4333,3,16,6,8,76,53,23,54
Copenhagen,4333,4,13,4,13,56,51,5,43
AaB,4333,5,9,11,10,37,40,-3,38
AC Horsens,4333,6,7,13,10,39,49,-10,34
Sonderjyske,4333,7,8,6,10,28,29,-1,30
Lyngby,4333,8,4,9,11,29,45,-16,21
Randers FC,4333,9,5,6,13,24,42,-18,21
Silkeborg IF,4333,10,5,4,13,25,44,-19,19
AGF Aarhus,4333,11,4,7,11,16,36,-20,19
Brondby,4334,1,22,5,3,81,32,49,71
FC Midtjylla,4334,2,19,5,6,63,43,20,62
FC Nords,4334,3,15,7,8,80,52,28,52
Copenhagen,4334,4,14,6,10,57,43,14,48
AaB,4334,5,7,12,11,34,44,-10,33
Sonderjyske,4334,6,8,6,10,28,29,-1,30
AC Horsens,4334,7,5,13,12,34,61,-27,28
Lyngby,4334,8,4,9,11,27,44,-17,21
Randers FC,4334,9,5,6,13,23,40,-17,21
Silkeborg IF,4334,10,5,4,13,27,46,-19,19
AGF Aarhus,4334,11,4,7,11,18,38,-20,19
Brondby,4335,1,22,5,3,73,31,42,71
FC Midtjylla,4335,2,18,6,6,59,38,21,60
FC Nords,4335,3,15,7,8,75,48,27,52
Copenhagen,4335,4,15,4,11,58,43,15,49
AaB,4335,5,7,11,12,37,48,-11,32
AC Horsens,4335,6,6,13,11,32,52,-20,31
Sonderjyske,4335,7,8,6,10,28,29,-1,30
Lyngby,4335,8,4,9,11,28,44,-16,21
Silkeborg IF,4335,9,6,3,13,27,44,-17,21
Randers FC,4335,10,5,6,13,23,41,-18,21
AGF Aarhus,4335,11,4,6,12,16,38,-22,18
Brondby,4336,1,20,6,4,72,38,34,66
FC Midtjylla,4336,2,20,4,6,70,42,28,64
Copenhagen,4336,3,17,4,9,68,42,26,55
FC Nords,4336,4,13,7,10,70,55,15,46
AaB,4336,5,7,12,11,36,43,-7,33
AC Horsens,4336,6,6,13,11,33,55,-22,31
Sonderjyske,4336,7,8,6,10,28,29,-1,30
Lyngby,4336,8,4,9,11,28,44,-16,21
Silkeborg IF,4336,9,6,3,13,27,44,-17,21
Randers FC,4336,10,5,6,13,23,41,-18,21
AGF Aarhus,4336,11,4,6,12,16,38,-22,18
Brondby,4337,1,20,7,3,72,34,38,67
FC Midtjylla,4337,2,20,5,5,70,37,33,65
Copenhagen,4337,3,15,5,10,57,42,15,50
FC Nords,4337,4,13,7,10,70,55,15,46
AaB,4337,5,8,13,9,37,43,-6,37
Sonderjyske,4337,6,8,6,10,28,29,-1,30
AC Horsens,4337,7,5,13,12,30,51,-21,28
Randers FC,4337,8,6,6,12,24,39,-15,24
AGF Aarhus,4337,9,5,6,11,18,36,-18,21
Lyngby,4337,10,3,9,12,26,45,-19,18
Silkeborg IF,4337,11,5,3,14,25,46,-21,18
Brondby,4338,1,21,6,3,69,32,37,69
FC Midtjylla,4338,2,20,4,6,71,38,33,64
FC Nords,4338,3,15,7,8,73,49,24,52
Copenhagen,4338,4,14,4,12,59,49,10,46
AaB,4338,5,7,12,11,38,45,-7,33
AC Horsens,4338,6,6,13,11,34,57,-23,31
Sonderjyske,4338,7,8,6,10,28,29,-1,30
Silkeborg IF,4338,8,6,3,13,28,44,-16,21
Lyngby,4338,9,4,9,11,28,45,-17,21
Randers FC,4338,10,5,6,13,24,41,-17,21
AGF Aarhus,4338,11,4,6,12,16,39,-23,18
Brondby,4339,1,21,6,3,73,33,40,69
FC Midtjylla,4339,2,20,4,6,65,38,27,64
Copenhagen,4339,3,15,5,10,60,46,14,50
FC Nords,4339,4,14,6,10,74,53,21,48
AaB,4339,5,8,11,11,36,45,-9,35
Sonderjyske,4339,6,8,6,10,28,29,-1,30
AC Horsens,4339,7,6,12,12,34,53,-19,30
Randers FC,4339,8,5,7,12,25,41,-16,22
Silkeborg IF,4339,9,6,3,13,26,44,-18,21
Lyngby,4339,10,3,10,11,28,46,-18,19
AGF Aarhus,4339,11,4,6,12,16,37,-21,18
Brondby,4340,1,22,5,3,75,32,43,71
FC Midtjylla,4340,2,20,5,5,66,38,28,65
Copenhagen,4340,3,15,5,10,61,46,15,50
FC Nords,4340,4,13,6,11,67,52,15,45
AaB,4340,5,7,13,10,33,39,-6,34
Sonderjyske,4340,6,8,6,10,28,29,-1,30
AC Horsens,4340,7,5,14,11,33,54,-21,29
Randers FC,4340,8,6,6,12,27,39,-12,24
Silkeborg IF,4340,9,6,3,13,29,44,-15,21
Lyngby,4340,10,3,9,12,26,48,-22,18
AGF Aarhus,4340,11,4,6,12,16,40,-24,18
Brondby,4341,1,22,6,2,74,32,42,72
FC Midtjylla,4341,2,21,5,4,65,35,30,68
FC Nords,4341,3,13,8,9,69,51,18,47
Copenhagen,4341,4,12,5,13,53,46,7,41
AaB,4341,5,7,12,11,33,42,-9,33
AC Horsens,4341,6,7,12,11,38,52,-14,33
Sonderjyske,4341,7,8,6,10,28,29,-1,30
Lyngby,4341,8,4,9,11,29,44,-15,21
AGF Aarhus,4341,9,5,6,11,18,36,-18,21
Randers FC,4341,10,5,6,13,23,42,-19,21
Silkeborg IF,4341,11,5,3,14,25,46,-21,18
Brondby,4342,1,19,9,2,72,31,41,66
FC Midtjylla,4342,2,19,7,4,65,37,28,64
FC Nords,4342,3,14,8,8,76,56,20,50
Copenhagen,4342,4,12,6,12,58,51,7,42
AaB,4342,5,7,13,10,38,45,-7,34
AC Horsens,4342,6,6,15,9,35,50,-15,33
Sonderjyske,4342,7,8,6,10,28,29,-1,30
Randers FC,4342,8,5,7,12,25,41,-16,22
Silkeborg IF,4342,9,6,3,13,26,44,-18,21
Lyngby,4342,10,3,10,11,28,46,-18,19
AGF Aarhus,4342,11,4,6,12,16,37,-21,18
Brondby,4343,1,21,6,3,71,35,36,69
FC Midtjylla,4343,2,19,5,6,65,38,27,62
FC Nords,4343,3,15,7,8,71,46,25,52
Copenhagen,4343,4,14,7,9,57,40,17,49
AaB,4343,5,7,13,10,35,41,-6,34
Sonderjyske,4343,6,8,6,10,28,29,-1,30
AC Horsens,4343,7,5,12,13,33,58,-25,27
Silkeborg IF,4343,8,6,3,13,29,44,-15,21
Lyngby,4343,9,4,9,11,30,47,-17,21
Randers FC,4343,10,5,6,13,26,43,-17,21
AGF Aarhus,4343,11,4,6,12,16,40,-24,18
FC Midtjylla,4344,1,21,4,5,66,35,31,67
Brondby,4344,2,20,5,5,68,31,37,65
Copenhagen,4344,3,16,4,10,60,44,16,52
FC Nords,4344,4,13,7,10,70,53,17,46
AaB,4344,5,7,13,10,37,40,-3,34
AC Horsens,4344,6,6,13,11,32,56,-24,31
Sonderjyske,4344,7,8,6,10,28,29,-1,30
Randers FC,4344,8,6,6,12,25,40,-15,24
AGF Aarhus,4344,9,5,6,11,18,37,-19,21
Lyngby,4344,10,3,9,12,27,46,-19,18
Silkeborg IF,4344,11,5,3,14,26,46,-20,18
FC Midtjylla,4345,1,21,4,5,67,40,27,67
Brondby,4345,2,20,6,4,68,33,35,66
FC Nords,4345,3,14,7,9,70,50,20,49
Copenhagen,4345,4,14,4,12,56,45,11,46
AaB,4345,5,8,11,11,41,46,-5,35
AC Horsens,4345,6,7,12,11,37,51,-14,33
Sonderjyske,4345,7,8,6,10,28,29,-1,30
Lyngby,4345,8,4,9,11,29,45,-16,21
Randers FC,4345,9,5,6,13,24,42,-18,21
AGF Aarhus,4345,10,5,6,11,18,36,-18,21
Silkeborg IF,4345,11,5,3,14,25,46,-21,18
Brondby,4346,1,20,7,3,68,31,37,67
FC Midtjylla,4346,2,19,5,6,61,37,24,62
FC Nords,4346,3,15,7,8,77,49,28,52
Copenhagen,4346,4,13,5,12,52,44,8,44
AC Horsens,4346,5,7,14,9,37,50,-13,35
AaB,4346,6,7,12,11,35,45,-10,33
Sonderjyske,4346,7,8,6,10,28,29,-1,30
Lyngby,4346,8,4,9,11,27,44,-17,21
Randers FC,4346,9,5,6,13,23,40,-17,21
Silkeborg IF,4346,10,6,3,13,26,44,-18,21
AGF Aarhus,4346,11,4,6,12,16,37,-21,18
Brondby,4347,1,19,8,3,69,34,35,65
FC Midtjylla,4347,2,19,5,6,67,41,26,62
FC Nords,4347,3,13,9,8,72,53,19,48
Copenhagen,4347,4,12,7,11,58,49,9,43
AaB,4347,5,9,12,9,40,41,-1,39
AC Horsens,4347,6,6,15,9,35,49,-14,33
Sonderjyske,4347,7,8,6,10,28,29,-1,30
Lyngby,4347,8,4,9,11,29,45,-16,21
Silkeborg IF,4347,9,6,3,13,28,44,-16,21
Randers FC,4347,10,5,6,13,24,42,-18,21
AGF Aarhus,4347,11,4,6,12,16,39,-23,18
Brondby,4348,1,20,5,5,69,37,32,65
FC Midtjylla,4348,2,20,4,6,67,40,27,64
Copenhagen,4348,3,15,5,10,62,45,17,50
FC Nords,4348,4,12,8,10,73,57,16,44
AaB,4348,5,9,13,8,42,43,-1,40
Sonderjyske,4348,6,8,6,10,28,29,-1,30
AC Horsens,4348,7,5,15,10,35,52,-17,30
Randers FC,4348,8,5,7,12,24,40,-16,22
Silkeborg IF,4348,9,6,3,13,26,44,-18,21
Lyngby,4348,10,3,10,11,27,45,-18,19
AGF Aarhus,4348,11,4,6,12,16,37,-21,18
Brondby,4349,1,21,6,3,72,32,40,69
FC Midtjylla,4349,2,20,4,6,67,42,25,64
FC Nords,4349,3,14,7,9,75,54,21,49
Copenhagen,4349,4,13,7,10,56,43,13,46
AaB,4349,5,7,14,9,37,41,-4,35
Sonderjyske,4349,6,8,6,10,28,29,-1,30
AC Horsens,4349,7,5,14,11,34,55,-21,29
Randers FC,4349,8,6,6,12,26,41,-15,24
Silkeborg IF,4349,9,6,3,13,28,46,-18,21
Lyngby,4349,10,3,9,12,28,47,-19,18
AGF Aarhus,4349,11,4,6,12,18,39,-21,18
Brondby,4350,1,20,7,3,70,32,38,67
FC Midtjylla,4350,2,20,4,6,69,39,30,64
FC Nords,4350,3,14,8,8,73,51,22,50
Copenhagen,4350,4,14,4,12,56,48,8,46
AaB,4350,5,7,14,9,38,44,-6,35
AC Horsens,4350,6,6,13,11,33,51,-18,31
Sonderjyske,4350,7,8,6,10,28,29,-1,30
Randers FC,4350,8,5,7,12,24,40,-16,22
Silkeborg IF,4350,9,6,3,13,27,45,-18,21
Lyngby,4350,10,3,10,11,27,45,-18,19
AGF Aarhus,4350,11,4,6,12,17,38,-21,18
Brondby,4351,1,21,5,4,73,36,37,68
FC Midtjylla,4351,2,20,5,5,67,38,29,65
Copenhagen,4351,3,15,5,10,60,46,14,50
FC Nords,4351,4,13,7,10,74,52,22,46
AaB,4351,5,7,12,11,35,43,-8,33
AC Horsens,4351,6,7,12,11,34,54,-20,33
Sonderjyske,4351,7,8,6,10,28,29,-1,30
Randers FC,4351,8,5,7,12,24,40,-16,22
Lyngby,4351,9,3,10,11,27,45,-18,19
Silkeborg IF,4351,10,5,4,13,25,44,-19,19
AGF Aarhus,4351,11,4,7,11,16,36,-20,19
Brondby,4352,1,20,6,4,73,35,38,66
FC Midtjylla,4352,2,19,6,5,64,37,27,63
Copenhagen,4352,3,14,6,10,61,48,13,48
FC Nords,4352,4,13,8,9,70,48,22,47
AaB,4352,5,7,13,10,35,46,-11,34
AC Horsens,4352,6,7,13,10,34,49,-15,34
Sonderjyske,4352,7,8,6,10,28,29,-1,30
Randers FC,4352,8,6,6,12,26,41,-15,24
AGF Aarhus,4352,9,5,6,11,18,36,-18,21
Lyngby,4352,10,3,9,12,28,47,-19,18
Silkeborg IF,4352,11,5,3,14,25,46,-21,18
FC Midtjylla,4353,1,22,4,4,69,35,34,70
Brondby,4353,2,21,6,3,67,30,37,69
FC Nords,4353,3,12,8,10,70,54,16,44
Copenhagen,4353,4,13,5,12,60,47,13,44
AaB,4353,5,8,11,11,36,43,-7,35
AC Horsens,4353,6,6,14,10,33,52,-19,32
Sonderjyske,4353,7,8,6,10,28,29,-1,30
Lyngby,4353,8,4,9,11,29,45,-16,21
Silkeborg IF,4353,9,6,3,13,27,44,-17,21
Randers FC,4353,10,5,6,13,24,42,-18,21
AGF Aarhus,4353,11,4,6,12,16,38,-22,18
Brondby,4354,1,21,7,2,68,29,39,70
FC Midtjylla,4354,2,19,6,5,66,38,28,63
FC Nords,4354,3,13,7,10,69,52,17,46
Copenhagen,4354,4,14,4,12,59,49,10,46
AaB,4354,5,8,11,11,36,43,-7,35
AC Horsens,4354,6,7,13,10,35,48,-13,34
Sonderjyske,4354,7,8,6,10,28,29,-1,30
Randers FC,4354,8,5,7,12,24,40,-16,22
Silkeborg IF,4354,9,6,3,13,29,44,-15,21
Lyngby,4354,10,3,10,11,27,45,-18,19
AGF Aarhus,4354,11,4,6,12,16,40,-24,18
Brondby,4355,1,20,6,4,67,33,34,66
FC Midtjylla,4355,2,19,7,4,66,36,30,64
FC Nords,4355,3,15,6,9,72,50,22,51
Copenhagen,4355,4,12,6,12,55,47,8,42
AaB,4355,5,7,14,9,40,44,-4,35
AC Horsens,4355,6,7,13,10,35,51,-16,34
Sonderjyske,4355,7,8,6,10,28,29,-1,30
Randers FC,4355,8,6,6,12,25,39,-14,24
Silkeborg IF,4355,9,5,4,13,26,45,-19,19
AGF Aarhus,4355,10,4,7,11,17,37,-20,19
Lyngby,4355,11,3,9,12,26,46,-20,18
Brondby,4356,1,21,5,4,71,31,40,68
FC Midtjylla,4356,2,21,4,5,70,38,32,67
FC Nords,4356,3,14,6,10,74,59,15,48
Copenhagen,4356,4,14,4,12,58,45,13,46
AaB,4356,5,9,11,10,41,46,-5,38
Sonderjyske,4356,6,8,6,10,28,29,-1,30
AC Horsens,4356,7,6,12,12,35,56,-21,30
Randers FC,4356,8,6,6,12,25,40,-15,24
Silkeborg IF,4356,9,6,3,13,26,44,-18,21
Lyngby,4356,10,3,9,12,27,46,-19,18
AGF Aarhus,4356,11,4,6,12,16,37,-21,18
Brondby,4357,1,22,5,3,75,35,40,71
FC Midtjylla,4357,2,20,5,5,74,46,28,65
FC Nords,4357,3,13,7,10,73,54,19,46
Copenhagen,4357,4,13,5,12,59,50,9,44
AaB,4357,5,8,12,10,35,41,-6,36
AC Horsens,4357,6,7,12,11,37,53,-16,33
Sonderjyske,4357,7,8,6,10,28,29,-1,30
Lyngby,4357,8,4,9,11,27,44,-17,21
Randers FC,4357,9,5,6,13,23,40,-17,21
Silkeborg IF,4357,10,5,4,13,27,46,-19,19
AGF Aarhus,4357,11,4,7,11,18,38,-20,19
Brondby,4358,1,20,6,4,72,36,36,66
FC Midtjylla,4358,2,19,5,6,65,44,21,62
Copenhagen,4358,3,16,4,10,62,47,15,52
FC Nords,4358,4,13,6,11,71,54,17,45
AaB,4358,5,8,12,10,40,44,-4,36
AC Horsens,4358,6,7,13,10,40,51,-11,34
Sonderjyske,4358,7,8,6,10,28,29,-1,30
Silkeborg IF,4358,8,6,3,13,29,45,-16,21
Lyngby,4358,9,4,9,11,28,44,-16,21
Randers FC,4358,10,5,6,13,23,41,-18,21
AGF Aarhus,4358,11,4,6,12,17,40,-23,18
Brondby,4359,1,20,8,2,72,32,40,68
FC Midtjylla,4359,2,19,6,5,63,38,25,63
FC Nords,4359,3,14,8,8,78,56,22,50
Copenhagen,4359,4,12,7,11,56,49,7,43
AaB,4359,5,8,11,11,40,44,-4,35
AC Horsens,4359,6,6,14,10,34,50,-16,32
Sonderjyske,4359,7,8,6,10,28,29,-1,30
Randers FC,4359,8,5,7,12,25,41,-16,22
AGF Aarhus,4359,9,5,6,11,18,37,-19,21
Lyngby,4359,10,3,10,11,28,46,-18,19
Silkeborg IF,4359,11,5,3,14,26,46,-20,18
FC Midtjylla,4360,1,21,4,5,66,40,26,67
Brondby,4360,2,19,6,5,70,36,34,63
FC Nords,4360,3,14,6,10,74,50,24,48
Copenhagen,4360,4,13,6,11,57,48,9,45
AaB,4360,5,8,12,10,39,43,-4,36
AC Horsens,4360,6,7,14,9,34,49,-15,35
Sonderjyske,4360,7,8,6,10,28,29,-1,30
Lyngby,4360,8,4,9,11,27,44,-17,21
Randers FC,4360,9,5,6,13,23,40,-17,21
AGF Aarhus,4360,10,5,6,11,19,37,-18,21
Silkeborg IF,4360,11,5,3,14,26,47,-21,18
Brondby,4361,1,21,6,3,68,31,37,69
FC Midtjylla,4361,2,19,5,6,65,39,26,62
Copenhagen,4361,3,14,6,10,56,42,14,48
FC Nords,4361,4,13,7,10,69,53,16,46
AaB,4361,5,9,12,9,38,37,1,39
Sonderjyske,4361,6,8,6,10,28,29,-1,30
AC Horsens,4361,7,5,14,11,32,52,-20,29
Randers FC,4361,8,5,7,12,24,40,-16,22
Lyngby,4361,9,3,10,11,27,45,-18,19
Silkeborg IF,4361,10,5,4,13,27,46,-19,19
AGF Aarhus,4361,11,4,7,11,18,38,-20,19
Brondby,4362,1,22,5,3,73,37,36,71
FC Midtjylla,4362,2,18,4,8,62,42,20,58
FC Nords,4362,3,15,7,8,75,51,24,52
Copenhagen,4362,4,13,5,12,57,46,11,44
AaB,4362,5,7,14,9,40,43,-3,35
AC Horsens,4362,6,7,13,10,37,51,-14,34
Sonderjyske,4362,7,8,6,10,28,29,-1,30
Lyngby,4362,8,4,9,11,28,45,-17,21
Silkeborg IF,4362,9,6,3,13,27,44,-17,21
Randers FC,4362,10,5,6,13,24,41,-17,21
AGF Aarhus,4362,11,4,6,12,16,38,-22,18
Brondby,4363,1,21,6,3,76,34,42,69
FC Midtjylla,4363,2,21,4,5,69,36,33,67
Copenhagen,4363,3,14,5,11,55,47,8,47
FC Nords,4363,4,12,8,10,69,55,14,44
AaB,4363,5,8,11,11,38,45,-7,35
AC Horsens,4363,6,6,14,10,38,54,-16,32
Sonderjyske,4363,7,8,6,10,28,29,-1,30
Randers FC,4363,8,5,7,12,24,40,-16,22
Silkeborg IF,4363,9,6,3,13,30,44,-14,21
Lyngby,4363,10,3,10,11,27,45,-18,19
AGF Aarhus,4363,11,4,6,12,16,41,-25,18
FC Midtjylla,4364,1,20,6,4,63,33,30,66
Brondby,4364,2,19,7,4,71,36,35,64
FC Nords,4364,3,14,6,10,72,50,22,48
Copenhagen,4364,4,13,4,13,51,44,7,43
AaB,4364,5,10,11,9,39,43,-4,41
AC Horsens,4364,6,6,14,10,35,51,-16,32
Sonderjyske,4364,7,8,6,10,28,29,-1,30
Lyngby,4364,8,4,9,11,29,45,-16,21
Silkeborg IF,4364,9,6,3,13,28,44,-16,21
Randers FC,4364,10,5,6,13,24,42,-18,21
AGF Aarhus,4364,11,4,6,12,16,39,-23,18
Brondby,4365,1,20,7,3,71,34,37,67
FC Midtjylla,4365,2,19,5,6,65,41,24,62
FC Nords,4365,3,15,6,9,74,50,24,51
Copenhagen,4365,4,15,4,11,59,44,15,49
AaB,4365,5,8,12,10,40,44,-4,36
Sonderjyske,4365,6,8,6,10,28,29,-1,30
AC Horsens,4365,7,5,14,11,33,55,-22,29
Randers FC,4365,8,5,7,12,24,40,-16,22
AGF Aarhus,4365,9,5,6,11,17,36,-19,21
Lyngby,4365,10,3,10,11,27,45,-18,19
Silkeborg IF,4365,11,5,3,14,25,45,-20,18
Brondby,4366,1,21,7,2,76,34,42,70
FC Midtjylla,4366,2,19,5,6,62,39,23,62
FC Nords,4366,3,15,6,9,74,54,20,51
Copenhagen,4366,4,14,4,12,63,51,12,46
AC Horsens,4366,5,7,13,10,36,51,-15,34
AaB,4366,6,7,11,12,40,48,-8,32
Sonderjyske,4366,7,8,6,10,28,29,-1,30
Lyngby,4366,8,4,9,11,27,44,-17,21
Randers FC,4366,9,5,6,13,23,40,-17,21
Silkeborg IF,4366,10,5,4,13,26,45,-19,19
AGF Aarhus,4366,11,4,7,11,17,37,-20,19
FC Midtjylla,4367,1,22,4,4,67,34,33,70
Brondby,4367,2,20,5,5,70,35,35,65
Copenhagen,4367,3,15,4,11,59,45,14,49
FC Nords,4367,4,13,6,11,69,54,15,45
AaB,4367,5,9,11,10,37,40,-3,38
Sonderjyske,4367,6,8,6,10,28,29,-1,30
AC Horsens,4367,7,6,12,12,33,53,-20,30
Lyngby,4367,8,4,9,11,27,44,-17,21
Randers FC,4367,9,5,6,13,23,40,-17,21
Silkeborg IF,4367,10,5,4,13,26,45,-19,19
AGF Aarhus,4367,11,4,7,11,17,37,-20,19
Brondby,4368,1,21,7,2,71,29,42,70
FC Midtjylla,4368,2,19,5,6,66,41,25,62
Copenhagen,4368,3,14,5,11,58,45,13,47
FC Nords,4368,4,13,7,10,68,52,16,46
AaB,4368,5,8,13,9,36,41,-5,37
AC Horsens,4368,6,6,13,11,38,55,-17,31
Sonderjyske,4368,7,8,6,10,28,29,-1,30
Lyngby,4368,8,4,9,11,27,44,-17,21
Randers FC,4368,9,5,6,13,23,40,-17,21
AGF Aarhus,4368,10,5,6,11,20,39,-19,21
Silkeborg IF,4368,11,5,3,14,28,48,-20,18
Brondby,4369,1,20,6,4,68,34,34,66
FC Midtjylla,4369,2,19,5,6,63,39,24,62
FC Nords,4369,3,16,7,7,76,47,29,55
Copenhagen,4369,4,14,5,11,57,46,11,47
AC Horsens,4369,5,7,13,10,36,51,-15,34
Sonderjyske,4369,6,8,6,10,28,29,-1,30
AaB,4369,7,6,12,12,37,46,-9,30
Randers FC,4369,8,5,7,12,25,41,-16,22
Lyngby,4369,9,3,10,11,28,46,-18,19
Silkeborg IF,4369,10,5,4,13,27,46,-19,19
AGF Aarhus,4369,11,4,7,11,18,38,-20,19
Brondby,4370,1,20,6,4,70,38,32,66
FC Midtjylla,4370,2,19,4,7,71,44,27,61
Copenhagen,4370,3,15,5,10,62,43,19,50
FC Nords,4370,4,14,7,9,73,55,18,49
AaB,4370,5,8,12,10,40,44,-4,36
AC Horsens,4370,6,7,12,11,39,57,-18,33
Sonderjyske,4370,7,8,6,10,28,29,-1,30
Lyngby,4370,8,4,9,11,28,45,-17,21
Randers FC,4370,9,5,6,13,24,41,-17,21
AGF Aarhus,4370,10,5,6,11,18,37,-19,21
Silkeborg IF,4370,11,5,3,14,26,46,-20,18
Brondby,4371,1,22,5,3,77,33,44,71
FC Midtjylla,4371,2,19,5,6,63,41,22,62
Copenhagen,4371,3,16,5,9,67,41,26,53
FC Nords,4371,4,13,6,11,68,58,10,45
AaB,4371,5,7,12,11,36,45,-9,33
AC Horsens,4371,6,6,13,11,36,55,-19,31
Sonderjyske,4371,7,8,6,10,28,29,-1,30
Randers FC,4371,8,6,6,12,25,40,-15,24
Silkeborg IF,4371,9,6,3,13,26,44,-18,21
Lyngby,4371,10,3,9,12,27,46,-19,18
AGF Aarhus,4371,11,4,6,12,16,37,-21,18
Brondby,4372,1,21,7,2,70,31,39,70
FC Midtjylla,4372,2,19,5,6,64,40,24,62
Copenhagen,4372,3,15,5,10,62,43,19,50
FC Nords,4372,4,12,6,12,70,58,12,42
AaB,4372,5,8,12,10,36,42,-6,36
AC Horsens,4372,6,7,13,10,38,52,-14,34
Sonderjyske,4372,7,8,6,10,28,29,-1,30
Randers FC,4372,8,6,6,12,24,39,-15,24
AGF Aarhus,4372,9,5,6,11,17,36,-19,21
Lyngby,4372,10,3,9,12,26,45,-19,18
Silkeborg IF,4372,11,5,3,14,25,45,-20,18
Brondby,4373,1,22,5,3,77,33,44,71
FC Midtjylla,4373,2,19,6,5,69,42,27,63
Copenhagen,4373,3,14,5,11,61,49,12,47
FC Nords,4373,4,13,7,10,73,55,18,46
AaB,4373,5,9,11,10,40,49,-9,38
Sonderjyske,4373,6,8,6,10,28,29,-1,30
AC Horsens,4373,7,6,12,12,36,54,-18,30
Lyngby,4373,8,4,9,11,28,44,-16,21
Silkeborg IF,4373,9,6,3,13,27,44,-17,21
Randers FC,4373,10,5,6,13,23,41,-18,21
AGF Aarhus,4373,11,4,6,12,16,38,-22,18
Brondby,4374,1,20,6,4,71,33,38,66
FC Midtjylla,4374,2,20,5,5,69,37,32,65
Copenhagen,4374,3,14,6,10,58,46,12,48
FC Nords,4374,4,12,6,12,68,59,9,42
AaB,4374,5,9,11,10,42,45,-3,38
AC Horsens,4374,6,8,12,10,39,53,-14,36
Sonderjyske,4374,7,8,6,10,28,29,-1,30
Lyngby,4374,8,4,9,11,27,44,-17,21
Randers FC,4374,9,5,6,13,23,40,-17,21
AGF Aarhus,4374,10,5,6,11,18,36,-18,21
Silkeborg IF,4374,11,5,3,14,25,46,-21,18
Brondby,4375,1,21,5,4,72,34,38,68
FC Midtjylla,4375,2,18,6,6,61,41,20,60
FC Nords,4375,3,17,6,7,78,46,32,57
Copenhagen,4375,4,13,6,11,59,48,11,45
AaB,4375,5,6,14,10,35,42,-7,32
AC Horsens,4375,6,6,13,11,32,52,-20,31
Sonderjyske,4375,7,8,6,10,28,29,-1,30
Lyngby,4375,8,4,9,11,31,46,-15,21
Silkeborg IF,4375,9,6,3,13,26,44,-18,21
Randers FC,4375,10,5,6,13,25,44,-19,21
AGF Aarhus,4375,11,4,6,12,16,37,-21,18
Brondby,4376,1,22,5,3,79,30,49,71
FC Midtjylla,4376,2,20,5,5,65,38,27,65
Copenhagen,4376,3,14,6,10,58,45,13,48
FC Nords,4376,4,13,7,10,71,57,14,46
AC Horsens,4376,5,6,14,10,36,55,-19,32
AaB,4376,6,6,13,11,35,45,-10,31
Sonderjyske,4376,7,8,6,10,28,29,-1,30
Randers FC,4376,8,6,6,12,26,40,-14,24
AGF Aarhus,4376,9,5,6,11,18,37,-19,21
Lyngby,4376,10,3,9,12,27,47,-20,18
Silkeborg IF,4376,11,5,3,14,26,46,-20,18
Brondby,4377,1,20,7,3,70,34,36,67
FC Midtjylla,4377,2,19,6,5,65,40,25,63
FC Nords,4377,3,13,8,9,67,49,18,47
Copenhagen,4377,4,13,7,10,55,42,13,46
AaB,4377,5,7,13,10,37,42,-5,34
AC Horsens,4377,6,7,13,10,40,53,-13,34
Sonderjyske,4377,7,8,6,10,28,29,-1,30
Randers FC,4377,8,6,6,12,25,40,-15,24
Silkeborg IF,4377,9,5,4,13,26,45,-19,19
AGF Aarhus,4377,10,4,7,11,17,37,-20,19
Lyngby,4377,11,3,9,12,27,46,-19,18
Brondby,4378,1,20,6,4,75,32,43,66
FC Midtjylla,4378,2,17,6,7,63,49,14,57
FC Nords,4378,3,15,6,9,78,56,22,51
Copenhagen,4378,4,13,5,12,56,49,7,44
AC Horsens,4378,5,9,12,9,38,51,-13,39
AaB,4378,6,8,13,9,39,38,1,37
Sonderjyske,4378,7,8,6,10,28,29,-1,30
Randers FC,4378,8,5,7,12,25,41,-16,22
AGF Aarhus,4378,9,5,6,11,17,36,-19,21
Lyngby,4378,10,3,10,11,28,46,-18,19
Silkeborg IF,4378,11,5,3,14,25,45,-20,18
Brondby,4379,1,23,5,2,73,28,45,74
FC Midtjylla,4379,2,20,5,5,66,39,27,65
FC Nords,4379,3,14,7,9,70,49,21,49
Copenhagen,4379,4,12,7,11,52,42,10,43
AaB,4379,5,6,14,10,32,39,-7,32
Sonderjyske,4379,6,8,6,10,28,29,-1,30
AC Horsens,4379,7,5,14,11,31,53,-22,29
Randers FC,4379,8,6,6,12,25,40,-15,24
Silkeborg IF,4379,9,5,4,13,26,45,-19,19
AGF Aarhus,4379,10,4,7,11,17,37,-20,19
Lyngby,4379,11,3,9,12,27,46,-19,18
Brondby,4380,1,21,7,2,68,30,38,70
FC Midtjylla,4380,2,19,6,5,66,37,29,63
FC Nords,4380,3,13,7,10,72,55,17,46
Copenhagen,4380,4,12,7,11,53,44,9,43
AC Horsens,4380,5,8,13,9,36,49,-13,37
AaB,4380,6,7,12,11,38,44,-6,33
Sonderjyske,4380,7,8,6,10,28,29,-1,30
Randers FC,4380,8,5,7,12,25,41,-16,22
Lyngby,4380,9,3,10,11,28,46,-18,19
Silkeborg IF,4380,10,5,4,13,26,45,-19,19
AGF Aarhus,4380,11,4,7,11,17,37,-20,19
Brondby,4381,1,20,6,4,67,36,31,66
FC Midtjylla,4381,2,18,6,6,67,41,26,60
FC Nords,4381,3,14,7,9,74,54,20,49
Copenhagen,4381,4,14,6,10,59,43,16,48
AaB,4381,5,8,13,9,40,42,-2,37
AC Horsens,4381,6,6,14,10,41,58,-17,32
Sonderjyske,4381,7,8,6,10,28,29,-1,30
Randers FC,4381,8,5,7,12,25,41,-16,22
AGF Aarhus,4381,9,5,6,11,19,37,-18,21
Lyngby,4381,10,3,10,11,28,46,-18,19
Silkeborg IF,4381,11,5,3,14,26,47,-21,18
Brondby,4382,1,19,7,4,68,32,36,64
FC Midtjylla,4382,2,18,7,5,61,39,22,61
Copenhagen,4382,3,16,5,9,62,42,20,53
FC Nords,4382,4,13,7,10,76,57,19,46
AaB,4382,5,7,14,9,38,45,-7,35
AC Horsens,4382,6,6,14,10,36,52,-16,32
Sonderjyske,4382,7,8,6,10,28,29,-1,30
Lyngby,4382,8,4,9,11,28,44,-16,21
Randers FC,4382,9,5,6,13,23,41,-18,21
AGF Aarhus,4382,10,5,6,11,18,36,-18,21
Silkeborg IF,4382,11,5,3,14,25,46,-21,18
Brondby,4383,1,23,5,2,73,28,45,74
FC Midtjylla,4383,2,20,4,6,66,38,28,64
FC Nords,4383,3,14,7,9,74,55,19,49
Copenhagen,4383,4,13,6,11,59,48,11,45
AC Horsens,4383,5,6,14,10,36,54,-18,32
Sonderjyske,4383,6,8,6,10,28,29,-1,30
AaB,4383,7,6,12,12,37,48,-11,30
Randers FC,4383,8,6,6,12,24,39,-15,24
Silkeborg IF,4383,9,5,4,13,27,46,-19,19
AGF Aarhus,4383,10,4,7,11,18,38,-20,19
Lyngby,4383,11,3,9,12,26,45,-19,18
Brondby,4384,1,21,6,3,69,31,38,69
FC Midtjylla,4384,2,19,4,7,68,39,29,61
FC Nords,4384,3,15,7,8,73,50,23,52
Copenhagen,4384,4,15,5,10,56,40,16,50
AaB,4384,5,7,12,11,34,46,-12,33
Sonderjyske,4384,6,8,6,10,28,29,-1,30
AC Horsens,4384,7,6,12,12,32,52,-20,30
Lyngby,4384,8,4,9,11,27,44,-17,21
Randers FC,4384,9,5,6,13,23,40,-17,21
AGF Aarhus,4384,10,5,6,11,19,38,-19,21
Silkeborg IF,4384,11,5,3,14,27,47,-20,18
FC Midtjylla,4385,1,21,4,5,67,38,29,67
Brondby,4385,2,20,6,4,68,33,35,66
FC Nords,4385,3,14,6,10,72,50,22,48
Copenhagen,4385,4,13,5,12,53,46,7,44
AC Horsens,4385,5,8,13,9,40,52,-12,37
AaB,4385,6,7,12,11,36,43,-7,33
Sonderjyske,4385,7,8,6,10,28,29,-1,30
Randers FC,4385,8,6,6,12,24,39,-15,24
AGF Aarhus,4385,9,5,6,11,17,36,-19,21
Lyngby,4385,10,3,9,12,26,45,-19,18
Silkeborg IF,4385,11,5,3,14,25,45,-20,18
Brondby,4386,1,20,6,4,68,32,36,66
FC Midtjylla,4386,2,19,4,7,63,38,25,61
Copenhagen,4386,3,14,6,10,57,41,16,48
FC Nords,4386,4,13,6,11,70,55,15,45
AaB,4386,5,9,11,10,39,44,-5,38
AC Horsens,4386,6,8,13,9,39,52,-13,37
Sonderjyske,4386,7,8,6,10,28,29,-1,30
Lyngby,4386,8,4,9,11,29,44,-15,21
Silkeborg IF,4386,9,6,3,13,28,44,-16,21
Randers FC,4386,10,5,6,13,23,42,-19,21
AGF Aarhus,4386,11,4,6,12,16,39,-23,18
Brondby,4387,1,19,9,2,70,32,38,66
FC Midtjylla,4387,2,19,7,4,67,39,28,64
FC Nords,4387,3,14,8,8,73,51,22,50
Copenhagen,4387,4,13,6,11,59,46,13,45
AaB,4387,5,7,13,10,39,47,-8,34
AC Horsens,4387,6,6,13,11,34,53,-19,31
Sonderjyske,4387,7,8,6,10,28,29,-1,30
Randers FC,4387,8,5,7,12,24,40,-16,22
Lyngby,4387,9,3,10,11,27,45,-18,19
Silkeborg IF,4387,10,5,4,13,27,46,-19,19
AGF Aarhus,4387,11,4,7,11,18,38,-20,19
Brondby,4388,1,19,7,4,67,34,33,64
FC Midtjylla,4388,2,18,7,5,63,42,21,61
FC Nords,4388,3,14,8,8,76,50,26,50
Copenhagen,4388,4,14,5,11,57,45,12,47
AaB,4388,5,8,13,9,40,43,-3,37
AC Horsens,4388,6,6,14,10,35,50,-15,32
Sonderjyske,4388,7,8,6,10,28,29,-1,30
Randers FC,4388,8,5,7,12,25,41,-16,22
AGF Aarhus,4388,9,5,6,11,17,36,-19,21
Lyngby,4388,10,3,10,11,28,46,-18,19
Silkeborg IF,4388,11,5,3,14,25,45,-20,18
FC Midtjylla,4389,1,22,4,4,67,35,32,70
Brondby,4389,2,21,6,3,72,33,39,69
FC Nords,4389,3,13,7,10,74,56,18,46
Copenhagen,4389,4,13,6,11,56,44,12,45
AaB,4389,5,7,11,12,37,45,-8,32
AC Horsens,4389,6,6,14,10,33,52,-19,32
Sonderjyske,4389,7,8,6,10,28,29,-1,30
Randers FC,4389,8,6,6,12,26,41,-15,24
Silkeborg IF,4389,9,5,4,13,26,45,-19,19
AGF Aarhus,4389,10,4,7,11,17,37,-20,19
Lyngby,4389,11,3,9,12,28,47,-19,18
Brondby,4390,1,20,6,4,71,34,37,66
FC Midtjylla,4390,2,18,5,7,64,42,22,59
FC Nords,4390,3,14,7,9,71,51,20,49
Copenhagen,4390,4,14,5,11,58,43,15,47
AC Horsens,4390,5,9,12,9,36,51,-15,39
AaB,4390,6,6,15,9,34,39,-5,33
Sonderjyske,4390,7,8,6,10,28,29,-1,30
Randers FC,4390,8,6,6,12,24,39,-15,24
Silkeborg IF,4390,9,6,3,13,29,44,-15,21
Lyngby,4390,10,3,9,12,26,45,-19,18
AGF Aarhus,4390,11,4,6,12,16,40,-24,18
Brondby,4391,1,21,5,4,70,34,36,68
FC Midtjylla,4391,2,20,4,6,67,41,26,64
FC Nords,4391,3,15,7,8,76,51,25,52
Copenhagen,4391,4,14,4,12,60,49,11,46
AaB,4391,5,8,12,10,40,45,-5,36
Sonderjyske,4391,6,8,6,10,28,29,-1,30
AC Horsens,4391,7,6,12,12,36,55,-19,30
Randers FC,4391,8,5,7,12,23,39,-16,22
Silkeborg IF,4391,9,6,3,13,29,46,-17,21
Lyngby,4391,10,3,10,11,26,44,-18,19
AGF Aarhus,4391,11,4,6,12,18,40,-22,18
Brondby,4392,1,20,6,4,69,33,36,66
FC Midtjylla,4392,2,19,7,4,68,41,27,64
Copenhagen,4392,3,15,5,10,64,45,19,50
FC Nords,4392,4,13,8,9,72,53,19,47
AaB,4392,5,8,12,10,38,44,-6,36
Sonderjyske,4392,6,8,6,10,28,29,-1,30
AC Horsens,4392,7,6,12,12,37,58,-21,30
Randers FC,4392,8,6,6,12,25,39,-14,24
AGF Aarhus,4392,9,5,6,11,18,36,-18,21
Lyngby,4392,10,3,9,12,26,46,-20,18
Silkeborg IF,4392,11,5,3,14,25,46,-21,18
Brondby,4393,1,20,7,3,73,33,40,67
FC Midtjylla,4393,2,20,4,6,64,38,26,64
Copenhagen,4393,3,16,4,10,63,45,18,52
FC Nords,4393,4,15,6,9,76,57,19,51
AC Horsens,4393,5,6,13,11,34,51,-17,31
Sonderjyske,4393,6,8,6,10,28,29,-1,30
AaB,4393,7,6,12,12,35,47,-12,30
Lyngby,4393,8,4,9,11,32,46,-14,21
Randers FC,4393,9,5,6,13,25,45,-20,21
Silkeborg IF,4393,10,5,4,13,25,44,-19,19
AGF Aarhus,4393,11,4,7,11,16,36,-20,19
Brondby,4394,1,21,6,3,71,30,41,69
FC Midtjylla,4394,2,20,5,5,73,41,32,65
Copenhagen,4394,3,14,5,11,60,49,11,47
FC Nords,4394,4,13,7,10,69,54,15,46
AaB,4394,5,7,13,10,35,40,-5,34
AC Horsens,4394,6,6,14,10,33,53,-20,32
Sonderjyske,4394,7,8,6,10,28,29,-1,30
Lyngby,4394,8,4,9,11,27,44,-17,21
Silkeborg IF,4394,8,6,3,13,27,44,-17,21
Randers FC,4394,10,5,6,13,23,40,-17,21
AGF Aarhus,4394,11,4,6,12,16,38,-22,18
Brondby,4395,1,22,6,2,78,32,46,72
FC Midtjylla,4395,2,20,4,6,70,40,30,64
Copenhagen,4395,3,14,5,11,60,48,12,47
FC Nords,4395,4,13,7,10,74,58,16,46
AaB,4395,5,7,12,11,37,50,-13,33
AC Horsens,4395,6,5,16,9,38,55,-17,31
Sonderjyske,4395,7,8,6,10,28,29,-1,30
Randers FC,4395,8,6,6,12,24,39,-15,24
Silkeborg IF,4395,9,5,4,13,25,44,-19,19
AGF Aarhus,4395,10,4,7,11,16,36,-20,19
Lyngby,4395,11,3,9,12,26,45,-19,18
Brondby,4396,1,21,6,3,74,33,41,69
FC Midtjylla,4396,2,20,5,5,65,40,25,65
FC Nords,4396,3,15,7,8,76,48,28,52
Copenhagen,4396,4,14,5,11,62,47,15,47
AC Horsens,4396,5,7,12,11,37,57,-20,33
Sonderjyske,4396,6,8,6,10,28,29,-1,30
AaB,4396,7,6,11,13,33,48,-15,29
Randers FC,4396,8,5,7,12,24,40,-16,22
Lyngby,4396,9,3,10,11,27,45,-18,19
Silkeborg IF,4396,10,5,4,13,25,44,-19,19
AGF Aarhus,4396,11,4,7,11,16,36,-20,19
FC Midtjylla,4397,1,19,6,5,64,38,26,63
Brondby,4397,2,19,5,6,67,34,33,62
FC Nords,4397,3,16,6,8,74,47,27,54
Copenhagen,4397,4,14,5,11,58,43,15,47
AaB,4397,5,8,12,10,38,44,-6,36
AC Horsens,4397,6,6,14,10,33,54,-21,32
Sonderjyske,4397,7,8,6,10,28,29,-1,30
Lyngby,4397,8,4,9,11,28,44,-16,21
Silkeborg IF,4397,8,6,3,13,28,44,-16,21
Randers FC,4397,10,5,6,13,23,41,-18,21
AGF Aarhus,4397,11,4,6,12,16,39,-23,18
FC Midtjylla,4398,1,21,4,5,74,39,35,67
Brondby,4398,2,20,6,4,68,33,35,66
FC Nords,4398,3,13,8,9,71,54,17,47
Copenhagen,4398,4,14,5,11,61,51,10,47
AaB,4398,5,9,11,10,39,40,-1,38
Sonderjyske,4398,6,8,6,10,28,29,-1,30
AC Horsens,4398,7,6,12,12,32,54,-22,30
Lyngby,4398,8,4,9,11,31,44,-13,21
Silkeborg IF,4398,9,6,3,13,28,46,-18,21
Randers FC,4398,10,5,6,13,23,44,-21,21
AGF Aarhus,4398,11,4,6,12,18,39,-21,18
Brondby,4399,1,21,6,3,74,36,38,69
FC Midtjylla,4399,2,19,4,7,64,42,22,61
FC Nords,4399,3,14,8,8,80,55,25,50
Copenhagen,4399,4,14,6,10,59,41,18,48
AaB,4399,5,7,12,11,38,45,-7,33
AC Horsens,4399,6,7,12,11,34,56,-22,33
Sonderjyske,4399,7,8,6,10,28,29,-1,30
Randers FC,4399,8,6,6,12,24,39,-15,24
Silkeborg IF,4399,9,6,3,13,28,44,-16,21
Lyngby,4399,10,3,9,12,26,45,-19,18
AGF Aarhus,4399,11,4,6,12,16,39,-23,18
Brondby,4400,1,21,5,4,66,31,35,68
FC Midtjylla,4400,2,18,5,7,60,38,22,59
FC Nords,4400,3,13,9,8,75,51,24,48
Copenhagen,4400,4,12,4,14,55,50,5,40
AC Horsens,4400,5,9,13,8,40,50,-10,40
AaB,4400,6,9,12,9,40,42,-2,39
Sonderjyske,4400,7,8,6,10,28,29,-1,30
Lyngby,4400,8,4,9,11,28,45,-17,21
Randers FC,4400,9,5,6,13,24,41,-17,21
Silkeborg IF,4400,10,6,3,13,26,44,-18,21
AGF Aarhus,4400,11,4,6,12,16,37,-21,18
Brondby,4401,1,21,6,3,72,31,41,69
FC Midtjylla,4401,2,18,5,7,62,40,22,59
FC Nords,4401,3,15,6,9,76,52,24,51
Copenhagen,4401,4,15,5,10,59,43,16,50
AC Horsens,4401,5,7,13,10,36,52,-16,34
AaB,4401,6,6,13,11,35,48,-13,31
Sonderjyske,4401,7,8,6,10,28,29,-1,30
Lyngby,4401,8,4,9,11,29,44,-15,21
Randers FC,4401,9,5,6,13,23,42,-19,21
Silkeborg IF,4401,10,5,4,13,26,45,-19,19
AGF Aarhus,4401,11,4,7,11,17,37,-20,19
Brondby,4402,1,20,7,3,72,34,38,67
FC Midtjylla,4402,2,19,6,5,63,36,27,63
Copenhagen,4402,3,15,5,10,60,46,14,50
FC Nords,4402,4,14,6,10,73,52,21,48
AaB,4402,5,6,14,10,35,44,-9,32
AC Horsens,4402,6,6,14,10,34,51,-17,32
Sonderjyske,4402,7,8,6,10,28,29,-1,30
Lyngby,4402,8,4,9,11,30,45,-15,21
Randers FC,4402,9,5,6,13,24,43,-19,21
AGF Aarhus,4402,10,5,6,11,20,39,-19,21
Silkeborg IF,4402,11,5,3,14,28,48,-20,18
Brondby,4403,1,22,5,3,77,34,43,71
FC Midtjylla,4403,2,19,6,5,69,40,29,63
FC Nords,4403,3,14,7,9,72,53,19,49
Copenhagen,4403,4,14,4,12,57,46,11,46
AaB,4403,5,8,12,10,39,43,-4,36
Sonderjyske,4403,6,8,6,10,28,29,-1,30
AC Horsens,4403,7,6,12,12,31,55,-24,30
Lyngby,4403,8,4,9,11,30,46,-16,21
Randers FC,4403,9,5,6,13,25,43,-18,21
Silkeborg IF,4403,10,5,4,13,27,46,-19,19
AGF Aarhus,4403,11,4,7,11,18,38,-20,19
FC Midtjylla,4404,1,21,5,4,72,41,31,68
Brondby,4404,2,18,7,5,68,36,32,61
FC Nords,4404,3,14,7,9,73,52,21,49
Copenhagen,4404,4,13,5,12,60,50,10,44
AaB,4404,5,8,13,9,38,42,-4,37
AC Horsens,4404,6,7,13,10,38,54,-16,34
Sonderjyske,4404,7,8,6,10,28,29,-1,30
Randers FC,4404,8,5,7,12,24,40,-16,22
Silkeborg IF,4404,9,6,3,13,28,46,-18,21
Lyngby,4404,10,3,10,11,27,45,-18,19
AGF Aarhus,4404,11,4,6,12,18,39,-21,18
Brondby,4405,1,19,6,5,67,35,32,63
FC Midtjylla,4405,2,18,6,6,66,40,26,60
FC Nords,4405,3,16,7,7,72,47,25,55
Copenhagen,4405,4,14,6,10,58,45,13,48
AaB,4405,5,7,13,10,37,43,-6,34
AC Horsens,4405,6,6,14,10,36,52,-16,32
Sonderjyske,4405,7,8,6,10,28,29,-1,30
Lyngby,4405,8,4,9,11,29,46,-17,21
Randers FC,4405,9,5,6,13,25,42,-17,21
Silkeborg IF,4405,10,5,4,13,26,45,-19,19
AGF Aarhus,4405,11,4,7,11,17,37,-20,19
Brondby,4406,1,21,6,3,73,31,42,69
FC Midtjylla,4406,2,18,5,7,61,38,23,59
Copenhagen,4406,3,14,5,11,58,44,14,47
FC Nords,4406,4,13,7,10,70,55,15,46
AaB,4406,5,10,11,9,37,40,-3,41
AC Horsens,4406,6,7,12,11,38,55,-17,33
Sonderjyske,4406,7,8,6,10,28,29,-1,30
Randers FC,4406,8,5,7,12,24,40,-16,22
AGF Aarhus,4406,9,5,6,11,19,38,-19,21
Lyngby,4406,10,3,10,11,27,45,-18,19
Silkeborg IF,4406,11,5,3,14,27,47,-20,18
Brondby,4407,1,20,7,3,67,32,35,67
FC Midtjylla,4407,2,17,7,6,60,40,20,58
Copenhagen,4407,3,16,4,10,60,43,17,52
FC Nords,4407,4,13,9,8,73,51,22,48
AaB,4407,5,9,11,10,39,40,-1,38
Sonderjyske,4407,6,8,6,10,28,29,-1,30
AC Horsens,4407,7,5,14,11,31,50,-19,29
Randers FC,4407,8,5,7,12,24,40,-16,22
Silkeborg IF,4407,9,6,3,13,28,45,-17,21
Lyngby,4407,10,3,10,11,27,45,-18,19
AGF Aarhus,4407,11,4,6,12,17,39,-22,18
Brondby,4408,1,21,6,3,68,30,38,69
FC Midtjylla,4408,2,20,5,5,65,38,27,65
FC Nords,4408,3,14,6,10,72,53,19,48
Copenhagen,4408,4,14,4,12,58,46,12,46
AC Horsens,4408,5,8,12,10,34,49,-15,36
AaB,4408,6,7,11,12,39,46,-7,32
Sonderjyske,4408,7,8,6,10,28,29,-1,30
Randers FC,4408,8,6,6,12,26,40,-14,24
Silkeborg IF,4408,9,6,3,13,26,44,-18,21
Lyngby,4408,10,3,9,12,27,47,-20,18
AGF Aarhus,4408,11,4,6,12,16,37,-21,18
Brondby,4409,1,21,6,3,73,34,39,69
FC Midtjylla,4409,2,19,7,4,69,41,28,64
FC Nords,4409,3,14,7,9,77,57,20,49
Copenhagen,4409,4,14,4,12,59,50,9,46
AC Horsens,4409,5,7,13,10,41,53,-12,34
AaB,4409,6,6,13,11,36,46,-10,31
Sonderjyske,4409,7,8,6,10,28,29,-1,30
Randers FC,4409,8,6,6,12,24,39,-15,24
Silkeborg IF,4409,9,5,4,13,26,45,-19,19
AGF Aarhus,4409,10,4,7,11,17,37,-20,19
Lyngby,4409,11,3,9,12,26,45,-19,18
Brondby,4410,1,20,6,4,69,35,34,66
FC Midtjylla,4410,2,18,5,7,62,39,23,59
FC Nords,4410,3,16,6,8,73,49,24,54
Copenhagen,4410,4,14,5,11,58,43,15,47
AC Horsens,4410,5,7,14,9,35,48,-13,35
AaB,4410,6,7,12,11,35,44,-9,33
Sonderjyske,4410,7,8,6,10,28,29,-1,30
Lyngby,4410,8,4,9,11,27,44,-17,21
Randers FC,4410,9,5,6,13,23,40,-17,21
Silkeborg IF,4410,10,5,4,13,25,44,-19,19
AGF Aarhus,4410,11,4,7,11,16,36,-20,19
FC Midtjylla,4411,1,20,6,4,66,36,30,66
Brondby,4411,2,18,7,5,65,37,28,61
FC Nords,4411,3,14,6,10,69,50,19,48
Copenhagen,4411,4,14,4,12,59,46,13,46
AaB,4411,5,9,13,8,38,36,2,40
AC Horsens,4411,6,6,14,10,33,51,-18,32
Sonderjyske,4411,7,8,6,10,28,29,-1,30
Randers FC,4411,8,6,6,12,24,39,-15,24
Silkeborg IF,4411,9,6,3,13,28,44,-16,21
Lyngby,4411,10,3,9,12,26,45,-19,18
AGF Aarhus,4411,11,4,6,12,16,39,-23,18
Brondby,4412,1,20,6,4,75,32,43,66
FC Midtjylla,4412,2,18,4,8,64,44,20,58
Copenhagen,4412,3,15,6,9,63,43,20,51
FC Nords,4412,4,14,6,10,71,56,15,48
AaB,4412,5,10,12,8,37,37,0,42
Sonderjyske,4412,6,8,6,10,28,29,-1,30
AC Horsens,4412,7,6,12,12,31,55,-24,30
Lyngby,4412,8,4,9,11,29,44,-15,21
AGF Aarhus,4412,9,5,6,11,19,36,-17,21
Randers FC,4412,10,5,6,13,23,42,-19,21
Silkeborg IF,4412,11,5,3,14,25,47,-22,18
Brondby,4413,1,22,6,2,71,27,44,72
FC Midtjylla,4413,2,19,5,6,67,41,26,62
FC Nords,4413,3,14,8,8,73,53,20,50
Copenhagen,4413,4,15,5,10,61,43,18,50
AaB,4413,5,7,12,11,35,43,-8,33
Sonderjyske,4413,6,8,6,10,28,29,-1,30
AC Horsens,4413,7,5,12,13,34,60,-26,27
Randers FC,4413,8,5,7,12,24,40,-16,22
Silkeborg IF,4413,9,6,3,13,28,45,-17,21
Lyngby,4413,10,3,10,11,27,45,-18,19
AGF Aarhus,4413,11,4,6,12,17,39,-22,18
Brondby,4414,1,20,7,3,75,35,40,67
FC Midtjylla,4414,2,21,4,5,66,37,29,67
FC Nords,4414,3,15,7,8,76,52,24,52
Copenhagen,4414,4,12,7,11,54,44,10,43
AaB,4414,5,7,13,10,38,43,-5,34
Sonderjyske,4414,6,8,6,10,28,29,-1,30
AC Horsens,4414,7,5,14,11,31,55,-24,29
Randers FC,4414,8,5,7,12,24,40,-16,22
Lyngby,4414,9,3,10,11,27,45,-18,19
Silkeborg IF,4414,10,5,4,13,27,46,-19,19
AGF Aarhus,4414,11,4,7,11,18,38,-20,19
Brondby,4415,1,20,7,3,70,30,40,67
FC Midtjylla,4415,2,18,6,6,66,43,23,60
FC Nords,4415,3,14,7,9,70,51,19,49
Copenhagen,4415,4,13,5,12,56,44,12,44
AC Horsens,4415,5,9,12,9,37,50,-13,39
AaB,4415,6,7,13,10,37,44,-7,34
Sonderjyske,4415,7,8,6,10,28,29,-1,30
Randers FC,4415,8,6,6,12,26,39,-13,24
Silkeborg IF,4415,9,6,3,13,26,44,-18,21
Lyngby,4415,10,3,9,12,26,47,-21,18
AGF Aarhus,4415,11,4,6,12,16,37,-21,18
Brondby,4416,1,21,6,3,71,33,38,69
FC Midtjylla,4416,2,19,6,5,66,37,29,63
FC Nords,4416,3,14,7,9,68,49,19,49
Copenhagen,4416,4,13,6,11,59,47,12,45
AC Horsens,4416,5,6,15,9,35,50,-15,33
AaB,4416,6,6,14,10,33,42,-9,32
Sonderjyske,4416,7,8,6,10,28,29,-1,30
Lyngby,4416,8,4,9,11,27,44,-17,21
Randers FC,4416,9,5,6,13,23,40,-17,21
Silkeborg IF,4416,10,6,3,13,27,45,-18,21
AGF Aarhus,4416,11,4,6,12,17,38,-21,18
Brondby,4417,1,20,6,4,66,33,33,66
FC Midtjylla,4417,2,19,6,5,62,36,26,63
Copenhagen,4417,3,15,6,9,61,41,20,51
FC Nords,4417,4,13,8,9,73,52,21,47
AaB,4417,5,8,11,11,36,42,-6,35
AC Horsens,4417,6,6,13,11,32,52,-20,31
Sonderjyske,4417,7,8,6,10,28,29,-1,30
Lyngby,4417,8,4,9,11,27,44,-17,21
Randers FC,4417,9,5,6,13,23,40,-17,21
AGF Aarhus,4417,10,5,6,11,17,36,-19,21
Silkeborg IF,4417,11,5,3,14,25,45,-20,18
Brondby,4418,1,20,6,4,68,35,33,66
FC Midtjylla,4418,2,20,6,4,69,37,32,66
FC Nords,4418,3,15,7,8,76,52,24,52
Copenhagen,4418,4,12,5,13,55,47,8,41
AC Horsens,4418,5,8,13,9,37,49,-12,37
AaB,4418,6,7,11,12,33,44,-11,32
Sonderjyske,4418,7,8,6,10,28,29,-1,30
Lyngby,4418,8,4,9,11,27,44,-17,21
Randers FC,4418,9,5,6,13,23,40,-17,21
Silkeborg IF,4418,10,5,4,13,26,45,-19,19
AGF Aarhus,4418,11,4,7,11,17,37,-20,19
Brondby,4419,1,22,6,2,68,28,40,72
FC Midtjylla,4419,2,18,6,6,63,40,23,60
FC Nords,4419,3,15,8,7,71,44,27,53
Copenhagen,4419,4,13,6,11,61,50,11,45
AaB,4419,5,7,13,10,36,42,-6,34
Sonderjyske,4419,6,8,6,10,28,29,-1,30
AC Horsens,4419,7,5,13,12,34,55,-21,28
Lyngby,4419,8,4,9,11,30,44,-14,21
Silkeborg IF,4419,9,6,3,13,28,44,-16,21
Randers FC,4419,10,5,6,13,23,43,-20,21
AGF Aarhus,4419,11,4,6,12,16,39,-23,18
Brondby,4420,1,20,6,4,70,37,33,66
FC Midtjylla,4420,2,19,5,6,68,45,23,62
FC Nords,4420,3,15,7,8,74,49,25,52
Copenhagen,4420,4,13,6,11,58,47,11,45
AC Horsens,4420,5,8,13,9,41,48,-7,37
AaB,4420,6,7,11,12,36,47,-11,32
Sonderjyske,4420,7,8,6,10,28,29,-1,30
Lyngby,4420,8,4,9,11,27,44,-17,21
Randers FC,4420,9,5,6,13,23,40,-17,21
AGF Aarhus,4420,10,5,6,11,19,36,-17,21
Silkeborg IF,4420,11,5,3,14,25,47,-22,18
Brondby,4421,1,21,7,2,74,32,42,70
FC Midtjylla,4421,2,18,7,5,64,38,26,61
FC Nords,4421,3,14,8,8,71,48,23,50
Copenhagen,4421,4,12,7,11,57,48,9,43
AaB,4421,5,7,13,10,35,45,-10,34
AC Horsens,4421,6,5,16,9,33,49,-16,31
Sonderjyske,4421,7,8,6,10,28,29,-1,30
Lyngby,4421,8,4,9,11,27,44,-17,21
Randers FC,4421,9,5,6,13,23,40,-17,21
AGF Aarhus,4421,10,5,6,11,18,37,-19,21
Silkeborg IF,4421,11,5,3,14,26,46,-20,18
Brondby,4422,1,20,7,3,69,30,39,67
FC Midtjylla,4422,2,21,4,5,71,37,34,67
FC Nords,4422,3,14,7,9,72,56,16,49
Copenhagen,4422,4,14,5,11,57,43,14,47
AC Horsens,4422,5,6,14,10,33,53,-20,32
AaB,4422,6,6,13,11,36,45,-9,31
Sonderjyske,4422,7,8,6,10,28,29,-1,30
Lyngby,4422,8,4,9,11,28,44,-16,21
Silkeborg IF,4422,9,6,3,13,26,44,-18,21
Randers FC,4422,10,5,6,13,23,41,-18,21
AGF Aarhus,4422,11,4,6,12,16,37,-21,18
Brondby,4423,1,22,6,2,72,31,41,72
FC Midtjylla,4423,2,18,6,6,69,44,25,60
FC Nords,4423,3,14,8,8,73,50,23,50
Copenhagen,4423,4,13,6,11,57,43,14,45
AaB,4423,5,8,12,10,39,46,-7,36
Sonderjyske,4423,6,8,6,10,28,29,-1,30
AC Horsens,4423,7,5,14,11,34,56,-22,29
Lyngby,4423,8,4,9,11,28,44,-16,21
Silkeborg IF,4423,9,6,3,13,27,44,-17,21
Randers FC,4423,10,5,6,13,23,41,-18,21
AGF Aarhus,4423,11,4,6,12,16,38,-22,18
Brondby,4424,1,21,6,3,74,35,39,69
FC Midtjylla,4424,2,19,6,5,66,40,26,63
Copenhagen,4424,3,14,4,12,57,45,12,46
FC Nords,4424,4,12,6,12,65,52,13,42
AaB,4424,5,9,13,8,41,42,-1,40
AC Horsens,4424,6,7,13,10,35,50,-15,34
Sonderjyske,4424,7,8,6,10,28,29,-1,30
Lyngby,4424,8,4,9,11,29,45,-16,21
Randers FC,4424,9,5,6,13,24,42,-18,21
AGF Aarhus,4424,10,5,6,11,18,37,-19,21
Silkeborg IF,4424,11,5,3,14,26,46,-20,18
Brondby,4425,1,19,9,2,74,36,38,66
FC Midtjylla,4425,2,19,5,6,66,46,20,62
FC Nords,4425,3,14,7,9,75,53,22,49
Copenhagen,4425,4,14,6,10,65,48,17,48
AaB,4425,5,8,11,11,40,47,-7,35
AC Horsens,4425,6,6,14,10,36,52,-16,32
Sonderjyske,4425,7,8,6,10,28,29,-1,30
Lyngby,4425,8,4,9,11,28,44,-16,21
Randers FC,4425,9,5,6,13,23,41,-18,21
AGF Aarhus,4425,10,5,6,11,18,37,-19,21
Silkeborg IF,4425,11,5,3,14,26,46,-20,18
FC Midtjylla,4426,1,21,5,4,73,37,36,68
Brondby,4426,2,20,6,4,71,32,39,66
FC Nords,4426,3,13,8,9,72,54,18,47
Copenhagen,4426,4,14,4,12,61,46,15,46
AC Horsens,4426,5,8,13,9,37,53,-16,37
Sonderjyske,4426,6,8,6,10,28,29,-1,30
AaB,4426,7,6,12,12,34,52,-18,30
Randers FC,4426,8,5,7,12,25,41,-16,22
Silkeborg IF,4426,9,6,3,13,26,44,-18,21
Lyngby,4426,10,3,10,11,28,46,-18,19
AGF Aarhus,4426,11,4,6,12,16,37,-21,18
Brondby,4427,1,21,5,4,67,30,37,68
FC Midtjylla,4427,2,20,4,6,63,38,25,64
FC Nords,4427,3,14,8,8,73,50,23,50
Copenhagen,4427,4,14,5,11,57,45,12,47
AaB,4427,5,6,14,10,35,43,-8,32
AC Horsens,4427,6,6,14,10,35,50,-15,32
Sonderjyske,4427,7,8,6,10,28,29,-1,30
Lyngby,4427,8,4,9,11,28,44,-16,21
Silkeborg IF,4427,9,6,3,13,26,44,-18,21
Randers FC,4427,10,5,6,13,23,41,-18,21
AGF Aarhus,4427,11,4,6,12,16,37,-21,18
Brondby,4428,1,20,5,5,69,36,33,65
FC Midtjylla,4428,2,19,6,5,64,38,26,63
FC Nords,4428,3,14,8,8,78,50,28,50
Copenhagen,4428,4,14,6,10,60,44,16,48
AC Horsens,4428,5,6,15,9,32,53,-21,33
AaB,4428,6,6,14,10,37,45,-8,32
Sonderjyske,4428,7,8,6,10,28,29,-1,30
Randers FC,4428,8,6,6,12,24,39,-15,24
Silkeborg IF,4428,9,6,3,13,26,44,-18,21
Lyngby,4428,10,3,9,12,26,45,-19,18
AGF Aarhus,4428,11,4,6,12,16,37,-21,18
Brondby,4429,1,22,5,3,69,29,40,71
FC Midtjylla,4429,2,19,5,6,64,39,25,62
FC Nords,4429,3,16,6,8,77,50,27,54
Copenhagen,4429,4,13,6,11,55,45,10,45
AC Horsens,4429,5,7,12,11,36,52,-16,33
Sonderjyske,4429,6,8,6,10,28,29,-1,30
AaB,4429,7,6,12,12,32,44,-12,30
Randers FC,4429,8,6,6,12,27,40,-13,24
Silkeborg IF,4429,9,6,3,13,29,46,-17,21
Lyngby,4429,10,3,9,12,27,48,-21,18
AGF Aarhus,4429,11,4,6,12,18,40,-22,18
Brondby,4430,1,21,5,4,72,35,37,68
FC Midtjylla,4430,2,21,4,5,64,38,26,67
Copenhagen,4430,3,16,5,9,60,40,20,53
FC Nords,4430,4,13,7,10,67,51,16,46
AaB,4430,5,7,12,11,38,44,-6,33
Sonderjyske,4430,6,8,6,10,28,29,-1,30
AC Horsens,4430,7,5,13,12,32,51,-19,28
Lyngby,4430,8,4,9,11,29,46,-17,21
Silkeborg IF,4430,8,6,3,13,29,46,-17,21
Randers FC,4430,10,5,6,13,25,42,-17,21
AGF Aarhus,4430,11,4,6,12,18,40,-22,18
Brondby,4431,1,20,8,2,71,30,41,68
FC Midtjylla,4431,2,21,5,4,71,38,33,68
FC Nords,4431,3,14,7,9,73,50,23,49
Copenhagen,4431,4,13,6,11,57,44,13,45
AaB,4431,5,7,13,10,37,43,-6,34
Sonderjyske,4431,6,8,6,10,28,29,-1,30
AC Horsens,4431,7,5,13,12,32,62,-30,28
Randers FC,4431,8,6,6,12,26,41,-15,24
Silkeborg IF,4431,9,6,3,13,28,45,-17,21
Lyngby,4431,10,3,9,12,28,47,-19,18
AGF Aarhus,4431,11,4,6,12,17,39,-22,18
Brondby,4432,1,20,5,5,68,34,34,65
FC Midtjylla,4432,2,18,5,7,62,41,21,59
FC Nords,4432,3,15,7,8,74,49,25,52
Copenhagen,4432,4,14,6,10,57,44,13,48
AaB,4432,5,8,14,8,38,39,-1,38
AC Horsens,4432,6,6,13,11,33,51,-18,31
Sonderjyske,4432,7,8,6,10,28,29,-1,30
Silkeborg IF,4432,8,6,3,13,28,44,-16,21
Lyngby,4432,9,4,9,11,28,45,-17,21
Randers FC,4432,10,5,6,13,24,41,-17,21
AGF Aarhus,4432,11,4,6,12,16,39,-23,18
Brondby,4433,1,20,7,3,71,33,38,67
FC Midtjylla,4433,2,20,5,5,64,37,27,65
FC Nords,4433,3,14,8,8,75,52,23,50
Copenhagen,4433,4,14,5,11,58,46,12,47
AC Horsens,4433,5,7,12,11,38,55,-17,33
AaB,4433,6,6,13,11,34,43,-9,31
Sonderjyske,4433,7,8,6,10,28,29,-1,30
Randers FC,4433,8,5,7,12,24,40,-16,22
Lyngby,4433,9,3,10,11,27,45,-18,19
Silkeborg IF,4433,10,5,4,13,26,45,-19,19
AGF Aarhus,4433,11,4,7,11,17,37,-20,19
FC Midtjylla,4434,1,22,4,4,66,35,31,70
Brondby,4434,2,20,6,4,70,33,37,66
Copenhagen,4434,3,14,6,10,53,39,14,48
FC Nords,4434,4,13,8,9,72,52,20,47
AC Horsens,4434,5,6,14,10,35,51,-16,32
Sonderjyske,4434,6,8,6,10,28,29,-1,30
AaB,4434,7,6,12,12,36,48,-12,30
Randers FC,4434,8,5,7,12,26,42,-16,22
AGF Aarhus,4434,9,5,6,11,18,37,-19,21
Lyngby,4434,10,3,10,11,29,47,-18,19
Silkeborg IF,4434,11,5,3,14,26,46,-20,18
Brondby,4435,1,21,6,3,69,31,38,69
FC Midtjylla,4435,2,20,5,5,64,36,28,65
Copenhagen,4435,3,15,5,10,61,45,16,50
FC Nords,4435,4,13,6,11,70,51,19,45
AC Horsens,4435,5,7,13,10,33,49,-16,34
AaB,4435,6,7,11,12,38,49,-11,32
Sonderjyske,4435,7,8,6,10,28,29,-1,30
Randers FC,4435,8,6,6,12,24,39,-15,24
Silkeborg IF,4435,9,6,3,13,27,44,-17,21
Lyngby,4435,10,3,9,12,26,45,-19,18
AGF Aarhus,4435,11,4,6,12,16,38,-22,18
Brondby,4436,1,20,5,5,66,31,35,65
FC Midtjylla,4436,2,20,4,6,63,38,25,64
FC Nords,4436,3,15,7,8,73,48,25,52
Copenhagen,4436,4,13,6,11,58,46,12,45
AaB,4436,5,8,13,9,39,42,-3,37
AC Horsens,4436,6,6,13,11,32,52,-20,31
Sonderjyske,4436,7,8,6,10,28,29,-1,30
Lyngby,4436,8,4,9,11,29,45,-16,21
Silkeborg IF,4436,9,6,3,13,27,45,-18,21
Randers FC,4436,10,5,6,13,24,42,-18,21
AGF Aarhus,4436,11,4,6,12,17,38,-21,18
Brondby,4437,1,20,7,3,69,33,36,67
FC Midtjylla,4437,2,19,6,5,70,40,30,63
FC Nords,4437,3,14,6,10,77,55,22,48
Copenhagen,4437,4,14,4,12,54,45,9,46
AaB,4437,5,8,12,10,38,41,-3,36
AC Horsens,4437,6,7,13,10,35,55,-20,34
Sonderjyske,4437,7,8,6,10,28,29,-1,30
Lyngby,4437,8,4,9,11,28,45,-17,21
Randers FC,4437,9,5,6,13,24,41,-17,21
Silkeborg IF,4437,10,5,4,13,26,45,-19,19
AGF Aarhus,4437,11,4,7,11,17,37,-20,19
Brondby,4438,1,20,7,3,73,34,39,67
FC Midtjylla,4438,2,20,5,5,66,37,29,65
Copenhagen,4438,3,14,5,11,57,44,13,47
FC Nords,4438,4,12,7,11,68,57,11,43
AaB,4438,5,10,11,9,39,38,1,41
AC Horsens,4438,6,6,13,11,33,52,-19,31
Sonderjyske,4438,7,8,6,10,28,29,-1,30
Randers FC,4438,8,5,7,12,24,40,-16,22
Lyngby,4438,9,3,10,11,27,45,-18,19
Silkeborg IF,4438,10,5,4,13,26,45,-19,19
AGF Aarhus,4438,11,4,7,11,17,37,-20,19
Brondby,4439,1,21,6,3,75,36,39,69
FC Midtjylla,4439,2,18,6,6,65,42,23,60
FC Nords,4439,3,17,6,7,78,46,32,57
Copenhagen,4439,4,12,5,13,57,51,6,41
AaB,4439,5,8,12,10,42,46,-4,36
AC Horsens,4439,6,6,13,11,33,55,-22,31
Sonderjyske,4439,7,8,6,10,28,29,-1,30
Lyngby,4439,8,4,9,11,28,45,-17,21
Randers FC,4439,9,5,6,13,24,41,-17,21
AGF Aarhus,4439,10,5,6,11,17,36,-19,21
Silkeborg IF,4439,11,5,3,14,25,45,-20,18
Brondby,4440,1,23,5,2,73,27,46,74
FC Midtjylla,4440,2,19,5,6,63,39,24,62
FC Nords,4440,3,14,8,8,72,50,22,50
Copenhagen,4440,4,13,6,11,55,45,10,45
AaB,4440,5,7,12,11,36,42,-6,33
Sonderjyske,4440,6,8,6,10,28,29,-1,30
AC Horsens,4440,7,5,14,11,34,56,-22,29
Randers FC,4440,8,5,7,12,23,39,-16,22
Silkeborg IF,4440,9,6,3,13,28,45,-17,21
Lyngby,4440,10,3,10,11,26,44,-18,19
AGF Aarhus,4440,11,4,6,12,17,39,-22,18
Brondby,4441,1,21,6,3,75,32,43,69
FC Midtjylla,4441,2,19,4,7,64,43,21,61
FC Nords,4441,3,14,7,9,71,54,17,49
Copenhagen,4441,4,12,7,11,56,47,9,43
AaB,4441,5,8,13,9,38,41,-3,37
AC Horsens,4441,6,7,13,10,34,47,-13,34
Sonderjyske,4441,7,8,6,10,28,29,-1,30
Randers FC,4441,8,5,7,12,24,40,-16,22
AGF Aarhus,4441,9,5,6,11,17,36,-19,21
Lyngby,4441,10,3,10,11,27,45,-18,19
Silkeborg IF,4441,11,5,3,14,25,45,-20,18
Brondby,4442,1,23,5,2,73,31,42,74
FC Midtjylla,4442,2,20,4,6,69,43,26,64
FC Nords,4442,3,14,7,9,77,52,25,49
Copenhagen,4442,4,15,4,11,57,43,14,49
AC Horsens,4442,5,6,13,11,34,56,-22,31
Sonderjyske,4442,6,8,6,10,28,29,-1,30
AaB,4442,7,6,11,13,34,45,-11,29
Randers FC,4442,8,5,7,12,24,40,-16,22
Silkeborg IF,4442,9,6,3,13,28,46,-18,21
Lyngby,4442,10,3,10,11,27,45,-18,19
AGF Aarhus,4442,11,4,6,12,18,39,-21,18
Brondby,4443,1,21,7,2,75,33,42,70
FC Midtjylla,4443,2,19,7,4,67,41,26,64
Copenhagen,4443,3,14,6,10,57,44,13,48
FC Nords,4443,4,12,8,10,69,55,14,44
AaB,4443,5,8,12,10,39,42,-3,36
Sonderjyske,4443,6,8,6,10,28,29,-1,30
AC Horsens,4443,7,6,12,12,36,54,-18,30
Randers FC,4443,8,5,7,12,23,39,-16,22
AGF Aarhus,4443,9,5,6,11,20,38,-18,21
Lyngby,4443,10,3,10,11,26,44,-18,19
Silkeborg IF,4443,11,5,3,14,27,48,-21,18
Brondby,4444,1,21,6,3,72,33,39,69
FC Midtjylla,4444,2,21,4,5,69,42,27,67
FC Nords,4444,3,15,6,9,76,53,23,51
Copenhagen,4444,4,15,4,11,60,44,16,49
Sonderjyske,4444,5,8,6,10,28,29,-1,30
AaB,4444,6,6,12,12,34,43,-9,30
AC Horsens,4444,7,6,12,12,34,56,-22,30
Lyngby,4444,8,4,9,11,29,44,-15,21
Silkeborg IF,4444,9,6,3,13,28,44,-16,21
Randers FC,4444,10,5,6,13,23,42,-19,21
AGF Aarhus,4444,11,4,6,12,16,39,-23,18
FC Midtjylla,4445,1,21,5,4,69,37,32,68
Brondby,4445,2,20,5,5,66,37,29,65
Copenhagen,4445,3,14,5,11,57,46,11,47
FC Nords,4445,4,13,7,10,74,54,20,46
AC Horsens,4445,5,7,14,9,39,52,-13,35
AaB,4445,6,7,12,11,33,38,-5,33
Sonderjyske,4445,7,8,6,10,28,29,-1,30
Silkeborg IF,4445,8,6,3,13,28,45,-17,21
Lyngby,4445,9,4,9,11,27,44,-17,21
Randers FC,4445,10,5,6,13,23,40,-17,21
AGF Aarhus,4445,11,4,6,12,17,39,-22,18
Brondby,4446,1,21,5,4,70,34,36,68
FC Midtjylla,4446,2,21,4,5,71,41,30,67
FC Nords,4446,3,14,7,9,74,51,23,49
Copenhagen,4446,4,15,4,11,57,45,12,49
AaB,4446,5,6,13,11,38,46,-8,31
AC Horsens,4446,6,6,13,11,36,55,-19,31
Sonderjyske,4446,7,8,6,10,28,29,-1,30
Lyngby,4446,8,4,9,11,29,44,-15,21
Silkeborg IF,4446,9,6,3,13,28,45,-17,21
Randers FC,4446,10,5,6,13,23,42,-19,21
AGF Aarhus,4446,11,4,6,12,17,39,-22,18
FC Midtjylla,4447,1,21,4,5,65,38,27,67
Brondby,4447,2,20,6,4,67,33,34,66
FC Nords,4447,3,14,7,9,76,51,25,49
Copenhagen,4447,4,13,4,13,60,48,12,43
AaB,4447,5,8,12,10,37,40,-3,36
AC Horsens,4447,6,7,13,10,36,57,-21,34
Sonderjyske,4447,7,8,6,10,28,29,-1,30
Lyngby,4447,8,4,9,11,28,45,-17,21
Randers FC,4447,9,5,6,13,24,41,-17,21
Silkeborg IF,4447,10,5,4,13,27,46,-19,19
AGF Aarhus,4447,11,4,7,11,18,38,-20,19
Brondby,4448,1,23,5,2,76,26,50,74
FC Midtjylla,4448,2,19,5,6,60,37,23,62
FC Nords,4448,3,12,9,9,70,53,17,45
Copenhagen,4448,4,13,6,11,56,46,10,45
AC Horsens,4448,5,7,13,10,35,48,-13,34
AaB,4448,6,7,12,11,35,48,-13,33
Sonderjyske,4448,7,8,6,10,28,29,-1,30
Randers FC,4448,8,6,6,12,26,39,-13,24
Silkeborg IF,4448,9,6,3,13,27,44,-17,21
Lyngby,4448,10,3,9,12,26,47,-21,18
AGF Aarhus,4448,11,4,6,12,16,38,-22,18
Brondby,4449,1,20,6,4,73,37,36,66
FC Midtjylla,4449,2,19,5,6,63,40,23,62
FC Nords,4449,3,14,6,10,70,52,18,48
Copenhagen,4449,4,14,6,10,62,44,18,48
AaB,4449,5,8,13,9,39,42,-3,37
AC Horsens,4449,6,7,12,11,36,54,-18,33
Sonderjyske,4449,7,8,6,10,28,29,-1,30
Randers FC,4449,8,6,6,12,24,39,-15,24
Silkeborg IF,4449,9,6,3,13,26,44,-18,21
Lyngby,4449,10,3,9,12,26,45,-19,18
AGF Aarhus,4449,11,4,6,12,16,37,-21,18
Brondby,4450,1,23,5,2,76,28,48,74
FC Midtjylla,4450,2,18,7,5,63,41,22,61
FC Nords,4450,3,13,6,11,73,58,15,45
Copenhagen,4450,4,13,5,12,54,48,6,44
AaB,4450,5,8,12,10,35,40,-5,36
AC Horsens,4450,6,7,13,10,38,50,-12,34
Sonderjyske,4450,7,8,6,10,28,29,-1,30
Lyngby,4450,8,4,9,11,28,45,-17,21
Randers FC,4450,9,5,6,13,24,41,-17,21
AGF Aarhus,4450,10,5,6,11,17,36,-19,21
Silkeborg IF,4450,11,5,3,14,25,45,-20,18
Brondby,4451,1,21,7,2,72,31,41,70
FC Midtjylla,4451,2,19,5,6,65,41,24,62
Copenhagen,4451,3,14,7,9,63,41,22,49
FC Nords,4451,4,13,6,11,68,54,14,45
AaB,4451,5,7,12,11,34,45,-11,33
AC Horsens,4451,6,6,15,9,33,49,-16,33
Sonderjyske,4451,7,8,6,10,28,29,-1,30
Lyngby,4451,8,4,9,11,28,44,-16,21
Silkeborg IF,4451,9,6,3,13,26,44,-18,21
Randers FC,4451,10,5,6,13,23,41,-18,21
AGF Aarhus,4451,11,4,6,12,16,37,-21,18
Brondby,4452,1,20,7,3,71,33,38,67
FC Midtjylla,4452,2,19,4,7,63,40,23,61
FC Nords,4452,3,14,7,9,76,55,21,49
Copenhagen,4452,4,14,4,12,56,44,12,46
AaB,4452,5,8,13,9,36,40,-4,37
AC Horsens,4452,6,7,13,10,35,51,-16,34
Sonderjyske,4452,7,8,6,10,28,29,-1,30
Randers FC,4452,8,6,6,12,25,40,-15,24
AGF Aarhus,4452,9,5,6,11,18,37,-19,21
Lyngby,4452,10,3,9,12,27,46,-19,18
Silkeborg IF,4452,11,5,3,14,26,46,-20,18
Brondby,4453,1,19,8,3,70,33,37,65
FC Midtjylla,4453,2,20,5,5,68,41,27,65
FC Nords,4453,3,13,8,9,75,56,19,47
Copenhagen,4453,4,14,5,11,59,45,14,47
AaB,4453,5,8,11,11,39,46,-7,35
AC Horsens,4453,6,7,13,10,34,50,-16,34
Sonderjyske,4453,7,8,6,10,28,29,-1,30
Lyngby,4453,8,4,9,11,29,46,-17,21
Randers FC,4453,9,5,6,13,25,42,-17,21
AGF Aarhus,4453,10,5,6,11,17,36,-19,21
Silkeborg IF,4453,11,5,3,14,25,45,-20,18
Brondby,4454,1,22,5,3,71,31,40,71
FC Midtjylla,4454,2,19,6,5,67,40,27,63
FC Nords,4454,3,14,7,9,72,52,20,49
Copenhagen,4454,4,13,6,11,57,45,12,45
AC Horsens,4454,5,8,12,10,38,54,-16,36
Sonderjyske,4454,6,8,6,10,28,29,-1,30
AaB,4454,7,6,12,12,33,42,-9,30
Randers FC,4454,8,6,6,12,24,39,-15,24
Silkeborg IF,4454,9,6,3,13,28,44,-16,21
Lyngby,4454,10,3,9,12,26,45,-19,18
AGF Aarhus,4454,11,4,6,12,16,39,-23,18
Brondby,4455,1,19,5,6,69,39,30,62
FC Midtjylla,4455,2,19,5,6,67,45,22,62
FC Nords,4455,3,16,6,8,75,50,25,54
Copenhagen,4455,4,15,4,11,61,43,18,49
AC Horsens,4455,5,9,12,9,40,53,-13,39
Sonderjyske,4455,6,8,6,10,28,29,-1,30
AaB,4455,7,6,12,12,38,46,-8,30
Lyngby,4455,8,4,9,11,27,44,-17,21
Randers FC,4455,9,5,6,13,23,40,-17,21
Silkeborg IF,4455,10,6,3,13,26,44,-18,21
AGF Aarhus,4455,11,4,6,12,16,37,-21,18
Brondby,4456,1,20,6,4,68,35,33,66
FC Midtjylla,4456,2,19,7,4,64,38,26,64
FC Nords,4456,3,15,8,7,75,46,29,53
Copenhagen,4456,4,14,6,10,55,42,13,48
AaB,4456,5,6,14,10,37,43,-6,32
Sonderjyske,4456,6,8,6,10,28,29,-1,30
AC Horsens,4456,7,5,13,12,31,52,-21,28
Randers FC,4456,8,5,7,12,24,40,-16,22
Lyngby,4456,9,3,10,11,27,45,-18,19
Silkeborg IF,4456,10,5,4,13,27,46,-19,19
AGF Aarhus,4456,11,4,7,11,18,38,-20,19
Brondby,4457,1,20,7,3,66,30,36,67
FC Midtjylla,4457,2,21,4,5,72,37,35,67
FC Nords,4457,3,14,7,9,76,56,20,49
Copenhagen,4457,4,13,6,11,60,47,13,45
AaB,4457,5,8,11,11,39,44,-5,35
AC Horsens,4457,6,6,13,11,33,58,-25,31
Sonderjyske,4457,7,8,6,10,28,29,-1,30
Randers FC,4457,8,6,6,12,24,39,-15,24
AGF Aarhus,4457,9,5,6,11,17,36,-19,21
Lyngby,4457,10,3,9,12,26,45,-19,18
Silkeborg IF,4457,11,5,3,14,25,45,-20,18
FC Midtjylla,4458,1,22,4,4,68,33,35,70
Brondby,4458,2,20,6,4,70,35,35,66
FC Nords,4458,3,13,8,9,72,54,18,47
Copenhagen,4458,4,13,6,11,55,43,12,45
AC Horsens,4458,5,7,13,10,36,51,-15,34
AaB,4458,6,7,11,12,36,47,-11,32
Sonderjyske,4458,7,8,6,10,28,29,-1,30
Randers FC,4458,8,6,6,12,25,40,-15,24
Silkeborg IF,4458,9,6,3,13,27,44,-17,21
Lyngby,4458,10,3,9,12,27,46,-19,18
AGF Aarhus,4458,11,4,6,12,16,38,-22,18
Brondby,4459,1,22,5,3,76,34,42,71
FC Midtjylla,4459,2,20,4,6,68,44,24,64
FC Nords,4459,3,13,7,10,71,52,19,46
Copenhagen,4459,4,13,5,12,57,48,9,44
AC Horsens,4459,5,9,12,9,39,50,-11,39
AaB,4459,6,6,13,11,38,47,-9,31
Sonderjyske,4459,7,8,6,10,28,29,-1,30
Randers FC,4459,8,6,6,12,25,40,-15,24
Silkeborg IF,4459,9,5,4,13,27,46,-19,19
AGF Aarhus,4459,10,4,7,11,18,38,-20,19
Lyngby,4459,11,3,9,12,27,46,-19,18
Brondby,4460,1,21,6,3,73,33,40,69
FC Midtjylla,4460,2,19,4,7,67,43,24,61
Copenhagen,4460,3,14,6,10,62,48,14,48
FC Nords,4460,4,13,6,11,73,58,15,45
AaB,4460,5,8,12,10,40,45,-5,36
AC Horsens,4460,6,8,12,10,37,51,-14,36
Sonderjyske,4460,7,8,6,10,28,29,-1,30
Lyngby,4460,8,4,9,11,30,44,-14,21
AGF Aarhus,4460,9,5,6,11,18,36,-18,21
Randers FC,4460,10,5,6,13,23,43,-20,21
Silkeborg IF,4460,11,5,3,14,25,46,-21,18
Brondby,4461,1,21,6,3,67,30,37,69
FC Midtjylla,4461,2,21,4,5,69,36,33,67
FC Nords,4461,3,14,7,9,80,58,22,49
Copenhagen,4461,4,14,5,11,62,51,11,47
AaB,4461,5,6,13,11,35,47,-12,31
AC Horsens,4461,6,6,13,11,33,50,-17,31
Sonderjyske,4461,7,8,6,10,28,29,-1,30
Lyngby,4461,8,4,9,11,31,44,-13,21
Silkeborg IF,4461,9,6,3,13,28,46,-18,21
Randers FC,4461,10,5,6,13,23,44,-21,21
AGF Aarhus,4461,11,4,6,12,18,39,-21,18
FC Midtjylla,4462,1,21,5,4,70,38,32,68
Brondby,4462,2,19,7,4,73,39,34,64
FC Nords,4462,3,15,6,9,77,50,27,51
Copenhagen,4462,4,14,5,11,60,48,12,47
AaB,4462,5,8,12,10,39,44,-5,36
Sonderjyske,4462,6,8,6,10,28,29,-1,30
AC Horsens,4462,7,5,13,12,32,58,-26,28
Randers FC,4462,8,5,7,12,24,40,-16,22
Silkeborg IF,4462,9,6,3,13,28,44,-16,21
Lyngby,4462,10,3,10,11,27,45,-18,19
AGF Aarhus,4462,11,4,6,12,16,39,-23,18
Brondby,4463,1,21,7,2,74,33,41,70
FC Midtjylla,4463,2,19,6,5,69,43,26,63
FC Nords,4463,3,13,7,10,71,54,17,46
Copenhagen,4463,4,14,4,12,60,48,12,46
AaB,4463,5,8,13,9,38,42,-4,37
AC Horsens,4463,6,6,13,11,36,54,-18,31
Sonderjyske,4463,7,8,6,10,28,29,-1,30
Randers FC,4463,8,6,6,12,27,40,-13,24
Silkeborg IF,4463,9,6,3,13,28,46,-18,21
Lyngby,4463,10,3,9,12,27,48,-21,18
AGF Aarhus,4463,11,4,6,12,18,39,-21,18
FC Midtjylla,4464,1,20,5,5,66,36,30,65
Brondby,4464,2,19,6,5,69,31,38,63
FC Nords,4464,3,15,6,9,74,55,19,51
Copenhagen,4464,4,13,4,13,51,44,7,43
AaB,4464,5,10,11,9,41,41,0,41
AC Horsens,4464,6,7,12,11,38,58,-20,33
Sonderjyske,4464,7,8,6,10,28,29,-1,30
Randers FC,4464,8,6,6,12,25,39,-14,24
Silkeborg IF,4464,9,5,4,13,26,45,-19,19
AGF Aarhus,4464,10,4,7,11,17,37,-20,19
Lyngby,4464,11,3,9,12,26,46,-20,18
Brondby,4465,1,21,6,3,70,32,38,69
FC Midtjylla,4465,2,20,4,6,67,39,28,64
Copenhagen,4465,3,15,4,11,55,42,13,49
FC Nords,4465,4,12,7,11,67,54,13,43
AaB,4465,5,10,12,8,44,41,3,42
Sonderjyske,4465,6,8,6,10,28,29,-1,30
AC Horsens,4465,7,5,13,12,35,56,-21,28
Lyngby,4465,8,4,9,11,27,44,-17,21
Randers FC,4465,9,5,6,13,23,40,-17,21
AGF Aarhus,4465,10,5,6,11,18,37,-19,21
Silkeborg IF,4465,11,5,3,14,26,46,-20,18
Brondby,4466,1,22,5,3,73,33,40,71
FC Midtjylla,4466,2,19,4,7,64,41,23,61
FC Nords,4466,3,15,7,8,72,46,26,52
Copenhagen,4466,4,15,4,11,56,45,11,49
AaB,4466,5,6,13,11,35,43,-8,31
AC Horsens,4466,6,6,13,11,37,55,-18,31
Sonderjyske,4466,7,8,6,10,28,29,-1,30
Lyngby,4466,8,4,9,11,28,45,-17,21
Silkeborg IF,4466,9,6,3,13,27,44,-17,21
Randers FC,4466,10,5,6,13,24,41,-17,21
AGF Aarhus,4466,11,4,6,12,16,38,-22,18
Brondby,4467,1,20,8,2,70,30,40,68
FC Midtjylla,4467,2,19,4,7,60,41,19,61
FC Nords,4467,3,14,8,8,72,50,22,50
Copenhagen,4467,4,13,6,11,57,44,13,45
AC Horsens,4467,5,7,14,9,38,50,-12,35
AaB,4467,6,7,12,11,36,44,-8,33
Sonderjyske,4467,7,8,6,10,28,29,-1,30
Randers FC,4467,8,5,7,12,24,40,-16,22
Silkeborg IF,4467,9,6,3,13,28,45,-17,21
Lyngby,4467,10,3,10,11,27,45,-18,19
AGF Aarhus,4467,11,4,6,12,17,39,-22,18
Brondby,4468,1,22,5,3,75,32,43,71
FC Midtjylla,4468,2,20,5,5,65,38,27,65
FC Nords,4468,3,16,7,7,84,51,33,55
Copenhagen,4468,4,12,4,14,53,52,1,40
AC Horsens,4468,5,7,12,11,35,53,-18,33
AaB,4468,6,7,11,12,34,46,-12,32
Sonderjyske,4468,7,8,6,10,28,29,-1,30
Randers FC,4468,8,6,6,12,24,39,-15,24
AGF Aarhus,4468,9,5,6,11,17,36,-19,21
Lyngby,4468,10,3,9,12,26,45,-19,18
Silkeborg IF,4468,11,5,3,14,25,45,-20,18
Brondby,4469,1,22,5,3,73,29,44,71
FC Midtjylla,4469,2,18,6,6,62,41,21,60
FC Nords,4469,3,14,7,9,73,50,23,49
Copenhagen,4469,4,13,6,11,59,48,11,45
AaB,4469,5,8,12,10,35,43,-8,36
AC Horsens,4469,6,7,12,11,35,52,-17,33
Sonderjyske,4469,7,8,6,10,28,29,-1,30
Lyngby,4469,8,4,9,11,29,45,-16,21
Randers FC,4469,9,5,6,13,24,42,-18,21
Silkeborg IF,4469,10,5,4,13,26,45,-19,19
AGF Aarhus,4469,11,4,7,11,17,37,-20,19
FC Midtjylla,4470,1,21,4,5,68,39,29,67
Brondby,4470,2,20,6,4,75,37,38,66
FC Nords,4470,3,16,7,7,78,51,27,55
Copenhagen,4470,4,15,4,11,58,44,14,49
AaB,4470,5,7,11,12,38,46,-8,32
Sonderjyske,4470,6,8,6,10,28,29,-1,30
AC Horsens,4470,7,5,12,13,30,56,-26,27
Randers FC,4470,8,5,7,12,24,40,-16,22
Silkeborg IF,4470,9,6,3,13,29,45,-16,21
Lyngby,4470,10,3,10,11,27,45,-18,19
AGF Aarhus,4470,11,4,6,12,17,40,-23,18
Brondby,4471,1,21,7,2,74,35,39,70
FC Midtjylla,4471,2,18,5,7,63,45,18,59
FC Nords,4471,3,15,6,9,77,53,24,51
Copenhagen,4471,4,13,7,10,59,46,13,46
AaB,4471,5,8,12,10,41,44,-3,36
AC Horsens,4471,6,6,13,11,34,51,-17,31
Sonderjyske,4471,7,8,6,10,28,29,-1,30
Lyngby,4471,8,4,9,11,27,44,-17,21
Randers FC,4471,9,5,6,13,23,40,-17,21
Silkeborg IF,4471,10,5,4,13,26,45,-19,19
AGF Aarhus,4471,11,4,7,11,17,37,-20,19
Brondby,4472,1,21,6,3,74,33,41,69
FC Midtjylla,4472,2,19,6,5,61,38,23,63
FC Nords,4472,3,15,7,8,73,46,27,52
Copenhagen,4472,4,13,7,10,57,44,13,46
AaB,4472,5,7,11,12,34,45,-11,32
AC Horsens,4472,6,6,13,11,34,53,-19,31
Sonderjyske,4472,7,8,6,10,28,29,-1,30
Randers FC,4472,8,5,7,12,24,40,-16,22
AGF Aarhus,4472,9,5,6,11,19,37,-18,21
Lyngby,4472,10,3,10,11,27,45,-18,19
Silkeborg IF,4472,11,5,3,14,26,47,-21,18
Brondby,4473,1,20,5,5,70,34,36,65
FC Midtjylla,4473,2,18,4,8,61,42,19,58
FC Nords,4473,3,16,7,7,78,48,30,55
Copenhagen,4473,4,15,6,9,56,40,16,51
AaB,4473,5,8,12,10,37,41,-4,36
Sonderjyske,4473,6,8,6,10,28,29,-1,30
AC Horsens,4473,7,5,14,11,33,56,-23,29
Lyngby,4473,8,4,9,11,28,44,-16,21
Silkeborg IF,4473,9,6,3,13,26,44,-18,21
Randers FC,4473,10,5,6,13,23,41,-18,21
AGF Aarhus,4473,11,4,6,12,16,37,-21,18
Brondby,4474,1,21,6,3,76,34,42,69
FC Midtjylla,4474,2,19,6,5,69,40,29,63
FC Nords,4474,3,14,8,8,72,53,19,50
Copenhagen,4474,4,14,5,11,60,44,16,47
AaB,4474,5,7,12,11,36,44,-8,33
AC Horsens,4474,6,6,13,11,34,58,-24,31
Sonderjyske,4474,7,8,6,10,28,29,-1,30
Lyngby,4474,8,4,9,11,29,45,-16,21
AGF Aarhus,4474,9,5,6,11,20,36,-16,21
Randers FC,4474,10,5,6,13,24,42,-18,21
Silkeborg IF,4474,11,5,3,14,25,48,-23,18
FC Midtjylla,4475,1,22,4,4,66,35,31,70
Brondby,4475,2,20,6,4,69,33,36,66
FC Nords,4475,3,13,6,11,70,53,17,45
Copenhagen,4475,4,13,5,12,52,43,9,44
AC Horsens,4475,5,8,12,10,39,50,-11,36
AaB,4475,6,7,13,10,35,43,-8,34
Sonderjyske,4475,7,8,6,10,28,29,-1,30
Randers FC,4475,8,5,7,12,23,39,-16,22
Silkeborg IF,4475,9,6,3,13,27,45,-18,21
Lyngby,4475,10,3,10,11,26,44,-18,19
AGF Aarhus,4475,11,4,6,12,17,38,-21,18
Brondby,4476,1,21,6,3,72,30,42,69
FC Midtjylla,4476,2,17,8,5,61,40,21,59
FC Nords,4476,3,14,7,9,72,54,18,49
Copenhagen,4476,4,12,7,11,55,45,10,43
AaB,4476,5,8,14,8,40,39,1,38
AC Horsens,4476,6,6,14,10,36,54,-18,32
Sonderjyske,4476,7,8,6,10,28,29,-1,30
Lyngby,4476,8,4,9,11,28,44,-16,21
Silkeborg IF,4476,9,6,3,13,28,46,-18,21
Randers FC,4476,10,5,6,13,23,41,-18,21
AGF Aarhus,4476,11,4,6,12,18,39,-21,18
Brondby,4477,1,21,5,4,75,33,42,68
FC Midtjylla,4477,2,18,5,7,66,43,23,59
FC Nords,4477,3,14,9,7,69,45,24,51
Copenhagen,4477,4,13,6,11,55,47,8,45
AaB,4477,5,8,12,10,36,41,-5,36
AC Horsens,4477,6,7,13,10,35,53,-18,34
Sonderjyske,4477,7,8,6,10,28,29,-1,30
Randers FC,4477,8,6,6,12,24,39,-15,24
Silkeborg IF,4477,9,6,3,13,28,44,-16,21
Lyngby,4477,10,3,9,12,26,45,-19,18
AGF Aarhus,4477,11,4,6,12,16,39,-23,18
Brondby,4478,1,20,5,5,67,33,34,65
FC Midtjylla,4478,2,20,4,6,66,41,25,64
FC Nords,4478,3,14,7,9,71,51,20,49
Copenhagen,4478,4,13,4,13,56,45,11,43
AC Horsens,4478,5,9,13,8,36,47,-11,40
AaB,4478,6,8,11,11,38,43,-5,35
Sonderjyske,4478,7,8,6,10,28,29,-1,30
Randers FC,4478,8,6,6,12,24,39,-15,24
Silkeborg IF,4478,9,5,4,13,26,45,-19,19
AGF Aarhus,4478,10,4,7,11,17,37,-20,19
Lyngby,4478,11,3,9,12,26,45,-19,18
Brondby,4479,1,21,6,3,72,35,37,69
FC Midtjylla,4479,2,19,4,7,66,44,22,61
FC Nords,4479,3,14,7,9,77,55,22,49
Copenhagen,4479,4,15,4,11,59,45,14,49
AaB,4479,5,8,11,11,40,46,-6,35
AC Horsens,4479,6,7,12,11,40,55,-15,33
Sonderjyske,4479,7,8,6,10,28,29,-1,30
Randers FC,4479,8,6,6,12,24,39,-15,24
Silkeborg IF,4479,9,6,3,13,27,45,-18,21
Lyngby,4479,10,3,9,12,26,45,-19,18
AGF Aarhus,4479,11,4,6,12,17,38,-21,18
Brondby,4480,1,21,6,3,71,30,41,69
FC Midtjylla,4480,2,19,5,6,65,39,26,62
FC Nords,4480,3,16,6,8,78,53,25,54
Copenhagen,4480,4,14,4,12,60,49,11,46
AaB,4480,5,8,11,11,39,47,-8,35
Sonderjyske,4480,6,8,6,10,28,29,-1,30
AC Horsens,4480,7,6,12,12,37,58,-21,30
Randers FC,4480,8,6,6,12,24,39,-15,24
AGF Aarhus,4480,9,5,6,11,17,36,-19,21
Lyngby,4480,10,3,9,12,26,45,-19,18
Silkeborg IF,4480,11,5,3,14,25,45,-20,18
Brondby,4481,1,21,7,2,70,29,41,70
FC Midtjylla,4481,2,20,5,5,66,39,27,65
FC Nords,4481,3,14,7,9,70,51,19,49
Copenhagen,4481,4,13,7,10,57,44,13,46
AaB,4481,5,6,13,11,34,43,-9,31
AC Horsens,4481,6,6,13,11,32,49,-17,31
Sonderjyske,4481,7,8,6,10,28,29,-1,30
Randers FC,4481,8,6,6,12,25,40,-15,24
Silkeborg IF,4481,9,6,3,13,27,45,-18,21
Lyngby,4481,10,3,9,12,27,46,-19,18
AGF Aarhus,4481,11,4,6,12,17,38,-21,18
Brondby,4482,1,20,7,3,67,31,36,67
FC Midtjylla,4482,2,19,4,7,61,38,23,61
FC Nords,4482,3,15,6,9,75,53,22,51
Copenhagen,4482,4,13,7,10,57,44,13,46
AaB,4482,5,7,13,10,36,42,-6,34
AC Horsens,4482,6,6,15,9,35,49,-14,33
Sonderjyske,4482,7,8,6,10,28,29,-1,30
Lyngby,4482,8,4,9,11,28,44,-16,21
Silkeborg IF,4482,9,6,3,13,27,44,-17,21
Randers FC,4482,10,5,6,13,23,41,-18,21
AGF Aarhus,4482,11,4,6,12,16,38,-22,18
FC Midtjylla,4483,1,22,4,4,73,39,34,70
Brondby,4483,2,20,6,4,69,33,36,66
FC Nords,4483,3,14,6,10,78,62,16,48
Copenhagen,4483,4,13,6,11,57,44,13,45
AC Horsens,4483,5,8,13,9,38,51,-13,37
Sonderjyske,4483,6,8,6,10,28,29,-1,30
AaB,4483,7,6,11,13,38,50,-12,29
Lyngby,4483,8,4,9,11,30,45,-15,21
Silkeborg IF,4483,9,6,3,13,26,44,-18,21
Randers FC,4483,10,5,6,13,24,43,-19,21
AGF Aarhus,4483,11,4,6,12,16,37,-21,18
Brondby,4484,1,22,6,2,76,30,46,72
FC Midtjylla,4484,2,17,5,8,59,47,12,56
FC Nords,4484,3,15,7,8,73,50,23,52
Copenhagen,4484,4,14,5,11,59,47,12,47
AC Horsens,4484,5,7,13,10,36,47,-11,34
AaB,4484,6,6,14,10,37,45,-8,32
Sonderjyske,4484,7,8,6,10,28,29,-1,30
Randers FC,4484,8,5,7,12,23,39,-16,22
Silkeborg IF,4484,9,6,3,13,29,44,-15,21
Lyngby,4484,10,3,10,11,26,44,-18,19
AGF Aarhus,4484,11,4,6,12,16,40,-24,18
FC Midtjylla,4485,1,21,5,4,67,38,29,68
Brondby,4485,2,20,5,5,72,33,39,65
Copenhagen,4485,3,14,5,11,57,45,12,47
FC Nords,4485,4,13,6,11,70,56,14,45
AC Horsens,4485,5,8,12,10,37,53,-16,36
AaB,4485,6,8,11,11,39,43,-4,35
Sonderjyske,4485,7,8,6,10,28,29,-1,30
Randers FC,4485,8,6,6,12,25,40,-15,24
AGF Aarhus,4485,9,5,6,11,18,37,-19,21
Lyngby,4485,10,3,9,12,27,46,-19,18
Silkeborg IF,4485,11,5,3,14,26,46,-20,18
Brondby,4486,1,21,7,2,71,30,41,70
FC Midtjylla,4486,2,20,5,5,66,40,26,65
FC Nords,4486,3,14,7,9,79,59,20,49
Copenhagen,4486,4,12,6,12,61,52,9,42
AC Horsens,4486,5,7,14,9,38,53,-15,35
AaB,4486,6,7,11,12,33,40,-7,32
Sonderjyske,4486,7,8,6,10,28,29,-1,30
Lyngby,4486,8,4,9,11,27,44,-17,21
Randers FC,4486,9,5,6,13,23,40,-17,21
Silkeborg IF,4486,10,5,4,13,26,45,-19,19
AGF Aarhus,4486,11,4,7,11,17,37,-20,19
Brondby,4487,1,20,8,2,73,33,40,68
FC Midtjylla,4487,2,19,4,7,65,44,21,61
Copenhagen,4487,3,14,6,10,60,44,16,48
FC Nords,4487,4,13,8,9,73,54,19,47
AaB,4487,5,9,11,10,43,45,-2,38
AC Horsens,4487,6,6,13,11,33,53,-20,31
Sonderjyske,4487,7,8,6,10,28,29,-1,30
Randers FC,4487,8,5,7,12,24,40,-16,22
Silkeborg IF,4487,9,6,3,13,27,44,-17,21
Lyngby,4487,10,3,10,11,27,45,-18,19
AGF Aarhus,4487,11,4,6,12,16,38,-22,18
Brondby,4488,1,20,8,2,73,31,42,68
FC Midtjylla,4488,2,20,5,5,67,41,26,65
Copenhagen,4488,3,15,5,10,63,43,20,50
FC Nords,4488,4,14,6,10,76,52,24,48
AaB,4488,5,7,12,11,34,49,-15,33
Sonderjyske,4488,6,8,6,10,28,29,-1,30
AC Horsens,4488,7,5,14,11,36,59,-23,29
Randers FC,4488,8,6,6,12,26,40,-14,24
Silkeborg IF,4488,9,6,3,13,29,46,-17,21
Lyngby,4488,10,3,9,12,27,47,-20,18
AGF Aarhus,4488,11,4,6,12,18,40,-22,18
Brondby,4489,1,20,5,5,71,35,36,65
FC Midtjylla,4489,2,19,6,5,67,38,29,63
FC Nords,4489,3,14,7,9,72,52,20,49
Copenhagen,4489,4,13,7,10,57,44,13,46
AaB,4489,5,8,12,10,39,45,-6,36
AC Horsens,4489,6,7,13,10,35,53,-18,34
Sonderjyske,4489,7,8,6,10,28,29,-1,30
Randers FC,4489,8,5,7,12,23,39,-16,22
Lyngby,4489,9,3,10,11,26,44,-18,19
Silkeborg IF,4489,10,5,4,13,26,45,-19,19
AGF Aarhus,4489,11,4,7,11,17,37,-20,19
Brondby,4490,1,22,6,2,74,31,43,72
FC Midtjylla,4490,2,20,4,6,68,41,27,64
FC Nords,4490,3,13,7,10,75,56,19,46
Copenhagen,4490,4,13,7,10,56,42,14,46
AaB,4490,5,7,12,11,35,43,-8,33
AC Horsens,4490,6,6,14,10,33,54,-21,32
Sonderjyske,4490,7,8,6,10,28,29,-1,30
Silkeborg IF,4490,8,6,3,13,29,44,-15,21
Lyngby,4490,9,4,9,11,27,44,-17,21
Randers FC,4490,10,5,6,13,23,40,-17,21
AGF Aarhus,4490,11,4,6,12,16,40,-24,18
Brondby,4491,1,22,6,2,76,30,46,72
FC Midtjylla,4491,2,20,4,6,63,37,26,64
FC Nords,4491,3,14,7,9,69,47,22,49
Copenhagen,4491,4,14,5,11,58,44,14,47
AaB,4491,5,7,13,10,36,49,-13,34
Sonderjyske,4491,6,8,6,10,28,29,-1,30
AC Horsens,4491,7,5,13,12,31,52,-21,28
Lyngby,4491,8,4,9,11,28,44,-16,21
Silkeborg IF,4491,9,6,3,13,27,45,-18,21
Randers FC,4491,10,5,6,13,23,41,-18,21
AGF Aarhus,4491,11,4,6,12,17,38,-21,18
Brondby,4492,1,21,6,3,69,31,38,69
FC Midtjylla,4492,2,17,5,8,62,46,16,56
FC Nords,4492,3,16,7,7,80,48,32,55
Copenhagen,4492,4,15,4,11,63,49,14,49
AaB,4492,5,7,13,10,38,43,-5,34
AC Horsens,4492,6,6,13,11,31,52,-21,31
Sonderjyske,4492,7,8,6,10,28,29,-1,30
Lyngby,4492,8,4,9,11,28,45,-17,21
Silkeborg IF,4492,8,6,3,13,28,45,-17,21
Randers FC,4492,10,5,6,13,24,41,-17,21
AGF Aarhus,4492,11,4,6,12,17,39,-22,18
Brondby,4493,1,21,6,3,74,29,45,69
FC Midtjylla,4493,2,20,4,6,65,42,23,64
Copenhagen,4493,3,15,5,10,60,44,16,50
FC Nords,4493,4,14,6,10,71,53,18,48
AaB,4493,5,8,11,11,40,45,-5,35
Sonderjyske,4493,6,8,6,10,28,29,-1,30
AC Horsens,4493,7,6,12,12,34,57,-23,30
Randers FC,4493,8,6,6,12,24,39,-15,24
Silkeborg IF,4493,9,5,4,13,26,45,-19,19
AGF Aarhus,4493,10,4,7,11,17,37,-20,19
Lyngby,4493,11,3,9,12,26,45,-19,18
Brondby,4494,1,22,5,3,77,30,47,71
FC Midtjylla,4494,2,18,5,7,63,47,16,59
Copenhagen,4494,3,15,4,11,59,44,15,49
FC Nords,4494,4,14,6,10,73,59,14,48
AC Horsens,4494,5,8,12,10,39,53,-14,36
AaB,4494,6,7,12,11,38,42,-4,33
Sonderjyske,4494,7,8,6,10,28,29,-1,30
Randers FC,4494,8,6,6,12,25,40,-15,24
Silkeborg IF,4494,9,6,3,13,28,44,-16,21
Lyngby,4494,10,3,9,12,27,46,-19,18
AGF Aarhus,4494,11,4,6,12,16,39,-23,18
Brondby,4495,1,20,7,3,73,37,36,67
FC Midtjylla,4495,2,18,5,7,66,46,20,59
FC Nords,4495,3,16,7,7,79,50,29,55
Copenhagen,4495,4,13,4,13,55,46,9,43
AC Horsens,4495,5,8,12,10,39,53,-14,36
AaB,4495,6,7,13,10,37,43,-6,34
Sonderjyske,4495,7,8,6,10,28,29,-1,30
Lyngby,4495,8,4,9,11,28,45,-17,21
Randers FC,4495,9,5,6,13,24,41,-17,21
AGF Aarhus,4495,10,5,6,11,17,36,-19,21
Silkeborg IF,4495,11,5,3,14,25,45,-20,18
Brondby,4496,1,21,7,2,72,34,38,70
FC Midtjylla,4496,2,19,4,7,63,42,21,61
FC Nords,4496,3,16,6,8,77,44,33,54
Copenhagen,4496,4,14,6,10,61,47,14,48
AC Horsens,4496,5,6,13,11,32,54,-22,31
Sonderjyske,4496,6,8,6,10,28,29,-1,30
AaB,4496,7,6,12,12,37,47,-10,30
Lyngby,4496,8,4,9,11,29,44,-15,21
Randers FC,4496,9,5,6,13,23,42,-19,21
Silkeborg IF,4496,10,5,4,13,27,46,-19,19
AGF Aarhus,4496,11,4,7,11,18,38,-20,19
Brondby,4497,1,20,7,3,68,30,38,67
FC Midtjylla,4497,2,20,4,6,68,42,26,64
FC Nords,4497,3,15,7,8,72,49,23,52
Copenhagen,4497,4,13,5,12,56,46,10,44
AaB,4497,5,8,11,11,36,42,-6,35
AC Horsens,4497,6,7,12,11,35,52,-17,33
Sonderjyske,4497,7,8,6,10,28,29,-1,30
Randers FC,4497,8,5,7,12,24,40,-16,22
Silkeborg IF,4497,9,6,3,13,28,44,-16,21
Lyngby,4497,10,3,10,11,27,45,-18,19
AGF Aarhus,4497,11,4,6,12,16,39,-23,18
FC Midtjylla,4498,1,21,4,5,63,34,29,67
Brondby,4498,2,19,5,6,68,34,34,62
FC Nords,4498,3,15,7,8,76,50,26,52
Copenhagen,4498,4,13,4,13,54,47,7,43
AC Horsens,4498,5,9,12,9,39,50,-11,39
AaB,4498,6,7,12,11,38,49,-11,33
Sonderjyske,4498,7,8,6,10,28,29,-1,30
Randers FC,4498,8,5,7,12,24,40,-16,22
Lyngby,4498,9,3,10,11,27,45,-18,19
Silkeborg IF,4498,10,5,4,13,25,44,-19,19
AGF Aarhus,4498,11,4,7,11,16,36,-20,19
Brondby,4499,1,22,5,3,76,36,40,71
FC Midtjylla,4499,2,19,6,5,67,39,28,63
FC Nords,4499,3,14,6,10,73,55,18,48
Copenhagen,4499,4,13,5,12,58,50,8,44
AaB,4499,5,9,12,9,42,44,-2,39
Sonderjyske,4499,6,8,6,10,28,29,-1,30
AC Horsens,4499,7,5,14,11,37,55,-18,29
Randers FC,4499,8,6,6,12,25,40,-15,24
Silkeborg IF,4499,9,5,4,13,26,45,-19,19
AGF Aarhus,4499,10,4,7,11,17,37,-20,19
Lyngby,4499,11,3,9,12,27,46,-19,18
Brondby,4500,1,21,5,4,72,32,40,68
FC Midtjylla,4500,2,20,4,6,66,41,25,64
Copenhagen,4500,3,15,5,10,61,44,17,50
FC Nords,4500,4,14,6,10,74,53,21,48
AaB,4500,5,8,12,10,39,45,-6,36
Sonderjyske,4500,6,8,6,10,28,29,-1,30
AC Horsens,4500,7,6,12,12,35,58,-23,30
Randers FC,4500,8,5,7,12,23,39,-16,22
AGF Aarhus,4500,9,5,6,11,17,36,-19,21
Lyngby,4500,10,3,10,11,26,44,-18,19
Silkeborg IF,4500,11,5,3,14,25,45,-20,18
FC Midtjylla,4501,1,22,4,4,72,34,38,70
Brondby,4501,2,21,5,4,73,34,39,68
Copenhagen,4501,3,15,5,10,61,45,16,50
FC Nords,4501,4,14,7,9,72,51,21,49
Sonderjyske,4501,5,8,6,10,28,29,-1,30
AaB,4501,6,6,12,12,36,46,-10,30
AC Horsens,4501,7,5,13,12,32,62,-30,28
Randers FC,4501,8,5,7,12,25,41,-16,22
AGF Aarhus,4501,9,5,6,11,19,38,-19,21
Lyngby,4501,10,3,10,11,28,46,-18,19
Silkeborg IF,4501,11,5,3,14,27,47,-20,18
Brondby,4502,1,23,5,2,78,31,47,74
FC Midtjylla,4502,2,20,4,6,68,41,27,64
Copenhagen,4502,3,14,5,11,58,45,13,47
FC Nords,4502,4,13,7,10,66,50,16,46
AaB,4502,5,7,12,11,37,44,-7,33
AC Horsens,4502,6,6,13,11,33,55,-22,31
Sonderjyske,4502,7,8,6,10,28,29,-1,30
Lyngby,4502,8,4,9,11,29,45,-16,21
Randers FC,4502,9,5,6,13,24,42,-18,21
AGF Aarhus,4502,10,5,6,11,18,37,-19,21
Silkeborg IF,4502,11,5,3,14,26,46,-20,18
Brondby,4503,1,21,6,3,75,37,38,69
FC Midtjylla,4503,2,17,4,9,57,39,18,55
FC Nords,4503,3,16,6,8,79,50,29,54
Copenhagen,4503,4,14,5,11,58,49,9,47
AaB,4503,5,9,12,9,39,39,0,39
AC Horsens,4503,6,6,13,11,33,53,-20,31
Sonderjyske,4503,7,8,6,10,28,29,-1,30
Randers FC,4503,8,6,6,12,24,39,-15,24
Silkeborg IF,4503,9,5,4,13,26,45,-19,19
AGF Aarhus,4503,10,4,7,11,17,37,-20,19
Lyngby,4503,11,3,9,12,26,45,-19,18
FC Midtjylla,4504,1,21,5,4,70,37,33,68
Brondby,4504,2,18,6,6,62,35,27,60
FC Nords,4504,3,14,8,8,73,52,21,50
Copenhagen,4504,4,14,6,10,63,45,18,48
AC Horsens,4504,5,7,13,10,35,53,-18,34
AaB,4504,6,7,12,11,37,44,-7,33
Sonderjyske,4504,7,8,6,10,28,29,-1,30
Lyngby,4504,8,4,9,11,28,44,-16,21
Silkeborg IF,4504,9,6,3,13,29,46,-17,21
Randers FC,4504,10,5,6,13,23,41,-18,21
AGF Aarhus,4504,11,4,6,12,18,40,-22,18
Brondby,4505,1,19,6,5,65,32,33,63
FC Midtjylla,4505,2,19,5,6,62,42,20,62
FC Nords,4505,3,15,6,9,79,47,32,51
Copenhagen,4505,4,15,4,11,60,45,15,49
AaB,4505,5,8,13,9,37,42,-5,37
AC Horsens,4505,6,7,12,11,34,55,-21,33
Sonderjyske,4505,7,8,6,10,28,29,-1,30
Randers FC,4505,8,6,6,12,25,40,-15,24
Silkeborg IF,4505,9,6,3,13,26,44,-18,21
Lyngby,4505,10,3,9,12,27,46,-19,18
AGF Aarhus,4505,11,4,6,12,16,37,-21,18
Brondby,4506,1,20,7,3,71,34,37,67
FC Midtjylla,4506,2,20,5,5,66,38,28,65
Copenhagen,4506,3,16,4,10,62,43,19,52
FC Nords,4506,4,13,6,11,73,56,17,45
AaB,4506,5,7,12,11,36,43,-7,33
AC Horsens,4506,6,7,12,11,35,55,-20,33
Sonderjyske,4506,7,8,6,10,28,29,-1,30
Randers FC,4506,8,6,6,12,26,41,-15,24
Silkeborg IF,4506,9,6,3,13,26,44,-18,21
Lyngby,4506,10,3,9,12,28,47,-19,18
AGF Aarhus,4506,11,4,6,12,16,37,-21,18
Brondby,4507,1,21,5,4,69,32,37,68
FC Midtjylla,4507,2,21,5,4,71,38,33,68
FC Nords,4507,3,13,6,11,71,56,15,45
Copenhagen,4507,4,12,4,14,57,54,3,40
AaB,4507,5,8,13,9,40,42,-2,37
AC Horsens,4507,6,8,13,9,40,52,-12,37
Sonderjyske,4507,7,8,6,10,28,29,-1,30
Randers FC,4507,8,5,7,12,23,39,-16,22
AGF Aarhus,4507,9,5,6,11,17,36,-19,21
Lyngby,4507,10,3,10,11,26,44,-18,19
Silkeborg IF,4507,11,5,3,14,25,45,-20,18
Brondby,4508,1,21,7,2,70,28,42,70
FC Midtjylla,4508,2,20,6,4,65,36,29,66
Copenhagen,4508,3,13,7,10,54,41,13,46
FC Nords,4508,4,13,6,11,69,53,16,45
AaB,4508,5,8,12,10,38,41,-3,36
Sonderjyske,4508,6,8,6,10,28,29,-1,30
AC Horsens,4508,7,5,14,11,33,56,-23,29
Lyngby,4508,8,4,9,11,27,44,-17,21
Randers FC,4508,9,5,6,13,23,40,-17,21
Silkeborg IF,4508,10,6,3,13,26,44,-18,21
AGF Aarhus,4508,11,4,6,12,16,37,-21,18
Brondby,4509,1,21,6,3,69,32,37,69
FC Midtjylla,4509,2,19,5,6,67,39,28,62
FC Nords,4509,3,14,8,8,76,51,25,50
Copenhagen,4509,4,14,4,12,55,43,12,46
AaB,4509,5,8,12,10,37,45,-8,36
AC Horsens,4509,6,6,13,11,34,54,-20,31
Sonderjyske,4509,7,8,6,10,28,29,-1,30
Randers FC,4509,8,6,6,12,26,40,-14,24
Silkeborg IF,4509,9,6,3,13,27,44,-17,21
Lyngby,4509,10,3,9,12,27,47,-20,18
AGF Aarhus,4509,11,4,6,12,16,38,-22,18
FC Midtjylla,4510,1,21,4,5,68,38,30,67
Brondby,4510,2,19,6,5,65,33,32,63
Copenhagen,4510,3,15,5,10,62,42,20,50
FC Nords,4510,4,13,9,8,74,51,23,48
AaB,4510,5,8,12,10,40,45,-5,36
Sonderjyske,4510,6,8,6,10,28,29,-1,30
AC Horsens,4510,7,5,14,11,34,60,-26,29
Randers FC,4510,8,5,7,12,24,40,-16,22
AGF Aarhus,4510,9,5,6,11,17,36,-19,21
Lyngby,4510,10,3,10,11,27,45,-18,19
Silkeborg IF,4510,11,5,3,14,25,45,-20,18
Brondby,4511,1,22,5,3,74,30,44,71
FC Midtjylla,4511,2,18,6,6,64,43,21,60
FC Nords,4511,3,15,7,8,71,49,22,52
Copenhagen,4511,4,13,5,12,58,49,9,44
AC Horsens,4511,5,7,13,10,37,52,-15,34
AaB,4511,6,6,14,10,36,43,-7,32
Sonderjyske,4511,7,8,6,10,28,29,-1,30
Randers FC,4511,8,6,6,12,26,39,-13,24
Silkeborg IF,4511,9,5,4,13,26,45,-19,19
AGF Aarhus,4511,10,4,7,11,17,37,-20,19
Lyngby,4511,11,3,9,12,26,47,-21,18
Brondby,4512,1,20,7,3,72,31,41,67
FC Midtjylla,4512,2,20,6,4,71,39,32,66
Copenhagen,4512,3,14,6,10,56,42,14,48
FC Nords,4512,4,13,8,9,75,56,19,47
AaB,4512,5,9,11,10,38,44,-6,38
Sonderjyske,4512,6,8,6,10,28,29,-1,30
AC Horsens,4512,7,5,12,13,32,58,-26,27
Randers FC,4512,8,5,7,12,25,41,-16,22
Silkeborg IF,4512,9,6,3,13,28,45,-17,21
Lyngby,4512,10,3,10,11,28,46,-18,19
AGF Aarhus,4512,11,4,6,12,17,39,-22,18
Brondby,4513,1,22,5,3,74,33,41,71
FC Midtjylla,4513,2,19,4,7,66,40,26,61
Copenhagen,4513,3,15,4,11,58,47,11,49
FC Nords,4513,4,13,8,9,70,56,14,47
AaB,4513,5,7,13,10,38,43,-5,34
AC Horsens,4513,6,6,14,10,41,54,-13,32
Sonderjyske,4513,7,8,6,10,28,29,-1,30
Randers FC,4513,8,6,6,12,25,39,-14,24
AGF Aarhus,4513,9,5,6,11,17,36,-19,21
Lyngby,4513,10,3,9,12,26,46,-20,18
Silkeborg IF,4513,11,5,3,14,25,45,-20,18
Brondby,4514,1,21,6,3,73,33,40,69
FC Midtjylla,4514,2,19,4,7,63,44,19,61
FC Nords,4514,3,14,6,10,75,56,19,48
Copenhagen,4514,4,14,4,12,59,47,12,46
AaB,4514,5,8,12,10,38,41,-3,36
AC Horsens,4514,6,7,14,9,36,49,-13,35
Sonderjyske,4514,7,8,6,10,28,29,-1,30
Lyngby,4514,8,4,9,11,29,46,-17,21
Randers FC,4514,9,5,6,13,25,42,-17,21
Silkeborg IF,4514,10,5,4,13,26,45,-19,19
AGF Aarhus,4514,11,4,7,11,17,37,-20,19
Brondby,4515,1,20,7,3,69,31,38,67
FC Midtjylla,4515,2,19,6,5,64,38,26,63
FC Nords,4515,3,14,7,9,73,54,19,49
Copenhagen,4515,4,14,5,11,58,46,12,47
AaB,4515,5,8,11,11,38,47,-9,35
AC Horsens,4515,6,7,12,11,38,50,-12,33
Sonderjyske,4515,7,8,6,10,28,29,-1,30
Silkeborg IF,4515,8,6,3,13,28,44,-16,21
Lyngby,4515,9,4,9,11,28,45,-17,21
Randers FC,4515,10,5,6,13,24,41,-17,21
AGF Aarhus,4515,11,4,6,12,16,39,-23,18
Brondby,4516,1,21,7,2,70,31,39,70
FC Midtjylla,4516,2,20,4,6,70,42,28,64
FC Nords,4516,3,14,8,8,74,50,24,50
Copenhagen,4516,4,13,6,11,56,44,12,45
AaB,4516,5,7,11,12,35,45,-10,32
AC Horsens,4516,6,6,14,10,34,53,-19,32
Sonderjyske,4516,7,8,6,10,28,29,-1,30
Randers FC,4516,8,6,6,12,26,39,-13,24
Silkeborg IF,4516,9,6,3,13,26,44,-18,21
Lyngby,4516,10,3,9,12,26,47,-21,18
AGF Aarhus,4516,11,4,6,12,16,37,-21,18
Brondby,4517,1,21,5,4,75,37,38,68
FC Midtjylla,4517,2,20,4,6,67,40,27,64
FC Nords,4517,3,15,6,9,72,49,23,51
Copenhagen,4517,4,15,4,11,62,46,16,49
AC Horsens,4517,5,8,12,10,40,58,-18,36
Sonderjyske,4517,6,8,6,10,28,29,-1,30
AaB,4517,7,6,11,13,41,53,-12,29
Lyngby,4517,8,4,9,11,29,44,-15,21
AGF Aarhus,4517,9,5,6,11,18,36,-18,21
Randers FC,4517,10,5,6,13,23,42,-19,21
Silkeborg IF,4517,11,5,3,14,25,46,-21,18
Brondby,4518,1,20,6,4,68,34,34,66
FC Midtjylla,4518,2,19,5,6,68,41,27,62
Copenhagen,4518,3,16,5,9,63,43,20,53
FC Nords,4518,4,14,8,8,73,51,22,50
AaB,4518,5,7,11,12,36,47,-11,32
AC Horsens,4518,6,6,13,11,37,55,-18,31
Sonderjyske,4518,7,8,6,10,28,29,-1,30
Randers FC,4518,8,6,6,12,25,40,-15,24
AGF Aarhus,4518,9,5,6,11,17,36,-19,21
Lyngby,4518,10,3,9,12,27,46,-19,18
Silkeborg IF,4518,11,5,3,14,25,45,-20,18
Brondby,4519,1,21,6,3,77,34,43,69
FC Midtjylla,4519,2,19,7,4,67,40,27,64
FC Nords,4519,3,14,8,8,79,56,23,50
Copenhagen,4519,4,14,6,10,59,45,14,48
AC Horsens,4519,5,6,14,10,34,50,-16,32
Sonderjyske,4519,6,8,6,10,28,29,-1,30
AaB,4519,7,6,11,13,37,54,-17,29
Lyngby,4519,8,4,9,11,29,44,-15,21
Randers FC,4519,9,5,6,13,23,42,-19,21
AGF Aarhus,4519,10,5,6,11,17,36,-19,21
Silkeborg IF,4519,11,5,3,14,25,45,-20,18
Brondby,4520,1,22,5,3,78,32,46,71
FC Midtjylla,4520,2,21,4,5,68,35,33,67
Copenhagen,4520,3,15,5,10,60,44,16,50
FC Nords,4520,4,14,7,9,69,51,18,49
AaB,4520,5,7,11,12,36,47,-11,32
Sonderjyske,4520,6,8,6,10,28,29,-1,30
AC Horsens,4520,7,5,12,13,35,63,-28,27
Lyngby,4520,8,4,9,11,31,46,-15,21
Silkeborg IF,4520,9,6,3,13,26,44,-18,21
Randers FC,4520,10,5,6,13,25,44,-19,21
AGF Aarhus,4520,11,4,6,12,16,37,-21,18
Brondby,4521,1,21,6,3,69,32,37,69
FC Midtjylla,4521,2,18,6,6,64,41,23,60
Copenhagen,4521,3,14,6,10,58,47,11,48
FC Nords,4521,4,13,7,10,71,53,18,46
AaB,4521,5,8,12,10,40,39,1,36
AC Horsens,4521,6,7,13,10,35,51,-16,34
Sonderjyske,4521,7,8,6,10,28,29,-1,30
Silkeborg IF,4521,8,6,3,13,31,45,-14,21
Lyngby,4521,9,4,9,11,29,45,-16,21
Randers FC,4521,10,5,6,13,24,42,-18,21
AGF Aarhus,4521,11,4,6,12,17,42,-25,18
Brondby,4522,1,20,7,3,71,31,40,67
FC Midtjylla,4522,2,20,5,5,68,39,29,65
FC Nords,4522,3,14,7,9,71,54,17,49
Copenhagen,4522,4,13,7,10,60,48,12,46
AaB,4522,5,7,13,10,35,39,-4,34
Sonderjyske,4522,6,8,6,10,28,29,-1,30
AC Horsens,4522,7,5,15,10,35,55,-20,30
Randers FC,4522,8,6,6,12,25,39,-14,24
Silkeborg IF,4522,9,6,3,13,26,44,-18,21
Lyngby,4522,10,3,9,12,26,46,-20,18
AGF Aarhus,4522,11,4,6,12,16,37,-21,18
Brondby,4523,1,21,6,3,73,32,41,69
FC Midtjylla,4523,2,20,5,5,73,42,31,65
FC Nords,4523,3,13,8,9,71,56,15,47
Copenhagen,4523,4,13,7,10,56,43,13,46
AaB,4523,5,7,12,11,38,47,-9,33
AC Horsens,4523,6,6,14,10,37,54,-17,32
Sonderjyske,4523,7,8,6,10,28,29,-1,30
Randers FC,4523,8,6,6,12,25,40,-15,24
Silkeborg IF,4523,9,6,3,13,26,44,-18,21
Lyngby,4523,10,3,9,12,27,46,-19,18
AGF Aarhus,4523,11,4,6,12,16,37,-21,18
Brondby,4524,1,23,5,2,70,30,40,74
FC Midtjylla,4524,2,19,5,6,69,41,28,62
FC Nords,4524,3,15,7,8,78,51,27,52
Copenhagen,4524,4,14,4,12,55,44,11,46
AaB,4524,5,8,11,11,39,44,-5,35
Sonderjyske,4524,6,8,6,10,28,29,-1,30
AC Horsens,4524,7,5,12,13,33,60,-27,27
Lyngby,4524,8,4,9,11,29,46,-17,21
Randers FC,4524,9,5,6,13,25,42,-17,21
Silkeborg IF,4524,10,5,4,13,26,45,-19,19
AGF Aarhus,4524,11,4,7,11,17,37,-20,19
Brondby,4525,1,22,6,2,78,33,45,72
FC Midtjylla,4525,2,21,4,5,68,39,29,67
FC Nords,4525,3,15,6,9,77,56,21,51
Copenhagen,4525,4,13,4,13,55,52,3,43
AaB,4525,5,8,11,11,39,42,-3,35
Sonderjyske,4525,6,8,6,10,28,29,-1,30
AC Horsens,4525,7,5,13,12,35,56,-21,28
Randers FC,4525,8,5,7,12,23,39,-16,22
Silkeborg IF,4525,9,6,3,13,28,45,-17,21
Lyngby,4525,10,3,10,11,26,44,-18,19
AGF Aarhus,4525,11,4,6,12,17,39,-22,18
Brondby,4526,1,21,7,2,72,33,39,70
FC Midtjylla,4526,2,18,6,6,61,37,24,60
FC Nords,4526,3,14,7,9,72,50,22,49
Copenhagen,4526,4,14,5,11,55,44,11,47
AaB,4526,5,7,13,10,35,40,-5,34
AC Horsens,4526,6,5,16,9,33,50,-17,31
Sonderjyske,4526,7,8,6,10,28,29,-1,30
Randers FC,4526,8,5,7,12,23,39,-16,22
Lyngby,4526,9,3,10,11,26,44,-18,19
Silkeborg IF,4526,10,5,4,13,26,45,-19,19
AGF Aarhus,4526,11,4,7,11,17,37,-20,19
Brondby,4527,1,20,7,3,70,34,36,67
FC Midtjylla,4527,2,20,4,6,65,38,27,64
FC Nords,4527,3,15,8,7,77,52,25,53
Copenhagen,4527,4,13,6,11,54,43,11,45
AaB,4527,5,7,13,10,34,41,-7,34
Sonderjyske,4527,6,8,6,10,28,29,-1,30
AC Horsens,4527,7,5,14,11,34,52,-18,29
Lyngby,4527,8,4,9,11,27,44,-17,21
Randers FC,4527,9,5,6,13,23,40,-17,21
Silkeborg IF,4527,10,5,4,13,25,44,-19,19
AGF Aarhus,4527,11,4,7,11,16,36,-20,19
Brondby,4528,1,21,7,2,71,31,40,70
FC Midtjylla,4528,2,18,5,7,62,41,21,59
Copenhagen,4528,3,15,5,10,59,41,18,50
FC Nords,4528,4,13,7,10,72,55,17,46
AaB,4528,5,8,11,11,37,42,-5,35
AC Horsens,4528,6,6,15,9,33,50,-17,33
Sonderjyske,4528,7,8,6,10,28,29,-1,30
Randers FC,4528,8,5,7,12,24,40,-16,22
AGF Aarhus,4528,9,5,6,11,17,36,-19,21
Lyngby,4528,10,3,10,11,27,45,-18,19
Silkeborg IF,4528,11,5,3,14,25,45,-20,18
FC Midtjylla,4529,1,21,4,5,65,36,29,67
Brondby,4529,2,19,5,6,63,35,28,62
Copenhagen,4529,3,16,4,10,63,43,20,52
FC Nords,4529,4,14,7,9,72,52,20,49
AaB,4529,5,8,12,10,40,44,-4,36
Sonderjyske,4529,6,8,6,10,28,29,-1,30
AC Horsens,4529,7,6,12,12,37,56,-19,30
Randers FC,4529,8,6,6,12,24,39,-15,24
AGF Aarhus,4529,9,5,6,11,18,37,-19,21
Lyngby,4529,10,3,9,12,26,45,-19,18
Silkeborg IF,4529,11,5,3,14,26,46,-20,18
Brondby,4530,1,20,8,2,70,33,37,68
FC Midtjylla,4530,2,19,5,6,64,38,26,62
Copenhagen,4530,3,16,5,9,59,42,17,53
FC Nords,4530,4,13,6,11,67,50,17,45
AaB,4530,5,7,12,11,38,44,-6,33
AC Horsens,4530,6,6,14,10,35,52,-17,32
Sonderjyske,4530,7,8,6,10,28,29,-1,30
Lyngby,4530,8,4,9,11,28,45,-17,21
Randers FC,4530,9,5,6,13,24,41,-17,21
Silkeborg IF,4530,10,5,4,13,26,45,-19,19
AGF Aarhus,4530,11,4,7,11,17,37,-20,19
Brondby,4531,1,20,6,4,66,32,34,66
FC Midtjylla,4531,2,19,7,4,65,38,27,64
FC Nords,4531,3,15,7,8,75,47,28,52
Copenhagen,4531,4,15,5,10,58,45,13,50
AaB,4531,5,7,13,10,35,41,-6,34
Sonderjyske,4531,6,8,6,10,28,29,-1,30
AC Horsens,4531,7,5,12,13,34,56,-22,27
Lyngby,4531,8,4,9,11,27,44,-17,21
Randers FC,4531,9,5,6,13,23,40,-17,21
Silkeborg IF,4531,10,5,4,13,27,46,-19,19
AGF Aarhus,4531,11,4,7,11,18,38,-20,19
Brondby,4532,1,20,6,4,70,32,38,66
FC Midtjylla,4532,2,19,5,6,67,40,27,62
Copenhagen,4532,3,15,6,9,57,41,16,51
FC Nords,4532,4,14,7,9,70,52,18,49
AaB,4532,5,8,11,11,37,43,-6,35
Sonderjyske,4532,6,8,6,10,28,29,-1,30
AC Horsens,4532,7,5,15,10,31,50,-19,30
Randers FC,4532,8,5,7,12,24,40,-16,22
AGF Aarhus,4532,9,5,6,11,18,37,-19,21
Lyngby,4532,10,3,10,11,27,45,-18,19
Silkeborg IF,4532,11,5,3,14,26,46,-20,18
Brondby,4533,1,20,7,3,70,35,35,67
FC Midtjylla,4533,2,20,6,4,66,35,31,66
FC Nords,4533,3,15,6,9,77,50,27,51
Copenhagen,4533,4,14,6,10,58,46,12,48
AC Horsens,4533,5,6,13,11,35,58,-23,31
Sonderjyske,4533,6,8,6,10,28,29,-1,30
AaB,4533,7,6,12,12,32,40,-8,30
Randers FC,4533,8,6,6,12,24,39,-15,24
AGF Aarhus,4533,9,5,6,11,18,37,-19,21
Lyngby,4533,10,3,9,12,26,45,-19,18
Silkeborg IF,4533,11,5,3,14,26,46,-20,18
Brondby,4534,1,21,6,3,71,31,40,69
FC Midtjylla,4534,2,20,4,6,66,40,26,64
FC Nords,4534,3,15,6,9,73,53,20,51
Copenhagen,4534,4,14,5,11,57,42,15,47
AC Horsens,4534,5,7,13,10,32,49,-17,34
Sonderjyske,4534,6,8,6,10,28,29,-1,30
AaB,4534,7,6,12,12,33,43,-10,30
Randers FC,4534,8,5,7,12,23,39,-16,22
Silkeborg IF,4534,9,6,3,13,29,45,-16,21
Lyngby,4534,10,3,10,11,26,44,-18,19
AGF Aarhus,4534,11,4,6,12,17,40,-23,18
Brondby,4535,1,21,6,3,67,31,36,69
FC Midtjylla,4535,2,21,4,5,69,37,32,67
FC Nords,4535,3,13,9,8,73,51,22,48
Copenhagen,4535,4,13,5,12,54,43,11,44
AaB,4535,5,8,12,10,37,42,-5,36
Sonderjyske,4535,6,8,6,10,28,29,-1,30
AC Horsens,4535,7,6,12,12,33,55,-22,30
Lyngby,4535,8,4,9,11,29,44,-15,21
Randers FC,4535,9,5,6,13,23,42,-19,21
AGF Aarhus,4535,10,5,6,11,17,36,-19,21
Silkeborg IF,4535,11,5,3,14,25,45,-20,18
Brondby,4536,1,21,6,3,71,35,36,69
FC Midtjylla,4536,2,18,7,5,66,40,26,61
Copenhagen,4536,3,15,4,11,60,45,15,49
FC Nords,4536,4,13,7,10,77,58,19,46
AaB,4536,5,8,13,9,39,42,-3,37
AC Horsens,4536,6,6,13,11,35,54,-19,31
Sonderjyske,4536,7,8,6,10,28,29,-1,30
Randers FC,4536,8,5,7,12,23,39,-16,22
Silkeborg IF,4536,9,6,3,13,27,45,-18,21
Lyngby,4536,10,3,10,11,26,44,-18,19
AGF Aarhus,4536,11,4,6,12,17,38,-21,18
Brondby,4537,1,19,8,3,73,38,35,65
FC Midtjylla,4537,2,18,5,7,66,45,21,59
Copenhagen,4537,3,16,4,10,62,43,19,52
FC Nords,4537,4,14,7,9,73,52,21,49
AaB,4537,5,9,11,10,36,39,-3,38
AC Horsens,4537,6,6,13,11,37,56,-19,31
Sonderjyske,4537,7,8,6,10,28,29,-1,30
Randers FC,4537,8,5,7,12,23,39,-16,22
AGF Aarhus,4537,9,5,6,11,18,37,-19,21
Lyngby,4537,10,3,10,11,26,44,-18,19
Silkeborg IF,4537,11,5,3,14,26,46,-20,18
Brondby,4538,1,20,6,4,73,37,36,66
FC Midtjylla,4538,2,19,6,5,65,39,26,63
Copenhagen,4538,3,15,4,11,59,42,17,49
FC Nords,4538,4,13,8,9,73,55,18,47
AaB,4538,5,9,12,9,39,42,-3,39
Sonderjyske,4538,6,8,6,10,28,29,-1,30
AC Horsens,4538,7,5,14,11,32,52,-20,29
Lyngby,4538,8,4,9,11,29,45,-16,21
Silkeborg IF,4538,9,6,3,13,26,44,-18,21
Randers FC,4538,10,5,6,13,24,42,-18,21
AGF Aarhus,4538,11,4,6,12,16,37,-21,18
Brondby,4539,1,21,6,3,69,30,39,69
FC Midtjylla,4539,2,17,7,6,61,39,22,58
FC Nords,4539,3,16,6,8,79,51,28,54
Copenhagen,4539,4,14,5,11,56,44,12,47
AC Horsens,4539,5,7,13,10,34,54,-20,34
AaB,4539,6,6,13,11,37,44,-7,31
Sonderjyske,4539,7,8,6,10,28,29,-1,30
Lyngby,4539,8,4,9,11,27,44,-17,21
Randers FC,4539,9,5,6,13,23,40,-17,21
Silkeborg IF,4539,10,6,3,13,28,46,-18,21
AGF Aarhus,4539,11,4,6,12,18,39,-21,18
Brondby,4540,1,21,5,4,71,33,38,68
FC Midtjylla,4540,2,19,6,5,65,37,28,63
FC Nords,4540,3,14,6,10,72,57,15,48
Copenhagen,4540,4,14,5,11,58,46,12,47
AaB,4540,5,9,11,10,41,42,-1,38
AC Horsens,4540,6,6,13,11,35,53,-18,31
Sonderjyske,4540,7,8,6,10,28,29,-1,30
Randers FC,4540,8,5,7,12,24,40,-16,22
Lyngby,4540,9,3,10,11,27,45,-18,19
Silkeborg IF,4540,10,5,4,13,26,45,-19,19
AGF Aarhus,4540,11,4,7,11,17,37,-20,19
Brondby,4541,1,20,7,3,67,30,37,67
FC Midtjylla,4541,2,19,5,6,64,41,23,62
FC Nords,4541,3,15,6,9,72,52,20,51
Copenhagen,4541,4,15,5,10,59,39,20,50
AC Horsens,4541,5,6,14,10,34,52,-18,32
AaB,4541,6,6,13,11,34,42,-8,31
Sonderjyske,4541,7,8,6,10,28,29,-1,30
Randers FC,4541,8,6,6,12,25,40,-15,24
AGF Aarhus,4541,9,5,6,11,19,37,-18,21
Lyngby,4541,10,3,9,12,27,46,-19,18
Silkeborg IF,4541,11,5,3,14,26,47,-21,18
Brondby,4542,1,20,5,5,68,34,34,65
FC Midtjylla,4542,2,19,5,6,65,42,23,62
FC Nords,4542,3,15,8,7,78,50,28,53
Copenhagen,4542,4,14,4,12,57,48,9,46
AaB,4542,5,8,11,11,36,43,-7,35
AC Horsens,4542,6,7,13,10,39,52,-13,34
Sonderjyske,4542,7,8,6,10,28,29,-1,30
Randers FC,4542,8,6,6,12,27,42,-15,24
Silkeborg IF,4542,9,6,3,13,26,44,-18,21
Lyngby,4542,10,3,9,12,29,48,-19,18
AGF Aarhus,4542,11,4,6,12,16,37,-21,18
Brondby,4543,1,20,5,5,69,40,29,65
FC Midtjylla,4543,2,19,5,6,64,38,26,62
FC Nords,4543,3,15,7,8,74,50,24,52
Copenhagen,4543,4,14,5,11,61,46,15,47
AaB,4543,5,9,12,9,40,41,-1,39
Sonderjyske,4543,6,8,6,10,28,29,-1,30
AC Horsens,4543,7,6,12,12,35,54,-19,30
Randers FC,4543,8,5,7,12,24,40,-16,22
AGF Aarhus,4543,9,5,6,11,17,36,-19,21
Lyngby,4543,10,3,10,11,27,45,-18,19
Silkeborg IF,4543,11,5,3,14,25,45,-20,18
Brondby,4544,1,20,7,3,70,35,35,67
FC Midtjylla,4544,2,19,6,5,67,40,27,63
Copenhagen,4544,3,14,7,9,57,42,15,49
FC Nords,4544,4,13,7,10,73,55,18,46
AC Horsens,4544,5,7,13,10,37,52,-15,34
AaB,4544,6,7,12,11,37,43,-6,33
Sonderjyske,4544,7,8,6,10,28,29,-1,30
Silkeborg IF,4544,8,6,3,13,28,44,-16,21
Lyngby,4544,9,4,9,11,28,45,-17,21
Randers FC,4544,10,5,6,13,24,41,-17,21
AGF Aarhus,4544,11,4,6,12,16,39,-23,18
Brondby,4545,1,22,5,3,72,31,41,71
FC Midtjylla,4545,2,20,4,6,66,41,25,64
Copenhagen,4545,3,15,5,10,61,48,13,50
FC Nords,4545,4,14,7,9,75,51,24,49
AaB,4545,5,6,13,11,36,43,-7,31
Sonderjyske,4545,6,8,6,10,28,29,-1,30
AC Horsens,4545,7,5,14,11,32,54,-22,29
Lyngby,4545,8,4,9,11,28,44,-16,21
Randers FC,4545,9,5,6,13,23,41,-18,21
Silkeborg IF,4545,10,5,4,13,25,44,-19,19
AGF Aarhus,4545,11,4,7,11,16,36,-20,19
Brondby,4546,1,22,5,3,74,30,44,71
FC Midtjylla,4546,2,21,4,5,62,39,23,67
FC Nords,4546,3,14,7,9,73,50,23,49
Copenhagen,4546,4,14,5,11,54,42,12,47
AaB,4546,5,6,13,11,35,44,-9,31
Sonderjyske,4546,6,8,6,10,28,29,-1,30
AC Horsens,4546,7,5,14,11,34,53,-19,29
Randers FC,4546,8,5,7,12,24,40,-16,22
Silkeborg IF,4546,9,6,3,13,28,44,-16,21
Lyngby,4546,10,3,10,11,27,45,-18,19
AGF Aarhus,4546,11,4,6,12,16,39,-23,18
Brondby,4547,1,20,5,5,68,34,34,65
FC Midtjylla,4547,2,19,5,6,62,36,26,62
FC Nords,4547,3,15,7,8,71,48,23,52
Copenhagen,4547,4,13,5,12,57,46,11,44
AaB,4547,5,9,12,9,38,40,-2,39
AC Horsens,4547,6,7,12,11,35,53,-18,33
Sonderjyske,4547,7,8,6,10,28,29,-1,30
Randers FC,4547,8,5,7,12,24,40,-16,22
AGF Aarhus,4547,9,5,6,11,17,36,-19,21
Lyngby,4547,10,3,10,11,27,45,-18,19
Silkeborg IF,4547,11,5,3,14,25,45,-20,18
Brondby,4548,1,21,6,3,80,38,42,69
FC Midtjylla,4548,2,19,5,6,65,40,25,62
FC Nords,4548,3,13,8,9,75,56,19,47
Copenhagen,4548,4,13,5,12,55,46,9,44
AaB,4548,5,9,12,9,38,44,-6,39
AC Horsens,4548,6,6,14,10,36,51,-15,32
Sonderjyske,4548,7,8,6,10,28,29,-1,30
Lyngby,4548,8,4,9,11,28,45,-17,21
Randers FC,4548,9,5,6,13,24,41,-17,21
AGF Aarhus,4548,10,5,6,11,19,38,-19,21
Silkeborg IF,4548,11,5,3,14,27,47,-20,18
FC Midtjylla,4549,1,22,4,4,71,36,35,70
Brondby,4549,2,20,5,5,66,35,31,65
Copenhagen,4549,3,16,4,10,60,41,19,52
FC Nords,4549,4,13,7,10,74,54,20,46
AaB,4549,5,7,13,10,38,45,-7,34
Sonderjyske,4549,6,8,6,10,28,29,-1,30
AC Horsens,4549,7,5,13,12,35,59,-24,28
Randers FC,4549,8,5,7,12,24,40,-16,22
Silkeborg IF,4549,9,6,3,13,26,44,-18,21
Lyngby,4549,10,3,10,11,27,45,-18,19
AGF Aarhus,4549,11,4,6,12,16,37,-21,18
Brondby,4550,1,21,7,2,68,28,40,70
FC Midtjylla,4550,2,20,5,5,63,35,28,65
Copenhagen,4550,3,14,6,10,58,43,15,48
FC Nords,4550,4,12,8,10,70,56,14,44
AaB,4550,5,8,12,10,34,38,-4,36
Sonderjyske,4550,6,8,6,10,28,29,-1,30
AC Horsens,4550,7,5,14,11,33,52,-19,29
Lyngby,4550,8,4,9,11,31,44,-13,21
AGF Aarhus,4550,9,5,6,11,19,36,-17,21
Randers FC,4550,10,5,6,13,23,44,-21,21
Silkeborg IF,4550,11,5,3,14,25,47,-22,18
Brondby,4551,1,21,6,3,70,34,36,69
FC Midtjylla,4551,2,20,5,5,71,41,30,65
FC Nords,4551,3,14,6,10,72,53,19,48
Copenhagen,4551,4,14,5,11,60,46,14,47
AaB,4551,5,8,12,10,38,44,-6,36
Sonderjyske,4551,6,8,6,10,28,29,-1,30
AC Horsens,4551,7,6,12,12,33,52,-19,30
Randers FC,4551,8,5,7,12,24,40,-16,22
Silkeborg IF,4551,9,6,3,13,31,45,-14,21
Lyngby,4551,10,3,10,11,27,45,-18,19
AGF Aarhus,4551,11,4,6,12,17,42,-25,18
Brondby,4552,1,22,5,3,74,32,42,71
FC Midtjylla,4552,2,18,6,6,65,41,24,60
Copenhagen,4552,3,15,5,10,59,41,18,50
FC Nords,4552,4,14,7,9,71,50,21,49
AaB,4552,5,7,12,11,35,47,-12,33
AC Horsens,4552,6,6,13,11,35,54,-19,31
Sonderjyske,4552,7,8,6,10,28,29,-1,30
Silkeborg IF,4552,8,6,3,13,29,45,-16,21
Lyngby,4552,9,4,9,11,29,46,-17,21
Randers FC,4552,10,5,6,13,25,42,-17,21
AGF Aarhus,4552,11,4,6,12,17,40,-23,18
Brondby,4553,1,20,7,3,73,34,39,67
FC Midtjylla,4553,2,19,5,6,68,40,28,62
FC Nords,4553,3,13,9,8,75,54,21,48
Copenhagen,4553,4,14,5,11,58,48,10,47
AC Horsens,4553,5,7,14,9,37,50,-13,35
AaB,4553,6,6,14,10,33,44,-11,32
Sonderjyske,4553,7,8,6,10,28,29,-1,30
Lyngby,4553,8,4,9,11,29,46,-17,21
Randers FC,4553,9,5,6,13,25,42,-17,21
Silkeborg IF,4553,10,6,3,13,26,44,-18,21
AGF Aarhus,4553,11,4,6,12,16,37,-21,18
Brondby,4554,1,21,7,2,81,34,47,70
FC Midtjylla,4554,2,19,6,5,71,42,29,63
FC Nords,4554,3,15,6,9,71,56,15,51
Copenhagen,4554,4,13,6,11,60,47,13,45
AaB,4554,5,7,13,10,38,48,-10,34
Sonderjyske,4554,6,8,6,10,28,29,-1,30
AC Horsens,4554,7,5,14,11,35,55,-20,29
Lyngby,4554,8,4,9,11,28,45,-17,21
Randers FC,4554,9,5,6,13,24,41,-17,21
AGF Aarhus,4554,10,5,6,11,18,36,-18,21
Silkeborg IF,4554,11,5,3,14,25,46,-21,18
Brondby,4555,1,21,5,4,69,32,37,68
FC Midtjylla,4555,2,19,4,7,60,42,18,61
FC Nords,4555,3,15,8,7,76,46,30,53
Copenhagen,4555,4,15,5,10,58,41,17,50
AaB,4555,5,7,11,12,33,45,-12,32
AC Horsens,4555,6,6,13,11,34,50,-16,31
Sonderjyske,4555,7,8,6,10,28,29,-1,30
Randers FC,4555,8,5,7,12,24,40,-16,22
AGF Aarhus,4555,9,5,6,11,19,38,-19,21
Lyngby,4555,10,3,10,11,27,45,-18,19
Silkeborg IF,4555,11,5,3,14,27,47,-20,18
Brondby,4556,1,19,7,4,70,37,33,64
FC Midtjylla,4556,2,19,6,5,70,40,30,63
Copenhagen,4556,3,15,4,11,62,47,15,49
FC Nords,4556,4,13,7,10,74,57,17,46
AC Horsens,4556,5,7,15,8,42,53,-11,36
AaB,4556,6,8,11,11,43,53,-10,35
Sonderjyske,4556,7,8,6,10,28,29,-1,30
Randers FC,4556,8,5,7,12,23,39,-16,22
Lyngby,4556,9,3,10,11,26,44,-18,19
Silkeborg IF,4556,10,5,4,13,26,45,-19,19
AGF Aarhus,4556,11,4,7,11,17,37,-20,19
Brondby,4557,1,21,7,2,76,32,44,70
FC Midtjylla,4557,2,21,5,4,65,35,30,68
FC Nords,4557,3,13,6,11,70,53,17,45
Copenhagen,4557,4,13,5,12,56,48,8,44
AaB,4557,5,8,11,11,36,42,-6,35
AC Horsens,4557,6,7,12,11,36,55,-19,33
Sonderjyske,4557,7,8,6,10,28,29,-1,30
Randers FC,4557,8,6,6,12,26,40,-14,24
Silkeborg IF,4557,9,6,3,13,26,44,-18,21
Lyngby,4557,10,3,9,12,27,47,-20,18
AGF Aarhus,4557,11,4,6,12,16,37,-21,18
Brondby,4558,1,21,5,4,74,31,43,68
FC Midtjylla,4558,2,21,4,5,65,39,26,67
FC Nords,4558,3,13,7,10,71,56,15,46
Copenhagen,4558,4,14,4,12,57,43,14,46
AaB,4558,5,10,11,9,37,39,-2,41
Sonderjyske,4558,6,8,6,10,28,29,-1,30
AC Horsens,4558,7,5,13,12,33,55,-22,28
Randers FC,4558,8,6,6,12,25,39,-14,24
AGF Aarhus,4558,9,5,6,11,21,37,-16,21
Lyngby,4558,10,3,9,12,26,46,-20,18
Silkeborg IF,4558,11,5,3,14,26,49,-23,18
Brondby,4559,1,20,6,4,70,35,35,66
FC Midtjylla,4559,2,18,5,7,62,43,19,59
FC Nords,4559,3,14,7,9,73,52,21,49
Copenhagen,4559,4,13,7,10,59,46,13,46
AaB,4559,5,10,11,9,43,41,2,41
AC Horsens,4559,6,6,14,10,37,53,-16,32
Sonderjyske,4559,7,8,6,10,28,29,-1,30
Randers FC,4559,8,5,7,12,24,40,-16,22
Silkeborg IF,4559,9,6,3,13,27,44,-17,21
Lyngby,4559,10,3,10,11,27,45,-18,19
AGF Aarhus,4559,11,4,6,12,16,38,-22,18
FC Midtjylla,4560,1,21,5,4,72,37,35,68
Brondby,4560,2,19,7,4,66,33,33,64
FC Nords,4560,3,13,8,9,75,53,22,47
Copenhagen,4560,4,14,4,12,58,55,3,46
AaB,4560,5,7,14,9,44,42,2,35
AC Horsens,4560,6,7,12,11,34,55,-21,33
Sonderjyske,4560,7,8,6,10,28,29,-1,30
Randers FC,4560,8,6,6,12,26,39,-13,24
Silkeborg IF,4560,9,6,3,13,27,45,-18,21
Lyngby,4560,10,3,9,12,26,47,-21,18
AGF Aarhus,4560,11,4,6,12,17,38,-21,18
Brondby,4561,1,19,7,4,67,34,33,64
FC Midtjylla,4561,2,18,7,5,62,38,24,61
FC Nords,4561,3,13,10,7,73,47,26,49
Copenhagen,4561,4,15,4,11,55,44,11,49
AaB,4561,5,8,13,9,37,40,-3,37
AC Horsens,4561,6,6,13,11,35,52,-17,31
Sonderjyske,4561,7,8,6,10,28,29,-1,30
Lyngby,4561,8,4,9,11,28,45,-17,21
Randers FC,4561,9,5,6,13,24,41,-17,21
Silkeborg IF,4561,10,6,3,13,26,44,-18,21
AGF Aarhus,4561,11,4,6,12,16,37,-21,18
Brondby,4562,1,20,7,3,69,33,36,67
FC Midtjylla,4562,2,19,6,5,67,38,29,63
FC Nords,4562,3,14,8,8,74,50,24,50
Copenhagen,4562,4,15,4,11,60,47,13,49
AaB,4562,5,7,14,9,38,42,-4,35
Sonderjyske,4562,6,8,6,10,28,29,-1,30
AC Horsens,4562,7,5,13,12,31,55,-24,28
Randers FC,4562,8,5,7,12,25,41,-16,22
Silkeborg IF,4562,9,6,3,13,27,45,-18,21
Lyngby,4562,10,3,10,11,28,46,-18,19
AGF Aarhus,4562,11,4,6,12,17,38,-21,18
Brondby,4563,1,20,6,4,71,36,35,66
FC Midtjylla,4563,2,19,6,5,70,44,26,63
FC Nords,4563,3,15,7,8,82,56,26,52
Copenhagen,4563,4,15,6,9,60,44,16,51
Sonderjyske,4563,5,8,6,10,28,29,-1,30
AaB,4563,6,6,12,12,33,43,-10,30
AC Horsens,4563,7,5,15,10,36,55,-19,30
Randers FC,4563,8,5,7,12,23,39,-16,22
Silkeborg IF,4563,9,6,3,13,27,44,-17,21
Lyngby,4563,10,3,10,11,26,44,-18,19
AGF Aarhus,4563,11,4,6,12,16,38,-22,18
Brondby,4564,1,20,6,4,72,39,33,66
FC Midtjylla,4564,2,20,5,5,65,39,26,65
FC Nords,4564,3,14,6,10,75,54,21,48
Copenhagen,4564,4,13,7,10,60,46,14,46
AaB,4564,5,8,13,9,38,39,-1,37
AC Horsens,4564,6,6,13,11,36,55,-19,31
Sonderjyske,4564,7,8,6,10,28,29,-1,30
Randers FC,4564,8,6,6,12,24,39,-15,24
AGF Aarhus,4564,9,5,6,11,17,36,-19,21
Lyngby,4564,10,3,9,12,26,45,-19,18
Silkeborg IF,4564,11,5,3,14,25,45,-20,18
FC Midtjylla,4565,1,20,5,5,70,40,30,65
Brondby,4565,2,19,6,5,67,34,33,63
Copenhagen,4565,3,14,6,10,56,43,13,48
FC Nords,4565,4,13,6,11,69,53,16,45
AaB,4565,5,9,13,8,40,41,-1,40
AC Horsens,4565,6,7,12,11,37,54,-17,33
Sonderjyske,4565,7,8,6,10,28,29,-1,30
Randers FC,4565,8,6,6,12,25,39,-14,24
Silkeborg IF,4565,9,5,4,13,28,47,-19,19
AGF Aarhus,4565,10,4,7,11,19,39,-20,19
Lyngby,4565,11,3,9,12,26,46,-20,18
Brondby,4566,1,20,8,2,73,31,42,68
FC Midtjylla,4566,2,21,5,4,67,36,31,68
FC Nords,4566,3,14,8,8,75,51,24,50
Copenhagen,4566,4,13,5,12,54,42,12,44
AaB,4566,5,8,11,11,37,48,-11,35
Sonderjyske,4566,6,8,6,10,28,29,-1,30
AC Horsens,4566,7,5,13,12,34,58,-24,28
Randers FC,4566,8,6,6,12,25,39,-14,24
Silkeborg IF,4566,9,5,4,13,25,44,-19,19
AGF Aarhus,4566,10,4,7,11,16,36,-20,19
Lyngby,4566,11,3,9,12,26,46,-20,18
Brondby,4567,1,21,6,3,81,32,49,69
FC Midtjylla,4567,2,19,5,6,63,40,23,62
FC Nords,4567,3,15,7,8,78,54,24,52
Copenhagen,4567,4,14,6,10,59,46,13,48
AC Horsens,4567,5,7,12,11,37,54,-17,33
Sonderjyske,4567,6,8,6,10,28,29,-1,30
AaB,4567,7,6,12,12,34,52,-18,30
Lyngby,4567,8,4,9,11,27,44,-17,21
Silkeborg IF,4567,8,6,3,13,27,44,-17,21
Randers FC,4567,10,5,6,13,23,40,-17,21
AGF Aarhus,4567,11,4,6,12,16,38,-22,18
Brondby,4568,1,21,7,2,70,29,41,70
FC Midtjylla,4568,2,18,4,8,58,38,20,58
Copenhagen,4568,3,16,5,9,61,39,22,53
FC Nords,4568,4,14,8,8,71,49,22,50
AaB,4568,5,8,12,10,37,41,-4,36
Sonderjyske,4568,6,8,6,10,28,29,-1,30
AC Horsens,4568,7,5,12,13,31,58,-27,27
Lyngby,4568,8,4,9,11,29,44,-15,21
Silkeborg IF,4568,9,6,3,13,26,44,-18,21
Randers FC,4568,10,5,6,13,23,42,-19,21
AGF Aarhus,4568,11,4,6,12,16,37,-21,18
FC Midtjylla,4569,1,21,4,5,69,39,30,67
Brondby,4569,2,19,6,5,70,39,31,63
FC Nords,4569,3,14,7,9,78,53,25,49
Copenhagen,4569,4,14,5,11,53,43,10,47
AaB,4569,5,7,13,10,34,39,-5,34
AC Horsens,4569,6,7,13,10,33,50,-17,34
Sonderjyske,4569,7,8,6,10,28,29,-1,30
Randers FC,4569,8,6,6,12,26,41,-15,24
Silkeborg IF,4569,9,6,3,13,28,44,-16,21
Lyngby,4569,10,3,9,12,28,47,-19,18
AGF Aarhus,4569,11,4,6,12,16,39,-23,18
Brondby,4570,1,21,6,3,71,30,41,69
FC Midtjylla,4570,2,19,6,5,68,37,31,63
FC Nords,4570,3,14,7,9,73,54,19,49
Copenhagen,4570,4,13,6,11,55,48,7,45
AaB,4570,5,8,13,9,38,39,-1,37
Sonderjyske,4570,6,8,6,10,28,29,-1,30
AC Horsens,4570,7,6,12,12,31,54,-23,30
Randers FC,4570,8,6,6,12,25,39,-14,24
AGF Aarhus,4570,9,5,6,11,17,36,-19,21
Lyngby,4570,10,3,9,12,26,46,-20,18
Silkeborg IF,4570,11,5,3,14,25,45,-20,18
Brondby,4571,1,20,6,4,69,34,35,66
FC Midtjylla,4571,2,19,5,6,65,42,23,62
FC Nords,4571,3,14,8,8,79,51,28,50
Copenhagen,4571,4,14,5,11,58,49,9,47
AC Horsens,4571,5,9,12,9,37,49,-12,39
Sonderjyske,4571,6,8,6,10,28,29,-1,30
AaB,4571,7,6,12,12,34,43,-9,30
Lyngby,4571,8,4,9,11,29,46,-17,21
Randers FC,4571,9,5,6,13,25,42,-17,21
Silkeborg IF,4571,10,5,4,13,27,46,-19,19
AGF Aarhus,4571,11,4,7,11,18,38,-20,19
Brondby,4572,1,20,5,5,70,34,36,65
FC Midtjylla,4572,2,19,4,7,64,40,24,61
FC Nords,4572,3,17,6,7,78,48,30,57
Copenhagen,4572,4,14,5,11,57,44,13,47
AaB,4572,5,7,13,10,37,44,-7,34
AC Horsens,4572,6,6,13,11,34,56,-22,31
Sonderjyske,4572,7,8,6,10,28,29,-1,30
Randers FC,4572,8,5,7,12,24,40,-16,22
Lyngby,4572,9,3,10,11,27,45,-18,19
Silkeborg IF,4572,10,5,4,13,26,45,-19,19
AGF Aarhus,4572,11,4,7,11,17,37,-20,19
Brondby,4573,1,21,7,2,75,32,43,70
FC Midtjylla,4573,2,21,5,4,72,35,37,68
FC Nords,4573,3,14,6,10,76,56,20,48
Copenhagen,4573,4,12,4,14,54,54,0,40
AaB,4573,5,8,11,11,36,44,-8,35
AC Horsens,4573,6,7,13,10,40,58,-18,34
Sonderjyske,4573,7,8,6,10,28,29,-1,30
Lyngby,4573,8,4,9,11,32,44,-12,21
Silkeborg IF,4573,9,6,3,13,27,45,-18,21
Randers FC,4573,10,5,6,13,23,45,-22,21
AGF Aarhus,4573,11,4,6,12,17,38,-21,18
Brondby,4574,1,21,5,4,69,33,36,68
FC Midtjylla,4574,2,19,7,4,64,34,30,64
FC Nords,4574,3,14,7,9,69,48,21,49
Copenhagen,4574,4,13,4,13,54,48,6,43
AaB,4574,5,8,13,9,37,40,-3,37
AC Horsens,4574,6,6,14,10,35,51,-16,32
Sonderjyske,4574,7,8,6,10,28,29,-1,30
Randers FC,4574,8,6,6,12,26,39,-13,24
Silkeborg IF,4574,9,5,4,13,25,44,-19,19
AGF Aarhus,4574,10,4,7,11,16,36,-20,19
Lyngby,4574,11,3,9,12,26,47,-21,18
FC Midtjylla,4575,1,22,4,4,73,34,39,70
Brondby,4575,2,19,6,5,66,33,33,63
Copenhagen,4575,3,15,5,10,59,46,13,50
FC Nords,4575,4,12,7,11,68,53,15,43
AC Horsens,4575,5,8,13,9,39,52,-13,37
AaB,4575,6,6,13,11,32,45,-13,31
Sonderjyske,4575,7,8,6,10,28,29,-1,30
Lyngby,4575,8,4,9,11,28,45,-17,21
Randers FC,4575,9,5,6,13,24,41,-17,21
Silkeborg IF,4575,10,5,4,13,25,44,-19,19
AGF Aarhus,4575,11,4,7,11,16,36,-20,19
Brondby,4576,1,19,7,4,71,35,36,64
FC Midtjylla,4576,2,19,5,6,66,40,26,62
Copenhagen,4576,3,14,6,10,59,45,14,48
FC Nords,4576,4,13,8,9,70,51,19,47
AaB,4576,5,8,13,9,38,42,-4,37
AC Horsens,4576,6,6,15,9,37,54,-17,33
Sonderjyske,4576,7,8,6,10,28,29,-1,30
Randers FC,4576,8,5,7,12,26,42,-16,22
AGF Aarhus,4576,9,5,6,11,17,36,-19,21
Lyngby,4576,10,3,10,11,29,47,-18,19
Silkeborg IF,4576,11,5,3,14,25,45,-20,18
Brondby,4577,1,23,5,2,79,27,52,74
FC Midtjylla,4577,2,19,4,7,67,44,23,61
FC Nords,4577,3,16,6,8,79,52,27,54
Copenhagen,4577,4,14,5,11,56,49,7,47
AaB,4577,5,7,11,12,36,48,-12,32
Sonderjyske,4577,6,8,6,10,28,29,-1,30
AC Horsens,4577,7,5,13,12,35,58,-23,28
Randers FC,4577,8,6,6,12,26,39,-13,24
Silkeborg IF,4577,9,5,4,13,26,45,-19,19
AGF Aarhus,4577,10,4,7,11,17,37,-20,19
Lyngby,4577,11,3,9,12,26,47,-21,18
Brondby,4578,1,21,6,3,71,32,39,69
FC Midtjylla,4578,2,20,5,5,66,42,24,65
FC Nords,4578,3,15,6,9,74,50,24,51
Copenhagen,4578,4,13,5,12,54,44,10,44
AaB,4578,5,7,13,10,37,43,-6,34
AC Horsens,4578,6,6,13,11,31,48,-17,31
Sonderjyske,4578,7,8,6,10,28,29,-1,30
Randers FC,4578,8,5,7,12,25,41,-16,22
Silkeborg IF,4578,9,6,3,13,26,44,-18,21
Lyngby,4578,10,3,10,11,28,46,-18,19
AGF Aarhus,4578,11,4,6,12,16,37,-21,18
Brondby,4579,1,20,8,2,72,33,39,68
FC Midtjylla,4579,2,20,5,5,68,38,30,65
FC Nords,4579,3,14,7,9,74,53,21,49
Copenhagen,4579,4,12,5,13,51,44,7,41
AC Horsens,4579,5,7,14,9,37,52,-15,35
AaB,4579,6,7,13,10,39,47,-8,34
Sonderjyske,4579,7,8,6,10,28,29,-1,30
Lyngby,4579,8,4,9,11,28,44,-16,21
Silkeborg IF,4579,9,6,3,13,27,45,-18,21
Randers FC,4579,10,5,6,13,23,41,-18,21
AGF Aarhus,4579,11,4,6,12,17,38,-21,18
Brondby,4580,1,21,6,3,69,31,38,69
FC Midtjylla,4580,2,20,5,5,65,38,27,65
FC Nords,4580,3,13,7,10,69,52,17,46
Copenhagen,4580,4,14,4,12,56,44,12,46
AaB,4580,5,8,12,10,41,46,-5,36
AC Horsens,4580,6,7,12,11,36,51,-15,33
Sonderjyske,4580,7,8,6,10,28,29,-1,30
Randers FC,4580,8,6,6,12,24,39,-15,24
AGF Aarhus,4580,9,5,6,11,18,36,-18,21
Lyngby,4580,10,3,9,12,26,45,-19,18
Silkeborg IF,4580,11,5,3,14,25,46,-21,18
Brondby,4581,1,22,5,3,72,31,41,71
FC Midtjylla,4581,2,19,6,5,65,39,26,63
FC Nords,4581,3,14,7,9,76,52,24,49
Copenhagen,4581,4,13,4,13,57,50,7,43
AaB,4581,5,7,13,10,36,45,-9,34
AC Horsens,4581,6,7,13,10,36,51,-15,34
Sonderjyske,4581,7,8,6,10,28,29,-1,30
Lyngby,4581,8,4,9,11,29,45,-16,21
Randers FC,4581,9,5,6,13,24,42,-18,21
Silkeborg IF,4581,10,5,4,13,25,44,-19,19
AGF Aarhus,4581,11,4,7,11,16,36,-20,19
Brondby,4582,1,21,7,2,68,29,39,70
FC Midtjylla,4582,2,19,6,5,64,38,26,63
FC Nords,4582,3,12,8,10,71,55,16,44
Copenhagen,4582,4,12,5,13,58,51,7,41
AC Horsens,4582,5,9,13,8,39,48,-9,40
AaB,4582,6,7,13,10,37,42,-5,34
Sonderjyske,4582,7,8,6,10,28,29,-1,30
Lyngby,4582,8,4,9,11,28,44,-16,21
Randers FC,4582,9,5,6,13,23,41,-18,21
AGF Aarhus,4582,10,5,6,11,19,38,-19,21
Silkeborg IF,4582,11,5,3,14,27,47,-20,18
Brondby,4583,1,23,5,2,73,31,42,74
FC Midtjylla,4583,2,19,4,7,62,40,22,61
FC Nords,4583,3,15,6,9,81,55,26,51
Copenhagen,4583,4,15,5,10,57,41,16,50
Sonderjyske,4583,5,8,6,10,28,29,-1,30
AaB,4583,6,6,12,12,34,42,-8,30
AC Horsens,4583,7,6,12,12,32,56,-24,30
Lyngby,4583,8,4,9,11,33,45,-12,21
Randers FC,4583,9,5,6,13,24,46,-22,21
Silkeborg IF,4583,10,5,4,13,25,44,-19,19
AGF Aarhus,4583,11,4,7,11,16,36,-20,19
Brondby,4584,1,19,6,5,71,36,35,63
FC Midtjylla,4584,2,19,6,5,63,37,26,63
FC Nords,4584,3,15,8,7,74,48,26,53
Copenhagen,4584,4,13,5,12,54,44,10,44
AC Horsens,4584,5,7,14,9,36,50,-14,35
AaB,4584,6,7,13,10,37,46,-9,34
Sonderjyske,4584,7,8,6,10,28,29,-1,30
Lyngby,4584,8,4,9,11,28,44,-16,21
Silkeborg IF,4584,8,6,3,13,28,44,-16,21
Randers FC,4584,10,5,6,13,23,41,-18,21
AGF Aarhus,4584,11,4,6,12,16,39,-23,18
Brondby,4585,1,21,6,3,77,36,41,69
FC Midtjylla,4585,2,19,5,6,64,41,23,62
Copenhagen,4585,3,15,6,9,63,46,17,51
FC Nords,4585,4,13,6,11,71,57,14,45
AaB,4585,5,8,12,10,38,42,-4,36
AC Horsens,4585,6,6,13,11,33,50,-17,31
Sonderjyske,4585,7,8,6,10,28,29,-1,30
Lyngby,4585,8,4,9,11,29,45,-16,21
Silkeborg IF,4585,9,6,3,13,27,44,-17,21
Randers FC,4585,10,5,6,13,24,42,-18,21
AGF Aarhus,4585,11,4,6,12,16,38,-22,18
FC Midtjylla,4586,1,20,6,4,69,38,31,66
Brondby,4586,2,20,5,5,70,32,38,65
FC Nords,4586,3,15,6,9,77,53,24,51
Copenhagen,4586,4,12,6,12,55,49,6,42
AaB,4586,5,8,14,8,39,38,1,38
AC Horsens,4586,6,6,13,11,33,59,-26,31
Sonderjyske,4586,7,8,6,10,28,29,-1,30
Lyngby,4586,8,4,9,11,29,45,-16,21
Randers FC,4586,9,5,6,13,24,42,-18,21
AGF Aarhus,4586,10,5,6,11,18,37,-19,21
Silkeborg IF,4586,11,5,3,14,26,46,-20,18
Brondby,4587,1,22,6,2,78,29,49,72
FC Midtjylla,4587,2,21,4,5,71,36,35,67
FC Nords,4587,3,13,7,10,72,57,15,46
Copenhagen,4587,4,13,5,12,60,53,7,44
AaB,4587,5,7,12,11,36,47,-11,33
AC Horsens,4587,6,6,14,10,33,54,-21,32
Sonderjyske,4587,7,8,6,10,28,29,-1,30
Lyngby,4587,8,4,9,11,28,44,-16,21
Silkeborg IF,4587,9,6,3,13,26,44,-18,21
Randers FC,4587,10,5,6,13,23,41,-18,21
AGF Aarhus,4587,11,4,6,12,16,37,-21,18
Brondby,4588,1,21,6,3,76,30,46,69
FC Midtjylla,4588,2,19,5,6,62,39,23,62
Copenhagen,4588,3,16,4,10,60,40,20,52
FC Nords,4588,4,15,6,9,71,55,16,51
AaB,4588,5,8,11,11,35,43,-8,35
Sonderjyske,4588,6,8,6,10,28,29,-1,30
AC Horsens,4588,7,5,12,13,32,55,-23,27
Randers FC,4588,8,6,6,12,25,39,-14,24
Silkeborg IF,4588,9,6,3,13,27,44,-17,21
Lyngby,4588,10,3,9,12,26,46,-20,18
AGF Aarhus,4588,11,4,6,12,16,38,-22,18
Brondby,4589,1,21,7,2,73,31,42,70
FC Midtjylla,4589,2,20,5,5,68,37,31,65
FC Nords,4589,3,14,7,9,73,54,19,49
Copenhagen,4589,4,13,5,12,57,52,5,44
AC Horsens,4589,5,7,14,9,35,49,-14,35
Sonderjyske,4589,6,8,6,10,28,29,-1,30
AaB,4589,7,6,12,12,34,43,-9,30
Randers FC,4589,8,6,6,12,24,39,-15,24
Silkeborg IF,4589,9,5,4,13,25,44,-19,19
AGF Aarhus,4589,10,4,7,11,16,36,-20,19
Lyngby,4589,11,3,9,12,26,45,-19,18
Brondby,4590,1,21,6,3,69,28,41,69
FC Midtjylla,4590,2,20,6,4,68,38,30,66
Copenhagen,4590,3,15,5,10,58,43,15,50
FC Nords,4590,4,13,8,9,68,49,19,47
AaB,4590,5,7,12,11,37,45,-8,33
Sonderjyske,4590,6,8,6,10,28,29,-1,30
AC Horsens,4590,7,5,13,12,32,55,-23,28
Lyngby,4590,8,4,9,11,31,45,-14,21
Silkeborg IF,4590,9,6,3,13,27,44,-17,21
Randers FC,4590,10,5,6,13,24,44,-20,21
AGF Aarhus,4590,11,4,6,12,16,38,-22,18
Brondby,4591,1,20,7,3,72,30,42,67
FC Midtjylla,4591,2,19,4,7,65,43,22,61
FC Nords,4591,3,15,7,8,76,54,22,52
Copenhagen,4591,4,14,5,11,59,46,13,47
AaB,4591,5,8,11,11,40,46,-6,35
AC Horsens,4591,6,7,12,11,32,51,-19,33
Sonderjyske,4591,7,8,6,10,28,29,-1,30
Randers FC,4591,8,5,7,12,24,40,-16,22
Lyngby,4591,9,3,10,11,27,45,-18,19
Silkeborg IF,4591,10,5,4,13,26,45,-19,19
AGF Aarhus,4591,11,4,7,11,17,37,-20,19
Brondby,4592,1,22,5,3,69,30,39,71
FC Midtjylla,4592,2,20,4,6,72,41,31,64
Copenhagen,4592,3,14,4,12,59,49,10,46
FC Nords,4592,4,12,6,12,69,55,14,42
AaB,4592,5,10,11,9,40,41,-1,41
AC Horsens,4592,6,7,12,11,35,54,-19,33
Sonderjyske,4592,7,8,6,10,28,29,-1,30
Lyngby,4592,8,4,9,11,29,44,-15,21
AGF Aarhus,4592,9,5,6,11,18,36,-18,21
Randers FC,4592,10,5,6,13,23,42,-19,21
Silkeborg IF,4592,11,5,3,14,25,46,-21,18
Brondby,4593,1,20,6,4,69,31,38,66
FC Midtjylla,4593,2,19,6,5,64,36,28,63
FC Nords,4593,3,14,8,8,73,53,20,50
Copenhagen,4593,4,14,6,10,56,42,14,48
AaB,4593,5,7,15,8,36,39,-3,36
Sonderjyske,4593,6,8,6,10,28,29,-1,30
AC Horsens,4593,7,5,13,12,34,57,-23,28
Lyngby,4593,8,4,9,11,30,45,-15,21
Silkeborg IF,4593,9,6,3,13,27,45,-18,21
Randers FC,4593,10,5,6,13,24,43,-19,21
AGF Aarhus,4593,11,4,6,12,17,38,-21,18
Brondby,4594,1,20,7,3,65,29,36,67
FC Midtjylla,4594,2,19,5,6,65,42,23,62
FC Nords,4594,3,16,7,7,79,49,30,55
Copenhagen,4594,4,13,6,11,59,47,12,45
AC Horsens,4594,5,7,12,11,37,55,-18,33
AaB,4594,6,6,13,11,38,47,-9,31
Sonderjyske,4594,7,8,6,10,28,29,-1,30
Randers FC,4594,8,6,6,12,25,39,-14,24
AGF Aarhus,4594,9,5,6,11,17,36,-19,21
Lyngby,4594,10,3,9,12,26,46,-20,18
Silkeborg IF,4594,11,5,3,14,25,45,-20,18
Brondby,4595,1,19,7,4,67,33,34,64
FC Midtjylla,4595,2,20,4,6,64,41,23,64
FC Nords,4595,3,15,7,8,77,53,24,52
Copenhagen,4595,4,14,4,12,61,45,16,46
AaB,4595,5,7,13,10,36,45,-9,34
AC Horsens,4595,6,7,13,10,37,51,-14,34
Sonderjyske,4595,7,8,6,10,28,29,-1,30
Randers FC,4595,8,6,6,12,24,39,-15,24
Silkeborg IF,4595,9,6,3,13,27,45,-18,21
Lyngby,4595,10,3,9,12,26,45,-19,18
AGF Aarhus,4595,11,4,6,12,17,38,-21,18
Brondby,4596,1,22,5,3,71,32,39,71
FC Midtjylla,4596,2,20,6,4,67,35,32,66
FC Nords,4596,3,13,8,9,71,53,18,47
Copenhagen,4596,4,12,6,12,53,45,8,42
AaB,4596,5,8,11,11,37,43,-6,35
AC Horsens,4596,6,6,14,10,34,51,-17,32
Sonderjyske,4596,7,8,6,10,28,29,-1,30
Randers FC,4596,8,6,6,12,25,40,-15,24
Silkeborg IF,4596,9,6,3,13,27,44,-17,21
Lyngby,4596,10,3,9,12,27,46,-19,18
AGF Aarhus,4596,11,4,6,12,16,38,-22,18
Brondby,4597,1,21,5,4,68,30,38,68
FC Midtjylla,4597,2,21,5,4,70,37,33,68
FC Nords,4597,3,15,6,9,77,50,27,51
Copenhagen,4597,4,13,4,13,54,49,5,43
AC Horsens,4597,5,7,13,10,36,53,-17,34
AaB,4597,6,7,11,12,34,46,-12,32
Sonderjyske,4597,7,8,6,10,28,29,-1,30
Randers FC,4597,8,6,6,12,24,39,-15,24
Silkeborg IF,4597,9,6,3,13,27,45,-18,21
Lyngby,4597,10,3,9,12,26,45,-19,18
AGF Aarhus,4597,11,4,6,12,17,38,-21,18
Brondby,4598,1,21,5,4,70,32,38,68
FC Midtjylla,4598,2,21,4,5,66,36,30,67
FC Nords,4598,3,14,7,9,75,50,25,49
Copenhagen,4598,4,12,6,12,54,49,5,42
AC Horsens,4598,5,7,14,9,33,49,-16,35
AaB,4598,6,6,14,10,34,42,-8,32
Sonderjyske,4598,7,8,6,10,28,29,-1,30
Randers FC,4598,8,6,6,12,25,40,-15,24
Silkeborg IF,4598,9,6,3,13,29,45,-16,21
Lyngby,4598,10,3,9,12,27,46,-19,18
AGF Aarhus,4598,11,4,6,12,17,40,-23,18
Brondby,4599,1,21,6,3,72,32,40,69
FC Midtjylla,4599,2,21,4,5,69,38,31,67
FC Nords,4599,3,14,6,10,72,57,15,48
Copenhagen,4599,4,14,5,11,55,44,11,47
AaB,4599,5,7,12,11,41,43,-2,33
AC Horsens,4599,6,6,13,11,33,54,-21,31
Sonderjyske,4599,7,8,6,10,28,29,-1,30
Randers FC,4599,8,6,6,12,27,41,-14,24
Silkeborg IF,4599,9,6,3,13,28,46,-18,21
Lyngby,4599,10,3,9,12,28,48,-20,18
AGF Aarhus,4599,11,4,6,12,18,39,-21,18
Brondby,4600,1,22,5,3,77,34,43,71
FC Midtjylla,4600,2,19,4,7,63,40,23,61
FC Nords,4600,3,14,6,10,69,51,18,48
Copenhagen,4600,4,14,5,11,55,42,13,47
AaB,4600,5,8,12,10,39,42,-3,36
AC Horsens,4600,6,6,14,10,35,55,-20,32
Sonderjyske,4600,7,8,6,10,28,29,-1,30
Randers FC,4600,8,6,6,12,26,40,-14,24
Silkeborg IF,4600,9,6,3,13,26,44,-18,21
Lyngby,4600,10,3,9,12,27,47,-20,18
AGF Aarhus,4600,11,4,6,12,16,37,-21,18
Brondby,4601,1,21,6,3,73,32,41,69
FC Midtjylla,4601,2,19,5,6,65,41,24,62
FC Nords,4601,3,15,7,8,74,49,25,52
Copenhagen,4601,4,15,4,11,59,43,16,49
AaB,4601,5,7,12,11,36,46,-10,33
Sonderjyske,4601,6,8,6,10,28,29,-1,30
AC Horsens,4601,7,5,14,11,33,55,-22,29
Lyngby,4601,8,4,9,11,28,45,-17,21
Randers FC,4601,9,5,6,13,24,41,-17,21
Silkeborg IF,4601,10,5,4,13,26,45,-19,19
AGF Aarhus,4601,11,4,7,11,17,37,-20,19
Brondby,4602,1,20,6,4,66,31,35,66
FC Midtjylla,4602,2,19,5,6,63,40,23,62
Copenhagen,4602,3,14,6,10,60,45,15,48
FC Nords,4602,4,13,8,9,75,55,20,47
AC Horsens,4602,5,8,13,9,37,50,-13,37
AaB,4602,6,7,12,11,36,42,-6,33
Sonderjyske,4602,7,8,6,10,28,29,-1,30
Randers FC,4602,8,5,7,12,25,41,-16,22
Silkeborg IF,4602,9,6,3,13,27,44,-17,21
Lyngby,4602,10,3,10,11,28,46,-18,19
AGF Aarhus,4602,11,4,6,12,16,38,-22,18
Brondby,4603,1,20,7,3,71,34,37,67
FC Midtjylla,4603,2,18,4,8,66,46,20,58
FC Nords,4603,3,16,7,7,82,49,33,55
Copenhagen,4603,4,13,6,11,56,47,9,45
AaB,4603,5,8,12,10,40,46,-6,36
AC Horsens,4603,6,7,12,11,36,55,-19,33
Sonderjyske,4603,7,8,6,10,28,29,-1,30
Randers FC,4603,8,6,6,12,24,39,-15,24
Silkeborg IF,4603,9,6,3,13,27,44,-17,21
Lyngby,4603,10,3,9,12,26,45,-19,18
AGF Aarhus,4603,11,4,6,12,16,38,-22,18
Brondby,4604,1,22,5,3,70,31,39,71
FC Midtjylla,4604,2,20,4,6,68,42,26,64
FC Nords,4604,3,15,6,9,78,53,25,51
Copenhagen,4604,4,14,4,12,56,46,10,46
AC Horsens,4604,5,7,13,10,37,52,-15,34
Sonderjyske,4604,6,8,6,10,28,29,-1,30
AaB,4604,7,6,12,12,35,46,-11,30
Lyngby,4604,8,4,9,11,28,44,-16,21
Randers FC,4604,9,5,6,13,23,41,-18,21
AGF Aarhus,4604,10,5,6,11,18,37,-19,21
Silkeborg IF,4604,11,5,3,14,26,46,-20,18
FC Midtjylla,4605,1,20,6,4,70,34,36,66
Brondby,4605,2,18,7,5,63,32,31,61
Copenhagen,4605,3,15,6,9,61,44,17,51
FC Nords,4605,4,14,6,10,74,52,22,48
AaB,4605,5,8,12,10,37,44,-7,36
AC Horsens,4605,6,6,13,11,33,58,-25,31
Sonderjyske,4605,7,8,6,10,28,29,-1,30
Randers FC,4605,8,6,6,12,24,39,-15,24
Silkeborg IF,4605,9,5,4,13,25,44,-19,19
AGF Aarhus,4605,10,4,7,11,16,36,-20,19
Lyngby,4605,11,3,9,12,26,45,-19,18
Brondby,4606,1,20,7,3,72,32,40,67
FC Midtjylla,4606,2,19,5,6,66,44,22,62
FC Nords,4606,3,14,6,10,76,56,20,48
Copenhagen,4606,4,14,4,12,62,49,13,46
AaB,4606,5,9,13,8,44,43,1,40
AC Horsens,4606,6,6,13,11,34,56,-22,31
Sonderjyske,4606,7,8,6,10,28,29,-1,30
Lyngby,4606,8,4,9,11,29,44,-15,21
Silkeborg IF,4606,9,6,3,13,26,44,-18,21
Randers FC,4606,10,5,6,13,23,42,-19,21
AGF Aarhus,4606,11,4,6,12,16,37,-21,18
FC Midtjylla,4607,1,21,4,5,68,38,30,67
Brondby,4607,2,19,6,5,67,32,35,63
FC Nords,4607,3,13,8,9,72,52,20,47
Copenhagen,4607,4,14,5,11,56,43,13,47
AC Horsens,4607,5,8,14,8,37,48,-11,38
AaB,4607,6,7,11,12,34,47,-13,32
Sonderjyske,4607,7,8,6,10,28,29,-1,30
Lyngby,4607,8,4,9,11,32,44,-12,21
Silkeborg IF,4607,9,6,3,13,27,44,-17,21
Randers FC,4607,10,5,6,13,23,45,-22,21
AGF Aarhus,4607,11,4,6,12,16,38,-22,18
Brondby,4608,1,21,6,3,72,34,38,69
FC Midtjylla,4608,2,18,6,6,61,39,22,60
FC Nords,4608,3,13,8,9,71,49,22,47
Copenhagen,4608,4,14,5,11,57,44,13,47
AaB,4608,5,9,12,9,42,42,0,39
AC Horsens,4608,6,6,13,11,32,53,-21,31
Sonderjyske,4608,7,8,6,10,28,29,-1,30
Randers FC,4608,8,6,6,12,24,39,-15,24
Silkeborg IF,4608,9,6,3,13,28,44,-16,21
Lyngby,4608,10,3,9,12,26,45,-19,18
AGF Aarhus,4608,11,4,6,12,16,39,-23,18
Brondby,4609,1,21,7,2,69,31,38,70
FC Midtjylla,4609,2,20,5,5,74,37,37,65
FC Nords,4609,3,14,6,10,70,56,14,48
Copenhagen,4609,4,13,7,10,58,45,13,46
AaB,4609,5,7,12,11,35,43,-8,33
AC Horsens,4609,6,6,13,11,34,54,-20,31
Sonderjyske,4609,7,8,6,10,28,29,-1,30
Lyngby,4609,8,4,9,11,28,45,-17,21
Randers FC,4609,9,5,6,13,24,41,-17,21
Silkeborg IF,4609,10,5,4,13,26,45,-19,19
AGF Aarhus,4609,11,4,7,11,17,37,-20,19
Brondby,4610,1,20,6,4,71,32,39,66
FC Midtjylla,4610,2,20,6,4,68,38,30,66
FC Nords,4610,3,16,6,8,78,50,28,54
Copenhagen,4610,4,13,5,12,60,56,4,44
AC Horsens,4610,5,7,12,11,35,53,-18,33
AaB,4610,6,7,11,12,38,47,-9,32
Sonderjyske,4610,7,8,6,10,28,29,-1,30
Randers FC,4610,8,6,6,12,26,40,-14,24
Silkeborg IF,4610,9,6,3,13,27,45,-18,21
Lyngby,4610,10,3,9,12,27,47,-20,18
AGF Aarhus,4610,11,4,6,12,17,38,-21,18
Brondby,4611,1,21,5,4,72,33,39,68
FC Midtjylla,4611,2,20,4,6,68,46,22,64
FC Nords,4611,3,15,7,8,78,52,26,52
Copenhagen,4611,4,15,6,9,61,41,20,51
AaB,4611,5,7,11,12,36,44,-8,32
Sonderjyske,4611,6,8,6,10,28,29,-1,30
AC Horsens,4611,7,5,13,12,32,57,-25,28
Lyngby,4611,8,4,9,11,27,44,-17,21
Silkeborg IF,4611,8,6,3,13,27,44,-17,21
Randers FC,4611,10,5,6,13,23,40,-17,21
AGF Aarhus,4611,11,4,6,12,16,38,-22,18
Brondby,4612,1,21,7,2,79,34,45,70
FC Midtjylla,4612,2,20,5,5,70,40,30,65
FC Nords,4612,3,15,6,9,72,55,17,51
Copenhagen,4612,4,13,7,10,59,48,11,46
AaB,4612,5,7,12,11,38,47,-9,33
Sonderjyske,4612,6,8,6,10,28,29,-1,30
AC Horsens,4612,7,5,13,12,36,56,-20,28
Randers FC,4612,8,5,7,12,23,39,-16,22
Silkeborg IF,4612,9,6,3,13,28,44,-16,21
Lyngby,4612,10,3,10,11,26,44,-18,19
AGF Aarhus,4612,11,4,6,12,16,39,-23,18
FC Midtjylla,4613,1,21,4,5,70,37,33,67
Brondby,4613,2,19,7,4,68,32,36,64
FC Nords,4613,3,15,7,8,76,53,23,52
Copenhagen,4613,4,13,6,11,55,42,13,45
AaB,4613,5,7,12,11,37,48,-11,33
AC Horsens,4613,6,7,12,11,34,54,-20,33
Sonderjyske,4613,7,8,6,10,28,29,-1,30
Lyngby,4613,8,4,9,11,31,44,-13,21
Randers FC,4613,9,5,6,13,23,44,-21,21
Silkeborg IF,4613,10,5,4,13,26,45,-19,19
AGF Aarhus,4613,11,4,7,11,17,37,-20,19
Brondby,4614,1,22,5,3,74,32,42,71
FC Midtjylla,4614,2,20,4,6,64,38,26,64
FC Nords,4614,3,14,6,10,74,55,19,48
Copenhagen,4614,4,14,4,12,55,43,12,46
AaB,4614,5,8,11,11,38,45,-7,35
AC Horsens,4614,6,7,12,11,34,52,-18,33
Sonderjyske,4614,7,8,6,10,28,29,-1,30
Randers FC,4614,8,5,7,12,24,40,-16,22
Lyngby,4614,9,3,10,11,27,45,-18,19
Silkeborg IF,4614,10,5,4,13,25,44,-19,19
AGF Aarhus,4614,11,4,7,11,16,36,-20,19
Brondby,4615,1,21,6,3,70,29,41,69
FC Midtjylla,4615,2,21,4,5,65,39,26,67
FC Nords,4615,3,14,7,9,68,52,16,49
Copenhagen,4615,4,12,8,10,54,42,12,44
AaB,4615,5,7,13,10,38,40,-2,34
Sonderjyske,4615,6,8,6,10,28,29,-1,30
AC Horsens,4615,7,5,14,11,32,51,-19,29
Randers FC,4615,8,6,6,12,25,40,-15,24
Silkeborg IF,4615,9,5,4,13,25,44,-19,19
AGF Aarhus,4615,10,4,7,11,16,36,-20,19
Lyngby,4615,11,3,9,12,27,46,-19,18
Brondby,4616,1,21,7,2,78,30,48,70
FC Midtjylla,4616,2,21,4,5,73,41,32,67
Copenhagen,4616,3,14,5,11,57,44,13,47
FC Nords,4616,4,13,7,10,70,58,12,46
AaB,4616,5,7,11,12,39,51,-12,32
AC Horsens,4616,6,6,14,10,34,53,-19,32
Sonderjyske,4616,7,8,6,10,28,29,-1,30
Lyngby,4616,8,4,9,11,28,44,-16,21
Silkeborg IF,4616,9,6,3,13,26,44,-18,21
Randers FC,4616,10,5,6,13,23,41,-18,21
AGF Aarhus,4616,11,4,6,12,16,37,-21,18
Brondby,4617,1,19,9,2,67,30,37,66
FC Midtjylla,4617,2,20,5,5,65,35,30,65
FC Nords,4617,3,14,7,9,70,50,20,49
Copenhagen,4617,4,14,6,10,60,44,16,48
AC Horsens,4617,5,6,14,10,34,54,-20,32
AaB,4617,6,6,13,11,34,43,-9,31
Sonderjyske,4617,7,8,6,10,28,29,-1,30
Lyngby,4617,8,4,9,11,29,46,-17,21
Randers FC,4617,9,5,6,13,25,42,-17,21
Silkeborg IF,4617,10,5,4,13,27,46,-19,19
AGF Aarhus,4617,11,4,7,11,18,38,-20,19
FC Midtjylla,4618,1,20,5,5,64,40,24,65
Brondby,4618,2,19,7,4,66,32,34,64
FC Nords,4618,3,14,7,9,71,50,21,49
Copenhagen,4618,4,14,7,9,56,39,17,49
AaB,4618,5,7,12,11,32,38,-6,33
AC Horsens,4618,6,6,14,10,35,51,-16,32
Sonderjyske,4618,7,8,6,10,28,29,-1,30
Randers FC,4618,8,5,7,12,24,40,-16,22
AGF Aarhus,4618,9,5,6,11,18,37,-19,21
Lyngby,4618,10,3,10,11,27,45,-18,19
Silkeborg IF,4618,11,5,3,14,26,46,-20,18
FC Midtjylla,4619,1,21,5,4,69,40,29,68
Brondby,4619,2,20,7,3,74,34,40,67
FC Nords,4619,3,13,7,10,78,59,19,46
Copenhagen,4619,4,12,7,11,55,47,8,43
AaB,4619,5,7,13,10,37,44,-7,34
AC Horsens,4619,6,7,13,10,39,54,-15,34
Sonderjyske,4619,7,8,6,10,28,29,-1,30
Lyngby,4619,8,4,9,11,29,44,-15,21
Randers FC,4619,9,5,6,13,23,42,-19,21
Silkeborg IF,4619,10,5,4,13,26,45,-19,19
AGF Aarhus,4619,11,4,7,11,17,37,-20,19
Brondby,4620,1,23,5,2,73,29,44,74
FC Midtjylla,4620,2,19,6,5,66,36,30,63
FC Nords,4620,3,14,7,9,75,58,17,49
Copenhagen,4620,4,12,7,11,61,51,10,43
AaB,4620,5,7,12,11,37,47,-10,33
Sonderjyske,4620,6,8,6,10,28,29,-1,30
AC Horsens,4620,7,5,15,10,36,53,-17,30
Randers FC,4620,8,6,6,12,25,40,-15,24
Silkeborg IF,4620,9,6,3,13,26,44,-18,21
Lyngby,4620,10,3,9,12,27,46,-19,18
AGF Aarhus,4620,11,4,6,12,16,37,-21,18
Brondby,4621,1,21,6,3,73,33,40,69
FC Midtjylla,4621,2,19,7,4,66,37,29,64
FC Nords,4621,3,14,6,10,75,51,24,48
Copenhagen,4621,4,12,6,12,57,54,3,42
AaB,4621,5,9,12,9,43,43,0,39
AC Horsens,4621,6,6,13,11,36,58,-22,31
Sonderjyske,4621,7,8,6,10,28,29,-1,30
Randers FC,4621,8,6,6,12,25,40,-15,24
Silkeborg IF,4621,9,5,4,13,27,46,-19,19
AGF Aarhus,4621,10,4,7,11,18,38,-20,19
Lyngby,4621,11,3,9,12,27,46,-19,18
Brondby,4622,1,21,7,2,68,30,38,70
FC Midtjylla,4622,2,19,4,7,64,37,27,61
Copenhagen,4622,3,15,6,9,61,42,19,51
FC Nords,4622,4,14,6,10,72,57,15,48
AaB,4622,5,7,13,10,37,43,-6,34
Sonderjyske,4622,6,8,6,10,28,29,-1,30
AC Horsens,4622,7,6,12,12,39,58,-19,30
Lyngby,4622,8,4,9,11,27,44,-17,21
Randers FC,4622,9,5,6,13,23,40,-17,21
AGF Aarhus,4622,10,5,6,11,17,36,-19,21
Silkeborg IF,4622,11,5,3,14,25,45,-20,18
Brondby,4623,1,20,5,5,68,37,31,65
FC Midtjylla,4623,2,20,5,5,65,36,29,65
Copenhagen,4623,3,14,5,11,61,45,16,47
FC Nords,4623,4,12,8,10,71,56,15,44
AaB,4623,5,9,12,9,41,42,-1,39
AC Horsens,4623,6,7,13,10,33,49,-16,34
Sonderjyske,4623,7,8,6,10,28,29,-1,30
Lyngby,4623,8,4,9,11,30,46,-16,21
Silkeborg IF,4623,9,6,3,13,26,44,-18,21
Randers FC,4623,10,5,6,13,25,43,-18,21
AGF Aarhus,4623,11,4,6,12,16,37,-21,18
FC Midtjylla,4624,1,20,5,5,66,34,32,65
Brondby,4624,2,19,7,4,65,32,33,64
FC Nords,4624,3,15,6,9,77,54,23,51
Copenhagen,4624,4,14,5,11,58,46,12,47
AC Horsens,4624,5,7,13,10,33,53,-20,34
AaB,4624,6,7,12,11,35,41,-6,33
Sonderjyske,4624,7,8,6,10,28,29,-1,30
Randers FC,4624,8,6,6,12,25,40,-15,24
AGF Aarhus,4624,9,5,6,11,18,36,-18,21
Lyngby,4624,10,3,9,12,27,46,-19,18
Silkeborg IF,4624,11,5,3,14,25,46,-21,18
Brondby,4625,1,21,5,4,70,36,34,68
FC Midtjylla,4625,2,19,5,6,66,41,25,62
FC Nords,4625,3,15,7,8,75,52,23,52
Copenhagen,4625,4,13,5,12,59,47,12,44
AaB,4625,5,9,12,9,41,39,2,39
Sonderjyske,4625,6,8,6,10,28,29,-1,30
AC Horsens,4625,7,5,14,11,34,56,-22,29
Randers FC,4625,8,6,6,12,24,39,-15,24
Silkeborg IF,4625,9,6,3,13,28,45,-17,21
Lyngby,4625,10,3,9,12,26,45,-19,18
AGF Aarhus,4625,11,4,6,12,17,39,-22,18
Brondby,4626,1,21,5,4,70,34,36,68
FC Midtjylla,4626,2,20,4,6,66,37,29,64
Copenhagen,4626,3,15,5,10,54,43,11,50
FC Nords,4626,4,14,6,10,76,53,23,48
AaB,4626,5,8,11,11,36,40,-4,35
AC Horsens,4626,6,6,13,11,34,55,-21,31
Sonderjyske,4626,7,8,6,10,28,29,-1,30
Randers FC,4626,8,5,7,12,25,41,-16,22
Lyngby,4626,9,3,10,11,28,46,-18,19
Silkeborg IF,4626,10,5,4,13,26,45,-19,19
AGF Aarhus,4626,11,4,7,11,17,37,-20,19
FC Midtjylla,4627,1,21,4,5,73,44,29,67
Brondby,4627,2,20,6,4,70,29,41,66
FC Nords,4627,3,14,6,10,71,55,16,48
Copenhagen,4627,4,14,4,12,57,47,10,46
AC Horsens,4627,5,8,12,10,37,51,-14,36
AaB,4627,6,7,12,11,37,45,-8,33
Sonderjyske,4627,7,8,6,10,28,29,-1,30
Lyngby,4627,8,4,9,11,27,44,-17,21
Randers FC,4627,9,5,6,13,23,40,-17,21
Silkeborg IF,4627,10,5,4,13,25,44,-19,19
AGF Aarhus,4627,11,4,7,11,16,36,-20,19
Brondby,4628,1,22,5,3,73,33,40,71
FC Midtjylla,4628,2,19,6,5,62,37,25,63
Copenhagen,4628,3,15,4,11,60,45,15,49
FC Nords,4628,4,13,8,9,73,53,20,47
AaB,4628,5,7,14,9,37,40,-3,35
Sonderjyske,4628,6,8,6,10,28,29,-1,30
AC Horsens,4628,7,5,13,12,33,56,-23,28
Lyngby,4628,8,4,9,11,29,46,-17,21
Randers FC,4628,9,5,6,13,25,42,-17,21
Silkeborg IF,4628,10,6,3,13,26,44,-18,21
AGF Aarhus,4628,11,4,6,12,16,37,-21,18
FC Midtjylla,4629,1,20,6,4,65,38,27,66
Brondby,4629,2,19,6,5,66,36,30,63
FC Nords,4629,3,16,7,7,78,49,29,55
Copenhagen,4629,4,13,6,11,58,47,11,45
AaB,4629,5,8,12,10,36,39,-3,36
Sonderjyske,4629,6,8,6,10,28,29,-1,30
AC Horsens,4629,7,5,13,12,32,52,-20,28
Lyngby,4629,8,4,9,11,29,44,-15,21
Silkeborg IF,4629,9,6,3,13,27,44,-17,21
Randers FC,4629,10,5,6,13,23,42,-19,21
AGF Aarhus,4629,11,4,6,12,16,38,-22,18
Brondby,4630,1,20,7,3,69,35,34,67
FC Midtjylla,4630,2,19,6,5,64,38,26,63
FC Nords,4630,3,13,7,10,72,51,21,46
Copenhagen,4630,4,12,7,11,55,45,10,43
AaB,4630,5,9,12,9,35,37,-2,39
AC Horsens,4630,6,6,15,9,38,53,-15,33
Sonderjyske,4630,7,8,6,10,28,29,-1,30
Lyngby,4630,8,4,9,11,28,44,-16,21
Silkeborg IF,4630,9,6,3,13,27,45,-18,21
Randers FC,4630,10,5,6,13,23,41,-18,21
AGF Aarhus,4630,11,4,6,12,17,38,-21,18
Brondby,4631,1,23,5,2,77,31,46,74
FC Midtjylla,4631,2,19,4,7,65,42,23,61
FC Nords,4631,3,15,6,9,74,56,18,51
Copenhagen,4631,4,14,4,12,55,44,11,46
AaB,4631,5,8,11,11,39,43,-4,35
Sonderjyske,4631,6,8,6,10,28,29,-1,30
AC Horsens,4631,7,6,12,12,37,57,-20,30
Randers FC,4631,8,6,6,12,24,39,-15,24
Silkeborg IF,4631,9,5,4,13,25,44,-19,19
AGF Aarhus,4631,10,4,7,11,16,36,-20,19
Lyngby,4631,11,3,9,12,26,45,-19,18
Brondby,4632,1,22,6,2,71,29,42,72
FC Midtjylla,4632,2,18,5,7,63,39,24,59
FC Nords,4632,3,15,6,9,75,51,24,51
Copenhagen,4632,4,15,4,11,59,45,14,49
AaB,4632,5,7,13,10,39,47,-8,34
Sonderjyske,4632,6,8,6,10,28,29,-1,30
AC Horsens,4632,7,6,12,12,35,57,-22,30
Randers FC,4632,8,6,6,12,25,40,-15,24
Silkeborg IF,4632,9,6,3,13,27,45,-18,21
Lyngby,4632,10,3,9,12,27,46,-19,18
AGF Aarhus,4632,11,4,6,12,17,38,-21,18
Brondby,4633,1,19,6,5,69,36,33,63
FC Midtjylla,4633,2,19,6,5,61,37,24,63
FC Nords,4633,3,15,6,9,73,51,22,51
Copenhagen,4633,4,13,4,13,54,43,11,43
AaB,4633,5,9,13,8,38,38,0,40
AC Horsens,4633,6,6,15,9,33,49,-16,33
Sonderjyske,4633,7,8,6,10,28,29,-1,30
Randers FC,4633,8,5,7,12,24,40,-16,22
AGF Aarhus,4633,9,5,6,11,18,36,-18,21
Lyngby,4633,10,3,10,11,27,45,-18,19
Silkeborg IF,4633,11,5,3,14,25,46,-21,18
Brondby,4634,1,21,5,4,70,32,38,68
FC Midtjylla,4634,2,19,5,6,65,40,25,62
FC Nords,4634,3,13,8,9,71,51,20,47
Copenhagen,4634,4,13,6,11,58,46,12,45
AC Horsens,4634,5,7,15,8,37,50,-13,36
AaB,4634,6,7,13,10,36,44,-8,34
Sonderjyske,4634,7,8,6,10,28,29,-1,30
Silkeborg IF,4634,8,6,3,13,29,45,-16,21
Lyngby,4634,9,4,9,11,28,44,-16,21
Randers FC,4634,10,5,6,13,23,41,-18,21
AGF Aarhus,4634,11,4,6,12,17,40,-23,18
Brondby,4635,1,20,6,4,68,29,39,66
FC Midtjylla,4635,2,18,5,7,62,43,19,59
FC Nords,4635,3,15,7,8,76,53,23,52
Copenhagen,4635,4,14,5,11,56,43,13,47
AC Horsens,4635,5,8,13,9,38,52,-14,37
AaB,4635,6,7,12,11,36,42,-6,33
Sonderjyske,4635,7,8,6,10,28,29,-1,30
Silkeborg IF,4635,8,6,3,13,29,46,-17,21
Lyngby,4635,9,4,9,11,28,45,-17,21
Randers FC,4635,10,5,6,13,24,41,-17,21
AGF Aarhus,4635,11,4,6,12,18,40,-22,18
Brondby,4636,1,21,6,3,74,34,40,69
FC Midtjylla,4636,2,19,5,6,65,42,23,62
FC Nords,4636,3,14,6,10,75,58,17,48
Copenhagen,4636,4,14,5,11,56,40,16,47
AaB,4636,5,8,12,10,39,45,-6,36
AC Horsens,4636,6,5,16,9,34,50,-16,31
Sonderjyske,4636,7,8,6,10,28,29,-1,30
Lyngby,4636,8,4,9,11,28,44,-16,21
Randers FC,4636,9,5,6,13,23,41,-18,21
AGF Aarhus,4636,10,5,6,11,18,37,-19,21
Silkeborg IF,4636,11,5,3,14,26,46,-20,18
Brondby,4637,1,21,7,2,70,31,39,70
FC Midtjylla,4637,2,18,6,6,64,41,23,60
FC Nords,4637,3,15,7,8,74,50,24,52
Copenhagen,4637,4,14,5,11,58,45,13,47
AaB,4637,5,7,13,10,37,42,-5,34
Sonderjyske,4637,6,8,6,10,28,29,-1,30
AC Horsens,4637,7,6,12,12,37,57,-20,30
Randers FC,4637,8,6,6,12,25,40,-15,24
Silkeborg IF,4637,9,5,4,13,26,45,-19,19
AGF Aarhus,4637,10,4,7,11,17,37,-20,19
Lyngby,4637,11,3,9,12,27,46,-19,18
Brondby,4638,1,20,6,4,70,33,37,66
FC Midtjylla,4638,2,20,6,4,67,37,30,66
Copenhagen,4638,3,14,4,12,59,46,13,46
FC Nords,4638,4,12,7,11,69,60,9,43
AaB,4638,5,9,12,9,42,43,-1,39
AC Horsens,4638,6,7,13,10,39,53,-14,34
Sonderjyske,4638,7,8,6,10,28,29,-1,30
Lyngby,4638,8,4,9,11,28,44,-16,21
Randers FC,4638,9,5,6,13,23,41,-18,21
AGF Aarhus,4638,10,5,6,11,20,38,-18,21
Silkeborg IF,4638,11,5,3,14,27,48,-21,18
Brondby,4639,1,22,6,2,76,31,45,72
FC Midtjylla,4639,2,20,4,6,65,41,24,64
FC Nords,4639,3,15,6,9,74,48,26,51
Copenhagen,4639,4,13,5,12,57,48,9,44
AC Horsens,4639,5,7,12,11,35,54,-19,33
AaB,4639,6,7,11,12,37,48,-11,32
Sonderjyske,4639,7,8,6,10,28,29,-1,30
Silkeborg IF,4639,8,6,3,13,28,45,-17,21
Lyngby,4639,9,4,9,11,27,44,-17,21
Randers FC,4639,10,5,6,13,23,40,-17,21
AGF Aarhus,4639,11,4,6,12,17,39,-22,18
Brondby,4640,1,21,6,3,71,30,41,69
FC Midtjylla,4640,2,21,5,4,73,36,37,68
FC Nords,4640,3,14,6,10,70,53,17,48
Copenhagen,4640,4,12,6,12,51,46,5,42
AaB,4640,5,8,12,10,36,45,-9,36
AC Horsens,4640,6,6,13,11,33,50,-17,31
Sonderjyske,4640,7,8,6,10,28,29,-1,30
Randers FC,4640,8,5,7,12,24,40,-16,22
Lyngby,4640,9,3,10,11,27,45,-18,19
Silkeborg IF,4640,10,5,4,13,25,44,-19,19
AGF Aarhus,4640,11,4,7,11,16,36,-20,19
Brondby,4641,1,21,6,3,71,29,42,69
FC Midtjylla,4641,2,18,6,6,61,38,23,60
FC Nords,4641,3,15,8,7,75,47,28,53
Copenhagen,4641,4,13,6,11,57,46,11,45
AaB,4641,5,8,12,10,35,40,-5,36
Sonderjyske,4641,6,8,6,10,28,29,-1,30
AC Horsens,4641,7,6,12,12,32,57,-25,30
Lyngby,4641,8,4,9,11,27,44,-17,21
Randers FC,4641,9,5,6,13,23,40,-17,21
AGF Aarhus,4641,10,5,6,11,17,36,-19,21
Silkeborg IF,4641,11,5,3,14,25,45,-20,18
Brondby,4642,1,20,6,4,68,35,33,66
FC Midtjylla,4642,2,19,7,4,63,36,27,64
FC Nords,4642,3,16,6,8,81,53,28,54
Copenhagen,4642,4,14,5,11,56,42,14,47
AC Horsens,4642,5,6,14,10,32,51,-19,32
Sonderjyske,4642,6,8,6,10,28,29,-1,30
AaB,4642,7,6,12,12,33,42,-9,30
Randers FC,4642,8,6,6,12,26,41,-15,24
Silkeborg IF,4642,9,6,3,13,28,46,-18,21
Lyngby,4642,10,3,9,12,28,47,-19,18
AGF Aarhus,4642,11,4,6,12,18,39,-21,18
Brondby,4643,1,21,5,4,75,36,39,68
FC Midtjylla,4643,2,19,5,6,62,38,24,62
FC Nords,4643,3,15,6,9,74,49,25,51
Copenhagen,4643,4,14,6,10,56,42,14,48
AaB,4643,5,7,13,10,34,41,-7,34
AC Horsens,4643,6,6,13,11,33,54,-21,31
Sonderjyske,4643,7,8,6,10,28,29,-1,30
Randers FC,4643,8,5,7,12,23,39,-16,22
AGF Aarhus,4643,9,5,6,11,17,36,-19,21
Lyngby,4643,10,3,10,11,26,44,-18,19
Silkeborg IF,4643,11,5,3,14,25,45,-20,18
Brondby,4644,1,20,7,3,67,31,36,67
FC Midtjylla,4644,2,19,5,6,63,38,25,62
FC Nords,4644,3,15,6,9,74,51,23,51
Copenhagen,4644,4,14,6,10,60,44,16,48
AC Horsens,4644,5,7,13,10,36,53,-17,34
AaB,4644,6,6,13,11,33,42,-9,31
Sonderjyske,4644,7,8,6,10,28,29,-1,30
Randers FC,4644,8,6,6,12,26,41,-15,24
AGF Aarhus,4644,9,5,6,11,19,36,-17,21
Lyngby,4644,10,3,9,12,28,47,-19,18
Silkeborg IF,4644,11,5,3,14,25,47,-22,18
Brondby,4645,1,22,6,2,69,28,41,72
FC Midtjylla,4645,2,19,4,7,64,41,23,61
FC Nords,4645,3,13,7,10,68,50,18,46
Copenhagen,4645,4,13,7,10,55,43,12,46
AaB,4645,5,8,13,9,40,41,-1,37
AC Horsens,4645,6,6,13,11,35,54,-19,31
Sonderjyske,4645,7,8,6,10,28,29,-1,30
Lyngby,4645,8,4,9,11,29,44,-15,21
Randers FC,4645,9,5,6,13,23,42,-19,21
AGF Aarhus,4645,10,5,6,11,19,38,-19,21
Silkeborg IF,4645,11,5,3,14,27,47,-20,18
Brondby,4646,1,22,6,2,76,32,44,72
FC Midtjylla,4646,2,19,7,4,66,39,27,64
FC Nords,4646,3,13,7,10,72,55,17,46
Copenhagen,4646,4,13,6,11,56,44,12,45
AaB,4646,5,8,12,10,38,41,-3,36
Sonderjyske,4646,6,8,6,10,28,29,-1,30
AC Horsens,4646,7,5,14,11,34,57,-23,29
Randers FC,4646,8,6,6,12,24,39,-15,24
Silkeborg IF,4646,9,6,3,13,26,44,-18,21
Lyngby,4646,10,3,9,12,26,45,-19,18
AGF Aarhus,4646,11,4,6,12,16,37,-21,18
Brondby,4647,1,20,5,5,68,38,30,65
FC Midtjylla,4647,2,19,4,7,63,43,20,61
FC Nords,4647,3,14,8,8,81,56,25,50
Copenhagen,4647,4,15,5,10,67,46,21,50
AaB,4647,5,8,12,10,43,47,-4,36
AC Horsens,4647,6,7,12,11,34,52,-18,33
Sonderjyske,4647,7,8,6,10,28,29,-1,30
Lyngby,4647,8,4,9,11,28,44,-16,21
Silkeborg IF,4647,9,6,3,13,26,44,-18,21
Randers FC,4647,10,5,6,13,23,41,-18,21
AGF Aarhus,4647,11,4,6,12,16,37,-21,18
Brondby,4648,1,20,5,5,69,36,33,65
FC Midtjylla,4648,2,18,4,8,66,45,21,58
FC Nords,4648,3,15,7,8,73,50,23,52
Copenhagen,4648,4,13,6,11,57,48,9,45
AC Horsens,4648,5,9,12,9,39,47,-8,39
AaB,4648,6,8,12,10,37,41,-4,36
Sonderjyske,4648,7,8,6,10,28,29,-1,30
Randers FC,4648,8,5,7,12,24,40,-16,22
Lyngby,4648,9,3,10,11,27,45,-18,19
Silkeborg IF,4648,10,5,4,13,26,45,-19,19
AGF Aarhus,4648,11,4,7,11,17,37,-20,19
FC Midtjylla,4649,1,21,4,5,66,37,29,67
Brondby,4649,2,19,7,4,66,34,32,64
FC Nords,4649,3,14,8,8,72,49,23,50
Copenhagen,4649,4,13,5,12,57,46,11,44
AC Horsens,4649,5,8,12,10,35,48,-13,36
AaB,4649,6,7,12,11,35,43,-8,33
Sonderjyske,4649,7,8,6,10,28,29,-1,30
Lyngby,4649,8,4,9,11,28,44,-16,21
Silkeborg IF,4649,9,6,3,13,27,44,-17,21
Randers FC,4649,10,5,6,13,23,41,-18,21
AGF Aarhus,4649,11,4,6,12,16,38,-22,18
Brondby,4650,1,22,6,2,70,30,40,72
FC Midtjylla,4650,2,18,4,8,64,44,20,58
FC Nords,4650,3,15,6,9,81,52,29,51
Copenhagen,4650,4,15,6,9,62,44,18,51
AaB,4650,5,8,12,10,36,44,-8,36
Sonderjyske,4650,6,8,6,10,28,29,-1,30
AC Horsens,4650,7,5,12,13,31,56,-25,27
Lyngby,4650,8,4,9,11,29,44,-15,21
Silkeborg IF,4650,9,6,3,13,27,45,-18,21
Randers FC,4650,10,5,6,13,23,42,-19,21
AGF Aarhus,4650,11,4,6,12,17,38,-21,18
Brondby,4651,1,20,6,4,70,34,36,66
FC Midtjylla,4651,2,19,5,6,64,43,21,62
FC Nords,4651,3,15,8,7,77,48,29,53
Copenhagen,4651,4,15,5,10,61,47,14,50
AC Horsens,4651,5,7,13,10,43,54,-11,34
Sonderjyske,4651,6,8,6,10,28,29,-1,30
AaB,4651,7,6,11,13,33,48,-15,29
Randers FC,4651,8,6,6,12,26,40,-14,24
Silkeborg IF,4651,9,6,3,13,27,44,-17,21
Lyngby,4651,10,3,9,12,27,47,-20,18
AGF Aarhus,4651,11,4,6,12,16,38,-22,18
Brondby,4652,1,19,6,5,67,34,33,63
FC Midtjylla,4652,2,18,5,7,65,45,20,59
Copenhagen,4652,3,15,5,10,60,42,18,50
FC Nords,4652,4,13,9,8,72,52,20,48
AC Horsens,4652,5,7,15,8,38,50,-12,36
AaB,4652,6,7,14,9,39,44,-5,35
Sonderjyske,4652,7,8,6,10,28,29,-1,30
Lyngby,4652,8,4,9,11,29,44,-15,21
Silkeborg IF,4652,8,6,3,13,29,44,-15,21
Randers FC,4652,10,5,6,13,23,42,-19,21
AGF Aarhus,4652,11,4,6,12,16,40,-24,18
Brondby,4653,1,20,5,5,66,31,35,65
FC Midtjylla,4653,2,18,7,5,62,38,24,61
Copenhagen,4653,3,14,5,11,57,46,11,47
FC Nords,4653,4,12,7,11,69,54,15,43
AaB,4653,5,9,13,8,39,38,1,40
AC Horsens,4653,6,7,15,8,38,50,-12,36
Sonderjyske,4653,7,8,6,10,28,29,-1,30
Randers FC,4653,8,6,6,12,25,40,-15,24
Silkeborg IF,4653,9,6,3,13,29,46,-17,21
Lyngby,4653,10,3,9,12,27,46,-19,18
AGF Aarhus,4653,11,4,6,12,18,40,-22,18
Brondby,4654,1,22,5,3,75,30,45,71
FC Midtjylla,4654,2,21,5,4,73,42,31,68
FC Nords,4654,3,14,6,10,70,54,16,48
Copenhagen,4654,4,12,4,14,52,47,5,40
AaB,4654,5,9,11,10,45,45,0,38
AC Horsens,4654,6,6,13,11,35,58,-23,31
Sonderjyske,4654,7,8,6,10,28,29,-1,30
Lyngby,4654,8,4,9,11,30,45,-15,21
Randers FC,4654,9,5,6,13,24,43,-19,21
AGF Aarhus,4654,10,5,6,11,18,37,-19,21
Silkeborg IF,4654,11,5,3,14,26,46,-20,18
Brondby,4655,1,21,7,2,71,32,39,70
FC Midtjylla,4655,2,20,6,4,65,34,31,66
FC Nords,4655,3,13,8,9,72,53,19,47
Copenhagen,4655,4,12,5,13,54,49,5,41
AaB,4655,5,8,11,11,38,42,-4,35
AC Horsens,4655,6,7,13,10,35,51,-16,34
Sonderjyske,4655,7,8,6,10,28,29,-1,30
Lyngby,4655,8,4,9,11,28,45,-17,21
Silkeborg IF,4655,9,6,3,13,27,44,-17,21
Randers FC,4655,10,5,6,13,24,41,-17,21
AGF Aarhus,4655,11,4,6,12,16,38,-22,18
Brondby,4656,1,20,6,4,69,31,38,66
FC Midtjylla,4656,2,20,4,6,69,42,27,64
FC Nords,4656,3,15,6,9,76,53,23,51
Copenhagen,4656,4,15,4,11,61,46,15,49
AaB,4656,5,8,11,11,36,43,-7,35
AC Horsens,4656,6,6,13,11,34,56,-22,31
Sonderjyske,4656,7,8,6,10,28,29,-1,30
Randers FC,4656,8,6,6,12,26,40,-14,24
Silkeborg IF,4656,9,6,3,13,27,45,-18,21
Lyngby,4656,10,3,9,12,27,47,-20,18
AGF Aarhus,4656,11,4,6,12,17,38,-21,18
Brondby,4657,1,20,5,5,71,39,32,65
FC Midtjylla,4657,2,20,4,6,69,42,27,64
FC Nords,4657,3,15,6,9,76,53,23,51
Copenhagen,4657,4,13,6,11,57,45,12,45
AaB,4657,5,8,12,10,38,40,-2,36
AC Horsens,4657,6,7,13,10,34,52,-18,34
Sonderjyske,4657,7,8,6,10,28,29,-1,30
Randers FC,4657,8,5,7,12,24,40,-16,22
Silkeborg IF,4657,9,6,3,13,26,44,-18,21
Lyngby,4657,10,3,10,11,27,45,-18,19
AGF Aarhus,4657,11,4,6,12,16,37,-21,18
Brondby,4658,1,19,7,4,66,31,35,64
FC Midtjylla,4658,2,19,6,5,69,38,31,63
FC Nords,4658,3,14,7,9,72,56,16,49
Copenhagen,4658,4,13,6,11,54,42,12,45
AaB,4658,5,9,13,8,37,37,0,40
AC Horsens,4658,6,6,13,11,33,53,-20,31
Sonderjyske,4658,7,8,6,10,28,29,-1,30
Randers FC,4658,8,5,7,12,24,40,-16,22
Silkeborg IF,4658,9,6,3,13,27,45,-18,21
Lyngby,4658,10,3,10,11,27,45,-18,19
AGF Aarhus,4658,11,4,6,12,17,38,-21,18
Brondby,4659,1,22,6,2,74,31,43,72
FC Midtjylla,4659,2,17,5,8,58,39,19,56
FC Nords,4659,3,16,6,8,74,53,21,54
Copenhagen,4659,4,14,4,12,59,48,11,46
AaB,4659,5,9,11,10,41,41,0,38
Sonderjyske,4659,6,8,6,10,28,29,-1,30
AC Horsens,4659,7,6,12,12,33,53,-20,30
Randers FC,4659,8,6,6,12,25,40,-15,24
Silkeborg IF,4659,9,6,3,13,26,44,-18,21
Lyngby,4659,10,3,9,12,27,46,-19,18
AGF Aarhus,4659,11,4,6,12,16,37,-21,18
Brondby,4660,1,20,7,3,72,34,38,67
FC Midtjylla,4660,2,20,5,5,63,37,26,65
FC Nords,4660,3,15,8,7,75,50,25,53
Copenhagen,4660,4,13,7,10,59,43,16,46
AaB,4660,5,6,14,10,36,42,-6,32
Sonderjyske,4660,6,8,6,10,28,29,-1,30
AC Horsens,4660,7,5,13,12,34,59,-25,28
Lyngby,4660,8,4,9,11,27,44,-17,21
Silkeborg IF,4660,8,6,3,13,27,44,-17,21
Randers FC,4660,10,5,6,13,23,40,-17,21
AGF Aarhus,4660,11,4,6,12,16,38,-22,18
Brondby,4661,1,20,6,4,72,35,37,66
FC Midtjylla,4661,2,18,5,7,64,46,18,59
FC Nords,4661,3,13,9,8,72,50,22,48
Copenhagen,4661,4,14,5,11,61,47,14,47
AaB,4661,5,9,12,9,42,45,-3,39
AC Horsens,4661,6,7,13,10,39,53,-14,34
Sonderjyske,4661,7,8,6,10,28,29,-1,30
Lyngby,4661,8,4,9,11,28,44,-16,21
Silkeborg IF,4661,9,6,3,13,26,44,-18,21
Randers FC,4661,10,5,6,13,23,41,-18,21
AGF Aarhus,4661,11,4,6,12,16,37,-21,18
Brondby,4662,1,22,6,2,74,32,42,72
FC Midtjylla,4662,2,19,6,5,69,40,29,63
Copenhagen,4662,3,14,7,9,60,44,16,49
FC Nords,4662,4,13,6,11,73,55,18,45
AaB,4662,5,7,12,11,35,48,-13,33
AC Horsens,4662,6,6,13,11,36,54,-18,31
Sonderjyske,4662,7,8,6,10,28,29,-1,30
Randers FC,4662,8,6,6,12,25,39,-14,24
Silkeborg IF,4662,9,5,4,13,28,47,-19,19
AGF Aarhus,4662,10,4,7,11,19,39,-20,19
Lyngby,4662,11,3,9,12,26,46,-20,18
Brondby,4663,1,21,6,3,75,32,43,69
FC Midtjylla,4663,2,20,4,6,63,39,24,64
Copenhagen,4663,3,16,4,10,62,40,22,52
FC Nords,4663,4,13,6,11,68,58,10,45
AC Horsens,4663,5,7,13,10,35,51,-16,34
AaB,4663,6,7,11,12,36,45,-9,32
Sonderjyske,4663,7,8,6,10,28,29,-1,30
Lyngby,4663,8,4,9,11,28,45,-17,21
Randers FC,4663,9,5,6,13,24,41,-17,21
Silkeborg IF,4663,10,5,4,13,27,46,-19,19
AGF Aarhus,4663,11,4,7,11,18,38,-20,19
Brondby,4664,1,19,9,2,66,29,37,66
FC Midtjylla,4664,2,17,7,6,60,41,19,58
FC Nords,4664,3,15,7,8,73,46,27,52
Copenhagen,4664,4,14,5,11,56,44,12,47
AaB,4664,5,8,13,9,39,40,-1,37
Sonderjyske,4664,6,8,6,10,28,29,-1,30
AC Horsens,4664,7,5,15,10,32,52,-20,30
Randers FC,4664,8,6,6,12,26,40,-14,24
Silkeborg IF,4664,9,5,4,13,27,46,-19,19
AGF Aarhus,4664,10,4,7,11,18,38,-20,19
Lyngby,4664,11,3,9,12,27,47,-20,18
Brondby,4665,1,22,5,3,69,29,40,71
FC Midtjylla,4665,2,21,4,5,69,41,28,67
FC Nords,4665,3,15,6,9,79,50,29,51
Copenhagen,4665,4,15,4,11,55,42,13,49
Sonderjyske,4665,5,8,6,10,28,29,-1,30
AC Horsens,4665,6,6,12,12,36,60,-24,30
AaB,4665,7,6,11,13,36,48,-12,29
Randers FC,4665,8,6,6,12,25,39,-14,24
AGF Aarhus,4665,9,5,6,11,19,36,-17,21
Lyngby,4665,10,3,9,12,26,46,-20,18
Silkeborg IF,4665,11,5,3,14,25,47,-22,18
Brondby,4666,1,21,7,2,69,28,41,70
FC Midtjylla,4666,2,19,5,6,65,41,24,62
FC Nords,4666,3,13,8,9,73,52,21,47
Copenhagen,4666,4,13,7,10,56,43,13,46
AaB,4666,5,7,13,10,39,47,-8,34
AC Horsens,4666,6,6,14,10,34,51,-17,32
Sonderjyske,4666,7,8,6,10,28,29,-1,30
Randers FC,4666,8,5,7,12,23,39,-16,22
Lyngby,4666,9,3,10,11,26,44,-18,19
Silkeborg IF,4666,10,5,4,13,25,44,-19,19
AGF Aarhus,4666,11,4,7,11,16,36,-20,19
Brondby,4667,1,22,6,2,78,34,44,72
FC Midtjylla,4667,2,19,6,5,67,39,28,63
Copenhagen,4667,3,13,7,10,57,45,12,46
FC Nords,4667,4,12,9,9,68,55,13,45
AaB,4667,5,6,14,10,38,46,-8,32
AC Horsens,4667,6,6,14,10,35,50,-15,32
Sonderjyske,4667,7,8,6,10,28,29,-1,30
Lyngby,4667,8,4,9,11,28,45,-17,21
Randers FC,4667,9,5,6,13,24,41,-17,21
AGF Aarhus,4667,10,5,6,11,20,37,-17,21
Silkeborg IF,4667,11,5,3,14,26,48,-22,18
Brondby,4668,1,21,6,3,69,32,37,69
FC Midtjylla,4668,2,17,6,7,62,42,20,57
FC Nords,4668,3,15,7,8,82,54,28,52
Copenhagen,4668,4,13,6,11,55,44,11,45
AaB,4668,5,8,13,9,38,41,-3,37
AC Horsens,4668,6,5,16,9,34,53,-19,31
Sonderjyske,4668,7,8,6,10,28,29,-1,30
Randers FC,4668,8,5,7,12,24,40,-16,22
AGF Aarhus,4668,9,5,6,11,19,38,-19,21
Lyngby,4668,10,3,10,11,27,45,-18,19
Silkeborg IF,4668,11,5,3,14,27,47,-20,18
FC Midtjylla,4669,1,21,4,5,69,39,30,67
Brondby,4669,2,19,6,5,69,38,31,63
FC Nords,4669,3,16,7,7,81,52,29,55
Copenhagen,4669,4,13,4,13,56,44,12,43
AC Horsens,4669,5,7,13,10,40,60,-20,34
AaB,4669,6,7,12,11,36,44,-8,33
Sonderjyske,4669,7,8,6,10,28,29,-1,30
Randers FC,4669,8,5,7,12,24,40,-16,22
AGF Aarhus,4669,9,5,6,11,18,36,-18,21
Lyngby,4669,10,3,10,11,27,45,-18,19
Silkeborg IF,4669,11,5,3,14,25,46,-21,18
FC Midtjylla,4670,1,21,5,4,69,37,32,68
Brondby,4670,2,19,7,4,73,41,32,64
FC Nords,4670,3,14,7,9,76,51,25,49
Copenhagen,4670,4,14,5,11,59,50,9,47
AaB,4670,5,8,11,11,36,42,-6,35
AC Horsens,4670,6,6,13,11,37,55,-18,31
Sonderjyske,4670,7,8,6,10,28,29,-1,30
Randers FC,4670,8,5,7,12,25,41,-16,22
Lyngby,4670,9,3,10,11,28,46,-18,19
Silkeborg IF,4670,10,5,4,13,26,45,-19,19
AGF Aarhus,4670,11,4,7,11,17,37,-20,19
Brondby,4671,1,21,6,3,69,31,38,69
FC Midtjylla,4671,2,18,6,6,65,42,23,60
Copenhagen,4671,3,17,4,9,63,43,20,55
FC Nords,4671,4,13,8,9,71,51,20,47
AaB,4671,5,7,12,11,36,43,-7,33
Sonderjyske,4671,6,8,6,10,28,29,-1,30
AC Horsens,4671,7,5,14,11,34,54,-20,29
Lyngby,4671,8,4,9,11,29,44,-15,21
Silkeborg IF,4671,9,6,3,13,26,44,-18,21
Randers FC,4671,10,5,6,13,23,42,-19,21
AGF Aarhus,4671,11,4,6,12,16,37,-21,18
Brondby,4672,1,19,8,3,66,31,35,65
FC Midtjylla,4672,2,19,6,5,68,42,26,63
FC Nords,4672,3,14,8,8,75,54,21,50
Copenhagen,4672,4,14,4,12,54,46,8,46
AaB,4672,5,9,12,9,44,41,3,39
Sonderjyske,4672,6,8,6,10,28,29,-1,30
AC Horsens,4672,7,5,14,11,36,55,-19,29
Randers FC,4672,8,6,6,12,26,41,-15,24
Silkeborg IF,4672,9,6,3,13,28,44,-16,21
Lyngby,4672,10,3,9,12,28,47,-19,18
AGF Aarhus,4672,11,4,6,12,16,39,-23,18
Brondby,4673,1,21,5,4,71,37,34,68
FC Midtjylla,4673,2,19,4,7,65,39,26,61
FC Nords,4673,3,15,7,8,78,55,23,52
Copenhagen,4673,4,15,5,10,58,42,16,50
AaB,4673,5,8,11,11,37,43,-6,35
Sonderjyske,4673,6,8,6,10,28,29,-1,30
AC Horsens,4673,7,6,12,12,34,53,-19,30
Lyngby,4673,8,4,9,11,27,44,-17,21
Randers FC,4673,9,5,6,13,23,40,-17,21
AGF Aarhus,4673,10,5,6,11,19,38,-19,21
Silkeborg IF,4673,11,5,3,14,27,47,-20,18
Brondby,4674,1,21,6,3,72,32,40,69
FC Midtjylla,4674,2,21,4,5,66,38,28,67
Copenhagen,4674,3,15,6,9,60,41,19,51
FC Nords,4674,4,14,7,9,75,54,21,49
AaB,4674,5,7,11,12,38,43,-5,32
Sonderjyske,4674,6,8,6,10,28,29,-1,30
AC Horsens,4674,7,5,12,13,35,64,-29,27
Lyngby,4674,8,4,9,11,28,44,-16,21
Silkeborg IF,4674,9,6,3,13,28,45,-17,21
Randers FC,4674,10,5,6,13,23,41,-18,21
AGF Aarhus,4674,11,4,6,12,17,39,-22,18
Brondby,4675,1,21,5,4,69,29,40,68
FC Midtjylla,4675,2,20,4,6,67,41,26,64
Copenhagen,4675,3,16,4,10,61,42,19,52
FC Nords,4675,4,14,6,10,73,57,16,48
AC Horsens,4675,5,7,12,11,33,53,-20,33
AaB,4675,6,7,11,12,37,44,-7,32
Sonderjyske,4675,7,8,6,10,28,29,-1,30
Randers FC,4675,8,6,6,12,27,41,-14,24
AGF Aarhus,4675,9,5,6,11,17,36,-19,21
Lyngby,4675,10,3,9,12,28,48,-20,18
Silkeborg IF,4675,11,5,3,14,25,45,-20,18
Brondby,4676,1,20,6,4,70,35,35,66
FC Midtjylla,4676,2,17,6,7,66,45,21,57
FC Nords,4676,3,14,7,9,76,55,21,49
Copenhagen,4676,4,15,4,11,61,49,12,49
AaB,4676,5,10,11,9,44,43,1,41
AC Horsens,4676,6,6,14,10,40,56,-16,32
Sonderjyske,4676,7,8,6,10,28,29,-1,30
Lyngby,4676,8,4,9,11,28,45,-17,21
Silkeborg IF,4676,9,6,3,13,27,44,-17,21
Randers FC,4676,10,5,6,13,24,41,-17,21
AGF Aarhus,4676,11,4,6,12,16,38,-22,18
Brondby,4677,1,19,7,4,69,34,35,64
FC Midtjylla,4677,2,19,5,6,66,38,28,62
Copenhagen,4677,3,15,5,10,66,46,20,50
FC Nords,4677,4,14,7,9,72,51,21,49
AC Horsens,4677,5,7,14,9,34,53,-19,35
AaB,4677,6,6,14,10,37,48,-11,32
Sonderjyske,4677,7,8,6,10,28,29,-1,30
Randers FC,4677,8,6,6,12,25,40,-15,24
Silkeborg IF,4677,9,6,3,13,26,44,-18,21
Lyngby,4677,10,3,9,12,27,46,-19,18
AGF Aarhus,4677,11,4,6,12,16,37,-21,18
Brondby,4678,1,20,6,4,71,36,35,66
FC Midtjylla,4678,2,19,5,6,63,39,24,62
FC Nords,4678,3,15,7,8,80,50,30,52
Copenhagen,4678,4,14,5,11,59,47,12,47
AaB,4678,5,8,13,9,39,40,-1,37
Sonderjyske,4678,6,8,6,10,28,29,-1,30
AC Horsens,4678,7,6,12,12,33,59,-26,30
Lyngby,4678,8,4,9,11,29,45,-16,21
Silkeborg IF,4678,9,6,3,13,26,44,-18,21
Randers FC,4678,10,5,6,13,24,42,-18,21
AGF Aarhus,4678,11,4,6,12,16,37,-21,18
Brondby,4679,1,21,6,3,72,33,39,69
FC Midtjylla,4679,2,19,4,7,68,41,27,61
Copenhagen,4679,3,14,5,11,54,42,12,47
FC Nords,4679,4,13,6,11,69,53,16,45
AC Horsens,4679,5,9,12,9,40,55,-15,39
AaB,4679,6,8,11,11,38,43,-5,35
Sonderjyske,4679,7,8,6,10,28,29,-1,30
Randers FC,4679,8,6,6,12,26,39,-13,24
Silkeborg IF,4679,9,6,3,13,28,45,-17,21
Lyngby,4679,10,3,9,12,26,47,-21,18
AGF Aarhus,4679,11,4,6,12,17,39,-22,18
Brondby,4680,1,22,6,2,78,34,44,72
FC Midtjylla,4680,2,19,4,7,62,41,21,61
FC Nords,4680,3,15,6,9,71,51,20,51
Copenhagen,4680,4,14,5,11,58,43,15,47
AaB,4680,5,7,11,12,37,47,-10,32
AC Horsens,4680,6,6,14,10,36,52,-16,32
Sonderjyske,4680,7,8,6,10,28,29,-1,30
Randers FC,4680,8,6,6,12,24,39,-15,24
Silkeborg IF,4680,9,6,3,13,27,45,-18,21
Lyngby,4680,10,3,9,12,26,45,-19,18
AGF Aarhus,4680,11,4,6,12,17,38,-21,18
Brondby,4681,1,22,5,3,72,29,43,71
FC Midtjylla,4681,2,19,4,7,66,42,24,61
FC Nords,4681,3,14,7,9,70,52,18,49
Copenhagen,4681,4,15,4,11,59,45,14,49
AaB,4681,5,7,12,11,38,45,-7,33
AC Horsens,4681,6,6,14,10,34,52,-18,32
Sonderjyske,4681,7,8,6,10,28,29,-1,30
Randers FC,4681,8,6,6,12,26,39,-13,24
Silkeborg IF,4681,9,6,3,13,26,44,-18,21
Lyngby,4681,10,3,9,12,26,47,-21,18
AGF Aarhus,4681,11,4,6,12,16,37,-21,18
Brondby,4682,1,20,6,4,73,36,37,66
FC Midtjylla,4682,2,19,4,7,65,43,22,61
FC Nords,4682,3,16,6,8,82,56,26,54
Copenhagen,4682,4,14,4,12,58,45,13,46
AaB,4682,5,8,13,9,36,40,-4,37
AC Horsens,4682,6,6,13,11,35,55,-20,31
Sonderjyske,4682,7,8,6,10,28,29,-1,30
Randers FC,4682,8,6,6,12,24,39,-15,24
Silkeborg IF,4682,9,5,4,13,26,45,-19,19
AGF Aarhus,4682,10,4,7,11,17,37,-20,19
Lyngby,4682,11,3,9,12,26,45,-19,18
FC Midtjylla,4683,1,21,5,4,71,38,33,68
Brondby,4683,2,19,7,4,65,31,34,64
Copenhagen,4683,3,15,5,10,62,47,15,50
FC Nords,4683,4,14,7,9,74,53,21,49
AaB,4683,5,7,12,11,38,45,-7,33
Sonderjyske,4683,6,8,6,10,28,29,-1,30
AC Horsens,4683,7,6,12,12,34,56,-22,30
Randers FC,4683,8,5,7,12,24,40,-16,22
Silkeborg IF,4683,9,6,3,13,27,45,-18,21
Lyngby,4683,10,3,10,11,27,45,-18,19
AGF Aarhus,4683,11,4,6,12,17,38,-21,18
Brondby,4684,1,21,5,4,76,32,44,68
FC Midtjylla,4684,2,20,4,6,67,43,24,64
FC Nords,4684,3,13,8,9,73,53,20,47
Copenhagen,4684,4,14,5,11,59,49,10,47
AaB,4684,5,9,12,9,43,45,-2,39
Sonderjyske,4684,6,8,6,10,28,29,-1,30
AC Horsens,4684,7,6,12,12,37,59,-22,30
Lyngby,4684,8,4,9,11,29,45,-16,21
Randers FC,4684,9,5,6,13,24,42,-18,21
Silkeborg IF,4684,10,5,4,13,26,45,-19,19
AGF Aarhus,4684,11,4,7,11,17,37,-20,19
Brondby,4685,1,21,5,4,71,34,37,68
FC Midtjylla,4685,2,20,5,5,66,39,27,65
Copenhagen,4685,3,14,5,11,57,43,14,47
FC Nords,4685,4,13,6,11,71,55,16,45
AaB,4685,5,8,12,10,35,39,-4,36
AC Horsens,4685,6,7,13,10,38,54,-16,34
Sonderjyske,4685,7,8,6,10,28,29,-1,30
Randers FC,4685,8,6,6,12,25,40,-15,24
AGF Aarhus,4685,9,5,6,11,18,37,-19,21
Lyngby,4685,10,3,9,12,27,46,-19,18
Silkeborg IF,4685,11,5,3,14,26,46,-20,18
Brondby,4686,1,19,7,4,68,41,27,64
FC Midtjylla,4686,2,19,6,5,70,39,31,63
FC Nords,4686,3,14,9,7,77,53,24,51
Copenhagen,4686,4,14,5,11,65,46,19,47
AaB,4686,5,7,13,10,38,45,-7,34
AC Horsens,4686,6,6,14,10,37,57,-20,32
Sonderjyske,4686,7,8,6,10,28,29,-1,30
Lyngby,4686,8,4,9,11,29,44,-15,21
Randers FC,4686,9,5,6,13,23,42,-19,21
Silkeborg IF,4686,10,5,4,13,25,44,-19,19
AGF Aarhus,4686,11,4,7,11,16,36,-20,19
Brondby,4687,1,20,7,3,68,32,36,67
FC Midtjylla,4687,2,19,5,6,61,37,24,62
Copenhagen,4687,3,14,6,10,59,44,15,48
FC Nords,4687,4,13,8,9,74,55,19,47
AaB,4687,5,7,13,10,38,42,-4,34
AC Horsens,4687,6,7,13,10,37,53,-16,34
Sonderjyske,4687,7,8,6,10,28,29,-1,30
Lyngby,4687,8,4,9,11,27,44,-17,21
Randers FC,4687,9,5,6,13,23,40,-17,21
Silkeborg IF,4687,10,6,3,13,27,45,-18,21
AGF Aarhus,4687,11,4,6,12,17,38,-21,18
Brondby,4688,1,19,8,3,64,28,36,65
FC Midtjylla,4688,2,17,7,6,61,44,17,58
Copenhagen,4688,3,15,5,10,59,41,18,50
FC Nords,4688,4,14,7,9,70,49,21,49
AaB,4688,5,8,13,9,38,40,-2,37
AC Horsens,4688,6,5,16,9,33,49,-16,31
Sonderjyske,4688,7,8,6,10,28,29,-1,30
Lyngby,4688,8,4,9,11,32,44,-12,21
Silkeborg IF,4688,9,6,3,13,27,44,-17,21
Randers FC,4688,10,5,6,13,23,45,-22,21
AGF Aarhus,4688,11,4,6,12,16,38,-22,18
Brondby,4689,1,20,7,3,72,34,38,67
FC Midtjylla,4689,2,19,5,6,67,42,25,62
FC Nords,4689,3,14,7,9,73,52,21,49
Copenhagen,4689,4,13,7,10,62,49,13,46
AaB,4689,5,8,12,10,39,45,-6,36
AC Horsens,4689,6,6,14,10,37,54,-17,32
Sonderjyske,4689,7,8,6,10,28,29,-1,30
Randers FC,4689,8,5,7,12,25,41,-16,22
Lyngby,4689,9,3,10,11,28,46,-18,19
Silkeborg IF,4689,10,5,4,13,26,45,-19,19
AGF Aarhus,4689,11,4,7,11,17,37,-20,19
Brondby,4690,1,21,5,4,72,32,40,68
FC Midtjylla,4690,2,20,6,4,67,39,28,66
FC Nords,4690,3,15,7,8,70,47,23,52
Copenhagen,4690,4,13,6,11,58,48,10,45
AaB,4690,5,7,13,10,36,41,-5,34
Sonderjyske,4690,6,8,6,10,28,29,-1,30
AC Horsens,4690,7,5,13,12,33,55,-22,28
Lyngby,4690,8,4,9,11,27,44,-17,21
Randers FC,4690,9,5,6,13,23,40,-17,21
AGF Aarhus,4690,10,5,6,11,17,36,-19,21
Silkeborg IF,4690,11,5,3,14,25,45,-20,18
FC Midtjylla,4691,1,20,6,4,67,37,30,66
Brondby,4691,2,19,6,5,66,35,31,63
FC Nords,4691,3,16,6,8,79,50,29,54
Copenhagen,4691,4,14,4,12,58,47,11,46
AC Horsens,4691,5,7,13,10,33,49,-16,34
AaB,4691,6,7,11,12,37,48,-11,32
Sonderjyske,4691,7,8,6,10,28,29,-1,30
Lyngby,4691,8,4,9,11,28,45,-17,21
Randers FC,4691,9,5,6,13,24,41,-17,21
Silkeborg IF,4691,10,5,4,13,26,45,-19,19
AGF Aarhus,4691,11,4,7,11,17,37,-20,19
Brondby,4692,1,21,5,4,71,31,40,68
FC Midtjylla,4692,2,18,6,6,61,37,24,60
Copenhagen,4692,3,15,5,10,59,45,14,50
FC Nords,4692,4,14,6,10,73,54,19,48
AaB,4692,5,9,13,8,35,36,-1,40
Sonderjyske,4692,6,8,6,10,28,29,-1,30
AC Horsens,4692,7,5,13,12,34,56,-22,28
Lyngby,4692,8,4,9,11,29,46,-17,21
Randers FC,4692,9,5,6,13,25,42,-17,21
AGF Aarhus,4692,10,5,6,11,19,37,-18,21
Silkeborg IF,4692,11,5,3,14,26,47,-21,18
Brondby,4693,1,19,7,4,72,37,35,64
FC Midtjylla,4693,2,19,5,6,64,40,24,62
Copenhagen,4693,3,16,4,10,58,45,13,52
FC Nords,4693,4,14,6,10,76,54,22,48
AaB,4693,5,7,13,10,38,43,-5,34
AC Horsens,4693,6,6,15,9,35,50,-15,33
Sonderjyske,4693,7,8,6,10,28,29,-1,30
Lyngby,4693,8,4,9,11,28,44,-16,21
Randers FC,4693,9,5,6,13,23,41,-18,21
AGF Aarhus,4693,10,5,6,11,18,36,-18,21
Silkeborg IF,4693,11,5,3,14,25,46,-21,18
Brondby,4694,1,22,5,3,74,29,45,71
FC Midtjylla,4694,2,21,4,5,64,36,28,67
Copenhagen,4694,3,14,4,12,58,44,14,46
FC Nords,4694,4,13,7,10,67,54,13,46
AaB,4694,5,8,12,10,38,41,-3,36
Sonderjyske,4694,6,8,6,10,28,29,-1,30
AC Horsens,4694,7,5,14,11,30,53,-23,29
Randers FC,4694,8,6,6,12,24,39,-15,24
Silkeborg IF,4694,9,5,4,13,26,45,-19,19
AGF Aarhus,4694,10,4,7,11,17,37,-20,19
Lyngby,4694,11,3,9,12,26,45,-19,18
Brondby,4695,1,21,5,4,70,30,40,68
FC Midtjylla,4695,2,20,5,5,67,39,28,65
FC Nords,4695,3,16,7,7,76,49,27,55
Copenhagen,4695,4,13,4,13,55,52,3,43
AaB,4695,5,7,12,11,36,45,-9,33
AC Horsens,4695,6,6,13,11,37,52,-15,31
Sonderjyske,4695,7,8,6,10,28,29,-1,30
Randers FC,4695,8,6,6,12,26,40,-14,24
Silkeborg IF,4695,9,6,3,13,29,46,-17,21
Lyngby,4695,10,3,9,12,27,47,-20,18
AGF Aarhus,4695,11,4,6,12,18,40,-22,18
Brondby,4696,1,19,8,3,69,34,35,65
FC Midtjylla,4696,2,18,5,7,63,42,21,59
FC Nords,4696,3,16,6,8,76,47,29,54
Copenhagen,4696,4,13,6,11,55,47,8,45
AC Horsens,4696,5,7,14,9,35,52,-17,35
AaB,4696,6,7,13,10,38,40,-2,34
Sonderjyske,4696,7,8,6,10,28,29,-1,30
Randers FC,4696,8,5,7,12,24,40,-16,22
Silkeborg IF,4696,9,6,3,13,28,44,-16,21
Lyngby,4696,10,3,10,11,27,45,-18,19
AGF Aarhus,4696,11,4,6,12,16,39,-23,18
Brondby,4697,1,20,7,3,68,31,37,67
FC Midtjylla,4697,2,19,6,5,67,41,26,63
FC Nords,4697,3,15,8,7,73,46,27,53
Copenhagen,4697,4,14,5,11,58,47,11,47
AaB,4697,5,7,12,11,38,44,-6,33
Sonderjyske,4697,6,8,6,10,28,29,-1,30
AC Horsens,4697,7,5,14,11,31,52,-21,29
Randers FC,4697,8,6,6,12,25,39,-14,24
AGF Aarhus,4697,9,5,6,11,19,36,-17,21
Lyngby,4697,10,3,9,12,26,46,-20,18
Silkeborg IF,4697,11,5,3,14,25,47,-22,18
Brondby,4698,1,21,5,4,66,32,34,68
FC Midtjylla,4698,2,21,4,5,66,36,30,67
FC Nords,4698,3,15,6,9,75,52,23,51
Copenhagen,4698,4,15,5,10,62,44,18,50
Sonderjyske,4698,5,8,6,10,28,29,-1,30
AaB,4698,6,6,12,12,36,48,-12,30
AC Horsens,4698,7,5,14,11,35,54,-19,29
Randers FC,4698,8,6,6,12,24,39,-15,24
AGF Aarhus,4698,9,5,6,11,18,37,-19,21
Lyngby,4698,10,3,9,12,26,45,-19,18
Silkeborg IF,4698,11,5,3,14,26,46,-20,18
Brondby,4699,1,21,6,3,77,33,44,69
FC Midtjylla,4699,2,20,5,5,67,40,27,65
FC Nords,4699,3,14,7,9,71,54,17,49
Copenhagen,4699,4,13,6,11,58,44,14,45
AaB,4699,5,7,13,10,34,45,-11,34
AC Horsens,4699,6,6,13,11,32,49,-17,31
Sonderjyske,4699,7,8,6,10,28,29,-1,30
Lyngby,4699,8,4,9,11,29,45,-16,21
Silkeborg IF,4699,9,6,3,13,26,44,-18,21
Randers FC,4699,10,5,6,13,24,42,-18,21
AGF Aarhus,4699,11,4,6,12,16,37,-21,18
FC Midtjylla,4700,1,21,4,5,78,39,39,67
Brondby,4700,2,19,7,4,70,39,31,64
FC Nords,4700,3,15,7,8,78,55,23,52
Copenhagen,4700,4,13,6,11,55,47,8,45
AC Horsens,4700,5,7,13,10,35,51,-16,34
AaB,4700,6,7,11,12,34,45,-11,32
Sonderjyske,4700,7,8,6,10,28,29,-1,30
Lyngby,4700,8,4,9,11,27,44,-17,21
Randers FC,4700,9,5,6,13,23,40,-17,21
Silkeborg IF,4700,10,6,3,13,27,45,-18,21
AGF Aarhus,4700,11,4,6,12,17,38,-21,18
Brondby,4701,1,22,6,2,72,32,40,72
FC Midtjylla,4701,2,20,5,5,64,38,26,65
Copenhagen,4701,3,14,4,12,56,44,12,46
FC Nords,4701,4,13,6,11,69,55,14,45
AaB,4701,5,8,12,10,44,41,3,36
AC Horsens,4701,6,6,13,11,36,57,-21,31
Sonderjyske,4701,7,8,6,10,28,29,-1,30
Randers FC,4701,8,6,6,12,24,39,-15,24
Silkeborg IF,4701,9,6,3,13,26,44,-18,21
Lyngby,4701,10,3,9,12,26,45,-19,18
AGF Aarhus,4701,11,4,6,12,16,37,-21,18
Brondby,4702,1,20,6,4,72,34,38,66
FC Midtjylla,4702,2,20,4,6,65,40,25,64
Copenhagen,4702,3,15,5,10,58,42,16,50
FC Nords,4702,4,14,7,9,70,47,23,49
AaB,4702,5,8,11,11,38,48,-10,35
AC Horsens,4702,6,6,13,11,35,53,-18,31
Sonderjyske,4702,7,8,6,10,28,29,-1,30
Randers FC,4702,8,5,7,12,23,39,-16,22
Silkeborg IF,4702,9,6,3,13,28,44,-16,21
Lyngby,4702,10,3,10,11,26,44,-18,19
AGF Aarhus,4702,11,4,6,12,16,39,-23,18
Brondby,4703,1,22,5,3,74,31,43,71
FC Midtjylla,4703,2,18,7,5,64,39,25,61
Copenhagen,4703,3,13,5,12,58,48,10,44
FC Nords,4703,4,12,7,11,67,55,12,43
AC Horsens,4703,5,8,14,8,36,48,-12,38
AaB,4703,6,8,12,10,35,39,-4,36
Sonderjyske,4703,7,8,6,10,28,29,-1,30
Lyngby,4703,8,4,9,11,27,44,-17,21
Randers FC,4703,9,5,6,13,23,40,-17,21
AGF Aarhus,4703,10,5,6,11,18,36,-18,21
Silkeborg IF,4703,11,5,3,14,25,46,-21,18
Brondby,4704,1,20,6,4,70,35,35,66
FC Midtjylla,4704,2,20,5,5,69,40,29,65
FC Nords,4704,3,13,7,10,71,55,16,46
Copenhagen,4704,4,13,6,11,57,46,11,45
AC Horsens,4704,5,7,15,8,41,53,-12,36
AaB,4704,6,7,13,10,37,42,-5,34
Sonderjyske,4704,7,8,6,10,28,29,-1,30
Lyngby,4704,8,4,9,11,27,44,-17,21
Randers FC,4704,9,5,6,13,23,40,-17,21
Silkeborg IF,4704,10,5,4,13,29,48,-19,19
AGF Aarhus,4704,11,4,7,11,20,40,-20,19
Brondby,4705,1,21,6,3,72,30,42,69
FC Midtjylla,4705,2,20,5,5,70,37,33,65
FC Nords,4705,3,15,6,9,74,55,19,51
Copenhagen,4705,4,13,5,12,58,49,9,44
AaB,4705,5,7,13,10,38,45,-7,34
AC Horsens,4705,6,6,13,11,32,54,-22,31
Sonderjyske,4705,7,8,6,10,28,29,-1,30
Randers FC,4705,8,6,6,12,26,41,-15,24
Silkeborg IF,4705,9,6,3,13,29,45,-16,21
Lyngby,4705,10,3,9,12,28,47,-19,18
AGF Aarhus,4705,11,4,6,12,17,40,-23,18
FC Midtjylla,4706,1,21,4,5,67,40,27,67
Brondby,4706,2,20,6,4,67,32,35,66
FC Nords,4706,3,13,8,9,72,51,21,47
Copenhagen,4706,4,14,5,11,58,44,14,47
AC Horsens,4706,5,7,13,10,36,52,-16,34
AaB,4706,6,7,12,11,35,42,-7,33
Sonderjyske,4706,7,8,6,10,28,29,-1,30
Lyngby,4706,8,4,9,11,31,45,-14,21
Randers FC,4706,9,5,6,13,24,44,-20,21
Silkeborg IF,4706,10,5,4,13,25,44,-19,19
AGF Aarhus,4706,11,4,7,11,16,36,-20,19
Brondby,4707,1,21,7,2,68,30,38,70
FC Midtjylla,4707,2,19,5,6,62,36,26,62
FC Nords,4707,3,15,7,8,74,45,29,52
Copenhagen,4707,4,13,5,12,56,48,8,44
AC Horsens,4707,5,7,13,10,35,54,-19,34
AaB,4707,6,6,13,11,35,43,-8,31
Sonderjyske,4707,7,8,6,10,28,29,-1,30
Lyngby,4707,8,4,9,11,28,45,-17,21
Silkeborg IF,4707,8,6,3,13,28,45,-17,21
Randers FC,4707,10,5,6,13,24,41,-17,21
AGF Aarhus,4707,11,4,6,12,17,39,-22,18
FC Midtjylla,4708,1,20,6,4,72,37,35,66
Brondby,4708,2,20,6,4,71,36,35,66
FC Nords,4708,3,14,7,9,72,53,19,49
Copenhagen,4708,4,14,6,10,57,44,13,48
AaB,4708,5,6,14,10,38,44,-6,32
Sonderjyske,4708,6,8,6,10,28,29,-1,30
AC Horsens,4708,7,5,15,10,36,58,-22,30
Lyngby,4708,8,4,9,11,28,45,-17,21
Randers FC,4708,9,5,6,13,24,41,-17,21
Silkeborg IF,4708,10,5,4,13,26,45,-19,19
AGF Aarhus,4708,11,4,7,11,17,37,-20,19
FC Midtjylla,4709,1,22,4,4,77,36,41,70
Brondby,4709,2,18,8,4,65,34,31,62
FC Nords,4709,3,14,7,9,72,51,21,49
Copenhagen,4709,4,13,5,12,55,48,7,44
AC Horsens,4709,5,8,13,9,38,53,-15,37
AaB,4709,6,7,11,12,35,46,-11,32
Sonderjyske,4709,7,8,6,10,28,29,-1,30
Randers FC,4709,8,6,6,12,25,40,-15,24
Silkeborg IF,4709,9,6,3,13,29,45,-16,21
Lyngby,4709,10,3,9,12,27,46,-19,18
AGF Aarhus,4709,11,4,6,12,17,40,-23,18
Brondby,4710,1,21,7,2,74,34,40,70
FC Midtjylla,4710,2,20,5,5,64,35,29,65
FC Nords,4710,3,13,9,8,72,50,22,48
Copenhagen,4710,4,13,6,11,56,45,11,45
AaB,4710,5,7,12,11,36,43,-7,33
AC Horsens,4710,6,6,13,11,36,57,-21,31
Sonderjyske,4710,7,8,6,10,28,29,-1,30
Randers FC,4710,8,5,7,12,25,41,-16,22
Silkeborg IF,4710,9,6,3,13,27,45,-18,21
Lyngby,4710,10,3,10,11,28,46,-18,19
AGF Aarhus,4710,11,4,6,12,17,38,-21,18
Brondby,4711,1,21,5,4,71,32,39,68
FC Midtjylla,4711,2,20,4,6,64,41,23,64
FC Nords,4711,3,16,6,8,75,52,23,54
Copenhagen,4711,4,16,4,10,60,40,20,52
Sonderjyske,4711,5,8,6,10,28,29,-1,30
AC Horsens,4711,6,6,12,12,34,53,-19,30
AaB,4711,7,6,11,13,37,49,-12,29
Randers FC,4711,8,5,7,12,24,40,-16,22
Silkeborg IF,4711,9,6,3,13,26,44,-18,21
Lyngby,4711,10,3,10,11,27,45,-18,19
AGF Aarhus,4711,11,4,6,12,16,37,-21,18
FC Midtjylla,4712,1,21,4,5,71,36,35,67
Brondby,4712,2,20,5,5,69,33,36,65
Copenhagen,4712,3,15,4,11,59,47,12,49
FC Nords,4712,4,13,6,11,69,56,13,45
AaB,4712,5,8,12,10,37,46,-9,36
AC Horsens,4712,6,7,13,10,38,51,-13,34
Sonderjyske,4712,7,8,6,10,28,29,-1,30
Lyngby,4712,8,4,9,11,28,45,-17,21
Randers FC,4712,9,5,6,13,24,41,-17,21
AGF Aarhus,4712,10,5,6,11,18,37,-19,21
Silkeborg IF,4712,11,5,3,14,26,46,-20,18
Brondby,4713,1,21,6,3,76,37,39,69
FC Midtjylla,4713,2,20,5,5,66,39,27,65
Copenhagen,4713,3,14,5,11,60,49,11,47
FC Nords,4713,4,12,8,10,73,56,17,44
AaB,4713,5,8,13,9,38,40,-2,37
Sonderjyske,4713,6,8,6,10,28,29,-1,30
AC Horsens,4713,7,5,15,10,33,51,-18,30
Randers FC,4713,8,5,7,12,24,40,-16,22
Lyngby,4713,9,3,10,11,27,45,-18,19
Silkeborg IF,4713,10,5,4,13,25,44,-19,19
AGF Aarhus,4713,11,4,7,11,16,36,-20,19
Brondby,4714,1,22,6,2,75,32,43,72
FC Midtjylla,4714,2,19,5,6,66,41,25,62
FC Nords,4714,3,13,8,9,72,52,20,47
Copenhagen,4714,4,14,5,11,59,46,13,47
AaB,4714,5,7,12,11,35,45,-10,33
AC Horsens,4714,6,6,14,10,36,53,-17,32
Sonderjyske,4714,7,8,6,10,28,29,-1,30
Lyngby,4714,8,4,9,11,28,44,-16,21
Randers FC,4714,9,5,6,13,23,41,-18,21
AGF Aarhus,4714,10,5,6,11,17,36,-19,21
Silkeborg IF,4714,11,5,3,14,25,45,-20,18
Brondby,4715,1,21,5,4,71,32,39,68
FC Midtjylla,4715,2,20,4,6,65,38,27,64
Copenhagen,4715,3,17,4,9,60,40,20,55
FC Nords,4715,4,12,7,11,70,56,14,43
AaB,4715,5,8,11,11,37,44,-7,35
AC Horsens,4715,6,6,13,11,34,53,-19,31
Sonderjyske,4715,7,8,6,10,28,29,-1,30
Randers FC,4715,8,5,7,12,23,39,-16,22
Silkeborg IF,4715,9,6,3,13,26,44,-18,21
Lyngby,4715,10,3,10,11,26,44,-18,19
AGF Aarhus,4715,11,4,6,12,16,37,-21,18
Brondby,4716,1,21,6,3,74,32,42,69
FC Midtjylla,4716,2,20,5,5,64,39,25,65
Copenhagen,4716,3,15,4,11,61,45,16,49
FC Nords,4716,4,13,7,10,71,55,16,46
AaB,4716,5,7,12,11,34,41,-7,33
AC Horsens,4716,6,6,14,10,33,51,-18,32
Sonderjyske,4716,7,8,6,10,28,29,-1,30
Randers FC,4716,8,6,6,12,25,40,-15,24
AGF Aarhus,4716,9,5,6,11,18,36,-18,21
Lyngby,4716,10,3,9,12,27,46,-19,18
Silkeborg IF,4716,11,5,3,14,25,46,-21,18
Brondby,4717,1,20,7,3,69,34,35,67
FC Midtjylla,4717,2,19,6,5,62,38,24,63
Copenhagen,4717,3,16,4,10,62,45,17,52
FC Nords,4717,4,14,7,9,74,50,24,49
AaB,4717,5,6,13,11,32,40,-8,31
AC Horsens,4717,6,6,13,11,36,54,-18,31
Sonderjyske,4717,7,8,6,10,28,29,-1,30
Lyngby,4717,8,4,9,11,28,44,-16,21
Silkeborg IF,4717,9,6,3,13,27,44,-17,21
Randers FC,4717,10,5,6,13,23,41,-18,21
AGF Aarhus,4717,11,4,6,12,16,38,-22,18
Brondby,4718,1,22,5,3,74,30,44,71
FC Midtjylla,4718,2,20,4,6,71,43,28,64
FC Nords,4718,3,15,7,8,78,51,27,52
Copenhagen,4718,4,13,6,11,58,45,13,45
AC Horsens,4718,5,7,12,11,34,57,-23,33
Sonderjyske,4718,6,8,6,10,28,29,-1,30
AaB,4718,7,6,12,12,37,52,-15,30
Lyngby,4718,8,4,9,11,28,44,-16,21
Randers FC,4718,9,5,6,13,23,41,-18,21
AGF Aarhus,4718,10,5,6,11,17,36,-19,21
Silkeborg IF,4718,11,5,3,14,25,45,-20,18
Brondby,4719,1,22,5,3,78,36,42,71
FC Midtjylla,4719,2,20,5,5,70,41,29,65
FC Nords,4719,3,14,6,10,74,56,18,48
Copenhagen,4719,4,14,5,11,56,44,12,47
AaB,4719,5,8,11,11,38,45,-7,35
Sonderjyske,4719,6,8,6,10,28,29,-1,30
AC Horsens,4719,7,6,12,12,37,57,-20,30
Lyngby,4719,8,4,9,11,28,44,-16,21
Randers FC,4719,9,5,6,13,23,41,-18,21
AGF Aarhus,4719,10,5,6,11,18,37,-19,21
Silkeborg IF,4719,11,5,3,14,26,46,-20,18
Brondby,4720,1,21,6,3,74,32,42,69
FC Midtjylla,4720,2,20,4,6,66,43,23,64
Copenhagen,4720,3,16,4,10,62,43,19,52
FC Nords,4720,4,13,7,10,70,57,13,46
AaB,4720,5,7,12,11,38,45,-7,33
AC Horsens,4720,6,6,13,11,34,50,-16,31
Sonderjyske,4720,7,8,6,10,28,29,-1,30
Randers FC,4720,8,6,6,12,25,39,-14,24
Silkeborg IF,4720,9,6,3,13,28,45,-17,21
Lyngby,4720,10,3,9,12,26,46,-20,18
AGF Aarhus,4720,11,4,6,12,17,39,-22,18
Brondby,4721,1,21,6,3,71,31,40,69
FC Midtjylla,4721,2,20,5,5,68,39,29,65
FC Nords,4721,3,15,6,9,73,51,22,51
Copenhagen,4721,4,15,5,10,60,41,19,50
Sonderjyske,4721,5,8,6,10,28,29,-1,30
AaB,4721,6,6,12,12,33,46,-13,30
AC Horsens,4721,7,6,12,12,34,57,-23,30
Randers FC,4721,8,6,6,12,24,39,-15,24
Silkeborg IF,4721,9,6,3,13,28,46,-18,21
Lyngby,4721,10,3,9,12,26,45,-19,18
AGF Aarhus,4721,11,4,6,12,18,39,-21,18
Brondby,4722,1,22,6,2,71,28,43,72
FC Midtjylla,4722,2,19,4,7,66,45,21,61
FC Nords,4722,3,16,6,8,73,48,25,54
Copenhagen,4722,4,13,5,12,55,45,10,44
AC Horsens,4722,5,6,14,10,35,53,-18,32
AaB,4722,6,6,13,11,37,44,-7,31
Sonderjyske,4722,7,8,6,10,28,29,-1,30
Randers FC,4722,8,5,7,12,24,40,-16,22
AGF Aarhus,4722,9,5,6,11,18,37,-19,21
Lyngby,4722,10,3,10,11,27,45,-18,19
Silkeborg IF,4722,11,5,3,14,26,46,-20,18
Brondby,4723,1,20,6,4,69,34,35,66
FC Midtjylla,4723,2,20,4,6,66,40,26,64
FC Nords,4723,3,16,7,7,83,48,35,55
Copenhagen,4723,4,14,7,9,57,42,15,49
Sonderjyske,4723,5,8,6,10,28,29,-1,30
AaB,4723,6,6,12,12,36,46,-10,30
AC Horsens,4723,7,5,14,11,30,57,-27,29
Randers FC,4723,8,6,6,12,27,41,-14,24
Silkeborg IF,4723,9,6,3,13,27,45,-18,21
Lyngby,4723,10,3,9,12,28,48,-20,18
AGF Aarhus,4723,11,4,6,12,17,38,-21,18
Brondby,4724,1,23,5,2,80,31,49,74
FC Midtjylla,4724,2,19,4,7,64,41,23,61
FC Nords,4724,3,14,7,9,72,51,21,49
Copenhagen,4724,4,15,4,11,58,44,14,49
AaB,4724,5,8,11,11,37,44,-7,35
Sonderjyske,4724,6,8,6,10,28,29,-1,30
AC Horsens,4724,7,5,13,12,31,57,-26,28
Lyngby,4724,8,4,9,11,28,45,-17,21
Randers FC,4724,9,5,6,13,24,41,-17,21
AGF Aarhus,4724,10,5,6,11,18,37,-19,21
Silkeborg IF,4724,11,5,3,14,26,46,-20,18
Brondby,4725,1,22,5,3,75,34,41,71
FC Midtjylla,4725,2,20,4,6,64,42,22,64
FC Nords,4725,3,15,7,8,77,48,29,52
Copenhagen,4725,4,13,5,12,56,49,7,44
AaB,4725,5,7,14,9,38,43,-5,35
Sonderjyske,4725,6,8,6,10,28,29,-1,30
AC Horsens,4725,7,5,13,12,36,56,-20,28
Lyngby,4725,8,4,9,11,29,44,-15,21
Silkeborg IF,4725,9,6,3,13,27,44,-17,21
Randers FC,4725,10,5,6,13,23,42,-19,21
AGF Aarhus,4725,11,4,6,12,16,38,-22,18
Brondby,4726,1,20,6,4,68,36,32,66
FC Midtjylla,4726,2,19,6,5,67,42,25,63
FC Nords,4726,3,13,9,8,75,54,21,48
Copenhagen,4726,4,13,6,11,53,43,10,45
AaB,4726,5,8,12,10,42,41,1,36
AC Horsens,4726,6,7,13,10,39,54,-15,34
Sonderjyske,4726,7,8,6,10,28,29,-1,30
Lyngby,4726,8,4,9,11,28,45,-17,21
Randers FC,4726,9,5,6,13,24,41,-17,21
Silkeborg IF,4726,10,6,3,13,26,44,-18,21
AGF Aarhus,4726,11,4,6,12,16,37,-21,18
Brondby,4727,1,20,6,4,68,32,36,66
FC Midtjylla,4727,2,20,4,6,63,36,27,64
FC Nords,4727,3,14,7,9,72,54,18,49
Copenhagen,4727,4,14,5,11,55,43,12,47
AaB,4727,5,8,11,11,41,44,-3,35
AC Horsens,4727,6,6,15,9,35,51,-16,33
Sonderjyske,4727,7,8,6,10,28,29,-1,30
Silkeborg IF,4727,8,6,3,13,28,44,-16,21
Lyngby,4727,9,4,9,11,29,46,-17,21
Randers FC,4727,10,5,6,13,25,42,-17,21
AGF Aarhus,4727,11,4,6,12,16,39,-23,18
Brondby,4728,1,21,7,2,72,31,41,70
FC Midtjylla,4728,2,18,6,6,66,43,23,60
FC Nords,4728,3,15,6,9,73,48,25,51
Copenhagen,4728,4,12,6,12,57,50,7,42
AaB,4728,5,8,13,9,35,40,-5,37
AC Horsens,4728,6,6,14,10,37,54,-17,32
Sonderjyske,4728,7,8,6,10,28,29,-1,30
Randers FC,4728,8,5,7,12,24,40,-16,22
Lyngby,4728,9,3,10,11,27,45,-18,19
Silkeborg IF,4728,10,5,4,13,27,46,-19,19
AGF Aarhus,4728,11,4,7,11,18,38,-20,19
Brondby,4729,1,20,7,3,70,32,38,67
FC Midtjylla,4729,2,20,6,4,66,37,29,66
Copenhagen,4729,3,15,5,10,57,41,16,50
FC Nords,4729,4,14,7,9,73,52,21,49
AC Horsens,4729,5,6,13,11,36,53,-17,31
Sonderjyske,4729,6,8,6,10,28,29,-1,30
AaB,4729,7,6,12,12,33,46,-13,30
Lyngby,4729,8,4,9,11,28,44,-16,21
Randers FC,4729,9,5,6,13,23,41,-18,21
Silkeborg IF,4729,10,5,4,13,26,45,-19,19
AGF Aarhus,4729,11,4,7,11,17,37,-20,19
Brondby,4730,1,20,6,4,69,33,36,66
FC Midtjylla,4730,2,20,4,6,68,38,30,64
FC Nords,4730,3,14,7,9,75,53,22,49
Copenhagen,4730,4,14,5,11,56,44,12,47
AaB,4730,5,7,13,10,36,41,-5,34
AC Horsens,4730,6,7,13,10,36,57,-21,34
Sonderjyske,4730,7,8,6,10,28,29,-1,30
Lyngby,4730,8,4,9,11,27,44,-17,21
Randers FC,4730,9,5,6,13,23,40,-17,21
AGF Aarhus,4730,10,5,6,11,18,37,-19,21
Silkeborg IF,4730,11,5,3,14,26,46,-20,18
Brondby,4731,1,20,7,3,68,32,36,67
FC Midtjylla,4731,2,18,6,6,62,38,24,60
FC Nords,4731,3,14,7,9,70,50,20,49
Copenhagen,4731,4,15,4,11,59,45,14,49
AaB,4731,5,10,12,8,43,39,4,42
Sonderjyske,4731,6,8,6,10,28,29,-1,30
AC Horsens,4731,7,5,12,13,30,54,-24,27
Lyngby,4731,8,4,9,11,29,45,-16,21
AGF Aarhus,4731,9,5,6,11,19,36,-17,21
Randers FC,4731,10,5,6,13,24,42,-18,21
Silkeborg IF,4731,11,5,3,14,25,47,-22,18
Brondby,4732,1,21,6,3,72,32,40,69
FC Midtjylla,4732,2,20,6,4,67,37,30,66
FC Nords,4732,3,15,6,9,76,53,23,51
Copenhagen,4732,4,13,4,13,55,49,6,43
AaB,4732,5,8,11,11,37,42,-5,35
AC Horsens,4732,6,6,13,11,34,54,-20,31
Sonderjyske,4732,7,8,6,10,28,29,-1,30
Randers FC,4732,8,5,7,12,23,39,-16,22
Silkeborg IF,4732,9,6,3,13,29,44,-15,21
Lyngby,4732,10,3,10,11,26,44,-18,19
AGF Aarhus,4732,11,4,6,12,16,40,-24,18
Brondby,4733,1,22,6,2,77,32,45,72
FC Midtjylla,4733,2,18,6,6,68,42,26,60
FC Nords,4733,3,14,8,8,79,57,22,50
Copenhagen,4733,4,13,5,12,59,47,12,44
AaB,4733,5,8,13,9,41,45,-4,37
Sonderjyske,4733,6,8,6,10,28,29,-1,30
AC Horsens,4733,7,6,12,12,33,60,-27,30
Randers FC,4733,8,6,6,12,24,39,-15,24
AGF Aarhus,4733,9,5,6,11,19,37,-18,21
Lyngby,4733,10,3,9,12,26,45,-19,18
Silkeborg IF,4733,11,5,3,14,26,47,-21,18
Brondby,4734,1,21,6,3,71,34,37,69
FC Midtjylla,4734,2,19,5,6,66,39,27,62
FC Nords,4734,3,13,9,8,74,50,24,48
Copenhagen,4734,4,14,5,11,56,42,14,47
AaB,4734,5,7,13,10,39,45,-6,34
AC Horsens,4734,6,7,12,11,36,58,-22,33
Sonderjyske,4734,7,8,6,10,28,29,-1,30
Lyngby,4734,8,4,9,11,28,44,-16,21
Randers FC,4734,9,5,6,13,23,41,-18,21
Silkeborg IF,4734,10,5,4,13,26,45,-19,19
AGF Aarhus,4734,11,4,7,11,17,37,-20,19
Brondby,4735,1,21,5,4,73,34,39,68
FC Midtjylla,4735,2,20,4,6,68,40,28,64
Copenhagen,4735,3,16,5,9,66,47,19,53
FC Nords,4735,4,13,7,10,71,56,15,46
AaB,4735,5,7,12,11,38,46,-8,33
AC Horsens,4735,6,6,13,11,36,55,-19,31
Sonderjyske,4735,7,8,6,10,28,29,-1,30
Randers FC,4735,8,6,6,12,24,39,-15,24
Silkeborg IF,4735,9,5,4,13,27,46,-19,19
AGF Aarhus,4735,10,4,7,11,18,38,-20,19
Lyngby,4735,11,3,9,12,26,45,-19,18
FC Midtjylla,4736,1,20,5,5,70,39,31,65
Brondby,4736,2,19,7,4,73,39,34,64
FC Nords,4736,3,15,6,9,73,51,22,51
Copenhagen,4736,4,14,5,11,56,45,11,47
AC Horsens,4736,5,7,13,10,34,53,-19,34
AaB,4736,6,7,12,11,37,42,-5,33
Sonderjyske,4736,7,8,6,10,28,29,-1,30
Lyngby,4736,8,4,9,11,28,45,-17,21
Randers FC,4736,9,5,6,13,24,41,-17,21
Silkeborg IF,4736,10,5,4,13,25,44,-19,19
AGF Aarhus,4736,11,4,7,11,16,36,-20,19
Brondby,4737,1,22,5,3,67,28,39,71
FC Midtjylla,4737,2,19,5,6,61,37,24,62
FC Nords,4737,3,14,7,9,72,49,23,49
Copenhagen,4737,4,12,5,13,52,45,7,41
AaB,4737,5,8,12,10,36,44,-8,36
AC Horsens,4737,6,8,12,10,40,51,-11,36
Sonderjyske,4737,7,8,6,10,28,29,-1,30
Randers FC,4737,8,6,6,12,24,39,-15,24
Silkeborg IF,4737,9,5,4,13,26,45,-19,19
AGF Aarhus,4737,10,4,7,11,17,37,-20,19
Lyngby,4737,11,3,9,12,26,45,-19,18
Brondby,4738,1,19,8,3,70,35,35,65
FC Midtjylla,4738,2,19,4,7,63,44,19,61
Copenhagen,4738,3,15,6,9,61,40,21,51
FC Nords,4738,4,14,7,9,72,54,18,49
AC Horsens,4738,5,7,14,9,36,47,-11,35
AaB,4738,6,6,13,11,35,43,-8,31
Sonderjyske,4738,7,8,6,10,28,29,-1,30
Randers FC,4738,8,5,7,12,24,40,-16,22
Silkeborg IF,4738,9,6,3,13,27,44,-17,21
Lyngby,4738,10,3,10,11,27,45,-18,19
AGF Aarhus,4738,11,4,6,12,16,38,-22,18
Brondby,4739,1,22,6,2,71,29,42,72
FC Midtjylla,4739,2,19,4,7,63,40,23,61
FC Nords,4739,3,14,6,10,73,50,23,48
Copenhagen,4739,4,13,4,13,56,47,9,43
AaB,4739,5,9,12,9,38,42,-4,39
AC Horsens,4739,6,7,12,11,35,54,-19,33
Sonderjyske,4739,7,8,6,10,28,29,-1,30
Lyngby,4739,8,4,9,11,31,45,-14,21
Silkeborg IF,4739,9,6,3,13,28,46,-18,21
Randers FC,4739,10,5,6,13,24,44,-20,21
AGF Aarhus,4739,11,4,6,12,18,39,-21,18
Brondby,4740,1,20,6,4,69,34,35,66
FC Midtjylla,4740,2,20,4,6,63,38,25,64
FC Nords,4740,3,14,7,9,70,51,19,49
Copenhagen,4740,4,13,4,13,54,47,7,43
AaB,4740,5,9,11,10,41,40,1,38
AC Horsens,4740,6,7,14,9,37,50,-13,35
Sonderjyske,4740,7,8,6,10,28,29,-1,30
Randers FC,4740,8,5,7,12,23,39,-16,22
Lyngby,4740,9,3,10,11,26,44,-18,19
Silkeborg IF,4740,10,5,4,13,27,46,-19,19
AGF Aarhus,4740,11,4,7,11,18,38,-20,19
Brondby,4741,1,21,5,4,70,31,39,68
FC Midtjylla,4741,2,20,4,6,65,40,25,64
Copenhagen,4741,3,16,5,9,61,41,20,53
FC Nords,4741,4,13,7,10,72,53,19,46
AaB,4741,5,7,12,11,36,46,-10,33
AC Horsens,4741,6,6,13,11,33,52,-19,31
Sonderjyske,4741,7,8,6,10,28,29,-1,30
Lyngby,4741,8,4,9,11,30,47,-17,21
Randers FC,4741,9,5,6,13,26,43,-17,21
Silkeborg IF,4741,10,6,3,13,28,46,-18,21
AGF Aarhus,4741,11,4,6,12,18,39,-21,18
Brondby,4742,1,19,6,5,71,35,36,63
FC Midtjylla,4742,2,19,6,5,64,37,27,63
FC Nords,4742,3,14,7,9,71,51,20,49
Copenhagen,4742,4,15,4,11,57,44,13,49
AaB,4742,5,9,12,9,38,42,-4,39
Sonderjyske,4742,6,8,6,10,28,29,-1,30
AC Horsens,4742,7,5,15,10,34,52,-18,30
Lyngby,4742,8,4,9,11,27,44,-17,21
Randers FC,4742,9,5,6,13,23,40,-17,21
Silkeborg IF,4742,10,6,3,13,27,45,-18,21
AGF Aarhus,4742,11,4,6,12,17,38,-21,18
Brondby,4743,1,22,6,2,71,31,40,72
FC Midtjylla,4743,2,19,5,6,67,42,25,62
Copenhagen,4743,3,14,7,9,62,46,16,49
FC Nords,4743,4,13,7,10,75,55,20,46
AaB,4743,5,9,11,10,41,41,0,38
Sonderjyske,4743,6,8,6,10,28,29,-1,30
AC Horsens,4743,7,5,12,13,34,61,-27,27
Lyngby,4743,8,4,9,11,28,45,-17,21
Randers FC,4743,9,5,6,13,24,41,-17,21
Silkeborg IF,4743,10,5,4,13,26,45,-19,19
AGF Aarhus,4743,11,4,7,11,17,37,-20,19
Brondby,4744,1,21,5,4,73,36,37,68
FC Midtjylla,4744,2,19,5,6,65,40,25,62
Copenhagen,4744,3,15,5,10,61,47,14,50
FC Nords,4744,4,14,7,9,73,52,21,49
AaB,4744,5,9,11,10,39,43,-4,38
Sonderjyske,4744,6,8,6,10,28,29,-1,30
AC Horsens,4744,7,5,13,12,35,54,-19,28
Lyngby,4744,8,4,9,11,28,44,-16,21
Silkeborg IF,4744,9,6,3,13,27,44,-17,21
Randers FC,4744,10,5,6,13,23,41,-18,21
AGF Aarhus,4744,11,4,6,12,16,38,-22,18
FC Midtjylla,4745,1,21,4,5,67,38,29,67
Brondby,4745,2,20,5,5,65,32,33,65
FC Nords,4745,3,15,7,8,72,50,22,52
Copenhagen,4745,4,13,5,12,58,46,12,44
AaB,4745,5,8,11,11,36,43,-7,35
AC Horsens,4745,6,7,12,11,38,53,-15,33
Sonderjyske,4745,7,8,6,10,28,29,-1,30
Randers FC,4745,8,5,7,12,24,40,-16,22
Silkeborg IF,4745,9,6,3,13,30,45,-15,21
Lyngby,4745,10,3,10,11,27,45,-18,19
AGF Aarhus,4745,11,4,6,12,17,41,-24,18
Brondby,4746,1,20,8,2,70,30,40,68
FC Midtjylla,4746,2,21,5,4,65,36,29,68
FC Nords,4746,3,14,6,10,76,55,21,48
Copenhagen,4746,4,13,6,11,55,44,11,45
AaB,4746,5,7,11,12,35,43,-8,32
AC Horsens,4746,6,6,14,10,33,52,-19,32
Sonderjyske,4746,7,8,6,10,28,29,-1,30
Randers FC,4746,8,6,6,12,24,39,-15,24
AGF Aarhus,4746,9,5,6,11,18,37,-19,21
Lyngby,4746,10,3,9,12,26,45,-19,18
Silkeborg IF,4746,11,5,3,14,26,46,-20,18
Brondby,4747,1,20,7,3,69,33,36,67
FC Midtjylla,4747,2,19,5,6,64,40,24,62
FC Nords,4747,3,15,7,8,75,47,28,52
Copenhagen,4747,4,14,5,11,57,48,9,47
AC Horsens,4747,5,7,13,10,35,49,-14,34
AaB,4747,6,6,13,11,33,42,-9,31
Sonderjyske,4747,7,8,6,10,28,29,-1,30
Lyngby,4747,8,4,9,11,27,44,-17,21
Randers FC,4747,9,5,6,13,23,40,-17,21
AGF Aarhus,4747,10,5,6,11,17,36,-19,21
Silkeborg IF,4747,11,5,3,14,25,45,-20,18
Brondby,4748,1,22,5,3,72,28,44,71
FC Midtjylla,4748,2,20,5,5,65,37,28,65
Copenhagen,4748,3,14,5,11,56,48,8,47
FC Nords,4748,4,13,6,11,73,56,17,45
AaB,4748,5,8,11,11,38,44,-6,35
AC Horsens,4748,6,7,12,11,38,55,-17,33
Sonderjyske,4748,7,8,6,10,28,29,-1,30
Lyngby,4748,8,4,9,11,28,44,-16,21
Silkeborg IF,4748,9,6,3,13,29,46,-17,21
Randers FC,4748,10,5,6,13,23,41,-18,21
AGF Aarhus,4748,11,4,6,12,18,40,-22,18
Brondby,4749,1,18,8,4,67,34,33,62
FC Midtjylla,4749,2,17,7,6,60,39,21,58
FC Nords,4749,3,14,8,8,76,53,23,50
Copenhagen,4749,4,14,7,9,58,43,15,49
AaB,4749,5,9,13,8,37,36,1,40
AC Horsens,4749,6,6,13,11,35,54,-19,31
Sonderjyske,4749,7,8,6,10,28,29,-1,30
Lyngby,4749,8,4,9,11,28,44,-16,21
Silkeborg IF,4749,9,6,3,13,27,45,-18,21
Randers FC,4749,10,5,6,13,23,41,-18,21
AGF Aarhus,4749,11,4,6,12,17,38,-21,18
FC Midtjylla,4750,1,20,4,6,68,41,27,64
Brondby,4750,2,19,6,5,69,35,34,63
FC Nords,4750,3,14,7,9,73,51,22,49
Copenhagen,4750,4,14,5,11,56,45,11,47
AaB,4750,5,9,12,9,40,44,-4,39
AC Horsens,4750,6,6,14,10,34,50,-16,32
Sonderjyske,4750,7,8,6,10,28,29,-1,30
Randers FC,4750,8,5,7,12,23,39,-16,22
AGF Aarhus,4750,9,5,6,11,18,37,-19,21
Lyngby,4750,10,3,10,11,26,44,-18,19
Silkeborg IF,4750,11,5,3,14,26,46,-20,18
Brondby,4751,1,21,6,3,69,30,39,69
FC Midtjylla,4751,2,19,5,6,65,44,21,62
FC Nords,4751,3,14,7,9,71,51,20,49
Copenhagen,4751,4,14,4,12,61,47,14,46
AC Horsens,4751,5,7,14,9,37,51,-14,35
AaB,4751,6,7,12,11,36,42,-6,33
Sonderjyske,4751,7,8,6,10,28,29,-1,30
Randers FC,4751,8,5,7,12,24,40,-16,22
Silkeborg IF,4751,9,6,3,13,27,44,-17,21
Lyngby,4751,10,3,10,11,27,45,-18,19
AGF Aarhus,4751,11,4,6,12,16,38,-22,18
Brondby,4752,1,19,6,5,66,36,30,63
FC Midtjylla,4752,2,19,4,7,61,45,16,61
FC Nords,4752,3,15,7,8,77,50,27,52
Copenhagen,4752,4,15,4,11,62,44,18,49
AC Horsens,4752,5,8,12,10,38,51,-13,36
AaB,4752,6,7,13,10,38,42,-4,34
Sonderjyske,4752,7,8,6,10,28,29,-1,30
Lyngby,4752,8,4,9,11,28,45,-17,21
Randers FC,4752,9,5,6,13,24,41,-17,21
AGF Aarhus,4752,10,5,6,11,18,37,-19,21
Silkeborg IF,4752,11,5,3,14,26,46,-20,18
FC Midtjylla,4753,1,20,5,5,66,39,27,65
Brondby,4753,2,19,5,6,69,40,29,62
FC Nords,4753,3,15,7,8,79,49,30,52
Copenhagen,4753,4,13,5,12,61,49,12,44
AaB,4753,5,10,11,9,40,42,-2,41
AC Horsens,4753,6,6,13,11,34,56,-22,31
Sonderjyske,4753,7,8,6,10,28,29,-1,30
Lyngby,4753,8,4,9,11,29,44,-15,21
Randers FC,4753,9,5,6,13,23,42,-19,21
Silkeborg IF,4753,10,5,4,13,26,45,-19,19
AGF Aarhus,4753,11,4,7,11,17,37,-20,19
FC Midtjylla,4754,1,21,4,5,70,34,36,67
Brondby,4754,2,20,6,4,67,32,35,66
Copenhagen,4754,3,16,4,10,58,41,17,52
FC Nords,4754,4,13,7,10,70,52,18,46
AaB,4754,5,8,11,11,36,45,-9,35
Sonderjyske,4754,6,8,6,10,28,29,-1,30
AC Horsens,4754,7,6,12,12,31,54,-23,30
Randers FC,4754,8,5,7,12,25,41,-16,22
AGF Aarhus,4754,9,5,6,11,17,36,-19,21
Lyngby,4754,10,3,10,11,28,46,-18,19
Silkeborg IF,4754,11,5,3,14,25,45,-20,18
Brondby,4755,1,22,5,3,70,28,42,71
FC Midtjylla,4755,2,19,5,6,65,41,24,62
FC Nords,4755,3,13,7,10,70,52,18,46
Copenhagen,4755,4,13,5,12,56,44,12,44
AaB,4755,5,10,11,9,42,41,1,41
AC Horsens,4755,6,6,13,11,34,57,-23,31
Sonderjyske,4755,7,8,6,10,28,29,-1,30
Lyngby,4755,8,4,9,11,28,45,-17,21
Randers FC,4755,9,5,6,13,24,41,-17,21
Silkeborg IF,4755,10,5,4,13,25,44,-19,19
AGF Aarhus,4755,11,4,7,11,16,36,-20,19
Brondby,4756,1,21,6,3,71,36,35,69
FC Midtjylla,4756,2,20,6,4,67,38,29,66
FC Nords,4756,3,14,8,8,78,49,29,50
Copenhagen,4756,4,12,6,12,54,47,7,42
AaB,4756,5,8,12,10,38,42,-4,36
Sonderjyske,4756,6,8,6,10,28,29,-1,30
AC Horsens,4756,7,6,12,12,34,56,-22,30
Lyngby,4756,8,4,9,11,30,44,-14,21
Silkeborg IF,4756,9,6,3,13,27,45,-18,21
Randers FC,4756,10,5,6,13,23,43,-20,21
AGF Aarhus,4756,11,4,6,12,17,38,-21,18
Brondby,4757,1,22,6,2,71,32,39,72
FC Midtjylla,4757,2,18,6,6,64,41,23,60
FC Nords,4757,3,15,7,8,73,48,25,52
Copenhagen,4757,4,14,6,10,61,44,17,48
AaB,4757,5,6,13,11,34,42,-8,31
Sonderjyske,4757,6,8,6,10,28,29,-1,30
AC Horsens,4757,7,5,14,11,37,59,-22,29
Randers FC,4757,8,6,6,12,24,39,-15,24
Silkeborg IF,4757,9,6,3,13,28,45,-17,21
Lyngby,4757,10,3,9,12,26,45,-19,18
AGF Aarhus,4757,11,4,6,12,17,39,-22,18
Brondby,4758,1,20,8,2,74,36,38,68
FC Midtjylla,4758,2,19,5,6,71,42,29,62
Copenhagen,4758,3,13,6,11,59,45,14,45
FC Nords,4758,4,12,8,10,72,62,10,44
AC Horsens,4758,5,8,14,8,38,48,-10,38
AaB,4758,6,6,15,9,39,46,-7,33
Sonderjyske,4758,7,8,6,10,28,29,-1,30
Randers FC,4758,8,5,7,12,24,40,-16,22
AGF Aarhus,4758,9,5,6,11,21,36,-15,21
Lyngby,4758,10,3,10,11,27,45,-18,19
Silkeborg IF,4758,11,5,3,14,25,49,-24,18
Brondby,4759,1,21,5,4,72,36,36,68
FC Midtjylla,4759,2,18,6,6,63,39,24,60
FC Nords,4759,3,14,8,8,79,54,25,50
Copenhagen,4759,4,15,5,10,61,42,19,50
AaB,4759,5,7,13,10,36,43,-7,34
AC Horsens,4759,6,6,13,11,33,56,-23,31
Sonderjyske,4759,7,8,6,10,28,29,-1,30
Randers FC,4759,8,6,6,12,25,40,-15,24
AGF Aarhus,4759,9,5,6,11,18,37,-19,21
Lyngby,4759,10,3,9,12,27,46,-19,18
Silkeborg IF,4759,11,5,3,14,26,46,-20,18
Brondby,4760,1,21,6,3,70,32,38,69
FC Midtjylla,4760,2,21,5,4,69,37,32,68
FC Nords,4760,3,15,7,8,73,47,26,52
Copenhagen,4760,4,12,6,12,55,47,8,42
AaB,4760,5,7,11,12,34,47,-13,32
AC Horsens,4760,6,6,13,11,37,54,-17,31
Sonderjyske,4760,7,8,6,10,28,29,-1,30
Lyngby,4760,8,4,9,11,28,45,-17,21
Randers FC,4760,9,5,6,13,24,41,-17,21
AGF Aarhus,4760,10,5,6,11,18,37,-19,21
Silkeborg IF,4760,11,5,3,14,26,46,-20,18
Brondby,4761,1,21,6,3,68,32,36,69
FC Midtjylla,4761,2,20,5,5,64,35,29,65
FC Nords,4761,3,13,8,9,78,54,24,47
Copenhagen,4761,4,13,6,11,57,47,10,45
AaB,4761,5,7,13,10,40,46,-6,34
AC Horsens,4761,6,6,14,10,34,53,-19,32
Sonderjyske,4761,7,8,6,10,28,29,-1,30
Lyngby,4761,8,4,9,11,31,45,-14,21
Silkeborg IF,4761,9,6,3,13,27,44,-17,21
Randers FC,4761,10,5,6,13,24,44,-20,21
AGF Aarhus,4761,11,4,6,12,16,38,-22,18
Brondby,4762,1,20,7,3,73,31,42,67
FC Midtjylla,4762,2,20,6,4,63,36,27,66
FC Nords,4762,3,14,7,9,73,59,14,49
Copenhagen,4762,4,13,4,13,56,46,10,43
AaB,4762,5,8,11,11,39,45,-6,35
AC Horsens,4762,6,7,13,10,38,51,-13,34
Sonderjyske,4762,7,8,6,10,28,29,-1,30
Lyngby,4762,8,4,9,11,28,45,-17,21
Randers FC,4762,9,5,6,13,24,41,-17,21
Silkeborg IF,4762,10,6,3,13,26,44,-18,21
AGF Aarhus,4762,11,4,6,12,16,37,-21,18
Brondby,4763,1,23,5,2,77,35,42,74
FC Midtjylla,4763,2,18,5,7,68,44,24,59
FC Nords,4763,3,14,6,10,71,53,18,48
Copenhagen,4763,4,13,6,11,58,46,12,45
AaB,4763,5,8,12,10,41,44,-3,36
AC Horsens,4763,6,7,12,11,41,60,-19,33
Sonderjyske,4763,7,8,6,10,28,29,-1,30
Lyngby,4763,8,4,9,11,27,44,-17,21
Randers FC,4763,9,5,6,13,23,40,-17,21
Silkeborg IF,4763,10,5,4,13,26,45,-19,19
AGF Aarhus,4763,11,4,7,11,17,37,-20,19
Brondby,4764,1,21,6,3,73,28,45,69
FC Midtjylla,4764,2,18,4,8,61,39,22,58
Copenhagen,4764,3,16,4,10,56,39,17,52
FC Nords,4764,4,14,6,10,69,52,17,48
AaB,4764,5,8,11,11,37,47,-10,35
AC Horsens,4764,6,7,13,10,36,53,-17,34
Sonderjyske,4764,7,8,6,10,28,29,-1,30
Lyngby,4764,8,4,9,11,27,44,-17,21
Randers FC,4764,9,5,6,13,23,40,-17,21
AGF Aarhus,4764,10,5,6,11,19,38,-19,21
Silkeborg IF,4764,11,5,3,14,27,47,-20,18
Brondby,4765,1,21,7,2,70,32,38,70
FC Midtjylla,4765,2,21,4,5,68,36,32,67
FC Nords,4765,3,14,6,10,72,53,19,48
Copenhagen,4765,4,12,4,14,57,50,7,40
AaB,4765,5,8,13,9,39,44,-5,37
AC Horsens,4765,6,6,14,10,35,52,-17,32
Sonderjyske,4765,7,8,6,10,28,29,-1,30
Lyngby,4765,8,4,9,11,27,44,-17,21
Randers FC,4765,9,5,6,13,23,40,-17,21
AGF Aarhus,4765,10,5,6,11,17,36,-19,21
Silkeborg IF,4765,11,5,3,14,25,45,-20,18
Brondby,4766,1,22,6,2,75,32,43,72
FC Midtjylla,4766,2,19,5,6,64,39,25,62
FC Nords,4766,3,14,6,10,71,49,22,48
Copenhagen,4766,4,13,6,11,57,46,11,45
AaB,4766,5,10,11,9,40,42,-2,41
Sonderjyske,4766,6,8,6,10,28,29,-1,30
AC Horsens,4766,7,5,12,13,32,57,-25,27
Randers FC,4766,8,6,6,12,26,40,-14,24
Silkeborg IF,4766,9,6,3,13,27,45,-18,21
Lyngby,4766,10,3,9,12,27,47,-20,18
AGF Aarhus,4766,11,4,6,12,17,38,-21,18
Brondby,4767,1,20,5,5,70,33,37,65
FC Midtjylla,4767,2,19,6,5,63,41,22,63
FC Nords,4767,3,14,8,8,71,47,24,50
Copenhagen,4767,4,15,5,10,63,42,21,50
AaB,4767,5,7,13,10,36,44,-8,34
AC Horsens,4767,6,6,13,11,32,54,-22,31
Sonderjyske,4767,7,8,6,10,28,29,-1,30
Randers FC,4767,8,6,6,12,25,39,-14,24
Silkeborg IF,4767,9,6,3,13,27,44,-17,21
Lyngby,4767,10,3,9,12,26,46,-20,18
AGF Aarhus,4767,11,4,6,12,16,38,-22,18
Brondby,4768,1,22,5,3,79,36,43,71
FC Midtjylla,4768,2,18,5,7,62,43,19,59
FC Nords,4768,3,14,8,8,69,47,22,50
Copenhagen,4768,4,14,4,12,56,45,11,46
AaB,4768,5,8,12,10,37,41,-4,36
AC Horsens,4768,6,7,12,11,33,50,-17,33
Sonderjyske,4768,7,8,6,10,28,29,-1,30
Lyngby,4768,8,4,9,11,27,44,-17,21
Randers FC,4768,9,5,6,13,23,40,-17,21
AGF Aarhus,4768,10,5,6,11,18,37,-19,21
Silkeborg IF,4768,11,5,3,14,26,46,-20,18
Brondby,4769,1,21,7,2,71,30,41,70
FC Midtjylla,4769,2,19,7,4,61,35,26,64
Copenhagen,4769,3,13,6,11,56,45,11,45
FC Nords,4769,4,12,8,10,69,54,15,44
AaB,4769,5,7,13,10,34,39,-5,34
AC Horsens,4769,6,7,13,10,35,49,-14,34
Sonderjyske,4769,7,8,6,10,28,29,-1,30
Lyngby,4769,8,4,9,11,27,44,-17,21
Randers FC,4769,9,5,6,13,23,40,-17,21
Silkeborg IF,4769,10,5,4,13,26,45,-19,19
AGF Aarhus,4769,11,4,7,11,17,37,-20,19
Brondby,4770,1,21,6,3,72,35,37,69
FC Midtjylla,4770,2,19,6,5,65,39,26,63
FC Nords,4770,3,15,6,9,76,52,24,51
Copenhagen,4770,4,14,5,11,60,47,13,47
AC Horsens,4770,5,7,12,11,39,57,-18,33
AaB,4770,6,6,13,11,34,42,-8,31
Sonderjyske,4770,7,8,6,10,28,29,-1,30
Lyngby,4770,8,4,9,11,31,46,-15,21
Silkeborg IF,4770,9,6,3,13,27,45,-18,21
Randers FC,4770,10,5,6,13,25,44,-19,21
AGF Aarhus,4770,11,4,6,12,17,38,-21,18
Brondby,4771,1,22,5,3,75,32,43,71
FC Midtjylla,4771,2,19,4,7,65,41,24,61
Copenhagen,4771,3,16,5,9,62,41,21,53
FC Nords,4771,4,15,7,8,77,49,28,52
Sonderjyske,4771,5,8,6,10,28,29,-1,30
AaB,4771,6,6,12,12,33,52,-19,30
AC Horsens,4771,7,5,13,12,35,58,-23,28
Lyngby,4771,8,4,9,11,29,45,-16,21
Silkeborg IF,4771,9,6,3,13,27,45,-18,21
Randers FC,4771,10,5,6,13,24,42,-18,21
AGF Aarhus,4771,11,4,6,12,17,38,-21,18
Brondby,4772,1,21,5,4,69,37,32,68
FC Midtjylla,4772,2,19,5,6,66,41,25,62
Copenhagen,4772,3,14,6,10,64,45,19,48
FC Nords,4772,4,13,6,11,75,60,15,45
AaB,4772,5,10,11,9,42,42,0,41
AC Horsens,4772,6,6,13,11,36,53,-17,31
Sonderjyske,4772,7,8,6,10,28,29,-1,30
Randers FC,4772,8,5,7,12,25,41,-16,22
Silkeborg IF,4772,9,6,3,13,26,44,-18,21
Lyngby,4772,10,3,10,11,28,46,-18,19
AGF Aarhus,4772,11,4,6,12,16,37,-21,18
Brondby,4773,1,21,7,2,76,32,44,70
FC Midtjylla,4773,2,20,5,5,70,40,30,65
FC Nords,4773,3,15,7,8,75,49,26,52
Copenhagen,4773,4,12,5,13,54,50,4,41
AC Horsens,4773,5,7,13,10,37,54,-17,34
AaB,4773,6,6,13,11,35,48,-13,31
Sonderjyske,4773,7,8,6,10,28,29,-1,30
Randers FC,4773,8,6,6,12,26,41,-15,24
AGF Aarhus,4773,9,5,6,11,18,36,-18,21
Lyngby,4773,10,3,9,12,28,47,-19,18
Silkeborg IF,4773,11,5,3,14,25,46,-21,18
Brondby,4774,1,19,7,4,73,36,37,64
FC Midtjylla,4774,2,19,7,4,68,40,28,64
FC Nords,4774,3,14,9,7,76,50,26,51
Copenhagen,4774,4,14,5,11,61,51,10,47
AaB,4774,5,6,14,10,36,47,-11,32
AC Horsens,4774,6,5,16,9,36,52,-16,31
Sonderjyske,4774,7,8,6,10,28,29,-1,30
Randers FC,4774,8,5,7,12,25,41,-16,22
Lyngby,4774,9,3,10,11,28,46,-18,19
Silkeborg IF,4774,10,5,4,13,25,44,-19,19
AGF Aarhus,4774,11,4,7,11,16,36,-20,19
Brondby,4775,1,20,6,4,68,33,35,66
FC Midtjylla,4775,2,18,7,5,67,40,27,61
FC Nords,4775,3,15,6,9,74,51,23,51
Copenhagen,4775,4,15,6,9,61,41,20,51
AaB,4775,5,7,14,9,37,44,-7,35
Sonderjyske,4775,6,8,6,10,28,29,-1,30
AC Horsens,4775,7,5,13,12,32,56,-24,28
Randers FC,4775,8,6,6,12,26,41,-15,24
Silkeborg IF,4775,9,6,3,13,26,44,-18,21
Lyngby,4775,10,3,9,12,28,47,-19,18
AGF Aarhus,4775,11,4,6,12,16,37,-21,18
Brondby,4776,1,19,7,4,66,35,31,64
FC Midtjylla,4776,2,20,4,6,67,40,27,64
Copenhagen,4776,3,15,5,10,57,40,17,50
FC Nords,4776,4,12,6,12,72,61,11,42
AC Horsens,4776,5,9,12,9,41,50,-9,39
AaB,4776,6,8,12,10,39,42,-3,36
Sonderjyske,4776,7,8,6,10,28,29,-1,30
Lyngby,4776,8,4,9,11,28,45,-17,21
Silkeborg IF,4776,9,6,3,13,27,44,-17,21
Randers FC,4776,10,5,6,13,24,41,-17,21
AGF Aarhus,4776,11,4,6,12,16,38,-22,18
FC Midtjylla,4777,1,21,5,4,66,35,31,68
Brondby,4777,2,20,5,5,71,40,31,65
FC Nords,4777,3,14,6,10,76,57,19,48
Copenhagen,4777,4,13,7,10,58,42,16,46
AC Horsens,4777,5,8,13,9,39,52,-13,37
Sonderjyske,4777,6,8,6,10,28,29,-1,30
AaB,4777,7,6,12,12,36,46,-10,30
Randers FC,4777,8,5,7,12,24,40,-16,22
Silkeborg IF,4777,9,6,3,13,27,44,-17,21
Lyngby,4777,10,3,10,11,27,45,-18,19
AGF Aarhus,4777,11,4,6,12,16,38,-22,18
Brondby,4778,1,21,6,3,75,35,40,69
FC Midtjylla,4778,2,19,4,7,62,42,20,61
FC Nords,4778,3,15,6,9,75,54,21,51
Copenhagen,4778,4,14,5,11,58,43,15,47
AC Horsens,4778,5,7,13,10,35,52,-17,34
AaB,4778,6,7,12,11,37,42,-5,33
Sonderjyske,4778,7,8,6,10,28,29,-1,30
Lyngby,4778,8,4,9,11,28,44,-16,21
Randers FC,4778,9,5,6,13,23,41,-18,21
AGF Aarhus,4778,10,5,6,11,17,36,-19,21
Silkeborg IF,4778,11,5,3,14,25,45,-20,18
Brondby,4779,1,22,5,3,76,31,45,71
FC Midtjylla,4779,2,20,4,6,65,40,25,64
FC Nords,4779,3,15,6,9,68,51,17,51
Copenhagen,4779,4,14,4,12,60,45,15,46
AaB,4779,5,9,11,10,40,42,-2,38
Sonderjyske,4779,6,8,6,10,28,29,-1,30
AC Horsens,4779,7,5,12,13,30,56,-26,27
Lyngby,4779,8,4,9,11,29,45,-16,21
Silkeborg IF,4779,9,6,3,13,28,44,-16,21
Randers FC,4779,10,5,6,13,24,42,-18,21
AGF Aarhus,4779,11,4,6,12,16,39,-23,18
Brondby,4780,1,21,7,2,72,31,41,70
FC Midtjylla,4780,2,20,4,6,64,39,25,64
FC Nords,4780,3,15,7,8,77,50,27,52
Copenhagen,4780,4,12,6,12,54,46,8,42
AaB,4780,5,7,12,11,36,44,-8,33
AC Horsens,4780,6,6,14,10,34,53,-19,32
Sonderjyske,4780,7,8,6,10,28,29,-1,30
Lyngby,4780,8,4,9,11,29,44,-15,21
Silkeborg IF,4780,9,6,3,13,28,46,-18,21
Randers FC,4780,10,5,6,13,23,42,-19,21
AGF Aarhus,4780,11,4,6,12,18,39,-21,18
Brondby,4781,1,21,7,2,79,33,46,70
FC Midtjylla,4781,2,18,5,7,68,46,22,59
FC Nords,4781,3,15,7,8,80,51,29,52
Copenhagen,4781,4,15,5,10,60,47,13,50
AaB,4781,5,8,12,10,39,45,-6,36
Sonderjyske,4781,6,8,6,10,28,29,-1,30
AC Horsens,4781,7,5,12,13,31,61,-30,27
Randers FC,4781,8,6,6,12,25,39,-14,24
Silkeborg IF,4781,9,6,3,13,27,45,-18,21
Lyngby,4781,10,3,9,12,26,46,-20,18
AGF Aarhus,4781,11,4,6,12,17,38,-21,18
FC Midtjylla,4782,1,20,5,5,69,39,30,65
Brondby,4782,2,19,7,4,69,34,35,64
Copenhagen,4782,3,14,6,10,58,43,15,48
FC Nords,4782,4,13,7,10,70,53,17,46
AC Horsens,4782,5,7,15,8,34,47,-13,36
AaB,4782,6,7,12,11,37,47,-10,33
Sonderjyske,4782,7,8,6,10,28,29,-1,30
Randers FC,4782,8,6,6,12,25,39,-14,24
Silkeborg IF,4782,9,6,3,13,28,44,-16,21
Lyngby,4782,10,3,9,12,26,46,-20,18
AGF Aarhus,4782,11,4,6,12,16,39,-23,18
Brondby,4783,1,20,5,5,75,40,35,65
FC Midtjylla,4783,2,19,4,7,64,41,23,61
FC Nords,4783,3,16,7,7,80,54,26,55
Copenhagen,4783,4,14,4,12,57,45,12,46
AaB,4783,5,8,12,10,41,48,-7,36
AC Horsens,4783,6,7,12,11,37,52,-15,33
Sonderjyske,4783,7,8,6,10,28,29,-1,30
Randers FC,4783,8,6,6,12,24,39,-15,24
Silkeborg IF,4783,9,6,3,13,26,44,-18,21
Lyngby,4783,10,3,9,12,26,45,-19,18
AGF Aarhus,4783,11,4,6,12,16,37,-21,18
Brondby,4784,1,20,7,3,71,32,39,67
FC Midtjylla,4784,2,21,4,5,69,41,28,67
FC Nords,4784,3,14,7,9,72,51,21,49
Copenhagen,4784,4,14,5,11,56,43,13,47
AaB,4784,5,7,13,10,37,43,-6,34
Sonderjyske,4784,6,8,6,10,28,29,-1,30
AC Horsens,4784,7,5,14,11,34,55,-21,29
Lyngby,4784,8,4,9,11,29,45,-16,21
Randers FC,4784,9,5,6,13,24,42,-18,21
AGF Aarhus,4784,10,5,6,11,17,36,-19,21
Silkeborg IF,4784,11,5,3,14,25,45,-20,18
FC Midtjylla,4785,1,22,4,4,72,33,39,70
Brondby,4785,2,19,7,4,66,35,31,64
FC Nords,4785,3,13,9,8,74,56,18,48
Copenhagen,4785,4,13,6,11,55,46,9,45
AaB,4785,5,8,13,9,43,43,0,37
Sonderjyske,4785,6,8,6,10,28,29,-1,30
AC Horsens,4785,7,5,13,12,33,56,-23,28
Lyngby,4785,8,4,9,11,28,44,-16,21
Randers FC,4785,9,5,6,13,23,41,-18,21
AGF Aarhus,4785,10,5,6,11,18,36,-18,21
Silkeborg IF,4785,11,5,3,14,25,46,-21,18
Brondby,4786,1,22,5,3,80,39,41,71
FC Midtjylla,4786,2,18,6,6,65,41,24,60
FC Nords,4786,3,14,7,9,83,62,21,49
Copenhagen,4786,4,14,5,11,58,46,12,47
AaB,4786,5,8,13,9,42,44,-2,37
Sonderjyske,4786,6,8,6,10,28,29,-1,30
AC Horsens,4786,7,6,12,12,37,59,-22,30
Randers FC,4786,8,6,6,12,24,39,-15,24
Silkeborg IF,4786,9,6,3,13,29,47,-18,21
Lyngby,4786,10,3,9,12,26,45,-19,18
AGF Aarhus,4786,11,4,6,12,19,40,-21,18
Brondby,4787,1,23,5,2,68,27,41,74
FC Midtjylla,4787,2,18,4,8,60,42,18,58
FC Nords,4787,3,15,7,8,72,46,26,52
Copenhagen,4787,4,14,6,10,56,40,16,48
AC Horsens,4787,5,7,13,10,36,50,-14,34
Sonderjyske,4787,6,8,6,10,28,29,-1,30
AaB,4787,7,6,11,13,32,45,-13,29
Randers FC,4787,8,6,6,12,25,39,-14,24
AGF Aarhus,4787,9,5,6,11,19,37,-18,21
Lyngby,4787,10,3,9,12,26,46,-20,18
Silkeborg IF,4787,11,5,3,14,26,47,-21,18
Brondby,4788,1,22,5,3,72,31,41,71
FC Midtjylla,4788,2,20,5,5,67,37,30,65
FC Nords,4788,3,14,7,9,70,49,21,49
Copenhagen,4788,4,14,4,12,55,44,11,46
AC Horsens,4788,5,7,12,11,35,53,-18,33
AaB,4788,6,7,11,12,35,46,-11,32
Sonderjyske,4788,7,8,6,10,28,29,-1,30
Lyngby,4788,8,4,9,11,29,45,-16,21
Silkeborg IF,4788,9,6,3,13,27,44,-17,21
Randers FC,4788,10,5,6,13,24,42,-18,21
AGF Aarhus,4788,11,4,6,12,16,38,-22,18
Brondby,4789,1,21,6,3,68,31,37,69
FC Midtjylla,4789,2,18,5,7,65,44,21,59
FC Nords,4789,3,14,7,9,71,48,23,49
Copenhagen,4789,4,13,5,12,55,46,9,44
AaB,4789,5,8,13,9,38,42,-4,37
AC Horsens,4789,6,8,12,10,36,48,-12,36
Sonderjyske,4789,7,8,6,10,28,29,-1,30
Randers FC,4789,8,5,7,12,23,39,-16,22
Lyngby,4789,9,3,10,11,26,44,-18,19
Silkeborg IF,4789,10,5,4,13,26,45,-19,19
AGF Aarhus,4789,11,4,7,11,17,37,-20,19
Brondby,4790,1,20,7,3,68,31,37,67
FC Midtjylla,4790,2,20,5,5,61,39,22,65
Copenhagen,4790,3,15,5,10,59,43,16,50
FC Nords,4790,4,14,6,10,73,51,22,48
AaB,4790,5,7,12,11,39,44,-5,33
AC Horsens,4790,6,6,13,11,36,54,-18,31
Sonderjyske,4790,7,8,6,10,28,29,-1,30
Randers FC,4790,8,6,6,12,25,39,-14,24
AGF Aarhus,4790,9,5,6,11,17,36,-19,21
Lyngby,4790,10,3,9,12,26,46,-20,18
Silkeborg IF,4790,11,5,3,14,25,45,-20,18
FC Midtjylla,4791,1,22,4,4,74,37,37,70
Brondby,4791,2,20,5,5,66,34,32,65
FC Nords,4791,3,14,7,9,73,53,20,49
Copenhagen,4791,4,14,5,11,57,47,10,47
AaB,4791,5,7,12,11,36,44,-8,33
AC Horsens,4791,6,6,13,11,36,53,-17,31
Sonderjyske,4791,7,8,6,10,28,29,-1,30
Lyngby,4791,8,4,9,11,27,44,-17,21
Randers FC,4791,9,5,6,13,23,40,-17,21
Silkeborg IF,4791,10,5,4,13,25,44,-19,19
AGF Aarhus,4791,11,4,7,11,16,36,-20,19
Brondby,4792,1,21,6,3,75,34,41,69
FC Midtjylla,4792,2,20,5,5,70,39,31,65
FC Nords,4792,3,15,6,9,78,53,25,51
Copenhagen,4792,4,14,5,11,57,44,13,47
AC Horsens,4792,5,6,15,9,36,54,-18,33
Sonderjyske,4792,6,8,6,10,28,29,-1,30
AaB,4792,7,6,11,13,34,52,-18,29
Randers FC,4792,8,5,7,12,24,40,-16,22
Silkeborg IF,4792,9,6,3,13,27,45,-18,21
Lyngby,4792,10,3,10,11,27,45,-18,19
AGF Aarhus,4792,11,4,6,12,17,38,-21,18
Brondby,4793,1,21,6,3,73,37,36,69
FC Midtjylla,4793,2,18,4,8,68,49,19,58
FC Nords,4793,3,15,7,8,82,57,25,52
Copenhagen,4793,4,16,4,10,64,42,22,52
AC Horsens,4793,5,7,12,11,34,53,-19,33
AaB,4793,6,6,13,11,38,47,-9,31
Sonderjyske,4793,7,8,6,10,28,29,-1,30
Randers FC,4793,8,5,7,12,23,39,-16,22
Lyngby,4793,9,3,10,11,26,44,-18,19
Silkeborg IF,4793,10,5,4,13,26,45,-19,19
AGF Aarhus,4793,11,4,7,11,17,37,-20,19
FC Midtjylla,4794,1,21,4,5,69,37,32,67
Brondby,4794,2,20,6,4,70,35,35,66
Copenhagen,4794,3,16,4,10,60,44,16,52
FC Nords,4794,4,13,6,11,76,55,21,45
AaB,4794,5,8,12,10,40,44,-4,36
Sonderjyske,4794,6,8,6,10,28,29,-1,30
AC Horsens,4794,7,6,12,12,33,59,-26,30
Lyngby,4794,8,4,9,11,28,44,-16,21
Randers FC,4794,9,5,6,13,23,41,-18,21
Silkeborg IF,4794,10,5,4,13,25,44,-19,19
AGF Aarhus,4794,11,4,7,11,16,36,-20,19
Brondby,4795,1,21,6,3,70,32,38,69
FC Midtjylla,4795,2,19,4,7,67,41,26,61
FC Nords,4795,3,14,8,8,75,51,24,50
Copenhagen,4795,4,13,5,12,58,52,6,44
AaB,4795,5,7,14,9,41,45,-4,35
AC Horsens,4795,6,7,13,10,35,51,-16,34
Sonderjyske,4795,7,8,6,10,28,29,-1,30
Randers FC,4795,8,5,7,12,24,40,-16,22
Lyngby,4795,9,3,10,11,27,45,-18,19
Silkeborg IF,4795,10,5,4,13,25,44,-19,19
AGF Aarhus,4795,11,4,7,11,16,36,-20,19
Brondby,4796,1,21,6,3,70,31,39,69
FC Midtjylla,4796,2,18,6,6,64,40,24,60
FC Nords,4796,3,15,7,8,77,52,25,52
Copenhagen,4796,4,14,4,12,56,44,12,46
AaB,4796,5,9,13,8,40,41,-1,40
Sonderjyske,4796,6,8,6,10,28,29,-1,30
AC Horsens,4796,7,5,12,13,34,59,-25,27
Lyngby,4796,8,4,9,11,27,44,-17,21
Randers FC,4796,9,5,6,13,23,40,-17,21
Silkeborg IF,4796,10,6,3,13,26,44,-18,21
AGF Aarhus,4796,11,4,6,12,16,37,-21,18
Brondby,4797,1,21,6,3,71,32,39,69
FC Midtjylla,4797,2,21,4,5,64,35,29,67
Copenhagen,4797,3,15,4,11,58,41,17,49
FC Nords,4797,4,14,6,10,70,53,17,48
AaB,4797,5,7,12,11,38,45,-7,33
Sonderjyske,4797,6,8,6,10,28,29,-1,30
AC Horsens,4797,7,5,14,11,32,53,-21,29
Lyngby,4797,8,4,9,11,30,47,-17,21
Randers FC,4797,9,5,6,13,26,43,-17,21
AGF Aarhus,4797,10,5,6,11,19,38,-19,21
Silkeborg IF,4797,11,5,3,14,27,47,-20,18
Brondby,4798,1,21,5,4,72,35,37,68
FC Midtjylla,4798,2,21,4,5,68,37,31,67
FC Nords,4798,3,14,6,10,72,50,22,48
Copenhagen,4798,4,14,4,12,57,49,8,46
AaB,4798,5,9,11,10,40,42,-2,38
Sonderjyske,4798,6,8,6,10,28,29,-1,30
AC Horsens,4798,7,6,12,12,32,54,-22,30
Randers FC,4798,8,6,6,12,27,41,-14,24
AGF Aarhus,4798,9,5,6,11,21,37,-16,21
Lyngby,4798,10,3,9,12,28,48,-20,18
Silkeborg IF,4798,11,5,3,14,26,49,-23,18
Brondby,4799,1,20,7,3,68,34,34,67
FC Midtjylla,4799,2,19,5,6,67,42,25,62
Copenhagen,4799,3,15,5,10,59,44,15,50
FC Nords,4799,4,14,7,9,72,50,22,49
AaB,4799,5,8,11,11,38,42,-4,35
AC Horsens,4799,6,6,13,11,34,52,-18,31
Sonderjyske,4799,7,8,6,10,28,29,-1,30
Lyngby,4799,8,4,9,11,28,44,-16,21
Randers FC,4799,9,5,6,13,23,41,-18,21
AGF Aarhus,4799,10,5,6,11,18,37,-19,21
Silkeborg IF,4799,11,5,3,14,26,46,-20,18
FC Midtjylla,4800,1,22,4,4,69,35,34,70
Brondby,4800,2,20,5,5,74,36,38,65
FC Nords,4800,3,13,7,10,70,52,18,46
Copenhagen,4800,4,12,6,12,56,49,7,42
AC Horsens,4800,5,8,13,9,38,52,-14,37
AaB,4800,6,7,13,10,39,48,-9,34
Sonderjyske,4800,7,8,6,10,28,29,-1,30
Randers FC,4800,8,5,7,12,25,41,-16,22
Silkeborg IF,4800,9,6,3,13,30,47,-17,21
Lyngby,4800,10,3,10,11,28,46,-18,19
AGF Aarhus,4800,11,4,6,12,19,41,-22,18
Brondby,4801,1,23,5,2,77,30,47,74
FC Midtjylla,4801,2,18,4,8,62,43,19,58
Copenhagen,4801,3,15,5,10,55,39,16,50
FC Nords,4801,4,14,7,9,71,51,20,49
AaB,4801,5,8,13,9,42,44,-2,37
Sonderjyske,4801,6,8,6,10,28,29,-1,30
AC Horsens,4801,7,5,12,13,32,58,-26,27
Randers FC,4801,8,6,6,12,25,39,-14,24
AGF Aarhus,4801,9,5,6,11,18,36,-18,21
Lyngby,4801,10,3,9,12,26,46,-20,18
Silkeborg IF,4801,11,5,3,14,25,46,-21,18
Brondby,4802,1,21,5,4,68,30,38,68
FC Midtjylla,4802,2,20,5,5,64,37,27,65
FC Nords,4802,3,15,6,9,74,51,23,51
Copenhagen,4802,4,15,5,10,59,44,15,50
AaB,4802,5,6,14,10,37,43,-6,32
Sonderjyske,4802,6,8,6,10,28,29,-1,30
AC Horsens,4802,7,5,13,12,31,54,-23,28
Randers FC,4802,8,5,7,12,23,39,-16,22
Lyngby,4802,9,3,10,11,26,44,-18,19
Silkeborg IF,4802,10,5,4,13,26,45,-19,19
AGF Aarhus,4802,11,4,7,11,17,37,-20,19
Brondby,4803,1,20,5,5,66,34,32,65
FC Midtjylla,4803,2,20,4,6,65,39,26,64
FC Nords,4803,3,15,6,9,74,51,23,51
Copenhagen,4803,4,15,5,10,61,45,16,50
AaB,4803,5,7,12,11,36,44,-8,33
AC Horsens,4803,6,7,12,11,38,53,-15,33
Sonderjyske,4803,7,8,6,10,28,29,-1,30
Lyngby,4803,8,4,9,11,28,45,-17,21
Randers FC,4803,9,5,6,13,24,41,-17,21
Silkeborg IF,4803,10,6,3,13,26,44,-18,21
AGF Aarhus,4803,11,4,6,12,16,37,-21,18
Brondby,4804,1,23,5,2,72,30,42,74
FC Midtjylla,4804,2,19,6,5,65,35,30,63
FC Nords,4804,3,14,7,9,75,51,24,49
Copenhagen,4804,4,13,5,12,54,50,4,44
AaB,4804,5,8,13,9,38,37,1,37
Sonderjyske,4804,6,8,6,10,28,29,-1,30
AC Horsens,4804,7,5,12,13,30,57,-27,27
Randers FC,4804,8,6,6,12,25,40,-15,24
AGF Aarhus,4804,9,5,6,11,18,36,-18,21
Lyngby,4804,10,3,9,12,27,46,-19,18
Silkeborg IF,4804,11,5,3,14,25,46,-21,18
Brondby,4805,1,22,5,3,72,32,40,71
FC Midtjylla,4805,2,18,5,7,65,43,22,59
FC Nords,4805,3,15,6,9,73,50,23,51
Copenhagen,4805,4,14,4,12,57,48,9,46
AC Horsens,4805,5,8,12,10,35,48,-13,36
AaB,4805,6,7,12,11,37,44,-7,33
Sonderjyske,4805,7,8,6,10,28,29,-1,30
Lyngby,4805,8,4,9,11,28,45,-17,21
Randers FC,4805,9,5,6,13,24,41,-17,21
Silkeborg IF,4805,10,5,4,13,25,44,-19,19
AGF Aarhus,4805,11,4,7,11,16,36,-20,19
Brondby,4806,1,20,6,4,67,31,36,66
FC Midtjylla,4806,2,19,6,5,62,37,25,63
FC Nords,4806,3,13,9,8,71,48,23,48
Copenhagen,4806,4,13,6,11,54,46,8,45
AaB,4806,5,8,12,10,39,41,-2,36
AC Horsens,4806,6,7,13,10,35,51,-16,34
Sonderjyske,4806,7,8,6,10,28,29,-1,30
Randers FC,4806,8,5,7,12,23,39,-16,22
Silkeborg IF,4806,9,6,3,13,28,46,-18,21
Lyngby,4806,10,3,10,11,26,44,-18,19
AGF Aarhus,4806,11,4,6,12,18,39,-21,18
Brondby,4807,1,21,5,4,73,34,39,68
FC Midtjylla,4807,2,20,5,5,62,37,25,65
FC Nords,4807,3,14,7,9,71,51,20,49
Copenhagen,4807,4,13,6,11,57,45,12,45
AaB,4807,5,8,13,9,40,41,-1,37
Sonderjyske,4807,6,8,6,10,28,29,-1,30
AC Horsens,4807,7,5,14,11,34,55,-21,29
Randers FC,4807,8,5,7,12,24,40,-16,22
Silkeborg IF,4807,9,6,3,13,29,44,-15,21
Lyngby,4807,10,3,10,11,27,45,-18,19
AGF Aarhus,4807,11,4,6,12,16,40,-24,18
Brondby,4808,1,20,6,4,68,32,36,66
FC Midtjylla,4808,2,20,5,5,63,35,28,65
FC Nords,4808,3,14,8,8,68,46,22,50
Copenhagen,4808,4,12,5,13,53,45,8,41
AaB,4808,5,8,12,10,36,42,-6,36
AC Horsens,4808,6,8,12,10,33,47,-14,36
Sonderjyske,4808,7,8,6,10,28,29,-1,30
Lyngby,4808,8,4,9,11,28,44,-16,21
Randers FC,4808,9,5,6,13,23,41,-18,21
Silkeborg IF,4808,10,5,4,13,25,44,-19,19
AGF Aarhus,4808,11,4,7,11,16,36,-20,19
Brondby,4809,1,21,7,2,70,31,39,70
FC Midtjylla,4809,2,19,6,5,65,38,27,63
FC Nords,4809,3,15,7,8,79,48,31,52
Copenhagen,4809,4,13,5,12,58,50,8,44
AaB,4809,5,8,13,9,35,38,-3,37
Sonderjyske,4809,6,8,6,10,28,29,-1,30
AC Horsens,4809,7,5,12,13,35,63,-28,27
Lyngby,4809,8,4,9,11,27,44,-17,21
Randers FC,4809,9,5,6,13,23,40,-17,21
AGF Aarhus,4809,10,5,6,11,19,37,-18,21
Silkeborg IF,4809,11,5,3,14,26,47,-21,18
Brondby,4810,1,21,7,2,67,28,39,70
FC Midtjylla,4810,2,20,4,6,66,40,26,64
FC Nords,4810,3,14,7,9,72,50,22,49
Copenhagen,4810,4,13,6,11,58,47,11,45
AC Horsens,4810,5,7,14,9,33,48,-15,35
Sonderjyske,4810,6,8,6,10,28,29,-1,30
AaB,4810,7,6,12,12,37,46,-9,30
Lyngby,4810,8,4,9,11,29,45,-16,21
Randers FC,4810,9,5,6,13,24,42,-18,21
AGF Aarhus,4810,10,5,6,11,17,36,-19,21
Silkeborg IF,4810,11,5,3,14,25,45,-20,18
Brondby,4811,1,21,6,3,71,29,42,69
FC Midtjylla,4811,2,20,4,6,65,38,27,64
FC Nords,4811,3,14,6,10,71,52,19,48
Copenhagen,4811,4,14,5,11,55,44,11,47
AaB,4811,5,8,13,9,37,39,-2,37
Sonderjyske,4811,6,8,6,10,28,29,-1,30
AC Horsens,4811,7,6,12,12,32,55,-23,30
Randers FC,4811,8,5,7,12,24,40,-16,22
Lyngby,4811,9,3,10,11,27,45,-18,19
Silkeborg IF,4811,10,5,4,13,26,45,-19,19
AGF Aarhus,4811,11,4,7,11,17,37,-20,19
Brondby,4812,1,21,7,2,71,31,40,70
FC Midtjylla,4812,2,17,5,8,61,44,17,56
FC Nords,4812,3,13,9,8,68,46,22,48
Copenhagen,4812,4,14,4,12,58,46,12,46
AaB,4812,5,9,13,8,38,38,0,40
AC Horsens,4812,6,6,14,10,35,52,-17,32
Sonderjyske,4812,7,8,6,10,28,29,-1,30
Randers FC,4812,8,6,6,12,24,39,-15,24
AGF Aarhus,4812,9,5,6,11,18,36,-18,21
Lyngby,4812,10,3,9,12,26,45,-19,18
Silkeborg IF,4812,11,5,3,14,25,46,-21,18
Brondby,4813,1,21,7,2,74,33,41,70
FC Midtjylla,4813,2,19,6,5,62,38,24,63
FC Nords,4813,3,14,9,7,77,52,25,51
Copenhagen,4813,4,13,6,11,59,50,9,45
AaB,4813,5,7,12,11,36,43,-7,33
Sonderjyske,4813,6,8,6,10,28,29,-1,30
AC Horsens,4813,7,5,14,11,34,52,-18,29
Randers FC,4813,8,5,7,12,23,39,-16,22
Lyngby,4813,9,3,10,11,26,44,-18,19
Silkeborg IF,4813,10,5,4,13,26,45,-19,19
AGF Aarhus,4813,11,4,7,11,17,37,-20,19
FC Midtjylla,4814,1,21,5,4,67,36,31,68
Brondby,4814,2,20,6,4,70,31,39,66
FC Nords,4814,3,13,7,10,72,55,17,46
Copenhagen,4814,4,13,5,12,55,45,10,44
AaB,4814,5,9,11,10,38,43,-5,38
AC Horsens,4814,6,5,16,9,41,59,-18,31
Sonderjyske,4814,7,8,6,10,28,29,-1,30
Randers FC,4814,8,5,7,12,24,40,-16,22
Silkeborg IF,4814,9,6,3,13,27,44,-17,21
Lyngby,4814,10,3,10,11,27,45,-18,19
AGF Aarhus,4814,11,4,6,12,16,38,-22,18
FC Midtjylla,4815,1,20,5,5,65,36,29,65
Brondby,4815,2,19,7,4,67,34,33,64
FC Nords,4815,3,14,8,8,74,50,24,50
Copenhagen,4815,4,13,6,11,54,45,9,45
AaB,4815,5,8,11,11,37,46,-9,35
AC Horsens,4815,6,6,15,9,36,48,-12,33
Sonderjyske,4815,7,8,6,10,28,29,-1,30
Lyngby,4815,8,4,9,11,29,44,-15,21
Silkeborg IF,4815,9,6,3,13,27,45,-18,21
Randers FC,4815,10,5,6,13,23,42,-19,21
AGF Aarhus,4815,11,4,6,12,17,38,-21,18
Brondby,4816,1,21,7,2,74,31,43,70
FC Midtjylla,4816,2,19,6,5,64,40,24,63
FC Nords,4816,3,14,6,10,74,56,18,48
Copenhagen,4816,4,14,5,11,59,44,15,47
AaB,4816,5,8,11,11,37,44,-7,35
AC Horsens,4816,6,6,13,11,34,53,-19,31
Sonderjyske,4816,7,8,6,10,28,29,-1,30
Randers FC,4816,8,6,6,12,25,40,-15,24
Silkeborg IF,4816,9,5,4,13,26,45,-19,19
AGF Aarhus,4816,10,4,7,11,17,37,-20,19
Lyngby,4816,11,3,9,12,27,46,-19,18
FC Midtjylla,4817,1,21,5,4,66,34,32,68
Brondby,4817,2,20,7,3,73,35,38,67
Copenhagen,4817,3,15,5,10,57,42,15,50
FC Nords,4817,4,13,8,9,73,53,20,47
AaB,4817,5,6,13,11,35,42,-7,31
Sonderjyske,4817,6,8,6,10,28,29,-1,30
AC Horsens,4817,7,6,12,12,33,57,-24,30
Randers FC,4817,8,5,7,12,24,40,-16,22
AGF Aarhus,4817,9,5,6,11,18,37,-19,21
Lyngby,4817,10,3,10,11,27,45,-18,19
Silkeborg IF,4817,11,5,3,14,26,46,-20,18
Brondby,4818,1,20,7,3,73,35,38,67
FC Midtjylla,4818,2,19,4,7,64,44,20,61
FC Nords,4818,3,15,7,8,78,50,28,52
Copenhagen,4818,4,14,5,11,60,51,9,47
AaB,4818,5,7,13,10,38,44,-6,34
AC Horsens,4818,6,7,12,11,37,52,-15,33
Sonderjyske,4818,7,8,6,10,28,29,-1,30
Lyngby,4818,8,4,9,11,31,45,-14,21
Silkeborg IF,4818,9,6,3,13,26,44,-18,21
Randers FC,4818,10,5,6,13,24,44,-20,21
AGF Aarhus,4818,11,4,6,12,16,37,-21,18
Brondby,4819,1,20,7,3,70,33,37,67
FC Midtjylla,4819,2,18,5,7,62,42,20,59
FC Nords,4819,3,15,8,7,73,46,27,53
Copenhagen,4819,4,14,5,11,57,44,13,47
AaB,4819,5,9,11,10,39,40,-1,38
Sonderjyske,4819,6,8,6,10,28,29,-1,30
AC Horsens,4819,7,6,12,12,34,56,-22,30
Lyngby,4819,8,4,9,11,28,45,-17,21
Randers FC,4819,9,5,6,13,24,41,-17,21
Silkeborg IF,4819,10,6,3,13,26,44,-18,21
AGF Aarhus,4819,11,4,6,12,16,37,-21,18
Brondby,4820,1,21,5,4,68,31,37,68
FC Midtjylla,4820,2,20,5,5,67,38,29,65
Copenhagen,4820,3,15,6,9,58,40,18,51
FC Nords,4820,4,13,7,10,73,57,16,46
AaB,4820,5,7,12,11,34,43,-9,33
AC Horsens,4820,6,6,13,11,34,51,-17,31
Sonderjyske,4820,7,8,6,10,28,29,-1,30
Lyngby,4820,8,4,9,11,29,44,-15,21
AGF Aarhus,4820,9,5,6,11,20,37,-17,21
Randers FC,4820,10,5,6,13,23,42,-19,21
Silkeborg IF,4820,11,5,3,14,26,48,-22,18
Brondby,4821,1,20,7,3,73,36,37,67
FC Midtjylla,4821,2,19,4,7,66,38,28,61
Copenhagen,4821,3,16,4,10,62,47,15,52
FC Nords,4821,4,12,8,10,72,57,15,44
AaB,4821,5,10,11,9,41,41,0,41
Sonderjyske,4821,6,8,6,10,28,29,-1,30
AC Horsens,4821,7,5,14,11,34,55,-21,29
Silkeborg IF,4821,8,6,3,13,29,45,-16,21
Lyngby,4821,9,4,9,11,27,44,-17,21
Randers FC,4821,10,5,6,13,23,40,-17,21
AGF Aarhus,4821,11,4,6,12,17,40,-23,18
Brondby,4822,1,22,5,3,72,32,40,71
FC Midtjylla,4822,2,20,4,6,63,36,27,64
Copenhagen,4822,3,14,5,11,54,42,12,47
FC Nords,4822,4,13,7,10,72,54,18,46
AaB,4822,5,9,11,10,38,43,-5,38
Sonderjyske,4822,6,8,6,10,28,29,-1,30
AC Horsens,4822,7,5,14,11,37,55,-18,29
Randers FC,4822,8,6,6,12,26,40,-14,24
AGF Aarhus,4822,9,5,6,11,17,36,-19,21
Lyngby,4822,10,3,9,12,27,47,-20,18
Silkeborg IF,4822,11,5,3,14,25,45,-20,18
Brondby,4823,1,23,5,2,71,30,41,74
FC Midtjylla,4823,2,19,5,6,67,40,27,62
FC Nords,4823,3,14,6,10,69,51,18,48
Copenhagen,4823,4,13,5,12,52,42,10,44
AaB,4823,5,8,11,11,35,45,-10,35
AC Horsens,4823,6,7,12,11,36,48,-12,33
Sonderjyske,4823,7,8,6,10,28,29,-1,30
Randers FC,4823,8,5,7,12,25,41,-16,22
Silkeborg IF,4823,9,6,3,13,27,45,-18,21
Lyngby,4823,10,3,10,11,28,46,-18,19
AGF Aarhus,4823,11,4,6,12,17,38,-21,18
Brondby,4824,1,21,6,3,71,29,42,69
FC Midtjylla,4824,2,20,6,4,67,37,30,66
FC Nords,4824,3,14,6,10,70,55,15,48
Copenhagen,4824,4,14,4,12,56,46,10,46
AaB,4824,5,7,12,11,34,42,-8,33
AC Horsens,4824,6,6,14,10,37,52,-15,32
Sonderjyske,4824,7,8,6,10,28,29,-1,30
Lyngby,4824,8,4,9,11,28,44,-16,21
Randers FC,4824,9,5,6,13,23,41,-18,21
Silkeborg IF,4824,10,5,4,13,25,44,-19,19
AGF Aarhus,4824,11,4,7,11,16,36,-20,19
Brondby,4825,1,21,5,4,71,32,39,68
FC Midtjylla,4825,2,19,5,6,64,41,23,62
Copenhagen,4825,3,14,6,10,59,45,14,48
FC Nords,4825,4,13,7,10,74,54,20,46
AaB,4825,5,9,12,9,42,46,-4,39
AC Horsens,4825,6,6,13,11,39,57,-18,31
Sonderjyske,4825,7,8,6,10,28,29,-1,30
Randers FC,4825,8,5,7,12,24,40,-16,22
Lyngby,4825,9,3,10,11,27,45,-18,19
Silkeborg IF,4825,10,5,4,13,26,45,-19,19
AGF Aarhus,4825,11,4,7,11,17,37,-20,19
Brondby,4826,1,22,5,3,75,36,39,71
FC Midtjylla,4826,2,19,6,5,65,38,27,63
Copenhagen,4826,3,14,5,11,57,43,14,47
FC Nords,4826,4,12,8,10,69,54,15,44
AC Horsens,4826,5,7,14,9,36,51,-15,35
AaB,4826,6,7,12,11,37,43,-6,33
Sonderjyske,4826,7,8,6,10,28,29,-1,30
Randers FC,4826,8,6,6,12,26,39,-13,24
AGF Aarhus,4826,9,5,6,11,17,36,-19,21
Silkeborg IF,4826,10,5,3,14,25,45,-20,18
Lyngby,4826,11,3,9,12,26,47,-21,18
Brondby,4827,1,20,7,3,72,36,36,67
FC Midtjylla,4827,2,19,5,6,64,39,25,62
Copenhagen,4827,3,15,4,11,61,43,18,49
FC Nords,4827,4,13,8,9,71,53,18,47
AaB,4827,5,8,12,10,36,43,-7,36
AC Horsens,4827,6,7,12,11,36,52,-16,33
Sonderjyske,4827,7,8,6,10,28,29,-1,30
Silkeborg IF,4827,8,6,3,13,28,44,-16,21
Lyngby,4827,9,4,9,11,28,45,-17,21
Randers FC,4827,10,5,6,13,24,41,-17,21
AGF Aarhus,4827,11,4,6,12,16,39,-23,18
Brondby,4828,1,22,5,3,78,34,44,71
FC Midtjylla,4828,2,19,5,6,67,41,26,62
Copenhagen,4828,3,15,6,9,57,40,17,51
FC Nords,4828,4,12,8,10,66,55,11,44
AaB,4828,5,6,14,10,34,42,-8,32
AC Horsens,4828,6,6,14,10,35,51,-16,32
Sonderjyske,4828,7,8,6,10,28,29,-1,30
Silkeborg IF,4828,8,6,3,13,32,44,-12,21
Lyngby,4828,9,4,9,11,29,44,-15,21
Randers FC,4828,10,5,6,13,23,42,-19,21
AGF Aarhus,4828,11,4,6,12,16,43,-27,18
FC Midtjylla,4829,1,20,5,5,65,36,29,65
Brondby,4829,2,19,6,5,72,39,33,63
FC Nords,4829,3,15,7,8,77,51,26,52
Copenhagen,4829,4,14,4,12,55,43,12,46
AaB,4829,5,9,12,9,39,42,-3,39
Sonderjyske,4829,6,8,6,10,28,29,-1,30
AC Horsens,4829,7,6,12,12,35,58,-23,30
Lyngby,4829,8,4,9,11,28,45,-17,21
Randers FC,4829,9,5,6,13,24,41,-17,21
Silkeborg IF,4829,10,5,4,13,25,44,-19,19
AGF Aarhus,4829,11,4,7,11,16,36,-20,19
FC Midtjylla,4830,1,20,5,5,67,38,29,65
Brondby,4830,2,19,6,5,65,33,32,63
FC Nords,4830,3,15,7,8,73,52,21,52
Copenhagen,4830,4,13,6,11,58,45,13,45
AaB,4830,5,9,11,10,38,39,-1,38
Sonderjyske,4830,6,8,6,10,28,29,-1,30
AC Horsens,4830,7,5,15,10,34,54,-20,30
Randers FC,4830,8,6,6,12,26,40,-14,24
AGF Aarhus,4830,9,5,6,11,17,36,-19,21
Lyngby,4830,10,3,9,12,27,47,-20,18
Silkeborg IF,4830,11,5,3,14,25,45,-20,18
Brondby,4831,1,21,6,3,70,32,38,69
FC Midtjylla,4831,2,20,6,4,64,37,27,66
FC Nords,4831,3,13,9,8,72,49,23,48
Copenhagen,4831,4,13,5,12,58,49,9,44
AaB,4831,5,7,14,9,41,43,-2,35
Sonderjyske,4831,6,8,6,10,28,29,-1,30
AC Horsens,4831,7,6,12,12,35,56,-21,30
Lyngby,4831,8,4,9,11,31,46,-15,21
Silkeborg IF,4831,9,6,3,13,26,44,-18,21
Randers FC,4831,10,5,6,13,25,44,-19,21
AGF Aarhus,4831,11,4,6,12,16,37,-21,18
Brondby,4832,1,21,7,2,74,32,42,70
FC Midtjylla,4832,2,19,5,6,65,41,24,62
FC Nords,4832,3,15,7,8,75,49,26,52
Copenhagen,4832,4,13,5,12,53,45,8,44
AaB,4832,5,8,12,10,37,40,-3,36
Sonderjyske,4832,6,8,6,10,28,29,-1,30
AC Horsens,4832,7,6,12,12,32,55,-23,30
Randers FC,4832,8,6,6,12,24,39,-15,24
Silkeborg IF,4832,9,6,3,13,26,44,-18,21
Lyngby,4832,10,3,9,12,26,45,-19,18
AGF Aarhus,4832,11,4,6,12,16,37,-21,18
Brondby,4833,1,20,5,5,75,37,38,65
FC Midtjylla,4833,2,19,6,5,66,38,28,63
Copenhagen,4833,3,15,5,10,60,46,14,50
FC Nords,4833,4,14,7,9,78,57,21,49
AC Horsens,4833,5,7,13,10,39,56,-17,34
AaB,4833,6,7,12,11,36,46,-10,33
Sonderjyske,4833,7,8,6,10,28,29,-1,30
Randers FC,4833,8,6,6,12,25,40,-15,24
AGF Aarhus,4833,9,5,6,11,18,37,-19,21
Lyngby,4833,10,3,9,12,27,46,-19,18
Silkeborg IF,4833,11,5,3,14,26,46,-20,18
Brondby,4834,1,21,6,3,71,32,39,69
FC Midtjylla,4834,2,18,6,6,66,43,23,60
FC Nords,4834,3,14,8,8,74,53,21,50
Copenhagen,4834,4,15,4,11,61,46,15,49
AaB,4834,5,7,13,10,36,43,-7,34
AC Horsens,4834,6,6,13,11,33,50,-17,31
Sonderjyske,4834,7,8,6,10,28,29,-1,30
Silkeborg IF,4834,8,6,3,13,29,44,-15,21
Lyngby,4834,9,4,9,11,27,44,-17,21
Randers FC,4834,10,5,6,13,23,40,-17,21
AGF Aarhus,4834,11,4,6,12,16,40,-24,18
Brondby,4835,1,21,7,2,69,28,41,70
FC Midtjylla,4835,2,17,6,7,65,49,16,57
FC Nords,4835,3,15,6,9,78,52,26,51
Copenhagen,4835,4,14,5,11,61,47,14,47
AaB,4835,5,8,13,9,37,41,-4,37
AC Horsens,4835,6,6,13,11,32,51,-19,31
Sonderjyske,4835,7,8,6,10,28,29,-1,30
Lyngby,4835,8,4,9,11,28,45,-17,21
Randers FC,4835,9,5,6,13,24,41,-17,21
Silkeborg IF,4835,10,6,3,13,26,44,-18,21
AGF Aarhus,4835,11,4,6,12,16,37,-21,18
Brondby,4836,1,21,6,3,71,31,40,69
FC Midtjylla,4836,2,19,5,6,61,39,22,62
Copenhagen,4836,3,15,4,11,59,42,17,49
FC Nords,4836,4,12,7,11,67,55,12,43
AC Horsens,4836,5,8,13,9,37,48,-11,37
AaB,4836,6,7,13,10,37,43,-6,34
Sonderjyske,4836,7,8,6,10,28,29,-1,30
Randers FC,4836,8,5,7,12,25,41,-16,22
Lyngby,4836,9,3,10,11,28,46,-18,19
Silkeborg IF,4836,10,5,4,13,26,45,-19,19
AGF Aarhus,4836,11,4,7,11,17,37,-20,19
Brondby,4837,1,23,5,2,74,30,44,74
FC Midtjylla,4837,2,20,5,5,72,39,33,65
FC Nords,4837,3,15,6,9,74,52,22,51
Copenhagen,4837,4,13,5,12,55,46,9,44
AaB,4837,5,7,11,12,33,43,-10,32
Sonderjyske,4837,6,8,6,10,28,29,-1,30
AC Horsens,4837,7,6,12,12,36,60,-24,30
Randers FC,4837,8,6,6,12,25,40,-15,24
Silkeborg IF,4837,9,6,3,13,29,46,-17,21
Lyngby,4837,10,3,9,12,27,46,-19,18
AGF Aarhus,4837,11,4,6,12,18,40,-22,18
Brondby,4838,1,21,6,3,71,30,41,69
FC Midtjylla,4838,2,19,6,5,64,38,26,63
FC Nords,4838,3,14,6,10,75,55,20,48
Copenhagen,4838,4,14,5,11,58,45,13,47
AaB,4838,5,8,13,9,35,40,-5,37
Sonderjyske,4838,6,8,6,10,28,29,-1,30
AC Horsens,4838,7,5,14,11,34,55,-21,29
Lyngby,4838,8,4,9,11,28,45,-17,21
Silkeborg IF,4838,8,6,3,13,28,45,-17,21
Randers FC,4838,10,5,6,13,24,41,-17,21
AGF Aarhus,4838,11,4,6,12,17,39,-22,18
Brondby,4839,1,22,5,3,71,31,40,71
FC Midtjylla,4839,2,19,6,5,61,35,26,63
Copenhagen,4839,3,14,7,9,60,44,16,49
FC Nords,4839,4,13,8,9,75,55,20,47
AaB,4839,5,7,13,10,35,40,-5,34
Sonderjyske,4839,6,8,6,10,28,29,-1,30
AC Horsens,4839,7,5,13,12,31,54,-23,28
Randers FC,4839,8,6,6,12,25,40,-15,24
Silkeborg IF,4839,9,6,3,13,27,45,-18,21
Lyngby,4839,10,3,9,12,27,46,-19,18
AGF Aarhus,4839,11,4,6,12,17,38,-21,18
Brondby,4840,1,20,7,3,71,35,36,67
FC Midtjylla,4840,2,20,6,4,72,38,34,66
FC Nords,4840,3,16,6,8,75,48,27,54
Copenhagen,4840,4,13,7,10,57,45,12,46
AC Horsens,4840,5,6,13,11,38,60,-22,31
Sonderjyske,4840,6,8,6,10,28,29,-1,30
AaB,4840,7,6,11,13,32,45,-13,29
Randers FC,4840,8,6,6,12,26,39,-13,24
Silkeborg IF,4840,9,6,3,13,29,46,-17,21
Lyngby,4840,10,3,9,12,26,47,-21,18
AGF Aarhus,4840,11,4,6,12,18,40,-22,18
Brondby,4841,1,21,6,3,75,34,41,69
FC Midtjylla,4841,2,20,5,5,62,37,25,65
Copenhagen,4841,3,17,4,9,62,40,22,55
FC Nords,4841,4,12,7,11,69,54,15,43
AaB,4841,5,7,12,11,36,45,-9,33
Sonderjyske,4841,6,8,6,10,28,29,-1,30
AC Horsens,4841,7,5,14,11,32,52,-20,29
Randers FC,4841,8,5,7,12,24,40,-16,22
Lyngby,4841,9,3,10,11,27,45,-18,19
Silkeborg IF,4841,10,5,4,13,25,44,-19,19
AGF Aarhus,4841,11,4,7,11,16,36,-20,19
Brondby,4842,1,19,5,6,69,39,30,62
FC Midtjylla,4842,2,19,5,6,65,38,27,62
Copenhagen,4842,3,15,4,11,61,43,18,49
FC Nords,4842,4,14,6,10,73,57,16,48
AaB,4842,5,10,11,9,38,39,-1,41
AC Horsens,4842,6,7,13,10,33,49,-16,34
Sonderjyske,4842,7,8,6,10,28,29,-1,30
Lyngby,4842,8,4,9,11,29,44,-15,21
Randers FC,4842,9,5,6,13,23,42,-19,21
AGF Aarhus,4842,10,5,6,11,17,36,-19,21
Silkeborg IF,4842,11,5,3,14,25,45,-20,18
FC Midtjylla,4843,1,20,5,5,65,39,26,65
Brondby,4843,2,18,7,5,68,36,32,61
FC Nords,4843,3,15,8,7,75,49,26,53
Copenhagen,4843,4,14,6,10,56,42,14,48
AaB,4843,5,6,14,10,35,42,-7,32
AC Horsens,4843,6,6,14,10,33,50,-17,32
Sonderjyske,4843,7,8,6,10,28,29,-1,30
Randers FC,4843,8,5,7,12,24,40,-16,22
Silkeborg IF,4843,9,6,3,13,26,44,-18,21
Lyngby,4843,10,3,10,11,27,45,-18,19
AGF Aarhus,4843,11,4,6,12,16,37,-21,18
Brondby,4844,1,21,7,2,72,31,41,70
FC Midtjylla,4844,2,21,4,5,69,39,30,67
FC Nords,4844,3,13,6,11,71,56,15,45
Copenhagen,4844,4,13,6,11,59,48,11,45
AaB,4844,5,7,14,9,39,44,-5,35
Sonderjyske,4844,6,8,6,10,28,29,-1,30
AC Horsens,4844,7,5,15,10,31,49,-18,30
Randers FC,4844,8,5,7,12,24,40,-16,22
Lyngby,4844,9,3,10,11,27,45,-18,19
Silkeborg IF,4844,10,5,4,13,26,45,-19,19
AGF Aarhus,4844,11,4,7,11,17,37,-20,19
Brondby,4845,1,21,6,3,72,33,39,69
FC Midtjylla,4845,2,21,5,4,66,36,30,68
FC Nords,4845,3,13,9,8,73,53,20,48
Copenhagen,4845,4,14,4,12,54,46,8,46
AaB,4845,5,8,11,11,45,46,-1,35
Sonderjyske,4845,6,8,6,10,28,29,-1,30
AC Horsens,4845,7,5,13,12,33,55,-22,28
Lyngby,4845,8,4,9,11,27,44,-17,21
Silkeborg IF,4845,8,6,3,13,27,44,-17,21
Randers FC,4845,10,5,6,13,23,40,-17,21
AGF Aarhus,4845,11,4,6,12,16,38,-22,18
Brondby,4846,1,19,7,4,69,34,35,64
FC Midtjylla,4846,2,17,6,7,64,44,20,57
FC Nords,4846,3,15,7,8,78,52,26,52
Copenhagen,4846,4,15,5,10,59,44,15,50
AC Horsens,4846,5,7,14,9,34,51,-17,35
AaB,4846,6,7,13,10,37,42,-5,34
Sonderjyske,4846,7,8,6,10,28,29,-1,30
Randers FC,4846,8,6,6,12,25,39,-14,24
Silkeborg IF,4846,9,6,3,13,26,44,-18,21
Lyngby,4846,10,3,9,12,26,46,-20,18
AGF Aarhus,4846,11,4,6,12,16,37,-21,18
Brondby,4847,1,22,5,3,74,31,43,71
FC Midtjylla,4847,2,18,4,8,63,42,21,58
Copenhagen,4847,3,16,4,10,57,41,16,52
FC Nords,4847,4,14,7,9,76,54,22,49
AaB,4847,5,8,12,10,37,42,-5,36
Sonderjyske,4847,6,8,6,10,28,29,-1,30
AC Horsens,4847,7,6,12,12,34,57,-23,30
Randers FC,4847,8,6,6,12,24,39,-15,24
Silkeborg IF,4847,9,6,3,13,26,44,-18,21
Lyngby,4847,10,3,9,12,26,45,-19,18
AGF Aarhus,4847,11,4,6,12,16,37,-21,18
Brondby,4848,1,21,7,2,78,35,43,70
FC Midtjylla,4848,2,19,5,6,68,40,28,62
FC Nords,4848,3,14,8,8,75,51,24,50
Copenhagen,4848,4,13,5,12,56,49,7,44
AaB,4848,5,8,12,10,39,42,-3,36
AC Horsens,4848,6,6,13,11,35,60,-25,31
Sonderjyske,4848,7,8,6,10,28,29,-1,30
Lyngby,4848,8,4,9,11,28,44,-16,21
Randers FC,4848,9,5,6,13,23,41,-18,21
AGF Aarhus,4848,10,5,6,11,18,37,-19,21
Silkeborg IF,4848,11,5,3,14,26,46,-20,18
FC Midtjylla,4849,1,19,6,5,68,40,28,63
Brondby,4849,2,18,6,6,67,39,28,60
FC Nords,4849,3,14,7,9,74,54,20,49
Copenhagen,4849,4,15,4,11,58,44,14,49
AaB,4849,5,8,13,9,39,41,-2,37
AC Horsens,4849,6,7,14,9,36,50,-14,35
Sonderjyske,4849,7,8,6,10,28,29,-1,30
Lyngby,4849,8,4,9,11,27,44,-17,21
Silkeborg IF,4849,8,6,3,13,27,44,-17,21
Randers FC,4849,10,5,6,13,23,40,-17,21
AGF Aarhus,4849,11,4,6,12,16,38,-22,18
Brondby,4850,1,22,5,3,72,32,40,71
FC Midtjylla,4850,2,18,6,6,64,42,22,60
FC Nords,4850,3,13,9,8,72,55,17,48
Copenhagen,4850,4,13,7,10,55,41,14,46
AC Horsens,4850,5,7,14,9,35,48,-13,35
AaB,4850,6,7,11,12,41,47,-6,32
Sonderjyske,4850,7,8,6,10,28,29,-1,30
Lyngby,4850,8,4,9,11,28,44,-16,21
Silkeborg IF,4850,9,6,3,13,27,45,-18,21
Randers FC,4850,10,5,6,13,23,41,-18,21
AGF Aarhus,4850,11,4,6,12,17,38,-21,18
Brondby,4851,1,22,6,2,74,30,44,72
FC Midtjylla,4851,2,19,4,7,66,42,24,61
FC Nords,4851,3,15,6,9,75,52,23,51
Copenhagen,4851,4,14,5,11,59,45,14,47
AaB,4851,5,8,11,11,37,46,-9,35
Sonderjyske,4851,6,8,6,10,28,29,-1,30
AC Horsens,4851,7,6,12,12,34,56,-22,30
Lyngby,4851,8,4,9,11,28,45,-17,21
Randers FC,4851,9,5,6,13,24,41,-17,21
Silkeborg IF,4851,10,5,4,13,26,45,-19,19
AGF Aarhus,4851,11,4,7,11,17,37,-20,19
Brondby,4852,1,22,6,2,74,32,42,72
FC Midtjylla,4852,2,18,6,6,63,39,24,60
FC Nords,4852,3,12,9,9,68,49,19,45
Copenhagen,4852,4,13,5,12,54,48,6,44
AaB,4852,5,8,13,9,35,38,-3,37
AC Horsens,4852,6,7,13,10,35,49,-14,34
Sonderjyske,4852,7,8,6,10,28,29,-1,30
Randers FC,4852,8,6,6,12,25,39,-14,24
Silkeborg IF,4852,9,5,4,13,27,46,-19,19
AGF Aarhus,4852,10,4,7,11,18,38,-20,19
Lyngby,4852,11,3,9,12,26,46,-20,18
Brondby,4853,1,21,6,3,70,33,37,69
FC Midtjylla,4853,2,20,5,5,69,37,32,65
FC Nords,4853,3,14,7,9,74,55,19,49
Copenhagen,4853,4,14,6,10,62,45,17,48
AaB,4853,5,6,13,11,35,45,-10,31
AC Horsens,4853,6,6,13,11,34,55,-21,31
Sonderjyske,4853,7,8,6,10,28,29,-1,30
Randers FC,4853,8,6,6,12,25,40,-15,24
Silkeborg IF,4853,9,6,3,13,29,46,-17,21
Lyngby,4853,10,3,9,12,27,46,-19,18
AGF Aarhus,4853,11,4,6,12,18,40,-22,18
Brondby,4854,1,21,6,3,75,30,45,69
FC Midtjylla,4854,2,20,6,4,67,40,27,66
FC Nords,4854,3,13,7,10,71,56,15,46
Copenhagen,4854,4,12,7,11,54,47,7,43
AaB,4854,5,8,13,9,39,42,-3,37
AC Horsens,4854,6,6,13,11,39,56,-17,31
Sonderjyske,4854,7,8,6,10,28,29,-1,30
Lyngby,4854,8,4,9,11,28,45,-17,21
Randers FC,4854,9,5,6,13,24,41,-17,21
Silkeborg IF,4854,10,5,4,13,25,44,-19,19
AGF Aarhus,4854,11,4,7,11,16,36,-20,19
Brondby,4855,1,22,6,2,79,35,44,72
FC Midtjylla,4855,2,20,4,6,69,37,32,64
Copenhagen,4855,3,15,4,11,58,42,16,49
FC Nords,4855,4,14,6,10,69,57,12,48
AaB,4855,5,7,11,12,39,47,-8,32
AC Horsens,4855,6,6,13,11,35,57,-22,31
Sonderjyske,4855,7,8,6,10,28,29,-1,30
Randers FC,4855,8,6,6,12,25,40,-15,24
Silkeborg IF,4855,9,5,4,13,27,46,-19,19
AGF Aarhus,4855,10,4,7,11,18,38,-20,19
Lyngby,4855,11,3,9,12,27,46,-19,18
Brondby,4856,1,19,6,5,68,40,28,63
FC Midtjylla,4856,2,19,5,6,62,43,19,62
FC Nords,4856,3,15,8,7,73,48,25,53
Copenhagen,4856,4,15,4,11,61,43,18,49
AaB,4856,5,9,11,10,40,39,1,38
Sonderjyske,4856,6,8,6,10,28,29,-1,30
AC Horsens,4856,7,6,12,12,36,53,-17,30
Randers FC,4856,8,6,6,12,24,39,-15,24
Silkeborg IF,4856,9,5,4,13,27,46,-19,19
AGF Aarhus,4856,10,4,7,11,18,38,-20,19
Lyngby,4856,11,3,9,12,26,45,-19,18
FC Midtjylla,4857,1,20,4,6,69,41,28,64
Brondby,4857,2,19,6,5,67,36,31,63
Copenhagen,4857,3,15,6,9,64,44,20,51
FC Nords,4857,4,12,9,9,71,54,17,45
AaB,4857,5,9,11,10,39,43,-4,38
AC Horsens,4857,6,6,14,10,35,53,-18,32
Sonderjyske,4857,7,8,6,10,28,29,-1,30
Lyngby,4857,8,4,9,11,27,44,-17,21
Silkeborg IF,4857,8,6,3,13,27,44,-17,21
Randers FC,4857,10,5,6,13,23,40,-17,21
AGF Aarhus,4857,11,4,6,12,16,38,-22,18
Brondby,4858,1,20,6,4,71,38,33,66
FC Midtjylla,4858,2,20,5,5,69,41,28,65
FC Nords,4858,3,16,6,8,81,49,32,54
Copenhagen,4858,4,12,5,13,53,46,7,41
AaB,4858,5,9,11,10,39,45,-6,38
AC Horsens,4858,6,6,13,11,37,57,-20,31
Sonderjyske,4858,7,8,6,10,28,29,-1,30
Lyngby,4858,8,4,9,11,30,44,-14,21
AGF Aarhus,4858,9,5,6,11,18,36,-18,21
Randers FC,4858,10,5,6,13,23,43,-20,21
Silkeborg IF,4858,11,5,3,14,25,46,-21,18
Brondby,4859,1,22,5,3,75,30,45,71
FC Midtjylla,4859,2,18,5,7,58,42,16,59
Copenhagen,4859,3,16,4,10,60,42,18,52
FC Nords,4859,4,14,6,10,69,50,19,48
AaB,4859,5,8,12,10,38,45,-7,36
Sonderjyske,4859,6,8,6,10,28,29,-1,30
AC Horsens,4859,7,6,12,12,34,51,-17,30
Randers FC,4859,8,5,7,12,24,40,-16,22
AGF Aarhus,4859,9,5,6,11,18,36,-18,21
Lyngby,4859,10,3,10,11,27,45,-18,19
Silkeborg IF,4859,11,5,3,14,25,46,-21,18
Brondby,4860,1,21,5,4,68,29,39,68
FC Midtjylla,4860,2,18,6,6,67,43,24,60
FC Nords,4860,3,15,6,9,74,51,23,51
Copenhagen,4860,4,13,5,12,59,52,7,44
AC Horsens,4860,5,9,12,9,42,52,-10,39
AaB,4860,6,7,12,11,34,43,-9,33
Sonderjyske,4860,7,8,6,10,28,29,-1,30
Randers FC,4860,8,6,6,12,24,39,-15,24
Silkeborg IF,4860,9,6,3,13,28,45,-17,21
Lyngby,4860,10,3,9,12,26,45,-19,18
AGF Aarhus,4860,11,4,6,12,17,39,-22,18
FC Midtjylla,4861,1,21,4,5,72,38,34,67
Brondby,4861,2,20,6,4,71,35,36,66
Copenhagen,4861,3,14,5,11,56,45,11,47
FC Nords,4861,4,12,8,10,68,53,15,44
AaB,4861,5,8,12,10,40,42,-2,36
AC Horsens,4861,6,7,13,10,32,52,-20,34
Sonderjyske,4861,7,8,6,10,28,29,-1,30
Lyngby,4861,8,4,9,11,29,44,-15,21
Silkeborg IF,4861,9,6,3,13,28,46,-18,21
Randers FC,4861,10,5,6,13,23,42,-19,21
AGF Aarhus,4861,11,4,6,12,18,39,-21,18
Brondby,4862,1,20,7,3,69,32,37,67
FC Midtjylla,4862,2,19,7,4,65,36,29,64
FC Nords,4862,3,15,6,9,75,53,22,51
Copenhagen,4862,4,14,5,11,57,43,14,47
AaB,4862,5,7,13,10,35,40,-5,34
Sonderjyske,4862,6,8,6,10,28,29,-1,30
AC Horsens,4862,7,6,12,12,33,56,-23,30
Lyngby,4862,8,4,9,11,29,45,-16,21
Silkeborg IF,4862,9,6,3,13,27,45,-18,21
Randers FC,4862,10,5,6,13,24,42,-18,21
AGF Aarhus,4862,11,4,6,12,17,38,-21,18
Brondby,4863,1,21,6,3,72,34,38,69
FC Midtjylla,4863,2,19,5,6,67,39,28,62
Copenhagen,4863,3,14,5,11,56,44,12,47
FC Nords,4863,4,12,7,11,71,57,14,43
AaB,4863,5,8,13,9,39,41,-2,37
AC Horsens,4863,6,8,12,10,37,53,-16,36
Sonderjyske,4863,7,8,6,10,28,29,-1,30
Lyngby,4863,8,4,9,11,28,44,-16,21
Silkeborg IF,4863,9,6,3,13,28,45,-17,21
Randers FC,4863,10,5,6,13,23,41,-18,21
AGF Aarhus,4863,11,4,6,12,17,39,-22,18
Brondby,4864,1,19,7,4,72,37,35,64
FC Midtjylla,4864,2,19,5,6,64,42,22,62
FC Nords,4864,3,14,8,8,77,54,23,50
Copenhagen,4864,4,15,5,10,61,46,15,50
AaB,4864,5,8,12,10,37,41,-4,36
Sonderjyske,4864,6,8,6,10,28,29,-1,30
AC Horsens,4864,7,5,15,10,36,53,-17,30
Lyngby,4864,8,4,9,11,27,44,-17,21
Randers FC,4864,9,5,6,13,23,40,-17,21
Silkeborg IF,4864,10,5,4,13,27,46,-19,19
AGF Aarhus,4864,11,4,7,11,18,38,-20,19
Brondby,4865,1,20,6,4,70,32,38,66
FC Midtjylla,4865,2,20,4,6,63,39,24,64
FC Nords,4865,3,15,7,8,75,51,24,52
Copenhagen,4865,4,13,5,12,57,44,13,44
AaB,4865,5,8,12,10,38,46,-8,36
AC Horsens,4865,6,5,16,9,35,52,-17,31
Sonderjyske,4865,7,8,6,10,28,29,-1,30
Randers FC,4865,8,6,6,12,25,40,-15,24
Silkeborg IF,4865,9,5,4,13,26,45,-19,19
AGF Aarhus,4865,10,4,7,11,17,37,-20,19
Lyngby,4865,11,3,9,12,27,46,-19,18
Brondby,4866,1,21,6,3,75,32,43,69
FC Midtjylla,4866,2,18,7,5,64,40,24,61
Copenhagen,4866,3,14,6,10,58,45,13,48
FC Nords,4866,4,12,8,10,69,55,14,44
AC Horsens,4866,5,7,14,9,40,54,-14,35
AaB,4866,6,7,13,10,42,48,-6,34
Sonderjyske,4866,7,8,6,10,28,29,-1,30
Lyngby,4866,8,4,9,11,29,44,-15,21
Silkeborg IF,4866,9,6,3,13,27,45,-18,21
Randers FC,4866,10,5,6,13,23,42,-19,21
AGF Aarhus,4866,11,4,6,12,17,38,-21,18
Brondby,4867,1,20,6,4,70,35,35,66
FC Midtjylla,4867,2,19,5,6,64,40,24,62
FC Nords,4867,3,13,7,10,71,55,16,46
Copenhagen,4867,4,14,4,12,59,49,10,46
AC Horsens,4867,5,9,13,8,41,50,-9,40
AaB,4867,6,8,11,11,42,44,-2,35
Sonderjyske,4867,7,8,6,10,28,29,-1,30
Lyngby,4867,8,4,9,11,28,45,-17,21
Silkeborg IF,4867,9,6,3,13,27,44,-17,21
Randers FC,4867,10,5,6,13,24,41,-17,21
AGF Aarhus,4867,11,4,6,12,16,38,-22,18
Brondby,4868,1,22,5,3,70,31,39,71
FC Midtjylla,4868,2,19,6,5,67,37,30,63
Copenhagen,4868,3,15,5,10,58,42,16,50
FC Nords,4868,4,13,7,10,73,56,17,46
AaB,4868,5,8,12,10,36,41,-5,36
Sonderjyske,4868,6,8,6,10,28,29,-1,30
AC Horsens,4868,7,5,13,12,34,57,-23,28
Lyngby,4868,8,4,9,11,30,47,-17,21
Randers FC,4868,9,5,6,13,26,43,-17,21
AGF Aarhus,4868,10,5,6,11,17,36,-19,21
Silkeborg IF,4868,11,5,3,14,25,45,-20,18
Brondby,4869,1,21,6,3,73,31,42,69
FC Midtjylla,4869,2,20,5,5,65,37,28,65
FC Nords,4869,3,14,7,9,75,56,19,49
Copenhagen,4869,4,13,7,10,57,44,13,46
AaB,4869,5,7,12,11,36,45,-9,33
AC Horsens,4869,6,6,13,11,35,54,-19,31
Sonderjyske,4869,7,8,6,10,28,29,-1,30
Lyngby,4869,8,4,9,11,31,46,-15,21
Silkeborg IF,4869,9,6,3,13,26,44,-18,21
Randers FC,4869,10,5,6,13,25,44,-19,21
AGF Aarhus,4869,11,4,6,12,16,37,-21,18
Brondby,4870,1,22,5,3,74,29,45,71
FC Midtjylla,4870,2,20,4,6,65,41,24,64
FC Nords,4870,3,15,6,9,75,54,21,51
Copenhagen,4870,4,14,4,12,59,48,11,46
AC Horsens,4870,5,7,12,11,33,50,-17,33
AaB,4870,6,7,11,12,35,45,-10,32
Sonderjyske,4870,7,8,6,10,28,29,-1,30
Randers FC,4870,8,6,6,12,24,39,-15,24
AGF Aarhus,4870,9,5,6,11,18,36,-18,21
Lyngby,4870,10,3,9,12,26,45,-19,18
Silkeborg IF,4870,11,5,3,14,25,46,-21,18
Brondby,4871,1,19,6,5,62,30,32,63
FC Midtjylla,4871,2,19,5,6,64,39,25,62
FC Nords,4871,3,16,6,8,79,54,25,54
Copenhagen,4871,4,15,5,10,59,44,15,50
AaB,4871,5,9,12,9,41,43,-2,39
Sonderjyske,4871,6,8,6,10,28,29,-1,30
AC Horsens,4871,7,5,12,13,31,52,-21,27
Randers FC,4871,8,6,6,12,24,39,-15,24
Silkeborg IF,4871,9,5,4,13,26,45,-19,19
AGF Aarhus,4871,10,4,7,11,17,37,-20,19
Lyngby,4871,11,3,9,12,26,45,-19,18
Brondby,4872,1,18,9,3,64,30,34,63
FC Midtjylla,4872,2,18,6,6,66,40,26,60
FC Nords,4872,3,15,7,8,81,54,27,52
Copenhagen,4872,4,15,4,11,57,42,15,49
AC Horsens,4872,5,7,14,9,36,52,-16,35
AaB,4872,6,7,12,11,32,44,-12,33
Sonderjyske,4872,7,8,6,10,28,29,-1,30
Randers FC,4872,8,5,7,12,23,39,-16,22
Silkeborg IF,4872,9,6,3,13,28,46,-18,21
Lyngby,4872,10,3,10,11,26,44,-18,19
AGF Aarhus,4872,11,4,6,12,18,39,-21,18
Brondby,4873,1,22,6,2,75,34,41,72
FC Midtjylla,4873,2,19,5,6,66,44,22,62
FC Nords,4873,3,14,6,10,73,51,22,48
Copenhagen,4873,4,12,5,13,56,52,4,41
AaB,4873,5,8,13,9,40,43,-3,37
AC Horsens,4873,6,6,15,9,38,50,-12,33
Sonderjyske,4873,7,8,6,10,28,29,-1,30
Lyngby,4873,8,4,9,11,29,44,-15,21
Silkeborg IF,4873,9,6,3,13,28,46,-18,21
Randers FC,4873,10,5,6,13,23,42,-19,21
AGF Aarhus,4873,11,4,6,12,18,39,-21,18
Brondby,4874,1,20,6,4,69,33,36,66
FC Midtjylla,4874,2,18,6,6,67,43,24,60
FC Nords,4874,3,16,6,8,77,52,25,54
Copenhagen,4874,4,13,6,11,62,47,15,45
AaB,4874,5,8,13,9,37,42,-5,37
AC Horsens,4874,6,6,13,11,34,55,-21,31
Sonderjyske,4874,7,8,6,10,28,29,-1,30
Silkeborg IF,4874,8,6,3,13,29,44,-15,21
Lyngby,4874,9,4,9,11,29,46,-17,21
Randers FC,4874,10,5,6,13,25,42,-17,21
AGF Aarhus,4874,11,4,6,12,16,40,-24,18
Brondby,4875,1,21,5,4,69,34,35,68
FC Midtjylla,4875,2,20,4,6,67,39,28,64
FC Nords,4875,3,14,7,9,73,49,24,49
Copenhagen,4875,4,14,5,11,60,47,13,47
AaB,4875,5,7,13,10,36,41,-5,34
AC Horsens,4875,6,7,12,11,37,58,-21,33
Sonderjyske,4875,7,8,6,10,28,29,-1,30
Randers FC,4875,8,6,6,12,24,39,-15,24
Silkeborg IF,4875,9,5,4,13,26,45,-19,19
AGF Aarhus,4875,10,4,7,11,17,37,-20,19
Lyngby,4875,11,3,9,12,26,45,-19,18
Brondby,4876,1,23,5,2,70,28,42,74
FC Midtjylla,4876,2,19,5,6,63,39,24,62
FC Nords,4876,3,15,6,9,73,51,22,51
Copenhagen,4876,4,14,4,12,54,45,9,46
AaB,4876,5,7,13,10,40,40,0,34
Sonderjyske,4876,6,8,6,10,28,29,-1,30
AC Horsens,4876,7,5,13,12,35,58,-23,28
Randers FC,4876,8,6,6,12,25,39,-14,24
Silkeborg IF,4876,9,6,3,13,29,45,-16,21
Lyngby,4876,10,3,9,12,26,46,-20,18
AGF Aarhus,4876,11,4,6,12,17,40,-23,18
Brondby,4877,1,21,6,3,70,34,36,69
FC Midtjylla,4877,2,20,6,4,68,37,31,66
FC Nords,4877,3,13,10,7,75,48,27,49
Copenhagen,4877,4,12,7,11,55,49,6,43
AC Horsens,4877,5,6,14,10,38,55,-17,32
AaB,4877,6,6,13,11,37,46,-9,31
Sonderjyske,4877,7,8,6,10,28,29,-1,30
Lyngby,4877,8,4,9,11,27,44,-17,21
Randers FC,4877,9,5,6,13,23,40,-17,21
Silkeborg IF,4877,10,6,3,13,27,45,-18,21
AGF Aarhus,4877,11,4,6,12,17,38,-21,18
FC Midtjylla,4878,1,20,5,5,63,36,27,65
Brondby,4878,2,18,6,6,67,37,30,60
FC Nords,4878,3,15,7,8,71,47,24,52
Copenhagen,4878,4,14,5,11,59,48,11,47
AaB,4878,5,8,11,11,39,45,-6,35
AC Horsens,4878,6,7,14,9,36,48,-12,35
Sonderjyske,4878,7,8,6,10,28,29,-1,30
Lyngby,4878,8,4,9,11,30,45,-15,21
Silkeborg IF,4878,9,6,3,13,28,44,-16,21
Randers FC,4878,10,5,6,13,24,43,-19,21
AGF Aarhus,4878,11,4,6,12,16,39,-23,18
Brondby,4879,1,21,6,3,69,29,40,69
FC Midtjylla,4879,2,19,4,7,61,42,19,61
Copenhagen,4879,3,15,5,10,57,41,16,50
FC Nords,4879,4,14,6,10,73,50,23,48
AaB,4879,5,8,11,11,40,45,-5,35
AC Horsens,4879,6,7,12,11,35,54,-19,33
Sonderjyske,4879,7,8,6,10,28,29,-1,30
Lyngby,4879,8,4,9,11,28,45,-17,21
Randers FC,4879,9,5,6,13,24,41,-17,21
AGF Aarhus,4879,10,5,6,11,17,36,-19,21
Silkeborg IF,4879,11,5,3,14,25,45,-20,18
Brondby,4880,1,20,6,4,70,31,39,66
FC Midtjylla,4880,2,19,4,7,59,37,22,61
Copenhagen,4880,3,15,5,10,58,42,16,50
FC Nords,4880,4,14,6,10,68,53,15,48
AaB,4880,5,9,12,9,38,39,-1,39
AC Horsens,4880,6,6,13,11,34,51,-17,31
Sonderjyske,4880,7,8,6,10,28,29,-1,30
Randers FC,4880,8,6,6,12,24,39,-15,24
AGF Aarhus,4880,9,5,6,11,18,37,-19,21
Lyngby,4880,10,3,9,12,26,45,-19,18
Silkeborg IF,4880,11,5,3,14,26,46,-20,18
Brondby,4881,1,21,6,3,72,32,40,69
FC Midtjylla,4881,2,20,5,5,68,43,25,65
FC Nords,4881,3,15,7,8,76,53,23,52
Copenhagen,4881,4,14,6,10,58,43,15,48
Sonderjyske,4881,5,8,6,10,28,29,-1,30
AaB,4881,6,6,12,12,38,48,-10,30
AC Horsens,4881,7,6,12,12,35,54,-19,30
Lyngby,4881,8,4,9,11,29,45,-16,21
Randers FC,4881,9,5,6,13,24,42,-18,21
AGF Aarhus,4881,10,5,6,11,17,36,-19,21
Silkeborg IF,4881,11,5,3,14,25,45,-20,18
Brondby,4882,1,20,7,3,71,33,38,67
FC Midtjylla,4882,2,20,5,5,67,37,30,65
FC Nords,4882,3,14,6,10,73,52,21,48
Copenhagen,4882,4,13,5,12,52,46,6,44
AaB,4882,5,9,12,9,41,42,-1,39
AC Horsens,4882,6,6,13,11,32,52,-20,31
Sonderjyske,4882,7,8,6,10,28,29,-1,30
Randers FC,4882,8,5,7,12,24,40,-16,22
AGF Aarhus,4882,9,5,6,11,18,36,-18,21
Lyngby,4882,10,3,10,11,27,45,-18,19
Silkeborg IF,4882,11,5,3,14,25,46,-21,18
Brondby,4883,1,21,6,3,74,35,39,69
FC Midtjylla,4883,2,21,4,5,74,38,36,67
Copenhagen,4883,3,16,4,10,62,44,18,52
FC Nords,4883,4,13,7,10,69,59,10,46
AaB,4883,5,7,12,11,34,41,-7,33
Sonderjyske,4883,6,8,6,10,28,29,-1,30
AC Horsens,4883,7,5,13,12,33,55,-22,28
Lyngby,4883,8,4,9,11,28,45,-17,21
Randers FC,4883,9,5,6,13,24,41,-17,21
AGF Aarhus,4883,10,5,6,11,17,36,-19,21
Silkeborg IF,4883,11,5,3,14,25,45,-20,18
Brondby,4884,1,21,5,4,65,30,35,68
FC Midtjylla,4884,2,21,5,4,66,34,32,68
FC Nords,4884,3,15,6,9,71,51,20,51
Copenhagen,4884,4,13,5,12,55,44,11,44
AaB,4884,5,8,11,11,38,42,-4,35
Sonderjyske,4884,6,8,6,10,28,29,-1,30
AC Horsens,4884,7,6,12,12,34,54,-20,30
Randers FC,4884,8,5,7,12,25,41,-16,22
AGF Aarhus,4884,9,5,6,11,17,36,-19,21
Lyngby,4884,10,3,10,11,28,46,-18,19
Silkeborg IF,4884,11,5,3,14,25,45,-20,18
Brondby,4885,1,21,5,4,73,32,41,68
FC Midtjylla,4885,2,20,6,4,67,39,28,66
Copenhagen,4885,3,13,7,10,55,41,14,46
FC Nords,4885,4,12,7,11,71,58,13,43
AaB,4885,5,8,12,10,39,45,-6,36
AC Horsens,4885,6,7,13,10,35,51,-16,34
Sonderjyske,4885,7,8,6,10,28,29,-1,30
Randers FC,4885,8,5,7,12,23,39,-16,22
Lyngby,4885,9,3,10,11,26,44,-18,19
Silkeborg IF,4885,10,5,4,13,26,45,-19,19
AGF Aarhus,4885,11,4,7,11,17,37,-20,19
Brondby,4886,1,20,7,3,69,33,36,67
FC Midtjylla,4886,2,19,5,6,63,38,25,62
FC Nords,4886,3,13,8,9,75,54,21,47
Copenhagen,4886,4,13,4,13,55,48,7,43
AaB,4886,5,9,12,9,41,42,-1,39
AC Horsens,4886,6,8,12,10,37,51,-14,36
Sonderjyske,4886,7,8,6,10,28,29,-1,30
Lyngby,4886,8,4,9,11,29,44,-15,21
Silkeborg IF,4886,9,6,3,13,27,44,-17,21
Randers FC,4886,10,5,6,13,23,42,-19,21
AGF Aarhus,4886,11,4,6,12,16,38,-22,18
Brondby,4887,1,20,8,2,74,34,40,68
FC Midtjylla,4887,2,20,5,5,67,39,28,65
FC Nords,4887,3,14,8,8,74,52,22,50
Copenhagen,4887,4,14,5,11,58,46,12,47
AC Horsens,4887,5,6,14,10,37,53,-16,32
Sonderjyske,4887,6,8,6,10,28,29,-1,30
AaB,4887,7,6,12,12,34,46,-12,30
Lyngby,4887,8,4,9,11,27,44,-17,21
Silkeborg IF,4887,8,6,3,13,27,44,-17,21
Randers FC,4887,10,5,6,13,23,40,-17,21
AGF Aarhus,4887,11,4,6,12,16,38,-22,18
Brondby,4888,1,21,7,2,77,34,43,70
FC Midtjylla,4888,2,18,5,7,64,41,23,59
FC Nords,4888,3,15,6,9,70,52,18,51
Copenhagen,4888,4,14,5,11,57,44,13,47
AC Horsens,4888,5,7,13,10,38,55,-17,34
AaB,4888,6,7,12,11,37,43,-6,33
Sonderjyske,4888,7,8,6,10,28,29,-1,30
Lyngby,4888,8,4,9,11,28,44,-16,21
Silkeborg IF,4888,9,6,3,13,27,45,-18,21
Randers FC,4888,10,5,6,13,23,41,-18,21
AGF Aarhus,4888,11,4,6,12,17,38,-21,18
Brondby,4889,1,21,6,3,71,33,38,69
FC Midtjylla,4889,2,20,5,5,63,36,27,65
Copenhagen,4889,3,16,4,10,62,43,19,52
FC Nords,4889,4,13,6,11,71,54,17,45
AaB,4889,5,7,12,11,37,45,-8,33
AC Horsens,4889,6,6,13,11,36,55,-19,31
Sonderjyske,4889,7,8,6,10,28,29,-1,30
Randers FC,4889,8,5,7,12,23,39,-16,22
Silkeborg IF,4889,9,6,3,13,29,44,-15,21
Lyngby,4889,10,3,10,11,26,44,-18,19
AGF Aarhus,4889,11,4,6,12,16,40,-24,18
Brondby,4890,1,21,7,2,75,29,46,70
FC Midtjylla,4890,2,18,4,8,62,48,14,58
FC Nords,4890,3,15,8,7,77,51,26,53
Copenhagen,4890,4,13,5,12,57,44,13,44
AaB,4890,5,9,12,9,38,42,-4,39
Sonderjyske,4890,6,8,6,10,28,29,-1,30
AC Horsens,4890,7,6,12,12,31,52,-21,30
Lyngby,4890,8,4,9,11,27,44,-17,21
Randers FC,4890,9,5,6,13,23,40,-17,21
Silkeborg IF,4890,10,5,4,13,27,46,-19,19
AGF Aarhus,4890,11,4,7,11,18,38,-20,19
Brondby,4891,1,22,5,3,71,31,40,71
FC Midtjylla,4891,2,18,6,6,61,39,22,60
FC Nords,4891,3,14,7,9,72,50,22,49
Copenhagen,4891,4,12,7,11,52,42,10,43
AaB,4891,5,9,11,10,38,39,-1,38
AC Horsens,4891,6,6,14,10,34,53,-19,32
Sonderjyske,4891,7,8,6,10,28,29,-1,30
Randers FC,4891,8,5,7,12,23,39,-16,22
Silkeborg IF,4891,9,6,3,13,26,44,-18,21
Lyngby,4891,10,3,10,11,26,44,-18,19
AGF Aarhus,4891,11,4,6,12,16,37,-21,18
FC Midtjylla,4892,1,21,4,5,70,39,31,67
Brondby,4892,2,20,6,4,69,33,36,66
FC Nords,4892,3,14,7,9,75,53,22,49
Copenhagen,4892,4,13,4,13,52,47,5,43
AC Horsens,4892,5,8,13,9,40,54,-14,37
AaB,4892,6,7,12,11,38,44,-6,33
Sonderjyske,4892,7,8,6,10,28,29,-1,30
Lyngby,4892,8,4,9,11,28,45,-17,21
Silkeborg IF,4892,8,6,3,13,28,45,-17,21
Randers FC,4892,10,5,6,13,24,41,-17,21
AGF Aarhus,4892,11,4,6,12,17,39,-22,18
Brondby,4893,1,22,5,3,77,32,45,71
FC Midtjylla,4893,2,18,5,7,59,40,19,59
FC Nords,4893,3,15,6,9,76,51,25,51
Copenhagen,4893,4,15,4,11,58,47,11,49
AaB,4893,5,8,12,10,36,43,-7,36
Sonderjyske,4893,6,8,6,10,28,29,-1,30
AC Horsens,4893,7,6,12,12,33,52,-19,30
Lyngby,4893,8,4,9,11,28,44,-16,21
Randers FC,4893,9,5,6,13,23,41,-18,21
AGF Aarhus,4893,10,5,6,11,17,36,-19,21
Silkeborg IF,4893,11,5,3,14,25,45,-20,18
Brondby,4894,1,21,5,4,72,34,38,68
FC Midtjylla,4894,2,20,4,6,65,37,28,64
FC Nords,4894,3,14,7,9,74,55,19,49
Copenhagen,4894,4,14,5,11,57,45,12,47
AaB,4894,5,8,11,11,38,45,-7,35
AC Horsens,4894,6,6,14,10,38,54,-16,32
Sonderjyske,4894,7,8,6,10,28,29,-1,30
Lyngby,4894,8,4,9,11,28,44,-16,21
Silkeborg IF,4894,9,6,3,13,27,44,-17,21
Randers FC,4894,10,5,6,13,23,41,-18,21
AGF Aarhus,4894,11,4,6,12,16,38,-22,18
Brondby,4895,1,21,6,3,68,31,37,69
FC Midtjylla,4895,2,20,5,5,63,35,28,65
FC Nords,4895,3,15,6,9,70,47,23,51
Copenhagen,4895,4,13,5,12,54,43,11,44
AC Horsens,4895,5,7,13,10,33,49,-16,34
AaB,4895,6,7,11,12,34,43,-9,32
Sonderjyske,4895,7,8,6,10,28,29,-1,30
Randers FC,4895,8,6,6,12,24,39,-15,24
Silkeborg IF,4895,9,5,4,13,27,46,-19,19
AGF Aarhus,4895,10,4,7,11,18,38,-20,19
Lyngby,4895,11,3,9,12,26,45,-19,18
FC Midtjylla,4896,1,20,6,4,70,40,30,66
Brondby,4896,2,19,6,5,68,38,30,63
FC Nords,4896,3,16,6,8,77,51,26,54
Copenhagen,4896,4,13,5,12,59,49,10,44
AC Horsens,4896,5,7,13,10,44,59,-15,34
AaB,4896,6,7,12,11,36,43,-7,33
Sonderjyske,4896,7,8,6,10,28,29,-1,30
Randers FC,4896,8,5,7,12,25,41,-16,22
Silkeborg IF,4896,9,6,3,13,26,44,-18,21
Lyngby,4896,10,3,10,11,28,46,-18,19
AGF Aarhus,4896,11,4,6,12,16,37,-21,18
Brondby,4897,1,21,6,3,70,33,37,69
FC Midtjylla,4897,2,19,4,7,68,44,24,61
FC Nords,4897,3,15,6,9,78,53,25,51
Copenhagen,4897,4,15,5,10,62,43,19,50
AC Horsens,4897,5,7,13,10,37,52,-15,34
Sonderjyske,4897,6,8,6,10,28,29,-1,30
AaB,4897,7,6,12,12,35,51,-16,30
Lyngby,4897,8,4,9,11,28,45,-17,21
Randers FC,4897,9,5,6,13,24,41,-17,21
AGF Aarhus,4897,10,5,6,11,17,36,-19,21
Silkeborg IF,4897,11,5,3,14,25,45,-20,18
Brondby,4898,1,21,6,3,70,34,36,69
FC Midtjylla,4898,2,20,5,5,69,38,31,65
FC Nords,4898,3,15,7,8,78,51,27,52
Copenhagen,4898,4,14,4,12,59,47,12,46
AaB,4898,5,7,12,11,39,45,-6,33
Sonderjyske,4898,6,8,6,10,28,29,-1,30
AC Horsens,4898,7,6,12,12,34,60,-26,30
Lyngby,4898,8,4,9,11,27,44,-17,21
Randers FC,4898,9,5,6,13,23,40,-17,21
AGF Aarhus,4898,10,5,6,11,17,36,-19,21
Silkeborg IF,4898,11,5,3,14,25,45,-20,18
FC Midtjylla,4899,1,21,5,4,67,34,33,68
Brondby,4899,2,18,7,5,67,36,31,61
FC Nords,4899,3,16,6,8,80,51,29,54
Copenhagen,4899,4,14,5,11,56,45,11,47
AaB,4899,5,6,14,10,34,43,-9,32
Sonderjyske,4899,6,8,6,10,28,29,-1,30
AC Horsens,4899,7,5,15,10,34,55,-21,30
Randers FC,4899,8,5,7,12,24,40,-16,22
Silkeborg IF,4899,9,6,3,13,26,44,-18,21
Lyngby,4899,10,3,10,11,27,45,-18,19
AGF Aarhus,4899,11,4,6,12,16,37,-21,18
Brondby,4900,1,20,8,2,73,36,37,68
FC Midtjylla,4900,2,18,5,7,61,40,21,59
FC Nords,4900,3,14,8,8,73,50,23,50
Copenhagen,4900,4,13,6,11,56,44,12,45
AaB,4900,5,8,13,9,39,41,-2,37
AC Horsens,4900,6,7,12,11,35,52,-17,33
Sonderjyske,4900,7,8,6,10,28,29,-1,30
Lyngby,4900,8,4,9,11,28,44,-16,21
Silkeborg IF,4900,9,6,3,13,27,45,-18,21
Randers FC,4900,10,5,6,13,23,41,-18,21
AGF Aarhus,4900,11,4,6,12,17,38,-21,18
Brondby,4901,1,23,5,2,76,30,46,74
FC Midtjylla,4901,2,19,5,6,66,45,21,62
FC Nords,4901,3,15,6,9,74,52,22,51
Copenhagen,4901,4,14,5,11,59,45,14,47
AC Horsens,4901,5,6,14,10,33,51,-18,32
Sonderjyske,4901,6,8,6,10,28,29,-1,30
AaB,4901,7,6,11,13,35,46,-11,29
Lyngby,4901,8,4,9,11,27,44,-17,21
Randers FC,4901,9,5,6,13,23,40,-17,21
Silkeborg IF,4901,10,6,3,13,27,45,-18,21
AGF Aarhus,4901,11,4,6,12,17,38,-21,18
Brondby,4902,1,21,7,2,70,28,42,70
FC Midtjylla,4902,2,17,5,8,60,43,17,56
FC Nords,4902,3,15,7,8,74,49,25,52
Copenhagen,4902,4,15,4,11,61,45,16,49
AaB,4902,5,7,13,10,38,48,-10,34
AC Horsens,4902,6,6,14,10,31,47,-16,32
Sonderjyske,4902,7,8,6,10,28,29,-1,30
Randers FC,4902,8,6,6,12,24,39,-15,24
Silkeborg IF,4902,9,6,3,13,26,44,-18,21
Lyngby,4902,10,3,9,12,26,45,-19,18
AGF Aarhus,4902,11,4,6,12,16,37,-21,18
Brondby,4903,1,20,5,5,67,33,34,65
FC Midtjylla,4903,2,19,5,6,63,39,24,62
FC Nords,4903,3,14,8,8,72,54,18,50
Copenhagen,4903,4,15,4,11,59,46,13,49
AaB,4903,5,10,11,9,41,36,5,41
Sonderjyske,4903,6,8,6,10,28,29,-1,30
AC Horsens,4903,7,5,13,12,30,50,-20,28
Lyngby,4903,8,4,9,11,27,44,-17,21
Silkeborg IF,4903,8,6,3,13,27,44,-17,21
Randers FC,4903,10,5,6,13,23,40,-17,21
AGF Aarhus,4903,11,4,6,12,16,38,-22,18
Brondby,4904,1,19,7,4,68,33,35,64
FC Midtjylla,4904,2,19,6,5,66,42,24,63
FC Nords,4904,3,15,7,8,74,51,23,52
Copenhagen,4904,4,14,5,11,60,43,17,47
AaB,4904,5,7,14,9,36,40,-4,35
AC Horsens,4904,6,6,13,11,36,57,-21,31
Sonderjyske,4904,7,8,6,10,28,29,-1,30
Lyngby,4904,8,4,9,11,28,44,-16,21
Randers FC,4904,9,5,6,13,23,41,-18,21
AGF Aarhus,4904,10,5,6,11,18,36,-18,21
Silkeborg IF,4904,11,5,3,14,25,46,-21,18
FC Midtjylla,4905,1,21,4,5,70,40,30,67
Brondby,4905,2,20,6,4,69,36,33,66
FC Nords,4905,3,14,8,8,76,51,25,50
Copenhagen,4905,4,14,5,11,60,45,15,47
AaB,4905,5,7,12,11,38,46,-8,33
AC Horsens,4905,6,6,13,11,33,54,-21,31
Sonderjyske,4905,7,8,6,10,28,29,-1,30
Randers FC,4905,8,5,7,12,24,40,-16,22
AGF Aarhus,4905,9,5,6,11,17,36,-19,21
Lyngby,4905,10,3,10,11,27,45,-18,19
Silkeborg IF,4905,11,5,3,14,25,45,-20,18
Brondby,4906,1,22,5,3,70,32,38,71
FC Midtjylla,4906,2,18,5,7,62,41,21,59
FC Nords,4906,3,15,7,8,71,48,23,52
Copenhagen,4906,4,14,5,11,60,44,16,47
AaB,4906,5,6,15,9,37,43,-6,33
AC Horsens,4906,6,6,13,11,32,50,-18,31
Sonderjyske,4906,7,8,6,10,28,29,-1,30
Randers FC,4906,8,5,7,12,25,41,-16,22
Lyngby,4906,9,3,10,11,28,46,-18,19
Silkeborg IF,4906,10,5,4,13,25,44,-19,19
AGF Aarhus,4906,11,4,7,11,16,36,-20,19
Brondby,4907,1,20,7,3,72,34,38,67
FC Midtjylla,4907,2,19,4,7,64,43,21,61
Copenhagen,4907,3,14,6,10,59,44,15,48
FC Nords,4907,4,12,8,10,72,57,15,44
AaB,4907,5,10,12,8,40,37,3,42
Sonderjyske,4907,6,8,6,10,28,29,-1,30
AC Horsens,4907,7,5,15,10,36,54,-18,30
Randers FC,4907,8,5,7,12,24,40,-16,22
AGF Aarhus,4907,9,5,6,11,19,38,-19,21
Lyngby,4907,10,3,10,11,27,45,-18,19
Silkeborg IF,4907,11,5,3,14,27,47,-20,18
Brondby,4908,1,22,5,3,72,35,37,71
FC Midtjylla,4908,2,19,5,6,65,40,25,62
Copenhagen,4908,3,16,4,10,61,44,17,52
FC Nords,4908,4,14,7,9,76,54,22,49
AC Horsens,4908,5,7,12,11,35,50,-15,33
Sonderjyske,4908,6,8,6,10,28,29,-1,30
AaB,4908,7,6,11,13,38,50,-12,29
Randers FC,4908,8,5,7,12,25,41,-16,22
Silkeborg IF,4908,9,6,3,13,26,44,-18,21
Lyngby,4908,10,3,10,11,28,46,-18,19
AGF Aarhus,4908,11,4,6,12,16,37,-21,18
Brondby,4909,1,21,7,2,70,31,39,70
FC Midtjylla,4909,2,20,5,5,68,38,30,65
FC Nords,4909,3,14,6,10,76,54,22,48
Copenhagen,4909,4,13,6,11,59,52,7,45
AC Horsens,4909,5,7,13,10,36,52,-16,34
AaB,4909,6,7,11,12,37,45,-8,32
Sonderjyske,4909,7,8,6,10,28,29,-1,30
Lyngby,4909,8,4,9,11,30,44,-14,21
Randers FC,4909,9,5,6,13,23,43,-20,21
Silkeborg IF,4909,10,5,4,13,26,45,-19,19
AGF Aarhus,4909,11,4,7,11,17,37,-20,19
Brondby,4910,1,20,6,4,70,35,35,66
FC Midtjylla,4910,2,19,6,5,63,36,27,63
Copenhagen,4910,3,15,5,10,60,45,15,50
FC Nords,4910,4,14,6,10,74,53,21,48
AaB,4910,5,9,12,9,39,40,-1,39
Sonderjyske,4910,6,8,6,10,28,29,-1,30
AC Horsens,4910,7,5,13,12,31,54,-23,28
Lyngby,4910,8,4,9,11,27,44,-17,21
Randers FC,4910,9,5,6,13,23,40,-17,21
AGF Aarhus,4910,10,5,6,11,18,37,-19,21
Silkeborg IF,4910,11,5,3,14,26,46,-20,18
Brondby,4911,1,20,7,3,66,31,35,67
FC Midtjylla,4911,2,20,6,4,69,39,30,66
Copenhagen,4911,3,13,6,11,57,44,13,45
FC Nords,4911,4,12,7,11,71,56,15,43
AaB,4911,5,8,13,9,37,41,-4,37
AC Horsens,4911,6,5,17,8,39,54,-15,32
Sonderjyske,4911,7,8,6,10,28,29,-1,30
Lyngby,4911,8,4,9,11,28,45,-17,21
Randers FC,4911,9,5,6,13,24,41,-17,21
Silkeborg IF,4911,10,5,4,13,25,44,-19,19
AGF Aarhus,4911,11,4,7,11,16,36,-20,19
FC Midtjylla,4912,1,21,5,4,65,37,28,68
Brondby,4912,2,19,6,5,65,32,33,63
FC Nords,4912,3,13,8,9,73,52,21,47
Copenhagen,4912,4,13,4,13,58,49,9,43
AaB,4912,5,8,13,9,41,44,-3,37
AC Horsens,4912,6,8,12,10,35,49,-14,36
Sonderjyske,4912,7,8,6,10,28,29,-1,30
Randers FC,4912,8,5,7,12,25,41,-16,22
Silkeborg IF,4912,9,6,3,13,28,45,-17,21
Lyngby,4912,10,3,10,11,28,46,-18,19
AGF Aarhus,4912,11,4,6,12,17,39,-22,18
Brondby,4913,1,21,6,3,75,37,38,69
FC Midtjylla,4913,2,19,5,6,65,40,25,62
FC Nords,4913,3,13,8,9,72,54,18,47
Copenhagen,4913,4,13,6,11,62,50,12,45
AaB,4913,5,7,13,10,34,39,-5,34
AC Horsens,4913,6,6,16,8,35,49,-14,34
Sonderjyske,4913,7,8,6,10,28,29,-1,30
Randers FC,4913,8,6,6,12,25,39,-14,24
AGF Aarhus,4913,9,5,6,11,18,36,-18,21
Lyngby,4913,10,3,9,12,26,46,-20,18
Silkeborg IF,4913,11,5,3,14,25,46,-21,18
Brondby,4914,1,22,5,3,67,30,37,71
FC Midtjylla,4914,2,20,4,6,66,35,31,64
Copenhagen,4914,3,14,5,11,57,43,14,47
FC Nords,4914,4,13,7,10,67,49,18,46
AC Horsens,4914,5,7,13,10,37,53,-16,34
AaB,4914,6,6,14,10,37,47,-10,32
Sonderjyske,4914,7,8,6,10,28,29,-1,30
Lyngby,4914,8,4,9,11,29,45,-16,21
Silkeborg IF,4914,9,6,3,13,26,44,-18,21
Randers FC,4914,10,5,6,13,24,42,-18,21
AGF Aarhus,4914,11,4,6,12,16,37,-21,18
Brondby,4915,1,21,6,3,71,33,38,69
FC Midtjylla,4915,2,17,5,8,59,43,16,56
FC Nords,4915,3,16,7,7,77,48,29,55
Copenhagen,4915,4,14,5,11,57,46,11,47
AC Horsens,4915,5,8,12,10,44,49,-5,36
AaB,4915,6,7,11,12,34,49,-15,32
Sonderjyske,4915,7,8,6,10,28,29,-1,30
Randers FC,4915,8,5,7,12,25,41,-16,22
Lyngby,4915,9,3,10,11,28,46,-18,19
Silkeborg IF,4915,10,5,4,13,26,45,-19,19
AGF Aarhus,4915,11,4,7,11,17,37,-20,19
Brondby,4916,1,23,5,2,73,29,44,74
FC Midtjylla,4916,2,20,4,6,66,36,30,64
FC Nords,4916,3,14,6,10,69,56,13,48
Copenhagen,4916,4,13,5,12,56,43,13,44
AaB,4916,5,7,12,11,33,40,-7,33
AC Horsens,4916,6,6,14,10,36,55,-19,32
Sonderjyske,4916,7,8,6,10,28,29,-1,30
Lyngby,4916,8,4,9,11,27,44,-17,21
Randers FC,4916,9,5,6,13,23,40,-17,21
AGF Aarhus,4916,10,5,6,11,17,36,-19,21
Silkeborg IF,4916,11,5,3,14,25,45,-20,18
Brondby,4917,1,20,6,4,68,33,35,66
FC Midtjylla,4917,2,17,6,7,62,43,19,57
FC Nords,4917,3,15,7,8,77,53,24,52
Copenhagen,4917,4,16,4,10,65,43,22,52
AaB,4917,5,8,12,10,36,42,-6,36
AC Horsens,4917,6,6,13,11,33,53,-20,31
Sonderjyske,4917,7,8,6,10,28,29,-1,30
Randers FC,4917,8,5,7,12,24,40,-16,22
Lyngby,4917,9,3,10,11,27,45,-18,19
Silkeborg IF,4917,10,5,4,13,26,45,-19,19
AGF Aarhus,4917,11,4,7,11,17,37,-20,19
Brondby,4918,1,19,9,2,68,30,38,66
FC Midtjylla,4918,2,19,5,6,62,39,23,62
Copenhagen,4918,3,15,6,9,56,39,17,51
FC Nords,4918,4,14,8,8,73,52,21,50
AC Horsens,4918,5,6,14,10,35,50,-15,32
Sonderjyske,4918,6,8,6,10,28,29,-1,30
AaB,4918,7,6,12,12,32,42,-10,30
Lyngby,4918,8,4,9,11,31,46,-15,21
Randers FC,4918,9,5,6,13,25,44,-19,21
AGF Aarhus,4918,10,5,6,11,18,37,-19,21
Silkeborg IF,4918,11,5,3,14,26,46,-20,18
Brondby,4919,1,20,6,4,69,33,36,66
FC Midtjylla,4919,2,19,5,6,62,38,24,62
Copenhagen,4919,3,16,5,9,61,41,20,53
FC Nords,4919,4,14,6,10,71,53,18,48
AaB,4919,5,7,12,11,37,43,-6,33
AC Horsens,4919,6,7,12,11,36,54,-18,33
Sonderjyske,4919,7,8,6,10,28,29,-1,30
Lyngby,4919,8,4,9,11,28,44,-16,21
Randers FC,4919,9,5,6,13,23,41,-18,21
AGF Aarhus,4919,10,5,6,11,19,37,-18,21
Silkeborg IF,4919,11,5,3,14,26,47,-21,18
Brondby,4920,1,21,5,4,79,35,44,68
FC Midtjylla,4920,2,20,4,6,70,48,22,64
Copenhagen,4920,3,15,5,10,64,46,18,50
FC Nords,4920,4,12,6,12,71,62,9,42
AaB,4920,5,8,12,10,38,41,-3,36
AC Horsens,4920,6,8,12,10,37,53,-16,36
Sonderjyske,4920,7,8,6,10,28,29,-1,30
Randers FC,4920,8,5,7,12,24,40,-16,22
Silkeborg IF,4920,9,6,3,13,28,44,-16,21
Lyngby,4920,10,3,10,11,27,45,-18,19
AGF Aarhus,4920,11,4,6,12,16,39,-23,18
FC Midtjylla,4921,1,20,5,5,67,40,27,65
Brondby,4921,2,19,7,4,68,33,35,64
FC Nords,4921,3,16,6,8,76,49,27,54
Copenhagen,4921,4,12,5,13,58,52,6,41
AC Horsens,4921,5,8,13,9,35,48,-13,37
AaB,4921,6,7,12,11,38,46,-8,33
Sonderjyske,4921,7,8,6,10,28,29,-1,30
Randers FC,4921,8,6,6,12,25,40,-15,24
AGF Aarhus,4921,9,5,6,11,19,38,-19,21
Lyngby,4921,10,3,9,12,27,46,-19,18
Silkeborg IF,4921,11,5,3,14,27,47,-20,18
Brondby,4922,1,21,6,3,77,35,42,69
FC Midtjylla,4922,2,20,5,5,67,39,28,65
FC Nords,4922,3,15,6,9,79,55,24,51
Copenhagen,4922,4,13,7,10,59,45,14,46
AC Horsens,4922,5,7,12,11,39,63,-24,33
Sonderjyske,4922,6,8,6,10,28,29,-1,30
AaB,4922,7,6,12,12,37,47,-10,30
Lyngby,4922,8,4,9,11,28,44,-16,21
Randers FC,4922,9,5,6,13,23,41,-18,21
AGF Aarhus,4922,10,5,6,11,17,36,-19,21
Silkeborg IF,4922,11,5,3,14,25,45,-20,18
Brondby,4923,1,21,6,3,71,33,38,69
FC Midtjylla,4923,2,20,4,6,69,40,29,64
Copenhagen,4923,3,15,4,11,57,43,14,49
FC Nords,4923,4,13,7,10,74,57,17,46
AaB,4923,5,9,11,10,35,39,-4,38
Sonderjyske,4923,6,8,6,10,28,29,-1,30
AC Horsens,4923,7,5,14,11,35,55,-20,29
Randers FC,4923,8,6,6,12,26,40,-14,24
Silkeborg IF,4923,9,5,4,13,27,46,-19,19
AGF Aarhus,4923,10,4,7,11,18,38,-20,19
Lyngby,4923,11,3,9,12,27,47,-20,18
Brondby,4924,1,22,5,3,71,30,41,71
FC Midtjylla,4924,2,19,6,5,67,41,26,63
Copenhagen,4924,3,15,5,10,62,44,18,50
FC Nords,4924,4,13,7,10,70,53,17,46
AC Horsens,4924,5,7,13,10,37,53,-16,34
Sonderjyske,4924,6,8,6,10,28,29,-1,30
AaB,4924,7,6,12,12,34,46,-12,30
Silkeborg IF,4924,8,6,3,13,29,44,-15,21
Lyngby,4924,9,4,9,11,28,44,-16,21
Randers FC,4924,10,5,6,13,23,41,-18,21
AGF Aarhus,4924,11,4,6,12,16,40,-24,18
Brondby,4925,1,20,7,3,72,36,36,67
FC Midtjylla,4925,2,19,5,6,68,42,26,62
Copenhagen,4925,3,15,6,9,60,44,16,51
FC Nords,4925,4,13,8,9,72,55,17,47
AaB,4925,5,7,14,9,39,40,-1,35
Sonderjyske,4925,6,8,6,10,28,29,-1,30
AC Horsens,4925,7,5,14,11,37,57,-20,29
Randers FC,4925,8,5,7,12,24,40,-16,22
Silkeborg IF,4925,9,6,3,13,29,45,-16,21
Lyngby,4925,10,3,10,11,27,45,-18,19
AGF Aarhus,4925,11,4,6,12,17,40,-23,18
Brondby,4926,1,21,7,2,73,33,40,70
FC Midtjylla,4926,2,19,5,6,67,44,23,62
FC Nords,4926,3,15,7,8,79,53,26,52
Copenhagen,4926,4,14,5,11,58,46,12,47
AaB,4926,5,7,12,11,38,44,-6,33
Sonderjyske,4926,6,8,6,10,28,29,-1,30
AC Horsens,4926,7,6,12,12,35,56,-21,30
Randers FC,4926,8,5,7,12,24,40,-16,22
Silkeborg IF,4926,9,6,3,13,28,45,-17,21
Lyngby,4926,10,3,10,11,27,45,-18,19
AGF Aarhus,4926,11,4,6,12,17,39,-22,18
Brondby,4927,1,21,6,3,71,30,41,69
FC Midtjylla,4927,2,21,4,5,68,38,30,67
FC Nords,4927,3,14,7,9,74,51,23,49
Copenhagen,4927,4,13,6,11,55,46,9,45
AaB,4927,5,8,12,10,37,43,-6,36
Sonderjyske,4927,6,8,6,10,28,29,-1,30
AC Horsens,4927,7,5,13,12,33,56,-23,28
Lyngby,4927,8,4,9,11,28,45,-17,21
Randers FC,4927,9,5,6,13,24,41,-17,21
Silkeborg IF,4927,10,6,3,13,26,44,-18,21
AGF Aarhus,4927,11,4,6,12,16,37,-21,18
Brondby,4928,1,20,5,5,69,37,32,65
FC Midtjylla,4928,2,20,5,5,65,37,28,65
FC Nords,4928,3,16,6,8,77,49,28,54
Copenhagen,4928,4,13,5,12,58,47,11,44
AaB,4928,5,9,11,10,38,40,-2,38
Sonderjyske,4928,6,8,6,10,28,29,-1,30
AC Horsens,4928,7,6,12,12,32,55,-23,30
Randers FC,4928,8,5,7,12,25,41,-16,22
Silkeborg IF,4928,9,6,3,13,28,44,-16,21
Lyngby,4928,10,3,10,11,28,46,-18,19
AGF Aarhus,4928,11,4,6,12,16,39,-23,18
Brondby,4929,1,21,6,3,72,31,41,69
FC Midtjylla,4929,2,21,4,5,68,39,29,67
FC Nords,4929,3,14,6,10,74,53,21,48
Copenhagen,4929,4,13,5,12,54,45,9,44
AaB,4929,5,8,13,9,39,41,-2,37
Sonderjyske,4929,6,8,6,10,28,29,-1,30
AC Horsens,4929,7,5,14,11,31,55,-24,29
Lyngby,4929,8,4,9,11,30,45,-15,21
Silkeborg IF,4929,9,6,3,13,27,45,-18,21
Randers FC,4929,10,5,6,13,24,43,-19,21
AGF Aarhus,4929,11,4,6,12,17,38,-21,18
Brondby,4930,1,22,5,3,77,30,47,71
FC Midtjylla,4930,2,18,5,7,64,44,20,59
Copenhagen,4930,3,14,6,10,59,44,15,48
FC Nords,4930,4,13,7,10,68,52,16,46
AaB,4930,5,8,13,9,38,42,-4,37
AC Horsens,4930,6,7,12,11,35,55,-20,33
Sonderjyske,4930,7,8,6,10,28,29,-1,30
Lyngby,4930,8,4,9,11,28,44,-16,21
Randers FC,4930,9,5,6,13,23,41,-18,21
AGF Aarhus,4930,10,5,6,11,17,36,-19,21
Silkeborg IF,4930,11,5,3,14,25,45,-20,18
Brondby,4931,1,22,5,3,70,35,35,71
FC Midtjylla,4931,2,20,4,6,65,39,26,64
Copenhagen,4931,3,15,4,11,64,46,18,49
FC Nords,4931,4,14,6,10,73,52,21,48
AaB,4931,5,7,12,11,33,41,-8,33
AC Horsens,4931,6,6,13,11,33,51,-18,31
Sonderjyske,4931,7,8,6,10,28,29,-1,30
Lyngby,4931,8,4,9,11,27,44,-17,21
Randers FC,4931,9,5,6,13,23,40,-17,21
Silkeborg IF,4931,10,6,3,13,26,44,-18,21
AGF Aarhus,4931,11,4,6,12,16,37,-21,18
Brondby,4932,1,21,5,4,69,32,37,68
FC Midtjylla,4932,2,19,5,6,66,42,24,62
FC Nords,4932,3,15,6,9,75,49,26,51
Copenhagen,4932,4,13,5,12,55,50,5,44
AC Horsens,4932,5,9,12,9,36,49,-13,39
AaB,4932,6,7,11,12,39,44,-5,32
Sonderjyske,4932,7,8,6,10,28,29,-1,30
Lyngby,4932,8,4,9,11,31,44,-13,21
AGF Aarhus,4932,9,5,6,11,18,36,-18,21
Randers FC,4932,10,5,6,13,23,44,-21,21
Silkeborg IF,4932,11,5,3,14,25,46,-21,18
Brondby,4933,1,20,7,3,70,32,38,67
FC Midtjylla,4933,2,20,5,5,64,40,24,65
FC Nords,4933,3,15,6,9,75,47,28,51
Copenhagen,4933,4,14,5,11,58,46,12,47
AC Horsens,4933,5,7,12,11,34,51,-17,33
AaB,4933,6,7,11,12,34,45,-11,32
Sonderjyske,4933,7,8,6,10,28,29,-1,30
Randers FC,4933,8,5,7,12,24,40,-16,22
Lyngby,4933,9,3,10,11,27,45,-18,19
Silkeborg IF,4933,10,5,4,13,27,46,-19,19
AGF Aarhus,4933,11,4,7,11,18,38,-20,19
Brondby,4934,1,20,7,3,70,33,37,67
FC Midtjylla,4934,2,21,4,5,68,44,24,67
FC Nords,4934,3,15,7,8,80,50,30,52
Copenhagen,4934,4,13,6,11,57,46,11,45
AC Horsens,4934,5,7,13,10,37,52,-15,34
Sonderjyske,4934,6,8,6,10,28,29,-1,30
AaB,4934,7,6,11,13,34,47,-13,29
Randers FC,4934,8,6,6,12,25,40,-15,24
Silkeborg IF,4934,9,5,4,13,25,44,-19,19
AGF Aarhus,4934,10,4,7,11,16,36,-20,19
Lyngby,4934,11,3,9,12,27,46,-19,18
FC Midtjylla,4935,1,21,5,4,69,37,32,68
Brondby,4935,2,20,6,4,64,31,33,66
FC Nords,4935,3,15,6,9,75,48,27,51
Copenhagen,4935,4,14,5,11,54,44,10,47
AaB,4935,5,7,12,11,34,42,-8,33
Sonderjyske,4935,6,8,6,10,28,29,-1,30
AC Horsens,4935,7,5,14,11,30,50,-20,29
Lyngby,4935,8,4,9,11,27,44,-17,21
Randers FC,4935,9,5,6,13,23,40,-17,21
Silkeborg IF,4935,10,6,3,13,26,44,-18,21
AGF Aarhus,4935,11,4,6,12,16,37,-21,18
Brondby,4936,1,23,5,2,77,30,47,74
FC Midtjylla,4936,2,21,4,5,69,40,29,67
FC Nords,4936,3,14,6,10,73,52,21,48
Copenhagen,4936,4,13,5,12,54,44,10,44
AaB,4936,5,7,11,12,34,48,-14,32
AC Horsens,4936,6,6,13,11,34,53,-19,31
Sonderjyske,4936,7,8,6,10,28,29,-1,30
Randers FC,4936,8,5,7,12,23,39,-16,22
Lyngby,4936,9,3,10,11,26,44,-18,19
Silkeborg IF,4936,10,5,4,13,25,44,-19,19
AGF Aarhus,4936,11,4,7,11,16,36,-20,19
Brondby,4937,1,22,6,2,75,29,46,72
FC Midtjylla,4937,2,20,4,6,68,42,26,64
FC Nords,4937,3,13,6,11,73,58,15,45
Copenhagen,4937,4,13,4,13,54,47,7,43
AaB,4937,5,8,13,9,36,41,-5,37
AC Horsens,4937,6,7,13,10,36,51,-15,34
Sonderjyske,4937,7,8,6,10,28,29,-1,30
Lyngby,4937,8,4,9,11,28,45,-17,21
Randers FC,4937,9,5,6,13,24,41,-17,21
Silkeborg IF,4937,10,5,4,13,27,46,-19,19
AGF Aarhus,4937,11,4,7,11,18,38,-20,19
Brondby,4938,1,20,8,2,71,34,37,68
FC Midtjylla,4938,2,20,5,5,64,37,27,65
Copenhagen,4938,3,15,5,10,57,41,16,50
FC Nords,4938,4,14,7,9,76,52,24,49
AaB,4938,5,7,13,10,39,44,-5,34
Sonderjyske,4938,6,8,6,10,28,29,-1,30
AC Horsens,4938,7,5,12,13,29,54,-25,27
Randers FC,4938,8,5,7,12,24,40,-16,22
Silkeborg IF,4938,9,6,3,13,27,45,-18,21
Lyngby,4938,10,3,10,11,27,45,-18,19
AGF Aarhus,4938,11,4,6,12,17,38,-21,18
Brondby,4939,1,20,7,3,70,33,37,67
FC Midtjylla,4939,2,19,5,6,64,40,24,62
Copenhagen,4939,3,15,5,10,62,44,18,50
FC Nords,4939,4,14,7,9,71,51,20,49
AaB,4939,5,8,12,10,38,41,-3,36
Sonderjyske,4939,6,8,6,10,28,29,-1,30
AC Horsens,4939,7,5,14,11,31,53,-22,29
Randers FC,4939,8,6,6,12,25,39,-14,24
Silkeborg IF,4939,9,6,3,13,29,46,-17,21
Lyngby,4939,10,3,9,12,26,46,-20,18
AGF Aarhus,4939,11,4,6,12,18,40,-22,18
Brondby,4940,1,19,8,3,67,31,36,65
FC Midtjylla,4940,2,20,5,5,67,39,28,65
Copenhagen,4940,3,15,5,10,59,41,18,50
FC Nords,4940,4,13,8,9,73,55,18,47
AaB,4940,5,7,13,10,35,40,-5,34
AC Horsens,4940,6,6,13,11,37,58,-21,31
Sonderjyske,4940,7,8,6,10,28,29,-1,30
Lyngby,4940,8,4,9,11,28,45,-17,21
Randers FC,4940,9,5,6,13,24,41,-17,21
Silkeborg IF,4940,10,5,4,13,25,44,-19,19
AGF Aarhus,4940,11,4,7,11,16,36,-20,19
Brondby,4941,1,21,6,3,74,32,42,69
FC Midtjylla,4941,2,20,4,6,67,39,28,64
FC Nords,4941,3,14,8,8,75,49,26,50
Copenhagen,4941,4,15,4,11,57,45,12,49
AaB,4941,5,7,12,11,38,51,-13,33
Sonderjyske,4941,6,8,6,10,28,29,-1,30
AC Horsens,4941,7,6,12,12,33,54,-21,30
Lyngby,4941,8,4,9,11,30,45,-15,21
Silkeborg IF,4941,9,6,3,13,28,44,-16,21
Randers FC,4941,10,5,6,13,24,43,-19,21
AGF Aarhus,4941,11,4,6,12,16,39,-23,18
Brondby,4942,1,21,5,4,73,34,39,68
FC Midtjylla,4942,2,21,4,5,72,38,34,67
FC Nords,4942,3,15,6,9,75,55,20,51
Copenhagen,4942,4,12,5,13,57,53,4,41
AC Horsens,4942,5,8,13,9,40,50,-10,37
AaB,4942,6,7,11,12,35,48,-13,32
Sonderjyske,4942,7,8,6,10,28,29,-1,30
Randers FC,4942,8,6,6,12,24,39,-15,24
AGF Aarhus,4942,9,5,6,11,18,36,-18,21
Lyngby,4942,10,3,9,12,26,45,-19,18
Silkeborg IF,4942,11,5,3,14,25,46,-21,18
Brondby,4943,1,20,5,5,69,34,35,65
FC Midtjylla,4943,2,19,5,6,64,40,24,62
FC Nords,4943,3,15,6,9,81,53,28,51
Copenhagen,4943,4,15,4,11,55,43,12,49
AaB,4943,5,7,13,10,38,45,-7,34
AC Horsens,4943,6,7,13,10,35,53,-18,34
Sonderjyske,4943,7,8,6,10,28,29,-1,30
Randers FC,4943,8,6,6,12,24,39,-15,24
Silkeborg IF,4943,9,6,3,13,28,45,-17,21
Lyngby,4943,10,3,9,12,26,45,-19,18
AGF Aarhus,4943,11,4,6,12,17,39,-22,18
Brondby,4944,1,22,6,2,75,30,45,72
FC Midtjylla,4944,2,18,6,6,61,41,20,60
FC Nords,4944,3,14,7,9,73,52,21,49
Copenhagen,4944,4,14,5,11,57,46,11,47
AaB,4944,5,9,11,10,40,43,-3,38
Sonderjyske,4944,6,8,6,10,28,29,-1,30
AC Horsens,4944,7,5,13,12,34,54,-20,28
Randers FC,4944,8,6,6,12,25,40,-15,24
AGF Aarhus,4944,9,5,6,11,17,36,-19,21
Lyngby,4944,10,3,9,12,27,46,-19,18
Silkeborg IF,4944,11,5,3,14,25,45,-20,18
Brondby,4945,1,20,5,5,71,33,38,65
FC Midtjylla,4945,2,17,5,8,60,45,15,56
FC Nords,4945,3,15,7,8,77,52,25,52
Copenhagen,4945,4,16,4,10,56,38,18,52
AaB,4945,5,9,11,10,38,41,-3,38
AC Horsens,4945,6,6,14,10,33,52,-19,32
Sonderjyske,4945,7,8,6,10,28,29,-1,30
Lyngby,4945,8,4,9,11,28,45,-17,21
Randers FC,4945,9,5,6,13,24,41,-17,21
Silkeborg IF,4945,10,5,4,13,26,45,-19,19
AGF Aarhus,4945,11,4,7,11,17,37,-20,19
Brondby,4946,1,21,5,4,74,39,35,68
FC Midtjylla,4946,2,19,5,6,61,37,24,62
FC Nords,4946,3,14,7,9,75,53,22,49
Copenhagen,4946,4,13,6,11,59,46,13,45
AaB,4946,5,8,12,10,39,44,-5,36
AC Horsens,4946,6,7,13,10,40,55,-15,34
Sonderjyske,4946,7,8,6,10,28,29,-1,30
Randers FC,4946,8,5,7,12,25,41,-16,22
AGF Aarhus,4946,9,5,6,11,18,36,-18,21
Lyngby,4946,10,3,10,11,28,46,-18,19
Silkeborg IF,4946,11,5,3,14,25,46,-21,18
Brondby,4947,1,22,6,2,73,33,40,72
FC Midtjylla,4947,2,20,5,5,67,40,27,65
FC Nords,4947,3,14,7,9,76,54,22,49
Copenhagen,4947,4,13,6,11,59,47,12,45
AaB,4947,5,7,12,11,41,46,-5,33
Sonderjyske,4947,6,8,6,10,28,29,-1,30
AC Horsens,4947,7,5,14,11,35,57,-22,29
Lyngby,4947,8,4,9,11,28,44,-16,21
Randers FC,4947,9,5,6,13,23,41,-18,21
AGF Aarhus,4947,10,5,6,11,18,37,-19,21
Silkeborg IF,4947,11,5,3,14,26,46,-20,18
Brondby,4948,1,21,6,3,68,29,39,69
FC Midtjylla,4948,2,19,4,7,63,38,25,61
Copenhagen,4948,3,14,7,9,58,43,15,49
FC Nords,4948,4,13,9,8,72,50,22,48
AC Horsens,4948,5,7,13,10,35,53,-18,34
AaB,4948,6,6,13,11,35,44,-9,31
Sonderjyske,4948,7,8,6,10,28,29,-1,30
Randers FC,4948,8,6,6,12,24,39,-15,24
Silkeborg IF,4948,9,6,3,13,26,44,-18,21
Lyngby,4948,10,3,9,12,26,45,-19,18
AGF Aarhus,4948,11,4,6,12,16,37,-21,18
Brondby,4949,1,19,7,4,74,35,39,64
FC Midtjylla,4949,2,19,5,6,64,40,24,62
FC Nords,4949,3,13,9,8,72,57,15,48
Copenhagen,4949,4,13,7,10,55,42,13,46
AC Horsens,4949,5,8,13,9,35,48,-13,37
AaB,4949,6,7,13,10,37,41,-4,34
Sonderjyske,4949,7,8,6,10,28,29,-1,30
Lyngby,4949,8,4,9,11,30,45,-15,21
Randers FC,4949,9,5,6,13,24,43,-19,21
Silkeborg IF,4949,10,5,4,13,25,44,-19,19
AGF Aarhus,4949,11,4,7,11,16,36,-20,19
Brondby,4950,1,21,5,4,68,33,35,68
FC Midtjylla,4950,2,19,5,6,61,37,24,62
FC Nords,4950,3,15,7,8,74,51,23,52
Copenhagen,4950,4,16,4,10,60,43,17,52
AaB,4950,5,7,11,12,39,45,-6,32
Sonderjyske,4950,6,8,6,10,28,29,-1,30
AC Horsens,4950,7,6,12,12,34,53,-19,30
Randers FC,4950,8,6,6,12,26,39,-13,24
Silkeborg IF,4950,9,6,3,13,28,45,-17,21
Lyngby,4950,10,3,9,12,26,47,-21,18
AGF Aarhus,4950,11,4,6,12,17,39,-22,18
FC Midtjylla,4951,1,21,4,5,63,39,24,67
Brondby,4951,2,20,5,5,71,34,37,65
FC Nords,4951,3,14,6,10,79,54,25,48
Copenhagen,4951,4,14,5,11,60,46,14,47
AaB,4951,5,9,11,10,40,41,-1,38
AC Horsens,4951,6,6,13,11,35,60,-25,31
Sonderjyske,4951,7,8,6,10,28,29,-1,30
Lyngby,4951,8,4,9,11,28,44,-16,21
Randers FC,4951,9,5,6,13,23,41,-18,21
AGF Aarhus,4951,10,5,6,11,19,38,-19,21
Silkeborg IF,4951,11,5,3,14,27,47,-20,18
Brondby,4952,1,21,6,3,72,30,42,69
FC Midtjylla,4952,2,19,4,7,64,45,19,61
FC Nords,4952,3,15,7,8,73,49,24,52
Copenhagen,4952,4,14,5,11,60,45,15,47
AaB,4952,5,6,14,10,35,44,-9,32
AC Horsens,4952,6,6,14,10,36,53,-17,32
Sonderjyske,4952,7,8,6,10,28,29,-1,30
Lyngby,4952,8,4,9,11,28,45,-17,21
Randers FC,4952,9,5,6,13,24,41,-17,21
AGF Aarhus,4952,10,5,6,11,18,37,-19,21
Silkeborg IF,4952,11,5,3,14,26,46,-20,18
Brondby,4953,1,23,5,2,74,31,43,74
FC Midtjylla,4953,2,21,4,5,70,37,33,67
FC Nords,4953,3,13,6,11,67,53,14,45
Copenhagen,4953,4,13,4,13,57,48,9,43
AC Horsens,4953,5,8,12,10,33,48,-15,36
AaB,4953,6,7,11,12,36,46,-10,32
Sonderjyske,4953,7,8,6,10,28,29,-1,30
Randers FC,4953,8,5,7,12,24,40,-16,22
Silkeborg IF,4953,9,6,3,13,29,45,-16,21
Lyngby,4953,10,3,10,11,27,45,-18,19
AGF Aarhus,4953,11,4,6,12,17,40,-23,18
Brondby,4954,1,20,6,4,64,30,34,66
FC Midtjylla,4954,2,20,5,5,65,39,26,65
Copenhagen,4954,3,14,7,9,59,42,17,49
FC Nords,4954,4,13,6,11,71,54,17,45
AaB,4954,5,8,13,9,42,41,1,37
AC Horsens,4954,6,6,13,11,34,55,-21,31
Sonderjyske,4954,7,8,6,10,28,29,-1,30
Randers FC,4954,8,5,7,12,24,40,-16,22
Silkeborg IF,4954,9,6,3,13,28,45,-17,21
Lyngby,4954,10,3,10,11,27,45,-18,19
AGF Aarhus,4954,11,4,6,12,17,39,-22,18
Brondby,4955,1,22,5,3,72,30,42,71
FC Midtjylla,4955,2,20,4,6,60,37,23,64
FC Nords,4955,3,14,7,9,75,53,22,49
Copenhagen,4955,4,13,4,13,56,47,9,43
AaB,4955,5,8,12,10,35,41,-6,36
AC Horsens,4955,6,7,12,11,33,49,-16,33
Sonderjyske,4955,7,8,6,10,28,29,-1,30
Lyngby,4955,8,4,9,11,30,47,-17,21
Randers FC,4955,9,5,6,13,26,43,-17,21
Silkeborg IF,4955,10,5,4,13,25,44,-19,19
AGF Aarhus,4955,11,4,7,11,16,36,-20,19
Brondby,4956,1,20,7,3,72,34,38,67
FC Midtjylla,4956,2,20,4,6,67,40,27,64
FC Nords,4956,3,16,7,7,77,49,28,55
Copenhagen,4956,4,13,6,11,59,48,11,45
AaB,4956,5,6,13,11,33,45,-12,31
Sonderjyske,4956,6,8,6,10,28,29,-1,30
AC Horsens,4956,7,5,15,10,34,52,-18,30
Randers FC,4956,8,5,7,12,24,40,-16,22
Silkeborg IF,4956,9,6,3,13,31,46,-15,21
Lyngby,4956,10,3,10,11,27,45,-18,19
AGF Aarhus,4956,11,4,6,12,18,42,-24,18
Brondby,4957,1,23,5,2,77,32,45,74
FC Midtjylla,4957,2,19,5,6,62,42,20,62
FC Nords,4957,3,14,8,8,71,48,23,50
Copenhagen,4957,4,13,4,13,57,54,3,43
AaB,4957,5,7,13,10,40,40,0,34
Sonderjyske,4957,6,8,6,10,28,29,-1,30
AC Horsens,4957,7,5,15,10,32,49,-17,30
Lyngby,4957,8,4,9,11,27,44,-17,21
Randers FC,4957,9,5,6,13,23,40,-17,21
Silkeborg IF,4957,10,6,3,13,28,46,-18,21
AGF Aarhus,4957,11,4,6,12,18,39,-21,18
Brondby,4958,1,22,6,2,77,33,44,72
FC Midtjylla,4958,2,18,6,6,67,42,25,60
FC Nords,4958,3,14,7,9,73,54,19,49
Copenhagen,4958,4,14,4,12,61,49,12,46
AaB,4958,5,8,11,11,40,49,-9,35
AC Horsens,4958,6,6,14,10,36,53,-17,32
Sonderjyske,4958,7,8,6,10,28,29,-1,30
Lyngby,4958,8,4,9,11,29,44,-15,21
Randers FC,4958,9,5,6,13,23,42,-19,21
AGF Aarhus,4958,10,5,6,11,18,37,-19,21
Silkeborg IF,4958,11,5,3,14,26,46,-20,18
Brondby,4959,1,21,6,3,68,30,38,69
FC Midtjylla,4959,2,18,8,4,62,37,25,62
FC Nords,4959,3,14,7,9,72,51,21,49
Copenhagen,4959,4,13,6,11,58,47,11,45
AC Horsens,4959,5,7,14,9,38,52,-14,35
AaB,4959,6,7,11,12,41,48,-7,32
Sonderjyske,4959,7,8,6,10,28,29,-1,30
Randers FC,4959,8,5,7,12,24,40,-16,22
Silkeborg IF,4959,9,6,3,13,28,44,-16,21
Lyngby,4959,10,3,10,11,27,45,-18,19
AGF Aarhus,4959,11,4,6,12,16,39,-23,18
Brondby,4960,1,21,6,3,72,32,40,69
FC Midtjylla,4960,2,19,6,5,68,41,27,63
FC Nords,4960,3,15,7,8,73,51,22,52
Copenhagen,4960,4,13,4,13,55,45,10,43
AaB,4960,5,7,13,10,37,44,-7,34
AC Horsens,4960,6,7,12,11,34,52,-18,33
Sonderjyske,4960,7,8,6,10,28,29,-1,30
Randers FC,4960,8,6,6,12,25,39,-14,24
Silkeborg IF,4960,9,6,3,13,27,45,-18,21
Lyngby,4960,10,3,9,12,26,46,-20,18
AGF Aarhus,4960,11,4,6,12,17,38,-21,18
FC Midtjylla,4961,1,22,4,4,74,38,36,70
Brondby,4961,2,20,6,4,73,35,38,66
Copenhagen,4961,3,15,4,11,60,48,12,49
FC Nords,4961,4,14,6,10,72,57,15,48
AaB,4961,5,7,12,11,42,49,-7,33
Sonderjyske,4961,6,8,6,10,28,29,-1,30
AC Horsens,4961,7,6,12,12,35,55,-20,30
Randers FC,4961,8,6,6,12,24,39,-15,24
AGF Aarhus,4961,9,5,6,11,21,39,-18,21
Lyngby,4961,10,3,9,12,26,45,-19,18
Silkeborg IF,4961,11,5,3,14,28,49,-21,18
Brondby,4962,1,21,6,3,72,30,42,69
FC Midtjylla,4962,2,20,5,5,65,39,26,65
FC Nords,4962,3,14,8,8,73,51,22,50
Copenhagen,4962,4,14,5,11,58,46,12,47
AaB,4962,5,7,12,11,34,40,-6,33
Sonderjyske,4962,6,8,6,10,28,29,-1,30
AC Horsens,4962,7,6,12,12,36,58,-22,30
Randers FC,4962,8,6,6,12,24,39,-15,24
AGF Aarhus,4962,9,5,6,11,19,36,-17,21
Lyngby,4962,10,3,9,12,26,45,-19,18
Silkeborg IF,4962,11,5,3,14,25,47,-22,18
Brondby,4963,1,21,6,3,70,30,40,69
FC Midtjylla,4963,2,21,4,5,65,37,28,67
Copenhagen,4963,3,15,6,9,61,43,18,51
FC Nords,4963,4,13,7,10,72,53,19,46
AaB,4963,5,7,11,12,37,45,-8,32
Sonderjyske,4963,6,8,6,10,28,29,-1,30
AC Horsens,4963,7,6,12,12,35,58,-23,30
Randers FC,4963,8,5,7,12,24,40,-16,22
Lyngby,4963,9,3,10,11,27,45,-18,19
Silkeborg IF,4963,10,5,4,13,26,45,-19,19
AGF Aarhus,4963,11,4,7,11,17,37,-20,19
Brondby,4964,1,22,6,2,70,28,42,72
FC Midtjylla,4964,2,19,5,6,66,37,29,62
FC Nords,4964,3,14,8,8,71,47,24,50
Copenhagen,4964,4,13,6,11,62,48,14,45
AC Horsens,4964,5,7,13,10,34,53,-19,34
Sonderjyske,4964,6,8,6,10,28,29,-1,30
AaB,4964,7,6,12,12,32,48,-16,30
Lyngby,4964,8,4,9,11,28,45,-17,21
Randers FC,4964,9,5,6,13,24,41,-17,21
Silkeborg IF,4964,10,5,4,13,27,46,-19,19
AGF Aarhus,4964,11,4,7,11,18,38,-20,19
FC Midtjylla,4965,1,20,5,5,71,36,35,65
Brondby,4965,2,18,8,4,63,31,32,62
FC Nords,4965,3,14,7,9,76,59,17,49
Copenhagen,4965,4,14,5,11,61,48,13,47
AaB,4965,5,9,11,10,40,44,-4,38
AC Horsens,4965,6,7,12,11,35,54,-19,33
Sonderjyske,4965,7,8,6,10,28,29,-1,30
Lyngby,4965,8,4,9,11,27,44,-17,21
Randers FC,4965,9,5,6,13,23,40,-17,21
AGF Aarhus,4965,10,5,6,11,17,36,-19,21
Silkeborg IF,4965,11,5,3,14,25,45,-20,18
Brondby,4966,1,22,6,2,73,30,43,72
FC Midtjylla,4966,2,18,6,6,59,41,18,60
Copenhagen,4966,3,15,4,11,61,44,17,49
FC Nords,4966,4,14,6,10,71,51,20,48
AC Horsens,4966,5,7,13,10,36,51,-15,34
AaB,4966,6,7,11,12,35,44,-9,32
Sonderjyske,4966,7,8,6,10,28,29,-1,30
Randers FC,4966,8,6,6,12,24,39,-15,24
Silkeborg IF,4966,9,5,4,13,26,45,-19,19
AGF Aarhus,4966,10,4,7,11,17,37,-20,19
Lyngby,4966,11,3,9,12,26,45,-19,18
Brondby,4967,1,21,5,4,69,33,36,68
FC Midtjylla,4967,2,19,7,4,66,39,27,64
Copenhagen,4967,3,14,6,10,59,43,16,48
FC Nords,4967,4,13,7,10,70,54,16,46
AaB,4967,5,9,12,9,41,42,-1,39
Sonderjyske,4967,6,8,6,10,28,29,-1,30
AC Horsens,4967,7,5,13,12,33,53,-20,28
Randers FC,4967,8,6,6,12,25,40,-15,24
Silkeborg IF,4967,9,5,4,13,26,45,-19,19
AGF Aarhus,4967,10,4,7,11,17,37,-20,19
Lyngby,4967,11,3,9,12,27,46,-19,18
Brondby,4968,1,22,5,3,79,33,46,71
FC Midtjylla,4968,2,20,5,5,64,37,27,65
FC Nords,4968,3,14,7,9,76,51,25,49
Copenhagen,4968,4,15,4,11,60,44,16,49
AaB,4968,5,7,11,12,34,51,-17,32
Sonderjyske,4968,6,8,6,10,28,29,-1,30
AC Horsens,4968,7,6,12,12,33,56,-23,30
Lyngby,4968,8,4,9,11,28,44,-16,21
Silkeborg IF,4968,9,6,3,13,27,44,-17,21
Randers FC,4968,10,5,6,13,23,41,-18,21
AGF Aarhus,4968,11,4,6,12,16,38,-22,18
Brondby,4969,1,20,6,4,73,31,42,66
FC Midtjylla,4969,2,18,7,5,63,39,24,61
FC Nords,4969,3,15,6,9,76,53,23,51
Copenhagen,4969,4,13,5,12,53,46,7,44
AaB,4969,5,8,12,10,36,40,-4,36
AC Horsens,4969,6,7,14,9,36,54,-18,35
Sonderjyske,4969,7,8,6,10,28,29,-1,30
Randers FC,4969,8,5,7,12,24,40,-16,22
Silkeborg IF,4969,9,6,3,13,27,45,-18,21
Lyngby,4969,10,3,10,11,27,45,-18,19
AGF Aarhus,4969,11,4,6,12,17,38,-21,18
Brondby,4970,1,21,6,3,74,33,41,69
FC Midtjylla,4970,2,19,5,6,68,41,27,62
FC Nords,4970,3,15,6,9,72,53,19,51
Copenhagen,4970,4,13,4,13,56,47,9,43
AaB,4970,5,8,12,10,37,44,-7,36
AC Horsens,4970,6,6,15,9,34,49,-15,33
Sonderjyske,4970,7,8,6,10,28,29,-1,30
Lyngby,4970,8,4,9,11,28,44,-16,21
Silkeborg IF,4970,9,6,3,13,28,46,-18,21
Randers FC,4970,10,5,6,13,23,41,-18,21
AGF Aarhus,4970,11,4,6,12,18,39,-21,18
Brondby,4971,1,22,6,2,70,28,42,72
FC Midtjylla,4971,2,19,4,7,65,41,24,61
FC Nords,4971,3,16,6,8,74,47,27,54
Copenhagen,4971,4,14,5,11,56,45,11,47
AaB,4971,5,7,12,11,38,43,-5,33
Sonderjyske,4971,6,8,6,10,28,29,-1,30
AC Horsens,4971,7,5,13,12,29,54,-25,28
Randers FC,4971,8,5,7,12,24,40,-16,22
Lyngby,4971,9,3,10,11,27,45,-18,19
Silkeborg IF,4971,10,5,4,13,26,45,-19,19
AGF Aarhus,4971,11,4,7,11,17,37,-20,19
Brondby,4972,1,20,7,3,70,33,37,67
FC Midtjylla,4972,2,20,5,5,67,40,27,65
FC Nords,4972,3,15,7,8,78,53,25,52
Copenhagen,4972,4,14,4,12,56,48,8,46
AaB,4972,5,7,12,11,40,45,-5,33
Sonderjyske,4972,6,8,6,10,28,29,-1,30
AC Horsens,4972,7,5,15,10,36,54,-18,30
Lyngby,4972,8,4,9,11,27,44,-17,21
Randers FC,4972,9,5,6,13,23,40,-17,21
Silkeborg IF,4972,10,5,4,13,28,47,-19,19
AGF Aarhus,4972,11,4,7,11,19,39,-20,19
FC Midtjylla,4973,1,21,5,4,66,35,31,68
Brondby,4973,2,19,7,4,70,35,35,64
FC Nords,4973,3,14,6,10,75,60,15,48
Copenhagen,4973,4,13,6,11,55,44,11,45
AaB,4973,5,8,12,10,38,41,-3,36
AC Horsens,4973,6,6,14,10,36,51,-15,32
Sonderjyske,4973,7,8,6,10,28,29,-1,30
Silkeborg IF,4973,8,6,3,13,29,46,-17,21
Lyngby,4973,9,4,9,11,28,45,-17,21
Randers FC,4973,10,5,6,13,24,41,-17,21
AGF Aarhus,4973,11,4,6,12,18,40,-22,18
Brondby,4974,1,20,5,5,70,35,35,65
FC Midtjylla,4974,2,20,4,6,70,40,30,64
FC Nords,4974,3,16,7,7,82,53,29,55
Copenhagen,4974,4,14,5,11,57,44,13,47
AaB,4974,5,8,11,11,37,47,-10,35
Sonderjyske,4974,6,8,6,10,28,29,-1,30
AC Horsens,4974,7,6,12,12,34,57,-23,30
Randers FC,4974,8,5,7,12,23,39,-16,22
Lyngby,4974,9,3,10,11,26,44,-18,19
Silkeborg IF,4974,10,5,4,13,25,44,-19,19
AGF Aarhus,4974,11,4,7,11,16,36,-20,19
Brondby,4975,1,21,7,2,69,29,40,70
FC Midtjylla,4975,2,19,6,5,61,36,25,63
Copenhagen,4975,3,14,4,12,58,46,12,46
FC Nords,4975,4,12,8,10,69,52,17,44
AC Horsens,4975,5,7,14,9,36,48,-12,35
AaB,4975,6,7,13,10,36,44,-8,34
Sonderjyske,4975,7,8,6,10,28,29,-1,30
Lyngby,4975,8,4,9,11,29,44,-15,21
AGF Aarhus,4975,9,5,6,11,20,37,-17,21
Randers FC,4975,10,5,6,13,23,42,-19,21
Silkeborg IF,4975,11,5,3,14,26,48,-22,18
Brondby,4976,1,23,5,2,77,33,44,74
FC Midtjylla,4976,2,19,5,6,67,42,25,62
Copenhagen,4976,3,14,6,10,56,45,11,48
FC Nords,4976,4,13,7,10,73,55,18,46
AC Horsens,4976,5,7,12,11,37,52,-15,33
AaB,4976,6,7,11,12,39,48,-9,32
Sonderjyske,4976,7,8,6,10,28,29,-1,30
Randers FC,4976,8,5,7,12,23,39,-16,22
Silkeborg IF,4976,9,6,3,13,26,44,-18,21
Lyngby,4976,10,3,10,11,26,44,-18,19
AGF Aarhus,4976,11,4,6,12,16,37,-21,18
Brondby,4977,1,21,5,4,69,35,34,68
FC Midtjylla,4977,2,21,4,5,72,38,34,67
FC Nords,4977,3,14,6,10,73,55,18,48
Copenhagen,4977,4,13,5,12,55,48,7,44
AaB,4977,5,9,12,9,39,42,-3,39
Sonderjyske,4977,6,8,6,10,28,29,-1,30
AC Horsens,4977,7,6,12,12,37,53,-16,30
Randers FC,4977,8,6,6,12,27,40,-13,24
AGF Aarhus,4977,9,5,6,11,18,37,-19,21
Silkeborg IF,4977,10,5,3,14,26,46,-20,18
Lyngby,4977,11,3,9,12,27,48,-21,18
Brondby,4978,1,21,6,3,70,30,40,69
FC Midtjylla,4978,2,20,4,6,69,41,28,64
FC Nords,4978,3,15,6,9,74,50,24,51
Copenhagen,4978,4,15,5,10,58,45,13,50
AC Horsens,4978,5,7,12,11,37,55,-18,33
Sonderjyske,4978,6,8,6,10,28,29,-1,30
AaB,4978,7,6,11,13,33,46,-13,29
Randers FC,4978,8,6,6,12,25,40,-15,24
Silkeborg IF,4978,9,6,3,13,28,44,-16,21
Lyngby,4978,10,3,9,12,27,46,-19,18
AGF Aarhus,4978,11,4,6,12,16,39,-23,18
FC Midtjylla,4979,1,21,5,4,67,36,31,68
Brondby,4979,2,20,7,3,68,32,36,67
FC Nords,4979,3,13,8,9,74,54,20,47
Copenhagen,4979,4,12,6,12,52,44,8,42
AC Horsens,4979,5,8,13,9,40,51,-11,37
AaB,4979,6,6,13,11,32,42,-10,31
Sonderjyske,4979,7,8,6,10,28,29,-1,30
Randers FC,4979,8,6,6,12,25,39,-14,24
Silkeborg IF,4979,9,6,3,13,29,45,-16,21
Lyngby,4979,10,3,9,12,26,46,-20,18
AGF Aarhus,4979,11,4,6,12,17,40,-23,18
FC Midtjylla,4980,1,21,4,5,71,40,31,67
Brondby,4980,2,20,5,5,69,34,35,65
FC Nords,4980,3,15,8,7,75,51,24,53
Copenhagen,4980,4,12,6,12,54,46,8,42
AC Horsens,4980,5,7,13,10,35,52,-17,34
AaB,4980,6,7,12,11,38,45,-7,33
Sonderjyske,4980,7,8,6,10,28,29,-1,30
Lyngby,4980,8,4,9,11,29,44,-15,21
AGF Aarhus,4980,9,5,6,11,20,36,-16,21
Randers FC,4980,10,5,6,13,23,42,-19,21
Silkeborg IF,4980,11,5,3,14,25,48,-23,18
Brondby,4981,1,22,6,2,77,29,48,72
FC Midtjylla,4981,2,20,5,5,69,42,27,65
FC Nords,4981,3,14,6,10,72,55,17,48
Copenhagen,4981,4,13,4,13,56,52,4,43
AaB,4981,5,9,11,10,41,40,1,38
Sonderjyske,4981,6,8,6,10,28,29,-1,30
AC Horsens,4981,7,6,12,12,33,56,-23,30
Randers FC,4981,8,5,7,12,24,40,-16,22
Lyngby,4981,9,3,10,11,27,45,-18,19
Silkeborg IF,4981,10,5,4,13,27,46,-19,19
AGF Aarhus,4981,11,4,7,11,18,38,-20,19
Brondby,4982,1,21,6,3,74,33,41,69
FC Midtjylla,4982,2,21,5,4,77,36,41,68
Copenhagen,4982,3,15,4,11,56,41,15,49
FC Nords,4982,4,13,6,11,68,56,12,45
AC Horsens,4982,5,8,12,10,38,56,-18,36
Sonderjyske,4982,6,8,6,10,28,29,-1,30
AaB,4982,7,6,11,13,32,49,-17,29
Randers FC,4982,8,6,6,12,26,40,-14,24
AGF Aarhus,4982,9,5,6,11,19,36,-17,21
Lyngby,4982,10,3,9,12,27,47,-20,18
Silkeborg IF,4982,11,5,3,14,25,47,-22,18
Brondby,4983,1,20,6,4,74,39,35,66
FC Midtjylla,4983,2,20,5,5,67,40,27,65
FC Nords,4983,3,16,6,8,82,55,27,54
Copenhagen,4983,4,16,4,10,64,46,18,52
AaB,4983,5,7,11,12,38,51,-13,32
Sonderjyske,4983,6,8,6,10,28,29,-1,30
AC Horsens,4983,7,5,12,13,33,53,-20,27
Randers FC,4983,8,6,6,12,25,39,-14,24
Silkeborg IF,4983,9,6,3,13,26,44,-18,21
Lyngby,4983,10,3,9,12,26,46,-20,18
AGF Aarhus,4983,11,4,6,12,16,37,-21,18
Brondby,4984,1,22,5,3,73,31,42,71
FC Midtjylla,4984,2,20,4,6,64,38,26,64
FC Nords,4984,3,14,6,10,72,53,19,48
Copenhagen,4984,4,13,5,12,55,44,11,44
AaB,4984,5,10,11,9,37,39,-2,41
Sonderjyske,4984,6,8,6,10,28,29,-1,30
AC Horsens,4984,7,5,13,12,32,54,-22,28
Lyngby,4984,8,4,9,11,27,44,-17,21
Silkeborg IF,4984,8,6,3,13,27,44,-17,21
Randers FC,4984,10,5,6,13,23,40,-17,21
AGF Aarhus,4984,11,4,6,12,16,38,-22,18
FC Midtjylla,4985,1,21,4,5,69,39,30,67
Brondby,4985,2,19,7,4,67,33,34,64
Copenhagen,4985,3,16,4,10,56,41,15,52
FC Nords,4985,4,12,9,9,72,53,19,45
AC Horsens,4985,5,7,14,9,39,52,-13,35
Sonderjyske,4985,6,8,6,10,28,29,-1,30
AaB,4985,7,6,12,12,33,44,-11,30
Randers FC,4985,8,5,7,12,23,39,-16,22
Silkeborg IF,4985,9,6,3,13,28,44,-16,21
Lyngby,4985,10,3,10,11,26,44,-18,19
AGF Aarhus,4985,11,4,6,12,16,39,-23,18
Brondby,4986,1,22,5,3,70,29,41,71
FC Midtjylla,4986,2,19,5,6,61,36,25,62
Copenhagen,4986,3,15,6,9,57,41,16,51
FC Nords,4986,4,12,8,10,71,55,16,44
AaB,4986,5,8,11,11,40,46,-6,35
Sonderjyske,4986,6,8,6,10,28,29,-1,30
AC Horsens,4986,7,5,15,10,38,56,-18,30
Lyngby,4986,8,4,9,11,28,44,-16,21
Silkeborg IF,4986,8,6,3,13,28,44,-16,21
Randers FC,4986,10,5,6,13,23,41,-18,21
AGF Aarhus,4986,11,4,6,12,16,39,-23,18
FC Midtjylla,4987,1,20,6,4,70,39,31,66
Brondby,4987,2,19,6,5,70,36,34,63
FC Nords,4987,3,14,7,9,75,52,23,49
Copenhagen,4987,4,15,4,11,63,47,16,49
AaB,4987,5,8,11,11,39,51,-12,35
AC Horsens,4987,6,6,14,10,38,56,-18,32
Sonderjyske,4987,7,8,6,10,28,29,-1,30
Lyngby,4987,8,4,9,11,29,44,-15,21
Randers FC,4987,9,5,6,13,23,42,-19,21
Silkeborg IF,4987,10,5,4,13,25,44,-19,19
AGF Aarhus,4987,11,4,7,11,16,36,-20,19
Brondby,4988,1,22,6,2,74,30,44,72
FC Midtjylla,4988,2,21,4,5,66,40,26,67
FC Nords,4988,3,13,8,9,70,52,18,47
Copenhagen,4988,4,14,4,12,53,43,10,46
AC Horsens,4988,5,7,12,11,41,51,-10,33
Sonderjyske,4988,6,8,6,10,28,29,-1,30
AaB,4988,7,6,12,12,34,48,-14,30
Randers FC,4988,8,5,7,12,25,41,-16,22
AGF Aarhus,4988,9,5,6,11,18,37,-19,21
Lyngby,4988,10,3,10,11,28,46,-18,19
Silkeborg IF,4988,11,5,3,14,26,46,-20,18
Brondby,4989,1,22,5,3,70,31,39,71
FC Midtjylla,4989,2,19,4,7,62,39,23,61
FC Nords,4989,3,16,7,7,75,48,27,55
Copenhagen,4989,4,15,4,11,58,44,14,49
Sonderjyske,4989,5,8,6,10,28,29,-1,30
AaB,4989,6,6,12,12,34,45,-11,30
AC Horsens,4989,7,6,12,12,33,51,-18,30
Randers FC,4989,8,5,7,12,25,41,-16,22
Lyngby,4989,9,3,10,11,28,46,-18,19
Silkeborg IF,4989,10,5,4,13,27,46,-19,19
AGF Aarhus,4989,11,4,7,11,18,38,-20,19
Brondby,4990,1,20,5,5,68,37,31,65
FC Midtjylla,4990,2,18,4,8,67,43,24,58
Copenhagen,4990,3,15,5,10,57,42,15,50
FC Nords,4990,4,13,8,9,71,53,18,47
AaB,4990,5,9,11,10,39,42,-3,38
AC Horsens,4990,6,8,13,9,40,51,-11,37
Sonderjyske,4990,7,8,6,10,28,29,-1,30
Lyngby,4990,8,4,9,11,29,45,-16,21
Silkeborg IF,4990,9,6,3,13,28,44,-16,21
Randers FC,4990,10,5,6,13,24,42,-18,21
AGF Aarhus,4990,11,4,6,12,16,39,-23,18
Brondby,4991,1,20,8,2,71,31,40,68
FC Midtjylla,4991,2,19,6,5,70,42,28,63
FC Nords,4991,3,15,8,7,78,47,31,53
Copenhagen,4991,4,14,5,11,59,44,15,47
Sonderjyske,4991,5,8,6,10,28,29,-1,30
AaB,4991,6,6,12,12,35,49,-14,30
AC Horsens,4991,7,5,15,10,31,57,-26,30
Lyngby,4991,8,4,9,11,28,44,-16,21
Randers FC,4991,9,5,6,13,23,41,-18,21
AGF Aarhus,4991,10,5,6,11,18,36,-18,21
Silkeborg IF,4991,11,5,3,14,25,46,-21,18
Brondby,4992,1,20,8,2,74,33,41,68
FC Midtjylla,4992,2,20,5,5,70,43,27,65
FC Nords,4992,3,14,7,9,75,51,24,49
Copenhagen,4992,4,12,5,13,58,53,5,41
AaB,4992,5,8,12,10,39,44,-5,36
AC Horsens,4992,6,7,13,10,37,55,-18,34
Sonderjyske,4992,7,8,6,10,28,29,-1,30
Randers FC,4992,8,6,6,12,25,39,-14,24
Silkeborg IF,4992,9,6,3,13,32,46,-14,21
Lyngby,4992,10,3,9,12,26,46,-20,18
AGF Aarhus,4992,11,4,6,12,18,43,-25,18
Brondby,4993,1,21,5,4,72,35,37,68
FC Midtjylla,4993,2,19,4,7,64,41,23,61
FC Nords,4993,3,14,7,9,76,54,22,49
Copenhagen,4993,4,14,6,10,58,46,12,48
AaB,4993,5,8,12,10,42,44,-2,36
AC Horsens,4993,6,6,14,10,35,53,-18,32
Sonderjyske,4993,7,8,6,10,28,29,-1,30
Lyngby,4993,8,4,9,11,29,45,-16,21
Randers FC,4993,9,5,6,13,24,42,-18,21
AGF Aarhus,4993,10,5,6,11,18,37,-19,21
Silkeborg IF,4993,11,5,3,14,26,46,-20,18
Brondby,4994,1,20,7,3,77,34,43,67
FC Midtjylla,4994,2,20,4,6,66,42,24,64
FC Nords,4994,3,15,6,9,71,56,15,51
Copenhagen,4994,4,13,4,13,58,51,7,43
AC Horsens,4994,5,7,14,9,41,52,-11,35
AaB,4994,6,7,13,10,40,44,-4,34
Sonderjyske,4994,7,8,6,10,28,29,-1,30
Lyngby,4994,8,4,9,11,30,45,-15,21
Silkeborg IF,4994,9,6,3,13,26,44,-18,21
Randers FC,4994,10,5,6,13,24,43,-19,21
AGF Aarhus,4994,11,4,6,12,16,37,-21,18
Brondby,4995,1,21,6,3,75,37,38,69
FC Midtjylla,4995,2,21,4,5,70,38,32,67
FC Nords,4995,3,14,7,9,73,53,20,49
Copenhagen,4995,4,13,4,13,55,47,8,43
AaB,4995,5,8,12,10,38,42,-4,36
AC Horsens,4995,6,6,13,11,34,54,-20,31
Sonderjyske,4995,7,8,6,10,28,29,-1,30
Lyngby,4995,8,4,9,11,28,45,-17,21
Randers FC,4995,9,5,6,13,24,41,-17,21
Silkeborg IF,4995,10,6,3,13,26,44,-18,21
AGF Aarhus,4995,11,4,6,12,16,37,-21,18
FC Midtjylla,4996,1,21,5,4,67,37,30,68
Brondby,4996,2,20,6,4,70,34,36,66
FC Nords,4996,3,14,7,9,78,53,25,49
Copenhagen,4996,4,14,5,11,56,50,6,47
AaB,4996,5,7,14,9,42,44,-2,35
Sonderjyske,4996,6,8,6,10,28,29,-1,30
AC Horsens,4996,7,5,13,12,32,53,-21,28
Silkeborg IF,4996,8,6,3,13,28,44,-16,21
Lyngby,4996,9,4,9,11,28,45,-17,21
Randers FC,4996,10,5,6,13,24,41,-17,21
AGF Aarhus,4996,11,4,6,12,16,39,-23,18
FC Midtjylla,4997,1,21,4,5,71,39,32,67
Brondby,4997,2,19,7,4,67,33,34,64
FC Nords,4997,3,14,7,9,69,51,18,49
Copenhagen,4997,4,13,6,11,60,47,13,45
AaB,4997,5,7,14,9,36,42,-6,35
AC Horsens,4997,6,7,12,11,35,52,-17,33
Sonderjyske,4997,7,8,6,10,28,29,-1,30
Randers FC,4997,8,6,6,12,26,41,-15,24
AGF Aarhus,4997,9,5,6,11,17,36,-19,21
Lyngby,4997,10,3,9,12,28,47,-19,18
Silkeborg IF,4997,11,5,3,14,25,45,-20,18
Brondby,4998,1,21,5,4,66,33,33,68
FC Midtjylla,4998,2,19,6,5,66,39,27,63
FC Nords,4998,3,14,7,9,71,48,23,49
Copenhagen,4998,4,13,6,11,57,43,14,45
AaB,4998,5,7,13,10,34,40,-6,34
AC Horsens,4998,6,7,13,10,34,51,-17,34
Sonderjyske,4998,7,8,6,10,28,29,-1,30
Lyngby,4998,8,4,9,11,29,45,-16,21
Silkeborg IF,4998,9,6,3,13,28,45,-17,21
Randers FC,4998,10,5,6,13,24,42,-18,21
AGF Aarhus,4998,11,4,6,12,17,39,-22,18
Brondby,4999,1,22,5,3,74,32,42,71
FC Midtjylla,4999,2,19,5,6,64,39,25,62
Copenhagen,4999,3,15,4,11,58,41,17,49
FC Nords,4999,4,14,6,10,71,55,16,48
AC Horsens,4999,5,7,13,10,35,54,-19,34
AaB,4999,6,7,11,12,36,43,-7,32
Sonderjyske,4999,7,8,6,10,28,29,-1,30
Lyngby,4999,8,4,9,11,28,45,-17,21
Randers FC,4999,9,5,6,13,24,41,-17,21
AGF Aarhus,4999,10,5,6,11,17,36,-19,21
Silkeborg IF,4999,11,5,3,14,25,45,-20,18
Brondby,5000,1,22,6,2,68,28,40,72
FC Midtjylla,5000,2,20,6,4,64,35,29,66
Copenhagen,5000,3,14,6,10,54,39,15,48
FC Nords,5000,4,12,9,9,70,52,18,45
AaB,5000,5,7,12,11,35,41,-6,33
Sonderjyske,5000,6,8,6,10,28,29,-1,30
AC Horsens,5000,7,5,13,12,33,55,-22,28
Randers FC,5000,8,6,6,12,25,39,-14,24
AGF Aarhus,5000,9,5,6,11,17,36,-19,21
Lyngby,5000,10,3,9,12,26,46,-20,18
Silkeborg IF,5000,11,5,3,14,25,45,-20,18
Brondby,5001,1,21,5,4,78,38,40,68
FC Midtjylla,5001,2,19,5,6,69,44,25,62
Copenhagen,5001,3,16,5,9,68,45,23,53
FC Nords,5001,4,14,6,10,70,52,18,48
AaB,5001,5,7,12,11,38,47,-9,33
AC Horsens,5001,6,6,13,11,35,58,-23,31
Sonderjyske,5001,7,8,6,10,28,29,-1,30
Randers FC,5001,8,5,7,12,26,42,-16,22
AGF Aarhus,5001,9,5,6,11,19,37,-18,21
Lyngby,5001,10,3,10,11,29,47,-18,19
Silkeborg IF,5001,11,5,3,14,26,47,-21,18
Brondby,5002,1,20,6,4,68,31,37,66
FC Midtjylla,5002,2,20,5,5,65,40,25,65
FC Nords,5002,3,15,7,8,77,51,26,52
Copenhagen,5002,4,14,5,11,61,45,16,47
AC Horsens,5002,5,7,12,11,32,51,-19,33
AaB,5002,6,7,11,12,35,46,-11,32
Sonderjyske,5002,7,8,6,10,28,29,-1,30
Lyngby,5002,8,4,9,11,29,46,-17,21
Randers FC,5002,9,5,6,13,25,42,-17,21
Silkeborg IF,5002,10,6,3,13,26,44,-18,21
AGF Aarhus,5002,11,4,6,12,16,37,-21,18
Brondby,5003,1,19,7,4,76,40,36,64
FC Midtjylla,5003,2,18,5,7,68,46,22,59
FC Nords,5003,3,14,9,7,73,47,26,51
Copenhagen,5003,4,15,4,11,63,51,12,49
AaB,5003,5,8,13,9,40,44,-4,37
AC Horsens,5003,6,6,14,10,36,54,-18,32
Sonderjyske,5003,7,8,6,10,28,29,-1,30
Lyngby,5003,8,4,9,11,28,45,-17,21
Randers FC,5003,9,5,6,13,24,41,-17,21
Silkeborg IF,5003,10,5,4,13,27,46,-19,19
AGF Aarhus,5003,11,4,7,11,18,38,-20,19
Brondby,5004,1,21,5,4,75,36,39,68
FC Midtjylla,5004,2,20,4,6,71,42,29,64
FC Nords,5004,3,14,7,9,74,53,21,49
Copenhagen,5004,4,14,5,11,60,49,11,47
AC Horsens,5004,5,9,12,9,44,55,-11,39
Sonderjyske,5004,6,8,6,10,28,29,-1,30
AaB,5004,7,6,11,13,34,49,-15,29
Randers FC,5004,8,5,7,12,24,40,-16,22
Lyngby,5004,9,3,10,11,27,45,-18,19
Silkeborg IF,5004,10,5,4,13,28,47,-19,19
AGF Aarhus,5004,11,4,7,11,19,39,-20,19
FC Midtjylla,5005,1,20,6,4,70,39,31,66
Brondby,5005,2,19,6,5,66,36,30,63
FC Nords,5005,3,14,8,8,72,49,23,50
Copenhagen,5005,4,12,7,11,55,44,11,43
AaB,5005,5,8,12,10,38,41,-3,36
AC Horsens,5005,6,7,13,10,33,51,-18,34
Sonderjyske,5005,7,8,6,10,28,29,-1,30
Randers FC,5005,8,6,6,12,25,40,-15,24
Silkeborg IF,5005,9,6,3,13,29,47,-18,21
Lyngby,5005,10,3,9,12,27,46,-19,18
AGF Aarhus,5005,11,4,6,12,19,40,-21,18
Brondby,5006,1,20,6,4,68,33,35,66
FC Midtjylla,5006,2,20,5,5,69,37,32,65
Copenhagen,5006,3,15,4,11,59,47,12,49
FC Nords,5006,4,14,6,10,68,51,17,48
AC Horsens,5006,5,7,14,9,35,49,-14,35
AaB,5006,6,7,11,12,37,45,-8,32
Sonderjyske,5006,7,8,6,10,28,29,-1,30
Randers FC,5006,8,6,6,12,25,39,-14,24
AGF Aarhus,5006,9,5,6,11,20,37,-17,21
Lyngby,5006,10,3,9,12,26,46,-20,18
Silkeborg IF,5006,11,5,3,14,26,48,-22,18
Brondby,5007,1,19,8,3,67,33,34,65
FC Midtjylla,5007,2,20,4,6,65,41,24,64
FC Nords,5007,3,13,9,8,72,50,22,48
Copenhagen,5007,4,13,7,10,56,41,15,46
AaB,5007,5,9,13,8,38,39,-1,40
Sonderjyske,5007,6,8,6,10,28,29,-1,30
AC Horsens,5007,7,5,13,12,36,56,-20,28
Randers FC,5007,8,5,7,12,23,39,-16,22
Silkeborg IF,5007,9,6,3,13,26,44,-18,21
Lyngby,5007,10,3,10,11,26,44,-18,19
AGF Aarhus,5007,11,4,6,12,16,37,-21,18
Brondby,5008,1,21,6,3,78,39,39,69
FC Midtjylla,5008,2,20,5,5,70,39,31,65
FC Nords,5008,3,14,8,8,74,51,23,50
Copenhagen,5008,4,13,5,12,56,51,5,44
AaB,5008,5,7,13,10,40,46,-6,34
AC Horsens,5008,6,6,13,11,34,52,-18,31
Sonderjyske,5008,7,8,6,10,28,29,-1,30
Lyngby,5008,8,4,9,11,28,45,-17,21
Randers FC,5008,9,5,6,13,24,41,-17,21
Silkeborg IF,5008,10,5,4,13,27,46,-19,19
AGF Aarhus,5008,11,4,7,11,18,38,-20,19
Brondby,5009,1,21,6,3,71,31,40,69
FC Midtjylla,5009,2,19,5,6,65,38,27,62
FC Nords,5009,3,16,7,7,74,48,26,55
Copenhagen,5009,4,12,5,13,54,47,7,41
AC Horsens,5009,5,7,13,10,37,56,-19,34
AaB,5009,6,6,14,10,38,45,-7,32
Sonderjyske,5009,7,8,6,10,28,29,-1,30
Randers FC,5009,8,6,6,12,24,39,-15,24
Silkeborg IF,5009,9,6,3,13,29,44,-15,21
Lyngby,5009,10,3,9,12,26,45,-19,18
AGF Aarhus,5009,11,4,6,12,16,40,-24,18
FC Midtjylla,5010,1,22,4,4,68,36,32,70
Brondby,5010,2,20,6,4,67,31,36,66
FC Nords,5010,3,14,6,10,75,54,21,48
Copenhagen,5010,4,12,6,12,56,47,9,42
AC Horsens,5010,5,8,13,9,36,50,-14,37
AaB,5010,6,6,13,11,36,46,-10,31
Sonderjyske,5010,7,8,6,10,28,29,-1,30
Randers FC,5010,8,6,6,12,24,39,-15,24
Silkeborg IF,5010,9,5,4,13,26,45,-19,19
AGF Aarhus,5010,10,4,7,11,17,37,-20,19
Lyngby,5010,11,3,9,12,26,45,-19,18
Brondby,5011,1,21,7,2,74,31,43,70
FC Midtjylla,5011,2,19,7,4,64,37,27,64
FC Nords,5011,3,15,7,8,75,55,20,52
Copenhagen,5011,4,14,4,12,59,45,14,46
Sonderjyske,5011,5,8,6,10,28,29,-1,30
AaB,5011,6,6,12,12,35,48,-13,30
AC Horsens,5011,7,5,15,10,31,48,-17,30
Randers FC,5011,8,5,7,12,25,41,-16,22
Silkeborg IF,5011,9,6,3,13,29,44,-15,21
Lyngby,5011,10,3,10,11,28,46,-18,19
AGF Aarhus,5011,11,4,6,12,16,40,-24,18
Brondby,5012,1,19,9,2,68,32,36,66
FC Midtjylla,5012,2,18,5,7,63,43,20,59
FC Nords,5012,3,16,7,7,76,46,30,55
Copenhagen,5012,4,13,4,13,54,46,8,43
AaB,5012,5,8,12,10,36,41,-5,36
AC Horsens,5012,6,7,13,10,32,47,-15,34
Sonderjyske,5012,7,8,6,10,28,29,-1,30
Lyngby,5012,8,4,9,11,28,45,-17,21
Randers FC,5012,9,5,6,13,24,41,-17,21
Silkeborg IF,5012,10,5,4,13,27,46,-19,19
AGF Aarhus,5012,11,4,7,11,18,38,-20,19
Brondby,5013,1,20,5,5,70,37,33,65
FC Midtjylla,5013,2,19,5,6,63,40,23,62
Copenhagen,5013,3,15,5,10,58,40,18,50
FC Nords,5013,4,14,7,9,75,52,23,49
AaB,5013,5,8,12,10,38,45,-7,36
AC Horsens,5013,6,5,16,9,37,53,-16,31
Sonderjyske,5013,7,8,6,10,28,29,-1,30
Lyngby,5013,8,4,9,11,30,44,-14,21
Silkeborg IF,5013,9,6,3,13,27,44,-17,21
Randers FC,5013,10,5,6,13,23,43,-20,21
AGF Aarhus,5013,11,4,6,12,16,38,-22,18
Brondby,5014,1,22,5,3,72,32,40,71
FC Midtjylla,5014,2,19,5,6,64,40,24,62
Copenhagen,5014,3,14,4,12,56,44,12,46
FC Nords,5014,4,12,6,12,70,57,13,42
AC Horsens,5014,5,9,12,9,40,50,-10,39
AaB,5014,6,8,12,10,37,42,-5,36
Sonderjyske,5014,7,8,6,10,28,29,-1,30
Silkeborg IF,5014,8,6,3,13,28,44,-16,21
Lyngby,5014,9,4,9,11,28,45,-17,21
Randers FC,5014,10,5,6,13,24,41,-17,21
AGF Aarhus,5014,11,4,6,12,16,39,-23,18
Brondby,5015,1,21,5,4,73,34,39,68
FC Midtjylla,5015,2,19,6,5,64,37,27,63
FC Nords,5015,3,15,6,9,75,51,24,51
Copenhagen,5015,4,15,4,11,58,48,10,49
AaB,5015,5,7,13,10,34,41,-7,34
Sonderjyske,5015,6,8,6,10,28,29,-1,30
AC Horsens,5015,7,5,14,11,33,52,-19,29
Lyngby,5015,8,4,9,11,31,44,-13,21
Silkeborg IF,5015,9,6,3,13,28,44,-16,21
Randers FC,5015,10,5,6,13,23,44,-21,21
AGF Aarhus,5015,11,4,6,12,16,39,-23,18
Brondby,5016,1,21,7,2,73,31,42,70
FC Midtjylla,5016,2,20,5,5,66,43,23,65
Copenhagen,5016,3,15,5,10,58,40,18,50
FC Nords,5016,4,13,7,10,69,52,17,46
AC Horsens,5016,5,6,14,10,34,51,-17,32
Sonderjyske,5016,6,8,6,10,28,29,-1,30
AaB,5016,7,6,12,12,35,44,-9,30
Randers FC,5016,8,6,6,12,24,39,-15,24
AGF Aarhus,5016,9,5,6,11,17,36,-19,21
Lyngby,5016,10,3,9,12,26,45,-19,18
Silkeborg IF,5016,11,5,3,14,25,45,-20,18
Brondby,5017,1,21,7,2,69,30,39,70
FC Midtjylla,5017,2,19,5,6,64,40,24,62
FC Nords,5017,3,13,9,8,71,49,22,48
Copenhagen,5017,4,14,4,12,58,44,14,46
AC Horsens,5017,5,7,13,10,36,53,-17,34
AaB,5017,6,7,12,11,36,44,-8,33
Sonderjyske,5017,7,8,6,10,28,29,-1,30
Lyngby,5017,8,4,9,11,27,44,-17,21
Randers FC,5017,9,5,6,13,23,40,-17,21
AGF Aarhus,5017,10,5,6,11,19,38,-19,21
Silkeborg IF,5017,11,5,3,14,27,47,-20,18
FC Midtjylla,5018,1,22,4,4,73,37,36,70
Brondby,5018,2,19,5,6,69,38,31,62
FC Nords,5018,3,15,7,8,78,55,23,52
Copenhagen,5018,4,15,4,11,58,45,13,49
AaB,5018,5,6,13,11,35,43,-8,31
AC Horsens,5018,6,6,13,11,38,59,-21,31
Sonderjyske,5018,7,8,6,10,28,29,-1,30
Lyngby,5018,8,4,9,11,30,46,-16,21
Randers FC,5018,9,5,6,13,25,43,-18,21
Silkeborg IF,5018,10,5,4,13,26,45,-19,19
AGF Aarhus,5018,11,4,7,11,17,37,-20,19
Brondby,5019,1,21,7,2,69,30,39,70
FC Midtjylla,5019,2,21,4,5,70,39,31,67
FC Nords,5019,3,13,8,9,72,53,19,47
Copenhagen,5019,4,14,5,11,61,47,14,47
AaB,5019,5,7,12,11,35,44,-9,33
Sonderjyske,5019,6,8,6,10,28,29,-1,30
AC Horsens,5019,7,5,14,11,32,52,-20,29
Randers FC,5019,8,5,7,12,23,39,-16,22
AGF Aarhus,5019,9,5,6,11,19,36,-17,21
Lyngby,5019,10,3,10,11,26,44,-18,19
Silkeborg IF,5019,11,5,3,14,25,47,-22,18
Brondby,5020,1,20,6,4,67,33,34,66
FC Midtjylla,5020,2,19,5,6,64,39,25,62
FC Nords,5020,3,15,6,9,75,52,23,51
Copenhagen,5020,4,15,5,10,60,41,19,50
AC Horsens,5020,5,7,13,10,34,55,-21,34
AaB,5020,6,7,11,12,39,45,-6,32
Sonderjyske,5020,7,8,6,10,28,29,-1,30
Lyngby,5020,8,4,9,11,29,46,-17,21
Silkeborg IF,5020,9,6,3,13,27,44,-17,21
Randers FC,5020,10,5,6,13,25,42,-17,21
AGF Aarhus,5020,11,4,6,12,16,38,-22,18
Brondby,5021,1,20,6,4,67,32,35,66
FC Midtjylla,5021,2,20,5,5,67,39,28,65
FC Nords,5021,3,14,6,10,75,53,22,48
Copenhagen,5021,4,13,5,12,54,47,7,44
AaB,5021,5,9,12,9,38,39,-1,39
AC Horsens,5021,6,6,14,10,34,51,-17,32
Sonderjyske,5021,7,8,6,10,28,29,-1,30
Randers FC,5021,8,5,7,12,24,40,-16,22
Lyngby,5021,9,3,10,11,27,45,-18,19
Silkeborg IF,5021,10,5,4,13,26,45,-19,19
AGF Aarhus,5021,11,4,7,11,17,37,-20,19
Brondby,5022,1,21,6,3,75,34,41,69
FC Midtjylla,5022,2,19,5,6,68,44,24,62
FC Nords,5022,3,15,6,9,82,53,29,51
Copenhagen,5022,4,13,6,11,60,50,10,45
AaB,5022,5,8,12,10,41,46,-5,36
AC Horsens,5022,6,6,13,11,33,58,-25,31
Sonderjyske,5022,7,8,6,10,28,29,-1,30
Lyngby,5022,8,4,9,11,27,44,-17,21
Randers FC,5022,9,5,6,13,23,40,-17,21
Silkeborg IF,5022,10,6,3,13,27,45,-18,21
AGF Aarhus,5022,11,4,6,12,17,38,-21,18
Brondby,5023,1,20,6,4,72,35,37,66
FC Midtjylla,5023,2,19,6,5,62,37,25,63
FC Nords,5023,3,15,7,8,71,47,24,52
Copenhagen,5023,4,12,7,11,54,45,9,43
AaB,5023,5,7,13,10,38,44,-6,34
AC Horsens,5023,6,6,15,9,35,50,-15,33
Sonderjyske,5023,7,8,6,10,28,29,-1,30
Lyngby,5023,8,4,9,11,27,44,-17,21
Randers FC,5023,9,5,6,13,23,40,-17,21
Silkeborg IF,5023,10,5,4,13,26,45,-19,19
AGF Aarhus,5023,11,4,7,11,17,37,-20,19
Brondby,5024,1,19,6,5,66,33,33,63
FC Midtjylla,5024,2,18,6,6,64,42,22,60
FC Nords,5024,3,15,7,8,74,48,26,52
Copenhagen,5024,4,14,4,12,57,47,10,46
AC Horsens,5024,5,8,13,9,35,48,-13,37
AaB,5024,6,8,12,10,37,41,-4,36
Sonderjyske,5024,7,8,6,10,28,29,-1,30
Lyngby,5024,8,4,9,11,28,45,-17,21
Silkeborg IF,5024,9,6,3,13,27,44,-17,21
Randers FC,5024,10,5,6,13,24,41,-17,21
AGF Aarhus,5024,11,4,6,12,16,38,-22,18
Brondby,5025,1,20,5,5,65,32,33,65
FC Midtjylla,5025,2,20,5,5,64,39,25,65
FC Nords,5025,3,16,6,8,73,47,26,54
Copenhagen,5025,4,14,6,10,54,40,14,48
AC Horsens,5025,5,7,12,11,34,49,-15,33
Sonderjyske,5025,6,8,6,10,28,29,-1,30
AaB,5025,7,6,12,12,34,43,-9,30
Randers FC,5025,8,6,6,12,26,40,-14,24
Silkeborg IF,5025,9,5,4,13,27,46,-19,19
AGF Aarhus,5025,10,4,7,11,18,38,-20,19
Lyngby,5025,11,3,9,12,27,47,-20,18
Brondby,5026,1,20,6,4,69,33,36,66
FC Midtjylla,5026,2,19,5,6,64,39,25,62
FC Nords,5026,3,15,7,8,74,51,23,52
Copenhagen,5026,4,14,6,10,61,47,14,48
AC Horsens,5026,5,7,13,10,41,57,-16,34
AaB,5026,6,6,13,11,33,41,-8,31
Sonderjyske,5026,7,8,6,10,28,29,-1,30
Lyngby,5026,8,4,9,11,28,44,-16,21
Randers FC,5026,9,5,6,13,23,41,-18,21
Silkeborg IF,5026,10,5,4,13,26,45,-19,19
AGF Aarhus,5026,11,4,7,11,17,37,-20,19
Brondby,5027,1,21,5,4,74,33,41,68
FC Midtjylla,5027,2,19,7,4,66,38,28,64
FC Nords,5027,3,14,7,9,70,52,18,49
Copenhagen,5027,4,14,6,10,59,44,15,48
AaB,5027,5,7,11,12,35,48,-13,32
AC Horsens,5027,6,6,14,10,38,53,-15,32
Sonderjyske,5027,7,8,6,10,28,29,-1,30
Lyngby,5027,8,4,9,11,31,45,-14,21
Randers FC,5027,9,5,6,13,24,44,-20,21
Silkeborg IF,5027,10,5,4,13,26,45,-19,19
AGF Aarhus,5027,11,4,7,11,17,37,-20,19
Brondby,5028,1,21,7,2,69,29,40,70
FC Midtjylla,5028,2,18,7,5,64,40,24,61
FC Nords,5028,3,14,8,8,76,52,24,50
Copenhagen,5028,4,13,7,10,57,45,12,46
AaB,5028,5,7,14,9,40,45,-5,35
Sonderjyske,5028,6,8,6,10,28,29,-1,30
AC Horsens,5028,7,5,13,12,35,56,-21,28
Randers FC,5028,8,6,6,12,26,40,-14,24
Silkeborg IF,5028,9,6,3,13,26,44,-18,21
Lyngby,5028,10,3,9,12,27,47,-20,18
AGF Aarhus,5028,11,4,6,12,16,37,-21,18
Brondby,5029,1,21,5,4,72,37,35,68
FC Midtjylla,5029,2,20,4,6,69,41,28,64
FC Nords,5029,3,13,7,10,72,55,17,46
Copenhagen,5029,4,14,4,12,59,47,12,46
AaB,5029,5,8,12,10,39,43,-4,36
AC Horsens,5029,6,8,12,10,40,54,-14,36
Sonderjyske,5029,7,8,6,10,28,29,-1,30
Randers FC,5029,8,6,6,12,24,39,-15,24
Silkeborg IF,5029,9,5,4,13,25,44,-19,19
AGF Aarhus,5029,10,4,7,11,16,36,-20,19
Lyngby,5029,11,3,9,12,26,45,-19,18
Brondby,5030,1,21,6,3,69,31,38,69
FC Midtjylla,5030,2,18,6,6,63,45,18,60
FC Nords,5030,3,15,7,8,84,53,31,52
Copenhagen,5030,4,14,5,11,60,46,14,47
AaB,5030,5,7,12,11,37,47,-10,33
AC Horsens,5030,6,7,12,11,37,54,-17,33
Sonderjyske,5030,7,8,6,10,28,29,-1,30
Lyngby,5030,8,4,9,11,29,45,-16,21
Silkeborg IF,5030,9,6,3,13,27,44,-17,21
Randers FC,5030,10,5,6,13,24,42,-18,21
AGF Aarhus,5030,11,4,6,12,16,38,-22,18
Brondby,5031,1,22,6,2,74,30,44,72
FC Midtjylla,5031,2,18,5,7,63,43,20,59
FC Nords,5031,3,14,8,8,76,50,26,50
Copenhagen,5031,4,13,6,11,57,46,11,45
AaB,5031,5,7,13,10,36,44,-8,34
AC Horsens,5031,6,6,14,10,38,57,-19,32
Sonderjyske,5031,7,8,6,10,28,29,-1,30
Lyngby,5031,8,4,9,11,27,44,-17,21
Randers FC,5031,9,5,6,13,23,40,-17,21
AGF Aarhus,5031,10,5,6,11,18,37,-19,21
Silkeborg IF,5031,11,5,3,14,26,46,-20,18
Brondby,5032,1,21,6,3,72,35,37,69
FC Midtjylla,5032,2,20,5,5,71,40,31,65
FC Nords,5032,3,14,7,9,74,51,23,49
Copenhagen,5032,4,13,5,12,55,46,9,44
AC Horsens,5032,5,7,13,10,39,56,-17,34
AaB,5032,6,7,12,11,35,44,-9,33
Sonderjyske,5032,7,8,6,10,28,29,-1,30
Lyngby,5032,8,4,9,11,30,44,-14,21
AGF Aarhus,5032,9,5,6,11,17,36,-19,21
Randers FC,5032,10,5,6,13,23,43,-20,21
Silkeborg IF,5032,11,5,3,14,25,45,-20,18
Brondby,5033,1,22,5,3,70,29,41,71
FC Midtjylla,5033,2,20,5,5,63,37,26,65
FC Nords,5033,3,15,6,9,75,51,24,51
Copenhagen,5033,4,14,5,11,56,46,10,47
AaB,5033,5,7,11,12,35,43,-8,32
Sonderjyske,5033,6,8,6,10,28,29,-1,30
AC Horsens,5033,7,6,12,12,36,55,-19,30
Randers FC,5033,8,5,7,12,24,40,-16,22
Lyngby,5033,9,3,10,11,27,45,-18,19
Silkeborg IF,5033,10,5,4,13,25,44,-19,19
AGF Aarhus,5033,11,4,7,11,16,36,-20,19
FC Midtjylla,5034,1,21,4,5,67,36,31,67
Brondby,5034,2,19,6,5,69,39,30,63
FC Nords,5034,3,14,6,10,76,55,21,48
Copenhagen,5034,4,14,6,10,60,46,14,48
AaB,5034,5,8,11,11,35,40,-5,35
AC Horsens,5034,6,7,13,10,36,53,-17,34
Sonderjyske,5034,7,8,6,10,28,29,-1,30
Randers FC,5034,8,5,7,12,24,40,-16,22
Silkeborg IF,5034,9,6,3,13,26,44,-18,21
Lyngby,5034,10,3,10,11,27,45,-18,19
AGF Aarhus,5034,11,4,6,12,16,37,-21,18
Brondby,5035,1,21,7,2,73,33,40,70
FC Midtjylla,5035,2,19,4,7,65,41,24,61
Copenhagen,5035,3,14,5,11,56,46,10,47
FC Nords,5035,4,12,7,11,71,59,12,43
AC Horsens,5035,5,8,14,8,43,51,-8,38
AaB,5035,6,8,11,11,40,44,-4,35
Sonderjyske,5035,7,8,6,10,28,29,-1,30
Randers FC,5035,8,6,6,12,24,39,-15,24
AGF Aarhus,5035,9,5,6,11,20,38,-18,21
Lyngby,5035,10,3,9,12,26,45,-19,18
Silkeborg IF,5035,11,5,3,14,27,48,-21,18
Brondby,5036,1,23,5,2,80,32,48,74
FC Midtjylla,5036,2,20,5,5,72,41,31,65
FC Nords,5036,3,12,8,10,71,56,15,44
Copenhagen,5036,4,12,6,12,54,49,5,42
AaB,5036,5,9,11,10,40,46,-6,38
Sonderjyske,5036,6,8,6,10,28,29,-1,30
AC Horsens,5036,7,5,15,10,34,53,-19,30
Randers FC,5036,8,6,6,12,26,39,-13,24
Silkeborg IF,5036,9,6,3,13,27,45,-18,21
Lyngby,5036,10,3,9,12,26,47,-21,18
AGF Aarhus,5036,11,4,6,12,17,38,-21,18
Brondby,5037,1,21,7,2,73,34,39,70
FC Midtjylla,5037,2,19,6,5,67,39,28,63
FC Nords,5037,3,15,7,8,78,56,22,52
Copenhagen,5037,4,13,5,12,56,48,8,44
AC Horsens,5037,5,6,14,10,37,53,-16,32
AaB,5037,6,6,13,11,40,47,-7,31
Sonderjyske,5037,7,8,6,10,28,29,-1,30
Lyngby,5037,8,4,9,11,28,44,-16,21
Silkeborg IF,5037,9,6,3,13,28,45,-17,21
Randers FC,5037,10,5,6,13,23,41,-18,21
AGF Aarhus,5037,11,4,6,12,17,39,-22,18
Brondby,5038,1,21,6,3,72,33,39,69
FC Midtjylla,5038,2,19,5,6,65,42,23,62
FC Nords,5038,3,13,9,8,73,52,21,48
Copenhagen,5038,4,14,4,12,57,46,11,46
AaB,5038,5,8,13,9,35,39,-4,37
AC Horsens,5038,6,6,13,11,36,52,-16,31
Sonderjyske,5038,7,8,6,10,28,29,-1,30
Lyngby,5038,8,4,9,11,28,44,-16,21
Silkeborg IF,5038,8,6,3,13,28,44,-16,21
Randers FC,5038,10,5,6,13,23,41,-18,21
AGF Aarhus,5038,11,4,6,12,16,39,-23,18
Brondby,5039,1,21,6,3,67,29,38,69
FC Midtjylla,5039,2,17,7,6,64,43,21,58
FC Nords,5039,3,14,8,8,71,48,23,50
Copenhagen,5039,4,13,7,10,59,46,13,46
AaB,5039,5,9,12,9,40,42,-2,39
Sonderjyske,5039,6,8,6,10,28,29,-1,30
AC Horsens,5039,7,5,14,11,35,54,-19,29
Randers FC,5039,8,6,6,12,24,39,-15,24
Silkeborg IF,5039,9,5,4,13,25,44,-19,19
AGF Aarhus,5039,10,4,7,11,16,36,-20,19
Lyngby,5039,11,3,9,12,26,45,-19,18
Brondby,5040,1,22,5,3,72,31,41,71
FC Midtjylla,5040,2,18,4,8,64,39,25,58
Copenhagen,5040,3,15,4,11,57,43,14,49
FC Nords,5040,4,13,8,9,69,51,18,47
AaB,5040,5,9,12,9,39,42,-3,39
AC Horsens,5040,6,6,13,11,35,56,-21,31
Sonderjyske,5040,7,8,6,10,28,29,-1,30
Randers FC,5040,8,6,6,12,24,39,-15,24
Silkeborg IF,5040,9,6,3,13,26,44,-18,21
Lyngby,5040,10,3,9,12,26,45,-19,18
AGF Aarhus,5040,11,4,6,12,16,37,-21,18
Brondby,5041,1,20,8,2,68,30,38,68
FC Midtjylla,5041,2,21,4,5,66,35,31,67
FC Nords,5041,3,15,6,9,72,48,24,51
Copenhagen,5041,4,13,5,12,55,48,7,44
AC Horsens,5041,5,6,14,10,32,50,-18,32
AaB,5041,6,6,13,11,33,41,-8,31
Sonderjyske,5041,7,8,6,10,28,29,-1,30
Lyngby,5041,8,4,9,11,29,44,-15,21
Silkeborg IF,5041,9,6,3,13,27,44,-17,21
Randers FC,5041,10,5,6,13,23,42,-19,21
AGF Aarhus,5041,11,4,6,12,16,38,-22,18
Brondby,5042,1,21,6,3,78,34,44,69
FC Midtjylla,5042,2,17,6,7,59,41,18,57
Copenhagen,5042,3,16,4,10,58,40,18,52
FC Nords,5042,4,12,10,8,69,51,18,46
AaB,5042,5,7,13,10,35,44,-9,34
AC Horsens,5042,6,7,13,10,37,52,-15,34
Sonderjyske,5042,7,8,6,10,28,29,-1,30
Lyngby,5042,8,4,9,11,27,44,-17,21
Randers FC,5042,9,5,6,13,23,40,-17,21
Silkeborg IF,5042,10,6,3,13,27,45,-18,21
AGF Aarhus,5042,11,4,6,12,17,38,-21,18
Brondby,5043,1,21,6,3,70,32,38,69
FC Midtjylla,5043,2,20,5,5,68,41,27,65
FC Nords,5043,3,14,8,8,72,48,24,50
Copenhagen,5043,4,13,5,12,55,47,8,44
AaB,5043,5,8,13,9,38,40,-2,37
Sonderjyske,5043,6,8,6,10,28,29,-1,30
AC Horsens,5043,7,5,13,12,31,52,-21,28
Randers FC,5043,8,6,6,12,25,39,-14,24
Silkeborg IF,5043,9,6,3,13,26,44,-18,21
Lyngby,5043,10,3,9,12,26,46,-20,18
AGF Aarhus,5043,11,4,6,12,16,37,-21,18
Brondby,5044,1,21,6,3,73,33,40,69
FC Midtjylla,5044,2,21,4,5,64,36,28,67
FC Nords,5044,3,14,6,10,74,54,20,48
Copenhagen,5044,4,14,4,12,55,42,13,46
AC Horsens,5044,5,7,13,10,33,50,-17,34
AaB,5044,6,7,11,12,33,43,-10,32
Sonderjyske,5044,7,8,6,10,28,29,-1,30
Lyngby,5044,8,4,9,11,28,44,-16,21
Silkeborg IF,5044,9,6,3,13,27,45,-18,21
Randers FC,5044,10,5,6,13,23,41,-18,21
AGF Aarhus,5044,11,4,6,12,17,38,-21,18
Brondby,5045,1,22,5,3,73,31,42,71
FC Midtjylla,5045,2,19,5,6,72,41,31,62
FC Nords,5045,3,15,7,8,74,54,20,52
Copenhagen,5045,4,14,5,11,57,44,13,47
AC Horsens,5045,5,7,13,10,37,56,-19,34
Sonderjyske,5045,6,8,6,10,28,29,-1,30
AaB,5045,7,6,11,13,37,50,-13,29
Randers FC,5045,8,5,7,12,24,40,-16,22
Silkeborg IF,5045,9,6,3,13,27,45,-18,21
Lyngby,5045,10,3,10,11,27,45,-18,19
AGF Aarhus,5045,11,4,6,12,17,38,-21,18
Brondby,5046,1,21,5,4,70,33,37,68
FC Midtjylla,5046,2,21,4,5,65,35,30,67
Copenhagen,5046,3,15,5,10,58,41,17,50
FC Nords,5046,4,13,8,9,72,52,20,47
AaB,5046,5,7,12,11,35,46,-11,33
Sonderjyske,5046,6,8,6,10,28,29,-1,30
AC Horsens,5046,7,6,12,12,34,53,-19,30
Lyngby,5046,8,4,9,11,32,44,-12,21
Silkeborg IF,5046,9,6,3,13,30,46,-16,21
Randers FC,5046,10,5,6,13,23,45,-22,21
AGF Aarhus,5046,11,4,6,12,18,41,-23,18
Brondby,5047,1,20,6,4,67,34,33,66
FC Midtjylla,5047,2,17,7,6,63,42,21,58
FC Nords,5047,3,15,8,7,78,49,29,53
Copenhagen,5047,4,13,6,11,57,45,12,45
AaB,5047,5,9,11,10,37,40,-3,38
AC Horsens,5047,6,7,12,11,36,54,-18,33
Sonderjyske,5047,7,8,6,10,28,29,-1,30
Lyngby,5047,8,4,9,11,27,44,-17,21
Randers FC,5047,9,5,6,13,23,40,-17,21
Silkeborg IF,5047,10,6,3,13,27,45,-18,21
AGF Aarhus,5047,11,4,6,12,17,38,-21,18
Brondby,5048,1,19,8,3,67,30,37,65
FC Midtjylla,5048,2,19,7,4,64,37,27,64
FC Nords,5048,3,13,8,9,68,52,16,47
Copenhagen,5048,4,13,6,11,55,42,13,45
AC Horsens,5048,5,8,14,8,38,48,-10,38
AaB,5048,6,6,13,11,37,46,-9,31
Sonderjyske,5048,7,8,6,10,28,29,-1,30
Lyngby,5048,8,4,9,11,28,45,-17,21
Randers FC,5048,9,5,6,13,24,41,-17,21
AGF Aarhus,5048,10,5,6,11,18,37,-19,21
Silkeborg IF,5048,11,5,3,14,26,46,-20,18
Brondby,5049,1,21,6,3,70,30,40,69
FC Midtjylla,5049,2,20,4,6,66,40,26,64
Copenhagen,5049,3,15,4,11,60,44,16,49
FC Nords,5049,4,14,6,10,76,56,20,48
AaB,5049,5,8,11,11,36,42,-6,35
AC Horsens,5049,6,6,13,11,35,57,-22,31
Sonderjyske,5049,7,8,6,10,28,29,-1,30
Randers FC,5049,8,5,7,12,25,41,-16,22
Lyngby,5049,9,3,10,11,28,46,-18,19
Silkeborg IF,5049,10,5,4,13,27,46,-19,19
AGF Aarhus,5049,11,4,7,11,18,38,-20,19
FC Midtjylla,5050,1,22,4,4,79,35,44,70
Brondby,5050,2,19,8,3,64,30,34,65
FC Nords,5050,3,15,7,8,71,47,24,52
Copenhagen,5050,4,12,5,13,50,47,3,41
AaB,5050,5,7,12,11,35,45,-10,33
AC Horsens,5050,6,6,14,10,36,57,-21,32
Sonderjyske,5050,7,8,6,10,28,29,-1,30
Randers FC,5050,8,6,6,12,26,41,-15,24
Silkeborg IF,5050,9,6,3,13,27,45,-18,21
Lyngby,5050,10,3,9,12,28,47,-19,18
AGF Aarhus,5050,11,4,6,12,17,38,-21,18
Brondby,5051,1,22,6,2,75,32,43,72
FC Midtjylla,5051,2,19,5,6,60,36,24,62
FC Nords,5051,3,14,9,7,71,47,24,51
Copenhagen,5051,4,12,5,13,53,51,2,41
AaB,5051,5,7,13,10,37,40,-3,34
AC Horsens,5051,6,6,14,10,34,50,-16,32
Sonderjyske,5051,7,8,6,10,28,29,-1,30
Lyngby,5051,8,4,9,11,27,44,-17,21
Randers FC,5051,9,5,6,13,23,40,-17,21
Silkeborg IF,5051,10,5,4,13,27,46,-19,19
AGF Aarhus,5051,11,4,7,11,18,38,-20,19
Brondby,5052,1,20,7,3,71,33,38,67
FC Midtjylla,5052,2,20,5,5,65,39,26,65
Copenhagen,5052,3,15,6,9,62,42,20,51
FC Nords,5052,4,12,7,11,72,58,14,43
AC Horsens,5052,5,7,13,10,36,54,-18,34
AaB,5052,6,6,14,10,36,42,-6,32
Sonderjyske,5052,7,8,6,10,28,29,-1,30
Randers FC,5052,8,6,6,12,26,39,-13,24
Silkeborg IF,5052,9,6,3,13,27,45,-18,21
Lyngby,5052,10,3,9,12,26,47,-21,18
AGF Aarhus,5052,11,4,6,12,17,38,-21,18
Brondby,5053,1,21,6,3,69,29,40,69
FC Midtjylla,5053,2,20,5,5,71,40,31,65
FC Nords,5053,3,14,7,9,75,53,22,49
Copenhagen,5053,4,15,4,11,59,48,11,49
AaB,5053,5,8,12,10,40,45,-5,36
Sonderjyske,5053,6,8,6,10,28,29,-1,30
AC Horsens,5053,7,5,12,13,33,58,-25,27
Randers FC,5053,8,6,6,12,25,40,-15,24
Silkeborg IF,5053,9,6,3,13,28,45,-17,21
Lyngby,5053,10,3,9,12,27,46,-19,18
AGF Aarhus,5053,11,4,6,12,17,39,-22,18
Brondby,5054,1,22,6,2,69,28,41,72
FC Midtjylla,5054,2,20,4,6,69,39,30,64
FC Nords,5054,3,14,6,10,73,51,22,48
Copenhagen,5054,4,14,4,12,56,44,12,46
AaB,5054,5,7,12,11,38,49,-11,33
AC Horsens,5054,6,7,12,11,42,62,-20,33
Sonderjyske,5054,7,8,6,10,28,29,-1,30
Randers FC,5054,8,5,7,12,23,39,-16,22
Silkeborg IF,5054,9,6,3,13,28,44,-16,21
Lyngby,5054,10,3,10,11,26,44,-18,19
AGF Aarhus,5054,11,4,6,12,16,39,-23,18
Brondby,5055,1,20,7,3,69,33,36,67
FC Midtjylla,5055,2,21,4,5,72,40,32,67
FC Nords,5055,3,14,6,10,78,52,26,48
Copenhagen,5055,4,14,5,11,58,43,15,47
AaB,5055,5,7,12,11,33,43,-10,33
AC Horsens,5055,6,6,14,10,32,57,-25,32
Sonderjyske,5055,7,8,6,10,28,29,-1,30
Randers FC,5055,8,5,7,12,23,39,-16,22
Silkeborg IF,5055,9,6,3,13,28,44,-16,21
Lyngby,5055,10,3,10,11,26,44,-18,19
AGF Aarhus,5055,11,4,6,12,16,39,-23,18
Brondby,5056,1,21,6,3,72,33,39,69
FC Midtjylla,5056,2,21,5,4,67,36,31,68
FC Nords,5056,3,14,7,9,78,56,22,49
Copenhagen,5056,4,12,5,13,53,50,3,41
AaB,5056,5,8,11,11,40,43,-3,35
AC Horsens,5056,6,6,14,10,35,53,-18,32
Sonderjyske,5056,7,8,6,10,28,29,-1,30
Lyngby,5056,8,4,9,11,29,44,-15,21
Silkeborg IF,5056,9,6,3,13,28,44,-16,21
Randers FC,5056,10,5,6,13,23,42,-19,21
AGF Aarhus,5056,11,4,6,12,16,39,-23,18
FC Midtjylla,5057,1,21,4,5,70,38,32,67
Brondby,5057,2,19,6,5,67,35,32,63
FC Nords,5057,3,15,7,8,72,50,22,52
Copenhagen,5057,4,14,5,11,57,46,11,47
AaB,5057,5,8,12,10,37,41,-4,36
Sonderjyske,5057,6,8,6,10,28,29,-1,30
AC Horsens,5057,7,5,14,11,32,51,-19,29
Randers FC,5057,8,6,6,12,26,40,-14,24
Silkeborg IF,5057,9,6,3,13,27,45,-18,21
Lyngby,5057,10,3,9,12,27,47,-20,18
AGF Aarhus,5057,11,4,6,12,17,38,-21,18
Brondby,5058,1,21,6,3,70,33,37,69
FC Midtjylla,5058,2,19,4,7,66,41,25,61
FC Nords,5058,3,14,7,9,74,54,20,49
Copenhagen,5058,4,15,4,11,60,46,14,49
AC Horsens,5058,5,7,13,10,37,52,-15,34
AaB,5058,6,6,14,10,36,43,-7,32
Sonderjyske,5058,7,8,6,10,28,29,-1,30
Randers FC,5058,8,6,6,12,27,39,-12,24
Silkeborg IF,5058,9,6,3,13,27,45,-18,21
AGF Aarhus,5058,10,4,6,12,17,38,-21,18
Lyngby,5058,11,3,9,12,26,48,-22,18
Brondby,5059,1,23,5,2,75,32,43,74
FC Midtjylla,5059,2,21,4,5,69,40,29,67
FC Nords,5059,3,14,6,10,74,54,20,48
Copenhagen,5059,4,12,6,12,58,50,8,42
AC Horsens,5059,5,6,14,10,35,51,-16,32
AaB,5059,6,6,13,11,38,48,-10,31
Sonderjyske,5059,7,8,6,10,28,29,-1,30
Randers FC,5059,8,6,6,12,27,41,-14,24
Silkeborg IF,5059,9,5,4,13,26,45,-19,19
AGF Aarhus,5059,10,4,7,11,17,37,-20,19
Lyngby,5059,11,3,9,12,28,48,-20,18
Brondby,5060,1,22,6,2,69,28,41,72
FC Midtjylla,5060,2,19,4,7,65,42,23,61
FC Nords,5060,3,14,7,9,71,49,22,49
Copenhagen,5060,4,13,7,10,54,40,14,46
AC Horsens,5060,5,7,13,10,37,53,-16,34
AaB,5060,6,7,11,12,37,47,-10,32
Sonderjyske,5060,7,8,6,10,28,29,-1,30
Lyngby,5060,8,4,9,11,27,44,-17,21
Randers FC,5060,9,5,6,13,23,40,-17,21
Silkeborg IF,5060,10,5,4,13,26,45,-19,19
AGF Aarhus,5060,11,4,7,11,17,37,-20,19
Brondby,5061,1,22,6,2,74,29,45,72
FC Midtjylla,5061,2,18,5,7,63,40,23,59
FC Nords,5061,3,13,8,9,73,55,18,47
Copenhagen,5061,4,14,5,11,59,44,15,47
AaB,5061,5,9,11,10,39,44,-5,38
Sonderjyske,5061,6,8,6,10,28,29,-1,30
AC Horsens,5061,7,5,15,10,32,54,-22,30
Lyngby,5061,8,4,9,11,29,45,-16,21
Silkeborg IF,5061,9,6,3,13,26,44,-18,21
Randers FC,5061,10,5,6,13,24,42,-18,21
AGF Aarhus,5061,11,4,6,12,16,37,-21,18
FC Midtjylla,5062,1,21,4,5,68,37,31,67
Brondby,5062,2,18,7,5,67,37,30,61
Copenhagen,5062,3,16,5,9,59,40,19,53
FC Nords,5062,4,14,7,9,71,49,22,49
AaB,5062,5,8,12,10,35,39,-4,36
Sonderjyske,5062,6,8,6,10,28,29,-1,30
AC Horsens,5062,7,5,13,12,35,59,-24,28
Randers FC,5062,8,5,7,12,25,41,-16,22
Lyngby,5062,9,3,10,11,28,46,-18,19
Silkeborg IF,5062,10,5,4,13,26,45,-19,19
AGF Aarhus,5062,11,4,7,11,17,37,-20,19
Brondby,5063,1,22,6,2,73,30,43,72
FC Midtjylla,5063,2,19,7,4,63,35,28,64
FC Nords,5063,3,15,7,8,74,49,25,52
Copenhagen,5063,4,12,5,13,52,47,5,41
AaB,5063,5,8,11,11,37,44,-7,35
Sonderjyske,5063,6,8,6,10,28,29,-1,30
AC Horsens,5063,7,6,12,12,32,52,-20,30
Lyngby,5063,8,4,9,11,29,44,-15,21
Silkeborg IF,5063,9,6,3,13,26,44,-18,21
Randers FC,5063,10,5,6,13,23,42,-19,21
AGF Aarhus,5063,11,4,6,12,16,37,-21,18
FC Midtjylla,5064,1,21,4,5,69,38,31,67
Brondby,5064,2,19,5,6,64,34,30,62
Copenhagen,5064,3,15,5,10,57,41,16,50
FC Nords,5064,4,12,8,10,71,56,15,44
AaB,5064,5,8,12,10,34,39,-5,36
AC Horsens,5064,6,7,14,9,35,48,-13,35
Sonderjyske,5064,7,8,6,10,28,29,-1,30
Lyngby,5064,8,4,9,11,32,45,-13,21
AGF Aarhus,5064,9,5,6,11,19,36,-17,21
Randers FC,5064,10,5,6,13,24,45,-21,21
Silkeborg IF,5064,11,5,3,14,25,47,-22,18
Brondby,5065,1,19,5,6,67,39,28,62
FC Midtjylla,5065,2,19,5,6,64,39,25,62
FC Nords,5065,3,16,7,7,77,49,28,55
Copenhagen,5065,4,16,5,9,62,40,22,53
AC Horsens,5065,5,7,13,10,35,51,-16,34
Sonderjyske,5065,6,8,6,10,28,29,-1,30
AaB,5065,7,6,11,13,34,47,-13,29
Lyngby,5065,8,4,9,11,27,44,-17,21
Randers FC,5065,9,5,6,13,23,40,-17,21
AGF Aarhus,5065,10,5,6,11,17,36,-19,21
Silkeborg IF,5065,11,5,3,14,25,45,-20,18
FC Midtjylla,5066,1,21,4,5,66,38,28,67
Brondby,5066,2,20,6,4,75,35,40,66
FC Nords,5066,3,14,6,10,73,53,20,48
Copenhagen,5066,4,12,5,13,55,49,6,41
AC Horsens,5066,5,9,12,9,36,49,-13,39
AaB,5066,6,8,11,11,37,44,-7,35
Sonderjyske,5066,7,8,6,10,28,29,-1,30
Randers FC,5066,8,6,6,12,25,40,-15,24
Silkeborg IF,5066,9,5,4,13,26,45,-19,19
AGF Aarhus,5066,10,4,7,11,17,37,-20,19
Lyngby,5066,11,3,9,12,27,46,-19,18
Brondby,5067,1,20,6,4,72,37,35,66
FC Midtjylla,5067,2,20,6,4,68,37,31,66
FC Nords,5067,3,14,7,9,73,53,20,49
Copenhagen,5067,4,14,5,11,56,44,12,47
AaB,5067,5,9,11,10,39,42,-3,38
Sonderjyske,5067,6,8,6,10,28,29,-1,30
AC Horsens,5067,7,5,13,12,36,57,-21,28
Randers FC,5067,8,5,7,12,23,39,-16,22
Silkeborg IF,5067,9,6,3,13,29,45,-16,21
Lyngby,5067,10,3,10,11,26,44,-18,19
AGF Aarhus,5067,11,4,6,12,17,40,-23,18
FC Midtjylla,5068,1,22,4,4,69,34,35,70
Brondby,5068,2,19,8,3,68,31,37,65
FC Nords,5068,3,14,7,9,73,51,22,49
Copenhagen,5068,4,14,5,11,56,45,11,47
AaB,5068,5,8,11,11,38,43,-5,35
Sonderjyske,5068,6,8,6,10,28,29,-1,30
AC Horsens,5068,7,5,13,12,32,58,-26,28
Lyngby,5068,8,4,9,11,27,44,-17,21
Randers FC,5068,9,5,6,13,23,40,-17,21
AGF Aarhus,5068,10,5,6,11,17,36,-19,21
Silkeborg IF,5068,11,5,3,14,25,45,-20,18
Brondby,5069,1,20,8,2,68,31,37,68
FC Midtjylla,5069,2,20,5,5,66,37,29,65
FC Nords,5069,3,15,6,9,71,49,22,51
Copenhagen,5069,4,14,5,11,56,41,15,47
AaB,5069,5,7,11,12,33,44,-11,32
AC Horsens,5069,6,6,13,11,34,52,-18,31
Sonderjyske,5069,7,8,6,10,28,29,-1,30
Lyngby,5069,8,4,9,11,29,44,-15,21
AGF Aarhus,5069,9,5,6,11,18,36,-18,21
Randers FC,5069,10,5,6,13,23,42,-19,21
Silkeborg IF,5069,11,5,3,14,25,46,-21,18
FC Midtjylla,5070,1,20,5,5,66,38,28,65
Brondby,5070,2,18,8,4,70,37,33,62
FC Nords,5070,3,15,6,9,77,53,24,51
Copenhagen,5070,4,13,6,11,56,46,10,45
AaB,5070,5,9,13,8,41,40,1,40
Sonderjyske,5070,6,8,6,10,28,29,-1,30
AC Horsens,5070,7,5,14,11,33,55,-22,29
Randers FC,5070,8,5,7,12,24,40,-16,22
Silkeborg IF,5070,9,6,3,13,27,44,-17,21
Lyngby,5070,10,3,10,11,27,45,-18,19
AGF Aarhus,5070,11,4,6,12,16,38,-22,18
Brondby,5071,1,21,6,3,70,30,40,69
FC Midtjylla,5071,2,19,5,6,64,40,24,62
Copenhagen,5071,3,15,5,10,60,42,18,50
FC Nords,5071,4,13,7,10,71,52,19,46
AC Horsens,5071,5,8,13,9,36,51,-15,37
Sonderjyske,5071,6,8,6,10,28,29,-1,30
AaB,5071,7,6,12,12,36,48,-12,30
Lyngby,5071,8,4,9,11,28,44,-16,21
Randers FC,5071,9,5,6,13,23,41,-18,21
Silkeborg IF,5071,10,5,4,13,28,47,-19,19
AGF Aarhus,5071,11,4,7,11,19,39,-20,19
Brondby,5072,1,21,6,3,75,32,43,69
FC Midtjylla,5072,2,19,5,6,65,42,23,62
FC Nords,5072,3,15,6,9,73,52,21,51
Copenhagen,5072,4,14,4,12,53,43,10,46
AaB,5072,5,7,13,10,37,43,-6,34
AC Horsens,5072,6,7,12,11,36,53,-17,33
Sonderjyske,5072,7,8,6,10,28,29,-1,30
Lyngby,5072,8,4,9,11,28,45,-17,21
Randers FC,5072,9,5,6,13,24,41,-17,21
Silkeborg IF,5072,10,6,3,13,27,45,-18,21
AGF Aarhus,5072,11,4,6,12,17,38,-21,18
Brondby,5073,1,20,6,4,66,31,35,66
FC Midtjylla,5073,2,20,4,6,69,43,26,64
Copenhagen,5073,3,15,5,10,64,43,21,50
FC Nords,5073,4,14,7,9,69,51,18,49
AaB,5073,5,8,12,10,36,41,-5,36
Sonderjyske,5073,6,8,6,10,28,29,-1,30
AC Horsens,5073,7,5,14,11,32,53,-21,29
Randers FC,5073,8,5,7,12,24,40,-16,22
Silkeborg IF,5073,9,6,3,13,28,44,-16,21
Lyngby,5073,10,3,10,11,27,45,-18,19
AGF Aarhus,5073,11,4,6,12,16,39,-23,18
Brondby,5074,1,23,5,2,75,31,44,74
FC Midtjylla,5074,2,20,4,6,67,39,28,64
FC Nords,5074,3,13,7,10,72,53,19,46
Copenhagen,5074,4,13,5,12,57,48,9,44
AC Horsens,5074,5,7,14,9,36,52,-16,35
AaB,5074,6,7,11,12,33,43,-10,32
Sonderjyske,5074,7,8,6,10,28,29,-1,30
Randers FC,5074,8,6,6,12,26,41,-15,24
AGF Aarhus,5074,9,5,6,11,17,36,-19,21
Lyngby,5074,10,3,9,12,28,47,-19,18
Silkeborg IF,5074,11,5,3,14,25,45,-20,18
Brondby,5075,1,22,5,3,76,33,43,71
FC Midtjylla,5075,2,19,5,6,69,45,24,62
Copenhagen,5075,3,15,5,10,63,44,19,50
FC Nords,5075,4,13,8,9,73,56,17,47
AC Horsens,5075,5,6,14,10,34,54,-20,32
AaB,5075,6,6,13,11,36,45,-9,31
Sonderjyske,5075,7,8,6,10,28,29,-1,30
Lyngby,5075,8,4,9,11,27,44,-17,21
Randers FC,5075,9,5,6,13,23,40,-17,21
AGF Aarhus,5075,10,5,6,11,19,38,-19,21
Silkeborg IF,5075,11,5,3,14,27,47,-20,18
Brondby,5076,1,22,5,3,71,31,40,71
FC Midtjylla,5076,2,21,4,5,66,38,28,67
Copenhagen,5076,3,15,4,11,60,44,16,49
FC Nords,5076,4,13,7,10,70,53,17,46
AaB,5076,5,7,12,11,34,42,-8,33
Sonderjyske,5076,6,8,6,10,28,29,-1,30
AC Horsens,5076,7,6,12,12,33,52,-19,30
Randers FC,5076,8,6,6,12,26,41,-15,24
Silkeborg IF,5076,9,6,3,13,28,45,-17,21
Lyngby,5076,10,3,9,12,28,47,-19,18
AGF Aarhus,5076,11,4,6,12,17,39,-22,18
Brondby,5077,1,20,6,4,70,33,37,66
FC Midtjylla,5077,2,20,4,6,66,42,24,64
Copenhagen,5077,3,15,5,10,62,45,17,50
FC Nords,5077,4,14,7,9,76,52,24,49
AaB,5077,5,7,12,11,36,45,-9,33
AC Horsens,5077,6,7,12,11,35,54,-19,33
Sonderjyske,5077,7,8,6,10,28,29,-1,30
Randers FC,5077,8,6,6,12,25,39,-14,24
Silkeborg IF,5077,9,6,3,13,27,44,-17,21
Lyngby,5077,10,3,9,12,26,46,-20,18
AGF Aarhus,5077,11,4,6,12,16,38,-22,18
Brondby,5078,1,21,6,3,76,35,41,69
FC Midtjylla,5078,2,19,4,7,69,42,27,61
FC Nords,5078,3,14,6,10,79,63,16,48
Copenhagen,5078,4,14,4,12,60,48,12,46
AaB,5078,5,10,12,8,40,37,3,42
Sonderjyske,5078,6,8,6,10,28,29,-1,30
AC Horsens,5078,7,5,14,11,35,60,-25,29
Randers FC,5078,8,5,7,12,25,41,-16,22
Silkeborg IF,5078,9,6,3,13,29,46,-17,21
Lyngby,5078,10,3,10,11,28,46,-18,19
AGF Aarhus,5078,11,4,6,12,18,40,-22,18
Brondby,5079,1,20,5,5,67,33,34,65
FC Midtjylla,5079,2,19,5,6,60,35,25,62
FC Nords,5079,3,15,6,9,74,51,23,51
Copenhagen,5079,4,14,4,12,54,46,8,46
AaB,5079,5,8,12,10,38,40,-2,36
AC Horsens,5079,6,8,12,10,35,49,-14,36
Sonderjyske,5079,7,8,6,10,28,29,-1,30
Randers FC,5079,8,6,6,12,25,40,-15,24
Silkeborg IF,5079,9,6,3,13,27,45,-18,21
Lyngby,5079,10,3,9,12,27,46,-19,18
AGF Aarhus,5079,11,4,6,12,17,38,-21,18
Brondby,5080,1,21,6,3,70,33,37,69
FC Midtjylla,5080,2,20,4,6,68,39,29,64
FC Nords,5080,3,14,7,9,70,50,20,49
Copenhagen,5080,4,13,4,13,59,51,8,43
AaB,5080,5,8,11,11,40,44,-4,35
AC Horsens,5080,6,7,14,9,36,52,-16,35
Sonderjyske,5080,7,8,6,10,28,29,-1,30
Randers FC,5080,8,6,6,12,28,40,-12,24
Silkeborg IF,5080,9,6,3,13,28,44,-16,21
Lyngby,5080,10,3,9,12,27,49,-22,18
AGF Aarhus,5080,11,4,6,12,16,39,-23,18
Brondby,5081,1,21,5,4,72,34,38,68
FC Midtjylla,5081,2,19,4,7,63,40,23,61
FC Nords,5081,3,15,7,8,75,51,24,52
Copenhagen,5081,4,14,6,10,58,45,13,48
AC Horsens,5081,5,8,12,10,37,51,-14,36
Sonderjyske,5081,6,8,6,10,28,29,-1,30
AaB,5081,7,6,12,12,37,47,-10,30
Lyngby,5081,8,4,9,11,28,44,-16,21
Randers FC,5081,9,5,6,13,23,41,-18,21
AGF Aarhus,5081,10,5,6,11,17,36,-19,21
Silkeborg IF,5081,11,5,3,14,25,45,-20,18
Brondby,5082,1,20,8,2,68,31,37,68
FC Midtjylla,5082,2,19,5,6,63,40,23,62
Copenhagen,5082,3,14,6,10,57,42,15,48
FC Nords,5082,4,12,8,10,69,52,17,44
AC Horsens,5082,5,8,13,9,39,50,-11,37
AaB,5082,6,7,12,11,35,42,-7,33
Sonderjyske,5082,7,8,6,10,28,29,-1,30
Randers FC,5082,8,5,7,12,24,40,-16,22
Silkeborg IF,5082,9,6,3,13,27,45,-18,21
Lyngby,5082,10,3,10,11,27,45,-18,19
AGF Aarhus,5082,11,4,6,12,17,38,-21,18
Brondby,5083,1,21,5,4,76,36,40,68
FC Midtjylla,5083,2,20,5,5,68,42,26,65
FC Nords,5083,3,16,6,8,83,57,26,54
Copenhagen,5083,4,13,5,12,57,48,9,44
AaB,5083,5,8,11,11,39,44,-5,35
Sonderjyske,5083,6,8,6,10,28,29,-1,30
AC Horsens,5083,7,6,12,12,38,60,-22,30
Randers FC,5083,8,5,7,12,24,40,-16,22
Silkeborg IF,5083,9,6,3,13,29,46,-17,21
Lyngby,5083,10,3,10,11,27,45,-18,19
AGF Aarhus,5083,11,4,6,12,18,40,-22,18
Brondby,5084,1,22,5,3,72,28,44,71
FC Midtjylla,5084,2,20,4,6,65,42,23,64
FC Nords,5084,3,14,7,9,71,51,20,49
Copenhagen,5084,4,13,5,12,55,42,13,44
AaB,5084,5,7,12,11,35,46,-11,33
AC Horsens,5084,6,6,15,9,34,49,-15,33
Sonderjyske,5084,7,8,6,10,28,29,-1,30
Randers FC,5084,8,6,6,12,24,39,-15,24
Silkeborg IF,5084,9,5,4,13,25,44,-19,19
AGF Aarhus,5084,10,4,7,11,16,36,-20,19
Lyngby,5084,11,3,9,12,26,45,-19,18
Brondby,5085,1,22,5,3,70,30,40,71
FC Midtjylla,5085,2,20,5,5,65,39,26,65
FC Nords,5085,3,14,7,9,73,50,23,49
Copenhagen,5085,4,12,5,13,51,45,6,41
AaB,5085,5,9,12,9,40,41,-1,39
Sonderjyske,5085,6,8,6,10,28,29,-1,30
AC Horsens,5085,7,6,12,12,34,54,-20,30
Randers FC,5085,8,6,6,12,27,39,-12,24
AGF Aarhus,5085,9,5,6,11,19,37,-18,21
Silkeborg IF,5085,10,5,3,14,26,47,-21,18
Lyngby,5085,11,3,9,12,26,48,-22,18
FC Midtjylla,5086,1,22,4,4,68,32,36,70
Brondby,5086,2,20,5,5,68,33,35,65
Copenhagen,5086,3,14,5,11,56,45,11,47
FC Nords,5086,4,13,6,11,69,53,16,45
AaB,5086,5,8,11,11,35,41,-6,35
AC Horsens,5086,6,7,13,10,35,53,-18,34
Sonderjyske,5086,7,8,6,10,28,29,-1,30
Randers FC,5086,8,5,7,12,24,40,-16,22
Silkeborg IF,5086,9,6,3,13,28,45,-17,21
Lyngby,5086,10,3,10,11,27,45,-18,19
AGF Aarhus,5086,11,4,6,12,17,39,-22,18
Brondby,5087,1,21,5,4,72,36,36,68
FC Midtjylla,5087,2,20,5,5,68,39,29,65
FC Nords,5087,3,15,6,9,73,53,20,51
Copenhagen,5087,4,15,4,11,57,41,16,49
AaB,5087,5,7,12,11,33,41,-8,33
Sonderjyske,5087,6,8,6,10,28,29,-1,30
AC Horsens,5087,7,6,12,12,34,53,-19,30
Randers FC,5087,8,6,6,12,25,40,-15,24
Silkeborg IF,5087,9,5,4,13,26,45,-19,19
AGF Aarhus,5087,10,4,7,11,17,37,-20,19
Lyngby,5087,11,3,9,12,27,46,-19,18
Brondby,5088,1,20,7,3,77,38,39,67
FC Midtjylla,5088,2,20,5,5,70,42,28,65
FC Nords,5088,3,14,6,10,76,53,23,48
Copenhagen,5088,4,14,5,11,54,44,10,47
AaB,5088,5,8,11,11,36,44,-8,35
AC Horsens,5088,6,6,14,10,38,56,-18,32
Sonderjyske,5088,7,8,6,10,28,29,-1,30
Randers FC,5088,8,6,6,12,26,41,-15,24
Silkeborg IF,5088,9,5,4,13,28,47,-19,19
AGF Aarhus,5088,10,4,7,11,19,39,-20,19
Lyngby,5088,11,3,9,12,28,47,-19,18
Brondby,5089,1,20,6,4,68,34,34,66
FC Midtjylla,5089,2,19,7,4,68,37,31,64
FC Nords,5089,3,14,8,8,74,51,23,50
Copenhagen,5089,4,13,7,10,59,44,15,46
AaB,5089,5,7,13,10,34,41,-7,34
AC Horsens,5089,6,6,13,11,36,58,-22,31
Sonderjyske,5089,7,8,6,10,28,29,-1,30
Randers FC,5089,8,6,6,12,26,40,-14,24
Silkeborg IF,5089,9,6,3,13,31,45,-14,21
Lyngby,5089,10,3,9,12,27,47,-20,18
AGF Aarhus,5089,11,4,6,12,17,42,-25,18
Brondby,5090,1,20,5,5,73,35,38,65
FC Midtjylla,5090,2,19,5,6,63,39,24,62
FC Nords,5090,3,16,6,8,74,55,19,54
Copenhagen,5090,4,14,5,11,61,46,15,47
AC Horsens,5090,5,8,12,10,40,51,-11,36
AaB,5090,6,7,11,12,38,49,-11,32
Sonderjyske,5090,7,8,6,10,28,29,-1,30
Lyngby,5090,8,4,9,11,28,45,-17,21
Silkeborg IF,5090,9,6,3,13,27,44,-17,21
Randers FC,5090,10,5,6,13,24,41,-17,21
AGF Aarhus,5090,11,4,6,12,16,38,-22,18
Brondby,5091,1,19,7,4,66,32,34,64
FC Midtjylla,5091,2,19,5,6,67,40,27,62
FC Nords,5091,3,15,7,8,70,48,22,52
Copenhagen,5091,4,14,5,11,55,42,13,47
AC Horsens,5091,5,8,12,10,38,53,-15,36
AaB,5091,6,7,12,11,34,41,-7,33
Sonderjyske,5091,7,8,6,10,28,29,-1,30
Randers FC,5091,8,6,6,12,25,39,-14,24
Silkeborg IF,5091,9,5,4,13,25,44,-19,19
AGF Aarhus,5091,10,4,7,11,16,36,-20,19
Lyngby,5091,11,3,9,12,26,46,-20,18
Brondby,5092,1,20,7,3,67,31,36,67
FC Midtjylla,5092,2,19,4,7,65,40,25,61
FC Nords,5092,3,14,8,8,71,49,22,50
Copenhagen,5092,4,14,5,11,57,43,14,47
AaB,5092,5,7,14,9,37,43,-6,35
AC Horsens,5092,6,7,12,11,34,51,-17,33
Sonderjyske,5092,7,8,6,10,28,29,-1,30
Lyngby,5092,8,4,9,11,28,45,-17,21
Randers FC,5092,9,5,6,13,24,41,-17,21
AGF Aarhus,5092,10,5,6,11,18,37,-19,21
Silkeborg IF,5092,11,5,3,14,26,46,-20,18
Brondby,5093,1,22,5,3,73,33,40,71
FC Midtjylla,5093,2,19,5,6,65,42,23,62
FC Nords,5093,3,13,7,10,73,53,20,46
Copenhagen,5093,4,14,4,12,60,49,11,46
AC Horsens,5093,5,8,13,9,38,52,-14,37
AaB,5093,6,7,12,11,36,42,-6,33
Sonderjyske,5093,7,8,6,10,28,29,-1,30
Lyngby,5093,8,4,9,11,28,44,-16,21
Silkeborg IF,5093,9,6,3,13,29,47,-18,21
Randers FC,5093,10,5,6,13,23,41,-18,21
AGF Aarhus,5093,11,4,6,12,19,40,-21,18
Brondby,5094,1,21,6,3,76,37,39,69
FC Midtjylla,5094,2,20,5,5,66,39,27,65
FC Nords,5094,3,15,6,9,76,54,22,51
Copenhagen,5094,4,13,4,13,54,44,10,43
AC Horsens,5094,5,8,12,10,41,58,-17,36
AaB,5094,6,7,11,12,34,41,-7,32
Sonderjyske,5094,7,8,6,10,28,29,-1,30
Randers FC,5094,8,5,7,12,23,39,-16,22
Lyngby,5094,9,3,10,11,26,44,-18,19
Silkeborg IF,5094,10,5,4,13,27,46,-19,19
AGF Aarhus,5094,11,4,7,11,18,38,-20,19
Brondby,5095,1,22,5,3,73,32,41,71
FC Midtjylla,5095,2,19,5,6,61,39,22,62
FC Nords,5095,3,14,7,9,77,56,21,49
Copenhagen,5095,4,14,5,11,59,47,12,47
AC Horsens,5095,5,7,13,10,34,49,-15,34
AaB,5095,6,6,13,11,33,40,-7,31
Sonderjyske,5095,7,8,6,10,28,29,-1,30
Lyngby,5095,8,4,9,11,28,45,-17,21
Randers FC,5095,9,5,6,13,24,41,-17,21
Silkeborg IF,5095,10,5,4,13,26,45,-19,19
AGF Aarhus,5095,11,4,7,11,17,37,-20,19
Brondby,5096,1,21,6,3,76,34,42,69
FC Midtjylla,5096,2,19,5,6,68,43,25,62
Copenhagen,5096,3,16,4,10,61,43,18,52
FC Nords,5096,4,15,6,9,76,58,18,51
Sonderjyske,5096,5,8,6,10,28,29,-1,30
AaB,5096,6,6,12,12,37,48,-11,30
AC Horsens,5096,7,5,15,10,34,52,-18,30
Lyngby,5096,8,4,9,11,28,44,-16,21
Silkeborg IF,5096,9,6,3,13,27,44,-17,21
Randers FC,5096,10,5,6,13,23,41,-18,21
AGF Aarhus,5096,11,4,6,12,16,38,-22,18
Brondby,5097,1,20,7,3,70,31,39,67
FC Midtjylla,5097,2,19,6,5,67,40,27,63
FC Nords,5097,3,16,6,8,75,48,27,54
Copenhagen,5097,4,13,6,11,57,45,12,45
AaB,5097,5,6,14,10,35,45,-10,32
Sonderjyske,5097,6,8,6,10,28,29,-1,30
AC Horsens,5097,7,5,15,10,35,56,-21,30
Randers FC,5097,8,6,6,12,25,40,-15,24
Silkeborg IF,5097,9,6,3,13,26,44,-18,21
Lyngby,5097,10,3,9,12,27,46,-19,18
AGF Aarhus,5097,11,4,6,12,16,37,-21,18
Brondby,5098,1,20,5,5,71,36,35,65
FC Midtjylla,5098,2,19,5,6,66,40,26,62
FC Nords,5098,3,14,6,10,72,55,17,48
Copenhagen,5098,4,13,6,11,58,45,13,45
AaB,5098,5,10,12,8,43,40,3,42
AC Horsens,5098,6,6,14,10,35,55,-20,32
Sonderjyske,5098,7,8,6,10,28,29,-1,30
Lyngby,5098,8,4,9,11,28,44,-16,21
Randers FC,5098,9,5,6,13,23,41,-18,21
Silkeborg IF,5098,10,5,4,13,28,47,-19,19
AGF Aarhus,5098,11,4,7,11,19,39,-20,19
Brondby,5099,1,20,6,4,71,35,36,66
FC Midtjylla,5099,2,20,4,6,67,41,26,64
FC Nords,5099,3,15,8,7,76,52,24,53
Copenhagen,5099,4,14,6,10,54,40,14,48
AC Horsens,5099,5,7,13,10,37,50,-13,34
Sonderjyske,5099,6,8,6,10,28,29,-1,30
AaB,5099,7,6,11,13,35,48,-13,29
Lyngby,5099,8,4,9,11,27,44,-17,21
Randers FC,5099,9,5,6,13,23,40,-17,21
Silkeborg IF,5099,10,5,4,13,25,44,-19,19
AGF Aarhus,5099,11,4,7,11,16,36,-20,19
Brondby,5100,1,21,5,4,76,35,41,68
FC Midtjylla,5100,2,20,4,6,69,42,27,64
Copenhagen,5100,3,15,4,11,57,41,16,49
FC Nords,5100,4,13,7,10,69,54,15,46
AaB,5100,5,8,13,9,37,40,-3,37
AC Horsens,5100,6,6,13,11,32,54,-22,31
Sonderjyske,5100,7,8,6,10,28,29,-1,30
Lyngby,5100,8,4,9,11,28,45,-17,21
Randers FC,5100,9,5,6,13,24,41,-17,21
Silkeborg IF,5100,10,5,4,13,27,46,-19,19
AGF Aarhus,5100,11,4,7,11,18,38,-20,19
Brondby,5101,1,21,6,3,72,28,44,69
FC Midtjylla,5101,2,18,6,6,66,45,21,60
FC Nords,5101,3,15,6,9,74,50,24,51
Copenhagen,5101,4,15,4,11,58,43,15,49
AaB,5101,5,7,12,11,39,50,-11,33
AC Horsens,5101,6,7,12,11,36,55,-19,33
Sonderjyske,5101,7,8,6,10,28,29,-1,30
Lyngby,5101,8,4,9,11,29,44,-15,21
Randers FC,5101,9,5,6,13,23,42,-19,21
Silkeborg IF,5101,10,5,4,13,27,46,-19,19
AGF Aarhus,5101,11,4,7,11,18,38,-20,19
Brondby,5102,1,21,7,2,75,36,39,70
FC Midtjylla,5102,2,19,5,6,68,40,28,62
FC Nords,5102,3,14,6,10,75,59,16,48
Copenhagen,5102,4,14,5,11,59,46,13,47
AC Horsens,5102,5,8,12,10,40,54,-14,36
AaB,5102,6,7,11,12,37,45,-8,32
Sonderjyske,5102,7,8,6,10,28,29,-1,30
Lyngby,5102,8,4,9,11,29,44,-15,21
AGF Aarhus,5102,9,5,6,11,18,36,-18,21
Randers FC,5102,10,5,6,13,23,42,-19,21
Silkeborg IF,5102,11,5,3,14,25,46,-21,18
FC Midtjylla,5103,1,21,5,4,70,38,32,68
Brondby,5103,2,19,6,5,67,36,31,63
FC Nords,5103,3,14,7,9,77,55,22,49
Copenhagen,5103,4,15,4,11,63,48,15,49
AaB,5103,5,8,12,10,41,44,-3,36
Sonderjyske,5103,6,8,6,10,28,29,-1,30
AC Horsens,5103,7,5,14,11,34,57,-23,29
Randers FC,5103,8,5,7,12,24,40,-16,22
AGF Aarhus,5103,9,5,6,11,17,36,-19,21
Lyngby,5103,10,3,10,11,27,45,-18,19
Silkeborg IF,5103,11,5,3,14,25,45,-20,18
FC Midtjylla,5104,1,22,4,4,74,40,34,70
Brondby,5104,2,21,5,4,71,36,35,68
FC Nords,5104,3,15,6,9,76,52,24,51
Copenhagen,5104,4,14,4,12,58,47,11,46
AaB,5104,5,7,11,12,37,46,-9,32
Sonderjyske,5104,6,8,6,10,28,29,-1,30
AC Horsens,5104,7,6,12,12,34,55,-21,30
Randers FC,5104,8,5,7,12,24,40,-16,22
Lyngby,5104,9,3,10,11,27,45,-18,19
Silkeborg IF,5104,10,5,4,13,27,46,-19,19
AGF Aarhus,5104,11,4,7,11,18,38,-20,19
Brondby,5105,1,21,5,4,71,34,37,68
FC Midtjylla,5105,2,20,5,5,69,39,30,65
FC Nords,5105,3,14,6,10,80,60,20,48
Copenhagen,5105,4,14,4,12,63,48,15,46
AaB,5105,5,8,11,11,38,46,-8,35
AC Horsens,5105,6,7,13,10,36,56,-20,34
Sonderjyske,5105,7,8,6,10,28,29,-1,30
Randers FC,5105,8,5,7,12,24,40,-16,22
AGF Aarhus,5105,9,5,6,11,19,38,-19,21
Lyngby,5105,10,3,10,11,27,45,-18,19
Silkeborg IF,5105,11,5,3,14,27,47,-20,18
Brondby,5106,1,20,6,4,71,33,38,66
FC Midtjylla,5106,2,20,5,5,68,39,29,65
FC Nords,5106,3,14,9,7,77,52,25,51
Copenhagen,5106,4,14,4,12,56,45,11,46
AaB,5106,5,7,12,11,36,49,-13,33
AC Horsens,5106,6,6,14,10,36,52,-16,32
Sonderjyske,5106,7,8,6,10,28,29,-1,30
Lyngby,5106,8,4,9,11,28,44,-16,21
Randers FC,5106,9,5,6,13,23,41,-18,21
Silkeborg IF,5106,10,5,4,13,25,44,-19,19
AGF Aarhus,5106,11,4,7,11,16,36,-20,19
Brondby,5107,1,21,7,2,70,29,41,70
FC Midtjylla,5107,2,20,5,5,68,42,26,65
FC Nords,5107,3,15,6,9,73,51,22,51
Copenhagen,5107,4,12,8,10,55,43,12,44
AaB,5107,5,6,14,10,36,45,-9,32
Sonderjyske,5107,6,8,6,10,28,29,-1,30
AC Horsens,5107,7,5,14,11,36,54,-18,29
Randers FC,5107,8,5,7,12,23,39,-16,22
Silkeborg IF,5107,9,6,3,13,27,44,-17,21
Lyngby,5107,10,3,10,11,26,44,-18,19
AGF Aarhus,5107,11,4,6,12,16,38,-22,18
Brondby,5108,1,19,7,4,70,34,36,64
FC Midtjylla,5108,2,19,6,5,66,38,28,63
FC Nords,5108,3,16,6,8,75,53,22,54
Copenhagen,5108,4,13,7,10,58,44,14,46
AC Horsens,5108,5,7,14,9,34,48,-14,35
Sonderjyske,5108,6,8,6,10,28,29,-1,30
AaB,5108,7,6,12,12,33,45,-12,30
Randers FC,5108,8,6,6,12,26,39,-13,24
Silkeborg IF,5108,9,5,4,13,25,44,-19,19
AGF Aarhus,5108,10,4,7,11,16,36,-20,19
Lyngby,5108,11,3,9,12,26,47,-21,18
Brondby,5109,1,21,7,2,69,30,39,70
FC Midtjylla,5109,2,18,7,5,64,39,25,61
FC Nords,5109,3,14,7,9,73,51,22,49
Copenhagen,5109,4,12,6,12,55,48,7,42
AaB,5109,5,10,11,9,39,39,0,41
Sonderjyske,5109,6,8,6,10,28,29,-1,30
AC Horsens,5109,7,5,14,11,35,54,-19,29
Randers FC,5109,8,5,7,12,23,39,-16,22
Lyngby,5109,9,3,10,11,26,44,-18,19
Silkeborg IF,5109,10,5,4,13,27,46,-19,19
AGF Aarhus,5109,11,4,7,11,18,38,-20,19
FC Midtjylla,5110,1,20,5,5,69,40,29,65
Brondby,5110,2,19,6,5,64,32,32,63
FC Nords,5110,3,15,7,8,76,52,24,52
Copenhagen,5110,4,14,5,11,59,49,10,47
AaB,5110,5,9,11,10,42,41,1,38
Sonderjyske,5110,6,8,6,10,28,29,-1,30
AC Horsens,5110,7,6,12,12,34,56,-22,30
Randers FC,5110,8,6,6,12,24,39,-15,24
Silkeborg IF,5110,9,6,3,13,28,44,-16,21
Lyngby,5110,10,3,9,12,26,45,-19,18
AGF Aarhus,5110,11,4,6,12,16,39,-23,18
Brondby,5111,1,20,6,4,71,34,37,66
FC Midtjylla,5111,2,20,4,6,71,45,26,64
FC Nords,5111,3,15,7,8,76,51,25,52
Copenhagen,5111,4,13,6,11,57,45,12,45
AC Horsens,5111,5,8,13,9,37,53,-16,37
Sonderjyske,5111,6,8,6,10,28,29,-1,30
AaB,5111,7,6,12,12,38,48,-10,30
Lyngby,5111,8,4,9,11,28,45,-17,21
Randers FC,5111,9,5,6,13,24,41,-17,21
Silkeborg IF,5111,10,6,3,13,28,46,-18,21
AGF Aarhus,5111,11,4,6,12,18,39,-21,18
FC Midtjylla,5112,1,21,4,5,67,37,30,67
Brondby,5112,2,20,5,5,67,37,30,65
FC Nords,5112,3,14,7,9,70,50,20,49
Copenhagen,5112,4,14,5,11,59,46,13,47
AC Horsens,5112,5,8,12,10,36,48,-12,36
AaB,5112,6,7,11,12,35,42,-7,32
Sonderjyske,5112,7,8,6,10,28,29,-1,30
Lyngby,5112,8,4,9,11,28,45,-17,21
Randers FC,5112,9,5,6,13,24,41,-17,21
AGF Aarhus,5112,10,5,6,11,18,37,-19,21
Silkeborg IF,5112,11,5,3,14,26,46,-20,18
Brondby,5113,1,21,6,3,78,33,45,69
FC Midtjylla,5113,2,20,4,6,65,42,23,64
FC Nords,5113,3,15,7,8,76,52,24,52
Copenhagen,5113,4,13,4,13,53,47,6,43
AaB,5113,5,7,13,10,36,43,-7,34
AC Horsens,5113,6,7,12,11,35,52,-17,33
Sonderjyske,5113,7,8,6,10,28,29,-1,30
Lyngby,5113,8,4,9,11,27,44,-17,21
Randers FC,5113,9,5,6,13,23,40,-17,21
Silkeborg IF,5113,10,5,4,13,25,44,-19,19
AGF Aarhus,5113,11,4,7,11,16,36,-20,19
FC Midtjylla,5114,1,21,5,4,70,35,35,68
Brondby,5114,2,20,6,4,68,33,35,66
Copenhagen,5114,3,14,5,11,55,46,9,47
FC Nords,5114,4,13,7,10,70,54,16,46
AaB,5114,5,8,12,10,38,43,-5,36
AC Horsens,5114,6,6,13,11,35,51,-16,31
Sonderjyske,5114,7,8,6,10,28,29,-1,30
Lyngby,5114,8,4,9,11,27,44,-17,21
Randers FC,5114,9,5,6,13,23,40,-17,21
AGF Aarhus,5114,10,5,6,11,17,36,-19,21
Silkeborg IF,5114,11,5,3,14,25,45,-20,18
Brondby,5115,1,19,7,4,68,37,31,64
FC Midtjylla,5115,2,19,6,5,67,38,29,63
FC Nords,5115,3,16,7,7,79,51,28,55
Copenhagen,5115,4,12,6,12,57,49,8,42
AC Horsens,5115,5,8,12,10,39,54,-15,36
AaB,5115,6,7,12,11,35,42,-7,33
Sonderjyske,5115,7,8,6,10,28,29,-1,30
Randers FC,5115,8,5,7,12,25,41,-16,22
Silkeborg IF,5115,9,6,3,13,27,45,-18,21
Lyngby,5115,10,3,10,11,28,46,-18,19
AGF Aarhus,5115,11,4,6,12,17,38,-21,18
Brondby,5116,1,20,6,4,72,33,39,66
FC Midtjylla,5116,2,20,4,6,70,41,29,64
Copenhagen,5116,3,16,4,10,58,39,19,52
FC Nords,5116,4,14,7,9,73,53,20,49
AaB,5116,5,7,12,11,35,49,-14,33
AC Horsens,5116,6,6,13,11,35,54,-19,31
Sonderjyske,5116,7,8,6,10,28,29,-1,30
Lyngby,5116,8,4,9,11,28,45,-17,21
Randers FC,5116,9,5,6,13,24,41,-17,21
Silkeborg IF,5116,10,5,4,13,26,45,-19,19
AGF Aarhus,5116,11,4,7,11,17,37,-20,19
Brondby,5117,1,22,6,2,76,31,45,72
FC Midtjylla,5117,2,20,4,6,64,40,24,64
FC Nords,5117,3,13,7,10,74,53,21,46
Copenhagen,5117,4,14,4,12,57,48,9,46
AC Horsens,5117,5,7,13,10,38,53,-15,34
AaB,5117,6,7,12,11,36,46,-10,33
Sonderjyske,5117,7,8,6,10,28,29,-1,30
Lyngby,5117,8,4,9,11,28,45,-17,21
Randers FC,5117,9,5,6,13,24,41,-17,21
AGF Aarhus,5117,10,5,6,11,18,37,-19,21
Silkeborg IF,5117,11,5,3,14,26,46,-20,18
FC Midtjylla,5118,1,21,4,5,65,36,29,67
Brondby,5118,2,19,6,5,66,33,33,63
Copenhagen,5118,3,16,5,9,58,40,18,53
FC Nords,5118,4,13,8,9,73,55,18,47
AaB,5118,5,7,12,11,38,44,-6,33
AC Horsens,5118,6,6,13,11,36,54,-18,31
Sonderjyske,5118,7,8,6,10,28,29,-1,30
Randers FC,5118,8,6,6,12,24,39,-15,24
Silkeborg IF,5118,9,5,4,13,26,45,-19,19
AGF Aarhus,5118,10,4,7,11,17,37,-20,19
Lyngby,5118,11,3,9,12,26,45,-19,18
Brondby,5119,1,21,6,3,69,33,36,69
FC Midtjylla,5119,2,19,6,5,68,39,29,63
FC Nords,5119,3,14,8,8,77,52,25,50
Copenhagen,5119,4,13,5,12,57,46,11,44
AaB,5119,5,7,13,10,37,44,-7,34
AC Horsens,5119,6,6,14,10,32,52,-20,32
Sonderjyske,5119,7,8,6,10,28,29,-1,30
Lyngby,5119,8,4,9,11,29,45,-16,21
Silkeborg IF,5119,9,6,3,13,29,46,-17,21
Randers FC,5119,10,5,6,13,24,42,-18,21
AGF Aarhus,5119,11,4,6,12,18,40,-22,18
FC Midtjylla,5120,1,21,4,5,70,40,30,67
Brondby,5120,2,20,6,4,73,39,34,66
FC Nords,5120,3,15,7,8,76,51,25,52
Copenhagen,5120,4,13,7,10,56,45,11,46
AaB,5120,5,6,13,11,36,46,-10,31
AC Horsens,5120,6,6,13,11,36,52,-16,31
Sonderjyske,5120,7,8,6,10,28,29,-1,30
Randers FC,5120,8,6,6,12,24,39,-15,24
Silkeborg IF,5120,9,6,3,13,27,45,-18,21
Lyngby,5120,10,3,9,12,26,45,-19,18
AGF Aarhus,5120,11,4,6,12,17,38,-21,18
FC Midtjylla,5121,1,22,4,4,68,35,33,70
Brondby,5121,2,21,5,4,73,35,38,68
FC Nords,5121,3,14,6,10,74,52,22,48
Copenhagen,5121,4,12,5,13,60,53,7,41
AaB,5121,5,8,11,11,39,45,-6,35
AC Horsens,5121,6,7,13,10,37,57,-20,34
Sonderjyske,5121,7,8,6,10,28,29,-1,30
Randers FC,5121,8,6,6,12,26,40,-14,24
Silkeborg IF,5121,9,5,4,13,25,44,-19,19
AGF Aarhus,5121,10,4,7,11,16,36,-20,19
Lyngby,5121,11,3,9,12,27,47,-20,18
Brondby,5122,1,20,5,5,70,35,35,65
FC Midtjylla,5122,2,19,4,7,61,39,22,61
FC Nords,5122,3,15,6,9,75,51,24,51
Copenhagen,5122,4,15,5,10,56,40,16,50
AaB,5122,5,9,12,9,36,39,-3,39
Sonderjyske,5122,6,8,6,10,28,29,-1,30
AC Horsens,5122,7,6,12,12,32,52,-20,30
Randers FC,5122,8,6,6,12,25,40,-15,24
Silkeborg IF,5122,9,6,3,13,27,45,-18,21
Lyngby,5122,10,3,9,12,27,46,-19,18
AGF Aarhus,5122,11,4,6,12,17,38,-21,18
Brondby,5123,1,21,6,3,70,32,38,69
FC Midtjylla,5123,2,21,4,5,69,38,31,67
FC Nords,5123,3,14,6,10,69,53,16,48
Copenhagen,5123,4,14,5,11,57,47,10,47
AaB,5123,5,8,11,11,42,42,0,35
Sonderjyske,5123,6,8,6,10,28,29,-1,30
AC Horsens,5123,7,5,14,11,33,54,-21,29
Randers FC,5123,8,5,7,12,23,39,-16,22
AGF Aarhus,5123,9,5,6,11,18,37,-19,21
Lyngby,5123,10,3,10,11,26,44,-18,19
Silkeborg IF,5123,11,5,3,14,26,46,-20,18
Brondby,5124,1,22,6,2,78,31,47,72
FC Midtjylla,5124,2,20,5,5,62,35,27,65
FC Nords,5124,3,14,7,9,73,51,22,49
Copenhagen,5124,4,14,4,12,56,47,9,46
AaB,5124,5,6,13,11,34,45,-11,31
Sonderjyske,5124,6,8,6,10,28,29,-1,30
AC Horsens,5124,7,5,15,10,31,51,-20,30
Silkeborg IF,5124,8,6,3,13,29,45,-16,21
Lyngby,5124,9,4,9,11,28,45,-17,21
Randers FC,5124,10,5,6,13,24,41,-17,21
AGF Aarhus,5124,11,4,6,12,17,40,-23,18
Brondby,5125,1,21,6,3,72,32,40,69
FC Midtjylla,5125,2,17,5,8,63,52,11,56
FC Nords,5125,3,16,6,8,77,50,27,54
Copenhagen,5125,4,13,7,10,59,43,16,46
AC Horsens,5125,5,7,14,9,38,49,-11,35
AaB,5125,6,7,12,11,36,45,-9,33
Sonderjyske,5125,7,8,6,10,28,29,-1,30
Silkeborg IF,5125,8,6,3,13,28,44,-16,21
Lyngby,5125,9,4,9,11,29,46,-17,21
Randers FC,5125,10,5,6,13,25,42,-17,21
AGF Aarhus,5125,11,4,6,12,16,39,-23,18
FC Midtjylla,5126,1,21,4,5,66,38,28,67
Brondby,5126,2,20,6,4,66,31,35,66
FC Nords,5126,3,14,6,10,75,54,21,48
Copenhagen,5126,4,14,4,12,57,41,16,46
AaB,5126,5,8,13,9,36,40,-4,37
AC Horsens,5126,6,6,13,11,33,55,-22,31
Sonderjyske,5126,7,8,6,10,28,29,-1,30
Lyngby,5126,8,4,9,11,29,45,-16,21
Silkeborg IF,5126,9,6,3,13,27,44,-17,21
Randers FC,5126,10,5,6,13,24,42,-18,21
AGF Aarhus,5126,11,4,6,12,16,38,-22,18
FC Midtjylla,5127,1,20,5,5,65,36,29,65
Brondby,5127,2,19,7,4,65,35,30,64
FC Nords,5127,3,14,8,8,75,51,24,50
Copenhagen,5127,4,12,7,11,54,47,7,43
AaB,5127,5,9,12,9,42,41,1,39
AC Horsens,5127,6,6,13,11,35,52,-17,31
Sonderjyske,5127,7,8,6,10,28,29,-1,30
Randers FC,5127,8,6,6,12,27,41,-14,24
Silkeborg IF,5127,9,5,4,13,28,47,-19,19
AGF Aarhus,5127,10,4,7,11,19,39,-20,19
Lyngby,5127,11,3,9,12,28,48,-20,18
FC Midtjylla,5128,1,20,6,4,64,37,27,66
Brondby,5128,2,19,8,3,71,35,36,65
FC Nords,5128,3,15,8,7,76,47,29,53
Copenhagen,5128,4,13,6,11,58,46,12,45
AC Horsens,5128,5,6,14,10,36,54,-18,32
Sonderjyske,5128,6,8,6,10,28,29,-1,30
AaB,5128,7,6,12,12,32,44,-12,30
Randers FC,5128,8,6,6,12,26,40,-14,24
AGF Aarhus,5128,9,5,6,11,18,37,-19,21
Lyngby,5128,10,3,9,12,27,47,-20,18
Silkeborg IF,5128,11,5,3,14,26,46,-20,18
Brondby,5129,1,21,5,4,73,31,42,68
FC Midtjylla,5129,2,21,5,4,67,37,30,68
FC Nords,5129,3,15,6,9,72,54,18,51
Copenhagen,5129,4,14,5,11,59,46,13,47
AaB,5129,5,8,11,11,42,46,-4,35
Sonderjyske,5129,6,8,6,10,28,29,-1,30
AC Horsens,5129,7,5,12,13,35,60,-25,27
Lyngby,5129,8,4,9,11,29,46,-17,21
Randers FC,5129,9,5,6,13,25,42,-17,21
AGF Aarhus,5129,10,5,6,11,18,36,-18,21
Silkeborg IF,5129,11,5,3,14,25,46,-21,18
Brondby,5130,1,22,6,2,75,34,41,72
FC Midtjylla,5130,2,19,4,7,62,38,24,61
FC Nords,5130,3,14,9,7,74,49,25,51
Copenhagen,5130,4,12,6,12,54,46,8,42
AaB,5130,5,7,13,10,40,46,-6,34
AC Horsens,5130,6,6,14,10,33,51,-18,32
Sonderjyske,5130,7,8,6,10,28,29,-1,30
Silkeborg IF,5130,8,6,3,13,28,44,-16,21
Lyngby,5130,9,4,9,11,27,44,-17,21
Randers FC,5130,10,5,6,13,23,40,-17,21
AGF Aarhus,5130,11,4,6,12,16,39,-23,18
FC Midtjylla,5131,1,21,5,4,72,36,36,68
Brondby,5131,2,20,5,5,67,30,37,65
FC Nords,5131,3,15,6,9,73,50,23,51
Copenhagen,5131,4,14,6,10,56,44,12,48
AaB,5131,5,7,12,11,33,42,-9,33
Sonderjyske,5131,6,8,6,10,28,29,-1,30
AC Horsens,5131,7,6,12,12,31,56,-25,30
Randers FC,5131,8,6,6,12,25,40,-15,24
Silkeborg IF,5131,9,6,3,13,28,45,-17,21
Lyngby,5131,10,3,9,12,27,46,-19,18
AGF Aarhus,5131,11,4,6,12,17,39,-22,18
FC Midtjylla,5132,1,21,4,5,65,38,27,67
Brondby,5132,2,20,5,5,72,34,38,65
FC Nords,5132,3,14,7,9,74,53,21,49
Copenhagen,5132,4,15,4,11,60,47,13,49
AaB,5132,5,8,12,10,36,40,-4,36
Sonderjyske,5132,6,8,6,10,28,29,-1,30
AC Horsens,5132,7,5,14,11,34,55,-21,29
Randers FC,5132,8,5,7,12,25,41,-16,22
Lyngby,5132,9,3,10,11,28,46,-18,19
Silkeborg IF,5132,10,5,4,13,26,45,-19,19
AGF Aarhus,5132,11,4,7,11,17,37,-20,19
Brondby,5133,1,22,6,2,72,28,44,72
FC Midtjylla,5133,2,20,4,6,64,41,23,64
FC Nords,5133,3,14,6,10,69,52,17,48
Copenhagen,5133,4,14,5,11,57,42,15,47
AaB,5133,5,8,12,10,37,41,-4,36
Sonderjyske,5133,6,8,6,10,28,29,-1,30
AC Horsens,5133,7,5,13,12,32,53,-21,28
Randers FC,5133,8,5,7,12,24,40,-16,22
Silkeborg IF,5133,9,6,3,13,27,45,-18,21
Lyngby,5133,10,3,10,11,27,45,-18,19
AGF Aarhus,5133,11,4,6,12,17,38,-21,18
Brondby,5134,1,20,6,4,75,37,38,66
FC Midtjylla,5134,2,19,5,6,64,40,24,62
Copenhagen,5134,3,15,6,9,60,44,16,51
FC Nords,5134,4,14,7,9,75,55,20,49
AC Horsens,5134,5,7,13,10,38,54,-16,34
AaB,5134,6,6,13,11,37,45,-8,31
Sonderjyske,5134,7,8,6,10,28,29,-1,30
Randers FC,5134,8,6,6,12,24,39,-15,24
Silkeborg IF,5134,9,6,3,13,28,45,-17,21
Lyngby,5134,10,3,9,12,26,45,-19,18
AGF Aarhus,5134,11,4,6,12,17,39,-22,18
Brondby,5135,1,20,6,4,72,33,39,66
FC Midtjylla,5135,2,18,7,5,61,38,23,61
FC Nords,5135,3,14,7,9,75,55,20,49
Copenhagen,5135,4,14,7,9,63,43,20,49
AaB,5135,5,6,16,8,38,42,-4,34
Sonderjyske,5135,6,8,6,10,28,29,-1,30
AC Horsens,5135,7,5,15,10,36,60,-24,30
Randers FC,5135,8,6,6,12,26,39,-13,24
AGF Aarhus,5135,9,5,6,11,18,36,-18,21
Lyngby,5135,10,3,9,12,26,47,-21,18
Silkeborg IF,5135,11,5,3,14,25,46,-21,18
Brondby,5136,1,22,6,2,77,30,47,72
FC Midtjylla,5136,2,21,4,5,67,36,31,67
FC Nords,5136,3,14,6,10,76,56,20,48
Copenhagen,5136,4,13,5,12,55,46,9,44
AaB,5136,5,9,11,10,37,40,-3,38
Sonderjyske,5136,6,8,6,10,28,29,-1,30
AC Horsens,5136,7,5,12,13,33,63,-30,27
Silkeborg IF,5136,8,6,3,13,30,46,-16,21
Lyngby,5136,9,4,9,11,28,45,-17,21
Randers FC,5136,10,5,6,13,24,41,-17,21
AGF Aarhus,5136,11,4,6,12,18,41,-23,18
Brondby,5137,1,20,6,4,72,34,38,66
FC Midtjylla,5137,2,18,6,6,65,44,21,60
FC Nords,5137,3,15,7,8,73,47,26,52
Copenhagen,5137,4,14,7,9,59,42,17,49
AaB,5137,5,8,12,10,38,41,-3,36
Sonderjyske,5137,6,8,6,10,28,29,-1,30
AC Horsens,5137,7,5,14,11,35,60,-25,29
Lyngby,5137,8,4,9,11,30,46,-16,21
AGF Aarhus,5137,9,5,6,11,19,36,-17,21
Randers FC,5137,10,5,6,13,25,43,-18,21
Silkeborg IF,5137,11,5,3,14,25,47,-22,18
Brondby,5138,1,21,7,2,72,33,39,70
FC Midtjylla,5138,2,19,7,4,66,38,28,64
FC Nords,5138,3,13,7,10,71,52,19,46
Copenhagen,5138,4,12,6,12,54,46,8,42
AaB,5138,5,7,14,9,35,39,-4,35
AC Horsens,5138,6,7,13,10,35,51,-16,34
Sonderjyske,5138,7,8,6,10,28,29,-1,30
Randers FC,5138,8,6,6,12,26,39,-13,24
Silkeborg IF,5138,9,6,3,13,26,44,-18,21
Lyngby,5138,10,3,9,12,26,47,-21,18
AGF Aarhus,5138,11,4,6,12,16,37,-21,18
Brondby,5139,1,21,6,3,73,32,41,69
FC Midtjylla,5139,2,21,5,4,69,36,33,68
FC Nords,5139,3,15,6,9,76,51,25,51
Copenhagen,5139,4,14,4,12,57,48,9,46
AaB,5139,5,7,11,12,35,46,-11,32
Sonderjyske,5139,6,8,6,10,28,29,-1,30
AC Horsens,5139,7,6,12,12,31,54,-23,30
Lyngby,5139,8,4,9,11,29,45,-16,21
Silkeborg IF,5139,9,6,3,13,27,45,-18,21
Randers FC,5139,10,5,6,13,24,42,-18,21
AGF Aarhus,5139,11,4,6,12,17,38,-21,18
Brondby,5140,1,21,7,2,72,31,41,70
FC Midtjylla,5140,2,19,7,4,67,40,27,64
Copenhagen,5140,3,14,6,10,61,46,15,48
FC Nords,5140,4,12,6,12,69,56,13,42
AaB,5140,5,8,13,9,36,40,-4,37
AC Horsens,5140,6,6,13,11,37,55,-18,31
Sonderjyske,5140,7,8,6,10,28,29,-1,30
Randers FC,5140,8,5,7,12,25,41,-16,22
Silkeborg IF,5140,9,6,3,13,26,44,-18,21
Lyngby,5140,10,3,10,11,28,46,-18,19
AGF Aarhus,5140,11,4,6,12,16,37,-21,18
Brondby,5141,1,22,5,3,70,30,40,71
FC Midtjylla,5141,2,19,4,7,65,39,26,61
FC Nords,5141,3,13,7,10,70,57,13,46
Copenhagen,5141,4,14,4,12,58,45,13,46
AC Horsens,5141,5,8,13,9,36,49,-13,37
AaB,5141,6,8,11,11,39,44,-5,35
Sonderjyske,5141,7,8,6,10,28,29,-1,30
Lyngby,5141,8,4,9,11,28,44,-16,21
Randers FC,5141,9,5,6,13,23,41,-18,21
Silkeborg IF,5141,10,5,4,13,27,46,-19,19
AGF Aarhus,5141,11,4,7,11,18,38,-20,19
Brondby,5142,1,21,7,2,68,30,38,70
FC Midtjylla,5142,2,19,6,5,63,38,25,63
FC Nords,5142,3,13,8,9,71,54,17,47
Copenhagen,5142,4,13,6,11,58,44,14,45
AaB,5142,5,7,12,11,36,42,-6,33
AC Horsens,5142,6,6,15,9,35,49,-14,33
Sonderjyske,5142,7,8,6,10,28,29,-1,30
Randers FC,5142,8,5,7,12,25,41,-16,22
Silkeborg IF,5142,9,6,3,13,27,45,-18,21
Lyngby,5142,10,3,10,11,28,46,-18,19
AGF Aarhus,5142,11,4,6,12,17,38,-21,18
FC Midtjylla,5143,1,21,4,5,65,39,26,67
Brondby,5143,2,19,8,3,68,32,36,65
Copenhagen,5143,3,15,5,10,61,44,17,50
FC Nords,5143,4,13,8,9,73,53,20,47
AaB,5143,5,8,12,10,40,42,-2,36
Sonderjyske,5143,6,8,6,10,28,29,-1,30
AC Horsens,5143,7,5,13,12,33,56,-23,28
Randers FC,5143,8,5,7,12,24,40,-16,22
Lyngby,5143,9,3,10,11,27,45,-18,19
Silkeborg IF,5143,10,5,4,13,25,44,-19,19
AGF Aarhus,5143,11,4,7,11,16,36,-20,19
Brondby,5144,1,21,5,4,70,32,38,68
FC Midtjylla,5144,2,21,4,5,65,35,30,67
FC Nords,5144,3,15,6,9,74,53,21,51
Copenhagen,5144,4,15,4,11,59,43,16,49
AaB,5144,5,7,11,12,35,44,-9,32
Sonderjyske,5144,6,8,6,10,28,29,-1,30
AC Horsens,5144,7,6,12,12,33,55,-22,30
Randers FC,5144,8,5,7,12,23,39,-16,22
Silkeborg IF,5144,9,6,3,13,28,45,-17,21
Lyngby,5144,10,3,10,11,26,44,-18,19
AGF Aarhus,5144,11,4,6,12,17,39,-22,18
Brondby,5145,1,21,5,4,72,34,38,68
FC Midtjylla,5145,2,21,4,5,64,35,29,67
FC Nords,5145,3,14,7,9,70,52,18,49
Copenhagen,5145,4,14,4,12,59,46,13,46
AC Horsens,5145,5,7,13,10,34,49,-15,34
AaB,5145,6,7,11,12,36,45,-9,32
Sonderjyske,5145,7,8,6,10,28,29,-1,30
Lyngby,5145,8,4,9,11,28,45,-17,21
Randers FC,5145,9,5,6,13,24,41,-17,21
Silkeborg IF,5145,10,5,4,13,25,44,-19,19
AGF Aarhus,5145,11,4,7,11,16,36,-20,19
Brondby,5146,1,22,6,2,73,28,45,72
FC Midtjylla,5146,2,17,6,7,62,46,16,57
FC Nords,5146,3,15,7,8,74,48,26,52
Copenhagen,5146,4,13,6,11,57,45,12,45
AaB,5146,5,9,12,9,39,40,-1,39
Sonderjyske,5146,6,8,6,10,28,29,-1,30
AC Horsens,5146,7,5,13,12,33,57,-24,28
Randers FC,5146,8,5,7,12,23,39,-16,22
Lyngby,5146,9,3,10,11,26,44,-18,19
Silkeborg IF,5146,10,5,4,13,26,45,-19,19
AGF Aarhus,5146,11,4,7,11,17,37,-20,19
Brondby,5147,1,20,5,5,67,33,34,65
FC Midtjylla,5147,2,20,4,6,64,38,26,64
FC Nords,5147,3,15,7,8,73,48,25,52
Copenhagen,5147,4,13,6,11,57,47,10,45
AaB,5147,5,8,13,9,38,41,-3,37
AC Horsens,5147,6,6,13,11,32,50,-18,31
Sonderjyske,5147,7,8,6,10,28,29,-1,30
Randers FC,5147,8,5,7,12,23,39,-16,22
AGF Aarhus,5147,9,5,6,11,19,36,-17,21
Lyngby,5147,10,3,10,11,26,44,-18,19
Silkeborg IF,5147,11,5,3,14,25,47,-22,18
Brondby,5148,1,21,5,4,75,32,43,68
FC Midtjylla,5148,2,18,4,8,63,42,21,58
FC Nords,5148,3,16,6,8,78,53,25,54
Copenhagen,5148,4,14,5,11,57,45,12,47
AaB,5148,5,10,11,9,42,42,0,41
Sonderjyske,5148,6,8,6,10,28,29,-1,30
AC Horsens,5148,7,5,13,12,32,59,-27,28
Randers FC,5148,8,5,7,12,25,41,-16,22
Silkeborg IF,5148,9,6,3,13,28,44,-16,21
Lyngby,5148,10,3,10,11,28,46,-18,19
AGF Aarhus,5148,11,4,6,12,16,39,-23,18
Brondby,5149,1,21,6,3,72,33,39,69
FC Midtjylla,5149,2,19,5,6,64,42,22,62
FC Nords,5149,3,15,8,7,80,49,31,53
Copenhagen,5149,4,13,7,10,59,44,15,46
AaB,5149,5,8,11,11,36,47,-11,35
Sonderjyske,5149,6,8,6,10,28,29,-1,30
AC Horsens,5149,7,5,13,12,32,54,-22,28
Randers FC,5149,8,6,6,12,25,39,-14,24
Silkeborg IF,5149,9,6,3,13,30,46,-16,21
Lyngby,5149,10,3,9,12,26,46,-20,18
AGF Aarhus,5149,11,4,6,12,18,41,-23,18
FC Midtjylla,5150,1,21,5,4,69,36,33,68
Brondby,5150,2,20,6,4,66,31,35,66
FC Nords,5150,3,14,7,9,71,51,20,49
Copenhagen,5150,4,13,5,12,53,42,11,44
AC Horsens,5150,5,7,13,10,33,51,-18,34
AaB,5150,6,7,12,11,38,45,-7,33
Sonderjyske,5150,7,8,6,10,28,29,-1,30
Randers FC,5150,8,5,7,12,25,41,-16,22
Lyngby,5150,9,3,10,11,28,46,-18,19
Silkeborg IF,5150,10,5,4,13,25,44,-19,19
AGF Aarhus,5150,11,4,7,11,16,36,-20,19
Brondby,5151,1,21,6,3,74,31,43,69
FC Midtjylla,5151,2,19,6,5,65,39,26,63
FC Nords,5151,3,15,7,8,75,49,26,52
Copenhagen,5151,4,12,5,13,53,47,6,41
AaB,5151,5,8,12,10,37,44,-7,36
AC Horsens,5151,6,6,14,10,31,51,-20,32
Sonderjyske,5151,7,8,6,10,28,29,-1,30
Randers FC,5151,8,5,7,12,25,41,-16,22
Silkeborg IF,5151,9,6,3,13,27,45,-18,21
Lyngby,5151,10,3,10,11,28,46,-18,19
AGF Aarhus,5151,11,4,6,12,17,38,-21,18
Brondby,5152,1,21,6,3,73,34,39,69
FC Midtjylla,5152,2,19,5,6,65,38,27,62
FC Nords,5152,3,14,7,9,70,52,18,49
Copenhagen,5152,4,15,4,11,61,48,13,49
AaB,5152,5,8,12,10,40,42,-2,36
Sonderjyske,5152,6,8,6,10,28,29,-1,30
AC Horsens,5152,7,5,14,11,37,58,-21,29
Lyngby,5152,8,4,9,11,28,45,-17,21
Randers FC,5152,9,5,6,13,24,41,-17,21
Silkeborg IF,5152,10,5,4,13,26,45,-19,19
AGF Aarhus,5152,11,4,7,11,17,37,-20,19
FC Midtjylla,5153,1,20,6,4,70,38,32,66
Brondby,5153,2,19,8,3,70,33,37,65
Copenhagen,5153,3,15,6,9,58,41,17,51
FC Nords,5153,4,13,9,8,73,50,23,48
AaB,5153,5,6,13,11,34,45,-11,31
Sonderjyske,5153,6,8,6,10,28,29,-1,30
AC Horsens,5153,7,5,14,11,32,56,-24,29
Lyngby,5153,8,4,9,11,27,44,-17,21
Randers FC,5153,9,5,6,13,23,40,-17,21
AGF Aarhus,5153,10,5,6,11,19,37,-18,21
Silkeborg IF,5153,11,5,3,14,26,47,-21,18
Brondby,5154,1,21,5,4,70,36,34,68
FC Midtjylla,5154,2,18,6,6,63,41,22,60
Copenhagen,5154,3,15,5,10,62,44,18,50
FC Nords,5154,4,14,6,10,73,53,20,48
AC Horsens,5154,5,8,13,9,39,51,-12,37
AaB,5154,6,7,11,12,36,44,-8,32
Sonderjyske,5154,7,8,6,10,28,29,-1,30
Lyngby,5154,8,4,9,11,30,44,-14,21
Randers FC,5154,9,5,6,13,23,43,-20,21
Silkeborg IF,5154,10,5,4,13,27,46,-19,19
AGF Aarhus,5154,11,4,7,11,18,38,-20,19
Brondby,5155,1,20,6,4,69,33,36,66
FC Midtjylla,5155,2,19,4,7,67,41,26,61
FC Nords,5155,3,15,6,9,72,51,21,51
Copenhagen,5155,4,13,5,12,54,44,10,44
AaB,5155,5,11,11,8,43,40,3,44
Sonderjyske,5155,6,8,6,10,28,29,-1,30
AC Horsens,5155,7,6,12,12,36,58,-22,30
Randers FC,5155,8,6,6,12,25,39,-14,24
Silkeborg IF,5155,9,5,4,13,25,44,-19,19
AGF Aarhus,5155,10,4,7,11,16,36,-20,19
Lyngby,5155,11,3,9,12,26,46,-20,18
Brondby,5156,1,21,5,4,70,30,40,68
FC Midtjylla,5156,2,19,6,5,67,42,25,63
FC Nords,5156,3,14,8,8,71,48,23,50
Copenhagen,5156,4,14,4,12,58,47,11,46
AC Horsens,5156,5,8,13,9,39,52,-13,37
Sonderjyske,5156,6,8,6,10,28,29,-1,30
AaB,5156,7,6,12,12,32,44,-12,30
Lyngby,5156,8,4,9,11,28,44,-16,21
Randers FC,5156,9,5,6,13,23,41,-18,21
AGF Aarhus,5156,10,5,6,11,19,37,-18,21
Silkeborg IF,5156,11,5,3,14,26,47,-21,18
Brondby,5157,1,20,8,2,69,32,37,68
FC Midtjylla,5157,2,20,5,5,71,40,31,65
FC Nords,5157,3,14,8,8,71,49,22,50
Copenhagen,5157,4,13,5,12,58,47,11,44
AaB,5157,5,7,12,11,35,46,-11,33
AC Horsens,5157,6,6,14,10,32,48,-16,32
Sonderjyske,5157,7,8,6,10,28,29,-1,30
Randers FC,5157,8,5,7,12,25,41,-16,22
Silkeborg IF,5157,9,6,3,13,27,44,-17,21
Lyngby,5157,10,3,10,11,28,46,-18,19
AGF Aarhus,5157,11,4,6,12,16,38,-22,18
Brondby,5158,1,22,6,2,76,33,43,72
FC Midtjylla,5158,2,19,4,7,65,41,24,61
FC Nords,5158,3,15,6,9,79,54,25,51
Copenhagen,5158,4,14,5,11,57,46,11,47
AaB,5158,5,7,11,12,37,49,-12,32
AC Horsens,5158,6,6,14,10,37,54,-17,32
Sonderjyske,5158,7,8,6,10,28,29,-1,30
Randers FC,5158,8,6,6,12,24,39,-15,24
Silkeborg IF,5158,9,6,3,13,26,44,-18,21
Lyngby,5158,10,3,9,12,26,45,-19,18
AGF Aarhus,5158,11,4,6,12,16,37,-21,18
Brondby,5159,1,21,6,3,75,34,41,69
FC Midtjylla,5159,2,21,4,5,68,38,30,67
FC Nords,5159,3,15,6,9,74,53,21,51
Copenhagen,5159,4,12,5,13,54,48,6,41
AaB,5159,5,8,11,11,36,44,-8,35
AC Horsens,5159,6,7,12,11,37,53,-16,33
Sonderjyske,5159,7,8,6,10,28,29,-1,30
Lyngby,5159,8,4,9,11,29,45,-16,21
Randers FC,5159,9,5,6,13,24,42,-18,21
Silkeborg IF,5159,10,5,4,13,25,44,-19,19
AGF Aarhus,5159,11,4,7,11,16,36,-20,19
Brondby,5160,1,21,5,4,73,35,38,68
FC Midtjylla,5160,2,20,5,5,67,36,31,65
FC Nords,5160,3,15,7,8,74,48,26,52
Copenhagen,5160,4,15,4,11,62,50,12,49
AaB,5160,5,7,11,12,37,49,-12,32
Sonderjyske,5160,6,8,6,10,28,29,-1,30
AC Horsens,5160,7,6,12,12,36,57,-21,30
Lyngby,5160,8,4,9,11,30,44,-14,21
AGF Aarhus,5160,9,5,6,11,18,36,-18,21
Randers FC,5160,10,5,6,13,23,43,-20,21
Silkeborg IF,5160,11,5,3,14,25,46,-21,18
Brondby,5161,1,20,6,4,65,31,34,66
FC Midtjylla,5161,2,18,5,7,64,42,22,59
FC Nords,5161,3,17,6,7,75,45,30,57
Copenhagen,5161,4,15,5,10,62,45,17,50
AaB,5161,5,8,12,10,39,41,-2,36
Sonderjyske,5161,6,8,6,10,28,29,-1,30
AC Horsens,5161,7,5,12,13,31,58,-27,27
Lyngby,5161,8,4,9,11,27,44,-17,21
Randers FC,5161,9,5,6,13,23,40,-17,21
Silkeborg IF,5161,10,6,3,13,27,45,-18,21
AGF Aarhus,5161,11,4,6,12,17,38,-21,18
Brondby,5162,1,22,5,3,77,33,44,71
FC Midtjylla,5162,2,19,4,7,62,40,22,61
FC Nords,5162,3,15,7,8,76,53,23,52
Copenhagen,5162,4,14,4,12,57,45,12,46
AaB,5162,5,8,11,11,40,44,-4,35
AC Horsens,5162,6,6,13,11,34,57,-23,31
Sonderjyske,5162,7,8,6,10,28,29,-1,30
Randers FC,5162,8,6,6,12,26,40,-14,24
AGF Aarhus,5162,9,5,6,11,21,38,-17,21
Lyngby,5162,10,3,9,12,27,47,-20,18
Silkeborg IF,5162,11,5,3,14,27,49,-22,18
FC Midtjylla,5163,1,20,5,5,69,38,31,65
Brondby,5163,2,18,7,5,66,35,31,61
FC Nords,5163,3,15,7,8,71,51,20,52
Copenhagen,5163,4,13,5,12,56,49,7,44
AC Horsens,5163,5,8,13,9,39,49,-10,37
AaB,5163,6,7,13,10,36,41,-5,34
Sonderjyske,5163,7,8,6,10,28,29,-1,30
Lyngby,5163,8,4,9,11,29,44,-15,21
AGF Aarhus,5163,9,5,6,11,19,36,-17,21
Randers FC,5163,10,5,6,13,23,42,-19,21
Silkeborg IF,5163,11,5,3,14,25,47,-22,18
FC Midtjylla,5164,1,22,4,4,71,38,33,70
Brondby,5164,2,20,6,4,71,32,39,66
FC Nords,5164,3,14,7,9,75,56,19,49
Copenhagen,5164,4,14,4,12,54,45,9,46
AaB,5164,5,8,11,11,37,43,-6,35
Sonderjyske,5164,6,8,6,10,28,29,-1,30
AC Horsens,5164,7,6,12,12,33,53,-20,30
Randers FC,5164,8,5,7,12,24,40,-16,22
Silkeborg IF,5164,9,6,3,13,28,44,-16,21
Lyngby,5164,10,3,10,11,27,45,-18,19
AGF Aarhus,5164,11,4,6,12,16,39,-23,18
FC Midtjylla,5165,1,22,4,4,75,37,38,70
Brondby,5165,2,19,8,3,73,38,35,65
Copenhagen,5165,3,15,5,10,59,48,11,50
FC Nords,5165,4,13,7,10,74,55,19,46
AaB,5165,5,7,12,11,37,43,-6,33
Sonderjyske,5165,6,8,6,10,28,29,-1,30
AC Horsens,5165,7,5,14,11,35,58,-23,29
Randers FC,5165,8,6,6,12,24,39,-15,24
AGF Aarhus,5165,9,5,6,11,19,37,-18,21
Lyngby,5165,10,3,9,12,26,45,-19,18
Silkeborg IF,5165,11,5,3,14,26,47,-21,18
Brondby,5166,1,20,5,5,67,34,33,65
FC Midtjylla,5166,2,20,5,5,69,41,28,65
FC Nords,5166,3,15,6,9,74,49,25,51
Copenhagen,5166,4,14,4,12,57,49,8,46
AaB,5166,5,8,11,11,38,44,-6,35
AC Horsens,5166,6,7,13,10,36,50,-14,34
Sonderjyske,5166,7,8,6,10,28,29,-1,30
Lyngby,5166,8,4,9,11,27,44,-17,21
Randers FC,5166,9,5,6,13,23,40,-17,21
Silkeborg IF,5166,10,6,3,13,27,45,-18,21
AGF Aarhus,5166,11,4,6,12,17,38,-21,18
Brondby,5167,1,21,5,4,74,33,41,68
FC Midtjylla,5167,2,20,4,6,68,39,29,64
FC Nords,5167,3,15,6,9,76,51,25,51
Copenhagen,5167,4,14,4,12,57,46,11,46
AaB,5167,5,8,12,10,37,40,-3,36
AC Horsens,5167,6,6,13,11,34,63,-29,31
Sonderjyske,5167,7,8,6,10,28,29,-1,30
Randers FC,5167,8,6,6,12,25,40,-15,24
Silkeborg IF,5167,9,6,3,13,26,44,-18,21
Lyngby,5167,10,3,9,12,27,46,-19,18
AGF Aarhus,5167,11,4,6,12,16,37,-21,18
Brondby,5168,1,20,7,3,67,30,37,67
FC Midtjylla,5168,2,19,5,6,66,39,27,62
FC Nords,5168,3,14,6,10,69,52,17,48
Copenhagen,5168,4,13,6,11,57,47,10,45
AaB,5168,5,9,11,10,41,43,-2,38
AC Horsens,5168,6,7,13,10,35,50,-15,34
Sonderjyske,5168,7,8,6,10,28,29,-1,30
Randers FC,5168,8,6,6,12,24,39,-15,24
Silkeborg IF,5168,9,6,3,13,27,44,-17,21
Lyngby,5168,10,3,9,12,26,45,-19,18
AGF Aarhus,5168,11,4,6,12,16,38,-22,18
Brondby,5169,1,22,5,3,71,31,40,71
FC Midtjylla,5169,2,20,5,5,67,40,27,65
FC Nords,5169,3,15,6,9,71,50,21,51
Copenhagen,5169,4,13,5,12,58,48,10,44
AaB,5169,5,7,12,11,38,45,-7,33
AC Horsens,5169,6,6,13,11,38,55,-17,31
Sonderjyske,5169,7,8,6,10,28,29,-1,30
Lyngby,5169,8,4,9,11,27,44,-17,21
Randers FC,5169,9,5,6,13,23,40,-17,21
Silkeborg IF,5169,10,6,3,13,28,46,-18,21
AGF Aarhus,5169,11,4,6,12,18,39,-21,18
FC Midtjylla,5170,1,20,6,4,65,36,29,66
Brondby,5170,2,20,5,5,67,32,35,65
FC Nords,5170,3,15,8,7,75,48,27,53
Copenhagen,5170,4,14,4,12,59,46,13,46
AC Horsens,5170,5,6,14,10,33,51,-18,32
AaB,5170,6,6,13,11,35,47,-12,31
Sonderjyske,5170,7,8,6,10,28,29,-1,30
Lyngby,5170,8,4,9,11,27,44,-17,21
Randers FC,5170,9,5,6,13,23,40,-17,21
Silkeborg IF,5170,10,6,3,13,28,46,-18,21
AGF Aarhus,5170,11,4,6,12,18,39,-21,18
Brondby,5171,1,21,5,4,67,34,33,68
FC Midtjylla,5171,2,18,4,8,63,45,18,58
FC Nords,5171,3,15,7,8,80,49,31,52
Copenhagen,5171,4,15,4,11,61,50,11,49
AaB,5171,5,9,12,9,37,38,-1,39
Sonderjyske,5171,6,8,6,10,28,29,-1,30
AC Horsens,5171,7,6,12,12,33,51,-18,30
Lyngby,5171,8,4,9,11,28,44,-16,21
Silkeborg IF,5171,9,6,3,13,28,46,-18,21
Randers FC,5171,10,5,6,13,23,41,-18,21
AGF Aarhus,5171,11,4,6,12,18,39,-21,18
Brondby,5172,1,19,7,4,70,33,37,64
FC Midtjylla,5172,2,19,4,7,63,42,21,61
Copenhagen,5172,3,16,5,9,59,40,19,53
FC Nords,5172,4,15,7,8,74,50,24,52
AC Horsens,5172,5,6,14,10,36,53,-17,32
AaB,5172,6,6,13,11,38,48,-10,31
Sonderjyske,5172,7,8,6,10,28,29,-1,30
Lyngby,5172,8,4,9,11,27,44,-17,21
Silkeborg IF,5172,8,6,3,13,27,44,-17,21
Randers FC,5172,10,5,6,13,23,40,-17,21
AGF Aarhus,5172,11,4,6,12,16,38,-22,18
FC Midtjylla,5173,1,19,5,6,67,39,28,62
Brondby,5173,2,19,5,6,66,40,26,62
FC Nords,5173,3,14,9,7,75,51,24,51
Copenhagen,5173,4,14,6,10,56,41,15,48
AaB,5173,5,8,12,10,36,41,-5,36
AC Horsens,5173,6,7,13,10,39,53,-14,34
Sonderjyske,5173,7,8,6,10,28,29,-1,30
Lyngby,5173,8,4,9,11,28,45,-17,21
Randers FC,5173,9,5,6,13,24,41,-17,21
Silkeborg IF,5173,10,6,3,13,26,44,-18,21
AGF Aarhus,5173,11,4,6,12,16,37,-21,18
Brondby,5174,1,20,5,5,67,34,33,65
FC Midtjylla,5174,2,20,5,5,66,37,29,65
Copenhagen,5174,3,16,5,9,63,41,22,53
FC Nords,5174,4,13,6,11,71,56,15,45
AaB,5174,5,8,12,10,36,41,-5,36
AC Horsens,5174,6,6,13,11,33,53,-20,31
Sonderjyske,5174,7,8,6,10,28,29,-1,30
Randers FC,5174,8,6,6,12,24,39,-15,24
Silkeborg IF,5174,9,6,3,13,28,44,-16,21
Lyngby,5174,10,3,9,12,26,45,-19,18
AGF Aarhus,5174,11,4,6,12,16,39,-23,18
Brondby,5175,1,20,6,4,71,36,35,66
FC Midtjylla,5175,2,19,5,6,72,42,30,62
Copenhagen,5175,3,15,6,9,62,45,17,51
FC Nords,5175,4,12,9,9,71,52,19,45
AaB,5175,5,8,11,11,37,46,-9,35
AC Horsens,5175,6,7,13,10,36,54,-18,34
Sonderjyske,5175,7,8,6,10,28,29,-1,30
Lyngby,5175,8,4,9,11,29,44,-15,21
Randers FC,5175,9,5,6,13,23,42,-19,21
Silkeborg IF,5175,10,5,4,13,28,47,-19,19
AGF Aarhus,5175,11,4,7,11,19,39,-20,19
FC Midtjylla,5176,1,21,5,4,70,40,30,68
Brondby,5176,2,20,6,4,71,35,36,66
FC Nords,5176,3,14,6,10,73,51,22,48
Copenhagen,5176,4,12,4,14,57,52,5,40
AaB,5176,5,9,11,10,38,43,-5,38
AC Horsens,5176,6,8,12,10,42,56,-14,36
Sonderjyske,5176,7,8,6,10,28,29,-1,30
AGF Aarhus,5176,8,5,6,11,22,37,-15,21
Lyngby,5176,9,4,9,11,28,45,-17,21
Randers FC,5176,10,5,6,13,24,41,-17,21
Silkeborg IF,5176,11,5,3,14,26,50,-24,18
Brondby,5177,1,20,6,4,69,35,34,66
FC Midtjylla,5177,2,20,6,4,64,35,29,66
FC Nords,5177,3,13,7,10,70,51,19,46
Copenhagen,5177,4,13,7,10,57,45,12,46
AaB,5177,5,7,13,10,36,42,-6,34
AC Horsens,5177,6,6,15,9,36,50,-14,33
Sonderjyske,5177,7,8,6,10,28,29,-1,30
Randers FC,5177,8,6,6,12,25,39,-14,24
AGF Aarhus,5177,9,5,6,11,18,37,-19,21
Lyngby,5177,10,3,9,12,26,46,-20,18
Silkeborg IF,5177,10,5,3,14,26,46,-20,18
Brondby,5178,1,22,5,3,73,29,44,71
FC Midtjylla,5178,2,19,5,6,62,39,23,62
FC Nords,5178,3,14,8,8,72,50,22,50
Copenhagen,5178,4,14,6,10,55,41,14,48
AaB,5178,5,6,15,9,34,43,-9,33
Sonderjyske,5178,6,8,6,10,28,29,-1,30
AC Horsens,5178,7,5,13,12,33,53,-20,28
Lyngby,5178,8,4,9,11,28,45,-17,21
Randers FC,5178,9,5,6,13,24,41,-17,21
AGF Aarhus,5178,10,5,6,11,19,36,-17,21
Silkeborg IF,5178,11,5,3,14,25,47,-22,18
FC Midtjylla,5179,1,22,4,4,68,38,30,70
Brondby,5179,2,19,7,4,69,38,31,64
FC Nords,5179,3,14,7,9,73,49,24,49
Copenhagen,5179,4,12,6,12,54,45,9,42
AaB,5179,5,7,14,9,37,40,-3,35
AC Horsens,5179,6,6,14,10,36,53,-17,32
Sonderjyske,5179,7,8,6,10,28,29,-1,30
Lyngby,5179,8,4,9,11,27,44,-17,21
Randers FC,5179,9,5,6,13,23,40,-17,21
Silkeborg IF,5179,10,5,4,13,25,44,-19,19
AGF Aarhus,5179,11,4,7,11,16,36,-20,19
Brondby,5180,1,21,5,4,72,35,37,68
FC Midtjylla,5180,2,18,6,6,65,41,24,60
Copenhagen,5180,3,15,5,10,57,39,18,50
FC Nords,5180,4,14,7,9,72,55,17,49
AaB,5180,5,8,12,10,37,40,-3,36
AC Horsens,5180,6,6,13,11,35,54,-19,31
Sonderjyske,5180,7,8,6,10,28,29,-1,30
Lyngby,5180,8,4,9,11,27,44,-17,21
Randers FC,5180,9,5,6,13,23,40,-17,21
AGF Aarhus,5180,10,5,6,11,18,37,-19,21
Silkeborg IF,5180,11,5,3,14,26,46,-20,18
Brondby,5181,1,21,5,4,67,33,34,68
FC Midtjylla,5181,2,20,4,6,66,38,28,64
Copenhagen,5181,3,15,6,9,63,43,20,51
FC Nords,5181,4,13,8,9,73,52,21,47
AaB,5181,5,6,14,10,38,46,-8,32
AC Horsens,5181,6,6,13,11,36,57,-21,31
Sonderjyske,5181,7,8,6,10,28,29,-1,30
Randers FC,5181,8,6,6,12,24,39,-15,24
Silkeborg IF,5181,9,6,3,13,27,44,-17,21
Lyngby,5181,10,3,9,12,26,45,-19,18
AGF Aarhus,5181,11,4,6,12,16,38,-22,18
Brondby,5182,1,22,6,2,73,29,44,72
FC Midtjylla,5182,2,21,4,5,69,37,32,67
FC Nords,5182,3,14,7,9,76,57,19,49
Copenhagen,5182,4,12,5,13,55,50,5,41
AaB,5182,5,7,13,10,36,44,-8,34
AC Horsens,5182,6,6,13,11,31,49,-18,31
Sonderjyske,5182,7,8,6,10,28,29,-1,30
Randers FC,5182,8,5,7,12,23,39,-16,22
AGF Aarhus,5182,9,5,6,11,17,36,-19,21
Lyngby,5182,10,3,10,11,26,44,-18,19
Silkeborg IF,5182,11,5,3,14,25,45,-20,18
Brondby,5183,1,21,5,4,67,32,35,68
FC Midtjylla,5183,2,19,4,7,64,41,23,61
FC Nords,5183,3,16,6,8,81,53,28,54
Copenhagen,5183,4,14,4,12,57,46,11,46
AaB,5183,5,9,11,10,40,42,-2,38
Sonderjyske,5183,6,8,6,10,28,29,-1,30
AC Horsens,5183,7,6,12,12,33,54,-21,30
Randers FC,5183,8,6,6,12,25,40,-15,24
AGF Aarhus,5183,9,5,6,11,20,39,-19,21
Lyngby,5183,10,3,9,12,27,46,-19,18
Silkeborg IF,5183,11,5,3,14,28,48,-20,18
Brondby,5184,1,20,7,3,66,31,35,67
FC Midtjylla,5184,2,20,5,5,70,40,30,65
FC Nords,5184,3,14,8,8,72,50,22,50
Copenhagen,5184,4,13,5,12,58,49,9,44
AC Horsens,5184,5,7,13,10,36,50,-14,34
AaB,5184,6,6,14,10,37,45,-8,32
Sonderjyske,5184,7,8,6,10,28,29,-1,30
Lyngby,5184,8,4,9,11,31,46,-15,21
Silkeborg IF,5184,9,6,3,13,27,44,-17,21
Randers FC,5184,10,5,6,13,25,44,-19,21
AGF Aarhus,5184,11,4,6,12,16,38,-22,18
Brondby,5185,1,21,5,4,72,34,38,68
FC Midtjylla,5185,2,19,5,6,64,41,23,62
Copenhagen,5185,3,14,5,11,61,45,16,47
FC Nords,5185,4,13,7,10,74,57,17,46
AaB,5185,5,8,12,10,39,43,-4,36
AC Horsens,5185,6,8,12,10,37,53,-16,36
Sonderjyske,5185,7,8,6,10,28,29,-1,30
Randers FC,5185,8,5,7,12,24,40,-16,22
Lyngby,5185,9,3,10,11,27,45,-18,19
Silkeborg IF,5185,10,5,4,13,27,46,-19,19
AGF Aarhus,5185,11,4,7,11,18,38,-20,19
Brondby,5186,1,21,5,4,71,33,38,68
FC Midtjylla,5186,2,18,5,7,64,41,23,59
FC Nords,5186,3,15,7,8,75,53,22,52
Copenhagen,5186,4,15,4,11,59,44,15,49
AC Horsens,5186,5,9,12,9,39,49,-10,39
Sonderjyske,5186,6,8,6,10,28,29,-1,30
AaB,5186,7,6,11,13,35,49,-14,29
Lyngby,5186,8,4,9,11,29,44,-15,21
Randers FC,5186,9,5,6,13,23,42,-19,21
AGF Aarhus,5186,10,5,6,11,17,36,-19,21
Silkeborg IF,5186,11,5,3,14,25,45,-20,18
Brondby,5187,1,21,6,3,68,31,37,69
FC Midtjylla,5187,2,21,5,4,71,42,29,68
FC Nords,5187,3,14,8,8,73,51,22,50
Copenhagen,5187,4,13,4,13,56,48,8,43
AaB,5187,5,7,13,10,41,45,-4,34
Sonderjyske,5187,6,8,6,10,28,29,-1,30
AC Horsens,5187,7,5,14,11,33,51,-18,29
Randers FC,5187,8,6,6,12,24,39,-15,24
AGF Aarhus,5187,9,5,6,11,18,36,-18,21
Lyngby,5187,10,3,9,12,26,45,-19,18
Silkeborg IF,5187,11,5,3,14,25,46,-21,18
Brondby,5188,1,21,6,3,65,28,37,69
FC Midtjylla,5188,2,18,6,6,69,42,27,60
FC Nords,5188,3,14,8,8,73,49,24,50
Copenhagen,5188,4,14,5,11,59,46,13,47
AC Horsens,5188,5,8,12,10,37,55,-18,36
AaB,5188,6,7,11,12,35,44,-9,32
Sonderjyske,5188,7,8,6,10,28,29,-1,30
Randers FC,5188,8,5,7,12,25,41,-16,22
AGF Aarhus,5188,9,5,6,11,18,36,-18,21
Lyngby,5188,10,3,10,11,28,46,-18,19
Silkeborg IF,5188,11,5,3,14,25,46,-21,18
FC Midtjylla,5189,1,20,4,6,67,42,25,64
Brondby,5189,2,19,6,5,66,35,31,63
FC Nords,5189,3,14,9,7,71,48,23,51
Copenhagen,5189,4,15,5,10,58,45,13,50
AC Horsens,5189,5,7,13,10,39,51,-12,34
AaB,5189,6,7,11,12,38,44,-6,32
Sonderjyske,5189,7,8,6,10,28,29,-1,30
Lyngby,5189,8,4,9,11,27,44,-17,21
Silkeborg IF,5189,8,6,3,13,27,44,-17,21
Randers FC,5189,10,5,6,13,23,40,-17,21
AGF Aarhus,5189,11,4,6,12,16,38,-22,18
Brondby,5190,1,20,6,4,70,34,36,66
FC Midtjylla,5190,2,20,4,6,63,37,26,64
FC Nords,5190,3,16,6,8,80,51,29,54
Copenhagen,5190,4,13,7,10,57,46,11,46
AC Horsens,5190,5,7,13,10,36,53,-17,34
Sonderjyske,5190,6,8,6,10,28,29,-1,30
AaB,5190,7,6,12,12,31,42,-11,30
Randers FC,5190,8,6,6,12,25,40,-15,24
Silkeborg IF,5190,9,6,3,13,28,44,-16,21
Lyngby,5190,10,3,9,12,27,46,-19,18
AGF Aarhus,5190,11,4,6,12,16,39,-23,18
Brondby,5191,1,21,6,3,72,31,41,69
FC Midtjylla,5191,2,19,6,5,61,35,26,63
FC Nords,5191,3,15,6,9,75,49,26,51
Copenhagen,5191,4,14,5,11,53,41,12,47
AaB,5191,5,7,13,10,34,43,-9,34
Sonderjyske,5191,6,8,6,10,28,29,-1,30
AC Horsens,5191,7,5,14,11,33,55,-22,29
Randers FC,5191,8,6,6,12,24,39,-15,24
AGF Aarhus,5191,9,5,6,11,19,36,-17,21
Lyngby,5191,10,3,9,12,26,45,-19,18
Silkeborg IF,5191,11,5,3,14,25,47,-22,18
Brondby,5192,1,21,7,2,67,29,38,70
FC Midtjylla,5192,2,19,4,7,64,41,23,61
FC Nords,5192,3,14,7,9,70,49,21,49
Copenhagen,5192,4,13,5,12,55,45,10,44
AC Horsens,5192,5,8,13,9,34,45,-11,37
AaB,5192,6,6,14,10,33,40,-7,32
Sonderjyske,5192,7,8,6,10,28,29,-1,30
Lyngby,5192,8,4,9,11,27,44,-17,21
Randers FC,5192,9,5,6,13,23,40,-17,21
AGF Aarhus,5192,10,5,6,11,17,36,-19,21
Silkeborg IF,5192,11,5,3,14,25,45,-20,18
FC Midtjylla,5193,1,21,5,4,72,36,36,68
Brondby,5193,2,20,6,4,69,32,37,66
Copenhagen,5193,3,15,4,11,57,44,13,49
FC Nords,5193,4,14,6,10,73,52,21,48
AaB,5193,5,9,11,10,40,46,-6,38
Sonderjyske,5193,6,8,6,10,28,29,-1,30
AC Horsens,5193,7,5,12,13,32,59,-27,27
Lyngby,5193,8,4,9,11,27,44,-17,21
Randers FC,5193,9,5,6,13,23,40,-17,21
Silkeborg IF,5193,10,5,4,13,26,45,-19,19
AGF Aarhus,5193,11,4,7,11,17,37,-20,19
Brondby,5194,1,20,8,2,68,29,39,68
FC Midtjylla,5194,2,18,5,7,63,41,22,59
FC Nords,5194,3,15,8,7,78,52,26,53
Copenhagen,5194,4,13,6,11,60,47,13,45
AaB,5194,5,7,14,9,36,41,-5,35
AC Horsens,5194,6,6,13,11,37,58,-21,31
Sonderjyske,5194,7,8,6,10,28,29,-1,30
Randers FC,5194,8,5,7,12,23,39,-16,22
AGF Aarhus,5194,9,5,6,11,17,36,-19,21
Lyngby,5194,10,3,10,11,26,44,-18,19
Silkeborg IF,5194,11,5,3,14,25,45,-20,18
FC Midtjylla,5195,1,20,5,5,70,39,31,65
Brondby,5195,2,19,6,5,66,34,32,63
FC Nords,5195,3,16,6,8,77,50,27,54
Copenhagen,5195,4,14,4,12,58,48,10,46
AaB,5195,5,8,12,10,42,44,-2,36
AC Horsens,5195,6,6,13,11,32,56,-24,31
Sonderjyske,5195,7,8,6,10,28,29,-1,30
Randers FC,5195,8,6,6,12,27,39,-12,24
Silkeborg IF,5195,9,5,4,13,25,44,-19,19
AGF Aarhus,5195,10,4,7,11,16,36,-20,19
Lyngby,5195,11,3,9,12,26,48,-22,18
Brondby,5196,1,20,7,3,72,37,35,67
FC Midtjylla,5196,2,19,6,5,66,38,28,63
Copenhagen,5196,3,14,5,11,56,41,15,47
FC Nords,5196,4,13,6,11,69,54,15,45
AaB,5196,5,8,12,10,34,38,-4,36
AC Horsens,5196,6,8,12,10,34,49,-15,36
Sonderjyske,5196,7,8,6,10,28,29,-1,30
Randers FC,5196,8,6,6,12,24,39,-15,24
AGF Aarhus,5196,9,5,6,11,18,37,-19,21
Lyngby,5196,10,3,9,12,26,45,-19,18
Silkeborg IF,5196,11,5,3,14,26,46,-20,18
Brondby,5197,1,21,5,4,68,32,36,68
FC Midtjylla,5197,2,17,8,5,60,37,23,59
FC Nords,5197,3,15,7,8,74,46,28,52
Copenhagen,5197,4,14,5,11,54,42,12,47
AaB,5197,5,9,12,9,37,41,-4,39
Sonderjyske,5197,6,8,6,10,28,29,-1,30
AC Horsens,5197,7,5,13,12,33,54,-21,28
Lyngby,5197,8,4,9,11,31,45,-14,21
AGF Aarhus,5197,9,5,6,11,18,37,-19,21
Randers FC,5197,10,5,6,13,24,44,-20,21
Silkeborg IF,5197,11,5,3,14,26,46,-20,18
Brondby,5198,1,19,7,4,69,35,34,64
FC Midtjylla,5198,2,18,8,4,64,37,27,62
FC Nords,5198,3,14,7,9,74,54,20,49
Copenhagen,5198,4,13,6,11,55,43,12,45
AC Horsens,5198,5,8,13,9,40,53,-13,37
AaB,5198,6,7,13,10,37,43,-6,34
Sonderjyske,5198,7,8,6,10,28,29,-1,30
Randers FC,5198,8,5,7,12,24,40,-16,22
Silkeborg IF,5198,9,6,3,13,26,44,-18,21
Lyngby,5198,10,3,10,11,27,45,-18,19
AGF Aarhus,5198,11,4,6,12,16,37,-21,18
Brondby,5199,1,21,7,2,76,33,43,70
FC Midtjylla,5199,2,18,7,5,65,40,25,61
FC Nords,5199,3,16,7,7,77,49,28,55
Copenhagen,5199,4,14,5,11,55,43,12,47
Sonderjyske,5199,5,8,6,10,28,29,-1,30
AaB,5199,6,6,12,12,35,45,-10,30
AC Horsens,5199,7,6,12,12,33,57,-24,30
Lyngby,5199,8,4,9,11,29,44,-15,21
Randers FC,5199,9,5,6,13,23,42,-19,21
Silkeborg IF,5199,10,5,4,13,26,45,-19,19
AGF Aarhus,5199,11,4,7,11,17,37,-20,19
Brondby,5200,1,22,5,3,77,30,47,71
FC Midtjylla,5200,2,20,4,6,63,40,23,64
FC Nords,5200,3,15,6,9,72,52,20,51
Copenhagen,5200,4,15,4,11,57,43,14,49
AC Horsens,5200,5,6,13,11,32,49,-17,31
Sonderjyske,5200,6,8,6,10,28,29,-1,30
AaB,5200,7,6,12,12,35,48,-13,30
Randers FC,5200,8,5,7,12,24,40,-16,22
Silkeborg IF,5200,9,6,3,13,30,45,-15,21
Lyngby,5200,10,3,10,11,27,45,-18,19
AGF Aarhus,5200,11,4,6,12,17,41,-24,18
Brondby,5201,1,21,6,3,76,34,42,69
FC Midtjylla,5201,2,20,6,4,69,38,31,66
FC Nords,5201,3,14,6,10,73,57,16,48
Copenhagen,5201,4,12,6,12,58,50,8,42
AaB,5201,5,7,13,10,40,48,-8,34
AC Horsens,5201,6,7,13,10,40,55,-15,34
Sonderjyske,5201,7,8,6,10,28,29,-1,30
Lyngby,5201,8,4,9,11,27,44,-17,21
Randers FC,5201,9,5,6,13,23,40,-17,21
Silkeborg IF,5201,10,6,3,13,26,44,-18,21
AGF Aarhus,5201,11,4,6,12,16,37,-21,18
Brondby,5202,1,20,6,4,69,31,38,66
FC Midtjylla,5202,2,17,8,5,59,38,21,59
FC Nords,5202,3,13,8,9,70,52,18,47
Copenhagen,5202,4,14,5,11,58,44,14,47
AaB,5202,5,8,13,9,36,40,-4,37
AC Horsens,5202,6,7,14,9,36,49,-13,35
Sonderjyske,5202,7,8,6,10,28,29,-1,30
Randers FC,5202,8,5,7,12,23,39,-16,22
Lyngby,5202,9,3,10,11,26,44,-18,19
Silkeborg IF,5202,10,5,4,13,26,45,-19,19
AGF Aarhus,5202,11,4,7,11,17,37,-20,19
FC Midtjylla,5203,1,22,4,4,70,37,33,70
Brondby,5203,2,21,5,4,70,33,37,68
FC Nords,5203,3,13,6,11,71,58,13,45
Copenhagen,5203,4,13,5,12,55,48,7,44
AC Horsens,5203,5,8,12,10,37,51,-14,36
AaB,5203,6,7,12,11,39,41,-2,33
Sonderjyske,5203,7,8,6,10,28,29,-1,30
Randers FC,5203,8,5,7,12,24,40,-16,22
AGF Aarhus,5203,9,5,6,11,18,36,-18,21
Lyngby,5203,10,3,10,11,27,45,-18,19
Silkeborg IF,5203,11,5,3,14,25,46,-21,18
Brondby,5204,1,21,6,3,70,31,39,69
FC Midtjylla,5204,2,18,4,8,63,43,20,58
FC Nords,5204,3,14,7,9,74,56,18,49
Copenhagen,5204,4,14,6,10,61,46,15,48
AC Horsens,5204,5,8,13,9,38,49,-11,37
AaB,5204,6,7,12,11,34,41,-7,33
Sonderjyske,5204,7,8,6,10,28,29,-1,30
Randers FC,5204,8,6,6,12,24,39,-15,24
Silkeborg IF,5204,9,5,4,13,25,44,-19,19
AGF Aarhus,5204,10,4,7,11,16,36,-20,19
Lyngby,5204,11,3,9,12,26,45,-19,18
Brondby,5205,1,21,6,3,77,33,44,69
FC Midtjylla,5205,2,18,6,6,63,39,24,60
FC Nords,5205,3,14,7,9,72,49,23,49
Copenhagen,5205,4,12,6,12,56,51,5,42
AC Horsens,5205,5,9,12,9,38,50,-12,39
AaB,5205,6,7,13,10,33,43,-10,34
Sonderjyske,5205,7,8,6,10,28,29,-1,30
Lyngby,5205,8,4,9,11,30,46,-16,21
Randers FC,5205,9,5,6,13,25,43,-18,21
Silkeborg IF,5205,10,5,4,13,27,46,-19,19
AGF Aarhus,5205,11,4,7,11,18,38,-20,19
Brondby,5206,1,21,6,3,74,32,42,69
FC Midtjylla,5206,2,18,6,6,63,46,17,60
FC Nords,5206,3,14,6,10,70,48,22,48
Copenhagen,5206,4,13,4,13,56,49,7,43
AaB,5206,5,8,13,9,41,44,-3,37
AC Horsens,5206,6,7,15,8,35,46,-11,36
Sonderjyske,5206,7,8,6,10,28,29,-1,30
Randers FC,5206,8,6,6,12,26,39,-13,24
Silkeborg IF,5206,9,5,4,13,26,45,-19,19
AGF Aarhus,5206,10,4,7,11,17,37,-20,19
Lyngby,5206,11,3,9,12,26,47,-21,18
Brondby,5207,1,22,5,3,72,32,40,71
FC Midtjylla,5207,2,18,6,6,62,41,21,60
FC Nords,5207,3,16,7,7,77,49,28,55
Copenhagen,5207,4,13,5,12,55,44,11,44
AaB,5207,5,7,13,10,40,45,-5,34
Sonderjyske,5207,6,8,6,10,28,29,-1,30
AC Horsens,5207,7,6,12,12,34,55,-21,30
Silkeborg IF,5207,8,6,3,13,31,44,-13,21
Lyngby,5207,9,4,9,11,28,44,-16,21
Randers FC,5207,10,5,6,13,23,41,-18,21
AGF Aarhus,5207,11,4,6,12,16,42,-26,18
FC Midtjylla,5208,1,21,5,4,66,35,31,68
Brondby,5208,2,19,5,6,67,35,32,62
FC Nords,5208,3,14,7,9,71,52,19,49
Copenhagen,5208,4,15,4,11,56,42,14,49
AaB,5208,5,9,11,10,38,40,-2,38
Sonderjyske,5208,6,8,6,10,28,29,-1,30
AC Horsens,5208,7,5,14,11,32,52,-20,29
Lyngby,5208,8,4,9,11,28,45,-17,21
Randers FC,5208,9,5,6,13,24,41,-17,21
Silkeborg IF,5208,10,6,3,13,27,45,-18,21
AGF Aarhus,5208,11,4,6,12,17,38,-21,18
Brondby,5209,1,19,8,3,67,33,34,65
FC Midtjylla,5209,2,20,5,5,68,40,28,65
Copenhagen,5209,3,15,5,10,60,44,16,50
FC Nords,5209,4,13,8,9,69,49,20,47
AC Horsens,5209,5,7,13,10,35,50,-15,34
AaB,5209,6,7,11,12,34,43,-9,32
Sonderjyske,5209,7,8,6,10,28,29,-1,30
Randers FC,5209,8,5,7,12,24,40,-16,22
Silkeborg IF,5209,9,6,3,13,28,46,-18,21
Lyngby,5209,10,3,10,11,27,45,-18,19
AGF Aarhus,5209,11,4,6,12,18,39,-21,18
Brondby,5210,1,21,6,3,70,30,40,69
FC Midtjylla,5210,2,19,6,5,65,38,27,63
FC Nords,5210,3,14,6,10,73,53,20,48
Copenhagen,5210,4,14,6,10,58,44,14,48
AaB,5210,5,7,13,10,36,43,-7,34
Sonderjyske,5210,6,8,6,10,28,29,-1,30
AC Horsens,5210,7,5,15,10,36,56,-20,30
Lyngby,5210,8,4,9,11,28,44,-16,21
Randers FC,5210,9,5,6,13,23,41,-18,21
Silkeborg IF,5210,10,5,4,13,26,45,-19,19
AGF Aarhus,5210,11,4,7,11,17,37,-20,19
Brondby,5211,1,20,6,4,73,32,41,66
FC Midtjylla,5211,2,19,5,6,65,39,26,62
FC Nords,5211,3,15,7,8,74,50,24,52
Copenhagen,5211,4,15,5,10,62,45,17,50
AC Horsens,5211,5,7,13,10,35,55,-20,34
Sonderjyske,5211,6,8,6,10,28,29,-1,30
AaB,5211,7,6,12,12,35,49,-14,30
Lyngby,5211,8,4,9,11,28,44,-16,21
Silkeborg IF,5211,9,6,3,13,26,44,-18,21
Randers FC,5211,10,5,6,13,23,41,-18,21
AGF Aarhus,5211,11,4,6,12,16,37,-21,18
FC Midtjylla,5212,1,20,5,5,65,38,27,65
Brondby,5212,2,19,6,5,65,33,32,63
FC Nords,5212,3,15,8,7,77,49,28,53
Copenhagen,5212,4,16,4,10,61,43,18,52
AC Horsens,5212,5,6,14,10,32,49,-17,32
Sonderjyske,5212,6,8,6,10,28,29,-1,30
AaB,5212,7,6,11,13,35,49,-14,29
Randers FC,5212,8,6,6,12,24,39,-15,24
Silkeborg IF,5212,9,5,4,13,26,45,-19,19
AGF Aarhus,5212,10,4,7,11,17,37,-20,19
Lyngby,5212,11,3,9,12,26,45,-19,18
Brondby,5213,1,21,7,2,73,33,40,70
FC Midtjylla,5213,2,19,6,5,69,46,23,63
FC Nords,5213,3,13,7,10,72,55,17,46
Copenhagen,5213,4,13,5,12,61,47,14,44
AaB,5213,5,7,14,9,36,40,-4,35
AC Horsens,5213,6,7,13,10,35,51,-16,34
Sonderjyske,5213,7,8,6,10,28,29,-1,30
Lyngby,5213,8,4,9,11,30,45,-15,21
Silkeborg IF,5213,9,6,3,13,29,44,-15,21
Randers FC,5213,10,5,6,13,24,43,-19,21
AGF Aarhus,5213,11,4,6,12,16,40,-24,18
Brondby,5214,1,21,7,2,72,30,42,70
FC Midtjylla,5214,2,19,5,6,63,40,23,62
FC Nords,5214,3,14,7,9,78,51,27,49
Copenhagen,5214,4,14,5,11,62,50,12,47
AaB,5214,5,8,11,11,38,43,-5,35
AC Horsens,5214,6,6,13,11,33,58,-25,31
Sonderjyske,5214,7,8,6,10,28,29,-1,30
Lyngby,5214,8,4,9,11,27,44,-17,21
Randers FC,5214,9,5,6,13,23,40,-17,21
AGF Aarhus,5214,10,5,6,11,17,36,-19,21
Silkeborg IF,5214,11,5,3,14,25,45,-20,18
FC Midtjylla,5215,1,21,4,5,70,44,26,67
Brondby,5215,2,20,6,4,72,33,39,66
FC Nords,5215,3,15,7,8,76,52,24,52
Copenhagen,5215,4,12,5,13,58,50,8,41
AaB,5215,5,7,13,10,38,46,-8,34
AC Horsens,5215,6,7,13,10,37,52,-15,34
Sonderjyske,5215,7,8,6,10,28,29,-1,30
Randers FC,5215,8,6,6,12,25,39,-14,24
AGF Aarhus,5215,9,5,6,11,17,36,-19,21
Lyngby,5215,10,3,9,12,26,46,-20,18
Silkeborg IF,5215,11,5,3,14,25,45,-20,18
FC Midtjylla,5216,1,21,5,4,69,36,33,68
Brondby,5216,2,20,6,4,69,33,36,66
FC Nords,5216,3,14,6,10,74,56,18,48
Copenhagen,5216,4,14,5,11,54,41,13,47
AC Horsens,5216,5,7,14,9,35,52,-17,35
Sonderjyske,5216,6,8,6,10,28,29,-1,30
AaB,5216,7,6,12,12,39,48,-9,30
Lyngby,5216,8,4,9,11,29,45,-16,21
AGF Aarhus,5216,9,5,6,11,19,36,-17,21
Randers FC,5216,10,5,6,13,24,42,-18,21
Silkeborg IF,5216,11,5,3,14,25,47,-22,18
Brondby,5217,1,23,5,2,72,30,42,74
FC Midtjylla,5217,2,20,5,5,63,37,26,65
FC Nords,5217,3,13,7,10,71,52,19,46
Copenhagen,5217,4,13,5,12,54,45,9,44
AC Horsens,5217,5,7,13,10,40,54,-14,34
AaB,5217,6,7,11,12,39,47,-8,32
Sonderjyske,5217,7,8,6,10,28,29,-1,30
Randers FC,5217,8,5,7,12,23,39,-16,22
Silkeborg IF,5217,9,6,3,13,27,45,-18,21
Lyngby,5217,10,3,10,11,26,44,-18,19
AGF Aarhus,5217,11,4,6,12,17,38,-21,18
Brondby,5218,1,23,5,2,80,28,52,74
FC Midtjylla,5218,2,20,5,5,70,43,27,65
FC Nords,5218,3,15,6,9,76,55,21,51
Copenhagen,5218,4,13,5,12,57,48,9,44
AaB,5218,5,7,12,11,38,44,-6,33
Sonderjyske,5218,6,8,6,10,28,29,-1,30
AC Horsens,5218,7,5,13,12,34,63,-29,28
Lyngby,5218,8,4,9,11,28,44,-16,21
Randers FC,5218,9,5,6,13,23,41,-18,21
AGF Aarhus,5218,10,5,6,11,18,37,-19,21
Silkeborg IF,5218,11,5,3,14,26,46,-20,18
Brondby,5219,1,20,7,3,70,34,36,67
FC Midtjylla,5219,2,18,6,6,63,40,23,60
FC Nords,5219,3,13,8,9,71,50,21,47
Copenhagen,5219,4,12,7,11,54,44,10,43
AaB,5219,5,8,13,9,39,42,-3,37
AC Horsens,5219,6,7,15,8,37,50,-13,36
Sonderjyske,5219,7,8,6,10,28,29,-1,30
Randers FC,5219,8,5,7,12,25,41,-16,22
Lyngby,5219,9,3,10,11,28,46,-18,19
Silkeborg IF,5219,10,5,4,13,25,44,-19,19
AGF Aarhus,5219,11,4,7,11,16,36,-20,19
Brondby,5220,1,22,5,3,69,29,40,71
FC Midtjylla,5220,2,20,5,5,66,37,29,65
Copenhagen,5220,3,15,5,10,60,46,14,50
FC Nords,5220,4,13,7,10,72,53,19,46
AC Horsens,5220,5,7,13,10,34,52,-18,34
Sonderjyske,5220,6,8,6,10,28,29,-1,30
AaB,5220,7,6,11,13,38,48,-10,29
Randers FC,5220,8,5,7,12,24,40,-16,22
Silkeborg IF,5220,9,6,3,13,28,45,-17,21
Lyngby,5220,10,3,10,11,27,45,-18,19
AGF Aarhus,5220,11,4,6,12,17,39,-22,18
Brondby,5221,1,20,6,4,68,36,32,66
FC Midtjylla,5221,2,19,6,5,64,36,28,63
FC Nords,5221,3,13,7,10,73,52,21,46
Copenhagen,5221,4,13,7,10,53,41,12,46
AaB,5221,5,8,12,10,37,43,-6,36
AC Horsens,5221,6,8,12,10,36,49,-13,36
Sonderjyske,5221,7,8,6,10,28,29,-1,30
Randers FC,5221,8,5,7,12,23,39,-16,22
Lyngby,5221,9,3,10,11,26,44,-18,19
Silkeborg IF,5221,10,5,4,13,26,45,-19,19
AGF Aarhus,5221,11,4,7,11,17,37,-20,19
FC Midtjylla,5222,1,21,5,4,72,42,30,68
Brondby,5222,2,20,5,5,68,33,35,65
FC Nords,5222,3,16,6,8,80,52,28,54
Copenhagen,5222,4,12,7,11,58,50,8,43
AaB,5222,5,7,12,11,40,47,-7,33
AC Horsens,5222,6,6,13,11,34,54,-20,31
Sonderjyske,5222,7,8,6,10,28,29,-1,30
Lyngby,5222,8,4,9,11,29,44,-15,21
Silkeborg IF,5222,9,6,3,13,28,45,-17,21
Randers FC,5222,10,5,6,13,23,42,-19,21
AGF Aarhus,5222,11,4,6,12,17,39,-22,18
Brondby,5223,1,21,6,3,75,34,41,69
FC Midtjylla,5223,2,21,4,5,71,40,31,67
Copenhagen,5223,3,14,7,9,62,45,17,49
FC Nords,5223,4,12,8,10,73,58,15,44
AC Horsens,5223,5,6,14,10,37,56,-19,32
AaB,5223,6,6,13,11,36,47,-11,31
Sonderjyske,5223,7,8,6,10,28,29,-1,30
Lyngby,5223,8,4,9,11,28,45,-17,21
Silkeborg IF,5223,8,6,3,13,28,45,-17,21
Randers FC,5223,10,5,6,13,24,41,-17,21
AGF Aarhus,5223,11,4,6,12,17,39,-22,18
Brondby,5224,1,20,7,3,67,29,38,67
FC Midtjylla,5224,2,19,4,7,63,46,17,61
Copenhagen,5224,3,16,4,10,62,43,19,52
FC Nords,5224,4,14,7,9,68,46,22,49
AaB,5224,5,7,12,11,38,43,-5,33
AC Horsens,5224,6,7,12,11,31,48,-17,33
Sonderjyske,5224,7,8,6,10,28,29,-1,30
Randers FC,5224,8,6,6,12,27,40,-13,24
Silkeborg IF,5224,9,6,3,13,28,44,-16,21
Lyngby,5224,10,3,9,12,27,48,-21,18
AGF Aarhus,5224,11,4,6,12,16,39,-23,18
Brondby,5225,1,21,5,4,71,34,37,68
FC Midtjylla,5225,2,20,5,5,66,39,27,65
Copenhagen,5225,3,15,6,9,62,42,20,51
FC Nords,5225,4,12,7,11,67,54,13,43
AaB,5225,5,7,13,10,33,39,-6,34
AC Horsens,5225,6,6,14,10,32,49,-17,32
Sonderjyske,5225,7,8,6,10,28,29,-1,30
Lyngby,5225,8,4,9,11,29,44,-15,21
Silkeborg IF,5225,9,6,3,13,27,44,-17,21
Randers FC,5225,10,5,6,13,23,42,-19,21
AGF Aarhus,5225,11,4,6,12,16,38,-22,18
Brondby,5226,1,21,6,3,70,32,38,69
FC Midtjylla,5226,2,20,4,6,64,36,28,64
Copenhagen,5226,3,15,5,10,58,41,17,50
FC Nords,5226,4,14,7,9,74,54,20,49
AC Horsens,5226,5,7,12,11,34,53,-19,33
Sonderjyske,5226,6,8,6,10,28,29,-1,30
AaB,5226,7,6,12,12,33,43,-10,30
Randers FC,5226,8,6,6,12,25,40,-15,24
Silkeborg IF,5226,9,5,4,13,26,45,-19,19
AGF Aarhus,5226,10,4,7,11,17,37,-20,19
Lyngby,5226,11,3,9,12,27,46,-19,18
Brondby,5227,1,21,7,2,76,35,41,70
FC Midtjylla,5227,2,20,4,6,68,43,25,64
FC Nords,5227,3,14,8,8,77,52,25,50
Copenhagen,5227,4,14,5,11,58,44,14,47
AC Horsens,5227,5,6,14,10,35,54,-19,32
Sonderjyske,5227,6,8,6,10,28,29,-1,30
AaB,5227,7,6,12,12,35,47,-12,30
Randers FC,5227,8,6,6,12,24,39,-15,24
AGF Aarhus,5227,9,5,6,11,17,36,-19,21
Lyngby,5227,10,3,9,12,26,45,-19,18
Silkeborg IF,5227,11,5,3,14,25,45,-20,18
Brondby,5228,1,21,7,2,75,33,42,70
FC Midtjylla,5228,2,19,6,5,65,41,24,63
FC Nords,5228,3,15,7,8,80,51,29,52
Copenhagen,5228,4,14,4,12,56,43,13,46
AaB,5228,5,7,11,12,39,52,-13,32
AC Horsens,5228,6,6,13,11,35,56,-21,31
Sonderjyske,5228,7,8,6,10,28,29,-1,30
Randers FC,5228,8,5,7,12,24,40,-16,22
Lyngby,5228,9,3,10,11,27,45,-18,19
Silkeborg IF,5228,10,5,4,13,28,47,-19,19
AGF Aarhus,5228,11,4,7,11,19,39,-20,19
Brondby,5229,1,21,7,2,73,34,39,70
FC Midtjylla,5229,2,19,6,5,61,36,25,63
FC Nords,5229,3,15,6,9,72,49,23,51
Copenhagen,5229,4,13,6,11,59,46,13,45
AC Horsens,5229,5,6,15,9,35,51,-16,33
Sonderjyske,5229,6,8,6,10,28,29,-1,30
AaB,5229,7,6,12,12,36,46,-10,30
Lyngby,5229,8,4,9,11,28,45,-17,21
Randers FC,5229,9,5,6,13,24,41,-17,21
Silkeborg IF,5229,10,6,3,13,27,45,-18,21
AGF Aarhus,5229,11,4,6,12,17,38,-21,18
Brondby,5230,1,20,7,3,70,32,38,67
FC Midtjylla,5230,2,19,6,5,64,37,27,63
FC Nords,5230,3,13,8,9,74,55,19,47
Copenhagen,5230,4,13,7,10,60,47,13,46
AaB,5230,5,7,13,10,39,45,-6,34
AC Horsens,5230,6,7,13,10,33,50,-17,34
Sonderjyske,5230,7,8,6,10,28,29,-1,30
Randers FC,5230,8,5,7,12,23,39,-16,22
Silkeborg IF,5230,9,6,3,13,26,44,-18,21
Lyngby,5230,10,3,10,11,26,44,-18,19
AGF Aarhus,5230,11,4,6,12,16,37,-21,18
Brondby,5231,1,20,5,5,77,40,37,65
FC Midtjylla,5231,2,20,4,6,72,41,31,64
FC Nords,5231,3,14,7,9,76,53,23,49
Copenhagen,5231,4,14,5,11,59,47,12,47
AaB,5231,5,9,11,10,39,43,-4,38
AC Horsens,5231,6,7,12,11,36,61,-25,33
Sonderjyske,5231,7,8,6,10,28,29,-1,30
Randers FC,5231,8,6,6,12,24,39,-15,24
Silkeborg IF,5231,9,6,3,13,27,44,-17,21
Lyngby,5231,10,3,9,12,26,45,-19,18
AGF Aarhus,5231,11,4,6,12,16,38,-22,18
Brondby,5232,1,21,6,3,73,33,40,69
FC Midtjylla,5232,2,19,4,7,71,47,24,61
FC Nords,5232,3,15,6,9,75,52,23,51
Copenhagen,5232,4,15,5,10,63,46,17,50
AaB,5232,5,7,12,11,35,44,-9,33
AC Horsens,5232,6,6,13,11,33,54,-21,31
Sonderjyske,5232,7,8,6,10,28,29,-1,30
Randers FC,5232,8,6,6,12,25,40,-15,24
Silkeborg IF,5232,9,6,3,13,27,44,-17,21
Lyngby,5232,10,3,9,12,27,46,-19,18
AGF Aarhus,5232,11,4,6,12,16,38,-22,18
Brondby,5233,1,21,7,2,75,32,43,70
FC Midtjylla,5233,2,19,5,6,65,44,21,62
FC Nords,5233,3,16,6,8,79,50,29,54
Copenhagen,5233,4,13,6,11,57,48,9,45
AaB,5233,5,7,13,10,41,48,-7,34
Sonderjyske,5233,6,8,6,10,28,29,-1,30
AC Horsens,5233,7,5,13,12,39,60,-21,28
Lyngby,5233,8,4,9,11,30,44,-14,21
Silkeborg IF,5233,9,6,3,13,28,45,-17,21
Randers FC,5233,10,5,6,13,23,43,-20,21
AGF Aarhus,5233,11,4,6,12,17,39,-22,18
Brondby,5234,1,22,6,2,75,29,46,72
FC Midtjylla,5234,2,20,5,5,64,38,26,65
FC Nords,5234,3,15,6,9,76,48,28,51
Copenhagen,5234,4,14,5,11,57,45,12,47
AC Horsens,5234,5,6,13,11,32,55,-23,31
Sonderjyske,5234,6,8,6,10,28,29,-1,30
AaB,5234,7,6,11,13,34,49,-15,29
Lyngby,5234,8,4,9,11,30,45,-15,21
Randers FC,5234,9,5,6,13,24,43,-19,21
Silkeborg IF,5234,10,5,4,13,26,45,-19,19
AGF Aarhus,5234,11,4,7,11,17,37,-20,19
Brondby,5235,1,20,6,4,68,33,35,66
FC Midtjylla,5235,2,18,5,7,58,41,17,59
FC Nords,5235,3,17,6,7,81,47,34,57
Copenhagen,5235,4,14,5,11,56,45,11,47
AaB,5235,5,7,13,10,37,43,-6,34
Sonderjyske,5235,6,8,6,10,28,29,-1,30
AC Horsens,5235,7,5,15,10,34,51,-17,30
Randers FC,5235,8,5,7,12,24,40,-16,22
Silkeborg IF,5235,9,6,3,13,28,46,-18,21
Lyngby,5235,10,3,10,11,27,45,-18,19
AGF Aarhus,5235,11,4,6,12,18,39,-21,18
Brondby,5236,1,20,5,5,67,30,37,65
FC Midtjylla,5236,2,19,5,6,62,38,24,62
Copenhagen,5236,3,15,5,10,59,42,17,50
FC Nords,5236,4,14,7,9,71,55,16,49
AaB,5236,5,8,13,9,40,41,-1,37
AC Horsens,5236,6,6,13,11,33,52,-19,31
Sonderjyske,5236,7,8,6,10,28,29,-1,30
Lyngby,5236,8,4,9,11,27,44,-17,21
Randers FC,5236,9,5,6,13,23,40,-17,21
AGF Aarhus,5236,10,5,6,11,17,36,-19,21
Silkeborg IF,5236,11,5,3,14,25,45,-20,18
Brondby,5237,1,21,7,2,77,32,45,70
FC Midtjylla,5237,2,20,5,5,66,39,27,65
FC Nords,5237,3,14,8,8,75,50,25,50
Copenhagen,5237,4,14,5,11,57,44,13,47
AC Horsens,5237,5,6,13,11,35,57,-22,31
Sonderjyske,5237,6,8,6,10,28,29,-1,30
AaB,5237,7,6,12,12,37,51,-14,30
Randers FC,5237,8,6,6,12,25,40,-15,24
AGF Aarhus,5237,9,5,6,11,19,38,-19,21
Lyngby,5237,10,3,9,12,27,46,-19,18
Silkeborg IF,5237,11,5,3,14,27,47,-20,18
Brondby,5238,1,22,5,3,71,33,38,71
FC Midtjylla,5238,2,20,4,6,70,39,31,64
Copenhagen,5238,3,14,5,11,58,45,13,47
FC Nords,5238,4,13,6,11,75,58,17,45
AC Horsens,5238,5,8,12,10,39,57,-18,36
AaB,5238,6,7,12,11,34,41,-7,33
Sonderjyske,5238,7,8,6,10,28,29,-1,30
Lyngby,5238,8,4,9,11,29,44,-15,21
Silkeborg IF,5238,9,6,3,13,27,45,-18,21
Randers FC,5238,10,5,6,13,23,42,-19,21
AGF Aarhus,5238,11,4,6,12,17,38,-21,18
Brondby,5239,1,20,8,2,75,35,40,68
FC Midtjylla,5239,2,20,5,5,69,39,30,65
FC Nords,5239,3,13,9,8,73,52,21,48
Copenhagen,5239,4,14,6,10,58,45,13,48
AaB,5239,5,7,11,12,40,51,-11,32
AC Horsens,5239,6,6,13,11,37,56,-19,31
Sonderjyske,5239,7,8,6,10,28,29,-1,30
Randers FC,5239,8,5,7,12,23,39,-16,22
Lyngby,5239,9,3,10,11,26,44,-18,19
Silkeborg IF,5239,10,5,4,13,26,45,-19,19
AGF Aarhus,5239,11,4,7,11,17,37,-20,19
Brondby,5240,1,22,6,2,72,29,43,72
FC Midtjylla,5240,2,20,6,4,69,39,30,66
FC Nords,5240,3,14,8,8,74,50,24,50
Copenhagen,5240,4,13,4,13,52,49,3,43
AaB,5240,5,7,11,12,37,45,-8,32
AC Horsens,5240,6,6,13,11,37,55,-18,31
Sonderjyske,5240,7,8,6,10,28,29,-1,30
Randers FC,5240,8,5,7,12,24,40,-16,22
Silkeborg IF,5240,9,6,3,13,27,45,-18,21
Lyngby,5240,10,3,10,11,27,45,-18,19
AGF Aarhus,5240,11,4,6,12,17,38,-21,18
Brondby,5241,1,20,7,3,72,33,39,67
FC Midtjylla,5241,2,19,6,5,71,41,30,63
FC Nords,5241,3,14,8,8,77,53,24,50
Copenhagen,5241,4,14,6,10,57,47,10,48
AC Horsens,5241,5,6,14,10,34,54,-20,32
AaB,5241,6,6,13,11,34,43,-9,31
Sonderjyske,5241,7,8,6,10,28,29,-1,30
Randers FC,5241,8,5,7,12,23,39,-16,22
Silkeborg IF,5241,9,6,3,13,28,46,-18,21
Lyngby,5241,10,3,10,11,26,44,-18,19
AGF Aarhus,5241,11,4,6,12,18,39,-21,18
Brondby,5242,1,21,5,4,70,31,39,68
FC Midtjylla,5242,2,19,5,6,66,40,26,62
FC Nords,5242,3,16,7,7,78,49,29,55
Copenhagen,5242,4,14,4,12,59,53,6,46
AaB,5242,5,8,11,11,38,44,-6,35
Sonderjyske,5242,6,8,6,10,28,29,-1,30
AC Horsens,5242,7,6,12,12,34,54,-20,30
Randers FC,5242,8,5,7,12,25,41,-16,22
Silkeborg IF,5242,9,6,3,13,27,45,-18,21
Lyngby,5242,10,3,10,11,28,46,-18,19
AGF Aarhus,5242,11,4,6,12,17,38,-21,18
FC Midtjylla,5243,1,22,4,4,69,39,30,70
Brondby,5243,2,21,5,4,68,30,38,68
FC Nords,5243,3,13,6,11,74,56,18,45
Copenhagen,5243,4,13,4,13,55,48,7,43
AC Horsens,5243,5,8,13,9,37,49,-12,37
AaB,5243,6,7,12,11,35,42,-7,33
Sonderjyske,5243,7,8,6,10,28,29,-1,30
Randers FC,5243,8,6,6,12,26,39,-13,24
Silkeborg IF,5243,9,6,3,13,29,44,-15,21
Lyngby,5243,10,3,9,12,26,47,-21,18
AGF Aarhus,5243,11,4,6,12,16,40,-24,18
Brondby,5244,1,20,6,4,70,33,37,66
FC Midtjylla,5244,2,19,5,6,67,43,24,62
Copenhagen,5244,3,15,5,10,57,41,16,50
FC Nords,5244,4,13,8,9,69,51,18,47
AaB,5244,5,7,14,9,39,43,-4,35
AC Horsens,5244,6,6,14,10,36,53,-17,32
Sonderjyske,5244,7,8,6,10,28,29,-1,30
Randers FC,5244,8,6,6,12,27,39,-12,24
Silkeborg IF,5244,9,6,3,13,27,45,-18,21
AGF Aarhus,5244,10,4,6,12,17,38,-21,18
Lyngby,5244,11,3,9,12,26,48,-22,18
Brondby,5245,1,20,8,2,73,33,40,68
FC Midtjylla,5245,2,19,7,4,64,37,27,64
FC Nords,5245,3,14,8,8,71,50,21,50
Copenhagen,5245,4,13,5,12,57,49,8,44
AaB,5245,5,8,12,10,43,42,1,36
Sonderjyske,5245,6,8,6,10,28,29,-1,30
AC Horsens,5245,7,5,14,11,30,53,-23,29
Lyngby,5245,8,4,9,11,28,45,-17,21
Silkeborg IF,5245,9,6,3,13,27,44,-17,21
Randers FC,5245,10,5,6,13,24,41,-17,21
AGF Aarhus,5245,11,4,6,12,16,38,-22,18
Brondby,5246,1,21,5,4,71,31,40,68
FC Midtjylla,5246,2,20,4,6,64,39,25,64
FC Nords,5246,3,14,7,9,71,51,20,49
Copenhagen,5246,4,13,5,12,54,44,10,44
AC Horsens,5246,5,8,12,10,37,51,-14,36
AaB,5246,6,8,11,11,36,43,-7,35
Sonderjyske,5246,7,8,6,10,28,29,-1,30
Randers FC,5246,8,5,7,12,24,40,-16,22
AGF Aarhus,5246,9,5,6,11,18,36,-18,21
Lyngby,5246,10,3,10,11,27,45,-18,19
Silkeborg IF,5246,11,5,3,14,25,46,-21,18
Brondby,5247,1,22,5,3,76,30,46,71
FC Midtjylla,5247,2,20,4,6,70,41,29,64
Copenhagen,5247,3,14,6,10,61,47,14,48
FC Nords,5247,4,13,8,9,71,57,14,47
AC Horsens,5247,5,7,12,11,38,53,-15,33
AaB,5247,6,6,13,11,35,49,-14,31
Sonderjyske,5247,7,8,6,10,28,29,-1,30
Randers FC,5247,8,6,6,12,28,39,-11,24
Silkeborg IF,5247,9,6,3,13,28,44,-16,21
Lyngby,5247,10,3,9,12,26,49,-23,18
AGF Aarhus,5247,11,4,6,12,16,39,-23,18
Brondby,5248,1,20,7,3,71,31,40,67
FC Midtjylla,5248,2,19,5,6,60,37,23,62
FC Nords,5248,3,16,7,7,74,46,28,55
Copenhagen,5248,4,14,5,11,55,41,14,47
AaB,5248,5,8,11,11,33,41,-8,35
Sonderjyske,5248,6,8,6,10,28,29,-1,30
AC Horsens,5248,7,5,13,12,31,54,-23,28
Randers FC,5248,8,5,7,12,24,40,-16,22
AGF Aarhus,5248,9,5,6,11,18,37,-19,21
Lyngby,5248,10,3,10,11,27,45,-18,19
Silkeborg IF,5248,11,5,3,14,26,46,-20,18
Brondby,5249,1,20,5,5,71,39,32,65
FC Midtjylla,5249,2,20,4,6,66,40,26,64
Copenhagen,5249,3,16,4,10,59,42,17,52
FC Nords,5249,4,14,6,10,74,54,20,48
AaB,5249,5,8,11,11,38,43,-5,35
AC Horsens,5249,6,7,12,11,34,50,-16,33
Sonderjyske,5249,7,8,6,10,28,29,-1,30
Randers FC,5249,8,6,6,12,28,41,-13,24
Silkeborg IF,5249,9,6,3,13,29,44,-15,21
Lyngby,5249,10,3,9,12,28,49,-21,18
AGF Aarhus,5249,11,4,6,12,16,40,-24,18
Brondby,5250,1,20,7,3,66,30,36,67
FC Midtjylla,5250,2,18,5,7,63,40,23,59
FC Nords,5250,3,14,6,10,74,54,20,48
Copenhagen,5250,4,14,6,10,57,45,12,48
AC Horsens,5250,5,8,13,9,36,49,-13,37
AaB,5250,6,7,13,10,37,41,-4,34
Sonderjyske,5250,7,8,6,10,28,29,-1,30
Randers FC,5250,8,5,7,12,25,41,-16,22
Silkeborg IF,5250,9,6,3,13,29,45,-16,21
Lyngby,5250,10,3,10,11,28,46,-18,19
AGF Aarhus,5250,11,4,6,12,17,40,-23,18
Brondby,5251,1,21,7,2,69,30,39,70
FC Midtjylla,5251,2,20,4,6,67,38,29,64
Copenhagen,5251,3,14,5,11,55,45,10,47
FC Nords,5251,4,12,9,9,73,54,19,45
AC Horsens,5251,5,6,15,9,35,49,-14,33
AaB,5251,6,6,14,10,35,44,-9,32
Sonderjyske,5251,7,8,6,10,28,29,-1,30
Randers FC,5251,8,6,6,12,25,40,-15,24
Silkeborg IF,5251,9,6,3,13,27,45,-18,21
Lyngby,5251,10,3,9,12,27,46,-19,18
AGF Aarhus,5251,11,4,6,12,17,38,-21,18
Brondby,5252,1,21,6,3,70,31,39,69
FC Midtjylla,5252,2,20,5,5,68,38,30,65
Copenhagen,5252,3,16,4,10,61,45,16,52
FC Nords,5252,4,13,6,11,73,58,15,45
AaB,5252,5,7,13,10,36,42,-6,34
Sonderjyske,5252,6,8,6,10,28,29,-1,30
AC Horsens,5252,7,5,14,11,33,53,-20,29
Randers FC,5252,8,5,7,12,24,40,-16,22
AGF Aarhus,5252,9,5,6,11,19,36,-17,21
Lyngby,5252,10,3,10,11,27,45,-18,19
Silkeborg IF,5252,11,5,3,14,25,47,-22,18
Brondby,5253,1,21,7,2,77,33,44,70
FC Midtjylla,5253,2,20,4,6,68,41,27,64
FC Nords,5253,3,15,6,9,75,57,18,51
Copenhagen,5253,4,13,5,12,57,47,10,44
AaB,5253,5,9,11,10,39,44,-5,38
Sonderjyske,5253,6,8,6,10,28,29,-1,30
AC Horsens,5253,7,5,13,12,36,56,-20,28
Lyngby,5253,8,4,9,11,29,45,-16,21
Silkeborg IF,5253,9,6,3,13,28,45,-17,21
Randers FC,5253,10,5,6,13,24,42,-18,21
AGF Aarhus,5253,11,4,6,12,17,39,-22,18
FC Midtjylla,5254,1,21,5,4,65,32,33,68
Brondby,5254,2,20,5,5,65,33,32,65
Copenhagen,5254,3,14,5,11,58,47,11,47
FC Nords,5254,4,13,6,11,68,53,15,45
AC Horsens,5254,5,8,13,9,39,48,-9,37
AaB,5254,6,7,12,11,37,45,-8,33
Sonderjyske,5254,7,8,6,10,28,29,-1,30
Randers FC,5254,8,6,6,12,24,39,-15,24
AGF Aarhus,5254,9,5,6,11,18,37,-19,21
Lyngby,5254,10,3,9,12,26,45,-19,18
Silkeborg IF,5254,11,5,3,14,26,46,-20,18
FC Midtjylla,5255,1,20,4,6,66,38,28,64
Brondby,5255,2,19,6,5,67,34,33,63
FC Nords,5255,3,15,7,8,76,48,28,52
Copenhagen,5255,4,14,6,10,57,41,16,48
AaB,5255,5,8,13,9,41,46,-5,37
Sonderjyske,5255,6,8,6,10,28,29,-1,30
AC Horsens,5255,7,5,14,11,33,59,-26,29
Lyngby,5255,8,4,9,11,28,44,-16,21
Silkeborg IF,5255,9,6,3,13,29,46,-17,21
Randers FC,5255,10,5,6,13,23,41,-18,21
AGF Aarhus,5255,11,4,6,12,18,40,-22,18
Brondby,5256,1,23,5,2,75,32,43,74
FC Midtjylla,5256,2,19,5,6,62,38,24,62
FC Nords,5256,3,16,6,8,78,49,29,54
Copenhagen,5256,4,13,4,13,55,50,5,43
AaB,5256,5,7,11,12,39,46,-7,32
AC Horsens,5256,6,6,13,11,34,54,-20,31
Sonderjyske,5256,7,8,6,10,28,29,-1,30
Lyngby,5256,8,4,9,11,28,45,-17,21
Randers FC,5256,9,5,6,13,24,41,-17,21
Silkeborg IF,5256,10,5,4,13,25,44,-19,19
AGF Aarhus,5256,11,4,7,11,16,36,-20,19
Brondby,5257,1,21,6,3,72,31,41,69
FC Midtjylla,5257,2,19,6,5,69,41,28,63
FC Nords,5257,3,13,9,8,72,53,19,48
Copenhagen,5257,4,13,7,10,60,48,12,46
AC Horsens,5257,5,8,12,10,36,52,-16,36
Sonderjyske,5257,6,8,6,10,28,29,-1,30
AaB,5257,7,6,12,12,33,43,-10,30
Lyngby,5257,8,4,9,11,28,45,-17,21
Randers FC,5257,9,5,6,13,24,41,-17,21
Silkeborg IF,5257,10,6,3,13,27,45,-18,21
AGF Aarhus,5257,11,4,6,12,17,38,-21,18
FC Midtjylla,5258,1,20,5,5,66,36,30,65
Brondby,5258,2,19,7,4,68,36,32,64
FC Nords,5258,3,15,7,8,75,51,24,52
Copenhagen,5258,4,15,5,10,57,40,17,50
AC Horsens,5258,5,6,14,10,36,53,-17,32
Sonderjyske,5258,6,8,6,10,28,29,-1,30
AaB,5258,7,6,12,12,36,48,-12,30
Lyngby,5258,8,4,9,11,27,44,-17,21
Randers FC,5258,9,5,6,13,23,40,-17,21
Silkeborg IF,5258,10,6,3,13,27,45,-18,21
AGF Aarhus,5258,11,4,6,12,17,38,-21,18
Brondby,5259,1,21,5,4,71,36,35,68
FC Midtjylla,5259,2,19,5,6,66,39,27,62
FC Nords,5259,3,14,8,8,76,56,20,50
Copenhagen,5259,4,12,5,13,55,47,8,41
AC Horsens,5259,5,8,13,9,35,49,-14,37
AaB,5259,6,8,12,10,40,42,-2,36
Sonderjyske,5259,7,8,6,10,28,29,-1,30
Randers FC,5259,8,5,7,12,25,41,-16,22
Silkeborg IF,5259,9,6,3,13,26,44,-18,21
Lyngby,5259,10,3,10,11,28,46,-18,19
AGF Aarhus,5259,11,4,6,12,16,37,-21,18
FC Midtjylla,5260,1,22,4,4,66,33,33,70
Brondby,5260,2,19,6,5,67,35,32,63
FC Nords,5260,3,15,6,9,74,53,21,51
Copenhagen,5260,4,13,5,12,58,45,13,44
AC Horsens,5260,5,7,13,10,38,57,-19,34
AaB,5260,6,7,12,11,34,40,-6,33
Sonderjyske,5260,7,8,6,10,28,29,-1,30
Lyngby,5260,8,4,9,11,29,44,-15,21
AGF Aarhus,5260,9,5,6,11,18,36,-18,21
Randers FC,5260,10,5,6,13,23,42,-19,21
Silkeborg IF,5260,11,5,3,14,25,46,-21,18
Brondby,5261,1,21,5,4,71,35,36,68
FC Midtjylla,5261,2,19,6,5,66,37,29,63
FC Nords,5261,3,14,8,8,72,51,21,50
Copenhagen,5261,4,13,6,11,55,47,8,45
AaB,5261,5,8,12,10,39,41,-2,36
AC Horsens,5261,6,6,13,11,36,54,-18,31
Sonderjyske,5261,7,8,6,10,28,29,-1,30
Randers FC,5261,8,6,6,12,26,39,-13,24
Silkeborg IF,5261,9,6,3,13,28,44,-16,21
Lyngby,5261,10,3,9,12,26,47,-21,18
AGF Aarhus,5261,11,4,6,12,16,39,-23,18
FC Midtjylla,5262,1,21,4,5,64,35,29,67
Brondby,5262,2,20,6,4,72,34,38,66
FC Nords,5262,3,13,8,9,68,48,20,47
Copenhagen,5262,4,14,5,11,57,46,11,47
AaB,5262,5,7,13,10,36,43,-7,34
AC Horsens,5262,6,7,12,11,39,56,-17,33
Sonderjyske,5262,7,8,6,10,28,29,-1,30
Lyngby,5262,8,4,9,11,28,45,-17,21
Randers FC,5262,9,5,6,13,24,41,-17,21
AGF Aarhus,5262,10,5,6,11,18,37,-19,21
Silkeborg IF,5262,11,5,3,14,26,46,-20,18
Brondby,5263,1,22,5,3,70,32,38,71
FC Midtjylla,5263,2,20,5,5,67,39,28,65
Copenhagen,5263,3,15,5,10,57,41,16,50
FC Nords,5263,4,13,6,11,71,57,14,45
AaB,5263,5,8,11,11,37,41,-4,35
Sonderjyske,5263,6,8,6,10,28,29,-1,30
AC Horsens,5263,7,6,12,12,36,54,-18,30
Lyngby,5263,8,4,9,11,28,44,-16,21
Randers FC,5263,9,5,6,13,23,41,-18,21
Silkeborg IF,5263,10,5,4,13,26,45,-19,19
AGF Aarhus,5263,11,4,7,11,17,37,-20,19
FC Midtjylla,5264,1,21,5,4,71,34,37,68
Brondby,5264,2,20,7,3,74,31,43,67
Copenhagen,5264,3,15,5,10,57,44,13,50
FC Nords,5264,4,13,6,11,67,66,1,45
AaB,5264,5,7,12,11,40,43,-3,33
AC Horsens,5264,6,6,13,11,34,51,-17,31
Sonderjyske,5264,7,8,6,10,28,29,-1,30
Lyngby,5264,8,4,9,11,27,44,-17,21
Randers FC,5264,9,5,6,13,23,40,-17,21
Silkeborg IF,5264,10,5,4,13,26,45,-19,19
AGF Aarhus,5264,11,4,7,11,17,37,-20,19
Brondby,5265,1,21,5,4,73,32,41,68
FC Midtjylla,5265,2,20,4,6,63,39,24,64
FC Nords,5265,3,15,6,9,73,52,21,51
Copenhagen,5265,4,13,4,13,54,48,6,43
AaB,5265,5,9,11,10,37,38,-1,38
AC Horsens,5265,6,7,12,11,36,53,-17,33
Sonderjyske,5265,7,8,6,10,28,29,-1,30
Lyngby,5265,8,4,9,11,30,45,-15,21
Silkeborg IF,5265,9,6,3,13,27,45,-18,21
Randers FC,5265,10,5,6,13,24,43,-19,21
AGF Aarhus,5265,11,4,6,12,17,38,-21,18
Brondby,5266,1,20,5,5,66,33,33,65
FC Midtjylla,5266,2,18,5,7,64,44,20,59
FC Nords,5266,3,14,8,8,80,52,28,50
Copenhagen,5266,4,14,6,10,61,49,12,48
AaB,5266,5,8,13,9,36,41,-5,37
AC Horsens,5266,6,7,13,10,38,52,-14,34
Sonderjyske,5266,7,8,6,10,28,29,-1,30
Randers FC,5266,8,5,7,12,24,40,-16,22
Silkeborg IF,5266,9,6,3,13,28,45,-17,21
Lyngby,5266,10,3,10,11,27,45,-18,19
AGF Aarhus,5266,11,4,6,12,17,39,-22,18
Brondby,5267,1,20,8,2,71,31,40,68
FC Midtjylla,5267,2,19,7,4,66,35,31,64
FC Nords,5267,3,12,8,10,66,53,13,44
Copenhagen,5267,4,13,5,12,60,47,13,44
AC Horsens,5267,5,8,12,10,37,56,-19,36
AaB,5267,6,7,14,9,38,42,-4,35
Sonderjyske,5267,7,8,6,10,28,29,-1,30
Lyngby,5267,8,4,9,11,28,45,-17,21
Randers FC,5267,9,5,6,13,24,41,-17,21
Silkeborg IF,5267,10,6,3,13,27,45,-18,21
AGF Aarhus,5267,11,4,6,12,17,38,-21,18
Brondby,5268,1,21,5,4,71,31,40,68
FC Midtjylla,5268,2,19,4,7,61,39,22,61
FC Nords,5268,3,15,6,9,75,54,21,51
Copenhagen,5268,4,15,5,10,61,44,17,50
AaB,5268,5,7,13,10,39,45,-6,34
AC Horsens,5268,6,6,13,11,35,55,-20,31
Sonderjyske,5268,7,8,6,10,28,29,-1,30
Randers FC,5268,8,6,6,12,24,39,-15,24
Silkeborg IF,5268,9,5,4,13,26,45,-19,19
AGF Aarhus,5268,10,4,7,11,17,37,-20,19
Lyngby,5268,11,3,9,12,26,45,-19,18
Brondby,5269,1,22,6,2,75,33,42,72
FC Midtjylla,5269,2,19,4,7,64,41,23,61
FC Nords,5269,3,14,7,9,72,52,20,49
Copenhagen,5269,4,13,5,12,59,46,13,44
AaB,5269,5,7,14,9,38,44,-6,35
AC Horsens,5269,6,6,14,10,37,55,-18,32
Sonderjyske,5269,7,8,6,10,28,29,-1,30
Randers FC,5269,8,6,6,12,26,41,-15,24
AGF Aarhus,5269,9,5,6,11,20,39,-19,21
Lyngby,5269,10,3,9,12,28,47,-19,18
Silkeborg IF,5269,11,5,3,14,28,48,-20,18
Brondby,5270,1,21,6,3,72,32,40,69
FC Midtjylla,5270,2,20,5,5,65,39,26,65
FC Nords,5270,3,15,6,9,78,52,26,51
Copenhagen,5270,4,13,7,10,56,45,11,46
AaB,5270,5,7,12,11,36,45,-9,33
Sonderjyske,5270,6,8,6,10,28,29,-1,30
AC Horsens,5270,7,6,12,12,38,58,-20,30
Lyngby,5270,8,4,9,11,29,45,-16,21
Silkeborg IF,5270,9,6,3,13,26,44,-18,21
Randers FC,5270,10,5,6,13,24,42,-18,21
AGF Aarhus,5270,11,4,6,12,16,37,-21,18
Brondby,5271,1,21,5,4,72,31,41,68
FC Midtjylla,5271,2,20,6,4,67,38,29,66
FC Nords,5271,3,14,7,9,76,55,21,49
Copenhagen,5271,4,14,5,11,57,42,15,47
AC Horsens,5271,5,6,14,10,32,51,-19,32
AaB,5271,6,6,13,11,36,49,-13,31
Sonderjyske,5271,7,8,6,10,28,29,-1,30
Lyngby,5271,8,4,9,11,28,44,-16,21
Randers FC,5271,9,5,6,13,23,41,-18,21
AGF Aarhus,5271,10,5,6,11,18,37,-19,21
Silkeborg IF,5271,11,5,3,14,26,46,-20,18
Brondby,5272,1,21,6,3,72,33,39,69
FC Midtjylla,5272,2,18,7,5,67,39,28,61
FC Nords,5272,3,13,8,9,70,54,16,47
Copenhagen,5272,4,14,5,11,58,46,12,47
AaB,5272,5,9,12,9,40,41,-1,39
Sonderjyske,5272,6,8,6,10,28,29,-1,30
AC Horsens,5272,7,5,14,11,33,53,-20,29
Lyngby,5272,8,4,9,11,30,45,-15,21
Randers FC,5272,9,5,6,13,24,43,-19,21
AGF Aarhus,5272,10,5,6,11,18,37,-19,21
Silkeborg IF,5272,11,5,3,14,26,46,-20,18
Brondby,5273,1,22,6,2,72,27,45,72
FC Midtjylla,5273,2,18,6,6,62,42,20,60
FC Nords,5273,3,14,6,10,74,55,19,48
Copenhagen,5273,4,13,7,10,53,40,13,46
AaB,5273,5,7,14,9,36,37,-1,35
AC Horsens,5273,6,6,13,11,31,53,-22,31
Sonderjyske,5273,7,8,6,10,28,29,-1,30
Lyngby,5273,8,4,9,11,29,45,-16,21
Randers FC,5273,9,5,6,13,24,42,-18,21
Silkeborg IF,5273,10,5,4,13,28,47,-19,19
AGF Aarhus,5273,11,4,7,11,19,39,-20,19
Brondby,5274,1,21,6,3,72,30,42,69
FC Midtjylla,5274,2,21,4,5,65,40,25,67
FC Nords,5274,3,13,8,9,70,49,21,47
Copenhagen,5274,4,14,4,12,55,44,11,46
AC Horsens,5274,5,6,15,9,32,47,-15,33
AaB,5274,6,6,13,11,34,44,-10,31
Sonderjyske,5274,7,8,6,10,28,29,-1,30
Randers FC,5274,8,6,6,12,26,39,-13,24
AGF Aarhus,5274,9,5,6,11,18,37,-19,21
Silkeborg IF,5274,10,5,3,14,26,46,-20,18
Lyngby,5274,11,3,9,12,26,47,-21,18
FC Midtjylla,5275,1,21,5,4,67,38,29,68
Brondby,5275,2,20,6,4,72,34,38,66
Copenhagen,5275,3,14,6,10,55,41,14,48
FC Nords,5275,4,13,7,10,68,52,16,46
AaB,5275,5,6,14,10,36,42,-6,32
AC Horsens,5275,6,6,14,10,33,50,-17,32
Sonderjyske,5275,7,8,6,10,28,29,-1,30
Randers FC,5275,8,5,7,12,24,40,-16,22
Silkeborg IF,5275,9,6,3,13,28,44,-16,21
Lyngby,5275,10,3,10,11,27,45,-18,19
AGF Aarhus,5275,11,4,6,12,16,39,-23,18
Brondby,5276,1,22,6,2,71,28,43,72
FC Midtjylla,5276,2,21,4,5,73,37,36,67
FC Nords,5276,3,13,7,10,72,60,12,46
Copenhagen,5276,4,13,5,12,58,46,12,44
AC Horsens,5276,5,7,13,10,36,57,-21,34
AaB,5276,6,7,11,12,36,44,-8,32
Sonderjyske,5276,7,8,6,10,28,29,-1,30
Randers FC,5276,8,6,6,12,25,40,-15,24
AGF Aarhus,5276,9,5,6,11,18,37,-19,21
Lyngby,5276,10,3,9,12,27,46,-19,18
Silkeborg IF,5276,11,5,3,14,26,46,-20,18
Brondby,5277,1,21,6,3,68,31,37,69
FC Midtjylla,5277,2,20,6,4,70,38,32,66
Copenhagen,5277,3,13,7,10,60,45,15,46
FC Nords,5277,4,13,6,11,69,56,13,45
AaB,5277,5,8,13,9,45,48,-3,37
Sonderjyske,5277,6,8,6,10,28,29,-1,30
AC Horsens,5277,7,5,14,11,34,54,-20,29
Lyngby,5277,8,4,9,11,29,44,-15,21
Silkeborg IF,5277,9,6,3,13,26,44,-18,21
Randers FC,5277,10,5,6,13,23,42,-19,21
AGF Aarhus,5277,11,4,6,12,16,37,-21,18
Brondby,5278,1,22,6,2,72,31,41,72
FC Midtjylla,5278,2,19,4,7,72,42,30,61
FC Nords,5278,3,15,7,8,75,48,27,52
Copenhagen,5278,4,14,4,12,58,53,5,46
AaB,5278,5,7,13,10,38,46,-8,34
Sonderjyske,5278,6,8,6,10,28,29,-1,30
AC Horsens,5278,7,5,14,11,37,58,-21,29
Randers FC,5278,8,6,6,12,25,40,-15,24
Silkeborg IF,5278,9,6,3,13,26,44,-18,21
Lyngby,5278,10,3,9,12,27,46,-19,18
AGF Aarhus,5278,11,4,6,12,16,37,-21,18
Brondby,5279,1,20,6,4,73,37,36,66
FC Midtjylla,5279,2,20,5,5,69,37,32,65
FC Nords,5279,3,14,8,8,74,54,20,50
Copenhagen,5279,4,14,5,11,57,46,11,47
AaB,5279,5,6,14,10,37,46,-9,32
AC Horsens,5279,6,6,14,10,34,50,-16,32
Sonderjyske,5279,7,8,6,10,28,29,-1,30
Randers FC,5279,8,5,7,12,24,40,-16,22
Silkeborg IF,5279,9,6,3,13,27,44,-17,21
Lyngby,5279,10,3,10,11,27,45,-18,19
AGF Aarhus,5279,11,4,6,12,16,38,-22,18
Brondby,5280,1,21,5,4,71,35,36,68
FC Midtjylla,5280,2,21,4,5,69,38,31,67
FC Nords,5280,3,14,6,10,74,57,17,48
Copenhagen,5280,4,13,5,12,55,45,10,44
AaB,5280,5,9,12,9,41,42,-1,39
Sonderjyske,5280,6,8,6,10,28,29,-1,30
AC Horsens,5280,7,5,14,11,31,50,-19,29
Randers FC,5280,8,5,7,12,25,41,-16,22
Silkeborg IF,5280,9,6,3,13,27,44,-17,21
Lyngby,5280,10,3,10,11,28,46,-18,19
AGF Aarhus,5280,11,4,6,12,16,38,-22,18
Brondby,5281,1,22,5,3,73,31,42,71
FC Midtjylla,5281,2,19,4,7,67,43,24,61
FC Nords,5281,3,14,6,10,72,56,16,48
Copenhagen,5281,4,14,6,10,58,42,16,48
AC Horsens,5281,5,7,13,10,36,52,-16,34
AaB,5281,6,7,12,11,37,45,-8,33
Sonderjyske,5281,7,8,6,10,28,29,-1,30
Lyngby,5281,8,4,9,11,28,45,-17,21
Randers FC,5281,9,5,6,13,24,41,-17,21
AGF Aarhus,5281,10,5,6,11,18,37,-19,21
Silkeborg IF,5281,11,5,3,14,26,46,-20,18
Brondby,5282,1,21,6,3,72,31,41,69
FC Midtjylla,5282,2,20,4,6,68,41,27,64
Copenhagen,5282,3,16,4,10,62,41,21,52
FC Nords,5282,4,14,7,9,74,57,17,49
AC Horsens,5282,5,6,13,11,34,56,-22,31
Sonderjyske,5282,6,8,6,10,28,29,-1,30
AaB,5282,7,6,12,12,36,46,-10,30
Lyngby,5282,8,4,9,11,28,45,-17,21
Randers FC,5282,9,5,6,13,24,41,-17,21
Silkeborg IF,5282,10,6,3,13,26,44,-18,21
AGF Aarhus,5282,11,4,6,12,16,37,-21,18
Brondby,5283,1,20,5,5,66,33,33,65
FC Midtjylla,5283,2,18,4,8,60,41,19,58
FC Nords,5283,3,16,7,7,72,45,27,55
Copenhagen,5283,4,15,4,11,59,43,16,49
AC Horsens,5283,5,8,12,10,37,51,-14,36
AaB,5283,6,7,12,11,34,41,-7,33
Sonderjyske,5283,7,8,6,10,28,29,-1,30
Randers FC,5283,8,5,7,12,25,41,-16,22
AGF Aarhus,5283,9,5,6,11,17,36,-19,21
Lyngby,5283,10,3,10,11,28,46,-18,19
Silkeborg IF,5283,11,5,3,14,25,45,-20,18
FC Midtjylla,5284,1,20,6,4,68,38,30,66
Brondby,5284,2,20,5,5,69,38,31,65
FC Nords,5284,3,15,7,8,75,49,26,52
Copenhagen,5284,4,15,6,9,62,43,19,51
AaB,5284,5,7,12,11,35,44,-9,33
Sonderjyske,5284,6,8,6,10,28,29,-1,30
AC Horsens,5284,7,5,12,13,33,56,-23,27
Lyngby,5284,8,4,9,11,28,44,-16,21
Randers FC,5284,9,5,6,13,23,41,-18,21
Silkeborg IF,5284,10,5,4,13,25,44,-19,19
AGF Aarhus,5284,11,4,7,11,16,36,-20,19
FC Midtjylla,5285,1,20,5,5,63,35,28,65
Brondby,5285,2,19,6,5,64,31,33,63
FC Nords,5285,3,13,8,9,72,52,20,47
Copenhagen,5285,4,13,8,9,60,45,15,47
AaB,5285,5,9,12,9,38,41,-3,39
AC Horsens,5285,6,6,13,11,32,51,-19,31
Sonderjyske,5285,7,8,6,10,28,29,-1,30
Randers FC,5285,8,6,6,12,25,39,-14,24
AGF Aarhus,5285,9,5,6,11,17,36,-19,21
Lyngby,5285,10,3,9,12,26,46,-20,18
Silkeborg IF,5285,11,5,3,14,25,45,-20,18
Brondby,5286,1,21,6,3,69,30,39,69
FC Midtjylla,5286,2,20,4,6,63,35,28,64
FC Nords,5286,3,15,6,9,76,50,26,51
Copenhagen,5286,4,13,5,12,57,46,11,44
AaB,5286,5,7,14,9,34,39,-5,35
AC Horsens,5286,6,6,13,11,31,56,-25,31
Sonderjyske,5286,7,8,6,10,28,29,-1,30
Lyngby,5286,8,4,9,11,27,44,-17,21
Randers FC,5286,9,5,6,13,23,40,-17,21
Silkeborg IF,5286,10,5,4,13,26,45,-19,19
AGF Aarhus,5286,11,4,7,11,17,37,-20,19
Brondby,5287,1,21,7,2,75,33,42,70
FC Midtjylla,5287,2,19,7,4,67,40,27,64
FC Nords,5287,3,13,9,8,71,52,19,48
Copenhagen,5287,4,12,5,13,54,48,6,41
AaB,5287,5,8,14,8,40,41,-1,38
Sonderjyske,5287,6,8,6,10,28,29,-1,30
AC Horsens,5287,7,5,14,11,32,51,-19,29
Randers FC,5287,8,6,6,12,26,41,-15,24
Silkeborg IF,5287,9,6,3,13,27,44,-17,21
Lyngby,5287,10,3,9,12,28,47,-19,18
AGF Aarhus,5287,11,4,6,12,16,38,-22,18
Brondby,5288,1,20,5,5,68,32,36,65
FC Midtjylla,5288,2,20,5,5,68,38,30,65
Copenhagen,5288,3,15,5,10,61,42,19,50
FC Nords,5288,4,14,6,10,71,57,14,48
AC Horsens,5288,5,8,12,10,37,51,-14,36
AaB,5288,6,7,11,12,36,47,-11,32
Sonderjyske,5288,7,8,6,10,28,29,-1,30
Randers FC,5288,8,5,7,12,24,40,-16,22
Lyngby,5288,9,3,10,11,27,45,-18,19
Silkeborg IF,5288,10,5,4,13,28,47,-19,19
AGF Aarhus,5288,11,4,7,11,19,39,-20,19
FC Midtjylla,5289,1,21,5,4,70,38,32,68
Brondby,5289,2,20,5,5,70,36,34,65
FC Nords,5289,3,15,6,9,77,53,24,51
Copenhagen,5289,4,14,6,10,60,48,12,48
AaB,5289,5,7,12,11,40,47,-7,33
Sonderjyske,5289,6,8,6,10,28,29,-1,30
AC Horsens,5289,7,5,14,11,35,56,-21,29
Lyngby,5289,8,4,9,11,27,44,-17,21
Randers FC,5289,9,5,6,13,23,40,-17,21
Silkeborg IF,5289,10,6,3,13,27,45,-18,21
AGF Aarhus,5289,11,4,6,12,17,38,-21,18
Brondby,5290,1,21,5,4,75,40,35,68
FC Midtjylla,5290,2,20,5,5,67,39,28,65
FC Nords,5290,3,15,8,7,76,51,25,53
Copenhagen,5290,4,14,4,12,55,42,13,46
AaB,5290,5,7,11,12,34,42,-8,32
AC Horsens,5290,6,6,13,11,35,54,-19,31
Sonderjyske,5290,7,8,6,10,28,29,-1,30
Randers FC,5290,8,5,7,12,26,42,-16,22
Silkeborg IF,5290,9,6,3,13,26,44,-18,21
Lyngby,5290,10,3,10,11,29,47,-18,19
AGF Aarhus,5290,11,4,6,12,16,37,-21,18
Brondby,5291,1,21,6,3,77,34,43,69
FC Midtjylla,5291,2,20,5,5,68,38,30,65
FC Nords,5291,3,13,8,9,71,54,17,47
Copenhagen,5291,4,14,4,12,58,47,11,46
AC Horsens,5291,5,7,14,9,34,49,-15,35
AaB,5291,6,6,13,11,35,47,-12,31
Sonderjyske,5291,7,8,6,10,28,29,-1,30
Randers FC,5291,8,5,7,12,23,39,-16,22
AGF Aarhus,5291,9,5,6,11,17,36,-19,21
Lyngby,5291,10,3,10,11,26,44,-18,19
Silkeborg IF,5291,11,5,3,14,25,45,-20,18
Brondby,5292,1,21,5,4,78,33,45,68
FC Midtjylla,5292,2,19,4,7,62,43,19,61
Copenhagen,5292,3,15,5,10,57,44,13,50
FC Nords,5292,4,13,7,10,68,51,17,46
AaB,5292,5,9,11,10,39,39,0,38
AC Horsens,5292,6,6,14,10,33,53,-20,32
Sonderjyske,5292,7,8,6,10,28,29,-1,30
Randers FC,5292,8,5,7,12,24,40,-16,22
AGF Aarhus,5292,9,5,6,11,18,37,-19,21
Lyngby,5292,10,3,10,11,27,45,-18,19
Silkeborg IF,5292,11,5,3,14,26,46,-20,18
FC Midtjylla,5293,1,21,4,5,71,41,30,67
Brondby,5293,2,19,7,4,70,35,35,64
FC Nords,5293,3,15,7,8,75,53,22,52
Copenhagen,5293,4,12,6,12,54,47,7,42
AaB,5293,5,8,12,10,39,43,-4,36
AC Horsens,5293,6,7,12,11,35,51,-16,33
Sonderjyske,5293,7,8,6,10,28,29,-1,30
Randers FC,5293,8,6,6,12,25,40,-15,24
AGF Aarhus,5293,9,5,6,11,18,36,-18,21
Lyngby,5293,10,3,9,12,27,46,-19,18
Silkeborg IF,5293,11,5,3,14,25,46,-21,18
Brondby,5294,1,22,5,3,81,34,47,71
FC Midtjylla,5294,2,21,4,5,65,42,23,67
Copenhagen,5294,3,14,5,11,57,44,13,47
FC Nords,5294,4,13,7,10,71,54,17,46
AC Horsens,5294,5,7,12,11,38,54,-16,33
AaB,5294,6,7,11,12,35,45,-10,32
Sonderjyske,5294,7,8,6,10,28,29,-1,30
Lyngby,5294,8,4,9,11,29,44,-15,21
Randers FC,5294,9,5,6,13,23,42,-19,21
Silkeborg IF,5294,10,5,4,13,25,44,-19,19
AGF Aarhus,5294,11,4,7,11,16,36,-20,19
Brondby,5295,1,22,5,3,70,30,40,71
FC Midtjylla,5295,2,20,5,5,69,38,31,65
FC Nords,5295,3,15,6,9,76,53,23,51
Copenhagen,5295,4,14,4,12,56,45,11,46
AaB,5295,5,7,12,11,37,44,-7,33
Sonderjyske,5295,6,8,6,10,28,29,-1,30
AC Horsens,5295,7,6,12,12,33,57,-24,30
Lyngby,5295,8,4,9,11,27,44,-17,21
Randers FC,5295,9,5,6,13,23,40,-17,21
Silkeborg IF,5295,10,5,4,13,28,47,-19,19
AGF Aarhus,5295,11,4,7,11,19,39,-20,19
Brondby,5296,1,21,5,4,70,32,38,68
FC Midtjylla,5296,2,20,5,5,63,34,29,65
Copenhagen,5296,3,15,4,11,59,44,15,49
FC Nords,5296,4,14,6,10,71,56,15,48
AaB,5296,5,7,12,11,38,43,-5,33
AC Horsens,5296,6,7,12,11,35,53,-18,33
Sonderjyske,5296,7,8,6,10,28,29,-1,30
Lyngby,5296,8,4,9,11,29,45,-16,21
Randers FC,5296,9,5,6,13,24,42,-18,21
AGF Aarhus,5296,10,5,6,11,17,36,-19,21
Silkeborg IF,5296,11,5,3,14,25,45,-20,18
Brondby,5297,1,19,8,3,67,33,34,65
FC Midtjylla,5297,2,18,7,5,69,44,25,61
Copenhagen,5297,3,15,6,9,65,44,21,51
FC Nords,5297,4,12,10,8,74,54,20,46
AaB,5297,5,7,14,9,38,45,-7,35
Sonderjyske,5297,6,8,6,10,28,29,-1,30
AC Horsens,5297,7,5,15,10,36,55,-19,30
Randers FC,5297,8,6,6,12,25,40,-15,24
AGF Aarhus,5297,9,5,6,11,17,36,-19,21
Lyngby,5297,10,3,9,12,27,46,-19,18
Silkeborg IF,5297,11,5,3,14,25,45,-20,18
Brondby,5298,1,21,5,4,70,34,36,68
FC Midtjylla,5298,2,20,4,6,67,41,26,64
Copenhagen,5298,3,15,4,11,59,44,15,49
FC Nords,5298,4,14,6,10,72,50,22,48
AaB,5298,5,8,11,11,37,43,-6,35
AC Horsens,5298,6,7,12,11,37,56,-19,33
Sonderjyske,5298,7,8,6,10,28,29,-1,30
Randers FC,5298,8,5,7,12,24,40,-16,22
Silkeborg IF,5298,9,6,3,13,26,44,-18,21
Lyngby,5298,10,3,10,11,27,45,-18,19
AGF Aarhus,5298,11,4,6,12,16,37,-21,18
FC Midtjylla,5299,1,20,5,5,67,40,27,65
Brondby,5299,2,18,6,6,65,38,27,60
FC Nords,5299,3,17,6,7,80,49,31,57
Copenhagen,5299,4,13,5,12,57,45,12,44
AC Horsens,5299,5,8,12,10,38,53,-15,36
AaB,5299,6,7,12,11,38,46,-8,33
Sonderjyske,5299,7,8,6,10,28,29,-1,30
Lyngby,5299,8,4,9,11,28,45,-17,21
Randers FC,5299,9,5,6,13,24,41,-17,21
Silkeborg IF,5299,10,6,3,13,27,45,-18,21
AGF Aarhus,5299,11,4,6,12,17,38,-21,18
Brondby,5300,1,21,5,4,70,32,38,68
FC Midtjylla,5300,2,21,4,5,71,43,28,67
FC Nords,5300,3,16,6,8,73,49,24,54
Copenhagen,5300,4,12,6,12,54,44,10,42
AaB,5300,5,7,12,11,33,42,-9,33
AC Horsens,5300,6,6,13,11,35,52,-17,31
Sonderjyske,5300,7,8,6,10,28,29,-1,30
Randers FC,5300,8,6,6,12,25,40,-15,24
Silkeborg IF,5300,9,6,3,13,27,45,-18,21
Lyngby,5300,10,3,9,12,27,46,-19,18
AGF Aarhus,5300,11,4,6,12,17,38,-21,18
FC Midtjylla,5301,1,20,5,5,65,37,28,65
Brondby,5301,2,19,7,4,67,32,35,64
Copenhagen,5301,3,16,5,9,61,41,20,53
FC Nords,5301,4,12,8,10,68,51,17,44
AaB,5301,5,6,15,9,36,43,-7,33
AC Horsens,5301,6,6,14,10,33,52,-19,32
Sonderjyske,5301,7,8,6,10,28,29,-1,30
Randers FC,5301,8,6,6,12,25,39,-14,24
AGF Aarhus,5301,9,5,6,11,17,36,-19,21
Lyngby,5301,10,3,9,12,26,46,-20,18
Silkeborg IF,5301,11,5,3,14,25,45,-20,18
FC Midtjylla,5302,1,19,7,4,67,36,31,64
Brondby,5302,2,19,6,5,69,34,35,63
FC Nords,5302,3,15,7,8,80,52,28,52
Copenhagen,5302,4,14,5,11,57,46,11,47
AaB,5302,5,8,11,11,39,46,-7,35
AC Horsens,5302,6,7,12,11,35,59,-24,33
Sonderjyske,5302,7,8,6,10,28,29,-1,30
Randers FC,5302,8,6,6,12,26,40,-14,24
Silkeborg IF,5302,9,6,3,13,27,45,-18,21
Lyngby,5302,10,3,9,12,27,47,-20,18
AGF Aarhus,5302,11,4,6,12,17,38,-21,18
Brondby,5303,1,22,6,2,76,32,44,72
FC Midtjylla,5303,2,19,5,6,65,41,24,62
FC Nords,5303,3,14,6,10,74,54,20,48
Copenhagen,5303,4,13,6,11,56,44,12,45
AC Horsens,5303,5,7,13,10,36,55,-19,34
AaB,5303,6,7,12,11,38,45,-7,33
Sonderjyske,5303,7,8,6,10,28,29,-1,30
Randers FC,5303,8,5,7,12,24,40,-16,22
Silkeborg IF,5303,9,6,3,13,27,44,-17,21
Lyngby,5303,10,3,10,11,27,45,-18,19
AGF Aarhus,5303,11,4,6,12,16,38,-22,18
Brondby,5304,1,21,7,2,74,32,42,70
FC Midtjylla,5304,2,18,6,6,65,40,25,60
FC Nords,5304,3,13,8,9,71,53,18,47
Copenhagen,5304,4,14,5,11,56,45,11,47
AC Horsens,5304,5,7,15,8,36,49,-13,36
AaB,5304,6,7,11,12,37,46,-9,32
Sonderjyske,5304,7,8,6,10,28,29,-1,30
Randers FC,5304,8,6,6,12,25,39,-14,24
Silkeborg IF,5304,9,6,3,13,27,45,-18,21
Lyngby,5304,10,3,9,12,26,46,-20,18
AGF Aarhus,5304,11,4,6,12,17,38,-21,18
Brondby,5305,1,20,6,4,71,35,36,66
FC Midtjylla,5305,2,20,5,5,67,41,26,65
FC Nords,5305,3,14,6,10,74,54,20,48
Copenhagen,5305,4,13,6,11,58,47,11,45
AC Horsens,5305,5,8,13,9,39,52,-13,37
AaB,5305,6,6,14,10,39,45,-6,32
Sonderjyske,5305,7,8,6,10,28,29,-1,30
Randers FC,5305,8,5,7,12,24,40,-16,22
Lyngby,5305,9,3,10,11,27,45,-18,19
Silkeborg IF,5305,10,5,4,13,25,44,-19,19
AGF Aarhus,5305,11,4,7,11,16,36,-20,19
Brondby,5306,1,21,5,4,69,32,37,68
FC Midtjylla,5306,2,19,5,6,66,39,27,62
FC Nords,5306,3,14,7,9,79,53,26,49
Copenhagen,5306,4,14,5,11,54,46,8,47
AaB,5306,5,9,12,9,43,44,-1,39
Sonderjyske,5306,6,8,6,10,28,29,-1,30
AC Horsens,5306,7,5,14,11,34,57,-23,29
Randers FC,5306,8,5,7,12,24,40,-16,22
AGF Aarhus,5306,9,5,6,11,21,36,-15,21
Lyngby,5306,10,3,10,11,27,45,-18,19
Silkeborg IF,5306,11,5,3,14,25,49,-24,18
Brondby,5307,1,21,6,3,72,32,40,69
FC Midtjylla,5307,2,20,4,6,67,41,26,64
Copenhagen,5307,3,15,5,10,61,47,14,50
FC Nords,5307,4,13,7,10,70,54,16,46
AC Horsens,5307,5,7,13,10,37,51,-14,34
AaB,5307,6,6,13,11,33,41,-8,31
Sonderjyske,5307,7,8,6,10,28,29,-1,30
Lyngby,5307,8,4,9,11,29,44,-15,21
Silkeborg IF,5307,9,6,3,13,27,44,-17,21
Randers FC,5307,10,5,6,13,23,42,-19,21
AGF Aarhus,5307,11,4,6,12,16,38,-22,18
Brondby,5308,1,21,5,4,73,30,43,68
FC Midtjylla,5308,2,20,6,4,66,35,31,66
Copenhagen,5308,3,16,4,10,60,40,20,52
FC Nords,5308,4,13,8,9,72,53,19,47
AaB,5308,5,6,14,10,35,49,-14,32
Sonderjyske,5308,6,8,6,10,28,29,-1,30
AC Horsens,5308,7,5,13,12,33,58,-25,28
Randers FC,5308,8,5,7,12,24,40,-16,22
Silkeborg IF,5308,9,6,3,13,27,44,-17,21
Lyngby,5308,10,3,10,11,27,45,-18,19
AGF Aarhus,5308,11,4,6,12,16,38,-22,18
Brondby,5309,1,19,7,4,68,35,33,64
FC Midtjylla,5309,2,19,4,7,64,38,26,61
FC Nords,5309,3,13,8,9,73,54,19,47
Copenhagen,5309,4,14,4,12,55,46,9,46
AC Horsens,5309,5,10,12,8,38,46,-8,42
AaB,5309,6,7,13,10,41,46,-5,34
Sonderjyske,5309,7,8,6,10,28,29,-1,30
Lyngby,5309,8,4,9,11,28,45,-17,21
Randers FC,5309,9,5,6,13,24,41,-17,21
Silkeborg IF,5309,10,5,4,13,25,44,-19,19
AGF Aarhus,5309,11,4,7,11,16,36,-20,19
Brondby,5310,1,20,5,5,65,31,34,65
FC Midtjylla,5310,2,20,5,5,65,37,28,65
FC Nords,5310,3,16,6,8,75,48,27,54
Copenhagen,5310,4,14,4,12,57,46,11,46
AaB,5310,5,9,12,9,41,39,2,39
Sonderjyske,5310,6,8,6,10,28,29,-1,30
AC Horsens,5310,7,5,12,13,32,60,-28,27
Lyngby,5310,8,4,9,11,29,46,-17,21
Randers FC,5310,9,5,6,13,25,42,-17,21
AGF Aarhus,5310,10,5,6,11,18,37,-19,21
Silkeborg IF,5310,11,5,3,14,26,46,-20,18
Brondby,5311,1,21,7,2,72,31,41,70
FC Midtjylla,5311,2,20,4,6,69,40,29,64
FC Nords,5311,3,15,8,7,76,51,25,53
Copenhagen,5311,4,12,5,13,54,47,7,41
AC Horsens,5311,5,7,13,10,37,56,-19,34
AaB,5311,6,7,11,12,40,49,-9,32
Sonderjyske,5311,7,8,6,10,28,29,-1,30
Lyngby,5311,8,4,9,11,29,46,-17,21
Randers FC,5311,9,5,6,13,25,42,-17,21
Silkeborg IF,5311,10,5,4,13,26,45,-19,19
AGF Aarhus,5311,11,4,7,11,17,37,-20,19
Brondby,5312,1,20,6,4,68,33,35,66
FC Midtjylla,5312,2,19,5,6,62,36,26,62
FC Nords,5312,3,16,7,7,76,49,27,55
Copenhagen,5312,4,14,5,11,60,48,12,47
AC Horsens,5312,5,7,13,10,35,52,-17,34
Sonderjyske,5312,6,8,6,10,28,29,-1,30
AaB,5312,7,6,12,12,35,44,-9,30
Randers FC,5312,8,5,7,12,25,41,-16,22
AGF Aarhus,5312,9,5,6,11,21,38,-17,21
Lyngby,5312,10,3,10,11,28,46,-18,19
Silkeborg IF,5312,11,5,3,14,27,49,-22,18
Brondby,5313,1,21,7,2,73,29,44,70
FC Midtjylla,5313,2,19,6,5,63,36,27,63
FC Nords,5313,3,14,8,8,79,47,32,50
Copenhagen,5313,4,14,5,11,54,49,5,47
AC Horsens,5313,5,6,14,10,34,51,-17,32
Sonderjyske,5313,6,8,6,10,28,29,-1,30
AaB,5313,7,6,12,12,31,48,-17,30
Randers FC,5313,8,5,7,12,25,41,-16,22
AGF Aarhus,5313,9,5,6,11,17,36,-19,21
Lyngby,5313,10,3,10,11,28,46,-18,19
Silkeborg IF,5313,11,5,3,14,25,45,-20,18
Brondby,5314,1,22,5,3,75,31,44,71
FC Midtjylla,5314,2,19,4,7,62,38,24,61
FC Nords,5314,3,14,8,8,73,53,20,50
Copenhagen,5314,4,14,5,11,60,48,12,47
AaB,5314,5,7,12,11,39,47,-8,33
AC Horsens,5314,6,7,12,11,35,53,-18,33
Sonderjyske,5314,7,8,6,10,28,29,-1,30
Randers FC,5314,8,5,7,12,25,41,-16,22
AGF Aarhus,5314,9,5,6,11,18,37,-19,21
Lyngby,5314,10,3,10,11,28,46,-18,19
Silkeborg IF,5314,11,5,3,14,26,46,-20,18
Brondby,5315,1,20,6,4,71,34,37,66
FC Midtjylla,5315,2,19,6,5,63,38,25,63
FC Nords,5315,3,15,7,8,76,50,26,52
Copenhagen,5315,4,14,6,10,59,46,13,48
AC Horsens,5315,5,6,15,9,37,51,-14,33
Sonderjyske,5315,6,8,6,10,28,29,-1,30
AaB,5315,7,6,12,12,33,46,-13,30
Lyngby,5315,8,4,9,11,28,45,-17,21
Randers FC,5315,9,5,6,13,24,41,-17,21
AGF Aarhus,5315,10,5,6,11,18,37,-19,21
Silkeborg IF,5315,11,5,3,14,26,46,-20,18
Brondby,5316,1,21,6,3,73,33,40,69
FC Midtjylla,5316,2,19,5,6,65,41,24,62
FC Nords,5316,3,15,8,7,77,51,26,53
Copenhagen,5316,4,13,6,11,58,47,11,45
AaB,5316,5,7,14,9,36,41,-5,35
Sonderjyske,5316,6,8,6,10,28,29,-1,30
AC Horsens,5316,7,5,13,12,37,59,-22,28
Randers FC,5316,8,6,6,12,27,39,-12,24
Silkeborg IF,5316,9,6,3,13,26,44,-18,21
AGF Aarhus,5316,10,4,6,12,16,37,-21,18
Lyngby,5316,11,3,9,12,26,48,-22,18
Brondby,5317,1,22,5,3,71,35,36,71
FC Midtjylla,5317,2,21,4,5,72,42,30,67
FC Nords,5317,3,13,7,10,76,61,15,46
Copenhagen,5317,4,13,5,12,59,47,12,44
AC Horsens,5317,5,8,12,10,40,52,-12,36
AaB,5317,6,6,13,11,41,48,-7,31
Sonderjyske,5317,7,8,6,10,28,29,-1,30
Lyngby,5317,8,4,9,11,27,44,-17,21
Randers FC,5317,9,5,6,13,23,40,-17,21
Silkeborg IF,5317,10,6,3,13,27,45,-18,21
AGF Aarhus,5317,11,4,6,12,17,38,-21,18
Brondby,5318,1,22,6,2,70,30,40,72
FC Midtjylla,5318,2,20,4,6,69,40,29,64
Copenhagen,5318,3,15,4,11,61,44,17,49
FC Nords,5318,4,13,7,10,70,52,18,46
AaB,5318,5,7,12,11,37,47,-10,33
AC Horsens,5318,6,6,13,11,35,55,-20,31
Sonderjyske,5318,7,8,6,10,28,29,-1,30
Randers FC,5318,8,5,7,12,24,40,-16,22
Lyngby,5318,9,3,10,11,27,45,-18,19
Silkeborg IF,5318,10,5,4,13,25,44,-19,19
AGF Aarhus,5318,11,4,7,11,16,36,-20,19
Brondby,5319,1,20,7,3,72,36,36,67
FC Midtjylla,5319,2,19,7,4,68,37,31,64
FC Nords,5319,3,14,9,7,74,50,24,51
Copenhagen,5319,4,13,4,13,55,48,7,43
AaB,5319,5,9,12,9,38,41,-3,39
Sonderjyske,5319,6,8,6,10,28,29,-1,30
AC Horsens,5319,7,5,13,12,37,58,-21,28
Lyngby,5319,8,4,9,11,27,44,-17,21
Randers FC,5319,9,5,6,13,23,40,-17,21
Silkeborg IF,5319,10,6,3,13,27,45,-18,21
AGF Aarhus,5319,11,4,6,12,17,38,-21,18
Brondby,5320,1,20,6,4,73,35,38,66
FC Midtjylla,5320,2,20,4,6,72,40,32,64
FC Nords,5320,3,15,7,8,72,53,19,52
Copenhagen,5320,4,14,5,11,59,47,12,47
AaB,5320,5,8,12,10,39,43,-4,36
Sonderjyske,5320,6,8,6,10,28,29,-1,30
AC Horsens,5320,7,6,12,12,32,55,-23,30
Randers FC,5320,8,6,6,12,25,39,-14,24
AGF Aarhus,5320,9,5,6,11,17,36,-19,21
Lyngby,5320,10,3,9,12,26,46,-20,18
Silkeborg IF,5320,11,5,3,14,25,45,-20,18
FC Midtjylla,5321,1,20,5,5,69,41,28,65
Brondby,5321,2,19,7,4,68,36,32,64
FC Nords,5321,3,16,6,8,79,52,27,54
Copenhagen,5321,4,13,6,11,58,47,11,45
AaB,5321,5,8,12,10,41,44,-3,36
Sonderjyske,5321,6,8,6,10,28,29,-1,30
AC Horsens,5321,7,5,14,11,32,53,-21,29
Lyngby,5321,8,4,9,11,30,45,-15,21
Randers FC,5321,9,5,6,13,24,43,-19,21
Silkeborg IF,5321,10,5,4,13,25,44,-19,19
AGF Aarhus,5321,11,4,7,11,16,36,-20,19
Brondby,5322,1,20,5,5,70,34,36,65
FC Midtjylla,5322,2,20,4,6,64,40,24,64
Copenhagen,5322,3,16,5,9,60,39,21,53
FC Nords,5322,4,13,7,10,72,54,18,46
AaB,5322,5,8,11,11,40,44,-4,35
AC Horsens,5322,6,6,14,10,33,54,-21,32
Sonderjyske,5322,7,8,6,10,28,29,-1,30
Lyngby,5322,8,4,9,11,29,45,-16,21
Randers FC,5322,9,5,6,13,24,42,-18,21
AGF Aarhus,5322,10,5,6,11,19,38,-19,21
Silkeborg IF,5322,11,5,3,14,27,47,-20,18
Brondby,5323,1,22,5,3,74,31,43,71
FC Midtjylla,5323,2,19,6,5,67,43,24,63
FC Nords,5323,3,14,6,10,74,52,22,48
Copenhagen,5323,4,14,5,11,62,50,12,47
AaB,5323,5,8,12,10,40,44,-4,36
Sonderjyske,5323,6,8,6,10,28,29,-1,30
AC Horsens,5323,7,6,12,12,32,55,-23,30
Randers FC,5323,8,5,7,12,23,39,-16,22
Silkeborg IF,5323,9,6,3,13,27,45,-18,21
Lyngby,5323,10,3,10,11,26,44,-18,19
AGF Aarhus,5323,11,4,6,12,17,38,-21,18
Brondby,5324,1,21,7,2,74,30,44,70
FC Midtjylla,5324,2,19,5,6,68,43,25,62
FC Nords,5324,3,15,7,8,74,49,25,52
Copenhagen,5324,4,12,6,12,53,48,5,42
AaB,5324,5,8,12,10,39,42,-3,36
AC Horsens,5324,6,6,13,11,34,56,-22,31
Sonderjyske,5324,7,8,6,10,28,29,-1,30
Lyngby,5324,8,4,9,11,31,45,-14,21
AGF Aarhus,5324,9,5,6,11,17,36,-19,21
Randers FC,5324,10,5,6,13,24,44,-20,21
Silkeborg IF,5324,11,5,3,14,25,45,-20,18
Brondby,5325,1,20,7,3,71,33,38,67
FC Midtjylla,5325,2,18,4,8,62,42,20,58
FC Nords,5325,3,15,6,9,73,56,17,51
Copenhagen,5325,4,14,5,11,58,44,14,47
AaB,5325,5,8,13,9,42,41,1,37
AC Horsens,5325,6,7,13,10,35,51,-16,34
Sonderjyske,5325,7,8,6,10,28,29,-1,30
Randers FC,5325,8,6,6,12,24,39,-15,24
Silkeborg IF,5325,9,5,4,13,26,45,-19,19
AGF Aarhus,5325,10,4,7,11,17,37,-20,19
Lyngby,5325,11,3,9,12,26,45,-19,18
Brondby,5326,1,22,6,2,73,30,43,72
FC Midtjylla,5326,2,19,5,6,67,44,23,62
FC Nords,5326,3,15,6,9,76,54,22,51
Copenhagen,5326,4,12,5,13,53,46,7,41
AaB,5326,5,9,12,9,41,41,0,39
Sonderjyske,5326,6,8,6,10,28,29,-1,30
AC Horsens,5326,7,5,14,11,34,55,-21,29
Randers FC,5326,8,5,7,12,24,40,-16,22
Lyngby,5326,9,3,10,11,27,45,-18,19
Silkeborg IF,5326,10,5,4,13,25,44,-19,19
AGF Aarhus,5326,11,4,7,11,16,36,-20,19
Brondby,5327,1,21,5,4,75,35,40,68
FC Midtjylla,5327,2,20,6,4,64,35,29,66
Copenhagen,5327,3,15,4,11,60,47,13,49
FC Nords,5327,4,13,8,9,73,55,18,47
AaB,5327,5,8,13,9,43,45,-2,37
Sonderjyske,5327,6,8,6,10,28,29,-1,30
AC Horsens,5327,7,5,12,13,31,55,-24,27
Randers FC,5327,8,6,6,12,26,41,-15,24
Silkeborg IF,5327,9,5,4,13,25,44,-19,19
AGF Aarhus,5327,10,4,7,11,16,36,-20,19
Lyngby,5327,11,3,9,12,28,47,-19,18
FC Midtjylla,5328,1,21,5,4,69,35,34,68
Brondby,5328,2,19,8,3,69,34,35,65
FC Nords,5328,3,13,8,9,69,50,19,47
Copenhagen,5328,4,12,7,11,54,44,10,43
AC Horsens,5328,5,8,12,10,34,48,-14,36
AaB,5328,6,7,12,11,34,44,-10,33
Sonderjyske,5328,7,8,6,10,28,29,-1,30
Randers FC,5328,8,6,6,12,26,40,-14,24
Silkeborg IF,5328,9,6,3,13,27,45,-18,21
Lyngby,5328,10,3,9,12,27,47,-20,18
AGF Aarhus,5328,11,4,6,12,17,38,-21,18
Brondby,5329,1,21,6,3,71,34,37,69
FC Midtjylla,5329,2,18,6,6,66,43,23,60
FC Nords,5329,3,14,8,8,76,53,23,50
Copenhagen,5329,4,13,7,10,59,49,10,46
AaB,5329,5,8,13,9,42,41,1,37
Sonderjyske,5329,6,8,6,10,28,29,-1,30
AC Horsens,5329,7,5,14,11,35,55,-20,29
Lyngby,5329,8,4,9,11,29,45,-16,21
Silkeborg IF,5329,8,6,3,13,29,45,-16,21
Randers FC,5329,10,5,6,13,24,42,-18,21
AGF Aarhus,5329,11,4,6,12,17,40,-23,18
FC Midtjylla,5330,1,21,5,4,75,37,38,68
Brondby,5330,2,20,5,5,68,37,31,65
FC Nords,5330,3,14,7,9,73,56,17,49
Copenhagen,5330,4,14,6,10,59,45,14,48
AC Horsens,5330,5,7,12,11,37,53,-16,33
AaB,5330,6,7,11,12,36,46,-10,32
Sonderjyske,5330,7,8,6,10,28,29,-1,30
Randers FC,5330,8,6,6,12,26,40,-14,24
Silkeborg IF,5330,9,6,3,13,28,45,-17,21
Lyngby,5330,10,3,9,12,27,47,-20,18
AGF Aarhus,5330,11,4,6,12,17,39,-22,18
Brondby,5331,1,21,6,3,70,32,38,69
FC Midtjylla,5331,2,21,4,5,70,37,33,67
FC Nords,5331,3,13,7,10,72,52,20,46
Copenhagen,5331,4,13,5,12,55,48,7,44
AaB,5331,5,9,11,10,37,44,-7,38
AC Horsens,5331,6,6,13,11,35,52,-17,31
Sonderjyske,5331,7,8,6,10,28,29,-1,30
Lyngby,5331,8,4,9,11,27,44,-17,21
Randers FC,5331,9,5,6,13,23,40,-17,21
Silkeborg IF,5331,10,6,3,13,27,45,-18,21
AGF Aarhus,5331,11,4,6,12,17,38,-21,18
FC Midtjylla,5332,1,20,6,4,74,45,29,66
Brondby,5332,2,18,7,5,67,39,28,61
FC Nords,5332,3,14,8,8,76,53,23,50
Copenhagen,5332,4,14,4,12,63,52,11,46
AC Horsens,5332,5,8,12,10,39,51,-12,36
AaB,5332,6,7,13,10,40,45,-5,34
Sonderjyske,5332,7,8,6,10,28,29,-1,30
Lyngby,5332,8,4,9,11,28,45,-17,21
Randers FC,5332,9,5,6,13,24,41,-17,21
Silkeborg IF,5332,10,6,3,13,26,44,-18,21
AGF Aarhus,5332,11,4,6,12,16,37,-21,18
Brondby,5333,1,23,5,2,75,32,43,74
FC Midtjylla,5333,2,20,5,5,66,41,25,65
FC Nords,5333,3,13,8,9,74,53,21,47
Copenhagen,5333,4,12,6,12,59,51,8,42
AaB,5333,5,6,14,10,36,43,-7,32
AC Horsens,5333,6,6,14,10,36,52,-16,32
Sonderjyske,5333,7,8,6,10,28,29,-1,30
Randers FC,5333,8,6,6,12,24,39,-15,24
Silkeborg IF,5333,9,5,4,13,28,47,-19,19
AGF Aarhus,5333,10,4,7,11,19,39,-20,19
Lyngby,5333,11,3,9,12,26,45,-19,18
Brondby,5334,1,20,7,3,67,31,36,67
FC Midtjylla,5334,2,18,4,8,60,41,19,58
FC Nords,5334,3,15,7,8,77,51,26,52
Copenhagen,5334,4,14,4,12,59,47,12,46
AaB,5334,5,9,12,9,37,39,-2,39
AC Horsens,5334,6,6,14,10,32,49,-17,32
Sonderjyske,5334,7,8,6,10,28,29,-1,30
Lyngby,5334,8,4,9,11,28,45,-17,21
Randers FC,5334,9,5,6,13,24,41,-17,21
AGF Aarhus,5334,10,5,6,11,17,36,-19,21
Silkeborg IF,5334,11,5,3,14,25,45,-20,18
Brondby,5335,1,19,7,4,68,34,34,64
FC Midtjylla,5335,2,20,4,6,67,42,25,64
FC Nords,5335,3,14,7,9,74,51,23,49
Copenhagen,5335,4,14,4,12,54,44,10,46
AaB,5335,5,9,11,10,37,41,-4,38
AC Horsens,5335,6,7,13,10,38,52,-14,34
Sonderjyske,5335,7,8,6,10,28,29,-1,30
Lyngby,5335,8,4,9,11,27,44,-17,21
Randers FC,5335,9,5,6,13,23,40,-17,21
Silkeborg IF,5335,10,5,4,13,26,45,-19,19
AGF Aarhus,5335,11,4,7,11,17,37,-20,19
Brondby,5336,1,19,8,3,68,35,33,65
FC Midtjylla,5336,2,19,6,5,69,43,26,63
Copenhagen,5336,3,15,5,10,63,45,18,50
FC Nords,5336,4,13,6,11,71,52,19,45
AaB,5336,5,7,15,8,39,42,-3,36
AC Horsens,5336,6,6,14,10,37,56,-19,32
Sonderjyske,5336,7,8,6,10,28,29,-1,30
Lyngby,5336,8,4,9,11,30,45,-15,21
Randers FC,5336,9,5,6,13,24,43,-19,21
AGF Aarhus,5336,10,5,6,11,19,38,-19,21
Silkeborg IF,5336,11,5,3,14,27,47,-20,18
Brondby,5337,1,22,5,3,74,30,44,71
FC Midtjylla,5337,2,20,4,6,65,38,27,64
FC Nords,5337,3,15,6,9,74,52,22,51
Copenhagen,5337,4,13,4,13,54,47,7,43
AaB,5337,5,8,12,10,34,42,-8,36
AC Horsens,5337,6,6,13,11,34,52,-18,31
Sonderjyske,5337,7,8,6,10,28,29,-1,30
Randers FC,5337,8,6,6,12,26,41,-15,24
Silkeborg IF,5337,9,5,4,13,26,45,-19,19
AGF Aarhus,5337,10,4,7,11,17,37,-20,19
Lyngby,5337,11,3,9,12,28,47,-19,18
Brondby,5338,1,22,5,3,74,34,40,71
FC Midtjylla,5338,2,20,5,5,70,41,29,65
Copenhagen,5338,3,14,5,11,55,42,13,47
FC Nords,5338,4,13,7,10,72,54,18,46
AaB,5338,5,7,13,10,33,39,-6,34
AC Horsens,5338,6,6,13,11,35,55,-20,31
Sonderjyske,5338,7,8,6,10,28,29,-1,30
Randers FC,5338,8,5,7,12,24,40,-16,22
AGF Aarhus,5338,9,5,6,11,19,37,-18,21
Lyngby,5338,10,3,10,11,27,45,-18,19
Silkeborg IF,5338,11,5,3,14,26,47,-21,18
Brondby,5339,1,20,6,4,66,32,34,66
FC Midtjylla,5339,2,20,5,5,63,37,26,65
FC Nords,5339,3,15,6,9,71,48,23,51
Copenhagen,5339,4,12,6,12,52,46,6,42
AaB,5339,5,8,12,10,35,39,-4,36
AC Horsens,5339,6,7,13,10,37,48,-11,34
Sonderjyske,5339,7,8,6,10,28,29,-1,30
Lyngby,5339,8,4,9,11,28,44,-16,21
Randers FC,5339,9,5,6,13,23,41,-18,21
AGF Aarhus,5339,10,5,6,11,17,36,-19,21
Silkeborg IF,5339,11,5,3,14,25,45,-20,18
Brondby,5340,1,20,7,3,71,36,35,67
FC Midtjylla,5340,2,21,4,5,67,35,32,67
Copenhagen,5340,3,14,5,11,54,42,12,47
FC Nords,5340,4,12,10,8,71,53,18,46
AaB,5340,5,7,13,10,38,43,-5,34
Sonderjyske,5340,6,8,6,10,28,29,-1,30
AC Horsens,5340,7,5,15,10,33,51,-18,30
Lyngby,5340,8,4,9,11,27,44,-17,21
Randers FC,5340,9,5,6,13,23,40,-17,21
AGF Aarhus,5340,10,5,6,11,18,37,-19,21
Silkeborg IF,5340,11,5,3,14,26,46,-20,18
Brondby,5341,1,19,7,4,68,33,35,64
FC Midtjylla,5341,2,19,6,5,67,39,28,63
FC Nords,5341,3,15,8,7,75,49,26,53
Copenhagen,5341,4,15,5,10,59,43,16,50
AaB,5341,5,7,12,11,36,46,-10,33
Sonderjyske,5341,6,8,6,10,28,29,-1,30
AC Horsens,5341,7,6,12,12,32,53,-21,30
Randers FC,5341,8,6,6,12,25,40,-15,24
AGF Aarhus,5341,9,5,6,11,17,36,-19,21
Lyngby,5341,10,3,9,12,27,46,-19,18
Silkeborg IF,5341,11,5,3,14,25,45,-20,18
Brondby,5342,1,23,5,2,72,29,43,74
FC Midtjylla,5342,2,19,5,6,65,42,23,62
FC Nords,5342,3,15,6,9,77,50,27,51
Copenhagen,5342,4,13,5,12,59,48,11,44
AaB,5342,5,8,12,10,37,42,-5,36
Sonderjyske,5342,6,8,6,10,28,29,-1,30
AC Horsens,5342,7,5,13,12,32,57,-25,28
Randers FC,5342,8,6,6,12,25,39,-14,24
Silkeborg IF,5342,9,6,3,13,28,46,-18,21
Lyngby,5342,10,3,9,12,26,46,-20,18
AGF Aarhus,5342,11,4,6,12,18,39,-21,18
Brondby,5343,1,21,5,4,72,33,39,68
FC Midtjylla,5343,2,20,5,5,71,40,31,65
FC Nords,5343,3,14,7,9,72,54,18,49
Copenhagen,5343,4,14,5,11,62,49,13,47
AaB,5343,5,8,12,10,41,44,-3,36
Sonderjyske,5343,6,8,6,10,28,29,-1,30
AC Horsens,5343,7,6,12,12,34,58,-24,30
Randers FC,5343,8,6,6,12,24,39,-15,24
Silkeborg IF,5343,9,6,3,13,28,45,-17,21
Lyngby,5343,10,3,9,12,26,45,-19,18
AGF Aarhus,5343,11,4,6,12,17,39,-22,18
Brondby,5344,1,21,7,2,71,32,39,70
FC Midtjylla,5344,2,21,4,5,68,37,31,67
FC Nords,5344,3,13,7,10,72,54,18,46
Copenhagen,5344,4,13,5,12,56,50,6,44
AaB,5344,5,7,13,10,38,41,-3,34
AC Horsens,5344,6,7,12,11,34,51,-17,33
Sonderjyske,5344,7,8,6,10,28,29,-1,30
Randers FC,5344,8,6,6,12,25,40,-15,24
Silkeborg IF,5344,9,6,3,13,31,45,-14,21
Lyngby,5344,10,3,9,12,27,46,-19,18
AGF Aarhus,5344,11,4,6,12,17,42,-25,18
Brondby,5345,1,22,6,2,78,30,48,72
FC Midtjylla,5345,2,19,6,5,72,45,27,63
FC Nords,5345,3,14,7,9,77,58,19,49
Copenhagen,5345,4,14,6,10,59,43,16,48
AaB,5345,5,6,13,11,37,45,-8,31
Sonderjyske,5345,6,8,6,10,28,29,-1,30
AC Horsens,5345,7,6,12,12,34,62,-28,30
Randers FC,5345,8,5,7,12,24,40,-16,22
Silkeborg IF,5345,9,6,3,13,27,45,-18,21
Lyngby,5345,10,3,10,11,27,45,-18,19
AGF Aarhus,5345,11,4,6,12,17,38,-21,18
Brondby,5346,1,20,6,4,68,29,39,66
FC Midtjylla,5346,2,19,4,7,65,40,25,61
Copenhagen,5346,3,16,5,9,60,40,20,53
FC Nords,5346,4,14,7,9,69,50,19,49
AaB,5346,5,7,12,11,36,45,-9,33
AC Horsens,5346,6,6,14,10,31,51,-20,32
Sonderjyske,5346,7,8,6,10,28,29,-1,30
Lyngby,5346,8,4,9,11,28,44,-16,21
AGF Aarhus,5346,9,5,6,11,20,37,-17,21
Randers FC,5346,10,5,6,13,23,41,-18,21
Silkeborg IF,5346,11,5,3,14,26,48,-22,18
Brondby,5347,1,21,7,2,75,33,42,70
FC Midtjylla,5347,2,20,5,5,67,39,28,65
Copenhagen,5347,3,16,4,10,62,44,18,52
FC Nords,5347,4,12,7,11,70,58,12,43
AaB,5347,5,8,11,11,34,40,-6,35
Sonderjyske,5347,6,8,6,10,28,29,-1,30
AC Horsens,5347,7,5,14,11,34,54,-20,29
Lyngby,5347,8,4,9,11,30,44,-14,21
Randers FC,5347,9,5,6,13,23,43,-20,21
Silkeborg IF,5347,10,5,4,13,25,44,-19,19
AGF Aarhus,5347,11,4,7,11,16,36,-20,19
Brondby,5348,1,19,7,4,70,34,36,64
FC Midtjylla,5348,2,18,4,8,62,42,20,58
FC Nords,5348,3,16,7,7,78,51,27,55
Copenhagen,5348,4,13,6,11,53,41,12,45
AC Horsens,5348,5,8,13,9,36,49,-13,37
AaB,5348,6,7,13,10,33,41,-8,34
Sonderjyske,5348,7,8,6,10,28,29,-1,30
Randers FC,5348,8,6,6,12,24,39,-15,24
Silkeborg IF,5348,9,6,3,13,27,44,-17,21
Lyngby,5348,10,3,9,12,26,45,-19,18
AGF Aarhus,5348,11,4,6,12,16,38,-22,18
Brondby,5349,1,21,6,3,69,33,36,69
FC Midtjylla,5349,2,19,5,6,62,39,23,62
FC Nords,5349,3,14,8,8,73,49,24,50
Copenhagen,5349,4,15,5,10,61,42,19,50
AC Horsens,5349,5,7,13,10,36,52,-16,34
Sonderjyske,5349,6,8,6,10,28,29,-1,30
AaB,5349,7,6,11,13,36,48,-12,29
Randers FC,5349,8,6,6,12,25,40,-15,24
AGF Aarhus,5349,9,5,6,11,19,38,-19,21
Lyngby,5349,10,3,9,12,27,46,-19,18
Silkeborg IF,5349,11,5,3,14,27,47,-20,18
FC Midtjylla,5350,1,21,4,5,65,36,29,67
Brondby,5350,2,20,6,4,65,30,35,66
FC Nords,5350,3,15,7,8,74,51,23,52
Copenhagen,5350,4,14,4,12,55,44,11,46
AaB,5350,5,8,11,11,37,43,-6,35
Sonderjyske,5350,6,8,6,10,28,29,-1,30
AC Horsens,5350,7,6,12,12,35,53,-18,30
Randers FC,5350,8,6,6,12,25,39,-14,24
Silkeborg IF,5350,9,6,3,13,27,44,-17,21
Lyngby,5350,10,3,9,12,26,46,-20,18
AGF Aarhus,5350,11,4,6,12,16,38,-22,18
Brondby,5351,1,19,7,4,69,34,35,64
FC Midtjylla,5351,2,18,6,6,61,39,22,60
FC Nords,5351,3,16,7,7,79,47,32,55
Copenhagen,5351,4,13,6,11,55,45,10,45
AaB,5351,5,7,13,10,36,42,-6,34
AC Horsens,5351,6,6,15,9,31,50,-19,33
Sonderjyske,5351,7,8,6,10,28,29,-1,30
Randers FC,5351,8,5,7,12,23,39,-16,22
AGF Aarhus,5351,9,5,6,11,19,36,-17,21
Lyngby,5351,10,3,10,11,26,44,-18,19
Silkeborg IF,5351,11,5,3,14,25,47,-22,18
Brondby,5352,1,21,6,3,70,31,39,69
FC Midtjylla,5352,2,18,4,8,63,47,16,58
FC Nords,5352,3,14,7,9,76,55,21,49
Copenhagen,5352,4,14,6,10,58,43,15,48
AaB,5352,5,8,14,8,41,41,0,38
Sonderjyske,5352,6,8,6,10,28,29,-1,30
AC Horsens,5352,7,5,15,10,36,53,-17,30
Randers FC,5352,8,5,7,12,24,40,-16,22
Lyngby,5352,9,3,10,11,27,45,-18,19
Silkeborg IF,5352,10,5,4,13,26,45,-19,19
AGF Aarhus,5352,11,4,7,11,17,37,-20,19
Brondby,5353,1,20,8,2,69,27,42,68
FC Midtjylla,5353,2,20,5,5,66,40,26,65
FC Nords,5353,3,14,6,10,70,52,18,48
Copenhagen,5353,4,12,5,13,52,48,4,41
AaB,5353,5,9,12,9,37,39,-2,39
AC Horsens,5353,6,6,14,10,36,50,-14,32
Sonderjyske,5353,7,8,6,10,28,29,-1,30
Randers FC,5353,8,5,7,12,26,42,-16,22
AGF Aarhus,5353,9,5,6,11,19,36,-17,21
Lyngby,5353,10,3,10,11,29,47,-18,19
Silkeborg IF,5353,11,5,3,14,25,47,-22,18
Brondby,5354,1,19,7,4,66,35,31,64
FC Midtjylla,5354,2,18,7,5,65,40,25,61
FC Nords,5354,3,15,8,7,75,49,26,53
Copenhagen,5354,4,13,6,11,56,42,14,45
AC Horsens,5354,5,8,13,9,37,48,-11,37
AaB,5354,6,7,11,12,35,46,-11,32
Sonderjyske,5354,7,8,6,10,28,29,-1,30
Silkeborg IF,5354,8,6,3,13,28,44,-16,21
Lyngby,5354,9,4,9,11,28,45,-17,21
Randers FC,5354,10,5,6,13,24,41,-17,21
AGF Aarhus,5354,11,4,6,12,16,39,-23,18
Brondby,5355,1,20,6,4,74,38,36,66
FC Midtjylla,5355,2,19,5,6,66,46,20,62
FC Nords,5355,3,15,6,9,77,51,26,51
Copenhagen,5355,4,15,4,11,64,46,18,49
AaB,5355,5,8,11,11,36,41,-5,35
AC Horsens,5355,6,7,12,11,34,55,-21,33
Sonderjyske,5355,7,8,6,10,28,29,-1,30
Randers FC,5355,8,6,6,12,24,39,-15,24
Silkeborg IF,5355,9,6,3,13,26,44,-18,21
Lyngby,5355,10,3,9,12,26,45,-19,18
AGF Aarhus,5355,11,4,6,12,16,37,-21,18
Brondby,5356,1,21,6,3,71,32,39,69
FC Midtjylla,5356,2,20,6,4,66,36,30,66
FC Nords,5356,3,13,8,9,73,54,19,47
Copenhagen,5356,4,13,4,13,54,47,7,43
AC Horsens,5356,5,8,13,9,38,52,-14,37
AaB,5356,6,6,13,11,34,41,-7,31
Sonderjyske,5356,7,8,6,10,28,29,-1,30
Lyngby,5356,8,4,9,11,30,46,-16,21
Silkeborg IF,5356,9,6,3,13,27,44,-17,21
Randers FC,5356,10,5,6,13,25,43,-18,21
AGF Aarhus,5356,11,4,6,12,16,38,-22,18
Brondby,5357,1,20,5,5,67,32,35,65
FC Midtjylla,5357,2,20,4,6,73,41,32,64
FC Nords,5357,3,16,6,8,71,50,21,54
Copenhagen,5357,4,15,4,11,56,41,15,49
AC Horsens,5357,5,7,12,11,36,55,-19,33
AaB,5357,6,7,11,12,34,44,-10,32
Sonderjyske,5357,7,8,6,10,28,29,-1,30
Randers FC,5357,8,6,6,12,25,40,-15,24
Silkeborg IF,5357,9,6,3,13,27,45,-18,21
Lyngby,5357,10,3,9,12,27,46,-19,18
AGF Aarhus,5357,11,4,6,12,17,38,-21,18
Brondby,5358,1,20,6,4,68,33,35,66
FC Midtjylla,5358,2,18,5,7,64,41,23,59
Copenhagen,5358,3,17,4,9,63,42,21,55
FC Nords,5358,4,16,6,8,79,54,25,54
AaB,5358,5,7,11,12,34,45,-11,32
Sonderjyske,5358,6,8,6,10,28,29,-1,30
AC Horsens,5358,7,5,14,11,39,58,-19,29
Silkeborg IF,5358,8,6,3,13,30,44,-14,21
Lyngby,5358,9,4,9,11,28,45,-17,21
Randers FC,5358,10,5,6,13,24,41,-17,21
AGF Aarhus,5358,11,4,6,12,16,41,-25,18
Brondby,5359,1,21,7,2,74,34,40,70
FC Midtjylla,5359,2,20,4,6,67,38,29,64
FC Nords,5359,3,14,6,10,74,55,19,48
Copenhagen,5359,4,14,4,12,56,48,8,46
AC Horsens,5359,5,7,13,10,36,54,-18,34
AaB,5359,6,7,12,11,39,43,-4,33
Sonderjyske,5359,7,8,6,10,28,29,-1,30
Lyngby,5359,8,4,9,11,28,45,-17,21
Randers FC,5359,9,5,6,13,24,41,-17,21
Silkeborg IF,5359,10,5,4,13,26,45,-19,19
AGF Aarhus,5359,11,4,7,11,17,37,-20,19
Brondby,5360,1,22,6,2,79,32,47,72
FC Midtjylla,5360,2,19,4,7,62,40,22,61
FC Nords,5360,3,13,8,9,74,52,22,47
Copenhagen,5360,4,13,5,12,57,50,7,44
AC Horsens,5360,5,8,12,10,39,57,-18,36
AaB,5360,6,8,11,11,40,46,-6,35
Sonderjyske,5360,7,8,6,10,28,29,-1,30
Lyngby,5360,8,4,9,11,30,44,-14,21
AGF Aarhus,5360,9,5,6,11,17,36,-19,21
Randers FC,5360,10,5,6,13,23,43,-20,21
Silkeborg IF,5360,11,5,3,14,25,45,-20,18
Brondby,5361,1,21,5,4,70,32,38,68
FC Midtjylla,5361,2,20,4,6,67,40,27,64
FC Nords,5361,3,14,7,9,74,53,21,49
Copenhagen,5361,4,14,5,11,62,48,14,47
AC Horsens,5361,5,7,13,10,36,55,-19,34
AaB,5361,6,7,12,11,38,45,-7,33
Sonderjyske,5361,7,8,6,10,28,29,-1,30
Randers FC,5361,8,5,7,12,24,40,-16,22
Lyngby,5361,9,3,10,11,27,45,-18,19
Silkeborg IF,5361,10,5,4,13,26,45,-19,19
AGF Aarhus,5361,11,4,7,11,17,37,-20,19
Brondby,5362,1,22,5,3,69,30,39,71
FC Midtjylla,5362,2,19,5,6,66,38,28,62
FC Nords,5362,3,13,7,10,74,54,20,46
Copenhagen,5362,4,13,4,13,56,50,6,43
AaB,5362,5,9,11,10,40,46,-6,38
AC Horsens,5362,6,8,12,10,39,52,-13,36
Sonderjyske,5362,7,8,6,10,28,29,-1,30
Lyngby,5362,8,4,9,11,28,45,-17,21
Randers FC,5362,9,5,6,13,24,41,-17,21
AGF Aarhus,5362,10,5,6,11,18,36,-18,21
Silkeborg IF,5362,11,5,3,14,25,46,-21,18
Brondby,5363,1,21,5,4,68,32,36,68
FC Midtjylla,5363,2,20,4,6,67,37,30,64
FC Nords,5363,3,15,6,9,75,48,27,51
Copenhagen,5363,4,15,4,11,55,43,12,49
AaB,5363,5,7,12,11,36,45,-9,33
AC Horsens,5363,6,6,13,11,32,54,-22,31
Sonderjyske,5363,7,8,6,10,28,29,-1,30
Randers FC,5363,8,6,6,12,25,39,-14,24
Silkeborg IF,5363,9,6,3,13,30,45,-15,21
Lyngby,5363,10,3,9,12,26,46,-20,18
AGF Aarhus,5363,11,4,6,12,17,41,-24,18
FC Midtjylla,5364,1,20,6,4,68,39,29,66
Brondby,5364,2,19,8,3,67,32,35,65
FC Nords,5364,3,13,8,9,71,52,19,47
Copenhagen,5364,4,13,7,10,59,46,13,46
AC Horsens,5364,5,6,15,9,35,51,-16,33
AaB,5364,6,6,14,10,36,42,-6,32
Sonderjyske,5364,7,8,6,10,28,29,-1,30
Lyngby,5364,8,4,9,11,29,45,-16,21
Randers FC,5364,9,5,6,13,24,42,-18,21
AGF Aarhus,5364,10,5,6,11,18,36,-18,21
Silkeborg IF,5364,11,5,3,14,25,46,-21,18
FC Midtjylla,5365,1,21,4,5,64,37,27,67
Brondby,5365,2,20,6,4,71,37,34,66
Copenhagen,5365,3,15,5,10,60,42,18,50
FC Nords,5365,4,13,8,9,71,52,19,47
AaB,5365,5,7,12,11,36,42,-6,33
AC Horsens,5365,6,6,13,11,34,52,-18,31
Sonderjyske,5365,7,8,6,10,28,29,-1,30
Randers FC,5365,8,6,6,12,26,39,-13,24
Silkeborg IF,5365,9,6,3,13,28,44,-16,21
Lyngby,5365,10,3,9,12,26,47,-21,18
AGF Aarhus,5365,11,4,6,12,16,39,-23,18
Brondby,5366,1,19,7,4,69,33,36,64
FC Midtjylla,5366,2,18,6,6,65,45,20,60
FC Nords,5366,3,14,8,8,70,47,23,50
Copenhagen,5366,4,13,7,10,56,41,15,46
AaB,5366,5,9,12,9,39,41,-2,39
AC Horsens,5366,6,6,14,10,33,51,-18,32
Sonderjyske,5366,7,8,6,10,28,29,-1,30
Randers FC,5366,8,5,7,12,24,40,-16,22
Silkeborg IF,5366,9,6,3,13,26,44,-18,21
Lyngby,5366,10,3,10,11,27,45,-18,19
AGF Aarhus,5366,11,4,6,12,16,37,-21,18
Brondby,5367,1,22,6,2,75,30,45,72
FC Midtjylla,5367,2,19,5,6,66,42,24,62
FC Nords,5367,3,15,6,9,77,54,23,51
Copenhagen,5367,4,12,4,14,54,49,5,40
AaB,5367,5,8,13,9,38,42,-4,37
AC Horsens,5367,6,7,12,11,37,56,-19,33
Sonderjyske,5367,7,8,6,10,28,29,-1,30
Randers FC,5367,8,5,7,12,24,40,-16,22
Lyngby,5367,9,3,10,11,27,45,-18,19
Silkeborg IF,5367,10,5,4,13,27,46,-19,19
AGF Aarhus,5367,11,4,7,11,18,38,-20,19
Brondby,5368,1,19,8,3,72,35,37,65
FC Midtjylla,5368,2,19,6,5,65,41,24,63
FC Nords,5368,3,15,7,8,73,46,27,52
Copenhagen,5368,4,13,6,11,55,45,10,45
AaB,5368,5,7,14,9,38,42,-4,35
Sonderjyske,5368,6,8,6,10,28,29,-1,30
AC Horsens,5368,7,5,15,10,32,52,-20,30
Randers FC,5368,8,6,6,12,27,41,-14,24
Silkeborg IF,5368,9,6,3,13,27,45,-18,21
Lyngby,5368,10,3,9,12,28,48,-20,18
AGF Aarhus,5368,11,4,6,12,17,38,-21,18
FC Midtjylla,5369,1,20,5,5,68,39,29,65
Brondby,5369,2,19,6,5,69,38,31,63
FC Nords,5369,3,15,6,9,76,49,27,51
Copenhagen,5369,4,13,6,11,59,50,9,45
AaB,5369,5,8,12,10,38,43,-5,36
AC Horsens,5369,6,7,13,10,36,53,-17,34
Sonderjyske,5369,7,8,6,10,28,29,-1,30
Randers FC,5369,8,6,6,12,25,40,-15,24
AGF Aarhus,5369,9,5,6,11,22,37,-15,21
Lyngby,5369,10,3,9,12,27,46,-19,18
Silkeborg IF,5369,11,5,3,14,26,50,-24,18
Brondby,5370,1,22,5,3,73,33,40,71
FC Midtjylla,5370,2,20,4,6,63,38,25,64
Copenhagen,5370,3,15,5,10,64,43,21,50
FC Nords,5370,4,14,7,9,73,53,20,49
AaB,5370,5,7,11,12,35,44,-9,32
Sonderjyske,5370,6,8,6,10,28,29,-1,30
AC Horsens,5370,7,6,12,12,34,57,-23,30
Randers FC,5370,8,5,7,12,24,40,-16,22
AGF Aarhus,5370,9,5,6,11,17,36,-19,21
Lyngby,5370,10,3,10,11,27,45,-18,19
Silkeborg IF,5370,11,5,3,14,25,45,-20,18
Brondby,5371,1,22,5,3,72,32,40,71
FC Midtjylla,5371,2,19,5,6,69,40,29,62
FC Nords,5371,3,14,7,9,75,55,20,49
Copenhagen,5371,4,13,6,11,58,47,11,45
AaB,5371,5,8,11,11,39,47,-8,35
AC Horsens,5371,6,6,14,10,34,52,-18,32
Sonderjyske,5371,7,8,6,10,28,29,-1,30
Randers FC,5371,8,6,6,12,24,39,-15,24
Silkeborg IF,5371,9,6,3,13,27,45,-18,21
Lyngby,5371,10,3,9,12,26,45,-19,18
AGF Aarhus,5371,11,4,6,12,17,38,-21,18
Brondby,5372,1,20,6,4,72,34,38,66
FC Midtjylla,5372,2,20,4,6,66,39,27,64
FC Nords,5372,3,14,7,9,71,50,21,49
Copenhagen,5372,4,14,6,10,61,46,15,48
AC Horsens,5372,5,7,13,10,37,53,-16,34
AaB,5372,6,7,12,11,36,47,-11,33
Sonderjyske,5372,7,8,6,10,28,29,-1,30
Lyngby,5372,8,4,9,11,29,44,-15,21
AGF Aarhus,5372,9,5,6,11,18,36,-18,21
Randers FC,5372,10,5,6,13,23,42,-19,21
Silkeborg IF,5372,11,5,3,14,25,46,-21,18
FC Midtjylla,5373,1,21,4,5,73,37,36,67
Brondby,5373,2,20,6,4,68,35,33,66
FC Nords,5373,3,14,7,9,73,52,21,49
Copenhagen,5373,4,15,4,11,58,44,14,49
AaB,5373,5,7,13,10,33,40,-7,34
Sonderjyske,5373,6,8,6,10,28,29,-1,30
AC Horsens,5373,7,6,12,12,33,56,-23,30
Lyngby,5373,8,4,9,11,29,45,-16,21
Randers FC,5373,9,5,6,13,24,42,-18,21
Silkeborg IF,5373,10,5,4,13,27,46,-19,19
AGF Aarhus,5373,11,4,7,11,18,38,-20,19
Brondby,5374,1,21,6,3,74,35,39,69
FC Midtjylla,5374,2,19,5,6,64,39,25,62
FC Nords,5374,3,16,6,8,76,50,26,54
Copenhagen,5374,4,15,6,9,60,42,18,51
Sonderjyske,5374,5,8,6,10,28,29,-1,30
AaB,5374,6,6,12,12,34,45,-11,30
AC Horsens,5374,7,5,13,12,34,57,-23,28
Lyngby,5374,8,4,9,11,30,47,-17,21
Randers FC,5374,9,5,6,13,26,43,-17,21
AGF Aarhus,5374,10,5,6,11,20,37,-17,21
Silkeborg IF,5374,11,5,3,14,26,48,-22,18
Brondby,5375,1,23,5,2,79,32,47,74
FC Midtjylla,5375,2,20,5,5,67,39,28,65
FC Nords,5375,3,14,6,10,74,59,15,48
Copenhagen,5375,4,12,4,14,54,49,5,40
AaB,5375,5,9,11,10,45,48,-3,38
AC Horsens,5375,6,6,13,11,36,54,-18,31
Sonderjyske,5375,7,8,6,10,28,29,-1,30
Lyngby,5375,8,4,9,11,30,44,-14,21
AGF Aarhus,5375,9,5,6,11,19,36,-17,21
Randers FC,5375,10,5,6,13,23,43,-20,21
Silkeborg IF,5375,11,5,3,14,25,47,-22,18
Brondby,5376,1,19,8,3,71,34,37,65
FC Midtjylla,5376,2,17,8,5,61,39,22,59
FC Nords,5376,3,15,8,7,75,47,28,53
Copenhagen,5376,4,13,7,10,56,43,13,46
AC Horsens,5376,5,7,14,9,38,51,-13,35
AaB,5376,6,6,13,11,33,46,-13,31
Sonderjyske,5376,7,8,6,10,28,29,-1,30
Lyngby,5376,8,4,9,11,27,44,-17,21
Randers FC,5376,9,5,6,13,23,40,-17,21
Silkeborg IF,5376,10,6,3,13,26,44,-18,21
AGF Aarhus,5376,11,4,6,12,16,37,-21,18
Brondby,5377,1,21,5,4,71,34,37,68
FC Midtjylla,5377,2,19,4,7,63,41,22,61
Copenhagen,5377,3,15,6,9,60,42,18,51
FC Nords,5377,4,13,8,9,71,51,20,47
AaB,5377,5,8,12,10,36,42,-6,36
Sonderjyske,5377,6,8,6,10,28,29,-1,30
AC Horsens,5377,7,5,15,10,34,51,-17,30
Lyngby,5377,8,4,9,11,29,44,-15,21
Silkeborg IF,5377,9,6,3,13,28,44,-16,21
Randers FC,5377,10,5,6,13,23,42,-19,21
AGF Aarhus,5377,11,4,6,12,16,39,-23,18
Brondby,5378,1,20,6,4,70,32,38,66
FC Midtjylla,5378,2,19,6,5,61,37,24,63
FC Nords,5378,3,13,8,9,71,50,21,47
Copenhagen,5378,4,13,7,10,54,41,13,46
AaB,5378,5,8,14,8,40,41,-1,38
Sonderjyske,5378,6,8,6,10,28,29,-1,30
AC Horsens,5378,7,5,15,10,33,54,-21,30
Randers FC,5378,8,6,6,12,24,39,-15,24
AGF Aarhus,5378,9,5,6,11,17,36,-19,21
Lyngby,5378,10,3,9,12,26,45,-19,18
Silkeborg IF,5378,11,5,3,14,25,45,-20,18
Brondby,5379,1,21,5,4,73,35,38,68
FC Midtjylla,5379,2,20,4,6,70,41,29,64
FC Nords,5379,3,14,7,9,77,55,22,49
Copenhagen,5379,4,13,6,11,60,50,10,45
AaB,5379,5,7,14,9,41,49,-8,35
AC Horsens,5379,6,6,14,10,32,49,-17,32
Sonderjyske,5379,7,8,6,10,28,29,-1,30
Randers FC,5379,8,5,7,12,24,40,-16,22
Silkeborg IF,5379,9,6,3,13,28,45,-17,21
Lyngby,5379,10,3,10,11,27,45,-18,19
AGF Aarhus,5379,11,4,6,12,17,39,-22,18
Brondby,5380,1,20,6,4,68,29,39,66
FC Midtjylla,5380,2,19,4,7,64,43,21,61
Copenhagen,5380,3,16,4,10,58,43,15,52
FC Nords,5380,4,13,8,9,74,50,24,47
AC Horsens,5380,5,8,13,9,36,48,-12,37
AaB,5380,6,7,11,12,35,48,-13,32
Sonderjyske,5380,7,8,6,10,28,29,-1,30
Randers FC,5380,8,6,6,12,24,39,-15,24
AGF Aarhus,5380,9,5,6,11,17,36,-19,21
Lyngby,5380,10,3,9,12,26,45,-19,18
Silkeborg IF,5380,11,5,3,14,25,45,-20,18
Brondby,5381,1,21,6,3,74,33,41,69
FC Midtjylla,5381,2,21,4,5,65,37,28,67
FC Nords,5381,3,15,6,9,76,55,21,51
Copenhagen,5381,4,13,5,12,57,48,9,44
AaB,5381,5,7,13,10,36,40,-4,34
Sonderjyske,5381,6,8,6,10,28,29,-1,30
AC Horsens,5381,7,5,14,11,34,55,-21,29
Lyngby,5381,8,4,9,11,28,45,-17,21
Silkeborg IF,5381,9,6,3,13,27,44,-17,21
Randers FC,5381,10,5,6,13,24,41,-17,21
AGF Aarhus,5381,11,4,6,12,16,38,-22,18
Brondby,5382,1,22,6,2,79,32,47,72
FC Midtjylla,5382,2,18,6,6,63,40,23,60
Copenhagen,5382,3,14,5,11,56,44,12,47
FC Nords,5382,4,13,7,10,72,56,16,46
AaB,5382,5,9,11,10,36,43,-7,38
AC Horsens,5382,6,6,13,11,35,52,-17,31
Sonderjyske,5382,7,8,6,10,28,29,-1,30
Randers FC,5382,8,6,6,12,26,41,-15,24
Silkeborg IF,5382,9,6,3,13,26,44,-18,21
Lyngby,5382,10,3,9,12,28,47,-19,18
AGF Aarhus,5382,11,4,6,12,16,37,-21,18
Brondby,5383,1,23,5,2,76,31,45,74
FC Midtjylla,5383,2,19,6,5,66,41,25,63
FC Nords,5383,3,14,6,10,72,55,17,48
Copenhagen,5383,4,12,5,13,55,47,8,41
AaB,5383,5,8,13,9,40,42,-2,37
Sonderjyske,5383,6,8,6,10,28,29,-1,30
AC Horsens,5383,7,5,15,10,35,54,-19,30
Randers FC,5383,8,6,6,12,26,41,-15,24
Silkeborg IF,5383,9,5,4,13,25,44,-19,19
AGF Aarhus,5383,10,4,7,11,16,36,-20,19
Lyngby,5383,11,3,9,12,28,47,-19,18
Brondby,5384,1,21,6,3,77,32,45,69
FC Midtjylla,5384,2,21,4,5,67,39,28,67
FC Nords,5384,3,15,6,9,73,51,22,51
Copenhagen,5384,4,14,4,12,57,49,8,46
AC Horsens,5384,5,7,13,10,37,53,-16,34
Sonderjyske,5384,6,8,6,10,28,29,-1,30
AaB,5384,7,6,11,13,36,49,-13,29
Randers FC,5384,8,5,7,12,24,40,-16,22
AGF Aarhus,5384,9,5,6,11,17,36,-19,21
Lyngby,5384,10,3,10,11,27,45,-18,19
Silkeborg IF,5384,11,5,3,14,25,45,-20,18
Brondby,5385,1,20,7,3,70,33,37,67
FC Midtjylla,5385,2,20,5,5,64,35,29,65
FC Nords,5385,3,13,7,10,68,47,21,46
Copenhagen,5385,4,13,5,12,53,45,8,44
AaB,5385,5,9,11,10,38,44,-6,38
AC Horsens,5385,6,7,13,10,34,49,-15,34
Sonderjyske,5385,7,8,6,10,28,29,-1,30
Lyngby,5385,8,4,9,11,28,44,-16,21
Silkeborg IF,5385,9,6,3,13,28,45,-17,21
Randers FC,5385,10,5,6,13,23,41,-18,21
AGF Aarhus,5385,11,4,6,12,17,39,-22,18
Brondby,5386,1,20,6,4,68,31,37,66
FC Midtjylla,5386,2,20,6,4,65,38,27,66
FC Nords,5386,3,14,7,9,73,48,25,49
Copenhagen,5386,4,13,7,10,56,44,12,46
AaB,5386,5,6,14,10,36,44,-8,32
AC Horsens,5386,6,6,14,10,37,56,-19,32
Sonderjyske,5386,7,8,6,10,28,29,-1,30
Randers FC,5386,8,6,6,12,26,39,-13,24
Silkeborg IF,5386,9,6,3,13,27,44,-17,21
Lyngby,5386,10,3,9,12,26,47,-21,18
AGF Aarhus,5386,11,4,6,12,16,38,-22,18
Brondby,5387,1,19,6,5,67,36,31,63
FC Midtjylla,5387,2,18,5,7,62,41,21,59
FC Nords,5387,3,13,8,9,73,51,22,47
Copenhagen,5387,4,14,5,11,56,46,10,47
AaB,5387,5,10,12,8,42,41,1,42
AC Horsens,5387,6,7,14,9,38,49,-11,35
Sonderjyske,5387,7,8,6,10,28,29,-1,30
Randers FC,5387,8,5,7,12,23,39,-16,22
AGF Aarhus,5387,9,5,6,11,19,37,-18,21
Lyngby,5387,10,3,10,11,26,44,-18,19
Silkeborg IF,5387,11,5,3,14,26,47,-21,18
FC Midtjylla,5388,1,21,5,4,76,39,37,68
Brondby,5388,2,18,6,6,64,39,25,60
FC Nords,5388,3,14,7,9,78,53,25,49
Copenhagen,5388,4,13,5,12,59,48,11,44
AaB,5388,5,10,11,9,37,40,-3,41
AC Horsens,5388,6,7,12,11,33,54,-21,33
Sonderjyske,5388,7,8,6,10,28,29,-1,30
Lyngby,5388,8,4,9,11,28,45,-17,21
Randers FC,5388,9,5,6,13,24,41,-17,21
AGF Aarhus,5388,10,5,6,11,17,36,-19,21
Silkeborg IF,5388,11,5,3,14,25,45,-20,18
Brondby,5389,1,21,6,3,70,31,39,69
FC Midtjylla,5389,2,20,5,5,66,36,30,65
FC Nords,5389,3,14,7,9,72,50,22,49
Copenhagen,5389,4,12,6,12,53,48,5,42
AaB,5389,5,7,13,10,34,41,-7,34
AC Horsens,5389,6,7,13,10,34,49,-15,34
Sonderjyske,5389,7,8,6,10,28,29,-1,30
Randers FC,5389,8,5,7,12,26,42,-16,22
Silkeborg IF,5389,9,6,3,13,29,45,-16,21
Lyngby,5389,10,3,10,11,29,47,-18,19
AGF Aarhus,5389,11,4,6,12,17,40,-23,18
Brondby,5390,1,21,6,3,68,33,35,69
FC Midtjylla,5390,2,19,5,6,64,43,21,62
FC Nords,5390,3,14,7,9,73,49,24,49
Copenhagen,5390,4,12,6,12,53,46,7,42
AC Horsens,5390,5,9,12,9,41,47,-6,39
AaB,5390,6,7,12,11,37,44,-7,33
Sonderjyske,5390,7,8,6,10,28,29,-1,30
Randers FC,5390,8,6,6,12,25,40,-15,24
Silkeborg IF,5390,9,6,3,13,27,44,-17,21
Lyngby,5390,10,3,9,12,27,46,-19,18
AGF Aarhus,5390,11,4,6,12,16,38,-22,18
Brondby,5391,1,21,6,3,72,30,42,69
FC Midtjylla,5391,2,18,6,6,63,44,19,60
Copenhagen,5391,3,15,6,9,58,41,17,51
FC Nords,5391,4,13,7,10,68,49,19,46
AaB,5391,5,9,11,10,37,41,-4,38
Sonderjyske,5391,6,8,6,10,28,29,-1,30
AC Horsens,5391,7,5,14,11,30,49,-19,29
Lyngby,5391,8,4,9,11,30,44,-14,21
Randers FC,5391,9,5,6,13,23,43,-20,21
Silkeborg IF,5391,10,5,4,13,27,46,-19,19
AGF Aarhus,5391,11,4,7,11,18,38,-20,19
Brondby,5392,1,22,6,2,78,34,44,72
FC Midtjylla,5392,2,20,4,6,69,41,28,64
Copenhagen,5392,3,16,5,9,67,43,24,53
FC Nords,5392,4,13,6,11,71,57,14,45
AC Horsens,5392,5,6,13,11,36,55,-19,31
Sonderjyske,5392,6,8,6,10,28,29,-1,30
AaB,5392,7,6,12,12,34,51,-17,30
Lyngby,5392,8,4,9,11,29,45,-16,21
Randers FC,5392,9,5,6,13,24,42,-18,21
Silkeborg IF,5392,10,5,4,13,25,44,-19,19
AGF Aarhus,5392,11,4,7,11,16,36,-20,19
Brondby,5393,1,20,8,2,74,36,38,68
FC Midtjylla,5393,2,18,6,6,63,40,23,60
FC Nords,5393,3,15,8,7,74,48,26,53
Copenhagen,5393,4,13,5,12,55,44,11,44
AaB,5393,5,7,13,10,34,41,-7,34
AC Horsens,5393,6,7,12,11,37,54,-17,33
Sonderjyske,5393,7,8,6,10,28,29,-1,30
Randers FC,5393,8,6,6,12,25,39,-14,24
Silkeborg IF,5393,9,6,3,13,26,44,-18,21
Lyngby,5393,10,3,9,12,26,46,-20,18
AGF Aarhus,5393,11,4,6,12,16,37,-21,18
Brondby,5394,1,19,6,5,70,38,32,63
FC Midtjylla,5394,2,18,7,5,67,40,27,61
FC Nords,5394,3,15,8,7,76,50,26,53
Copenhagen,5394,4,15,5,10,61,44,17,50
AaB,5394,5,9,11,10,38,41,-3,38
Sonderjyske,5394,6,8,6,10,28,29,-1,30
AC Horsens,5394,7,5,13,12,34,59,-25,28
Lyngby,5394,8,4,9,11,29,45,-16,21
AGF Aarhus,5394,9,5,6,11,19,36,-17,21
Randers FC,5394,10,5,6,13,24,42,-18,21
Silkeborg IF,5394,11,5,3,14,25,47,-22,18
Brondby,5395,1,21,5,4,69,33,36,68
FC Midtjylla,5395,2,18,6,6,64,40,24,60
FC Nords,5395,3,15,8,7,74,48,26,53
Copenhagen,5395,4,13,4,13,59,50,9,43
AaB,5395,5,9,12,9,38,40,-2,39
AC Horsens,5395,6,6,13,11,37,56,-19,31
Sonderjyske,5395,7,8,6,10,28,29,-1,30
Lyngby,5395,8,4,9,11,28,45,-17,21
Randers FC,5395,9,5,6,13,24,41,-17,21
Silkeborg IF,5395,10,5,4,13,26,45,-19,19
AGF Aarhus,5395,11,4,7,11,17,37,-20,19
Brondby,5396,1,19,6,5,70,36,34,63
FC Midtjylla,5396,2,19,6,5,65,37,28,63
Copenhagen,5396,3,15,5,10,57,41,16,50
FC Nords,5396,4,12,7,11,68,55,13,43
AC Horsens,5396,5,9,12,9,38,49,-11,39
AaB,5396,6,8,12,10,34,40,-6,36
Sonderjyske,5396,7,8,6,10,28,29,-1,30
Lyngby,5396,8,4,9,11,29,44,-15,21
Silkeborg IF,5396,9,6,3,13,27,45,-18,21
Randers FC,5396,10,5,6,13,23,42,-19,21
AGF Aarhus,5396,11,4,6,12,17,38,-21,18
Brondby,5397,1,20,6,4,70,34,36,66
FC Midtjylla,5397,2,18,5,7,65,42,23,59
FC Nords,5397,3,16,6,8,82,56,26,54
Copenhagen,5397,4,14,6,10,63,46,17,48
AaB,5397,5,8,12,10,41,47,-6,36
AC Horsens,5397,6,6,13,11,34,56,-22,31
Sonderjyske,5397,7,8,6,10,28,29,-1,30
Lyngby,5397,8,4,9,11,30,46,-16,21
Randers FC,5397,9,5,6,13,25,43,-18,21
Silkeborg IF,5397,10,5,4,13,26,45,-19,19
AGF Aarhus,5397,11,4,7,11,17,37,-20,19
Brondby,5398,1,20,5,5,74,39,35,65
FC Midtjylla,5398,2,18,7,5,63,40,23,61
Copenhagen,5398,3,16,4,10,60,44,16,52
FC Nords,5398,4,14,8,8,75,52,23,50
AaB,5398,5,7,13,10,39,43,-4,34
AC Horsens,5398,6,6,13,11,40,59,-19,31
Sonderjyske,5398,7,8,6,10,28,29,-1,30
Randers FC,5398,8,6,6,12,25,40,-15,24
Silkeborg IF,5398,9,6,3,13,28,44,-16,21
Lyngby,5398,10,3,9,12,27,46,-19,18
AGF Aarhus,5398,11,4,6,12,16,39,-23,18
Brondby,5399,1,21,7,2,74,32,42,70
FC Midtjylla,5399,2,18,7,5,61,37,24,61
FC Nords,5399,3,14,6,10,73,54,19,48
Copenhagen,5399,4,13,7,10,57,44,13,46
AC Horsens,5399,5,7,14,9,40,50,-10,35
AaB,5399,6,6,13,11,34,48,-14,31
Sonderjyske,5399,7,8,6,10,28,29,-1,30
Lyngby,5399,8,4,9,11,29,46,-17,21
Randers FC,5399,9,5,6,13,25,42,-17,21
AGF Aarhus,5399,10,5,6,11,17,36,-19,21
Silkeborg IF,5399,11,5,3,14,25,45,-20,18
Brondby,5400,1,20,5,5,69,32,37,65
FC Midtjylla,5400,2,20,5,5,70,41,29,65
FC Nords,5400,3,14,7,9,72,53,19,49
Copenhagen,5400,4,15,4,11,55,41,14,49
AC Horsens,5400,5,7,14,9,36,50,-14,35
AaB,5400,6,7,11,12,36,47,-11,32
Sonderjyske,5400,7,8,6,10,28,29,-1,30
Lyngby,5400,8,4,9,11,28,45,-17,21
Randers FC,5400,9,5,6,13,24,41,-17,21
AGF Aarhus,5400,10,5,6,11,17,36,-19,21
Silkeborg IF,5400,11,5,3,14,25,45,-20,18
Brondby,5401,1,21,6,3,72,32,40,69
FC Midtjylla,5401,2,19,5,6,64,37,27,62
FC Nords,5401,3,13,9,8,74,50,24,48
Copenhagen,5401,4,14,5,11,54,44,10,47
AaB,5401,5,9,11,10,38,40,-2,38
Sonderjyske,5401,6,8,6,10,28,29,-1,30
AC Horsens,5401,7,6,12,12,32,57,-25,30
Lyngby,5401,8,4,9,11,28,44,-16,21
Randers FC,5401,9,5,6,13,23,41,-18,21
Silkeborg IF,5401,10,5,4,13,27,46,-19,19
AGF Aarhus,5401,11,4,7,11,18,38,-20,19
Brondby,5402,1,21,5,4,72,32,40,68
FC Midtjylla,5402,2,20,4,6,68,44,24,64
FC Nords,5402,3,16,6,8,81,53,28,54
Copenhagen,5402,4,15,4,11,60,44,16,49
AC Horsens,5402,5,7,12,11,34,50,-16,33
Sonderjyske,5402,6,8,6,10,28,29,-1,30
AaB,5402,7,6,11,13,35,53,-18,29
Lyngby,5402,8,4,9,11,28,45,-17,21
Silkeborg IF,5402,8,6,3,13,28,45,-17,21
Randers FC,5402,10,5,6,13,24,41,-17,21
AGF Aarhus,5402,11,4,6,12,17,39,-22,18
Brondby,5403,1,20,5,5,75,38,37,65
FC Midtjylla,5403,2,19,5,6,66,44,22,62
FC Nords,5403,3,16,6,8,75,50,25,54
Copenhagen,5403,4,15,5,10,59,43,16,50
AC Horsens,5403,5,7,14,9,38,52,-14,35
Sonderjyske,5403,6,8,6,10,28,29,-1,30
AaB,5403,7,6,11,13,38,50,-12,29
Randers FC,5403,8,5,7,12,26,42,-16,22
Silkeborg IF,5403,9,6,3,13,29,44,-15,21
Lyngby,5403,10,3,10,11,29,47,-18,19
AGF Aarhus,5403,11,4,6,12,16,40,-24,18
Brondby,5404,1,20,7,3,71,31,40,67
FC Midtjylla,5404,2,19,6,5,65,40,25,63
FC Nords,5404,3,15,6,9,77,54,23,51
Copenhagen,5404,4,13,5,12,56,48,8,44
AC Horsens,5404,5,7,14,9,34,49,-15,35
AaB,5404,6,7,12,11,41,48,-7,33
Sonderjyske,5404,7,8,6,10,28,29,-1,30
Silkeborg IF,5404,8,6,3,13,28,44,-16,21
Lyngby,5404,9,4,9,11,27,44,-17,21
Randers FC,5404,10,5,6,13,23,40,-17,21
AGF Aarhus,5404,11,4,6,12,16,39,-23,18
Brondby,5405,1,21,5,4,72,32,40,68
FC Midtjylla,5405,2,19,5,6,61,40,21,62
FC Nords,5405,3,15,6,9,76,52,24,51
Copenhagen,5405,4,13,4,13,53,46,7,43
AaB,5405,5,8,13,9,38,40,-2,37
AC Horsens,5405,6,7,13,10,35,51,-16,34
Sonderjyske,5405,7,8,6,10,28,29,-1,30
Lyngby,5405,8,4,9,11,29,46,-17,21
Randers FC,5405,9,5,6,13,25,42,-17,21
AGF Aarhus,5405,10,5,6,11,18,36,-18,21
Silkeborg IF,5405,11,5,3,14,25,46,-21,18
Brondby,5406,1,20,6,4,70,33,37,66
FC Midtjylla,5406,2,19,6,5,64,36,28,63
FC Nords,5406,3,16,6,8,76,47,29,54
Copenhagen,5406,4,13,5,12,55,48,7,44
AC Horsens,5406,5,7,13,10,33,52,-19,34
AaB,5406,6,7,12,11,36,44,-8,33
Sonderjyske,5406,7,8,6,10,28,29,-1,30
Randers FC,5406,8,6,6,12,24,39,-15,24
Silkeborg IF,5406,9,5,4,13,26,45,-19,19
AGF Aarhus,5406,10,4,7,11,17,37,-20,19
Lyngby,5406,11,3,9,12,26,45,-19,18
Brondby,5407,1,20,7,3,71,32,39,67
FC Midtjylla,5407,2,20,6,4,66,38,28,66
Copenhagen,5407,3,14,6,10,61,47,14,48
FC Nords,5407,4,12,7,11,69,55,14,43
AaB,5407,5,8,12,10,37,42,-5,36
AC Horsens,5407,6,5,16,9,35,51,-16,31
Sonderjyske,5407,7,8,6,10,28,29,-1,30
Lyngby,5407,8,4,9,11,30,47,-17,21
Randers FC,5407,9,5,6,13,26,43,-17,21
Silkeborg IF,5407,10,5,4,13,25,44,-19,19
AGF Aarhus,5407,11,4,7,11,16,36,-20,19
Brondby,5408,1,22,6,2,72,29,43,72
FC Midtjylla,5408,2,18,5,7,61,39,22,59
Copenhagen,5408,3,15,5,10,56,43,13,50
FC Nords,5408,4,13,7,10,68,51,17,46
AaB,5408,5,9,11,10,38,39,-1,38
Sonderjyske,5408,6,8,6,10,28,29,-1,30
AC Horsens,5408,7,6,12,12,33,53,-20,30
Randers FC,5408,8,6,6,12,26,39,-13,24
Silkeborg IF,5408,9,5,4,13,27,46,-19,19
AGF Aarhus,5408,10,4,7,11,18,38,-20,19
Lyngby,5408,11,3,9,12,26,47,-21,18
Brondby,5409,1,20,6,4,69,32,37,66
FC Midtjylla,5409,2,20,4,6,64,39,25,64
FC Nords,5409,3,15,8,7,72,46,26,53
Copenhagen,5409,4,14,7,9,56,40,16,49
AaB,5409,5,7,12,11,35,43,-8,33
Sonderjyske,5409,6,8,6,10,28,29,-1,30
AC Horsens,5409,7,5,13,12,35,57,-22,28
Lyngby,5409,8,4,9,11,30,46,-16,21
Randers FC,5409,9,5,6,13,25,43,-18,21
Silkeborg IF,5409,10,5,4,13,26,45,-19,19
AGF Aarhus,5409,11,4,7,11,17,37,-20,19
Brondby,5410,1,20,5,5,71,37,34,65
FC Midtjylla,5410,2,19,5,6,69,41,28,62
FC Nords,5410,3,14,7,9,76,52,24,49
Copenhagen,5410,4,14,6,10,61,47,14,48
AaB,5410,5,8,12,10,39,47,-8,36
AC Horsens,5410,6,7,13,10,36,54,-18,34
Sonderjyske,5410,7,8,6,10,28,29,-1,30
Randers FC,5410,8,5,7,12,25,41,-16,22
Lyngby,5410,9,3,10,11,28,46,-18,19
Silkeborg IF,5410,10,5,4,13,26,45,-19,19
AGF Aarhus,5410,11,4,7,11,17,37,-20,19
Brondby,5411,1,22,5,3,75,31,44,71
FC Midtjylla,5411,2,20,4,6,68,40,28,64
FC Nords,5411,3,14,6,10,74,57,17,48
Copenhagen,5411,4,14,5,11,59,44,15,47
AaB,5411,5,7,12,11,35,45,-10,33
AC Horsens,5411,6,7,12,11,35,55,-20,33
Sonderjyske,5411,7,8,6,10,28,29,-1,30
Randers FC,5411,8,6,6,12,24,39,-15,24
AGF Aarhus,5411,9,5,6,11,18,37,-19,21
Lyngby,5411,10,3,9,12,26,45,-19,18
Silkeborg IF,5411,11,5,3,14,26,46,-20,18
Brondby,5412,1,21,5,4,69,31,38,68
FC Midtjylla,5412,2,21,4,5,66,37,29,67
FC Nords,5412,3,14,7,9,71,48,23,49
Copenhagen,5412,4,14,4,12,55,47,8,46
AaB,5412,5,7,12,11,36,45,-9,33
AC Horsens,5412,6,6,14,10,34,49,-15,32
Sonderjyske,5412,7,8,6,10,28,29,-1,30
Randers FC,5412,8,5,7,12,25,41,-16,22
Lyngby,5412,9,3,10,11,28,46,-18,19
Silkeborg IF,5412,10,5,4,13,27,46,-19,19
AGF Aarhus,5412,11,4,7,11,18,38,-20,19
Brondby,5413,1,21,5,4,70,32,38,68
FC Midtjylla,5413,2,19,4,7,64,42,22,61
FC Nords,5413,3,16,6,8,75,49,26,54
Copenhagen,5413,4,14,5,11,61,45,16,47
AaB,5413,5,8,11,11,36,45,-9,35
AC Horsens,5413,6,6,13,11,36,55,-19,31
Sonderjyske,5413,7,8,6,10,28,29,-1,30
Randers FC,5413,8,6,6,12,25,40,-15,24
Silkeborg IF,5413,9,6,3,13,26,44,-18,21
Lyngby,5413,10,3,9,12,27,46,-19,18
AGF Aarhus,5413,11,4,6,12,16,37,-21,18
Brondby,5414,1,20,7,3,74,37,37,67
FC Midtjylla,5414,2,20,5,5,66,38,28,65
FC Nords,5414,3,14,7,9,74,55,19,49
Copenhagen,5414,4,14,6,10,59,45,14,48
AaB,5414,5,7,13,10,42,44,-2,34
Sonderjyske,5414,6,8,6,10,28,29,-1,30
AC Horsens,5414,7,6,12,12,36,58,-22,30
Lyngby,5414,8,4,9,11,27,44,-17,21
Randers FC,5414,9,5,6,13,23,40,-17,21
Silkeborg IF,5414,10,5,4,13,25,44,-19,19
AGF Aarhus,5414,11,4,7,11,16,36,-20,19
Brondby,5415,1,20,5,5,67,30,37,65
FC Midtjylla,5415,2,19,6,5,64,39,25,63
FC Nords,5415,3,14,7,9,71,51,20,49
Copenhagen,5415,4,14,4,12,53,44,9,46
AaB,5415,5,9,11,10,37,40,-3,38
AC Horsens,5415,6,7,13,10,33,47,-14,34
Sonderjyske,5415,7,8,6,10,28,29,-1,30
Lyngby,5415,8,4,9,11,28,45,-17,21
Randers FC,5415,9,5,6,13,24,41,-17,21
AGF Aarhus,5415,10,5,6,11,18,36,-18,21
Silkeborg IF,5415,11,5,3,14,25,46,-21,18
Brondby,5416,1,20,6,4,72,34,38,66
FC Midtjylla,5416,2,20,6,4,68,40,28,66
Copenhagen,5416,3,14,7,9,60,44,16,49
FC Nords,5416,4,12,7,11,75,62,13,43
AaB,5416,5,8,12,10,39,45,-6,36
AC Horsens,5416,6,7,12,11,37,52,-15,33
Sonderjyske,5416,7,8,6,10,28,29,-1,30
Lyngby,5416,8,4,9,11,29,45,-16,21
Randers FC,5416,9,5,6,13,24,42,-18,21
AGF Aarhus,5416,10,5,6,11,18,37,-19,21
Silkeborg IF,5416,11,5,3,14,26,46,-20,18
Brondby,5417,1,21,6,3,75,32,43,69
FC Midtjylla,5417,2,17,8,5,61,38,23,59
FC Nords,5417,3,14,7,9,72,54,18,49
Copenhagen,5417,4,14,6,10,56,44,12,48
AaB,5417,5,8,12,10,37,42,-5,36
Sonderjyske,5417,6,8,6,10,28,29,-1,30
AC Horsens,5417,7,5,15,10,36,53,-17,30
Lyngby,5417,8,4,9,11,29,46,-17,21
Randers FC,5417,9,5,6,13,25,42,-17,21
AGF Aarhus,5417,10,5,6,11,18,37,-19,21
Silkeborg IF,5417,11,5,3,14,26,46,-20,18
Brondby,5418,1,19,8,3,66,36,30,65
FC Midtjylla,5418,2,19,6,5,61,36,25,63
FC Nords,5418,3,16,7,7,80,47,33,55
Copenhagen,5418,4,15,4,11,60,43,17,49
AaB,5418,5,7,11,12,36,47,-11,32
Sonderjyske,5418,6,8,6,10,28,29,-1,30
AC Horsens,5418,7,5,14,11,32,52,-20,29
Randers FC,5418,8,5,7,12,25,41,-16,22
Silkeborg IF,5418,9,6,3,13,27,44,-17,21
Lyngby,5418,10,3,10,11,28,46,-18,19
AGF Aarhus,5418,11,4,6,12,16,38,-22,18
FC Midtjylla,5419,1,21,4,5,66,38,28,67
Brondby,5419,2,20,6,4,72,34,38,66
FC Nords,5419,3,14,6,10,73,52,21,48
Copenhagen,5419,4,14,5,11,54,45,9,47
AaB,5419,5,7,13,10,40,44,-4,34
AC Horsens,5419,6,6,14,10,36,54,-18,32
Sonderjyske,5419,7,8,6,10,28,29,-1,30
Randers FC,5419,8,6,6,12,25,40,-15,24
Silkeborg IF,5419,9,5,4,13,25,44,-19,19
AGF Aarhus,5419,10,4,7,11,16,36,-20,19
Lyngby,5419,11,3,9,12,27,46,-19,18
Brondby,5420,1,21,5,4,70,33,37,68
FC Midtjylla,5420,2,18,6,6,61,42,19,60
FC Nords,5420,3,14,8,8,77,51,26,50
Copenhagen,5420,4,14,6,10,58,42,16,48
AaB,5420,5,7,14,9,37,42,-5,35
AC Horsens,5420,6,6,13,11,35,54,-19,31
Sonderjyske,5420,7,8,6,10,28,29,-1,30
Randers FC,5420,8,6,6,12,26,39,-13,24
Silkeborg IF,5420,9,6,3,13,28,46,-18,21
Lyngby,5420,10,3,9,12,26,47,-21,18
AGF Aarhus,5420,11,4,6,12,18,39,-21,18
Brondby,5421,1,22,5,3,74,30,44,71
FC Midtjylla,5421,2,20,4,6,68,43,25,64
FC Nords,5421,3,14,6,10,69,49,20,48
Copenhagen,5421,4,14,5,11,58,44,14,47
AaB,5421,5,7,12,11,34,44,-10,33
AC Horsens,5421,6,7,12,11,37,56,-19,33
Sonderjyske,5421,7,8,6,10,28,29,-1,30
Lyngby,5421,8,4,9,11,28,44,-16,21
Silkeborg IF,5421,9,6,3,13,28,46,-18,21
Randers FC,5421,10,5,6,13,23,41,-18,21
AGF Aarhus,5421,11,4,6,12,18,39,-21,18
Brondby,5422,1,20,6,4,74,38,36,66
FC Midtjylla,5422,2,20,4,6,63,38,25,64
FC Nords,5422,3,16,7,7,77,49,28,55
Copenhagen,5422,4,14,4,12,60,48,12,46
AC Horsens,5422,5,7,12,11,36,53,-17,33
AaB,5422,6,7,11,12,37,47,-10,32
Sonderjyske,5422,7,8,6,10,28,29,-1,30
Lyngby,5422,8,4,9,11,27,44,-17,21
Silkeborg IF,5422,8,6,3,13,27,44,-17,21
Randers FC,5422,10,5,6,13,23,40,-17,21
AGF Aarhus,5422,11,4,6,12,16,38,-22,18
Brondby,5423,1,21,6,3,69,29,40,69
FC Midtjylla,5423,2,17,5,8,61,42,19,56
FC Nords,5423,3,14,7,9,72,51,21,49
Copenhagen,5423,4,15,4,11,56,40,16,49
AaB,5423,5,9,12,9,38,42,-4,39
AC Horsens,5423,6,7,12,11,32,50,-18,33
Sonderjyske,5423,7,8,6,10,28,29,-1,30
Lyngby,5423,8,4,9,11,29,44,-15,21
AGF Aarhus,5423,9,5,6,11,18,36,-18,21
Randers FC,5423,10,5,6,13,23,42,-19,21
Silkeborg IF,5423,11,5,3,14,25,46,-21,18
Brondby,5424,1,21,6,3,70,29,41,69
FC Midtjylla,5424,2,20,6,4,62,33,29,66
FC Nords,5424,3,15,7,8,77,50,27,52
Copenhagen,5424,4,13,4,13,57,48,9,43
AaB,5424,5,8,12,10,37,43,-6,36
Sonderjyske,5424,6,8,6,10,28,29,-1,30
AC Horsens,5424,7,5,13,12,33,59,-26,28
Randers FC,5424,8,6,6,12,25,40,-15,24
Silkeborg IF,5424,9,5,4,13,25,44,-19,19
AGF Aarhus,5424,10,4,7,11,16,36,-20,19
Lyngby,5424,11,3,9,12,27,46,-19,18
Brondby,5425,1,23,5,2,76,28,48,74
FC Midtjylla,5425,2,19,4,7,68,48,20,61
FC Nords,5425,3,14,7,9,69,51,18,49
Copenhagen,5425,4,13,6,11,57,43,14,45
AaB,5425,5,8,12,10,38,44,-6,36
Sonderjyske,5425,6,8,6,10,28,29,-1,30
AC Horsens,5425,7,5,14,11,30,50,-20,29
Randers FC,5425,8,5,7,12,25,41,-16,22
Silkeborg IF,5425,9,6,3,13,28,45,-17,21
Lyngby,5425,10,3,10,11,28,46,-18,19
AGF Aarhus,5425,11,4,6,12,17,39,-22,18
Brondby,5426,1,20,7,3,69,31,38,67
FC Midtjylla,5426,2,21,4,5,71,39,32,67
FC Nords,5426,3,15,7,8,74,48,26,52
Copenhagen,5426,4,13,4,13,54,46,8,43
AaB,5426,5,7,12,11,37,44,-7,33
AC Horsens,5426,6,7,12,11,35,58,-23,33
Sonderjyske,5426,7,8,6,10,28,29,-1,30
Lyngby,5426,8,4,9,11,29,45,-16,21
Randers FC,5426,9,5,6,13,24,42,-18,21
Silkeborg IF,5426,10,5,4,13,25,44,-19,19
AGF Aarhus,5426,11,4,7,11,16,36,-20,19
Brondby,5427,1,20,5,5,72,35,37,65
FC Midtjylla,5427,2,19,6,5,65,36,29,63
Copenhagen,5427,3,14,7,9,57,41,16,49
FC Nords,5427,4,13,8,9,72,55,17,47
AaB,5427,5,7,13,10,35,44,-9,34
AC Horsens,5427,6,7,13,10,33,49,-16,34
Sonderjyske,5427,7,8,6,10,28,29,-1,30
Lyngby,5427,8,4,9,11,30,45,-15,21
Randers FC,5427,9,5,6,13,24,43,-19,21
Silkeborg IF,5427,10,5,4,13,26,45,-19,19
AGF Aarhus,5427,11,4,7,11,17,37,-20,19
Brondby,5428,1,20,6,4,74,33,41,66
FC Midtjylla,5428,2,20,5,5,62,37,25,65
Copenhagen,5428,3,15,5,10,57,39,18,50
FC Nords,5428,4,12,9,9,73,55,18,45
AaB,5428,5,8,12,10,41,43,-2,36
Sonderjyske,5428,6,8,6,10,28,29,-1,30
AC Horsens,5428,7,5,15,10,30,56,-26,30
Randers FC,5428,8,5,7,12,23,39,-16,22
Lyngby,5428,9,3,10,11,26,44,-18,19
Silkeborg IF,5428,10,5,4,13,26,45,-19,19
AGF Aarhus,5428,11,4,7,11,17,37,-20,19
Brondby,5429,1,22,5,3,75,32,43,71
FC Midtjylla,5429,2,20,4,6,64,43,21,64
Copenhagen,5429,3,15,5,10,62,42,20,50
FC Nords,5429,4,12,9,9,72,55,17,45
AaB,5429,5,7,13,10,42,49,-7,34
Sonderjyske,5429,6,8,6,10,28,29,-1,30
AC Horsens,5429,7,5,14,11,35,55,-20,29
Lyngby,5429,8,4,9,11,28,44,-16,21
Randers FC,5429,9,5,6,13,23,41,-18,21
AGF Aarhus,5429,10,5,6,11,19,38,-19,21
Silkeborg IF,5429,11,5,3,14,27,47,-20,18
Brondby,5430,1,21,6,3,74,33,41,69
FC Midtjylla,5430,2,18,5,7,62,40,22,59
Copenhagen,5430,3,16,4,10,62,42,20,52
FC Nords,5430,4,14,7,9,71,52,19,49
AaB,5430,5,8,12,10,37,42,-5,36
Sonderjyske,5430,6,8,6,10,28,29,-1,30
AC Horsens,5430,7,6,12,12,34,57,-23,30
Silkeborg IF,5430,8,6,3,13,29,44,-15,21
Lyngby,5430,9,4,9,11,27,44,-17,21
Randers FC,5430,10,5,6,13,23,40,-17,21
AGF Aarhus,5430,11,4,6,12,16,40,-24,18
Brondby,5431,1,22,6,2,69,29,40,72
FC Midtjylla,5431,2,20,5,5,65,37,28,65
FC Nords,5431,3,15,6,9,79,52,27,51
Copenhagen,5431,4,13,7,10,56,44,12,46
AC Horsens,5431,5,6,13,11,36,55,-19,31
Sonderjyske,5431,6,8,6,10,28,29,-1,30
AaB,5431,7,6,11,13,35,49,-14,29
Randers FC,5431,8,6,6,12,26,40,-14,24
Silkeborg IF,5431,9,5,4,13,26,45,-19,19
AGF Aarhus,5431,10,4,7,11,17,37,-20,19
Lyngby,5431,11,3,9,12,27,47,-20,18
Brondby,5432,1,21,5,4,69,33,36,68
FC Midtjylla,5432,2,19,5,6,65,40,25,62
Copenhagen,5432,3,14,5,11,54,42,12,47
FC Nords,5432,4,13,6,11,66,49,17,45
AC Horsens,5432,5,9,12,9,37,50,-13,39
AaB,5432,6,8,11,11,37,40,-3,35
Sonderjyske,5432,7,8,6,10,28,29,-1,30
Randers FC,5432,8,5,7,12,23,39,-16,22
Lyngby,5432,9,3,10,11,26,44,-18,19
Silkeborg IF,5432,10,5,4,13,25,44,-19,19
AGF Aarhus,5432,11,4,7,11,16,36,-20,19
Brondby,5433,1,20,6,4,69,35,34,66
FC Midtjylla,5433,2,20,4,6,65,40,25,64
FC Nords,5433,3,14,6,10,74,52,22,48
Copenhagen,5433,4,14,4,12,59,49,10,46
AaB,5433,5,8,12,10,36,41,-5,36
AC Horsens,5433,6,8,12,10,42,54,-12,36
Sonderjyske,5433,7,8,6,10,28,29,-1,30
Randers FC,5433,8,6,6,12,24,39,-15,24
AGF Aarhus,5433,9,5,6,11,18,36,-18,21
Lyngby,5433,10,3,9,12,26,45,-19,18
Silkeborg IF,5433,11,5,3,14,25,46,-21,18
Brondby,5434,1,22,6,2,71,30,41,72
FC Midtjylla,5434,2,19,5,6,67,41,26,62
FC Nords,5434,3,14,7,9,71,50,21,49
Copenhagen,5434,4,13,4,13,56,49,7,43
AaB,5434,5,7,13,10,35,42,-7,34
AC Horsens,5434,6,7,13,10,34,48,-14,34
Sonderjyske,5434,7,8,6,10,28,29,-1,30
Randers FC,5434,8,6,6,12,25,39,-14,24
Silkeborg IF,5434,9,6,3,13,28,46,-18,21
Lyngby,5434,10,3,9,12,26,46,-20,18
AGF Aarhus,5434,11,4,6,12,18,39,-21,18
Brondby,5435,1,21,6,3,69,33,36,69
FC Midtjylla,5435,2,20,6,4,66,36,30,66
FC Nords,5435,3,13,7,10,70,54,16,46
Copenhagen,5435,4,13,6,11,59,46,13,45
AaB,5435,5,8,12,10,37,42,-5,36
AC Horsens,5435,6,6,13,11,37,53,-16,31
Sonderjyske,5435,7,8,6,10,28,29,-1,30
Silkeborg IF,5435,8,6,3,13,30,44,-14,21
Lyngby,5435,9,4,9,11,28,44,-16,21
Randers FC,5435,10,5,6,13,23,41,-18,21
AGF Aarhus,5435,11,4,6,12,16,41,-25,18
Brondby,5436,1,21,6,3,74,32,42,69
FC Midtjylla,5436,2,19,5,6,66,40,26,62
FC Nords,5436,3,14,6,10,73,54,19,48
Copenhagen,5436,4,14,4,12,56,49,7,46
AC Horsens,5436,5,8,12,10,37,54,-17,36
AaB,5436,6,7,13,10,39,42,-3,34
Sonderjyske,5436,7,8,6,10,28,29,-1,30
Lyngby,5436,8,4,9,11,28,44,-16,21
Silkeborg IF,5436,9,6,3,13,27,45,-18,21
Randers FC,5436,10,5,6,13,23,41,-18,21
AGF Aarhus,5436,11,4,6,12,17,38,-21,18
Brondby,5437,1,21,6,3,70,31,39,69
FC Midtjylla,5437,2,20,4,6,63,37,26,64
Copenhagen,5437,3,16,5,9,64,43,21,53
FC Nords,5437,4,12,7,11,70,58,12,43
AC Horsens,5437,5,7,13,10,38,52,-14,34
AaB,5437,6,7,11,12,36,46,-10,32
Sonderjyske,5437,7,8,6,10,28,29,-1,30
Randers FC,5437,8,6,6,12,26,39,-13,24
AGF Aarhus,5437,9,5,6,11,18,37,-19,21
Silkeborg IF,5437,10,5,3,14,26,46,-20,18
Lyngby,5437,11,3,9,12,26,47,-21,18
Brondby,5438,1,21,5,4,71,33,38,68
FC Midtjylla,5438,2,19,5,6,65,39,26,62
Copenhagen,5438,3,15,4,11,60,47,13,49
FC Nords,5438,4,14,6,10,67,50,17,48
AaB,5438,5,10,11,9,40,39,1,41
Sonderjyske,5438,6,8,6,10,28,29,-1,30
AC Horsens,5438,7,5,13,12,37,58,-21,28
Randers FC,5438,8,5,7,12,23,39,-16,22
Lyngby,5438,9,3,10,11,26,44,-18,19
Silkeborg IF,5438,10,5,4,13,25,44,-19,19
AGF Aarhus,5438,11,4,7,11,16,36,-20,19
Brondby,5439,1,21,7,2,69,28,41,70
FC Midtjylla,5439,2,19,5,6,66,40,26,62
Copenhagen,5439,3,15,4,11,57,42,15,49
FC Nords,5439,4,13,6,11,70,56,14,45
AaB,5439,5,9,13,8,38,38,0,40
Sonderjyske,5439,6,8,6,10,28,29,-1,30
AC Horsens,5439,7,5,13,12,34,56,-22,28
Randers FC,5439,8,5,7,12,24,40,-16,22
Silkeborg IF,5439,9,6,3,13,27,45,-18,21
Lyngby,5439,10,3,10,11,27,45,-18,19
AGF Aarhus,5439,11,4,6,12,17,38,-21,18
Brondby,5440,1,20,8,2,69,30,39,68
FC Midtjylla,5440,2,18,6,6,66,41,25,60
FC Nords,5440,3,14,8,8,70,48,22,50
Copenhagen,5440,4,13,7,10,54,41,13,46
AC Horsens,5440,5,7,14,9,32,47,-15,35
AaB,5440,6,6,13,11,33,43,-10,31
Sonderjyske,5440,7,8,6,10,28,29,-1,30
Randers FC,5440,8,5,7,12,24,40,-16,22
AGF Aarhus,5440,9,5,6,11,19,37,-18,21
Lyngby,5440,10,3,10,11,27,45,-18,19
Silkeborg IF,5440,11,5,3,14,26,47,-21,18
Brondby,5441,1,21,6,3,69,31,38,69
FC Midtjylla,5441,2,19,5,6,69,45,24,62
Copenhagen,5441,3,15,5,10,58,45,13,50
FC Nords,5441,4,13,7,10,71,53,18,46
AaB,5441,5,7,13,10,40,44,-4,34
AC Horsens,5441,6,6,14,10,36,51,-15,32
Sonderjyske,5441,7,8,6,10,28,29,-1,30
Randers FC,5441,8,6,6,12,25,40,-15,24
Silkeborg IF,5441,9,6,3,13,27,45,-18,21
Lyngby,5441,10,3,9,12,27,46,-19,18
AGF Aarhus,5441,11,4,6,12,17,38,-21,18
Brondby,5442,1,21,6,3,70,31,39,69
FC Midtjylla,5442,2,19,4,7,62,46,16,61
FC Nords,5442,3,14,7,9,77,52,25,49
Copenhagen,5442,4,14,5,11,58,45,13,47
AC Horsens,5442,5,7,14,9,40,51,-11,35
AaB,5442,6,6,14,10,33,41,-8,32
Sonderjyske,5442,7,8,6,10,28,29,-1,30
Lyngby,5442,8,4,9,11,27,44,-17,21
Randers FC,5442,9,5,6,13,23,40,-17,21
Silkeborg IF,5442,10,6,3,13,26,44,-18,21
AGF Aarhus,5442,11,4,6,12,16,37,-21,18
Brondby,5443,1,21,5,4,75,32,43,68
FC Midtjylla,5443,2,19,5,6,64,42,22,62
Copenhagen,5443,3,15,5,10,58,43,15,50
FC Nords,5443,4,13,7,10,69,52,17,46
AaB,5443,5,9,12,9,42,46,-4,39
Sonderjyske,5443,6,8,6,10,28,29,-1,30
AC Horsens,5443,7,6,12,12,35,54,-19,30
Randers FC,5443,8,5,7,12,25,41,-16,22
Silkeborg IF,5443,9,6,3,13,27,45,-18,21
Lyngby,5443,10,3,10,11,28,46,-18,19
AGF Aarhus,5443,11,4,6,12,17,38,-21,18
Brondby,5444,1,22,5,3,70,30,40,71
FC Midtjylla,5444,2,19,6,5,63,39,24,63
FC Nords,5444,3,15,6,9,72,49,23,51
Copenhagen,5444,4,12,4,14,51,45,6,40
AaB,5444,5,9,12,9,40,41,-1,39
AC Horsens,5444,6,6,13,11,35,53,-18,31
Sonderjyske,5444,7,8,6,10,28,29,-1,30
Randers FC,5444,8,5,7,12,24,40,-16,22
AGF Aarhus,5444,9,5,6,11,18,37,-19,21
Lyngby,5444,10,3,10,11,27,45,-18,19
Silkeborg IF,5444,11,5,3,14,26,46,-20,18
Brondby,5445,1,22,6,2,76,31,45,72
FC Midtjylla,5445,2,20,4,6,64,42,22,64
Copenhagen,5445,3,15,5,10,61,43,18,50
FC Nords,5445,4,13,6,11,73,59,14,45
AC Horsens,5445,5,7,12,11,35,50,-15,33
AaB,5445,6,7,11,12,36,46,-10,32
Sonderjyske,5445,7,8,6,10,28,29,-1,30
Randers FC,5445,8,5,7,12,23,39,-16,22
Silkeborg IF,5445,9,6,3,13,26,44,-18,21
Lyngby,5445,10,3,10,11,26,44,-18,19
AGF Aarhus,5445,11,4,6,12,16,37,-21,18
Brondby,5446,1,22,5,3,77,29,48,71
FC Midtjylla,5446,2,18,7,5,63,41,22,61
FC Nords,5446,3,13,9,8,71,52,19,48
Copenhagen,5446,4,13,8,9,58,44,14,47
AaB,5446,5,6,14,10,35,44,-9,32
AC Horsens,5446,6,6,13,11,31,51,-20,31
Sonderjyske,5446,7,8,6,10,28,29,-1,30
Lyngby,5446,8,4,9,11,28,45,-17,21
Randers FC,5446,9,5,6,13,24,41,-17,21
AGF Aarhus,5446,10,5,6,11,17,36,-19,21
Silkeborg IF,5446,11,5,3,14,25,45,-20,18
Brondby,5447,1,22,6,2,70,28,42,72
FC Midtjylla,5447,2,19,5,6,63,39,24,62
FC Nords,5447,3,15,7,8,75,48,27,52
Copenhagen,5447,4,13,4,13,56,48,8,43
AaB,5447,5,7,12,11,36,44,-8,33
AC Horsens,5447,6,6,14,10,34,53,-19,32
Sonderjyske,5447,7,8,6,10,28,29,-1,30
Randers FC,5447,8,5,7,12,24,40,-16,22
AGF Aarhus,5447,9,5,6,11,18,36,-18,21
Lyngby,5447,10,3,10,11,27,45,-18,19
Silkeborg IF,5447,11,5,3,14,25,46,-21,18
Brondby,5448,1,22,6,2,70,29,41,72
FC Midtjylla,5448,2,20,4,6,64,37,27,64
FC Nords,5448,3,15,6,9,73,53,20,51
Copenhagen,5448,4,13,5,12,56,44,12,44
AaB,5448,5,7,12,11,39,48,-9,33
AC Horsens,5448,6,6,13,11,36,53,-17,31
Sonderjyske,5448,7,8,6,10,28,29,-1,30
Randers FC,5448,8,5,7,12,24,40,-16,22
Silkeborg IF,5448,9,6,3,13,26,44,-18,21
Lyngby,5448,10,3,10,11,27,45,-18,19
AGF Aarhus,5448,11,4,6,12,16,37,-21,18
FC Midtjylla,5449,1,22,4,4,73,36,37,70
Brondby,5449,2,21,5,4,70,37,33,68
FC Nords,5449,3,15,6,9,76,52,24,51
Copenhagen,5449,4,12,5,13,56,49,7,41
AaB,5449,5,8,11,11,40,46,-6,35
AC Horsens,5449,6,6,13,11,34,55,-21,31
Sonderjyske,5449,7,8,6,10,28,29,-1,30
Randers FC,5449,8,5,7,12,24,40,-16,22
Lyngby,5449,9,3,10,11,27,45,-18,19
Silkeborg IF,5449,10,5,4,13,28,47,-19,19
AGF Aarhus,5449,11,4,7,11,19,39,-20,19
Brondby,5450,1,22,5,3,71,32,39,71
FC Midtjylla,5450,2,20,6,4,67,37,30,66
Copenhagen,5450,3,15,5,10,57,40,17,50
FC Nords,5450,4,14,6,10,71,51,20,48
Sonderjyske,5450,5,8,6,10,28,29,-1,30
AaB,5450,6,6,12,12,34,42,-8,30
AC Horsens,5450,7,6,12,12,31,55,-24,30
Randers FC,5450,8,6,6,12,24,39,-15,24
Silkeborg IF,5450,9,5,4,13,25,44,-19,19
AGF Aarhus,5450,10,4,7,11,16,36,-20,19
Lyngby,5450,11,3,9,12,26,45,-19,18
Brondby,5451,1,20,8,2,72,34,38,68
FC Midtjylla,5451,2,20,4,6,69,43,26,64
FC Nords,5451,3,15,6,9,76,52,24,51
Copenhagen,5451,4,12,5,13,59,54,5,41
AaB,5451,5,9,12,9,39,39,0,39
AC Horsens,5451,6,6,13,11,33,52,-19,31
Sonderjyske,5451,7,8,6,10,28,29,-1,30
Randers FC,5451,8,6,6,12,25,40,-15,24
Silkeborg IF,5451,9,6,3,13,27,45,-18,21
Lyngby,5451,10,3,9,12,27,46,-19,18
AGF Aarhus,5451,11,4,6,12,17,38,-21,18
Brondby,5452,1,20,6,4,66,31,35,66
FC Midtjylla,5452,2,19,5,6,64,43,21,62
FC Nords,5452,3,13,8,9,74,51,23,47
Copenhagen,5452,4,13,5,12,57,50,7,44
AaB,5452,5,9,13,8,42,40,2,40
AC Horsens,5452,6,6,15,9,38,52,-14,33
Sonderjyske,5452,7,8,6,10,28,29,-1,30
Lyngby,5452,8,4,9,11,29,46,-17,21
Silkeborg IF,5452,9,6,3,13,27,44,-17,21
Randers FC,5452,10,5,6,13,25,42,-17,21
AGF Aarhus,5452,11,4,6,12,16,38,-22,18
Brondby,5453,1,23,5,2,79,32,47,74
FC Midtjylla,5453,2,19,4,7,60,37,23,61
FC Nords,5453,3,14,6,10,71,50,21,48
Copenhagen,5453,4,13,5,12,57,50,7,44
AaB,5453,5,8,12,10,36,44,-8,36
AC Horsens,5453,6,7,12,11,35,51,-16,33
Sonderjyske,5453,7,8,6,10,28,29,-1,30
Randers FC,5453,8,5,7,12,23,39,-16,22
AGF Aarhus,5453,9,5,6,11,18,37,-19,21
Lyngby,5453,10,3,10,11,26,44,-18,19
Silkeborg IF,5453,11,5,3,14,26,46,-20,18
Brondby,5454,1,21,6,3,70,31,39,69
FC Midtjylla,5454,2,18,4,8,62,40,22,58
Copenhagen,5454,3,16,4,10,60,43,17,52
FC Nords,5454,4,14,7,9,71,50,21,49
AaB,5454,5,8,13,9,38,41,-3,37
Sonderjyske,5454,6,8,6,10,28,29,-1,30
AC Horsens,5454,7,6,12,12,36,58,-22,30
Randers FC,5454,8,5,7,12,25,41,-16,22
Silkeborg IF,5454,9,6,3,13,28,46,-18,21
Lyngby,5454,10,3,10,11,28,46,-18,19
AGF Aarhus,5454,11,4,6,12,18,39,-21,18
Brondby,5455,1,22,5,3,72,29,43,71
FC Midtjylla,5455,2,19,6,5,67,42,25,63
FC Nords,5455,3,14,6,10,70,53,17,48
Copenhagen,5455,4,12,7,11,55,46,9,43
AaB,5455,5,7,14,9,40,43,-3,35
AC Horsens,5455,6,6,14,10,32,49,-17,32
Sonderjyske,5455,7,8,6,10,28,29,-1,30
Randers FC,5455,8,5,7,12,24,40,-16,22
Lyngby,5455,9,3,10,11,27,45,-18,19
Silkeborg IF,5455,10,5,4,13,26,45,-19,19
AGF Aarhus,5455,11,4,7,11,17,37,-20,19
Brondby,5456,1,21,6,3,74,33,41,69
FC Midtjylla,5456,2,20,5,5,67,39,28,65
FC Nords,5456,3,14,7,9,74,52,22,49
Copenhagen,5456,4,13,5,12,58,48,10,44
AaB,5456,5,8,12,10,36,44,-8,36
AC Horsens,5456,6,6,13,11,35,54,-19,31
Sonderjyske,5456,7,8,6,10,28,29,-1,30
Lyngby,5456,8,4,9,11,27,44,-17,21
Randers FC,5456,9,5,6,13,23,40,-17,21
AGF Aarhus,5456,10,5,6,11,17,36,-19,21
Silkeborg IF,5456,11,5,3,14,25,45,-20,18
Brondby,5457,1,22,6,2,75,31,44,72
FC Midtjylla,5457,2,21,4,5,64,36,28,67
FC Nords,5457,3,13,7,10,71,53,18,46
Copenhagen,5457,4,12,7,11,56,47,9,43
AaB,5457,5,7,12,11,38,46,-8,33
AC Horsens,5457,6,7,12,11,36,53,-17,33
Sonderjyske,5457,7,8,6,10,28,29,-1,30
Randers FC,5457,8,5,7,12,24,40,-16,22
Silkeborg IF,5457,9,6,3,13,27,44,-17,21
Lyngby,5457,10,3,10,11,27,45,-18,19
AGF Aarhus,5457,11,4,6,12,16,38,-22,18
Brondby,5458,1,20,6,4,75,31,44,66
FC Midtjylla,5458,2,20,4,6,65,43,22,64
FC Nords,5458,3,15,6,9,75,54,21,51
Copenhagen,5458,4,13,5,12,60,48,12,44
AaB,5458,5,9,12,9,38,40,-2,39
AC Horsens,5458,6,6,13,11,32,55,-23,31
Sonderjyske,5458,7,8,6,10,28,29,-1,30
Randers FC,5458,8,6,6,12,25,39,-14,24
AGF Aarhus,5458,9,5,6,11,17,36,-19,21
Lyngby,5458,10,3,9,12,26,46,-20,18
Silkeborg IF,5458,11,5,3,14,25,45,-20,18
Brondby,5459,1,21,6,3,77,33,44,69
FC Midtjylla,5459,2,21,4,5,70,45,25,67
FC Nords,5459,3,14,7,9,76,53,23,49
Copenhagen,5459,4,15,4,11,61,48,13,49
AaB,5459,5,7,11,12,38,51,-13,32
Sonderjyske,5459,6,8,6,10,28,29,-1,30
AC Horsens,5459,7,6,12,12,38,56,-18,30
Lyngby,5459,8,4,9,11,29,45,-16,21
Silkeborg IF,5459,9,6,3,13,26,44,-18,21
Randers FC,5459,10,5,6,13,24,42,-18,21
AGF Aarhus,5459,11,4,6,12,16,37,-21,18
FC Midtjylla,5460,1,21,4,5,67,37,30,67
Brondby,5460,2,19,7,4,70,36,34,64
FC Nords,5460,3,14,7,9,76,56,20,49
Copenhagen,5460,4,13,5,12,59,47,12,44
AC Horsens,5460,5,8,12,10,42,58,-16,36
AaB,5460,6,7,13,10,39,45,-6,34
Sonderjyske,5460,7,8,6,10,28,29,-1,30
Lyngby,5460,8,4,9,11,29,44,-15,21
Randers FC,5460,9,5,6,13,23,42,-19,21
AGF Aarhus,5460,10,5,6,11,17,36,-19,21
Silkeborg IF,5460,11,5,3,14,25,45,-20,18
Brondby,5461,1,21,5,4,72,33,39,68
FC Midtjylla,5461,2,19,4,7,64,44,20,61
FC Nords,5461,3,15,7,8,72,52,20,52
Copenhagen,5461,4,15,4,11,60,43,17,49
AaB,5461,5,8,11,11,37,42,-5,35
AC Horsens,5461,6,6,13,11,33,50,-17,31
Sonderjyske,5461,7,8,6,10,28,29,-1,30
Randers FC,5461,8,6,6,12,26,41,-15,24
Silkeborg IF,5461,9,5,4,13,26,45,-19,19
AGF Aarhus,5461,10,4,7,11,17,37,-20,19
Lyngby,5461,11,3,9,12,28,47,-19,18
Brondby,5462,1,21,7,2,70,30,40,70
FC Midtjylla,5462,2,20,5,5,71,38,33,65
FC Nords,5462,3,14,6,10,74,50,24,48
Copenhagen,5462,4,13,6,11,56,50,6,45
AaB,5462,5,9,12,9,40,43,-3,39
Sonderjyske,5462,6,8,6,10,28,29,-1,30
AC Horsens,5462,7,5,12,13,31,57,-26,27
Lyngby,5462,8,4,9,11,29,46,-17,21
Randers FC,5462,9,5,6,13,25,42,-17,21
AGF Aarhus,5462,10,5,6,11,17,36,-19,21
Silkeborg IF,5462,11,5,3,14,25,45,-20,18
Brondby,5463,1,22,6,2,68,29,39,72
FC Midtjylla,5463,2,19,5,6,60,37,23,62
FC Nords,5463,3,16,6,8,73,45,28,54
Copenhagen,5463,4,12,4,14,53,48,5,40
AaB,5463,5,8,11,11,37,42,-5,35
AC Horsens,5463,6,7,12,11,35,51,-16,33
Sonderjyske,5463,7,8,6,10,28,29,-1,30
Randers FC,5463,8,6,6,12,24,39,-15,24
Silkeborg IF,5463,9,6,3,13,26,44,-18,21
Lyngby,5463,10,3,9,12,26,45,-19,18
AGF Aarhus,5463,11,4,6,12,16,37,-21,18
Brondby,5464,1,21,7,2,69,29,40,70
FC Midtjylla,5464,2,19,5,6,62,38,24,62
Copenhagen,5464,3,15,5,10,61,44,17,50
FC Nords,5464,4,14,6,10,70,50,20,48
AC Horsens,5464,5,7,13,10,35,50,-15,34
Sonderjyske,5464,6,8,6,10,28,29,-1,30
AaB,5464,7,6,12,12,36,48,-12,30
Lyngby,5464,8,4,9,11,29,45,-16,21
Silkeborg IF,5464,9,6,3,13,27,45,-18,21
Randers FC,5464,10,5,6,13,24,42,-18,21
AGF Aarhus,5464,11,4,6,12,17,38,-21,18
Brondby,5465,1,21,6,3,70,34,36,69
FC Midtjylla,5465,2,20,5,5,71,40,31,65
FC Nords,5465,3,14,7,9,75,52,23,49
Copenhagen,5465,4,14,6,10,63,50,13,48
AC Horsens,5465,5,6,14,10,37,56,-19,32
Sonderjyske,5465,6,8,6,10,28,29,-1,30
AaB,5465,7,6,12,12,37,47,-10,30
Randers FC,5465,8,6,6,12,27,39,-12,24
AGF Aarhus,5465,9,5,6,11,21,36,-15,21
Lyngby,5465,10,3,9,12,26,48,-22,18
Silkeborg IF,5465,11,5,3,14,25,49,-24,18
FC Midtjylla,5466,1,21,4,5,63,37,26,67
Brondby,5466,2,20,6,4,73,35,38,66
FC Nords,5466,3,15,7,8,78,53,25,52
Copenhagen,5466,4,16,4,10,63,44,19,52
AaB,5466,5,7,11,12,40,51,-11,32
Sonderjyske,5466,6,8,6,10,28,29,-1,30
AC Horsens,5466,7,5,12,13,34,57,-23,27
Lyngby,5466,8,4,9,11,28,44,-16,21
Randers FC,5466,9,5,6,13,23,41,-18,21
Silkeborg IF,5466,10,5,4,13,27,46,-19,19
AGF Aarhus,5466,11,4,7,11,18,38,-20,19
Brondby,5467,1,22,6,2,73,29,44,72
FC Midtjylla,5467,2,19,5,6,69,42,27,62
FC Nords,5467,3,15,6,9,75,53,22,51
Copenhagen,5467,4,14,4,12,61,52,9,46
AC Horsens,5467,5,7,12,11,39,56,-17,33
AaB,5467,6,6,13,11,38,49,-11,31
Sonderjyske,5467,7,8,6,10,28,29,-1,30
Randers FC,5467,8,6,6,12,24,39,-15,24
Silkeborg IF,5467,9,5,4,13,26,45,-19,19
AGF Aarhus,5467,10,4,7,11,17,37,-20,19
Lyngby,5467,11,3,9,12,26,45,-19,18
Brondby,5468,1,21,6,3,72,31,41,69
FC Midtjylla,5468,2,17,5,8,60,45,15,56
FC Nords,5468,3,15,7,8,74,54,20,52
Copenhagen,5468,4,14,5,11,57,42,15,47
AaB,5468,5,8,12,10,40,43,-3,36
AC Horsens,5468,6,7,13,10,37,51,-14,34
Sonderjyske,5468,7,8,6,10,28,29,-1,30
Randers FC,5468,8,6,6,12,24,39,-15,24
Silkeborg IF,5468,9,6,3,13,28,45,-17,21
Lyngby,5468,10,3,9,12,26,45,-19,18
AGF Aarhus,5468,11,4,6,12,17,39,-22,18
Brondby,5469,1,22,6,2,73,31,42,72
FC Midtjylla,5469,2,20,4,6,69,41,28,64
FC Nords,5469,3,14,6,10,70,51,19,48
Copenhagen,5469,4,14,4,12,56,46,10,46
AaB,5469,5,7,13,10,38,44,-6,34
AC Horsens,5469,6,6,13,11,30,49,-19,31
Sonderjyske,5469,7,8,6,10,28,29,-1,30
Randers FC,5469,8,5,7,12,24,40,-16,22
AGF Aarhus,5469,9,5,6,11,19,37,-18,21
Lyngby,5469,10,3,10,11,27,45,-18,19
Silkeborg IF,5469,11,5,3,14,26,47,-21,18
Brondby,5470,1,21,5,4,68,31,37,68
FC Midtjylla,5470,2,19,6,5,63,38,25,63
FC Nords,5470,3,14,6,10,75,53,22,48
Copenhagen,5470,4,13,7,10,58,45,13,46
AaB,5470,5,7,13,10,35,42,-7,34
AC Horsens,5470,6,7,13,10,35,51,-16,34
Sonderjyske,5470,7,8,6,10,28,29,-1,30
Lyngby,5470,8,4,9,11,29,46,-17,21
Randers FC,5470,9,5,6,13,25,42,-17,21
Silkeborg IF,5470,10,6,3,13,27,45,-18,21
AGF Aarhus,5470,11,4,6,12,17,38,-21,18
Brondby,5471,1,21,6,3,75,34,41,69
FC Midtjylla,5471,2,20,5,5,68,36,32,65
FC Nords,5471,3,15,7,8,76,51,25,52
Copenhagen,5471,4,12,4,14,53,47,6,40
AaB,5471,5,7,13,10,34,40,-6,34
AC Horsens,5471,6,7,13,10,35,59,-24,34
Sonderjyske,5471,7,8,6,10,28,29,-1,30
Randers FC,5471,8,6,6,12,25,40,-15,24
Silkeborg IF,5471,9,5,4,13,26,45,-19,19
AGF Aarhus,5471,10,4,7,11,17,37,-20,19
Lyngby,5471,11,3,9,12,27,46,-19,18
FC Midtjylla,5472,1,20,6,4,66,37,29,66
Brondby,5472,2,19,7,4,67,34,33,64
FC Nords,5472,3,14,8,8,72,48,24,50
Copenhagen,5472,4,14,6,10,63,46,17,48
AC Horsens,5472,5,6,14,10,37,55,-18,32
AaB,5472,6,6,13,11,39,50,-11,31
Sonderjyske,5472,7,8,6,10,28,29,-1,30
Lyngby,5472,8,4,9,11,29,45,-16,21
Silkeborg IF,5472,9,6,3,13,26,44,-18,21
Randers FC,5472,10,5,6,13,24,42,-18,21
AGF Aarhus,5472,11,4,6,12,16,37,-21,18
Brondby,5473,1,20,6,4,68,34,34,66
FC Midtjylla,5473,2,19,5,6,67,40,27,62
Copenhagen,5473,3,15,6,9,62,44,18,51
FC Nords,5473,4,14,7,9,76,51,25,49
AaB,5473,5,7,14,9,38,41,-3,35
Sonderjyske,5473,6,8,6,10,28,29,-1,30
AC Horsens,5473,7,6,12,12,31,58,-27,30
Lyngby,5473,8,4,9,11,29,46,-17,21
Randers FC,5473,9,5,6,13,25,42,-17,21
AGF Aarhus,5473,10,5,6,11,20,38,-18,21
Silkeborg IF,5473,11,5,3,14,27,48,-21,18
FC Midtjylla,5474,1,20,6,4,70,37,33,66
Brondby,5474,2,19,8,3,69,34,35,65
Copenhagen,5474,3,15,5,10,61,44,17,50
FC Nords,5474,4,14,6,10,71,53,18,48
AaB,5474,5,7,12,11,38,48,-10,33
AC Horsens,5474,6,6,13,11,38,57,-19,31
Sonderjyske,5474,7,8,6,10,28,29,-1,30
Lyngby,5474,8,4,9,11,28,44,-16,21
Silkeborg IF,5474,9,6,3,13,27,45,-18,21
Randers FC,5474,10,5,6,13,23,41,-18,21
AGF Aarhus,5474,11,4,6,12,17,38,-21,18
Brondby,5475,1,23,5,2,71,28,43,74
FC Midtjylla,5475,2,20,4,6,64,39,25,64
Copenhagen,5475,3,15,4,11,61,43,18,49
FC Nords,5475,4,14,6,10,72,53,19,48
AC Horsens,5475,5,7,12,11,36,53,-17,33
Sonderjyske,5475,6,8,6,10,28,29,-1,30
AaB,5475,7,6,11,13,37,51,-14,29
Lyngby,5475,8,4,9,11,32,47,-15,21
Randers FC,5475,9,5,6,13,26,45,-19,21
AGF Aarhus,5475,10,5,6,11,19,38,-19,21
Silkeborg IF,5475,11,5,3,14,27,47,-20,18
FC Midtjylla,5476,1,21,4,5,71,43,28,67
Brondby,5476,2,19,6,5,70,34,36,63
FC Nords,5476,3,14,7,9,70,48,22,49
Copenhagen,5476,4,15,4,11,57,44,13,49
AaB,5476,5,8,11,11,39,48,-9,35
AC Horsens,5476,6,6,14,10,34,50,-16,32
Sonderjyske,5476,7,8,6,10,28,29,-1,30
Lyngby,5476,8,4,9,11,29,44,-15,21
AGF Aarhus,5476,9,5,6,11,18,36,-18,21
Randers FC,5476,10,5,6,13,23,42,-19,21
Silkeborg IF,5476,11,5,3,14,25,46,-21,18
Brondby,5477,1,21,6,3,73,32,41,69
FC Midtjylla,5477,2,19,5,6,63,40,23,62
FC Nords,5477,3,15,8,7,78,49,29,53
Copenhagen,5477,4,13,5,12,56,50,6,44
AC Horsens,5477,5,7,13,10,33,48,-15,34
AaB,5477,6,7,11,12,36,46,-10,32
Sonderjyske,5477,7,8,6,10,28,29,-1,30
Randers FC,5477,8,6,6,12,25,39,-14,24
AGF Aarhus,5477,9,5,6,11,19,38,-19,21
Silkeborg IF,5477,10,5,3,14,27,47,-20,18
Lyngby,5477,11,3,9,12,26,46,-20,18
Brondby,5478,1,23,5,2,75,30,45,74
FC Midtjylla,5478,2,19,5,6,68,40,28,62
FC Nords,5478,3,14,6,10,73,59,14,48
Copenhagen,5478,4,13,6,11,60,49,11,45
AC Horsens,5478,5,7,13,10,38,53,-15,34
AaB,5478,6,7,11,12,41,50,-9,32
Sonderjyske,5478,7,8,6,10,28,29,-1,30
Lyngby,5478,8,4,9,11,27,44,-17,21
Randers FC,5478,9,5,6,13,23,40,-17,21
AGF Aarhus,5478,10,5,6,11,18,36,-18,21
Silkeborg IF,5478,11,5,3,14,25,46,-21,18
Brondby,5479,1,23,5,2,73,29,44,74
FC Midtjylla,5479,2,20,5,5,66,36,30,65
FC Nords,5479,3,14,7,9,81,58,23,49
Copenhagen,5479,4,13,5,12,56,47,9,44
AaB,5479,5,6,13,11,36,45,-9,31
AC Horsens,5479,6,6,13,11,36,59,-23,31
Sonderjyske,5479,7,8,6,10,28,29,-1,30
Randers FC,5479,8,5,7,12,23,39,-16,22
AGF Aarhus,5479,9,5,6,11,17,36,-19,21
Lyngby,5479,10,3,10,11,26,44,-18,19
Silkeborg IF,5479,11,5,3,14,25,45,-20,18
Brondby,5480,1,21,6,3,70,30,40,69
FC Midtjylla,5480,2,21,5,4,66,36,30,68
Copenhagen,5480,3,16,4,10,61,41,20,52
FC Nords,5480,4,14,6,10,77,56,21,48
Sonderjyske,5480,5,8,6,10,28,29,-1,30
AaB,5480,6,6,12,12,38,54,-16,30
AC Horsens,5480,7,5,13,12,32,53,-21,28
Lyngby,5480,8,4,9,11,28,44,-16,21
Silkeborg IF,5480,9,6,3,13,28,45,-17,21
Randers FC,5480,10,5,6,13,23,41,-18,21
AGF Aarhus,5480,11,4,6,12,17,39,-22,18
Brondby,5481,1,21,6,3,68,27,41,69
FC Midtjylla,5481,2,19,6,5,68,41,27,63
FC Nords,5481,3,14,8,8,75,51,24,50
Copenhagen,5481,4,13,5,12,54,46,8,44
AaB,5481,5,6,15,9,36,41,-5,33
AC Horsens,5481,6,6,14,10,33,54,-21,32
Sonderjyske,5481,7,8,6,10,28,29,-1,30
Randers FC,5481,8,6,6,12,25,40,-15,24
Silkeborg IF,5481,9,5,4,13,26,45,-19,19
AGF Aarhus,5481,10,4,7,11,17,37,-20,19
Lyngby,5481,11,3,9,12,27,46,-19,18
Brondby,5482,1,21,6,3,73,32,41,69
FC Midtjylla,5482,2,20,5,5,72,38,34,65
FC Nords,5482,3,14,7,9,78,61,17,49
Copenhagen,5482,4,14,6,10,60,45,15,48
AaB,5482,5,7,12,11,35,46,-11,33
Sonderjyske,5482,6,8,6,10,28,29,-1,30
AC Horsens,5482,7,6,12,12,35,57,-22,30
Randers FC,5482,8,5,7,12,24,40,-16,22
AGF Aarhus,5482,9,5,6,11,18,37,-19,21
Lyngby,5482,10,3,10,11,27,45,-18,19
Silkeborg IF,5482,11,5,3,14,26,46,-20,18
Brondby,5483,1,20,7,3,70,32,38,67
FC Midtjylla,5483,2,20,6,4,64,36,28,66
FC Nords,5483,3,15,6,9,75,50,25,51
Copenhagen,5483,4,12,6,12,55,47,8,42
AC Horsens,5483,5,6,15,9,33,50,-17,33
AaB,5483,6,6,14,10,33,41,-8,32
Sonderjyske,5483,7,8,6,10,28,29,-1,30
Randers FC,5483,8,6,6,12,24,39,-15,24
Silkeborg IF,5483,9,5,4,13,25,44,-19,19
AGF Aarhus,5483,10,4,7,11,16,36,-20,19
Lyngby,5483,11,3,9,12,26,45,-19,18
Brondby,5484,1,21,7,2,71,32,39,70
FC Midtjylla,5484,2,19,5,6,64,38,26,62
FC Nords,5484,3,14,6,10,70,50,20,48
Copenhagen,5484,4,14,5,11,55,42,13,47
AaB,5484,5,8,12,10,40,47,-7,36
AC Horsens,5484,6,6,13,11,35,52,-17,31
Sonderjyske,5484,7,8,6,10,28,29,-1,30
Randers FC,5484,8,5,7,12,23,39,-16,22
AGF Aarhus,5484,9,5,6,11,17,36,-19,21
Lyngby,5484,10,3,10,11,26,44,-18,19
Silkeborg IF,5484,11,5,3,14,25,45,-20,18
Brondby,5485,1,21,6,3,70,34,36,69
FC Midtjylla,5485,2,19,5,6,64,39,25,62
FC Nords,5485,3,13,7,10,70,53,17,46
Copenhagen,5485,4,13,5,12,59,49,10,44
AaB,5485,5,10,11,9,43,41,2,41
AC Horsens,5485,6,7,12,11,36,52,-16,33
Sonderjyske,5485,7,8,6,10,28,29,-1,30
Randers FC,5485,8,5,7,12,24,40,-16,22
Lyngby,5485,9,3,10,11,27,45,-18,19
Silkeborg IF,5485,10,5,4,13,26,45,-19,19
AGF Aarhus,5485,11,4,7,11,17,37,-20,19
Brondby,5486,1,22,6,2,77,30,47,72
FC Midtjylla,5486,2,18,6,6,65,44,21,60
FC Nords,5486,3,14,7,9,69,49,20,49
Copenhagen,5486,4,14,5,11,59,45,14,47
AaB,5486,5,8,11,11,39,46,-7,35
AC Horsens,5486,6,6,13,11,32,53,-21,31
Sonderjyske,5486,7,8,6,10,28,29,-1,30
Randers FC,5486,8,5,7,12,25,41,-16,22
Lyngby,5486,9,3,10,11,28,46,-18,19
Silkeborg IF,5486,10,5,4,13,25,44,-19,19
AGF Aarhus,5486,11,4,7,11,16,36,-20,19
Brondby,5487,1,20,6,4,69,31,38,66
FC Midtjylla,5487,2,20,5,5,68,40,28,65
FC Nords,5487,3,15,7,8,77,49,28,52
Copenhagen,5487,4,14,6,10,55,43,12,48
AaB,5487,5,6,14,10,35,44,-9,32
Sonderjyske,5487,6,8,6,10,28,29,-1,30
AC Horsens,5487,7,6,12,12,31,54,-23,30
Randers FC,5487,8,5,7,12,23,39,-16,22
Silkeborg IF,5487,9,6,3,13,28,45,-17,21
Lyngby,5487,10,3,10,11,26,44,-18,19
AGF Aarhus,5487,11,4,6,12,17,39,-22,18
Brondby,5488,1,20,8,2,69,29,40,68
FC Midtjylla,5488,2,20,6,4,67,38,29,66
FC Nords,5488,3,13,6,11,69,53,16,45
Copenhagen,5488,4,13,5,12,55,49,6,44
AaB,5488,5,8,11,11,39,40,-1,35
AC Horsens,5488,6,7,14,9,37,53,-16,35
Sonderjyske,5488,7,8,6,10,28,29,-1,30
Randers FC,5488,8,5,7,12,24,40,-16,22
Silkeborg IF,5488,9,6,3,13,26,44,-18,21
Lyngby,5488,10,3,10,11,27,45,-18,19
AGF Aarhus,5488,11,4,6,12,16,37,-21,18
Brondby,5489,1,21,6,3,71,32,39,69
FC Midtjylla,5489,2,18,7,5,66,42,24,61
FC Nords,5489,3,15,7,8,73,49,24,52
Copenhagen,5489,4,14,6,10,56,43,13,48
AaB,5489,5,7,11,12,37,46,-9,32
Sonderjyske,5489,6,8,6,10,28,29,-1,30
AC Horsens,5489,7,5,15,10,32,49,-17,30
Randers FC,5489,8,5,7,12,23,39,-16,22
Silkeborg IF,5489,9,6,3,13,29,44,-15,21
Lyngby,5489,10,3,10,11,26,44,-18,19
AGF Aarhus,5489,11,4,6,12,16,40,-24,18
Brondby,5490,1,22,6,2,74,31,43,72
FC Midtjylla,5490,2,19,6,5,66,40,26,63
FC Nords,5490,3,14,6,10,74,55,19,48
Copenhagen,5490,4,13,5,12,57,46,11,44
AaB,5490,5,7,12,11,37,47,-10,33
AC Horsens,5490,6,6,15,9,37,52,-15,33
Sonderjyske,5490,7,8,6,10,28,29,-1,30
Randers FC,5490,8,6,6,12,27,40,-13,24
AGF Aarhus,5490,9,5,6,11,18,37,-19,21
Silkeborg IF,5490,10,5,3,14,26,46,-20,18
Lyngby,5490,11,3,9,12,27,48,-21,18
Brondby,5491,1,22,6,2,71,27,44,72
FC Midtjylla,5491,2,21,4,5,66,35,31,67
FC Nords,5491,3,12,8,10,67,53,14,44
Copenhagen,5491,4,12,7,11,55,44,11,43
AC Horsens,5491,5,7,13,10,36,55,-19,34
AaB,5491,6,7,12,11,37,44,-7,33
Sonderjyske,5491,7,8,6,10,28,29,-1,30
Randers FC,5491,8,6,6,12,25,40,-15,24
Silkeborg IF,5491,9,6,3,13,26,44,-18,21
Lyngby,5491,10,3,9,12,27,46,-19,18
AGF Aarhus,5491,11,4,6,12,16,37,-21,18
Brondby,5492,1,21,5,4,71,30,41,68
FC Midtjylla,5492,2,20,4,6,65,38,27,64
Copenhagen,5492,3,15,4,11,61,44,17,49
FC Nords,5492,4,14,6,10,73,51,22,48
AaB,5492,5,9,11,10,38,45,-7,38
Sonderjyske,5492,6,8,6,10,28,29,-1,30
AC Horsens,5492,7,6,12,12,34,60,-26,30
Lyngby,5492,8,4,9,11,27,44,-17,21
Randers FC,5492,9,5,6,13,23,40,-17,21
Silkeborg IF,5492,10,5,4,13,25,44,-19,19
AGF Aarhus,5492,11,4,7,11,16,36,-20,19
Brondby,5493,1,21,6,3,75,35,40,69
FC Midtjylla,5493,2,18,6,6,61,41,20,60
FC Nords,5493,3,15,6,9,76,50,26,51
Copenhagen,5493,4,14,5,11,60,46,14,47
AaB,5493,5,7,13,10,36,44,-8,34
AC Horsens,5493,6,5,16,9,33,51,-18,31
Sonderjyske,5493,7,8,6,10,28,29,-1,30
Randers FC,5493,8,6,6,12,25,40,-15,24
Silkeborg IF,5493,9,5,4,13,26,45,-19,19
AGF Aarhus,5493,10,4,7,11,17,37,-20,19
Lyngby,5493,11,3,9,12,27,46,-19,18
Brondby,5494,1,22,5,3,74,30,44,71
FC Midtjylla,5494,2,22,4,4,69,37,32,70
FC Nords,5494,3,14,6,10,74,57,17,48
Copenhagen,5494,4,13,4,13,56,51,5,43
AaB,5494,5,8,11,11,37,42,-5,35
Sonderjyske,5494,6,8,6,10,28,29,-1,30
AC Horsens,5494,7,6,12,12,35,54,-19,30
Randers FC,5494,8,6,6,12,25,39,-14,24
Silkeborg IF,5494,9,5,4,13,26,45,-19,19
AGF Aarhus,5494,10,4,7,11,17,37,-20,19
Lyngby,5494,11,3,9,12,26,46,-20,18
Brondby,5495,1,20,8,2,71,33,38,68
FC Midtjylla,5495,2,19,5,6,66,45,21,62
FC Nords,5495,3,14,9,7,73,48,25,51
Copenhagen,5495,4,14,5,11,61,48,13,47
AaB,5495,5,6,14,10,36,42,-6,32
AC Horsens,5495,6,6,13,11,34,51,-17,31
Sonderjyske,5495,7,8,6,10,28,29,-1,30
Randers FC,5495,8,6,6,12,24,39,-15,24
AGF Aarhus,5495,9,5,6,11,18,36,-18,21
Lyngby,5495,10,3,9,12,26,45,-19,18
Silkeborg IF,5495,11,5,3,14,25,46,-21,18
Brondby,5496,1,20,6,4,73,32,41,66
FC Midtjylla,5496,2,20,5,5,68,39,29,65
Copenhagen,5496,3,13,6,11,59,46,13,45
FC Nords,5496,4,12,7,11,72,67,5,43
AaB,5496,5,9,13,8,41,42,-1,40
AC Horsens,5496,6,7,13,10,36,49,-13,34
Sonderjyske,5496,7,8,6,10,28,29,-1,30
Randers FC,5496,8,6,6,12,27,41,-14,24
Silkeborg IF,5496,9,6,3,13,27,45,-18,21
Lyngby,5496,10,3,9,12,28,48,-20,18
AGF Aarhus,5496,11,4,6,12,17,38,-21,18
Brondby,5497,1,20,6,4,72,35,37,66
FC Midtjylla,5497,2,20,4,6,65,38,27,64
Copenhagen,5497,3,15,5,10,59,44,15,50
FC Nords,5497,4,14,7,9,70,52,18,49
AaB,5497,5,7,12,11,38,45,-7,33
AC Horsens,5497,6,6,14,10,37,53,-16,32
Sonderjyske,5497,7,8,6,10,28,29,-1,30
Randers FC,5497,8,5,7,12,24,40,-16,22
Silkeborg IF,5497,9,6,3,13,26,44,-18,21
Lyngby,5497,10,3,10,11,27,45,-18,19
AGF Aarhus,5497,11,4,6,12,16,37,-21,18
Brondby,5498,1,20,8,2,72,33,39,68
FC Midtjylla,5498,2,19,5,6,65,40,25,62
FC Nords,5498,3,13,10,7,78,56,22,49
Copenhagen,5498,4,15,4,11,59,44,15,49
AaB,5498,5,7,13,10,41,48,-7,34
Sonderjyske,5498,6,8,6,10,28,29,-1,30
AC Horsens,5498,7,5,14,11,35,55,-20,29
Lyngby,5498,8,4,9,11,27,44,-17,21
Randers FC,5498,9,5,6,13,23,40,-17,21
Silkeborg IF,5498,10,5,4,13,27,46,-19,19
AGF Aarhus,5498,11,4,7,11,18,38,-20,19
FC Midtjylla,5499,1,21,5,4,68,39,29,68
Brondby,5499,2,20,5,5,74,40,34,65
FC Nords,5499,3,16,6,8,76,50,26,54
Copenhagen,5499,4,14,5,11,62,48,14,47
AC Horsens,5499,5,7,12,11,36,54,-18,33
Sonderjyske,5499,6,8,6,10,28,29,-1,30
AaB,5499,7,6,11,13,36,47,-11,29
Randers FC,5499,8,5,7,12,23,39,-16,22
Lyngby,5499,9,3,10,11,26,44,-18,19
Silkeborg IF,5499,10,5,4,13,26,45,-19,19
AGF Aarhus,5499,11,4,7,11,17,37,-20,19
Brondby,5500,1,21,6,3,72,33,39,69
FC Midtjylla,5500,2,19,4,7,64,35,29,61
Copenhagen,5500,3,16,5,9,62,43,19,53
FC Nords,5500,4,14,6,10,75,57,18,48
AaB,5500,5,8,12,10,37,43,-6,36
Sonderjyske,5500,6,8,6,10,28,29,-1,30
AC Horsens,5500,7,5,13,12,33,58,-25,28
Randers FC,5500,8,6,6,12,26,40,-14,24
Silkeborg IF,5500,9,6,3,13,28,45,-17,21
Lyngby,5500,10,3,9,12,27,47,-20,18
AGF Aarhus,5500,11,4,6,12,17,39,-22,18
Brondby,5501,1,21,5,4,73,34,39,68
FC Midtjylla,5501,2,21,4,5,71,39,32,67
Copenhagen,5501,3,14,6,10,57,42,15,48
FC Nords,5501,4,13,7,10,71,51,20,46
AaB,5501,5,7,13,10,37,46,-9,34
AC Horsens,5501,6,6,13,11,36,59,-23,31
Sonderjyske,5501,7,8,6,10,28,29,-1,30
Lyngby,5501,8,4,9,11,29,45,-16,21
Randers FC,5501,9,5,6,13,24,42,-18,21
Silkeborg IF,5501,10,5,4,13,26,45,-19,19
AGF Aarhus,5501,11,4,7,11,17,37,-20,19
FC Midtjylla,5502,1,21,4,5,67,36,31,67
Brondby,5502,2,19,6,5,65,35,30,63
FC Nords,5502,3,15,7,8,72,47,25,52
Copenhagen,5502,4,16,4,10,59,43,16,52
AC Horsens,5502,5,6,13,11,33,48,-15,31
Sonderjyske,5502,6,8,6,10,28,29,-1,30
AaB,5502,7,6,12,12,33,46,-13,30
Lyngby,5502,8,4,9,11,28,44,-16,21
Silkeborg IF,5502,9,6,3,13,26,44,-18,21
Randers FC,5502,10,5,6,13,23,41,-18,21
AGF Aarhus,5502,11,4,6,12,16,37,-21,18
Brondby,5503,1,20,6,4,65,33,32,66
FC Midtjylla,5503,2,20,5,5,65,36,29,65
Copenhagen,5503,3,14,7,9,56,39,17,49
FC Nords,5503,4,13,6,11,68,56,12,45
AaB,5503,5,8,11,11,39,43,-4,35
AC Horsens,5503,6,7,13,10,38,50,-12,34
Sonderjyske,5503,7,8,6,10,28,29,-1,30
Lyngby,5503,8,4,9,11,27,44,-17,21
Randers FC,5503,9,5,6,13,23,40,-17,21
Silkeborg IF,5503,10,6,3,13,26,44,-18,21
AGF Aarhus,5503,11,4,6,12,16,37,-21,18
Brondby,5504,1,22,5,3,72,31,41,71
FC Midtjylla,5504,2,18,5,7,64,44,20,59
FC Nords,5504,3,14,9,7,71,48,23,51
Copenhagen,5504,4,13,6,11,56,44,12,45
AaB,5504,5,7,13,10,39,43,-4,34
AC Horsens,5504,6,7,12,11,35,53,-18,33
Sonderjyske,5504,7,8,6,10,28,29,-1,30
Lyngby,5504,8,4,9,11,29,46,-17,21
Silkeborg IF,5504,9,6,3,13,28,45,-17,21
Randers FC,5504,10,5,6,13,25,42,-17,21
AGF Aarhus,5504,11,4,6,12,17,39,-22,18
Brondby,5505,1,21,5,4,68,31,37,68
FC Midtjylla,5505,2,20,5,5,67,35,32,65
FC Nords,5505,3,13,7,10,67,50,17,46
Copenhagen,5505,4,13,6,11,56,46,10,45
AaB,5505,5,9,13,8,39,38,1,40
Sonderjyske,5505,6,8,6,10,28,29,-1,30
AC Horsens,5505,7,6,12,12,34,57,-23,30
Lyngby,5505,8,4,9,11,27,44,-17,21
Randers FC,5505,9,5,6,13,23,40,-17,21
Silkeborg IF,5505,10,5,4,13,26,45,-19,19
AGF Aarhus,5505,11,4,7,11,17,37,-20,19
Brondby,5506,1,21,7,2,67,29,38,70
FC Midtjylla,5506,2,19,5,6,60,36,24,62
FC Nords,5506,3,15,7,8,72,47,25,52
Copenhagen,5506,4,15,4,11,59,42,17,49
AC Horsens,5506,5,6,14,10,33,52,-19,32
Sonderjyske,5506,6,8,6,10,28,29,-1,30
AaB,5506,7,6,11,13,33,44,-11,29
Lyngby,5506,8,4,9,11,28,44,-16,21
Randers FC,5506,9,5,6,13,23,41,-18,21
Silkeborg IF,5506,10,5,4,13,25,44,-19,19
AGF Aarhus,5506,11,4,7,11,16,36,-20,19
Brondby,5507,1,20,6,4,70,35,35,66
FC Midtjylla,5507,2,19,5,6,63,39,24,62
FC Nords,5507,3,15,6,9,74,51,23,51
Copenhagen,5507,4,15,4,11,61,44,17,49
AC Horsens,5507,5,7,13,10,37,55,-18,34
AaB,5507,6,6,14,10,36,43,-7,32
Sonderjyske,5507,7,8,6,10,28,29,-1,30
Lyngby,5507,8,4,9,11,29,44,-15,21
Silkeborg IF,5507,9,6,3,13,28,45,-17,21
Randers FC,5507,10,5,6,13,23,42,-19,21
AGF Aarhus,5507,11,4,6,12,17,39,-22,18
Brondby,5508,1,20,5,5,69,34,35,65
FC Midtjylla,5508,2,20,4,6,67,36,31,64
FC Nords,5508,3,14,6,10,73,57,16,48
Copenhagen,5508,4,14,4,12,55,42,13,46
AaB,5508,5,9,11,10,35,41,-6,38
AC Horsens,5508,6,8,12,10,35,50,-15,36
Sonderjyske,5508,7,8,6,10,28,29,-1,30
Lyngby,5508,8,4,9,11,29,44,-15,21
Silkeborg IF,5508,9,6,3,13,27,45,-18,21
Randers FC,5508,10,5,6,13,23,42,-19,21
AGF Aarhus,5508,11,4,6,12,17,38,-21,18
Brondby,5509,1,22,5,3,68,29,39,71
FC Midtjylla,5509,2,20,4,6,69,39,30,64
Copenhagen,5509,3,14,5,11,56,44,12,47
FC Nords,5509,4,13,6,11,68,53,15,45
AaB,5509,5,8,12,10,38,40,-2,36
AC Horsens,5509,6,7,12,11,35,55,-20,33
Sonderjyske,5509,7,8,6,10,28,29,-1,30
Lyngby,5509,8,4,9,11,28,45,-17,21
Randers FC,5509,9,5,6,13,24,41,-17,21
Silkeborg IF,5509,10,5,4,13,25,44,-19,19
AGF Aarhus,5509,11,4,7,11,16,36,-20,19
Brondby,5510,1,22,6,2,76,32,44,72
FC Midtjylla,5510,2,19,5,6,64,41,23,62
FC Nords,5510,3,15,6,9,72,50,22,51
Copenhagen,5510,4,13,6,11,57,44,13,45
AaB,5510,5,7,12,11,35,43,-8,33
Sonderjyske,5510,6,8,6,10,28,29,-1,30
AC Horsens,5510,7,5,15,10,33,53,-20,30
Randers FC,5510,8,5,7,12,24,40,-16,22
AGF Aarhus,5510,9,5,6,11,20,36,-16,21
Lyngby,5510,10,3,10,11,27,45,-18,19
Silkeborg IF,5510,11,5,3,14,25,48,-23,18
Brondby,5511,1,21,6,3,73,31,42,69
FC Midtjylla,5511,2,18,5,7,65,43,22,59
FC Nords,5511,3,15,7,8,77,51,26,52
Copenhagen,5511,4,15,5,10,57,43,14,50
AC Horsens,5511,5,7,13,10,36,54,-18,34
Sonderjyske,5511,6,8,6,10,28,29,-1,30
AaB,5511,7,6,12,12,34,46,-12,30
Randers FC,5511,8,6,6,12,26,39,-13,24
Silkeborg IF,5511,9,6,3,13,27,45,-18,21
Lyngby,5511,10,3,9,12,26,47,-21,18
AGF Aarhus,5511,11,4,6,12,17,38,-21,18
Brondby,5512,1,21,5,4,76,39,37,68
FC Midtjylla,5512,2,21,4,5,69,41,28,67
Copenhagen,5512,3,16,5,9,64,44,20,53
FC Nords,5512,4,14,7,9,75,54,21,49
Sonderjyske,5512,5,8,6,10,28,29,-1,30
AC Horsens,5512,6,6,12,12,36,57,-21,30
AaB,5512,7,6,11,13,37,48,-11,29
Randers FC,5512,8,5,7,12,25,41,-16,22
Lyngby,5512,9,3,10,11,28,46,-18,19
Silkeborg IF,5512,10,5,4,13,25,44,-19,19
AGF Aarhus,5512,11,4,7,11,16,36,-20,19
Brondby,5513,1,21,7,2,70,31,39,70
FC Midtjylla,5513,2,19,5,6,62,38,24,62
Copenhagen,5513,3,14,7,9,55,39,16,49
FC Nords,5513,4,13,6,11,70,55,15,45
AaB,5513,5,7,12,11,36,44,-8,33
AC Horsens,5513,6,6,15,9,37,49,-12,33
Sonderjyske,5513,7,8,6,10,28,29,-1,30
Lyngby,5513,8,4,9,11,29,46,-17,21
Randers FC,5513,9,5,6,13,25,42,-17,21
AGF Aarhus,5513,10,5,6,11,17,36,-19,21
Silkeborg IF,5513,11,5,3,14,25,45,-20,18
Brondby,5514,1,20,6,4,67,36,31,66
FC Midtjylla,5514,2,19,5,6,62,38,24,62
Copenhagen,5514,3,15,5,10,60,42,18,50
FC Nords,5514,4,14,7,9,75,52,23,49
AaB,5514,5,9,12,9,42,40,2,39
Sonderjyske,5514,6,8,6,10,28,29,-1,30
AC Horsens,5514,7,5,13,12,31,55,-24,28
Silkeborg IF,5514,8,6,3,13,29,45,-16,21
Lyngby,5514,9,4,9,11,27,44,-17,21
Randers FC,5514,10,5,6,13,23,40,-17,21
AGF Aarhus,5514,11,4,6,12,17,40,-23,18
Brondby,5515,1,21,5,4,73,34,39,68
FC Midtjylla,5515,2,18,5,7,68,43,25,59
FC Nords,5515,3,15,6,9,77,58,19,51
Copenhagen,5515,4,13,4,13,57,54,3,43
AaB,5515,5,9,11,10,40,44,-4,38
AC Horsens,5515,6,8,13,9,41,49,-8,37
Sonderjyske,5515,7,8,6,10,28,29,-1,30
AGF Aarhus,5515,8,5,6,11,20,36,-16,21
Lyngby,5515,9,4,9,11,29,46,-17,21
Randers FC,5515,10,5,6,13,25,42,-17,21
Silkeborg IF,5515,11,5,3,14,25,48,-23,18
Brondby,5516,1,22,6,2,74,31,43,72
FC Midtjylla,5516,2,19,5,6,63,39,24,62
FC Nords,5516,3,14,8,8,72,49,23,50
Copenhagen,5516,4,14,7,9,58,40,18,49
AaB,5516,5,6,13,11,34,42,-8,31
Sonderjyske,5516,6,8,6,10,28,29,-1,30
AC Horsens,5516,7,5,13,12,33,59,-26,28
Randers FC,5516,8,6,6,12,27,42,-15,24
Silkeborg IF,5516,9,5,4,13,26,45,-19,19
AGF Aarhus,5516,10,4,7,11,17,37,-20,19
Lyngby,5516,11,3,9,12,29,48,-19,18
Brondby,5517,1,20,6,4,70,36,34,66
FC Midtjylla,5517,2,19,5,6,62,38,24,62
FC Nords,5517,3,15,6,9,74,51,23,51
Copenhagen,5517,4,15,4,11,62,50,12,49
AaB,5517,5,9,11,10,40,43,-3,38
Sonderjyske,5517,6,8,6,10,28,29,-1,30
AC Horsens,5517,7,6,12,12,38,54,-16,30
Randers FC,5517,8,5,7,12,25,41,-16,22
Silkeborg IF,5517,9,6,3,13,28,45,-17,21
Lyngby,5517,10,3,10,11,28,46,-18,19
AGF Aarhus,5517,11,4,6,12,17,39,-22,18
Brondby,5518,1,22,5,3,74,31,43,71
FC Midtjylla,5518,2,19,5,6,62,38,24,62
FC Nords,5518,3,15,6,9,73,51,22,51
Copenhagen,5518,4,14,5,11,58,44,14,47
AC Horsens,5518,5,7,12,11,33,53,-20,33
AaB,5518,6,7,11,12,34,43,-9,32
Sonderjyske,5518,7,8,6,10,28,29,-1,30
Lyngby,5518,8,4,9,11,29,45,-16,21
Silkeborg IF,5518,8,6,3,13,29,45,-16,21
Randers FC,5518,10,5,6,13,24,42,-18,21
AGF Aarhus,5518,11,4,6,12,17,40,-23,18
FC Midtjylla,5519,1,20,5,5,65,37,28,65
Brondby,5519,2,19,7,4,71,36,35,64
Copenhagen,5519,3,14,7,9,62,44,18,49
FC Nords,5519,4,13,7,10,72,57,15,46
AaB,5519,5,8,13,9,38,40,-2,37
Sonderjyske,5519,6,8,6,10,28,29,-1,30
AC Horsens,5519,7,5,15,10,31,51,-20,30
Lyngby,5519,8,4,9,11,29,45,-16,21
Randers FC,5519,9,5,6,13,24,42,-18,21
Silkeborg IF,5519,10,5,4,13,27,46,-19,19
AGF Aarhus,5519,11,4,7,11,18,38,-20,19
Brondby,5520,1,20,7,3,70,31,39,67
FC Midtjylla,5520,2,20,4,6,63,41,22,64
Copenhagen,5520,3,14,5,11,60,45,15,47
FC Nords,5520,4,13,7,10,72,53,19,46
AaB,5520,5,9,12,9,36,38,-2,39
AC Horsens,5520,6,6,13,11,33,52,-19,31
Sonderjyske,5520,7,8,6,10,28,29,-1,30
Lyngby,5520,8,4,9,11,28,44,-16,21
Silkeborg IF,5520,8,6,3,13,28,44,-16,21
Randers FC,5520,10,5,6,13,23,41,-18,21
AGF Aarhus,5520,11,4,6,12,16,39,-23,18
Brondby,5521,1,21,6,3,70,32,38,69
FC Midtjylla,5521,2,20,5,5,68,38,30,65
FC Nords,5521,3,13,7,10,74,56,18,46
Copenhagen,5521,4,12,6,12,59,50,9,42
AC Horsens,5521,5,9,12,9,38,50,-12,39
AaB,5521,6,7,12,11,37,46,-9,33
Sonderjyske,5521,7,8,6,10,28,29,-1,30
Lyngby,5521,8,4,9,11,28,45,-17,21
Randers FC,5521,9,5,6,13,24,41,-17,21
AGF Aarhus,5521,10,5,6,11,17,36,-19,21
Silkeborg IF,5521,11,5,3,14,25,45,-20,18
Brondby,5522,1,20,5,5,71,41,30,65
FC Midtjylla,5522,2,20,4,6,70,40,30,64
Copenhagen,5522,3,16,4,10,61,44,17,52
FC Nords,5522,4,14,7,9,76,56,20,49
AaB,5522,5,8,12,10,36,44,-8,36
Sonderjyske,5522,6,8,6,10,28,29,-1,30
AC Horsens,5522,7,6,12,12,38,53,-15,30
Randers FC,5522,8,6,6,12,24,39,-15,24
Silkeborg IF,5522,9,6,3,13,27,44,-17,21
Lyngby,5522,10,3,9,12,26,45,-19,18
AGF Aarhus,5522,11,4,6,12,16,38,-22,18
Brondby,5523,1,21,7,2,71,31,40,70
FC Midtjylla,5523,2,20,5,5,67,36,31,65
Copenhagen,5523,3,13,7,10,56,41,15,46
FC Nords,5523,4,12,9,9,69,53,16,45
AaB,5523,5,7,13,10,35,43,-8,34
Sonderjyske,5523,6,8,6,10,28,29,-1,30
AC Horsens,5523,7,5,15,10,36,56,-20,30
Randers FC,5523,8,5,7,12,24,40,-16,22
Lyngby,5523,9,3,10,11,27,45,-18,19
Silkeborg IF,5523,10,5,4,13,25,44,-19,19
AGF Aarhus,5523,11,4,7,11,16,36,-20,19
Brondby,5524,1,21,6,3,71,32,39,69
FC Midtjylla,5524,2,19,5,6,63,41,22,62
FC Nords,5524,3,14,7,9,72,49,23,49
Copenhagen,5524,4,13,7,10,59,45,14,46
AC Horsens,5524,5,7,13,10,35,50,-15,34
AaB,5524,6,7,12,11,36,45,-9,33
Sonderjyske,5524,7,8,6,10,28,29,-1,30
Lyngby,5524,8,4,9,11,27,44,-17,21
Randers FC,5524,9,5,6,13,23,40,-17,21
Silkeborg IF,5524,10,5,4,13,25,44,-19,19
AGF Aarhus,5524,11,4,7,11,16,36,-20,19
Brondby,5525,1,21,6,3,70,32,38,69
FC Midtjylla,5525,2,20,5,5,64,37,27,65
FC Nords,5525,3,14,7,9,72,52,20,49
Copenhagen,5525,4,14,6,10,56,44,12,48
AaB,5525,5,7,12,11,41,46,-5,33
Sonderjyske,5525,6,8,6,10,28,29,-1,30
AC Horsens,5525,7,6,12,12,34,52,-18,30
Randers FC,5525,8,6,6,12,25,39,-14,24
AGF Aarhus,5525,9,5,6,11,18,37,-19,21
Lyngby,5525,10,3,9,12,26,46,-20,18
Silkeborg IF,5525,10,5,3,14,26,46,-20,18
Brondby,5526,1,20,6,4,69,33,36,66
FC Midtjylla,5526,2,20,4,6,68,40,28,64
FC Nords,5526,3,15,6,9,75,50,25,51
Copenhagen,5526,4,15,5,10,62,47,15,50
AaB,5526,5,7,13,10,36,43,-7,34
Sonderjyske,5526,6,8,6,10,28,29,-1,30
AC Horsens,5526,7,5,14,11,34,57,-23,29
Lyngby,5526,8,4,9,11,27,44,-17,21
Randers FC,5526,9,5,6,13,23,40,-17,21
Silkeborg IF,5526,10,6,3,13,27,45,-18,21
AGF Aarhus,5526,11,4,6,12,17,38,-21,18
FC Midtjylla,5527,1,21,4,5,69,39,30,67
Brondby,5527,2,19,5,6,67,36,31,62
FC Nords,5527,3,14,7,9,72,52,20,49
Copenhagen,5527,4,15,4,11,59,45,14,49
AaB,5527,5,8,13,9,39,41,-2,37
AC Horsens,5527,6,6,13,11,35,54,-19,31
Sonderjyske,5527,7,8,6,10,28,29,-1,30
Lyngby,5527,8,4,9,11,29,45,-16,21
Silkeborg IF,5527,9,6,3,13,26,44,-18,21
Randers FC,5527,10,5,6,13,24,42,-18,21
AGF Aarhus,5527,11,4,6,12,16,37,-21,18
Brondby,5528,1,22,5,3,73,33,40,71
FC Midtjylla,5528,2,20,4,6,65,40,25,64
FC Nords,5528,3,15,7,8,77,51,26,52
Copenhagen,5528,4,13,5,12,59,49,10,44
AC Horsens,5528,5,7,13,10,37,52,-15,34
Sonderjyske,5528,6,8,6,10,28,29,-1,30
AaB,5528,7,6,12,12,36,48,-12,30
Randers FC,5528,8,5,7,12,24,40,-16,22
Silkeborg IF,5528,9,6,3,13,27,45,-18,21
Lyngby,5528,10,3,10,11,27,45,-18,19
AGF Aarhus,5528,11,4,6,12,17,38,-21,18
Brondby,5529,1,21,6,3,68,32,36,69
FC Midtjylla,5529,2,18,6,6,64,39,25,60
FC Nords,5529,3,16,6,8,79,50,29,54
Copenhagen,5529,4,14,5,11,56,43,13,47
AaB,5529,5,8,11,11,35,44,-9,35
Sonderjyske,5529,6,8,6,10,28,29,-1,30
AC Horsens,5529,7,5,14,11,34,54,-20,29
Randers FC,5529,8,6,6,12,24,39,-15,24
Silkeborg IF,5529,9,5,4,13,25,44,-19,19
AGF Aarhus,5529,10,4,7,11,16,36,-20,19
Lyngby,5529,11,3,9,12,26,45,-19,18
FC Midtjylla,5530,1,21,5,4,67,37,30,68
Brondby,5530,2,19,6,5,68,33,35,63
FC Nords,5530,3,15,6,9,75,50,25,51
Copenhagen,5530,4,13,5,12,52,44,8,44
AC Horsens,5530,5,7,14,9,35,49,-14,35
AaB,5530,6,7,12,11,38,48,-10,33
Sonderjyske,5530,7,8,6,10,28,29,-1,30
Lyngby,5530,8,4,9,11,29,44,-15,21
Silkeborg IF,5530,9,6,3,13,26,44,-18,21
Randers FC,5530,10,5,6,13,23,42,-19,21
AGF Aarhus,5530,11,4,6,12,16,37,-21,18
Brondby,5531,1,22,5,3,70,30,40,71
FC Midtjylla,5531,2,20,6,4,70,39,31,66
FC Nords,5531,3,14,7,9,70,52,18,49
Copenhagen,5531,4,14,5,11,60,48,12,47
AaB,5531,5,6,13,11,36,45,-9,31
Sonderjyske,5531,6,8,6,10,28,29,-1,30
AC Horsens,5531,7,6,12,12,33,51,-18,30
Randers FC,5531,8,5,7,12,23,39,-16,22
AGF Aarhus,5531,9,5,6,11,19,37,-18,21
Lyngby,5531,10,3,10,11,26,44,-18,19
Silkeborg IF,5531,11,5,3,14,26,47,-21,18
Brondby,5532,1,20,7,3,73,31,42,67
FC Midtjylla,5532,2,21,4,5,63,40,23,67
Copenhagen,5532,3,15,5,10,60,43,17,50
FC Nords,5532,4,13,6,11,69,53,16,45
AaB,5532,5,9,11,10,41,42,-1,38
Sonderjyske,5532,6,8,6,10,28,29,-1,30
AC Horsens,5532,7,5,13,12,32,55,-23,28
Randers FC,5532,8,5,7,12,25,41,-16,22
Silkeborg IF,5532,9,6,3,13,26,44,-18,21
Lyngby,5532,10,3,10,11,28,46,-18,19
AGF Aarhus,5532,11,4,6,12,16,37,-21,18
FC Midtjylla,5533,1,21,4,5,72,39,33,67
Brondby,5533,2,20,5,5,67,36,31,65
Copenhagen,5533,3,17,4,9,65,42,23,55
FC Nords,5533,4,14,6,10,75,57,18,48
AaB,5533,5,8,11,11,37,43,-6,35
Sonderjyske,5533,6,8,6,10,28,29,-1,30
AC Horsens,5533,7,5,12,13,29,54,-25,27
Randers FC,5533,8,6,6,12,27,41,-14,24
Silkeborg IF,5533,9,5,4,13,26,45,-19,19
AGF Aarhus,5533,10,4,7,11,17,37,-20,19
Lyngby,5533,11,3,9,12,28,48,-20,18
Brondby,5534,1,22,6,2,71,30,41,72
FC Midtjylla,5534,2,19,4,7,64,40,24,61
Copenhagen,5534,3,14,5,11,58,45,13,47
FC Nords,5534,4,13,7,10,74,56,18,46
AaB,5534,5,9,11,10,41,43,-2,38
AC Horsens,5534,6,6,13,11,33,53,-20,31
Sonderjyske,5534,7,8,6,10,28,29,-1,30
Randers FC,5534,8,6,6,12,26,39,-13,24
Silkeborg IF,5534,9,5,4,13,27,46,-19,19
AGF Aarhus,5534,10,4,7,11,18,38,-20,19
Lyngby,5534,11,3,9,12,26,47,-21,18
Brondby,5535,1,22,6,2,79,30,49,72
FC Midtjylla,5535,2,19,4,7,63,40,23,61
FC Nords,5535,3,13,9,8,73,52,21,48
Copenhagen,5535,4,13,6,11,60,51,9,45
AaB,5535,5,8,13,9,37,43,-6,37
Sonderjyske,5535,6,8,6,10,28,29,-1,30
AC Horsens,5535,7,6,12,12,36,58,-22,30
Randers FC,5535,8,5,7,12,24,40,-16,22
AGF Aarhus,5535,9,5,6,11,18,36,-18,21
Lyngby,5535,10,3,10,11,27,45,-18,19
Silkeborg IF,5535,11,5,3,14,25,46,-21,18
Brondby,5536,1,21,6,3,73,33,40,69
FC Midtjylla,5536,2,18,6,6,62,39,23,60
FC Nords,5536,3,15,7,8,77,53,24,52
Copenhagen,5536,4,13,5,12,58,46,12,44
AaB,5536,5,8,12,10,36,42,-6,36
AC Horsens,5536,6,6,14,10,38,57,-19,32
Sonderjyske,5536,7,8,6,10,28,29,-1,30
Randers FC,5536,8,5,7,12,24,40,-16,22
AGF Aarhus,5536,9,5,6,11,18,37,-19,21
Lyngby,5536,10,3,10,11,27,45,-18,19
Silkeborg IF,5536,11,5,3,14,26,46,-20,18
Brondby,5537,1,21,7,2,75,35,40,70
FC Midtjylla,5537,2,18,6,6,65,41,24,60
FC Nords,5537,3,16,6,8,79,51,28,54
Copenhagen,5537,4,12,7,11,54,46,8,43
AaB,5537,5,7,13,10,37,42,-5,34
AC Horsens,5537,6,6,13,11,31,52,-21,31
Sonderjyske,5537,7,8,6,10,28,29,-1,30
Randers FC,5537,8,5,7,12,23,39,-16,22
Lyngby,5537,9,3,10,11,26,44,-18,19
Silkeborg IF,5537,10,5,4,13,26,45,-19,19
AGF Aarhus,5537,11,4,7,11,17,37,-20,19
Brondby,5538,1,21,6,3,77,35,42,69
FC Midtjylla,5538,2,20,4,6,64,40,24,64
Copenhagen,5538,3,15,6,9,63,42,21,51
FC Nords,5538,4,14,7,9,75,54,21,49
AC Horsens,5538,5,6,13,11,37,53,-16,31
Sonderjyske,5538,6,8,6,10,28,29,-1,30
AaB,5538,7,6,12,12,35,53,-18,30
Silkeborg IF,5538,8,6,3,13,28,44,-16,21
Lyngby,5538,9,4,9,11,27,44,-17,21
Randers FC,5538,10,5,6,13,23,40,-17,21
AGF Aarhus,5538,11,4,6,12,16,39,-23,18
Brondby,5539,1,21,7,2,70,29,41,70
FC Midtjylla,5539,2,20,5,5,61,34,27,65
FC Nords,5539,3,15,6,9,77,51,26,51
Copenhagen,5539,4,13,4,13,58,52,6,43
AaB,5539,5,7,13,10,34,40,-6,34
AC Horsens,5539,6,6,13,11,36,56,-20,31
Sonderjyske,5539,7,8,6,10,28,29,-1,30
Lyngby,5539,8,4,9,11,27,44,-17,21
Randers FC,5539,9,5,6,13,23,40,-17,21
AGF Aarhus,5539,10,5,6,11,17,36,-19,21
Silkeborg IF,5539,11,5,3,14,25,45,-20,18
Brondby,5540,1,21,7,2,72,32,40,70
FC Midtjylla,5540,2,19,4,7,65,41,24,61
FC Nords,5540,3,15,8,7,73,46,27,53
Copenhagen,5540,4,13,5,12,53,43,10,44
AaB,5540,5,6,14,10,37,46,-9,32
AC Horsens,5540,6,6,14,10,37,55,-18,32
Sonderjyske,5540,7,8,6,10,28,29,-1,30
Randers FC,5540,8,6,6,12,28,39,-11,24
Silkeborg IF,5540,9,6,3,13,27,45,-18,21
AGF Aarhus,5540,10,4,6,12,17,38,-21,18
Lyngby,5540,11,3,9,12,26,49,-23,18
Brondby,5541,1,19,8,3,65,29,36,65
FC Midtjylla,5541,2,19,5,6,65,42,23,62
Copenhagen,5541,3,13,7,10,59,44,15,46
FC Nords,5541,4,12,9,9,68,50,18,45
AaB,5541,5,9,12,9,38,41,-3,39
AC Horsens,5541,6,7,13,10,34,49,-15,34
Sonderjyske,5541,7,8,6,10,28,29,-1,30
Lyngby,5541,8,4,9,11,27,44,-17,21
Randers FC,5541,9,5,6,13,23,40,-17,21
Silkeborg IF,5541,10,5,4,13,26,45,-19,19
AGF Aarhus,5541,11,4,7,11,17,37,-20,19
FC Midtjylla,5542,1,20,6,4,70,39,31,66
Brondby,5542,2,19,7,4,69,35,34,64
Copenhagen,5542,3,14,6,10,60,47,13,48
FC Nords,5542,4,13,8,9,76,56,20,47
AaB,5542,5,7,14,9,40,43,-3,35
AC Horsens,5542,6,6,13,11,36,57,-21,31
Sonderjyske,5542,7,8,6,10,28,29,-1,30
Randers FC,5542,8,5,7,12,24,40,-16,22
Lyngby,5542,9,3,10,11,27,45,-18,19
Silkeborg IF,5542,10,5,4,13,25,44,-19,19
AGF Aarhus,5542,11,4,7,11,16,36,-20,19
Brondby,5543,1,21,6,3,71,33,38,69
FC Midtjylla,5543,2,20,4,6,68,41,27,64
FC Nords,5543,3,14,8,8,75,48,27,50
Copenhagen,5543,4,13,4,13,53,45,8,43
AaB,5543,5,8,12,10,38,42,-4,36
AC Horsens,5543,6,7,12,11,32,54,-22,33
Sonderjyske,5543,7,8,6,10,28,29,-1,30
Randers FC,5543,8,6,6,12,24,39,-15,24
Silkeborg IF,5543,9,5,4,13,27,46,-19,19
AGF Aarhus,5543,10,4,7,11,18,38,-20,19
Lyngby,5543,11,3,9,12,26,45,-19,18
FC Midtjylla,5544,1,22,4,4,66,35,31,70
Brondby,5544,2,20,7,3,70,32,38,67
FC Nords,5544,3,14,8,8,74,52,22,50
Copenhagen,5544,4,13,5,12,55,45,10,44
AaB,5544,5,7,11,12,35,44,-9,32
AC Horsens,5544,6,6,13,11,32,50,-18,31
Sonderjyske,5544,7,8,6,10,28,29,-1,30
Lyngby,5544,8,4,9,11,29,45,-16,21
Randers FC,5544,9,5,6,13,24,42,-18,21
Silkeborg IF,5544,10,5,4,13,26,45,-19,19
AGF Aarhus,5544,11,4,7,11,17,37,-20,19
Brondby,5545,1,22,6,2,78,31,47,72
FC Midtjylla,5545,2,20,5,5,65,38,27,65
Copenhagen,5545,3,14,4,12,59,46,13,46
FC Nords,5545,4,13,6,11,71,63,8,45
AaB,5545,5,8,12,10,37,42,-5,36
AC Horsens,5545,6,6,13,11,36,52,-16,31
Sonderjyske,5545,7,8,6,10,28,29,-1,30
Randers FC,5545,8,6,6,12,26,39,-13,24
Silkeborg IF,5545,9,5,4,13,26,45,-19,19
AGF Aarhus,5545,10,4,7,11,17,37,-20,19
Lyngby,5545,11,3,9,12,26,47,-21,18
Brondby,5546,1,20,5,5,69,35,34,65
FC Midtjylla,5546,2,20,5,5,65,39,26,65
FC Nords,5546,3,15,6,9,75,49,26,51
Copenhagen,5546,4,12,5,13,55,49,6,41
AC Horsens,5546,5,9,12,9,42,51,-9,39
AaB,5546,6,8,11,11,38,47,-9,35
Sonderjyske,5546,7,8,6,10,28,29,-1,30
Randers FC,5546,8,6,6,12,25,39,-14,24
Silkeborg IF,5546,9,6,3,13,28,45,-17,21
Lyngby,5546,10,3,9,12,26,46,-20,18
AGF Aarhus,5546,11,4,6,12,17,39,-22,18
Brondby,5547,1,20,5,5,68,38,30,65
FC Midtjylla,5547,2,19,6,5,62,37,25,63
FC Nords,5547,3,16,7,7,81,51,30,55
Copenhagen,5547,4,13,5,12,53,44,9,44
AaB,5547,5,8,12,10,40,44,-4,36
AC Horsens,5547,6,6,13,11,36,52,-16,31
Sonderjyske,5547,7,8,6,10,28,29,-1,30
Randers FC,5547,8,5,7,12,24,40,-16,22
Silkeborg IF,5547,9,6,3,13,27,44,-17,21
Lyngby,5547,10,3,10,11,27,45,-18,19
AGF Aarhus,5547,11,4,6,12,16,38,-22,18
Brondby,5548,1,21,7,2,73,31,42,70
FC Midtjylla,5548,2,21,4,5,68,39,29,67
Copenhagen,5548,3,14,6,10,59,44,15,48
FC Nords,5548,4,12,6,12,72,58,14,42
AC Horsens,5548,5,7,13,10,37,55,-18,34
AaB,5548,6,7,12,11,37,45,-8,33
Sonderjyske,5548,7,8,6,10,28,29,-1,30
Randers FC,5548,8,5,7,12,23,39,-16,22
AGF Aarhus,5548,9,5,6,11,17,36,-19,21
Lyngby,5548,10,3,10,11,26,44,-18,19
Silkeborg IF,5548,11,5,3,14,25,45,-20,18
Brondby,5549,1,21,6,3,76,33,43,69
FC Midtjylla,5549,2,19,5,6,66,45,21,62
FC Nords,5549,3,14,7,9,73,55,18,49
Copenhagen,5549,4,13,6,11,58,47,11,45
AaB,5549,5,8,11,11,40,44,-4,35
AC Horsens,5549,6,7,13,10,36,51,-15,34
Sonderjyske,5549,7,8,6,10,28,29,-1,30
Randers FC,5549,8,5,7,12,24,40,-16,22
AGF Aarhus,5549,9,5,6,11,17,36,-19,21
Lyngby,5549,10,3,10,11,27,45,-18,19
Silkeborg IF,5549,11,5,3,14,25,45,-20,18
Brondby,5550,1,22,5,3,76,33,43,71
FC Midtjylla,5550,2,19,6,5,66,40,26,63
FC Nords,5550,3,14,8,8,71,50,21,50
Copenhagen,5550,4,13,7,10,57,44,13,46
AaB,5550,5,6,13,11,37,47,-10,31
Sonderjyske,5550,6,8,6,10,28,29,-1,30
AC Horsens,5550,7,5,15,10,35,54,-19,30
Lyngby,5550,8,4,9,11,28,44,-16,21
Randers FC,5550,9,5,6,13,23,41,-18,21
AGF Aarhus,5550,10,5,6,11,19,38,-19,21
Silkeborg IF,5550,11,5,3,14,27,47,-20,18
FC Midtjylla,5551,1,21,4,5,65,36,29,67
Brondby,5551,2,20,6,4,68,34,34,66
Copenhagen,5551,3,15,5,10,66,45,21,50
FC Nords,5551,4,12,9,9,72,57,15,45
AaB,5551,5,8,11,11,40,42,-2,35
AC Horsens,5551,6,6,13,11,36,59,-23,31
Sonderjyske,5551,7,8,6,10,28,29,-1,30
Randers FC,5551,8,5,7,12,23,39,-16,22
Lyngby,5551,9,3,10,11,26,44,-18,19
Silkeborg IF,5551,10,5,4,13,26,45,-19,19
AGF Aarhus,5551,11,4,7,11,17,37,-20,19
FC Midtjylla,5552,1,21,5,4,69,41,28,68
Brondby,5552,2,18,9,3,71,37,34,63
FC Nords,5552,3,14,7,9,75,52,23,49
Copenhagen,5552,4,13,6,11,58,47,11,45
AC Horsens,5552,5,7,14,9,37,49,-12,35
AaB,5552,6,6,13,11,34,44,-10,31
Sonderjyske,5552,7,8,6,10,28,29,-1,30
Randers FC,5552,8,6,6,12,24,39,-15,24
Silkeborg IF,5552,9,6,3,13,28,44,-16,21
Lyngby,5552,10,3,9,12,26,45,-19,18
AGF Aarhus,5552,11,4,6,12,16,39,-23,18
Brondby,5553,1,23,5,2,75,28,47,74
FC Midtjylla,5553,2,19,5,6,67,43,24,62
FC Nords,5553,3,16,6,8,80,50,30,54
Copenhagen,5553,4,13,5,12,53,46,7,44
AaB,5553,5,7,12,11,35,43,-8,33
Sonderjyske,5553,6,8,6,10,28,29,-1,30
AC Horsens,5553,7,5,13,12,32,58,-26,28
Randers FC,5553,8,6,6,12,27,40,-13,24
Silkeborg IF,5553,9,5,4,13,26,45,-19,19
AGF Aarhus,5553,10,4,7,11,17,37,-20,19
Lyngby,5553,11,3,9,12,27,48,-21,18
Brondby,5554,1,20,6,4,71,34,37,66
FC Midtjylla,5554,2,20,6,4,69,41,28,66
FC Nords,5554,3,15,6,9,77,54,23,51
Copenhagen,5554,4,14,5,11,59,46,13,47
AaB,5554,5,7,12,11,37,46,-9,33
AC Horsens,5554,6,6,13,11,39,57,-18,31
Sonderjyske,5554,7,8,6,10,28,29,-1,30
Randers FC,5554,8,6,6,12,27,40,-13,24
Silkeborg IF,5554,9,6,3,13,27,45,-18,21
Lyngby,5554,10,3,9,12,27,48,-21,18
AGF Aarhus,5554,11,4,6,12,17,38,-21,18
Brondby,5555,1,21,6,3,70,32,38,69
FC Midtjylla,5555,2,21,4,5,73,38,35,67
FC Nords,5555,3,14,6,10,74,56,18,48
Copenhagen,5555,4,14,5,11,58,45,13,47
AC Horsens,5555,5,7,12,11,35,55,-20,33
AaB,5555,6,7,11,12,35,45,-10,32
Sonderjyske,5555,7,8,6,10,28,29,-1,30
Lyngby,5555,8,4,9,11,27,44,-17,21
Randers FC,5555,9,5,6,13,23,40,-17,21
Silkeborg IF,5555,10,5,4,13,26,45,-19,19
AGF Aarhus,5555,11,4,7,11,17,37,-20,19
Brondby,5556,1,21,5,4,68,32,36,68
FC Midtjylla,5556,2,20,5,5,65,35,30,65
FC Nords,5556,3,16,6,8,76,51,25,54
Copenhagen,5556,4,13,5,12,54,47,7,44
AC Horsens,5556,5,7,12,11,37,51,-14,33
AaB,5556,6,7,11,12,39,49,-10,32
Sonderjyske,5556,7,8,6,10,28,29,-1,30
Randers FC,5556,8,5,7,12,24,40,-16,22
Silkeborg IF,5556,9,6,3,13,26,44,-18,21
Lyngby,5556,10,3,10,11,27,45,-18,19
AGF Aarhus,5556,11,4,6,12,16,37,-21,18
Brondby,5557,1,22,6,2,70,29,41,72
FC Midtjylla,5557,2,19,5,6,65,38,27,62
FC Nords,5557,3,14,7,9,75,54,21,49
Copenhagen,5557,4,13,8,9,58,44,14,47
AaB,5557,5,7,12,11,33,41,-8,33
Sonderjyske,5557,6,8,6,10,28,29,-1,30
AC Horsens,5557,7,6,12,12,34,55,-21,30
Lyngby,5557,8,4,9,11,28,45,-17,21
Silkeborg IF,5557,9,6,3,13,27,44,-17,21
Randers FC,5557,10,5,6,13,24,41,-17,21
AGF Aarhus,5557,11,4,6,12,16,38,-22,18
Brondby,5558,1,22,5,3,69,28,41,71
FC Midtjylla,5558,2,20,6,4,67,37,30,66
FC Nords,5558,3,14,8,8,73,51,22,50
Copenhagen,5558,4,13,6,11,56,43,13,45
AaB,5558,5,6,14,10,35,45,-10,32
Sonderjyske,5558,6,8,6,10,28,29,-1,30
AC Horsens,5558,7,5,13,12,33,55,-22,28
Lyngby,5558,8,4,9,11,30,44,-14,21
Silkeborg IF,5558,9,6,3,13,28,45,-17,21
Randers FC,5558,10,5,6,13,23,43,-20,21
AGF Aarhus,5558,11,4,6,12,17,39,-22,18
Brondby,5559,1,21,6,3,75,35,40,69
FC Midtjylla,5559,2,20,4,6,66,41,25,64
FC Nords,5559,3,14,6,10,74,56,18,48
Copenhagen,5559,4,12,7,11,58,48,10,43
AaB,5559,5,8,13,9,39,40,-1,37
AC Horsens,5559,6,6,14,10,36,54,-18,32
Sonderjyske,5559,7,8,6,10,28,29,-1,30
Lyngby,5559,8,4,9,11,27,44,-17,21
Randers FC,5559,9,5,6,13,23,40,-17,21
AGF Aarhus,5559,10,5,6,11,19,36,-17,21
Silkeborg IF,5559,11,5,3,14,25,47,-22,18
FC Midtjylla,5560,1,21,4,5,67,34,33,67
Brondby,5560,2,20,5,5,67,32,35,65
FC Nords,5560,3,16,6,8,75,47,28,54
Copenhagen,5560,4,14,4,12,57,48,9,46
AaB,5560,5,8,11,11,37,43,-6,35
Sonderjyske,5560,6,8,6,10,28,29,-1,30
AC Horsens,5560,7,6,12,12,31,56,-25,30
Lyngby,5560,8,4,9,11,32,44,-12,21
AGF Aarhus,5560,9,5,6,11,19,37,-18,21
Randers FC,5560,10,5,6,13,23,45,-22,21
Silkeborg IF,5560,11,5,3,14,26,47,-21,18
Brondby,5561,1,20,8,2,67,29,38,68
FC Midtjylla,5561,2,20,6,4,71,37,34,66
FC Nords,5561,3,14,6,10,68,53,15,48
Copenhagen,5561,4,12,5,13,53,47,6,41
AaB,5561,5,8,12,10,37,41,-4,36
AC Horsens,5561,6,6,15,9,34,49,-15,33
Sonderjyske,5561,7,8,6,10,28,29,-1,30
Lyngby,5561,8,4,9,11,28,45,-17,21
Randers FC,5561,9,5,6,13,24,41,-17,21
Silkeborg IF,5561,10,6,3,13,27,45,-18,21
AGF Aarhus,5561,11,4,6,12,17,38,-21,18
Brondby,5562,1,21,6,3,66,31,35,69
FC Midtjylla,5562,2,20,4,6,66,38,28,64
FC Nords,5562,3,14,7,9,71,50,21,49
Copenhagen,5562,4,14,6,10,57,41,16,48
AaB,5562,5,6,14,10,38,44,-6,32
Sonderjyske,5562,6,8,6,10,28,29,-1,30
AC Horsens,5562,7,5,15,10,32,52,-20,30
Randers FC,5562,8,5,7,12,24,40,-16,22
Silkeborg IF,5562,9,6,3,13,28,44,-16,21
Lyngby,5562,10,3,10,11,27,45,-18,19
AGF Aarhus,5562,11,4,6,12,16,39,-23,18
FC Midtjylla,5563,1,21,4,5,68,38,30,67
Brondby,5563,2,20,5,5,69,36,33,65
FC Nords,5563,3,13,7,10,72,54,18,46
Copenhagen,5563,4,14,4,12,58,46,12,46
AaB,5563,5,8,12,10,39,43,-4,36
AC Horsens,5563,6,8,12,10,39,54,-15,36
Sonderjyske,5563,7,8,6,10,28,29,-1,30
Lyngby,5563,8,4,9,11,28,44,-16,21
Silkeborg IF,5563,9,6,3,13,26,44,-18,21
Randers FC,5563,10,5,6,13,23,41,-18,21
AGF Aarhus,5563,11,4,6,12,16,37,-21,18
Brondby,5564,1,20,8,2,67,30,37,68
FC Midtjylla,5564,2,19,4,7,63,41,22,61
FC Nords,5564,3,14,7,9,74,51,23,49
Copenhagen,5564,4,13,6,11,54,44,10,45
AC Horsens,5564,5,7,14,9,38,50,-12,35
AaB,5564,6,7,13,10,36,42,-6,34
Sonderjyske,5564,7,8,6,10,28,29,-1,30
Randers FC,5564,8,6,6,12,25,40,-15,24
AGF Aarhus,5564,9,5,6,11,19,38,-19,21
Lyngby,5564,10,3,9,12,27,46,-19,18
Silkeborg IF,5564,11,5,3,14,27,47,-20,18
Brondby,5565,1,21,7,2,75,32,43,70
FC Midtjylla,5565,2,19,5,6,63,42,21,62
Copenhagen,5565,3,15,4,11,57,42,15,49
FC Nords,5565,4,13,8,9,72,52,20,47
AaB,5565,5,9,11,10,41,44,-3,38
Sonderjyske,5565,6,8,6,10,28,29,-1,30
AC Horsens,5565,7,5,13,12,36,58,-22,28
Randers FC,5565,8,5,7,12,23,39,-16,22
Lyngby,5565,9,3,10,11,26,44,-18,19
Silkeborg IF,5565,10,5,4,13,25,44,-19,19
AGF Aarhus,5565,11,4,7,11,16,36,-20,19
Brondby,5566,1,21,6,3,74,35,39,69
FC Midtjylla,5566,2,19,5,6,68,40,28,62
FC Nords,5566,3,13,8,9,73,55,18,47
Copenhagen,5566,4,13,5,12,57,46,11,44
AaB,5566,5,9,13,8,40,40,0,40
AC Horsens,5566,6,6,13,11,34,56,-22,31
Sonderjyske,5566,7,8,6,10,28,29,-1,30
Randers FC,5566,8,6,6,12,25,39,-14,24
AGF Aarhus,5566,9,5,6,11,17,36,-19,21
Lyngby,5566,10,3,9,12,26,46,-20,18
Silkeborg IF,5566,11,5,3,14,25,45,-20,18
Brondby,5567,1,22,6,2,70,30,40,72
FC Midtjylla,5567,2,19,6,5,67,40,27,63
FC Nords,5567,3,14,6,10,72,52,20,48
Copenhagen,5567,4,13,6,11,55,43,12,45
AC Horsens,5567,5,6,15,9,38,54,-16,33
AaB,5567,6,7,11,12,38,47,-9,32
Sonderjyske,5567,7,8,6,10,28,29,-1,30
Lyngby,5567,8,4,9,11,28,45,-17,21
Randers FC,5567,9,5,6,13,24,41,-17,21
Silkeborg IF,5567,10,6,3,13,26,44,-18,21
AGF Aarhus,5567,11,4,6,12,16,37,-21,18
Brondby,5568,1,22,5,3,74,30,44,71
FC Midtjylla,5568,2,19,5,6,65,39,26,62
FC Nords,5568,3,13,6,11,67,53,14,45
Copenhagen,5568,4,13,4,13,55,49,6,43
AaB,5568,5,10,12,8,42,40,2,42
AC Horsens,5568,6,7,12,11,33,51,-18,33
Sonderjyske,5568,7,8,6,10,28,29,-1,30
Lyngby,5568,8,4,9,11,29,45,-16,21
Silkeborg IF,5568,9,6,3,13,28,44,-16,21
Randers FC,5568,10,5,6,13,24,42,-18,21
AGF Aarhus,5568,11,4,6,12,16,39,-23,18
Brondby,5569,1,20,6,4,71,35,36,66
FC Midtjylla,5569,2,19,5,6,68,43,25,62
FC Nords,5569,3,15,7,8,71,48,23,52
Copenhagen,5569,4,12,6,12,53,45,8,42
AC Horsens,5569,5,8,13,9,41,50,-9,37
AaB,5569,6,7,13,10,36,45,-9,34
Sonderjyske,5569,7,8,6,10,28,29,-1,30
Randers FC,5569,8,5,7,12,24,40,-16,22
Lyngby,5569,9,3,10,11,27,45,-18,19
Silkeborg IF,5569,10,5,4,13,26,45,-19,19
AGF Aarhus,5569,11,4,7,11,17,37,-20,19
Brondby,5570,1,21,5,4,71,33,38,68
FC Midtjylla,5570,2,19,6,5,70,43,27,63
FC Nords,5570,3,15,7,8,78,55,23,52
Copenhagen,5570,4,13,6,11,55,44,11,45
AaB,5570,5,7,13,10,39,45,-6,34
AC Horsens,5570,6,6,13,11,35,54,-19,31
Sonderjyske,5570,7,8,6,10,28,29,-1,30
Silkeborg IF,5570,8,6,3,13,28,44,-16,21
Lyngby,5570,9,4,9,11,29,46,-17,21
Randers FC,5570,10,5,6,13,25,42,-17,21
AGF Aarhus,5570,11,4,6,12,16,39,-23,18
Brondby,5571,1,22,5,3,74,29,45,71
FC Midtjylla,5571,2,18,5,7,64,45,19,59
Copenhagen,5571,3,16,4,10,56,40,16,52
FC Nords,5571,4,14,6,10,73,56,17,48
AC Horsens,5571,5,7,13,10,38,50,-12,34
AaB,5571,6,7,11,12,36,47,-11,32
Sonderjyske,5571,7,8,6,10,28,29,-1,30
Lyngby,5571,8,4,9,11,27,44,-17,21
Randers FC,5571,9,5,6,13,23,40,-17,21
Silkeborg IF,5571,10,5,4,13,28,47,-19,19
AGF Aarhus,5571,11,4,7,11,19,39,-20,19
Brondby,5572,1,23,5,2,74,31,43,74
FC Midtjylla,5572,2,18,5,7,64,43,21,59
FC Nords,5572,3,15,7,8,78,52,26,52
Copenhagen,5572,4,12,4,14,55,51,4,40
AaB,5572,5,8,11,11,36,41,-5,35
AC Horsens,5572,6,7,14,9,36,51,-15,35
Sonderjyske,5572,7,8,6,10,28,29,-1,30
Randers FC,5572,8,6,6,12,26,40,-14,24
AGF Aarhus,5572,9,5,6,11,20,37,-17,21
Lyngby,5572,10,3,9,12,27,47,-20,18
Silkeborg IF,5572,11,5,3,14,26,48,-22,18
Brondby,5573,1,21,6,3,76,28,48,69
FC Midtjylla,5573,2,20,4,6,65,41,24,64
FC Nords,5573,3,15,6,9,73,54,19,51
Copenhagen,5573,4,13,6,11,53,44,9,45
AaB,5573,5,9,11,10,36,39,-3,38
Sonderjyske,5573,6,8,6,10,28,29,-1,30
AC Horsens,5573,7,5,13,12,32,55,-23,28
Lyngby,5573,8,4,9,11,27,44,-17,21
Randers FC,5573,9,5,6,13,23,40,-17,21
Silkeborg IF,5573,10,6,3,13,26,44,-18,21
AGF Aarhus,5573,11,4,6,12,16,37,-21,18
Brondby,5574,1,20,7,3,68,32,36,67
FC Midtjylla,5574,2,20,4,6,63,39,24,64
FC Nords,5574,3,14,6,10,71,56,15,48
Copenhagen,5574,4,14,5,11,61,41,20,47
AaB,5574,5,8,12,10,34,38,-4,36
AC Horsens,5574,6,7,12,11,36,53,-17,33
Sonderjyske,5574,7,8,6,10,28,29,-1,30
Lyngby,5574,8,4,9,11,27,44,-17,21
Randers FC,5574,9,5,6,13,23,40,-17,21
Silkeborg IF,5574,10,6,3,13,26,44,-18,21
AGF Aarhus,5574,11,4,6,12,16,37,-21,18
Brondby,5575,1,19,7,4,68,35,33,64
FC Midtjylla,5575,2,19,6,5,67,41,26,63
Copenhagen,5575,3,16,4,10,58,42,16,52
FC Nords,5575,4,13,6,11,70,54,16,45
AaB,5575,5,8,12,10,37,40,-3,36
AC Horsens,5575,6,7,13,10,39,53,-14,34
Sonderjyske,5575,7,8,6,10,28,29,-1,30
Lyngby,5575,8,4,9,11,27,44,-17,21
Randers FC,5575,9,5,6,13,23,40,-17,21
Silkeborg IF,5575,10,5,4,13,26,45,-19,19
AGF Aarhus,5575,11,4,7,11,17,37,-20,19
Brondby,5576,1,21,6,3,72,33,39,69
FC Midtjylla,5576,2,20,5,5,65,37,28,65
FC Nords,5576,3,15,8,7,74,48,26,53
Copenhagen,5576,4,12,5,13,55,53,2,41
AaB,5576,5,7,12,11,37,43,-6,33
AC Horsens,5576,6,6,14,10,37,52,-15,32
Sonderjyske,5576,7,8,6,10,28,29,-1,30
Randers FC,5576,8,6,6,12,25,40,-15,24
Silkeborg IF,5576,9,6,3,13,27,44,-17,21
Lyngby,5576,10,3,9,12,27,46,-19,18
AGF Aarhus,5576,11,4,6,12,16,38,-22,18
Brondby,5577,1,21,7,2,72,31,41,70
FC Midtjylla,5577,2,20,5,5,68,38,30,65
FC Nords,5577,3,12,8,10,72,60,12,44
Copenhagen,5577,4,12,8,10,57,46,11,44
AaB,5577,5,8,12,10,39,43,-4,36
AC Horsens,5577,6,6,14,10,37,53,-16,32
Sonderjyske,5577,7,8,6,10,28,29,-1,30
Randers FC,5577,8,6,6,12,28,42,-14,24
Silkeborg IF,5577,9,5,4,13,25,44,-19,19
AGF Aarhus,5577,10,4,7,11,16,36,-20,19
Lyngby,5577,11,3,9,12,29,49,-20,18
Brondby,5578,1,21,7,2,74,33,41,70
FC Midtjylla,5578,2,19,6,5,65,40,25,63
Copenhagen,5578,3,14,7,9,59,42,17,49
FC Nords,5578,4,14,6,10,72,54,18,48
AaB,5578,5,6,14,10,36,44,-8,32
Sonderjyske,5578,6,8,6,10,28,29,-1,30
AC Horsens,5578,7,5,14,11,36,55,-19,29
Randers FC,5578,8,5,7,12,26,42,-16,22
Silkeborg IF,5578,9,6,3,13,27,44,-17,21
Lyngby,5578,10,3,10,11,29,47,-18,19
AGF Aarhus,5578,11,4,6,12,16,38,-22,18
Brondby,5579,1,21,5,4,71,37,34,68
FC Midtjylla,5579,2,21,5,4,74,41,33,68
Copenhagen,5579,3,15,4,11,60,44,16,49
FC Nords,5579,4,13,6,11,72,55,17,45
AaB,5579,5,8,11,11,35,42,-7,35
AC Horsens,5579,6,6,13,11,37,56,-19,31
Sonderjyske,5579,7,8,6,10,28,29,-1,30
Randers FC,5579,8,6,6,12,25,40,-15,24
Silkeborg IF,5579,9,5,4,13,27,46,-19,19
AGF Aarhus,5579,10,4,7,11,18,38,-20,19
Lyngby,5579,11,3,9,12,27,46,-19,18
Brondby,5580,1,20,6,4,76,37,39,66
FC Midtjylla,5580,2,19,5,6,67,43,24,62
FC Nords,5580,3,14,8,8,78,57,21,50
Copenhagen,5580,4,15,4,11,64,48,16,49
AC Horsens,5580,5,7,14,9,38,52,-14,35
AaB,5580,6,7,11,12,34,46,-12,32
Sonderjyske,5580,7,8,6,10,28,29,-1,30
Lyngby,5580,8,4,9,11,27,44,-17,21
Randers FC,5580,9,5,6,13,23,40,-17,21
Silkeborg IF,5580,10,5,4,13,28,47,-19,19
AGF Aarhus,5580,11,4,7,11,19,39,-20,19
Brondby,5581,1,21,6,3,70,33,37,69
FC Midtjylla,5581,2,21,4,5,69,37,32,67
FC Nords,5581,3,14,7,9,78,53,25,49
Copenhagen,5581,4,14,5,11,57,47,10,47
AaB,5581,5,7,11,12,36,46,-10,32
AC Horsens,5581,6,6,13,11,34,54,-20,31
Sonderjyske,5581,7,8,6,10,28,29,-1,30
Silkeborg IF,5581,8,6,3,13,28,44,-16,21
Lyngby,5581,9,4,9,11,27,44,-17,21
Randers FC,5581,10,5,6,13,23,40,-17,21
AGF Aarhus,5581,11,4,6,12,16,39,-23,18
Brondby,5582,1,21,7,2,72,32,40,70
FC Midtjylla,5582,2,19,5,6,65,41,24,62
FC Nords,5582,3,16,7,7,79,49,30,55
Copenhagen,5582,4,14,5,11,60,50,10,47
AaB,5582,5,6,13,11,37,46,-9,31
Sonderjyske,5582,6,8,6,10,28,29,-1,30
AC Horsens,5582,7,5,13,12,35,56,-21,28
Randers FC,5582,8,6,6,12,25,40,-15,24
Silkeborg IF,5582,9,6,3,13,26,44,-18,21
Lyngby,5582,10,3,9,12,27,46,-19,18
AGF Aarhus,5582,11,4,6,12,16,37,-21,18
FC Midtjylla,5583,1,21,5,4,70,38,32,68
Brondby,5583,2,20,5,5,66,33,33,65
Copenhagen,5583,3,15,5,10,61,44,17,50
FC Nords,5583,4,14,6,10,73,56,17,48
AaB,5583,5,7,12,11,35,42,-7,33
AC Horsens,5583,6,6,13,11,35,53,-18,31
Sonderjyske,5583,7,8,6,10,28,29,-1,30
Lyngby,5583,8,4,9,11,28,44,-16,21
Silkeborg IF,5583,9,6,3,13,28,45,-17,21
Randers FC,5583,10,5,6,13,23,41,-18,21
AGF Aarhus,5583,11,4,6,12,17,39,-22,18
Brondby,5584,1,21,6,3,68,30,38,69
FC Midtjylla,5584,2,19,4,7,64,39,25,61
FC Nords,5584,3,17,6,7,77,50,27,57
Copenhagen,5584,4,12,6,12,53,44,9,42
AaB,5584,5,8,11,11,36,42,-6,35
AC Horsens,5584,6,6,13,11,34,53,-19,31
Sonderjyske,5584,7,8,6,10,28,29,-1,30
Randers FC,5584,8,5,7,12,23,39,-16,22
Lyngby,5584,9,3,10,11,26,44,-18,19
Silkeborg IF,5584,10,5,4,13,25,44,-19,19
AGF Aarhus,5584,11,4,7,11,16,36,-20,19
Brondby,5585,1,21,6,3,74,33,41,69
FC Midtjylla,5585,2,19,6,5,67,39,28,63
FC Nords,5585,3,14,7,9,75,53,22,49
Copenhagen,5585,4,13,5,12,51,44,7,44
AaB,5585,5,7,13,10,36,44,-8,34
AC Horsens,5585,6,7,13,10,37,53,-16,34
Sonderjyske,5585,7,8,6,10,28,29,-1,30
Randers FC,5585,8,6,6,12,24,39,-15,24
AGF Aarhus,5585,9,5,6,11,17,36,-19,21
Lyngby,5585,10,3,9,12,26,45,-19,18
Silkeborg IF,5585,11,5,3,14,25,45,-20,18
Brondby,5586,1,20,6,4,69,33,36,66
FC Midtjylla,5586,2,20,4,6,64,37,27,64
FC Nords,5586,3,14,7,9,74,52,22,49
Copenhagen,5586,4,14,5,11,54,44,10,47
AC Horsens,5586,5,7,14,9,35,49,-14,35
AaB,5586,6,7,12,11,37,44,-7,33
Sonderjyske,5586,7,8,6,10,28,29,-1,30
Lyngby,5586,8,4,9,11,28,45,-17,21
Silkeborg IF,5586,9,6,3,13,27,44,-17,21
Randers FC,5586,10,5,6,13,24,41,-17,21
AGF Aarhus,5586,11,4,6,12,16,38,-22,18
Brondby,5587,1,21,7,2,76,29,47,70
FC Midtjylla,5587,2,20,5,5,67,39,28,65
Copenhagen,5587,3,14,5,11,59,47,12,47
FC Nords,5587,4,13,7,10,71,57,14,46
AaB,5587,5,7,12,11,39,48,-9,33
AC Horsens,5587,6,6,14,10,35,53,-18,32
Sonderjyske,5587,7,8,6,10,28,29,-1,30
Lyngby,5587,8,4,9,11,28,45,-17,21
Randers FC,5587,9,5,6,13,24,41,-17,21
Silkeborg IF,5587,10,5,4,13,25,44,-19,19
AGF Aarhus,5587,11,4,7,11,16,36,-20,19
Brondby,5588,1,20,7,3,74,33,41,67
FC Midtjylla,5588,2,18,5,7,65,46,19,59
FC Nords,5588,3,14,7,9,71,51,20,49
Copenhagen,5588,4,14,6,10,58,47,11,48
AaB,5588,5,7,14,9,40,41,-1,35
AC Horsens,5588,6,7,13,10,35,51,-16,34
Sonderjyske,5588,7,8,6,10,28,29,-1,30
Lyngby,5588,8,4,9,11,28,44,-16,21
Silkeborg IF,5588,9,6,3,13,26,44,-18,21
Randers FC,5588,10,5,6,13,23,41,-18,21
AGF Aarhus,5588,11,4,6,12,16,37,-21,18
Brondby,5589,1,20,7,3,69,32,37,67
FC Midtjylla,5589,2,20,5,5,63,36,27,65
FC Nords,5589,3,15,8,7,74,49,25,53
Copenhagen,5589,4,14,4,12,58,46,12,46
AaB,5589,5,8,12,10,39,44,-5,36
Sonderjyske,5589,6,8,6,10,28,29,-1,30
AC Horsens,5589,7,5,12,13,34,56,-22,27
Randers FC,5589,8,6,6,12,26,41,-15,24
Silkeborg IF,5589,9,6,3,13,27,45,-18,21
Lyngby,5589,10,3,9,12,28,47,-19,18
AGF Aarhus,5589,11,4,6,12,17,38,-21,18
Brondby,5590,1,22,6,2,70,30,40,72
FC Midtjylla,5590,2,20,5,5,67,38,29,65
FC Nords,5590,3,15,6,9,71,50,21,51
Copenhagen,5590,4,12,5,13,55,47,8,41
AaB,5590,5,7,13,10,34,39,-5,34
AC Horsens,5590,6,6,13,11,34,53,-19,31
Sonderjyske,5590,7,8,6,10,28,29,-1,30
Randers FC,5590,8,5,7,12,25,41,-16,22
Silkeborg IF,5590,9,6,3,13,30,44,-14,21
Lyngby,5590,10,3,10,11,28,46,-18,19
AGF Aarhus,5590,11,4,6,12,16,41,-25,18
Brondby,5591,1,21,6,3,68,30,38,69
FC Midtjylla,5591,2,20,4,6,67,38,29,64
FC Nords,5591,3,14,7,9,74,54,20,49
Copenhagen,5591,4,15,4,11,57,42,15,49
AaB,5591,5,7,13,10,35,43,-8,34
Sonderjyske,5591,6,8,6,10,28,29,-1,30
AC Horsens,5591,7,6,12,12,37,57,-20,30
Randers FC,5591,8,6,6,12,25,40,-15,24
AGF Aarhus,5591,9,5,6,11,17,36,-19,21
Lyngby,5591,10,3,9,12,27,46,-19,18
Silkeborg IF,5591,11,5,3,14,25,45,-20,18
Brondby,5592,1,22,6,2,77,32,45,72
FC Midtjylla,5592,2,17,6,7,63,42,21,57
Copenhagen,5592,3,14,4,12,59,50,9,46
FC Nords,5592,4,13,6,11,69,56,13,45
AaB,5592,5,8,13,9,38,40,-2,37
AC Horsens,5592,6,8,13,9,39,51,-12,37
Sonderjyske,5592,7,8,6,10,28,29,-1,30
Randers FC,5592,8,5,7,12,24,40,-16,22
Silkeborg IF,5592,9,6,3,13,27,44,-17,21
Lyngby,5592,10,3,10,11,27,45,-18,19
AGF Aarhus,5592,11,4,6,12,16,38,-22,18
Brondby,5593,1,21,6,3,71,34,37,69
FC Midtjylla,5593,2,20,5,5,64,35,29,65
FC Nords,5593,3,14,8,8,73,51,22,50
Copenhagen,5593,4,15,5,10,58,40,18,50
Sonderjyske,5593,5,8,6,10,28,29,-1,30
AaB,5593,6,6,12,12,33,46,-13,30
AC Horsens,5593,7,5,14,11,31,50,-19,29
Randers FC,5593,8,6,6,12,26,40,-14,24
Silkeborg IF,5593,9,5,4,13,26,45,-19,19
AGF Aarhus,5593,10,4,7,11,17,37,-20,19
Lyngby,5593,11,3,9,12,27,47,-20,18
Brondby,5594,1,21,6,3,72,31,41,69
FC Midtjylla,5594,2,19,5,6,65,43,22,62
FC Nords,5594,3,14,9,7,75,49,26,51
Copenhagen,5594,4,15,5,10,64,45,19,50
AaB,5594,5,6,13,11,37,48,-11,31
Sonderjyske,5594,6,8,6,10,28,29,-1,30
AC Horsens,5594,7,6,12,12,32,55,-23,30
Lyngby,5594,8,4,9,11,29,44,-15,21
Randers FC,5594,9,5,6,13,23,42,-19,21
Silkeborg IF,5594,10,5,4,13,25,44,-19,19
AGF Aarhus,5594,11,4,7,11,16,36,-20,19
FC Midtjylla,5595,1,20,5,5,62,35,27,65
Brondby,5595,2,19,6,5,67,35,32,63
FC Nords,5595,3,14,6,10,71,52,19,48
Copenhagen,5595,4,14,6,10,57,43,14,48
AaB,5595,5,8,13,9,40,42,-2,37
AC Horsens,5595,6,6,14,10,33,49,-16,32
Sonderjyske,5595,7,8,6,10,28,29,-1,30
Randers FC,5595,8,6,6,12,25,39,-14,24
Silkeborg IF,5595,9,6,3,13,26,44,-18,21
Lyngby,5595,10,3,9,12,26,46,-20,18
AGF Aarhus,5595,11,4,6,12,16,37,-21,18
Brondby,5596,1,21,6,3,71,34,37,69
FC Midtjylla,5596,2,21,5,4,69,35,34,68
FC Nords,5596,3,14,6,10,72,54,18,48
Copenhagen,5596,4,13,5,12,58,49,9,44
AaB,5596,5,7,12,11,36,45,-9,33
AC Horsens,5596,6,6,14,10,37,52,-15,32
Sonderjyske,5596,7,8,6,10,28,29,-1,30
Randers FC,5596,8,6,6,12,25,39,-14,24
Silkeborg IF,5596,9,6,3,13,27,45,-18,21
Lyngby,5596,10,3,9,12,26,46,-20,18
AGF Aarhus,5596,11,4,6,12,17,38,-21,18
Brondby,5597,1,21,6,3,68,30,38,69
FC Midtjylla,5597,2,20,4,6,71,39,32,64
FC Nords,5597,3,15,6,9,77,54,23,51
Copenhagen,5597,4,14,5,11,59,43,16,47
AC Horsens,5597,5,7,12,11,35,54,-19,33
AaB,5597,6,7,11,12,34,50,-16,32
Sonderjyske,5597,7,8,6,10,28,29,-1,30
Randers FC,5597,8,5,7,12,24,40,-16,22
AGF Aarhus,5597,9,5,6,11,18,37,-19,21
Lyngby,5597,10,3,10,11,27,45,-18,19
Silkeborg IF,5597,11,5,3,14,26,46,-20,18
Brondby,5598,1,20,6,4,64,30,34,66
FC Midtjylla,5598,2,19,5,6,67,39,28,62
Copenhagen,5598,3,15,5,10,55,40,15,50
FC Nords,5598,4,13,8,9,70,48,22,47
AaB,5598,5,8,11,11,37,44,-7,35
AC Horsens,5598,6,7,13,10,35,53,-18,34
Sonderjyske,5598,7,8,6,10,28,29,-1,30
Lyngby,5598,8,4,9,11,28,44,-16,21
Silkeborg IF,5598,9,6,3,13,27,44,-17,21
Randers FC,5598,10,5,6,13,23,41,-18,21
AGF Aarhus,5598,11,4,6,12,16,38,-22,18
Brondby,5599,1,21,7,2,73,34,39,70
FC Midtjylla,5599,2,19,6,5,67,38,29,63
FC Nords,5599,3,13,9,8,77,52,25,48
Copenhagen,5599,4,14,6,10,58,45,13,48
AaB,5599,5,7,13,10,37,42,-5,34
Sonderjyske,5599,6,8,6,10,28,29,-1,30
AC Horsens,5599,7,5,13,12,34,61,-27,28
Silkeborg IF,5599,8,6,3,13,30,44,-14,21
Lyngby,5599,9,4,9,11,28,45,-17,21
Randers FC,5599,10,5,6,13,24,41,-17,21
AGF Aarhus,5599,11,4,6,12,16,41,-25,18
Brondby,5600,1,22,5,3,72,30,42,71
FC Midtjylla,5600,2,18,6,6,60,36,24,60
FC Nords,5600,3,15,7,8,73,52,21,52
Copenhagen,5600,4,12,5,13,54,46,8,41
AaB,5600,5,8,11,11,39,45,-6,35
AC Horsens,5600,6,7,14,9,37,52,-15,35
Sonderjyske,5600,7,8,6,10,28,29,-1,30
Randers FC,5600,8,5,7,12,25,41,-16,22
Lyngby,5600,9,3,10,11,28,46,-18,19
Silkeborg IF,5600,10,5,4,13,25,44,-19,19
AGF Aarhus,5600,11,4,7,11,16,36,-20,19
Brondby,5601,1,21,6,3,71,33,38,69
FC Midtjylla,5601,2,19,6,5,65,40,25,63
FC Nords,5601,3,14,7,9,71,49,22,49
Copenhagen,5601,4,14,6,10,58,43,15,48
AC Horsens,5601,5,8,12,10,35,48,-13,36
Sonderjyske,5601,6,8,6,10,28,29,-1,30
AaB,5601,7,6,11,13,32,45,-13,29
Randers FC,5601,8,6,6,12,24,39,-15,24
Silkeborg IF,5601,9,6,3,13,30,46,-16,21
Lyngby,5601,10,3,9,12,26,45,-19,18
AGF Aarhus,5601,11,4,6,12,18,41,-23,18
Brondby,5602,1,22,6,2,77,31,46,72
FC Midtjylla,5602,2,17,7,6,61,41,20,58
FC Nords,5602,3,13,9,8,73,54,19,48
Copenhagen,5602,4,14,4,12,57,47,10,46
AaB,5602,5,7,13,10,34,40,-6,34
AC Horsens,5602,6,6,15,9,38,53,-15,33
Sonderjyske,5602,7,8,6,10,28,29,-1,30
Randers FC,5602,8,5,7,12,23,39,-16,22
Lyngby,5602,9,3,10,11,26,44,-18,19
Silkeborg IF,5602,10,5,4,13,27,46,-19,19
AGF Aarhus,5602,11,4,7,11,18,38,-20,19
Brondby,5603,1,21,6,3,73,35,38,69
FC Midtjylla,5603,2,19,5,6,70,41,29,62
FC Nords,5603,3,15,6,9,72,49,23,51
Copenhagen,5603,4,14,4,12,57,44,13,46
AaB,5603,5,10,11,9,41,42,-1,41
Sonderjyske,5603,6,8,6,10,28,29,-1,30
AC Horsens,5603,7,5,12,13,30,58,-28,27
Randers FC,5603,8,6,6,12,25,40,-15,24
AGF Aarhus,5603,9,5,6,11,19,36,-17,21
Lyngby,5603,10,3,9,12,27,46,-19,18
Silkeborg IF,5603,11,5,3,14,25,47,-22,18
Brondby,5604,1,20,8,2,74,35,39,68
FC Midtjylla,5604,2,21,5,4,68,35,33,68
FC Nords,5604,3,15,7,8,76,52,24,52
Copenhagen,5604,4,13,4,13,56,47,9,43
AaB,5604,5,7,12,11,38,48,-10,33
Sonderjyske,5604,6,8,6,10,28,29,-1,30
AC Horsens,5604,7,6,12,12,36,57,-21,30
Randers FC,5604,8,5,7,12,24,40,-16,22
Silkeborg IF,5604,9,6,3,13,27,45,-18,21
Lyngby,5604,10,3,10,11,27,45,-18,19
AGF Aarhus,5604,11,4,6,12,17,38,-21,18
Brondby,5605,1,19,5,6,69,38,31,62
FC Midtjylla,5605,2,19,4,7,63,41,22,61
FC Nords,5605,3,15,6,9,72,52,20,51
Copenhagen,5605,4,15,4,11,58,41,17,49
AaB,5605,5,9,11,10,41,44,-3,38
AC Horsens,5605,6,8,12,10,36,49,-13,36
Sonderjyske,5605,7,8,6,10,28,29,-1,30
Lyngby,5605,8,4,9,11,29,46,-17,21
Randers FC,5605,9,5,6,13,25,42,-17,21
AGF Aarhus,5605,10,5,6,11,17,36,-19,21
Silkeborg IF,5605,11,5,3,14,25,45,-20,18
Brondby,5606,1,22,5,3,70,31,39,71
FC Midtjylla,5606,2,19,5,6,64,37,27,62
FC Nords,5606,3,14,7,9,74,52,22,49
Copenhagen,5606,4,13,5,12,55,45,10,44
AaB,5606,5,8,12,10,35,43,-8,36
AC Horsens,5606,6,6,14,10,37,53,-16,32
Sonderjyske,5606,7,8,6,10,28,29,-1,30
Randers FC,5606,8,5,7,12,23,39,-16,22
AGF Aarhus,5606,9,5,6,11,19,38,-19,21
Lyngby,5606,10,3,10,11,26,44,-18,19
Silkeborg IF,5606,11,5,3,14,27,47,-20,18
Brondby,5607,1,20,5,5,66,30,36,65
FC Midtjylla,5607,2,20,5,5,66,38,28,65
FC Nords,5607,3,14,6,10,69,51,18,48
Copenhagen,5607,4,13,4,13,56,50,6,43
AaB,5607,5,9,11,10,40,43,-3,38
AC Horsens,5607,6,8,13,9,42,53,-11,37
Sonderjyske,5607,7,8,6,10,28,29,-1,30
Randers FC,5607,8,6,6,12,25,40,-15,24
Silkeborg IF,5607,9,6,3,13,26,44,-18,21
Lyngby,5607,10,3,9,12,27,46,-19,18
AGF Aarhus,5607,11,4,6,12,16,37,-21,18
Brondby,5608,1,22,5,3,69,30,39,71
FC Midtjylla,5608,2,19,6,5,63,38,25,63
FC Nords,5608,3,13,8,9,75,53,22,47
Copenhagen,5608,4,13,7,10,58,46,12,46
AC Horsens,5608,5,7,12,11,39,55,-16,33
AaB,5608,6,6,14,10,34,42,-8,32
Sonderjyske,5608,7,8,6,10,28,29,-1,30
Randers FC,5608,8,5,7,12,24,40,-16,22
AGF Aarhus,5608,9,5,6,11,18,36,-18,21
Lyngby,5608,10,3,10,11,27,45,-18,19
Silkeborg IF,5608,11,5,3,14,25,46,-21,18
Brondby,5609,1,22,6,2,73,33,40,72
FC Midtjylla,5609,2,19,5,6,66,40,26,62
FC Nords,5609,3,14,6,10,71,52,19,48
Copenhagen,5609,4,13,5,12,56,45,11,44
AaB,5609,5,8,14,8,39,38,1,38
Sonderjyske,5609,6,8,6,10,28,29,-1,30
AC Horsens,5609,7,5,14,11,32,55,-23,29
Randers FC,5609,8,6,6,12,26,39,-13,24
Silkeborg IF,5609,9,6,3,13,27,44,-17,21
Lyngby,5609,10,3,9,12,26,47,-21,18
AGF Aarhus,5609,11,4,6,12,16,38,-22,18
Brondby,5610,1,21,6,3,72,31,41,69
FC Midtjylla,5610,2,18,5,7,63,45,18,59
FC Nords,5610,3,15,6,9,76,51,25,51
Copenhagen,5610,4,14,5,11,57,45,12,47
AaB,5610,5,8,12,10,40,46,-6,36
AC Horsens,5610,6,6,14,10,39,55,-16,32
Sonderjyske,5610,7,8,6,10,28,29,-1,30
Lyngby,5610,8,4,9,11,29,45,-16,21
Silkeborg IF,5610,9,6,3,13,26,44,-18,21
Randers FC,5610,10,5,6,13,24,42,-18,21
AGF Aarhus,5610,11,4,6,12,16,37,-21,18
Brondby,5611,1,21,6,3,74,31,43,69
FC Midtjylla,5611,2,19,6,5,65,37,28,63
FC Nords,5611,3,15,7,8,77,50,27,52
Copenhagen,5611,4,13,4,13,54,53,1,43
AaB,5611,5,9,11,10,42,43,-1,38
Sonderjyske,5611,6,8,6,10,28,29,-1,30
AC Horsens,5611,7,6,12,12,35,59,-24,30
Randers FC,5611,8,6,6,12,25,40,-15,24
Silkeborg IF,5611,9,6,3,13,26,44,-18,21
Lyngby,5611,10,3,9,12,27,46,-19,18
AGF Aarhus,5611,11,4,6,12,16,37,-21,18
FC Midtjylla,5612,1,21,4,5,70,36,34,67
Brondby,5612,2,20,6,4,69,34,35,66
FC Nords,5612,3,14,7,9,78,53,25,49
Copenhagen,5612,4,15,4,11,54,46,8,49
AaB,5612,5,7,12,11,34,41,-7,33
AC Horsens,5612,6,6,13,11,33,54,-21,31
Sonderjyske,5612,7,8,6,10,28,29,-1,30
Randers FC,5612,8,5,7,12,24,40,-16,22
AGF Aarhus,5612,9,5,6,11,18,37,-19,21
Lyngby,5612,10,3,10,11,27,45,-18,19
Silkeborg IF,5612,11,5,3,14,26,46,-20,18
Brondby,5613,1,20,7,3,68,34,34,67
FC Midtjylla,5613,2,17,9,4,62,38,24,60
FC Nords,5613,3,14,8,8,79,54,25,50
Copenhagen,5613,4,14,5,11,62,47,15,47
AaB,5613,5,8,13,9,34,37,-3,37
Sonderjyske,5613,6,8,6,10,28,29,-1,30
AC Horsens,5613,7,5,14,11,35,56,-21,29
Lyngby,5613,8,4,9,11,29,44,-15,21
Silkeborg IF,5613,9,6,3,13,26,44,-18,21
Randers FC,5613,10,5,6,13,23,42,-19,21
AGF Aarhus,5613,11,4,6,12,16,37,-21,18
Brondby,5614,1,21,6,3,71,31,40,69
FC Midtjylla,5614,2,17,8,5,61,38,23,59
FC Nords,5614,3,14,7,9,71,49,22,49
Copenhagen,5614,4,13,6,11,56,47,9,45
AC Horsens,5614,5,8,13,9,35,48,-13,37
AaB,5614,6,7,12,11,35,42,-7,33
Sonderjyske,5614,7,8,6,10,28,29,-1,30
Lyngby,5614,8,4,9,11,29,44,-15,21
Silkeborg IF,5614,9,6,3,13,26,44,-18,21
Randers FC,5614,10,5,6,13,23,42,-19,21
AGF Aarhus,5614,11,4,6,12,16,37,-21,18
Brondby,5615,1,21,6,3,68,29,39,69
FC Midtjylla,5615,2,20,4,6,70,43,27,64
FC Nords,5615,3,14,6,10,82,58,24,48
Copenhagen,5615,4,14,5,11,58,45,13,47
AaB,5615,5,8,11,11,38,47,-9,35
AC Horsens,5615,6,7,12,11,39,59,-20,33
Sonderjyske,5615,7,8,6,10,28,29,-1,30
Randers FC,5615,8,5,7,12,24,40,-16,22
AGF Aarhus,5615,9,5,6,11,18,37,-19,21
Lyngby,5615,10,3,10,11,27,45,-18,19
Silkeborg IF,5615,11,5,3,14,26,46,-20,18
Brondby,5616,1,19,7,4,69,33,36,64
FC Midtjylla,5616,2,19,6,5,61,39,22,63
FC Nords,5616,3,14,8,8,73,48,25,50
Copenhagen,5616,4,14,5,11,56,46,10,47
AC Horsens,5616,5,7,14,9,37,49,-12,35
AaB,5616,6,7,12,11,39,46,-7,33
Sonderjyske,5616,7,8,6,10,28,29,-1,30
Lyngby,5616,8,4,9,11,27,44,-17,21
Randers FC,5616,9,5,6,13,23,40,-17,21
AGF Aarhus,5616,10,5,6,11,18,37,-19,21
Silkeborg IF,5616,11,5,3,14,26,46,-20,18
Brondby,5617,1,21,5,4,70,36,34,68
FC Midtjylla,5617,2,19,4,7,61,39,22,61
FC Nords,5617,3,15,7,8,74,48,26,52
Copenhagen,5617,4,15,5,10,61,44,17,50
AaB,5617,5,8,11,11,38,41,-3,35
Sonderjyske,5617,6,8,6,10,28,29,-1,30
AC Horsens,5617,7,6,12,12,34,56,-22,30
Randers FC,5617,8,5,7,12,24,40,-16,22
Silkeborg IF,5617,9,6,3,13,26,44,-18,21
Lyngby,5617,10,3,10,11,27,45,-18,19
AGF Aarhus,5617,11,4,6,12,16,37,-21,18
Brondby,5618,1,22,6,2,72,32,40,72
FC Midtjylla,5618,2,19,5,6,66,43,23,62
FC Nords,5618,3,14,7,9,74,53,21,49
Copenhagen,5618,4,13,6,11,58,46,12,45
AaB,5618,5,8,12,10,39,43,-4,36
Sonderjyske,5618,6,8,6,10,28,29,-1,30
AC Horsens,5618,7,6,12,12,35,53,-18,30
Randers FC,5618,8,6,6,12,26,41,-15,24
AGF Aarhus,5618,9,5,6,11,18,37,-19,21
Lyngby,5618,10,3,9,12,28,47,-19,18
Silkeborg IF,5618,11,5,3,14,26,46,-20,18
Brondby,5619,1,21,6,3,70,30,40,69
FC Midtjylla,5619,2,19,5,6,66,42,24,62
Copenhagen,5619,3,16,5,9,61,43,18,53
FC Nords,5619,4,13,7,10,73,49,24,46
AaB,5619,5,8,12,10,39,45,-6,36
Sonderjyske,5619,6,8,6,10,28,29,-1,30
AC Horsens,5619,7,5,13,12,32,58,-26,28
Lyngby,5619,8,4,9,11,29,44,-15,21
Silkeborg IF,5619,9,6,3,13,28,44,-16,21
Randers FC,5619,10,5,6,13,23,42,-19,21
AGF Aarhus,5619,11,4,6,12,16,39,-23,18
Brondby,5620,1,20,6,4,71,32,39,66
FC Midtjylla,5620,2,20,6,4,72,38,34,66
FC Nords,5620,3,13,8,9,69,52,17,47
Copenhagen,5620,4,13,6,11,57,44,13,45
AaB,5620,5,8,12,10,39,46,-7,36
AC Horsens,5620,6,7,12,11,35,57,-22,33
Sonderjyske,5620,7,8,6,10,28,29,-1,30
Randers FC,5620,8,6,6,12,26,40,-14,24
Silkeborg IF,5620,9,6,3,13,27,44,-17,21
Lyngby,5620,10,3,9,12,27,47,-20,18
AGF Aarhus,5620,11,4,6,12,16,38,-22,18
Brondby,5621,1,21,6,3,72,29,43,69
FC Midtjylla,5621,2,20,4,6,63,42,21,64
FC Nords,5621,3,15,7,8,79,49,30,52
Copenhagen,5621,4,14,6,10,59,46,13,48
AaB,5621,5,7,13,10,38,48,-10,34
Sonderjyske,5621,6,8,6,10,28,29,-1,30
AC Horsens,5621,7,5,12,13,30,53,-23,27
Lyngby,5621,8,4,9,11,27,44,-17,21
Randers FC,5621,9,5,6,13,23,40,-17,21
Silkeborg IF,5621,10,6,3,13,27,45,-18,21
AGF Aarhus,5621,11,4,6,12,17,38,-21,18
Brondby,5622,1,20,6,4,71,36,35,66
FC Midtjylla,5622,2,20,5,5,68,39,29,65
FC Nords,5622,3,13,9,8,79,57,22,48
Copenhagen,5622,4,14,6,10,61,47,14,48
AC Horsens,5622,5,7,13,10,37,54,-17,34
AaB,5622,6,7,11,12,38,47,-9,32
Sonderjyske,5622,7,8,6,10,28,29,-1,30
Lyngby,5622,8,4,9,11,28,44,-16,21
Randers FC,5622,9,5,6,13,23,41,-18,21
AGF Aarhus,5622,10,5,6,11,18,37,-19,21
Silkeborg IF,5622,11,5,3,14,26,46,-20,18
Brondby,5623,1,21,6,3,72,31,41,69
FC Midtjylla,5623,2,19,5,6,64,40,24,62
FC Nords,5623,3,13,9,8,76,55,21,48
Copenhagen,5623,4,14,5,11,59,47,12,47
AaB,5623,5,7,13,10,34,41,-7,34
AC Horsens,5623,6,6,14,10,35,52,-17,32
Sonderjyske,5623,7,8,6,10,28,29,-1,30
Lyngby,5623,8,4,9,11,28,44,-16,21
Silkeborg IF,5623,9,6,3,13,27,44,-17,21
Randers FC,5623,10,5,6,13,23,41,-18,21
AGF Aarhus,5623,11,4,6,12,16,38,-22,18
Brondby,5624,1,21,6,3,78,32,46,69
FC Midtjylla,5624,2,19,6,5,63,40,23,63
FC Nords,5624,3,15,7,8,77,50,27,52
Copenhagen,5624,4,13,5,12,54,49,5,44
AaB,5624,5,7,13,10,37,45,-8,34
AC Horsens,5624,6,6,13,11,38,57,-19,31
Sonderjyske,5624,7,8,6,10,28,29,-1,30
Lyngby,5624,8,4,9,11,28,45,-17,21
Randers FC,5624,9,5,6,13,24,41,-17,21
Silkeborg IF,5624,10,5,4,13,27,46,-19,19
AGF Aarhus,5624,11,4,7,11,18,38,-20,19
FC Midtjylla,5625,1,21,4,5,69,40,29,67
Brondby,5625,2,19,6,5,69,35,34,63
Copenhagen,5625,3,15,4,11,63,49,14,49
FC Nords,5625,4,14,6,10,76,57,19,48
AaB,5625,5,8,12,10,37,42,-5,36
AC Horsens,5625,6,7,12,11,37,54,-17,33
Sonderjyske,5625,7,8,6,10,28,29,-1,30
Randers FC,5625,8,6,6,12,25,39,-14,24
AGF Aarhus,5625,9,5,6,11,17,36,-19,21
Lyngby,5625,10,3,9,12,26,46,-20,18
Silkeborg IF,5625,11,5,3,14,25,45,-20,18
Brondby,5626,1,21,7,2,69,31,38,70
FC Midtjylla,5626,2,19,5,6,65,40,25,62
FC Nords,5626,3,13,8,9,73,53,20,47
Copenhagen,5626,4,14,5,11,59,44,15,47
AaB,5626,5,9,12,9,39,42,-3,39
Sonderjyske,5626,6,8,6,10,28,29,-1,30
AC Horsens,5626,7,5,13,12,39,60,-21,28
Lyngby,5626,8,4,9,11,29,45,-16,21
Silkeborg IF,5626,9,6,3,13,28,44,-16,21
Randers FC,5626,10,5,6,13,24,42,-18,21
AGF Aarhus,5626,11,4,6,12,16,39,-23,18
Brondby,5627,1,21,7,2,71,30,41,70
FC Midtjylla,5627,2,20,5,5,66,38,28,65
FC Nords,5627,3,14,6,10,72,55,17,48
Copenhagen,5627,4,12,6,12,56,46,10,42
AC Horsens,5627,5,7,14,9,37,50,-13,35
AaB,5627,6,7,12,11,36,45,-9,33
Sonderjyske,5627,7,8,6,10,28,29,-1,30
Randers FC,5627,8,5,7,12,25,41,-16,22
Lyngby,5627,9,3,10,11,28,46,-18,19
Silkeborg IF,5627,10,5,4,13,26,45,-19,19
AGF Aarhus,5627,11,4,7,11,17,37,-20,19
Brondby,5628,1,21,5,4,69,33,36,68
FC Midtjylla,5628,2,20,4,6,65,38,27,64
FC Nords,5628,3,16,7,7,78,51,27,55
Copenhagen,5628,4,14,6,10,60,44,16,48
AaB,5628,5,7,12,11,37,45,-8,33
Sonderjyske,5628,6,8,6,10,28,29,-1,30
AC Horsens,5628,7,5,12,13,36,60,-24,27
Lyngby,5628,8,4,9,11,28,45,-17,21
Randers FC,5628,9,5,6,13,24,41,-17,21
AGF Aarhus,5628,10,5,6,11,18,37,-19,21
Silkeborg IF,5628,11,5,3,14,26,46,-20,18
Brondby,5629,1,21,6,3,70,32,38,69
FC Midtjylla,5629,2,21,4,5,67,37,30,67
FC Nords,5629,3,15,7,8,74,48,26,52
Copenhagen,5629,4,12,5,13,54,49,5,41
AC Horsens,5629,5,6,15,9,35,51,-16,33
AaB,5629,6,6,13,11,34,43,-9,31
Sonderjyske,5629,7,8,6,10,28,29,-1,30
Randers FC,5629,8,6,6,12,25,40,-15,24
Silkeborg IF,5629,9,6,3,13,27,45,-18,21
Lyngby,5629,10,3,9,12,27,46,-19,18
AGF Aarhus,5629,11,4,6,12,17,38,-21,18
Brondby,5630,1,20,7,3,70,33,37,67
FC Midtjylla,5630,2,19,5,6,65,41,24,62
Copenhagen,5630,3,16,4,10,60,42,18,52
FC Nords,5630,4,14,7,9,71,50,21,49
AC Horsens,5630,5,7,12,11,38,52,-14,33
AaB,5630,6,7,11,12,34,46,-12,32
Sonderjyske,5630,7,8,6,10,28,29,-1,30
Lyngby,5630,8,4,9,11,30,44,-14,21
Silkeborg IF,5630,9,6,3,13,27,44,-17,21
Randers FC,5630,10,5,6,13,23,43,-20,21
AGF Aarhus,5630,11,4,6,12,16,38,-22,18
Brondby,5631,1,21,7,2,69,28,41,70
FC Midtjylla,5631,2,18,6,6,66,44,22,60
Copenhagen,5631,3,14,5,11,55,43,12,47
FC Nords,5631,4,13,7,10,71,54,17,46
AaB,5631,5,8,13,9,39,39,0,37
AC Horsens,5631,6,5,16,9,34,52,-18,31
Sonderjyske,5631,7,8,6,10,28,29,-1,30
Lyngby,5631,8,4,9,11,29,46,-17,21
Randers FC,5631,9,5,6,13,25,42,-17,21
Silkeborg IF,5631,10,6,3,13,28,46,-18,21
AGF Aarhus,5631,11,4,6,12,18,39,-21,18
FC Midtjylla,5632,1,19,7,4,67,39,28,64
Brondby,5632,2,19,6,5,69,38,31,63
FC Nords,5632,3,14,9,7,75,49,26,51
Copenhagen,5632,4,13,6,11,57,48,9,45
AC Horsens,5632,5,7,14,9,37,51,-14,35
AaB,5632,6,6,14,10,38,44,-6,32
Sonderjyske,5632,7,8,6,10,28,29,-1,30
Lyngby,5632,8,4,9,11,29,46,-17,21
Randers FC,5632,9,5,6,13,25,42,-17,21
Silkeborg IF,5632,10,5,4,13,26,45,-19,19
AGF Aarhus,5632,11,4,7,11,17,37,-20,19
Brondby,5633,1,23,5,2,78,27,51,74
FC Midtjylla,5633,2,17,6,7,61,47,14,57
FC Nords,5633,3,13,8,9,77,62,15,47
Copenhagen,5633,4,14,5,11,58,46,12,47
AaB,5633,5,8,13,9,39,40,-1,37
AC Horsens,5633,6,6,13,11,39,56,-17,31
Sonderjyske,5633,7,8,6,10,28,29,-1,30
Lyngby,5633,8,4,9,11,28,45,-17,21
Randers FC,5633,9,5,6,13,24,41,-17,21
AGF Aarhus,5633,10,5,6,11,18,36,-18,21
Silkeborg IF,5633,11,5,3,14,25,46,-21,18
Brondby,5634,1,20,6,4,69,31,38,66
FC Midtjylla,5634,2,18,4,8,61,47,14,58
FC Nords,5634,3,15,8,7,76,50,26,53
Copenhagen,5634,4,15,4,11,59,42,17,49
AC Horsens,5634,5,7,14,9,34,49,-15,35
AaB,5634,6,7,12,11,37,43,-6,33
Sonderjyske,5634,7,8,6,10,28,29,-1,30
Lyngby,5634,8,4,9,11,27,44,-17,21
Silkeborg IF,5634,8,6,3,13,27,44,-17,21
Randers FC,5634,10,5,6,13,23,40,-17,21
AGF Aarhus,5634,11,4,6,12,16,38,-22,18
Brondby,5635,1,22,5,3,77,34,43,71
FC Midtjylla,5635,2,18,7,5,65,42,23,61
Copenhagen,5635,3,16,5,9,66,42,24,53
FC Nords,5635,4,12,8,10,70,58,12,44
AaB,5635,5,6,14,10,37,47,-10,32
AC Horsens,5635,6,6,13,11,38,56,-18,31
Sonderjyske,5635,7,8,6,10,28,29,-1,30
Lyngby,5635,8,4,9,11,29,44,-15,21
Randers FC,5635,9,5,6,13,23,42,-19,21
AGF Aarhus,5635,10,5,6,11,17,36,-19,21
Silkeborg IF,5635,11,5,3,14,25,45,-20,18
Brondby,5636,1,22,6,2,72,30,42,72
FC Midtjylla,5636,2,20,5,5,69,40,29,65
FC Nords,5636,3,13,6,11,75,60,15,45
Copenhagen,5636,4,13,5,12,60,49,11,44
AaB,5636,5,8,12,10,40,47,-7,36
AC Horsens,5636,6,6,14,10,37,53,-16,32
Sonderjyske,5636,7,8,6,10,28,29,-1,30
Lyngby,5636,8,4,9,11,31,45,-14,21
Silkeborg IF,5636,9,6,3,13,29,44,-15,21
Randers FC,5636,10,5,6,13,24,44,-20,21
AGF Aarhus,5636,11,4,6,12,16,40,-24,18
Brondby,5637,1,22,5,3,74,29,45,71
FC Midtjylla,5637,2,20,4,6,63,40,23,64
FC Nords,5637,3,14,7,9,68,49,19,49
Copenhagen,5637,4,14,5,11,53,42,11,47
AC Horsens,5637,5,7,12,11,37,50,-13,33
AaB,5637,6,7,11,12,37,48,-11,32
Sonderjyske,5637,7,8,6,10,28,29,-1,30
Lyngby,5637,8,4,9,11,27,44,-17,21
Randers FC,5637,9,5,6,13,23,40,-17,21
AGF Aarhus,5637,10,5,6,11,17,36,-19,21
Silkeborg IF,5637,11,5,3,14,25,45,-20,18
Brondby,5638,1,21,5,4,70,30,40,68
FC Midtjylla,5638,2,19,4,7,67,44,23,61
Copenhagen,5638,3,14,5,11,61,45,16,47
FC Nords,5638,4,13,7,10,73,58,15,46
AaB,5638,5,9,11,10,40,42,-2,38
AC Horsens,5638,6,8,12,10,39,57,-18,36
Sonderjyske,5638,7,8,6,10,28,29,-1,30
Lyngby,5638,8,4,9,11,28,45,-17,21
Randers FC,5638,9,5,6,13,24,41,-17,21
AGF Aarhus,5638,10,5,6,11,19,37,-18,21
Silkeborg IF,5638,11,5,3,14,26,47,-21,18
Brondby,5639,1,21,7,2,75,30,45,70
FC Midtjylla,5639,2,20,4,6,66,42,24,64
Copenhagen,5639,3,14,5,11,61,47,14,47
FC Nords,5639,4,13,7,10,71,56,15,46
AC Horsens,5639,5,8,12,10,38,51,-13,36
AaB,5639,6,6,13,11,37,48,-11,31
Sonderjyske,5639,7,8,6,10,28,29,-1,30
Randers FC,5639,8,5,7,12,24,40,-16,22
Lyngby,5639,9,3,10,11,27,45,-18,19
Silkeborg IF,5639,10,5,4,13,25,44,-19,19
AGF Aarhus,5639,11,4,7,11,16,36,-20,19
FC Midtjylla,5640,1,20,6,4,70,41,29,66
Brondby,5640,2,20,5,5,71,35,36,65
FC Nords,5640,3,14,7,9,70,52,18,49
Copenhagen,5640,4,12,5,13,58,49,9,41
AaB,5640,5,9,13,8,39,40,-1,40
AC Horsens,5640,6,7,12,11,35,52,-17,33
Sonderjyske,5640,7,8,6,10,28,29,-1,30
Randers FC,5640,8,6,6,12,24,39,-15,24
Silkeborg IF,5640,9,6,3,13,28,44,-16,21
Lyngby,5640,10,3,9,12,26,45,-19,18
AGF Aarhus,5640,11,4,6,12,16,39,-23,18
FC Midtjylla,5641,1,21,5,4,66,35,31,68
Brondby,5641,2,19,5,6,70,38,32,62
Copenhagen,5641,3,16,4,10,60,42,18,52
FC Nords,5641,4,13,6,11,71,54,17,45
AaB,5641,5,8,12,10,40,46,-6,36
AC Horsens,5641,6,6,14,10,34,52,-18,32
Sonderjyske,5641,7,8,6,10,28,29,-1,30
Randers FC,5641,8,5,7,12,25,41,-16,22
Silkeborg IF,5641,9,6,3,13,28,45,-17,21
Lyngby,5641,10,3,10,11,28,46,-18,19
AGF Aarhus,5641,11,4,6,12,17,39,-22,18
Brondby,5642,1,21,6,3,72,30,42,69
FC Midtjylla,5642,2,20,4,6,65,42,23,64
FC Nords,5642,3,14,6,10,74,56,18,48
Copenhagen,5642,4,14,6,10,60,45,15,48
AaB,5642,5,8,12,10,37,41,-4,36
Sonderjyske,5642,6,8,6,10,28,29,-1,30
AC Horsens,5642,7,6,12,12,33,53,-20,30
Randers FC,5642,8,6,6,12,25,39,-14,24
Silkeborg IF,5642,9,6,3,13,27,44,-17,21
Lyngby,5642,10,3,9,12,26,46,-20,18
AGF Aarhus,5642,11,4,6,12,16,38,-22,18
FC Midtjylla,5643,1,20,5,5,69,41,28,65
Brondby,5643,2,19,6,5,67,35,32,63
FC Nords,5643,3,14,9,7,75,48,27,51
Copenhagen,5643,4,13,6,11,59,49,10,45
AaB,5643,5,8,13,9,37,41,-4,37
AC Horsens,5643,6,6,13,11,34,53,-19,31
Sonderjyske,5643,7,8,6,10,28,29,-1,30
Lyngby,5643,8,4,9,11,29,45,-16,21
Randers FC,5643,9,5,6,13,24,42,-18,21
Silkeborg IF,5643,10,5,4,13,26,45,-19,19
AGF Aarhus,5643,11,4,7,11,17,37,-20,19
Brondby,5644,1,21,5,4,73,33,40,68
FC Midtjylla,5644,2,20,4,6,69,37,32,64
FC Nords,5644,3,16,6,8,77,51,26,54
Copenhagen,5644,4,13,4,13,55,50,5,43
AC Horsens,5644,5,7,13,10,34,51,-17,34
AaB,5644,6,7,12,11,37,49,-12,33
Sonderjyske,5644,7,8,6,10,28,29,-1,30
Lyngby,5644,8,4,9,11,27,44,-17,21
Randers FC,5644,9,5,6,13,23,40,-17,21
Silkeborg IF,5644,10,5,4,13,25,44,-19,19
AGF Aarhus,5644,11,4,7,11,16,36,-20,19
Brondby,5645,1,18,6,6,64,35,29,60
FC Midtjylla,5645,2,18,6,6,63,41,22,60
FC Nords,5645,3,15,8,7,72,46,26,53
Copenhagen,5645,4,13,6,11,60,47,13,45
AaB,5645,5,10,11,9,40,39,1,41
AC Horsens,5645,6,7,13,10,33,50,-17,34
Sonderjyske,5645,7,8,6,10,28,29,-1,30
Randers FC,5645,8,5,7,12,24,40,-16,22
AGF Aarhus,5645,9,5,6,11,17,36,-19,21
Lyngby,5645,10,3,10,11,27,45,-18,19
Silkeborg IF,5645,11,5,3,14,25,45,-20,18
Brondby,5646,1,20,6,4,66,31,35,66
FC Midtjylla,5646,2,19,4,7,62,38,24,61
FC Nords,5646,3,14,7,9,71,51,20,49
Copenhagen,5646,4,14,6,10,60,44,16,48
AC Horsens,5646,5,8,14,8,42,54,-12,38
AaB,5646,6,6,13,11,35,44,-9,31
Sonderjyske,5646,7,8,6,10,28,29,-1,30
Randers FC,5646,8,6,6,12,25,40,-15,24
Silkeborg IF,5646,9,6,3,13,27,45,-18,21
Lyngby,5646,10,3,9,12,27,46,-19,18
AGF Aarhus,5646,11,4,6,12,17,38,-21,18
FC Midtjylla,5647,1,20,6,4,71,39,32,66
Brondby,5647,2,19,8,3,75,37,38,65
FC Nords,5647,3,13,9,8,73,53,20,48
Copenhagen,5647,4,13,6,11,61,52,9,45
AC Horsens,5647,5,7,14,9,37,52,-15,35
AaB,5647,6,7,11,12,37,47,-10,32
Sonderjyske,5647,7,8,6,10,28,29,-1,30
Randers FC,5647,8,6,6,12,24,39,-15,24
Silkeborg IF,5647,9,6,3,13,26,44,-18,21
Lyngby,5647,10,3,9,12,26,45,-19,18
AGF Aarhus,5647,11,4,6,12,16,37,-21,18
Brondby,5648,1,19,8,3,67,32,35,65
FC Midtjylla,5648,2,18,7,5,63,38,25,61
FC Nords,5648,3,14,6,10,68,51,17,48
Copenhagen,5648,4,14,6,10,55,42,13,48
AaB,5648,5,10,12,8,39,36,3,42
Sonderjyske,5648,6,8,6,10,28,29,-1,30
AC Horsens,5648,7,5,13,12,30,49,-19,28
Lyngby,5648,8,4,9,11,28,45,-17,21
Randers FC,5648,9,5,6,13,24,41,-17,21
AGF Aarhus,5648,10,5,6,11,19,37,-18,21
Silkeborg IF,5648,11,5,3,14,26,47,-21,18
FC Midtjylla,5649,1,21,5,4,67,35,32,68
Brondby,5649,2,18,10,2,65,30,35,64
Copenhagen,5649,3,14,6,10,56,42,14,48
FC Nords,5649,4,13,8,9,71,51,20,47
AaB,5649,5,6,14,10,37,46,-9,32
AC Horsens,5649,6,6,13,11,33,51,-18,31
Sonderjyske,5649,7,8,6,10,28,29,-1,30
Randers FC,5649,8,5,7,12,24,40,-16,22
AGF Aarhus,5649,9,5,6,11,18,37,-19,21
Lyngby,5649,10,3,10,11,27,45,-18,19
Silkeborg IF,5649,11,5,3,14,26,46,-20,18
Brondby,5650,1,21,6,3,71,31,40,69
FC Midtjylla,5650,2,19,6,5,67,38,29,63
FC Nords,5650,3,14,7,9,69,55,14,49
Copenhagen,5650,4,12,5,13,53,46,7,41
AaB,5650,5,8,13,9,40,41,-1,37
AC Horsens,5650,6,7,13,10,36,51,-15,34
Sonderjyske,5650,7,8,6,10,28,29,-1,30
Randers FC,5650,8,5,7,12,25,41,-16,22
AGF Aarhus,5650,9,5,6,11,18,37,-19,21
Lyngby,5650,10,3,10,11,28,46,-18,19
Silkeborg IF,5650,11,5,3,14,26,46,-20,18
Brondby,5651,1,20,5,5,70,38,32,65
FC Midtjylla,5651,2,20,5,5,69,39,30,65
FC Nords,5651,3,14,6,10,72,55,17,48
Copenhagen,5651,4,14,6,10,58,43,15,48
AaB,5651,5,8,13,9,40,42,-2,37
AC Horsens,5651,6,6,13,11,33,51,-18,31
Sonderjyske,5651,7,8,6,10,28,29,-1,30
Randers FC,5651,8,5,7,12,24,40,-16,22
Lyngby,5651,9,3,10,11,27,45,-18,19
Silkeborg IF,5651,10,5,4,13,25,44,-19,19
AGF Aarhus,5651,11,4,7,11,16,36,-20,19
Brondby,5652,1,20,7,3,68,30,38,67
FC Midtjylla,5652,2,18,7,5,62,38,24,61
FC Nords,5652,3,14,6,10,73,53,20,48
Copenhagen,5652,4,13,7,10,58,46,12,46
AaB,5652,5,8,12,10,35,41,-6,36
AC Horsens,5652,6,6,15,9,37,51,-14,33
Sonderjyske,5652,7,8,6,10,28,29,-1,30
Lyngby,5652,8,4,9,11,30,46,-16,21
Silkeborg IF,5652,9,6,3,13,29,45,-16,21
Randers FC,5652,10,5,6,13,25,43,-18,21
AGF Aarhus,5652,11,4,6,12,17,40,-23,18
Brondby,5653,1,22,6,2,74,31,43,72
FC Midtjylla,5653,2,19,5,6,64,41,23,62
FC Nords,5653,3,15,6,9,75,51,24,51
Copenhagen,5653,4,13,6,11,55,43,12,45
AaB,5653,5,7,12,11,35,42,-7,33
AC Horsens,5653,6,6,13,11,32,53,-21,31
Sonderjyske,5653,7,8,6,10,28,29,-1,30
Lyngby,5653,8,4,9,11,28,45,-17,21
Randers FC,5653,9,5,6,13,24,41,-17,21
Silkeborg IF,5653,10,5,4,13,26,45,-19,19
AGF Aarhus,5653,11,4,7,11,17,37,-20,19
Brondby,5654,1,21,6,3,70,31,39,69
FC Midtjylla,5654,2,20,4,6,67,39,28,64
FC Nords,5654,3,14,6,10,70,53,17,48
Copenhagen,5654,4,13,5,12,55,48,7,44
AaB,5654,5,10,12,8,44,40,4,42
Sonderjyske,5654,6,8,6,10,28,29,-1,30
AC Horsens,5654,7,5,13,12,35,56,-21,28
Randers FC,5654,8,5,7,12,24,40,-16,22
Silkeborg IF,5654,9,6,3,13,26,44,-18,21
Lyngby,5654,10,3,10,11,27,45,-18,19
AGF Aarhus,5654,11,4,6,12,16,37,-21,18
Brondby,5655,1,21,7,2,72,33,39,70
FC Midtjylla,5655,2,19,5,6,65,40,25,62
FC Nords,5655,3,15,7,8,73,49,24,52
Copenhagen,5655,4,12,4,14,55,48,7,40
AC Horsens,5655,5,7,14,9,37,52,-15,35
AaB,5655,6,7,13,10,34,40,-6,34
Sonderjyske,5655,7,8,6,10,28,29,-1,30
Lyngby,5655,8,4,9,11,28,44,-16,21
Randers FC,5655,9,5,6,13,23,41,-18,21
Silkeborg IF,5655,10,5,4,13,25,44,-19,19
AGF Aarhus,5655,11,4,7,11,16,36,-20,19
Brondby,5656,1,20,6,4,70,36,34,66
FC Midtjylla,5656,2,19,6,5,65,37,28,63
FC Nords,5656,3,15,6,9,82,55,27,51
Copenhagen,5656,4,13,6,11,56,46,10,45
AaB,5656,5,9,12,9,40,42,-2,39
Sonderjyske,5656,6,8,6,10,28,29,-1,30
AC Horsens,5656,7,5,14,11,31,54,-23,29
Lyngby,5656,8,4,9,11,28,45,-17,21
Randers FC,5656,9,5,6,13,24,41,-17,21
Silkeborg IF,5656,10,6,3,13,26,44,-18,21
AGF Aarhus,5656,11,4,6,12,16,37,-21,18
FC Midtjylla,5657,1,21,5,4,73,36,37,68
Brondby,5657,2,19,6,5,70,37,33,63
FC Nords,5657,3,14,7,9,73,56,17,49
Copenhagen,5657,4,14,6,10,60,45,15,48
AaB,5657,5,8,13,9,38,41,-3,37
Sonderjyske,5657,6,8,6,10,28,29,-1,30
AC Horsens,5657,7,5,13,12,34,59,-25,28
Lyngby,5657,8,4,9,11,29,45,-16,21
Silkeborg IF,5657,9,6,3,13,27,44,-17,21
Randers FC,5657,10,5,6,13,24,42,-18,21
AGF Aarhus,5657,11,4,6,12,16,38,-22,18
Brondby,5658,1,21,6,3,76,37,39,69
FC Midtjylla,5658,2,20,4,6,66,41,25,64
FC Nords,5658,3,15,6,9,76,56,20,51
Copenhagen,5658,4,13,5,12,56,45,11,44
AaB,5658,5,8,12,10,36,40,-4,36
AC Horsens,5658,6,6,13,11,35,52,-17,31
Sonderjyske,5658,7,8,6,10,28,29,-1,30
Lyngby,5658,8,4,9,11,30,45,-15,21
Randers FC,5658,9,5,6,13,24,43,-19,21
AGF Aarhus,5658,10,5,6,11,18,37,-19,21
Silkeborg IF,5658,11,5,3,14,26,46,-20,18
FC Midtjylla,5659,1,22,4,4,67,37,30,70
Brondby,5659,2,20,5,5,67,32,35,65
FC Nords,5659,3,14,6,10,78,53,25,48
Copenhagen,5659,4,13,5,12,60,49,11,44
AaB,5659,5,8,12,10,38,45,-7,36
AC Horsens,5659,6,7,12,11,35,55,-20,33
Sonderjyske,5659,7,8,6,10,28,29,-1,30
Randers FC,5659,8,5,7,12,23,39,-16,22
Silkeborg IF,5659,9,6,3,13,26,44,-18,21
Lyngby,5659,10,3,10,11,26,44,-18,19
AGF Aarhus,5659,11,4,6,12,16,37,-21,18
FC Midtjylla,5660,1,20,5,5,64,34,30,65
Brondby,5660,2,18,7,5,63,31,32,61
Copenhagen,5660,3,15,4,11,56,42,14,49
FC Nords,5660,4,13,8,9,70,52,18,47
AaB,5660,5,8,13,9,36,40,-4,37
AC Horsens,5660,6,7,13,10,34,50,-16,34
Sonderjyske,5660,7,8,6,10,28,29,-1,30
Randers FC,5660,8,5,7,12,23,39,-16,22
Silkeborg IF,5660,9,6,3,13,29,45,-16,21
Lyngby,5660,10,3,10,11,26,44,-18,19
AGF Aarhus,5660,11,4,6,12,17,40,-23,18
Brondby,5661,1,20,8,2,68,28,40,68
FC Midtjylla,5661,2,20,6,4,64,33,31,66
FC Nords,5661,3,14,7,9,68,48,20,49
Copenhagen,5661,4,13,6,11,53,42,11,45
AaB,5661,5,6,15,9,37,42,-5,33
Sonderjyske,5661,6,8,6,10,28,29,-1,30
AC Horsens,5661,7,6,12,12,31,54,-23,30
Lyngby,5661,8,4,9,11,29,46,-17,21
Randers FC,5661,9,5,6,13,25,42,-17,21
AGF Aarhus,5661,10,5,6,11,19,36,-17,21
Silkeborg IF,5661,11,5,3,14,25,47,-22,18
Brondby,5662,1,22,5,3,73,32,41,71
FC Midtjylla,5662,2,18,6,6,63,40,23,60
Copenhagen,5662,3,15,5,10,59,42,17,50
FC Nords,5662,4,14,6,10,72,54,18,48
AaB,5662,5,9,11,10,37,39,-2,38
Sonderjyske,5662,6,8,6,10,28,29,-1,30
AC Horsens,5662,7,5,13,12,34,57,-23,28
Randers FC,5662,8,6,6,12,25,40,-15,24
Silkeborg IF,5662,9,6,3,13,28,45,-17,21
Lyngby,5662,10,3,9,12,27,46,-19,18
AGF Aarhus,5662,11,4,6,12,17,39,-22,18
Brondby,5663,1,22,6,2,70,28,42,72
FC Midtjylla,5663,2,21,4,5,72,36,36,67
FC Nords,5663,3,12,8,10,69,53,16,44
Copenhagen,5663,4,13,5,12,57,51,6,44
AaB,5663,5,8,12,10,41,45,-4,36
AC Horsens,5663,6,6,13,11,38,60,-22,31
Sonderjyske,5663,7,8,6,10,28,29,-1,30
Randers FC,5663,8,5,7,12,23,39,-16,22
AGF Aarhus,5663,9,5,6,11,21,38,-17,21
Lyngby,5663,10,3,10,11,26,44,-18,19
Silkeborg IF,5663,11,5,3,14,27,49,-22,18
Brondby,5664,1,21,7,2,68,27,41,70
FC Midtjylla,5664,2,19,6,5,65,41,24,63
FC Nords,5664,3,13,8,9,72,52,20,47
Copenhagen,5664,4,14,5,11,58,46,12,47
AC Horsens,5664,5,7,13,10,35,50,-15,34
AaB,5664,6,6,13,11,34,42,-8,31
Sonderjyske,5664,7,8,6,10,28,29,-1,30
Randers FC,5664,8,6,6,12,25,40,-15,24
AGF Aarhus,5664,9,5,6,11,18,37,-19,21
Lyngby,5664,10,3,9,12,27,46,-19,18
Silkeborg IF,5664,11,5,3,14,26,46,-20,18
Brondby,5665,1,22,5,3,73,34,39,71
FC Midtjylla,5665,2,19,5,6,69,41,28,62
Copenhagen,5665,3,15,4,11,62,45,17,49
FC Nords,5665,4,14,6,10,71,56,15,48
AC Horsens,5665,5,7,13,10,36,52,-16,34
AaB,5665,6,6,13,11,34,43,-9,31
Sonderjyske,5665,7,8,6,10,28,29,-1,30
Lyngby,5665,8,4,9,11,27,44,-17,21
Randers FC,5665,9,5,6,13,23,40,-17,21
Silkeborg IF,5665,10,6,3,13,26,44,-18,21
AGF Aarhus,5665,11,4,6,12,16,37,-21,18
Brondby,5666,1,20,6,4,69,36,33,66
FC Midtjylla,5666,2,19,5,6,71,45,26,62
FC Nords,5666,3,15,8,7,77,49,28,53
Copenhagen,5666,4,15,5,10,66,48,18,50
AaB,5666,5,6,13,11,32,41,-9,31
AC Horsens,5666,6,6,13,11,37,59,-22,31
Sonderjyske,5666,7,8,6,10,28,29,-1,30
Randers FC,5666,8,6,6,12,24,39,-15,24
Silkeborg IF,5666,9,6,3,13,28,44,-16,21
Lyngby,5666,10,3,9,12,26,45,-19,18
AGF Aarhus,5666,11,4,6,12,16,39,-23,18
FC Midtjylla,5667,1,21,4,5,69,39,30,67
Brondby,5667,2,19,6,5,67,33,34,63
Copenhagen,5667,3,15,6,9,63,43,20,51
FC Nords,5667,4,13,9,8,76,55,21,48
AC Horsens,5667,5,7,12,11,37,54,-17,33
AaB,5667,6,6,13,11,34,48,-14,31
Sonderjyske,5667,7,8,6,10,28,29,-1,30
Lyngby,5667,8,4,9,11,28,45,-17,21
Silkeborg IF,5667,9,6,3,13,27,44,-17,21
Randers FC,5667,10,5,6,13,24,41,-17,21
AGF Aarhus,5667,11,4,6,12,16,38,-22,18
Brondby,5668,1,20,8,2,70,29,41,68
FC Midtjylla,5668,2,19,7,4,64,36,28,64
FC Nords,5668,3,15,6,9,74,49,25,51
Copenhagen,5668,4,13,7,10,58,46,12,46
AC Horsens,5668,5,6,14,10,35,51,-16,32
Sonderjyske,5668,6,8,6,10,28,29,-1,30
AaB,5668,7,6,12,12,33,49,-16,30
Lyngby,5668,8,4,9,11,27,44,-17,21
Randers FC,5668,9,5,6,13,23,40,-17,21
Silkeborg IF,5668,10,5,4,13,26,45,-19,19
AGF Aarhus,5668,11,4,7,11,17,37,-20,19
Brondby,5669,1,22,5,3,74,33,41,71
FC Midtjylla,5669,2,20,5,5,69,44,25,65
FC Nords,5669,3,13,7,10,68,48,20,46
Copenhagen,5669,4,13,7,10,57,44,13,46
AaB,5669,5,8,12,10,37,40,-3,36
Sonderjyske,5669,6,8,6,10,28,29,-1,30
AC Horsens,5669,7,5,14,11,35,57,-22,29
Lyngby,5669,8,4,9,11,27,44,-17,21
Randers FC,5669,9,5,6,13,23,40,-17,21
Silkeborg IF,5669,10,5,4,13,26,45,-19,19
AGF Aarhus,5669,11,4,7,11,17,37,-20,19
FC Midtjylla,5670,1,21,5,4,69,37,32,68
Brondby,5670,2,20,5,5,73,38,35,65
FC Nords,5670,3,14,7,9,71,50,21,49
Copenhagen,5670,4,14,4,12,55,44,11,46
AaB,5670,5,10,11,9,42,40,2,41
Sonderjyske,5670,6,8,6,10,28,29,-1,30
AC Horsens,5670,7,5,12,13,31,58,-27,27
Randers FC,5670,8,6,6,12,25,40,-15,24
AGF Aarhus,5670,9,5,6,11,20,36,-16,21
Lyngby,5670,10,3,9,12,27,46,-19,18
Silkeborg IF,5670,11,5,3,14,25,48,-23,18
Brondby,5671,1,23,5,2,76,28,48,74
FC Midtjylla,5671,2,20,5,5,69,42,27,65
Copenhagen,5671,3,14,6,10,60,43,17,48
FC Nords,5671,4,14,6,10,69,55,14,48
Sonderjyske,5671,5,8,6,10,28,29,-1,30
AaB,5671,6,6,12,12,33,44,-11,30
AC Horsens,5671,7,6,12,12,34,55,-21,30
Randers FC,5671,8,6,6,12,26,39,-13,24
Silkeborg IF,5671,9,6,3,13,27,45,-18,21
Lyngby,5671,10,3,9,12,26,47,-21,18
AGF Aarhus,5671,11,4,6,12,17,38,-21,18
Brondby,5672,1,20,6,4,67,30,37,66
FC Midtjylla,5672,2,18,7,5,62,38,24,61
Copenhagen,5672,3,16,5,9,60,41,19,53
FC Nords,5672,4,14,7,9,74,52,22,49
AC Horsens,5672,5,7,14,9,38,53,-15,35
Sonderjyske,5672,6,8,6,10,28,29,-1,30
AaB,5672,7,6,11,13,34,47,-13,29
Lyngby,5672,8,4,9,11,27,44,-17,21
Randers FC,5672,9,5,6,13,23,40,-17,21
AGF Aarhus,5672,10,5,6,11,17,36,-19,21
Silkeborg IF,5672,11,5,3,14,25,45,-20,18
Brondby,5673,1,21,7,2,73,30,43,70
FC Midtjylla,5673,2,19,4,7,67,43,24,61
FC Nords,5673,3,15,6,9,73,50,23,51
Copenhagen,5673,4,12,7,11,54,48,6,43
AaB,5673,5,8,13,9,36,39,-3,37
AC Horsens,5673,6,6,13,11,34,53,-19,31
Sonderjyske,5673,7,8,6,10,28,29,-1,30
Randers FC,5673,8,5,7,12,24,40,-16,22
Lyngby,5673,9,3,10,11,27,45,-18,19
Silkeborg IF,5673,10,5,4,13,26,45,-19,19
AGF Aarhus,5673,11,4,7,11,17,37,-20,19
Brondby,5674,1,21,6,3,68,32,36,69
FC Midtjylla,5674,2,18,6,6,61,38,23,60
Copenhagen,5674,3,15,6,9,60,42,18,51
FC Nords,5674,4,13,7,10,72,53,19,46
AaB,5674,5,7,13,10,37,42,-5,34
AC Horsens,5674,6,5,16,9,35,52,-17,31
Sonderjyske,5674,7,8,6,10,28,29,-1,30
Lyngby,5674,8,4,9,11,30,45,-15,21
Randers FC,5674,9,5,6,13,24,43,-19,21
AGF Aarhus,5674,10,5,6,11,17,36,-19,21
Silkeborg IF,5674,11,5,3,14,25,45,-20,18
Brondby,5675,1,22,6,2,74,31,43,72
FC Midtjylla,5675,2,17,6,7,64,44,20,57
FC Nords,5675,3,15,6,9,75,52,23,51
Copenhagen,5675,4,13,6,11,55,44,11,45
AC Horsens,5675,5,7,14,9,38,52,-14,35
AaB,5675,6,7,12,11,38,47,-9,33
Sonderjyske,5675,7,8,6,10,28,29,-1,30
Randers FC,5675,8,5,7,12,24,40,-16,22
Silkeborg IF,5675,9,6,3,13,27,45,-18,21
Lyngby,5675,10,3,10,11,27,45,-18,19
AGF Aarhus,5675,11,4,6,12,17,38,-21,18
Brondby,5676,1,22,5,3,72,31,41,71
FC Midtjylla,5676,2,21,5,4,64,34,30,68
FC Nords,5676,3,14,8,8,70,48,22,50
Copenhagen,5676,4,14,4,12,55,45,10,46
AaB,5676,5,7,11,12,34,42,-8,32
Sonderjyske,5676,6,8,6,10,28,29,-1,30
AC Horsens,5676,7,5,13,12,32,53,-21,28
Randers FC,5676,8,6,6,12,25,40,-15,24
Silkeborg IF,5676,9,5,4,13,25,44,-19,19
AGF Aarhus,5676,10,4,7,11,16,36,-20,19
Lyngby,5676,11,3,9,12,27,46,-19,18
Brondby,5677,1,20,7,3,66,30,36,67
FC Midtjylla,5677,2,18,5,7,62,41,21,59
Copenhagen,5677,3,15,6,9,57,40,17,51
FC Nords,5677,4,14,8,8,70,48,22,50
AC Horsens,5677,5,7,13,10,37,49,-12,34
AaB,5677,6,6,13,11,35,45,-10,31
Sonderjyske,5677,7,8,6,10,28,29,-1,30
Randers FC,5677,8,5,7,12,24,40,-16,22
Silkeborg IF,5677,9,6,3,13,27,44,-17,21
Lyngby,5677,10,3,10,11,27,45,-18,19
AGF Aarhus,5677,11,4,6,12,16,38,-22,18
FC Midtjylla,5678,1,22,4,4,72,37,35,70
Brondby,5678,2,21,5,4,70,34,36,68
Copenhagen,5678,3,14,4,12,57,48,9,46
FC Nords,5678,4,12,8,10,73,55,18,44
AaB,5678,5,8,12,10,36,41,-5,36
AC Horsens,5678,6,6,13,11,36,55,-19,31
Sonderjyske,5678,7,8,6,10,28,29,-1,30
Randers FC,5678,8,5,7,12,24,40,-16,22
Lyngby,5678,9,3,10,11,27,45,-18,19
Silkeborg IF,5678,10,5,4,13,26,45,-19,19
AGF Aarhus,5678,11,4,7,11,17,37,-20,19
Brondby,5679,1,20,7,3,68,32,36,67
FC Midtjylla,5679,2,20,6,4,69,36,33,66
Copenhagen,5679,3,14,7,9,60,44,16,49
FC Nords,5679,4,13,6,11,73,55,18,45
AaB,5679,5,7,12,11,35,43,-8,33
AC Horsens,5679,6,6,14,10,34,55,-21,32
Sonderjyske,5679,7,8,6,10,28,29,-1,30
Randers FC,5679,8,6,6,12,26,40,-14,24
Silkeborg IF,5679,9,5,4,13,26,45,-19,19
AGF Aarhus,5679,10,4,7,11,17,37,-20,19
Lyngby,5679,11,3,9,12,27,47,-20,18
Brondby,5680,1,22,6,2,73,33,40,72
FC Midtjylla,5680,2,18,5,7,63,43,20,59
Copenhagen,5680,3,15,5,10,62,47,15,50
FC Nords,5680,4,14,7,9,76,54,22,49
AaB,5680,5,7,13,10,38,42,-4,34
Sonderjyske,5680,6,8,6,10,28,29,-1,30
AC Horsens,5680,7,5,14,11,32,51,-19,29
Randers FC,5680,8,5,7,12,24,40,-16,22
Silkeborg IF,5680,9,6,3,13,29,45,-16,21
Lyngby,5680,10,3,10,11,27,45,-18,19
AGF Aarhus,5680,11,4,6,12,17,40,-23,18
Brondby,5681,1,20,7,3,71,32,39,67
FC Midtjylla,5681,2,19,5,6,66,41,25,62
Copenhagen,5681,3,17,4,9,62,41,21,55
FC Nords,5681,4,14,8,8,76,51,25,50
Sonderjyske,5681,5,8,6,10,28,29,-1,30
AaB,5681,6,6,12,12,36,53,-17,30
AC Horsens,5681,7,5,14,11,34,53,-19,29
Randers FC,5681,8,5,7,12,24,40,-16,22
AGF Aarhus,5681,9,5,6,11,19,36,-17,21
Lyngby,5681,10,3,10,11,27,45,-18,19
Silkeborg IF,5681,11,5,3,14,25,47,-22,18
Brondby,5682,1,22,5,3,76,32,44,71
FC Midtjylla,5682,2,19,4,7,65,43,22,61
FC Nords,5682,3,14,6,10,73,52,21,48
Copenhagen,5682,4,14,5,11,60,47,13,47
AaB,5682,5,9,11,10,39,43,-4,38
AC Horsens,5682,6,6,13,11,37,59,-22,31
Sonderjyske,5682,7,8,6,10,28,29,-1,30
Lyngby,5682,8,4,9,11,27,44,-17,21
Randers FC,5682,9,5,6,13,23,40,-17,21
AGF Aarhus,5682,10,5,6,11,18,37,-19,21
Silkeborg IF,5682,11,5,3,14,26,46,-20,18
Brondby,5683,1,22,6,2,72,29,43,72
FC Midtjylla,5683,2,20,5,5,69,38,31,65
FC Nords,5683,3,13,9,8,71,50,21,48
Copenhagen,5683,4,12,5,13,56,47,9,41
AaB,5683,5,8,13,9,37,41,-4,37
Sonderjyske,5683,6,8,6,10,28,29,-1,30
AC Horsens,5683,7,5,14,11,34,60,-26,29
Randers FC,5683,8,6,6,12,25,39,-14,24
Silkeborg IF,5683,9,5,4,13,25,44,-19,19
AGF Aarhus,5683,10,4,7,11,16,36,-20,19
Lyngby,5683,11,3,9,12,26,46,-20,18
Brondby,5684,1,20,6,4,71,36,35,66
FC Midtjylla,5684,2,19,5,6,65,38,27,62
FC Nords,5684,3,15,6,9,73,53,20,51
Copenhagen,5684,4,14,6,10,58,44,14,48
AaB,5684,5,7,14,9,40,43,-3,35
AC Horsens,5684,6,6,13,11,34,53,-19,31
Sonderjyske,5684,7,8,6,10,28,29,-1,30
Lyngby,5684,8,4,9,11,30,46,-16,21
Silkeborg IF,5684,9,6,3,13,28,44,-16,21
Randers FC,5684,10,5,6,13,25,43,-18,21
AGF Aarhus,5684,11,4,6,12,16,39,-23,18
FC Midtjylla,5685,1,21,5,4,71,33,38,68
Brondby,5685,2,20,7,3,68,32,36,67
FC Nords,5685,3,16,6,8,77,51,26,54
Copenhagen,5685,4,12,4,14,54,48,6,40
AaB,5685,5,8,11,11,36,49,-13,35
AC Horsens,5685,6,6,13,11,32,51,-19,31
Sonderjyske,5685,7,8,6,10,28,29,-1,30
Randers FC,5685,8,6,6,12,24,39,-15,24
Silkeborg IF,5685,9,6,3,13,27,44,-17,21
Lyngby,5685,10,3,9,12,26,45,-19,18
AGF Aarhus,5685,11,4,6,12,16,38,-22,18
Brondby,5686,1,20,6,4,67,29,38,66
FC Midtjylla,5686,2,19,5,6,66,42,24,62
FC Nords,5686,3,15,6,9,73,53,20,51
Copenhagen,5686,4,13,5,12,55,45,10,44
AaB,5686,5,8,12,10,37,43,-6,36
AC Horsens,5686,6,8,12,10,37,49,-12,36
Sonderjyske,5686,7,8,6,10,28,29,-1,30
Randers FC,5686,8,6,6,12,24,39,-15,24
AGF Aarhus,5686,9,5,6,11,19,36,-17,21
Lyngby,5686,10,3,9,12,26,45,-19,18
Silkeborg IF,5686,11,5,3,14,25,47,-22,18
FC Midtjylla,5687,1,20,5,5,64,35,29,65
Brondby,5687,2,19,7,4,65,32,33,64
FC Nords,5687,3,15,8,7,73,46,27,53
Copenhagen,5687,4,12,6,12,53,45,8,42
AaB,5687,5,8,11,11,36,40,-4,35
AC Horsens,5687,6,7,13,10,33,52,-19,34
Sonderjyske,5687,7,8,6,10,28,29,-1,30
Lyngby,5687,8,4,9,11,28,44,-16,21
Randers FC,5687,9,5,6,13,23,41,-18,21
Silkeborg IF,5687,10,5,4,13,26,45,-19,19
AGF Aarhus,5687,11,4,7,11,17,37,-20,19
Brondby,5688,1,21,6,3,71,32,39,69
FC Midtjylla,5688,2,19,6,5,65,37,28,63
FC Nords,5688,3,14,6,10,78,56,22,48
Copenhagen,5688,4,14,6,10,58,44,14,48
AaB,5688,5,8,13,9,36,40,-4,37
Sonderjyske,5688,6,8,6,10,28,29,-1,30
AC Horsens,5688,7,5,13,12,33,58,-25,28
Lyngby,5688,8,4,9,11,29,44,-15,21
Silkeborg IF,5688,9,6,3,13,27,45,-18,21
Randers FC,5688,10,5,6,13,23,42,-19,21
AGF Aarhus,5688,11,4,6,12,17,38,-21,18
Brondby,5689,1,18,7,5,63,32,31,61
FC Midtjylla,5689,2,18,5,7,61,40,21,59
FC Nords,5689,3,16,6,8,75,48,27,54
Copenhagen,5689,4,16,4,10,60,45,15,52
AaB,5689,5,8,12,10,37,41,-4,36
AC Horsens,5689,6,7,12,11,36,52,-16,33
Sonderjyske,5689,7,8,6,10,28,29,-1,30
Lyngby,5689,8,4,9,11,28,45,-17,21
Randers FC,5689,9,5,6,13,24,41,-17,21
AGF Aarhus,5689,10,5,6,11,17,36,-19,21
Silkeborg IF,5689,11,5,3,14,25,45,-20,18
Brondby,5690,1,23,5,2,79,31,48,74
FC Midtjylla,5690,2,21,4,5,66,42,24,67
FC Nords,5690,3,14,6,10,73,53,20,48
Copenhagen,5690,4,12,4,14,53,48,5,40
AaB,5690,5,9,11,10,40,43,-3,38
Sonderjyske,5690,6,8,6,10,28,29,-1,30
AC Horsens,5690,7,6,12,12,35,55,-20,30
Randers FC,5690,8,6,6,12,24,39,-15,24
AGF Aarhus,5690,9,5,6,11,18,36,-18,21
Lyngby,5690,10,3,9,12,26,45,-19,18
Silkeborg IF,5690,11,5,3,14,25,46,-21,18
Brondby,5691,1,21,6,3,73,34,39,69
FC Midtjylla,5691,2,19,5,6,67,41,26,62
FC Nords,5691,3,16,6,8,74,47,27,54
Copenhagen,5691,4,14,6,10,54,43,11,48
AC Horsens,5691,5,6,14,10,32,50,-18,32
Sonderjyske,5691,6,8,6,10,28,29,-1,30
AaB,5691,7,6,11,13,35,46,-11,29
Lyngby,5691,8,4,9,11,29,44,-15,21
Randers FC,5691,9,5,6,13,23,42,-19,21
Silkeborg IF,5691,10,5,4,13,27,46,-19,19
AGF Aarhus,5691,11,4,7,11,18,38,-20,19
Brondby,5692,1,22,6,2,81,37,44,72
FC Midtjylla,5692,2,18,6,6,62,40,22,60
FC Nords,5692,3,15,7,8,78,51,27,52
Copenhagen,5692,4,13,5,12,54,48,6,44
AaB,5692,5,8,12,10,41,45,-4,36
Sonderjyske,5692,6,8,6,10,28,29,-1,30
AC Horsens,5692,7,5,14,11,33,54,-21,29
Lyngby,5692,8,4,9,11,28,44,-16,21
Randers FC,5692,9,5,6,13,23,41,-18,21
Silkeborg IF,5692,10,5,4,13,28,47,-19,19
AGF Aarhus,5692,11,4,7,11,19,39,-20,19
Brondby,5693,1,21,7,2,75,32,43,70
FC Midtjylla,5693,2,20,4,6,67,39,28,64
Copenhagen,5693,3,14,7,9,58,43,15,49
FC Nords,5693,4,13,7,10,76,55,21,46
AC Horsens,5693,5,7,13,10,36,56,-20,34
Sonderjyske,5693,6,8,6,10,28,29,-1,30
AaB,5693,7,6,12,12,34,47,-13,30
Randers FC,5693,8,6,6,12,25,39,-14,24
AGF Aarhus,5693,9,5,6,11,17,36,-19,21
Lyngby,5693,10,3,9,12,26,46,-20,18
Silkeborg IF,5693,11,5,3,14,25,45,-20,18
Brondby,5694,1,20,6,4,71,34,37,66
FC Midtjylla,5694,2,19,7,4,63,37,26,64
FC Nords,5694,3,16,6,8,80,51,29,54
Copenhagen,5694,4,14,6,10,56,39,17,48
AC Horsens,5694,5,6,13,11,34,55,-21,31
Sonderjyske,5694,6,8,6,10,28,29,-1,30
AaB,5694,7,6,12,12,33,47,-14,30
Lyngby,5694,8,4,9,11,27,44,-17,21
Randers FC,5694,9,5,6,13,23,40,-17,21
Silkeborg IF,5694,10,5,4,13,25,44,-19,19
AGF Aarhus,5694,11,4,7,11,16,36,-20,19
Brondby,5695,1,21,7,2,71,30,41,70
FC Midtjylla,5695,2,18,7,5,60,38,22,61
Copenhagen,5695,3,15,6,9,57,39,18,51
FC Nords,5695,4,13,8,9,70,49,21,47
AaB,5695,5,8,12,10,37,43,-6,36
Sonderjyske,5695,6,8,6,10,28,29,-1,30
AC Horsens,5695,7,5,12,13,33,55,-22,27
Lyngby,5695,8,4,9,11,28,45,-17,21
Randers FC,5695,9,5,6,13,24,41,-17,21
AGF Aarhus,5695,10,5,6,11,18,36,-18,21
Silkeborg IF,5695,11,5,3,14,25,46,-21,18
Brondby,5696,1,19,8,3,70,36,34,65
FC Midtjylla,5696,2,20,5,5,66,37,29,65
FC Nords,5696,3,15,6,9,76,55,21,51
Copenhagen,5696,4,13,5,12,59,46,13,44
AaB,5696,5,7,13,10,35,41,-6,34
AC Horsens,5696,6,7,13,10,35,52,-17,34
Sonderjyske,5696,7,8,6,10,28,29,-1,30
Lyngby,5696,8,4,9,11,30,45,-15,21
AGF Aarhus,5696,9,5,6,11,20,38,-18,21
Randers FC,5696,10,5,6,13,24,43,-19,21
Silkeborg IF,5696,11,5,3,14,27,48,-21,18
Brondby,5697,1,20,6,4,70,33,37,66
FC Midtjylla,5697,2,19,5,6,62,40,22,62
Copenhagen,5697,3,15,5,10,61,43,18,50
FC Nords,5697,4,13,9,8,70,49,21,48
AaB,5697,5,8,12,10,35,40,-5,36
AC Horsens,5697,6,6,13,11,33,52,-19,31
Sonderjyske,5697,7,8,6,10,28,29,-1,30
AGF Aarhus,5697,8,5,6,11,21,36,-15,21
Lyngby,5697,9,4,9,11,27,44,-17,21
Randers FC,5697,10,5,6,13,23,40,-17,21
Silkeborg IF,5697,11,5,3,14,25,49,-24,18
FC Midtjylla,5698,1,20,5,5,65,39,26,65
Brondby,5698,2,19,6,5,69,35,34,63
FC Nords,5698,3,14,7,9,69,48,21,49
Copenhagen,5698,4,12,6,12,54,47,7,42
AC Horsens,5698,5,8,14,8,38,48,-10,38
AaB,5698,6,8,12,10,37,41,-4,36
Sonderjyske,5698,7,8,6,10,28,29,-1,30
Randers FC,5698,8,6,6,12,25,40,-15,24
AGF Aarhus,5698,9,5,6,11,18,37,-19,21
Lyngby,5698,10,3,9,12,27,46,-19,18
Silkeborg IF,5698,11,5,3,14,26,46,-20,18
Brondby,5699,1,20,7,3,72,34,38,67
FC Midtjylla,5699,2,19,4,7,64,41,23,61
FC Nords,5699,3,14,9,7,73,48,25,51
Copenhagen,5699,4,14,5,11,56,42,14,47
AaB,5699,5,8,12,10,35,40,-5,36
AC Horsens,5699,6,6,13,11,35,56,-21,31
Sonderjyske,5699,7,8,6,10,28,29,-1,30
Lyngby,5699,8,4,9,11,28,45,-17,21
Randers FC,5699,9,5,6,13,24,41,-17,21
Silkeborg IF,5699,10,6,3,13,26,44,-18,21
AGF Aarhus,5699,11,4,6,12,16,37,-21,18
Brondby,5700,1,22,6,2,72,32,40,72
FC Midtjylla,5700,2,18,6,6,66,43,23,60
FC Nords,5700,3,13,9,8,80,53,27,48
Copenhagen,5700,4,14,5,11,57,44,13,47
AaB,5700,5,7,13,10,35,41,-6,34
AC Horsens,5700,6,6,13,11,36,59,-23,31
Sonderjyske,5700,7,8,6,10,28,29,-1,30
Randers FC,5700,8,6,6,12,24,39,-15,24
Silkeborg IF,5700,9,5,4,13,26,45,-19,19
AGF Aarhus,5700,10,4,7,11,17,37,-20,19
Lyngby,5700,11,3,9,12,26,45,-19,18
Brondby,5701,1,21,6,3,72,31,41,69
FC Midtjylla,5701,2,21,4,5,67,37,30,67
FC Nords,5701,3,14,6,10,72,51,21,48
Copenhagen,5701,4,14,5,11,58,45,13,47
AC Horsens,5701,5,7,12,11,36,55,-19,33
AaB,5701,6,7,11,12,36,48,-12,32
Sonderjyske,5701,7,8,6,10,28,29,-1,30
Lyngby,5701,8,4,9,11,29,45,-16,21
Silkeborg IF,5701,9,6,3,13,28,44,-16,21
Randers FC,5701,10,5,6,13,24,42,-18,21
AGF Aarhus,5701,11,4,6,12,16,39,-23,18
Brondby,5702,1,21,5,4,73,31,42,68
FC Midtjylla,5702,2,18,6,6,66,47,19,60
Copenhagen,5702,3,14,7,9,59,44,15,49
FC Nords,5702,4,14,6,10,76,56,20,48
AaB,5702,5,8,13,9,39,43,-4,37
AC Horsens,5702,6,6,13,11,36,54,-18,31
Sonderjyske,5702,7,8,6,10,28,29,-1,30
Randers FC,5702,8,5,7,12,24,40,-16,22
Silkeborg IF,5702,9,6,3,13,30,45,-15,21
Lyngby,5702,10,3,10,11,27,45,-18,19
AGF Aarhus,5702,11,4,6,12,17,41,-24,18
Brondby,5703,1,20,5,5,70,36,34,65
FC Midtjylla,5703,2,18,5,7,63,45,18,59
Copenhagen,5703,3,17,4,9,61,41,20,55
FC Nords,5703,4,15,6,9,78,52,26,51
AaB,5703,5,8,11,11,39,43,-4,35
AC Horsens,5703,6,6,13,11,35,55,-20,31
Sonderjyske,5703,7,8,6,10,28,29,-1,30
Lyngby,5703,8,4,9,11,29,44,-15,21
Silkeborg IF,5703,9,6,3,13,26,44,-18,21
Randers FC,5703,10,5,6,13,23,42,-19,21
AGF Aarhus,5703,11,4,6,12,16,37,-21,18
Brondby,5704,1,22,5,3,67,29,38,71
FC Midtjylla,5704,2,20,4,6,70,45,25,64
Copenhagen,5704,3,14,6,10,61,46,15,48
FC Nords,5704,4,13,7,10,74,53,21,46
AaB,5704,5,7,12,11,37,44,-7,33
AC Horsens,5704,6,7,12,11,41,59,-18,33
Sonderjyske,5704,7,8,6,10,28,29,-1,30
Lyngby,5704,8,4,9,11,27,44,-17,21
Randers FC,5704,9,5,6,13,23,40,-17,21
Silkeborg IF,5704,10,5,4,13,26,45,-19,19
AGF Aarhus,5704,11,4,7,11,17,37,-20,19
Brondby,5705,1,20,8,2,70,32,38,68
FC Midtjylla,5705,2,18,7,5,62,38,24,61
FC Nords,5705,3,15,8,7,79,48,31,53
Copenhagen,5705,4,12,5,13,53,46,7,41
AaB,5705,5,8,11,11,35,41,-6,35
AC Horsens,5705,6,7,13,10,31,51,-20,34
Sonderjyske,5705,7,8,6,10,28,29,-1,30
Lyngby,5705,8,4,9,11,28,45,-17,21
Randers FC,5705,9,5,6,13,24,41,-17,21
AGF Aarhus,5705,10,5,6,11,18,36,-18,21
Silkeborg IF,5705,11,5,3,14,25,46,-21,18
Brondby,5706,1,21,7,2,72,28,44,70
FC Midtjylla,5706,2,19,5,6,66,46,20,62
FC Nords,5706,3,16,6,8,81,53,28,54
Copenhagen,5706,4,13,4,13,59,54,5,43
AaB,5706,5,8,13,9,40,43,-3,37
Sonderjyske,5706,6,8,6,10,28,29,-1,30
AC Horsens,5706,7,5,13,12,31,51,-20,28
Randers FC,5706,8,6,6,12,24,39,-15,24
Silkeborg IF,5706,9,5,4,13,25,44,-19,19
AGF Aarhus,5706,10,4,7,11,16,36,-20,19
Lyngby,5706,11,3,9,12,26,45,-19,18
FC Midtjylla,5707,1,20,5,5,73,43,30,65
Brondby,5707,2,19,6,5,67,33,34,63
Copenhagen,5707,3,15,5,10,63,44,19,50
FC Nords,5707,4,13,7,10,71,57,14,46
AaB,5707,5,7,15,8,36,39,-3,36
AC Horsens,5707,6,6,14,10,32,52,-20,32
Sonderjyske,5707,7,8,6,10,28,29,-1,30
Randers FC,5707,8,6,6,12,26,39,-13,24
Silkeborg IF,5707,9,6,3,13,27,45,-18,21
Lyngby,5707,10,3,9,12,26,47,-21,18
AGF Aarhus,5707,11,4,6,12,17,38,-21,18
Brondby,5708,1,22,5,3,73,30,43,71
FC Midtjylla,5708,2,17,6,7,60,42,18,57
FC Nords,5708,3,15,7,8,73,47,26,52
Copenhagen,5708,4,13,5,12,55,46,9,44
AC Horsens,5708,5,8,13,9,39,52,-13,37
AaB,5708,6,7,12,11,36,45,-9,33
Sonderjyske,5708,7,8,6,10,28,29,-1,30
Lyngby,5708,8,4,9,11,28,45,-17,21
Randers FC,5708,9,5,6,13,24,41,-17,21
AGF Aarhus,5708,10,5,6,11,18,36,-18,21
Silkeborg IF,5708,11,5,3,14,25,46,-21,18
Brondby,5709,1,21,6,3,71,31,40,69
FC Midtjylla,5709,2,21,4,5,66,37,29,67
Copenhagen,5709,3,14,6,10,56,41,15,48
FC Nords,5709,4,13,7,10,70,52,18,46
AC Horsens,5709,5,7,12,11,37,55,-18,33
AaB,5709,6,6,13,11,34,44,-10,31
Sonderjyske,5709,7,8,6,10,28,29,-1,30
Lyngby,5709,8,4,9,11,30,46,-16,21
Randers FC,5709,9,5,6,13,25,43,-18,21
Silkeborg IF,5709,10,5,4,13,26,45,-19,19
AGF Aarhus,5709,11,4,7,11,17,37,-20,19
Brondby,5710,1,21,6,3,77,33,44,69
FC Midtjylla,5710,2,19,5,6,64,38,26,62
FC Nords,5710,3,14,7,9,74,53,21,49
Copenhagen,5710,4,13,5,12,57,51,6,44
AaB,5710,5,7,14,9,35,41,-6,35
AC Horsens,5710,6,7,13,10,36,53,-17,34
Sonderjyske,5710,7,8,6,10,28,29,-1,30
Lyngby,5710,8,4,9,11,29,46,-17,21
Randers FC,5710,9,5,6,13,25,42,-17,21
AGF Aarhus,5710,10,5,6,11,18,37,-19,21
Silkeborg IF,5710,11,5,3,14,26,46,-20,18
Brondby,5711,1,20,7,3,70,30,40,67
FC Midtjylla,5711,2,18,4,8,60,41,19,58
FC Nords,5711,3,15,6,9,72,50,22,51
Copenhagen,5711,4,14,5,11,56,43,13,47
AaB,5711,5,8,13,9,37,40,-3,37
AC Horsens,5711,6,7,13,10,34,51,-17,34
Sonderjyske,5711,7,8,6,10,28,29,-1,30
Lyngby,5711,8,4,9,11,31,45,-14,21
Silkeborg IF,5711,9,6,3,13,26,44,-18,21
Randers FC,5711,10,5,6,13,24,44,-20,21
AGF Aarhus,5711,11,4,6,12,16,37,-21,18
Brondby,5712,1,21,7,2,75,34,41,70
FC Midtjylla,5712,2,17,6,7,61,43,18,57
FC Nords,5712,3,15,7,8,77,55,22,52
Copenhagen,5712,4,14,5,11,59,46,13,47
AaB,5712,5,8,12,10,45,45,0,36
AC Horsens,5712,6,6,13,11,38,58,-20,31
Sonderjyske,5712,7,8,6,10,28,29,-1,30
Randers FC,5712,8,6,6,12,24,39,-15,24
Silkeborg IF,5712,9,5,4,13,27,46,-19,19
AGF Aarhus,5712,10,4,7,11,18,38,-20,19
Lyngby,5712,11,3,9,12,26,45,-19,18
FC Midtjylla,5713,1,20,5,5,69,41,28,65
Brondby,5713,2,19,6,5,67,34,33,63
FC Nords,5713,3,15,7,8,77,53,24,52
Copenhagen,5713,4,14,5,11,58,45,13,47
AaB,5713,5,8,13,9,39,43,-4,37
Sonderjyske,5713,6,8,6,10,28,29,-1,30
AC Horsens,5713,7,5,14,11,33,53,-20,29
Lyngby,5713,8,4,9,11,28,44,-16,21
Randers FC,5713,9,5,6,13,23,41,-18,21
AGF Aarhus,5713,10,5,6,11,17,36,-19,21
Silkeborg IF,5713,11,5,3,14,25,45,-20,18
Brondby,5714,1,20,6,4,68,33,35,66
FC Midtjylla,5714,2,20,5,5,63,35,28,65
FC Nords,5714,3,14,8,8,72,48,24,50
Copenhagen,5714,4,13,5,12,55,48,7,44
AaB,5714,5,9,12,9,37,38,-1,39
Sonderjyske,5714,6,8,6,10,28,29,-1,30
AC Horsens,5714,7,5,14,11,33,52,-19,29
Lyngby,5714,8,4,9,11,29,44,-15,21
Randers FC,5714,9,5,6,13,23,42,-19,21
Silkeborg IF,5714,10,5,4,13,26,45,-19,19
AGF Aarhus,5714,11,4,7,11,17,37,-20,19
Brondby,5715,1,21,6,3,74,34,40,69
FC Midtjylla,5715,2,20,6,4,68,39,29,66
FC Nords,5715,3,14,9,7,82,53,29,51
Copenhagen,5715,4,13,5,12,55,49,6,44
AaB,5715,5,7,13,10,38,47,-9,34
Sonderjyske,5715,6,8,6,10,28,29,-1,30
AC Horsens,5715,7,5,13,12,36,57,-21,28
Randers FC,5715,8,6,6,12,25,39,-14,24
Silkeborg IF,5715,9,5,4,13,25,44,-19,19
AGF Aarhus,5715,10,4,7,11,16,36,-20,19
Lyngby,5715,11,3,9,12,26,46,-20,18
Brondby,5716,1,20,6,4,68,34,34,66
FC Midtjylla,5716,2,18,6,6,63,42,21,60
FC Nords,5716,3,14,8,8,77,52,25,50
Copenhagen,5716,4,14,5,11,58,44,14,47
AC Horsens,5716,5,7,14,9,38,53,-15,35
AaB,5716,6,7,13,10,37,42,-5,34
Sonderjyske,5716,7,8,6,10,28,29,-1,30
Randers FC,5716,8,6,6,12,24,39,-15,24
Silkeborg IF,5716,9,5,4,13,25,44,-19,19
AGF Aarhus,5716,10,4,7,11,16,36,-20,19
Lyngby,5716,11,3,9,12,26,45,-19,18
Brondby,5717,1,21,6,3,71,32,39,69
FC Midtjylla,5717,2,20,5,5,68,42,26,65
FC Nords,5717,3,15,7,8,76,53,23,52
Copenhagen,5717,4,12,4,14,57,50,7,40
AaB,5717,5,8,11,11,37,42,-5,35
AC Horsens,5717,6,7,13,10,36,52,-16,34
Sonderjyske,5717,7,8,6,10,28,29,-1,30
Randers FC,5717,8,6,6,12,26,40,-14,24
Silkeborg IF,5717,9,6,3,13,26,44,-18,21
Lyngby,5717,10,3,9,12,27,47,-20,18
AGF Aarhus,5717,11,4,6,12,16,37,-21,18
Brondby,5718,1,20,6,4,68,34,34,66
FC Midtjylla,5718,2,20,5,5,65,39,26,65
FC Nords,5718,3,15,6,9,78,53,25,51
Copenhagen,5718,4,15,5,10,58,40,18,50
AaB,5718,5,7,11,12,36,44,-8,32
AC Horsens,5718,6,6,13,11,35,56,-21,31
Sonderjyske,5718,7,8,6,10,28,29,-1,30
Lyngby,5718,8,4,9,11,30,45,-15,21
Randers FC,5718,9,5,6,13,24,43,-19,21
Silkeborg IF,5718,10,5,4,13,26,45,-19,19
AGF Aarhus,5718,11,4,7,11,17,37,-20,19
Brondby,5719,1,22,6,2,73,28,45,72
FC Midtjylla,5719,2,20,4,6,64,37,27,64
FC Nords,5719,3,15,6,9,75,52,23,51
Copenhagen,5719,4,13,6,11,58,49,9,45
AaB,5719,5,7,11,12,34,44,-10,32
AC Horsens,5719,6,6,13,11,33,53,-20,31
Sonderjyske,5719,7,8,6,10,28,29,-1,30
Lyngby,5719,8,4,9,11,28,44,-16,21
Silkeborg IF,5719,9,6,3,13,26,44,-18,21
Randers FC,5719,10,5,6,13,23,41,-18,21
AGF Aarhus,5719,11,4,6,12,16,37,-21,18
Brondby,5720,1,20,8,2,72,32,40,68
FC Midtjylla,5720,2,18,7,5,66,42,24,61
FC Nords,5720,3,14,8,8,74,51,23,50
Copenhagen,5720,4,13,6,11,58,47,11,45
AaB,5720,5,8,12,10,39,43,-4,36
Sonderjyske,5720,6,8,6,10,28,29,-1,30
AC Horsens,5720,7,5,15,10,30,50,-20,30
Randers FC,5720,8,5,7,12,23,39,-16,22
Silkeborg IF,5720,9,6,3,13,28,45,-17,21
Lyngby,5720,10,3,10,11,26,44,-18,19
AGF Aarhus,5720,11,4,6,12,17,39,-22,18
Brondby,5721,1,21,7,2,73,29,44,70
FC Midtjylla,5721,2,21,5,4,66,34,32,68
FC Nords,5721,3,15,6,9,72,52,20,51
Copenhagen,5721,4,13,6,11,54,41,13,45
AaB,5721,5,7,12,11,37,46,-9,33
Sonderjyske,5721,6,8,6,10,28,29,-1,30
AC Horsens,5721,7,5,12,13,32,58,-26,27
Randers FC,5721,8,5,7,12,25,41,-16,22
Lyngby,5721,9,3,10,11,28,46,-18,19
Silkeborg IF,5721,10,5,4,13,26,45,-19,19
AGF Aarhus,5721,11,4,7,11,17,37,-20,19
Brondby,5722,1,20,5,5,65,33,32,65
FC Midtjylla,5722,2,20,4,6,65,38,27,64
FC Nords,5722,3,16,6,8,76,47,29,54
Copenhagen,5722,4,15,4,11,58,44,14,49
AC Horsens,5722,5,7,12,11,35,55,-20,33
AaB,5722,6,7,11,12,35,43,-8,32
Sonderjyske,5722,7,8,6,10,28,29,-1,30
Randers FC,5722,8,5,7,12,23,39,-16,22
Lyngby,5722,9,3,10,11,26,44,-18,19
Silkeborg IF,5722,10,5,4,13,26,45,-19,19
AGF Aarhus,5722,11,4,7,11,17,37,-20,19
Brondby,5723,1,20,6,4,66,32,34,66
FC Midtjylla,5723,2,20,5,5,67,42,25,65
Copenhagen,5723,3,15,5,10,59,43,16,50
FC Nords,5723,4,13,6,11,73,55,18,45
AaB,5723,5,8,13,9,38,40,-2,37
AC Horsens,5723,6,6,13,11,35,52,-17,31
Sonderjyske,5723,7,8,6,10,28,29,-1,30
Lyngby,5723,8,4,9,11,28,44,-16,21
Randers FC,5723,9,5,6,13,23,41,-18,21
Silkeborg IF,5723,10,5,4,13,26,45,-19,19
AGF Aarhus,5723,11,4,7,11,17,37,-20,19
Brondby,5724,1,22,6,2,73,32,41,72
FC Midtjylla,5724,2,18,5,7,62,43,19,59
FC Nords,5724,3,15,7,8,78,50,28,52
Copenhagen,5724,4,14,5,11,56,47,9,47
AaB,5724,5,8,13,9,38,39,-1,37
Sonderjyske,5724,6,8,6,10,28,29,-1,30
AC Horsens,5724,7,5,12,13,33,55,-22,27
Randers FC,5724,8,5,7,12,25,41,-16,22
AGF Aarhus,5724,9,5,6,11,19,38,-19,21
Lyngby,5724,10,3,10,11,28,46,-18,19
Silkeborg IF,5724,11,5,3,14,27,47,-20,18
FC Midtjylla,5725,1,22,4,4,70,38,32,70
Brondby,5725,2,21,6,3,71,32,39,69
FC Nords,5725,3,15,6,9,79,52,27,51
Copenhagen,5725,4,13,5,12,57,47,10,44
AaB,5725,5,7,12,11,38,48,-10,33
Sonderjyske,5725,6,8,6,10,28,29,-1,30
AC Horsens,5725,7,5,13,12,32,56,-24,28
Lyngby,5725,8,4,9,11,29,46,-17,21
Randers FC,5725,9,5,6,13,25,42,-17,21
AGF Aarhus,5725,10,5,6,11,18,37,-19,21
Silkeborg IF,5725,11,5,3,14,26,46,-20,18
Brondby,5726,1,19,7,4,70,34,36,64
FC Midtjylla,5726,2,19,6,5,66,41,25,63
Copenhagen,5726,3,16,4,10,56,42,14,52
FC Nords,5726,4,13,8,9,72,54,18,47
AaB,5726,5,7,13,10,40,43,-3,34
AC Horsens,5726,6,6,14,10,33,49,-16,32
Sonderjyske,5726,7,8,6,10,28,29,-1,30
Randers FC,5726,8,5,7,12,23,39,-16,22
Silkeborg IF,5726,9,6,3,13,27,45,-18,21
Lyngby,5726,10,3,10,11,26,44,-18,19
AGF Aarhus,5726,11,4,6,12,17,38,-21,18
Brondby,5727,1,20,6,4,70,30,40,66
FC Midtjylla,5727,2,19,6,5,66,45,21,63
FC Nords,5727,3,15,7,8,76,49,27,52
Copenhagen,5727,4,13,5,12,56,47,9,44
AaB,5727,5,8,11,11,38,45,-7,35
AC Horsens,5727,6,6,15,9,35,51,-16,33
Sonderjyske,5727,7,8,6,10,28,29,-1,30
Randers FC,5727,8,5,7,12,24,40,-16,22
AGF Aarhus,5727,9,5,6,11,17,36,-19,21
Lyngby,5727,10,3,10,11,27,45,-18,19
Silkeborg IF,5727,11,5,3,14,25,45,-20,18
Brondby,5728,1,20,8,2,70,29,41,68
FC Midtjylla,5728,2,19,7,4,64,36,28,64
FC Nords,5728,3,14,6,10,74,51,23,48
Copenhagen,5728,4,13,7,10,54,41,13,46
AaB,5728,5,7,12,11,36,45,-9,33
AC Horsens,5728,6,6,14,10,32,54,-22,32
Sonderjyske,5728,7,8,6,10,28,29,-1,30
Randers FC,5728,8,5,7,12,23,39,-16,22
Lyngby,5728,9,3,10,11,26,44,-18,19
Silkeborg IF,5728,10,5,4,13,25,44,-19,19
AGF Aarhus,5728,11,4,7,11,16,36,-20,19
Brondby,5729,1,20,6,4,68,30,38,66
FC Midtjylla,5729,2,19,5,6,66,41,25,62
FC Nords,5729,3,16,7,7,77,49,28,55
Copenhagen,5729,4,14,5,11,60,49,11,47
AaB,5729,5,7,14,9,36,43,-7,35
Sonderjyske,5729,6,8,6,10,28,29,-1,30
AC Horsens,5729,7,5,13,12,33,54,-21,28
Randers FC,5729,8,5,7,12,24,40,-16,22
Lyngby,5729,9,3,10,11,27,45,-18,19
Silkeborg IF,5729,10,5,4,13,27,46,-19,19
AGF Aarhus,5729,11,4,7,11,18,38,-20,19
Brondby,5730,1,20,6,4,73,34,39,66
FC Midtjylla,5730,2,20,4,6,67,38,29,64
Copenhagen,5730,3,14,6,10,59,45,14,48
FC Nords,5730,4,13,7,10,73,58,15,46
AaB,5730,5,9,11,10,39,43,-4,38
AC Horsens,5730,6,7,12,11,35,54,-19,33
Sonderjyske,5730,7,8,6,10,28,29,-1,30
Lyngby,5730,8,4,9,11,29,44,-15,21
Randers FC,5730,9,5,6,13,23,42,-19,21
Silkeborg IF,5730,10,5,4,13,26,45,-19,19
AGF Aarhus,5730,11,4,7,11,17,37,-20,19
Brondby,5731,1,21,7,2,70,27,43,70
FC Midtjylla,5731,2,20,5,5,67,40,27,65
Copenhagen,5731,3,13,7,10,57,47,10,46
FC Nords,5731,4,12,7,11,68,52,16,43
AaB,5731,5,7,13,10,36,44,-8,34
AC Horsens,5731,6,6,15,9,36,50,-14,33
Sonderjyske,5731,7,8,6,10,28,29,-1,30
Randers FC,5731,8,6,6,12,25,40,-15,24
AGF Aarhus,5731,9,5,6,11,17,36,-19,21
Lyngby,5731,10,3,9,12,27,46,-19,18
Silkeborg IF,5731,11,5,3,14,25,45,-20,18
FC Midtjylla,5732,1,21,5,4,69,36,33,68
Brondby,5732,2,20,7,3,69,30,39,67
FC Nords,5732,3,15,7,8,72,51,21,52
Copenhagen,5732,4,13,5,12,56,47,9,44
AaB,5732,5,7,12,11,38,47,-9,33
Sonderjyske,5732,6,8,6,10,28,29,-1,30
AC Horsens,5732,7,6,12,12,39,58,-19,30
Randers FC,5732,8,6,6,12,26,39,-13,24
Silkeborg IF,5732,9,5,4,13,25,44,-19,19
AGF Aarhus,5732,10,4,7,11,16,36,-20,19
Lyngby,5732,11,3,9,12,26,47,-21,18
Brondby,5733,1,19,6,5,74,40,34,63
FC Midtjylla,5733,2,19,5,6,64,40,24,62
FC Nords,5733,3,14,8,8,78,53,25,50
Copenhagen,5733,4,14,5,11,64,51,13,47
AaB,5733,5,8,12,10,40,40,0,36
AC Horsens,5733,6,8,12,10,40,62,-22,36
Sonderjyske,5733,7,8,6,10,28,29,-1,30
Lyngby,5733,8,4,9,11,30,44,-14,21
Randers FC,5733,9,5,6,13,23,43,-20,21
Silkeborg IF,5733,10,5,4,13,25,44,-19,19
AGF Aarhus,5733,11,4,7,11,16,36,-20,19
Brondby,5734,1,20,5,5,70,35,35,65
FC Midtjylla,5734,2,18,4,8,61,43,18,58
FC Nords,5734,3,17,6,7,78,46,32,57
Copenhagen,5734,4,16,4,10,61,44,17,52
AC Horsens,5734,5,7,12,11,36,56,-20,33
AaB,5734,6,7,11,12,35,43,-8,32
Sonderjyske,5734,7,8,6,10,28,29,-1,30
Lyngby,5734,8,4,9,11,27,44,-17,21
Randers FC,5734,9,5,6,13,23,40,-17,21
Silkeborg IF,5734,10,6,3,13,26,44,-18,21
AGF Aarhus,5734,11,4,6,12,16,37,-21,18
Brondby,5735,1,19,6,5,69,35,34,63
FC Midtjylla,5735,2,19,6,5,69,41,28,63
FC Nords,5735,3,14,7,9,75,53,22,49
Copenhagen,5735,4,14,6,10,59,44,15,48
AaB,5735,5,8,11,11,37,49,-12,35
AC Horsens,5735,6,7,14,9,41,54,-13,35
Sonderjyske,5735,7,8,6,10,28,29,-1,30
Randers FC,5735,8,6,6,12,25,39,-14,24
AGF Aarhus,5735,9,5,6,11,19,37,-18,21
Lyngby,5735,10,3,9,12,26,46,-20,18
Silkeborg IF,5735,11,5,3,14,26,47,-21,18
Brondby,5736,1,22,6,2,77,32,45,72
FC Midtjylla,5736,2,20,5,5,74,43,31,65
FC Nords,5736,3,14,6,10,77,60,17,48
Copenhagen,5736,4,14,5,11,60,46,14,47
AaB,5736,5,8,11,11,36,47,-11,35
Sonderjyske,5736,6,8,6,10,28,29,-1,30
AC Horsens,5736,7,5,13,12,31,53,-22,28
Randers FC,5736,8,5,7,12,25,41,-16,22
AGF Aarhus,5736,9,5,6,11,18,37,-19,21
Lyngby,5736,10,3,10,11,28,46,-18,19
Silkeborg IF,5736,11,5,3,14,26,46,-20,18
Brondby,5737,1,20,7,3,66,30,36,67
FC Midtjylla,5737,2,19,5,6,62,38,24,62
Copenhagen,5737,3,16,5,9,61,42,19,53
FC Nords,5737,4,13,8,9,72,52,20,47
AaB,5737,5,8,11,11,39,44,-5,35
Sonderjyske,5737,6,8,6,10,28,29,-1,30
AC Horsens,5737,7,5,14,11,33,53,-20,29
Randers FC,5737,8,5,7,12,24,40,-16,22
Silkeborg IF,5737,9,6,3,13,27,44,-17,21
Lyngby,5737,10,3,10,11,27,45,-18,19
AGF Aarhus,5737,11,4,6,12,16,38,-22,18
Brondby,5738,1,21,7,2,70,30,40,70
FC Midtjylla,5738,2,20,6,4,69,38,31,66
Copenhagen,5738,3,13,6,11,57,42,15,45
FC Nords,5738,4,12,8,10,66,50,16,44
AC Horsens,5738,5,7,14,9,33,48,-15,35
AaB,5738,6,7,11,12,37,50,-13,32
Sonderjyske,5738,7,8,6,10,28,29,-1,30
Lyngby,5738,8,4,9,11,27,44,-17,21
Randers FC,5738,9,5,6,13,23,40,-17,21
AGF Aarhus,5738,10,5,6,11,17,36,-19,21
Silkeborg IF,5738,11,5,3,14,25,45,-20,18
Brondby,5739,1,19,7,4,69,34,35,64
FC Midtjylla,5739,2,19,6,5,65,39,26,63
FC Nords,5739,3,14,7,9,76,57,19,49
Copenhagen,5739,4,13,5,12,58,51,7,44
AaB,5739,5,9,13,8,43,39,4,40
AC Horsens,5739,6,7,12,11,37,54,-17,33
Sonderjyske,5739,7,8,6,10,28,29,-1,30
Randers FC,5739,8,6,6,12,24,39,-15,24
Silkeborg IF,5739,9,6,3,13,27,45,-18,21
Lyngby,5739,10,3,9,12,26,45,-19,18
AGF Aarhus,5739,11,4,6,12,17,38,-21,18
Brondby,5740,1,21,7,2,74,33,41,70
FC Midtjylla,5740,2,20,5,5,72,41,31,65
Copenhagen,5740,3,14,5,11,60,47,13,47
FC Nords,5740,4,13,7,10,69,54,15,46
AaB,5740,5,8,11,11,41,50,-9,35
AC Horsens,5740,6,6,13,11,39,56,-17,31
Sonderjyske,5740,7,8,6,10,28,29,-1,30
Lyngby,5740,8,4,9,11,29,44,-15,21
Randers FC,5740,9,5,6,13,23,42,-19,21
Silkeborg IF,5740,10,5,4,13,25,44,-19,19
AGF Aarhus,5740,11,4,7,11,16,36,-20,19
Brondby,5741,1,21,6,3,69,32,37,69
FC Midtjylla,5741,2,19,6,5,61,35,26,63
Copenhagen,5741,3,14,7,9,59,41,18,49
FC Nords,5741,4,13,7,10,72,50,22,46
AaB,5741,5,7,14,9,35,41,-6,35
Sonderjyske,5741,6,8,6,10,28,29,-1,30
AC Horsens,5741,7,5,14,11,30,53,-23,29
Randers FC,5741,8,5,7,12,25,41,-16,22
Lyngby,5741,9,3,10,11,28,46,-18,19
Silkeborg IF,5741,10,5,4,13,27,46,-19,19
AGF Aarhus,5741,11,4,7,11,18,38,-20,19
Brondby,5742,1,21,5,4,74,29,45,68
FC Midtjylla,5742,2,21,4,5,69,37,32,67
FC Nords,5742,3,14,6,10,69,51,18,48
Copenhagen,5742,4,14,4,12,56,46,10,46
AC Horsens,5742,5,8,12,10,36,49,-13,36
AaB,5742,6,7,11,12,34,52,-18,32
Sonderjyske,5742,7,8,6,10,28,29,-1,30
Randers FC,5742,8,6,6,12,24,39,-15,24
Silkeborg IF,5742,9,6,3,13,28,44,-16,21
Lyngby,5742,10,3,9,12,26,45,-19,18
AGF Aarhus,5742,11,4,6,12,16,39,-23,18
Brondby,5743,1,22,6,2,72,32,40,72
FC Midtjylla,5743,2,20,5,5,66,39,27,65
FC Nords,5743,3,14,7,9,69,46,23,49
Copenhagen,5743,4,12,7,11,51,41,10,43
AaB,5743,5,8,11,11,37,43,-6,35
Sonderjyske,5743,6,8,6,10,28,29,-1,30
AC Horsens,5743,7,5,14,11,32,52,-20,29
Randers FC,5743,8,6,6,12,24,39,-15,24
Silkeborg IF,5743,9,6,3,13,27,45,-18,21
Lyngby,5743,10,3,9,12,26,45,-19,18
AGF Aarhus,5743,11,4,6,12,17,38,-21,18
Brondby,5744,1,21,6,3,73,30,43,69
FC Midtjylla,5744,2,20,5,5,65,40,25,65
FC Nords,5744,3,15,7,8,76,49,27,52
Copenhagen,5744,4,15,4,11,56,41,15,49
AC Horsens,5744,5,6,13,11,33,56,-23,31
Sonderjyske,5744,6,8,6,10,28,29,-1,30
AaB,5744,7,6,11,13,34,47,-13,29
Randers FC,5744,8,5,7,12,25,41,-16,22
Silkeborg IF,5744,9,6,3,13,26,44,-18,21
Lyngby,5744,10,3,10,11,28,46,-18,19
AGF Aarhus,5744,11,4,6,12,16,37,-21,18
Brondby,5745,1,21,6,3,66,31,35,69
FC Midtjylla,5745,2,20,5,5,68,37,31,65
FC Nords,5745,3,14,7,9,71,48,23,49
Copenhagen,5745,4,14,5,11,58,45,13,47
AaB,5745,5,7,11,12,34,41,-7,32
AC Horsens,5745,6,6,14,10,32,53,-21,32
Sonderjyske,5745,7,8,6,10,28,29,-1,30
Lyngby,5745,8,4,9,11,30,46,-16,21
Randers FC,5745,9,5,6,13,25,43,-18,21
Silkeborg IF,5745,10,5,4,13,25,44,-19,19
AGF Aarhus,5745,11,4,7,11,16,36,-20,19
FC Midtjylla,5746,1,20,5,5,64,34,30,65
Brondby,5746,2,19,7,4,68,35,33,64
FC Nords,5746,3,16,6,8,76,48,28,54
Copenhagen,5746,4,15,4,11,58,46,12,49
AaB,5746,5,7,11,12,35,45,-10,32
AC Horsens,5746,6,6,13,11,37,56,-19,31
Sonderjyske,5746,7,8,6,10,28,29,-1,30
Randers FC,5746,8,5,7,12,24,40,-16,22
Silkeborg IF,5746,9,6,3,13,27,44,-17,21
Lyngby,5746,10,3,10,11,27,45,-18,19
AGF Aarhus,5746,11,4,6,12,16,38,-22,18
Brondby,5747,1,20,7,3,69,31,38,67
FC Midtjylla,5747,2,20,5,5,66,36,30,65
FC Nords,5747,3,13,8,9,71,53,18,47
Copenhagen,5747,4,13,6,11,58,49,9,45
AaB,5747,5,10,11,9,43,42,1,41
Sonderjyske,5747,6,8,6,10,28,29,-1,30
AC Horsens,5747,7,5,13,12,33,55,-22,28
Randers FC,5747,8,5,7,12,23,39,-16,22
AGF Aarhus,5747,9,5,6,11,17,36,-19,21
Lyngby,5747,10,3,10,11,26,44,-18,19
Silkeborg IF,5747,11,5,3,14,25,45,-20,18
Brondby,5748,1,22,5,3,73,34,39,71
FC Midtjylla,5748,2,19,5,6,62,38,24,62
FC Nords,5748,3,14,7,9,75,51,24,49
Copenhagen,5748,4,13,5,12,54,46,8,44
AC Horsens,5748,5,9,12,9,38,47,-9,39
Sonderjyske,5748,6,8,6,10,28,29,-1,30
AaB,5748,7,6,12,12,34,46,-12,30
Lyngby,5748,8,4,9,11,27,44,-17,21
Silkeborg IF,5748,8,6,3,13,27,44,-17,21
Randers FC,5748,10,5,6,13,23,40,-17,21
AGF Aarhus,5748,11,4,6,12,16,38,-22,18
Brondby,5749,1,19,7,4,67,33,34,64
FC Midtjylla,5749,2,19,7,4,65,38,27,64
FC Nords,5749,3,15,6,9,74,50,24,51
Copenhagen,5749,4,14,5,11,59,45,14,47
AaB,5749,5,8,13,9,40,43,-3,37
Sonderjyske,5749,6,8,6,10,28,29,-1,30
AC Horsens,5749,7,5,14,11,35,57,-22,29
Randers FC,5749,8,5,7,12,25,41,-16,22
Silkeborg IF,5749,9,6,3,13,26,44,-18,21
Lyngby,5749,10,3,10,11,28,46,-18,19
AGF Aarhus,5749,11,4,6,12,16,37,-21,18
Brondby,5750,1,22,6,2,73,32,41,72
FC Midtjylla,5750,2,18,5,7,65,47,18,59
FC Nords,5750,3,15,7,8,79,52,27,52
Copenhagen,5750,4,14,5,11,64,47,17,47
AaB,5750,5,7,12,11,38,48,-10,33
AC Horsens,5750,6,6,13,11,36,55,-19,31
Sonderjyske,5750,7,8,6,10,28,29,-1,30
Lyngby,5750,8,4,9,11,28,44,-16,21
Silkeborg IF,5750,9,6,3,13,28,45,-17,21
Randers FC,5750,10,5,6,13,23,41,-18,21
AGF Aarhus,5750,11,4,6,12,17,39,-22,18
Brondby,5751,1,21,5,4,72,35,37,68
FC Midtjylla,5751,2,20,4,6,74,45,29,64
Copenhagen,5751,3,15,5,10,62,45,17,50
FC Nords,5751,4,14,7,9,77,55,22,49
AaB,5751,5,8,12,10,39,45,-6,36
Sonderjyske,5751,6,8,6,10,28,29,-1,30
AC Horsens,5751,7,5,13,12,33,58,-25,28
Lyngby,5751,8,4,9,11,28,44,-16,21
Randers FC,5751,9,5,6,13,23,41,-18,21
AGF Aarhus,5751,10,5,6,11,18,37,-19,21
Silkeborg IF,5751,11,5,3,14,26,46,-20,18
Brondby,5752,1,23,5,2,74,30,44,74
FC Midtjylla,5752,2,19,5,6,66,43,23,62
Copenhagen,5752,3,15,4,11,62,46,16,49
FC Nords,5752,4,14,6,10,73,56,17,48
AaB,5752,5,7,11,12,39,46,-7,32
AC Horsens,5752,6,6,13,11,38,57,-19,31
Sonderjyske,5752,7,8,6,10,28,29,-1,30
Randers FC,5752,8,5,7,12,23,39,-16,22
AGF Aarhus,5752,9,5,6,11,20,38,-18,21
Lyngby,5752,10,3,10,11,26,44,-18,19
Silkeborg IF,5752,11,5,3,14,27,48,-21,18
Brondby,5753,1,20,6,4,70,35,35,66
FC Midtjylla,5753,2,19,7,4,65,37,28,64
FC Nords,5753,3,13,10,7,72,50,22,49
Copenhagen,5753,4,14,4,12,55,44,11,46
AaB,5753,5,7,13,10,38,44,-6,34
AC Horsens,5753,6,6,14,10,33,49,-16,32
Sonderjyske,5753,7,8,6,10,28,29,-1,30
Randers FC,5753,8,5,7,12,24,40,-16,22
Silkeborg IF,5753,9,6,3,13,27,44,-17,21
Lyngby,5753,10,3,10,11,27,45,-18,19
AGF Aarhus,5753,11,4,6,12,16,38,-22,18
Brondby,5754,1,22,5,3,73,29,44,71
FC Midtjylla,5754,2,18,6,6,65,44,21,60
FC Nords,5754,3,14,7,9,72,52,20,49
Copenhagen,5754,4,14,6,10,57,42,15,48
AaB,5754,5,6,14,10,34,42,-8,32
AC Horsens,5754,6,6,14,10,34,52,-18,32
Sonderjyske,5754,7,8,6,10,28,29,-1,30
Randers FC,5754,8,6,6,12,24,39,-15,24
Silkeborg IF,5754,9,5,4,13,26,45,-19,19
AGF Aarhus,5754,10,4,7,11,17,37,-20,19
Lyngby,5754,11,3,9,12,26,45,-19,18
Brondby,5755,1,22,5,3,76,30,46,71
FC Midtjylla,5755,2,19,5,6,68,44,24,62
FC Nords,5755,3,14,6,10,78,55,23,48
Copenhagen,5755,4,14,5,11,59,46,13,47
AC Horsens,5755,5,7,13,10,37,58,-21,34
AaB,5755,6,7,12,11,38,49,-11,33
Sonderjyske,5755,7,8,6,10,28,29,-1,30
Lyngby,5755,8,4,9,11,30,46,-16,21
Randers FC,5755,9,5,6,13,25,43,-18,21
AGF Aarhus,5755,10,5,6,11,17,36,-19,21
Silkeborg IF,5755,11,5,3,14,25,45,-20,18
FC Midtjylla,5756,1,21,5,4,66,36,30,68
Brondby,5756,2,20,7,3,71,33,38,67
FC Nords,5756,3,14,7,9,70,50,20,49
Copenhagen,5756,4,12,6,12,57,47,10,42
AaB,5756,5,7,13,10,37,44,-7,34
AC Horsens,5756,6,6,14,10,34,51,-17,32
Sonderjyske,5756,7,8,6,10,28,29,-1,30
Lyngby,5756,8,4,9,11,29,44,-15,21
AGF Aarhus,5756,9,5,6,11,19,36,-17,21
Randers FC,5756,10,5,6,13,23,42,-19,21
Silkeborg IF,5756,11,5,3,14,25,47,-22,18
FC Midtjylla,5757,1,20,4,6,64,37,27,64
Brondby,5757,2,19,6,5,71,36,35,63
FC Nords,5757,3,16,7,7,76,48,28,55
Copenhagen,5757,4,15,4,11,56,43,13,49
AC Horsens,5757,5,7,12,11,35,52,-17,33
AaB,5757,6,7,11,12,34,46,-12,32
Sonderjyske,5757,7,8,6,10,28,29,-1,30
Randers FC,5757,8,6,6,12,24,39,-15,24
Silkeborg IF,5757,9,6,3,13,27,45,-18,21
Lyngby,5757,10,3,9,12,26,45,-19,18
AGF Aarhus,5757,11,4,6,12,17,38,-21,18
Brondby,5758,1,21,6,3,68,30,38,69
FC Midtjylla,5758,2,20,5,5,72,41,31,65
Copenhagen,5758,3,15,4,11,60,45,15,49
FC Nords,5758,4,13,7,10,67,49,18,46
AaB,5758,5,8,12,10,36,43,-7,36
Sonderjyske,5758,6,8,6,10,28,29,-1,30
AC Horsens,5758,7,6,12,12,33,54,-21,30
Randers FC,5758,8,5,7,12,24,40,-16,22
Silkeborg IF,5758,9,6,3,13,28,45,-17,21
Lyngby,5758,10,3,10,11,27,45,-18,19
AGF Aarhus,5758,11,4,6,12,17,39,-22,18
Brondby,5759,1,21,5,4,68,33,35,68
FC Midtjylla,5759,2,20,4,6,67,42,25,64
FC Nords,5759,3,16,6,8,75,50,25,54
Copenhagen,5759,4,15,4,11,63,46,17,49
AC Horsens,5759,5,6,13,11,35,52,-17,31
Sonderjyske,5759,6,8,6,10,28,29,-1,30
AaB,5759,7,6,12,12,36,47,-11,30
Randers FC,5759,8,5,7,12,25,41,-16,22
Silkeborg IF,5759,9,6,3,13,27,44,-17,21
Lyngby,5759,10,3,10,11,28,46,-18,19
AGF Aarhus,5759,11,4,6,12,16,38,-22,18
FC Midtjylla,5760,1,22,4,4,74,38,36,70
Brondby,5760,2,21,6,3,74,34,40,69
FC Nords,5760,3,15,6,9,73,51,22,51
Copenhagen,5760,4,14,5,11,55,45,10,47
Sonderjyske,5760,5,8,6,10,28,29,-1,30
AaB,5760,6,6,12,12,36,46,-10,30
AC Horsens,5760,7,5,13,12,35,59,-24,28
Silkeborg IF,5760,8,6,3,13,29,45,-16,21
Lyngby,5760,9,4,9,11,27,44,-17,21
Randers FC,5760,10,5,6,13,23,40,-17,21
AGF Aarhus,5760,11,4,6,12,17,40,-23,18
FC Midtjylla,5761,1,21,5,4,68,36,32,68
Brondby,5761,2,20,5,5,69,34,35,65
FC Nords,5761,3,14,7,9,72,53,19,49
Copenhagen,5761,4,14,5,11,59,44,15,47
AaB,5761,5,8,12,10,41,43,-2,36
Sonderjyske,5761,6,8,6,10,28,29,-1,30
AC Horsens,5761,7,6,12,12,31,56,-25,30
Randers FC,5761,8,6,6,12,24,39,-15,24
Silkeborg IF,5761,9,6,3,13,30,45,-15,21
Lyngby,5761,10,3,9,12,26,45,-19,18
AGF Aarhus,5761,11,4,6,12,17,41,-24,18
FC Midtjylla,5762,1,20,6,4,71,41,30,66
Brondby,5762,2,19,8,3,67,32,35,65
Copenhagen,5762,3,15,6,9,60,43,17,51
FC Nords,5762,4,13,7,10,71,53,18,46
AaB,5762,5,7,13,10,35,39,-4,34
Sonderjyske,5762,6,8,6,10,28,29,-1,30
AC Horsens,5762,7,5,14,11,34,56,-22,29
Randers FC,5762,8,5,7,12,23,39,-16,22
Silkeborg IF,5762,9,6,3,13,29,44,-15,21
Lyngby,5762,10,3,10,11,26,44,-18,19
AGF Aarhus,5762,11,4,6,12,16,40,-24,18
Brondby,5763,1,21,6,3,71,30,41,69
FC Midtjylla,5763,2,19,6,5,66,41,25,63
Copenhagen,5763,3,14,5,11,59,46,13,47
FC Nords,5763,4,12,7,11,72,57,15,43
AaB,5763,5,8,13,9,38,41,-3,37
AC Horsens,5763,6,7,13,10,36,53,-17,34
Sonderjyske,5763,7,8,6,10,28,29,-1,30
Lyngby,5763,8,4,9,11,28,45,-17,21
Randers FC,5763,9,5,6,13,24,41,-17,21
AGF Aarhus,5763,10,5,6,11,18,37,-19,21
Silkeborg IF,5763,11,5,3,14,26,46,-20,18
Brondby,5764,1,19,7,4,68,32,36,64
FC Midtjylla,5764,2,19,6,5,61,35,26,63
FC Nords,5764,3,14,6,10,72,55,17,48
Copenhagen,5764,4,13,4,13,53,45,8,43
AaB,5764,5,10,12,8,40,37,3,42
AC Horsens,5764,6,7,13,10,33,49,-16,34
Sonderjyske,5764,7,8,6,10,28,29,-1,30
Randers FC,5764,8,5,7,12,25,41,-16,22
Silkeborg IF,5764,9,6,3,13,27,45,-18,21
Lyngby,5764,10,3,10,11,28,46,-18,19
AGF Aarhus,5764,11,4,6,12,17,38,-21,18
Brondby,5765,1,22,6,2,74,28,46,72
FC Midtjylla,5765,2,20,5,5,67,38,29,65
FC Nords,5765,3,14,6,10,75,58,17,48
Copenhagen,5765,4,14,5,11,60,48,12,47
AaB,5765,5,7,12,11,36,47,-11,33
Sonderjyske,5765,6,8,6,10,28,29,-1,30
AC Horsens,5765,7,5,14,11,38,57,-19,29
Randers FC,5765,8,5,7,12,24,40,-16,22
Lyngby,5765,9,3,10,11,27,45,-18,19
Silkeborg IF,5765,10,5,4,13,26,45,-19,19
AGF Aarhus,5765,11,4,7,11,17,37,-20,19
Brondby,5766,1,22,6,2,79,33,46,72
FC Midtjylla,5766,2,19,7,4,67,39,28,64
FC Nords,5766,3,12,8,10,73,60,13,44
Copenhagen,5766,4,13,5,12,54,46,8,44
AaB,5766,5,7,13,10,34,39,-5,34
AC Horsens,5766,6,6,15,9,35,51,-16,33
Sonderjyske,5766,7,8,6,10,28,29,-1,30
Randers FC,5766,8,5,7,12,24,40,-16,22
Silkeborg IF,5766,9,6,3,13,30,46,-16,21
Lyngby,5766,10,3,10,11,27,45,-18,19
AGF Aarhus,5766,11,4,6,12,18,41,-23,18
Brondby,5767,1,21,6,3,70,33,37,69
FC Midtjylla,5767,2,20,4,6,64,40,24,64
FC Nords,5767,3,15,6,9,73,50,23,51
Copenhagen,5767,4,13,4,13,57,51,6,43
AaB,5767,5,8,13,9,42,41,1,37
AC Horsens,5767,6,6,13,11,38,55,-17,31
Sonderjyske,5767,7,8,6,10,28,29,-1,30
Lyngby,5767,8,4,9,11,29,44,-15,21
Randers FC,5767,9,5,6,13,23,42,-19,21
AGF Aarhus,5767,10,5,6,11,17,36,-19,21
Silkeborg IF,5767,11,5,3,14,25,45,-20,18
Brondby,5768,1,21,5,4,72,37,35,68
FC Midtjylla,5768,2,20,4,6,65,40,25,64
FC Nords,5768,3,14,6,10,74,53,21,48
AaB,5768,4,10,12,8,40,38,2,42
Copenhagen,5768,5,12,4,14,59,54,5,40
AC Horsens,5768,6,7,13,10,38,52,-14,34
Sonderjyske,5768,7,8,6,10,28,29,-1,30
Randers FC,5768,8,5,7,12,23,39,-16,22
Silkeborg IF,5768,9,6,3,13,26,44,-18,21
Lyngby,5768,10,3,10,11,26,44,-18,19
AGF Aarhus,5768,11,4,6,12,16,37,-21,18
FC Midtjylla,5769,1,22,4,4,66,34,32,70
Brondby,5769,2,19,6,5,65,34,31,63
Copenhagen,5769,3,14,5,11,57,45,12,47
FC Nords,5769,4,13,7,10,70,52,18,46
AaB,5769,5,8,12,10,35,37,-2,36
AC Horsens,5769,6,7,12,11,35,52,-17,33
Sonderjyske,5769,7,8,6,10,28,29,-1,30
Randers FC,5769,8,5,7,12,26,42,-16,22
Silkeborg IF,5769,9,6,3,13,28,46,-18,21
Lyngby,5769,10,3,10,11,29,47,-18,19
AGF Aarhus,5769,11,4,6,12,18,39,-21,18
Brondby,5770,1,21,5,4,71,32,39,68
FC Midtjylla,5770,2,20,5,5,64,37,27,65
FC Nords,5770,3,14,8,8,74,53,21,50
Copenhagen,5770,4,14,6,10,60,44,16,48
AaB,5770,5,6,13,11,39,48,-9,31
Sonderjyske,5770,6,8,6,10,28,29,-1,30
AC Horsens,5770,7,5,15,10,34,54,-20,30
Lyngby,5770,8,4,9,11,28,44,-16,21
Randers FC,5770,9,5,6,13,23,41,-18,21
Silkeborg IF,5770,10,5,4,13,25,44,-19,19
AGF Aarhus,5770,11,4,7,11,16,36,-20,19
Brondby,5771,1,22,6,2,67,26,41,72
FC Midtjylla,5771,2,20,4,6,63,36,27,64
FC Nords,5771,3,14,7,9,74,51,23,49
Copenhagen,5771,4,14,4,12,52,42,10,46
AaB,5771,5,7,12,11,33,43,-10,33
AC Horsens,5771,6,6,13,11,35,52,-17,31
Sonderjyske,5771,7,8,6,10,28,29,-1,30
Lyngby,5771,8,4,9,11,28,44,-16,21
Randers FC,5771,9,5,6,13,23,41,-18,21
Silkeborg IF,5771,10,5,4,13,27,46,-19,19
AGF Aarhus,5771,11,4,7,11,18,38,-20,19
Brondby,5772,1,21,6,3,68,29,39,69
FC Midtjylla,5772,2,21,5,4,69,34,35,68
FC Nords,5772,3,14,7,9,72,51,21,49
Copenhagen,5772,4,13,7,10,58,42,16,46
AaB,5772,5,6,14,10,34,41,-7,32
Sonderjyske,5772,6,8,6,10,28,29,-1,30
AC Horsens,5772,7,5,13,12,32,62,-30,28
Randers FC,5772,8,6,6,12,25,39,-14,24
Silkeborg IF,5772,9,6,3,13,27,45,-18,21
Lyngby,5772,10,3,9,12,26,46,-20,18
AGF Aarhus,5772,11,4,6,12,17,38,-21,18
Brondby,5773,1,19,8,3,69,34,35,65
FC Midtjylla,5773,2,20,4,6,67,40,27,64
FC Nords,5773,3,14,8,8,74,50,24,50
Copenhagen,5773,4,14,7,9,56,40,16,49
AaB,5773,5,7,13,10,34,41,-7,34
Sonderjyske,5773,6,8,6,10,28,29,-1,30
AC Horsens,5773,7,5,14,11,36,57,-21,29
Lyngby,5773,8,4,9,11,28,44,-16,21
Silkeborg IF,5773,9,6,3,13,27,45,-18,21
Randers FC,5773,10,5,6,13,23,41,-18,21
AGF Aarhus,5773,11,4,6,12,17,38,-21,18
FC Midtjylla,5774,1,21,4,5,69,43,26,67
Brondby,5774,2,20,6,4,67,32,35,66
FC Nords,5774,3,14,7,9,73,52,21,49
Copenhagen,5774,4,13,7,10,62,47,15,46
AaB,5774,5,7,13,10,39,45,-6,34
AC Horsens,5774,6,6,13,11,39,56,-17,31
Sonderjyske,5774,7,8,6,10,28,29,-1,30
Lyngby,5774,8,4,9,11,27,44,-17,21
Randers FC,5774,9,5,6,13,23,40,-17,21
Silkeborg IF,5774,10,6,3,13,26,44,-18,21
AGF Aarhus,5774,11,4,6,12,16,37,-21,18
Brondby,5775,1,21,6,3,71,35,36,69
FC Midtjylla,5775,2,17,6,7,63,43,20,57
FC Nords,5775,3,16,6,8,78,53,25,54
Copenhagen,5775,4,15,5,10,65,45,20,50
AC Horsens,5775,5,7,13,10,35,52,-17,34
Sonderjyske,5775,6,8,6,10,28,29,-1,30
AaB,5775,7,6,12,12,35,45,-10,30
Randers FC,5775,8,6,6,12,24,39,-15,24
Silkeborg IF,5775,9,5,4,13,25,44,-19,19
AGF Aarhus,5775,10,4,7,11,16,36,-20,19
Lyngby,5775,11,3,9,12,26,45,-19,18
Brondby,5776,1,20,7,3,73,34,39,67
FC Midtjylla,5776,2,18,6,6,71,45,26,60
FC Nords,5776,3,15,8,7,74,48,26,53
Copenhagen,5776,4,13,7,10,60,45,15,46
AaB,5776,5,7,12,11,37,47,-10,33
AC Horsens,5776,6,7,12,11,35,57,-22,33
Sonderjyske,5776,7,8,6,10,28,29,-1,30
Randers FC,5776,8,6,6,12,25,40,-15,24
Silkeborg IF,5776,9,6,3,13,27,45,-18,21
Lyngby,5776,10,3,9,12,27,46,-19,18
AGF Aarhus,5776,11,4,6,12,17,38,-21,18
Brondby,5777,1,20,7,3,71,36,35,67
FC Midtjylla,5777,2,19,5,6,67,39,28,62
FC Nords,5777,3,14,9,7,74,49,25,51
Copenhagen,5777,4,13,7,10,56,44,12,46
AaB,5777,5,8,12,10,38,42,-4,36
Sonderjyske,5777,6,8,6,10,28,29,-1,30
AC Horsens,5777,7,6,12,12,34,56,-22,30
Randers FC,5777,8,6,6,12,25,40,-15,24
Silkeborg IF,5777,9,6,3,13,28,44,-16,21
Lyngby,5777,10,3,9,12,27,46,-19,18
AGF Aarhus,5777,11,4,6,12,16,39,-23,18
Brondby,5778,1,21,6,3,71,30,41,69
FC Midtjylla,5778,2,21,4,5,63,34,29,67
FC Nords,5778,3,14,7,9,73,53,20,49
Copenhagen,5778,4,14,5,11,58,48,10,47
AaB,5778,5,7,12,11,38,44,-6,33
Sonderjyske,5778,6,8,6,10,28,29,-1,30
AC Horsens,5778,7,6,12,12,33,53,-20,30
Lyngby,5778,8,4,9,11,27,44,-17,21
Randers FC,5778,9,5,6,13,23,40,-17,21
AGF Aarhus,5778,10,5,6,11,21,38,-17,21
Silkeborg IF,5778,11,5,3,14,27,49,-22,18
Brondby,5779,1,22,5,3,70,29,41,71
FC Midtjylla,5779,2,21,4,5,68,37,31,67
FC Nords,5779,3,14,6,10,68,48,20,48
Copenhagen,5779,4,14,4,12,55,43,12,46
AaB,5779,5,8,11,11,34,43,-9,35
Sonderjyske,5779,6,8,6,10,28,29,-1,30
AC Horsens,5779,7,6,12,12,31,52,-21,30
Lyngby,5779,8,4,9,11,28,44,-16,21
Randers FC,5779,9,5,6,13,23,41,-18,21
AGF Aarhus,5779,10,5,6,11,18,36,-18,21
Silkeborg IF,5779,11,5,3,14,25,46,-21,18
Brondby,5780,1,22,5,3,71,31,40,71
FC Midtjylla,5780,2,19,5,6,67,41,26,62
FC Nords,5780,3,13,9,8,67,47,20,48
Copenhagen,5780,4,13,5,12,57,46,11,44
AaB,5780,5,8,12,10,36,40,-4,36
AC Horsens,5780,6,6,14,10,31,50,-19,32
Sonderjyske,5780,7,8,6,10,28,29,-1,30
Randers FC,5780,8,6,6,12,26,40,-14,24
Silkeborg IF,5780,9,5,4,13,28,47,-19,19
AGF Aarhus,5780,10,4,7,11,19,39,-20,19
Lyngby,5780,11,3,9,12,27,47,-20,18
Brondby,5781,1,19,8,3,67,31,36,65
FC Midtjylla,5781,2,20,5,5,63,36,27,65
FC Nords,5781,3,13,9,8,75,53,22,48
Copenhagen,5781,4,14,6,10,58,46,12,48
AaB,5781,5,6,15,9,36,41,-5,33
Sonderjyske,5781,6,8,6,10,28,29,-1,30
AC Horsens,5781,7,5,15,10,31,49,-18,30
Lyngby,5781,8,4,9,11,28,44,-16,21
Randers FC,5781,9,5,6,13,23,41,-18,21
Silkeborg IF,5781,10,5,4,13,25,44,-19,19
AGF Aarhus,5781,11,4,7,11,16,36,-20,19
Brondby,5782,1,21,6,3,72,36,36,69
FC Midtjylla,5782,2,21,4,5,67,36,31,67
FC Nords,5782,3,13,9,8,76,54,22,48
Copenhagen,5782,4,12,6,12,55,46,9,42
AaB,5782,5,7,14,9,39,43,-4,35
AC Horsens,5782,6,6,13,11,35,55,-20,31
Sonderjyske,5782,7,8,6,10,28,29,-1,30
Silkeborg IF,5782,8,6,3,13,30,46,-16,21
Lyngby,5782,9,4,9,11,28,44,-16,21
Randers FC,5782,10,5,6,13,23,41,-18,21
AGF Aarhus,5782,11,4,6,12,18,41,-23,18
Brondby,5783,1,20,6,4,72,36,36,66
FC Midtjylla,5783,2,20,4,6,68,42,26,64
FC Nords,5783,3,14,6,10,73,54,19,48
Copenhagen,5783,4,14,6,10,61,46,15,48
AC Horsens,5783,5,7,14,9,40,53,-13,35
AaB,5783,6,7,12,11,36,45,-9,33
Sonderjyske,5783,7,8,6,10,28,29,-1,30
Randers FC,5783,8,6,6,12,27,42,-15,24
Silkeborg IF,5783,9,5,4,13,25,44,-19,19
AGF Aarhus,5783,10,4,7,11,16,36,-20,19
Lyngby,5783,11,3,9,12,29,48,-19,18
Brondby,5784,1,21,6,3,72,30,42,69
FC Midtjylla,5784,2,18,7,5,63,38,25,61
FC Nords,5784,3,14,8,8,74,54,20,50
Copenhagen,5784,4,15,4,11,58,44,14,49
AaB,5784,5,6,14,10,34,40,-6,32
AC Horsens,5784,6,6,13,11,35,56,-21,31
Sonderjyske,5784,7,8,6,10,28,29,-1,30
Randers FC,5784,8,5,7,12,24,40,-16,22
Silkeborg IF,5784,9,6,3,13,28,45,-17,21
Lyngby,5784,10,3,10,11,27,45,-18,19
AGF Aarhus,5784,11,4,6,12,17,39,-22,18
Brondby,5785,1,23,5,2,77,29,48,74
FC Midtjylla,5785,2,19,5,6,61,40,21,62
FC Nords,5785,3,14,7,9,74,52,22,49
Copenhagen,5785,4,14,4,12,61,50,11,46
AaB,5785,5,8,12,10,38,42,-4,36
Sonderjyske,5785,6,8,6,10,28,29,-1,30
AC Horsens,5785,7,5,13,12,33,57,-24,28
Randers FC,5785,8,6,6,12,25,40,-15,24
Silkeborg IF,5785,9,6,3,13,27,44,-17,21
Lyngby,5785,10,3,9,12,27,46,-19,18
AGF Aarhus,5785,11,4,6,12,16,38,-22,18
Brondby,5786,1,21,7,2,74,33,41,70
FC Midtjylla,5786,2,19,4,7,65,42,23,61
FC Nords,5786,3,13,8,9,71,51,20,47
Copenhagen,5786,4,13,8,9,59,45,14,47
AaB,5786,5,6,15,9,35,41,-6,33
AC Horsens,5786,6,6,14,10,36,54,-18,32
Sonderjyske,5786,7,8,6,10,28,29,-1,30
Randers FC,5786,8,5,7,12,25,41,-16,22
Silkeborg IF,5786,9,6,3,13,27,45,-18,21
Lyngby,5786,10,3,10,11,28,46,-18,19
AGF Aarhus,5786,11,4,6,12,17,38,-21,18
Brondby,5787,1,22,6,2,72,28,44,72
FC Midtjylla,5787,2,18,6,6,60,38,22,60
FC Nords,5787,3,15,6,9,73,50,23,51
Copenhagen,5787,4,14,5,11,56,44,12,47
AC Horsens,5787,5,7,12,11,35,53,-18,33
AaB,5787,6,7,11,12,38,47,-9,32
Sonderjyske,5787,7,8,6,10,28,29,-1,30
Randers FC,5787,8,5,7,12,25,41,-16,22
AGF Aarhus,5787,9,5,6,11,19,38,-19,21
Lyngby,5787,10,3,10,11,28,46,-18,19
Silkeborg IF,5787,11,5,3,14,27,47,-20,18
Brondby,5788,1,21,6,3,76,39,37,69
FC Midtjylla,5788,2,20,6,4,72,40,32,66
FC Nords,5788,3,14,7,9,77,54,23,49
Copenhagen,5788,4,13,4,13,57,51,6,43
AaB,5788,5,8,12,10,40,45,-5,36
AC Horsens,5788,6,6,13,11,33,52,-19,31
Sonderjyske,5788,7,8,6,10,28,29,-1,30
Silkeborg IF,5788,8,6,3,13,29,45,-16,21
Lyngby,5788,9,4,9,11,28,44,-16,21
Randers FC,5788,10,5,6,13,23,41,-18,21
AGF Aarhus,5788,11,4,6,12,17,40,-23,18
Brondby,5789,1,21,5,4,72,30,42,68
FC Midtjylla,5789,2,20,5,5,69,40,29,65
FC Nords,5789,3,14,7,9,72,53,19,49
Copenhagen,5789,4,14,4,12,58,48,10,46
AC Horsens,5789,5,7,13,10,36,52,-16,34
AaB,5789,6,7,12,11,36,46,-10,33
Sonderjyske,5789,7,8,6,10,28,29,-1,30
Lyngby,5789,8,4,9,11,29,45,-16,21
Silkeborg IF,5789,9,6,3,13,27,44,-17,21
Randers FC,5789,10,5,6,13,24,42,-18,21
AGF Aarhus,5789,11,4,6,12,16,38,-22,18
Brondby,5790,1,21,5,4,72,34,38,68
FC Midtjylla,5790,2,20,5,5,71,40,31,65
FC Nords,5790,3,13,8,9,71,53,18,47
Copenhagen,5790,4,13,7,10,59,49,10,46
AaB,5790,5,8,13,9,38,39,-1,37
Sonderjyske,5790,6,8,6,10,28,29,-1,30
AC Horsens,5790,7,5,14,11,37,59,-22,29
Lyngby,5790,8,4,9,11,28,45,-17,21
Randers FC,5790,9,5,6,13,24,41,-17,21
Silkeborg IF,5790,10,5,4,13,25,44,-19,19
AGF Aarhus,5790,11,4,7,11,16,36,-20,19
Brondby,5791,1,20,5,5,69,34,35,65
FC Midtjylla,5791,2,19,5,6,64,43,21,62
Copenhagen,5791,3,16,4,10,64,41,23,52
FC Nords,5791,4,14,6,10,70,51,19,48
AaB,5791,5,9,11,10,38,45,-7,38
AC Horsens,5791,6,6,13,11,33,50,-17,31
Sonderjyske,5791,7,8,6,10,28,29,-1,30
Randers FC,5791,8,5,7,12,24,40,-16,22
Silkeborg IF,5791,9,6,3,13,28,46,-18,21
Lyngby,5791,10,3,10,11,27,45,-18,19
AGF Aarhus,5791,11,4,6,12,18,39,-21,18
Brondby,5792,1,21,7,2,69,31,38,70
FC Midtjylla,5792,2,21,4,5,70,40,30,67
FC Nords,5792,3,14,7,9,77,52,25,49
Copenhagen,5792,4,13,5,12,56,49,7,44
AaB,5792,5,8,11,11,38,44,-6,35
Sonderjyske,5792,6,8,6,10,28,29,-1,30
AC Horsens,5792,7,6,12,12,35,55,-20,30
Randers FC,5792,8,6,6,12,25,39,-14,24
Silkeborg IF,5792,9,5,4,13,25,44,-19,19
AGF Aarhus,5792,10,4,7,11,16,36,-20,19
Lyngby,5792,11,3,9,12,26,46,-20,18
Brondby,5793,1,20,6,4,67,33,34,66
FC Midtjylla,5793,2,20,6,4,68,41,27,66
FC Nords,5793,3,16,7,7,81,51,30,55
Copenhagen,5793,4,13,6,11,58,44,14,45
AaB,5793,5,7,11,12,35,45,-10,32
Sonderjyske,5793,6,8,6,10,28,29,-1,30
AC Horsens,5793,7,5,14,11,35,56,-21,29
Randers FC,5793,8,5,7,12,23,39,-16,22
Lyngby,5793,9,3,10,11,26,44,-18,19
Silkeborg IF,5793,10,5,4,13,27,46,-19,19
AGF Aarhus,5793,11,4,7,11,18,38,-20,19
Brondby,5794,1,21,7,2,71,30,41,70
FC Midtjylla,5794,2,18,5,7,60,40,20,59
FC Nords,5794,3,14,8,8,77,53,24,50
Copenhagen,5794,4,14,6,10,59,44,15,48
AaB,5794,5,7,13,10,35,43,-8,34
Sonderjyske,5794,6,8,6,10,28,29,-1,30
AC Horsens,5794,7,5,15,10,32,50,-18,30
Silkeborg IF,5794,8,6,3,13,28,45,-17,21
Lyngby,5794,9,4,9,11,27,44,-17,21
Randers FC,5794,10,5,6,13,23,40,-17,21
AGF Aarhus,5794,11,4,6,12,17,39,-22,18
Brondby,5795,1,22,5,3,77,34,43,71
FC Midtjylla,5795,2,19,6,5,69,44,25,63
FC Nords,5795,3,12,9,9,72,55,17,45
Copenhagen,5795,4,13,6,11,60,49,11,45
AaB,5795,5,8,12,10,40,43,-3,36
AC Horsens,5795,6,6,14,10,35,54,-19,32
Sonderjyske,5795,7,8,6,10,28,29,-1,30
Lyngby,5795,8,4,9,11,29,46,-17,21
Randers FC,5795,9,5,6,13,25,42,-17,21
Silkeborg IF,5795,10,6,3,13,26,44,-18,21
AGF Aarhus,5795,11,4,6,12,16,37,-21,18
Brondby,5796,1,21,5,4,68,33,35,68
FC Midtjylla,5796,2,20,5,5,68,38,30,65
FC Nords,5796,3,15,6,9,75,49,26,51
Copenhagen,5796,4,12,5,13,52,47,5,41
AC Horsens,5796,5,8,14,8,35,45,-10,38
AaB,5796,6,6,13,11,34,46,-12,31
Sonderjyske,5796,7,8,6,10,28,29,-1,30
Lyngby,5796,8,4,9,11,28,44,-16,21
Silkeborg IF,5796,9,6,3,13,28,45,-17,21
Randers FC,5796,10,5,6,13,23,41,-18,21
AGF Aarhus,5796,11,4,6,12,17,39,-22,18
Brondby,5797,1,20,7,3,72,33,39,67
FC Midtjylla,5797,2,18,6,6,65,41,24,60
Copenhagen,5797,3,14,6,10,59,45,14,48
FC Nords,5797,4,13,6,11,72,55,17,45
AaB,5797,5,8,13,9,36,42,-6,37
AC Horsens,5797,6,7,14,9,38,52,-14,35
Sonderjyske,5797,7,8,6,10,28,29,-1,30
Lyngby,5797,8,4,9,11,28,45,-17,21
Randers FC,5797,9,5,6,13,24,41,-17,21
Silkeborg IF,5797,10,6,3,13,27,45,-18,21
AGF Aarhus,5797,11,4,6,12,17,38,-21,18
Brondby,5798,1,18,8,4,67,35,32,62
FC Midtjylla,5798,2,18,6,6,65,42,23,60
FC Nords,5798,3,15,7,8,75,50,25,52
Copenhagen,5798,4,15,4,11,59,45,14,49
AC Horsens,5798,5,9,12,9,39,52,-13,39
AaB,5798,6,6,13,11,37,44,-7,31
Sonderjyske,5798,7,8,6,10,28,29,-1,30
Lyngby,5798,8,4,9,11,29,45,-16,21
Silkeborg IF,5798,9,6,3,13,28,45,-17,21
Randers FC,5798,10,5,6,13,24,42,-18,21
AGF Aarhus,5798,11,4,6,12,17,39,-22,18
FC Midtjylla,5799,1,19,7,4,69,40,29,64
Brondby,5799,2,18,6,6,66,37,29,60
FC Nords,5799,3,14,8,8,73,51,22,50
Copenhagen,5799,4,14,6,10,57,44,13,48
AaB,5799,5,9,11,10,38,43,-5,38
AC Horsens,5799,6,6,14,10,34,48,-14,32
Sonderjyske,5799,7,8,6,10,28,29,-1,30
Lyngby,5799,8,4,9,11,28,44,-16,21
Silkeborg IF,5799,9,6,3,13,27,44,-17,21
Randers FC,5799,10,5,6,13,23,41,-18,21
AGF Aarhus,5799,11,4,6,12,16,38,-22,18
Brondby,5800,1,22,6,2,73,30,43,72
FC Midtjylla,5800,2,19,5,6,66,41,25,62
FC Nords,5800,3,14,6,10,75,55,20,48
Copenhagen,5800,4,13,4,13,57,49,8,43
AC Horsens,5800,5,8,12,10,37,52,-15,36
AaB,5800,6,8,11,11,35,42,-7,35
Sonderjyske,5800,7,8,6,10,28,29,-1,30
Randers FC,5800,8,6,6,12,25,40,-15,24
AGF Aarhus,5800,9,5,6,11,18,37,-19,21
Lyngby,5800,10,3,9,12,27,46,-19,18
Silkeborg IF,5800,11,5,3,14,26,46,-20,18
Brondby,5801,1,20,7,3,74,34,40,67
FC Midtjylla,5801,2,20,6,4,67,39,28,66
FC Nords,5801,3,16,6,8,79,50,29,54
Copenhagen,5801,4,12,5,13,54,50,4,41
AaB,5801,5,7,12,11,39,49,-10,33
AC Horsens,5801,6,7,12,11,36,53,-17,33
Sonderjyske,5801,7,8,6,10,28,29,-1,30
Lyngby,5801,8,4,9,11,29,44,-15,21
Randers FC,5801,9,5,6,13,23,42,-19,21
Silkeborg IF,5801,10,5,4,13,27,46,-19,19
AGF Aarhus,5801,11,4,7,11,18,38,-20,19
Brondby,5802,1,22,6,2,77,29,48,72
FC Midtjylla,5802,2,20,4,6,67,39,28,64
FC Nords,5802,3,14,7,9,70,54,16,49
Copenhagen,5802,4,12,4,14,55,52,3,40
AaB,5802,5,8,13,9,36,41,-5,37
AC Horsens,5802,6,7,12,11,39,55,-16,33
Sonderjyske,5802,7,8,6,10,28,29,-1,30
Randers FC,5802,8,6,6,12,25,39,-14,24
Silkeborg IF,5802,9,6,3,13,27,45,-18,21
Lyngby,5802,10,3,9,12,26,46,-20,18
AGF Aarhus,5802,11,4,6,12,17,38,-21,18
Brondby,5803,1,22,5,3,73,31,42,71
FC Midtjylla,5803,2,19,5,6,66,43,23,62
FC Nords,5803,3,14,7,9,76,50,26,49
Copenhagen,5803,4,14,4,12,58,46,12,46
AaB,5803,5,8,12,10,36,43,-7,36
AC Horsens,5803,6,6,13,11,33,55,-22,31
Sonderjyske,5803,7,8,6,10,28,29,-1,30
Randers FC,5803,8,5,7,12,24,40,-16,22
Lyngby,5803,9,3,10,11,27,45,-18,19
Silkeborg IF,5803,10,5,4,13,25,44,-19,19
AGF Aarhus,5803,11,4,7,11,16,36,-20,19
Brondby,5804,1,21,6,3,69,28,41,69
FC Midtjylla,5804,2,20,5,5,63,38,25,65
Copenhagen,5804,3,15,5,10,61,44,17,50
FC Nords,5804,4,14,6,10,73,52,21,48
AaB,5804,5,8,12,10,37,40,-3,36
Sonderjyske,5804,6,8,6,10,28,29,-1,30
AC Horsens,5804,7,5,12,13,33,60,-27,27
Randers FC,5804,8,5,7,12,23,39,-16,22
Silkeborg IF,5804,9,6,3,13,28,45,-17,21
Lyngby,5804,10,3,10,11,26,44,-18,19
AGF Aarhus,5804,11,4,6,12,17,39,-22,18
Brondby,5805,1,21,6,3,72,33,39,69
FC Midtjylla,5805,2,17,4,9,59,44,15,55
FC Nords,5805,3,15,6,9,70,47,23,51
Copenhagen,5805,4,14,5,11,60,45,15,47
AaB,5805,5,10,11,9,38,40,-2,41
AC Horsens,5805,6,7,12,11,34,50,-16,33
Sonderjyske,5805,7,8,6,10,28,29,-1,30
Lyngby,5805,8,4,9,11,28,45,-17,21
Randers FC,5805,9,5,6,13,24,41,-17,21
AGF Aarhus,5805,10,5,6,11,18,36,-18,21
Silkeborg IF,5805,11,5,3,14,25,46,-21,18
Brondby,5806,1,20,6,4,70,33,37,66
FC Midtjylla,5806,2,18,5,7,63,43,20,59
FC Nords,5806,3,13,10,7,70,48,22,49
Copenhagen,5806,4,14,6,10,57,44,13,48
AC Horsens,5806,5,8,13,9,38,49,-11,37
AaB,5806,6,7,12,11,39,46,-7,33
Sonderjyske,5806,7,8,6,10,28,29,-1,30
Lyngby,5806,8,4,9,11,32,47,-15,21
Randers FC,5806,9,5,6,13,26,45,-19,21
Silkeborg IF,5806,10,5,4,13,27,46,-19,19
AGF Aarhus,5806,11,4,7,11,18,38,-20,19
Brondby,5807,1,21,7,2,71,33,38,70
FC Midtjylla,5807,2,19,5,6,62,39,23,62
FC Nords,5807,3,14,8,8,75,53,22,50
Copenhagen,5807,4,13,4,13,57,47,10,43
AaB,5807,5,9,12,9,38,39,-1,39
Sonderjyske,5807,6,8,6,10,28,29,-1,30
AC Horsens,5807,7,6,12,12,36,54,-18,30
Randers FC,5807,8,6,6,12,24,39,-15,24
Silkeborg IF,5807,9,6,3,13,27,44,-17,21
Lyngby,5807,10,3,9,12,26,45,-19,18
AGF Aarhus,5807,11,4,6,12,16,38,-22,18
Brondby,5808,1,21,5,4,72,32,40,68
FC Midtjylla,5808,2,19,6,5,63,36,27,63
FC Nords,5808,3,14,6,10,75,56,19,48
Copenhagen,5808,4,14,5,11,56,43,13,47
AaB,5808,5,9,11,10,39,42,-3,38
AC Horsens,5808,6,6,13,11,36,58,-22,31
Sonderjyske,5808,7,8,6,10,28,29,-1,30
Randers FC,5808,8,6,6,12,25,40,-15,24
AGF Aarhus,5808,9,5,6,11,18,37,-19,21
Lyngby,5808,10,3,9,12,27,46,-19,18
Silkeborg IF,5808,11,5,3,14,26,46,-20,18
Brondby,5809,1,22,6,2,70,29,41,72
FC Midtjylla,5809,2,19,5,6,63,37,26,62
Copenhagen,5809,3,14,6,10,57,42,15,48
FC Nords,5809,4,13,7,10,74,55,19,46
AaB,5809,5,8,12,10,37,42,-5,36
Sonderjyske,5809,6,8,6,10,28,29,-1,30
AC Horsens,5809,7,6,12,12,34,56,-22,30
Randers FC,5809,8,6,6,12,25,39,-14,24
Silkeborg IF,5809,9,6,3,13,29,45,-16,21
Lyngby,5809,10,3,9,12,26,46,-20,18
AGF Aarhus,5809,11,4,6,12,17,40,-23,18
Brondby,5810,1,21,6,3,73,33,40,69
FC Midtjylla,5810,2,20,5,5,66,39,27,65
FC Nords,5810,3,15,7,8,74,49,25,52
Copenhagen,5810,4,12,5,13,53,47,6,41
AaB,5810,5,8,11,11,41,45,-4,35
AC Horsens,5810,6,7,12,11,32,52,-20,33
Sonderjyske,5810,7,8,6,10,28,29,-1,30
Randers FC,5810,8,6,6,12,27,40,-13,24
Silkeborg IF,5810,9,6,3,13,27,44,-17,21
Lyngby,5810,10,3,9,12,27,48,-21,18
AGF Aarhus,5810,11,4,6,12,16,38,-22,18
Brondby,5811,1,23,5,2,73,28,45,74
FC Midtjylla,5811,2,21,4,5,67,40,27,67
FC Nords,5811,3,12,7,11,71,60,11,43
Copenhagen,5811,4,13,4,13,55,46,9,43
AaB,5811,5,8,11,11,38,40,-2,35
AC Horsens,5811,6,7,13,10,34,50,-16,34
Sonderjyske,5811,7,8,6,10,28,29,-1,30
Randers FC,5811,8,5,7,12,24,40,-16,22
Silkeborg IF,5811,9,6,3,13,27,45,-18,21
Lyngby,5811,10,3,10,11,27,45,-18,19
AGF Aarhus,5811,11,4,6,12,17,38,-21,18
Brondby,5812,1,21,6,3,69,31,38,69
FC Midtjylla,5812,2,21,4,5,66,38,28,67
FC Nords,5812,3,14,6,10,73,51,22,48
Copenhagen,5812,4,13,5,12,54,44,10,44
AaB,5812,5,8,11,11,37,42,-5,35
AC Horsens,5812,6,6,14,10,33,52,-19,32
Sonderjyske,5812,7,8,6,10,28,29,-1,30
Lyngby,5812,8,4,9,11,28,44,-16,21
Silkeborg IF,5812,9,6,3,13,26,44,-18,21
Randers FC,5812,10,5,6,13,23,41,-18,21
AGF Aarhus,5812,11,4,6,12,16,37,-21,18
Brondby,5813,1,20,7,3,72,34,38,67
FC Midtjylla,5813,2,20,5,5,68,38,30,65
FC Nords,5813,3,15,6,9,77,53,24,51
Copenhagen,5813,4,13,5,12,58,49,9,44
AaB,5813,5,8,11,11,40,48,-8,35
AC Horsens,5813,6,7,12,11,38,57,-19,33
Sonderjyske,5813,7,8,6,10,28,29,-1,30
Lyngby,5813,8,4,9,11,28,44,-16,21
AGF Aarhus,5813,9,5,6,11,19,36,-17,21
Randers FC,5813,10,5,6,13,23,41,-18,21
Silkeborg IF,5813,11,5,3,14,25,47,-22,18
Brondby,5814,1,21,6,3,70,35,35,69
FC Midtjylla,5814,2,21,4,5,68,40,28,67
FC Nords,5814,3,13,7,10,72,57,15,46
Copenhagen,5814,4,13,4,13,61,45,16,43
AaB,5814,5,8,13,9,38,43,-5,37
AC Horsens,5814,6,7,12,11,36,51,-15,33
Sonderjyske,5814,7,8,6,10,28,29,-1,30
Randers FC,5814,8,6,6,12,25,40,-15,24
Silkeborg IF,5814,9,6,3,13,29,45,-16,21
Lyngby,5814,10,3,9,12,27,46,-19,18
AGF Aarhus,5814,11,4,6,12,17,40,-23,18
Brondby,5815,1,21,7,2,75,34,41,70
FC Midtjylla,5815,2,18,5,7,64,45,19,59
Copenhagen,5815,3,15,5,10,61,44,17,50
FC Nords,5815,4,14,7,9,73,50,23,49
AaB,5815,5,7,12,11,36,43,-7,33
AC Horsens,5815,6,5,16,9,33,52,-19,31
Sonderjyske,5815,7,8,6,10,28,29,-1,30
Lyngby,5815,8,4,9,11,29,45,-16,21
Randers FC,5815,9,5,6,13,24,42,-18,21
AGF Aarhus,5815,10,5,6,11,19,37,-18,21
Silkeborg IF,5815,11,5,3,14,26,47,-21,18
Brondby,5816,1,21,7,2,70,30,40,70
FC Midtjylla,5816,2,19,6,5,61,36,25,63
FC Nords,5816,3,15,7,8,73,47,26,52
Copenhagen,5816,4,14,4,12,58,43,15,46
AaB,5816,5,8,11,11,37,44,-7,35
Sonderjyske,5816,6,8,6,10,28,29,-1,30
AC Horsens,5816,7,5,13,12,29,54,-25,28
Lyngby,5816,8,4,9,11,27,44,-17,21
Randers FC,5816,9,5,6,13,23,40,-17,21
Silkeborg IF,5816,10,6,3,13,26,44,-18,21
AGF Aarhus,5816,11,4,6,12,16,37,-21,18
Brondby,5817,1,21,7,2,69,27,42,70
FC Midtjylla,5817,2,20,5,5,65,36,29,65
FC Nords,5817,3,15,7,8,71,47,24,52
Copenhagen,5817,4,12,6,12,51,41,10,42
AaB,5817,5,8,11,11,34,42,-8,35
Sonderjyske,5817,6,8,6,10,28,29,-1,30
AC Horsens,5817,7,6,12,12,31,54,-23,30
Randers FC,5817,8,5,7,12,24,40,-16,22
Silkeborg IF,5817,9,6,3,13,27,45,-18,21
Lyngby,5817,10,3,10,11,27,45,-18,19
AGF Aarhus,5817,11,4,6,12,17,38,-21,18
Brondby,5818,1,21,6,3,73,31,42,69
FC Midtjylla,5818,2,19,6,5,62,37,25,63
FC Nords,5818,3,14,8,8,72,48,24,50
Copenhagen,5818,4,13,6,11,57,45,12,45
AaB,5818,5,8,11,11,37,47,-10,35
AC Horsens,5818,6,6,13,11,32,51,-19,31
Sonderjyske,5818,7,8,6,10,28,29,-1,30
Lyngby,5818,8,4,9,11,29,44,-15,21
Randers FC,5818,9,5,6,13,23,42,-19,21
AGF Aarhus,5818,10,5,6,11,17,36,-19,21
Silkeborg IF,5818,11,5,3,14,25,45,-20,18
Brondby,5819,1,20,7,3,72,34,38,67
FC Midtjylla,5819,2,19,6,5,64,39,25,63
FC Nords,5819,3,14,8,8,74,51,23,50
Copenhagen,5819,4,12,6,12,53,44,9,42
AaB,5819,5,7,13,10,39,46,-7,34
AC Horsens,5819,6,6,16,8,41,55,-14,34
Sonderjyske,5819,7,8,6,10,28,29,-1,30
Randers FC,5819,8,6,6,12,24,39,-15,24
AGF Aarhus,5819,9,5,6,11,19,37,-18,21
Lyngby,5819,10,3,9,12,26,45,-19,18
Silkeborg IF,5819,11,5,3,14,26,47,-21,18
Brondby,5820,1,21,5,4,66,32,34,68
FC Midtjylla,5820,2,20,4,6,67,39,28,64
FC Nords,5820,3,14,7,9,72,49,23,49
Copenhagen,5820,4,14,6,10,58,44,14,48
AaB,5820,5,7,12,11,35,42,-7,33
AC Horsens,5820,6,7,12,11,36,54,-18,33
Sonderjyske,5820,7,8,6,10,28,29,-1,30
Randers FC,5820,8,5,7,12,24,40,-16,22
Lyngby,5820,9,3,10,11,27,45,-18,19
Silkeborg IF,5820,10,5,4,13,25,44,-19,19
AGF Aarhus,5820,11,4,7,11,16,36,-20,19
Brondby,5821,1,21,5,4,73,38,35,68
FC Midtjylla,5821,2,21,4,5,72,41,31,67
FC Nords,5821,3,15,6,9,75,55,20,51
Copenhagen,5821,4,13,5,12,57,47,10,44
AC Horsens,5821,5,7,13,10,39,53,-14,34
AaB,5821,6,6,13,11,35,43,-8,31
Sonderjyske,5821,7,8,6,10,28,29,-1,30
Randers FC,5821,8,6,6,12,25,40,-15,24
Silkeborg IF,5821,9,6,3,13,28,44,-16,21
Lyngby,5821,10,3,9,12,27,46,-19,18
AGF Aarhus,5821,11,4,6,12,16,39,-23,18
Brondby,5822,1,21,6,3,70,30,40,69
FC Midtjylla,5822,2,18,5,7,62,42,20,59
FC Nords,5822,3,15,7,8,76,54,22,52
Copenhagen,5822,4,13,6,11,54,43,11,45
AaB,5822,5,8,12,10,42,41,1,36
AC Horsens,5822,6,7,12,11,36,56,-20,33
Sonderjyske,5822,7,8,6,10,28,29,-1,30
Randers FC,5822,8,5,7,12,24,40,-16,22
Silkeborg IF,5822,9,6,3,13,26,44,-18,21
Lyngby,5822,10,3,10,11,27,45,-18,19
AGF Aarhus,5822,11,4,6,12,16,37,-21,18
Brondby,5823,1,22,5,3,78,29,49,71
FC Midtjylla,5823,2,18,7,5,61,39,22,61
FC Nords,5823,3,13,8,9,71,56,15,47
Copenhagen,5823,4,12,7,11,54,48,6,43
AaB,5823,5,8,12,10,40,41,-1,36
AC Horsens,5823,6,7,13,10,34,51,-17,34
Sonderjyske,5823,7,8,6,10,28,29,-1,30
Randers FC,5823,8,6,6,12,26,40,-14,24
Silkeborg IF,5823,9,6,3,13,27,45,-18,21
Lyngby,5823,10,3,9,12,27,47,-20,18
AGF Aarhus,5823,11,4,6,12,17,38,-21,18
Brondby,5824,1,21,7,2,79,37,42,70
FC Midtjylla,5824,2,19,6,5,70,43,27,63
FC Nords,5824,3,13,9,8,77,57,20,48
Copenhagen,5824,4,14,6,10,61,45,16,48
AaB,5824,5,7,11,12,36,46,-10,32
Sonderjyske,5824,6,8,6,10,28,29,-1,30
AC Horsens,5824,7,5,15,10,37,58,-21,30
Randers FC,5824,8,5,7,12,24,40,-16,22
AGF Aarhus,5824,9,5,6,11,17,36,-19,21
Lyngby,5824,10,3,10,11,27,45,-18,19
Silkeborg IF,5824,11,5,3,14,25,45,-20,18
Brondby,5825,1,21,6,3,70,30,40,69
FC Midtjylla,5825,2,18,4,8,62,44,18,58
FC Nords,5825,3,16,6,8,78,50,28,54
Copenhagen,5825,4,14,6,10,59,43,16,48
AaB,5825,5,8,12,10,40,45,-5,36
Sonderjyske,5825,6,8,6,10,28,29,-1,30
AC Horsens,5825,7,5,14,11,33,56,-23,29
Lyngby,5825,8,4,9,11,30,45,-15,21
Silkeborg IF,5825,9,6,3,13,29,44,-15,21
Randers FC,5825,10,5,6,13,24,43,-19,21
AGF Aarhus,5825,11,4,6,12,16,40,-24,18
Brondby,5826,1,20,7,3,71,30,41,67
FC Midtjylla,5826,2,18,6,6,60,40,20,60
FC Nords,5826,3,14,7,9,71,50,21,49
Copenhagen,5826,4,14,5,11,55,43,12,47
AC Horsens,5826,5,9,12,9,37,49,-12,39
AaB,5826,6,6,13,11,35,43,-8,31
Sonderjyske,5826,7,8,6,10,28,29,-1,30
Lyngby,5826,8,4,9,11,30,44,-14,21
Randers FC,5826,9,5,6,13,23,43,-20,21
Silkeborg IF,5826,10,5,4,13,28,47,-19,19
AGF Aarhus,5826,11,4,7,11,19,39,-20,19
Brondby,5827,1,21,5,4,70,33,37,68
FC Midtjylla,5827,2,19,4,7,66,42,24,61
FC Nords,5827,3,15,6,9,76,52,24,51
Copenhagen,5827,4,15,6,9,60,41,19,51
AC Horsens,5827,5,7,13,10,32,51,-19,34
Sonderjyske,5827,6,8,6,10,28,29,-1,30
AaB,5827,7,6,12,12,32,43,-11,30
Randers FC,5827,8,5,7,12,25,41,-16,22
Silkeborg IF,5827,9,6,3,13,27,45,-18,21
Lyngby,5827,10,3,10,11,28,46,-18,19
AGF Aarhus,5827,11,4,6,12,17,38,-21,18
Brondby,5828,1,20,6,4,69,34,35,66
FC Midtjylla,5828,2,20,5,5,70,41,29,65
Copenhagen,5828,3,15,4,11,58,44,14,49
FC Nords,5828,4,14,6,10,72,50,22,48
AC Horsens,5828,5,7,13,10,33,52,-19,34
AaB,5828,6,7,12,11,37,44,-7,33
Sonderjyske,5828,7,8,6,10,28,29,-1,30
Randers FC,5828,8,5,7,12,24,40,-16,22
Silkeborg IF,5828,9,6,3,13,27,45,-18,21
Lyngby,5828,10,3,10,11,27,45,-18,19
AGF Aarhus,5828,11,4,6,12,17,38,-21,18
Brondby,5829,1,21,7,2,70,29,41,70
FC Midtjylla,5829,2,20,5,5,62,35,27,65
Copenhagen,5829,3,15,5,10,57,42,15,50
FC Nords,5829,4,14,6,10,72,54,18,48
AaB,5829,5,7,12,11,38,43,-5,33
Sonderjyske,5829,6,8,6,10,28,29,-1,30
AC Horsens,5829,7,5,13,12,34,56,-22,28
Silkeborg IF,5829,8,6,3,13,28,44,-16,21
Lyngby,5829,9,4,9,11,29,46,-17,21
Randers FC,5829,10,5,6,13,25,42,-17,21
AGF Aarhus,5829,11,4,6,12,16,39,-23,18
Brondby,5830,1,21,7,2,70,28,42,70
FC Midtjylla,5830,2,18,8,4,63,35,28,62
FC Nords,5830,3,13,8,9,72,52,20,47
Copenhagen,5830,4,13,6,11,57,47,10,45
AaB,5830,5,6,15,9,35,40,-5,33
AC Horsens,5830,6,6,14,10,36,57,-21,32
Sonderjyske,5830,7,8,6,10,28,29,-1,30
Lyngby,5830,8,4,9,11,27,44,-17,21
Randers FC,5830,9,5,6,13,23,40,-17,21
Silkeborg IF,5830,10,6,3,13,26,44,-18,21
AGF Aarhus,5830,11,4,6,12,16,37,-21,18
Brondby,5831,1,21,5,4,66,29,37,68
FC Midtjylla,5831,2,19,5,6,60,37,23,62
FC Nords,5831,3,14,6,10,70,48,22,48
Copenhagen,5831,4,14,4,12,58,48,10,46
AaB,5831,5,8,12,10,39,44,-5,36
AC Horsens,5831,6,7,14,9,36,49,-13,35
Sonderjyske,5831,7,8,6,10,28,29,-1,30
Randers FC,5831,8,6,6,12,25,39,-14,24
Silkeborg IF,5831,9,5,4,13,26,45,-19,19
AGF Aarhus,5831,10,4,7,11,17,37,-20,19
Lyngby,5831,11,3,9,12,26,46,-20,18
Brondby,5832,1,21,5,4,73,32,41,68
FC Midtjylla,5832,2,19,5,6,64,42,22,62
Copenhagen,5832,3,14,6,10,59,42,17,48
FC Nords,5832,4,13,8,9,77,59,18,47
AaB,5832,5,7,13,10,38,46,-8,34
AC Horsens,5832,6,7,13,10,37,53,-16,34
Sonderjyske,5832,7,8,6,10,28,29,-1,30
Randers FC,5832,8,6,6,12,25,39,-14,24
AGF Aarhus,5832,9,5,6,11,17,36,-19,21
Lyngby,5832,10,3,9,12,26,46,-20,18
Silkeborg IF,5832,11,5,3,14,25,45,-20,18
Brondby,5833,1,21,7,2,70,29,41,70
FC Midtjylla,5833,2,19,5,6,65,39,26,62
FC Nords,5833,3,15,7,8,70,47,23,52
Copenhagen,5833,4,14,5,11,58,46,12,47
AaB,5833,5,8,11,11,35,43,-8,35
Sonderjyske,5833,6,8,6,10,28,29,-1,30
AC Horsens,5833,7,5,13,12,30,50,-20,28
Randers FC,5833,8,6,6,12,26,41,-15,24
Silkeborg IF,5833,9,6,3,13,27,44,-17,21
Lyngby,5833,10,3,9,12,28,47,-19,18
AGF Aarhus,5833,11,4,6,12,16,38,-22,18
Brondby,5834,1,19,7,4,71,37,34,64
FC Midtjylla,5834,2,19,5,6,65,38,27,62
Copenhagen,5834,3,15,5,10,59,43,16,50
FC Nords,5834,4,14,7,9,73,51,22,49
AaB,5834,5,7,13,10,36,47,-11,34
AC Horsens,5834,6,7,13,10,36,50,-14,34
Sonderjyske,5834,7,8,6,10,28,29,-1,30
Randers FC,5834,8,6,6,12,24,39,-15,24
Silkeborg IF,5834,9,5,4,13,25,44,-19,19
AGF Aarhus,5834,10,4,7,11,16,36,-20,19
Lyngby,5834,11,3,9,12,26,45,-19,18
FC Midtjylla,5835,1,21,5,4,68,34,34,68
Brondby,5835,2,19,8,3,69,36,33,65
FC Nords,5835,3,13,8,9,72,53,19,47
Copenhagen,5835,4,13,5,12,57,47,10,44
AaB,5835,5,8,13,9,41,45,-4,37
AC Horsens,5835,6,6,13,11,33,51,-18,31
Sonderjyske,5835,7,8,6,10,28,29,-1,30
Lyngby,5835,8,4,9,11,27,44,-17,21
Randers FC,5835,9,5,6,13,23,40,-17,21
Silkeborg IF,5835,10,5,4,13,26,45,-19,19
AGF Aarhus,5835,11,4,7,11,17,37,-20,19
Brondby,5836,1,22,5,3,72,30,42,71
FC Midtjylla,5836,2,21,4,5,71,39,32,67
FC Nords,5836,3,16,6,8,75,47,28,54
Copenhagen,5836,4,13,4,13,56,50,6,43
AaB,5836,5,7,11,12,34,44,-10,32
Sonderjyske,5836,6,8,6,10,28,29,-1,30
AC Horsens,5836,7,6,12,12,35,59,-24,30
Lyngby,5836,8,4,9,11,30,44,-14,21
Silkeborg IF,5836,9,6,3,13,26,44,-18,21
Randers FC,5836,10,5,6,13,23,43,-20,21
AGF Aarhus,5836,11,4,6,12,16,37,-21,18
Brondby,5837,1,21,7,2,70,31,39,70
FC Midtjylla,5837,2,19,6,5,66,39,27,63
Copenhagen,5837,3,13,7,10,60,47,13,46
FC Nords,5837,4,12,9,9,72,55,17,45
AaB,5837,5,9,12,9,39,40,-1,39
Sonderjyske,5837,6,8,6,10,28,29,-1,30
AC Horsens,5837,7,5,13,12,33,54,-21,28
Randers FC,5837,8,5,7,12,23,39,-16,22
Silkeborg IF,5837,9,6,3,13,27,45,-18,21
Lyngby,5837,10,3,10,11,26,44,-18,19
AGF Aarhus,5837,11,4,6,12,17,38,-21,18
Brondby,5838,1,23,5,2,76,32,44,74
FC Midtjylla,5838,2,21,4,5,70,42,28,67
FC Nords,5838,3,15,6,9,82,55,27,51
Copenhagen,5838,4,12,4,14,54,49,5,40
AC Horsens,5838,5,7,12,11,36,55,-19,33
AaB,5838,6,7,11,12,35,46,-11,32
Sonderjyske,5838,7,8,6,10,28,29,-1,30
Randers FC,5838,8,6,6,12,26,40,-14,24
Silkeborg IF,5838,9,5,4,13,26,45,-19,19
AGF Aarhus,5838,10,4,7,11,17,37,-20,19
Lyngby,5838,11,3,9,12,27,47,-20,18
Brondby,5839,1,20,7,3,69,31,38,67
FC Midtjylla,5839,2,20,5,5,68,39,29,65
Copenhagen,5839,3,15,4,11,60,45,15,49
FC Nords,5839,4,14,6,10,75,54,21,48
AaB,5839,5,8,11,11,36,45,-9,35
AC Horsens,5839,6,6,13,11,33,53,-20,31
Sonderjyske,5839,7,8,6,10,28,29,-1,30
Randers FC,5839,8,5,7,12,24,40,-16,22
AGF Aarhus,5839,9,5,6,11,17,36,-19,21
Lyngby,5839,10,3,10,11,27,45,-18,19
Silkeborg IF,5839,11,5,3,14,25,45,-20,18
Brondby,5840,1,21,6,3,69,32,37,69
FC Midtjylla,5840,2,18,4,8,63,44,19,58
FC Nords,5840,3,16,6,8,76,48,28,54
Copenhagen,5840,4,15,5,10,60,45,15,50
AaB,5840,5,7,12,11,36,43,-7,33
Sonderjyske,5840,6,8,6,10,28,29,-1,30
AC Horsens,5840,7,5,15,10,37,55,-18,30
Randers FC,5840,8,5,7,12,23,39,-16,22
AGF Aarhus,5840,9,5,6,11,18,37,-19,21
Lyngby,5840,10,3,10,11,26,44,-18,19
Silkeborg IF,5840,11,5,3,14,26,46,-20,18
Brondby,5841,1,21,5,4,72,33,39,68
FC Midtjylla,5841,2,18,7,5,63,38,25,61
FC Nords,5841,3,15,6,9,74,55,19,51
Copenhagen,5841,4,14,5,11,58,44,14,47
AaB,5841,5,8,12,10,39,44,-5,36
AC Horsens,5841,6,6,13,11,33,51,-18,31
Sonderjyske,5841,7,8,6,10,28,29,-1,30
Lyngby,5841,8,4,9,11,28,44,-16,21
Randers FC,5841,9,5,6,13,23,41,-18,21
Silkeborg IF,5841,10,5,4,13,26,45,-19,19
AGF Aarhus,5841,11,4,7,11,17,37,-20,19
Brondby,5842,1,21,7,2,73,29,44,70
FC Midtjylla,5842,2,20,4,6,65,40,25,64
FC Nords,5842,3,14,7,9,72,55,17,49
Copenhagen,5842,4,13,5,12,55,44,11,44
AaB,5842,5,8,12,10,36,41,-5,36
AC Horsens,5842,6,6,13,11,37,55,-18,31
Sonderjyske,5842,7,8,6,10,28,29,-1,30
Silkeborg IF,5842,8,6,3,13,28,45,-17,21
Lyngby,5842,9,4,9,11,27,44,-17,21
Randers FC,5842,10,5,6,13,23,40,-17,21
AGF Aarhus,5842,11,4,6,12,17,39,-22,18
Brondby,5843,1,20,7,3,69,32,37,67
FC Midtjylla,5843,2,19,6,5,65,39,26,63
FC Nords,5843,3,14,6,10,76,57,19,48
Copenhagen,5843,4,14,5,11,60,45,15,47
AaB,5843,5,9,12,9,38,40,-2,39
Sonderjyske,5843,6,8,6,10,28,29,-1,30
AC Horsens,5843,7,5,14,11,34,55,-21,29
Randers FC,5843,8,6,6,12,25,40,-15,24
Silkeborg IF,5843,9,6,3,13,26,44,-18,21
Lyngby,5843,10,3,9,12,27,46,-19,18
AGF Aarhus,5843,11,4,6,12,16,37,-21,18
Brondby,5844,1,21,6,3,69,31,38,69
FC Midtjylla,5844,2,20,5,5,66,41,25,65
Copenhagen,5844,3,15,4,11,58,43,15,49
FC Nords,5844,4,14,6,10,73,51,22,48
AC Horsens,5844,5,8,12,10,36,50,-14,36
Sonderjyske,5844,6,8,6,10,28,29,-1,30
AaB,5844,7,6,11,13,35,47,-12,29
Lyngby,5844,8,4,9,11,28,44,-16,21
Randers FC,5844,9,5,6,13,23,41,-18,21
Silkeborg IF,5844,10,5,4,13,25,44,-19,19
AGF Aarhus,5844,11,4,7,11,16,36,-20,19
Brondby,5845,1,22,6,2,75,31,44,72
FC Midtjylla,5845,2,20,4,6,67,39,28,64
FC Nords,5845,3,15,7,8,79,49,30,52
Copenhagen,5845,4,13,4,13,55,46,9,43
AaB,5845,5,7,12,11,35,44,-9,33
AC Horsens,5845,6,6,13,11,33,61,-28,31
Sonderjyske,5845,7,8,6,10,28,29,-1,30
Lyngby,5845,8,4,9,11,29,45,-16,21
Randers FC,5845,9,5,6,13,24,42,-18,21
AGF Aarhus,5845,10,5,6,11,18,36,-18,21
Silkeborg IF,5845,11,5,3,14,25,46,-21,18
FC Midtjylla,5846,1,21,4,5,67,38,29,67
Brondby,5846,2,20,5,5,64,36,28,65
FC Nords,5846,3,15,6,9,78,48,30,51
Copenhagen,5846,4,13,4,13,54,48,6,43
AC Horsens,5846,5,8,12,10,36,51,-15,36
AaB,5846,6,8,11,11,37,41,-4,35
Sonderjyske,5846,7,8,6,10,28,29,-1,30
Lyngby,5846,8,4,9,11,28,44,-16,21
Silkeborg IF,5846,9,6,3,13,29,46,-17,21
Randers FC,5846,10,5,6,13,23,41,-18,21
AGF Aarhus,5846,11,4,6,12,18,40,-22,18
Brondby,5847,1,21,5,4,71,33,38,68
FC Midtjylla,5847,2,18,6,6,67,44,23,60
FC Nords,5847,3,16,6,8,73,48,25,54
AaB,5847,4,10,12,8,43,41,2,42
Copenhagen,5847,5,12,5,13,57,51,6,41
Sonderjyske,5847,6,8,6,10,28,29,-1,30
AC Horsens,5847,7,6,12,12,34,54,-20,30
Randers FC,5847,8,5,7,12,24,40,-16,22
AGF Aarhus,5847,9,5,6,11,18,37,-19,21
Lyngby,5847,10,3,10,11,27,45,-18,19
Silkeborg IF,5847,11,5,3,14,26,46,-20,18
Brondby,5848,1,19,8,3,72,35,37,65
FC Midtjylla,5848,2,19,5,6,63,38,25,62
Copenhagen,5848,3,13,7,10,55,41,14,46
FC Nords,5848,4,13,6,11,73,57,16,45
AaB,5848,5,8,13,9,38,43,-5,37
AC Horsens,5848,6,8,13,9,37,50,-13,37
Sonderjyske,5848,7,8,6,10,28,29,-1,30
Lyngby,5848,8,4,9,11,27,44,-17,21
Randers FC,5848,9,5,6,13,23,40,-17,21
AGF Aarhus,5848,10,5,6,11,17,36,-19,21
Silkeborg IF,5848,11,5,3,14,25,45,-20,18
Brondby,5849,1,20,7,3,71,33,38,67
FC Midtjylla,5849,2,19,6,5,64,40,24,63
FC Nords,5849,3,15,7,8,82,52,30,52
Copenhagen,5849,4,15,5,10,64,46,18,50
AaB,5849,5,7,12,11,35,45,-10,33
Sonderjyske,5849,6,8,6,10,28,29,-1,30
AC Horsens,5849,7,5,13,12,35,61,-26,28
Lyngby,5849,8,4,9,11,29,44,-15,21
Randers FC,5849,9,5,6,13,23,42,-19,21
AGF Aarhus,5849,10,5,6,11,18,37,-19,21
Silkeborg IF,5849,11,5,3,14,26,46,-20,18
Brondby,5850,1,19,6,5,69,37,32,63
FC Midtjylla,5850,2,19,4,7,62,41,21,61
FC Nords,5850,3,15,8,7,73,46,27,53
Copenhagen,5850,4,15,4,11,60,45,15,49
AaB,5850,5,8,12,10,37,41,-4,36
AC Horsens,5850,6,7,12,11,37,54,-17,33
Sonderjyske,5850,7,8,6,10,28,29,-1,30
Lyngby,5850,8,4,9,11,28,45,-17,21
Randers FC,5850,9,5,6,13,24,41,-17,21
AGF Aarhus,5850,10,5,6,11,18,37,-19,21
Silkeborg IF,5850,11,5,3,14,26,46,-20,18
Brondby,5851,1,19,6,5,75,41,34,63
FC Midtjylla,5851,2,19,6,5,64,39,25,63
FC Nords,5851,3,15,8,7,80,49,31,53
Copenhagen,5851,4,13,7,10,55,43,12,46
AaB,5851,5,9,11,10,40,45,-5,38
Sonderjyske,5851,6,8,6,10,28,29,-1,30
AC Horsens,5851,7,5,14,11,32,55,-23,29
Randers FC,5851,8,6,6,12,25,40,-15,24
Silkeborg IF,5851,9,6,3,13,28,44,-16,21
Lyngby,5851,10,3,9,12,27,46,-19,18
AGF Aarhus,5851,11,4,6,12,16,39,-23,18
Brondby,5852,1,22,6,2,74,31,43,72
FC Midtjylla,5852,2,20,5,5,66,37,29,65
FC Nords,5852,3,14,7,9,74,52,22,49
Copenhagen,5852,4,15,4,11,56,43,13,49
AC Horsens,5852,5,6,13,11,34,54,-20,31
Sonderjyske,5852,6,8,6,10,28,29,-1,30
AaB,5852,7,6,11,13,31,44,-13,29
Randers FC,5852,8,6,6,12,25,40,-15,24
Silkeborg IF,5852,9,6,3,13,28,45,-17,21
Lyngby,5852,10,3,9,12,27,46,-19,18
AGF Aarhus,5852,11,4,6,12,17,39,-22,18
Brondby,5853,1,21,6,3,76,34,42,69
FC Midtjylla,5853,2,21,4,5,70,41,29,67
FC Nords,5853,3,15,6,9,78,53,25,51
Copenhagen,5853,4,13,7,10,53,42,11,46
AaB,5853,5,6,13,11,33,44,-11,31
Sonderjyske,5853,6,8,6,10,28,29,-1,30
AC Horsens,5853,7,5,14,11,30,52,-22,29
Randers FC,5853,8,6,6,12,26,40,-14,24
AGF Aarhus,5853,9,5,6,11,18,37,-19,21
Lyngby,5853,10,3,9,12,27,47,-20,18
Silkeborg IF,5853,11,5,3,14,26,46,-20,18
Brondby,5854,1,21,6,3,71,32,39,69
FC Midtjylla,5854,2,19,7,4,68,37,31,64
Copenhagen,5854,3,15,4,11,60,44,16,49
FC Nords,5854,4,13,7,10,71,58,13,46
AaB,5854,5,7,13,10,37,43,-6,34
AC Horsens,5854,6,6,13,11,37,56,-19,31
Sonderjyske,5854,7,8,6,10,28,29,-1,30
Randers FC,5854,8,6,6,12,24,39,-15,24
Silkeborg IF,5854,9,6,3,13,27,45,-18,21
Lyngby,5854,10,3,9,12,26,45,-19,18
AGF Aarhus,5854,11,4,6,12,17,38,-21,18
FC Midtjylla,5855,1,22,4,4,75,40,35,70
Brondby,5855,2,19,7,4,66,34,32,64
FC Nords,5855,3,13,7,10,74,55,19,46
Copenhagen,5855,4,14,4,12,57,46,11,46
AaB,5855,5,8,12,10,37,45,-8,36
AC Horsens,5855,6,7,12,11,37,52,-15,33
Sonderjyske,5855,7,8,6,10,28,29,-1,30
Randers FC,5855,8,5,7,12,24,40,-16,22
Lyngby,5855,9,3,10,11,27,45,-18,19
Silkeborg IF,5855,10,5,4,13,26,45,-19,19
AGF Aarhus,5855,11,4,7,11,17,37,-20,19
Brondby,5856,1,20,6,4,71,36,35,66
FC Midtjylla,5856,2,19,7,4,66,39,27,64
FC Nords,5856,3,14,8,8,76,54,22,50
Copenhagen,5856,4,14,6,10,62,47,15,48
AC Horsens,5856,5,7,13,10,36,52,-16,34
Sonderjyske,5856,6,8,6,10,28,29,-1,30
AaB,5856,7,6,12,12,37,46,-9,30
Randers FC,5856,8,6,6,12,25,40,-15,24
Silkeborg IF,5856,9,6,3,13,27,45,-18,21
Lyngby,5856,10,3,9,12,27,46,-19,18
AGF Aarhus,5856,11,4,6,12,17,38,-21,18
Brondby,5857,1,21,6,3,68,30,38,69
FC Midtjylla,5857,2,18,5,7,64,41,23,59
FC Nords,5857,3,15,7,8,77,52,25,52
Copenhagen,5857,4,15,5,10,62,47,15,50
AC Horsens,5857,5,7,12,11,35,53,-18,33
AaB,5857,6,7,11,12,35,44,-9,32
Sonderjyske,5857,7,8,6,10,28,29,-1,30
Lyngby,5857,8,4,9,11,27,44,-17,21
Randers FC,5857,9,5,6,13,23,40,-17,21
AGF Aarhus,5857,10,5,6,11,17,36,-19,21
Silkeborg IF,5857,11,5,3,14,25,45,-20,18
Brondby,5858,1,20,7,3,73,38,35,67
FC Midtjylla,5858,2,20,5,5,67,42,25,65
FC Nords,5858,3,14,8,8,74,52,22,50
Copenhagen,5858,4,14,4,12,58,46,12,46
AaB,5858,5,7,13,10,37,42,-5,34
AC Horsens,5858,6,6,13,11,36,51,-15,31
Sonderjyske,5858,7,8,6,10,28,29,-1,30
Lyngby,5858,8,4,9,11,27,44,-17,21
Randers FC,5858,9,5,6,13,23,40,-17,21
Silkeborg IF,5858,10,5,4,13,26,45,-19,19
AGF Aarhus,5858,11,4,7,11,17,37,-20,19
Brondby,5859,1,22,6,2,70,28,42,72
FC Midtjylla,5859,2,19,5,6,62,39,23,62
FC Nords,5859,3,14,8,8,72,47,25,50
Copenhagen,5859,4,12,5,13,55,50,5,41
AaB,5859,5,9,12,9,38,38,0,39
Sonderjyske,5859,6,8,6,10,28,29,-1,30
AC Horsens,5859,7,5,14,11,33,54,-21,29
Silkeborg IF,5859,8,6,3,13,31,44,-13,21
Lyngby,5859,9,4,9,11,30,44,-14,21
Randers FC,5859,10,5,6,13,23,43,-20,21
AGF Aarhus,5859,11,4,6,12,16,42,-26,18
Brondby,5860,1,21,5,4,69,32,37,68
FC Midtjylla,5860,2,20,6,4,68,41,27,66
FC Nords,5860,3,13,7,10,72,55,17,46
Copenhagen,5860,4,13,4,13,57,48,9,43
AaB,5860,5,9,12,9,40,41,-1,39
AC Horsens,5860,6,7,12,11,35,50,-15,33
Sonderjyske,5860,7,8,6,10,28,29,-1,30
Lyngby,5860,8,4,9,11,29,45,-16,21
Silkeborg IF,5860,9,6,3,13,27,45,-18,21
Randers FC,5860,10,5,6,13,24,42,-18,21
AGF Aarhus,5860,11,4,6,12,17,38,-21,18
Brondby,5861,1,22,5,3,72,32,40,71
FC Midtjylla,5861,2,21,4,5,65,39,26,67
FC Nords,5861,3,14,6,10,72,53,19,48
Copenhagen,5861,4,14,4,12,60,47,13,46
AaB,5861,5,7,12,11,39,45,-6,33
AC Horsens,5861,6,6,13,11,34,52,-18,31
Sonderjyske,5861,7,8,6,10,28,29,-1,30
Lyngby,5861,8,4,9,11,29,44,-15,21
Randers FC,5861,9,5,6,13,23,42,-19,21
AGF Aarhus,5861,10,5,6,11,18,37,-19,21
Silkeborg IF,5861,11,5,3,14,26,46,-20,18
Brondby,5862,1,21,5,4,71,34,37,68
FC Midtjylla,5862,2,20,4,6,67,40,27,64
Copenhagen,5862,3,15,6,9,58,40,18,51
FC Nords,5862,4,13,7,10,71,55,16,46
AaB,5862,5,9,11,10,41,41,0,38
Sonderjyske,5862,6,8,6,10,28,29,-1,30
AC Horsens,5862,7,5,13,12,32,56,-24,28
Randers FC,5862,8,6,6,12,26,41,-15,24
Silkeborg IF,5862,9,6,3,13,27,44,-17,21
Lyngby,5862,10,3,9,12,28,47,-19,18
AGF Aarhus,5862,11,4,6,12,16,38,-22,18
Brondby,5863,1,21,6,3,72,32,40,69
FC Midtjylla,5863,2,18,6,6,66,41,25,60
FC Nords,5863,3,15,7,8,74,52,22,52
Copenhagen,5863,4,13,5,12,58,48,10,44
AC Horsens,5863,5,7,14,9,37,52,-15,35
AaB,5863,6,7,12,11,34,42,-8,33
Sonderjyske,5863,7,8,6,10,28,29,-1,30
Lyngby,5863,8,4,9,11,28,44,-16,21
Randers FC,5863,9,5,6,13,23,41,-18,21
AGF Aarhus,5863,10,5,6,11,17,36,-19,21
Silkeborg IF,5863,11,5,3,14,25,45,-20,18
Brondby,5864,1,20,6,4,74,38,36,66
FC Midtjylla,5864,2,19,5,6,65,38,27,62
FC Nords,5864,3,15,6,9,73,56,17,51
Copenhagen,5864,4,15,4,11,60,43,17,49
AaB,5864,5,8,12,10,39,43,-4,36
Sonderjyske,5864,6,8,6,10,28,29,-1,30
AC Horsens,5864,7,5,15,10,35,54,-19,30
Randers FC,5864,8,6,6,12,26,41,-15,24
Silkeborg IF,5864,9,6,3,13,27,44,-17,21
Lyngby,5864,10,3,9,12,28,47,-19,18
AGF Aarhus,5864,11,4,6,12,16,38,-22,18
FC Midtjylla,5865,1,20,6,4,61,34,27,66
Brondby,5865,2,20,5,5,72,33,39,65
Copenhagen,5865,3,15,5,10,61,46,15,50
FC Nords,5865,4,12,7,11,67,52,15,43
AaB,5865,5,8,12,10,33,40,-7,36
AC Horsens,5865,6,7,13,10,34,49,-15,34
Sonderjyske,5865,7,8,6,10,28,29,-1,30
Lyngby,5865,8,4,9,11,28,44,-16,21
Silkeborg IF,5865,9,6,3,13,26,44,-18,21
Randers FC,5865,10,5,6,13,23,41,-18,21
AGF Aarhus,5865,11,4,6,12,16,37,-21,18
Brondby,5866,1,21,6,3,71,32,39,69
FC Midtjylla,5866,2,18,4,8,63,46,17,58
FC Nords,5866,3,15,6,9,77,54,23,51
Copenhagen,5866,4,14,5,11,61,46,15,47
AaB,5866,5,8,13,9,38,40,-2,37
AC Horsens,5866,6,7,12,11,37,55,-18,33
Sonderjyske,5866,7,8,6,10,28,29,-1,30
Randers FC,5866,8,5,7,12,24,40,-16,22
AGF Aarhus,5866,9,5,6,11,17,36,-19,21
Lyngby,5866,10,3,10,11,27,45,-18,19
Silkeborg IF,5866,11,5,3,14,25,45,-20,18
FC Midtjylla,5867,1,22,4,4,67,36,31,70
Brondby,5867,2,20,7,3,73,32,41,67
Copenhagen,5867,3,14,6,10,58,43,15,48
FC Nords,5867,4,13,7,10,71,58,13,46
AC Horsens,5867,5,6,14,10,37,53,-16,32
Sonderjyske,5867,6,8,6,10,28,29,-1,30
AaB,5867,7,6,12,12,36,46,-10,30
Lyngby,5867,8,4,9,11,28,44,-16,21
Silkeborg IF,5867,9,6,3,13,27,44,-17,21
Randers FC,5867,10,5,6,13,23,41,-18,21
AGF Aarhus,5867,11,4,6,12,16,38,-22,18
Brondby,5868,1,20,5,5,66,37,29,65
FC Midtjylla,5868,2,20,4,6,62,39,23,64
FC Nords,5868,3,16,6,8,78,46,32,54
Copenhagen,5868,4,14,4,12,56,45,11,46
AaB,5868,5,8,11,11,37,40,-3,35
AC Horsens,5868,6,7,12,11,34,52,-18,33
Sonderjyske,5868,7,8,6,10,28,29,-1,30
Randers FC,5868,8,6,6,12,28,39,-11,24
Silkeborg IF,5868,9,6,3,13,27,44,-17,21
AGF Aarhus,5868,10,4,6,12,16,38,-22,18
Lyngby,5868,11,3,9,12,26,49,-23,18
Brondby,5869,1,19,8,3,66,31,35,65
FC Midtjylla,5869,2,18,8,4,65,40,25,62
FC Nords,5869,3,13,8,9,73,52,21,47
Copenhagen,5869,4,14,5,11,58,47,11,47
AC Horsens,5869,5,8,12,10,39,49,-10,36
AaB,5869,6,7,13,10,38,46,-8,34
Sonderjyske,5869,7,8,6,10,28,29,-1,30
Randers FC,5869,8,6,6,12,26,40,-14,24
AGF Aarhus,5869,9,5,6,11,17,36,-19,21
Lyngby,5869,10,3,9,12,27,47,-20,18
Silkeborg IF,5869,11,5,3,14,25,45,-20,18
Brondby,5870,1,21,6,3,76,35,41,69
FC Midtjylla,5870,2,19,6,5,67,38,29,63
FC Nords,5870,3,14,7,9,71,52,19,49
Copenhagen,5870,4,13,7,10,59,45,14,46
AaB,5870,5,7,13,10,37,45,-8,34
AC Horsens,5870,6,6,13,11,35,56,-21,31
Sonderjyske,5870,7,8,6,10,28,29,-1,30
Randers FC,5870,8,6,6,12,25,40,-15,24
Silkeborg IF,5870,9,6,3,13,26,44,-18,21
Lyngby,5870,10,3,9,12,27,46,-19,18
AGF Aarhus,5870,11,4,6,12,16,37,-21,18
Brondby,5871,1,21,5,4,76,33,43,68
FC Midtjylla,5871,2,20,5,5,65,40,25,65
FC Nords,5871,3,15,6,9,76,54,22,51
Copenhagen,5871,4,14,4,12,57,50,7,46
AaB,5871,5,8,11,11,37,42,-5,35
AC Horsens,5871,6,6,13,11,35,53,-18,31
Sonderjyske,5871,7,8,6,10,28,29,-1,30
Silkeborg IF,5871,8,6,3,13,29,44,-15,21
Lyngby,5871,9,4,9,11,29,45,-16,21
Randers FC,5871,10,5,6,13,24,42,-18,21
AGF Aarhus,5871,11,4,6,12,16,40,-24,18
Brondby,5872,1,22,5,3,72,32,40,71
FC Midtjylla,5872,2,20,4,6,69,40,29,64
Copenhagen,5872,3,14,6,10,59,45,14,48
FC Nords,5872,4,12,8,10,76,58,18,44
AC Horsens,5872,5,7,13,10,38,53,-15,34
AaB,5872,6,7,12,11,35,47,-12,33
Sonderjyske,5872,7,8,6,10,28,29,-1,30
Randers FC,5872,8,5,7,12,23,39,-16,22
Silkeborg IF,5872,9,6,3,13,27,44,-17,21
Lyngby,5872,10,3,10,11,26,44,-18,19
AGF Aarhus,5872,11,4,6,12,16,38,-22,18
Brondby,5873,1,21,6,3,73,34,39,69
FC Midtjylla,5873,2,19,6,5,70,38,32,63
FC Nords,5873,3,14,8,8,74,51,23,50
Copenhagen,5873,4,14,4,12,56,44,12,46
AaB,5873,5,8,12,10,39,44,-5,36
Sonderjyske,5873,6,8,6,10,28,29,-1,30
AC Horsens,5873,7,6,12,12,33,60,-27,30
Lyngby,5873,8,4,9,11,28,45,-17,21
Randers FC,5873,9,5,6,13,24,41,-17,21
Silkeborg IF,5873,10,6,3,13,27,45,-18,21
AGF Aarhus,5873,11,4,6,12,17,38,-21,18
Brondby,5874,1,21,6,3,68,30,38,69
FC Midtjylla,5874,2,19,4,7,63,42,21,61
FC Nords,5874,3,16,6,8,71,47,24,54
Copenhagen,5874,4,15,5,10,62,43,19,50
AaB,5874,5,7,11,12,37,45,-8,32
Sonderjyske,5874,6,8,6,10,28,29,-1,30
AC Horsens,5874,7,6,12,12,34,54,-20,30
AGF Aarhus,5874,8,5,6,11,20,36,-16,21
Lyngby,5874,9,4,9,11,29,46,-17,21
Randers FC,5874,10,5,6,13,25,42,-17,21
Silkeborg IF,5874,11,5,3,14,25,48,-23,18
Brondby,5875,1,22,6,2,77,34,43,72
FC Midtjylla,5875,2,19,5,6,65,41,24,62
Copenhagen,5875,3,15,5,10,61,43,18,50
FC Nords,5875,4,14,6,10,78,55,23,48
AaB,5875,5,8,12,10,37,42,-5,36
Sonderjyske,5875,6,8,6,10,28,29,-1,30
AC Horsens,5875,7,5,12,13,32,61,-29,27
Randers FC,5875,8,6,6,12,24,39,-15,24
Silkeborg IF,5875,9,5,4,13,26,45,-19,19
AGF Aarhus,5875,10,4,7,11,17,37,-20,19
Lyngby,5875,11,3,9,12,26,45,-19,18
Brondby,5876,1,20,7,3,68,31,37,67
FC Midtjylla,5876,2,20,6,4,69,37,32,66
FC Nords,5876,3,15,6,9,76,52,24,51
Copenhagen,5876,4,13,6,11,56,46,10,45
AaB,5876,5,7,12,11,38,45,-7,33
AC Horsens,5876,6,6,13,11,35,57,-22,31
Sonderjyske,5876,7,8,6,10,28,29,-1,30
Randers FC,5876,8,5,7,12,24,40,-16,22
Lyngby,5876,9,3,10,11,27,45,-18,19
Silkeborg IF,5876,10,5,4,13,26,45,-19,19
AGF Aarhus,5876,11,4,7,11,17,37,-20,19
Brondby,5877,1,18,8,4,65,36,29,62
FC Midtjylla,5877,2,18,8,4,61,36,25,62
FC Nords,5877,3,15,8,7,73,46,27,53
Copenhagen,5877,4,15,5,10,60,45,15,50
AaB,5877,5,6,14,10,36,43,-7,32
AC Horsens,5877,6,6,13,11,38,53,-15,31
Sonderjyske,5877,7,8,6,10,28,29,-1,30
Lyngby,5877,8,4,9,11,29,45,-16,21
Randers FC,5877,9,5,6,13,24,42,-18,21
AGF Aarhus,5877,10,5,6,11,17,36,-19,21
Silkeborg IF,5877,11,5,3,14,25,45,-20,18
Brondby,5878,1,22,5,3,77,35,42,71
FC Midtjylla,5878,2,18,5,7,65,46,19,59
FC Nords,5878,3,15,7,8,78,53,25,52
Copenhagen,5878,4,15,5,10,62,47,15,50
AaB,5878,5,8,11,11,36,42,-6,35
Sonderjyske,5878,6,8,6,10,28,29,-1,30
AC Horsens,5878,7,5,13,12,34,55,-21,28
Randers FC,5878,8,5,7,12,23,39,-16,22
Silkeborg IF,5878,9,6,3,13,27,44,-17,21
Lyngby,5878,10,3,10,11,26,44,-18,19
AGF Aarhus,5878,11,4,6,12,16,38,-22,18
Brondby,5879,1,21,7,2,72,30,42,70
FC Midtjylla,5879,2,19,4,7,63,41,22,61
FC Nords,5879,3,15,6,9,76,51,25,51
Copenhagen,5879,4,14,6,10,56,44,12,48
AaB,5879,5,7,12,11,36,43,-7,33
AC Horsens,5879,6,6,13,11,35,55,-20,31
Sonderjyske,5879,7,8,6,10,28,29,-1,30
Randers FC,5879,8,5,7,12,24,40,-16,22
Lyngby,5879,9,3,10,11,27,45,-18,19
Silkeborg IF,5879,10,5,4,13,26,45,-19,19
AGF Aarhus,5879,11,4,7,11,17,37,-20,19
Brondby,5880,1,21,5,4,70,32,38,68
FC Midtjylla,5880,2,17,4,9,59,42,17,55
FC Nords,5880,3,15,6,9,72,53,19,51
Copenhagen,5880,4,14,6,10,60,46,14,48
AaB,5880,5,9,12,9,41,41,0,39
AC Horsens,5880,6,7,13,10,36,50,-14,34
Sonderjyske,5880,7,8,6,10,28,29,-1,30
Lyngby,5880,8,4,9,11,29,45,-16,21
Randers FC,5880,9,5,6,13,24,42,-18,21
Silkeborg IF,5880,10,5,4,13,26,45,-19,19
AGF Aarhus,5880,11,4,7,11,17,37,-20,19
Brondby,5881,1,21,5,4,69,33,36,68
FC Midtjylla,5881,2,20,4,6,65,39,26,64
FC Nords,5881,3,15,6,9,77,49,28,51
Copenhagen,5881,4,14,4,12,60,45,15,46
AaB,5881,5,10,11,9,39,41,-2,41
Sonderjyske,5881,6,8,6,10,28,29,-1,30
AC Horsens,5881,7,5,12,13,30,59,-29,27
Lyngby,5881,8,4,9,11,30,44,-14,21
Silkeborg IF,5881,9,6,3,13,28,44,-16,21
Randers FC,5881,10,5,6,13,23,43,-20,21
AGF Aarhus,5881,11,4,6,12,16,39,-23,18
Brondby,5882,1,19,9,2,66,30,36,66
FC Midtjylla,5882,2,18,6,6,68,43,25,60
Copenhagen,5882,3,14,6,10,62,48,14,48
FC Nords,5882,4,13,8,9,71,51,20,47
AaB,5882,5,9,13,8,43,43,0,40
Sonderjyske,5882,6,8,6,10,28,29,-1,30
AC Horsens,5882,7,5,14,11,32,53,-21,29
Lyngby,5882,8,4,9,11,27,44,-17,21
Randers FC,5882,9,5,6,13,23,40,-17,21
Silkeborg IF,5882,10,6,3,13,28,46,-18,21
AGF Aarhus,5882,11,4,6,12,18,39,-21,18
Brondby,5883,1,22,5,3,75,32,43,71
FC Midtjylla,5883,2,20,5,5,67,40,27,65
Copenhagen,5883,3,14,5,11,63,48,15,47
FC Nords,5883,4,12,7,11,68,61,7,43
AaB,5883,5,8,11,11,42,44,-2,35
AC Horsens,5883,6,7,13,10,37,53,-16,34
Sonderjyske,5883,7,8,6,10,28,29,-1,30
Lyngby,5883,8,4,9,11,29,45,-16,21
Silkeborg IF,5883,9,6,3,13,27,45,-18,21
Randers FC,5883,10,5,6,13,24,42,-18,21
AGF Aarhus,5883,11,4,6,12,17,38,-21,18
Brondby,5884,1,21,6,3,72,32,40,69
FC Midtjylla,5884,2,20,5,5,65,36,29,65
FC Nords,5884,3,16,6,8,77,50,27,54
Copenhagen,5884,4,12,5,13,56,47,9,41
AaB,5884,5,8,11,11,35,44,-9,35
AC Horsens,5884,6,6,13,11,34,56,-22,31
Sonderjyske,5884,7,8,6,10,28,29,-1,30
Lyngby,5884,8,4,9,11,27,44,-17,21
Silkeborg IF,5884,8,6,3,13,27,44,-17,21
Randers FC,5884,10,5,6,13,23,40,-17,21
AGF Aarhus,5884,11,4,6,12,16,38,-22,18
Brondby,5885,1,20,7,3,70,35,35,67
FC Midtjylla,5885,2,20,4,6,65,38,27,64
Copenhagen,5885,3,16,5,9,60,42,18,53
FC Nords,5885,4,15,6,9,72,49,23,51
AaB,5885,5,6,13,11,35,43,-8,31
Sonderjyske,5885,6,8,6,10,28,29,-1,30
AC Horsens,5885,7,5,13,12,31,52,-21,28
Lyngby,5885,8,4,9,11,27,44,-17,21
Randers FC,5885,9,5,6,13,23,40,-17,21
Silkeborg IF,5885,10,6,3,13,27,45,-18,21
AGF Aarhus,5885,11,4,6,12,17,38,-21,18
Brondby,5886,1,20,5,5,67,34,33,65
FC Midtjylla,5886,2,19,6,5,63,36,27,63
Copenhagen,5886,3,15,5,10,58,41,17,50
FC Nords,5886,4,12,7,11,68,54,14,43
AaB,5886,5,9,12,9,38,39,-1,39
AC Horsens,5886,6,7,13,10,35,51,-16,34
Sonderjyske,5886,7,8,6,10,28,29,-1,30
Lyngby,5886,8,4,9,11,27,44,-17,21
Randers FC,5886,9,5,6,13,23,40,-17,21
Silkeborg IF,5886,10,5,4,13,26,45,-19,19
AGF Aarhus,5886,11,4,7,11,17,37,-20,19
Brondby,5887,1,23,5,2,79,35,44,74
FC Midtjylla,5887,2,18,4,8,61,41,20,58
Copenhagen,5887,3,16,4,10,57,40,17,52
FC Nords,5887,4,12,6,12,66,57,9,42
AaB,5887,5,9,11,10,42,41,1,38
AC Horsens,5887,6,7,12,11,41,58,-17,33
Sonderjyske,5887,7,8,6,10,28,29,-1,30
Lyngby,5887,8,4,9,11,27,44,-17,21
Randers FC,5887,9,5,6,13,23,40,-17,21
Silkeborg IF,5887,10,6,3,13,26,44,-18,21
AGF Aarhus,5887,11,4,6,12,16,37,-21,18
Brondby,5888,1,21,7,2,75,33,42,70
FC Midtjylla,5888,2,18,7,5,62,39,23,61
FC Nords,5888,3,14,8,8,74,50,24,50
Copenhagen,5888,4,15,5,10,61,45,16,50
AC Horsens,5888,5,6,13,11,33,52,-19,31
Sonderjyske,5888,6,8,6,10,28,29,-1,30
AaB,5888,7,6,12,12,38,50,-12,30
Lyngby,5888,8,4,9,11,28,45,-17,21
Randers FC,5888,9,5,6,13,24,41,-17,21
AGF Aarhus,5888,10,5,6,11,17,36,-19,21
Silkeborg IF,5888,11,5,3,14,25,45,-20,18
FC Midtjylla,5889,1,22,4,4,68,36,32,70
Brondby,5889,2,21,5,4,71,34,37,68
FC Nords,5889,3,14,7,9,73,53,20,49
Copenhagen,5889,4,13,6,11,57,45,12,45
AC Horsens,5889,5,6,14,10,33,51,-18,32
Sonderjyske,5889,6,8,6,10,28,29,-1,30
AaB,5889,7,6,12,12,35,44,-9,30
Randers FC,5889,8,5,7,12,25,41,-16,22
Silkeborg IF,5889,9,6,3,13,27,45,-18,21
Lyngby,5889,10,3,10,11,28,46,-18,19
AGF Aarhus,5889,11,4,6,12,17,38,-21,18
Brondby,5890,1,20,7,3,69,33,36,67
FC Midtjylla,5890,2,18,5,7,60,41,19,59
FC Nords,5890,3,15,6,9,76,50,26,51
Copenhagen,5890,4,14,6,10,57,42,15,48
AaB,5890,5,8,12,10,37,41,-4,36
AC Horsens,5890,6,6,14,10,35,53,-18,32
Sonderjyske,5890,7,8,6,10,28,29,-1,30
Randers FC,5890,8,5,7,12,24,40,-16,22
Silkeborg IF,5890,9,6,3,13,27,45,-18,21
Lyngby,5890,10,3,10,11,27,45,-18,19
AGF Aarhus,5890,11,4,6,12,17,38,-21,18
Brondby,5891,1,20,6,4,67,31,36,66
FC Midtjylla,5891,2,19,5,6,61,37,24,62
FC Nords,5891,3,14,8,8,72,49,23,50
Copenhagen,5891,4,13,5,12,53,44,9,44
AC Horsens,5891,5,8,13,9,36,47,-11,37
AaB,5891,6,7,13,10,35,42,-7,34
Sonderjyske,5891,7,8,6,10,28,29,-1,30
Silkeborg IF,5891,8,6,3,13,28,44,-16,21
Lyngby,5891,9,4,9,11,28,45,-17,21
Randers FC,5891,10,5,6,13,24,41,-17,21
AGF Aarhus,5891,11,4,6,12,16,39,-23,18
Brondby,5892,1,20,7,3,73,33,40,67
FC Midtjylla,5892,2,19,4,7,64,41,23,61
FC Nords,5892,3,15,7,8,85,50,35,52
Copenhagen,5892,4,13,6,11,59,55,4,45
AC Horsens,5892,5,6,16,8,39,53,-14,34
AaB,5892,6,7,12,11,37,51,-14,33
Sonderjyske,5892,7,8,6,10,28,29,-1,30
Randers FC,5892,8,5,7,12,23,39,-16,22
Silkeborg IF,5892,9,6,3,13,26,44,-18,21
Lyngby,5892,10,3,10,11,26,44,-18,19
AGF Aarhus,5892,11,4,6,12,16,37,-21,18
Brondby,5893,1,22,5,3,71,32,39,71
FC Midtjylla,5893,2,19,5,6,68,42,26,62
Copenhagen,5893,3,16,4,10,62,44,18,52
FC Nords,5893,4,13,8,9,69,49,20,47
AaB,5893,5,8,12,10,38,43,-5,36
Sonderjyske,5893,6,8,6,10,28,29,-1,30
AC Horsens,5893,7,5,12,13,30,54,-24,27
Randers FC,5893,8,6,6,12,24,39,-15,24
Silkeborg IF,5893,9,6,3,13,27,45,-18,21
Lyngby,5893,10,3,9,12,26,45,-19,18
AGF Aarhus,5893,11,4,6,12,17,38,-21,18
FC Midtjylla,5894,1,20,5,5,69,39,30,65
Brondby,5894,2,19,6,5,69,37,32,63
FC Nords,5894,3,15,8,7,77,49,28,53
Copenhagen,5894,4,15,6,9,57,40,17,51
AaB,5894,5,7,12,11,35,45,-10,33
Sonderjyske,5894,6,8,6,10,28,29,-1,30
AC Horsens,5894,7,5,13,12,31,54,-23,28
Randers FC,5894,8,6,6,12,25,40,-15,24
Silkeborg IF,5894,9,6,3,13,26,44,-18,21
Lyngby,5894,10,3,9,12,27,46,-19,18
AGF Aarhus,5894,11,4,6,12,16,37,-21,18
Brondby,5895,1,22,5,3,75,33,42,71
FC Midtjylla,5895,2,19,4,7,70,44,26,61
Copenhagen,5895,3,15,5,10,56,44,12,50
FC Nords,5895,4,14,6,10,75,56,19,48
AaB,5895,5,8,12,10,38,39,-1,36
Sonderjyske,5895,6,8,6,10,28,29,-1,30
AC Horsens,5895,7,6,12,12,31,55,-24,30
Lyngby,5895,8,4,9,11,27,44,-17,21
Randers FC,5895,9,5,6,13,23,40,-17,21
AGF Aarhus,5895,10,5,6,11,19,37,-18,21
Silkeborg IF,5895,11,5,3,14,26,47,-21,18
Brondby,5896,1,21,7,2,73,32,41,70
FC Midtjylla,5896,2,18,5,7,64,41,23,59
FC Nords,5896,3,14,8,8,78,51,27,50
Copenhagen,5896,4,12,7,11,55,47,8,43
AaB,5896,5,8,13,9,39,44,-5,37
AC Horsens,5896,6,6,14,10,33,53,-20,32
Sonderjyske,5896,7,8,6,10,28,29,-1,30
Silkeborg IF,5896,8,6,3,13,29,44,-15,21
Lyngby,5896,9,4,9,11,28,45,-17,21
Randers FC,5896,10,5,6,13,24,41,-17,21
AGF Aarhus,5896,11,4,6,12,16,40,-24,18
Brondby,5897,1,22,5,3,76,34,42,71
FC Midtjylla,5897,2,19,4,7,68,44,24,61
Copenhagen,5897,3,15,5,10,56,42,14,50
FC Nords,5897,4,14,6,10,73,53,20,48
AaB,5897,5,8,12,10,37,43,-6,36
Sonderjyske,5897,6,8,6,10,28,29,-1,30
AC Horsens,5897,7,6,12,12,34,54,-20,30
Randers FC,5897,8,5,7,12,23,39,-16,22
Silkeborg IF,5897,9,6,3,13,29,45,-16,21
Lyngby,5897,10,3,10,11,26,44,-18,19
AGF Aarhus,5897,11,4,6,12,17,40,-23,18
Brondby,5898,1,21,5,4,71,34,37,68
FC Midtjylla,5898,2,20,5,5,69,40,29,65
FC Nords,5898,3,16,6,8,76,54,22,54
Copenhagen,5898,4,13,4,13,54,49,5,43
AaB,5898,5,7,13,10,39,40,-1,34
AC Horsens,5898,6,6,13,11,37,55,-18,31
Sonderjyske,5898,7,8,6,10,28,29,-1,30
Lyngby,5898,8,4,9,11,27,44,-17,21
Randers FC,5898,9,5,6,13,23,40,-17,21
AGF Aarhus,5898,10,5,6,11,17,36,-19,21
Silkeborg IF,5898,11,5,3,14,25,45,-20,18
FC Midtjylla,5899,1,21,5,4,70,33,37,68
Brondby,5899,2,19,8,3,66,30,36,65
FC Nords,5899,3,14,8,8,73,53,20,50
Copenhagen,5899,4,15,4,11,59,45,14,49
AaB,5899,5,6,14,10,35,41,-6,32
Sonderjyske,5899,6,8,6,10,28,29,-1,30
AC Horsens,5899,7,5,13,12,36,63,-27,28
Randers FC,5899,8,5,7,12,24,40,-16,22
AGF Aarhus,5899,9,5,6,11,18,36,-18,21
Lyngby,5899,10,3,10,11,27,45,-18,19
Silkeborg IF,5899,11,5,3,14,25,46,-21,18
Brondby,5900,1,21,7,2,69,29,40,70
FC Midtjylla,5900,2,18,5,7,59,38,21,59
FC Nords,5900,3,14,7,9,69,49,20,49
Copenhagen,5900,4,13,8,9,56,42,14,47
AaB,5900,5,8,12,10,40,44,-4,36
Sonderjyske,5900,6,8,6,10,28,29,-1,30
AC Horsens,5900,7,5,15,10,34,51,-17,30
Randers FC,5900,8,6,6,12,29,44,-15,24
AGF Aarhus,5900,9,5,6,11,19,36,-17,21
Lyngby,5900,10,3,9,12,31,50,-19,18
Silkeborg IF,5900,11,5,3,14,25,47,-22,18
Brondby,5901,1,21,5,4,75,35,40,68
FC Midtjylla,5901,2,20,5,5,69,40,29,65
FC Nords,5901,3,14,7,9,72,55,17,49
Copenhagen,5901,4,13,6,11,57,46,11,45
AaB,5901,5,8,11,11,39,45,-6,35
AC Horsens,5901,6,6,14,10,36,53,-17,32
Sonderjyske,5901,7,8,6,10,28,29,-1,30
Lyngby,5901,8,4,9,11,27,44,-17,21
Silkeborg IF,5901,8,6,3,13,27,44,-17,21
Randers FC,5901,10,5,6,13,23,40,-17,21
AGF Aarhus,5901,11,4,6,12,16,38,-22,18
Brondby,5902,1,21,6,3,69,35,34,69
FC Midtjylla,5902,2,19,5,6,63,40,23,62
Copenhagen,5902,3,16,4,10,62,42,20,52
FC Nords,5902,4,15,6,9,77,49,28,51
AaB,5902,5,7,11,12,36,46,-10,32
Sonderjyske,5902,6,8,6,10,28,29,-1,30
AC Horsens,5902,7,6,12,12,32,53,-21,30
Lyngby,5902,8,4,9,11,27,44,-17,21
Randers FC,5902,9,5,6,13,23,40,-17,21
Silkeborg IF,5902,10,6,3,13,26,44,-18,21
AGF Aarhus,5902,11,4,6,12,16,37,-21,18
FC Midtjylla,5903,1,21,4,5,69,38,31,67
Brondby,5903,2,20,6,4,70,37,33,66
FC Nords,5903,3,13,7,10,73,55,18,46
Copenhagen,5903,4,13,4,13,54,47,7,43
AaB,5903,5,10,11,9,45,44,1,41
AC Horsens,5903,6,6,14,10,41,57,-16,32
Sonderjyske,5903,7,8,6,10,28,29,-1,30
Randers FC,5903,8,6,6,12,25,39,-14,24
Silkeborg IF,5903,9,6,3,13,26,44,-18,21
Lyngby,5903,10,3,9,12,26,46,-20,18
AGF Aarhus,5903,11,4,6,12,16,37,-21,18
Brondby,5904,1,21,6,3,77,35,42,69
FC Midtjylla,5904,2,20,6,4,70,38,32,66
Copenhagen,5904,3,16,4,10,60,42,18,52
FC Nords,5904,4,13,6,11,70,59,11,45
AaB,5904,5,7,13,10,40,43,-3,34
Sonderjyske,5904,6,8,6,10,28,29,-1,30
AC Horsens,5904,7,5,13,12,32,58,-26,28
Randers FC,5904,8,6,6,12,25,40,-15,24
Silkeborg IF,5904,9,6,3,13,27,45,-18,21
Lyngby,5904,10,3,9,12,27,46,-19,18
AGF Aarhus,5904,11,4,6,12,17,38,-21,18
Brondby,5905,1,22,5,3,76,33,43,71
FC Midtjylla,5905,2,19,4,7,68,40,28,61
FC Nords,5905,3,14,6,10,73,55,18,48
Copenhagen,5905,4,14,5,11,58,47,11,47
AC Horsens,5905,5,8,12,10,37,53,-16,36
AaB,5905,6,7,12,11,35,45,-10,33
Sonderjyske,5905,7,8,6,10,28,29,-1,30
Lyngby,5905,8,4,9,11,31,46,-15,21
Randers FC,5905,9,5,6,13,25,44,-19,21
Silkeborg IF,5905,10,5,4,13,26,45,-19,19
AGF Aarhus,5905,11,4,7,11,17,37,-20,19
Brondby,5906,1,22,5,3,73,31,42,71
FC Midtjylla,5906,2,18,4,8,60,43,17,58
FC Nords,5906,3,14,7,9,73,49,24,49
Copenhagen,5906,4,15,4,11,57,43,14,49
AC Horsens,5906,5,8,13,9,35,47,-12,37
AaB,5906,6,7,11,12,35,46,-11,32
Sonderjyske,5906,7,8,6,10,28,29,-1,30
Randers FC,5906,8,5,7,12,23,39,-16,22
Lyngby,5906,9,3,10,11,26,44,-18,19
Silkeborg IF,5906,10,5,4,13,26,45,-19,19
AGF Aarhus,5906,11,4,7,11,17,37,-20,19
Brondby,5907,1,21,7,2,73,33,40,70
FC Midtjylla,5907,2,20,4,6,65,40,25,64
Copenhagen,5907,3,14,7,9,61,46,15,49
FC Nords,5907,4,13,9,8,74,53,21,48
Sonderjyske,5907,5,8,6,10,28,29,-1,30
AaB,5907,6,6,12,12,33,42,-9,30
AC Horsens,5907,7,5,15,10,37,55,-18,30
Randers FC,5907,8,5,7,12,24,40,-16,22
Silkeborg IF,5907,9,6,3,13,27,45,-18,21
Lyngby,5907,10,3,10,11,27,45,-18,19
AGF Aarhus,5907,11,4,6,12,17,38,-21,18
Brondby,5908,1,20,5,5,66,36,30,65
FC Midtjylla,5908,2,19,6,5,67,41,26,63
FC Nords,5908,3,15,7,8,77,53,24,52
Copenhagen,5908,4,14,4,12,63,45,18,46
AaB,5908,5,8,12,10,38,42,-4,36
AC Horsens,5908,6,7,12,11,36,56,-20,33
Sonderjyske,5908,7,8,6,10,28,29,-1,30
Randers FC,5908,8,6,6,12,25,39,-14,24
Silkeborg IF,5908,9,6,3,13,27,45,-18,21
Lyngby,5908,10,3,9,12,26,46,-20,18
AGF Aarhus,5908,11,4,6,12,17,38,-21,18
FC Midtjylla,5909,1,21,5,4,65,35,30,68
Brondby,5909,2,18,7,5,67,35,32,61
FC Nords,5909,3,14,8,8,74,49,25,50
Copenhagen,5909,4,12,6,12,52,46,6,42
AC Horsens,5909,5,8,13,9,37,50,-13,37
AaB,5909,6,6,15,9,37,43,-6,33
Sonderjyske,5909,7,8,6,10,28,29,-1,30
Lyngby,5909,8,4,9,11,28,44,-16,21
Silkeborg IF,5909,9,6,3,13,29,46,-17,21
Randers FC,5909,10,5,6,13,23,41,-18,21
AGF Aarhus,5909,11,4,6,12,18,40,-22,18
Brondby,5910,1,21,5,4,67,29,38,68
FC Midtjylla,5910,2,21,5,4,66,35,31,68
Copenhagen,5910,3,14,5,11,56,42,14,47
FC Nords,5910,4,12,9,9,69,52,17,45
AC Horsens,5910,5,7,13,10,35,51,-16,34
AaB,5910,6,6,13,11,34,44,-10,31
Sonderjyske,5910,7,8,6,10,28,29,-1,30
Randers FC,5910,8,5,7,12,24,40,-16,22
Lyngby,5910,9,3,10,11,27,45,-18,19
Silkeborg IF,5910,10,5,4,13,25,44,-19,19
AGF Aarhus,5910,11,4,7,11,16,36,-20,19
Brondby,5911,1,20,7,3,68,32,36,67
FC Midtjylla,5911,2,20,6,4,65,38,27,66
Copenhagen,5911,3,15,4,11,62,45,17,49
FC Nords,5911,4,13,9,8,70,49,21,48
AC Horsens,5911,5,7,12,11,38,53,-15,33
Sonderjyske,5911,6,8,6,10,28,29,-1,30
AaB,5911,7,6,12,12,36,48,-12,30
Randers FC,5911,8,6,6,12,25,40,-15,24
Silkeborg IF,5911,9,6,3,13,26,44,-18,21
Lyngby,5911,10,3,9,12,27,46,-19,18
AGF Aarhus,5911,11,4,6,12,16,37,-21,18
Brondby,5912,1,21,6,3,74,37,37,69
FC Midtjylla,5912,2,20,4,6,65,41,24,64
FC Nords,5912,3,14,9,7,74,49,25,51
Copenhagen,5912,4,14,4,12,61,46,15,46
AaB,5912,5,7,12,11,34,41,-7,33
AC Horsens,5912,6,6,13,11,33,53,-20,31
Sonderjyske,5912,7,8,6,10,28,29,-1,30
Randers FC,5912,8,5,7,12,24,40,-16,22
Lyngby,5912,9,3,10,11,27,45,-18,19
Silkeborg IF,5912,10,5,4,13,26,45,-19,19
AGF Aarhus,5912,11,4,7,11,17,37,-20,19
Brondby,5913,1,20,7,3,73,35,38,67
FC Midtjylla,5913,2,20,6,4,74,39,35,66
FC Nords,5913,3,13,7,10,73,59,14,46
Copenhagen,5913,4,12,4,14,57,52,5,40
AaB,5913,5,8,13,9,37,40,-3,37
AC Horsens,5913,6,8,13,9,42,57,-15,37
Sonderjyske,5913,7,8,6,10,28,29,-1,30
Randers FC,5913,8,5,7,12,26,42,-16,22
AGF Aarhus,5913,9,5,6,11,17,36,-19,21
Lyngby,5913,10,3,10,11,29,47,-18,19
Silkeborg IF,5913,11,5,3,14,25,45,-20,18
Brondby,5914,1,22,5,3,77,33,44,71
FC Midtjylla,5914,2,20,5,5,69,44,25,65
FC Nords,5914,3,14,6,10,74,54,20,48
Copenhagen,5914,4,12,5,13,56,52,4,41
AC Horsens,5914,5,8,12,10,43,56,-13,36
AaB,5914,6,8,11,11,39,45,-6,35
Sonderjyske,5914,7,8,6,10,28,29,-1,30
Lyngby,5914,8,4,9,11,28,45,-17,21
Randers FC,5914,9,5,6,13,24,41,-17,21
Silkeborg IF,5914,10,6,3,13,28,46,-18,21
AGF Aarhus,5914,11,4,6,12,18,39,-21,18
Brondby,5915,1,21,7,2,71,30,41,70
FC Midtjylla,5915,2,21,4,5,72,40,32,67
FC Nords,5915,3,14,6,10,72,53,19,48
Copenhagen,5915,4,12,6,12,54,47,7,42
AaB,5915,5,7,13,10,35,40,-5,34
AC Horsens,5915,6,7,12,11,38,58,-20,33
Sonderjyske,5915,7,8,6,10,28,29,-1,30
Randers FC,5915,8,5,7,12,25,41,-16,22
Silkeborg IF,5915,9,6,3,13,27,45,-18,21
Lyngby,5915,10,3,10,11,28,46,-18,19
AGF Aarhus,5915,11,4,6,12,17,38,-21,18
Brondby,5916,1,22,5,3,74,32,42,71
FC Midtjylla,5916,2,20,4,6,63,39,24,64
FC Nords,5916,3,15,6,9,75,52,23,51
Copenhagen,5916,4,15,4,11,60,45,15,49
AC Horsens,5916,5,7,12,11,36,54,-18,33
Sonderjyske,5916,6,8,6,10,28,29,-1,30
AaB,5916,7,6,11,13,36,48,-12,29
Randers FC,5916,8,5,7,12,23,39,-16,22
Silkeborg IF,5916,9,6,3,13,26,44,-18,21
Lyngby,5916,10,3,10,11,26,44,-18,19
AGF Aarhus,5916,11,4,6,12,16,37,-21,18
Brondby,5917,1,19,6,5,70,35,35,63
FC Midtjylla,5917,2,19,5,6,61,39,22,62
Copenhagen,5917,3,16,4,10,58,41,17,52
FC Nords,5917,4,13,7,10,74,58,16,46
AaB,5917,5,10,12,8,41,38,3,42
Sonderjyske,5917,6,8,6,10,28,29,-1,30
AC Horsens,5917,7,5,14,11,37,56,-19,29
Lyngby,5917,8,4,9,11,29,45,-16,21
Randers FC,5917,9,5,6,13,24,42,-18,21
AGF Aarhus,5917,10,5,6,11,17,36,-19,21
Silkeborg IF,5917,11,5,3,14,25,45,-20,18
Brondby,5918,1,20,5,5,70,37,33,65
FC Midtjylla,5918,2,20,4,6,63,38,25,64
Copenhagen,5918,3,16,4,10,62,41,21,52
FC Nords,5918,4,15,6,9,73,49,24,51
AC Horsens,5918,5,7,13,10,39,53,-14,34
Sonderjyske,5918,6,8,6,10,28,29,-1,30
AaB,5918,7,6,12,12,35,50,-15,30
Randers FC,5918,8,6,6,12,24,39,-15,24
Silkeborg IF,5918,9,6,3,13,26,44,-18,21
Lyngby,5918,10,3,9,12,26,45,-19,18
AGF Aarhus,5918,11,4,6,12,16,37,-21,18
Brondby,5919,1,20,7,3,70,33,37,67
FC Midtjylla,5919,2,19,5,6,65,39,26,62
FC Nords,5919,3,15,7,8,74,51,23,52
Copenhagen,5919,4,13,6,11,58,46,12,45
AaB,5919,5,7,13,10,33,40,-7,34
AC Horsens,5919,6,6,14,10,34,51,-17,32
Sonderjyske,5919,7,8,6,10,28,29,-1,30
Randers FC,5919,8,6,6,12,24,39,-15,24
Silkeborg IF,5919,9,5,4,13,26,45,-19,19
AGF Aarhus,5919,10,4,7,11,17,37,-20,19
Lyngby,5919,11,3,9,12,26,45,-19,18
Brondby,5920,1,21,6,3,68,31,37,69
FC Midtjylla,5920,2,20,6,4,65,37,28,66
FC Nords,5920,3,14,6,10,73,53,20,48
Copenhagen,5920,4,12,5,13,53,45,8,41
AC Horsens,5920,5,8,14,8,37,49,-12,38
AaB,5920,6,7,11,12,35,42,-7,32
Sonderjyske,5920,7,8,6,10,28,29,-1,30
Lyngby,5920,8,4,9,11,27,44,-17,21
Randers FC,5920,9,5,6,13,23,40,-17,21
Silkeborg IF,5920,10,5,4,13,25,44,-19,19
AGF Aarhus,5920,11,4,7,11,16,36,-20,19
Brondby,5921,1,21,6,3,68,29,39,69
FC Midtjylla,5921,2,18,5,7,64,44,20,59
FC Nords,5921,3,15,6,9,74,51,23,51
Copenhagen,5921,4,15,4,11,58,41,17,49
AaB,5921,5,8,12,10,36,42,-6,36
AC Horsens,5921,6,6,13,11,38,57,-19,31
Sonderjyske,5921,7,8,6,10,28,29,-1,30
Lyngby,5921,8,4,9,11,29,44,-15,21
Silkeborg IF,5921,9,6,3,13,26,44,-18,21
Randers FC,5921,10,5,6,13,23,42,-19,21
AGF Aarhus,5921,11,4,6,12,16,37,-21,18
Brondby,5922,1,22,5,3,78,30,48,71
FC Midtjylla,5922,2,21,4,5,70,40,30,67
Copenhagen,5922,3,15,4,11,59,50,9,49
FC Nords,5922,4,14,6,10,78,59,19,48
AC Horsens,5922,5,6,13,11,33,53,-20,31
Sonderjyske,5922,6,8,6,10,28,29,-1,30
AaB,5922,7,6,12,12,32,44,-12,30
Silkeborg IF,5922,8,6,3,13,29,44,-15,21
Lyngby,5922,9,4,9,11,28,44,-16,21
Randers FC,5922,10,5,6,13,23,41,-18,21
AGF Aarhus,5922,11,4,6,12,16,40,-24,18
Brondby,5923,1,22,5,3,72,31,41,71
FC Midtjylla,5923,2,19,4,7,60,37,23,61
FC Nords,5923,3,15,7,8,72,49,23,52
Copenhagen,5923,4,13,4,13,56,48,8,43
AaB,5923,5,9,11,10,39,41,-2,38
AC Horsens,5923,6,6,13,11,33,52,-19,31
Sonderjyske,5923,7,8,6,10,28,29,-1,30
Lyngby,5923,8,4,9,11,33,48,-15,21
Silkeborg IF,5923,9,6,3,13,29,44,-15,21
Randers FC,5923,10,5,6,13,27,46,-19,21
AGF Aarhus,5923,11,4,6,12,16,40,-24,18
Brondby,5924,1,21,5,4,75,33,42,68
FC Midtjylla,5924,2,21,5,4,67,38,29,68
FC Nords,5924,3,15,6,9,79,54,25,51
Copenhagen,5924,4,14,5,11,61,48,13,47
AC Horsens,5924,5,6,13,11,34,56,-22,31
Sonderjyske,5924,6,8,6,10,28,29,-1,30
AaB,5924,7,6,12,12,33,46,-13,30
Randers FC,5924,8,5,7,12,23,39,-16,22
Silkeborg IF,5924,9,6,3,13,27,45,-18,21
Lyngby,5924,10,3,10,11,26,44,-18,19
AGF Aarhus,5924,11,4,6,12,17,38,-21,18
Brondby,5925,1,21,6,3,68,31,37,69
FC Midtjylla,5925,2,20,5,5,64,36,28,65
FC Nords,5925,3,13,7,10,68,49,19,46
Copenhagen,5925,4,13,4,13,55,45,10,43
AaB,5925,5,8,12,10,34,38,-4,36
AC Horsens,5925,6,8,12,10,35,51,-16,36
Sonderjyske,5925,7,8,6,10,28,29,-1,30
Lyngby,5925,8,4,9,11,28,44,-16,21
Randers FC,5925,9,5,6,13,23,41,-18,21
AGF Aarhus,5925,10,5,6,11,17,36,-19,21
Silkeborg IF,5925,11,5,3,14,25,45,-20,18
Brondby,5926,1,20,7,3,75,36,39,67
FC Midtjylla,5926,2,20,4,6,65,41,24,64
FC Nords,5926,3,14,7,9,71,52,19,49
Copenhagen,5926,4,14,5,11,59,45,14,47
AaB,5926,5,8,11,11,41,45,-4,35
AC Horsens,5926,6,6,14,10,36,54,-18,32
Sonderjyske,5926,7,8,6,10,28,29,-1,30
Randers FC,5926,8,5,7,12,24,40,-16,22
AGF Aarhus,5926,9,5,6,11,18,37,-19,21
Lyngby,5926,10,3,10,11,27,45,-18,19
Silkeborg IF,5926,11,5,3,14,26,46,-20,18
Brondby,5927,1,22,6,2,76,30,46,72
FC Midtjylla,5927,2,18,7,5,68,38,30,61
FC Nords,5927,3,14,6,10,69,55,14,48
Copenhagen,5927,4,14,4,12,56,45,11,46
AaB,5927,5,8,12,10,36,45,-9,36
AC Horsens,5927,6,6,13,11,34,52,-18,31
Sonderjyske,5927,7,8,6,10,28,29,-1,30
Lyngby,5927,8,4,9,11,29,44,-15,21
Silkeborg IF,5927,9,6,3,13,29,45,-16,21
Randers FC,5927,10,5,6,13,23,42,-19,21
AGF Aarhus,5927,11,4,6,12,17,40,-23,18
Brondby,5928,1,22,6,2,74,30,44,72
FC Midtjylla,5928,2,18,7,5,60,37,23,61
FC Nords,5928,3,14,9,7,73,49,24,51
Copenhagen,5928,4,12,6,12,53,44,9,42
AaB,5928,5,7,13,10,35,42,-7,34
AC Horsens,5928,6,6,13,11,34,53,-19,31
Sonderjyske,5928,7,8,6,10,28,29,-1,30
Lyngby,5928,8,4,9,11,31,45,-14,21
AGF Aarhus,5928,9,5,6,11,18,37,-19,21
Randers FC,5928,10,5,6,13,24,44,-20,21
Silkeborg IF,5928,11,5,3,14,26,46,-20,18
Brondby,5929,1,20,6,4,73,34,39,66
FC Midtjylla,5929,2,19,5,6,66,40,26,62
FC Nords,5929,3,15,8,7,76,49,27,53
Copenhagen,5929,4,13,6,11,56,50,6,45
AaB,5929,5,8,13,9,35,38,-3,37
Sonderjyske,5929,6,8,6,10,28,29,-1,30
AC Horsens,5929,7,5,14,11,36,57,-21,29
Lyngby,5929,8,4,9,11,28,45,-17,21
Silkeborg IF,5929,9,6,3,13,27,44,-17,21
Randers FC,5929,10,5,6,13,24,41,-17,21
AGF Aarhus,5929,11,4,6,12,16,38,-22,18
Brondby,5930,1,21,6,3,70,33,37,69
FC Midtjylla,5930,2,21,4,5,68,40,28,67
FC Nords,5930,3,13,8,9,73,54,19,47
Copenhagen,5930,4,13,6,11,60,49,11,45
AaB,5930,5,7,12,11,34,40,-6,33
AC Horsens,5930,6,6,14,10,38,53,-15,32
Sonderjyske,5930,7,8,6,10,28,29,-1,30
Lyngby,5930,8,4,9,11,27,44,-17,21
Randers FC,5930,9,5,6,13,23,40,-17,21
Silkeborg IF,5930,10,5,4,13,26,45,-19,19
AGF Aarhus,5930,11,4,7,11,17,37,-20,19
Brondby,5931,1,21,7,2,71,29,42,70
FC Midtjylla,5931,2,18,7,5,65,41,24,61
FC Nords,5931,3,15,7,8,82,54,28,52
Copenhagen,5931,4,13,6,11,61,49,12,45
AaB,5931,5,6,14,10,39,47,-8,32
AC Horsens,5931,6,6,13,11,37,61,-24,31
Sonderjyske,5931,7,8,6,10,28,29,-1,30
Randers FC,5931,8,6,6,12,25,39,-14,24
Silkeborg IF,5931,9,6,3,13,26,44,-18,21
Lyngby,5931,10,3,9,12,26,46,-20,18
AGF Aarhus,5931,11,4,6,12,16,37,-21,18
Brondby,5932,1,19,7,4,69,35,34,64
FC Midtjylla,5932,2,20,4,6,67,40,27,64
Copenhagen,5932,3,14,7,9,59,41,18,49
FC Nords,5932,4,12,9,9,74,55,19,45
AaB,5932,5,8,13,9,36,40,-4,37
AC Horsens,5932,6,7,12,11,36,56,-20,33
Sonderjyske,5932,7,8,6,10,28,29,-1,30
Randers FC,5932,8,5,7,12,23,39,-16,22
Lyngby,5932,9,3,10,11,26,44,-18,19
Silkeborg IF,5932,10,5,4,13,28,47,-19,19
AGF Aarhus,5932,11,4,7,11,19,39,-20,19
Brondby,5933,1,22,5,3,74,31,43,71
FC Midtjylla,5933,2,20,4,6,65,42,23,64
FC Nords,5933,3,14,6,10,74,53,21,48
Copenhagen,5933,4,13,5,12,57,47,10,44
AaB,5933,5,9,11,10,40,43,-3,38
AC Horsens,5933,6,6,13,11,31,51,-20,31
Sonderjyske,5933,7,8,6,10,28,29,-1,30
Lyngby,5933,8,4,9,11,28,44,-16,21
Randers FC,5933,9,5,6,13,23,41,-18,21
AGF Aarhus,5933,10,5,6,11,19,37,-18,21
Silkeborg IF,5933,11,5,3,14,26,47,-21,18
Brondby,5934,1,19,9,2,68,31,37,66
FC Midtjylla,5934,2,20,5,5,63,35,28,65
FC Nords,5934,3,14,8,8,72,49,23,50
Copenhagen,5934,4,14,5,11,55,43,12,47
AaB,5934,5,6,14,10,34,40,-6,32
AC Horsens,5934,6,6,13,11,33,53,-20,31
Sonderjyske,5934,7,8,6,10,28,29,-1,30
Lyngby,5934,8,4,9,11,32,46,-14,21
Randers FC,5934,9,5,6,13,25,45,-20,21
Silkeborg IF,5934,10,5,4,13,25,44,-19,19
AGF Aarhus,5934,11,4,7,11,16,36,-20,19
Brondby,5935,1,22,5,3,78,32,46,71
FC Midtjylla,5935,2,20,4,6,68,46,22,64
FC Nords,5935,3,14,7,9,76,55,21,49
Copenhagen,5935,4,14,4,12,61,52,9,46
AC Horsens,5935,5,8,12,10,42,54,-12,36
Sonderjyske,5935,6,8,6,10,28,29,-1,30
AaB,5935,7,6,12,12,35,47,-12,30
Lyngby,5935,8,4,9,11,28,44,-16,21
Randers FC,5935,9,5,6,13,23,41,-18,21
AGF Aarhus,5935,10,5,6,11,18,36,-18,21
Silkeborg IF,5935,11,5,3,14,25,46,-21,18
Brondby,5936,1,23,5,2,78,36,42,74
FC Midtjylla,5936,2,21,4,5,67,38,29,67
FC Nords,5936,3,15,6,9,71,48,23,51
Copenhagen,5936,4,13,5,12,57,49,8,44
Sonderjyske,5936,5,8,6,10,28,29,-1,30
AaB,5936,6,6,12,12,37,49,-12,30
AC Horsens,5936,7,6,12,12,37,53,-16,30
Lyngby,5936,8,4,9,11,28,45,-17,21
Randers FC,5936,9,5,6,13,24,41,-17,21
Silkeborg IF,5936,10,5,4,13,26,45,-19,19
AGF Aarhus,5936,11,4,7,11,17,37,-20,19
FC Midtjylla,5937,1,20,4,6,66,38,28,64
Brondby,5937,2,18,7,5,66,34,32,61
FC Nords,5937,3,14,7,9,75,54,21,49
AaB,5937,4,11,11,8,42,40,2,44
Copenhagen,5937,5,13,4,13,57,50,7,43
AC Horsens,5937,6,7,13,10,36,52,-16,34
Sonderjyske,5937,7,8,6,10,28,29,-1,30
Randers FC,5937,8,6,6,12,26,39,-13,24
Silkeborg IF,5937,9,5,4,13,26,45,-19,19
AGF Aarhus,5937,10,4,7,11,17,37,-20,19
Lyngby,5937,11,3,9,12,26,47,-21,18
Brondby,5938,1,22,6,2,70,29,41,72
FC Midtjylla,5938,2,20,5,5,64,39,25,65
FC Nords,5938,3,15,6,9,73,50,23,51
Copenhagen,5938,4,13,4,13,56,45,11,43
AC Horsens,5938,5,7,12,11,35,53,-18,33
AaB,5938,6,7,11,12,37,45,-8,32
Sonderjyske,5938,7,8,6,10,28,29,-1,30
Lyngby,5938,8,4,9,11,27,44,-17,21
Randers FC,5938,9,5,6,13,23,40,-17,21
Silkeborg IF,5938,10,5,4,13,26,45,-19,19
AGF Aarhus,5938,11,4,7,11,17,37,-20,19
Brondby,5939,1,20,7,3,68,33,35,67
FC Midtjylla,5939,2,19,5,6,62,39,23,62
FC Nords,5939,3,14,7,9,76,52,24,49
Copenhagen,5939,4,14,6,10,60,47,13,48
AaB,5939,5,8,12,10,40,43,-3,36
AC Horsens,5939,6,6,13,11,36,54,-18,31
Sonderjyske,5939,7,8,6,10,28,29,-1,30
Randers FC,5939,8,6,6,12,25,39,-14,24
Silkeborg IF,5939,9,6,3,13,26,44,-18,21
Lyngby,5939,10,3,9,12,26,46,-20,18
AGF Aarhus,5939,11,4,6,12,16,37,-21,18
Brondby,5940,1,20,7,3,72,34,38,67
FC Midtjylla,5940,2,21,4,5,70,37,33,67
FC Nords,5940,3,16,6,8,74,46,28,54
Copenhagen,5940,4,13,5,12,58,51,7,44
AaB,5940,5,8,11,11,35,45,-10,35
Sonderjyske,5940,6,8,6,10,28,29,-1,30
AC Horsens,5940,7,5,13,12,35,57,-22,28
Lyngby,5940,8,4,9,11,30,47,-17,21
Randers FC,5940,9,5,6,13,26,43,-17,21
AGF Aarhus,5940,10,5,6,11,18,36,-18,21
Silkeborg IF,5940,11,5,3,14,25,46,-21,18
Brondby,5941,1,19,7,4,67,34,33,64
FC Midtjylla,5941,2,18,7,5,63,39,24,61
Copenhagen,5941,3,16,4,10,57,40,17,52
FC Nords,5941,4,14,7,9,73,51,22,49
AC Horsens,5941,5,7,13,10,34,49,-15,34
AaB,5941,6,7,12,11,35,42,-7,33
Sonderjyske,5941,7,8,6,10,28,29,-1,30
Randers FC,5941,8,5,7,12,23,39,-16,22
Lyngby,5941,9,3,10,11,26,44,-18,19
Silkeborg IF,5941,10,5,4,13,27,46,-19,19
AGF Aarhus,5941,11,4,7,11,18,38,-20,19
Brondby,5942,1,22,6,2,76,32,44,72
FC Midtjylla,5942,2,19,5,6,65,41,24,62
FC Nords,5942,3,15,6,9,72,51,21,51
Copenhagen,5942,4,15,5,10,61,44,17,50
AaB,5942,5,7,12,11,36,42,-6,33
Sonderjyske,5942,6,8,6,10,28,29,-1,30
AC Horsens,5942,7,5,12,13,32,58,-26,27
Randers FC,5942,8,6,6,12,24,39,-15,24
Silkeborg IF,5942,9,5,4,13,27,46,-19,19
AGF Aarhus,5942,10,4,7,11,18,38,-20,19
Lyngby,5942,11,3,9,12,26,45,-19,18
Brondby,5943,1,21,6,3,71,34,37,69
FC Midtjylla,5943,2,17,7,6,62,40,22,58
FC Nords,5943,3,13,9,8,75,53,22,48
Copenhagen,5943,4,14,5,11,59,48,11,47
AaB,5943,5,7,14,9,36,40,-4,35
AC Horsens,5943,6,7,13,10,37,51,-14,34
Sonderjyske,5943,7,8,6,10,28,29,-1,30
Lyngby,5943,8,4,9,11,29,46,-17,21
Randers FC,5943,9,5,6,13,25,42,-17,21
Silkeborg IF,5943,10,5,4,13,26,45,-19,19
AGF Aarhus,5943,11,4,7,11,17,37,-20,19
Brondby,5944,1,20,7,3,66,29,37,67
FC Midtjylla,5944,2,20,6,4,70,39,31,66
FC Nords,5944,3,14,7,9,75,55,20,49
Copenhagen,5944,4,13,5,12,54,44,10,44
AaB,5944,5,9,11,10,34,39,-5,38
Sonderjyske,5944,6,8,6,10,28,29,-1,30
AC Horsens,5944,7,6,12,12,32,51,-19,30
Randers FC,5944,8,6,6,12,25,40,-15,24
Silkeborg IF,5944,9,6,3,13,28,44,-16,21
Lyngby,5944,10,3,9,12,27,46,-19,18
AGF Aarhus,5944,11,4,6,12,16,39,-23,18
Brondby,5945,1,22,5,3,71,31,40,71
FC Midtjylla,5945,2,21,4,5,69,36,33,67
FC Nords,5945,3,15,6,9,76,52,24,51
Copenhagen,5945,4,15,4,11,58,46,12,49
Sonderjyske,5945,5,8,6,10,28,29,-1,30
AC Horsens,5945,6,6,12,12,32,54,-22,30
AaB,5945,7,6,11,13,34,47,-13,29
Randers FC,5945,8,5,7,12,23,39,-16,22
Lyngby,5945,9,3,10,11,26,44,-18,19
Silkeborg IF,5945,10,5,4,13,26,45,-19,19
AGF Aarhus,5945,11,4,7,11,17,37,-20,19
Brondby,5946,1,19,8,3,67,32,35,65
FC Midtjylla,5946,2,18,6,6,61,38,23,60
Copenhagen,5946,3,15,5,10,62,43,19,50
FC Nords,5946,4,13,10,7,71,49,22,49
AC Horsens,5946,5,7,13,10,36,53,-17,34
AaB,5946,6,6,14,10,33,41,-8,32
Sonderjyske,5946,7,8,6,10,28,29,-1,30
Randers FC,5946,8,6,6,12,25,40,-15,24
Silkeborg IF,5946,9,5,4,13,26,45,-19,19
AGF Aarhus,5946,10,4,7,11,17,37,-20,19
Lyngby,5946,11,3,9,12,27,46,-19,18
Brondby,5947,1,22,6,2,69,29,40,72
FC Midtjylla,5947,2,18,6,6,64,41,23,60
FC Nords,5947,3,14,7,9,77,53,24,49
Copenhagen,5947,4,12,6,12,52,45,7,42
AaB,5947,5,9,12,9,41,42,-1,39
AC Horsens,5947,6,6,13,11,32,51,-19,31
Sonderjyske,5947,7,8,6,10,28,29,-1,30
Lyngby,5947,8,4,9,11,29,46,-17,21
Randers FC,5947,9,5,6,13,25,42,-17,21
AGF Aarhus,5947,10,5,6,11,19,36,-17,21
Silkeborg IF,5947,11,5,3,14,25,47,-22,18
Brondby,5948,1,20,7,3,72,33,39,67
FC Midtjylla,5948,2,18,7,5,69,44,25,61
FC Nords,5948,3,15,6,9,71,50,21,51
Copenhagen,5948,4,13,6,11,59,48,11,45
AaB,5948,5,8,11,11,36,41,-5,35
AC Horsens,5948,6,7,13,10,36,53,-17,34
Sonderjyske,5948,7,8,6,10,28,29,-1,30
Lyngby,5948,8,4,9,11,29,44,-15,21
AGF Aarhus,5948,9,5,6,11,18,36,-18,21
Randers FC,5948,10,5,6,13,23,42,-19,21
Silkeborg IF,5948,11,5,3,14,25,46,-21,18
Brondby,5949,1,20,8,2,70,32,38,68
FC Midtjylla,5949,2,19,6,5,67,38,29,63
FC Nords,5949,3,15,8,7,72,47,25,53
Copenhagen,5949,4,13,6,11,56,44,12,45
AaB,5949,5,7,13,10,38,44,-6,34
Sonderjyske,5949,6,8,6,10,28,29,-1,30
AC Horsens,5949,7,5,13,12,31,55,-24,28
Lyngby,5949,8,4,9,11,29,46,-17,21
Randers FC,5949,9,5,6,13,25,42,-17,21
AGF Aarhus,5949,10,5,6,11,18,36,-18,21
Silkeborg IF,5949,11,5,3,14,25,46,-21,18
Brondby,5950,1,21,6,3,67,33,34,69
FC Midtjylla,5950,2,19,5,6,62,38,24,62
FC Nords,5950,3,15,6,9,74,49,25,51
Copenhagen,5950,4,14,5,11,57,44,13,47
AaB,5950,5,7,13,10,35,40,-5,34
AC Horsens,5950,6,6,13,11,36,53,-17,31
Sonderjyske,5950,7,8,6,10,28,29,-1,30
Lyngby,5950,8,4,9,11,28,45,-17,21
Randers FC,5950,9,5,6,13,24,41,-17,21
Silkeborg IF,5950,10,5,4,13,25,44,-19,19
AGF Aarhus,5950,11,4,7,11,16,36,-20,19
Brondby,5951,1,22,5,3,72,31,41,71
FC Midtjylla,5951,2,18,5,7,62,44,18,59
Copenhagen,5951,3,16,4,10,59,40,19,52
FC Nords,5951,4,13,7,10,73,54,19,46
AaB,5951,5,8,12,10,39,46,-7,36
AC Horsens,5951,6,6,13,11,38,54,-16,31
Sonderjyske,5951,7,8,6,10,28,29,-1,30
Randers FC,5951,8,5,7,12,26,42,-16,22
Silkeborg IF,5951,9,6,3,13,26,44,-18,21
Lyngby,5951,10,3,10,11,29,47,-18,19
AGF Aarhus,5951,11,4,6,12,16,37,-21,18
Brondby,5952,1,20,7,3,75,38,37,67
FC Midtjylla,5952,2,20,5,5,70,37,33,65
FC Nords,5952,3,14,7,9,77,56,21,49
Copenhagen,5952,4,14,5,11,59,47,12,47
AaB,5952,5,7,13,10,38,43,-5,34
AC Horsens,5952,6,6,13,11,34,58,-24,31
Sonderjyske,5952,7,8,6,10,28,29,-1,30
Lyngby,5952,8,4,9,11,27,44,-17,21
Randers FC,5952,9,5,6,13,23,40,-17,21
AGF Aarhus,5952,10,5,6,11,18,37,-19,21
Silkeborg IF,5952,11,5,3,14,26,46,-20,18
Brondby,5953,1,22,5,3,74,29,45,71
FC Midtjylla,5953,2,19,5,6,65,41,24,62
FC Nords,5953,3,13,7,10,67,50,17,46
Copenhagen,5953,4,12,6,12,55,46,9,42
AaB,5953,5,10,11,9,40,41,-1,41
AC Horsens,5953,6,6,14,10,34,54,-20,32
Sonderjyske,5953,7,8,6,10,28,29,-1,30
Randers FC,5953,8,5,7,12,23,39,-16,22
Silkeborg IF,5953,9,6,3,13,29,45,-16,21
Lyngby,5953,10,3,10,11,26,44,-18,19
AGF Aarhus,5953,11,4,6,12,17,40,-23,18
FC Midtjylla,5954,1,19,7,4,67,38,29,64
Brondby,5954,2,18,7,5,65,35,30,61
FC Nords,5954,3,15,8,7,74,48,26,53
Copenhagen,5954,4,14,5,11,57,45,12,47
AaB,5954,5,8,11,11,38,43,-5,35
AC Horsens,5954,6,6,14,10,35,53,-18,32
Sonderjyske,5954,7,8,6,10,28,29,-1,30
Randers FC,5954,8,5,7,12,24,40,-16,22
Silkeborg IF,5954,9,6,3,13,27,45,-18,21
Lyngby,5954,10,3,10,11,27,45,-18,19
AGF Aarhus,5954,11,4,6,12,17,38,-21,18
Brondby,5955,1,20,6,4,70,31,39,66
FC Midtjylla,5955,2,20,6,4,67,36,31,66
FC Nords,5955,3,13,7,10,70,52,18,46
Copenhagen,5955,4,12,6,12,60,52,8,42
AaB,5955,5,9,11,10,40,46,-6,38
AC Horsens,5955,6,8,12,10,41,57,-16,36
Sonderjyske,5955,7,8,6,10,28,29,-1,30
Randers FC,5955,8,6,6,12,26,39,-13,24
Silkeborg IF,5955,9,5,4,13,27,46,-19,19
AGF Aarhus,5955,10,4,7,11,18,38,-20,19
Lyngby,5955,11,3,9,12,26,47,-21,18
FC Midtjylla,5956,1,21,4,5,69,38,31,67
Brondby,5956,2,19,8,3,66,33,33,65
FC Nords,5956,3,14,8,8,74,50,24,50
Copenhagen,5956,4,12,8,10,54,42,12,44
AC Horsens,5956,5,6,15,9,33,51,-18,33
AaB,5956,6,6,13,11,35,43,-8,31
Sonderjyske,5956,7,8,6,10,28,29,-1,30
Lyngby,5956,8,4,9,11,29,44,-15,21
Silkeborg IF,5956,9,6,3,13,28,45,-17,21
Randers FC,5956,10,5,6,13,23,42,-19,21
AGF Aarhus,5956,11,4,6,12,17,39,-22,18
Brondby,5957,1,20,5,5,71,34,37,65
FC Midtjylla,5957,2,18,6,6,62,41,21,60
FC Nords,5957,3,16,7,7,78,51,27,55
Copenhagen,5957,4,14,4,12,56,45,11,46
AaB,5957,5,8,13,9,37,42,-5,37
AC Horsens,5957,6,6,13,11,35,52,-17,31
Sonderjyske,5957,7,8,6,10,28,29,-1,30
Randers FC,5957,8,6,6,12,24,39,-15,24
Silkeborg IF,5957,9,5,4,13,26,45,-19,19
AGF Aarhus,5957,10,4,7,11,17,37,-20,19
Lyngby,5957,11,3,9,12,26,45,-19,18
Brondby,5958,1,19,9,2,71,32,39,66
FC Midtjylla,5958,2,19,4,7,67,46,21,61
FC Nords,5958,3,13,8,9,76,55,21,47
Copenhagen,5958,4,12,7,11,57,48,9,43
AaB,5958,5,8,13,9,34,39,-5,37
AC Horsens,5958,6,8,13,9,41,52,-11,37
Sonderjyske,5958,7,8,6,10,28,29,-1,30
Lyngby,5958,8,4,9,11,28,44,-16,21
Randers FC,5958,9,5,6,13,23,41,-18,21
AGF Aarhus,5958,10,5,6,11,19,37,-18,21
Silkeborg IF,5958,11,5,3,14,26,47,-21,18
Brondby,5959,1,20,5,5,68,34,34,65
FC Midtjylla,5959,2,20,4,6,70,39,31,64
FC Nords,5959,3,15,6,9,73,52,21,51
Copenhagen,5959,4,15,5,10,61,44,17,50
AaB,5959,5,9,12,9,38,42,-4,39
Sonderjyske,5959,6,8,6,10,28,29,-1,30
AC Horsens,5959,7,5,12,13,31,56,-25,27
Randers FC,5959,8,6,6,12,25,40,-15,24
AGF Aarhus,5959,9,5,6,11,18,37,-19,21
Lyngby,5959,10,3,9,12,27,46,-19,18
Silkeborg IF,5959,11,5,3,14,26,46,-20,18
Brondby,5960,1,21,6,3,73,34,39,69
FC Midtjylla,5960,2,20,5,5,67,34,33,65
FC Nords,5960,3,14,7,9,73,55,18,49
Copenhagen,5960,4,14,5,11,63,53,10,47
AaB,5960,5,7,11,12,41,51,-10,32
AC Horsens,5960,6,6,14,10,35,51,-16,32
Sonderjyske,5960,7,8,6,10,28,29,-1,30
Randers FC,5960,8,5,7,12,26,42,-16,22
Silkeborg IF,5960,9,6,3,13,27,45,-18,21
Lyngby,5960,10,3,10,11,29,47,-18,19
AGF Aarhus,5960,11,4,6,12,17,38,-21,18
Brondby,5961,1,22,6,2,77,33,44,72
FC Midtjylla,5961,2,19,5,6,68,44,24,62
FC Nords,5961,3,16,7,7,81,48,33,55
Copenhagen,5961,4,13,5,12,55,51,4,44
AaB,5961,5,8,11,11,41,43,-2,35
Sonderjyske,5961,6,8,6,10,28,29,-1,30
AC Horsens,5961,7,5,12,13,32,61,-29,27
Randers FC,5961,8,6,6,12,25,40,-15,24
Silkeborg IF,5961,9,6,3,13,28,46,-18,21
Lyngby,5961,10,3,9,12,27,46,-19,18
AGF Aarhus,5961,11,4,6,12,18,39,-21,18
Brondby,5962,1,21,6,3,72,33,39,69
FC Midtjylla,5962,2,20,4,6,70,38,32,64
FC Nords,5962,3,15,7,8,75,54,21,52
Copenhagen,5962,4,14,4,12,56,43,13,46
AC Horsens,5962,5,7,12,11,38,55,-17,33
AaB,5962,6,7,11,12,37,51,-14,32
Sonderjyske,5962,7,8,6,10,28,29,-1,30
Randers FC,5962,8,6,6,12,26,39,-13,24
AGF Aarhus,5962,9,5,6,11,19,37,-18,21
Lyngby,5962,10,3,9,12,26,47,-21,18
Silkeborg IF,5962,10,5,3,14,26,47,-21,18
Brondby,5963,1,20,6,4,67,34,33,66
FC Midtjylla,5963,2,19,5,6,66,43,23,62
FC Nords,5963,3,14,7,9,72,49,23,49
Copenhagen,5963,4,13,6,11,57,45,12,45
AaB,5963,5,8,13,9,40,42,-2,37
AC Horsens,5963,6,6,15,9,32,47,-15,33
Sonderjyske,5963,7,8,6,10,28,29,-1,30
Randers FC,5963,8,6,6,12,27,39,-12,24
Silkeborg IF,5963,9,6,3,13,27,45,-18,21
AGF Aarhus,5963,10,4,6,12,17,38,-21,18
Lyngby,5963,11,3,9,12,26,48,-22,18
Brondby,5964,1,21,6,3,71,35,36,69
FC Midtjylla,5964,2,18,7,5,63,35,28,61
FC Nords,5964,3,16,6,8,75,48,27,54
Copenhagen,5964,4,13,6,11,57,45,12,45
AaB,5964,5,8,12,10,37,40,-3,36
Sonderjyske,5964,6,8,6,10,28,29,-1,30
AC Horsens,5964,7,5,13,12,31,57,-26,28
Lyngby,5964,8,4,9,11,28,44,-16,21
Randers FC,5964,9,5,6,13,23,41,-18,21
AGF Aarhus,5964,10,5,6,11,17,36,-19,21
Silkeborg IF,5964,11,5,3,14,25,45,-20,18
Brondby,5965,1,21,7,2,80,36,44,70
FC Midtjylla,5965,2,20,5,5,67,40,27,65
Copenhagen,5965,3,15,5,10,61,45,16,50
FC Nords,5965,4,13,7,10,73,57,16,46
AaB,5965,5,7,13,10,37,41,-4,34
Sonderjyske,5965,6,8,6,10,28,29,-1,30
AC Horsens,5965,7,5,13,12,34,59,-25,28
Lyngby,5965,8,4,9,11,28,44,-16,21
Randers FC,5965,9,5,6,13,23,41,-18,21
Silkeborg IF,5965,10,5,4,13,27,46,-19,19
AGF Aarhus,5965,11,4,7,11,18,38,-20,19
Brondby,5966,1,22,6,2,77,31,46,72
FC Midtjylla,5966,2,17,7,6,64,43,21,58
Copenhagen,5966,3,15,5,10,63,46,17,50
FC Nords,5966,4,12,8,10,76,65,11,44
AC Horsens,5966,5,7,14,9,39,54,-15,35
AaB,5966,6,7,12,11,39,45,-6,33
Sonderjyske,5966,7,8,6,10,28,29,-1,30
Randers FC,5966,8,5,7,12,24,40,-16,22
AGF Aarhus,5966,9,5,6,11,18,36,-18,21
Lyngby,5966,10,3,10,11,27,45,-18,19
Silkeborg IF,5966,11,5,3,14,25,46,-21,18
Brondby,5967,1,20,7,3,72,36,36,67
FC Midtjylla,5967,2,19,6,5,65,39,26,63
FC Nords,5967,3,14,8,8,73,49,24,50
Copenhagen,5967,4,14,4,12,60,46,14,46
AaB,5967,5,6,15,9,33,41,-8,33
AC Horsens,5967,6,6,14,10,34,52,-18,32
Sonderjyske,5967,7,8,6,10,28,29,-1,30
Randers FC,5967,8,5,7,12,24,40,-16,22
Silkeborg IF,5967,9,6,3,13,28,46,-18,21
Lyngby,5967,10,3,10,11,27,45,-18,19
AGF Aarhus,5967,11,4,6,12,18,39,-21,18
FC Midtjylla,5968,1,21,5,4,68,38,30,68
Brondby,5968,2,20,7,3,70,33,37,67
Copenhagen,5968,3,13,7,10,56,44,12,46
FC Nords,5968,4,13,7,10,70,59,11,46
AaB,5968,5,7,12,11,43,43,0,33
AC Horsens,5968,6,5,16,9,36,52,-16,31
Sonderjyske,5968,7,8,6,10,28,29,-1,30
Silkeborg IF,5968,8,6,3,13,28,44,-16,21
Lyngby,5968,9,4,9,11,28,45,-17,21
Randers FC,5968,10,5,6,13,24,41,-17,21
AGF Aarhus,5968,11,4,6,12,16,39,-23,18
Brondby,5969,1,21,7,2,74,34,40,70
FC Midtjylla,5969,2,18,6,6,65,42,23,60
FC Nords,5969,3,13,7,10,73,55,18,46
Copenhagen,5969,4,14,4,12,62,49,13,46
AaB,5969,5,9,12,9,36,38,-2,39
AC Horsens,5969,6,7,12,11,34,52,-18,33
Sonderjyske,5969,7,8,6,10,28,29,-1,30
Silkeborg IF,5969,8,6,3,13,28,45,-17,21
Lyngby,5969,9,4,9,11,27,44,-17,21
Randers FC,5969,10,5,6,13,23,40,-17,21
AGF Aarhus,5969,11,4,6,12,17,39,-22,18
Brondby,5970,1,20,6,4,69,34,35,66
FC Midtjylla,5970,2,20,4,6,71,38,33,64
Copenhagen,5970,3,15,6,9,64,46,18,51
FC Nords,5970,4,14,6,10,72,55,17,48
AaB,5970,5,7,12,11,33,44,-11,33
AC Horsens,5970,6,7,12,11,36,54,-18,33
Sonderjyske,5970,7,8,6,10,28,29,-1,30
Randers FC,5970,8,5,7,12,24,40,-16,22
Lyngby,5970,9,3,10,11,27,45,-18,19
Silkeborg IF,5970,10,5,4,13,27,46,-19,19
AGF Aarhus,5970,11,4,7,11,18,38,-20,19
Brondby,5971,1,20,5,5,71,38,33,65
FC Midtjylla,5971,2,18,7,5,65,43,22,61
FC Nords,5971,3,14,7,9,70,47,23,49
Copenhagen,5971,4,13,5,12,57,48,9,44
AaB,5971,5,10,11,9,42,42,0,41
AC Horsens,5971,6,7,13,10,40,53,-13,34
Sonderjyske,5971,7,8,6,10,28,29,-1,30
Randers FC,5971,8,6,6,12,24,39,-15,24
Silkeborg IF,5971,9,5,4,13,26,45,-19,19
AGF Aarhus,5971,10,4,7,11,17,37,-20,19
Lyngby,5971,11,3,9,12,26,45,-19,18
Brondby,5972,1,23,5,2,77,32,45,74
FC Midtjylla,5972,2,19,5,6,67,37,30,62
FC Nords,5972,3,14,7,9,78,53,25,49
Copenhagen,5972,4,13,5,12,56,49,7,44
AaB,5972,5,7,14,9,37,41,-4,35
Sonderjyske,5972,6,8,6,10,28,29,-1,30
AC Horsens,5972,7,5,14,11,34,63,-29,29
Lyngby,5972,8,4,9,11,28,45,-17,21
Randers FC,5972,9,5,6,13,24,41,-17,21
Silkeborg IF,5972,10,5,4,13,27,46,-19,19
AGF Aarhus,5972,11,4,7,11,18,38,-20,19
Brondby,5973,1,22,6,2,74,30,44,72
FC Midtjylla,5973,2,20,4,6,63,39,24,64
FC Nords,5973,3,14,7,9,73,51,22,49
Copenhagen,5973,4,13,4,13,55,48,7,43
AC Horsens,5973,5,8,14,8,36,47,-11,38
Sonderjyske,5973,6,8,6,10,28,29,-1,30
AaB,5973,7,6,11,13,32,44,-12,29
Lyngby,5973,8,4,9,11,30,45,-15,21
Randers FC,5973,9,5,6,13,24,43,-19,21
AGF Aarhus,5973,10,5,6,11,18,37,-19,21
Silkeborg IF,5973,11,5,3,14,26,46,-20,18
Brondby,5974,1,22,6,2,76,34,42,72
FC Midtjylla,5974,2,19,5,6,64,40,24,62
FC Nords,5974,3,14,6,10,70,50,20,48
Copenhagen,5974,4,14,6,10,57,44,13,48
AaB,5974,5,7,12,11,40,48,-8,33
AC Horsens,5974,6,6,13,11,34,51,-17,31
Sonderjyske,5974,7,8,6,10,28,29,-1,30
Lyngby,5974,8,4,9,11,28,44,-16,21
Randers FC,5974,9,5,6,13,23,41,-18,21
Silkeborg IF,5974,10,5,4,13,26,45,-19,19
AGF Aarhus,5974,11,4,7,11,17,37,-20,19
Brondby,5975,1,19,8,3,67,32,35,65
FC Midtjylla,5975,2,19,5,6,66,39,27,62
FC Nords,5975,3,14,7,9,72,53,19,49
Copenhagen,5975,4,13,6,11,57,47,10,45
AaB,5975,5,7,14,9,38,41,-3,35
AC Horsens,5975,6,7,14,9,35,49,-14,35
Sonderjyske,5975,7,8,6,10,28,29,-1,30
Lyngby,5975,8,4,9,11,28,44,-16,21
Randers FC,5975,9,5,6,13,23,41,-18,21
Silkeborg IF,5975,10,5,4,13,25,44,-19,19
AGF Aarhus,5975,11,4,7,11,16,36,-20,19
Brondby,5976,1,22,5,3,71,33,38,71
FC Midtjylla,5976,2,19,5,6,71,43,28,62
Copenhagen,5976,3,15,5,10,64,47,17,50
FC Nords,5976,4,14,7,9,77,52,25,49
AC Horsens,5976,5,7,12,11,34,54,-20,33
Sonderjyske,5976,6,8,6,10,28,29,-1,30
AaB,5976,7,6,12,12,33,47,-14,30
Randers FC,5976,8,5,7,12,26,42,-16,22
Silkeborg IF,5976,9,6,3,13,29,45,-16,21
Lyngby,5976,10,3,10,11,29,47,-18,19
AGF Aarhus,5976,11,4,6,12,17,40,-23,18
Brondby,5977,1,21,5,4,69,33,36,68
FC Midtjylla,5977,2,18,6,6,64,38,26,60
FC Nords,5977,3,16,6,8,73,49,24,54
Copenhagen,5977,4,15,4,11,59,47,12,49
AC Horsens,5977,5,7,13,10,38,51,-13,34
Sonderjyske,5977,6,8,6,10,28,29,-1,30
AaB,5977,7,6,12,12,32,43,-11,30
Randers FC,5977,8,5,7,12,25,41,-16,22
Silkeborg IF,5977,9,6,3,13,29,45,-16,21
Lyngby,5977,10,3,10,11,28,46,-18,19
AGF Aarhus,5977,11,4,6,12,17,40,-23,18
Brondby,5978,1,22,5,3,74,31,43,71
FC Midtjylla,5978,2,18,5,7,62,42,20,59
FC Nords,5978,3,15,6,9,73,50,23,51
Copenhagen,5978,4,15,5,10,57,41,16,50
AaB,5978,5,7,13,10,37,43,-6,34
Sonderjyske,5978,6,8,6,10,28,29,-1,30
AC Horsens,5978,7,5,14,11,35,57,-22,29
Lyngby,5978,8,4,9,11,28,45,-17,21
Randers FC,5978,9,5,6,13,24,41,-17,21
Silkeborg IF,5978,10,6,3,13,27,45,-18,21
AGF Aarhus,5978,11,4,6,12,17,38,-21,18
Brondby,5979,1,20,6,4,71,35,36,66
FC Midtjylla,5979,2,18,6,6,66,47,19,60
FC Nords,5979,3,15,7,8,80,53,27,52
Copenhagen,5979,4,15,4,11,57,43,14,49
AaB,5979,5,6,15,9,38,44,-6,33
AC Horsens,5979,6,6,14,10,39,55,-16,32
Sonderjyske,5979,7,8,6,10,28,29,-1,30
Randers FC,5979,8,5,7,12,24,40,-16,22
Silkeborg IF,5979,9,6,3,13,26,44,-18,21
Lyngby,5979,10,3,10,11,27,45,-18,19
AGF Aarhus,5979,11,4,6,12,16,37,-21,18
Brondby,5980,1,20,6,4,75,33,42,66
FC Midtjylla,5980,2,20,4,6,62,40,22,64
FC Nords,5980,3,15,6,9,74,56,18,51
Copenhagen,5980,4,15,5,10,62,44,18,50
AC Horsens,5980,5,7,12,11,39,56,-17,33
AaB,5980,6,7,11,12,34,43,-9,32
Sonderjyske,5980,7,8,6,10,28,29,-1,30
Lyngby,5980,8,4,9,11,27,44,-17,21
Randers FC,5980,9,5,6,13,23,40,-17,21
AGF Aarhus,5980,10,5,6,11,17,36,-19,21
Silkeborg IF,5980,11,5,3,14,25,45,-20,18
Brondby,5981,1,22,6,2,76,32,44,72
FC Midtjylla,5981,2,20,4,6,67,38,29,64
FC Nords,5981,3,13,7,10,71,56,15,46
Copenhagen,5981,4,13,4,13,54,46,8,43
AaB,5981,5,8,12,10,36,44,-8,36
AC Horsens,5981,6,7,13,10,43,57,-14,34
Sonderjyske,5981,7,8,6,10,28,29,-1,30
Lyngby,5981,8,4,9,11,28,44,-16,21
Silkeborg IF,5981,9,6,3,13,28,45,-17,21
Randers FC,5981,10,5,6,13,23,41,-18,21
AGF Aarhus,5981,11,4,6,12,17,39,-22,18
Brondby,5982,1,21,6,3,67,30,37,69
FC Midtjylla,5982,2,19,4,7,64,39,25,61
FC Nords,5982,3,14,6,10,68,48,20,48
Copenhagen,5982,4,14,5,11,57,44,13,47
AaB,5982,5,9,11,10,38,41,-3,38
AC Horsens,5982,6,6,14,10,34,52,-18,32
Sonderjyske,5982,7,8,6,10,28,29,-1,30
Randers FC,5982,8,5,7,12,24,40,-16,22
Silkeborg IF,5982,9,6,3,13,27,45,-18,21
Lyngby,5982,10,3,10,11,27,45,-18,19
AGF Aarhus,5982,11,4,6,12,17,38,-21,18
Brondby,5983,1,21,5,4,68,34,34,68
FC Midtjylla,5983,2,19,6,5,64,37,27,63
FC Nords,5983,3,15,7,8,75,48,27,52
Copenhagen,5983,4,14,5,11,58,47,11,47
AC Horsens,5983,5,7,12,11,34,53,-19,33
AaB,5983,6,7,11,12,39,45,-6,32
Sonderjyske,5983,7,8,6,10,28,29,-1,30
Randers FC,5983,8,6,6,12,25,39,-14,24
AGF Aarhus,5983,9,5,6,11,19,38,-19,21
Silkeborg IF,5983,10,5,3,14,27,47,-20,18
Lyngby,5983,11,3,9,12,26,46,-20,18
Brondby,5984,1,22,5,3,73,29,44,71
FC Midtjylla,5984,2,18,4,8,64,49,15,58
Copenhagen,5984,3,16,4,10,65,44,21,52
FC Nords,5984,4,13,8,9,72,53,19,47
AaB,5984,5,8,12,10,38,43,-5,36
AC Horsens,5984,6,6,13,11,36,56,-20,31
Sonderjyske,5984,7,8,6,10,28,29,-1,30
Randers FC,5984,8,5,7,12,25,41,-16,22
Silkeborg IF,5984,9,6,3,13,26,44,-18,21
Lyngby,5984,10,3,10,11,28,46,-18,19
AGF Aarhus,5984,11,4,6,12,16,37,-21,18
Brondby,5985,1,20,7,3,65,28,37,67
FC Midtjylla,5985,2,19,5,6,61,38,23,62
FC Nords,5985,3,15,7,8,72,47,25,52
Copenhagen,5985,4,12,5,13,53,45,8,41
AaB,5985,5,8,13,9,39,42,-3,37
AC Horsens,5985,6,7,13,10,33,49,-16,34
Sonderjyske,5985,7,8,6,10,28,29,-1,30
Silkeborg IF,5985,8,6,3,13,28,44,-16,21
Lyngby,5985,9,4,9,11,28,45,-17,21
Randers FC,5985,10,5,6,13,24,41,-17,21
AGF Aarhus,5985,11,4,6,12,16,39,-23,18
Brondby,5986,1,22,5,3,74,34,40,71
FC Midtjylla,5986,2,19,5,6,65,40,25,62
FC Nords,5986,3,13,6,11,69,54,15,45
Copenhagen,5986,4,13,5,12,55,45,10,44
AC Horsens,5986,5,8,13,9,36,48,-12,37
AaB,5986,6,7,14,9,37,41,-4,35
Sonderjyske,5986,7,8,6,10,28,29,-1,30
Randers FC,5986,8,6,6,12,25,39,-14,24
Silkeborg IF,5986,9,6,3,13,26,44,-18,21
Lyngby,5986,10,3,9,12,26,46,-20,18
AGF Aarhus,5986,11,4,6,12,16,37,-21,18
FC Midtjylla,5987,1,21,5,4,69,37,32,68
Brondby,5987,2,19,7,4,69,35,34,64
FC Nords,5987,3,13,9,8,72,52,20,48
Copenhagen,5987,4,13,6,11,55,43,12,45
AaB,5987,5,7,13,10,33,41,-8,34
AC Horsens,5987,6,6,14,10,34,50,-16,32
Sonderjyske,5987,7,8,6,10,28,29,-1,30
Lyngby,5987,8,4,9,11,29,45,-16,21
Randers FC,5987,9,5,6,13,24,42,-18,21
Silkeborg IF,5987,10,5,4,13,27,46,-19,19
AGF Aarhus,5987,11,4,7,11,18,38,-20,19
Brondby,5988,1,19,9,2,68,30,38,66
FC Midtjylla,5988,2,19,6,5,66,41,25,63
FC Nords,5988,3,14,7,9,73,52,21,49
Copenhagen,5988,4,14,5,11,61,50,11,47
AaB,5988,5,8,12,10,38,43,-5,36
AC Horsens,5988,6,6,13,11,36,52,-16,31
Sonderjyske,5988,7,8,6,10,28,29,-1,30
Lyngby,5988,8,4,9,11,29,44,-15,21
Randers FC,5988,9,5,6,13,23,42,-19,21
Silkeborg IF,5988,10,5,4,13,26,45,-19,19
AGF Aarhus,5988,11,4,7,11,17,37,-20,19
Brondby,5989,1,21,5,4,70,32,38,68
FC Midtjylla,5989,2,19,6,5,68,43,25,63
FC Nords,5989,3,13,7,10,75,57,18,46
Copenhagen,5989,4,13,5,12,55,46,9,44
AC Horsens,5989,5,8,13,9,39,50,-11,37
AaB,5989,6,8,12,10,38,43,-5,36
Sonderjyske,5989,7,8,6,10,28,29,-1,30
Randers FC,5989,8,5,7,12,24,40,-16,22
Lyngby,5989,9,3,10,11,27,45,-18,19
Silkeborg IF,5989,10,5,4,13,26,45,-19,19
AGF Aarhus,5989,11,4,7,11,17,37,-20,19
Brondby,5990,1,22,5,3,71,34,37,71
FC Midtjylla,5990,2,21,4,5,64,37,27,67
FC Nords,5990,3,13,8,9,72,51,21,47
Copenhagen,5990,4,12,4,14,55,52,3,40
AaB,5990,5,8,12,10,37,39,-2,36
AC Horsens,5990,6,7,13,10,41,53,-12,34
Sonderjyske,5990,7,8,6,10,28,29,-1,30
Lyngby,5990,8,4,9,11,28,45,-17,21
Randers FC,5990,9,5,6,13,24,41,-17,21
AGF Aarhus,5990,10,5,6,11,18,36,-18,21
Silkeborg IF,5990,11,5,3,14,25,46,-21,18
Brondby,5991,1,21,5,4,72,33,39,68
FC Midtjylla,5991,2,19,4,7,63,40,23,61
FC Nords,5991,3,15,6,9,76,55,21,51
Copenhagen,5991,4,12,6,12,57,48,9,42
AaB,5991,5,9,12,9,38,40,-2,39
AC Horsens,5991,6,7,13,10,36,52,-16,34
Sonderjyske,5991,7,8,6,10,28,29,-1,30
Randers FC,5991,8,6,6,12,24,39,-15,24
AGF Aarhus,5991,9,5,6,11,17,36,-19,21
Lyngby,5991,10,3,9,12,26,45,-19,18
Silkeborg IF,5991,11,5,3,14,25,45,-20,18
FC Midtjylla,5992,1,22,4,4,72,37,35,70
Brondby,5992,2,20,6,4,71,31,40,66
FC Nords,5992,3,14,7,9,72,54,18,49
Copenhagen,5992,4,15,4,11,60,46,14,49
AaB,5992,5,7,12,11,35,46,-11,33
Sonderjyske,5992,6,8,6,10,28,29,-1,30
AC Horsens,5992,7,5,13,12,34,56,-22,28
Silkeborg IF,5992,8,6,3,13,30,46,-16,21
Lyngby,5992,9,4,9,11,28,45,-17,21
Randers FC,5992,10,5,6,13,24,41,-17,21
AGF Aarhus,5992,11,4,6,12,18,41,-23,18
Brondby,5993,1,22,6,2,75,32,43,72
FC Midtjylla,5993,2,19,4,7,67,44,23,61
Copenhagen,5993,3,15,5,10,61,47,14,50
FC Nords,5993,4,14,7,9,72,49,23,49
AaB,5993,5,7,12,11,37,46,-9,33
Sonderjyske,5993,6,8,6,10,28,29,-1,30
AC Horsens,5993,7,6,12,12,36,56,-20,30
Lyngby,5993,8,4,9,11,30,44,-14,21
AGF Aarhus,5993,9,5,6,11,17,36,-19,21
Randers FC,5993,10,5,6,13,23,43,-20,21
Silkeborg IF,5993,11,5,3,14,25,45,-20,18
Brondby,5994,1,19,9,2,66,30,36,66
FC Midtjylla,5994,2,18,5,7,63,40,23,59
FC Nords,5994,3,13,9,8,71,51,20,48
Copenhagen,5994,4,13,7,10,56,43,13,46
AaB,5994,5,8,12,10,40,44,-4,36
AC Horsens,5994,6,7,14,9,39,53,-14,35
Sonderjyske,5994,7,8,6,10,28,29,-1,30
Randers FC,5994,8,6,6,12,26,41,-15,24
Silkeborg IF,5994,9,5,4,13,26,45,-19,19
AGF Aarhus,5994,10,4,7,11,17,37,-20,19
Lyngby,5994,11,3,9,12,28,47,-19,18
Brondby,5995,1,19,6,5,68,39,29,63
FC Midtjylla,5995,2,19,6,5,69,41,28,63
Copenhagen,5995,3,16,4,10,60,43,17,52
FC Nords,5995,4,14,6,10,74,57,17,48
AaB,5995,5,7,14,9,41,43,-2,35
AC Horsens,5995,6,6,14,10,38,53,-15,32
Sonderjyske,5995,7,8,6,10,28,29,-1,30
Lyngby,5995,8,4,9,11,29,45,-16,21
Randers FC,5995,9,5,6,13,24,42,-18,21
AGF Aarhus,5995,10,5,6,11,17,36,-19,21
Silkeborg IF,5995,11,5,3,14,25,45,-20,18
Brondby,5996,1,22,6,2,73,28,45,72
FC Midtjylla,5996,2,19,6,5,64,40,24,63
FC Nords,5996,3,15,6,9,74,51,23,51
Copenhagen,5996,4,13,5,12,55,47,8,44
AaB,5996,5,7,14,9,39,43,-4,35
Sonderjyske,5996,6,8,6,10,28,29,-1,30
AC Horsens,5996,7,5,13,12,32,54,-22,28
Randers FC,5996,8,6,6,12,25,40,-15,24
Silkeborg IF,5996,9,5,4,13,25,44,-19,19
AGF Aarhus,5996,10,4,7,11,16,36,-20,19
Lyngby,5996,11,3,9,12,27,46,-19,18
Brondby,5997,1,20,6,4,71,33,38,66
FC Midtjylla,5997,2,18,6,6,62,39,23,60
FC Nords,5997,3,15,7,8,73,49,24,52
Copenhagen,5997,4,12,5,13,55,53,2,41
AaB,5997,5,9,12,9,43,42,1,39
AC Horsens,5997,6,8,12,10,35,49,-14,36
Sonderjyske,5997,7,8,6,10,28,29,-1,30
Randers FC,5997,8,6,6,12,25,40,-15,24
Silkeborg IF,5997,9,6,3,13,27,45,-18,21
Lyngby,5997,10,3,9,12,27,46,-19,18
AGF Aarhus,5997,11,4,6,12,17,38,-21,18
Brondby,5998,1,21,6,3,70,32,38,69
FC Midtjylla,5998,2,17,4,9,59,43,16,55
FC Nords,5998,3,14,7,9,73,52,21,49
Copenhagen,5998,4,14,7,9,59,41,18,49
AaB,5998,5,9,11,10,38,40,-2,38
AC Horsens,5998,6,7,13,10,35,52,-17,34
Sonderjyske,5998,7,8,6,10,28,29,-1,30
Randers FC,5998,8,5,7,12,25,41,-16,22
Silkeborg IF,5998,9,6,3,13,27,44,-17,21
Lyngby,5998,10,3,10,11,28,46,-18,19
AGF Aarhus,5998,11,4,6,12,16,38,-22,18
Brondby,5999,1,21,7,2,72,31,41,70
FC Midtjylla,5999,2,20,4,6,70,41,29,64
Copenhagen,5999,3,16,4,10,59,41,18,52
FC Nords,5999,4,13,6,11,70,58,12,45
AaB,5999,5,8,12,10,37,42,-5,36
Sonderjyske,5999,6,8,6,10,28,29,-1,30
AC Horsens,5999,7,5,13,12,34,55,-21,28
Lyngby,5999,8,4,9,11,30,44,-14,21
Randers FC,5999,9,5,6,13,23,43,-20,21
Silkeborg IF,5999,10,5,4,13,26,45,-19,19
AGF Aarhus,5999,11,4,7,11,17,37,-20,19
Brondby,6000,1,19,8,3,68,33,35,65
FC Midtjylla,6000,2,18,6,6,64,39,25,60
FC Nords,6000,3,15,8,7,78,52,26,53
Copenhagen,6000,4,14,7,9,59,44,15,49
AC Horsens,6000,5,6,14,10,37,52,-15,32
AaB,6000,6,6,13,11,35,47,-12,31
Sonderjyske,6000,7,8,6,10,28,29,-1,30
Lyngby,6000,8,4,9,11,28,44,-16,21
Silkeborg IF,6000,9,6,3,13,26,44,-18,21
Randers FC,6000,10,5,6,13,23,41,-18,21
AGF Aarhus,6000,11,4,6,12,16,37,-21,18
Brondby,6001,1,22,5,3,69,31,38,71
FC Midtjylla,6001,2,20,5,5,66,39,27,65
FC Nords,6001,3,14,7,9,77,53,24,49
Copenhagen,6001,4,14,5,11,61,46,15,47
AC Horsens,6001,5,7,13,10,35,51,-16,34
Sonderjyske,6001,6,8,6,10,28,29,-1,30
AaB,6001,7,6,11,13,33,47,-14,29
Lyngby,6001,8,4,9,11,27,44,-17,21
Randers FC,6001,9,5,6,13,23,40,-17,21
AGF Aarhus,6001,10,5,6,11,18,36,-18,21
Silkeborg IF,6001,11,5,3,14,25,46,-21,18
Brondby,6002,1,20,7,3,73,35,38,67
FC Midtjylla,6002,2,21,4,5,67,37,30,67
FC Nords,6002,3,14,7,9,72,54,18,49
Copenhagen,6002,4,14,6,10,63,46,17,48
AaB,6002,5,7,11,12,36,47,-11,32
AC Horsens,6002,6,6,13,11,37,55,-18,31
Sonderjyske,6002,7,8,6,10,28,29,-1,30
Randers FC,6002,8,5,7,12,24,40,-16,22
Silkeborg IF,6002,9,6,3,13,29,47,-18,21
Lyngby,6002,10,3,10,11,27,45,-18,19
AGF Aarhus,6002,11,4,6,12,19,40,-21,18
Brondby,6003,1,21,5,4,72,35,37,68
FC Midtjylla,6003,2,19,7,4,67,41,26,64
FC Nords,6003,3,14,8,8,72,50,22,50
Copenhagen,6003,4,14,4,12,60,48,12,46
AaB,6003,5,7,14,9,38,41,-3,35
Sonderjyske,6003,6,8,6,10,28,29,-1,30
AC Horsens,6003,7,5,14,11,34,54,-20,29
Lyngby,6003,8,4,9,11,29,44,-15,21
Silkeborg IF,6003,9,6,3,13,26,44,-18,21
Randers FC,6003,10,5,6,13,23,42,-19,21
AGF Aarhus,6003,11,4,6,12,16,37,-21,18
Brondby,6004,1,23,5,2,76,31,45,74
FC Midtjylla,6004,2,19,5,6,67,44,23,62
FC Nords,6004,3,13,9,8,73,55,18,48
Copenhagen,6004,4,14,5,11,60,45,15,47
AaB,6004,5,8,12,10,38,42,-4,36
Sonderjyske,6004,6,8,6,10,28,29,-1,30
AC Horsens,6004,7,5,12,13,31,54,-23,27
Randers FC,6004,8,6,6,12,25,40,-15,24
Silkeborg IF,6004,9,5,4,13,26,45,-19,19
AGF Aarhus,6004,10,4,7,11,17,37,-20,19
Lyngby,6004,11,3,9,12,27,46,-19,18
Brondby,6005,1,21,5,4,76,37,39,68
FC Midtjylla,6005,2,21,5,4,66,35,31,68
FC Nords,6005,3,16,6,8,74,46,28,54
Copenhagen,6005,4,12,6,12,55,49,6,42
AC Horsens,6005,5,7,12,11,38,56,-18,33
Sonderjyske,6005,6,8,6,10,28,29,-1,30
AaB,6005,7,6,12,12,32,44,-12,30
Lyngby,6005,8,4,9,11,28,45,-17,21
Silkeborg IF,6005,9,6,3,13,27,44,-17,21
Randers FC,6005,10,5,6,13,24,41,-17,21
AGF Aarhus,6005,11,4,6,12,16,38,-22,18
Brondby,6006,1,23,5,2,75,29,46,74
FC Midtjylla,6006,2,21,4,5,66,37,29,67
FC Nords,6006,3,15,6,9,79,59,20,51
Copenhagen,6006,4,12,4,14,56,51,5,40
AaB,6006,5,8,11,11,39,47,-8,35
Sonderjyske,6006,6,8,6,10,28,29,-1,30
AC Horsens,6006,7,6,12,12,33,51,-18,30
Randers FC,6006,8,5,7,12,23,39,-16,22
AGF Aarhus,6006,9,5,6,11,18,36,-18,21
Lyngby,6006,10,3,10,11,26,44,-18,19
Silkeborg IF,6006,11,5,3,14,25,46,-21,18
Brondby,6007,1,22,5,3,75,32,43,71
FC Midtjylla,6007,2,19,4,7,65,44,21,61
FC Nords,6007,3,15,7,8,75,50,25,52
Copenhagen,6007,4,14,5,11,59,45,14,47
AaB,6007,5,9,11,10,36,39,-3,38
Sonderjyske,6007,6,8,6,10,28,29,-1,30
AC Horsens,6007,7,5,12,13,31,57,-26,27
Lyngby,6007,8,4,9,11,28,44,-16,21
Silkeborg IF,6007,8,6,3,13,28,44,-16,21
Randers FC,6007,10,5,6,13,23,41,-18,21
AGF Aarhus,6007,11,4,6,12,16,39,-23,18
FC Midtjylla,6008,1,22,4,4,75,37,38,70
Brondby,6008,2,20,6,4,69,33,36,66
Copenhagen,6008,3,14,6,10,57,43,14,48
FC Nords,6008,4,13,6,11,72,60,12,45
AaB,6008,5,7,14,9,37,42,-5,35
Sonderjyske,6008,6,8,6,10,28,29,-1,30
AC Horsens,6008,7,5,14,11,32,53,-21,29
Lyngby,6008,8,4,9,11,27,44,-17,21
Randers FC,6008,9,5,6,13,23,40,-17,21
Silkeborg IF,6008,10,5,4,13,25,44,-19,19
AGF Aarhus,6008,11,4,7,11,16,36,-20,19
Brondby,6009,1,21,6,3,71,33,38,69
FC Midtjylla,6009,2,19,4,7,64,43,21,61
FC Nords,6009,3,16,7,7,78,47,31,55
Copenhagen,6009,4,13,5,12,59,48,11,44
AaB,6009,5,7,13,10,37,44,-7,34
AC Horsens,6009,6,6,13,11,35,55,-20,31
Sonderjyske,6009,7,8,6,10,28,29,-1,30
Randers FC,6009,8,5,7,12,23,39,-16,22
Silkeborg IF,6009,9,6,3,13,26,44,-18,21
Lyngby,6009,10,3,10,11,26,44,-18,19
AGF Aarhus,6009,11,4,6,12,16,37,-21,18
Brondby,6010,1,22,5,3,72,31,41,71
FC Midtjylla,6010,2,20,5,5,69,46,23,65
FC Nords,6010,3,14,7,9,76,52,24,49
Copenhagen,6010,4,14,6,10,59,45,14,48
AaB,6010,5,6,13,11,37,45,-8,31
Sonderjyske,6010,6,8,6,10,28,29,-1,30
AC Horsens,6010,7,6,12,12,32,52,-20,30
Randers FC,6010,8,6,6,12,25,40,-15,24
Silkeborg IF,6010,9,6,3,13,27,44,-17,21
Lyngby,6010,10,3,9,12,27,46,-19,18
AGF Aarhus,6010,11,4,6,12,16,38,-22,18
Brondby,6011,1,21,5,4,67,30,37,68
FC Midtjylla,6011,2,21,4,5,70,35,35,67
FC Nords,6011,3,16,7,7,78,49,29,55
Copenhagen,6011,4,13,5,12,60,47,13,44
AaB,6011,5,7,13,10,36,45,-9,34
Sonderjyske,6011,6,8,6,10,28,29,-1,30
AC Horsens,6011,7,5,12,13,32,63,-31,27
Randers FC,6011,8,5,7,12,24,40,-16,22
Silkeborg IF,6011,9,6,3,13,27,45,-18,21
Lyngby,6011,10,3,10,11,27,45,-18,19
AGF Aarhus,6011,11,4,6,12,17,38,-21,18
Brondby,6012,1,21,6,3,72,30,42,69
FC Midtjylla,6012,2,20,5,5,70,41,29,65
Copenhagen,6012,3,14,7,9,61,45,16,49
FC Nords,6012,4,13,7,10,79,59,20,46
AaB,6012,5,7,12,11,41,54,-13,33
AC Horsens,6012,6,6,13,11,37,57,-20,31
Sonderjyske,6012,7,8,6,10,28,29,-1,30
Randers FC,6012,8,6,6,12,25,39,-14,24
Silkeborg IF,6012,9,6,3,13,27,44,-17,21
Lyngby,6012,10,3,9,12,26,46,-20,18
AGF Aarhus,6012,11,4,6,12,16,38,-22,18
Brondby,6013,1,21,6,3,71,31,40,69
FC Midtjylla,6013,2,21,4,5,67,38,29,67
Copenhagen,6013,3,14,6,10,57,43,14,48
FC Nords,6013,4,13,6,11,70,53,17,45
AC Horsens,6013,5,7,13,10,33,51,-18,34
AaB,6013,6,6,13,11,36,44,-8,31
Sonderjyske,6013,7,8,6,10,28,29,-1,30
Lyngby,6013,8,4,9,11,29,45,-16,21
Randers FC,6013,9,5,6,13,24,42,-18,21
AGF Aarhus,6013,10,5,6,11,17,36,-19,21
Silkeborg IF,6013,11,5,3,14,25,45,-20,18
Brondby,6014,1,23,5,2,74,28,46,74
FC Midtjylla,6014,2,19,5,6,67,43,24,62
FC Nords,6014,3,16,6,8,75,48,27,54
Copenhagen,6014,4,12,6,12,54,48,6,42
AC Horsens,6014,5,7,12,11,36,55,-19,33
Sonderjyske,6014,6,8,6,10,28,29,-1,30
AaB,6014,7,6,12,12,34,44,-10,30
Lyngby,6014,8,4,9,11,30,44,-14,21
Silkeborg IF,6014,9,6,3,13,27,45,-18,21
Randers FC,6014,10,5,6,13,23,43,-20,21
AGF Aarhus,6014,11,4,6,12,17,38,-21,18
Brondby,6015,1,22,6,2,71,27,44,72
FC Midtjylla,6015,2,20,5,5,63,35,28,65
FC Nords,6015,3,14,8,8,73,51,22,50
Copenhagen,6015,4,14,5,11,57,44,13,47
Sonderjyske,6015,5,8,6,10,28,29,-1,30
AaB,6015,6,6,12,12,34,48,-14,30
AC Horsens,6015,7,6,12,12,33,52,-19,30
Lyngby,6015,8,4,9,11,29,45,-16,21
Randers FC,6015,9,5,6,13,24,42,-18,21
AGF Aarhus,6015,10,5,6,11,18,36,-18,21
Silkeborg IF,6015,11,5,3,14,25,46,-21,18
Brondby,6016,1,20,7,3,67,32,35,67
FC Midtjylla,6016,2,20,5,5,73,40,33,65
Copenhagen,6016,3,15,6,9,60,42,18,51
FC Nords,6016,4,13,8,9,73,52,21,47
AaB,6016,5,7,12,11,38,49,-11,33
Sonderjyske,6016,6,8,6,10,28,29,-1,30
AC Horsens,6016,7,5,14,11,34,56,-22,29
Randers FC,6016,8,6,6,12,26,40,-14,24
Silkeborg IF,6016,9,6,3,13,27,45,-18,21
Lyngby,6016,10,3,9,12,27,47,-20,18
AGF Aarhus,6016,11,4,6,12,17,38,-21,18
Brondby,6017,1,21,5,4,79,36,43,68
FC Midtjylla,6017,2,20,5,5,66,38,28,65
FC Nords,6017,3,15,6,9,78,51,27,51
Copenhagen,6017,4,14,4,12,54,45,9,46
AaB,6017,5,7,12,11,34,46,-12,33
AC Horsens,6017,6,7,12,11,32,53,-21,33
Sonderjyske,6017,7,8,6,10,28,29,-1,30
Randers FC,6017,8,6,6,12,25,40,-15,24
Silkeborg IF,6017,9,6,3,13,27,45,-18,21
Lyngby,6017,10,3,9,12,27,46,-19,18
AGF Aarhus,6017,11,4,6,12,17,38,-21,18
Brondby,6018,1,21,6,3,70,29,41,69
FC Midtjylla,6018,2,21,4,5,66,39,27,67
FC Nords,6018,3,14,6,10,72,52,20,48
Copenhagen,6018,4,13,5,12,55,46,9,44
AaB,6018,5,8,11,11,34,39,-5,35
AC Horsens,6018,6,6,14,10,31,49,-18,32
Sonderjyske,6018,7,8,6,10,28,29,-1,30
Lyngby,6018,8,4,9,11,28,45,-17,21
Randers FC,6018,9,5,6,13,24,41,-17,21
Silkeborg IF,6018,10,5,4,13,25,44,-19,19
AGF Aarhus,6018,11,4,7,11,16,36,-20,19
Brondby,6019,1,20,5,5,68,33,35,65
FC Midtjylla,6019,2,19,5,6,68,43,25,62
FC Nords,6019,3,15,7,8,75,51,24,52
Copenhagen,6019,4,13,6,11,57,44,13,45
AaB,6019,5,9,11,10,39,44,-5,38
AC Horsens,6019,6,6,14,10,36,54,-18,32
Sonderjyske,6019,7,8,6,10,28,29,-1,30
Randers FC,6019,8,5,7,12,25,41,-16,22
AGF Aarhus,6019,9,5,6,11,17,36,-19,21
Lyngby,6019,10,3,10,11,28,46,-18,19
Silkeborg IF,6019,11,5,3,14,25,45,-20,18
Brondby,6020,1,20,6,4,72,36,36,66
FC Midtjylla,6020,2,20,5,5,67,39,28,65
FC Nords,6020,3,15,8,7,74,48,26,53
Copenhagen,6020,4,13,5,12,54,43,11,44
AaB,6020,5,7,13,10,36,43,-7,34
AC Horsens,6020,6,6,13,11,32,52,-20,31
Sonderjyske,6020,7,8,6,10,28,29,-1,30
Randers FC,6020,8,6,6,12,24,39,-15,24
Silkeborg IF,6020,9,6,3,13,27,45,-18,21
Lyngby,6020,10,3,9,12,26,45,-19,18
AGF Aarhus,6020,11,4,6,12,17,38,-21,18
Brondby,6021,1,19,7,4,66,36,30,64
FC Midtjylla,6021,2,19,6,5,67,41,26,63
Copenhagen,6021,3,15,4,11,64,49,15,49
FC Nords,6021,4,13,8,9,73,53,20,47
AaB,6021,5,8,13,9,44,45,-1,37
AC Horsens,6021,6,6,14,10,38,54,-16,32
Sonderjyske,6021,7,8,6,10,28,29,-1,30
Lyngby,6021,8,4,9,11,28,44,-16,21
Silkeborg IF,6021,9,6,3,13,26,44,-18,21
Randers FC,6021,10,5,6,13,23,41,-18,21
AGF Aarhus,6021,11,4,6,12,16,37,-21,18
Brondby,6022,1,22,5,3,76,32,44,71
FC Midtjylla,6022,2,20,4,6,63,42,21,64
FC Nords,6022,3,13,7,10,71,54,17,46
Copenhagen,6022,4,14,4,12,57,45,12,46
AC Horsens,6022,5,8,12,10,38,51,-13,36
AaB,6022,6,7,12,11,36,43,-7,33
Sonderjyske,6022,7,8,6,10,28,29,-1,30
Lyngby,6022,8,4,9,11,29,45,-16,21
AGF Aarhus,6022,9,5,6,11,19,36,-17,21
Randers FC,6022,10,5,6,13,24,42,-18,21
Silkeborg IF,6022,11,5,3,14,25,47,-22,18
Brondby,6023,1,21,6,3,77,40,37,69
FC Midtjylla,6023,2,18,5,7,65,48,17,59
FC Nords,6023,3,14,7,9,76,52,24,49
Copenhagen,6023,4,12,6,12,61,52,9,42
AC Horsens,6023,5,9,13,8,43,49,-6,40
AaB,6023,6,8,11,11,45,52,-7,35
Sonderjyske,6023,7,8,6,10,28,29,-1,30
Randers FC,6023,8,5,7,12,23,39,-16,22
AGF Aarhus,6023,9,5,6,11,18,37,-19,21
Lyngby,6023,10,3,10,11,26,44,-18,19
Silkeborg IF,6023,11,5,3,14,26,46,-20,18
Brondby,6024,1,21,6,3,74,35,39,69
FC Midtjylla,6024,2,19,6,5,73,44,29,63
FC Nords,6024,3,15,6,9,81,56,25,51
Copenhagen,6024,4,13,6,11,59,51,8,45
AaB,6024,5,8,12,10,39,45,-6,36
Sonderjyske,6024,6,8,6,10,28,29,-1,30
AC Horsens,6024,7,5,14,11,35,56,-21,29
Randers FC,6024,8,5,7,12,23,39,-16,22
Silkeborg IF,6024,9,6,3,13,27,44,-17,21
Lyngby,6024,10,3,10,11,26,44,-18,19
AGF Aarhus,6024,11,4,6,12,16,38,-22,18
Brondby,6025,1,21,6,3,73,35,38,69
FC Midtjylla,6025,2,18,5,7,64,44,20,59
FC Nords,6025,3,16,6,8,76,50,26,54
Copenhagen,6025,4,13,5,12,54,44,10,44
AaB,6025,5,8,12,10,37,41,-4,36
AC Horsens,6025,6,5,16,9,33,49,-16,31
Sonderjyske,6025,7,8,6,10,28,29,-1,30
Lyngby,6025,8,4,9,11,27,44,-17,21
Randers FC,6025,9,5,6,13,23,40,-17,21
Silkeborg IF,6025,10,6,3,13,27,45,-18,21
AGF Aarhus,6025,11,4,6,12,17,38,-21,18
Brondby,6026,1,21,6,3,72,33,39,69
FC Midtjylla,6026,2,19,5,6,66,40,26,62
FC Nords,6026,3,14,6,10,77,59,18,48
Copenhagen,6026,4,13,6,11,60,48,12,45
AaB,6026,5,8,11,11,36,44,-8,35
AC Horsens,6026,6,7,14,9,37,50,-13,35
Sonderjyske,6026,7,8,6,10,28,29,-1,30
Lyngby,6026,8,4,9,11,30,45,-15,21
Silkeborg IF,6026,9,6,3,13,26,44,-18,21
Randers FC,6026,10,5,6,13,24,43,-19,21
AGF Aarhus,6026,11,4,6,12,16,37,-21,18
Brondby,6027,1,21,5,4,69,32,37,68
FC Midtjylla,6027,2,21,4,5,69,38,31,67
FC Nords,6027,3,14,7,9,71,50,21,49
Copenhagen,6027,4,14,4,12,57,46,11,46
AaB,6027,5,8,12,10,35,44,-9,36
Sonderjyske,6027,6,8,6,10,28,29,-1,30
AC Horsens,6027,7,6,12,12,34,51,-17,30
Lyngby,6027,8,4,9,11,28,45,-17,21
Randers FC,6027,9,5,6,13,24,41,-17,21
AGF Aarhus,6027,10,5,6,11,19,36,-17,21
Silkeborg IF,6027,11,5,3,14,25,47,-22,18
Brondby,6028,1,21,5,4,72,32,40,68
FC Midtjylla,6028,2,18,7,5,71,44,27,61
FC Nords,6028,3,14,8,8,79,59,20,50
Copenhagen,6028,4,13,6,11,62,50,12,45
AC Horsens,6028,5,8,12,10,40,57,-17,36
AaB,6028,6,6,14,10,40,48,-8,32
Sonderjyske,6028,7,8,6,10,28,29,-1,30
Randers FC,6028,8,6,6,12,24,39,-15,24
AGF Aarhus,6028,9,5,6,11,17,36,-19,21
Lyngby,6028,10,3,9,12,26,45,-19,18
Silkeborg IF,6028,11,5,3,14,25,45,-20,18
Brondby,6029,1,20,8,2,67,30,37,68
FC Midtjylla,6029,2,19,4,7,62,39,23,61
Copenhagen,6029,3,13,6,11,58,47,11,45
FC Nords,6029,4,12,7,11,72,55,17,43
AaB,6029,5,10,12,8,40,39,1,42
AC Horsens,6029,6,7,13,10,35,50,-15,34
Sonderjyske,6029,7,8,6,10,28,29,-1,30
Lyngby,6029,8,4,9,11,27,44,-17,21
Randers FC,6029,9,5,6,13,23,40,-17,21
Silkeborg IF,6029,10,6,3,13,26,44,-18,21
AGF Aarhus,6029,11,4,6,12,16,37,-21,18
Brondby,6030,1,21,7,2,73,34,39,70
FC Midtjylla,6030,2,20,4,6,61,36,25,64
FC Nords,6030,3,15,6,9,74,52,22,51
Copenhagen,6030,4,13,5,12,55,44,11,44
AaB,6030,5,9,11,10,46,48,-2,38
Sonderjyske,6030,6,8,6,10,28,29,-1,30
AC Horsens,6030,7,5,13,12,36,57,-21,28
Randers FC,6030,8,6,6,12,25,40,-15,24
AGF Aarhus,6030,9,5,6,11,17,36,-19,21
Lyngby,6030,10,3,9,12,27,46,-19,18
Silkeborg IF,6030,11,5,3,14,25,45,-20,18
Brondby,6031,1,20,6,4,72,38,34,66
FC Midtjylla,6031,2,20,6,4,68,40,28,66
FC Nords,6031,3,14,9,7,74,51,23,51
Copenhagen,6031,4,13,7,10,62,46,16,46
AaB,6031,5,7,12,11,40,45,-5,33
Sonderjyske,6031,6,8,6,10,28,29,-1,30
AC Horsens,6031,7,5,14,11,33,55,-22,29
Randers FC,6031,8,6,6,12,25,39,-14,24
AGF Aarhus,6031,9,5,6,11,21,36,-15,21
Lyngby,6031,10,3,9,12,26,46,-20,18
Silkeborg IF,6031,11,5,3,14,25,49,-24,18
FC Midtjylla,6032,1,21,5,4,67,36,31,68
Brondby,6032,2,20,6,4,69,34,35,66
FC Nords,6032,3,13,8,9,80,55,25,47
Copenhagen,6032,4,13,5,12,64,54,10,44
AC Horsens,6032,5,8,12,10,37,56,-19,36
AaB,6032,6,6,14,10,37,45,-8,32
Sonderjyske,6032,7,8,6,10,28,29,-1,30
Lyngby,6032,8,4,9,11,29,45,-16,21
Silkeborg IF,6032,9,6,3,13,26,44,-18,21
Randers FC,6032,10,5,6,13,24,42,-18,21
AGF Aarhus,6032,11,4,6,12,16,37,-21,18
Brondby,6033,1,21,6,3,71,29,42,69
FC Midtjylla,6033,2,20,5,5,68,39,29,65
FC Nords,6033,3,15,8,7,72,46,26,53
Copenhagen,6033,4,12,6,12,54,47,7,42
AaB,6033,5,8,12,10,37,41,-4,36
Sonderjyske,6033,6,8,6,10,28,29,-1,30
AC Horsens,6033,7,5,13,12,34,60,-26,28
Randers FC,6033,8,6,6,12,25,39,-14,24
Silkeborg IF,6033,9,6,3,13,28,45,-17,21
Lyngby,6033,10,3,9,12,26,46,-20,18
AGF Aarhus,6033,11,4,6,12,17,39,-22,18
Brondby,6034,1,20,7,3,70,33,37,67
FC Midtjylla,6034,2,20,6,4,66,36,30,66
FC Nords,6034,3,13,7,10,68,50,18,46
Copenhagen,6034,4,13,6,11,60,50,10,45
AC Horsens,6034,5,8,13,9,40,54,-14,37
AaB,6034,6,7,11,12,36,43,-7,32
Sonderjyske,6034,7,8,6,10,28,29,-1,30
Lyngby,6034,8,4,9,11,27,44,-17,21
Randers FC,6034,9,5,6,13,23,40,-17,21
AGF Aarhus,6034,10,5,6,11,18,36,-18,21
Silkeborg IF,6034,11,5,3,14,25,46,-21,18
Brondby,6035,1,21,7,2,67,29,38,70
FC Midtjylla,6035,2,19,6,5,66,41,25,63
FC Nords,6035,3,14,7,9,75,54,21,49
Copenhagen,6035,4,14,4,12,59,49,10,46
AaB,6035,5,7,12,11,38,42,-4,33
AC Horsens,6035,6,7,12,11,35,51,-16,33
Sonderjyske,6035,7,8,6,10,28,29,-1,30
Randers FC,6035,8,5,7,12,23,39,-16,22
AGF Aarhus,6035,9,5,6,11,19,37,-18,21
Lyngby,6035,10,3,10,11,26,44,-18,19
Silkeborg IF,6035,11,5,3,14,26,47,-21,18
Brondby,6036,1,20,6,4,73,37,36,66
FC Midtjylla,6036,2,18,5,7,61,39,22,59
FC Nords,6036,3,17,6,7,78,48,30,57
Copenhagen,6036,4,15,5,10,59,46,13,50
AC Horsens,6036,5,6,14,10,33,51,-18,32
Sonderjyske,6036,6,8,6,10,28,29,-1,30
AaB,6036,7,6,12,12,38,47,-9,30
Randers FC,6036,8,5,7,12,27,43,-16,22
Silkeborg IF,6036,9,6,3,13,28,44,-16,21
Lyngby,6036,10,3,10,11,30,48,-18,19
AGF Aarhus,6036,11,4,6,12,16,39,-23,18
Brondby,6037,1,21,6,3,74,32,42,69
FC Midtjylla,6037,2,19,5,6,64,38,26,62
Copenhagen,6037,3,15,5,10,57,42,15,50
FC Nords,6037,4,13,8,9,72,55,17,47
AaB,6037,5,7,12,11,34,44,-10,33
AC Horsens,6037,6,5,16,9,30,46,-16,31
Sonderjyske,6037,7,8,6,10,28,29,-1,30
Lyngby,6037,8,4,9,11,28,44,-16,21
Silkeborg IF,6037,9,6,3,13,28,46,-18,21
Randers FC,6037,10,5,6,13,23,41,-18,21
AGF Aarhus,6037,11,4,6,12,18,39,-21,18
Brondby,6038,1,21,5,4,78,44,34,68
FC Midtjylla,6038,2,19,5,6,67,43,24,62
Copenhagen,6038,3,16,4,10,62,44,18,52
FC Nords,6038,4,14,7,9,73,49,24,49
AaB,6038,5,7,12,11,34,41,-7,33
Sonderjyske,6038,6,8,6,10,28,29,-1,30
AC Horsens,6038,7,5,15,10,33,52,-19,30
Randers FC,6038,8,6,6,12,27,40,-13,24
Silkeborg IF,6038,9,6,3,13,27,44,-17,21
Lyngby,6038,10,3,9,12,27,48,-21,18
AGF Aarhus,6038,11,4,6,12,16,38,-22,18
Brondby,6039,1,22,5,3,71,29,42,71
FC Midtjylla,6039,2,21,4,5,65,37,28,67
FC Nords,6039,3,14,8,8,72,49,23,50
Copenhagen,6039,4,12,6,12,55,47,8,42
AC Horsens,6039,5,7,12,11,34,52,-18,33
AaB,6039,6,6,13,11,34,43,-9,31
Sonderjyske,6039,7,8,6,10,28,29,-1,30
Randers FC,6039,8,6,6,12,25,39,-14,24
AGF Aarhus,6039,9,5,6,11,18,37,-19,21
Lyngby,6039,10,3,9,12,26,46,-20,18
Silkeborg IF,6039,10,5,3,14,26,46,-20,18
FC Midtjylla,6040,1,21,5,4,67,35,32,68
Brondby,6040,2,20,7,3,71,36,35,67
FC Nords,6040,3,13,8,9,74,53,21,47
Copenhagen,6040,4,13,4,13,58,50,8,43
AaB,6040,5,8,11,11,40,45,-5,35
AC Horsens,6040,6,7,13,10,36,53,-17,34
Sonderjyske,6040,7,8,6,10,28,29,-1,30
Lyngby,6040,8,4,9,11,28,44,-16,21
Silkeborg IF,6040,9,6,3,13,26,44,-18,21
Randers FC,6040,10,5,6,13,23,41,-18,21
AGF Aarhus,6040,11,4,6,12,16,37,-21,18
Brondby,6041,1,20,5,5,67,34,33,65
FC Midtjylla,6041,2,20,4,6,63,38,25,64
Copenhagen,6041,3,17,4,9,65,42,23,55
FC Nords,6041,4,14,7,9,72,48,24,49
AaB,6041,5,7,12,11,36,43,-7,33
Sonderjyske,6041,6,8,6,10,28,29,-1,30
AC Horsens,6041,7,6,12,12,32,56,-24,30
Randers FC,6041,8,5,7,12,26,42,-16,22
Silkeborg IF,6041,9,6,3,13,27,44,-17,21
Lyngby,6041,10,3,10,11,29,47,-18,19
AGF Aarhus,6041,11,4,6,12,16,38,-22,18
Brondby,6042,1,21,5,4,70,32,38,68
FC Midtjylla,6042,2,19,6,5,65,39,26,63
FC Nords,6042,3,14,7,9,74,56,18,49
Copenhagen,6042,4,13,6,11,56,43,13,45
AaB,6042,5,8,13,9,37,39,-2,37
AC Horsens,6042,6,6,13,11,37,56,-19,31
Sonderjyske,6042,7,8,6,10,28,29,-1,30
Randers FC,6042,8,5,7,12,25,41,-16,22
Silkeborg IF,6042,9,6,3,13,28,44,-16,21
Lyngby,6042,10,3,10,11,28,46,-18,19
AGF Aarhus,6042,11,4,6,12,16,39,-23,18
Brondby,6043,1,20,7,3,68,33,35,67
FC Midtjylla,6043,2,19,5,6,68,39,29,62
FC Nords,6043,3,15,6,9,76,52,24,51
Copenhagen,6043,4,12,7,11,59,49,10,43
AaB,6043,5,7,14,9,36,43,-7,35
AC Horsens,6043,6,7,13,10,37,54,-17,34
Sonderjyske,6043,7,8,6,10,28,29,-1,30
Lyngby,6043,8,4,9,11,27,44,-17,21
Randers FC,6043,9,5,6,13,23,40,-17,21
Silkeborg IF,6043,10,5,4,13,25,44,-19,19
AGF Aarhus,6043,11,4,7,11,16,36,-20,19
Brondby,6044,1,20,7,3,72,35,37,67
FC Midtjylla,6044,2,18,6,6,63,41,22,60
Copenhagen,6044,3,15,5,10,60,43,17,50
FC Nords,6044,4,13,9,8,79,53,26,48
AaB,6044,5,8,12,10,40,45,-5,36
AC Horsens,6044,6,6,13,11,34,57,-23,31
Sonderjyske,6044,7,8,6,10,28,29,-1,30
Randers FC,6044,8,5,7,12,24,40,-16,22
AGF Aarhus,6044,9,5,6,11,18,36,-18,21
Lyngby,6044,10,3,10,11,27,45,-18,19
Silkeborg IF,6044,11,5,3,14,25,46,-21,18
FC Midtjylla,6045,1,21,5,4,70,37,33,68
Brondby,6045,2,19,7,4,69,35,34,64
FC Nords,6045,3,15,6,9,75,52,23,51
Copenhagen,6045,4,14,4,12,55,49,6,46
AaB,6045,5,8,13,9,39,42,-3,37
Sonderjyske,6045,6,8,6,10,28,29,-1,30
AC Horsens,6045,7,5,13,12,33,52,-19,28
Lyngby,6045,8,4,9,11,29,46,-17,21
Randers FC,6045,9,5,6,13,25,42,-17,21
AGF Aarhus,6045,10,5,6,11,18,37,-19,21
Silkeborg IF,6045,11,5,3,14,26,46,-20,18
Brondby,6046,1,21,7,2,72,32,40,70
FC Midtjylla,6046,2,19,6,5,67,41,26,63
FC Nords,6046,3,14,7,9,74,51,23,49
Copenhagen,6046,4,15,4,11,58,44,14,49
AaB,6046,5,7,11,12,38,45,-7,32
AC Horsens,6046,6,6,13,11,38,60,-22,31
Sonderjyske,6046,7,8,6,10,28,29,-1,30
Lyngby,6046,8,4,9,11,28,44,-16,21
Randers FC,6046,9,5,6,13,23,41,-18,21
Silkeborg IF,6046,10,5,4,13,27,46,-19,19
AGF Aarhus,6046,11,4,7,11,18,38,-20,19
Brondby,6047,1,21,5,4,72,38,34,68
FC Midtjylla,6047,2,20,5,5,65,38,27,65
FC Nords,6047,3,13,7,10,71,52,19,46
Copenhagen,6047,4,14,4,12,61,46,15,46
AC Horsens,6047,5,8,12,10,34,47,-13,36
AaB,6047,6,8,11,11,36,44,-8,35
Sonderjyske,6047,7,8,6,10,28,29,-1,30
Randers FC,6047,8,6,6,12,24,39,-15,24
Silkeborg IF,6047,9,5,4,13,25,44,-19,19
AGF Aarhus,6047,10,4,7,11,16,36,-20,19
Lyngby,6047,11,3,9,12,26,45,-19,18
Brondby,6048,1,20,7,3,74,33,41,67
FC Midtjylla,6048,2,17,4,9,57,40,17,55
FC Nords,6048,3,13,7,10,68,55,13,46
Copenhagen,6048,4,13,7,10,56,43,13,46
AaB,6048,5,11,11,8,40,37,3,44
AC Horsens,6048,6,7,14,9,34,47,-13,35
Sonderjyske,6048,7,8,6,10,28,29,-1,30
Randers FC,6048,8,6,6,12,26,41,-15,24
AGF Aarhus,6048,9,5,6,11,19,36,-17,21
Lyngby,6048,10,3,9,12,28,47,-19,18
Silkeborg IF,6048,11,5,3,14,25,47,-22,18
Brondby,6049,1,21,6,3,71,31,40,69
FC Midtjylla,6049,2,19,6,5,64,37,27,63
FC Nords,6049,3,13,8,9,73,52,21,47
Copenhagen,6049,4,14,5,11,56,45,11,47
AaB,6049,5,9,11,10,42,44,-2,38
Sonderjyske,6049,6,8,6,10,28,29,-1,30
AC Horsens,6049,7,6,12,12,31,54,-23,30
Randers FC,6049,8,6,6,12,26,39,-13,24
AGF Aarhus,6049,9,5,6,11,18,36,-18,21
Lyngby,6049,10,3,9,12,26,47,-21,18
Silkeborg IF,6049,11,5,3,14,25,46,-21,18
Brondby,6050,1,21,7,2,70,29,41,70
FC Midtjylla,6050,2,20,5,5,64,37,27,65
FC Nords,6050,3,14,7,9,69,47,22,49
Copenhagen,6050,4,12,5,13,54,46,8,41
AaB,6050,5,8,11,11,36,42,-6,35
AC Horsens,6050,6,7,13,10,34,52,-18,34
Sonderjyske,6050,7,8,6,10,28,29,-1,30
Lyngby,6050,8,4,9,11,28,45,-17,21
Silkeborg IF,6050,9,6,3,13,27,44,-17,21
Randers FC,6050,10,5,6,13,24,41,-17,21
AGF Aarhus,6050,11,4,6,12,16,38,-22,18
FC Midtjylla,6051,1,20,5,5,66,37,29,65
Brondby,6051,2,19,6,5,68,36,32,63
FC Nords,6051,3,13,7,10,71,53,18,46
Copenhagen,6051,4,13,5,12,60,53,7,44
AaB,6051,5,9,12,9,37,39,-2,39
AC Horsens,6051,6,8,13,9,40,50,-10,37
Sonderjyske,6051,7,8,6,10,28,29,-1,30
Randers FC,6051,8,6,6,12,28,39,-11,24
Silkeborg IF,6051,9,6,3,13,27,44,-17,21
AGF Aarhus,6051,10,4,6,12,16,38,-22,18
Lyngby,6051,11,3,9,12,26,49,-23,18
Brondby,6052,1,21,6,3,70,31,39,69
FC Midtjylla,6052,2,20,5,5,69,39,30,65
FC Nords,6052,3,14,6,10,73,55,18,48
Copenhagen,6052,4,12,6,12,55,47,8,42
AC Horsens,6052,5,8,13,9,40,52,-12,37
AaB,6052,6,7,12,11,34,43,-9,33
Sonderjyske,6052,7,8,6,10,28,29,-1,30
Randers FC,6052,8,6,6,12,25,39,-14,24
Silkeborg IF,6052,9,5,4,13,26,45,-19,19
AGF Aarhus,6052,10,4,7,11,17,37,-20,19
Lyngby,6052,11,3,9,12,26,46,-20,18
Brondby,6053,1,21,5,4,72,34,38,68
FC Midtjylla,6053,2,17,6,7,64,43,21,57
FC Nords,6053,3,15,6,9,76,54,22,51
Copenhagen,6053,4,13,7,10,59,46,13,46
AaB,6053,5,8,12,10,36,44,-8,36
AC Horsens,6053,6,7,14,9,41,53,-12,35
Sonderjyske,6053,7,8,6,10,28,29,-1,30
Randers FC,6053,8,6,6,12,26,40,-14,24
Silkeborg IF,6053,9,5,4,13,25,44,-19,19
AGF Aarhus,6053,10,4,7,11,16,36,-20,19
Lyngby,6053,11,3,9,12,27,47,-20,18
FC Midtjylla,6054,1,21,5,4,67,36,31,68
Brondby,6054,2,20,5,5,73,36,37,65
Copenhagen,6054,3,15,4,11,58,46,12,49
FC Nords,6054,4,13,8,9,73,57,16,47
AC Horsens,6054,5,7,14,9,39,52,-13,35
Sonderjyske,6054,6,8,6,10,28,29,-1,30
AaB,6054,7,6,12,12,33,42,-9,30
Randers FC,6054,8,5,7,12,23,39,-16,22
Silkeborg IF,6054,9,6,3,13,27,44,-17,21
Lyngby,6054,10,3,10,11,26,44,-18,19
AGF Aarhus,6054,11,4,6,12,16,38,-22,18
Brondby,6055,1,21,6,3,70,33,37,69
FC Midtjylla,6055,2,20,4,6,66,37,29,64
FC Nords,6055,3,15,7,8,74,47,27,52
Copenhagen,6055,4,12,6,12,53,45,8,42
AaB,6055,5,8,12,10,39,42,-3,36
AC Horsens,6055,6,6,13,11,31,55,-24,31
Sonderjyske,6055,7,8,6,10,28,29,-1,30
Randers FC,6055,8,5,7,12,23,39,-16,22
Lyngby,6055,9,3,10,11,26,44,-18,19
Silkeborg IF,6055,10,5,4,13,25,44,-19,19
AGF Aarhus,6055,11,4,7,11,16,36,-20,19
Brondby,6056,1,22,6,2,71,31,40,72
FC Midtjylla,6056,2,20,4,6,67,38,29,64
Copenhagen,6056,3,15,5,10,56,41,15,50
FC Nords,6056,4,14,6,10,76,55,21,48
AC Horsens,6056,5,7,12,11,35,55,-20,33
Sonderjyske,6056,6,8,6,10,28,29,-1,30
AaB,6056,7,6,11,13,35,46,-11,29
Randers FC,6056,8,6,6,12,24,39,-15,24
AGF Aarhus,6056,9,5,6,11,18,36,-18,21
Lyngby,6056,10,3,9,12,26,45,-19,18
Silkeborg IF,6056,11,5,3,14,25,46,-21,18
Brondby,6057,1,21,7,2,75,33,42,70
FC Midtjylla,6057,2,19,6,5,68,41,27,63
Copenhagen,6057,3,14,5,11,63,48,15,47
FC Nords,6057,4,13,7,10,71,52,19,46
AaB,6057,5,7,12,11,36,50,-14,33
AC Horsens,6057,6,6,15,9,37,52,-15,33
Sonderjyske,6057,7,8,6,10,28,29,-1,30
Randers FC,6057,8,6,6,12,26,40,-14,24
Silkeborg IF,6057,9,6,3,13,28,44,-16,21
Lyngby,6057,10,3,9,12,27,47,-20,18
AGF Aarhus,6057,11,4,6,12,16,39,-23,18
Brondby,6058,1,22,6,2,73,30,43,72
FC Midtjylla,6058,2,20,5,5,69,40,29,65
FC Nords,6058,3,13,8,9,74,55,19,47
Copenhagen,6058,4,13,6,11,57,46,11,45
AaB,6058,5,7,14,9,37,41,-4,35
Sonderjyske,6058,6,8,6,10,28,29,-1,30
AC Horsens,6058,7,5,13,12,31,55,-24,28
Lyngby,6058,8,4,9,11,28,45,-17,21
Randers FC,6058,9,5,6,13,24,41,-17,21
Silkeborg IF,6058,10,6,3,13,26,44,-18,21
AGF Aarhus,6058,11,4,6,12,16,37,-21,18
Brondby,6059,1,21,7,2,68,28,40,70
FC Midtjylla,6059,2,19,6,5,69,40,29,63
FC Nords,6059,3,14,6,10,72,55,17,48
Copenhagen,6059,4,13,7,10,55,43,12,46
AC Horsens,6059,5,6,15,9,34,48,-14,33
AaB,6059,6,6,13,11,33,43,-10,31
Sonderjyske,6059,7,8,6,10,28,29,-1,30
Randers FC,6059,8,6,6,12,26,40,-14,24
AGF Aarhus,6059,9,5,6,11,18,36,-18,21
Lyngby,6059,10,3,9,12,27,47,-20,18
Silkeborg IF,6059,11,5,3,14,25,46,-21,18
Brondby,6060,1,20,6,4,71,36,35,66
FC Midtjylla,6060,2,20,5,5,67,42,25,65
Copenhagen,6060,3,16,4,10,65,45,20,52
FC Nords,6060,4,14,6,10,70,50,20,48
AaB,6060,5,8,13,9,37,41,-4,37
Sonderjyske,6060,6,8,6,10,28,29,-1,30
AC Horsens,6060,7,5,12,13,32,54,-22,27
Randers FC,6060,8,6,6,12,26,41,-15,24
Silkeborg IF,6060,9,6,3,13,27,44,-17,21
Lyngby,6060,10,3,9,12,28,47,-19,18
AGF Aarhus,6060,11,4,6,12,16,38,-22,18
Brondby,6061,1,21,6,3,73,29,44,69
FC Midtjylla,6061,2,18,8,4,65,38,27,62
Copenhagen,6061,3,14,6,10,55,42,13,48
FC Nords,6061,4,13,7,10,68,52,16,46
AaB,6061,5,8,12,10,35,43,-8,36
AC Horsens,6061,6,6,13,11,32,50,-18,31
Sonderjyske,6061,7,8,6,10,28,29,-1,30
Lyngby,6061,8,4,9,11,28,45,-17,21
Randers FC,6061,9,5,6,13,24,41,-17,21
Silkeborg IF,6061,10,5,4,13,26,45,-19,19
AGF Aarhus,6061,11,4,7,11,17,37,-20,19
Brondby,6062,1,21,5,4,70,33,37,68
FC Midtjylla,6062,2,20,6,4,61,34,27,66
FC Nords,6062,3,14,7,9,72,52,20,49
Copenhagen,6062,4,14,5,11,59,43,16,47
AaB,6062,5,7,12,11,38,47,-9,33
AC Horsens,6062,6,6,13,11,32,49,-17,31
Sonderjyske,6062,7,8,6,10,28,29,-1,30
Randers FC,6062,8,6,6,12,24,39,-15,24
AGF Aarhus,6062,9,5,6,11,18,36,-18,21
Lyngby,6062,10,3,9,12,26,45,-19,18
Silkeborg IF,6062,11,5,3,14,25,46,-21,18
FC Midtjylla,6063,1,21,4,5,70,37,33,67
Brondby,6063,2,19,6,5,69,33,36,63
FC Nords,6063,3,16,6,8,79,51,28,54
Copenhagen,6063,4,14,5,11,55,44,11,47
AC Horsens,6063,5,6,14,10,33,55,-22,32
AaB,6063,6,6,13,11,34,46,-12,31
Sonderjyske,6063,7,8,6,10,28,29,-1,30
Lyngby,6063,8,4,9,11,28,45,-17,21
Silkeborg IF,6063,9,6,3,13,27,44,-17,21
Randers FC,6063,10,5,6,13,24,41,-17,21
AGF Aarhus,6063,11,4,6,12,16,38,-22,18
Brondby,6064,1,23,5,2,76,31,45,74
FC Midtjylla,6064,2,18,5,7,62,38,24,59
FC Nords,6064,3,15,6,9,72,55,17,51
Copenhagen,6064,4,13,6,11,57,45,12,45
AaB,6064,5,7,12,11,36,43,-7,33
AC Horsens,6064,6,7,12,11,35,52,-17,33
Sonderjyske,6064,7,8,6,10,28,29,-1,30
Randers FC,6064,8,5,7,12,24,40,-16,22
Silkeborg IF,6064,9,6,3,13,27,45,-18,21
Lyngby,6064,10,3,10,11,27,45,-18,19
AGF Aarhus,6064,11,4,6,12,17,38,-21,18
Brondby,6065,1,21,6,3,71,30,41,69
FC Midtjylla,6065,2,18,6,6,61,40,21,60
FC Nords,6065,3,15,7,8,74,50,24,52
Copenhagen,6065,4,12,6,12,55,49,6,42
AaB,6065,5,8,12,10,38,42,-4,36
AC Horsens,6065,6,7,13,10,38,52,-14,34
Sonderjyske,6065,7,8,6,10,28,29,-1,30
Randers FC,6065,8,5,7,12,23,39,-16,22
AGF Aarhus,6065,9,5,6,11,19,37,-18,21
Lyngby,6065,10,3,10,11,26,44,-18,19
Silkeborg IF,6065,11,5,3,14,26,47,-21,18
Brondby,6066,1,20,6,4,70,34,36,66
FC Midtjylla,6066,2,20,5,5,68,38,30,65
FC Nords,6066,3,15,6,9,73,51,22,51
Copenhagen,6066,4,14,4,12,58,46,12,46
AC Horsens,6066,5,8,12,10,35,50,-15,36
AaB,6066,6,7,11,12,33,44,-11,32
Sonderjyske,6066,7,8,6,10,28,29,-1,30
Randers FC,6066,8,6,6,12,26,41,-15,24
Silkeborg IF,6066,9,6,3,13,27,44,-17,21
Lyngby,6066,10,3,9,12,28,47,-19,18
AGF Aarhus,6066,11,4,6,12,16,38,-22,18
Brondby,6067,1,20,6,4,75,34,41,66
FC Midtjylla,6067,2,20,5,5,67,37,30,65
Copenhagen,6067,3,15,6,9,58,42,16,51
FC Nords,6067,4,14,7,9,73,57,16,49
AaB,6067,5,6,14,10,39,46,-7,32
Sonderjyske,6067,6,8,6,10,28,29,-1,30
AC Horsens,6067,7,6,12,12,33,55,-22,30
Randers FC,6067,8,6,6,12,24,39,-15,24
Silkeborg IF,6067,9,5,4,13,26,45,-19,19
AGF Aarhus,6067,10,4,7,11,17,37,-20,19
Lyngby,6067,11,3,9,12,26,45,-19,18
Brondby,6068,1,20,8,2,69,32,37,68
FC Midtjylla,6068,2,19,5,6,64,40,24,62
FC Nords,6068,3,15,6,9,81,56,25,51
Copenhagen,6068,4,14,5,11,59,43,16,47
AaB,6068,5,7,12,11,37,45,-8,33
AC Horsens,6068,6,6,14,10,33,53,-20,32
Sonderjyske,6068,7,8,6,10,28,29,-1,30
Randers FC,6068,8,6,6,12,24,39,-15,24
AGF Aarhus,6068,9,5,6,11,19,37,-18,21
Lyngby,6068,10,3,9,12,26,45,-19,18
Silkeborg IF,6068,11,5,3,14,26,47,-21,18
Brondby,6069,1,20,5,5,72,36,36,65
FC Midtjylla,6069,2,20,5,5,68,39,29,65
FC Nords,6069,3,15,6,9,71,53,18,51
Copenhagen,6069,4,14,6,10,59,44,15,48
AaB,6069,5,7,12,11,41,48,-7,33
AC Horsens,6069,6,6,14,10,35,52,-17,32
Sonderjyske,6069,7,8,6,10,28,29,-1,30
Lyngby,6069,8,4,9,11,27,44,-17,21
Randers FC,6069,9,5,6,13,23,40,-17,21
Silkeborg IF,6069,10,6,3,13,26,44,-18,21
AGF Aarhus,6069,11,4,6,12,16,37,-21,18
Brondby,6070,1,20,7,3,68,30,38,67
FC Midtjylla,6070,2,20,5,5,63,36,27,65
FC Nords,6070,3,16,6,8,80,51,29,54
Copenhagen,6070,4,14,5,11,57,46,11,47
AaB,6070,5,7,11,12,37,48,-11,32
Sonderjyske,6070,6,8,6,10,28,29,-1,30
AC Horsens,6070,7,6,12,12,33,53,-20,30
Randers FC,6070,8,5,7,12,23,39,-16,22
Silkeborg IF,6070,9,6,3,13,29,44,-15,21
Lyngby,6070,10,3,10,11,26,44,-18,19
AGF Aarhus,6070,11,4,6,12,16,40,-24,18
Brondby,6071,1,20,8,2,69,29,40,68
FC Midtjylla,6071,2,17,6,7,59,41,18,57
FC Nords,6071,3,15,7,8,77,52,25,52
Copenhagen,6071,4,13,6,11,54,43,11,45
AaB,6071,5,8,14,8,39,40,-1,38
AC Horsens,6071,6,6,13,11,35,54,-19,31
Sonderjyske,6071,7,8,6,10,28,29,-1,30
Randers FC,6071,8,6,6,12,25,40,-15,24
Silkeborg IF,6071,9,6,3,13,26,44,-18,21
Lyngby,6071,10,3,9,12,27,46,-19,18
AGF Aarhus,6071,11,4,6,12,16,37,-21,18
FC Midtjylla,6072,1,21,4,5,68,38,30,67
Brondby,6072,2,18,8,4,69,37,32,62
Copenhagen,6072,3,14,7,9,58,42,16,49
FC Nords,6072,4,13,9,8,71,52,19,48
AaB,6072,5,7,14,9,35,40,-5,35
Sonderjyske,6072,6,8,6,10,28,29,-1,30
AC Horsens,6072,7,6,12,12,32,50,-18,30
Randers FC,6072,8,6,6,12,25,39,-14,24
AGF Aarhus,6072,9,5,6,11,18,37,-19,21
Lyngby,6072,10,3,9,12,26,46,-20,18
Silkeborg IF,6072,10,5,3,14,26,46,-20,18
Brondby,6073,1,20,7,3,70,34,36,67
FC Midtjylla,6073,2,19,6,5,64,39,25,63
Copenhagen,6073,3,15,5,10,59,43,16,50
FC Nords,6073,4,14,7,9,74,53,21,49
AC Horsens,6073,5,6,14,10,36,53,-17,32
AaB,6073,6,6,13,11,36,43,-7,31
Sonderjyske,6073,7,8,6,10,28,29,-1,30
Randers FC,6073,8,5,7,12,23,39,-16,22
Lyngby,6073,9,3,10,11,26,44,-18,19
Silkeborg IF,6073,10,5,4,13,26,45,-19,19
AGF Aarhus,6073,11,4,7,11,17,37,-20,19
FC Midtjylla,6074,1,20,6,4,68,40,28,66
Brondby,6074,2,20,5,5,69,35,34,65
FC Nords,6074,3,14,7,9,76,53,23,49
Copenhagen,6074,4,13,6,11,56,45,11,45
AaB,6074,5,8,13,9,37,40,-3,37
AC Horsens,6074,6,6,13,11,33,52,-19,31
Sonderjyske,6074,7,8,6,10,28,29,-1,30
Randers FC,6074,8,6,6,12,26,39,-13,24
Silkeborg IF,6074,9,6,3,13,28,44,-16,21
Lyngby,6074,10,3,9,12,26,47,-21,18
AGF Aarhus,6074,11,4,6,12,16,39,-23,18
Brondby,6075,1,22,5,3,75,35,40,71
FC Midtjylla,6075,2,18,6,6,64,42,22,60
FC Nords,6075,3,14,7,9,69,51,18,49
Copenhagen,6075,4,13,6,11,61,46,15,45
AaB,6075,5,8,12,10,35,41,-6,36
AC Horsens,6075,6,7,12,11,37,52,-15,33
Sonderjyske,6075,7,8,6,10,28,29,-1,30
Randers FC,6075,8,5,7,12,25,41,-16,22
Silkeborg IF,6075,9,6,3,13,27,44,-17,21
Lyngby,6075,10,3,10,11,28,46,-18,19
AGF Aarhus,6075,11,4,6,12,16,38,-22,18
FC Midtjylla,6076,1,21,5,4,69,37,32,68
Brondby,6076,2,18,7,5,68,36,32,61
FC Nords,6076,3,14,6,10,72,53,19,48
Copenhagen,6076,4,13,6,11,57,46,11,45
AaB,6076,5,7,14,9,40,46,-6,35
AC Horsens,6076,6,7,14,9,39,53,-14,35
Sonderjyske,6076,7,8,6,10,28,29,-1,30
Lyngby,6076,8,4,9,11,27,44,-17,21
Randers FC,6076,9,5,6,13,23,40,-17,21
Silkeborg IF,6076,10,6,3,13,26,44,-18,21
AGF Aarhus,6076,11,4,6,12,16,37,-21,18
Brondby,6077,1,23,5,2,76,30,46,74
FC Midtjylla,6077,2,19,5,6,67,44,23,62
Copenhagen,6077,3,15,5,10,60,45,15,50
FC Nords,6077,4,12,7,11,71,57,14,43
AaB,6077,5,6,14,10,36,44,-8,32
AC Horsens,6077,6,6,14,10,35,51,-16,32
Sonderjyske,6077,7,8,6,10,28,29,-1,30
Lyngby,6077,8,4,9,11,30,44,-14,21
Randers FC,6077,9,5,6,13,23,43,-20,21
Silkeborg IF,6077,10,5,4,13,25,44,-19,19
AGF Aarhus,6077,11,4,7,11,16,36,-20,19
Brondby,6078,1,20,6,4,71,36,35,66
FC Midtjylla,6078,2,18,5,7,62,40,22,59
FC Nords,6078,3,13,10,7,71,49,22,49
Copenhagen,6078,4,12,8,10,62,51,11,44
AaB,6078,5,8,13,9,45,44,1,37
AC Horsens,6078,6,7,14,9,35,52,-17,35
Sonderjyske,6078,7,8,6,10,28,29,-1,30
Silkeborg IF,6078,8,6,3,13,29,44,-15,21
Lyngby,6078,9,4,9,11,27,44,-17,21
Randers FC,6078,10,5,6,13,23,40,-17,21
AGF Aarhus,6078,11,4,6,12,16,40,-24,18
Brondby,6079,1,21,6,3,68,29,39,69
FC Midtjylla,6079,2,19,5,6,65,39,26,62
Copenhagen,6079,3,15,5,10,57,42,15,50
FC Nords,6079,4,13,8,9,68,50,18,47
AaB,6079,5,7,12,11,34,42,-8,33
AC Horsens,6079,6,6,14,10,35,51,-16,32
Sonderjyske,6079,7,8,6,10,28,29,-1,30
Randers FC,6079,8,6,6,12,25,39,-14,24
AGF Aarhus,6079,9,5,6,11,18,37,-19,21
Lyngby,6079,10,3,9,12,26,46,-20,18
Silkeborg IF,6079,10,5,3,14,26,46,-20,18
Brondby,6080,1,20,6,4,67,30,37,66
FC Midtjylla,6080,2,20,4,6,65,39,26,64
FC Nords,6080,3,15,6,9,74,49,25,51
Copenhagen,6080,4,13,6,11,57,43,14,45
AC Horsens,6080,5,7,14,9,33,51,-18,35
AaB,6080,6,7,12,11,35,45,-10,33
Sonderjyske,6080,7,8,6,10,28,29,-1,30
Randers FC,6080,8,6,6,12,25,40,-15,24
AGF Aarhus,6080,9,5,6,11,17,36,-19,21
Lyngby,6080,10,3,9,12,27,46,-19,18
Silkeborg IF,6080,11,5,3,14,25,45,-20,18
Brondby,6081,1,21,6,3,69,29,40,69
FC Midtjylla,6081,2,20,4,6,65,40,25,64
FC Nords,6081,3,17,6,7,79,47,32,57
Copenhagen,6081,4,13,5,12,52,43,9,44
AaB,6081,5,7,11,12,34,44,-10,32
Sonderjyske,6081,6,8,6,10,28,29,-1,30
AC Horsens,6081,7,6,12,12,31,53,-22,30
Lyngby,6081,8,4,9,11,28,45,-17,21
Randers FC,6081,9,5,6,13,24,41,-17,21
AGF Aarhus,6081,10,5,6,11,18,37,-19,21
Silkeborg IF,6081,11,5,3,14,26,46,-20,18
Brondby,6082,1,22,6,2,75,29,46,72
FC Midtjylla,6082,2,18,5,7,62,41,21,59
FC Nords,6082,3,15,6,9,76,52,24,51
Copenhagen,6082,4,14,6,10,59,44,15,48
AC Horsens,6082,5,6,14,10,38,54,-16,32
AaB,6082,6,7,11,12,34,50,-16,32
Sonderjyske,6082,7,8,6,10,28,29,-1,30
Lyngby,6082,8,4,9,11,27,44,-17,21
Silkeborg IF,6082,8,6,3,13,27,44,-17,21
Randers FC,6082,10,5,6,13,23,40,-17,21
AGF Aarhus,6082,11,4,6,12,16,38,-22,18
Brondby,6083,1,19,7,4,68,33,35,64
FC Midtjylla,6083,2,19,6,5,65,38,27,63
FC Nords,6083,3,16,7,7,77,48,29,55
Copenhagen,6083,4,13,4,13,56,50,6,43
AaB,6083,5,8,11,11,38,45,-7,35
AC Horsens,6083,6,7,13,10,35,51,-16,34
Sonderjyske,6083,7,8,6,10,28,29,-1,30
Lyngby,6083,8,4,9,11,29,46,-17,21
Silkeborg IF,6083,9,6,3,13,27,44,-17,21
Randers FC,6083,10,5,6,13,25,42,-17,21
AGF Aarhus,6083,11,4,6,12,16,38,-22,18
Brondby,6084,1,22,5,3,77,35,42,71
FC Midtjylla,6084,2,20,4,6,66,42,24,64
FC Nords,6084,3,15,6,9,78,53,25,51
Copenhagen,6084,4,14,4,12,59,48,11,46
AC Horsens,6084,5,8,12,10,38,53,-15,36
Sonderjyske,6084,6,8,6,10,28,29,-1,30
AaB,6084,7,6,11,13,35,48,-13,29
Randers FC,6084,8,5,7,12,23,39,-16,22
Silkeborg IF,6084,9,6,3,13,29,46,-17,21
Lyngby,6084,10,3,10,11,26,44,-18,19
AGF Aarhus,6084,11,4,6,12,18,40,-22,18
FC Midtjylla,6085,1,20,6,4,69,40,29,66
Brondby,6085,2,20,5,5,70,35,35,65
FC Nords,6085,3,15,6,9,75,51,24,51
Copenhagen,6085,4,13,5,12,54,46,8,44
AC Horsens,6085,5,8,13,9,39,51,-12,37
AaB,6085,6,7,11,12,36,46,-10,32
Sonderjyske,6085,7,8,6,10,28,29,-1,30
Lyngby,6085,8,4,9,11,27,44,-17,21
Randers FC,6085,9,5,6,13,23,40,-17,21
Silkeborg IF,6085,10,5,4,13,27,46,-19,19
AGF Aarhus,6085,11,4,7,11,18,38,-20,19
Brondby,6086,1,20,6,4,70,33,37,66
FC Midtjylla,6086,2,20,5,5,66,37,29,65
Copenhagen,6086,3,15,4,11,59,44,15,49
FC Nords,6086,4,13,9,8,72,51,21,48
AC Horsens,6086,5,8,12,10,41,57,-16,36
Sonderjyske,6086,6,8,6,10,28,29,-1,30
AaB,6086,7,6,12,12,34,46,-12,30
Lyngby,6086,8,4,9,11,28,44,-16,21
Randers FC,6086,9,5,6,13,23,41,-18,21
AGF Aarhus,6086,10,5,6,11,18,36,-18,21
Silkeborg IF,6086,11,5,3,14,25,46,-21,18
FC Midtjylla,6087,1,21,4,5,67,37,30,67
Brondby,6087,2,20,6,4,69,32,37,66
Copenhagen,6087,3,15,5,10,60,45,15,50
FC Nords,6087,4,13,7,10,75,59,16,46
AaB,6087,5,7,12,11,39,45,-6,33
AC Horsens,6087,6,7,12,11,38,56,-18,33
Sonderjyske,6087,7,8,6,10,28,29,-1,30
Lyngby,6087,8,4,9,11,28,44,-16,21
Randers FC,6087,9,5,6,13,23,41,-18,21
Silkeborg IF,6087,10,5,4,13,25,44,-19,19
AGF Aarhus,6087,11,4,7,11,16,36,-20,19
Brondby,6088,1,20,6,4,72,34,38,66
FC Midtjylla,6088,2,19,4,7,64,45,19,61
FC Nords,6088,3,14,7,9,75,54,21,49
Copenhagen,6088,4,15,4,11,60,46,14,49
AC Horsens,6088,5,8,12,10,41,54,-13,36
AaB,6088,6,8,11,11,38,43,-5,35
Sonderjyske,6088,7,8,6,10,28,29,-1,30
Lyngby,6088,8,4,9,11,27,44,-17,21
Randers FC,6088,9,5,6,13,23,40,-17,21
Silkeborg IF,6088,10,6,3,13,26,44,-18,21
AGF Aarhus,6088,11,4,6,12,16,37,-21,18
FC Midtjylla,6089,1,20,5,5,71,42,29,65
Brondby,6089,2,19,6,5,72,38,34,63
FC Nords,6089,3,14,6,10,71,53,18,48
Copenhagen,6089,4,12,7,11,57,47,10,43
AaB,6089,5,9,11,10,38,43,-5,38
AC Horsens,6089,6,8,13,9,36,48,-12,37
Sonderjyske,6089,7,8,6,10,28,29,-1,30
Lyngby,6089,8,4,9,11,30,46,-16,21
Randers FC,6089,9,5,6,13,25,43,-18,21
Silkeborg IF,6089,10,5,4,13,26,45,-19,19
AGF Aarhus,6089,11,4,7,11,17,37,-20,19
Brondby,6090,1,21,6,3,71,31,40,69
FC Midtjylla,6090,2,20,5,5,66,36,30,65
FC Nords,6090,3,15,6,9,77,51,26,51
Copenhagen,6090,4,12,6,12,50,46,4,42
AC Horsens,6090,5,7,13,10,34,52,-18,34
AaB,6090,6,7,12,11,36,44,-8,33
Sonderjyske,6090,7,8,6,10,28,29,-1,30
Randers FC,6090,8,5,7,12,24,40,-16,22
Silkeborg IF,6090,9,6,3,13,27,44,-17,21
Lyngby,6090,10,3,10,11,27,45,-18,19
AGF Aarhus,6090,11,4,6,12,16,38,-22,18
FC Midtjylla,6091,1,20,5,5,71,42,29,65
Brondby,6091,2,19,6,5,66,35,31,63
FC Nords,6091,3,15,8,7,77,48,29,53
Copenhagen,6091,4,14,4,12,59,47,12,46
AaB,6091,5,8,12,10,40,48,-8,36
AC Horsens,6091,6,6,13,11,34,53,-19,31
Sonderjyske,6091,7,8,6,10,28,29,-1,30
Randers FC,6091,8,5,7,12,24,40,-16,22
AGF Aarhus,6091,9,5,6,11,17,36,-19,21
Lyngby,6091,10,3,10,11,27,45,-18,19
Silkeborg IF,6091,11,5,3,14,25,45,-20,18
Brondby,6092,1,21,5,4,68,31,37,68
FC Midtjylla,6092,2,20,5,5,66,39,27,65
FC Nords,6092,3,16,7,7,73,46,27,55
Copenhagen,6092,4,13,5,12,56,44,12,44
AaB,6092,5,7,11,12,34,45,-11,32
AC Horsens,6092,6,6,13,11,32,50,-18,31
Sonderjyske,6092,7,8,6,10,28,29,-1,30
Lyngby,6092,8,4,9,11,30,46,-16,21
Randers FC,6092,9,5,6,13,25,43,-18,21
AGF Aarhus,6092,10,5,6,11,21,39,-18,21
Silkeborg IF,6092,11,5,3,14,28,49,-21,18
Brondby,6093,1,21,6,3,70,32,38,69
FC Midtjylla,6093,2,20,5,5,64,40,24,65
FC Nords,6093,3,15,6,9,74,52,22,51
Copenhagen,6093,4,13,4,13,59,48,11,43
AaB,6093,5,8,11,11,40,42,-2,35
AC Horsens,6093,6,7,12,11,35,54,-19,33
Sonderjyske,6093,7,8,6,10,28,29,-1,30
Randers FC,6093,8,6,6,12,25,40,-15,24
Silkeborg IF,6093,9,6,3,13,26,44,-18,21
Lyngby,6093,10,3,9,12,27,46,-19,18
AGF Aarhus,6093,11,4,6,12,16,37,-21,18
Brondby,6094,1,21,6,3,67,31,36,69
FC Midtjylla,6094,2,18,6,6,64,39,25,60
FC Nords,6094,3,13,8,9,72,52,20,47
Copenhagen,6094,4,13,5,12,57,46,11,44
AaB,6094,5,10,12,8,40,40,0,42
AC Horsens,6094,6,6,13,11,33,51,-18,31
Sonderjyske,6094,7,8,6,10,28,29,-1,30
Randers FC,6094,8,5,7,12,25,41,-16,22
Lyngby,6094,9,3,10,11,28,46,-18,19
Silkeborg IF,6094,10,5,4,13,25,44,-19,19
AGF Aarhus,6094,11,4,7,11,16,36,-20,19
Brondby,6095,1,21,6,3,73,29,44,69
FC Midtjylla,6095,2,19,5,6,64,44,20,62
FC Nords,6095,3,14,7,9,73,50,23,49
Copenhagen,6095,4,15,4,11,58,46,12,49
AaB,6095,5,7,13,10,34,40,-6,34
AC Horsens,6095,6,6,13,11,35,54,-19,31
Sonderjyske,6095,7,8,6,10,28,29,-1,30
Lyngby,6095,8,4,9,11,27,44,-17,21
Randers FC,6095,9,5,6,13,23,40,-17,21
Silkeborg IF,6095,10,5,4,13,26,45,-19,19
AGF Aarhus,6095,11,4,7,11,17,37,-20,19
Brondby,6096,1,21,5,4,69,33,36,68
FC Midtjylla,6096,2,20,4,6,67,42,25,64
FC Nords,6096,3,15,6,9,78,51,27,51
Copenhagen,6096,4,15,4,11,61,48,13,49
AaB,6096,5,8,11,11,37,43,-6,35
Sonderjyske,6096,6,8,6,10,28,29,-1,30
AC Horsens,6096,7,6,12,12,31,52,-21,30
Randers FC,6096,8,5,7,12,23,39,-16,22
Silkeborg IF,6096,9,6,3,13,26,44,-18,21
Lyngby,6096,10,3,10,11,26,44,-18,19
AGF Aarhus,6096,11,4,6,12,16,37,-21,18
Brondby,6097,1,21,6,3,70,30,40,69
FC Midtjylla,6097,2,19,4,7,60,37,23,61
FC Nords,6097,3,13,7,10,68,53,15,46
Copenhagen,6097,4,13,7,10,55,41,14,46
AaB,6097,5,9,13,8,39,38,1,40
AC Horsens,6097,6,6,13,11,34,53,-19,31
Sonderjyske,6097,7,8,6,10,28,29,-1,30
Randers FC,6097,8,5,7,12,25,41,-16,22
Silkeborg IF,6097,9,6,3,13,28,44,-16,21
Lyngby,6097,10,3,10,11,28,46,-18,19
AGF Aarhus,6097,11,4,6,12,16,39,-23,18
Brondby,6098,1,23,5,2,78,30,48,74
FC Midtjylla,6098,2,19,4,7,64,44,20,61
FC Nords,6098,3,14,7,9,70,52,18,49
Copenhagen,6098,4,13,5,12,55,45,10,44
AC Horsens,6098,5,7,13,10,39,55,-16,34
AaB,6098,6,7,12,11,36,42,-6,33
Sonderjyske,6098,7,8,6,10,28,29,-1,30
Randers FC,6098,8,5,7,12,24,40,-16,22
AGF Aarhus,6098,9,5,6,11,17,36,-19,21
Lyngby,6098,10,3,10,11,27,45,-18,19
Silkeborg IF,6098,11,5,3,14,25,45,-20,18
FC Midtjylla,6099,1,19,7,4,69,41,28,64
Brondby,6099,2,18,7,5,65,38,27,61
FC Nords,6099,3,14,7,9,72,52,20,49
Copenhagen,6099,4,15,4,11,66,46,20,49
AaB,6099,5,8,13,9,38,43,-5,37
AC Horsens,6099,6,6,14,10,36,52,-16,32
Sonderjyske,6099,7,8,6,10,28,29,-1,30
Lyngby,6099,8,4,9,11,34,44,-10,21
Silkeborg IF,6099,9,6,3,13,31,45,-14,21
Randers FC,6099,10,5,6,13,23,47,-24,21
AGF Aarhus,6099,11,4,6,12,17,42,-25,18
Brondby,6100,1,22,5,3,74,32,42,71
FC Midtjylla,6100,2,19,4,7,64,40,24,61
FC Nords,6100,3,12,8,10,71,58,13,44
AaB,6100,4,11,11,8,41,38,3,44
Copenhagen,6100,5,12,6,12,55,47,8,42
AC Horsens,6100,6,6,14,10,35,51,-16,32
Sonderjyske,6100,7,8,6,10,28,29,-1,30
Lyngby,6100,8,4,9,11,29,45,-16,21
Silkeborg IF,6100,9,6,3,13,27,45,-18,21
Randers FC,6100,10,5,6,13,24,42,-18,21
AGF Aarhus,6100,11,4,6,12,17,38,-21,18
Brondby,6101,1,22,5,3,73,34,39,71
FC Midtjylla,6101,2,20,4,6,69,40,29,64
Copenhagen,6101,3,16,5,9,63,38,25,53
FC Nords,6101,4,13,7,10,75,63,12,46
AaB,6101,5,7,11,12,36,46,-10,32
Sonderjyske,6101,6,8,6,10,28,29,-1,30
AC Horsens,6101,7,5,14,11,33,54,-21,29
Lyngby,6101,8,4,9,11,28,45,-17,21
Randers FC,6101,9,5,6,13,24,41,-17,21
Silkeborg IF,6101,10,5,4,13,25,44,-19,19
AGF Aarhus,6101,11,4,7,11,16,36,-20,19
Brondby,6102,1,19,6,5,72,37,35,63
FC Midtjylla,6102,2,18,6,6,65,41,24,60
FC Nords,6102,3,15,7,8,73,49,24,52
Copenhagen,6102,4,14,6,10,62,45,17,48
AaB,6102,5,10,11,9,40,44,-4,41
Sonderjyske,6102,6,8,6,10,28,29,-1,30
AC Horsens,6102,7,6,12,12,33,55,-22,30
Randers FC,6102,8,5,7,12,23,39,-16,22
Silkeborg IF,6102,9,6,3,13,27,45,-18,21
Lyngby,6102,10,3,10,11,26,44,-18,19
AGF Aarhus,6102,11,4,6,12,17,38,-21,18
FC Midtjylla,6103,1,21,5,4,71,35,36,68
Brondby,6103,2,20,7,3,66,30,36,67
FC Nords,6103,3,14,7,9,71,51,20,49
Copenhagen,6103,4,13,5,12,56,47,9,44
AaB,6103,5,7,13,10,35,42,-7,34
AC Horsens,6103,6,6,13,11,31,51,-20,31
Sonderjyske,6103,7,8,6,10,28,29,-1,30
Randers FC,6103,8,5,7,12,23,39,-16,22
AGF Aarhus,6103,9,5,6,11,19,37,-18,21
Lyngby,6103,10,3,10,11,26,44,-18,19
Silkeborg IF,6103,11,5,3,14,26,47,-21,18
Brondby,6104,1,22,6,2,82,32,50,72
FC Midtjylla,6104,2,20,5,5,64,41,23,65
FC Nords,6104,3,14,6,10,71,55,16,48
Copenhagen,6104,4,13,6,11,55,44,11,45
AC Horsens,6104,5,6,14,10,35,53,-18,32
AaB,6104,6,6,13,11,36,44,-8,31
Sonderjyske,6104,7,8,6,10,28,29,-1,30
Randers FC,6104,8,6,6,12,26,40,-14,24
Silkeborg IF,6104,9,6,3,13,28,44,-16,21
Lyngby,6104,10,3,9,12,27,47,-20,18
AGF Aarhus,6104,11,4,6,12,16,39,-23,18
Brondby,6105,1,21,7,2,70,30,40,70
FC Midtjylla,6105,2,18,5,7,67,47,20,59
Copenhagen,6105,3,14,6,10,58,42,16,48
FC Nords,6105,4,13,8,9,70,51,19,47
AaB,6105,5,7,13,10,39,45,-6,34
AC Horsens,6105,6,6,15,9,37,52,-15,33
Sonderjyske,6105,7,8,6,10,28,29,-1,30
Randers FC,6105,8,5,7,12,26,42,-16,22
Silkeborg IF,6105,9,6,3,13,30,44,-14,21
Lyngby,6105,10,3,10,11,29,47,-18,19
AGF Aarhus,6105,11,4,6,12,16,41,-25,18
Brondby,6106,1,21,6,3,69,30,39,69
FC Midtjylla,6106,2,20,4,6,69,39,30,64
FC Nords,6106,3,15,7,8,69,49,20,52
Copenhagen,6106,4,14,5,11,60,46,14,47
AaB,6106,5,7,11,12,37,48,-11,32
AC Horsens,6106,6,6,13,11,37,55,-18,31
Sonderjyske,6106,7,8,6,10,28,29,-1,30
Randers FC,6106,8,6,6,12,26,41,-15,24
Silkeborg IF,6106,9,6,3,13,27,45,-18,21
Lyngby,6106,10,3,9,12,28,47,-19,18
AGF Aarhus,6106,11,4,6,12,17,38,-21,18
Brondby,6107,1,21,5,4,75,34,41,68
FC Midtjylla,6107,2,20,4,6,65,43,22,64
Copenhagen,6107,3,16,5,9,61,43,18,53
FC Nords,6107,4,14,7,9,75,51,24,49
AC Horsens,6107,5,6,13,11,36,56,-20,31
Sonderjyske,6107,6,8,6,10,28,29,-1,30
AaB,6107,7,6,12,12,38,49,-11,30
Randers FC,6107,8,5,7,12,24,40,-16,22
AGF Aarhus,6107,9,5,6,11,18,37,-19,21
Lyngby,6107,10,3,10,11,27,45,-18,19
Silkeborg IF,6107,11,5,3,14,26,46,-20,18
Brondby,6108,1,22,6,2,77,30,47,72
FC Midtjylla,6108,2,20,5,5,64,38,26,65
FC Nords,6108,3,14,7,9,72,52,20,49
Copenhagen,6108,4,14,5,11,57,45,12,47
AC Horsens,6108,5,6,13,11,33,53,-20,31
Sonderjyske,6108,6,8,6,10,28,29,-1,30
AaB,6108,7,6,12,12,33,44,-11,30
Lyngby,6108,8,4,9,11,30,46,-16,21
Randers FC,6108,9,5,6,13,25,43,-18,21
Silkeborg IF,6108,10,5,4,13,26,45,-19,19
AGF Aarhus,6108,11,4,7,11,17,37,-20,19
Brondby,6109,1,20,6,4,70,34,36,66
FC Midtjylla,6109,2,20,6,4,67,36,31,66
FC Nords,6109,3,13,7,10,67,52,15,46
Copenhagen,6109,4,13,4,13,57,49,8,43
AaB,6109,5,9,13,8,41,40,1,40
AC Horsens,6109,6,7,12,11,35,52,-17,33
Sonderjyske,6109,7,8,6,10,28,29,-1,30
Randers FC,6109,8,6,6,12,26,40,-14,24
Silkeborg IF,6109,9,6,3,13,27,44,-17,21
Lyngby,6109,10,3,9,12,27,47,-20,18
AGF Aarhus,6109,11,4,6,12,16,38,-22,18
Brondby,6110,1,20,6,4,73,34,39,66
FC Midtjylla,6110,2,20,5,5,65,37,28,65
FC Nords,6110,3,16,6,8,73,47,26,54
Copenhagen,6110,4,14,5,11,55,43,12,47
AaB,6110,5,7,12,11,35,43,-8,33
Sonderjyske,6110,6,8,6,10,28,29,-1,30
AC Horsens,6110,7,6,12,12,33,56,-23,30
Lyngby,6110,8,4,9,11,27,44,-17,21
Randers FC,6110,9,5,6,13,23,40,-17,21
AGF Aarhus,6110,10,5,6,11,18,37,-19,21
Silkeborg IF,6110,11,5,3,14,26,46,-20,18
Brondby,6111,1,20,6,4,71,36,35,66
FC Midtjylla,6111,2,18,6,6,61,38,23,60
FC Nords,6111,3,16,7,7,77,47,30,55
Copenhagen,6111,4,13,7,10,57,48,9,46
AaB,6111,5,7,13,10,39,44,-5,34
Sonderjyske,6111,6,8,6,10,28,29,-1,30
AC Horsens,6111,7,5,15,10,36,54,-18,30
Randers FC,6111,8,6,6,12,24,39,-15,24
AGF Aarhus,6111,9,5,6,11,18,37,-19,21
Lyngby,6111,10,3,9,12,26,45,-19,18
Silkeborg IF,6111,11,5,3,14,26,46,-20,18
FC Midtjylla,6112,1,19,6,5,65,37,28,63
Brondby,6112,2,19,5,6,67,36,31,62
FC Nords,6112,3,16,7,7,73,46,27,55
Copenhagen,6112,4,15,5,10,61,45,16,50
AaB,6112,5,7,12,11,35,45,-10,33
AC Horsens,6112,6,6,13,11,36,54,-18,31
Sonderjyske,6112,7,8,6,10,28,29,-1,30
Randers FC,6112,8,6,6,12,25,39,-14,24
AGF Aarhus,6112,9,5,6,11,20,36,-16,21
Lyngby,6112,10,3,9,12,26,46,-20,18
Silkeborg IF,6112,11,5,3,14,25,48,-23,18
Brondby,6113,1,20,8,2,75,32,43,68
FC Midtjylla,6113,2,19,7,4,66,38,28,64
FC Nords,6113,3,14,7,9,73,53,20,49
Copenhagen,6113,4,12,4,14,52,49,3,40
AaB,6113,5,8,14,8,39,40,-1,38
AC Horsens,6113,6,6,14,10,33,52,-19,32
Sonderjyske,6113,7,8,6,10,28,29,-1,30
Randers FC,6113,8,6,6,12,24,39,-15,24
AGF Aarhus,6113,9,5,6,11,19,37,-18,21
Lyngby,6113,10,3,9,12,26,45,-19,18
Silkeborg IF,6113,11,5,3,14,26,47,-21,18
Brondby,6114,1,21,6,3,70,34,36,69
FC Midtjylla,6114,2,19,5,6,64,41,23,62
FC Nords,6114,3,15,6,9,76,54,22,51
Copenhagen,6114,4,14,5,11,61,44,17,47
AC Horsens,6114,5,7,13,10,38,54,-16,34
AaB,6114,6,6,13,11,39,47,-8,31
Sonderjyske,6114,7,8,6,10,28,29,-1,30
Lyngby,6114,8,4,9,11,28,44,-16,21
Randers FC,6114,9,5,6,13,23,41,-18,21
AGF Aarhus,6114,10,5,6,11,18,37,-19,21
Silkeborg IF,6114,11,5,3,14,26,46,-20,18
Brondby,6115,1,21,6,3,71,31,40,69
FC Midtjylla,6115,2,20,4,6,62,37,25,64
Copenhagen,6115,3,16,4,10,58,42,16,52
FC Nords,6115,4,14,7,9,72,51,21,49
AC Horsens,6115,5,6,13,11,34,52,-18,31
Sonderjyske,6115,6,8,6,10,28,29,-1,30
AaB,6115,7,6,12,12,34,44,-10,30
Lyngby,6115,8,4,9,11,29,45,-16,21
Randers FC,6115,9,5,6,13,24,42,-18,21
AGF Aarhus,6115,10,5,6,11,18,37,-19,21
Silkeborg IF,6115,11,5,3,14,26,46,-20,18
Brondby,6116,1,22,5,3,69,30,39,71
FC Midtjylla,6116,2,20,4,6,64,36,28,64
FC Nords,6116,3,15,6,9,72,51,21,51
Copenhagen,6116,4,13,5,12,52,41,11,44
AaB,6116,5,7,12,11,33,42,-9,33
AC Horsens,6116,6,7,12,11,36,52,-16,33
Sonderjyske,6116,7,8,6,10,28,29,-1,30
Lyngby,6116,8,4,9,11,28,45,-17,21
Randers FC,6116,9,5,6,13,24,41,-17,21
AGF Aarhus,6116,10,5,6,11,17,36,-19,21
Silkeborg IF,6116,11,5,3,14,25,45,-20,18
Brondby,6117,1,21,7,2,72,32,40,70
FC Midtjylla,6117,2,18,5,7,63,44,19,59
Copenhagen,6117,3,15,5,10,61,43,18,50
FC Nords,6117,4,13,10,7,75,50,25,49
AaB,6117,5,7,13,10,39,44,-5,34
Sonderjyske,6117,6,8,6,10,28,29,-1,30
AC Horsens,6117,7,5,14,11,32,55,-23,29
Lyngby,6117,8,4,9,11,28,45,-17,21
Randers FC,6117,9,5,6,13,24,41,-17,21
AGF Aarhus,6117,10,5,6,11,17,36,-19,21
Silkeborg IF,6117,11,5,3,14,25,45,-20,18
Brondby,6118,1,21,6,3,70,33,37,69
FC Midtjylla,6118,2,18,4,8,63,41,22,58
Copenhagen,6118,3,16,4,10,64,44,20,52
FC Nords,6118,4,14,7,9,73,54,19,49
AaB,6118,5,10,11,9,42,41,1,41
Sonderjyske,6118,6,8,6,10,28,29,-1,30
AC Horsens,6118,7,5,12,13,37,62,-25,27
Lyngby,6118,8,4,9,11,28,45,-17,21
Randers FC,6118,9,5,6,13,24,41,-17,21
AGF Aarhus,6118,10,5,6,11,18,36,-18,21
Silkeborg IF,6118,11,5,3,14,25,46,-21,18
Brondby,6119,1,20,6,4,70,36,34,66
FC Midtjylla,6119,2,20,4,6,64,41,23,64
FC Nords,6119,3,15,6,9,73,50,23,51
Copenhagen,6119,4,15,5,10,62,42,20,50
AaB,6119,5,7,12,11,38,48,-10,33
AC Horsens,6119,6,6,13,11,36,52,-16,31
Sonderjyske,6119,7,8,6,10,28,29,-1,30
Lyngby,6119,8,4,9,11,29,45,-16,21
Silkeborg IF,6119,9,6,3,13,27,45,-18,21
Randers FC,6119,10,5,6,13,24,42,-18,21
AGF Aarhus,6119,11,4,6,12,17,38,-21,18
Brondby,6120,1,22,5,3,69,31,38,71
FC Midtjylla,6120,2,20,4,6,72,40,32,64
FC Nords,6120,3,14,7,9,70,48,22,49
Copenhagen,6120,4,13,5,12,54,45,9,44
AC Horsens,6120,5,8,12,10,36,49,-13,36
AaB,6120,6,6,13,11,35,49,-14,31
Sonderjyske,6120,7,8,6,10,28,29,-1,30
Lyngby,6120,8,4,9,11,28,44,-16,21
Silkeborg IF,6120,9,6,3,13,27,45,-18,21
Randers FC,6120,10,5,6,13,23,41,-18,21
AGF Aarhus,6120,11,4,6,12,17,38,-21,18
Brondby,6121,1,23,5,2,77,31,46,74
FC Midtjylla,6121,2,17,5,8,64,48,16,56
FC Nords,6121,3,15,7,8,75,54,21,52
Copenhagen,6121,4,13,5,12,61,50,11,44
AC Horsens,6121,5,8,12,10,39,51,-12,36
AaB,6121,6,6,14,10,41,49,-8,32
Sonderjyske,6121,7,8,6,10,28,29,-1,30
Randers FC,6121,8,5,7,12,23,39,-16,22
AGF Aarhus,6121,9,5,6,11,19,37,-18,21
Lyngby,6121,10,3,10,11,26,44,-18,19
Silkeborg IF,6121,11,5,3,14,26,47,-21,18
Brondby,6122,1,21,6,3,75,35,40,69
FC Midtjylla,6122,2,19,5,6,69,42,27,62
FC Nords,6122,3,12,10,8,72,53,19,46
Copenhagen,6122,4,13,6,11,63,52,11,45
AaB,6122,5,8,12,10,39,44,-5,36
AC Horsens,6122,6,6,15,9,37,55,-18,33
Sonderjyske,6122,7,8,6,10,28,29,-1,30
Lyngby,6122,8,4,9,11,28,44,-16,21
Silkeborg IF,6122,9,6,3,13,27,45,-18,21
Randers FC,6122,10,5,6,13,23,41,-18,21
AGF Aarhus,6122,11,4,6,12,17,38,-21,18
Brondby,6123,1,20,6,4,73,36,37,66
FC Midtjylla,6123,2,18,7,5,69,44,25,61
Copenhagen,6123,3,14,6,10,63,50,13,48
FC Nords,6123,4,13,6,11,67,53,14,45
AaB,6123,5,9,12,9,40,44,-4,39
AC Horsens,6123,6,7,13,10,41,52,-11,34
Sonderjyske,6123,7,8,6,10,28,29,-1,30
Randers FC,6123,8,6,6,12,25,40,-15,24
Silkeborg IF,6123,9,5,4,13,27,46,-19,19
AGF Aarhus,6123,10,4,7,11,18,38,-20,19
Lyngby,6123,11,3,9,12,27,46,-19,18
Brondby,6124,1,22,6,2,78,33,45,72
FC Midtjylla,6124,2,19,6,5,63,38,25,63
Copenhagen,6124,3,14,6,10,58,44,14,48
FC Nords,6124,4,12,9,9,69,50,19,45
AaB,6124,5,7,11,12,37,47,-10,32
AC Horsens,6124,6,6,14,10,33,52,-19,32
Sonderjyske,6124,7,8,6,10,28,29,-1,30
Randers FC,6124,8,6,6,12,24,39,-15,24
Silkeborg IF,6124,9,6,3,13,28,46,-18,21
Lyngby,6124,10,3,9,12,26,45,-19,18
AGF Aarhus,6124,11,4,6,12,18,39,-21,18
FC Midtjylla,6125,1,21,5,4,71,40,31,68
Brondby,6125,2,20,6,4,70,35,35,66
FC Nords,6125,3,13,6,11,72,55,17,45
Copenhagen,6125,4,13,5,12,55,46,9,44
AaB,6125,5,8,14,8,42,41,1,38
AC Horsens,6125,6,7,12,11,38,57,-19,33
Sonderjyske,6125,7,8,6,10,28,29,-1,30
Lyngby,6125,8,4,9,11,29,46,-17,21
Randers FC,6125,9,5,6,13,25,42,-17,21
AGF Aarhus,6125,10,5,6,11,17,36,-19,21
Silkeborg IF,6125,11,5,3,14,25,45,-20,18
Brondby,6126,1,22,5,3,75,30,45,71
FC Midtjylla,6126,2,19,5,6,67,40,27,62
Copenhagen,6126,3,16,5,9,60,41,19,53
FC Nords,6126,4,14,6,10,74,55,19,48
AC Horsens,6126,5,7,12,11,35,55,-20,33
Sonderjyske,6126,6,8,6,10,28,29,-1,30
AaB,6126,7,6,11,13,33,49,-16,29
Lyngby,6126,8,4,9,11,29,44,-15,21
Silkeborg IF,6126,9,6,3,13,26,44,-18,21
Randers FC,6126,10,5,6,13,23,42,-19,21
AGF Aarhus,6126,11,4,6,12,16,37,-21,18
Brondby,6127,1,21,5,4,69,33,36,68
FC Midtjylla,6127,2,17,6,7,64,45,19,57
FC Nords,6127,3,14,9,7,81,53,28,51
Copenhagen,6127,4,13,7,10,61,48,13,46
AaB,6127,5,7,15,8,39,42,-3,36
AC Horsens,6127,6,6,14,10,37,56,-19,32
Sonderjyske,6127,7,8,6,10,28,29,-1,30
Lyngby,6127,8,4,9,11,29,45,-16,21
Randers FC,6127,9,5,6,13,24,42,-18,21
AGF Aarhus,6127,10,5,6,11,18,36,-18,21
Silkeborg IF,6127,11,5,3,14,25,46,-21,18
Brondby,6128,1,22,5,3,73,31,42,71
FC Midtjylla,6128,2,21,4,5,69,37,32,67
FC Nords,6128,3,15,6,9,70,48,22,51
Copenhagen,6128,4,13,5,12,55,44,11,44
AaB,6128,5,7,12,11,38,45,-7,33
Sonderjyske,6128,6,8,6,10,28,29,-1,30
AC Horsens,6128,7,5,14,11,32,58,-26,29
Lyngby,6128,8,4,9,11,29,44,-15,21
Randers FC,6128,9,5,6,13,23,42,-19,21
AGF Aarhus,6128,10,5,6,11,18,37,-19,21
Silkeborg IF,6128,11,5,3,14,26,46,-20,18
FC Midtjylla,6129,1,20,5,5,66,36,30,65
Brondby,6129,2,19,7,4,70,36,34,64
FC Nords,6129,3,14,6,10,68,52,16,48
Copenhagen,6129,4,14,6,10,56,42,14,48
AaB,6129,5,8,12,10,38,42,-4,36
AC Horsens,6129,6,6,14,10,36,52,-16,32
Sonderjyske,6129,7,8,6,10,28,29,-1,30
Randers FC,6129,8,5,7,12,25,41,-16,22
AGF Aarhus,6129,9,5,6,11,20,38,-18,21
Lyngby,6129,10,3,10,11,28,46,-18,19
Silkeborg IF,6129,11,5,3,14,27,48,-21,18
Brondby,6130,1,20,7,3,71,36,35,67
FC Midtjylla,6130,2,18,6,6,66,45,21,60
Copenhagen,6130,3,16,4,10,62,45,17,52
FC Nords,6130,4,13,7,10,75,56,19,46
AaB,6130,5,8,13,9,41,41,0,37
AC Horsens,6130,6,6,13,11,35,53,-18,31
Sonderjyske,6130,7,8,6,10,28,29,-1,30
Randers FC,6130,8,6,6,12,25,40,-15,24
Silkeborg IF,6130,9,5,4,13,26,45,-19,19
AGF Aarhus,6130,10,4,7,11,17,37,-20,19
Lyngby,6130,11,3,9,12,27,46,-19,18
Brondby,6131,1,21,5,4,69,32,37,68
FC Midtjylla,6131,2,20,4,6,70,42,28,64
Copenhagen,6131,3,15,6,9,59,41,18,51
FC Nords,6131,4,12,8,10,70,58,12,44
AaB,6131,5,8,12,10,36,39,-3,36
Sonderjyske,6131,6,8,6,10,28,29,-1,30
AC Horsens,6131,7,5,15,10,33,51,-18,30
Lyngby,6131,8,4,9,11,32,45,-13,21
AGF Aarhus,6131,9,5,6,11,18,37,-19,21
Randers FC,6131,10,5,6,13,24,45,-21,21
Silkeborg IF,6131,11,5,3,14,26,46,-20,18
Brondby,6132,1,23,5,2,76,30,46,74
FC Midtjylla,6132,2,19,5,6,65,46,19,62
Copenhagen,6132,3,14,5,11,59,48,11,47
FC Nords,6132,4,13,7,10,73,51,22,46
AaB,6132,5,8,12,10,39,43,-4,36
Sonderjyske,6132,6,8,6,10,28,29,-1,30
AC Horsens,6132,7,6,12,12,34,54,-20,30
Randers FC,6132,8,6,6,12,26,40,-14,24
Silkeborg IF,6132,9,6,3,13,28,46,-18,21
Lyngby,6132,10,3,9,12,27,47,-20,18
AGF Aarhus,6132,11,4,6,12,18,39,-21,18
Brondby,6133,1,21,5,4,71,35,36,68
FC Midtjylla,6133,2,20,5,5,66,35,31,65
FC Nords,6133,3,15,6,9,76,54,22,51
Copenhagen,6133,4,14,5,11,57,44,13,47
AC Horsens,6133,5,7,14,9,36,48,-12,35
Sonderjyske,6133,6,8,6,10,28,29,-1,30
AaB,6133,7,6,11,13,34,50,-16,29
Lyngby,6133,8,4,9,11,30,46,-16,21
Silkeborg IF,6133,9,6,3,13,28,46,-18,21
Randers FC,6133,10,5,6,13,25,43,-18,21
AGF Aarhus,6133,11,4,6,12,18,39,-21,18
Brondby,6134,1,20,5,5,67,32,35,65
FC Midtjylla,6134,2,18,5,7,62,39,23,59
FC Nords,6134,3,15,8,7,74,49,25,53
Copenhagen,6134,4,15,4,11,58,45,13,49
AaB,6134,5,8,11,11,37,44,-7,35
AC Horsens,6134,6,7,13,10,37,52,-15,34
Sonderjyske,6134,7,8,6,10,28,29,-1,30
Randers FC,6134,8,5,7,12,24,40,-16,22
AGF Aarhus,6134,9,5,6,11,19,36,-17,21
Lyngby,6134,10,3,10,11,27,45,-18,19
Silkeborg IF,6134,11,5,3,14,25,47,-22,18
Brondby,6135,1,21,6,3,69,29,40,69
FC Midtjylla,6135,2,18,4,8,62,40,22,58
Copenhagen,6135,3,15,5,10,59,45,14,50
FC Nords,6135,4,14,7,9,72,50,22,49
AC Horsens,6135,5,7,14,9,35,49,-14,35
AaB,6135,6,7,12,11,36,46,-10,33
Sonderjyske,6135,7,8,6,10,28,29,-1,30
Randers FC,6135,8,6,6,12,24,39,-15,24
AGF Aarhus,6135,9,5,6,11,17,36,-19,21
Lyngby,6135,10,3,9,12,26,45,-19,18
Silkeborg IF,6135,11,5,3,14,25,45,-20,18
Brondby,6136,1,19,7,4,70,38,32,64
FC Midtjylla,6136,2,19,4,7,65,44,21,61
Copenhagen,6136,3,16,5,9,64,40,24,53
FC Nords,6136,4,15,6,9,77,55,22,51
AaB,6136,5,7,13,10,40,46,-6,34
AC Horsens,6136,6,6,13,11,33,52,-19,31
Sonderjyske,6136,7,8,6,10,28,29,-1,30
Lyngby,6136,8,4,9,11,27,44,-17,21
Randers FC,6136,9,5,6,13,23,40,-17,21
Silkeborg IF,6136,10,6,3,13,26,44,-18,21
AGF Aarhus,6136,11,4,6,12,16,37,-21,18
Brondby,6137,1,20,8,2,72,33,39,68
FC Midtjylla,6137,2,19,4,7,64,38,26,61
FC Nords,6137,3,14,7,9,76,53,23,49
Copenhagen,6137,4,15,4,11,58,46,12,49
AC Horsens,6137,5,7,13,10,39,55,-16,34
AaB,6137,6,7,12,11,37,47,-10,33
Sonderjyske,6137,7,8,6,10,28,29,-1,30
Randers FC,6137,8,6,6,12,26,41,-15,24
Silkeborg IF,6137,9,5,4,13,25,44,-19,19
AGF Aarhus,6137,10,4,7,11,16,36,-20,19
Lyngby,6137,11,3,9,12,28,47,-19,18
Brondby,6138,1,20,8,2,66,29,37,68
FC Midtjylla,6138,2,21,5,4,66,38,28,68
FC Nords,6138,3,12,8,10,71,54,17,44
Copenhagen,6138,4,13,5,12,55,44,11,44
AaB,6138,5,8,12,10,38,42,-4,36
AC Horsens,6138,6,6,14,10,33,48,-15,32
Sonderjyske,6138,7,8,6,10,28,29,-1,30
Randers FC,6138,8,5,7,12,25,41,-16,22
AGF Aarhus,6138,9,5,6,11,19,38,-19,21
Lyngby,6138,10,3,10,11,28,46,-18,19
Silkeborg IF,6138,11,5,3,14,27,47,-20,18
FC Midtjylla,6139,1,21,4,5,69,40,29,67
Brondby,6139,2,19,7,4,69,35,34,64
FC Nords,6139,3,15,7,8,73,51,22,52
Copenhagen,6139,4,14,4,12,57,44,13,46
AC Horsens,6139,5,7,14,9,36,51,-15,35
Sonderjyske,6139,6,8,6,10,28,29,-1,30
AaB,6139,7,6,12,12,34,43,-9,30
Lyngby,6139,8,4,9,11,29,45,-16,21
Silkeborg IF,6139,9,6,3,13,28,44,-16,21
Randers FC,6139,10,5,6,13,24,42,-18,21
AGF Aarhus,6139,11,4,6,12,16,39,-23,18
Brondby,6140,1,22,5,3,70,31,39,71
FC Midtjylla,6140,2,20,4,6,62,37,25,64
Copenhagen,6140,3,15,4,11,57,42,15,49
FC Nords,6140,4,14,6,10,76,53,23,48
AaB,6140,5,8,12,10,38,41,-3,36
Sonderjyske,6140,6,8,6,10,28,29,-1,30
AC Horsens,6140,7,5,13,12,33,58,-25,28
Randers FC,6140,8,5,7,12,26,42,-16,22
Silkeborg IF,6140,9,6,3,13,28,45,-17,21
Lyngby,6140,10,3,10,11,29,47,-18,19
AGF Aarhus,6140,11,4,6,12,17,39,-22,18
Brondby,6141,1,21,6,3,70,32,38,69
FC Midtjylla,6141,2,18,5,7,59,41,18,59
FC Nords,6141,3,15,7,8,77,49,28,52
Copenhagen,6141,4,15,6,9,60,39,21,51
AaB,6141,5,6,13,11,32,43,-11,31
Sonderjyske,6141,6,8,6,10,28,29,-1,30
AC Horsens,6141,7,5,15,10,32,52,-20,30
Randers FC,6141,8,5,7,12,24,40,-16,22
AGF Aarhus,6141,9,5,6,11,18,37,-19,21
Lyngby,6141,10,3,10,11,27,45,-18,19
Silkeborg IF,6141,11,5,3,14,26,46,-20,18
Brondby,6142,1,21,5,4,73,32,41,68
FC Midtjylla,6142,2,20,4,6,66,38,28,64
Copenhagen,6142,3,15,4,11,57,46,11,49
FC Nords,6142,4,13,6,11,73,55,18,45
AaB,6142,5,8,12,10,37,45,-8,36
AC Horsens,6142,6,7,13,10,33,49,-16,34
Sonderjyske,6142,7,8,6,10,28,29,-1,30
Randers FC,6142,8,5,7,12,24,40,-16,22
Silkeborg IF,6142,9,6,3,13,27,45,-18,21
Lyngby,6142,10,3,10,11,27,45,-18,19
AGF Aarhus,6142,11,4,6,12,17,38,-21,18
Brondby,6143,1,21,5,4,75,36,39,68
FC Midtjylla,6143,2,19,7,4,68,41,27,64
FC Nords,6143,3,15,7,8,77,52,25,52
Copenhagen,6143,4,14,4,12,61,48,13,46
AC Horsens,6143,5,7,13,10,36,53,-17,34
Sonderjyske,6143,6,8,6,10,28,29,-1,30
AaB,6143,7,6,12,12,36,49,-13,30
Lyngby,6143,8,4,9,11,28,45,-17,21
Silkeborg IF,6143,8,6,3,13,28,45,-17,21
Randers FC,6143,10,5,6,13,24,41,-17,21
AGF Aarhus,6143,11,4,6,12,17,39,-22,18
Brondby,6144,1,21,6,3,72,30,42,69
FC Midtjylla,6144,2,19,5,6,69,38,31,62
Copenhagen,6144,3,16,5,9,59,39,20,53
FC Nords,6144,4,15,6,9,73,50,23,51
Sonderjyske,6144,5,8,6,10,28,29,-1,30
AaB,6144,6,6,12,12,34,50,-16,30
AC Horsens,6144,7,5,14,11,31,57,-26,29
Lyngby,6144,8,4,9,11,31,46,-15,21
AGF Aarhus,6144,9,5,6,11,18,36,-18,21
Randers FC,6144,10,5,6,13,25,44,-19,21
Silkeborg IF,6144,11,5,3,14,25,46,-21,18
Brondby,6145,1,20,7,3,70,31,39,67
FC Midtjylla,6145,2,19,5,6,65,40,25,62
FC Nords,6145,3,14,7,9,74,55,19,49
Copenhagen,6145,4,13,6,11,58,46,12,45
AC Horsens,6145,5,8,13,9,39,53,-14,37
AaB,6145,6,7,12,11,36,43,-7,33
Sonderjyske,6145,7,8,6,10,28,29,-1,30
Randers FC,6145,8,6,6,12,26,41,-15,24
Silkeborg IF,6145,9,5,4,13,25,44,-19,19
AGF Aarhus,6145,10,4,7,11,16,36,-20,19
Lyngby,6145,11,3,9,12,28,47,-19,18
Brondby,6146,1,20,6,4,68,31,37,66
FC Midtjylla,6146,2,19,6,5,68,43,25,63
FC Nords,6146,3,16,6,8,78,51,27,54
Copenhagen,6146,4,14,5,11,58,47,11,47
AaB,6146,5,7,12,11,39,47,-8,33
AC Horsens,6146,6,6,13,11,35,53,-18,31
Sonderjyske,6146,7,8,6,10,28,29,-1,30
Randers FC,6146,8,6,6,12,28,43,-15,24
AGF Aarhus,6146,9,5,6,11,18,36,-18,21
Lyngby,6146,10,3,9,12,30,49,-19,18
Silkeborg IF,6146,11,5,3,14,25,46,-21,18
Brondby,6147,1,21,6,3,75,32,43,69
FC Midtjylla,6147,2,20,5,5,67,39,28,65
FC Nords,6147,3,15,7,8,76,51,25,52
Copenhagen,6147,4,12,6,12,54,50,4,42
AaB,6147,5,7,12,11,35,43,-8,33
AC Horsens,6147,6,6,14,10,31,49,-18,32
Sonderjyske,6147,7,8,6,10,28,29,-1,30
Randers FC,6147,8,5,7,12,24,40,-16,22
Lyngby,6147,9,3,10,11,27,45,-18,19
Silkeborg IF,6147,10,5,4,13,25,44,-19,19
AGF Aarhus,6147,11,4,7,11,16,36,-20,19
Brondby,6148,1,22,6,2,73,32,41,72
FC Midtjylla,6148,2,19,4,7,62,41,21,61
FC Nords,6148,3,15,6,9,73,50,23,51
Copenhagen,6148,4,13,4,13,55,46,9,43
AaB,6148,5,9,11,10,39,42,-3,38
AC Horsens,6148,6,6,13,11,35,52,-17,31
Sonderjyske,6148,7,8,6,10,28,29,-1,30
Lyngby,6148,8,4,9,11,29,46,-17,21
Randers FC,6148,9,5,6,13,25,42,-17,21
Silkeborg IF,6148,10,5,4,13,27,46,-19,19
AGF Aarhus,6148,11,4,7,11,18,38,-20,19
Brondby,6149,1,21,6,3,71,34,37,69
FC Midtjylla,6149,2,19,5,6,66,40,26,62
FC Nords,6149,3,14,8,8,77,56,21,50
Copenhagen,6149,4,14,4,12,60,47,13,46
AaB,6149,5,8,13,9,43,46,-3,37
Sonderjyske,6149,6,8,6,10,28,29,-1,30
AC Horsens,6149,7,5,14,11,37,57,-20,29
Randers FC,6149,8,5,7,12,23,39,-16,22
AGF Aarhus,6149,9,5,6,11,17,36,-19,21
Lyngby,6149,10,3,10,11,26,44,-18,19
Silkeborg IF,6149,11,5,3,14,25,45,-20,18
Brondby,6150,1,20,5,5,74,41,33,65
FC Midtjylla,6150,2,20,5,5,66,39,27,65
FC Nords,6150,3,14,7,9,75,50,25,49
Copenhagen,6150,4,13,8,9,60,45,15,47
AC Horsens,6150,5,7,13,10,37,53,-16,34
AaB,6150,6,7,12,11,35,45,-10,33
Sonderjyske,6150,7,8,6,10,28,29,-1,30
Lyngby,6150,8,4,9,11,29,44,-15,21
Silkeborg IF,6150,9,6,3,13,26,44,-18,21
Randers FC,6150,10,5,6,13,23,42,-19,21
AGF Aarhus,6150,11,4,6,12,16,37,-21,18
Brondby,6151,1,20,6,4,71,37,34,66
FC Midtjylla,6151,2,20,5,5,68,39,29,65
FC Nords,6151,3,14,6,10,76,58,18,48
Copenhagen,6151,4,13,4,13,58,47,11,43
AC Horsens,6151,5,8,13,9,35,49,-14,37
AaB,6151,6,8,12,10,36,40,-4,36
Sonderjyske,6151,7,8,6,10,28,29,-1,30
Randers FC,6151,8,6,6,12,25,40,-15,24
Silkeborg IF,6151,9,5,4,13,26,45,-19,19
AGF Aarhus,6151,10,4,7,11,17,37,-20,19
Lyngby,6151,11,3,9,12,27,46,-19,18
Brondby,6152,1,20,7,3,69,33,36,67
FC Midtjylla,6152,2,20,5,5,67,36,31,65
FC Nords,6152,3,16,6,8,75,50,25,54
Copenhagen,6152,4,15,4,11,60,45,15,49
AaB,6152,5,7,11,12,35,48,-13,32
Sonderjyske,6152,6,8,6,10,28,29,-1,30
AC Horsens,6152,7,5,13,12,33,53,-20,28
Lyngby,6152,8,4,9,11,28,45,-17,21
Randers FC,6152,9,5,6,13,24,41,-17,21
Silkeborg IF,6152,10,6,3,13,28,46,-18,21
AGF Aarhus,6152,11,4,6,12,18,39,-21,18
FC Midtjylla,6153,1,21,5,4,76,42,34,68
Brondby,6153,2,20,7,3,71,36,35,67
FC Nords,6153,3,14,6,10,71,55,16,48
Copenhagen,6153,4,13,4,13,56,48,8,43
AaB,6153,5,10,11,9,43,42,1,41
Sonderjyske,6153,6,8,6,10,28,29,-1,30
AC Horsens,6153,7,5,13,12,35,55,-20,28
Randers FC,6153,8,6,6,12,25,40,-15,24
Silkeborg IF,6153,9,6,3,13,27,44,-17,21
Lyngby,6153,10,3,9,12,27,46,-19,18
AGF Aarhus,6153,11,4,6,12,16,38,-22,18
Brondby,6154,1,20,6,4,67,33,34,66
FC Midtjylla,6154,2,19,4,7,62,42,20,61
FC Nords,6154,3,16,6,8,78,49,29,54
Copenhagen,6154,4,13,4,13,51,44,7,43
AaB,6154,5,8,12,10,37,40,-3,36
AC Horsens,6154,6,8,12,10,41,54,-13,36
Sonderjyske,6154,7,8,6,10,28,29,-1,30
Randers FC,6154,8,5,7,12,23,39,-16,22
AGF Aarhus,6154,9,5,6,11,18,36,-18,21
Lyngby,6154,10,3,10,11,26,44,-18,19
Silkeborg IF,6154,11,5,3,14,25,46,-21,18
Brondby,6155,1,22,5,3,78,31,47,71
FC Midtjylla,6155,2,20,4,6,67,41,26,64
FC Nords,6155,3,15,6,9,76,56,20,51
Copenhagen,6155,4,13,4,13,58,51,7,43
AaB,6155,5,8,11,11,38,45,-7,35
AC Horsens,6155,6,7,12,11,37,56,-19,33
Sonderjyske,6155,7,8,6,10,28,29,-1,30
Randers FC,6155,8,6,6,12,25,39,-14,24
AGF Aarhus,6155,9,5,6,11,17,36,-19,21
Lyngby,6155,10,3,9,12,26,46,-20,18
Silkeborg IF,6155,11,5,3,14,25,45,-20,18
Brondby,6156,1,21,5,4,68,30,38,68
FC Midtjylla,6156,2,21,5,4,69,38,31,68
FC Nords,6156,3,15,6,9,77,51,26,51
Copenhagen,6156,4,14,5,11,55,43,12,47
AaB,6156,5,7,12,11,35,45,-10,33
Sonderjyske,6156,6,8,6,10,28,29,-1,30
AC Horsens,6156,7,5,13,12,30,53,-23,28
Lyngby,6156,8,4,9,11,28,45,-17,21
Randers FC,6156,9,5,6,13,24,41,-17,21
AGF Aarhus,6156,10,5,6,11,17,36,-19,21
Silkeborg IF,6156,11,5,3,14,25,45,-20,18
Brondby,6157,1,21,6,3,74,30,44,69
FC Midtjylla,6157,2,20,4,6,69,42,27,64
Copenhagen,6157,3,15,4,11,60,47,13,49
FC Nords,6157,4,13,8,9,71,56,15,47
AaB,6157,5,8,12,10,37,42,-5,36
Sonderjyske,6157,6,8,6,10,28,29,-1,30
AC Horsens,6157,7,5,14,11,34,54,-20,29
Randers FC,6157,8,6,6,12,24,39,-15,24
Silkeborg IF,6157,9,6,3,13,27,45,-18,21
Lyngby,6157,10,3,9,12,26,45,-19,18
AGF Aarhus,6157,11,4,6,12,17,38,-21,18
Brondby,6158,1,20,6,4,72,34,38,66
FC Midtjylla,6158,2,19,4,7,70,48,22,61
FC Nords,6158,3,15,6,9,75,54,21,51
Copenhagen,6158,4,13,5,12,57,47,10,44
AC Horsens,6158,5,8,13,9,36,47,-11,37
AaB,6158,6,8,12,10,39,45,-6,36
Sonderjyske,6158,7,8,6,10,28,29,-1,30
Randers FC,6158,8,6,6,12,28,41,-13,24
Silkeborg IF,6158,9,6,3,13,28,45,-17,21
Lyngby,6158,10,3,9,12,28,49,-21,18
AGF Aarhus,6158,11,4,6,12,17,39,-22,18
Brondby,6159,1,22,6,2,72,31,41,72
FC Midtjylla,6159,2,17,6,7,61,43,18,57
Copenhagen,6159,3,15,5,10,61,42,19,50
FC Nords,6159,4,13,7,10,75,58,17,46
AC Horsens,6159,5,7,14,9,36,50,-14,35
AaB,6159,6,6,14,10,36,43,-7,32
Sonderjyske,6159,7,8,6,10,28,29,-1,30
Randers FC,6159,8,5,7,12,25,41,-16,22
Lyngby,6159,9,3,10,11,28,46,-18,19
Silkeborg IF,6159,10,5,4,13,26,45,-19,19
AGF Aarhus,6159,11,4,7,11,17,37,-20,19
Brondby,6160,1,23,5,2,73,31,42,74
FC Midtjylla,6160,2,21,4,5,72,35,37,67
FC Nords,6160,3,13,8,9,75,55,20,47
Copenhagen,6160,4,12,5,13,54,49,5,41
AaB,6160,5,6,14,10,36,45,-9,32
AC Horsens,6160,6,6,14,10,34,55,-21,32
Sonderjyske,6160,7,8,6,10,28,29,-1,30
Randers FC,6160,8,6,6,12,25,40,-15,24
Silkeborg IF,6160,9,5,4,13,26,45,-19,19
AGF Aarhus,6160,10,4,7,11,17,37,-20,19
Lyngby,6160,11,3,9,12,27,46,-19,18
Brondby,6161,1,21,6,3,69,34,35,69
FC Midtjylla,6161,2,19,5,6,62,37,25,62
FC Nords,6161,3,14,7,9,70,49,21,49
Copenhagen,6161,4,14,5,11,63,46,17,47
AC Horsens,6161,5,8,12,10,36,53,-17,36
AaB,6161,6,7,11,12,35,42,-7,32
Sonderjyske,6161,7,8,6,10,28,29,-1,30
Randers FC,6161,8,5,7,12,25,41,-16,22
Silkeborg IF,6161,9,6,3,13,28,46,-18,21
Lyngby,6161,10,3,10,11,28,46,-18,19
AGF Aarhus,6161,11,4,6,12,18,39,-21,18
Brondby,6162,1,22,6,2,74,29,45,72
FC Midtjylla,6162,2,19,5,6,66,41,25,62
FC Nords,6162,3,13,9,8,75,53,22,48
Copenhagen,6162,4,13,5,12,57,48,9,44
AaB,6162,5,9,11,10,38,42,-4,38
Sonderjyske,6162,6,8,6,10,28,29,-1,30
AC Horsens,6162,7,6,12,12,33,56,-23,30
Lyngby,6162,8,4,9,11,28,44,-16,21
Silkeborg IF,6162,9,6,3,13,26,44,-18,21
Randers FC,6162,10,5,6,13,23,41,-18,21
AGF Aarhus,6162,11,4,6,12,16,37,-21,18
Brondby,6163,1,21,6,3,72,29,43,69
FC Midtjylla,6163,2,20,5,5,70,36,34,65
FC Nords,6163,3,15,6,9,71,51,20,51
Copenhagen,6163,4,12,5,13,53,47,6,41
AaB,6163,5,9,11,10,41,48,-7,38
AC Horsens,6163,6,6,13,11,35,57,-22,31
Sonderjyske,6163,7,8,6,10,28,29,-1,30
Lyngby,6163,8,4,9,11,30,44,-14,21
Randers FC,6163,9,5,6,13,23,43,-20,21
Silkeborg IF,6163,10,5,4,13,26,45,-19,19
AGF Aarhus,6163,11,4,7,11,17,37,-20,19
Brondby,6164,1,22,6,2,69,27,42,72
FC Midtjylla,6164,2,19,5,6,66,41,25,62
Copenhagen,6164,3,15,4,11,57,42,15,49
FC Nords,6164,4,12,7,11,70,53,17,43
AaB,6164,5,8,12,10,36,41,-5,36
AC Horsens,6164,6,7,12,11,38,58,-20,33
Sonderjyske,6164,7,8,6,10,28,29,-1,30
Lyngby,6164,8,4,9,11,29,44,-15,21
Randers FC,6164,9,5,6,13,23,42,-19,21
Silkeborg IF,6164,10,5,4,13,25,44,-19,19
AGF Aarhus,6164,11,4,7,11,16,36,-20,19
Brondby,6165,1,20,7,3,71,34,37,67
FC Midtjylla,6165,2,19,6,5,65,37,28,63
Copenhagen,6165,3,15,5,10,58,44,14,50
FC Nords,6165,4,14,6,10,72,54,18,48
AC Horsens,6165,5,8,12,10,38,53,-15,36
Sonderjyske,6165,6,8,6,10,28,29,-1,30
AaB,6165,7,6,12,12,35,43,-8,30
Lyngby,6165,8,4,9,11,28,44,-16,21
Silkeborg IF,6165,9,6,3,13,28,45,-17,21
Randers FC,6165,10,5,6,13,23,41,-18,21
AGF Aarhus,6165,11,4,6,12,17,39,-22,18
Brondby,6166,1,22,5,3,74,32,42,71
FC Midtjylla,6166,2,20,5,5,65,38,27,65
FC Nords,6166,3,13,6,11,69,54,15,45
Copenhagen,6166,4,13,6,11,55,44,11,45
AaB,6166,5,8,12,10,37,43,-6,36
AC Horsens,6166,6,7,12,11,37,52,-15,33
Sonderjyske,6166,7,8,6,10,28,29,-1,30
Randers FC,6166,8,6,6,12,25,39,-14,24
Silkeborg IF,6166,9,6,3,13,26,44,-18,21
Lyngby,6166,10,3,9,12,26,46,-20,18
AGF Aarhus,6166,11,4,6,12,16,37,-21,18
Brondby,6167,1,20,7,3,70,33,37,67
FC Midtjylla,6167,2,20,5,5,66,37,29,65
FC Nords,6167,3,13,8,9,72,52,20,47
Copenhagen,6167,4,14,4,12,57,47,10,46
AaB,6167,5,7,15,8,37,39,-2,36
AC Horsens,6167,6,6,13,11,35,55,-20,31
Sonderjyske,6167,7,8,6,10,28,29,-1,30
Randers FC,6167,8,5,7,12,25,41,-16,22
Silkeborg IF,6167,9,6,3,13,26,44,-18,21
Lyngby,6167,10,3,10,11,28,46,-18,19
AGF Aarhus,6167,11,4,6,12,16,37,-21,18
Brondby,6168,1,20,7,3,66,30,36,67
FC Midtjylla,6168,2,20,4,6,67,39,28,64
FC Nords,6168,3,15,6,9,74,52,22,51
Copenhagen,6168,4,13,5,12,57,47,10,44
AaB,6168,5,8,12,10,36,41,-5,36
AC Horsens,6168,6,6,14,10,34,51,-17,32
Sonderjyske,6168,7,8,6,10,28,29,-1,30
Randers FC,6168,8,5,7,12,24,40,-16,22
Lyngby,6168,9,3,10,11,27,45,-18,19
Silkeborg IF,6168,10,5,4,13,27,46,-19,19
AGF Aarhus,6168,11,4,7,11,18,38,-20,19
Brondby,6169,1,20,6,4,68,32,36,66
FC Midtjylla,6169,2,19,4,7,61,37,24,61
Copenhagen,6169,3,15,4,11,60,45,15,49
FC Nords,6169,4,14,6,10,72,54,18,48
AaB,6169,5,10,11,9,39,40,-1,41
AC Horsens,6169,6,6,13,11,38,56,-18,31
Sonderjyske,6169,7,8,6,10,28,29,-1,30
Lyngby,6169,8,4,9,11,28,45,-17,21
Randers FC,6169,9,5,6,13,24,41,-17,21
Silkeborg IF,6169,10,5,4,13,25,44,-19,19
AGF Aarhus,6169,11,4,7,11,16,36,-20,19
Brondby,6170,1,21,6,3,74,34,40,69
FC Midtjylla,6170,2,20,6,4,66,36,30,66
Copenhagen,6170,3,15,5,10,56,41,15,50
FC Nords,6170,4,14,6,10,79,59,20,48
AC Horsens,6170,5,7,12,11,38,55,-17,33
Sonderjyske,6170,6,8,6,10,28,29,-1,30
AaB,6170,7,6,11,13,34,48,-14,29
Lyngby,6170,8,4,9,11,28,44,-16,21
Randers FC,6170,9,5,6,13,23,41,-18,21
AGF Aarhus,6170,10,5,6,11,17,36,-19,21
Silkeborg IF,6170,11,5,3,14,25,45,-20,18
Brondby,6171,1,21,5,4,69,33,36,68
FC Midtjylla,6171,2,20,4,6,69,42,27,64
FC Nords,6171,3,16,6,8,76,47,29,54
Copenhagen,6171,4,14,5,11,57,45,12,47
AaB,6171,5,7,11,12,33,46,-13,32
AC Horsens,6171,6,6,13,11,34,51,-17,31
Sonderjyske,6171,7,8,6,10,28,29,-1,30
Randers FC,6171,8,6,6,12,24,39,-15,24
Silkeborg IF,6171,9,6,3,13,28,44,-16,21
Lyngby,6171,10,3,9,12,26,45,-19,18
AGF Aarhus,6171,11,4,6,12,16,39,-23,18
Brondby,6172,1,20,8,2,74,34,40,68
FC Midtjylla,6172,2,20,5,5,61,34,27,65
FC Nords,6172,3,15,8,7,77,52,25,53
Copenhagen,6172,4,13,4,13,56,48,8,43
AaB,6172,5,7,12,11,38,44,-6,33
AC Horsens,6172,6,6,13,11,34,54,-20,31
Sonderjyske,6172,7,8,6,10,28,29,-1,30
Randers FC,6172,8,5,7,12,24,40,-16,22
Lyngby,6172,9,3,10,11,27,45,-18,19
Silkeborg IF,6172,10,5,4,13,27,46,-19,19
AGF Aarhus,6172,11,4,7,11,18,38,-20,19
Brondby,6173,1,21,6,3,71,31,40,69
FC Midtjylla,6173,2,20,4,6,63,39,24,64
FC Nords,6173,3,14,7,9,77,55,22,49
Copenhagen,6173,4,14,4,12,56,45,11,46
AC Horsens,6173,5,7,13,10,37,52,-15,34
AaB,6173,6,7,12,11,33,41,-8,33
Sonderjyske,6173,7,8,6,10,28,29,-1,30
Randers FC,6173,8,6,6,12,24,39,-15,24
Silkeborg IF,6173,9,6,3,13,29,44,-15,21
Lyngby,6173,10,3,9,12,26,45,-19,18
AGF Aarhus,6173,11,4,6,12,16,40,-24,18
Brondby,6174,1,20,7,3,67,32,35,67
FC Midtjylla,6174,2,18,7,5,61,36,25,61
Copenhagen,6174,3,14,7,9,55,39,16,49
FC Nords,6174,4,13,8,9,72,51,21,47
AaB,6174,5,8,14,8,37,38,-1,38
Sonderjyske,6174,6,8,6,10,28,29,-1,30
AC Horsens,6174,7,5,13,12,34,56,-22,28
Lyngby,6174,8,4,9,11,29,44,-15,21
Silkeborg IF,6174,9,6,3,13,26,44,-18,21
Randers FC,6174,10,5,6,13,23,42,-19,21
AGF Aarhus,6174,11,4,6,12,16,37,-21,18
Brondby,6175,1,21,5,4,73,35,38,68
FC Midtjylla,6175,2,17,5,8,64,46,18,56
FC Nords,6175,3,14,7,9,82,55,27,49
Copenhagen,6175,4,15,4,11,61,48,13,49
AaB,6175,5,9,11,10,39,44,-5,38
AC Horsens,6175,6,8,12,10,39,56,-17,36
Sonderjyske,6175,7,8,6,10,28,29,-1,30
Randers FC,6175,8,5,7,12,25,41,-16,22
Silkeborg IF,6175,9,6,3,13,27,45,-18,21
Lyngby,6175,10,3,10,11,28,46,-18,19
AGF Aarhus,6175,11,4,6,12,17,38,-21,18
Brondby,6176,1,21,6,3,73,37,36,69
FC Midtjylla,6176,2,18,6,6,66,40,26,60
Copenhagen,6176,3,15,5,10,57,42,15,50
FC Nords,6176,4,14,6,10,72,54,18,48
AC Horsens,6176,5,8,12,10,42,53,-11,36
AaB,6176,6,6,13,11,38,48,-10,31
Sonderjyske,6176,7,8,6,10,28,29,-1,30
Lyngby,6176,8,4,9,11,29,46,-17,21
Randers FC,6176,9,5,6,13,25,42,-17,21
Silkeborg IF,6176,10,5,4,13,25,44,-19,19
AGF Aarhus,6176,11,4,7,11,16,36,-20,19
Brondby,6177,1,20,7,3,66,30,36,67
FC Midtjylla,6177,2,20,5,5,62,36,26,65
Copenhagen,6177,3,14,5,11,56,43,13,47
FC Nords,6177,4,13,6,11,68,50,18,45
AC Horsens,6177,5,8,13,9,37,50,-13,37
AaB,6177,6,7,12,11,38,44,-6,33
Sonderjyske,6177,7,8,6,10,28,29,-1,30
Randers FC,6177,8,6,6,12,26,41,-15,24
Silkeborg IF,6177,9,5,4,13,25,44,-19,19
AGF Aarhus,6177,10,4,7,11,16,36,-20,19
Lyngby,6177,11,3,9,12,28,47,-19,18
FC Midtjylla,6178,1,20,6,4,65,37,28,66
Brondby,6178,2,20,5,5,68,34,34,65
FC Nords,6178,3,14,7,9,74,52,22,49
Copenhagen,6178,4,13,5,12,56,48,8,44
AaB,6178,5,8,12,10,37,41,-4,36
AC Horsens,6178,6,7,13,10,35,49,-14,34
Sonderjyske,6178,7,8,6,10,28,29,-1,30
Randers FC,6178,8,6,6,12,25,39,-14,24
Silkeborg IF,6178,9,6,3,13,26,44,-18,21
Lyngby,6178,10,3,9,12,26,46,-20,18
AGF Aarhus,6178,11,4,6,12,16,37,-21,18
Brondby,6179,1,21,6,3,74,33,41,69
FC Midtjylla,6179,2,19,5,6,60,38,22,62
FC Nords,6179,3,14,7,9,68,48,20,49
Copenhagen,6179,4,15,4,11,58,43,15,49
AC Horsens,6179,5,6,15,9,37,51,-14,33
AaB,6179,6,6,13,11,33,43,-10,31
Sonderjyske,6179,7,8,6,10,28,29,-1,30
Randers FC,6179,8,5,7,12,24,40,-16,22
Silkeborg IF,6179,9,6,3,13,27,45,-18,21
Lyngby,6179,10,3,10,11,27,45,-18,19
AGF Aarhus,6179,11,4,6,12,17,38,-21,18
Brondby,6180,1,22,6,2,74,31,43,72
FC Midtjylla,6180,2,20,4,6,68,41,27,64
FC Nords,6180,3,14,7,9,71,47,24,49
Copenhagen,6180,4,14,5,11,55,42,13,47
AaB,6180,5,7,11,12,35,45,-10,32
AC Horsens,6180,6,6,13,11,33,56,-23,31
Sonderjyske,6180,7,8,6,10,28,29,-1,30
Lyngby,6180,8,4,9,11,28,45,-17,21
Silkeborg IF,6180,8,6,3,13,28,45,-17,21
Randers FC,6180,10,5,6,13,24,41,-17,21
AGF Aarhus,6180,11,4,6,12,17,39,-22,18
Brondby,6181,1,23,5,2,77,29,48,74
FC Midtjylla,6181,2,18,5,7,59,39,20,59
FC Nords,6181,3,15,6,9,75,58,17,51
Copenhagen,6181,4,13,4,13,57,48,9,43
AaB,6181,5,9,12,9,44,43,1,39
Sonderjyske,6181,6,8,6,10,28,29,-1,30
AC Horsens,6181,7,6,12,12,35,56,-21,30
Randers FC,6181,8,5,7,12,24,40,-16,22
Silkeborg IF,6181,9,6,3,13,27,45,-18,21
Lyngby,6181,10,3,10,11,27,45,-18,19
AGF Aarhus,6181,11,4,6,12,17,38,-21,18
Brondby,6182,1,21,6,3,76,34,42,69
FC Midtjylla,6182,2,20,4,6,67,41,26,64
Copenhagen,6182,3,15,5,10,57,41,16,50
FC Nords,6182,4,13,8,9,69,52,17,47
AaB,6182,5,8,12,10,38,42,-4,36
Sonderjyske,6182,6,8,6,10,28,29,-1,30
AC Horsens,6182,7,5,13,12,31,54,-23,28
Lyngby,6182,8,4,9,11,28,44,-16,21
Silkeborg IF,6182,9,6,3,13,26,44,-18,21
Randers FC,6182,10,5,6,13,23,41,-18,21
AGF Aarhus,6182,11,4,6,12,16,37,-21,18
Brondby,6183,1,20,5,5,69,35,34,65
FC Midtjylla,6183,2,20,5,5,68,37,31,65
FC Nords,6183,3,14,7,9,76,55,21,49
Copenhagen,6183,4,14,7,9,60,45,15,49
AC Horsens,6183,5,7,13,10,37,52,-15,34
AaB,6183,6,7,11,12,35,47,-12,32
Sonderjyske,6183,7,8,6,10,28,29,-1,30
Randers FC,6183,8,6,6,12,24,39,-15,24
Silkeborg IF,6183,9,6,3,13,26,44,-18,21
Lyngby,6183,10,3,9,12,26,45,-19,18
AGF Aarhus,6183,11,4,6,12,16,37,-21,18
Brondby,6184,1,21,6,3,68,31,37,69
FC Midtjylla,6184,2,18,4,8,62,43,19,58
FC Nords,6184,3,14,7,9,69,50,19,49
Copenhagen,6184,4,14,4,12,58,45,13,46
AaB,6184,5,8,13,9,40,41,-1,37
AC Horsens,6184,6,7,14,9,38,51,-13,35
Sonderjyske,6184,7,8,6,10,28,29,-1,30
Randers FC,6184,8,5,7,12,25,41,-16,22
AGF Aarhus,6184,9,5,6,11,17,36,-19,21
Lyngby,6184,10,3,10,11,28,46,-18,19
Silkeborg IF,6184,11,5,3,14,25,45,-20,18
Brondby,6185,1,22,6,2,76,28,48,72
FC Midtjylla,6185,2,20,4,6,68,41,27,64
Copenhagen,6185,3,14,5,11,61,50,11,47
FC Nords,6185,4,12,9,9,73,54,19,45
AaB,6185,5,8,11,11,38,48,-10,35
AC Horsens,6185,6,6,13,11,37,58,-21,31
Sonderjyske,6185,7,8,6,10,28,29,-1,30
Lyngby,6185,8,4,9,11,28,44,-16,21
Randers FC,6185,9,5,6,13,23,41,-18,21
AGF Aarhus,6185,10,5,6,11,18,37,-19,21
Silkeborg IF,6185,11,5,3,14,26,46,-20,18
FC Midtjylla,6186,1,22,4,4,71,39,32,70
Brondby,6186,2,21,6,3,71,30,41,69
FC Nords,6186,3,14,6,10,74,53,21,48
Copenhagen,6186,4,12,4,14,55,56,-1,40
AaB,6186,5,8,11,11,40,44,-4,35
AC Horsens,6186,6,7,13,10,39,54,-15,34
Sonderjyske,6186,7,8,6,10,28,29,-1,30
Randers FC,6186,8,6,6,12,27,41,-14,24
Silkeborg IF,6186,9,6,3,13,27,45,-18,21
Lyngby,6186,10,3,9,12,28,48,-20,18
AGF Aarhus,6186,11,4,6,12,17,38,-21,18
Brondby,6187,1,20,6,4,67,32,35,66
FC Midtjylla,6187,2,19,5,6,68,43,25,62
Copenhagen,6187,3,14,6,10,58,43,15,48
FC Nords,6187,4,12,9,9,71,53,18,45
AaB,6187,5,8,13,9,40,43,-3,37
AC Horsens,6187,6,6,15,9,33,49,-16,33
Sonderjyske,6187,7,8,6,10,28,29,-1,30
Lyngby,6187,8,4,9,11,28,45,-17,21
Randers FC,6187,9,5,6,13,24,41,-17,21
Silkeborg IF,6187,10,6,3,13,26,44,-18,21
AGF Aarhus,6187,11,4,6,12,16,37,-21,18
Brondby,6188,1,21,6,3,70,31,39,69
FC Midtjylla,6188,2,20,5,5,68,40,28,65
Copenhagen,6188,3,16,4,10,58,40,18,52
FC Nords,6188,4,13,7,10,73,57,16,46
AaB,6188,5,7,12,11,37,44,-7,33
Sonderjyske,6188,6,8,6,10,28,29,-1,30
AC Horsens,6188,7,5,14,11,31,51,-20,29
Randers FC,6188,8,6,6,12,25,39,-14,24
Silkeborg IF,6188,9,6,3,13,26,44,-18,21
Lyngby,6188,10,3,9,12,26,46,-20,18
AGF Aarhus,6188,11,4,6,12,16,37,-21,18
FC Midtjylla,6189,1,21,5,4,69,38,31,68
Brondby,6189,2,19,7,4,67,35,32,64
FC Nords,6189,3,15,7,8,74,49,25,52
Copenhagen,6189,4,12,6,12,56,48,8,42
AaB,6189,5,7,13,10,39,44,-5,34
AC Horsens,6189,6,6,14,10,34,51,-17,32
Sonderjyske,6189,7,8,6,10,28,29,-1,30
Lyngby,6189,8,4,9,11,29,44,-15,21
Silkeborg IF,6189,9,6,3,13,27,45,-18,21
Randers FC,6189,10,5,6,13,23,42,-19,21
AGF Aarhus,6189,11,4,6,12,17,38,-21,18
Brondby,6190,1,21,5,4,73,35,38,68
FC Midtjylla,6190,2,20,4,6,65,39,26,64
FC Nords,6190,3,14,6,10,73,53,20,48
Copenhagen,6190,4,14,4,12,58,45,13,46
AaB,6190,5,9,11,10,38,42,-4,38
AC Horsens,6190,6,7,12,11,38,57,-19,33
Sonderjyske,6190,7,8,6,10,28,29,-1,30
Randers FC,6190,8,6,6,12,26,39,-13,24
Silkeborg IF,6190,9,5,4,13,26,45,-19,19
AGF Aarhus,6190,10,4,7,11,17,37,-20,19
Lyngby,6190,11,3,9,12,26,47,-21,18
Brondby,6191,1,22,5,3,67,29,38,71
FC Midtjylla,6191,2,20,4,6,63,38,25,64
FC Nords,6191,3,14,7,9,70,46,24,49
Copenhagen,6191,4,13,5,12,53,46,7,44
AaB,6191,5,8,12,10,35,39,-4,36
AC Horsens,6191,6,6,13,11,34,50,-16,31
Sonderjyske,6191,7,8,6,10,28,29,-1,30
Randers FC,6191,8,5,7,12,25,41,-16,22
Lyngby,6191,9,3,10,11,28,46,-18,19
Silkeborg IF,6191,10,5,4,13,26,45,-19,19
AGF Aarhus,6191,11,4,7,11,17,37,-20,19
Brondby,6192,1,21,6,3,69,32,37,69
FC Midtjylla,6192,2,20,4,6,65,36,29,64
Copenhagen,6192,3,15,4,11,58,46,12,49
FC Nords,6192,4,13,7,10,73,55,18,46
AaB,6192,5,9,12,9,40,39,1,39
Sonderjyske,6192,6,8,6,10,28,29,-1,30
AC Horsens,6192,7,5,13,12,32,55,-23,28
Lyngby,6192,8,4,9,11,29,44,-15,21
Randers FC,6192,9,5,6,13,23,42,-19,21
Silkeborg IF,6192,10,5,4,13,26,45,-19,19
AGF Aarhus,6192,11,4,7,11,17,37,-20,19
FC Midtjylla,6193,1,20,5,5,65,38,27,65
Brondby,6193,2,19,5,6,67,38,29,62
FC Nords,6193,3,14,7,9,73,53,20,49
Copenhagen,6193,4,14,4,12,58,44,14,46
AC Horsens,6193,5,9,12,9,39,49,-10,39
AaB,6193,6,8,11,11,37,43,-6,35
Sonderjyske,6193,7,8,6,10,28,29,-1,30
Lyngby,6193,8,4,9,11,28,45,-17,21
Randers FC,6193,9,5,6,13,24,41,-17,21
AGF Aarhus,6193,10,5,6,11,21,39,-18,21
Silkeborg IF,6193,11,5,3,14,28,49,-21,18
FC Midtjylla,6194,1,22,4,4,67,33,34,70
Brondby,6194,2,19,6,5,67,34,33,63
FC Nords,6194,3,15,6,9,73,53,20,51
Copenhagen,6194,4,13,4,13,55,47,8,43
AaB,6194,5,8,11,11,37,42,-5,35
AC Horsens,6194,6,7,13,10,37,53,-16,34
Sonderjyske,6194,7,8,6,10,28,29,-1,30
Silkeborg IF,6194,8,6,3,13,28,44,-16,21
Lyngby,6194,9,4,9,11,27,44,-17,21
Randers FC,6194,10,5,6,13,23,40,-17,21
AGF Aarhus,6194,11,4,6,12,16,39,-23,18
Brondby,6195,1,21,7,2,74,31,43,70
FC Midtjylla,6195,2,17,7,6,64,44,20,58
Copenhagen,6195,3,15,4,11,61,44,17,49
FC Nords,6195,4,13,8,9,69,51,18,47
AaB,6195,5,9,13,8,40,39,1,40
Sonderjyske,6195,6,8,6,10,28,29,-1,30
AC Horsens,6195,7,5,13,12,31,56,-25,28
Randers FC,6195,8,5,7,12,25,41,-16,22
Silkeborg IF,6195,9,6,3,13,28,46,-18,21
Lyngby,6195,10,3,10,11,28,46,-18,19
AGF Aarhus,6195,11,4,6,12,18,39,-21,18
Brondby,6196,1,21,6,3,73,32,41,69
FC Midtjylla,6196,2,20,5,5,68,40,28,65
Copenhagen,6196,3,14,6,10,59,44,15,48
FC Nords,6196,4,13,7,10,71,57,14,46
AaB,6196,5,8,11,11,35,42,-7,35
AC Horsens,6196,6,6,13,11,34,51,-17,31
Sonderjyske,6196,7,8,6,10,28,29,-1,30
Lyngby,6196,8,4,9,11,30,44,-14,21
AGF Aarhus,6196,9,5,6,11,20,39,-19,21
Randers FC,6196,10,5,6,13,23,43,-20,21
Silkeborg IF,6196,11,5,3,14,28,48,-20,18
Brondby,6197,1,21,6,3,74,34,40,69
FC Midtjylla,6197,2,21,5,4,71,40,31,68
FC Nords,6197,3,14,9,7,76,51,25,51
Copenhagen,6197,4,13,5,12,56,44,12,44
AaB,6197,5,7,13,10,39,44,-5,34
Sonderjyske,6197,6,8,6,10,28,29,-1,30
AC Horsens,6197,7,5,12,13,34,63,-29,27
Lyngby,6197,8,4,9,11,28,44,-16,21
Randers FC,6197,9,5,6,13,23,41,-18,21
AGF Aarhus,6197,10,5,6,11,18,37,-19,21
Silkeborg IF,6197,11,5,3,14,26,46,-20,18
Brondby,6198,1,23,5,2,77,33,44,74
FC Midtjylla,6198,2,19,4,7,65,45,20,61
FC Nords,6198,3,14,8,8,74,51,23,50
Copenhagen,6198,4,13,5,12,61,51,10,44
AaB,6198,5,7,13,10,38,44,-6,34
AC Horsens,6198,6,6,13,11,34,51,-17,31
Sonderjyske,6198,7,8,6,10,28,29,-1,30
Randers FC,6198,8,5,7,12,24,40,-16,22
AGF Aarhus,6198,9,5,6,11,21,39,-18,21
Lyngby,6198,10,3,10,11,27,45,-18,19
Silkeborg IF,6198,11,5,3,14,28,49,-21,18
FC Midtjylla,6199,1,21,4,5,71,37,34,67
Brondby,6199,2,20,5,5,72,34,38,65
FC Nords,6199,3,15,7,8,74,51,23,52
Copenhagen,6199,4,14,4,12,53,43,10,46
AaB,6199,5,8,11,11,37,47,-10,35
AC Horsens,6199,6,6,13,11,33,54,-21,31
Sonderjyske,6199,7,8,6,10,28,29,-1,30
Lyngby,6199,8,4,9,11,28,44,-16,21
Silkeborg IF,6199,9,6,3,13,26,44,-18,21
Randers FC,6199,10,5,6,13,23,41,-18,21
AGF Aarhus,6199,11,4,6,12,16,37,-21,18
Brondby,6200,1,19,7,4,69,37,32,64
FC Midtjylla,6200,2,19,7,4,63,36,27,64
FC Nords,6200,3,16,6,8,82,51,31,54
Copenhagen,6200,4,13,6,11,54,47,7,45
AaB,6200,5,8,13,9,39,40,-1,37
Sonderjyske,6200,6,8,6,10,28,29,-1,30
AC Horsens,6200,7,5,13,12,32,54,-22,28
Lyngby,6200,8,4,9,11,28,44,-16,21
Randers FC,6200,9,5,6,13,23,41,-18,21
AGF Aarhus,6200,10,5,6,11,20,38,-18,21
Silkeborg IF,6200,11,5,3,14,27,48,-21,18
Brondby,6201,1,20,7,3,70,31,39,67
FC Midtjylla,6201,2,19,5,6,67,42,25,62
FC Nords,6201,3,14,8,8,77,55,22,50
Copenhagen,6201,4,13,5,12,57,48,9,44
AaB,6201,5,9,12,9,44,43,1,39
AC Horsens,6201,6,6,13,11,35,57,-22,31
Sonderjyske,6201,7,8,6,10,28,29,-1,30
Randers FC,6201,8,5,7,12,23,39,-16,22
Lyngby,6201,9,3,10,11,26,44,-18,19
Silkeborg IF,6201,10,5,4,13,27,46,-19,19
AGF Aarhus,6201,11,4,7,11,18,38,-20,19
Brondby,6202,1,19,8,3,69,31,38,65
FC Midtjylla,6202,2,19,6,5,63,38,25,63
Copenhagen,6202,3,15,5,10,58,40,18,50
FC Nords,6202,4,14,6,10,69,53,16,48
AaB,6202,5,8,12,10,36,41,-5,36
AC Horsens,6202,6,6,13,11,34,52,-18,31
Sonderjyske,6202,7,8,6,10,28,29,-1,30
Lyngby,6202,8,4,9,11,29,44,-15,21
Randers FC,6202,9,5,6,13,23,42,-19,21
Silkeborg IF,6202,10,5,4,13,27,46,-19,19
AGF Aarhus,6202,11,4,7,11,18,38,-20,19
Brondby,6203,1,21,5,4,70,32,38,68
FC Midtjylla,6203,2,20,4,6,62,38,24,64
FC Nords,6203,3,14,7,9,70,49,21,49
Copenhagen,6203,4,13,5,12,57,45,12,44
AaB,6203,5,10,11,9,41,41,0,41
Sonderjyske,6203,6,8,6,10,28,29,-1,30
AC Horsens,6203,7,6,12,12,33,54,-21,30
Randers FC,6203,8,5,7,12,23,39,-16,22
Lyngby,6203,9,3,10,11,26,44,-18,19
Silkeborg IF,6203,10,5,4,13,26,45,-19,19
AGF Aarhus,6203,11,4,7,11,17,37,-20,19
Brondby,6204,1,22,5,3,71,30,41,71
FC Midtjylla,6204,2,19,6,5,66,38,28,63
Copenhagen,6204,3,15,5,10,57,42,15,50
FC Nords,6204,4,13,6,11,71,54,17,45
AaB,6204,5,7,12,11,35,45,-10,33
AC Horsens,6204,6,7,12,11,36,53,-17,33
Sonderjyske,6204,7,8,6,10,28,29,-1,30
Randers FC,6204,8,5,7,12,25,41,-16,22
Silkeborg IF,6204,9,6,3,13,26,44,-18,21
Lyngby,6204,10,3,10,11,28,46,-18,19
AGF Aarhus,6204,11,4,6,12,16,37,-21,18
Brondby,6205,1,19,7,4,65,32,33,64
FC Midtjylla,6205,2,19,5,6,62,40,22,62
Copenhagen,6205,3,15,6,9,59,41,18,51
FC Nords,6205,4,14,8,8,74,50,24,50
AaB,6205,5,6,14,10,32,38,-6,32
AC Horsens,6205,6,6,14,10,35,52,-17,32
Sonderjyske,6205,7,8,6,10,28,29,-1,30
Silkeborg IF,6205,8,6,3,13,30,46,-16,21
Lyngby,6205,9,4,9,11,28,44,-16,21
Randers FC,6205,10,5,6,13,23,41,-18,21
AGF Aarhus,6205,11,4,6,12,18,41,-23,18
FC Midtjylla,6206,1,21,5,4,66,34,32,68
Brondby,6206,2,20,6,4,67,30,37,66
FC Nords,6206,3,13,7,10,71,55,16,46
Copenhagen,6206,4,13,5,12,54,44,10,44
AaB,6206,5,8,13,9,37,39,-2,37
AC Horsens,6206,6,6,14,10,32,51,-19,32
Sonderjyske,6206,7,8,6,10,28,29,-1,30
Randers FC,6206,8,6,6,12,24,39,-15,24
Silkeborg IF,6206,9,6,3,13,27,44,-17,21
Lyngby,6206,10,3,9,12,26,45,-19,18
AGF Aarhus,6206,11,4,6,12,16,38,-22,18
Brondby,6207,1,20,6,4,71,38,33,66
FC Midtjylla,6207,2,20,4,6,73,38,35,64
Copenhagen,6207,3,15,5,10,61,45,16,50
FC Nords,6207,4,13,7,10,71,56,15,46
AaB,6207,5,8,11,11,37,45,-8,35
AC Horsens,6207,6,7,13,10,36,53,-17,34
Sonderjyske,6207,7,8,6,10,28,29,-1,30
Lyngby,6207,8,4,9,11,27,44,-17,21
Randers FC,6207,9,5,6,13,23,40,-17,21
Silkeborg IF,6207,10,6,3,13,26,44,-18,21
AGF Aarhus,6207,11,4,6,12,16,37,-21,18
FC Midtjylla,6208,1,21,5,4,64,34,30,68
Brondby,6208,2,20,7,3,71,35,36,67
FC Nords,6208,3,14,7,9,69,50,19,49
Copenhagen,6208,4,12,6,12,53,43,10,42
AaB,6208,5,7,13,10,37,44,-7,34
AC Horsens,6208,6,6,14,10,36,50,-14,32
Sonderjyske,6208,7,8,6,10,28,29,-1,30
Lyngby,6208,8,4,9,11,29,44,-15,21
Randers FC,6208,9,5,6,13,23,42,-19,21
Silkeborg IF,6208,10,5,4,13,27,46,-19,19
AGF Aarhus,6208,11,4,7,11,18,38,-20,19
Brondby,6209,1,22,5,3,71,33,38,71
FC Midtjylla,6209,2,19,4,7,62,37,25,61
FC Nords,6209,3,15,6,9,74,51,23,51
Copenhagen,6209,4,13,4,13,58,48,10,43
AaB,6209,5,8,12,10,39,45,-6,36
AC Horsens,6209,6,7,13,10,36,52,-16,34
Sonderjyske,6209,7,8,6,10,28,29,-1,30
Randers FC,6209,8,6,6,12,25,40,-15,24
Silkeborg IF,6209,9,6,3,13,28,44,-16,21
Lyngby,6209,10,3,9,12,27,46,-19,18
AGF Aarhus,6209,11,4,6,12,16,39,-23,18
Brondby,6210,1,21,5,4,69,35,34,68
FC Midtjylla,6210,2,19,5,6,64,41,23,62
FC Nords,6210,3,14,7,9,75,51,24,49
Copenhagen,6210,4,14,6,10,62,45,17,48
AC Horsens,6210,5,7,13,10,34,49,-15,34
AaB,6210,6,7,12,11,35,44,-9,33
Sonderjyske,6210,7,8,6,10,28,29,-1,30
Randers FC,6210,8,5,7,12,23,39,-16,22
AGF Aarhus,6210,9,5,6,11,17,36,-19,21
Lyngby,6210,10,3,10,11,26,44,-18,19
Silkeborg IF,6210,11,5,3,14,25,45,-20,18
Brondby,6211,1,21,6,3,73,34,39,69
FC Midtjylla,6211,2,21,4,5,71,37,34,67
FC Nords,6211,3,13,7,10,70,51,19,46
Copenhagen,6211,4,14,4,12,57,45,12,46
AaB,6211,5,8,11,11,38,47,-9,35
AC Horsens,6211,6,6,14,10,35,56,-21,32
Sonderjyske,6211,7,8,6,10,28,29,-1,30
Lyngby,6211,8,4,9,11,28,45,-17,21
Silkeborg IF,6211,8,6,3,13,28,45,-17,21
Randers FC,6211,10,5,6,13,24,41,-17,21
AGF Aarhus,6211,11,4,6,12,17,39,-22,18
Brondby,6212,1,20,5,5,66,32,34,65
FC Midtjylla,6212,2,19,5,6,70,40,30,62
Copenhagen,6212,3,16,4,10,60,44,16,52
FC Nords,6212,4,14,7,9,72,51,21,49
AC Horsens,6212,5,8,12,10,35,51,-16,36
AaB,6212,6,7,11,12,36,47,-11,32
Sonderjyske,6212,7,8,6,10,28,29,-1,30
Randers FC,6212,8,6,6,12,28,40,-12,24
Silkeborg IF,6212,9,5,4,13,26,45,-19,19
AGF Aarhus,6212,10,4,7,11,17,37,-20,19
Lyngby,6212,11,3,9,12,27,49,-22,18
Brondby,6213,1,22,6,2,77,31,46,72
FC Midtjylla,6213,2,20,4,6,65,40,25,64
Copenhagen,6213,3,14,4,12,56,47,9,46
FC Nords,6213,4,13,6,11,68,54,14,45
AaB,6213,5,8,12,10,42,44,-2,36
AC Horsens,6213,6,7,12,11,37,55,-18,33
Sonderjyske,6213,7,8,6,10,28,29,-1,30
Randers FC,6213,8,6,6,12,25,40,-15,24
Silkeborg IF,6213,9,5,4,13,26,45,-19,19
AGF Aarhus,6213,10,4,7,11,17,37,-20,19
Lyngby,6213,11,3,9,12,27,46,-19,18
FC Midtjylla,6214,1,20,5,5,66,38,28,65
Brondby,6214,2,19,7,4,64,30,34,64
Copenhagen,6214,3,14,5,11,58,44,14,47
FC Nords,6214,4,13,7,10,71,58,13,46
AaB,6214,5,9,12,9,42,40,2,39
AC Horsens,6214,6,6,14,10,32,49,-17,32
Sonderjyske,6214,7,8,6,10,28,29,-1,30
Lyngby,6214,8,4,9,11,27,44,-17,21
Randers FC,6214,9,5,6,13,23,40,-17,21
AGF Aarhus,6214,10,5,6,11,18,37,-19,21
Silkeborg IF,6214,11,5,3,14,26,46,-20,18
Brondby,6215,1,22,5,3,74,32,42,71
FC Midtjylla,6215,2,21,4,5,68,40,28,67
FC Nords,6215,3,15,6,9,77,50,27,51
Copenhagen,6215,4,13,5,12,57,48,9,44
AaB,6215,5,6,13,11,37,46,-9,31
AC Horsens,6215,6,6,13,11,33,56,-23,31
Sonderjyske,6215,7,8,6,10,28,29,-1,30
Lyngby,6215,8,4,9,11,30,45,-15,21
Silkeborg IF,6215,9,6,3,13,29,47,-18,21
Randers FC,6215,10,5,6,13,24,43,-19,21
AGF Aarhus,6215,11,4,6,12,19,40,-21,18
Brondby,6216,1,21,5,4,70,35,35,68
FC Midtjylla,6216,2,20,5,5,69,39,30,65
FC Nords,6216,3,16,6,8,74,46,28,54
Copenhagen,6216,4,13,6,11,57,46,11,45
AaB,6216,5,7,11,12,41,52,-11,32
AC Horsens,6216,6,6,13,11,34,53,-19,31
Sonderjyske,6216,7,8,6,10,28,29,-1,30
Lyngby,6216,8,4,9,11,30,47,-17,21
Randers FC,6216,9,5,6,13,26,43,-17,21
Silkeborg IF,6216,10,6,3,13,27,45,-18,21
AGF Aarhus,6216,11,4,6,12,17,38,-21,18
Brondby,6217,1,20,6,4,71,34,37,66
FC Midtjylla,6217,2,19,5,6,64,42,22,62
Copenhagen,6217,3,15,5,10,66,48,18,50
FC Nords,6217,4,12,8,10,68,54,14,44
AaB,6217,5,9,12,9,41,42,-1,39
AC Horsens,6217,6,6,14,10,38,54,-16,32
Sonderjyske,6217,7,8,6,10,28,29,-1,30
Lyngby,6217,8,4,9,11,28,45,-17,21
Randers FC,6217,9,5,6,13,24,41,-17,21
Silkeborg IF,6217,10,5,4,13,26,45,-19,19
AGF Aarhus,6217,11,4,7,11,17,37,-20,19
Brondby,6218,1,19,7,4,68,37,31,64
FC Midtjylla,6218,2,19,6,5,65,36,29,63
FC Nords,6218,3,14,8,8,74,53,21,50
Copenhagen,6218,4,14,6,10,61,47,14,48
AaB,6218,5,7,13,10,43,47,-4,34
AC Horsens,6218,6,7,12,11,36,53,-17,33
Sonderjyske,6218,7,8,6,10,28,29,-1,30
Lyngby,6218,8,4,9,11,28,45,-17,21
Randers FC,6218,9,5,6,13,24,41,-17,21
AGF Aarhus,6218,10,5,6,11,17,36,-19,21
Silkeborg IF,6218,11,5,3,14,25,45,-20,18
Brondby,6219,1,21,6,3,73,34,39,69
FC Midtjylla,6219,2,20,5,5,65,37,28,65
FC Nords,6219,3,15,7,8,71,49,22,52
Copenhagen,6219,4,15,5,10,57,40,17,50
AaB,6219,5,7,11,12,37,46,-9,32
Sonderjyske,6219,6,8,6,10,28,29,-1,30
AC Horsens,6219,7,5,12,13,33,56,-23,27
Lyngby,6219,8,4,9,11,28,45,-17,21
Randers FC,6219,9,5,6,13,24,41,-17,21
Silkeborg IF,6219,10,5,4,13,27,46,-19,19
AGF Aarhus,6219,11,4,7,11,18,38,-20,19
Brondby,6220,1,21,6,3,68,33,35,69
FC Midtjylla,6220,2,18,7,5,69,43,26,61
FC Nords,6220,3,15,6,9,75,52,23,51
Copenhagen,6220,4,13,7,10,57,45,12,46
AaB,6220,5,7,12,11,35,42,-7,33
AC Horsens,6220,6,6,14,10,37,52,-15,32
Sonderjyske,6220,7,8,6,10,28,29,-1,30
Randers FC,6220,8,6,6,12,24,39,-15,24
Silkeborg IF,6220,9,6,3,13,28,44,-16,21
Lyngby,6220,10,3,9,12,26,45,-19,18
AGF Aarhus,6220,11,4,6,12,16,39,-23,18
Brondby,6221,1,20,6,4,70,35,35,66
FC Midtjylla,6221,2,20,4,6,66,44,22,64
FC Nords,6221,3,15,7,8,76,51,25,52
Copenhagen,6221,4,12,6,12,56,47,9,42
AaB,6221,5,8,12,10,45,45,0,36
AC Horsens,6221,6,6,15,9,33,50,-17,33
Sonderjyske,6221,7,8,6,10,28,29,-1,30
Lyngby,6221,8,4,9,11,29,45,-16,21
Silkeborg IF,6221,9,6,3,13,27,45,-18,21
Randers FC,6221,10,5,6,13,24,42,-18,21
AGF Aarhus,6221,11,4,6,12,17,38,-21,18
Brondby,6222,1,20,6,4,70,31,39,66
FC Midtjylla,6222,2,20,4,6,64,38,26,64
FC Nords,6222,3,16,6,8,75,49,26,54
Copenhagen,6222,4,15,5,10,59,44,15,50
AC Horsens,6222,5,6,13,11,33,52,-19,31
Sonderjyske,6222,6,8,6,10,28,29,-1,30
AaB,6222,7,6,12,12,36,49,-13,30
Randers FC,6222,8,6,6,12,26,41,-15,24
AGF Aarhus,6222,9,5,6,11,20,36,-16,21
Lyngby,6222,10,3,9,12,28,47,-19,18
Silkeborg IF,6222,11,5,3,14,25,48,-23,18
Brondby,6223,1,21,6,3,69,32,37,69
FC Midtjylla,6223,2,20,5,5,65,37,28,65
Copenhagen,6223,3,15,5,10,61,44,17,50
FC Nords,6223,4,14,6,10,69,53,16,48
AaB,6223,5,8,12,10,41,41,0,36
Sonderjyske,6223,6,8,6,10,28,29,-1,30
AC Horsens,6223,7,5,12,13,30,54,-24,27
Randers FC,6223,8,6,6,12,24,39,-15,24
Silkeborg IF,6223,9,5,4,13,26,45,-19,19
AGF Aarhus,6223,10,4,7,11,17,37,-20,19
Lyngby,6223,11,3,9,12,26,45,-19,18
FC Midtjylla,6224,1,21,4,5,66,37,29,67
Brondby,6224,2,19,8,3,70,35,35,65
FC Nords,6224,3,15,7,8,77,50,27,52
Copenhagen,6224,4,12,5,13,53,50,3,41
AaB,6224,5,7,14,9,37,41,-4,35
AC Horsens,6224,6,6,14,10,37,53,-16,32
Sonderjyske,6224,7,8,6,10,28,29,-1,30
Randers FC,6224,8,6,6,12,25,39,-14,24
Silkeborg IF,6224,9,6,3,13,28,46,-18,21
Lyngby,6224,10,3,9,12,26,46,-20,18
AGF Aarhus,6224,11,4,6,12,18,39,-21,18
Brondby,6225,1,21,6,3,71,30,41,69
FC Midtjylla,6225,2,19,4,7,65,40,25,61
FC Nords,6225,3,15,6,9,75,53,22,51
Copenhagen,6225,4,14,4,12,57,45,12,46
AaB,6225,5,9,12,9,42,44,-2,39
Sonderjyske,6225,6,8,6,10,28,29,-1,30
AC Horsens,6225,7,6,12,12,33,57,-24,30
Lyngby,6225,8,4,9,11,29,45,-16,21
Silkeborg IF,6225,9,6,3,13,27,44,-17,21
Randers FC,6225,10,5,6,13,24,42,-18,21
AGF Aarhus,6225,11,4,6,12,16,38,-22,18
FC Midtjylla,6226,1,19,7,4,63,35,28,64
Brondby,6226,2,19,6,5,69,36,33,63
Copenhagen,6226,3,16,5,9,59,41,18,53
FC Nords,6226,4,14,6,10,74,53,21,48
AaB,6226,5,7,12,11,36,45,-9,33
AC Horsens,6226,6,6,14,10,33,50,-17,32
Sonderjyske,6226,7,8,6,10,28,29,-1,30
Lyngby,6226,8,4,9,11,28,44,-16,21
Randers FC,6226,9,5,6,13,23,41,-18,21
Silkeborg IF,6226,10,5,4,13,27,46,-19,19
AGF Aarhus,6226,11,4,7,11,18,38,-20,19
Brondby,6227,1,21,7,2,74,32,42,70
FC Midtjylla,6227,2,19,5,6,67,42,25,62
FC Nords,6227,3,13,9,8,77,57,20,48
Copenhagen,6227,4,14,6,10,61,48,13,48
AaB,6227,5,8,13,9,40,41,-1,37
Sonderjyske,6227,6,8,6,10,28,29,-1,30
AC Horsens,6227,7,5,12,13,32,57,-25,27
Lyngby,6227,8,4,9,11,28,44,-16,21
Silkeborg IF,6227,9,6,3,13,27,45,-18,21
Randers FC,6227,10,5,6,13,23,41,-18,21
AGF Aarhus,6227,11,4,6,12,17,38,-21,18
Brondby,6228,1,22,6,2,80,31,49,72
FC Midtjylla,6228,2,19,6,5,68,40,28,63
Copenhagen,6228,3,14,6,10,58,43,15,48
FC Nords,6228,4,13,7,10,72,54,18,46
AC Horsens,6228,5,7,12,11,35,59,-24,33
AaB,6228,6,6,13,11,35,47,-12,31
Sonderjyske,6228,7,8,6,10,28,29,-1,30
Randers FC,6228,8,5,7,12,24,40,-16,22
Silkeborg IF,6228,9,6,3,13,32,45,-13,21
Lyngby,6228,10,3,10,11,27,45,-18,19
AGF Aarhus,6228,11,4,6,12,17,43,-26,18
Brondby,6229,1,20,6,4,71,36,35,66
FC Midtjylla,6229,2,20,4,6,71,41,30,64
Copenhagen,6229,3,14,6,10,60,45,15,48
FC Nords,6229,4,13,8,9,70,53,17,47
AC Horsens,6229,5,7,14,9,39,50,-11,35
AaB,6229,6,7,12,11,37,49,-12,33
Sonderjyske,6229,7,8,6,10,28,29,-1,30
Randers FC,6229,8,5,7,12,24,40,-16,22
Lyngby,6229,9,3,10,11,27,45,-18,19
Silkeborg IF,6229,10,5,4,13,25,44,-19,19
AGF Aarhus,6229,11,4,7,11,16,36,-20,19
Brondby,6230,1,21,6,3,69,31,38,69
FC Midtjylla,6230,2,19,4,7,64,43,21,61
FC Nords,6230,3,15,6,9,73,50,23,51
Copenhagen,6230,4,15,5,10,59,42,17,50
AC Horsens,6230,5,7,13,10,34,49,-15,34
Sonderjyske,6230,6,8,6,10,28,29,-1,30
AaB,6230,7,6,12,12,33,43,-10,30
Lyngby,6230,8,4,9,11,29,44,-15,21
Silkeborg IF,6230,9,6,3,13,27,45,-18,21
Randers FC,6230,10,5,6,13,23,42,-19,21
AGF Aarhus,6230,11,4,6,12,17,38,-21,18
Brondby,6231,1,20,6,4,69,34,35,66
FC Midtjylla,6231,2,18,6,6,63,40,23,60
FC Nords,6231,3,15,6,9,72,49,23,51
Copenhagen,6231,4,15,4,11,59,45,14,49
AC Horsens,6231,5,8,12,10,33,48,-15,36
AaB,6231,6,7,12,11,35,41,-6,33
Sonderjyske,6231,7,8,6,10,28,29,-1,30
Randers FC,6231,8,6,6,12,25,39,-14,24
Silkeborg IF,6231,9,5,4,13,26,45,-19,19
AGF Aarhus,6231,10,4,7,11,17,37,-20,19
Lyngby,6231,11,3,9,12,26,46,-20,18
Brondby,6232,1,22,6,2,74,30,44,72
FC Midtjylla,6232,2,18,5,7,61,41,20,59
FC Nords,6232,3,16,6,8,76,49,27,54
Copenhagen,6232,4,13,6,11,57,44,13,45
AaB,6232,5,8,11,11,38,45,-7,35
Sonderjyske,6232,6,8,6,10,28,29,-1,30
AC Horsens,6232,7,5,14,11,33,56,-23,29
Randers FC,6232,8,5,7,12,27,43,-16,22
Silkeborg IF,6232,9,6,3,13,28,45,-17,21
Lyngby,6232,10,3,10,11,30,48,-18,19
AGF Aarhus,6232,11,4,6,12,17,39,-22,18
Brondby,6233,1,22,5,3,77,34,43,71
FC Midtjylla,6233,2,20,4,6,70,39,31,64
FC Nords,6233,3,14,6,10,72,59,13,48
Copenhagen,6233,4,14,5,11,57,44,13,47
AC Horsens,6233,5,7,13,10,34,52,-18,34
AaB,6233,6,7,11,12,37,45,-8,32
Sonderjyske,6233,7,8,6,10,28,29,-1,30
Lyngby,6233,8,4,9,11,28,44,-16,21
Randers FC,6233,9,5,6,13,23,41,-18,21
Silkeborg IF,6233,10,5,4,13,26,45,-19,19
AGF Aarhus,6233,11,4,7,11,17,37,-20,19
Brondby,6234,1,21,7,2,71,32,39,70
FC Midtjylla,6234,2,19,6,5,67,41,26,63
FC Nords,6234,3,13,8,9,72,50,22,47
Copenhagen,6234,4,13,5,12,54,46,8,44
AaB,6234,5,8,13,9,41,44,-3,37
Sonderjyske,6234,6,8,6,10,28,29,-1,30
AC Horsens,6234,7,5,15,10,35,53,-18,30
Lyngby,6234,8,4,9,11,27,44,-17,21
Randers FC,6234,9,5,6,13,23,40,-17,21
Silkeborg IF,6234,10,6,3,13,28,46,-18,21
AGF Aarhus,6234,11,4,6,12,18,39,-21,18
Brondby,6235,1,21,5,4,69,31,38,68
FC Midtjylla,6235,2,18,6,6,67,46,21,60
FC Nords,6235,3,15,6,9,74,53,21,51
Copenhagen,6235,4,14,5,11,60,42,18,47
AaB,6235,5,8,12,10,41,46,-5,36
AC Horsens,6235,6,6,14,10,34,53,-19,32
Sonderjyske,6235,7,8,6,10,28,29,-1,30
Randers FC,6235,8,5,7,12,23,39,-16,22
Lyngby,6235,9,3,10,11,26,44,-18,19
Silkeborg IF,6235,10,5,4,13,26,45,-19,19
AGF Aarhus,6235,11,4,7,11,17,37,-20,19
Brondby,6236,1,21,7,2,75,35,40,70
FC Midtjylla,6236,2,20,4,6,66,39,27,64
FC Nords,6236,3,15,8,7,79,51,28,53
Copenhagen,6236,4,12,5,13,54,50,4,41
AC Horsens,6236,5,7,13,10,39,54,-15,34
AaB,6236,6,6,13,11,35,45,-10,31
Sonderjyske,6236,7,8,6,10,28,29,-1,30
Lyngby,6236,8,4,9,11,28,44,-16,21
Randers FC,6236,9,5,6,13,23,41,-18,21
Silkeborg IF,6236,10,5,4,13,26,45,-19,19
AGF Aarhus,6236,11,4,7,11,17,37,-20,19
FC Midtjylla,6237,1,20,4,6,68,41,27,64
Brondby,6237,2,19,6,5,67,34,33,63
FC Nords,6237,3,15,7,8,76,50,26,52
Copenhagen,6237,4,14,6,10,57,43,14,48
AaB,6237,5,7,13,10,35,40,-5,34
AC Horsens,6237,6,6,14,10,38,59,-21,32
Sonderjyske,6237,7,8,6,10,28,29,-1,30
Lyngby,6237,8,4,9,11,27,44,-17,21
Randers FC,6237,9,5,6,13,23,40,-17,21
AGF Aarhus,6237,10,5,6,11,18,36,-18,21
Silkeborg IF,6237,11,5,3,14,25,46,-21,18
FC Midtjylla,6238,1,21,5,4,70,37,33,68
Brondby,6238,2,20,6,4,70,36,34,66
Copenhagen,6238,3,16,5,9,63,45,18,53
FC Nords,6238,4,13,7,10,72,55,17,46
AaB,6238,5,8,11,11,38,42,-4,35
Sonderjyske,6238,6,8,6,10,28,29,-1,30
AC Horsens,6238,7,5,12,13,36,60,-24,27
Randers FC,6238,8,5,7,12,24,40,-16,22
Silkeborg IF,6238,9,6,3,13,27,45,-18,21
Lyngby,6238,10,3,10,11,27,45,-18,19
AGF Aarhus,6238,11,4,6,12,17,38,-21,18
Brondby,6239,1,21,5,4,69,35,34,68
FC Midtjylla,6239,2,20,4,6,66,40,26,64
FC Nords,6239,3,15,6,9,74,48,26,51
Copenhagen,6239,4,15,5,10,58,40,18,50
AaB,6239,5,7,12,11,36,45,-9,33
Sonderjyske,6239,6,8,6,10,28,29,-1,30
AC Horsens,6239,7,6,12,12,32,53,-21,30
Lyngby,6239,8,4,9,11,27,44,-17,21
Randers FC,6239,9,5,6,13,23,40,-17,21
Silkeborg IF,6239,10,6,3,13,27,45,-18,21
AGF Aarhus,6239,11,4,6,12,17,38,-21,18
Brondby,6240,1,20,6,4,67,32,35,66
FC Midtjylla,6240,2,20,4,6,62,36,26,64
FC Nords,6240,3,16,6,8,73,47,26,54
Copenhagen,6240,4,13,5,12,52,42,10,44
AaB,6240,5,8,12,10,38,43,-5,36
AC Horsens,6240,6,6,13,11,36,54,-18,31
Sonderjyske,6240,7,8,6,10,28,29,-1,30
Lyngby,6240,8,4,9,11,27,44,-17,21
Randers FC,6240,9,5,6,13,23,40,-17,21
Silkeborg IF,6240,10,6,3,13,26,44,-18,21
AGF Aarhus,6240,11,4,6,12,16,37,-21,18
FC Midtjylla,6241,1,21,5,4,71,36,35,68
Brondby,6241,2,19,6,5,69,35,34,63
FC Nords,6241,3,14,7,9,77,51,26,49
Copenhagen,6241,4,13,6,11,59,53,6,45
AaB,6241,5,7,13,10,38,45,-7,34
AC Horsens,6241,6,7,13,10,43,63,-20,34
Sonderjyske,6241,7,8,6,10,28,29,-1,30
Randers FC,6241,8,6,6,12,26,39,-13,24
Silkeborg IF,6241,9,6,3,13,27,45,-18,21
Lyngby,6241,10,3,9,12,26,47,-21,18
AGF Aarhus,6241,11,4,6,12,17,38,-21,18
Brondby,6242,1,23,5,2,82,31,51,74
FC Midtjylla,6242,2,20,5,5,66,42,24,65
FC Nords,6242,3,13,8,9,70,50,20,47
Copenhagen,6242,4,12,6,12,53,45,8,42
AC Horsens,6242,5,7,13,10,33,49,-16,34
AaB,6242,6,7,11,12,35,48,-13,32
Sonderjyske,6242,7,8,6,10,28,29,-1,30
Randers FC,6242,8,5,7,12,23,39,-16,22
Lyngby,6242,9,3,10,11,26,44,-18,19
Silkeborg IF,6242,10,5,4,13,25,44,-19,19
AGF Aarhus,6242,11,4,7,11,16,36,-20,19
Brondby,6243,1,21,5,4,73,34,39,68
FC Midtjylla,6243,2,18,6,6,64,42,22,60
Copenhagen,6243,3,16,4,10,59,45,14,52
FC Nords,6243,4,14,8,8,78,50,28,50
AaB,6243,5,7,13,10,38,47,-9,34
Sonderjyske,6243,6,8,6,10,28,29,-1,30
AC Horsens,6243,7,6,12,12,34,54,-20,30
Randers FC,6243,8,5,7,12,23,39,-16,22
Silkeborg IF,6243,9,6,3,13,28,45,-17,21
Lyngby,6243,10,3,10,11,26,44,-18,19
AGF Aarhus,6243,11,4,6,12,17,39,-22,18
FC Midtjylla,6244,1,20,6,4,66,33,33,66
Brondby,6244,2,20,6,4,68,36,32,66
FC Nords,6244,3,16,6,8,78,50,28,54
Copenhagen,6244,4,14,5,11,59,46,13,47
AaB,6244,5,8,11,11,36,44,-8,35
Sonderjyske,6244,6,8,6,10,28,29,-1,30
AC Horsens,6244,7,5,12,13,31,55,-24,27
Lyngby,6244,8,4,9,11,28,45,-17,21
Randers FC,6244,9,5,6,13,24,41,-17,21
Silkeborg IF,6244,10,5,4,13,28,47,-19,19
AGF Aarhus,6244,11,4,7,11,19,39,-20,19
Brondby,6245,1,21,7,2,72,31,41,70
FC Midtjylla,6245,2,20,4,6,61,37,24,64
FC Nords,6245,3,15,6,9,71,50,21,51
Copenhagen,6245,4,13,6,11,56,44,12,45
AaB,6245,5,8,11,11,34,39,-5,35
Sonderjyske,6245,6,8,6,10,28,29,-1,30
AC Horsens,6245,7,5,14,11,34,53,-19,29
Randers FC,6245,8,5,7,12,23,39,-16,22
Lyngby,6245,9,3,10,11,26,44,-18,19
Silkeborg IF,6245,10,5,4,13,25,44,-19,19
AGF Aarhus,6245,11,4,7,11,16,36,-20,19
Brondby,6246,1,21,7,2,70,27,43,70
FC Midtjylla,6246,2,19,6,5,67,39,28,63
Copenhagen,6246,3,14,6,10,54,40,14,48
FC Nords,6246,4,13,7,10,70,55,15,46
AaB,6246,5,7,12,11,35,44,-9,33
AC Horsens,6246,6,7,12,11,35,52,-17,33
Sonderjyske,6246,7,8,6,10,28,29,-1,30
Silkeborg IF,6246,8,6,3,13,30,44,-14,21
Lyngby,6246,9,4,9,11,29,45,-16,21
Randers FC,6246,10,5,6,13,24,42,-18,21
AGF Aarhus,6246,11,4,6,12,16,41,-25,18
Brondby,6247,1,20,5,5,70,35,35,65
FC Midtjylla,6247,2,19,5,6,64,38,26,62
FC Nords,6247,3,15,7,8,71,48,23,52
Copenhagen,6247,4,13,6,11,58,48,10,45
AC Horsens,6247,5,7,14,9,38,51,-13,35
AaB,6247,6,6,15,9,32,39,-7,33
Sonderjyske,6247,7,8,6,10,28,29,-1,30
Lyngby,6247,8,4,9,11,29,45,-16,21
Silkeborg IF,6247,9,6,3,13,27,44,-17,21
Randers FC,6247,10,5,6,13,24,42,-18,21
AGF Aarhus,6247,11,4,6,12,16,38,-22,18
Brondby,6248,1,21,6,3,70,29,41,69
FC Midtjylla,6248,2,20,4,6,68,38,30,64
Copenhagen,6248,3,16,4,10,62,43,19,52
FC Nords,6248,4,13,7,10,78,59,19,46
AC Horsens,6248,5,8,12,10,39,58,-19,36
Sonderjyske,6248,6,8,6,10,28,29,-1,30
AaB,6248,7,6,11,13,36,52,-16,29
Randers FC,6248,8,6,6,12,26,40,-14,24
Silkeborg IF,6248,9,5,4,13,27,46,-19,19
AGF Aarhus,6248,10,4,7,11,18,38,-20,19
Lyngby,6248,11,3,9,12,27,47,-20,18
Brondby,6249,1,22,5,3,75,31,44,71
FC Midtjylla,6249,2,19,5,6,70,44,26,62
FC Nords,6249,3,15,6,9,76,57,19,51
Copenhagen,6249,4,12,6,12,57,49,8,42
AaB,6249,5,9,11,10,41,46,-5,38
AC Horsens,6249,6,6,13,11,36,54,-18,31
Sonderjyske,6249,7,8,6,10,28,29,-1,30
Lyngby,6249,8,4,9,11,29,45,-16,21
Randers FC,6249,9,5,6,13,24,42,-18,21
AGF Aarhus,6249,10,5,6,11,17,36,-19,21
Silkeborg IF,6249,11,5,3,14,25,45,-20,18
Brondby,6250,1,21,5,4,71,30,41,68
FC Midtjylla,6250,2,21,4,5,64,39,25,67
Copenhagen,6250,3,15,4,11,58,43,15,49
FC Nords,6250,4,13,6,11,71,59,12,45
AC Horsens,6250,5,8,12,10,38,49,-11,36
AaB,6250,6,7,11,12,36,44,-8,32
Sonderjyske,6250,7,8,6,10,28,29,-1,30
Randers FC,6250,8,6,6,12,25,39,-14,24
Silkeborg IF,6250,9,6,3,13,27,45,-18,21
Lyngby,6250,10,3,9,12,26,46,-20,18
AGF Aarhus,6250,11,4,6,12,17,38,-21,18
Brondby,6251,1,22,5,3,76,31,45,71
FC Midtjylla,6251,2,19,5,6,64,39,25,62
FC Nords,6251,3,15,7,8,78,55,23,52
Copenhagen,6251,4,14,4,12,59,46,13,46
AC Horsens,6251,5,7,13,10,34,51,-17,34
Sonderjyske,6251,6,8,6,10,28,29,-1,30
AaB,6251,7,6,12,12,34,49,-15,30
Lyngby,6251,8,4,9,11,27,44,-17,21
Randers FC,6251,9,5,6,13,23,40,-17,21
AGF Aarhus,6251,10,5,6,11,19,36,-17,21
Silkeborg IF,6251,11,5,3,14,25,47,-22,18
FC Midtjylla,6252,1,20,4,6,66,39,27,64
Brondby,6252,2,19,5,6,69,37,32,62
FC Nords,6252,3,14,7,9,73,54,19,49
Copenhagen,6252,4,15,4,11,57,43,14,49
AaB,6252,5,8,13,9,35,41,-6,37
AC Horsens,6252,6,7,13,10,38,50,-12,34
Sonderjyske,6252,7,8,6,10,28,29,-1,30
Lyngby,6252,8,4,9,11,29,44,-15,21
Silkeborg IF,6252,9,6,3,13,27,44,-17,21
Randers FC,6252,10,5,6,13,23,42,-19,21
AGF Aarhus,6252,11,4,6,12,16,38,-22,18
Brondby,6253,1,20,7,3,68,35,33,67
FC Midtjylla,6253,2,19,5,6,66,37,29,62
Copenhagen,6253,3,14,7,9,58,40,18,49
FC Nords,6253,4,12,10,8,70,54,16,46
AaB,6253,5,7,12,11,36,42,-6,33
AC Horsens,6253,6,6,15,9,32,48,-16,33
Sonderjyske,6253,7,8,6,10,28,29,-1,30
Randers FC,6253,8,5,7,12,25,41,-16,22
Silkeborg IF,6253,9,6,3,13,26,44,-18,21
Lyngby,6253,10,3,10,11,28,46,-18,19
AGF Aarhus,6253,11,4,6,12,16,37,-21,18
Brondby,6254,1,20,7,3,71,31,40,67
FC Midtjylla,6254,2,19,5,6,66,43,23,62
FC Nords,6254,3,12,9,9,70,51,19,45
Copenhagen,6254,4,13,5,12,56,46,10,44
AaB,6254,5,9,11,10,40,45,-5,38
AC Horsens,6254,6,8,13,9,39,52,-13,37
Sonderjyske,6254,7,8,6,10,28,29,-1,30
Randers FC,6254,8,5,7,12,24,40,-16,22
Silkeborg IF,6254,9,6,3,13,26,44,-18,21
Lyngby,6254,10,3,10,11,27,45,-18,19
AGF Aarhus,6254,11,4,6,12,16,37,-21,18
Brondby,6255,1,19,6,5,65,35,30,63
FC Midtjylla,6255,2,19,4,7,64,43,21,61
FC Nords,6255,3,16,6,8,75,49,26,54
Copenhagen,6255,4,15,5,10,65,48,17,50
AC Horsens,6255,5,8,12,10,35,49,-14,36
AaB,6255,6,7,11,12,38,44,-6,32
Sonderjyske,6255,7,8,6,10,28,29,-1,30
Randers FC,6255,8,5,7,12,23,39,-16,22
Silkeborg IF,6255,9,6,3,13,27,45,-18,21
Lyngby,6255,10,3,10,11,26,44,-18,19
AGF Aarhus,6255,11,4,6,12,17,38,-21,18
Brondby,6256,1,21,5,4,68,31,37,68
FC Midtjylla,6256,2,17,5,8,60,42,18,56
FC Nords,6256,3,16,6,8,73,49,24,54
Copenhagen,6256,4,14,4,12,59,45,14,46
AaB,6256,5,9,11,10,41,43,-2,38
AC Horsens,6256,6,7,13,10,35,52,-17,34
Sonderjyske,6256,7,8,6,10,28,29,-1,30
Randers FC,6256,8,5,7,12,24,40,-16,22
Silkeborg IF,6256,9,6,3,13,28,45,-17,21
Lyngby,6256,10,3,10,11,27,45,-18,19
AGF Aarhus,6256,11,4,6,12,17,39,-22,18
Brondby,6257,1,21,5,4,73,33,40,68
FC Midtjylla,6257,2,20,5,5,65,37,28,65
FC Nords,6257,3,14,6,10,72,54,18,48
Copenhagen,6257,4,14,5,11,57,43,14,47
AaB,6257,5,8,12,10,37,43,-6,36
AC Horsens,6257,6,6,13,11,33,53,-20,31
Sonderjyske,6257,7,8,6,10,28,29,-1,30
Randers FC,6257,8,5,7,12,25,41,-16,22
Silkeborg IF,6257,9,6,3,13,28,45,-17,21
Lyngby,6257,10,3,10,11,28,46,-18,19
AGF Aarhus,6257,11,4,6,12,17,39,-22,18
Brondby,6258,1,20,7,3,67,30,37,67
FC Midtjylla,6258,2,20,5,5,66,39,27,65
FC Nords,6258,3,13,9,8,70,50,20,48
Copenhagen,6258,4,14,6,10,59,43,16,48
AaB,6258,5,7,12,11,36,43,-7,33
AC Horsens,6258,6,6,13,11,31,50,-19,31
Sonderjyske,6258,7,8,6,10,28,29,-1,30
Lyngby,6258,8,4,9,11,27,44,-17,21
Randers FC,6258,9,5,6,13,23,40,-17,21
Silkeborg IF,6258,10,6,3,13,27,45,-18,21
AGF Aarhus,6258,11,4,6,12,17,38,-21,18
Brondby,6259,1,23,5,2,78,28,50,74
FC Midtjylla,6259,2,19,5,6,68,42,26,62
FC Nords,6259,3,15,7,8,81,55,26,52
Copenhagen,6259,4,12,7,11,55,45,10,43
AaB,6259,5,6,13,11,32,49,-17,31
Sonderjyske,6259,6,8,6,10,28,29,-1,30
AC Horsens,6259,7,5,15,10,39,60,-21,30
Lyngby,6259,8,4,9,11,27,44,-17,21
Silkeborg IF,6259,8,6,3,13,27,44,-17,21
Randers FC,6259,10,5,6,13,23,40,-17,21
AGF Aarhus,6259,11,4,6,12,16,38,-22,18
Brondby,6260,1,19,9,2,65,29,36,66
FC Midtjylla,6260,2,19,5,6,63,38,25,62
FC Nords,6260,3,15,8,7,77,49,28,53
Copenhagen,6260,4,13,6,11,59,49,10,45
AaB,6260,5,7,13,10,41,46,-5,34
Sonderjyske,6260,6,8,6,10,28,29,-1,30
AC Horsens,6260,7,5,15,10,31,51,-20,30
Randers FC,6260,8,6,6,12,26,39,-13,24
Silkeborg IF,6260,9,6,3,13,26,44,-18,21
Lyngby,6260,10,3,9,12,26,47,-21,18
AGF Aarhus,6260,11,4,6,12,16,37,-21,18
Brondby,6261,1,21,6,3,68,32,36,69
FC Midtjylla,6261,2,19,5,6,66,40,26,62
FC Nords,6261,3,14,6,10,71,49,22,48
Copenhagen,6261,4,13,7,10,56,43,13,46
AaB,6261,5,8,14,8,36,38,-2,38
Sonderjyske,6261,6,8,6,10,28,29,-1,30
AC Horsens,6261,7,5,14,11,34,55,-21,29
Lyngby,6261,8,4,9,11,30,46,-16,21
Silkeborg IF,6261,9,6,3,13,27,44,-17,21
Randers FC,6261,10,5,6,13,25,43,-18,21
AGF Aarhus,6261,11,4,6,12,16,38,-22,18
Brondby,6262,1,21,6,3,68,30,38,69
FC Midtjylla,6262,2,20,4,6,70,41,29,64
FC Nords,6262,3,14,6,10,70,51,19,48
Copenhagen,6262,4,14,6,10,55,41,14,48
AaB,6262,5,7,13,10,34,44,-10,34
AC Horsens,6262,6,6,13,11,36,52,-16,31
Sonderjyske,6262,7,8,6,10,28,29,-1,30
Randers FC,6262,8,6,6,12,26,40,-14,24
AGF Aarhus,6262,9,5,6,11,19,36,-17,21
Lyngby,6262,10,3,9,12,27,47,-20,18
Silkeborg IF,6262,11,5,3,14,25,47,-22,18
Brondby,6263,1,21,7,2,71,30,41,70
FC Midtjylla,6263,2,19,6,5,65,40,25,63
FC Nords,6263,3,13,6,11,74,58,16,45
Copenhagen,6263,4,12,5,13,57,50,7,41
AaB,6263,5,9,13,8,42,38,4,40
AC Horsens,6263,6,7,13,10,34,53,-19,34
Sonderjyske,6263,7,8,6,10,28,29,-1,30
Lyngby,6263,8,4,9,11,29,44,-15,21
Silkeborg IF,6263,9,6,3,13,27,44,-17,21
Randers FC,6263,10,5,6,13,23,42,-19,21
AGF Aarhus,6263,11,4,6,12,16,38,-22,18
Brondby,6264,1,21,6,3,70,32,38,69
FC Midtjylla,6264,2,20,6,4,71,38,33,66
FC Nords,6264,3,14,8,8,68,48,20,50
Copenhagen,6264,4,13,5,12,55,45,10,44
AaB,6264,5,7,12,11,36,46,-10,33
Sonderjyske,6264,6,8,6,10,28,29,-1,30
AC Horsens,6264,7,5,15,10,33,50,-17,30
Randers FC,6264,8,6,6,12,25,40,-15,24
Silkeborg IF,6264,9,5,4,13,27,46,-19,19
AGF Aarhus,6264,10,4,7,11,18,38,-20,19
Lyngby,6264,11,3,9,12,27,46,-19,18
Brondby,6265,1,22,5,3,78,32,46,71
FC Midtjylla,6265,2,21,4,5,67,39,28,67
FC Nords,6265,3,14,7,9,76,59,17,49
Copenhagen,6265,4,14,5,11,61,46,15,47
AaB,6265,5,7,11,12,38,50,-12,32
Sonderjyske,6265,6,8,6,10,28,29,-1,30
AC Horsens,6265,7,6,12,12,39,59,-20,30
Silkeborg IF,6265,8,6,3,13,29,46,-17,21
Lyngby,6265,9,4,9,11,27,44,-17,21
Randers FC,6265,10,5,6,13,23,40,-17,21
AGF Aarhus,6265,11,4,6,12,18,40,-22,18
Brondby,6266,1,21,6,3,71,32,39,69
FC Midtjylla,6266,2,19,5,6,64,40,24,62
FC Nords,6266,3,14,6,10,78,55,23,48
Copenhagen,6266,4,13,7,10,61,48,13,46
AaB,6266,5,8,13,9,36,39,-3,37
AC Horsens,6266,6,6,13,11,33,55,-22,31
Sonderjyske,6266,7,8,6,10,28,29,-1,30
Randers FC,6266,8,6,6,12,25,39,-14,24
Silkeborg IF,6266,9,6,3,13,27,44,-17,21
Lyngby,6266,10,3,9,12,26,46,-20,18
AGF Aarhus,6266,11,4,6,12,16,38,-22,18
Brondby,6267,1,22,5,3,73,30,43,71
FC Midtjylla,6267,2,19,5,6,62,38,24,62
Copenhagen,6267,3,15,5,10,58,42,16,50
FC Nords,6267,4,14,6,10,69,49,20,48
AC Horsens,6267,5,7,14,9,36,52,-16,35
Sonderjyske,6267,6,8,6,10,28,29,-1,30
AaB,6267,7,6,11,13,37,50,-13,29
Randers FC,6267,8,5,7,12,24,40,-16,22
Silkeborg IF,6267,9,6,3,13,27,44,-17,21
Lyngby,6267,10,3,10,11,27,45,-18,19
AGF Aarhus,6267,11,4,6,12,16,38,-22,18
Brondby,6268,1,21,7,2,74,31,43,70
FC Midtjylla,6268,2,19,5,6,65,42,23,62
FC Nords,6268,3,15,7,8,72,48,24,52
Copenhagen,6268,4,14,6,10,57,43,14,48
AaB,6268,5,7,12,11,37,44,-7,33
Sonderjyske,6268,6,8,6,10,28,29,-1,30
AC Horsens,6268,7,5,13,12,33,56,-23,28
Lyngby,6268,8,4,9,11,28,45,-17,21
Randers FC,6268,9,5,6,13,24,41,-17,21
Silkeborg IF,6268,10,5,4,13,26,45,-19,19
AGF Aarhus,6268,11,4,7,11,17,37,-20,19
Brondby,6269,1,21,6,3,68,30,38,69
FC Midtjylla,6269,2,20,5,5,66,37,29,65
FC Nords,6269,3,14,8,8,71,50,21,50
Copenhagen,6269,4,15,4,11,57,44,13,49
AaB,6269,5,6,13,11,36,43,-7,31
Sonderjyske,6269,6,8,6,10,28,29,-1,30
AC Horsens,6269,7,5,14,11,32,52,-20,29
Randers FC,6269,8,6,6,12,28,40,-12,24
Silkeborg IF,6269,9,6,3,13,27,45,-18,21
AGF Aarhus,6269,10,4,6,12,17,38,-21,18
Lyngby,6269,11,3,9,12,27,49,-22,18
Brondby,6270,1,22,6,2,74,33,41,72
FC Midtjylla,6270,2,20,4,6,67,39,28,64
FC Nords,6270,3,16,6,8,78,51,27,54
Copenhagen,6270,4,14,5,11,60,48,12,47
AaB,6270,5,7,11,12,36,43,-7,32
Sonderjyske,6270,6,8,6,10,28,29,-1,30
AC Horsens,6270,7,5,12,13,30,57,-27,27
Randers FC,6270,8,6,6,12,24,39,-15,24
Silkeborg IF,6270,9,6,3,13,26,44,-18,21
Lyngby,6270,10,3,9,12,26,45,-19,18
AGF Aarhus,6270,11,4,6,12,16,37,-21,18
Brondby,6271,1,23,5,2,79,31,48,74
FC Midtjylla,6271,2,18,5,7,65,45,20,59
FC Nords,6271,3,14,7,9,75,55,20,49
Copenhagen,6271,4,12,6,12,56,50,6,42
AaB,6271,5,8,12,10,38,41,-3,36
AC Horsens,6271,6,7,13,10,37,54,-17,34
Sonderjyske,6271,7,8,6,10,28,29,-1,30
Randers FC,6271,8,5,7,12,23,39,-16,22
Silkeborg IF,6271,9,6,3,13,27,44,-17,21
Lyngby,6271,10,3,10,11,26,44,-18,19
AGF Aarhus,6271,11,4,6,12,16,38,-22,18
FC Midtjylla,6272,1,21,4,5,65,38,27,67
Brondby,6272,2,19,8,3,67,32,35,65
FC Nords,6272,3,14,6,10,76,53,23,48
Copenhagen,6272,4,14,6,10,59,43,16,48
AaB,6272,5,7,13,10,35,40,-5,34
AC Horsens,6272,6,6,13,11,33,55,-22,31
Sonderjyske,6272,7,8,6,10,28,29,-1,30
Lyngby,6272,8,4,9,11,29,45,-16,21
Silkeborg IF,6272,9,6,3,13,27,44,-17,21
Randers FC,6272,10,5,6,13,24,42,-18,21
AGF Aarhus,6272,11,4,6,12,16,38,-22,18
Brondby,6273,1,21,6,3,68,33,35,69
FC Midtjylla,6273,2,19,6,5,64,37,27,63
FC Nords,6273,3,15,6,9,74,52,22,51
Copenhagen,6273,4,13,6,11,58,46,12,45
AaB,6273,5,8,12,10,38,42,-4,36
Sonderjyske,6273,6,8,6,10,28,29,-1,30
AC Horsens,6273,7,6,12,12,38,56,-18,30
Randers FC,6273,8,6,6,12,25,39,-14,24
Silkeborg IF,6273,9,6,3,13,27,45,-18,21
Lyngby,6273,10,3,9,12,26,46,-20,18
AGF Aarhus,6273,11,4,6,12,17,38,-21,18
FC Midtjylla,6274,1,20,6,4,65,36,29,66
Brondby,6274,2,19,8,3,71,35,36,65
FC Nords,6274,3,15,7,8,79,51,28,52
Copenhagen,6274,4,13,6,11,57,49,8,45
AaB,6274,5,8,11,11,36,43,-7,35
Sonderjyske,6274,6,8,6,10,28,29,-1,30
AC Horsens,6274,7,6,12,12,36,56,-20,30
Randers FC,6274,8,6,6,12,25,40,-15,24
Silkeborg IF,6274,9,5,4,13,26,45,-19,19
AGF Aarhus,6274,10,4,7,11,17,37,-20,19
Lyngby,6274,11,3,9,12,27,46,-19,18
FC Midtjylla,6275,1,21,5,4,68,36,32,68
Brondby,6275,2,20,7,3,74,35,39,67
FC Nords,6275,3,14,6,10,71,52,19,48
Copenhagen,6275,4,13,4,13,54,45,9,43
AC Horsens,6275,5,8,13,9,36,51,-15,37
AaB,6275,6,7,11,12,36,46,-10,32
Sonderjyske,6275,7,8,6,10,28,29,-1,30
Lyngby,6275,8,4,9,11,28,45,-17,21
Silkeborg IF,6275,8,6,3,13,28,45,-17,21
Randers FC,6275,10,5,6,13,24,41,-17,21
AGF Aarhus,6275,11,4,6,12,17,39,-22,18
Brondby,6276,1,20,5,5,66,33,33,65
FC Midtjylla,6276,2,19,4,7,66,40,26,61
FC Nords,6276,3,15,7,8,71,47,24,52
Copenhagen,6276,4,15,6,9,56,39,17,51
AaB,6276,5,8,11,11,35,42,-7,35
AC Horsens,6276,6,6,13,11,32,51,-19,31
Sonderjyske,6276,7,8,6,10,28,29,-1,30
Randers FC,6276,8,5,7,12,24,40,-16,22
Silkeborg IF,6276,9,6,3,13,26,44,-18,21
Lyngby,6276,10,3,10,11,27,45,-18,19
AGF Aarhus,6276,11,4,6,12,16,37,-21,18
Brondby,6277,1,22,6,2,77,34,43,72
FC Midtjylla,6277,2,18,5,7,65,43,22,59
FC Nords,6277,3,14,7,9,78,53,25,49
Copenhagen,6277,4,13,5,12,57,50,7,44
AC Horsens,6277,5,8,14,8,41,50,-9,38
AaB,6277,6,6,13,11,33,47,-14,31
Sonderjyske,6277,7,8,6,10,28,29,-1,30
Lyngby,6277,8,4,9,11,28,44,-16,21
Randers FC,6277,9,5,6,13,23,41,-18,21
AGF Aarhus,6277,10,5,6,11,17,36,-19,21
Silkeborg IF,6277,11,5,3,14,25,45,-20,18
Brondby,6278,1,20,7,3,69,33,36,67
FC Midtjylla,6278,2,19,5,6,65,41,24,62
FC Nords,6278,3,14,9,7,72,48,24,51
Copenhagen,6278,4,14,5,11,56,45,11,47
AC Horsens,6278,5,7,13,10,35,48,-13,34
AaB,6278,6,7,11,12,38,46,-8,32
Sonderjyske,6278,7,8,6,10,28,29,-1,30
Randers FC,6278,8,5,7,12,24,40,-16,22
AGF Aarhus,6278,9,5,6,11,19,38,-19,21
Lyngby,6278,10,3,10,11,27,45,-18,19
Silkeborg IF,6278,11,5,3,14,27,47,-20,18
Brondby,6279,1,21,7,2,71,30,41,70
FC Midtjylla,6279,2,19,5,6,68,46,22,62
FC Nords,6279,3,14,7,9,75,52,23,49
Copenhagen,6279,4,14,5,11,60,46,14,47
AaB,6279,5,7,14,9,38,43,-5,35
Sonderjyske,6279,6,8,6,10,28,29,-1,30
AC Horsens,6279,7,5,14,11,34,55,-21,29
Randers FC,6279,8,6,6,12,26,41,-15,24
Silkeborg IF,6279,9,6,3,13,28,46,-18,21
Lyngby,6279,10,3,9,12,28,47,-19,18
AGF Aarhus,6279,11,4,6,12,18,39,-21,18
Brondby,6280,1,19,6,5,65,34,31,63
FC Midtjylla,6280,2,18,5,7,65,44,21,59
FC Nords,6280,3,16,7,7,80,50,30,55
Copenhagen,6280,4,16,5,9,65,45,20,53
AaB,6280,5,7,12,11,38,47,-9,33
AC Horsens,6280,6,6,13,11,35,54,-19,31
Sonderjyske,6280,7,8,6,10,28,29,-1,30
Randers FC,6280,8,5,7,12,23,39,-16,22
Silkeborg IF,6280,9,6,3,13,28,45,-17,21
Lyngby,6280,10,3,10,11,26,44,-18,19
AGF Aarhus,6280,11,4,6,12,17,39,-22,18
Brondby,6281,1,22,6,2,76,32,44,72
FC Midtjylla,6281,2,20,5,5,71,38,33,65
FC Nords,6281,3,15,6,9,79,54,25,51
Copenhagen,6281,4,14,5,11,60,52,8,47
Sonderjyske,6281,5,8,6,10,28,29,-1,30
AaB,6281,6,6,12,12,35,50,-15,30
AC Horsens,6281,7,6,12,12,36,57,-21,30
Lyngby,6281,8,4,9,11,28,44,-16,21
Silkeborg IF,6281,9,6,3,13,27,44,-17,21
Randers FC,6281,10,5,6,13,23,41,-18,21
AGF Aarhus,6281,11,4,6,12,16,38,-22,18
FC Midtjylla,6282,1,20,6,4,64,36,28,66
Brondby,6282,2,19,6,5,68,36,32,63
FC Nords,6282,3,14,9,7,73,49,24,51
Copenhagen,6282,4,15,5,10,63,45,18,50
AaB,6282,5,7,13,10,35,41,-6,34
Sonderjyske,6282,6,8,6,10,28,29,-1,30
AC Horsens,6282,7,5,13,12,33,55,-22,28
Randers FC,6282,8,5,7,12,26,42,-16,22
Silkeborg IF,6282,9,6,3,13,28,46,-18,21
Lyngby,6282,10,3,10,11,29,47,-18,19
AGF Aarhus,6282,11,4,6,12,18,39,-21,18
Brondby,6283,1,19,8,3,68,33,35,65
FC Midtjylla,6283,2,20,5,5,69,41,28,65
FC Nords,6283,3,14,6,10,76,56,20,48
Copenhagen,6283,4,13,6,11,60,48,12,45
AaB,6283,5,8,12,10,37,43,-6,36
AC Horsens,6283,6,7,13,10,36,51,-15,34
Sonderjyske,6283,7,8,6,10,28,29,-1,30
Randers FC,6283,8,6,6,12,24,39,-15,24
AGF Aarhus,6283,9,5,6,11,17,36,-19,21
Lyngby,6283,10,3,9,12,26,45,-19,18
Silkeborg IF,6283,11,5,3,14,25,45,-20,18
Brondby,6284,1,22,6,2,74,29,45,72
FC Midtjylla,6284,2,20,4,6,70,42,28,64
FC Nords,6284,3,14,6,10,73,59,14,48
Copenhagen,6284,4,14,5,11,60,47,13,47
AaB,6284,5,7,12,11,40,46,-6,33
AC Horsens,6284,6,6,13,11,34,54,-20,31
Sonderjyske,6284,7,8,6,10,28,29,-1,30
Randers FC,6284,8,6,6,12,25,39,-14,24
Silkeborg IF,6284,9,6,3,13,27,45,-18,21
Lyngby,6284,10,3,9,12,26,46,-20,18
AGF Aarhus,6284,11,4,6,12,17,38,-21,18
Brondby,6285,1,21,5,4,72,34,38,68
FC Midtjylla,6285,2,20,4,6,69,42,27,64
Copenhagen,6285,3,16,4,10,64,42,22,52
FC Nords,6285,4,14,6,10,75,52,23,48
AC Horsens,6285,5,7,12,11,35,54,-19,33
AaB,6285,6,7,11,12,38,55,-17,32
Sonderjyske,6285,7,8,6,10,28,29,-1,30
Lyngby,6285,8,4,9,11,30,46,-16,21
Silkeborg IF,6285,9,6,3,13,26,44,-18,21
Randers FC,6285,10,5,6,13,25,43,-18,21
AGF Aarhus,6285,11,4,6,12,16,37,-21,18
Brondby,6286,1,22,5,3,72,32,40,71
FC Midtjylla,6286,2,20,5,5,62,38,24,65
FC Nords,6286,3,13,8,9,72,53,19,47
Copenhagen,6286,4,13,6,11,57,45,12,45
AC Horsens,6286,5,6,15,9,35,48,-13,33
AaB,6286,6,6,13,11,34,42,-8,31
Sonderjyske,6286,7,8,6,10,28,29,-1,30
Lyngby,6286,8,4,9,11,29,45,-16,21
AGF Aarhus,6286,9,5,6,11,19,36,-17,21
Randers FC,6286,10,5,6,13,24,42,-18,21
Silkeborg IF,6286,11,5,3,14,25,47,-22,18
Brondby,6287,1,23,5,2,76,32,44,74
FC Midtjylla,6287,2,18,7,5,64,41,23,61
FC Nords,6287,3,12,9,9,71,54,17,45
Copenhagen,6287,4,13,6,11,60,46,14,45
AaB,6287,5,7,13,10,36,42,-6,34
AC Horsens,6287,6,6,14,10,36,54,-18,32
Sonderjyske,6287,7,8,6,10,28,29,-1,30
Lyngby,6287,8,4,9,11,28,45,-17,21
Randers FC,6287,9,5,6,13,24,41,-17,21
AGF Aarhus,6287,10,5,6,11,18,37,-19,21
Silkeborg IF,6287,11,5,3,14,26,46,-20,18
FC Midtjylla,6288,1,22,4,4,74,34,40,70
Brondby,6288,2,20,5,5,71,36,35,65
Copenhagen,6288,3,15,5,10,58,44,14,50
FC Nords,6288,4,13,7,10,75,58,17,46
AC Horsens,6288,5,7,13,10,36,54,-18,34
Sonderjyske,6288,6,8,6,10,28,29,-1,30
AaB,6288,7,6,12,12,37,51,-14,30
Randers FC,6288,8,5,7,12,23,39,-16,22
Silkeborg IF,6288,9,6,3,13,27,45,-18,21
Lyngby,6288,10,3,10,11,26,44,-18,19
AGF Aarhus,6288,11,4,6,12,17,38,-21,18
Brondby,6289,1,20,6,4,71,35,36,66
FC Midtjylla,6289,2,18,7,5,63,41,22,61
FC Nords,6289,3,15,7,8,79,53,26,52
Copenhagen,6289,4,14,6,10,59,45,14,48
AC Horsens,6289,5,7,13,10,35,50,-15,34
AaB,6289,6,7,11,12,36,45,-9,32
Sonderjyske,6289,7,8,6,10,28,29,-1,30
Lyngby,6289,8,4,9,11,30,44,-14,21
AGF Aarhus,6289,9,5,6,11,18,36,-18,21
Randers FC,6289,10,5,6,13,23,43,-20,21
Silkeborg IF,6289,11,5,3,14,25,46,-21,18
FC Midtjylla,6290,1,20,5,5,66,39,27,65
Brondby,6290,2,19,6,5,71,35,36,63
FC Nords,6290,3,14,7,9,74,53,21,49
Copenhagen,6290,4,14,5,11,61,47,14,47
AaB,6290,5,9,12,9,39,43,-4,39
AC Horsens,6290,6,6,13,11,37,57,-20,31
Sonderjyske,6290,7,8,6,10,28,29,-1,30
Randers FC,6290,8,6,6,12,25,39,-14,24
Silkeborg IF,6290,9,5,4,13,25,44,-19,19
AGF Aarhus,6290,10,4,7,11,16,36,-20,19
Lyngby,6290,11,3,9,12,26,46,-20,18
Brondby,6291,1,21,6,3,72,32,40,69
FC Midtjylla,6291,2,20,5,5,68,42,26,65
FC Nords,6291,3,14,8,8,76,54,22,50
Copenhagen,6291,4,13,6,11,58,46,12,45
AaB,6291,5,7,12,11,38,45,-7,33
AC Horsens,6291,6,6,13,11,37,56,-19,31
Sonderjyske,6291,7,8,6,10,28,29,-1,30
Randers FC,6291,8,5,7,12,25,41,-16,22
AGF Aarhus,6291,9,5,6,11,19,36,-17,21
Lyngby,6291,10,3,10,11,28,46,-18,19
Silkeborg IF,6291,11,5,3,14,25,47,-22,18
Brondby,6292,1,21,6,3,76,36,40,69
FC Midtjylla,6292,2,18,6,6,65,42,23,60
FC Nords,6292,3,15,7,8,75,49,26,52
Copenhagen,6292,4,15,5,10,60,44,16,50
AaB,6292,5,7,12,11,38,50,-12,33
Sonderjyske,6292,6,8,6,10,28,29,-1,30
AC Horsens,6292,7,6,12,12,34,53,-19,30
Randers FC,6292,8,5,7,12,24,40,-16,22
Silkeborg IF,6292,9,6,3,13,27,44,-17,21
Lyngby,6292,10,3,10,11,27,45,-18,19
AGF Aarhus,6292,11,4,6,12,16,38,-22,18
Brondby,6293,1,21,5,4,73,36,37,68
FC Midtjylla,6293,2,21,4,5,67,37,30,67
FC Nords,6293,3,14,6,10,74,53,21,48
Copenhagen,6293,4,14,4,12,58,48,10,46
AaB,6293,5,8,11,11,38,44,-6,35
AC Horsens,6293,6,7,12,11,37,55,-18,33
Sonderjyske,6293,7,8,6,10,28,29,-1,30
Lyngby,6293,8,4,9,11,28,45,-17,21
Randers FC,6293,9,5,6,13,24,41,-17,21
Silkeborg IF,6293,10,6,3,13,27,45,-18,21
AGF Aarhus,6293,11,4,6,12,17,38,-21,18
FC Midtjylla,6294,1,21,5,4,70,35,35,68
Brondby,6294,2,20,6,4,70,32,38,66
FC Nords,6294,3,14,7,9,71,52,19,49
Copenhagen,6294,4,13,7,10,57,47,10,46
AaB,6294,5,7,13,10,35,42,-7,34
Sonderjyske,6294,6,8,6,10,28,29,-1,30
AC Horsens,6294,7,5,14,11,33,54,-21,29
Silkeborg IF,6294,8,6,3,13,29,45,-16,21
Lyngby,6294,9,4,9,11,27,44,-17,21
Randers FC,6294,10,5,6,13,23,40,-17,21
AGF Aarhus,6294,11,4,6,12,17,40,-23,18
Brondby,6295,1,21,6,3,66,29,37,69
FC Midtjylla,6295,2,21,4,5,68,39,29,67
FC Nords,6295,3,15,7,8,74,51,23,52
Copenhagen,6295,4,12,4,14,55,47,8,40
AaB,6295,5,8,11,11,41,46,-5,35
AC Horsens,6295,6,7,12,11,37,55,-18,33
Sonderjyske,6295,7,8,6,10,28,29,-1,30
Lyngby,6295,8,4,9,11,29,46,-17,21
Randers FC,6295,9,5,6,13,25,42,-17,21
AGF Aarhus,6295,10,5,6,11,17,36,-19,21
Silkeborg IF,6295,11,5,3,14,25,45,-20,18
Brondby,6296,1,21,6,3,70,30,40,69
FC Midtjylla,6296,2,19,4,7,64,39,25,61
FC Nords,6296,3,16,6,8,76,53,23,54
Copenhagen,6296,4,13,4,13,54,45,9,43
AaB,6296,5,8,12,10,35,40,-5,36
AC Horsens,6296,6,7,12,11,34,52,-18,33
Sonderjyske,6296,7,8,6,10,28,29,-1,30
Lyngby,6296,8,4,9,11,28,45,-17,21
Randers FC,6296,9,5,6,13,24,41,-17,21
Silkeborg IF,6296,10,5,4,13,25,44,-19,19
AGF Aarhus,6296,11,4,7,11,16,36,-20,19
Brondby,6297,1,22,6,2,71,31,40,72
FC Midtjylla,6297,2,19,5,6,63,37,26,62
FC Nords,6297,3,15,7,8,75,49,26,52
Copenhagen,6297,4,14,4,12,57,48,9,46
AC Horsens,6297,5,7,12,11,37,54,-17,33
Sonderjyske,6297,6,8,6,10,28,29,-1,30
AaB,6297,7,6,12,12,35,45,-10,30
Lyngby,6297,8,4,9,11,30,44,-14,21
Randers FC,6297,9,5,6,13,23,43,-20,21
Silkeborg IF,6297,10,5,4,13,26,45,-19,19
AGF Aarhus,6297,11,4,7,11,17,37,-20,19
Brondby,6298,1,20,7,3,70,33,37,67
FC Midtjylla,6298,2,19,4,7,65,44,21,61
Copenhagen,6298,3,15,5,10,59,43,16,50
FC Nords,6298,4,13,7,10,68,48,20,46
AaB,6298,5,8,11,11,39,45,-6,35
AC Horsens,6298,6,7,14,9,38,52,-14,35
Sonderjyske,6298,7,8,6,10,28,29,-1,30
Randers FC,6298,8,5,7,12,24,40,-16,22
Silkeborg IF,6298,9,6,3,13,27,44,-17,21
Lyngby,6298,10,3,10,11,27,45,-18,19
AGF Aarhus,6298,11,4,6,12,16,38,-22,18
Brondby,6299,1,20,7,3,70,31,39,67
FC Midtjylla,6299,2,20,4,6,64,41,23,64
FC Nords,6299,3,15,7,8,73,51,22,52
Copenhagen,6299,4,14,6,10,61,44,17,48
AaB,6299,5,7,12,11,34,42,-8,33
Sonderjyske,6299,6,8,6,10,28,29,-1,30
AC Horsens,6299,7,6,12,12,35,54,-19,30
Randers FC,6299,8,5,7,12,24,40,-16,22
Silkeborg IF,6299,9,6,3,13,28,44,-16,21
Lyngby,6299,10,3,10,11,27,45,-18,19
AGF Aarhus,6299,11,4,6,12,16,39,-23,18
Brondby,6300,1,21,6,3,68,31,37,69
FC Midtjylla,6300,2,19,4,7,64,40,24,61
FC Nords,6300,3,15,7,8,77,51,26,52
Copenhagen,6300,4,14,4,12,56,43,13,46
AaB,6300,5,8,11,11,39,47,-8,35
AC Horsens,6300,6,7,12,11,39,57,-18,33
Sonderjyske,6300,7,8,6,10,28,29,-1,30
Randers FC,6300,8,5,7,12,25,41,-16,22
AGF Aarhus,6300,9,5,6,11,17,36,-19,21
Lyngby,6300,10,3,10,11,28,46,-18,19
Silkeborg IF,6300,11,5,3,14,25,45,-20,18
FC Midtjylla,6301,1,20,5,5,65,39,26,65
Brondby,6301,2,18,9,3,69,35,34,63
FC Nords,6301,3,13,8,9,71,51,20,47
Copenhagen,6301,4,13,6,11,55,43,12,45
AaB,6301,5,8,12,10,42,45,-3,36
AC Horsens,6301,6,7,14,9,38,53,-15,35
Sonderjyske,6301,7,8,6,10,28,29,-1,30
Randers FC,6301,8,5,7,12,24,40,-16,22
Silkeborg IF,6301,9,6,3,13,28,46,-18,21
Lyngby,6301,10,3,10,11,27,45,-18,19
AGF Aarhus,6301,11,4,6,12,18,39,-21,18
FC Midtjylla,6302,1,22,4,4,70,36,34,70
Brondby,6302,2,19,6,5,67,34,33,63
FC Nords,6302,3,13,9,8,72,51,21,48
Copenhagen,6302,4,13,6,11,53,46,7,45
AC Horsens,6302,5,7,14,9,38,50,-12,35
AaB,6302,6,6,13,11,35,44,-9,31
Sonderjyske,6302,7,8,6,10,28,29,-1,30
Randers FC,6302,8,5,7,12,25,41,-16,22
AGF Aarhus,6302,9,5,6,11,17,36,-19,21
Lyngby,6302,10,3,10,11,28,46,-18,19
Silkeborg IF,6302,11,5,3,14,25,45,-20,18
Brondby,6303,1,22,6,2,72,31,41,72
FC Midtjylla,6303,2,20,5,5,63,38,25,65
FC Nords,6303,3,13,8,9,71,52,19,47
Copenhagen,6303,4,12,4,14,55,48,7,40
AaB,6303,5,8,12,10,37,41,-4,36
AC Horsens,6303,6,6,15,9,37,51,-14,33
Sonderjyske,6303,7,8,6,10,28,29,-1,30
Lyngby,6303,8,4,9,11,28,45,-17,21
Randers FC,6303,9,5,6,13,24,41,-17,21
AGF Aarhus,6303,10,5,6,11,17,36,-19,21
Silkeborg IF,6303,11,5,3,14,25,45,-20,18
Brondby,6304,1,21,7,2,73,30,43,70
FC Midtjylla,6304,2,19,5,6,64,41,23,62
FC Nords,6304,3,14,6,10,76,52,24,48
Copenhagen,6304,4,13,5,12,55,51,4,44
AaB,6304,5,8,13,9,41,41,0,37
AC Horsens,6304,6,6,14,10,35,55,-20,32
Sonderjyske,6304,7,8,6,10,28,29,-1,30
Randers FC,6304,8,5,7,12,24,40,-16,22
Lyngby,6304,9,3,10,11,27,45,-18,19
Silkeborg IF,6304,10,5,4,13,26,45,-19,19
AGF Aarhus,6304,11,4,7,11,17,37,-20,19
Brondby,6305,1,20,7,3,67,31,36,67
FC Midtjylla,6305,2,19,5,6,68,40,28,62
FC Nords,6305,3,15,7,8,75,53,22,52
Copenhagen,6305,4,14,5,11,57,43,14,47
AC Horsens,6305,5,6,15,9,37,55,-18,33
AaB,6305,6,6,13,11,35,43,-8,31
Sonderjyske,6305,7,8,6,10,28,29,-1,30
Lyngby,6305,8,4,9,11,27,44,-17,21
Randers FC,6305,9,5,6,13,23,40,-17,21
AGF Aarhus,6305,10,5,6,11,19,36,-17,21
Silkeborg IF,6305,11,5,3,14,25,47,-22,18
Brondby,6306,1,23,5,2,79,32,47,74
FC Midtjylla,6306,2,20,5,5,70,43,27,65
FC Nords,6306,3,15,7,8,76,52,24,52
Copenhagen,6306,4,13,4,13,56,46,10,43
AaB,6306,5,7,11,12,36,50,-14,32
Sonderjyske,6306,6,8,6,10,28,29,-1,30
AC Horsens,6306,7,6,12,12,34,54,-20,30
Randers FC,6306,8,6,6,12,24,39,-15,24
Silkeborg IF,6306,9,6,3,13,29,44,-15,21
Lyngby,6306,10,3,9,12,26,45,-19,18
AGF Aarhus,6306,11,4,6,12,16,40,-24,18
Brondby,6307,1,20,8,2,74,35,39,68
FC Midtjylla,6307,2,20,5,5,66,40,26,65
FC Nords,6307,3,15,7,8,74,46,28,52
Copenhagen,6307,4,13,4,13,58,46,12,43
AaB,6307,5,7,13,10,38,46,-8,34
Sonderjyske,6307,6,8,6,10,28,29,-1,30
AC Horsens,6307,7,5,15,10,33,56,-23,30
Randers FC,6307,8,6,6,12,25,40,-15,24
Silkeborg IF,6307,9,5,4,13,27,46,-19,19
AGF Aarhus,6307,10,4,7,11,18,38,-20,19
Lyngby,6307,11,3,9,12,27,46,-19,18
Brondby,6308,1,22,6,2,76,28,48,72
FC Midtjylla,6308,2,20,5,5,67,35,32,65
FC Nords,6308,3,14,6,10,68,53,15,48
Copenhagen,6308,4,14,4,12,56,50,6,46
AaB,6308,5,7,12,11,33,42,-9,33
AC Horsens,6308,6,6,13,11,36,54,-18,31
Sonderjyske,6308,7,8,6,10,28,29,-1,30
Lyngby,6308,8,4,9,11,29,45,-16,21
Silkeborg IF,6308,9,6,3,13,28,45,-17,21
Randers FC,6308,10,5,6,13,24,42,-18,21
AGF Aarhus,6308,11,4,6,12,17,39,-22,18
FC Midtjylla,6309,1,21,4,5,64,34,30,67
Brondby,6309,2,20,6,4,69,34,35,66
Copenhagen,6309,3,16,4,10,56,39,17,52
FC Nords,6309,4,14,7,9,72,52,20,49
AaB,6309,5,6,13,11,39,48,-9,31
Sonderjyske,6309,6,8,6,10,28,29,-1,30
AC Horsens,6309,7,5,14,11,31,50,-19,29
Randers FC,6309,8,5,7,12,24,40,-16,22
Silkeborg IF,6309,9,6,3,13,27,44,-17,21
Lyngby,6309,10,3,10,11,27,45,-18,19
AGF Aarhus,6309,11,4,6,12,16,38,-22,18
Brondby,6310,1,20,8,2,70,29,41,68
FC Midtjylla,6310,2,20,6,4,65,36,29,66
FC Nords,6310,3,13,10,7,73,49,24,49
Copenhagen,6310,4,13,6,11,57,45,12,45
AaB,6310,5,7,12,11,37,49,-12,33
Sonderjyske,6310,6,8,6,10,28,29,-1,30
AC Horsens,6310,7,5,14,11,33,53,-20,29
Randers FC,6310,8,6,6,12,24,39,-15,24
Silkeborg IF,6310,9,6,3,13,26,44,-18,21
Lyngby,6310,10,3,9,12,26,45,-19,18
AGF Aarhus,6310,11,4,6,12,16,37,-21,18
Brondby,6311,1,21,5,4,72,35,37,68
FC Midtjylla,6311,2,21,4,5,73,45,28,67
FC Nords,6311,3,15,6,9,73,50,23,51
Copenhagen,6311,4,15,4,11,62,46,16,49
AaB,6311,5,7,11,12,38,48,-10,32
Sonderjyske,6311,6,8,6,10,28,29,-1,30
AC Horsens,6311,7,6,12,12,41,61,-20,30
Lyngby,6311,8,4,9,11,29,45,-16,21
Randers FC,6311,9,5,6,13,24,42,-18,21
Silkeborg IF,6311,10,5,4,13,26,45,-19,19
AGF Aarhus,6311,11,4,7,11,17,37,-20,19
Brondby,6312,1,20,5,5,71,39,32,65
FC Midtjylla,6312,2,20,5,5,72,41,31,65
FC Nords,6312,3,14,6,10,72,52,20,48
Copenhagen,6312,4,14,5,11,60,52,8,47
AaB,6312,5,8,12,10,39,42,-3,36
AC Horsens,6312,6,7,13,10,38,52,-14,34
Sonderjyske,6312,7,8,6,10,28,29,-1,30
Randers FC,6312,8,5,7,12,24,40,-16,22
Lyngby,6312,9,3,10,11,27,45,-18,19
Silkeborg IF,6312,10,5,4,13,25,44,-19,19
AGF Aarhus,6312,11,4,7,11,16,36,-20,19
Brondby,6313,1,19,5,6,68,37,31,62
FC Midtjylla,6313,2,19,4,7,69,44,25,61
FC Nords,6313,3,16,7,7,72,47,25,55
Copenhagen,6313,4,14,4,12,60,47,13,46
AaB,6313,5,9,12,9,40,41,-1,39
AC Horsens,6313,6,6,14,10,36,55,-19,32
Sonderjyske,6313,7,8,6,10,28,29,-1,30
Randers FC,6313,8,5,7,12,23,39,-16,22
Lyngby,6313,9,3,10,11,26,44,-18,19
Silkeborg IF,6313,10,5,4,13,27,46,-19,19
AGF Aarhus,6313,11,4,7,11,18,38,-20,19
Brondby,6314,1,21,5,4,75,37,38,68
FC Midtjylla,6314,2,20,5,5,69,41,28,65
FC Nords,6314,3,14,8,8,74,51,23,50
Copenhagen,6314,4,12,7,11,57,49,8,43
AaB,6314,5,7,13,10,37,43,-6,34
AC Horsens,6314,6,5,16,9,37,54,-17,31
Sonderjyske,6314,7,8,6,10,28,29,-1,30
Randers FC,6314,8,5,7,12,25,41,-16,22
AGF Aarhus,6314,9,5,6,11,17,36,-19,21
Lyngby,6314,10,3,10,11,28,46,-18,19
Silkeborg IF,6314,11,5,3,14,25,45,-20,18
Brondby,6315,1,21,5,4,73,31,42,68
FC Midtjylla,6315,2,19,4,7,62,40,22,61
FC Nords,6315,3,14,6,10,68,50,18,48
Copenhagen,6315,4,13,4,13,53,48,5,43
AC Horsens,6315,5,9,12,9,38,49,-11,39
AaB,6315,6,9,11,10,40,42,-2,38
Sonderjyske,6315,7,8,6,10,28,29,-1,30
Randers FC,6315,8,6,6,12,25,40,-15,24
AGF Aarhus,6315,9,5,6,11,18,37,-19,21
Lyngby,6315,10,3,9,12,27,46,-19,18
Silkeborg IF,6315,11,5,3,14,26,46,-20,18
Brondby,6316,1,20,6,4,68,34,34,66
FC Midtjylla,6316,2,19,5,6,63,40,23,62
Copenhagen,6316,3,15,6,9,61,43,18,51
FC Nords,6316,4,14,6,10,71,49,22,48
AC Horsens,6316,5,7,13,10,35,51,-16,34
AaB,6316,6,7,12,11,37,44,-7,33
Sonderjyske,6316,7,8,6,10,28,29,-1,30
Randers FC,6316,8,5,7,12,25,41,-16,22
Lyngby,6316,9,3,10,11,28,46,-18,19
Silkeborg IF,6316,10,5,4,13,27,46,-19,19
AGF Aarhus,6316,11,4,7,11,18,38,-20,19
Brondby,6317,1,22,5,3,73,30,43,71
FC Midtjylla,6317,2,20,5,5,64,37,27,65
FC Nords,6317,3,13,7,10,71,52,19,46
Copenhagen,6317,4,12,6,12,56,48,8,42
AaB,6317,5,8,13,9,37,43,-6,37
AC Horsens,6317,6,6,14,10,35,52,-17,32
Sonderjyske,6317,7,8,6,10,28,29,-1,30
Lyngby,6317,8,4,9,11,28,44,-16,21
Silkeborg IF,6317,9,6,3,13,28,46,-18,21
Randers FC,6317,10,5,6,13,23,41,-18,21
AGF Aarhus,6317,11,4,6,12,18,39,-21,18
Brondby,6318,1,20,6,4,67,32,35,66
FC Midtjylla,6318,2,18,5,7,62,43,19,59
FC Nords,6318,3,14,7,9,73,50,23,49
Copenhagen,6318,4,15,4,11,60,46,14,49
AC Horsens,6318,5,8,13,9,37,49,-12,37
AaB,6318,6,8,11,11,36,41,-5,35
Sonderjyske,6318,7,8,6,10,28,29,-1,30
Lyngby,6318,8,4,9,11,28,44,-16,21
Silkeborg IF,6318,9,6,3,13,28,46,-18,21
Randers FC,6318,10,5,6,13,23,41,-18,21
AGF Aarhus,6318,11,4,6,12,18,39,-21,18
Brondby,6319,1,20,8,2,73,33,40,68
FC Midtjylla,6319,2,20,5,5,64,37,27,65
FC Nords,6319,3,14,6,10,77,55,22,48
Copenhagen,6319,4,12,6,12,54,50,4,42
AaB,6319,5,8,11,11,39,46,-7,35
AC Horsens,6319,6,7,14,9,37,49,-12,35
Sonderjyske,6319,7,8,6,10,28,29,-1,30
Randers FC,6319,8,6,6,12,24,39,-15,24
Silkeborg IF,6319,9,5,4,13,27,46,-19,19
AGF Aarhus,6319,10,4,7,11,18,38,-20,19
Lyngby,6319,11,3,9,12,26,45,-19,18
Brondby,6320,1,20,6,4,70,35,35,66
FC Midtjylla,6320,2,19,5,6,65,42,23,62
FC Nords,6320,3,13,8,9,73,54,19,47
Copenhagen,6320,4,13,7,10,60,44,16,46
AC Horsens,6320,5,8,13,9,38,51,-13,37
AaB,6320,6,7,13,10,35,41,-6,34
Sonderjyske,6320,7,8,6,10,28,29,-1,30
Randers FC,6320,8,5,7,12,24,40,-16,22
Silkeborg IF,6320,9,6,3,13,28,46,-18,21
Lyngby,6320,10,3,10,11,27,45,-18,19
AGF Aarhus,6320,11,4,6,12,18,39,-21,18
Brondby,6321,1,21,7,2,72,32,40,70
FC Midtjylla,6321,2,20,5,5,65,40,25,65
FC Nords,6321,3,14,8,8,78,54,24,50
Copenhagen,6321,4,14,6,10,61,45,16,48
Sonderjyske,6321,5,8,6,10,28,29,-1,30
AaB,6321,6,6,12,12,34,45,-11,30
AC Horsens,6321,7,5,14,11,35,55,-20,29
Randers FC,6321,8,6,6,12,26,40,-14,24
Silkeborg IF,6321,9,6,3,13,26,44,-18,21
Lyngby,6321,10,3,9,12,27,47,-20,18
AGF Aarhus,6321,11,4,6,12,16,37,-21,18
Brondby,6322,1,21,6,3,75,32,43,69
FC Midtjylla,6322,2,19,4,7,65,43,22,61
FC Nords,6322,3,14,6,10,75,55,20,48
Copenhagen,6322,4,14,6,10,60,50,10,48
AaB,6322,5,9,11,10,45,47,-2,38
AC Horsens,6322,6,6,13,11,33,52,-19,31
Sonderjyske,6322,7,8,6,10,28,29,-1,30
Lyngby,6322,8,4,9,11,28,45,-17,21
Randers FC,6322,9,5,6,13,24,41,-17,21
AGF Aarhus,6322,10,5,6,11,18,37,-19,21
Silkeborg IF,6322,11,5,3,14,26,46,-20,18
Brondby,6323,1,21,5,4,69,35,34,68
FC Midtjylla,6323,2,18,6,6,64,39,25,60
FC Nords,6323,3,14,6,10,78,56,22,48
Copenhagen,6323,4,14,6,10,59,46,13,48
AaB,6323,5,8,12,10,39,46,-7,36
AC Horsens,6323,6,7,13,10,41,54,-13,34
Sonderjyske,6323,7,8,6,10,28,29,-1,30
Lyngby,6323,8,4,9,11,28,44,-16,21
Silkeborg IF,6323,9,6,3,13,26,44,-18,21
Randers FC,6323,10,5,6,13,23,41,-18,21
AGF Aarhus,6323,11,4,6,12,16,37,-21,18
FC Midtjylla,6324,1,19,5,6,63,40,23,62
Brondby,6324,2,18,7,5,66,37,29,61
FC Nords,6324,3,16,6,8,73,47,26,54
Copenhagen,6324,4,14,6,10,61,44,17,48
AaB,6324,5,7,13,10,36,42,-6,34
AC Horsens,6324,6,7,13,10,38,53,-15,34
Sonderjyske,6324,7,8,6,10,28,29,-1,30
Randers FC,6324,8,6,6,12,28,39,-11,24
Silkeborg IF,6324,9,6,3,13,28,46,-18,21
AGF Aarhus,6324,10,4,6,12,18,39,-21,18
Lyngby,6324,11,3,9,12,26,49,-23,18
Brondby,6325,1,19,7,4,74,37,37,64
FC Midtjylla,6325,2,17,6,7,63,43,20,57
FC Nords,6325,3,16,7,7,77,49,28,55
Copenhagen,6325,4,14,6,10,56,41,15,48
AC Horsens,6325,5,7,14,9,37,53,-16,35
AaB,6325,6,6,14,10,36,46,-10,32
Sonderjyske,6325,7,8,6,10,28,29,-1,30
Lyngby,6325,8,4,9,11,29,44,-15,21
Silkeborg IF,6325,9,6,3,13,26,44,-18,21
Randers FC,6325,10,5,6,13,23,42,-19,21
AGF Aarhus,6325,11,4,6,12,16,37,-21,18
Brondby,6326,1,22,6,2,73,32,41,72
FC Midtjylla,6326,2,20,4,6,65,39,26,64
FC Nords,6326,3,14,6,10,72,49,23,48
Copenhagen,6326,4,14,5,11,58,46,12,47
AC Horsens,6326,5,7,13,10,37,54,-17,34
Sonderjyske,6326,6,8,6,10,28,29,-1,30
AaB,6326,7,6,12,12,36,47,-11,30
Lyngby,6326,8,4,9,11,28,44,-16,21
Silkeborg IF,6326,9,6,3,13,26,44,-18,21
Randers FC,6326,10,5,6,13,23,41,-18,21
AGF Aarhus,6326,11,4,6,12,16,37,-21,18
FC Midtjylla,6327,1,20,5,5,66,36,30,65
Brondby,6327,2,19,7,4,67,33,34,64
Copenhagen,6327,3,16,4,10,62,46,16,52
FC Nords,6327,4,14,7,9,74,52,22,49
AaB,6327,5,7,12,11,37,44,-7,33
AC Horsens,6327,6,6,13,11,34,55,-21,31
Sonderjyske,6327,7,8,6,10,28,29,-1,30
Lyngby,6327,8,4,9,11,29,46,-17,21
Randers FC,6327,9,5,6,13,25,42,-17,21
Silkeborg IF,6327,10,5,4,13,26,45,-19,19
AGF Aarhus,6327,11,4,7,11,17,37,-20,19
Brondby,6328,1,21,5,4,71,30,41,68
FC Midtjylla,6328,2,18,6,6,64,43,21,60
Copenhagen,6328,3,16,5,9,60,41,19,53
FC Nords,6328,4,13,8,9,71,54,17,47
AaB,6328,5,7,12,11,36,46,-10,33
AC Horsens,6328,6,7,12,11,38,52,-14,33
Sonderjyske,6328,7,8,6,10,28,29,-1,30
Lyngby,6328,8,4,9,11,32,45,-13,21
Silkeborg IF,6328,9,6,3,13,27,45,-18,21
Randers FC,6328,10,5,6,13,24,45,-21,21
AGF Aarhus,6328,11,4,6,12,17,38,-21,18
Brondby,6329,1,20,7,3,70,32,38,67
FC Midtjylla,6329,2,20,5,5,65,38,27,65
FC Nords,6329,3,15,7,8,70,46,24,52
Copenhagen,6329,4,14,5,11,54,42,12,47
AC Horsens,6329,5,6,15,9,34,50,-16,33
Sonderjyske,6329,6,8,6,10,28,29,-1,30
AaB,6329,7,6,11,13,34,45,-11,29
Lyngby,6329,8,4,9,11,28,45,-17,21
Randers FC,6329,9,5,6,13,24,41,-17,21
Silkeborg IF,6329,10,6,3,13,26,44,-18,21
AGF Aarhus,6329,11,4,6,12,16,37,-21,18
Brondby,6330,1,20,7,3,72,36,36,67
FC Midtjylla,6330,2,20,4,6,67,41,26,64
FC Nords,6330,3,15,6,9,73,50,23,51
Copenhagen,6330,4,15,5,10,58,44,14,50
AaB,6330,5,7,12,11,34,42,-8,33
Sonderjyske,6330,6,8,6,10,28,29,-1,30
AC Horsens,6330,7,6,12,12,34,51,-17,30
Randers FC,6330,8,5,7,12,25,41,-16,22
AGF Aarhus,6330,9,5,6,11,19,36,-17,21
Lyngby,6330,10,3,10,11,28,46,-18,19
Silkeborg IF,6330,11,5,3,14,25,47,-22,18
Brondby,6331,1,20,7,3,65,29,36,67
FC Midtjylla,6331,2,20,4,6,65,37,28,64
FC Nords,6331,3,14,8,8,72,48,24,50
Copenhagen,6331,4,14,5,11,54,42,12,47
AaB,6331,5,7,12,11,34,46,-12,33
AC Horsens,6331,6,6,14,10,35,49,-14,32
Sonderjyske,6331,7,8,6,10,28,29,-1,30
Lyngby,6331,8,4,9,11,28,44,-16,21
Silkeborg IF,6331,9,6,3,13,26,44,-18,21
Randers FC,6331,10,5,6,13,23,41,-18,21
AGF Aarhus,6331,11,4,6,12,16,37,-21,18
Brondby,6332,1,21,7,2,74,30,44,70
FC Midtjylla,6332,2,21,5,4,69,39,30,68
FC Nords,6332,3,13,7,10,70,52,18,46
Copenhagen,6332,4,12,4,14,52,49,3,40
AaB,6332,5,8,13,9,42,44,-2,37
AC Horsens,6332,6,7,12,11,38,57,-19,33
Sonderjyske,6332,7,8,6,10,28,29,-1,30
Lyngby,6332,8,4,9,11,28,45,-17,21
Randers FC,6332,9,5,6,13,24,41,-17,21
AGF Aarhus,6332,10,5,6,11,17,36,-19,21
Silkeborg IF,6332,11,5,3,14,25,45,-20,18
Brondby,6333,1,21,7,2,72,30,42,70
FC Midtjylla,6333,2,19,5,6,66,41,25,62
FC Nords,6333,3,13,10,7,69,47,22,49
Copenhagen,6333,4,13,8,9,59,43,16,47
AaB,6333,5,6,13,11,35,44,-9,31
Sonderjyske,6333,6,8,6,10,28,29,-1,30
AC Horsens,6333,7,5,15,10,33,55,-22,30
Randers FC,6333,8,5,7,12,23,39,-16,22
Silkeborg IF,6333,9,6,3,13,28,46,-18,21
Lyngby,6333,10,3,10,11,26,44,-18,19
AGF Aarhus,6333,11,4,6,12,18,39,-21,18
Brondby,6334,1,23,5,2,78,30,48,74
FC Midtjylla,6334,2,18,6,6,60,37,23,60
FC Nords,6334,3,13,7,10,70,53,17,46
Copenhagen,6334,4,13,5,12,56,46,10,44
AC Horsens,6334,5,8,13,9,39,56,-17,37
AaB,6334,6,6,14,10,38,45,-7,32
Sonderjyske,6334,7,8,6,10,28,29,-1,30
Lyngby,6334,8,4,9,11,27,44,-17,21
Randers FC,6334,9,5,6,13,23,40,-17,21
AGF Aarhus,6334,10,5,6,11,18,37,-19,21
Silkeborg IF,6334,11,5,3,14,26,46,-20,18
Brondby,6335,1,21,5,4,69,33,36,68
FC Midtjylla,6335,2,21,5,4,67,34,33,68
Copenhagen,6335,3,14,6,10,59,42,17,48
FC Nords,6335,4,13,7,10,70,51,19,46
AaB,6335,5,8,12,10,35,41,-6,36
Sonderjyske,6335,6,8,6,10,28,29,-1,30
AC Horsens,6335,7,5,13,12,32,57,-25,28
Randers FC,6335,8,5,7,12,23,39,-16,22
Lyngby,6335,9,3,10,11,26,44,-18,19
Silkeborg IF,6335,10,5,4,13,27,46,-19,19
AGF Aarhus,6335,11,4,7,11,18,38,-20,19
Brondby,6336,1,21,7,2,73,32,41,70
FC Midtjylla,6336,2,20,4,6,70,37,33,64
FC Nords,6336,3,14,6,10,74,56,18,48
Copenhagen,6336,4,14,5,11,57,46,11,47
AaB,6336,5,8,12,10,42,45,-3,36
Sonderjyske,6336,6,8,6,10,28,29,-1,30
AC Horsens,6336,7,6,12,12,33,59,-26,30
Lyngby,6336,8,4,9,11,30,47,-17,21
Silkeborg IF,6336,9,6,3,13,27,44,-17,21
Randers FC,6336,10,5,6,13,26,43,-17,21
AGF Aarhus,6336,11,4,6,12,16,38,-22,18
Brondby,6337,1,20,7,3,70,32,38,67
FC Midtjylla,6337,2,19,5,6,66,43,23,62
FC Nords,6337,3,15,8,7,77,51,26,53
Copenhagen,6337,4,13,6,11,59,45,14,45
AC Horsens,6337,5,7,13,10,35,52,-17,34
AaB,6337,6,6,13,11,33,43,-10,31
Sonderjyske,6337,7,8,6,10,28,29,-1,30
Lyngby,6337,8,4,9,11,31,47,-16,21
Randers FC,6337,9,5,6,13,26,44,-18,21
Silkeborg IF,6337,10,5,4,13,26,45,-19,19
AGF Aarhus,6337,11,4,7,11,17,37,-20,19
Brondby,6338,1,20,7,3,67,30,37,67
FC Midtjylla,6338,2,19,5,6,65,43,22,62
Copenhagen,6338,3,16,5,9,59,39,20,53
FC Nords,6338,4,12,7,11,70,56,14,43
AC Horsens,6338,5,7,14,9,36,51,-15,35
AaB,6338,6,7,12,11,39,43,-4,33
Sonderjyske,6338,7,8,6,10,28,29,-1,30
Randers FC,6338,8,5,7,12,23,39,-16,22
Silkeborg IF,6338,9,6,3,13,27,44,-17,21
Lyngby,6338,10,3,10,11,26,44,-18,19
AGF Aarhus,6338,11,4,6,12,16,38,-22,18
Brondby,6339,1,21,7,2,70,30,40,70
FC Midtjylla,6339,2,21,5,4,66,36,30,68
Copenhagen,6339,3,14,6,10,60,44,16,48
FC Nords,6339,4,13,8,9,78,55,23,47
Sonderjyske,6339,5,8,6,10,28,29,-1,30
AaB,6339,6,6,12,12,36,48,-12,30
AC Horsens,6339,7,6,12,12,32,55,-23,30
Lyngby,6339,8,4,9,11,32,44,-12,21
Silkeborg IF,6339,9,6,3,13,27,45,-18,21
Randers FC,6339,10,5,6,13,23,45,-22,21
AGF Aarhus,6339,11,4,6,12,17,38,-21,18
Brondby,6340,1,20,8,2,70,32,38,68
FC Midtjylla,6340,2,19,4,7,65,44,21,61
FC Nords,6340,3,14,7,9,74,55,19,49
Copenhagen,6340,4,14,4,12,60,44,16,46
AaB,6340,5,8,13,9,39,43,-4,37
AC Horsens,6340,6,6,14,10,34,50,-16,32
Sonderjyske,6340,7,8,6,10,28,29,-1,30
Randers FC,6340,8,6,6,12,28,39,-11,24
Silkeborg IF,6340,9,5,4,13,26,45,-19,19
AGF Aarhus,6340,10,4,7,11,17,37,-20,19
Lyngby,6340,11,3,9,12,26,49,-23,18
Brondby,6341,1,22,6,2,71,29,42,72
FC Midtjylla,6341,2,20,4,6,64,40,24,64
Copenhagen,6341,3,14,5,11,57,43,14,47
FC Nords,6341,4,13,7,10,73,55,18,46
AC Horsens,6341,5,7,13,10,32,47,-15,34
AaB,6341,6,7,11,12,34,43,-9,32
Sonderjyske,6341,7,8,6,10,28,29,-1,30
Lyngby,6341,8,4,9,11,30,44,-14,21
AGF Aarhus,6341,9,5,6,11,19,36,-17,21
Randers FC,6341,10,5,6,13,23,43,-20,21
Silkeborg IF,6341,11,5,3,14,25,47,-22,18
Brondby,6342,1,21,5,4,71,31,40,68
FC Midtjylla,6342,2,19,5,6,62,44,18,62
FC Nords,6342,3,15,6,9,78,54,24,51
Copenhagen,6342,4,13,7,10,57,45,12,46
AaB,6342,5,8,12,10,42,44,-2,36
AC Horsens,6342,6,6,13,11,35,53,-18,31
Sonderjyske,6342,7,8,6,10,28,29,-1,30
Lyngby,6342,8,4,9,11,28,45,-17,21
Randers FC,6342,9,5,6,13,24,41,-17,21
Silkeborg IF,6342,10,5,4,13,27,46,-19,19
AGF Aarhus,6342,11,4,7,11,18,38,-20,19
Brondby,6343,1,21,6,3,73,34,39,69
FC Midtjylla,6343,2,19,4,7,66,43,23,61
FC Nords,6343,3,15,6,9,76,54,22,51
Copenhagen,6343,4,14,6,10,60,46,14,48
AaB,6343,5,7,13,10,35,40,-5,34
Sonderjyske,6343,6,8,6,10,28,29,-1,30
AC Horsens,6343,7,5,15,10,32,51,-19,30
Silkeborg IF,6343,8,6,3,13,31,45,-14,21
Lyngby,6343,9,4,9,11,27,44,-17,21
Randers FC,6343,10,5,6,13,23,40,-17,21
AGF Aarhus,6343,11,4,6,12,17,42,-25,18
FC Midtjylla,6344,1,20,5,5,65,38,27,65
Brondby,6344,2,19,6,5,72,37,35,63
FC Nords,6344,3,14,6,10,75,53,22,48
Copenhagen,6344,4,14,4,12,58,47,11,46
AaB,6344,5,9,11,10,42,46,-4,38
AC Horsens,6344,6,7,14,9,36,53,-17,35
Sonderjyske,6344,7,8,6,10,28,29,-1,30
Randers FC,6344,8,5,7,12,24,40,-16,22
Lyngby,6344,9,3,10,11,27,45,-18,19
Silkeborg IF,6344,10,5,4,13,25,44,-19,19
AGF Aarhus,6344,11,4,7,11,16,36,-20,19
Brondby,6345,1,19,7,4,68,33,35,64
FC Midtjylla,6345,2,19,6,5,67,43,24,63
FC Nords,6345,3,14,8,8,71,49,22,50
Copenhagen,6345,4,15,4,11,60,46,14,49
AaB,6345,5,7,14,9,36,40,-4,35
Sonderjyske,6345,6,8,6,10,28,29,-1,30
AC Horsens,6345,7,5,15,10,36,53,-17,30
Randers FC,6345,8,5,7,12,23,39,-16,22
Silkeborg IF,6345,9,6,3,13,26,44,-18,21
Lyngby,6345,10,3,10,11,26,44,-18,19
AGF Aarhus,6345,11,4,6,12,16,37,-21,18
FC Midtjylla,6346,1,20,5,5,70,40,30,65
Brondby,6346,2,19,6,5,67,33,34,63
FC Nords,6346,3,15,7,8,76,51,25,52
Copenhagen,6346,4,15,5,10,64,45,19,50
AC Horsens,6346,5,7,13,10,36,56,-20,34
Sonderjyske,6346,6,8,6,10,28,29,-1,30
AaB,6346,7,6,12,12,38,52,-14,30
Lyngby,6346,8,4,9,11,28,44,-16,21
Randers FC,6346,9,5,6,13,23,41,-18,21
Silkeborg IF,6346,10,5,4,13,26,45,-19,19
AGF Aarhus,6346,11,4,7,11,17,37,-20,19
FC Midtjylla,6347,1,20,5,5,68,40,28,65
Brondby,6347,2,19,7,4,66,33,33,64
Copenhagen,6347,3,15,5,10,63,47,16,50
FC Nords,6347,4,14,7,9,76,52,24,49
AaB,6347,5,7,12,11,38,45,-7,33
AC Horsens,6347,6,6,14,10,33,53,-20,32
Sonderjyske,6347,7,8,6,10,28,29,-1,30
Randers FC,6347,8,6,6,12,25,39,-14,24
Silkeborg IF,6347,9,6,3,13,30,45,-15,21
Lyngby,6347,10,3,9,12,26,46,-20,18
AGF Aarhus,6347,11,4,6,12,17,41,-24,18
Brondby,6348,1,22,6,2,74,32,42,72
FC Midtjylla,6348,2,20,6,4,71,38,33,66
FC Nords,6348,3,14,6,10,75,55,20,48
Copenhagen,6348,4,14,5,11,57,42,15,47
AC Horsens,6348,5,7,12,11,36,59,-23,33
Sonderjyske,6348,6,8,6,10,28,29,-1,30
AaB,6348,7,6,11,13,34,47,-13,29
Lyngby,6348,8,4,9,11,28,45,-17,21
Randers FC,6348,9,5,6,13,24,41,-17,21
Silkeborg IF,6348,10,5,4,13,26,45,-19,19
AGF Aarhus,6348,11,4,7,11,17,37,-20,19
Brondby,6349,1,21,5,4,75,34,41,68
FC Midtjylla,6349,2,19,5,6,64,39,25,62
FC Nords,6349,3,14,6,10,73,54,19,48
Copenhagen,6349,4,13,6,11,58,46,12,45
AaB,6349,5,8,12,10,38,45,-7,36
AC Horsens,6349,6,8,12,10,33,49,-16,36
Sonderjyske,6349,7,8,6,10,28,29,-1,30
Randers FC,6349,8,6,6,12,26,39,-13,24
AGF Aarhus,6349,9,5,6,11,19,36,-17,21
Lyngby,6349,10,3,9,12,26,47,-21,18
Silkeborg IF,6349,11,5,3,14,25,47,-22,18
Brondby,6350,1,20,7,3,66,28,38,67
FC Midtjylla,6350,2,19,4,7,61,37,24,61
Copenhagen,6350,3,14,5,11,55,44,11,47
FC Nords,6350,4,12,8,10,70,54,16,44
AaB,6350,5,8,13,9,35,38,-3,37
AC Horsens,6350,6,7,15,8,36,48,-12,36
Sonderjyske,6350,7,8,6,10,28,29,-1,30
Lyngby,6350,8,4,9,11,30,44,-14,21
Randers FC,6350,9,5,6,13,23,43,-20,21
Silkeborg IF,6350,10,5,4,13,27,46,-19,19
AGF Aarhus,6350,11,4,7,11,18,38,-20,19
Brondby,6351,1,21,6,3,73,32,41,69
FC Midtjylla,6351,2,19,4,7,62,42,20,61
FC Nords,6351,3,16,6,8,84,50,34,54
Copenhagen,6351,4,14,6,10,60,48,12,48
AaB,6351,5,6,13,11,36,45,-9,31
AC Horsens,6351,6,6,13,11,33,57,-24,31
Sonderjyske,6351,7,8,6,10,28,29,-1,30
Randers FC,6351,8,5,7,12,24,40,-16,22
Silkeborg IF,6351,9,6,3,13,26,44,-18,21
Lyngby,6351,10,3,10,11,27,45,-18,19
AGF Aarhus,6351,11,4,6,12,16,37,-21,18
Brondby,6352,1,21,5,4,71,35,36,68
FC Midtjylla,6352,2,20,4,6,67,40,27,64
FC Nords,6352,3,16,7,7,78,48,30,55
Copenhagen,6352,4,13,6,11,55,44,11,45
AaB,6352,5,6,13,11,35,47,-12,31
AC Horsens,6352,6,6,13,11,34,52,-18,31
Sonderjyske,6352,7,8,6,10,28,29,-1,30
Randers FC,6352,8,6,6,12,26,39,-13,24
Silkeborg IF,6352,9,6,3,13,26,44,-18,21
Lyngby,6352,10,3,9,12,26,47,-21,18
AGF Aarhus,6352,11,4,6,12,16,37,-21,18
Brondby,6353,1,19,8,3,67,32,35,65
FC Midtjylla,6353,2,20,5,5,68,40,28,65
FC Nords,6353,3,15,6,9,72,48,24,51
Copenhagen,6353,4,14,5,11,60,45,15,47
AaB,6353,5,8,12,10,35,42,-7,36
Sonderjyske,6353,6,8,6,10,28,29,-1,30
AC Horsens,6353,7,5,14,11,33,54,-21,29
Randers FC,6353,8,6,6,12,24,39,-15,24
Silkeborg IF,6353,9,5,4,13,25,44,-19,19
AGF Aarhus,6353,10,4,7,11,16,36,-20,19
Lyngby,6353,11,3,9,12,26,45,-19,18
Brondby,6354,1,19,5,6,67,37,30,62
FC Midtjylla,6354,2,19,5,6,63,34,29,62
FC Nords,6354,3,16,6,8,75,48,27,54
Copenhagen,6354,4,15,4,11,56,44,12,49
AaB,6354,5,8,13,9,37,42,-5,37
AC Horsens,6354,6,6,13,11,33,52,-19,31
Sonderjyske,6354,7,8,6,10,28,29,-1,30
Silkeborg IF,6354,8,6,3,13,30,44,-14,21
Lyngby,6354,9,4,9,11,29,45,-16,21
Randers FC,6354,10,5,6,13,24,42,-18,21
AGF Aarhus,6354,11,4,6,12,16,41,-25,18
Brondby,6355,1,20,7,3,70,34,36,67
FC Midtjylla,6355,2,20,5,5,67,37,30,65
Copenhagen,6355,3,14,6,10,56,42,14,48
FC Nords,6355,4,13,7,10,72,55,17,46
AC Horsens,6355,5,7,13,10,36,51,-15,34
AaB,6355,6,7,12,11,36,44,-8,33
Sonderjyske,6355,7,8,6,10,28,29,-1,30
Randers FC,6355,8,5,7,12,24,40,-16,22
Lyngby,6355,9,3,10,11,27,45,-18,19
Silkeborg IF,6355,10,5,4,13,26,45,-19,19
AGF Aarhus,6355,11,4,7,11,17,37,-20,19
Brondby,6356,1,21,6,3,74,32,42,69
FC Midtjylla,6356,2,19,5,6,67,44,23,62
FC Nords,6356,3,13,9,8,69,48,21,48
Copenhagen,6356,4,14,6,10,61,47,14,48
AaB,6356,5,8,12,10,37,45,-8,36
Sonderjyske,6356,6,8,6,10,28,29,-1,30
AC Horsens,6356,7,5,14,11,34,52,-18,29
Randers FC,6356,8,5,7,12,23,39,-16,22
AGF Aarhus,6356,9,5,6,11,19,37,-18,21
Lyngby,6356,10,3,10,11,26,44,-18,19
Silkeborg IF,6356,11,5,3,14,26,47,-21,18
Brondby,6357,1,22,5,3,72,32,40,71
FC Midtjylla,6357,2,20,4,6,63,37,26,64
FC Nords,6357,3,15,7,8,73,45,28,52
Copenhagen,6357,4,14,5,11,56,43,13,47
AaB,6357,5,7,12,11,34,44,-10,33
Sonderjyske,6357,6,8,6,10,28,29,-1,30
AC Horsens,6357,7,5,13,12,32,55,-23,28
Lyngby,6357,8,4,9,11,27,44,-17,21
Randers FC,6357,9,5,6,13,23,40,-17,21
AGF Aarhus,6357,10,5,6,11,20,37,-17,21
Silkeborg IF,6357,11,5,3,14,26,48,-22,18
Brondby,6358,1,20,7,3,67,29,38,67
FC Midtjylla,6358,2,19,5,6,66,43,23,62
Copenhagen,6358,3,17,4,9,62,41,21,55
FC Nords,6358,4,12,9,9,72,53,19,45
AaB,6358,5,7,11,12,34,43,-9,32
AC Horsens,6358,6,6,14,10,34,52,-18,32
Sonderjyske,6358,7,8,6,10,28,29,-1,30
Randers FC,6358,8,5,7,12,25,41,-16,22
Silkeborg IF,6358,9,6,3,13,28,44,-16,21
Lyngby,6358,10,3,10,11,28,46,-18,19
AGF Aarhus,6358,11,4,6,12,16,39,-23,18
Brondby,6359,1,21,7,2,70,31,39,70
FC Midtjylla,6359,2,18,5,7,65,43,22,59
FC Nords,6359,3,14,8,8,73,48,25,50
Copenhagen,6359,4,13,7,10,54,43,11,46
AC Horsens,6359,5,6,15,9,39,54,-15,33
AaB,6359,6,6,14,10,36,44,-8,32
Sonderjyske,6359,7,8,6,10,28,29,-1,30
Randers FC,6359,8,5,7,12,25,41,-16,22
AGF Aarhus,6359,9,5,6,11,17,36,-19,21
Lyngby,6359,10,3,10,11,28,46,-18,19
Silkeborg IF,6359,11,5,3,14,25,45,-20,18
Brondby,6360,1,21,5,4,75,32,43,68
FC Midtjylla,6360,2,19,4,7,67,49,18,61
FC Nords,6360,3,15,6,9,73,51,22,51
Copenhagen,6360,4,13,4,13,60,52,8,43
AaB,6360,5,9,11,10,39,42,-3,38
AC Horsens,6360,6,8,12,10,35,49,-14,36
Sonderjyske,6360,7,8,6,10,28,29,-1,30
Lyngby,6360,8,4,9,11,30,44,-14,21
AGF Aarhus,6360,9,5,6,11,17,36,-19,21
Randers FC,6360,10,5,6,13,23,43,-20,21
Silkeborg IF,6360,11,5,3,14,25,45,-20,18
FC Midtjylla,6361,1,21,5,4,70,37,33,68
Brondby,6361,2,20,6,4,65,30,35,66
Copenhagen,6361,3,14,6,10,61,45,16,48
FC Nords,6361,4,13,8,9,71,51,20,47
AaB,6361,5,8,11,11,36,44,-8,35
Sonderjyske,6361,6,8,6,10,28,29,-1,30
AC Horsens,6361,7,6,12,12,34,56,-22,30
Randers FC,6361,8,6,6,12,27,40,-13,24
Silkeborg IF,6361,9,6,3,13,26,44,-18,21
Lyngby,6361,10,3,9,12,27,48,-21,18
AGF Aarhus,6361,11,4,6,12,16,37,-21,18
Brondby,6362,1,19,8,3,68,32,36,65
FC Midtjylla,6362,2,18,7,5,64,39,25,61
FC Nords,6362,3,15,8,7,76,46,30,53
Copenhagen,6362,4,14,6,10,61,47,14,48
AaB,6362,5,7,13,10,36,44,-8,34
Sonderjyske,6362,6,8,6,10,28,29,-1,30
AC Horsens,6362,7,6,12,12,34,57,-23,30
Randers FC,6362,8,6,6,12,24,39,-15,24
Silkeborg IF,6362,9,6,3,13,28,45,-17,21
Lyngby,6362,10,3,9,12,26,45,-19,18
AGF Aarhus,6362,11,4,6,12,17,39,-22,18
Brondby,6363,1,20,8,2,69,31,38,68
FC Midtjylla,6363,2,20,4,6,64,38,26,64
FC Nords,6363,3,13,8,9,71,53,18,47
Copenhagen,6363,4,13,6,11,56,45,11,45
AaB,6363,5,8,13,9,39,40,-1,37
AC Horsens,6363,6,6,13,11,34,52,-18,31
Sonderjyske,6363,7,8,6,10,28,29,-1,30
Randers FC,6363,8,5,7,12,25,41,-16,22
Silkeborg IF,6363,9,6,3,13,27,44,-17,21
Lyngby,6363,10,3,10,11,28,46,-18,19
AGF Aarhus,6363,11,4,6,12,16,38,-22,18
Brondby,6364,1,21,6,3,74,32,42,69
FC Midtjylla,6364,2,19,4,7,63,40,23,61
FC Nords,6364,3,14,6,10,71,54,17,48
Copenhagen,6364,4,13,4,13,55,50,5,43
AaB,6364,5,9,11,10,38,39,-1,38
AC Horsens,6364,6,8,13,9,34,46,-12,37
Sonderjyske,6364,7,8,6,10,28,29,-1,30
Randers FC,6364,8,5,7,12,24,40,-16,22
Lyngby,6364,9,3,10,11,27,45,-18,19
Silkeborg IF,6364,10,5,4,13,26,45,-19,19
AGF Aarhus,6364,11,4,7,11,17,37,-20,19
Brondby,6365,1,20,6,4,71,35,36,66
FC Midtjylla,6365,2,19,6,5,72,40,32,63
FC Nords,6365,3,15,7,8,77,56,21,52
Copenhagen,6365,4,15,4,11,58,44,14,49
AaB,6365,5,6,14,10,35,43,-8,32
AC Horsens,6365,6,6,13,11,35,56,-21,31
Sonderjyske,6365,7,8,6,10,28,29,-1,30
Randers FC,6365,8,5,7,12,23,39,-16,22
Silkeborg IF,6365,9,6,3,13,26,44,-18,21
Lyngby,6365,10,3,10,11,26,44,-18,19
AGF Aarhus,6365,11,4,6,12,16,37,-21,18
Brondby,6366,1,21,6,3,70,29,41,69
FC Midtjylla,6366,2,19,5,6,64,40,24,62
Copenhagen,6366,3,15,5,10,59,43,16,50
FC Nords,6366,4,13,8,9,75,55,20,47
AaB,6366,5,7,13,10,35,40,-5,34
AC Horsens,6366,6,6,13,11,34,56,-22,31
Sonderjyske,6366,7,8,6,10,28,29,-1,30
Lyngby,6366,8,4,9,11,30,44,-14,21
AGF Aarhus,6366,9,5,6,11,18,36,-18,21
Randers FC,6366,10,5,6,13,23,43,-20,21
Silkeborg IF,6366,11,5,3,14,25,46,-21,18
Brondby,6367,1,21,5,4,70,30,40,68
FC Midtjylla,6367,2,20,4,6,64,40,24,64
FC Nords,6367,3,14,6,10,72,51,21,48
Copenhagen,6367,4,14,5,11,58,44,14,47
AaB,6367,5,8,12,10,37,43,-6,36
AC Horsens,6367,6,7,12,11,33,52,-19,33
Sonderjyske,6367,7,8,6,10,28,29,-1,30
Randers FC,6367,8,5,7,12,24,40,-16,22
Silkeborg IF,6367,9,6,3,13,28,46,-18,21
Lyngby,6367,10,3,10,11,27,45,-18,19
AGF Aarhus,6367,11,4,6,12,18,39,-21,18
Brondby,6368,1,21,5,4,73,33,40,68
FC Midtjylla,6368,2,19,6,5,66,41,25,63
FC Nords,6368,3,14,6,10,70,50,20,48
Copenhagen,6368,4,14,5,11,59,47,12,47
AaB,6368,5,9,12,9,44,46,-2,39
Sonderjyske,6368,6,8,6,10,28,29,-1,30
AC Horsens,6368,7,6,12,12,33,54,-21,30
Randers FC,6368,8,6,6,12,26,39,-13,24
Silkeborg IF,6368,9,6,3,13,28,45,-17,21
Lyngby,6368,10,3,9,12,26,47,-21,18
AGF Aarhus,6368,11,4,6,12,17,39,-22,18
Brondby,6369,1,21,6,3,76,34,42,69
FC Midtjylla,6369,2,19,7,4,65,37,28,64
FC Nords,6369,3,14,6,10,72,56,16,48
Copenhagen,6369,4,14,6,10,59,45,14,48
AaB,6369,5,8,11,11,37,45,-8,35
Sonderjyske,6369,6,8,6,10,28,29,-1,30
AC Horsens,6369,7,5,14,11,39,57,-18,29
Lyngby,6369,8,4,9,11,29,45,-16,21
Randers FC,6369,9,5,6,13,24,42,-18,21
AGF Aarhus,6369,10,5,6,11,18,36,-18,21
Silkeborg IF,6369,11,5,3,14,25,46,-21,18
Brondby,6370,1,21,6,3,72,34,38,69
FC Midtjylla,6370,2,21,4,5,70,38,32,67
FC Nords,6370,3,14,7,9,72,54,18,49
Copenhagen,6370,4,12,5,13,53,46,7,41
AC Horsens,6370,5,8,13,9,42,53,-11,37
AaB,6370,6,6,13,11,33,43,-10,31
Sonderjyske,6370,7,8,6,10,28,29,-1,30
Randers FC,6370,8,5,7,12,24,40,-16,22
Silkeborg IF,6370,9,6,3,13,27,45,-18,21
Lyngby,6370,10,3,10,11,27,45,-18,19
AGF Aarhus,6370,11,4,6,12,17,38,-21,18
Brondby,6371,1,22,5,3,73,30,43,71
FC Midtjylla,6371,2,18,4,8,61,42,19,58
FC Nords,6371,3,16,7,7,76,50,26,55
Copenhagen,6371,4,13,5,12,54,43,11,44
AaB,6371,5,7,14,9,34,40,-6,35
AC Horsens,6371,6,6,13,11,34,53,-19,31
Sonderjyske,6371,7,8,6,10,28,29,-1,30
Randers FC,6371,8,5,7,12,24,40,-16,22
Lyngby,6371,9,3,10,11,27,45,-18,19
Silkeborg IF,6371,10,5,4,13,26,45,-19,19
AGF Aarhus,6371,11,4,7,11,17,37,-20,19
Brondby,6372,1,21,6,3,71,31,40,69
FC Midtjylla,6372,2,18,5,7,61,40,21,59
Copenhagen,6372,3,14,6,10,57,43,14,48
FC Nords,6372,4,13,8,9,72,51,21,47
AaB,6372,5,8,11,11,37,44,-7,35
AC Horsens,6372,6,7,14,9,34,49,-15,35
Sonderjyske,6372,7,8,6,10,28,29,-1,30
Randers FC,6372,8,6,6,12,25,39,-14,24
Silkeborg IF,6372,9,6,3,13,26,44,-18,21
Lyngby,6372,10,3,9,12,26,46,-20,18
AGF Aarhus,6372,11,4,6,12,16,37,-21,18
Brondby,6373,1,19,7,4,68,35,33,64
FC Midtjylla,6373,2,20,4,6,67,42,25,64
FC Nords,6373,3,15,6,9,75,49,26,51
Copenhagen,6373,4,13,5,12,57,48,9,44
AaB,6373,5,9,11,10,40,43,-3,38
AC Horsens,6373,6,7,13,10,36,52,-16,34
Sonderjyske,6373,7,8,6,10,28,29,-1,30
Randers FC,6373,8,6,6,12,27,42,-15,24
Silkeborg IF,6373,9,6,3,13,30,46,-16,21
Lyngby,6373,10,3,9,12,29,48,-19,18
AGF Aarhus,6373,11,4,6,12,18,41,-23,18
FC Midtjylla,6374,1,21,5,4,71,39,32,68
Brondby,6374,2,20,6,4,71,36,35,66
FC Nords,6374,3,15,6,9,75,50,25,51
Copenhagen,6374,4,15,6,9,57,40,17,51
Sonderjyske,6374,5,8,6,10,28,29,-1,30
AaB,6374,6,6,12,12,35,47,-12,30
AC Horsens,6374,7,5,13,12,31,54,-23,28
Randers FC,6374,8,6,6,12,27,40,-13,24
AGF Aarhus,6374,9,5,6,11,17,36,-19,21
Silkeborg IF,6374,10,5,3,14,25,45,-20,18
Lyngby,6374,11,3,9,12,27,48,-21,18
Brondby,6375,1,20,6,4,69,32,37,66
FC Midtjylla,6375,2,17,4,9,65,47,18,55
Copenhagen,6375,3,16,5,9,61,44,17,53
FC Nords,6375,4,14,8,8,73,48,25,50
AaB,6375,5,8,13,9,41,44,-3,37
AC Horsens,6375,6,7,12,11,36,56,-20,33
Sonderjyske,6375,7,8,6,10,28,29,-1,30
Randers FC,6375,8,6,6,12,25,40,-15,24
AGF Aarhus,6375,9,5,6,11,17,36,-19,21
Lyngby,6375,10,3,9,12,27,46,-19,18
Silkeborg IF,6375,11,5,3,14,25,45,-20,18
FC Midtjylla,6376,1,19,6,5,65,40,25,63
Brondby,6376,2,19,5,6,68,38,30,62
FC Nords,6376,3,15,7,8,80,52,28,52
Copenhagen,6376,4,13,7,10,58,45,13,46
AaB,6376,5,8,12,10,37,42,-5,36
AC Horsens,6376,6,7,13,10,34,51,-17,34
Sonderjyske,6376,7,8,6,10,28,29,-1,30
Randers FC,6376,8,5,7,12,24,40,-16,22
Silkeborg IF,6376,9,6,3,13,26,44,-18,21
Lyngby,6376,10,3,10,11,27,45,-18,19
AGF Aarhus,6376,11,4,6,12,16,37,-21,18
FC Midtjylla,6377,1,21,4,5,70,41,29,67
Brondby,6377,2,19,6,5,72,41,31,63
FC Nords,6377,3,13,7,10,72,55,17,46
Copenhagen,6377,4,13,5,12,59,49,10,44
AC Horsens,6377,5,10,12,8,47,51,-4,42
AaB,6377,6,7,12,11,39,48,-9,33
Sonderjyske,6377,7,8,6,10,28,29,-1,30
Randers FC,6377,8,6,6,12,26,40,-14,24
Silkeborg IF,6377,9,5,4,13,26,45,-19,19
AGF Aarhus,6377,10,4,7,11,17,37,-20,19
Lyngby,6377,11,3,9,12,27,47,-20,18
Brondby,6378,1,23,5,2,72,29,43,74
FC Midtjylla,6378,2,18,6,6,58,36,22,60
FC Nords,6378,3,13,8,9,69,50,19,47
Copenhagen,6378,4,14,5,11,60,45,15,47
AC Horsens,6378,5,7,12,11,36,52,-16,33
AaB,6378,6,6,14,10,34,43,-9,32
Sonderjyske,6378,7,8,6,10,28,29,-1,30
Randers FC,6378,8,5,7,12,25,41,-16,22
Lyngby,6378,9,3,10,11,28,46,-18,19
Silkeborg IF,6378,10,5,4,13,26,45,-19,19
AGF Aarhus,6378,11,4,7,11,17,37,-20,19
Brondby,6379,1,21,7,2,72,29,43,70
FC Midtjylla,6379,2,19,4,7,62,43,19,61
FC Nords,6379,3,15,7,8,81,51,30,52
Copenhagen,6379,4,13,4,13,54,52,2,43
AC Horsens,6379,5,8,12,10,36,49,-13,36
AaB,6379,6,7,12,11,36,43,-7,33
Sonderjyske,6379,7,8,6,10,28,29,-1,30
Lyngby,6379,8,4,9,11,30,44,-14,21
Randers FC,6379,9,5,6,13,23,43,-20,21
Silkeborg IF,6379,10,5,4,13,25,44,-19,19
AGF Aarhus,6379,11,4,7,11,16,36,-20,19
Brondby,6380,1,20,6,4,68,32,36,66
FC Midtjylla,6380,2,19,6,5,62,37,25,63
FC Nords,6380,3,14,7,9,75,52,23,49
Copenhagen,6380,4,15,4,11,60,48,12,49
AC Horsens,6380,5,7,14,9,36,50,-14,35
AaB,6380,6,6,13,11,35,43,-8,31
Sonderjyske,6380,7,8,6,10,28,29,-1,30
Silkeborg IF,6380,8,6,3,13,29,45,-16,21
Lyngby,6380,9,4,9,11,28,45,-17,21
Randers FC,6380,10,5,6,13,24,41,-17,21
AGF Aarhus,6380,11,4,6,12,17,40,-23,18
FC Midtjylla,6381,1,22,4,4,75,37,38,70
Brondby,6381,2,20,6,4,69,34,35,66
FC Nords,6381,3,15,6,9,73,49,24,51
Copenhagen,6381,4,13,5,12,58,50,8,44
AC Horsens,6381,5,7,14,9,35,52,-17,35
Sonderjyske,6381,6,8,6,10,28,29,-1,30
AaB,6381,7,6,11,13,33,47,-14,29
Lyngby,6381,8,4,9,11,29,46,-17,21
Randers FC,6381,9,5,6,13,25,42,-17,21
AGF Aarhus,6381,10,5,6,11,18,37,-19,21
Silkeborg IF,6381,11,5,3,14,26,46,-20,18
Brondby,6382,1,20,7,3,70,34,36,67
FC Midtjylla,6382,2,20,4,6,65,39,26,64
FC Nords,6382,3,14,9,7,76,50,26,51
Copenhagen,6382,4,13,6,11,57,45,12,45
AC Horsens,6382,5,6,15,9,38,54,-16,33
AaB,6382,6,6,13,11,33,43,-10,31
Sonderjyske,6382,7,8,6,10,28,29,-1,30
Randers FC,6382,8,5,7,12,23,39,-16,22
Silkeborg IF,6382,9,6,3,13,28,46,-18,21
Lyngby,6382,10,3,10,11,26,44,-18,19
AGF Aarhus,6382,11,4,6,12,18,39,-21,18
Brondby,6383,1,22,6,2,72,29,43,72
FC Midtjylla,6383,2,19,6,5,66,38,28,63
Copenhagen,6383,3,14,6,10,60,46,14,48
FC Nords,6383,4,13,6,11,73,53,20,45
AaB,6383,5,7,12,11,37,47,-10,33
AC Horsens,6383,6,7,12,11,40,61,-21,33
Sonderjyske,6383,7,8,6,10,28,29,-1,30
Lyngby,6383,8,4,9,11,27,44,-17,21
Randers FC,6383,9,5,6,13,23,40,-17,21
AGF Aarhus,6383,10,5,6,11,19,36,-17,21
Silkeborg IF,6383,11,5,3,14,25,47,-22,18
Brondby,6384,1,20,7,3,70,32,38,67
FC Midtjylla,6384,2,18,6,6,66,43,23,60
FC Nords,6384,3,14,7,9,74,52,22,49
Copenhagen,6384,4,14,5,11,60,46,14,47
AC Horsens,6384,5,7,14,9,38,52,-14,35
AaB,6384,6,7,13,10,38,47,-9,34
Sonderjyske,6384,7,8,6,10,28,29,-1,30
Lyngby,6384,8,4,9,11,29,44,-15,21
Randers FC,6384,9,5,6,13,23,42,-19,21
Silkeborg IF,6384,10,5,4,13,26,45,-19,19
AGF Aarhus,6384,11,4,7,11,17,37,-20,19
Brondby,6385,1,22,5,3,69,29,40,71
FC Midtjylla,6385,2,19,6,5,65,40,25,63
FC Nords,6385,3,13,8,9,71,50,21,47
Copenhagen,6385,4,14,5,11,59,45,14,47
AaB,6385,5,7,13,10,38,44,-6,34
AC Horsens,6385,6,6,13,11,30,50,-20,31
Sonderjyske,6385,7,8,6,10,28,29,-1,30
Lyngby,6385,8,4,9,11,29,45,-16,21
Randers FC,6385,9,5,6,13,24,42,-18,21
Silkeborg IF,6385,10,5,4,13,25,44,-19,19
AGF Aarhus,6385,11,4,7,11,16,36,-20,19
Brondby,6386,1,22,5,3,74,33,41,71
FC Midtjylla,6386,2,19,6,5,63,38,25,63
FC Nords,6386,3,14,7,9,75,52,23,49
Copenhagen,6386,4,13,6,11,56,46,10,45
AC Horsens,6386,5,7,14,9,36,52,-16,35
Sonderjyske,6386,6,8,6,10,28,29,-1,30
AaB,6386,7,6,12,12,34,43,-9,30
Randers FC,6386,8,5,7,12,25,41,-16,22
Lyngby,6386,9,3,10,11,28,46,-18,19
Silkeborg IF,6386,10,5,4,13,26,45,-19,19
AGF Aarhus,6386,11,4,7,11,17,37,-20,19
Brondby,6387,1,22,5,3,71,29,42,71
FC Midtjylla,6387,2,20,5,5,73,37,36,65
Copenhagen,6387,3,14,6,10,57,44,13,48
FC Nords,6387,4,13,7,10,71,57,14,46
AaB,6387,5,7,13,10,35,40,-5,34
Sonderjyske,6387,6,8,6,10,28,29,-1,30
AC Horsens,6387,7,6,12,12,32,58,-26,30
Lyngby,6387,8,4,9,11,30,45,-15,21
Randers FC,6387,9,5,6,13,24,43,-19,21
Silkeborg IF,6387,10,5,4,13,27,46,-19,19
AGF Aarhus,6387,11,4,7,11,18,38,-20,19
Brondby,6388,1,21,7,2,74,33,41,70
FC Midtjylla,6388,2,19,5,6,63,39,24,62
FC Nords,6388,3,14,8,8,75,54,21,50
Copenhagen,6388,4,14,5,11,57,46,11,47
AaB,6388,5,7,13,10,36,41,-5,34
Sonderjyske,6388,6,8,6,10,28,29,-1,30
AC Horsens,6388,7,5,14,11,31,49,-18,29
Randers FC,6388,8,6,6,12,24,39,-15,24
Silkeborg IF,6388,9,6,3,13,27,45,-18,21
Lyngby,6388,10,3,9,12,26,45,-19,18
AGF Aarhus,6388,11,4,6,12,17,38,-21,18
Brondby,6389,1,19,7,4,72,37,35,64
FC Midtjylla,6389,2,18,7,5,67,42,25,61
FC Nords,6389,3,14,8,8,77,51,26,50
Copenhagen,6389,4,13,6,11,53,46,7,45
AC Horsens,6389,5,9,12,9,40,49,-9,39
AaB,6389,6,6,14,10,36,46,-10,32
Sonderjyske,6389,7,8,6,10,28,29,-1,30
Randers FC,6389,8,5,7,12,24,40,-16,22
Lyngby,6389,9,3,10,11,27,45,-18,19
Silkeborg IF,6389,10,5,4,13,26,45,-19,19
AGF Aarhus,6389,11,4,7,11,17,37,-20,19
Brondby,6390,1,22,6,2,73,30,43,72
FC Midtjylla,6390,2,19,5,6,61,37,24,62
FC Nords,6390,3,14,6,10,74,54,20,48
Copenhagen,6390,4,14,6,10,59,45,14,48
AC Horsens,6390,5,8,12,10,36,52,-16,36
Sonderjyske,6390,6,8,6,10,28,29,-1,30
AaB,6390,7,6,11,13,36,47,-11,29
Lyngby,6390,8,4,9,11,28,45,-17,21
Randers FC,6390,9,5,6,13,24,41,-17,21
Silkeborg IF,6390,10,5,4,13,25,44,-19,19
AGF Aarhus,6390,11,4,7,11,16,36,-20,19
Brondby,6391,1,22,6,2,71,31,40,72
FC Midtjylla,6391,2,19,4,7,65,45,20,61
FC Nords,6391,3,15,8,7,77,51,26,53
Copenhagen,6391,4,13,7,10,60,44,16,46
AaB,6391,5,7,12,11,37,44,-7,33
Sonderjyske,6391,6,8,6,10,28,29,-1,30
AC Horsens,6391,7,5,13,12,33,54,-21,28
Lyngby,6391,8,4,9,11,29,45,-16,21
Silkeborg IF,6391,9,6,3,13,28,44,-16,21
Randers FC,6391,10,5,6,13,24,42,-18,21
AGF Aarhus,6391,11,4,6,12,16,39,-23,18
Brondby,6392,1,22,5,3,73,31,42,71
FC Midtjylla,6392,2,19,5,6,66,41,25,62
FC Nords,6392,3,15,6,9,76,54,22,51
Copenhagen,6392,4,13,4,13,52,43,9,43
AC Horsens,6392,5,8,12,10,38,54,-16,36
AaB,6392,6,7,12,11,38,46,-8,33
Sonderjyske,6392,7,8,6,10,28,29,-1,30
Silkeborg IF,6392,8,6,3,13,30,44,-14,21
Lyngby,6392,9,4,9,11,28,44,-16,21
Randers FC,6392,10,5,6,13,23,41,-18,21
AGF Aarhus,6392,11,4,6,12,16,41,-25,18
Brondby,6393,1,19,7,4,66,36,30,64
FC Midtjylla,6393,2,18,5,7,58,37,21,59
FC Nords,6393,3,13,9,8,67,45,22,48
Copenhagen,6393,4,13,7,10,57,41,16,46
AaB,6393,5,9,12,9,35,37,-2,39
AC Horsens,6393,6,7,14,9,32,45,-13,35
Sonderjyske,6393,7,8,6,10,28,29,-1,30
Lyngby,6393,8,4,9,11,28,45,-17,21
Randers FC,6393,9,5,6,13,24,41,-17,21
AGF Aarhus,6393,10,5,6,11,18,37,-19,21
Silkeborg IF,6393,11,5,3,14,26,46,-20,18
Brondby,6394,1,21,6,3,67,30,37,69
FC Midtjylla,6394,2,21,4,5,72,39,33,67
Copenhagen,6394,3,15,4,11,62,46,16,49
FC Nords,6394,4,13,8,9,72,54,18,47
AaB,6394,5,7,12,11,37,46,-9,33
Sonderjyske,6394,6,8,6,10,28,29,-1,30
AC Horsens,6394,7,5,14,11,32,53,-21,29
Lyngby,6394,8,4,9,11,27,44,-17,21
Randers FC,6394,9,5,6,13,23,40,-17,21
AGF Aarhus,6394,10,5,6,11,18,37,-19,21
Silkeborg IF,6394,11,5,3,14,26,46,-20,18
FC Midtjylla,6395,1,20,6,4,62,35,27,66
Brondby,6395,2,19,6,5,64,32,32,63
FC Nords,6395,3,15,6,9,74,50,24,51
Copenhagen,6395,4,13,5,12,56,46,10,44
AaB,6395,5,9,12,9,38,40,-2,39
AC Horsens,6395,6,6,13,11,34,51,-17,31
Sonderjyske,6395,7,8,6,10,28,29,-1,30
Randers FC,6395,8,6,6,12,26,39,-13,24
Silkeborg IF,6395,9,5,4,13,26,45,-19,19
AGF Aarhus,6395,10,4,7,11,17,37,-20,19
Lyngby,6395,11,3,9,12,26,47,-21,18
Brondby,6396,1,19,8,3,69,34,35,65
FC Midtjylla,6396,2,20,5,5,66,38,28,65
FC Nords,6396,3,14,6,10,75,54,21,48
Copenhagen,6396,4,14,6,10,57,43,14,48
AC Horsens,6396,5,7,14,9,35,49,-14,35
AaB,6396,6,6,13,11,35,45,-10,31
Sonderjyske,6396,7,8,6,10,28,29,-1,30
Lyngby,6396,8,4,9,11,27,44,-17,21
Randers FC,6396,9,5,6,13,23,40,-17,21
AGF Aarhus,6396,10,5,6,11,19,38,-19,21
Silkeborg IF,6396,11,5,3,14,27,47,-20,18
Brondby,6397,1,20,5,5,70,35,35,65
FC Midtjylla,6397,2,20,5,5,70,39,31,65
Copenhagen,6397,3,15,4,11,58,47,11,49
FC Nords,6397,4,13,6,11,73,60,13,45
AC Horsens,6397,5,8,14,8,44,51,-7,38
AaB,6397,6,7,12,11,35,44,-9,33
Sonderjyske,6397,7,8,6,10,28,29,-1,30
Lyngby,6397,8,4,9,11,28,45,-17,21
Silkeborg IF,6397,9,6,3,13,27,44,-17,21
Randers FC,6397,10,5,6,13,24,41,-17,21
AGF Aarhus,6397,11,4,6,12,16,38,-22,18
Brondby,6398,1,20,7,3,71,33,38,67
FC Midtjylla,6398,2,19,5,6,64,40,24,62
FC Nords,6398,3,15,7,8,74,49,25,52
Copenhagen,6398,4,14,6,10,57,41,16,48
AaB,6398,5,9,11,10,40,42,-2,38
Sonderjyske,6398,6,8,6,10,28,29,-1,30
AC Horsens,6398,7,5,12,13,32,59,-27,27
Randers FC,6398,8,5,7,12,23,39,-16,22
AGF Aarhus,6398,9,5,6,11,19,37,-18,21
Lyngby,6398,10,3,10,11,26,44,-18,19
Silkeborg IF,6398,11,5,3,14,26,47,-21,18
Brondby,6399,1,20,6,4,69,32,37,66
FC Midtjylla,6399,2,19,4,7,62,41,21,61
FC Nords,6399,3,16,6,8,75,47,28,54
Copenhagen,6399,4,15,4,11,62,47,15,49
AC Horsens,6399,5,7,13,10,39,55,-16,34
AaB,6399,6,7,11,12,38,49,-11,32
Sonderjyske,6399,7,8,6,10,28,29,-1,30
Lyngby,6399,8,4,9,11,28,45,-17,21
Randers FC,6399,9,5,6,13,24,41,-17,21
Silkeborg IF,6399,10,5,4,13,27,46,-19,19
AGF Aarhus,6399,11,4,7,11,18,38,-20,19
Brondby,6400,1,20,7,3,69,30,39,67
FC Midtjylla,6400,2,20,4,6,67,40,27,64
FC Nords,6400,3,14,8,8,71,48,23,50
Copenhagen,6400,4,15,4,11,58,42,16,49
AaB,6400,5,7,12,11,34,43,-9,33
AC Horsens,6400,6,6,13,11,32,54,-22,31
Sonderjyske,6400,7,8,6,10,28,29,-1,30
Lyngby,6400,8,4,9,11,27,44,-17,21
Randers FC,6400,9,5,6,13,23,40,-17,21
Silkeborg IF,6400,10,6,3,13,27,45,-18,21
AGF Aarhus,6400,11,4,6,12,17,38,-21,18
Brondby,6401,1,23,5,2,77,27,50,74
FC Midtjylla,6401,2,19,5,6,64,41,23,62
FC Nords,6401,3,13,9,8,73,52,21,48
Copenhagen,6401,4,14,5,11,57,45,12,47
AaB,6401,5,7,12,11,33,40,-7,33
Sonderjyske,6401,6,8,6,10,28,29,-1,30
AC Horsens,6401,7,6,12,12,34,59,-25,30
Lyngby,6401,8,4,9,11,29,45,-16,21
Randers FC,6401,9,5,6,13,24,42,-18,21
AGF Aarhus,6401,10,5,6,11,17,36,-19,21
Silkeborg IF,6401,11,5,3,14,25,45,-20,18
Brondby,6402,1,21,5,4,75,34,41,68
FC Midtjylla,6402,2,21,4,5,65,35,30,67
Copenhagen,6402,3,16,4,10,62,47,15,52
FC Nords,6402,4,13,6,11,75,57,18,45
AaB,6402,5,8,11,11,39,51,-12,35
Sonderjyske,6402,6,8,6,10,28,29,-1,30
AC Horsens,6402,7,6,12,12,35,53,-18,30
Randers FC,6402,8,6,6,12,26,41,-15,24
Silkeborg IF,6402,9,6,3,13,28,46,-18,21
Lyngby,6402,10,3,9,12,28,47,-19,18
AGF Aarhus,6402,11,4,6,12,18,39,-21,18
Brondby,6403,1,20,7,3,74,35,39,67
FC Midtjylla,6403,2,19,5,6,63,40,23,62
Copenhagen,6403,3,16,4,10,59,40,19,52
FC Nords,6403,4,13,6,11,73,55,18,45
AC Horsens,6403,5,8,12,10,37,52,-15,36
AaB,6403,6,7,12,11,35,45,-10,33
Sonderjyske,6403,7,8,6,10,28,29,-1,30
Randers FC,6403,8,6,6,12,24,39,-15,24
Silkeborg IF,6403,9,6,3,13,28,45,-17,21
Lyngby,6403,10,3,9,12,26,45,-19,18
AGF Aarhus,6403,11,4,6,12,17,39,-22,18
FC Midtjylla,6404,1,21,5,4,69,37,32,68
Brondby,6404,2,19,7,4,67,35,32,64
FC Nords,6404,3,14,7,9,74,50,24,49
Copenhagen,6404,4,13,7,10,56,46,10,46
AC Horsens,6404,5,7,13,10,34,49,-15,34
AaB,6404,6,6,13,11,35,44,-9,31
Sonderjyske,6404,7,8,6,10,28,29,-1,30
Randers FC,6404,8,5,7,12,23,39,-16,22
AGF Aarhus,6404,9,5,6,11,18,37,-19,21
Lyngby,6404,10,3,10,11,26,44,-18,19
Silkeborg IF,6404,11,5,3,14,26,46,-20,18
Brondby,6405,1,21,6,3,72,32,40,69
FC Midtjylla,6405,2,19,4,7,63,42,21,61
Copenhagen,6405,3,14,6,10,56,44,12,48
FC Nords,6405,4,13,6,11,70,54,16,45
AaB,6405,5,8,12,10,38,41,-3,36
AC Horsens,6405,6,7,14,9,36,48,-12,35
Sonderjyske,6405,7,8,6,10,28,29,-1,30
Lyngby,6405,8,4,9,11,29,45,-16,21
Randers FC,6405,9,5,6,13,24,42,-18,21
AGF Aarhus,6405,10,5,6,11,19,37,-18,21
Silkeborg IF,6405,11,5,3,14,26,47,-21,18
Brondby,6406,1,22,6,2,69,30,39,72
FC Midtjylla,6406,2,21,5,4,73,34,39,68
FC Nords,6406,3,13,8,9,70,54,16,47
Copenhagen,6406,4,14,5,11,58,44,14,47
AC Horsens,6406,5,6,13,11,33,55,-22,31
Sonderjyske,6406,6,8,6,10,28,29,-1,30
AaB,6406,7,6,11,13,33,45,-12,29
Randers FC,6406,8,6,6,12,26,40,-14,24
AGF Aarhus,6406,9,5,6,11,18,36,-18,21
Lyngby,6406,10,3,9,12,27,47,-20,18
Silkeborg IF,6406,11,5,3,14,25,46,-21,18
Brondby,6407,1,23,5,2,76,29,47,74
FC Midtjylla,6407,2,18,5,7,61,40,21,59
FC Nords,6407,3,13,8,9,74,57,17,47
Copenhagen,6407,4,14,5,11,59,48,11,47
AC Horsens,6407,5,8,12,10,41,52,-11,36
AaB,6407,6,7,11,12,34,45,-11,32
Sonderjyske,6407,7,8,6,10,28,29,-1,30
Randers FC,6407,8,6,6,12,25,39,-14,24
AGF Aarhus,6407,9,5,6,11,17,36,-19,21
Lyngby,6407,10,3,9,12,26,46,-20,18
Silkeborg IF,6407,11,5,3,14,25,45,-20,18
Brondby,6408,1,20,6,4,71,37,34,66
FC Midtjylla,6408,2,18,6,6,64,39,25,60
FC Nords,6408,3,15,7,8,77,52,25,52
Copenhagen,6408,4,14,6,10,58,44,14,48
AaB,6408,5,7,13,10,39,43,-4,34
AC Horsens,6408,6,7,12,11,33,53,-20,33
Sonderjyske,6408,7,8,6,10,28,29,-1,30
Lyngby,6408,8,4,9,11,29,46,-17,21
Randers FC,6408,9,5,6,13,25,42,-17,21
Silkeborg IF,6408,10,5,4,13,26,45,-19,19
AGF Aarhus,6408,11,4,7,11,17,37,-20,19
Brondby,6409,1,21,5,4,67,33,34,68
FC Midtjylla,6409,2,20,4,6,63,38,25,64
FC Nords,6409,3,16,6,8,75,46,29,54
Copenhagen,6409,4,15,4,11,58,44,14,49
AaB,6409,5,7,11,12,37,45,-8,32
Sonderjyske,6409,6,8,6,10,28,29,-1,30
AC Horsens,6409,7,6,12,12,38,58,-20,30
Randers FC,6409,8,5,7,12,23,39,-16,22
Lyngby,6409,9,3,10,11,26,44,-18,19
Silkeborg IF,6409,10,5,4,13,26,45,-19,19
AGF Aarhus,6409,11,4,7,11,17,37,-20,19
Brondby,6410,1,20,7,3,71,33,38,67
FC Midtjylla,6410,2,19,4,7,62,40,22,61
FC Nords,6410,3,14,7,9,74,53,21,49
Copenhagen,6410,4,13,5,12,56,45,11,44
AC Horsens,6410,5,8,13,9,38,50,-12,37
AaB,6410,6,8,12,10,37,43,-6,36
Sonderjyske,6410,7,8,6,10,28,29,-1,30
Lyngby,6410,8,4,9,11,29,45,-16,21
AGF Aarhus,6410,9,5,6,11,19,36,-17,21
Randers FC,6410,10,5,6,13,24,42,-18,21
Silkeborg IF,6410,11,5,3,14,25,47,-22,18
Brondby,6411,1,21,5,4,72,34,38,68
FC Midtjylla,6411,2,20,6,4,70,40,30,66
FC Nords,6411,3,15,7,8,72,48,24,52
Copenhagen,6411,4,14,5,11,57,44,13,47
AaB,6411,5,7,11,12,36,47,-11,32
Sonderjyske,6411,6,8,6,10,28,29,-1,30
AC Horsens,6411,7,6,12,12,32,52,-20,30
Randers FC,6411,8,5,7,12,25,41,-16,22
Silkeborg IF,6411,9,6,3,13,30,44,-14,21
Lyngby,6411,10,3,10,11,28,46,-18,19
AGF Aarhus,6411,11,4,6,12,16,41,-25,18
Brondby,6412,1,23,5,2,75,31,44,74
FC Midtjylla,6412,2,18,6,6,66,47,19,60
FC Nords,6412,3,15,7,8,78,53,25,52
Copenhagen,6412,4,13,5,12,59,50,9,44
AC Horsens,6412,5,6,14,10,39,55,-16,32
AaB,6412,6,6,13,11,37,44,-7,31
Sonderjyske,6412,7,8,6,10,28,29,-1,30
Lyngby,6412,8,4,9,11,28,44,-16,21
Silkeborg IF,6412,9,6,3,13,27,45,-18,21
Randers FC,6412,10,5,6,13,23,41,-18,21
AGF Aarhus,6412,11,4,6,12,17,38,-21,18
Brondby,6413,1,21,6,3,72,32,40,69
FC Midtjylla,6413,2,20,5,5,67,39,28,65
FC Nords,6413,3,13,7,10,71,54,17,46
Copenhagen,6413,4,13,5,12,57,48,9,44
AaB,6413,5,8,12,10,40,46,-6,36
AC Horsens,6413,6,7,13,10,35,49,-14,34
Sonderjyske,6413,7,8,6,10,28,29,-1,30
Randers FC,6413,8,5,7,12,24,40,-16,22
Silkeborg IF,6413,9,6,3,13,26,44,-18,21
Lyngby,6413,10,3,10,11,27,45,-18,19
AGF Aarhus,6413,11,4,6,12,16,37,-21,18
FC Midtjylla,6414,1,22,4,4,69,35,34,70
Brondby,6414,2,21,5,4,66,32,34,68
FC Nords,6414,3,14,7,9,74,51,23,49
Copenhagen,6414,4,13,4,13,54,49,5,43
AaB,6414,5,7,12,11,35,44,-9,33
AC Horsens,6414,6,7,12,11,37,50,-13,33
Sonderjyske,6414,7,8,6,10,28,29,-1,30
Randers FC,6414,8,6,6,12,24,39,-15,24
AGF Aarhus,6414,9,5,6,11,18,36,-18,21
Lyngby,6414,10,3,9,12,26,45,-19,18
Silkeborg IF,6414,11,5,3,14,25,46,-21,18
Brondby,6415,1,20,8,2,74,35,39,68
FC Midtjylla,6415,2,18,6,6,66,44,22,60
FC Nords,6415,3,15,8,7,73,48,25,53
Copenhagen,6415,4,12,6,12,58,50,8,42
AaB,6415,5,7,14,9,40,44,-4,35
AC Horsens,6415,6,5,16,9,34,50,-16,31
Sonderjyske,6415,7,8,6,10,28,29,-1,30
Lyngby,6415,8,4,9,11,29,44,-15,21
Randers FC,6415,9,5,6,13,23,42,-19,21
Silkeborg IF,6415,10,5,4,13,27,46,-19,19
AGF Aarhus,6415,11,4,7,11,18,38,-20,19
Brondby,6416,1,20,6,4,76,38,38,66
FC Midtjylla,6416,2,20,4,6,64,40,24,64
FC Nords,6416,3,14,6,10,73,54,19,48
Copenhagen,6416,4,14,4,12,56,45,11,46
AaB,6416,5,8,13,9,38,40,-2,37
AC Horsens,6416,6,7,13,10,36,52,-16,34
Sonderjyske,6416,7,8,6,10,28,29,-1,30
Lyngby,6416,8,4,9,11,28,44,-16,21
Silkeborg IF,6416,9,6,3,13,27,44,-17,21
Randers FC,6416,10,5,6,13,23,41,-18,21
AGF Aarhus,6416,11,4,6,12,16,38,-22,18
Brondby,6417,1,22,6,2,78,30,48,72
FC Midtjylla,6417,2,19,4,7,64,39,25,61
Copenhagen,6417,3,14,7,9,57,40,17,49
FC Nords,6417,4,13,6,11,72,60,12,45
AaB,6417,5,7,13,10,35,41,-6,34
AC Horsens,6417,6,6,14,10,32,54,-22,32
Sonderjyske,6417,7,8,6,10,28,29,-1,30
Lyngby,6417,8,4,9,11,28,45,-17,21
Randers FC,6417,9,5,6,13,24,41,-17,21
Silkeborg IF,6417,10,5,4,13,25,44,-19,19
AGF Aarhus,6417,11,4,7,11,16,36,-20,19
Brondby,6418,1,21,6,3,69,31,38,69
FC Midtjylla,6418,2,18,6,6,63,40,23,60
FC Nords,6418,3,15,8,7,76,50,26,53
Copenhagen,6418,4,14,5,11,58,45,13,47
AC Horsens,6418,5,6,14,10,37,55,-18,32
AaB,6418,6,6,13,11,36,44,-8,31
Sonderjyske,6418,7,8,6,10,28,29,-1,30
Randers FC,6418,8,6,6,12,24,39,-15,24
Silkeborg IF,6418,9,6,3,13,27,44,-17,21
Lyngby,6418,10,3,9,12,26,45,-19,18
AGF Aarhus,6418,11,4,6,12,16,38,-22,18
Brondby,6419,1,20,7,3,71,33,38,67
FC Midtjylla,6419,2,19,4,7,62,40,22,61
Copenhagen,6419,3,15,4,11,59,43,16,49
FC Nords,6419,4,13,6,11,72,57,15,45
AC Horsens,6419,5,8,13,9,35,49,-14,37
AaB,6419,6,8,12,10,41,44,-3,36
Sonderjyske,6419,7,8,6,10,28,29,-1,30
Randers FC,6419,8,6,6,12,25,39,-14,24
AGF Aarhus,6419,9,5,6,11,17,36,-19,21
Lyngby,6419,10,3,9,12,26,46,-20,18
Silkeborg IF,6419,11,5,3,14,25,45,-20,18
Brondby,6420,1,21,5,4,72,31,41,68
FC Midtjylla,6420,2,20,4,6,69,40,29,64
Copenhagen,6420,3,16,4,10,60,44,16,52
FC Nords,6420,4,13,7,10,72,56,16,46
AaB,6420,5,7,12,11,38,47,-9,33
AC Horsens,6420,6,6,14,10,32,51,-19,32
Sonderjyske,6420,7,8,6,10,28,29,-1,30
Randers FC,6420,8,5,7,12,25,41,-16,22
Silkeborg IF,6420,9,6,3,13,28,46,-18,21
Lyngby,6420,10,3,10,11,28,46,-18,19
AGF Aarhus,6420,11,4,6,12,18,39,-21,18
Brondby,6421,1,20,7,3,69,32,37,67
FC Midtjylla,6421,2,18,6,6,63,37,26,60
FC Nords,6421,3,14,7,9,70,54,16,49
Copenhagen,6421,4,14,6,10,59,43,16,48
AaB,6421,5,7,13,10,34,40,-6,34
AC Horsens,6421,6,7,13,10,39,54,-15,34
Sonderjyske,6421,7,8,6,10,28,29,-1,30
Lyngby,6421,8,4,9,11,30,46,-16,21
Randers FC,6421,9,5,6,13,25,43,-18,21
Silkeborg IF,6421,10,5,4,13,27,46,-19,19
AGF Aarhus,6421,11,4,7,11,18,38,-20,19
Brondby,6422,1,22,6,2,73,28,45,72
FC Midtjylla,6422,2,20,6,4,66,37,29,66
FC Nords,6422,3,14,7,9,75,51,24,49
Copenhagen,6422,4,12,6,12,54,48,6,42
AC Horsens,6422,5,7,12,11,34,55,-21,33
AaB,6422,6,7,11,12,38,47,-9,32
Sonderjyske,6422,7,8,6,10,28,29,-1,30
Lyngby,6422,8,4,9,11,28,44,-16,21
Silkeborg IF,6422,9,6,3,13,26,44,-18,21
Randers FC,6422,10,5,6,13,23,41,-18,21
AGF Aarhus,6422,11,4,6,12,16,37,-21,18
Brondby,6423,1,21,6,3,67,30,37,69
FC Midtjylla,6423,2,20,5,5,65,36,29,65
FC Nords,6423,3,14,6,10,74,54,20,48
Copenhagen,6423,4,14,5,11,57,44,13,47
AC Horsens,6423,5,7,14,9,34,48,-14,35
Sonderjyske,6423,6,8,6,10,28,29,-1,30
AaB,6423,7,6,12,12,38,49,-11,30
Randers FC,6423,8,6,6,12,25,40,-15,24
Silkeborg IF,6423,9,5,4,13,27,46,-19,19
AGF Aarhus,6423,10,4,7,11,18,38,-20,19
Lyngby,6423,11,3,9,12,27,46,-19,18
Brondby,6424,1,21,7,2,71,33,38,70
FC Midtjylla,6424,2,21,5,4,70,37,33,68
FC Nords,6424,3,13,8,9,71,51,20,47
Copenhagen,6424,4,12,6,12,58,51,7,42
AaB,6424,5,7,12,11,35,43,-8,33
AC Horsens,6424,6,6,14,10,35,51,-16,32
Sonderjyske,6424,7,8,6,10,28,29,-1,30
Lyngby,6424,8,4,9,11,28,45,-17,21
Randers FC,6424,9,5,6,13,24,41,-17,21
Silkeborg IF,6424,10,5,4,13,26,45,-19,19
AGF Aarhus,6424,11,4,7,11,17,37,-20,19
Brondby,6425,1,21,6,3,73,31,42,69
FC Midtjylla,6425,2,18,6,6,63,39,24,60
Copenhagen,6425,3,15,6,9,58,40,18,51
FC Nords,6425,4,13,8,9,71,52,19,47
AaB,6425,5,8,11,11,37,47,-10,35
Sonderjyske,6425,6,8,6,10,28,29,-1,30
AC Horsens,6425,7,5,15,10,35,54,-19,30
Randers FC,6425,8,5,7,12,25,41,-16,22
Lyngby,6425,9,3,10,11,28,46,-18,19
Silkeborg IF,6425,10,5,4,13,27,46,-19,19
AGF Aarhus,6425,11,4,7,11,18,38,-20,19
Brondby,6426,1,22,5,3,71,31,40,71
FC Midtjylla,6426,2,20,4,6,67,41,26,64
Copenhagen,6426,3,15,5,10,60,45,15,50
FC Nords,6426,4,13,6,11,73,52,21,45
AaB,6426,5,8,12,10,35,39,-4,36
Sonderjyske,6426,6,8,6,10,28,29,-1,30
AC Horsens,6426,7,6,12,12,33,57,-24,30
Randers FC,6426,8,6,6,12,27,40,-13,24
Silkeborg IF,6426,9,6,3,13,29,45,-16,21
Lyngby,6426,10,3,9,12,27,48,-21,18
AGF Aarhus,6426,11,4,6,12,17,40,-23,18
Brondby,6427,1,21,7,2,73,32,41,70
FC Midtjylla,6427,2,20,6,4,65,35,30,66
FC Nords,6427,3,15,6,9,73,53,20,51
Copenhagen,6427,4,14,4,12,58,43,15,46
AC Horsens,6427,5,6,13,11,33,54,-21,31
Sonderjyske,6427,6,8,6,10,28,29,-1,30
AaB,6427,7,6,12,12,38,49,-11,30
Lyngby,6427,8,4,9,11,28,45,-17,21
Randers FC,6427,9,5,6,13,24,41,-17,21
Silkeborg IF,6427,10,5,4,13,25,44,-19,19
AGF Aarhus,6427,11,4,7,11,16,36,-20,19
Brondby,6428,1,21,6,3,75,36,39,69
FC Midtjylla,6428,2,17,5,8,60,40,20,56
FC Nords,6428,3,14,7,9,74,53,21,49
Copenhagen,6428,4,14,5,11,57,45,12,47
AaB,6428,5,9,13,8,43,40,3,40
AC Horsens,6428,6,6,14,10,34,55,-21,32
Sonderjyske,6428,7,8,6,10,28,29,-1,30
Lyngby,6428,8,4,9,11,29,45,-16,21
Silkeborg IF,6428,9,6,3,13,27,44,-17,21
Randers FC,6428,10,5,6,13,24,42,-18,21
AGF Aarhus,6428,11,4,6,12,16,38,-22,18
Brondby,6429,1,20,7,3,70,33,37,67
FC Midtjylla,6429,2,20,4,6,65,42,23,64
FC Nords,6429,3,15,6,9,72,50,22,51
Copenhagen,6429,4,13,5,12,62,46,16,44
AaB,6429,5,8,12,10,37,43,-6,36
AC Horsens,6429,6,7,12,11,34,52,-18,33
Sonderjyske,6429,7,8,6,10,28,29,-1,30
Lyngby,6429,8,4,9,11,29,46,-17,21
Randers FC,6429,9,5,6,13,25,42,-17,21
Silkeborg IF,6429,10,6,3,13,28,46,-18,21
AGF Aarhus,6429,11,4,6,12,18,39,-21,18
Brondby,6430,1,22,5,3,74,32,42,71
FC Midtjylla,6430,2,22,4,4,73,41,32,70
FC Nords,6430,3,15,6,9,77,53,24,51
Copenhagen,6430,4,13,4,13,61,52,9,43
AC Horsens,6430,5,7,12,11,36,55,-19,33
Sonderjyske,6430,6,8,6,10,28,29,-1,30
AaB,6430,7,6,11,13,36,50,-14,29
Randers FC,6430,8,6,6,12,24,39,-15,24
AGF Aarhus,6430,9,5,6,11,18,37,-19,21
Lyngby,6430,10,3,9,12,26,45,-19,18
Silkeborg IF,6430,11,5,3,14,26,46,-20,18
Brondby,6431,1,22,6,2,73,32,41,72
FC Midtjylla,6431,2,19,5,6,70,39,31,62
FC Nords,6431,3,14,8,8,73,50,23,50
Copenhagen,6431,4,13,5,12,52,43,9,44
AC Horsens,6431,5,7,13,10,34,51,-17,34
AaB,6431,6,7,11,12,36,49,-13,32
Sonderjyske,6431,7,8,6,10,28,29,-1,30
Randers FC,6431,8,6,6,12,25,39,-14,24
Silkeborg IF,6431,9,6,3,13,27,45,-18,21
Lyngby,6431,10,3,9,12,26,46,-20,18
AGF Aarhus,6431,11,4,6,12,17,38,-21,18
Brondby,6432,1,20,8,2,67,29,38,68
FC Midtjylla,6432,2,19,5,6,65,38,27,62
FC Nords,6432,3,14,8,8,70,46,24,50
Copenhagen,6432,4,13,5,12,54,47,7,44
AaB,6432,5,7,13,10,37,42,-5,34
AC Horsens,6432,6,7,13,10,36,53,-17,34
Sonderjyske,6432,7,8,6,10,28,29,-1,30
Randers FC,6432,8,6,6,12,25,40,-15,24
Silkeborg IF,6432,9,5,4,13,26,45,-19,19
AGF Aarhus,6432,10,4,7,11,17,37,-20,19
Lyngby,6432,11,3,9,12,27,46,-19,18
Brondby,6433,1,21,5,4,70,30,40,68
FC Midtjylla,6433,2,19,5,6,63,40,23,62
FC Nords,6433,3,15,7,8,75,50,25,52
Copenhagen,6433,4,13,5,12,54,45,9,44
AaB,6433,5,7,13,10,35,43,-8,34
AC Horsens,6433,6,7,13,10,35,50,-15,34
Sonderjyske,6433,7,8,6,10,28,29,-1,30
Randers FC,6433,8,5,7,12,24,40,-16,22
Lyngby,6433,9,3,10,11,27,45,-18,19
Silkeborg IF,6433,10,5,4,13,25,44,-19,19
AGF Aarhus,6433,11,4,7,11,16,36,-20,19
Brondby,6434,1,20,8,2,74,33,41,68
FC Midtjylla,6434,2,19,6,5,66,38,28,63
FC Nords,6434,3,14,8,8,73,49,24,50
Copenhagen,6434,4,13,5,12,55,50,5,44
AaB,6434,5,9,11,10,36,39,-3,38
Sonderjyske,6434,6,8,6,10,28,29,-1,30
AC Horsens,6434,7,6,12,12,34,55,-21,30
Randers FC,6434,8,5,7,12,25,41,-16,22
Lyngby,6434,9,3,10,11,28,46,-18,19
Silkeborg IF,6434,10,5,4,13,26,45,-19,19
AGF Aarhus,6434,11,4,7,11,17,37,-20,19
Brondby,6435,1,21,6,3,75,34,41,69
FC Midtjylla,6435,2,21,4,5,67,36,31,67
FC Nords,6435,3,15,7,8,76,51,25,52
Copenhagen,6435,4,13,5,12,58,46,12,44
AaB,6435,5,7,12,11,37,45,-8,33
Sonderjyske,6435,6,8,6,10,28,29,-1,30
AC Horsens,6435,7,6,12,12,34,61,-27,30
Randers FC,6435,8,6,6,12,25,40,-15,24
AGF Aarhus,6435,9,5,6,11,18,37,-19,21
Lyngby,6435,10,3,9,12,27,46,-19,18
Silkeborg IF,6435,11,5,3,14,26,46,-20,18
Brondby,6436,1,21,5,4,70,35,35,68
FC Midtjylla,6436,2,19,5,6,65,38,27,62
Copenhagen,6436,3,16,5,9,63,42,21,53
FC Nords,6436,4,13,6,11,71,54,17,45
AaB,6436,5,9,11,10,38,43,-5,38
Sonderjyske,6436,6,8,6,10,28,29,-1,30
AC Horsens,6436,7,6,12,12,34,55,-21,30
Randers FC,6436,8,6,6,12,25,39,-14,24
Silkeborg IF,6436,9,6,3,13,26,44,-18,21
Lyngby,6436,10,3,9,12,26,46,-20,18
AGF Aarhus,6436,11,4,6,12,16,37,-21,18
Brondby,6437,1,21,5,4,76,33,43,68
FC Midtjylla,6437,2,21,5,4,71,36,35,68
FC Nords,6437,3,15,6,9,72,54,18,51
Copenhagen,6437,4,14,5,11,56,43,13,47
AaB,6437,5,7,11,12,33,41,-8,32
Sonderjyske,6437,6,8,6,10,28,29,-1,30
AC Horsens,6437,7,6,12,12,34,61,-27,30
Randers FC,6437,8,5,7,12,24,40,-16,22
Silkeborg IF,6437,9,6,3,13,26,44,-18,21
Lyngby,6437,10,3,10,11,27,45,-18,19
AGF Aarhus,6437,11,4,6,12,16,37,-21,18
Brondby,6438,1,21,6,3,74,31,43,69
FC Midtjylla,6438,2,18,4,8,62,43,19,58
FC Nords,6438,3,15,6,9,74,53,21,51
Copenhagen,6438,4,15,6,9,59,42,17,51
AC Horsens,6438,5,7,13,10,37,52,-15,34
AaB,6438,6,7,11,12,35,46,-11,32
Sonderjyske,6438,7,8,6,10,28,29,-1,30
Randers FC,6438,8,5,7,12,24,40,-16,22
Silkeborg IF,6438,9,6,3,13,27,44,-17,21
Lyngby,6438,10,3,10,11,27,45,-18,19
AGF Aarhus,6438,11,4,6,12,16,38,-22,18
Brondby,6439,1,22,5,3,71,32,39,71
FC Midtjylla,6439,2,19,4,7,64,41,23,61
FC Nords,6439,3,16,6,8,79,53,26,54
Copenhagen,6439,4,13,4,13,59,49,10,43
AC Horsens,6439,5,8,12,10,38,52,-14,36
AaB,6439,6,7,11,12,35,45,-10,32
Sonderjyske,6439,7,8,6,10,28,29,-1,30
Randers FC,6439,8,6,6,12,26,39,-13,24
Silkeborg IF,6439,9,6,3,13,27,45,-18,21
Lyngby,6439,10,3,9,12,26,47,-21,18
AGF Aarhus,6439,11,4,6,12,17,38,-21,18
FC Midtjylla,6440,1,21,5,4,66,34,32,68
Brondby,6440,2,19,7,4,70,35,35,64
Copenhagen,6440,3,15,4,11,56,40,16,49
FC Nords,6440,4,13,7,10,75,55,20,46
AaB,6440,5,9,11,10,43,46,-3,38
Sonderjyske,6440,6,8,6,10,28,29,-1,30
AC Horsens,6440,7,6,12,12,33,59,-26,30
Lyngby,6440,8,4,9,11,29,46,-17,21
Randers FC,6440,9,5,6,13,25,42,-17,21
AGF Aarhus,6440,10,5,6,11,18,36,-18,21
Silkeborg IF,6440,11,5,3,14,25,46,-21,18
Brondby,6441,1,21,7,2,75,32,43,70
FC Midtjylla,6441,2,20,5,5,68,38,30,65
FC Nords,6441,3,13,8,9,77,58,19,47
Copenhagen,6441,4,13,4,13,53,44,9,43
AaB,6441,5,8,12,10,38,46,-8,36
AC Horsens,6441,6,6,14,10,37,56,-19,32
Sonderjyske,6441,7,8,6,10,28,29,-1,30
Randers FC,6441,8,6,6,12,24,39,-15,24
Silkeborg IF,6441,9,6,3,13,28,44,-16,21
Lyngby,6441,10,3,9,12,26,45,-19,18
AGF Aarhus,6441,11,4,6,12,16,39,-23,18
Brondby,6442,1,22,5,3,74,30,44,71
FC Midtjylla,6442,2,18,5,7,65,47,18,59
FC Nords,6442,3,15,8,7,76,50,26,53
Copenhagen,6442,4,12,6,12,57,48,9,42
AaB,6442,5,8,12,10,42,44,-2,36
AC Horsens,6442,6,7,12,11,37,58,-21,33
Sonderjyske,6442,7,8,6,10,28,29,-1,30
Lyngby,6442,8,4,9,11,28,45,-17,21
Randers FC,6442,9,5,6,13,24,41,-17,21
AGF Aarhus,6442,10,5,6,11,17,36,-19,21
Silkeborg IF,6442,11,5,3,14,25,45,-20,18
Brondby,6443,1,20,5,5,69,36,33,65
FC Midtjylla,6443,2,18,6,6,62,42,20,60
FC Nords,6443,3,15,7,8,73,47,26,52
Copenhagen,6443,4,14,5,11,52,41,11,47
AC Horsens,6443,5,9,12,9,41,47,-6,39
AaB,6443,6,7,11,12,35,45,-10,32
Sonderjyske,6443,7,8,6,10,28,29,-1,30
Randers FC,6443,8,6,6,12,28,41,-13,24
Silkeborg IF,6443,9,6,3,13,28,45,-17,21
Lyngby,6443,10,3,9,12,28,49,-21,18
AGF Aarhus,6443,11,4,6,12,17,39,-22,18
Brondby,6444,1,22,6,2,76,31,45,72
FC Midtjylla,6444,2,19,5,6,64,39,25,62
FC Nords,6444,3,13,8,9,71,54,17,47
Copenhagen,6444,4,12,7,11,52,45,7,43
AaB,6444,5,8,12,10,41,43,-2,36
AC Horsens,6444,6,6,14,10,35,53,-18,32
Sonderjyske,6444,7,8,6,10,28,29,-1,30
Lyngby,6444,8,4,9,11,29,44,-15,21
Silkeborg IF,6444,9,6,3,13,28,45,-17,21
Randers FC,6444,10,5,6,13,23,42,-19,21
AGF Aarhus,6444,11,4,6,12,17,39,-22,18
Brondby,6445,1,21,5,4,72,33,39,68
FC Midtjylla,6445,2,20,5,5,65,40,25,65
FC Nords,6445,3,14,7,9,75,48,27,49
Copenhagen,6445,4,14,5,11,56,42,14,47
AC Horsens,6445,5,7,13,10,35,55,-20,34
AaB,6445,6,7,11,12,33,44,-11,32
Sonderjyske,6445,7,8,6,10,28,29,-1,30
Randers FC,6445,8,5,7,12,23,39,-16,22
Lyngby,6445,9,3,10,11,26,44,-18,19
Silkeborg IF,6445,10,5,4,13,25,44,-19,19
AGF Aarhus,6445,11,4,7,11,16,36,-20,19
Brondby,6446,1,21,7,2,71,30,41,70
FC Midtjylla,6446,2,20,5,5,69,40,29,65
FC Nords,6446,3,15,7,8,74,49,25,52
Copenhagen,6446,4,12,5,13,51,45,6,41
AaB,6446,5,7,12,11,38,43,-5,33
AC Horsens,6446,6,6,14,10,33,55,-22,32
Sonderjyske,6446,7,8,6,10,28,29,-1,30
Lyngby,6446,8,4,9,11,27,44,-17,21
Randers FC,6446,9,5,6,13,23,40,-17,21
Silkeborg IF,6446,10,5,4,13,26,45,-19,19
AGF Aarhus,6446,11,4,7,11,17,37,-20,19
Brondby,6447,1,22,6,2,73,32,41,72
FC Midtjylla,6447,2,19,5,6,66,38,28,62
Copenhagen,6447,3,14,6,10,58,46,12,48
FC Nords,6447,4,12,7,11,70,57,13,43
AaB,6447,5,7,13,10,34,39,-5,34
AC Horsens,6447,6,6,15,9,35,50,-15,33
Sonderjyske,6447,7,8,6,10,28,29,-1,30
Randers FC,6447,8,6,6,12,24,39,-15,24
AGF Aarhus,6447,9,5,6,11,18,37,-19,21
Lyngby,6447,10,3,9,12,26,45,-19,18
Silkeborg IF,6447,11,5,3,14,26,46,-20,18
Brondby,6448,1,21,5,4,69,33,36,68
FC Midtjylla,6448,2,20,4,6,68,38,30,64
FC Nords,6448,3,15,7,8,74,50,24,52
Copenhagen,6448,4,13,5,12,59,48,11,44
AC Horsens,6448,5,7,13,10,37,54,-17,34
AaB,6448,6,7,12,11,38,48,-10,33
Sonderjyske,6448,7,8,6,10,28,29,-1,30
Randers FC,6448,8,6,6,12,25,40,-15,24
AGF Aarhus,6448,9,5,6,11,21,37,-16,21
Lyngby,6448,10,3,9,12,27,46,-19,18
Silkeborg IF,6448,11,5,3,14,26,49,-23,18
Brondby,6449,1,19,9,2,67,30,37,66
FC Midtjylla,6449,2,19,6,5,63,38,25,63
FC Nords,6449,3,14,7,9,72,53,19,49
Copenhagen,6449,4,13,7,10,56,41,15,46
AaB,6449,5,8,14,8,37,38,-1,38
Sonderjyske,6449,6,8,6,10,28,29,-1,30
AC Horsens,6449,7,5,13,12,33,54,-21,28
Randers FC,6449,8,5,7,12,24,40,-16,22
Silkeborg IF,6449,9,6,3,13,27,44,-17,21
Lyngby,6449,10,3,10,11,27,45,-18,19
AGF Aarhus,6449,11,4,6,12,16,38,-22,18
FC Midtjylla,6450,1,20,6,4,68,37,31,66
Brondby,6450,2,18,8,4,65,32,33,62
FC Nords,6450,3,15,8,7,75,49,26,53
Copenhagen,6450,4,13,5,12,55,46,9,44
AaB,6450,5,7,13,10,34,41,-7,34
AC Horsens,6450,6,6,14,10,39,57,-18,32
Sonderjyske,6450,7,8,6,10,28,29,-1,30
Randers FC,6450,8,5,7,12,23,39,-16,22
Lyngby,6450,9,3,10,11,26,44,-18,19
Silkeborg IF,6450,10,5,4,13,28,47,-19,19
AGF Aarhus,6450,11,4,7,11,19,39,-20,19
FC Midtjylla,6451,1,22,4,4,68,33,35,70
Brondby,6451,2,21,6,3,71,32,39,69
FC Nords,6451,3,13,7,10,70,52,18,46
Copenhagen,6451,4,13,6,11,54,45,9,45
AaB,6451,5,7,12,11,37,47,-10,33
AC Horsens,6451,6,6,13,11,36,53,-17,31
Sonderjyske,6451,7,8,6,10,28,29,-1,30
Lyngby,6451,8,4,9,11,28,44,-16,21
Randers FC,6451,9,5,6,13,23,41,-18,21
Silkeborg IF,6451,10,5,4,13,25,44,-19,19
AGF Aarhus,6451,11,4,7,11,16,36,-20,19
Brondby,6452,1,22,5,3,76,33,43,71
FC Midtjylla,6452,2,21,4,5,70,35,35,67
FC Nords,6452,3,13,7,10,71,55,16,46
Copenhagen,6452,4,13,4,13,55,51,4,43
AaB,6452,5,8,11,11,37,43,-6,35
AC Horsens,6452,6,7,13,10,37,55,-18,34
Sonderjyske,6452,7,8,6,10,28,29,-1,30
Lyngby,6452,8,4,9,11,28,44,-16,21
Silkeborg IF,6452,9,6,3,13,26,44,-18,21
Randers FC,6452,10,5,6,13,23,41,-18,21
AGF Aarhus,6452,11,4,6,12,16,37,-21,18
FC Midtjylla,6453,1,20,4,6,65,39,26,64
Brondby,6453,2,19,6,5,69,37,32,63
FC Nords,6453,3,14,7,9,73,53,20,49
Copenhagen,6453,4,13,5,12,60,49,11,44
AaB,6453,5,9,11,10,37,38,-1,38
AC Horsens,6453,6,8,13,9,39,53,-14,37
Sonderjyske,6453,7,8,6,10,28,29,-1,30
Lyngby,6453,8,4,9,11,28,45,-17,21
Randers FC,6453,9,5,6,13,24,41,-17,21
AGF Aarhus,6453,10,5,6,11,18,36,-18,21
Silkeborg IF,6453,11,5,3,14,25,46,-21,18
FC Midtjylla,6454,1,20,5,5,72,40,32,65
Brondby,6454,2,19,7,4,67,32,35,64
FC Nords,6454,3,15,7,8,76,52,24,52
Copenhagen,6454,4,14,5,11,55,46,9,47
AaB,6454,5,8,12,10,38,43,-5,36
Sonderjyske,6454,6,8,6,10,28,29,-1,30
AC Horsens,6454,7,6,12,12,36,57,-21,30
Lyngby,6454,8,4,9,11,28,45,-17,21
Silkeborg IF,6454,8,6,3,13,28,45,-17,21
Randers FC,6454,10,5,6,13,24,41,-17,21
AGF Aarhus,6454,11,4,6,12,17,39,-22,18
Brondby,6455,1,22,6,2,73,31,42,72
FC Midtjylla,6455,2,18,5,7,60,42,18,59
FC Nords,6455,3,15,6,9,75,49,26,51
Copenhagen,6455,4,13,6,11,57,45,12,45
AC Horsens,6455,5,7,13,10,39,53,-14,34
AaB,6455,6,7,12,11,36,46,-10,33
Sonderjyske,6455,7,8,6,10,28,29,-1,30
Lyngby,6455,8,4,9,11,28,44,-16,21
Silkeborg IF,6455,9,6,3,13,26,44,-18,21
Randers FC,6455,10,5,6,13,23,41,-18,21
AGF Aarhus,6455,11,4,6,12,16,37,-21,18
Brondby,6456,1,23,5,2,73,30,43,74
FC Midtjylla,6456,2,18,4,8,61,44,17,58
FC Nords,6456,3,16,6,8,75,48,27,54
Copenhagen,6456,4,14,4,12,62,46,16,46
AC Horsens,6456,5,7,13,10,39,54,-15,34
Sonderjyske,6456,6,8,6,10,28,29,-1,30
AaB,6456,7,6,12,12,37,51,-14,30
Randers FC,6456,8,6,6,12,24,39,-15,24
AGF Aarhus,6456,9,5,6,11,18,37,-19,21
Lyngby,6456,10,3,9,12,26,45,-19,18
Silkeborg IF,6456,11,5,3,14,26,46,-20,18
Brondby,6457,1,22,5,3,69,28,41,71
FC Midtjylla,6457,2,18,6,6,60,38,22,60
FC Nords,6457,3,14,8,8,73,48,25,50
Copenhagen,6457,4,13,4,13,55,47,8,43
AaB,6457,5,9,12,9,37,38,-1,39
AC Horsens,6457,6,6,13,11,34,55,-21,31
Sonderjyske,6457,7,8,6,10,28,29,-1,30
Lyngby,6457,8,4,9,11,28,45,-17,21
Randers FC,6457,9,5,6,13,24,41,-17,21
AGF Aarhus,6457,10,5,6,11,19,38,-19,21
Silkeborg IF,6457,11,5,3,14,27,47,-20,18
FC Midtjylla,6458,1,20,4,6,65,41,24,64
Brondby,6458,2,19,6,5,68,35,33,63
Copenhagen,6458,3,16,4,10,58,42,16,52
FC Nords,6458,4,14,8,8,74,52,22,50
AaB,6458,5,8,11,11,37,41,-4,35
AC Horsens,6458,6,6,13,11,35,52,-17,31
Sonderjyske,6458,7,8,6,10,28,29,-1,30
Randers FC,6458,8,6,6,12,26,40,-14,24
Silkeborg IF,6458,9,5,4,13,28,47,-19,19
AGF Aarhus,6458,10,4,7,11,19,39,-20,19
Lyngby,6458,11,3,9,12,27,47,-20,18
FC Midtjylla,6459,1,20,5,5,66,40,26,65
Brondby,6459,2,19,5,6,64,39,25,62
FC Nords,6459,3,15,6,9,78,54,24,51
Copenhagen,6459,4,14,5,11,61,42,19,47
AC Horsens,6459,5,9,12,9,37,47,-10,39
AaB,6459,6,6,13,11,35,45,-10,31
Sonderjyske,6459,7,8,6,10,28,29,-1,30
Silkeborg IF,6459,8,6,3,13,28,44,-16,21
Lyngby,6459,9,4,9,11,27,44,-17,21
Randers FC,6459,10,5,6,13,23,40,-17,21
AGF Aarhus,6459,11,4,6,12,16,39,-23,18
Brondby,6460,1,22,5,3,76,35,41,71
FC Midtjylla,6460,2,19,5,6,67,44,23,62
FC Nords,6460,3,14,6,10,73,52,21,48
Copenhagen,6460,4,14,5,11,57,45,12,47
AaB,6460,5,8,12,10,33,40,-7,36
AC Horsens,6460,6,6,13,11,34,50,-16,31
Sonderjyske,6460,7,8,6,10,28,29,-1,30
Randers FC,6460,8,6,6,12,26,39,-13,24
Silkeborg IF,6460,9,5,4,13,27,46,-19,19
AGF Aarhus,6460,10,4,7,11,18,38,-20,19
Lyngby,6460,11,3,9,12,26,47,-21,18
Brondby,6461,1,21,6,3,73,32,41,69
FC Midtjylla,6461,2,21,4,5,70,38,32,67
FC Nords,6461,3,14,7,9,72,53,19,49
Copenhagen,6461,4,14,5,11,61,48,13,47
AC Horsens,6461,5,6,14,10,37,58,-21,32
Sonderjyske,6461,6,8,6,10,28,29,-1,30
AaB,6461,7,6,12,12,40,50,-10,30
Lyngby,6461,8,4,9,11,27,44,-17,21
Randers FC,6461,9,5,6,13,23,40,-17,21
Silkeborg IF,6461,10,5,4,13,25,44,-19,19
AGF Aarhus,6461,11,4,7,11,16,36,-20,19
Brondby,6462,1,21,5,4,70,32,38,68
FC Midtjylla,6462,2,19,4,7,66,39,27,61
FC Nords,6462,3,14,6,10,72,54,18,48
Copenhagen,6462,4,14,5,11,56,43,13,47
AC Horsens,6462,5,8,13,9,36,50,-14,37
AaB,6462,6,8,11,11,37,45,-8,35
Sonderjyske,6462,7,8,6,10,28,29,-1,30
Randers FC,6462,8,5,7,12,25,41,-16,22
Silkeborg IF,6462,9,6,3,13,28,45,-17,21
Lyngby,6462,10,3,10,11,28,46,-18,19
AGF Aarhus,6462,11,4,6,12,17,39,-22,18
Brondby,6463,1,20,7,3,71,35,36,67
FC Midtjylla,6463,2,18,4,8,57,38,19,58
FC Nords,6463,3,16,6,8,76,49,27,54
Copenhagen,6463,4,13,6,11,56,44,12,45
AaB,6463,5,10,12,8,42,38,4,42
Sonderjyske,6463,6,8,6,10,28,29,-1,30
AC Horsens,6463,7,5,13,12,31,55,-24,28
Lyngby,6463,8,4,9,11,29,45,-16,21
Silkeborg IF,6463,9,6,3,13,27,44,-17,21
Randers FC,6463,10,5,6,13,24,42,-18,21
AGF Aarhus,6463,11,4,6,12,16,38,-22,18
Brondby,6464,1,20,6,4,68,33,35,66
FC Midtjylla,6464,2,20,6,4,70,38,32,66
FC Nords,6464,3,14,6,10,70,50,20,48
Copenhagen,6464,4,12,7,11,54,44,10,43
AaB,6464,5,8,12,10,37,45,-8,36
AC Horsens,6464,6,7,13,10,35,50,-15,34
Sonderjyske,6464,7,8,6,10,28,29,-1,30
Randers FC,6464,8,6,6,12,26,39,-13,24
Silkeborg IF,6464,9,5,4,13,26,45,-19,19
AGF Aarhus,6464,10,4,7,11,17,37,-20,19
Lyngby,6464,11,3,9,12,26,47,-21,18
Brondby,6465,1,21,6,3,75,35,40,69
FC Midtjylla,6465,2,19,5,6,67,46,21,62
FC Nords,6465,3,15,7,8,83,56,27,52
Copenhagen,6465,4,12,4,14,55,53,2,40
AaB,6465,5,8,12,10,41,44,-3,36
AC Horsens,6465,6,7,14,9,39,52,-13,35
Sonderjyske,6465,7,8,6,10,28,29,-1,30
Randers FC,6465,8,6,6,12,24,39,-15,24
Silkeborg IF,6465,9,6,3,13,27,44,-17,21
Lyngby,6465,10,3,9,12,26,45,-19,18
AGF Aarhus,6465,11,4,6,12,16,38,-22,18
Brondby,6466,1,21,5,4,75,36,39,68
FC Midtjylla,6466,2,19,5,6,65,40,25,62
Copenhagen,6466,3,16,4,10,56,42,14,52
FC Nords,6466,4,15,6,9,71,50,21,51
AC Horsens,6466,5,7,12,11,36,52,-16,33
Sonderjyske,6466,6,8,6,10,28,29,-1,30
AaB,6466,7,6,12,12,36,45,-9,30
Lyngby,6466,8,4,9,11,27,44,-17,21
Randers FC,6466,9,5,6,13,23,40,-17,21
AGF Aarhus,6466,10,5,6,11,20,37,-17,21
Silkeborg IF,6466,11,5,3,14,26,48,-22,18
Brondby,6467,1,20,7,3,69,32,37,67
FC Midtjylla,6467,2,18,5,7,62,41,21,59
FC Nords,6467,3,13,9,8,74,52,22,48
Copenhagen,6467,4,13,6,11,55,43,12,45
AaB,6467,5,10,12,8,40,40,0,42
AC Horsens,6467,6,6,13,11,35,53,-18,31
Sonderjyske,6467,7,8,6,10,28,29,-1,30
Randers FC,6467,8,5,7,12,25,41,-16,22
AGF Aarhus,6467,9,5,6,11,17,36,-19,21
Lyngby,6467,10,3,10,11,28,46,-18,19
Silkeborg IF,6467,11,5,3,14,25,45,-20,18
FC Midtjylla,6468,1,21,4,5,65,37,28,67
Brondby,6468,2,20,5,5,69,34,35,65
FC Nords,6468,3,16,7,7,79,49,30,55
Copenhagen,6468,4,13,5,12,51,44,7,44
AaB,6468,5,7,14,9,36,40,-4,35
Sonderjyske,6468,6,8,6,10,28,29,-1,30
AC Horsens,6468,7,5,13,12,33,55,-22,28
Randers FC,6468,8,5,7,12,23,39,-16,22
Silkeborg IF,6468,9,6,3,13,26,44,-18,21
Lyngby,6468,10,3,10,11,26,44,-18,19
AGF Aarhus,6468,11,4,6,12,16,37,-21,18
Brondby,6469,1,19,7,4,68,32,36,64
FC Midtjylla,6469,2,18,6,6,61,44,17,60
FC Nords,6469,3,15,6,9,75,51,24,51
Copenhagen,6469,4,14,6,10,58,44,14,48
AaB,6469,5,8,11,11,39,46,-7,35
AC Horsens,6469,6,7,14,9,41,51,-10,35
Sonderjyske,6469,7,8,6,10,28,29,-1,30
Lyngby,6469,8,4,9,11,27,44,-17,21
Randers FC,6469,9,5,6,13,23,40,-17,21
Silkeborg IF,6469,10,6,3,13,26,44,-18,21
AGF Aarhus,6469,11,4,6,12,16,37,-21,18
Brondby,6470,1,21,6,3,69,32,37,69
FC Midtjylla,6470,2,19,6,5,64,39,25,63
FC Nords,6470,3,15,7,8,77,53,24,52
Copenhagen,6470,4,14,4,12,60,48,12,46
AC Horsens,6470,5,7,12,11,34,52,-18,33
AaB,6470,6,7,11,12,37,43,-6,32
Sonderjyske,6470,7,8,6,10,28,29,-1,30
Randers FC,6470,8,6,6,12,24,39,-15,24
AGF Aarhus,6470,9,5,6,11,19,36,-17,21
Lyngby,6470,10,3,9,12,26,45,-19,18
Silkeborg IF,6470,11,5,3,14,25,47,-22,18
Brondby,6471,1,21,6,3,70,31,39,69
FC Midtjylla,6471,2,19,4,7,66,40,26,61
FC Nords,6471,3,15,7,8,76,53,23,52
Copenhagen,6471,4,14,4,12,57,45,12,46
AaB,6471,5,9,11,10,36,40,-4,38
Sonderjyske,6471,6,8,6,10,28,29,-1,30
AC Horsens,6471,7,6,12,12,33,55,-22,30
Randers FC,6471,8,5,7,12,24,40,-16,22
AGF Aarhus,6471,9,5,6,11,20,37,-17,21
Lyngby,6471,10,3,10,11,27,45,-18,19
Silkeborg IF,6471,11,5,3,14,26,48,-22,18
Brondby,6472,1,21,5,4,69,31,38,68
FC Midtjylla,6472,2,20,5,5,67,35,32,65
Copenhagen,6472,3,15,5,10,55,42,13,50
FC Nords,6472,4,14,7,9,73,49,24,49
AC Horsens,6472,5,7,12,11,36,53,-17,33
Sonderjyske,6472,6,8,6,10,28,29,-1,30
AaB,6472,7,6,12,12,35,51,-16,30
Lyngby,6472,8,4,9,11,28,44,-16,21
Silkeborg IF,6472,9,6,3,13,27,45,-18,21
Randers FC,6472,10,5,6,13,23,41,-18,21
AGF Aarhus,6472,11,4,6,12,17,38,-21,18
Brondby,6473,1,21,7,2,74,33,41,70
FC Midtjylla,6473,2,19,7,4,70,42,28,64
FC Nords,6473,3,14,7,9,75,53,22,49
Copenhagen,6473,4,13,6,11,56,45,11,45
AC Horsens,6473,5,6,15,9,39,55,-16,33
Sonderjyske,6473,6,8,6,10,28,29,-1,30
AaB,6473,7,6,12,12,34,46,-12,30
Lyngby,6473,8,4,9,11,27,44,-17,21
Randers FC,6473,9,5,6,13,23,40,-17,21
AGF Aarhus,6473,10,5,6,11,17,36,-19,21
Silkeborg IF,6473,11,5,3,14,25,45,-20,18
FC Midtjylla,6474,1,21,4,5,68,37,31,67
Brondby,6474,2,19,7,4,67,36,31,64
Copenhagen,6474,3,15,5,10,62,44,18,50
FC Nords,6474,4,14,6,10,71,51,20,48
AaB,6474,5,7,13,10,37,44,-7,34
Sonderjyske,6474,6,8,6,10,28,29,-1,30
AC Horsens,6474,7,5,15,10,34,53,-19,30
Randers FC,6474,8,6,6,12,24,39,-15,24
Silkeborg IF,6474,9,5,4,13,26,45,-19,19
AGF Aarhus,6474,10,4,7,11,17,37,-20,19
Lyngby,6474,11,3,9,12,26,45,-19,18
Brondby,6475,1,23,5,2,72,27,45,74
FC Midtjylla,6475,2,19,5,6,66,40,26,62
FC Nords,6475,3,14,6,10,72,54,18,48
Copenhagen,6475,4,12,5,13,55,47,8,41
AC Horsens,6475,5,8,12,10,35,48,-13,36
AaB,6475,6,8,11,11,36,46,-10,35
Sonderjyske,6475,7,8,6,10,28,29,-1,30
Lyngby,6475,8,4,9,11,28,45,-17,21
Silkeborg IF,6475,9,6,3,13,27,44,-17,21
Randers FC,6475,10,5,6,13,24,41,-17,21
AGF Aarhus,6475,11,4,6,12,16,38,-22,18
FC Midtjylla,6476,1,19,7,4,72,41,31,64
Brondby,6476,2,19,6,5,67,37,30,63
FC Nords,6476,3,14,8,8,80,54,26,50
Copenhagen,6476,4,14,7,9,58,42,16,49
AaB,6476,5,6,15,9,36,42,-6,33
Sonderjyske,6476,6,8,6,10,28,29,-1,30
AC Horsens,6476,7,5,15,10,33,56,-23,30
Lyngby,6476,8,4,9,11,28,45,-17,21
Silkeborg IF,6476,9,6,3,13,27,44,-17,21
Randers FC,6476,10,5,6,13,24,41,-17,21
AGF Aarhus,6476,11,4,6,12,16,38,-22,18
FC Midtjylla,6477,1,21,4,5,68,37,31,67
Brondby,6477,2,19,8,3,69,31,38,65
FC Nords,6477,3,15,6,9,70,50,20,51
Copenhagen,6477,4,14,5,11,56,44,12,47
AaB,6477,5,7,12,11,34,41,-7,33
AC Horsens,6477,6,6,13,11,34,54,-20,31
Sonderjyske,6477,7,8,6,10,28,29,-1,30
Randers FC,6477,8,5,7,12,25,41,-16,22
Silkeborg IF,6477,9,6,3,13,26,44,-18,21
Lyngby,6477,10,3,10,11,28,46,-18,19
AGF Aarhus,6477,11,4,6,12,16,37,-21,18
Brondby,6478,1,22,6,2,72,31,41,72
FC Midtjylla,6478,2,19,6,5,70,43,27,63
Copenhagen,6478,3,14,7,9,60,44,16,49
FC Nords,6478,4,12,8,10,77,59,18,44
AaB,6478,5,7,12,11,39,47,-8,33
AC Horsens,6478,6,6,13,11,36,56,-20,31
Sonderjyske,6478,7,8,6,10,28,29,-1,30
Lyngby,6478,8,4,9,11,27,44,-17,21
Randers FC,6478,9,5,6,13,23,40,-17,21
Silkeborg IF,6478,10,5,4,13,27,46,-19,19
AGF Aarhus,6478,11,4,7,11,18,38,-20,19
FC Midtjylla,6479,1,21,4,5,68,37,31,67
Brondby,6479,2,19,5,6,69,40,29,62
FC Nords,6479,3,16,6,8,75,51,24,54
Copenhagen,6479,4,13,4,13,58,47,11,43
AaB,6479,5,9,11,10,38,44,-6,38
AC Horsens,6479,6,7,12,11,40,55,-15,33
Sonderjyske,6479,7,8,6,10,28,29,-1,30
Randers FC,6479,8,5,7,12,23,39,-16,22
Silkeborg IF,6479,9,6,3,13,27,45,-18,21
Lyngby,6479,10,3,10,11,26,44,-18,19
AGF Aarhus,6479,11,4,6,12,17,38,-21,18
Brondby,6480,1,20,5,5,71,40,31,65
FC Midtjylla,6480,2,18,6,6,65,41,24,60
FC Nords,6480,3,15,7,8,77,49,28,52
Copenhagen,6480,4,12,6,12,57,47,10,42
AaB,6480,5,10,11,9,39,39,0,41
AC Horsens,6480,6,7,13,10,36,55,-19,34
Sonderjyske,6480,7,8,6,10,28,29,-1,30
Randers FC,6480,8,6,6,12,25,40,-15,24
AGF Aarhus,6480,9,5,6,11,18,36,-18,21
Lyngby,6480,10,3,9,12,27,46,-19,18
Silkeborg IF,6480,11,5,3,14,25,46,-21,18
Brondby,6481,1,20,7,3,65,30,35,67
FC Midtjylla,6481,2,19,5,6,70,38,32,62
FC Nords,6481,3,14,7,9,72,51,21,49
Copenhagen,6481,4,12,6,12,53,50,3,42
AaB,6481,5,10,12,8,40,38,2,42
AC Horsens,6481,6,6,13,11,36,55,-19,31
Sonderjyske,6481,7,8,6,10,28,29,-1,30
Randers FC,6481,8,6,6,12,27,41,-14,24
AGF Aarhus,6481,9,5,6,11,18,36,-18,21
Lyngby,6481,10,3,9,12,28,48,-20,18
Silkeborg IF,6481,11,5,3,14,25,46,-21,18
Brondby,6482,1,20,8,2,67,29,38,68
FC Midtjylla,6482,2,21,4,5,64,35,29,67
FC Nords,6482,3,12,8,10,72,55,17,44
Copenhagen,6482,4,12,6,12,54,44,10,42
AaB,6482,5,8,12,10,33,39,-6,36
AC Horsens,6482,6,8,12,10,33,47,-14,36
Sonderjyske,6482,7,8,6,10,28,29,-1,30
Randers FC,6482,8,6,6,12,24,39,-15,24
Silkeborg IF,6482,9,6,3,13,26,44,-18,21
Lyngby,6482,10,3,9,12,26,45,-19,18
AGF Aarhus,6482,11,4,6,12,16,37,-21,18
Brondby,6483,1,20,7,3,67,32,35,67
FC Midtjylla,6483,2,19,7,4,68,41,27,64
FC Nords,6483,3,13,8,9,72,51,21,47
Copenhagen,6483,4,13,6,11,55,44,11,45
AaB,6483,5,8,13,9,45,48,-3,37
AC Horsens,6483,6,6,13,11,36,53,-17,31
Sonderjyske,6483,7,8,6,10,28,29,-1,30
Lyngby,6483,8,4,9,11,31,44,-13,21
AGF Aarhus,6483,9,5,6,11,19,37,-18,21
Randers FC,6483,10,5,6,13,23,44,-21,21
Silkeborg IF,6483,11,5,3,14,26,47,-21,18
Brondby,6484,1,21,5,4,69,34,35,68
FC Midtjylla,6484,2,21,4,5,72,37,35,67
FC Nords,6484,3,12,8,10,67,51,16,44
Copenhagen,6484,4,13,5,12,57,47,10,44
AC Horsens,6484,5,10,12,8,38,48,-10,42
Sonderjyske,6484,6,8,6,10,28,29,-1,30
AaB,6484,7,6,12,12,33,45,-12,30
Lyngby,6484,8,4,9,11,31,45,-14,21
AGF Aarhus,6484,9,5,6,11,19,38,-19,21
Randers FC,6484,10,5,6,13,24,44,-20,21
Silkeborg IF,6484,11,5,3,14,27,47,-20,18
FC Midtjylla,6485,1,20,6,4,70,40,30,66
Brondby,6485,2,20,5,5,67,33,34,65
FC Nords,6485,3,14,6,10,71,52,19,48
Copenhagen,6485,4,14,5,11,55,41,14,47
AaB,6485,5,8,12,10,40,43,-3,36
AC Horsens,6485,6,7,12,11,37,57,-20,33
Sonderjyske,6485,7,8,6,10,28,29,-1,30
Lyngby,6485,8,4,9,11,28,44,-16,21
Silkeborg IF,6485,9,6,3,13,28,45,-17,21
Randers FC,6485,10,5,6,13,23,41,-18,21
AGF Aarhus,6485,11,4,6,12,17,39,-22,18
Brondby,6486,1,21,6,3,73,32,41,69
FC Midtjylla,6486,2,19,6,5,64,40,24,63
FC Nords,6486,3,14,8,8,75,51,24,50
Copenhagen,6486,4,12,8,10,56,44,12,44
AC Horsens,6486,5,7,13,10,33,51,-18,34
AaB,6486,6,6,13,11,32,41,-9,31
Sonderjyske,6486,7,8,6,10,28,29,-1,30
Lyngby,6486,8,4,9,11,29,44,-15,21
Randers FC,6486,9,5,6,13,23,42,-19,21
Silkeborg IF,6486,10,5,4,13,25,44,-19,19
AGF Aarhus,6486,11,4,7,11,16,36,-20,19
Brondby,6487,1,19,6,5,70,36,34,63
FC Midtjylla,6487,2,19,6,5,65,38,27,63
FC Nords,6487,3,16,6,8,74,48,26,54
Copenhagen,6487,4,14,4,12,57,49,8,46
AC Horsens,6487,5,7,14,9,36,48,-12,35
AaB,6487,6,7,12,11,36,45,-9,33
Sonderjyske,6487,7,8,6,10,28,29,-1,30
Lyngby,6487,8,4,9,11,29,46,-17,21
Silkeborg IF,6487,9,6,3,13,28,45,-17,21
Randers FC,6487,10,5,6,13,25,42,-17,21
AGF Aarhus,6487,11,4,6,12,17,39,-22,18
Brondby,6488,1,20,6,4,66,33,33,66
FC Midtjylla,6488,2,18,7,5,63,40,23,61
FC Nords,6488,3,15,8,7,75,47,28,53
Copenhagen,6488,4,13,6,11,58,45,13,45
AC Horsens,6488,5,7,14,9,34,47,-13,35
AaB,6488,6,6,13,11,34,44,-10,31
Sonderjyske,6488,7,8,6,10,28,29,-1,30
Randers FC,6488,8,5,7,12,24,40,-16,22
AGF Aarhus,6488,9,5,6,11,18,36,-18,21
Lyngby,6488,10,3,10,11,27,45,-18,19
Silkeborg IF,6488,11,5,3,14,25,46,-21,18
Brondby,6489,1,20,6,4,75,34,41,66
FC Midtjylla,6489,2,18,7,5,63,41,22,61
FC Nords,6489,3,15,6,9,76,52,24,51
Copenhagen,6489,4,14,5,11,59,51,8,47
AaB,6489,5,8,12,10,40,41,-1,36
AC Horsens,6489,6,6,14,10,35,55,-20,32
Sonderjyske,6489,7,8,6,10,28,29,-1,30
Silkeborg IF,6489,8,6,3,13,28,45,-17,21
Lyngby,6489,9,4,9,11,27,44,-17,21
Randers FC,6489,10,5,6,13,23,40,-17,21
AGF Aarhus,6489,11,4,6,12,17,39,-22,18
Brondby,6490,1,22,6,2,73,28,45,72
FC Midtjylla,6490,2,20,5,5,64,37,27,65
Copenhagen,6490,3,14,6,10,57,42,15,48
FC Nords,6490,4,13,7,10,68,54,14,46
AaB,6490,5,7,12,11,41,47,-6,33
Sonderjyske,6490,6,8,6,10,28,29,-1,30
AC Horsens,6490,7,5,14,11,34,55,-21,29
Randers FC,6490,8,6,6,12,24,39,-15,24
Silkeborg IF,6490,9,6,3,13,26,44,-18,21
Lyngby,6490,10,3,9,12,26,45,-19,18
AGF Aarhus,6490,11,4,6,12,16,37,-21,18
Brondby,6491,1,20,8,2,70,28,42,68
FC Midtjylla,6491,2,20,4,6,65,43,22,64
FC Nords,6491,3,15,8,7,75,49,26,53
Copenhagen,6491,4,13,6,11,55,43,12,45
AaB,6491,5,8,12,10,39,41,-2,36
Sonderjyske,6491,6,8,6,10,28,29,-1,30
AC Horsens,6491,7,5,12,13,33,59,-26,27
Randers FC,6491,8,6,6,12,26,39,-13,24
Silkeborg IF,6491,9,6,3,13,27,45,-18,21
Lyngby,6491,10,3,9,12,26,47,-21,18
AGF Aarhus,6491,11,4,6,12,17,38,-21,18
Brondby,6492,1,20,5,5,73,39,34,65
FC Midtjylla,6492,2,19,5,6,68,40,28,62
FC Nords,6492,3,16,6,8,77,50,27,54
Copenhagen,6492,4,14,5,11,60,50,10,47
AaB,6492,5,9,12,9,40,42,-2,39
Sonderjyske,6492,6,8,6,10,28,29,-1,30
AC Horsens,6492,7,5,13,12,37,60,-23,28
Lyngby,6492,8,4,9,11,29,45,-16,21
Silkeborg IF,6492,9,6,3,13,28,45,-17,21
Randers FC,6492,10,5,6,13,24,42,-18,21
AGF Aarhus,6492,11,4,6,12,17,39,-22,18
Brondby,6493,1,21,6,3,68,28,40,69
FC Midtjylla,6493,2,21,4,5,67,38,29,67
FC Nords,6493,3,14,7,9,73,52,21,49
Copenhagen,6493,4,13,4,13,54,48,6,43
AC Horsens,6493,5,7,13,10,36,50,-14,34
AaB,6493,6,7,12,11,34,42,-8,33
Sonderjyske,6493,7,8,6,10,28,29,-1,30
Silkeborg IF,6493,8,6,3,13,30,45,-15,21
Lyngby,6493,9,4,9,11,27,44,-17,21
Randers FC,6493,10,5,6,13,23,40,-17,21
AGF Aarhus,6493,11,4,6,12,17,41,-24,18
Brondby,6494,1,20,5,5,69,34,35,65
FC Midtjylla,6494,2,18,6,6,64,41,23,60
FC Nords,6494,3,16,6,8,83,50,33,54
Copenhagen,6494,4,14,6,10,56,42,14,48
AC Horsens,6494,5,7,13,10,35,54,-19,34
AaB,6494,6,7,12,11,34,46,-12,33
Sonderjyske,6494,7,8,6,10,28,29,-1,30
Randers FC,6494,8,6,6,12,24,39,-15,24
Silkeborg IF,6494,9,5,4,13,26,45,-19,19
AGF Aarhus,6494,10,4,7,11,17,37,-20,19
Lyngby,6494,11,3,9,12,26,45,-19,18
Brondby,6495,1,21,6,3,75,36,39,69
FC Midtjylla,6495,2,20,4,6,71,45,26,64
FC Nords,6495,3,14,6,10,82,58,24,48
Copenhagen,6495,4,14,4,12,59,50,9,46
AaB,6495,5,8,11,11,39,45,-6,35
AC Horsens,6495,6,7,13,10,39,57,-18,34
Sonderjyske,6495,7,8,6,10,28,29,-1,30
Randers FC,6495,8,5,7,12,23,39,-16,22
Silkeborg IF,6495,9,6,3,13,29,44,-15,21
Lyngby,6495,10,3,10,11,26,44,-18,19
AGF Aarhus,6495,11,4,6,12,16,40,-24,18
Brondby,6496,1,21,6,3,76,37,39,69
FC Midtjylla,6496,2,20,6,4,67,38,29,66
FC Nords,6496,3,14,6,10,75,58,17,48
Copenhagen,6496,4,12,5,13,54,48,6,41
AaB,6496,5,9,13,8,42,40,2,40
Sonderjyske,6496,6,8,6,10,28,29,-1,30
AC Horsens,6496,7,5,14,11,33,52,-19,29
Randers FC,6496,8,6,6,12,24,39,-15,24
Silkeborg IF,6496,9,6,3,13,27,44,-17,21
Lyngby,6496,10,3,9,12,26,45,-19,18
AGF Aarhus,6496,11,4,6,12,16,38,-22,18
Brondby,6497,1,21,5,4,71,35,36,68
FC Midtjylla,6497,2,21,5,4,73,38,35,68
FC Nords,6497,3,14,7,9,71,51,20,49
Copenhagen,6497,4,12,8,10,58,48,10,44
AaB,6497,5,7,12,11,38,44,-6,33
AC Horsens,6497,6,6,13,11,34,55,-21,31
Sonderjyske,6497,7,8,6,10,28,29,-1,30
Randers FC,6497,8,5,7,12,24,40,-16,22
Silkeborg IF,6497,9,6,3,13,27,45,-18,21
Lyngby,6497,10,3,10,11,27,45,-18,19
AGF Aarhus,6497,11,4,6,12,17,38,-21,18
Brondby,6498,1,20,7,3,70,33,37,67
FC Midtjylla,6498,2,19,4,7,67,43,24,61
Copenhagen,6498,3,14,5,11,59,49,10,47
FC Nords,6498,4,13,7,10,75,55,20,46
AaB,6498,5,9,13,8,39,40,-1,40
AC Horsens,6498,6,7,12,11,34,50,-16,33
Sonderjyske,6498,7,8,6,10,28,29,-1,30
Silkeborg IF,6498,8,6,3,13,28,45,-17,21
Lyngby,6498,9,4,9,11,27,44,-17,21
Randers FC,6498,10,5,6,13,23,40,-17,21
AGF Aarhus,6498,11,4,6,12,17,39,-22,18
Brondby,6499,1,21,7,2,73,33,40,70
FC Midtjylla,6499,2,19,6,5,63,38,25,63
FC Nords,6499,3,14,6,10,73,53,20,48
Copenhagen,6499,4,12,5,13,57,51,6,41
AaB,6499,5,10,11,9,43,40,3,41
AC Horsens,6499,6,6,13,11,37,57,-20,31
Sonderjyske,6499,7,8,6,10,28,29,-1,30
Silkeborg IF,6499,8,6,3,13,29,44,-15,21
Lyngby,6499,9,4,9,11,27,44,-17,21
Randers FC,6499,10,5,6,13,23,40,-17,21
AGF Aarhus,6499,11,4,6,12,16,40,-24,18
Brondby,6500,1,20,6,4,71,35,36,66
FC Midtjylla,6500,2,20,6,4,66,38,28,66
FC Nords,6500,3,15,6,9,78,50,28,51
Copenhagen,6500,4,14,7,9,57,42,15,49
AC Horsens,6500,5,6,13,11,35,58,-23,31
Sonderjyske,6500,6,8,6,10,28,29,-1,30
AaB,6500,7,6,12,12,35,45,-10,30
Randers FC,6500,8,5,7,12,23,39,-16,22
Lyngby,6500,9,3,10,11,26,44,-18,19
Silkeborg IF,6500,10,5,4,13,27,46,-19,19
AGF Aarhus,6500,11,4,7,11,18,38,-20,19
Brondby,6501,1,21,6,3,71,32,39,69
FC Midtjylla,6501,2,19,5,6,65,42,23,62
FC Nords,6501,3,14,8,8,73,49,24,50
Copenhagen,6501,4,15,5,10,60,44,16,50
AaB,6501,5,7,13,10,37,41,-4,34
Sonderjyske,6501,6,8,6,10,28,29,-1,30
AC Horsens,6501,7,5,13,12,34,58,-24,28
Randers FC,6501,8,6,6,12,25,40,-15,24
Silkeborg IF,6501,9,5,4,13,28,47,-19,19
AGF Aarhus,6501,10,4,7,11,19,39,-20,19
Lyngby,6501,11,3,9,12,27,46,-19,18
Brondby,6502,1,22,6,2,70,31,39,72
FC Midtjylla,6502,2,19,6,5,65,38,27,63
Copenhagen,6502,3,14,7,9,62,45,17,49
FC Nords,6502,4,13,7,10,75,56,19,46
AaB,6502,5,7,13,10,39,42,-3,34
Sonderjyske,6502,6,8,6,10,28,29,-1,30
AC Horsens,6502,7,5,13,12,34,59,-25,28
Lyngby,6502,8,4,9,11,29,44,-15,21
Silkeborg IF,6502,9,6,3,13,29,47,-18,21
Randers FC,6502,10,5,6,13,23,42,-19,21
AGF Aarhus,6502,11,4,6,12,19,40,-21,18
FC Midtjylla,6503,1,21,5,4,70,37,33,68
Brondby,6503,2,19,6,5,68,38,30,63
FC Nords,6503,3,14,6,10,73,56,17,48
Copenhagen,6503,4,13,6,11,59,45,14,45
AaB,6503,5,9,12,9,41,40,1,39
AC Horsens,6503,6,6,13,11,37,58,-21,31
Sonderjyske,6503,7,8,6,10,28,29,-1,30
Randers FC,6503,8,5,7,12,23,39,-16,22
Silkeborg IF,6503,9,6,3,13,27,45,-18,21
Lyngby,6503,10,3,10,11,26,44,-18,19
AGF Aarhus,6503,11,4,6,12,17,38,-21,18
Brondby,6504,1,20,5,5,66,32,34,65
FC Midtjylla,6504,2,20,4,6,64,40,24,64
FC Nords,6504,3,15,6,9,75,52,23,51
Copenhagen,6504,4,14,4,12,59,47,12,46
AC Horsens,6504,5,8,12,10,37,51,-14,36
AaB,6504,6,8,11,11,38,43,-5,35
Sonderjyske,6504,7,8,6,10,28,29,-1,30
Randers FC,6504,8,6,6,12,26,40,-14,24
Silkeborg IF,6504,9,6,3,13,26,44,-18,21
Lyngby,6504,10,3,9,12,27,47,-20,18
AGF Aarhus,6504,11,4,6,12,16,37,-21,18
FC Midtjylla,6505,1,20,5,5,68,39,29,65
Brondby,6505,2,19,6,5,69,38,31,63
FC Nords,6505,3,17,6,7,80,48,32,57
Copenhagen,6505,4,13,5,12,58,48,10,44
AaB,6505,5,8,12,10,35,42,-7,36
Sonderjyske,6505,6,8,6,10,28,29,-1,30
AC Horsens,6505,7,6,12,12,35,56,-21,30
Randers FC,6505,8,6,6,12,24,39,-15,24
AGF Aarhus,6505,9,5,6,11,20,37,-17,21
Lyngby,6505,10,3,9,12,26,45,-19,18
Silkeborg IF,6505,11,5,3,14,26,48,-22,18
Brondby,6506,1,22,6,2,73,31,42,72
FC Midtjylla,6506,2,20,5,5,68,39,29,65
FC Nords,6506,3,15,8,7,85,52,33,53
Copenhagen,6506,4,13,5,12,58,54,4,44
AC Horsens,6506,5,6,13,11,36,60,-24,31
Sonderjyske,6506,6,8,6,10,28,29,-1,30
AaB,6506,7,6,11,13,37,47,-10,29
Lyngby,6506,8,4,9,11,29,45,-16,21
Randers FC,6506,9,5,6,13,24,42,-18,21
AGF Aarhus,6506,10,5,6,11,18,37,-19,21
Silkeborg IF,6506,11,5,3,14,26,46,-20,18
Brondby,6507,1,23,5,2,73,30,43,74
FC Midtjylla,6507,2,20,4,6,67,40,27,64
Copenhagen,6507,3,15,4,11,59,43,16,49
FC Nords,6507,4,13,6,11,74,58,16,45
AaB,6507,5,8,11,11,39,41,-2,35
Sonderjyske,6507,6,8,6,10,28,29,-1,30
AC Horsens,6507,7,6,12,12,32,58,-26,30
Randers FC,6507,8,5,7,12,23,39,-16,22
Silkeborg IF,6507,9,6,3,13,28,45,-17,21
Lyngby,6507,10,3,10,11,26,44,-18,19
AGF Aarhus,6507,11,4,6,12,17,39,-22,18
Brondby,6508,1,21,6,3,74,32,42,69
FC Midtjylla,6508,2,19,6,5,67,42,25,63
FC Nords,6508,3,15,7,8,71,52,19,52
Copenhagen,6508,4,14,4,12,57,45,12,46
AaB,6508,5,8,11,11,36,42,-6,35
Sonderjyske,6508,6,8,6,10,28,29,-1,30
AC Horsens,6508,7,5,14,11,36,54,-18,29
Randers FC,6508,8,6,6,12,24,39,-15,24
AGF Aarhus,6508,9,5,6,11,18,37,-19,21
Lyngby,6508,10,3,9,12,26,45,-19,18
Silkeborg IF,6508,11,5,3,14,26,46,-20,18
Brondby,6509,1,20,6,4,67,33,34,66
FC Midtjylla,6509,2,18,6,6,65,40,25,60
FC Nords,6509,3,14,8,8,74,51,23,50
Copenhagen,6509,4,15,4,11,59,45,14,49
AC Horsens,6509,5,8,12,10,35,49,-14,36
AaB,6509,6,7,12,11,38,46,-8,33
Sonderjyske,6509,7,8,6,10,28,29,-1,30
Lyngby,6509,8,4,9,11,29,45,-16,21
Silkeborg IF,6509,9,6,3,13,26,44,-18,21
Randers FC,6509,10,5,6,13,24,42,-18,21
AGF Aarhus,6509,11,4,6,12,16,37,-21,18
Brondby,6510,1,21,6,3,73,38,35,69
FC Midtjylla,6510,2,18,6,6,63,41,22,60
FC Nords,6510,3,16,6,8,79,54,25,54
Copenhagen,6510,4,15,5,10,63,43,20,50
AC Horsens,6510,5,6,13,11,35,54,-19,31
Sonderjyske,6510,6,8,6,10,28,29,-1,30
AaB,6510,7,6,12,12,36,45,-9,30
Randers FC,6510,8,5,7,12,24,40,-16,22
Silkeborg IF,6510,9,6,3,13,27,44,-17,21
Lyngby,6510,10,3,10,11,27,45,-18,19
AGF Aarhus,6510,11,4,6,12,16,38,-22,18
Brondby,6511,1,21,6,3,74,31,43,69
FC Midtjylla,6511,2,19,5,6,67,41,26,62
FC Nords,6511,3,15,7,8,75,53,22,52
Copenhagen,6511,4,16,4,10,60,43,17,52
AaB,6511,5,7,12,11,36,44,-8,33
Sonderjyske,6511,6,8,6,10,28,29,-1,30
AC Horsens,6511,7,5,12,13,33,59,-26,27
Lyngby,6511,8,4,9,11,27,44,-17,21
Silkeborg IF,6511,8,6,3,13,27,44,-17,21
Randers FC,6511,10,5,6,13,23,40,-17,21
AGF Aarhus,6511,11,4,6,12,16,38,-22,18
Brondby,6512,1,21,6,3,72,34,38,69
FC Midtjylla,6512,2,18,6,6,63,42,21,60
FC Nords,6512,3,15,8,7,74,50,24,53
Copenhagen,6512,4,13,6,11,57,45,12,45
AaB,6512,5,7,12,11,39,43,-4,33
AC Horsens,6512,6,7,12,11,38,55,-17,33
Sonderjyske,6512,7,8,6,10,28,29,-1,30
Randers FC,6512,8,5,7,12,24,40,-16,22
Silkeborg IF,6512,9,6,3,13,28,45,-17,21
Lyngby,6512,10,3,10,11,27,45,-18,19
AGF Aarhus,6512,11,4,6,12,17,39,-22,18
Brondby,6513,1,21,7,2,74,29,45,70
FC Midtjylla,6513,2,20,4,6,65,43,22,64
FC Nords,6513,3,13,9,8,69,48,21,48
Copenhagen,6513,4,14,5,11,59,45,14,47
AaB,6513,5,7,12,11,37,47,-10,33
AC Horsens,6513,6,6,13,11,33,51,-18,31
Sonderjyske,6513,7,8,6,10,28,29,-1,30
Randers FC,6513,8,6,6,12,26,41,-15,24
Silkeborg IF,6513,9,5,4,13,28,47,-19,19
AGF Aarhus,6513,10,4,7,11,19,39,-20,19
Lyngby,6513,11,3,9,12,28,47,-19,18
Brondby,6514,1,21,6,3,71,32,39,69
FC Midtjylla,6514,2,20,6,4,65,37,28,66
Copenhagen,6514,3,14,4,12,58,47,11,46
FC Nords,6514,4,13,6,11,68,52,16,45
AaB,6514,5,8,12,10,37,41,-4,36
AC Horsens,6514,6,7,12,11,34,50,-16,33
Sonderjyske,6514,7,8,6,10,28,29,-1,30
Randers FC,6514,8,5,7,12,25,41,-16,22
Lyngby,6514,9,3,10,11,28,46,-18,19
Silkeborg IF,6514,10,5,4,13,26,45,-19,19
AGF Aarhus,6514,11,4,7,11,17,37,-20,19
Brondby,6515,1,20,6,4,69,32,37,66
FC Midtjylla,6515,2,20,6,4,68,38,30,66
FC Nords,6515,3,15,7,8,72,50,22,52
Copenhagen,6515,4,13,5,12,56,47,9,44
AC Horsens,6515,5,7,13,10,34,49,-15,34
AaB,6515,6,6,13,11,35,44,-9,31
Sonderjyske,6515,7,8,6,10,28,29,-1,30
Lyngby,6515,8,4,9,11,29,45,-16,21
Silkeborg IF,6515,9,6,3,13,28,44,-16,21
Randers FC,6515,10,5,6,13,24,42,-18,21
AGF Aarhus,6515,11,4,6,12,16,39,-23,18
Brondby,6516,1,21,6,3,76,36,40,69
FC Midtjylla,6516,2,17,5,8,61,47,14,56
FC Nords,6516,3,15,7,8,75,51,24,52
Copenhagen,6516,4,14,4,12,64,49,15,46
AC Horsens,6516,5,8,14,8,39,50,-11,38
AaB,6516,6,7,12,11,38,46,-8,33
Sonderjyske,6516,7,8,6,10,28,29,-1,30
Randers FC,6516,8,6,6,12,26,41,-15,24
Silkeborg IF,6516,9,6,3,13,27,44,-17,21
Lyngby,6516,10,3,9,12,28,47,-19,18
AGF Aarhus,6516,11,4,6,12,16,38,-22,18
Brondby,6517,1,20,6,4,68,30,38,66
FC Midtjylla,6517,2,20,6,4,73,39,34,66
Copenhagen,6517,3,15,5,10,61,46,15,50
FC Nords,6517,4,14,6,10,72,54,18,48
AC Horsens,6517,5,7,12,11,34,55,-21,33
AaB,6517,6,7,11,12,37,47,-10,32
Sonderjyske,6517,7,8,6,10,28,29,-1,30
Randers FC,6517,8,6,6,12,25,40,-15,24
Silkeborg IF,6517,9,5,4,13,26,45,-19,19
AGF Aarhus,6517,10,4,7,11,17,37,-20,19
Lyngby,6517,11,3,9,12,27,46,-19,18
Brondby,6518,1,18,9,3,65,33,32,63
FC Midtjylla,6518,2,18,8,4,69,43,26,62
Copenhagen,6518,3,15,5,10,61,44,17,50
FC Nords,6518,4,13,9,8,74,52,22,48
AC Horsens,6518,5,6,15,9,37,53,-16,33
AaB,6518,6,6,14,10,36,43,-7,32
Sonderjyske,6518,7,8,6,10,28,29,-1,30
Lyngby,6518,8,4,9,11,28,45,-17,21
Randers FC,6518,9,5,6,13,24,41,-17,21
AGF Aarhus,6518,10,5,6,11,18,37,-19,21
Silkeborg IF,6518,11,5,3,14,26,46,-20,18
Brondby,6519,1,21,7,2,72,31,41,70
FC Midtjylla,6519,2,20,4,6,66,39,27,64
FC Nords,6519,3,15,7,8,81,51,30,52
Copenhagen,6519,4,14,5,11,56,46,10,47
AC Horsens,6519,5,7,12,11,34,56,-22,33
Sonderjyske,6519,6,8,6,10,28,29,-1,30
AaB,6519,7,6,11,13,35,47,-12,29
Randers FC,6519,8,6,6,12,25,40,-15,24
Silkeborg IF,6519,9,6,3,13,27,44,-17,21
Lyngby,6519,10,3,9,12,27,46,-19,18
AGF Aarhus,6519,11,4,6,12,16,38,-22,18
Brondby,6520,1,20,5,5,71,38,33,65
FC Midtjylla,6520,2,20,4,6,64,40,24,64
FC Nords,6520,3,15,6,9,75,55,20,51
Copenhagen,6520,4,14,4,12,56,43,13,46
AC Horsens,6520,5,8,12,10,45,56,-11,36
AaB,6520,6,8,11,11,37,42,-5,35
Sonderjyske,6520,7,8,6,10,28,29,-1,30
Randers FC,6520,8,6,6,12,26,40,-14,24
Silkeborg IF,6520,9,5,4,13,26,45,-19,19
AGF Aarhus,6520,10,4,7,11,17,37,-20,19
Lyngby,6520,11,3,9,12,27,47,-20,18
FC Midtjylla,6521,1,21,5,4,70,35,35,68
Brondby,6521,2,20,6,4,67,32,35,66
FC Nords,6521,3,13,8,9,71,52,19,47
Copenhagen,6521,4,13,6,11,58,48,10,45
AaB,6521,5,7,14,9,37,41,-4,35
AC Horsens,6521,6,6,13,11,34,55,-21,31
Sonderjyske,6521,7,8,6,10,28,29,-1,30
Lyngby,6521,8,4,9,11,28,44,-16,21
Randers FC,6521,9,5,6,13,23,41,-18,21
AGF Aarhus,6521,10,5,6,11,18,37,-19,21
Silkeborg IF,6521,11,5,3,14,26,46,-20,18
Brondby,6522,1,19,6,5,69,35,34,63
FC Midtjylla,6522,2,19,6,5,65,39,26,63
Copenhagen,6522,3,14,6,10,58,44,14,48
FC Nords,6522,4,13,8,9,70,49,21,47
AaB,6522,5,9,12,9,40,40,0,39
AC Horsens,6522,6,7,12,11,36,57,-21,33
Sonderjyske,6522,7,8,6,10,28,29,-1,30
Lyngby,6522,8,4,9,11,29,44,-15,21
Randers FC,6522,9,5,6,13,23,42,-19,21
Silkeborg IF,6522,10,5,4,13,25,44,-19,19
AGF Aarhus,6522,11,4,7,11,16,36,-20,19
Brondby,6523,1,21,6,3,71,31,40,69
FC Midtjylla,6523,2,18,7,5,63,41,22,61
FC Nords,6523,3,13,9,8,73,52,21,48
Copenhagen,6523,4,12,6,12,57,49,8,42
AaB,6523,5,8,12,10,38,43,-5,36
AC Horsens,6523,6,7,14,9,39,51,-12,35
Sonderjyske,6523,7,8,6,10,28,29,-1,30
Lyngby,6523,8,4,9,11,27,44,-17,21
Randers FC,6523,9,5,6,13,23,40,-17,21
Silkeborg IF,6523,10,5,4,13,26,45,-19,19
AGF Aarhus,6523,11,4,7,11,17,37,-20,19
Brondby,6524,1,21,7,2,77,35,42,70
FC Midtjylla,6524,2,18,7,5,65,42,23,61
FC Nords,6524,3,15,7,8,81,52,29,52
Copenhagen,6524,4,14,4,12,56,46,10,46
AaB,6524,5,7,13,10,41,50,-9,34
Sonderjyske,6524,6,8,6,10,28,29,-1,30
AC Horsens,6524,7,5,14,11,33,54,-21,29
Silkeborg IF,6524,8,6,3,13,29,45,-16,21
Lyngby,6524,9,4,9,11,28,44,-16,21
Randers FC,6524,10,5,6,13,23,41,-18,21
AGF Aarhus,6524,11,4,6,12,17,40,-23,18
FC Midtjylla,6525,1,22,4,4,70,35,35,70
Brondby,6525,2,20,6,4,71,36,35,66
FC Nords,6525,3,15,7,8,76,51,25,52
Copenhagen,6525,4,13,5,12,61,50,11,44
AaB,6525,5,8,11,11,35,43,-8,35
Sonderjyske,6525,6,8,6,10,28,29,-1,30
AC Horsens,6525,7,5,13,12,34,58,-24,28
Lyngby,6525,8,4,9,11,30,45,-15,21
Silkeborg IF,6525,9,6,3,13,27,44,-17,21
Randers FC,6525,10,5,6,13,24,43,-19,21
AGF Aarhus,6525,11,4,6,12,16,38,-22,18
Brondby,6526,1,21,6,3,75,33,42,69
FC Midtjylla,6526,2,20,4,6,71,39,32,64
FC Nords,6526,3,13,8,9,74,60,14,47
Copenhagen,6526,4,14,5,11,61,47,14,47
AaB,6526,5,8,11,11,36,48,-12,35
AC Horsens,6526,6,6,14,10,35,51,-16,32
Sonderjyske,6526,7,8,6,10,28,29,-1,30
Randers FC,6526,8,6,6,12,25,40,-15,24
Silkeborg IF,6526,9,5,4,13,25,44,-19,19
AGF Aarhus,6526,10,4,7,11,16,36,-20,19
Lyngby,6526,11,3,9,12,27,46,-19,18
Brondby,6527,1,23,5,2,78,29,49,74
FC Midtjylla,6527,2,18,5,7,61,45,16,59
Copenhagen,6527,3,15,5,10,57,42,15,50
FC Nords,6527,4,12,9,9,69,52,17,45
AC Horsens,6527,5,7,13,10,36,52,-16,34
AaB,6527,6,7,11,12,39,46,-7,32
Sonderjyske,6527,7,8,6,10,28,29,-1,30
Lyngby,6527,8,4,9,11,29,46,-17,21
Randers FC,6527,9,5,6,13,25,42,-17,21
Silkeborg IF,6527,10,5,4,13,25,44,-19,19
AGF Aarhus,6527,11,4,7,11,16,36,-20,19
Brondby,6528,1,22,6,2,76,33,43,72
FC Midtjylla,6528,2,20,5,5,70,37,33,65
FC Nords,6528,3,13,9,8,73,53,20,48
Copenhagen,6528,4,12,5,13,52,47,5,41
AaB,6528,5,8,11,11,39,44,-5,35
AC Horsens,6528,6,6,14,10,35,57,-22,32
Sonderjyske,6528,7,8,6,10,28,29,-1,30
Lyngby,6528,8,4,9,11,28,45,-17,21
Randers FC,6528,9,5,6,13,24,41,-17,21
Silkeborg IF,6528,10,6,3,13,27,45,-18,21
AGF Aarhus,6528,11,4,6,12,17,38,-21,18
Brondby,6529,1,20,6,4,69,33,36,66
FC Midtjylla,6529,2,19,7,4,66,38,28,64
FC Nords,6529,3,13,7,10,72,52,20,46
Copenhagen,6529,4,13,5,12,56,48,8,44
AC Horsens,6529,5,9,12,9,37,49,-12,39
AaB,6529,6,8,11,11,37,43,-6,35
Sonderjyske,6529,7,8,6,10,28,29,-1,30
Silkeborg IF,6529,8,6,3,13,29,45,-16,21
Lyngby,6529,9,4,9,11,30,47,-17,21
Randers FC,6529,10,5,6,13,26,43,-17,21
AGF Aarhus,6529,11,4,6,12,17,40,-23,18
Brondby,6530,1,22,5,3,71,31,40,71
FC Midtjylla,6530,2,19,5,6,64,39,25,62
FC Nords,6530,3,15,7,8,73,49,24,52
Copenhagen,6530,4,14,4,12,53,41,12,46
AaB,6530,5,8,11,11,36,41,-5,35
Sonderjyske,6530,6,8,6,10,28,29,-1,30
AC Horsens,6530,7,6,12,12,31,53,-22,30
Randers FC,6530,8,6,6,12,27,39,-12,24
Silkeborg IF,6530,9,6,3,13,28,46,-18,21
AGF Aarhus,6530,10,4,6,12,18,39,-21,18
Lyngby,6530,11,3,9,12,26,48,-22,18
FC Midtjylla,6531,1,21,5,4,69,37,32,68
Brondby,6531,2,20,5,5,69,32,37,65
FC Nords,6531,3,14,7,9,72,52,20,49
Copenhagen,6531,4,14,5,11,57,49,8,47
AaB,6531,5,7,12,11,36,43,-7,33
AC Horsens,6531,6,7,12,11,36,52,-16,33
Sonderjyske,6531,7,8,6,10,28,29,-1,30
Lyngby,6531,8,4,9,11,29,44,-15,21
Silkeborg IF,6531,9,6,3,13,27,44,-17,21
Randers FC,6531,10,5,6,13,23,42,-19,21
AGF Aarhus,6531,11,4,6,12,16,38,-22,18
Brondby,6532,1,21,6,3,73,35,38,69
FC Midtjylla,6532,2,20,5,5,71,41,30,65
FC Nords,6532,3,15,7,8,73,50,23,52
Copenhagen,6532,4,13,5,12,56,46,10,44
AaB,6532,5,7,12,11,41,50,-9,33
AC Horsens,6532,6,6,13,11,35,53,-18,31
Sonderjyske,6532,7,8,6,10,28,29,-1,30
Randers FC,6532,8,6,6,12,25,40,-15,24
AGF Aarhus,6532,9,5,6,11,17,36,-19,21
Lyngby,6532,10,3,9,12,27,46,-19,18
Silkeborg IF,6532,11,5,3,14,25,45,-20,18
FC Midtjylla,6533,1,20,5,5,72,37,35,65
Brondby,6533,2,20,5,5,66,32,34,65
FC Nords,6533,3,15,8,7,73,46,27,53
Copenhagen,6533,4,14,5,11,53,46,7,47
AaB,6533,5,7,12,11,36,48,-12,33
AC Horsens,6533,6,6,13,11,36,53,-17,31
Sonderjyske,6533,7,8,6,10,28,29,-1,30
Randers FC,6533,8,6,6,12,27,40,-13,24
AGF Aarhus,6533,9,5,6,11,18,37,-19,21
Silkeborg IF,6533,10,5,3,14,26,46,-20,18
Lyngby,6533,11,3,9,12,27,48,-21,18
Brondby,6534,1,21,7,2,77,30,47,70
FC Midtjylla,6534,2,20,6,4,72,38,34,66
FC Nords,6534,3,15,6,9,77,51,26,51
Copenhagen,6534,4,13,7,10,59,48,11,46
Sonderjyske,6534,5,8,6,10,28,29,-1,30
AaB,6534,6,6,12,12,35,50,-15,30
AC Horsens,6534,7,6,12,12,33,62,-29,30
Lyngby,6534,8,4,9,11,32,45,-13,21
Randers FC,6534,9,5,6,13,24,45,-21,21
Silkeborg IF,6534,10,5,4,13,27,46,-19,19
AGF Aarhus,6534,11,4,7,11,18,38,-20,19
FC Midtjylla,6535,1,21,5,4,68,38,30,68
Brondby,6535,2,19,8,3,66,31,35,65
Copenhagen,6535,3,14,5,11,57,45,12,47
FC Nords,6535,4,13,6,11,68,51,17,45
AaB,6535,5,8,13,9,41,43,-2,37
Sonderjyske,6535,6,8,6,10,28,29,-1,30
AC Horsens,6535,7,5,15,10,37,55,-18,30
Randers FC,6535,8,6,6,12,25,40,-15,24
Silkeborg IF,6535,9,5,4,13,26,45,-19,19
AGF Aarhus,6535,10,4,7,11,17,37,-20,19
Lyngby,6535,11,3,9,12,27,46,-19,18
Brondby,6536,1,22,5,3,72,31,41,71
FC Midtjylla,6536,2,19,5,6,62,38,24,62
FC Nords,6536,3,15,7,8,78,49,29,52
Copenhagen,6536,4,14,4,12,57,45,12,46
AaB,6536,5,7,12,11,35,45,-10,33
AC Horsens,6536,6,6,13,11,36,58,-22,31
Sonderjyske,6536,7,8,6,10,28,29,-1,30
Lyngby,6536,8,4,9,11,27,44,-17,21
Randers FC,6536,9,5,6,13,23,40,-17,21
AGF Aarhus,6536,10,5,6,11,18,36,-18,21
Silkeborg IF,6536,11,5,3,14,25,46,-21,18
Brondby,6537,1,19,8,3,68,33,35,65
FC Midtjylla,6537,2,19,4,7,64,42,22,61
Copenhagen,6537,3,16,5,9,62,44,18,53
FC Nords,6537,4,12,8,10,69,51,18,44
AC Horsens,6537,5,7,14,9,34,48,-14,35
AaB,6537,6,7,13,10,35,40,-5,34
Sonderjyske,6537,7,8,6,10,28,29,-1,30
Lyngby,6537,8,4,9,11,30,45,-15,21
Randers FC,6537,9,5,6,13,24,43,-19,21
AGF Aarhus,6537,10,5,6,11,17,36,-19,21
Silkeborg IF,6537,11,5,3,14,25,45,-20,18
FC Midtjylla,6538,1,19,6,5,66,40,26,63
Brondby,6538,2,18,7,5,67,35,32,61
FC Nords,6538,3,17,6,7,79,47,32,57
Copenhagen,6538,4,13,5,12,58,53,5,44
AaB,6538,5,9,12,9,41,39,2,39
Sonderjyske,6538,6,8,6,10,28,29,-1,30
AC Horsens,6538,7,6,12,12,32,55,-23,30
Randers FC,6538,8,5,7,12,26,42,-16,22
Lyngby,6538,9,3,10,11,29,47,-18,19
Silkeborg IF,6538,10,5,4,13,25,44,-19,19
AGF Aarhus,6538,11,4,7,11,16,36,-20,19
Brondby,6539,1,20,6,4,69,34,35,66
FC Midtjylla,6539,2,18,6,6,60,39,21,60
FC Nords,6539,3,15,6,9,76,52,24,51
Copenhagen,6539,4,15,4,11,58,48,10,49
AaB,6539,5,8,13,9,35,38,-3,37
AC Horsens,6539,6,6,13,11,39,52,-13,31
Sonderjyske,6539,7,8,6,10,28,29,-1,30
Randers FC,6539,8,5,7,12,24,40,-16,22
AGF Aarhus,6539,9,5,6,11,17,36,-19,21
Lyngby,6539,10,3,10,11,27,45,-18,19
Silkeborg IF,6539,11,5,3,14,25,45,-20,18
Brondby,6540,1,20,6,4,71,34,37,66
FC Midtjylla,6540,2,17,7,6,60,38,22,58
FC Nords,6540,3,14,7,9,70,50,20,49
Copenhagen,6540,4,13,4,13,56,47,9,43
AaB,6540,5,9,13,8,38,38,0,40
AC Horsens,6540,6,8,13,9,37,51,-14,37
Sonderjyske,6540,7,8,6,10,28,29,-1,30
Randers FC,6540,8,5,7,12,25,41,-16,22
AGF Aarhus,6540,9,5,6,11,18,37,-19,21
Lyngby,6540,10,3,10,11,28,46,-18,19
Silkeborg IF,6540,11,5,3,14,26,46,-20,18
Brondby,6541,1,20,7,3,71,35,36,67
FC Midtjylla,6541,2,20,4,6,69,38,31,64
FC Nords,6541,3,14,7,9,75,57,18,49
Copenhagen,6541,4,12,7,11,56,48,8,43
AaB,6541,5,9,12,9,39,41,-2,39
AC Horsens,6541,6,6,13,11,36,53,-17,31
Sonderjyske,6541,7,8,6,10,28,29,-1,30
Randers FC,6541,8,5,7,12,23,39,-16,22
AGF Aarhus,6541,9,5,6,11,19,37,-18,21
Lyngby,6541,10,3,10,11,26,44,-18,19
Silkeborg IF,6541,11,5,3,14,26,47,-21,18
Brondby,6542,1,21,6,3,73,31,42,69
FC Midtjylla,6542,2,21,4,5,64,38,26,67
FC Nords,6542,3,13,7,10,72,57,15,46
Copenhagen,6542,4,13,5,12,58,46,12,44
AaB,6542,5,8,12,10,37,42,-5,36
AC Horsens,6542,6,6,14,10,36,52,-16,32
Sonderjyske,6542,7,8,6,10,28,29,-1,30
Randers FC,6542,8,6,6,12,26,40,-14,24
Silkeborg IF,6542,9,6,3,13,28,45,-17,21
Lyngby,6542,10,3,9,12,27,47,-20,18
AGF Aarhus,6542,11,4,6,12,17,39,-22,18
Brondby,6543,1,21,5,4,69,30,39,68
FC Midtjylla,6543,2,20,5,5,67,39,28,65
Copenhagen,6543,3,16,5,9,61,43,18,53
FC Nords,6543,4,15,6,9,75,52,23,51
Sonderjyske,6543,5,8,6,10,28,29,-1,30
AC Horsens,6543,6,6,12,12,36,55,-19,30
AaB,6543,7,6,11,13,34,49,-15,29
Randers FC,6543,8,5,7,12,24,40,-16,22
Silkeborg IF,6543,9,6,3,13,26,44,-18,21
Lyngby,6543,10,3,10,11,27,45,-18,19
AGF Aarhus,6543,11,4,6,12,16,37,-21,18
Brondby,6544,1,22,5,3,77,30,47,71
FC Midtjylla,6544,2,20,4,6,68,42,26,64
FC Nords,6544,3,15,6,9,74,48,26,51
Copenhagen,6544,4,14,5,11,62,50,12,47
AaB,6544,5,7,11,12,40,52,-12,32
AC Horsens,6544,6,6,13,11,35,60,-25,31
Sonderjyske,6544,7,8,6,10,28,29,-1,30
Randers FC,6544,8,5,7,12,24,40,-16,22
AGF Aarhus,6544,9,5,6,11,19,36,-17,21
Lyngby,6544,10,3,10,11,27,45,-18,19
Silkeborg IF,6544,11,5,3,14,25,47,-22,18
Brondby,6545,1,22,5,3,70,33,37,71
FC Midtjylla,6545,2,19,4,7,66,39,27,61
FC Nords,6545,3,16,7,7,78,47,31,55
Copenhagen,6545,4,13,4,13,57,49,8,43
AaB,6545,5,8,12,10,38,45,-7,36
Sonderjyske,6545,6,8,6,10,28,29,-1,30
AC Horsens,6545,7,6,12,12,35,57,-22,30
Lyngby,6545,8,4,9,11,27,44,-17,21
Randers FC,6545,9,5,6,13,23,40,-17,21
Silkeborg IF,6545,10,6,3,13,26,44,-18,21
AGF Aarhus,6545,11,4,6,12,16,37,-21,18
Brondby,6546,1,20,7,3,69,31,38,67
FC Midtjylla,6546,2,20,5,5,66,39,27,65
Copenhagen,6546,3,14,5,11,57,42,15,47
FC Nords,6546,4,13,7,10,70,50,20,46
AaB,6546,5,9,11,10,37,43,-6,38
AC Horsens,6546,6,6,13,11,33,53,-20,31
Sonderjyske,6546,7,8,6,10,28,29,-1,30
Randers FC,6546,8,6,6,12,27,40,-13,24
Silkeborg IF,6546,9,6,3,13,28,46,-18,21
Lyngby,6546,10,3,9,12,27,48,-21,18
AGF Aarhus,6546,11,4,6,12,18,39,-21,18
Brondby,6547,1,22,5,3,73,30,43,71
FC Midtjylla,6547,2,19,6,5,63,35,28,63
Copenhagen,6547,3,14,6,10,54,40,14,48
FC Nords,6547,4,12,9,9,71,53,18,45
AaB,6547,5,8,12,10,36,45,-9,36
Sonderjyske,6547,6,8,6,10,28,29,-1,30
AC Horsens,6547,7,5,14,11,34,54,-20,29
Randers FC,6547,8,5,7,12,24,40,-16,22
Lyngby,6547,9,3,10,11,27,45,-18,19
Silkeborg IF,6547,10,5,4,13,27,46,-19,19
AGF Aarhus,6547,11,4,7,11,18,38,-20,19
Brondby,6548,1,21,5,4,70,32,38,68
FC Midtjylla,6548,2,20,5,5,68,39,29,65
FC Nords,6548,3,14,6,10,70,53,17,48
Copenhagen,6548,4,14,5,11,57,46,11,47
AaB,6548,5,7,13,10,37,41,-4,34
AC Horsens,6548,6,7,12,11,34,51,-17,33
Sonderjyske,6548,7,8,6,10,28,29,-1,30
Lyngby,6548,8,4,9,11,30,46,-16,21
Randers FC,6548,9,5,6,13,25,43,-18,21
Silkeborg IF,6548,10,5,4,13,26,45,-19,19
AGF Aarhus,6548,11,4,7,11,17,37,-20,19
Brondby,6549,1,21,7,2,74,30,44,70
FC Midtjylla,6549,2,17,7,6,64,42,22,58
FC Nords,6549,3,14,9,7,75,50,25,51
Copenhagen,6549,4,13,4,13,56,49,7,43
AaB,6549,5,9,12,9,36,42,-6,39
AC Horsens,6549,6,6,13,11,34,52,-18,31
Sonderjyske,6549,7,8,6,10,28,29,-1,30
Lyngby,6549,8,4,9,11,29,44,-15,21
Randers FC,6549,9,5,6,13,23,42,-19,21
Silkeborg IF,6549,10,5,4,13,26,45,-19,19
AGF Aarhus,6549,11,4,7,11,17,37,-20,19
Brondby,6550,1,22,5,3,77,34,43,71
FC Midtjylla,6550,2,18,5,7,61,43,18,59
FC Nords,6550,3,15,7,8,74,51,23,52
Copenhagen,6550,4,15,5,10,61,44,17,50
AaB,6550,5,7,11,12,38,45,-7,32
AC Horsens,6550,6,6,13,11,35,55,-20,31
Sonderjyske,6550,7,8,6,10,28,29,-1,30
Randers FC,6550,8,6,6,12,24,39,-15,24
AGF Aarhus,6550,9,5,6,11,18,36,-18,21
Lyngby,6550,10,3,9,12,26,45,-19,18
Silkeborg IF,6550,11,5,3,14,25,46,-21,18
FC Midtjylla,6551,1,21,5,4,69,33,36,68
Brondby,6551,2,20,5,5,71,37,34,65
FC Nords,6551,3,13,8,9,74,55,19,47
Copenhagen,6551,4,14,5,11,56,46,10,47
AC Horsens,6551,5,8,13,9,40,50,-10,37
Sonderjyske,6551,6,8,6,10,28,29,-1,30
AaB,6551,7,6,12,12,35,50,-15,30
Lyngby,6551,8,4,9,11,28,45,-17,21
Randers FC,6551,9,5,6,13,24,41,-17,21
Silkeborg IF,6551,10,6,3,13,27,45,-18,21
AGF Aarhus,6551,11,4,6,12,17,38,-21,18
Brondby,6552,1,20,6,4,67,33,34,66
FC Midtjylla,6552,2,20,5,5,64,37,27,65
FC Nords,6552,3,15,6,9,78,48,30,51
Copenhagen,6552,4,15,4,11,60,44,16,49
AaB,6552,5,7,12,11,35,46,-11,33
Sonderjyske,6552,6,8,6,10,28,29,-1,30
AC Horsens,6552,7,5,15,10,35,57,-22,30
Randers FC,6552,8,5,7,12,24,40,-16,22
Silkeborg IF,6552,9,6,3,13,27,45,-18,21
Lyngby,6552,10,3,10,11,27,45,-18,19
AGF Aarhus,6552,11,4,6,12,17,38,-21,18
Brondby,6553,1,20,7,3,67,31,36,67
FC Midtjylla,6553,2,19,6,5,67,39,28,63
FC Nords,6553,3,15,6,9,73,51,22,51
Copenhagen,6553,4,15,4,11,58,44,14,49
AaB,6553,5,7,13,10,34,39,-5,34
Sonderjyske,6553,6,8,6,10,28,29,-1,30
AC Horsens,6553,7,5,14,11,36,57,-21,29
Lyngby,6553,8,4,9,11,27,44,-17,21
Randers FC,6553,9,5,6,13,23,40,-17,21
AGF Aarhus,6553,10,5,6,11,18,37,-19,21
Silkeborg IF,6553,11,5,3,14,26,46,-20,18
Brondby,6554,1,20,6,4,71,34,37,66
FC Midtjylla,6554,2,20,5,5,63,39,24,65
Copenhagen,6554,3,16,5,9,64,44,20,53
FC Nords,6554,4,12,6,12,69,54,15,42
AC Horsens,6554,5,8,12,10,37,52,-15,36
AaB,6554,6,7,12,11,35,42,-7,33
Sonderjyske,6554,7,8,6,10,28,29,-1,30
Lyngby,6554,8,4,9,11,28,45,-17,21
Randers FC,6554,9,5,6,13,24,41,-17,21
Silkeborg IF,6554,10,5,4,13,26,45,-19,19
AGF Aarhus,6554,11,4,7,11,17,37,-20,19
Brondby,6555,1,21,6,3,70,32,38,69
FC Midtjylla,6555,2,19,4,7,64,41,23,61
FC Nords,6555,3,14,9,7,75,52,23,51
Copenhagen,6555,4,14,4,12,61,44,17,46
AaB,6555,5,8,13,9,42,45,-3,37
Sonderjyske,6555,6,8,6,10,28,29,-1,30
AC Horsens,6555,7,5,14,11,36,60,-24,29
Randers FC,6555,8,5,7,12,24,40,-16,22
Silkeborg IF,6555,9,6,3,13,28,44,-16,21
Lyngby,6555,10,3,10,11,27,45,-18,19
AGF Aarhus,6555,11,4,6,12,16,39,-23,18
Brondby,6556,1,20,6,4,69,33,36,66
FC Midtjylla,6556,2,19,6,5,63,38,25,63
FC Nords,6556,3,15,6,9,75,54,21,51
Copenhagen,6556,4,15,6,9,62,43,19,51
AaB,6556,5,6,13,11,36,48,-12,31
AC Horsens,6556,6,6,13,11,37,52,-15,31
Sonderjyske,6556,7,8,6,10,28,29,-1,30
Randers FC,6556,8,6,6,12,24,39,-15,24
AGF Aarhus,6556,9,5,6,11,19,37,-18,21
Lyngby,6556,10,3,9,12,26,45,-19,18
Silkeborg IF,6556,11,5,3,14,26,47,-21,18
Brondby,6557,1,21,6,3,71,34,37,69
FC Midtjylla,6557,2,21,4,5,68,34,34,67
Copenhagen,6557,3,15,4,11,60,45,15,49
FC Nords,6557,4,13,8,9,72,55,17,47
AaB,6557,5,8,11,11,38,46,-8,35
Sonderjyske,6557,6,8,6,10,28,29,-1,30
AC Horsens,6557,7,5,13,12,33,54,-21,28
Randers FC,6557,8,6,6,12,25,40,-15,24
AGF Aarhus,6557,9,5,6,11,18,37,-19,21
Lyngby,6557,10,3,9,12,27,46,-19,18
Silkeborg IF,6557,11,5,3,14,26,46,-20,18
Brondby,6558,1,21,7,2,68,30,38,70
FC Midtjylla,6558,2,19,5,6,68,40,28,62
FC Nords,6558,3,15,7,8,76,51,25,52
Copenhagen,6558,4,13,5,12,57,47,10,44
AaB,6558,5,8,11,11,35,46,-11,35
AC Horsens,6558,6,6,13,11,35,51,-16,31
Sonderjyske,6558,7,8,6,10,28,29,-1,30
Randers FC,6558,8,5,7,12,24,40,-16,22
AGF Aarhus,6558,9,5,6,11,17,36,-19,21
Lyngby,6558,10,3,10,11,27,45,-18,19
Silkeborg IF,6558,11,5,3,14,25,45,-20,18
FC Midtjylla,6559,1,21,4,5,65,36,29,67
Brondby,6559,2,19,7,4,69,32,37,64
FC Nords,6559,3,15,6,9,72,53,19,51
Copenhagen,6559,4,15,4,11,59,47,12,49
AaB,6559,5,7,12,11,39,44,-5,33
AC Horsens,6559,6,6,13,11,33,51,-18,31
Sonderjyske,6559,7,8,6,10,28,29,-1,30
Randers FC,6559,8,5,7,12,24,40,-16,22
Silkeborg IF,6559,9,6,3,13,28,44,-16,21
Lyngby,6559,10,3,10,11,27,45,-18,19
AGF Aarhus,6559,11,4,6,12,16,39,-23,18
Brondby,6560,1,21,7,2,72,32,40,70
FC Midtjylla,6560,2,20,4,6,67,40,27,64
FC Nords,6560,3,14,7,9,74,52,22,49
Copenhagen,6560,4,14,4,12,61,50,11,46
AC Horsens,6560,5,7,13,10,37,52,-15,34
AaB,6560,6,7,11,12,36,47,-11,32
Sonderjyske,6560,7,8,6,10,28,29,-1,30
Randers FC,6560,8,6,6,12,25,40,-15,24
Silkeborg IF,6560,9,5,4,13,27,46,-19,19
AGF Aarhus,6560,10,4,7,11,18,38,-20,19
Lyngby,6560,11,3,9,12,27,46,-19,18
Brondby,6561,1,21,5,4,71,36,35,68
FC Midtjylla,6561,2,20,5,5,66,40,26,65
FC Nords,6561,3,15,6,9,78,51,27,51
Copenhagen,6561,4,13,4,13,57,49,8,43
AaB,6561,5,7,13,10,41,45,-4,34
AC Horsens,6561,6,7,13,10,40,58,-18,34
Sonderjyske,6561,7,8,6,10,28,29,-1,30
Lyngby,6561,8,4,9,11,29,44,-15,21
Randers FC,6561,9,5,6,13,23,42,-19,21
Silkeborg IF,6561,10,5,4,13,25,44,-19,19
AGF Aarhus,6561,11,4,7,11,16,36,-20,19
Brondby,6562,1,20,6,4,70,33,37,66
FC Midtjylla,6562,2,20,4,6,67,40,27,64
Copenhagen,6562,3,16,4,10,65,47,18,52
FC Nords,6562,4,14,8,8,76,55,21,50
AaB,6562,5,6,13,11,38,47,-9,31
AC Horsens,6562,6,6,13,11,37,57,-20,31
Sonderjyske,6562,7,8,6,10,28,29,-1,30
Randers FC,6562,8,6,6,12,25,39,-14,24
AGF Aarhus,6562,9,5,6,11,19,36,-17,21
Lyngby,6562,10,3,9,12,26,46,-20,18
Silkeborg IF,6562,11,5,3,14,25,47,-22,18
Brondby,6563,1,22,5,3,72,30,42,71
FC Midtjylla,6563,2,20,5,5,64,37,27,65
FC Nords,6563,3,16,6,8,79,51,28,54
Copenhagen,6563,4,12,6,12,55,49,6,42
AaB,6563,5,6,13,11,36,46,-10,31
AC Horsens,6563,6,6,13,11,32,51,-19,31
Sonderjyske,6563,7,8,6,10,28,29,-1,30
Randers FC,6563,8,5,7,12,24,40,-16,22
Silkeborg IF,6563,9,6,3,13,28,44,-16,21
Lyngby,6563,10,3,10,11,27,45,-18,19
AGF Aarhus,6563,11,4,6,12,16,39,-23,18
Brondby,6564,1,21,6,3,71,33,38,69
FC Midtjylla,6564,2,18,6,6,70,44,26,60
Copenhagen,6564,3,16,5,9,60,40,20,53
FC Nords,6564,4,14,6,10,73,57,16,48
AaB,6564,5,8,12,10,40,45,-5,36
Sonderjyske,6564,6,8,6,10,28,29,-1,30
AC Horsens,6564,7,5,13,12,35,56,-21,28
Lyngby,6564,8,4,9,11,28,44,-16,21
Silkeborg IF,6564,9,6,3,13,28,46,-18,21
Randers FC,6564,10,5,6,13,23,41,-18,21
AGF Aarhus,6564,11,4,6,12,18,39,-21,18
Brondby,6565,1,23,5,2,74,30,44,74
FC Midtjylla,6565,2,19,4,7,65,44,21,61
Copenhagen,6565,3,15,4,11,60,44,16,49
FC Nords,6565,4,13,6,11,74,58,16,45
AaB,6565,5,8,11,11,38,41,-3,35
AC Horsens,6565,6,7,12,11,33,53,-20,33
Sonderjyske,6565,7,8,6,10,28,29,-1,30
Randers FC,6565,8,6,6,12,26,40,-14,24
Silkeborg IF,6565,9,5,4,13,26,45,-19,19
AGF Aarhus,6565,10,4,7,11,17,37,-20,19
Lyngby,6565,11,3,9,12,27,47,-20,18
Brondby,6566,1,20,8,2,72,34,38,68
FC Midtjylla,6566,2,21,5,4,72,38,34,68
FC Nords,6566,3,13,8,9,76,55,21,47
Copenhagen,6566,4,12,6,12,59,50,9,42
AC Horsens,6566,5,7,13,10,38,57,-19,34
AaB,6566,6,7,12,11,37,46,-9,33
Sonderjyske,6566,7,8,6,10,28,29,-1,30
Randers FC,6566,8,6,6,12,26,39,-13,24
Silkeborg IF,6566,9,5,4,13,26,45,-19,19
AGF Aarhus,6566,10,4,7,11,17,37,-20,19
Lyngby,6566,11,3,9,12,26,47,-21,18
Brondby,6567,1,21,5,4,67,29,38,68
FC Midtjylla,6567,2,18,5,7,63,39,24,59
FC Nords,6567,3,14,6,10,68,50,18,48
Copenhagen,6567,4,13,5,12,53,42,11,44
AC Horsens,6567,5,9,12,9,39,52,-13,39
AaB,6567,6,9,11,10,35,39,-4,38
Sonderjyske,6567,7,8,6,10,28,29,-1,30
Lyngby,6567,8,4,9,11,30,47,-17,21
Randers FC,6567,9,5,6,13,26,43,-17,21
Silkeborg IF,6567,10,5,4,13,26,45,-19,19
AGF Aarhus,6567,11,4,7,11,17,37,-20,19
Brondby,6568,1,20,6,4,70,36,34,66
FC Midtjylla,6568,2,18,8,4,65,37,28,62
FC Nords,6568,3,13,7,10,76,57,19,46
Copenhagen,6568,4,13,5,12,54,46,8,44
AaB,6568,5,10,12,8,40,39,1,42
AC Horsens,6568,6,6,14,10,33,49,-16,32
Sonderjyske,6568,7,8,6,10,28,29,-1,30
Randers FC,6568,8,6,6,12,26,39,-13,24
Silkeborg IF,6568,9,6,3,13,27,45,-18,21
Lyngby,6568,10,3,9,12,26,47,-21,18
AGF Aarhus,6568,11,4,6,12,17,38,-21,18
Brondby,6569,1,20,7,3,69,31,38,67
FC Midtjylla,6569,2,21,4,5,69,39,30,67
FC Nords,6569,3,13,9,8,72,51,21,48
Copenhagen,6569,4,13,6,11,55,43,12,45
AaB,6569,5,8,12,10,35,42,-7,36
Sonderjyske,6569,6,8,6,10,28,29,-1,30
AC Horsens,6569,7,5,14,11,32,52,-20,29
Lyngby,6569,8,4,9,11,28,45,-17,21
Randers FC,6569,9,5,6,13,24,41,-17,21
AGF Aarhus,6569,10,5,6,11,18,36,-18,21
Silkeborg IF,6569,11,5,3,14,25,46,-21,18
Brondby,6570,1,21,5,4,74,34,40,68
FC Midtjylla,6570,2,18,4,8,62,36,26,58
FC Nords,6570,3,15,7,8,72,51,21,52
Copenhagen,6570,4,14,4,12,59,47,12,46
AaB,6570,5,9,13,8,38,38,0,40
AC Horsens,6570,6,6,13,11,33,58,-25,31
Sonderjyske,6570,7,8,6,10,28,29,-1,30
Silkeborg IF,6570,8,6,3,13,29,44,-15,21
Lyngby,6570,9,4,9,11,27,44,-17,21
Randers FC,6570,10,5,6,13,23,40,-17,21
AGF Aarhus,6570,11,4,6,12,16,40,-24,18
Brondby,6571,1,20,5,5,64,37,27,65
FC Midtjylla,6571,2,19,6,5,67,37,30,63
FC Nords,6571,3,16,7,7,79,45,34,55
Copenhagen,6571,4,15,4,11,58,43,15,49
AaB,6571,5,7,11,12,36,46,-10,32
AC Horsens,6571,6,6,13,11,33,55,-22,31
Sonderjyske,6571,7,8,6,10,28,29,-1,30
Randers FC,6571,8,5,7,12,25,41,-16,22
Silkeborg IF,6571,9,6,3,13,27,44,-17,21
Lyngby,6571,10,3,10,11,28,46,-18,19
AGF Aarhus,6571,11,4,6,12,16,38,-22,18
Brondby,6572,1,21,5,4,68,34,34,68
FC Midtjylla,6572,2,19,4,7,67,43,24,61
FC Nords,6572,3,13,8,9,73,54,19,47
Copenhagen,6572,4,14,5,11,58,46,12,47
AaB,6572,5,8,12,10,40,44,-4,36
AC Horsens,6572,6,8,12,10,38,49,-11,36
Sonderjyske,6572,7,8,6,10,28,29,-1,30
Randers FC,6572,8,5,7,12,23,39,-16,22
AGF Aarhus,6572,9,5,6,11,17,36,-19,21
Lyngby,6572,10,3,10,11,26,44,-18,19
Silkeborg IF,6572,11,5,3,14,25,45,-20,18
Brondby,6573,1,21,7,2,74,33,41,70
FC Midtjylla,6573,2,19,5,6,64,41,23,62
FC Nords,6573,3,15,6,9,76,54,22,51
Copenhagen,6573,4,14,5,11,61,48,13,47
AaB,6573,5,7,12,11,36,45,-9,33
AC Horsens,6573,6,6,13,11,36,52,-16,31
Sonderjyske,6573,7,8,6,10,28,29,-1,30
Lyngby,6573,8,4,9,11,28,44,-16,21
Randers FC,6573,9,5,6,13,23,41,-18,21
Silkeborg IF,6573,10,5,4,13,26,45,-19,19
AGF Aarhus,6573,11,4,7,11,17,37,-20,19
FC Midtjylla,6574,1,20,5,5,64,37,27,65
Brondby,6574,2,18,7,5,65,33,32,61
FC Nords,6574,3,16,6,8,71,45,26,54
Copenhagen,6574,4,16,4,10,59,41,18,52
AC Horsens,6574,5,7,12,11,33,53,-20,33
Sonderjyske,6574,6,8,6,10,28,29,-1,30
AaB,6574,7,6,12,12,33,42,-9,30
Lyngby,6574,8,4,9,11,27,44,-17,21
Silkeborg IF,6574,8,6,3,13,27,44,-17,21
Randers FC,6574,10,5,6,13,23,40,-17,21
AGF Aarhus,6574,11,4,6,12,16,38,-22,18
FC Midtjylla,6575,1,20,4,6,66,38,28,64
Brondby,6575,2,18,8,4,65,35,30,62
Copenhagen,6575,3,15,5,10,61,44,17,50
FC Nords,6575,4,13,7,10,72,56,16,46
AaB,6575,5,7,14,9,39,42,-3,35
AC Horsens,6575,6,7,14,9,36,50,-14,35
Sonderjyske,6575,7,8,6,10,28,29,-1,30
Lyngby,6575,8,4,9,11,28,44,-16,21
Silkeborg IF,6575,8,6,3,13,28,44,-16,21
Randers FC,6575,10,5,6,13,23,41,-18,21
AGF Aarhus,6575,11,4,6,12,16,39,-23,18
Brondby,6576,1,21,5,4,68,32,36,68
FC Midtjylla,6576,2,19,5,6,65,40,25,62
Copenhagen,6576,3,16,5,9,58,40,18,53
FC Nords,6576,4,14,7,9,71,52,19,49
AaB,6576,5,6,14,10,36,42,-6,32
Sonderjyske,6576,6,8,6,10,28,29,-1,30
AC Horsens,6576,7,5,14,11,34,52,-18,29
Randers FC,6576,8,5,7,12,25,41,-16,22
Silkeborg IF,6576,9,6,3,13,28,45,-17,21
Lyngby,6576,10,3,10,11,28,46,-18,19
AGF Aarhus,6576,11,4,6,12,17,39,-22,18
Brondby,6577,1,21,6,3,71,31,40,69
FC Midtjylla,6577,2,19,7,4,63,36,27,64
Copenhagen,6577,3,14,6,10,59,47,12,48
FC Nords,6577,4,12,8,10,74,56,18,44
AC Horsens,6577,5,7,13,10,33,50,-17,34
AaB,6577,6,7,12,11,38,44,-6,33
Sonderjyske,6577,7,8,6,10,28,29,-1,30
Randers FC,6577,8,6,6,12,24,39,-15,24
Silkeborg IF,6577,9,5,4,13,26,45,-19,19
AGF Aarhus,6577,10,4,7,11,17,37,-20,19
Lyngby,6577,11,3,9,12,26,45,-19,18
Brondby,6578,1,21,5,4,71,33,38,68
FC Midtjylla,6578,2,19,6,5,65,38,27,63
FC Nords,6578,3,15,8,7,73,47,26,53
Copenhagen,6578,4,13,6,11,58,48,10,45
AaB,6578,5,7,12,11,35,43,-8,33
AC Horsens,6578,6,6,13,11,33,52,-19,31
Sonderjyske,6578,7,8,6,10,28,29,-1,30
Randers FC,6578,8,6,6,12,26,40,-14,24
AGF Aarhus,6578,9,5,6,11,20,39,-19,21
Silkeborg IF,6578,10,5,3,14,28,48,-20,18
Lyngby,6578,11,3,9,12,27,47,-20,18
Brondby,6579,1,22,6,2,71,29,42,72
FC Midtjylla,6579,2,19,5,6,66,41,25,62
FC Nords,6579,3,15,6,9,75,53,22,51
Copenhagen,6579,4,13,4,13,55,48,7,43
AaB,6579,5,8,12,10,40,43,-3,36
AC Horsens,6579,6,6,13,11,34,53,-19,31
Sonderjyske,6579,7,8,6,10,28,29,-1,30
Lyngby,6579,8,4,9,11,29,44,-15,21
Silkeborg IF,6579,9,6,3,13,27,45,-18,21
Randers FC,6579,10,5,6,13,23,42,-19,21
AGF Aarhus,6579,11,4,6,12,17,38,-21,18
Brondby,6580,1,21,7,2,72,30,42,70
FC Midtjylla,6580,2,19,6,5,66,38,28,63
Copenhagen,6580,3,14,5,11,58,46,12,47
FC Nords,6580,4,13,6,11,70,52,18,45
AaB,6580,5,8,14,8,38,38,0,38
Sonderjyske,6580,6,8,6,10,28,29,-1,30
AC Horsens,6580,7,6,12,12,32,58,-26,30
Randers FC,6580,8,6,6,12,25,39,-14,24
Silkeborg IF,6580,9,5,4,13,25,44,-19,19
AGF Aarhus,6580,10,4,7,11,16,36,-20,19
Lyngby,6580,11,3,9,12,26,46,-20,18
Brondby,6581,1,22,5,3,76,31,45,71
FC Midtjylla,6581,2,19,6,5,68,40,28,63
FC Nords,6581,3,14,7,9,72,54,18,49
Copenhagen,6581,4,12,7,11,55,45,10,43
AaB,6581,5,8,13,9,42,48,-6,37
Sonderjyske,6581,6,8,6,10,28,29,-1,30
AC Horsens,6581,7,5,14,11,34,55,-21,29
Randers FC,6581,8,5,7,12,23,39,-16,22
Lyngby,6581,9,3,10,11,26,44,-18,19
Silkeborg IF,6581,10,5,4,13,28,47,-19,19
AGF Aarhus,6581,11,4,7,11,19,39,-20,19
FC Midtjylla,6582,1,21,5,4,74,39,35,68
Brondby,6582,2,20,6,4,75,37,38,66
FC Nords,6582,3,14,6,10,71,52,19,48
Copenhagen,6582,4,14,4,12,61,52,9,46
AaB,6582,5,9,11,10,38,43,-5,38
Sonderjyske,6582,6,8,6,10,28,29,-1,30
AC Horsens,6582,7,6,12,12,34,56,-22,30
Lyngby,6582,8,4,9,11,28,44,-16,21
Randers FC,6582,9,5,6,13,23,41,-18,21
Silkeborg IF,6582,10,5,4,13,26,45,-19,19
AGF Aarhus,6582,11,4,7,11,17,37,-20,19
Brondby,6583,1,21,6,3,70,31,39,69
FC Midtjylla,6583,2,20,5,5,71,43,28,65
FC Nords,6583,3,14,7,9,70,52,18,49
Copenhagen,6583,4,13,4,13,57,50,7,43
AaB,6583,5,9,11,10,42,40,2,38
AC Horsens,6583,6,6,13,11,30,50,-20,31
Sonderjyske,6583,7,8,6,10,28,29,-1,30
Lyngby,6583,8,4,9,11,31,47,-16,21
Randers FC,6583,9,5,6,13,26,44,-18,21
AGF Aarhus,6583,10,5,6,11,18,36,-18,21
Silkeborg IF,6583,11,5,3,14,25,46,-21,18
Brondby,6584,1,23,5,2,76,29,47,74
FC Midtjylla,6584,2,18,6,6,64,40,24,60
Copenhagen,6584,3,14,5,11,57,46,11,47
FC Nords,6584,4,13,7,10,69,52,17,46
AaB,6584,5,10,11,9,39,38,1,41
Sonderjyske,6584,6,8,6,10,28,29,-1,30
AC Horsens,6584,7,5,12,13,30,56,-26,27
Lyngby,6584,8,4,9,11,28,45,-17,21
Randers FC,6584,9,5,6,13,24,41,-17,21
Silkeborg IF,6584,10,5,4,13,27,46,-19,19
AGF Aarhus,6584,11,4,7,11,18,38,-20,19
Brondby,6585,1,20,6,4,65,30,35,66
FC Midtjylla,6585,2,19,7,4,61,33,28,64
FC Nords,6585,3,13,7,10,66,48,18,46
Copenhagen,6585,4,13,6,11,54,44,10,45
AC Horsens,6585,5,9,13,8,38,45,-7,40
AaB,6585,6,6,13,11,33,43,-10,31
Sonderjyske,6585,7,8,6,10,28,29,-1,30
Randers FC,6585,8,6,6,12,24,39,-15,24
Silkeborg IF,6585,9,6,3,13,27,44,-17,21
Lyngby,6585,10,3,9,12,26,45,-19,18
AGF Aarhus,6585,11,4,6,12,16,38,-22,18
Brondby,6586,1,22,5,3,79,29,50,71
FC Midtjylla,6586,2,19,6,5,67,41,26,63
FC Nords,6586,3,16,7,7,82,51,31,55
Copenhagen,6586,4,13,6,11,55,47,8,45
Sonderjyske,6586,5,8,6,10,28,29,-1,30
AaB,6586,6,6,12,12,34,54,-20,30
AC Horsens,6586,7,6,12,12,36,57,-21,30
Randers FC,6586,8,5,7,12,24,40,-16,22
Lyngby,6586,9,3,10,11,27,45,-18,19
Silkeborg IF,6586,10,5,4,13,26,45,-19,19
AGF Aarhus,6586,11,4,7,11,17,37,-20,19
Brondby,6587,1,20,7,3,74,38,36,67
FC Midtjylla,6587,2,18,7,5,69,45,24,61
Copenhagen,6587,3,15,5,10,64,46,18,50
FC Nords,6587,4,13,8,9,75,54,21,47
AC Horsens,6587,5,7,13,10,39,54,-15,34
AaB,6587,6,7,12,11,38,48,-10,33
Sonderjyske,6587,7,8,6,10,28,29,-1,30
Lyngby,6587,8,4,9,11,28,44,-16,21
Randers FC,6587,9,5,6,13,23,41,-18,21
Silkeborg IF,6587,10,5,4,13,28,47,-19,19
AGF Aarhus,6587,11,4,7,11,19,39,-20,19
Brondby,6588,1,22,5,3,72,31,41,71
FC Midtjylla,6588,2,19,4,7,62,39,23,61
FC Nords,6588,3,14,7,9,73,51,22,49
Copenhagen,6588,4,14,4,12,62,48,14,46
AaB,6588,5,9,11,10,39,41,-2,38
AC Horsens,6588,6,6,13,11,34,58,-24,31
Sonderjyske,6588,7,8,6,10,28,29,-1,30
Lyngby,6588,8,4,9,11,27,44,-17,21
Randers FC,6588,9,5,6,13,23,40,-17,21
AGF Aarhus,6588,10,5,6,11,18,37,-19,21
Silkeborg IF,6588,11,5,3,14,26,46,-20,18
Brondby,6589,1,21,6,3,73,31,42,69
FC Midtjylla,6589,2,19,5,6,65,40,25,62
FC Nords,6589,3,16,6,8,75,48,27,54
Copenhagen,6589,4,13,4,13,52,44,8,43
AC Horsens,6589,5,7,13,10,35,54,-19,34
AaB,6589,6,7,12,11,33,42,-9,33
Sonderjyske,6589,7,8,6,10,28,29,-1,30
Randers FC,6589,8,6,6,12,27,40,-13,24
Silkeborg IF,6589,9,5,4,13,28,47,-19,19
AGF Aarhus,6589,10,4,7,11,19,39,-20,19
Lyngby,6589,11,3,9,12,27,48,-21,18
Brondby,6590,1,21,6,3,73,32,41,69
FC Midtjylla,6590,2,19,4,7,63,37,26,61
FC Nords,6590,3,16,6,8,72,50,22,54
Copenhagen,6590,4,15,4,11,59,41,18,49
AaB,6590,5,7,11,12,33,45,-12,32
AC Horsens,6590,6,6,13,11,35,56,-21,31
Sonderjyske,6590,7,8,6,10,28,29,-1,30
Randers FC,6590,8,5,7,12,24,40,-16,22
Lyngby,6590,9,3,10,11,27,45,-18,19
Silkeborg IF,6590,10,5,4,13,27,46,-19,19
AGF Aarhus,6590,11,4,7,11,18,38,-20,19
Brondby,6591,1,19,6,5,68,35,33,63
FC Midtjylla,6591,2,19,5,6,69,41,28,62
FC Nords,6591,3,15,7,8,78,53,25,52
Copenhagen,6591,4,13,7,10,61,51,10,46
AC Horsens,6591,5,8,13,9,37,52,-15,37
AaB,6591,6,7,12,11,38,45,-7,33
Sonderjyske,6591,7,8,6,10,28,29,-1,30
Lyngby,6591,8,4,9,11,27,44,-17,21
Randers FC,6591,9,5,6,13,23,40,-17,21
Silkeborg IF,6591,10,6,3,13,26,44,-18,21
AGF Aarhus,6591,11,4,6,12,16,37,-21,18
Brondby,6592,1,19,8,3,72,33,39,65
FC Midtjylla,6592,2,18,6,6,64,45,19,60
FC Nords,6592,3,13,8,9,70,51,19,47
Copenhagen,6592,4,13,7,10,56,44,12,46
AC Horsens,6592,5,8,13,9,39,50,-11,37
AaB,6592,6,7,14,9,35,39,-4,35
Sonderjyske,6592,7,8,6,10,28,29,-1,30
Randers FC,6592,8,6,6,12,24,39,-15,24
AGF Aarhus,6592,9,5,6,11,18,37,-19,21
Lyngby,6592,10,3,9,12,26,45,-19,18
Silkeborg IF,6592,11,5,3,14,26,46,-20,18
Brondby,6593,1,22,5,3,74,32,42,71
FC Midtjylla,6593,2,20,5,5,69,41,28,65
Copenhagen,6593,3,14,5,11,57,45,12,47
FC Nords,6593,4,13,7,10,73,53,20,46
AaB,6593,5,7,12,11,35,45,-10,33
AC Horsens,6593,6,7,12,11,37,55,-18,33
Sonderjyske,6593,7,8,6,10,28,29,-1,30
Lyngby,6593,8,4,9,11,28,45,-17,21
Randers FC,6593,9,5,6,13,24,41,-17,21
AGF Aarhus,6593,10,5,6,11,17,36,-19,21
Silkeborg IF,6593,11,5,3,14,25,45,-20,18
Brondby,6594,1,21,6,3,72,33,39,69
FC Midtjylla,6594,2,19,6,5,66,39,27,63
Copenhagen,6594,3,14,6,10,57,44,13,48
FC Nords,6594,4,13,7,10,73,56,17,46
AaB,6594,5,7,14,9,37,41,-4,35
AC Horsens,6594,6,6,13,11,33,51,-18,31
Sonderjyske,6594,7,8,6,10,28,29,-1,30
Randers FC,6594,8,6,6,12,24,39,-15,24
AGF Aarhus,6594,9,5,6,11,20,36,-16,21
Lyngby,6594,10,3,9,12,26,45,-19,18
Silkeborg IF,6594,11,5,3,14,25,48,-23,18
Brondby,6595,1,21,5,4,68,32,36,68
FC Midtjylla,6595,2,20,4,6,69,42,27,64
FC Nords,6595,3,14,7,9,72,51,21,49
Copenhagen,6595,4,14,5,11,60,46,14,47
AaB,6595,5,8,12,10,35,38,-3,36
AC Horsens,6595,6,6,13,11,34,55,-21,31
Sonderjyske,6595,7,8,6,10,28,29,-1,30
Randers FC,6595,8,6,6,12,24,39,-15,24
AGF Aarhus,6595,9,5,6,11,19,36,-17,21
Lyngby,6595,10,3,9,12,26,45,-19,18
Silkeborg IF,6595,11,5,3,14,25,47,-22,18
Brondby,6596,1,20,6,4,67,32,35,66
FC Midtjylla,6596,2,19,5,6,63,36,27,62
FC Nords,6596,3,16,6,8,73,46,27,54
Copenhagen,6596,4,15,5,10,55,42,13,50
AC Horsens,6596,5,6,14,10,33,49,-16,32
Sonderjyske,6596,6,8,6,10,28,29,-1,30
AaB,6596,7,6,12,12,32,44,-12,30
Lyngby,6596,8,4,9,11,27,44,-17,21
Randers FC,6596,9,5,6,13,23,40,-17,21
Silkeborg IF,6596,10,6,3,13,27,45,-18,21
AGF Aarhus,6596,11,4,6,12,17,38,-21,18
Brondby,6597,1,21,5,4,72,33,39,68
FC Midtjylla,6597,2,18,4,8,64,44,20,58
FC Nords,6597,3,14,7,9,77,55,22,49
Copenhagen,6597,4,14,5,11,58,48,10,47
AaB,6597,5,8,12,10,39,44,-5,36
AC Horsens,6597,6,7,15,8,39,51,-12,36
Sonderjyske,6597,7,8,6,10,28,29,-1,30
Randers FC,6597,8,5,7,12,24,40,-16,22
Lyngby,6597,9,3,10,11,27,45,-18,19
Silkeborg IF,6597,10,5,4,13,26,45,-19,19
AGF Aarhus,6597,11,4,7,11,17,37,-20,19
Brondby,6598,1,21,5,4,78,39,39,68
FC Midtjylla,6598,2,18,4,8,65,46,19,58
Copenhagen,6598,3,16,4,10,68,47,21,52
FC Nords,6598,4,15,6,9,79,56,23,51
AaB,6598,5,9,11,10,41,45,-4,38
Sonderjyske,6598,6,8,6,10,28,29,-1,30
AC Horsens,6598,7,6,12,12,34,58,-24,30
Randers FC,6598,8,6,6,12,27,39,-12,24
Silkeborg IF,6598,9,6,3,13,28,45,-17,21
Lyngby,6598,10,3,9,12,26,48,-22,18
AGF Aarhus,6598,11,4,6,12,17,39,-22,18
Brondby,6599,1,20,7,3,67,31,36,67
FC Midtjylla,6599,2,17,7,6,60,41,19,58
Copenhagen,6599,3,16,5,9,63,39,24,53
FC Nords,6599,4,14,7,9,68,48,20,49
AaB,6599,5,7,14,9,36,40,-4,35
Sonderjyske,6599,6,8,6,10,28,29,-1,30
AC Horsens,6599,7,5,14,11,30,51,-21,29
Randers FC,6599,8,6,6,12,26,40,-14,24
Silkeborg IF,6599,9,5,4,13,26,45,-19,19
AGF Aarhus,6599,10,4,7,11,17,37,-20,19
Lyngby,6599,11,3,9,12,27,47,-20,18
FC Midtjylla,6600,1,22,4,4,68,34,34,70
Brondby,6600,2,20,7,3,72,32,40,67
FC Nords,6600,3,14,8,8,74,49,25,50
Copenhagen,6600,4,12,6,12,57,47,10,42
AaB,6600,5,7,12,11,35,45,-10,33
AC Horsens,6600,6,6,13,11,33,58,-25,31
Sonderjyske,6600,7,8,6,10,28,29,-1,30
Lyngby,6600,8,4,9,11,28,44,-16,21
Randers FC,6600,9,5,6,13,23,41,-18,21
Silkeborg IF,6600,10,5,4,13,26,45,-19,19
AGF Aarhus,6600,11,4,7,11,17,37,-20,19
Brondby,6601,1,22,6,2,71,28,43,72
FC Midtjylla,6601,2,20,5,5,63,35,28,65
Copenhagen,6601,3,14,5,11,56,43,13,47
FC Nords,6601,4,12,8,10,70,53,17,44
AaB,6601,5,8,12,10,37,44,-7,36
Sonderjyske,6601,6,8,6,10,28,29,-1,30
AC Horsens,6601,7,6,12,12,32,52,-20,30
Lyngby,6601,8,4,9,11,28,44,-16,21
Randers FC,6601,9,5,6,13,23,41,-18,21
Silkeborg IF,6601,10,5,4,13,26,45,-19,19
AGF Aarhus,6601,11,4,7,11,17,37,-20,19
FC Midtjylla,6602,1,20,6,4,70,37,33,66
Brondby,6602,2,19,7,4,67,36,31,64
FC Nords,6602,3,14,7,9,77,54,23,49
Copenhagen,6602,4,13,6,11,56,45,11,45
AaB,6602,5,10,12,8,39,38,1,42
Sonderjyske,6602,6,8,6,10,28,29,-1,30
AC Horsens,6602,7,5,12,13,33,58,-25,27
Randers FC,6602,8,5,7,12,23,39,-16,22
AGF Aarhus,6602,9,5,6,11,19,36,-17,21
Lyngby,6602,10,3,10,11,26,44,-18,19
Silkeborg IF,6602,11,5,3,14,25,47,-22,18
FC Midtjylla,6603,1,20,5,5,68,40,28,65
Brondby,6603,2,19,5,6,68,36,32,62
FC Nords,6603,3,16,7,7,75,48,27,55
Copenhagen,6603,4,14,4,12,58,46,12,46
AaB,6603,5,8,12,10,37,42,-5,36
AC Horsens,6603,6,6,13,11,35,55,-20,31
Sonderjyske,6603,7,8,6,10,28,29,-1,30
Lyngby,6603,8,4,9,11,29,46,-17,21
Randers FC,6603,9,5,6,13,25,42,-17,21
AGF Aarhus,6603,10,5,6,11,18,36,-18,21
Silkeborg IF,6603,11,5,3,14,25,46,-21,18
Brondby,6604,1,21,7,2,73,31,42,70
FC Midtjylla,6604,2,18,7,5,68,41,27,61
FC Nords,6604,3,14,8,8,75,53,22,50
Copenhagen,6604,4,12,8,10,58,47,11,44
AaB,6604,5,7,13,10,38,47,-9,34
AC Horsens,6604,6,6,13,11,36,55,-19,31
Sonderjyske,6604,7,8,6,10,28,29,-1,30
Randers FC,6604,8,6,6,12,26,41,-15,24
AGF Aarhus,6604,9,5,6,11,19,37,-18,21
Lyngby,6604,10,3,9,12,28,47,-19,18
Silkeborg IF,6604,11,5,3,14,26,47,-21,18
FC Midtjylla,6605,1,22,4,4,73,35,38,70
Brondby,6605,2,18,5,7,63,35,28,59
FC Nords,6605,3,14,7,9,69,50,19,49
Copenhagen,6605,4,13,6,11,55,46,9,45
AaB,6605,5,8,12,10,34,40,-6,36
AC Horsens,6605,6,8,12,10,35,49,-14,36
Sonderjyske,6605,7,8,6,10,28,29,-1,30
Lyngby,6605,8,4,9,11,29,44,-15,21
Randers FC,6605,9,5,6,13,23,42,-19,21
AGF Aarhus,6605,10,5,6,11,17,36,-19,21
Silkeborg IF,6605,11,5,3,14,25,45,-20,18
Brondby,6606,1,21,6,3,74,32,42,69
FC Midtjylla,6606,2,20,6,4,68,40,28,66
FC Nords,6606,3,14,8,8,76,52,24,50
Copenhagen,6606,4,13,7,10,57,46,11,46
Sonderjyske,6606,5,8,6,10,28,29,-1,30
AaB,6606,6,6,12,12,38,49,-11,30
AC Horsens,6606,7,5,15,10,33,53,-20,30
Randers FC,6606,8,6,6,12,26,40,-14,24
Silkeborg IF,6606,9,6,3,13,27,45,-18,21
Lyngby,6606,10,3,9,12,27,47,-20,18
AGF Aarhus,6606,11,4,6,12,17,38,-21,18
FC Midtjylla,6607,1,21,5,4,70,35,35,68
Brondby,6607,2,20,7,3,69,31,38,67
Copenhagen,6607,3,15,4,11,59,44,15,49
FC Nords,6607,4,13,8,9,69,50,19,47
AaB,6607,5,8,12,10,35,41,-6,36
Sonderjyske,6607,6,8,6,10,28,29,-1,30
AC Horsens,6607,7,5,12,13,31,58,-27,27
Randers FC,6607,8,6,6,12,27,42,-15,24
AGF Aarhus,6607,9,5,6,11,18,37,-19,21
Lyngby,6607,10,3,9,12,29,48,-19,18
Silkeborg IF,6607,11,5,3,14,26,46,-20,18
Brondby,6608,1,20,5,5,72,36,36,65
FC Midtjylla,6608,2,20,4,6,66,39,27,64
FC Nords,6608,3,14,8,8,74,50,24,50
Copenhagen,6608,4,14,6,10,61,46,15,48
AC Horsens,6608,5,7,13,10,37,55,-18,34
AaB,6608,6,6,14,10,36,46,-10,32
Sonderjyske,6608,7,8,6,10,28,29,-1,30
Randers FC,6608,8,6,6,12,25,40,-15,24
Silkeborg IF,6608,9,5,4,13,26,45,-19,19
AGF Aarhus,6608,10,4,7,11,17,37,-20,19
Lyngby,6608,11,3,9,12,27,46,-19,18
Brondby,6609,1,20,7,3,69,34,35,67
FC Midtjylla,6609,2,19,6,5,65,39,26,63
FC Nords,6609,3,16,6,8,74,51,23,54
Copenhagen,6609,4,15,4,11,59,43,16,49
AaB,6609,5,6,13,11,37,44,-7,31
Sonderjyske,6609,6,8,6,10,28,29,-1,30
AC Horsens,6609,7,5,14,11,34,53,-19,29
Randers FC,6609,8,6,6,12,25,40,-15,24
Silkeborg IF,6609,9,5,4,13,25,44,-19,19
AGF Aarhus,6609,10,4,7,11,16,36,-20,19
Lyngby,6609,11,3,9,12,27,46,-19,18
Brondby,6610,1,20,7,3,72,37,35,67
FC Midtjylla,6610,2,19,6,5,66,41,25,63
FC Nords,6610,3,15,6,9,78,49,29,51
Copenhagen,6610,4,12,7,11,54,46,8,43
AC Horsens,6610,5,7,14,9,35,49,-14,35
AaB,6610,6,7,12,11,38,47,-9,33
Sonderjyske,6610,7,8,6,10,28,29,-1,30
Lyngby,6610,8,4,9,11,28,44,-16,21
Randers FC,6610,9,5,6,13,23,41,-18,21
AGF Aarhus,6610,10,5,6,11,19,37,-18,21
Silkeborg IF,6610,11,5,3,14,26,47,-21,18
Brondby,6611,1,20,7,3,66,31,35,67
FC Midtjylla,6611,2,18,5,7,61,40,21,59
FC Nords,6611,3,15,7,8,69,46,23,52
Copenhagen,6611,4,16,4,10,62,43,19,52
AaB,6611,5,8,12,10,37,40,-3,36
Sonderjyske,6611,6,8,6,10,28,29,-1,30
AC Horsens,6611,7,5,13,12,31,52,-21,28
Silkeborg IF,6611,8,6,3,13,32,48,-16,21
Lyngby,6611,9,4,9,11,28,45,-17,21
Randers FC,6611,10,5,6,13,24,41,-17,21
AGF Aarhus,6611,11,4,6,12,20,43,-23,18
Brondby,6612,1,21,6,3,71,31,40,69
FC Midtjylla,6612,2,19,5,6,62,40,22,62
Copenhagen,6612,3,14,7,9,57,40,17,49
FC Nords,6612,4,13,6,11,69,53,16,45
AC Horsens,6612,5,7,14,9,38,52,-14,35
AaB,6612,6,7,12,11,35,42,-7,33
Sonderjyske,6612,7,8,6,10,28,29,-1,30
Randers FC,6612,8,6,6,12,25,39,-14,24
Silkeborg IF,6612,9,6,3,13,28,46,-18,21
Lyngby,6612,10,3,9,12,26,46,-20,18
AGF Aarhus,6612,11,4,6,12,18,39,-21,18
Brondby,6613,1,21,5,4,69,29,40,68
FC Midtjylla,6613,2,19,5,6,64,41,23,62
Copenhagen,6613,3,16,4,10,59,43,16,52
FC Nords,6613,4,14,6,10,72,52,20,48
AaB,6613,5,7,12,11,38,45,-7,33
AC Horsens,6613,6,7,12,11,36,54,-18,33
Sonderjyske,6613,7,8,6,10,28,29,-1,30
Lyngby,6613,8,4,9,11,29,45,-16,21
Silkeborg IF,6613,9,6,3,13,28,45,-17,21
Randers FC,6613,10,5,6,13,24,42,-18,21
AGF Aarhus,6613,11,4,6,12,17,39,-22,18
Brondby,6614,1,21,6,3,72,34,38,69
FC Midtjylla,6614,2,20,6,4,65,36,29,66
FC Nords,6614,3,14,9,7,75,50,25,51
Copenhagen,6614,4,13,6,11,58,47,11,45
AaB,6614,5,6,13,11,35,45,-10,31
Sonderjyske,6614,6,8,6,10,28,29,-1,30
AC Horsens,6614,7,6,12,12,34,53,-19,30
Lyngby,6614,8,4,9,11,27,44,-17,21
Randers FC,6614,9,5,6,13,23,40,-17,21
AGF Aarhus,6614,10,5,6,11,18,36,-18,21
Silkeborg IF,6614,11,5,3,14,25,46,-21,18
Brondby,6615,1,21,6,3,76,35,41,69
FC Midtjylla,6615,2,20,4,6,72,40,32,64
FC Nords,6615,3,15,6,9,75,58,17,51
Copenhagen,6615,4,13,6,11,58,48,10,45
AaB,6615,5,7,12,11,35,44,-9,33
AC Horsens,6615,6,6,14,10,40,57,-17,32
Sonderjyske,6615,7,8,6,10,28,29,-1,30
Lyngby,6615,8,4,9,11,29,46,-17,21
Randers FC,6615,9,5,6,13,25,42,-17,21
Silkeborg IF,6615,10,5,4,13,26,45,-19,19
AGF Aarhus,6615,11,4,7,11,17,37,-20,19
Brondby,6616,1,20,7,3,68,31,37,67
FC Midtjylla,6616,2,19,7,4,64,36,28,64
Copenhagen,6616,3,15,5,10,58,44,14,50
FC Nords,6616,4,13,9,8,73,49,24,48
AaB,6616,5,7,12,11,37,45,-8,33
Sonderjyske,6616,6,8,6,10,28,29,-1,30
AC Horsens,6616,7,5,14,11,35,56,-21,29
Lyngby,6616,8,4,9,11,29,45,-16,21
Randers FC,6616,9,5,6,13,24,42,-18,21
Silkeborg IF,6616,10,5,4,13,26,45,-19,19
AGF Aarhus,6616,11,4,7,11,17,37,-20,19
Brondby,6617,1,19,9,2,68,32,36,66
FC Midtjylla,6617,2,18,6,6,60,37,23,60
FC Nords,6617,3,15,7,8,76,50,26,52
Copenhagen,6617,4,14,6,10,57,45,12,48
AaB,6617,5,7,13,10,36,41,-5,34
AC Horsens,6617,6,6,13,11,32,50,-18,31
Sonderjyske,6617,7,8,6,10,28,29,-1,30
Randers FC,6617,8,6,6,12,24,39,-15,24
Silkeborg IF,6617,9,6,3,13,27,45,-18,21
Lyngby,6617,10,3,9,12,26,45,-19,18
AGF Aarhus,6617,11,4,6,12,17,38,-21,18
Brondby,6618,1,20,7,3,72,30,42,67
FC Midtjylla,6618,2,20,6,4,67,35,32,66
FC Nords,6618,3,12,9,9,69,56,13,45
Copenhagen,6618,4,13,6,11,57,46,11,45
AaB,6618,5,7,13,10,41,48,-7,34
AC Horsens,6618,6,7,13,10,36,53,-17,34
Sonderjyske,6618,7,8,6,10,28,29,-1,30
Lyngby,6618,8,4,9,11,28,45,-17,21
Randers FC,6618,9,5,6,13,24,41,-17,21
Silkeborg IF,6618,10,6,3,13,27,45,-18,21
AGF Aarhus,6618,11,4,6,12,17,38,-21,18
Brondby,6619,1,21,6,3,70,32,38,69
FC Midtjylla,6619,2,19,6,5,67,39,28,63
FC Nords,6619,3,15,8,7,80,52,28,53
Copenhagen,6619,4,14,4,12,56,46,10,46
AaB,6619,5,7,11,12,34,46,-12,32
AC Horsens,6619,6,6,13,11,39,57,-18,31
Sonderjyske,6619,7,8,6,10,28,29,-1,30
Randers FC,6619,8,6,6,12,25,40,-15,24
Silkeborg IF,6619,9,6,3,13,28,45,-17,21
Lyngby,6619,10,3,9,12,27,46,-19,18
AGF Aarhus,6619,11,4,6,12,17,39,-22,18
Brondby,6620,1,21,6,3,74,34,40,69
FC Midtjylla,6620,2,21,5,4,69,35,34,68
Copenhagen,6620,3,14,6,10,60,44,16,48
FC Nords,6620,4,13,6,11,73,56,17,45
AaB,6620,5,8,12,10,36,42,-6,36
Sonderjyske,6620,6,8,6,10,28,29,-1,30
AC Horsens,6620,7,5,13,12,33,60,-27,28
Randers FC,6620,8,5,7,12,24,40,-16,22
Lyngby,6620,9,3,10,11,27,45,-18,19
Silkeborg IF,6620,10,5,4,13,26,45,-19,19
AGF Aarhus,6620,11,4,7,11,17,37,-20,19
Brondby,6621,1,21,7,2,76,30,46,70
FC Midtjylla,6621,2,20,4,6,63,36,27,64
FC Nords,6621,3,14,8,8,73,52,21,50
Copenhagen,6621,4,12,8,10,57,46,11,44
AaB,6621,5,7,12,11,39,51,-12,33
AC Horsens,6621,6,6,13,11,33,52,-19,31
Sonderjyske,6621,7,8,6,10,28,29,-1,30
Silkeborg IF,6621,8,6,3,13,28,45,-17,21
Lyngby,6621,9,4,9,11,27,44,-17,21
Randers FC,6621,10,5,6,13,23,40,-17,21
AGF Aarhus,6621,11,4,6,12,17,39,-22,18
Brondby,6622,1,21,6,3,73,33,40,69
FC Midtjylla,6622,2,20,5,5,66,40,26,65
Copenhagen,6622,3,16,4,10,61,42,19,52
FC Nords,6622,4,13,6,11,70,53,17,45
AC Horsens,6622,5,7,12,11,35,53,-18,33
AaB,6622,6,7,11,12,35,45,-10,32
Sonderjyske,6622,7,8,6,10,28,29,-1,30
Lyngby,6622,8,4,9,11,29,44,-15,21
AGF Aarhus,6622,9,5,6,11,18,36,-18,21
Randers FC,6622,10,5,6,13,23,42,-19,21
Silkeborg IF,6622,11,5,3,14,25,46,-21,18
Brondby,6623,1,20,6,4,71,34,37,66
FC Midtjylla,6623,2,19,4,7,63,46,17,61
FC Nords,6623,3,15,7,8,75,49,26,52
Copenhagen,6623,4,14,6,10,62,45,17,48
AaB,6623,5,8,11,11,39,44,-5,35
AC Horsens,6623,6,6,14,10,35,53,-18,32
Sonderjyske,6623,7,8,6,10,28,29,-1,30
Randers FC,6623,8,6,6,12,25,40,-15,24
AGF Aarhus,6623,9,5,6,11,18,37,-19,21
Lyngby,6623,10,3,9,12,27,46,-19,18
Silkeborg IF,6623,11,5,3,14,26,46,-20,18
FC Midtjylla,6624,1,20,5,5,68,41,27,65
Brondby,6624,2,18,9,3,71,37,34,63
FC Nords,6624,3,14,6,10,74,53,21,48
Copenhagen,6624,4,14,6,10,60,45,15,48
AaB,6624,5,8,12,10,37,42,-5,36
AC Horsens,6624,6,6,14,10,36,54,-18,32
Sonderjyske,6624,7,8,6,10,28,29,-1,30
Lyngby,6624,8,4,9,11,27,44,-17,21
Randers FC,6624,9,5,6,13,23,40,-17,21
Silkeborg IF,6624,10,6,3,13,28,46,-18,21
AGF Aarhus,6624,11,4,6,12,18,39,-21,18
FC Midtjylla,6625,1,21,5,4,69,36,33,68
Brondby,6625,2,20,7,3,68,32,36,67
FC Nords,6625,3,15,6,9,71,46,25,51
Copenhagen,6625,4,13,4,13,52,46,6,43
AaB,6625,5,7,12,11,36,44,-8,33
AC Horsens,6625,6,7,12,11,36,54,-18,33
Sonderjyske,6625,7,8,6,10,28,29,-1,30
Lyngby,6625,8,4,9,11,27,44,-17,21
Randers FC,6625,9,5,6,13,23,40,-17,21
AGF Aarhus,6625,10,5,6,11,17,36,-19,21
Silkeborg IF,6625,11,5,3,14,25,45,-20,18
Brondby,6626,1,22,6,2,75,32,43,72
FC Midtjylla,6626,2,17,5,8,62,43,19,56
FC Nords,6626,3,14,8,8,74,48,26,50
Copenhagen,6626,4,14,4,12,58,48,10,46
AC Horsens,6626,5,8,12,10,38,56,-18,36
AaB,6626,6,8,11,11,40,46,-6,35
Sonderjyske,6626,7,8,6,10,28,29,-1,30
Lyngby,6626,8,4,9,11,28,44,-16,21
Silkeborg IF,6626,9,6,3,13,26,44,-18,21
Randers FC,6626,10,5,6,13,23,41,-18,21
AGF Aarhus,6626,11,4,6,12,16,37,-21,18
Brondby,6627,1,22,5,3,74,30,44,71
FC Midtjylla,6627,2,18,5,7,64,42,22,59
Copenhagen,6627,3,15,5,10,59,42,17,50
FC Nords,6627,4,13,6,11,69,55,14,45
AaB,6627,5,8,13,9,39,43,-4,37
AC Horsens,6627,6,7,12,11,34,53,-19,33
Sonderjyske,6627,7,8,6,10,28,29,-1,30
Randers FC,6627,8,5,7,12,24,40,-16,22
AGF Aarhus,6627,9,5,6,11,19,37,-18,21
Lyngby,6627,10,3,10,11,27,45,-18,19
Silkeborg IF,6627,11,5,3,14,26,47,-21,18
Brondby,6628,1,21,5,4,70,33,37,68
FC Midtjylla,6628,2,19,6,5,67,42,25,63
FC Nords,6628,3,16,6,8,75,50,25,54
Copenhagen,6628,4,15,5,10,62,43,19,50
AaB,6628,5,7,12,11,33,42,-9,33
Sonderjyske,6628,6,8,6,10,28,29,-1,30
AC Horsens,6628,7,5,12,13,31,54,-23,27
Lyngby,6628,8,4,9,11,28,45,-17,21
Randers FC,6628,9,5,6,13,24,41,-17,21
Silkeborg IF,6628,10,6,3,13,27,45,-18,21
AGF Aarhus,6628,11,4,6,12,17,38,-21,18
Brondby,6629,1,21,6,3,70,32,38,69
FC Midtjylla,6629,2,21,4,5,71,36,35,67
FC Nords,6629,3,16,6,8,73,49,24,54
Copenhagen,6629,4,13,5,12,57,47,10,44
AaB,6629,5,6,14,10,37,49,-12,32
Sonderjyske,6629,6,8,6,10,28,29,-1,30
AC Horsens,6629,7,5,13,12,33,54,-21,28
Randers FC,6629,8,6,6,12,25,40,-15,24
AGF Aarhus,6629,9,5,6,11,19,37,-18,21
Lyngby,6629,10,3,9,12,27,46,-19,18
Silkeborg IF,6629,11,5,3,14,26,47,-21,18
Brondby,6630,1,20,7,3,72,33,39,67
FC Midtjylla,6630,2,20,5,5,68,36,32,65
FC Nords,6630,3,15,6,9,74,53,21,51
Copenhagen,6630,4,15,4,11,63,49,14,49
AaB,6630,5,7,11,12,36,49,-13,32
AC Horsens,6630,6,6,13,11,33,52,-19,31
Sonderjyske,6630,7,8,6,10,28,29,-1,30
Randers FC,6630,8,6,6,12,26,39,-13,24
AGF Aarhus,6630,9,5,6,11,17,36,-19,21
Silkeborg IF,6630,10,5,3,14,25,45,-20,18
Lyngby,6630,11,3,9,12,26,47,-21,18
Brondby,6631,1,21,6,3,72,31,41,69
FC Midtjylla,6631,2,19,5,6,65,41,24,62
FC Nords,6631,3,15,7,8,73,49,24,52
Copenhagen,6631,4,13,7,10,59,45,14,46
AaB,6631,5,8,12,10,38,43,-5,36
Sonderjyske,6631,6,8,6,10,28,29,-1,30
AC Horsens,6631,7,5,13,12,34,58,-24,28
Randers FC,6631,8,5,7,12,24,40,-16,22
Silkeborg IF,6631,9,6,3,13,26,44,-18,21
Lyngby,6631,10,3,10,11,27,45,-18,19
AGF Aarhus,6631,11,4,6,12,16,37,-21,18
Brondby,6632,1,20,8,2,77,34,43,68
FC Midtjylla,6632,2,19,6,5,65,37,28,63
FC Nords,6632,3,14,8,8,76,53,23,50
Copenhagen,6632,4,13,6,11,58,45,13,45
AaB,6632,5,7,14,9,35,42,-7,35
Sonderjyske,6632,6,8,6,10,28,29,-1,30
AC Horsens,6632,7,5,14,11,31,57,-26,29
Randers FC,6632,8,5,7,12,25,41,-16,22
Silkeborg IF,6632,9,6,3,13,30,45,-15,21
Lyngby,6632,10,3,10,11,28,46,-18,19
AGF Aarhus,6632,11,4,6,12,17,41,-24,18
Brondby,6633,1,22,5,3,72,31,41,71
FC Midtjylla,6633,2,20,4,6,66,41,25,64
Copenhagen,6633,3,16,5,9,59,41,18,53
FC Nords,6633,4,13,6,11,68,52,16,45
AaB,6633,5,8,12,10,37,41,-4,36
Sonderjyske,6633,6,8,6,10,28,29,-1,30
AC Horsens,6633,7,5,12,13,31,53,-22,27
Randers FC,6633,8,5,7,12,24,40,-16,22
Lyngby,6633,9,3,10,11,27,45,-18,19
Silkeborg IF,6633,10,5,4,13,26,45,-19,19
AGF Aarhus,6633,11,4,7,11,17,37,-20,19
Brondby,6634,1,19,7,4,67,33,34,64
FC Midtjylla,6634,2,19,5,6,62,39,23,62
Copenhagen,6634,3,16,4,10,64,45,19,52
FC Nords,6634,4,14,7,9,72,52,20,49
AaB,6634,5,7,12,11,36,42,-6,33
AC Horsens,6634,6,6,15,9,35,51,-16,33
Sonderjyske,6634,7,8,6,10,28,29,-1,30
Randers FC,6634,8,6,6,12,26,39,-13,24
Silkeborg IF,6634,9,5,4,13,25,44,-19,19
AGF Aarhus,6634,10,4,7,11,16,36,-20,19
Lyngby,6634,11,3,9,12,26,47,-21,18
Brondby,6635,1,21,7,2,72,28,44,70
FC Midtjylla,6635,2,18,4,8,58,39,19,58
FC Nords,6635,3,16,6,8,75,48,27,54
Copenhagen,6635,4,13,6,11,55,44,11,45
AC Horsens,6635,5,7,13,10,35,55,-20,34
AaB,6635,6,6,14,10,33,40,-7,32
Sonderjyske,6635,7,8,6,10,28,29,-1,30
Randers FC,6635,8,6,6,12,25,40,-15,24
AGF Aarhus,6635,9,5,6,11,17,36,-19,21
Lyngby,6635,10,3,9,12,27,46,-19,18
Silkeborg IF,6635,11,5,3,14,25,45,-20,18
Brondby,6636,1,21,5,4,70,35,35,68
FC Midtjylla,6636,2,20,5,5,68,38,30,65
FC Nords,6636,3,15,6,9,73,48,25,51
Copenhagen,6636,4,15,5,10,57,42,15,50
AC Horsens,6636,5,7,12,11,35,53,-18,33
Sonderjyske,6636,6,8,6,10,28,29,-1,30
AaB,6636,7,6,11,13,37,50,-13,29
Lyngby,6636,8,4,9,11,29,45,-16,21
Randers FC,6636,9,5,6,13,24,42,-18,21
Silkeborg IF,6636,10,5,4,13,26,45,-19,19
AGF Aarhus,6636,11,4,7,11,17,37,-20,19
Brondby,6637,1,21,5,4,73,34,39,68
FC Midtjylla,6637,2,20,4,6,63,37,26,64
Copenhagen,6637,3,15,4,11,57,46,11,49
FC Nords,6637,4,14,6,10,71,51,20,48
AaB,6637,5,9,11,10,42,47,-5,38
Sonderjyske,6637,6,8,6,10,28,29,-1,30
AC Horsens,6637,7,6,12,12,38,55,-17,30
Lyngby,6637,8,4,9,11,27,44,-17,21
Randers FC,6637,9,5,6,13,23,40,-17,21
AGF Aarhus,6637,10,5,6,11,18,36,-18,21
Silkeborg IF,6637,11,5,3,14,25,46,-21,18
Brondby,6638,1,20,8,2,71,33,38,68
FC Midtjylla,6638,2,20,4,6,68,37,31,64
FC Nords,6638,3,14,8,8,73,50,23,50
Copenhagen,6638,4,15,5,10,58,45,13,50
AC Horsens,6638,5,6,14,10,35,52,-17,32
Sonderjyske,6638,6,8,6,10,28,29,-1,30
AaB,6638,7,6,11,13,34,48,-14,29
Lyngby,6638,8,4,9,11,29,45,-16,21
Silkeborg IF,6638,9,6,3,13,27,45,-18,21
Randers FC,6638,10,5,6,13,24,42,-18,21
AGF Aarhus,6638,11,4,6,12,17,38,-21,18
Brondby,6639,1,21,6,3,69,32,37,69
FC Midtjylla,6639,2,19,5,6,64,38,26,62
FC Nords,6639,3,16,6,8,74,46,28,54
Copenhagen,6639,4,13,4,13,53,47,6,43
AaB,6639,5,8,13,9,38,41,-3,37
Sonderjyske,6639,6,8,6,10,28,29,-1,30
AC Horsens,6639,7,6,12,12,33,53,-20,30
Silkeborg IF,6639,8,6,3,13,30,45,-15,21
Lyngby,6639,9,4,9,11,29,45,-16,21
Randers FC,6639,10,5,6,13,24,42,-18,21
AGF Aarhus,6639,11,4,6,12,17,41,-24,18
Brondby,6640,1,20,8,2,71,33,38,68
FC Midtjylla,6640,2,20,6,4,70,36,34,66
FC Nords,6640,3,14,8,8,77,51,26,50
Copenhagen,6640,4,12,6,12,53,48,5,42
AC Horsens,6640,5,7,13,10,36,54,-18,34
AaB,6640,6,6,13,11,33,44,-11,31
Sonderjyske,6640,7,8,6,10,28,29,-1,30
Randers FC,6640,8,5,7,12,25,41,-16,22
Lyngby,6640,9,3,10,11,28,46,-18,19
Silkeborg IF,6640,10,5,4,13,26,45,-19,19
AGF Aarhus,6640,11,4,7,11,17,37,-20,19
Brondby,6641,1,21,6,3,72,31,41,69
FC Midtjylla,6641,2,20,4,6,68,40,28,64
FC Nords,6641,3,15,6,9,77,56,21,51
Copenhagen,6641,4,14,4,12,60,47,13,46
AaB,6641,5,7,13,10,37,44,-7,34
AC Horsens,6641,6,6,13,11,36,58,-22,31
Sonderjyske,6641,7,8,6,10,28,29,-1,30
Lyngby,6641,8,4,9,11,28,45,-17,21
Randers FC,6641,9,5,6,13,24,41,-17,21
Silkeborg IF,6641,10,5,4,13,26,45,-19,19
AGF Aarhus,6641,11,4,7,11,17,37,-20,19
Brondby,6642,1,21,5,4,75,36,39,68
FC Midtjylla,6642,2,19,4,7,65,38,27,61
FC Nords,6642,3,14,6,10,74,58,16,48
Copenhagen,6642,4,14,4,12,60,49,11,46
AaB,6642,5,10,12,8,41,41,0,42
AC Horsens,6642,6,6,13,11,36,55,-19,31
Sonderjyske,6642,7,8,6,10,28,29,-1,30
Lyngby,6642,8,4,9,11,27,44,-17,21
Randers FC,6642,9,5,6,13,23,40,-17,21
AGF Aarhus,6642,10,5,6,11,18,37,-19,21
Silkeborg IF,6642,11,5,3,14,26,46,-20,18
Brondby,6643,1,22,5,3,70,32,38,71
FC Midtjylla,6643,2,20,4,6,63,37,26,64
Copenhagen,6643,3,15,4,11,56,42,14,49
FC Nords,6643,4,13,6,11,68,53,15,45
AC Horsens,6643,5,7,13,10,35,49,-14,34
AaB,6643,6,7,12,11,35,40,-5,33
Sonderjyske,6643,7,8,6,10,28,29,-1,30
Lyngby,6643,8,4,9,11,28,45,-17,21
Randers FC,6643,9,5,6,13,24,41,-17,21
Silkeborg IF,6643,10,5,4,13,26,45,-19,19
AGF Aarhus,6643,11,4,7,11,17,37,-20,19
Brondby,6644,1,20,6,4,69,34,35,66
FC Midtjylla,6644,2,20,5,5,63,35,28,65
Copenhagen,6644,3,14,6,10,54,40,14,48
FC Nords,6644,4,13,7,10,68,52,16,46
AaB,6644,5,7,13,10,37,41,-4,34
AC Horsens,6644,6,6,15,9,34,49,-15,33
Sonderjyske,6644,7,8,6,10,28,29,-1,30
Lyngby,6644,8,4,9,11,29,45,-16,21
Randers FC,6644,9,5,6,13,24,42,-18,21
AGF Aarhus,6644,10,5,6,11,18,37,-19,21
Silkeborg IF,6644,11,5,3,14,26,46,-20,18
Brondby,6645,1,22,5,3,73,31,42,71
FC Midtjylla,6645,2,18,5,7,63,42,21,59
FC Nords,6645,3,15,6,9,76,56,20,51
Copenhagen,6645,4,14,4,12,59,43,16,46
AC Horsens,6645,5,8,12,10,36,51,-15,36
AaB,6645,6,7,12,11,37,47,-10,33
Sonderjyske,6645,7,8,6,10,28,29,-1,30
Lyngby,6645,8,4,9,11,27,44,-17,21
Randers FC,6645,9,5,6,13,23,40,-17,21
Silkeborg IF,6645,10,5,4,13,26,45,-19,19
AGF Aarhus,6645,11,4,7,11,17,37,-20,19
Brondby,6646,1,19,7,4,67,33,34,64
FC Midtjylla,6646,2,18,5,7,60,40,20,59
FC Nords,6646,3,16,6,8,71,46,25,54
Copenhagen,6646,4,16,4,10,60,40,20,52
AaB,6646,5,8,12,10,37,40,-3,36
Sonderjyske,6646,6,8,6,10,28,29,-1,30
AC Horsens,6646,7,6,12,12,34,56,-22,30
Randers FC,6646,8,5,7,12,24,40,-16,22
AGF Aarhus,6646,9,5,6,11,17,36,-19,21
Lyngby,6646,10,3,10,11,27,45,-18,19
Silkeborg IF,6646,11,5,3,14,25,45,-20,18
Brondby,6647,1,22,5,3,76,33,43,71
FC Midtjylla,6647,2,19,6,5,67,39,28,63
FC Nords,6647,3,15,8,7,74,48,26,53
Copenhagen,6647,4,12,5,13,53,48,5,41
AaB,6647,5,6,15,9,34,39,-5,33
AC Horsens,6647,6,6,13,11,36,59,-23,31
Sonderjyske,6647,7,8,6,10,28,29,-1,30
Randers FC,6647,8,5,7,12,24,40,-16,22
Silkeborg IF,6647,9,6,3,13,27,45,-18,21
Lyngby,6647,10,3,10,11,27,45,-18,19
AGF Aarhus,6647,11,4,6,12,17,38,-21,18
Brondby,6648,1,19,7,4,70,34,36,64
FC Midtjylla,6648,2,19,7,4,67,39,28,64
FC Nords,6648,3,13,8,9,69,52,17,47
Copenhagen,6648,4,13,6,11,55,44,11,45
AaB,6648,5,8,13,9,42,44,-2,37
AC Horsens,6648,6,7,13,10,35,51,-16,34
Sonderjyske,6648,7,8,6,10,28,29,-1,30
Lyngby,6648,8,4,9,11,28,45,-17,21
Randers FC,6648,9,5,6,13,24,41,-17,21
Silkeborg IF,6648,10,5,4,13,27,46,-19,19
AGF Aarhus,6648,11,4,7,11,18,38,-20,19
Brondby,6649,1,22,5,3,81,36,45,71
FC Midtjylla,6649,2,21,5,4,73,40,33,68
FC Nords,6649,3,13,6,11,70,60,10,45
Copenhagen,6649,4,12,5,13,56,50,6,41
AC Horsens,6649,5,8,12,10,36,49,-13,36
AaB,6649,6,8,11,11,35,42,-7,35
Sonderjyske,6649,7,8,6,10,28,29,-1,30
Randers FC,6649,8,6,6,12,24,39,-15,24
AGF Aarhus,6649,9,5,6,11,17,36,-19,21
Lyngby,6649,10,3,9,12,26,45,-19,18
Silkeborg IF,6649,11,5,3,14,25,45,-20,18
Brondby,6650,1,22,5,3,72,32,40,71
FC Midtjylla,6650,2,20,4,6,68,42,26,64
FC Nords,6650,3,16,6,8,74,50,24,54
Copenhagen,6650,4,15,4,11,55,41,14,49
Sonderjyske,6650,5,8,6,10,28,29,-1,30
AC Horsens,6650,6,6,12,12,36,54,-18,30
AaB,6650,7,6,11,13,34,46,-12,29
Lyngby,6650,8,4,9,11,28,45,-17,21
Randers FC,6650,9,5,6,13,24,41,-17,21
Silkeborg IF,6650,10,6,3,13,27,45,-18,21
AGF Aarhus,6650,11,4,6,12,17,38,-21,18
Brondby,6651,1,19,8,3,67,31,36,65
FC Midtjylla,6651,2,18,6,6,64,43,21,60
Copenhagen,6651,3,15,4,11,60,44,16,49
FC Nords,6651,4,13,7,10,70,53,17,46
AaB,6651,5,10,12,8,41,39,2,42
AC Horsens,6651,6,6,13,11,35,53,-18,31
Sonderjyske,6651,7,8,6,10,28,29,-1,30
Lyngby,6651,8,4,9,11,28,45,-17,21
Randers FC,6651,9,5,6,13,24,41,-17,21
Silkeborg IF,6651,10,5,4,13,28,47,-19,19
AGF Aarhus,6651,11,4,7,11,19,39,-20,19
Brondby,6652,1,21,5,4,67,32,35,68
FC Midtjylla,6652,2,19,5,6,65,40,25,62
FC Nords,6652,3,15,6,9,76,50,26,51
Copenhagen,6652,4,13,4,13,57,48,9,43
AaB,6652,5,8,12,10,38,45,-7,36
AC Horsens,6652,6,7,14,9,37,51,-14,35
Sonderjyske,6652,7,8,6,10,28,29,-1,30
Lyngby,6652,8,4,9,11,28,45,-17,21
Randers FC,6652,9,5,6,13,24,41,-17,21
Silkeborg IF,6652,10,6,3,13,26,44,-18,21
AGF Aarhus,6652,11,4,6,12,16,37,-21,18
Brondby,6653,1,21,6,3,73,34,39,69
FC Midtjylla,6653,2,19,6,5,67,38,29,63
FC Nords,6653,3,14,7,9,71,56,15,49
Copenhagen,6653,4,14,5,11,54,42,12,47
AaB,6653,5,7,12,11,39,45,-6,33
AC Horsens,6653,6,7,12,11,39,54,-15,33
Sonderjyske,6653,7,8,6,10,28,29,-1,30
Lyngby,6653,8,4,9,11,28,45,-17,21
Randers FC,6653,9,5,6,13,24,41,-17,21
Silkeborg IF,6653,10,6,3,13,28,46,-18,21
AGF Aarhus,6653,11,4,6,12,18,39,-21,18
Brondby,6654,1,20,5,5,73,35,38,65
FC Midtjylla,6654,2,19,6,5,63,39,24,63
FC Nords,6654,3,14,8,8,76,51,25,50
Copenhagen,6654,4,15,4,11,58,45,13,49
AC Horsens,6654,5,7,13,10,34,51,-17,34
AaB,6654,6,7,12,11,34,43,-9,33
Sonderjyske,6654,7,8,6,10,28,29,-1,30
Randers FC,6654,8,6,6,12,25,39,-14,24
AGF Aarhus,6654,9,5,6,11,18,36,-18,21
Lyngby,6654,10,3,9,12,26,46,-20,18
Silkeborg IF,6654,11,5,3,14,25,46,-21,18
Brondby,6655,1,22,6,2,77,31,46,72
FC Midtjylla,6655,2,19,4,7,63,42,21,61
FC Nords,6655,3,15,8,7,78,51,27,53
Copenhagen,6655,4,13,4,13,55,49,6,43
AaB,6655,5,8,12,10,40,43,-3,36
Sonderjyske,6655,6,8,6,10,28,29,-1,30
AC Horsens,6655,7,6,12,12,32,55,-23,30
Silkeborg IF,6655,8,6,3,13,29,45,-16,21
Lyngby,6655,9,4,9,11,28,44,-16,21
Randers FC,6655,10,5,6,13,23,41,-18,21
AGF Aarhus,6655,11,4,6,12,17,40,-23,18
Brondby,6656,1,21,5,4,69,33,36,68
FC Midtjylla,6656,2,20,5,5,67,39,28,65
Copenhagen,6656,3,14,5,11,54,44,10,47
FC Nords,6656,4,13,7,10,72,52,20,46
AaB,6656,5,9,11,10,41,44,-3,38
AC Horsens,6656,6,6,13,11,37,54,-17,31
Sonderjyske,6656,7,8,6,10,28,29,-1,30
Randers FC,6656,8,6,6,12,24,39,-15,24
Silkeborg IF,6656,9,6,3,13,27,44,-17,21
Lyngby,6656,10,3,9,12,26,45,-19,18
AGF Aarhus,6656,11,4,6,12,16,38,-22,18
Brondby,6657,1,20,5,5,66,34,32,65
FC Midtjylla,6657,2,20,4,6,69,39,30,64
Copenhagen,6657,3,16,4,10,61,44,17,52
FC Nords,6657,4,15,6,9,74,57,17,51
AaB,6657,5,9,11,10,42,42,0,38
Sonderjyske,6657,6,8,6,10,28,29,-1,30
AC Horsens,6657,7,5,12,13,33,55,-22,27
Lyngby,6657,8,4,9,11,27,44,-17,21
Randers FC,6657,9,5,6,13,23,40,-17,21
Silkeborg IF,6657,10,5,4,13,26,45,-19,19
AGF Aarhus,6657,11,4,7,11,17,37,-20,19
Brondby,6658,1,22,6,2,74,28,46,72
FC Midtjylla,6658,2,18,5,7,62,43,19,59
FC Nords,6658,3,14,7,9,73,52,21,49
Copenhagen,6658,4,14,5,11,58,47,11,47
AaB,6658,5,8,12,10,39,40,-1,36
AC Horsens,6658,6,6,13,11,32,54,-22,31
Sonderjyske,6658,7,8,6,10,28,29,-1,30
Lyngby,6658,8,4,9,11,28,44,-16,21
Randers FC,6658,9,5,6,13,23,41,-18,21
AGF Aarhus,6658,10,5,6,11,19,38,-19,21
Silkeborg IF,6658,11,5,3,14,27,47,-20,18
Brondby,6659,1,20,6,4,67,34,33,66
FC Midtjylla,6659,2,20,6,4,66,38,28,66
FC Nords,6659,3,14,7,9,74,53,21,49
Copenhagen,6659,4,14,5,11,61,46,15,47
AaB,6659,5,7,12,11,36,43,-7,33
AC Horsens,6659,6,6,14,10,37,53,-16,32
Sonderjyske,6659,7,8,6,10,28,29,-1,30
Lyngby,6659,8,4,9,11,27,44,-17,21
Randers FC,6659,9,5,6,13,23,40,-17,21
Silkeborg IF,6659,10,6,3,13,26,44,-18,21
AGF Aarhus,6659,11,4,6,12,16,37,-21,18
Brondby,6660,1,21,5,4,72,35,37,68
FC Midtjylla,6660,2,19,6,5,69,42,27,63
Copenhagen,6660,3,15,5,10,56,42,14,50
FC Nords,6660,4,13,8,9,74,54,20,47
AaB,6660,5,7,13,10,37,43,-6,34
Sonderjyske,6660,6,8,6,10,28,29,-1,30
AC Horsens,6660,7,5,15,10,35,53,-18,30
Randers FC,6660,8,5,7,12,25,41,-16,22
AGF Aarhus,6660,9,5,6,11,19,36,-17,21
Lyngby,6660,10,3,10,11,28,46,-18,19
Silkeborg IF,6660,11,5,3,14,25,47,-22,18
Brondby,6661,1,19,6,5,70,36,34,63
FC Midtjylla,6661,2,18,5,7,62,42,20,59
FC Nords,6661,3,17,6,7,77,45,32,57
Copenhagen,6661,4,14,6,10,58,44,14,48
AC Horsens,6661,5,8,12,10,39,53,-14,36
AaB,6661,6,7,11,12,36,48,-12,32
Sonderjyske,6661,7,8,6,10,28,29,-1,30
Randers FC,6661,8,5,7,12,26,42,-16,22
Silkeborg IF,6661,9,6,3,13,29,45,-16,21
Lyngby,6661,10,3,10,11,29,47,-18,19
AGF Aarhus,6661,11,4,6,12,17,40,-23,18
FC Midtjylla,6662,1,21,4,5,70,39,31,67
Brondby,6662,2,20,6,4,70,36,34,66
FC Nords,6662,3,15,6,9,75,53,22,51
Copenhagen,6662,4,15,5,10,62,46,16,50
AaB,6662,5,7,12,11,40,46,-6,33
Sonderjyske,6662,6,8,6,10,28,29,-1,30
AC Horsens,6662,7,5,13,12,34,57,-23,28
Randers FC,6662,8,5,7,12,23,39,-16,22
Lyngby,6662,9,3,10,11,26,44,-18,19
Silkeborg IF,6662,10,5,4,13,26,45,-19,19
AGF Aarhus,6662,11,4,7,11,17,37,-20,19
Brondby,6663,1,21,5,4,72,34,38,68
FC Midtjylla,6663,2,19,5,6,66,39,27,62
FC Nords,6663,3,15,7,8,73,49,24,52
Copenhagen,6663,4,15,5,10,59,42,17,50
AaB,6663,5,7,13,10,37,47,-10,34
Sonderjyske,6663,6,8,6,10,28,29,-1,30
AC Horsens,6663,7,5,13,12,34,56,-22,28
Lyngby,6663,8,4,9,11,28,45,-17,21
Silkeborg IF,6663,9,6,3,13,27,44,-17,21
Randers FC,6663,10,5,6,13,24,41,-17,21
AGF Aarhus,6663,11,4,6,12,16,38,-22,18
Brondby,6664,1,21,6,3,71,28,43,69
FC Midtjylla,6664,2,19,4,7,61,42,19,61
FC Nords,6664,3,14,8,8,72,46,26,50
Copenhagen,6664,4,14,5,11,58,45,13,47
AaB,6664,5,8,11,11,36,45,-9,35
AC Horsens,6664,6,6,14,10,34,52,-18,32
Sonderjyske,6664,7,8,6,10,28,29,-1,30
Randers FC,6664,8,6,6,12,25,40,-15,24
AGF Aarhus,6664,9,5,6,11,17,36,-19,21
Lyngby,6664,10,3,9,12,27,46,-19,18
Silkeborg IF,6664,11,5,3,14,25,45,-20,18
Brondby,6665,1,20,6,4,72,34,38,66
FC Midtjylla,6665,2,20,5,5,63,39,24,65
FC Nords,6665,3,14,6,10,70,53,17,48
Copenhagen,6665,4,13,6,11,55,45,10,45
AC Horsens,6665,5,7,14,9,37,49,-12,35
AaB,6665,6,7,13,10,37,40,-3,34
Sonderjyske,6665,7,8,6,10,28,29,-1,30
Lyngby,6665,8,4,9,11,27,44,-17,21
Randers FC,6665,9,5,6,13,23,40,-17,21
AGF Aarhus,6665,10,5,6,11,17,36,-19,21
Silkeborg IF,6665,11,5,3,14,25,45,-20,18
Brondby,6666,1,23,5,2,73,29,44,74
FC Midtjylla,6666,2,18,6,6,67,42,25,60
FC Nords,6666,3,14,7,9,73,54,19,49
Copenhagen,6666,4,14,5,11,58,45,13,47
AaB,6666,5,7,11,12,35,46,-11,32
AC Horsens,6666,6,6,14,10,34,50,-16,32
Sonderjyske,6666,7,8,6,10,28,29,-1,30
Lyngby,6666,8,4,9,11,30,45,-15,21
Silkeborg IF,6666,9,6,3,13,26,44,-18,21
Randers FC,6666,10,5,6,13,24,43,-19,21
AGF Aarhus,6666,11,4,6,12,16,37,-21,18
Brondby,6667,1,21,5,4,73,36,37,68
FC Midtjylla,6667,2,21,5,4,69,39,30,68
FC Nords,6667,3,14,6,10,76,51,25,48
Copenhagen,6667,4,13,5,12,59,50,9,44
AaB,6667,5,8,12,10,38,43,-5,36
AC Horsens,6667,6,6,13,11,36,58,-22,31
Sonderjyske,6667,7,8,6,10,28,29,-1,30
Randers FC,6667,8,5,7,12,24,40,-16,22
Silkeborg IF,6667,9,6,3,13,28,46,-18,21
Lyngby,6667,10,3,10,11,27,45,-18,19
AGF Aarhus,6667,11,4,6,12,18,39,-21,18
Brondby,6668,1,19,5,6,66,35,31,62
FC Midtjylla,6668,2,19,5,6,62,43,19,62
FC Nords,6668,3,16,7,7,78,49,29,55
Copenhagen,6668,4,14,5,11,59,43,16,47
AC Horsens,6668,5,8,12,10,37,51,-14,36
AaB,6668,6,7,12,11,37,44,-7,33
Sonderjyske,6668,7,8,6,10,28,29,-1,30
Randers FC,6668,8,6,6,12,25,40,-15,24
Silkeborg IF,6668,9,5,4,13,26,45,-19,19
AGF Aarhus,6668,10,4,7,11,17,37,-20,19
Lyngby,6668,11,3,9,12,27,46,-19,18
Brondby,6669,1,20,5,5,71,36,35,65
FC Midtjylla,6669,2,20,5,5,66,35,31,65
FC Nords,6669,3,13,8,9,71,50,21,47
Copenhagen,6669,4,14,5,11,58,47,11,47
AaB,6669,5,8,12,10,36,40,-4,36
AC Horsens,6669,6,7,13,10,36,56,-20,34
Sonderjyske,6669,7,8,6,10,28,29,-1,30
Silkeborg IF,6669,8,6,3,13,28,45,-17,21
Lyngby,6669,9,4,9,11,27,44,-17,21
Randers FC,6669,10,5,6,13,23,40,-17,21
AGF Aarhus,6669,11,4,6,12,17,39,-22,18
Brondby,6670,1,22,5,3,72,32,40,71
FC Midtjylla,6670,2,18,5,7,61,41,20,59
FC Nords,6670,3,15,6,9,72,48,24,51
Copenhagen,6670,4,15,4,11,59,45,14,49
AaB,6670,5,8,12,10,38,40,-2,36
Sonderjyske,6670,6,8,6,10,28,29,-1,30
AC Horsens,6670,7,5,14,11,33,55,-22,29
Lyngby,6670,8,4,9,11,29,45,-16,21
Randers FC,6670,9,5,6,13,24,42,-18,21
Silkeborg IF,6670,10,5,4,13,26,45,-19,19
AGF Aarhus,6670,11,4,7,11,17,37,-20,19
FC Midtjylla,6671,1,21,4,5,67,40,27,67
Brondby,6671,2,19,7,4,63,29,34,64
FC Nords,6671,3,14,7,9,75,51,24,49
Copenhagen,6671,4,14,6,10,57,42,15,48
AaB,6671,5,8,12,10,39,43,-4,36
Sonderjyske,6671,6,8,6,10,28,29,-1,30
AC Horsens,6671,7,6,12,12,34,56,-22,30
Randers FC,6671,8,6,6,12,25,40,-15,24
AGF Aarhus,6671,9,5,6,11,21,37,-16,21
Lyngby,6671,10,3,9,12,27,46,-19,18
Silkeborg IF,6671,11,5,3,14,26,49,-23,18
Brondby,6672,1,23,5,2,75,29,46,74
FC Midtjylla,6672,2,19,4,7,63,45,18,61
FC Nords,6672,3,16,6,8,79,54,25,54
Copenhagen,6672,4,13,4,13,56,46,10,43
AaB,6672,5,8,11,11,38,42,-4,35
Sonderjyske,6672,6,8,6,10,28,29,-1,30
AC Horsens,6672,7,6,12,12,35,56,-21,30
Randers FC,6672,8,5,7,12,25,41,-16,22
Silkeborg IF,6672,9,6,3,13,26,44,-18,21
Lyngby,6672,10,3,10,11,28,46,-18,19
AGF Aarhus,6672,11,4,6,12,16,37,-21,18
Brondby,6673,1,20,6,4,68,31,37,66
FC Midtjylla,6673,2,20,4,6,66,37,29,64
FC Nords,6673,3,14,7,9,72,51,21,49
Copenhagen,6673,4,14,5,11,60,48,12,47
AaB,6673,5,7,13,10,35,41,-6,34
AC Horsens,6673,6,7,13,10,36,55,-19,34
Sonderjyske,6673,7,8,6,10,28,29,-1,30
Lyngby,6673,8,4,9,11,30,45,-15,21
Randers FC,6673,9,5,6,13,24,43,-19,21
AGF Aarhus,6673,10,5,6,11,18,37,-19,21
Silkeborg IF,6673,11,5,3,14,26,46,-20,18
Brondby,6674,1,20,6,4,71,34,37,66
FC Midtjylla,6674,2,19,4,7,62,44,18,61
FC Nords,6674,3,14,8,8,72,51,21,50
Copenhagen,6674,4,14,6,10,64,46,18,48
AC Horsens,6674,5,8,12,10,37,51,-14,36
AaB,6674,6,7,12,11,36,42,-6,33
Sonderjyske,6674,7,8,6,10,28,29,-1,30
Lyngby,6674,8,4,9,11,28,45,-17,21
Silkeborg IF,6674,9,6,3,13,27,44,-17,21
Randers FC,6674,10,5,6,13,24,41,-17,21
AGF Aarhus,6674,11,4,6,12,16,38,-22,18
Brondby,6675,1,21,6,3,75,29,46,69
FC Midtjylla,6675,2,19,6,5,66,46,20,63
FC Nords,6675,3,14,7,9,74,53,21,49
Copenhagen,6675,4,13,5,12,55,47,8,44
AaB,6675,5,8,12,10,40,45,-5,36
AC Horsens,6675,6,6,14,10,34,50,-16,32
Sonderjyske,6675,7,8,6,10,28,29,-1,30
Randers FC,6675,8,6,6,12,25,40,-15,24
AGF Aarhus,6675,9,5,6,11,18,37,-19,21
Lyngby,6675,10,3,9,12,27,46,-19,18
Silkeborg IF,6675,11,5,3,14,26,46,-20,18
Brondby,6676,1,21,5,4,69,32,37,68
FC Midtjylla,6676,2,19,6,5,63,36,27,63
FC Nords,6676,3,15,6,9,75,54,21,51
Copenhagen,6676,4,13,6,11,54,44,10,45
AaB,6676,5,7,13,10,36,41,-5,34
AC Horsens,6676,6,6,14,10,34,50,-16,32
Sonderjyske,6676,7,8,6,10,28,29,-1,30
Lyngby,6676,8,4,9,11,27,44,-17,21
Randers FC,6676,9,5,6,13,23,40,-17,21
Silkeborg IF,6676,10,5,4,13,27,46,-19,19
AGF Aarhus,6676,11,4,7,11,18,38,-20,19
Brondby,6677,1,23,5,2,77,30,47,74
FC Midtjylla,6677,2,21,4,5,68,37,31,67
FC Nords,6677,3,14,6,10,73,53,20,48
Copenhagen,6677,4,14,4,12,55,45,10,46
AaB,6677,5,7,12,11,39,47,-8,33
Sonderjyske,6677,6,8,6,10,28,29,-1,30
AC Horsens,6677,7,5,13,12,33,59,-26,28
Lyngby,6677,8,4,9,11,28,45,-17,21
Silkeborg IF,6677,9,6,3,13,27,44,-17,21
Randers FC,6677,10,5,6,13,24,41,-17,21
AGF Aarhus,6677,11,4,6,12,16,38,-22,18
Brondby,6678,1,20,5,5,68,37,31,65
FC Midtjylla,6678,2,18,4,8,67,47,20,58
FC Nords,6678,3,16,6,8,78,50,28,54
Copenhagen,6678,4,15,5,10,59,42,17,50
AaB,6678,5,8,11,11,41,47,-6,35
AC Horsens,6678,6,7,13,10,36,52,-16,34
Sonderjyske,6678,7,8,6,10,28,29,-1,30
Randers FC,6678,8,5,7,12,26,42,-16,22
Lyngby,6678,9,3,10,11,29,47,-18,19
Silkeborg IF,6678,10,5,4,13,26,45,-19,19
AGF Aarhus,6678,11,4,7,11,17,37,-20,19
Brondby,6679,1,21,5,4,68,32,36,68
FC Midtjylla,6679,2,19,5,6,63,37,26,62
Copenhagen,6679,3,16,4,10,60,41,19,52
FC Nords,6679,4,14,8,8,72,50,22,50
AaB,6679,5,7,11,12,36,45,-9,32
AC Horsens,6679,6,6,13,11,34,54,-20,31
Sonderjyske,6679,7,8,6,10,28,29,-1,30
Randers FC,6679,8,5,7,12,23,39,-16,22
Lyngby,6679,9,3,10,11,26,44,-18,19
Silkeborg IF,6679,10,5,4,13,25,44,-19,19
AGF Aarhus,6679,11,4,7,11,16,36,-20,19
Brondby,6680,1,21,6,3,71,31,40,69
FC Midtjylla,6680,2,20,4,6,68,46,22,64
Copenhagen,6680,3,16,4,10,60,42,18,52
FC Nords,6680,4,12,8,10,70,54,16,44
AC Horsens,6680,5,7,13,10,36,52,-16,34
AaB,6680,6,7,11,12,37,43,-6,32
Sonderjyske,6680,7,8,6,10,28,29,-1,30
Randers FC,6680,8,6,6,12,26,39,-13,24
AGF Aarhus,6680,9,5,6,11,17,36,-19,21
Silkeborg IF,6680,10,5,3,14,25,45,-20,18
Lyngby,6680,11,3,9,12,26,47,-21,18
Brondby,6681,1,20,6,4,72,33,39,66
FC Midtjylla,6681,2,20,5,5,68,40,28,65
FC Nords,6681,3,15,6,9,70,53,17,51
Copenhagen,6681,4,14,5,11,57,43,14,47
AaB,6681,5,8,11,11,40,46,-6,35
AC Horsens,6681,6,6,13,11,34,52,-18,31
Sonderjyske,6681,7,8,6,10,28,29,-1,30
Lyngby,6681,8,4,9,11,31,44,-13,21
Silkeborg IF,6681,9,6,3,13,26,44,-18,21
Randers FC,6681,10,5,6,13,23,44,-21,21
AGF Aarhus,6681,11,4,6,12,16,37,-21,18
Brondby,6682,1,22,5,3,70,30,40,71
FC Midtjylla,6682,2,18,6,6,61,40,21,60
FC Nords,6682,3,14,7,9,73,53,20,49
Copenhagen,6682,4,13,5,12,57,46,11,44
AaB,6682,5,8,12,10,39,42,-3,36
AC Horsens,6682,6,6,15,9,36,51,-15,33
Sonderjyske,6682,7,8,6,10,28,29,-1,30
Randers FC,6682,8,6,6,12,26,41,-15,24
AGF Aarhus,6682,9,5,6,11,17,36,-19,21
Lyngby,6682,10,3,9,12,28,47,-19,18
Silkeborg IF,6682,11,5,3,14,25,45,-20,18
Brondby,6683,1,20,8,2,70,31,39,68
FC Midtjylla,6683,2,21,4,5,64,38,26,67
FC Nords,6683,3,14,8,8,73,48,25,50
Copenhagen,6683,4,14,4,12,61,50,11,46
AaB,6683,5,7,13,10,37,42,-5,34
Sonderjyske,6683,6,8,6,10,28,29,-1,30
AC Horsens,6683,7,5,13,12,33,55,-22,28
Lyngby,6683,8,4,9,11,28,44,-16,21
Silkeborg IF,6683,8,6,3,13,28,44,-16,21
Randers FC,6683,10,5,6,13,23,41,-18,21
AGF Aarhus,6683,11,4,6,12,16,39,-23,18
Brondby,6684,1,21,6,3,69,30,39,69
FC Midtjylla,6684,2,19,5,6,68,36,32,62
FC Nords,6684,3,15,6,9,81,57,24,51
Copenhagen,6684,4,14,5,11,55,41,14,47
AaB,6684,5,8,12,10,36,45,-9,36
Sonderjyske,6684,6,8,6,10,28,29,-1,30
AC Horsens,6684,7,5,14,11,33,59,-26,29
Randers FC,6684,8,5,7,12,24,40,-16,22
Silkeborg IF,6684,9,6,3,13,27,45,-18,21
Lyngby,6684,10,3,10,11,27,45,-18,19
AGF Aarhus,6684,11,4,6,12,17,38,-21,18
Brondby,6685,1,22,6,2,71,31,40,72
FC Midtjylla,6685,2,18,8,4,67,39,28,62
FC Nords,6685,3,13,8,9,78,56,22,47
Copenhagen,6685,4,13,5,12,61,55,6,44
AaB,6685,5,7,12,11,37,45,-8,33
AC Horsens,6685,6,6,15,9,38,52,-14,33
Sonderjyske,6685,7,8,6,10,28,29,-1,30
Lyngby,6685,8,4,9,11,29,44,-15,21
AGF Aarhus,6685,9,5,6,11,18,36,-18,21
Randers FC,6685,10,5,6,13,23,42,-19,21
Silkeborg IF,6685,11,5,3,14,25,46,-21,18
Brondby,6686,1,21,6,3,68,29,39,69
FC Midtjylla,6686,2,19,5,6,70,45,25,62
FC Nords,6686,3,16,6,8,78,52,26,54
Copenhagen,6686,4,15,4,11,61,46,15,49
AaB,6686,5,7,12,11,36,43,-7,33
Sonderjyske,6686,6,8,6,10,28,29,-1,30
AC Horsens,6686,7,5,13,12,34,58,-24,28
Randers FC,6686,8,6,6,12,26,40,-14,24
Silkeborg IF,6686,9,6,3,13,27,44,-17,21
Lyngby,6686,10,3,9,12,27,47,-20,18
AGF Aarhus,6686,11,4,6,12,16,38,-22,18
Brondby,6687,1,20,5,5,68,39,29,65
FC Midtjylla,6687,2,19,6,5,69,41,28,63
FC Nords,6687,3,16,6,8,74,47,27,54
Copenhagen,6687,4,15,5,10,63,46,17,50
AaB,6687,5,8,12,10,38,42,-4,36
Sonderjyske,6687,6,8,6,10,28,29,-1,30
AC Horsens,6687,7,5,12,13,32,55,-23,27
Lyngby,6687,8,4,9,11,30,46,-16,21
Silkeborg IF,6687,9,6,3,13,26,44,-18,21
Randers FC,6687,10,5,6,13,25,43,-18,21
AGF Aarhus,6687,11,4,6,12,16,37,-21,18
Brondby,6688,1,19,7,4,67,31,36,64
FC Midtjylla,6688,2,18,7,5,61,35,26,61
FC Nords,6688,3,15,7,8,75,50,25,52
Copenhagen,6688,4,14,6,10,55,43,12,48
AaB,6688,5,7,13,10,36,44,-8,34
AC Horsens,6688,6,7,12,11,35,52,-17,33
Sonderjyske,6688,7,8,6,10,28,29,-1,30
Lyngby,6688,8,4,9,11,27,44,-17,21
Randers FC,6688,9,5,6,13,23,40,-17,21
AGF Aarhus,6688,10,5,6,11,19,38,-19,21
Silkeborg IF,6688,11,5,3,14,27,47,-20,18
Brondby,6689,1,20,6,4,74,35,39,66
FC Midtjylla,6689,2,19,5,6,67,40,27,62
FC Nords,6689,3,15,6,9,72,56,16,51
Copenhagen,6689,4,15,5,10,63,46,17,50
AC Horsens,6689,5,6,15,9,35,51,-16,33
AaB,6689,6,7,11,12,37,46,-9,32
Sonderjyske,6689,7,8,6,10,28,29,-1,30
Randers FC,6689,8,5,7,12,23,39,-16,22
Silkeborg IF,6689,9,6,3,13,26,44,-18,21
Lyngby,6689,10,3,10,11,26,44,-18,19
AGF Aarhus,6689,11,4,6,12,16,37,-21,18
Brondby,6690,1,22,5,3,71,33,38,71
FC Midtjylla,6690,2,20,4,6,66,38,28,64
Copenhagen,6690,3,14,4,12,56,43,13,46
FC Nords,6690,4,13,6,11,69,56,13,45
AaB,6690,5,9,11,10,39,42,-3,38
AC Horsens,6690,6,7,12,11,34,49,-15,33
Sonderjyske,6690,7,8,6,10,28,29,-1,30
Randers FC,6690,8,5,7,12,24,40,-16,22
Lyngby,6690,9,3,10,11,27,45,-18,19
Silkeborg IF,6690,10,5,4,13,25,44,-19,19
AGF Aarhus,6690,11,4,7,11,16,36,-20,19
Brondby,6691,1,23,5,2,72,27,45,74
FC Midtjylla,6691,2,18,6,6,62,41,21,60
FC Nords,6691,3,14,8,8,71,50,21,50
Copenhagen,6691,4,13,5,12,57,44,13,44
AaB,6691,5,7,14,9,36,42,-6,35
Sonderjyske,6691,6,8,6,10,28,29,-1,30
AC Horsens,6691,7,6,12,12,34,54,-20,30
Randers FC,6691,8,6,6,12,25,39,-14,24
Silkeborg IF,6691,9,5,4,13,28,47,-19,19
AGF Aarhus,6691,10,4,7,11,19,39,-20,19
Lyngby,6691,11,3,9,12,26,46,-20,18
Brondby,6692,1,22,6,2,74,28,46,72
FC Midtjylla,6692,2,18,7,5,61,35,26,61
FC Nords,6692,3,15,6,9,75,56,19,51
Copenhagen,6692,4,14,4,12,60,49,11,46
AaB,6692,5,7,12,11,35,44,-9,33
AC Horsens,6692,6,6,13,11,34,53,-19,31
Sonderjyske,6692,7,8,6,10,28,29,-1,30
Randers FC,6692,8,6,6,12,25,39,-14,24
AGF Aarhus,6692,9,5,6,11,17,36,-19,21
Lyngby,6692,10,3,9,12,26,46,-20,18
Silkeborg IF,6692,11,5,3,14,25,45,-20,18
Brondby,6693,1,21,6,3,71,33,38,69
FC Midtjylla,6693,2,21,4,5,65,37,28,67
FC Nords,6693,3,15,7,8,76,51,25,52
Copenhagen,6693,4,14,4,12,58,46,12,46
AaB,6693,5,7,11,12,40,47,-7,32
Sonderjyske,6693,6,8,6,10,28,29,-1,30
AC Horsens,6693,7,6,12,12,31,53,-22,30
Lyngby,6693,8,4,9,11,29,45,-16,21
Randers FC,6693,9,5,6,13,24,42,-18,21
Silkeborg IF,6693,10,5,4,13,26,45,-19,19
AGF Aarhus,6693,11,4,7,11,17,37,-20,19
Brondby,6694,1,20,7,3,76,36,40,67
FC Midtjylla,6694,2,20,4,6,68,39,29,64
Copenhagen,6694,3,16,4,10,61,44,17,52
FC Nords,6694,4,14,7,9,77,56,21,49
AaB,6694,5,8,11,11,40,48,-8,35
Sonderjyske,6694,6,8,6,10,28,29,-1,30
AC Horsens,6694,7,5,13,12,33,58,-25,28
Randers FC,6694,8,6,6,12,25,40,-15,24
Silkeborg IF,6694,9,6,3,13,27,44,-17,21
Lyngby,6694,10,3,9,12,27,46,-19,18
AGF Aarhus,6694,11,4,6,12,16,38,-22,18
Brondby,6695,1,21,5,4,69,35,34,68
FC Midtjylla,6695,2,19,5,6,62,36,26,62
FC Nords,6695,3,15,7,8,79,53,26,52
Copenhagen,6695,4,13,7,10,53,40,13,46
AaB,6695,5,7,13,10,35,41,-6,34
Sonderjyske,6695,6,8,6,10,28,29,-1,30
AC Horsens,6695,7,5,15,10,32,51,-19,30
Randers FC,6695,8,5,7,12,25,41,-16,22
AGF Aarhus,6695,9,5,6,11,18,37,-19,21
Lyngby,6695,10,3,10,11,28,46,-18,19
Silkeborg IF,6695,11,5,3,14,26,46,-20,18
Brondby,6696,1,22,6,2,71,30,41,72
FC Midtjylla,6696,2,21,4,5,67,36,31,67
FC Nords,6696,3,15,7,8,72,48,24,52
Copenhagen,6696,4,14,4,12,59,48,11,46
Sonderjyske,6696,5,8,6,10,28,29,-1,30
AC Horsens,6696,6,6,12,12,32,55,-23,30
AaB,6696,7,6,11,13,36,46,-10,29
Lyngby,6696,8,4,9,11,28,45,-17,21
Silkeborg IF,6696,9,6,3,13,27,44,-17,21
Randers FC,6696,10,5,6,13,24,41,-17,21
AGF Aarhus,6696,11,4,6,12,16,38,-22,18
Brondby,6697,1,20,7,3,71,34,37,67
FC Midtjylla,6697,2,20,6,4,70,41,29,66
FC Nords,6697,3,13,8,9,72,53,19,47
Copenhagen,6697,4,13,5,12,57,48,9,44
AaB,6697,5,9,12,9,40,42,-2,39
Sonderjyske,6697,6,8,6,10,28,29,-1,30
AC Horsens,6697,7,6,12,12,39,57,-18,30
Randers FC,6697,8,6,6,12,25,40,-15,24
Silkeborg IF,6697,9,6,3,13,28,44,-16,21
Lyngby,6697,10,3,9,12,27,46,-19,18
AGF Aarhus,6697,11,4,6,12,16,39,-23,18
FC Midtjylla,6698,1,22,4,4,69,35,34,70
Brondby,6698,2,21,5,4,70,32,38,68
FC Nords,6698,3,14,7,9,72,51,21,49
Copenhagen,6698,4,13,5,12,59,46,13,44
AaB,6698,5,7,12,11,38,49,-11,33
AC Horsens,6698,6,6,13,11,37,58,-21,31
Sonderjyske,6698,7,8,6,10,28,29,-1,30
Lyngby,6698,8,4,9,11,27,44,-17,21
Randers FC,6698,9,5,6,13,23,40,-17,21
AGF Aarhus,6698,10,5,6,11,19,38,-19,21
Silkeborg IF,6698,11,5,3,14,27,47,-20,18
Brondby,6699,1,20,5,5,71,36,35,65
FC Midtjylla,6699,2,19,6,5,67,39,28,63
FC Nords,6699,3,15,6,9,74,53,21,51
Copenhagen,6699,4,15,4,11,59,46,13,49
AC Horsens,6699,5,7,13,10,34,50,-16,34
AaB,6699,6,7,12,11,37,44,-7,33
Sonderjyske,6699,7,8,6,10,28,29,-1,30
Lyngby,6699,8,4,9,11,29,45,-16,21
Randers FC,6699,9,5,6,13,24,42,-18,21
Silkeborg IF,6699,10,5,4,13,26,45,-19,19
AGF Aarhus,6699,11,4,7,11,17,37,-20,19
Brondby,6700,1,20,6,4,67,31,36,66
FC Midtjylla,6700,2,17,8,5,58,35,23,59
Copenhagen,6700,3,15,5,10,62,44,18,50
FC Nords,6700,4,14,7,9,74,51,23,49
AC Horsens,6700,5,8,12,10,36,52,-16,36
AaB,6700,6,7,12,11,35,45,-10,33
Sonderjyske,6700,7,8,6,10,28,29,-1,30
Randers FC,6700,8,6,6,12,24,39,-15,24
AGF Aarhus,6700,9,5,6,11,17,36,-19,21
Lyngby,6700,10,3,9,12,26,45,-19,18
Silkeborg IF,6700,11,5,3,14,25,45,-20,18
FC Midtjylla,6701,1,21,4,5,69,37,32,67
Brondby,6701,2,19,7,4,68,34,34,64
Copenhagen,6701,3,15,4,11,57,43,14,49
FC Nords,6701,4,12,8,10,67,53,14,44
AaB,6701,5,9,12,9,40,38,2,39
AC Horsens,6701,6,6,13,11,34,56,-22,31
Sonderjyske,6701,7,8,6,10,28,29,-1,30
Lyngby,6701,8,4,9,11,30,44,-14,21
Silkeborg IF,6701,9,6,3,13,28,45,-17,21
Randers FC,6701,10,5,6,13,23,43,-20,21
AGF Aarhus,6701,11,4,6,12,17,39,-22,18
Brondby,6702,1,21,7,2,69,27,42,70
FC Midtjylla,6702,2,20,6,4,64,33,31,66
FC Nords,6702,3,14,6,10,71,51,20,48
Copenhagen,6702,4,13,6,11,57,45,12,45
AaB,6702,5,8,11,11,35,45,-10,35
Sonderjyske,6702,6,8,6,10,28,29,-1,30
AC Horsens,6702,7,6,12,12,32,53,-21,30
Lyngby,6702,8,4,9,11,28,45,-17,21
Randers FC,6702,9,5,6,13,24,41,-17,21
AGF Aarhus,6702,10,5,6,11,18,36,-18,21
Silkeborg IF,6702,11,5,3,14,25,46,-21,18
Brondby,6703,1,20,7,3,72,36,36,67
FC Midtjylla,6703,2,20,4,6,65,42,23,64
FC Nords,6703,3,15,7,8,79,52,27,52
Copenhagen,6703,4,15,4,11,58,41,17,49
AaB,6703,5,7,12,11,38,45,-7,33
Sonderjyske,6703,6,8,6,10,28,29,-1,30
AC Horsens,6703,7,6,12,12,35,57,-22,30
Randers FC,6703,8,5,7,12,24,40,-16,22
Silkeborg IF,6703,9,6,3,13,26,44,-18,21
Lyngby,6703,10,3,10,11,27,45,-18,19
AGF Aarhus,6703,11,4,6,12,16,37,-21,18
FC Midtjylla,6704,1,21,5,4,67,37,30,68
Brondby,6704,2,20,6,4,70,35,35,66
FC Nords,6704,3,14,6,10,71,52,19,48
Copenhagen,6704,4,13,5,12,57,46,11,44
AaB,6704,5,7,13,10,38,43,-5,34
AC Horsens,6704,6,7,13,10,36,52,-16,34
Sonderjyske,6704,7,8,6,10,28,29,-1,30
Randers FC,6704,8,5,7,12,24,40,-16,22
Silkeborg IF,6704,9,6,3,13,27,45,-18,21
Lyngby,6704,10,3,10,11,27,45,-18,19
AGF Aarhus,6704,11,4,6,12,17,38,-21,18
Brondby,6705,1,20,5,5,67,37,30,65
FC Midtjylla,6705,2,20,5,5,65,38,27,65
FC Nords,6705,3,13,9,8,71,49,22,48
Copenhagen,6705,4,14,6,10,56,40,16,48
AC Horsens,6705,5,7,13,10,36,51,-15,34
AaB,6705,6,7,12,11,40,46,-6,33
Sonderjyske,6705,7,8,6,10,28,29,-1,30
Randers FC,6705,8,6,6,12,25,39,-14,24
Silkeborg IF,6705,9,6,3,13,28,46,-18,21
Lyngby,6705,10,3,9,12,26,46,-20,18
AGF Aarhus,6705,11,4,6,12,18,39,-21,18
Brondby,6706,1,22,5,3,74,34,40,71
FC Midtjylla,6706,2,18,6,6,63,41,22,60
FC Nords,6706,3,13,8,9,70,52,18,47
Copenhagen,6706,4,14,5,11,59,44,15,47
AC Horsens,6706,5,7,14,9,35,49,-14,35
AaB,6706,6,7,12,11,36,43,-7,33
Sonderjyske,6706,7,8,6,10,28,29,-1,30
Lyngby,6706,8,4,9,11,28,44,-16,21
Randers FC,6706,9,5,6,13,23,41,-18,21
AGF Aarhus,6706,10,5,6,11,19,38,-19,21
Silkeborg IF,6706,11,5,3,14,27,47,-20,18
Brondby,6707,1,19,8,3,72,36,36,65
FC Midtjylla,6707,2,19,6,5,64,38,26,63
FC Nords,6707,3,13,10,7,75,51,24,49
Copenhagen,6707,4,14,6,10,60,46,14,48
AC Horsens,6707,5,7,13,10,38,56,-18,34
AaB,6707,6,6,13,11,37,45,-8,31
Sonderjyske,6707,7,8,6,10,28,29,-1,30
Randers FC,6707,8,6,6,12,26,41,-15,24
Silkeborg IF,6707,9,5,4,13,25,44,-19,19
AGF Aarhus,6707,10,4,7,11,16,36,-20,19
Lyngby,6707,11,3,9,12,28,47,-19,18
Brondby,6708,1,20,8,2,74,33,41,68
FC Midtjylla,6708,2,19,5,6,62,41,21,62
FC Nords,6708,3,14,6,10,70,49,21,48
Copenhagen,6708,4,14,6,10,56,44,12,48
AaB,6708,5,8,13,9,39,40,-1,37
Sonderjyske,6708,6,8,6,10,28,29,-1,30
AC Horsens,6708,7,5,14,11,32,52,-20,29
Randers FC,6708,8,6,6,12,25,39,-14,24
Silkeborg IF,6708,9,6,3,13,31,46,-15,21
Lyngby,6708,10,3,9,12,26,46,-20,18
AGF Aarhus,6708,11,4,6,12,18,42,-24,18
Brondby,6709,1,20,7,3,70,34,36,67
FC Midtjylla,6709,2,19,4,7,64,41,23,61
FC Nords,6709,3,15,6,9,73,50,23,51
Copenhagen,6709,4,13,5,12,56,44,12,44
AaB,6709,5,9,13,8,39,38,1,40
AC Horsens,6709,6,6,13,11,33,54,-21,31
Sonderjyske,6709,7,8,6,10,28,29,-1,30
Randers FC,6709,8,6,6,12,25,39,-14,24
Silkeborg IF,6709,9,6,3,13,26,44,-18,21
Lyngby,6709,10,3,9,12,26,46,-20,18
AGF Aarhus,6709,11,4,6,12,16,37,-21,18
Brondby,6710,1,21,6,3,68,28,40,69
FC Midtjylla,6710,2,19,5,6,62,38,24,62
Copenhagen,6710,3,15,4,11,56,44,12,49
FC Nords,6710,4,12,7,11,70,55,15,43
AaB,6710,5,8,13,9,36,39,-3,37
AC Horsens,6710,6,6,15,9,37,51,-14,33
Sonderjyske,6710,7,8,6,10,28,29,-1,30
Randers FC,6710,8,6,6,12,24,39,-15,24
Silkeborg IF,6710,9,6,3,13,27,44,-17,21
Lyngby,6710,10,3,9,12,26,45,-19,18
AGF Aarhus,6710,11,4,6,12,16,38,-22,18
Brondby,6711,1,22,5,3,71,33,38,71
FC Midtjylla,6711,2,18,5,7,64,43,21,59
FC Nords,6711,3,14,7,9,75,57,18,49
Copenhagen,6711,4,14,4,12,57,48,9,46
AaB,6711,5,8,12,10,40,39,1,36
AC Horsens,6711,6,7,13,10,37,50,-13,34
Sonderjyske,6711,7,8,6,10,28,29,-1,30
Randers FC,6711,8,5,7,12,24,40,-16,22
AGF Aarhus,6711,9,5,6,11,18,37,-19,21
Lyngby,6711,10,3,10,11,27,45,-18,19
Silkeborg IF,6711,11,5,3,14,26,46,-20,18
Brondby,6712,1,21,5,4,69,32,37,68
FC Midtjylla,6712,2,19,5,6,66,39,27,62
FC Nords,6712,3,16,7,7,76,51,25,55
Copenhagen,6712,4,15,4,11,59,43,16,49
AaB,6712,5,7,11,12,35,48,-13,32
Sonderjyske,6712,6,8,6,10,28,29,-1,30
AC Horsens,6712,7,6,12,12,33,51,-18,30
Randers FC,6712,8,5,7,12,26,42,-16,22
Lyngby,6712,9,3,10,11,29,47,-18,19
Silkeborg IF,6712,10,5,4,13,27,46,-19,19
AGF Aarhus,6712,11,4,7,11,18,38,-20,19
Brondby,6713,1,21,5,4,69,32,37,68
FC Midtjylla,6713,2,20,4,6,66,37,29,64
Copenhagen,6713,3,15,4,11,60,41,19,49
FC Nords,6713,4,14,6,10,71,53,18,48
AaB,6713,5,8,11,11,37,43,-6,35
AC Horsens,6713,6,7,12,11,35,58,-23,33
Sonderjyske,6713,7,8,6,10,28,29,-1,30
Lyngby,6713,8,4,9,11,28,45,-17,21
Randers FC,6713,9,5,6,13,24,41,-17,21
Silkeborg IF,6713,10,6,3,13,26,44,-18,21
AGF Aarhus,6713,11,4,6,12,16,37,-21,18
Brondby,6714,1,21,6,3,69,29,40,69
FC Midtjylla,6714,2,19,6,5,73,41,32,63
Copenhagen,6714,3,14,6,10,59,42,17,48
FC Nords,6714,4,13,7,10,70,54,16,46
AC Horsens,6714,5,7,13,10,36,54,-18,34
AaB,6714,6,7,12,11,35,48,-13,33
Sonderjyske,6714,7,8,6,10,28,29,-1,30
Randers FC,6714,8,6,6,12,24,39,-15,24
Silkeborg IF,6714,9,6,3,13,27,44,-17,21
Lyngby,6714,10,3,9,12,26,45,-19,18
AGF Aarhus,6714,11,4,6,12,16,38,-22,18
Brondby,6715,1,21,6,3,72,34,38,69
FC Midtjylla,6715,2,21,5,4,70,41,29,68
FC Nords,6715,3,14,6,10,74,55,19,48
Copenhagen,6715,4,14,5,11,58,45,13,47
AaB,6715,5,7,11,12,39,45,-6,32
AC Horsens,6715,6,6,13,11,37,56,-19,31
Sonderjyske,6715,7,8,6,10,28,29,-1,30
Lyngby,6715,8,4,9,11,28,45,-17,21
Randers FC,6715,9,5,6,13,24,41,-17,21
AGF Aarhus,6715,10,5,6,11,19,37,-18,21
Silkeborg IF,6715,11,5,3,14,26,47,-21,18
Brondby,6716,1,20,5,5,67,33,34,65
FC Midtjylla,6716,2,19,5,6,60,37,23,62
FC Nords,6716,3,15,7,8,71,48,23,52
Copenhagen,6716,4,14,5,11,57,43,14,47
AaB,6716,5,7,14,9,39,41,-2,35
AC Horsens,6716,6,7,12,11,37,55,-18,33
Sonderjyske,6716,7,8,6,10,28,29,-1,30
Silkeborg IF,6716,8,6,3,13,28,44,-16,21
Lyngby,6716,9,4,9,11,28,45,-17,21
Randers FC,6716,10,5,6,13,24,41,-17,21
AGF Aarhus,6716,11,4,6,12,16,39,-23,18
FC Midtjylla,6717,1,22,4,4,74,34,40,70
Brondby,6717,2,20,7,3,67,32,35,67
FC Nords,6717,3,13,6,11,72,55,17,45
Copenhagen,6717,4,13,5,12,57,51,6,44
AaB,6717,5,9,11,10,37,41,-4,38
AC Horsens,6717,6,6,13,11,34,54,-20,31
Sonderjyske,6717,7,8,6,10,28,29,-1,30
Randers FC,6717,8,6,6,12,25,39,-14,24
Silkeborg IF,6717,9,5,4,13,26,45,-19,19
AGF Aarhus,6717,10,4,7,11,17,37,-20,19
Lyngby,6717,11,3,9,12,26,46,-20,18
FC Midtjylla,6718,1,21,5,4,67,38,29,68
Brondby,6718,2,20,7,3,74,30,44,67
Copenhagen,6718,3,14,6,10,59,46,13,48
FC Nords,6718,4,13,8,9,73,53,20,47
AaB,6718,5,7,12,11,37,48,-11,33
Sonderjyske,6718,6,8,6,10,28,29,-1,30
AC Horsens,6718,7,5,14,11,36,57,-21,29
Randers FC,6718,8,5,7,12,24,40,-16,22
Lyngby,6718,9,3,10,11,27,45,-18,19
Silkeborg IF,6718,10,5,4,13,26,45,-19,19
AGF Aarhus,6718,11,4,7,11,17,37,-20,19
Brondby,6719,1,21,6,3,69,30,39,69
FC Midtjylla,6719,2,19,4,7,65,43,22,61
FC Nords,6719,3,14,7,9,73,52,21,49
Copenhagen,6719,4,14,5,11,60,46,14,47
AaB,6719,5,8,12,10,39,42,-3,36
AC Horsens,6719,6,7,12,11,34,53,-19,33
Sonderjyske,6719,7,8,6,10,28,29,-1,30
Silkeborg IF,6719,8,6,3,13,28,45,-17,21
Lyngby,6719,9,4,9,11,27,44,-17,21
Randers FC,6719,10,5,6,13,23,40,-17,21
AGF Aarhus,6719,11,4,6,12,17,39,-22,18
Brondby,6720,1,22,5,3,77,32,45,71
FC Midtjylla,6720,2,19,5,6,67,42,25,62
Copenhagen,6720,3,15,4,11,59,45,14,49
FC Nords,6720,4,14,6,10,75,59,16,48
AaB,6720,5,9,12,9,40,41,-1,39
Sonderjyske,6720,6,8,6,10,28,29,-1,30
AC Horsens,6720,7,5,12,13,33,58,-25,27
Lyngby,6720,8,4,9,11,27,44,-17,21
Randers FC,6720,9,5,6,13,23,40,-17,21
Silkeborg IF,6720,10,6,3,13,26,44,-18,21
AGF Aarhus,6720,11,4,6,12,16,37,-21,18
Brondby,6721,1,22,5,3,71,32,39,71
FC Midtjylla,6721,2,20,4,6,65,36,29,64
FC Nords,6721,3,15,6,9,72,47,25,51
Copenhagen,6721,4,14,4,12,56,47,9,46
AaB,6721,5,8,12,10,37,41,-4,36
Sonderjyske,6721,6,8,6,10,28,29,-1,30
AC Horsens,6721,7,5,13,12,32,56,-24,28
Randers FC,6721,8,5,7,12,24,40,-16,22
Lyngby,6721,9,3,10,11,27,45,-18,19
Silkeborg IF,6721,10,5,4,13,26,45,-19,19
AGF Aarhus,6721,11,4,7,11,17,37,-20,19
Brondby,6722,1,22,6,2,77,32,45,72
FC Midtjylla,6722,2,17,7,6,65,44,21,58
FC Nords,6722,3,14,8,8,74,52,22,50
Copenhagen,6722,4,14,6,10,59,46,13,48
AaB,6722,5,7,12,11,37,47,-10,33
AC Horsens,6722,6,6,13,11,36,53,-17,31
Sonderjyske,6722,7,8,6,10,28,29,-1,30
Lyngby,6722,8,4,9,11,30,44,-14,21
Silkeborg IF,6722,9,6,3,13,28,44,-16,21
Randers FC,6722,10,5,6,13,23,43,-20,21
AGF Aarhus,6722,11,4,6,12,16,39,-23,18
Brondby,6723,1,21,6,3,74,30,44,69
FC Midtjylla,6723,2,19,5,6,65,42,23,62
Copenhagen,6723,3,14,5,11,57,46,11,47
FC Nords,6723,4,12,8,10,72,56,16,44
AaB,6723,5,8,13,9,36,38,-2,37
AC Horsens,6723,6,7,13,10,38,56,-18,34
Sonderjyske,6723,7,8,6,10,28,29,-1,30
Lyngby,6723,8,4,9,11,28,44,-16,21
Silkeborg IF,6723,9,6,3,13,26,44,-18,21
Randers FC,6723,10,5,6,13,23,41,-18,21
AGF Aarhus,6723,11,4,6,12,16,37,-21,18
Brondby,6724,1,20,7,3,70,35,35,67
FC Midtjylla,6724,2,20,5,5,67,37,30,65
FC Nords,6724,3,13,7,10,70,54,16,46
Copenhagen,6724,4,13,5,12,56,45,11,44
AaB,6724,5,9,12,9,41,43,-2,39
AC Horsens,6724,6,7,12,11,35,51,-16,33
Sonderjyske,6724,7,8,6,10,28,29,-1,30
Randers FC,6724,8,5,7,12,24,40,-16,22
Lyngby,6724,9,3,10,11,27,45,-18,19
Silkeborg IF,6724,10,5,4,13,27,46,-19,19
AGF Aarhus,6724,11,4,7,11,18,38,-20,19
Brondby,6725,1,22,6,2,74,29,45,72
FC Midtjylla,6725,2,19,6,5,63,37,26,63
FC Nords,6725,3,15,7,8,72,50,22,52
Copenhagen,6725,4,13,5,12,54,45,9,44
AaB,6725,5,7,12,11,34,42,-8,33
Sonderjyske,6725,6,8,6,10,28,29,-1,30
AC Horsens,6725,7,5,14,11,32,52,-20,29
Randers FC,6725,8,5,7,12,24,40,-16,22
AGF Aarhus,6725,9,5,6,11,18,37,-19,21
Lyngby,6725,10,3,10,11,27,45,-18,19
Silkeborg IF,6725,11,5,3,14,26,46,-20,18
FC Midtjylla,6726,1,21,4,5,77,42,35,67
Brondby,6726,2,19,7,4,69,36,33,64
FC Nords,6726,3,15,6,9,77,55,22,51
Copenhagen,6726,4,14,5,11,62,49,13,47
AaB,6726,5,7,13,10,41,50,-9,34
AC Horsens,6726,6,6,13,11,37,57,-20,31
Sonderjyske,6726,7,8,6,10,28,29,-1,30
Randers FC,6726,8,6,6,12,25,39,-14,24
Silkeborg IF,6726,9,5,4,13,27,46,-19,19
AGF Aarhus,6726,10,4,7,11,18,38,-20,19
Lyngby,6726,11,3,9,12,26,46,-20,18
Brondby,6727,1,21,7,2,72,30,42,70
FC Midtjylla,6727,2,19,6,5,65,37,28,63
Copenhagen,6727,3,14,5,11,60,48,12,47
FC Nords,6727,4,12,7,11,71,56,15,43
AaB,6727,5,8,12,10,40,45,-5,36
AC Horsens,6727,6,7,13,10,36,54,-18,34
Sonderjyske,6727,7,8,6,10,28,29,-1,30
Lyngby,6727,8,4,9,11,27,44,-17,21
Randers FC,6727,9,5,6,13,23,40,-17,21
Silkeborg IF,6727,10,6,3,13,26,44,-18,21
AGF Aarhus,6727,11,4,6,12,16,37,-21,18
Brondby,6728,1,21,5,4,71,35,36,68
FC Midtjylla,6728,2,19,4,7,67,43,24,61
Copenhagen,6728,3,15,5,10,63,42,21,50
FC Nords,6728,4,12,9,9,69,54,15,45
AC Horsens,6728,5,8,13,9,37,51,-14,37
AaB,6728,6,7,12,11,34,42,-8,33
Sonderjyske,6728,7,8,6,10,28,29,-1,30
Lyngby,6728,8,4,9,11,29,46,-17,21
Randers FC,6728,9,5,6,13,25,42,-17,21
Silkeborg IF,6728,10,6,3,13,27,45,-18,21
AGF Aarhus,6728,11,4,6,12,17,38,-21,18
Brondby,6729,1,21,6,3,71,32,39,69
FC Midtjylla,6729,2,19,5,6,65,36,29,62
FC Nords,6729,3,15,7,8,72,47,25,52
Copenhagen,6729,4,14,5,11,56,44,12,47
AaB,6729,5,8,11,11,33,41,-8,35
Sonderjyske,6729,6,8,6,10,28,29,-1,30
AC Horsens,6729,7,6,12,12,34,57,-23,30
Randers FC,6729,8,5,7,12,24,40,-16,22
Silkeborg IF,6729,9,6,3,13,26,44,-18,21
Lyngby,6729,10,3,10,11,27,45,-18,19
AGF Aarhus,6729,11,4,6,12,16,37,-21,18
Brondby,6730,1,21,7,2,73,30,43,70
FC Midtjylla,6730,2,19,5,6,62,38,24,62
FC Nords,6730,3,15,6,9,75,50,25,51
Copenhagen,6730,4,15,6,9,58,42,16,51
Sonderjyske,6730,5,8,6,10,28,29,-1,30
AaB,6730,6,6,12,12,35,47,-12,30
AC Horsens,6730,7,6,12,12,33,55,-22,30
Lyngby,6730,8,4,9,11,28,45,-17,21
Randers FC,6730,9,5,6,13,24,41,-17,21
Silkeborg IF,6730,10,5,4,13,26,45,-19,19
AGF Aarhus,6730,11,4,7,11,17,37,-20,19
Brondby,6731,1,22,6,2,72,29,43,72
FC Midtjylla,6731,2,19,6,5,67,37,30,63
FC Nords,6731,3,13,7,10,71,54,17,46
Copenhagen,6731,4,13,5,12,55,47,8,44
AaB,6731,5,8,12,10,39,44,-5,36
AC Horsens,6731,6,6,14,10,36,55,-19,32
Sonderjyske,6731,7,8,6,10,28,29,-1,30
Randers FC,6731,8,6,6,12,26,39,-13,24
Silkeborg IF,6731,9,5,4,13,25,44,-19,19
AGF Aarhus,6731,10,4,7,11,16,36,-20,19
Lyngby,6731,11,3,9,12,26,47,-21,18
Brondby,6732,1,22,6,2,76,27,49,72
FC Midtjylla,6732,2,20,4,6,68,39,29,64
FC Nords,6732,3,13,8,9,70,55,15,47
Copenhagen,6732,4,14,4,12,58,49,9,46
AaB,6732,5,7,13,10,33,41,-8,34
AC Horsens,6732,6,6,13,11,36,56,-20,31
Sonderjyske,6732,7,8,6,10,28,29,-1,30
Randers FC,6732,8,5,7,12,23,39,-16,22
AGF Aarhus,6732,9,5,6,11,19,37,-18,21
Lyngby,6732,10,3,10,11,26,44,-18,19
Silkeborg IF,6732,11,5,3,14,26,47,-21,18
FC Midtjylla,6733,1,21,5,4,71,34,37,68
Brondby,6733,2,18,10,2,65,30,35,64
FC Nords,6733,3,14,8,8,73,57,16,50
Copenhagen,6733,4,14,5,11,57,43,14,47
AC Horsens,6733,5,6,14,10,35,51,-16,32
Sonderjyske,6733,6,8,6,10,28,29,-1,30
AaB,6733,7,6,12,12,36,48,-12,30
Randers FC,6733,8,6,6,12,25,40,-15,24
Silkeborg IF,6733,9,6,3,13,27,45,-18,21
Lyngby,6733,10,3,9,12,27,46,-19,18
AGF Aarhus,6733,11,4,6,12,17,38,-21,18
Brondby,6734,1,21,7,2,77,31,46,70
FC Midtjylla,6734,2,19,5,6,67,37,30,62
FC Nords,6734,3,14,7,9,76,55,21,49
Copenhagen,6734,4,13,4,13,57,52,5,43
AaB,6734,5,8,12,10,37,43,-6,36
AC Horsens,6734,6,7,13,10,35,57,-22,34
Sonderjyske,6734,7,8,6,10,28,29,-1,30
Randers FC,6734,8,5,7,12,24,40,-16,22
Silkeborg IF,6734,9,6,3,13,27,44,-17,21
Lyngby,6734,10,3,10,11,27,45,-18,19
AGF Aarhus,6734,11,4,6,12,16,38,-22,18
Brondby,6735,1,23,5,2,72,30,42,74
FC Midtjylla,6735,2,20,4,6,65,37,28,64
Copenhagen,6735,3,14,5,11,57,45,12,47
FC Nords,6735,4,13,7,10,71,54,17,46
AaB,6735,5,8,12,10,41,46,-5,36
Sonderjyske,6735,6,8,6,10,28,29,-1,30
AC Horsens,6735,7,5,13,12,34,54,-20,28
Randers FC,6735,8,5,7,12,24,40,-16,22
AGF Aarhus,6735,9,5,6,11,17,36,-19,21
Lyngby,6735,10,3,10,11,27,45,-18,19
Silkeborg IF,6735,11,5,3,14,25,45,-20,18
Brondby,6736,1,23,5,2,71,28,43,74
FC Midtjylla,6736,2,19,4,7,62,38,24,61
FC Nords,6736,3,14,7,9,75,52,23,49
Copenhagen,6736,4,14,6,10,59,43,16,48
AaB,6736,5,7,11,12,35,46,-11,32
AC Horsens,6736,6,6,13,11,32,53,-21,31
Sonderjyske,6736,7,8,6,10,28,29,-1,30
Lyngby,6736,8,4,9,11,27,44,-17,21
Randers FC,6736,9,5,6,13,23,40,-17,21
AGF Aarhus,6736,10,5,6,11,17,36,-19,21
Silkeborg IF,6736,11,5,3,14,25,45,-20,18
Brondby,6737,1,21,5,4,73,38,35,68
FC Midtjylla,6737,2,20,5,5,69,36,33,65
FC Nords,6737,3,15,7,8,77,57,20,52
Copenhagen,6737,4,14,5,11,60,44,16,47
AC Horsens,6737,5,7,12,11,35,53,-18,33
Sonderjyske,6737,6,8,6,10,28,29,-1,30
AaB,6737,7,6,12,12,39,51,-12,30
Randers FC,6737,8,5,7,12,23,39,-16,22
AGF Aarhus,6737,9,5,6,11,17,36,-19,21
Lyngby,6737,10,3,10,11,26,44,-18,19
Silkeborg IF,6737,11,5,3,14,25,45,-20,18
FC Midtjylla,6738,1,21,5,4,64,33,31,68
Brondby,6738,2,20,5,5,65,34,31,65
FC Nords,6738,3,14,6,10,71,49,22,48
Copenhagen,6738,4,14,5,11,57,44,13,47
AaB,6738,5,8,11,11,36,40,-4,35
AC Horsens,6738,6,7,12,11,33,52,-19,33
Sonderjyske,6738,7,8,6,10,28,29,-1,30
Lyngby,6738,8,4,9,11,33,45,-12,21
Silkeborg IF,6738,9,6,3,13,26,44,-18,21
Randers FC,6738,10,5,6,13,24,46,-22,21
AGF Aarhus,6738,11,4,6,12,16,37,-21,18
Brondby,6739,1,21,5,4,71,34,37,68
FC Midtjylla,6739,2,19,4,7,68,44,24,61
FC Nords,6739,3,14,7,9,71,52,19,49
Copenhagen,6739,4,15,4,11,58,42,16,49
AaB,6739,5,7,13,10,38,47,-9,34
AC Horsens,6739,6,7,13,10,37,50,-13,34
Sonderjyske,6739,7,8,6,10,28,29,-1,30
Randers FC,6739,8,6,6,12,24,39,-15,24
Silkeborg IF,6739,9,6,3,13,26,44,-18,21
Lyngby,6739,10,3,9,12,26,45,-19,18
AGF Aarhus,6739,11,4,6,12,16,37,-21,18
Brondby,6740,1,21,5,4,70,34,36,68
FC Midtjylla,6740,2,20,5,5,69,35,34,65
Copenhagen,6740,3,16,5,9,62,42,20,53
FC Nords,6740,4,14,6,10,70,53,17,48
AaB,6740,5,7,12,11,36,45,-9,33
Sonderjyske,6740,6,8,6,10,28,29,-1,30
AC Horsens,6740,7,5,13,12,32,56,-24,28
Randers FC,6740,8,5,7,12,25,41,-16,22
AGF Aarhus,6740,9,5,6,11,19,37,-18,21
Lyngby,6740,10,3,10,11,28,46,-18,19
Silkeborg IF,6740,11,5,3,14,26,47,-21,18
Brondby,6741,1,23,5,2,72,30,42,74
FC Midtjylla,6741,2,19,6,5,62,37,25,63
FC Nords,6741,3,12,10,8,69,49,20,46
Copenhagen,6741,4,13,6,11,56,42,14,45
AaB,6741,5,6,14,10,34,41,-7,32
AC Horsens,6741,6,6,13,11,35,55,-20,31
Sonderjyske,6741,7,8,6,10,28,29,-1,30
Lyngby,6741,8,4,9,11,27,44,-17,21
Randers FC,6741,9,5,6,13,23,40,-17,21
Silkeborg IF,6741,10,6,3,13,26,44,-18,21
AGF Aarhus,6741,11,4,6,12,16,37,-21,18
Brondby,6742,1,20,8,2,69,31,38,68
FC Midtjylla,6742,2,21,5,4,69,37,32,68
FC Nords,6742,3,13,7,10,74,51,23,46
Copenhagen,6742,4,13,7,10,57,46,11,46
AaB,6742,5,7,13,10,35,41,-6,34
Sonderjyske,6742,6,8,6,10,28,29,-1,30
AC Horsens,6742,7,5,14,11,31,55,-24,29
Randers FC,6742,8,6,6,12,24,39,-15,24
Silkeborg IF,6742,9,6,3,13,27,44,-17,21
Lyngby,6742,10,3,9,12,26,45,-19,18
AGF Aarhus,6742,11,4,6,12,16,38,-22,18
Brondby,6743,1,21,6,3,69,31,38,69
FC Midtjylla,6743,2,19,5,6,65,39,26,62
FC Nords,6743,3,16,6,8,80,51,29,54
Copenhagen,6743,4,13,5,12,60,51,9,44
AaB,6743,5,8,12,10,36,41,-5,36
Sonderjyske,6743,6,8,6,10,28,29,-1,30
AC Horsens,6743,7,6,12,12,32,55,-23,30
Lyngby,6743,8,4,9,11,28,44,-16,21
Randers FC,6743,9,5,6,13,23,41,-18,21
Silkeborg IF,6743,10,5,4,13,26,45,-19,19
AGF Aarhus,6743,11,4,7,11,17,37,-20,19
Brondby,6744,1,21,7,2,79,32,47,70
FC Midtjylla,6744,2,20,4,6,67,39,28,64
FC Nords,6744,3,15,6,9,73,54,19,51
Copenhagen,6744,4,13,7,10,57,44,13,46
AaB,6744,5,7,12,11,33,45,-12,33
Sonderjyske,6744,6,8,6,10,28,29,-1,30
AC Horsens,6744,7,5,14,11,29,50,-21,29
Silkeborg IF,6744,8,6,3,13,28,44,-16,21
Lyngby,6744,9,4,9,11,28,45,-17,21
Randers FC,6744,10,5,6,13,24,41,-17,21
AGF Aarhus,6744,11,4,6,12,16,39,-23,18
Brondby,6745,1,21,6,3,73,37,36,69
FC Midtjylla,6745,2,21,5,4,72,35,37,68
Copenhagen,6745,3,15,4,11,63,46,17,49
FC Nords,6745,4,13,7,10,73,58,15,46
AaB,6745,5,7,11,12,35,48,-13,32
AC Horsens,6745,6,6,13,11,36,54,-18,31
Sonderjyske,6745,7,8,6,10,28,29,-1,30
Lyngby,6745,8,4,9,11,29,44,-15,21
Randers FC,6745,9,5,6,13,23,42,-19,21
Silkeborg IF,6745,10,5,4,13,27,46,-19,19
AGF Aarhus,6745,11,4,7,11,18,38,-20,19
Brondby,6746,1,20,7,3,67,31,36,67
FC Midtjylla,6746,2,20,5,5,65,37,28,65
Copenhagen,6746,3,15,5,10,59,42,17,50
FC Nords,6746,4,14,7,9,74,51,23,49
AaB,6746,5,8,11,11,38,48,-10,35
Sonderjyske,6746,6,8,6,10,28,29,-1,30
AC Horsens,6746,7,5,13,12,34,54,-20,28
Randers FC,6746,8,5,7,12,25,41,-16,22
Silkeborg IF,6746,9,6,3,13,30,44,-14,21
Lyngby,6746,10,3,10,11,28,46,-18,19
AGF Aarhus,6746,11,4,6,12,16,41,-25,18
Brondby,6747,1,20,6,4,70,33,37,66
FC Midtjylla,6747,2,20,6,4,65,35,30,66
FC Nords,6747,3,15,8,7,76,50,26,53
Copenhagen,6747,4,12,6,12,54,49,5,42
AaB,6747,5,8,11,11,37,43,-6,35
AC Horsens,6747,6,6,13,11,34,52,-18,31
Sonderjyske,6747,7,8,6,10,28,29,-1,30
Silkeborg IF,6747,8,6,3,13,28,44,-16,21
Lyngby,6747,9,4,9,11,29,46,-17,21
Randers FC,6747,10,5,6,13,25,42,-17,21
AGF Aarhus,6747,11,4,6,12,16,39,-23,18
Brondby,6748,1,20,7,3,69,34,35,67
FC Midtjylla,6748,2,19,6,5,64,39,25,63
FC Nords,6748,3,14,7,9,72,51,21,49
Copenhagen,6748,4,13,5,12,56,47,9,44
AC Horsens,6748,5,8,14,8,36,45,-9,38
AaB,6748,6,6,13,11,35,42,-7,31
Sonderjyske,6748,7,8,6,10,28,29,-1,30
Lyngby,6748,8,4,9,11,28,44,-16,21
Silkeborg IF,6748,8,6,3,13,28,44,-16,21
Randers FC,6748,10,5,6,13,23,41,-18,21
AGF Aarhus,6748,11,4,6,12,16,39,-23,18
Brondby,6749,1,21,6,3,76,35,41,69
FC Midtjylla,6749,2,19,6,5,66,43,23,63
Copenhagen,6749,3,14,6,10,59,44,15,48
FC Nords,6749,4,13,8,9,71,53,18,47
AaB,6749,5,8,12,10,39,42,-3,36
Sonderjyske,6749,6,8,6,10,28,29,-1,30
AC Horsens,6749,7,5,14,11,35,55,-20,29
Randers FC,6749,8,5,7,12,23,39,-16,22
Silkeborg IF,6749,9,6,3,13,27,44,-17,21
Lyngby,6749,10,3,10,11,26,44,-18,19
AGF Aarhus,6749,11,4,6,12,16,38,-22,18
Brondby,6750,1,21,6,3,71,32,39,69
FC Midtjylla,6750,2,19,5,6,66,39,27,62
Copenhagen,6750,3,15,6,9,60,40,20,51
FC Nords,6750,4,13,8,9,72,58,14,47
AC Horsens,6750,5,7,13,10,37,52,-15,34
Sonderjyske,6750,6,8,6,10,28,29,-1,30
AaB,6750,7,6,12,12,37,48,-11,30
Randers FC,6750,8,5,7,12,23,39,-16,22
AGF Aarhus,6750,9,5,6,11,20,37,-17,21
Lyngby,6750,10,3,10,11,26,44,-18,19
Silkeborg IF,6750,11,5,3,14,26,48,-22,18
Brondby,6751,1,22,6,2,76,34,42,72
FC Midtjylla,6751,2,19,4,7,68,41,27,61
Copenhagen,6751,3,15,4,11,59,45,14,49
FC Nords,6751,4,13,6,11,70,54,16,45
AC Horsens,6751,5,8,13,9,42,56,-14,37
AaB,6751,6,7,11,12,38,49,-11,32
Sonderjyske,6751,7,8,6,10,28,29,-1,30
Lyngby,6751,8,4,9,11,30,47,-17,21
Randers FC,6751,9,5,6,13,26,43,-17,21
Silkeborg IF,6751,10,6,3,13,26,44,-18,21
AGF Aarhus,6751,11,4,6,12,16,37,-21,18
Brondby,6752,1,21,6,3,77,36,41,69
FC Midtjylla,6752,2,20,4,6,69,41,28,64
Copenhagen,6752,3,14,5,11,58,44,14,47
FC Nords,6752,4,13,7,10,72,57,15,46
AaB,6752,5,8,12,10,35,41,-6,36
AC Horsens,6752,6,7,12,11,35,53,-18,33
Sonderjyske,6752,7,8,6,10,28,29,-1,30
Randers FC,6752,8,6,6,12,25,39,-14,24
AGF Aarhus,6752,9,5,6,11,18,36,-18,21
Lyngby,6752,10,3,9,12,26,46,-20,18
Silkeborg IF,6752,11,5,3,14,25,46,-21,18
Brondby,6753,1,20,6,4,72,35,37,66
FC Midtjylla,6753,2,20,5,5,69,40,29,65
Copenhagen,6753,3,15,6,9,58,41,17,51
FC Nords,6753,4,12,9,9,73,55,18,45
AaB,6753,5,8,12,10,37,43,-6,36
Sonderjyske,6753,6,8,6,10,28,29,-1,30
AC Horsens,6753,7,5,14,11,35,56,-21,29
Lyngby,6753,8,4,9,11,29,45,-16,21
Randers FC,6753,9,5,6,13,24,42,-18,21
Silkeborg IF,6753,10,5,4,13,26,45,-19,19
AGF Aarhus,6753,11,4,7,11,17,37,-20,19
Brondby,6754,1,22,5,3,71,29,42,71
FC Midtjylla,6754,2,20,5,5,64,36,28,65
FC Nords,6754,3,14,6,10,69,52,17,48
Copenhagen,6754,4,14,5,11,56,42,14,47
AaB,6754,5,7,11,12,37,47,-10,32
AC Horsens,6754,6,6,14,10,36,53,-17,32
Sonderjyske,6754,7,8,6,10,28,29,-1,30
Lyngby,6754,8,4,9,11,28,44,-16,21
Silkeborg IF,6754,9,6,3,13,27,44,-17,21
Randers FC,6754,10,5,6,13,23,41,-18,21
AGF Aarhus,6754,11,4,6,12,16,38,-22,18
Brondby,6755,1,20,6,4,67,34,33,66
FC Midtjylla,6755,2,19,6,5,64,38,26,63
FC Nords,6755,3,14,7,9,73,53,20,49
Copenhagen,6755,4,14,6,10,57,42,15,48
AC Horsens,6755,5,8,14,8,41,49,-8,38
Sonderjyske,6755,6,8,6,10,28,29,-1,30
AaB,6755,7,6,11,13,32,44,-12,29
Lyngby,6755,8,4,9,11,29,46,-17,21
Randers FC,6755,9,5,6,13,25,42,-17,21
AGF Aarhus,6755,10,5,6,11,18,37,-19,21
Silkeborg IF,6755,11,5,3,14,26,46,-20,18
Brondby,6756,1,20,6,4,69,36,33,66
FC Midtjylla,6756,2,20,5,5,63,37,26,65
Copenhagen,6756,3,16,4,10,57,38,19,52
FC Nords,6756,4,14,7,9,73,51,22,49
AaB,6756,5,6,15,9,37,42,-5,33
Sonderjyske,6756,6,8,6,10,28,29,-1,30
AC Horsens,6756,7,5,13,12,32,53,-21,28
Randers FC,6756,8,5,7,12,23,39,-16,22
Silkeborg IF,6756,9,6,3,13,27,45,-18,21
Lyngby,6756,10,3,10,11,26,44,-18,19
AGF Aarhus,6756,11,4,6,12,17,38,-21,18
Brondby,6757,1,20,7,3,73,39,34,67
FC Midtjylla,6757,2,19,6,5,67,42,25,63
FC Nords,6757,3,14,7,9,77,52,25,49
Copenhagen,6757,4,14,7,9,62,44,18,49
AaB,6757,5,8,12,10,38,43,-5,36
Sonderjyske,6757,6,8,6,10,28,29,-1,30
AC Horsens,6757,7,5,13,12,31,54,-23,28
Randers FC,6757,8,5,7,12,23,39,-16,22
AGF Aarhus,6757,9,5,6,11,18,37,-19,21
Lyngby,6757,10,3,10,11,26,44,-18,19
Silkeborg IF,6757,11,5,3,14,26,46,-20,18
Brondby,6758,1,21,6,3,75,33,42,69
FC Midtjylla,6758,2,19,6,5,63,38,25,63
FC Nords,6758,3,14,7,9,71,54,17,49
Copenhagen,6758,4,14,4,12,57,46,11,46
AC Horsens,6758,5,6,15,9,33,48,-15,33
AaB,6758,6,6,14,10,34,40,-6,32
Sonderjyske,6758,7,8,6,10,28,29,-1,30
Randers FC,6758,8,5,7,12,24,40,-16,22
AGF Aarhus,6758,9,5,6,11,18,37,-19,21
Lyngby,6758,10,3,10,11,27,45,-18,19
Silkeborg IF,6758,11,5,3,14,26,46,-20,18
Brondby,6759,1,20,7,3,68,33,35,67
FC Midtjylla,6759,2,19,5,6,63,40,23,62
FC Nords,6759,3,15,6,9,72,49,23,51
Copenhagen,6759,4,14,6,10,60,45,15,48
AaB,6759,5,8,11,11,34,39,-5,35
AC Horsens,6759,6,6,13,11,35,52,-17,31
Sonderjyske,6759,7,8,6,10,28,29,-1,30
Silkeborg IF,6759,8,6,3,13,30,45,-15,21
Lyngby,6759,9,4,9,11,29,46,-17,21
Randers FC,6759,10,5,6,13,25,42,-17,21
AGF Aarhus,6759,11,4,6,12,17,41,-24,18
Brondby,6760,1,21,6,3,69,30,39,69
FC Midtjylla,6760,2,19,6,5,63,37,26,63
FC Nords,6760,3,13,9,8,72,53,19,48
Copenhagen,6760,4,13,4,13,57,47,10,43
AaB,6760,5,7,14,9,35,39,-4,35
AC Horsens,6760,6,6,15,9,36,52,-16,33
Sonderjyske,6760,7,8,6,10,28,29,-1,30
Randers FC,6760,8,6,6,12,26,41,-15,24
Silkeborg IF,6760,9,5,4,13,26,45,-19,19
AGF Aarhus,6760,10,4,7,11,17,37,-20,19
Lyngby,6760,11,3,9,12,28,47,-19,18
Brondby,6761,1,20,6,4,70,33,37,66
FC Midtjylla,6761,2,19,4,7,65,42,23,61
FC Nords,6761,3,14,8,8,73,49,24,50
Copenhagen,6761,4,14,5,11,55,46,9,47
AaB,6761,5,8,13,9,40,38,2,37
AC Horsens,6761,6,7,12,11,33,54,-21,33
Sonderjyske,6761,7,8,6,10,28,29,-1,30
Randers FC,6761,8,5,7,12,23,39,-16,22
Silkeborg IF,6761,9,6,3,13,28,46,-18,21
Lyngby,6761,10,3,10,11,26,44,-18,19
AGF Aarhus,6761,11,4,6,12,18,39,-21,18
Brondby,6762,1,20,7,3,69,31,38,67
FC Midtjylla,6762,2,19,5,6,65,40,25,62
FC Nords,6762,3,14,7,9,74,53,21,49
Copenhagen,6762,4,14,5,11,59,45,14,47
AaB,6762,5,8,12,10,37,44,-7,36
AC Horsens,6762,6,7,12,11,36,53,-17,33
Sonderjyske,6762,7,8,6,10,28,29,-1,30
Lyngby,6762,8,4,9,11,27,44,-17,21
Randers FC,6762,9,5,6,13,23,40,-17,21
AGF Aarhus,6762,10,5,6,11,19,37,-18,21
Silkeborg IF,6762,11,5,3,14,26,47,-21,18
FC Midtjylla,6763,1,22,4,4,67,38,29,70
Brondby,6763,2,19,7,4,71,36,35,64
FC Nords,6763,3,13,7,10,68,50,18,46
Copenhagen,6763,4,12,5,13,56,47,9,41
AaB,6763,5,9,12,9,39,41,-2,39
AC Horsens,6763,6,7,13,10,34,49,-15,34
Sonderjyske,6763,7,8,6,10,28,29,-1,30
Randers FC,6763,8,6,6,12,25,40,-15,24
AGF Aarhus,6763,9,5,6,11,18,36,-18,21
Lyngby,6763,10,3,9,12,27,46,-19,18
Silkeborg IF,6763,11,5,3,14,25,46,-21,18
Brondby,6764,1,20,7,3,76,34,42,67
FC Midtjylla,6764,2,19,6,5,63,41,22,63
FC Nords,6764,3,14,6,10,79,58,21,48
Copenhagen,6764,4,14,5,11,58,46,12,47
AaB,6764,5,8,13,9,40,40,0,37
AC Horsens,6764,6,6,13,11,34,57,-23,31
Sonderjyske,6764,7,8,6,10,28,29,-1,30
Lyngby,6764,8,4,9,11,28,45,-17,21
Randers FC,6764,9,5,6,13,24,41,-17,21
AGF Aarhus,6764,10,5,6,11,19,37,-18,21
Silkeborg IF,6764,11,5,3,14,26,47,-21,18
Brondby,6765,1,22,5,3,78,35,43,71
FC Midtjylla,6765,2,20,5,5,67,43,24,65
FC Nords,6765,3,14,6,10,73,55,18,48
Copenhagen,6765,4,14,4,12,62,49,13,46
AaB,6765,5,8,11,11,38,43,-5,35
AC Horsens,6765,6,6,13,11,35,54,-19,31
Sonderjyske,6765,7,8,6,10,28,29,-1,30
Silkeborg IF,6765,8,6,3,13,28,44,-16,21
Lyngby,6765,9,4,9,11,29,46,-17,21
Randers FC,6765,10,5,6,13,25,42,-17,21
AGF Aarhus,6765,11,4,6,12,16,39,-23,18
FC Midtjylla,6766,1,20,5,5,67,39,28,65
Brondby,6766,2,18,7,5,67,36,31,61
FC Nords,6766,3,14,9,7,74,51,23,51
Copenhagen,6766,4,14,5,11,58,43,15,47
AC Horsens,6766,5,7,14,9,37,51,-14,35
AaB,6766,6,7,12,11,33,42,-9,33
Sonderjyske,6766,7,8,6,10,28,29,-1,30
Lyngby,6766,8,4,9,11,30,44,-14,21
Silkeborg IF,6766,9,6,3,13,27,45,-18,21
Randers FC,6766,10,5,6,13,23,43,-20,21
AGF Aarhus,6766,11,4,6,12,17,38,-21,18
Brondby,6767,1,22,5,3,72,30,42,71
FC Midtjylla,6767,2,19,6,5,66,39,27,63
Copenhagen,6767,3,16,4,10,59,41,18,52
FC Nords,6767,4,12,6,12,68,57,11,42
AaB,6767,5,8,12,10,40,44,-4,36
AC Horsens,6767,6,6,13,11,35,55,-20,31
Sonderjyske,6767,7,8,6,10,28,29,-1,30
Lyngby,6767,8,4,9,11,29,46,-17,21
Randers FC,6767,9,5,6,13,25,42,-17,21
AGF Aarhus,6767,10,5,6,11,18,37,-19,21
Silkeborg IF,6767,11,5,3,14,26,46,-20,18
FC Midtjylla,6768,1,21,4,5,69,39,30,67
Brondby,6768,2,19,7,4,69,37,32,64
FC Nords,6768,3,14,7,9,77,52,25,49
Copenhagen,6768,4,13,6,11,61,53,8,45
AaB,6768,5,8,12,10,37,40,-3,36
AC Horsens,6768,6,6,14,10,36,54,-18,32
Sonderjyske,6768,7,8,6,10,28,29,-1,30
Randers FC,6768,8,5,7,12,24,40,-16,22
Lyngby,6768,9,3,10,11,27,45,-18,19
Silkeborg IF,6768,10,5,4,13,25,44,-19,19
AGF Aarhus,6768,11,4,7,11,16,36,-20,19
Brondby,6769,1,22,5,3,78,32,46,71
FC Midtjylla,6769,2,19,4,7,64,44,20,61
FC Nords,6769,3,15,6,9,72,52,20,51
Copenhagen,6769,4,15,4,11,62,47,15,49
AaB,6769,5,9,11,10,39,42,-3,38
Sonderjyske,6769,6,8,6,10,28,29,-1,30
AC Horsens,6769,7,5,12,13,33,57,-24,27
Randers FC,6769,8,6,6,12,25,40,-15,24
Silkeborg IF,6769,9,5,4,13,28,47,-19,19
AGF Aarhus,6769,10,4,7,11,19,39,-20,19
Lyngby,6769,11,3,9,12,27,46,-19,18
Brondby,6770,1,20,6,4,69,35,34,66
FC Midtjylla,6770,2,20,6,4,67,36,31,66
FC Nords,6770,3,14,6,10,73,52,21,48
Copenhagen,6770,4,14,5,11,56,44,12,47
AaB,6770,5,8,11,11,37,43,-6,35
AC Horsens,6770,6,7,12,11,36,54,-18,33
Sonderjyske,6770,7,8,6,10,28,29,-1,30
Lyngby,6770,8,4,9,11,29,46,-17,21
Randers FC,6770,9,5,6,13,25,42,-17,21
Silkeborg IF,6770,10,5,4,13,28,47,-19,19
AGF Aarhus,6770,11,4,7,11,19,39,-20,19
Brondby,6771,1,21,6,3,72,29,43,69
FC Midtjylla,6771,2,19,5,6,68,43,25,62
FC Nords,6771,3,14,8,8,72,52,20,50
Copenhagen,6771,4,14,4,12,57,46,11,46
AaB,6771,5,9,11,10,39,41,-2,38
Sonderjyske,6771,6,8,6,10,28,29,-1,30
AC Horsens,6771,7,6,12,12,32,55,-23,30
Lyngby,6771,8,4,9,11,27,44,-17,21
Randers FC,6771,9,5,6,13,23,40,-17,21
Silkeborg IF,6771,10,6,3,13,29,47,-18,21
AGF Aarhus,6771,11,4,6,12,19,40,-21,18
Brondby,6772,1,22,5,3,71,31,40,71
FC Midtjylla,6772,2,19,4,7,68,46,22,61
Copenhagen,6772,3,14,6,10,58,41,17,48
FC Nords,6772,4,12,8,10,69,53,16,44
AaB,6772,5,8,13,9,39,40,-1,37
AC Horsens,6772,6,6,14,10,31,51,-20,32
Sonderjyske,6772,7,8,6,10,28,29,-1,30
Randers FC,6772,8,5,7,12,24,40,-16,22
Silkeborg IF,6772,9,6,3,13,27,45,-18,21
Lyngby,6772,10,3,10,11,27,45,-18,19
AGF Aarhus,6772,11,4,6,12,17,38,-21,18
Brondby,6773,1,22,6,2,73,30,43,72
FC Midtjylla,6773,2,19,5,6,70,46,24,62
FC Nords,6773,3,14,6,10,74,57,17,48
Copenhagen,6773,4,14,4,12,59,47,12,46
AaB,6773,5,8,11,11,41,50,-9,35
AC Horsens,6773,6,7,12,11,42,55,-13,33
Sonderjyske,6773,7,8,6,10,28,29,-1,30
Lyngby,6773,8,4,9,11,27,44,-17,21
Randers FC,6773,9,5,6,13,23,40,-17,21
Silkeborg IF,6773,10,6,3,13,27,45,-18,21
AGF Aarhus,6773,11,4,6,12,17,38,-21,18
Brondby,6774,1,21,7,2,76,34,42,70
FC Midtjylla,6774,2,20,5,5,76,40,36,65
FC Nords,6774,3,14,7,9,78,57,21,49
Copenhagen,6774,4,13,4,13,54,48,6,43
AC Horsens,6774,5,7,13,10,35,55,-20,34
AaB,6774,6,7,12,11,36,47,-11,33
Sonderjyske,6774,7,8,6,10,28,29,-1,30
Lyngby,6774,8,4,9,11,27,44,-17,21
Randers FC,6774,9,5,6,13,23,40,-17,21
Silkeborg IF,6774,10,5,4,13,26,45,-19,19
AGF Aarhus,6774,11,4,7,11,17,37,-20,19
Brondby,6775,1,21,7,2,72,31,41,70
FC Midtjylla,6775,2,21,4,5,73,39,34,67
FC Nords,6775,3,14,7,9,80,55,25,49
Copenhagen,6775,4,13,5,12,59,49,10,44
AC Horsens,6775,5,7,13,10,37,58,-21,34
Sonderjyske,6775,6,8,6,10,28,29,-1,30
AaB,6775,7,6,12,12,35,50,-15,30
Randers FC,6775,8,5,7,12,25,41,-16,22
Silkeborg IF,6775,9,6,3,13,27,44,-17,21
Lyngby,6775,10,3,10,11,28,46,-18,19
AGF Aarhus,6775,11,4,6,12,16,38,-22,18
Brondby,6776,1,20,6,4,68,35,33,66
FC Midtjylla,6776,2,19,6,5,62,35,27,63
FC Nords,6776,3,14,7,9,73,52,21,49
Copenhagen,6776,4,13,8,9,58,42,16,47
AC Horsens,6776,5,7,13,10,35,51,-16,34
AaB,6776,6,7,12,11,36,43,-7,33
Sonderjyske,6776,7,8,6,10,28,29,-1,30
Randers FC,6776,8,6,6,12,24,39,-15,24
Silkeborg IF,6776,9,6,3,13,30,45,-15,21
Lyngby,6776,10,3,9,12,26,45,-19,18
AGF Aarhus,6776,11,4,6,12,17,41,-24,18
FC Midtjylla,6777,1,21,5,4,66,35,31,68
Brondby,6777,2,20,5,5,67,35,32,65
Copenhagen,6777,3,15,5,10,62,43,19,50
FC Nords,6777,4,14,7,9,80,51,29,49
AC Horsens,6777,5,7,12,11,38,64,-26,33
Sonderjyske,6777,6,8,6,10,28,29,-1,30
AaB,6777,7,6,12,12,35,46,-11,30
Lyngby,6777,8,4,9,11,30,46,-16,21
Silkeborg IF,6777,9,6,3,13,28,44,-16,21
Randers FC,6777,10,5,6,13,25,43,-18,21
AGF Aarhus,6777,11,4,6,12,16,39,-23,18
FC Midtjylla,6778,1,20,4,6,64,39,25,64
Brondby,6778,2,19,6,5,65,32,33,63
FC Nords,6778,3,15,7,8,73,48,25,52
Copenhagen,6778,4,14,5,11,57,48,9,47
AaB,6778,5,8,11,11,40,44,-4,35
AC Horsens,6778,6,7,13,10,38,52,-14,34
Sonderjyske,6778,7,8,6,10,28,29,-1,30
Lyngby,6778,8,4,9,11,29,44,-15,21
Randers FC,6778,9,5,6,13,23,42,-19,21
Silkeborg IF,6778,10,5,4,13,26,45,-19,19
AGF Aarhus,6778,11,4,7,11,17,37,-20,19
FC Midtjylla,6779,1,21,4,5,66,42,24,67
Brondby,6779,2,20,5,5,71,34,37,65
Copenhagen,6779,3,14,6,10,61,44,17,48
FC Nords,6779,4,13,7,10,70,52,18,46
AaB,6779,5,8,13,9,40,44,-4,37
AC Horsens,6779,6,6,13,11,35,53,-18,31
Sonderjyske,6779,7,8,6,10,28,29,-1,30
Randers FC,6779,8,5,7,12,23,39,-16,22
Lyngby,6779,9,3,10,11,26,44,-18,19
Silkeborg IF,6779,10,5,4,13,27,46,-19,19
AGF Aarhus,6779,11,4,7,11,18,38,-20,19
Brondby,6780,1,21,6,3,71,32,39,69
FC Midtjylla,6780,2,18,8,4,65,39,26,62
FC Nords,6780,3,14,8,8,75,50,25,50
Copenhagen,6780,4,13,4,13,57,53,4,43
AaB,6780,5,8,12,10,41,46,-5,36
AC Horsens,6780,6,6,14,10,34,49,-15,32
Sonderjyske,6780,7,8,6,10,28,29,-1,30
Randers FC,6780,8,6,6,12,26,39,-13,24
Silkeborg IF,6780,9,6,3,13,28,45,-17,21
Lyngby,6780,10,3,9,12,26,47,-21,18
AGF Aarhus,6780,11,4,6,12,17,39,-22,18
Brondby,6781,1,22,6,2,75,29,46,72
FC Midtjylla,6781,2,19,7,4,65,38,27,64
Copenhagen,6781,3,14,4,12,54,44,10,46
FC Nords,6781,4,13,6,11,70,57,13,45
AC Horsens,6781,5,8,13,9,34,47,-13,37
Sonderjyske,6781,6,8,6,10,28,29,-1,30
AaB,6781,7,6,12,12,33,42,-9,30
Randers FC,6781,8,6,6,12,25,40,-15,24
Silkeborg IF,6781,9,6,3,13,28,44,-16,21
Lyngby,6781,10,3,9,12,27,46,-19,18
AGF Aarhus,6781,11,4,6,12,16,39,-23,18
Brondby,6782,1,23,5,2,77,31,46,74
FC Midtjylla,6782,2,19,5,6,69,42,27,62
FC Nords,6782,3,13,7,10,69,58,11,46
Copenhagen,6782,4,13,6,11,56,44,12,45
AaB,6782,5,8,13,9,37,39,-2,37
Sonderjyske,6782,6,8,6,10,28,29,-1,30
AC Horsens,6782,7,5,14,11,36,56,-20,29
Silkeborg IF,6782,8,6,3,13,30,46,-16,21
Lyngby,6782,9,4,9,11,29,45,-16,21
Randers FC,6782,10,5,6,13,24,42,-18,21
AGF Aarhus,6782,11,4,6,12,18,41,-23,18
Brondby,6783,1,22,6,2,74,32,42,72
FC Midtjylla,6783,2,19,6,5,70,41,29,63
FC Nords,6783,3,13,9,8,76,55,21,48
Copenhagen,6783,4,12,7,11,58,47,11,43
AaB,6783,5,7,12,11,35,44,-9,33
AC Horsens,6783,6,7,12,11,36,56,-20,33
Sonderjyske,6783,7,8,6,10,28,29,-1,30
Randers FC,6783,8,5,7,12,24,40,-16,22
Silkeborg IF,6783,9,6,3,13,29,45,-16,21
Lyngby,6783,10,3,10,11,27,45,-18,19
AGF Aarhus,6783,11,4,6,12,17,40,-23,18
Brondby,6784,1,21,6,3,70,29,41,69
FC Midtjylla,6784,2,19,4,7,64,43,21,61
FC Nords,6784,3,15,7,8,73,50,23,52
Copenhagen,6784,4,14,4,12,59,48,11,46
AaB,6784,5,7,13,10,34,41,-7,34
AC Horsens,6784,6,7,12,11,36,51,-15,33
Sonderjyske,6784,7,8,6,10,28,29,-1,30
Randers FC,6784,8,6,6,12,24,39,-15,24
AGF Aarhus,6784,9,5,6,11,17,36,-19,21
Lyngby,6784,10,3,9,12,26,45,-19,18
Silkeborg IF,6784,11,5,3,14,25,45,-20,18
Brondby,6785,1,20,7,3,72,33,39,67
FC Midtjylla,6785,2,18,6,6,65,42,23,60
FC Nords,6785,3,15,7,8,71,49,22,52
Copenhagen,6785,4,14,6,10,61,47,14,48
AaB,6785,5,7,13,10,39,44,-5,34
AC Horsens,6785,6,6,13,11,34,53,-19,31
Sonderjyske,6785,7,8,6,10,28,29,-1,30
Lyngby,6785,8,4,9,11,30,44,-14,21
Randers FC,6785,9,5,6,13,23,43,-20,21
Silkeborg IF,6785,10,5,4,13,26,45,-19,19
AGF Aarhus,6785,11,4,7,11,17,37,-20,19
Brondby,6786,1,20,6,4,68,30,38,66
FC Midtjylla,6786,2,19,4,7,60,38,22,61
FC Nords,6786,3,16,7,7,75,47,28,55
Copenhagen,6786,4,14,4,12,56,47,9,46
AaB,6786,5,8,11,11,35,42,-7,35
AC Horsens,6786,6,7,12,11,34,50,-16,33
Sonderjyske,6786,7,8,6,10,28,29,-1,30
Randers FC,6786,8,6,6,12,25,39,-14,24
Silkeborg IF,6786,9,6,3,13,27,44,-17,21
Lyngby,6786,10,3,9,12,26,46,-20,18
AGF Aarhus,6786,11,4,6,12,16,38,-22,18
Brondby,6787,1,20,6,4,70,34,36,66
FC Midtjylla,6787,2,20,5,5,69,37,32,65
FC Nords,6787,3,13,7,10,69,52,17,46
Copenhagen,6787,4,14,4,12,57,50,7,46
AC Horsens,6787,5,9,12,9,42,52,-10,39
AaB,6787,6,6,14,10,34,42,-8,32
Sonderjyske,6787,7,8,6,10,28,29,-1,30
Lyngby,6787,8,4,9,11,28,44,-16,21
Randers FC,6787,9,5,6,13,23,41,-18,21
Silkeborg IF,6787,10,5,4,13,25,44,-19,19
AGF Aarhus,6787,11,4,7,11,16,36,-20,19
Brondby,6788,1,19,8,3,66,32,34,65
FC Midtjylla,6788,2,19,5,6,71,40,31,62
FC Nords,6788,3,14,7,9,74,55,19,49
Copenhagen,6788,4,14,7,9,63,45,18,49
AaB,6788,5,8,13,9,38,42,-4,37
Sonderjyske,6788,6,8,6,10,28,29,-1,30
AC Horsens,6788,7,5,14,11,31,55,-24,29
Randers FC,6788,8,6,6,12,25,39,-14,24
AGF Aarhus,6788,9,5,6,11,18,37,-19,21
Lyngby,6788,10,3,9,12,26,46,-20,18
Silkeborg IF,6788,10,5,3,14,26,46,-20,18
Brondby,6789,1,21,5,4,69,30,39,68
FC Midtjylla,6789,2,19,4,7,60,41,19,61
FC Nords,6789,3,15,7,8,75,50,25,52
Copenhagen,6789,4,14,5,11,62,48,14,47
AC Horsens,6789,5,7,13,10,41,55,-14,34
AaB,6789,6,7,12,11,36,45,-9,33
Sonderjyske,6789,7,8,6,10,28,29,-1,30
Lyngby,6789,8,4,9,11,29,45,-16,21
Randers FC,6789,9,5,6,13,24,42,-18,21
AGF Aarhus,6789,10,5,6,11,19,38,-19,21
Silkeborg IF,6789,11,5,3,14,27,47,-20,18
Brondby,6790,1,19,9,2,71,35,36,66
FC Midtjylla,6790,2,20,6,4,73,40,33,66
Copenhagen,6790,3,14,6,10,59,46,13,48
FC Nords,6790,4,13,7,10,72,51,21,46
AC Horsens,6790,5,6,15,9,37,54,-17,33
AaB,6790,6,6,13,11,36,48,-12,31
Sonderjyske,6790,7,8,6,10,28,29,-1,30
Lyngby,6790,8,4,9,11,27,44,-17,21
Randers FC,6790,9,5,6,13,23,40,-17,21
AGF Aarhus,6790,10,5,6,11,18,37,-19,21
Silkeborg IF,6790,11,5,3,14,26,46,-20,18
Brondby,6791,1,20,6,4,70,34,36,66
FC Midtjylla,6791,2,17,6,7,60,44,16,57
FC Nords,6791,3,14,8,8,75,50,25,50
Copenhagen,6791,4,15,4,11,59,48,11,49
AaB,6791,5,10,11,9,47,43,4,41
AC Horsens,6791,6,6,13,11,33,51,-18,31
Sonderjyske,6791,7,8,6,10,28,29,-1,30
Randers FC,6791,8,6,6,12,25,40,-15,24
Silkeborg IF,6791,9,6,3,13,27,45,-18,21
Lyngby,6791,10,3,9,12,27,46,-19,18
AGF Aarhus,6791,11,4,6,12,17,38,-21,18
Brondby,6792,1,20,5,5,69,35,34,65
FC Midtjylla,6792,2,20,5,5,70,41,29,65
FC Nords,6792,3,14,8,8,75,52,23,50
Copenhagen,6792,4,13,6,11,57,46,11,45
AaB,6792,5,10,11,9,38,40,-2,41
Sonderjyske,6792,6,8,6,10,28,29,-1,30
AC Horsens,6792,7,5,13,12,31,52,-21,28
Randers FC,6792,8,5,7,12,24,40,-16,22
Silkeborg IF,6792,9,6,3,13,29,45,-16,21
Lyngby,6792,10,3,10,11,27,45,-18,19
AGF Aarhus,6792,11,4,6,12,17,40,-23,18
Brondby,6793,1,21,5,4,68,30,38,68
FC Midtjylla,6793,2,21,4,5,67,36,31,67
Copenhagen,6793,3,15,5,10,60,44,16,50
FC Nords,6793,4,14,6,10,72,55,17,48
AaB,6793,5,7,11,12,35,45,-10,32
AC Horsens,6793,6,6,13,11,35,53,-18,31
Sonderjyske,6793,7,8,6,10,28,29,-1,30
Silkeborg IF,6793,8,6,3,13,28,44,-16,21
Lyngby,6793,9,4,9,11,28,45,-17,21
Randers FC,6793,10,5,6,13,24,41,-17,21
AGF Aarhus,6793,11,4,6,12,16,39,-23,18
Brondby,6794,1,22,5,3,74,31,43,71
FC Midtjylla,6794,2,19,5,6,66,39,27,62
FC Nords,6794,3,15,7,8,74,51,23,52
Copenhagen,6794,4,15,4,11,62,46,16,49
AaB,6794,5,7,12,11,36,44,-8,33
Sonderjyske,6794,6,8,6,10,28,29,-1,30
AC Horsens,6794,7,5,13,12,31,58,-27,28
Randers FC,6794,8,6,6,12,25,40,-15,24
Silkeborg IF,6794,9,6,3,13,26,44,-18,21
Lyngby,6794,10,3,9,12,27,46,-19,18
AGF Aarhus,6794,11,4,6,12,16,37,-21,18
Brondby,6795,1,21,5,4,65,28,37,68
FC Midtjylla,6795,2,20,5,5,67,39,28,65
FC Nords,6795,3,15,7,8,76,52,24,52
Copenhagen,6795,4,13,7,10,58,43,15,46
AaB,6795,5,8,12,10,39,42,-3,36
Sonderjyske,6795,6,8,6,10,28,29,-1,30
AC Horsens,6795,7,5,12,13,32,59,-27,27
Lyngby,6795,8,4,9,11,30,44,-14,21
AGF Aarhus,6795,9,5,6,11,18,37,-19,21
Randers FC,6795,10,5,6,13,23,43,-20,21
Silkeborg IF,6795,11,5,3,14,26,46,-20,18
Brondby,6796,1,20,6,4,66,32,34,66
FC Midtjylla,6796,2,18,7,5,65,42,23,61
FC Nords,6796,3,16,6,8,79,50,29,54
Copenhagen,6796,4,13,4,13,56,47,9,43
AC Horsens,6796,5,8,13,9,37,50,-13,37
AaB,6796,6,7,12,11,36,44,-8,33
Sonderjyske,6796,7,8,6,10,28,29,-1,30
Randers FC,6796,8,6,6,12,25,39,-14,24
AGF Aarhus,6796,9,5,6,11,18,36,-18,21
Lyngby,6796,10,3,9,12,26,46,-20,18
Silkeborg IF,6796,11,5,3,14,25,46,-21,18
Brondby,6797,1,19,8,3,68,33,35,65
FC Midtjylla,6797,2,20,5,5,68,39,29,65
FC Nords,6797,3,14,8,8,75,53,22,50
Copenhagen,6797,4,14,7,9,54,38,16,49
AaB,6797,5,7,12,11,33,41,-8,33
Sonderjyske,6797,6,8,6,10,28,29,-1,30
AC Horsens,6797,7,6,12,12,36,56,-20,30
Lyngby,6797,8,4,9,11,30,47,-17,21
Silkeborg IF,6797,9,6,3,13,27,44,-17,21
Randers FC,6797,10,5,6,13,26,43,-17,21
AGF Aarhus,6797,11,4,6,12,16,38,-22,18
FC Midtjylla,6798,1,21,5,4,71,38,33,68
Brondby,6798,2,19,6,5,68,36,32,63
FC Nords,6798,3,15,6,9,74,51,23,51
Copenhagen,6798,4,13,6,11,62,53,9,45
AaB,6798,5,7,13,10,37,42,-5,34
AC Horsens,6798,6,7,12,11,37,55,-18,33
Sonderjyske,6798,7,8,6,10,28,29,-1,30
Lyngby,6798,8,4,9,11,29,45,-16,21
Randers FC,6798,9,5,6,13,24,42,-18,21
Silkeborg IF,6798,10,5,4,13,25,44,-19,19
AGF Aarhus,6798,11,4,7,11,16,36,-20,19
Brondby,6799,1,22,6,2,76,31,45,72
FC Midtjylla,6799,2,20,4,6,68,39,29,64
FC Nords,6799,3,14,7,9,70,52,18,49
Copenhagen,6799,4,14,4,12,57,47,10,46
AaB,6799,5,6,14,10,37,43,-6,32
AC Horsens,6799,6,6,13,11,35,57,-22,31
Sonderjyske,6799,7,8,6,10,28,29,-1,30
Randers FC,6799,8,5,7,12,23,39,-16,22
Silkeborg IF,6799,9,6,3,13,27,45,-18,21
Lyngby,6799,10,3,10,11,26,44,-18,19
AGF Aarhus,6799,11,4,6,12,17,38,-21,18
Brondby,6800,1,22,6,2,71,29,42,72
FC Midtjylla,6800,2,20,4,6,67,40,27,64
FC Nords,6800,3,14,8,8,74,51,23,50
Copenhagen,6800,4,13,5,12,54,42,12,44
AC Horsens,6800,5,7,12,11,34,53,-19,33
AaB,6800,6,7,11,12,38,49,-11,32
Sonderjyske,6800,7,8,6,10,28,29,-1,30
Randers FC,6800,8,5,7,12,24,40,-16,22
Silkeborg IF,6800,9,6,3,13,27,44,-17,21
Lyngby,6800,10,3,10,11,27,45,-18,19
AGF Aarhus,6800,11,4,6,12,16,38,-22,18
FC Midtjylla,6801,1,20,6,4,71,44,27,66
Brondby,6801,2,19,7,4,67,34,33,64
FC Nords,6801,3,14,7,9,78,51,27,49
Copenhagen,6801,4,14,4,12,54,43,11,46
AaB,6801,5,8,12,10,38,41,-3,36
AC Horsens,6801,6,6,14,10,33,54,-21,32
Sonderjyske,6801,7,8,6,10,28,29,-1,30
Randers FC,6801,8,5,7,12,23,39,-16,22
AGF Aarhus,6801,9,5,6,11,17,36,-19,21
Lyngby,6801,10,3,10,11,26,44,-18,19
Silkeborg IF,6801,11,5,3,14,25,45,-20,18
Brondby,6802,1,21,7,2,72,28,44,70
FC Midtjylla,6802,2,20,5,5,70,42,28,65
FC Nords,6802,3,15,6,9,78,54,24,51
Copenhagen,6802,4,13,6,11,61,50,11,45
AaB,6802,5,7,11,12,40,55,-15,32
Sonderjyske,6802,6,8,6,10,28,29,-1,30
AC Horsens,6802,7,5,15,10,37,55,-18,30
Randers FC,6802,8,5,7,12,23,39,-16,22
Lyngby,6802,9,3,10,11,26,44,-18,19
Silkeborg IF,6802,10,5,4,13,26,45,-19,19
AGF Aarhus,6802,11,4,7,11,17,37,-20,19
Brondby,6803,1,19,9,2,69,33,36,66
FC Midtjylla,6803,2,20,6,4,66,39,27,66
FC Nords,6803,3,14,7,9,73,50,23,49
Copenhagen,6803,4,13,4,13,57,47,10,43
AaB,6803,5,8,13,9,35,38,-3,37
AC Horsens,6803,6,6,13,11,32,51,-19,31
Sonderjyske,6803,7,8,6,10,28,29,-1,30
Randers FC,6803,8,6,6,12,27,40,-13,24
AGF Aarhus,6803,9,5,6,11,18,37,-19,21
Silkeborg IF,6803,10,5,3,14,26,46,-20,18
Lyngby,6803,11,3,9,12,27,48,-21,18
Brondby,6804,1,22,5,3,71,31,40,71
FC Midtjylla,6804,2,20,4,6,67,38,29,64
FC Nords,6804,3,14,8,8,68,47,21,50
Copenhagen,6804,4,14,5,11,58,44,14,47
AaB,6804,5,7,13,10,34,40,-6,34
Sonderjyske,6804,6,8,6,10,28,29,-1,30
AC Horsens,6804,7,5,13,12,29,53,-24,28
Randers FC,6804,8,6,6,12,25,40,-15,24
Silkeborg IF,6804,9,6,3,13,27,44,-17,21
Lyngby,6804,10,3,9,12,27,46,-19,18
AGF Aarhus,6804,11,4,6,12,16,38,-22,18
Brondby,6805,1,21,6,3,73,33,40,69
FC Midtjylla,6805,2,20,4,6,68,39,29,64
Copenhagen,6805,3,15,4,11,59,46,13,49
FC Nords,6805,4,14,6,10,75,55,20,48
AaB,6805,5,9,11,10,40,41,-1,38
Sonderjyske,6805,6,8,6,10,28,29,-1,30
AC Horsens,6805,7,5,13,12,35,62,-27,28
Randers FC,6805,8,6,6,12,25,40,-15,24
Silkeborg IF,6805,9,6,3,13,26,44,-18,21
Lyngby,6805,10,3,9,12,27,46,-19,18
AGF Aarhus,6805,11,4,6,12,16,37,-21,18
Brondby,6806,1,20,7,3,67,30,37,67
FC Midtjylla,6806,2,19,7,4,66,37,29,64
FC Nords,6806,3,13,6,11,69,57,12,45
Copenhagen,6806,4,13,6,11,55,44,11,45
AaB,6806,5,8,12,10,40,42,-2,36
AC Horsens,6806,6,8,12,10,38,51,-13,36
Sonderjyske,6806,7,8,6,10,28,29,-1,30
Randers FC,6806,8,5,7,12,25,41,-16,22
Lyngby,6806,9,3,10,11,28,46,-18,19
Silkeborg IF,6806,10,5,4,13,26,45,-19,19
AGF Aarhus,6806,11,4,7,11,17,37,-20,19
Brondby,6807,1,20,7,3,69,31,38,67
FC Midtjylla,6807,2,18,5,7,60,40,20,59
FC Nords,6807,3,15,8,7,76,50,26,53
Copenhagen,6807,4,13,5,12,53,44,9,44
AaB,6807,5,8,12,10,37,41,-4,36
AC Horsens,6807,6,7,13,10,34,49,-15,34
Sonderjyske,6807,7,8,6,10,28,29,-1,30
Lyngby,6807,8,4,9,11,28,45,-17,21
Randers FC,6807,9,5,6,13,24,41,-17,21
AGF Aarhus,6807,10,5,6,11,19,36,-17,21
Silkeborg IF,6807,11,5,3,14,25,47,-22,18
Brondby,6808,1,20,8,2,70,32,38,68
FC Midtjylla,6808,2,19,6,5,63,38,25,63
FC Nords,6808,3,15,7,8,74,46,28,52
Copenhagen,6808,4,14,4,12,54,44,10,46
AaB,6808,5,7,14,9,37,42,-5,35
Sonderjyske,6808,6,8,6,10,28,29,-1,30
AC Horsens,6808,7,5,13,12,32,54,-22,28
Randers FC,6808,8,6,6,12,26,39,-13,24
Silkeborg IF,6808,9,6,3,13,27,44,-17,21
Lyngby,6808,10,3,9,12,26,47,-21,18
AGF Aarhus,6808,11,4,6,12,16,38,-22,18
Brondby,6809,1,21,7,2,72,33,39,70
FC Midtjylla,6809,2,19,5,6,62,39,23,62
Copenhagen,6809,3,15,5,10,66,44,22,50
FC Nords,6809,4,12,7,11,68,54,14,43
AaB,6809,5,8,12,10,36,44,-8,36
AC Horsens,6809,6,7,12,11,37,53,-16,33
Sonderjyske,6809,7,8,6,10,28,29,-1,30
Lyngby,6809,8,4,9,11,28,45,-17,21
Silkeborg IF,6809,8,6,3,13,28,45,-17,21
Randers FC,6809,10,5,6,13,24,41,-17,21
AGF Aarhus,6809,11,4,6,12,17,39,-22,18
Brondby,6810,1,22,5,3,73,29,44,71
FC Midtjylla,6810,2,20,4,6,69,45,24,64
Copenhagen,6810,3,15,5,10,62,44,18,50
FC Nords,6810,4,14,6,10,73,53,20,48
AaB,6810,5,7,13,10,35,42,-7,34
Sonderjyske,6810,6,8,6,10,28,29,-1,30
AC Horsens,6810,7,5,13,12,34,59,-25,28
Randers FC,6810,8,5,7,12,24,40,-16,22
AGF Aarhus,6810,9,5,6,11,18,37,-19,21
Lyngby,6810,10,3,10,11,27,45,-18,19
Silkeborg IF,6810,11,5,3,14,26,46,-20,18
Brondby,6811,1,20,6,4,72,36,36,66
FC Midtjylla,6811,2,20,6,4,65,38,27,66
FC Nords,6811,3,12,8,10,70,54,16,44
Copenhagen,6811,4,13,5,12,55,44,11,44
AC Horsens,6811,5,9,13,8,40,49,-9,40
AaB,6811,6,7,12,11,37,44,-7,33
Sonderjyske,6811,7,8,6,10,28,29,-1,30
Randers FC,6811,8,6,6,12,24,39,-15,24
Silkeborg IF,6811,9,5,4,13,25,44,-19,19
AGF Aarhus,6811,10,4,7,11,16,36,-20,19
Lyngby,6811,11,3,9,12,26,45,-19,18
Brondby,6812,1,21,6,3,74,31,43,69
FC Midtjylla,6812,2,19,5,6,66,42,24,62
FC Nords,6812,3,15,8,7,77,49,28,53
Copenhagen,6812,4,13,6,11,57,47,10,45
AaB,6812,5,8,11,11,38,49,-11,35
Sonderjyske,6812,6,8,6,10,28,29,-1,30
AC Horsens,6812,7,6,12,12,36,56,-20,30
Lyngby,6812,8,4,9,11,27,44,-17,21
Randers FC,6812,9,5,6,13,23,40,-17,21
AGF Aarhus,6812,10,5,6,11,18,37,-19,21
Silkeborg IF,6812,11,5,3,14,26,46,-20,18
Brondby,6813,1,22,6,2,81,38,43,72
FC Midtjylla,6813,2,20,5,5,70,39,31,65
FC Nords,6813,3,13,6,11,71,57,14,45
Copenhagen,6813,4,12,7,11,56,47,9,43
AaB,6813,5,8,12,10,38,45,-7,36
AC Horsens,6813,6,6,14,10,36,52,-16,32
Sonderjyske,6813,7,8,6,10,28,29,-1,30
Lyngby,6813,8,4,9,11,27,44,-17,21
Randers FC,6813,9,5,6,13,23,40,-17,21
AGF Aarhus,6813,10,5,6,11,18,37,-19,21
Silkeborg IF,6813,11,5,3,14,26,46,-20,18
Brondby,6814,1,20,6,4,69,35,34,66
FC Midtjylla,6814,2,20,5,5,71,40,31,65
FC Nords,6814,3,15,6,9,79,52,27,51
Copenhagen,6814,4,15,4,11,60,44,16,49
AaB,6814,5,9,11,10,40,41,-1,38
Sonderjyske,6814,6,8,6,10,28,29,-1,30
AC Horsens,6814,7,5,12,13,30,63,-33,27
Randers FC,6814,8,6,6,12,25,39,-14,24
AGF Aarhus,6814,9,5,6,11,17,36,-19,21
Lyngby,6814,10,3,9,12,26,46,-20,18
Silkeborg IF,6814,11,5,3,14,25,45,-20,18
Brondby,6815,1,19,6,5,64,35,29,63
FC Midtjylla,6815,2,19,5,6,68,42,26,62
FC Nords,6815,3,15,7,8,75,49,26,52
Copenhagen,6815,4,13,7,10,59,44,15,46
AaB,6815,5,7,14,9,39,43,-4,35
AC Horsens,6815,6,7,13,10,36,54,-18,34
Sonderjyske,6815,7,8,6,10,28,29,-1,30
Randers FC,6815,8,5,7,12,23,39,-16,22
AGF Aarhus,6815,9,5,6,11,18,36,-18,21
Lyngby,6815,10,3,10,11,26,44,-18,19
Silkeborg IF,6815,11,5,3,14,25,46,-21,18
Brondby,6816,1,20,8,2,68,30,38,68
FC Midtjylla,6816,2,20,5,5,63,39,24,65
FC Nords,6816,3,15,7,8,78,54,24,52
Copenhagen,6816,4,13,5,12,57,44,13,44
AC Horsens,6816,5,7,13,10,34,48,-14,34
Sonderjyske,6816,6,8,6,10,28,29,-1,30
AaB,6816,7,6,12,12,35,46,-11,30
Randers FC,6816,8,6,6,12,27,39,-12,24
Silkeborg IF,6816,9,6,3,13,26,44,-18,21
AGF Aarhus,6816,10,4,6,12,16,37,-21,18
Lyngby,6816,11,3,9,12,26,48,-22,18
Brondby,6817,1,23,5,2,73,29,44,74
FC Midtjylla,6817,2,20,4,6,64,43,21,64
Copenhagen,6817,3,15,5,10,63,41,22,50
FC Nords,6817,4,13,6,11,69,52,17,45
AC Horsens,6817,5,7,12,11,33,52,-19,33
Sonderjyske,6817,6,8,6,10,28,29,-1,30
AaB,6817,7,6,12,12,33,44,-11,30
Lyngby,6817,8,4,9,11,29,44,-15,21
Randers FC,6817,9,5,6,13,23,42,-19,21
AGF Aarhus,6817,10,5,6,11,18,37,-19,21
Silkeborg IF,6817,11,5,3,14,26,46,-20,18
Brondby,6818,1,22,5,3,70,33,37,71
FC Midtjylla,6818,2,19,7,4,67,35,32,64
FC Nords,6818,3,15,7,8,78,52,26,52
Copenhagen,6818,4,12,6,12,57,52,5,42
AaB,6818,5,6,14,10,36,43,-7,32
Sonderjyske,6818,6,8,6,10,28,29,-1,30
AC Horsens,6818,7,5,15,10,32,51,-19,30
Randers FC,6818,8,5,7,12,23,39,-16,22
Silkeborg IF,6818,9,6,3,13,30,45,-15,21
Lyngby,6818,10,3,10,11,26,44,-18,19
AGF Aarhus,6818,11,4,6,12,17,41,-24,18
Brondby,6819,1,21,5,4,69,34,35,68
FC Midtjylla,6819,2,21,4,5,70,38,32,67
FC Nords,6819,3,14,7,9,72,52,20,49
Copenhagen,6819,4,15,4,11,61,44,17,49
AaB,6819,5,6,13,11,33,44,-11,31
AC Horsens,6819,6,6,13,11,36,55,-19,31
Sonderjyske,6819,7,8,6,10,28,29,-1,30
Randers FC,6819,8,6,6,12,25,39,-14,24
AGF Aarhus,6819,9,5,6,11,19,37,-18,21
Lyngby,6819,10,3,9,12,26,46,-20,18
Silkeborg IF,6819,11,5,3,14,26,47,-21,18
Brondby,6820,1,21,6,3,72,29,43,69
FC Midtjylla,6820,2,19,4,7,68,40,28,61
Copenhagen,6820,3,15,5,10,59,42,17,50
FC Nords,6820,4,14,7,9,70,52,18,49
AaB,6820,5,7,12,11,33,42,-9,33
AC Horsens,6820,6,6,14,10,36,59,-23,32
Sonderjyske,6820,7,8,6,10,28,29,-1,30
Randers FC,6820,8,5,7,12,23,39,-16,22
Lyngby,6820,9,3,10,11,26,44,-18,19
Silkeborg IF,6820,10,5,4,13,26,45,-19,19
AGF Aarhus,6820,11,4,7,11,17,37,-20,19
Brondby,6821,1,21,5,4,73,34,39,68
FC Midtjylla,6821,2,19,4,7,68,40,28,61
Copenhagen,6821,3,16,4,10,58,44,14,52
FC Nords,6821,4,13,6,11,73,55,18,45
AC Horsens,6821,5,9,12,9,41,54,-13,39
AaB,6821,6,7,11,12,34,46,-12,32
Sonderjyske,6821,7,8,6,10,28,29,-1,30
Randers FC,6821,8,5,7,12,26,42,-16,22
Lyngby,6821,9,3,10,11,29,47,-18,19
Silkeborg IF,6821,10,5,4,13,26,45,-19,19
AGF Aarhus,6821,11,4,7,11,17,37,-20,19
Brondby,6822,1,21,6,3,72,33,39,69
FC Midtjylla,6822,2,19,6,5,68,41,27,63
FC Nords,6822,3,14,7,9,75,53,22,49
Copenhagen,6822,4,13,5,12,58,49,9,44
AaB,6822,5,9,11,10,37,40,-3,38
AC Horsens,6822,6,6,13,11,37,57,-20,31
Sonderjyske,6822,7,8,6,10,28,29,-1,30
Lyngby,6822,8,4,9,11,31,45,-14,21
Randers FC,6822,9,5,6,13,24,44,-20,21
Silkeborg IF,6822,10,5,4,13,26,45,-19,19
AGF Aarhus,6822,11,4,7,11,17,37,-20,19
Brondby,6823,1,20,6,4,72,32,40,66
FC Midtjylla,6823,2,20,6,4,70,37,33,66
FC Nords,6823,3,14,8,8,72,51,21,50
Copenhagen,6823,4,13,6,11,56,44,12,45
AaB,6823,5,6,14,10,36,46,-10,32
AC Horsens,6823,6,6,14,10,32,54,-22,32
Sonderjyske,6823,7,8,6,10,28,29,-1,30
Randers FC,6823,8,5,7,12,25,41,-16,22
Silkeborg IF,6823,9,6,3,13,26,44,-18,21
Lyngby,6823,10,3,10,11,28,46,-18,19
AGF Aarhus,6823,11,4,6,12,16,37,-21,18
Brondby,6824,1,21,5,4,70,31,39,68
FC Midtjylla,6824,2,20,4,6,68,41,27,64
Copenhagen,6824,3,15,6,9,58,41,17,51
FC Nords,6824,4,14,7,9,76,54,22,49
AaB,6824,5,7,13,10,33,38,-5,34
Sonderjyske,6824,6,8,6,10,28,29,-1,30
AC Horsens,6824,7,5,13,12,30,56,-26,28
Lyngby,6824,8,4,9,11,27,44,-17,21
Randers FC,6824,9,5,6,13,23,40,-17,21
AGF Aarhus,6824,10,5,6,11,19,36,-17,21
Silkeborg IF,6824,11,5,3,14,25,47,-22,18
Brondby,6825,1,21,5,4,72,34,38,68
FC Midtjylla,6825,2,19,5,6,67,38,29,62
FC Nords,6825,3,14,7,9,73,53,20,49
Copenhagen,6825,4,14,5,11,59,47,12,47
AaB,6825,5,8,13,9,36,38,-2,37
AC Horsens,6825,6,6,13,11,34,57,-23,31
Sonderjyske,6825,7,8,6,10,28,29,-1,30
Lyngby,6825,8,4,9,11,29,45,-16,21
Randers FC,6825,9,5,6,13,24,42,-18,21
AGF Aarhus,6825,10,5,6,11,17,36,-19,21
Silkeborg IF,6825,11,5,3,14,25,45,-20,18
Brondby,6826,1,22,6,2,68,28,40,72
FC Midtjylla,6826,2,19,6,5,64,36,28,63
FC Nords,6826,3,13,7,10,70,52,18,46
Copenhagen,6826,4,12,7,11,56,47,9,43
AaB,6826,5,8,11,11,37,42,-5,35
AC Horsens,6826,6,7,13,10,38,54,-16,34
Sonderjyske,6826,7,8,6,10,28,29,-1,30
Lyngby,6826,8,4,9,11,32,44,-12,21
AGF Aarhus,6826,9,5,6,11,17,36,-19,21
Randers FC,6826,10,5,6,13,23,45,-22,21
Silkeborg IF,6826,11,5,3,14,25,45,-20,18
FC Midtjylla,6827,1,20,5,5,66,38,28,65
Brondby,6827,2,19,6,5,67,33,34,63
FC Nords,6827,3,16,7,7,72,47,25,55
Copenhagen,6827,4,15,4,11,59,43,16,49
AaB,6827,5,7,11,12,33,46,-13,32
AC Horsens,6827,6,6,13,11,36,52,-16,31
Sonderjyske,6827,7,8,6,10,28,29,-1,30
Randers FC,6827,8,6,6,12,28,40,-12,24
Silkeborg IF,6827,9,5,4,13,26,45,-19,19
AGF Aarhus,6827,10,4,7,11,17,37,-20,19
Lyngby,6827,11,3,9,12,27,49,-22,18
FC Midtjylla,6828,1,21,5,4,69,37,32,68
Brondby,6828,2,19,9,2,69,33,36,66
Copenhagen,6828,3,15,5,10,60,42,18,50
FC Nords,6828,4,13,7,10,70,54,16,46
AaB,6828,5,6,13,11,36,44,-8,31
AC Horsens,6828,6,6,13,11,35,55,-20,31
Sonderjyske,6828,7,8,6,10,28,29,-1,30
Lyngby,6828,8,4,9,11,29,46,-17,21
Silkeborg IF,6828,9,6,3,13,27,44,-17,21
Randers FC,6828,10,5,6,13,25,42,-17,21
AGF Aarhus,6828,11,4,6,12,16,38,-22,18
Brondby,6829,1,19,7,4,69,32,37,64
FC Midtjylla,6829,2,18,5,7,63,43,20,59
FC Nords,6829,3,17,6,7,76,48,28,57
Copenhagen,6829,4,12,7,11,54,43,11,43
AaB,6829,5,7,14,9,37,40,-3,35
AC Horsens,6829,6,7,13,10,34,53,-19,34
Sonderjyske,6829,7,8,6,10,28,29,-1,30
Silkeborg IF,6829,8,6,3,13,28,45,-17,21
Lyngby,6829,9,4,9,11,27,44,-17,21
Randers FC,6829,10,5,6,13,23,40,-17,21
AGF Aarhus,6829,11,4,6,12,17,39,-22,18
Brondby,6830,1,21,6,3,72,33,39,69
FC Midtjylla,6830,2,19,7,4,66,38,28,64
FC Nords,6830,3,15,7,8,73,46,27,52
Copenhagen,6830,4,13,6,11,56,45,11,45
AaB,6830,5,6,13,11,34,44,-10,31
AC Horsens,6830,6,6,13,11,35,56,-21,31
Sonderjyske,6830,7,8,6,10,28,29,-1,30
Randers FC,6830,8,5,7,12,26,42,-16,22
Lyngby,6830,9,3,10,11,29,47,-18,19
Silkeborg IF,6830,10,5,4,13,26,45,-19,19
AGF Aarhus,6830,11,4,7,11,17,37,-20,19
Brondby,6831,1,21,6,3,69,32,37,69
FC Midtjylla,6831,2,19,5,6,64,38,26,62
FC Nords,6831,3,15,7,8,75,47,28,52
Copenhagen,6831,4,15,4,11,62,47,15,49
AC Horsens,6831,5,7,12,11,35,56,-21,33
Sonderjyske,6831,6,8,6,10,28,29,-1,30
AaB,6831,7,6,12,12,36,47,-11,30
Silkeborg IF,6831,8,6,3,13,29,44,-15,21
Lyngby,6831,9,4,9,11,27,44,-17,21
Randers FC,6831,10,5,6,13,23,40,-17,21
AGF Aarhus,6831,11,4,6,12,16,40,-24,18
Brondby,6832,1,22,5,3,70,32,38,71
FC Midtjylla,6832,2,20,5,5,67,39,28,65
FC Nords,6832,3,16,6,8,77,49,28,54
Copenhagen,6832,4,13,6,11,58,46,12,45
AC Horsens,6832,5,6,13,11,34,52,-18,31
Sonderjyske,6832,6,8,6,10,28,29,-1,30
AaB,6832,7,6,11,13,32,46,-14,29
Randers FC,6832,8,6,6,12,24,39,-15,24
Silkeborg IF,6832,9,5,4,13,26,45,-19,19
AGF Aarhus,6832,10,4,7,11,17,37,-20,19
Lyngby,6832,11,3,9,12,26,45,-19,18
Brondby,6833,1,21,6,3,75,35,40,69
FC Midtjylla,6833,2,20,4,6,68,44,24,64
Copenhagen,6833,3,15,4,11,63,42,21,49
FC Nords,6833,4,13,8,9,69,53,16,47
AaB,6833,5,8,12,10,41,44,-3,36
Sonderjyske,6833,6,8,6,10,28,29,-1,30
AC Horsens,6833,7,6,12,12,33,57,-24,30
Randers FC,6833,8,6,6,12,25,39,-14,24
AGF Aarhus,6833,9,5,6,11,18,37,-19,21
Lyngby,6833,10,3,9,12,26,46,-20,18
Silkeborg IF,6833,10,5,3,14,26,46,-20,18
FC Midtjylla,6834,1,20,5,5,71,37,34,65
Brondby,6834,2,18,7,5,67,37,30,61
FC Nords,6834,3,15,8,7,76,49,27,53
Copenhagen,6834,4,14,4,12,58,46,12,46
AC Horsens,6834,5,8,12,10,36,56,-20,36
AaB,6834,6,7,12,11,33,42,-9,33
Sonderjyske,6834,7,8,6,10,28,29,-1,30
Lyngby,6834,8,4,9,11,29,44,-15,21
AGF Aarhus,6834,9,5,6,11,18,36,-18,21
Randers FC,6834,10,5,6,13,23,42,-19,21
Silkeborg IF,6834,11,5,3,14,25,46,-21,18
Brondby,6835,1,21,5,4,69,33,36,68
FC Midtjylla,6835,2,19,4,7,63,40,23,61
FC Nords,6835,3,16,6,8,77,51,26,54
Copenhagen,6835,4,13,4,13,58,49,9,43
AC Horsens,6835,5,8,12,10,37,51,-14,36
AaB,6835,6,8,11,11,40,46,-6,35
Sonderjyske,6835,7,8,6,10,28,29,-1,30
Lyngby,6835,8,4,9,11,27,44,-17,21
Randers FC,6835,9,5,6,13,23,40,-17,21
Silkeborg IF,6835,10,5,4,13,25,44,-19,19
AGF Aarhus,6835,11,4,7,11,16,36,-20,19
Brondby,6836,1,20,6,4,73,37,36,66
FC Midtjylla,6836,2,20,5,5,70,40,30,65
Copenhagen,6836,3,17,4,9,63,42,21,55
FC Nords,6836,4,14,7,9,72,50,22,49
AaB,6836,5,7,12,11,34,42,-8,33
Sonderjyske,6836,6,8,6,10,28,29,-1,30
AC Horsens,6836,7,5,12,13,34,61,-27,27
Randers FC,6836,8,6,6,12,25,39,-14,24
AGF Aarhus,6836,9,5,6,11,19,37,-18,21
Lyngby,6836,10,3,9,12,26,46,-20,18
Silkeborg IF,6836,11,5,3,14,26,47,-21,18
Brondby,6837,1,21,5,4,68,32,36,68
FC Midtjylla,6837,2,20,5,5,63,37,26,65
Copenhagen,6837,3,15,5,10,59,41,18,50
FC Nords,6837,4,14,6,10,74,52,22,48
AC Horsens,6837,5,7,13,10,37,53,-16,34
Sonderjyske,6837,6,8,6,10,28,29,-1,30
AaB,6837,7,6,12,12,36,48,-12,30
Lyngby,6837,8,4,9,11,29,46,-17,21
Randers FC,6837,9,5,6,13,25,42,-17,21
AGF Aarhus,6837,10,5,6,11,18,36,-18,21
Silkeborg IF,6837,11,5,3,14,25,46,-21,18
Brondby,6838,1,21,5,4,76,38,38,68
FC Midtjylla,6838,2,21,5,4,66,38,28,68
FC Nords,6838,3,15,7,8,76,51,25,52
Copenhagen,6838,4,13,5,12,59,49,10,44
AaB,6838,5,6,13,11,34,42,-8,31
AC Horsens,6838,6,6,13,11,37,56,-19,31
Sonderjyske,6838,7,8,6,10,28,29,-1,30
Lyngby,6838,8,4,9,11,29,45,-16,21
Randers FC,6838,9,5,6,13,24,42,-18,21
Silkeborg IF,6838,10,5,4,13,26,45,-19,19
AGF Aarhus,6838,11,4,7,11,17,37,-20,19
Brondby,6839,1,21,5,4,73,36,37,68
FC Midtjylla,6839,2,21,4,5,71,38,33,67
Copenhagen,6839,3,16,4,10,57,42,15,52
FC Nords,6839,4,13,7,10,75,59,16,46
AaB,6839,5,8,11,11,39,44,-5,35
Sonderjyske,6839,6,8,6,10,28,29,-1,30
AC Horsens,6839,7,5,13,12,35,57,-22,28
Randers FC,6839,8,5,7,12,24,40,-16,22
AGF Aarhus,6839,9,5,6,11,18,37,-19,21
Lyngby,6839,10,3,10,11,27,45,-18,19
Silkeborg IF,6839,11,5,3,14,26,46,-20,18
Brondby,6840,1,20,6,4,69,35,34,66
FC Midtjylla,6840,2,19,6,5,69,42,27,63
FC Nords,6840,3,13,10,7,74,52,22,49
Copenhagen,6840,4,12,7,11,57,47,10,43
AaB,6840,5,9,12,9,40,41,-1,39
AC Horsens,6840,6,6,13,11,36,54,-18,31
Sonderjyske,6840,7,8,6,10,28,29,-1,30
Randers FC,6840,8,6,6,12,27,40,-13,24
AGF Aarhus,6840,9,5,6,11,17,36,-19,21
Silkeborg IF,6840,10,5,3,14,25,45,-20,18
Lyngby,6840,11,3,9,12,27,48,-21,18
Brondby,6841,1,23,5,2,75,29,46,74
FC Midtjylla,6841,2,20,4,6,67,42,25,64
FC Nords,6841,3,15,6,9,77,54,23,51
Copenhagen,6841,4,13,4,13,56,50,6,43
AaB,6841,5,7,12,11,36,42,-6,33
AC Horsens,6841,6,6,13,11,35,55,-20,31
Sonderjyske,6841,7,8,6,10,28,29,-1,30
Randers FC,6841,8,5,7,12,23,39,-16,22
AGF Aarhus,6841,9,5,6,11,19,38,-19,21
Lyngby,6841,10,3,10,11,26,44,-18,19
Silkeborg IF,6841,11,5,3,14,27,47,-20,18
Brondby,6842,1,21,6,3,73,32,41,69
FC Midtjylla,6842,2,20,4,6,66,41,25,64
Copenhagen,6842,3,16,5,9,65,46,19,53
FC Nords,6842,4,14,6,10,73,53,20,48
AaB,6842,5,7,11,12,36,48,-12,32
Sonderjyske,6842,6,8,6,10,28,29,-1,30
AC Horsens,6842,7,6,12,12,39,58,-19,30
Randers FC,6842,8,6,6,12,24,39,-15,24
AGF Aarhus,6842,9,5,6,11,18,37,-19,21
Lyngby,6842,10,3,9,12,26,45,-19,18
Silkeborg IF,6842,11,5,3,14,26,46,-20,18
Brondby,6843,1,22,5,3,68,28,40,71
FC Midtjylla,6843,2,21,4,5,66,36,30,67
FC Nords,6843,3,14,6,10,71,50,21,48
Copenhagen,6843,4,13,5,12,54,44,10,44
AaB,6843,5,9,11,10,40,42,-2,38
Sonderjyske,6843,6,8,6,10,28,29,-1,30
AC Horsens,6843,7,5,13,12,29,54,-25,28
Lyngby,6843,8,4,9,11,30,45,-15,21
Silkeborg IF,6843,9,6,3,13,29,45,-16,21
Randers FC,6843,10,5,6,13,24,43,-19,21
AGF Aarhus,6843,11,4,6,12,17,40,-23,18
Brondby,6844,1,22,5,3,74,35,39,71
FC Midtjylla,6844,2,19,4,7,67,43,24,61
FC Nords,6844,3,14,6,10,71,52,19,48
Copenhagen,6844,4,13,4,13,58,48,10,43
AC Horsens,6844,5,9,12,9,38,50,-12,39
AaB,6844,6,8,11,11,35,41,-6,35
Sonderjyske,6844,7,8,6,10,28,29,-1,30
Randers FC,6844,8,6,6,12,26,39,-13,24
Silkeborg IF,6844,9,6,3,13,27,45,-18,21
Lyngby,6844,10,3,9,12,26,47,-21,18
AGF Aarhus,6844,11,4,6,12,17,38,-21,18
Brondby,6845,1,20,6,4,67,37,30,66
FC Midtjylla,6845,2,20,4,6,71,41,30,64
Copenhagen,6845,3,16,4,10,59,46,13,52
FC Nords,6845,4,14,6,10,79,58,21,48
AaB,6845,5,8,11,11,44,44,0,35
AC Horsens,6845,6,6,13,11,38,58,-20,31
Sonderjyske,6845,7,8,6,10,28,29,-1,30
Lyngby,6845,8,4,9,11,28,44,-16,21
Randers FC,6845,9,5,6,13,23,41,-18,21
AGF Aarhus,6845,10,5,6,11,18,36,-18,21
Silkeborg IF,6845,11,5,3,14,25,46,-21,18
Brondby,6846,1,21,6,3,73,33,40,69
FC Midtjylla,6846,2,17,4,9,59,41,18,55
FC Nords,6846,3,16,6,8,76,50,26,54
Copenhagen,6846,4,15,4,11,59,42,17,49
AaB,6846,5,8,12,10,34,39,-5,36
AC Horsens,6846,6,7,12,11,33,55,-22,33
Sonderjyske,6846,7,8,6,10,28,29,-1,30
Randers FC,6846,8,5,7,12,25,41,-16,22
Silkeborg IF,6846,9,6,3,13,26,44,-18,21
Lyngby,6846,10,3,10,11,28,46,-18,19
AGF Aarhus,6846,11,4,6,12,16,37,-21,18
Brondby,6847,1,20,6,4,66,29,37,66
FC Midtjylla,6847,2,19,6,5,62,38,24,63
FC Nords,6847,3,15,7,8,74,46,28,52
Copenhagen,6847,4,13,5,12,55,46,9,44
AaB,6847,5,7,13,10,37,46,-9,34
AC Horsens,6847,6,6,15,9,34,49,-15,33
Sonderjyske,6847,7,8,6,10,28,29,-1,30
Lyngby,6847,8,4,9,11,29,45,-16,21
Silkeborg IF,6847,9,6,3,13,27,44,-17,21
Randers FC,6847,10,5,6,13,24,42,-18,21
AGF Aarhus,6847,11,4,6,12,16,38,-22,18
Brondby,6848,1,21,7,2,69,31,38,70
FC Midtjylla,6848,2,19,5,6,61,37,24,62
FC Nords,6848,3,15,7,8,76,51,25,52
Copenhagen,6848,4,14,5,11,58,44,14,47
AaB,6848,5,8,11,11,36,41,-5,35
Sonderjyske,6848,6,8,6,10,28,29,-1,30
AC Horsens,6848,7,5,13,12,32,54,-22,28
Lyngby,6848,8,4,9,11,27,44,-17,21
Silkeborg IF,6848,8,6,3,13,27,44,-17,21
Randers FC,6848,10,5,6,13,23,40,-17,21
AGF Aarhus,6848,11,4,6,12,16,38,-22,18
Brondby,6849,1,20,5,5,69,36,33,65
FC Midtjylla,6849,2,20,5,5,63,37,26,65
FC Nords,6849,3,15,6,9,78,50,28,51
Copenhagen,6849,4,15,5,10,56,41,15,50
AaB,6849,5,7,12,11,35,43,-8,33
AC Horsens,6849,6,6,13,11,35,55,-20,31
Sonderjyske,6849,7,8,6,10,28,29,-1,30
Lyngby,6849,8,4,9,11,27,44,-17,21
Randers FC,6849,9,5,6,13,23,40,-17,21
Silkeborg IF,6849,10,5,4,13,26,45,-19,19
AGF Aarhus,6849,11,4,7,11,17,37,-20,19
Brondby,6850,1,22,6,2,72,29,43,72
FC Midtjylla,6850,2,18,5,7,61,41,20,59
FC Nords,6850,3,13,6,11,75,56,19,45
Copenhagen,6850,4,12,6,12,55,48,7,42
AC Horsens,6850,5,8,14,8,39,50,-11,38
AaB,6850,6,8,13,9,37,41,-4,37
Sonderjyske,6850,7,8,6,10,28,29,-1,30
Randers FC,6850,8,5,7,12,24,40,-16,22
Silkeborg IF,6850,9,6,3,13,29,46,-17,21
Lyngby,6850,10,3,10,11,27,45,-18,19
AGF Aarhus,6850,11,4,6,12,18,40,-22,18
Brondby,6851,1,21,6,3,73,32,41,69
FC Midtjylla,6851,2,21,4,5,74,36,38,67
FC Nords,6851,3,13,7,10,69,57,12,46
Copenhagen,6851,4,13,6,11,54,47,7,45
AaB,6851,5,8,12,10,40,40,0,36
AC Horsens,6851,6,6,13,11,33,57,-24,31
Sonderjyske,6851,7,8,6,10,28,29,-1,30
Lyngby,6851,8,4,9,11,29,44,-15,21
AGF Aarhus,6851,9,5,6,11,19,37,-18,21
Randers FC,6851,10,5,6,13,23,42,-19,21
Silkeborg IF,6851,11,5,3,14,26,47,-21,18
FC Midtjylla,6852,1,21,5,4,68,34,34,68
Brondby,6852,2,18,8,4,68,36,32,62
FC Nords,6852,3,14,7,9,75,55,20,49
Copenhagen,6852,4,14,5,11,55,44,11,47
AaB,6852,5,8,12,10,40,44,-4,36
AC Horsens,6852,6,6,13,11,37,56,-19,31
Sonderjyske,6852,7,8,6,10,28,29,-1,30
Lyngby,6852,8,4,9,11,28,44,-16,21
Randers FC,6852,9,5,6,13,23,41,-18,21
AGF Aarhus,6852,10,5,6,11,17,36,-19,21
Silkeborg IF,6852,11,5,3,14,25,45,-20,18
FC Midtjylla,6853,1,22,4,4,70,37,33,70
Brondby,6853,2,20,6,4,70,33,37,66
FC Nords,6853,3,13,7,10,68,52,16,46
Copenhagen,6853,4,13,7,10,57,44,13,46
AaB,6853,5,7,12,11,35,41,-6,33
AC Horsens,6853,6,6,14,10,34,53,-19,32
Sonderjyske,6853,7,8,6,10,28,29,-1,30
Randers FC,6853,8,5,7,12,25,41,-16,22
Silkeborg IF,6853,9,6,3,13,27,44,-17,21
Lyngby,6853,10,3,10,11,28,46,-18,19
AGF Aarhus,6853,11,4,6,12,16,38,-22,18
Brondby,6854,1,19,7,4,68,33,35,64
FC Midtjylla,6854,2,18,8,4,65,39,26,62
FC Nords,6854,3,14,8,8,73,51,22,50
Copenhagen,6854,4,14,5,11,56,44,12,47
AaB,6854,5,8,12,10,37,42,-5,36
AC Horsens,6854,6,6,14,10,38,54,-16,32
Sonderjyske,6854,7,8,6,10,28,29,-1,30
Randers FC,6854,8,6,6,12,27,42,-15,24
Silkeborg IF,6854,9,5,4,13,26,45,-19,19
AGF Aarhus,6854,10,4,7,11,17,37,-20,19
Lyngby,6854,11,3,9,12,29,48,-19,18
Brondby,6855,1,20,7,3,70,35,35,67
FC Midtjylla,6855,2,20,5,5,68,41,27,65
FC Nords,6855,3,13,9,8,70,49,21,48
Copenhagen,6855,4,14,6,10,58,41,17,48
AaB,6855,5,7,12,11,36,43,-7,33
AC Horsens,6855,6,6,13,11,33,52,-19,31
Sonderjyske,6855,7,8,6,10,28,29,-1,30
Lyngby,6855,8,4,9,11,28,45,-17,21
Randers FC,6855,9,5,6,13,24,41,-17,21
Silkeborg IF,6855,10,5,4,13,27,46,-19,19
AGF Aarhus,6855,11,4,7,11,18,38,-20,19
Brondby,6856,1,20,8,2,71,32,39,68
FC Midtjylla,6856,2,19,5,6,66,39,27,62
Copenhagen,6856,3,15,5,10,57,42,15,50
FC Nords,6856,4,14,7,9,71,54,17,49
AaB,6856,5,7,12,11,36,43,-7,33
Sonderjyske,6856,6,8,6,10,28,29,-1,30
AC Horsens,6856,7,5,15,10,33,50,-17,30
Lyngby,6856,8,4,9,11,28,44,-16,21
Silkeborg IF,6856,9,6,3,13,27,44,-17,21
Randers FC,6856,10,5,6,13,23,41,-18,21
AGF Aarhus,6856,11,4,6,12,16,38,-22,18
Brondby,6857,1,21,6,3,69,30,39,69
FC Midtjylla,6857,2,19,4,7,65,41,24,61
FC Nords,6857,3,14,7,9,71,51,20,49
Copenhagen,6857,4,12,5,13,55,46,9,41
AC Horsens,6857,5,9,12,9,37,50,-13,39
AaB,6857,6,8,12,10,37,42,-5,36
Sonderjyske,6857,7,8,6,10,28,29,-1,30
Lyngby,6857,8,4,9,11,29,44,-15,21
Silkeborg IF,6857,9,6,3,13,28,44,-16,21
Randers FC,6857,10,5,6,13,23,42,-19,21
AGF Aarhus,6857,11,4,6,12,16,39,-23,18
FC Midtjylla,6858,1,20,6,4,68,37,31,66
Brondby,6858,2,19,6,5,69,36,33,63
FC Nords,6858,3,14,7,9,75,58,17,49
Copenhagen,6858,4,14,5,11,58,44,14,47
AC Horsens,6858,5,7,14,9,37,51,-14,35
AaB,6858,6,6,14,10,39,46,-7,32
Sonderjyske,6858,7,8,6,10,28,29,-1,30
Lyngby,6858,8,4,9,11,32,46,-14,21
Randers FC,6858,9,5,6,13,25,45,-20,21
Silkeborg IF,6858,10,5,4,13,26,45,-19,19
AGF Aarhus,6858,11,4,7,11,17,37,-20,19
Brondby,6859,1,20,6,4,72,32,40,66
FC Midtjylla,6859,2,19,5,6,64,42,22,62
FC Nords,6859,3,14,6,10,72,54,18,48
Copenhagen,6859,4,14,6,10,60,45,15,48
AaB,6859,5,9,11,10,37,40,-3,38
AC Horsens,6859,6,6,14,10,34,52,-18,32
Sonderjyske,6859,7,8,6,10,28,29,-1,30
Randers FC,6859,8,5,7,12,23,39,-16,22
Lyngby,6859,9,3,10,11,26,44,-18,19
Silkeborg IF,6859,10,5,4,13,26,45,-19,19
AGF Aarhus,6859,11,4,7,11,17,37,-20,19
Brondby,6860,1,21,6,3,72,31,41,69
FC Midtjylla,6860,2,19,5,6,63,37,26,62
FC Nords,6860,3,15,7,8,73,50,23,52
Copenhagen,6860,4,13,5,12,56,47,9,44
AaB,6860,5,8,11,11,35,40,-5,35
AC Horsens,6860,6,7,12,11,34,54,-20,33
Sonderjyske,6860,7,8,6,10,28,29,-1,30
Randers FC,6860,8,5,7,12,26,42,-16,22
Silkeborg IF,6860,9,6,3,13,27,44,-17,21
Lyngby,6860,10,3,10,11,29,47,-18,19
AGF Aarhus,6860,11,4,6,12,16,38,-22,18
FC Midtjylla,6861,1,21,4,5,69,39,30,67
Brondby,6861,2,19,9,2,71,34,37,66
FC Nords,6861,3,14,8,8,76,53,23,50
Copenhagen,6861,4,13,7,10,58,45,13,46
AaB,6861,5,7,12,11,36,43,-7,33
Sonderjyske,6861,6,8,6,10,28,29,-1,30
AC Horsens,6861,7,5,14,11,35,57,-22,29
Lyngby,6861,8,4,9,11,29,44,-15,21
Silkeborg IF,6861,9,6,3,13,28,45,-17,21
Randers FC,6861,10,5,6,13,23,42,-19,21
AGF Aarhus,6861,11,4,6,12,17,39,-22,18
Brondby,6862,1,20,5,5,69,35,34,65
FC Midtjylla,6862,2,18,6,6,64,41,23,60
FC Nords,6862,3,14,8,8,68,45,23,50
Copenhagen,6862,4,14,4,12,56,44,12,46
AC Horsens,6862,5,8,14,8,38,49,-11,38
AaB,6862,6,8,11,11,38,45,-7,35
Sonderjyske,6862,7,8,6,10,28,29,-1,30
Randers FC,6862,8,5,7,12,25,41,-16,22
Silkeborg IF,6862,9,6,3,13,27,44,-17,21
Lyngby,6862,10,3,10,11,28,46,-18,19
AGF Aarhus,6862,11,4,6,12,16,38,-22,18
Brondby,6863,1,22,5,3,74,30,44,71
FC Midtjylla,6863,2,20,4,6,64,37,27,64
FC Nords,6863,3,14,7,9,72,52,20,49
Copenhagen,6863,4,14,5,11,54,43,11,47
AC Horsens,6863,5,7,12,11,35,52,-17,33
AaB,6863,6,7,11,12,38,49,-11,32
Sonderjyske,6863,7,8,6,10,28,29,-1,30
Randers FC,6863,8,5,7,12,24,40,-16,22
AGF Aarhus,6863,9,5,6,11,19,37,-18,21
Lyngby,6863,10,3,10,11,27,45,-18,19
Silkeborg IF,6863,11,5,3,14,26,47,-21,18
Brondby,6864,1,22,5,3,71,32,39,71
FC Midtjylla,6864,2,21,5,4,63,34,29,68
FC Nords,6864,3,14,7,9,75,51,24,49
Copenhagen,6864,4,12,5,13,53,46,7,41
AaB,6864,5,8,13,9,38,40,-2,37
Sonderjyske,6864,6,8,6,10,28,29,-1,30
AC Horsens,6864,7,5,13,12,30,53,-23,28
Silkeborg IF,6864,8,6,3,13,30,45,-15,21
Lyngby,6864,9,4,9,11,27,44,-17,21
Randers FC,6864,10,5,6,13,23,40,-17,21
AGF Aarhus,6864,11,4,6,12,17,41,-24,18
Brondby,6865,1,21,5,4,73,35,38,68
FC Midtjylla,6865,2,19,6,5,68,40,28,63
Copenhagen,6865,3,15,5,10,60,45,15,50
FC Nords,6865,4,13,9,8,72,51,21,48
AC Horsens,6865,5,7,13,10,37,53,-16,34
Sonderjyske,6865,6,8,6,10,28,29,-1,30
AaB,6865,7,6,12,12,34,46,-12,30
Randers FC,6865,8,5,7,12,24,40,-16,22
AGF Aarhus,6865,9,5,6,11,18,37,-19,21
Lyngby,6865,10,3,10,11,27,45,-18,19
Silkeborg IF,6865,11,5,3,14,26,46,-20,18
Brondby,6866,1,21,6,3,74,35,39,69
FC Midtjylla,6866,2,20,6,4,65,35,30,66
FC Nords,6866,3,13,7,10,74,54,20,46
Copenhagen,6866,4,13,5,12,58,45,13,44
AaB,6866,5,8,12,10,37,42,-5,36
AC Horsens,6866,6,7,12,11,31,54,-23,33
Sonderjyske,6866,7,8,6,10,28,29,-1,30
Silkeborg IF,6866,8,6,3,13,28,44,-16,21
Lyngby,6866,9,4,9,11,28,45,-17,21
Randers FC,6866,10,5,6,13,24,41,-17,21
AGF Aarhus,6866,11,4,6,12,16,39,-23,18
Brondby,6867,1,19,7,4,68,31,37,64
FC Midtjylla,6867,2,20,4,6,69,44,25,64
FC Nords,6867,3,17,6,7,80,49,31,57
Copenhagen,6867,4,13,5,12,55,45,10,44
AC Horsens,6867,5,7,13,10,38,56,-18,34
AaB,6867,6,6,13,11,36,47,-11,31
Sonderjyske,6867,7,8,6,10,28,29,-1,30
Randers FC,6867,8,6,6,12,25,39,-14,24
Silkeborg IF,6867,9,6,3,13,27,45,-18,21
Lyngby,6867,10,3,9,12,26,46,-20,18
AGF Aarhus,6867,11,4,6,12,17,38,-21,18
FC Midtjylla,6868,1,21,5,4,68,34,34,68
Brondby,6868,2,19,7,4,68,34,34,64
FC Nords,6868,3,15,8,7,73,46,27,53
Copenhagen,6868,4,13,5,12,56,47,9,44
AaB,6868,5,8,12,10,38,44,-6,36
Sonderjyske,6868,6,8,6,10,28,29,-1,30
AC Horsens,6868,7,5,13,12,32,56,-24,28
Randers FC,6868,8,5,7,12,25,41,-16,22
AGF Aarhus,6868,9,5,6,11,19,38,-19,21
Lyngby,6868,10,3,10,11,28,46,-18,19
Silkeborg IF,6868,11,5,3,14,27,47,-20,18
Brondby,6869,1,22,6,2,72,28,44,72
FC Midtjylla,6869,2,20,4,6,66,41,25,64
FC Nords,6869,3,14,7,9,73,51,22,49
Copenhagen,6869,4,13,5,12,55,47,8,44
AaB,6869,5,8,11,11,34,42,-8,35
AC Horsens,6869,6,6,13,11,37,54,-17,31
Sonderjyske,6869,7,8,6,10,28,29,-1,30
Lyngby,6869,8,4,9,11,31,44,-13,21
AGF Aarhus,6869,9,5,6,11,17,36,-19,21
Randers FC,6869,10,5,6,13,23,44,-21,21
Silkeborg IF,6869,11,5,3,14,25,45,-20,18
Brondby,6870,1,22,6,2,72,30,42,72
FC Midtjylla,6870,2,19,4,7,67,42,25,61
FC Nords,6870,3,14,7,9,75,57,18,49
Copenhagen,6870,4,13,5,12,57,46,11,44
AC Horsens,6870,5,7,14,9,38,52,-14,35
AaB,6870,6,7,12,11,39,47,-8,33
Sonderjyske,6870,7,8,6,10,28,29,-1,30
Lyngby,6870,8,4,9,11,28,45,-17,21
Randers FC,6870,9,5,6,13,24,41,-17,21
Silkeborg IF,6870,10,5,4,13,26,45,-19,19
AGF Aarhus,6870,11,4,7,11,17,37,-20,19
Brondby,6871,1,21,5,4,66,30,36,68
FC Midtjylla,6871,2,17,5,8,60,41,19,56
FC Nords,6871,3,15,7,8,74,50,24,52
Copenhagen,6871,4,14,5,11,58,47,11,47
AaB,6871,5,9,12,9,41,38,3,39
AC Horsens,6871,6,7,12,11,32,51,-19,33
Sonderjyske,6871,7,8,6,10,28,29,-1,30
Randers FC,6871,8,5,7,12,25,41,-16,22
Silkeborg IF,6871,9,6,3,13,28,46,-18,21
Lyngby,6871,10,3,10,11,28,46,-18,19
AGF Aarhus,6871,11,4,6,12,18,39,-21,18
Brondby,6872,1,20,6,4,69,35,34,66
FC Midtjylla,6872,2,20,4,6,66,42,24,64
FC Nords,6872,3,16,6,8,79,47,32,54
Copenhagen,6872,4,15,4,11,58,44,14,49
AaB,6872,5,7,13,10,33,40,-7,34
Sonderjyske,6872,6,8,6,10,28,29,-1,30
AC Horsens,6872,7,5,13,12,33,56,-23,28
Lyngby,6872,8,4,9,11,28,45,-17,21
Randers FC,6872,9,5,6,13,24,41,-17,21
Silkeborg IF,6872,10,5,4,13,25,44,-19,19
AGF Aarhus,6872,11,4,7,11,16,36,-20,19
Brondby,6873,1,21,5,4,70,34,36,68
FC Midtjylla,6873,2,20,5,5,65,37,28,65
FC Nords,6873,3,15,7,8,74,51,23,52
Copenhagen,6873,4,13,6,11,53,41,12,45
AC Horsens,6873,5,7,13,10,36,49,-13,34
Sonderjyske,6873,6,8,6,10,28,29,-1,30
AaB,6873,7,6,12,12,37,49,-12,30
Randers FC,6873,8,6,6,12,25,39,-14,24
Silkeborg IF,6873,9,6,3,13,27,45,-18,21
Lyngby,6873,10,3,9,12,26,46,-20,18
AGF Aarhus,6873,11,4,6,12,17,38,-21,18
FC Midtjylla,6874,1,21,5,4,68,36,32,68
Brondby,6874,2,19,8,3,66,34,32,65
Copenhagen,6874,3,15,4,11,60,43,17,49
FC Nords,6874,4,13,8,9,75,58,17,47
AaB,6874,5,7,13,10,37,44,-7,34
Sonderjyske,6874,6,8,6,10,28,29,-1,30
AC Horsens,6874,7,6,12,12,34,51,-17,30
Randers FC,6874,8,6,6,12,24,39,-15,24
Silkeborg IF,6874,9,5,4,13,26,45,-19,19
AGF Aarhus,6874,10,4,7,11,17,37,-20,19
Lyngby,6874,11,3,9,12,26,45,-19,18
Brondby,6875,1,20,6,4,69,30,39,66
FC Midtjylla,6875,2,19,4,7,60,44,16,61
FC Nords,6875,3,14,8,8,74,47,27,50
Copenhagen,6875,4,14,5,11,58,44,14,47
AaB,6875,5,8,13,9,36,39,-3,37
AC Horsens,6875,6,7,12,11,34,53,-19,33
Sonderjyske,6875,7,8,6,10,28,29,-1,30
Lyngby,6875,8,4,9,11,28,44,-16,21
Randers FC,6875,9,5,6,13,23,41,-18,21
AGF Aarhus,6875,10,5,6,11,18,37,-19,21
Silkeborg IF,6875,11,5,3,14,26,46,-20,18
Brondby,6876,1,22,6,2,73,28,45,72
FC Midtjylla,6876,2,19,6,5,64,41,23,63
FC Nords,6876,3,14,7,9,77,52,25,49
Copenhagen,6876,4,13,7,10,57,44,13,46
AaB,6876,5,6,14,10,34,43,-9,32
Sonderjyske,6876,6,8,6,10,28,29,-1,30
AC Horsens,6876,7,6,12,12,35,58,-23,30
Lyngby,6876,8,4,9,11,28,45,-17,21
Randers FC,6876,9,5,6,13,24,41,-17,21
Silkeborg IF,6876,10,6,3,13,27,45,-18,21
AGF Aarhus,6876,11,4,6,12,17,38,-21,18
Brondby,6877,1,20,7,3,71,35,36,67
FC Midtjylla,6877,2,19,5,6,63,41,22,62
Copenhagen,6877,3,15,5,10,64,45,19,50
FC Nords,6877,4,14,6,10,77,56,21,48
AC Horsens,6877,5,7,13,10,38,53,-15,34
AaB,6877,6,7,12,11,35,44,-9,33
Sonderjyske,6877,7,8,6,10,28,29,-1,30
Randers FC,6877,8,5,7,12,23,39,-16,22
Silkeborg IF,6877,9,6,3,13,29,44,-15,21
Lyngby,6877,10,3,10,11,26,44,-18,19
AGF Aarhus,6877,11,4,6,12,16,40,-24,18
Brondby,6878,1,21,6,3,77,35,42,69
FC Midtjylla,6878,2,18,7,5,64,41,23,61
FC Nords,6878,3,16,6,8,77,55,22,54
Copenhagen,6878,4,13,5,12,60,47,13,44
AaB,6878,5,8,12,10,38,43,-5,36
Sonderjyske,6878,6,8,6,10,28,29,-1,30
AC Horsens,6878,7,5,14,11,35,56,-21,29
Randers FC,6878,8,5,7,12,25,41,-16,22
Lyngby,6878,9,3,10,11,28,46,-18,19
Silkeborg IF,6878,10,5,4,13,28,47,-19,19
AGF Aarhus,6878,11,4,7,11,19,39,-20,19
Brondby,6879,1,20,6,4,68,31,37,66
FC Midtjylla,6879,2,18,6,6,64,41,23,60
FC Nords,6879,3,15,8,7,73,48,25,53
Copenhagen,6879,4,13,7,10,60,48,12,46
AaB,6879,5,8,12,10,41,44,-3,36
AC Horsens,6879,6,6,13,11,34,54,-20,31
Sonderjyske,6879,7,8,6,10,28,29,-1,30
Randers FC,6879,8,6,6,12,25,39,-14,24
Silkeborg IF,6879,9,5,4,13,28,47,-19,19
AGF Aarhus,6879,10,4,7,11,19,39,-20,19
Lyngby,6879,11,3,9,12,26,46,-20,18
Brondby,6880,1,20,6,4,69,35,34,66
FC Midtjylla,6880,2,20,5,5,69,40,29,65
FC Nords,6880,3,14,9,7,76,53,23,51
Copenhagen,6880,4,13,5,12,59,47,12,44
AC Horsens,6880,5,7,13,10,41,57,-16,34
AaB,6880,6,7,12,11,37,45,-8,33
Sonderjyske,6880,7,8,6,10,28,29,-1,30
Lyngby,6880,8,4,9,11,29,44,-15,21
Randers FC,6880,9,5,6,13,23,42,-19,21
Silkeborg IF,6880,10,5,4,13,27,46,-19,19
AGF Aarhus,6880,11,4,7,11,18,38,-20,19
Brondby,6881,1,20,6,4,72,36,36,66
FC Midtjylla,6881,2,18,5,7,62,42,20,59
FC Nords,6881,3,14,7,9,75,52,23,49
Copenhagen,6881,4,14,7,9,60,43,17,49
AaB,6881,5,8,13,9,37,40,-3,37
AC Horsens,6881,6,6,14,10,32,51,-19,32
Sonderjyske,6881,7,8,6,10,28,29,-1,30
Randers FC,6881,8,6,6,12,25,40,-15,24
Silkeborg IF,6881,9,6,3,13,27,44,-17,21
Lyngby,6881,10,3,9,12,27,46,-19,18
AGF Aarhus,6881,11,4,6,12,16,38,-22,18
Brondby,6882,1,20,7,3,68,30,38,67
FC Midtjylla,6882,2,18,5,7,61,43,18,59
FC Nords,6882,3,14,7,9,72,51,21,49
Copenhagen,6882,4,14,5,11,56,42,14,47
AaB,6882,5,7,14,9,34,38,-4,35
AC Horsens,6882,6,7,14,9,37,50,-13,35
Sonderjyske,6882,7,8,6,10,28,29,-1,30
Randers FC,6882,8,6,6,12,25,40,-15,24
Silkeborg IF,6882,9,6,3,13,26,44,-18,21
Lyngby,6882,10,3,9,12,27,46,-19,18
AGF Aarhus,6882,11,4,6,12,16,37,-21,18
Brondby,6883,1,20,6,4,66,30,36,66
FC Midtjylla,6883,2,18,5,7,61,41,20,59
FC Nords,6883,3,13,9,8,71,48,23,48
Copenhagen,6883,4,14,4,12,53,43,10,46
AC Horsens,6883,5,8,14,8,38,49,-11,38
AaB,6883,6,7,14,9,36,40,-4,35
Sonderjyske,6883,7,8,6,10,28,29,-1,30
Randers FC,6883,8,6,6,12,24,39,-15,24
Silkeborg IF,6883,9,5,4,13,27,46,-19,19
AGF Aarhus,6883,10,4,7,11,18,38,-20,19
Lyngby,6883,11,3,9,12,26,45,-19,18
Brondby,6884,1,19,7,4,66,33,33,64
FC Midtjylla,6884,2,19,5,6,69,40,29,62
FC Nords,6884,3,14,8,8,73,52,21,50
Copenhagen,6884,4,12,7,11,56,47,9,43
AaB,6884,5,10,12,8,41,37,4,42
AC Horsens,6884,6,6,13,11,35,57,-22,31
Sonderjyske,6884,7,8,6,10,28,29,-1,30
Randers FC,6884,8,5,7,12,24,40,-16,22
Silkeborg IF,6884,9,6,3,13,26,44,-18,21
Lyngby,6884,10,3,10,11,27,45,-18,19
AGF Aarhus,6884,11,4,6,12,16,37,-21,18
Brondby,6885,1,21,6,3,73,33,40,69
FC Midtjylla,6885,2,19,6,5,63,38,25,63
FC Nords,6885,3,14,7,9,70,50,20,49
Copenhagen,6885,4,14,5,11,59,47,12,47
AaB,6885,5,8,11,11,37,43,-6,35
AC Horsens,6885,6,6,13,11,35,52,-17,31
Sonderjyske,6885,7,8,6,10,28,29,-1,30
Lyngby,6885,8,4,9,11,28,44,-16,21
Silkeborg IF,6885,9,6,3,13,27,45,-18,21
Randers FC,6885,10,5,6,13,23,41,-18,21
AGF Aarhus,6885,11,4,6,12,17,38,-21,18
Brondby,6886,1,21,5,4,74,34,40,68
FC Midtjylla,6886,2,21,4,5,67,37,30,67
Copenhagen,6886,3,15,4,11,57,43,14,49
FC Nords,6886,4,14,6,10,72,57,15,48
AaB,6886,5,9,11,10,39,40,-1,38
Sonderjyske,6886,6,8,6,10,28,29,-1,30
AC Horsens,6886,7,5,12,13,31,55,-24,27
Lyngby,6886,8,4,9,11,28,44,-16,21
Randers FC,6886,9,5,6,13,23,41,-18,21
Silkeborg IF,6886,10,5,4,13,26,45,-19,19
AGF Aarhus,6886,11,4,7,11,17,37,-20,19
Brondby,6887,1,21,5,4,72,33,39,68
FC Midtjylla,6887,2,20,5,5,68,40,28,65
Copenhagen,6887,3,16,5,9,60,41,19,53
FC Nords,6887,4,13,6,11,71,53,18,45
AaB,6887,5,7,11,12,33,43,-10,32
AC Horsens,6887,6,6,14,10,33,53,-20,32
Sonderjyske,6887,7,8,6,10,28,29,-1,30
Randers FC,6887,8,5,7,12,23,39,-16,22
AGF Aarhus,6887,9,5,6,11,21,39,-18,21
Lyngby,6887,10,3,10,11,26,44,-18,19
Silkeborg IF,6887,11,5,3,14,28,49,-21,18
Brondby,6888,1,19,6,5,67,35,32,63
FC Midtjylla,6888,2,19,5,6,71,40,31,62
Copenhagen,6888,3,15,5,10,65,50,15,50
FC Nords,6888,4,14,6,10,72,53,19,48
AaB,6888,5,11,11,8,41,40,1,44
Sonderjyske,6888,6,8,6,10,28,29,-1,30
AC Horsens,6888,7,5,13,12,34,58,-24,28
Randers FC,6888,8,5,7,12,24,40,-16,22
AGF Aarhus,6888,9,5,6,11,18,37,-19,21
Lyngby,6888,10,3,10,11,27,45,-18,19
Silkeborg IF,6888,11,5,3,14,26,46,-20,18
Brondby,6889,1,21,6,3,74,31,43,69
FC Midtjylla,6889,2,19,5,6,71,46,25,62
Copenhagen,6889,3,16,4,10,64,45,19,52
FC Nords,6889,4,13,7,10,74,60,14,46
AaB,6889,5,7,14,9,39,44,-5,35
Sonderjyske,6889,6,8,6,10,28,29,-1,30
AC Horsens,6889,7,6,12,12,35,57,-22,30
Randers FC,6889,8,5,7,12,24,40,-16,22
Silkeborg IF,6889,9,6,3,13,29,45,-16,21
Lyngby,6889,10,3,10,11,27,45,-18,19
AGF Aarhus,6889,11,4,6,12,17,40,-23,18
Brondby,6890,1,21,7,2,72,31,41,70
FC Midtjylla,6890,2,20,6,4,71,40,31,66
FC Nords,6890,3,14,9,7,79,51,28,51
Copenhagen,6890,4,13,4,13,53,50,3,43
AC Horsens,6890,5,7,12,11,37,55,-18,33
Sonderjyske,6890,6,8,6,10,28,29,-1,30
AaB,6890,7,6,12,12,35,46,-11,30
Randers FC,6890,8,5,7,12,23,39,-16,22
AGF Aarhus,6890,9,5,6,11,17,36,-19,21
Lyngby,6890,10,3,10,11,26,44,-18,19
Silkeborg IF,6890,11,5,3,14,25,45,-20,18
Brondby,6891,1,21,6,3,79,34,45,69
FC Midtjylla,6891,2,19,5,6,63,37,26,62
FC Nords,6891,3,14,7,9,71,49,22,49
Copenhagen,6891,4,12,4,14,54,54,0,40
AaB,6891,5,9,12,9,40,44,-4,39
AC Horsens,6891,6,7,14,9,39,54,-15,35
Sonderjyske,6891,7,8,6,10,28,29,-1,30
Randers FC,6891,8,6,6,12,26,41,-15,24
Silkeborg IF,6891,9,6,3,13,26,44,-18,21
Lyngby,6891,10,3,9,12,28,47,-19,18
AGF Aarhus,6891,11,4,6,12,16,37,-21,18
Brondby,6892,1,21,5,4,69,32,37,68
FC Midtjylla,6892,2,17,5,8,62,43,19,56
Copenhagen,6892,3,17,4,9,65,41,24,55
FC Nords,6892,4,15,7,8,76,54,22,52
AaB,6892,5,7,12,11,39,46,-7,33
AC Horsens,6892,6,6,13,11,33,54,-21,31
Sonderjyske,6892,7,8,6,10,28,29,-1,30
Lyngby,6892,8,4,9,11,27,44,-17,21
Randers FC,6892,9,5,6,13,23,40,-17,21
Silkeborg IF,6892,10,5,4,13,25,44,-19,19
AGF Aarhus,6892,11,4,7,11,16,36,-20,19
Brondby,6893,1,20,6,4,70,37,33,66
FC Midtjylla,6893,2,19,6,5,62,36,26,63
FC Nords,6893,3,13,9,8,72,51,21,48
Copenhagen,6893,4,14,4,12,60,45,15,46
AaB,6893,5,8,13,9,36,38,-2,37
AC Horsens,6893,6,7,12,11,36,55,-19,33
Sonderjyske,6893,7,8,6,10,28,29,-1,30
Lyngby,6893,8,4,9,11,28,45,-17,21
Randers FC,6893,9,5,6,13,24,41,-17,21
Silkeborg IF,6893,10,6,3,13,28,46,-18,21
AGF Aarhus,6893,11,4,6,12,18,39,-21,18
FC Midtjylla,6894,1,21,4,5,69,39,30,67
Brondby,6894,2,20,5,5,71,33,38,65
FC Nords,6894,3,15,6,9,77,50,27,51
Copenhagen,6894,4,14,4,12,60,48,12,46
AC Horsens,6894,5,8,12,10,37,56,-19,36
AaB,6894,6,7,11,12,35,49,-14,32
Sonderjyske,6894,7,8,6,10,28,29,-1,30
Lyngby,6894,8,4,9,11,29,44,-15,21
Silkeborg IF,6894,9,6,3,13,27,45,-18,21
Randers FC,6894,10,5,6,13,23,42,-19,21
AGF Aarhus,6894,11,4,6,12,17,38,-21,18
Brondby,6895,1,22,5,3,76,29,47,71
FC Midtjylla,6895,2,20,5,5,67,37,30,65
FC Nords,6895,3,14,6,10,73,55,18,48
Copenhagen,6895,4,14,6,10,58,45,13,48
AaB,6895,5,7,12,11,36,46,-10,33
Sonderjyske,6895,6,8,6,10,28,29,-1,30
AC Horsens,6895,7,5,14,11,34,58,-24,29
Randers FC,6895,8,5,7,12,23,39,-16,22
Silkeborg IF,6895,9,6,3,13,28,45,-17,21
Lyngby,6895,10,3,10,11,26,44,-18,19
AGF Aarhus,6895,11,4,6,12,17,39,-22,18
Brondby,6896,1,21,7,2,73,33,40,70
FC Midtjylla,6896,2,20,5,5,65,39,26,65
FC Nords,6896,3,14,6,10,73,54,19,48
Copenhagen,6896,4,14,5,11,60,47,13,47
AaB,6896,5,8,12,10,39,42,-3,36
Sonderjyske,6896,6,8,6,10,28,29,-1,30
AC Horsens,6896,7,5,13,12,32,53,-21,28
Randers FC,6896,8,5,7,12,23,39,-16,22
AGF Aarhus,6896,9,5,6,11,17,36,-19,21
Lyngby,6896,10,3,10,11,26,44,-18,19
Silkeborg IF,6896,11,5,3,14,25,45,-20,18
Brondby,6897,1,20,8,2,69,32,37,68
FC Midtjylla,6897,2,19,5,6,67,40,27,62
FC Nords,6897,3,15,6,9,76,53,23,51
Copenhagen,6897,4,14,5,11,57,43,14,47
AaB,6897,5,7,14,9,37,42,-5,35
Sonderjyske,6897,6,8,6,10,28,29,-1,30
AC Horsens,6897,7,5,14,11,33,55,-22,29
Randers FC,6897,8,6,6,12,26,41,-15,24
AGF Aarhus,6897,9,5,6,11,18,37,-19,21
Lyngby,6897,10,3,9,12,28,47,-19,18
Silkeborg IF,6897,11,5,3,14,26,46,-20,18
FC Midtjylla,6898,1,20,5,5,70,37,33,65
Brondby,6898,2,19,6,5,65,36,29,63
FC Nords,6898,3,15,7,8,73,49,24,52
Copenhagen,6898,4,14,4,12,59,49,10,46
AaB,6898,5,8,12,10,36,43,-7,36
AC Horsens,6898,6,7,12,11,39,54,-15,33
Sonderjyske,6898,7,8,6,10,28,29,-1,30
Lyngby,6898,8,4,9,11,27,44,-17,21
Silkeborg IF,6898,8,6,3,13,27,44,-17,21
Randers FC,6898,10,5,6,13,23,40,-17,21
AGF Aarhus,6898,11,4,6,12,16,38,-22,18
Brondby,6899,1,19,7,4,69,36,33,64
FC Midtjylla,6899,2,19,6,5,65,39,26,63
FC Nords,6899,3,16,7,7,76,49,27,55
Copenhagen,6899,4,12,5,13,57,48,9,41
AaB,6899,5,9,11,10,38,41,-3,38
AC Horsens,6899,6,7,12,11,36,54,-18,33
Sonderjyske,6899,7,8,6,10,28,29,-1,30
Randers FC,6899,8,6,6,12,25,40,-15,24
AGF Aarhus,6899,9,5,6,11,18,37,-19,21
Lyngby,6899,10,3,9,12,27,46,-19,18
Silkeborg IF,6899,11,5,3,14,26,46,-20,18
Brondby,6900,1,22,6,2,75,29,46,72
FC Midtjylla,6900,2,19,6,5,65,42,23,63
FC Nords,6900,3,15,6,9,71,49,22,51
Copenhagen,6900,4,14,5,11,59,47,12,47
AC Horsens,6900,5,6,13,11,33,51,-18,31
Sonderjyske,6900,6,8,6,10,28,29,-1,30
AaB,6900,7,6,12,12,34,45,-11,30
Lyngby,6900,8,4,9,11,29,45,-16,21
Silkeborg IF,6900,9,6,3,13,28,45,-17,21
Randers FC,6900,10,5,6,13,24,42,-18,21
AGF Aarhus,6900,11,4,6,12,17,39,-22,18
Brondby,6901,1,20,6,4,67,32,35,66
FC Midtjylla,6901,2,20,5,5,68,36,32,65
Copenhagen,6901,3,15,5,10,57,43,14,50
FC Nords,6901,4,14,6,10,73,53,20,48
AaB,6901,5,9,11,10,36,40,-4,38
Sonderjyske,6901,6,8,6,10,28,29,-1,30
AC Horsens,6901,7,5,13,12,31,54,-23,28
Randers FC,6901,8,6,6,12,26,40,-14,24
AGF Aarhus,6901,9,5,6,11,17,36,-19,21
Lyngby,6901,10,3,9,12,27,47,-20,18
Silkeborg IF,6901,11,5,3,14,25,45,-20,18
Brondby,6902,1,21,6,3,80,35,45,69
FC Midtjylla,6902,2,19,6,5,65,38,27,63
FC Nords,6902,3,14,7,9,71,53,18,49
Copenhagen,6902,4,14,5,11,56,43,13,47
AC Horsens,6902,5,8,12,10,35,53,-18,36
Sonderjyske,6902,6,8,6,10,28,29,-1,30
AaB,6902,7,6,12,12,36,47,-11,30
Randers FC,6902,8,6,6,12,26,41,-15,24
AGF Aarhus,6902,9,5,6,11,17,36,-19,21
Lyngby,6902,10,3,9,12,28,47,-19,18
Silkeborg IF,6902,11,5,3,14,25,45,-20,18
Brondby,6903,1,22,5,3,80,33,47,71
FC Midtjylla,6903,2,20,5,5,71,38,33,65
FC Nords,6903,3,13,8,9,69,54,15,47
Copenhagen,6903,4,14,4,12,58,54,4,46
AaB,6903,5,7,12,11,36,46,-10,33
AC Horsens,6903,6,6,14,10,37,52,-15,32
Sonderjyske,6903,7,8,6,10,28,29,-1,30
Lyngby,6903,8,4,9,11,28,44,-16,21
Randers FC,6903,9,5,6,13,23,41,-18,21
AGF Aarhus,6903,10,5,6,11,18,37,-19,21
Silkeborg IF,6903,11,5,3,14,26,46,-20,18
Brondby,6904,1,20,8,2,68,31,37,68
FC Midtjylla,6904,2,19,7,4,67,37,30,64
Copenhagen,6904,3,15,4,11,61,48,13,49
FC Nords,6904,4,14,6,10,71,52,19,48
AC Horsens,6904,5,6,14,10,34,52,-18,32
AaB,6904,6,6,13,11,38,45,-7,31
Sonderjyske,6904,7,8,6,10,28,29,-1,30
Randers FC,6904,8,5,7,12,25,41,-16,22
Silkeborg IF,6904,9,6,3,13,28,46,-18,21
Lyngby,6904,10,3,10,11,28,46,-18,19
AGF Aarhus,6904,11,4,6,12,18,39,-21,18
Brondby,6905,1,21,7,2,72,32,40,70
FC Midtjylla,6905,2,20,4,6,66,39,27,64
FC Nords,6905,3,14,7,9,72,48,24,49
Copenhagen,6905,4,15,4,11,59,46,13,49
AaB,6905,5,8,12,10,37,41,-4,36
Sonderjyske,6905,6,8,6,10,28,29,-1,30
AC Horsens,6905,7,5,12,13,30,56,-26,27
Lyngby,6905,8,4,9,11,30,45,-15,21
Randers FC,6905,9,5,6,13,24,43,-19,21
Silkeborg IF,6905,10,5,4,13,26,45,-19,19
AGF Aarhus,6905,11,4,7,11,17,37,-20,19
Brondby,6906,1,22,5,3,73,33,40,71
FC Midtjylla,6906,2,19,5,6,72,41,31,62
FC Nords,6906,3,14,6,10,70,58,12,48
Copenhagen,6906,4,13,7,10,58,45,13,46
AaB,6906,5,9,12,9,41,40,1,39
Sonderjyske,6906,6,8,6,10,28,29,-1,30
AC Horsens,6906,7,5,13,12,33,56,-23,28
Lyngby,6906,8,4,9,11,27,44,-17,21
Randers FC,6906,9,5,6,13,23,40,-17,21
AGF Aarhus,6906,10,5,6,11,18,36,-18,21
Silkeborg IF,6906,11,5,3,14,25,46,-21,18
FC Midtjylla,6907,1,21,5,4,69,37,32,68
Brondby,6907,2,20,6,4,70,33,37,66
FC Nords,6907,3,16,6,8,75,49,26,54
Copenhagen,6907,4,13,4,13,58,52,6,43
AC Horsens,6907,5,7,12,11,34,54,-20,33
AaB,6907,6,7,11,12,35,42,-7,32
Sonderjyske,6907,7,8,6,10,28,29,-1,30
Randers FC,6907,8,5,7,12,23,39,-16,22
Silkeborg IF,6907,9,6,3,13,26,44,-18,21
Lyngby,6907,10,3,10,11,26,44,-18,19
AGF Aarhus,6907,11,4,6,12,16,37,-21,18
Brondby,6908,1,22,6,2,75,34,41,72
FC Midtjylla,6908,2,19,6,5,63,39,24,63
Copenhagen,6908,3,15,5,10,62,45,17,50
FC Nords,6908,4,12,7,11,68,54,14,43
AaB,6908,5,8,13,9,42,43,-1,37
Sonderjyske,6908,6,8,6,10,28,29,-1,30
AC Horsens,6908,7,5,13,12,32,53,-21,28
Lyngby,6908,8,4,9,11,27,44,-17,21
Randers FC,6908,9,5,6,13,23,40,-17,21
AGF Aarhus,6908,10,5,6,11,19,36,-17,21
Silkeborg IF,6908,11,5,3,14,25,47,-22,18
Brondby,6909,1,21,6,3,76,36,40,69
FC Midtjylla,6909,2,19,4,7,63,43,20,61
FC Nords,6909,3,13,9,8,74,52,22,48
Copenhagen,6909,4,14,5,11,58,46,12,47
AaB,6909,5,8,12,10,37,42,-5,36
AC Horsens,6909,6,6,14,10,38,53,-15,32
Sonderjyske,6909,7,8,6,10,28,29,-1,30
Lyngby,6909,8,4,9,11,29,46,-17,21
Randers FC,6909,9,5,6,13,25,42,-17,21
Silkeborg IF,6909,10,6,3,13,26,44,-18,21
AGF Aarhus,6909,11,4,6,12,16,37,-21,18
Brondby,6910,1,22,6,2,76,34,42,72
FC Midtjylla,6910,2,20,6,4,68,38,30,66
Copenhagen,6910,3,13,7,10,59,45,14,46
FC Nords,6910,4,12,7,11,70,55,15,43
AaB,6910,5,8,12,10,37,42,-5,36
Sonderjyske,6910,6,8,6,10,28,29,-1,30
AC Horsens,6910,7,6,12,12,35,57,-22,30
Lyngby,6910,8,4,9,11,28,44,-16,21
Randers FC,6910,9,5,6,13,23,41,-18,21
Silkeborg IF,6910,10,5,4,13,27,46,-19,19
AGF Aarhus,6910,11,4,7,11,18,38,-20,19
FC Midtjylla,6911,1,21,5,4,66,37,29,68
Brondby,6911,2,19,7,4,70,36,34,64
FC Nords,6911,3,14,7,9,72,49,23,49
Copenhagen,6911,4,14,5,11,58,46,12,47
AaB,6911,5,7,12,11,36,42,-6,33
AC Horsens,6911,6,7,12,11,34,52,-18,33
Sonderjyske,6911,7,8,6,10,28,29,-1,30
Lyngby,6911,8,4,9,11,29,45,-16,21
Randers FC,6911,9,5,6,13,24,42,-18,21
AGF Aarhus,6911,10,5,6,11,19,37,-18,21
Silkeborg IF,6911,11,5,3,14,26,47,-21,18
Brondby,6912,1,21,6,3,69,30,39,69
FC Midtjylla,6912,2,20,4,6,63,39,24,64
FC Nords,6912,3,14,7,9,72,51,21,49
Copenhagen,6912,4,14,5,11,55,42,13,47
AC Horsens,6912,5,8,12,10,35,50,-15,36
Sonderjyske,6912,6,8,6,10,28,29,-1,30
AaB,6912,7,6,12,12,36,44,-8,30
Randers FC,6912,8,5,7,12,23,39,-16,22
Lyngby,6912,9,3,10,11,26,44,-18,19
Silkeborg IF,6912,10,5,4,13,27,46,-19,19
AGF Aarhus,6912,11,4,7,11,18,38,-20,19
Brondby,6913,1,20,7,3,73,37,36,67
FC Midtjylla,6913,2,19,6,5,65,38,27,63
FC Nords,6913,3,15,7,8,75,50,25,52
Copenhagen,6913,4,15,5,10,59,44,15,50
AC Horsens,6913,5,6,13,11,31,50,-19,31
Sonderjyske,6913,6,8,6,10,28,29,-1,30
AaB,6913,7,6,12,12,33,43,-10,30
Lyngby,6913,8,4,9,11,29,45,-16,21
Randers FC,6913,9,5,6,13,24,42,-18,21
Silkeborg IF,6913,10,5,4,13,26,45,-19,19
AGF Aarhus,6913,11,4,7,11,17,37,-20,19
Brondby,6914,1,20,7,3,67,32,35,67
FC Midtjylla,6914,2,20,6,4,69,37,32,66
FC Nords,6914,3,15,8,7,76,52,24,53
Copenhagen,6914,4,14,5,11,59,42,17,47
AaB,6914,5,6,13,11,35,44,-9,31
Sonderjyske,6914,6,8,6,10,28,29,-1,30
AC Horsens,6914,7,5,13,12,34,59,-25,28
Randers FC,6914,8,6,6,12,25,40,-15,24
Silkeborg IF,6914,9,6,3,13,30,44,-14,21
Lyngby,6914,10,3,9,12,27,46,-19,18
AGF Aarhus,6914,11,4,6,12,16,41,-25,18
Brondby,6915,1,21,6,3,70,33,37,69
FC Midtjylla,6915,2,19,7,4,66,38,28,64
Copenhagen,6915,3,14,5,11,58,47,11,47
FC Nords,6915,4,13,7,10,76,54,22,46
AC Horsens,6915,5,7,13,10,37,53,-16,34
AaB,6915,6,7,12,11,35,43,-8,33
Sonderjyske,6915,7,8,6,10,28,29,-1,30
Lyngby,6915,8,4,9,11,27,44,-17,21
Randers FC,6915,9,5,6,13,23,40,-17,21
AGF Aarhus,6915,10,5,6,11,17,36,-19,21
Silkeborg IF,6915,11,5,3,14,25,45,-20,18
Brondby,6916,1,20,5,5,69,34,35,65
FC Midtjylla,6916,2,20,4,6,68,41,27,64
FC Nords,6916,3,15,7,8,75,49,26,52
Copenhagen,6916,4,16,4,10,61,44,17,52
AaB,6916,5,7,12,11,37,46,-9,33
Sonderjyske,6916,6,8,6,10,28,29,-1,30
AC Horsens,6916,7,6,12,12,32,54,-22,30
Lyngby,6916,8,4,9,11,30,44,-14,21
Silkeborg IF,6916,9,6,3,13,27,45,-18,21
Randers FC,6916,10,5,6,13,23,43,-20,21
AGF Aarhus,6916,11,4,6,12,17,38,-21,18
Brondby,6917,1,21,6,3,72,34,38,69
FC Midtjylla,6917,2,19,6,5,68,41,27,63
Copenhagen,6917,3,14,5,11,58,44,14,47
FC Nords,6917,4,13,7,10,71,55,16,46
AaB,6917,5,8,13,9,39,41,-2,37
AC Horsens,6917,6,6,13,11,33,52,-19,31
Sonderjyske,6917,7,8,6,10,28,29,-1,30
Randers FC,6917,8,6,6,12,24,39,-15,24
Silkeborg IF,6917,9,5,4,13,26,45,-19,19
AGF Aarhus,6917,10,4,7,11,17,37,-20,19
Lyngby,6917,11,3,9,12,26,45,-19,18
Brondby,6918,1,20,6,4,73,39,34,66
FC Midtjylla,6918,2,20,6,4,70,41,29,66
FC Nords,6918,3,13,7,10,74,53,21,46
Copenhagen,6918,4,13,7,10,58,45,13,46
AaB,6918,5,8,13,9,41,46,-5,37
AC Horsens,6918,6,6,13,11,41,59,-18,31
Sonderjyske,6918,7,8,6,10,28,29,-1,30
Lyngby,6918,8,4,9,11,28,45,-17,21
Randers FC,6918,9,5,6,13,24,41,-17,21
AGF Aarhus,6918,10,5,6,11,18,36,-18,21
Silkeborg IF,6918,11,5,3,14,25,46,-21,18
Brondby,6919,1,20,5,5,67,35,32,65
FC Midtjylla,6919,2,19,5,6,65,41,24,62
FC Nords,6919,3,15,7,8,76,48,28,52
Copenhagen,6919,4,16,4,10,61,47,14,52
AC Horsens,6919,5,6,14,10,34,50,-16,32
AaB,6919,6,6,13,11,34,42,-8,31
Sonderjyske,6919,7,8,6,10,28,29,-1,30
Silkeborg IF,6919,8,6,3,13,30,44,-14,21
Lyngby,6919,9,4,9,11,27,44,-17,21
Randers FC,6919,10,5,6,13,23,40,-17,21
AGF Aarhus,6919,11,4,6,12,16,41,-25,18
Brondby,6920,1,20,6,4,68,32,36,66
FC Midtjylla,6920,2,20,5,5,68,38,30,65
FC Nords,6920,3,14,7,9,78,56,22,49
Copenhagen,6920,4,14,5,11,58,49,9,47
AaB,6920,5,8,13,9,42,46,-4,37
Sonderjyske,6920,6,8,6,10,28,29,-1,30
AC Horsens,6920,7,6,12,12,33,52,-19,30
Silkeborg IF,6920,8,6,3,13,28,44,-16,21
Lyngby,6920,9,4,9,11,29,46,-17,21
Randers FC,6920,10,5,6,13,25,42,-17,21
AGF Aarhus,6920,11,4,6,12,16,39,-23,18
Brondby,6921,1,20,7,3,71,35,36,67
FC Midtjylla,6921,2,21,4,5,72,42,30,67
Copenhagen,6921,3,14,5,11,62,49,13,47
FC Nords,6921,4,13,6,11,72,53,19,45
AaB,6921,5,7,13,10,36,44,-8,34
AC Horsens,6921,6,7,13,10,34,50,-16,34
Sonderjyske,6921,7,8,6,10,28,29,-1,30
Lyngby,6921,8,4,9,11,28,44,-16,21
Silkeborg IF,6921,9,6,3,13,27,45,-18,21
Randers FC,6921,10,5,6,13,23,41,-18,21
AGF Aarhus,6921,11,4,6,12,17,38,-21,18
FC Midtjylla,6922,1,22,4,4,69,37,32,70
Brondby,6922,2,19,7,4,66,32,34,64
FC Nords,6922,3,15,6,9,74,51,23,51
Copenhagen,6922,4,14,5,11,57,43,14,47
AaB,6922,5,7,11,12,34,43,-9,32
AC Horsens,6922,6,6,13,11,34,54,-20,31
Sonderjyske,6922,7,8,6,10,28,29,-1,30
Randers FC,6922,8,5,7,12,24,40,-16,22
AGF Aarhus,6922,9,5,6,11,21,38,-17,21
Lyngby,6922,10,3,10,11,27,45,-18,19
Silkeborg IF,6922,11,5,3,14,27,49,-22,18
Brondby,6923,1,19,8,3,68,34,34,65
FC Midtjylla,6923,2,19,6,5,68,40,28,63
Copenhagen,6923,3,15,4,11,57,42,15,49
FC Nords,6923,4,12,7,11,70,57,13,43
AC Horsens,6923,5,8,13,9,37,49,-12,37
AaB,6923,6,8,12,10,37,41,-4,36
Sonderjyske,6923,7,8,6,10,28,29,-1,30
Randers FC,6923,8,5,7,12,24,40,-16,22
Silkeborg IF,6923,9,6,3,13,26,44,-18,21
Lyngby,6923,10,3,10,11,27,45,-18,19
AGF Aarhus,6923,11,4,6,12,16,37,-21,18
Brondby,6924,1,22,5,3,75,33,42,71
FC Midtjylla,6924,2,20,5,5,71,40,31,65
FC Nords,6924,3,14,7,9,77,54,23,49
Copenhagen,6924,4,15,4,11,59,44,15,49
AaB,6924,5,7,11,12,36,52,-16,32
Sonderjyske,6924,6,8,6,10,28,29,-1,30
AC Horsens,6924,7,6,12,12,32,53,-21,30
Randers FC,6924,8,6,6,12,25,39,-14,24
Silkeborg IF,6924,9,6,3,13,27,45,-18,21
Lyngby,6924,10,3,9,12,26,46,-20,18
AGF Aarhus,6924,11,4,6,12,17,38,-21,18
FC Midtjylla,6925,1,21,5,4,68,38,30,68
Brondby,6925,2,20,7,3,72,31,41,67
FC Nords,6925,3,14,7,9,75,52,23,49
Copenhagen,6925,4,13,4,13,54,50,4,43
AaB,6925,5,8,12,10,39,42,-3,36
AC Horsens,6925,6,6,13,11,34,55,-21,31
Sonderjyske,6925,7,8,6,10,28,29,-1,30
Randers FC,6925,8,5,7,12,24,40,-16,22
AGF Aarhus,6925,9,5,6,11,18,37,-19,21
Lyngby,6925,10,3,10,11,27,45,-18,19
Silkeborg IF,6925,11,5,3,14,26,46,-20,18
Brondby,6926,1,21,5,4,70,32,38,68
FC Midtjylla,6926,2,17,5,8,58,46,12,56
FC Nords,6926,3,14,8,8,76,48,28,50
Copenhagen,6926,4,15,5,10,59,43,16,50
AaB,6926,5,8,13,9,37,38,-1,37
AC Horsens,6926,6,6,14,10,36,55,-19,32
Sonderjyske,6926,7,8,6,10,28,29,-1,30
Lyngby,6926,8,4,9,11,28,45,-17,21
Randers FC,6926,9,5,6,13,24,41,-17,21
Silkeborg IF,6926,10,6,3,13,27,45,-18,21
AGF Aarhus,6926,11,4,6,12,17,38,-21,18
Brondby,6927,1,21,7,2,70,30,40,70
FC Midtjylla,6927,2,19,4,7,67,40,27,61
FC Nords,6927,3,15,8,7,73,48,25,53
Copenhagen,6927,4,14,5,11,57,46,11,47
AaB,6927,5,7,11,12,32,40,-8,32
AC Horsens,6927,6,6,13,11,31,52,-21,31
Sonderjyske,6927,7,8,6,10,28,29,-1,30
Randers FC,6927,8,5,7,12,23,39,-16,22
AGF Aarhus,6927,9,5,6,11,17,36,-19,21
Lyngby,6927,10,3,10,11,26,44,-18,19
Silkeborg IF,6927,11,5,3,14,25,45,-20,18
Brondby,6928,1,22,6,2,76,27,49,72
FC Midtjylla,6928,2,20,5,5,67,38,29,65
FC Nords,6928,3,15,6,9,75,57,18,51
Copenhagen,6928,4,13,5,12,54,44,10,44
AaB,6928,5,6,13,11,34,43,-9,31
AC Horsens,6928,6,6,13,11,34,57,-23,31
Sonderjyske,6928,7,8,6,10,28,29,-1,30
Randers FC,6928,8,6,6,12,24,39,-15,24
Silkeborg IF,6928,9,6,3,13,27,44,-17,21
Lyngby,6928,10,3,9,12,26,45,-19,18
AGF Aarhus,6928,11,4,6,12,16,38,-22,18
Brondby,6929,1,19,6,5,65,33,32,63
FC Midtjylla,6929,2,18,6,6,66,41,25,60
FC Nords,6929,3,14,8,8,73,53,20,50
Copenhagen,6929,4,12,6,12,56,46,10,42
AaB,6929,5,10,11,9,40,40,0,41
AC Horsens,6929,6,8,13,9,34,47,-13,37
Sonderjyske,6929,7,8,6,10,28,29,-1,30
Lyngby,6929,8,4,9,11,29,45,-16,21
Randers FC,6929,9,5,6,13,24,42,-18,21
AGF Aarhus,6929,10,5,6,11,17,36,-19,21
Silkeborg IF,6929,11,5,3,14,25,45,-20,18
Brondby,6930,1,21,5,4,72,36,36,68
FC Midtjylla,6930,2,19,5,6,61,41,20,62
FC Nords,6930,3,16,6,8,81,50,31,54
Copenhagen,6930,4,13,6,11,62,48,14,45
AC Horsens,6930,5,7,13,10,37,51,-14,34
AaB,6930,6,6,13,11,36,49,-13,31
Sonderjyske,6930,7,8,6,10,28,29,-1,30
Randers FC,6930,8,5,7,12,23,39,-16,22
Silkeborg IF,6930,9,6,3,13,27,44,-17,21
Lyngby,6930,10,3,10,11,26,44,-18,19
AGF Aarhus,6930,11,4,6,12,16,38,-22,18
Brondby,6931,1,22,5,3,70,30,40,71
FC Midtjylla,6931,2,20,4,6,66,38,28,64
FC Nords,6931,3,15,6,9,72,56,16,51
Copenhagen,6931,4,14,5,11,60,45,15,47
AC Horsens,6931,5,7,12,11,40,53,-13,33
Sonderjyske,6931,6,8,6,10,28,29,-1,30
AaB,6931,7,6,12,12,34,46,-12,30
Randers FC,6931,8,5,7,12,24,40,-16,22
Lyngby,6931,9,3,10,11,27,45,-18,19
Silkeborg IF,6931,10,5,4,13,27,46,-19,19
AGF Aarhus,6931,11,4,7,11,18,38,-20,19
Brondby,6932,1,21,7,2,73,33,40,70
FC Midtjylla,6932,2,18,6,6,62,40,22,60
FC Nords,6932,3,13,7,10,75,54,21,46
Copenhagen,6932,4,13,7,10,58,44,14,46
AaB,6932,5,8,12,10,38,46,-8,36
AC Horsens,6932,6,7,13,10,35,50,-15,34
Sonderjyske,6932,7,8,6,10,28,29,-1,30
Randers FC,6932,8,5,7,12,24,40,-16,22
AGF Aarhus,6932,9,5,6,11,19,36,-17,21
Lyngby,6932,10,3,10,11,27,45,-18,19
Silkeborg IF,6932,11,5,3,14,25,47,-22,18
Brondby,6933,1,20,6,4,73,35,38,66
FC Midtjylla,6933,2,19,7,4,72,41,31,64
FC Nords,6933,3,14,6,10,75,56,19,48
Copenhagen,6933,4,12,5,13,54,49,5,41
AC Horsens,6933,5,9,12,9,36,49,-13,39
AaB,6933,6,8,12,10,36,42,-6,36
Sonderjyske,6933,7,8,6,10,28,29,-1,30
Randers FC,6933,8,5,7,12,24,40,-16,22
Silkeborg IF,6933,9,6,3,13,27,44,-17,21
Lyngby,6933,10,3,10,11,27,45,-18,19
AGF Aarhus,6933,11,4,6,12,16,38,-22,18
Brondby,6934,1,22,6,2,75,30,45,72
FC Midtjylla,6934,2,20,4,6,69,45,24,64
FC Nords,6934,3,13,8,9,71,50,21,47
Copenhagen,6934,4,12,5,13,56,48,8,41
AaB,6934,5,9,11,10,37,43,-6,38
AC Horsens,6934,6,6,14,10,34,52,-18,32
Sonderjyske,6934,7,8,6,10,28,29,-1,30
Lyngby,6934,8,4,9,11,27,44,-17,21
Randers FC,6934,9,5,6,13,23,40,-17,21
Silkeborg IF,6934,10,5,4,13,26,45,-19,19
AGF Aarhus,6934,11,4,7,11,17,37,-20,19
Brondby,6935,1,21,7,2,70,31,39,70
FC Midtjylla,6935,2,20,5,5,65,39,26,65
FC Nords,6935,3,14,7,9,74,53,21,49
Copenhagen,6935,4,13,6,11,60,47,13,45
AaB,6935,5,8,12,10,36,41,-5,36
Sonderjyske,6935,6,8,6,10,28,29,-1,30
AC Horsens,6935,7,5,13,12,34,54,-20,28
Randers FC,6935,8,6,6,12,24,39,-15,24
Silkeborg IF,6935,9,6,3,13,28,44,-16,21
Lyngby,6935,10,3,9,12,26,45,-19,18
AGF Aarhus,6935,11,4,6,12,16,39,-23,18
Brondby,6936,1,22,5,3,78,34,44,71
FC Midtjylla,6936,2,19,4,7,65,42,23,61
FC Nords,6936,3,14,6,10,72,55,17,48
Copenhagen,6936,4,13,4,13,56,47,9,43
AC Horsens,6936,5,8,13,9,38,50,-12,37
AaB,6936,6,8,12,10,37,44,-7,36
Sonderjyske,6936,7,8,6,10,28,29,-1,30
Lyngby,6936,8,4,9,11,30,45,-15,21
Randers FC,6936,9,5,6,13,24,43,-19,21
Silkeborg IF,6936,10,5,4,13,25,44,-19,19
AGF Aarhus,6936,11,4,7,11,16,36,-20,19
FC Midtjylla,6937,1,20,5,5,66,36,30,65
Brondby,6937,2,19,7,4,69,36,33,64
Copenhagen,6937,3,16,4,10,61,43,18,52
FC Nords,6937,4,12,7,11,67,53,14,43
AaB,6937,5,9,12,9,37,40,-3,39
AC Horsens,6937,6,6,13,11,33,51,-18,31
Sonderjyske,6937,7,8,6,10,28,29,-1,30
Randers FC,6937,8,6,6,12,26,40,-14,24
Silkeborg IF,6937,9,6,3,13,28,45,-17,21
Lyngby,6937,10,3,9,12,27,47,-20,18
AGF Aarhus,6937,11,4,6,12,17,39,-22,18
Brondby,6938,1,21,6,3,70,31,39,69
FC Midtjylla,6938,2,19,4,7,65,37,28,61
FC Nords,6938,3,13,6,11,69,56,13,45
Copenhagen,6938,4,13,5,12,55,46,9,44
AaB,6938,5,9,12,9,39,41,-2,39
AC Horsens,6938,6,8,13,9,36,49,-13,37
Sonderjyske,6938,7,8,6,10,28,29,-1,30
Randers FC,6938,8,6,6,12,25,40,-15,24
Silkeborg IF,6938,9,5,4,13,27,46,-19,19
AGF Aarhus,6938,10,4,7,11,18,38,-20,19
Lyngby,6938,11,3,9,12,27,46,-19,18
Brondby,6939,1,20,6,4,69,34,35,66
FC Midtjylla,6939,2,20,4,6,65,38,27,64
FC Nords,6939,3,15,7,8,76,51,25,52
Copenhagen,6939,4,13,4,13,57,49,8,43
AaB,6939,5,9,12,9,38,42,-4,39
AC Horsens,6939,6,6,13,11,36,53,-17,31
Sonderjyske,6939,7,8,6,10,28,29,-1,30
Lyngby,6939,8,4,9,11,29,45,-16,21
Silkeborg IF,6939,9,6,3,13,27,45,-18,21
Randers FC,6939,10,5,6,13,24,42,-18,21
AGF Aarhus,6939,11,4,6,12,17,38,-21,18
Brondby,6940,1,22,6,2,73,30,43,72
FC Midtjylla,6940,2,21,4,5,69,38,31,67
FC Nords,6940,3,14,7,9,72,51,21,49
Copenhagen,6940,4,12,4,14,52,46,6,40
AaB,6940,5,9,11,10,37,44,-7,38
Sonderjyske,6940,6,8,6,10,28,29,-1,30
AC Horsens,6940,7,6,12,12,32,52,-20,30
Randers FC,6940,8,5,7,12,25,41,-16,22
Silkeborg IF,6940,9,6,3,13,26,44,-18,21
Lyngby,6940,10,3,10,11,28,46,-18,19
AGF Aarhus,6940,11,4,6,12,16,37,-21,18
Brondby,6941,1,21,5,4,70,36,34,68
FC Midtjylla,6941,2,20,4,6,64,37,27,64
Copenhagen,6941,3,14,5,11,59,42,17,47
FC Nords,6941,4,13,7,10,71,54,17,46
AaB,6941,5,8,12,10,34,41,-7,36
AC Horsens,6941,6,6,15,9,35,49,-14,33
Sonderjyske,6941,7,8,6,10,28,29,-1,30
Lyngby,6941,8,4,9,11,32,45,-13,21
Randers FC,6941,9,5,6,13,24,45,-21,21
Silkeborg IF,6941,10,5,4,13,26,45,-19,19
AGF Aarhus,6941,11,4,7,11,17,37,-20,19
Brondby,6942,1,21,7,2,71,31,40,70
FC Midtjylla,6942,2,18,4,8,61,40,21,58
FC Nords,6942,3,15,7,8,77,49,28,52
Copenhagen,6942,4,13,7,10,56,42,14,46
AaB,6942,5,9,12,9,36,38,-2,39
Sonderjyske,6942,6,8,6,10,28,29,-1,30
AC Horsens,6942,7,5,13,12,31,58,-27,28
Randers FC,6942,8,5,7,12,23,39,-16,22
Lyngby,6942,9,3,10,11,26,44,-18,19
Silkeborg IF,6942,10,5,4,13,27,46,-19,19
AGF Aarhus,6942,11,4,7,11,18,38,-20,19
Brondby,6943,1,19,8,3,69,32,37,65
FC Midtjylla,6943,2,19,6,5,67,39,28,63
FC Nords,6943,3,16,7,7,75,48,27,55
Copenhagen,6943,4,13,4,13,54,47,7,43
AaB,6943,5,7,13,10,39,45,-6,34
AC Horsens,6943,6,7,12,11,36,55,-19,33
Sonderjyske,6943,7,8,6,10,28,29,-1,30
Randers FC,6943,8,6,6,12,25,40,-15,24
Silkeborg IF,6943,9,5,4,13,26,45,-19,19
AGF Aarhus,6943,10,4,7,11,17,37,-20,19
Lyngby,6943,11,3,9,12,27,46,-19,18
Brondby,6944,1,20,6,4,69,34,35,66
FC Midtjylla,6944,2,20,4,6,66,36,30,64
Copenhagen,6944,3,15,4,11,57,44,13,49
FC Nords,6944,4,14,6,10,72,52,20,48
AaB,6944,5,9,11,10,38,41,-3,38
AC Horsens,6944,6,6,13,11,34,55,-21,31
Sonderjyske,6944,7,8,6,10,28,29,-1,30
Randers FC,6944,8,5,7,12,24,40,-16,22
AGF Aarhus,6944,9,5,6,11,17,36,-19,21
Lyngby,6944,10,3,10,11,27,45,-18,19
Silkeborg IF,6944,11,5,3,14,25,45,-20,18
Brondby,6945,1,21,7,2,69,30,39,70
FC Midtjylla,6945,2,19,4,7,62,42,20,61
FC Nords,6945,3,15,7,8,77,47,30,52
Copenhagen,6945,4,14,4,12,55,46,9,46
AaB,6945,5,8,12,10,40,40,0,36
Sonderjyske,6945,6,8,6,10,28,29,-1,30
AC Horsens,6945,7,5,14,11,31,55,-24,29
Randers FC,6945,8,6,6,12,26,40,-14,24
Silkeborg IF,6945,9,6,3,13,27,45,-18,21
Lyngby,6945,10,3,9,12,27,47,-20,18
AGF Aarhus,6945,11,4,6,12,17,38,-21,18
Brondby,6946,1,19,8,3,71,36,35,65
FC Midtjylla,6946,2,18,6,6,65,44,21,60
FC Nords,6946,3,14,8,8,76,53,23,50
Copenhagen,6946,4,13,5,12,61,50,11,44
AaB,6946,5,9,12,9,42,44,-2,39
AC Horsens,6946,6,7,13,10,39,53,-14,34
Sonderjyske,6946,7,8,6,10,28,29,-1,30
Lyngby,6946,8,4,9,11,29,46,-17,21
Randers FC,6946,9,5,6,13,25,42,-17,21
Silkeborg IF,6946,10,5,4,13,26,45,-19,19
AGF Aarhus,6946,11,4,7,11,17,37,-20,19
FC Midtjylla,6947,1,21,5,4,68,38,30,68
Brondby,6947,2,20,6,4,69,33,36,66
FC Nords,6947,3,14,7,9,73,54,19,49
Copenhagen,6947,4,13,4,13,55,47,8,43
AaB,6947,5,7,13,10,41,46,-5,34
AC Horsens,6947,6,7,13,10,42,56,-14,34
Sonderjyske,6947,7,8,6,10,28,29,-1,30
Randers FC,6947,8,6,6,12,25,40,-15,24
Silkeborg IF,6947,9,5,4,13,26,45,-19,19
AGF Aarhus,6947,10,4,7,11,17,37,-20,19
Lyngby,6947,11,3,9,12,27,46,-19,18
Brondby,6948,1,22,6,2,74,31,43,72
FC Midtjylla,6948,2,20,4,6,68,40,28,64
FC Nords,6948,3,13,7,10,71,54,17,46
Copenhagen,6948,4,14,4,12,56,44,12,46
AaB,6948,5,8,12,10,36,43,-7,36
AC Horsens,6948,6,6,13,11,32,51,-19,31
Sonderjyske,6948,7,8,6,10,28,29,-1,30
Randers FC,6948,8,6,6,12,25,40,-15,24
Silkeborg IF,6948,9,6,3,13,26,44,-18,21
Lyngby,6948,10,3,9,12,27,46,-19,18
AGF Aarhus,6948,11,4,6,12,16,37,-21,18
Brondby,6949,1,20,7,3,74,34,40,67
FC Midtjylla,6949,2,20,4,6,64,41,23,64
FC Nords,6949,3,15,7,8,72,52,20,52
Copenhagen,6949,4,13,4,13,56,47,9,43
AaB,6949,5,8,13,9,42,43,-1,37
AC Horsens,6949,6,6,13,11,36,53,-17,31
Sonderjyske,6949,7,8,6,10,28,29,-1,30
Randers FC,6949,8,6,6,12,27,39,-12,24
Silkeborg IF,6949,9,5,4,13,26,45,-19,19
AGF Aarhus,6949,10,4,7,11,17,37,-20,19
Lyngby,6949,11,3,9,12,26,48,-22,18
Brondby,6950,1,20,6,4,70,36,34,66
FC Midtjylla,6950,2,20,4,6,66,40,26,64
FC Nords,6950,3,12,9,9,71,55,16,45
Copenhagen,6950,4,13,6,11,60,47,13,45
AC Horsens,6950,5,8,14,8,41,49,-8,38
AaB,6950,6,7,13,10,36,43,-7,34
Sonderjyske,6950,7,8,6,10,28,29,-1,30
Randers FC,6950,8,5,7,12,24,40,-16,22
Silkeborg IF,6950,9,6,3,13,29,46,-17,21
Lyngby,6950,10,3,10,11,27,45,-18,19
AGF Aarhus,6950,11,4,6,12,18,40,-22,18
Brondby,6951,1,20,7,3,69,32,37,67
FC Midtjylla,6951,2,19,5,6,67,41,26,62
FC Nords,6951,3,15,7,8,74,50,24,52
Copenhagen,6951,4,13,6,11,58,47,11,45
AC Horsens,6951,5,7,13,10,36,53,-17,34
AaB,6951,6,6,14,10,37,44,-7,32
Sonderjyske,6951,7,8,6,10,28,29,-1,30
Lyngby,6951,8,4,9,11,28,44,-16,21
Randers FC,6951,9,5,6,13,23,41,-18,21
AGF Aarhus,6951,10,5,6,11,18,37,-19,21
Silkeborg IF,6951,11,5,3,14,26,46,-20,18
Brondby,6952,1,19,8,3,73,36,37,65
FC Midtjylla,6952,2,19,6,5,65,39,26,63
Copenhagen,6952,3,15,6,9,60,41,19,51
FC Nords,6952,4,13,7,10,72,55,17,46
AaB,6952,5,9,12,9,38,41,-3,39
Sonderjyske,6952,6,8,6,10,28,29,-1,30
AC Horsens,6952,7,5,13,12,34,56,-22,28
Lyngby,6952,8,4,9,11,27,44,-17,21
Randers FC,6952,9,5,6,13,23,40,-17,21
Silkeborg IF,6952,10,6,3,13,26,44,-18,21
AGF Aarhus,6952,11,4,6,12,16,37,-21,18
Brondby,6953,1,19,7,4,69,36,33,64
FC Midtjylla,6953,2,18,5,7,63,40,23,59
FC Nords,6953,3,16,6,8,77,49,28,54
Copenhagen,6953,4,14,5,11,61,48,13,47
AaB,6953,5,8,12,10,37,42,-5,36
AC Horsens,6953,6,7,13,10,36,54,-18,34
Sonderjyske,6953,7,8,6,10,28,29,-1,30
Lyngby,6953,8,4,9,11,27,44,-17,21
Randers FC,6953,9,5,6,13,23,40,-17,21
Silkeborg IF,6953,10,5,4,13,25,44,-19,19
AGF Aarhus,6953,11,4,7,11,16,36,-20,19
Brondby,6954,1,22,5,3,71,29,42,71
FC Midtjylla,6954,2,20,6,4,61,32,29,66
FC Nords,6954,3,14,7,9,70,51,19,49
Copenhagen,6954,4,13,6,11,54,44,10,45
AaB,6954,5,7,12,11,34,40,-6,33
Sonderjyske,6954,6,8,6,10,28,29,-1,30
AC Horsens,6954,7,5,14,11,33,53,-20,29
Lyngby,6954,8,4,9,11,29,44,-15,21
Silkeborg IF,6954,9,6,3,13,27,45,-18,21
Randers FC,6954,10,5,6,13,23,42,-19,21
AGF Aarhus,6954,11,4,6,12,17,38,-21,18
Brondby,6955,1,22,5,3,76,34,42,71
FC Midtjylla,6955,2,20,4,6,64,39,25,64
FC Nords,6955,3,15,7,8,72,51,21,52
Copenhagen,6955,4,15,4,11,61,42,19,49
Sonderjyske,6955,5,8,6,10,28,29,-1,30
AaB,6955,6,6,12,12,37,47,-10,30
AC Horsens,6955,7,6,12,12,35,58,-23,30
Lyngby,6955,8,4,9,11,27,44,-17,21
Randers FC,6955,9,5,6,13,23,40,-17,21
Silkeborg IF,6955,10,6,3,13,27,45,-18,21
AGF Aarhus,6955,11,4,6,12,17,38,-21,18
Brondby,6956,1,21,6,3,75,36,39,69
FC Midtjylla,6956,2,19,7,4,71,42,29,64
FC Nords,6956,3,15,7,8,78,56,22,52
Copenhagen,6956,4,13,5,12,55,46,9,44
AC Horsens,6956,5,6,15,9,37,50,-13,33
Sonderjyske,6956,6,8,6,10,28,29,-1,30
AaB,6956,7,6,12,12,36,48,-12,30
Randers FC,6956,8,5,7,12,25,41,-16,22
Lyngby,6956,9,3,10,11,28,46,-18,19
Silkeborg IF,6956,10,5,4,13,26,45,-19,19
AGF Aarhus,6956,11,4,7,11,17,37,-20,19
Brondby,6957,1,19,6,5,72,37,35,63
FC Midtjylla,6957,2,17,9,4,63,39,24,60
FC Nords,6957,3,15,7,8,78,53,25,52
Copenhagen,6957,4,15,5,10,60,43,17,50
AaB,6957,5,8,12,10,37,43,-6,36
AC Horsens,6957,6,6,13,11,36,57,-21,31
Sonderjyske,6957,7,8,6,10,28,29,-1,30
Lyngby,6957,8,4,9,11,28,44,-16,21
Silkeborg IF,6957,9,6,3,13,27,45,-18,21
Randers FC,6957,10,5,6,13,23,41,-18,21
AGF Aarhus,6957,11,4,6,12,17,38,-21,18
Brondby,6958,1,21,6,3,71,31,40,69
FC Midtjylla,6958,2,19,5,6,63,42,21,62
Copenhagen,6958,3,15,5,10,60,44,16,50
FC Nords,6958,4,14,7,9,72,54,18,49
AaB,6958,5,8,11,11,40,42,-2,35
Sonderjyske,6958,6,8,6,10,28,29,-1,30
AC Horsens,6958,7,5,14,11,34,53,-19,29
Randers FC,6958,8,5,7,12,23,39,-16,22
Lyngby,6958,9,3,10,11,26,44,-18,19
Silkeborg IF,6958,10,5,4,13,26,45,-19,19
AGF Aarhus,6958,11,4,7,11,17,37,-20,19
Brondby,6959,1,20,7,3,68,32,36,67
FC Midtjylla,6959,2,18,5,7,65,43,22,59
Copenhagen,6959,3,16,4,10,57,41,16,52
FC Nords,6959,4,13,9,8,73,52,21,48
AaB,6959,5,7,13,10,37,42,-5,34
AC Horsens,6959,6,5,16,9,36,52,-16,31
Sonderjyske,6959,7,8,6,10,28,29,-1,30
Lyngby,6959,8,4,9,11,29,45,-16,21
Randers FC,6959,9,5,6,13,24,42,-18,21
Silkeborg IF,6959,10,5,4,13,26,45,-19,19
AGF Aarhus,6959,11,4,7,11,17,37,-20,19
Brondby,6960,1,22,6,2,77,31,46,72
FC Midtjylla,6960,2,21,4,5,70,39,31,67
FC Nords,6960,3,13,7,10,70,53,17,46
Copenhagen,6960,4,12,5,13,54,53,1,41
AaB,6960,5,7,13,10,35,41,-6,34
AC Horsens,6960,6,7,13,10,38,53,-15,34
Sonderjyske,6960,7,8,6,10,28,29,-1,30
Lyngby,6960,8,4,9,11,28,45,-17,21
Randers FC,6960,9,5,6,13,24,41,-17,21
Silkeborg IF,6960,10,5,4,13,26,45,-19,19
AGF Aarhus,6960,11,4,7,11,17,37,-20,19
Brondby,6961,1,19,7,4,66,32,34,64
FC Midtjylla,6961,2,20,4,6,64,39,25,64
FC Nords,6961,3,14,8,8,75,51,24,50
Copenhagen,6961,4,13,5,12,56,47,9,44
AaB,6961,5,8,13,9,37,40,-3,37
AC Horsens,6961,6,7,13,10,36,51,-15,34
Sonderjyske,6961,7,8,6,10,28,29,-1,30
Lyngby,6961,8,4,9,11,30,47,-17,21
Randers FC,6961,9,5,6,13,26,43,-17,21
AGF Aarhus,6961,10,5,6,11,19,37,-18,21
Silkeborg IF,6961,11,5,3,14,26,47,-21,18
Brondby,6962,1,22,6,2,72,31,41,72
FC Midtjylla,6962,2,19,5,6,64,40,24,62
FC Nords,6962,3,13,8,9,76,53,23,47
Copenhagen,6962,4,13,7,10,54,45,9,46
AaB,6962,5,7,13,10,37,41,-4,34
Sonderjyske,6962,6,8,6,10,28,29,-1,30
AC Horsens,6962,7,5,15,10,32,51,-19,30
Randers FC,6962,8,5,7,12,24,40,-16,22
Lyngby,6962,9,3,10,11,27,45,-18,19
Silkeborg IF,6962,10,5,4,13,27,46,-19,19
AGF Aarhus,6962,11,4,7,11,18,38,-20,19
Brondby,6963,1,21,6,3,75,33,42,69
FC Midtjylla,6963,2,20,5,5,70,41,29,65
FC Nords,6963,3,14,7,9,70,49,21,49
Copenhagen,6963,4,14,4,12,58,49,9,46
AC Horsens,6963,5,7,13,10,35,53,-18,34
AaB,6963,6,6,13,11,37,46,-9,31
Sonderjyske,6963,7,8,6,10,28,29,-1,30
Lyngby,6963,8,4,9,11,28,45,-17,21
Randers FC,6963,9,5,6,13,24,41,-17,21
AGF Aarhus,6963,10,5,6,11,18,36,-18,21
Silkeborg IF,6963,11,5,3,14,25,46,-21,18
Brondby,6964,1,22,5,3,73,32,41,71
FC Midtjylla,6964,2,22,4,4,72,35,37,70
Copenhagen,6964,3,14,4,12,56,46,10,46
FC Nords,6964,4,13,6,11,70,55,15,45
AaB,6964,5,7,12,11,39,49,-10,33
AC Horsens,6964,6,6,13,11,36,55,-19,31
Sonderjyske,6964,7,8,6,10,28,29,-1,30
Lyngby,6964,8,4,9,11,30,45,-15,21
Silkeborg IF,6964,9,6,3,13,27,44,-17,21
Randers FC,6964,10,5,6,13,24,43,-19,21
AGF Aarhus,6964,11,4,6,12,16,38,-22,18
Brondby,6965,1,20,7,3,69,31,38,67
FC Midtjylla,6965,2,19,5,6,63,40,23,62
FC Nords,6965,3,15,7,8,77,51,26,52
Copenhagen,6965,4,13,6,11,56,45,11,45
AaB,6965,5,8,11,11,36,44,-8,35
AC Horsens,6965,6,5,16,9,36,52,-16,31
Sonderjyske,6965,7,8,6,10,28,29,-1,30
Lyngby,6965,8,4,9,11,28,45,-17,21
Randers FC,6965,9,5,6,13,24,41,-17,21
Silkeborg IF,6965,10,6,3,13,27,45,-18,21
AGF Aarhus,6965,11,4,6,12,17,38,-21,18
Brondby,6966,1,21,5,4,72,34,38,68
FC Midtjylla,6966,2,19,6,5,67,40,27,63
Copenhagen,6966,3,15,6,9,59,42,17,51
FC Nords,6966,4,13,9,8,76,51,25,48
AaB,6966,5,7,13,10,40,49,-9,34
Sonderjyske,6966,6,8,6,10,28,29,-1,30
AC Horsens,6966,7,5,13,12,32,56,-24,28
Lyngby,6966,8,4,9,11,29,46,-17,21
Randers FC,6966,9,5,6,13,25,42,-17,21
Silkeborg IF,6966,10,5,4,13,27,46,-19,19
AGF Aarhus,6966,11,4,7,11,18,38,-20,19
Brondby,6967,1,22,5,3,79,38,41,71
FC Midtjylla,6967,2,22,4,4,72,37,35,70
Copenhagen,6967,3,13,6,11,56,46,10,45
FC Nords,6967,4,12,8,10,70,56,14,44
AaB,6967,5,7,11,12,41,52,-11,32
AC Horsens,6967,6,6,14,10,36,51,-15,32
Sonderjyske,6967,7,8,6,10,28,29,-1,30
Lyngby,6967,8,4,9,11,28,45,-17,21
Randers FC,6967,9,5,6,13,24,41,-17,21
Silkeborg IF,6967,10,6,3,13,26,44,-18,21
AGF Aarhus,6967,11,4,6,12,16,37,-21,18
Brondby,6968,1,20,8,2,73,32,41,68
FC Midtjylla,6968,2,18,6,6,60,37,23,60
FC Nords,6968,3,13,8,9,70,54,16,47
Copenhagen,6968,4,13,7,10,56,43,13,46
AaB,6968,5,7,14,9,39,43,-4,35
AC Horsens,6968,6,6,15,9,32,47,-15,33
Sonderjyske,6968,7,8,6,10,28,29,-1,30
Randers FC,6968,8,5,7,12,23,39,-16,22
Silkeborg IF,6968,9,6,3,13,26,44,-18,21
Lyngby,6968,10,3,10,11,26,44,-18,19
AGF Aarhus,6968,11,4,6,12,16,37,-21,18
FC Midtjylla,6969,1,20,5,5,70,36,34,65
Brondby,6969,2,19,7,4,69,35,34,64
FC Nords,6969,3,16,6,8,75,52,23,54
Copenhagen,6969,4,15,5,10,59,43,16,50
AaB,6969,5,7,11,12,38,46,-8,32
Sonderjyske,6969,6,8,6,10,28,29,-1,30
AC Horsens,6969,7,6,12,12,35,60,-25,30
Lyngby,6969,8,4,9,11,29,45,-16,21
Randers FC,6969,9,5,6,13,24,42,-18,21
Silkeborg IF,6969,10,5,4,13,27,46,-19,19
AGF Aarhus,6969,11,4,7,11,18,38,-20,19
Brondby,6970,1,22,6,2,69,27,42,72
FC Midtjylla,6970,2,20,5,5,65,37,28,65
FC Nords,6970,3,15,6,9,75,48,27,51
Copenhagen,6970,4,14,4,12,56,46,10,46
AaB,6970,5,8,11,11,35,43,-8,35
Sonderjyske,6970,6,8,6,10,28,29,-1,30
AC Horsens,6970,7,5,12,13,29,54,-25,27
Lyngby,6970,8,4,9,11,28,44,-16,21
Silkeborg IF,6970,9,6,3,13,26,44,-18,21
Randers FC,6970,10,5,6,13,23,41,-18,21
AGF Aarhus,6970,11,4,6,12,16,37,-21,18
Brondby,6971,1,21,7,2,68,30,38,70
FC Midtjylla,6971,2,20,4,6,66,38,28,64
FC Nords,6971,3,14,7,9,73,52,21,49
Copenhagen,6971,4,14,4,12,59,48,11,46
AC Horsens,6971,5,7,13,10,39,53,-14,34
AaB,6971,6,7,11,12,34,44,-10,32
Sonderjyske,6971,7,8,6,10,28,29,-1,30
Randers FC,6971,8,6,6,12,24,39,-15,24
Silkeborg IF,6971,9,6,3,13,27,44,-17,21
Lyngby,6971,10,3,9,12,26,45,-19,18
AGF Aarhus,6971,11,4,6,12,16,38,-22,18
FC Midtjylla,6972,1,20,6,4,69,39,30,66
Brondby,6972,2,19,5,6,72,39,33,62
FC Nords,6972,3,14,8,8,75,51,24,50
Copenhagen,6972,4,15,5,10,64,47,17,50
AC Horsens,6972,5,8,13,9,39,49,-10,37
Sonderjyske,6972,6,8,6,10,28,29,-1,30
AaB,6972,7,6,11,13,33,53,-20,29
Lyngby,6972,8,4,9,11,28,44,-16,21
Silkeborg IF,6972,9,6,3,13,27,44,-17,21
Randers FC,6972,10,5,6,13,23,41,-18,21
AGF Aarhus,6972,11,4,6,12,16,38,-22,18
Brondby,6973,1,21,6,3,72,32,40,69
FC Midtjylla,6973,2,19,5,6,65,38,27,62
Copenhagen,6973,3,15,5,10,62,47,15,50
FC Nords,6973,4,14,7,9,75,52,23,49
AaB,6973,5,7,13,10,38,45,-7,34
Sonderjyske,6973,6,8,6,10,28,29,-1,30
AC Horsens,6973,7,5,14,11,33,57,-24,29
Randers FC,6973,8,6,6,12,24,39,-15,24
Silkeborg IF,6973,9,5,4,13,26,45,-19,19
AGF Aarhus,6973,10,4,7,11,17,37,-20,19
Lyngby,6973,11,3,9,12,26,45,-19,18
Brondby,6974,1,21,7,2,70,30,40,70
FC Midtjylla,6974,2,19,7,4,62,35,27,64
FC Nords,6974,3,14,7,9,78,54,24,49
Copenhagen,6974,4,13,4,13,58,49,9,43
AC Horsens,6974,5,6,15,9,35,53,-18,33
AaB,6974,6,6,14,10,41,49,-8,32
Sonderjyske,6974,7,8,6,10,28,29,-1,30
Lyngby,6974,8,4,9,11,28,44,-16,21
Silkeborg IF,6974,9,6,3,13,27,45,-18,21
Randers FC,6974,10,5,6,13,23,41,-18,21
AGF Aarhus,6974,11,4,6,12,17,38,-21,18
Brondby,6975,1,19,7,4,70,37,33,64
FC Midtjylla,6975,2,19,6,5,67,41,26,63
FC Nords,6975,3,16,7,7,84,53,31,55
Copenhagen,6975,4,12,9,9,58,45,13,45
AC Horsens,6975,5,7,13,10,35,50,-15,34
Sonderjyske,6975,6,8,6,10,28,29,-1,30
AaB,6975,7,6,12,12,37,51,-14,30
Randers FC,6975,8,5,7,12,24,40,-16,22
Lyngby,6975,9,3,10,11,27,45,-18,19
Silkeborg IF,6975,10,5,4,13,28,47,-19,19
AGF Aarhus,6975,11,4,7,11,19,39,-20,19
FC Midtjylla,6976,1,21,5,4,70,35,35,68
Brondby,6976,2,20,7,3,68,34,34,67
FC Nords,6976,3,14,7,9,68,48,20,49
Copenhagen,6976,4,13,5,12,55,44,11,44
AaB,6976,5,8,13,9,37,39,-2,37
Sonderjyske,6976,6,8,6,10,28,29,-1,30
AC Horsens,6976,7,5,13,12,32,56,-24,28
Lyngby,6976,8,4,9,11,29,45,-16,21
Randers FC,6976,9,5,6,13,24,42,-18,21
Silkeborg IF,6976,10,5,4,13,26,45,-19,19
AGF Aarhus,6976,11,4,7,11,17,37,-20,19
Brondby,6977,1,19,8,3,65,30,35,65
FC Midtjylla,6977,2,19,7,4,67,38,29,64
FC Nords,6977,3,13,9,8,74,50,24,48
Copenhagen,6977,4,13,5,12,56,48,8,44
AaB,6977,5,8,12,10,35,42,-7,36
AC Horsens,6977,6,6,15,9,32,47,-15,33
Sonderjyske,6977,7,8,6,10,28,29,-1,30
Randers FC,6977,8,6,6,12,24,39,-15,24
Silkeborg IF,6977,9,6,3,13,29,45,-16,21
Lyngby,6977,10,3,9,12,26,45,-19,18
AGF Aarhus,6977,11,4,6,12,17,40,-23,18
Brondby,6978,1,22,6,2,72,29,43,72
FC Midtjylla,6978,2,19,4,7,63,41,22,61
FC Nords,6978,3,14,7,9,81,55,26,49
Copenhagen,6978,4,13,6,11,55,43,12,45
AC Horsens,6978,5,7,15,8,36,49,-13,36
Sonderjyske,6978,6,8,6,10,28,29,-1,30
AaB,6978,7,6,12,12,33,49,-16,30
Lyngby,6978,8,4,9,11,29,45,-16,21
Randers FC,6978,9,5,6,13,24,42,-18,21
Silkeborg IF,6978,10,5,4,13,28,47,-19,19
AGF Aarhus,6978,11,4,7,11,19,39,-20,19
Brondby,6979,1,22,6,2,71,28,43,72
FC Midtjylla,6979,2,20,4,6,66,41,25,64
FC Nords,6979,3,14,7,9,72,51,21,49
Copenhagen,6979,4,12,6,12,57,48,9,42
AaB,6979,5,9,11,10,39,44,-5,38
Sonderjyske,6979,6,8,6,10,28,29,-1,30
AC Horsens,6979,7,6,12,12,33,52,-19,30
Randers FC,6979,8,6,6,12,25,39,-14,24
Silkeborg IF,6979,9,6,3,13,30,45,-15,21
Lyngby,6979,10,3,9,12,26,46,-20,18
AGF Aarhus,6979,11,4,6,12,17,41,-24,18
Brondby,6980,1,21,6,3,70,29,41,69
FC Midtjylla,6980,2,21,5,4,67,38,29,68
Copenhagen,6980,3,15,4,11,59,46,13,49
FC Nords,6980,4,14,6,10,72,54,18,48
AaB,6980,5,7,11,12,36,44,-8,32
Sonderjyske,6980,6,8,6,10,28,29,-1,30
AC Horsens,6980,7,6,12,12,32,51,-19,30
Lyngby,6980,8,4,9,11,29,44,-15,21
Silkeborg IF,6980,9,6,3,13,26,44,-18,21
Randers FC,6980,10,5,6,13,23,42,-19,21
AGF Aarhus,6980,11,4,6,12,16,37,-21,18
FC Midtjylla,6981,1,21,5,4,74,40,34,68
Brondby,6981,2,20,5,5,73,35,38,65
FC Nords,6981,3,15,7,8,73,50,23,52
Copenhagen,6981,4,13,5,12,58,48,10,44
AaB,6981,5,8,12,10,41,48,-7,36
Sonderjyske,6981,6,8,6,10,28,29,-1,30
AC Horsens,6981,7,6,12,12,37,61,-24,30
Lyngby,6981,8,4,9,11,30,47,-17,21
Randers FC,6981,9,5,6,13,26,43,-17,21
Silkeborg IF,6981,10,6,3,13,26,44,-18,21
AGF Aarhus,6981,11,4,6,12,16,37,-21,18
Brondby,6982,1,20,5,5,68,36,32,65
FC Midtjylla,6982,2,19,5,6,63,38,25,62
Copenhagen,6982,3,16,4,10,64,44,20,52
AaB,6982,4,11,11,8,42,40,2,44
FC Nords,6982,5,12,6,12,71,59,12,42
AC Horsens,6982,6,6,13,11,33,50,-17,31
Sonderjyske,6982,7,8,6,10,28,29,-1,30
Randers FC,6982,8,6,6,12,24,39,-15,24
Silkeborg IF,6982,9,6,3,13,28,44,-16,21
Lyngby,6982,10,3,9,12,26,45,-19,18
AGF Aarhus,6982,11,4,6,12,16,39,-23,18
Brondby,6983,1,20,6,4,73,32,41,66
FC Midtjylla,6983,2,19,5,6,64,39,25,62
FC Nords,6983,3,16,6,8,81,49,32,54
Copenhagen,6983,4,15,5,10,57,44,13,50
AaB,6983,5,6,13,11,35,47,-12,31
Sonderjyske,6983,6,8,6,10,28,29,-1,30
AC Horsens,6983,7,5,15,10,34,59,-25,30
Randers FC,6983,8,5,7,12,24,40,-16,22
Lyngby,6983,9,3,10,11,27,45,-18,19
Silkeborg IF,6983,10,5,4,13,26,45,-19,19
AGF Aarhus,6983,11,4,7,11,17,37,-20,19
Brondby,6984,1,20,6,4,69,36,33,66
FC Midtjylla,6984,2,19,5,6,65,40,25,62
FC Nords,6984,3,15,6,9,76,51,25,51
Copenhagen,6984,4,13,6,11,55,46,9,45
AC Horsens,6984,5,8,12,10,40,52,-12,36
AaB,6984,6,8,11,11,37,43,-6,35
Sonderjyske,6984,7,8,6,10,28,29,-1,30
Randers FC,6984,8,6,6,12,26,40,-14,24
AGF Aarhus,6984,9,5,6,11,17,36,-19,21
Lyngby,6984,10,3,9,12,27,47,-20,18
Silkeborg IF,6984,11,5,3,14,25,45,-20,18
FC Midtjylla,6985,1,21,4,5,68,36,32,67
Brondby,6985,2,20,6,4,71,34,37,66
Copenhagen,6985,3,15,5,10,58,42,16,50
FC Nords,6985,4,13,6,11,70,57,13,45
AaB,6985,5,8,12,10,35,41,-6,36
AC Horsens,6985,6,6,13,11,36,54,-18,31
Sonderjyske,6985,7,8,6,10,28,29,-1,30
Randers FC,6985,8,5,7,12,24,40,-16,22
Lyngby,6985,9,3,10,11,27,45,-18,19
Silkeborg IF,6985,10,5,4,13,27,46,-19,19
AGF Aarhus,6985,11,4,7,11,18,38,-20,19
FC Midtjylla,6986,1,22,4,4,70,35,35,70
Brondby,6986,2,19,7,4,66,34,32,64
FC Nords,6986,3,15,6,9,73,49,24,51
Copenhagen,6986,4,13,5,12,53,44,9,44
AaB,6986,5,7,13,10,39,46,-7,34
AC Horsens,6986,6,6,13,11,34,53,-19,31
Sonderjyske,6986,7,8,6,10,28,29,-1,30
Silkeborg IF,6986,8,6,3,13,28,45,-17,21
Lyngby,6986,9,4,9,11,27,44,-17,21
Randers FC,6986,10,5,6,13,23,40,-17,21
AGF Aarhus,6986,11,4,6,12,17,39,-22,18
FC Midtjylla,6987,1,21,4,5,63,35,28,67
Brondby,6987,2,20,6,4,70,34,36,66
FC Nords,6987,3,14,6,10,68,49,19,48
Copenhagen,6987,4,14,6,10,58,44,14,48
AC Horsens,6987,5,8,12,10,35,48,-13,36
Sonderjyske,6987,6,8,6,10,28,29,-1,30
AaB,6987,7,6,12,12,36,46,-10,30
Lyngby,6987,8,4,9,11,29,46,-17,21
Randers FC,6987,9,5,6,13,25,42,-17,21
AGF Aarhus,6987,10,5,6,11,18,36,-18,21
Silkeborg IF,6987,11,5,3,14,25,46,-21,18
FC Midtjylla,6988,1,21,4,5,70,36,34,67
Brondby,6988,2,19,7,4,66,35,31,64
FC Nords,6988,3,13,8,9,71,53,18,47
Copenhagen,6988,4,13,7,10,57,43,14,46
AaB,6988,5,7,14,9,38,44,-6,35
AC Horsens,6988,6,5,16,9,33,50,-17,31
Sonderjyske,6988,7,8,6,10,28,29,-1,30
Randers FC,6988,8,5,7,12,25,41,-16,22
Silkeborg IF,6988,9,6,3,13,28,46,-18,21
Lyngby,6988,10,3,10,11,28,46,-18,19
AGF Aarhus,6988,11,4,6,12,18,39,-21,18
Brondby,6989,1,20,6,4,67,32,35,66
FC Midtjylla,6989,2,19,6,5,68,41,27,63
FC Nords,6989,3,15,6,9,74,51,23,51
Copenhagen,6989,4,12,7,11,58,49,9,43
AC Horsens,6989,5,8,13,9,37,49,-12,37
AaB,6989,6,7,12,11,38,46,-8,33
Sonderjyske,6989,7,8,6,10,28,29,-1,30
Randers FC,6989,8,6,6,12,24,39,-15,24
Silkeborg IF,6989,9,6,3,13,26,44,-18,21
Lyngby,6989,10,3,9,12,26,45,-19,18
AGF Aarhus,6989,11,4,6,12,16,37,-21,18
Brondby,6990,1,22,6,2,75,31,44,72
FC Midtjylla,6990,2,19,6,5,63,39,24,63
FC Nords,6990,3,14,7,9,75,50,25,49
Copenhagen,6990,4,14,5,11,59,46,13,47
AC Horsens,6990,5,6,15,9,39,57,-18,33
Sonderjyske,6990,6,8,6,10,28,29,-1,30
AaB,6990,7,6,11,13,33,47,-14,29
Randers FC,6990,8,6,6,12,26,40,-14,24
Silkeborg IF,6990,9,5,4,13,25,44,-19,19
AGF Aarhus,6990,10,4,7,11,16,36,-20,19
Lyngby,6990,11,3,9,12,27,47,-20,18
Brondby,6991,1,20,6,4,70,33,37,66
FC Midtjylla,6991,2,19,5,6,63,41,22,62
FC Nords,6991,3,15,7,8,72,49,23,52
Copenhagen,6991,4,14,5,11,60,45,15,47
AaB,6991,5,8,11,11,35,42,-7,35
AC Horsens,6991,6,6,14,10,33,49,-16,32
Sonderjyske,6991,7,8,6,10,28,29,-1,30
Randers FC,6991,8,6,6,12,24,39,-15,24
Silkeborg IF,6991,9,6,3,13,27,45,-18,21
Lyngby,6991,10,3,9,12,26,45,-19,18
AGF Aarhus,6991,11,4,6,12,17,38,-21,18
Brondby,6992,1,20,7,3,73,32,41,67
FC Midtjylla,6992,2,19,6,5,70,41,29,63
FC Nords,6992,3,14,8,8,75,48,27,50
Copenhagen,6992,4,13,5,12,58,49,9,44
AC Horsens,6992,5,7,14,9,38,54,-16,35
AaB,6992,6,7,12,11,34,50,-16,33
Sonderjyske,6992,7,8,6,10,28,29,-1,30
Randers FC,6992,8,5,7,12,25,41,-16,22
Lyngby,6992,9,3,10,11,28,46,-18,19
Silkeborg IF,6992,10,5,4,13,25,44,-19,19
AGF Aarhus,6992,11,4,7,11,16,36,-20,19
Brondby,6993,1,21,6,3,68,29,39,69
FC Midtjylla,6993,2,18,5,7,60,40,20,59
FC Nords,6993,3,16,7,7,79,48,31,55
Copenhagen,6993,4,14,5,11,57,46,11,47
AaB,6993,5,6,14,10,35,44,-9,32
AC Horsens,6993,6,6,13,11,35,53,-18,31
Sonderjyske,6993,7,8,6,10,28,29,-1,30
Randers FC,6993,8,6,6,12,26,41,-15,24
Silkeborg IF,6993,9,6,3,13,27,45,-18,21
Lyngby,6993,10,3,9,12,28,47,-19,18
AGF Aarhus,6993,11,4,6,12,17,38,-21,18
FC Midtjylla,6994,1,21,5,4,70,37,33,68
Brondby,6994,2,19,8,3,71,32,39,65
FC Nords,6994,3,13,8,9,72,54,18,47
Copenhagen,6994,4,13,5,12,57,50,7,44
AaB,6994,5,7,14,9,34,40,-6,35
AC Horsens,6994,6,6,14,10,33,50,-17,32
Sonderjyske,6994,7,8,6,10,28,29,-1,30
Lyngby,6994,8,4,9,11,27,44,-17,21
Randers FC,6994,9,5,6,13,23,40,-17,21
AGF Aarhus,6994,10,5,6,11,19,37,-18,21
Silkeborg IF,6994,11,5,3,14,26,47,-21,18
Brondby,6995,1,20,8,2,74,33,41,68
FC Midtjylla,6995,2,18,5,7,64,43,21,59
Copenhagen,6995,3,15,6,9,61,44,17,51
FC Nords,6995,4,13,8,9,73,52,21,47
AaB,6995,5,7,13,10,37,42,-5,34
AC Horsens,6995,6,6,14,10,34,55,-21,32
Sonderjyske,6995,7,8,6,10,28,29,-1,30
Randers FC,6995,8,6,6,12,25,40,-15,24
Silkeborg IF,6995,9,6,3,13,27,44,-17,21
Lyngby,6995,10,3,9,12,27,46,-19,18
AGF Aarhus,6995,11,4,6,12,16,38,-22,18
Brondby,6996,1,21,5,4,70,32,38,68
FC Midtjylla,6996,2,19,4,7,64,42,22,61
FC Nords,6996,3,14,7,9,71,49,22,49
Copenhagen,6996,4,15,4,11,66,49,17,49
AaB,6996,5,8,12,10,36,41,-5,36
AC Horsens,6996,6,6,14,10,35,55,-20,32
Sonderjyske,6996,7,8,6,10,28,29,-1,30
Lyngby,6996,8,4,9,11,28,44,-16,21
Silkeborg IF,6996,9,6,3,13,27,44,-17,21
Randers FC,6996,10,5,6,13,23,41,-18,21
AGF Aarhus,6996,11,4,6,12,16,38,-22,18
Brondby,6997,1,21,5,4,68,30,38,68
FC Midtjylla,6997,2,18,6,6,60,39,21,60
FC Nords,6997,3,13,8,9,68,48,20,47
Copenhagen,6997,4,13,5,12,55,43,12,44
AC Horsens,6997,5,8,14,8,35,47,-12,38
AaB,6997,6,8,12,10,34,39,-5,36
Sonderjyske,6997,7,8,6,10,28,29,-1,30
Randers FC,6997,8,5,7,12,23,39,-16,22
Silkeborg IF,6997,9,6,3,13,27,44,-17,21
Lyngby,6997,10,3,10,11,26,44,-18,19
AGF Aarhus,6997,11,4,6,12,16,38,-22,18
Brondby,6998,1,21,6,3,70,33,37,69
FC Midtjylla,6998,2,18,6,6,61,38,23,60
FC Nords,6998,3,13,10,7,70,48,22,49
Copenhagen,6998,4,12,4,14,54,48,6,40
AaB,6998,5,9,12,9,40,42,-2,39
AC Horsens,6998,6,7,14,9,36,48,-12,35
Sonderjyske,6998,7,8,6,10,28,29,-1,30
Randers FC,6998,8,6,6,12,27,40,-13,24
Silkeborg IF,6998,9,6,3,13,27,45,-18,21
Lyngby,6998,10,3,9,12,27,48,-21,18
AGF Aarhus,6998,11,4,6,12,17,38,-21,18
Brondby,6999,1,22,5,3,73,34,39,71
FC Midtjylla,6999,2,19,4,7,65,43,22,61
FC Nords,6999,3,15,6,9,83,53,30,51
Copenhagen,6999,4,15,4,11,59,49,10,49
AaB,6999,5,8,11,11,37,43,-6,35
Sonderjyske,6999,6,8,6,10,28,29,-1,30
AC Horsens,6999,7,6,12,12,33,54,-21,30
Randers FC,6999,8,5,7,12,25,41,-16,22
Silkeborg IF,6999,9,6,3,13,30,44,-14,21
Lyngby,6999,10,3,10,11,28,46,-18,19
AGF Aarhus,6999,11,4,6,12,16,41,-25,18
Brondby,7000,1,20,7,3,72,37,35,67
FC Midtjylla,7000,2,20,5,5,70,40,30,65
FC Nords,7000,3,15,7,8,74,52,22,52
Copenhagen,7000,4,15,4,11,62,47,15,49
AC Horsens,7000,5,6,13,11,32,51,-19,31
Sonderjyske,7000,6,8,6,10,28,29,-1,30
AaB,7000,7,6,12,12,36,45,-9,30
Randers FC,7000,8,5,7,12,24,40,-16,22
Lyngby,7000,9,3,10,11,27,45,-18,19
Silkeborg IF,7000,10,5,4,13,26,45,-19,19
AGF Aarhus,7000,11,4,7,11,17,37,-20,19
Brondby,7001,1,23,5,2,69,26,43,74
FC Midtjylla,7001,2,20,5,5,68,36,32,65
FC Nords,7001,3,14,8,8,73,49,24,50
Copenhagen,7001,4,12,7,11,52,42,10,43
AC Horsens,7001,5,6,13,11,33,55,-22,31
Sonderjyske,7001,6,8,6,10,28,29,-1,30
AaB,7001,7,6,12,12,34,47,-13,30
Lyngby,7001,8,4,9,11,27,44,-17,21
Randers FC,7001,9,5,6,13,23,40,-17,21
Silkeborg IF,7001,10,5,4,13,26,45,-19,19
AGF Aarhus,7001,11,4,7,11,17,37,-20,19
Brondby,7002,1,22,6,2,78,28,50,72
FC Midtjylla,7002,2,19,4,7,65,39,26,61
FC Nords,7002,3,14,7,9,71,54,17,49
Copenhagen,7002,4,13,6,11,57,45,12,45
AC Horsens,7002,5,7,13,10,38,59,-21,34
AaB,7002,6,7,12,11,36,46,-10,33
Sonderjyske,7002,7,8,6,10,28,29,-1,30
Randers FC,7002,8,5,7,12,23,39,-16,22
Silkeborg IF,7002,9,6,3,13,26,44,-18,21
Lyngby,7002,10,3,10,11,26,44,-18,19
AGF Aarhus,7002,11,4,6,12,16,37,-21,18
Brondby,7003,1,20,5,5,67,36,31,65
FC Midtjylla,7003,2,20,4,6,66,37,29,64
Copenhagen,7003,3,15,6,9,60,41,19,51
FC Nords,7003,4,13,8,9,69,50,19,47
AaB,7003,5,7,14,9,34,39,-5,35
AC Horsens,7003,6,6,13,11,33,52,-19,31
Sonderjyske,7003,7,8,6,10,28,29,-1,30
Lyngby,7003,8,4,9,11,28,44,-16,21
Randers FC,7003,9,5,6,13,23,41,-18,21
Silkeborg IF,7003,10,5,4,13,25,44,-19,19
AGF Aarhus,7003,11,4,7,11,16,36,-20,19
Brondby,7004,1,20,6,4,72,35,37,66
FC Midtjylla,7004,2,19,6,5,63,39,24,63
FC Nords,7004,3,14,7,9,73,54,19,49
Copenhagen,7004,4,13,5,12,57,45,12,44
AC Horsens,7004,5,8,13,9,36,49,-13,37
AaB,7004,6,7,13,10,40,45,-5,34
Sonderjyske,7004,7,8,6,10,28,29,-1,30
Lyngby,7004,8,4,9,11,30,47,-17,21
Silkeborg IF,7004,9,6,3,13,27,44,-17,21
Randers FC,7004,10,5,6,13,26,43,-17,21
AGF Aarhus,7004,11,4,6,12,16,38,-22,18
Brondby,7005,1,22,5,3,71,29,42,71
FC Midtjylla,7005,2,19,6,5,69,40,29,63
FC Nords,7005,3,13,8,9,73,54,19,47
Copenhagen,7005,4,13,5,12,57,48,9,44
AaB,7005,5,9,13,8,38,38,0,40
Sonderjyske,7005,6,8,6,10,28,29,-1,30
AC Horsens,7005,7,5,13,12,32,57,-25,28
Randers FC,7005,8,6,6,12,25,39,-14,24
AGF Aarhus,7005,9,5,6,11,19,37,-18,21
Lyngby,7005,10,3,9,12,26,46,-20,18
Silkeborg IF,7005,11,5,3,14,26,47,-21,18
Brondby,7006,1,19,7,4,68,35,33,64
FC Midtjylla,7006,2,19,6,5,67,40,27,63
Copenhagen,7006,3,14,7,9,57,41,16,49
FC Nords,7006,4,12,8,10,70,52,18,44
AaB,7006,5,7,14,9,35,39,-4,35
AC Horsens,7006,6,7,14,9,34,50,-16,35
Sonderjyske,7006,7,8,6,10,28,29,-1,30
Lyngby,7006,8,4,9,11,27,44,-17,21
Randers FC,7006,9,5,6,13,23,40,-17,21
Silkeborg IF,7006,10,6,3,13,27,45,-18,21
AGF Aarhus,7006,11,4,6,12,17,38,-21,18
Brondby,7007,1,22,5,3,78,29,49,71
FC Midtjylla,7007,2,22,4,4,68,38,30,70
Copenhagen,7007,3,14,5,11,60,48,12,47
FC Nords,7007,4,13,6,11,73,55,18,45
AaB,7007,5,7,12,11,35,46,-11,33
Sonderjyske,7007,6,8,6,10,28,29,-1,30
AC Horsens,7007,7,5,14,11,32,56,-24,29
Randers FC,7007,8,6,6,12,26,41,-15,24
Silkeborg IF,7007,9,5,4,13,26,45,-19,19
AGF Aarhus,7007,10,4,7,11,17,37,-20,19
Lyngby,7007,11,3,9,12,28,47,-19,18
Brondby,7008,1,19,7,4,66,32,34,64
FC Midtjylla,7008,2,19,6,5,67,41,26,63
FC Nords,7008,3,14,7,9,73,51,22,49
Copenhagen,7008,4,14,6,10,57,44,13,48
AaB,7008,5,8,13,9,39,43,-4,37
AC Horsens,7008,6,6,13,11,36,53,-17,31
Sonderjyske,7008,7,8,6,10,28,29,-1,30
Lyngby,7008,8,4,9,11,28,44,-16,21
Randers FC,7008,9,5,6,13,23,41,-18,21
Silkeborg IF,7008,10,5,4,13,26,45,-19,19
AGF Aarhus,7008,11,4,7,11,17,37,-20,19
Brondby,7009,1,21,6,3,74,33,41,69
FC Midtjylla,7009,2,21,4,5,68,39,29,67
FC Nords,7009,3,13,8,9,79,58,21,47
Copenhagen,7009,4,12,6,12,54,50,4,42
AaB,7009,5,7,14,9,41,47,-6,35
AC Horsens,7009,6,7,12,11,39,54,-15,33
Sonderjyske,7009,7,8,6,10,28,29,-1,30
Randers FC,7009,8,5,7,12,24,40,-16,22
AGF Aarhus,7009,9,5,6,11,19,37,-18,21
Lyngby,7009,10,3,10,11,27,45,-18,19
Silkeborg IF,7009,11,5,3,14,26,47,-21,18
Brondby,7010,1,22,6,2,74,27,47,72
FC Midtjylla,7010,2,20,5,5,62,38,24,65
FC Nords,7010,3,15,6,9,72,52,20,51
Copenhagen,7010,4,12,6,12,56,48,8,42
AC Horsens,7010,5,6,14,10,34,49,-15,32
AaB,7010,6,6,13,11,34,44,-10,31
Sonderjyske,7010,7,8,6,10,28,29,-1,30
Lyngby,7010,8,4,9,11,28,45,-17,21
Randers FC,7010,9,5,6,13,24,41,-17,21
Silkeborg IF,7010,10,6,3,13,27,45,-18,21
AGF Aarhus,7010,11,4,6,12,17,38,-21,18
Brondby,7011,1,19,6,5,67,34,33,63
FC Midtjylla,7011,2,18,6,6,64,40,24,60
FC Nords,7011,3,14,7,9,69,50,19,49
Copenhagen,7011,4,13,7,10,55,42,13,46
AC Horsens,7011,5,8,14,8,38,49,-11,38
AaB,7011,6,7,14,9,36,40,-4,35
Sonderjyske,7011,7,8,6,10,28,29,-1,30
Lyngby,7011,8,4,9,11,29,44,-15,21
Silkeborg IF,7011,9,6,3,13,27,45,-18,21
Randers FC,7011,10,5,6,13,23,42,-19,21
AGF Aarhus,7011,11,4,6,12,17,38,-21,18
Brondby,7012,1,23,5,2,77,29,48,74
FC Midtjylla,7012,2,18,7,5,62,36,26,61
FC Nords,7012,3,13,7,10,73,58,15,46
Copenhagen,7012,4,13,6,11,59,46,13,45
AaB,7012,5,7,13,10,35,47,-12,34
AC Horsens,7012,6,5,16,9,34,50,-16,31
Sonderjyske,7012,7,8,6,10,28,29,-1,30
Randers FC,7012,8,6,6,12,26,40,-14,24
Silkeborg IF,7012,9,6,3,13,28,45,-17,21
Lyngby,7012,10,3,9,12,27,47,-20,18
AGF Aarhus,7012,11,4,6,12,17,39,-22,18
Brondby,7013,1,20,7,3,70,31,39,67
FC Midtjylla,7013,2,20,4,6,66,38,28,64
FC Nords,7013,3,15,7,8,77,47,30,52
Copenhagen,7013,4,13,5,12,57,49,8,44
AaB,7013,5,7,14,9,39,43,-4,35
AC Horsens,7013,6,6,13,11,35,62,-27,31
Sonderjyske,7013,7,8,6,10,28,29,-1,30
Lyngby,7013,8,4,9,11,28,44,-16,21
Silkeborg IF,7013,9,6,3,13,26,44,-18,21
Randers FC,7013,10,5,6,13,23,41,-18,21
AGF Aarhus,7013,11,4,6,12,16,37,-21,18
FC Midtjylla,7014,1,19,6,5,64,39,25,63
Brondby,7014,2,19,5,6,68,38,30,62
FC Nords,7014,3,16,6,8,78,49,29,54
Copenhagen,7014,4,15,5,10,58,42,16,50
AaB,7014,5,8,12,10,40,42,-2,36
Sonderjyske,7014,6,8,6,10,28,29,-1,30
AC Horsens,7014,7,6,12,12,33,57,-24,30
Randers FC,7014,8,5,7,12,25,41,-16,22
AGF Aarhus,7014,9,5,6,11,18,36,-18,21
Lyngby,7014,10,3,10,11,28,46,-18,19
Silkeborg IF,7014,11,5,3,14,25,46,-21,18
Brondby,7015,1,21,5,4,71,33,38,68
FC Midtjylla,7015,2,21,4,5,70,42,28,67
FC Nords,7015,3,15,6,9,77,55,22,51
Copenhagen,7015,4,13,5,12,53,43,10,44
AaB,7015,5,8,11,11,38,43,-5,35
AC Horsens,7015,6,6,13,11,34,53,-19,31
Sonderjyske,7015,7,8,6,10,28,29,-1,30
Randers FC,7015,8,6,6,12,24,39,-15,24
AGF Aarhus,7015,9,5,6,11,18,37,-19,21
Lyngby,7015,10,3,9,12,26,45,-19,18
Silkeborg IF,7015,11,5,3,14,26,46,-20,18
Brondby,7016,1,20,5,5,72,42,30,65
FC Midtjylla,7016,2,19,5,6,66,39,27,62
FC Nords,7016,3,14,8,8,73,49,24,50
Copenhagen,7016,4,15,5,10,61,47,14,50
AaB,7016,5,8,13,9,40,43,-3,37
Sonderjyske,7016,6,8,6,10,28,29,-1,30
AC Horsens,7016,7,6,12,12,36,54,-18,30
Silkeborg IF,7016,8,6,3,13,29,44,-15,21
Lyngby,7016,9,4,9,11,27,44,-17,21
Randers FC,7016,10,5,6,13,23,40,-17,21
AGF Aarhus,7016,11,4,6,12,16,40,-24,18
Brondby,7017,1,22,5,3,68,30,38,71
FC Midtjylla,7017,2,19,6,5,63,40,23,63
FC Nords,7017,3,12,9,9,69,52,17,45
Copenhagen,7017,4,13,5,12,57,46,11,44
AaB,7017,5,8,12,10,43,43,0,36
AC Horsens,7017,6,6,15,9,37,52,-15,33
Sonderjyske,7017,7,8,6,10,28,29,-1,30
Silkeborg IF,7017,8,6,3,13,29,44,-15,21
Lyngby,7017,9,4,9,11,28,44,-16,21
Randers FC,7017,10,5,6,13,23,41,-18,21
AGF Aarhus,7017,11,4,6,12,16,40,-24,18
Brondby,7018,1,21,5,4,74,35,39,68
FC Midtjylla,7018,2,20,4,6,66,40,26,64
FC Nords,7018,3,15,6,9,79,54,25,51
Copenhagen,7018,4,15,4,11,59,50,9,49
AaB,7018,5,7,12,11,38,45,-7,33
AC Horsens,7018,6,6,13,11,37,55,-18,31
Sonderjyske,7018,7,8,6,10,28,29,-1,30
Lyngby,7018,8,4,9,11,28,45,-17,21
Randers FC,7018,9,5,6,13,24,41,-17,21
Silkeborg IF,7018,10,6,3,13,26,44,-18,21
AGF Aarhus,7018,11,4,6,12,16,37,-21,18
Brondby,7019,1,22,5,3,77,32,45,71
FC Midtjylla,7019,2,21,4,5,69,37,32,67
FC Nords,7019,3,13,8,9,70,54,16,47
Copenhagen,7019,4,13,4,13,55,48,7,43
AaB,7019,5,8,12,10,40,45,-5,36
AC Horsens,7019,6,6,13,11,33,54,-21,31
Sonderjyske,7019,7,8,6,10,28,29,-1,30
Randers FC,7019,8,6,6,12,26,41,-15,24
Silkeborg IF,7019,9,5,4,13,25,44,-19,19
AGF Aarhus,7019,10,4,7,11,16,36,-20,19
Lyngby,7019,11,3,9,12,28,47,-19,18
Brondby,7020,1,22,5,3,74,35,39,71
FC Midtjylla,7020,2,21,4,5,68,37,31,67
FC Nords,7020,3,14,7,9,72,50,22,49
Copenhagen,7020,4,14,5,11,62,50,12,47
AC Horsens,7020,5,7,12,11,39,56,-17,33
Sonderjyske,7020,6,8,6,10,28,29,-1,30
AaB,7020,7,6,11,13,34,47,-13,29
Lyngby,7020,8,4,9,11,29,46,-17,21
Randers FC,7020,9,5,6,13,25,42,-17,21
AGF Aarhus,7020,10,5,6,11,17,36,-19,21
Silkeborg IF,7020,11,5,3,14,25,45,-20,18
FC Midtjylla,7021,1,20,5,5,68,39,29,65
Brondby,7021,2,19,6,5,70,35,35,63
FC Nords,7021,3,13,9,8,73,53,20,48
Copenhagen,7021,4,13,6,11,59,46,13,45
AC Horsens,7021,5,9,12,9,37,49,-12,39
AaB,7021,6,6,14,10,35,46,-11,32
Sonderjyske,7021,7,8,6,10,28,29,-1,30
Lyngby,7021,8,4,9,11,31,44,-13,21
AGF Aarhus,7021,9,5,6,11,18,37,-19,21
Randers FC,7021,10,5,6,13,23,44,-21,21
Silkeborg IF,7021,11,5,3,14,26,46,-20,18
Brondby,7022,1,19,9,2,71,35,36,66
FC Midtjylla,7022,2,20,6,4,71,38,33,66
FC Nords,7022,3,14,7,9,72,54,18,49
Copenhagen,7022,4,13,7,10,58,45,13,46
AaB,7022,5,7,13,10,35,41,-6,34
Sonderjyske,7022,6,8,6,10,28,29,-1,30
AC Horsens,7022,7,5,14,11,36,56,-20,29
Randers FC,7022,8,5,7,12,24,40,-16,22
AGF Aarhus,7022,9,5,6,11,19,36,-17,21
Lyngby,7022,10,3,10,11,27,45,-18,19
Silkeborg IF,7022,11,5,3,14,25,47,-22,18
Brondby,7023,1,19,6,5,67,36,31,63
FC Midtjylla,7023,2,19,4,7,66,43,23,61
FC Nords,7023,3,14,7,9,75,52,23,49
Copenhagen,7023,4,15,4,11,64,48,16,49
AC Horsens,7023,5,9,12,9,41,54,-13,39
AaB,7023,6,8,11,11,36,42,-6,35
Sonderjyske,7023,7,8,6,10,28,29,-1,30
Randers FC,7023,8,5,7,12,24,40,-16,22
Silkeborg IF,7023,9,6,3,13,26,44,-18,21
Lyngby,7023,10,3,10,11,27,45,-18,19
AGF Aarhus,7023,11,4,6,12,16,37,-21,18
Brondby,7024,1,21,6,3,71,32,39,69
FC Midtjylla,7024,2,19,6,5,70,45,25,63
Copenhagen,7024,3,15,6,9,64,46,18,51
FC Nords,7024,4,13,6,11,74,56,18,45
AaB,7024,5,8,13,9,41,45,-4,37
Sonderjyske,7024,6,8,6,10,28,29,-1,30
AC Horsens,7024,7,5,13,12,35,57,-22,28
Randers FC,7024,8,5,7,12,24,40,-16,22
Silkeborg IF,7024,9,6,3,13,28,45,-17,21
Lyngby,7024,10,3,10,11,27,45,-18,19
AGF Aarhus,7024,11,4,6,12,17,39,-22,18
Brondby,7025,1,21,5,4,70,31,39,68
FC Midtjylla,7025,2,20,4,6,68,43,25,64
FC Nords,7025,3,16,6,8,79,50,29,54
Copenhagen,7025,4,14,4,12,57,46,11,46
AC Horsens,7025,5,8,12,10,36,51,-15,36
Sonderjyske,7025,6,8,6,10,28,29,-1,30
AaB,7025,7,6,11,13,34,49,-15,29
Lyngby,7025,8,4,9,11,29,46,-17,21
Randers FC,7025,9,5,6,13,25,42,-17,21
Silkeborg IF,7025,10,6,3,13,26,44,-18,21
AGF Aarhus,7025,11,4,6,12,16,37,-21,18
Brondby,7026,1,20,7,3,66,28,38,67
FC Midtjylla,7026,2,20,5,5,68,37,31,65
Copenhagen,7026,3,15,5,10,57,43,14,50
FC Nords,7026,4,14,7,9,71,49,22,49
AaB,7026,5,6,13,11,34,46,-12,31
AC Horsens,7026,6,6,13,11,36,55,-19,31
Sonderjyske,7026,7,8,6,10,28,29,-1,30
Randers FC,7026,8,6,6,12,25,39,-14,24
Silkeborg IF,7026,9,5,4,13,27,46,-19,19
AGF Aarhus,7026,10,4,7,11,18,38,-20,19
Lyngby,7026,11,3,9,12,26,46,-20,18
Brondby,7027,1,20,5,5,68,37,31,65
FC Midtjylla,7027,2,18,5,7,64,42,22,59
FC Nords,7027,3,14,7,9,76,56,20,49
Copenhagen,7027,4,14,5,11,62,45,17,47
AaB,7027,5,10,11,9,39,38,1,41
AC Horsens,7027,6,7,13,10,34,51,-17,34
Sonderjyske,7027,7,8,6,10,28,29,-1,30
Randers FC,7027,8,6,6,12,24,39,-15,24
Silkeborg IF,7027,9,6,3,13,26,44,-18,21
Lyngby,7027,10,3,9,12,26,45,-19,18
AGF Aarhus,7027,11,4,6,12,16,37,-21,18
FC Midtjylla,7028,1,21,5,4,68,36,32,68
Brondby,7028,2,19,5,6,69,39,30,62
FC Nords,7028,3,13,7,10,72,53,19,46
Copenhagen,7028,4,14,4,12,58,44,14,46
AaB,7028,5,9,12,9,35,38,-3,39
AC Horsens,7028,6,7,13,10,35,53,-18,34
Sonderjyske,7028,7,8,6,10,28,29,-1,30
Randers FC,7028,8,5,7,12,23,39,-16,22
AGF Aarhus,7028,9,5,6,11,18,36,-18,21
Lyngby,7028,10,3,10,11,26,44,-18,19
Silkeborg IF,7028,11,5,3,14,25,46,-21,18
Brondby,7029,1,21,5,4,76,37,39,68
FC Midtjylla,7029,2,21,4,5,69,39,30,67
FC Nords,7029,3,15,6,9,75,53,22,51
Copenhagen,7029,4,12,4,14,53,56,-3,40
AC Horsens,7029,5,8,12,10,42,51,-9,36
AaB,7029,6,8,11,11,40,45,-5,35
Sonderjyske,7029,7,8,6,10,28,29,-1,30
Lyngby,7029,8,4,9,11,28,45,-17,21
Randers FC,7029,9,5,6,13,24,41,-17,21
Silkeborg IF,7029,10,6,3,13,26,44,-18,21
AGF Aarhus,7029,11,4,6,12,16,37,-21,18
Brondby,7030,1,22,6,2,73,31,42,72
FC Midtjylla,7030,2,19,7,4,63,36,27,64
FC Nords,7030,3,15,7,8,78,52,26,52
Copenhagen,7030,4,12,5,13,54,47,7,41
AaB,7030,5,8,11,11,37,45,-8,35
Sonderjyske,7030,6,8,6,10,28,29,-1,30
AC Horsens,7030,7,6,12,12,33,53,-20,30
Randers FC,7030,8,6,6,12,26,41,-15,24
AGF Aarhus,7030,9,5,6,11,17,36,-19,21
Lyngby,7030,10,3,9,12,28,47,-19,18
Silkeborg IF,7030,11,5,3,14,25,45,-20,18
Brondby,7031,1,19,9,2,69,33,36,66
FC Midtjylla,7031,2,19,5,6,69,44,25,62
FC Nords,7031,3,14,8,8,78,55,23,50
Copenhagen,7031,4,13,6,11,58,45,13,45
AaB,7031,5,8,11,11,40,47,-7,35
AC Horsens,7031,6,7,13,10,35,51,-16,34
Sonderjyske,7031,7,8,6,10,28,29,-1,30
Randers FC,7031,8,6,6,12,25,39,-14,24
Silkeborg IF,7031,9,5,4,13,26,45,-19,19
AGF Aarhus,7031,10,4,7,11,17,37,-20,19
Lyngby,7031,11,3,9,12,26,46,-20,18
Brondby,7032,1,20,7,3,66,29,37,67
FC Midtjylla,7032,2,18,7,5,70,39,31,61
Copenhagen,7032,3,16,4,10,58,39,19,52
FC Nords,7032,4,14,7,9,68,49,19,49
AaB,7032,5,7,14,9,36,40,-4,35
Sonderjyske,7032,6,8,6,10,28,29,-1,30
AC Horsens,7032,7,5,13,12,31,59,-28,28
Lyngby,7032,8,4,9,11,27,44,-17,21
Randers FC,7032,9,5,6,13,23,40,-17,21
Silkeborg IF,7032,10,6,3,13,27,45,-18,21
AGF Aarhus,7032,11,4,6,12,17,38,-21,18
Brondby,7033,1,20,6,4,69,34,35,66
FC Midtjylla,7033,2,20,5,5,67,39,28,65
FC Nords,7033,3,16,6,8,75,48,27,54
Copenhagen,7033,4,13,7,10,60,48,12,46
AaB,7033,5,7,12,11,37,43,-6,33
Sonderjyske,7033,6,8,6,10,28,29,-1,30
AC Horsens,7033,7,5,14,11,36,58,-22,29
Randers FC,7033,8,5,7,12,23,39,-16,22
AGF Aarhus,7033,9,5,6,11,18,37,-19,21
Lyngby,7033,10,3,10,11,26,44,-18,19
Silkeborg IF,7033,11,5,3,14,26,46,-20,18
FC Midtjylla,7034,1,21,5,4,67,36,31,68
Brondby,7034,2,20,6,4,69,33,36,66
FC Nords,7034,3,14,6,10,71,53,18,48
Copenhagen,7034,4,14,6,10,59,45,14,48
AaB,7034,5,8,12,10,37,41,-4,36
Sonderjyske,7034,6,8,6,10,28,29,-1,30
AC Horsens,7034,7,5,13,12,34,55,-21,28
Silkeborg IF,7034,8,6,3,13,29,46,-17,21
Lyngby,7034,9,4,9,11,28,45,-17,21
Randers FC,7034,10,5,6,13,24,41,-17,21
AGF Aarhus,7034,11,4,6,12,18,40,-22,18
Brondby,7035,1,21,6,3,71,32,39,69
FC Midtjylla,7035,2,19,6,5,67,38,29,63
Copenhagen,7035,3,14,6,10,59,46,13,48
FC Nords,7035,4,13,7,10,76,58,18,46
AaB,7035,5,7,14,9,39,44,-5,35
AC Horsens,7035,6,6,13,11,40,60,-20,31
Sonderjyske,7035,7,8,6,10,28,29,-1,30
Randers FC,7035,8,5,7,12,24,40,-16,22
Silkeborg IF,7035,9,6,3,13,28,46,-18,21
Lyngby,7035,10,3,10,11,27,45,-18,19
AGF Aarhus,7035,11,4,6,12,18,39,-21,18
Brondby,7036,1,22,6,2,70,28,42,72
FC Midtjylla,7036,2,20,5,5,67,40,27,65
Copenhagen,7036,3,14,6,10,56,42,14,48
FC Nords,7036,4,13,6,11,73,55,18,45
AaB,7036,5,7,11,12,38,47,-9,32
AC Horsens,7036,6,6,14,10,37,55,-18,32
Sonderjyske,7036,7,8,6,10,28,29,-1,30
Lyngby,7036,8,4,9,11,29,45,-16,21
Silkeborg IF,7036,9,6,3,13,28,45,-17,21
Randers FC,7036,10,5,6,13,24,42,-18,21
AGF Aarhus,7036,11,4,6,12,17,39,-22,18
Brondby,7037,1,21,6,3,76,32,44,69
FC Midtjylla,7037,2,21,4,5,70,37,33,67
FC Nords,7037,3,13,7,10,72,60,12,46
Copenhagen,7037,4,12,6,12,58,51,7,42
AaB,7037,5,9,11,10,40,41,-1,38
AC Horsens,7037,6,6,14,10,35,56,-21,32
Sonderjyske,7037,7,8,6,10,28,29,-1,30
Randers FC,7037,8,5,7,12,24,40,-16,22
Lyngby,7037,9,3,10,11,27,45,-18,19
Silkeborg IF,7037,10,5,4,13,25,44,-19,19
AGF Aarhus,7037,11,4,7,11,16,36,-20,19
Brondby,7038,1,21,7,2,74,33,41,70
FC Midtjylla,7038,2,20,6,4,69,40,29,66
Copenhagen,7038,3,14,6,10,57,44,13,48
FC Nords,7038,4,13,6,11,74,54,20,45
AaB,7038,5,8,12,10,40,44,-4,36
Sonderjyske,7038,6,8,6,10,28,29,-1,30
AC Horsens,7038,7,5,13,12,37,62,-25,28
Randers FC,7038,8,6,6,12,25,39,-14,24
AGF Aarhus,7038,9,5,6,11,17,36,-19,21
Lyngby,7038,10,3,9,12,26,46,-20,18
Silkeborg IF,7038,11,5,3,14,25,45,-20,18
Brondby,7039,1,21,6,3,71,31,40,69
FC Midtjylla,7039,2,19,4,7,66,45,21,61
FC Nords,7039,3,14,6,10,71,53,18,48
Copenhagen,7039,4,14,4,12,58,46,12,46
AaB,7039,5,9,12,9,41,41,0,39
AC Horsens,7039,6,7,12,11,36,53,-17,33
Sonderjyske,7039,7,8,6,10,28,29,-1,30
Randers FC,7039,8,6,6,12,25,40,-15,24
AGF Aarhus,7039,9,5,6,11,17,36,-19,21
Lyngby,7039,10,3,9,12,27,46,-19,18
Silkeborg IF,7039,11,5,3,14,25,45,-20,18
Brondby,7040,1,21,7,2,73,30,43,70
FC Midtjylla,7040,2,20,5,5,70,45,25,65
FC Nords,7040,3,13,6,11,73,57,16,45
Copenhagen,7040,4,13,5,12,55,45,10,44
AaB,7040,5,7,14,9,36,40,-4,35
AC Horsens,7040,6,7,13,10,38,54,-16,34
Sonderjyske,7040,7,8,6,10,28,29,-1,30
Randers FC,7040,8,6,6,12,24,39,-15,24
AGF Aarhus,7040,9,5,6,11,18,36,-18,21
Lyngby,7040,10,3,9,12,26,45,-19,18
Silkeborg IF,7040,11,5,3,14,25,46,-21,18
Brondby,7041,1,23,5,2,71,28,43,74
FC Midtjylla,7041,2,18,4,8,59,40,19,58
FC Nords,7041,3,16,6,8,78,49,29,54
Copenhagen,7041,4,14,5,11,57,49,8,47
AC Horsens,7041,5,7,13,10,35,51,-16,34
Sonderjyske,7041,6,8,6,10,28,29,-1,30
AaB,7041,7,6,11,13,33,42,-9,29
Randers FC,7041,8,5,7,12,24,40,-16,22
AGF Aarhus,7041,9,5,6,11,18,37,-19,21
Lyngby,7041,10,3,10,11,27,45,-18,19
Silkeborg IF,7041,11,5,3,14,26,46,-20,18
Brondby,7042,1,21,6,3,66,29,37,69
FC Midtjylla,7042,2,19,5,6,69,41,28,62
FC Nords,7042,3,14,7,9,74,53,21,49
Copenhagen,7042,4,14,6,10,56,43,13,48
AaB,7042,5,7,12,11,36,46,-10,33
AC Horsens,7042,6,6,14,10,36,51,-15,32
Sonderjyske,7042,7,8,6,10,28,29,-1,30
Lyngby,7042,8,4,9,11,30,45,-15,21
Silkeborg IF,7042,9,6,3,13,27,45,-18,21
Randers FC,7042,10,5,6,13,24,43,-19,21
AGF Aarhus,7042,11,4,6,12,17,38,-21,18
Brondby,7043,1,20,7,3,67,33,34,67
FC Midtjylla,7043,2,20,5,5,68,38,30,65
Copenhagen,7043,3,16,4,10,63,42,21,52
FC Nords,7043,4,13,7,10,71,52,19,46
AaB,7043,5,7,12,11,38,49,-11,33
AC Horsens,7043,6,6,13,11,38,57,-19,31
Sonderjyske,7043,7,8,6,10,28,29,-1,30
Randers FC,7043,8,6,6,12,25,39,-14,24
AGF Aarhus,7043,9,5,6,11,17,36,-19,21
Lyngby,7043,10,3,9,12,26,46,-20,18
Silkeborg IF,7043,11,5,3,14,25,45,-20,18
Brondby,7044,1,21,5,4,67,32,35,68
FC Midtjylla,7044,2,20,4,6,69,37,32,64
FC Nords,7044,3,16,6,8,77,49,28,54
Copenhagen,7044,4,14,5,11,59,46,13,47
AaB,7044,5,7,12,11,36,45,-9,33
Sonderjyske,7044,6,8,6,10,28,29,-1,30
AC Horsens,7044,7,6,12,12,34,59,-25,30
Randers FC,7044,8,5,7,12,23,39,-16,22
Silkeborg IF,7044,9,6,3,13,26,44,-18,21
Lyngby,7044,10,3,10,11,26,44,-18,19
AGF Aarhus,7044,11,4,6,12,16,37,-21,18
Brondby,7045,1,21,7,2,69,30,39,70
FC Midtjylla,7045,2,19,5,6,69,40,29,62
FC Nords,7045,3,14,8,8,76,53,23,50
Copenhagen,7045,4,14,6,10,59,45,14,48
AaB,7045,5,7,12,11,36,47,-11,33
Sonderjyske,7045,6,8,6,10,28,29,-1,30
AC Horsens,7045,7,6,12,12,35,55,-20,30
Randers FC,7045,8,6,6,12,24,39,-15,24
Silkeborg IF,7045,9,6,3,13,26,44,-18,21
Lyngby,7045,10,3,9,12,26,45,-19,18
AGF Aarhus,7045,11,4,6,12,16,37,-21,18
FC Midtjylla,7046,1,21,5,4,72,39,33,68
Brondby,7046,2,19,6,5,67,35,32,63
Copenhagen,7046,3,14,4,12,58,47,11,46
FC Nords,7046,4,12,7,11,71,57,14,43
AC Horsens,7046,5,9,12,9,40,50,-10,39
AaB,7046,6,8,12,10,37,43,-6,36
Sonderjyske,7046,7,8,6,10,28,29,-1,30
Lyngby,7046,8,4,9,11,28,45,-17,21
Randers FC,7046,9,5,6,13,24,41,-17,21
AGF Aarhus,7046,10,5,6,11,18,37,-19,21
Silkeborg IF,7046,11,5,3,14,26,46,-20,18
Brondby,7047,1,20,6,4,69,31,38,66
FC Midtjylla,7047,2,19,5,6,61,38,23,62
FC Nords,7047,3,14,7,9,70,49,21,49
Copenhagen,7047,4,13,6,11,56,46,10,45
AaB,7047,5,9,11,10,37,38,-1,38
AC Horsens,7047,6,6,15,9,32,49,-17,33
Sonderjyske,7047,7,8,6,10,28,29,-1,30
Randers FC,7047,8,5,7,12,23,39,-16,22
Lyngby,7047,9,3,10,11,26,44,-18,19
Silkeborg IF,7047,10,5,4,13,26,45,-19,19
AGF Aarhus,7047,11,4,7,11,17,37,-20,19
Brondby,7048,1,22,6,2,77,30,47,72
FC Midtjylla,7048,2,20,5,5,65,38,27,65
FC Nords,7048,3,14,6,10,73,54,19,48
Copenhagen,7048,4,14,5,11,58,49,9,47
AaB,7048,5,7,12,11,43,48,-5,33
Sonderjyske,7048,6,8,6,10,28,29,-1,30
AC Horsens,7048,7,6,12,12,35,58,-23,30
Randers FC,7048,8,6,6,12,26,41,-15,24
Silkeborg IF,7048,9,6,3,13,26,44,-18,21
Lyngby,7048,10,3,9,12,28,47,-19,18
AGF Aarhus,7048,11,4,6,12,16,37,-21,18
Brondby,7049,1,20,6,4,69,34,35,66
FC Midtjylla,7049,2,19,7,4,67,40,27,64
FC Nords,7049,3,15,6,9,74,53,21,51
Copenhagen,7049,4,13,4,13,58,49,9,43
AaB,7049,5,8,13,9,41,42,-1,37
AC Horsens,7049,6,6,14,10,38,55,-17,32
Sonderjyske,7049,7,8,6,10,28,29,-1,30
Randers FC,7049,8,5,7,12,24,40,-16,22
Silkeborg IF,7049,9,6,3,13,27,45,-18,21
Lyngby,7049,10,3,10,11,27,45,-18,19
AGF Aarhus,7049,11,4,6,12,17,38,-21,18
Brondby,7050,1,21,5,4,70,31,39,68
FC Midtjylla,7050,2,20,4,6,68,38,30,64
FC Nords,7050,3,16,6,8,77,50,27,54
Copenhagen,7050,4,15,5,10,57,41,16,50
AaB,7050,5,7,11,12,36,47,-11,32
Sonderjyske,7050,6,8,6,10,28,29,-1,30
AC Horsens,7050,7,5,13,12,31,58,-27,28
Randers FC,7050,8,6,6,12,27,41,-14,24
Silkeborg IF,7050,9,6,3,13,28,45,-17,21
Lyngby,7050,10,3,9,12,28,48,-20,18
AGF Aarhus,7050,11,4,6,12,17,39,-22,18
Brondby,7051,1,21,6,3,70,34,36,69
FC Midtjylla,7051,2,20,4,6,68,41,27,64
FC Nords,7051,3,14,6,10,71,53,18,48
Copenhagen,7051,4,14,6,10,58,42,16,48
AaB,7051,5,7,14,9,38,42,-4,35
Sonderjyske,7051,6,8,6,10,28,29,-1,30
AC Horsens,7051,7,5,14,11,34,53,-19,29
Randers FC,7051,8,5,7,12,24,40,-16,22
AGF Aarhus,7051,9,5,6,11,18,37,-19,21
Lyngby,7051,10,3,10,11,27,45,-18,19
Silkeborg IF,7051,11,5,3,14,26,46,-20,18
Brondby,7052,1,22,5,3,76,33,43,71
FC Midtjylla,7052,2,18,6,6,63,41,22,60
Copenhagen,7052,3,15,5,10,62,46,16,50
FC Nords,7052,4,14,7,9,76,53,23,49
AaB,7052,5,7,13,10,37,45,-8,34
Sonderjyske,7052,6,8,6,10,28,29,-1,30
AC Horsens,7052,7,6,12,12,34,56,-22,30
Lyngby,7052,8,4,9,11,28,45,-17,21
Silkeborg IF,7052,8,6,3,13,28,45,-17,21
Randers FC,7052,10,5,6,13,24,41,-17,21
AGF Aarhus,7052,11,4,6,12,17,39,-22,18
Brondby,7053,1,20,6,4,72,33,39,66
FC Midtjylla,7053,2,18,6,6,62,39,23,60
FC Nords,7053,3,13,9,8,71,52,19,48
Copenhagen,7053,4,14,5,11,59,44,15,47
AaB,7053,5,8,12,10,40,46,-6,36
AC Horsens,7053,6,7,14,9,36,52,-16,35
Sonderjyske,7053,7,8,6,10,28,29,-1,30
Randers FC,7053,8,5,7,12,23,39,-16,22
AGF Aarhus,7053,9,5,6,11,19,37,-18,21
Lyngby,7053,10,3,10,11,26,44,-18,19
Silkeborg IF,7053,11,5,3,14,26,47,-21,18
Brondby,7054,1,22,5,3,72,32,40,71
FC Midtjylla,7054,2,21,4,5,67,37,30,67
FC Nords,7054,3,13,8,9,73,53,20,47
Copenhagen,7054,4,14,5,11,58,45,13,47
AaB,7054,5,6,14,10,36,43,-7,32
Sonderjyske,7054,6,8,6,10,28,29,-1,30
AC Horsens,7054,7,5,14,11,33,55,-22,29
Randers FC,7054,8,6,6,12,24,39,-15,24
AGF Aarhus,7054,9,5,6,11,19,38,-19,21
Lyngby,7054,10,3,9,12,26,45,-19,18
Silkeborg IF,7054,11,5,3,14,27,47,-20,18
Brondby,7055,1,19,8,3,67,31,36,65
FC Midtjylla,7055,2,20,4,6,62,38,24,64
FC Nords,7055,3,15,7,8,73,48,25,52
Copenhagen,7055,4,13,5,12,55,47,8,44
AaB,7055,5,8,13,9,39,39,0,37
AC Horsens,7055,6,6,13,11,34,53,-19,31
Sonderjyske,7055,7,8,6,10,28,29,-1,30
Lyngby,7055,8,4,9,11,27,44,-17,21
Randers FC,7055,9,5,6,13,23,40,-17,21
Silkeborg IF,7055,10,5,4,13,27,46,-19,19
AGF Aarhus,7055,11,4,7,11,18,38,-20,19
Brondby,7056,1,22,6,2,74,29,45,72
FC Midtjylla,7056,2,20,4,6,69,42,27,64
Copenhagen,7056,3,14,6,10,57,42,15,48
FC Nords,7056,4,12,8,10,69,55,14,44
AC Horsens,7056,5,7,13,10,36,52,-16,34
AaB,7056,6,7,11,12,33,44,-11,32
Sonderjyske,7056,7,8,6,10,28,29,-1,30
Lyngby,7056,8,4,9,11,29,44,-15,21
Randers FC,7056,9,5,6,13,23,42,-19,21
Silkeborg IF,7056,10,5,4,13,27,46,-19,19
AGF Aarhus,7056,11,4,7,11,18,38,-20,19
Brondby,7057,1,19,7,4,70,37,33,64
FC Midtjylla,7057,2,18,5,7,68,46,22,59
FC Nords,7057,3,15,7,8,79,56,23,52
Copenhagen,7057,4,14,5,11,59,45,14,47
AC Horsens,7057,5,9,12,9,41,49,-8,39
AaB,7057,6,7,12,11,36,46,-10,33
Sonderjyske,7057,7,8,6,10,28,29,-1,30
Lyngby,7057,8,4,9,11,29,45,-16,21
Silkeborg IF,7057,9,6,3,13,27,45,-18,21
Randers FC,7057,10,5,6,13,24,42,-18,21
AGF Aarhus,7057,11,4,6,12,17,38,-21,18
Brondby,7058,1,20,6,4,70,32,38,66
FC Midtjylla,7058,2,19,5,6,63,42,21,62
FC Nords,7058,3,16,6,8,82,52,30,54
Copenhagen,7058,4,15,5,10,63,45,18,50
AaB,7058,5,7,12,11,33,42,-9,33
Sonderjyske,7058,6,8,6,10,28,29,-1,30
AC Horsens,7058,7,6,12,12,35,59,-24,30
Lyngby,7058,8,4,9,11,29,46,-17,21
Randers FC,7058,9,5,6,13,25,42,-17,21
Silkeborg IF,7058,10,6,3,13,27,45,-18,21
AGF Aarhus,7058,11,4,6,12,17,38,-21,18
Brondby,7059,1,21,5,4,70,35,35,68
FC Midtjylla,7059,2,21,4,5,69,37,32,67
Copenhagen,7059,3,16,5,9,60,39,21,53
FC Nords,7059,4,14,6,10,72,52,20,48
AaB,7059,5,6,13,11,38,48,-10,31
Sonderjyske,7059,6,8,6,10,28,29,-1,30
AC Horsens,7059,7,5,13,12,32,56,-24,28
Randers FC,7059,8,6,6,12,24,39,-15,24
Silkeborg IF,7059,9,6,3,13,31,46,-15,21
Lyngby,7059,10,3,9,12,26,45,-19,18
AGF Aarhus,7059,11,4,6,12,18,42,-24,18
Brondby,7060,1,21,6,3,70,31,39,69
FC Midtjylla,7060,2,18,6,6,67,42,25,60
FC Nords,7060,3,15,6,9,75,52,23,51
Copenhagen,7060,4,14,4,12,60,47,13,46
AC Horsens,7060,5,8,13,9,40,50,-10,37
AaB,7060,6,7,11,12,34,50,-16,32
Sonderjyske,7060,7,8,6,10,28,29,-1,30
Randers FC,7060,8,5,7,12,24,40,-16,22
Silkeborg IF,7060,9,6,3,13,29,46,-17,21
Lyngby,7060,10,3,10,11,27,45,-18,19
AGF Aarhus,7060,11,4,6,12,18,40,-22,18
Brondby,7061,1,22,5,3,71,31,40,71
FC Midtjylla,7061,2,21,4,5,68,39,29,67
FC Nords,7061,3,14,7,9,76,56,20,49
Copenhagen,7061,4,13,5,12,56,46,10,44
AaB,7061,5,7,13,10,36,42,-6,34
Sonderjyske,7061,6,8,6,10,28,29,-1,30
AC Horsens,7061,7,5,14,11,34,53,-19,29
Randers FC,7061,8,6,6,12,26,39,-13,24
Silkeborg IF,7061,9,6,3,13,30,45,-15,21
Lyngby,7061,10,3,9,12,26,47,-21,18
AGF Aarhus,7061,11,4,6,12,17,41,-24,18
Brondby,7062,1,21,6,3,73,33,40,69
FC Midtjylla,7062,2,19,5,6,64,41,23,62
FC Nords,7062,3,14,6,10,72,59,13,48
Copenhagen,7062,4,14,5,11,63,48,15,47
AaB,7062,5,8,13,9,41,40,1,37
AC Horsens,7062,6,6,13,11,37,55,-18,31
Sonderjyske,7062,7,8,6,10,28,29,-1,30
Lyngby,7062,8,4,9,11,29,45,-16,21
Randers FC,7062,9,5,6,13,24,42,-18,21
Silkeborg IF,7062,10,5,4,13,27,46,-19,19
AGF Aarhus,7062,11,4,7,11,18,38,-20,19
Brondby,7063,1,21,6,3,70,33,37,69
FC Midtjylla,7063,2,21,5,4,71,36,35,68
FC Nords,7063,3,14,7,9,77,51,26,49
Copenhagen,7063,4,13,5,12,56,49,7,44
AaB,7063,5,8,11,11,40,46,-6,35
Sonderjyske,7063,6,8,6,10,28,29,-1,30
AC Horsens,7063,7,6,12,12,33,58,-25,30
Randers FC,7063,8,5,7,12,24,40,-16,22
AGF Aarhus,7063,9,5,6,11,17,36,-19,21
Lyngby,7063,10,3,10,11,27,45,-18,19
Silkeborg IF,7063,11,5,3,14,25,45,-20,18
Brondby,7064,1,20,7,3,69,31,38,67
FC Midtjylla,7064,2,21,4,5,67,36,31,67
FC Nords,7064,3,12,8,10,72,59,13,44
Copenhagen,7064,4,12,6,12,57,51,6,42
AC Horsens,7064,5,9,12,9,39,48,-9,39
AaB,7064,6,7,13,10,39,44,-5,34
Sonderjyske,7064,7,8,6,10,28,29,-1,30
Lyngby,7064,8,4,9,11,28,45,-17,21
Silkeborg IF,7064,8,6,3,13,28,45,-17,21
Randers FC,7064,10,5,6,13,24,41,-17,21
AGF Aarhus,7064,11,4,6,12,17,39,-22,18
Brondby,7065,1,22,6,2,72,30,42,72
FC Midtjylla,7065,2,19,5,6,68,44,24,62
Copenhagen,7065,3,15,4,11,57,43,14,49
FC Nords,7065,4,13,6,11,72,52,20,45
AaB,7065,5,8,13,9,40,43,-3,37
Sonderjyske,7065,6,8,6,10,28,29,-1,30
AC Horsens,7065,7,6,12,12,35,58,-23,30
Lyngby,7065,8,4,9,11,31,44,-13,21
AGF Aarhus,7065,9,5,6,11,20,37,-17,21
Randers FC,7065,10,5,6,13,23,44,-21,21
Silkeborg IF,7065,11,5,3,14,26,48,-22,18
Brondby,7066,1,21,6,3,69,31,38,69
FC Midtjylla,7066,2,21,4,5,69,44,25,67
FC Nords,7066,3,14,8,8,71,52,19,50
Copenhagen,7066,4,14,4,12,63,45,18,46
AaB,7066,5,7,12,11,39,46,-7,33
Sonderjyske,7066,6,8,6,10,28,29,-1,30
AC Horsens,7066,7,6,12,12,35,54,-19,30
Randers FC,7066,8,6,6,12,26,41,-15,24
Silkeborg IF,7066,9,6,3,13,26,44,-18,21
Lyngby,7066,10,3,9,12,28,47,-19,18
AGF Aarhus,7066,11,4,6,12,16,37,-21,18
Brondby,7067,1,21,7,2,75,31,44,70
FC Midtjylla,7067,2,21,5,4,69,38,31,68
FC Nords,7067,3,15,6,9,77,56,21,51
Copenhagen,7067,4,12,7,11,54,44,10,43
AaB,7067,5,7,12,11,37,46,-9,33
Sonderjyske,7067,6,8,6,10,28,29,-1,30
AC Horsens,7067,7,5,13,12,35,58,-23,28
Randers FC,7067,8,6,6,12,25,39,-14,24
Silkeborg IF,7067,9,6,3,13,28,44,-16,21
Lyngby,7067,10,3,9,12,26,46,-20,18
AGF Aarhus,7067,11,4,6,12,16,39,-23,18
Brondby,7068,1,20,6,4,68,33,35,66
FC Midtjylla,7068,2,18,7,5,61,38,23,61
Copenhagen,7068,3,16,4,10,59,41,18,52
FC Nords,7068,4,13,7,10,70,52,18,46
AaB,7068,5,8,12,10,38,42,-4,36
AC Horsens,7068,6,7,12,11,35,51,-16,33
Sonderjyske,7068,7,8,6,10,28,29,-1,30
Randers FC,7068,8,5,7,12,23,39,-16,22
Lyngby,7068,9,3,10,11,26,44,-18,19
Silkeborg IF,7068,10,5,4,13,25,44,-19,19
AGF Aarhus,7068,11,4,7,11,16,36,-20,19
Brondby,7069,1,21,6,3,75,33,42,69
FC Midtjylla,7069,2,20,4,6,67,42,25,64
Copenhagen,7069,3,15,4,11,56,48,8,49
FC Nords,7069,4,14,6,10,83,59,24,48
AaB,7069,5,8,11,11,39,47,-8,35
AC Horsens,7069,6,6,13,11,34,51,-17,31
Sonderjyske,7069,7,8,6,10,28,29,-1,30
Lyngby,7069,8,4,9,11,29,44,-15,21
Silkeborg IF,7069,9,6,3,13,27,45,-18,21
Randers FC,7069,10,5,6,13,23,42,-19,21
AGF Aarhus,7069,11,4,6,12,17,38,-21,18
Brondby,7070,1,20,7,3,70,33,37,67
FC Midtjylla,7070,2,19,4,7,68,43,25,61
FC Nords,7070,3,14,6,10,73,53,20,48
Copenhagen,7070,4,14,4,12,60,48,12,46
AaB,7070,5,8,13,9,38,42,-4,37
AC Horsens,7070,6,7,14,9,36,52,-16,35
Sonderjyske,7070,7,8,6,10,28,29,-1,30
Randers FC,7070,8,6,6,12,25,40,-15,24
Silkeborg IF,7070,9,5,4,13,26,45,-19,19
AGF Aarhus,7070,10,4,7,11,17,37,-20,19
Lyngby,7070,11,3,9,12,27,46,-19,18
Brondby,7071,1,21,5,4,68,31,37,68
FC Midtjylla,7071,2,20,5,5,65,41,24,65
FC Nords,7071,3,15,7,8,82,58,24,52
Copenhagen,7071,4,15,5,10,62,45,17,50
Sonderjyske,7071,5,8,6,10,28,29,-1,30
AaB,7071,6,6,12,12,37,47,-10,30
AC Horsens,7071,7,5,14,11,37,55,-18,29
Silkeborg IF,7071,8,6,3,13,30,47,-17,21
Lyngby,7071,9,4,9,11,27,44,-17,21
Randers FC,7071,10,5,6,13,23,40,-17,21
AGF Aarhus,7071,11,4,6,12,19,41,-22,18
Brondby,7072,1,20,6,4,76,37,39,66
FC Midtjylla,7072,2,17,5,8,62,42,20,56
FC Nords,7072,3,15,8,7,78,53,25,53
Copenhagen,7072,4,15,5,10,59,43,16,50
AC Horsens,7072,5,8,12,10,38,51,-13,36
AaB,7072,6,7,12,11,33,46,-13,33
Sonderjyske,7072,7,8,6,10,28,29,-1,30
Randers FC,7072,8,5,7,12,23,39,-16,22
Silkeborg IF,7072,9,6,3,13,28,45,-17,21
Lyngby,7072,10,3,10,11,26,44,-18,19
AGF Aarhus,7072,11,4,6,12,17,39,-22,18
Brondby,7073,1,22,6,2,72,29,43,72
FC Midtjylla,7073,2,19,4,7,65,42,23,61
Copenhagen,7073,3,15,6,9,61,42,19,51
FC Nords,7073,4,14,7,9,71,53,18,49
AaB,7073,5,7,11,12,36,42,-6,32
Sonderjyske,7073,6,8,6,10,28,29,-1,30
AC Horsens,7073,7,6,12,12,35,58,-23,30
Randers FC,7073,8,6,6,12,25,40,-15,24
Silkeborg IF,7073,9,6,3,13,27,44,-17,21
Lyngby,7073,10,3,9,12,27,46,-19,18
AGF Aarhus,7073,11,4,6,12,16,38,-22,18
Brondby,7074,1,20,7,3,68,32,36,67
FC Midtjylla,7074,2,19,5,6,63,39,24,62
FC Nords,7074,3,15,6,9,74,50,24,51
Copenhagen,7074,4,14,4,12,56,47,9,46
AaB,7074,5,8,11,11,36,40,-4,35
AC Horsens,7074,6,7,13,10,37,52,-15,34
Sonderjyske,7074,7,8,6,10,28,29,-1,30
Randers FC,7074,8,5,7,12,25,41,-16,22
Silkeborg IF,7074,9,6,3,13,28,44,-16,21
Lyngby,7074,10,3,10,11,28,46,-18,19
AGF Aarhus,7074,11,4,6,12,16,39,-23,18
Brondby,7075,1,21,5,4,73,35,38,68
FC Midtjylla,7075,2,20,5,5,66,40,26,65
Copenhagen,7075,3,14,5,11,58,43,15,47
FC Nords,7075,4,13,7,10,72,56,16,46
AaB,7075,5,10,11,9,43,42,1,41
Sonderjyske,7075,6,8,6,10,28,29,-1,30
AC Horsens,7075,7,5,13,12,36,58,-22,28
Randers FC,7075,8,6,6,12,24,39,-15,24
Silkeborg IF,7075,9,5,4,13,25,44,-19,19
AGF Aarhus,7075,10,4,7,11,16,36,-20,19
Lyngby,7075,11,3,9,12,26,45,-19,18
Brondby,7076,1,22,6,2,74,30,44,72
FC Midtjylla,7076,2,19,4,7,68,41,27,61
FC Nords,7076,3,14,7,9,75,54,21,49
Copenhagen,7076,4,14,5,11,55,43,12,47
AaB,7076,5,8,12,10,38,44,-6,36
Sonderjyske,7076,6,8,6,10,28,29,-1,30
AC Horsens,7076,7,6,12,12,36,60,-24,30
Randers FC,7076,8,6,6,12,27,42,-15,24
Silkeborg IF,7076,9,6,3,13,27,45,-18,21
Lyngby,7076,10,3,9,12,29,48,-19,18
AGF Aarhus,7076,11,4,6,12,17,38,-21,18
Brondby,7077,1,21,5,4,73,35,38,68
FC Midtjylla,7077,2,18,5,7,66,45,21,59
FC Nords,7077,3,15,6,9,77,53,24,51
Copenhagen,7077,4,13,6,11,59,47,12,45
AaB,7077,5,9,13,8,38,38,0,40
AC Horsens,7077,6,6,13,11,35,56,-21,31
Sonderjyske,7077,7,8,6,10,28,29,-1,30
Randers FC,7077,8,5,7,12,24,40,-16,22
Silkeborg IF,7077,9,6,3,13,26,44,-18,21
Lyngby,7077,10,3,10,11,27,45,-18,19
AGF Aarhus,7077,11,4,6,12,16,37,-21,18
Brondby,7078,1,20,6,4,69,37,32,66
FC Midtjylla,7078,2,20,6,4,66,37,29,66
Copenhagen,7078,3,15,5,10,67,43,24,50
FC Nords,7078,4,14,7,9,71,50,21,49
AC Horsens,7078,5,7,13,10,34,53,-19,34
Sonderjyske,7078,6,8,6,10,28,29,-1,30
AaB,7078,7,6,11,13,33,46,-13,29
Lyngby,7078,8,4,9,11,27,44,-17,21
Randers FC,7078,9,5,6,13,23,40,-17,21
AGF Aarhus,7078,10,5,6,11,17,36,-19,21
Silkeborg IF,7078,11,5,3,14,25,45,-20,18
Brondby,7079,1,21,5,4,70,31,39,68
FC Midtjylla,7079,2,20,4,6,68,36,32,64
Copenhagen,7079,3,16,4,10,59,41,18,52
FC Nords,7079,4,14,6,10,69,56,13,48
AaB,7079,5,8,11,11,35,43,-8,35
Sonderjyske,7079,6,8,6,10,28,29,-1,30
AC Horsens,7079,7,6,12,12,30,50,-20,30
Randers FC,7079,8,6,6,12,26,40,-14,24
Silkeborg IF,7079,9,6,3,13,28,46,-18,21
Lyngby,7079,10,3,9,12,27,47,-20,18
AGF Aarhus,7079,11,4,6,12,18,39,-21,18
Brondby,7080,1,20,6,4,70,37,33,66
FC Midtjylla,7080,2,20,5,5,66,37,29,65
Copenhagen,7080,3,16,4,10,62,42,20,52
FC Nords,7080,4,13,8,9,69,52,17,47
AaB,7080,5,7,12,11,38,45,-7,33
AC Horsens,7080,6,6,13,11,35,53,-18,31
Sonderjyske,7080,7,8,6,10,28,29,-1,30
Silkeborg IF,7080,8,6,3,13,29,44,-15,21
Lyngby,7080,9,4,9,11,28,44,-16,21
Randers FC,7080,10,5,6,13,23,41,-18,21
AGF Aarhus,7080,11,4,6,12,16,40,-24,18
FC Midtjylla,7081,1,21,5,4,64,35,29,68
Brondby,7081,2,19,6,5,70,35,35,63
Copenhagen,7081,3,15,6,9,58,39,19,51
FC Nords,7081,4,13,8,9,73,57,16,47
AC Horsens,7081,5,7,13,10,36,53,-17,34
Sonderjyske,7081,6,8,6,10,28,29,-1,30
AaB,7081,7,6,12,12,36,44,-8,30
Randers FC,7081,8,5,7,12,23,39,-16,22
AGF Aarhus,7081,9,5,6,11,18,37,-19,21
Lyngby,7081,10,3,10,11,26,44,-18,19
Silkeborg IF,7081,11,5,3,14,26,46,-20,18
Brondby,7082,1,22,6,2,70,28,42,72
FC Midtjylla,7082,2,19,4,7,67,46,21,61
Copenhagen,7082,3,15,5,10,65,45,20,50
FC Nords,7082,4,14,7,9,71,50,21,49
AaB,7082,5,7,11,12,39,48,-9,32
AC Horsens,7082,6,6,13,11,35,56,-21,31
Sonderjyske,7082,7,8,6,10,28,29,-1,30
Lyngby,7082,8,4,9,11,28,44,-16,21
Silkeborg IF,7082,9,6,3,13,26,44,-18,21
Randers FC,7082,10,5,6,13,23,41,-18,21
AGF Aarhus,7082,11,4,6,12,16,37,-21,18
Brondby,7083,1,22,5,3,73,29,44,71
FC Midtjylla,7083,2,19,4,7,62,45,17,61
FC Nords,7083,3,16,6,8,71,47,24,54
Copenhagen,7083,4,15,4,11,61,43,18,49
AaB,7083,5,7,12,11,37,45,-8,33
Sonderjyske,7083,6,8,6,10,28,29,-1,30
AC Horsens,7083,7,5,13,12,33,54,-21,28
Randers FC,7083,8,5,7,12,23,39,-16,22
Lyngby,7083,9,3,10,11,26,44,-18,19
Silkeborg IF,7083,10,5,4,13,27,46,-19,19
AGF Aarhus,7083,11,4,7,11,18,38,-20,19
Brondby,7084,1,21,5,4,65,30,35,68
FC Midtjylla,7084,2,19,5,6,62,39,23,62
Copenhagen,7084,3,14,7,9,59,41,18,49
FC Nords,7084,4,13,8,9,71,50,21,47
AC Horsens,7084,5,8,14,8,35,46,-11,38
Sonderjyske,7084,6,8,6,10,28,29,-1,30
AaB,7084,7,6,11,13,33,45,-12,29
Lyngby,7084,8,4,9,11,27,44,-17,21
Randers FC,7084,9,5,6,13,23,40,-17,21
Silkeborg IF,7084,10,5,4,13,26,45,-19,19
AGF Aarhus,7084,11,4,7,11,17,37,-20,19
Brondby,7085,1,19,7,4,66,32,34,64
FC Midtjylla,7085,2,19,6,5,64,38,26,63
Copenhagen,7085,3,13,8,9,57,43,14,47
FC Nords,7085,4,12,8,10,69,53,16,44
AaB,7085,5,8,13,9,39,41,-2,37
AC Horsens,7085,6,7,14,9,37,51,-14,35
Sonderjyske,7085,7,8,6,10,28,29,-1,30
Randers FC,7085,8,5,7,12,24,40,-16,22
Lyngby,7085,9,3,10,11,27,45,-18,19
Silkeborg IF,7085,10,5,4,13,25,44,-19,19
AGF Aarhus,7085,11,4,7,11,16,36,-20,19
Brondby,7086,1,20,7,3,70,34,36,67
FC Midtjylla,7086,2,20,5,5,64,38,26,65
FC Nords,7086,3,15,7,8,74,47,27,52
Copenhagen,7086,4,13,6,11,54,41,13,45
AaB,7086,5,8,13,9,38,41,-3,37
Sonderjyske,7086,6,8,6,10,28,29,-1,30
AC Horsens,7086,7,5,12,13,31,56,-25,27
Lyngby,7086,8,4,9,11,30,45,-15,21
Silkeborg IF,7086,9,6,3,13,26,44,-18,21
Randers FC,7086,10,5,6,13,24,43,-19,21
AGF Aarhus,7086,11,4,6,12,16,37,-21,18
Brondby,7087,1,22,5,3,72,34,38,71
FC Midtjylla,7087,2,19,6,5,68,41,27,63
Copenhagen,7087,3,15,6,9,65,44,21,51
FC Nords,7087,4,14,6,10,74,54,20,48
AaB,7087,5,6,13,11,34,44,-10,31
Sonderjyske,7087,6,8,6,10,28,29,-1,30
AC Horsens,7087,7,5,14,11,33,55,-22,29
Lyngby,7087,8,4,9,11,27,44,-17,21
Randers FC,7087,9,5,6,13,23,40,-17,21
Silkeborg IF,7087,10,5,4,13,25,44,-19,19
AGF Aarhus,7087,11,4,7,11,16,36,-20,19
Brondby,7088,1,21,7,2,74,31,43,70
FC Midtjylla,7088,2,20,5,5,64,36,28,65
FC Nords,7088,3,14,6,10,73,53,20,48
Copenhagen,7088,4,13,4,13,52,49,3,43
AaB,7088,5,9,11,10,39,42,-3,38
AC Horsens,7088,6,6,13,11,32,49,-17,31
Sonderjyske,7088,7,8,6,10,28,29,-1,30
Lyngby,7088,8,4,9,11,29,46,-17,21
Randers FC,7088,9,5,6,13,25,42,-17,21
AGF Aarhus,7088,10,5,6,11,19,37,-18,21
Silkeborg IF,7088,11,5,3,14,26,47,-21,18
Brondby,7089,1,22,5,3,72,30,42,71
FC Midtjylla,7089,2,17,6,7,61,43,18,57
Copenhagen,7089,3,15,5,10,59,43,16,50
FC Nords,7089,4,14,7,9,72,52,20,49
AaB,7089,5,8,11,11,42,46,-4,35
AC Horsens,7089,6,6,14,10,35,53,-18,32
Sonderjyske,7089,7,8,6,10,28,29,-1,30
Randers FC,7089,8,6,6,12,25,40,-15,24
AGF Aarhus,7089,9,5,6,11,17,36,-19,21
Lyngby,7089,10,3,9,12,27,46,-19,18
Silkeborg IF,7089,11,5,3,14,25,45,-20,18
Brondby,7090,1,22,5,3,72,30,42,71
FC Midtjylla,7090,2,20,4,6,69,44,25,64
Copenhagen,7090,3,15,5,10,58,44,14,50
FC Nords,7090,4,14,6,10,75,52,23,48
AaB,7090,5,7,12,11,37,47,-10,33
Sonderjyske,7090,6,8,6,10,28,29,-1,30
AC Horsens,7090,7,6,12,12,36,56,-20,30
Lyngby,7090,8,4,9,11,28,44,-16,21
Randers FC,7090,9,5,6,13,23,41,-18,21
Silkeborg IF,7090,10,5,4,13,25,44,-19,19
AGF Aarhus,7090,11,4,7,11,16,36,-20,19
Brondby,7091,1,23,5,2,68,26,42,74
FC Midtjylla,7091,2,19,5,6,66,40,26,62
FC Nords,7091,3,16,6,8,80,51,29,54
Copenhagen,7091,4,12,5,13,56,52,4,41
AaB,7091,5,7,12,11,34,41,-7,33
AC Horsens,7091,6,6,13,11,34,54,-20,31
Sonderjyske,7091,7,8,6,10,28,29,-1,30
Lyngby,7091,8,4,9,11,29,46,-17,21
Randers FC,7091,9,5,6,13,25,42,-17,21
Silkeborg IF,7091,10,5,4,13,27,46,-19,19
AGF Aarhus,7091,11,4,7,11,18,38,-20,19
Brondby,7092,1,21,6,3,70,32,38,69
FC Midtjylla,7092,2,18,6,6,60,37,23,60
FC Nords,7092,3,15,7,8,73,46,27,52
Copenhagen,7092,4,12,7,11,53,43,10,43
AC Horsens,7092,5,8,12,10,33,48,-15,36
AaB,7092,6,7,12,11,37,46,-9,33
Sonderjyske,7092,7,8,6,10,28,29,-1,30
Lyngby,7092,8,4,9,11,28,45,-17,21
Randers FC,7092,9,5,6,13,24,41,-17,21
AGF Aarhus,7092,10,5,6,11,18,36,-18,21
Silkeborg IF,7092,11,5,3,14,25,46,-21,18
Brondby,7093,1,21,6,3,70,35,35,69
FC Midtjylla,7093,2,20,6,4,70,36,34,66
FC Nords,7093,3,13,7,10,73,55,18,46
Copenhagen,7093,4,12,6,12,56,50,6,42
AC Horsens,7093,5,7,14,9,41,54,-13,35
AaB,7093,6,6,15,9,37,43,-6,33
Sonderjyske,7093,7,8,6,10,28,29,-1,30
Randers FC,7093,8,6,6,12,27,41,-14,24
Silkeborg IF,7093,9,5,4,13,26,45,-19,19
AGF Aarhus,7093,10,4,7,11,17,37,-20,19
Lyngby,7093,11,3,9,12,28,48,-20,18
Brondby,7094,1,22,5,3,73,30,43,71
FC Midtjylla,7094,2,19,5,6,65,43,22,62
FC Nords,7094,3,15,6,9,71,48,23,51
Copenhagen,7094,4,14,5,11,56,45,11,47
AC Horsens,7094,5,7,12,11,37,54,-17,33
AaB,7094,6,7,11,12,37,45,-8,32
Sonderjyske,7094,7,8,6,10,28,29,-1,30
Lyngby,7094,8,4,9,11,27,44,-17,21
Randers FC,7094,9,5,6,13,23,40,-17,21
Silkeborg IF,7094,10,6,3,13,28,46,-18,21
AGF Aarhus,7094,11,4,6,12,18,39,-21,18
Brondby,7095,1,21,7,2,74,31,43,70
FC Midtjylla,7095,2,18,5,7,65,43,22,59
FC Nords,7095,3,13,8,9,78,56,22,47
Copenhagen,7095,4,14,5,11,59,49,10,47
AaB,7095,5,8,13,9,42,44,-2,37
AC Horsens,7095,6,6,14,10,34,55,-21,32
Sonderjyske,7095,7,8,6,10,28,29,-1,30
Randers FC,7095,8,6,6,12,26,39,-13,24
Silkeborg IF,7095,9,6,3,13,26,44,-18,21
Lyngby,7095,10,3,9,12,26,47,-21,18
AGF Aarhus,7095,11,4,6,12,16,37,-21,18
Brondby,7096,1,21,7,2,70,32,38,70
FC Midtjylla,7096,2,20,5,5,67,38,29,65
Copenhagen,7096,3,14,7,9,56,41,15,49
FC Nords,7096,4,12,6,12,72,56,16,42
AaB,7096,5,7,13,10,37,42,-5,34
AC Horsens,7096,6,7,12,11,33,52,-19,33
Sonderjyske,7096,7,8,6,10,28,29,-1,30
Lyngby,7096,8,4,9,11,28,44,-16,21
Randers FC,7096,9,5,6,13,23,41,-18,21
Silkeborg IF,7096,10,5,4,13,25,44,-19,19
AGF Aarhus,7096,11,4,7,11,16,36,-20,19
Brondby,7097,1,21,6,3,71,30,41,69
FC Midtjylla,7097,2,19,6,5,66,42,24,63
FC Nords,7097,3,14,7,9,75,54,21,49
Copenhagen,7097,4,13,6,11,57,45,12,45
AaB,7097,5,8,13,9,37,41,-4,37
Sonderjyske,7097,6,8,6,10,28,29,-1,30
AC Horsens,7097,7,5,14,11,33,53,-20,29
Randers FC,7097,8,6,6,12,25,40,-15,24
Silkeborg IF,7097,9,6,3,13,28,45,-17,21
Lyngby,7097,10,3,9,12,27,46,-19,18
AGF Aarhus,7097,11,4,6,12,17,39,-22,18
Brondby,7098,1,20,5,5,68,34,34,65
FC Midtjylla,7098,2,20,5,5,70,39,31,65
Copenhagen,7098,3,13,7,10,57,43,14,46
FC Nords,7098,4,12,8,10,69,54,15,44
AC Horsens,7098,5,8,13,9,36,52,-16,37
AaB,7098,6,8,12,10,38,42,-4,36
Sonderjyske,7098,7,8,6,10,28,29,-1,30
AGF Aarhus,7098,8,5,6,11,20,36,-16,21
Lyngby,7098,9,4,9,11,27,44,-17,21
Randers FC,7098,10,5,6,13,23,40,-17,21
Silkeborg IF,7098,11,5,3,14,25,48,-23,18
Brondby,7099,1,22,6,2,71,31,40,72
FC Midtjylla,7099,2,20,6,4,68,38,30,66
FC Nords,7099,3,13,7,10,70,50,20,46
Copenhagen,7099,4,13,6,11,57,48,9,45
AaB,7099,5,8,11,11,39,42,-3,35
Sonderjyske,7099,6,8,6,10,28,29,-1,30
AC Horsens,7099,7,6,12,12,32,54,-22,30
Lyngby,7099,8,4,9,11,31,45,-14,21
Randers FC,7099,9,5,6,13,24,44,-20,21
Silkeborg IF,7099,10,5,4,13,27,46,-19,19
AGF Aarhus,7099,11,4,7,11,18,38,-20,19
Brondby,7100,1,23,5,2,72,31,41,74
FC Midtjylla,7100,2,18,6,6,63,40,23,60
FC Nords,7100,3,13,9,8,74,51,23,48
Copenhagen,7100,4,14,5,11,59,46,13,47
AaB,7100,5,7,13,10,37,39,-2,34
Sonderjyske,7100,6,8,6,10,28,29,-1,30
AC Horsens,7100,7,6,12,12,33,57,-24,30
Lyngby,7100,8,4,9,11,28,44,-16,21
Randers FC,7100,9,5,6,13,23,41,-18,21
Silkeborg IF,7100,10,5,4,13,27,46,-19,19
AGF Aarhus,7100,11,4,7,11,18,38,-20,19
FC Midtjylla,7101,1,20,6,4,67,39,28,66
Brondby,7101,2,19,7,4,69,36,33,64
FC Nords,7101,3,15,7,8,74,53,21,52
Copenhagen,7101,4,15,5,10,60,42,18,50
AaB,7101,5,7,12,11,41,47,-6,33
Sonderjyske,7101,6,8,6,10,28,29,-1,30
AC Horsens,7101,7,5,13,12,34,54,-20,28
Randers FC,7101,8,6,6,12,26,40,-14,24
Silkeborg IF,7101,9,6,3,13,27,44,-17,21
Lyngby,7101,10,3,9,12,27,47,-20,18
AGF Aarhus,7101,11,4,6,12,16,38,-22,18
Brondby,7102,1,23,5,2,76,29,47,74
FC Midtjylla,7102,2,18,6,6,63,39,24,60
FC Nords,7102,3,15,6,9,74,55,19,51
Copenhagen,7102,4,13,5,12,59,50,9,44
AaB,7102,5,6,14,10,39,48,-9,32
AC Horsens,7102,6,6,14,10,32,48,-16,32
Sonderjyske,7102,7,8,6,10,28,29,-1,30
Randers FC,7102,8,5,7,12,23,39,-16,22
Silkeborg IF,7102,9,6,3,13,27,44,-17,21
Lyngby,7102,10,3,10,11,26,44,-18,19
AGF Aarhus,7102,11,4,6,12,16,38,-22,18
Brondby,7103,1,18,10,2,67,32,35,64
FC Midtjylla,7103,2,19,5,6,70,41,29,62
FC Nords,7103,3,13,9,8,73,52,21,48
Copenhagen,7103,4,13,6,11,59,49,10,45
AC Horsens,7103,5,8,13,9,37,50,-13,37
AaB,7103,6,7,13,10,36,44,-8,34
Sonderjyske,7103,7,8,6,10,28,29,-1,30
Randers FC,7103,8,5,7,12,26,42,-16,22
Silkeborg IF,7103,9,6,3,13,27,44,-17,21
Lyngby,7103,10,3,10,11,29,47,-18,19
AGF Aarhus,7103,11,4,6,12,16,38,-22,18
Brondby,7104,1,21,7,2,73,30,43,70
FC Midtjylla,7104,2,19,6,5,60,34,26,63
FC Nords,7104,3,14,7,9,72,50,22,49
Copenhagen,7104,4,12,8,10,55,45,10,44
AaB,7104,5,7,12,11,37,47,-10,33
AC Horsens,7104,6,6,14,10,34,51,-17,32
Sonderjyske,7104,7,8,6,10,28,29,-1,30
Lyngby,7104,8,4,9,11,28,44,-16,21
Silkeborg IF,7104,8,6,3,13,28,44,-16,21
Randers FC,7104,10,5,6,13,23,41,-18,21
AGF Aarhus,7104,11,4,6,12,16,39,-23,18
Brondby,7105,1,21,5,4,75,36,39,68
FC Midtjylla,7105,2,18,6,6,60,38,22,60
FC Nords,7105,3,15,8,7,74,48,26,53
Copenhagen,7105,4,12,8,10,56,44,12,44
AC Horsens,7105,5,7,13,10,42,58,-16,34
AaB,7105,6,7,12,11,33,42,-9,33
Sonderjyske,7105,7,8,6,10,28,29,-1,30
Randers FC,7105,8,6,6,12,24,39,-15,24
Silkeborg IF,7105,9,6,3,13,26,44,-18,21
Lyngby,7105,10,3,9,12,26,45,-19,18
AGF Aarhus,7105,11,4,6,12,16,37,-21,18
Brondby,7106,1,21,7,2,72,30,42,70
FC Midtjylla,7106,2,20,4,6,67,39,28,64
Copenhagen,7106,3,14,6,10,56,40,16,48
FC Nords,7106,4,13,7,10,73,56,17,46
AaB,7106,5,8,13,9,37,39,-2,37
Sonderjyske,7106,6,8,6,10,28,29,-1,30
AC Horsens,7106,7,5,13,12,32,59,-27,28
Randers FC,7106,8,5,7,12,24,40,-16,22
Silkeborg IF,7106,9,6,3,13,26,44,-18,21
Lyngby,7106,10,3,10,11,27,45,-18,19
AGF Aarhus,7106,11,4,6,12,16,37,-21,18
Brondby,7107,1,21,7,2,70,32,38,70
FC Midtjylla,7107,2,20,4,6,68,40,28,64
FC Nords,7107,3,14,6,10,76,53,23,48
Copenhagen,7107,4,14,4,12,56,49,7,46
AaB,7107,5,7,13,10,38,45,-7,34
AC Horsens,7107,6,6,14,10,40,55,-15,32
Sonderjyske,7107,7,8,6,10,28,29,-1,30
Lyngby,7107,8,4,9,11,28,45,-17,21
Randers FC,7107,9,5,6,13,24,41,-17,21
AGF Aarhus,7107,10,5,6,11,17,36,-19,21
Silkeborg IF,7107,11,5,3,14,25,45,-20,18
Brondby,7108,1,19,7,4,68,34,34,64
FC Midtjylla,7108,2,18,7,5,66,40,26,61
FC Nords,7108,3,15,6,9,73,48,25,51
Copenhagen,7108,4,13,6,11,59,47,12,45
AaB,7108,5,9,12,9,41,44,-3,39
AC Horsens,7108,6,6,14,10,34,54,-20,32
Sonderjyske,7108,7,8,6,10,28,29,-1,30
Lyngby,7108,8,4,9,11,27,44,-17,21
Randers FC,7108,9,5,6,13,23,40,-17,21
Silkeborg IF,7108,10,5,4,13,25,44,-19,19
AGF Aarhus,7108,11,4,7,11,16,36,-20,19
Brondby,7109,1,21,6,3,75,33,42,69
FC Midtjylla,7109,2,19,5,6,66,43,23,62
FC Nords,7109,3,15,7,8,72,47,25,52
Copenhagen,7109,4,14,5,11,57,44,13,47
AaB,7109,5,8,11,11,35,42,-7,35
Sonderjyske,7109,6,8,6,10,28,29,-1,30
AC Horsens,7109,7,5,14,11,30,52,-22,29
Randers FC,7109,8,5,7,12,23,39,-16,22
AGF Aarhus,7109,9,5,6,11,18,37,-19,21
Lyngby,7109,10,3,10,11,26,44,-18,19
Silkeborg IF,7109,11,5,3,14,26,46,-20,18
Brondby,7110,1,22,5,3,70,29,41,71
FC Midtjylla,7110,2,18,6,6,65,42,23,60
FC Nords,7110,3,13,7,10,75,54,21,46
Copenhagen,7110,4,13,4,13,54,47,7,43
AaB,7110,5,9,12,9,40,43,-3,39
AC Horsens,7110,6,8,12,10,37,52,-15,36
Sonderjyske,7110,7,8,6,10,28,29,-1,30
Lyngby,7110,8,4,9,11,30,46,-16,21
Randers FC,7110,9,5,6,13,25,43,-18,21
AGF Aarhus,7110,10,5,6,11,17,36,-19,21
Silkeborg IF,7110,11,5,3,14,25,45,-20,18
Brondby,7111,1,20,6,4,73,36,37,66
FC Midtjylla,7111,2,18,7,5,62,38,24,61
FC Nords,7111,3,16,7,7,73,45,28,55
Copenhagen,7111,4,14,4,12,60,46,14,46
AaB,7111,5,8,12,10,39,47,-8,36
Sonderjyske,7111,6,8,6,10,28,29,-1,30
AC Horsens,7111,7,6,12,12,36,57,-21,30
Randers FC,7111,8,5,7,12,24,40,-16,22
AGF Aarhus,7111,9,5,6,11,19,37,-18,21
Lyngby,7111,10,3,10,11,27,45,-18,19
Silkeborg IF,7111,11,5,3,14,26,47,-21,18
FC Midtjylla,7112,1,20,5,5,63,38,25,65
Brondby,7112,2,18,7,5,68,37,31,61
Copenhagen,7112,3,16,5,9,62,41,21,53
FC Nords,7112,4,13,7,10,70,53,17,46
AaB,7112,5,7,13,10,36,41,-5,34
AC Horsens,7112,6,6,15,9,36,51,-15,33
Sonderjyske,7112,7,8,6,10,28,29,-1,30
Lyngby,7112,8,4,9,11,28,45,-17,21
Silkeborg IF,7112,8,6,3,13,28,45,-17,21
Randers FC,7112,10,5,6,13,24,41,-17,21
AGF Aarhus,7112,11,4,6,12,17,39,-22,18
Brondby,7113,1,21,5,4,69,32,37,68
FC Midtjylla,7113,2,20,6,4,66,38,28,66
FC Nords,7113,3,13,9,8,72,53,19,48
Copenhagen,7113,4,13,6,11,58,45,13,45
AaB,7113,5,7,12,11,36,42,-6,33
AC Horsens,7113,6,6,14,10,36,53,-17,32
Sonderjyske,7113,7,8,6,10,28,29,-1,30
Randers FC,7113,8,6,6,12,24,39,-15,24
Silkeborg IF,7113,9,5,4,13,27,46,-19,19
AGF Aarhus,7113,10,4,7,11,18,38,-20,19
Lyngby,7113,11,3,9,12,26,45,-19,18
Brondby,7114,1,21,7,2,72,30,42,70
FC Midtjylla,7114,2,19,6,5,67,42,25,63
FC Nords,7114,3,13,9,8,74,51,23,48
Copenhagen,7114,4,13,5,12,53,47,6,44
AaB,7114,5,7,12,11,36,42,-6,33
AC Horsens,7114,6,6,15,9,34,50,-16,33
Sonderjyske,7114,7,8,6,10,28,29,-1,30
Randers FC,7114,8,5,7,12,23,39,-16,22
Lyngby,7114,9,3,10,11,26,44,-18,19
Silkeborg IF,7114,10,5,4,13,26,45,-19,19
AGF Aarhus,7114,11,4,7,11,17,37,-20,19
Brondby,7115,1,22,5,3,72,34,38,71
FC Midtjylla,7115,2,19,6,5,65,39,26,63
FC Nords,7115,3,15,7,8,73,49,24,52
Copenhagen,7115,4,14,6,10,63,47,16,48
AC Horsens,7115,5,6,13,11,34,53,-19,31
Sonderjyske,7115,6,8,6,10,28,29,-1,30
AaB,7115,7,6,11,13,36,47,-11,29
Randers FC,7115,8,5,7,12,23,39,-16,22
Lyngby,7115,9,3,10,11,26,44,-18,19
Silkeborg IF,7115,10,5,4,13,27,46,-19,19
AGF Aarhus,7115,11,4,7,11,18,38,-20,19
Brondby,7116,1,20,7,3,71,32,39,67
FC Midtjylla,7116,2,19,6,5,63,37,26,63
Copenhagen,7116,3,14,6,10,55,41,14,48
FC Nords,7116,4,13,8,9,70,51,19,47
AaB,7116,5,6,15,9,35,42,-7,33
AC Horsens,7116,6,6,14,10,35,52,-17,32
Sonderjyske,7116,7,8,6,10,28,29,-1,30
Lyngby,7116,8,4,9,11,28,44,-16,21
Silkeborg IF,7116,9,6,3,13,29,46,-17,21
Randers FC,7116,10,5,6,13,23,41,-18,21
AGF Aarhus,7116,11,4,6,12,18,40,-22,18
Brondby,7117,1,21,5,4,71,36,35,68
FC Midtjylla,7117,2,20,4,6,66,39,27,64
FC Nords,7117,3,16,6,8,79,49,30,54
Copenhagen,7117,4,14,5,11,62,48,14,47
AaB,7117,5,7,12,11,36,44,-8,33
Sonderjyske,7117,6,8,6,10,28,29,-1,30
AC Horsens,7117,7,5,14,11,36,60,-24,29
Randers FC,7117,8,5,7,12,24,40,-16,22
AGF Aarhus,7117,9,5,6,11,18,37,-19,21
Lyngby,7117,10,3,10,11,27,45,-18,19
Silkeborg IF,7117,11,5,3,14,26,46,-20,18
FC Midtjylla,7118,1,20,6,4,67,39,28,66
Brondby,7118,2,19,7,4,67,36,31,64
Copenhagen,7118,3,15,4,11,60,45,15,49
FC Nords,7118,4,13,8,9,72,52,20,47
AaB,7118,5,7,13,10,37,42,-5,34
AC Horsens,7118,6,6,14,10,35,50,-15,32
Sonderjyske,7118,7,8,6,10,28,29,-1,30
Lyngby,7118,8,4,9,11,28,45,-17,21
Randers FC,7118,9,5,6,13,24,41,-17,21
Silkeborg IF,7118,10,6,3,13,26,44,-18,21
AGF Aarhus,7118,11,4,6,12,16,37,-21,18
Brondby,7119,1,20,7,3,73,36,37,67
FC Midtjylla,7119,2,19,6,5,65,37,28,63
FC Nords,7119,3,14,8,8,76,52,24,50
Copenhagen,7119,4,12,6,12,58,52,6,42
AC Horsens,7119,5,8,13,9,38,50,-12,37
AaB,7119,6,7,12,11,37,46,-9,33
Sonderjyske,7119,7,8,6,10,28,29,-1,30
Lyngby,7119,8,4,9,11,30,44,-14,21
AGF Aarhus,7119,9,5,6,11,19,36,-17,21
Randers FC,7119,10,5,6,13,23,43,-20,21
Silkeborg IF,7119,11,5,3,14,25,47,-22,18
Brondby,7120,1,22,5,3,75,34,41,71
FC Midtjylla,7120,2,19,4,7,65,43,22,61
FC Nords,7120,3,14,7,9,77,52,25,49
Copenhagen,7120,4,15,4,11,59,42,17,49
AaB,7120,5,8,12,10,36,41,-5,36
Sonderjyske,7120,6,8,6,10,28,29,-1,30
AC Horsens,7120,7,6,12,12,34,60,-26,30
Lyngby,7120,8,4,9,11,29,45,-16,21
Randers FC,7120,9,5,6,13,24,42,-18,21
AGF Aarhus,7120,10,5,6,11,17,36,-19,21
Silkeborg IF,7120,11,5,3,14,25,45,-20,18
Brondby,7121,1,21,6,3,72,34,38,69
FC Midtjylla,7121,2,18,5,7,64,41,23,59
Copenhagen,7121,3,17,4,9,60,40,20,55
FC Nords,7121,4,13,8,9,71,50,21,47
AaB,7121,5,8,12,10,34,40,-6,36
Sonderjyske,7121,6,8,6,10,28,29,-1,30
AC Horsens,7121,7,5,13,12,33,55,-22,28
Lyngby,7121,8,4,9,11,30,45,-15,21
Randers FC,7121,9,5,6,13,24,43,-19,21
AGF Aarhus,7121,10,5,6,11,18,37,-19,21
Silkeborg IF,7121,11,5,3,14,26,46,-20,18
FC Midtjylla,7122,1,21,5,4,68,36,32,68
Brondby,7122,2,20,6,4,68,32,36,66
FC Nords,7122,3,14,7,9,70,48,22,49
Copenhagen,7122,4,12,7,11,56,47,9,43
AaB,7122,5,8,12,10,38,42,-4,36
AC Horsens,7122,6,6,13,11,30,51,-21,31
Sonderjyske,7122,7,8,6,10,28,29,-1,30
Randers FC,7122,8,6,6,12,25,40,-15,24
Silkeborg IF,7122,9,6,3,13,28,44,-16,21
Lyngby,7122,10,3,9,12,27,46,-19,18
AGF Aarhus,7122,11,4,6,12,16,39,-23,18
Brondby,7123,1,20,5,5,70,36,34,65
FC Midtjylla,7123,2,20,4,6,68,40,28,64
Copenhagen,7123,3,15,5,10,61,42,19,50
FC Nords,7123,4,14,7,9,72,52,20,49
AC Horsens,7123,5,7,13,10,35,52,-17,34
AaB,7123,6,7,12,11,36,46,-10,33
Sonderjyske,7123,7,8,6,10,28,29,-1,30
Lyngby,7123,8,4,9,11,29,46,-17,21
Randers FC,7123,9,5,6,13,25,42,-17,21
AGF Aarhus,7123,10,5,6,11,18,36,-18,21
Silkeborg IF,7123,11,5,3,14,25,46,-21,18
Brondby,7124,1,21,5,4,66,30,36,68
FC Midtjylla,7124,2,19,5,6,63,40,23,62
Copenhagen,7124,3,15,5,10,65,46,19,50
FC Nords,7124,4,14,6,10,69,49,20,48
AaB,7124,5,7,13,10,38,42,-4,34
AC Horsens,7124,6,7,12,11,35,55,-20,33
Sonderjyske,7124,7,8,6,10,28,29,-1,30
Randers FC,7124,8,5,7,12,23,39,-16,22
AGF Aarhus,7124,9,5,6,11,19,37,-18,21
Lyngby,7124,10,3,10,11,26,44,-18,19
Silkeborg IF,7124,11,5,3,14,26,47,-21,18
Brondby,7125,1,21,6,3,73,34,39,69
FC Midtjylla,7125,2,20,5,5,68,43,25,65
FC Nords,7125,3,13,7,10,71,53,18,46
Copenhagen,7125,4,13,6,11,58,45,13,45
AaB,7125,5,8,12,10,40,42,-2,36
AC Horsens,7125,6,6,14,10,34,53,-19,32
Sonderjyske,7125,7,8,6,10,28,29,-1,30
Randers FC,7125,8,6,6,12,25,40,-15,24
AGF Aarhus,7125,9,5,6,11,17,36,-19,21
Lyngby,7125,10,3,9,12,27,46,-19,18
Silkeborg IF,7125,11,5,3,14,25,45,-20,18
Brondby,7126,1,21,7,2,72,33,39,70
FC Midtjylla,7126,2,19,5,6,69,42,27,62
FC Nords,7126,3,14,6,10,72,53,19,48
Copenhagen,7126,4,14,5,11,59,46,13,47
AC Horsens,7126,5,7,13,10,36,51,-15,34
AaB,7126,6,7,12,11,37,46,-9,33
Sonderjyske,7126,7,8,6,10,28,29,-1,30
Randers FC,7126,8,5,7,12,25,41,-16,22
Lyngby,7126,9,3,10,11,28,46,-18,19
Silkeborg IF,7126,10,5,4,13,27,46,-19,19
AGF Aarhus,7126,11,4,7,11,18,38,-20,19
Brondby,7127,1,19,8,3,69,34,35,65
FC Midtjylla,7127,2,20,5,5,65,37,28,65
FC Nords,7127,3,15,7,8,71,49,22,52
Copenhagen,7127,4,14,6,10,60,43,17,48
AC Horsens,7127,5,7,12,11,36,55,-19,33
Sonderjyske,7127,6,8,6,10,28,29,-1,30
AaB,7127,7,6,12,12,34,43,-9,30
Randers FC,7127,8,5,7,12,26,42,-16,22
Silkeborg IF,7127,9,6,3,13,29,46,-17,21
Lyngby,7127,10,3,10,11,29,47,-18,19
AGF Aarhus,7127,11,4,6,12,18,40,-22,18
Brondby,7128,1,20,8,2,71,28,43,68
FC Midtjylla,7128,2,19,5,6,64,39,25,62
Copenhagen,7128,3,14,5,11,56,43,13,47
FC Nords,7128,4,13,7,10,69,56,13,46
AaB,7128,5,9,11,10,42,45,-3,38
AC Horsens,7128,6,6,14,10,36,53,-17,32
Sonderjyske,7128,7,8,6,10,28,29,-1,30
Randers FC,7128,8,5,7,12,24,40,-16,22
Lyngby,7128,9,3,10,11,27,45,-18,19
Silkeborg IF,7128,10,5,4,13,27,46,-19,19
AGF Aarhus,7128,11,4,7,11,18,38,-20,19
Brondby,7129,1,21,6,3,77,31,46,69
FC Midtjylla,7129,2,20,4,6,61,40,21,64
Copenhagen,7129,3,15,4,11,60,45,15,49
FC Nords,7129,4,12,7,11,70,56,14,43
AaB,7129,5,8,11,11,39,49,-10,35
AC Horsens,7129,6,7,14,9,38,50,-12,35
Sonderjyske,7129,7,8,6,10,28,29,-1,30
Randers FC,7129,8,5,7,12,24,40,-16,22
Lyngby,7129,9,3,10,11,27,45,-18,19
Silkeborg IF,7129,10,5,4,13,28,47,-19,19
AGF Aarhus,7129,11,4,7,11,19,39,-20,19
Brondby,7130,1,22,6,2,75,31,44,72
FC Midtjylla,7130,2,19,5,6,65,41,24,62
FC Nords,7130,3,16,7,7,78,48,30,55
Copenhagen,7130,4,12,4,14,55,49,6,40
AaB,7130,5,8,12,10,36,43,-7,36
Sonderjyske,7130,6,8,6,10,28,29,-1,30
AC Horsens,7130,7,6,12,12,32,55,-23,30
Lyngby,7130,8,4,9,11,30,44,-14,21
Silkeborg IF,7130,9,6,3,13,26,44,-18,21
Randers FC,7130,10,5,6,13,23,43,-20,21
AGF Aarhus,7130,11,4,6,12,16,37,-21,18
Brondby,7131,1,21,6,3,71,35,36,69
FC Midtjylla,7131,2,19,6,5,63,37,26,63
FC Nords,7131,3,14,8,8,77,50,27,50
Copenhagen,7131,4,13,6,11,58,43,15,45
AaB,7131,5,8,12,10,36,42,-6,36
Sonderjyske,7131,6,8,6,10,28,29,-1,30
AC Horsens,7131,7,6,12,12,35,59,-24,30
Lyngby,7131,8,4,9,11,29,46,-17,21
Randers FC,7131,9,5,6,13,25,42,-17,21
Silkeborg IF,7131,10,5,4,13,25,44,-19,19
AGF Aarhus,7131,11,4,7,11,16,36,-20,19
Brondby,7132,1,21,5,4,73,34,39,68
FC Midtjylla,7132,2,18,6,6,63,41,22,60
Copenhagen,7132,3,17,4,9,63,42,21,55
FC Nords,7132,4,14,7,9,74,54,20,49
AaB,7132,5,6,13,11,34,43,-9,31
Sonderjyske,7132,6,8,6,10,28,29,-1,30
AC Horsens,7132,7,5,15,10,35,54,-19,30
Randers FC,7132,8,6,6,12,25,40,-15,24
AGF Aarhus,7132,9,5,6,11,19,36,-17,21
Lyngby,7132,10,3,9,12,27,46,-19,18
Silkeborg IF,7132,11,5,3,14,25,47,-22,18
Brondby,7133,1,21,6,3,70,31,39,69
FC Midtjylla,7133,2,18,7,5,64,39,25,61
FC Nords,7133,3,15,6,9,76,51,25,51
Copenhagen,7133,4,14,6,10,57,46,11,48
AaB,7133,5,7,12,11,36,44,-8,33
AC Horsens,7133,6,6,13,11,37,55,-18,31
Sonderjyske,7133,7,8,6,10,28,29,-1,30
Randers FC,7133,8,6,6,12,24,39,-15,24
Silkeborg IF,7133,9,6,3,13,28,46,-18,21
Lyngby,7133,10,3,9,12,26,45,-19,18
AGF Aarhus,7133,11,4,6,12,18,39,-21,18
Brondby,7134,1,22,6,2,72,33,39,72
FC Midtjylla,7134,2,19,6,5,68,41,27,63
FC Nords,7134,3,13,9,8,79,52,27,48
Copenhagen,7134,4,13,5,12,54,50,4,44
AaB,7134,5,8,13,9,38,41,-3,37
Sonderjyske,7134,6,8,6,10,28,29,-1,30
AC Horsens,7134,7,5,13,12,34,54,-20,28
Randers FC,7134,8,5,7,12,24,40,-16,22
Lyngby,7134,9,3,10,11,27,45,-18,19
Silkeborg IF,7134,10,5,4,13,26,45,-19,19
AGF Aarhus,7134,11,4,7,11,17,37,-20,19
Brondby,7135,1,22,5,3,76,33,43,71
FC Midtjylla,7135,2,20,4,6,61,36,25,64
FC Nords,7135,3,14,7,9,73,56,17,49
Copenhagen,7135,4,13,5,12,56,45,11,44
AaB,7135,5,9,11,10,42,44,-2,38
Sonderjyske,7135,6,8,6,10,28,29,-1,30
AC Horsens,7135,7,6,12,12,37,57,-20,30
Lyngby,7135,8,4,9,11,29,45,-16,21
Silkeborg IF,7135,9,6,3,13,26,44,-18,21
Randers FC,7135,10,5,6,13,24,42,-18,21
AGF Aarhus,7135,11,4,6,12,16,37,-21,18
Brondby,7136,1,21,5,4,71,36,35,68
FC Midtjylla,7136,2,20,5,5,64,34,30,65
FC Nords,7136,3,15,6,9,76,52,24,51
Copenhagen,7136,4,15,4,11,59,43,16,49
AaB,7136,5,7,12,11,37,45,-8,33
Sonderjyske,7136,6,8,6,10,28,29,-1,30
AC Horsens,7136,7,5,14,11,30,53,-23,29
Lyngby,7136,8,4,9,11,28,44,-16,21
Silkeborg IF,7136,9,6,3,13,26,44,-18,21
Randers FC,7136,10,5,6,13,23,41,-18,21
AGF Aarhus,7136,11,4,6,12,16,37,-21,18
Brondby,7137,1,21,6,3,70,28,42,69
FC Midtjylla,7137,2,19,5,6,62,37,25,62
FC Nords,7137,3,16,6,8,75,49,26,54
Copenhagen,7137,4,14,4,12,53,43,10,46
AC Horsens,7137,5,8,12,10,38,53,-15,36
Sonderjyske,7137,6,8,6,10,28,29,-1,30
AaB,7137,7,6,11,13,32,46,-14,29
Lyngby,7137,8,4,9,11,30,44,-14,21
Silkeborg IF,7137,9,6,3,13,26,44,-18,21
Randers FC,7137,10,5,6,13,23,43,-20,21
AGF Aarhus,7137,11,4,6,12,16,37,-21,18
Brondby,7138,1,21,5,4,71,32,39,68
FC Midtjylla,7138,2,20,4,6,72,41,31,64
FC Nords,7138,3,14,7,9,74,56,18,49
Copenhagen,7138,4,13,7,10,59,47,12,46
AaB,7138,5,8,12,10,38,43,-5,36
AC Horsens,7138,6,6,13,11,35,56,-21,31
Sonderjyske,7138,7,8,6,10,28,29,-1,30
Lyngby,7138,8,4,9,11,28,45,-17,21
Randers FC,7138,9,5,6,13,24,41,-17,21
Silkeborg IF,7138,10,5,4,13,26,45,-19,19
AGF Aarhus,7138,11,4,7,11,17,37,-20,19
Brondby,7139,1,21,6,3,77,35,42,69
FC Midtjylla,7139,2,18,7,5,63,40,23,61
FC Nords,7139,3,13,9,8,70,54,16,48
Copenhagen,7139,4,12,6,12,52,42,10,42
AC Horsens,7139,5,8,13,9,39,51,-12,37
AaB,7139,6,7,13,10,39,44,-5,34
Sonderjyske,7139,7,8,6,10,28,29,-1,30
Lyngby,7139,8,4,9,11,27,44,-17,21
Randers FC,7139,9,5,6,13,23,40,-17,21
Silkeborg IF,7139,10,5,4,13,25,44,-19,19
AGF Aarhus,7139,11,4,7,11,16,36,-20,19
Brondby,7140,1,21,6,3,75,31,44,69
FC Midtjylla,7140,2,18,5,7,64,40,24,59
FC Nords,7140,3,15,7,8,78,56,22,52
Copenhagen,7140,4,16,4,10,57,43,14,52
AC Horsens,7140,5,7,12,11,36,50,-14,33
Sonderjyske,7140,6,8,6,10,28,29,-1,30
AaB,7140,7,6,12,12,33,49,-16,30
Lyngby,7140,8,4,9,11,28,45,-17,21
Randers FC,7140,9,5,6,13,24,41,-17,21
Silkeborg IF,7140,10,6,3,13,26,44,-18,21
AGF Aarhus,7140,11,4,6,12,16,37,-21,18
Brondby,7141,1,22,6,2,70,30,40,72
FC Midtjylla,7141,2,20,4,6,69,36,33,64
FC Nords,7141,3,15,6,9,72,53,19,51
Copenhagen,7141,4,13,6,11,60,49,11,45
AC Horsens,7141,5,6,14,10,37,55,-18,32
Sonderjyske,7141,6,8,6,10,28,29,-1,30
AaB,7141,7,6,12,12,36,47,-11,30
Randers FC,7141,8,6,6,12,25,39,-14,24
AGF Aarhus,7141,9,5,6,11,18,36,-18,21
Lyngby,7141,10,3,9,12,26,46,-20,18
Silkeborg IF,7141,11,5,3,14,25,46,-21,18
Brondby,7142,1,21,5,4,70,30,40,68
FC Midtjylla,7142,2,21,4,5,69,37,32,67
FC Nords,7142,3,13,7,10,70,51,19,46
Copenhagen,7142,4,13,6,11,55,44,11,45
AaB,7142,5,8,11,11,38,51,-13,35
AC Horsens,7142,6,7,13,10,36,51,-15,34
Sonderjyske,7142,7,8,6,10,28,29,-1,30
Randers FC,7142,8,6,6,12,26,41,-15,24
Silkeborg IF,7142,9,6,3,13,27,44,-17,21
Lyngby,7142,10,3,9,12,28,47,-19,18
AGF Aarhus,7142,11,4,6,12,16,38,-22,18
Brondby,7143,1,23,5,2,72,30,42,74
FC Midtjylla,7143,2,20,5,5,71,39,32,65
Copenhagen,7143,3,14,6,10,59,43,16,48
FC Nords,7143,4,13,7,10,72,53,19,46
AaB,7143,5,7,11,12,36,44,-8,32
Sonderjyske,7143,6,8,6,10,28,29,-1,30
AC Horsens,7143,7,6,12,12,35,62,-27,30
Lyngby,7143,8,4,9,11,28,44,-16,21
Randers FC,7143,9,5,6,13,23,41,-18,21
AGF Aarhus,7143,10,5,6,11,18,37,-19,21
Silkeborg IF,7143,11,5,3,14,26,46,-20,18
Brondby,7144,1,21,5,4,69,32,37,68
FC Midtjylla,7144,2,21,4,5,75,41,34,67
FC Nords,7144,3,15,6,9,77,52,25,51
Copenhagen,7144,4,14,4,12,57,53,4,46
AC Horsens,7144,5,7,12,11,36,54,-18,33
AaB,7144,6,7,11,12,36,44,-8,32
Sonderjyske,7144,7,8,6,10,28,29,-1,30
Randers FC,7144,8,6,6,12,26,41,-15,24
Silkeborg IF,7144,9,6,3,13,27,44,-17,21
Lyngby,7144,10,3,9,12,28,47,-19,18
AGF Aarhus,7144,11,4,6,12,16,38,-22,18
Brondby,7145,1,21,6,3,74,31,43,69
FC Midtjylla,7145,2,21,4,5,67,42,25,67
FC Nords,7145,3,14,6,10,70,52,18,48
Copenhagen,7145,4,13,6,11,54,41,13,45
AaB,7145,5,7,14,9,35,39,-4,35
Sonderjyske,7145,6,8,6,10,28,29,-1,30
AC Horsens,7145,7,5,14,11,35,56,-21,29
Randers FC,7145,8,5,7,12,26,42,-16,22
Silkeborg IF,7145,9,6,3,13,28,45,-17,21
Lyngby,7145,10,3,10,11,29,47,-18,19
AGF Aarhus,7145,11,4,6,12,17,39,-22,18
Brondby,7146,1,22,6,2,72,30,42,72
FC Midtjylla,7146,2,20,4,6,67,42,25,64
FC Nords,7146,3,15,7,8,79,51,28,52
Copenhagen,7146,4,12,5,13,55,48,7,41
AaB,7146,5,6,15,9,37,43,-6,33
AC Horsens,7146,6,6,13,11,34,56,-22,31
Sonderjyske,7146,7,8,6,10,28,29,-1,30
Lyngby,7146,8,4,9,11,28,44,-16,21
Silkeborg IF,7146,9,6,3,13,26,44,-18,21
Randers FC,7146,10,5,6,13,23,41,-18,21
AGF Aarhus,7146,11,4,6,12,16,37,-21,18
Brondby,7147,1,18,9,3,66,33,33,63
FC Midtjylla,7147,2,19,6,5,65,44,21,63
FC Nords,7147,3,15,7,8,76,49,27,52
Copenhagen,7147,4,12,7,11,55,46,9,43
AaB,7147,5,8,12,10,39,42,-3,36
AC Horsens,7147,6,7,13,10,35,48,-13,34
Sonderjyske,7147,7,8,6,10,28,29,-1,30
Randers FC,7147,8,6,6,12,25,40,-15,24
Silkeborg IF,7147,9,6,3,13,31,45,-14,21
Lyngby,7147,10,3,9,12,27,46,-19,18
AGF Aarhus,7147,11,4,6,12,17,42,-25,18
Brondby,7148,1,20,7,3,69,33,36,67
FC Midtjylla,7148,2,19,6,5,63,33,30,63
FC Nords,7148,3,12,9,9,69,52,17,45
Copenhagen,7148,4,13,6,11,56,44,12,45
AC Horsens,7148,5,7,15,8,34,47,-13,36
AaB,7148,6,7,13,10,37,45,-8,34
Sonderjyske,7148,7,8,6,10,28,29,-1,30
Silkeborg IF,7148,8,6,3,13,28,45,-17,21
Lyngby,7148,9,4,9,11,27,44,-17,21
Randers FC,7148,10,5,6,13,23,40,-17,21
AGF Aarhus,7148,11,4,6,12,17,39,-22,18
Brondby,7149,1,22,5,3,77,33,44,71
FC Midtjylla,7149,2,19,6,5,64,38,26,63
Copenhagen,7149,3,14,6,10,58,45,13,48
FC Nords,7149,4,13,8,9,71,57,14,47
AaB,7149,5,8,11,11,39,45,-6,35
Sonderjyske,7149,6,8,6,10,28,29,-1,30
AC Horsens,7149,7,6,12,12,33,50,-17,30
Randers FC,7149,8,5,7,12,24,40,-16,22
AGF Aarhus,7149,9,5,6,11,17,36,-19,21
Lyngby,7149,10,3,10,11,27,45,-18,19
Silkeborg IF,7149,11,5,3,14,25,45,-20,18
Brondby,7150,1,21,6,3,69,30,39,69
FC Midtjylla,7150,2,19,5,6,64,40,24,62
FC Nords,7150,3,13,8,9,71,54,17,47
Copenhagen,7150,4,13,5,12,56,45,11,44
AC Horsens,7150,5,8,13,9,38,47,-9,37
AaB,7150,6,8,11,11,35,43,-8,35
Sonderjyske,7150,7,8,6,10,28,29,-1,30
Randers FC,7150,8,6,6,12,24,39,-15,24
Silkeborg IF,7150,9,5,4,13,26,45,-19,19
AGF Aarhus,7150,10,4,7,11,17,37,-20,19
Lyngby,7150,11,3,9,12,26,45,-19,18
Brondby,7151,1,22,5,3,76,31,45,71
FC Midtjylla,7151,2,20,4,6,64,41,23,64
FC Nords,7151,3,14,7,9,73,53,20,49
Copenhagen,7151,4,14,4,12,59,49,10,46
AaB,7151,5,8,12,10,42,44,-2,36
Sonderjyske,7151,6,8,6,10,28,29,-1,30
AC Horsens,7151,7,5,14,11,34,56,-22,29
Lyngby,7151,8,4,9,11,29,44,-15,21
Randers FC,7151,9,5,6,13,23,42,-19,21
AGF Aarhus,7151,10,5,6,11,18,37,-19,21
Silkeborg IF,7151,11,5,3,14,26,46,-20,18
Brondby,7152,1,19,8,3,67,31,36,65
FC Midtjylla,7152,2,19,4,7,64,42,22,61
Copenhagen,7152,3,15,6,9,58,42,16,51
FC Nords,7152,4,14,7,9,73,53,20,49
AaB,7152,5,7,13,10,36,40,-4,34
AC Horsens,7152,6,5,16,9,34,50,-16,31
Sonderjyske,7152,7,8,6,10,28,29,-1,30
Randers FC,7152,8,5,7,12,24,40,-16,22
Silkeborg IF,7152,9,6,3,13,29,45,-16,21
Lyngby,7152,10,3,10,11,27,45,-18,19
AGF Aarhus,7152,11,4,6,12,17,40,-23,18
FC Midtjylla,7153,1,21,4,5,70,37,33,67
Brondby,7153,2,19,6,5,71,37,34,63
Copenhagen,7153,3,16,4,10,58,41,17,52
FC Nords,7153,4,13,7,10,67,55,12,46
AaB,7153,5,8,12,10,37,42,-5,36
AC Horsens,7153,6,6,13,11,36,53,-17,31
Sonderjyske,7153,7,8,6,10,28,29,-1,30
Randers FC,7153,8,6,6,12,24,39,-15,24
Silkeborg IF,7153,9,6,3,13,27,45,-18,21
Lyngby,7153,10,3,9,12,26,45,-19,18
AGF Aarhus,7153,11,4,6,12,17,38,-21,18
Brondby,7154,1,22,6,2,74,32,42,72
FC Midtjylla,7154,2,19,6,5,64,38,26,63
Copenhagen,7154,3,14,5,11,58,43,15,47
FC Nords,7154,4,13,7,10,71,53,18,46
AC Horsens,7154,5,7,13,10,34,49,-15,34
AaB,7154,6,7,11,12,34,46,-12,32
Sonderjyske,7154,7,8,6,10,28,29,-1,30
Randers FC,7154,8,6,6,12,25,39,-14,24
Silkeborg IF,7154,9,6,3,13,28,46,-18,21
Lyngby,7154,10,3,9,12,26,46,-20,18
AGF Aarhus,7154,11,4,6,12,18,39,-21,18
Brondby,7155,1,21,7,2,72,31,41,70
FC Midtjylla,7155,2,19,5,6,64,37,27,62
FC Nords,7155,3,15,6,9,73,50,23,51
Copenhagen,7155,4,15,5,10,60,45,15,50
AaB,7155,5,8,11,11,35,45,-10,35
Sonderjyske,7155,6,8,6,10,28,29,-1,30
AC Horsens,7155,7,5,12,13,34,56,-22,27
Randers FC,7155,8,6,6,12,25,40,-15,24
Silkeborg IF,7155,9,5,4,13,25,44,-19,19
AGF Aarhus,7155,10,4,7,11,16,36,-20,19
Lyngby,7155,11,3,9,12,27,46,-19,18
Brondby,7156,1,21,7,2,70,30,40,70
FC Midtjylla,7156,2,19,5,6,65,38,27,62
Copenhagen,7156,3,15,4,11,58,43,15,49
FC Nords,7156,4,13,6,11,68,54,14,45
AaB,7156,5,8,13,9,36,39,-3,37
AC Horsens,7156,6,6,13,11,35,54,-19,31
Sonderjyske,7156,7,8,6,10,28,29,-1,30
Randers FC,7156,8,5,7,12,24,40,-16,22
Lyngby,7156,9,3,10,11,27,45,-18,19
Silkeborg IF,7156,10,5,4,13,27,46,-19,19
AGF Aarhus,7156,11,4,7,11,18,38,-20,19
Brondby,7157,1,20,7,3,70,34,36,67
FC Midtjylla,7157,2,19,6,5,69,45,24,63
FC Nords,7157,3,14,8,8,74,49,25,50
Copenhagen,7157,4,13,8,9,60,46,14,47
AaB,7157,5,7,11,12,36,43,-7,32
AC Horsens,7157,6,6,14,10,35,53,-18,32
Sonderjyske,7157,7,8,6,10,28,29,-1,30
Randers FC,7157,8,5,7,12,24,40,-16,22
Silkeborg IF,7157,9,6,3,13,27,45,-18,21
Lyngby,7157,10,3,10,11,27,45,-18,19
AGF Aarhus,7157,11,4,6,12,17,38,-21,18
Brondby,7158,1,21,6,3,74,33,41,69
FC Midtjylla,7158,2,19,5,6,69,42,27,62
Copenhagen,7158,3,16,4,10,62,44,18,52
FC Nords,7158,4,13,6,11,72,57,15,45
AaB,7158,5,8,13,9,39,45,-6,37
Sonderjyske,7158,6,8,6,10,28,29,-1,30
AC Horsens,7158,7,5,14,11,31,52,-21,29
Lyngby,7158,8,4,9,11,28,45,-17,21
Randers FC,7158,9,5,6,13,24,41,-17,21
AGF Aarhus,7158,10,5,6,11,19,37,-18,21
Silkeborg IF,7158,11,5,3,14,26,47,-21,18
Brondby,7159,1,20,7,3,69,31,38,67
FC Midtjylla,7159,2,19,4,7,63,38,25,61
FC Nords,7159,3,14,7,9,70,51,19,49
Copenhagen,7159,4,14,5,11,58,44,14,47
AaB,7159,5,9,11,10,36,38,-2,38
AC Horsens,7159,6,6,14,10,33,53,-20,32
Sonderjyske,7159,7,8,6,10,28,29,-1,30
Randers FC,7159,8,5,7,12,23,39,-16,22
AGF Aarhus,7159,9,5,6,11,17,36,-19,21
Lyngby,7159,10,3,10,11,26,44,-18,19
Silkeborg IF,7159,11,5,3,14,25,45,-20,18
FC Midtjylla,7160,1,19,7,4,65,36,29,64
Brondby,7160,2,19,5,6,66,37,29,62
FC Nords,7160,3,14,6,10,70,52,18,48
Copenhagen,7160,4,13,7,10,56,43,13,46
AaB,7160,5,8,14,8,36,37,-1,38
AC Horsens,7160,6,6,15,9,36,50,-14,33
Sonderjyske,7160,7,8,6,10,28,29,-1,30
Lyngby,7160,8,4,9,11,28,45,-17,21
Randers FC,7160,9,5,6,13,24,41,-17,21
AGF Aarhus,7160,10,5,6,11,19,37,-18,21
Silkeborg IF,7160,11,5,3,14,26,47,-21,18
Brondby,7161,1,22,6,2,70,29,41,72
FC Midtjylla,7161,2,18,7,5,64,40,24,61
FC Nords,7161,3,14,7,9,71,52,19,49
Copenhagen,7161,4,13,5,12,58,47,11,44
AaB,7161,5,8,14,8,39,39,0,38
Sonderjyske,7161,6,8,6,10,28,29,-1,30
AC Horsens,7161,7,5,13,12,32,53,-21,28
Randers FC,7161,8,6,6,12,26,39,-13,24
AGF Aarhus,7161,9,5,6,11,18,37,-19,21
Silkeborg IF,7161,10,5,3,14,26,46,-20,18
Lyngby,7161,11,3,9,12,26,47,-21,18
Brondby,7162,1,20,6,4,72,36,36,66
FC Midtjylla,7162,2,19,4,7,63,40,23,61
Copenhagen,7162,3,16,5,9,59,40,19,53
FC Nords,7162,4,15,6,9,77,53,24,51
AaB,7162,5,8,12,10,39,42,-3,36
Sonderjyske,7162,6,8,6,10,28,29,-1,30
AC Horsens,7162,7,5,13,12,35,60,-25,28
Lyngby,7162,8,4,9,11,29,44,-15,21
Silkeborg IF,7162,9,6,3,13,27,45,-18,21
Randers FC,7162,10,5,6,13,23,42,-19,21
AGF Aarhus,7162,11,4,6,12,17,38,-21,18
Brondby,7163,1,21,5,4,71,34,37,68
FC Midtjylla,7163,2,18,5,7,65,45,20,59
FC Nords,7163,3,14,7,9,81,57,24,49
Copenhagen,7163,4,13,5,12,54,45,9,44
AaB,7163,5,9,12,9,38,37,1,39
AC Horsens,7163,6,8,12,10,36,53,-17,36
Sonderjyske,7163,7,8,6,10,28,29,-1,30
Lyngby,7163,8,4,9,11,30,46,-16,21
Silkeborg IF,7163,9,6,3,13,28,45,-17,21
Randers FC,7163,10,5,6,13,25,43,-18,21
AGF Aarhus,7163,11,4,6,12,17,39,-22,18
Brondby,7164,1,21,6,3,69,31,38,69
FC Midtjylla,7164,2,18,6,6,63,41,22,60
FC Nords,7164,3,15,7,8,75,50,25,52
Copenhagen,7164,4,13,4,13,53,44,9,43
AaB,7164,5,7,14,9,39,42,-3,35
AC Horsens,7164,6,6,15,9,33,50,-17,33
Sonderjyske,7164,7,8,6,10,28,29,-1,30
Lyngby,7164,8,4,9,11,29,46,-17,21
Randers FC,7164,9,5,6,13,25,42,-17,21
Silkeborg IF,7164,10,6,3,13,26,44,-18,21
AGF Aarhus,7164,11,4,6,12,16,37,-21,18
FC Midtjylla,7165,1,20,6,4,68,39,29,66
Brondby,7165,2,19,6,5,71,38,33,63
FC Nords,7165,3,15,7,8,83,55,28,52
Copenhagen,7165,4,12,5,13,55,53,2,41
AC Horsens,7165,5,8,13,9,38,52,-14,37
AaB,7165,6,8,11,11,39,43,-4,35
Sonderjyske,7165,7,8,6,10,28,29,-1,30
Lyngby,7165,8,4,9,11,28,45,-17,21
Randers FC,7165,9,5,6,13,24,41,-17,21
AGF Aarhus,7165,10,5,6,11,18,37,-19,21
Silkeborg IF,7165,11,5,3,14,26,46,-20,18
Brondby,7166,1,22,6,2,74,30,44,72
FC Midtjylla,7166,2,19,6,5,65,35,30,63
FC Nords,7166,3,13,7,10,69,55,14,46
Copenhagen,7166,4,14,4,12,55,45,10,46
AaB,7166,5,7,13,10,37,40,-3,34
AC Horsens,7166,6,7,12,11,34,55,-21,33
Sonderjyske,7166,7,8,6,10,28,29,-1,30
Lyngby,7166,8,4,9,11,29,44,-15,21
Silkeborg IF,7166,9,6,3,13,28,46,-18,21
Randers FC,7166,10,5,6,13,23,42,-19,21
AGF Aarhus,7166,11,4,6,12,18,39,-21,18
Brondby,7167,1,22,5,3,70,31,39,71
FC Midtjylla,7167,2,19,4,7,65,41,24,61
FC Nords,7167,3,15,6,9,77,56,21,51
Copenhagen,7167,4,14,5,11,63,49,14,47
AC Horsens,7167,5,8,12,10,37,50,-13,36
Sonderjyske,7167,6,8,6,10,28,29,-1,30
AaB,7167,7,6,12,12,39,50,-11,30
Randers FC,7167,8,5,7,12,24,40,-16,22
Silkeborg IF,7167,9,6,3,13,28,44,-16,21
Lyngby,7167,10,3,10,11,27,45,-18,19
AGF Aarhus,7167,11,4,6,12,16,39,-23,18
Brondby,7168,1,20,7,3,70,32,38,67
FC Midtjylla,7168,2,19,6,5,60,34,26,63
FC Nords,7168,3,13,8,9,68,47,21,47
Copenhagen,7168,4,14,5,11,54,42,12,47
AaB,7168,5,8,13,9,37,39,-2,37
Sonderjyske,7168,6,8,6,10,28,29,-1,30
AC Horsens,7168,7,5,15,10,31,52,-21,30
Randers FC,7168,8,6,6,12,26,39,-13,24
Silkeborg IF,7168,9,5,4,13,26,45,-19,19
AGF Aarhus,7168,10,4,7,11,17,37,-20,19
Lyngby,7168,11,3,9,12,26,47,-21,18
Brondby,7169,1,23,5,2,76,29,47,74
FC Midtjylla,7169,2,20,4,6,65,39,26,64
FC Nords,7169,3,13,7,10,70,52,18,46
Copenhagen,7169,4,13,5,12,53,46,7,44
AaB,7169,5,9,11,10,40,40,0,38
Sonderjyske,7169,6,8,6,10,28,29,-1,30
AC Horsens,7169,7,6,12,12,33,57,-24,30
Randers FC,7169,8,6,6,12,26,41,-15,24
AGF Aarhus,7169,9,5,6,11,22,36,-14,21
Lyngby,7169,10,3,9,12,28,47,-19,18
Silkeborg IF,7169,11,5,3,14,25,50,-25,18
Brondby,7170,1,22,5,3,72,32,40,71
FC Midtjylla,7170,2,20,5,5,69,41,28,65
FC Nords,7170,3,14,8,8,71,49,22,50
Copenhagen,7170,4,12,5,13,54,46,8,41
AaB,7170,5,7,13,10,35,43,-8,34
AC Horsens,7170,6,6,14,10,34,50,-16,32
Sonderjyske,7170,7,8,6,10,28,29,-1,30
Lyngby,7170,8,4,9,11,29,45,-16,21
Silkeborg IF,7170,9,6,3,13,27,45,-18,21
Randers FC,7170,10,5,6,13,24,42,-18,21
AGF Aarhus,7170,11,4,6,12,17,38,-21,18
Brondby,7171,1,21,6,3,69,30,39,69
FC Midtjylla,7171,2,20,6,4,62,33,29,66
FC Nords,7171,3,13,8,9,74,57,17,47
Copenhagen,7171,4,13,4,13,55,46,9,43
AC Horsens,7171,5,7,14,9,36,50,-14,35
AaB,7171,6,7,12,11,39,45,-6,33
Sonderjyske,7171,7,8,6,10,28,29,-1,30
Randers FC,7171,8,6,6,12,24,39,-15,24
Silkeborg IF,7171,9,6,3,13,27,45,-18,21
Lyngby,7171,10,3,9,12,26,45,-19,18
AGF Aarhus,7171,11,4,6,12,17,38,-21,18
Brondby,7172,1,22,6,2,68,28,40,72
FC Midtjylla,7172,2,20,5,5,64,36,28,65
Copenhagen,7172,3,14,6,10,57,43,14,48
FC Nords,7172,4,13,7,10,76,54,22,46
AaB,7172,5,8,12,10,38,41,-3,36
Sonderjyske,7172,6,8,6,10,28,29,-1,30
AC Horsens,7172,7,5,12,13,31,58,-27,27
Randers FC,7172,8,5,7,12,25,41,-16,22
Silkeborg IF,7172,9,6,3,13,27,45,-18,21
Lyngby,7172,10,3,10,11,28,46,-18,19
AGF Aarhus,7172,11,4,6,12,17,38,-21,18
Brondby,7173,1,21,5,4,72,32,40,68
FC Midtjylla,7173,2,18,5,7,64,42,22,59
FC Nords,7173,3,13,9,8,71,53,18,48
Copenhagen,7173,4,14,5,11,58,42,16,47
AC Horsens,7173,5,8,13,9,37,47,-10,37
AaB,7173,6,7,13,10,36,48,-12,34
Sonderjyske,7173,7,8,6,10,28,29,-1,30
Randers FC,7173,8,6,6,12,26,40,-14,24
Silkeborg IF,7173,9,5,4,13,26,45,-19,19
AGF Aarhus,7173,10,4,7,11,17,37,-20,19
Lyngby,7173,11,3,9,12,27,47,-20,18
Brondby,7174,1,21,5,4,69,32,37,68
FC Midtjylla,7174,2,21,4,5,69,38,31,67
Copenhagen,7174,3,14,4,12,57,46,11,46
FC Nords,7174,4,13,6,11,74,58,16,45
AaB,7174,5,10,11,9,39,40,-1,41
Sonderjyske,7174,6,8,6,10,28,29,-1,30
AC Horsens,7174,7,6,12,12,40,60,-20,30
Randers FC,7174,8,6,6,12,26,40,-14,24
Silkeborg IF,7174,9,6,3,13,28,45,-17,21
Lyngby,7174,10,3,9,12,27,47,-20,18
AGF Aarhus,7174,11,4,6,12,17,39,-22,18
Brondby,7175,1,21,7,2,72,31,41,70
FC Midtjylla,7175,2,17,6,7,61,45,16,57
FC Nords,7175,3,15,6,9,79,50,29,51
Copenhagen,7175,4,14,5,11,57,44,13,47
AaB,7175,5,7,13,10,37,45,-8,34
AC Horsens,7175,6,7,13,10,36,53,-17,34
Sonderjyske,7175,7,8,6,10,28,29,-1,30
Randers FC,7175,8,6,6,12,25,40,-15,24
Silkeborg IF,7175,9,6,3,13,26,44,-18,21
Lyngby,7175,10,3,9,12,27,46,-19,18
AGF Aarhus,7175,11,4,6,12,16,37,-21,18
Brondby,7176,1,22,6,2,72,31,41,72
FC Midtjylla,7176,2,18,6,6,63,39,24,60
FC Nords,7176,3,13,7,10,70,53,17,46
Copenhagen,7176,4,13,5,12,55,43,12,44
AaB,7176,5,10,11,9,42,42,0,41
AC Horsens,7176,6,6,13,11,34,54,-20,31
Sonderjyske,7176,7,8,6,10,28,29,-1,30
Lyngby,7176,8,4,9,11,27,44,-17,21
Silkeborg IF,7176,8,6,3,13,27,44,-17,21
Randers FC,7176,10,5,6,13,23,40,-17,21
AGF Aarhus,7176,11,4,6,12,16,38,-22,18
Brondby,7177,1,21,6,3,70,31,39,69
FC Midtjylla,7177,2,20,4,6,72,44,28,64
FC Nords,7177,3,15,6,9,73,54,19,51
Copenhagen,7177,4,15,5,10,57,40,17,50
AaB,7177,5,6,14,10,40,47,-7,32
Sonderjyske,7177,6,8,6,10,28,29,-1,30
AC Horsens,7177,7,5,13,12,34,56,-22,28
Randers FC,7177,8,5,7,12,24,40,-16,22
Silkeborg IF,7177,9,6,3,13,28,45,-17,21
Lyngby,7177,10,3,10,11,27,45,-18,19
AGF Aarhus,7177,11,4,6,12,17,39,-22,18
Brondby,7178,1,21,6,3,75,32,43,69
FC Midtjylla,7178,2,19,5,6,64,39,25,62
Copenhagen,7178,3,14,6,10,55,43,12,48
FC Nords,7178,4,12,9,9,68,54,14,45
AC Horsens,7178,5,8,12,10,38,51,-13,36
AaB,7178,6,7,12,11,35,42,-7,33
Sonderjyske,7178,7,8,6,10,28,29,-1,30
Randers FC,7178,8,5,7,12,23,39,-16,22
Silkeborg IF,7178,9,6,3,13,26,44,-18,21
Lyngby,7178,10,3,10,11,26,44,-18,19
AGF Aarhus,7178,11,4,6,12,16,37,-21,18
Brondby,7179,1,21,7,2,73,30,43,70
FC Midtjylla,7179,2,20,6,4,68,36,32,66
FC Nords,7179,3,14,7,9,74,55,19,49
Copenhagen,7179,4,12,7,11,55,45,10,43
AaB,7179,5,8,11,11,35,45,-10,35
Sonderjyske,7179,6,8,6,10,28,29,-1,30
AC Horsens,7179,7,5,14,11,32,52,-20,29
Randers FC,7179,8,5,7,12,23,39,-16,22
AGF Aarhus,7179,9,5,6,11,17,36,-19,21
Lyngby,7179,10,3,10,11,26,44,-18,19
Silkeborg IF,7179,11,5,3,14,25,45,-20,18
Brondby,7180,1,20,8,2,69,31,38,68
FC Midtjylla,7180,2,19,5,6,64,43,21,62
FC Nords,7180,3,14,7,9,74,53,21,49
Copenhagen,7180,4,13,5,12,59,46,13,44
AaB,7180,5,8,13,9,40,39,1,37
AC Horsens,7180,6,6,14,10,33,53,-20,32
Sonderjyske,7180,7,8,6,10,28,29,-1,30
Randers FC,7180,8,5,7,12,25,41,-16,22
Lyngby,7180,9,3,10,11,28,46,-18,19
Silkeborg IF,7180,10,5,4,13,26,45,-19,19
AGF Aarhus,7180,11,4,7,11,17,37,-20,19
Brondby,7181,1,21,6,3,69,28,41,69
FC Midtjylla,7181,2,20,5,5,66,38,28,65
Copenhagen,7181,3,15,4,11,55,41,14,49
FC Nords,7181,4,13,9,8,71,49,22,48
AC Horsens,7181,5,7,12,11,39,55,-16,33
Sonderjyske,7181,6,8,6,10,28,29,-1,30
AaB,7181,7,6,12,12,32,47,-15,30
Silkeborg IF,7181,8,6,3,13,28,44,-16,21
Lyngby,7181,9,4,9,11,27,44,-17,21
Randers FC,7181,10,5,6,13,23,40,-17,21
AGF Aarhus,7181,11,4,6,12,16,39,-23,18
Brondby,7182,1,23,5,2,77,31,46,74
FC Midtjylla,7182,2,19,5,6,62,40,22,62
FC Nords,7182,3,14,6,10,75,54,21,48
Copenhagen,7182,4,12,4,14,55,51,4,40
AC Horsens,7182,5,8,13,9,40,52,-12,37
AaB,7182,6,8,11,11,37,44,-7,35
Sonderjyske,7182,7,8,6,10,28,29,-1,30
Lyngby,7182,8,4,9,11,28,45,-17,21
Randers FC,7182,9,5,6,13,24,41,-17,21
Silkeborg IF,7182,10,6,3,13,27,45,-18,21
AGF Aarhus,7182,11,4,6,12,17,38,-21,18
Brondby,7183,1,21,6,3,72,35,37,69
FC Midtjylla,7183,2,18,7,5,68,42,26,61
FC Nords,7183,3,14,7,9,76,57,19,49
Copenhagen,7183,4,14,4,12,56,43,13,46
AaB,7183,5,8,11,11,40,46,-6,35
AC Horsens,7183,6,7,13,10,33,48,-15,34
Sonderjyske,7183,7,8,6,10,28,29,-1,30
Randers FC,7183,8,6,6,12,25,40,-15,24
Silkeborg IF,7183,9,5,4,13,27,46,-19,19
AGF Aarhus,7183,10,4,7,11,18,38,-20,19
Lyngby,7183,11,3,9,12,27,46,-19,18
Brondby,7184,1,22,5,3,75,30,45,71
FC Midtjylla,7184,2,19,5,6,69,42,27,62
FC Nords,7184,3,14,7,9,74,56,18,49
Copenhagen,7184,4,14,5,11,53,43,10,47
AC Horsens,7184,5,7,13,10,34,51,-17,34
AaB,7184,6,7,11,12,36,45,-9,32
Sonderjyske,7184,7,8,6,10,28,29,-1,30
Lyngby,7184,8,4,9,11,29,44,-15,21
Randers FC,7184,9,5,6,13,23,42,-19,21
AGF Aarhus,7184,10,5,6,11,17,36,-19,21
Silkeborg IF,7184,11,5,3,14,25,45,-20,18
Brondby,7185,1,22,6,2,70,29,41,72
FC Midtjylla,7185,2,18,5,7,63,40,23,59
Copenhagen,7185,3,15,5,10,59,43,16,50
FC Nords,7185,4,14,7,9,75,52,23,49
AaB,7185,5,8,12,10,37,43,-6,36
Sonderjyske,7185,6,8,6,10,28,29,-1,30
AC Horsens,7185,7,5,13,12,31,54,-23,28
Randers FC,7185,8,5,7,12,25,41,-16,22
Silkeborg IF,7185,9,6,3,13,28,46,-18,21
Lyngby,7185,10,3,10,11,28,46,-18,19
AGF Aarhus,7185,11,4,6,12,18,39,-21,18
Brondby,7186,1,20,7,3,70,33,37,67
FC Midtjylla,7186,2,19,5,6,64,40,24,62
FC Nords,7186,3,14,7,9,72,54,18,49
Copenhagen,7186,4,15,4,11,62,45,17,49
AaB,7186,5,8,12,10,39,42,-3,36
AC Horsens,7186,6,6,13,11,33,52,-19,31
Sonderjyske,7186,7,8,6,10,28,29,-1,30
Randers FC,7186,8,6,6,12,24,39,-15,24
AGF Aarhus,7186,9,5,6,11,17,36,-19,21
Lyngby,7186,10,3,9,12,26,45,-19,18
Silkeborg IF,7186,11,5,3,14,25,45,-20,18
FC Midtjylla,7187,1,19,7,4,66,39,27,64
Brondby,7187,2,19,5,6,68,36,32,62
FC Nords,7187,3,15,7,8,77,50,27,52
Copenhagen,7187,4,14,5,11,56,45,11,47
AaB,7187,5,8,13,9,37,41,-4,37
AC Horsens,7187,6,6,13,11,34,53,-19,31
Sonderjyske,7187,7,8,6,10,28,29,-1,30
Lyngby,7187,8,4,9,11,27,44,-17,21
Randers FC,7187,9,5,6,13,23,40,-17,21
AGF Aarhus,7187,10,5,6,11,18,36,-18,21
Silkeborg IF,7187,11,5,3,14,25,46,-21,18
Brondby,7188,1,19,8,3,69,33,36,65
FC Midtjylla,7188,2,19,6,5,64,40,24,63
FC Nords,7188,3,14,7,9,75,50,25,49
Copenhagen,7188,4,14,5,11,58,46,12,47
AC Horsens,7188,5,8,12,10,38,53,-15,36
AaB,7188,6,7,12,11,36,44,-8,33
Sonderjyske,7188,7,8,6,10,28,29,-1,30
Lyngby,7188,8,4,9,11,31,44,-13,21
Randers FC,7188,9,5,6,13,23,44,-21,21
Silkeborg IF,7188,10,5,4,13,26,45,-19,19
AGF Aarhus,7188,11,4,7,11,17,37,-20,19
Brondby,7189,1,20,8,2,72,32,40,68
FC Midtjylla,7189,2,19,5,6,74,41,33,62
Copenhagen,7189,3,14,6,10,59,44,15,48
FC Nords,7189,4,13,8,9,70,54,16,47
AaB,7189,5,8,12,10,36,42,-6,36
Sonderjyske,7189,6,8,6,10,28,29,-1,30
AC Horsens,7189,7,5,15,10,34,58,-24,30
Randers FC,7189,8,5,7,12,23,39,-16,22
AGF Aarhus,7189,9,5,6,11,18,37,-19,21
Lyngby,7189,10,3,10,11,26,44,-18,19
Silkeborg IF,7189,11,5,3,14,26,46,-20,18
Brondby,7190,1,22,5,3,73,32,41,71
FC Midtjylla,7190,2,20,5,5,67,41,26,65
FC Nords,7190,3,14,6,10,76,53,23,48
Copenhagen,7190,4,13,6,11,59,50,9,45
AaB,7190,5,8,12,10,40,43,-3,36
Sonderjyske,7190,6,8,6,10,28,29,-1,30
AC Horsens,7190,7,5,14,11,33,55,-22,29
Randers FC,7190,8,5,7,12,25,41,-16,22
Silkeborg IF,7190,9,6,3,13,26,44,-18,21
Lyngby,7190,10,3,10,11,28,46,-18,19
AGF Aarhus,7190,11,4,6,12,16,37,-21,18
Brondby,7191,1,20,8,2,72,32,40,68
FC Midtjylla,7191,2,18,7,5,64,39,25,61
FC Nords,7191,3,14,7,9,75,54,21,49
Copenhagen,7191,4,12,6,12,61,52,9,42
AaB,7191,5,9,12,9,39,40,-1,39
AC Horsens,7191,6,7,12,11,39,59,-20,33
Sonderjyske,7191,7,8,6,10,28,29,-1,30
Randers FC,7191,8,6,6,12,24,39,-15,24
Silkeborg IF,7191,9,6,3,13,27,44,-17,21
Lyngby,7191,10,3,9,12,26,45,-19,18
AGF Aarhus,7191,11,4,6,12,16,38,-22,18
Brondby,7192,1,21,7,2,71,27,44,70
FC Midtjylla,7192,2,20,5,5,67,37,30,65
Copenhagen,7192,3,15,6,9,61,44,17,51
FC Nords,7192,4,13,6,11,70,56,14,45
AC Horsens,7192,5,7,12,11,35,57,-22,33
Sonderjyske,7192,6,8,6,10,28,29,-1,30
AaB,7192,7,6,12,12,34,43,-9,30
Lyngby,7192,8,4,9,11,28,44,-16,21
Silkeborg IF,7192,8,6,3,13,28,44,-16,21
Randers FC,7192,10,5,6,13,23,41,-18,21
AGF Aarhus,7192,11,4,6,12,16,39,-23,18
Brondby,7193,1,22,5,3,74,31,43,71
FC Midtjylla,7193,2,19,4,7,65,46,19,61
FC Nords,7193,3,15,6,9,73,51,22,51
Copenhagen,7193,4,14,4,12,60,47,13,46
AaB,7193,5,8,11,11,37,42,-5,35
AC Horsens,7193,6,7,12,11,36,54,-18,33
Sonderjyske,7193,7,8,6,10,28,29,-1,30
Lyngby,7193,8,4,9,11,29,44,-15,21
Randers FC,7193,9,5,6,13,23,42,-19,21
AGF Aarhus,7193,10,5,6,11,18,37,-19,21
Silkeborg IF,7193,11,5,3,14,26,46,-20,18
Brondby,7194,1,21,7,2,70,30,40,70
FC Midtjylla,7194,2,20,5,5,67,37,30,65
FC Nords,7194,3,14,7,9,69,49,20,49
Copenhagen,7194,4,13,5,12,54,47,7,44
AaB,7194,5,8,12,10,39,43,-4,36
Sonderjyske,7194,6,8,6,10,28,29,-1,30
AC Horsens,7194,7,6,12,12,30,49,-19,30
Randers FC,7194,8,6,6,12,26,39,-13,24
AGF Aarhus,7194,9,5,6,11,19,36,-17,21
Lyngby,7194,10,3,9,12,26,47,-21,18
Silkeborg IF,7194,11,5,3,14,25,47,-22,18
Brondby,7195,1,21,7,2,74,31,43,70
FC Midtjylla,7195,2,19,5,6,68,41,27,62
FC Nords,7195,3,15,7,8,75,49,26,52
Copenhagen,7195,4,13,5,12,54,49,5,44
AaB,7195,5,7,12,11,39,50,-11,33
AC Horsens,7195,6,7,12,11,41,57,-16,33
Sonderjyske,7195,7,8,6,10,28,29,-1,30
Lyngby,7195,8,4,9,11,30,45,-15,21
Randers FC,7195,9,5,6,13,24,43,-19,21
Silkeborg IF,7195,10,5,4,13,26,45,-19,19
AGF Aarhus,7195,11,4,7,11,17,37,-20,19
Brondby,7196,1,22,5,3,74,32,42,71
FC Midtjylla,7196,2,19,4,7,63,40,23,61
FC Nords,7196,3,13,8,9,69,48,21,47
Copenhagen,7196,4,14,5,11,58,48,10,47
AC Horsens,7196,5,8,12,10,39,50,-11,36
AaB,7196,6,7,12,11,34,45,-11,33
Sonderjyske,7196,7,8,6,10,28,29,-1,30
Lyngby,7196,8,4,9,11,30,46,-16,21
Randers FC,7196,9,5,6,13,25,43,-18,21
Silkeborg IF,7196,10,5,4,13,27,46,-19,19
AGF Aarhus,7196,11,4,7,11,18,38,-20,19
Brondby,7197,1,20,7,3,71,31,40,67
FC Midtjylla,7197,2,20,4,6,66,39,27,64
FC Nords,7197,3,14,8,8,77,54,23,50
Copenhagen,7197,4,15,5,10,61,44,17,50
AaB,7197,5,6,13,11,35,46,-11,31
AC Horsens,7197,6,6,13,11,34,56,-22,31
Sonderjyske,7197,7,8,6,10,28,29,-1,30
Lyngby,7197,8,4,9,11,30,44,-14,21
Silkeborg IF,7197,9,6,3,13,28,45,-17,21
Randers FC,7197,10,5,6,13,23,43,-20,21
AGF Aarhus,7197,11,4,6,12,17,39,-22,18
Brondby,7198,1,21,7,2,74,32,42,70
FC Midtjylla,7198,2,18,7,5,65,43,22,61
Copenhagen,7198,3,13,8,9,58,43,15,47
FC Nords,7198,4,13,6,11,73,58,15,45
AaB,7198,5,7,13,10,37,41,-4,34
AC Horsens,7198,6,7,13,10,37,53,-16,34
Sonderjyske,7198,7,8,6,10,28,29,-1,30
Randers FC,7198,8,5,7,12,23,39,-16,22
AGF Aarhus,7198,9,5,6,11,19,38,-19,21
Lyngby,7198,10,3,10,11,26,44,-18,19
Silkeborg IF,7198,11,5,3,14,27,47,-20,18
Brondby,7199,1,21,6,3,74,34,40,69
FC Midtjylla,7199,2,20,4,6,70,43,27,64
FC Nords,7199,3,15,6,9,78,55,23,51
Copenhagen,7199,4,13,5,12,61,50,11,44
AaB,7199,5,9,11,10,41,45,-4,38
Sonderjyske,7199,6,8,6,10,28,29,-1,30
AC Horsens,7199,7,6,12,12,31,54,-23,30
Lyngby,7199,8,4,9,11,29,45,-16,21
Silkeborg IF,7199,9,6,3,13,27,44,-17,21
Randers FC,7199,10,5,6,13,24,42,-18,21
AGF Aarhus,7199,11,4,6,12,16,38,-22,18
Brondby,7200,1,19,7,4,68,32,36,64
FC Midtjylla,7200,2,20,4,6,64,38,26,64
FC Nords,7200,3,15,6,9,72,53,19,51
Copenhagen,7200,4,14,6,10,54,40,14,48
AaB,7200,5,8,13,9,36,40,-4,37
Sonderjyske,7200,6,8,6,10,28,29,-1,30
AC Horsens,7200,7,6,12,12,33,50,-17,30
Lyngby,7200,8,4,9,11,28,45,-17,21
Randers FC,7200,9,5,6,13,24,41,-17,21
Silkeborg IF,7200,10,6,3,13,27,45,-18,21
AGF Aarhus,7200,11,4,6,12,17,38,-21,18
Brondby,7201,1,23,5,2,73,32,41,74
FC Midtjylla,7201,2,19,6,5,62,37,25,63
FC Nords,7201,3,13,8,9,70,50,20,47
Copenhagen,7201,4,14,4,12,56,44,12,46
AaB,7201,5,7,13,10,35,40,-5,34
Sonderjyske,7201,6,8,6,10,28,29,-1,30
AC Horsens,7201,7,6,12,12,34,53,-19,30
Randers FC,7201,8,6,6,12,26,41,-15,24
Silkeborg IF,7201,9,6,3,13,29,44,-15,21
Lyngby,7201,10,3,9,12,28,47,-19,18
AGF Aarhus,7201,11,4,6,12,16,40,-24,18
Brondby,7202,1,20,7,3,70,31,39,67
FC Midtjylla,7202,2,19,4,7,62,45,17,61
FC Nords,7202,3,14,8,8,71,49,22,50
Copenhagen,7202,4,14,5,11,57,44,13,47
AaB,7202,5,8,13,9,42,42,0,37
AC Horsens,7202,6,6,13,11,34,51,-17,31
Sonderjyske,7202,7,8,6,10,28,29,-1,30
Lyngby,7202,8,4,9,11,28,45,-17,21
Randers FC,7202,9,5,6,13,24,41,-17,21
Silkeborg IF,7202,10,6,3,13,26,44,-18,21
AGF Aarhus,7202,11,4,6,12,16,37,-21,18
Brondby,7203,1,19,7,4,71,37,34,64
FC Midtjylla,7203,2,19,5,6,64,39,25,62
FC Nords,7203,3,13,9,8,76,54,22,48
Copenhagen,7203,4,13,7,10,58,46,12,46
AaB,7203,5,10,11,9,44,43,1,41
AC Horsens,7203,6,6,13,11,34,54,-20,31
Sonderjyske,7203,7,8,6,10,28,29,-1,30
Lyngby,7203,8,4,9,11,28,45,-17,21
Silkeborg IF,7203,9,6,3,13,27,44,-17,21
Randers FC,7203,10,5,6,13,24,41,-17,21
AGF Aarhus,7203,11,4,6,12,16,38,-22,18
FC Midtjylla,7204,1,20,6,4,65,36,29,66
Brondby,7204,2,18,6,6,66,37,29,60
FC Nords,7204,3,14,7,9,71,52,19,49
Copenhagen,7204,4,13,6,11,57,46,11,45
AaB,7204,5,9,13,8,44,42,2,40
AC Horsens,7204,6,6,14,10,34,50,-16,32
Sonderjyske,7204,7,8,6,10,28,29,-1,30
Randers FC,7204,8,5,7,12,23,39,-16,22
Lyngby,7204,9,3,10,11,26,44,-18,19
Silkeborg IF,7204,10,5,4,13,26,45,-19,19
AGF Aarhus,7204,11,4,7,11,17,37,-20,19
Brondby,7205,1,21,6,3,70,31,39,69
FC Midtjylla,7205,2,21,5,4,71,38,33,68
Copenhagen,7205,3,14,5,11,60,48,12,47
FC Nords,7205,4,13,7,10,70,51,19,46
AaB,7205,5,7,12,11,34,46,-12,33
AC Horsens,7205,6,6,13,11,35,52,-17,31
Sonderjyske,7205,7,8,6,10,28,29,-1,30
Lyngby,7205,8,4,9,11,30,46,-16,21
Silkeborg IF,7205,9,6,3,13,26,44,-18,21
Randers FC,7205,10,5,6,13,25,43,-18,21
AGF Aarhus,7205,11,4,6,12,16,37,-21,18
Brondby,7206,1,22,5,3,76,36,40,71
FC Midtjylla,7206,2,20,4,6,68,40,28,64
Copenhagen,7206,3,15,5,10,60,46,14,50
FC Nords,7206,4,14,7,9,73,50,23,49
AC Horsens,7206,5,7,12,11,36,52,-16,33
Sonderjyske,7206,6,8,6,10,28,29,-1,30
AaB,7206,7,6,11,13,36,51,-15,29
Randers FC,7206,8,5,7,12,24,40,-16,22
Silkeborg IF,7206,9,6,3,13,26,44,-18,21
Lyngby,7206,10,3,10,11,27,45,-18,19
AGF Aarhus,7206,11,4,6,12,16,37,-21,18
Brondby,7207,1,22,6,2,77,33,44,72
FC Midtjylla,7207,2,19,4,7,64,38,26,61
FC Nords,7207,3,14,7,9,78,60,18,49
Copenhagen,7207,4,14,4,12,60,48,12,46
AaB,7207,5,9,12,9,39,41,-2,39
Sonderjyske,7207,6,8,6,10,28,29,-1,30
AC Horsens,7207,7,5,13,12,34,58,-24,28
Randers FC,7207,8,5,7,12,24,40,-16,22
AGF Aarhus,7207,9,5,6,11,19,36,-17,21
Lyngby,7207,10,3,10,11,27,45,-18,19
Silkeborg IF,7207,11,5,3,14,25,47,-22,18
Brondby,7208,1,22,6,2,74,33,41,72
FC Midtjylla,7208,2,18,5,7,62,40,22,59
FC Nords,7208,3,13,8,9,68,49,19,47
Copenhagen,7208,4,13,6,11,58,49,9,45
AaB,7208,5,8,12,10,39,41,-2,36
AC Horsens,7208,6,5,17,8,35,50,-15,32
Sonderjyske,7208,7,8,6,10,28,29,-1,30
Randers FC,7208,8,6,6,12,25,40,-15,24
Silkeborg IF,7208,9,6,3,13,29,45,-16,21
Lyngby,7208,10,3,9,12,27,46,-19,18
AGF Aarhus,7208,11,4,6,12,17,40,-23,18
Brondby,7209,1,20,5,5,72,38,34,65
FC Midtjylla,7209,2,20,4,6,67,38,29,64
FC Nords,7209,3,16,7,7,76,48,28,55
Copenhagen,7209,4,13,4,13,53,44,9,43
AC Horsens,7209,5,8,12,10,38,53,-15,36
AaB,7209,6,7,12,11,36,47,-11,33
Sonderjyske,7209,7,8,6,10,28,29,-1,30
Randers FC,7209,8,6,6,12,25,39,-14,24
Silkeborg IF,7209,9,6,3,13,26,44,-18,21
Lyngby,7209,10,3,9,12,26,46,-20,18
AGF Aarhus,7209,11,4,6,12,16,37,-21,18
Brondby,7210,1,21,6,3,69,30,39,69
FC Midtjylla,7210,2,20,5,5,69,42,27,65
Copenhagen,7210,3,16,4,10,57,43,14,52
FC Nords,7210,4,15,6,9,75,50,25,51
AaB,7210,5,7,11,12,37,46,-9,32
Sonderjyske,7210,6,8,6,10,28,29,-1,30
AC Horsens,7210,7,5,12,13,35,57,-22,27
Randers FC,7210,8,5,7,12,24,40,-16,22
AGF Aarhus,7210,9,5,6,11,19,38,-19,21
Lyngby,7210,10,3,10,11,27,45,-18,19
Silkeborg IF,7210,11,5,3,14,27,47,-20,18
Brondby,7211,1,21,5,4,71,34,37,68
FC Midtjylla,7211,2,21,4,5,66,36,30,67
Copenhagen,7211,3,16,4,10,62,44,18,52
FC Nords,7211,4,13,6,11,72,54,18,45
AaB,7211,5,7,12,11,37,44,-7,33
AC Horsens,7211,6,6,13,11,36,58,-22,31
Sonderjyske,7211,7,8,6,10,28,29,-1,30
Lyngby,7211,8,4,9,11,29,44,-15,21
Randers FC,7211,9,5,6,13,23,42,-19,21
Silkeborg IF,7211,10,5,4,13,26,45,-19,19
AGF Aarhus,7211,11,4,7,11,17,37,-20,19
Brondby,7212,1,21,6,3,72,29,43,69
FC Midtjylla,7212,2,21,4,5,69,38,31,67
Copenhagen,7212,3,14,4,12,56,46,10,46
FC Nords,7212,4,13,6,11,67,54,13,45
AC Horsens,7212,5,7,14,9,35,48,-13,35
AaB,7212,6,7,12,11,38,48,-10,33
Sonderjyske,7212,7,8,6,10,28,29,-1,30
Randers FC,7212,8,6,6,12,24,39,-15,24
Silkeborg IF,7212,9,6,3,13,26,44,-18,21
Lyngby,7212,10,3,9,12,26,45,-19,18
AGF Aarhus,7212,11,4,6,12,16,37,-21,18
Brondby,7213,1,20,7,3,68,31,37,67
FC Midtjylla,7213,2,19,6,5,66,40,26,63
FC Nords,7213,3,15,7,8,75,49,26,52
Copenhagen,7213,4,14,6,10,56,44,12,48
AC Horsens,7213,5,6,14,10,36,49,-13,32
Sonderjyske,7213,6,8,6,10,28,29,-1,30
AaB,7213,7,6,12,12,35,49,-14,30
Lyngby,7213,8,4,9,11,28,44,-16,21
Randers FC,7213,9,5,6,13,23,41,-18,21
Silkeborg IF,7213,10,5,4,13,27,46,-19,19
AGF Aarhus,7213,11,4,7,11,18,38,-20,19
Brondby,7214,1,20,7,3,66,31,35,67
FC Midtjylla,7214,2,20,5,5,69,41,28,65
FC Nords,7214,3,14,6,10,70,53,17,48
Copenhagen,7214,4,14,4,12,58,44,14,46
AaB,7214,5,8,12,10,38,41,-3,36
AC Horsens,7214,6,7,12,11,37,54,-17,33
Sonderjyske,7214,7,8,6,10,28,29,-1,30
Lyngby,7214,8,4,9,11,28,45,-17,21
Randers FC,7214,9,5,6,13,24,41,-17,21
Silkeborg IF,7214,10,6,3,13,26,44,-18,21
AGF Aarhus,7214,11,4,6,12,16,37,-21,18
Brondby,7215,1,21,7,2,76,34,42,70
FC Midtjylla,7215,2,20,5,5,64,37,27,65
FC Nords,7215,3,15,6,9,73,51,22,51
Copenhagen,7215,4,12,5,13,54,51,3,41
AC Horsens,7215,5,7,13,10,38,53,-15,34
AaB,7215,6,7,12,11,37,42,-5,33
Sonderjyske,7215,7,8,6,10,28,29,-1,30
Randers FC,7215,8,6,6,12,24,39,-15,24
Silkeborg IF,7215,9,5,4,13,26,45,-19,19
AGF Aarhus,7215,10,4,7,11,17,37,-20,19
Lyngby,7215,11,3,9,12,26,45,-19,18
Brondby,7216,1,21,5,4,68,33,35,68
FC Midtjylla,7216,2,20,4,6,65,37,28,64
Copenhagen,7216,3,14,6,10,55,42,13,48
FC Nords,7216,4,13,7,10,72,54,18,46
AaB,7216,5,8,13,9,37,40,-3,37
Sonderjyske,7216,6,8,6,10,28,29,-1,30
AC Horsens,7216,7,5,15,10,34,51,-17,30
Randers FC,7216,8,6,6,12,26,40,-14,24
Silkeborg IF,7216,9,6,3,13,26,44,-18,21
Lyngby,7216,10,3,9,12,27,47,-20,18
AGF Aarhus,7216,11,4,6,12,16,37,-21,18
Brondby,7217,1,22,5,3,75,29,46,71
FC Midtjylla,7217,2,19,5,6,65,39,26,62
FC Nords,7217,3,15,6,9,74,56,18,51
Copenhagen,7217,4,13,5,12,57,48,9,44
AaB,7217,5,9,11,10,35,38,-3,38
Sonderjyske,7217,6,8,6,10,28,29,-1,30
AC Horsens,7217,7,6,12,12,34,56,-22,30
Lyngby,7217,8,4,9,11,28,45,-17,21
Randers FC,7217,9,5,6,13,24,41,-17,21
Silkeborg IF,7217,10,6,3,13,26,44,-18,21
AGF Aarhus,7217,11,4,6,12,16,37,-21,18
Brondby,7218,1,21,6,3,75,32,43,69
FC Midtjylla,7218,2,20,6,4,68,35,33,66
FC Nords,7218,3,12,9,9,74,58,16,45
Copenhagen,7218,4,13,6,11,58,47,11,45
AaB,7218,5,8,12,10,41,49,-8,36
AC Horsens,7218,6,6,13,11,34,55,-21,31
Sonderjyske,7218,7,8,6,10,28,29,-1,30
Lyngby,7218,8,4,9,11,29,45,-16,21
Randers FC,7218,9,5,6,13,24,42,-18,21
AGF Aarhus,7218,10,5,6,11,17,36,-19,21
Silkeborg IF,7218,11,5,3,14,25,45,-20,18
Brondby,7219,1,21,6,3,71,34,37,69
FC Midtjylla,7219,2,21,5,4,71,37,34,68
FC Nords,7219,3,14,7,9,73,53,20,49
Copenhagen,7219,4,13,4,13,51,45,6,43
AaB,7219,5,7,13,10,36,43,-7,34
AC Horsens,7219,6,6,13,11,34,50,-16,31
Sonderjyske,7219,7,8,6,10,28,29,-1,30
Lyngby,7219,8,4,9,11,29,45,-16,21
Randers FC,7219,9,5,6,13,24,42,-18,21
Silkeborg IF,7219,10,5,4,13,27,46,-19,19
AGF Aarhus,7219,11,4,7,11,18,38,-20,19
Brondby,7220,1,21,6,3,71,31,40,69
FC Midtjylla,7220,2,19,5,6,64,41,23,62
FC Nords,7220,3,14,8,8,75,49,26,50
Copenhagen,7220,4,13,6,11,54,44,10,45
AaB,7220,5,9,12,9,42,46,-4,39
Sonderjyske,7220,6,8,6,10,28,29,-1,30
AC Horsens,7220,7,5,13,12,31,52,-21,28
Lyngby,7220,8,4,9,11,29,45,-16,21
Randers FC,7220,9,5,6,13,24,42,-18,21
AGF Aarhus,7220,10,5,6,11,19,37,-18,21
Silkeborg IF,7220,11,5,3,14,26,47,-21,18
FC Midtjylla,7221,1,21,4,5,67,37,30,67
Brondby,7221,2,19,6,5,66,33,33,63
FC Nords,7221,3,16,6,8,72,46,26,54
Copenhagen,7221,4,14,5,11,53,42,11,47
AC Horsens,7221,5,7,12,11,36,52,-16,33
AaB,7221,6,7,11,12,34,44,-10,32
Sonderjyske,7221,7,8,6,10,28,29,-1,30
Randers FC,7221,8,6,6,12,26,40,-14,24
Silkeborg IF,7221,9,6,3,13,26,44,-18,21
Lyngby,7221,10,3,9,12,27,47,-20,18
AGF Aarhus,7221,11,4,6,12,16,37,-21,18
Brondby,7222,1,21,6,3,74,33,41,69
FC Midtjylla,7222,2,19,4,7,63,41,22,61
FC Nords,7222,3,15,6,9,76,53,23,51
Copenhagen,7222,4,14,6,10,60,46,14,48
AaB,7222,5,8,11,11,37,42,-5,35
AC Horsens,7222,6,6,13,11,34,55,-21,31
Sonderjyske,7222,7,8,6,10,28,29,-1,30
Randers FC,7222,8,6,6,12,26,39,-13,24
Silkeborg IF,7222,9,6,3,13,27,45,-18,21
Lyngby,7222,10,3,9,12,26,47,-21,18
AGF Aarhus,7222,11,4,6,12,17,38,-21,18
Brondby,7223,1,20,8,2,69,31,38,68
FC Midtjylla,7223,2,20,5,5,66,39,27,65
FC Nords,7223,3,13,8,9,73,52,21,47
Copenhagen,7223,4,14,5,11,57,46,11,47
AaB,7223,5,6,14,10,37,43,-6,32
AC Horsens,7223,6,6,14,10,33,50,-17,32
Sonderjyske,7223,7,8,6,10,28,29,-1,30
Randers FC,7223,8,5,7,12,24,40,-16,22
Lyngby,7223,9,3,10,11,27,45,-18,19
Silkeborg IF,7223,10,5,4,13,25,44,-19,19
AGF Aarhus,7223,11,4,7,11,16,36,-20,19
Brondby,7224,1,20,6,4,70,30,40,66
FC Midtjylla,7224,2,17,6,7,60,44,16,57
Copenhagen,7224,3,15,4,11,61,49,12,49
FC Nords,7224,4,13,7,10,71,55,16,46
AaB,7224,5,8,14,8,42,40,2,38
AC Horsens,7224,6,8,13,9,38,50,-12,37
Sonderjyske,7224,7,8,6,10,28,29,-1,30
Randers FC,7224,8,6,6,12,25,40,-15,24
Silkeborg IF,7224,9,6,3,13,27,44,-17,21
Lyngby,7224,10,3,9,12,27,46,-19,18
AGF Aarhus,7224,11,4,6,12,16,38,-22,18
Brondby,7225,1,21,7,2,77,31,46,70
FC Midtjylla,7225,2,20,5,5,69,42,27,65
FC Nords,7225,3,15,7,8,75,51,24,52
Copenhagen,7225,4,12,6,12,59,55,4,42
AaB,7225,5,8,11,11,39,47,-8,35
Sonderjyske,7225,6,8,6,10,28,29,-1,30
AC Horsens,7225,7,5,14,11,34,53,-19,29
Lyngby,7225,8,4,9,11,29,45,-16,21
Randers FC,7225,9,5,6,13,24,42,-18,21
Silkeborg IF,7225,10,5,4,13,27,46,-19,19
AGF Aarhus,7225,11,4,7,11,18,38,-20,19
Brondby,7226,1,22,6,2,72,31,41,72
FC Midtjylla,7226,2,20,5,5,73,38,35,65
FC Nords,7226,3,15,7,8,72,49,23,52
Copenhagen,7226,4,12,5,13,52,46,6,41
AC Horsens,7226,5,7,12,11,33,55,-22,33
AaB,7226,6,6,13,11,35,44,-9,31
Sonderjyske,7226,7,8,6,10,28,29,-1,30
Randers FC,7226,8,5,7,12,25,41,-16,22
Lyngby,7226,9,3,10,11,28,46,-18,19
Silkeborg IF,7226,10,5,4,13,27,46,-19,19
AGF Aarhus,7226,11,4,7,11,18,38,-20,19
FC Midtjylla,7227,1,20,4,6,67,43,24,64
Brondby,7227,2,18,7,5,69,37,32,61
FC Nords,7227,3,16,7,7,76,46,30,55
Copenhagen,7227,4,14,6,10,62,47,15,48
AaB,7227,5,6,14,10,36,44,-8,32
AC Horsens,7227,6,6,14,10,35,54,-19,32
Sonderjyske,7227,7,8,6,10,28,29,-1,30
Randers FC,7227,8,6,6,12,25,40,-15,24
Silkeborg IF,7227,9,6,3,13,27,45,-18,21
Lyngby,7227,10,3,9,12,27,46,-19,18
AGF Aarhus,7227,11,4,6,12,17,38,-21,18
FC Midtjylla,7228,1,21,4,5,68,36,32,67
Brondby,7228,2,19,6,5,63,34,29,63
FC Nords,7228,3,14,9,7,75,50,25,51
Copenhagen,7228,4,12,7,11,54,45,9,43
AaB,7228,5,7,13,10,36,42,-6,34
AC Horsens,7228,6,7,13,10,35,50,-15,34
Sonderjyske,7228,7,8,6,10,28,29,-1,30
Lyngby,7228,8,4,9,11,29,45,-16,21
Randers FC,7228,9,5,6,13,24,42,-18,21
Silkeborg IF,7228,10,5,4,13,25,44,-19,19
AGF Aarhus,7228,11,4,7,11,16,36,-20,19
FC Midtjylla,7229,1,21,4,5,70,45,25,67
Brondby,7229,2,20,6,4,73,32,41,66
FC Nords,7229,3,15,6,9,73,52,21,51
Copenhagen,7229,4,12,5,13,56,49,7,41
AC Horsens,7229,5,8,12,10,42,56,-14,36
AaB,7229,6,8,11,11,38,44,-6,35
Sonderjyske,7229,7,8,6,10,28,29,-1,30
Randers FC,7229,8,6,6,12,26,40,-14,24
Silkeborg IF,7229,9,6,3,13,30,44,-14,21
Lyngby,7229,10,3,9,12,27,47,-20,18
AGF Aarhus,7229,11,4,6,12,16,41,-25,18
Brondby,7230,1,20,7,3,68,31,37,67
FC Midtjylla,7230,2,20,6,4,64,35,29,66
FC Nords,7230,3,14,7,9,71,50,21,49
Copenhagen,7230,4,14,5,11,56,42,14,47
AaB,7230,5,6,14,10,37,43,-6,32
AC Horsens,7230,6,6,13,11,35,56,-21,31
Sonderjyske,7230,7,8,6,10,28,29,-1,30
Randers FC,7230,8,6,6,12,25,40,-15,24
AGF Aarhus,7230,9,5,6,11,19,38,-19,21
Lyngby,7230,10,3,9,12,27,46,-19,18
Silkeborg IF,7230,11,5,3,14,27,47,-20,18
Brondby,7231,1,21,5,4,74,33,41,68
FC Midtjylla,7231,2,19,5,6,63,40,23,62
FC Nords,7231,3,15,6,9,78,52,26,51
Copenhagen,7231,4,15,4,11,60,45,15,49
AaB,7231,5,8,12,10,38,42,-4,36
Sonderjyske,7231,6,8,6,10,28,29,-1,30
AC Horsens,7231,7,6,12,12,33,60,-27,30
Randers FC,7231,8,6,6,12,27,41,-14,24
AGF Aarhus,7231,9,5,6,11,18,36,-18,21
Lyngby,7231,10,3,9,12,28,48,-20,18
Silkeborg IF,7231,11,5,3,14,25,46,-21,18
Brondby,7232,1,21,5,4,70,32,38,68
FC Midtjylla,7232,2,21,4,5,64,39,25,67
FC Nords,7232,3,14,7,9,73,49,24,49
Copenhagen,7232,4,12,5,13,56,47,9,41
AaB,7232,5,8,12,10,39,45,-6,36
AC Horsens,7232,6,7,13,10,35,51,-16,34
Sonderjyske,7232,7,8,6,10,28,29,-1,30
Randers FC,7232,8,5,7,12,24,40,-16,22
Silkeborg IF,7232,9,6,3,13,29,44,-15,21
Lyngby,7232,10,3,10,11,27,45,-18,19
AGF Aarhus,7232,11,4,6,12,16,40,-24,18
FC Midtjylla,7233,1,21,4,5,73,38,35,67
Brondby,7233,2,19,5,6,69,35,34,62
FC Nords,7233,3,15,7,8,75,49,26,52
Copenhagen,7233,4,13,5,12,56,50,6,44
AC Horsens,7233,5,8,12,10,38,59,-21,36
AaB,7233,6,7,13,10,38,44,-6,34
Sonderjyske,7233,7,8,6,10,28,29,-1,30
Randers FC,7233,8,5,7,12,24,40,-16,22
Silkeborg IF,7233,9,6,3,13,27,45,-18,21
Lyngby,7233,10,3,10,11,27,45,-18,19
AGF Aarhus,7233,11,4,6,12,17,38,-21,18
Brondby,7234,1,21,6,3,68,31,37,69
FC Midtjylla,7234,2,17,7,6,60,40,20,58
FC Nords,7234,3,15,7,8,75,51,24,52
Copenhagen,7234,4,14,6,10,60,44,16,48
AaB,7234,5,7,12,11,35,42,-7,33
AC Horsens,7234,6,7,12,11,37,53,-16,33
Sonderjyske,7234,7,8,6,10,28,29,-1,30
Lyngby,7234,8,4,9,11,27,44,-17,21
Silkeborg IF,7234,8,6,3,13,27,44,-17,21
Randers FC,7234,10,5,6,13,23,40,-17,21
AGF Aarhus,7234,11,4,6,12,16,38,-22,18
Brondby,7235,1,22,6,2,74,33,41,72
FC Midtjylla,7235,2,18,6,6,62,40,22,60
Copenhagen,7235,3,14,5,11,60,45,15,47
FC Nords,7235,4,13,7,10,69,51,18,46
AC Horsens,7235,5,7,15,8,34,47,-13,36
AaB,7235,6,6,13,11,33,42,-9,31
Sonderjyske,7235,7,8,6,10,28,29,-1,30
Randers FC,7235,8,6,6,12,24,39,-15,24
Silkeborg IF,7235,9,6,3,13,27,44,-17,21
Lyngby,7235,10,3,9,12,26,45,-19,18
AGF Aarhus,7235,11,4,6,12,16,38,-22,18
Brondby,7236,1,19,8,3,68,33,35,65
FC Midtjylla,7236,2,20,4,6,73,41,32,64
Copenhagen,7236,3,15,6,9,62,43,19,51
FC Nords,7236,4,13,8,9,75,60,15,47
AaB,7236,5,7,13,10,36,43,-7,34
AC Horsens,7236,6,6,13,11,34,54,-20,31
Sonderjyske,7236,7,8,6,10,28,29,-1,30
Lyngby,7236,8,4,9,11,27,44,-17,21
Randers FC,7236,9,5,6,13,23,40,-17,21
Silkeborg IF,7236,10,6,3,13,26,44,-18,21
AGF Aarhus,7236,11,4,6,12,16,37,-21,18
Brondby,7237,1,21,5,4,74,34,40,68
FC Midtjylla,7237,2,18,5,7,63,44,19,59
FC Nords,7237,3,16,6,8,77,47,30,54
Copenhagen,7237,4,15,5,10,60,48,12,50
AaB,7237,5,7,14,9,35,40,-5,35
Sonderjyske,7237,6,8,6,10,28,29,-1,30
AC Horsens,7237,7,5,13,12,36,58,-22,28
Randers FC,7237,8,5,7,12,24,40,-16,22
Silkeborg IF,7237,9,6,3,13,26,44,-18,21
Lyngby,7237,10,3,10,11,27,45,-18,19
AGF Aarhus,7237,11,4,6,12,16,37,-21,18
Brondby,7238,1,21,7,2,72,31,41,70
FC Midtjylla,7238,2,18,4,8,66,43,23,58
FC Nords,7238,3,15,6,9,74,54,20,51
Copenhagen,7238,4,14,6,10,56,43,13,48
AaB,7238,5,8,14,8,41,41,0,38
Sonderjyske,7238,6,8,6,10,28,29,-1,30
AC Horsens,7238,7,5,13,12,31,54,-23,28
Lyngby,7238,8,4,9,11,31,44,-13,21
Silkeborg IF,7238,9,6,3,13,28,44,-16,21
Randers FC,7238,10,5,6,13,23,44,-21,21
AGF Aarhus,7238,11,4,6,12,16,39,-23,18
FC Midtjylla,7239,1,21,5,4,70,39,31,68
Brondby,7239,2,18,9,3,70,36,34,63
FC Nords,7239,3,15,7,8,74,51,23,52
Copenhagen,7239,4,12,6,12,54,45,9,42
AaB,7239,5,8,12,10,37,42,-5,36
AC Horsens,7239,6,6,13,11,36,54,-18,31
Sonderjyske,7239,7,8,6,10,28,29,-1,30
Randers FC,7239,8,5,7,12,23,39,-16,22
AGF Aarhus,7239,9,5,6,11,18,36,-18,21
Lyngby,7239,10,3,10,11,26,44,-18,19
Silkeborg IF,7239,11,5,3,14,25,46,-21,18
Brondby,7240,1,22,6,2,70,30,40,72
FC Midtjylla,7240,2,19,4,7,67,40,27,61
Copenhagen,7240,3,14,5,11,56,44,12,47
FC Nords,7240,4,13,7,10,71,54,17,46
AaB,7240,5,8,11,11,39,42,-3,35
AC Horsens,7240,6,7,13,10,33,52,-19,34
Sonderjyske,7240,7,8,6,10,28,29,-1,30
Lyngby,7240,8,4,9,11,28,44,-16,21
Randers FC,7240,9,5,6,13,23,41,-18,21
AGF Aarhus,7240,10,5,6,11,19,37,-18,21
Silkeborg IF,7240,11,5,3,14,26,47,-21,18
Brondby,7241,1,21,7,2,73,30,43,70
FC Midtjylla,7241,2,20,5,5,64,36,28,65
FC Nords,7241,3,15,6,9,73,51,22,51
Copenhagen,7241,4,13,5,12,58,50,8,44
AaB,7241,5,7,11,12,34,44,-10,32
AC Horsens,7241,6,6,14,10,35,52,-17,32
Sonderjyske,7241,7,8,6,10,28,29,-1,30
Randers FC,7241,8,5,7,12,23,39,-16,22
Silkeborg IF,7241,9,6,3,13,26,44,-18,21
Lyngby,7241,10,3,10,11,26,44,-18,19
AGF Aarhus,7241,11,4,6,12,16,37,-21,18
FC Midtjylla,7242,1,19,7,4,65,38,27,64
Brondby,7242,2,19,6,5,68,37,31,63
FC Nords,7242,3,15,8,7,76,47,29,53
Copenhagen,7242,4,14,6,10,60,45,15,48
AaB,7242,5,7,12,11,33,42,-9,33
Sonderjyske,7242,6,8,6,10,28,29,-1,30
AC Horsens,7242,7,5,15,10,37,56,-19,30
Lyngby,7242,8,4,9,11,28,44,-16,21
Randers FC,7242,9,5,6,13,23,41,-18,21
Silkeborg IF,7242,10,5,4,13,25,44,-19,19
AGF Aarhus,7242,11,4,7,11,16,36,-20,19
Brondby,7243,1,21,6,3,74,34,40,69
FC Midtjylla,7243,2,18,5,7,65,42,23,59
FC Nords,7243,3,15,6,9,77,52,25,51
Copenhagen,7243,4,15,4,11,63,45,18,49
AaB,7243,5,9,11,10,38,45,-7,38
Sonderjyske,7243,6,8,6,10,28,29,-1,30
AC Horsens,7243,7,5,14,11,38,63,-25,29
Randers FC,7243,8,6,6,12,25,40,-15,24
Silkeborg IF,7243,9,5,4,13,25,44,-19,19
AGF Aarhus,7243,10,4,7,11,16,36,-20,19
Lyngby,7243,11,3,9,12,27,46,-19,18
Brondby,7244,1,20,8,2,66,29,37,68
FC Midtjylla,7244,2,19,6,5,64,39,25,63
FC Nords,7244,3,14,7,9,70,49,21,49
Copenhagen,7244,4,13,4,13,56,48,8,43
AaB,7244,5,8,13,9,36,38,-2,37
AC Horsens,7244,6,6,14,10,36,51,-15,32
Sonderjyske,7244,7,8,6,10,28,29,-1,30
Randers FC,7244,8,6,6,12,25,40,-15,24
Silkeborg IF,7244,9,6,3,13,28,44,-16,21
Lyngby,7244,10,3,9,12,27,46,-19,18
AGF Aarhus,7244,11,4,6,12,16,39,-23,18
Brondby,7245,1,20,6,4,73,37,36,66
FC Midtjylla,7245,2,20,4,6,71,41,30,64
FC Nords,7245,3,15,6,9,78,56,22,51
Copenhagen,7245,4,14,6,10,60,45,15,48
AaB,7245,5,8,12,10,39,43,-4,36
Sonderjyske,7245,6,8,6,10,28,29,-1,30
AC Horsens,7245,7,6,12,12,35,60,-25,30
Randers FC,7245,8,5,7,12,24,40,-16,22
Lyngby,7245,9,3,10,11,27,45,-18,19
Silkeborg IF,7245,10,5,4,13,26,45,-19,19
AGF Aarhus,7245,11,4,7,11,17,37,-20,19
Brondby,7246,1,22,6,2,73,30,43,72
FC Midtjylla,7246,2,19,4,7,66,44,22,61
FC Nords,7246,3,14,7,9,74,54,20,49
Copenhagen,7246,4,14,5,11,58,46,12,47
AC Horsens,7246,5,7,13,10,36,49,-13,34
AaB,7246,6,6,13,11,34,44,-10,31
Sonderjyske,7246,7,8,6,10,28,29,-1,30
Silkeborg IF,7246,8,6,3,13,29,44,-15,21
Lyngby,7246,9,4,9,11,27,44,-17,21
Randers FC,7246,10,5,6,13,23,40,-17,21
AGF Aarhus,7246,11,4,6,12,16,40,-24,18
Brondby,7247,1,20,6,4,68,33,35,66
FC Midtjylla,7247,2,18,4,8,63,42,21,58
FC Nords,7247,3,14,7,9,71,51,20,49
Copenhagen,7247,4,14,6,10,59,44,15,48
AaB,7247,5,8,14,8,40,42,-2,38
AC Horsens,7247,6,6,15,9,37,52,-15,33
Sonderjyske,7247,7,8,6,10,28,29,-1,30
Randers FC,7247,8,6,6,12,25,39,-14,24
Silkeborg IF,7247,9,5,4,13,26,45,-19,19
AGF Aarhus,7247,10,4,7,11,17,37,-20,19
Lyngby,7247,11,3,9,12,26,46,-20,18
Brondby,7248,1,22,6,2,79,30,49,72
FC Midtjylla,7248,2,19,5,6,64,45,19,62
Copenhagen,7248,3,15,4,11,56,41,15,49
FC Nords,7248,4,13,8,9,70,53,17,47
AC Horsens,7248,5,7,12,11,37,53,-16,33
AaB,7248,6,6,13,11,36,46,-10,31
Sonderjyske,7248,7,8,6,10,28,29,-1,30
Randers FC,7248,8,6,6,12,25,40,-15,24
Silkeborg IF,7248,9,6,3,13,27,44,-17,21
Lyngby,7248,10,3,9,12,27,46,-19,18
AGF Aarhus,7248,11,4,6,12,16,38,-22,18
Brondby,7249,1,19,7,4,66,29,37,64
FC Midtjylla,7249,2,19,4,7,62,39,23,61
Copenhagen,7249,3,16,5,9,61,41,20,53
FC Nords,7249,4,14,7,9,73,56,17,49
AaB,7249,5,7,14,9,34,39,-5,35
Sonderjyske,7249,6,8,6,10,28,29,-1,30
AC Horsens,7249,7,5,15,10,32,50,-18,30
Randers FC,7249,8,6,6,12,24,39,-15,24
Silkeborg IF,7249,9,6,3,13,29,44,-15,21
Lyngby,7249,10,3,9,12,26,45,-19,18
AGF Aarhus,7249,11,4,6,12,16,40,-24,18
Brondby,7250,1,20,6,4,69,35,34,66
FC Midtjylla,7250,2,19,4,7,64,42,22,61
FC Nords,7250,3,15,7,8,76,47,29,52
Copenhagen,7250,4,15,6,9,61,41,20,51
AaB,7250,5,7,13,10,36,43,-7,34
Sonderjyske,7250,6,8,6,10,28,29,-1,30
AC Horsens,7250,7,5,14,11,32,56,-24,29
Lyngby,7250,8,4,9,11,29,45,-16,21
Randers FC,7250,9,5,6,13,24,42,-18,21
Silkeborg IF,7250,10,5,4,13,25,44,-19,19
AGF Aarhus,7250,11,4,7,11,16,36,-20,19
Brondby,7251,1,21,5,4,68,31,37,68
FC Midtjylla,7251,2,20,5,5,67,37,30,65
Copenhagen,7251,3,15,4,11,59,43,16,49
FC Nords,7251,4,13,6,11,69,55,14,45
AaB,7251,5,7,13,10,36,40,-4,34
AC Horsens,7251,6,7,13,10,32,51,-19,34
Sonderjyske,7251,7,8,6,10,28,29,-1,30
Randers FC,7251,8,6,6,12,24,39,-15,24
Silkeborg IF,7251,9,5,4,13,28,47,-19,19
AGF Aarhus,7251,10,4,7,11,19,39,-20,19
Lyngby,7251,11,3,9,12,26,45,-19,18
Brondby,7252,1,22,6,2,73,31,42,72
FC Midtjylla,7252,2,19,5,6,68,40,28,62
Copenhagen,7252,3,14,5,11,58,46,12,47
FC Nords,7252,4,12,10,8,69,51,18,46
AaB,7252,5,7,13,10,35,44,-9,34
AC Horsens,7252,6,6,13,11,35,52,-17,31
Sonderjyske,7252,7,8,6,10,28,29,-1,30
Silkeborg IF,7252,8,6,3,13,28,44,-16,21
Lyngby,7252,9,4,9,11,28,45,-17,21
Randers FC,7252,10,5,6,13,24,41,-17,21
AGF Aarhus,7252,11,4,6,12,16,39,-23,18
Brondby,7253,1,20,7,3,69,30,39,67
FC Midtjylla,7253,2,20,4,6,67,43,24,64
FC Nords,7253,3,15,7,8,79,53,26,52
Copenhagen,7253,4,14,6,10,63,49,14,48
AaB,7253,5,7,11,12,39,47,-8,32
AC Horsens,7253,6,6,13,11,33,54,-21,31
Sonderjyske,7253,7,8,6,10,28,29,-1,30
Randers FC,7253,8,5,7,12,24,40,-16,22
Lyngby,7253,9,3,10,11,27,45,-18,19
Silkeborg IF,7253,10,5,4,13,26,45,-19,19
AGF Aarhus,7253,11,4,7,11,17,37,-20,19
Brondby,7254,1,21,7,2,67,28,39,70
FC Midtjylla,7254,2,20,4,6,70,37,33,64
FC Nords,7254,3,14,7,9,71,52,19,49
Copenhagen,7254,4,14,6,10,56,42,14,48
AaB,7254,5,8,11,11,36,43,-7,35
Sonderjyske,7254,6,8,6,10,28,29,-1,30
AC Horsens,7254,7,5,13,12,30,54,-24,28
Randers FC,7254,8,6,6,12,25,39,-14,24
Silkeborg IF,7254,9,6,3,13,26,44,-18,21
Lyngby,7254,10,3,9,12,26,46,-20,18
AGF Aarhus,7254,11,4,6,12,16,37,-21,18
Brondby,7255,1,21,5,4,71,31,40,68
FC Midtjylla,7255,2,19,4,7,63,46,17,61
FC Nords,7255,3,16,6,8,80,49,31,54
Copenhagen,7255,4,13,5,12,58,47,11,44
AaB,7255,5,8,13,9,36,39,-3,37
AC Horsens,7255,6,6,13,11,32,54,-22,31
Sonderjyske,7255,7,8,6,10,28,29,-1,30
Randers FC,7255,8,5,7,12,23,39,-16,22
Silkeborg IF,7255,9,6,3,13,30,46,-16,21
Lyngby,7255,10,3,10,11,26,44,-18,19
AGF Aarhus,7255,11,4,6,12,18,41,-23,18
Brondby,7256,1,22,6,2,77,33,44,72
FC Midtjylla,7256,2,20,5,5,64,37,27,65
FC Nords,7256,3,13,7,10,74,54,20,46
Copenhagen,7256,4,12,7,11,59,52,7,43
AaB,7256,5,7,13,10,37,45,-8,34
AC Horsens,7256,6,6,14,10,37,53,-16,32
Sonderjyske,7256,7,8,6,10,28,29,-1,30
Lyngby,7256,8,4,9,11,29,44,-15,21
Silkeborg IF,7256,9,6,3,13,26,44,-18,21
Randers FC,7256,10,5,6,13,23,42,-19,21
AGF Aarhus,7256,11,4,6,12,16,37,-21,18
Brondby,7257,1,21,6,3,72,30,42,69
FC Midtjylla,7257,2,19,6,5,64,37,27,63
FC Nords,7257,3,14,6,10,71,53,18,48
Copenhagen,7257,4,14,6,10,57,41,16,48
AaB,7257,5,7,13,10,37,43,-6,34
AC Horsens,7257,6,6,13,11,32,55,-23,31
Sonderjyske,7257,7,8,6,10,28,29,-1,30
Randers FC,7257,8,5,7,12,25,41,-16,22
AGF Aarhus,7257,9,5,6,11,20,38,-18,21
Lyngby,7257,10,3,10,11,28,46,-18,19
Silkeborg IF,7257,11,5,3,14,27,48,-21,18
Brondby,7258,1,22,5,3,79,37,42,71
FC Midtjylla,7258,2,18,4,8,60,41,19,58
FC Nords,7258,3,15,6,9,69,52,17,51
Copenhagen,7258,4,14,5,11,60,42,18,47
AaB,7258,5,8,11,11,36,42,-6,35
AC Horsens,7258,6,7,13,10,36,52,-16,34
Sonderjyske,7258,7,8,6,10,28,29,-1,30
Randers FC,7258,8,6,6,12,25,39,-14,24
AGF Aarhus,7258,9,5,6,11,18,37,-19,21
Lyngby,7258,10,3,9,12,26,46,-20,18
Silkeborg IF,7258,10,5,3,14,26,46,-20,18
Brondby,7259,1,22,5,3,71,28,43,71
FC Midtjylla,7259,2,20,5,5,62,35,27,65
FC Nords,7259,3,14,8,8,73,50,23,50
Copenhagen,7259,4,13,5,12,56,50,6,44
AaB,7259,5,7,13,10,39,41,-2,34
Sonderjyske,7259,6,8,6,10,28,29,-1,30
AC Horsens,7259,7,5,14,11,31,54,-23,29
Randers FC,7259,8,6,6,12,26,40,-14,24
AGF Aarhus,7259,9,5,6,11,18,37,-19,21
Lyngby,7259,10,3,9,12,27,47,-20,18
Silkeborg IF,7259,11,5,3,14,26,46,-20,18
Brondby,7260,1,23,5,2,72,31,41,74
FC Midtjylla,7260,2,20,4,6,67,39,28,64
FC Nords,7260,3,14,6,10,76,54,22,48
Copenhagen,7260,4,14,4,12,57,45,12,46
AaB,7260,5,7,12,11,35,43,-8,33
AC Horsens,7260,6,6,13,11,38,59,-21,31
Sonderjyske,7260,7,8,6,10,28,29,-1,30
Randers FC,7260,8,5,7,12,23,39,-16,22
Silkeborg IF,7260,9,6,3,13,27,45,-18,21
Lyngby,7260,10,3,10,11,26,44,-18,19
AGF Aarhus,7260,11,4,6,12,17,38,-21,18
Brondby,7261,1,22,5,3,72,33,39,71
FC Midtjylla,7261,2,20,5,5,66,38,28,65
Copenhagen,7261,3,15,5,10,61,43,18,50
FC Nords,7261,4,14,6,10,71,55,16,48
AC Horsens,7261,5,6,13,11,36,51,-15,31
Sonderjyske,7261,6,8,6,10,28,29,-1,30
AaB,7261,7,6,12,12,34,46,-12,30
Randers FC,7261,8,5,7,12,24,40,-16,22
Silkeborg IF,7261,9,6,3,13,28,45,-17,21
Lyngby,7261,10,3,10,11,27,45,-18,19
AGF Aarhus,7261,11,4,6,12,17,39,-22,18
FC Midtjylla,7262,1,21,5,4,67,37,30,68
Brondby,7262,2,20,7,3,69,32,37,67
FC Nords,7262,3,15,7,8,76,51,25,52
Copenhagen,7262,4,13,5,12,59,49,10,44
AaB,7262,5,7,14,9,36,40,-4,35
Sonderjyske,7262,6,8,6,10,28,29,-1,30
AC Horsens,7262,7,5,12,13,31,55,-24,27
Randers FC,7262,8,6,6,12,24,39,-15,24
Silkeborg IF,7262,9,6,3,13,26,44,-18,21
Lyngby,7262,10,3,9,12,26,45,-19,18
AGF Aarhus,7262,11,4,6,12,16,37,-21,18
Brondby,7263,1,20,7,3,68,33,35,67
FC Midtjylla,7263,2,20,6,4,65,34,31,66
Copenhagen,7263,3,15,4,11,60,46,14,49
FC Nords,7263,4,13,8,9,77,56,21,47
AaB,7263,5,7,12,11,39,46,-7,33
AC Horsens,7263,6,6,13,11,34,54,-20,31
Sonderjyske,7263,7,8,6,10,28,29,-1,30
Randers FC,7263,8,6,6,12,24,39,-15,24
Silkeborg IF,7263,9,6,3,13,26,44,-18,21
Lyngby,7263,10,3,9,12,26,45,-19,18
AGF Aarhus,7263,11,4,6,12,16,37,-21,18
Brondby,7264,1,21,6,3,74,35,39,69
FC Midtjylla,7264,2,21,4,5,74,39,35,67
FC Nords,7264,3,14,6,10,74,58,16,48
Copenhagen,7264,4,13,6,11,56,45,11,45
AaB,7264,5,8,12,10,37,41,-4,36
Sonderjyske,7264,6,8,6,10,28,29,-1,30
AC Horsens,7264,7,5,14,11,34,57,-23,29
Lyngby,7264,8,4,9,11,28,45,-17,21
Randers FC,7264,9,5,6,13,24,41,-17,21
Silkeborg IF,7264,10,6,3,13,28,46,-18,21
AGF Aarhus,7264,11,4,6,12,18,39,-21,18
Brondby,7265,1,20,7,3,70,35,35,67
FC Midtjylla,7265,2,19,4,7,60,37,23,61
FC Nords,7265,3,15,6,9,76,51,25,51
Copenhagen,7265,4,14,5,11,60,46,14,47
AaB,7265,5,8,12,10,37,43,-6,36
AC Horsens,7265,6,6,14,10,35,52,-17,32
Sonderjyske,7265,7,8,6,10,28,29,-1,30
Randers FC,7265,8,5,7,12,25,41,-16,22
Silkeborg IF,7265,9,6,3,13,26,44,-18,21
Lyngby,7265,10,3,10,11,28,46,-18,19
AGF Aarhus,7265,11,4,6,12,16,37,-21,18
Brondby,7266,1,21,6,3,73,32,41,69
FC Midtjylla,7266,2,20,4,6,64,36,28,64
FC Nords,7266,3,15,7,8,74,46,28,52
Copenhagen,7266,4,15,5,10,57,41,16,50
AC Horsens,7266,5,6,13,11,34,52,-18,31
Sonderjyske,7266,6,8,6,10,28,29,-1,30
AaB,7266,7,6,11,13,34,55,-21,29
Randers FC,7266,8,5,7,12,24,40,-16,22
Silkeborg IF,7266,9,6,3,13,28,44,-16,21
Lyngby,7266,10,3,10,11,27,45,-18,19
AGF Aarhus,7266,11,4,6,12,16,39,-23,18
Brondby,7267,1,22,5,3,73,32,41,71
FC Midtjylla,7267,2,21,5,4,69,39,30,68
FC Nords,7267,3,14,7,9,76,52,24,49
Copenhagen,7267,4,12,4,14,56,52,4,40
AaB,7267,5,8,13,9,36,39,-3,37
Sonderjyske,7267,6,8,6,10,28,29,-1,30
AC Horsens,7267,7,6,12,12,38,60,-22,30
Randers FC,7267,8,6,6,12,24,39,-15,24
AGF Aarhus,7267,9,5,6,11,17,36,-19,21
Lyngby,7267,10,3,9,12,26,45,-19,18
Silkeborg IF,7267,11,5,3,14,25,45,-20,18
Brondby,7268,1,23,5,2,74,31,43,74
FC Midtjylla,7268,2,19,5,6,65,40,25,62
FC Nords,7268,3,15,6,9,78,53,25,51
Copenhagen,7268,4,14,5,11,56,44,12,47
AaB,7268,5,7,11,12,37,47,-10,32
Sonderjyske,7268,6,8,6,10,28,29,-1,30
AC Horsens,7268,7,5,14,11,33,54,-21,29
Randers FC,7268,8,6,6,12,25,40,-15,24
Silkeborg IF,7268,9,6,3,13,27,45,-18,21
Lyngby,7268,10,3,9,12,27,46,-19,18
AGF Aarhus,7268,11,4,6,12,17,38,-21,18
Brondby,7269,1,21,6,3,75,33,42,69
FC Midtjylla,7269,2,20,4,6,67,38,29,64
Copenhagen,7269,3,15,5,10,60,45,15,50
FC Nords,7269,4,13,7,10,71,53,18,46
AaB,7269,5,8,12,10,38,47,-9,36
Sonderjyske,7269,6,8,6,10,28,29,-1,30
AC Horsens,7269,7,6,12,12,34,55,-21,30
Lyngby,7269,8,4,9,11,27,44,-17,21
Silkeborg IF,7269,8,6,3,13,27,44,-17,21
Randers FC,7269,10,5,6,13,23,40,-17,21
AGF Aarhus,7269,11,4,6,12,16,38,-22,18
Brondby,7270,1,19,8,3,66,30,36,65
FC Midtjylla,7270,2,17,6,7,61,43,18,57
Copenhagen,7270,3,16,4,10,60,40,20,52
FC Nords,7270,4,14,7,9,74,53,21,49
AaB,7270,5,8,13,9,38,41,-3,37
AC Horsens,7270,6,6,14,10,35,53,-18,32
Sonderjyske,7270,7,8,6,10,28,29,-1,30
Lyngby,7270,8,4,9,11,30,44,-14,21
AGF Aarhus,7270,9,5,6,11,17,36,-19,21
Randers FC,7270,10,5,6,13,23,43,-20,21
Silkeborg IF,7270,11,5,3,14,25,45,-20,18
Brondby,7271,1,22,5,3,70,30,40,71
FC Midtjylla,7271,2,20,5,5,69,38,31,65
Copenhagen,7271,3,15,5,10,62,45,17,50
FC Nords,7271,4,12,7,11,71,58,13,43
AC Horsens,7271,5,8,12,10,39,55,-16,36
Sonderjyske,7271,6,8,6,10,28,29,-1,30
AaB,7271,7,6,12,12,35,46,-11,30
Randers FC,7271,8,6,6,12,25,39,-14,24
Silkeborg IF,7271,9,6,3,13,28,44,-16,21
Lyngby,7271,10,3,9,12,26,46,-20,18
AGF Aarhus,7271,11,4,6,12,16,39,-23,18
Brondby,7272,1,22,5,3,77,33,44,71
FC Midtjylla,7272,2,22,4,4,71,38,33,70
FC Nords,7272,3,14,7,9,72,52,20,49
Copenhagen,7272,4,13,6,11,56,46,10,45
AaB,7272,5,7,11,12,36,49,-13,32
Sonderjyske,7272,6,8,6,10,28,29,-1,30
AC Horsens,7272,7,5,13,12,31,51,-20,28
Randers FC,7272,8,5,7,12,23,39,-16,22
Silkeborg IF,7272,9,6,3,13,27,45,-18,21
Lyngby,7272,10,3,10,11,26,44,-18,19
AGF Aarhus,7272,11,4,6,12,17,38,-21,18
Brondby,7273,1,20,6,4,68,33,35,66
FC Midtjylla,7273,2,20,4,6,67,37,30,64
Copenhagen,7273,3,14,6,10,58,43,15,48
FC Nords,7273,4,13,7,10,71,53,18,46
AC Horsens,7273,5,8,12,10,37,52,-15,36
AaB,7273,6,8,11,11,38,47,-9,35
Sonderjyske,7273,7,8,6,10,28,29,-1,30
Lyngby,7273,8,4,9,11,29,44,-15,21
Silkeborg IF,7273,9,6,3,13,27,45,-18,21
Randers FC,7273,10,5,6,13,23,42,-19,21
AGF Aarhus,7273,11,4,6,12,17,38,-21,18
FC Midtjylla,7274,1,21,4,5,70,37,33,67
Brondby,7274,2,20,6,4,69,33,36,66
FC Nords,7274,3,13,8,9,66,52,14,47
Copenhagen,7274,4,13,6,11,54,42,12,45
AaB,7274,5,8,12,10,37,41,-4,36
AC Horsens,7274,6,5,16,9,33,50,-17,31
Sonderjyske,7274,7,8,6,10,28,29,-1,30
Randers FC,7274,8,6,6,12,25,39,-14,24
Silkeborg IF,7274,9,5,4,13,26,45,-19,19
AGF Aarhus,7274,10,4,7,11,17,37,-20,19
Lyngby,7274,11,3,9,12,26,46,-20,18
Brondby,7275,1,20,5,5,67,32,35,65
FC Midtjylla,7275,2,19,6,5,63,37,26,63
Copenhagen,7275,3,15,5,10,59,42,17,50
FC Nords,7275,4,14,7,9,73,53,20,49
AC Horsens,7275,5,8,12,10,38,53,-15,36
AaB,7275,6,6,13,11,33,42,-9,31
Sonderjyske,7275,7,8,6,10,28,29,-1,30
Randers FC,7275,8,6,6,12,25,39,-14,24
AGF Aarhus,7275,9,5,6,11,18,37,-19,21
Lyngby,7275,10,3,9,12,26,46,-20,18
Silkeborg IF,7275,10,5,3,14,26,46,-20,18
Brondby,7276,1,19,8,3,68,34,34,65
FC Midtjylla,7276,2,18,6,6,61,42,19,60
Copenhagen,7276,3,14,6,10,59,42,17,48
FC Nords,7276,4,13,8,9,72,52,20,47
AaB,7276,5,8,13,9,40,41,-1,37
AC Horsens,7276,6,7,13,10,34,49,-15,34
Sonderjyske,7276,7,8,6,10,28,29,-1,30
Lyngby,7276,8,4,9,11,29,44,-15,21
Randers FC,7276,9,5,6,13,23,42,-19,21
AGF Aarhus,7276,10,5,6,11,17,36,-19,21
Silkeborg IF,7276,11,5,3,14,25,45,-20,18
Brondby,7277,1,21,7,2,71,30,41,70
FC Midtjylla,7277,2,20,4,6,66,40,26,64
FC Nords,7277,3,14,8,8,71,49,22,50
Copenhagen,7277,4,13,5,12,55,45,10,44
AC Horsens,7277,5,7,13,10,32,49,-17,34
AaB,7277,6,7,11,12,37,45,-8,32
Sonderjyske,7277,7,8,6,10,28,29,-1,30
Lyngby,7277,8,4,9,11,27,44,-17,21
Randers FC,7277,9,5,6,13,23,40,-17,21
AGF Aarhus,7277,10,5,6,11,17,36,-19,21
Silkeborg IF,7277,11,5,3,14,25,45,-20,18
Brondby,7278,1,20,8,2,68,31,37,68
FC Midtjylla,7278,2,20,5,5,68,40,28,65
FC Nords,7278,3,15,6,9,73,50,23,51
Copenhagen,7278,4,12,5,13,56,50,6,41
AaB,7278,5,8,11,11,40,45,-5,35
AC Horsens,7278,6,7,13,10,37,52,-15,34
Sonderjyske,7278,7,8,6,10,28,29,-1,30
Lyngby,7278,8,4,9,11,28,45,-17,21
Randers FC,7278,9,5,6,13,24,41,-17,21
Silkeborg IF,7278,10,5,4,13,25,44,-19,19
AGF Aarhus,7278,11,4,7,11,16,36,-20,19
Brondby,7279,1,22,5,3,73,31,42,71
FC Midtjylla,7279,2,19,5,6,63,37,26,62
FC Nords,7279,3,13,7,10,73,54,19,46
Copenhagen,7279,4,13,7,10,53,41,12,46
AaB,7279,5,7,14,9,37,45,-8,35
AC Horsens,7279,6,6,14,10,34,51,-17,32
Sonderjyske,7279,7,8,6,10,28,29,-1,30
Lyngby,7279,8,4,9,11,29,45,-16,21
Randers FC,7279,9,5,6,13,24,42,-18,21
Silkeborg IF,7279,10,5,4,13,26,45,-19,19
AGF Aarhus,7279,11,4,7,11,17,37,-20,19
Brondby,7280,1,21,7,2,68,30,38,70
FC Midtjylla,7280,2,20,5,5,65,37,28,65
Copenhagen,7280,3,15,5,10,58,40,18,50
FC Nords,7280,4,14,6,10,71,52,19,48
AC Horsens,7280,5,7,12,11,37,56,-19,33
Sonderjyske,7280,6,8,6,10,28,29,-1,30
AaB,7280,7,6,11,13,34,44,-10,29
Randers FC,7280,8,6,6,12,26,40,-14,24
Silkeborg IF,7280,9,5,4,13,26,45,-19,19
AGF Aarhus,7280,10,4,7,11,17,37,-20,19
Lyngby,7280,11,3,9,12,27,47,-20,18
Brondby,7281,1,21,6,3,71,30,41,69
FC Midtjylla,7281,2,21,4,5,70,39,31,67
FC Nords,7281,3,14,7,9,71,53,18,49
Copenhagen,7281,4,13,5,12,55,45,10,44
AaB,7281,5,8,13,9,39,43,-4,37
Sonderjyske,7281,6,8,6,10,28,29,-1,30
AC Horsens,7281,7,5,13,12,31,53,-22,28
Randers FC,7281,8,5,7,12,23,39,-16,22
Silkeborg IF,7281,9,6,3,13,27,45,-18,21
Lyngby,7281,10,3,10,11,26,44,-18,19
AGF Aarhus,7281,11,4,6,12,17,38,-21,18
Brondby,7282,1,23,5,2,74,30,44,74
FC Midtjylla,7282,2,19,4,7,66,42,24,61
FC Nords,7282,3,14,7,9,79,57,22,49
Copenhagen,7282,4,14,4,12,61,49,12,46
AaB,7282,5,7,12,11,36,44,-8,33
AC Horsens,7282,6,6,14,10,34,54,-20,32
Sonderjyske,7282,7,8,6,10,28,29,-1,30
Randers FC,7282,8,5,7,12,25,41,-16,22
Silkeborg IF,7282,9,6,3,13,27,45,-18,21
Lyngby,7282,10,3,10,11,28,46,-18,19
AGF Aarhus,7282,11,4,6,12,17,38,-21,18
Brondby,7283,1,21,6,3,73,30,43,69
FC Midtjylla,7283,2,20,4,6,68,40,28,64
FC Nords,7283,3,13,7,10,70,58,12,46
Copenhagen,7283,4,13,4,13,52,47,5,43
AaB,7283,5,9,12,9,43,41,2,39
AC Horsens,7283,6,6,15,9,37,53,-16,33
Sonderjyske,7283,7,8,6,10,28,29,-1,30
Lyngby,7283,8,4,9,11,29,44,-15,21
Randers FC,7283,9,5,6,13,23,42,-19,21
Silkeborg IF,7283,10,5,4,13,25,44,-19,19
AGF Aarhus,7283,11,4,7,11,16,36,-20,19
FC Midtjylla,7284,1,21,4,5,66,39,27,67
Brondby,7284,2,19,6,5,70,38,32,63
FC Nords,7284,3,15,7,8,74,51,23,52
Copenhagen,7284,4,13,4,13,54,45,9,43
AC Horsens,7284,5,8,12,10,40,53,-13,36
AaB,7284,6,8,11,11,42,46,-4,35
Sonderjyske,7284,7,8,6,10,28,29,-1,30
Randers FC,7284,8,6,6,12,24,39,-15,24
Silkeborg IF,7284,9,6,3,13,27,45,-18,21
Lyngby,7284,10,3,9,12,26,45,-19,18
AGF Aarhus,7284,11,4,6,12,17,38,-21,18
Brondby,7285,1,22,6,2,78,30,48,72
FC Midtjylla,7285,2,18,6,6,62,40,22,60
Copenhagen,7285,3,15,4,11,60,43,17,49
FC Nords,7285,4,13,8,9,73,61,12,47
AaB,7285,5,7,13,10,39,45,-6,34
Sonderjyske,7285,6,8,6,10,28,29,-1,30
AC Horsens,7285,7,5,15,10,36,55,-19,30
Lyngby,7285,8,4,9,11,27,44,-17,21
Randers FC,7285,9,5,6,13,23,40,-17,21
AGF Aarhus,7285,10,5,6,11,19,37,-18,21
Silkeborg IF,7285,11,5,3,14,26,47,-21,18
Brondby,7286,1,20,6,4,68,34,34,66
FC Midtjylla,7286,2,19,6,5,63,35,28,63
Copenhagen,7286,3,14,4,12,57,46,11,46
FC Nords,7286,4,12,7,11,69,53,16,43
AaB,7286,5,9,12,9,38,40,-2,39
AC Horsens,7286,6,8,13,9,39,52,-13,37
Sonderjyske,7286,7,8,6,10,28,29,-1,30
Lyngby,7286,8,4,9,11,29,45,-16,21
Randers FC,7286,9,5,6,13,24,42,-18,21
Silkeborg IF,7286,10,5,4,13,27,46,-19,19
AGF Aarhus,7286,11,4,7,11,18,38,-20,19
Brondby,7287,1,20,7,3,68,30,38,67
FC Midtjylla,7287,2,19,5,6,61,38,23,62
Copenhagen,7287,3,14,6,10,62,44,18,48
FC Nords,7287,4,12,7,11,67,51,16,43
AaB,7287,5,9,11,10,41,43,-2,38
AC Horsens,7287,6,8,12,10,35,54,-19,36
Sonderjyske,7287,7,8,6,10,28,29,-1,30
Randers FC,7287,8,5,7,12,25,41,-16,22
Silkeborg IF,7287,9,6,3,13,28,46,-18,21
Lyngby,7287,10,3,10,11,28,46,-18,19
AGF Aarhus,7287,11,4,6,12,18,39,-21,18
Brondby,7288,1,22,5,3,71,33,38,71
FC Midtjylla,7288,2,20,4,6,65,38,27,64
Copenhagen,7288,3,15,4,11,60,46,14,49
FC Nords,7288,4,13,6,11,74,58,16,45
AC Horsens,7288,5,7,13,10,38,52,-14,34
AaB,7288,6,7,12,11,35,42,-7,33
Sonderjyske,7288,7,8,6,10,28,29,-1,30
Randers FC,7288,8,6,6,12,26,40,-14,24
Silkeborg IF,7288,9,6,3,13,28,46,-18,21
Lyngby,7288,10,3,9,12,27,47,-20,18
AGF Aarhus,7288,11,4,6,12,18,39,-21,18
Brondby,7289,1,20,7,3,72,35,37,67
FC Midtjylla,7289,2,19,6,5,65,41,24,63
FC Nords,7289,3,15,6,9,77,51,26,51
Copenhagen,7289,4,13,5,12,57,48,9,44
AaB,7289,5,9,12,9,45,46,-1,39
Sonderjyske,7289,6,8,6,10,28,29,-1,30
AC Horsens,7289,7,5,14,11,34,55,-21,29
Randers FC,7289,8,5,7,12,23,39,-16,22
Silkeborg IF,7289,9,6,3,13,27,45,-18,21
Lyngby,7289,10,3,10,11,26,44,-18,19
AGF Aarhus,7289,11,4,6,12,17,38,-21,18
Brondby,7290,1,21,6,3,71,33,38,69
FC Midtjylla,7290,2,18,5,7,62,41,21,59
FC Nords,7290,3,14,7,9,73,51,22,49
Copenhagen,7290,4,14,5,11,59,46,13,47
AC Horsens,7290,5,8,12,10,38,54,-16,36
AaB,7290,6,7,13,10,37,41,-4,34
Sonderjyske,7290,7,8,6,10,28,29,-1,30
Lyngby,7290,8,4,9,11,30,45,-15,21
Randers FC,7290,9,5,6,13,24,43,-19,21
AGF Aarhus,7290,10,5,6,11,17,36,-19,21
Silkeborg IF,7290,11,5,3,14,25,45,-20,18
Brondby,7291,1,23,5,2,75,30,45,74
FC Midtjylla,7291,2,18,5,7,63,40,23,59
Copenhagen,7291,3,15,5,10,60,43,17,50
FC Nords,7291,4,13,7,10,67,51,16,46
AaB,7291,5,8,12,10,38,44,-6,36
Sonderjyske,7291,6,8,6,10,28,29,-1,30
AC Horsens,7291,7,6,12,12,33,54,-21,30
Randers FC,7291,8,5,7,12,25,41,-16,22
AGF Aarhus,7291,9,5,6,11,18,36,-18,21
Lyngby,7291,10,3,10,11,28,46,-18,19
Silkeborg IF,7291,11,5,3,14,25,46,-21,18
Brondby,7292,1,21,5,4,72,34,38,68
FC Midtjylla,7292,2,19,4,7,66,43,23,61
FC Nords,7292,3,15,6,9,75,52,23,51
Copenhagen,7292,4,14,6,10,60,46,14,48
AC Horsens,7292,5,7,13,10,33,49,-16,34
AaB,7292,6,7,12,11,38,46,-8,33
Sonderjyske,7292,7,8,6,10,28,29,-1,30
Silkeborg IF,7292,8,6,3,13,30,44,-14,21
Lyngby,7292,9,4,9,11,27,44,-17,21
Randers FC,7292,10,5,6,13,23,40,-17,21
AGF Aarhus,7292,11,4,6,12,16,41,-25,18
Brondby,7293,1,19,7,4,73,38,35,64
FC Midtjylla,7293,2,19,5,6,69,44,25,62
FC Nords,7293,3,14,8,8,72,49,23,50
Copenhagen,7293,4,12,8,10,54,44,10,44
AaB,7293,5,9,12,9,40,42,-2,39
AC Horsens,7293,6,6,14,10,35,52,-17,32
Sonderjyske,7293,7,8,6,10,28,29,-1,30
Lyngby,7293,8,4,9,11,27,44,-17,21
Randers FC,7293,9,5,6,13,23,40,-17,21
Silkeborg IF,7293,10,6,3,13,27,45,-18,21
AGF Aarhus,7293,11,4,6,12,17,38,-21,18
Brondby,7294,1,21,6,3,72,33,39,69
FC Midtjylla,7294,2,19,4,7,64,39,25,61
FC Nords,7294,3,14,7,9,73,51,22,49
Copenhagen,7294,4,14,4,12,59,48,11,46
AC Horsens,7294,5,8,12,10,39,51,-12,36
AaB,7294,6,8,11,11,38,49,-11,35
Sonderjyske,7294,7,8,6,10,28,29,-1,30
Randers FC,7294,8,6,6,12,26,40,-14,24
AGF Aarhus,7294,9,5,6,11,19,37,-18,21
Lyngby,7294,10,3,9,12,27,47,-20,18
Silkeborg IF,7294,11,5,3,14,26,47,-21,18
Brondby,7295,1,23,5,2,74,28,46,74
FC Midtjylla,7295,2,19,5,6,63,39,24,62
FC Nords,7295,3,14,8,8,69,47,22,50
Copenhagen,7295,4,13,4,13,52,45,7,43
AC Horsens,7295,5,7,13,10,35,49,-14,34
AaB,7295,6,6,13,11,34,45,-11,31
Sonderjyske,7295,7,8,6,10,28,29,-1,30
Randers FC,7295,8,5,7,12,23,39,-16,22
Lyngby,7295,9,3,10,11,26,44,-18,19
Silkeborg IF,7295,10,5,4,13,25,44,-19,19
AGF Aarhus,7295,11,4,7,11,16,36,-20,19
Brondby,7296,1,21,6,3,70,33,37,69
FC Midtjylla,7296,2,21,5,4,71,38,33,68
FC Nords,7296,3,14,7,9,73,51,22,49
Copenhagen,7296,4,13,7,10,57,45,12,46
AaB,7296,5,7,11,12,39,44,-5,32
Sonderjyske,7296,6,8,6,10,28,29,-1,30
AC Horsens,7296,7,5,14,11,31,56,-25,29
Randers FC,7296,8,5,7,12,24,40,-16,22
Lyngby,7296,9,3,10,11,27,45,-18,19
Silkeborg IF,7296,10,5,4,13,27,46,-19,19
AGF Aarhus,7296,11,4,7,11,18,38,-20,19
Brondby,7297,1,21,5,4,70,35,35,68
FC Midtjylla,7297,2,18,6,6,66,39,27,60
FC Nords,7297,3,16,6,8,71,46,25,54
Copenhagen,7297,4,13,7,10,55,43,12,46
AaB,7297,5,7,13,10,37,41,-4,34
AC Horsens,7297,6,6,13,11,34,55,-21,31
Sonderjyske,7297,7,8,6,10,28,29,-1,30
Randers FC,7297,8,6,6,12,26,39,-13,24
AGF Aarhus,7297,9,5,6,11,18,37,-19,21
Silkeborg IF,7297,10,5,3,14,26,46,-20,18
Lyngby,7297,11,3,9,12,26,47,-21,18
Brondby,7298,1,20,7,3,72,36,36,67
FC Midtjylla,7298,2,20,6,4,68,37,31,66
FC Nords,7298,3,15,6,9,72,54,18,51
Copenhagen,7298,4,12,6,12,57,47,10,42
AC Horsens,7298,5,7,13,10,38,52,-14,34
AaB,7298,6,7,12,11,36,43,-7,33
Sonderjyske,7298,7,8,6,10,28,29,-1,30
Randers FC,7298,8,5,7,12,23,39,-16,22
Silkeborg IF,7298,9,6,3,13,28,44,-16,21
Lyngby,7298,10,3,10,11,26,44,-18,19
AGF Aarhus,7298,11,4,6,12,16,39,-23,18
Brondby,7299,1,21,6,3,73,32,41,69
FC Midtjylla,7299,2,20,6,4,67,39,28,66
FC Nords,7299,3,13,9,8,71,49,22,48
Copenhagen,7299,4,12,7,11,56,47,9,43
AaB,7299,5,7,13,10,36,43,-7,34
Sonderjyske,7299,6,8,6,10,28,29,-1,30
AC Horsens,7299,7,5,15,10,35,54,-19,30
Randers FC,7299,8,6,6,12,25,40,-15,24
Silkeborg IF,7299,9,6,3,13,28,44,-16,21
Lyngby,7299,10,3,9,12,27,46,-19,18
AGF Aarhus,7299,11,4,6,12,16,39,-23,18
Brondby,7300,1,20,7,3,69,32,37,67
FC Midtjylla,7300,2,19,6,5,63,35,28,63
FC Nords,7300,3,14,8,8,73,50,23,50
Copenhagen,7300,4,12,5,13,59,53,6,41
AaB,7300,5,9,12,9,40,43,-3,39
AC Horsens,7300,6,6,14,10,34,51,-17,32
Sonderjyske,7300,7,8,6,10,28,29,-1,30
Lyngby,7300,8,4,9,11,28,44,-16,21
Randers FC,7300,9,5,6,13,23,41,-18,21
AGF Aarhus,7300,10,5,6,11,19,38,-19,21
Silkeborg IF,7300,11,5,3,14,27,47,-20,18
Brondby,7301,1,21,6,3,75,34,41,69
FC Midtjylla,7301,2,17,7,6,63,43,20,58
FC Nords,7301,3,14,8,8,74,55,19,50
Copenhagen,7301,4,14,5,11,56,42,14,47
AaB,7301,5,8,12,10,38,41,-3,36
AC Horsens,7301,6,6,14,10,33,50,-17,32
Sonderjyske,7301,7,8,6,10,28,29,-1,30
Randers FC,7301,8,5,7,12,24,40,-16,22
Lyngby,7301,9,3,10,11,27,45,-18,19
Silkeborg IF,7301,10,5,4,13,25,44,-19,19
AGF Aarhus,7301,11,4,7,11,16,36,-20,19
Brondby,7302,1,20,7,3,69,32,37,67
FC Midtjylla,7302,2,18,5,7,62,46,16,59
FC Nords,7302,3,15,8,7,73,48,25,53
Copenhagen,7302,4,13,4,13,59,46,13,43
AaB,7302,5,8,13,9,40,43,-3,37
AC Horsens,7302,6,7,13,10,37,51,-14,34
Sonderjyske,7302,7,8,6,10,28,29,-1,30
Randers FC,7302,8,5,7,12,25,41,-16,22
Silkeborg IF,7302,9,6,3,13,28,45,-17,21
Lyngby,7302,10,3,10,11,28,46,-18,19
AGF Aarhus,7302,11,4,6,12,17,39,-22,18
Brondby,7303,1,21,7,2,74,28,46,70
FC Midtjylla,7303,2,18,7,5,62,41,21,61
FC Nords,7303,3,13,7,10,72,55,17,46
Copenhagen,7303,4,14,4,12,59,46,13,46
AaB,7303,5,9,13,8,40,40,0,40
Sonderjyske,7303,6,8,6,10,28,29,-1,30
AC Horsens,7303,7,5,14,11,33,56,-23,29
Lyngby,7303,8,4,9,11,28,45,-17,21
Randers FC,7303,9,5,6,13,24,41,-17,21
Silkeborg IF,7303,10,6,3,13,27,45,-18,21
AGF Aarhus,7303,11,4,6,12,17,38,-21,18
Brondby,7304,1,20,7,3,69,33,36,67
FC Midtjylla,7304,2,19,6,5,64,39,25,63
FC Nords,7304,3,15,6,9,78,52,26,51
Copenhagen,7304,4,15,5,10,58,44,14,50
AaB,7304,5,7,11,12,35,43,-8,32
AC Horsens,7304,6,6,13,11,34,53,-19,31
Sonderjyske,7304,7,8,6,10,28,29,-1,30
Randers FC,7304,8,5,7,12,23,39,-16,22
Lyngby,7304,9,3,10,11,26,44,-18,19
Silkeborg IF,7304,10,5,4,13,26,45,-19,19
AGF Aarhus,7304,11,4,7,11,17,37,-20,19
Brondby,7305,1,20,5,5,69,33,36,65
FC Midtjylla,7305,2,19,5,6,59,39,20,62
FC Nords,7305,3,15,7,8,76,48,28,52
Copenhagen,7305,4,13,7,10,52,41,11,46
AaB,7305,5,8,13,9,36,39,-3,37
AC Horsens,7305,6,6,13,11,33,51,-18,31
Sonderjyske,7305,7,8,6,10,28,29,-1,30
Randers FC,7305,8,6,6,12,25,40,-15,24
AGF Aarhus,7305,9,5,6,11,18,37,-19,21
Lyngby,7305,10,3,9,12,27,46,-19,18
Silkeborg IF,7305,11,5,3,14,26,46,-20,18
Brondby,7306,1,20,7,3,71,33,38,67
FC Midtjylla,7306,2,19,6,5,65,42,23,63
FC Nords,7306,3,15,7,8,78,52,26,52
Copenhagen,7306,4,14,4,12,59,48,11,46
AaB,7306,5,7,12,11,37,44,-7,33
AC Horsens,7306,6,6,14,10,38,55,-17,32
Sonderjyske,7306,7,8,6,10,28,29,-1,30
Randers FC,7306,8,6,6,12,29,41,-12,24
AGF Aarhus,7306,9,5,6,11,18,37,-19,21
Silkeborg IF,7306,10,5,3,14,26,46,-20,18
Lyngby,7306,11,3,9,12,28,50,-22,18
Brondby,7307,1,21,6,3,71,32,39,69
FC Midtjylla,7307,2,20,6,4,67,37,30,66
FC Nords,7307,3,14,6,10,76,55,21,48
Copenhagen,7307,4,13,4,13,54,44,10,43
AC Horsens,7307,5,8,12,10,37,52,-15,36
AaB,7307,6,7,12,11,36,47,-11,33
Sonderjyske,7307,7,8,6,10,28,29,-1,30
Lyngby,7307,8,4,9,11,28,44,-16,21
Silkeborg IF,7307,9,6,3,13,27,45,-18,21
Randers FC,7307,10,5,6,13,23,41,-18,21
AGF Aarhus,7307,11,4,6,12,17,38,-21,18
Brondby,7308,1,22,5,3,73,30,43,71
FC Midtjylla,7308,2,21,4,5,70,38,32,67
FC Nords,7308,3,14,6,10,73,57,16,48
Copenhagen,7308,4,13,5,12,58,49,9,44
AC Horsens,7308,5,7,13,10,39,57,-18,34
AaB,7308,6,7,11,12,40,48,-8,32
Sonderjyske,7308,7,8,6,10,28,29,-1,30
Randers FC,7308,8,5,7,12,24,40,-16,22
Silkeborg IF,7308,9,6,3,13,28,45,-17,21
Lyngby,7308,10,3,10,11,27,45,-18,19
AGF Aarhus,7308,11,4,6,12,17,39,-22,18
Brondby,7309,1,21,5,4,70,35,35,68
FC Midtjylla,7309,2,19,4,7,69,43,26,61
Copenhagen,7309,3,17,4,9,65,41,24,55
FC Nords,7309,4,14,6,10,75,54,21,48
AaB,7309,5,8,11,11,38,47,-9,35
Sonderjyske,7309,6,8,6,10,28,29,-1,30
AC Horsens,7309,7,6,12,12,34,57,-23,30
Lyngby,7309,8,4,9,11,29,44,-15,21
Silkeborg IF,7309,9,6,3,13,26,44,-18,21
Randers FC,7309,10,5,6,13,23,42,-19,21
AGF Aarhus,7309,11,4,6,12,16,37,-21,18
Brondby,7310,1,23,5,2,68,28,40,74
FC Midtjylla,7310,2,18,6,6,64,41,23,60
Copenhagen,7310,3,14,4,12,59,48,11,46
FC Nords,7310,4,12,9,9,72,53,19,45
AC Horsens,7310,5,7,14,9,36,49,-13,35
AaB,7310,6,7,12,11,37,43,-6,33
Sonderjyske,7310,7,8,6,10,28,29,-1,30
Randers FC,7310,8,5,7,12,23,39,-16,22
AGF Aarhus,7310,9,5,6,11,17,36,-19,21
Lyngby,7310,10,3,10,11,26,44,-18,19
Silkeborg IF,7310,11,5,3,14,25,45,-20,18
Brondby,7311,1,21,7,2,72,31,41,70
FC Midtjylla,7311,2,19,5,6,64,41,23,62
FC Nords,7311,3,14,8,8,73,51,22,50
Copenhagen,7311,4,13,5,12,55,46,9,44
AaB,7311,5,8,12,10,37,40,-3,36
AC Horsens,7311,6,6,13,11,35,53,-18,31
Sonderjyske,7311,7,8,6,10,28,29,-1,30
Randers FC,7311,8,6,6,12,24,39,-15,24
Silkeborg IF,7311,9,6,3,13,26,44,-18,21
Lyngby,7311,10,3,9,12,26,45,-19,18
AGF Aarhus,7311,11,4,6,12,16,37,-21,18
Brondby,7312,1,22,5,3,73,31,42,71
FC Midtjylla,7312,2,21,4,5,70,37,33,67
Copenhagen,7312,3,15,5,10,58,44,14,50
FC Nords,7312,4,13,6,11,69,54,15,45
AaB,7312,5,8,12,10,34,41,-7,36
Sonderjyske,7312,6,8,6,10,28,29,-1,30
AC Horsens,7312,7,5,12,13,30,53,-23,27
Randers FC,7312,8,5,7,12,24,40,-16,22
Silkeborg IF,7312,9,6,3,13,27,44,-17,21
Lyngby,7312,10,3,10,11,27,45,-18,19
AGF Aarhus,7312,11,4,6,12,16,38,-22,18
Brondby,7313,1,22,5,3,76,33,43,71
FC Midtjylla,7313,2,21,5,4,69,38,31,68
FC Nords,7313,3,13,8,9,75,55,20,47
Copenhagen,7313,4,13,6,11,57,47,10,45
AaB,7313,5,8,12,10,35,41,-6,36
Sonderjyske,7313,6,8,6,10,28,29,-1,30
AC Horsens,7313,7,5,12,13,30,54,-24,27
Randers FC,7313,8,5,7,12,24,40,-16,22
Silkeborg IF,7313,9,6,3,13,28,46,-18,21
Lyngby,7313,10,3,10,11,27,45,-18,19
AGF Aarhus,7313,11,4,6,12,18,39,-21,18
Brondby,7314,1,21,6,3,73,30,43,69
FC Midtjylla,7314,2,19,5,6,64,39,25,62
FC Nords,7314,3,14,7,9,72,52,20,49
Copenhagen,7314,4,13,5,12,56,46,10,44
AC Horsens,7314,5,8,12,10,33,50,-17,36
AaB,7314,6,8,11,11,36,43,-7,35
Sonderjyske,7314,7,8,6,10,28,29,-1,30
Randers FC,7314,8,6,6,12,25,39,-14,24
Silkeborg IF,7314,9,6,3,13,27,44,-17,21
Lyngby,7314,10,3,9,12,26,46,-20,18
AGF Aarhus,7314,11,4,6,12,16,38,-22,18
Brondby,7315,1,20,5,5,70,37,33,65
FC Midtjylla,7315,2,20,4,6,68,40,28,64
FC Nords,7315,3,14,8,8,73,49,24,50
Copenhagen,7315,4,13,6,11,55,46,9,45
AC Horsens,7315,5,7,14,9,35,51,-16,35
AaB,7315,6,7,13,10,38,42,-4,34
Sonderjyske,7315,7,8,6,10,28,29,-1,30
Lyngby,7315,8,4,9,11,31,44,-13,21
Silkeborg IF,7315,9,6,3,13,27,45,-18,21
Randers FC,7315,10,5,6,13,23,44,-21,21
AGF Aarhus,7315,11,4,6,12,17,38,-21,18
Brondby,7316,1,20,5,5,72,36,36,65
FC Midtjylla,7316,2,20,4,6,64,43,21,64
FC Nords,7316,3,14,6,10,75,54,21,48
Copenhagen,7316,4,14,5,11,61,45,16,47
AaB,7316,5,10,12,8,41,39,2,42
Sonderjyske,7316,6,8,6,10,28,29,-1,30
AC Horsens,7316,7,6,12,12,30,52,-22,30
Lyngby,7316,8,4,9,11,28,44,-16,21
Silkeborg IF,7316,9,6,3,13,27,44,-17,21
Randers FC,7316,10,5,6,13,23,41,-18,21
AGF Aarhus,7316,11,4,6,12,16,38,-22,18
Brondby,7317,1,21,6,3,71,30,41,69
FC Midtjylla,7317,2,20,6,4,71,37,34,66
FC Nords,7317,3,14,6,10,74,57,17,48
Copenhagen,7317,4,12,6,12,59,50,9,42
AC Horsens,7317,5,8,12,10,40,56,-16,36
AaB,7317,6,7,12,11,37,48,-11,33
Sonderjyske,7317,7,8,6,10,28,29,-1,30
Lyngby,7317,8,4,9,11,27,44,-17,21
Randers FC,7317,9,5,6,13,23,40,-17,21
Silkeborg IF,7317,10,5,4,13,25,44,-19,19
AGF Aarhus,7317,11,4,7,11,16,36,-20,19
Brondby,7318,1,21,5,4,67,31,36,68
FC Midtjylla,7318,2,18,5,7,63,40,23,59
FC Nords,7318,3,15,6,9,74,50,24,51
Copenhagen,7318,4,15,6,9,58,42,16,51
AaB,7318,5,7,12,11,37,44,-7,33
AC Horsens,7318,6,6,14,10,34,52,-18,32
Sonderjyske,7318,7,8,6,10,28,29,-1,30
Randers FC,7318,8,5,7,12,23,39,-16,22
Silkeborg IF,7318,9,6,3,13,28,44,-16,21
Lyngby,7318,10,3,10,11,26,44,-18,19
AGF Aarhus,7318,11,4,6,12,16,39,-23,18
Brondby,7319,1,22,5,3,73,32,41,71
FC Midtjylla,7319,2,18,6,6,64,39,25,60
FC Nords,7319,3,15,7,8,76,51,25,52
Copenhagen,7319,4,13,4,13,54,48,6,43
AaB,7319,5,7,13,10,35,43,-8,34
AC Horsens,7319,6,7,13,10,35,50,-15,34
Sonderjyske,7319,7,8,6,10,28,29,-1,30
Lyngby,7319,8,4,9,11,28,45,-17,21
Randers FC,7319,9,5,6,13,24,41,-17,21
Silkeborg IF,7319,10,6,3,13,27,45,-18,21
AGF Aarhus,7319,11,4,6,12,17,38,-21,18
Brondby,7320,1,22,5,3,76,31,45,71
FC Midtjylla,7320,2,21,5,4,70,36,34,68
FC Nords,7320,3,15,7,8,74,49,25,52
Copenhagen,7320,4,13,4,13,55,48,7,43
AaB,7320,5,8,11,11,38,44,-6,35
Sonderjyske,7320,6,8,6,10,28,29,-1,30
AC Horsens,7320,7,5,12,13,31,62,-31,27
Lyngby,7320,8,4,9,11,28,45,-17,21
Silkeborg IF,7320,8,6,3,13,28,45,-17,21
Randers FC,7320,10,5,6,13,24,41,-17,21
AGF Aarhus,7320,11,4,6,12,17,39,-22,18
Brondby,7321,1,22,5,3,73,32,41,71
FC Midtjylla,7321,2,19,5,6,70,41,29,62
Copenhagen,7321,3,14,5,11,58,42,16,47
FC Nords,7321,4,13,7,10,72,56,16,46
AC Horsens,7321,5,7,14,9,35,49,-14,35
AaB,7321,6,7,12,11,36,50,-14,33
Sonderjyske,7321,7,8,6,10,28,29,-1,30
Randers FC,7321,8,6,6,12,26,40,-14,24
Silkeborg IF,7321,9,6,3,13,27,45,-18,21
Lyngby,7321,10,3,9,12,27,47,-20,18
AGF Aarhus,7321,11,4,6,12,17,38,-21,18
Brondby,7322,1,22,5,3,79,32,47,71
FC Midtjylla,7322,2,19,4,7,61,40,21,61
FC Nords,7322,3,14,6,10,74,51,23,48
Copenhagen,7322,4,13,6,11,52,49,3,45
AC Horsens,7322,5,8,13,9,40,51,-11,37
AaB,7322,6,7,12,11,35,44,-9,33
Sonderjyske,7322,7,8,6,10,28,29,-1,30
Randers FC,7322,8,6,6,12,25,40,-15,24
Silkeborg IF,7322,9,5,4,13,26,45,-19,19
AGF Aarhus,7322,10,4,7,11,17,37,-20,19
Lyngby,7322,11,3,9,12,27,46,-19,18
Brondby,7323,1,21,6,3,69,30,39,69
FC Midtjylla,7323,2,21,4,5,68,38,30,67
FC Nords,7323,3,13,6,11,73,54,19,45
Copenhagen,7323,4,13,5,12,58,50,8,44
AaB,7323,5,9,11,10,42,45,-3,38
AC Horsens,7323,6,7,12,11,33,52,-19,33
Sonderjyske,7323,7,8,6,10,28,29,-1,30
Lyngby,7323,8,4,9,11,28,44,-16,21
Silkeborg IF,7323,9,6,3,13,26,44,-18,21
Randers FC,7323,10,5,6,13,23,41,-18,21
AGF Aarhus,7323,11,4,6,12,16,37,-21,18
Brondby,7324,1,21,6,3,69,31,38,69
FC Midtjylla,7324,2,19,4,7,69,43,26,61
Copenhagen,7324,3,15,5,10,64,44,20,50
FC Nords,7324,4,13,7,10,74,58,16,46
AaB,7324,5,7,13,10,38,45,-7,34
AC Horsens,7324,6,7,13,10,37,56,-19,34
Sonderjyske,7324,7,8,6,10,28,29,-1,30
Lyngby,7324,8,4,9,11,27,44,-17,21
Randers FC,7324,9,5,6,13,23,40,-17,21
Silkeborg IF,7324,10,6,3,13,27,45,-18,21
AGF Aarhus,7324,11,4,6,12,17,38,-21,18
Brondby,7325,1,21,6,3,69,32,37,69
FC Midtjylla,7325,2,19,6,5,63,40,23,63
FC Nords,7325,3,14,8,8,73,49,24,50
Copenhagen,7325,4,15,5,10,62,44,18,50
AC Horsens,7325,5,6,14,10,35,52,-17,32
Sonderjyske,7325,6,8,6,10,28,29,-1,30
AaB,7325,7,6,11,13,34,45,-11,29
Randers FC,7325,8,5,7,12,23,39,-16,22
AGF Aarhus,7325,9,5,6,11,19,37,-18,21
Lyngby,7325,10,3,10,11,26,44,-18,19
Silkeborg IF,7325,11,5,3,14,26,47,-21,18
Brondby,7326,1,20,6,4,68,33,35,66
FC Midtjylla,7326,2,19,7,4,71,42,29,64
FC Nords,7326,3,14,6,10,76,57,19,48
Copenhagen,7326,4,14,5,11,55,47,8,47
AaB,7326,5,10,11,9,41,39,2,41
Sonderjyske,7326,6,8,6,10,28,29,-1,30
AC Horsens,7326,7,5,13,12,34,53,-19,28
Randers FC,7326,8,6,6,12,26,39,-13,24
AGF Aarhus,7326,9,5,6,11,17,36,-19,21
Silkeborg IF,7326,10,5,3,14,25,45,-20,18
Lyngby,7326,11,3,9,12,26,47,-21,18
Brondby,7327,1,22,5,3,73,31,42,71
FC Midtjylla,7327,2,18,5,7,62,45,17,59
FC Nords,7327,3,14,7,9,75,51,24,49
Copenhagen,7327,4,13,4,13,53,42,11,43
AaB,7327,5,10,11,9,41,39,2,41
AC Horsens,7327,6,7,12,11,33,55,-22,33
Sonderjyske,7327,7,8,6,10,28,29,-1,30
Lyngby,7327,8,4,9,11,28,45,-17,21
Randers FC,7327,9,5,6,13,24,41,-17,21
Silkeborg IF,7327,10,6,3,13,28,46,-18,21
AGF Aarhus,7327,11,4,6,12,18,39,-21,18
Brondby,7328,1,19,8,3,69,34,35,65
FC Midtjylla,7328,2,20,4,6,68,38,30,64
FC Nords,7328,3,15,7,8,73,52,21,52
Copenhagen,7328,4,13,7,10,60,47,13,46
AaB,7328,5,7,13,10,35,41,-6,34
Sonderjyske,7328,6,8,6,10,28,29,-1,30
AC Horsens,7328,7,5,15,10,32,51,-19,30
Lyngby,7328,8,4,9,11,30,44,-14,21
Randers FC,7328,9,5,6,13,23,43,-20,21
Silkeborg IF,7328,10,5,4,13,26,45,-19,19
AGF Aarhus,7328,11,4,7,11,17,37,-20,19
Brondby,7329,1,20,6,4,71,36,35,66
FC Midtjylla,7329,2,18,5,7,64,42,22,59
Copenhagen,7329,3,16,5,9,59,38,21,53
FC Nords,7329,4,12,7,11,68,53,15,43
AaB,7329,5,9,11,10,36,41,-5,38
AC Horsens,7329,6,8,12,10,40,54,-14,36
Sonderjyske,7329,7,8,6,10,28,29,-1,30
Lyngby,7329,8,4,9,11,29,45,-16,21
Randers FC,7329,9,5,6,13,24,42,-18,21
Silkeborg IF,7329,10,5,4,13,25,44,-19,19
AGF Aarhus,7329,11,4,7,11,16,36,-20,19
Brondby,7330,1,21,6,3,74,30,44,69
FC Midtjylla,7330,2,20,5,5,67,41,26,65
FC Nords,7330,3,14,7,9,78,52,26,49
Copenhagen,7330,4,14,5,11,59,46,13,47
AaB,7330,5,8,12,10,42,48,-6,36
Sonderjyske,7330,6,8,6,10,28,29,-1,30
AC Horsens,7330,7,5,13,12,34,63,-29,28
Randers FC,7330,8,5,7,12,25,41,-16,22
Silkeborg IF,7330,9,6,3,13,28,44,-16,21
Lyngby,7330,10,3,10,11,28,46,-18,19
AGF Aarhus,7330,11,4,6,12,16,39,-23,18
Brondby,7331,1,21,6,3,76,37,39,69
FC Midtjylla,7331,2,21,4,5,72,40,32,67
FC Nords,7331,3,14,7,9,78,58,20,49
Copenhagen,7331,4,14,5,11,63,47,16,47
AaB,7331,5,7,11,12,35,46,-11,32
AC Horsens,7331,6,6,13,11,35,57,-22,31
Sonderjyske,7331,7,8,6,10,28,29,-1,30
Randers FC,7331,8,6,6,12,27,42,-15,24
Silkeborg IF,7331,9,6,3,13,26,44,-18,21
Lyngby,7331,10,3,9,12,29,48,-19,18
AGF Aarhus,7331,11,4,6,12,16,37,-21,18
Brondby,7332,1,21,6,3,71,34,37,69
FC Midtjylla,7332,2,20,5,5,67,42,25,65
FC Nords,7332,3,14,8,8,78,53,25,50
Copenhagen,7332,4,13,5,12,56,46,10,44
AaB,7332,5,7,13,10,39,43,-4,34
Sonderjyske,7332,6,8,6,10,28,29,-1,30
AC Horsens,7332,7,5,15,10,37,56,-19,30
Randers FC,7332,8,5,7,12,26,42,-16,22
Lyngby,7332,9,3,10,11,29,47,-18,19
Silkeborg IF,7332,10,5,4,13,27,46,-19,19
AGF Aarhus,7332,11,4,7,11,18,38,-20,19
Brondby,7333,1,21,7,2,72,30,42,70
FC Midtjylla,7333,2,19,5,6,63,41,22,62
Copenhagen,7333,3,15,5,10,63,49,14,50
FC Nords,7333,4,13,8,9,75,54,21,47
AaB,7333,5,7,12,11,37,43,-6,33
AC Horsens,7333,6,6,13,11,34,53,-19,31
Sonderjyske,7333,7,8,6,10,28,29,-1,30
Randers FC,7333,8,6,6,12,25,40,-15,24
AGF Aarhus,7333,9,5,6,11,17,36,-19,21
Lyngby,7333,10,3,9,12,27,46,-19,18
Silkeborg IF,7333,11,5,3,14,25,45,-20,18
Brondby,7334,1,21,7,2,72,31,41,70
FC Midtjylla,7334,2,19,4,7,61,40,21,61
Copenhagen,7334,3,15,4,11,58,45,13,49
FC Nords,7334,4,13,8,9,72,52,20,47
AaB,7334,5,8,11,11,36,42,-6,35
AC Horsens,7334,6,6,14,10,37,52,-15,32
Sonderjyske,7334,7,8,6,10,28,29,-1,30
Lyngby,7334,8,4,9,11,27,44,-17,21
Randers FC,7334,9,5,6,13,23,40,-17,21
Silkeborg IF,7334,10,6,3,13,27,45,-18,21
AGF Aarhus,7334,11,4,6,12,17,38,-21,18
FC Midtjylla,7335,1,20,5,5,62,33,29,65
Brondby,7335,2,19,6,5,65,33,32,63
FC Nords,7335,3,15,6,9,69,49,20,51
Copenhagen,7335,4,15,4,11,55,40,15,49
AaB,7335,5,9,12,9,35,36,-1,39
Sonderjyske,7335,6,8,6,10,28,29,-1,30
AC Horsens,7335,7,5,13,12,29,50,-21,28
Lyngby,7335,8,4,9,11,29,46,-17,21
Randers FC,7335,9,5,6,13,25,42,-17,21
Silkeborg IF,7335,10,5,4,13,26,45,-19,19
AGF Aarhus,7335,11,4,7,11,17,37,-20,19
Brondby,7336,1,22,5,3,76,31,45,71
FC Midtjylla,7336,2,20,5,5,62,38,24,65
Copenhagen,7336,3,15,4,11,57,43,14,49
FC Nords,7336,4,13,8,9,68,50,18,47
AaB,7336,5,7,11,12,36,44,-8,32
AC Horsens,7336,6,6,13,11,31,50,-19,31
Sonderjyske,7336,7,8,6,10,28,29,-1,30
Randers FC,7336,8,5,7,12,24,40,-16,22
AGF Aarhus,7336,9,5,6,11,19,38,-19,21
Lyngby,7336,10,3,10,11,27,45,-18,19
Silkeborg IF,7336,11,5,3,14,27,47,-20,18
Brondby,7337,1,23,5,2,76,31,45,74
FC Midtjylla,7337,2,19,4,7,66,44,22,61
FC Nords,7337,3,14,7,9,73,50,23,49
Copenhagen,7337,4,12,5,13,55,49,6,41
AaB,7337,5,9,12,9,38,39,-1,39
AC Horsens,7337,6,6,13,11,35,56,-21,31
Sonderjyske,7337,7,8,6,10,28,29,-1,30
Randers FC,7337,8,6,6,12,24,39,-15,24
Silkeborg IF,7337,9,6,3,13,27,44,-17,21
Lyngby,7337,10,3,9,12,26,45,-19,18
AGF Aarhus,7337,11,4,6,12,16,38,-22,18
FC Midtjylla,7338,1,21,5,4,75,35,40,68
Brondby,7338,2,20,5,5,66,38,28,65
FC Nords,7338,3,15,6,9,74,50,24,51
Copenhagen,7338,4,13,5,12,53,44,9,44
AaB,7338,5,9,13,8,43,41,2,40
Sonderjyske,7338,6,8,6,10,28,29,-1,30
AC Horsens,7338,7,5,12,13,32,61,-29,27
Lyngby,7338,8,4,9,11,28,45,-17,21
Randers FC,7338,9,5,6,13,24,41,-17,21
Silkeborg IF,7338,10,5,4,13,26,45,-19,19
AGF Aarhus,7338,11,4,7,11,17,37,-20,19
FC Midtjylla,7339,1,20,6,4,68,36,32,66
Brondby,7339,2,20,5,5,66,39,27,65
Copenhagen,7339,3,14,6,10,57,42,15,48
FC Nords,7339,4,13,8,9,73,51,22,47
AC Horsens,7339,5,7,14,9,36,51,-15,35
AaB,7339,6,7,11,12,33,40,-7,32
Sonderjyske,7339,7,8,6,10,28,29,-1,30
Randers FC,7339,8,5,7,12,23,39,-16,22
AGF Aarhus,7339,9,5,6,11,20,37,-17,21
Lyngby,7339,10,3,10,11,26,44,-18,19
Silkeborg IF,7339,11,5,3,14,26,48,-22,18
Brondby,7340,1,22,6,2,74,31,43,72
FC Midtjylla,7340,2,19,5,6,64,40,24,62
FC Nords,7340,3,13,8,9,72,55,17,47
Copenhagen,7340,4,13,5,12,55,46,9,44
AaB,7340,5,7,13,10,39,44,-5,34
AC Horsens,7340,6,6,15,9,38,52,-14,33
Sonderjyske,7340,7,8,6,10,28,29,-1,30
Lyngby,7340,8,4,9,11,28,44,-16,21
Silkeborg IF,7340,9,6,3,13,28,45,-17,21
Randers FC,7340,10,5,6,13,23,41,-18,21
AGF Aarhus,7340,11,4,6,12,17,39,-22,18
Brondby,7341,1,20,8,2,69,30,39,68
FC Midtjylla,7341,2,19,7,4,65,37,28,64
FC Nords,7341,3,15,7,8,81,52,29,52
Copenhagen,7341,4,13,4,13,54,48,6,43
AaB,7341,5,7,13,10,38,43,-5,34
AC Horsens,7341,6,6,13,11,34,57,-23,31
Sonderjyske,7341,7,8,6,10,28,29,-1,30
Randers FC,7341,8,5,7,12,25,41,-16,22
AGF Aarhus,7341,9,5,6,11,17,36,-19,21
Lyngby,7341,10,3,10,11,28,46,-18,19
Silkeborg IF,7341,11,5,3,14,25,45,-20,18
Brondby,7342,1,21,5,4,73,33,40,68
FC Midtjylla,7342,2,20,5,5,65,40,25,65
FC Nords,7342,3,13,8,9,73,53,20,47
Copenhagen,7342,4,14,4,12,57,45,12,46
AaB,7342,5,7,13,10,35,42,-7,34
AC Horsens,7342,6,7,13,10,35,51,-16,34
Sonderjyske,7342,7,8,6,10,28,29,-1,30
Lyngby,7342,8,4,9,11,27,44,-17,21
Silkeborg IF,7342,8,6,3,13,27,44,-17,21
Randers FC,7342,10,5,6,13,23,40,-17,21
AGF Aarhus,7342,11,4,6,12,16,38,-22,18
Brondby,7343,1,22,6,2,74,32,42,72
FC Midtjylla,7343,2,20,5,5,68,37,31,65
Copenhagen,7343,3,15,4,11,57,44,13,49
FC Nords,7343,4,14,6,10,72,55,17,48
AaB,7343,5,7,12,11,34,40,-6,33
Sonderjyske,7343,6,8,6,10,28,29,-1,30
AC Horsens,7343,7,5,13,12,33,56,-23,28
Lyngby,7343,8,4,9,11,28,44,-16,21
AGF Aarhus,7343,9,5,6,11,19,36,-17,21
Randers FC,7343,10,5,6,13,23,41,-18,21
Silkeborg IF,7343,11,5,3,14,25,47,-22,18
FC Midtjylla,7344,1,20,4,6,66,38,28,64
Brondby,7344,2,19,6,5,67,32,35,63
FC Nords,7344,3,16,6,8,73,47,26,54
Copenhagen,7344,4,13,4,13,54,47,7,43
AaB,7344,5,9,11,10,37,45,-8,38
AC Horsens,7344,6,7,13,10,36,50,-14,34
Sonderjyske,7344,7,8,6,10,28,29,-1,30
Randers FC,7344,8,5,7,12,24,40,-16,22
AGF Aarhus,7344,9,5,6,11,17,36,-19,21
Lyngby,7344,10,3,10,11,27,45,-18,19
Silkeborg IF,7344,11,5,3,14,25,45,-20,18
Brondby,7345,1,22,6,2,74,29,45,72
FC Midtjylla,7345,2,18,6,6,65,48,17,60
FC Nords,7345,3,15,6,9,76,48,28,51
Copenhagen,7345,4,12,6,12,56,49,7,42
AaB,7345,5,7,13,10,35,42,-7,34
AC Horsens,7345,6,6,15,9,33,49,-16,33
Sonderjyske,7345,7,8,6,10,28,29,-1,30
Randers FC,7345,8,5,7,12,23,39,-16,22
Lyngby,7345,9,3,10,11,26,44,-18,19
Silkeborg IF,7345,10,5,4,13,25,44,-19,19
AGF Aarhus,7345,11,4,7,11,16,36,-20,19
Brondby,7346,1,21,5,4,71,32,39,68
FC Midtjylla,7346,2,20,4,6,67,41,26,64
FC Nords,7346,3,15,6,9,75,52,23,51
Copenhagen,7346,4,14,4,12,57,46,11,46
AaB,7346,5,8,12,10,35,42,-7,36
AC Horsens,7346,6,6,13,11,34,52,-18,31
Sonderjyske,7346,7,8,6,10,28,29,-1,30
Randers FC,7346,8,5,7,12,25,41,-16,22
Lyngby,7346,9,3,10,11,28,46,-18,19
Silkeborg IF,7346,10,5,4,13,26,45,-19,19
AGF Aarhus,7346,11,4,7,11,17,37,-20,19
Brondby,7347,1,20,7,3,69,33,36,67
FC Midtjylla,7347,2,19,6,5,65,39,26,63
FC Nords,7347,3,14,8,8,72,50,22,50
Copenhagen,7347,4,14,6,10,60,44,16,48
AC Horsens,7347,5,7,13,10,36,49,-13,34
Sonderjyske,7347,6,8,6,10,28,29,-1,30
AaB,7347,7,6,12,12,37,50,-13,30
Randers FC,7347,8,6,6,12,26,40,-14,24
Silkeborg IF,7347,9,5,4,13,25,44,-19,19
AGF Aarhus,7347,10,4,7,11,16,36,-20,19
Lyngby,7347,11,3,9,12,27,47,-20,18
Brondby,7348,1,20,6,4,73,34,39,66
FC Midtjylla,7348,2,17,8,5,64,41,23,59
FC Nords,7348,3,16,7,7,76,49,27,55
Copenhagen,7348,4,14,5,11,57,44,13,47
AC Horsens,7348,5,7,13,10,34,53,-19,34
AaB,7348,6,6,13,11,35,44,-9,31
Sonderjyske,7348,7,8,6,10,28,29,-1,30
Randers FC,7348,8,6,6,12,25,40,-15,24
Silkeborg IF,7348,9,5,4,13,25,44,-19,19
AGF Aarhus,7348,10,4,7,11,16,36,-20,19
Lyngby,7348,11,3,9,12,27,46,-19,18
Brondby,7349,1,22,5,3,71,31,40,71
FC Midtjylla,7349,2,19,6,5,64,38,26,63
FC Nords,7349,3,15,6,9,79,56,23,51
Copenhagen,7349,4,13,5,12,59,47,12,44
AaB,7349,5,8,11,11,39,46,-7,35
AC Horsens,7349,6,6,13,11,37,57,-20,31
Sonderjyske,7349,7,8,6,10,28,29,-1,30
Lyngby,7349,8,4,9,11,28,44,-16,21
Silkeborg IF,7349,9,6,3,13,27,44,-17,21
Randers FC,7349,10,5,6,13,23,41,-18,21
AGF Aarhus,7349,11,4,6,12,16,38,-22,18
Brondby,7350,1,21,5,4,75,34,41,68
FC Midtjylla,7350,2,21,5,4,67,38,29,68
FC Nords,7350,3,15,6,9,69,49,20,51
Copenhagen,7350,4,14,5,11,57,43,14,47
AaB,7350,5,7,11,12,37,49,-12,32
Sonderjyske,7350,6,8,6,10,28,29,-1,30
AC Horsens,7350,7,6,12,12,33,51,-18,30
Randers FC,7350,8,5,7,12,24,40,-16,22
AGF Aarhus,7350,9,5,6,11,18,37,-19,21
Lyngby,7350,10,3,10,11,27,45,-18,19
Silkeborg IF,7350,11,5,3,14,26,46,-20,18
Brondby,7351,1,22,5,3,69,29,40,71
FC Midtjylla,7351,2,18,6,6,62,40,22,60
Copenhagen,7351,3,16,5,9,63,46,17,53
FC Nords,7351,4,12,6,12,68,53,15,42
AaB,7351,5,7,14,9,36,39,-3,35
AC Horsens,7351,6,6,14,10,33,50,-17,32
Sonderjyske,7351,7,8,6,10,28,29,-1,30
Lyngby,7351,8,4,9,11,28,45,-17,21
Randers FC,7351,9,5,6,13,24,41,-17,21
AGF Aarhus,7351,10,5,6,11,18,37,-19,21
Silkeborg IF,7351,11,5,3,14,26,46,-20,18
Brondby,7352,1,19,7,4,68,34,34,64
FC Midtjylla,7352,2,19,5,6,68,39,29,62
FC Nords,7352,3,15,6,9,73,53,20,51
Copenhagen,7352,4,14,6,10,57,44,13,48
AC Horsens,7352,5,7,14,9,36,50,-14,35
AaB,7352,6,7,12,11,36,44,-8,33
Sonderjyske,7352,7,8,6,10,28,29,-1,30
Lyngby,7352,8,4,9,11,30,44,-14,21
Silkeborg IF,7352,9,6,3,13,27,44,-17,21
Randers FC,7352,10,5,6,13,23,43,-20,21
AGF Aarhus,7352,11,4,6,12,16,38,-22,18
Brondby,7353,1,21,6,3,71,29,42,69
FC Midtjylla,7353,2,19,5,6,62,38,24,62
FC Nords,7353,3,15,7,8,73,48,25,52
Copenhagen,7353,4,15,5,10,59,44,15,50
AC Horsens,7353,5,6,13,11,33,53,-20,31
Sonderjyske,7353,6,8,6,10,28,29,-1,30
AaB,7353,7,6,12,12,33,45,-12,30
Randers FC,7353,8,6,6,12,26,40,-14,24
Silkeborg IF,7353,9,6,3,13,27,45,-18,21
Lyngby,7353,10,3,9,12,27,47,-20,18
AGF Aarhus,7353,11,4,6,12,17,38,-21,18
Brondby,7354,1,20,7,3,67,30,37,67
FC Midtjylla,7354,2,20,5,5,66,37,29,65
FC Nords,7354,3,13,7,10,72,55,17,46
Copenhagen,7354,4,12,7,11,54,44,10,43
AaB,7354,5,9,12,9,36,39,-3,39
AC Horsens,7354,6,6,14,10,34,50,-16,32
Sonderjyske,7354,7,8,6,10,28,29,-1,30
Lyngby,7354,8,4,9,11,27,44,-17,21
Randers FC,7354,9,5,6,13,23,40,-17,21
AGF Aarhus,7354,10,5,6,11,17,36,-19,21
Silkeborg IF,7354,11,5,3,14,25,45,-20,18
Brondby,7355,1,21,5,4,69,33,36,68
FC Midtjylla,7355,2,19,6,5,61,37,24,63
FC Nords,7355,3,14,7,9,73,49,24,49
Copenhagen,7355,4,14,5,11,60,46,14,47
AaB,7355,5,7,12,11,34,42,-8,33
AC Horsens,7355,6,6,15,9,37,53,-16,33
Sonderjyske,7355,7,8,6,10,28,29,-1,30
Randers FC,7355,8,5,7,12,24,40,-16,22
Silkeborg IF,7355,9,6,3,13,27,44,-17,21
Lyngby,7355,10,3,10,11,27,45,-18,19
AGF Aarhus,7355,11,4,6,12,16,38,-22,18
Brondby,7356,1,21,6,3,69,35,34,69
FC Midtjylla,7356,2,21,5,4,67,33,34,68
FC Nords,7356,3,14,7,9,71,53,18,49
Copenhagen,7356,4,14,5,11,54,41,13,47
AaB,7356,5,7,12,11,35,41,-6,33
Sonderjyske,7356,6,8,6,10,28,29,-1,30
AC Horsens,7356,7,5,13,12,32,51,-19,28
Lyngby,7356,8,4,9,11,28,45,-17,21
Randers FC,7356,9,5,6,13,24,41,-17,21
Silkeborg IF,7356,10,5,4,13,25,44,-19,19
AGF Aarhus,7356,11,4,7,11,16,36,-20,19
Brondby,7357,1,22,5,3,72,31,41,71
FC Midtjylla,7357,2,20,4,6,66,44,22,64
FC Nords,7357,3,15,6,9,78,51,27,51
Copenhagen,7357,4,15,4,11,57,44,13,49
AaB,7357,5,7,11,12,35,42,-7,32
Sonderjyske,7357,6,8,6,10,28,29,-1,30
AC Horsens,7357,7,6,12,12,30,52,-22,30
Lyngby,7357,8,4,9,11,30,44,-14,21
Randers FC,7357,9,5,6,13,23,43,-20,21
Silkeborg IF,7357,10,5,4,13,26,45,-19,19
AGF Aarhus,7357,11,4,7,11,17,37,-20,19
Brondby,7358,1,22,5,3,79,33,46,71
FC Midtjylla,7358,2,19,5,6,67,43,24,62
FC Nords,7358,3,13,8,9,71,54,17,47
Copenhagen,7358,4,14,4,12,63,48,15,46
AC Horsens,7358,5,7,14,9,40,57,-17,35
AaB,7358,6,7,12,11,38,49,-11,33
Sonderjyske,7358,7,8,6,10,28,29,-1,30
Randers FC,7358,8,5,7,12,25,41,-16,22
Silkeborg IF,7358,9,6,3,13,27,45,-18,21
Lyngby,7358,10,3,10,11,28,46,-18,19
AGF Aarhus,7358,11,4,6,12,17,38,-21,18
Brondby,7359,1,21,6,3,70,32,38,69
FC Midtjylla,7359,2,19,4,7,64,40,24,61
Copenhagen,7359,3,16,5,9,60,43,17,53
FC Nords,7359,4,14,8,8,72,49,23,50
AaB,7359,5,7,12,11,32,39,-7,33
Sonderjyske,7359,6,8,6,10,28,29,-1,30
AC Horsens,7359,7,5,13,12,32,53,-21,28
Lyngby,7359,8,4,9,11,27,44,-17,21
Randers FC,7359,9,5,6,13,23,40,-17,21
Silkeborg IF,7359,10,6,3,13,27,45,-18,21
AGF Aarhus,7359,11,4,6,12,17,38,-21,18
Brondby,7360,1,21,7,2,72,28,44,70
FC Midtjylla,7360,2,21,4,5,68,39,29,67
FC Nords,7360,3,14,7,9,71,50,21,49
Copenhagen,7360,4,14,6,10,58,44,14,48
AaB,7360,5,7,11,12,36,48,-12,32
Sonderjyske,7360,6,8,6,10,28,29,-1,30
AC Horsens,7360,7,5,13,12,31,53,-22,28
Randers FC,7360,8,5,7,12,24,40,-16,22
Lyngby,7360,9,3,10,11,27,45,-18,19
Silkeborg IF,7360,10,5,4,13,26,45,-19,19
AGF Aarhus,7360,11,4,7,11,17,37,-20,19
Brondby,7361,1,21,6,3,69,31,38,69
FC Midtjylla,7361,2,18,5,7,67,41,26,59
Copenhagen,7361,3,15,5,10,58,42,16,50
FC Nords,7361,4,14,6,10,73,58,15,48
AaB,7361,5,8,12,10,37,40,-3,36
AC Horsens,7361,6,6,14,10,34,52,-18,32
Sonderjyske,7361,7,8,6,10,28,29,-1,30
Lyngby,7361,8,4,9,11,27,44,-17,21
Randers FC,7361,9,5,6,13,23,40,-17,21
Silkeborg IF,7361,10,5,4,13,26,45,-19,19
AGF Aarhus,7361,11,4,7,11,17,37,-20,19
Brondby,7362,1,22,6,2,74,32,42,72
FC Midtjylla,7362,2,21,4,5,71,40,31,67
FC Nords,7362,3,14,6,10,74,55,19,48
Copenhagen,7362,4,13,5,12,65,52,13,44
AaB,7362,5,8,11,11,37,49,-12,35
Sonderjyske,7362,6,8,6,10,28,29,-1,30
AC Horsens,7362,7,6,12,12,35,54,-19,30
Randers FC,7362,8,6,6,12,26,40,-14,24
Silkeborg IF,7362,9,6,3,13,26,44,-18,21
Lyngby,7362,10,3,9,12,27,47,-20,18
AGF Aarhus,7362,11,4,6,12,16,37,-21,18
Brondby,7363,1,21,7,2,75,31,44,70
FC Midtjylla,7363,2,19,5,6,64,41,23,62
FC Nords,7363,3,16,6,8,76,51,25,54
Copenhagen,7363,4,14,6,10,60,45,15,48
AaB,7363,5,6,13,11,35,47,-12,31
Sonderjyske,7363,6,8,6,10,28,29,-1,30
AC Horsens,7363,7,5,13,12,32,53,-21,28
Lyngby,7363,8,4,9,11,31,44,-13,21
Silkeborg IF,7363,9,6,3,13,26,44,-18,21
Randers FC,7363,10,5,6,13,23,44,-21,21
AGF Aarhus,7363,11,4,6,12,16,37,-21,18
Brondby,7364,1,21,6,3,71,32,39,69
FC Midtjylla,7364,2,19,6,5,64,39,25,63
FC Nords,7364,3,13,8,9,73,52,21,47
Copenhagen,7364,4,13,6,11,58,48,10,45
AaB,7364,5,8,12,10,39,43,-4,36
AC Horsens,7364,6,6,14,10,37,54,-17,32
Sonderjyske,7364,7,8,6,10,28,29,-1,30
Lyngby,7364,8,4,9,11,28,45,-17,21
Randers FC,7364,9,5,6,13,24,41,-17,21
Silkeborg IF,7364,10,6,3,13,28,46,-18,21
AGF Aarhus,7364,11,4,6,12,18,39,-21,18
Brondby,7365,1,21,5,4,73,35,38,68
FC Midtjylla,7365,2,21,5,4,68,36,32,68
FC Nords,7365,3,13,7,10,66,54,12,46
Copenhagen,7365,4,13,6,11,54,44,10,45
AaB,7365,5,8,11,11,41,43,-2,35
AC Horsens,7365,6,6,14,10,33,49,-16,32
Sonderjyske,7365,7,8,6,10,28,29,-1,30
Lyngby,7365,8,4,9,11,28,44,-16,21
Randers FC,7365,9,5,6,13,23,41,-18,21
Silkeborg IF,7365,10,5,4,13,26,45,-19,19
AGF Aarhus,7365,11,4,7,11,17,37,-20,19
FC Midtjylla,7366,1,19,5,6,66,42,24,62
Brondby,7366,2,18,6,6,64,33,31,60
FC Nords,7366,3,15,6,9,76,53,23,51
Copenhagen,7366,4,15,6,9,59,43,16,51
AaB,7366,5,8,12,10,35,40,-5,36
AC Horsens,7366,6,6,15,9,37,52,-15,33
Sonderjyske,7366,7,8,6,10,28,29,-1,30
Randers FC,7366,8,5,7,12,23,39,-16,22
AGF Aarhus,7366,9,5,6,11,18,37,-19,21
Lyngby,7366,10,3,10,11,26,44,-18,19
Silkeborg IF,7366,11,5,3,14,26,46,-20,18
Brondby,7367,1,22,6,2,75,31,44,72
FC Midtjylla,7367,2,19,6,5,63,38,25,63
FC Nords,7367,3,15,6,9,72,51,21,51
Copenhagen,7367,4,14,5,11,58,45,13,47
AaB,7367,5,6,14,10,36,43,-7,32
Sonderjyske,7367,6,8,6,10,28,29,-1,30
AC Horsens,7367,7,5,13,12,32,54,-22,28
Randers FC,7367,8,5,7,12,24,40,-16,22
Lyngby,7367,9,3,10,11,27,45,-18,19
Silkeborg IF,7367,10,5,4,13,25,44,-19,19
AGF Aarhus,7367,11,4,7,11,16,36,-20,19
Brondby,7368,1,20,7,3,69,32,37,67
FC Midtjylla,7368,2,20,5,5,67,35,32,65
FC Nords,7368,3,14,6,10,71,51,20,48
Copenhagen,7368,4,14,5,11,55,40,15,47
AaB,7368,5,9,11,10,37,39,-2,38
Sonderjyske,7368,6,8,6,10,28,29,-1,30
AC Horsens,7368,7,6,12,12,33,61,-28,30
Randers FC,7368,8,5,7,12,23,39,-16,22
Silkeborg IF,7368,9,6,3,13,28,45,-17,21
Lyngby,7368,10,3,10,11,26,44,-18,19
AGF Aarhus,7368,11,4,6,12,17,39,-22,18
Brondby,7369,1,21,5,4,68,34,34,68
FC Midtjylla,7369,2,18,6,6,61,37,24,60
Copenhagen,7369,3,15,6,9,66,46,20,51
FC Nords,7369,4,12,6,12,72,57,15,42
AaB,7369,5,8,12,10,38,44,-6,36
AC Horsens,7369,6,7,15,8,36,49,-13,36
Sonderjyske,7369,7,8,6,10,28,29,-1,30
Lyngby,7369,8,4,9,11,28,44,-16,21
Silkeborg IF,7369,9,6,3,13,27,45,-18,21
Randers FC,7369,10,5,6,13,23,41,-18,21
AGF Aarhus,7369,11,4,6,12,17,38,-21,18
Brondby,7370,1,21,6,3,73,31,42,69
FC Midtjylla,7370,2,20,6,4,68,37,31,66
FC Nords,7370,3,14,6,10,69,53,16,48
Copenhagen,7370,4,13,6,11,55,46,9,45
AaB,7370,5,8,12,10,36,41,-5,36
Sonderjyske,7370,6,8,6,10,28,29,-1,30
AC Horsens,7370,7,6,12,12,37,56,-19,30
Randers FC,7370,8,5,7,12,25,41,-16,22
Lyngby,7370,9,3,10,11,28,46,-18,19
Silkeborg IF,7370,10,5,4,13,25,44,-19,19
AGF Aarhus,7370,11,4,7,11,16,36,-20,19
Brondby,7371,1,22,6,2,72,29,43,72
FC Midtjylla,7371,2,21,5,4,66,35,31,68
FC Nords,7371,3,14,6,10,73,56,17,48
Copenhagen,7371,4,13,4,13,55,49,6,43
AC Horsens,7371,5,7,12,11,37,51,-14,33
AaB,7371,6,7,11,12,35,44,-9,32
Sonderjyske,7371,7,8,6,10,28,29,-1,30
Lyngby,7371,8,4,9,11,28,44,-16,21
Randers FC,7371,9,5,6,13,23,41,-18,21
AGF Aarhus,7371,10,5,6,11,17,36,-19,21
Silkeborg IF,7371,11,5,3,14,25,45,-20,18
Brondby,7372,1,21,7,2,73,32,41,70
FC Midtjylla,7372,2,19,7,4,66,37,29,64
Copenhagen,7372,3,14,7,9,58,42,16,49
FC Nords,7372,4,13,7,10,75,57,18,46
AaB,7372,5,7,12,11,36,42,-6,33
Sonderjyske,7372,6,8,6,10,28,29,-1,30
AC Horsens,7372,7,6,12,12,32,56,-24,30
Lyngby,7372,8,4,9,11,28,45,-17,21
Randers FC,7372,9,5,6,13,24,41,-17,21
AGF Aarhus,7372,10,5,6,11,17,36,-19,21
Silkeborg IF,7372,11,5,3,14,25,45,-20,18
Brondby,7373,1,22,5,3,75,37,38,71
FC Midtjylla,7373,2,19,4,7,64,40,24,61
FC Nords,7373,3,15,7,8,78,53,25,52
Copenhagen,7373,4,13,5,12,59,50,9,44
AC Horsens,7373,5,7,13,10,35,51,-16,34
AaB,7373,6,6,14,10,36,42,-6,32
Sonderjyske,7373,7,8,6,10,28,29,-1,30
Lyngby,7373,8,4,9,11,31,45,-14,21
Randers FC,7373,9,5,6,13,24,44,-20,21
Silkeborg IF,7373,10,5,4,13,26,45,-19,19
AGF Aarhus,7373,11,4,7,11,17,37,-20,19
Brondby,7374,1,22,5,3,77,31,46,71
FC Midtjylla,7374,2,21,4,5,68,36,32,67
Copenhagen,7374,3,15,4,11,58,45,13,49
FC Nords,7374,4,13,8,9,71,59,12,47
AC Horsens,7374,5,6,13,11,36,56,-20,31
Sonderjyske,7374,6,8,6,10,28,29,-1,30
AaB,7374,7,6,12,12,36,45,-9,30
Randers FC,7374,8,6,6,12,26,40,-14,24
Silkeborg IF,7374,9,6,3,13,27,44,-17,21
Lyngby,7374,10,3,9,12,27,47,-20,18
AGF Aarhus,7374,11,4,6,12,16,38,-22,18
FC Midtjylla,7375,1,21,4,5,71,39,32,67
Brondby,7375,2,19,6,5,67,33,34,63
FC Nords,7375,3,14,7,9,72,50,22,49
Copenhagen,7375,4,14,7,9,59,43,16,49
AaB,7375,5,7,12,11,36,48,-12,33
AC Horsens,7375,6,6,14,10,36,54,-18,32
Sonderjyske,7375,7,8,6,10,28,29,-1,30
Randers FC,7375,8,6,6,12,25,39,-14,24
Silkeborg IF,7375,9,6,3,13,30,45,-15,21
Lyngby,7375,10,3,9,12,26,46,-20,18
AGF Aarhus,7375,11,4,6,12,17,41,-24,18
Brondby,7376,1,21,6,3,72,30,42,69
FC Midtjylla,7376,2,18,4,8,62,40,22,58
FC Nords,7376,3,16,6,8,75,50,25,54
Copenhagen,7376,4,14,5,11,57,48,9,47
AC Horsens,7376,5,7,14,9,39,50,-11,35
AaB,7376,6,7,11,12,35,48,-13,32
Sonderjyske,7376,7,8,6,10,28,29,-1,30
Lyngby,7376,8,4,9,11,27,44,-17,21
Randers FC,7376,9,5,6,13,23,40,-17,21
Silkeborg IF,7376,10,5,4,13,26,45,-19,19
AGF Aarhus,7376,11,4,7,11,17,37,-20,19
Brondby,7377,1,23,5,2,78,32,46,74
FC Midtjylla,7377,2,19,5,6,65,39,26,62
Copenhagen,7377,3,14,6,10,62,47,15,48
FC Nords,7377,4,13,8,9,70,54,16,47
AaB,7377,5,7,12,11,33,43,-10,33
Sonderjyske,7377,6,8,6,10,28,29,-1,30
AC Horsens,7377,7,6,12,12,33,52,-19,30
Randers FC,7377,8,5,7,12,24,40,-16,22
AGF Aarhus,7377,9,5,6,11,17,36,-19,21
Lyngby,7377,10,3,10,11,27,45,-18,19
Silkeborg IF,7377,11,5,3,14,25,45,-20,18
Brondby,7378,1,22,6,2,74,30,44,72
FC Midtjylla,7378,2,18,7,5,61,37,24,61
FC Nords,7378,3,15,7,8,76,51,25,52
Copenhagen,7378,4,13,6,11,54,44,10,45
AaB,7378,5,7,13,10,35,40,-5,34
Sonderjyske,7378,6,8,6,10,28,29,-1,30
AC Horsens,7378,7,5,13,12,30,54,-24,28
Randers FC,7378,8,6,6,12,25,40,-15,24
AGF Aarhus,7378,9,5,6,11,17,36,-19,21
Lyngby,7378,10,3,9,12,27,46,-19,18
Silkeborg IF,7378,11,5,3,14,25,45,-20,18
Brondby,7379,1,21,7,2,70,30,40,70
FC Midtjylla,7379,2,19,5,6,65,42,23,62
FC Nords,7379,3,14,8,8,77,51,26,50
Copenhagen,7379,4,14,6,10,61,47,14,48
AaB,7379,5,7,11,12,33,45,-12,32
AC Horsens,7379,6,6,13,11,36,53,-17,31
Sonderjyske,7379,7,8,6,10,28,29,-1,30
Lyngby,7379,8,4,9,11,28,45,-17,21
Randers FC,7379,9,5,6,13,24,41,-17,21
AGF Aarhus,7379,10,5,6,11,19,38,-19,21
Silkeborg IF,7379,11,5,3,14,27,47,-20,18
Brondby,7380,1,21,5,4,73,36,37,68
FC Midtjylla,7380,2,20,4,6,66,43,23,64
FC Nords,7380,3,15,6,9,76,52,24,51
Copenhagen,7380,4,15,4,11,57,43,14,49
AaB,7380,5,7,12,11,36,42,-6,33
AC Horsens,7380,6,6,13,11,38,56,-18,31
Sonderjyske,7380,7,8,6,10,28,29,-1,30
Randers FC,7380,8,5,7,12,24,40,-16,22
AGF Aarhus,7380,9,5,6,11,18,37,-19,21
Lyngby,7380,10,3,10,11,27,45,-18,19
Silkeborg IF,7380,11,5,3,14,26,46,-20,18
FC Midtjylla,7381,1,20,6,4,67,39,28,66
Brondby,7381,2,19,6,5,73,38,35,63
FC Nords,7381,3,16,6,8,73,49,24,54
Copenhagen,7381,4,14,5,11,62,46,16,47
AC Horsens,7381,5,7,12,11,36,57,-21,33
AaB,7381,6,7,11,12,38,46,-8,32
Sonderjyske,7381,7,8,6,10,28,29,-1,30
Lyngby,7381,8,4,9,11,30,46,-16,21
Randers FC,7381,9,5,6,13,25,43,-18,21
AGF Aarhus,7381,10,5,6,11,17,36,-19,21
Silkeborg IF,7381,11,5,3,14,25,45,-20,18
Brondby,7382,1,21,5,4,68,32,36,68
FC Midtjylla,7382,2,20,4,6,68,43,25,64
FC Nords,7382,3,15,6,9,80,52,28,51
Copenhagen,7382,4,14,4,12,59,48,11,46
AC Horsens,7382,5,8,12,10,34,50,-16,36
AaB,7382,6,7,11,12,35,45,-10,32
Sonderjyske,7382,7,8,6,10,28,29,-1,30
Randers FC,7382,8,6,6,12,24,39,-15,24
Silkeborg IF,7382,9,6,3,13,28,46,-18,21
Lyngby,7382,10,3,9,12,26,45,-19,18
AGF Aarhus,7382,11,4,6,12,18,39,-21,18
Brondby,7383,1,20,8,2,71,32,39,68
FC Midtjylla,7383,2,19,6,5,65,39,26,63
Copenhagen,7383,3,15,4,11,60,47,13,49
FC Nords,7383,4,14,6,10,72,52,20,48
AaB,7383,5,7,12,11,35,41,-6,33
AC Horsens,7383,6,6,14,10,34,52,-18,32
Sonderjyske,7383,7,8,6,10,28,29,-1,30
Lyngby,7383,8,4,9,11,28,44,-16,21
Randers FC,7383,9,5,6,13,23,41,-18,21
AGF Aarhus,7383,10,5,6,11,19,37,-18,21
Silkeborg IF,7383,11,5,3,14,26,47,-21,18
Brondby,7384,1,19,7,4,68,32,36,64
FC Midtjylla,7384,2,19,5,6,62,37,25,62
FC Nords,7384,3,16,7,7,75,46,29,55
Copenhagen,7384,4,14,6,10,58,41,17,48
AC Horsens,7384,5,6,15,9,35,50,-15,33
Sonderjyske,7384,6,8,6,10,28,29,-1,30
AaB,7384,7,6,12,12,35,53,-18,30
Randers FC,7384,8,6,6,12,27,41,-14,24
Silkeborg IF,7384,9,6,3,13,28,44,-16,21
Lyngby,7384,10,3,9,12,28,48,-20,18
AGF Aarhus,7384,11,4,6,12,16,39,-23,18
Brondby,7385,1,21,6,3,68,31,37,69
FC Midtjylla,7385,2,19,4,7,60,39,21,61
FC Nords,7385,3,14,6,10,74,53,21,48
Copenhagen,7385,4,14,5,11,57,46,11,47
AaB,7385,5,8,12,10,38,42,-4,36
AC Horsens,7385,6,7,13,10,39,51,-12,34
Sonderjyske,7385,7,8,6,10,28,29,-1,30
Lyngby,7385,8,4,9,11,31,45,-14,21
Randers FC,7385,9,5,6,13,24,44,-20,21
Silkeborg IF,7385,10,5,4,13,26,45,-19,19
AGF Aarhus,7385,11,4,7,11,17,37,-20,19
FC Midtjylla,7386,1,20,6,4,65,37,28,66
Brondby,7386,2,19,7,4,65,31,34,64
Copenhagen,7386,3,14,6,10,58,44,14,48
FC Nords,7386,4,13,8,9,71,52,19,47
AC Horsens,7386,5,7,13,10,36,50,-14,34
AaB,7386,6,6,14,10,34,41,-7,32
Sonderjyske,7386,7,8,6,10,28,29,-1,30
Randers FC,7386,8,6,6,12,24,39,-15,24
Silkeborg IF,7386,9,5,4,13,27,46,-19,19
AGF Aarhus,7386,10,4,7,11,18,38,-20,19
Lyngby,7386,11,3,9,12,26,45,-19,18
FC Midtjylla,7387,1,21,4,5,69,37,32,67
Brondby,7387,2,19,6,5,69,36,33,63
FC Nords,7387,3,15,6,9,73,49,24,51
Copenhagen,7387,4,14,6,10,56,42,14,48
AaB,7387,5,7,12,11,36,47,-11,33
AC Horsens,7387,6,7,12,11,34,52,-18,33
Sonderjyske,7387,7,8,6,10,28,29,-1,30
Randers FC,7387,8,6,6,12,25,39,-14,24
Silkeborg IF,7387,9,5,4,13,27,46,-19,19
AGF Aarhus,7387,10,4,7,11,18,38,-20,19
Lyngby,7387,11,3,9,12,26,46,-20,18
Brondby,7388,1,19,8,3,68,33,35,65
FC Midtjylla,7388,2,19,6,5,65,39,26,63
FC Nords,7388,3,13,7,10,71,52,19,46
Copenhagen,7388,4,14,4,12,54,45,9,46
AaB,7388,5,9,11,10,38,40,-2,38
AC Horsens,7388,6,7,14,9,41,54,-13,35
Sonderjyske,7388,7,8,6,10,28,29,-1,30
Lyngby,7388,8,4,9,11,29,45,-16,21
Randers FC,7388,9,5,6,13,24,42,-18,21
Silkeborg IF,7388,10,5,4,13,27,46,-19,19
AGF Aarhus,7388,11,4,7,11,18,38,-20,19
Brondby,7389,1,23,5,2,78,30,48,74
FC Midtjylla,7389,2,20,4,6,61,37,24,64
FC Nords,7389,3,15,6,9,76,52,24,51
Copenhagen,7389,4,14,5,11,59,47,12,47
AC Horsens,7389,5,6,13,11,37,55,-18,31
Sonderjyske,7389,6,8,6,10,28,29,-1,30
AaB,7389,7,6,11,13,33,49,-16,29
Randers FC,7389,8,6,6,12,25,39,-14,24
Silkeborg IF,7389,9,6,3,13,28,45,-17,21
Lyngby,7389,10,3,9,12,26,46,-20,18
AGF Aarhus,7389,11,4,6,12,17,39,-22,18
Brondby,7390,1,20,6,4,73,38,35,66
FC Midtjylla,7390,2,18,5,7,68,49,19,59
FC Nords,7390,3,16,6,8,86,54,32,54
Copenhagen,7390,4,14,5,11,60,51,9,47
AaB,7390,5,8,13,9,41,41,0,37
AC Horsens,7390,6,6,13,11,38,59,-21,31
Sonderjyske,7390,7,8,6,10,28,29,-1,30
Lyngby,7390,8,4,9,11,28,44,-16,21
Randers FC,7390,9,5,6,13,23,41,-18,21
AGF Aarhus,7390,10,5,6,11,18,36,-18,21
Silkeborg IF,7390,11,5,3,14,25,46,-21,18
Brondby,7391,1,21,7,2,70,32,38,70
FC Midtjylla,7391,2,19,5,6,66,37,29,62
Copenhagen,7391,3,14,6,10,59,44,15,48
FC Nords,7391,4,13,7,10,71,54,17,46
AaB,7391,5,8,14,8,41,42,-1,38
Sonderjyske,7391,6,8,6,10,28,29,-1,30
AC Horsens,7391,7,5,13,12,34,58,-24,28
Randers FC,7391,8,6,6,12,24,39,-15,24
Silkeborg IF,7391,9,5,4,13,26,45,-19,19
AGF Aarhus,7391,10,4,7,11,17,37,-20,19
Lyngby,7391,11,3,9,12,26,45,-19,18
Brondby,7392,1,21,6,3,75,32,43,69
FC Midtjylla,7392,2,19,6,5,65,41,24,63
FC Nords,7392,3,14,7,9,77,55,22,49
Copenhagen,7392,4,14,5,11,59,45,14,47
AaB,7392,5,8,13,9,36,40,-4,37
Sonderjyske,7392,6,8,6,10,28,29,-1,30
AC Horsens,7392,7,5,13,12,33,58,-25,28
Lyngby,7392,8,4,9,11,31,45,-14,21
Silkeborg IF,7392,9,6,3,13,28,45,-17,21
Randers FC,7392,10,5,6,13,24,44,-20,21
AGF Aarhus,7392,11,4,6,12,17,39,-22,18
Brondby,7393,1,19,7,4,67,32,35,64
FC Midtjylla,7393,2,20,4,6,70,41,29,64
FC Nords,7393,3,15,7,8,72,49,23,52
Copenhagen,7393,4,13,7,10,57,44,13,46
AaB,7393,5,7,13,10,36,44,-8,34
AC Horsens,7393,6,6,14,10,33,51,-18,32
Sonderjyske,7393,7,8,6,10,28,29,-1,30
Randers FC,7393,8,5,7,12,23,39,-16,22
Lyngby,7393,9,3,10,11,26,44,-18,19
Silkeborg IF,7393,10,5,4,13,26,45,-19,19
AGF Aarhus,7393,11,4,7,11,17,37,-20,19
Brondby,7394,1,22,6,2,78,32,46,72
FC Midtjylla,7394,2,20,5,5,69,40,29,65
FC Nords,7394,3,14,7,9,73,55,18,49
Copenhagen,7394,4,13,6,11,60,51,9,45
AaB,7394,5,7,12,11,38,43,-5,33
Sonderjyske,7394,6,8,6,10,28,29,-1,30
AC Horsens,7394,7,5,14,11,33,56,-23,29
Randers FC,7394,8,6,6,12,24,39,-15,24
Silkeborg IF,7394,9,6,3,13,27,44,-17,21
Lyngby,7394,10,3,9,12,26,45,-19,18
AGF Aarhus,7394,11,4,6,12,16,38,-22,18
Brondby,7395,1,22,6,2,72,30,42,72
FC Midtjylla,7395,2,19,5,6,65,39,26,62
FC Nords,7395,3,15,7,8,72,48,24,52
Copenhagen,7395,4,12,5,13,53,48,5,41
AC Horsens,7395,5,7,13,10,36,48,-12,34
AaB,7395,6,7,12,11,35,46,-11,33
Sonderjyske,7395,7,8,6,10,28,29,-1,30
Randers FC,7395,8,6,6,12,27,41,-14,24
AGF Aarhus,7395,9,5,6,11,18,36,-18,21
Lyngby,7395,10,3,9,12,28,48,-20,18
Silkeborg IF,7395,11,5,3,14,25,46,-21,18
FC Midtjylla,7396,1,20,4,6,64,43,21,64
Brondby,7396,2,19,6,5,67,38,29,63
FC Nords,7396,3,15,8,7,81,50,31,53
Copenhagen,7396,4,14,6,10,62,44,18,48
AC Horsens,7396,5,6,15,9,32,48,-16,33
AaB,7396,6,6,13,11,39,48,-9,31
Sonderjyske,7396,7,8,6,10,28,29,-1,30
Lyngby,7396,8,4,9,11,28,44,-16,21
Silkeborg IF,7396,9,6,3,13,27,45,-18,21
Randers FC,7396,10,5,6,13,23,41,-18,21
AGF Aarhus,7396,11,4,6,12,17,38,-21,18
Brondby,7397,1,21,6,3,71,31,40,69
FC Midtjylla,7397,2,18,4,8,63,41,22,58
FC Nords,7397,3,15,6,9,71,49,22,51
Copenhagen,7397,4,15,4,11,55,40,15,49
AaB,7397,5,7,13,10,34,43,-9,34
AC Horsens,7397,6,7,13,10,34,50,-16,34
Sonderjyske,7397,7,8,6,10,28,29,-1,30
Lyngby,7397,8,4,9,11,29,46,-17,21
Silkeborg IF,7397,9,6,3,13,28,45,-17,21
Randers FC,7397,10,5,6,13,25,42,-17,21
AGF Aarhus,7397,11,4,6,12,17,39,-22,18
Brondby,7398,1,20,8,2,73,33,40,68
FC Midtjylla,7398,2,19,5,6,64,43,21,62
FC Nords,7398,3,13,9,8,72,50,22,48
Copenhagen,7398,4,13,6,11,57,47,10,45
AaB,7398,5,7,14,9,39,42,-3,35
AC Horsens,7398,6,5,16,9,37,53,-16,31
Sonderjyske,7398,7,8,6,10,28,29,-1,30
Lyngby,7398,8,4,9,11,28,44,-16,21
Randers FC,7398,9,5,6,13,23,41,-18,21
Silkeborg IF,7398,10,5,4,13,27,46,-19,19
AGF Aarhus,7398,11,4,7,11,18,38,-20,19
Brondby,7399,1,22,5,3,69,29,40,71
FC Midtjylla,7399,2,20,4,6,66,42,24,64
Copenhagen,7399,3,15,4,11,62,46,16,49
FC Nords,7399,4,14,6,10,69,48,21,48
AaB,7399,5,9,11,10,37,41,-4,38
Sonderjyske,7399,6,8,6,10,28,29,-1,30
AC Horsens,7399,7,5,12,13,33,56,-23,27
Lyngby,7399,8,4,9,11,27,44,-17,21
Randers FC,7399,9,5,6,13,23,40,-17,21
Silkeborg IF,7399,10,5,4,13,26,45,-19,19
AGF Aarhus,7399,11,4,7,11,17,37,-20,19
Brondby,7400,1,19,8,3,68,34,34,65
FC Midtjylla,7400,2,18,5,7,62,38,24,59
Copenhagen,7400,3,16,5,9,60,38,22,53
FC Nords,7400,4,13,7,10,71,56,15,46
AaB,7400,5,9,11,10,39,41,-2,38
AC Horsens,7400,6,7,12,11,34,53,-19,33
Sonderjyske,7400,7,8,6,10,28,29,-1,30
Randers FC,7400,8,6,6,12,24,39,-15,24
AGF Aarhus,7400,9,5,6,11,18,37,-19,21
Lyngby,7400,10,3,9,12,26,45,-19,18
Silkeborg IF,7400,11,5,3,14,26,46,-20,18
FC Midtjylla,7401,1,21,4,5,66,36,30,67
Brondby,7401,2,20,5,5,68,33,35,65
Copenhagen,7401,3,14,6,10,55,41,14,48
FC Nords,7401,4,13,8,9,70,52,18,47
AaB,7401,5,8,13,9,39,41,-2,37
Sonderjyske,7401,6,8,6,10,28,29,-1,30
AC Horsens,7401,7,6,12,12,32,53,-21,30
Silkeborg IF,7401,8,6,3,13,28,44,-16,21
Lyngby,7401,9,4,9,11,28,45,-17,21
Randers FC,7401,10,5,6,13,24,41,-17,21
AGF Aarhus,7401,11,4,6,12,16,39,-23,18
Brondby,7402,1,21,6,3,74,31,43,69
FC Midtjylla,7402,2,19,4,7,62,41,21,61
FC Nords,7402,3,14,6,10,72,50,22,48
Copenhagen,7402,4,14,5,11,56,44,12,47
AaB,7402,5,8,12,10,39,46,-7,36
AC Horsens,7402,6,7,13,10,35,52,-17,34
Sonderjyske,7402,7,8,6,10,28,29,-1,30
Randers FC,7402,8,6,6,12,27,40,-13,24
AGF Aarhus,7402,9,5,6,11,19,38,-19,21
Silkeborg IF,7402,10,5,3,14,27,47,-20,18
Lyngby,7402,11,3,9,12,27,48,-21,18
Brondby,7403,1,21,6,3,74,35,39,69
FC Midtjylla,7403,2,20,4,6,64,39,25,64
FC Nords,7403,3,15,6,9,71,50,21,51
Copenhagen,7403,4,14,6,10,57,43,14,48
AC Horsens,7403,5,7,12,11,35,51,-16,33
Sonderjyske,7403,6,8,6,10,28,29,-1,30
AaB,7403,7,6,12,12,35,44,-9,30
Lyngby,7403,8,4,9,11,27,44,-17,21
Randers FC,7403,9,5,6,13,23,40,-17,21
AGF Aarhus,7403,10,5,6,11,17,36,-19,21
Silkeborg IF,7403,11,5,3,14,25,45,-20,18
Brondby,7404,1,21,6,3,69,32,37,69
FC Midtjylla,7404,2,20,4,6,65,38,27,64
FC Nords,7404,3,15,6,9,76,50,26,51
Copenhagen,7404,4,13,4,13,56,50,6,43
AaB,7404,5,8,12,10,41,40,1,36
AC Horsens,7404,6,7,12,11,36,59,-23,33
Sonderjyske,7404,7,8,6,10,28,29,-1,30
Randers FC,7404,8,6,6,12,26,40,-14,24
AGF Aarhus,7404,9,5,6,11,18,37,-19,21
Lyngby,7404,10,3,9,12,27,47,-20,18
Silkeborg IF,7404,11,5,3,14,26,46,-20,18
Brondby,7405,1,21,6,3,75,36,39,69
FC Midtjylla,7405,2,19,6,5,67,38,29,63
FC Nords,7405,3,14,8,8,77,55,22,50
Copenhagen,7405,4,13,6,11,57,48,9,45
AaB,7405,5,7,14,9,41,44,-3,35
Sonderjyske,7405,6,8,6,10,28,29,-1,30
AC Horsens,7405,7,5,14,11,34,56,-22,29
Randers FC,7405,8,6,6,12,25,39,-14,24
AGF Aarhus,7405,9,5,6,11,17,36,-19,21
Lyngby,7405,10,3,9,12,26,46,-20,18
Silkeborg IF,7405,11,5,3,14,25,45,-20,18
Brondby,7406,1,20,7,3,73,36,37,67
FC Midtjylla,7406,2,19,6,5,66,39,27,63
FC Nords,7406,3,15,7,8,76,52,24,52
Copenhagen,7406,4,12,5,13,53,47,6,41
AaB,7406,5,7,14,9,40,44,-4,35
AC Horsens,7406,6,7,13,10,38,54,-16,34
Sonderjyske,7406,7,8,6,10,28,29,-1,30
Randers FC,7406,8,5,7,12,24,40,-16,22
AGF Aarhus,7406,9,5,6,11,17,36,-19,21
Lyngby,7406,10,3,10,11,27,45,-18,19
Silkeborg IF,7406,11,5,3,14,25,45,-20,18
Brondby,7407,1,20,6,4,70,34,36,66
FC Midtjylla,7407,2,20,5,5,67,39,28,65
Copenhagen,7407,3,14,6,10,60,46,14,48
FC Nords,7407,4,13,7,10,73,54,19,46
AaB,7407,5,8,12,10,38,44,-6,36
AC Horsens,7407,6,6,14,10,36,53,-17,32
Sonderjyske,7407,7,8,6,10,28,29,-1,30
Randers FC,7407,8,6,6,12,25,39,-14,24
AGF Aarhus,7407,9,5,6,11,19,37,-18,21
Lyngby,7407,10,3,9,12,26,46,-20,18
Silkeborg IF,7407,11,5,3,14,26,47,-21,18
Brondby,7408,1,22,5,3,71,30,41,71
FC Midtjylla,7408,2,22,4,4,68,33,35,70
FC Nords,7408,3,14,6,10,71,49,22,48
Copenhagen,7408,4,13,5,12,53,46,7,44
AaB,7408,5,7,13,10,34,42,-8,34
Sonderjyske,7408,6,8,6,10,28,29,-1,30
AC Horsens,7408,7,5,13,12,33,56,-23,28
Randers FC,7408,8,5,7,12,24,40,-16,22
Lyngby,7408,9,3,10,11,27,45,-18,19
Silkeborg IF,7408,10,5,4,13,26,45,-19,19
AGF Aarhus,7408,11,4,7,11,17,37,-20,19
Brondby,7409,1,21,6,3,69,30,39,69
FC Midtjylla,7409,2,19,5,6,67,41,26,62
FC Nords,7409,3,14,7,9,74,51,23,49
Copenhagen,7409,4,14,6,10,59,44,15,48
AaB,7409,5,7,13,10,35,42,-7,34
AC Horsens,7409,6,6,13,11,31,53,-22,31
Sonderjyske,7409,7,8,6,10,28,29,-1,30
Lyngby,7409,8,4,9,11,28,44,-16,21
Randers FC,7409,9,5,6,13,23,41,-18,21
Silkeborg IF,7409,10,5,4,13,26,45,-19,19
AGF Aarhus,7409,11,4,7,11,17,37,-20,19
Brondby,7410,1,20,7,3,70,33,37,67
FC Midtjylla,7410,2,19,6,5,64,36,28,63
FC Nords,7410,3,15,6,9,74,50,24,51
Copenhagen,7410,4,13,6,11,54,46,8,45
AC Horsens,7410,5,7,13,10,33,49,-16,34
AaB,7410,6,7,12,11,34,41,-7,33
Sonderjyske,7410,7,8,6,10,28,29,-1,30
Lyngby,7410,8,4,9,11,27,44,-17,21
Randers FC,7410,9,5,6,13,23,40,-17,21
AGF Aarhus,7410,10,5,6,11,18,36,-18,21
Silkeborg IF,7410,11,5,3,14,25,46,-21,18
Brondby,7411,1,22,5,3,76,29,47,71
FC Midtjylla,7411,2,20,5,5,68,37,31,65
FC Nords,7411,3,14,7,9,70,53,17,49
Copenhagen,7411,4,14,4,12,57,46,11,46
AaB,7411,5,8,11,11,38,48,-10,35
Sonderjyske,7411,6,8,6,10,28,29,-1,30
AC Horsens,7411,7,6,12,12,34,56,-22,30
Randers FC,7411,8,5,7,12,23,39,-16,22
Silkeborg IF,7411,9,6,3,13,28,44,-16,21
Lyngby,7411,10,3,10,11,26,44,-18,19
AGF Aarhus,7411,11,4,6,12,16,39,-23,18
Brondby,7412,1,21,7,2,74,31,43,70
FC Midtjylla,7412,2,19,5,6,63,39,24,62
FC Nords,7412,3,15,6,9,75,56,19,51
Copenhagen,7412,4,14,5,11,59,43,16,47
AaB,7412,5,8,13,9,37,42,-5,37
Sonderjyske,7412,6,8,6,10,28,29,-1,30
AC Horsens,7412,7,5,12,13,33,56,-23,27
Randers FC,7412,8,6,6,12,25,40,-15,24
Silkeborg IF,7412,9,5,4,13,26,45,-19,19
AGF Aarhus,7412,10,4,7,11,17,37,-20,19
Lyngby,7412,11,3,9,12,27,46,-19,18
Brondby,7413,1,19,7,4,66,34,32,64
FC Midtjylla,7413,2,17,7,6,63,42,21,58
FC Nords,7413,3,15,8,7,76,48,28,53
Copenhagen,7413,4,13,7,10,55,42,13,46
AaB,7413,5,8,11,11,38,44,-6,35
AC Horsens,7413,6,7,14,9,36,50,-14,35
Sonderjyske,7413,7,8,6,10,28,29,-1,30
Randers FC,7413,8,6,6,12,26,40,-14,24
Silkeborg IF,7413,9,5,4,13,27,46,-19,19
AGF Aarhus,7413,10,4,7,11,18,38,-20,19
Lyngby,7413,11,3,9,12,27,47,-20,18
Brondby,7414,1,22,5,3,76,32,44,71
FC Midtjylla,7414,2,20,4,6,68,39,29,64
FC Nords,7414,3,14,6,10,71,49,22,48
Copenhagen,7414,4,14,4,12,57,48,9,46
AC Horsens,7414,5,8,12,10,36,56,-20,36
AaB,7414,6,7,11,12,39,49,-10,32
Sonderjyske,7414,7,8,6,10,28,29,-1,30
Randers FC,7414,8,6,6,12,26,39,-13,24
Silkeborg IF,7414,9,6,3,13,26,44,-18,21
Lyngby,7414,10,3,9,12,26,47,-21,18
AGF Aarhus,7414,11,4,6,12,16,37,-21,18
Brondby,7415,1,21,5,4,73,37,36,68
FC Midtjylla,7415,2,20,5,5,65,38,27,65
Copenhagen,7415,3,15,4,11,56,44,12,49
FC Nords,7415,4,14,6,10,77,55,22,48
AaB,7415,5,8,12,10,41,44,-3,36
Sonderjyske,7415,6,8,6,10,28,29,-1,30
AC Horsens,7415,7,5,14,11,33,53,-20,29
Randers FC,7415,8,6,6,12,25,40,-15,24
Silkeborg IF,7415,9,5,4,13,26,45,-19,19
AGF Aarhus,7415,10,4,7,11,17,37,-20,19
Lyngby,7415,11,3,9,12,27,46,-19,18
Brondby,7416,1,20,6,4,66,30,36,66
FC Midtjylla,7416,2,19,5,6,61,36,25,62
FC Nords,7416,3,14,6,10,68,48,20,48
Copenhagen,7416,4,13,6,11,52,41,11,45
AaB,7416,5,9,13,8,35,36,-1,40
AC Horsens,7416,6,7,12,11,34,51,-17,33
Sonderjyske,7416,7,8,6,10,28,29,-1,30
Randers FC,7416,8,6,6,12,25,40,-15,24
Silkeborg IF,7416,9,5,4,13,25,44,-19,19
AGF Aarhus,7416,10,4,7,11,16,36,-20,19
Lyngby,7416,11,3,9,12,27,46,-19,18
Brondby,7417,1,20,6,4,71,34,37,66
FC Midtjylla,7417,2,19,7,4,67,37,30,64
FC Nords,7417,3,14,9,7,76,51,25,51
Copenhagen,7417,4,13,6,11,52,42,10,45
AaB,7417,5,8,13,9,37,43,-6,37
Sonderjyske,7417,6,8,6,10,28,29,-1,30
AC Horsens,7417,7,5,13,12,34,56,-22,28
Silkeborg IF,7417,8,6,3,13,29,45,-16,21
Lyngby,7417,9,4,9,11,29,46,-17,21
Randers FC,7417,10,5,6,13,25,42,-17,21
AGF Aarhus,7417,11,4,6,12,17,40,-23,18
FC Midtjylla,7418,1,21,5,4,69,40,29,68
Brondby,7418,2,20,6,4,70,34,36,66
FC Nords,7418,3,14,7,9,72,49,23,49
Copenhagen,7418,4,14,5,11,61,49,12,47
AaB,7418,5,7,12,11,40,45,-5,33
AC Horsens,7418,6,6,13,11,32,53,-21,31
Sonderjyske,7418,7,8,6,10,28,29,-1,30
Randers FC,7418,8,6,6,12,26,40,-14,24
Silkeborg IF,7418,9,5,4,13,26,45,-19,19
AGF Aarhus,7418,10,4,7,11,17,37,-20,19
Lyngby,7418,11,3,9,12,27,47,-20,18
FC Midtjylla,7419,1,20,4,6,70,41,29,64
Brondby,7419,2,19,6,5,68,35,33,63
FC Nords,7419,3,15,7,8,76,57,19,52
Copenhagen,7419,4,14,4,12,56,45,11,46
AaB,7419,5,9,11,10,39,43,-4,38
AC Horsens,7419,6,7,12,11,38,52,-14,33
Sonderjyske,7419,7,8,6,10,28,29,-1,30
Lyngby,7419,8,4,9,11,28,44,-16,21
Silkeborg IF,7419,9,6,3,13,27,44,-17,21
Randers FC,7419,10,5,6,13,23,41,-18,21
AGF Aarhus,7419,11,4,6,12,16,38,-22,18
Brondby,7420,1,21,6,3,72,32,40,69
FC Midtjylla,7420,2,20,4,6,64,38,26,64
Copenhagen,7420,3,15,4,11,59,43,16,49
FC Nords,7420,4,13,7,10,74,56,18,46
AaB,7420,5,7,13,10,34,40,-6,34
AC Horsens,7420,6,6,14,10,35,55,-20,32
Sonderjyske,7420,7,8,6,10,28,29,-1,30
Randers FC,7420,8,5,7,12,25,41,-16,22
Silkeborg IF,7420,9,6,3,13,26,44,-18,21
Lyngby,7420,10,3,10,11,28,46,-18,19
AGF Aarhus,7420,11,4,6,12,16,37,-21,18
FC Midtjylla,7421,1,21,4,5,71,39,32,67
Brondby,7421,2,20,5,5,77,37,40,65
Copenhagen,7421,3,14,6,10,59,44,15,48
FC Nords,7421,4,13,8,9,70,54,16,47
AaB,7421,5,9,11,10,42,44,-2,38
Sonderjyske,7421,6,8,6,10,28,29,-1,30
AC Horsens,7421,7,5,14,11,30,57,-27,29
Randers FC,7421,8,5,7,12,23,39,-16,22
Silkeborg IF,7421,9,6,3,13,27,45,-18,21
Lyngby,7421,10,3,10,11,26,44,-18,19
AGF Aarhus,7421,11,4,6,12,17,38,-21,18
Brondby,7422,1,22,5,3,72,30,42,71
FC Midtjylla,7422,2,20,5,5,70,40,30,65
FC Nords,7422,3,15,7,8,73,51,22,52
Copenhagen,7422,4,14,4,12,59,48,11,46
AaB,7422,5,7,11,12,35,46,-11,32
Sonderjyske,7422,6,8,6,10,28,29,-1,30
AC Horsens,7422,7,6,12,12,34,54,-20,30
Randers FC,7422,8,6,6,12,24,39,-15,24
AGF Aarhus,7422,9,5,6,11,18,36,-18,21
Lyngby,7422,10,3,9,12,26,45,-19,18
Silkeborg IF,7422,11,5,3,14,25,46,-21,18
Brondby,7423,1,20,5,5,68,33,35,65
FC Midtjylla,7423,2,20,4,6,65,40,25,64
FC Nords,7423,3,16,6,8,78,50,28,54
Copenhagen,7423,4,14,5,11,59,46,13,47
AaB,7423,5,8,12,10,38,41,-3,36
Sonderjyske,7423,6,8,6,10,28,29,-1,30
AC Horsens,7423,7,5,14,11,31,55,-24,29
Lyngby,7423,8,4,9,11,28,44,-16,21
Randers FC,7423,9,5,6,13,23,41,-18,21
AGF Aarhus,7423,10,5,6,11,19,37,-18,21
Silkeborg IF,7423,11,5,3,14,26,47,-21,18
Brondby,7424,1,23,5,2,75,31,44,74
FC Midtjylla,7424,2,19,5,6,66,42,24,62
FC Nords,7424,3,15,7,8,77,49,28,52
Copenhagen,7424,4,14,4,12,60,51,9,46
AaB,7424,5,7,11,12,37,50,-13,32
Sonderjyske,7424,6,8,6,10,28,29,-1,30
AC Horsens,7424,7,6,12,12,36,54,-18,30
Randers FC,7424,8,6,6,12,25,39,-14,24
Silkeborg IF,7424,9,6,3,13,26,44,-18,21
Lyngby,7424,10,3,9,12,26,46,-20,18
AGF Aarhus,7424,11,4,6,12,16,37,-21,18
Brondby,7425,1,22,6,2,77,31,46,72
FC Midtjylla,7425,2,21,4,5,71,39,32,67
FC Nords,7425,3,13,7,10,72,59,13,46
Copenhagen,7425,4,13,5,12,58,48,10,44
AaB,7425,5,8,11,11,35,42,-7,35
AC Horsens,7425,6,6,13,11,38,58,-20,31
Sonderjyske,7425,7,8,6,10,28,29,-1,30
Lyngby,7425,8,4,9,11,28,45,-17,21
Silkeborg IF,7425,9,6,3,13,27,44,-17,21
Randers FC,7425,10,5,6,13,24,41,-17,21
AGF Aarhus,7425,11,4,6,12,16,38,-22,18
Brondby,7426,1,20,6,4,69,32,37,66
FC Midtjylla,7426,2,20,6,4,64,36,28,66
Copenhagen,7426,3,14,5,11,55,44,11,47
FC Nords,7426,4,13,7,10,73,53,20,46
AC Horsens,7426,5,8,12,10,35,53,-18,36
AaB,7426,6,7,12,11,39,43,-4,33
Sonderjyske,7426,7,8,6,10,28,29,-1,30
Randers FC,7426,8,6,6,12,24,39,-15,24
Silkeborg IF,7426,9,6,3,13,26,44,-18,21
Lyngby,7426,10,3,9,12,26,45,-19,18
AGF Aarhus,7426,11,4,6,12,16,37,-21,18
Brondby,7427,1,21,6,3,73,29,44,69
FC Midtjylla,7427,2,20,4,6,70,41,29,64
FC Nords,7427,3,14,7,9,73,51,22,49
Copenhagen,7427,4,14,5,11,57,47,10,47
AC Horsens,7427,5,8,13,9,38,53,-15,37
Sonderjyske,7427,6,8,6,10,28,29,-1,30
AaB,7427,7,6,11,13,33,49,-16,29
Randers FC,7427,8,5,7,12,23,39,-16,22
Silkeborg IF,7427,9,6,3,13,27,44,-17,21
Lyngby,7427,10,3,10,11,26,44,-18,19
AGF Aarhus,7427,11,4,6,12,16,38,-22,18
Brondby,7428,1,20,5,5,70,37,33,65
FC Midtjylla,7428,2,20,5,5,72,42,30,65
Copenhagen,7428,3,16,5,9,60,42,18,53
FC Nords,7428,4,14,6,10,72,56,16,48
AC Horsens,7428,5,7,12,11,35,50,-15,33
AaB,7428,6,7,11,12,37,45,-8,32
Sonderjyske,7428,7,8,6,10,28,29,-1,30
Lyngby,7428,8,4,9,11,28,44,-16,21
Silkeborg IF,7428,8,6,3,13,28,44,-16,21
Randers FC,7428,10,5,6,13,23,41,-18,21
AGF Aarhus,7428,11,4,6,12,16,39,-23,18
Brondby,7429,1,20,6,4,69,32,37,66
FC Midtjylla,7429,2,20,5,5,70,40,30,65
FC Nords,7429,3,15,6,9,76,53,23,51
Copenhagen,7429,4,14,6,10,57,45,12,48
AaB,7429,5,7,12,11,33,42,-9,33
AC Horsens,7429,6,6,13,11,34,53,-19,31
Sonderjyske,7429,7,8,6,10,28,29,-1,30
Randers FC,7429,8,5,7,12,24,40,-16,22
Lyngby,7429,9,3,10,11,27,45,-18,19
Silkeborg IF,7429,10,5,4,13,25,44,-19,19
AGF Aarhus,7429,11,4,7,11,16,36,-20,19
Brondby,7430,1,21,5,4,72,38,34,68
FC Midtjylla,7430,2,21,4,5,72,38,34,67
FC Nords,7430,3,15,6,9,74,54,20,51
Copenhagen,7430,4,15,4,11,61,44,17,49
AaB,7430,5,8,11,11,35,44,-9,35
Sonderjyske,7430,6,8,6,10,28,29,-1,30
AC Horsens,7430,7,5,12,13,32,54,-22,27
Randers FC,7430,8,5,7,12,24,40,-16,22
AGF Aarhus,7430,9,5,6,11,19,38,-19,21
Lyngby,7430,10,3,10,11,27,45,-18,19
Silkeborg IF,7430,11,5,3,14,27,47,-20,18
FC Midtjylla,7431,1,21,4,5,68,36,32,67
Brondby,7431,2,20,5,5,66,37,29,65
Copenhagen,7431,3,16,4,10,64,43,21,52
FC Nords,7431,4,12,6,12,70,59,11,42
AC Horsens,7431,5,8,13,9,40,49,-9,37
AaB,7431,6,7,12,11,36,46,-10,33
Sonderjyske,7431,7,8,6,10,28,29,-1,30
Lyngby,7431,8,4,9,11,27,44,-17,21
Randers FC,7431,9,5,6,13,23,40,-17,21
AGF Aarhus,7431,10,5,6,11,18,37,-19,21
Silkeborg IF,7431,11,5,3,14,26,46,-20,18
Brondby,7432,1,20,5,5,70,34,36,65
FC Midtjylla,7432,2,19,4,7,66,40,26,61
FC Nords,7432,3,17,6,7,79,51,28,57
Copenhagen,7432,4,14,6,10,56,43,13,48
AC Horsens,7432,5,6,14,10,37,56,-19,32
AaB,7432,6,6,13,11,34,44,-10,31
Sonderjyske,7432,7,8,6,10,28,29,-1,30
Randers FC,7432,8,5,7,12,23,39,-16,22
Lyngby,7432,9,3,10,11,26,44,-18,19
Silkeborg IF,7432,10,5,4,13,26,45,-19,19
AGF Aarhus,7432,11,4,7,11,17,37,-20,19
Brondby,7433,1,21,7,2,74,30,44,70
FC Midtjylla,7433,2,20,5,5,71,40,31,65
Copenhagen,7433,3,13,7,10,56,42,14,46
FC Nords,7433,4,12,8,10,76,63,13,44
AaB,7433,5,8,12,10,40,46,-6,36
AC Horsens,7433,6,6,13,11,36,58,-22,31
Sonderjyske,7433,7,8,6,10,28,29,-1,30
Randers FC,7433,8,5,7,12,23,39,-16,22
AGF Aarhus,7433,9,5,6,11,17,36,-19,21
Lyngby,7433,10,3,10,11,26,44,-18,19
Silkeborg IF,7433,11,5,3,14,25,45,-20,18
Brondby,7434,1,22,5,3,73,33,40,71
FC Midtjylla,7434,2,18,4,8,63,43,20,58
Copenhagen,7434,3,15,5,10,59,42,17,50
FC Nords,7434,4,14,6,10,76,57,19,48
AaB,7434,5,9,11,10,40,43,-3,38
AC Horsens,7434,6,6,13,11,36,55,-19,31
Sonderjyske,7434,7,8,6,10,28,29,-1,30
Lyngby,7434,8,4,9,11,29,44,-15,21
Silkeborg IF,7434,9,6,3,13,26,44,-18,21
Randers FC,7434,10,5,6,13,23,42,-19,21
AGF Aarhus,7434,11,4,6,12,16,37,-21,18
Brondby,7435,1,20,6,4,68,32,36,66
FC Midtjylla,7435,2,20,5,5,71,42,29,65
FC Nords,7435,3,14,6,10,74,54,20,48
Copenhagen,7435,4,14,6,10,59,46,13,48
AaB,7435,5,8,11,11,40,45,-5,35
AC Horsens,7435,6,6,14,10,34,53,-19,32
Sonderjyske,7435,7,8,6,10,28,29,-1,30
Silkeborg IF,7435,8,6,3,13,29,46,-17,21
Lyngby,7435,9,4,9,11,27,44,-17,21
Randers FC,7435,10,5,6,13,23,40,-17,21
AGF Aarhus,7435,11,4,6,12,18,40,-22,18
Brondby,7436,1,19,6,5,68,38,30,63
FC Midtjylla,7436,2,19,5,6,64,40,24,62
FC Nords,7436,3,14,7,9,76,53,23,49
Copenhagen,7436,4,14,6,10,58,44,14,48
AaB,7436,5,9,12,9,39,39,0,39
AC Horsens,7436,6,7,12,11,36,53,-17,33
Sonderjyske,7436,7,8,6,10,28,29,-1,30
Lyngby,7436,8,4,9,11,28,45,-17,21
Randers FC,7436,9,5,6,13,24,41,-17,21
Silkeborg IF,7436,10,6,3,13,28,46,-18,21
AGF Aarhus,7436,11,4,6,12,18,39,-21,18
Brondby,7437,1,22,5,3,78,38,40,71
FC Midtjylla,7437,2,20,4,6,67,41,26,64
FC Nords,7437,3,15,6,9,78,54,24,51
Copenhagen,7437,4,12,4,14,51,49,2,40
AaB,7437,5,9,11,10,42,45,-3,38
AC Horsens,7437,6,7,12,11,39,54,-15,33
Sonderjyske,7437,7,8,6,10,28,29,-1,30
Randers FC,7437,8,6,6,12,25,40,-15,24
AGF Aarhus,7437,9,5,6,11,17,36,-19,21
Lyngby,7437,10,3,9,12,27,46,-19,18
Silkeborg IF,7437,11,5,3,14,25,45,-20,18
FC Midtjylla,7438,1,21,5,4,73,40,33,68
Brondby,7438,2,19,8,3,72,34,38,65
Copenhagen,7438,3,14,7,9,60,44,16,49
FC Nords,7438,4,13,8,9,73,55,18,47
AaB,7438,5,6,13,11,37,47,-10,31
Sonderjyske,7438,6,8,6,10,28,29,-1,30
AC Horsens,7438,7,5,15,10,37,58,-21,30
Randers FC,7438,8,5,7,12,24,40,-16,22
Silkeborg IF,7438,9,6,3,13,27,45,-18,21
Lyngby,7438,10,3,10,11,27,45,-18,19
AGF Aarhus,7438,11,4,6,12,17,38,-21,18
Brondby,7439,1,21,5,4,71,31,40,68
FC Midtjylla,7439,2,18,6,6,66,42,24,60
FC Nords,7439,3,15,7,8,74,49,25,52
Copenhagen,7439,4,15,4,11,56,44,12,49
AaB,7439,5,7,13,10,39,48,-9,34
Sonderjyske,7439,6,8,6,10,28,29,-1,30
AC Horsens,7439,7,5,15,10,31,49,-18,30
Randers FC,7439,8,6,6,12,26,40,-14,24
AGF Aarhus,7439,9,5,6,11,18,37,-19,21
Lyngby,7439,10,3,9,12,27,47,-20,18
Silkeborg IF,7439,11,5,3,14,26,46,-20,18
Brondby,7440,1,21,6,3,69,33,36,69
FC Midtjylla,7440,2,18,7,5,64,39,25,61
Copenhagen,7440,3,14,5,11,59,47,12,47
FC Nords,7440,4,13,7,10,72,52,20,46
AaB,7440,5,8,13,9,37,41,-4,37
AC Horsens,7440,6,6,14,10,35,50,-15,32
Sonderjyske,7440,7,8,6,10,28,29,-1,30
Lyngby,7440,8,4,9,11,28,45,-17,21
Randers FC,7440,9,5,6,13,24,41,-17,21
AGF Aarhus,7440,10,5,6,11,18,37,-19,21
Silkeborg IF,7440,11,5,3,14,26,46,-20,18
FC Midtjylla,7441,1,21,4,5,68,42,26,67
Brondby,7441,2,20,5,5,67,34,33,65
FC Nords,7441,3,16,6,8,76,48,28,54
Copenhagen,7441,4,15,4,11,59,44,15,49
AaB,7441,5,7,11,12,39,47,-8,32
Sonderjyske,7441,6,8,6,10,28,29,-1,30
AC Horsens,7441,7,6,12,12,32,52,-20,30
Lyngby,7441,8,4,9,11,31,44,-13,21
AGF Aarhus,7441,9,5,6,11,18,37,-19,21
Randers FC,7441,10,5,6,13,23,44,-21,21
Silkeborg IF,7441,11,5,3,14,26,46,-20,18
Brondby,7442,1,19,7,4,71,33,38,64
FC Midtjylla,7442,2,19,6,5,67,39,28,63
Copenhagen,7442,3,14,6,10,60,44,16,48
FC Nords,7442,4,13,8,9,72,54,18,47
AC Horsens,7442,5,8,13,9,39,54,-15,37
AaB,7442,6,7,12,11,39,50,-11,33
Sonderjyske,7442,7,8,6,10,28,29,-1,30
Randers FC,7442,8,5,7,12,25,41,-16,22
AGF Aarhus,7442,9,5,6,11,17,36,-19,21
Lyngby,7442,10,3,10,11,28,46,-18,19
Silkeborg IF,7442,11,5,3,14,25,45,-20,18
Brondby,7443,1,21,7,2,70,30,40,70
FC Midtjylla,7443,2,18,5,7,68,45,23,59
FC Nords,7443,3,15,6,9,76,51,25,51
Copenhagen,7443,4,13,7,10,57,45,12,46
AaB,7443,5,7,12,11,35,43,-8,33
AC Horsens,7443,6,6,15,9,34,52,-18,33
Sonderjyske,7443,7,8,6,10,28,29,-1,30
Lyngby,7443,8,4,9,11,27,44,-17,21
Randers FC,7443,9,5,6,13,23,40,-17,21
Silkeborg IF,7443,10,6,3,13,27,45,-18,21
AGF Aarhus,7443,11,4,6,12,17,38,-21,18
FC Midtjylla,7444,1,20,5,5,66,39,27,65
Brondby,7444,2,19,7,4,71,35,36,64
FC Nords,7444,3,14,8,8,75,49,26,50
Copenhagen,7444,4,14,6,10,57,43,14,48
AC Horsens,7444,5,7,13,10,35,52,-17,34
AaB,7444,6,7,11,12,35,47,-12,32
Sonderjyske,7444,7,8,6,10,28,29,-1,30
Lyngby,7444,8,4,9,11,28,45,-17,21
Silkeborg IF,7444,8,6,3,13,28,45,-17,21
Randers FC,7444,10,5,6,13,24,41,-17,21
AGF Aarhus,7444,11,4,6,12,17,39,-22,18
Brondby,7445,1,22,6,2,75,31,44,72
FC Midtjylla,7445,2,20,5,5,67,37,30,65
FC Nords,7445,3,14,7,9,74,53,21,49
Copenhagen,7445,4,13,4,13,57,48,9,43
AaB,7445,5,8,12,10,37,46,-9,36
Sonderjyske,7445,6,8,6,10,28,29,-1,30
AC Horsens,7445,7,5,14,11,34,55,-21,29
Lyngby,7445,8,4,9,11,28,44,-16,21
Randers FC,7445,9,5,6,13,23,41,-18,21
Silkeborg IF,7445,10,5,4,13,26,45,-19,19
AGF Aarhus,7445,11,4,7,11,17,37,-20,19
Brondby,7446,1,20,6,4,74,36,38,66
FC Midtjylla,7446,2,20,5,5,67,39,28,65
FC Nords,7446,3,15,6,9,70,50,20,51
Copenhagen,7446,4,13,5,12,57,44,13,44
AaB,7446,5,9,11,10,37,45,-8,38
Sonderjyske,7446,6,8,6,10,28,29,-1,30
AC Horsens,7446,7,5,15,10,35,52,-17,30
Lyngby,7446,8,4,9,11,31,45,-14,21
Randers FC,7446,9,5,6,13,24,44,-20,21
Silkeborg IF,7446,10,5,4,13,25,44,-19,19
AGF Aarhus,7446,11,4,7,11,16,36,-20,19
Brondby,7447,1,19,7,4,69,37,32,64
FC Midtjylla,7447,2,20,4,6,65,43,22,64
FC Nords,7447,3,15,7,8,77,49,28,52
Copenhagen,7447,4,13,6,11,55,42,13,45
AaB,7447,5,7,13,10,35,41,-6,34
AC Horsens,7447,6,7,13,10,38,53,-15,34
Sonderjyske,7447,7,8,6,10,28,29,-1,30
Randers FC,7447,8,6,6,12,25,39,-14,24
Silkeborg IF,7447,9,5,4,13,26,45,-19,19
AGF Aarhus,7447,10,4,7,11,17,37,-20,19
Lyngby,7447,11,3,9,12,26,46,-20,18
Brondby,7448,1,20,6,4,72,37,35,66
FC Midtjylla,7448,2,20,6,4,70,41,29,66
FC Nords,7448,3,15,7,8,83,58,25,52
Copenhagen,7448,4,14,4,12,61,50,11,46
AaB,7448,5,7,12,11,40,48,-8,33
AC Horsens,7448,6,6,13,11,38,56,-18,31
Sonderjyske,7448,7,8,6,10,28,29,-1,30
Randers FC,7448,8,6,6,12,25,40,-15,24
Silkeborg IF,7448,9,6,3,13,26,44,-18,21
Lyngby,7448,10,3,9,12,27,46,-19,18
AGF Aarhus,7448,11,4,6,12,16,37,-21,18
Brondby,7449,1,23,5,2,76,33,43,74
FC Midtjylla,7449,2,20,5,5,65,36,29,65
FC Nords,7449,3,13,7,10,74,54,20,46
Copenhagen,7449,4,12,7,11,57,47,10,43
AC Horsens,7449,5,7,13,10,36,52,-16,34
AaB,7449,6,6,13,11,37,49,-12,31
Sonderjyske,7449,7,8,6,10,28,29,-1,30
Randers FC,7449,8,5,7,12,24,40,-16,22
Silkeborg IF,7449,9,6,3,13,27,44,-17,21
Lyngby,7449,10,3,10,11,27,45,-18,19
AGF Aarhus,7449,11,4,6,12,16,38,-22,18
Brondby,7450,1,20,6,4,67,33,34,66
FC Midtjylla,7450,2,20,4,6,67,37,30,64
FC Nords,7450,3,15,6,9,75,48,27,51
Copenhagen,7450,4,15,4,11,61,45,16,49
AaB,7450,5,8,12,10,38,42,-4,36
Sonderjyske,7450,6,8,6,10,28,29,-1,30
AC Horsens,7450,7,6,12,12,32,61,-29,30
Randers FC,7450,8,5,7,12,23,39,-16,22
AGF Aarhus,7450,9,5,6,11,17,36,-19,21
Lyngby,7450,10,3,10,11,26,44,-18,19
Silkeborg IF,7450,11,5,3,14,25,45,-20,18
Brondby,7451,1,22,5,3,80,37,43,71
FC Midtjylla,7451,2,21,4,5,69,39,30,67
Copenhagen,7451,3,15,4,11,64,46,18,49
FC Nords,7451,4,13,6,11,73,56,17,45
AaB,7451,5,8,11,11,38,48,-10,35
Sonderjyske,7451,6,8,6,10,28,29,-1,30
AC Horsens,7451,7,6,12,12,35,59,-24,30
Silkeborg IF,7451,8,6,3,13,29,45,-16,21
Lyngby,7451,9,4,9,11,29,46,-17,21
Randers FC,7451,10,5,6,13,25,42,-17,21
AGF Aarhus,7451,11,4,6,12,17,40,-23,18
Brondby,7452,1,21,5,4,71,31,40,68
FC Midtjylla,7452,2,20,6,4,65,36,29,66
Copenhagen,7452,3,15,4,11,60,44,16,49
FC Nords,7452,4,13,8,9,72,53,19,47
AaB,7452,5,7,11,12,34,48,-14,32
AC Horsens,7452,6,6,14,10,34,50,-16,32
Sonderjyske,7452,7,8,6,10,28,29,-1,30
Randers FC,7452,8,6,6,12,25,40,-15,24
AGF Aarhus,7452,9,5,6,11,19,37,-18,21
Lyngby,7452,10,3,9,12,27,46,-19,18
Silkeborg IF,7452,11,5,3,14,26,47,-21,18
Brondby,7453,1,20,7,3,67,33,34,67
FC Midtjylla,7453,2,19,5,6,68,41,27,62
FC Nords,7453,3,14,6,10,72,56,16,48
Copenhagen,7453,4,13,5,12,56,45,11,44
AaB,7453,5,8,13,9,42,44,-2,37
AC Horsens,7453,6,7,14,9,38,50,-12,35
Sonderjyske,7453,7,8,6,10,28,29,-1,30
Lyngby,7453,8,4,9,11,29,44,-15,21
Randers FC,7453,9,5,6,13,23,42,-19,21
Silkeborg IF,7453,10,5,4,13,26,45,-19,19
AGF Aarhus,7453,11,4,7,11,17,37,-20,19
FC Midtjylla,7454,1,21,4,5,69,37,32,67
Brondby,7454,2,20,5,5,71,39,32,65
Copenhagen,7454,3,16,4,10,61,43,18,52
FC Nords,7454,4,14,6,10,74,54,20,48
AaB,7454,5,8,11,11,38,45,-7,35
Sonderjyske,7454,6,8,6,10,28,29,-1,30
AC Horsens,7454,7,6,12,12,34,55,-21,30
Randers FC,7454,8,5,7,12,25,41,-16,22
Silkeborg IF,7454,9,6,3,13,26,44,-18,21
Lyngby,7454,10,3,10,11,28,46,-18,19
AGF Aarhus,7454,11,4,6,12,16,37,-21,18
Brondby,7455,1,20,6,4,68,34,34,66
FC Midtjylla,7455,2,18,7,5,66,41,25,61
FC Nords,7455,3,14,7,9,72,48,24,49
Copenhagen,7455,4,14,6,10,60,47,13,48
AC Horsens,7455,5,8,13,9,36,48,-12,37
AaB,7455,6,7,11,12,34,44,-10,32
Sonderjyske,7455,7,8,6,10,28,29,-1,30
Randers FC,7455,8,6,6,12,27,39,-12,24
Silkeborg IF,7455,9,5,4,13,26,45,-19,19
AGF Aarhus,7455,10,4,7,11,17,37,-20,19
Lyngby,7455,11,3,9,12,26,48,-22,18
Brondby,7456,1,21,5,4,75,37,38,68
FC Midtjylla,7456,2,20,4,6,69,45,24,64
Copenhagen,7456,3,15,5,10,60,46,14,50
FC Nords,7456,4,14,6,10,80,55,25,48
AaB,7456,5,7,12,11,41,52,-11,33
AC Horsens,7456,6,6,14,10,36,52,-16,32
Sonderjyske,7456,7,8,6,10,28,29,-1,30
Lyngby,7456,8,4,9,11,29,45,-16,21
Silkeborg IF,7456,8,6,3,13,29,45,-16,21
Randers FC,7456,10,5,6,13,24,42,-18,21
AGF Aarhus,7456,11,4,6,12,17,40,-23,18
Brondby,7457,1,19,8,3,64,29,35,65
FC Midtjylla,7457,2,18,7,5,61,38,23,61
FC Nords,7457,3,15,7,8,73,47,26,52
Copenhagen,7457,4,13,7,10,54,43,11,46
AaB,7457,5,7,13,10,35,40,-5,34
AC Horsens,7457,6,6,14,10,33,49,-16,32
Sonderjyske,7457,7,8,6,10,28,29,-1,30
Randers FC,7457,8,6,6,12,25,40,-15,24
Silkeborg IF,7457,9,6,3,13,27,44,-17,21
Lyngby,7457,10,3,9,12,27,46,-19,18
AGF Aarhus,7457,11,4,6,12,16,38,-22,18
Brondby,7458,1,19,8,3,70,35,35,65
FC Midtjylla,7458,2,19,7,4,66,40,26,64
Copenhagen,7458,3,15,6,9,58,40,18,51
FC Nords,7458,4,13,9,8,76,55,21,48
AaB,7458,5,6,14,10,35,41,-6,32
Sonderjyske,7458,6,8,6,10,28,29,-1,30
AC Horsens,7458,7,5,14,11,33,53,-20,29
Lyngby,7458,8,4,9,11,27,44,-17,21
Randers FC,7458,9,5,6,13,23,40,-17,21
AGF Aarhus,7458,10,5,6,11,17,36,-19,21
Silkeborg IF,7458,11,5,3,14,25,45,-20,18
Brondby,7459,1,22,6,2,74,32,42,72
FC Midtjylla,7459,2,19,4,7,67,42,25,61
FC Nords,7459,3,14,7,9,74,54,20,49
Copenhagen,7459,4,13,4,13,57,49,8,43
AC Horsens,7459,5,8,13,9,39,52,-13,37
AaB,7459,6,7,12,11,39,47,-8,33
Sonderjyske,7459,7,8,6,10,28,29,-1,30
Randers FC,7459,8,6,6,12,24,39,-15,24
AGF Aarhus,7459,9,5,6,11,17,36,-19,21
Lyngby,7459,10,3,9,12,26,45,-19,18
Silkeborg IF,7459,11,5,3,14,25,45,-20,18
Brondby,7460,1,20,6,4,68,32,36,66
FC Midtjylla,7460,2,19,4,7,68,40,28,61
Copenhagen,7460,3,15,5,10,61,44,17,50
FC Nords,7460,4,14,6,10,72,58,14,48
AaB,7460,5,8,12,10,39,44,-5,36
AC Horsens,7460,6,7,13,10,36,52,-16,34
Sonderjyske,7460,7,8,6,10,28,29,-1,30
Randers FC,7460,8,6,6,12,25,40,-15,24
Silkeborg IF,7460,9,5,4,13,25,44,-19,19
AGF Aarhus,7460,10,4,7,11,16,36,-20,19
Lyngby,7460,11,3,9,12,27,46,-19,18
Brondby,7461,1,22,5,3,73,32,41,71
FC Midtjylla,7461,2,19,4,7,62,42,20,61
FC Nords,7461,3,15,6,9,74,52,22,51
Copenhagen,7461,4,13,6,11,54,42,12,45
AC Horsens,7461,5,7,13,10,35,50,-15,34
AaB,7461,6,7,12,11,35,41,-6,33
Sonderjyske,7461,7,8,6,10,28,29,-1,30
Silkeborg IF,7461,8,6,3,13,29,45,-16,21
Lyngby,7461,9,4,9,11,28,45,-17,21
Randers FC,7461,10,5,6,13,24,41,-17,21
AGF Aarhus,7461,11,4,6,12,17,40,-23,18
Brondby,7462,1,21,5,4,69,31,38,68
FC Midtjylla,7462,2,19,5,6,66,41,25,62
Copenhagen,7462,3,15,4,11,57,43,14,49
FC Nords,7462,4,14,6,10,73,54,19,48
AC Horsens,7462,5,8,13,9,36,49,-13,37
AaB,7462,6,7,11,12,36,45,-9,32
Sonderjyske,7462,7,8,6,10,28,29,-1,30
Lyngby,7462,8,4,9,11,27,44,-17,21
Randers FC,7462,9,5,6,13,23,40,-17,21
Silkeborg IF,7462,10,5,4,13,25,44,-19,19
AGF Aarhus,7462,11,4,7,11,16,36,-20,19
Brondby,7463,1,22,6,2,72,30,42,72
FC Midtjylla,7463,2,20,5,5,70,41,29,65
Copenhagen,7463,3,13,6,11,55,45,10,45
FC Nords,7463,4,12,7,11,70,58,12,43
AaB,7463,5,8,11,11,38,42,-4,35
AC Horsens,7463,6,7,13,10,38,53,-15,34
Sonderjyske,7463,7,8,6,10,28,29,-1,30
Silkeborg IF,7463,8,6,3,13,30,47,-17,21
Lyngby,7463,9,4,9,11,28,45,-17,21
Randers FC,7463,10,5,6,13,24,41,-17,21
AGF Aarhus,7463,11,4,6,12,19,41,-22,18
Brondby,7464,1,21,7,2,71,30,41,70
FC Midtjylla,7464,2,19,5,6,67,41,26,62
Copenhagen,7464,3,15,4,11,57,42,15,49
FC Nords,7464,4,13,6,11,69,57,12,45
AaB,7464,5,7,13,10,39,42,-3,34
AC Horsens,7464,6,7,13,10,35,52,-17,34
Sonderjyske,7464,7,8,6,10,28,29,-1,30
Randers FC,7464,8,6,6,12,25,40,-15,24
AGF Aarhus,7464,9,5,6,11,17,36,-19,21
Lyngby,7464,10,3,9,12,27,46,-19,18
Silkeborg IF,7464,11,5,3,14,25,45,-20,18
FC Midtjylla,7465,1,20,6,4,71,40,31,66
Brondby,7465,2,19,7,4,66,32,34,64
Copenhagen,7465,3,15,5,10,58,43,15,50
FC Nords,7465,4,13,9,8,73,53,20,48
AaB,7465,5,7,12,11,36,43,-7,33
AC Horsens,7465,6,6,13,11,32,51,-19,31
Sonderjyske,7465,7,8,6,10,28,29,-1,30
Randers FC,7465,8,6,6,12,25,40,-15,24
Silkeborg IF,7465,9,6,3,13,28,45,-17,21
Lyngby,7465,10,3,9,12,27,46,-19,18
AGF Aarhus,7465,11,4,6,12,17,39,-22,18
Brondby,7466,1,20,7,3,69,32,37,67
FC Midtjylla,7466,2,20,5,5,68,41,27,65
FC Nords,7466,3,15,7,8,78,53,25,52
Copenhagen,7466,4,14,5,11,60,47,13,47
AaB,7466,5,6,13,11,35,45,-10,31
AC Horsens,7466,6,6,13,11,35,53,-18,31
Sonderjyske,7466,7,8,6,10,28,29,-1,30
Randers FC,7466,8,6,6,12,26,40,-14,24
Silkeborg IF,7466,9,5,4,13,26,45,-19,19
AGF Aarhus,7466,10,4,7,11,17,37,-20,19
Lyngby,7466,11,3,9,12,27,47,-20,18
Brondby,7467,1,22,6,2,75,31,44,72
FC Midtjylla,7467,2,19,5,6,67,39,28,62
Copenhagen,7467,3,15,4,11,60,43,17,49
FC Nords,7467,4,13,6,11,70,60,10,45
AC Horsens,7467,5,8,12,10,35,51,-16,36
AaB,7467,6,7,11,12,35,44,-9,32
Sonderjyske,7467,7,8,6,10,28,29,-1,30
Lyngby,7467,8,4,9,11,27,44,-17,21
Randers FC,7467,9,5,6,13,23,40,-17,21
AGF Aarhus,7467,10,5,6,11,18,37,-19,21
Silkeborg IF,7467,11,5,3,14,26,46,-20,18
Brondby,7468,1,20,7,3,72,33,39,67
FC Midtjylla,7468,2,19,6,5,65,40,25,63
FC Nords,7468,3,14,8,8,74,51,23,50
Copenhagen,7468,4,13,6,11,58,46,12,45
AaB,7468,5,9,11,10,37,43,-6,38
Sonderjyske,7468,6,8,6,10,28,29,-1,30
AC Horsens,7468,7,5,14,11,36,55,-19,29
Randers FC,7468,8,5,7,12,23,39,-16,22
Silkeborg IF,7468,9,6,3,13,27,45,-18,21
Lyngby,7468,10,3,10,11,26,44,-18,19
AGF Aarhus,7468,11,4,6,12,17,38,-21,18
Brondby,7469,1,21,7,2,71,31,40,70
FC Midtjylla,7469,2,18,6,6,64,39,25,60
Copenhagen,7469,3,15,5,10,58,43,15,50
FC Nords,7469,4,14,7,9,74,53,21,49
AaB,7469,5,6,13,11,35,46,-11,31
AC Horsens,7469,6,5,16,9,35,51,-16,31
Sonderjyske,7469,7,8,6,10,28,29,-1,30
Lyngby,7469,8,4,9,11,29,45,-16,21
Silkeborg IF,7469,9,6,3,13,28,45,-17,21
Randers FC,7469,10,5,6,13,24,42,-18,21
AGF Aarhus,7469,11,4,6,12,17,39,-22,18
Brondby,7470,1,21,6,3,69,28,41,69
FC Midtjylla,7470,2,21,4,5,66,41,25,67
FC Nords,7470,3,14,8,8,76,49,27,50
Copenhagen,7470,4,13,4,13,53,48,5,43
AaB,7470,5,7,12,11,34,41,-7,33
AC Horsens,7470,6,7,12,11,35,52,-17,33
Sonderjyske,7470,7,8,6,10,28,29,-1,30
Randers FC,7470,8,5,7,12,24,40,-16,22
AGF Aarhus,7470,9,5,6,11,17,36,-19,21
Lyngby,7470,10,3,10,11,27,45,-18,19
Silkeborg IF,7470,11,5,3,14,25,45,-20,18
Brondby,7471,1,20,8,2,73,32,41,68
FC Midtjylla,7471,2,19,5,6,64,43,21,62
FC Nords,7471,3,14,6,10,70,52,18,48
Copenhagen,7471,4,13,5,12,60,50,10,44
AaB,7471,5,9,12,9,38,39,-1,39
AC Horsens,7471,6,6,14,10,37,52,-15,32
Sonderjyske,7471,7,8,6,10,28,29,-1,30
Randers FC,7471,8,5,7,12,24,40,-16,22
AGF Aarhus,7471,9,5,6,11,18,37,-19,21
Lyngby,7471,10,3,10,11,27,45,-18,19
Silkeborg IF,7471,11,5,3,14,26,46,-20,18
Brondby,7472,1,21,5,4,76,36,40,68
FC Midtjylla,7472,2,20,5,5,68,40,28,65
FC Nords,7472,3,14,7,9,73,55,18,49
Copenhagen,7472,4,14,6,10,59,45,14,48
AC Horsens,7472,5,7,12,11,36,53,-17,33
AaB,7472,6,6,13,11,35,44,-9,31
Sonderjyske,7472,7,8,6,10,28,29,-1,30
Lyngby,7472,8,4,9,11,31,45,-14,21
Randers FC,7472,9,5,6,13,24,44,-20,21
Silkeborg IF,7472,10,5,4,13,27,46,-19,19
AGF Aarhus,7472,11,4,7,11,18,38,-20,19
Brondby,7473,1,22,6,2,71,30,41,72
FC Midtjylla,7473,2,18,6,6,63,39,24,60
FC Nords,7473,3,14,7,9,74,56,18,49
Copenhagen,7473,4,14,7,9,57,40,17,49
AC Horsens,7473,5,6,15,9,39,52,-13,33
Sonderjyske,7473,6,8,6,10,28,29,-1,30
AaB,7473,7,6,11,13,33,46,-13,29
Lyngby,7473,8,4,9,11,28,44,-16,21
Randers FC,7473,9,5,6,13,23,41,-18,21
AGF Aarhus,7473,10,5,6,11,18,37,-19,21
Silkeborg IF,7473,11,5,3,14,26,46,-20,18
Brondby,7474,1,21,5,4,76,41,35,68
FC Midtjylla,7474,2,18,6,6,64,42,22,60
FC Nords,7474,3,14,7,9,72,52,20,49
Copenhagen,7474,4,13,5,12,61,51,10,44
AaB,7474,5,9,11,10,44,44,0,38
AC Horsens,7474,6,8,12,10,37,50,-13,36
Sonderjyske,7474,7,8,6,10,28,29,-1,30
Lyngby,7474,8,4,9,11,28,44,-16,21
Randers FC,7474,9,5,6,13,23,41,-18,21
Silkeborg IF,7474,10,5,4,13,26,45,-19,19
AGF Aarhus,7474,11,4,7,11,17,37,-20,19
Brondby,7475,1,22,5,3,76,29,47,71
FC Midtjylla,7475,2,18,6,6,63,39,24,60
FC Nords,7475,3,13,7,10,70,55,15,46
Copenhagen,7475,4,13,6,11,55,48,7,45
AC Horsens,7475,5,8,14,8,36,48,-12,38
AaB,7475,6,7,12,11,34,41,-7,33
Sonderjyske,7475,7,8,6,10,28,29,-1,30
Lyngby,7475,8,4,9,11,27,44,-17,21
Randers FC,7475,9,5,6,13,23,40,-17,21
Silkeborg IF,7475,10,5,4,13,27,46,-19,19
AGF Aarhus,7475,11,4,7,11,18,38,-20,19
FC Midtjylla,7476,1,21,4,5,65,39,26,67
Brondby,7476,2,20,5,5,73,35,38,65
FC Nords,7476,3,15,6,9,71,48,23,51
Copenhagen,7476,4,15,5,10,60,44,16,50
AaB,7476,5,7,12,11,35,42,-7,33
Sonderjyske,7476,6,8,6,10,28,29,-1,30
AC Horsens,7476,7,6,12,12,34,56,-22,30
Randers FC,7476,8,6,6,12,27,41,-14,24
Silkeborg IF,7476,9,6,3,13,27,44,-17,21
Lyngby,7476,10,3,9,12,28,48,-20,18
AGF Aarhus,7476,11,4,6,12,16,38,-22,18
Brondby,7477,1,21,6,3,74,31,43,69
FC Midtjylla,7477,2,19,4,7,65,45,20,61
FC Nords,7477,3,15,7,8,76,51,25,52
Copenhagen,7477,4,16,4,10,57,41,16,52
AaB,7477,5,7,11,12,35,44,-9,32
Sonderjyske,7477,6,8,6,10,28,29,-1,30
AC Horsens,7477,7,6,12,12,35,56,-21,30
Randers FC,7477,8,6,6,12,26,39,-13,24
Silkeborg IF,7477,9,5,4,13,25,44,-19,19
AGF Aarhus,7477,10,4,7,11,16,36,-20,19
Lyngby,7477,11,3,9,12,26,47,-21,18
Brondby,7478,1,21,7,2,71,29,42,70
FC Midtjylla,7478,2,20,5,5,65,35,30,65
FC Nords,7478,3,14,8,8,74,50,24,50
Copenhagen,7478,4,13,5,12,53,43,10,44
AaB,7478,5,7,13,10,35,41,-6,34
Sonderjyske,7478,6,8,6,10,28,29,-1,30
AC Horsens,7478,7,6,12,12,32,58,-26,30
Lyngby,7478,8,4,9,11,28,45,-17,21
Randers FC,7478,9,5,6,13,24,41,-17,21
Silkeborg IF,7478,10,5,4,13,26,45,-19,19
AGF Aarhus,7478,11,4,7,11,17,37,-20,19
Brondby,7479,1,21,7,2,72,30,42,70
FC Midtjylla,7479,2,20,6,4,64,35,29,66
FC Nords,7479,3,13,7,10,70,55,15,46
Copenhagen,7479,4,13,4,13,55,47,8,43
AaB,7479,5,7,13,10,36,41,-5,34
AC Horsens,7479,6,7,13,10,34,49,-15,34
Sonderjyske,7479,7,8,6,10,28,29,-1,30
Lyngby,7479,8,4,9,11,28,45,-17,21
Randers FC,7479,9,5,6,13,24,41,-17,21
Silkeborg IF,7479,10,6,3,13,27,45,-18,21
AGF Aarhus,7479,11,4,6,12,17,38,-21,18
Brondby,7480,1,19,7,4,79,38,41,64
FC Midtjylla,7480,2,19,6,5,65,40,25,63
Copenhagen,7480,3,16,5,9,65,43,22,53
FC Nords,7480,4,14,7,9,74,57,17,49
AaB,7480,5,6,14,10,35,44,-9,32
AC Horsens,7480,6,6,13,11,36,58,-22,31
Sonderjyske,7480,7,8,6,10,28,29,-1,30
Lyngby,7480,8,4,9,11,28,45,-17,21
Randers FC,7480,9,5,6,13,24,41,-17,21
Silkeborg IF,7480,10,5,4,13,26,45,-19,19
AGF Aarhus,7480,11,4,7,11,17,37,-20,19
Brondby,7481,1,21,6,3,76,33,43,69
FC Midtjylla,7481,2,21,4,5,72,38,34,67
FC Nords,7481,3,15,6,9,70,51,19,51
Copenhagen,7481,4,14,5,11,61,48,13,47
AC Horsens,7481,5,6,14,10,37,55,-18,32
Sonderjyske,7481,6,8,6,10,28,29,-1,30
AaB,7481,7,6,11,13,36,53,-17,29
Randers FC,7481,8,6,6,12,26,40,-14,24
Silkeborg IF,7481,9,6,3,13,27,45,-18,21
Lyngby,7481,10,3,9,12,27,47,-20,18
AGF Aarhus,7481,11,4,6,12,17,38,-21,18
FC Midtjylla,7482,1,20,5,5,68,38,30,65
Brondby,7482,2,19,6,5,68,38,30,63
FC Nords,7482,3,16,7,7,76,51,25,55
Copenhagen,7482,4,15,5,10,61,41,20,50
AC Horsens,7482,5,6,13,11,33,51,-18,31
Sonderjyske,7482,6,8,6,10,28,29,-1,30
AaB,7482,7,6,12,12,34,47,-13,30
Lyngby,7482,8,4,9,11,27,44,-17,21
Randers FC,7482,9,5,6,13,23,40,-17,21
Silkeborg IF,7482,10,5,4,13,26,45,-19,19
AGF Aarhus,7482,11,4,7,11,17,37,-20,19
Brondby,7483,1,20,8,2,75,32,43,68
FC Midtjylla,7483,2,20,4,6,67,44,23,64
Copenhagen,7483,3,14,5,11,58,48,10,47
FC Nords,7483,4,13,7,10,75,57,18,46
AaB,7483,5,7,13,10,37,43,-6,34
AC Horsens,7483,6,7,13,10,36,50,-14,34
Sonderjyske,7483,7,8,6,10,28,29,-1,30
Randers FC,7483,8,6,6,12,25,40,-15,24
AGF Aarhus,7483,9,5,6,11,17,36,-19,21
Lyngby,7483,10,3,9,12,27,46,-19,18
Silkeborg IF,7483,11,5,3,14,25,45,-20,18
Brondby,7484,1,21,6,3,73,31,42,69
FC Midtjylla,7484,2,19,5,6,62,41,21,62
FC Nords,7484,3,14,7,9,73,54,19,49
Copenhagen,7484,4,14,4,12,56,43,13,46
AaB,7484,5,7,13,10,36,41,-5,34
AC Horsens,7484,6,6,15,9,34,50,-16,33
Sonderjyske,7484,7,8,6,10,28,29,-1,30
Lyngby,7484,8,4,9,11,27,44,-17,21
Randers FC,7484,9,5,6,13,23,40,-17,21
AGF Aarhus,7484,10,5,6,11,18,37,-19,21
Silkeborg IF,7484,11,5,3,14,26,46,-20,18
Brondby,7485,1,20,6,4,68,29,39,66
FC Midtjylla,7485,2,18,7,5,62,43,19,61
FC Nords,7485,3,15,6,9,77,53,24,51
Copenhagen,7485,4,13,5,12,54,46,8,44
AaB,7485,5,8,13,9,39,39,0,37
AC Horsens,7485,6,7,13,10,37,53,-16,34
Sonderjyske,7485,7,8,6,10,28,29,-1,30
Randers FC,7485,8,6,6,12,24,39,-15,24
Silkeborg IF,7485,9,6,3,13,28,44,-16,21
Lyngby,7485,10,3,9,12,26,45,-19,18
AGF Aarhus,7485,11,4,6,12,16,39,-23,18
Brondby,7486,1,21,7,2,69,31,38,70
FC Midtjylla,7486,2,19,6,5,64,38,26,63
FC Nords,7486,3,15,8,7,74,48,26,53
Copenhagen,7486,4,12,6,12,56,47,9,42
AC Horsens,7486,5,7,12,11,35,53,-18,33
AaB,7486,6,6,13,11,34,41,-7,31
Sonderjyske,7486,7,8,6,10,28,29,-1,30
Lyngby,7486,8,4,9,11,28,45,-17,21
Randers FC,7486,9,5,6,13,24,41,-17,21
AGF Aarhus,7486,10,5,6,11,17,36,-19,21
Silkeborg IF,7486,11,5,3,14,25,45,-20,18
Brondby,7487,1,20,8,2,72,30,42,68
FC Midtjylla,7487,2,18,7,5,66,42,24,61
FC Nords,7487,3,13,8,9,78,59,19,47
Copenhagen,7487,4,13,6,11,60,47,13,45
AC Horsens,7487,5,7,14,9,35,53,-18,35
AaB,7487,6,7,13,10,38,44,-6,34
Sonderjyske,7487,7,8,6,10,28,29,-1,30
Randers FC,7487,8,5,7,12,26,42,-16,22
Lyngby,7487,9,3,10,11,29,47,-18,19
Silkeborg IF,7487,10,5,4,13,27,46,-19,19
AGF Aarhus,7487,11,4,7,11,18,38,-20,19
FC Midtjylla,7488,1,21,4,5,68,38,30,67
Brondby,7488,2,20,5,5,69,34,35,65
FC Nords,7488,3,15,6,9,73,53,20,51
Copenhagen,7488,4,12,4,14,52,47,5,40
AaB,7488,5,9,12,9,37,38,-1,39
AC Horsens,7488,6,7,13,10,34,49,-15,34
Sonderjyske,7488,7,8,6,10,28,29,-1,30
Randers FC,7488,8,5,7,12,24,40,-16,22
AGF Aarhus,7488,9,5,6,11,19,36,-17,21
Lyngby,7488,10,3,10,11,27,45,-18,19
Silkeborg IF,7488,11,5,3,14,25,47,-22,18
Brondby,7489,1,20,6,4,67,32,35,66
FC Midtjylla,7489,2,19,6,5,67,39,28,63
FC Nords,7489,3,14,8,8,72,50,22,50
Copenhagen,7489,4,14,5,11,56,44,12,47
AaB,7489,5,9,12,9,42,41,1,39
Sonderjyske,7489,6,8,6,10,28,29,-1,30
AC Horsens,7489,7,5,13,12,32,56,-24,28
Randers FC,7489,8,5,7,12,23,39,-16,22
Silkeborg IF,7489,9,6,3,13,28,44,-16,21
Lyngby,7489,10,3,10,11,26,44,-18,19
AGF Aarhus,7489,11,4,6,12,16,39,-23,18
Brondby,7490,1,20,5,5,71,36,35,65
FC Midtjylla,7490,2,20,4,6,67,39,28,64
FC Nords,7490,3,14,7,9,76,50,26,49
Copenhagen,7490,4,14,5,11,57,45,12,47
AaB,7490,5,8,12,10,37,44,-7,36
AC Horsens,7490,6,7,13,10,34,54,-20,34
Sonderjyske,7490,7,8,6,10,28,29,-1,30
Lyngby,7490,8,4,9,11,28,45,-17,21
Randers FC,7490,9,5,6,13,24,41,-17,21
Silkeborg IF,7490,10,5,4,13,26,45,-19,19
AGF Aarhus,7490,11,4,7,11,17,37,-20,19
Brondby,7491,1,20,5,5,74,42,32,65
FC Midtjylla,7491,2,20,5,5,70,41,29,65
Copenhagen,7491,3,15,4,11,59,45,14,49
FC Nords,7491,4,14,6,10,71,53,18,48
AaB,7491,5,8,12,10,39,44,-5,36
AC Horsens,7491,6,7,12,11,38,52,-14,33
Sonderjyske,7491,7,8,6,10,28,29,-1,30
Randers FC,7491,8,6,6,12,25,40,-15,24
Silkeborg IF,7491,9,6,3,13,27,44,-17,21
Lyngby,7491,10,3,9,12,27,46,-19,18
AGF Aarhus,7491,11,4,6,12,16,38,-22,18
Brondby,7492,1,20,7,3,66,30,36,67
FC Midtjylla,7492,2,19,6,5,64,37,27,63
Copenhagen,7492,3,15,5,10,57,42,15,50
FC Nords,7492,4,14,6,10,74,55,19,48
AC Horsens,7492,5,6,15,9,35,49,-14,33
AaB,7492,6,6,13,11,33,42,-9,31
Sonderjyske,7492,7,8,6,10,28,29,-1,30
Randers FC,7492,8,6,6,12,24,39,-15,24
Silkeborg IF,7492,9,6,3,13,27,44,-17,21
Lyngby,7492,10,3,9,12,26,45,-19,18
AGF Aarhus,7492,11,4,6,12,16,38,-22,18
Brondby,7493,1,20,5,5,67,35,32,65
FC Midtjylla,7493,2,19,6,5,64,38,26,63
FC Nords,7493,3,14,7,9,74,50,24,49
Copenhagen,7493,4,14,6,10,62,45,17,48
AaB,7493,5,8,13,9,38,41,-3,37
AC Horsens,7493,6,6,13,11,35,57,-22,31
Sonderjyske,7493,7,8,6,10,28,29,-1,30
Randers FC,7493,8,5,7,12,24,40,-16,22
Silkeborg IF,7493,9,6,3,13,28,45,-17,21
Lyngby,7493,10,3,10,11,27,45,-18,19
AGF Aarhus,7493,11,4,6,12,17,39,-22,18
Brondby,7494,1,23,5,2,75,30,45,74
FC Midtjylla,7494,2,19,4,7,67,43,24,61
FC Nords,7494,3,16,6,8,78,53,25,54
Copenhagen,7494,4,13,5,12,54,46,8,44
AC Horsens,7494,5,7,13,10,36,52,-16,34
Sonderjyske,7494,6,8,6,10,28,29,-1,30
AaB,7494,7,6,11,13,35,47,-12,29
Lyngby,7494,8,4,9,11,30,45,-15,21
Silkeborg IF,7494,9,6,3,13,27,45,-18,21
Randers FC,7494,10,5,6,13,24,43,-19,21
AGF Aarhus,7494,11,4,6,12,17,38,-21,18
Brondby,7495,1,21,6,3,72,31,41,69
FC Midtjylla,7495,2,19,5,6,62,38,24,62
Copenhagen,7495,3,14,6,10,57,41,16,48
FC Nords,7495,4,12,8,10,68,52,16,44
AaB,7495,5,8,11,11,36,43,-7,35
AC Horsens,7495,6,7,14,9,33,49,-16,35
Sonderjyske,7495,7,8,6,10,28,29,-1,30
Lyngby,7495,8,4,9,11,28,45,-17,21
Randers FC,7495,9,5,6,13,24,41,-17,21
Silkeborg IF,7495,10,6,3,13,26,44,-18,21
AGF Aarhus,7495,11,4,6,12,16,37,-21,18
Brondby,7496,1,21,6,3,72,33,39,69
FC Midtjylla,7496,2,19,5,6,64,40,24,62
FC Nords,7496,3,16,7,7,72,46,26,55
Copenhagen,7496,4,14,5,11,61,43,18,47
Sonderjyske,7496,5,8,6,10,28,29,-1,30
AaB,7496,6,6,12,12,31,47,-16,30
AC Horsens,7496,7,5,15,10,31,48,-17,30
Randers FC,7496,8,6,6,12,26,40,-14,24
Silkeborg IF,7496,9,6,3,13,28,45,-17,21
Lyngby,7496,10,3,9,12,27,47,-20,18
AGF Aarhus,7496,11,4,6,12,17,39,-22,18
Brondby,7497,1,20,7,3,69,33,36,67
FC Midtjylla,7497,2,19,5,6,63,40,23,62
Copenhagen,7497,3,15,6,9,63,43,20,51
FC Nords,7497,4,14,7,9,73,51,22,49
AaB,7497,5,7,12,11,38,46,-8,33
Sonderjyske,7497,6,8,6,10,28,29,-1,30
AC Horsens,7497,7,5,15,10,32,51,-19,30
Lyngby,7497,8,4,9,11,27,44,-17,21
Randers FC,7497,9,5,6,13,23,40,-17,21
Silkeborg IF,7497,10,5,4,13,26,45,-19,19
AGF Aarhus,7497,11,4,7,11,17,37,-20,19
Brondby,7498,1,20,5,5,69,40,29,65
FC Midtjylla,7498,2,20,5,5,63,38,25,65
FC Nords,7498,3,13,8,9,76,52,24,47
Copenhagen,7498,4,13,5,12,56,43,13,44
AaB,7498,5,9,11,10,37,40,-3,38
AC Horsens,7498,6,7,14,9,36,50,-14,35
Sonderjyske,7498,7,8,6,10,28,29,-1,30
Lyngby,7498,8,4,9,11,28,44,-16,21
Randers FC,7498,9,5,6,13,23,41,-18,21
AGF Aarhus,7498,10,5,6,11,19,38,-19,21
Silkeborg IF,7498,11,5,3,14,27,47,-20,18
Brondby,7499,1,21,6,3,76,34,42,69
FC Midtjylla,7499,2,19,4,7,70,45,25,61
Copenhagen,7499,3,16,4,10,64,47,17,52
FC Nords,7499,4,14,6,10,75,51,24,48
AaB,7499,5,7,12,11,36,48,-12,33
AC Horsens,7499,6,6,14,10,34,56,-22,32
Sonderjyske,7499,7,8,6,10,28,29,-1,30
Randers FC,7499,8,6,6,12,26,39,-13,24
Silkeborg IF,7499,9,6,3,13,27,45,-18,21
Lyngby,7499,10,3,9,12,26,47,-21,18
AGF Aarhus,7499,11,4,6,12,17,38,-21,18
Brondby,7500,1,21,7,2,71,32,39,70
FC Midtjylla,7500,2,20,5,5,69,38,31,65
FC Nords,7500,3,14,6,10,72,54,18,48
Copenhagen,7500,4,13,4,13,55,49,6,43
AaB,7500,5,8,12,10,37,42,-5,36
AC Horsens,7500,6,6,14,10,33,48,-15,32
Sonderjyske,7500,7,8,6,10,28,29,-1,30
Randers FC,7500,8,5,7,12,25,41,-16,22
Silkeborg IF,7500,9,6,3,13,28,46,-18,21
Lyngby,7500,10,3,10,11,28,46,-18,19
AGF Aarhus,7500,11,4,6,12,18,39,-21,18
Brondby,7501,1,20,6,4,73,33,40,66
FC Midtjylla,7501,2,20,5,5,68,40,28,65
Copenhagen,7501,3,15,6,9,60,42,18,51
FC Nords,7501,4,14,7,9,74,51,23,49
AaB,7501,5,7,12,11,36,52,-16,33
Sonderjyske,7501,6,8,6,10,28,29,-1,30
AC Horsens,7501,7,5,14,11,34,53,-19,29
Lyngby,7501,8,4,9,11,28,45,-17,21
Randers FC,7501,9,5,6,13,24,41,-17,21
Silkeborg IF,7501,10,6,3,13,26,44,-18,21
AGF Aarhus,7501,11,4,6,12,16,37,-21,18
Brondby,7502,1,22,5,3,71,32,39,71
FC Midtjylla,7502,2,19,4,7,60,36,24,61
FC Nords,7502,3,15,6,9,75,55,20,51
Copenhagen,7502,4,14,6,10,60,45,15,48
AC Horsens,7502,5,7,13,10,34,49,-15,34
Sonderjyske,7502,6,8,6,10,28,29,-1,30
AaB,7502,7,6,12,12,36,45,-9,30
Lyngby,7502,8,4,9,11,27,44,-17,21
Randers FC,7502,9,5,6,13,23,40,-17,21
AGF Aarhus,7502,10,5,6,11,17,36,-19,21
Silkeborg IF,7502,11,5,3,14,25,45,-20,18
Brondby,7503,1,22,5,3,74,30,44,71
FC Midtjylla,7503,2,20,5,5,69,43,26,65
FC Nords,7503,3,15,7,8,74,51,23,52
Copenhagen,7503,4,13,4,13,56,50,6,43
AaB,7503,5,6,14,10,35,41,-6,32
AC Horsens,7503,6,6,13,11,34,53,-19,31
Sonderjyske,7503,7,8,6,10,28,29,-1,30
Lyngby,7503,8,4,9,11,29,46,-17,21
Randers FC,7503,9,5,6,13,25,42,-17,21
Silkeborg IF,7503,10,5,4,13,25,44,-19,19
AGF Aarhus,7503,11,4,7,11,16,36,-20,19
Brondby,7504,1,21,6,3,72,32,40,69
FC Midtjylla,7504,2,19,5,6,66,41,25,62
FC Nords,7504,3,15,7,8,74,48,26,52
Copenhagen,7504,4,14,7,9,58,43,15,49
AaB,7504,5,6,13,11,35,44,-9,31
Sonderjyske,7504,6,8,6,10,28,29,-1,30
AC Horsens,7504,7,5,14,11,35,58,-23,29
Randers FC,7504,8,6,6,12,25,40,-15,24
Silkeborg IF,7504,9,5,4,13,27,46,-19,19
AGF Aarhus,7504,10,4,7,11,18,38,-20,19
Lyngby,7504,11,3,9,12,27,46,-19,18
Brondby,7505,1,19,7,4,70,34,36,64
FC Midtjylla,7505,2,19,7,4,63,37,26,64
Copenhagen,7505,3,14,6,10,55,41,14,48
FC Nords,7505,4,13,6,11,69,53,16,45
AaB,7505,5,7,14,9,39,43,-4,35
AC Horsens,7505,6,7,14,9,38,52,-14,35
Sonderjyske,7505,7,8,6,10,28,29,-1,30
Lyngby,7505,8,4,9,11,27,44,-17,21
Randers FC,7505,9,5,6,13,23,40,-17,21
AGF Aarhus,7505,10,5,6,11,17,36,-19,21
Silkeborg IF,7505,11,5,3,14,25,45,-20,18
Brondby,7506,1,19,7,4,70,38,32,64
FC Midtjylla,7506,2,19,5,6,67,42,25,62
FC Nords,7506,3,15,7,8,79,54,25,52
Copenhagen,7506,4,15,5,10,63,45,18,50
AaB,7506,5,6,14,10,37,44,-7,32
AC Horsens,7506,6,6,14,10,37,56,-19,32
Sonderjyske,7506,7,8,6,10,28,29,-1,30
Randers FC,7506,8,6,6,12,25,40,-15,24
Silkeborg IF,7506,9,6,3,13,28,46,-18,21
Lyngby,7506,10,3,9,12,27,46,-19,18
AGF Aarhus,7506,11,4,6,12,18,39,-21,18
Brondby,7507,1,20,7,3,73,35,38,67
FC Midtjylla,7507,2,21,4,5,69,38,31,67
Copenhagen,7507,3,14,6,10,58,44,14,48
FC Nords,7507,4,13,8,9,74,55,19,47
AC Horsens,7507,5,6,14,10,34,51,-17,32
AaB,7507,6,6,13,11,31,42,-11,31
Sonderjyske,7507,7,8,6,10,28,29,-1,30
Lyngby,7507,8,4,9,11,28,45,-17,21
Randers FC,7507,9,5,6,13,24,41,-17,21
Silkeborg IF,7507,10,6,3,13,27,45,-18,21
AGF Aarhus,7507,11,4,6,12,17,38,-21,18
Brondby,7508,1,21,5,4,69,36,33,68
FC Midtjylla,7508,2,20,5,5,68,37,31,65
Copenhagen,7508,3,12,8,10,52,40,12,44
FC Nords,7508,4,12,7,11,66,50,16,43
AaB,7508,5,9,12,9,37,40,-3,39
AC Horsens,7508,6,7,13,10,36,51,-15,34
Sonderjyske,7508,7,8,6,10,28,29,-1,30
Lyngby,7508,8,4,9,11,28,45,-17,21
Randers FC,7508,9,5,6,13,24,41,-17,21
Silkeborg IF,7508,10,6,3,13,27,45,-18,21
AGF Aarhus,7508,11,4,6,12,17,38,-21,18
FC Midtjylla,7509,1,22,4,4,72,35,37,70
Brondby,7509,2,20,6,4,67,30,37,66
Copenhagen,7509,3,14,5,11,57,43,14,47
FC Nords,7509,4,12,7,11,70,57,13,43
AC Horsens,7509,5,8,12,10,38,56,-18,36
AaB,7509,6,7,12,11,34,43,-9,33
Sonderjyske,7509,7,8,6,10,28,29,-1,30
Lyngby,7509,8,4,9,11,27,44,-17,21
Randers FC,7509,9,5,6,13,23,40,-17,21
Silkeborg IF,7509,10,5,4,13,25,44,-19,19
AGF Aarhus,7509,11,4,7,11,16,36,-20,19
Brondby,7510,1,22,5,3,71,31,40,71
FC Midtjylla,7510,2,21,4,5,66,37,29,67
FC Nords,7510,3,14,7,9,67,48,19,49
Copenhagen,7510,4,13,4,13,53,43,10,43
AaB,7510,5,8,11,11,36,43,-7,35
AC Horsens,7510,6,6,13,11,35,52,-17,31
Sonderjyske,7510,7,8,6,10,28,29,-1,30
Randers FC,7510,8,5,7,12,24,40,-16,22
Silkeborg IF,7510,9,6,3,13,27,45,-18,21
Lyngby,7510,10,3,10,11,27,45,-18,19
AGF Aarhus,7510,11,4,6,12,17,38,-21,18
Brondby,7511,1,22,6,2,69,28,41,72
FC Midtjylla,7511,2,19,6,5,62,36,26,63
Copenhagen,7511,3,14,4,12,55,44,11,46
FC Nords,7511,4,13,6,11,72,55,17,45
AC Horsens,7511,5,8,13,9,36,47,-11,37
AaB,7511,6,6,13,11,32,42,-10,31
Sonderjyske,7511,7,8,6,10,28,29,-1,30
Randers FC,7511,8,5,7,12,24,40,-16,22
Lyngby,7511,9,3,10,11,27,45,-18,19
Silkeborg IF,7511,10,5,4,13,25,44,-19,19
AGF Aarhus,7511,11,4,7,11,16,36,-20,19
Brondby,7512,1,20,5,5,66,31,35,65
FC Midtjylla,7512,2,18,6,6,62,40,22,60
Copenhagen,7512,3,15,6,9,60,44,16,51
FC Nords,7512,4,14,7,9,79,54,25,49
AaB,7512,5,7,14,9,38,44,-6,35
AC Horsens,7512,6,5,16,9,36,54,-18,31
Sonderjyske,7512,7,8,6,10,28,29,-1,30
Randers FC,7512,8,5,7,12,25,41,-16,22
Silkeborg IF,7512,9,6,3,13,27,44,-17,21
Lyngby,7512,10,3,10,11,28,46,-18,19
AGF Aarhus,7512,11,4,6,12,16,38,-22,18
Brondby,7513,1,20,7,3,71,33,38,67
FC Midtjylla,7513,2,20,6,4,74,42,32,66
Copenhagen,7513,3,15,4,11,66,45,21,49
FC Nords,7513,4,13,7,10,75,60,15,46
AaB,7513,5,8,13,9,36,39,-3,37
Sonderjyske,7513,6,8,6,10,28,29,-1,30
AC Horsens,7513,7,5,13,12,33,62,-29,28
Randers FC,7513,8,6,6,12,24,39,-15,24
Silkeborg IF,7513,9,5,4,13,25,44,-19,19
AGF Aarhus,7513,10,4,7,11,16,36,-20,19
Lyngby,7513,11,3,9,12,26,45,-19,18
Brondby,7514,1,18,8,4,66,36,30,62
FC Midtjylla,7514,2,18,7,5,62,37,25,61
FC Nords,7514,3,15,8,7,78,47,31,53
Copenhagen,7514,4,15,5,10,59,43,16,50
AaB,7514,5,7,13,10,41,49,-8,34
AC Horsens,7514,6,6,13,11,35,55,-20,31
Sonderjyske,7514,7,8,6,10,28,29,-1,30
Randers FC,7514,8,6,6,12,24,39,-15,24
AGF Aarhus,7514,9,5,6,11,19,37,-18,21
Lyngby,7514,10,3,9,12,26,45,-19,18
Silkeborg IF,7514,11,5,3,14,26,47,-21,18
Brondby,7515,1,22,5,3,71,28,43,71
FC Midtjylla,7515,2,21,4,5,69,38,31,67
FC Nords,7515,3,14,7,9,77,54,23,49
Copenhagen,7515,4,13,5,12,53,45,8,44
AC Horsens,7515,5,7,12,11,34,55,-21,33
AaB,7515,6,7,11,12,36,46,-10,32
Sonderjyske,7515,7,8,6,10,28,29,-1,30
Lyngby,7515,8,4,9,11,27,44,-17,21
Randers FC,7515,9,5,6,13,23,40,-17,21
AGF Aarhus,7515,10,5,6,11,18,37,-19,21
Silkeborg IF,7515,11,5,3,14,26,46,-20,18
FC Midtjylla,7516,1,21,4,5,70,40,30,67
Brondby,7516,2,19,6,5,67,37,30,63
FC Nords,7516,3,16,7,7,80,47,33,55
Copenhagen,7516,4,13,5,12,57,49,8,44
AC Horsens,7516,5,7,12,11,33,52,-19,33
AaB,7516,6,6,14,10,38,46,-8,32
Sonderjyske,7516,7,8,6,10,28,29,-1,30
Silkeborg IF,7516,8,6,3,13,29,44,-15,21
Lyngby,7516,9,4,9,11,27,44,-17,21
Randers FC,7516,10,5,6,13,23,40,-17,21
AGF Aarhus,7516,11,4,6,12,16,40,-24,18
Brondby,7517,1,23,5,2,75,30,45,74
FC Midtjylla,7517,2,17,5,8,61,46,15,56
Copenhagen,7517,3,16,4,10,63,45,18,52
FC Nords,7517,4,14,7,9,75,52,23,49
AaB,7517,5,8,12,10,39,43,-4,36
Sonderjyske,7517,6,8,6,10,28,29,-1,30
AC Horsens,7517,7,5,13,12,33,56,-23,28
Lyngby,7517,8,4,9,11,29,44,-15,21
Silkeborg IF,7517,9,6,3,13,27,44,-17,21
Randers FC,7517,10,5,6,13,23,42,-19,21
AGF Aarhus,7517,11,4,6,12,16,38,-22,18
Brondby,7518,1,21,5,4,72,37,35,68
FC Midtjylla,7518,2,21,5,4,73,41,32,68
FC Nords,7518,3,13,8,9,74,54,20,47
Copenhagen,7518,4,14,4,12,62,50,12,46
AaB,7518,5,7,12,11,37,48,-11,33
AC Horsens,7518,6,6,14,10,38,52,-14,32
Sonderjyske,7518,7,8,6,10,28,29,-1,30
Randers FC,7518,8,6,6,12,25,39,-14,24
Silkeborg IF,7518,9,6,3,13,27,45,-18,21
Lyngby,7518,10,3,9,12,26,46,-20,18
AGF Aarhus,7518,11,4,6,12,17,38,-21,18
FC Midtjylla,7519,1,21,4,5,64,37,27,67
Brondby,7519,2,20,5,5,69,33,36,65
Copenhagen,7519,3,16,5,9,62,43,19,53
FC Nords,7519,4,14,7,9,71,48,23,49
AaB,7519,5,8,11,11,36,41,-5,35
Sonderjyske,7519,6,8,6,10,28,29,-1,30
AC Horsens,7519,7,5,12,13,32,58,-26,27
Lyngby,7519,8,4,9,11,27,44,-17,21
Randers FC,7519,9,5,6,13,23,40,-17,21
Silkeborg IF,7519,10,6,3,13,26,44,-18,21
AGF Aarhus,7519,11,4,6,12,16,37,-21,18
Brondby,7520,1,23,5,2,72,30,42,74
FC Midtjylla,7520,2,20,4,6,66,38,28,64
FC Nords,7520,3,13,8,9,70,52,18,47
Copenhagen,7520,4,14,4,12,58,47,11,46
AaB,7520,5,7,12,11,36,44,-8,33
AC Horsens,7520,6,6,13,11,36,53,-17,31
Sonderjyske,7520,7,8,6,10,28,29,-1,30
Lyngby,7520,8,4,9,11,30,45,-15,21
AGF Aarhus,7520,9,5,6,11,19,37,-18,21
Randers FC,7520,10,5,6,13,24,43,-19,21
Silkeborg IF,7520,11,5,3,14,26,47,-21,18
Brondby,7521,1,21,5,4,71,32,39,68
FC Midtjylla,7521,2,19,5,6,66,40,26,62
Copenhagen,7521,3,15,6,9,59,42,17,51
FC Nords,7521,4,14,7,9,74,53,21,49
AaB,7521,5,7,13,10,35,45,-10,34
Sonderjyske,7521,6,8,6,10,28,29,-1,30
AC Horsens,7521,7,5,14,11,33,52,-19,29
Lyngby,7521,8,4,9,11,28,44,-16,21
Silkeborg IF,7521,9,6,3,13,26,44,-18,21
Randers FC,7521,10,5,6,13,23,41,-18,21
AGF Aarhus,7521,11,4,6,12,16,37,-21,18
Brondby,7522,1,23,5,2,78,27,51,74
FC Midtjylla,7522,2,19,5,6,66,44,22,62
FC Nords,7522,3,14,7,9,70,52,18,49
Copenhagen,7522,4,13,6,11,62,49,13,45
AaB,7522,5,7,13,10,35,40,-5,34
Sonderjyske,7522,6,8,6,10,28,29,-1,30
AC Horsens,7522,7,6,12,12,32,57,-25,30
Lyngby,7522,8,4,9,11,29,44,-15,21
Silkeborg IF,7522,9,6,3,13,27,44,-17,21
Randers FC,7522,10,5,6,13,23,42,-19,21
AGF Aarhus,7522,11,4,6,12,16,38,-22,18
Brondby,7523,1,22,5,3,71,34,37,71
FC Midtjylla,7523,2,21,4,5,66,36,30,67
FC Nords,7523,3,13,6,11,72,54,18,45
Copenhagen,7523,4,13,4,13,55,48,7,43
AaB,7523,5,8,12,10,40,44,-4,36
AC Horsens,7523,6,7,13,10,37,51,-14,34
Sonderjyske,7523,7,8,6,10,28,29,-1,30
Lyngby,7523,8,4,9,11,29,44,-15,21
Randers FC,7523,9,5,6,13,23,42,-19,21
Silkeborg IF,7523,10,5,4,13,26,45,-19,19
AGF Aarhus,7523,11,4,7,11,17,37,-20,19
FC Midtjylla,7524,1,21,5,4,74,39,35,68
Brondby,7524,2,18,8,4,69,38,31,62
FC Nords,7524,3,13,8,9,73,55,18,47
Copenhagen,7524,4,14,5,11,61,50,11,47
AC Horsens,7524,5,7,14,9,38,51,-13,35
AaB,7524,6,7,12,11,37,45,-8,33
Sonderjyske,7524,7,8,6,10,28,29,-1,30
Randers FC,7524,8,5,7,12,23,39,-16,22
Silkeborg IF,7524,9,6,3,13,26,44,-18,21
Lyngby,7524,10,3,10,11,26,44,-18,19
AGF Aarhus,7524,11,4,6,12,16,37,-21,18
Brondby,7525,1,22,5,3,73,30,43,71
FC Midtjylla,7525,2,19,4,7,63,44,19,61
Copenhagen,7525,3,15,5,10,59,43,16,50
FC Nords,7525,4,14,7,9,74,53,21,49
AC Horsens,7525,5,7,12,11,33,50,-17,33
AaB,7525,6,7,11,12,36,44,-8,32
Sonderjyske,7525,7,8,6,10,28,29,-1,30
Lyngby,7525,8,4,9,11,28,45,-17,21
Silkeborg IF,7525,9,6,3,13,27,44,-17,21
Randers FC,7525,10,5,6,13,24,41,-17,21
AGF Aarhus,7525,11,4,6,12,16,38,-22,18
Brondby,7526,1,21,5,4,68,35,33,68
FC Midtjylla,7526,2,20,5,5,68,39,29,65
FC Nords,7526,3,15,7,8,75,53,22,52
Copenhagen,7526,4,14,5,11,59,44,15,47
AC Horsens,7526,5,6,14,10,38,54,-16,32
Sonderjyske,7526,6,8,6,10,28,29,-1,30
AaB,7526,7,6,12,12,35,44,-9,30
Randers FC,7526,8,6,6,12,25,40,-15,24
AGF Aarhus,7526,9,5,6,11,21,40,-19,21
Lyngby,7526,10,3,9,12,27,46,-19,18
Silkeborg IF,7526,11,5,3,14,29,49,-20,18
Brondby,7527,1,22,6,2,73,28,45,72
FC Midtjylla,7527,2,20,4,6,66,38,28,64
FC Nords,7527,3,13,8,9,70,51,19,47
Copenhagen,7527,4,14,4,12,57,47,10,46
AaB,7527,5,7,12,11,36,48,-12,33
AC Horsens,7527,6,7,12,11,35,51,-16,33
Sonderjyske,7527,7,8,6,10,28,29,-1,30
Lyngby,7527,8,4,9,11,28,45,-17,21
Randers FC,7527,9,5,6,13,24,41,-17,21
Silkeborg IF,7527,10,5,4,13,27,46,-19,19
AGF Aarhus,7527,11,4,7,11,18,38,-20,19
FC Midtjylla,7528,1,21,5,4,68,36,32,68
Brondby,7528,2,19,6,5,67,35,32,63
Copenhagen,7528,3,14,5,11,54,43,11,47
FC Nords,7528,4,13,7,10,71,52,19,46
AC Horsens,7528,5,7,14,9,37,48,-11,35
AaB,7528,6,7,13,10,34,43,-9,34
Sonderjyske,7528,7,8,6,10,28,29,-1,30
Lyngby,7528,8,4,9,11,27,44,-17,21
Randers FC,7528,9,5,6,13,23,40,-17,21
AGF Aarhus,7528,10,5,6,11,18,37,-19,21
Silkeborg IF,7528,11,5,3,14,26,46,-20,18
Brondby,7529,1,20,7,3,70,35,35,67
FC Midtjylla,7529,2,18,5,7,64,43,21,59
FC Nords,7529,3,15,7,8,77,51,26,52
Copenhagen,7529,4,14,6,10,61,47,14,48
AaB,7529,5,9,13,8,39,38,1,40
Sonderjyske,7529,6,8,6,10,28,29,-1,30
AC Horsens,7529,7,5,12,13,35,58,-23,27
Randers FC,7529,8,6,6,12,25,40,-15,24
Silkeborg IF,7529,9,6,3,13,26,44,-18,21
Lyngby,7529,10,3,9,12,27,46,-19,18
AGF Aarhus,7529,11,4,6,12,16,37,-21,18
Brondby,7530,1,20,7,3,74,34,40,67
FC Midtjylla,7530,2,19,6,5,62,39,23,63
FC Nords,7530,3,15,8,7,78,49,29,53
Copenhagen,7530,4,12,7,11,58,52,6,43
AaB,7530,5,7,12,11,36,43,-7,33
AC Horsens,7530,6,6,14,10,36,53,-17,32
Sonderjyske,7530,7,8,6,10,28,29,-1,30
Randers FC,7530,8,5,7,12,24,40,-16,22
AGF Aarhus,7530,9,5,6,11,17,36,-19,21
Lyngby,7530,10,3,10,11,27,45,-18,19
Silkeborg IF,7530,11,5,3,14,25,45,-20,18
Brondby,7531,1,21,6,3,73,31,42,69
FC Midtjylla,7531,2,19,6,5,65,42,23,63
Copenhagen,7531,3,16,5,9,65,45,20,53
FC Nords,7531,4,13,6,11,72,52,20,45
AaB,7531,5,8,12,10,38,44,-6,36
Sonderjyske,7531,6,8,6,10,28,29,-1,30
AC Horsens,7531,7,5,13,12,32,57,-25,28
Randers FC,7531,8,6,6,12,25,39,-14,24
Silkeborg IF,7531,9,6,3,13,31,47,-16,21
Lyngby,7531,10,3,9,12,26,46,-20,18
AGF Aarhus,7531,11,4,6,12,19,42,-23,18
FC Midtjylla,7532,1,20,5,5,69,37,32,65
Brondby,7532,2,19,6,5,66,33,33,63
FC Nords,7532,3,15,6,9,71,52,19,51
Copenhagen,7532,4,13,5,12,54,42,12,44
AaB,7532,5,8,12,10,38,47,-9,36
AC Horsens,7532,6,8,12,10,37,50,-13,36
Sonderjyske,7532,7,8,6,10,28,29,-1,30
Randers FC,7532,8,5,7,12,24,40,-16,22
Silkeborg IF,7532,9,6,3,13,27,45,-18,21
Lyngby,7532,10,3,10,11,27,45,-18,19
AGF Aarhus,7532,11,4,6,12,17,38,-21,18
Brondby,7533,1,22,6,2,74,30,44,72
FC Midtjylla,7533,2,21,4,5,72,39,33,67
FC Nords,7533,3,13,7,10,69,50,19,46
Copenhagen,7533,4,12,5,13,51,52,-1,41
AaB,7533,5,8,11,11,39,46,-7,35
AC Horsens,7533,6,7,13,10,37,51,-14,34
Sonderjyske,7533,7,8,6,10,28,29,-1,30
Lyngby,7533,8,4,9,11,29,45,-16,21
Randers FC,7533,9,5,6,13,24,42,-18,21
Silkeborg IF,7533,10,5,4,13,26,45,-19,19
AGF Aarhus,7533,11,4,7,11,17,37,-20,19
Brondby,7534,1,22,6,2,77,32,45,72
FC Midtjylla,7534,2,18,6,6,65,41,24,60
FC Nords,7534,3,14,7,9,73,59,14,49
Copenhagen,7534,4,14,6,10,59,42,17,48
AaB,7534,5,8,12,10,39,44,-5,36
Sonderjyske,7534,6,8,6,10,28,29,-1,30
AC Horsens,7534,7,5,13,12,37,58,-21,28
Lyngby,7534,8,4,9,11,29,46,-17,21
Randers FC,7534,9,5,6,13,25,42,-17,21
Silkeborg IF,7534,10,6,3,13,26,44,-18,21
AGF Aarhus,7534,11,4,6,12,16,37,-21,18
Brondby,7535,1,23,5,2,77,30,47,74
FC Midtjylla,7535,2,19,5,6,63,38,25,62
FC Nords,7535,3,15,6,9,75,54,21,51
Copenhagen,7535,4,12,6,12,55,48,7,42
AaB,7535,5,8,11,11,37,41,-4,35
AC Horsens,7535,6,6,13,11,32,54,-22,31
Sonderjyske,7535,7,8,6,10,28,29,-1,30
Randers FC,7535,8,5,7,12,25,41,-16,22
Silkeborg IF,7535,9,6,3,13,26,44,-18,21
Lyngby,7535,10,3,10,11,28,46,-18,19
AGF Aarhus,7535,11,4,6,12,16,37,-21,18
Brondby,7536,1,19,8,3,74,37,37,65
FC Midtjylla,7536,2,20,5,5,67,36,31,65
FC Nords,7536,3,15,7,8,75,49,26,52
Copenhagen,7536,4,12,5,13,55,52,3,41
AC Horsens,7536,5,9,12,9,36,47,-11,39
AaB,7536,6,7,11,12,34,46,-12,32
Sonderjyske,7536,7,8,6,10,28,29,-1,30
Randers FC,7536,8,6,6,12,25,39,-14,24
Silkeborg IF,7536,9,6,3,13,31,45,-14,21
Lyngby,7536,10,3,9,12,26,46,-20,18
AGF Aarhus,7536,11,4,6,12,17,42,-25,18
Brondby,7537,1,22,5,3,69,28,41,71
FC Midtjylla,7537,2,19,6,5,64,42,22,63
FC Nords,7537,3,14,7,9,70,48,22,49
Copenhagen,7537,4,14,5,11,60,46,14,47
AaB,7537,5,8,13,9,37,38,-1,37
Sonderjyske,7537,6,8,6,10,28,29,-1,30
AC Horsens,7537,7,5,12,13,32,56,-24,27
Lyngby,7537,8,4,9,11,28,45,-17,21
Randers FC,7537,9,5,6,13,24,41,-17,21
Silkeborg IF,7537,10,5,4,13,25,44,-19,19
AGF Aarhus,7537,11,4,7,11,16,36,-20,19
Brondby,7538,1,19,8,3,68,33,35,65
FC Midtjylla,7538,2,19,5,6,62,36,26,62
Copenhagen,7538,3,15,5,10,57,42,15,50
FC Nords,7538,4,13,8,9,70,52,18,47
AaB,7538,5,7,13,10,39,45,-6,34
AC Horsens,7538,6,6,15,9,37,51,-14,33
Sonderjyske,7538,7,8,6,10,28,29,-1,30
Randers FC,7538,8,6,6,12,27,41,-14,24
Silkeborg IF,7538,9,6,3,13,29,44,-15,21
Lyngby,7538,10,3,9,12,28,48,-20,18
AGF Aarhus,7538,11,4,6,12,16,40,-24,18
Brondby,7539,1,23,5,2,78,33,45,74
FC Midtjylla,7539,2,19,6,5,69,44,25,63
FC Nords,7539,3,14,7,9,74,55,19,49
Copenhagen,7539,4,14,4,12,57,46,11,46
AaB,7539,5,6,14,10,36,43,-7,32
Sonderjyske,7539,6,8,6,10,28,29,-1,30
AC Horsens,7539,7,5,14,11,35,54,-19,29
Randers FC,7539,8,6,6,12,25,39,-14,24
Silkeborg IF,7539,9,6,3,13,28,45,-17,21
Lyngby,7539,10,3,9,12,26,46,-20,18
AGF Aarhus,7539,11,4,6,12,17,39,-22,18
Brondby,7540,1,22,5,3,69,30,39,71
FC Midtjylla,7540,2,20,5,5,70,41,29,65
FC Nords,7540,3,15,7,8,79,50,29,52
Copenhagen,7540,4,12,5,13,53,50,3,41
AC Horsens,7540,5,7,13,10,35,53,-18,34
AaB,7540,6,6,13,11,34,42,-8,31
Sonderjyske,7540,7,8,6,10,28,29,-1,30
Lyngby,7540,8,4,9,11,28,45,-17,21
Silkeborg IF,7540,9,6,3,13,27,44,-17,21
Randers FC,7540,10,5,6,13,24,41,-17,21
AGF Aarhus,7540,11,4,6,12,16,38,-22,18
Brondby,7541,1,22,6,2,77,35,42,72
FC Midtjylla,7541,2,18,6,6,70,41,29,60
FC Nords,7541,3,14,6,10,73,58,15,48
Copenhagen,7541,4,14,6,10,60,48,12,48
AaB,7541,5,7,12,11,39,46,-7,33
AC Horsens,7541,6,6,14,10,35,52,-17,32
Sonderjyske,7541,7,8,6,10,28,29,-1,30
Lyngby,7541,8,4,9,11,28,44,-16,21
Randers FC,7541,9,5,6,13,23,41,-18,21
AGF Aarhus,7541,10,5,6,11,17,36,-19,21
Silkeborg IF,7541,11,5,3,14,25,45,-20,18
FC Midtjylla,7542,1,20,6,4,72,36,36,66
Brondby,7542,2,20,6,4,68,33,35,66
FC Nords,7542,3,15,8,7,74,50,24,53
Copenhagen,7542,4,14,5,11,57,47,10,47
AC Horsens,7542,5,6,13,11,35,54,-19,31
Sonderjyske,7542,6,8,6,10,28,29,-1,30
AaB,7542,7,6,12,12,37,49,-12,30
Randers FC,7542,8,6,6,12,25,40,-15,24
Silkeborg IF,7542,9,6,3,13,30,44,-14,21
Lyngby,7542,10,3,9,12,27,46,-19,18
AGF Aarhus,7542,11,4,6,12,16,41,-25,18
Brondby,7543,1,22,6,2,77,30,47,72
FC Midtjylla,7543,2,19,4,7,63,45,18,61
FC Nords,7543,3,13,7,10,72,54,18,46
Copenhagen,7543,4,13,7,10,58,44,14,46
AaB,7543,5,9,13,8,43,41,2,40
Sonderjyske,7543,6,8,6,10,28,29,-1,30
AC Horsens,7543,7,5,13,12,32,57,-25,28
Randers FC,7543,8,6,6,12,26,39,-13,24
AGF Aarhus,7543,9,5,6,11,17,36,-19,21
Silkeborg IF,7543,10,5,3,14,25,45,-20,18
Lyngby,7543,11,3,9,12,26,47,-21,18
Brondby,7544,1,22,5,3,73,31,42,71
FC Midtjylla,7544,2,21,4,5,67,37,30,67
FC Nords,7544,3,13,8,9,70,50,20,47
Copenhagen,7544,4,13,5,12,56,44,12,44
AaB,7544,5,7,13,10,35,45,-10,34
AC Horsens,7544,6,6,13,11,34,54,-20,31
Sonderjyske,7544,7,8,6,10,28,29,-1,30
Lyngby,7544,8,4,9,11,28,44,-16,21
Randers FC,7544,9,5,6,13,23,41,-18,21
Silkeborg IF,7544,10,5,4,13,27,46,-19,19
AGF Aarhus,7544,11,4,7,11,18,38,-20,19
Brondby,7545,1,20,7,3,66,30,36,67
FC Midtjylla,7545,2,18,7,5,66,42,24,61
FC Nords,7545,3,15,6,9,74,51,23,51
Copenhagen,7545,4,13,5,12,54,45,9,44
AaB,7545,5,8,12,10,40,43,-3,36
AC Horsens,7545,6,7,13,10,36,51,-15,34
Sonderjyske,7545,7,8,6,10,28,29,-1,30
Lyngby,7545,8,4,9,11,28,44,-16,21
Silkeborg IF,7545,9,6,3,13,28,45,-17,21
Randers FC,7545,10,5,6,13,23,41,-18,21
AGF Aarhus,7545,11,4,6,12,17,39,-22,18
Brondby,7546,1,21,5,4,69,32,37,68
FC Midtjylla,7546,2,21,4,5,69,38,31,67
FC Nords,7546,3,14,6,10,76,54,22,48
Copenhagen,7546,4,13,4,13,54,48,6,43
AaB,7546,5,10,11,9,40,40,0,41
Sonderjyske,7546,6,8,6,10,28,29,-1,30
AC Horsens,7546,7,6,12,12,33,55,-22,30
Randers FC,7546,8,5,7,12,24,40,-16,22
Silkeborg IF,7546,9,6,3,13,28,44,-16,21
Lyngby,7546,10,3,10,11,27,45,-18,19
AGF Aarhus,7546,11,4,6,12,16,39,-23,18
Brondby,7547,1,21,7,2,73,28,45,70
FC Midtjylla,7547,2,21,4,5,67,38,29,67
Copenhagen,7547,3,14,5,11,56,42,14,47
FC Nords,7547,4,13,6,11,67,54,13,45
AaB,7547,5,7,12,11,34,44,-10,33
AC Horsens,7547,6,6,14,10,35,52,-17,32
Sonderjyske,7547,7,8,6,10,28,29,-1,30
Lyngby,7547,8,4,9,11,29,44,-15,21
Silkeborg IF,7547,9,6,3,13,27,45,-18,21
Randers FC,7547,10,5,6,13,23,42,-19,21
AGF Aarhus,7547,11,4,6,12,17,38,-21,18
FC Midtjylla,7548,1,20,6,4,63,34,29,66
Brondby,7548,2,19,7,4,67,34,33,64
FC Nords,7548,3,14,7,9,71,50,21,49
Copenhagen,7548,4,13,8,9,59,44,15,47
AaB,7548,5,7,13,10,37,42,-5,34
AC Horsens,7548,6,6,13,11,36,55,-19,31
Sonderjyske,7548,7,8,6,10,28,29,-1,30
Lyngby,7548,8,4,9,11,27,44,-17,21
Randers FC,7548,9,5,6,13,23,40,-17,21
Silkeborg IF,7548,10,6,3,13,27,45,-18,21
AGF Aarhus,7548,11,4,6,12,17,38,-21,18
Brondby,7549,1,21,5,4,68,31,37,68
FC Midtjylla,7549,2,20,4,6,66,39,27,64
Copenhagen,7549,3,15,5,10,63,44,19,50
FC Nords,7549,4,13,7,10,70,53,17,46
AaB,7549,5,8,11,11,34,43,-9,35
AC Horsens,7549,6,7,12,11,38,55,-17,33
Sonderjyske,7549,7,8,6,10,28,29,-1,30
Lyngby,7549,8,4,9,11,28,44,-16,21
Randers FC,7549,9,5,6,13,23,41,-18,21
Silkeborg IF,7549,10,5,4,13,26,45,-19,19
AGF Aarhus,7549,11,4,7,11,17,37,-20,19
Brondby,7550,1,21,6,3,72,33,39,69
FC Midtjylla,7550,2,20,5,5,79,41,38,65
FC Nords,7550,3,14,8,8,71,53,18,50
Copenhagen,7550,4,12,8,10,59,48,11,44
AaB,7550,5,6,14,10,35,46,-11,32
Sonderjyske,7550,6,8,6,10,28,29,-1,30
AC Horsens,7550,7,5,15,10,35,56,-21,30
Silkeborg IF,7550,8,6,3,13,31,44,-13,21
Lyngby,7550,9,4,9,11,28,45,-17,21
Randers FC,7550,10,5,6,13,24,41,-17,21
AGF Aarhus,7550,11,4,6,12,16,42,-26,18
Brondby,7551,1,21,6,3,71,31,40,69
FC Midtjylla,7551,2,17,5,8,57,42,15,56
FC Nords,7551,3,16,6,8,75,48,27,54
Copenhagen,7551,4,13,6,11,55,44,11,45
AC Horsens,7551,5,8,13,9,34,47,-13,37
AaB,7551,6,6,14,10,33,39,-6,32
Sonderjyske,7551,7,8,6,10,28,29,-1,30
Randers FC,7551,8,5,7,12,24,40,-16,22
AGF Aarhus,7551,9,5,6,11,17,36,-19,21
Lyngby,7551,10,3,10,11,27,45,-18,19
Silkeborg IF,7551,11,5,3,14,25,45,-20,18
Brondby,7552,1,21,5,4,71,31,40,68
FC Midtjylla,7552,2,20,4,6,63,39,24,64
FC Nords,7552,3,16,7,7,78,49,29,55
Copenhagen,7552,4,13,5,12,55,46,9,44
AaB,7552,5,7,12,11,35,44,-9,33
Sonderjyske,7552,6,8,6,10,28,29,-1,30
AC Horsens,7552,7,5,15,10,35,54,-19,30
Randers FC,7552,8,6,6,12,26,40,-14,24
Silkeborg IF,7552,9,6,3,13,28,44,-16,21
Lyngby,7552,10,3,9,12,27,47,-20,18
AGF Aarhus,7552,11,4,6,12,16,39,-23,18
Brondby,7553,1,22,5,3,78,34,44,71
FC Midtjylla,7553,2,20,5,5,69,41,28,65
Copenhagen,7553,3,16,4,10,63,44,19,52
FC Nords,7553,4,13,6,11,70,57,13,45
AaB,7553,5,6,13,11,38,48,-10,31
AC Horsens,7553,6,6,13,11,34,54,-20,31
Sonderjyske,7553,7,8,6,10,28,29,-1,30
Randers FC,7553,8,5,7,12,24,40,-16,22
AGF Aarhus,7553,9,5,6,11,18,37,-19,21
Lyngby,7553,10,3,10,11,27,45,-18,19
Silkeborg IF,7553,11,5,3,14,26,46,-20,18
Brondby,7554,1,21,7,2,74,32,42,70
FC Midtjylla,7554,2,18,6,6,66,43,23,60
FC Nords,7554,3,13,8,9,71,55,16,47
Copenhagen,7554,4,13,6,11,58,44,14,45
AaB,7554,5,9,12,9,39,41,-2,39
AC Horsens,7554,6,6,13,11,32,51,-19,31
Sonderjyske,7554,7,8,6,10,28,29,-1,30
Lyngby,7554,8,4,9,11,29,45,-16,21
Silkeborg IF,7554,9,6,3,13,27,45,-18,21
Randers FC,7554,10,5,6,13,24,42,-18,21
AGF Aarhus,7554,11,4,6,12,17,38,-21,18
FC Midtjylla,7555,1,22,4,4,71,38,33,70
Brondby,7555,2,20,6,4,73,34,39,66
FC Nords,7555,3,14,6,10,74,56,18,48
Copenhagen,7555,4,14,5,11,58,47,11,47
AaB,7555,5,8,12,10,44,51,-7,36
Sonderjyske,7555,6,8,6,10,28,29,-1,30
AC Horsens,7555,7,5,13,12,35,55,-20,28
Randers FC,7555,8,6,6,12,25,39,-14,24
AGF Aarhus,7555,9,5,6,11,18,37,-19,21
Lyngby,7555,10,3,9,12,26,46,-20,18
Silkeborg IF,7555,10,5,3,14,26,46,-20,18
Brondby,7556,1,21,6,3,69,29,40,69
FC Midtjylla,7556,2,20,4,6,68,39,29,64
FC Nords,7556,3,14,8,8,72,48,24,50
Copenhagen,7556,4,15,4,11,59,45,14,49
AC Horsens,7556,5,7,12,11,32,50,-18,33
Sonderjyske,7556,6,8,6,10,28,29,-1,30
AaB,7556,7,6,12,12,34,49,-15,30
Randers FC,7556,8,6,6,12,25,40,-15,24
AGF Aarhus,7556,9,5,6,11,18,37,-19,21
Lyngby,7556,10,3,9,12,27,46,-19,18
Silkeborg IF,7556,11,5,3,14,26,46,-20,18
Brondby,7557,1,20,6,4,68,30,38,66
FC Midtjylla,7557,2,19,7,4,63,35,28,64
FC Nords,7557,3,14,8,8,74,51,23,50
Copenhagen,7557,4,15,5,10,60,43,17,50
AaB,7557,5,8,11,11,36,46,-10,35
Sonderjyske,7557,6,8,6,10,28,29,-1,30
AC Horsens,7557,7,5,13,12,29,51,-22,28
Lyngby,7557,8,4,9,11,28,44,-16,21
Randers FC,7557,9,5,6,13,23,41,-18,21
AGF Aarhus,7557,10,5,6,11,17,36,-19,21
Silkeborg IF,7557,11,5,3,14,25,45,-20,18
FC Midtjylla,7558,1,20,6,4,68,39,29,66
Brondby,7558,2,20,5,5,69,37,32,65
FC Nords,7558,3,16,7,7,76,46,30,55
Copenhagen,7558,4,12,5,13,57,51,6,41
AC Horsens,7558,5,8,12,10,38,53,-15,36
AaB,7558,6,7,11,12,37,45,-8,32
Sonderjyske,7558,7,8,6,10,28,29,-1,30
Randers FC,7558,8,5,7,12,24,40,-16,22
Silkeborg IF,7558,9,6,3,13,28,46,-18,21
Lyngby,7558,10,3,10,11,27,45,-18,19
AGF Aarhus,7558,11,4,6,12,18,39,-21,18
Brondby,7559,1,20,5,5,69,34,35,65
FC Midtjylla,7559,2,20,5,5,72,40,32,65
FC Nords,7559,3,14,8,8,72,50,22,50
Copenhagen,7559,4,15,4,11,59,43,16,49
AC Horsens,7559,5,7,13,10,37,54,-17,34
AaB,7559,6,6,13,11,34,48,-14,31
Sonderjyske,7559,7,8,6,10,28,29,-1,30
Lyngby,7559,8,4,9,11,27,44,-17,21
Randers FC,7559,9,5,6,13,23,40,-17,21
Silkeborg IF,7559,10,5,4,13,26,45,-19,19
AGF Aarhus,7559,11,4,7,11,17,37,-20,19
Brondby,7560,1,22,6,2,71,28,43,72
FC Midtjylla,7560,2,21,5,4,66,34,32,68
FC Nords,7560,3,13,8,9,69,51,18,47
Copenhagen,7560,4,13,5,12,54,46,8,44
AaB,7560,5,7,12,11,36,41,-5,33
Sonderjyske,7560,6,8,6,10,28,29,-1,30
AC Horsens,7560,7,6,12,12,33,55,-22,30
Lyngby,7560,8,4,9,11,28,45,-17,21
Randers FC,7560,9,5,6,13,24,41,-17,21
Silkeborg IF,7560,10,5,4,13,25,44,-19,19
AGF Aarhus,7560,11,4,7,11,16,36,-20,19
Brondby,7561,1,21,5,4,71,35,36,68
FC Midtjylla,7561,2,19,5,6,66,42,24,62
FC Nords,7561,3,16,6,8,76,50,26,54
Copenhagen,7561,4,16,4,10,63,47,16,52
AaB,7561,5,7,12,11,36,41,-5,33
Sonderjyske,7561,6,8,6,10,28,29,-1,30
AC Horsens,7561,7,5,12,13,33,56,-23,27
Randers FC,7561,8,5,7,12,23,39,-16,22
AGF Aarhus,7561,9,5,6,11,17,36,-19,21
Lyngby,7561,10,3,10,11,26,44,-18,19
Silkeborg IF,7561,11,5,3,14,25,45,-20,18
FC Midtjylla,7562,1,20,6,4,74,40,34,66
Brondby,7562,2,20,5,5,70,36,34,65
FC Nords,7562,3,15,7,8,78,53,25,52
Copenhagen,7562,4,14,6,10,60,46,14,48
AaB,7562,5,6,15,9,38,46,-8,33
Sonderjyske,7562,6,8,6,10,28,29,-1,30
AC Horsens,7562,7,5,13,12,35,60,-25,28
Randers FC,7562,8,5,7,12,23,39,-16,22
Lyngby,7562,9,3,10,11,26,44,-18,19
Silkeborg IF,7562,10,5,4,13,25,44,-19,19
AGF Aarhus,7562,11,4,7,11,16,36,-20,19
Brondby,7563,1,21,7,2,76,31,45,70
FC Midtjylla,7563,2,19,7,4,71,38,33,64
Copenhagen,7563,3,14,6,10,58,44,14,48
FC Nords,7563,4,13,8,9,70,54,16,47
AaB,7563,5,7,13,10,39,44,-5,34
Sonderjyske,7563,6,8,6,10,28,29,-1,30
AC Horsens,7563,7,5,13,12,33,62,-29,28
Lyngby,7563,8,4,9,11,33,44,-11,21
Silkeborg IF,7563,9,6,3,13,26,44,-18,21
Randers FC,7563,10,5,6,13,23,46,-23,21
AGF Aarhus,7563,11,4,6,12,16,37,-21,18
Brondby,7564,1,20,8,2,73,33,40,68
FC Midtjylla,7564,2,19,5,6,66,41,25,62
FC Nords,7564,3,15,6,9,77,48,29,51
Copenhagen,7564,4,13,5,12,55,49,6,44
AaB,7564,5,8,12,10,37,43,-6,36
AC Horsens,7564,6,6,14,10,35,55,-20,32
Sonderjyske,7564,7,8,6,10,28,29,-1,30
Lyngby,7564,8,4,9,11,27,44,-17,21
Randers FC,7564,9,5,6,13,23,40,-17,21
Silkeborg IF,7564,10,5,4,13,27,46,-19,19
AGF Aarhus,7564,11,4,7,11,18,38,-20,19
Brondby,7565,1,21,7,2,74,33,41,70
FC Midtjylla,7565,2,20,4,6,65,39,26,64
FC Nords,7565,3,15,7,8,72,47,25,52
Copenhagen,7565,4,13,5,12,55,46,9,44
AaB,7565,5,7,12,11,38,47,-9,33
AC Horsens,7565,6,6,13,11,36,54,-18,31
Sonderjyske,7565,7,8,6,10,28,29,-1,30
Lyngby,7565,8,4,9,11,27,44,-17,21
Randers FC,7565,9,5,6,13,23,40,-17,21
AGF Aarhus,7565,10,5,6,11,17,36,-19,21
Silkeborg IF,7565,11,5,3,14,25,45,-20,18
FC Midtjylla,7566,1,20,5,5,67,41,26,65
Brondby,7566,2,19,7,4,67,34,33,64
FC Nords,7566,3,16,6,8,74,47,27,54
Copenhagen,7566,4,14,6,10,61,46,15,48
AaB,7566,5,6,14,10,38,44,-6,32
Sonderjyske,7566,6,8,6,10,28,29,-1,30
AC Horsens,7566,7,5,14,11,33,54,-21,29
Lyngby,7566,8,4,9,11,29,45,-16,21
Silkeborg IF,7566,9,6,3,13,27,44,-17,21
Randers FC,7566,10,5,6,13,24,42,-18,21
AGF Aarhus,7566,11,4,6,12,16,38,-22,18
Brondby,7567,1,21,7,2,77,33,44,70
FC Midtjylla,7567,2,21,5,4,69,36,33,68
FC Nords,7567,3,14,6,10,72,51,21,48
Copenhagen,7567,4,13,6,11,57,45,12,45
AaB,7567,5,7,12,11,36,47,-11,33
Sonderjyske,7567,6,8,6,10,28,29,-1,30
AC Horsens,7567,7,5,14,11,33,58,-25,29
Lyngby,7567,8,4,9,11,29,46,-17,21
Randers FC,7567,9,5,6,13,25,42,-17,21
Silkeborg IF,7567,10,5,4,13,26,45,-19,19
AGF Aarhus,7567,11,4,7,11,17,37,-20,19
Brondby,7568,1,20,7,3,68,35,33,67
FC Midtjylla,7568,2,19,5,6,64,36,28,62
FC Nords,7568,3,15,6,9,75,52,23,51
Copenhagen,7568,4,13,6,11,58,48,10,45
AaB,7568,5,9,12,9,39,39,0,39
Sonderjyske,7568,6,8,6,10,28,29,-1,30
AC Horsens,7568,7,6,12,12,32,52,-20,30
Randers FC,7568,8,6,6,12,27,39,-12,24
Silkeborg IF,7568,9,6,3,13,27,44,-17,21
Lyngby,7568,10,3,9,12,26,48,-22,18
AGF Aarhus,7568,11,4,6,12,16,38,-22,18
Brondby,7569,1,21,7,2,71,32,39,70
FC Midtjylla,7569,2,20,5,5,67,38,29,65
FC Nords,7569,3,13,7,10,74,58,16,46
Copenhagen,7569,4,13,7,10,59,45,14,46
AaB,7569,5,7,12,11,38,46,-8,33
AC Horsens,7569,6,6,14,10,35,51,-16,32
Sonderjyske,7569,7,8,6,10,28,29,-1,30
Lyngby,7569,8,4,9,11,28,45,-17,21
Randers FC,7569,9,5,6,13,24,41,-17,21
Silkeborg IF,7569,10,5,4,13,25,44,-19,19
AGF Aarhus,7569,11,4,7,11,16,36,-20,19
Brondby,7570,1,21,5,4,72,31,41,68
FC Midtjylla,7570,2,21,4,5,66,38,28,67
FC Nords,7570,3,14,7,9,69,51,18,49
Copenhagen,7570,4,14,4,12,56,45,11,46
AC Horsens,7570,5,7,13,10,37,52,-15,34
AaB,7570,6,7,11,12,34,43,-9,32
Sonderjyske,7570,7,8,6,10,28,29,-1,30
Lyngby,7570,8,4,9,11,27,44,-17,21
Silkeborg IF,7570,8,6,3,13,27,44,-17,21
Randers FC,7570,10,5,6,13,23,40,-17,21
AGF Aarhus,7570,11,4,6,12,16,38,-22,18
Brondby,7571,1,22,5,3,72,32,40,71
FC Midtjylla,7571,2,18,6,6,63,40,23,60
FC Nords,7571,3,15,7,8,74,50,24,52
Copenhagen,7571,4,15,5,10,57,44,13,50
AaB,7571,5,7,12,11,36,43,-7,33
Sonderjyske,7571,6,8,6,10,28,29,-1,30
AC Horsens,7571,7,5,13,12,33,52,-19,28
Randers FC,7571,8,5,7,12,23,39,-16,22
Silkeborg IF,7571,9,6,3,13,27,44,-17,21
Lyngby,7571,10,3,10,11,26,44,-18,19
AGF Aarhus,7571,11,4,6,12,16,38,-22,18
FC Midtjylla,7572,1,20,4,6,69,37,32,64
Brondby,7572,2,19,5,6,67,39,28,62
Copenhagen,7572,3,16,5,9,59,38,21,53
FC Nords,7572,4,14,6,10,72,52,20,48
AC Horsens,7572,5,8,13,9,36,49,-13,37
AaB,7572,6,7,11,12,35,49,-14,32
Sonderjyske,7572,7,8,6,10,28,29,-1,30
Lyngby,7572,8,4,9,11,28,45,-17,21
Randers FC,7572,9,5,6,13,24,41,-17,21
Silkeborg IF,7572,10,6,3,13,27,45,-18,21
AGF Aarhus,7572,11,4,6,12,17,38,-21,18
Brondby,7573,1,22,6,2,71,28,43,72
FC Midtjylla,7573,2,21,4,5,62,36,26,67
Copenhagen,7573,3,14,4,12,58,48,10,46
FC Nords,7573,4,13,6,11,69,51,18,45
AaB,7573,5,7,12,11,34,40,-6,33
AC Horsens,7573,6,7,12,11,36,53,-17,33
Sonderjyske,7573,7,8,6,10,28,29,-1,30
Lyngby,7573,8,4,9,11,29,45,-16,21
Randers FC,7573,9,5,6,13,24,42,-18,21
AGF Aarhus,7573,10,5,6,11,17,36,-19,21
Silkeborg IF,7573,11,5,3,14,25,45,-20,18
Brondby,7574,1,21,5,4,72,35,37,68
FC Midtjylla,7574,2,20,5,5,67,37,30,65
FC Nords,7574,3,15,6,9,78,52,26,51
Copenhagen,7574,4,14,4,12,57,46,11,46
AaB,7574,5,8,12,10,38,44,-6,36
Sonderjyske,7574,6,8,6,10,28,29,-1,30
AC Horsens,7574,7,5,14,11,33,57,-24,29
Lyngby,7574,8,4,9,11,27,44,-17,21
Randers FC,7574,9,5,6,13,23,40,-17,21
Silkeborg IF,7574,10,6,3,13,27,45,-18,21
AGF Aarhus,7574,11,4,6,12,17,38,-21,18
Brondby,7575,1,21,6,3,76,33,43,69
FC Midtjylla,7575,2,19,5,6,67,40,27,62
Copenhagen,7575,3,16,4,10,59,41,18,52
FC Nords,7575,4,12,6,12,67,55,12,42
AaB,7575,5,9,11,10,38,44,-6,38
AC Horsens,7575,6,7,12,11,33,53,-20,33
Sonderjyske,7575,7,8,6,10,28,29,-1,30
Lyngby,7575,8,4,9,11,27,44,-17,21
Silkeborg IF,7575,8,6,3,13,27,44,-17,21
Randers FC,7575,10,5,6,13,23,40,-17,21
AGF Aarhus,7575,11,4,6,12,16,38,-22,18
FC Midtjylla,7576,1,20,4,6,63,38,25,64
Brondby,7576,2,18,6,6,64,36,28,60
FC Nords,7576,3,15,6,9,73,49,24,51
Copenhagen,7576,4,15,6,9,61,43,18,51
AaB,7576,5,8,12,10,37,40,-3,36
AC Horsens,7576,6,6,14,10,35,53,-18,32
Sonderjyske,7576,7,8,6,10,28,29,-1,30
Randers FC,7576,8,6,6,12,26,40,-14,24
AGF Aarhus,7576,9,5,6,11,18,37,-19,21
Lyngby,7576,10,3,9,12,27,47,-20,18
Silkeborg IF,7576,11,5,3,14,26,46,-20,18
Brondby,7577,1,21,5,4,68,35,33,68
FC Midtjylla,7577,2,21,4,5,74,37,37,67
Copenhagen,7577,3,15,4,11,63,45,18,49
FC Nords,7577,4,14,6,10,71,54,17,48
AC Horsens,7577,5,7,13,10,37,52,-15,34
Sonderjyske,7577,6,8,6,10,28,29,-1,30
AaB,7577,7,6,12,12,34,50,-16,30
Randers FC,7577,8,6,6,12,24,39,-15,24
Silkeborg IF,7577,9,6,3,13,26,44,-18,21
Lyngby,7577,10,3,9,12,26,45,-19,18
AGF Aarhus,7577,11,4,6,12,16,37,-21,18
FC Midtjylla,7578,1,21,5,4,68,36,32,68
Brondby,7578,2,20,7,3,73,33,40,67
FC Nords,7578,3,13,8,9,71,56,15,47
Copenhagen,7578,4,12,8,10,56,44,12,44
AaB,7578,5,7,13,10,37,42,-5,34
AC Horsens,7578,6,6,13,11,34,54,-20,31
Sonderjyske,7578,7,8,6,10,28,29,-1,30
Lyngby,7578,8,4,9,11,31,45,-14,21
AGF Aarhus,7578,9,5,6,11,17,36,-19,21
Randers FC,7578,10,5,6,13,24,44,-20,21
Silkeborg IF,7578,11,5,3,14,25,45,-20,18
Brondby,7579,1,21,5,4,74,33,41,68
FC Midtjylla,7579,2,20,4,6,70,42,28,64
FC Nords,7579,3,15,7,8,78,52,26,52
Copenhagen,7579,4,15,5,10,62,45,17,50
AC Horsens,7579,5,7,12,11,37,53,-16,33
Sonderjyske,7579,6,8,6,10,28,29,-1,30
AaB,7579,7,6,11,13,33,55,-22,29
Lyngby,7579,8,4,9,11,30,45,-15,21
Silkeborg IF,7579,9,6,3,13,26,44,-18,21
Randers FC,7579,10,5,6,13,24,43,-19,21
AGF Aarhus,7579,11,4,6,12,16,37,-21,18
Brondby,7580,1,21,6,3,73,33,40,69
FC Midtjylla,7580,2,18,4,8,62,46,16,58
FC Nords,7580,3,14,7,9,75,52,23,49
Copenhagen,7580,4,14,7,9,61,42,19,49
AaB,7580,5,8,11,11,38,44,-6,35
AC Horsens,7580,6,7,13,10,34,52,-18,34
Sonderjyske,7580,7,8,6,10,28,29,-1,30
Randers FC,7580,8,6,6,12,25,40,-15,24
Silkeborg IF,7580,9,5,4,13,26,45,-19,19
AGF Aarhus,7580,10,4,7,11,17,37,-20,19
Lyngby,7580,11,3,9,12,27,46,-19,18
Brondby,7581,1,20,5,5,74,38,36,65
FC Midtjylla,7581,2,19,6,5,65,37,28,63
FC Nords,7581,3,15,7,8,80,51,29,52
Copenhagen,7581,4,14,5,11,56,44,12,47
AC Horsens,7581,5,7,13,10,36,54,-18,34
AaB,7581,6,7,12,11,35,48,-13,33
Sonderjyske,7581,7,8,6,10,28,29,-1,30
Randers FC,7581,8,5,7,12,26,42,-16,22
AGF Aarhus,7581,9,5,6,11,17,36,-19,21
Lyngby,7581,10,3,10,11,29,47,-18,19
Silkeborg IF,7581,11,5,3,14,25,45,-20,18
Brondby,7582,1,21,6,3,72,30,42,69
FC Midtjylla,7582,2,19,4,7,68,44,24,61
Copenhagen,7582,3,15,5,10,61,44,17,50
FC Nords,7582,4,14,6,10,74,56,18,48
AaB,7582,5,8,12,10,36,44,-8,36
AC Horsens,7582,6,6,13,11,36,55,-19,31
Sonderjyske,7582,7,8,6,10,28,29,-1,30
Lyngby,7582,8,4,9,11,31,44,-13,21
Silkeborg IF,7582,9,6,3,13,27,44,-17,21
Randers FC,7582,10,5,6,13,23,44,-21,21
AGF Aarhus,7582,11,4,6,12,16,38,-22,18
Brondby,7583,1,20,6,4,67,33,34,66
FC Midtjylla,7583,2,17,6,7,62,42,20,57
FC Nords,7583,3,15,6,9,75,52,23,51
Copenhagen,7583,4,13,6,11,58,46,12,45
AaB,7583,5,8,14,8,38,40,-2,38
AC Horsens,7583,6,8,12,10,35,48,-13,36
Sonderjyske,7583,7,8,6,10,28,29,-1,30
Randers FC,7583,8,6,6,12,25,40,-15,24
AGF Aarhus,7583,9,5,6,11,20,37,-17,21
Lyngby,7583,10,3,9,12,27,46,-19,18
Silkeborg IF,7583,11,5,3,14,26,48,-22,18
Brondby,7584,1,22,5,3,76,35,41,71
FC Midtjylla,7584,2,18,6,6,64,42,22,60
Copenhagen,7584,3,15,5,10,58,43,15,50
FC Nords,7584,4,14,7,9,76,52,24,49
AaB,7584,5,8,12,10,37,40,-3,36
Sonderjyske,7584,6,8,6,10,28,29,-1,30
AC Horsens,7584,7,5,13,12,32,57,-25,28
Lyngby,7584,8,4,9,11,30,44,-14,21
AGF Aarhus,7584,9,5,6,11,19,38,-19,21
Randers FC,7584,10,5,6,13,23,43,-20,21
Silkeborg IF,7584,11,5,3,14,27,47,-20,18
FC Midtjylla,7585,1,19,5,6,66,39,27,62
Brondby,7585,2,18,7,5,68,39,29,61
Copenhagen,7585,3,15,5,10,58,42,16,50
FC Nords,7585,4,14,7,9,71,50,21,49
AaB,7585,5,8,12,10,41,47,-6,36
AC Horsens,7585,6,7,14,9,38,51,-13,35
Sonderjyske,7585,7,8,6,10,28,29,-1,30
Lyngby,7585,8,4,9,11,28,45,-17,21
Randers FC,7585,9,5,6,13,24,41,-17,21
AGF Aarhus,7585,10,5,6,11,18,36,-18,21
Silkeborg IF,7585,11,5,3,14,25,46,-21,18
Brondby,7586,1,23,5,2,73,31,42,74
FC Midtjylla,7586,2,18,5,7,63,39,24,59
FC Nords,7586,3,14,7,9,71,52,19,49
Copenhagen,7586,4,13,5,12,58,49,9,44
AaB,7586,5,8,13,9,41,45,-4,37
AC Horsens,7586,6,6,13,11,35,51,-16,31
Sonderjyske,7586,7,8,6,10,28,29,-1,30
Randers FC,7586,8,6,6,12,25,40,-15,24
AGF Aarhus,7586,9,5,6,11,17,36,-19,21
Lyngby,7586,10,3,9,12,27,46,-19,18
Silkeborg IF,7586,11,5,3,14,25,45,-20,18
Brondby,7587,1,22,5,3,75,35,40,71
FC Midtjylla,7587,2,20,4,6,69,41,28,64
FC Nords,7587,3,15,7,8,79,54,25,52
Copenhagen,7587,4,14,5,11,63,55,8,47
AaB,7587,5,7,12,11,41,44,-3,33
Sonderjyske,7587,6,8,6,10,28,29,-1,30
AC Horsens,7587,7,5,13,12,34,58,-24,28
Randers FC,7587,8,6,6,12,26,41,-15,24
AGF Aarhus,7587,9,5,6,11,18,36,-18,21
Lyngby,7587,10,3,9,12,28,47,-19,18
Silkeborg IF,7587,11,5,3,14,25,46,-21,18
Brondby,7588,1,21,6,3,70,33,37,69
FC Midtjylla,7588,2,20,4,6,64,38,26,64
FC Nords,7588,3,15,8,7,75,49,26,53
Copenhagen,7588,4,12,6,12,56,46,10,42
AaB,7588,5,8,11,11,37,44,-7,35
AC Horsens,7588,6,6,13,11,34,52,-18,31
Sonderjyske,7588,7,8,6,10,28,29,-1,30
Randers FC,7588,8,6,6,12,24,39,-15,24
Silkeborg IF,7588,9,6,3,13,29,44,-15,21
Lyngby,7588,10,3,9,12,26,45,-19,18
AGF Aarhus,7588,11,4,6,12,16,40,-24,18
Brondby,7589,1,20,7,3,70,32,38,67
FC Midtjylla,7589,2,20,6,4,70,38,32,66
Copenhagen,7589,3,14,6,10,57,44,13,48
FC Nords,7589,4,13,8,9,72,54,18,47
AaB,7589,5,7,11,12,39,47,-8,32
AC Horsens,7589,6,6,14,10,37,56,-19,32
Sonderjyske,7589,7,8,6,10,28,29,-1,30
Randers FC,7589,8,5,7,12,24,40,-16,22
Lyngby,7589,9,3,10,11,27,45,-18,19
Silkeborg IF,7589,10,5,4,13,26,45,-19,19
AGF Aarhus,7589,11,4,7,11,17,37,-20,19
Brondby,7590,1,21,6,3,69,30,39,69
FC Midtjylla,7590,2,19,4,7,62,40,22,61
FC Nords,7590,3,15,7,8,74,50,24,52
Copenhagen,7590,4,13,6,11,56,45,11,45
AaB,7590,5,8,11,11,41,45,-4,35
AC Horsens,7590,6,7,12,11,37,55,-18,33
Sonderjyske,7590,7,8,6,10,28,29,-1,30
Randers FC,7590,8,6,6,12,25,39,-14,24
Silkeborg IF,7590,9,5,4,13,27,46,-19,19
AGF Aarhus,7590,10,4,7,11,18,38,-20,19
Lyngby,7590,11,3,9,12,26,46,-20,18
Brondby,7591,1,22,6,2,71,32,39,72
FC Midtjylla,7591,2,20,4,6,67,39,28,64
FC Nords,7591,3,13,7,10,71,58,13,46
Copenhagen,7591,4,13,6,11,59,46,13,45
AaB,7591,5,8,13,9,38,39,-1,37
Sonderjyske,7591,6,8,6,10,28,29,-1,30
AC Horsens,7591,7,5,14,11,38,56,-18,29
Lyngby,7591,8,4,9,11,28,44,-16,21
Silkeborg IF,7591,8,6,3,13,28,44,-16,21
Randers FC,7591,10,5,6,13,23,41,-18,21
AGF Aarhus,7591,11,4,6,12,16,39,-23,18
Brondby,7592,1,22,5,3,71,29,42,71
FC Midtjylla,7592,2,18,5,7,63,42,21,59
FC Nords,7592,3,15,6,9,74,54,20,51
Copenhagen,7592,4,14,5,11,58,46,12,47
AaB,7592,5,8,13,9,40,41,-1,37
Sonderjyske,7592,6,8,6,10,28,29,-1,30
AC Horsens,7592,7,6,12,12,32,52,-20,30
Randers FC,7592,8,5,7,12,25,41,-16,22
AGF Aarhus,7592,9,5,6,11,19,38,-19,21
Lyngby,7592,10,3,10,11,28,46,-18,19
Silkeborg IF,7592,11,5,3,14,27,47,-20,18
Brondby,7593,1,20,8,2,73,32,41,68
FC Midtjylla,7593,2,21,4,5,70,38,32,67
Copenhagen,7593,3,13,7,10,56,43,13,46
FC Nords,7593,4,12,9,9,68,53,15,45
AC Horsens,7593,5,6,15,9,35,51,-16,33
AaB,7593,6,6,13,11,35,46,-11,31
Sonderjyske,7593,7,8,6,10,28,29,-1,30
Randers FC,7593,8,6,6,12,27,39,-12,24
Silkeborg IF,7593,9,6,3,13,27,44,-17,21
Lyngby,7593,10,3,9,12,26,48,-22,18
AGF Aarhus,7593,11,4,6,12,16,38,-22,18
Brondby,7594,1,22,5,3,72,30,42,71
FC Midtjylla,7594,2,20,4,6,65,38,27,64
Copenhagen,7594,3,14,5,11,57,42,15,47
FC Nords,7594,4,12,8,10,66,51,15,44
AaB,7594,5,8,11,11,35,47,-12,35
AC Horsens,7594,6,7,13,10,35,48,-13,34
Sonderjyske,7594,7,8,6,10,28,29,-1,30
Randers FC,7594,8,6,6,12,25,39,-14,24
Silkeborg IF,7594,9,5,4,13,25,44,-19,19
AGF Aarhus,7594,10,4,7,11,16,36,-20,19
Lyngby,7594,11,3,9,12,26,46,-20,18
FC Midtjylla,7595,1,21,5,4,69,37,32,68
Brondby,7595,2,19,7,4,65,31,34,64
FC Nords,7595,3,13,8,9,72,54,18,47
Copenhagen,7595,4,13,6,11,55,44,11,45
AaB,7595,5,7,14,9,36,40,-4,35
AC Horsens,7595,6,6,14,10,35,52,-17,32
Sonderjyske,7595,7,8,6,10,28,29,-1,30
Lyngby,7595,8,4,9,11,29,46,-17,21
Silkeborg IF,7595,9,6,3,13,27,44,-17,21
Randers FC,7595,10,5,6,13,25,42,-17,21
AGF Aarhus,7595,11,4,6,12,16,38,-22,18
Brondby,7596,1,19,8,3,74,37,37,65
FC Midtjylla,7596,2,20,4,6,67,40,27,64
FC Nords,7596,3,16,7,7,80,53,27,55
Copenhagen,7596,4,13,6,11,57,45,12,45
AaB,7596,5,7,12,11,40,46,-6,33
AC Horsens,7596,6,6,13,11,33,56,-23,31
Sonderjyske,7596,7,8,6,10,28,29,-1,30
Lyngby,7596,8,4,9,11,27,44,-17,21
Randers FC,7596,9,5,6,13,23,40,-17,21
Silkeborg IF,7596,10,6,3,13,28,46,-18,21
AGF Aarhus,7596,11,4,6,12,18,39,-21,18
Brondby,7597,1,21,7,2,74,32,42,70
FC Midtjylla,7597,2,18,5,7,64,41,23,59
FC Nords,7597,3,13,10,7,72,49,23,49
Copenhagen,7597,4,14,6,10,56,41,15,48
AaB,7597,5,8,12,10,40,47,-7,36
Sonderjyske,7597,6,8,6,10,28,29,-1,30
AC Horsens,7597,7,6,12,12,35,57,-22,30
Randers FC,7597,8,5,7,12,25,41,-16,22
Silkeborg IF,7597,9,6,3,13,26,44,-18,21
Lyngby,7597,10,3,10,11,28,46,-18,19
AGF Aarhus,7597,11,4,6,12,16,37,-21,18
Brondby,7598,1,22,5,3,70,30,40,71
FC Midtjylla,7598,2,22,4,4,68,33,35,70
FC Nords,7598,3,13,7,10,70,55,15,46
Copenhagen,7598,4,13,6,11,55,44,11,45
AaB,7598,5,7,11,12,33,40,-7,32
AC Horsens,7598,6,6,13,11,32,52,-20,31
Sonderjyske,7598,7,8,6,10,28,29,-1,30
Lyngby,7598,8,4,9,11,28,45,-17,21
Randers FC,7598,9,5,6,13,24,41,-17,21
AGF Aarhus,7598,10,5,6,11,17,36,-19,21
Silkeborg IF,7598,11,5,3,14,25,45,-20,18
Brondby,7599,1,20,6,4,71,36,35,66
FC Midtjylla,7599,2,18,6,6,69,44,25,60
Copenhagen,7599,3,14,4,12,58,47,11,46
FC Nords,7599,4,13,6,11,70,55,15,45
AaB,7599,5,9,12,9,39,40,-1,39
AC Horsens,7599,6,8,14,8,38,49,-11,38
Sonderjyske,7599,7,8,6,10,28,29,-1,30
Randers FC,7599,8,6,6,12,24,39,-15,24
Silkeborg IF,7599,9,5,4,13,26,45,-19,19
AGF Aarhus,7599,10,4,7,11,17,37,-20,19
Lyngby,7599,11,3,9,12,26,45,-19,18
Brondby,7600,1,21,7,2,74,30,44,70
FC Midtjylla,7600,2,18,6,6,61,38,23,60
FC Nords,7600,3,14,6,10,71,53,18,48
Copenhagen,7600,4,12,6,12,53,43,10,42
AaB,7600,5,9,12,9,37,40,-3,39
AC Horsens,7600,6,7,13,10,33,51,-18,34
Sonderjyske,7600,7,8,6,10,28,29,-1,30
Randers FC,7600,8,6,6,12,28,41,-13,24
Silkeborg IF,7600,9,5,4,13,26,45,-19,19
AGF Aarhus,7600,10,4,7,11,17,37,-20,19
Lyngby,7600,11,3,9,12,28,49,-21,18
Brondby,7601,1,21,6,3,73,34,39,69
FC Midtjylla,7601,2,20,5,5,65,38,27,65
FC Nords,7601,3,15,6,9,73,49,24,51
Copenhagen,7601,4,12,5,13,53,46,7,41
AaB,7601,5,8,11,11,38,43,-5,35
AC Horsens,7601,6,7,13,10,37,55,-18,34
Sonderjyske,7601,7,8,6,10,28,29,-1,30
Lyngby,7601,8,4,9,11,31,44,-13,21
Randers FC,7601,9,5,6,13,23,44,-21,21
Silkeborg IF,7601,10,5,4,13,25,44,-19,19
AGF Aarhus,7601,11,4,7,11,16,36,-20,19
Brondby,7602,1,22,5,3,71,29,42,71
FC Midtjylla,7602,2,21,4,5,63,34,29,67
Copenhagen,7602,3,14,4,12,58,48,10,46
FC Nords,7602,4,12,7,11,68,54,14,43
AC Horsens,7602,5,7,14,9,38,51,-13,35
AaB,7602,6,7,12,11,37,45,-8,33
Sonderjyske,7602,7,8,6,10,28,29,-1,30
Lyngby,7602,8,4,9,11,28,45,-17,21
Randers FC,7602,9,5,6,13,24,41,-17,21
Silkeborg IF,7602,10,5,4,13,25,44,-19,19
AGF Aarhus,7602,11,4,7,11,16,36,-20,19
Brondby,7603,1,21,7,2,69,28,41,70
FC Midtjylla,7603,2,19,5,6,65,39,26,62
FC Nords,7603,3,13,8,9,67,49,18,47
Copenhagen,7603,4,13,5,12,56,46,10,44
AaB,7603,5,7,14,9,37,41,-4,35
AC Horsens,7603,6,6,15,9,32,49,-17,33
Sonderjyske,7603,7,8,6,10,28,29,-1,30
Lyngby,7603,8,4,9,11,30,46,-16,21
Randers FC,7603,9,5,6,13,25,43,-18,21
AGF Aarhus,7603,10,5,6,11,17,36,-19,21
Silkeborg IF,7603,11,5,3,14,25,45,-20,18
Brondby,7604,1,20,7,3,69,32,37,67
FC Midtjylla,7604,2,19,5,6,63,38,25,62
Copenhagen,7604,3,16,4,10,59,42,17,52
FC Nords,7604,4,15,6,9,71,49,22,51
AaB,7604,5,7,11,12,36,45,-9,32
AC Horsens,7604,6,6,13,11,39,57,-18,31
Sonderjyske,7604,7,8,6,10,28,29,-1,30
Lyngby,7604,8,4,9,11,28,45,-17,21
Randers FC,7604,9,5,6,13,24,41,-17,21
Silkeborg IF,7604,10,5,4,13,26,45,-19,19
AGF Aarhus,7604,11,4,7,11,17,37,-20,19
Brondby,7605,1,20,5,5,72,35,37,65
FC Midtjylla,7605,2,20,5,5,69,38,31,65
Copenhagen,7605,3,14,6,10,61,45,16,48
FC Nords,7605,4,13,8,9,74,53,21,47
AaB,7605,5,8,12,10,35,47,-12,36
AC Horsens,7605,6,6,14,10,34,53,-19,32
Sonderjyske,7605,7,8,6,10,28,29,-1,30
Randers FC,7605,8,6,6,12,25,40,-15,24
AGF Aarhus,7605,9,5,6,11,20,39,-19,21
Lyngby,7605,10,3,9,12,27,46,-19,18
Silkeborg IF,7605,11,5,3,14,28,48,-20,18
Brondby,7606,1,20,5,5,67,32,35,65
FC Midtjylla,7606,2,20,4,6,67,38,29,64
FC Nords,7606,3,15,6,9,74,49,25,51
Copenhagen,7606,4,14,4,12,54,48,6,46
AaB,7606,5,9,12,9,41,41,0,39
AC Horsens,7606,6,6,13,11,35,56,-21,31
Sonderjyske,7606,7,8,6,10,28,29,-1,30
Lyngby,7606,8,4,9,11,27,44,-17,21
Randers FC,7606,9,5,6,13,23,40,-17,21
AGF Aarhus,7606,10,5,6,11,18,37,-19,21
Silkeborg IF,7606,11,5,3,14,26,46,-20,18
Brondby,7607,1,20,7,3,68,33,35,67
FC Midtjylla,7607,2,18,5,7,63,41,22,59
FC Nords,7607,3,15,7,8,84,52,32,52
Copenhagen,7607,4,14,4,12,54,45,9,46
AC Horsens,7607,5,8,13,9,38,53,-15,37
AaB,7607,6,6,14,10,33,42,-9,32
Sonderjyske,7607,7,8,6,10,28,29,-1,30
Lyngby,7607,8,4,9,11,28,45,-17,21
Silkeborg IF,7607,9,6,3,13,27,44,-17,21
Randers FC,7607,10,5,6,13,24,41,-17,21
AGF Aarhus,7607,11,4,6,12,16,38,-22,18
Brondby,7608,1,21,6,3,74,33,41,69
FC Midtjylla,7608,2,19,6,5,66,40,26,63
FC Nords,7608,3,15,7,8,76,53,23,52
Copenhagen,7608,4,12,5,13,57,52,5,41
AaB,7608,5,8,14,8,37,39,-2,38
Sonderjyske,7608,6,8,6,10,28,29,-1,30
AC Horsens,7608,7,6,12,12,32,51,-19,30
Silkeborg IF,7608,8,6,3,13,28,44,-16,21
Lyngby,7608,9,4,9,11,28,45,-17,21
Randers FC,7608,10,5,6,13,24,41,-17,21
AGF Aarhus,7608,11,4,6,12,16,39,-23,18
Brondby,7609,1,21,6,3,75,37,38,69
FC Midtjylla,7609,2,21,4,5,69,39,30,67
FC Nords,7609,3,14,7,9,72,51,21,49
Copenhagen,7609,4,12,6,12,55,48,7,42
AaB,7609,5,7,13,10,35,41,-6,34
AC Horsens,7609,6,7,12,11,37,53,-16,33
Sonderjyske,7609,7,8,6,10,28,29,-1,30
Randers FC,7609,8,5,7,12,25,41,-16,22
AGF Aarhus,7609,9,5,6,11,20,39,-19,21
Lyngby,7609,10,3,10,11,28,46,-18,19
Silkeborg IF,7609,11,5,3,14,28,48,-20,18
Brondby,7610,1,21,5,4,69,34,35,68
FC Midtjylla,7610,2,17,7,6,61,40,21,58
FC Nords,7610,3,12,10,8,70,50,20,46
Copenhagen,7610,4,13,7,10,57,44,13,46
AaB,7610,5,10,12,8,39,37,2,42
Sonderjyske,7610,6,8,6,10,28,29,-1,30
AC Horsens,7610,7,5,15,10,36,53,-17,30
Lyngby,7610,8,4,9,11,29,46,-17,21
Randers FC,7610,9,5,6,13,25,42,-17,21
AGF Aarhus,7610,10,5,6,11,19,36,-17,21
Silkeborg IF,7610,11,5,3,14,25,47,-22,18
Brondby,7611,1,21,6,3,75,32,43,69
FC Midtjylla,7611,2,18,4,8,61,45,16,58
FC Nords,7611,3,15,6,9,74,50,24,51
Copenhagen,7611,4,13,5,12,56,46,10,44
AC Horsens,7611,5,8,13,9,35,49,-14,37
AaB,7611,6,8,12,10,35,40,-5,36
Sonderjyske,7611,7,8,6,10,28,29,-1,30
Lyngby,7611,8,4,9,11,28,44,-16,21
Silkeborg IF,7611,9,6,3,13,27,44,-17,21
Randers FC,7611,10,5,6,13,23,41,-18,21
AGF Aarhus,7611,11,4,6,12,16,38,-22,18
FC Midtjylla,7612,1,21,5,4,70,37,33,68
Brondby,7612,2,19,5,6,65,34,31,62
FC Nords,7612,3,16,6,8,73,49,24,54
Copenhagen,7612,4,13,5,12,57,47,10,44
AaB,7612,5,9,11,10,36,41,-5,38
Sonderjyske,7612,6,8,6,10,28,29,-1,30
AC Horsens,7612,7,6,12,12,35,54,-19,30
Lyngby,7612,8,4,9,11,27,44,-17,21
Randers FC,7612,9,5,6,13,23,40,-17,21
AGF Aarhus,7612,10,5,6,11,18,36,-18,21
Silkeborg IF,7612,11,5,3,14,25,46,-21,18
FC Midtjylla,7613,1,19,6,5,66,40,26,63
Brondby,7613,2,18,6,6,65,34,31,60
Copenhagen,7613,3,15,5,10,59,43,16,50
FC Nords,7613,4,14,7,9,70,49,21,49
AaB,7613,5,9,11,10,37,42,-5,38
AC Horsens,7613,6,7,13,10,36,51,-15,34
Sonderjyske,7613,7,8,6,10,28,29,-1,30
Lyngby,7613,8,4,9,11,29,44,-15,21
Randers FC,7613,9,5,6,13,23,42,-19,21
Silkeborg IF,7613,10,5,4,13,26,45,-19,19
AGF Aarhus,7613,11,4,7,11,17,37,-20,19
Brondby,7614,1,21,6,3,76,34,42,69
FC Midtjylla,7614,2,20,4,6,70,43,27,64
FC Nords,7614,3,15,8,7,72,47,25,53
Copenhagen,7614,4,13,4,13,55,49,6,43
AaB,7614,5,8,12,10,38,44,-6,36
Sonderjyske,7614,6,8,6,10,28,29,-1,30
AC Horsens,7614,7,5,14,11,36,56,-20,29
Randers FC,7614,8,6,6,12,26,39,-13,24
AGF Aarhus,7614,9,5,6,11,18,36,-18,21
Lyngby,7614,10,3,9,12,26,47,-21,18
Silkeborg IF,7614,11,5,3,14,25,46,-21,18
Brondby,7615,1,21,5,4,75,38,37,68
FC Midtjylla,7615,2,18,4,8,61,41,20,58
FC Nords,7615,3,15,7,8,76,50,26,52
Copenhagen,7615,4,15,5,10,61,45,16,50
AaB,7615,5,8,12,10,40,44,-4,36
AC Horsens,7615,6,6,13,11,35,56,-21,31
Sonderjyske,7615,7,8,6,10,28,29,-1,30
Lyngby,7615,8,4,9,11,29,46,-17,21
Randers FC,7615,9,5,6,13,25,42,-17,21
AGF Aarhus,7615,10,5,6,11,18,37,-19,21
Silkeborg IF,7615,11,5,3,14,26,46,-20,18
Brondby,7616,1,21,5,4,69,32,37,68
FC Midtjylla,7616,2,21,4,5,65,36,29,67
Copenhagen,7616,3,14,5,11,58,45,13,47
FC Nords,7616,4,13,6,11,73,56,17,45
AC Horsens,7616,5,8,12,10,37,51,-14,36
AaB,7616,6,7,12,11,38,46,-8,33
Sonderjyske,7616,7,8,6,10,28,29,-1,30
Lyngby,7616,8,4,9,11,30,47,-17,21
Randers FC,7616,9,5,6,13,26,43,-17,21
AGF Aarhus,7616,10,5,6,11,17,36,-19,21
Silkeborg IF,7616,11,5,3,14,25,45,-20,18
Brondby,7617,1,21,6,3,73,32,41,69
FC Midtjylla,7617,2,20,4,6,70,39,31,64
Copenhagen,7617,3,15,4,11,59,43,16,49
FC Nords,7617,4,13,7,10,73,60,13,46
AaB,7617,5,8,13,9,38,41,-3,37
Sonderjyske,7617,6,8,6,10,28,29,-1,30
AC Horsens,7617,7,6,12,12,34,58,-24,30
Randers FC,7617,8,5,7,12,26,42,-16,22
Lyngby,7617,9,3,10,11,29,47,-18,19
Silkeborg IF,7617,10,5,4,13,26,45,-19,19
AGF Aarhus,7617,11,4,7,11,17,37,-20,19
Brondby,7618,1,21,6,3,73,33,40,69
FC Midtjylla,7618,2,20,4,6,69,39,30,64
FC Nords,7618,3,13,9,8,72,51,21,48
Copenhagen,7618,4,13,7,10,56,45,11,46
AaB,7618,5,7,14,9,36,43,-7,35
Sonderjyske,7618,6,8,6,10,28,29,-1,30
AC Horsens,7618,7,5,14,11,34,55,-21,29
Lyngby,7618,8,4,9,11,31,46,-15,21
Silkeborg IF,7618,9,6,3,13,27,45,-18,21
Randers FC,7618,10,5,6,13,25,44,-19,21
AGF Aarhus,7618,11,4,6,12,17,38,-21,18
Brondby,7619,1,21,5,4,74,37,37,68
FC Midtjylla,7619,2,19,5,6,66,40,26,62
Copenhagen,7619,3,15,5,10,59,43,16,50
FC Nords,7619,4,13,7,10,74,56,18,46
AC Horsens,7619,5,9,12,9,35,48,-13,39
Sonderjyske,7619,6,8,6,10,28,29,-1,30
AaB,7619,7,6,12,12,34,44,-10,30
Lyngby,7619,8,4,9,11,28,44,-16,21
Randers FC,7619,9,5,6,13,23,41,-18,21
AGF Aarhus,7619,10,5,6,11,18,37,-19,21
Silkeborg IF,7619,11,5,3,14,26,46,-20,18
FC Midtjylla,7620,1,21,4,5,69,40,29,67
Brondby,7620,2,20,5,5,70,35,35,65
FC Nords,7620,3,14,8,8,80,59,21,50
Copenhagen,7620,4,12,5,13,59,53,6,41
AaB,7620,5,9,12,9,40,40,0,39
AC Horsens,7620,6,6,14,10,33,50,-17,32
Sonderjyske,7620,7,8,6,10,28,29,-1,30
Lyngby,7620,8,4,9,11,28,45,-17,21
Silkeborg IF,7620,9,6,3,13,27,44,-17,21
Randers FC,7620,10,5,6,13,24,41,-17,21
AGF Aarhus,7620,11,4,6,12,16,38,-22,18
Brondby,7621,1,20,6,4,70,33,37,66
FC Midtjylla,7621,2,19,5,6,65,40,25,62
FC Nords,7621,3,15,6,9,78,54,24,51
Copenhagen,7621,4,15,4,11,58,46,12,49
AC Horsens,7621,5,7,14,9,37,49,-12,35
AaB,7621,6,7,11,12,37,49,-12,32
Sonderjyske,7621,7,8,6,10,28,29,-1,30
Lyngby,7621,8,4,9,11,28,45,-17,21
Silkeborg IF,7621,8,6,3,13,28,45,-17,21
Randers FC,7621,10,5,6,13,24,41,-17,21
AGF Aarhus,7621,11,4,6,12,17,39,-22,18
Brondby,7622,1,21,7,2,72,32,40,70
FC Midtjylla,7622,2,18,6,6,65,44,21,60
FC Nords,7622,3,14,8,8,75,51,24,50
Copenhagen,7622,4,12,7,11,54,46,8,43
AaB,7622,5,7,15,8,38,40,-2,36
AC Horsens,7622,6,6,13,11,35,52,-17,31
Sonderjyske,7622,7,8,6,10,28,29,-1,30
Randers FC,7622,8,5,7,12,23,39,-16,22
Lyngby,7622,9,3,10,11,26,44,-18,19
Silkeborg IF,7622,10,5,4,13,26,45,-19,19
AGF Aarhus,7622,11,4,7,11,17,37,-20,19
Brondby,7623,1,20,7,3,67,30,37,67
FC Midtjylla,7623,2,19,6,5,67,40,27,63
Copenhagen,7623,3,14,6,10,59,46,13,48
FC Nords,7623,4,13,6,11,73,58,15,45
AaB,7623,5,8,13,9,37,39,-2,37
AC Horsens,7623,6,6,14,10,36,52,-16,32
Sonderjyske,7623,7,8,6,10,28,29,-1,30
Randers FC,7623,8,5,7,12,25,41,-16,22
Lyngby,7623,9,3,10,11,28,46,-18,19
Silkeborg IF,7623,10,5,4,13,26,45,-19,19
AGF Aarhus,7623,11,4,7,11,17,37,-20,19
FC Midtjylla,7624,1,20,6,4,66,38,28,66
Brondby,7624,2,19,7,4,67,34,33,64
FC Nords,7624,3,14,7,9,75,53,22,49
Copenhagen,7624,4,14,4,12,57,45,12,46
AC Horsens,7624,5,7,14,9,37,53,-16,35
AaB,7624,6,7,12,11,36,41,-5,33
Sonderjyske,7624,7,8,6,10,28,29,-1,30
Lyngby,7624,8,4,9,11,27,44,-17,21
Randers FC,7624,9,5,6,13,23,40,-17,21
Silkeborg IF,7624,10,6,3,13,26,44,-18,21
AGF Aarhus,7624,11,4,6,12,16,37,-21,18
Brondby,7625,1,22,6,2,73,31,42,72
FC Midtjylla,7625,2,19,5,6,67,41,26,62
FC Nords,7625,3,16,6,8,79,50,29,54
Copenhagen,7625,4,13,4,13,56,48,8,43
AaB,7625,5,7,12,11,34,43,-9,33
AC Horsens,7625,6,6,13,11,36,58,-22,31
Sonderjyske,7625,7,8,6,10,28,29,-1,30
Lyngby,7625,8,4,9,11,31,45,-14,21
AGF Aarhus,7625,9,5,6,11,18,37,-19,21
Randers FC,7625,10,5,6,13,24,44,-20,21
Silkeborg IF,7625,11,5,3,14,26,46,-20,18
Brondby,7626,1,18,9,3,67,33,34,63
FC Midtjylla,7626,2,19,5,6,63,40,23,62
FC Nords,7626,3,16,7,7,76,47,29,55
Copenhagen,7626,4,14,5,11,58,46,12,47
AaB,7626,5,7,13,10,35,41,-6,34
AC Horsens,7626,6,6,13,11,37,55,-18,31
Sonderjyske,7626,7,8,6,10,28,29,-1,30
Lyngby,7626,8,4,9,11,29,44,-15,21
AGF Aarhus,7626,9,5,6,11,19,37,-18,21
Randers FC,7626,10,5,6,13,23,42,-19,21
Silkeborg IF,7626,11,5,3,14,26,47,-21,18
Brondby,7627,1,21,6,3,67,29,38,69
FC Midtjylla,7627,2,20,4,6,68,40,28,64
FC Nords,7627,3,15,6,9,74,53,21,51
Copenhagen,7627,4,15,4,11,56,40,16,49
AaB,7627,5,7,11,12,34,43,-9,32
AC Horsens,7627,6,6,13,11,34,54,-20,31
Sonderjyske,7627,7,8,6,10,28,29,-1,30
Lyngby,7627,8,4,9,11,28,44,-16,21
Silkeborg IF,7627,9,6,3,13,27,45,-18,21
Randers FC,7627,10,5,6,13,23,41,-18,21
AGF Aarhus,7627,11,4,6,12,17,38,-21,18
Brondby,7628,1,23,5,2,74,28,46,74
FC Midtjylla,7628,2,21,4,5,70,39,31,67
FC Nords,7628,3,13,8,9,72,56,16,47
Copenhagen,7628,4,13,6,11,56,42,14,45
AaB,7628,5,7,12,11,36,44,-8,33
Sonderjyske,7628,6,8,6,10,28,29,-1,30
AC Horsens,7628,7,5,13,12,33,58,-25,28
Randers FC,7628,8,5,7,12,23,39,-16,22
Silkeborg IF,7628,9,6,3,13,27,44,-17,21
Lyngby,7628,10,3,10,11,26,44,-18,19
AGF Aarhus,7628,11,4,6,12,16,38,-22,18
Brondby,7629,1,19,8,3,72,37,35,65
FC Midtjylla,7629,2,19,7,4,66,39,27,64
FC Nords,7629,3,15,8,7,85,51,34,53
Copenhagen,7629,4,14,6,10,61,46,15,48
AaB,7629,5,7,11,12,40,49,-9,32
Sonderjyske,7629,6,8,6,10,28,29,-1,30
AC Horsens,7629,7,6,12,12,37,65,-28,30
Randers FC,7629,8,6,6,12,26,39,-13,24
Silkeborg IF,7629,9,6,3,13,28,44,-16,21
Lyngby,7629,10,3,9,12,26,47,-21,18
AGF Aarhus,7629,11,4,6,12,16,39,-23,18
Brondby,7630,1,21,6,3,76,34,42,69
FC Midtjylla,7630,2,20,5,5,67,38,29,65
FC Nords,7630,3,15,6,9,72,51,21,51
Copenhagen,7630,4,15,5,10,59,43,16,50
AaB,7630,5,7,11,12,35,45,-10,32
Sonderjyske,7630,6,8,6,10,28,29,-1,30
AC Horsens,7630,7,5,13,12,32,56,-24,28
Randers FC,7630,8,6,6,12,24,39,-15,24
Silkeborg IF,7630,9,5,4,13,25,44,-19,19
AGF Aarhus,7630,10,4,7,11,16,36,-20,19
Lyngby,7630,11,3,9,12,26,45,-19,18
Brondby,7631,1,21,5,4,72,33,39,68
FC Midtjylla,7631,2,20,5,5,70,40,30,65
Copenhagen,7631,3,15,5,10,59,41,18,50
FC Nords,7631,4,13,7,10,72,58,14,46
AaB,7631,5,7,12,11,38,46,-8,33
AC Horsens,7631,6,6,14,10,35,54,-19,32
Sonderjyske,7631,7,8,6,10,28,29,-1,30
Randers FC,7631,8,6,6,12,24,39,-15,24
Silkeborg IF,7631,9,6,3,13,26,44,-18,21
Lyngby,7631,10,3,9,12,26,45,-19,18
AGF Aarhus,7631,11,4,6,12,16,37,-21,18
Brondby,7632,1,20,6,4,71,35,36,66
FC Midtjylla,7632,2,20,6,4,67,36,31,66
FC Nords,7632,3,13,7,10,76,58,18,46
Copenhagen,7632,4,12,7,11,57,46,11,43
AaB,7632,5,9,12,9,41,45,-4,39
AC Horsens,7632,6,6,14,10,37,55,-18,32
Sonderjyske,7632,7,8,6,10,28,29,-1,30
Lyngby,7632,8,4,9,11,28,44,-16,21
Randers FC,7632,9,5,6,13,23,41,-18,21
Silkeborg IF,7632,10,5,4,13,25,44,-19,19
AGF Aarhus,7632,11,4,7,11,16,36,-20,19
Brondby,7633,1,22,6,2,74,32,42,72
FC Midtjylla,7633,2,20,4,6,66,39,27,64
FC Nords,7633,3,14,8,8,77,55,22,50
Copenhagen,7633,4,14,4,12,61,47,14,46
AC Horsens,7633,5,7,13,10,35,54,-19,34
Sonderjyske,7633,6,8,6,10,28,29,-1,30
AaB,7633,7,6,11,13,36,48,-12,29
Randers FC,7633,8,6,6,12,25,39,-14,24
Silkeborg IF,7633,9,6,3,13,28,46,-18,21
Lyngby,7633,10,3,9,12,26,46,-20,18
AGF Aarhus,7633,11,4,6,12,18,39,-21,18
Brondby,7634,1,21,7,2,73,33,40,70
FC Midtjylla,7634,2,19,5,6,69,44,25,62
FC Nords,7634,3,14,8,8,77,56,21,50
Copenhagen,7634,4,13,6,11,59,47,12,45
AaB,7634,5,9,11,10,42,45,-3,38
Sonderjyske,7634,6,8,6,10,28,29,-1,30
AC Horsens,7634,7,5,13,12,31,52,-21,28
Lyngby,7634,8,4,9,11,27,44,-17,21
Randers FC,7634,9,5,6,13,23,40,-17,21
AGF Aarhus,7634,10,5,6,11,18,36,-18,21
Silkeborg IF,7634,11,5,3,14,25,46,-21,18
Brondby,7635,1,19,7,4,67,32,35,64
FC Midtjylla,7635,2,19,5,6,66,39,27,62
Copenhagen,7635,3,16,5,9,59,41,18,53
FC Nords,7635,4,14,8,8,75,48,27,50
AaB,7635,5,8,11,11,35,47,-12,35
Sonderjyske,7635,6,8,6,10,28,29,-1,30
AC Horsens,7635,7,5,14,11,32,53,-21,29
Randers FC,7635,8,5,7,12,23,39,-16,22
AGF Aarhus,7635,9,5,6,11,18,37,-19,21
Lyngby,7635,10,3,10,11,26,44,-18,19
Silkeborg IF,7635,11,5,3,14,26,46,-20,18
Brondby,7636,1,21,6,3,71,35,36,69
FC Midtjylla,7636,2,17,6,7,59,40,19,57
Copenhagen,7636,3,15,5,10,60,42,18,50
FC Nords,7636,4,14,7,9,76,54,22,49
AC Horsens,7636,5,7,13,10,35,50,-15,34
AaB,7636,6,6,15,9,34,40,-6,33
Sonderjyske,7636,7,8,6,10,28,29,-1,30
Randers FC,7636,8,5,7,12,25,41,-16,22
Lyngby,7636,9,3,10,11,28,46,-18,19
Silkeborg IF,7636,10,5,4,13,25,44,-19,19
AGF Aarhus,7636,11,4,7,11,16,36,-20,19
Brondby,7637,1,20,7,3,71,33,38,67
FC Midtjylla,7637,2,20,4,6,69,41,28,64
FC Nords,7637,3,15,6,9,73,53,20,51
Copenhagen,7637,4,13,5,12,58,47,11,44
AC Horsens,7637,5,8,13,9,35,47,-12,37
AaB,7637,6,7,11,12,34,45,-11,32
Sonderjyske,7637,7,8,6,10,28,29,-1,30
Lyngby,7637,8,4,9,11,28,45,-17,21
Randers FC,7637,9,5,6,13,24,41,-17,21
Silkeborg IF,7637,10,5,4,13,26,45,-19,19
AGF Aarhus,7637,11,4,7,11,17,37,-20,19
FC Midtjylla,7638,1,21,4,5,68,35,33,67
Brondby,7638,2,20,6,4,70,35,35,66
FC Nords,7638,3,15,6,9,74,53,21,51
Copenhagen,7638,4,13,5,12,58,50,8,44
AaB,7638,5,8,11,11,38,44,-6,35
AC Horsens,7638,6,7,12,11,40,57,-17,33
Sonderjyske,7638,7,8,6,10,28,29,-1,30
Lyngby,7638,8,4,9,11,29,46,-17,21
Randers FC,7638,9,5,6,13,25,42,-17,21
Silkeborg IF,7638,10,5,4,13,27,46,-19,19
AGF Aarhus,7638,11,4,7,11,18,38,-20,19
FC Midtjylla,7639,1,21,4,5,68,38,30,67
Brondby,7639,2,19,6,5,67,33,34,63
FC Nords,7639,3,14,7,9,77,53,24,49
Copenhagen,7639,4,13,4,13,58,51,7,43
AaB,7639,5,9,12,9,42,46,-4,39
AC Horsens,7639,6,7,13,10,36,53,-17,34
Sonderjyske,7639,7,8,6,10,28,29,-1,30
Randers FC,7639,8,6,6,12,26,39,-13,24
Silkeborg IF,7639,9,6,3,13,26,44,-18,21
Lyngby,7639,10,3,9,12,26,47,-21,18
AGF Aarhus,7639,11,4,6,12,16,37,-21,18
FC Midtjylla,7640,1,20,5,5,66,39,27,65
Brondby,7640,2,19,6,5,70,40,30,63
FC Nords,7640,3,16,6,8,77,49,28,54
Copenhagen,7640,4,12,6,12,54,46,8,42
AaB,7640,5,8,12,10,38,43,-5,36
AC Horsens,7640,6,7,13,10,34,48,-14,34
Sonderjyske,7640,7,8,6,10,28,29,-1,30
Lyngby,7640,8,4,9,11,27,44,-17,21
Randers FC,7640,9,5,6,13,23,40,-17,21
Silkeborg IF,7640,10,6,3,13,26,44,-18,21
AGF Aarhus,7640,11,4,6,12,16,37,-21,18
Brondby,7641,1,20,6,4,69,34,35,66
FC Midtjylla,7641,2,20,6,4,67,38,29,66
FC Nords,7641,3,14,7,9,69,50,19,49
Copenhagen,7641,4,13,5,12,55,44,11,44
AaB,7641,5,8,11,11,35,41,-6,35
AC Horsens,7641,6,7,13,10,35,49,-14,34
Sonderjyske,7641,7,8,6,10,28,29,-1,30
Lyngby,7641,8,4,9,11,31,45,-14,21
Randers FC,7641,9,5,6,13,24,44,-20,21
Silkeborg IF,7641,10,5,4,13,25,44,-19,19
AGF Aarhus,7641,11,4,7,11,16,36,-20,19
Brondby,7642,1,21,6,3,68,31,37,69
FC Midtjylla,7642,2,20,4,6,67,43,24,64
FC Nords,7642,3,14,7,9,73,53,20,49
Copenhagen,7642,4,13,4,13,57,49,8,43
AC Horsens,7642,5,8,12,10,41,51,-10,36
AaB,7642,6,8,11,11,38,43,-5,35
Sonderjyske,7642,7,8,6,10,28,29,-1,30
Lyngby,7642,8,4,9,11,31,46,-15,21
Silkeborg IF,7642,9,6,3,13,28,45,-17,21
Randers FC,7642,10,5,6,13,25,44,-19,21
AGF Aarhus,7642,11,4,6,12,17,39,-22,18
Brondby,7643,1,22,5,3,75,33,42,71
FC Midtjylla,7643,2,19,5,6,64,41,23,62
FC Nords,7643,3,13,8,9,74,54,20,47
Copenhagen,7643,4,12,5,13,54,50,4,41
AaB,7643,5,9,12,9,41,42,-1,39
AC Horsens,7643,6,6,15,9,36,50,-14,33
Sonderjyske,7643,7,8,6,10,28,29,-1,30
Randers FC,7643,8,6,6,12,25,39,-14,24
AGF Aarhus,7643,9,5,6,11,18,37,-19,21
Lyngby,7643,10,3,9,12,26,46,-20,18
Silkeborg IF,7643,10,5,3,14,26,46,-20,18
Brondby,7644,1,20,5,5,67,34,33,65
FC Midtjylla,7644,2,19,6,5,66,38,28,63
Copenhagen,7644,3,14,6,10,59,47,12,48
FC Nords,7644,4,13,8,9,75,57,18,47
AC Horsens,7644,5,8,13,9,38,50,-12,37
AaB,7644,6,7,12,11,37,42,-5,33
Sonderjyske,7644,7,8,6,10,28,29,-1,30
Randers FC,7644,8,6,6,12,24,39,-15,24
Silkeborg IF,7644,9,6,3,13,26,44,-18,21
Lyngby,7644,10,3,9,12,26,45,-19,18
AGF Aarhus,7644,11,4,6,12,16,37,-21,18
Brondby,7645,1,21,5,4,71,33,38,68
FC Midtjylla,7645,2,20,4,6,68,46,22,64
FC Nords,7645,3,15,6,9,78,50,28,51
Copenhagen,7645,4,13,5,12,56,49,7,44
AaB,7645,5,8,12,10,40,43,-3,36
AC Horsens,7645,6,7,12,11,34,52,-18,33
Sonderjyske,7645,7,8,6,10,28,29,-1,30
Silkeborg IF,7645,8,6,3,13,30,44,-14,21
Lyngby,7645,9,4,9,11,27,44,-17,21
Randers FC,7645,10,5,6,13,23,40,-17,21
AGF Aarhus,7645,11,4,6,12,16,41,-25,18
Brondby,7646,1,20,7,3,71,31,40,67
FC Midtjylla,7646,2,19,4,7,64,40,24,61
FC Nords,7646,3,15,8,7,74,47,27,53
Copenhagen,7646,4,15,4,11,59,44,15,49
AC Horsens,7646,5,7,13,10,36,54,-18,34
Sonderjyske,7646,6,8,6,10,28,29,-1,30
AaB,7646,7,6,12,12,32,46,-14,30
Lyngby,7646,8,4,9,11,28,45,-17,21
Silkeborg IF,7646,9,6,3,13,27,44,-17,21
Randers FC,7646,10,5,6,13,24,41,-17,21
AGF Aarhus,7646,11,4,6,12,16,38,-22,18
Brondby,7647,1,22,5,3,72,30,42,71
FC Midtjylla,7647,2,21,4,5,69,35,34,67
FC Nords,7647,3,14,7,9,72,51,21,49
Copenhagen,7647,4,13,5,12,56,47,9,44
AC Horsens,7647,5,7,13,10,33,52,-19,34
Sonderjyske,7647,6,8,6,10,28,29,-1,30
AaB,7647,7,6,12,12,32,45,-13,30
Lyngby,7647,8,4,9,11,28,45,-17,21
Randers FC,7647,9,5,6,13,24,41,-17,21
Silkeborg IF,7647,10,5,4,13,25,44,-19,19
AGF Aarhus,7647,11,4,7,11,16,36,-20,19
Brondby,7648,1,21,7,2,69,29,40,70
FC Midtjylla,7648,2,20,5,5,67,38,29,65
FC Nords,7648,3,14,7,9,72,52,20,49
Copenhagen,7648,4,14,5,11,60,47,13,47
AC Horsens,7648,5,7,12,11,34,52,-18,33
Sonderjyske,7648,6,8,6,10,28,29,-1,30
AaB,7648,7,6,12,12,37,47,-10,30
Randers FC,7648,8,6,6,12,24,39,-15,24
AGF Aarhus,7648,9,5,6,11,19,36,-17,21
Lyngby,7648,10,3,9,12,26,45,-19,18
Silkeborg IF,7648,11,5,3,14,25,47,-22,18
FC Midtjylla,7649,1,21,4,5,69,39,30,67
Brondby,7649,2,20,6,4,69,36,33,66
FC Nords,7649,3,14,7,9,79,54,25,49
Copenhagen,7649,4,14,6,10,58,43,15,48
AaB,7649,5,7,12,11,35,43,-8,33
AC Horsens,7649,6,6,13,11,32,53,-21,31
Sonderjyske,7649,7,8,6,10,28,29,-1,30
Randers FC,7649,8,6,6,12,24,39,-15,24
AGF Aarhus,7649,9,5,6,11,17,36,-19,21
Lyngby,7649,10,3,9,12,26,45,-19,18
Silkeborg IF,7649,11,5,3,14,25,45,-20,18
FC Midtjylla,7650,1,22,4,4,75,36,39,70
Brondby,7650,2,21,5,4,70,33,37,68
FC Nords,7650,3,14,7,9,72,52,20,49
Copenhagen,7650,4,12,5,13,54,52,2,41
AC Horsens,7650,5,7,14,9,37,52,-15,35
AaB,7650,6,7,11,12,42,51,-9,32
Sonderjyske,7650,7,8,6,10,28,29,-1,30
Lyngby,7650,8,4,9,11,28,45,-17,21
Randers FC,7650,9,5,6,13,24,41,-17,21
Silkeborg IF,7650,10,5,4,13,26,45,-19,19
AGF Aarhus,7650,11,4,7,11,17,37,-20,19
Brondby,7651,1,21,6,3,70,30,40,69
FC Midtjylla,7651,2,20,5,5,65,39,26,65
FC Nords,7651,3,15,6,9,73,51,22,51
Copenhagen,7651,4,13,6,11,56,44,12,45
AaB,7651,5,6,14,10,32,39,-7,32
Sonderjyske,7651,6,8,6,10,28,29,-1,30
AC Horsens,7651,7,5,15,10,31,50,-19,30
Randers FC,7651,8,5,7,12,24,40,-16,22
Silkeborg IF,7651,9,6,3,13,27,44,-17,21
Lyngby,7651,10,3,10,11,27,45,-18,19
AGF Aarhus,7651,11,4,6,12,16,38,-22,18
Brondby,7652,1,21,7,2,72,30,42,70
FC Midtjylla,7652,2,19,5,6,69,42,27,62
FC Nords,7652,3,13,9,8,70,51,19,48
Copenhagen,7652,4,13,7,10,52,43,9,46
AaB,7652,5,7,13,10,39,44,-5,34
Sonderjyske,7652,6,8,6,10,28,29,-1,30
AC Horsens,7652,7,5,15,10,34,52,-18,30
Randers FC,7652,8,5,7,12,24,40,-16,22
AGF Aarhus,7652,9,5,6,11,20,37,-17,21
Lyngby,7652,10,3,10,11,27,45,-18,19
Silkeborg IF,7652,11,5,3,14,26,48,-22,18
Brondby,7653,1,21,5,4,71,30,41,68
FC Midtjylla,7653,2,20,5,5,64,38,26,65
FC Nords,7653,3,14,6,10,71,55,16,48
Copenhagen,7653,4,14,5,11,60,47,13,47
AC Horsens,7653,5,7,14,9,36,48,-12,35
AaB,7653,6,7,11,12,35,45,-10,32
Sonderjyske,7653,7,8,6,10,28,29,-1,30
Randers FC,7653,8,6,6,12,26,40,-14,24
AGF Aarhus,7653,9,5,6,11,17,36,-19,21
Lyngby,7653,10,3,9,12,27,47,-20,18
Silkeborg IF,7653,11,5,3,14,25,45,-20,18
Brondby,7654,1,21,7,2,75,33,42,70
FC Midtjylla,7654,2,19,7,4,60,34,26,64
Copenhagen,7654,3,14,6,10,58,43,15,48
FC Nords,7654,4,13,6,11,69,53,16,45
AaB,7654,5,7,12,11,38,46,-8,33
AC Horsens,7654,6,6,14,10,35,52,-17,32
Sonderjyske,7654,7,8,6,10,28,29,-1,30
Randers FC,7654,8,6,6,12,26,41,-15,24
AGF Aarhus,7654,9,5,6,11,17,36,-19,21
Lyngby,7654,10,3,9,12,28,47,-19,18
Silkeborg IF,7654,11,5,3,14,25,45,-20,18
Brondby,7655,1,20,7,3,67,31,36,67
FC Midtjylla,7655,2,19,5,6,66,42,24,62
Copenhagen,7655,3,15,4,11,60,46,14,49
FC Nords,7655,4,14,6,10,75,55,20,48
AaB,7655,5,7,13,10,36,43,-7,34
AC Horsens,7655,6,7,13,10,37,50,-13,34
Sonderjyske,7655,7,8,6,10,28,29,-1,30
Randers FC,7655,8,6,6,12,24,39,-15,24
Silkeborg IF,7655,9,6,3,13,26,44,-18,21
Lyngby,7655,10,3,9,12,26,45,-19,18
AGF Aarhus,7655,11,4,6,12,16,37,-21,18
Brondby,7656,1,20,6,4,66,31,35,66
FC Midtjylla,7656,2,18,8,4,64,39,25,62
Copenhagen,7656,3,16,5,9,61,39,22,53
FC Nords,7656,4,13,8,9,71,53,18,47
AC Horsens,7656,5,7,12,11,37,54,-17,33
AaB,7656,6,6,13,11,35,44,-9,31
Sonderjyske,7656,7,8,6,10,28,29,-1,30
Lyngby,7656,8,4,9,11,29,44,-15,21
Randers FC,7656,9,5,6,13,23,42,-19,21
Silkeborg IF,7656,10,5,4,13,27,46,-19,19
AGF Aarhus,7656,11,4,7,11,18,38,-20,19
Brondby,7657,1,21,6,3,72,33,39,69
FC Midtjylla,7657,2,19,4,7,66,44,22,61
Copenhagen,7657,3,17,4,9,63,42,21,55
FC Nords,7657,4,15,7,8,74,49,25,52
Sonderjyske,7657,5,8,6,10,28,29,-1,30
AaB,7657,6,6,12,12,37,48,-11,30
AC Horsens,7657,7,5,13,12,37,59,-22,28
Randers FC,7657,8,6,6,12,25,40,-15,24
Silkeborg IF,7657,9,6,3,13,27,45,-18,21
Lyngby,7657,10,3,9,12,27,46,-19,18
AGF Aarhus,7657,11,4,6,12,17,38,-21,18
Brondby,7658,1,22,6,2,71,30,41,72
FC Midtjylla,7658,2,20,4,6,65,36,29,64
FC Nords,7658,3,15,6,9,74,51,23,51
Copenhagen,7658,4,15,5,10,58,43,15,50
Sonderjyske,7658,5,8,6,10,28,29,-1,30
AC Horsens,7658,6,6,12,12,33,56,-23,30
AaB,7658,7,6,11,13,37,48,-11,29
Randers FC,7658,8,6,6,12,26,41,-15,24
Silkeborg IF,7658,9,6,3,13,26,44,-18,21
Lyngby,7658,10,3,9,12,28,47,-19,18
AGF Aarhus,7658,11,4,6,12,16,37,-21,18
Brondby,7659,1,20,6,4,71,38,33,66
FC Midtjylla,7659,2,18,6,6,65,43,22,60
FC Nords,7659,3,15,8,7,73,47,26,53
Copenhagen,7659,4,13,5,12,56,45,11,44
AaB,7659,5,8,12,10,36,39,-3,36
AC Horsens,7659,6,6,15,9,37,52,-15,33
Sonderjyske,7659,7,8,6,10,28,29,-1,30
Randers FC,7659,8,6,6,12,24,39,-15,24
Silkeborg IF,7659,9,6,3,13,28,45,-17,21
Lyngby,7659,10,3,9,12,26,45,-19,18
AGF Aarhus,7659,11,4,6,12,17,39,-22,18
FC Midtjylla,7660,1,21,5,4,69,38,31,68
Brondby,7660,2,19,7,4,67,33,34,64
FC Nords,7660,3,15,8,7,75,50,25,53
Copenhagen,7660,4,14,5,11,59,46,13,47
AaB,7660,5,7,11,12,32,41,-9,32
Sonderjyske,7660,6,8,6,10,28,29,-1,30
AC Horsens,7660,7,6,12,12,33,53,-20,30
Lyngby,7660,8,4,9,11,28,44,-16,21
Randers FC,7660,9,5,6,13,23,41,-18,21
AGF Aarhus,7660,10,5,6,11,18,37,-19,21
Silkeborg IF,7660,11,5,3,14,26,46,-20,18
Brondby,7661,1,19,8,3,69,33,36,65
FC Midtjylla,7661,2,19,5,6,69,44,25,62
FC Nords,7661,3,14,7,9,79,51,28,49
Copenhagen,7661,4,12,7,11,55,50,5,43
AaB,7661,5,8,14,8,39,41,-2,38
AC Horsens,7661,6,6,15,9,34,52,-18,33
Sonderjyske,7661,7,8,6,10,28,29,-1,30
Lyngby,7661,8,4,9,11,29,45,-16,21
Silkeborg IF,7661,9,6,3,13,26,44,-18,21
Randers FC,7661,10,5,6,13,24,42,-18,21
AGF Aarhus,7661,11,4,6,12,16,37,-21,18
Brondby,7662,1,21,5,4,71,35,36,68
FC Midtjylla,7662,2,21,5,4,69,34,35,68
FC Nords,7662,3,15,6,9,70,50,20,51
Copenhagen,7662,4,13,5,12,55,47,8,44
AaB,7662,5,8,11,11,40,45,-5,35
Sonderjyske,7662,6,8,6,10,28,29,-1,30
AC Horsens,7662,7,6,12,12,35,55,-20,30
Randers FC,7662,8,6,6,12,26,40,-14,24
Silkeborg IF,7662,9,6,3,13,28,46,-18,21
Lyngby,7662,10,3,9,12,27,47,-20,18
AGF Aarhus,7662,11,4,6,12,18,39,-21,18
Brondby,7663,1,20,7,3,69,32,37,67
FC Midtjylla,7663,2,19,7,4,67,40,27,64
FC Nords,7663,3,13,8,9,70,51,19,47
Copenhagen,7663,4,13,6,11,56,44,12,45
AC Horsens,7663,5,7,14,9,35,50,-15,35
AaB,7663,6,7,12,11,41,47,-6,33
Sonderjyske,7663,7,8,6,10,28,29,-1,30
Lyngby,7663,8,4,9,11,30,45,-15,21
Randers FC,7663,9,5,6,13,24,43,-19,21
AGF Aarhus,7663,10,5,6,11,19,38,-19,21
Silkeborg IF,7663,11,5,3,14,27,47,-20,18
Brondby,7664,1,21,7,2,73,31,42,70
FC Midtjylla,7664,2,18,5,7,66,41,25,59
FC Nords,7664,3,14,7,9,71,54,17,49
Copenhagen,7664,4,13,6,11,59,48,11,45
AaB,7664,5,7,14,9,38,41,-3,35
AC Horsens,7664,6,6,15,9,36,54,-18,33
Sonderjyske,7664,7,8,6,10,28,29,-1,30
Randers FC,7664,8,6,6,12,25,39,-14,24
Silkeborg IF,7664,9,5,4,13,27,46,-19,19
AGF Aarhus,7664,10,4,7,11,18,38,-20,19
Lyngby,7664,11,3,9,12,26,46,-20,18
Brondby,7665,1,21,6,3,73,32,41,69
FC Midtjylla,7665,2,20,5,5,70,44,26,65
FC Nords,7665,3,16,6,8,76,51,25,54
Copenhagen,7665,4,12,5,13,60,51,9,41
AaB,7665,5,7,12,11,34,43,-9,33
AC Horsens,7665,6,6,14,10,37,55,-18,32
Sonderjyske,7665,7,8,6,10,28,29,-1,30
Lyngby,7665,8,4,9,11,27,44,-17,21
Randers FC,7665,9,5,6,13,23,40,-17,21
AGF Aarhus,7665,10,5,6,11,18,37,-19,21
Silkeborg IF,7665,11,5,3,14,26,46,-20,18
Brondby,7666,1,21,6,3,71,35,36,69
FC Midtjylla,7666,2,18,5,7,59,40,19,59
FC Nords,7666,3,15,7,8,77,49,28,52
Copenhagen,7666,4,16,4,10,61,43,18,52
AaB,7666,5,7,12,11,35,43,-8,33
Sonderjyske,7666,6,8,6,10,28,29,-1,30
AC Horsens,7666,7,6,12,12,35,54,-19,30
Lyngby,7666,8,4,9,11,30,44,-14,21
AGF Aarhus,7666,9,5,6,11,17,36,-19,21
Randers FC,7666,10,5,6,13,23,43,-20,21
Silkeborg IF,7666,11,5,3,14,25,45,-20,18
Brondby,7667,1,21,6,3,76,38,38,69
FC Midtjylla,7667,2,20,6,4,71,41,30,66
Copenhagen,7667,3,14,6,10,61,46,15,48
FC Nords,7667,4,13,8,9,69,49,20,47
AaB,7667,5,7,12,11,37,46,-9,33
Sonderjyske,7667,6,8,6,10,28,29,-1,30
AC Horsens,7667,7,6,12,12,34,54,-20,30
Randers FC,7667,8,6,6,12,24,39,-15,24
Silkeborg IF,7667,9,6,3,13,27,44,-17,21
Lyngby,7667,10,3,9,12,26,45,-19,18
AGF Aarhus,7667,11,4,6,12,16,38,-22,18
Brondby,7668,1,21,5,4,69,33,36,68
FC Midtjylla,7668,2,18,7,5,63,40,23,61
FC Nords,7668,3,15,7,8,77,52,25,52
Copenhagen,7668,4,13,5,12,55,47,8,44
AaB,7668,5,8,12,10,38,41,-3,36
AC Horsens,7668,6,7,12,11,37,52,-15,33
Sonderjyske,7668,7,8,6,10,28,29,-1,30
Randers FC,7668,8,6,6,12,25,40,-15,24
AGF Aarhus,7668,9,5,6,11,18,36,-18,21
Lyngby,7668,10,3,9,12,27,46,-19,18
Silkeborg IF,7668,11,5,3,14,25,46,-21,18
Brondby,7669,1,23,5,2,74,27,47,74
FC Midtjylla,7669,2,18,5,7,62,41,21,59
FC Nords,7669,3,14,8,8,73,48,25,50
Copenhagen,7669,4,12,6,12,53,47,6,42
AC Horsens,7669,5,7,14,9,36,49,-13,35
AaB,7669,6,7,12,11,34,46,-12,33
Sonderjyske,7669,7,8,6,10,28,29,-1,30
Silkeborg IF,7669,8,6,3,13,31,44,-13,21
Lyngby,7669,9,4,9,11,29,45,-16,21
Randers FC,7669,10,5,6,13,24,42,-18,21
AGF Aarhus,7669,11,4,6,12,16,42,-26,18
Brondby,7670,1,21,6,3,78,39,39,69
FC Midtjylla,7670,2,19,5,6,69,46,23,62
Copenhagen,7670,3,16,4,10,62,45,17,52
FC Nords,7670,4,13,6,11,70,55,15,45
AaB,7670,5,8,11,11,39,45,-6,35
AC Horsens,7670,6,7,12,11,39,53,-14,33
Sonderjyske,7670,7,8,6,10,28,29,-1,30
Silkeborg IF,7670,8,6,3,13,29,46,-17,21
Lyngby,7670,9,4,9,11,27,44,-17,21
Randers FC,7670,10,5,6,13,23,40,-17,21
AGF Aarhus,7670,11,4,6,12,18,40,-22,18
Brondby,7671,1,20,5,5,68,37,31,65
FC Midtjylla,7671,2,20,4,6,68,43,25,64
FC Nords,7671,3,16,6,8,74,47,27,54
Copenhagen,7671,4,14,6,10,60,44,16,48
AC Horsens,7671,5,7,13,10,37,53,-16,34
Sonderjyske,7671,6,8,6,10,28,29,-1,30
AaB,7671,7,6,12,12,36,45,-9,30
Lyngby,7671,8,4,9,11,27,44,-17,21
Randers FC,7671,9,5,6,13,23,40,-17,21
Silkeborg IF,7671,10,6,3,13,27,45,-18,21
AGF Aarhus,7671,11,4,6,12,17,38,-21,18
FC Midtjylla,7672,1,21,5,4,68,35,33,68
Brondby,7672,2,20,7,3,64,28,36,67
FC Nords,7672,3,13,8,9,73,54,19,47
Copenhagen,7672,4,13,6,11,58,48,10,45
AaB,7672,5,7,12,11,38,46,-8,33
AC Horsens,7672,6,6,14,10,34,50,-16,32
Sonderjyske,7672,7,8,6,10,28,29,-1,30
Lyngby,7672,8,4,9,11,30,47,-17,21
Silkeborg IF,7672,9,6,3,13,27,44,-17,21
Randers FC,7672,10,5,6,13,26,43,-17,21
AGF Aarhus,7672,11,4,6,12,16,38,-22,18
Brondby,7673,1,20,6,4,68,33,35,66
FC Midtjylla,7673,2,20,4,6,63,38,25,64
FC Nords,7673,3,15,6,9,78,53,25,51
Copenhagen,7673,4,15,4,11,57,43,14,49
AC Horsens,7673,5,7,13,10,38,53,-15,34
AaB,7673,6,7,11,12,33,43,-10,32
Sonderjyske,7673,7,8,6,10,28,29,-1,30
Lyngby,7673,8,4,9,11,27,44,-17,21
Randers FC,7673,9,5,6,13,23,40,-17,21
Silkeborg IF,7673,10,6,3,13,27,45,-18,21
AGF Aarhus,7673,11,4,6,12,17,38,-21,18
Brondby,7674,1,22,5,3,71,32,39,71
FC Midtjylla,7674,2,20,4,6,66,40,26,64
FC Nords,7674,3,14,8,8,77,52,25,50
Copenhagen,7674,4,14,5,11,60,48,12,47
AaB,7674,5,7,13,10,37,43,-6,34
Sonderjyske,7674,6,8,6,10,28,29,-1,30
AC Horsens,7674,7,5,13,12,37,59,-22,28
Lyngby,7674,8,4,9,11,28,44,-16,21
Silkeborg IF,7674,9,6,3,13,27,45,-18,21
Randers FC,7674,10,5,6,13,23,41,-18,21
AGF Aarhus,7674,11,4,6,12,17,38,-21,18
Brondby,7675,1,20,7,3,73,34,39,67
FC Midtjylla,7675,2,20,5,5,73,42,31,65
FC Nords,7675,3,14,7,9,74,55,19,49
Copenhagen,7675,4,14,6,10,57,45,12,48
AaB,7675,5,6,14,10,35,41,-6,32
AC Horsens,7675,6,6,13,11,34,55,-21,31
Sonderjyske,7675,7,8,6,10,28,29,-1,30
Lyngby,7675,8,4,9,11,28,45,-17,21
Randers FC,7675,9,5,6,13,24,41,-17,21
AGF Aarhus,7675,10,5,6,11,18,37,-19,21
Silkeborg IF,7675,11,5,3,14,26,46,-20,18
Brondby,7676,1,21,6,3,74,36,38,69
FC Midtjylla,7676,2,20,5,5,64,36,28,65
FC Nords,7676,3,14,7,9,77,52,25,49
Copenhagen,7676,4,12,5,13,54,50,4,41
AaB,7676,5,8,11,11,39,48,-9,35
AC Horsens,7676,6,7,14,9,39,51,-12,35
Sonderjyske,7676,7,8,6,10,28,29,-1,30
Randers FC,7676,8,6,6,12,24,39,-15,24
Silkeborg IF,7676,9,6,3,13,27,45,-18,21
Lyngby,7676,10,3,9,12,26,45,-19,18
AGF Aarhus,7676,11,4,6,12,17,38,-21,18
Brondby,7677,1,20,6,4,71,32,39,66
FC Midtjylla,7677,2,20,5,5,67,39,28,65
Copenhagen,7677,3,16,4,10,62,45,17,52
FC Nords,7677,4,14,6,10,73,55,18,48
AC Horsens,7677,5,7,12,11,40,53,-13,33
AaB,7677,6,7,11,12,35,50,-15,32
Sonderjyske,7677,7,8,6,10,28,29,-1,30
Randers FC,7677,8,5,7,12,23,39,-16,22
AGF Aarhus,7677,9,5,6,11,18,37,-19,21
Lyngby,7677,10,3,10,11,26,44,-18,19
Silkeborg IF,7677,11,5,3,14,26,46,-20,18
FC Midtjylla,7678,1,19,5,6,69,44,25,62
Brondby,7678,2,18,7,5,66,34,32,61
Copenhagen,7678,3,15,5,10,61,47,14,50
FC Nords,7678,4,14,7,9,77,54,23,49
AC Horsens,7678,5,8,13,9,38,52,-14,37
AaB,7678,6,8,11,11,39,45,-6,35
Sonderjyske,7678,7,8,6,10,28,29,-1,30
Randers FC,7678,8,6,6,12,26,41,-15,24
Silkeborg IF,7678,9,6,3,13,26,44,-18,21
Lyngby,7678,10,3,9,12,28,47,-19,18
AGF Aarhus,7678,11,4,6,12,16,37,-21,18
Brondby,7679,1,22,6,2,75,30,45,72
FC Midtjylla,7679,2,20,4,6,65,38,27,64
Copenhagen,7679,3,14,5,11,56,45,11,47
FC Nords,7679,4,13,6,11,71,53,18,45
AC Horsens,7679,5,7,13,10,37,53,-16,34
AaB,7679,6,7,12,11,38,49,-11,33
Sonderjyske,7679,7,8,6,10,28,29,-1,30
Randers FC,7679,8,6,6,12,25,39,-14,24
Silkeborg IF,7679,9,6,3,13,28,44,-16,21
Lyngby,7679,10,3,9,12,26,46,-20,18
AGF Aarhus,7679,11,4,6,12,16,39,-23,18
Brondby,7680,1,21,6,3,74,30,44,69
FC Midtjylla,7680,2,18,7,5,69,41,28,61
FC Nords,7680,3,13,9,8,70,52,18,48
Copenhagen,7680,4,13,7,10,57,44,13,46
AaB,7680,5,6,16,8,38,42,-4,34
AC Horsens,7680,6,6,13,11,32,57,-25,31
Sonderjyske,7680,7,8,6,10,28,29,-1,30
Lyngby,7680,8,4,9,11,31,46,-15,21
Silkeborg IF,7680,9,6,3,13,28,46,-18,21
Randers FC,7680,10,5,6,13,25,44,-19,21
AGF Aarhus,7680,11,4,6,12,18,39,-21,18
Brondby,7681,1,21,7,2,73,30,43,70
FC Midtjylla,7681,2,20,5,5,69,40,29,65
FC Nords,7681,3,13,6,11,73,56,17,45
Copenhagen,7681,4,13,5,12,55,43,12,44
AaB,7681,5,8,11,11,37,49,-12,35
AC Horsens,7681,6,7,14,9,38,53,-15,35
Sonderjyske,7681,7,8,6,10,28,29,-1,30
Randers FC,7681,8,6,6,12,25,40,-15,24
AGF Aarhus,7681,9,5,6,11,18,37,-19,21
Lyngby,7681,10,3,9,12,27,46,-19,18
Silkeborg IF,7681,11,5,3,14,26,46,-20,18
Brondby,7682,1,20,6,4,70,34,36,66
FC Midtjylla,7682,2,19,7,4,61,34,27,64
FC Nords,7682,3,14,6,10,75,52,23,48
Copenhagen,7682,4,14,6,10,55,43,12,48
AC Horsens,7682,5,7,13,10,39,52,-13,34
AaB,7682,6,6,14,10,34,45,-11,32
Sonderjyske,7682,7,8,6,10,28,29,-1,30
Randers FC,7682,8,6,6,12,26,41,-15,24
Silkeborg IF,7682,9,5,4,13,27,46,-19,19
AGF Aarhus,7682,10,4,7,11,18,38,-20,19
Lyngby,7682,11,3,9,12,28,47,-19,18
Brondby,7683,1,22,6,2,73,28,45,72
FC Midtjylla,7683,2,19,5,6,65,41,24,62
FC Nords,7683,3,15,6,9,76,54,22,51
Copenhagen,7683,4,15,4,11,59,43,16,49
AC Horsens,7683,5,6,13,11,36,59,-23,31
Sonderjyske,7683,6,8,6,10,28,29,-1,30
AaB,7683,7,6,12,12,36,46,-10,30
Lyngby,7683,8,4,9,11,27,44,-17,21
Randers FC,7683,9,5,6,13,23,40,-17,21
Silkeborg IF,7683,10,6,3,13,27,45,-18,21
AGF Aarhus,7683,11,4,6,12,17,38,-21,18
Brondby,7684,1,20,8,2,71,34,37,68
FC Midtjylla,7684,2,19,6,5,65,38,27,63
FC Nords,7684,3,16,6,8,78,50,28,54
Copenhagen,7684,4,12,5,13,55,47,8,41
AaB,7684,5,8,11,11,33,42,-9,35
AC Horsens,7684,6,6,14,10,34,51,-17,32
Sonderjyske,7684,7,8,6,10,28,29,-1,30
Randers FC,7684,8,5,7,12,24,40,-16,22
Silkeborg IF,7684,9,6,3,13,27,44,-17,21
Lyngby,7684,10,3,10,11,27,45,-18,19
AGF Aarhus,7684,11,4,6,12,16,38,-22,18
Brondby,7685,1,21,5,4,71,30,41,68
FC Midtjylla,7685,2,20,4,6,66,37,29,64
FC Nords,7685,3,15,6,9,70,52,18,51
Copenhagen,7685,4,13,6,11,53,44,9,45
AaB,7685,5,8,12,10,35,40,-5,36
AC Horsens,7685,6,6,13,11,34,52,-18,31
Sonderjyske,7685,7,8,6,10,28,29,-1,30
Lyngby,7685,8,4,9,11,29,46,-17,21
Randers FC,7685,9,5,6,13,25,42,-17,21
Silkeborg IF,7685,10,5,4,13,27,46,-19,19
AGF Aarhus,7685,11,4,7,11,18,38,-20,19
Brondby,7686,1,22,5,3,73,30,43,71
FC Midtjylla,7686,2,19,4,7,64,41,23,61
Copenhagen,7686,3,15,4,11,56,45,11,49
FC Nords,7686,4,13,6,11,67,54,13,45
AaB,7686,5,9,11,10,40,39,1,38
AC Horsens,7686,6,7,12,11,35,52,-17,33
Sonderjyske,7686,7,8,6,10,28,29,-1,30
Randers FC,7686,8,6,6,12,25,39,-14,24
Silkeborg IF,7686,9,5,4,13,25,44,-19,19
AGF Aarhus,7686,10,4,7,11,16,36,-20,19
Lyngby,7686,11,3,9,12,26,46,-20,18
FC Midtjylla,7687,1,21,5,4,69,38,31,68
Brondby,7687,2,20,6,4,69,34,35,66
FC Nords,7687,3,15,6,9,72,47,25,51
Copenhagen,7687,4,12,5,13,54,51,3,41
AaB,7687,5,8,12,10,39,42,-3,36
AC Horsens,7687,6,7,12,11,34,51,-17,33
Sonderjyske,7687,7,8,6,10,28,29,-1,30
Lyngby,7687,8,4,9,11,28,44,-16,21
Silkeborg IF,7687,9,6,3,13,27,45,-18,21
Randers FC,7687,10,5,6,13,23,41,-18,21
AGF Aarhus,7687,11,4,6,12,17,38,-21,18
Brondby,7688,1,20,7,3,69,35,34,67
FC Midtjylla,7688,2,20,4,6,64,37,27,64
FC Nords,7688,3,15,7,8,76,49,27,52
Copenhagen,7688,4,15,5,10,56,42,14,50
AC Horsens,7688,5,6,13,11,33,51,-18,31
Sonderjyske,7688,6,8,6,10,28,29,-1,30
AaB,7688,7,6,12,12,36,46,-10,30
Lyngby,7688,8,4,9,11,28,44,-16,21
Silkeborg IF,7688,9,6,3,13,27,44,-17,21
Randers FC,7688,10,5,6,13,23,41,-18,21
AGF Aarhus,7688,11,4,6,12,16,38,-22,18
Brondby,7689,1,21,5,4,74,37,37,68
FC Midtjylla,7689,2,20,4,6,66,38,28,64
FC Nords,7689,3,14,8,8,72,51,21,50
Copenhagen,7689,4,15,4,11,61,47,14,49
AaB,7689,5,7,12,11,37,43,-6,33
AC Horsens,7689,6,6,13,11,33,53,-20,31
Sonderjyske,7689,7,8,6,10,28,29,-1,30
Lyngby,7689,8,4,9,11,28,45,-17,21
Randers FC,7689,9,5,6,13,24,41,-17,21
Silkeborg IF,7689,10,6,3,13,27,45,-18,21
AGF Aarhus,7689,11,4,6,12,17,38,-21,18
Brondby,7690,1,20,6,4,70,34,36,66
FC Midtjylla,7690,2,19,5,6,64,39,25,62
FC Nords,7690,3,14,7,9,68,51,17,49
Copenhagen,7690,4,15,4,11,59,45,14,49
AaB,7690,5,7,13,10,38,43,-5,34
AC Horsens,7690,6,7,13,10,37,50,-13,34
Sonderjyske,7690,7,8,6,10,28,29,-1,30
Randers FC,7690,8,6,6,12,25,39,-14,24
Silkeborg IF,7690,9,6,3,13,27,45,-18,21
Lyngby,7690,10,3,9,12,26,46,-20,18
AGF Aarhus,7690,11,4,6,12,17,38,-21,18
FC Midtjylla,7691,1,20,5,5,70,41,29,65
Brondby,7691,2,19,7,4,68,36,32,64
FC Nords,7691,3,15,6,9,72,50,22,51
Copenhagen,7691,4,15,5,10,62,46,16,50
AaB,7691,5,8,11,11,34,39,-5,35
Sonderjyske,7691,6,8,6,10,28,29,-1,30
AC Horsens,7691,7,5,14,11,32,52,-20,29
Randers FC,7691,8,5,7,12,23,39,-16,22
Silkeborg IF,7691,9,6,3,13,29,46,-17,21
Lyngby,7691,10,3,10,11,26,44,-18,19
AGF Aarhus,7691,11,4,6,12,18,40,-22,18
Brondby,7692,1,20,6,4,72,35,37,66
FC Midtjylla,7692,2,20,4,6,63,40,23,64
Copenhagen,7692,3,15,5,10,56,42,14,50
FC Nords,7692,4,14,6,10,74,55,19,48
AC Horsens,7692,5,7,13,10,41,53,-12,34
AaB,7692,6,7,12,11,42,49,-7,33
Sonderjyske,7692,7,8,6,10,28,29,-1,30
Lyngby,7692,8,4,9,11,28,44,-16,21
Silkeborg IF,7692,9,6,3,13,26,44,-18,21
Randers FC,7692,10,5,6,13,23,41,-18,21
AGF Aarhus,7692,11,4,6,12,16,37,-21,18
Brondby,7693,1,21,6,3,70,33,37,69
FC Midtjylla,7693,2,20,4,6,65,39,26,64
FC Nords,7693,3,13,7,10,72,56,16,46
Copenhagen,7693,4,12,4,14,52,46,6,40
AC Horsens,7693,5,9,12,9,38,49,-11,39
AaB,7693,6,9,11,10,39,39,0,38
Sonderjyske,7693,7,8,6,10,28,29,-1,30
Lyngby,7693,8,4,9,11,31,44,-13,21
Silkeborg IF,7693,9,6,3,13,28,44,-16,21
Randers FC,7693,10,5,6,13,23,44,-21,21
AGF Aarhus,7693,11,4,6,12,16,39,-23,18
FC Midtjylla,7694,1,21,5,4,65,34,31,68
Brondby,7694,2,20,6,4,68,34,34,66
Copenhagen,7694,3,14,6,10,58,44,14,48
FC Nords,7694,4,13,7,10,70,49,21,46
AaB,7694,5,6,14,10,33,42,-9,32
AC Horsens,7694,6,6,14,10,34,51,-17,32
Sonderjyske,7694,7,8,6,10,28,29,-1,30
Randers FC,7694,8,6,6,12,26,39,-13,24
AGF Aarhus,7694,9,5,6,11,17,36,-19,21
Silkeborg IF,7694,10,5,3,14,25,45,-20,18
Lyngby,7694,11,3,9,12,26,47,-21,18
Brondby,7695,1,21,6,3,73,34,39,69
FC Midtjylla,7695,2,21,4,5,73,43,30,67
FC Nords,7695,3,14,7,9,74,57,17,49
Copenhagen,7695,4,13,7,10,60,45,15,46
AaB,7695,5,7,12,11,38,46,-8,33
Sonderjyske,7695,6,8,6,10,28,29,-1,30
AC Horsens,7695,7,6,12,12,36,55,-19,30
Lyngby,7695,8,4,9,11,27,44,-17,21
Randers FC,7695,9,5,6,13,23,40,-17,21
Silkeborg IF,7695,10,6,3,13,26,44,-18,21
AGF Aarhus,7695,11,4,6,12,16,37,-21,18
FC Midtjylla,7696,1,21,5,4,66,37,29,68
Brondby,7696,2,20,7,3,69,31,38,67
FC Nords,7696,3,14,7,9,75,52,23,49
Copenhagen,7696,4,13,6,11,57,46,11,45
AaB,7696,5,8,12,10,36,40,-4,36
Sonderjyske,7696,6,8,6,10,28,29,-1,30
AC Horsens,7696,7,5,13,12,31,54,-23,28
Randers FC,7696,8,6,6,12,26,41,-15,24
Silkeborg IF,7696,9,6,3,13,26,44,-18,21
Lyngby,7696,10,3,9,12,28,47,-19,18
AGF Aarhus,7696,11,4,6,12,16,37,-21,18
Brondby,7697,1,19,6,5,71,38,33,63
FC Midtjylla,7697,2,19,4,7,62,43,19,61
FC Nords,7697,3,15,7,8,76,49,27,52
Copenhagen,7697,4,15,4,11,61,47,14,49
AaB,7697,5,8,13,9,41,43,-2,37
AC Horsens,7697,6,6,14,10,36,53,-17,32
Sonderjyske,7697,7,8,6,10,28,29,-1,30
Lyngby,7697,8,4,9,11,30,45,-15,21
Randers FC,7697,9,5,6,13,24,43,-19,21
Silkeborg IF,7697,10,5,4,13,27,46,-19,19
AGF Aarhus,7697,11,4,7,11,18,38,-20,19
Brondby,7698,1,20,8,2,69,32,37,68
FC Midtjylla,7698,2,19,6,5,63,37,26,63
FC Nords,7698,3,13,8,9,72,53,19,47
Copenhagen,7698,4,14,5,11,58,44,14,47
AaB,7698,5,9,12,9,40,40,0,39
Sonderjyske,7698,6,8,6,10,28,29,-1,30
AC Horsens,7698,7,5,13,12,34,56,-22,28
Lyngby,7698,8,4,9,11,28,44,-16,21
Silkeborg IF,7698,8,6,3,13,28,44,-16,21
Randers FC,7698,10,5,6,13,23,41,-18,21
AGF Aarhus,7698,11,4,6,12,16,39,-23,18
Brondby,7699,1,21,6,3,69,30,39,69
FC Midtjylla,7699,2,17,7,6,64,44,20,58
FC Nords,7699,3,15,7,8,76,52,24,52
Copenhagen,7699,4,15,5,10,58,43,15,50
AaB,7699,5,6,15,9,39,44,-5,33
Sonderjyske,7699,6,8,6,10,28,29,-1,30
AC Horsens,7699,7,5,14,11,33,52,-19,29
Lyngby,7699,8,4,9,11,28,45,-17,21
Randers FC,7699,9,5,6,13,24,41,-17,21
AGF Aarhus,7699,10,5,6,11,17,36,-19,21
Silkeborg IF,7699,11,5,3,14,25,45,-20,18
Brondby,7700,1,21,6,3,77,34,43,69
FC Midtjylla,7700,2,20,5,5,65,38,27,65
FC Nords,7700,3,14,6,10,74,54,20,48
Copenhagen,7700,4,14,6,10,54,39,15,48
AaB,7700,5,7,12,11,39,47,-8,33
Sonderjyske,7700,6,8,6,10,28,29,-1,30
AC Horsens,7700,7,5,15,10,34,57,-23,30
Randers FC,7700,8,5,7,12,24,40,-16,22
AGF Aarhus,7700,9,5,6,11,18,36,-18,21
Lyngby,7700,10,3,10,11,27,45,-18,19
Silkeborg IF,7700,11,5,3,14,25,46,-21,18
Brondby,7701,1,21,6,3,69,32,37,69
FC Midtjylla,7701,2,20,6,4,68,36,32,66
FC Nords,7701,3,13,6,11,70,56,14,45
Copenhagen,7701,4,13,6,11,54,44,10,45
AaB,7701,5,8,13,9,36,39,-3,37
AC Horsens,7701,6,6,13,11,36,52,-16,31
Sonderjyske,7701,7,8,6,10,28,29,-1,30
Lyngby,7701,8,4,9,11,28,44,-16,21
Randers FC,7701,9,5,6,13,23,41,-18,21
AGF Aarhus,7701,10,5,6,11,17,36,-19,21
Silkeborg IF,7701,11,5,3,14,25,45,-20,18
Brondby,7702,1,22,6,2,72,31,41,72
FC Midtjylla,7702,2,19,6,5,68,39,29,63
FC Nords,7702,3,13,7,10,68,51,17,46
Copenhagen,7702,4,13,5,12,52,43,9,44
AaB,7702,5,8,13,9,39,41,-2,37
AC Horsens,7702,6,6,13,11,35,55,-20,31
Sonderjyske,7702,7,8,6,10,28,29,-1,30
Lyngby,7702,8,4,9,11,29,44,-15,21
Randers FC,7702,9,5,6,13,23,42,-19,21
Silkeborg IF,7702,10,5,4,13,26,45,-19,19
AGF Aarhus,7702,11,4,7,11,17,37,-20,19
Brondby,7703,1,20,6,4,75,36,39,66
FC Midtjylla,7703,2,19,5,6,65,45,20,62
FC Nords,7703,3,15,8,7,79,52,27,53
Copenhagen,7703,4,13,6,11,59,49,10,45
AaB,7703,5,8,12,10,41,46,-5,36
Sonderjyske,7703,6,8,6,10,28,29,-1,30
AC Horsens,7703,7,5,15,10,34,51,-17,30
Silkeborg IF,7703,8,6,3,13,28,44,-16,21
Lyngby,7703,9,4,9,11,28,45,-17,21
Randers FC,7703,10,5,6,13,24,41,-17,21
AGF Aarhus,7703,11,4,6,12,16,39,-23,18
FC Midtjylla,7704,1,21,4,5,71,37,34,67
Brondby,7704,2,20,5,5,67,34,33,65
FC Nords,7704,3,14,7,9,69,49,20,49
Copenhagen,7704,4,14,4,12,58,47,11,46
AaB,7704,5,8,12,10,36,42,-6,36
AC Horsens,7704,6,7,12,11,33,51,-18,33
Sonderjyske,7704,7,8,6,10,28,29,-1,30
Randers FC,7704,8,6,6,12,27,42,-15,24
Silkeborg IF,7704,9,6,3,13,27,45,-18,21
Lyngby,7704,10,3,9,12,29,48,-19,18
AGF Aarhus,7704,11,4,6,12,17,38,-21,18
Brondby,7705,1,20,7,3,68,32,36,67
FC Midtjylla,7705,2,19,4,7,65,41,24,61
FC Nords,7705,3,15,8,7,70,45,25,53
Copenhagen,7705,4,15,4,11,60,45,15,49
AaB,7705,5,7,11,12,34,42,-8,32
AC Horsens,7705,6,6,14,10,36,54,-18,32
Sonderjyske,7705,7,8,6,10,28,29,-1,30
Randers FC,7705,8,6,6,12,24,39,-15,24
Silkeborg IF,7705,9,6,3,13,28,44,-16,21
Lyngby,7705,10,3,9,12,26,45,-19,18
AGF Aarhus,7705,11,4,6,12,16,39,-23,18
Brondby,7706,1,21,6,3,75,32,43,69
FC Midtjylla,7706,2,20,6,4,66,37,29,66
FC Nords,7706,3,14,7,9,75,49,26,49
Copenhagen,7706,4,13,4,13,54,52,2,43
AaB,7706,5,7,12,11,33,43,-10,33
AC Horsens,7706,6,6,15,9,34,50,-16,33
Sonderjyske,7706,7,8,6,10,28,29,-1,30
Randers FC,7706,8,5,7,12,24,40,-16,22
AGF Aarhus,7706,9,5,6,11,17,36,-19,21
Lyngby,7706,10,3,10,11,27,45,-18,19
Silkeborg IF,7706,11,5,3,14,25,45,-20,18
Brondby,7707,1,21,6,3,74,34,40,69
FC Midtjylla,7707,2,20,5,5,67,38,29,65
FC Nords,7707,3,14,7,9,76,52,24,49
Copenhagen,7707,4,13,5,12,59,54,5,44
AaB,7707,5,9,13,8,41,41,0,40
Sonderjyske,7707,6,8,6,10,28,29,-1,30
AC Horsens,7707,7,5,12,13,34,58,-24,27
Lyngby,7707,8,4,9,11,28,44,-16,21
Randers FC,7707,9,5,6,13,23,41,-18,21
AGF Aarhus,7707,10,5,6,11,17,36,-19,21
Silkeborg IF,7707,11,5,3,14,25,45,-20,18
Brondby,7708,1,20,7,3,74,32,42,67
FC Midtjylla,7708,2,21,4,5,64,37,27,67
FC Nords,7708,3,15,6,9,77,55,22,51
Copenhagen,7708,4,13,6,11,54,45,9,45
AaB,7708,5,7,11,12,34,42,-8,32
AC Horsens,7708,6,6,14,10,36,54,-18,32
Sonderjyske,7708,7,8,6,10,28,29,-1,30
Lyngby,7708,8,4,9,11,31,44,-13,21
Randers FC,7708,9,5,6,13,23,44,-21,21
Silkeborg IF,7708,10,5,4,13,26,45,-19,19
AGF Aarhus,7708,11,4,7,11,17,37,-20,19
Brondby,7709,1,22,6,2,72,33,39,72
FC Midtjylla,7709,2,19,5,6,71,43,28,62
FC Nords,7709,3,15,7,8,81,54,27,52
Copenhagen,7709,4,12,6,12,56,50,6,42
AaB,7709,5,7,12,11,37,45,-8,33
AC Horsens,7709,6,6,14,10,35,53,-18,32
Sonderjyske,7709,7,8,6,10,28,29,-1,30
Randers FC,7709,8,6,6,12,24,39,-15,24
Silkeborg IF,7709,9,6,3,13,27,44,-17,21
Lyngby,7709,10,3,9,12,26,45,-19,18
AGF Aarhus,7709,11,4,6,12,16,38,-22,18
Brondby,7710,1,22,5,3,71,33,38,71
FC Midtjylla,7710,2,21,4,5,73,41,32,67
FC Nords,7710,3,15,7,8,79,55,24,52
Copenhagen,7710,4,14,4,12,56,45,11,46
Sonderjyske,7710,5,8,6,10,28,29,-1,30
AaB,7710,6,6,12,12,36,48,-12,30
AC Horsens,7710,7,6,12,12,34,53,-19,30
Silkeborg IF,7710,8,6,3,13,29,44,-15,21
Lyngby,7710,9,4,9,11,28,45,-17,21
Randers FC,7710,10,5,6,13,24,41,-17,21
AGF Aarhus,7710,11,4,6,12,16,40,-24,18
Brondby,7711,1,21,5,4,69,33,36,68
FC Midtjylla,7711,2,19,6,5,63,37,26,63
FC Nords,7711,3,15,7,8,80,49,31,52
Copenhagen,7711,4,14,5,11,55,45,10,47
AaB,7711,5,8,12,10,39,43,-4,36
Sonderjyske,7711,6,8,6,10,28,29,-1,30
AC Horsens,7711,7,5,13,12,31,56,-25,28
Randers FC,7711,8,6,6,12,26,40,-14,24
Silkeborg IF,7711,9,5,4,13,25,44,-19,19
AGF Aarhus,7711,10,4,7,11,16,36,-20,19
Lyngby,7711,11,3,9,12,27,47,-20,18
Brondby,7712,1,20,5,5,70,36,34,65
FC Midtjylla,7712,2,20,4,6,68,41,27,64
Copenhagen,7712,3,15,4,11,60,47,13,49
FC Nords,7712,4,13,8,9,69,50,19,47
AaB,7712,5,8,12,10,37,42,-5,36
AC Horsens,7712,6,7,13,10,37,51,-14,34
Sonderjyske,7712,7,8,6,10,28,29,-1,30
Randers FC,7712,8,5,7,12,24,40,-16,22
Lyngby,7712,9,3,10,11,27,45,-18,19
Silkeborg IF,7712,10,5,4,13,25,44,-19,19
AGF Aarhus,7712,11,4,7,11,16,36,-20,19
Brondby,7713,1,19,8,3,67,32,35,65
FC Midtjylla,7713,2,19,4,7,61,38,23,61
FC Nords,7713,3,16,7,7,78,49,29,55
Copenhagen,7713,4,14,6,10,58,40,18,48
AaB,7713,5,7,12,11,34,43,-9,33
AC Horsens,7713,6,6,13,11,34,56,-22,31
Sonderjyske,7713,7,8,6,10,28,29,-1,30
Lyngby,7713,8,4,9,11,28,44,-16,21
Randers FC,7713,9,5,6,13,23,41,-18,21
AGF Aarhus,7713,10,5,6,11,17,36,-19,21
Silkeborg IF,7713,11,5,3,14,25,45,-20,18
Brondby,7714,1,22,6,2,74,29,45,72
FC Midtjylla,7714,2,21,4,5,65,37,28,67
FC Nords,7714,3,14,6,10,76,54,22,48
Copenhagen,7714,4,12,4,14,57,51,6,40
AaB,7714,5,9,12,9,41,42,-1,39
Sonderjyske,7714,6,8,6,10,28,29,-1,30
AC Horsens,7714,7,6,12,12,33,59,-26,30
Randers FC,7714,8,5,7,12,26,42,-16,22
Silkeborg IF,7714,9,6,3,13,27,45,-18,21
Lyngby,7714,10,3,10,11,29,47,-18,19
AGF Aarhus,7714,11,4,6,12,17,38,-21,18
Brondby,7715,1,22,6,2,76,32,44,72
FC Midtjylla,7715,2,18,5,7,63,43,20,59
FC Nords,7715,3,13,7,10,72,53,19,46
Copenhagen,7715,4,13,6,11,56,48,8,45
AaB,7715,5,8,12,10,40,43,-3,36
AC Horsens,7715,6,8,12,10,37,51,-14,36
Sonderjyske,7715,7,8,6,10,28,29,-1,30
Randers FC,7715,8,6,6,12,25,40,-15,24
AGF Aarhus,7715,9,5,6,11,18,37,-19,21
Lyngby,7715,10,3,9,12,27,46,-19,18
Silkeborg IF,7715,11,5,3,14,26,46,-20,18
Brondby,7716,1,21,5,4,74,35,39,68
FC Midtjylla,7716,2,20,4,6,65,37,28,64
FC Nords,7716,3,15,6,9,75,51,24,51
Copenhagen,7716,4,15,5,10,58,43,15,50
AaB,7716,5,7,11,12,38,50,-12,32
AC Horsens,7716,6,6,13,11,33,53,-20,31
Sonderjyske,7716,7,8,6,10,28,29,-1,30
Lyngby,7716,8,4,9,11,28,45,-17,21
Randers FC,7716,9,5,6,13,24,41,-17,21
Silkeborg IF,7716,10,5,4,13,25,44,-19,19
AGF Aarhus,7716,11,4,7,11,16,36,-20,19
Brondby,7717,1,20,6,4,71,32,39,66
FC Midtjylla,7717,2,19,6,5,63,37,26,63
FC Nords,7717,3,16,6,8,80,54,26,54
Copenhagen,7717,4,16,4,10,60,43,17,52
Sonderjyske,7717,5,8,6,10,28,29,-1,30
AaB,7717,6,6,12,12,34,48,-14,30
AC Horsens,7717,7,6,12,12,33,53,-20,30
Lyngby,7717,8,4,9,11,28,44,-16,21
Randers FC,7717,9,5,6,13,23,41,-18,21
AGF Aarhus,7717,10,5,6,11,18,37,-19,21
Silkeborg IF,7717,11,5,3,14,26,46,-20,18
Brondby,7718,1,23,5,2,72,28,44,74
FC Midtjylla,7718,2,21,4,5,69,36,33,67
Copenhagen,7718,3,14,5,11,59,48,11,47
FC Nords,7718,4,13,7,10,70,51,19,46
AaB,7718,5,7,12,11,38,48,-10,33
Sonderjyske,7718,6,8,6,10,28,29,-1,30
AC Horsens,7718,7,5,13,12,34,57,-23,28
Silkeborg IF,7718,8,6,3,13,30,46,-16,21
Lyngby,7718,9,4,9,11,28,44,-16,21
Randers FC,7718,10,5,6,13,23,41,-18,21
AGF Aarhus,7718,11,4,6,12,18,41,-23,18
Brondby,7719,1,21,6,3,75,32,43,69
FC Midtjylla,7719,2,20,4,6,66,43,23,64
Copenhagen,7719,3,15,5,10,58,45,13,50
FC Nords,7719,4,14,7,9,73,53,20,49
AaB,7719,5,6,14,10,35,42,-7,32
Sonderjyske,7719,6,8,6,10,28,29,-1,30
AC Horsens,7719,7,6,12,12,34,52,-18,30
Lyngby,7719,8,4,9,11,29,44,-15,21
Silkeborg IF,7719,9,6,3,13,28,44,-16,21
Randers FC,7719,10,5,6,13,23,42,-19,21
AGF Aarhus,7719,11,4,6,12,16,39,-23,18
Brondby,7720,1,20,7,3,69,31,38,67
FC Midtjylla,7720,2,20,5,5,66,39,27,65
FC Nords,7720,3,13,7,10,71,51,20,46
Copenhagen,7720,4,13,6,11,60,50,10,45
AC Horsens,7720,5,8,12,10,36,53,-17,36
AaB,7720,6,8,11,11,38,42,-4,35
Sonderjyske,7720,7,8,6,10,28,29,-1,30
Randers FC,7720,8,6,6,12,25,39,-14,24
Silkeborg IF,7720,9,6,3,13,26,44,-18,21
Lyngby,7720,10,3,9,12,26,46,-20,18
AGF Aarhus,7720,11,4,6,12,16,37,-21,18
Brondby,7721,1,21,7,2,76,28,48,70
FC Midtjylla,7721,2,19,5,6,65,43,22,62
Copenhagen,7721,3,15,5,10,59,41,18,50
FC Nords,7721,4,14,6,10,70,57,13,48
AC Horsens,7721,5,6,14,10,37,56,-19,32
AaB,7721,6,6,13,11,37,45,-8,31
Sonderjyske,7721,7,8,6,10,28,29,-1,30
Randers FC,7721,8,6,6,12,26,41,-15,24
Silkeborg IF,7721,9,6,3,13,27,44,-17,21
Lyngby,7721,10,3,9,12,28,47,-19,18
AGF Aarhus,7721,11,4,6,12,16,38,-22,18
Brondby,7722,1,21,6,3,69,31,38,69
FC Midtjylla,7722,2,18,5,7,61,41,20,59
FC Nords,7722,3,14,6,10,73,54,19,48
Copenhagen,7722,4,14,4,12,56,43,13,46
AaB,7722,5,9,11,10,40,40,0,38
AC Horsens,7722,6,8,12,10,36,52,-16,36
Sonderjyske,7722,7,8,6,10,28,29,-1,30
Lyngby,7722,8,4,9,11,28,44,-16,21
Randers FC,7722,9,5,6,13,23,41,-18,21
Silkeborg IF,7722,10,5,4,13,27,46,-19,19
AGF Aarhus,7722,11,4,7,11,18,38,-20,19
Brondby,7723,1,21,6,3,70,34,36,69
FC Midtjylla,7723,2,20,4,6,68,42,26,64
Copenhagen,7723,3,15,4,11,58,46,12,49
FC Nords,7723,4,14,6,10,75,54,21,48
AaB,7723,5,7,12,11,40,45,-5,33
AC Horsens,7723,6,7,12,11,39,55,-16,33
Sonderjyske,7723,7,8,6,10,28,29,-1,30
Randers FC,7723,8,5,7,12,23,39,-16,22
AGF Aarhus,7723,9,5,6,11,19,37,-18,21
Lyngby,7723,10,3,10,11,26,44,-18,19
Silkeborg IF,7723,11,5,3,14,26,47,-21,18
Brondby,7724,1,23,5,2,76,29,47,74
FC Midtjylla,7724,2,20,4,6,63,39,24,64
FC Nords,7724,3,14,6,10,74,56,18,48
Copenhagen,7724,4,14,5,11,58,45,13,47
AaB,7724,5,7,11,12,37,46,-9,32
AC Horsens,7724,6,6,13,11,35,54,-19,31
Sonderjyske,7724,7,8,6,10,28,29,-1,30
Randers FC,7724,8,5,7,12,24,40,-16,22
Silkeborg IF,7724,9,6,3,13,27,45,-18,21
Lyngby,7724,10,3,10,11,27,45,-18,19
AGF Aarhus,7724,11,4,6,12,17,38,-21,18
FC Midtjylla,7725,1,20,5,5,66,41,25,65
Brondby,7725,2,19,6,5,66,36,30,63
FC Nords,7725,3,16,6,8,79,48,31,54
Copenhagen,7725,4,14,5,11,59,44,15,47
AaB,7725,5,7,13,10,33,41,-8,34
AC Horsens,7725,6,6,13,11,34,53,-19,31
Sonderjyske,7725,7,8,6,10,28,29,-1,30
Randers FC,7725,8,5,7,12,24,40,-16,22
Lyngby,7725,9,3,10,11,27,45,-18,19
Silkeborg IF,7725,10,5,4,13,26,45,-19,19
AGF Aarhus,7725,11,4,7,11,17,37,-20,19
Brondby,7726,1,20,7,3,69,30,39,67
FC Midtjylla,7726,2,20,4,6,64,36,28,64
Copenhagen,7726,3,14,5,11,61,47,14,47
FC Nords,7726,4,13,7,10,69,54,15,46
AaB,7726,5,9,11,10,40,43,-3,38
AC Horsens,7726,6,6,14,10,36,55,-19,32
Sonderjyske,7726,7,8,6,10,28,29,-1,30
Randers FC,7726,8,5,7,12,24,40,-16,22
AGF Aarhus,7726,9,5,6,11,17,36,-19,21
Lyngby,7726,10,3,10,11,27,45,-18,19
Silkeborg IF,7726,11,5,3,14,25,45,-20,18
Brondby,7727,1,20,7,3,75,33,42,67
FC Midtjylla,7727,2,19,4,7,64,44,20,61
Copenhagen,7727,3,15,5,10,67,45,22,50
FC Nords,7727,4,13,6,11,70,58,12,45
AaB,7727,5,10,11,9,41,45,-4,41
AC Horsens,7727,6,6,13,11,36,54,-18,31
Sonderjyske,7727,7,8,6,10,28,29,-1,30
Randers FC,7727,8,5,7,12,25,41,-16,22
Silkeborg IF,7727,9,6,3,13,30,45,-15,21
Lyngby,7727,10,3,10,11,28,46,-18,19
AGF Aarhus,7727,11,4,6,12,17,41,-24,18
Brondby,7728,1,22,5,3,76,29,47,71
FC Midtjylla,7728,2,19,5,6,64,43,21,62
Copenhagen,7728,3,14,5,11,53,40,13,47
FC Nords,7728,4,12,8,10,72,56,16,44
AC Horsens,7728,5,8,12,10,35,49,-14,36
AaB,7728,6,8,11,11,39,48,-9,35
Sonderjyske,7728,7,8,6,10,28,29,-1,30
Randers FC,7728,8,6,6,12,27,39,-12,24
Silkeborg IF,7728,9,6,3,13,27,45,-18,21
AGF Aarhus,7728,10,4,6,12,17,38,-21,18
Lyngby,7728,11,3,9,12,26,48,-22,18
Brondby,7729,1,21,7,2,73,30,43,70
FC Midtjylla,7729,2,19,6,5,66,42,24,63
FC Nords,7729,3,14,6,10,75,53,22,48
Copenhagen,7729,4,13,5,12,55,47,8,44
AaB,7729,5,8,11,11,35,43,-8,35
AC Horsens,7729,6,7,13,10,37,52,-15,34
Sonderjyske,7729,7,8,6,10,28,29,-1,30
Randers FC,7729,8,5,7,12,25,41,-16,22
Lyngby,7729,9,3,10,11,28,46,-18,19
Silkeborg IF,7729,10,5,4,13,26,45,-19,19
AGF Aarhus,7729,11,4,7,11,17,37,-20,19
Brondby,7730,1,23,5,2,71,29,42,74
FC Midtjylla,7730,2,19,4,7,63,42,21,61
Copenhagen,7730,3,15,4,11,60,47,13,49
FC Nords,7730,4,14,6,10,78,52,26,48
AaB,7730,5,7,12,11,36,43,-7,33
AC Horsens,7730,6,6,13,11,34,55,-21,31
Sonderjyske,7730,7,8,6,10,28,29,-1,30
Lyngby,7730,8,4,9,11,27,44,-17,21
Randers FC,7730,9,5,6,13,23,40,-17,21
Silkeborg IF,7730,10,5,4,13,26,45,-19,19
AGF Aarhus,7730,11,4,7,11,17,37,-20,19
Brondby,7731,1,23,5,2,77,31,46,74
FC Midtjylla,7731,2,19,4,7,62,42,20,61
FC Nords,7731,3,14,6,10,76,55,21,48
Copenhagen,7731,4,14,5,11,59,47,12,47
AaB,7731,5,8,12,10,36,41,-5,36
Sonderjyske,7731,6,8,6,10,28,29,-1,30
AC Horsens,7731,7,6,12,12,37,57,-20,30
Randers FC,7731,8,5,7,12,24,40,-16,22
AGF Aarhus,7731,9,5,6,11,18,36,-18,21
Lyngby,7731,10,3,10,11,27,45,-18,19
Silkeborg IF,7731,11,5,3,14,25,46,-21,18
Brondby,7732,1,21,6,3,69,30,39,69
FC Midtjylla,7732,2,19,4,7,62,39,23,61
FC Nords,7732,3,15,6,9,75,52,23,51
Copenhagen,7732,4,12,7,11,57,47,10,43
AaB,7732,5,8,13,9,40,44,-4,37
AC Horsens,7732,6,6,14,10,35,52,-17,32
Sonderjyske,7732,7,8,6,10,28,29,-1,30
Lyngby,7732,8,4,9,11,28,45,-17,21
Randers FC,7732,9,5,6,13,24,41,-17,21
Silkeborg IF,7732,10,6,3,13,27,45,-18,21
AGF Aarhus,7732,11,4,6,12,17,38,-21,18
Brondby,7733,1,22,5,3,75,31,44,71
FC Midtjylla,7733,2,18,5,7,68,49,19,59
FC Nords,7733,3,15,7,8,79,54,25,52
Copenhagen,7733,4,14,4,12,57,46,11,46
AC Horsens,7733,5,8,13,9,36,50,-14,37
Sonderjyske,7733,6,8,6,10,28,29,-1,30
AaB,7733,7,6,12,12,35,46,-11,30
Lyngby,7733,8,4,9,11,28,44,-16,21
Randers FC,7733,9,5,6,13,23,41,-18,21
AGF Aarhus,7733,10,5,6,11,17,36,-19,21
Silkeborg IF,7733,11,5,3,14,25,45,-20,18
Brondby,7734,1,22,5,3,75,31,44,71
FC Midtjylla,7734,2,19,5,6,63,42,21,62
Copenhagen,7734,3,16,4,10,64,45,19,52
FC Nords,7734,4,12,7,11,69,54,15,43
AaB,7734,5,8,11,11,38,47,-9,35
AC Horsens,7734,6,7,12,11,36,52,-16,33
Sonderjyske,7734,7,8,6,10,28,29,-1,30
Lyngby,7734,8,4,9,11,30,46,-16,21
Silkeborg IF,7734,9,6,3,13,26,44,-18,21
Randers FC,7734,10,5,6,13,25,43,-18,21
AGF Aarhus,7734,11,4,6,12,16,37,-21,18
Brondby,7735,1,20,6,4,67,32,35,66
FC Midtjylla,7735,2,18,7,5,62,37,25,61
FC Nords,7735,3,14,9,7,73,50,23,51
Copenhagen,7735,4,14,6,10,59,45,14,48
AaB,7735,5,7,12,11,37,45,-8,33
AC Horsens,7735,6,6,14,10,37,52,-15,32
Sonderjyske,7735,7,8,6,10,28,29,-1,30
Lyngby,7735,8,4,9,11,27,44,-17,21
Silkeborg IF,7735,8,6,3,13,27,44,-17,21
Randers FC,7735,10,5,6,13,23,40,-17,21
AGF Aarhus,7735,11,4,6,12,16,38,-22,18
Brondby,7736,1,22,5,3,70,30,40,71
FC Midtjylla,7736,2,20,4,6,69,45,24,64
FC Nords,7736,3,15,7,8,74,51,23,52
Copenhagen,7736,4,15,4,11,64,48,16,49
AaB,7736,5,7,11,12,37,46,-9,32
Sonderjyske,7736,6,8,6,10,28,29,-1,30
AC Horsens,7736,7,5,13,12,34,54,-20,28
Lyngby,7736,8,4,9,11,29,44,-15,21
Silkeborg IF,7736,9,6,3,13,26,44,-18,21
Randers FC,7736,10,5,6,13,23,42,-19,21
AGF Aarhus,7736,11,4,6,12,16,37,-21,18
Brondby,7737,1,20,7,3,70,33,37,67
FC Midtjylla,7737,2,20,5,5,65,39,26,65
FC Nords,7737,3,13,9,8,75,55,20,48
Copenhagen,7737,4,14,5,11,59,43,16,47
AaB,7737,5,7,14,9,40,44,-4,35
Sonderjyske,7737,6,8,6,10,28,29,-1,30
AC Horsens,7737,7,5,14,11,34,55,-21,29
Lyngby,7737,8,4,9,11,28,45,-17,21
Randers FC,7737,9,5,6,13,24,41,-17,21
Silkeborg IF,7737,10,5,4,13,26,45,-19,19
AGF Aarhus,7737,11,4,7,11,17,37,-20,19
Brondby,7738,1,20,6,4,71,36,35,66
FC Midtjylla,7738,2,20,5,5,66,34,32,65
Copenhagen,7738,3,15,5,10,59,42,17,50
FC Nords,7738,4,13,8,9,73,53,20,47
AaB,7738,5,7,12,11,34,46,-12,33
AC Horsens,7738,6,7,12,11,34,52,-18,33
Sonderjyske,7738,7,8,6,10,28,29,-1,30
Randers FC,7738,8,5,7,12,24,40,-16,22
Silkeborg IF,7738,9,6,3,13,28,45,-17,21
Lyngby,7738,10,3,10,11,27,45,-18,19
AGF Aarhus,7738,11,4,6,12,17,39,-22,18
Brondby,7739,1,22,5,3,70,28,42,71
FC Midtjylla,7739,2,20,4,6,65,37,28,64
Copenhagen,7739,3,15,6,9,57,41,16,51
FC Nords,7739,4,13,7,10,70,51,19,46
AaB,7739,5,7,13,10,37,43,-6,34
Sonderjyske,7739,6,8,6,10,28,29,-1,30
AC Horsens,7739,7,5,13,12,30,55,-25,28
Silkeborg IF,7739,8,6,3,13,28,44,-16,21
Lyngby,7739,9,4,9,11,28,45,-17,21
Randers FC,7739,10,5,6,13,24,41,-17,21
AGF Aarhus,7739,11,4,6,12,16,39,-23,18
Brondby,7740,1,20,6,4,69,33,36,66
FC Midtjylla,7740,2,20,5,5,69,40,29,65
FC Nords,7740,3,13,9,8,70,50,20,48
Copenhagen,7740,4,14,6,10,58,42,16,48
AaB,7740,5,8,12,10,36,40,-4,36
Sonderjyske,7740,6,8,6,10,28,29,-1,30
AC Horsens,7740,7,5,14,11,33,56,-23,29
Silkeborg IF,7740,8,6,3,13,28,44,-16,21
Lyngby,7740,9,4,9,11,28,45,-17,21
Randers FC,7740,10,5,6,13,24,41,-17,21
AGF Aarhus,7740,11,4,6,12,16,39,-23,18
Brondby,7741,1,21,6,3,71,33,38,69
FC Midtjylla,7741,2,18,7,5,63,39,24,61
FC Nords,7741,3,14,8,8,78,51,27,50
Copenhagen,7741,4,14,4,12,62,53,9,46
AaB,7741,5,7,13,10,38,44,-6,34
AC Horsens,7741,6,6,14,10,34,52,-18,32
Sonderjyske,7741,7,8,6,10,28,29,-1,30
Lyngby,7741,8,4,9,11,28,44,-16,21
Silkeborg IF,7741,9,6,3,13,27,45,-18,21
Randers FC,7741,10,5,6,13,23,41,-18,21
AGF Aarhus,7741,11,4,6,12,17,38,-21,18
Brondby,7742,1,20,6,4,70,39,31,66
FC Midtjylla,7742,2,19,7,4,68,37,31,64
FC Nords,7742,3,15,6,9,81,51,30,51
Copenhagen,7742,4,14,5,11,61,44,17,47
AaB,7742,5,7,13,10,39,47,-8,34
AC Horsens,7742,6,6,13,11,33,60,-27,31
Sonderjyske,7742,7,8,6,10,28,29,-1,30
Randers FC,7742,8,6,6,12,26,41,-15,24
Silkeborg IF,7742,9,6,3,13,26,44,-18,21
Lyngby,7742,10,3,9,12,28,47,-19,18
AGF Aarhus,7742,11,4,6,12,16,37,-21,18
FC Midtjylla,7743,1,22,4,4,69,35,34,70
Brondby,7743,2,20,5,5,72,38,34,65
Copenhagen,7743,3,14,5,11,61,44,17,47
FC Nords,7743,4,13,7,10,70,57,13,46
AaB,7743,5,8,11,11,36,43,-7,35
AC Horsens,7743,6,7,12,11,37,54,-17,33
Sonderjyske,7743,7,8,6,10,28,29,-1,30
Randers FC,7743,8,6,6,12,24,39,-15,24
Silkeborg IF,7743,9,6,3,13,29,46,-17,21
Lyngby,7743,10,3,9,12,26,45,-19,18
AGF Aarhus,7743,11,4,6,12,18,40,-22,18
Brondby,7744,1,20,8,2,71,29,42,68
FC Midtjylla,7744,2,19,6,5,67,43,24,63
FC Nords,7744,3,14,8,8,78,53,25,50
Copenhagen,7744,4,12,6,12,54,48,6,42
AC Horsens,7744,5,7,14,9,35,52,-17,35
AaB,7744,6,6,14,10,37,43,-6,32
Sonderjyske,7744,7,8,6,10,28,29,-1,30
Randers FC,7744,8,5,7,12,24,40,-16,22
Silkeborg IF,7744,9,6,3,13,27,45,-18,21
Lyngby,7744,10,3,10,11,27,45,-18,19
AGF Aarhus,7744,11,4,6,12,17,38,-21,18
Brondby,7745,1,20,7,3,69,30,39,67
FC Midtjylla,7745,2,20,5,5,66,39,27,65
FC Nords,7745,3,14,7,9,72,52,20,49
Copenhagen,7745,4,14,6,10,56,42,14,48
AaB,7745,5,7,11,12,35,44,-9,32
AC Horsens,7745,6,6,14,10,34,51,-17,32
Sonderjyske,7745,7,8,6,10,28,29,-1,30
Randers FC,7745,8,5,7,12,23,39,-16,22
AGF Aarhus,7745,9,5,6,11,19,37,-18,21
Lyngby,7745,10,3,10,11,26,44,-18,19
Silkeborg IF,7745,11,5,3,14,26,47,-21,18
Brondby,7746,1,21,6,3,73,30,43,69
FC Midtjylla,7746,2,20,6,4,70,36,34,66
FC Nords,7746,3,13,6,11,72,61,11,45
Copenhagen,7746,4,12,6,12,57,50,7,42
AaB,7746,5,8,13,9,38,40,-2,37
AC Horsens,7746,6,7,13,10,36,55,-19,34
Sonderjyske,7746,7,8,6,10,28,29,-1,30
Lyngby,7746,8,4,9,11,27,44,-17,21
Randers FC,7746,9,5,6,13,23,40,-17,21
Silkeborg IF,7746,10,5,4,13,25,44,-19,19
AGF Aarhus,7746,11,4,7,11,16,36,-20,19
Brondby,7747,1,21,6,3,74,37,37,69
FC Midtjylla,7747,2,19,6,5,68,41,27,63
Copenhagen,7747,3,14,5,11,60,46,14,47
FC Nords,7747,4,13,7,10,74,55,19,46
AaB,7747,5,8,12,10,38,43,-5,36
AC Horsens,7747,6,6,14,10,35,53,-18,32
Sonderjyske,7747,7,8,6,10,28,29,-1,30
Lyngby,7747,8,4,9,11,29,45,-16,21
Randers FC,7747,9,5,6,13,24,42,-18,21
AGF Aarhus,7747,10,5,6,11,19,37,-18,21
Silkeborg IF,7747,11,5,3,14,26,47,-21,18
Brondby,7748,1,20,8,2,76,33,43,68
FC Midtjylla,7748,2,20,5,5,71,40,31,65
Copenhagen,7748,3,14,6,10,57,43,14,48
FC Nords,7748,4,12,9,9,71,53,18,45
AaB,7748,5,9,11,10,40,49,-9,38
Sonderjyske,7748,6,8,6,10,28,29,-1,30
AC Horsens,7748,7,5,13,12,33,56,-23,28
Lyngby,7748,8,4,9,11,28,45,-17,21
Randers FC,7748,9,5,6,13,24,41,-17,21
Silkeborg IF,7748,10,5,4,13,26,45,-19,19
AGF Aarhus,7748,11,4,7,11,17,37,-20,19
Brondby,7749,1,21,5,4,65,30,35,68
FC Midtjylla,7749,2,20,5,5,65,36,29,65
FC Nords,7749,3,15,8,7,77,50,27,53
Copenhagen,7749,4,13,5,12,52,42,10,44
AaB,7749,5,7,13,10,35,41,-6,34
Sonderjyske,7749,6,8,6,10,28,29,-1,30
AC Horsens,7749,7,5,14,11,31,52,-21,29
Randers FC,7749,8,5,7,12,25,41,-16,22
Silkeborg IF,7749,9,6,3,13,26,44,-18,21
Lyngby,7749,10,3,10,11,28,46,-18,19
AGF Aarhus,7749,11,4,6,12,16,37,-21,18
Brondby,7750,1,22,6,2,71,30,41,72
FC Midtjylla,7750,2,19,6,5,63,38,25,63
FC Nords,7750,3,15,6,9,73,49,24,51
Copenhagen,7750,4,14,4,12,59,47,12,46
AaB,7750,5,7,13,10,39,44,-5,34
Sonderjyske,7750,6,8,6,10,28,29,-1,30
AC Horsens,7750,7,5,13,12,33,56,-23,28
Randers FC,7750,8,5,7,12,25,41,-16,22
Silkeborg IF,7750,9,6,3,13,27,44,-17,21
Lyngby,7750,10,3,10,11,28,46,-18,19
AGF Aarhus,7750,11,4,6,12,16,38,-22,18
Brondby,7751,1,21,6,3,70,29,41,69
FC Midtjylla,7751,2,19,5,6,63,41,22,62
FC Nords,7751,3,14,7,9,69,50,19,49
Copenhagen,7751,4,13,5,12,55,45,10,44
AaB,7751,5,9,11,10,42,43,-1,38
AC Horsens,7751,6,6,14,10,34,51,-17,32
Sonderjyske,7751,7,8,6,10,28,29,-1,30
AGF Aarhus,7751,8,5,6,11,20,36,-16,21
Lyngby,7751,9,4,9,11,28,45,-17,21
Randers FC,7751,10,5,6,13,24,41,-17,21
Silkeborg IF,7751,11,5,3,14,25,48,-23,18
Brondby,7752,1,21,7,2,76,31,45,70
FC Midtjylla,7752,2,20,5,5,69,37,32,65
Copenhagen,7752,3,15,5,10,61,47,14,50
FC Nords,7752,4,12,8,10,71,56,15,44
AaB,7752,5,8,11,11,38,47,-9,35
Sonderjyske,7752,6,8,6,10,28,29,-1,30
AC Horsens,7752,7,5,14,11,35,58,-23,29
Lyngby,7752,8,4,9,11,28,45,-17,21
Randers FC,7752,9,5,6,13,24,41,-17,21
Silkeborg IF,7752,10,6,3,13,26,44,-18,21
AGF Aarhus,7752,11,4,6,12,16,37,-21,18
Brondby,7753,1,23,5,2,75,31,44,74
FC Midtjylla,7753,2,18,6,6,65,40,25,60
FC Nords,7753,3,13,9,8,73,52,21,48
Copenhagen,7753,4,14,4,12,56,45,11,46
AC Horsens,7753,5,7,14,9,38,50,-12,35
Sonderjyske,7753,6,8,6,10,28,29,-1,30
AaB,7753,7,6,12,12,34,49,-15,30
Randers FC,7753,8,5,7,12,23,39,-16,22
Lyngby,7753,9,3,10,11,26,44,-18,19
Silkeborg IF,7753,10,5,4,13,27,46,-19,19
AGF Aarhus,7753,11,4,7,11,18,38,-20,19
Brondby,7754,1,21,6,3,75,34,41,69
FC Midtjylla,7754,2,18,6,6,61,39,22,60
FC Nords,7754,3,16,7,7,76,50,26,55
Copenhagen,7754,4,13,5,12,57,48,9,44
AaB,7754,5,8,12,10,40,44,-4,36
Sonderjyske,7754,6,8,6,10,28,29,-1,30
AC Horsens,7754,7,6,12,12,36,56,-20,30
Randers FC,7754,8,6,6,12,26,39,-13,24
AGF Aarhus,7754,9,5,6,11,17,36,-19,21
Silkeborg IF,7754,10,5,3,14,25,45,-20,18
Lyngby,7754,11,3,9,12,26,47,-21,18
FC Midtjylla,7755,1,22,4,4,73,40,33,70
Brondby,7755,2,21,6,3,68,29,39,69
FC Nords,7755,3,12,9,9,71,53,18,45
Copenhagen,7755,4,12,7,11,56,47,9,43
AaB,7755,5,7,14,9,41,45,-4,35
Sonderjyske,7755,6,8,6,10,28,29,-1,30
AC Horsens,7755,7,5,14,11,33,54,-21,29
Randers FC,7755,8,6,6,12,24,39,-15,24
Silkeborg IF,7755,9,6,3,13,28,44,-16,21
Lyngby,7755,10,3,9,12,26,45,-19,18
AGF Aarhus,7755,11,4,6,12,16,39,-23,18
Brondby,7756,1,20,5,5,67,34,33,65
FC Midtjylla,7756,2,19,5,6,67,39,28,62
FC Nords,7756,3,15,7,8,70,47,23,52
Copenhagen,7756,4,14,6,10,60,45,15,48
AC Horsens,7756,5,7,13,10,35,53,-18,34
AaB,7756,6,7,12,11,36,43,-7,33
Sonderjyske,7756,7,8,6,10,28,29,-1,30
Randers FC,7756,8,5,7,12,24,40,-16,22
AGF Aarhus,7756,9,5,6,11,17,36,-19,21
Lyngby,7756,10,3,10,11,27,45,-18,19
Silkeborg IF,7756,11,5,3,14,25,45,-20,18
Brondby,7757,1,20,7,3,68,29,39,67
FC Midtjylla,7757,2,18,6,6,62,41,21,60
FC Nords,7757,3,13,9,8,74,53,21,48
Copenhagen,7757,4,13,6,11,57,46,11,45
AaB,7757,5,7,15,8,36,38,-2,36
AC Horsens,7757,6,6,15,9,32,48,-16,33
Sonderjyske,7757,7,8,6,10,28,29,-1,30
Silkeborg IF,7757,8,6,3,13,28,44,-16,21
Lyngby,7757,9,4,9,11,28,45,-17,21
Randers FC,7757,10,5,6,13,24,41,-17,21
AGF Aarhus,7757,11,4,6,12,16,39,-23,18
Brondby,7758,1,20,7,3,72,33,39,67
FC Midtjylla,7758,2,18,5,7,63,41,22,59
FC Nords,7758,3,15,8,7,77,49,28,53
Copenhagen,7758,4,13,6,11,58,45,13,45
AaB,7758,5,8,12,10,37,48,-11,36
AC Horsens,7758,6,7,12,11,36,53,-17,33
Sonderjyske,7758,7,8,6,10,28,29,-1,30
Randers FC,7758,8,5,7,12,24,40,-16,22
Silkeborg IF,7758,9,6,3,13,28,44,-16,21
Lyngby,7758,10,3,10,11,27,45,-18,19
AGF Aarhus,7758,11,4,6,12,16,39,-23,18
Brondby,7759,1,22,5,3,72,30,42,71
FC Midtjylla,7759,2,21,4,5,67,35,32,67
Copenhagen,7759,3,14,4,12,56,48,8,46
FC Nords,7759,4,13,6,11,76,56,20,45
AaB,7759,5,9,12,9,38,39,-1,39
Sonderjyske,7759,6,8,6,10,28,29,-1,30
AC Horsens,7759,7,5,13,12,33,60,-27,28
Lyngby,7759,8,4,9,11,30,47,-17,21
Randers FC,7759,9,5,6,13,26,43,-17,21
Silkeborg IF,7759,10,5,4,13,26,45,-19,19
AGF Aarhus,7759,11,4,7,11,17,37,-20,19
FC Midtjylla,7760,1,21,5,4,73,39,34,68
Brondby,7760,2,19,7,4,67,34,33,64
FC Nords,7760,3,15,7,8,76,51,25,52
Copenhagen,7760,4,13,4,13,56,51,5,43
AaB,7760,5,7,13,10,37,46,-9,34
AC Horsens,7760,6,7,12,11,36,50,-14,33
Sonderjyske,7760,7,8,6,10,28,29,-1,30
Randers FC,7760,8,5,7,12,24,40,-16,22
AGF Aarhus,7760,9,5,6,11,19,38,-19,21
Lyngby,7760,10,3,10,11,27,45,-18,19
Silkeborg IF,7760,11,5,3,14,27,47,-20,18
FC Midtjylla,7761,1,20,4,6,67,40,27,64
Brondby,7761,2,19,6,5,68,35,33,63
Copenhagen,7761,3,16,4,10,61,43,18,52
FC Nords,7761,4,14,8,8,70,49,21,50
AaB,7761,5,7,12,11,36,41,-5,33
AC Horsens,7761,6,6,14,10,32,52,-20,32
Sonderjyske,7761,7,8,6,10,28,29,-1,30
Randers FC,7761,8,6,6,12,26,40,-14,24
Silkeborg IF,7761,9,5,4,13,25,44,-19,19
AGF Aarhus,7761,10,4,7,11,16,36,-20,19
Lyngby,7761,11,3,9,12,27,47,-20,18
Brondby,7762,1,23,5,2,75,29,46,74
FC Midtjylla,7762,2,20,5,5,71,40,31,65
FC Nords,7762,3,13,8,9,73,61,12,47
Copenhagen,7762,4,13,4,13,55,47,8,43
AaB,7762,5,7,13,10,38,43,-5,34
AC Horsens,7762,6,6,13,11,36,54,-18,31
Sonderjyske,7762,7,8,6,10,28,29,-1,30
Randers FC,7762,8,5,7,12,23,39,-16,22
Silkeborg IF,7762,9,6,3,13,27,45,-18,21
Lyngby,7762,10,3,10,11,26,44,-18,19
AGF Aarhus,7762,11,4,6,12,17,38,-21,18
FC Midtjylla,7763,1,21,5,4,72,37,35,68
Brondby,7763,2,20,7,3,67,31,36,67
FC Nords,7763,3,14,7,9,74,54,20,49
Copenhagen,7763,4,13,6,11,56,47,9,45
AaB,7763,5,7,12,11,36,43,-7,33
AC Horsens,7763,6,6,13,11,36,55,-19,31
Sonderjyske,7763,7,8,6,10,28,29,-1,30
Randers FC,7763,8,5,7,12,23,39,-16,22
Lyngby,7763,9,3,10,11,26,44,-18,19
Silkeborg IF,7763,10,5,4,13,25,44,-19,19
AGF Aarhus,7763,11,4,7,11,16,36,-20,19
Brondby,7764,1,21,5,4,82,38,44,68
FC Midtjylla,7764,2,19,5,6,66,44,22,62
FC Nords,7764,3,15,6,9,83,61,22,51
Copenhagen,7764,4,12,7,11,57,51,6,43
AaB,7764,5,8,12,10,42,45,-3,36
AC Horsens,7764,6,7,13,10,38,55,-17,34
Sonderjyske,7764,7,8,6,10,28,29,-1,30
Lyngby,7764,8,4,9,11,27,44,-17,21
Randers FC,7764,9,5,6,13,23,40,-17,21
Silkeborg IF,7764,10,6,3,13,26,44,-18,21
AGF Aarhus,7764,11,4,6,12,16,37,-21,18
Brondby,7765,1,20,7,3,67,29,38,67
FC Midtjylla,7765,2,18,7,5,59,35,24,61
Copenhagen,7765,3,14,6,10,62,47,15,48
FC Nords,7765,4,13,8,9,70,51,19,47
AC Horsens,7765,5,7,14,9,37,51,-14,35
AaB,7765,6,7,12,11,38,46,-8,33
Sonderjyske,7765,7,8,6,10,28,29,-1,30
Lyngby,7765,8,4,9,11,27,44,-17,21
Randers FC,7765,9,5,6,13,23,40,-17,21
AGF Aarhus,7765,10,5,6,11,18,37,-19,21
Silkeborg IF,7765,11,5,3,14,26,46,-20,18
Brondby,7766,1,21,5,4,70,33,37,68
FC Midtjylla,7766,2,21,4,5,71,39,32,67
FC Nords,7766,3,14,7,9,73,54,19,49
Copenhagen,7766,4,13,5,12,57,47,10,44
AaB,7766,5,7,13,10,37,42,-5,34
AC Horsens,7766,6,6,14,10,38,57,-19,32
Sonderjyske,7766,7,8,6,10,28,29,-1,30
Lyngby,7766,8,4,9,11,31,44,-13,21
Randers FC,7766,9,5,6,13,23,44,-21,21
Silkeborg IF,7766,10,5,4,13,26,45,-19,19
AGF Aarhus,7766,11,4,7,11,17,37,-20,19
Brondby,7767,1,20,7,3,71,34,37,67
FC Midtjylla,7767,2,19,7,4,67,37,30,64
Copenhagen,7767,3,15,6,9,67,42,25,51
FC Nords,7767,4,14,7,9,72,56,16,49
AaB,7767,5,7,12,11,35,48,-13,33
Sonderjyske,7767,6,8,6,10,28,29,-1,30
AC Horsens,7767,7,5,13,12,34,55,-21,28
Lyngby,7767,8,4,9,11,28,44,-16,21
Silkeborg IF,7767,9,6,3,13,27,44,-17,21
Randers FC,7767,10,5,6,13,23,41,-18,21
AGF Aarhus,7767,11,4,6,12,16,38,-22,18
Brondby,7768,1,21,6,3,75,35,40,69
FC Midtjylla,7768,2,20,5,5,67,37,30,65
FC Nords,7768,3,14,6,10,74,53,21,48
Copenhagen,7768,4,14,5,11,56,45,11,47
AaB,7768,5,9,11,10,39,46,-7,38
Sonderjyske,7768,6,8,6,10,28,29,-1,30
AC Horsens,7768,7,5,13,12,36,57,-21,28
Randers FC,7768,8,6,6,12,27,41,-14,24
Silkeborg IF,7768,9,5,4,13,26,45,-19,19
AGF Aarhus,7768,10,4,7,11,17,37,-20,19
Lyngby,7768,11,3,9,12,28,48,-20,18
Brondby,7769,1,22,5,3,78,31,47,71
FC Midtjylla,7769,2,20,5,5,65,37,28,65
Copenhagen,7769,3,13,6,11,51,40,11,45
FC Nords,7769,4,12,8,10,69,55,14,44
AC Horsens,7769,5,8,12,10,35,50,-15,36
AaB,7769,6,7,12,11,35,46,-11,33
Sonderjyske,7769,7,8,6,10,28,29,-1,30
Randers FC,7769,8,6,6,12,26,40,-14,24
Silkeborg IF,7769,9,6,3,13,26,44,-18,21
Lyngby,7769,10,3,9,12,27,47,-20,18
AGF Aarhus,7769,11,4,6,12,16,37,-21,18
Brondby,7770,1,21,6,3,75,32,43,69
FC Midtjylla,7770,2,18,4,8,63,41,22,58
Copenhagen,7770,3,16,5,9,62,41,21,53
FC Nords,7770,4,15,7,8,71,52,19,52
AaB,7770,5,7,12,11,35,42,-7,33
Sonderjyske,7770,6,8,6,10,28,29,-1,30
AC Horsens,7770,7,6,12,12,32,56,-24,30
Lyngby,7770,8,4,9,11,30,44,-14,21
Randers FC,7770,9,5,6,13,23,43,-20,21
Silkeborg IF,7770,10,5,4,13,27,46,-19,19
AGF Aarhus,7770,11,4,7,11,18,38,-20,19
FC Midtjylla,7771,1,21,5,4,71,39,32,68
Brondby,7771,2,19,8,3,68,33,35,65
FC Nords,7771,3,15,7,8,76,51,25,52
Copenhagen,7771,4,14,5,11,60,43,17,47
AC Horsens,7771,5,7,12,11,33,52,-19,33
Sonderjyske,7771,6,8,6,10,28,29,-1,30
AaB,7771,7,6,11,13,36,52,-16,29
Lyngby,7771,8,4,9,11,29,46,-17,21
Randers FC,7771,9,5,6,13,25,42,-17,21
Silkeborg IF,7771,10,6,3,13,27,45,-18,21
AGF Aarhus,7771,11,4,6,12,17,38,-21,18
Brondby,7772,1,20,6,4,69,34,35,66
FC Midtjylla,7772,2,17,8,5,62,39,23,59
Copenhagen,7772,3,14,6,10,59,45,14,48
FC Nords,7772,4,13,7,10,72,53,19,46
AaB,7772,5,8,12,10,40,45,-5,36
AC Horsens,7772,6,7,15,8,36,48,-12,36
Sonderjyske,7772,7,8,6,10,28,29,-1,30
Lyngby,7772,8,4,9,11,28,44,-16,21
Silkeborg IF,7772,9,6,3,13,27,45,-18,21
Randers FC,7772,10,5,6,13,23,41,-18,21
AGF Aarhus,7772,11,4,6,12,17,38,-21,18
Brondby,7773,1,22,5,3,72,30,42,71
FC Midtjylla,7773,2,21,4,5,68,39,29,67
FC Nords,7773,3,14,8,8,74,49,25,50
Copenhagen,7773,4,13,6,11,55,45,10,45
AaB,7773,5,6,13,11,38,47,-9,31
Sonderjyske,7773,6,8,6,10,28,29,-1,30
AC Horsens,7773,7,6,12,12,34,57,-23,30
Lyngby,7773,8,4,9,11,30,45,-15,21
Randers FC,7773,9,5,6,13,24,43,-19,21
Silkeborg IF,7773,10,5,4,13,25,44,-19,19
AGF Aarhus,7773,11,4,7,11,16,36,-20,19
Brondby,7774,1,22,5,3,75,32,43,71
FC Midtjylla,7774,2,19,6,5,64,39,25,63
FC Nords,7774,3,13,9,8,72,53,19,48
Copenhagen,7774,4,12,8,10,57,47,10,44
AaB,7774,5,6,15,9,36,42,-6,33
Sonderjyske,7774,6,8,6,10,28,29,-1,30
AC Horsens,7774,7,5,15,10,37,54,-17,30
Randers FC,7774,8,6,6,12,24,39,-15,24
Silkeborg IF,7774,9,6,3,13,27,44,-17,21
Lyngby,7774,10,3,9,12,26,45,-19,18
AGF Aarhus,7774,11,4,6,12,16,38,-22,18
FC Midtjylla,7775,1,21,4,5,73,37,36,67
Brondby,7775,2,20,6,4,67,31,36,66
FC Nords,7775,3,16,7,7,73,47,26,55
Copenhagen,7775,4,13,4,13,54,50,4,43
AC Horsens,7775,5,7,12,11,39,55,-16,33
AaB,7775,6,7,11,12,35,47,-12,32
Sonderjyske,7775,7,8,6,10,28,29,-1,30
Randers FC,7775,8,5,7,12,24,40,-16,22
Lyngby,7775,9,3,10,11,27,45,-18,19
Silkeborg IF,7775,10,5,4,13,26,45,-19,19
AGF Aarhus,7775,11,4,7,11,17,37,-20,19
Brondby,7776,1,20,7,3,66,29,37,67
FC Midtjylla,7776,2,20,5,5,64,37,27,65
FC Nords,7776,3,16,6,8,71,45,26,54
Copenhagen,7776,4,12,6,12,52,48,4,42
AC Horsens,7776,5,8,12,10,37,47,-10,36
Sonderjyske,7776,6,8,6,10,28,29,-1,30
AaB,7776,7,6,12,12,34,44,-10,30
Lyngby,7776,8,4,9,11,29,45,-16,21
Randers FC,7776,9,5,6,13,24,42,-18,21
Silkeborg IF,7776,10,5,4,13,26,45,-19,19
AGF Aarhus,7776,11,4,7,11,17,37,-20,19
Brondby,7777,1,21,6,3,72,34,38,69
FC Midtjylla,7777,2,19,4,7,62,42,20,61
FC Nords,7777,3,16,6,8,76,48,28,54
Copenhagen,7777,4,13,6,11,57,45,12,45
AaB,7777,5,8,11,11,40,45,-5,35
AC Horsens,7777,6,6,13,11,35,54,-19,31
Sonderjyske,7777,7,8,6,10,28,29,-1,30
Lyngby,7777,8,4,9,11,29,44,-15,21
Silkeborg IF,7777,9,6,3,13,26,44,-18,21
Randers FC,7777,10,5,6,13,23,42,-19,21
AGF Aarhus,7777,11,4,6,12,16,37,-21,18
Brondby,7778,1,22,6,2,79,32,47,72
FC Midtjylla,7778,2,18,5,7,70,46,24,59
FC Nords,7778,3,15,6,9,72,51,21,51
Copenhagen,7778,4,12,5,13,53,52,1,41
AaB,7778,5,10,11,9,44,45,-1,41
AC Horsens,7778,6,6,13,11,37,55,-18,31
Sonderjyske,7778,7,8,6,10,28,29,-1,30
Randers FC,7778,8,6,6,12,26,40,-14,24
Silkeborg IF,7778,9,6,3,13,27,45,-18,21
Lyngby,7778,10,3,9,12,27,47,-20,18
AGF Aarhus,7778,11,4,6,12,17,38,-21,18
Brondby,7779,1,22,5,3,71,32,39,71
FC Midtjylla,7779,2,19,4,7,65,42,23,61
FC Nords,7779,3,13,8,9,73,52,21,47
Copenhagen,7779,4,13,5,12,56,48,8,44
AaB,7779,5,9,11,10,42,44,-2,38
AC Horsens,7779,6,7,13,10,33,48,-15,34
Sonderjyske,7779,7,8,6,10,28,29,-1,30
Lyngby,7779,8,4,9,11,29,46,-17,21
Randers FC,7779,9,5,6,13,25,42,-17,21
AGF Aarhus,7779,10,5,6,11,17,36,-19,21
Silkeborg IF,7779,11,5,3,14,25,45,-20,18
Brondby,7780,1,22,5,3,70,31,39,71
FC Midtjylla,7780,2,19,6,5,68,40,28,63
FC Nords,7780,3,13,8,9,76,53,23,47
Copenhagen,7780,4,13,5,12,57,51,6,44
AaB,7780,5,7,13,10,38,42,-4,34
AC Horsens,7780,6,6,15,9,37,55,-18,33
Sonderjyske,7780,7,8,6,10,28,29,-1,30
Randers FC,7780,8,5,7,12,24,40,-16,22
Lyngby,7780,9,3,10,11,27,45,-18,19
Silkeborg IF,7780,10,5,4,13,25,44,-19,19
AGF Aarhus,7780,11,4,7,11,16,36,-20,19
Brondby,7781,1,21,7,2,73,32,41,70
FC Midtjylla,7781,2,21,4,5,67,37,30,67
FC Nords,7781,3,13,6,11,73,54,19,45
Copenhagen,7781,4,13,4,13,53,47,6,43
AC Horsens,7781,5,7,14,9,35,49,-14,35
AaB,7781,6,7,13,10,35,43,-8,34
Sonderjyske,7781,7,8,6,10,28,29,-1,30
Lyngby,7781,8,4,9,11,31,44,-13,21
Silkeborg IF,7781,9,6,3,13,26,44,-18,21
Randers FC,7781,10,5,6,13,23,44,-21,21
AGF Aarhus,7781,11,4,6,12,16,37,-21,18
Brondby,7782,1,22,5,3,71,31,40,71
FC Midtjylla,7782,2,18,5,7,67,47,20,59
FC Nords,7782,3,16,6,8,79,47,32,54
Copenhagen,7782,4,15,5,10,57,42,15,50
AaB,7782,5,8,11,11,37,42,-5,35
Sonderjyske,7782,6,8,6,10,28,29,-1,30
AC Horsens,7782,7,5,12,13,32,60,-28,27
Silkeborg IF,7782,8,6,3,13,29,44,-15,21
Lyngby,7782,9,4,9,11,27,44,-17,21
Randers FC,7782,10,5,6,13,23,40,-17,21
AGF Aarhus,7782,11,4,6,12,16,40,-24,18
Brondby,7783,1,21,6,3,75,33,42,69
FC Midtjylla,7783,2,21,5,4,68,34,34,68
FC Nords,7783,3,15,6,9,74,56,18,51
Copenhagen,7783,4,13,4,13,57,50,7,43
AaB,7783,5,9,11,10,39,41,-2,38
Sonderjyske,7783,6,8,6,10,28,29,-1,30
AC Horsens,7783,7,5,12,13,30,55,-25,27
Lyngby,7783,8,4,9,11,27,44,-17,21
Randers FC,7783,9,5,6,13,23,40,-17,21
Silkeborg IF,7783,10,6,3,13,27,45,-18,21
AGF Aarhus,7783,11,4,6,12,17,38,-21,18
Brondby,7784,1,20,7,3,73,35,38,67
FC Midtjylla,7784,2,20,5,5,66,42,24,65
FC Nords,7784,3,16,7,7,79,49,30,55
Copenhagen,7784,4,13,6,11,60,48,12,45
AaB,7784,5,6,13,11,34,42,-8,31
Sonderjyske,7784,6,8,6,10,28,29,-1,30
AC Horsens,7784,7,6,12,12,32,54,-22,30
Lyngby,7784,8,4,9,11,28,44,-16,21
Randers FC,7784,9,5,6,13,23,41,-18,21
AGF Aarhus,7784,10,5,6,11,18,36,-18,21
Silkeborg IF,7784,11,5,3,14,25,46,-21,18
Brondby,7785,1,21,5,4,70,34,36,68
FC Midtjylla,7785,2,19,6,5,68,38,30,63
FC Nords,7785,3,14,7,9,78,59,19,49
Copenhagen,7785,4,14,6,10,61,45,16,48
AaB,7785,5,8,12,10,41,42,-1,36
Sonderjyske,7785,6,8,6,10,28,29,-1,30
AC Horsens,7785,7,6,12,12,35,61,-26,30
Randers FC,7785,8,5,7,12,24,40,-16,22
Lyngby,7785,9,3,10,11,27,45,-18,19
Silkeborg IF,7785,10,5,4,13,26,45,-19,19
AGF Aarhus,7785,11,4,7,11,17,37,-20,19
FC Midtjylla,7786,1,21,5,4,65,33,32,68
Brondby,7786,2,20,5,5,74,35,39,65
FC Nords,7786,3,14,7,9,72,50,22,49
Copenhagen,7786,4,12,7,11,55,47,8,43
AaB,7786,5,8,13,9,36,39,-3,37
AC Horsens,7786,6,6,13,11,33,57,-24,31
Sonderjyske,7786,7,8,6,10,28,29,-1,30
Randers FC,7786,8,6,6,12,27,41,-14,24
Silkeborg IF,7786,9,6,3,13,27,45,-18,21
Lyngby,7786,10,3,9,12,28,48,-20,18
AGF Aarhus,7786,11,4,6,12,17,38,-21,18
Brondby,7787,1,22,5,3,76,34,42,71
FC Midtjylla,7787,2,20,6,4,69,39,30,66
Copenhagen,7787,3,15,5,10,65,44,21,50
FC Nords,7787,4,13,7,10,71,55,16,46
AaB,7787,5,7,11,12,34,45,-11,32
Sonderjyske,7787,6,8,6,10,28,29,-1,30
AC Horsens,7787,7,6,12,12,31,55,-24,30
Randers FC,7787,8,6,6,12,24,39,-15,24
Silkeborg IF,7787,9,6,3,13,26,44,-18,21
Lyngby,7787,10,3,9,12,26,45,-19,18
AGF Aarhus,7787,11,4,6,12,16,37,-21,18
FC Midtjylla,7788,1,20,5,5,67,39,28,65
Brondby,7788,2,19,7,4,65,32,33,64
Copenhagen,7788,3,15,6,9,60,42,18,51
FC Nords,7788,4,14,7,9,74,53,21,49
AaB,7788,5,8,12,10,36,38,-2,36
Sonderjyske,7788,6,8,6,10,28,29,-1,30
AC Horsens,7788,7,5,13,12,33,57,-24,28
Lyngby,7788,8,4,9,11,27,44,-17,21
Randers FC,7788,9,5,6,13,23,40,-17,21
Silkeborg IF,7788,10,5,4,13,26,45,-19,19
AGF Aarhus,7788,11,4,7,11,17,37,-20,19
Brondby,7789,1,22,5,3,73,35,38,71
FC Midtjylla,7789,2,20,4,6,67,41,26,64
FC Nords,7789,3,15,7,8,76,50,26,52
Copenhagen,7789,4,15,5,10,61,43,18,50
Sonderjyske,7789,5,8,6,10,28,29,-1,30
AC Horsens,7789,6,6,12,12,31,52,-21,30
AaB,7789,7,6,11,13,35,48,-13,29
Lyngby,7789,8,4,9,11,29,45,-16,21
Randers FC,7789,9,5,6,13,24,42,-18,21
Silkeborg IF,7789,10,5,4,13,26,45,-19,19
AGF Aarhus,7789,11,4,7,11,17,37,-20,19
Brondby,7790,1,21,6,3,68,31,37,69
FC Midtjylla,7790,2,19,5,6,62,38,24,62
FC Nords,7790,3,13,9,8,75,54,21,48
Copenhagen,7790,4,14,4,12,56,45,11,46
AaB,7790,5,8,12,10,40,42,-2,36
AC Horsens,7790,6,7,12,11,38,55,-17,33
Sonderjyske,7790,7,8,6,10,28,29,-1,30
Lyngby,7790,8,4,9,11,29,45,-16,21
Silkeborg IF,7790,9,6,3,13,28,45,-17,21
Randers FC,7790,10,5,6,13,24,42,-18,21
AGF Aarhus,7790,11,4,6,12,17,39,-22,18
Brondby,7791,1,23,5,2,71,29,42,74
FC Midtjylla,7791,2,19,6,5,63,38,25,63
FC Nords,7791,3,14,7,9,71,53,18,49
Copenhagen,7791,4,13,4,13,56,46,10,43
AaB,7791,5,8,12,10,40,41,-1,36
Sonderjyske,7791,6,8,6,10,28,29,-1,30
AC Horsens,7791,7,6,12,12,32,52,-20,30
Lyngby,7791,8,4,9,11,28,44,-16,21
Randers FC,7791,9,5,6,13,23,41,-18,21
AGF Aarhus,7791,10,5,6,11,19,37,-18,21
Silkeborg IF,7791,11,5,3,14,26,47,-21,18
Brondby,7792,1,22,5,3,70,31,39,71
FC Midtjylla,7792,2,19,6,5,68,41,27,63
FC Nords,7792,3,14,6,10,68,47,21,48
Copenhagen,7792,4,13,5,12,54,43,11,44
AaB,7792,5,7,13,10,35,42,-7,34
AC Horsens,7792,6,7,13,10,35,52,-17,34
Sonderjyske,7792,7,8,6,10,28,29,-1,30
Randers FC,7792,8,6,6,12,24,39,-15,24
Silkeborg IF,7792,9,5,4,13,25,44,-19,19
AGF Aarhus,7792,10,4,7,11,16,36,-20,19
Lyngby,7792,11,3,9,12,26,45,-19,18
Brondby,7793,1,22,5,3,80,31,49,71
FC Midtjylla,7793,2,19,4,7,62,39,23,61
Copenhagen,7793,3,15,4,11,60,46,14,49
FC Nords,7793,4,13,6,11,70,58,12,45
AC Horsens,7793,5,8,12,10,38,53,-15,36
AaB,7793,6,8,11,11,39,48,-9,35
Sonderjyske,7793,7,8,6,10,28,29,-1,30
Randers FC,7793,8,6,6,12,27,39,-12,24
Silkeborg IF,7793,9,6,3,13,27,44,-17,21
Lyngby,7793,10,3,9,12,26,48,-22,18
AGF Aarhus,7793,11,4,6,12,16,38,-22,18
Brondby,7794,1,20,5,5,75,39,36,65
FC Midtjylla,7794,2,20,5,5,67,40,27,65
FC Nords,7794,3,14,6,10,68,60,8,48
Copenhagen,7794,4,14,5,11,56,44,12,47
AaB,7794,5,8,14,8,48,42,6,38
AC Horsens,7794,6,6,13,11,38,53,-15,31
Sonderjyske,7794,7,8,6,10,28,29,-1,30
Randers FC,7794,8,6,6,12,25,40,-15,24
Silkeborg IF,7794,9,6,3,13,28,44,-16,21
Lyngby,7794,10,3,9,12,27,46,-19,18
AGF Aarhus,7794,11,4,6,12,16,39,-23,18
Brondby,7795,1,21,6,3,73,31,42,69
FC Midtjylla,7795,2,20,4,6,69,41,28,64
FC Nords,7795,3,16,6,8,75,51,24,54
Copenhagen,7795,4,13,5,12,56,45,11,44
AC Horsens,7795,5,7,12,11,33,50,-17,33
AaB,7795,6,7,11,12,37,51,-14,32
Sonderjyske,7795,7,8,6,10,28,29,-1,30
Lyngby,7795,8,4,9,11,29,44,-15,21
Silkeborg IF,7795,9,6,3,13,26,44,-18,21
Randers FC,7795,10,5,6,13,23,42,-19,21
AGF Aarhus,7795,11,4,6,12,16,37,-21,18
Brondby,7796,1,22,5,3,71,30,41,71
FC Midtjylla,7796,2,21,4,5,65,34,31,67
FC Nords,7796,3,14,6,10,68,49,19,48
Copenhagen,7796,4,14,4,12,59,46,13,46
AaB,7796,5,9,11,10,35,41,-6,38
Sonderjyske,7796,6,8,6,10,28,29,-1,30
AC Horsens,7796,7,5,12,13,32,56,-24,27
Randers FC,7796,8,5,7,12,24,40,-16,22
Lyngby,7796,9,3,10,11,27,45,-18,19
Silkeborg IF,7796,10,5,4,13,27,46,-19,19
AGF Aarhus,7796,11,4,7,11,18,38,-20,19
Brondby,7797,1,20,6,4,72,32,40,66
FC Midtjylla,7797,2,20,4,6,63,37,26,64
FC Nords,7797,3,14,8,8,77,51,26,50
Copenhagen,7797,4,15,4,11,56,44,12,49
AaB,7797,5,7,12,11,37,49,-12,33
AC Horsens,7797,6,7,12,11,36,54,-18,33
Sonderjyske,7797,7,8,6,10,28,29,-1,30
Lyngby,7797,8,4,9,11,29,46,-17,21
Randers FC,7797,9,5,6,13,25,42,-17,21
AGF Aarhus,7797,10,5,6,11,19,37,-18,21
Silkeborg IF,7797,11,5,3,14,26,47,-21,18
Brondby,7798,1,20,6,4,69,31,38,66
FC Midtjylla,7798,2,20,5,5,67,40,27,65
FC Nords,7798,3,14,6,10,69,53,16,48
Copenhagen,7798,4,14,5,11,59,45,14,47
AaB,7798,5,8,13,9,41,43,-2,37
AC Horsens,7798,6,6,13,11,36,55,-19,31
Sonderjyske,7798,7,8,6,10,28,29,-1,30
Randers FC,7798,8,6,6,12,25,39,-14,24
Silkeborg IF,7798,9,6,3,13,29,44,-15,21
Lyngby,7798,10,3,9,12,26,46,-20,18
AGF Aarhus,7798,11,4,6,12,16,40,-24,18
Brondby,7799,1,21,6,3,72,30,42,69
FC Midtjylla,7799,2,20,5,5,66,38,28,65
Copenhagen,7799,3,16,4,10,61,45,16,52
FC Nords,7799,4,13,7,10,73,55,18,46
AC Horsens,7799,5,6,14,10,36,53,-17,32
Sonderjyske,7799,6,8,6,10,28,29,-1,30
AaB,7799,7,6,12,12,32,45,-13,30
Randers FC,7799,8,5,7,12,24,40,-16,22
AGF Aarhus,7799,9,5,6,11,17,36,-19,21
Lyngby,7799,10,3,10,11,27,45,-18,19
Silkeborg IF,7799,11,5,3,14,25,45,-20,18
Brondby,7800,1,23,5,2,72,28,44,74
FC Midtjylla,7800,2,20,4,6,63,35,28,64
FC Nords,7800,3,14,7,9,70,52,18,49
Copenhagen,7800,4,13,6,11,54,43,11,45
AaB,7800,5,7,13,10,35,40,-5,34
Sonderjyske,7800,6,8,6,10,28,29,-1,30
AC Horsens,7800,7,5,13,12,32,54,-22,28
Lyngby,7800,8,4,9,11,28,44,-16,21
Randers FC,7800,9,5,6,13,23,41,-18,21
AGF Aarhus,7800,10,5,6,11,20,39,-19,21
Silkeborg IF,7800,11,5,3,14,28,48,-20,18
Brondby,7801,1,21,7,2,70,28,42,70
FC Midtjylla,7801,2,19,5,6,67,42,25,62
FC Nords,7801,3,14,7,9,70,51,19,49
Copenhagen,7801,4,15,4,11,57,42,15,49
AaB,7801,5,7,12,11,33,43,-10,33
Sonderjyske,7801,6,8,6,10,28,29,-1,30
AC Horsens,7801,7,5,15,10,31,48,-17,30
Randers FC,7801,8,6,6,12,24,39,-15,24
AGF Aarhus,7801,9,5,6,11,17,36,-19,21
Lyngby,7801,10,3,9,12,26,45,-19,18
Silkeborg IF,7801,11,5,3,14,25,45,-20,18
Brondby,7802,1,20,5,5,72,35,37,65
FC Midtjylla,7802,2,18,5,7,62,41,21,59
Copenhagen,7802,3,15,5,10,61,45,16,50
FC Nords,7802,4,13,7,10,76,58,18,46
AaB,7802,5,9,12,9,41,41,0,39
AC Horsens,7802,6,8,12,10,34,52,-18,36
Sonderjyske,7802,7,8,6,10,28,29,-1,30
Lyngby,7802,8,4,9,11,29,44,-15,21
Silkeborg IF,7802,8,6,3,13,29,44,-15,21
Randers FC,7802,10,5,6,13,23,42,-19,21
AGF Aarhus,7802,11,4,6,12,16,40,-24,18
FC Midtjylla,7803,1,21,4,5,73,41,32,67
Brondby,7803,2,20,5,5,74,40,34,65
Copenhagen,7803,3,16,4,10,61,40,21,52
FC Nords,7803,4,12,7,11,73,59,14,43
AaB,7803,5,9,11,10,36,41,-5,38
AC Horsens,7803,6,6,13,11,33,55,-22,31
Sonderjyske,7803,7,8,6,10,28,29,-1,30
Randers FC,7803,8,5,7,12,23,39,-16,22
Lyngby,7803,9,3,10,11,26,44,-18,19
Silkeborg IF,7803,10,5,4,13,27,46,-19,19
AGF Aarhus,7803,11,4,7,11,18,38,-20,19
Brondby,7804,1,22,5,3,71,29,42,71
FC Midtjylla,7804,2,20,5,5,65,38,27,65
FC Nords,7804,3,15,6,9,73,50,23,51
Copenhagen,7804,4,12,7,11,55,45,10,43
AaB,7804,5,7,13,10,38,45,-7,34
Sonderjyske,7804,6,8,6,10,28,29,-1,30
AC Horsens,7804,7,5,14,11,34,55,-21,29
Randers FC,7804,8,5,7,12,24,40,-16,22
AGF Aarhus,7804,9,5,6,11,18,37,-19,21
Lyngby,7804,10,3,10,11,27,45,-18,19
Silkeborg IF,7804,11,5,3,14,26,46,-20,18
Brondby,7805,1,20,7,3,65,31,34,67
FC Midtjylla,7805,2,20,6,4,67,37,30,66
FC Nords,7805,3,14,6,10,69,51,18,48
Copenhagen,7805,4,13,7,10,57,44,13,46
AC Horsens,7805,5,7,13,10,39,53,-14,34
AaB,7805,6,7,11,12,36,43,-7,32
Sonderjyske,7805,7,8,6,10,28,29,-1,30
Randers FC,7805,8,5,7,12,23,39,-16,22
Lyngby,7805,9,3,10,11,26,44,-18,19
Silkeborg IF,7805,10,5,4,13,26,45,-19,19
AGF Aarhus,7805,11,4,7,11,17,37,-20,19
Brondby,7806,1,19,7,4,67,34,33,64
FC Midtjylla,7806,2,19,6,5,69,42,27,63
FC Nords,7806,3,15,6,9,78,56,22,51
Copenhagen,7806,4,13,5,12,58,50,8,44
AaB,7806,5,8,12,10,39,42,-3,36
AC Horsens,7806,6,8,12,10,35,48,-13,36
Sonderjyske,7806,7,8,6,10,28,29,-1,30
Lyngby,7806,8,4,9,11,29,44,-15,21
Randers FC,7806,9,5,6,13,23,42,-19,21
Silkeborg IF,7806,10,5,4,13,26,45,-19,19
AGF Aarhus,7806,11,4,7,11,17,37,-20,19
FC Midtjylla,7807,1,21,4,5,67,40,27,67
Brondby,7807,2,20,5,5,73,37,36,65
FC Nords,7807,3,15,7,8,79,50,29,52
Copenhagen,7807,4,15,6,9,62,43,19,51
Sonderjyske,7807,5,8,6,10,28,29,-1,30
AaB,7807,6,6,12,12,34,49,-15,30
AC Horsens,7807,7,6,12,12,34,56,-22,30
Randers FC,7807,8,6,6,12,24,39,-15,24
Silkeborg IF,7807,9,6,3,13,29,45,-16,21
Lyngby,7807,10,3,9,12,26,45,-19,18
AGF Aarhus,7807,11,4,6,12,17,40,-23,18
Brondby,7808,1,22,6,2,70,29,41,72
FC Midtjylla,7808,2,19,6,5,65,40,25,63
FC Nords,7808,3,13,8,9,76,55,21,47
Copenhagen,7808,4,12,5,13,57,50,7,41
AaB,7808,5,7,14,9,35,41,-6,35
AC Horsens,7808,6,7,13,10,37,51,-14,34
Sonderjyske,7808,7,8,6,10,28,29,-1,30
Randers FC,7808,8,5,7,12,23,39,-16,22
Lyngby,7808,9,3,10,11,26,44,-18,19
Silkeborg IF,7808,10,5,4,13,26,45,-19,19
AGF Aarhus,7808,11,4,7,11,17,37,-20,19
Brondby,7809,1,21,6,3,72,33,39,69
FC Midtjylla,7809,2,19,6,5,64,38,26,63
FC Nords,7809,3,15,6,9,72,52,20,51
Copenhagen,7809,4,13,6,11,56,44,12,45
AaB,7809,5,7,12,11,36,44,-8,33
AC Horsens,7809,6,7,12,11,36,51,-15,33
Sonderjyske,7809,7,8,6,10,28,29,-1,30
Lyngby,7809,8,4,9,11,28,45,-17,21
Randers FC,7809,9,5,6,13,24,41,-17,21
Silkeborg IF,7809,10,6,3,13,26,44,-18,21
AGF Aarhus,7809,11,4,6,12,16,37,-21,18
Brondby,7810,1,23,5,2,70,27,43,74
FC Midtjylla,7810,2,19,6,5,65,40,25,63
FC Nords,7810,3,14,7,9,74,53,21,49
Copenhagen,7810,4,12,5,13,53,44,9,41
AC Horsens,7810,5,7,13,10,35,52,-17,34
AaB,7810,6,6,14,10,34,41,-7,32
Sonderjyske,7810,7,8,6,10,28,29,-1,30
Randers FC,7810,8,5,7,12,24,40,-16,22
Lyngby,7810,9,3,10,11,27,45,-18,19
Silkeborg IF,7810,10,5,4,13,25,44,-19,19
AGF Aarhus,7810,11,4,7,11,16,36,-20,19
Brondby,7811,1,20,7,3,67,32,35,67
FC Midtjylla,7811,2,19,6,5,67,38,29,63
FC Nords,7811,3,14,7,9,68,51,17,49
Copenhagen,7811,4,12,5,13,55,47,8,41
AaB,7811,5,9,12,9,39,40,-1,39
AC Horsens,7811,6,7,13,10,34,48,-14,34
Sonderjyske,7811,7,8,6,10,28,29,-1,30
AGF Aarhus,7811,8,5,6,11,22,37,-15,21
Lyngby,7811,9,4,9,11,27,44,-17,21
Randers FC,7811,10,5,6,13,23,40,-17,21
Silkeborg IF,7811,11,5,3,14,26,50,-24,18
Brondby,7812,1,20,6,4,65,30,35,66
FC Midtjylla,7812,2,19,5,6,66,42,24,62
Copenhagen,7812,3,15,5,10,61,43,18,50
FC Nords,7812,4,12,9,9,74,55,19,45
AaB,7812,5,8,12,10,38,45,-7,36
AC Horsens,7812,6,7,13,10,37,52,-15,34
Sonderjyske,7812,7,8,6,10,28,29,-1,30
Randers FC,7812,8,5,7,12,23,39,-16,22
Silkeborg IF,7812,9,6,3,13,27,45,-18,21
Lyngby,7812,10,3,10,11,26,44,-18,19
AGF Aarhus,7812,11,4,6,12,17,38,-21,18
Brondby,7813,1,21,6,3,71,32,39,69
FC Midtjylla,7813,2,18,4,8,65,44,21,58
FC Nords,7813,3,15,7,8,78,51,27,52
Copenhagen,7813,4,15,4,11,59,46,13,49
AC Horsens,7813,5,7,13,10,36,54,-18,34
AaB,7813,6,7,12,11,38,46,-8,33
Sonderjyske,7813,7,8,6,10,28,29,-1,30
Randers FC,7813,8,5,7,12,26,42,-16,22
Lyngby,7813,9,3,10,11,29,47,-18,19
Silkeborg IF,7813,10,5,4,13,26,45,-19,19
AGF Aarhus,7813,11,4,7,11,17,37,-20,19
Brondby,7814,1,20,7,3,70,32,38,67
FC Midtjylla,7814,2,20,5,5,60,35,25,65
FC Nords,7814,3,15,7,8,77,50,27,52
Copenhagen,7814,4,12,6,12,55,46,9,42
AaB,7814,5,7,13,10,36,43,-7,34
AC Horsens,7814,6,7,12,11,32,50,-18,33
Sonderjyske,7814,7,8,6,10,28,29,-1,30
Randers FC,7814,8,5,7,12,24,40,-16,22
Silkeborg IF,7814,9,6,3,13,27,45,-18,21
Lyngby,7814,10,3,10,11,27,45,-18,19
AGF Aarhus,7814,11,4,6,12,17,38,-21,18
Brondby,7815,1,22,6,2,72,30,42,72
FC Midtjylla,7815,2,20,4,6,69,42,27,64
FC Nords,7815,3,14,7,9,78,51,27,49
Copenhagen,7815,4,15,4,11,60,49,11,49
AaB,7815,5,7,12,11,38,46,-8,33
Sonderjyske,7815,6,8,6,10,28,29,-1,30
AC Horsens,7815,7,5,13,12,32,57,-25,28
Randers FC,7815,8,6,6,12,27,40,-13,24
Silkeborg IF,7815,9,5,4,13,25,44,-19,19
AGF Aarhus,7815,10,4,7,11,16,36,-20,19
Lyngby,7815,11,3,9,12,27,48,-21,18
Brondby,7816,1,21,5,4,73,31,42,68
FC Midtjylla,7816,2,18,5,7,65,42,23,59
FC Nords,7816,3,15,7,8,76,53,23,52
Copenhagen,7816,4,13,6,11,57,45,12,45
AaB,7816,5,8,12,10,38,45,-7,36
AC Horsens,7816,6,7,13,10,34,53,-19,34
Sonderjyske,7816,7,8,6,10,28,29,-1,30
Randers FC,7816,8,5,7,12,23,39,-16,22
AGF Aarhus,7816,9,5,6,11,18,36,-18,21
Lyngby,7816,10,3,10,11,26,44,-18,19
Silkeborg IF,7816,11,5,3,14,25,46,-21,18
Brondby,7817,1,21,5,4,70,32,38,68
FC Midtjylla,7817,2,20,6,4,67,38,29,66
FC Nords,7817,3,13,8,9,71,51,20,47
Copenhagen,7817,4,13,7,10,56,44,12,46
AaB,7817,5,8,12,10,38,43,-5,36
Sonderjyske,7817,6,8,6,10,28,29,-1,30
AC Horsens,7817,7,5,14,11,32,52,-20,29
Randers FC,7817,8,6,6,12,25,39,-14,24
AGF Aarhus,7817,9,5,6,11,19,36,-17,21
Lyngby,7817,10,3,9,12,26,46,-20,18
Silkeborg IF,7817,11,5,3,14,25,47,-22,18
Brondby,7818,1,20,7,3,67,32,35,67
FC Midtjylla,7818,2,21,4,5,69,37,32,67
FC Nords,7818,3,14,6,10,75,58,17,48
Copenhagen,7818,4,14,5,11,56,43,13,47
AaB,7818,5,7,12,11,40,47,-7,33
AC Horsens,7818,6,7,12,11,39,55,-16,33
Sonderjyske,7818,7,8,6,10,28,29,-1,30
Randers FC,7818,8,6,6,12,25,40,-15,24
AGF Aarhus,7818,9,5,6,11,18,36,-18,21
Lyngby,7818,10,3,9,12,27,46,-19,18
Silkeborg IF,7818,11,5,3,14,25,46,-21,18
Brondby,7819,1,22,6,2,70,28,42,72
FC Midtjylla,7819,2,18,7,5,65,41,24,61
Copenhagen,7819,3,14,6,10,57,44,13,48
FC Nords,7819,4,13,6,11,74,59,15,45
AaB,7819,5,7,13,10,34,38,-4,34
AC Horsens,7819,6,6,14,10,39,55,-16,32
Sonderjyske,7819,7,8,6,10,28,29,-1,30
Randers FC,7819,8,6,6,12,27,40,-13,24
Silkeborg IF,7819,9,6,3,13,26,44,-18,21
Lyngby,7819,10,3,9,12,27,48,-21,18
AGF Aarhus,7819,11,4,6,12,16,37,-21,18
Brondby,7820,1,19,8,3,69,33,36,65
FC Midtjylla,7820,2,19,5,6,63,38,25,62
FC Nords,7820,3,15,7,8,73,49,24,52
Copenhagen,7820,4,14,5,11,55,42,13,47
AaB,7820,5,8,12,10,35,40,-5,36
AC Horsens,7820,6,6,13,11,36,55,-19,31
Sonderjyske,7820,7,8,6,10,28,29,-1,30
Lyngby,7820,8,4,9,11,27,44,-17,21
Randers FC,7820,9,5,6,13,23,40,-17,21
Silkeborg IF,7820,10,6,3,13,29,47,-18,21
AGF Aarhus,7820,11,4,6,12,19,40,-21,18
Brondby,7821,1,20,7,3,72,34,38,67
FC Midtjylla,7821,2,21,4,5,71,36,35,67
FC Nords,7821,3,14,8,8,73,54,19,50
Copenhagen,7821,4,14,6,10,57,41,16,48
AaB,7821,5,6,13,11,33,45,-12,31
Sonderjyske,7821,6,8,6,10,28,29,-1,30
AC Horsens,7821,7,5,14,11,35,57,-22,29
Randers FC,7821,8,6,6,12,25,40,-15,24
Silkeborg IF,7821,9,5,4,13,25,44,-19,19
AGF Aarhus,7821,10,4,7,11,16,36,-20,19
Lyngby,7821,11,3,9,12,27,46,-19,18
Brondby,7822,1,19,7,4,69,34,35,64
FC Midtjylla,7822,2,18,5,7,65,42,23,59
FC Nords,7822,3,15,6,9,75,54,21,51
Copenhagen,7822,4,15,5,10,61,44,17,50
AaB,7822,5,9,11,10,38,40,-2,38
AC Horsens,7822,6,7,12,11,34,54,-20,33
Sonderjyske,7822,7,8,6,10,28,29,-1,30
Lyngby,7822,8,4,9,11,30,44,-14,21
Silkeborg IF,7822,9,6,3,13,29,44,-15,21
Randers FC,7822,10,5,6,13,23,43,-20,21
AGF Aarhus,7822,11,4,6,12,16,40,-24,18
Brondby,7823,1,21,7,2,74,30,44,70
FC Midtjylla,7823,2,21,5,4,71,36,35,68
FC Nords,7823,3,12,9,9,72,55,17,45
Copenhagen,7823,4,13,6,11,58,47,11,45
AaB,7823,5,8,11,11,37,45,-8,35
Sonderjyske,7823,6,8,6,10,28,29,-1,30
AC Horsens,7823,7,5,14,11,32,57,-25,29
Lyngby,7823,8,4,9,11,30,46,-16,21
Randers FC,7823,9,5,6,13,25,43,-18,21
Silkeborg IF,7823,10,5,4,13,27,46,-19,19
AGF Aarhus,7823,11,4,7,11,18,38,-20,19
FC Midtjylla,7824,1,20,5,5,66,38,28,65
Brondby,7824,2,19,7,4,67,32,35,64
Copenhagen,7824,3,16,4,10,58,41,17,52
FC Nords,7824,4,14,7,9,69,48,21,49
AaB,7824,5,8,11,11,37,42,-5,35
Sonderjyske,7824,6,8,6,10,28,29,-1,30
AC Horsens,7824,7,5,14,11,31,53,-22,29
Randers FC,7824,8,5,7,12,26,42,-16,22
Silkeborg IF,7824,9,6,3,13,30,45,-15,21
Lyngby,7824,10,3,10,11,29,47,-18,19
AGF Aarhus,7824,11,4,6,12,17,41,-24,18
Brondby,7825,1,21,6,3,71,34,37,69
FC Midtjylla,7825,2,21,4,5,70,40,30,67
Copenhagen,7825,3,14,5,11,57,43,14,47
FC Nords,7825,4,13,7,10,71,54,17,46
AaB,7825,5,7,12,11,38,44,-6,33
AC Horsens,7825,6,6,14,10,35,53,-18,32
Sonderjyske,7825,7,8,6,10,28,29,-1,30
Randers FC,7825,8,6,6,12,24,39,-15,24
AGF Aarhus,7825,9,5,6,11,20,37,-17,21
Lyngby,7825,10,3,9,12,26,45,-19,18
Silkeborg IF,7825,11,5,3,14,26,48,-22,18
Brondby,7826,1,21,5,4,71,34,37,68
FC Midtjylla,7826,2,21,4,5,71,36,35,67
FC Nords,7826,3,15,6,9,76,53,23,51
Copenhagen,7826,4,14,4,12,55,48,7,46
AC Horsens,7826,5,7,12,11,37,53,-16,33
AaB,7826,6,7,11,12,37,49,-12,32
Sonderjyske,7826,7,8,6,10,28,29,-1,30
Lyngby,7826,8,4,9,11,27,44,-17,21
Randers FC,7826,9,5,6,13,23,40,-17,21
Silkeborg IF,7826,10,5,4,13,28,47,-19,19
AGF Aarhus,7826,11,4,7,11,19,39,-20,19
Brondby,7827,1,22,6,2,75,31,44,72
FC Midtjylla,7827,2,21,4,5,68,39,29,67
FC Nords,7827,3,15,6,9,74,53,21,51
Copenhagen,7827,4,12,7,11,54,44,10,43
AC Horsens,7827,5,6,13,11,33,55,-22,31
Sonderjyske,7827,6,8,6,10,28,29,-1,30
AaB,7827,7,6,12,12,35,43,-8,30
Lyngby,7827,8,4,9,11,29,44,-15,21
Randers FC,7827,9,5,6,13,23,42,-19,21
Silkeborg IF,7827,10,5,4,13,26,45,-19,19
AGF Aarhus,7827,11,4,7,11,17,37,-20,19
Brondby,7828,1,20,6,4,68,34,34,66
FC Midtjylla,7828,2,20,4,6,65,39,26,64
FC Nords,7828,3,15,6,9,72,50,22,51
Copenhagen,7828,4,15,4,11,58,43,15,49
AaB,7828,5,8,11,11,39,42,-3,35
AC Horsens,7828,6,6,13,11,36,56,-20,31
Sonderjyske,7828,7,8,6,10,28,29,-1,30
Lyngby,7828,8,4,9,11,29,44,-15,21
Silkeborg IF,7828,9,6,3,13,27,45,-18,21
Randers FC,7828,10,5,6,13,23,42,-19,21
AGF Aarhus,7828,11,4,6,12,17,38,-21,18
Brondby,7829,1,20,6,4,68,32,36,66
FC Midtjylla,7829,2,17,5,8,62,48,14,56
FC Nords,7829,3,14,7,9,73,52,21,49
Copenhagen,7829,4,15,4,11,60,42,18,49
AaB,7829,5,8,13,9,40,43,-3,37
AC Horsens,7829,6,8,13,9,36,48,-12,37
Sonderjyske,7829,7,8,6,10,28,29,-1,30
Lyngby,7829,8,4,9,11,28,45,-17,21
Randers FC,7829,9,5,6,13,24,41,-17,21
Silkeborg IF,7829,10,6,3,13,26,44,-18,21
AGF Aarhus,7829,11,4,6,12,16,37,-21,18
Brondby,7830,1,20,6,4,71,33,38,66
FC Midtjylla,7830,2,19,6,5,65,41,24,63
FC Nords,7830,3,16,6,8,74,48,26,54
Copenhagen,7830,4,15,5,10,61,43,18,50
AaB,7830,5,7,11,12,36,46,-10,32
Sonderjyske,7830,6,8,6,10,28,29,-1,30
AC Horsens,7830,7,6,12,12,34,56,-22,30
Lyngby,7830,8,4,9,11,27,44,-17,21
Randers FC,7830,9,5,6,13,23,40,-17,21
AGF Aarhus,7830,10,5,6,11,18,36,-18,21
Silkeborg IF,7830,11,5,3,14,25,46,-21,18
Brondby,7831,1,22,6,2,70,30,40,72
FC Midtjylla,7831,2,17,8,5,62,40,22,59
Copenhagen,7831,3,13,7,10,60,46,14,46
FC Nords,7831,4,12,9,9,68,51,17,45
AaB,7831,5,7,13,10,35,40,-5,34
AC Horsens,7831,6,6,15,9,35,49,-14,33
Sonderjyske,7831,7,8,6,10,28,29,-1,30
Randers FC,7831,8,5,7,12,24,40,-16,22
Silkeborg IF,7831,9,6,3,13,28,45,-17,21
Lyngby,7831,10,3,10,11,27,45,-18,19
AGF Aarhus,7831,11,4,6,12,17,39,-22,18
Brondby,7832,1,22,5,3,70,32,38,71
FC Midtjylla,7832,2,19,4,7,67,41,26,61
Copenhagen,7832,3,16,4,10,59,41,18,52
FC Nords,7832,4,14,6,10,71,54,17,48
AC Horsens,7832,5,7,12,11,39,52,-13,33
AaB,7832,6,7,11,12,35,47,-12,32
Sonderjyske,7832,7,8,6,10,28,29,-1,30
Lyngby,7832,8,4,9,11,28,44,-16,21
Randers FC,7832,9,5,6,13,23,41,-18,21
AGF Aarhus,7832,10,5,6,11,18,37,-19,21
Silkeborg IF,7832,11,5,3,14,26,46,-20,18
Brondby,7833,1,21,6,3,70,32,38,69
FC Midtjylla,7833,2,20,4,6,64,39,25,64
Copenhagen,7833,3,15,4,11,59,45,14,49
FC Nords,7833,4,14,6,10,75,53,22,48
AaB,7833,5,8,11,11,37,42,-5,35
AC Horsens,7833,6,6,13,11,31,51,-20,31
Sonderjyske,7833,7,8,6,10,28,29,-1,30
Lyngby,7833,8,4,9,11,27,44,-17,21
Randers FC,7833,9,5,6,13,23,40,-17,21
AGF Aarhus,7833,10,5,6,11,18,37,-19,21
Silkeborg IF,7833,11,5,3,14,26,46,-20,18
Brondby,7834,1,21,7,2,67,29,38,70
FC Midtjylla,7834,2,19,5,6,67,43,24,62
Copenhagen,7834,3,15,6,9,60,42,18,51
FC Nords,7834,4,12,8,10,72,55,17,44
AaB,7834,5,7,13,10,38,43,-5,34
AC Horsens,7834,6,6,13,11,33,51,-18,31
Sonderjyske,7834,7,8,6,10,28,29,-1,30
Lyngby,7834,8,4,9,11,28,44,-16,21
Silkeborg IF,7834,9,6,3,13,27,45,-18,21
Randers FC,7834,10,5,6,13,23,41,-18,21
AGF Aarhus,7834,11,4,6,12,17,38,-21,18
Brondby,7835,1,20,6,4,73,33,40,66
FC Midtjylla,7835,2,20,4,6,61,37,24,64
FC Nords,7835,3,15,7,8,77,52,25,52
Copenhagen,7835,4,13,5,12,53,43,10,44
AC Horsens,7835,5,8,13,9,37,49,-12,37
AaB,7835,6,7,11,12,35,48,-13,32
Sonderjyske,7835,7,8,6,10,28,29,-1,30
Lyngby,7835,8,4,9,11,29,44,-15,21
Randers FC,7835,9,5,6,13,23,42,-19,21
AGF Aarhus,7835,10,5,6,11,17,36,-19,21
Silkeborg IF,7835,11,5,3,14,25,45,-20,18
Brondby,7836,1,21,6,3,73,31,42,69
FC Midtjylla,7836,2,19,4,7,66,44,22,61
FC Nords,7836,3,14,7,9,69,55,14,49
Copenhagen,7836,4,14,5,11,58,45,13,47
AC Horsens,7836,5,9,13,8,43,50,-7,40
Sonderjyske,7836,6,8,6,10,28,29,-1,30
AaB,7836,7,6,11,13,35,45,-10,29
Randers FC,7836,8,6,6,12,26,40,-14,24
Silkeborg IF,7836,9,6,3,13,26,44,-18,21
Lyngby,7836,10,3,9,12,27,47,-20,18
AGF Aarhus,7836,11,4,6,12,16,37,-21,18
Brondby,7837,1,20,7,3,70,30,40,67
FC Midtjylla,7837,2,20,6,4,66,36,30,66
Copenhagen,7837,3,13,6,11,57,49,8,45
FC Nords,7837,4,12,6,12,73,63,10,42
AaB,7837,5,8,14,8,41,40,1,38
AC Horsens,7837,6,6,15,9,35,50,-15,33
Sonderjyske,7837,7,8,6,10,28,29,-1,30
Silkeborg IF,7837,8,6,3,13,29,45,-16,21
Lyngby,7837,9,4,9,11,28,44,-16,21
Randers FC,7837,10,5,6,13,23,41,-18,21
AGF Aarhus,7837,11,4,6,12,17,40,-23,18
Brondby,7838,1,19,6,5,68,35,33,63
FC Midtjylla,7838,2,19,5,6,65,44,21,62
FC Nords,7838,3,15,7,8,75,50,25,52
Copenhagen,7838,4,14,6,10,55,40,15,48
AaB,7838,5,7,13,10,35,40,-5,34
AC Horsens,7838,6,7,13,10,38,53,-15,34
Sonderjyske,7838,7,8,6,10,28,29,-1,30
Randers FC,7838,8,5,7,12,23,39,-16,22
Silkeborg IF,7838,9,6,3,13,29,44,-15,21
Lyngby,7838,10,3,10,11,26,44,-18,19
AGF Aarhus,7838,11,4,6,12,16,40,-24,18
Brondby,7839,1,22,5,3,75,33,42,71
FC Midtjylla,7839,2,19,4,7,65,44,21,61
FC Nords,7839,3,14,7,9,78,57,21,49
Copenhagen,7839,4,14,5,11,60,48,12,47
AC Horsens,7839,5,7,13,10,39,53,-14,34
AaB,7839,6,6,14,10,37,45,-8,32
Sonderjyske,7839,7,8,6,10,28,29,-1,30
Lyngby,7839,8,4,9,11,28,44,-16,21
Randers FC,7839,9,5,6,13,23,41,-18,21
Silkeborg IF,7839,10,5,4,13,27,46,-19,19
AGF Aarhus,7839,11,4,7,11,18,38,-20,19
Brondby,7840,1,22,6,2,75,29,46,72
FC Midtjylla,7840,2,20,5,5,66,38,28,65
FC Nords,7840,3,15,6,9,76,54,22,51
Copenhagen,7840,4,13,4,13,54,49,5,43
AC Horsens,7840,5,7,12,11,35,53,-18,33
AaB,7840,6,7,11,12,37,46,-9,32
Sonderjyske,7840,7,8,6,10,28,29,-1,30
Lyngby,7840,8,4,9,11,28,44,-16,21
Silkeborg IF,7840,9,6,3,13,28,45,-17,21
Randers FC,7840,10,5,6,13,23,41,-18,21
AGF Aarhus,7840,11,4,6,12,17,39,-22,18
Brondby,7841,1,21,6,3,74,32,42,69
FC Midtjylla,7841,2,18,6,6,65,41,24,60
FC Nords,7841,3,15,6,9,78,56,22,51
Copenhagen,7841,4,15,4,11,60,47,13,49
AC Horsens,7841,5,7,13,10,36,52,-16,34
AaB,7841,6,7,11,12,36,47,-11,32
Sonderjyske,7841,7,8,6,10,28,29,-1,30
Randers FC,7841,8,5,7,12,25,41,-16,22
AGF Aarhus,7841,9,5,6,11,19,38,-19,21
Lyngby,7841,10,3,10,11,28,46,-18,19
Silkeborg IF,7841,11,5,3,14,27,47,-20,18
Brondby,7842,1,20,6,4,74,37,37,66
FC Midtjylla,7842,2,18,6,6,65,41,24,60
FC Nords,7842,3,15,7,8,74,51,23,52
Copenhagen,7842,4,13,6,11,61,51,10,45
AaB,7842,5,8,13,9,37,39,-2,37
AC Horsens,7842,6,7,12,11,33,51,-18,33
Sonderjyske,7842,7,8,6,10,28,29,-1,30
Randers FC,7842,8,5,7,12,25,41,-16,22
Lyngby,7842,9,3,10,11,28,46,-18,19
Silkeborg IF,7842,10,5,4,13,28,47,-19,19
AGF Aarhus,7842,11,4,7,11,19,39,-20,19
Brondby,7843,1,21,5,4,68,34,34,68
FC Midtjylla,7843,2,20,5,5,72,44,28,65
FC Nords,7843,3,15,7,8,77,50,27,52
Copenhagen,7843,4,14,5,11,58,45,13,47
AaB,7843,5,7,12,11,34,42,-8,33
Sonderjyske,7843,6,8,6,10,28,29,-1,30
AC Horsens,7843,7,6,12,12,33,53,-20,30
Lyngby,7843,8,4,9,11,27,44,-17,21
Randers FC,7843,9,5,6,13,23,40,-17,21
AGF Aarhus,7843,10,5,6,11,18,37,-19,21
Silkeborg IF,7843,11,5,3,14,26,46,-20,18
Brondby,7844,1,18,7,5,70,40,30,61
FC Midtjylla,7844,2,18,7,5,65,39,26,61
Copenhagen,7844,3,15,5,10,60,44,16,50
FC Nords,7844,4,13,8,9,69,49,20,47
AaB,7844,5,10,12,8,44,40,4,42
AC Horsens,7844,6,6,13,11,35,57,-22,31
Sonderjyske,7844,7,8,6,10,28,29,-1,30
Lyngby,7844,8,4,9,11,28,45,-17,21
Randers FC,7844,9,5,6,13,24,41,-17,21
Silkeborg IF,7844,10,6,3,13,26,44,-18,21
AGF Aarhus,7844,11,4,6,12,16,37,-21,18
Brondby,7845,1,19,8,3,70,35,35,65
FC Midtjylla,7845,2,18,8,4,62,37,25,62
FC Nords,7845,3,14,7,9,72,52,20,49
Copenhagen,7845,4,13,7,10,57,43,14,46
AC Horsens,7845,5,7,15,8,37,50,-13,36
AaB,7845,6,6,13,11,34,41,-7,31
Sonderjyske,7845,7,8,6,10,28,29,-1,30
Randers FC,7845,8,6,6,12,25,40,-15,24
Silkeborg IF,7845,9,5,4,13,26,45,-19,19
AGF Aarhus,7845,10,4,7,11,17,37,-20,19
Lyngby,7845,11,3,9,12,27,46,-19,18
Brondby,7846,1,20,8,2,68,28,40,68
FC Midtjylla,7846,2,20,5,5,67,42,25,65
FC Nords,7846,3,13,8,9,76,55,21,47
Copenhagen,7846,4,12,7,11,57,47,10,43
AaB,7846,5,7,13,10,39,44,-5,34
AC Horsens,7846,6,7,13,10,40,57,-17,34
Sonderjyske,7846,7,8,6,10,28,29,-1,30
Randers FC,7846,8,5,7,12,25,41,-16,22
Lyngby,7846,9,3,10,11,28,46,-18,19
Silkeborg IF,7846,10,5,4,13,27,46,-19,19
AGF Aarhus,7846,11,4,7,11,18,38,-20,19
Brondby,7847,1,22,5,3,76,33,43,71
FC Midtjylla,7847,2,20,5,5,67,40,27,65
FC Nords,7847,3,15,6,9,77,52,25,51
Copenhagen,7847,4,13,4,13,57,48,9,43
AaB,7847,5,8,11,11,37,44,-7,35
AC Horsens,7847,6,6,13,11,36,59,-23,31
Sonderjyske,7847,7,8,6,10,28,29,-1,30
Silkeborg IF,7847,8,6,3,13,28,44,-16,21
Lyngby,7847,9,4,9,11,28,45,-17,21
Randers FC,7847,10,5,6,13,24,41,-17,21
AGF Aarhus,7847,11,4,6,12,16,39,-23,18
Brondby,7848,1,21,6,3,67,32,35,69
FC Midtjylla,7848,2,19,5,6,67,41,26,62
FC Nords,7848,3,15,7,8,76,52,24,52
Copenhagen,7848,4,14,5,11,61,46,15,47
AaB,7848,5,6,14,10,36,43,-7,32
AC Horsens,7848,6,6,13,11,36,55,-19,31
Sonderjyske,7848,7,8,6,10,28,29,-1,30
Randers FC,7848,8,6,6,12,24,39,-15,24
AGF Aarhus,7848,9,5,6,11,18,37,-19,21
Lyngby,7848,10,3,9,12,26,45,-19,18
Silkeborg IF,7848,11,5,3,14,26,46,-20,18
FC Midtjylla,7849,1,21,4,5,70,41,29,67
Brondby,7849,2,20,5,5,71,39,32,65
FC Nords,7849,3,16,6,8,80,52,28,54
Copenhagen,7849,4,14,5,11,57,43,14,47
AC Horsens,7849,5,7,13,10,37,52,-15,34
Sonderjyske,7849,6,8,6,10,28,29,-1,30
AaB,7849,7,6,11,13,36,50,-14,29
Randers FC,7849,8,5,7,12,23,39,-16,22
Lyngby,7849,9,3,10,11,26,44,-18,19
Silkeborg IF,7849,10,5,4,13,27,46,-19,19
AGF Aarhus,7849,11,4,7,11,18,38,-20,19
FC Midtjylla,7850,1,21,4,5,69,41,28,67
Brondby,7850,2,20,6,4,73,36,37,66
FC Nords,7850,3,14,7,9,75,55,20,49
Copenhagen,7850,4,13,5,12,59,49,10,44
AC Horsens,7850,5,8,12,10,39,50,-11,36
AaB,7850,6,7,12,11,34,44,-10,33
Sonderjyske,7850,7,8,6,10,28,29,-1,30
Randers FC,7850,8,6,6,12,25,40,-15,24
AGF Aarhus,7850,9,5,6,11,17,36,-19,21
Lyngby,7850,10,3,9,12,27,46,-19,18
Silkeborg IF,7850,11,5,3,14,25,45,-20,18
Brondby,7851,1,20,6,4,73,37,36,66
FC Midtjylla,7851,2,19,5,6,63,41,22,62
FC Nords,7851,3,15,6,9,73,50,23,51
Copenhagen,7851,4,15,5,10,61,43,18,50
AaB,7851,5,7,14,9,37,41,-4,35
Sonderjyske,7851,6,8,6,10,28,29,-1,30
AC Horsens,7851,7,5,14,11,33,54,-21,29
Randers FC,7851,8,5,7,12,24,40,-16,22
Silkeborg IF,7851,9,6,3,13,28,46,-18,21
Lyngby,7851,10,3,10,11,27,45,-18,19
AGF Aarhus,7851,11,4,6,12,18,39,-21,18
FC Midtjylla,7852,1,21,4,5,66,38,28,67
Brondby,7852,2,19,7,4,68,34,34,64
Copenhagen,7852,3,15,5,10,60,41,19,50
FC Nords,7852,4,13,7,10,71,55,16,46
AaB,7852,5,9,11,10,42,44,-2,38
Sonderjyske,7852,6,8,6,10,28,29,-1,30
AC Horsens,7852,7,5,14,11,31,52,-21,29
Randers FC,7852,8,5,7,12,23,39,-16,22
Lyngby,7852,9,3,10,11,26,44,-18,19
Silkeborg IF,7852,10,5,4,13,26,45,-19,19
AGF Aarhus,7852,11,4,7,11,17,37,-20,19
Brondby,7853,1,21,5,4,68,33,35,68
FC Midtjylla,7853,2,18,6,6,64,40,24,60
FC Nords,7853,3,14,8,8,73,48,25,50
Copenhagen,7853,4,14,5,11,54,44,10,47
AaB,7853,5,7,13,10,34,41,-7,34
AC Horsens,7853,6,7,13,10,36,49,-13,34
Sonderjyske,7853,7,8,6,10,28,29,-1,30
Randers FC,7853,8,5,7,12,24,40,-16,22
Lyngby,7853,9,3,10,11,27,45,-18,19
Silkeborg IF,7853,10,5,4,13,28,47,-19,19
AGF Aarhus,7853,11,4,7,11,19,39,-20,19
Brondby,7854,1,22,6,2,78,31,47,72
FC Midtjylla,7854,2,20,4,6,69,40,29,64
FC Nords,7854,3,14,6,10,74,54,20,48
Copenhagen,7854,4,14,5,11,59,48,11,47
AC Horsens,7854,5,7,12,11,36,52,-16,33
AaB,7854,6,7,11,12,38,55,-17,32
Sonderjyske,7854,7,8,6,10,28,29,-1,30
Randers FC,7854,8,6,6,12,27,42,-15,24
AGF Aarhus,7854,9,5,6,11,19,37,-18,21
Lyngby,7854,10,3,9,12,29,48,-19,18
Silkeborg IF,7854,11,5,3,14,26,47,-21,18
Brondby,7855,1,21,5,4,71,31,40,68
FC Midtjylla,7855,2,20,4,6,62,37,25,64
FC Nords,7855,3,15,6,9,75,51,24,51
Copenhagen,7855,4,13,5,12,55,49,6,44
AC Horsens,7855,5,8,12,10,38,51,-13,36
AaB,7855,6,7,12,11,35,43,-8,33
Sonderjyske,7855,7,8,6,10,28,29,-1,30
Lyngby,7855,8,4,9,11,31,47,-16,21
Silkeborg IF,7855,9,6,3,13,27,44,-17,21
Randers FC,7855,10,5,6,13,26,44,-18,21
AGF Aarhus,7855,11,4,6,12,16,38,-22,18
Brondby,7856,1,19,9,2,68,32,36,66
FC Midtjylla,7856,2,19,5,6,66,41,25,62
FC Nords,7856,3,15,6,9,78,51,27,51
Copenhagen,7856,4,14,6,10,57,44,13,48
AaB,7856,5,7,12,11,35,42,-7,33
AC Horsens,7856,6,6,14,10,35,55,-20,32
Sonderjyske,7856,7,8,6,10,28,29,-1,30
Lyngby,7856,8,4,9,11,29,45,-16,21
Randers FC,7856,9,5,6,13,24,42,-18,21
Silkeborg IF,7856,10,5,4,13,27,46,-19,19
AGF Aarhus,7856,11,4,7,11,18,38,-20,19
Brondby,7857,1,21,6,3,71,31,40,69
FC Midtjylla,7857,2,20,4,6,68,38,30,64
Copenhagen,7857,3,14,5,11,54,41,13,47
FC Nords,7857,4,13,7,10,71,58,13,46
AaB,7857,5,8,12,10,38,42,-4,36
AC Horsens,7857,6,6,14,10,36,54,-18,32
Sonderjyske,7857,7,8,6,10,28,29,-1,30
Lyngby,7857,8,4,9,11,29,45,-16,21
Randers FC,7857,9,5,6,13,24,42,-18,21
Silkeborg IF,7857,10,5,4,13,26,45,-19,19
AGF Aarhus,7857,11,4,7,11,17,37,-20,19
Brondby,7858,1,21,6,3,75,32,43,69
FC Midtjylla,7858,2,21,4,5,74,38,36,67
FC Nords,7858,3,14,6,10,73,58,15,48
Copenhagen,7858,4,13,6,11,61,49,12,45
AaB,7858,5,8,11,11,34,46,-12,35
AC Horsens,7858,6,6,13,11,33,53,-20,31
Sonderjyske,7858,7,8,6,10,28,29,-1,30
Randers FC,7858,8,5,7,12,24,40,-16,22
AGF Aarhus,7858,9,5,6,11,18,37,-19,21
Lyngby,7858,10,3,10,11,27,45,-18,19
Silkeborg IF,7858,11,5,3,14,26,46,-20,18
Brondby,7859,1,21,5,4,71,33,38,68
FC Midtjylla,7859,2,19,4,7,64,39,25,61
Copenhagen,7859,3,15,5,10,57,39,18,50
FC Nords,7859,4,13,7,10,68,53,15,46
AaB,7859,5,8,12,10,38,42,-4,36
AC Horsens,7859,6,7,13,10,36,54,-18,34
Sonderjyske,7859,7,8,6,10,28,29,-1,30
Lyngby,7859,8,4,9,11,28,45,-17,21
Randers FC,7859,9,5,6,13,24,41,-17,21
Silkeborg IF,7859,10,5,4,13,26,45,-19,19
AGF Aarhus,7859,11,4,7,11,17,37,-20,19
Brondby,7860,1,20,7,3,71,33,38,67
FC Midtjylla,7860,2,20,6,4,66,38,28,66
FC Nords,7860,3,13,10,7,73,51,22,49
Copenhagen,7860,4,13,6,11,57,45,12,45
AaB,7860,5,8,12,10,36,41,-5,36
Sonderjyske,7860,6,8,6,10,28,29,-1,30
AC Horsens,7860,7,5,13,12,33,54,-21,28
Lyngby,7860,8,4,9,11,29,45,-16,21
Randers FC,7860,9,5,6,13,24,42,-18,21
AGF Aarhus,7860,10,5,6,11,19,37,-18,21
Silkeborg IF,7860,11,5,3,14,26,47,-21,18
Brondby,7861,1,20,7,3,68,31,37,67
FC Midtjylla,7861,2,20,5,5,71,39,32,65
FC Nords,7861,3,16,6,8,76,50,26,54
Copenhagen,7861,4,14,4,12,59,44,15,46
AaB,7861,5,8,11,11,35,43,-8,35
Sonderjyske,7861,6,8,6,10,28,29,-1,30
AC Horsens,7861,7,5,13,12,33,61,-28,28
Randers FC,7861,8,6,6,12,26,39,-13,24
AGF Aarhus,7861,9,5,6,11,18,37,-19,21
Silkeborg IF,7861,10,5,3,14,26,46,-20,18
Lyngby,7861,11,3,9,12,26,47,-21,18
Brondby,7862,1,20,6,4,70,34,36,66
FC Midtjylla,7862,2,18,6,6,63,40,23,60
FC Nords,7862,3,15,8,7,79,52,27,53
Copenhagen,7862,4,14,5,11,57,47,10,47
AaB,7862,5,8,12,10,39,43,-4,36
AC Horsens,7862,6,6,13,11,34,52,-18,31
Sonderjyske,7862,7,8,6,10,28,29,-1,30
Randers FC,7862,8,6,6,12,24,39,-15,24
AGF Aarhus,7862,9,5,6,11,17,36,-19,21
Lyngby,7862,10,3,9,12,26,45,-19,18
Silkeborg IF,7862,11,5,3,14,25,45,-20,18
Brondby,7863,1,20,5,5,67,32,35,65
FC Midtjylla,7863,2,20,5,5,65,43,22,65
Copenhagen,7863,3,16,4,10,64,46,18,52
FC Nords,7863,4,13,6,11,72,53,19,45
AaB,7863,5,9,11,10,41,43,-2,38
AC Horsens,7863,6,6,13,11,34,52,-18,31
Sonderjyske,7863,7,8,6,10,28,29,-1,30
Randers FC,7863,8,5,7,12,25,41,-16,22
Silkeborg IF,7863,9,6,3,13,28,45,-17,21
Lyngby,7863,10,3,10,11,28,46,-18,19
AGF Aarhus,7863,11,4,6,12,17,39,-22,18
Brondby,7864,1,22,6,2,72,31,41,72
FC Midtjylla,7864,2,19,6,5,65,40,25,63
Copenhagen,7864,3,15,5,10,59,43,16,50
FC Nords,7864,4,13,6,11,72,56,16,45
AC Horsens,7864,5,7,12,11,36,54,-18,33
AaB,7864,6,7,11,12,35,41,-6,32
Sonderjyske,7864,7,8,6,10,28,29,-1,30
Randers FC,7864,8,6,6,12,25,39,-14,24
Silkeborg IF,7864,9,6,3,13,27,44,-17,21
Lyngby,7864,10,3,9,12,26,46,-20,18
AGF Aarhus,7864,11,4,6,12,16,38,-22,18
FC Midtjylla,7865,1,20,5,5,70,36,34,65
Brondby,7865,2,19,7,4,66,30,36,64
FC Nords,7865,3,15,7,8,71,46,25,52
Copenhagen,7865,4,14,5,11,55,46,9,47
AaB,7865,5,7,13,10,35,44,-9,34
AC Horsens,7865,6,6,13,11,33,54,-21,31
Sonderjyske,7865,7,8,6,10,28,29,-1,30
Randers FC,7865,8,6,6,12,24,39,-15,24
AGF Aarhus,7865,9,5,6,11,18,36,-18,21
Lyngby,7865,10,3,9,12,26,45,-19,18
Silkeborg IF,7865,11,5,3,14,25,46,-21,18
Brondby,7866,1,22,5,3,73,30,43,71
FC Midtjylla,7866,2,21,4,5,70,41,29,67
Copenhagen,7866,3,15,5,10,58,43,15,50
FC Nords,7866,4,12,7,11,72,58,14,43
AaB,7866,5,7,13,10,35,44,-9,34
Sonderjyske,7866,6,8,6,10,28,29,-1,30
AC Horsens,7866,7,6,12,12,37,55,-18,30
Randers FC,7866,8,5,7,12,25,41,-16,22
Silkeborg IF,7866,9,6,3,13,26,44,-18,21
Lyngby,7866,10,3,10,11,28,46,-18,19
AGF Aarhus,7866,11,4,6,12,16,37,-21,18
Brondby,7867,1,21,5,4,67,31,36,68
FC Midtjylla,7867,2,21,5,4,68,38,30,68
FC Nords,7867,3,14,8,8,71,49,22,50
Copenhagen,7867,4,12,6,12,55,45,10,42
AaB,7867,5,7,14,9,33,38,-5,35
Sonderjyske,7867,6,8,6,10,28,29,-1,30
AC Horsens,7867,7,5,14,11,35,54,-19,29
Silkeborg IF,7867,8,6,3,13,28,45,-17,21
Lyngby,7867,9,4,9,11,27,44,-17,21
Randers FC,7867,10,5,6,13,23,40,-17,21
AGF Aarhus,7867,11,4,6,12,17,39,-22,18
Brondby,7868,1,21,6,3,76,32,44,69
FC Midtjylla,7868,2,21,4,5,73,39,34,67
Copenhagen,7868,3,15,5,10,63,45,18,50
FC Nords,7868,4,12,7,11,71,64,7,43
AaB,7868,5,8,11,11,39,45,-6,35
Sonderjyske,7868,6,8,6,10,28,29,-1,30
AC Horsens,7868,7,5,15,10,32,55,-23,30
Silkeborg IF,7868,8,6,3,13,28,44,-16,21
Lyngby,7868,9,4,9,11,27,44,-17,21
Randers FC,7868,10,5,6,13,23,40,-17,21
AGF Aarhus,7868,11,4,6,12,16,39,-23,18
Brondby,7869,1,22,5,3,76,33,43,71
FC Midtjylla,7869,2,19,5,6,65,40,25,62
FC Nords,7869,3,15,6,9,75,48,27,51
Copenhagen,7869,4,14,4,12,57,46,11,46
AaB,7869,5,8,12,10,38,45,-7,36
Sonderjyske,7869,6,8,6,10,28,29,-1,30
AC Horsens,7869,7,5,14,11,33,58,-25,29
Lyngby,7869,8,4,9,11,27,44,-17,21
Randers FC,7869,9,5,6,13,23,40,-17,21
AGF Aarhus,7869,10,5,6,11,17,36,-19,21
Silkeborg IF,7869,11,5,3,14,25,45,-20,18
FC Midtjylla,7870,1,21,4,5,67,37,30,67
Brondby,7870,2,20,6,4,70,35,35,66
Copenhagen,7870,3,15,4,11,56,43,13,49
FC Nords,7870,4,13,7,10,70,50,20,46
AaB,7870,5,8,12,10,38,42,-4,36
AC Horsens,7870,6,6,13,11,35,55,-20,31
Sonderjyske,7870,7,8,6,10,28,29,-1,30
Lyngby,7870,8,4,9,11,31,46,-15,21
Silkeborg IF,7870,9,6,3,13,27,45,-18,21
Randers FC,7870,10,5,6,13,25,44,-19,21
AGF Aarhus,7870,11,4,6,12,17,38,-21,18
Brondby,7871,1,20,6,4,70,31,39,66
FC Midtjylla,7871,2,19,6,5,62,38,24,63
FC Nords,7871,3,14,7,9,80,53,27,49
Copenhagen,7871,4,15,4,11,56,44,12,49
AaB,7871,5,9,12,9,38,44,-6,39
Sonderjyske,7871,6,8,6,10,28,29,-1,30
AC Horsens,7871,7,5,13,12,32,54,-22,28
Silkeborg IF,7871,8,6,3,13,28,45,-17,21
Lyngby,7871,9,4,9,11,27,44,-17,21
Randers FC,7871,10,5,6,13,23,40,-17,21
AGF Aarhus,7871,11,4,6,12,17,39,-22,18
Brondby,7872,1,21,6,3,72,35,37,69
FC Midtjylla,7872,2,20,4,6,69,37,32,64
FC Nords,7872,3,14,8,8,74,52,22,50
Copenhagen,7872,4,15,5,10,59,44,15,50
AC Horsens,7872,5,6,13,11,35,56,-21,31
Sonderjyske,7872,6,8,6,10,28,29,-1,30
AaB,7872,7,6,12,12,33,44,-11,30
Lyngby,7872,8,4,9,11,29,45,-16,21
Randers FC,7872,9,5,6,13,24,42,-18,21
AGF Aarhus,7872,10,5,6,11,18,37,-19,21
Silkeborg IF,7872,11,5,3,14,26,46,-20,18
FC Midtjylla,7873,1,20,6,4,63,35,28,66
Brondby,7873,2,19,8,3,67,31,36,65
FC Nords,7873,3,14,6,10,77,54,23,48
Copenhagen,7873,4,13,5,12,53,46,7,44
AaB,7873,5,7,14,9,40,43,-3,35
AC Horsens,7873,6,7,13,10,33,50,-17,34
Sonderjyske,7873,7,8,6,10,28,29,-1,30
Randers FC,7873,8,6,6,12,26,40,-14,24
Silkeborg IF,7873,9,6,3,13,27,44,-17,21
Lyngby,7873,10,3,9,12,27,47,-20,18
AGF Aarhus,7873,11,4,6,12,16,38,-22,18
Brondby,7874,1,23,5,2,74,29,45,74
FC Midtjylla,7874,2,20,5,5,66,40,26,65
FC Nords,7874,3,14,7,9,75,51,24,49
Copenhagen,7874,4,13,5,12,55,44,11,44
AC Horsens,7874,5,7,12,11,34,54,-20,33
Sonderjyske,7874,6,8,6,10,28,29,-1,30
AaB,7874,7,6,12,12,37,49,-12,30
Randers FC,7874,8,6,6,12,25,40,-15,24
Silkeborg IF,7874,9,6,3,13,28,44,-16,21
Lyngby,7874,10,3,9,12,27,46,-19,18
AGF Aarhus,7874,11,4,6,12,16,39,-23,18
Brondby,7875,1,21,6,3,70,30,40,69
FC Midtjylla,7875,2,20,5,5,67,35,32,65
FC Nords,7875,3,15,6,9,76,52,24,51
Copenhagen,7875,4,13,4,13,55,51,4,43
AaB,7875,5,8,11,11,38,46,-8,35
AC Horsens,7875,6,6,14,10,34,52,-18,32
Sonderjyske,7875,7,8,6,10,28,29,-1,30
Randers FC,7875,8,5,7,12,25,41,-16,22
Lyngby,7875,9,3,10,11,28,46,-18,19
Silkeborg IF,7875,10,5,4,13,25,44,-19,19
AGF Aarhus,7875,11,4,7,11,16,36,-20,19
Brondby,7876,1,21,5,4,76,38,38,68
FC Midtjylla,7876,2,20,5,5,69,41,28,65
FC Nords,7876,3,15,7,8,81,54,27,52
Copenhagen,7876,4,14,5,11,59,45,14,47
AC Horsens,7876,5,6,14,10,35,53,-18,32
Sonderjyske,7876,6,8,6,10,28,29,-1,30
AaB,7876,7,6,12,12,33,48,-15,30
Silkeborg IF,7876,8,6,3,13,28,45,-17,21
Lyngby,7876,9,4,9,11,27,44,-17,21
Randers FC,7876,10,5,6,13,23,40,-17,21
AGF Aarhus,7876,11,4,6,12,17,39,-22,18
FC Midtjylla,7877,1,22,4,4,68,38,30,70
Brondby,7877,2,20,7,3,69,32,37,67
FC Nords,7877,3,13,8,9,71,53,18,47
Copenhagen,7877,4,13,5,12,54,43,11,44
AC Horsens,7877,5,6,15,9,36,49,-13,33
AaB,7877,6,6,13,11,34,43,-9,31
Sonderjyske,7877,7,8,6,10,28,29,-1,30
Randers FC,7877,8,6,6,12,25,39,-14,24
Silkeborg IF,7877,9,6,3,13,28,44,-16,21
Lyngby,7877,10,3,9,12,26,46,-20,18
AGF Aarhus,7877,11,4,6,12,16,39,-23,18
Brondby,7878,1,22,6,2,75,32,43,72
FC Midtjylla,7878,2,19,5,6,64,40,24,62
FC Nords,7878,3,15,6,9,74,51,23,51
Copenhagen,7878,4,14,5,11,61,48,13,47
AaB,7878,5,6,13,11,35,46,-11,31
AC Horsens,7878,6,6,13,11,37,55,-18,31
Sonderjyske,7878,7,8,6,10,28,29,-1,30
Randers FC,7878,8,5,7,12,24,40,-16,22
Silkeborg IF,7878,9,6,3,13,26,44,-18,21
Lyngby,7878,10,3,10,11,27,45,-18,19
AGF Aarhus,7878,11,4,6,12,16,37,-21,18
Brondby,7879,1,21,6,3,75,35,40,69
FC Midtjylla,7879,2,19,5,6,61,37,24,62
Copenhagen,7879,3,15,5,10,59,43,16,50
FC Nords,7879,4,14,7,9,72,54,18,49
AaB,7879,5,7,12,11,33,40,-7,33
AC Horsens,7879,6,6,13,11,36,53,-17,31
Sonderjyske,7879,7,8,6,10,28,29,-1,30
Randers FC,7879,8,5,7,12,24,40,-16,22
Lyngby,7879,9,3,10,11,27,45,-18,19
Silkeborg IF,7879,10,5,4,13,25,44,-19,19
AGF Aarhus,7879,11,4,7,11,16,36,-20,19
Brondby,7880,1,22,5,3,72,32,40,71
FC Midtjylla,7880,2,18,6,6,67,49,18,60
FC Nords,7880,3,16,6,8,81,48,33,54
Copenhagen,7880,4,14,5,11,58,51,7,47
AaB,7880,5,7,12,11,37,45,-8,33
Sonderjyske,7880,6,8,6,10,28,29,-1,30
AC Horsens,7880,7,6,12,12,37,53,-16,30
Lyngby,7880,8,4,9,11,31,44,-13,21
Silkeborg IF,7880,9,6,3,13,29,44,-15,21
Randers FC,7880,10,5,6,13,23,44,-21,21
AGF Aarhus,7880,11,4,6,12,16,40,-24,18
FC Midtjylla,7881,1,21,5,4,72,39,33,68
Brondby,7881,2,20,6,4,72,36,36,66
FC Nords,7881,3,13,7,10,69,52,17,46
Copenhagen,7881,4,13,5,12,59,47,12,44
AC Horsens,7881,5,8,12,10,37,53,-16,36
AaB,7881,6,8,11,11,38,46,-8,35
Sonderjyske,7881,7,8,6,10,28,29,-1,30
Randers FC,7881,8,6,6,12,25,39,-14,24
Silkeborg IF,7881,9,5,4,13,28,47,-19,19
AGF Aarhus,7881,10,4,7,11,19,39,-20,19
Lyngby,7881,11,3,9,12,26,46,-20,18
Brondby,7882,1,21,7,2,71,32,39,70
FC Midtjylla,7882,2,19,5,6,65,38,27,62
FC Nords,7882,3,15,6,9,75,54,21,51
Copenhagen,7882,4,14,4,12,61,48,13,46
AaB,7882,5,8,11,11,38,44,-6,35
AC Horsens,7882,6,6,13,11,37,57,-20,31
Sonderjyske,7882,7,8,6,10,28,29,-1,30
Silkeborg IF,7882,8,6,3,13,28,45,-17,21
Lyngby,7882,9,4,9,11,27,44,-17,21
Randers FC,7882,10,5,6,13,23,40,-17,21
AGF Aarhus,7882,11,4,6,12,17,39,-22,18
Brondby,7883,1,21,5,4,72,35,37,68
FC Midtjylla,7883,2,20,6,4,67,38,29,66
Copenhagen,7883,3,14,5,11,57,44,13,47
FC Nords,7883,4,12,8,10,68,52,16,44
AC Horsens,7883,5,7,13,10,37,52,-15,34
AaB,7883,6,6,15,9,33,39,-6,33
Sonderjyske,7883,7,8,6,10,28,29,-1,30
Lyngby,7883,8,4,9,11,27,44,-17,21
Randers FC,7883,9,5,6,13,23,40,-17,21
Silkeborg IF,7883,10,6,3,13,26,44,-18,21
AGF Aarhus,7883,11,4,6,12,16,37,-21,18
Brondby,7884,1,20,8,2,68,28,40,68
FC Midtjylla,7884,2,21,5,4,63,32,31,68
FC Nords,7884,3,13,7,10,68,52,16,46
Copenhagen,7884,4,13,4,13,55,49,6,43
AC Horsens,7884,5,8,12,10,37,50,-13,36
AaB,7884,6,7,12,11,35,41,-6,33
Sonderjyske,7884,7,8,6,10,28,29,-1,30
Lyngby,7884,8,4,9,11,28,45,-17,21
Randers FC,7884,9,5,6,13,24,41,-17,21
Silkeborg IF,7884,10,5,4,13,27,46,-19,19
AGF Aarhus,7884,11,4,7,11,18,38,-20,19
Brondby,7885,1,20,7,3,72,33,39,67
FC Midtjylla,7885,2,20,4,6,69,40,29,64
Copenhagen,7885,3,15,5,10,66,46,20,50
FC Nords,7885,4,13,6,11,69,57,12,45
AaB,7885,5,9,11,10,40,44,-4,38
AC Horsens,7885,6,6,13,11,35,57,-22,31
Sonderjyske,7885,7,8,6,10,28,29,-1,30
Randers FC,7885,8,6,6,12,27,41,-14,24
AGF Aarhus,7885,9,5,6,11,18,37,-19,21
Lyngby,7885,10,3,9,12,28,48,-20,18
Silkeborg IF,7885,11,5,3,14,26,46,-20,18
Brondby,7886,1,21,6,3,73,32,41,69
FC Midtjylla,7886,2,19,6,5,66,40,26,63
Copenhagen,7886,3,15,5,10,59,44,15,50
FC Nords,7886,4,13,6,11,73,56,17,45
AaB,7886,5,7,13,10,37,43,-6,34
AC Horsens,7886,6,7,12,11,39,58,-19,33
Sonderjyske,7886,7,8,6,10,28,29,-1,30
Lyngby,7886,8,4,9,11,29,46,-17,21
Randers FC,7886,9,5,6,13,25,42,-17,21
Silkeborg IF,7886,10,6,3,13,27,45,-18,21
AGF Aarhus,7886,11,4,6,12,17,38,-21,18
Brondby,7887,1,22,6,2,73,27,46,72
FC Midtjylla,7887,2,19,5,6,69,42,27,62
FC Nords,7887,3,14,8,8,77,52,25,50
Copenhagen,7887,4,14,4,12,55,47,8,46
AaB,7887,5,8,11,11,37,45,-8,35
Sonderjyske,7887,6,8,6,10,28,29,-1,30
AC Horsens,7887,7,6,12,12,35,59,-24,30
Randers FC,7887,8,5,7,12,23,39,-16,22
Silkeborg IF,7887,9,6,3,13,30,45,-15,21
Lyngby,7887,10,3,10,11,26,44,-18,19
AGF Aarhus,7887,11,4,6,12,17,41,-24,18
Brondby,7888,1,20,7,3,72,35,37,67
FC Midtjylla,7888,2,18,6,6,63,39,24,60
FC Nords,7888,3,13,10,7,75,50,25,49
Copenhagen,7888,4,13,5,12,57,46,11,44
AaB,7888,5,10,12,8,40,39,1,42
Sonderjyske,7888,6,8,6,10,28,29,-1,30
AC Horsens,7888,7,6,12,12,34,58,-24,30
Lyngby,7888,8,4,9,11,28,44,-16,21
Silkeborg IF,7888,9,6,3,13,27,44,-17,21
Randers FC,7888,10,5,6,13,23,41,-18,21
AGF Aarhus,7888,11,4,6,12,16,38,-22,18
Brondby,7889,1,20,7,3,71,33,38,67
FC Midtjylla,7889,2,18,7,5,61,36,25,61
FC Nords,7889,3,13,9,8,69,48,21,48
Copenhagen,7889,4,14,6,10,56,41,15,48
AC Horsens,7889,5,7,13,10,33,52,-19,34
AaB,7889,6,6,14,10,34,40,-6,32
Sonderjyske,7889,7,8,6,10,28,29,-1,30
Randers FC,7889,8,5,7,12,26,42,-16,22
Silkeborg IF,7889,9,6,3,13,27,44,-17,21
Lyngby,7889,10,3,10,11,29,47,-18,19
AGF Aarhus,7889,11,4,6,12,16,38,-22,18
Brondby,7890,1,22,6,2,75,29,46,72
FC Midtjylla,7890,2,19,4,7,63,47,16,61
Copenhagen,7890,3,15,4,11,57,40,17,49
FC Nords,7890,4,14,6,10,72,55,17,48
AaB,7890,5,7,12,11,33,38,-5,33
AC Horsens,7890,6,6,14,10,33,50,-17,32
Sonderjyske,7890,7,8,6,10,28,29,-1,30
Lyngby,7890,8,4,9,11,28,44,-16,21
Randers FC,7890,9,5,6,13,23,41,-18,21
Silkeborg IF,7890,10,5,4,13,27,46,-19,19
AGF Aarhus,7890,11,4,7,11,18,38,-20,19
Brondby,7891,1,19,7,4,70,35,35,64
FC Midtjylla,7891,2,19,6,5,69,42,27,63
FC Nords,7891,3,15,7,8,76,51,25,52
Copenhagen,7891,4,15,5,10,58,41,17,50
AC Horsens,7891,5,6,15,9,34,50,-16,33
Sonderjyske,7891,6,8,6,10,28,29,-1,30
AaB,7891,7,6,12,12,33,47,-14,30
Lyngby,7891,8,4,9,11,28,45,-17,21
Randers FC,7891,9,5,6,13,24,41,-17,21
AGF Aarhus,7891,10,5,6,11,18,37,-19,21
Silkeborg IF,7891,11,5,3,14,26,46,-20,18
Brondby,7892,1,19,8,3,67,29,38,65
FC Midtjylla,7892,2,20,4,6,63,38,25,64
FC Nords,7892,3,13,8,9,67,47,20,47
Copenhagen,7892,4,13,6,11,57,45,12,45
AaB,7892,5,9,12,9,40,44,-4,39
AC Horsens,7892,6,6,14,10,35,52,-17,32
Sonderjyske,7892,7,8,6,10,28,29,-1,30
Lyngby,7892,8,4,9,11,27,44,-17,21
Randers FC,7892,9,5,6,13,23,40,-17,21
Silkeborg IF,7892,10,5,4,13,25,44,-19,19
AGF Aarhus,7892,11,4,7,11,16,36,-20,19
Brondby,7893,1,20,7,3,71,34,37,67
FC Midtjylla,7893,2,18,4,8,64,50,14,58
Copenhagen,7893,3,15,5,10,60,41,19,50
FC Nords,7893,4,14,7,9,72,50,22,49
AC Horsens,7893,5,8,13,9,38,50,-12,37
AaB,7893,6,7,12,11,38,44,-6,33
Sonderjyske,7893,7,8,6,10,28,29,-1,30
Lyngby,7893,8,4,9,11,29,44,-15,21
Randers FC,7893,9,5,6,13,23,42,-19,21
Silkeborg IF,7893,10,5,4,13,25,44,-19,19
AGF Aarhus,7893,11,4,7,11,16,36,-20,19
Brondby,7894,1,23,5,2,73,28,45,74
FC Midtjylla,7894,2,19,4,7,66,43,23,61
Copenhagen,7894,3,16,4,10,64,47,17,52
FC Nords,7894,4,13,6,11,74,55,19,45
AaB,7894,5,8,12,10,37,40,-3,36
Sonderjyske,7894,6,8,6,10,28,29,-1,30
AC Horsens,7894,7,5,13,12,32,59,-27,28
Lyngby,7894,8,4,9,11,27,44,-17,21
Randers FC,7894,9,5,6,13,23,40,-17,21
Silkeborg IF,7894,10,6,3,13,26,44,-18,21
AGF Aarhus,7894,11,4,6,12,16,37,-21,18
Brondby,7895,1,20,7,3,73,36,37,67
FC Midtjylla,7895,2,19,5,6,64,41,23,62
FC Nords,7895,3,14,7,9,79,53,26,49
Copenhagen,7895,4,14,5,11,57,42,15,47
AaB,7895,5,8,13,9,41,43,-2,37
AC Horsens,7895,6,6,13,11,34,59,-25,31
Sonderjyske,7895,7,8,6,10,28,29,-1,30
Randers FC,7895,8,6,6,12,26,41,-15,24
Silkeborg IF,7895,9,6,3,13,28,46,-18,21
Lyngby,7895,10,3,9,12,28,47,-19,18
AGF Aarhus,7895,11,4,6,12,18,39,-21,18
FC Midtjylla,7896,1,22,4,4,70,37,33,70
Brondby,7896,2,20,6,4,68,33,35,66
Copenhagen,7896,3,14,4,12,54,44,10,46
FC Nords,7896,4,12,7,11,68,56,12,43
AaB,7896,5,8,13,9,39,41,-2,37
AC Horsens,7896,6,6,14,10,35,49,-14,32
Sonderjyske,7896,7,8,6,10,28,29,-1,30
Randers FC,7896,8,6,6,12,24,39,-15,24
Silkeborg IF,7896,9,6,3,13,26,44,-18,21
Lyngby,7896,10,3,9,12,26,45,-19,18
AGF Aarhus,7896,11,4,6,12,16,37,-21,18
FC Midtjylla,7897,1,20,4,6,62,37,25,64
Brondby,7897,2,19,5,6,65,39,26,62
FC Nords,7897,3,15,7,8,78,51,27,52
Copenhagen,7897,4,15,4,11,58,39,19,49
AaB,7897,5,8,11,11,36,41,-5,35
AC Horsens,7897,6,7,13,10,35,53,-18,34
Sonderjyske,7897,7,8,6,10,28,29,-1,30
Randers FC,7897,8,5,7,12,24,40,-16,22
Silkeborg IF,7897,9,6,3,13,28,46,-18,21
Lyngby,7897,10,3,10,11,27,45,-18,19
AGF Aarhus,7897,11,4,6,12,18,39,-21,18
Brondby,7898,1,21,6,3,72,32,40,69
FC Midtjylla,7898,2,19,6,5,65,39,26,63
FC Nords,7898,3,14,7,9,73,55,18,49
Copenhagen,7898,4,13,7,10,56,43,13,46
AaB,7898,5,6,14,10,36,43,-7,32
AC Horsens,7898,6,6,14,10,37,53,-16,32
Sonderjyske,7898,7,8,6,10,28,29,-1,30
Randers FC,7898,8,5,7,12,23,39,-16,22
Lyngby,7898,9,3,10,11,26,44,-18,19
Silkeborg IF,7898,10,5,4,13,28,47,-19,19
AGF Aarhus,7898,11,4,7,11,19,39,-20,19
Brondby,7899,1,22,5,3,72,30,42,71
FC Midtjylla,7899,2,22,4,4,67,36,31,70
FC Nords,7899,3,13,6,11,69,55,14,45
Copenhagen,7899,4,13,4,13,57,49,8,43
AaB,7899,5,8,12,10,38,41,-3,36
AC Horsens,7899,6,6,13,11,32,50,-18,31
Sonderjyske,7899,7,8,6,10,28,29,-1,30
Lyngby,7899,8,4,9,11,28,45,-17,21
Randers FC,7899,9,5,6,13,24,41,-17,21
AGF Aarhus,7899,10,5,6,11,17,36,-19,21
Silkeborg IF,7899,11,5,3,14,25,45,-20,18
Brondby,7900,1,22,5,3,75,32,43,71
FC Midtjylla,7900,2,19,5,6,66,38,28,62
FC Nords,7900,3,14,7,9,72,52,20,49
Copenhagen,7900,4,13,6,11,55,44,11,45
AaB,7900,5,8,12,10,36,43,-7,36
AC Horsens,7900,6,6,13,11,35,56,-21,31
Sonderjyske,7900,7,8,6,10,28,29,-1,30
Lyngby,7900,8,4,9,11,28,45,-17,21
Silkeborg IF,7900,8,6,3,13,28,45,-17,21
Randers FC,7900,10,5,6,13,24,41,-17,21
AGF Aarhus,7900,11,4,6,12,17,39,-22,18
Brondby,7901,1,19,8,3,65,32,33,65
FC Midtjylla,7901,2,19,5,6,64,40,24,62
FC Nords,7901,3,17,6,7,79,49,30,57
Copenhagen,7901,4,14,5,11,59,46,13,47
AaB,7901,5,7,12,11,37,42,-5,33
Sonderjyske,7901,6,8,6,10,28,29,-1,30
AC Horsens,7901,7,6,12,12,37,58,-21,30
Randers FC,7901,8,6,6,12,27,40,-13,24
AGF Aarhus,7901,9,5,6,11,18,37,-19,21
Silkeborg IF,7901,10,5,3,14,26,46,-20,18
Lyngby,7901,11,3,9,12,27,48,-21,18
Brondby,7902,1,22,6,2,77,31,46,72
FC Midtjylla,7902,2,18,4,8,62,39,23,58
Copenhagen,7902,3,13,6,11,56,49,7,45
FC Nords,7902,4,12,8,10,72,58,14,44
AaB,7902,5,9,12,9,40,42,-2,39
AC Horsens,7902,6,6,16,8,33,47,-14,34
Sonderjyske,7902,7,8,6,10,28,29,-1,30
Randers FC,7902,8,5,7,12,25,41,-16,22
Lyngby,7902,9,3,10,11,28,46,-18,19
Silkeborg IF,7902,10,5,4,13,27,46,-19,19
AGF Aarhus,7902,11,4,7,11,18,38,-20,19
Brondby,7903,1,20,6,4,67,31,36,66
FC Midtjylla,7903,2,20,6,4,70,43,27,66
FC Nords,7903,3,12,10,8,74,56,18,46
Copenhagen,7903,4,13,6,11,60,47,13,45
AaB,7903,5,6,15,9,36,41,-5,33
AC Horsens,7903,6,6,15,9,36,51,-15,33
Sonderjyske,7903,7,8,6,10,28,29,-1,30
Silkeborg IF,7903,8,6,3,13,28,45,-17,21
Lyngby,7903,9,4,9,11,27,44,-17,21
Randers FC,7903,10,5,6,13,23,40,-17,21
AGF Aarhus,7903,11,4,6,12,17,39,-22,18
Brondby,7904,1,21,5,4,70,30,40,68
FC Midtjylla,7904,2,19,6,5,68,41,27,63
Copenhagen,7904,3,15,5,10,61,43,18,50
FC Nords,7904,4,13,7,10,75,60,15,46
AaB,7904,5,7,13,10,42,44,-2,34
AC Horsens,7904,6,7,12,11,34,58,-24,33
Sonderjyske,7904,7,8,6,10,28,29,-1,30
Randers FC,7904,8,5,7,12,24,40,-16,22
Silkeborg IF,7904,9,6,3,13,27,45,-18,21
Lyngby,7904,10,3,10,11,27,45,-18,19
AGF Aarhus,7904,11,4,6,12,17,38,-21,18
Brondby,7905,1,20,7,3,67,31,36,67
FC Midtjylla,7905,2,19,6,5,62,36,26,63
FC Nords,7905,3,14,9,7,73,49,24,51
Copenhagen,7905,4,12,6,12,53,46,7,42
AaB,7905,5,7,13,10,35,43,-8,34
AC Horsens,7905,6,7,13,10,39,50,-11,34
Sonderjyske,7905,7,8,6,10,28,29,-1,30
Randers FC,7905,8,5,7,12,23,39,-16,22
AGF Aarhus,7905,9,5,6,11,19,38,-19,21
Lyngby,7905,10,3,10,11,26,44,-18,19
Silkeborg IF,7905,11,5,3,14,27,47,-20,18
Brondby,7906,1,20,6,4,70,41,29,66
FC Midtjylla,7906,2,20,4,6,70,39,31,64
Copenhagen,7906,3,17,4,9,65,39,26,55
FC Nords,7906,4,15,6,9,74,53,21,51
AC Horsens,7906,5,6,13,11,38,55,-17,31
Sonderjyske,7906,6,8,6,10,28,29,-1,30
AaB,7906,7,6,11,13,34,50,-16,29
Lyngby,7906,8,4,9,11,28,45,-17,21
Randers FC,7906,9,5,6,13,24,41,-17,21
Silkeborg IF,7906,10,6,3,13,27,45,-18,21
AGF Aarhus,7906,11,4,6,12,17,38,-21,18
Brondby,7907,1,20,6,4,67,30,37,66
FC Midtjylla,7907,2,20,4,6,67,37,30,64
FC Nords,7907,3,16,6,8,74,51,23,54
Copenhagen,7907,4,12,4,14,55,51,4,40
AaB,7907,5,9,12,9,41,41,0,39
AC Horsens,7907,6,7,12,11,33,53,-20,33
Sonderjyske,7907,7,8,6,10,28,29,-1,30
Randers FC,7907,8,6,6,12,24,39,-15,24
Silkeborg IF,7907,9,5,4,13,26,45,-19,19
AGF Aarhus,7907,10,4,7,11,17,37,-20,19
Lyngby,7907,11,3,9,12,26,45,-19,18
Brondby,7908,1,23,5,2,80,30,50,74
FC Midtjylla,7908,2,20,4,6,70,45,25,64
FC Nords,7908,3,14,6,10,72,51,21,48
Copenhagen,7908,4,13,5,12,54,45,9,44
AC Horsens,7908,5,8,12,10,36,52,-16,36
Sonderjyske,7908,6,8,6,10,28,29,-1,30
AaB,7908,7,6,12,12,32,47,-15,30
Randers FC,7908,8,6,6,12,26,40,-14,24
Silkeborg IF,7908,9,6,3,13,26,44,-18,21
Lyngby,7908,10,3,9,12,27,47,-20,18
AGF Aarhus,7908,11,4,6,12,16,37,-21,18
Brondby,7909,1,22,6,2,74,29,45,72
FC Midtjylla,7909,2,18,6,6,63,38,25,60
FC Nords,7909,3,14,7,9,76,51,25,49
Copenhagen,7909,4,13,4,13,53,51,2,43
AaB,7909,5,9,11,10,38,43,-5,38
AC Horsens,7909,6,6,14,10,35,53,-18,32
Sonderjyske,7909,7,8,6,10,28,29,-1,30
Lyngby,7909,8,4,9,11,30,44,-14,21
Randers FC,7909,9,5,6,13,23,43,-20,21
Silkeborg IF,7909,10,5,4,13,25,44,-19,19
AGF Aarhus,7909,11,4,7,11,16,36,-20,19
FC Midtjylla,7910,1,19,6,5,64,38,26,63
Brondby,7910,2,19,5,6,69,37,32,62
FC Nords,7910,3,15,6,9,72,54,18,51
Copenhagen,7910,4,15,5,10,64,46,18,50
AaB,7910,5,8,12,10,39,41,-2,36
AC Horsens,7910,6,7,12,11,39,57,-18,33
Sonderjyske,7910,7,8,6,10,28,29,-1,30
Randers FC,7910,8,6,6,12,26,41,-15,24
AGF Aarhus,7910,9,5,6,11,17,36,-19,21
Lyngby,7910,10,3,9,12,28,47,-19,18
Silkeborg IF,7910,11,5,3,14,25,45,-20,18
FC Midtjylla,7911,1,21,4,5,65,36,29,67
Brondby,7911,2,19,7,4,65,32,33,64
FC Nords,7911,3,16,6,8,75,48,27,54
Copenhagen,7911,4,12,5,13,54,47,7,41
AaB,7911,5,8,13,9,37,39,-2,37
AC Horsens,7911,6,6,13,11,31,51,-20,31
Sonderjyske,7911,7,8,6,10,28,29,-1,30
Lyngby,7911,8,4,9,11,28,44,-16,21
Randers FC,7911,9,5,6,13,23,41,-18,21
Silkeborg IF,7911,10,5,4,13,26,45,-19,19
AGF Aarhus,7911,11,4,7,11,17,37,-20,19
Brondby,7912,1,20,6,4,70,35,35,66
FC Midtjylla,7912,2,20,5,5,70,39,31,65
FC Nords,7912,3,15,6,9,73,50,23,51
Copenhagen,7912,4,14,4,12,57,49,8,46
AaB,7912,5,8,11,11,44,48,-4,35
AC Horsens,7912,6,7,12,11,37,56,-19,33
Sonderjyske,7912,7,8,6,10,28,29,-1,30
Lyngby,7912,8,4,9,11,29,44,-15,21
Randers FC,7912,9,5,6,13,23,42,-19,21
Silkeborg IF,7912,10,5,4,13,25,44,-19,19
AGF Aarhus,7912,11,4,7,11,16,36,-20,19
FC Midtjylla,7913,1,21,5,4,64,35,29,68
Brondby,7913,2,19,8,3,68,33,35,65
FC Nords,7913,3,14,6,10,73,52,21,48
Copenhagen,7913,4,13,6,11,55,44,11,45
AaB,7913,5,7,14,9,34,38,-4,35
Sonderjyske,7913,6,8,6,10,28,29,-1,30
AC Horsens,7913,7,5,15,10,33,51,-18,30
Randers FC,7913,8,5,7,12,23,39,-16,22
Silkeborg IF,7913,9,6,3,13,28,44,-16,21
Lyngby,7913,10,3,10,11,26,44,-18,19
AGF Aarhus,7913,11,4,6,12,16,39,-23,18
Brondby,7914,1,22,6,2,71,28,43,72
FC Midtjylla,7914,2,20,5,5,63,37,26,65
Copenhagen,7914,3,15,5,10,57,41,16,50
FC Nords,7914,4,13,8,9,70,51,19,47
AC Horsens,7914,5,6,13,11,34,54,-20,31
Sonderjyske,7914,6,8,6,10,28,29,-1,30
AaB,7914,7,6,11,13,33,43,-10,29
Lyngby,7914,8,4,9,11,30,45,-15,21
AGF Aarhus,7914,9,5,6,11,19,36,-17,21
Randers FC,7914,10,5,6,13,24,43,-19,21
Silkeborg IF,7914,11,5,3,14,25,47,-22,18
Brondby,7915,1,20,8,2,76,36,40,68
FC Midtjylla,7915,2,18,5,7,65,42,23,59
FC Nords,7915,3,12,8,10,77,63,14,44
Copenhagen,7915,4,12,7,11,59,48,11,43
AaB,7915,5,9,12,9,40,42,-2,39
AC Horsens,7915,6,8,14,8,39,51,-12,38
Sonderjyske,7915,7,8,6,10,28,29,-1,30
Randers FC,7915,8,6,6,12,26,39,-13,24
AGF Aarhus,7915,9,5,6,11,17,36,-19,21
Silkeborg IF,7915,10,5,3,14,25,45,-20,18
Lyngby,7915,11,3,9,12,26,47,-21,18
Brondby,7916,1,21,6,3,72,30,42,69
FC Midtjylla,7916,2,20,4,6,62,35,27,64
FC Nords,7916,3,15,7,8,70,49,21,52
Copenhagen,7916,4,13,6,11,55,43,12,45
AaB,7916,5,8,12,10,41,47,-6,36
Sonderjyske,7916,6,8,6,10,28,29,-1,30
AC Horsens,7916,7,5,13,12,32,54,-22,28
Randers FC,7916,8,5,7,12,23,39,-16,22
Lyngby,7916,9,3,10,11,26,44,-18,19
Silkeborg IF,7916,10,5,4,13,26,45,-19,19
AGF Aarhus,7916,11,4,7,11,17,37,-20,19
Brondby,7917,1,19,8,3,72,34,38,65
FC Midtjylla,7917,2,20,5,5,65,34,31,65
Copenhagen,7917,3,15,5,10,60,44,16,50
FC Nords,7917,4,14,6,10,73,56,17,48
AaB,7917,5,7,12,11,33,48,-15,33
AC Horsens,7917,6,6,14,10,41,54,-13,32
Sonderjyske,7917,7,8,6,10,28,29,-1,30
Lyngby,7917,8,4,9,11,27,44,-17,21
Randers FC,7917,9,5,6,13,23,40,-17,21
Silkeborg IF,7917,10,5,4,13,25,44,-19,19
AGF Aarhus,7917,11,4,7,11,16,36,-20,19
Brondby,7918,1,21,5,4,73,36,37,68
FC Midtjylla,7918,2,21,4,5,67,41,26,67
FC Nords,7918,3,14,7,9,73,51,22,49
Copenhagen,7918,4,13,5,12,54,43,11,44
AC Horsens,7918,5,8,12,10,39,56,-17,36
AaB,7918,6,7,11,12,39,44,-5,32
Sonderjyske,7918,7,8,6,10,28,29,-1,30
Lyngby,7918,8,4,9,11,28,45,-17,21
Randers FC,7918,9,5,6,13,24,41,-17,21
Silkeborg IF,7918,10,5,4,13,26,45,-19,19
AGF Aarhus,7918,11,4,7,11,17,37,-20,19
Brondby,7919,1,21,5,4,71,35,36,68
FC Midtjylla,7919,2,18,5,7,65,45,20,59
Copenhagen,7919,3,13,7,10,63,50,13,46
FC Nords,7919,4,12,9,9,73,56,17,45
AaB,7919,5,8,13,9,40,40,0,37
AC Horsens,7919,6,7,15,8,37,49,-12,36
Sonderjyske,7919,7,8,6,10,28,29,-1,30
Randers FC,7919,8,5,7,12,24,40,-16,22
Lyngby,7919,9,3,10,11,27,45,-18,19
Silkeborg IF,7919,10,5,4,13,26,45,-19,19
AGF Aarhus,7919,11,4,7,11,17,37,-20,19
Brondby,7920,1,21,6,3,68,32,36,69
FC Midtjylla,7920,2,20,5,5,67,39,28,65
FC Nords,7920,3,13,8,9,72,52,20,47
Copenhagen,7920,4,13,6,11,57,43,14,45
AaB,7920,5,8,11,11,37,46,-9,35
AC Horsens,7920,6,6,14,10,38,53,-15,32
Sonderjyske,7920,7,8,6,10,28,29,-1,30
Randers FC,7920,8,5,7,12,24,40,-16,22
Lyngby,7920,9,3,10,11,27,45,-18,19
Silkeborg IF,7920,10,5,4,13,26,45,-19,19
AGF Aarhus,7920,11,4,7,11,17,37,-20,19
Brondby,7921,1,22,5,3,71,30,41,71
FC Midtjylla,7921,2,21,4,5,69,37,32,67
FC Nords,7921,3,14,7,9,70,51,19,49
Copenhagen,7921,4,13,4,13,53,45,8,43
AaB,7921,5,7,12,11,36,44,-8,33
AC Horsens,7921,6,7,12,11,36,54,-18,33
Sonderjyske,7921,7,8,6,10,28,29,-1,30
Lyngby,7921,8,4,9,11,31,45,-14,21
Silkeborg IF,7921,9,6,3,13,26,44,-18,21
Randers FC,7921,10,5,6,13,24,44,-20,21
AGF Aarhus,7921,11,4,6,12,16,37,-21,18
Brondby,7922,1,21,7,2,68,29,39,70
FC Midtjylla,7922,2,19,4,7,65,42,23,61
FC Nords,7922,3,14,7,9,73,50,23,49
Copenhagen,7922,4,14,4,12,56,44,12,46
AaB,7922,5,9,11,10,38,41,-3,38
AC Horsens,7922,6,6,13,11,35,55,-20,31
Sonderjyske,7922,7,8,6,10,28,29,-1,30
Randers FC,7922,8,5,7,12,24,40,-16,22
AGF Aarhus,7922,9,5,6,11,17,36,-19,21
Lyngby,7922,10,3,10,11,27,45,-18,19
Silkeborg IF,7922,11,5,3,14,25,45,-20,18
Brondby,7923,1,20,6,4,71,37,34,66
FC Midtjylla,7923,2,20,5,5,67,36,31,65
FC Nords,7923,3,16,6,8,75,48,27,54
Copenhagen,7923,4,12,6,12,54,45,9,42
AaB,7923,5,8,12,10,38,43,-5,36
AC Horsens,7923,6,6,13,11,30,52,-22,31
Sonderjyske,7923,7,8,6,10,28,29,-1,30
Silkeborg IF,7923,8,6,3,13,28,45,-17,21
Lyngby,7923,9,4,9,11,27,44,-17,21
Randers FC,7923,10,5,6,13,23,40,-17,21
AGF Aarhus,7923,11,4,6,12,17,39,-22,18
Brondby,7924,1,21,6,3,73,37,36,69
FC Midtjylla,7924,2,17,7,6,58,40,18,58
FC Nords,7924,3,14,7,9,72,50,22,49
Copenhagen,7924,4,14,4,12,61,44,17,46
AaB,7924,5,8,13,9,34,37,-3,37
AC Horsens,7924,6,7,13,10,36,52,-16,34
Sonderjyske,7924,7,8,6,10,28,29,-1,30
Randers FC,7924,8,6,6,12,27,41,-14,24
Silkeborg IF,7924,9,6,3,13,27,45,-18,21
Lyngby,7924,10,3,9,12,28,48,-20,18
AGF Aarhus,7924,11,4,6,12,17,38,-21,18
Brondby,7925,1,20,7,3,71,36,35,67
FC Midtjylla,7925,2,19,6,5,69,42,27,63
FC Nords,7925,3,14,8,8,77,53,24,50
Copenhagen,7925,4,14,5,11,65,49,16,47
AaB,7925,5,9,11,10,37,43,-6,38
Sonderjyske,7925,6,8,6,10,28,29,-1,30
AC Horsens,7925,7,5,13,12,36,58,-22,28
Lyngby,7925,8,4,9,11,27,44,-17,21
Randers FC,7925,9,5,6,13,23,40,-17,21
Silkeborg IF,7925,10,5,4,13,27,46,-19,19
AGF Aarhus,7925,11,4,7,11,18,38,-20,19
Brondby,7926,1,22,5,3,73,30,43,71
FC Midtjylla,7926,2,18,5,7,64,46,18,59
FC Nords,7926,3,15,6,9,73,52,21,51
Copenhagen,7926,4,13,4,13,59,48,11,43
AaB,7926,5,8,13,9,41,42,-1,37
AC Horsens,7926,6,7,13,10,37,55,-18,34
Sonderjyske,7926,7,8,6,10,28,29,-1,30
Lyngby,7926,8,4,9,11,28,45,-17,21
Randers FC,7926,9,5,6,13,24,41,-17,21
Silkeborg IF,7926,10,5,4,13,25,44,-19,19
AGF Aarhus,7926,11,4,7,11,16,36,-20,19
Brondby,7927,1,20,6,4,75,38,37,66
FC Midtjylla,7927,2,19,5,6,66,43,23,62
FC Nords,7927,3,14,7,9,72,52,20,49
Copenhagen,7927,4,13,6,11,58,46,12,45
AaB,7927,5,7,14,9,41,45,-4,35
AC Horsens,7927,6,7,14,9,38,52,-14,35
Sonderjyske,7927,7,8,6,10,28,29,-1,30
Lyngby,7927,8,4,9,11,29,46,-17,21
Randers FC,7927,9,5,6,13,25,42,-17,21
AGF Aarhus,7927,10,5,6,11,17,36,-19,21
Silkeborg IF,7927,11,5,3,14,25,45,-20,18
Brondby,7928,1,22,6,2,73,30,43,72
FC Midtjylla,7928,2,20,4,6,69,40,29,64
FC Nords,7928,3,14,6,10,74,54,20,48
Copenhagen,7928,4,14,5,11,56,46,10,47
AaB,7928,5,8,11,11,39,47,-8,35
Sonderjyske,7928,6,8,6,10,28,29,-1,30
AC Horsens,7928,7,5,14,11,38,58,-20,29
Randers FC,7928,8,6,6,12,25,40,-15,24
Silkeborg IF,7928,9,5,4,13,27,46,-19,19
AGF Aarhus,7928,10,4,7,11,18,38,-20,19
Lyngby,7928,11,3,9,12,27,46,-19,18
FC Midtjylla,7929,1,19,7,4,62,36,26,64
Brondby,7929,2,18,8,4,69,37,32,62
FC Nords,7929,3,13,9,8,74,49,25,48
Copenhagen,7929,4,14,6,10,57,42,15,48
AaB,7929,5,9,11,10,36,39,-3,38
AC Horsens,7929,6,6,13,11,37,58,-21,31
Sonderjyske,7929,7,8,6,10,28,29,-1,30
Randers FC,7929,8,6,6,12,26,41,-15,24
Silkeborg IF,7929,9,6,3,13,27,44,-17,21
Lyngby,7929,10,3,9,12,28,47,-19,18
AGF Aarhus,7929,11,4,6,12,16,38,-22,18
Brondby,7930,1,21,5,4,67,32,35,68
FC Midtjylla,7930,2,20,5,5,66,39,27,65
Copenhagen,7930,3,16,4,10,59,40,19,52
FC Nords,7930,4,13,8,9,72,52,20,47
AaB,7930,5,7,13,10,41,47,-6,34
Sonderjyske,7930,6,8,6,10,28,29,-1,30
AC Horsens,7930,7,5,13,12,33,54,-21,28
Lyngby,7930,8,4,9,11,29,44,-15,21
Randers FC,7930,9,5,6,13,23,42,-19,21
AGF Aarhus,7930,10,5,6,11,17,36,-19,21
Silkeborg IF,7930,11,5,3,14,25,45,-20,18
Brondby,7931,1,21,6,3,71,34,37,69
FC Midtjylla,7931,2,20,4,6,70,40,30,64
Copenhagen,7931,3,14,6,10,58,43,15,48
FC Nords,7931,4,13,8,9,71,52,19,47
AC Horsens,7931,5,8,13,9,37,50,-13,37
Sonderjyske,7931,6,8,6,10,28,29,-1,30
AaB,7931,7,6,11,13,33,47,-14,29
Lyngby,7931,8,4,9,11,29,44,-15,21
Silkeborg IF,7931,9,6,3,13,27,45,-18,21
Randers FC,7931,10,5,6,13,23,42,-19,21
AGF Aarhus,7931,11,4,6,12,17,38,-21,18
Brondby,7932,1,20,7,3,77,33,44,67
FC Midtjylla,7932,2,19,5,6,64,44,20,62
FC Nords,7932,3,16,7,7,83,48,35,55
Copenhagen,7932,4,13,7,10,54,45,9,46
AaB,7932,5,6,14,10,35,43,-8,32
Sonderjyske,7932,6,8,6,10,28,29,-1,30
AC Horsens,7932,7,5,14,11,32,58,-26,29
Randers FC,7932,8,6,6,12,26,39,-13,24
Silkeborg IF,7932,9,6,3,13,27,45,-18,21
Lyngby,7932,10,3,9,12,26,47,-21,18
AGF Aarhus,7932,11,4,6,12,17,38,-21,18
Brondby,7933,1,21,7,2,69,30,39,70
FC Midtjylla,7933,2,18,6,6,63,43,20,60
FC Nords,7933,3,14,8,8,78,53,25,50
Copenhagen,7933,4,12,5,13,54,46,8,41
AaB,7933,5,7,15,8,37,39,-2,36
AC Horsens,7933,6,7,13,10,35,51,-16,34
Sonderjyske,7933,7,8,6,10,28,29,-1,30
Randers FC,7933,8,6,6,12,26,39,-13,24
Silkeborg IF,7933,9,5,4,13,27,46,-19,19
AGF Aarhus,7933,10,4,7,11,18,38,-20,19
Lyngby,7933,11,3,9,12,26,47,-21,18
FC Midtjylla,7934,1,21,5,4,68,37,31,68
Brondby,7934,2,20,6,4,68,33,35,66
FC Nords,7934,3,14,6,10,71,50,21,48
Copenhagen,7934,4,14,5,11,61,47,14,47
AaB,7934,5,7,13,10,33,41,-8,34
AC Horsens,7934,6,6,13,11,33,52,-19,31
Sonderjyske,7934,7,8,6,10,28,29,-1,30
Lyngby,7934,8,4,9,11,27,44,-17,21
Randers FC,7934,9,5,6,13,23,40,-17,21
AGF Aarhus,7934,10,5,6,11,18,37,-19,21
Silkeborg IF,7934,11,5,3,14,26,46,-20,18
Brondby,7935,1,21,6,3,70,32,38,69
FC Midtjylla,7935,2,19,5,6,62,37,25,62
FC Nords,7935,3,15,7,8,74,50,24,52
Copenhagen,7935,4,13,5,12,58,49,9,44
AaB,7935,5,7,13,10,38,43,-5,34
AC Horsens,7935,6,7,12,11,33,50,-17,33
Sonderjyske,7935,7,8,6,10,28,29,-1,30
Randers FC,7935,8,6,6,12,25,40,-15,24
Silkeborg IF,7935,9,5,4,13,27,46,-19,19
AGF Aarhus,7935,10,4,7,11,18,38,-20,19
Lyngby,7935,11,3,9,12,27,46,-19,18
Brondby,7936,1,22,5,3,74,31,43,71
FC Midtjylla,7936,2,21,4,5,65,38,27,67
FC Nords,7936,3,14,6,10,73,56,17,48
Copenhagen,7936,4,13,5,12,58,46,12,44
AaB,7936,5,7,12,11,42,49,-7,33
AC Horsens,7936,6,7,12,11,37,55,-18,33
Sonderjyske,7936,7,8,6,10,28,29,-1,30
Randers FC,7936,8,5,7,12,24,40,-16,22
Silkeborg IF,7936,9,6,3,13,28,44,-16,21
Lyngby,7936,10,3,10,11,27,45,-18,19
AGF Aarhus,7936,11,4,6,12,16,39,-23,18
Brondby,7937,1,19,6,5,72,38,34,63
FC Midtjylla,7937,2,19,5,6,67,39,28,62
Copenhagen,7937,3,16,4,10,58,40,18,52
FC Nords,7937,4,14,8,8,75,53,22,50
AaB,7937,5,8,12,10,35,40,-5,36
AC Horsens,7937,6,6,13,11,35,58,-23,31
Sonderjyske,7937,7,8,6,10,28,29,-1,30
Lyngby,7937,8,4,9,11,29,44,-15,21
AGF Aarhus,7937,9,5,6,11,18,36,-18,21
Randers FC,7937,10,5,6,13,23,42,-19,21
Silkeborg IF,7937,11,5,3,14,25,46,-21,18
Brondby,7938,1,21,5,4,69,35,34,68
FC Midtjylla,7938,2,21,5,4,68,36,32,68
FC Nords,7938,3,15,6,9,75,52,23,51
Copenhagen,7938,4,13,4,13,53,45,8,43
AaB,7938,5,8,13,9,45,44,1,37
Sonderjyske,7938,6,8,6,10,28,29,-1,30
AC Horsens,7938,7,5,13,12,33,57,-24,28
Randers FC,7938,8,6,6,12,25,39,-14,24
Silkeborg IF,7938,9,5,4,13,27,46,-19,19
AGF Aarhus,7938,10,4,7,11,18,38,-20,19
Lyngby,7938,11,3,9,12,26,46,-20,18
Brondby,7939,1,20,6,4,72,33,39,66
FC Midtjylla,7939,2,19,5,6,68,45,23,62
Copenhagen,7939,3,15,5,10,64,47,17,50
FC Nords,7939,4,13,9,8,73,54,19,48
AC Horsens,7939,5,7,13,10,34,49,-15,34
AaB,7939,6,7,12,11,41,50,-9,33
Sonderjyske,7939,7,8,6,10,28,29,-1,30
Randers FC,7939,8,6,6,12,24,39,-15,24
Silkeborg IF,7939,9,5,4,13,26,45,-19,19
AGF Aarhus,7939,10,4,7,11,17,37,-20,19
Lyngby,7939,11,3,9,12,26,45,-19,18
Brondby,7940,1,21,5,4,66,30,36,68
FC Midtjylla,7940,2,19,7,4,60,34,26,64
FC Nords,7940,3,15,7,8,74,46,28,52
Copenhagen,7940,4,13,5,12,56,47,9,44
AaB,7940,5,7,12,11,33,43,-10,33
AC Horsens,7940,6,7,12,11,34,49,-15,33
Sonderjyske,7940,7,8,6,10,28,29,-1,30
Lyngby,7940,8,4,9,11,27,44,-17,21
Randers FC,7940,9,5,6,13,23,40,-17,21
Silkeborg IF,7940,10,5,4,13,27,46,-19,19
AGF Aarhus,7940,11,4,7,11,18,38,-20,19
Brondby,7941,1,20,5,5,67,34,33,65
FC Midtjylla,7941,2,20,5,5,68,41,27,65
FC Nords,7941,3,15,7,8,75,47,28,52
Copenhagen,7941,4,13,6,11,56,45,11,45
AaB,7941,5,9,11,10,41,48,-7,38
Sonderjyske,7941,6,8,6,10,28,29,-1,30
AC Horsens,7941,7,6,12,12,35,53,-18,30
Randers FC,7941,8,5,7,12,25,41,-16,22
Silkeborg IF,7941,9,6,3,13,28,44,-16,21
Lyngby,7941,10,3,10,11,28,46,-18,19
AGF Aarhus,7941,11,4,6,12,16,39,-23,18
Brondby,7942,1,21,7,2,76,33,43,70
FC Midtjylla,7942,2,18,7,5,68,42,26,61
FC Nords,7942,3,14,7,9,74,54,20,49
Copenhagen,7942,4,14,5,11,56,47,9,47
AaB,7942,5,7,14,9,40,46,-6,35
Sonderjyske,7942,6,8,6,10,28,29,-1,30
AC Horsens,7942,7,5,14,11,35,53,-18,29
Lyngby,7942,8,4,9,11,29,45,-16,21
Randers FC,7942,9,5,6,13,24,42,-18,21
AGF Aarhus,7942,10,5,6,11,20,39,-19,21
Silkeborg IF,7942,11,5,3,14,28,48,-20,18
Brondby,7943,1,21,5,4,72,31,41,68
FC Midtjylla,7943,2,19,5,6,65,45,20,62
FC Nords,7943,3,16,6,8,76,52,24,54
Copenhagen,7943,4,14,4,12,65,49,16,46
AaB,7943,5,8,11,11,40,43,-3,35
AC Horsens,7943,6,6,13,11,32,56,-24,31
Sonderjyske,7943,7,8,6,10,28,29,-1,30
Lyngby,7943,8,4,9,11,29,45,-16,21
Randers FC,7943,9,5,6,13,24,42,-18,21
Silkeborg IF,7943,10,5,4,13,26,45,-19,19
AGF Aarhus,7943,11,4,7,11,17,37,-20,19
Brondby,7944,1,21,5,4,73,33,40,68
FC Midtjylla,7944,2,20,5,5,67,38,29,65
Copenhagen,7944,3,15,5,10,61,41,20,50
FC Nords,7944,4,14,6,10,73,57,16,48
AC Horsens,7944,5,7,12,11,34,52,-18,33
AaB,7944,6,7,11,12,37,50,-13,32
Sonderjyske,7944,7,8,6,10,28,29,-1,30
Lyngby,7944,8,4,9,11,28,45,-17,21
Randers FC,7944,9,5,6,13,24,41,-17,21
AGF Aarhus,7944,10,5,6,11,18,37,-19,21
Silkeborg IF,7944,11,5,3,14,26,46,-20,18
Brondby,7945,1,22,6,2,71,30,41,72
FC Midtjylla,7945,2,19,6,5,69,41,28,63
FC Nords,7945,3,14,7,9,70,47,23,49
Copenhagen,7945,4,13,7,10,61,47,14,46
AaB,7945,5,7,11,12,36,46,-10,32
AC Horsens,7945,6,6,13,11,35,57,-22,31
Sonderjyske,7945,7,8,6,10,28,29,-1,30
Randers FC,7945,8,5,7,12,25,41,-16,22
Silkeborg IF,7945,9,6,3,13,28,44,-16,21
Lyngby,7945,10,3,10,11,28,46,-18,19
AGF Aarhus,7945,11,4,6,12,16,39,-23,18
Brondby,7946,1,20,6,4,71,32,39,66
FC Midtjylla,7946,2,18,6,6,66,44,22,60
FC Nords,7946,3,15,6,9,76,54,22,51
Copenhagen,7946,4,13,6,11,59,47,12,45
AaB,7946,5,10,11,9,36,37,-1,41
AC Horsens,7946,6,6,13,11,35,55,-20,31
Sonderjyske,7946,7,8,6,10,28,29,-1,30
Lyngby,7946,8,4,9,11,30,46,-16,21
Silkeborg IF,7946,9,6,3,13,26,44,-18,21
Randers FC,7946,10,5,6,13,25,43,-18,21
AGF Aarhus,7946,11,4,6,12,16,37,-21,18
Brondby,7947,1,22,6,2,74,33,41,72
FC Midtjylla,7947,2,20,4,6,66,35,31,64
FC Nords,7947,3,14,7,9,76,57,19,49
Copenhagen,7947,4,14,5,11,61,48,13,47
AaB,7947,5,8,12,10,39,44,-5,36
Sonderjyske,7947,6,8,6,10,28,29,-1,30
AC Horsens,7947,7,5,12,13,34,59,-25,27
Randers FC,7947,8,6,6,12,25,40,-15,24
AGF Aarhus,7947,9,5,6,11,17,36,-19,21
Lyngby,7947,10,3,9,12,27,46,-19,18
Silkeborg IF,7947,11,5,3,14,25,45,-20,18
Brondby,7948,1,22,5,3,74,30,44,71
FC Midtjylla,7948,2,20,4,6,64,39,25,64
FC Nords,7948,3,12,7,11,72,57,15,43
Copenhagen,7948,4,12,6,12,56,47,9,42
AaB,7948,5,9,12,9,38,43,-5,39
AC Horsens,7948,6,7,14,9,35,49,-14,35
Sonderjyske,7948,7,8,6,10,28,29,-1,30
Lyngby,7948,8,4,9,11,27,44,-17,21
Randers FC,7948,9,5,6,13,23,40,-17,21
AGF Aarhus,7948,10,5,6,11,18,36,-18,21
Silkeborg IF,7948,11,5,3,14,25,46,-21,18
FC Midtjylla,7949,1,21,4,5,67,38,29,67
Brondby,7949,2,20,6,4,73,37,36,66
FC Nords,7949,3,14,6,10,73,54,19,48
Copenhagen,7949,4,14,5,11,62,44,18,47
AaB,7949,5,7,14,9,37,41,-4,35
AC Horsens,7949,6,6,13,11,37,61,-24,31
Sonderjyske,7949,7,8,6,10,28,29,-1,30
Randers FC,7949,8,5,7,12,23,39,-16,22
Lyngby,7949,9,3,10,11,26,44,-18,19
Silkeborg IF,7949,10,5,4,13,27,46,-19,19
AGF Aarhus,7949,11,4,7,11,18,38,-20,19
Brondby,7950,1,21,5,4,75,34,41,68
FC Midtjylla,7950,2,21,5,4,68,38,30,68
FC Nords,7950,3,15,6,9,75,51,24,51
Copenhagen,7950,4,12,6,12,56,49,7,42
AC Horsens,7950,5,8,12,10,43,54,-11,36
Sonderjyske,7950,6,8,6,10,28,29,-1,30
AaB,7950,7,6,12,12,33,50,-17,30
Randers FC,7950,8,5,7,12,24,40,-16,22
AGF Aarhus,7950,9,5,6,11,18,37,-19,21
Lyngby,7950,10,3,10,11,27,45,-18,19
Silkeborg IF,7950,11,5,3,14,26,46,-20,18
Brondby,7951,1,21,7,2,70,31,39,70
FC Midtjylla,7951,2,18,7,5,65,40,25,61
FC Nords,7951,3,13,9,8,71,51,20,48
Copenhagen,7951,4,13,8,9,60,44,16,47
AaB,7951,5,7,13,10,36,43,-7,34
Sonderjyske,7951,6,8,6,10,28,29,-1,30
AC Horsens,7951,7,5,14,11,36,55,-19,29
Lyngby,7951,8,4,9,11,30,46,-16,21
Randers FC,7951,9,5,6,13,25,43,-18,21
AGF Aarhus,7951,10,5,6,11,18,36,-18,21
Silkeborg IF,7951,11,5,3,14,25,46,-21,18
Brondby,7952,1,22,6,2,70,31,39,72
FC Midtjylla,7952,2,19,4,7,63,39,24,61
FC Nords,7952,3,16,6,8,80,52,28,54
Copenhagen,7952,4,13,6,11,57,45,12,45
AC Horsens,7952,5,7,12,11,36,54,-18,33
Sonderjyske,7952,6,8,6,10,28,29,-1,30
AaB,7952,7,6,12,12,36,47,-11,30
Silkeborg IF,7952,8,6,3,13,28,44,-16,21
Lyngby,7952,9,4,9,11,28,45,-17,21
Randers FC,7952,10,5,6,13,24,41,-17,21
AGF Aarhus,7952,11,4,6,12,16,39,-23,18
Brondby,7953,1,21,5,4,74,36,38,68
FC Midtjylla,7953,2,19,5,6,69,41,28,62
FC Nords,7953,3,16,6,8,77,54,23,54
Copenhagen,7953,4,14,4,12,56,45,11,46
AC Horsens,7953,5,7,13,10,36,51,-15,34
AaB,7953,6,7,11,12,36,47,-11,32
Sonderjyske,7953,7,8,6,10,28,29,-1,30
Lyngby,7953,8,4,9,11,27,44,-17,21
Randers FC,7953,9,5,6,13,23,40,-17,21
Silkeborg IF,7953,10,5,4,13,28,47,-19,19
AGF Aarhus,7953,11,4,7,11,19,39,-20,19
Brondby,7954,1,21,6,3,72,31,41,69
FC Midtjylla,7954,2,19,5,6,65,44,21,62
Copenhagen,7954,3,14,6,10,55,39,16,48
FC Nords,7954,4,13,7,10,71,56,15,46
AaB,7954,5,9,11,10,39,40,-1,38
AC Horsens,7954,6,6,13,11,35,53,-18,31
Sonderjyske,7954,7,8,6,10,28,29,-1,30
Randers FC,7954,8,5,7,12,24,40,-16,22
Silkeborg IF,7954,9,6,3,13,27,45,-18,21
Lyngby,7954,10,3,10,11,27,45,-18,19
AGF Aarhus,7954,11,4,6,12,17,38,-21,18
Brondby,7955,1,22,5,3,72,30,42,71
FC Midtjylla,7955,2,18,5,7,63,40,23,59
FC Nords,7955,3,16,7,7,77,48,29,55
Copenhagen,7955,4,14,4,12,58,49,9,46
AaB,7955,5,6,14,10,36,44,-8,32
AC Horsens,7955,6,6,13,11,34,55,-21,31
Sonderjyske,7955,7,8,6,10,28,29,-1,30
Lyngby,7955,8,4,9,11,29,46,-17,21
Silkeborg IF,7955,9,6,3,13,28,45,-17,21
Randers FC,7955,10,5,6,13,25,42,-17,21
AGF Aarhus,7955,11,4,6,12,17,39,-22,18
Brondby,7956,1,21,6,3,75,35,40,69
FC Midtjylla,7956,2,19,4,7,61,39,22,61
FC Nords,7956,3,14,7,9,76,54,22,49
Copenhagen,7956,4,14,7,9,60,42,18,49
AaB,7956,5,8,12,10,35,40,-5,36
Sonderjyske,7956,6,8,6,10,28,29,-1,30
AC Horsens,7956,7,6,12,12,36,59,-23,30
Lyngby,7956,8,4,9,11,28,44,-16,21
Silkeborg IF,7956,9,6,3,13,27,45,-18,21
Randers FC,7956,10,5,6,13,23,41,-18,21
AGF Aarhus,7956,11,4,6,12,17,38,-21,18
Brondby,7957,1,21,6,3,74,34,40,69
FC Midtjylla,7957,2,20,5,5,67,42,25,65
FC Nords,7957,3,14,7,9,76,52,24,49
Copenhagen,7957,4,13,4,13,55,48,7,43
AaB,7957,5,7,13,10,37,43,-6,34
AC Horsens,7957,6,7,13,10,35,51,-16,34
Sonderjyske,7957,7,8,6,10,28,29,-1,30
Randers FC,7957,8,5,7,12,24,40,-16,22
Lyngby,7957,9,3,10,11,27,45,-18,19
Silkeborg IF,7957,10,5,4,13,28,47,-19,19
AGF Aarhus,7957,11,4,7,11,19,39,-20,19
Brondby,7958,1,22,5,3,75,32,43,71
FC Midtjylla,7958,2,20,4,6,64,39,25,64
FC Nords,7958,3,16,6,8,75,50,25,54
Copenhagen,7958,4,13,5,12,55,48,7,44
AaB,7958,5,7,11,12,40,48,-8,32
AC Horsens,7958,6,6,13,11,35,53,-18,31
Sonderjyske,7958,7,8,6,10,28,29,-1,30
Randers FC,7958,8,5,7,12,24,40,-16,22
AGF Aarhus,7958,9,5,6,11,18,37,-19,21
Lyngby,7958,10,3,10,11,27,45,-18,19
Silkeborg IF,7958,11,5,3,14,26,46,-20,18
Brondby,7959,1,22,5,3,74,30,44,71
FC Midtjylla,7959,2,18,5,7,64,44,20,59
FC Nords,7959,3,15,6,9,77,53,24,51
Copenhagen,7959,4,15,5,10,60,48,12,50
AC Horsens,7959,5,7,13,10,34,51,-17,34
Sonderjyske,7959,6,8,6,10,28,29,-1,30
AaB,7959,7,6,12,12,34,43,-9,30
Lyngby,7959,8,4,9,11,29,45,-16,21
Randers FC,7959,9,5,6,13,24,42,-18,21
Silkeborg IF,7959,10,5,4,13,26,45,-19,19
AGF Aarhus,7959,11,4,7,11,17,37,-20,19
Brondby,7960,1,21,6,3,74,32,42,69
FC Midtjylla,7960,2,20,5,5,65,38,27,65
Copenhagen,7960,3,14,7,9,61,44,17,49
FC Nords,7960,4,13,8,9,72,56,16,47
AaB,7960,5,7,12,11,41,46,-5,33
Sonderjyske,7960,6,8,6,10,28,29,-1,30
AC Horsens,7960,7,5,14,11,34,57,-23,29
Randers FC,7960,8,6,6,12,27,40,-13,24
Silkeborg IF,7960,9,6,3,13,27,45,-18,21
Lyngby,7960,10,3,9,12,27,48,-21,18
AGF Aarhus,7960,11,4,6,12,17,38,-21,18
Brondby,7961,1,19,5,6,69,38,31,62
FC Midtjylla,7961,2,19,4,7,66,44,22,61
FC Nords,7961,3,17,6,7,75,46,29,57
Copenhagen,7961,4,15,4,11,61,45,16,49
AaB,7961,5,8,12,10,42,45,-3,36
AC Horsens,7961,6,6,13,11,33,54,-21,31
Sonderjyske,7961,7,8,6,10,28,29,-1,30
Lyngby,7961,8,4,9,11,28,44,-16,21
Randers FC,7961,9,5,6,13,23,41,-18,21
Silkeborg IF,7961,10,5,4,13,26,45,-19,19
AGF Aarhus,7961,11,4,7,11,17,37,-20,19
Brondby,7962,1,21,7,2,74,29,45,70
FC Midtjylla,7962,2,19,4,7,63,47,16,61
FC Nords,7962,3,16,7,7,75,47,28,55
Copenhagen,7962,4,14,4,12,59,47,12,46
AaB,7962,5,6,13,11,34,44,-10,31
AC Horsens,7962,6,6,13,11,37,54,-17,31
Sonderjyske,7962,7,8,6,10,28,29,-1,30
Randers FC,7962,8,6,6,12,24,39,-15,24
Silkeborg IF,7962,9,6,3,13,28,45,-17,21
Lyngby,7962,10,3,9,12,26,45,-19,18
AGF Aarhus,7962,11,4,6,12,17,39,-22,18
Brondby,7963,1,21,6,3,71,32,39,69
FC Midtjylla,7963,2,18,5,7,62,40,22,59
FC Nords,7963,3,14,7,9,73,55,18,49
Copenhagen,7963,4,14,5,11,57,44,13,47
AaB,7963,5,8,12,10,43,48,-5,36
AC Horsens,7963,6,7,13,10,38,51,-13,34
Sonderjyske,7963,7,8,6,10,28,29,-1,30
Randers FC,7963,8,6,6,12,24,39,-15,24
AGF Aarhus,7963,9,5,6,11,19,36,-17,21
Lyngby,7963,10,3,9,12,26,45,-19,18
Silkeborg IF,7963,11,5,3,14,25,47,-22,18
Brondby,7964,1,20,7,3,71,35,36,67
FC Midtjylla,7964,2,20,5,5,64,37,27,65
FC Nords,7964,3,14,8,8,77,51,26,50
Copenhagen,7964,4,14,5,11,55,42,13,47
AaB,7964,5,7,14,9,39,41,-2,35
Sonderjyske,7964,6,8,6,10,28,29,-1,30
AC Horsens,7964,7,5,13,12,32,58,-26,28
Randers FC,7964,8,6,6,12,26,41,-15,24
Silkeborg IF,7964,9,6,3,13,30,46,-16,21
Lyngby,7964,10,3,9,12,28,47,-19,18
AGF Aarhus,7964,11,4,6,12,18,41,-23,18
FC Midtjylla,7965,1,20,4,6,67,36,31,64
Brondby,7965,2,19,6,5,67,35,32,63
FC Nords,7965,3,14,7,9,74,51,23,49
Copenhagen,7965,4,14,6,10,57,46,11,48
AaB,7965,5,10,11,9,39,39,0,41
Sonderjyske,7965,6,8,6,10,28,29,-1,30
AC Horsens,7965,7,6,12,12,35,58,-23,30
Lyngby,7965,8,4,9,11,29,44,-15,21
Silkeborg IF,7965,9,6,3,13,26,44,-18,21
Randers FC,7965,10,5,6,13,23,42,-19,21
AGF Aarhus,7965,11,4,6,12,16,37,-21,18
Brondby,7966,1,19,7,4,73,41,32,64
FC Midtjylla,7966,2,18,6,6,65,42,23,60
FC Nords,7966,3,15,7,8,78,52,26,52
Copenhagen,7966,4,15,5,10,62,46,16,50
AC Horsens,7966,5,7,13,10,39,56,-17,34
AaB,7966,6,7,12,11,34,40,-6,33
Sonderjyske,7966,7,8,6,10,28,29,-1,30
Lyngby,7966,8,4,9,11,28,44,-16,21
Randers FC,7966,9,5,6,13,23,41,-18,21
Silkeborg IF,7966,10,5,4,13,25,44,-19,19
AGF Aarhus,7966,11,4,7,11,16,36,-20,19
Brondby,7967,1,22,5,3,72,30,42,71
FC Midtjylla,7967,2,20,5,5,69,41,28,65
Copenhagen,7967,3,14,4,12,59,50,9,46
FC Nords,7967,4,13,6,11,75,55,20,45
AaB,7967,5,7,13,10,41,50,-9,34
AC Horsens,7967,6,7,13,10,41,57,-16,34
Sonderjyske,7967,7,8,6,10,28,29,-1,30
Lyngby,7967,8,4,9,11,28,44,-16,21
Randers FC,7967,9,5,6,13,23,41,-18,21
Silkeborg IF,7967,10,5,4,13,25,44,-19,19
AGF Aarhus,7967,11,4,7,11,16,36,-20,19
FC Midtjylla,7968,1,22,4,4,67,36,31,70
Brondby,7968,2,21,5,4,70,32,38,68
FC Nords,7968,3,13,8,9,68,48,20,47
Copenhagen,7968,4,14,5,11,57,45,12,47
AaB,7968,5,8,11,11,38,44,-6,35
Sonderjyske,7968,6,8,6,10,28,29,-1,30
AC Horsens,7968,7,5,13,12,32,53,-21,28
Randers FC,7968,8,5,7,12,23,39,-16,22
AGF Aarhus,7968,9,5,6,11,18,37,-19,21
Lyngby,7968,10,3,10,11,26,44,-18,19
Silkeborg IF,7968,11,5,3,14,26,46,-20,18
Brondby,7969,1,22,5,3,76,31,45,71
FC Midtjylla,7969,2,19,5,6,67,41,26,62
FC Nords,7969,3,15,7,8,76,51,25,52
Copenhagen,7969,4,13,5,12,54,51,3,44
AaB,7969,5,7,13,10,41,47,-6,34
Sonderjyske,7969,6,8,6,10,28,29,-1,30
AC Horsens,7969,7,5,15,10,33,52,-19,30
Randers FC,7969,8,5,7,12,24,40,-16,22
AGF Aarhus,7969,9,5,6,11,18,37,-19,21
Lyngby,7969,10,3,10,11,27,45,-18,19
Silkeborg IF,7969,11,5,3,14,26,46,-20,18
Brondby,7970,1,22,5,3,73,30,43,71
FC Midtjylla,7970,2,20,4,6,63,38,25,64
FC Nords,7970,3,13,7,10,70,50,20,46
AaB,7970,4,10,12,8,42,40,2,42
Copenhagen,7970,5,12,5,13,55,48,7,41
AC Horsens,7970,6,6,13,11,33,56,-23,31
Sonderjyske,7970,7,8,6,10,28,29,-1,30
Randers FC,7970,8,5,7,12,25,41,-16,22
Silkeborg IF,7970,9,6,3,13,28,44,-16,21
Lyngby,7970,10,3,10,11,28,46,-18,19
AGF Aarhus,7970,11,4,6,12,16,39,-23,18
Brondby,7971,1,20,6,4,72,39,33,66
FC Midtjylla,7971,2,20,5,5,64,37,27,65
FC Nords,7971,3,14,8,8,77,53,24,50
Copenhagen,7971,4,13,7,10,59,44,15,46
AaB,7971,5,7,13,10,39,45,-6,34
Sonderjyske,7971,6,8,6,10,28,29,-1,30
AC Horsens,7971,7,5,15,10,33,52,-19,30
Randers FC,7971,8,5,7,12,25,41,-16,22
Lyngby,7971,9,3,10,11,28,46,-18,19
Silkeborg IF,7971,10,5,4,13,27,46,-19,19
AGF Aarhus,7971,11,4,7,11,18,38,-20,19
Brondby,7972,1,21,6,3,70,31,39,69
FC Midtjylla,7972,2,18,6,6,63,40,23,60
FC Nords,7972,3,15,7,8,76,50,26,52
Copenhagen,7972,4,14,6,10,57,42,15,48
AaB,7972,5,6,15,9,35,42,-7,33
Sonderjyske,7972,6,8,6,10,28,29,-1,30
AC Horsens,7972,7,6,12,12,34,56,-22,30
Randers FC,7972,8,5,7,12,24,40,-16,22
Silkeborg IF,7972,9,6,3,13,27,44,-17,21
Lyngby,7972,10,3,10,11,27,45,-18,19
AGF Aarhus,7972,11,4,6,12,16,38,-22,18
Brondby,7973,1,22,5,3,74,29,45,71
FC Midtjylla,7973,2,21,5,4,67,37,30,68
FC Nords,7973,3,13,8,9,72,54,18,47
Copenhagen,7973,4,12,5,13,57,51,6,41
AaB,7973,5,7,13,10,38,42,-4,34
AC Horsens,7973,6,6,14,10,33,54,-21,32
Sonderjyske,7973,7,8,6,10,28,29,-1,30
Lyngby,7973,8,4,9,11,29,45,-16,21
Silkeborg IF,7973,9,6,3,13,26,44,-18,21
Randers FC,7973,10,5,6,13,24,42,-18,21
AGF Aarhus,7973,11,4,6,12,16,37,-21,18
Brondby,7974,1,20,7,3,70,32,38,67
FC Midtjylla,7974,2,17,5,8,64,46,18,56
FC Nords,7974,3,14,8,8,67,49,18,50
Copenhagen,7974,4,14,7,9,56,40,16,49
AaB,7974,5,8,13,9,41,39,2,37
AC Horsens,7974,6,6,14,10,35,53,-18,32
Sonderjyske,7974,7,8,6,10,28,29,-1,30
Lyngby,7974,8,4,9,11,29,46,-17,21
Randers FC,7974,9,5,6,13,25,42,-17,21
Silkeborg IF,7974,10,5,4,13,26,45,-19,19
AGF Aarhus,7974,11,4,7,11,17,37,-20,19
FC Midtjylla,7975,1,21,4,5,65,37,28,67
Brondby,7975,2,20,6,4,68,33,35,66
FC Nords,7975,3,15,6,9,74,50,24,51
Copenhagen,7975,4,12,5,13,57,49,8,41
AaB,7975,5,10,11,9,39,40,-1,41
Sonderjyske,7975,6,8,6,10,28,29,-1,30
AC Horsens,7975,7,5,14,11,38,58,-20,29
Lyngby,7975,8,4,9,11,28,44,-16,21
Silkeborg IF,7975,9,6,3,13,27,44,-17,21
Randers FC,7975,10,5,6,13,23,41,-18,21
AGF Aarhus,7975,11,4,6,12,16,38,-22,18
Brondby,7976,1,21,7,2,75,33,42,70
FC Midtjylla,7976,2,19,7,4,66,40,26,64
Copenhagen,7976,3,14,7,9,59,43,16,49
FC Nords,7976,4,12,8,10,75,59,16,44
AaB,7976,5,7,14,9,38,43,-5,35
Sonderjyske,7976,6,8,6,10,28,29,-1,30
AC Horsens,7976,7,5,13,12,34,55,-21,28
Lyngby,7976,8,4,9,11,28,44,-16,21
Randers FC,7976,9,5,6,13,23,41,-18,21
AGF Aarhus,7976,10,5,6,11,17,36,-19,21
Silkeborg IF,7976,11,5,3,14,25,45,-20,18
Brondby,7977,1,22,6,2,75,30,45,72
FC Midtjylla,7977,2,19,5,6,63,39,24,62
Copenhagen,7977,3,15,6,9,59,43,16,51
FC Nords,7977,4,13,6,11,70,52,18,45
AaB,7977,5,8,11,11,35,43,-8,35
Sonderjyske,7977,6,8,6,10,28,29,-1,30
AC Horsens,7977,7,6,12,12,35,56,-21,30
Randers FC,7977,8,5,7,12,23,39,-16,22
Silkeborg IF,7977,9,6,3,13,28,44,-16,21
Lyngby,7977,10,3,10,11,26,44,-18,19
AGF Aarhus,7977,11,4,6,12,16,39,-23,18
Brondby,7978,1,23,5,2,75,31,44,74
FC Midtjylla,7978,2,19,6,5,67,41,26,63
FC Nords,7978,3,14,8,8,75,54,21,50
Copenhagen,7978,4,14,5,11,57,43,14,47
Sonderjyske,7978,5,8,6,10,28,29,-1,30
AaB,7978,6,6,12,12,35,46,-11,30
AC Horsens,7978,7,6,12,12,36,56,-20,30
Randers FC,7978,8,6,6,12,25,40,-15,24
Silkeborg IF,7978,9,6,3,13,27,44,-17,21
Lyngby,7978,10,3,9,12,27,46,-19,18
AGF Aarhus,7978,11,4,6,12,16,38,-22,18
Brondby,7979,1,21,5,4,73,34,39,68
FC Midtjylla,7979,2,18,6,6,65,45,20,60
FC Nords,7979,3,16,6,8,80,54,26,54
Copenhagen,7979,4,13,6,11,57,43,14,45
AC Horsens,7979,5,7,13,10,42,57,-15,34
AaB,7979,6,6,14,10,38,48,-10,32
Sonderjyske,7979,7,8,6,10,28,29,-1,30
Randers FC,7979,8,6,6,12,26,40,-14,24
Silkeborg IF,7979,9,6,3,13,26,44,-18,21
Lyngby,7979,10,3,9,12,27,47,-20,18
AGF Aarhus,7979,11,4,6,12,16,37,-21,18
Brondby,7980,1,22,6,2,78,32,46,72
FC Midtjylla,7980,2,19,4,7,66,43,23,61
Copenhagen,7980,3,15,5,10,59,43,16,50
FC Nords,7980,4,13,7,10,72,56,16,46
AaB,7980,5,7,12,11,37,46,-9,33
AC Horsens,7980,6,7,12,11,35,53,-18,33
Sonderjyske,7980,7,8,6,10,28,29,-1,30
Randers FC,7980,8,5,7,12,25,41,-16,22
Lyngby,7980,9,3,10,11,28,46,-18,19
Silkeborg IF,7980,10,5,4,13,27,46,-19,19
AGF Aarhus,7980,11,4,7,11,18,38,-20,19
Brondby,7981,1,22,5,3,75,29,46,71
FC Midtjylla,7981,2,20,4,6,68,43,25,64
FC Nords,7981,3,15,7,8,77,50,27,52
Copenhagen,7981,4,13,6,11,58,48,10,45
AaB,7981,5,7,11,12,36,52,-16,32
AC Horsens,7981,6,6,13,11,35,53,-18,31
Sonderjyske,7981,7,8,6,10,28,29,-1,30
Randers FC,7981,8,5,7,12,23,39,-16,22
Silkeborg IF,7981,9,6,3,13,27,45,-18,21
Lyngby,7981,10,3,10,11,26,44,-18,19
AGF Aarhus,7981,11,4,6,12,17,38,-21,18
Brondby,7982,1,20,7,3,72,35,37,67
FC Midtjylla,7982,2,18,7,5,62,38,24,61
FC Nords,7982,3,15,6,9,78,50,28,51
Copenhagen,7982,4,15,5,10,60,46,14,50
AaB,7982,5,7,11,12,33,47,-14,32
AC Horsens,7982,6,6,14,10,37,52,-15,32
Sonderjyske,7982,7,8,6,10,28,29,-1,30
Randers FC,7982,8,6,6,12,27,42,-15,24
Silkeborg IF,7982,9,6,3,13,27,44,-17,21
Lyngby,7982,10,3,9,12,29,48,-19,18
AGF Aarhus,7982,11,4,6,12,16,38,-22,18
Brondby,7983,1,21,7,2,73,32,41,70
FC Midtjylla,7983,2,20,5,5,72,40,32,65
Copenhagen,7983,3,15,5,10,60,44,16,50
FC Nords,7983,4,12,7,11,70,60,10,43
AaB,7983,5,8,12,10,37,42,-5,36
Sonderjyske,7983,6,8,6,10,28,29,-1,30
AC Horsens,7983,7,5,14,11,34,54,-20,29
Randers FC,7983,8,5,7,12,25,41,-16,22
Lyngby,7983,9,3,10,11,28,46,-18,19
Silkeborg IF,7983,10,5,4,13,26,45,-19,19
AGF Aarhus,7983,11,4,7,11,17,37,-20,19
Brondby,7984,1,22,6,2,69,28,41,72
FC Midtjylla,7984,2,19,4,7,67,43,24,61
FC Nords,7984,3,14,7,9,76,53,23,49
Copenhagen,7984,4,13,6,11,62,50,12,45
AaB,7984,5,8,11,11,36,44,-8,35
AC Horsens,7984,6,7,12,11,36,54,-18,33
Sonderjyske,7984,7,8,6,10,28,29,-1,30
Lyngby,7984,8,4,9,11,27,44,-17,21
Randers FC,7984,9,5,6,13,23,40,-17,21
Silkeborg IF,7984,10,5,4,13,25,44,-19,19
AGF Aarhus,7984,11,4,7,11,16,36,-20,19
Brondby,7985,1,21,5,4,69,30,39,68
FC Midtjylla,7985,2,20,5,5,64,37,27,65
Copenhagen,7985,3,15,5,10,62,45,17,50
FC Nords,7985,4,14,6,10,73,52,21,48
AaB,7985,5,8,11,11,37,43,-6,35
Sonderjyske,7985,6,8,6,10,28,29,-1,30
AC Horsens,7985,7,6,12,12,36,60,-24,30
Randers FC,7985,8,5,7,12,23,39,-16,22
AGF Aarhus,7985,9,5,6,11,18,37,-19,21
Lyngby,7985,10,3,10,11,26,44,-18,19
Silkeborg IF,7985,11,5,3,14,26,46,-20,18
FC Midtjylla,7986,1,22,4,4,69,33,36,70
Brondby,7986,2,19,6,5,67,35,32,63
FC Nords,7986,3,15,6,9,76,52,24,51
Copenhagen,7986,4,15,5,10,57,42,15,50
AaB,7986,5,7,11,12,34,46,-12,32
Sonderjyske,7986,6,8,6,10,28,29,-1,30
AC Horsens,7986,7,6,12,12,31,52,-21,30
Randers FC,7986,8,6,6,12,25,40,-15,24
Silkeborg IF,7986,9,6,3,13,27,44,-17,21
Lyngby,7986,10,3,9,12,27,46,-19,18
AGF Aarhus,7986,11,4,6,12,16,38,-22,18
FC Midtjylla,7987,1,21,5,4,73,41,32,68
Brondby,7987,2,20,6,4,71,36,35,66
FC Nords,7987,3,14,6,10,71,52,19,48
Copenhagen,7987,4,13,5,12,57,48,9,44
AC Horsens,7987,5,7,14,9,37,52,-15,35
AaB,7987,6,6,14,10,37,43,-6,32
Sonderjyske,7987,7,8,6,10,28,29,-1,30
Randers FC,7987,8,5,7,12,24,40,-16,22
AGF Aarhus,7987,9,5,6,11,18,37,-19,21
Lyngby,7987,10,3,10,11,27,45,-18,19
Silkeborg IF,7987,11,5,3,14,26,46,-20,18
Brondby,7988,1,21,7,2,74,31,43,70
FC Midtjylla,7988,2,20,5,5,67,39,28,65
FC Nords,7988,3,15,6,9,75,51,24,51
Copenhagen,7988,4,13,6,11,54,44,10,45
AaB,7988,5,8,11,11,36,46,-10,35
Sonderjyske,7988,6,8,6,10,28,29,-1,30
AC Horsens,7988,7,5,13,12,31,52,-21,28
Randers FC,7988,8,5,7,12,23,39,-16,22
Silkeborg IF,7988,9,6,3,13,28,44,-16,21
Lyngby,7988,10,3,10,11,26,44,-18,19
AGF Aarhus,7988,11,4,6,12,16,39,-23,18
Brondby,7989,1,21,6,3,72,30,42,69
FC Midtjylla,7989,2,19,6,5,63,36,27,63
FC Nords,7989,3,15,7,8,77,54,23,52
Copenhagen,7989,4,13,6,11,55,46,9,45
AaB,7989,5,7,13,10,39,43,-4,34
Sonderjyske,7989,6,8,6,10,28,29,-1,30
AC Horsens,7989,7,5,14,11,34,57,-23,29
Randers FC,7989,8,5,7,12,24,40,-16,22
Lyngby,7989,9,3,10,11,27,45,-18,19
Silkeborg IF,7989,10,5,4,13,27,46,-19,19
AGF Aarhus,7989,11,4,7,11,18,38,-20,19
Brondby,7990,1,22,5,3,73,29,44,71
FC Midtjylla,7990,2,20,5,5,70,40,30,65
FC Nords,7990,3,14,6,10,75,56,19,48
Copenhagen,7990,4,12,5,13,55,48,7,41
AC Horsens,7990,5,8,12,10,37,52,-15,36
AaB,7990,6,8,11,11,36,47,-11,35
Sonderjyske,7990,7,8,6,10,28,29,-1,30
Randers FC,7990,8,5,7,12,23,39,-16,22
AGF Aarhus,7990,9,5,6,11,18,36,-18,21
Lyngby,7990,10,3,10,11,26,44,-18,19
Silkeborg IF,7990,11,5,3,14,25,46,-21,18
Brondby,7991,1,22,5,3,75,34,41,71
FC Midtjylla,7991,2,19,6,5,64,39,25,63
FC Nords,7991,3,15,6,9,78,52,26,51
Copenhagen,7991,4,13,5,12,55,49,6,44
AC Horsens,7991,5,7,13,10,36,52,-16,34
AaB,7991,6,7,11,12,38,46,-8,32
Sonderjyske,7991,7,8,6,10,28,29,-1,30
Randers FC,7991,8,5,7,12,23,39,-16,22
Silkeborg IF,7991,9,6,3,13,29,45,-16,21
Lyngby,7991,10,3,10,11,26,44,-18,19
AGF Aarhus,7991,11,4,6,12,17,40,-23,18
Brondby,7992,1,20,6,4,74,35,39,66
FC Midtjylla,7992,2,20,5,5,66,37,29,65
Copenhagen,7992,3,15,6,9,63,44,19,51
FC Nords,7992,4,14,7,9,73,53,20,49
AaB,7992,5,6,13,11,37,50,-13,31
AC Horsens,7992,6,6,13,11,36,56,-20,31
Sonderjyske,7992,7,8,6,10,28,29,-1,30
Lyngby,7992,8,4,9,11,29,45,-16,21
Randers FC,7992,9,5,6,13,24,42,-18,21
Silkeborg IF,7992,10,5,4,13,26,45,-19,19
AGF Aarhus,7992,11,4,7,11,17,37,-20,19
Brondby,7993,1,20,6,4,67,33,34,66
FC Midtjylla,7993,2,19,4,7,67,44,23,61
FC Nords,7993,3,14,7,9,76,53,23,49
Copenhagen,7993,4,15,4,11,58,44,14,49
AaB,7993,5,9,12,9,42,46,-4,39
AC Horsens,7993,6,6,13,11,35,51,-16,31
Sonderjyske,7993,7,8,6,10,28,29,-1,30
Randers FC,7993,8,5,7,12,23,39,-16,22
Silkeborg IF,7993,9,6,3,13,27,45,-18,21
Lyngby,7993,10,3,10,11,26,44,-18,19
AGF Aarhus,7993,11,4,6,12,17,38,-21,18
Brondby,7994,1,21,7,2,72,33,39,70
FC Midtjylla,7994,2,19,6,5,67,42,25,63
Copenhagen,7994,3,14,7,9,59,43,16,49
FC Nords,7994,4,12,8,10,72,57,15,44
AaB,7994,5,8,12,10,42,44,-2,36
Sonderjyske,7994,6,8,6,10,28,29,-1,30
AC Horsens,7994,7,5,14,11,37,56,-19,29
Lyngby,7994,8,4,9,11,28,44,-16,21
Silkeborg IF,7994,9,6,3,13,27,45,-18,21
Randers FC,7994,10,5,6,13,23,41,-18,21
AGF Aarhus,7994,11,4,6,12,17,38,-21,18
Brondby,7995,1,22,6,2,75,34,41,72
FC Midtjylla,7995,2,20,4,6,70,44,26,64
FC Nords,7995,3,14,6,10,70,51,19,48
Copenhagen,7995,4,14,4,12,58,46,12,46
AaB,7995,5,9,11,10,41,43,-2,38
Sonderjyske,7995,6,8,6,10,28,29,-1,30
AC Horsens,7995,7,5,13,12,33,55,-22,28
Randers FC,7995,8,6,6,12,24,39,-15,24
Silkeborg IF,7995,9,6,3,13,27,44,-17,21
Lyngby,7995,10,3,9,12,26,45,-19,18
AGF Aarhus,7995,11,4,6,12,16,38,-22,18
Brondby,7996,1,20,6,4,69,36,33,66
FC Midtjylla,7996,2,19,6,5,66,41,25,63
Copenhagen,7996,3,15,6,9,62,42,20,51
FC Nords,7996,4,14,7,9,76,51,25,49
AaB,7996,5,6,14,10,40,48,-8,32
Sonderjyske,7996,6,8,6,10,28,29,-1,30
AC Horsens,7996,7,5,15,10,31,52,-21,30
Lyngby,7996,8,4,9,11,27,44,-17,21
Randers FC,7996,9,5,6,13,23,40,-17,21
Silkeborg IF,7996,10,6,3,13,28,46,-18,21
AGF Aarhus,7996,11,4,6,12,18,39,-21,18
Brondby,7997,1,21,6,3,78,34,44,69
FC Midtjylla,7997,2,21,4,5,69,45,24,67
Copenhagen,7997,3,15,5,10,62,47,15,50
FC Nords,7997,4,13,6,11,75,57,18,45
AaB,7997,5,8,12,10,38,44,-6,36
Sonderjyske,7997,6,8,6,10,28,29,-1,30
AC Horsens,7997,7,5,13,12,32,53,-21,28
Lyngby,7997,8,4,9,11,27,44,-17,21
Randers FC,7997,9,5,6,13,23,40,-17,21
Silkeborg IF,7997,10,5,4,13,25,44,-19,19
AGF Aarhus,7997,11,4,7,11,16,36,-20,19
Brondby,7998,1,21,6,3,72,33,39,69
FC Midtjylla,7998,2,19,4,7,63,42,21,61
Copenhagen,7998,3,15,5,10,59,41,18,50
FC Nords,7998,4,13,6,11,75,59,16,45
AaB,7998,5,8,11,11,34,42,-8,35
AC Horsens,7998,6,7,14,9,37,49,-12,35
Sonderjyske,7998,7,8,6,10,28,29,-1,30
Lyngby,7998,8,4,9,11,28,44,-16,21
Silkeborg IF,7998,9,6,3,13,28,45,-17,21
Randers FC,7998,10,5,6,13,23,41,-18,21
AGF Aarhus,7998,11,4,6,12,17,39,-22,18
FC Midtjylla,7999,1,20,6,4,68,35,33,66
Brondby,7999,2,19,5,6,66,34,32,62
FC Nords,7999,3,15,6,9,74,53,21,51
Copenhagen,7999,4,14,4,12,54,45,9,46
AaB,7999,5,9,12,9,36,40,-4,39
AC Horsens,7999,6,6,13,11,31,48,-17,31
Sonderjyske,7999,7,8,6,10,28,29,-1,30
Lyngby,7999,8,4,9,11,27,44,-17,21
Randers FC,7999,9,5,6,13,23,40,-17,21
AGF Aarhus,7999,10,5,6,11,17,36,-19,21
Silkeborg IF,7999,11,5,3,14,25,45,-20,18
Brondby,8000,1,23,5,2,79,28,51,74
FC Midtjylla,8000,2,19,5,6,62,40,22,62
Copenhagen,8000,3,14,5,11,60,46,14,47
FC Nords,8000,4,12,10,8,72,54,18,46
AC Horsens,8000,5,7,13,10,35,52,-17,34
Sonderjyske,8000,6,8,6,10,28,29,-1,30
AaB,8000,7,6,12,12,35,49,-14,30
Lyngby,8000,8,4,9,11,27,44,-17,21
Randers FC,8000,9,5,6,13,23,40,-17,21
Silkeborg IF,8000,10,5,4,13,26,45,-19,19
AGF Aarhus,8000,11,4,7,11,17,37,-20,19
Brondby,8001,1,22,6,2,69,27,42,72
FC Midtjylla,8001,2,19,5,6,68,43,25,62
FC Nords,8001,3,13,8,9,70,53,17,47
Copenhagen,8001,4,14,4,12,58,46,12,46
AC Horsens,8001,5,7,13,10,36,51,-15,34
AaB,8001,6,7,12,11,36,43,-7,33
Sonderjyske,8001,7,8,6,10,28,29,-1,30
Randers FC,8001,8,6,6,12,24,39,-15,24
Silkeborg IF,8001,9,6,3,13,28,46,-18,21
Lyngby,8001,10,3,9,12,26,45,-19,18
AGF Aarhus,8001,11,4,6,12,18,39,-21,18
Brondby,8002,1,22,6,2,68,27,41,72
FC Midtjylla,8002,2,19,4,7,67,42,25,61
Copenhagen,8002,3,14,5,11,60,43,17,47
FC Nords,8002,4,13,7,10,71,55,16,46
AaB,8002,5,9,11,10,37,40,-3,38
AC Horsens,8002,6,6,13,11,37,59,-22,31
Sonderjyske,8002,7,8,6,10,28,29,-1,30
Randers FC,8002,8,6,6,12,25,39,-14,24
AGF Aarhus,8002,9,5,6,11,19,37,-18,21
Lyngby,8002,10,3,9,12,26,46,-20,18
Silkeborg IF,8002,11,5,3,14,26,47,-21,18
Brondby,8003,1,22,6,2,77,29,48,72
FC Midtjylla,8003,2,20,4,6,67,41,26,64
FC Nords,8003,3,14,6,10,73,54,19,48
Copenhagen,8003,4,14,6,10,55,41,14,48
AaB,8003,5,7,12,11,39,47,-8,33
Sonderjyske,8003,6,8,6,10,28,29,-1,30
AC Horsens,8003,7,5,14,11,36,61,-25,29
Randers FC,8003,8,5,7,12,24,40,-16,22
Lyngby,8003,9,3,10,11,27,45,-18,19
Silkeborg IF,8003,10,5,4,13,25,44,-19,19
AGF Aarhus,8003,11,4,7,11,16,36,-20,19
Brondby,8004,1,21,7,2,72,31,41,70
FC Midtjylla,8004,2,17,7,6,66,44,22,58
FC Nords,8004,3,15,6,9,77,54,23,51
Copenhagen,8004,4,14,6,10,59,46,13,48
AaB,8004,5,8,11,11,38,45,-7,35
AC Horsens,8004,6,6,13,11,38,56,-18,31
Sonderjyske,8004,7,8,6,10,28,29,-1,30
Lyngby,8004,8,4,9,11,29,46,-17,21
Randers FC,8004,9,5,6,13,25,42,-17,21
Silkeborg IF,8004,10,6,3,13,27,45,-18,21
AGF Aarhus,8004,11,4,6,12,17,38,-21,18
Brondby,8005,1,23,5,2,73,28,45,74
FC Midtjylla,8005,2,19,4,7,64,41,23,61
FC Nords,8005,3,15,7,8,72,49,23,52
Copenhagen,8005,4,13,6,11,54,43,11,45
AaB,8005,5,7,13,10,35,42,-7,34
Sonderjyske,8005,6,8,6,10,28,29,-1,30
AC Horsens,8005,7,5,13,12,31,52,-21,28
Randers FC,8005,8,6,6,12,24,39,-15,24
Silkeborg IF,8005,9,6,3,13,26,44,-18,21
Lyngby,8005,10,3,9,12,26,45,-19,18
AGF Aarhus,8005,11,4,6,12,16,37,-21,18
Brondby,8006,1,20,5,5,69,39,30,65
FC Midtjylla,8006,2,18,5,7,70,48,22,59
FC Nords,8006,3,16,7,7,83,51,32,55
Copenhagen,8006,4,14,7,9,63,45,18,49
AaB,8006,5,6,14,10,36,47,-11,32
AC Horsens,8006,6,6,14,10,39,56,-17,32
Sonderjyske,8006,7,8,6,10,28,29,-1,30
Randers FC,8006,8,5,7,12,23,39,-16,22
Silkeborg IF,8006,9,6,3,13,27,45,-18,21
Lyngby,8006,10,3,10,11,26,44,-18,19
AGF Aarhus,8006,11,4,6,12,17,38,-21,18
Brondby,8007,1,20,6,4,74,37,37,66
FC Midtjylla,8007,2,20,5,5,68,43,25,65
FC Nords,8007,3,13,7,10,71,57,14,46
Copenhagen,8007,4,13,6,11,57,46,11,45
AC Horsens,8007,5,7,15,8,41,49,-8,36
AaB,8007,6,7,13,10,38,43,-5,34
Sonderjyske,8007,7,8,6,10,28,29,-1,30
Randers FC,8007,8,6,6,12,25,40,-15,24
AGF Aarhus,8007,9,5,6,11,19,36,-17,21
Lyngby,8007,10,3,9,12,27,46,-19,18
Silkeborg IF,8007,11,5,3,14,25,47,-22,18
Brondby,8008,1,22,5,3,73,29,44,71
FC Midtjylla,8008,2,19,5,6,62,38,24,62
FC Nords,8008,3,15,6,9,75,52,23,51
Copenhagen,8008,4,13,4,13,58,48,10,43
AaB,8008,5,9,11,10,37,42,-5,38
AC Horsens,8008,6,6,13,11,34,56,-22,31
Sonderjyske,8008,7,8,6,10,28,29,-1,30
Lyngby,8008,8,4,9,11,29,46,-17,21
Randers FC,8008,9,5,6,13,25,42,-17,21
Silkeborg IF,8008,10,5,4,13,25,44,-19,19
AGF Aarhus,8008,11,4,7,11,16,36,-20,19
Brondby,8009,1,20,7,3,65,29,36,67
FC Midtjylla,8009,2,19,5,6,63,39,24,62
FC Nords,8009,3,14,7,9,73,51,22,49
Copenhagen,8009,4,14,4,12,56,45,11,46
AaB,8009,5,8,12,10,36,43,-7,36
AC Horsens,8009,6,6,15,9,38,50,-12,33
Sonderjyske,8009,7,8,6,10,28,29,-1,30
Lyngby,8009,8,4,9,11,28,44,-16,21
Randers FC,8009,9,5,6,13,23,41,-18,21
Silkeborg IF,8009,10,5,4,13,28,47,-19,19
AGF Aarhus,8009,11,4,7,11,19,39,-20,19
Brondby,8010,1,20,6,4,69,34,35,66
FC Midtjylla,8010,2,20,5,5,68,36,32,65
Copenhagen,8010,3,15,4,11,57,44,13,49
FC Nords,8010,4,13,6,11,69,53,16,45
AaB,8010,5,8,14,8,35,36,-1,38
AC Horsens,8010,6,6,13,11,32,53,-21,31
Sonderjyske,8010,7,8,6,10,28,29,-1,30
Lyngby,8010,8,4,9,11,30,46,-16,21
Randers FC,8010,9,5,6,13,25,43,-18,21
AGF Aarhus,8010,10,5,6,11,18,37,-19,21
Silkeborg IF,8010,11,5,3,14,26,46,-20,18
Brondby,8011,1,21,5,4,72,31,41,68
FC Midtjylla,8011,2,21,4,5,67,38,29,67
FC Nords,8011,3,14,6,10,72,52,20,48
Copenhagen,8011,4,14,4,12,54,45,9,46
AC Horsens,8011,5,8,12,10,37,52,-15,36
AaB,8011,6,7,11,12,36,46,-10,32
Sonderjyske,8011,7,8,6,10,28,29,-1,30
Randers FC,8011,8,5,7,12,24,40,-16,22
Silkeborg IF,8011,9,6,3,13,27,45,-18,21
Lyngby,8011,10,3,10,11,27,45,-18,19
AGF Aarhus,8011,11,4,6,12,17,38,-21,18
Brondby,8012,1,21,6,3,71,32,39,69
FC Midtjylla,8012,2,19,5,6,60,37,23,62
FC Nords,8012,3,15,6,9,71,49,22,51
Copenhagen,8012,4,14,4,12,57,44,13,46
AaB,8012,5,9,13,8,35,36,-1,40
Sonderjyske,8012,6,8,6,10,28,29,-1,30
AC Horsens,8012,7,5,12,13,32,54,-22,27
Lyngby,8012,8,4,9,11,27,44,-17,21
Randers FC,8012,9,5,6,13,23,40,-17,21
AGF Aarhus,8012,10,5,6,11,18,37,-19,21
Silkeborg IF,8012,11,5,3,14,26,46,-20,18
Brondby,8013,1,20,5,5,66,33,33,65
FC Midtjylla,8013,2,19,6,5,64,37,27,63
FC Nords,8013,3,14,7,9,74,53,21,49
Copenhagen,8013,4,13,6,11,56,45,11,45
AaB,8013,5,9,11,10,38,37,1,38
AC Horsens,8013,6,7,13,10,37,56,-19,34
Sonderjyske,8013,7,8,6,10,28,29,-1,30
Randers FC,8013,8,5,7,12,23,39,-16,22
AGF Aarhus,8013,9,5,6,11,17,36,-19,21
Lyngby,8013,10,3,10,11,26,44,-18,19
Silkeborg IF,8013,11,5,3,14,25,45,-20,18
Brondby,8014,1,21,5,4,71,36,35,68
FC Midtjylla,8014,2,19,4,7,69,42,27,61
FC Nords,8014,3,17,6,7,83,50,33,57
Copenhagen,8014,4,13,4,13,54,48,6,43
AC Horsens,8014,5,8,12,10,39,54,-15,36
AaB,8014,6,7,11,12,40,52,-12,32
Sonderjyske,8014,7,8,6,10,28,29,-1,30
Randers FC,8014,8,5,7,12,24,40,-16,22
AGF Aarhus,8014,9,5,6,11,17,36,-19,21
Lyngby,8014,10,3,10,11,27,45,-18,19
Silkeborg IF,8014,11,5,3,14,25,45,-20,18
Brondby,8015,1,23,5,2,71,29,42,74
FC Midtjylla,8015,2,19,4,7,63,42,21,61
FC Nords,8015,3,15,7,8,75,47,28,52
Copenhagen,8015,4,14,4,12,59,49,10,46
AC Horsens,8015,5,7,12,11,35,51,-16,33
Sonderjyske,8015,6,8,6,10,28,29,-1,30
AaB,8015,7,6,12,12,36,47,-11,30
Lyngby,8015,8,4,9,11,28,44,-16,21
Randers FC,8015,9,5,6,13,23,41,-18,21
Silkeborg IF,8015,10,5,4,13,27,46,-19,19
AGF Aarhus,8015,11,4,7,11,18,38,-20,19
Brondby,8016,1,19,7,4,69,34,35,64
FC Midtjylla,8016,2,18,7,5,64,40,24,61
Copenhagen,8016,3,15,5,10,59,43,16,50
FC Nords,8016,4,13,8,9,75,54,21,47
AaB,8016,5,8,13,9,36,40,-4,37
AC Horsens,8016,6,6,14,10,34,52,-18,32
Sonderjyske,8016,7,8,6,10,28,29,-1,30
Randers FC,8016,8,5,7,12,24,40,-16,22
Lyngby,8016,9,3,10,11,27,45,-18,19
Silkeborg IF,8016,10,5,4,13,28,47,-19,19
AGF Aarhus,8016,11,4,7,11,19,39,-20,19
FC Midtjylla,8017,1,21,5,4,67,37,30,68
Brondby,8017,2,20,5,5,69,38,31,65
FC Nords,8017,3,13,8,9,70,51,19,47
Copenhagen,8017,4,13,6,11,57,45,12,45
AaB,8017,5,7,13,10,37,43,-6,34
AC Horsens,8017,6,6,15,9,37,49,-12,33
Sonderjyske,8017,7,8,6,10,28,29,-1,30
Randers FC,8017,8,6,6,12,25,39,-14,24
Silkeborg IF,8017,9,6,3,13,26,44,-18,21
Lyngby,8017,10,3,9,12,26,46,-20,18
AGF Aarhus,8017,11,4,6,12,16,37,-21,18
Brondby,8018,1,21,7,2,69,30,39,70
FC Midtjylla,8018,2,19,4,7,66,38,28,61
FC Nords,8018,3,14,7,9,74,55,19,49
Copenhagen,8018,4,13,7,10,59,46,13,46
AaB,8018,5,8,12,10,38,44,-6,36
AC Horsens,8018,6,6,13,11,36,55,-19,31
Sonderjyske,8018,7,8,6,10,28,29,-1,30
Lyngby,8018,8,4,9,11,27,44,-17,21
Randers FC,8018,9,5,6,13,23,40,-17,21
Silkeborg IF,8018,10,5,4,13,25,44,-19,19
AGF Aarhus,8018,11,4,7,11,16,36,-20,19
Brondby,8019,1,20,6,4,70,34,36,66
FC Midtjylla,8019,2,19,5,6,66,44,22,62
FC Nords,8019,3,14,8,8,74,51,23,50
Copenhagen,8019,4,15,5,10,63,45,18,50
AaB,8019,5,8,11,11,37,44,-7,35
AC Horsens,8019,6,6,13,11,37,55,-18,31
Sonderjyske,8019,7,8,6,10,28,29,-1,30
Lyngby,8019,8,4,9,11,27,44,-17,21
Randers FC,8019,9,5,6,13,23,40,-17,21
Silkeborg IF,8019,10,5,4,13,26,45,-19,19
AGF Aarhus,8019,11,4,7,11,17,37,-20,19
Brondby,8020,1,20,6,4,68,32,36,66
FC Midtjylla,8020,2,20,4,6,68,42,26,64
Copenhagen,8020,3,16,5,9,65,46,19,53
FC Nords,8020,4,14,7,9,72,51,21,49
AaB,8020,5,7,13,10,38,46,-8,34
Sonderjyske,8020,6,8,6,10,28,29,-1,30
AC Horsens,8020,7,5,13,12,34,54,-20,28
Randers FC,8020,8,6,6,12,25,39,-14,24
Silkeborg IF,8020,9,5,4,13,26,45,-19,19
AGF Aarhus,8020,10,4,7,11,17,37,-20,19
Lyngby,8020,11,3,9,12,26,46,-20,18
FC Midtjylla,8021,1,21,4,5,64,36,28,67
Brondby,8021,2,19,7,4,67,34,33,64
FC Nords,8021,3,14,6,10,75,53,22,48
Copenhagen,8021,4,13,6,11,54,44,10,45
AaB,8021,5,10,11,9,43,40,3,41
Sonderjyske,8021,6,8,6,10,28,29,-1,30
AC Horsens,8021,7,5,14,11,32,54,-22,29
Randers FC,8021,8,5,7,12,24,40,-16,22
Silkeborg IF,8021,9,6,3,13,29,46,-17,21
Lyngby,8021,10,3,10,11,27,45,-18,19
AGF Aarhus,8021,11,4,6,12,18,40,-22,18
Brondby,8022,1,22,5,3,76,32,44,71
FC Midtjylla,8022,2,17,5,8,58,41,17,56
Copenhagen,8022,3,15,4,11,59,46,13,49
FC Nords,8022,4,12,8,10,71,54,17,44
AC Horsens,8022,5,10,12,8,38,48,-10,42
AaB,8022,6,7,12,11,36,43,-7,33
Sonderjyske,8022,7,8,6,10,28,29,-1,30
Randers FC,8022,8,6,6,12,24,39,-15,24
AGF Aarhus,8022,9,5,6,11,20,38,-18,21
Lyngby,8022,10,3,9,12,26,45,-19,18
Silkeborg IF,8022,11,5,3,14,27,48,-21,18
Brondby,8023,1,18,8,4,69,36,33,62
FC Midtjylla,8023,2,17,6,7,62,43,19,57
FC Nords,8023,3,14,8,8,77,51,26,50
Copenhagen,8023,4,14,4,12,56,50,6,46
AaB,8023,5,10,12,8,42,39,3,42
AC Horsens,8023,6,7,14,9,37,50,-13,35
Sonderjyske,8023,7,8,6,10,28,29,-1,30
Lyngby,8023,8,4,9,11,28,44,-16,21
Randers FC,8023,9,5,6,13,23,41,-18,21
AGF Aarhus,8023,10,5,6,11,19,37,-18,21
Silkeborg IF,8023,11,5,3,14,26,47,-21,18
Brondby,8024,1,21,5,4,68,30,38,68
FC Midtjylla,8024,2,19,5,6,65,42,23,62
FC Nords,8024,3,16,6,8,76,51,25,54
Copenhagen,8024,4,14,4,12,57,45,12,46
AaB,8024,5,8,11,11,35,42,-7,35
AC Horsens,8024,6,6,13,11,34,51,-17,31
Sonderjyske,8024,7,8,6,10,28,29,-1,30
Lyngby,8024,8,4,9,11,30,44,-14,21
Silkeborg IF,8024,9,6,3,13,27,44,-17,21
Randers FC,8024,10,5,6,13,23,43,-20,21
AGF Aarhus,8024,11,4,6,12,16,38,-22,18
Brondby,8025,1,20,5,5,69,37,32,65
FC Midtjylla,8025,2,19,5,6,63,40,23,62
FC Nords,8025,3,16,6,8,78,50,28,54
Copenhagen,8025,4,13,4,13,57,51,6,43
AaB,8025,5,8,12,10,41,47,-6,36
AC Horsens,8025,6,8,12,10,40,49,-9,36
Sonderjyske,8025,7,8,6,10,28,29,-1,30
Randers FC,8025,8,6,6,12,24,39,-15,24
Silkeborg IF,8025,9,5,4,13,26,45,-19,19
AGF Aarhus,8025,10,4,7,11,17,37,-20,19
Lyngby,8025,11,3,9,12,26,45,-19,18
Brondby,8026,1,22,5,3,77,34,43,71
FC Midtjylla,8026,2,20,4,6,71,39,32,64
FC Nords,8026,3,14,7,9,72,51,21,49
Copenhagen,8026,4,14,4,12,59,46,13,46
AaB,8026,5,7,12,11,35,49,-14,33
AC Horsens,8026,6,7,12,11,33,54,-21,33
Sonderjyske,8026,7,8,6,10,28,29,-1,30
Silkeborg IF,8026,8,6,3,13,28,45,-17,21
Lyngby,8026,9,4,9,11,27,44,-17,21
Randers FC,8026,10,5,6,13,23,40,-17,21
AGF Aarhus,8026,11,4,6,12,17,39,-22,18
Brondby,8027,1,21,5,4,76,37,39,68
FC Midtjylla,8027,2,20,5,5,70,43,27,65
FC Nords,8027,3,16,6,8,84,53,31,54
Copenhagen,8027,4,13,6,11,54,46,8,45
AC Horsens,8027,5,7,12,11,38,58,-20,33
Sonderjyske,8027,6,8,6,10,28,29,-1,30
AaB,8027,7,6,12,12,37,48,-11,30
Randers FC,8027,8,6,6,12,24,39,-15,24
Silkeborg IF,8027,9,6,3,13,29,46,-17,21
Lyngby,8027,10,3,9,12,26,45,-19,18
AGF Aarhus,8027,11,4,6,12,18,40,-22,18
Brondby,8028,1,20,5,5,67,34,33,65
FC Midtjylla,8028,2,19,5,6,65,37,28,62
Copenhagen,8028,3,16,5,9,60,39,21,53
FC Nords,8028,4,15,6,9,76,55,21,51
AC Horsens,8028,5,7,14,9,39,53,-14,35
Sonderjyske,8028,6,8,6,10,28,29,-1,30
AaB,8028,7,6,11,13,37,52,-15,29
Randers FC,8028,8,6,6,12,24,39,-15,24
AGF Aarhus,8028,9,5,6,11,18,36,-18,21
Lyngby,8028,10,3,9,12,26,45,-19,18
Silkeborg IF,8028,11,5,3,14,25,46,-21,18
FC Midtjylla,8029,1,21,5,4,71,42,29,68
Brondby,8029,2,19,8,3,70,35,35,65
FC Nords,8029,3,14,7,9,74,53,21,49
Copenhagen,8029,4,14,5,11,59,45,14,47
AaB,8029,5,7,11,12,40,49,-9,32
AC Horsens,8029,6,6,14,10,34,50,-16,32
Sonderjyske,8029,7,8,6,10,28,29,-1,30
Randers FC,8029,8,5,7,12,24,40,-16,22
Silkeborg IF,8029,9,6,3,13,29,44,-15,21
Lyngby,8029,10,3,10,11,27,45,-18,19
AGF Aarhus,8029,11,4,6,12,16,40,-24,18
Brondby,8030,1,23,5,2,75,30,45,74
FC Midtjylla,8030,2,20,4,6,67,40,27,64
FC Nords,8030,3,15,6,9,72,51,21,51
Copenhagen,8030,4,14,4,12,56,48,8,46
AaB,8030,5,7,11,12,38,45,-7,32
Sonderjyske,8030,6,8,6,10,28,29,-1,30
AC Horsens,8030,7,6,12,12,33,53,-20,30
Lyngby,8030,8,4,9,11,27,44,-17,21
Randers FC,8030,9,5,6,13,23,40,-17,21
Silkeborg IF,8030,10,5,4,13,26,45,-19,19
AGF Aarhus,8030,11,4,7,11,17,37,-20,19
Brondby,8031,1,21,6,3,73,37,36,69
FC Midtjylla,8031,2,19,5,6,65,39,26,62
FC Nords,8031,3,13,8,9,71,52,19,47
Copenhagen,8031,4,13,5,12,60,51,9,44
AaB,8031,5,8,12,10,40,42,-2,36
AC Horsens,8031,6,7,14,9,38,52,-14,35
Sonderjyske,8031,7,8,6,10,28,29,-1,30
Randers FC,8031,8,5,7,12,23,39,-16,22
Silkeborg IF,8031,9,6,3,13,26,44,-18,21
Lyngby,8031,10,3,10,11,26,44,-18,19
AGF Aarhus,8031,11,4,6,12,16,37,-21,18
Brondby,8032,1,22,6,2,78,34,44,72
FC Midtjylla,8032,2,19,5,6,68,39,29,62
Copenhagen,8032,3,15,4,11,60,49,11,49
FC Nords,8032,4,13,7,10,74,62,12,46
AC Horsens,8032,5,8,13,9,40,50,-10,37
Sonderjyske,8032,6,8,6,10,28,29,-1,30
AaB,8032,7,6,11,13,35,47,-12,29
Randers FC,8032,8,6,6,12,27,39,-12,24
Silkeborg IF,8032,9,6,3,13,27,45,-18,21
AGF Aarhus,8032,10,4,6,12,17,38,-21,18
Lyngby,8032,11,3,9,12,26,48,-22,18
Brondby,8033,1,21,7,2,70,29,41,70
FC Midtjylla,8033,2,20,4,6,61,37,24,64
FC Nords,8033,3,13,8,9,70,52,18,47
Copenhagen,8033,4,13,5,12,54,43,11,44
AC Horsens,8033,5,7,14,9,35,49,-14,35
AaB,8033,6,7,12,11,33,39,-6,33
Sonderjyske,8033,7,8,6,10,28,29,-1,30
Randers FC,8033,8,5,7,12,26,42,-16,22
Lyngby,8033,9,3,10,11,29,47,-18,19
Silkeborg IF,8033,10,5,4,13,25,44,-19,19
AGF Aarhus,8033,11,4,7,11,16,36,-20,19
Brondby,8034,1,21,5,4,69,32,37,68
FC Midtjylla,8034,2,20,6,4,68,38,30,66
FC Nords,8034,3,13,8,9,75,54,21,47
Copenhagen,8034,4,13,5,12,55,46,9,44
AaB,8034,5,7,13,10,39,47,-8,34
AC Horsens,8034,6,7,13,10,34,49,-15,34
Sonderjyske,8034,7,8,6,10,28,29,-1,30
Randers FC,8034,8,5,7,12,25,41,-16,22
Silkeborg IF,8034,9,6,3,13,29,44,-15,21
Lyngby,8034,10,3,10,11,28,46,-18,19
AGF Aarhus,8034,11,4,6,12,16,40,-24,18
Brondby,8035,1,21,5,4,73,33,40,68
FC Midtjylla,8035,2,21,4,5,72,42,30,67
FC Nords,8035,3,15,6,9,77,54,23,51
Copenhagen,8035,4,14,4,12,58,45,13,46
AaB,8035,5,7,12,11,33,43,-10,33
AC Horsens,8035,6,6,13,11,34,56,-22,31
Sonderjyske,8035,7,8,6,10,28,29,-1,30
Lyngby,8035,8,4,9,11,28,44,-16,21
Randers FC,8035,9,5,6,13,23,41,-18,21
AGF Aarhus,8035,10,5,6,11,18,37,-19,21
Silkeborg IF,8035,11,5,3,14,26,46,-20,18
Brondby,8036,1,22,5,3,76,30,46,71
FC Midtjylla,8036,2,21,4,5,67,38,29,67
FC Nords,8036,3,15,6,9,77,57,20,51
Copenhagen,8036,4,14,5,11,58,45,13,47
AaB,8036,5,7,11,12,37,44,-7,32
Sonderjyske,8036,6,8,6,10,28,29,-1,30
AC Horsens,8036,7,5,13,12,34,61,-27,28
Lyngby,8036,8,4,9,11,27,44,-17,21
Randers FC,8036,9,5,6,13,23,40,-17,21
Silkeborg IF,8036,10,6,3,13,26,44,-18,21
AGF Aarhus,8036,11,4,6,12,16,37,-21,18
Brondby,8037,1,20,6,4,68,34,34,66
FC Midtjylla,8037,2,20,5,5,61,35,26,65
FC Nords,8037,3,15,6,9,71,47,24,51
Copenhagen,8037,4,14,5,11,55,42,13,47
AaB,8037,5,9,11,10,37,41,-4,38
Sonderjyske,8037,6,8,6,10,28,29,-1,30
AC Horsens,8037,7,5,13,12,32,51,-19,28
Silkeborg IF,8037,8,6,3,13,29,45,-16,21
Lyngby,8037,9,4,9,11,27,44,-17,21
Randers FC,8037,10,5,6,13,23,40,-17,21
AGF Aarhus,8037,11,4,6,12,17,40,-23,18
Brondby,8038,1,23,5,2,74,28,46,74
FC Midtjylla,8038,2,19,4,7,69,39,30,61
FC Nords,8038,3,14,6,10,70,51,19,48
Copenhagen,8038,4,14,5,11,53,41,12,47
AaB,8038,5,8,11,11,37,49,-12,35
AC Horsens,8038,6,6,13,11,31,52,-21,31
Sonderjyske,8038,7,8,6,10,28,29,-1,30
Lyngby,8038,8,4,9,11,28,45,-17,21
Silkeborg IF,8038,9,6,3,13,27,44,-17,21
Randers FC,8038,10,5,6,13,24,41,-17,21
AGF Aarhus,8038,11,4,6,12,16,38,-22,18
Brondby,8039,1,21,6,3,74,33,41,69
FC Midtjylla,8039,2,19,5,6,68,44,24,62
Copenhagen,8039,3,16,5,9,67,47,20,53
FC Nords,8039,4,12,8,10,71,55,16,44
AaB,8039,5,7,12,11,40,47,-7,33
AC Horsens,8039,6,7,12,11,36,56,-20,33
Sonderjyske,8039,7,8,6,10,28,29,-1,30
Lyngby,8039,8,4,9,11,30,47,-17,21
Randers FC,8039,9,5,6,13,26,43,-17,21
Silkeborg IF,8039,10,5,4,13,26,45,-19,19
AGF Aarhus,8039,11,4,7,11,17,37,-20,19
Brondby,8040,1,21,7,2,74,32,42,70
FC Midtjylla,8040,2,20,4,6,73,44,29,64
FC Nords,8040,3,14,7,9,75,52,23,49
Copenhagen,8040,4,14,4,12,56,44,12,46
AC Horsens,8040,5,7,13,10,37,57,-20,34
AaB,8040,6,6,13,11,37,49,-12,31
Sonderjyske,8040,7,8,6,10,28,29,-1,30
Randers FC,8040,8,6,6,12,26,41,-15,24
AGF Aarhus,8040,9,5,6,11,18,36,-18,21
Lyngby,8040,10,3,9,12,28,47,-19,18
Silkeborg IF,8040,11,5,3,14,25,46,-21,18
Brondby,8041,1,22,5,3,72,33,39,71
FC Midtjylla,8041,2,20,5,5,70,42,28,65
FC Nords,8041,3,14,7,9,78,57,21,49
Copenhagen,8041,4,13,6,11,64,55,9,45
AaB,8041,5,8,12,10,41,43,-2,36
Sonderjyske,8041,6,8,6,10,28,29,-1,30
AC Horsens,8041,7,5,13,12,36,57,-21,28
Lyngby,8041,8,4,9,11,28,45,-17,21
Randers FC,8041,9,5,6,13,24,41,-17,21
Silkeborg IF,8041,10,6,3,13,27,45,-18,21
AGF Aarhus,8041,11,4,6,12,17,38,-21,18
Brondby,8042,1,21,5,4,72,36,36,68
FC Midtjylla,8042,2,20,6,4,67,37,30,66
FC Nords,8042,3,14,7,9,76,52,24,49
Copenhagen,8042,4,13,5,12,58,53,5,44
AaB,8042,5,9,11,10,43,44,-1,38
Sonderjyske,8042,6,8,6,10,28,29,-1,30
AC Horsens,8042,7,6,12,12,37,57,-20,30
Randers FC,8042,8,6,6,12,24,39,-15,24
AGF Aarhus,8042,9,5,6,11,19,36,-17,21
Lyngby,8042,10,3,9,12,26,45,-19,18
Silkeborg IF,8042,11,5,3,14,25,47,-22,18
Brondby,8043,1,20,7,3,66,30,36,67
FC Midtjylla,8043,2,20,6,4,65,35,30,66
FC Nords,8043,3,15,6,9,76,53,23,51
Copenhagen,8043,4,13,5,12,53,44,9,44
AaB,8043,5,7,12,11,35,42,-7,33
AC Horsens,8043,6,5,16,9,31,48,-17,31
Sonderjyske,8043,7,8,6,10,28,29,-1,30
Randers FC,8043,8,6,6,12,24,39,-15,24
Silkeborg IF,8043,9,6,3,13,26,44,-18,21
Lyngby,8043,10,3,9,12,26,45,-19,18
AGF Aarhus,8043,11,4,6,12,16,37,-21,18
Brondby,8044,1,22,5,3,70,31,39,71
FC Midtjylla,8044,2,20,5,5,68,36,32,65
FC Nords,8044,3,14,6,10,76,53,23,48
Copenhagen,8044,4,12,6,12,52,48,4,42
AaB,8044,5,7,13,10,34,42,-8,34
AC Horsens,8044,6,7,13,10,35,51,-16,34
Sonderjyske,8044,7,8,6,10,28,29,-1,30
Lyngby,8044,8,4,9,11,28,45,-17,21
Randers FC,8044,9,5,6,13,24,41,-17,21
Silkeborg IF,8044,10,5,4,13,26,45,-19,19
AGF Aarhus,8044,11,4,7,11,17,37,-20,19
Brondby,8045,1,20,7,3,70,33,37,67
FC Midtjylla,8045,2,20,5,5,73,42,31,65
Copenhagen,8045,3,15,6,9,61,44,17,51
FC Nords,8045,4,13,6,11,69,57,12,45
AC Horsens,8045,5,8,12,10,36,49,-13,36
Sonderjyske,8045,6,8,6,10,28,29,-1,30
AaB,8045,7,6,12,12,37,47,-10,30
Lyngby,8045,8,4,9,11,28,44,-16,21
Randers FC,8045,9,5,6,13,23,41,-18,21
AGF Aarhus,8045,10,5,6,11,17,36,-19,21
Silkeborg IF,8045,11,5,3,14,25,45,-20,18
Brondby,8046,1,20,6,4,70,34,36,66
FC Midtjylla,8046,2,19,5,6,63,42,21,62
FC Nords,8046,3,17,6,7,77,50,27,57
Copenhagen,8046,4,14,4,12,60,44,16,46
AaB,8046,5,8,12,10,39,44,-5,36
Sonderjyske,8046,6,8,6,10,28,29,-1,30
AC Horsens,8046,7,5,13,12,33,54,-21,28
Lyngby,8046,8,4,9,11,29,44,-15,21
Silkeborg IF,8046,9,6,3,13,27,45,-18,21
Randers FC,8046,10,5,6,13,23,42,-19,21
AGF Aarhus,8046,11,4,6,12,17,38,-21,18
Brondby,8047,1,20,6,4,73,36,37,66
FC Midtjylla,8047,2,19,6,5,61,37,24,63
Copenhagen,8047,3,16,5,9,60,40,20,53
FC Nords,8047,4,12,7,11,73,60,13,43
AC Horsens,8047,5,8,12,10,38,51,-13,36
AaB,8047,6,7,12,11,36,43,-7,33
Sonderjyske,8047,7,8,6,10,28,29,-1,30
Randers FC,8047,8,6,6,12,26,40,-14,24
Silkeborg IF,8047,9,5,4,13,25,44,-19,19
AGF Aarhus,8047,10,4,7,11,16,36,-20,19
Lyngby,8047,11,3,9,12,27,47,-20,18
Brondby,8048,1,21,6,3,71,33,38,69
FC Midtjylla,8048,2,20,5,5,66,38,28,65
FC Nords,8048,3,14,7,9,73,57,16,49
Copenhagen,8048,4,13,5,12,56,48,8,44
AC Horsens,8048,5,8,12,10,44,52,-8,36
AaB,8048,6,6,13,11,36,44,-8,31
Sonderjyske,8048,7,8,6,10,28,29,-1,30
Randers FC,8048,8,6,6,12,24,39,-15,24
AGF Aarhus,8048,9,5,6,11,17,36,-19,21
Lyngby,8048,10,3,9,12,26,45,-19,18
Silkeborg IF,8048,11,5,3,14,25,45,-20,18
FC Midtjylla,8049,1,22,4,4,75,37,38,70
Brondby,8049,2,20,5,5,70,34,36,65
FC Nords,8049,3,14,8,8,70,49,21,50
Copenhagen,8049,4,14,5,11,58,47,11,47
AaB,8049,5,7,11,12,35,42,-7,32
AC Horsens,8049,6,6,13,11,34,59,-25,31
Sonderjyske,8049,7,8,6,10,28,29,-1,30
Randers FC,8049,8,5,7,12,24,40,-16,22
Lyngby,8049,9,3,10,11,27,45,-18,19
Silkeborg IF,8049,10,5,4,13,26,45,-19,19
AGF Aarhus,8049,11,4,7,11,17,37,-20,19
Brondby,8050,1,20,7,3,71,31,40,67
FC Midtjylla,8050,2,20,5,5,69,42,27,65
FC Nords,8050,3,16,7,7,81,47,34,55
Copenhagen,8050,4,12,4,14,53,49,4,40
AaB,8050,5,8,11,11,34,42,-8,35
AC Horsens,8050,6,7,12,11,35,58,-23,33
Sonderjyske,8050,7,8,6,10,28,29,-1,30
Randers FC,8050,8,5,7,12,25,41,-16,22
AGF Aarhus,8050,9,5,6,11,18,36,-18,21
Lyngby,8050,10,3,10,11,28,46,-18,19
Silkeborg IF,8050,11,5,3,14,25,46,-21,18
Brondby,8051,1,22,6,2,76,32,44,72
FC Midtjylla,8051,2,17,5,8,59,42,17,56
Copenhagen,8051,3,15,6,9,58,40,18,51
FC Nords,8051,4,14,8,8,71,48,23,50
AaB,8051,5,6,14,10,33,41,-8,32
AC Horsens,8051,6,6,13,11,36,56,-20,31
Sonderjyske,8051,7,8,6,10,28,29,-1,30
Lyngby,8051,8,4,9,11,27,44,-17,21
Randers FC,8051,9,5,6,13,23,40,-17,21
Silkeborg IF,8051,10,6,3,13,27,45,-18,21
AGF Aarhus,8051,11,4,6,12,17,38,-21,18
Brondby,8052,1,20,8,2,78,38,40,68
FC Midtjylla,8052,2,20,5,5,76,40,36,65
FC Nords,8052,3,14,7,9,75,61,14,49
Copenhagen,8052,4,13,6,11,58,47,11,45
AaB,8052,5,7,13,10,41,47,-6,34
AC Horsens,8052,6,6,13,11,39,60,-21,31
Sonderjyske,8052,7,8,6,10,28,29,-1,30
Lyngby,8052,8,4,9,11,28,44,-16,21
Randers FC,8052,9,5,6,13,23,41,-18,21
Silkeborg IF,8052,10,5,4,13,27,46,-19,19
AGF Aarhus,8052,11,4,7,11,18,38,-20,19
Brondby,8053,1,21,5,4,70,36,34,68
FC Midtjylla,8053,2,18,5,7,64,44,20,59
Copenhagen,8053,3,16,5,9,66,43,23,53
FC Nords,8053,4,13,8,9,73,55,18,47
AC Horsens,8053,5,8,12,10,38,50,-12,36
AaB,8053,6,7,11,12,36,45,-9,32
Sonderjyske,8053,7,8,6,10,28,29,-1,30
Randers FC,8053,8,5,7,12,24,40,-16,22
AGF Aarhus,8053,9,5,6,11,18,37,-19,21
Lyngby,8053,10,3,10,11,27,45,-18,19
Silkeborg IF,8053,11,5,3,14,26,46,-20,18
Brondby,8054,1,20,7,3,70,34,36,67
FC Midtjylla,8054,2,19,7,4,66,36,30,64
Copenhagen,8054,3,15,5,10,60,45,15,50
FC Nords,8054,4,12,8,10,70,53,17,44
AC Horsens,8054,5,7,14,9,35,50,-15,35
AaB,8054,6,7,11,12,35,44,-9,32
Sonderjyske,8054,7,8,6,10,28,29,-1,30
Randers FC,8054,8,6,6,12,26,41,-15,24
Silkeborg IF,8054,9,5,4,13,25,44,-19,19
AGF Aarhus,8054,10,4,7,11,16,36,-20,19
Lyngby,8054,11,3,9,12,28,47,-19,18
Brondby,8055,1,21,6,3,72,31,41,69
FC Midtjylla,8055,2,20,6,4,68,37,31,66
FC Nords,8055,3,14,7,9,71,49,22,49
Copenhagen,8055,4,14,5,11,58,43,15,47
AaB,8055,5,7,13,10,37,49,-12,34
Sonderjyske,8055,6,8,6,10,28,29,-1,30
AC Horsens,8055,7,5,13,12,33,56,-23,28
Randers FC,8055,8,5,7,12,24,40,-16,22
Silkeborg IF,8055,9,6,3,13,26,44,-18,21
Lyngby,8055,10,3,10,11,27,45,-18,19
AGF Aarhus,8055,11,4,6,12,16,37,-21,18
Brondby,8056,1,21,6,3,71,29,42,69
FC Midtjylla,8056,2,20,6,4,66,37,29,66
Copenhagen,8056,3,13,7,10,61,47,14,46
FC Nords,8056,4,13,7,10,69,56,13,46
AaB,8056,5,7,12,11,39,47,-8,33
AC Horsens,8056,6,7,12,11,34,50,-16,33
Sonderjyske,8056,7,8,6,10,28,29,-1,30
Randers FC,8056,8,6,6,12,26,39,-13,24
AGF Aarhus,8056,9,5,6,11,18,37,-19,21
Silkeborg IF,8056,10,5,3,14,26,46,-20,18
Lyngby,8056,11,3,9,12,26,47,-21,18
Brondby,8057,1,22,5,3,71,29,42,71
FC Midtjylla,8057,2,20,4,6,64,41,23,64
Copenhagen,8057,3,15,5,10,59,42,17,50
FC Nords,8057,4,14,6,10,72,49,23,48
AC Horsens,8057,5,6,14,10,34,54,-20,32
Sonderjyske,8057,6,8,6,10,28,29,-1,30
AaB,8057,7,6,12,12,34,45,-11,30
Randers FC,8057,8,5,7,12,25,41,-16,22
Silkeborg IF,8057,9,6,3,13,26,44,-18,21
Lyngby,8057,10,3,10,11,28,46,-18,19
AGF Aarhus,8057,11,4,6,12,16,37,-21,18
Brondby,8058,1,20,6,4,71,33,38,66
FC Midtjylla,8058,2,18,6,6,62,42,20,60
FC Nords,8058,3,14,6,10,71,51,20,48
Copenhagen,8058,4,13,6,11,54,43,11,45
AaB,8058,5,8,13,9,38,40,-2,37
AC Horsens,8058,6,7,15,8,35,48,-13,36
Sonderjyske,8058,7,8,6,10,28,29,-1,30
Randers FC,8058,8,6,6,12,25,40,-15,24
AGF Aarhus,8058,9,5,6,11,18,37,-19,21
Lyngby,8058,10,3,9,12,27,46,-19,18
Silkeborg IF,8058,11,5,3,14,26,46,-20,18
Brondby,8059,1,22,6,2,74,33,41,72
FC Midtjylla,8059,2,18,5,7,61,40,21,59
FC Nords,8059,3,14,8,8,74,51,23,50
Copenhagen,8059,4,13,7,10,60,48,12,46
AaB,8059,5,8,11,11,38,42,-4,35
AC Horsens,8059,6,6,13,11,35,54,-19,31
Sonderjyske,8059,7,8,6,10,28,29,-1,30
Randers FC,8059,8,6,6,12,25,40,-15,24
AGF Aarhus,8059,9,5,6,11,19,38,-19,21
Lyngby,8059,10,3,9,12,27,46,-19,18
Silkeborg IF,8059,11,5,3,14,27,47,-20,18
Brondby,8060,1,20,6,4,68,35,33,66
FC Midtjylla,8060,2,19,5,6,63,43,20,62
Copenhagen,8060,3,15,5,10,60,41,19,50
FC Nords,8060,4,14,7,9,75,53,22,49
AaB,8060,5,8,11,11,38,41,-3,35
AC Horsens,8060,6,7,12,11,36,53,-17,33
Sonderjyske,8060,7,8,6,10,28,29,-1,30
Randers FC,8060,8,6,6,12,25,40,-15,24
Silkeborg IF,8060,9,6,3,13,26,44,-18,21
Lyngby,8060,10,3,9,12,27,46,-19,18
AGF Aarhus,8060,11,4,6,12,16,37,-21,18
Brondby,8061,1,22,5,3,72,31,41,71
FC Midtjylla,8061,2,18,5,7,62,41,21,59
FC Nords,8061,3,14,6,10,71,54,17,48
Copenhagen,8061,4,13,5,12,57,45,12,44
AC Horsens,8061,5,9,12,9,38,49,-11,39
AaB,8061,6,7,13,10,36,42,-6,34
Sonderjyske,8061,7,8,6,10,28,29,-1,30
Randers FC,8061,8,6,6,12,26,40,-14,24
Silkeborg IF,8061,9,5,4,13,25,44,-19,19
AGF Aarhus,8061,10,4,7,11,16,36,-20,19
Lyngby,8061,11,3,9,12,27,47,-20,18
Brondby,8062,1,21,5,4,71,30,41,68
FC Midtjylla,8062,2,18,4,8,61,47,14,58
FC Nords,8062,3,15,7,8,75,49,26,52
Copenhagen,8062,4,13,6,11,56,45,11,45
AaB,8062,5,9,11,10,39,41,-2,38
AC Horsens,8062,6,7,13,10,36,52,-16,34
Sonderjyske,8062,7,8,6,10,28,29,-1,30
Lyngby,8062,8,4,9,11,28,44,-16,21
AGF Aarhus,8062,9,5,6,11,20,37,-17,21
Randers FC,8062,10,5,6,13,23,41,-18,21
Silkeborg IF,8062,11,5,3,14,26,48,-22,18
Brondby,8063,1,22,5,3,73,34,39,71
FC Midtjylla,8063,2,20,5,5,70,38,32,65
FC Nords,8063,3,15,6,9,81,56,25,51
Copenhagen,8063,4,13,4,13,53,49,4,43
AaB,8063,5,7,13,10,35,41,-6,34
AC Horsens,8063,6,6,13,11,36,56,-20,31
Sonderjyske,8063,7,8,6,10,28,29,-1,30
Randers FC,8063,8,5,7,12,24,40,-16,22
Silkeborg IF,8063,9,6,3,13,27,44,-17,21
Lyngby,8063,10,3,10,11,27,45,-18,19
AGF Aarhus,8063,11,4,6,12,16,38,-22,18
Brondby,8064,1,22,5,3,75,30,45,71
FC Midtjylla,8064,2,20,5,5,71,44,27,65
FC Nords,8064,3,15,7,8,73,49,24,52
Copenhagen,8064,4,13,4,13,54,45,9,43
AaB,8064,5,8,11,11,40,52,-12,35
Sonderjyske,8064,6,8,6,10,28,29,-1,30
AC Horsens,8064,7,6,12,12,34,53,-19,30
Lyngby,8064,8,4,9,11,28,44,-16,21
Silkeborg IF,8064,8,6,3,13,28,44,-16,21
Randers FC,8064,10,5,6,13,23,41,-18,21
AGF Aarhus,8064,11,4,6,12,16,39,-23,18
Brondby,8065,1,19,8,3,71,37,34,65
FC Midtjylla,8065,2,19,5,6,64,42,22,62
FC Nords,8065,3,13,9,8,72,50,22,48
Copenhagen,8065,4,14,6,10,60,44,16,48
AaB,8065,5,7,14,9,36,42,-6,35
AC Horsens,8065,6,6,14,10,38,52,-14,32
Sonderjyske,8065,7,8,6,10,28,29,-1,30
Lyngby,8065,8,4,9,11,27,44,-17,21
Randers FC,8065,9,5,6,13,23,40,-17,21
Silkeborg IF,8065,10,6,3,13,27,45,-18,21
AGF Aarhus,8065,11,4,6,12,17,38,-21,18
FC Midtjylla,8066,1,21,4,5,69,38,31,67
Brondby,8066,2,20,6,4,71,36,35,66
FC Nords,8066,3,14,7,9,72,53,19,49
Copenhagen,8066,4,14,5,11,62,49,13,47
AC Horsens,8066,5,7,13,10,35,53,-18,34
AaB,8066,6,7,11,12,41,47,-6,32
Sonderjyske,8066,7,8,6,10,28,29,-1,30
Lyngby,8066,8,4,9,11,27,44,-17,21
Randers FC,8066,9,5,6,13,23,40,-17,21
Silkeborg IF,8066,10,6,3,13,27,45,-18,21
AGF Aarhus,8066,11,4,6,12,17,38,-21,18
Brondby,8067,1,20,8,2,71,32,39,68
FC Midtjylla,8067,2,20,6,4,70,36,34,66
FC Nords,8067,3,15,7,8,78,52,26,52
Copenhagen,8067,4,14,5,11,59,45,14,47
AaB,8067,5,6,13,11,36,48,-12,31
Sonderjyske,8067,6,8,6,10,28,29,-1,30
AC Horsens,8067,7,5,13,12,30,57,-27,28
Lyngby,8067,8,4,9,11,28,44,-16,21
Randers FC,8067,9,5,6,13,23,41,-18,21
AGF Aarhus,8067,10,5,6,11,18,37,-19,21
Silkeborg IF,8067,11,5,3,14,26,46,-20,18
Brondby,8068,1,22,5,3,74,33,41,71
FC Midtjylla,8068,2,18,7,5,67,42,25,61
FC Nords,8068,3,14,7,9,76,53,23,49
Copenhagen,8068,4,13,4,13,55,49,6,43
AaB,8068,5,8,13,9,38,42,-4,37
AC Horsens,8068,6,6,14,10,32,49,-17,32
Sonderjyske,8068,7,8,6,10,28,29,-1,30
Randers FC,8068,8,6,6,12,26,39,-13,24
Silkeborg IF,8068,9,5,4,13,25,44,-19,19
AGF Aarhus,8068,10,4,7,11,16,36,-20,19
Lyngby,8068,11,3,9,12,26,47,-21,18
Brondby,8069,1,22,6,2,72,32,40,72
FC Midtjylla,8069,2,17,6,7,63,45,18,57
Copenhagen,8069,3,16,4,10,61,42,19,52
FC Nords,8069,4,14,6,10,74,54,20,48
AaB,8069,5,7,13,10,38,43,-5,34
AC Horsens,8069,6,6,13,11,39,57,-18,31
Sonderjyske,8069,7,8,6,10,28,29,-1,30
Randers FC,8069,8,6,6,12,24,39,-15,24
AGF Aarhus,8069,9,5,6,11,17,36,-19,21
Lyngby,8069,10,3,9,12,26,45,-19,18
Silkeborg IF,8069,11,5,3,14,25,45,-20,18
Brondby,8070,1,22,5,3,71,33,38,71
FC Midtjylla,8070,2,20,4,6,65,41,24,64
FC Nords,8070,3,17,6,7,78,48,30,57
Copenhagen,8070,4,13,5,12,55,42,13,44
AC Horsens,8070,5,6,13,11,32,51,-19,31
Sonderjyske,8070,6,8,6,10,28,29,-1,30
AaB,8070,7,6,11,13,35,47,-12,29
Randers FC,8070,8,6,6,12,25,40,-15,24
Silkeborg IF,8070,9,6,3,13,26,44,-18,21
Lyngby,8070,10,3,9,12,27,46,-19,18
AGF Aarhus,8070,11,4,6,12,16,37,-21,18
Brondby,8071,1,20,7,3,69,30,39,67
FC Midtjylla,8071,2,20,4,6,67,39,28,64
Copenhagen,8071,3,13,6,11,55,44,11,45
FC Nords,8071,4,12,8,10,69,54,15,44
AaB,8071,5,8,13,9,36,41,-5,37
AC Horsens,8071,6,7,14,9,37,51,-14,35
Sonderjyske,8071,7,8,6,10,28,29,-1,30
Randers FC,8071,8,6,6,12,28,40,-12,24
AGF Aarhus,8071,9,5,6,11,18,36,-18,21
Silkeborg IF,8071,10,5,3,14,25,46,-21,18
Lyngby,8071,11,3,9,12,27,49,-22,18
Brondby,8072,1,20,8,2,75,36,39,68
FC Midtjylla,8072,2,19,4,7,63,41,22,61
Copenhagen,8072,3,16,5,9,63,42,21,53
FC Nords,8072,4,15,7,8,76,53,23,52
Sonderjyske,8072,5,8,6,10,28,29,-1,30
AaB,8072,6,6,12,12,38,48,-10,30
AC Horsens,8072,7,5,14,11,35,56,-21,29
Randers FC,8072,8,5,7,12,27,43,-16,22
Silkeborg IF,8072,9,6,3,13,29,44,-15,21
Lyngby,8072,10,3,10,11,30,48,-18,19
AGF Aarhus,8072,11,4,6,12,16,40,-24,18
Brondby,8073,1,21,5,4,73,35,38,68
FC Midtjylla,8073,2,18,5,7,60,42,18,59
FC Nords,8073,3,14,6,10,68,51,17,48
Copenhagen,8073,4,14,4,12,58,45,13,46
AaB,8073,5,9,13,8,38,39,-1,40
AC Horsens,8073,6,7,13,10,38,49,-11,34
Sonderjyske,8073,7,8,6,10,28,29,-1,30
Randers FC,8073,8,5,7,12,24,40,-16,22
AGF Aarhus,8073,9,5,6,11,17,36,-19,21
Lyngby,8073,10,3,10,11,27,45,-18,19
Silkeborg IF,8073,11,5,3,14,25,45,-20,18
Brondby,8074,1,21,5,4,68,31,37,68
FC Midtjylla,8074,2,19,6,5,65,40,25,63
FC Nords,8074,3,17,6,7,75,47,28,57
Copenhagen,8074,4,12,7,11,56,46,10,43
AaB,8074,5,7,13,10,36,41,-5,34
Sonderjyske,8074,6,8,6,10,28,29,-1,30
AC Horsens,8074,7,5,13,12,35,56,-21,28
Randers FC,8074,8,6,6,12,25,39,-14,24
Silkeborg IF,8074,9,6,3,13,28,44,-16,21
Lyngby,8074,10,3,9,12,26,46,-20,18
AGF Aarhus,8074,11,4,6,12,16,39,-23,18
Brondby,8075,1,21,6,3,75,31,44,69
FC Midtjylla,8075,2,20,5,5,63,41,22,65
Copenhagen,8075,3,16,5,9,63,44,19,53
FC Nords,8075,4,14,6,10,74,54,20,48
Sonderjyske,8075,5,8,6,10,28,29,-1,30
AaB,8075,6,6,12,12,33,43,-10,30
AC Horsens,8075,7,6,12,12,34,55,-21,30
Randers FC,8075,8,5,7,12,24,40,-16,22
AGF Aarhus,8075,9,5,6,11,19,37,-18,21
Lyngby,8075,10,3,10,11,27,45,-18,19
Silkeborg IF,8075,11,5,3,14,26,47,-21,18
Brondby,8076,1,20,6,4,69,35,34,66
FC Midtjylla,8076,2,19,4,7,67,38,29,61
FC Nords,8076,3,16,6,8,80,46,34,54
Copenhagen,8076,4,15,4,11,56,44,12,49
AaB,8076,5,8,11,11,38,49,-11,35
AC Horsens,8076,6,6,13,11,35,59,-24,31
Sonderjyske,8076,7,8,6,10,28,29,-1,30
Randers FC,8076,8,5,7,12,23,39,-16,22
Silkeborg IF,8076,9,6,3,13,26,44,-18,21
Lyngby,8076,10,3,10,11,26,44,-18,19
AGF Aarhus,8076,11,4,6,12,16,37,-21,18
Brondby,8077,1,22,5,3,73,30,43,71
FC Midtjylla,8077,2,19,4,7,65,39,26,61
Copenhagen,8077,3,15,5,10,61,45,16,50
FC Nords,8077,4,14,7,9,74,52,22,49
AC Horsens,8077,5,7,12,11,32,54,-22,33
AaB,8077,6,7,11,12,36,47,-11,32
Sonderjyske,8077,7,8,6,10,28,29,-1,30
Lyngby,8077,8,4,9,11,27,44,-17,21
Randers FC,8077,9,5,6,13,23,40,-17,21
Silkeborg IF,8077,10,5,4,13,25,44,-19,19
AGF Aarhus,8077,11,4,7,11,16,36,-20,19
Brondby,8078,1,21,5,4,76,35,41,68
FC Midtjylla,8078,2,20,5,5,64,38,26,65
FC Nords,8078,3,14,7,9,72,56,16,49
Copenhagen,8078,4,13,5,12,58,45,13,44
AaB,8078,5,7,14,9,36,40,-4,35
AC Horsens,8078,6,7,12,11,36,54,-18,33
Sonderjyske,8078,7,8,6,10,28,29,-1,30
Randers FC,8078,8,6,6,12,25,40,-15,24
Silkeborg IF,8078,9,6,3,13,27,45,-18,21
Lyngby,8078,10,3,9,12,27,46,-19,18
AGF Aarhus,8078,11,4,6,12,17,38,-21,18
Brondby,8079,1,21,6,3,75,31,44,69
FC Midtjylla,8079,2,19,6,5,61,35,26,63
Copenhagen,8079,3,16,4,10,59,42,17,52
FC Nords,8079,4,13,7,10,73,52,21,46
AaB,8079,5,8,11,11,37,47,-10,35
Sonderjyske,8079,6,8,6,10,28,29,-1,30
AC Horsens,8079,7,6,12,12,33,57,-24,30
Randers FC,8079,8,6,6,12,24,39,-15,24
Silkeborg IF,8079,9,5,4,13,25,44,-19,19
AGF Aarhus,8079,10,4,7,11,16,36,-20,19
Lyngby,8079,11,3,9,12,26,45,-19,18
Brondby,8080,1,21,5,4,75,32,43,68
FC Midtjylla,8080,2,19,6,5,65,41,24,63
Copenhagen,8080,3,15,5,10,58,41,17,50
FC Nords,8080,4,13,7,10,72,55,17,46
AaB,8080,5,8,11,11,37,45,-8,35
AC Horsens,8080,6,7,12,11,38,57,-19,33
Sonderjyske,8080,7,8,6,10,28,29,-1,30
Lyngby,8080,8,4,9,11,27,44,-17,21
Randers FC,8080,9,5,6,13,23,40,-17,21
Silkeborg IF,8080,10,6,3,13,26,44,-18,21
AGF Aarhus,8080,11,4,6,12,16,37,-21,18
Brondby,8081,1,21,7,2,70,32,38,70
FC Midtjylla,8081,2,19,5,6,63,36,27,62
FC Nords,8081,3,13,8,9,75,51,24,47
Copenhagen,8081,4,13,7,10,57,43,14,46
AaB,8081,5,7,13,10,38,44,-6,34
AC Horsens,8081,6,6,14,10,34,57,-23,32
Sonderjyske,8081,7,8,6,10,28,29,-1,30
Randers FC,8081,8,6,6,12,24,39,-15,24
AGF Aarhus,8081,9,5,6,11,19,38,-19,21
Lyngby,8081,10,3,9,12,26,45,-19,18
Silkeborg IF,8081,11,5,3,14,27,47,-20,18
Brondby,8082,1,20,7,3,65,31,34,67
FC Midtjylla,8082,2,18,7,5,64,38,26,61
FC Nords,8082,3,14,7,9,73,50,23,49
Copenhagen,8082,4,15,4,11,61,49,12,49
AaB,8082,5,7,14,9,39,42,-3,35
AC Horsens,8082,6,6,13,11,34,52,-18,31
Sonderjyske,8082,7,8,6,10,28,29,-1,30
Lyngby,8082,8,4,9,11,28,44,-16,21
Silkeborg IF,8082,9,6,3,13,26,44,-18,21
Randers FC,8082,10,5,6,13,23,41,-18,21
AGF Aarhus,8082,11,4,6,12,16,37,-21,18
Brondby,8083,1,22,5,3,70,30,40,71
FC Midtjylla,8083,2,18,7,5,63,38,25,61
Copenhagen,8083,3,14,5,11,60,46,14,47
FC Nords,8083,4,12,7,11,71,58,13,43
AaB,8083,5,9,12,9,40,40,0,39
AC Horsens,8083,6,7,12,11,38,56,-18,33
Sonderjyske,8083,7,8,6,10,28,29,-1,30
Lyngby,8083,8,4,9,11,29,44,-15,21
Randers FC,8083,9,5,6,13,23,42,-19,21
AGF Aarhus,8083,10,5,6,11,18,37,-19,21
Silkeborg IF,8083,11,5,3,14,26,46,-20,18
Brondby,8084,1,21,6,3,73,32,41,69
FC Midtjylla,8084,2,19,7,4,65,35,30,64
FC Nords,8084,3,14,7,9,74,52,22,49
Copenhagen,8084,4,13,6,11,55,43,12,45
AaB,8084,5,7,12,11,36,45,-9,33
AC Horsens,8084,6,6,14,10,37,59,-22,32
Sonderjyske,8084,7,8,6,10,28,29,-1,30
Randers FC,8084,8,6,6,12,26,41,-15,24
AGF Aarhus,8084,9,5,6,11,19,36,-17,21
Lyngby,8084,10,3,9,12,28,47,-19,18
Silkeborg IF,8084,11,5,3,14,25,47,-22,18
Brondby,8085,1,19,7,4,70,38,32,64
FC Midtjylla,8085,2,18,7,5,64,39,25,61
FC Nords,8085,3,15,7,8,76,50,26,52
Copenhagen,8085,4,14,6,10,59,45,14,48
AaB,8085,5,7,13,10,38,44,-6,34
AC Horsens,8085,6,7,12,11,37,54,-17,33
Sonderjyske,8085,7,8,6,10,28,29,-1,30
Randers FC,8085,8,5,7,12,25,41,-16,22
Lyngby,8085,9,3,10,11,28,46,-18,19
Silkeborg IF,8085,10,5,4,13,25,44,-19,19
AGF Aarhus,8085,11,4,7,11,16,36,-20,19
Brondby,8086,1,21,5,4,65,30,35,68
FC Midtjylla,8086,2,20,5,5,62,36,26,65
FC Nords,8086,3,15,6,9,74,50,24,51
Copenhagen,8086,4,14,4,12,56,44,12,46
AaB,8086,5,7,12,11,36,41,-5,33
AC Horsens,8086,6,6,14,10,35,53,-18,32
Sonderjyske,8086,7,8,6,10,28,29,-1,30
Lyngby,8086,8,4,9,11,28,45,-17,21
Silkeborg IF,8086,9,6,3,13,27,44,-17,21
Randers FC,8086,10,5,6,13,24,41,-17,21
AGF Aarhus,8086,11,4,6,12,16,38,-22,18
Brondby,8087,1,22,6,2,74,32,42,72
FC Midtjylla,8087,2,20,5,5,62,35,27,65
FC Nords,8087,3,14,7,9,80,55,25,49
Copenhagen,8087,4,12,7,11,56,46,10,43
AaB,8087,5,7,12,11,36,44,-8,33
Sonderjyske,8087,6,8,6,10,28,29,-1,30
AC Horsens,8087,7,5,15,10,39,61,-22,30
Lyngby,8087,8,4,9,11,28,45,-17,21
Silkeborg IF,8087,9,6,3,13,27,44,-17,21
Randers FC,8087,10,5,6,13,24,41,-17,21
AGF Aarhus,8087,11,4,6,12,16,38,-22,18
Brondby,8088,1,22,5,3,72,31,41,71
FC Midtjylla,8088,2,18,5,7,62,43,19,59
FC Nords,8088,3,13,7,10,72,55,17,46
Copenhagen,8088,4,13,6,11,54,44,10,45
AaB,8088,5,8,13,9,38,41,-3,37
AC Horsens,8088,6,8,12,10,40,50,-10,36
Sonderjyske,8088,7,8,6,10,28,29,-1,30
Lyngby,8088,8,4,9,11,28,45,-17,21
Randers FC,8088,9,5,6,13,24,41,-17,21
Silkeborg IF,8088,10,5,4,13,25,44,-19,19
AGF Aarhus,8088,11,4,7,11,16,36,-20,19
FC Midtjylla,8089,1,21,5,4,71,37,34,68
Brondby,8089,2,20,7,3,69,32,37,67
FC Nords,8089,3,15,7,8,78,51,27,52
Copenhagen,8089,4,13,4,13,54,48,6,43
AaB,8089,5,8,11,11,37,46,-9,35
Sonderjyske,8089,6,8,6,10,28,29,-1,30
AC Horsens,8089,7,5,14,11,33,54,-21,29
Randers FC,8089,8,5,7,12,24,40,-16,22
Silkeborg IF,8089,9,6,3,13,27,44,-17,21
Lyngby,8089,10,3,10,11,27,45,-18,19
AGF Aarhus,8089,11,4,6,12,16,38,-22,18
Brondby,8090,1,22,6,2,69,28,41,72
FC Midtjylla,8090,2,18,5,7,62,41,21,59
FC Nords,8090,3,14,6,10,71,54,17,48
Copenhagen,8090,4,12,5,13,57,50,7,41
AC Horsens,8090,5,9,13,8,38,47,-9,40
AaB,8090,6,7,13,10,40,43,-3,34
Sonderjyske,8090,7,8,6,10,28,29,-1,30
Lyngby,8090,8,4,9,11,33,45,-12,21
Silkeborg IF,8090,9,6,3,13,27,45,-18,21
Randers FC,8090,10,5,6,13,24,46,-22,21
AGF Aarhus,8090,11,4,6,12,17,38,-21,18
Brondby,8091,1,22,6,2,75,30,45,72
FC Midtjylla,8091,2,19,4,7,68,40,28,61
Copenhagen,8091,3,14,6,10,56,42,14,48
FC Nords,8091,4,13,7,10,70,58,12,46
AC Horsens,8091,5,7,14,9,36,50,-14,35
AaB,8091,6,6,13,11,38,49,-11,31
Sonderjyske,8091,7,8,6,10,28,29,-1,30
Randers FC,8091,8,6,6,12,25,39,-14,24
Silkeborg IF,8091,9,6,3,13,27,44,-17,21
Lyngby,8091,10,3,9,12,26,46,-20,18
AGF Aarhus,8091,11,4,6,12,16,38,-22,18
FC Midtjylla,8092,1,19,6,5,65,41,24,63
Brondby,8092,2,18,8,4,67,34,33,62
FC Nords,8092,3,13,10,7,70,47,23,49
Copenhagen,8092,4,13,5,12,58,49,9,44
AC Horsens,8092,5,8,13,9,39,48,-9,37
AaB,8092,6,7,14,9,38,44,-6,35
Sonderjyske,8092,7,8,6,10,28,29,-1,30
Randers FC,8092,8,6,6,12,26,41,-15,24
Silkeborg IF,8092,9,5,4,13,26,45,-19,19
AGF Aarhus,8092,10,4,7,11,17,37,-20,19
Lyngby,8092,11,3,9,12,28,47,-19,18
Brondby,8093,1,21,7,2,72,30,42,70
FC Midtjylla,8093,2,19,6,5,66,41,25,63
FC Nords,8093,3,15,7,8,73,48,25,52
Copenhagen,8093,4,12,6,12,54,44,10,42
AaB,8093,5,7,13,10,35,43,-8,34
AC Horsens,8093,6,6,13,11,34,54,-20,31
Sonderjyske,8093,7,8,6,10,28,29,-1,30
Randers FC,8093,8,5,7,12,24,40,-16,22
AGF Aarhus,8093,9,5,6,11,19,37,-18,21
Lyngby,8093,10,3,10,11,27,45,-18,19
Silkeborg IF,8093,11,5,3,14,26,47,-21,18
Brondby,8094,1,20,7,3,68,31,37,67
FC Midtjylla,8094,2,20,4,6,62,36,26,64
FC Nords,8094,3,14,6,10,73,53,20,48
Copenhagen,8094,4,14,4,12,58,48,10,46
AaB,8094,5,8,12,10,40,44,-4,36
AC Horsens,8094,6,7,13,10,35,50,-15,34
Sonderjyske,8094,7,8,6,10,28,29,-1,30
Randers FC,8094,8,6,6,12,27,41,-14,24
Silkeborg IF,8094,9,6,3,13,26,44,-18,21
Lyngby,8094,10,3,9,12,28,48,-20,18
AGF Aarhus,8094,11,4,6,12,16,37,-21,18
FC Midtjylla,8095,1,20,6,4,66,35,31,66
Brondby,8095,2,19,7,4,69,35,34,64
FC Nords,8095,3,13,8,9,72,52,20,47
Copenhagen,8095,4,12,5,13,55,51,4,41
AaB,8095,5,9,12,9,39,39,0,39
AC Horsens,8095,6,7,14,9,37,52,-15,35
Sonderjyske,8095,7,8,6,10,28,29,-1,30
Lyngby,8095,8,4,9,11,29,44,-15,21
Silkeborg IF,8095,9,6,3,13,28,45,-17,21
Randers FC,8095,10,5,6,13,23,42,-19,21
AGF Aarhus,8095,11,4,6,12,17,39,-22,18
Brondby,8096,1,20,6,4,67,31,36,66
FC Midtjylla,8096,2,20,4,6,64,37,27,64
FC Nords,8096,3,15,6,9,73,50,23,51
Copenhagen,8096,4,13,7,10,55,43,12,46
AC Horsens,8096,5,7,13,10,36,53,-17,34
AaB,8096,6,7,12,11,35,42,-7,33
Sonderjyske,8096,7,8,6,10,28,29,-1,30
Randers FC,8096,8,5,7,12,24,40,-16,22
Lyngby,8096,9,3,10,11,27,45,-18,19
Silkeborg IF,8096,10,5,4,13,26,45,-19,19
AGF Aarhus,8096,11,4,7,11,17,37,-20,19
Brondby,8097,1,21,5,4,73,36,37,68
FC Midtjylla,8097,2,19,5,6,63,41,22,62
FC Nords,8097,3,14,7,9,77,55,22,49
Copenhagen,8097,4,14,6,10,61,45,16,48
AaB,8097,5,8,13,9,39,40,-1,37
Sonderjyske,8097,6,8,6,10,28,29,-1,30
AC Horsens,8097,7,5,14,11,31,53,-22,29
Lyngby,8097,8,4,9,11,28,45,-17,21
Silkeborg IF,8097,8,6,3,13,28,45,-17,21
Randers FC,8097,10,5,6,13,24,41,-17,21
AGF Aarhus,8097,11,4,6,12,17,39,-22,18
Brondby,8098,1,20,6,4,69,35,34,66
FC Midtjylla,8098,2,20,5,5,69,37,32,65
FC Nords,8098,3,13,8,9,69,49,20,47
Copenhagen,8098,4,13,6,11,57,47,10,45
AC Horsens,8098,5,8,13,9,35,50,-15,37
AaB,8098,6,7,12,11,38,45,-7,33
Sonderjyske,8098,7,8,6,10,28,29,-1,30
Lyngby,8098,8,4,9,11,27,44,-17,21
Randers FC,8098,9,5,6,13,23,40,-17,21
AGF Aarhus,8098,10,5,6,11,19,37,-18,21
Silkeborg IF,8098,11,5,3,14,26,47,-21,18
Brondby,8099,1,21,6,3,74,33,41,69
FC Midtjylla,8099,2,20,5,5,67,37,30,65
FC Nords,8099,3,15,7,8,76,52,24,52
Copenhagen,8099,4,12,6,12,54,47,7,42
AC Horsens,8099,5,7,13,10,35,51,-16,34
AaB,8099,6,6,13,11,34,46,-12,31
Sonderjyske,8099,7,8,6,10,28,29,-1,30
Lyngby,8099,8,4,9,11,28,45,-17,21
Randers FC,8099,9,5,6,13,24,41,-17,21
Silkeborg IF,8099,10,5,4,13,25,44,-19,19
AGF Aarhus,8099,11,4,7,11,16,36,-20,19
Brondby,8100,1,22,6,2,70,29,41,72
FC Midtjylla,8100,2,19,5,6,64,40,24,62
FC Nords,8100,3,14,6,10,71,52,19,48
Copenhagen,8100,4,14,5,11,58,44,14,47
AaB,8100,5,7,14,9,37,41,-4,35
Sonderjyske,8100,6,8,6,10,28,29,-1,30
AC Horsens,8100,7,5,14,11,33,53,-20,29
Randers FC,8100,8,5,7,12,24,40,-16,22
AGF Aarhus,8100,9,5,6,11,18,36,-18,21
Lyngby,8100,10,3,10,11,27,45,-18,19
Silkeborg IF,8100,11,5,3,14,25,46,-21,18
Brondby,8101,1,19,8,3,67,32,35,65
FC Midtjylla,8101,2,20,4,6,64,38,26,64
FC Nords,8101,3,13,8,9,73,53,20,47
Copenhagen,8101,4,14,4,12,57,45,12,46
AC Horsens,8101,5,7,15,8,36,49,-13,36
AaB,8101,6,7,13,10,38,44,-6,34
Sonderjyske,8101,7,8,6,10,28,29,-1,30
Lyngby,8101,8,4,9,11,31,45,-14,21
AGF Aarhus,8101,9,5,6,11,21,38,-17,21
Randers FC,8101,10,5,6,13,24,44,-20,21
Silkeborg IF,8101,11,5,3,14,27,49,-22,18
Brondby,8102,1,19,7,4,69,35,34,64
FC Midtjylla,8102,2,19,6,5,64,36,28,63
Copenhagen,8102,3,15,5,10,60,47,13,50
FC Nords,8102,4,13,8,9,72,51,21,47
AaB,8102,5,8,12,10,39,42,-3,36
AC Horsens,8102,6,7,12,11,33,52,-19,33
Sonderjyske,8102,7,8,6,10,28,29,-1,30
Randers FC,8102,8,5,7,12,25,41,-16,22
Silkeborg IF,8102,9,6,3,13,28,46,-18,21
Lyngby,8102,10,3,10,11,28,46,-18,19
AGF Aarhus,8102,11,4,6,12,18,39,-21,18
Brondby,8103,1,22,5,3,73,32,41,71
FC Midtjylla,8103,2,20,4,6,66,42,24,64
FC Nords,8103,3,15,7,8,76,49,27,52
Copenhagen,8103,4,14,5,11,55,46,9,47
Sonderjyske,8103,5,8,6,10,28,29,-1,30
AaB,8103,6,6,12,12,37,46,-9,30
AC Horsens,8103,7,5,15,10,32,50,-18,30
Lyngby,8103,8,4,9,11,28,44,-16,21
Silkeborg IF,8103,9,6,3,13,27,44,-17,21
Randers FC,8103,10,5,6,13,23,41,-18,21
AGF Aarhus,8103,11,4,6,12,16,38,-22,18
Brondby,8104,1,22,5,3,73,32,41,71
FC Midtjylla,8104,2,18,5,7,60,39,21,59
FC Nords,8104,3,14,7,9,71,50,21,49
Copenhagen,8104,4,12,7,11,54,45,9,43
AaB,8104,5,9,12,9,39,41,-2,39
AC Horsens,8104,6,6,14,10,34,50,-16,32
Sonderjyske,8104,7,8,6,10,28,29,-1,30
Lyngby,8104,8,4,9,11,29,44,-15,21
Randers FC,8104,9,5,6,13,23,42,-19,21
Silkeborg IF,8104,10,5,4,13,26,45,-19,19
AGF Aarhus,8104,11,4,7,11,17,37,-20,19
Brondby,8105,1,21,5,4,73,32,41,68
FC Midtjylla,8105,2,20,4,6,67,45,22,64
Copenhagen,8105,3,16,4,10,62,44,18,52
FC Nords,8105,4,13,7,10,69,53,16,46
AaB,8105,5,7,12,11,34,41,-7,33
AC Horsens,8105,6,6,14,10,35,51,-16,32
Sonderjyske,8105,7,8,6,10,28,29,-1,30
Lyngby,8105,8,4,9,11,28,44,-16,21
Randers FC,8105,9,5,6,13,23,41,-18,21
Silkeborg IF,8105,10,5,4,13,27,46,-19,19
AGF Aarhus,8105,11,4,7,11,18,38,-20,19
FC Midtjylla,8106,1,20,6,4,69,40,29,66
Brondby,8106,2,19,5,6,67,35,32,62
FC Nords,8106,3,15,6,9,75,52,23,51
Copenhagen,8106,4,13,7,10,57,45,12,46
AaB,8106,5,7,13,10,37,42,-5,34
AC Horsens,8106,6,6,15,9,37,54,-17,33
Sonderjyske,8106,7,8,6,10,28,29,-1,30
Lyngby,8106,8,4,9,11,28,45,-17,21
Silkeborg IF,8106,8,6,3,13,28,45,-17,21
Randers FC,8106,10,5,6,13,24,41,-17,21
AGF Aarhus,8106,11,4,6,12,17,39,-22,18
Brondby,8107,1,23,5,2,80,28,52,74
FC Midtjylla,8107,2,18,7,5,66,42,24,61
FC Nords,8107,3,13,9,8,75,53,22,48
Copenhagen,8107,4,12,7,11,53,45,8,43
AC Horsens,8107,5,7,12,11,35,59,-24,33
AaB,8107,6,6,14,10,37,45,-8,32
Sonderjyske,8107,7,8,6,10,28,29,-1,30
Randers FC,8107,8,5,7,12,23,39,-16,22
AGF Aarhus,8107,9,5,6,11,17,36,-19,21
Lyngby,8107,10,3,10,11,26,44,-18,19
Silkeborg IF,8107,11,5,3,14,25,45,-20,18
Brondby,8108,1,21,6,3,70,32,38,69
FC Midtjylla,8108,2,18,5,7,61,40,21,59
FC Nords,8108,3,16,6,8,74,48,26,54
Copenhagen,8108,4,14,5,11,59,44,15,47
AaB,8108,5,8,12,10,38,42,-4,36
Sonderjyske,8108,6,8,6,10,28,29,-1,30
AC Horsens,8108,7,6,12,12,33,55,-22,30
Randers FC,8108,8,6,6,12,25,40,-15,24
Silkeborg IF,8108,9,6,3,13,28,44,-16,21
Lyngby,8108,10,3,9,12,27,46,-19,18
AGF Aarhus,8108,11,4,6,12,16,39,-23,18
Brondby,8109,1,19,8,3,68,36,32,65
FC Midtjylla,8109,2,20,5,5,66,38,28,65
FC Nords,8109,3,14,7,9,74,50,24,49
Copenhagen,8109,4,13,6,11,56,43,13,45
AaB,8109,5,7,15,8,38,40,-2,36
Sonderjyske,8109,6,8,6,10,28,29,-1,30
AC Horsens,8109,7,5,15,10,33,54,-21,30
Randers FC,8109,8,6,6,12,24,39,-15,24
Silkeborg IF,8109,9,5,4,13,25,44,-19,19
AGF Aarhus,8109,10,4,7,11,16,36,-20,19
Lyngby,8109,11,3,9,12,26,45,-19,18
Brondby,8110,1,20,7,3,67,30,37,67
FC Midtjylla,8110,2,18,6,6,63,40,23,60
FC Nords,8110,3,17,6,7,82,46,36,57
Copenhagen,8110,4,12,6,12,57,51,6,42
AaB,8110,5,9,12,9,42,39,3,39
Sonderjyske,8110,6,8,6,10,28,29,-1,30
AC Horsens,8110,7,5,13,12,35,66,-31,28
Silkeborg IF,8110,8,6,3,13,28,44,-16,21
Lyngby,8110,9,4,9,11,29,46,-17,21
Randers FC,8110,10,5,6,13,25,42,-17,21
AGF Aarhus,8110,11,4,6,12,16,39,-23,18
Brondby,8111,1,21,5,4,73,33,40,68
FC Midtjylla,8111,2,20,5,5,66,39,27,65
Copenhagen,8111,3,15,5,10,60,42,18,50
FC Nords,8111,4,14,7,9,75,56,19,49
AaB,8111,5,6,13,11,36,46,-10,31
AC Horsens,8111,6,6,13,11,35,55,-20,31
Sonderjyske,8111,7,8,6,10,28,29,-1,30
Lyngby,8111,8,4,9,11,28,45,-17,21
Randers FC,8111,9,5,6,13,24,41,-17,21
Silkeborg IF,8111,10,5,4,13,26,45,-19,19
AGF Aarhus,8111,11,4,7,11,17,37,-20,19
Brondby,8112,1,20,6,4,68,31,37,66
FC Midtjylla,8112,2,19,6,5,60,35,25,63
FC Nords,8112,3,14,7,9,72,51,21,49
Copenhagen,8112,4,14,5,11,57,45,12,47
AaB,8112,5,9,12,9,35,37,-2,39
Sonderjyske,8112,6,8,6,10,28,29,-1,30
AC Horsens,8112,7,6,12,12,37,56,-19,30
Randers FC,8112,8,5,7,12,24,40,-16,22
Silkeborg IF,8112,9,6,3,13,27,44,-17,21
Lyngby,8112,10,3,10,11,27,45,-18,19
AGF Aarhus,8112,11,4,6,12,16,38,-22,18
Brondby,8113,1,20,6,4,68,31,37,66
FC Midtjylla,8113,2,20,4,6,66,38,28,64
FC Nords,8113,3,15,7,8,74,51,23,52
Copenhagen,8113,4,14,6,10,54,40,14,48
AC Horsens,8113,5,6,14,10,32,53,-21,32
AaB,8113,6,6,13,11,35,42,-7,31
Sonderjyske,8113,7,8,6,10,28,29,-1,30
Randers FC,8113,8,5,7,12,26,42,-16,22
Silkeborg IF,8113,9,6,3,13,27,45,-18,21
Lyngby,8113,10,3,10,11,29,47,-18,19
AGF Aarhus,8113,11,4,6,12,17,38,-21,18
Brondby,8114,1,21,6,3,72,34,38,69
FC Midtjylla,8114,2,19,5,6,68,40,28,62
FC Nords,8114,3,14,6,10,73,53,20,48
Copenhagen,8114,4,14,5,11,57,42,15,47
AC Horsens,8114,5,8,12,10,34,50,-16,36
AaB,8114,6,7,12,11,36,47,-11,33
Sonderjyske,8114,7,8,6,10,28,29,-1,30
Randers FC,8114,8,5,7,12,24,40,-16,22
AGF Aarhus,8114,9,5,6,11,19,37,-18,21
Lyngby,8114,10,3,10,11,27,45,-18,19
Silkeborg IF,8114,11,5,3,14,26,47,-21,18
Brondby,8115,1,19,7,4,68,37,31,64
FC Midtjylla,8115,2,20,4,6,67,44,23,64
FC Nords,8115,3,14,8,8,73,51,22,50
Copenhagen,8115,4,14,5,11,61,45,16,47
AC Horsens,8115,5,8,12,10,39,50,-11,36
AaB,8115,6,6,14,10,33,40,-7,32
Sonderjyske,8115,7,8,6,10,28,29,-1,30
Silkeborg IF,8115,8,6,3,13,29,45,-16,21
Lyngby,8115,9,4,9,11,28,45,-17,21
Randers FC,8115,10,5,6,13,24,41,-17,21
AGF Aarhus,8115,11,4,6,12,17,40,-23,18
Brondby,8116,1,22,5,3,74,31,43,71
FC Midtjylla,8116,2,20,5,5,64,38,26,65
FC Nords,8116,3,13,9,8,73,52,21,48
Copenhagen,8116,4,13,6,11,57,46,11,45
AaB,8116,5,7,14,9,40,43,-3,35
Sonderjyske,8116,6,8,6,10,28,29,-1,30
AC Horsens,8116,7,5,13,12,32,56,-24,28
Lyngby,8116,8,4,9,11,29,44,-15,21
Silkeborg IF,8116,9,6,3,13,27,45,-18,21
Randers FC,8116,10,5,6,13,23,42,-19,21
AGF Aarhus,8116,11,4,6,12,17,38,-21,18
Brondby,8117,1,20,5,5,70,33,37,65
FC Midtjylla,8117,2,17,5,8,58,41,17,56
FC Nords,8117,3,16,6,8,77,51,26,54
Copenhagen,8117,4,15,4,11,58,51,7,49
AaB,8117,5,9,12,9,43,40,3,39
AC Horsens,8117,6,7,12,11,35,51,-16,33
Sonderjyske,8117,7,8,6,10,28,29,-1,30
Lyngby,8117,8,4,9,11,31,46,-15,21
Silkeborg IF,8117,9,6,3,13,28,46,-18,21
Randers FC,8117,10,5,6,13,25,44,-19,21
AGF Aarhus,8117,11,4,6,12,18,39,-21,18
Brondby,8118,1,23,5,2,77,34,43,74
FC Midtjylla,8118,2,20,4,6,64,40,24,64
FC Nords,8118,3,14,6,10,70,53,17,48
Copenhagen,8118,4,14,5,11,63,44,19,47
AaB,8118,5,8,11,11,37,42,-5,35
Sonderjyske,8118,6,8,6,10,28,29,-1,30
AC Horsens,8118,7,5,13,12,34,58,-24,28
Randers FC,8118,8,6,6,12,25,39,-14,24
Silkeborg IF,8118,9,6,3,13,29,45,-16,21
Lyngby,8118,10,3,9,12,26,46,-20,18
AGF Aarhus,8118,11,4,6,12,17,40,-23,18
Brondby,8119,1,21,6,3,69,30,39,69
FC Midtjylla,8119,2,19,7,4,64,38,26,64
Copenhagen,8119,3,15,4,11,55,41,14,49
FC Nords,8119,4,13,7,10,68,53,15,46
AaB,8119,5,7,13,10,38,41,-3,34
Sonderjyske,8119,6,8,6,10,28,29,-1,30
AC Horsens,8119,7,5,15,10,35,52,-17,30
Lyngby,8119,8,4,9,11,29,45,-16,21
Randers FC,8119,9,5,6,13,24,42,-18,21
AGF Aarhus,8119,10,5,6,11,20,38,-18,21
Silkeborg IF,8119,11,5,3,14,27,48,-21,18
FC Midtjylla,8120,1,21,5,4,72,42,30,68
Brondby,8120,2,19,8,3,72,35,37,65
FC Nords,8120,3,13,8,9,76,57,19,47
Copenhagen,8120,4,13,7,10,58,45,13,46
AaB,8120,5,7,13,10,36,43,-7,34
Sonderjyske,8120,6,8,6,10,28,29,-1,30
AC Horsens,8120,7,5,15,10,32,50,-18,30
Silkeborg IF,8120,8,6,3,13,29,44,-15,21
Lyngby,8120,9,4,9,11,30,46,-16,21
Randers FC,8120,10,5,6,13,25,43,-18,21
AGF Aarhus,8120,11,4,6,12,16,40,-24,18
Brondby,8121,1,20,6,4,70,36,34,66
FC Midtjylla,8121,2,19,5,6,66,41,25,62
FC Nords,8121,3,15,6,9,74,50,24,51
Copenhagen,8121,4,14,4,12,62,46,16,46
AaB,8121,5,10,11,9,40,41,-1,41
Sonderjyske,8121,6,8,6,10,28,29,-1,30
AC Horsens,8121,7,6,12,12,35,59,-24,30
Lyngby,8121,8,4,9,11,28,45,-17,21
Randers FC,8121,9,5,6,13,24,41,-17,21
AGF Aarhus,8121,10,5,6,11,20,38,-18,21
Silkeborg IF,8121,11,5,3,14,27,48,-21,18
FC Midtjylla,8122,1,21,4,5,63,36,27,67
Brondby,8122,2,18,5,7,66,37,29,59
Copenhagen,8122,3,16,5,9,58,40,18,53
FC Nords,8122,4,13,6,11,68,50,18,45
AaB,8122,5,9,12,9,38,40,-2,39
AC Horsens,8122,6,7,12,11,33,49,-16,33
Sonderjyske,8122,7,8,6,10,28,29,-1,30
Randers FC,8122,8,6,6,12,24,39,-15,24
Silkeborg IF,8122,9,6,3,13,26,44,-18,21
Lyngby,8122,10,3,9,12,26,45,-19,18
AGF Aarhus,8122,11,4,6,12,16,37,-21,18
Brondby,8123,1,21,6,3,69,31,38,69
FC Midtjylla,8123,2,19,5,6,64,39,25,62
FC Nords,8123,3,15,6,9,72,50,22,51
Copenhagen,8123,4,13,6,11,59,46,13,45
AC Horsens,8123,5,7,13,10,34,51,-17,34
AaB,8123,6,7,12,11,38,45,-7,33
Sonderjyske,8123,7,8,6,10,28,29,-1,30
Randers FC,8123,8,5,7,12,23,39,-16,22
Lyngby,8123,9,3,10,11,26,44,-18,19
Silkeborg IF,8123,10,5,4,13,25,44,-19,19
AGF Aarhus,8123,11,4,7,11,16,36,-20,19
Brondby,8124,1,20,6,4,69,34,35,66
FC Midtjylla,8124,2,20,4,6,61,36,25,64
FC Nords,8124,3,15,7,8,76,48,28,52
Copenhagen,8124,4,13,5,12,54,45,9,44
AaB,8124,5,8,13,9,34,40,-6,37
AC Horsens,8124,6,6,13,11,35,52,-17,31
Sonderjyske,8124,7,8,6,10,28,29,-1,30
Lyngby,8124,8,4,9,11,29,44,-15,21
Silkeborg IF,8124,9,6,3,13,28,44,-16,21
Randers FC,8124,10,5,6,13,23,42,-19,21
AGF Aarhus,8124,11,4,6,12,16,39,-23,18
Brondby,8125,1,21,6,3,69,30,39,69
FC Midtjylla,8125,2,17,6,7,61,42,19,57
FC Nords,8125,3,15,7,8,76,53,23,52
Copenhagen,8125,4,15,6,9,60,42,18,51
AaB,8125,5,7,12,11,38,44,-6,33
AC Horsens,8125,6,6,13,11,32,51,-19,31
Sonderjyske,8125,7,8,6,10,28,29,-1,30
Lyngby,8125,8,4,9,11,30,44,-14,21
Silkeborg IF,8125,9,6,3,13,28,45,-17,21
Randers FC,8125,10,5,6,13,23,43,-20,21
AGF Aarhus,8125,11,4,6,12,17,39,-22,18
Brondby,8126,1,20,7,3,68,32,36,67
FC Midtjylla,8126,2,21,4,5,64,35,29,67
FC Nords,8126,3,14,8,8,77,52,25,50
Copenhagen,8126,4,13,4,13,59,51,8,43
AaB,8126,5,7,13,10,36,43,-7,34
AC Horsens,8126,6,6,14,10,37,54,-17,32
Sonderjyske,8126,7,8,6,10,28,29,-1,30
Lyngby,8126,8,4,9,11,28,45,-17,21
Silkeborg IF,8126,9,6,3,13,27,44,-17,21
Randers FC,8126,10,5,6,13,24,41,-17,21
AGF Aarhus,8126,11,4,6,12,16,38,-22,18
Brondby,8127,1,22,6,2,74,28,46,72
FC Midtjylla,8127,2,21,4,5,68,38,30,67
Copenhagen,8127,3,14,4,12,60,50,10,46
FC Nords,8127,4,13,6,11,68,59,9,45
AaB,8127,5,8,12,10,40,43,-3,36
Sonderjyske,8127,6,8,6,10,28,29,-1,30
AC Horsens,8127,7,6,12,12,33,51,-18,30
Randers FC,8127,8,6,6,12,25,40,-15,24
AGF Aarhus,8127,9,5,6,11,18,36,-18,21
Lyngby,8127,10,3,9,12,27,46,-19,18
Silkeborg IF,8127,11,5,3,14,25,46,-21,18
Brondby,8128,1,21,6,3,71,31,40,69
FC Midtjylla,8128,2,19,6,5,66,41,25,63
FC Nords,8128,3,15,8,7,77,51,26,53
Copenhagen,8128,4,15,4,11,60,47,13,49
AaB,8128,5,7,12,11,38,46,-8,33
Sonderjyske,8128,6,8,6,10,28,29,-1,30
AC Horsens,8128,7,5,12,13,34,56,-22,27
Randers FC,8128,8,5,7,12,23,39,-16,22
Silkeborg IF,8128,9,6,3,13,28,44,-16,21
Lyngby,8128,10,3,10,11,26,44,-18,19
AGF Aarhus,8128,11,4,6,12,16,39,-23,18
Brondby,8129,1,20,6,4,69,31,38,66
FC Midtjylla,8129,2,18,7,5,62,38,24,61
FC Nords,8129,3,15,6,9,73,52,21,51
Copenhagen,8129,4,14,6,10,60,45,15,48
AaB,8129,5,7,12,11,37,45,-8,33
AC Horsens,8129,6,6,15,9,38,54,-16,33
Sonderjyske,8129,7,8,6,10,28,29,-1,30
Silkeborg IF,8129,8,6,3,13,29,45,-16,21
Lyngby,8129,9,4,9,11,28,44,-16,21
Randers FC,8129,10,5,6,13,23,41,-18,21
AGF Aarhus,8129,11,4,6,12,17,40,-23,18
FC Midtjylla,8130,1,22,4,4,67,34,33,70
Brondby,8130,2,19,8,3,67,32,35,65
FC Nords,8130,3,13,7,10,71,55,16,46
Copenhagen,8130,4,13,6,11,54,45,9,45
AaB,8130,5,8,12,10,37,39,-2,36
AC Horsens,8130,6,6,13,11,33,50,-17,31
Sonderjyske,8130,7,8,6,10,28,29,-1,30
Lyngby,8130,8,4,9,11,29,44,-15,21
Silkeborg IF,8130,9,6,3,13,27,44,-17,21
Randers FC,8130,10,5,6,13,23,42,-19,21
AGF Aarhus,8130,11,4,6,12,16,38,-22,18
Brondby,8131,1,21,6,3,73,29,44,69
FC Midtjylla,8131,2,19,5,6,66,42,24,62
Copenhagen,8131,3,16,5,9,63,45,18,53
FC Nords,8131,4,14,7,9,73,54,19,49
AaB,8131,5,6,13,11,37,47,-10,31
Sonderjyske,8131,6,8,6,10,28,29,-1,30
AC Horsens,8131,7,5,14,11,33,54,-21,29
Randers FC,8131,8,5,7,12,24,40,-16,22
Silkeborg IF,8131,9,6,3,13,27,45,-18,21
Lyngby,8131,10,3,10,11,27,45,-18,19
AGF Aarhus,8131,11,4,6,12,17,38,-21,18
Brondby,8132,1,21,6,3,71,32,39,69
FC Midtjylla,8132,2,21,4,5,73,37,36,67
FC Nords,8132,3,14,8,8,74,50,24,50
Copenhagen,8132,4,12,7,11,57,51,6,43
AC Horsens,8132,5,6,14,10,38,55,-17,32
AaB,8132,6,6,13,11,35,49,-14,31
Sonderjyske,8132,7,8,6,10,28,29,-1,30
Randers FC,8132,8,5,7,12,24,40,-16,22
AGF Aarhus,8132,9,5,6,11,19,38,-19,21
Lyngby,8132,10,3,10,11,27,45,-18,19
Silkeborg IF,8132,11,5,3,14,27,47,-20,18
Brondby,8133,1,20,5,5,68,33,35,65
FC Midtjylla,8133,2,20,4,6,64,40,24,64
FC Nords,8133,3,14,7,9,73,50,23,49
Copenhagen,8133,4,15,4,11,58,44,14,49
AaB,8133,5,7,13,10,37,41,-4,34
AC Horsens,8133,6,7,13,10,34,52,-18,34
Sonderjyske,8133,7,8,6,10,28,29,-1,30
Randers FC,8133,8,5,7,12,23,39,-16,22
Silkeborg IF,8133,9,6,3,13,28,44,-16,21
Lyngby,8133,10,3,10,11,26,44,-18,19
AGF Aarhus,8133,11,4,6,12,16,39,-23,18
Brondby,8134,1,21,6,3,73,33,40,69
FC Midtjylla,8134,2,18,6,6,66,43,23,60
FC Nords,8134,3,14,7,9,73,55,18,49
Copenhagen,8134,4,14,5,11,59,47,12,47
AaB,8134,5,9,13,8,39,36,3,40
Sonderjyske,8134,6,8,6,10,28,29,-1,30
AC Horsens,8134,7,5,13,12,32,54,-22,28
Randers FC,8134,8,5,7,12,24,40,-16,22
Lyngby,8134,9,3,10,11,27,45,-18,19
Silkeborg IF,8134,10,5,4,13,25,44,-19,19
AGF Aarhus,8134,11,4,7,11,16,36,-20,19
Brondby,8135,1,21,6,3,69,33,36,69
FC Midtjylla,8135,2,19,7,4,68,40,28,64
FC Nords,8135,3,14,8,8,77,51,26,50
Copenhagen,8135,4,12,6,12,56,51,5,42
AaB,8135,5,8,13,9,42,43,-1,37
Sonderjyske,8135,6,8,6,10,28,29,-1,30
AC Horsens,8135,7,5,14,11,33,53,-20,29
Randers FC,8135,8,6,6,12,26,41,-15,24
Silkeborg IF,8135,9,6,3,13,29,45,-16,21
Lyngby,8135,10,3,9,12,28,47,-19,18
AGF Aarhus,8135,11,4,6,12,17,40,-23,18
Brondby,8136,1,20,5,5,68,32,36,65
FC Midtjylla,8136,2,18,6,6,59,37,22,60
Copenhagen,8136,3,15,5,10,58,45,13,50
FC Nords,8136,4,13,7,10,69,51,18,46
AaB,8136,5,9,12,9,41,41,0,39
AC Horsens,8136,6,7,13,10,36,51,-15,34
Sonderjyske,8136,7,8,6,10,28,29,-1,30
Lyngby,8136,8,4,9,11,27,44,-17,21
Randers FC,8136,9,5,6,13,23,40,-17,21
AGF Aarhus,8136,10,5,6,11,18,36,-18,21
Silkeborg IF,8136,11,5,3,14,25,46,-21,18
Brondby,8137,1,20,7,3,69,32,37,67
FC Midtjylla,8137,2,19,7,4,65,37,28,64
FC Nords,8137,3,13,8,9,74,57,17,47
Copenhagen,8137,4,13,6,11,58,45,13,45
AaB,8137,5,7,14,9,37,41,-4,35
AC Horsens,8137,6,5,16,9,34,51,-17,31
Sonderjyske,8137,7,8,6,10,28,29,-1,30
Randers FC,8137,8,5,7,12,23,39,-16,22
Silkeborg IF,8137,9,6,3,13,26,44,-18,21
Lyngby,8137,10,3,10,11,26,44,-18,19
AGF Aarhus,8137,11,4,6,12,16,37,-21,18
Brondby,8138,1,20,6,4,69,33,36,66
FC Midtjylla,8138,2,18,6,6,59,40,19,60
FC Nords,8138,3,15,7,8,75,47,28,52
Copenhagen,8138,4,14,6,10,63,46,17,48
AaB,8138,5,7,13,10,36,41,-5,34
AC Horsens,8138,6,6,14,10,33,54,-21,32
Sonderjyske,8138,7,8,6,10,28,29,-1,30
Randers FC,8138,8,6,6,12,26,41,-15,24
AGF Aarhus,8138,9,5,6,11,19,37,-18,21
Lyngby,8138,10,3,9,12,28,47,-19,18
Silkeborg IF,8138,11,5,3,14,26,47,-21,18
Brondby,8139,1,20,5,5,71,39,32,65
FC Midtjylla,8139,2,19,4,7,66,43,23,61
FC Nords,8139,3,16,6,8,76,46,30,54
Copenhagen,8139,4,15,5,10,63,47,16,50
AaB,8139,5,9,11,10,39,43,-4,38
Sonderjyske,8139,6,8,6,10,28,29,-1,30
AC Horsens,8139,7,5,13,12,30,53,-23,28
Lyngby,8139,8,4,9,11,32,44,-12,21
Randers FC,8139,9,5,6,13,23,45,-22,21
Silkeborg IF,8139,10,5,4,13,26,45,-19,19
AGF Aarhus,8139,11,4,7,11,17,37,-20,19
Brondby,8140,1,21,6,3,71,33,38,69
FC Midtjylla,8140,2,21,4,5,71,37,34,67
FC Nords,8140,3,14,7,9,76,54,22,49
Copenhagen,8140,4,13,5,12,57,47,10,44
AaB,8140,5,7,12,11,38,48,-10,33
AC Horsens,8140,6,7,12,11,34,54,-20,33
Sonderjyske,8140,7,8,6,10,28,29,-1,30
Lyngby,8140,8,4,9,11,28,45,-17,21
Randers FC,8140,9,5,6,13,24,41,-17,21
AGF Aarhus,8140,10,5,6,11,17,36,-19,21
Silkeborg IF,8140,11,5,3,14,25,45,-20,18
Brondby,8141,1,21,6,3,72,32,40,69
FC Midtjylla,8141,2,18,6,6,60,39,21,60
Copenhagen,8141,3,14,5,11,56,42,14,47
FC Nords,8141,4,13,7,10,73,55,18,46
AaB,8141,5,8,13,9,36,41,-5,37
AC Horsens,8141,6,7,13,10,37,51,-14,34
Sonderjyske,8141,7,8,6,10,28,29,-1,30
Lyngby,8141,8,4,9,11,30,44,-14,21
AGF Aarhus,8141,9,5,6,11,17,36,-19,21
Randers FC,8141,10,5,6,13,23,43,-20,21
Silkeborg IF,8141,11,5,3,14,25,45,-20,18
Brondby,8142,1,21,7,2,79,32,47,70
FC Midtjylla,8142,2,18,6,6,64,42,22,60
FC Nords,8142,3,14,6,10,71,55,16,48
Copenhagen,8142,4,12,6,12,56,48,8,42
AaB,8142,5,9,12,9,42,41,1,39
AC Horsens,8142,6,7,13,10,36,56,-20,34
Sonderjyske,8142,7,8,6,10,28,29,-1,30
Randers FC,8142,8,6,6,12,26,39,-13,24
Silkeborg IF,8142,9,6,3,13,27,45,-18,21
Lyngby,8142,10,3,9,12,26,47,-21,18
AGF Aarhus,8142,11,4,6,12,17,38,-21,18
Brondby,8143,1,20,6,4,68,39,29,66
FC Midtjylla,8143,2,20,5,5,70,39,31,65
FC Nords,8143,3,15,8,7,81,51,30,53
Copenhagen,8143,4,14,5,11,61,47,14,47
AaB,8143,5,6,14,10,39,46,-7,32
Sonderjyske,8143,6,8,6,10,28,29,-1,30
AC Horsens,8143,7,5,14,11,31,54,-23,29
Randers FC,8143,8,5,7,12,24,40,-16,22
AGF Aarhus,8143,9,5,6,11,19,38,-19,21
Lyngby,8143,10,3,10,11,27,45,-18,19
Silkeborg IF,8143,11,5,3,14,27,47,-20,18
Brondby,8144,1,22,5,3,73,31,42,71
FC Midtjylla,8144,2,19,4,7,63,39,24,61
Copenhagen,8144,3,15,4,11,58,46,12,49
FC Nords,8144,4,14,6,10,75,54,21,48
AaB,8144,5,8,11,11,37,44,-7,35
AC Horsens,8144,6,7,12,11,34,52,-18,33
Sonderjyske,8144,7,8,6,10,28,29,-1,30
Randers FC,8144,8,5,7,12,23,39,-16,22
Silkeborg IF,8144,9,6,3,13,28,45,-17,21
Lyngby,8144,10,3,10,11,26,44,-18,19
AGF Aarhus,8144,11,4,6,12,17,39,-22,18
Brondby,8145,1,21,7,2,74,31,43,70
FC Midtjylla,8145,2,18,5,7,65,44,21,59
FC Nords,8145,3,14,7,9,73,54,19,49
Copenhagen,8145,4,13,7,10,58,45,13,46
AaB,8145,5,7,13,10,37,42,-5,34
AC Horsens,8145,6,7,13,10,37,54,-17,34
Sonderjyske,8145,7,8,6,10,28,29,-1,30
Randers FC,8145,8,6,6,12,26,41,-15,24
Silkeborg IF,8145,9,6,3,13,26,44,-18,21
Lyngby,8145,10,3,9,12,28,47,-19,18
AGF Aarhus,8145,11,4,6,12,16,37,-21,18
Brondby,8146,1,21,5,4,71,33,38,68
FC Midtjylla,8146,2,19,4,7,63,42,21,61
FC Nords,8146,3,16,6,8,75,49,26,54
Copenhagen,8146,4,15,5,10,60,44,16,50
AaB,8146,5,7,11,12,37,44,-7,32
AC Horsens,8146,6,6,13,11,34,54,-20,31
Sonderjyske,8146,7,8,6,10,28,29,-1,30
Silkeborg IF,8146,8,6,3,13,28,45,-17,21
Lyngby,8146,9,4,9,11,27,44,-17,21
Randers FC,8146,10,5,6,13,23,40,-17,21
AGF Aarhus,8146,11,4,6,12,17,39,-22,18
Brondby,8147,1,19,6,5,69,37,32,63
FC Midtjylla,8147,2,19,6,5,65,39,26,63
FC Nords,8147,3,15,6,9,76,51,25,51
Copenhagen,8147,4,14,5,11,55,44,11,47
AaB,8147,5,9,12,9,39,39,0,39
Sonderjyske,8147,6,8,6,10,28,29,-1,30
AC Horsens,8147,7,5,15,10,34,54,-20,30
Randers FC,8147,8,5,7,12,24,40,-16,22
Silkeborg IF,8147,9,6,3,13,28,45,-17,21
Lyngby,8147,10,3,10,11,27,45,-18,19
AGF Aarhus,8147,11,4,6,12,17,39,-22,18
Brondby,8148,1,20,6,4,68,34,34,66
FC Midtjylla,8148,2,20,4,6,65,38,27,64
FC Nords,8148,3,13,8,9,73,57,16,47
Copenhagen,8148,4,13,5,12,55,44,11,44
AaB,8148,5,9,12,9,39,39,0,39
AC Horsens,8148,6,6,15,9,39,53,-14,33
Sonderjyske,8148,7,8,6,10,28,29,-1,30
Lyngby,8148,8,4,9,11,30,44,-14,21
Silkeborg IF,8148,9,6,3,13,27,45,-18,21
Randers FC,8148,10,5,6,13,23,43,-20,21
AGF Aarhus,8148,11,4,6,12,17,38,-21,18
Brondby,8149,1,21,6,3,71,33,38,69
FC Midtjylla,8149,2,19,7,4,64,37,27,64
FC Nords,8149,3,15,6,9,74,50,24,51
Copenhagen,8149,4,13,5,12,54,45,9,44
AaB,8149,5,8,11,11,38,43,-5,35
AC Horsens,8149,6,6,13,11,34,53,-19,31
Sonderjyske,8149,7,8,6,10,28,29,-1,30
Randers FC,8149,8,5,7,12,24,40,-16,22
Silkeborg IF,8149,9,6,3,13,26,44,-18,21
Lyngby,8149,10,3,10,11,27,45,-18,19
AGF Aarhus,8149,11,4,6,12,16,37,-21,18
Brondby,8150,1,20,8,2,71,32,39,68
FC Midtjylla,8150,2,21,5,4,70,38,32,68
FC Nords,8150,3,14,8,8,75,52,23,50
Copenhagen,8150,4,12,5,13,56,50,6,41
AaB,8150,5,8,11,11,38,44,-6,35
Sonderjyske,8150,6,8,6,10,28,29,-1,30
AC Horsens,8150,7,5,15,10,33,53,-20,30
Randers FC,8150,8,6,6,12,24,39,-15,24
Silkeborg IF,8150,9,6,3,13,29,45,-16,21
Lyngby,8150,10,3,9,12,26,45,-19,18
AGF Aarhus,8150,11,4,6,12,17,40,-23,18
Brondby,8151,1,21,5,4,74,35,39,68
FC Midtjylla,8151,2,20,5,5,67,41,26,65
Copenhagen,8151,3,16,4,10,60,41,19,52
FC Nords,8151,4,13,6,11,71,58,13,45
AaB,8151,5,8,12,10,40,44,-4,36
Sonderjyske,8151,6,8,6,10,28,29,-1,30
AC Horsens,8151,7,6,12,12,33,52,-19,30
Randers FC,8151,8,6,6,12,25,40,-15,24
Silkeborg IF,8151,9,6,3,13,31,45,-14,21
Lyngby,8151,10,3,9,12,27,46,-19,18
AGF Aarhus,8151,11,4,6,12,17,42,-25,18
Brondby,8152,1,20,5,5,67,33,34,65
FC Midtjylla,8152,2,18,6,6,61,39,22,60
Copenhagen,8152,3,16,4,10,63,45,18,52
FC Nords,8152,4,14,6,10,70,49,21,48
AaB,8152,5,8,12,10,38,42,-4,36
AC Horsens,8152,6,7,13,10,35,52,-17,34
Sonderjyske,8152,7,8,6,10,28,29,-1,30
Lyngby,8152,8,4,9,11,28,44,-16,21
Randers FC,8152,9,5,6,13,23,41,-18,21
AGF Aarhus,8152,10,5,6,11,18,36,-18,21
Silkeborg IF,8152,11,5,3,14,25,46,-21,18
Brondby,8153,1,21,5,4,72,35,37,68
FC Midtjylla,8153,2,20,5,5,67,39,28,65
Copenhagen,8153,3,14,5,11,65,48,17,47
FC Nords,8153,4,13,7,10,75,58,17,46
AaB,8153,5,8,13,9,41,43,-2,37
AC Horsens,8153,6,6,13,11,37,60,-23,31
Sonderjyske,8153,7,8,6,10,28,29,-1,30
Randers FC,8153,8,6,6,12,25,39,-14,24
AGF Aarhus,8153,9,5,6,11,19,37,-18,21
Lyngby,8153,10,3,9,12,26,46,-20,18
Silkeborg IF,8153,11,5,3,14,26,47,-21,18
Brondby,8154,1,22,5,3,75,36,39,71
FC Midtjylla,8154,2,20,4,6,64,39,25,64
FC Nords,8154,3,13,8,9,71,51,20,47
Copenhagen,8154,4,13,4,13,57,48,9,43
AaB,8154,5,8,13,9,41,43,-2,37
AC Horsens,8154,6,6,14,10,35,52,-17,32
Sonderjyske,8154,7,8,6,10,28,29,-1,30
Randers FC,8154,8,6,6,12,26,41,-15,24
Silkeborg IF,8154,9,6,3,13,28,45,-17,21
Lyngby,8154,10,3,9,12,28,47,-19,18
AGF Aarhus,8154,11,4,6,12,17,39,-22,18
Brondby,8155,1,20,7,3,66,30,36,67
FC Midtjylla,8155,2,20,5,5,63,38,25,65
FC Nords,8155,3,15,8,7,75,49,26,53
Copenhagen,8155,4,12,5,13,55,51,4,41
AC Horsens,8155,5,7,13,10,37,51,-14,34
AaB,8155,6,7,12,11,38,41,-3,33
Sonderjyske,8155,7,8,6,10,28,29,-1,30
Randers FC,8155,8,6,6,12,25,40,-15,24
Silkeborg IF,8155,9,5,4,13,27,46,-19,19
AGF Aarhus,8155,10,4,7,11,18,38,-20,19
Lyngby,8155,11,3,9,12,27,46,-19,18
Brondby,8156,1,19,8,3,70,35,35,65
FC Midtjylla,8156,2,19,6,5,63,36,27,63
FC Nords,8156,3,14,8,8,71,49,22,50
Copenhagen,8156,4,12,7,11,52,43,9,43
AaB,8156,5,7,13,10,38,43,-5,34
AC Horsens,8156,6,6,16,8,34,48,-14,34
Sonderjyske,8156,7,8,6,10,28,29,-1,30
Lyngby,8156,8,4,9,11,29,45,-16,21
Silkeborg IF,8156,9,6,3,13,27,44,-17,21
Randers FC,8156,10,5,6,13,24,42,-18,21
AGF Aarhus,8156,11,4,6,12,16,38,-22,18
Brondby,8157,1,23,5,2,72,27,45,74
FC Midtjylla,8157,2,18,5,7,63,48,15,59
Copenhagen,8157,3,16,4,10,63,44,19,52
FC Nords,8157,4,14,6,10,74,50,24,48
AC Horsens,8157,5,7,13,10,33,49,-16,34
Sonderjyske,8157,6,8,6,10,28,29,-1,30
AaB,8157,7,6,11,13,35,48,-13,29
Randers FC,8157,8,5,7,12,25,41,-16,22
Silkeborg IF,8157,9,6,3,13,27,45,-18,21
Lyngby,8157,10,3,10,11,28,46,-18,19
AGF Aarhus,8157,11,4,6,12,17,38,-21,18
FC Midtjylla,8158,1,21,4,5,73,41,32,67
Brondby,8158,2,20,5,5,65,34,31,65
Copenhagen,8158,3,14,5,11,58,43,15,47
FC Nords,8158,4,13,6,11,71,52,19,45
AaB,8158,5,8,12,10,38,42,-4,36
AC Horsens,8158,6,8,12,10,35,54,-19,36
Sonderjyske,8158,7,8,6,10,28,29,-1,30
Randers FC,8158,8,6,6,12,24,39,-15,24
Silkeborg IF,8158,9,6,3,13,28,44,-16,21
Lyngby,8158,10,3,9,12,26,45,-19,18
AGF Aarhus,8158,11,4,6,12,16,39,-23,18
Brondby,8159,1,21,7,2,75,34,41,70
FC Midtjylla,8159,2,18,6,6,64,44,20,60
FC Nords,8159,3,15,7,8,78,55,23,52
Copenhagen,8159,4,13,5,12,63,53,10,44
AaB,8159,5,8,12,10,39,41,-2,36
Sonderjyske,8159,6,8,6,10,28,29,-1,30
AC Horsens,8159,7,5,15,10,36,54,-18,30
Lyngby,8159,8,4,9,11,27,44,-17,21
Randers FC,8159,9,5,6,13,23,40,-17,21
Silkeborg IF,8159,10,5,4,13,27,46,-19,19
AGF Aarhus,8159,11,4,7,11,18,38,-20,19
Brondby,8160,1,21,5,4,68,34,34,68
FC Midtjylla,8160,2,20,5,5,70,38,32,65
Copenhagen,8160,3,14,6,10,56,45,11,48
FC Nords,8160,4,13,7,10,70,55,15,46
AC Horsens,8160,5,7,13,10,40,51,-11,34
AaB,8160,6,7,12,11,38,45,-7,33
Sonderjyske,8160,7,8,6,10,28,29,-1,30
Lyngby,8160,8,4,9,11,31,45,-14,21
Silkeborg IF,8160,9,6,3,13,29,45,-16,21
Randers FC,8160,10,5,6,13,24,44,-20,21
AGF Aarhus,8160,11,4,6,12,17,40,-23,18
FC Midtjylla,8161,1,20,5,5,68,40,28,65
Brondby,8161,2,19,7,4,69,34,35,64
FC Nords,8161,3,14,6,10,73,56,17,48
Copenhagen,8161,4,13,5,12,59,49,10,44
AaB,8161,5,10,12,8,41,39,2,42
AC Horsens,8161,6,6,13,11,36,54,-18,31
Sonderjyske,8161,7,8,6,10,28,29,-1,30
Randers FC,8161,8,6,6,12,26,40,-14,24
Silkeborg IF,8161,9,6,3,13,29,44,-15,21
Lyngby,8161,10,3,9,12,27,47,-20,18
AGF Aarhus,8161,11,4,6,12,16,40,-24,18
Brondby,8162,1,20,6,4,67,32,35,66
FC Midtjylla,8162,2,19,5,6,64,42,22,62
Copenhagen,8162,3,16,5,9,62,40,22,53
FC Nords,8162,4,13,8,9,71,53,18,47
AC Horsens,8162,5,6,15,9,35,50,-15,33
AaB,8162,6,7,11,12,36,44,-8,32
Sonderjyske,8162,7,8,6,10,28,29,-1,30
Randers FC,8162,8,6,6,12,25,40,-15,24
Silkeborg IF,8162,9,6,3,13,27,45,-18,21
Lyngby,8162,10,3,9,12,27,46,-19,18
AGF Aarhus,8162,11,4,6,12,17,38,-21,18
Brondby,8163,1,21,6,3,73,33,40,69
FC Midtjylla,8163,2,19,6,5,67,42,25,63
FC Nords,8163,3,14,7,9,72,49,23,49
Copenhagen,8163,4,13,7,10,58,47,11,46
AaB,8163,5,7,13,10,38,43,-5,34
AC Horsens,8163,6,6,13,11,31,51,-20,31
Sonderjyske,8163,7,8,6,10,28,29,-1,30
Randers FC,8163,8,6,6,12,25,40,-15,24
Silkeborg IF,8163,9,6,3,13,28,45,-17,21
Lyngby,8163,10,3,9,12,27,46,-19,18
AGF Aarhus,8163,11,4,6,12,17,39,-22,18
Brondby,8164,1,21,6,3,66,29,37,69
FC Midtjylla,8164,2,20,5,5,65,36,29,65
FC Nords,8164,3,15,7,8,74,47,27,52
Copenhagen,8164,4,12,7,11,50,43,7,43
AaB,8164,5,7,12,11,36,41,-5,33
AC Horsens,8164,6,6,13,11,34,55,-21,31
Sonderjyske,8164,7,8,6,10,28,29,-1,30
Lyngby,8164,8,4,9,11,28,44,-16,21
Silkeborg IF,8164,9,6,3,13,27,44,-17,21
Randers FC,8164,10,5,6,13,23,41,-18,21
AGF Aarhus,8164,11,4,6,12,16,38,-22,18
Brondby,8165,1,20,6,4,70,37,33,66
FC Midtjylla,8165,2,18,6,6,66,43,23,60
Copenhagen,8165,3,14,6,10,61,44,17,48
FC Nords,8165,4,13,8,9,72,53,19,47
AaB,8165,5,9,12,9,44,41,3,39
AC Horsens,8165,6,7,12,11,35,56,-21,33
Sonderjyske,8165,7,8,6,10,28,29,-1,30
Lyngby,8165,8,4,9,11,29,45,-16,21
Randers FC,8165,9,5,6,13,24,42,-18,21
Silkeborg IF,8165,10,5,4,13,26,45,-19,19
AGF Aarhus,8165,11,4,7,11,17,37,-20,19
Brondby,8166,1,19,5,6,65,33,32,62
FC Midtjylla,8166,2,19,4,7,64,40,24,61
Copenhagen,8166,3,16,5,9,62,40,22,53
FC Nords,8166,4,14,7,9,74,53,21,49
AaB,8166,5,10,11,9,36,38,-2,41
Sonderjyske,8166,6,8,6,10,28,29,-1,30
AC Horsens,8166,7,6,12,12,33,56,-23,30
Randers FC,8166,8,5,7,12,25,41,-16,22
Silkeborg IF,8166,9,6,3,13,28,45,-17,21
Lyngby,8166,10,3,10,11,28,46,-18,19
AGF Aarhus,8166,11,4,6,12,17,39,-22,18
Brondby,8167,1,20,6,4,69,31,38,66
FC Midtjylla,8167,2,19,6,5,62,37,25,63
FC Nords,8167,3,12,10,8,69,51,18,46
Copenhagen,8167,4,13,7,10,55,42,13,46
AaB,8167,5,9,12,9,38,40,-2,39
AC Horsens,8167,6,6,13,11,32,50,-18,31
Sonderjyske,8167,7,8,6,10,28,29,-1,30
Randers FC,8167,8,5,7,12,23,39,-16,22
Silkeborg IF,8167,9,6,3,13,27,45,-18,21
Lyngby,8167,10,3,10,11,26,44,-18,19
AGF Aarhus,8167,11,4,6,12,17,38,-21,18
Brondby,8168,1,21,7,2,73,32,41,70
FC Midtjylla,8168,2,20,5,5,68,38,30,65
FC Nords,8168,3,13,7,10,75,54,21,46
Copenhagen,8168,4,13,5,12,53,47,6,44
AaB,8168,5,7,13,10,38,43,-5,34
AC Horsens,8168,6,7,13,10,37,56,-19,34
Sonderjyske,8168,7,8,6,10,28,29,-1,30
Randers FC,8168,8,6,6,12,25,39,-14,24
AGF Aarhus,8168,9,5,6,11,17,36,-19,21
Lyngby,8168,10,3,9,12,26,46,-20,18
Silkeborg IF,8168,11,5,3,14,25,45,-20,18
Brondby,8169,1,20,6,4,72,37,35,66
FC Midtjylla,8169,2,20,4,6,68,43,25,64
FC Nords,8169,3,16,6,8,79,52,27,54
Copenhagen,8169,4,16,4,10,64,44,20,52
AC Horsens,8169,5,6,13,11,38,53,-15,31
Sonderjyske,8169,6,8,6,10,28,29,-1,30
AaB,8169,7,6,11,13,33,51,-18,29
Lyngby,8169,8,4,9,11,30,44,-14,21
AGF Aarhus,8169,9,5,6,11,18,36,-18,21
Randers FC,8169,10,5,6,13,23,43,-20,21
Silkeborg IF,8169,11,5,3,14,25,46,-21,18
Brondby,8170,1,21,6,3,70,29,41,69
FC Midtjylla,8170,2,17,7,6,61,39,22,58
Copenhagen,8170,3,14,5,11,57,45,12,47
FC Nords,8170,4,13,7,10,68,51,17,46
AaB,8170,5,9,12,9,37,41,-4,39
AC Horsens,8170,6,6,15,9,35,49,-14,33
Sonderjyske,8170,7,8,6,10,28,29,-1,30
Lyngby,8170,8,4,9,11,28,44,-16,21
Randers FC,8170,9,5,6,13,23,41,-18,21
AGF Aarhus,8170,10,5,6,11,17,36,-19,21
Silkeborg IF,8170,11,5,3,14,25,45,-20,18
FC Midtjylla,8171,1,21,4,5,64,38,26,67
Brondby,8171,2,20,6,4,68,31,37,66
Copenhagen,8171,3,16,4,10,58,40,18,52
FC Nords,8171,4,13,7,10,69,52,17,46
AaB,8171,5,9,11,10,41,42,-1,38
Sonderjyske,8171,6,8,6,10,28,29,-1,30
AC Horsens,8171,7,5,12,13,33,56,-23,27
Lyngby,8171,8,4,9,11,30,46,-16,21
Randers FC,8171,9,5,6,13,25,43,-18,21
Silkeborg IF,8171,10,5,4,13,26,45,-19,19
AGF Aarhus,8171,11,4,7,11,17,37,-20,19
FC Midtjylla,8172,1,21,5,4,69,38,31,68
Brondby,8172,2,20,5,5,65,36,29,65
FC Nords,8172,3,15,6,9,81,53,28,51
Copenhagen,8172,4,14,4,12,57,46,11,46
AaB,8172,5,7,13,10,40,45,-5,34
AC Horsens,8172,6,6,13,11,36,56,-20,31
Sonderjyske,8172,7,8,6,10,28,29,-1,30
Randers FC,8172,8,6,6,12,25,40,-15,24
Silkeborg IF,8172,9,6,3,13,27,44,-17,21
Lyngby,8172,10,3,9,12,27,46,-19,18
AGF Aarhus,8172,11,4,6,12,16,38,-22,18
Brondby,8173,1,22,5,3,76,33,43,71
FC Midtjylla,8173,2,20,5,5,68,42,26,65
FC Nords,8173,3,14,7,9,75,53,22,49
Copenhagen,8173,4,14,6,10,58,44,14,48
AC Horsens,8173,5,7,12,11,34,54,-20,33
Sonderjyske,8173,6,8,6,10,28,29,-1,30
AaB,8173,7,6,11,13,36,47,-11,29
Randers FC,8173,8,5,7,12,24,40,-16,22
Silkeborg IF,8173,9,6,3,13,27,45,-18,21
Lyngby,8173,10,3,10,11,27,45,-18,19
AGF Aarhus,8173,11,4,6,12,17,38,-21,18
Brondby,8174,1,19,6,5,65,32,33,63
FC Midtjylla,8174,2,19,6,5,67,40,27,63
Copenhagen,8174,3,15,5,10,59,40,19,50
FC Nords,8174,4,14,7,9,75,54,21,49
AC Horsens,8174,5,7,14,9,35,50,-15,35
AaB,8174,6,7,12,11,36,47,-11,33
Sonderjyske,8174,7,8,6,10,28,29,-1,30
Randers FC,8174,8,5,7,12,23,39,-16,22
Silkeborg IF,8174,9,6,3,13,28,45,-17,21
Lyngby,8174,10,3,10,11,26,44,-18,19
AGF Aarhus,8174,11,4,6,12,17,39,-22,18
Brondby,8175,1,23,5,2,79,29,50,74
FC Midtjylla,8175,2,18,6,6,66,46,20,60
Copenhagen,8175,3,14,6,10,55,41,14,48
FC Nords,8175,4,13,6,11,73,58,15,45
AaB,8175,5,8,13,9,38,40,-2,37
Sonderjyske,8175,6,8,6,10,28,29,-1,30
AC Horsens,8175,7,5,14,11,35,58,-23,29
Randers FC,8175,8,6,6,12,25,40,-15,24
Silkeborg IF,8175,9,6,3,13,29,44,-15,21
Lyngby,8175,10,3,9,12,27,46,-19,18
AGF Aarhus,8175,11,4,6,12,16,40,-24,18
Brondby,8176,1,21,6,3,68,30,38,69
FC Midtjylla,8176,2,20,4,6,65,40,25,64
FC Nords,8176,3,15,6,9,74,51,23,51
Copenhagen,8176,4,14,5,11,54,40,14,47
AC Horsens,8176,5,6,14,10,35,51,-16,32
AaB,8176,6,6,13,11,32,42,-10,31
Sonderjyske,8176,7,8,6,10,28,29,-1,30
Randers FC,8176,8,6,6,12,26,40,-14,24
AGF Aarhus,8176,9,5,6,11,17,36,-19,21
Lyngby,8176,10,3,9,12,27,47,-20,18
Silkeborg IF,8176,11,5,3,14,25,45,-20,18
Brondby,8177,1,21,6,3,72,32,40,69
FC Midtjylla,8177,2,19,5,6,69,42,27,62
FC Nords,8177,3,16,7,7,77,49,28,55
Copenhagen,8177,4,13,6,11,56,44,12,45
AC Horsens,8177,5,6,14,10,35,58,-23,32
Sonderjyske,8177,6,8,6,10,28,29,-1,30
AaB,8177,7,6,12,12,33,43,-10,30
Randers FC,8177,8,6,6,12,26,40,-14,24
AGF Aarhus,8177,9,5,6,11,17,36,-19,21
Lyngby,8177,10,3,9,12,27,47,-20,18
Silkeborg IF,8177,11,5,3,14,25,45,-20,18
FC Midtjylla,8178,1,20,5,5,70,40,30,65
Brondby,8178,2,19,6,5,64,33,31,63
FC Nords,8178,3,15,7,8,78,53,25,52
Copenhagen,8178,4,13,4,13,58,51,7,43
AC Horsens,8178,5,9,12,9,38,49,-11,39
AaB,8178,6,7,12,11,38,46,-8,33
Sonderjyske,8178,7,8,6,10,28,29,-1,30
Randers FC,8178,8,5,7,12,23,39,-16,22
Lyngby,8178,9,3,10,11,26,44,-18,19
Silkeborg IF,8178,10,5,4,13,26,45,-19,19
AGF Aarhus,8178,11,4,7,11,17,37,-20,19
Brondby,8179,1,19,7,4,73,38,35,64
FC Midtjylla,8179,2,19,6,5,64,38,26,63
FC Nords,8179,3,15,8,7,75,51,24,53
Copenhagen,8179,4,14,4,12,61,50,11,46
AaB,8179,5,8,12,10,37,40,-3,36
AC Horsens,8179,6,6,13,11,34,53,-19,31
Sonderjyske,8179,7,8,6,10,28,29,-1,30
Lyngby,8179,8,4,9,11,28,44,-16,21
Silkeborg IF,8179,9,6,3,13,27,44,-17,21
Randers FC,8179,10,5,6,13,23,41,-18,21
AGF Aarhus,8179,11,4,6,12,16,38,-22,18
Brondby,8180,1,20,5,5,67,33,34,65
FC Midtjylla,8180,2,20,4,6,68,41,27,64
FC Nords,8180,3,15,6,9,70,47,23,51
Copenhagen,8180,4,14,4,12,55,44,11,46
AaB,8180,5,10,11,9,37,39,-2,41
Sonderjyske,8180,6,8,6,10,28,29,-1,30
AC Horsens,8180,7,6,12,12,33,52,-19,30
Silkeborg IF,8180,8,6,3,13,28,45,-17,21
Lyngby,8180,9,4,9,11,27,44,-17,21
Randers FC,8180,10,5,6,13,23,40,-17,21
AGF Aarhus,8180,11,4,6,12,17,39,-22,18
Brondby,8181,1,21,6,3,71,32,39,69
FC Midtjylla,8181,2,19,5,6,65,44,21,62
FC Nords,8181,3,14,7,9,77,51,26,49
Copenhagen,8181,4,14,6,10,64,45,19,48
AaB,8181,5,9,11,10,37,41,-4,38
Sonderjyske,8181,6,8,6,10,28,29,-1,30
AC Horsens,8181,7,5,13,12,29,56,-27,28
Lyngby,8181,8,4,9,11,28,44,-16,21
Silkeborg IF,8181,9,6,3,13,26,44,-18,21
Randers FC,8181,10,5,6,13,23,41,-18,21
AGF Aarhus,8181,11,4,6,12,16,37,-21,18
Brondby,8182,1,21,7,2,68,28,40,70
FC Midtjylla,8182,2,18,6,6,65,40,25,60
FC Nords,8182,3,15,6,9,72,52,20,51
Copenhagen,8182,4,14,4,12,56,43,13,46
AC Horsens,8182,5,7,14,9,35,49,-14,35
AaB,8182,6,7,11,12,36,46,-10,32
Sonderjyske,8182,7,8,6,10,28,29,-1,30
Randers FC,8182,8,5,7,12,23,39,-16,22
Silkeborg IF,8182,9,6,3,13,26,44,-18,21
Lyngby,8182,10,3,10,11,26,44,-18,19
AGF Aarhus,8182,11,4,6,12,16,37,-21,18
Brondby,8183,1,19,8,3,70,34,36,65
FC Midtjylla,8183,2,19,7,4,64,38,26,64
Copenhagen,8183,3,14,6,10,61,45,16,48
FC Nords,8183,4,13,8,9,72,52,20,47
AaB,8183,5,8,13,9,39,41,-2,37
Sonderjyske,8183,6,8,6,10,28,29,-1,30
AC Horsens,8183,7,5,14,11,33,55,-22,29
Randers FC,8183,8,5,7,12,23,39,-16,22
Silkeborg IF,8183,9,6,3,13,31,45,-14,21
Lyngby,8183,10,3,10,11,26,44,-18,19
AGF Aarhus,8183,11,4,6,12,17,42,-25,18
Brondby,8184,1,21,6,3,69,34,35,69
FC Midtjylla,8184,2,19,5,6,64,40,24,62
Copenhagen,8184,3,15,6,9,62,43,19,51
FC Nords,8184,4,13,8,9,74,56,18,47
AaB,8184,5,7,13,10,38,43,-5,34
Sonderjyske,8184,6,8,6,10,28,29,-1,30
AC Horsens,8184,7,6,12,12,35,52,-17,30
Randers FC,8184,8,6,6,12,25,39,-14,24
AGF Aarhus,8184,9,5,6,11,19,38,-19,21
Silkeborg IF,8184,10,5,3,14,27,47,-20,18
Lyngby,8184,11,3,9,12,26,46,-20,18
FC Midtjylla,8185,1,21,4,5,69,38,31,67
Brondby,8185,2,20,6,4,71,35,36,66
FC Nords,8185,3,13,8,9,72,54,18,47
Copenhagen,8185,4,12,8,10,56,46,10,44
AaB,8185,5,8,13,9,38,42,-4,37
Sonderjyske,8185,6,8,6,10,28,29,-1,30
AC Horsens,8185,7,5,15,10,34,51,-17,30
Randers FC,8185,8,6,6,12,26,41,-15,24
Silkeborg IF,8185,9,6,3,13,28,44,-16,21
Lyngby,8185,10,3,9,12,28,47,-19,18
AGF Aarhus,8185,11,4,6,12,16,39,-23,18
Brondby,8186,1,21,6,3,69,32,37,69
FC Midtjylla,8186,2,18,8,4,65,38,27,62
FC Nords,8186,3,15,7,8,78,52,26,52
Copenhagen,8186,4,12,6,12,55,46,9,42
AaB,8186,5,7,13,10,37,44,-7,34
AC Horsens,8186,6,6,14,10,36,54,-18,32
Sonderjyske,8186,7,8,6,10,28,29,-1,30
Randers FC,8186,8,5,7,12,24,40,-16,22
Silkeborg IF,8186,9,6,3,13,30,45,-15,21
Lyngby,8186,10,3,10,11,27,45,-18,19
AGF Aarhus,8186,11,4,6,12,17,41,-24,18
FC Midtjylla,8187,1,19,4,7,63,41,22,61
Brondby,8187,2,18,6,6,66,38,28,60
Copenhagen,8187,3,15,5,10,60,43,17,50
FC Nords,8187,4,14,7,9,72,51,21,49
AaB,8187,5,9,11,10,37,40,-3,38
AC Horsens,8187,6,8,13,9,37,48,-11,37
Sonderjyske,8187,7,8,6,10,28,29,-1,30
Randers FC,8187,8,6,6,12,26,39,-13,24
AGF Aarhus,8187,9,5,6,11,17,36,-19,21
Silkeborg IF,8187,10,5,3,14,25,45,-20,18
Lyngby,8187,11,3,9,12,26,47,-21,18
Brondby,8188,1,19,8,3,69,35,34,65
FC Midtjylla,8188,2,18,6,6,65,43,22,60
FC Nords,8188,3,14,8,8,79,56,23,50
Copenhagen,8188,4,15,4,11,61,45,16,49
AaB,8188,5,7,13,10,38,44,-6,34
AC Horsens,8188,6,7,13,10,38,53,-15,34
Sonderjyske,8188,7,8,6,10,28,29,-1,30
Silkeborg IF,8188,8,6,3,13,29,45,-16,21
Lyngby,8188,9,4,9,11,27,44,-17,21
Randers FC,8188,10,5,6,13,23,40,-17,21
AGF Aarhus,8188,11,4,6,12,17,40,-23,18
Brondby,8189,1,21,6,3,76,35,41,69
FC Midtjylla,8189,2,20,6,4,67,37,30,66
FC Nords,8189,3,13,8,9,76,53,23,47
Copenhagen,8189,4,13,5,12,54,47,7,44
AaB,8189,5,9,11,10,37,40,-3,38
Sonderjyske,8189,6,8,6,10,28,29,-1,30
AC Horsens,8189,7,6,12,12,33,57,-24,30
Lyngby,8189,8,4,9,11,28,44,-16,21
Randers FC,8189,9,5,6,13,23,41,-18,21
Silkeborg IF,8189,10,5,4,13,27,46,-19,19
AGF Aarhus,8189,11,4,7,11,18,38,-20,19
Brondby,8190,1,21,6,3,69,30,39,69
FC Midtjylla,8190,2,20,4,6,62,37,25,64
FC Nords,8190,3,14,8,8,70,49,21,50
Copenhagen,8190,4,13,5,12,53,43,10,44
AaB,8190,5,9,11,10,37,39,-2,38
Sonderjyske,8190,6,8,6,10,28,29,-1,30
AC Horsens,8190,7,5,14,11,30,49,-19,29
Lyngby,8190,8,4,9,11,28,45,-17,21
Randers FC,8190,9,5,6,13,24,41,-17,21
Silkeborg IF,8190,10,5,4,13,27,46,-19,19
AGF Aarhus,8190,11,4,7,11,18,38,-20,19
Brondby,8191,1,22,5,3,77,32,45,71
FC Midtjylla,8191,2,19,6,5,68,45,23,63
Copenhagen,8191,3,14,6,10,61,45,16,48
FC Nords,8191,4,12,7,11,68,55,13,43
AC Horsens,8191,5,8,12,10,40,53,-13,36
AaB,8191,6,6,14,10,35,45,-10,32
Sonderjyske,8191,7,8,6,10,28,29,-1,30
Lyngby,8191,8,4,9,11,28,44,-16,21
Randers FC,8191,9,5,6,13,23,41,-18,21
AGF Aarhus,8191,10,5,6,11,18,37,-19,21
Silkeborg IF,8191,11,5,3,14,26,46,-20,18
Brondby,8192,1,20,8,2,72,35,37,68
FC Midtjylla,8192,2,21,5,4,69,38,31,68
FC Nords,8192,3,13,9,8,70,49,21,48
Copenhagen,8192,4,12,6,12,56,48,8,42
AaB,8192,5,8,12,10,41,46,-5,36
Sonderjyske,8192,6,8,6,10,28,29,-1,30
AC Horsens,8192,7,6,12,12,38,56,-18,30
Lyngby,8192,8,4,9,11,28,44,-16,21
Silkeborg IF,8192,9,6,3,13,28,46,-18,21
Randers FC,8192,10,5,6,13,23,41,-18,21
AGF Aarhus,8192,11,4,6,12,18,39,-21,18
Brondby,8193,1,21,6,3,70,30,40,69
FC Midtjylla,8193,2,21,4,5,71,43,28,67
FC Nords,8193,3,14,6,10,73,54,19,48
Copenhagen,8193,4,12,5,13,57,51,6,41
AaB,8193,5,9,11,10,39,41,-2,38
AC Horsens,8193,6,7,12,11,35,52,-17,33
Sonderjyske,8193,7,8,6,10,28,29,-1,30
Randers FC,8193,8,5,7,12,25,41,-16,22
Lyngby,8193,9,3,10,11,28,46,-18,19
Silkeborg IF,8193,10,5,4,13,25,44,-19,19
AGF Aarhus,8193,11,4,7,11,16,36,-20,19
Brondby,8194,1,21,7,2,74,35,39,70
FC Midtjylla,8194,2,18,8,4,66,40,26,62
Copenhagen,8194,3,14,6,10,59,45,14,48
FC Nords,8194,4,13,8,9,73,53,20,47
AC Horsens,8194,5,6,15,9,36,52,-16,33
Sonderjyske,8194,6,8,6,10,28,29,-1,30
AaB,8194,7,6,12,12,37,46,-9,30
Lyngby,8194,8,4,9,11,30,44,-14,21
AGF Aarhus,8194,9,5,6,11,18,36,-18,21
Randers FC,8194,10,5,6,13,23,43,-20,21
Silkeborg IF,8194,11,5,3,14,25,46,-21,18
Brondby,8195,1,22,6,2,71,30,41,72
FC Midtjylla,8195,2,18,5,7,59,41,18,59
FC Nords,8195,3,14,7,9,72,50,22,49
Copenhagen,8195,4,15,4,11,58,41,17,49
AaB,8195,5,7,12,11,36,44,-8,33
AC Horsens,8195,6,7,12,11,38,54,-16,33
Sonderjyske,8195,7,8,6,10,28,29,-1,30
Randers FC,8195,8,5,7,12,26,42,-16,22
Lyngby,8195,9,3,10,11,29,47,-18,19
Silkeborg IF,8195,10,5,4,13,27,46,-19,19
AGF Aarhus,8195,11,4,7,11,18,38,-20,19
Brondby,8196,1,20,6,4,75,34,41,66
FC Midtjylla,8196,2,18,6,6,63,40,23,60
Copenhagen,8196,3,16,5,9,58,40,18,53
FC Nords,8196,4,15,6,9,77,54,23,51
AaB,8196,5,7,12,11,35,44,-9,33
AC Horsens,8196,6,6,13,11,40,62,-22,31
Sonderjyske,8196,7,8,6,10,28,29,-1,30
Randers FC,8196,8,6,6,12,25,39,-14,24
AGF Aarhus,8196,9,5,6,11,17,36,-19,21
Lyngby,8196,10,3,9,12,26,46,-20,18
Silkeborg IF,8196,11,5,3,14,25,45,-20,18
Brondby,8197,1,23,5,2,72,29,43,74
FC Midtjylla,8197,2,20,5,5,62,36,26,65
FC Nords,8197,3,14,7,9,73,49,24,49
Copenhagen,8197,4,12,4,14,53,47,6,40
AaB,8197,5,8,11,11,35,42,-7,35
AC Horsens,8197,6,6,14,10,34,52,-18,32
Sonderjyske,8197,7,8,6,10,28,29,-1,30
Lyngby,8197,8,4,9,11,27,44,-17,21
Randers FC,8197,9,5,6,13,23,40,-17,21
Silkeborg IF,8197,10,6,3,13,29,47,-18,21
AGF Aarhus,8197,11,4,6,12,19,40,-21,18
FC Midtjylla,8198,1,21,5,4,68,35,33,68
Brondby,8198,2,20,5,5,71,35,36,65
Copenhagen,8198,3,14,7,9,61,43,18,49
FC Nords,8198,4,12,9,9,73,57,16,45
AaB,8198,5,7,13,10,38,47,-9,34
AC Horsens,8198,6,6,13,11,38,58,-20,31
Sonderjyske,8198,7,8,6,10,28,29,-1,30
Randers FC,8198,8,6,6,12,25,40,-15,24
Silkeborg IF,8198,9,6,3,13,28,45,-17,21
Lyngby,8198,10,3,9,12,27,46,-19,18
AGF Aarhus,8198,11,4,6,12,17,39,-22,18
Brondby,8199,1,21,7,2,70,29,41,70
FC Midtjylla,8199,2,21,4,5,69,41,28,67
FC Nords,8199,3,15,6,9,75,51,24,51
Copenhagen,8199,4,13,6,11,61,50,11,45
AaB,8199,5,6,14,10,36,45,-9,32
Sonderjyske,8199,6,8,6,10,28,29,-1,30
AC Horsens,8199,7,5,13,12,34,55,-21,28
Lyngby,8199,8,4,9,11,27,44,-17,21
Randers FC,8199,9,5,6,13,23,40,-17,21
Silkeborg IF,8199,10,6,3,13,28,46,-18,21
AGF Aarhus,8199,11,4,6,12,18,39,-21,18
Brondby,8200,1,22,5,3,71,30,41,71
FC Midtjylla,8200,2,20,4,6,66,38,28,64
Copenhagen,8200,3,14,6,10,55,40,15,48
FC Nords,8200,4,12,8,10,70,57,13,44
AC Horsens,8200,5,8,12,10,40,51,-11,36
AaB,8200,6,6,13,11,33,45,-12,31
Sonderjyske,8200,7,8,6,10,28,29,-1,30
Silkeborg IF,8200,8,6,3,13,29,44,-15,21
Lyngby,8200,9,4,9,11,28,45,-17,21
Randers FC,8200,10,5,6,13,24,41,-17,21
AGF Aarhus,8200,11,4,6,12,16,40,-24,18
Brondby,8201,1,20,5,5,68,34,34,65
FC Midtjylla,8201,2,19,4,7,60,39,21,61
FC Nords,8201,3,16,6,8,74,50,24,54
Copenhagen,8201,4,15,5,10,61,43,18,50
AC Horsens,8201,5,7,13,10,36,52,-16,34
AaB,8201,6,7,11,12,36,43,-7,32
Sonderjyske,8201,7,8,6,10,28,29,-1,30
Silkeborg IF,8201,8,6,3,13,29,44,-15,21
Lyngby,8201,9,4,9,11,27,44,-17,21
Randers FC,8201,10,5,6,13,23,40,-17,21
AGF Aarhus,8201,11,4,6,12,16,40,-24,18
Brondby,8202,1,21,7,2,68,28,40,70
FC Midtjylla,8202,2,19,7,4,68,40,28,64
FC Nords,8202,3,15,6,9,74,50,24,51
Copenhagen,8202,4,13,6,11,60,49,11,45
AaB,8202,5,7,12,11,37,44,-7,33
Sonderjyske,8202,6,8,6,10,28,29,-1,30
AC Horsens,8202,7,5,14,11,33,55,-22,29
Lyngby,8202,8,4,9,11,29,45,-16,21
Randers FC,8202,9,5,6,13,24,42,-18,21
Silkeborg IF,8202,10,5,4,13,25,44,-19,19
AGF Aarhus,8202,11,4,7,11,16,36,-20,19
Brondby,8203,1,21,5,4,70,32,38,68
FC Midtjylla,8203,2,18,4,8,68,47,21,58
FC Nords,8203,3,16,7,7,76,49,27,55
Copenhagen,8203,4,13,6,11,57,45,12,45
AaB,8203,5,8,11,11,39,47,-8,35
AC Horsens,8203,6,7,13,10,39,55,-16,34
Sonderjyske,8203,7,8,6,10,28,29,-1,30
Lyngby,8203,8,4,9,11,30,46,-16,21
Randers FC,8203,9,5,6,13,25,43,-18,21
AGF Aarhus,8203,10,5,6,11,18,37,-19,21
Silkeborg IF,8203,11,5,3,14,26,46,-20,18
Brondby,8204,1,21,6,3,67,30,37,69
FC Midtjylla,8204,2,19,4,7,64,40,24,61
Copenhagen,8204,3,14,7,9,61,44,17,49
FC Nords,8204,4,12,9,9,73,55,18,45
AaB,8204,5,8,13,9,40,40,0,37
AC Horsens,8204,6,6,13,11,33,55,-22,31
Sonderjyske,8204,7,8,6,10,28,29,-1,30
Randers FC,8204,8,6,6,12,25,40,-15,24
AGF Aarhus,8204,9,5,6,11,18,37,-19,21
Lyngby,8204,10,3,9,12,27,46,-19,18
Silkeborg IF,8204,11,5,3,14,26,46,-20,18
Brondby,8205,1,20,7,3,75,34,41,67
FC Midtjylla,8205,2,20,5,5,65,37,28,65
Copenhagen,8205,3,15,5,10,60,47,13,50
FC Nords,8205,4,13,8,9,70,51,19,47
AaB,8205,5,8,11,11,38,46,-8,35
Sonderjyske,8205,6,8,6,10,28,29,-1,30
AC Horsens,8205,7,5,14,11,31,50,-19,29
Randers FC,8205,8,6,6,12,26,41,-15,24
Silkeborg IF,8205,9,6,3,13,27,45,-18,21
Lyngby,8205,10,3,9,12,28,47,-19,18
AGF Aarhus,8205,11,4,6,12,17,38,-21,18
Brondby,8206,1,23,5,2,79,32,47,74
FC Midtjylla,8206,2,21,4,5,68,39,29,67
FC Nords,8206,3,14,6,10,78,53,25,48
Copenhagen,8206,4,13,4,13,59,49,10,43
AaB,8206,5,8,11,11,35,47,-12,35
Sonderjyske,8206,6,8,6,10,28,29,-1,30
AC Horsens,8206,7,6,12,12,37,62,-25,30
Randers FC,8206,8,6,6,12,26,40,-14,24
AGF Aarhus,8206,9,5,6,11,19,38,-19,21
Lyngby,8206,10,3,9,12,27,47,-20,18
Silkeborg IF,8206,10,5,3,14,27,47,-20,18
FC Midtjylla,8207,1,22,4,4,70,40,30,70
Brondby,8207,2,19,7,4,69,36,33,64
FC Nords,8207,3,14,8,8,72,49,23,50
Copenhagen,8207,4,14,5,11,60,44,16,47
AC Horsens,8207,5,5,16,9,37,53,-16,31
Sonderjyske,8207,6,8,6,10,28,29,-1,30
AaB,8207,7,6,12,12,34,46,-12,30
Randers FC,8207,8,6,6,12,24,39,-15,24
AGF Aarhus,8207,9,5,6,11,20,38,-18,21
Lyngby,8207,10,3,9,12,26,45,-19,18
Silkeborg IF,8207,11,5,3,14,27,48,-21,18
Brondby,8208,1,21,7,2,71,31,40,70
FC Midtjylla,8208,2,17,6,7,63,45,18,57
Copenhagen,8208,3,15,4,11,59,45,14,49
FC Nords,8208,4,14,6,10,80,54,26,48
AaB,8208,5,8,12,10,36,44,-8,36
AC Horsens,8208,6,7,13,10,35,51,-16,34
Sonderjyske,8208,7,8,6,10,28,29,-1,30
Randers FC,8208,8,5,7,12,25,41,-16,22
Silkeborg IF,8208,9,6,3,13,27,45,-18,21
Lyngby,8208,10,3,10,11,28,46,-18,19
AGF Aarhus,8208,11,4,6,12,17,38,-21,18
Brondby,8209,1,21,7,2,71,29,42,70
FC Midtjylla,8209,2,21,4,5,69,39,30,67
Copenhagen,8209,3,14,5,11,55,41,14,47
FC Nords,8209,4,13,6,11,71,53,18,45
AaB,8209,5,8,11,11,36,46,-10,35
AC Horsens,8209,6,6,13,11,31,51,-20,31
Sonderjyske,8209,7,8,6,10,28,29,-1,30
Randers FC,8209,8,6,6,12,27,39,-12,24
Silkeborg IF,8209,9,5,4,13,26,45,-19,19
AGF Aarhus,8209,10,4,7,11,17,37,-20,19
Lyngby,8209,11,3,9,12,26,48,-22,18
Brondby,8210,1,21,6,3,72,32,40,69
FC Midtjylla,8210,2,20,4,6,67,38,29,64
FC Nords,8210,3,15,7,8,76,51,25,52
Copenhagen,8210,4,13,5,12,59,48,11,44
AC Horsens,8210,5,7,12,11,32,54,-22,33
AaB,8210,6,6,14,10,37,46,-9,32
Sonderjyske,8210,7,8,6,10,28,29,-1,30
Randers FC,8210,8,5,7,12,25,41,-16,22
AGF Aarhus,8210,9,5,6,11,17,36,-19,21
Lyngby,8210,10,3,10,11,28,46,-18,19
Silkeborg IF,8210,11,5,3,14,25,45,-20,18
Brondby,8211,1,20,6,4,69,32,37,66
FC Midtjylla,8211,2,20,4,6,65,40,25,64
FC Nords,8211,3,16,6,8,74,48,26,54
Copenhagen,8211,4,14,6,10,56,44,12,48
AC Horsens,8211,5,7,13,10,35,49,-14,34
Sonderjyske,8211,6,8,6,10,28,29,-1,30
AaB,8211,7,6,11,13,36,48,-12,29
Randers FC,8211,8,6,6,12,25,40,-15,24
Silkeborg IF,8211,9,6,3,13,26,44,-18,21
Lyngby,8211,10,3,9,12,27,46,-19,18
AGF Aarhus,8211,11,4,6,12,16,37,-21,18
Brondby,8212,1,19,7,4,71,34,37,64
FC Midtjylla,8212,2,19,5,6,67,43,24,62
Copenhagen,8212,3,15,5,10,63,43,20,50
FC Nords,8212,4,14,6,10,73,56,17,48
AaB,8212,5,8,14,8,40,41,-1,38
AC Horsens,8212,6,6,13,11,36,59,-23,31
Sonderjyske,8212,7,8,6,10,28,29,-1,30
Lyngby,8212,8,4,9,11,29,44,-15,21
Silkeborg IF,8212,9,6,3,13,27,44,-17,21
Randers FC,8212,10,5,6,13,23,42,-19,21
AGF Aarhus,8212,11,4,6,12,16,38,-22,18
Brondby,8213,1,21,6,3,70,31,39,69
FC Midtjylla,8213,2,20,5,5,64,38,26,65
FC Nords,8213,3,14,6,10,72,50,22,48
Copenhagen,8213,4,13,5,12,55,48,7,44
AaB,8213,5,8,11,11,38,42,-4,35
AC Horsens,8213,6,7,13,10,36,52,-16,34
Sonderjyske,8213,7,8,6,10,28,29,-1,30
Randers FC,8213,8,6,6,12,24,39,-15,24
Silkeborg IF,8213,9,5,4,13,25,44,-19,19
AGF Aarhus,8213,10,4,7,11,16,36,-20,19
Lyngby,8213,11,3,9,12,26,45,-19,18
Brondby,8214,1,22,5,3,71,32,39,71
FC Midtjylla,8214,2,19,6,5,65,39,26,63
FC Nords,8214,3,13,9,8,72,52,20,48
Copenhagen,8214,4,14,6,10,57,43,14,48
AaB,8214,5,6,15,9,34,39,-5,33
Sonderjyske,8214,6,8,6,10,28,29,-1,30
AC Horsens,8214,7,5,13,12,33,53,-20,28
Randers FC,8214,8,6,6,12,26,40,-14,24
Silkeborg IF,8214,9,6,3,13,27,44,-17,21
Lyngby,8214,10,3,9,12,27,47,-20,18
AGF Aarhus,8214,11,4,6,12,16,38,-22,18
FC Midtjylla,8215,1,19,6,5,70,43,27,63
Brondby,8215,2,18,5,7,65,37,28,59
FC Nords,8215,3,15,8,7,75,50,25,53
Copenhagen,8215,4,14,4,12,57,45,12,46
AaB,8215,5,8,14,8,39,40,-1,38
AC Horsens,8215,6,7,13,10,35,52,-17,34
Sonderjyske,8215,7,8,6,10,28,29,-1,30
Lyngby,8215,8,4,9,11,27,44,-17,21
Randers FC,8215,9,5,6,13,23,40,-17,21
Silkeborg IF,8215,10,5,4,13,26,45,-19,19
AGF Aarhus,8215,11,4,7,11,17,37,-20,19
Brondby,8216,1,20,6,4,68,31,37,66
FC Midtjylla,8216,2,19,4,7,67,43,24,61
FC Nords,8216,3,16,6,8,77,49,28,54
Copenhagen,8216,4,13,5,12,57,50,7,44
AC Horsens,8216,5,9,12,9,37,48,-11,39
AaB,8216,6,7,11,12,35,46,-11,32
Sonderjyske,8216,7,8,6,10,28,29,-1,30
Randers FC,8216,8,5,7,12,25,41,-16,22
Silkeborg IF,8216,9,6,3,13,27,45,-18,21
Lyngby,8216,10,3,10,11,28,46,-18,19
AGF Aarhus,8216,11,4,6,12,17,38,-21,18
FC Midtjylla,8217,1,20,4,6,70,39,31,64
Brondby,8217,2,19,6,5,67,36,31,63
Copenhagen,8217,3,16,5,9,59,41,18,53
FC Nords,8217,4,13,8,9,70,53,17,47
AaB,8217,5,8,12,10,39,45,-6,36
AC Horsens,8217,6,6,13,11,36,53,-17,31
Sonderjyske,8217,7,8,6,10,28,29,-1,30
Lyngby,8217,8,4,9,11,29,45,-16,21
Silkeborg IF,8217,9,6,3,13,27,44,-17,21
Randers FC,8217,10,5,6,13,24,42,-18,21
AGF Aarhus,8217,11,4,6,12,16,38,-22,18
Brondby,8218,1,22,6,2,74,30,44,72
FC Midtjylla,8218,2,19,5,6,68,43,25,62
FC Nords,8218,3,13,8,9,69,51,18,47
Copenhagen,8218,4,13,5,12,57,45,12,44
AaB,8218,5,8,11,11,36,46,-10,35
AC Horsens,8218,6,7,13,10,35,50,-15,34
Sonderjyske,8218,7,8,6,10,28,29,-1,30
Randers FC,8218,8,6,6,12,25,40,-15,24
Silkeborg IF,8218,9,5,4,13,26,45,-19,19
AGF Aarhus,8218,10,4,7,11,17,37,-20,19
Lyngby,8218,11,3,9,12,27,46,-19,18
Brondby,8219,1,20,7,3,71,32,39,67
FC Midtjylla,8219,2,19,6,5,66,40,26,63
FC Nords,8219,3,14,8,8,72,49,23,50
Copenhagen,8219,4,12,6,12,56,46,10,42
AC Horsens,8219,5,8,12,10,35,51,-16,36
AaB,8219,6,7,13,10,37,45,-8,34
Sonderjyske,8219,7,8,6,10,28,29,-1,30
Lyngby,8219,8,4,9,11,28,45,-17,21
Randers FC,8219,9,5,6,13,24,41,-17,21
AGF Aarhus,8219,10,5,6,11,18,36,-18,21
Silkeborg IF,8219,11,5,3,14,25,46,-21,18
FC Midtjylla,8220,1,22,4,4,68,35,33,70
Brondby,8220,2,20,6,4,72,34,38,66
FC Nords,8220,3,14,6,10,73,59,14,48
Copenhagen,8220,4,13,5,12,56,45,11,44
AaB,8220,5,8,11,11,36,42,-6,35
AC Horsens,8220,6,7,12,11,32,48,-16,33
Sonderjyske,8220,7,8,6,10,28,29,-1,30
Randers FC,8220,8,6,6,12,24,39,-15,24
Silkeborg IF,8220,9,6,3,13,27,45,-18,21
Lyngby,8220,10,3,9,12,26,45,-19,18
AGF Aarhus,8220,11,4,6,12,17,38,-21,18
Brondby,8221,1,19,7,4,69,35,34,64
FC Midtjylla,8221,2,18,5,7,64,42,22,59
FC Nords,8221,3,15,7,8,74,52,22,52
Copenhagen,8221,4,16,4,10,63,43,20,52
AaB,8221,5,8,12,10,37,42,-5,36
AC Horsens,8221,6,6,13,11,38,57,-19,31
Sonderjyske,8221,7,8,6,10,28,29,-1,30
Silkeborg IF,8221,8,6,3,13,29,44,-15,21
Lyngby,8221,9,4,9,11,27,44,-17,21
Randers FC,8221,10,5,6,13,23,40,-17,21
AGF Aarhus,8221,11,4,6,12,16,40,-24,18
Brondby,8222,1,22,6,2,72,31,41,72
FC Midtjylla,8222,2,21,4,5,69,39,30,67
FC Nords,8222,3,15,6,9,78,52,26,51
Copenhagen,8222,4,12,4,14,54,50,4,40
AaB,8222,5,7,12,11,37,44,-7,33
AC Horsens,8222,6,6,14,10,32,52,-20,32
Sonderjyske,8222,7,8,6,10,28,29,-1,30
Randers FC,8222,8,6,6,12,25,40,-15,24
AGF Aarhus,8222,9,5,6,11,19,37,-18,21
Lyngby,8222,10,3,9,12,27,46,-19,18
Silkeborg IF,8222,11,5,3,14,26,47,-21,18
Brondby,8223,1,23,5,2,78,32,46,74
FC Midtjylla,8223,2,19,5,6,62,38,24,62
FC Nords,8223,3,15,6,9,72,54,18,51
Copenhagen,8223,4,14,4,12,56,46,10,46
AaB,8223,5,7,12,11,37,41,-4,33
Sonderjyske,8223,6,8,6,10,28,29,-1,30
AC Horsens,8223,7,6,12,12,32,52,-20,30
Randers FC,8223,8,5,7,12,24,40,-16,22
Lyngby,8223,9,3,10,11,27,45,-18,19
Silkeborg IF,8223,10,5,4,13,27,46,-19,19
AGF Aarhus,8223,11,4,7,11,18,38,-20,19
Brondby,8224,1,20,6,4,71,32,39,66
FC Midtjylla,8224,2,20,4,6,67,39,28,64
FC Nords,8224,3,15,7,8,74,50,24,52
Copenhagen,8224,4,15,5,10,57,42,15,50
AaB,8224,5,7,12,11,38,46,-8,33
Sonderjyske,8224,6,8,6,10,28,29,-1,30
AC Horsens,8224,7,6,12,12,34,58,-24,30
Randers FC,8224,8,6,6,12,24,39,-15,24
Silkeborg IF,8224,9,6,3,13,27,45,-18,21
Lyngby,8224,10,3,9,12,26,45,-19,18
AGF Aarhus,8224,11,4,6,12,17,38,-21,18
Brondby,8225,1,19,7,4,71,37,34,64
FC Midtjylla,8225,2,18,6,6,61,38,23,60
FC Nords,8225,3,16,7,7,78,52,26,55
Copenhagen,8225,4,13,6,11,59,47,12,45
AaB,8225,5,7,13,10,36,42,-6,34
AC Horsens,8225,6,7,13,10,35,50,-15,34
Sonderjyske,8225,7,8,6,10,28,29,-1,30
Lyngby,8225,8,4,9,11,28,44,-16,21
Randers FC,8225,9,5,6,13,23,41,-18,21
AGF Aarhus,8225,10,5,6,11,18,36,-18,21
Silkeborg IF,8225,11,5,3,14,25,46,-21,18
Brondby,8226,1,21,6,3,68,29,39,69
FC Midtjylla,8226,2,19,5,6,65,41,24,62
Copenhagen,8226,3,15,5,10,64,43,21,50
FC Nords,8226,4,13,7,10,72,58,14,46
AaB,8226,5,8,13,9,37,39,-2,37
Sonderjyske,8226,6,8,6,10,28,29,-1,30
AC Horsens,8226,7,5,14,11,30,52,-22,29
Randers FC,8226,8,6,6,12,24,39,-15,24
Silkeborg IF,8226,9,5,4,13,27,46,-19,19
AGF Aarhus,8226,10,4,7,11,18,38,-20,19
Lyngby,8226,11,3,9,12,26,45,-19,18
FC Midtjylla,8227,1,21,4,5,67,38,29,67
Brondby,8227,2,20,6,4,69,33,36,66
FC Nords,8227,3,14,8,8,78,55,23,50
Copenhagen,8227,4,14,6,10,60,46,14,48
AaB,8227,5,6,14,10,37,45,-8,32
Sonderjyske,8227,6,8,6,10,28,29,-1,30
AC Horsens,8227,7,5,14,11,35,55,-20,29
Lyngby,8227,8,4,9,11,28,44,-16,21
Silkeborg IF,8227,9,6,3,13,26,44,-18,21
Randers FC,8227,10,5,6,13,23,41,-18,21
AGF Aarhus,8227,11,4,6,12,16,37,-21,18
Brondby,8228,1,21,5,4,73,32,41,68
FC Midtjylla,8228,2,19,6,5,62,38,24,63
FC Nords,8228,3,14,8,8,73,49,24,50
Copenhagen,8228,4,14,5,11,60,49,11,47
AaB,8228,5,8,11,11,41,49,-8,35
AC Horsens,8228,6,6,13,11,33,51,-18,31
Sonderjyske,8228,7,8,6,10,28,29,-1,30
Randers FC,8228,8,5,7,12,26,42,-16,22
AGF Aarhus,8228,9,5,6,11,18,37,-19,21
Lyngby,8228,10,3,10,11,29,47,-18,19
Silkeborg IF,8228,11,5,3,14,26,46,-20,18
Brondby,8229,1,22,5,3,76,29,47,71
FC Midtjylla,8229,2,19,5,6,64,42,22,62
FC Nords,8229,3,15,8,7,73,48,25,53
Copenhagen,8229,4,14,5,11,58,47,11,47
AaB,8229,5,7,12,11,38,43,-5,33
Sonderjyske,8229,6,8,6,10,28,29,-1,30
AC Horsens,8229,7,5,13,12,33,59,-26,28
Randers FC,8229,8,5,7,12,23,39,-16,22
Silkeborg IF,8229,9,6,3,13,27,44,-17,21
Lyngby,8229,10,3,10,11,26,44,-18,19
AGF Aarhus,8229,11,4,6,12,16,38,-22,18
Brondby,8230,1,20,7,3,71,31,40,67
FC Midtjylla,8230,2,17,6,7,60,42,18,57
FC Nords,8230,3,14,7,9,73,52,21,49
Copenhagen,8230,4,13,5,12,55,48,7,44
AaB,8230,5,10,12,8,43,38,5,42
AC Horsens,8230,6,7,13,10,37,54,-17,34
Sonderjyske,8230,7,8,6,10,28,29,-1,30
Randers FC,8230,8,6,6,12,25,40,-15,24
Silkeborg IF,8230,9,5,4,13,26,45,-19,19
AGF Aarhus,8230,10,4,7,11,17,37,-20,19
Lyngby,8230,11,3,9,12,27,46,-19,18
Brondby,8231,1,20,6,4,71,34,37,66
FC Midtjylla,8231,2,19,5,6,64,38,26,62
FC Nords,8231,3,14,8,8,74,50,24,50
Copenhagen,8231,4,13,6,11,58,48,10,45
AC Horsens,8231,5,9,12,9,40,51,-11,39
AaB,8231,6,6,13,11,37,49,-12,31
Sonderjyske,8231,7,8,6,10,28,29,-1,30
Lyngby,8231,8,4,9,11,32,45,-13,21
AGF Aarhus,8231,9,5,6,11,20,36,-16,21
Randers FC,8231,10,5,6,13,24,45,-21,21
Silkeborg IF,8231,11,5,3,14,25,48,-23,18
Brondby,8232,1,21,5,4,73,37,36,68
FC Midtjylla,8232,2,19,5,6,66,42,24,62
FC Nords,8232,3,14,8,8,76,55,21,50
Copenhagen,8232,4,15,5,10,58,40,18,50
AC Horsens,8232,5,7,14,9,37,51,-14,35
Sonderjyske,8232,6,8,6,10,28,29,-1,30
AaB,8232,7,6,11,13,32,43,-11,29
Lyngby,8232,8,4,9,11,30,44,-14,21
Randers FC,8232,9,5,6,13,23,43,-20,21
Silkeborg IF,8232,10,5,4,13,25,44,-19,19
AGF Aarhus,8232,11,4,7,11,16,36,-20,19
Brondby,8233,1,20,7,3,70,35,35,67
FC Midtjylla,8233,2,20,5,5,63,35,28,65
FC Nords,8233,3,13,7,10,71,53,18,46
Copenhagen,8233,4,14,4,12,59,48,11,46
AaB,8233,5,8,13,9,38,41,-3,37
AC Horsens,8233,6,7,12,11,36,51,-15,33
Sonderjyske,8233,7,8,6,10,28,29,-1,30
Randers FC,8233,8,5,7,12,25,41,-16,22
Silkeborg IF,8233,9,6,3,13,28,45,-17,21
Lyngby,8233,10,3,10,11,28,46,-18,19
AGF Aarhus,8233,11,4,6,12,17,39,-22,18
Brondby,8234,1,20,7,3,71,36,35,67
FC Midtjylla,8234,2,18,7,5,63,39,24,61
Copenhagen,8234,3,15,6,9,60,43,17,51
FC Nords,8234,4,12,7,11,69,56,13,43
AaB,8234,5,7,14,9,40,43,-3,35
AC Horsens,8234,6,7,13,10,38,50,-12,34
Sonderjyske,8234,7,8,6,10,28,29,-1,30
Lyngby,8234,8,4,9,11,27,44,-17,21
Randers FC,8234,9,5,6,13,23,40,-17,21
AGF Aarhus,8234,10,5,6,11,18,37,-19,21
Silkeborg IF,8234,11,5,3,14,26,46,-20,18
Brondby,8235,1,21,7,2,72,32,40,70
FC Midtjylla,8235,2,21,5,4,70,35,35,68
FC Nords,8235,3,14,6,10,72,56,16,48
Copenhagen,8235,4,12,6,12,54,45,9,42
AaB,8235,5,7,12,11,35,45,-10,33
AC Horsens,8235,6,6,14,10,34,50,-16,32
Sonderjyske,8235,7,8,6,10,28,29,-1,30
Randers FC,8235,8,6,6,12,26,39,-13,24
AGF Aarhus,8235,9,5,6,11,19,36,-17,21
Lyngby,8235,10,3,9,12,26,47,-21,18
Silkeborg IF,8235,11,5,3,14,25,47,-22,18
Brondby,8236,1,23,5,2,76,28,48,74
FC Midtjylla,8236,2,18,6,6,66,41,25,60
Copenhagen,8236,3,14,6,10,56,42,14,48
FC Nords,8236,4,13,8,9,68,50,18,47
AaB,8236,5,7,13,10,34,47,-13,34
Sonderjyske,8236,6,8,6,10,28,29,-1,30
AC Horsens,8236,7,6,12,12,36,54,-18,30
Randers FC,8236,8,6,6,12,26,40,-14,24
Silkeborg IF,8236,9,6,3,13,29,44,-15,21
Lyngby,8236,10,3,9,12,27,47,-20,18
AGF Aarhus,8236,11,4,6,12,16,40,-24,18
Brondby,8237,1,22,6,2,75,29,46,72
FC Midtjylla,8237,2,19,5,6,61,38,23,62
FC Nords,8237,3,14,6,10,75,52,23,48
Copenhagen,8237,4,14,4,12,56,47,9,46
AaB,8237,5,8,12,10,37,43,-6,36
AC Horsens,8237,6,6,13,11,34,55,-21,31
Sonderjyske,8237,7,8,6,10,28,29,-1,30
Randers FC,8237,8,5,7,12,24,40,-16,22
Silkeborg IF,8237,9,6,3,13,27,44,-17,21
Lyngby,8237,10,3,10,11,27,45,-18,19
AGF Aarhus,8237,11,4,6,12,16,38,-22,18
Brondby,8238,1,20,7,3,66,32,34,67
FC Midtjylla,8238,2,21,4,5,63,35,28,67
Copenhagen,8238,3,14,5,11,60,47,13,47
FC Nords,8238,4,12,7,11,71,55,16,43
AaB,8238,5,8,12,10,37,39,-2,36
AC Horsens,8238,6,6,15,9,32,47,-15,33
Sonderjyske,8238,7,8,6,10,28,29,-1,30
Randers FC,8238,8,5,7,12,23,39,-16,22
Silkeborg IF,8238,9,6,3,13,28,44,-16,21
Lyngby,8238,10,3,10,11,26,44,-18,19
AGF Aarhus,8238,11,4,6,12,16,39,-23,18
Brondby,8239,1,22,5,3,74,30,44,71
FC Midtjylla,8239,2,20,4,6,60,37,23,64
FC Nords,8239,3,15,6,9,69,49,20,51
Copenhagen,8239,4,15,4,11,56,41,15,49
AaB,8239,5,7,11,12,33,43,-10,32
Sonderjyske,8239,6,8,6,10,28,29,-1,30
AC Horsens,8239,7,6,12,12,32,50,-18,30
Lyngby,8239,8,4,9,11,30,45,-15,21
Silkeborg IF,8239,9,6,3,13,28,46,-18,21
Randers FC,8239,10,5,6,13,24,43,-19,21
AGF Aarhus,8239,11,4,6,12,18,39,-21,18
Brondby,8240,1,21,5,4,71,32,39,68
FC Midtjylla,8240,2,20,4,6,66,42,24,64
Copenhagen,8240,3,16,4,10,61,46,15,52
FC Nords,8240,4,14,6,10,74,54,20,48
AaB,8240,5,9,11,10,38,40,-2,38
Sonderjyske,8240,6,8,6,10,28,29,-1,30
AC Horsens,8240,7,5,12,13,33,55,-22,27
Lyngby,8240,8,4,9,11,29,44,-15,21
Randers FC,8240,9,5,6,13,23,42,-19,21
Silkeborg IF,8240,10,5,4,13,26,45,-19,19
AGF Aarhus,8240,11,4,7,11,17,37,-20,19
Brondby,8241,1,21,6,3,68,32,36,69
FC Midtjylla,8241,2,19,6,5,63,35,28,63
FC Nords,8241,3,14,7,9,76,53,23,49
Copenhagen,8241,4,14,5,11,57,45,12,47
AC Horsens,8241,5,8,12,10,36,51,-15,36
Sonderjyske,8241,6,8,6,10,28,29,-1,30
AaB,8241,7,6,12,12,35,45,-10,30
Lyngby,8241,8,4,9,11,30,44,-14,21
Randers FC,8241,9,5,6,13,23,43,-20,21
Silkeborg IF,8241,10,5,4,13,25,44,-19,19
AGF Aarhus,8241,11,4,7,11,16,36,-20,19
Brondby,8242,1,18,8,4,66,34,32,62
FC Midtjylla,8242,2,18,7,5,64,40,24,61
FC Nords,8242,3,16,7,7,76,48,28,55
Copenhagen,8242,4,15,5,10,59,43,16,50
AC Horsens,8242,5,6,14,10,37,54,-17,32
AaB,8242,6,6,13,11,32,41,-9,31
Sonderjyske,8242,7,8,6,10,28,29,-1,30
Randers FC,8242,8,6,6,12,25,40,-15,24
Silkeborg IF,8242,9,5,4,13,26,45,-19,19
AGF Aarhus,8242,10,4,7,11,17,37,-20,19
Lyngby,8242,11,3,9,12,27,46,-19,18
Brondby,8243,1,20,5,5,68,33,35,65
FC Midtjylla,8243,2,20,4,6,70,41,29,64
Copenhagen,8243,3,16,4,10,56,42,14,52
FC Nords,8243,4,15,6,9,74,48,26,51
AC Horsens,8243,5,7,12,11,36,54,-18,33
AaB,8243,6,7,11,12,33,45,-12,32
Sonderjyske,8243,7,8,6,10,28,29,-1,30
Randers FC,8243,8,6,6,12,25,39,-14,24
Silkeborg IF,8243,9,6,3,13,29,44,-15,21
Lyngby,8243,10,3,9,12,26,46,-20,18
AGF Aarhus,8243,11,4,6,12,16,40,-24,18
Brondby,8244,1,18,8,4,68,37,31,62
FC Midtjylla,8244,2,18,7,5,62,38,24,61
FC Nords,8244,3,17,6,7,74,45,29,57
Copenhagen,8244,4,13,6,11,54,43,11,45
AaB,8244,5,8,12,10,35,38,-3,36
AC Horsens,8244,6,6,13,11,34,52,-18,31
Sonderjyske,8244,7,8,6,10,28,29,-1,30
Lyngby,8244,8,4,9,11,27,44,-17,21
Randers FC,8244,9,5,6,13,23,40,-17,21
AGF Aarhus,8244,10,5,6,11,18,36,-18,21
Silkeborg IF,8244,11,5,3,14,25,46,-21,18
Brondby,8245,1,20,7,3,69,30,39,67
FC Midtjylla,8245,2,19,6,5,64,37,27,63
FC Nords,8245,3,14,9,7,76,50,26,51
Copenhagen,8245,4,14,4,12,58,46,12,46
AaB,8245,5,9,12,9,40,44,-4,39
Sonderjyske,8245,6,8,6,10,28,29,-1,30
AC Horsens,8245,7,5,12,13,33,59,-26,27
Randers FC,8245,8,6,6,12,25,40,-15,24
Silkeborg IF,8245,9,6,3,13,28,46,-18,21
Lyngby,8245,10,3,9,12,27,46,-19,18
AGF Aarhus,8245,11,4,6,12,18,39,-21,18
Brondby,8246,1,21,6,3,72,32,40,69
FC Midtjylla,8246,2,17,6,7,62,44,18,57
Copenhagen,8246,3,17,4,9,64,39,25,55
FC Nords,8246,4,14,6,10,70,54,16,48
AC Horsens,8246,5,6,15,9,35,52,-17,33
AaB,8246,6,6,13,11,33,41,-8,31
Sonderjyske,8246,7,8,6,10,28,29,-1,30
Randers FC,8246,8,5,7,12,23,39,-16,22
AGF Aarhus,8246,9,5,6,11,18,37,-19,21
Lyngby,8246,10,3,10,11,26,44,-18,19
Silkeborg IF,8246,11,5,3,14,26,46,-20,18
Brondby,8247,1,20,8,2,66,28,38,68
FC Midtjylla,8247,2,19,7,4,64,38,26,64
FC Nords,8247,3,12,9,9,69,50,19,45
Copenhagen,8247,4,13,6,11,59,47,12,45
AaB,8247,5,8,12,10,38,42,-4,36
AC Horsens,8247,6,5,16,9,32,49,-17,31
Sonderjyske,8247,7,8,6,10,28,29,-1,30
Randers FC,8247,8,5,7,12,24,40,-16,22
AGF Aarhus,8247,9,5,6,11,18,36,-18,21
Lyngby,8247,10,3,10,11,27,45,-18,19
Silkeborg IF,8247,11,5,3,14,25,46,-21,18
Brondby,8248,1,22,6,2,73,31,42,72
FC Midtjylla,8248,2,20,5,5,66,38,28,65
FC Nords,8248,3,13,8,9,76,56,20,47
Copenhagen,8248,4,14,4,12,56,47,9,46
AaB,8248,5,7,12,11,38,44,-6,33
AC Horsens,8248,6,6,13,11,34,53,-19,31
Sonderjyske,8248,7,8,6,10,28,29,-1,30
Randers FC,8248,8,5,7,12,25,41,-16,22
AGF Aarhus,8248,9,5,6,11,17,36,-19,21
Lyngby,8248,10,3,10,11,28,46,-18,19
Silkeborg IF,8248,11,5,3,14,25,45,-20,18
FC Midtjylla,8249,1,21,5,4,76,40,36,68
Brondby,8249,2,19,6,5,68,34,34,63
FC Nords,8249,3,15,6,9,79,55,24,51
Copenhagen,8249,4,15,4,11,65,53,12,49
AaB,8249,5,7,13,10,39,47,-8,34
Sonderjyske,8249,6,8,6,10,28,29,-1,30
AC Horsens,8249,7,5,14,11,36,60,-24,29
Randers FC,8249,8,5,7,12,24,40,-16,22
AGF Aarhus,8249,9,5,6,11,18,36,-18,21
Lyngby,8249,10,3,10,11,27,45,-18,19
Silkeborg IF,8249,11,5,3,14,25,46,-21,18
Brondby,8250,1,20,6,4,75,35,40,66
FC Midtjylla,8250,2,20,6,4,70,40,30,66
FC Nords,8250,3,13,7,10,72,55,17,46
Copenhagen,8250,4,12,8,10,58,49,9,44
AaB,8250,5,8,12,10,36,43,-7,36
AC Horsens,8250,6,7,13,10,37,52,-15,34
Sonderjyske,8250,7,8,6,10,28,29,-1,30
Lyngby,8250,8,4,9,11,29,46,-17,21
Silkeborg IF,8250,9,6,3,13,28,45,-17,21
Randers FC,8250,10,5,6,13,25,42,-17,21
AGF Aarhus,8250,11,4,6,12,17,39,-22,18
Brondby,8251,1,22,6,2,74,34,40,72
FC Midtjylla,8251,2,19,5,6,70,44,26,62
FC Nords,8251,3,14,8,8,75,51,24,50
Copenhagen,8251,4,14,5,11,57,47,10,47
AaB,8251,5,8,11,11,38,43,-5,35
Sonderjyske,8251,6,8,6,10,28,29,-1,30
AC Horsens,8251,7,5,13,12,29,50,-21,28
Lyngby,8251,8,4,9,11,29,45,-16,21
Silkeborg IF,8251,9,6,3,13,27,44,-17,21
Randers FC,8251,10,5,6,13,24,42,-18,21
AGF Aarhus,8251,11,4,6,12,16,38,-22,18
Brondby,8252,1,21,7,2,77,35,42,70
FC Midtjylla,8252,2,20,5,5,70,40,30,65
FC Nords,8252,3,14,8,8,76,55,21,50
Copenhagen,8252,4,14,4,12,60,48,12,46
AC Horsens,8252,5,6,14,10,35,55,-20,32
Sonderjyske,8252,6,8,6,10,28,29,-1,30
AaB,8252,7,6,12,12,35,46,-11,30
Randers FC,8252,8,6,6,12,25,40,-15,24
Silkeborg IF,8252,9,5,4,13,27,46,-19,19
AGF Aarhus,8252,10,4,7,11,18,38,-20,19
Lyngby,8252,11,3,9,12,27,46,-19,18
Brondby,8253,1,19,8,3,67,29,38,65
FC Midtjylla,8253,2,18,6,6,64,40,24,60
FC Nords,8253,3,17,6,7,79,50,29,57
Copenhagen,8253,4,13,5,12,57,46,11,44
AaB,8253,5,8,12,10,38,45,-7,36
AC Horsens,8253,6,6,13,11,34,55,-21,31
Sonderjyske,8253,7,8,6,10,28,29,-1,30
Randers FC,8253,8,5,7,12,24,40,-16,22
Lyngby,8253,9,3,10,11,27,45,-18,19
Silkeborg IF,8253,10,5,4,13,26,45,-19,19
AGF Aarhus,8253,11,4,7,11,17,37,-20,19
Brondby,8254,1,20,6,4,72,37,35,66
FC Midtjylla,8254,2,19,6,5,67,39,28,63
FC Nords,8254,3,14,7,9,78,56,22,49
Copenhagen,8254,4,15,4,11,61,46,15,49
AaB,8254,5,8,12,10,40,46,-6,36
AC Horsens,8254,6,6,13,11,34,54,-20,31
Sonderjyske,8254,7,8,6,10,28,29,-1,30
Randers FC,8254,8,5,7,12,24,40,-16,22
Silkeborg IF,8254,9,6,3,13,28,45,-17,21
Lyngby,8254,10,3,10,11,27,45,-18,19
AGF Aarhus,8254,11,4,6,12,17,39,-22,18
Brondby,8255,1,22,6,2,79,31,48,72
FC Midtjylla,8255,2,18,7,5,66,44,22,61
FC Nords,8255,3,15,7,8,74,53,21,52
Copenhagen,8255,4,14,4,12,57,45,12,46
AaB,8255,5,8,11,11,36,43,-7,35
Sonderjyske,8255,6,8,6,10,28,29,-1,30
AC Horsens,8255,7,5,13,12,33,55,-22,28
Randers FC,8255,8,5,7,12,24,40,-16,22
Silkeborg IF,8255,9,6,3,13,27,44,-17,21
Lyngby,8255,10,3,10,11,27,45,-18,19
AGF Aarhus,8255,11,4,6,12,16,38,-22,18
Brondby,8256,1,23,5,2,75,30,45,74
FC Midtjylla,8256,2,19,5,6,65,38,27,62
FC Nords,8256,3,14,6,10,71,54,17,48
Copenhagen,8256,4,14,5,11,60,46,14,47
AaB,8256,5,9,11,10,38,41,-3,38
Sonderjyske,8256,6,8,6,10,28,29,-1,30
AC Horsens,8256,7,5,12,13,30,56,-26,27
Randers FC,8256,8,6,6,12,25,40,-15,24
Silkeborg IF,8256,9,6,3,13,28,45,-17,21
Lyngby,8256,10,3,9,12,27,46,-19,18
AGF Aarhus,8256,11,4,6,12,17,39,-22,18
Brondby,8257,1,21,7,2,69,31,38,70
FC Midtjylla,8257,2,19,6,5,68,39,29,63
FC Nords,8257,3,14,8,8,75,52,23,50
Copenhagen,8257,4,13,5,12,60,52,8,44
AaB,8257,5,7,13,10,38,46,-8,34
AC Horsens,8257,6,6,13,11,40,56,-16,31
Sonderjyske,8257,7,8,6,10,28,29,-1,30
Lyngby,8257,8,4,9,11,27,44,-17,21
Randers FC,8257,9,5,6,13,23,40,-17,21
Silkeborg IF,8257,10,5,4,13,25,44,-19,19
AGF Aarhus,8257,11,4,7,11,16,36,-20,19
FC Midtjylla,8258,1,21,5,4,68,36,32,68
Brondby,8258,2,20,7,3,67,31,36,67
FC Nords,8258,3,13,9,8,71,49,22,48
Copenhagen,8258,4,13,5,12,56,45,11,44
AaB,8258,5,7,12,11,35,45,-10,33
AC Horsens,8258,6,6,14,10,34,51,-17,32
Sonderjyske,8258,7,8,6,10,28,29,-1,30
Randers FC,8258,8,5,7,12,24,40,-16,22
Silkeborg IF,8258,9,6,3,13,28,45,-17,21
Lyngby,8258,10,3,10,11,27,45,-18,19
AGF Aarhus,8258,11,4,6,12,17,39,-22,18
Brondby,8259,1,21,7,2,72,32,40,70
FC Midtjylla,8259,2,20,4,6,67,41,26,64
Copenhagen,8259,3,15,5,10,57,42,15,50
FC Nords,8259,4,14,6,10,73,51,22,48
AaB,8259,5,8,11,11,37,42,-5,35
Sonderjyske,8259,6,8,6,10,28,29,-1,30
AC Horsens,8259,7,5,13,12,31,55,-24,28
Silkeborg IF,8259,8,6,3,13,29,44,-15,21
Lyngby,8259,9,4,9,11,27,44,-17,21
Randers FC,8259,10,5,6,13,23,40,-17,21
AGF Aarhus,8259,11,4,6,12,16,40,-24,18
Brondby,8260,1,22,6,2,73,29,44,72
FC Midtjylla,8260,2,20,4,6,67,37,30,64
Copenhagen,8260,3,15,5,10,63,44,19,50
FC Nords,8260,4,12,8,10,68,52,16,44
AC Horsens,8260,5,7,12,11,35,58,-23,33
AaB,8260,6,7,11,12,33,45,-12,32
Sonderjyske,8260,7,8,6,10,28,29,-1,30
Randers FC,8260,8,6,6,12,26,39,-13,24
Silkeborg IF,8260,9,6,3,13,27,45,-18,21
Lyngby,8260,10,3,9,12,26,47,-21,18
AGF Aarhus,8260,11,4,6,12,17,38,-21,18
Brondby,8261,1,21,7,2,76,35,41,70
FC Midtjylla,8261,2,20,5,5,64,39,25,65
Copenhagen,8261,3,14,6,10,61,45,16,48
FC Nords,8261,4,13,8,9,76,54,22,47
AaB,8261,5,7,12,11,35,42,-7,33
Sonderjyske,8261,6,8,6,10,28,29,-1,30
AC Horsens,8261,7,6,12,12,33,56,-23,30
Randers FC,8261,8,5,7,12,24,40,-16,22
AGF Aarhus,8261,9,5,6,11,18,37,-19,21
Lyngby,8261,10,3,10,11,27,45,-18,19
Silkeborg IF,8261,11,5,3,14,26,46,-20,18
Brondby,8262,1,23,5,2,74,32,42,74
FC Midtjylla,8262,2,20,4,6,68,43,25,64
FC Nords,8262,3,13,9,8,74,50,24,48
Copenhagen,8262,4,14,5,11,60,46,14,47
AC Horsens,8262,5,6,13,11,33,52,-19,31
Sonderjyske,8262,6,8,6,10,28,29,-1,30
AaB,8262,7,6,12,12,34,46,-12,30
Lyngby,8262,8,4,9,11,27,44,-17,21
Randers FC,8262,9,5,6,13,23,40,-17,21
AGF Aarhus,8262,10,5,6,11,17,36,-19,21
Silkeborg IF,8262,11,5,3,14,25,45,-20,18
Brondby,8263,1,22,5,3,79,35,44,71
FC Midtjylla,8263,2,19,5,6,70,47,23,62
FC Nords,8263,3,13,8,9,74,55,19,47
Copenhagen,8263,4,14,4,12,63,50,13,46
AaB,8263,5,8,11,11,39,50,-11,35
AC Horsens,8263,6,7,13,10,37,51,-14,34
Sonderjyske,8263,7,8,6,10,28,29,-1,30
Lyngby,8263,8,4,9,11,28,45,-17,21
Randers FC,8263,9,5,6,13,24,41,-17,21
Silkeborg IF,8263,10,5,4,13,26,45,-19,19
AGF Aarhus,8263,11,4,7,11,17,37,-20,19
Brondby,8264,1,20,8,2,70,31,39,68
FC Midtjylla,8264,2,19,6,5,67,41,26,63
FC Nords,8264,3,14,8,8,74,50,24,50
Copenhagen,8264,4,13,6,11,56,47,9,45
AaB,8264,5,8,14,8,39,40,-1,38
Sonderjyske,8264,6,8,6,10,28,29,-1,30
AC Horsens,8264,7,5,12,13,33,56,-23,27
Lyngby,8264,8,4,9,11,31,45,-14,21
Randers FC,8264,9,5,6,13,24,44,-20,21
Silkeborg IF,8264,10,5,4,13,26,45,-19,19
AGF Aarhus,8264,11,4,7,11,17,37,-20,19
Brondby,8265,1,22,6,2,72,33,39,72
FC Midtjylla,8265,2,19,5,6,68,46,22,62
FC Nords,8265,3,14,8,8,73,49,24,50
Copenhagen,8265,4,14,6,10,63,46,17,48
Sonderjyske,8265,5,8,6,10,28,29,-1,30
AaB,8265,6,6,12,12,36,46,-10,30
AC Horsens,8265,7,5,15,10,37,55,-18,30
Lyngby,8265,8,4,9,11,30,44,-14,21
AGF Aarhus,8265,9,5,6,11,18,37,-19,21
Randers FC,8265,10,5,6,13,23,43,-20,21
Silkeborg IF,8265,11,5,3,14,26,46,-20,18
Brondby,8266,1,21,7,2,72,32,40,70
FC Midtjylla,8266,2,19,4,7,64,47,17,61
FC Nords,8266,3,14,7,9,75,51,24,49
Copenhagen,8266,4,13,8,9,57,41,16,47
AaB,8266,5,8,12,10,41,45,-4,36
Sonderjyske,8266,6,8,6,10,28,29,-1,30
AC Horsens,8266,7,5,14,11,34,53,-19,29
Randers FC,8266,8,5,7,12,24,40,-16,22
Lyngby,8266,9,3,10,11,27,45,-18,19
Silkeborg IF,8266,10,5,4,13,29,48,-19,19
AGF Aarhus,8266,11,4,7,11,20,40,-20,19
Brondby,8267,1,22,6,2,76,32,44,72
FC Midtjylla,8267,2,20,4,6,66,38,28,64
Copenhagen,8267,3,14,5,11,60,46,14,47
FC Nords,8267,4,13,7,10,72,57,15,46
AaB,8267,5,7,12,11,37,47,-10,33
AC Horsens,8267,6,6,14,10,35,52,-17,32
Sonderjyske,8267,7,8,6,10,28,29,-1,30
Lyngby,8267,8,4,9,11,28,44,-16,21
Silkeborg IF,8267,9,6,3,13,26,44,-18,21
Randers FC,8267,10,5,6,13,23,41,-18,21
AGF Aarhus,8267,11,4,6,12,16,37,-21,18
Brondby,8268,1,19,6,5,66,34,32,63
FC Midtjylla,8268,2,19,6,5,64,36,28,63
Copenhagen,8268,3,16,4,10,58,40,18,52
FC Nords,8268,4,15,6,9,72,48,24,51
AaB,8268,5,7,13,10,35,42,-7,34
AC Horsens,8268,6,6,13,11,33,54,-21,31
Sonderjyske,8268,7,8,6,10,28,29,-1,30
Randers FC,8268,8,5,7,12,25,41,-16,22
Silkeborg IF,8268,9,6,3,13,28,45,-17,21
Lyngby,8268,10,3,10,11,28,46,-18,19
AGF Aarhus,8268,11,4,6,12,17,39,-22,18
FC Midtjylla,8269,1,21,4,5,67,36,31,67
Brondby,8269,2,20,6,4,74,32,42,66
FC Nords,8269,3,14,7,9,73,59,14,49
Copenhagen,8269,4,15,4,11,56,43,13,49
AaB,8269,5,8,12,10,40,45,-5,36
Sonderjyske,8269,6,8,6,10,28,29,-1,30
AC Horsens,8269,7,5,13,12,32,53,-21,28
Lyngby,8269,8,4,9,11,27,44,-17,21
Randers FC,8269,9,5,6,13,23,40,-17,21
Silkeborg IF,8269,10,6,3,13,27,45,-18,21
AGF Aarhus,8269,11,4,6,12,17,38,-21,18
Brondby,8270,1,21,6,3,73,34,39,69
FC Midtjylla,8270,2,18,7,5,68,40,28,61
FC Nords,8270,3,14,7,9,71,51,20,49
Copenhagen,8270,4,13,7,10,59,45,14,46
AaB,8270,5,9,13,8,39,39,0,40
Sonderjyske,8270,6,8,6,10,28,29,-1,30
AC Horsens,8270,7,5,12,13,34,61,-27,27
Randers FC,8270,8,6,6,12,26,41,-15,24
Silkeborg IF,8270,9,5,4,13,25,44,-19,19
AGF Aarhus,8270,10,4,7,11,16,36,-20,19
Lyngby,8270,11,3,9,12,28,47,-19,18
Brondby,8271,1,22,6,2,75,30,45,72
FC Midtjylla,8271,2,19,5,6,65,42,23,62
FC Nords,8271,3,14,7,9,72,53,19,49
Copenhagen,8271,4,12,6,12,52,45,7,42
AaB,8271,5,8,13,9,39,41,-2,37
AC Horsens,8271,6,6,13,11,34,52,-18,31
Sonderjyske,8271,7,8,6,10,28,29,-1,30
Randers FC,8271,8,6,6,12,24,39,-15,24
AGF Aarhus,8271,9,5,6,11,19,37,-18,21
Lyngby,8271,10,3,9,12,26,45,-19,18
Silkeborg IF,8271,11,5,3,14,26,47,-21,18
Brondby,8272,1,21,5,4,73,32,41,68
FC Midtjylla,8272,2,19,6,5,63,39,24,63
Copenhagen,8272,3,16,4,10,66,42,24,52
FC Nords,8272,4,14,8,8,70,48,22,50
AaB,8272,5,7,12,11,37,48,-11,33
Sonderjyske,8272,6,8,6,10,28,29,-1,30
AC Horsens,8272,7,5,13,12,31,57,-26,28
Randers FC,8272,8,6,6,12,26,41,-15,24
Silkeborg IF,8272,9,6,3,13,27,45,-18,21
Lyngby,8272,10,3,9,12,28,47,-19,18
AGF Aarhus,8272,11,4,6,12,17,38,-21,18
Brondby,8273,1,20,6,4,69,33,36,66
FC Midtjylla,8273,2,19,6,5,63,39,24,63
FC Nords,8273,3,13,8,9,71,52,19,47
Copenhagen,8273,4,12,5,13,52,44,8,41
AaB,8273,5,9,13,8,41,41,0,40
AC Horsens,8273,6,7,14,9,40,53,-13,35
Sonderjyske,8273,7,8,6,10,28,29,-1,30
Lyngby,8273,8,4,9,11,27,44,-17,21
Silkeborg IF,8273,8,6,3,13,27,44,-17,21
Randers FC,8273,10,5,6,13,23,40,-17,21
AGF Aarhus,8273,11,4,6,12,16,38,-22,18
FC Midtjylla,8274,1,21,4,5,65,37,28,67
Brondby,8274,2,20,6,4,75,32,43,66
Copenhagen,8274,3,16,5,9,62,42,20,53
FC Nords,8274,4,12,9,9,70,53,17,45
AC Horsens,8274,5,7,12,11,37,58,-21,33
Sonderjyske,8274,6,8,6,10,28,29,-1,30
AaB,8274,7,6,12,12,36,49,-13,30
Lyngby,8274,8,4,9,11,28,45,-17,21
Randers FC,8274,9,5,6,13,24,41,-17,21
AGF Aarhus,8274,10,5,6,11,17,36,-19,21
Silkeborg IF,8274,11,5,3,14,25,45,-20,18
Brondby,8275,1,20,6,4,68,31,37,66
FC Midtjylla,8275,2,18,4,8,61,42,19,58
FC Nords,8275,3,16,6,8,74,50,24,54
Copenhagen,8275,4,16,4,10,62,45,17,52
AaB,8275,5,9,11,10,38,41,-3,38
Sonderjyske,8275,6,8,6,10,28,29,-1,30
AC Horsens,8275,7,5,13,12,34,54,-20,28
Lyngby,8275,8,4,9,11,28,44,-16,21
Silkeborg IF,8275,9,6,3,13,26,44,-18,21
Randers FC,8275,10,5,6,13,23,41,-18,21
AGF Aarhus,8275,11,4,6,12,16,37,-21,18
Brondby,8276,1,21,7,2,78,37,41,70
FC Midtjylla,8276,2,18,5,7,62,41,21,59
FC Nords,8276,3,14,6,10,76,55,21,48
Copenhagen,8276,4,13,4,13,55,47,8,43
AaB,8276,5,8,13,9,39,41,-2,37
AC Horsens,8276,6,8,13,9,39,54,-15,37
Sonderjyske,8276,7,8,6,10,28,29,-1,30
Lyngby,8276,8,4,9,11,27,44,-17,21
Randers FC,8276,9,5,6,13,23,40,-17,21
Silkeborg IF,8276,10,6,3,13,27,45,-18,21
AGF Aarhus,8276,11,4,6,12,17,38,-21,18
Brondby,8277,1,20,7,3,70,31,39,67
FC Midtjylla,8277,2,19,7,4,65,38,27,64
FC Nords,8277,3,13,8,9,69,52,17,47
Copenhagen,8277,4,12,8,10,57,46,11,44
AaB,8277,5,7,14,9,36,42,-6,35
AC Horsens,8277,6,6,14,10,39,53,-14,32
Sonderjyske,8277,7,8,6,10,28,29,-1,30
Lyngby,8277,8,4,9,11,31,44,-13,21
Silkeborg IF,8277,9,6,3,13,26,44,-18,21
Randers FC,8277,10,5,6,13,23,44,-21,21
AGF Aarhus,8277,11,4,6,12,16,37,-21,18
Brondby,8278,1,21,6,3,72,31,41,69
FC Midtjylla,8278,2,19,5,6,67,40,27,62
Copenhagen,8278,3,14,7,9,56,40,16,49
FC Nords,8278,4,13,6,11,69,54,15,45
AaB,8278,5,8,11,11,39,46,-7,35
AC Horsens,8278,6,7,13,10,34,52,-18,34
Sonderjyske,8278,7,8,6,10,28,29,-1,30
Randers FC,8278,8,5,7,12,25,41,-16,22
AGF Aarhus,8278,9,5,6,11,18,37,-19,21
Lyngby,8278,10,3,10,11,28,46,-18,19
Silkeborg IF,8278,11,5,3,14,26,46,-20,18
Brondby,8279,1,21,6,3,74,33,41,69
FC Midtjylla,8279,2,20,5,5,66,39,27,65
FC Nords,8279,3,15,8,7,73,47,26,53
Copenhagen,8279,4,13,5,12,55,46,9,44
AaB,8279,5,7,12,11,36,43,-7,33
Sonderjyske,8279,6,8,6,10,28,29,-1,30
AC Horsens,8279,7,6,12,12,34,56,-22,30
Lyngby,8279,8,4,9,11,27,44,-17,21
Randers FC,8279,9,5,6,13,23,40,-17,21
Silkeborg IF,8279,10,6,3,13,26,44,-18,21
AGF Aarhus,8279,11,4,6,12,16,37,-21,18
Brondby,8280,1,23,5,2,78,30,48,74
FC Midtjylla,8280,2,18,4,8,65,42,23,58
FC Nords,8280,3,14,7,9,74,53,21,49
Copenhagen,8280,4,13,5,12,56,46,10,44
AC Horsens,8280,5,8,12,10,38,56,-18,36
AaB,8280,6,8,11,11,39,49,-10,35
Sonderjyske,8280,7,8,6,10,28,29,-1,30
Randers FC,8280,8,5,7,12,23,39,-16,22
Silkeborg IF,8280,9,6,3,13,27,45,-18,21
Lyngby,8280,10,3,10,11,26,44,-18,19
AGF Aarhus,8280,11,4,6,12,17,38,-21,18
Brondby,8281,1,21,5,4,67,31,36,68
FC Midtjylla,8281,2,18,5,7,60,38,22,59
FC Nords,8281,3,16,6,8,74,49,25,54
Copenhagen,8281,4,13,4,13,53,43,10,43
AaB,8281,5,8,12,10,36,41,-5,36
AC Horsens,8281,6,8,12,10,33,47,-14,36
Sonderjyske,8281,7,8,6,10,28,29,-1,30
Randers FC,8281,8,5,7,12,23,39,-16,22
Lyngby,8281,9,3,10,11,26,44,-18,19
Silkeborg IF,8281,10,5,4,13,26,45,-19,19
AGF Aarhus,8281,11,4,7,11,17,37,-20,19
Brondby,8282,1,21,7,2,71,28,43,70
FC Midtjylla,8282,2,21,4,5,62,35,27,67
FC Nords,8282,3,14,7,9,73,49,24,49
Copenhagen,8282,4,14,6,10,59,44,15,48
Sonderjyske,8282,5,8,6,10,28,29,-1,30
AaB,8282,6,6,12,12,33,49,-16,30
AC Horsens,8282,7,5,14,11,32,51,-19,29
Randers FC,8282,8,6,6,12,25,39,-14,24
Silkeborg IF,8282,9,6,3,13,28,44,-16,21
Lyngby,8282,10,3,9,12,26,46,-20,18
AGF Aarhus,8282,11,4,6,12,16,39,-23,18
Brondby,8283,1,21,6,3,70,34,36,69
FC Midtjylla,8283,2,19,5,6,67,43,24,62
FC Nords,8283,3,14,8,8,71,50,21,50
Copenhagen,8283,4,14,5,11,61,44,17,47
AaB,8283,5,7,12,11,36,42,-6,33
AC Horsens,8283,6,5,16,9,37,55,-18,31
Sonderjyske,8283,7,8,6,10,28,29,-1,30
Lyngby,8283,8,4,9,11,28,45,-17,21
Randers FC,8283,9,5,6,13,24,41,-17,21
Silkeborg IF,8283,10,6,3,13,27,45,-18,21
AGF Aarhus,8283,11,4,6,12,17,38,-21,18
Brondby,8284,1,21,7,2,71,30,41,70
FC Midtjylla,8284,2,19,6,5,63,38,25,63
FC Nords,8284,3,15,7,8,78,52,26,52
Copenhagen,8284,4,13,5,12,56,48,8,44
AC Horsens,8284,5,6,15,9,36,52,-16,33
Sonderjyske,8284,6,8,6,10,28,29,-1,30
AaB,8284,7,6,12,12,35,45,-10,30
Randers FC,8284,8,6,6,12,25,39,-14,24
Silkeborg IF,8284,9,6,3,13,27,44,-17,21
Lyngby,8284,10,3,9,12,26,46,-20,18
AGF Aarhus,8284,11,4,6,12,16,38,-22,18
Brondby,8285,1,21,5,4,71,31,40,68
FC Midtjylla,8285,2,20,5,5,65,37,28,65
FC Nords,8285,3,14,8,8,71,46,25,50
Copenhagen,8285,4,12,5,13,55,48,7,41
AC Horsens,8285,5,8,12,10,35,53,-18,36
AaB,8285,6,8,11,11,34,42,-8,35
Sonderjyske,8285,7,8,6,10,28,29,-1,30
Randers FC,8285,8,6,6,12,26,40,-14,24
Silkeborg IF,8285,9,6,3,13,28,46,-18,21
Lyngby,8285,10,3,9,12,27,47,-20,18
AGF Aarhus,8285,11,4,6,12,18,39,-21,18
Brondby,8286,1,22,5,3,72,31,41,71
FC Midtjylla,8286,2,17,5,8,63,43,20,56
FC Nords,8286,3,16,6,8,76,51,25,54
Copenhagen,8286,4,13,5,12,55,52,3,44
AC Horsens,8286,5,7,14,9,41,51,-10,35
AaB,8286,6,7,13,10,37,42,-5,34
Sonderjyske,8286,7,8,6,10,28,29,-1,30
Randers FC,8286,8,6,6,12,24,39,-15,24
Silkeborg IF,8286,9,5,4,13,25,44,-19,19
AGF Aarhus,8286,10,4,7,11,16,36,-20,19
Lyngby,8286,11,3,9,12,26,45,-19,18
Brondby,8287,1,19,8,3,68,29,39,65
FC Midtjylla,8287,2,19,5,6,59,35,24,62
Copenhagen,8287,3,15,6,9,57,40,17,51
FC Nords,8287,4,13,6,11,70,57,13,45
AaB,8287,5,7,14,9,38,41,-3,35
AC Horsens,8287,6,7,13,10,36,52,-16,34
Sonderjyske,8287,7,8,6,10,28,29,-1,30
Randers FC,8287,8,6,6,12,25,39,-14,24
AGF Aarhus,8287,9,5,6,11,19,37,-18,21
Lyngby,8287,10,3,9,12,26,46,-20,18
Silkeborg IF,8287,11,5,3,14,26,47,-21,18
Brondby,8288,1,21,7,2,75,31,44,70
FC Midtjylla,8288,2,19,6,5,65,38,27,63
FC Nords,8288,3,14,7,9,77,56,21,49
Copenhagen,8288,4,14,4,12,56,45,11,46
AaB,8288,5,7,13,10,39,47,-8,34
AC Horsens,8288,6,6,13,11,33,54,-21,31
Sonderjyske,8288,7,8,6,10,28,29,-1,30
Randers FC,8288,8,6,6,12,25,39,-14,24
Silkeborg IF,8288,9,6,3,13,30,44,-14,21
Lyngby,8288,10,3,9,12,26,46,-20,18
AGF Aarhus,8288,11,4,6,12,16,41,-25,18
Brondby,8289,1,21,5,4,68,33,35,68
FC Midtjylla,8289,2,18,4,8,66,44,22,58
Copenhagen,8289,3,17,4,9,66,41,25,55
FC Nords,8289,4,14,6,10,72,52,20,48
AaB,8289,5,8,12,10,39,44,-5,36
AC Horsens,8289,6,6,13,11,35,58,-23,31
Sonderjyske,8289,7,8,6,10,28,29,-1,30
Silkeborg IF,8289,8,6,3,13,29,44,-15,21
Lyngby,8289,9,4,9,11,27,44,-17,21
Randers FC,8289,10,5,6,13,23,40,-17,21
AGF Aarhus,8289,11,4,6,12,16,40,-24,18
Brondby,8290,1,21,6,3,70,33,37,69
FC Midtjylla,8290,2,19,5,6,61,38,23,62
Copenhagen,8290,3,14,6,10,57,41,16,48
FC Nords,8290,4,13,8,9,69,52,17,47
AaB,8290,5,8,12,10,39,40,-1,36
Sonderjyske,8290,6,8,6,10,28,29,-1,30
AC Horsens,8290,7,5,15,10,32,50,-18,30
Lyngby,8290,8,4,9,11,30,44,-14,21
AGF Aarhus,8290,9,5,6,11,17,36,-19,21
Randers FC,8290,10,5,6,13,23,43,-20,21
Silkeborg IF,8290,11,5,3,14,25,45,-20,18
Brondby,8291,1,22,5,3,74,32,42,71
FC Midtjylla,8291,2,19,6,5,65,40,25,63
Copenhagen,8291,3,16,4,10,58,43,15,52
FC Nords,8291,4,14,7,9,75,52,23,49
AaB,8291,5,6,13,11,34,45,-11,31
Sonderjyske,8291,6,8,6,10,28,29,-1,30
AC Horsens,8291,7,5,13,12,30,50,-20,28
Lyngby,8291,8,4,9,11,28,44,-16,21
Randers FC,8291,9,5,6,13,23,41,-18,21
AGF Aarhus,8291,10,5,6,11,17,36,-19,21
Silkeborg IF,8291,11,5,3,14,25,45,-20,18
Brondby,8292,1,21,6,3,71,34,37,69
FC Midtjylla,8292,2,20,5,5,68,41,27,65
Copenhagen,8292,3,14,5,11,58,46,12,47
FC Nords,8292,4,12,8,10,71,53,18,44
AaB,8292,5,7,14,9,38,41,-3,35
AC Horsens,8292,6,6,14,10,39,56,-17,32
Sonderjyske,8292,7,8,6,10,28,29,-1,30
Lyngby,8292,8,4,9,11,27,44,-17,21
Randers FC,8292,9,5,6,13,23,40,-17,21
AGF Aarhus,8292,10,5,6,11,21,39,-18,21
Silkeborg IF,8292,11,5,3,14,28,49,-21,18
Brondby,8293,1,20,7,3,69,32,37,67
FC Midtjylla,8293,2,21,4,5,64,36,28,67
FC Nords,8293,3,15,7,8,76,47,29,52
Copenhagen,8293,4,15,4,11,56,47,9,49
AaB,8293,5,7,11,12,36,42,-6,32
Sonderjyske,8293,6,8,6,10,28,29,-1,30
AC Horsens,8293,7,5,13,12,32,55,-23,28
Randers FC,8293,8,6,6,12,26,39,-13,24
AGF Aarhus,8293,9,5,6,11,19,37,-18,21
Lyngby,8293,10,3,9,12,26,47,-21,18
Silkeborg IF,8293,10,5,3,14,26,47,-21,18
Brondby,8294,1,22,5,3,71,32,39,71
FC Midtjylla,8294,2,19,6,5,62,40,22,63
FC Nords,8294,3,14,7,9,75,56,19,49
Copenhagen,8294,4,13,6,11,54,42,12,45
AC Horsens,8294,5,7,13,10,35,50,-15,34
AaB,8294,6,7,11,12,38,41,-3,32
Sonderjyske,8294,7,8,6,10,28,29,-1,30
Randers FC,8294,8,6,6,12,24,39,-15,24
Silkeborg IF,8294,9,6,3,13,27,44,-17,21
Lyngby,8294,10,3,9,12,26,45,-19,18
AGF Aarhus,8294,11,4,6,12,16,38,-22,18
Brondby,8295,1,20,6,4,72,37,35,66
FC Midtjylla,8295,2,18,7,5,65,43,22,61
FC Nords,8295,3,15,6,9,76,51,25,51
Copenhagen,8295,4,14,5,11,61,47,14,47
AaB,8295,5,8,13,9,37,42,-5,37
AC Horsens,8295,6,6,13,11,36,53,-17,31
Sonderjyske,8295,7,8,6,10,28,29,-1,30
Randers FC,8295,8,5,7,12,23,39,-16,22
Lyngby,8295,9,3,10,11,26,44,-18,19
Silkeborg IF,8295,10,5,4,13,25,44,-19,19
AGF Aarhus,8295,11,4,7,11,16,36,-20,19
Brondby,8296,1,21,5,4,73,31,42,68
FC Midtjylla,8296,2,19,5,6,62,39,23,62
FC Nords,8296,3,15,6,9,70,49,21,51
Copenhagen,8296,4,14,6,10,56,44,12,48
AaB,8296,5,7,12,11,35,45,-10,33
AC Horsens,8296,6,7,12,11,36,50,-14,33
Sonderjyske,8296,7,8,6,10,28,29,-1,30
Lyngby,8296,8,4,9,11,30,45,-15,21
Randers FC,8296,9,5,6,13,24,43,-19,21
AGF Aarhus,8296,10,5,6,11,18,37,-19,21
Silkeborg IF,8296,11,5,3,14,26,46,-20,18
Brondby,8297,1,20,8,2,72,29,43,68
FC Midtjylla,8297,2,19,5,6,63,40,23,62
FC Nords,8297,3,14,6,10,71,54,17,48
Copenhagen,8297,4,14,6,10,57,41,16,48
AaB,8297,5,9,11,10,39,43,-4,38
Sonderjyske,8297,6,8,6,10,28,29,-1,30
AC Horsens,8297,7,5,14,11,33,54,-21,29
Randers FC,8297,8,5,7,12,25,41,-16,22
Lyngby,8297,9,3,10,11,28,46,-18,19
Silkeborg IF,8297,10,5,4,13,28,47,-19,19
AGF Aarhus,8297,11,4,7,11,19,39,-20,19
Brondby,8298,1,22,5,3,75,36,39,71
FC Midtjylla,8298,2,20,4,6,70,44,26,64
FC Nords,8298,3,15,6,9,74,51,23,51
Copenhagen,8298,4,13,6,11,58,45,13,45
AaB,8298,5,7,12,11,35,43,-8,33
AC Horsens,8298,6,6,13,11,32,51,-19,31
Sonderjyske,8298,7,8,6,10,28,29,-1,30
Randers FC,8298,8,5,7,12,24,40,-16,22
Silkeborg IF,8298,9,6,3,13,27,45,-18,21
Lyngby,8298,10,3,10,11,27,45,-18,19
AGF Aarhus,8298,11,4,6,12,17,38,-21,18
Brondby,8299,1,19,6,5,67,35,32,63
FC Midtjylla,8299,2,19,5,6,62,38,24,62
FC Nords,8299,3,15,6,9,76,54,22,51
Copenhagen,8299,4,15,5,10,57,41,16,50
AaB,8299,5,8,11,11,39,44,-5,35
AC Horsens,8299,6,7,13,10,36,51,-15,34
Sonderjyske,8299,7,8,6,10,28,29,-1,30
Lyngby,8299,8,4,9,11,28,44,-16,21
Randers FC,8299,9,5,6,13,23,41,-18,21
AGF Aarhus,8299,10,5,6,11,18,37,-19,21
Silkeborg IF,8299,11,5,3,14,26,46,-20,18
Brondby,8300,1,22,5,3,70,30,40,71
FC Midtjylla,8300,2,20,4,6,65,43,22,64
Copenhagen,8300,3,15,5,10,62,42,20,50
FC Nords,8300,4,13,8,9,70,52,18,47
AC Horsens,8300,5,7,12,11,37,52,-15,33
Sonderjyske,8300,6,8,6,10,28,29,-1,30
AaB,8300,7,6,12,12,34,45,-11,30
Lyngby,8300,8,4,9,11,30,45,-15,21
Randers FC,8300,9,5,6,13,24,43,-19,21
Silkeborg IF,8300,10,5,4,13,27,46,-19,19
AGF Aarhus,8300,11,4,7,11,18,38,-20,19
Brondby,8301,1,22,5,3,70,31,39,71
FC Midtjylla,8301,2,19,4,7,65,38,27,61
FC Nords,8301,3,15,6,9,75,50,25,51
Copenhagen,8301,4,15,5,10,57,41,16,50
AC Horsens,8301,5,6,14,10,33,53,-20,32
Sonderjyske,8301,6,8,6,10,28,29,-1,30
AaB,8301,7,6,12,12,36,49,-13,30
Lyngby,8301,8,4,9,11,29,45,-16,21
Silkeborg IF,8301,9,6,3,13,28,45,-17,21
Randers FC,8301,10,5,6,13,24,42,-18,21
AGF Aarhus,8301,11,4,6,12,17,39,-22,18
FC Midtjylla,8302,1,21,4,5,74,39,35,67
Brondby,8302,2,19,8,3,66,30,36,65
FC Nords,8302,3,13,8,9,71,52,19,47
Copenhagen,8302,4,13,6,11,55,47,8,45
AaB,8302,5,8,12,10,41,42,-1,36
AC Horsens,8302,6,7,12,11,32,55,-23,33
Sonderjyske,8302,7,8,6,10,28,29,-1,30
Randers FC,8302,8,5,7,12,25,41,-16,22
Silkeborg IF,8302,9,6,3,13,27,44,-17,21
Lyngby,8302,10,3,10,11,28,46,-18,19
AGF Aarhus,8302,11,4,6,12,16,38,-22,18
Brondby,8303,1,22,5,3,71,30,41,71
FC Midtjylla,8303,2,17,7,6,64,42,22,58
Copenhagen,8303,3,15,5,10,58,42,16,50
FC Nords,8303,4,14,7,9,77,57,20,49
AaB,8303,5,7,13,10,36,43,-7,34
AC Horsens,8303,6,6,13,11,33,51,-18,31
Sonderjyske,8303,7,8,6,10,28,29,-1,30
Lyngby,8303,8,4,9,11,28,44,-16,21
Randers FC,8303,9,5,6,13,23,41,-18,21
Silkeborg IF,8303,10,5,4,13,25,44,-19,19
AGF Aarhus,8303,11,4,7,11,16,36,-20,19
FC Midtjylla,8304,1,21,4,5,66,40,26,67
Brondby,8304,2,20,6,4,72,34,38,66
FC Nords,8304,3,14,8,8,73,48,25,50
Copenhagen,8304,4,15,5,10,62,44,18,50
AaB,8304,5,6,14,10,35,42,-7,32
Sonderjyske,8304,6,8,6,10,28,29,-1,30
AC Horsens,8304,7,5,13,12,32,58,-26,28
Randers FC,8304,8,6,6,12,26,39,-13,24
AGF Aarhus,8304,9,5,6,11,18,37,-19,21
Silkeborg IF,8304,10,5,3,14,26,46,-20,18
Lyngby,8304,11,3,9,12,26,47,-21,18
Brondby,8305,1,20,7,3,71,32,39,67
FC Midtjylla,8305,2,20,6,4,70,39,31,66
Copenhagen,8305,3,15,6,9,61,44,17,51
FC Nords,8305,4,12,6,12,69,55,14,42
AC Horsens,8305,5,7,13,10,33,50,-17,34
AaB,8305,6,7,12,11,35,45,-10,33
Sonderjyske,8305,7,8,6,10,28,29,-1,30
Randers FC,8305,8,6,6,12,24,39,-15,24
Silkeborg IF,8305,9,6,3,13,27,45,-18,21
Lyngby,8305,10,3,9,12,26,45,-19,18
AGF Aarhus,8305,11,4,6,12,17,38,-21,18
Brondby,8306,1,21,5,4,70,32,38,68
FC Midtjylla,8306,2,20,5,5,67,39,28,65
Copenhagen,8306,3,15,5,10,60,40,20,50
FC Nords,8306,4,13,7,10,71,55,16,46
AaB,8306,5,7,12,11,37,46,-9,33
AC Horsens,8306,6,7,12,11,36,55,-19,33
Sonderjyske,8306,7,8,6,10,28,29,-1,30
Randers FC,8306,8,5,7,12,23,39,-16,22
Silkeborg IF,8306,9,6,3,13,26,44,-18,21
Lyngby,8306,10,3,10,11,26,44,-18,19
AGF Aarhus,8306,11,4,6,12,16,37,-21,18
Brondby,8307,1,20,8,2,68,30,38,68
FC Midtjylla,8307,2,19,5,6,65,40,25,62
Copenhagen,8307,3,14,7,9,59,42,17,49
FC Nords,8307,4,13,6,11,70,58,12,45
AC Horsens,8307,5,7,15,8,40,47,-7,36
AaB,8307,6,6,13,11,33,44,-11,31
Sonderjyske,8307,7,8,6,10,28,29,-1,30
Randers FC,8307,8,5,7,12,24,40,-16,22
AGF Aarhus,8307,9,5,6,11,19,38,-19,21
Lyngby,8307,10,3,10,11,27,45,-18,19
Silkeborg IF,8307,11,5,3,14,27,47,-20,18
FC Midtjylla,8308,1,22,4,4,66,35,31,70
Brondby,8308,2,20,6,4,68,34,34,66
FC Nords,8308,3,14,8,8,75,49,26,50
Copenhagen,8308,4,14,6,10,57,41,16,48
AaB,8308,5,7,11,12,37,49,-12,32
Sonderjyske,8308,6,8,6,10,28,29,-1,30
AC Horsens,8308,7,5,13,12,33,54,-21,28
Lyngby,8308,8,4,9,11,28,44,-16,21
Randers FC,8308,9,5,6,13,23,41,-18,21
AGF Aarhus,8308,10,5,6,11,18,37,-19,21
Silkeborg IF,8308,11,5,3,14,26,46,-20,18
Brondby,8309,1,22,6,2,74,32,42,72
FC Midtjylla,8309,2,18,6,6,67,43,24,60
FC Nords,8309,3,13,6,11,71,56,15,45
Copenhagen,8309,4,13,6,11,57,46,11,45
AaB,8309,5,9,12,9,43,43,0,39
AC Horsens,8309,6,7,12,11,37,55,-18,33
Sonderjyske,8309,7,8,6,10,28,29,-1,30
Randers FC,8309,8,5,7,12,25,41,-16,22
Silkeborg IF,8309,9,6,3,13,27,44,-17,21
Lyngby,8309,10,3,10,11,28,46,-18,19
AGF Aarhus,8309,11,4,6,12,16,38,-22,18
FC Midtjylla,8310,1,20,5,5,64,37,27,65
Brondby,8310,2,19,6,5,66,33,33,63
FC Nords,8310,3,15,7,8,72,47,25,52
Copenhagen,8310,4,16,4,10,62,43,19,52
AaB,8310,5,6,14,10,37,45,-8,32
Sonderjyske,8310,6,8,6,10,28,29,-1,30
AC Horsens,8310,7,6,12,12,33,55,-22,30
Randers FC,8310,8,6,6,12,25,39,-14,24
AGF Aarhus,8310,9,5,6,11,18,37,-19,21
Lyngby,8310,10,3,9,12,26,46,-20,18
Silkeborg IF,8310,10,5,3,14,26,46,-20,18
Brondby,8311,1,21,6,3,71,32,39,69
FC Midtjylla,8311,2,19,4,7,61,41,20,61
FC Nords,8311,3,15,7,8,76,52,24,52
Copenhagen,8311,4,14,6,10,60,45,15,48
AaB,8311,5,7,12,11,35,43,-8,33
AC Horsens,8311,6,6,13,11,33,49,-16,31
Sonderjyske,8311,7,8,6,10,28,29,-1,30
Lyngby,8311,8,4,9,11,28,45,-17,21
Randers FC,8311,9,5,6,13,24,41,-17,21
Silkeborg IF,8311,10,6,3,13,26,44,-18,21
AGF Aarhus,8311,11,4,6,12,16,37,-21,18
Brondby,8312,1,21,6,3,70,33,37,69
FC Midtjylla,8312,2,18,6,6,61,42,19,60
Copenhagen,8312,3,15,5,10,61,43,18,50
FC Nords,8312,4,14,6,10,73,51,22,48
AaB,8312,5,7,13,10,37,42,-5,34
AC Horsens,8312,6,6,14,10,32,49,-17,32
Sonderjyske,8312,7,8,6,10,28,29,-1,30
Randers FC,8312,8,6,6,12,25,39,-14,24
AGF Aarhus,8312,9,5,6,11,17,36,-19,21
Lyngby,8312,10,3,9,12,26,46,-20,18
Silkeborg IF,8312,11,5,3,14,25,45,-20,18
Brondby,8313,1,20,5,5,68,32,36,65
FC Midtjylla,8313,2,20,4,6,68,41,27,64
FC Nords,8313,3,15,7,8,73,48,25,52
Copenhagen,8313,4,13,6,11,58,47,11,45
AaB,8313,5,7,13,10,35,43,-8,34
AC Horsens,8313,6,7,13,10,35,52,-17,34
Sonderjyske,8313,7,8,6,10,28,29,-1,30
Randers FC,8313,8,6,6,12,25,39,-14,24
Silkeborg IF,8313,9,6,3,13,27,44,-17,21
Lyngby,8313,10,3,9,12,26,46,-20,18
AGF Aarhus,8313,11,4,6,12,16,38,-22,18
Brondby,8314,1,21,6,3,74,31,43,69
FC Midtjylla,8314,2,20,5,5,67,38,29,65
Copenhagen,8314,3,14,5,11,56,43,13,47
FC Nords,8314,4,12,7,11,68,56,12,43
AaB,8314,5,7,13,10,36,45,-9,34
AC Horsens,8314,6,6,16,8,36,50,-14,34
Sonderjyske,8314,7,8,6,10,28,29,-1,30
Randers FC,8314,8,6,6,12,26,41,-15,24
Silkeborg IF,8314,9,5,4,13,26,45,-19,19
AGF Aarhus,8314,10,4,7,11,17,37,-20,19
Lyngby,8314,11,3,9,12,28,47,-19,18
Brondby,8315,1,22,6,2,71,27,44,72
FC Midtjylla,8315,2,19,5,6,61,38,23,62
FC Nords,8315,3,13,7,10,69,53,16,46
Copenhagen,8315,4,12,7,11,53,46,7,43
AaB,8315,5,8,13,9,38,38,0,37
AC Horsens,8315,6,6,14,10,33,49,-16,32
Sonderjyske,8315,7,8,6,10,28,29,-1,30
Lyngby,8315,8,4,9,11,29,45,-16,21
Silkeborg IF,8315,9,6,3,13,27,44,-17,21
Randers FC,8315,10,5,6,13,24,42,-18,21
AGF Aarhus,8315,11,4,6,12,16,38,-22,18
Brondby,8316,1,20,7,3,68,32,36,67
FC Midtjylla,8316,2,20,5,5,65,37,28,65
Copenhagen,8316,3,14,5,11,57,44,13,47
FC Nords,8316,4,12,6,12,70,59,11,42
AaB,8316,5,8,13,9,40,41,-1,37
AC Horsens,8316,6,7,14,9,38,51,-13,35
Sonderjyske,8316,7,8,6,10,28,29,-1,30
Randers FC,8316,8,6,6,12,25,40,-15,24
Silkeborg IF,8316,9,6,3,13,27,45,-18,21
Lyngby,8316,10,3,9,12,27,46,-19,18
AGF Aarhus,8316,11,4,6,12,17,38,-21,18
Brondby,8317,1,21,5,4,71,34,37,68
FC Midtjylla,8317,2,20,4,6,70,46,24,64
FC Nords,8317,3,16,6,8,77,50,27,54
Copenhagen,8317,4,15,4,11,61,48,13,49
AaB,8317,5,7,11,12,38,45,-7,32
Sonderjyske,8317,6,8,6,10,28,29,-1,30
AC Horsens,8317,7,6,12,12,34,54,-20,30
Lyngby,8317,8,4,9,11,28,44,-16,21
Silkeborg IF,8317,9,6,3,13,27,45,-18,21
Randers FC,8317,10,5,6,13,23,41,-18,21
AGF Aarhus,8317,11,4,6,12,17,38,-21,18
Brondby,8318,1,22,5,3,74,29,45,71
FC Midtjylla,8318,2,21,5,4,64,34,30,68
FC Nords,8318,3,13,7,10,70,53,17,46
Copenhagen,8318,4,14,4,12,59,48,11,46
AaB,8318,5,7,11,12,37,47,-10,32
AC Horsens,8318,6,6,14,10,32,51,-19,32
Sonderjyske,8318,7,8,6,10,28,29,-1,30
Randers FC,8318,8,5,7,12,24,40,-16,22
Lyngby,8318,9,3,10,11,27,45,-18,19
Silkeborg IF,8318,10,5,4,13,26,45,-19,19
AGF Aarhus,8318,11,4,7,11,17,37,-20,19
Brondby,8319,1,21,6,3,71,32,39,69
FC Midtjylla,8319,2,19,5,6,64,41,23,62
FC Nords,8319,3,14,7,9,70,49,21,49
Copenhagen,8319,4,13,6,11,56,45,11,45
AaB,8319,5,8,12,10,37,41,-4,36
AC Horsens,8319,6,6,14,10,35,51,-16,32
Sonderjyske,8319,7,8,6,10,28,29,-1,30
Lyngby,8319,8,4,9,11,28,44,-16,21
Randers FC,8319,9,5,6,13,23,41,-18,21
Silkeborg IF,8319,10,5,4,13,26,45,-19,19
AGF Aarhus,8319,11,4,7,11,17,37,-20,19
Brondby,8320,1,21,6,3,72,30,42,69
FC Midtjylla,8320,2,20,5,5,65,39,26,65
FC Nords,8320,3,13,8,9,73,52,21,47
Copenhagen,8320,4,13,5,12,58,51,7,44
AC Horsens,8320,5,7,15,8,37,48,-11,36
AaB,8320,6,7,11,12,37,48,-11,32
Sonderjyske,8320,7,8,6,10,28,29,-1,30
Lyngby,8320,8,4,9,11,29,44,-15,21
Silkeborg IF,8320,9,6,3,13,26,44,-18,21
Randers FC,8320,10,5,6,13,23,42,-19,21
AGF Aarhus,8320,11,4,6,12,16,37,-21,18
Brondby,8321,1,20,7,3,72,37,35,67
FC Midtjylla,8321,2,21,4,5,65,35,30,67
FC Nords,8321,3,13,8,9,72,51,21,47
Copenhagen,8321,4,14,5,11,59,43,16,47
AaB,8321,5,8,12,10,36,43,-7,36
Sonderjyske,8321,6,8,6,10,28,29,-1,30
AC Horsens,8321,7,5,14,11,36,57,-21,29
Lyngby,8321,8,4,9,11,28,44,-16,21
Silkeborg IF,8321,9,6,3,13,28,45,-17,21
Randers FC,8321,10,5,6,13,23,41,-18,21
AGF Aarhus,8321,11,4,6,12,17,39,-22,18
Brondby,8322,1,22,5,3,73,32,41,71
FC Midtjylla,8322,2,20,4,6,68,43,25,64
FC Nords,8322,3,13,7,10,72,54,18,46
Copenhagen,8322,4,13,4,13,59,50,9,43
AaB,8322,5,9,11,10,36,39,-3,38
AC Horsens,8322,6,7,13,10,37,53,-16,34
Sonderjyske,8322,7,8,6,10,28,29,-1,30
Lyngby,8322,8,4,9,11,29,44,-15,21
Randers FC,8322,9,5,6,13,23,42,-19,21
AGF Aarhus,8322,10,5,6,11,17,36,-19,21
Silkeborg IF,8322,11,5,3,14,25,45,-20,18
FC Midtjylla,8323,1,20,6,4,67,37,30,66
Brondby,8323,2,19,7,4,69,35,34,64
FC Nords,8323,3,13,8,9,70,53,17,47
Copenhagen,8323,4,13,6,11,58,47,11,45
AaB,8323,5,8,12,10,38,41,-3,36
AC Horsens,8323,6,5,17,8,37,52,-15,32
Sonderjyske,8323,7,8,6,10,28,29,-1,30
Randers FC,8323,8,5,7,12,24,40,-16,22
AGF Aarhus,8323,9,5,6,11,19,36,-17,21
Lyngby,8323,10,3,10,11,27,45,-18,19
Silkeborg IF,8323,11,5,3,14,25,47,-22,18
Brondby,8324,1,19,7,4,67,35,32,64
FC Midtjylla,8324,2,19,6,5,66,40,26,63
FC Nords,8324,3,12,11,7,71,50,21,47
Copenhagen,8324,4,14,5,11,58,44,14,47
AaB,8324,5,8,12,10,40,41,-1,36
AC Horsens,8324,6,7,13,10,37,55,-18,34
Sonderjyske,8324,7,8,6,10,28,29,-1,30
Randers FC,8324,8,6,6,12,25,40,-15,24
Silkeborg IF,8324,9,6,3,13,27,45,-18,21
Lyngby,8324,10,3,9,12,27,46,-19,18
AGF Aarhus,8324,11,4,6,12,17,38,-21,18
Brondby,8325,1,20,6,4,65,30,35,66
FC Midtjylla,8325,2,18,5,7,60,40,20,59
FC Nords,8325,3,17,6,7,78,49,29,57
Copenhagen,8325,4,14,5,11,56,42,14,47
AC Horsens,8325,5,7,14,9,37,52,-15,35
Sonderjyske,8325,6,8,6,10,28,29,-1,30
AaB,8325,7,6,12,12,34,43,-9,30
Randers FC,8325,8,6,6,12,25,40,-15,24
Silkeborg IF,8325,9,5,4,13,26,45,-19,19
AGF Aarhus,8325,10,4,7,11,17,37,-20,19
Lyngby,8325,11,3,9,12,27,46,-19,18
Brondby,8326,1,21,6,3,72,33,39,69
FC Midtjylla,8326,2,18,6,6,62,41,21,60
Copenhagen,8326,3,15,5,10,57,41,16,50
FC Nords,8326,4,14,6,10,73,50,23,48
AaB,8326,5,9,12,9,37,40,-3,39
Sonderjyske,8326,6,8,6,10,28,29,-1,30
AC Horsens,8326,7,5,13,12,32,54,-22,28
Lyngby,8326,8,4,9,11,28,45,-17,21
Randers FC,8326,9,5,6,13,24,41,-17,21
Silkeborg IF,8326,10,5,4,13,26,45,-19,19
AGF Aarhus,8326,11,4,7,11,17,37,-20,19
Brondby,8327,1,21,6,3,71,32,39,69
FC Midtjylla,8327,2,21,4,5,68,36,32,67
FC Nords,8327,3,13,7,10,69,53,16,46
Copenhagen,8327,4,14,4,12,58,44,14,46
AaB,8327,5,9,11,10,38,42,-4,38
Sonderjyske,8327,6,8,6,10,28,29,-1,30
AC Horsens,8327,7,5,14,11,31,54,-23,29
Randers FC,8327,8,5,7,12,23,39,-16,22
Silkeborg IF,8327,9,6,3,13,29,45,-16,21
Lyngby,8327,10,3,10,11,26,44,-18,19
AGF Aarhus,8327,11,4,6,12,17,40,-23,18
Brondby,8328,1,19,7,4,65,32,33,64
FC Midtjylla,8328,2,20,4,6,68,40,28,64
FC Nords,8328,3,14,7,9,75,53,22,49
Copenhagen,8328,4,14,5,11,55,42,13,47
AaB,8328,5,8,12,10,36,43,-7,36
AC Horsens,8328,6,7,13,10,36,51,-15,34
Sonderjyske,8328,7,8,6,10,28,29,-1,30
Lyngby,8328,8,4,9,11,27,44,-17,21
Silkeborg IF,8328,8,6,3,13,27,44,-17,21
Randers FC,8328,10,5,6,13,23,40,-17,21
AGF Aarhus,8328,11,4,6,12,16,38,-22,18
Brondby,8329,1,20,7,3,74,33,41,67
FC Midtjylla,8329,2,19,7,4,67,38,29,64
FC Nords,8329,3,13,9,8,71,49,22,48
Copenhagen,8329,4,14,4,12,55,47,8,46
AaB,8329,5,8,13,9,37,40,-3,37
Sonderjyske,8329,6,8,6,10,28,29,-1,30
AC Horsens,8329,7,6,12,12,36,59,-23,30
Lyngby,8329,8,4,9,11,29,46,-17,21
Silkeborg IF,8329,9,6,3,13,28,45,-17,21
Randers FC,8329,10,5,6,13,25,42,-17,21
AGF Aarhus,8329,11,4,6,12,17,39,-22,18
Brondby,8330,1,20,6,4,69,33,36,66
FC Midtjylla,8330,2,20,5,5,63,34,29,65
Copenhagen,8330,3,16,5,9,62,41,21,53
FC Nords,8330,4,13,7,10,70,52,18,46
AaB,8330,5,8,11,11,35,41,-6,35
Sonderjyske,8330,6,8,6,10,28,29,-1,30
AC Horsens,8330,7,6,12,12,31,55,-24,30
Randers FC,8330,8,5,7,12,24,40,-16,22
Silkeborg IF,8330,9,6,3,13,27,45,-18,21
Lyngby,8330,10,3,10,11,27,45,-18,19
AGF Aarhus,8330,11,4,6,12,17,38,-21,18
FC Midtjylla,8331,1,21,5,4,74,36,38,68
Brondby,8331,2,19,6,5,65,35,30,63
FC Nords,8331,3,14,7,9,71,56,15,49
Copenhagen,8331,4,12,6,12,56,48,8,42
AaB,8331,5,8,13,9,40,43,-3,37
AC Horsens,8331,6,7,13,10,38,52,-14,34
Sonderjyske,8331,7,8,6,10,28,29,-1,30
Silkeborg IF,8331,8,6,3,13,28,45,-17,21
Lyngby,8331,9,4,9,11,27,44,-17,21
Randers FC,8331,10,5,6,13,23,40,-17,21
AGF Aarhus,8331,11,4,6,12,17,39,-22,18
Brondby,8332,1,22,6,2,73,29,44,72
FC Midtjylla,8332,2,20,4,6,68,38,30,64
FC Nords,8332,3,14,7,9,75,58,17,49
Copenhagen,8332,4,13,6,11,57,48,9,45
AaB,8332,5,8,11,11,38,45,-7,35
Sonderjyske,8332,6,8,6,10,28,29,-1,30
AC Horsens,8332,7,5,14,11,34,53,-19,29
Randers FC,8332,8,5,7,12,23,39,-16,22
Lyngby,8332,9,3,10,11,26,44,-18,19
Silkeborg IF,8332,10,5,4,13,27,46,-19,19
AGF Aarhus,8332,11,4,7,11,18,38,-20,19
Brondby,8333,1,22,6,2,77,32,45,72
FC Midtjylla,8333,2,19,5,6,62,39,23,62
Copenhagen,8333,3,15,5,10,63,47,16,50
FC Nords,8333,4,13,8,9,77,56,21,47
AaB,8333,5,6,13,11,34,45,-11,31
AC Horsens,8333,6,6,13,11,36,56,-20,31
Sonderjyske,8333,7,8,6,10,28,29,-1,30
Lyngby,8333,8,4,9,11,30,45,-15,21
Randers FC,8333,9,5,6,13,24,43,-19,21
AGF Aarhus,8333,10,5,6,11,18,37,-19,21
Silkeborg IF,8333,11,5,3,14,26,46,-20,18
Brondby,8334,1,21,5,4,71,36,35,68
FC Midtjylla,8334,2,18,6,6,62,37,25,60
FC Nords,8334,3,15,7,8,72,48,24,52
Copenhagen,8334,4,15,5,10,62,40,22,50
AaB,8334,5,7,12,11,38,49,-11,33
Sonderjyske,8334,6,8,6,10,28,29,-1,30
AC Horsens,8334,7,5,15,10,30,51,-21,30
Lyngby,8334,8,4,9,11,29,45,-16,21
Randers FC,8334,9,5,6,13,24,42,-18,21
AGF Aarhus,8334,10,5,6,11,18,37,-19,21
Silkeborg IF,8334,11,5,3,14,26,46,-20,18
Brondby,8335,1,20,8,2,69,32,37,68
FC Midtjylla,8335,2,20,6,4,66,36,30,66
FC Nords,8335,3,14,8,8,74,49,25,50
Copenhagen,8335,4,12,5,13,52,50,2,41
AC Horsens,8335,5,7,14,9,35,50,-15,35
AaB,8335,6,7,11,12,40,45,-5,32
Sonderjyske,8335,7,8,6,10,28,29,-1,30
Lyngby,8335,8,4,9,11,28,45,-17,21
Randers FC,8335,9,5,6,13,24,41,-17,21
AGF Aarhus,8335,10,5,6,11,17,36,-19,21
Silkeborg IF,8335,11,5,3,14,25,45,-20,18
Brondby,8336,1,20,6,4,71,33,38,66
FC Midtjylla,8336,2,19,4,7,64,43,21,61
FC Nords,8336,3,14,6,10,73,57,16,48
Copenhagen,8336,4,14,4,12,59,43,16,46
AaB,8336,5,10,11,9,42,43,-1,41
AC Horsens,8336,6,7,13,10,35,51,-16,34
Sonderjyske,8336,7,8,6,10,28,29,-1,30
Lyngby,8336,8,4,9,11,29,44,-15,21
Randers FC,8336,9,5,6,13,23,42,-19,21
Silkeborg IF,8336,10,5,4,13,25,44,-19,19
AGF Aarhus,8336,11,4,7,11,16,36,-20,19
Brondby,8337,1,22,6,2,79,34,45,72
FC Midtjylla,8337,2,21,4,5,68,38,30,67
FC Nords,8337,3,15,6,9,72,50,22,51
Copenhagen,8337,4,12,5,13,52,49,3,41
AaB,8337,5,8,11,11,37,43,-6,35
Sonderjyske,8337,6,8,6,10,28,29,-1,30
AC Horsens,8337,7,5,14,11,34,54,-20,29
Randers FC,8337,8,5,7,12,23,39,-16,22
AGF Aarhus,8337,9,5,6,11,17,36,-19,21
Lyngby,8337,10,3,10,11,26,44,-18,19
Silkeborg IF,8337,11,5,3,14,25,45,-20,18
Brondby,8338,1,21,6,3,74,32,42,69
FC Midtjylla,8338,2,20,5,5,68,37,31,65
Copenhagen,8338,3,15,5,10,58,43,15,50
FC Nords,8338,4,13,7,10,69,57,12,46
AaB,8338,5,7,13,10,39,45,-6,34
Sonderjyske,8338,6,8,6,10,28,29,-1,30
AC Horsens,8338,7,5,14,11,31,51,-20,29
Lyngby,8338,8,4,9,11,28,45,-17,21
Silkeborg IF,8338,9,6,3,13,27,44,-17,21
Randers FC,8338,10,5,6,13,24,41,-17,21
AGF Aarhus,8338,11,4,6,12,16,38,-22,18
Brondby,8339,1,21,6,3,75,37,38,69
FC Midtjylla,8339,2,20,5,5,68,40,28,65
Copenhagen,8339,3,14,6,10,62,48,14,48
FC Nords,8339,4,13,7,10,74,56,18,46
AC Horsens,8339,5,7,12,11,36,52,-16,33
AaB,8339,6,6,14,10,39,47,-8,32
Sonderjyske,8339,7,8,6,10,28,29,-1,30
Randers FC,8339,8,5,7,12,25,41,-16,22
Silkeborg IF,8339,9,6,3,13,28,46,-18,21
Lyngby,8339,10,3,10,11,28,46,-18,19
AGF Aarhus,8339,11,4,6,12,18,39,-21,18
Brondby,8340,1,20,6,4,70,35,35,66
FC Midtjylla,8340,2,19,5,6,63,41,22,62
Copenhagen,8340,3,16,4,10,61,41,20,52
FC Nords,8340,4,15,6,9,76,51,25,51
AaB,8340,5,7,14,9,38,40,-2,35
Sonderjyske,8340,6,8,6,10,28,29,-1,30
AC Horsens,8340,7,5,13,12,33,59,-26,28
Lyngby,8340,8,4,9,11,28,44,-16,21
Silkeborg IF,8340,9,6,3,13,28,46,-18,21
Randers FC,8340,10,5,6,13,23,41,-18,21
AGF Aarhus,8340,11,4,6,12,18,39,-21,18
Brondby,8341,1,22,6,2,74,34,40,72
FC Midtjylla,8341,2,20,6,4,74,36,38,66
FC Nords,8341,3,14,6,10,74,55,19,48
Copenhagen,8341,4,13,4,13,56,51,5,43
AC Horsens,8341,5,7,13,10,39,54,-15,34
AaB,8341,6,7,11,12,38,51,-13,32
Sonderjyske,8341,7,8,6,10,28,29,-1,30
Randers FC,8341,8,6,6,12,26,40,-14,24
Silkeborg IF,8341,9,6,3,13,28,46,-18,21
Lyngby,8341,10,3,9,12,27,47,-20,18
AGF Aarhus,8341,11,4,6,12,18,39,-21,18
Brondby,8342,1,20,6,4,76,37,39,66
FC Midtjylla,8342,2,18,7,5,64,39,25,61
FC Nords,8342,3,16,7,7,76,50,26,55
Copenhagen,8342,4,13,5,12,57,46,11,44
AaB,8342,5,8,11,11,36,46,-10,35
AC Horsens,8342,6,6,14,10,37,54,-17,32
Sonderjyske,8342,7,8,6,10,28,29,-1,30
Randers FC,8342,8,5,7,12,24,40,-16,22
AGF Aarhus,8342,9,5,6,11,19,38,-19,21
Lyngby,8342,10,3,10,11,27,45,-18,19
Silkeborg IF,8342,11,5,3,14,27,47,-20,18
Brondby,8343,1,21,7,2,75,35,40,70
FC Midtjylla,8343,2,18,6,6,65,41,24,60
FC Nords,8343,3,13,8,9,74,57,17,47
Copenhagen,8343,4,13,6,11,57,47,10,45
AaB,8343,5,8,12,10,42,45,-3,36
AC Horsens,8343,6,6,15,9,41,55,-14,33
Sonderjyske,8343,7,8,6,10,28,29,-1,30
Lyngby,8343,8,4,9,11,29,45,-16,21
Randers FC,8343,9,5,6,13,24,42,-18,21
Silkeborg IF,8343,10,5,4,13,26,45,-19,19
AGF Aarhus,8343,11,4,7,11,17,37,-20,19
Brondby,8344,1,22,6,2,78,30,48,72
FC Midtjylla,8344,2,18,5,7,65,43,22,59
FC Nords,8344,3,14,8,8,73,54,19,50
Copenhagen,8344,4,13,6,11,56,47,9,45
AaB,8344,5,9,12,9,42,43,-1,39
Sonderjyske,8344,6,8,6,10,28,29,-1,30
AC Horsens,8344,7,5,13,12,32,55,-23,28
Lyngby,8344,8,4,9,11,28,44,-16,21
Randers FC,8344,9,5,6,13,23,41,-18,21
Silkeborg IF,8344,10,5,4,13,25,44,-19,19
AGF Aarhus,8344,11,4,7,11,16,36,-20,19
Brondby,8345,1,19,8,3,70,34,36,65
FC Midtjylla,8345,2,19,6,5,66,41,25,63
Copenhagen,8345,3,15,6,9,58,42,16,51
FC Nords,8345,4,13,7,10,71,54,17,46
AaB,8345,5,8,13,9,38,39,-1,37
Sonderjyske,8345,6,8,6,10,28,29,-1,30
AC Horsens,8345,7,6,12,12,34,53,-19,30
Randers FC,8345,8,6,6,12,25,40,-15,24
Silkeborg IF,8345,9,6,3,13,27,45,-18,21
Lyngby,8345,10,3,9,12,27,46,-19,18
AGF Aarhus,8345,11,4,6,12,17,38,-21,18
Brondby,8346,1,21,7,2,69,29,40,70
FC Midtjylla,8346,2,20,6,4,68,37,31,66
FC Nords,8346,3,15,6,9,72,50,22,51
Copenhagen,8346,4,13,5,12,53,45,8,44
AaB,8346,5,8,12,10,41,41,0,36
Sonderjyske,8346,6,8,6,10,28,29,-1,30
AC Horsens,8346,7,5,12,13,33,60,-27,27
Randers FC,8346,8,5,7,12,24,40,-16,22
AGF Aarhus,8346,9,5,6,11,17,36,-19,21
Lyngby,8346,10,3,10,11,27,45,-18,19
Silkeborg IF,8346,11,5,3,14,25,45,-20,18
Brondby,8347,1,21,6,3,72,33,39,69
FC Midtjylla,8347,2,18,6,6,63,41,22,60
FC Nords,8347,3,15,8,7,76,48,28,53
Copenhagen,8347,4,13,6,11,57,44,13,45
AaB,8347,5,7,12,11,36,44,-8,33
AC Horsens,8347,6,7,12,11,34,54,-20,33
Sonderjyske,8347,7,8,6,10,28,29,-1,30
Lyngby,8347,8,4,9,11,28,44,-16,21
Randers FC,8347,9,5,6,13,23,41,-18,21
Silkeborg IF,8347,10,5,4,13,27,46,-19,19
AGF Aarhus,8347,11,4,7,11,18,38,-20,19
Brondby,8348,1,20,6,4,72,37,35,66
FC Midtjylla,8348,2,19,6,5,66,41,25,63
FC Nords,8348,3,14,7,9,74,52,22,49
Copenhagen,8348,4,14,6,10,59,42,17,48
AC Horsens,8348,5,7,13,10,36,54,-18,34
AaB,8348,6,6,14,10,38,45,-7,32
Sonderjyske,8348,7,8,6,10,28,29,-1,30
Randers FC,8348,8,6,6,12,24,39,-15,24
AGF Aarhus,8348,9,5,6,11,17,36,-19,21
Lyngby,8348,10,3,9,12,26,45,-19,18
Silkeborg IF,8348,11,5,3,14,25,45,-20,18
Brondby,8349,1,21,6,3,66,30,36,69
FC Midtjylla,8349,2,19,5,6,62,40,22,62
Copenhagen,8349,3,16,5,9,64,40,24,53
FC Nords,8349,4,14,7,9,75,52,23,49
AC Horsens,8349,5,6,13,11,34,54,-20,31
Sonderjyske,8349,6,8,6,10,28,29,-1,30
AaB,8349,7,6,12,12,33,44,-11,30
Silkeborg IF,8349,8,6,3,13,29,44,-15,21
Lyngby,8349,9,4,9,11,28,45,-17,21
Randers FC,8349,10,5,6,13,24,41,-17,21
AGF Aarhus,8349,11,4,6,12,16,40,-24,18
Brondby,8350,1,22,5,3,73,29,44,71
FC Midtjylla,8350,2,19,5,6,66,40,26,62
Copenhagen,8350,3,15,5,10,59,43,16,50
FC Nords,8350,4,13,7,10,70,53,17,46
AaB,8350,5,7,12,11,36,45,-9,33
AC Horsens,8350,6,6,14,10,33,53,-20,32
Sonderjyske,8350,7,8,6,10,28,29,-1,30
Randers FC,8350,8,6,6,12,25,39,-14,24
Silkeborg IF,8350,9,5,4,13,25,44,-19,19
AGF Aarhus,8350,10,4,7,11,16,36,-20,19
Lyngby,8350,11,3,9,12,26,46,-20,18
Brondby,8351,1,19,7,4,69,37,32,64
FC Midtjylla,8351,2,19,6,5,68,43,25,63
FC Nords,8351,3,14,7,9,72,52,20,49
Copenhagen,8351,4,12,6,12,53,43,10,42
AaB,8351,5,9,12,9,38,40,-2,39
AC Horsens,8351,6,7,14,9,40,51,-11,35
Sonderjyske,8351,7,8,6,10,28,29,-1,30
Lyngby,8351,8,4,9,11,28,45,-17,21
Silkeborg IF,8351,8,6,3,13,28,45,-17,21
Randers FC,8351,10,5,6,13,24,41,-17,21
AGF Aarhus,8351,11,4,6,12,17,39,-22,18
Brondby,8352,1,21,7,2,74,33,41,70
FC Midtjylla,8352,2,19,5,6,66,43,23,62
Copenhagen,8352,3,14,6,10,58,42,16,48
FC Nords,8352,4,13,7,10,72,56,16,46
AaB,8352,5,7,13,10,38,44,-6,34
AC Horsens,8352,6,5,16,9,36,52,-16,31
Sonderjyske,8352,7,8,6,10,28,29,-1,30
Randers FC,8352,8,5,7,12,25,41,-16,22
Lyngby,8352,9,3,10,11,28,46,-18,19
Silkeborg IF,8352,10,5,4,13,25,44,-19,19
AGF Aarhus,8352,11,4,7,11,16,36,-20,19
Brondby,8353,1,19,6,5,66,33,33,63
FC Midtjylla,8353,2,18,6,6,64,44,20,60
FC Nords,8353,3,15,6,9,81,55,26,51
Copenhagen,8353,4,15,6,9,63,46,17,51
AC Horsens,8353,5,8,12,10,39,53,-14,36
AaB,8353,6,7,12,11,36,44,-8,33
Sonderjyske,8353,7,8,6,10,28,29,-1,30
AGF Aarhus,8353,8,5,6,11,21,36,-15,21
Lyngby,8353,9,4,9,11,29,46,-17,21
Randers FC,8353,10,5,6,13,25,42,-17,21
Silkeborg IF,8353,11,5,3,14,25,49,-24,18
Brondby,8354,1,22,6,2,71,30,41,72
FC Midtjylla,8354,2,20,6,4,69,38,31,66
FC Nords,8354,3,13,8,9,75,57,18,47
Copenhagen,8354,4,13,5,12,58,49,9,44
AaB,8354,5,8,11,11,38,46,-8,35
Sonderjyske,8354,6,8,6,10,28,29,-1,30
AC Horsens,8354,7,6,12,12,38,55,-17,30
Lyngby,8354,8,4,9,11,30,44,-14,21
Silkeborg IF,8354,9,6,3,13,27,44,-17,21
Randers FC,8354,10,5,6,13,23,43,-20,21
AGF Aarhus,8354,11,4,6,12,16,38,-22,18
Brondby,8355,1,22,6,2,72,27,45,72
FC Midtjylla,8355,2,19,5,6,64,41,23,62
FC Nords,8355,3,15,6,9,74,51,23,51
Copenhagen,8355,4,13,5,12,55,44,11,44
AaB,8355,5,7,13,10,37,43,-6,34
AC Horsens,8355,6,6,13,11,32,54,-22,31
Sonderjyske,8355,7,8,6,10,28,29,-1,30
Randers FC,8355,8,6,6,12,26,41,-15,24
Silkeborg IF,8355,9,6,3,13,29,47,-18,21
Lyngby,8355,10,3,9,12,28,47,-19,18
AGF Aarhus,8355,11,4,6,12,19,40,-21,18
Brondby,8356,1,22,5,3,76,34,42,71
FC Midtjylla,8356,2,19,5,6,65,41,24,62
Copenhagen,8356,3,15,4,11,59,43,16,49
FC Nords,8356,4,14,6,10,73,55,18,48
AaB,8356,5,8,12,10,38,44,-6,36
Sonderjyske,8356,6,8,6,10,28,29,-1,30
AC Horsens,8356,7,6,12,12,36,56,-20,30
Randers FC,8356,8,6,6,12,25,39,-14,24
AGF Aarhus,8356,9,5,6,11,18,37,-19,21
Lyngby,8356,10,3,9,12,26,46,-20,18
Silkeborg IF,8356,10,5,3,14,26,46,-20,18
FC Midtjylla,8357,1,20,6,4,68,39,29,66
Brondby,8357,2,19,8,3,69,34,35,65
FC Nords,8357,3,14,8,8,73,48,25,50
Copenhagen,8357,4,13,6,11,57,46,11,45
AaB,8357,5,7,12,11,37,45,-8,33
AC Horsens,8357,6,6,14,10,32,50,-18,32
Sonderjyske,8357,7,8,6,10,28,29,-1,30
Lyngby,8357,8,4,9,11,27,44,-17,21
Randers FC,8357,9,5,6,13,23,40,-17,21
Silkeborg IF,8357,10,6,3,13,29,47,-18,21
AGF Aarhus,8357,11,4,6,12,19,40,-21,18
Brondby,8358,1,21,5,4,69,31,38,68
FC Midtjylla,8358,2,19,6,5,65,38,27,63
FC Nords,8358,3,15,6,9,70,54,16,51
Copenhagen,8358,4,13,5,12,52,41,11,44
AaB,8358,5,8,11,11,42,46,-4,35
AC Horsens,8358,6,7,13,10,37,51,-14,34
Sonderjyske,8358,7,8,6,10,28,29,-1,30
Silkeborg IF,8358,8,6,3,13,29,44,-15,21
Lyngby,8358,9,4,9,11,27,44,-17,21
Randers FC,8358,10,5,6,13,23,40,-17,21
AGF Aarhus,8358,11,4,6,12,16,40,-24,18
Brondby,8359,1,21,5,4,77,34,43,68
FC Midtjylla,8359,2,21,4,5,71,36,35,67
FC Nords,8359,3,15,6,9,77,60,17,51
Copenhagen,8359,4,13,4,13,58,56,2,43
AaB,8359,5,9,11,10,39,42,-3,38
Sonderjyske,8359,6,8,6,10,28,29,-1,30
AC Horsens,8359,7,6,12,12,35,55,-20,30
Randers FC,8359,8,6,6,12,24,39,-15,24
Silkeborg IF,8359,9,5,4,13,26,45,-19,19
AGF Aarhus,8359,10,4,7,11,17,37,-20,19
Lyngby,8359,11,3,9,12,26,45,-19,18
Brondby,8360,1,22,6,2,72,29,43,72
FC Midtjylla,8360,2,18,5,7,64,43,21,59
FC Nords,8360,3,15,6,9,70,48,22,51
Copenhagen,8360,4,14,5,11,59,47,12,47
AaB,8360,5,7,12,11,34,42,-8,33
AC Horsens,8360,6,6,14,10,35,51,-16,32
Sonderjyske,8360,7,8,6,10,28,29,-1,30
Lyngby,8360,8,4,9,11,27,44,-17,21
Randers FC,8360,9,5,6,13,23,40,-17,21
AGF Aarhus,8360,10,5,6,11,19,36,-17,21
Silkeborg IF,8360,11,5,3,14,25,47,-22,18
Brondby,8361,1,22,6,2,73,31,42,72
FC Midtjylla,8361,2,20,4,6,68,40,28,64
Copenhagen,8361,3,15,4,11,59,45,14,49
FC Nords,8361,4,14,6,10,72,51,21,48
AaB,8361,5,8,11,11,37,45,-8,35
Sonderjyske,8361,6,8,6,10,28,29,-1,30
AC Horsens,8361,7,5,13,12,30,53,-23,28
Randers FC,8361,8,6,6,12,24,39,-15,24
Silkeborg IF,8361,9,6,3,13,26,44,-18,21
Lyngby,8361,10,3,9,12,26,45,-19,18
AGF Aarhus,8361,11,4,6,12,16,37,-21,18
Brondby,8362,1,21,5,4,70,32,38,68
FC Midtjylla,8362,2,20,5,5,66,40,26,65
Copenhagen,8362,3,14,6,10,58,43,15,48
FC Nords,8362,4,13,6,11,70,53,17,45
AaB,8362,5,9,11,10,36,39,-3,38
AC Horsens,8362,6,6,13,11,34,53,-19,31
Sonderjyske,8362,7,8,6,10,28,29,-1,30
Lyngby,8362,8,4,9,11,28,45,-17,21
Randers FC,8362,9,5,6,13,24,41,-17,21
Silkeborg IF,8362,10,5,4,13,26,45,-19,19
AGF Aarhus,8362,11,4,7,11,17,37,-20,19
Brondby,8363,1,20,8,2,69,32,37,68
FC Midtjylla,8363,2,19,6,5,65,40,25,63
FC Nords,8363,3,13,8,9,74,50,24,47
Copenhagen,8363,4,13,5,12,56,45,11,44
AaB,8363,5,8,13,9,36,40,-4,37
AC Horsens,8363,6,6,14,10,37,56,-19,32
Sonderjyske,8363,7,8,6,10,28,29,-1,30
Randers FC,8363,8,5,7,12,25,41,-16,22
Silkeborg IF,8363,9,6,3,13,29,45,-16,21
Lyngby,8363,10,3,10,11,28,46,-18,19
AGF Aarhus,8363,11,4,6,12,17,40,-23,18
Brondby,8364,1,20,6,4,69,33,36,66
FC Midtjylla,8364,2,20,6,4,71,39,32,66
FC Nords,8364,3,14,7,9,74,55,19,49
Copenhagen,8364,4,14,5,11,57,46,11,47
AaB,8364,5,7,12,11,38,44,-6,33
AC Horsens,8364,6,6,14,10,41,59,-18,32
Sonderjyske,8364,7,8,6,10,28,29,-1,30
Lyngby,8364,8,4,9,11,28,45,-17,21
Randers FC,8364,9,5,6,13,24,41,-17,21
AGF Aarhus,8364,10,5,6,11,20,38,-18,21
Silkeborg IF,8364,11,5,3,14,27,48,-21,18
Brondby,8365,1,21,7,2,70,29,41,70
FC Midtjylla,8365,2,18,5,7,60,39,21,59
FC Nords,8365,3,14,9,7,75,48,27,51
Copenhagen,8365,4,13,7,10,56,43,13,46
AaB,8365,5,8,12,10,37,44,-7,36
Sonderjyske,8365,6,8,6,10,28,29,-1,30
AC Horsens,8365,7,5,14,11,35,56,-21,29
Randers FC,8365,8,6,6,12,26,39,-13,24
Silkeborg IF,8365,9,6,3,13,27,44,-17,21
Lyngby,8365,10,3,9,12,26,47,-21,18
AGF Aarhus,8365,11,4,6,12,16,38,-22,18
Brondby,8366,1,21,7,2,72,33,39,70
FC Midtjylla,8366,2,19,5,6,72,47,25,62
FC Nords,8366,3,15,7,8,74,49,25,52
Copenhagen,8366,4,14,6,10,61,45,16,48
AaB,8366,5,6,13,11,37,47,-10,31
Sonderjyske,8366,6,8,6,10,28,29,-1,30
AC Horsens,8366,7,5,14,11,31,52,-21,29
Lyngby,8366,8,4,9,11,27,44,-17,21
Randers FC,8366,9,5,6,13,23,40,-17,21
AGF Aarhus,8366,10,5,6,11,17,36,-19,21
Silkeborg IF,8366,11,5,3,14,25,45,-20,18
Brondby,8367,1,22,6,2,70,26,44,72
FC Midtjylla,8367,2,19,5,6,60,38,22,62
FC Nords,8367,3,13,6,11,68,55,13,45
Copenhagen,8367,4,12,8,10,55,44,11,44
AaB,8367,5,8,12,10,37,39,-2,36
AC Horsens,8367,6,7,13,10,37,51,-14,34
Sonderjyske,8367,7,8,6,10,28,29,-1,30
Randers FC,8367,8,5,7,12,24,40,-16,22
Silkeborg IF,8367,9,6,3,13,30,45,-15,21
Lyngby,8367,10,3,10,11,27,45,-18,19
AGF Aarhus,8367,11,4,6,12,17,41,-24,18
Brondby,8368,1,20,7,3,69,32,37,67
FC Midtjylla,8368,2,20,4,6,63,37,26,64
FC Nords,8368,3,14,6,10,74,56,18,48
Copenhagen,8368,4,14,5,11,58,44,14,47
AaB,8368,5,9,12,9,37,38,-1,39
Sonderjyske,8368,6,8,6,10,28,29,-1,30
AC Horsens,8368,7,6,12,12,35,55,-20,30
Randers FC,8368,8,5,7,12,24,40,-16,22
AGF Aarhus,8368,9,5,6,11,17,36,-19,21
Lyngby,8368,10,3,10,11,27,45,-18,19
Silkeborg IF,8368,11,5,3,14,25,45,-20,18
Brondby,8369,1,21,7,2,72,31,41,70
FC Midtjylla,8369,2,18,6,6,64,42,22,60
FC Nords,8369,3,15,8,7,74,48,26,53
Copenhagen,8369,4,12,5,13,52,46,6,41
AaB,8369,5,8,11,11,39,44,-5,35
AC Horsens,8369,6,7,13,10,33,49,-16,34
Sonderjyske,8369,7,8,6,10,28,29,-1,30
Randers FC,8369,8,6,6,12,25,40,-15,24
Silkeborg IF,8369,9,6,3,13,27,45,-18,21
Lyngby,8369,10,3,9,12,27,46,-19,18
AGF Aarhus,8369,11,4,6,12,17,38,-21,18
Brondby,8370,1,21,6,3,71,32,39,69
FC Midtjylla,8370,2,20,5,5,69,39,30,65
Copenhagen,8370,3,15,5,10,58,43,15,50
FC Nords,8370,4,14,6,10,77,58,19,48
AaB,8370,5,8,11,11,40,44,-4,35
Sonderjyske,8370,6,8,6,10,28,29,-1,30
AC Horsens,8370,7,5,13,12,34,59,-25,28
Randers FC,8370,8,6,6,12,24,39,-15,24
Silkeborg IF,8370,9,6,3,13,28,45,-17,21
Lyngby,8370,10,3,9,12,26,45,-19,18
AGF Aarhus,8370,11,4,6,12,17,39,-22,18
Brondby,8371,1,20,7,3,68,32,36,67
FC Midtjylla,8371,2,20,5,5,62,34,28,65
FC Nords,8371,3,14,7,9,72,47,25,49
Copenhagen,8371,4,13,5,12,54,48,6,44
AaB,8371,5,9,11,10,38,41,-3,38
AC Horsens,8371,6,6,13,11,37,55,-18,31
Sonderjyske,8371,7,8,6,10,28,29,-1,30
Lyngby,8371,8,4,9,11,28,45,-17,21
Randers FC,8371,9,5,6,13,24,41,-17,21
Silkeborg IF,8371,10,5,4,13,25,44,-19,19
AGF Aarhus,8371,11,4,7,11,16,36,-20,19
Brondby,8372,1,20,6,4,73,34,39,66
FC Midtjylla,8372,2,19,5,6,66,39,27,62
Copenhagen,8372,3,16,5,9,58,40,18,53
FC Nords,8372,4,15,7,8,70,45,25,52
Sonderjyske,8372,5,8,6,10,28,29,-1,30
AC Horsens,8372,6,5,15,10,33,50,-17,30
AaB,8372,7,6,12,12,35,53,-18,30
Lyngby,8372,8,4,9,11,27,44,-17,21
Randers FC,8372,9,5,6,13,23,40,-17,21
Silkeborg IF,8372,10,6,3,13,28,46,-18,21
AGF Aarhus,8372,11,4,6,12,18,39,-21,18
FC Midtjylla,8373,1,20,4,6,65,40,25,64
Brondby,8373,2,19,6,5,70,37,33,63
FC Nords,8373,3,14,8,8,74,50,24,50
Copenhagen,8373,4,12,7,11,56,47,9,43
AaB,8373,5,9,11,10,37,39,-2,38
AC Horsens,8373,6,7,14,9,33,48,-15,35
Sonderjyske,8373,7,8,6,10,28,29,-1,30
Randers FC,8373,8,5,7,12,24,40,-16,22
Silkeborg IF,8373,9,6,3,13,30,44,-14,21
Lyngby,8373,10,3,10,11,27,45,-18,19
AGF Aarhus,8373,11,4,6,12,16,41,-25,18
Brondby,8374,1,20,7,3,70,32,38,67
FC Midtjylla,8374,2,20,5,5,69,39,30,65
FC Nords,8374,3,14,7,9,77,52,25,49
Copenhagen,8374,4,13,5,12,56,46,10,44
AC Horsens,8374,5,8,12,10,35,54,-19,36
AaB,8374,6,7,12,11,37,47,-10,33
Sonderjyske,8374,7,8,6,10,28,29,-1,30
Randers FC,8374,8,5,7,12,24,40,-16,22
Silkeborg IF,8374,9,6,3,13,28,45,-17,21
Lyngby,8374,10,3,10,11,27,45,-18,19
AGF Aarhus,8374,11,4,6,12,17,39,-22,18
Brondby,8375,1,20,7,3,70,32,38,67
FC Midtjylla,8375,2,18,5,7,66,42,24,59
FC Nords,8375,3,14,8,8,77,52,25,50
Copenhagen,8375,4,13,6,11,56,47,9,45
AaB,8375,5,9,11,10,37,41,-4,38
AC Horsens,8375,6,6,15,9,33,51,-18,33
Sonderjyske,8375,7,8,6,10,28,29,-1,30
Randers FC,8375,8,6,6,12,25,40,-15,24
Silkeborg IF,8375,9,5,4,13,26,45,-19,19
AGF Aarhus,8375,10,4,7,11,17,37,-20,19
Lyngby,8375,11,3,9,12,27,46,-19,18
Brondby,8376,1,21,6,3,77,31,46,69
FC Midtjylla,8376,2,20,5,5,73,44,29,65
Copenhagen,8376,3,14,6,10,59,44,15,48
FC Nords,8376,4,13,8,9,76,61,15,47
AaB,8376,5,7,14,9,35,41,-6,35
Sonderjyske,8376,6,8,6,10,28,29,-1,30
AC Horsens,8376,7,5,13,12,30,55,-25,28
Lyngby,8376,8,4,9,11,28,44,-16,21
Randers FC,8376,9,5,6,13,23,41,-18,21
AGF Aarhus,8376,10,5,6,11,19,37,-18,21
Silkeborg IF,8376,11,5,3,14,26,47,-21,18
Brondby,8377,1,21,7,2,74,33,41,70
FC Midtjylla,8377,2,19,6,5,66,37,29,63
FC Nords,8377,3,13,7,10,70,55,15,46
Copenhagen,8377,4,12,6,12,59,49,10,42
AaB,8377,5,9,12,9,38,40,-2,39
AC Horsens,8377,6,7,12,11,35,54,-19,33
Sonderjyske,8377,7,8,6,10,28,29,-1,30
Silkeborg IF,8377,8,6,3,13,29,44,-15,21
Lyngby,8377,9,4,9,11,29,45,-16,21
Randers FC,8377,10,5,6,13,24,42,-18,21
AGF Aarhus,8377,11,4,6,12,16,40,-24,18
Brondby,8378,1,19,7,4,66,33,33,64
FC Midtjylla,8378,2,19,6,5,63,38,25,63
FC Nords,8378,3,14,8,8,74,48,26,50
Copenhagen,8378,4,13,4,13,55,51,4,43
AC Horsens,8378,5,8,14,8,41,49,-8,38
AaB,8378,6,8,11,11,38,44,-6,35
Sonderjyske,8378,7,8,6,10,28,29,-1,30
Randers FC,8378,8,6,6,12,27,40,-13,24
AGF Aarhus,8378,9,5,6,11,19,38,-19,21
Silkeborg IF,8378,10,5,3,14,27,47,-20,18
Lyngby,8378,11,3,9,12,27,48,-21,18
Brondby,8379,1,19,8,3,70,32,38,65
FC Midtjylla,8379,2,20,5,5,65,41,24,65
FC Nords,8379,3,14,8,8,76,53,23,50
Copenhagen,8379,4,14,5,11,61,48,13,47
AaB,8379,5,7,13,10,41,45,-4,34
AC Horsens,8379,6,6,13,11,37,57,-20,31
Sonderjyske,8379,7,8,6,10,28,29,-1,30
Randers FC,8379,8,6,6,12,25,39,-14,24
Silkeborg IF,8379,9,6,3,13,28,46,-18,21
Lyngby,8379,10,3,9,12,26,46,-20,18
AGF Aarhus,8379,11,4,6,12,18,39,-21,18
Brondby,8380,1,19,6,5,69,34,35,63
FC Midtjylla,8380,2,19,4,7,65,45,20,61
FC Nords,8380,3,14,7,9,77,56,21,49
Copenhagen,8380,4,14,5,11,62,47,15,47
AaB,8380,5,9,12,9,39,41,-2,39
AC Horsens,8380,6,8,12,10,38,53,-15,36
Sonderjyske,8380,7,8,6,10,28,29,-1,30
Randers FC,8380,8,5,7,12,25,41,-16,22
AGF Aarhus,8380,9,5,6,11,19,37,-18,21
Lyngby,8380,10,3,10,11,28,46,-18,19
Silkeborg IF,8380,11,5,3,14,26,47,-21,18
Brondby,8381,1,21,6,3,69,34,35,69
FC Midtjylla,8381,2,20,6,4,76,38,38,66
FC Nords,8381,3,14,7,9,73,50,23,49
Copenhagen,8381,4,13,5,12,54,48,6,44
AaB,8381,5,7,12,11,34,43,-9,33
AC Horsens,8381,6,7,12,11,36,55,-19,33
Sonderjyske,8381,7,8,6,10,28,29,-1,30
Randers FC,8381,8,6,6,12,26,39,-13,24
Silkeborg IF,8381,9,6,3,13,27,45,-18,21
Lyngby,8381,10,3,9,12,26,47,-21,18
AGF Aarhus,8381,11,4,6,12,17,38,-21,18
Brondby,8382,1,20,8,2,68,30,38,68
FC Midtjylla,8382,2,20,5,5,71,38,33,65
FC Nords,8382,3,14,6,10,76,55,21,48
Copenhagen,8382,4,13,4,13,57,53,4,43
AaB,8382,5,9,12,9,40,43,-3,39
AC Horsens,8382,6,6,13,11,37,56,-19,31
Sonderjyske,8382,7,8,6,10,28,29,-1,30
Lyngby,8382,8,4,9,11,29,44,-15,21
Randers FC,8382,9,5,6,13,23,42,-19,21
AGF Aarhus,8382,10,5,6,11,17,36,-19,21
Silkeborg IF,8382,11,5,3,14,25,45,-20,18
Brondby,8383,1,22,5,3,74,36,38,71
FC Midtjylla,8383,2,19,5,6,67,41,26,62
FC Nords,8383,3,14,7,9,80,56,24,49
Copenhagen,8383,4,14,5,11,60,46,14,47
AC Horsens,8383,5,7,13,10,37,56,-19,34
AaB,8383,6,6,13,11,32,41,-9,31
Sonderjyske,8383,7,8,6,10,28,29,-1,30
Randers FC,8383,8,6,6,12,26,40,-14,24
Silkeborg IF,8383,9,6,3,13,26,44,-18,21
Lyngby,8383,10,3,9,12,27,47,-20,18
AGF Aarhus,8383,11,4,6,12,16,37,-21,18
Brondby,8384,1,21,5,4,70,31,39,68
FC Midtjylla,8384,2,19,6,5,65,37,28,63
Copenhagen,8384,3,15,6,9,58,39,19,51
FC Nords,8384,4,14,8,8,71,49,22,50
AC Horsens,8384,5,7,12,11,36,55,-19,33
Sonderjyske,8384,6,8,6,10,28,29,-1,30
AaB,8384,7,6,11,13,32,47,-15,29
Randers FC,8384,8,5,7,12,24,40,-16,22
Silkeborg IF,8384,9,6,3,13,26,44,-18,21
Lyngby,8384,10,3,10,11,27,45,-18,19
AGF Aarhus,8384,11,4,6,12,16,37,-21,18
FC Midtjylla,8385,1,21,4,5,75,38,37,67
Brondby,8385,2,19,6,5,63,36,27,63
Copenhagen,8385,3,15,6,9,59,39,20,51
FC Nords,8385,4,13,8,9,72,54,18,47
AC Horsens,8385,5,7,13,10,34,54,-20,34
AaB,8385,6,7,11,12,34,42,-8,32
Sonderjyske,8385,7,8,6,10,28,29,-1,30
Lyngby,8385,8,4,9,11,28,45,-17,21
Randers FC,8385,9,5,6,13,24,41,-17,21
Silkeborg IF,8385,10,6,3,13,26,44,-18,21
AGF Aarhus,8385,11,4,6,12,16,37,-21,18
Brondby,8386,1,22,5,3,70,32,38,71
FC Midtjylla,8386,2,18,4,8,63,46,17,58
FC Nords,8386,3,15,7,8,77,52,25,52
Copenhagen,8386,4,14,5,11,58,42,16,47
AaB,8386,5,8,13,9,39,41,-2,37
Sonderjyske,8386,6,8,6,10,28,29,-1,30
AC Horsens,8386,7,6,12,12,33,53,-20,30
Lyngby,8386,8,4,9,11,27,44,-17,21
Randers FC,8386,9,5,6,13,23,40,-17,21
Silkeborg IF,8386,10,6,3,13,26,44,-18,21
AGF Aarhus,8386,11,4,6,12,16,37,-21,18
FC Midtjylla,8387,1,21,4,5,68,35,33,67
Brondby,8387,2,19,6,5,68,35,33,63
FC Nords,8387,3,14,6,10,70,56,14,48
Copenhagen,8387,4,14,5,11,58,43,15,47
AC Horsens,8387,5,8,12,10,42,51,-9,36
AaB,8387,6,8,11,11,37,49,-12,35
Sonderjyske,8387,7,8,6,10,28,29,-1,30
Randers FC,8387,8,6,6,12,26,40,-14,24
AGF Aarhus,8387,9,5,6,11,17,36,-19,21
Lyngby,8387,10,3,9,12,27,47,-20,18
Silkeborg IF,8387,11,5,3,14,25,45,-20,18
Brondby,8388,1,20,6,4,69,33,36,66
FC Midtjylla,8388,2,20,5,5,68,36,32,65
Copenhagen,8388,3,15,5,10,56,41,15,50
FC Nords,8388,4,13,8,9,71,54,17,47
AaB,8388,5,8,12,10,38,42,-4,36
Sonderjyske,8388,6,8,6,10,28,29,-1,30
AC Horsens,8388,7,6,12,12,35,57,-22,30
Randers FC,8388,8,5,7,12,24,40,-16,22
Silkeborg IF,8388,9,6,3,13,28,45,-17,21
Lyngby,8388,10,3,10,11,27,45,-18,19
AGF Aarhus,8388,11,4,6,12,17,39,-22,18
Brondby,8389,1,21,6,3,71,33,38,69
FC Midtjylla,8389,2,19,5,6,67,47,20,62
Copenhagen,8389,3,15,4,11,62,44,18,49
FC Nords,8389,4,14,6,10,74,53,21,48
AaB,8389,5,8,12,10,39,44,-5,36
AC Horsens,8389,6,6,13,11,34,52,-18,31
Sonderjyske,8389,7,8,6,10,28,29,-1,30
Randers FC,8389,8,6,6,12,24,39,-15,24
Silkeborg IF,8389,9,6,3,13,26,44,-18,21
Lyngby,8389,10,3,9,12,26,45,-19,18
AGF Aarhus,8389,11,4,6,12,16,37,-21,18
FC Midtjylla,8390,1,21,5,4,71,39,32,68
Brondby,8390,2,19,7,4,71,34,37,64
FC Nords,8390,3,13,8,9,74,55,19,47
Copenhagen,8390,4,13,5,12,54,49,5,44
AC Horsens,8390,5,8,12,10,40,55,-15,36
AaB,8390,6,8,11,11,41,45,-4,35
Sonderjyske,8390,7,8,6,10,28,29,-1,30
Lyngby,8390,8,4,9,11,27,44,-17,21
Randers FC,8390,9,5,6,13,23,40,-17,21
Silkeborg IF,8390,10,6,3,13,26,44,-18,21
AGF Aarhus,8390,11,4,6,12,16,37,-21,18
Brondby,8391,1,21,5,4,68,31,37,68
FC Midtjylla,8391,2,20,4,6,67,41,26,64
FC Nords,8391,3,16,6,8,73,46,27,54
Copenhagen,8391,4,14,4,12,59,47,12,46
AaB,8391,5,9,11,10,39,41,-2,38
Sonderjyske,8391,6,8,6,10,28,29,-1,30
AC Horsens,8391,7,5,12,13,31,57,-26,27
Randers FC,8391,8,6,6,12,25,40,-15,24
AGF Aarhus,8391,9,5,6,11,21,38,-17,21
Lyngby,8391,10,3,9,12,27,46,-19,18
Silkeborg IF,8391,11,5,3,14,27,49,-22,18
Brondby,8392,1,19,8,3,68,34,34,65
FC Midtjylla,8392,2,19,5,6,64,42,22,62
FC Nords,8392,3,15,8,7,79,50,29,53
Copenhagen,8392,4,13,6,11,57,44,13,45
AC Horsens,8392,5,8,12,10,37,52,-15,36
AaB,8392,6,6,13,11,36,45,-9,31
Sonderjyske,8392,7,8,6,10,28,29,-1,30
Lyngby,8392,8,4,9,11,27,44,-17,21
Randers FC,8392,9,5,6,13,23,40,-17,21
AGF Aarhus,8392,10,5,6,11,19,36,-17,21
Silkeborg IF,8392,11,5,3,14,25,47,-22,18
Brondby,8393,1,20,6,4,71,34,37,66
FC Midtjylla,8393,2,19,5,6,62,41,21,62
FC Nords,8393,3,16,6,8,78,51,27,54
Copenhagen,8393,4,15,5,10,58,44,14,50
AaB,8393,5,6,13,11,35,42,-7,31
Sonderjyske,8393,6,8,6,10,28,29,-1,30
AC Horsens,8393,7,5,15,10,32,50,-18,30
Lyngby,8393,8,4,9,11,28,45,-17,21
Silkeborg IF,8393,8,6,3,13,28,45,-17,21
Randers FC,8393,10,5,6,13,24,41,-17,21
AGF Aarhus,8393,11,4,6,12,17,39,-22,18
Brondby,8394,1,20,7,3,71,32,39,67
FC Midtjylla,8394,2,19,5,6,65,42,23,62
Copenhagen,8394,3,15,5,10,58,43,15,50
FC Nords,8394,4,12,7,11,67,54,13,43
AaB,8394,5,7,14,9,36,40,-4,35
AC Horsens,8394,6,7,14,9,38,50,-12,35
Sonderjyske,8394,7,8,6,10,28,29,-1,30
Lyngby,8394,8,4,9,11,28,45,-17,21
Randers FC,8394,9,5,6,13,24,41,-17,21
Silkeborg IF,8394,10,6,3,13,26,44,-18,21
AGF Aarhus,8394,11,4,6,12,16,37,-21,18
Brondby,8395,1,21,6,3,71,32,39,69
FC Midtjylla,8395,2,19,6,5,63,37,26,63
FC Nords,8395,3,14,7,9,74,50,24,49
Copenhagen,8395,4,14,6,10,55,41,14,48
AaB,8395,5,7,12,11,36,44,-8,33
AC Horsens,8395,6,6,13,11,36,57,-21,31
Sonderjyske,8395,7,8,6,10,28,29,-1,30
Randers FC,8395,8,5,7,12,25,41,-16,22
Lyngby,8395,9,3,10,11,28,46,-18,19
Silkeborg IF,8395,10,5,4,13,26,45,-19,19
AGF Aarhus,8395,11,4,7,11,17,37,-20,19
Brondby,8396,1,22,5,3,71,30,41,71
FC Midtjylla,8396,2,18,5,7,62,42,20,59
FC Nords,8396,3,15,6,9,76,53,23,51
Copenhagen,8396,4,15,4,11,59,42,17,49
AaB,8396,5,8,12,10,38,46,-8,36
Sonderjyske,8396,6,8,6,10,28,29,-1,30
AC Horsens,8396,7,5,14,11,36,55,-19,29
Randers FC,8396,8,6,6,12,25,40,-15,24
Silkeborg IF,8396,9,6,3,13,30,45,-15,21
Lyngby,8396,10,3,9,12,27,46,-19,18
AGF Aarhus,8396,11,4,6,12,17,41,-24,18
Brondby,8397,1,20,5,5,72,36,36,65
FC Midtjylla,8397,2,20,4,6,67,40,27,64
FC Nords,8397,3,15,6,9,82,57,25,51
Copenhagen,8397,4,14,4,12,57,47,10,46
AaB,8397,5,8,12,10,39,43,-4,36
AC Horsens,8397,6,7,13,10,39,59,-20,34
Sonderjyske,8397,7,8,6,10,28,29,-1,30
Lyngby,8397,8,4,9,11,28,45,-17,21
Silkeborg IF,8397,8,6,3,13,28,45,-17,21
Randers FC,8397,10,5,6,13,24,41,-17,21
AGF Aarhus,8397,11,4,6,12,17,39,-22,18
Brondby,8398,1,22,6,2,72,29,43,72
FC Midtjylla,8398,2,21,4,5,66,36,30,67
FC Nords,8398,3,14,6,10,70,54,16,48
Copenhagen,8398,4,14,4,12,58,42,16,46
AC Horsens,8398,5,6,14,10,36,54,-18,32
Sonderjyske,8398,6,8,6,10,28,29,-1,30
AaB,8398,7,6,12,12,34,47,-13,30
Silkeborg IF,8398,8,6,3,13,30,44,-14,21
Lyngby,8398,9,4,9,11,27,44,-17,21
Randers FC,8398,10,5,6,13,23,40,-17,21
AGF Aarhus,8398,11,4,6,12,16,41,-25,18
Brondby,8399,1,23,5,2,73,29,44,74
FC Midtjylla,8399,2,18,6,6,61,37,24,60
FC Nords,8399,3,15,7,8,77,50,27,52
Copenhagen,8399,4,14,4,12,58,45,13,46
AaB,8399,5,8,12,10,37,40,-3,36
Sonderjyske,8399,6,8,6,10,28,29,-1,30
AC Horsens,8399,7,5,12,13,32,63,-31,27
Randers FC,8399,8,6,6,12,25,40,-15,24
Silkeborg IF,8399,9,6,3,13,27,44,-17,21
Lyngby,8399,10,3,9,12,27,46,-19,18
AGF Aarhus,8399,11,4,6,12,16,38,-22,18
Brondby,8400,1,20,8,2,75,34,41,68
FC Midtjylla,8400,2,19,6,5,63,38,25,63
FC Nords,8400,3,12,9,9,72,55,17,45
Copenhagen,8400,4,13,6,11,59,47,12,45
AaB,8400,5,7,14,9,39,43,-4,35
AC Horsens,8400,6,7,13,10,37,54,-17,34
Sonderjyske,8400,7,8,6,10,28,29,-1,30
Randers FC,8400,8,5,7,12,24,40,-16,22
Silkeborg IF,8400,9,6,3,13,26,44,-18,21
Lyngby,8400,10,3,10,11,27,45,-18,19
AGF Aarhus,8400,11,4,6,12,16,37,-21,18
Brondby,8401,1,20,6,4,67,33,34,66
FC Midtjylla,8401,2,18,5,7,67,43,24,59
FC Nords,8401,3,15,6,9,76,55,21,51
Copenhagen,8401,4,15,5,10,58,41,17,50
AaB,8401,5,7,14,9,35,42,-7,35
AC Horsens,8401,6,7,12,11,36,51,-15,33
Sonderjyske,8401,7,8,6,10,28,29,-1,30
Randers FC,8401,8,5,7,12,23,39,-16,22
AGF Aarhus,8401,9,5,6,11,19,38,-19,21
Lyngby,8401,10,3,10,11,26,44,-18,19
Silkeborg IF,8401,11,5,3,14,27,47,-20,18
FC Midtjylla,8402,1,21,5,4,68,37,31,68
Brondby,8402,2,19,8,3,68,32,36,65
FC Nords,8402,3,14,7,9,76,51,25,49
Copenhagen,8402,4,13,6,11,61,49,12,45
AaB,8402,5,7,14,9,39,43,-4,35
Sonderjyske,8402,6,8,6,10,28,29,-1,30
AC Horsens,8402,7,5,14,11,35,61,-26,29
Randers FC,8402,8,5,7,12,23,39,-16,22
AGF Aarhus,8402,9,5,6,11,18,37,-19,21
Lyngby,8402,10,3,10,11,26,44,-18,19
Silkeborg IF,8402,11,5,3,14,26,46,-20,18
Brondby,8403,1,21,6,3,71,31,40,69
FC Midtjylla,8403,2,19,6,5,65,40,25,63
FC Nords,8403,3,14,7,9,76,53,23,49
Copenhagen,8403,4,14,5,11,55,42,13,47
AaB,8403,5,8,12,10,35,40,-5,36
Sonderjyske,8403,6,8,6,10,28,29,-1,30
AC Horsens,8403,7,5,14,11,30,52,-22,29
Lyngby,8403,8,4,9,11,28,45,-17,21
Randers FC,8403,9,5,6,13,24,41,-17,21
Silkeborg IF,8403,10,6,3,13,26,44,-18,21
AGF Aarhus,8403,11,4,6,12,16,37,-21,18
Brondby,8404,1,20,7,3,71,32,39,67
FC Midtjylla,8404,2,18,7,5,63,39,24,61
FC Nords,8404,3,14,7,9,78,55,23,49
Copenhagen,8404,4,13,6,11,59,48,11,45
AaB,8404,5,9,12,9,38,39,-1,39
Sonderjyske,8404,6,8,6,10,28,29,-1,30
AC Horsens,8404,7,5,15,10,33,55,-22,30
Lyngby,8404,8,4,9,11,28,45,-17,21
Randers FC,8404,9,5,6,13,24,41,-17,21
Silkeborg IF,8404,10,5,4,13,26,45,-19,19
AGF Aarhus,8404,11,4,7,11,17,37,-20,19
Brondby,8405,1,21,6,3,72,32,40,69
FC Midtjylla,8405,2,20,6,4,68,37,31,66
FC Nords,8405,3,14,7,9,73,52,21,49
Copenhagen,8405,4,14,6,10,59,44,15,48
AaB,8405,5,6,14,10,35,43,-8,32
Sonderjyske,8405,6,8,6,10,28,29,-1,30
AC Horsens,8405,7,5,13,12,36,61,-25,28
Lyngby,8405,8,4,9,11,27,44,-17,21
Randers FC,8405,9,5,6,13,23,40,-17,21
Silkeborg IF,8405,10,5,4,13,27,46,-19,19
AGF Aarhus,8405,11,4,7,11,18,38,-20,19
FC Midtjylla,8406,1,21,4,5,70,34,36,67
Brondby,8406,2,20,5,5,70,34,36,65
FC Nords,8406,3,14,6,10,71,57,14,48
Copenhagen,8406,4,13,5,12,57,50,7,44
AaB,8406,5,10,12,8,38,36,2,42
Sonderjyske,8406,6,8,6,10,28,29,-1,30
AC Horsens,8406,7,6,12,12,32,53,-21,30
Lyngby,8406,8,4,9,11,28,45,-17,21
Silkeborg IF,8406,8,6,3,13,28,45,-17,21
Randers FC,8406,10,5,6,13,24,41,-17,21
AGF Aarhus,8406,11,4,6,12,17,39,-22,18
Brondby,8407,1,20,6,4,67,32,35,66
FC Midtjylla,8407,2,20,5,5,64,39,25,65
FC Nords,8407,3,14,6,10,73,51,22,48
Copenhagen,8407,4,13,5,12,54,42,12,44
AaB,8407,5,10,11,9,37,36,1,41
AC Horsens,8407,6,6,13,11,34,55,-21,31
Sonderjyske,8407,7,8,6,10,28,29,-1,30
Lyngby,8407,8,4,9,11,27,44,-17,21
Randers FC,8407,9,5,6,13,23,40,-17,21
AGF Aarhus,8407,10,5,6,11,19,38,-19,21
Silkeborg IF,8407,11,5,3,14,27,47,-20,18
FC Midtjylla,8408,1,21,4,5,69,39,30,67
Brondby,8408,2,20,6,4,64,31,33,66
FC Nords,8408,3,15,6,9,71,49,22,51
Copenhagen,8408,4,13,4,13,57,47,10,43
AaB,8408,5,9,11,10,38,41,-3,38
AC Horsens,8408,6,6,13,11,33,51,-18,31
Sonderjyske,8408,7,8,6,10,28,29,-1,30
Lyngby,8408,8,4,9,11,29,45,-16,21
Randers FC,8408,9,5,6,13,24,42,-18,21
AGF Aarhus,8408,10,5,6,11,18,36,-18,21
Silkeborg IF,8408,11,5,3,14,25,46,-21,18
Brondby,8409,1,20,7,3,72,34,38,67
FC Midtjylla,8409,2,20,4,6,64,38,26,64
FC Nords,8409,3,14,6,10,73,53,20,48
Copenhagen,8409,4,14,5,11,60,45,15,47
AaB,8409,5,8,12,10,36,40,-4,36
AC Horsens,8409,6,7,12,11,37,58,-21,33
Sonderjyske,8409,7,8,6,10,28,29,-1,30
Silkeborg IF,8409,8,6,3,13,29,45,-16,21
Lyngby,8409,9,4,9,11,28,44,-16,21
Randers FC,8409,10,5,6,13,23,41,-18,21
AGF Aarhus,8409,11,4,6,12,17,40,-23,18
Brondby,8410,1,20,5,5,65,32,33,65
FC Midtjylla,8410,2,19,5,6,66,41,25,62
Copenhagen,8410,3,16,4,10,62,42,20,52
FC Nords,8410,4,14,7,9,75,53,22,49
AC Horsens,8410,5,7,13,10,37,55,-18,34
AaB,8410,6,7,12,11,36,44,-8,33
Sonderjyske,8410,7,8,6,10,28,29,-1,30
Lyngby,8410,8,4,9,11,28,44,-16,21
Silkeborg IF,8410,9,6,3,13,27,45,-18,21
Randers FC,8410,10,5,6,13,23,41,-18,21
AGF Aarhus,8410,11,4,6,12,17,38,-21,18
FC Midtjylla,8411,1,20,5,5,65,40,25,65
Brondby,8411,2,19,6,5,71,40,31,63
FC Nords,8411,3,16,7,7,81,50,31,55
Copenhagen,8411,4,12,6,12,52,46,6,42
AC Horsens,8411,5,8,13,9,39,49,-10,37
AaB,8411,6,6,13,11,36,45,-9,31
Sonderjyske,8411,7,8,6,10,28,29,-1,30
Lyngby,8411,8,4,9,11,28,45,-17,21
Randers FC,8411,9,5,6,13,24,41,-17,21
Silkeborg IF,8411,10,6,3,13,26,44,-18,21
AGF Aarhus,8411,11,4,6,12,16,37,-21,18
Brondby,8412,1,21,6,3,72,31,41,69
FC Midtjylla,8412,2,19,5,6,63,40,23,62
FC Nords,8412,3,14,7,9,68,46,22,49
Copenhagen,8412,4,15,4,11,57,44,13,49
AaB,8412,5,8,12,10,37,44,-7,36
Sonderjyske,8412,6,8,6,10,28,29,-1,30
AC Horsens,8412,7,6,12,12,35,53,-18,30
Randers FC,8412,8,6,6,12,25,40,-15,24
AGF Aarhus,8412,9,5,6,11,17,36,-19,21
Lyngby,8412,10,3,9,12,27,46,-19,18
Silkeborg IF,8412,11,5,3,14,25,45,-20,18
Brondby,8413,1,20,7,3,71,33,38,67
FC Midtjylla,8413,2,19,5,6,67,43,24,62
Copenhagen,8413,3,15,6,9,62,43,19,51
FC Nords,8413,4,14,7,9,70,54,16,49
AaB,8413,5,7,12,11,40,45,-5,33
Sonderjyske,8413,6,8,6,10,28,29,-1,30
AC Horsens,8413,7,5,15,10,36,54,-18,30
Randers FC,8413,8,6,6,12,24,39,-15,24
AGF Aarhus,8413,9,5,6,11,17,36,-19,21
Lyngby,8413,10,3,9,12,26,45,-19,18
Silkeborg IF,8413,11,5,3,14,25,45,-20,18
Brondby,8414,1,22,5,3,72,33,39,71
FC Midtjylla,8414,2,18,5,7,62,40,22,59
FC Nords,8414,3,15,6,9,79,51,28,51
Copenhagen,8414,4,12,5,13,54,49,5,41
AaB,8414,5,9,12,9,42,43,-1,39
AC Horsens,8414,6,7,13,10,36,55,-19,34
Sonderjyske,8414,7,8,6,10,28,29,-1,30
Randers FC,8414,8,6,6,12,24,39,-15,24
Silkeborg IF,8414,9,5,4,13,26,45,-19,19
AGF Aarhus,8414,10,4,7,11,17,37,-20,19
Lyngby,8414,11,3,9,12,26,45,-19,18
Brondby,8415,1,22,5,3,77,30,47,71
FC Midtjylla,8415,2,18,4,8,62,46,16,58
FC Nords,8415,3,15,7,8,77,52,25,52
Copenhagen,8415,4,13,6,11,54,45,9,45
AaB,8415,5,8,13,9,37,41,-4,37
AC Horsens,8415,6,6,13,11,34,53,-19,31
Sonderjyske,8415,7,8,6,10,28,29,-1,30
Randers FC,8415,8,6,6,12,24,39,-15,24
Silkeborg IF,8415,9,6,3,13,27,44,-17,21
Lyngby,8415,10,3,9,12,26,45,-19,18
AGF Aarhus,8415,11,4,6,12,16,38,-22,18
Brondby,8416,1,21,6,3,69,32,37,69
FC Midtjylla,8416,2,20,4,6,66,39,27,64
FC Nords,8416,3,15,7,8,78,50,28,52
Copenhagen,8416,4,13,5,12,56,49,7,44
AaB,8416,5,8,12,10,39,40,-1,36
Sonderjyske,8416,6,8,6,10,28,29,-1,30
AC Horsens,8416,7,6,12,12,33,57,-24,30
Randers FC,8416,8,5,7,12,24,40,-16,22
AGF Aarhus,8416,9,5,6,11,18,37,-19,21
Lyngby,8416,10,3,10,11,27,45,-18,19
Silkeborg IF,8416,11,5,3,14,26,46,-20,18
Brondby,8417,1,19,8,3,67,32,35,65
FC Midtjylla,8417,2,19,7,4,68,36,32,64
FC Nords,8417,3,14,7,9,75,54,21,49
Copenhagen,8417,4,14,5,11,58,43,15,47
AaB,8417,5,9,11,10,40,44,-4,38
Sonderjyske,8417,6,8,6,10,28,29,-1,30
AC Horsens,8417,7,5,14,11,31,56,-25,29
Randers FC,8417,8,5,7,12,23,39,-16,22
Silkeborg IF,8417,9,6,3,13,28,46,-18,21
Lyngby,8417,10,3,10,11,26,44,-18,19
AGF Aarhus,8417,11,4,6,12,18,39,-21,18
FC Midtjylla,8418,1,20,6,4,65,35,30,66
Brondby,8418,2,19,7,4,67,32,35,64
FC Nords,8418,3,15,6,9,79,53,26,51
Copenhagen,8418,4,15,5,10,57,42,15,50
AaB,8418,5,6,14,10,35,47,-12,32
Sonderjyske,8418,6,8,6,10,28,29,-1,30
AC Horsens,8418,7,5,14,11,32,52,-20,29
Randers FC,8418,8,6,6,12,25,40,-15,24
Silkeborg IF,8418,9,6,3,13,27,45,-18,21
Lyngby,8418,10,3,9,12,27,46,-19,18
AGF Aarhus,8418,11,4,6,12,17,38,-21,18
Brondby,8419,1,21,6,3,74,32,42,69
FC Midtjylla,8419,2,20,5,5,68,37,31,65
Copenhagen,8419,3,16,5,9,59,42,17,53
FC Nords,8419,4,13,7,10,69,54,15,46
AaB,8419,5,7,12,11,37,47,-10,33
Sonderjyske,8419,6,8,6,10,28,29,-1,30
AC Horsens,8419,7,5,13,12,33,54,-21,28
Lyngby,8419,8,4,9,11,29,45,-16,21
Randers FC,8419,9,5,6,13,24,42,-18,21
AGF Aarhus,8419,10,5,6,11,18,37,-19,21
Silkeborg IF,8419,11,5,3,14,26,46,-20,18
Brondby,8420,1,19,6,5,66,35,31,63
FC Midtjylla,8420,2,17,8,5,62,39,23,59
FC Nords,8420,3,15,8,7,74,50,24,53
Copenhagen,8420,4,13,7,10,56,43,13,46
AaB,8420,5,9,11,10,39,40,-1,38
AC Horsens,8420,6,6,14,10,33,49,-16,32
Sonderjyske,8420,7,8,6,10,28,29,-1,30
Randers FC,8420,8,6,6,12,24,39,-15,24
Silkeborg IF,8420,9,6,3,13,28,46,-18,21
Lyngby,8420,10,3,9,12,26,45,-19,18
AGF Aarhus,8420,11,4,6,12,18,39,-21,18
Brondby,8421,1,21,6,3,73,33,40,69
FC Midtjylla,8421,2,20,4,6,63,39,24,64
FC Nords,8421,3,16,6,8,78,49,29,54
Copenhagen,8421,4,13,6,11,57,45,12,45
AaB,8421,5,7,11,12,39,50,-11,32
AC Horsens,8421,6,6,13,11,33,53,-20,31
Sonderjyske,8421,7,8,6,10,28,29,-1,30
Randers FC,8421,8,5,7,12,23,39,-16,22
Silkeborg IF,8421,9,6,3,13,28,45,-17,21
Lyngby,8421,10,3,10,11,26,44,-18,19
AGF Aarhus,8421,11,4,6,12,17,39,-22,18
Brondby,8422,1,21,7,2,71,29,42,70
FC Midtjylla,8422,2,20,5,5,68,38,30,65
FC Nords,8422,3,13,9,8,69,50,19,48
Copenhagen,8422,4,12,8,10,55,45,10,44
AaB,8422,5,6,14,10,37,44,-7,32
AC Horsens,8422,6,6,13,11,34,54,-20,31
Sonderjyske,8422,7,8,6,10,28,29,-1,30
Lyngby,8422,8,4,9,11,27,44,-17,21
Silkeborg IF,8422,8,6,3,13,27,44,-17,21
Randers FC,8422,10,5,6,13,23,40,-17,21
AGF Aarhus,8422,11,4,6,12,16,38,-22,18
Brondby,8423,1,23,5,2,75,30,45,74
FC Midtjylla,8423,2,20,5,5,69,39,30,65
FC Nords,8423,3,14,7,9,73,53,20,49
Copenhagen,8423,4,12,4,14,55,50,5,40
AaB,8423,5,7,13,10,36,44,-8,34
AC Horsens,8423,6,7,12,11,35,53,-18,33
Sonderjyske,8423,7,8,6,10,28,29,-1,30
Randers FC,8423,8,6,6,12,24,39,-15,24
Silkeborg IF,8423,9,6,3,13,26,44,-18,21
Lyngby,8423,10,3,9,12,26,45,-19,18
AGF Aarhus,8423,11,4,6,12,16,37,-21,18
Brondby,8424,1,22,5,3,75,34,41,71
FC Midtjylla,8424,2,19,4,7,63,41,22,61
FC Nords,8424,3,14,8,8,75,52,23,50
Copenhagen,8424,4,14,6,10,58,43,15,48
AaB,8424,5,7,11,12,40,48,-8,32
AC Horsens,8424,6,6,14,10,35,54,-19,32
Sonderjyske,8424,7,8,6,10,28,29,-1,30
Randers FC,8424,8,5,7,12,23,39,-16,22
Silkeborg IF,8424,9,6,3,13,26,44,-18,21
Lyngby,8424,10,3,10,11,26,44,-18,19
AGF Aarhus,8424,11,4,6,12,16,37,-21,18
FC Midtjylla,8425,1,21,5,4,70,36,34,68
Brondby,8425,2,20,7,3,67,30,37,67
FC Nords,8425,3,15,7,8,73,50,23,52
Copenhagen,8425,4,13,5,12,54,48,6,44
AaB,8425,5,7,11,12,36,44,-8,32
AC Horsens,8425,6,6,13,11,33,51,-18,31
Sonderjyske,8425,7,8,6,10,28,29,-1,30
Lyngby,8425,8,4,9,11,31,46,-15,21
Silkeborg IF,8425,9,6,3,13,27,44,-17,21
Randers FC,8425,10,5,6,13,25,44,-19,21
AGF Aarhus,8425,11,4,6,12,16,38,-22,18
Brondby,8426,1,22,5,3,75,32,43,71
FC Midtjylla,8426,2,18,5,7,63,41,22,59
FC Nords,8426,3,16,7,7,79,47,32,55
Copenhagen,8426,4,13,4,13,57,50,7,43
AaB,8426,5,8,13,9,38,44,-6,37
Sonderjyske,8426,6,8,6,10,28,29,-1,30
AC Horsens,8426,7,6,12,12,34,58,-24,30
Lyngby,8426,8,4,9,11,28,44,-16,21
Randers FC,8426,9,5,6,13,23,41,-18,21
AGF Aarhus,8426,10,5,6,11,18,37,-19,21
Silkeborg IF,8426,11,5,3,14,26,46,-20,18
Brondby,8427,1,21,5,4,70,31,39,68
FC Midtjylla,8427,2,18,5,7,59,40,19,59
Copenhagen,8427,3,16,5,9,60,41,19,53
FC Nords,8427,4,12,8,10,68,51,17,44
AC Horsens,8427,5,8,13,9,35,48,-13,37
AaB,8427,6,7,12,11,36,43,-7,33
Sonderjyske,8427,7,8,6,10,28,29,-1,30
Lyngby,8427,8,4,9,11,27,44,-17,21
Randers FC,8427,9,5,6,13,23,40,-17,21
AGF Aarhus,8427,10,5,6,11,19,36,-17,21
Silkeborg IF,8427,11,5,3,14,25,47,-22,18
Brondby,8428,1,20,7,3,70,32,38,67
FC Midtjylla,8428,2,20,4,6,65,42,23,64
FC Nords,8428,3,14,8,8,76,53,23,50
Copenhagen,8428,4,15,5,10,59,42,17,50
AC Horsens,8428,5,7,12,11,37,54,-17,33
Sonderjyske,8428,6,8,6,10,28,29,-1,30
AaB,8428,7,6,12,12,34,44,-10,30
Randers FC,8428,8,6,6,12,25,40,-15,24
Silkeborg IF,8428,9,6,3,13,27,44,-17,21
Lyngby,8428,10,3,9,12,27,46,-19,18
AGF Aarhus,8428,11,4,6,12,16,38,-22,18
Brondby,8429,1,21,6,3,72,32,40,69
FC Midtjylla,8429,2,21,4,5,67,37,30,67
Copenhagen,8429,3,15,5,10,62,46,16,50
FC Nords,8429,4,14,6,10,72,54,18,48
AaB,8429,5,7,12,11,39,46,-7,33
Sonderjyske,8429,6,8,6,10,28,29,-1,30
AC Horsens,8429,7,5,13,12,31,54,-23,28
Lyngby,8429,8,4,9,11,27,44,-17,21
Randers FC,8429,9,5,6,13,23,40,-17,21
Silkeborg IF,8429,10,5,4,13,26,45,-19,19
AGF Aarhus,8429,11,4,7,11,17,37,-20,19
Brondby,8430,1,21,6,3,70,31,39,69
FC Midtjylla,8430,2,20,5,5,66,36,30,65
FC Nords,8430,3,15,7,8,77,52,25,52
Copenhagen,8430,4,13,6,11,57,46,11,45
AC Horsens,8430,5,7,13,10,35,52,-17,34
Sonderjyske,8430,6,8,6,10,28,29,-1,30
AaB,8430,7,6,11,13,32,46,-14,29
Randers FC,8430,8,5,7,12,23,39,-16,22
Silkeborg IF,8430,9,6,3,13,28,45,-17,21
Lyngby,8430,10,3,10,11,26,44,-18,19
AGF Aarhus,8430,11,4,6,12,17,39,-22,18
Brondby,8431,1,20,7,3,68,31,37,67
FC Midtjylla,8431,2,18,7,5,64,39,25,61
FC Nords,8431,3,14,9,7,71,48,23,51
Copenhagen,8431,4,14,6,10,59,45,14,48
AaB,8431,5,7,13,10,35,42,-7,34
Sonderjyske,8431,6,8,6,10,28,29,-1,30
AC Horsens,8431,7,5,14,11,35,53,-18,29
Lyngby,8431,8,4,9,11,29,46,-17,21
Silkeborg IF,8431,9,6,3,13,27,44,-17,21
Randers FC,8431,10,5,6,13,25,42,-17,21
AGF Aarhus,8431,11,4,6,12,16,38,-22,18
Brondby,8432,1,21,7,2,73,33,40,70
FC Midtjylla,8432,2,21,4,5,67,38,29,67
FC Nords,8432,3,13,7,10,73,54,19,46
Copenhagen,8432,4,14,4,12,58,43,15,46
AaB,8432,5,8,11,11,36,44,-8,35
AC Horsens,8432,6,6,13,11,36,57,-21,31
Sonderjyske,8432,7,8,6,10,28,29,-1,30
Lyngby,8432,8,4,9,11,27,44,-17,21
Randers FC,8432,9,5,6,13,23,40,-17,21
Silkeborg IF,8432,10,5,4,13,27,46,-19,19
AGF Aarhus,8432,11,4,7,11,18,38,-20,19
Brondby,8433,1,21,5,4,71,36,35,68
FC Midtjylla,8433,2,20,5,5,67,38,29,65
FC Nords,8433,3,15,7,8,77,52,25,52
Copenhagen,8433,4,13,4,13,54,52,2,43
AaB,8433,5,9,13,8,41,37,4,40
Sonderjyske,8433,6,8,6,10,28,29,-1,30
AC Horsens,8433,7,5,12,13,32,53,-21,27
Randers FC,8433,8,5,7,12,24,40,-16,22
Lyngby,8433,9,3,10,11,27,45,-18,19
Silkeborg IF,8433,10,5,4,13,26,45,-19,19
AGF Aarhus,8433,11,4,7,11,17,37,-20,19
Brondby,8434,1,22,5,3,71,29,42,71
FC Midtjylla,8434,2,21,4,5,66,37,29,67
FC Nords,8434,3,13,8,9,69,53,16,47
Copenhagen,8434,4,12,5,13,53,47,6,41
AaB,8434,5,8,12,10,38,41,-3,36
AC Horsens,8434,6,7,12,11,35,51,-16,33
Sonderjyske,8434,7,8,6,10,28,29,-1,30
Lyngby,8434,8,4,9,11,28,45,-17,21
Randers FC,8434,9,5,6,13,24,41,-17,21
Silkeborg IF,8434,10,6,3,13,26,44,-18,21
AGF Aarhus,8434,11,4,6,12,16,37,-21,18
Brondby,8435,1,21,6,3,70,31,39,69
FC Midtjylla,8435,2,18,5,7,60,42,18,59
Copenhagen,8435,3,16,5,9,61,39,22,53
FC Nords,8435,4,15,7,8,76,48,28,52
AaB,8435,5,7,11,12,35,47,-12,32
Sonderjyske,8435,6,8,6,10,28,29,-1,30
AC Horsens,8435,7,6,12,12,31,52,-21,30
Randers FC,8435,8,5,7,12,23,39,-16,22
Silkeborg IF,8435,9,6,3,13,28,44,-16,21
Lyngby,8435,10,3,10,11,26,44,-18,19
AGF Aarhus,8435,11,4,6,12,16,39,-23,18
Brondby,8436,1,21,5,4,77,36,41,68
FC Midtjylla,8436,2,21,4,5,67,37,30,67
FC Nords,8436,3,15,6,9,74,52,22,51
Copenhagen,8436,4,15,4,11,62,45,17,49
AaB,8436,5,7,11,12,37,48,-11,32
Sonderjyske,8436,6,8,6,10,28,29,-1,30
AC Horsens,8436,7,6,12,12,35,60,-25,30
Randers FC,8436,8,5,7,12,24,40,-16,22
Silkeborg IF,8436,9,6,3,13,26,44,-18,21
Lyngby,8436,10,3,10,11,27,45,-18,19
AGF Aarhus,8436,11,4,6,12,16,37,-21,18
Brondby,8437,1,21,6,3,70,29,41,69
FC Midtjylla,8437,2,20,4,6,65,40,25,64
FC Nords,8437,3,15,7,8,74,51,23,52
Copenhagen,8437,4,14,5,11,56,45,11,47
AC Horsens,8437,5,6,13,11,39,52,-13,31
AaB,8437,6,6,13,11,34,47,-13,31
Sonderjyske,8437,7,8,6,10,28,29,-1,30
Lyngby,8437,8,4,9,11,31,46,-15,21
Randers FC,8437,9,5,6,13,25,44,-19,21
Silkeborg IF,8437,10,5,4,13,25,44,-19,19
AGF Aarhus,8437,11,4,7,11,16,36,-20,19
FC Midtjylla,8438,1,20,5,5,69,40,29,65
Brondby,8438,2,18,6,6,66,35,31,60
FC Nords,8438,3,15,8,7,75,49,26,53
Copenhagen,8438,4,14,4,12,55,43,12,46
AaB,8438,5,8,13,9,39,44,-5,37
AC Horsens,8438,6,6,14,10,36,55,-19,32
Sonderjyske,8438,7,8,6,10,28,29,-1,30
Randers FC,8438,8,6,6,12,24,39,-15,24
AGF Aarhus,8438,9,5,6,11,18,37,-19,21
Lyngby,8438,10,3,9,12,26,45,-19,18
Silkeborg IF,8438,11,5,3,14,26,46,-20,18
Brondby,8439,1,22,5,3,74,33,41,71
FC Midtjylla,8439,2,19,5,6,70,47,23,62
FC Nords,8439,3,15,7,8,74,48,26,52
Copenhagen,8439,4,14,4,12,58,46,12,46
AC Horsens,8439,5,7,12,11,36,56,-20,33
AaB,8439,6,7,11,12,37,45,-8,32
Sonderjyske,8439,7,8,6,10,28,29,-1,30
Randers FC,8439,8,5,7,12,24,40,-16,22
AGF Aarhus,8439,9,5,6,11,20,36,-16,21
Lyngby,8439,10,3,10,11,27,45,-18,19
Silkeborg IF,8439,11,5,3,14,25,48,-23,18
FC Midtjylla,8440,1,21,4,5,65,37,28,67
Brondby,8440,2,19,6,5,67,34,33,63
FC Nords,8440,3,14,7,9,74,54,20,49
Copenhagen,8440,4,14,4,12,58,47,11,46
AaB,8440,5,9,12,9,43,43,0,39
AC Horsens,8440,6,6,13,11,35,53,-18,31
Sonderjyske,8440,7,8,6,10,28,29,-1,30
Randers FC,8440,8,6,6,12,25,39,-14,24
AGF Aarhus,8440,9,5,6,11,17,36,-19,21
Lyngby,8440,10,3,9,12,26,46,-20,18
Silkeborg IF,8440,11,5,3,14,25,45,-20,18
Brondby,8441,1,22,5,3,69,30,39,71
FC Midtjylla,8441,2,20,4,6,65,38,27,64
Copenhagen,8441,3,15,6,9,58,40,18,51
FC Nords,8441,4,14,7,9,72,53,19,49
AC Horsens,8441,5,6,13,11,34,53,-19,31
Sonderjyske,8441,6,8,6,10,28,29,-1,30
AaB,8441,7,6,11,13,35,45,-10,29
Lyngby,8441,8,4,9,11,27,44,-17,21
Randers FC,8441,9,5,6,13,23,40,-17,21
Silkeborg IF,8441,10,6,3,13,27,45,-18,21
AGF Aarhus,8441,11,4,6,12,17,38,-21,18
Brondby,8442,1,21,6,3,73,31,42,69
FC Midtjylla,8442,2,19,5,6,67,40,27,62
FC Nords,8442,3,14,8,8,70,51,19,50
Copenhagen,8442,4,13,6,11,53,42,11,45
AaB,8442,5,8,12,10,37,44,-7,36
AC Horsens,8442,6,6,13,11,32,50,-18,31
Sonderjyske,8442,7,8,6,10,28,29,-1,30
Randers FC,8442,8,5,7,12,25,41,-16,22
Lyngby,8442,9,3,10,11,28,46,-18,19
Silkeborg IF,8442,10,5,4,13,27,46,-19,19
AGF Aarhus,8442,11,4,7,11,18,38,-20,19
Brondby,8443,1,21,6,3,73,28,45,69
FC Midtjylla,8443,2,20,4,6,67,40,27,64
FC Nords,8443,3,15,7,8,73,52,21,52
Copenhagen,8443,4,14,4,12,57,47,10,46
AaB,8443,5,8,13,9,40,42,-2,37
Sonderjyske,8443,6,8,6,10,28,29,-1,30
AC Horsens,8443,7,5,12,13,31,58,-27,27
Lyngby,8443,8,4,9,11,28,45,-17,21
Silkeborg IF,8443,8,6,3,13,28,45,-17,21
Randers FC,8443,10,5,6,13,24,41,-17,21
AGF Aarhus,8443,11,4,6,12,17,39,-22,18
Brondby,8444,1,20,7,3,67,30,37,67
FC Midtjylla,8444,2,20,6,4,68,34,34,66
FC Nords,8444,3,13,8,9,70,51,19,47
Copenhagen,8444,4,13,7,10,57,43,14,46
AaB,8444,5,7,12,11,34,43,-9,33
AC Horsens,8444,6,7,12,11,33,54,-21,33
Sonderjyske,8444,7,8,6,10,28,29,-1,30
Lyngby,8444,8,4,9,11,29,44,-15,21
Randers FC,8444,9,5,6,13,23,42,-19,21
Silkeborg IF,8444,10,5,4,13,26,45,-19,19
AGF Aarhus,8444,11,4,7,11,17,37,-20,19
FC Midtjylla,8445,1,21,4,5,71,38,33,67
Brondby,8445,2,20,6,4,70,37,33,66
FC Nords,8445,3,13,8,9,72,54,18,47
Copenhagen,8445,4,13,4,13,54,46,8,43
AC Horsens,8445,5,8,13,9,37,50,-13,37
AaB,8445,6,8,11,11,36,41,-5,35
Sonderjyske,8445,7,8,6,10,28,29,-1,30
Randers FC,8445,8,5,7,12,24,40,-16,22
AGF Aarhus,8445,9,5,6,11,19,37,-18,21
Lyngby,8445,10,3,10,11,27,45,-18,19
Silkeborg IF,8445,11,5,3,14,26,47,-21,18
Brondby,8446,1,20,8,2,67,30,37,68
FC Midtjylla,8446,2,18,6,6,64,40,24,60
FC Nords,8446,3,14,7,9,71,50,21,49
Copenhagen,8446,4,12,6,12,55,48,7,42
AaB,8446,5,8,12,10,40,46,-6,36
AC Horsens,8446,6,7,15,8,38,47,-9,36
Sonderjyske,8446,7,8,6,10,28,29,-1,30
Lyngby,8446,8,4,9,11,30,44,-14,21
Silkeborg IF,8446,9,6,3,13,26,44,-18,21
Randers FC,8446,10,5,6,13,23,43,-20,21
AGF Aarhus,8446,11,4,6,12,16,37,-21,18
Brondby,8447,1,21,7,2,72,32,40,70
FC Midtjylla,8447,2,19,5,6,63,41,22,62
FC Nords,8447,3,15,6,9,76,57,19,51
Copenhagen,8447,4,14,4,12,58,44,14,46
AaB,8447,5,8,12,10,41,41,0,36
Sonderjyske,8447,6,8,6,10,28,29,-1,30
AC Horsens,8447,7,5,14,11,35,56,-21,29
Randers FC,8447,8,5,7,12,26,42,-16,22
AGF Aarhus,8447,9,5,6,11,17,36,-19,21
Lyngby,8447,10,3,10,11,29,47,-18,19
Silkeborg IF,8447,11,5,3,14,25,45,-20,18
Brondby,8448,1,20,6,4,72,33,39,66
FC Midtjylla,8448,2,19,5,6,63,41,22,62
FC Nords,8448,3,14,7,9,70,50,20,49
Copenhagen,8448,4,14,5,11,58,44,14,47
AaB,8448,5,7,14,9,34,39,-5,35
AC Horsens,8448,6,7,13,10,36,52,-16,34
Sonderjyske,8448,7,8,6,10,28,29,-1,30
Lyngby,8448,8,4,9,11,27,44,-17,21
Randers FC,8448,9,5,6,13,23,40,-17,21
Silkeborg IF,8448,10,5,4,13,26,45,-19,19
AGF Aarhus,8448,11,4,7,11,17,37,-20,19
Brondby,8449,1,20,7,3,72,33,39,67
FC Midtjylla,8449,2,20,5,5,70,39,31,65
FC Nords,8449,3,14,9,7,80,48,32,51
Copenhagen,8449,4,12,5,13,55,50,5,41
AC Horsens,8449,5,8,12,10,35,56,-21,36
AaB,8449,6,7,12,11,34,46,-12,33
Sonderjyske,8449,7,8,6,10,28,29,-1,30
Lyngby,8449,8,4,9,11,27,44,-17,21
Randers FC,8449,9,5,6,13,23,40,-17,21
Silkeborg IF,8449,10,5,4,13,25,44,-19,19
AGF Aarhus,8449,11,4,7,11,16,36,-20,19
Brondby,8450,1,22,6,2,72,30,42,72
FC Midtjylla,8450,2,21,5,4,67,36,31,68
FC Nords,8450,3,14,6,10,75,54,21,48
Copenhagen,8450,4,12,5,13,57,51,6,41
AaB,8450,5,7,13,10,38,41,-3,34
AC Horsens,8450,6,6,13,11,35,58,-23,31
Sonderjyske,8450,7,8,6,10,28,29,-1,30
Lyngby,8450,8,4,9,11,28,44,-16,21
Randers FC,8450,9,5,6,13,23,41,-18,21
Silkeborg IF,8450,10,5,4,13,26,45,-19,19
AGF Aarhus,8450,11,4,7,11,17,37,-20,19
FC Midtjylla,8451,1,20,6,4,72,35,37,66
Brondby,8451,2,19,7,4,65,32,33,64
FC Nords,8451,3,14,7,9,74,52,22,49
Copenhagen,8451,4,13,6,11,57,48,9,45
AaB,8451,5,8,11,11,35,46,-11,35
AC Horsens,8451,6,6,15,9,36,52,-16,33
Sonderjyske,8451,7,8,6,10,28,29,-1,30
Randers FC,8451,8,6,6,12,24,39,-15,24
AGF Aarhus,8451,9,5,6,11,19,38,-19,21
Lyngby,8451,10,3,9,12,26,45,-19,18
Silkeborg IF,8451,11,5,3,14,27,47,-20,18
Brondby,8452,1,21,6,3,75,31,44,69
FC Midtjylla,8452,2,20,5,5,67,35,32,65
Copenhagen,8452,3,16,5,9,59,39,20,53
FC Nords,8452,4,13,6,11,69,60,9,45
AaB,8452,5,6,13,11,33,44,-11,31
AC Horsens,8452,6,6,13,11,35,55,-20,31
Sonderjyske,8452,7,8,6,10,28,29,-1,30
Lyngby,8452,8,4,9,11,27,44,-17,21
Randers FC,8452,9,5,6,13,23,40,-17,21
Silkeborg IF,8452,10,6,3,13,26,44,-18,21
AGF Aarhus,8452,11,4,6,12,16,37,-21,18
FC Midtjylla,8453,1,20,4,6,64,41,23,64
Brondby,8453,2,19,6,5,67,36,31,63
Copenhagen,8453,3,15,5,10,63,44,19,50
FC Nords,8453,4,13,9,8,69,49,20,48
AaB,8453,5,9,11,10,38,41,-3,38
AC Horsens,8453,6,6,13,11,36,52,-16,31
Sonderjyske,8453,7,8,6,10,28,29,-1,30
Randers FC,8453,8,6,6,12,26,40,-14,24
Silkeborg IF,8453,9,5,4,13,26,45,-19,19
AGF Aarhus,8453,10,4,7,11,17,37,-20,19
Lyngby,8453,11,3,9,12,27,47,-20,18
Brondby,8454,1,22,5,3,71,31,40,71
FC Midtjylla,8454,2,21,5,4,64,36,28,68
FC Nords,8454,3,15,7,8,75,52,23,52
Copenhagen,8454,4,13,4,13,57,47,10,43
AaB,8454,5,7,11,12,36,47,-11,32
Sonderjyske,8454,6,8,6,10,28,29,-1,30
AC Horsens,8454,7,6,12,12,37,53,-16,30
Randers FC,8454,8,5,7,12,24,40,-16,22
Silkeborg IF,8454,9,6,3,13,28,45,-17,21
Lyngby,8454,10,3,10,11,27,45,-18,19
AGF Aarhus,8454,11,4,6,12,17,39,-22,18
Brondby,8455,1,21,6,3,70,34,36,69
FC Midtjylla,8455,2,20,5,5,65,37,28,65
FC Nords,8455,3,14,7,9,74,51,23,49
Copenhagen,8455,4,14,5,11,64,49,15,47
AaB,8455,5,8,13,9,41,44,-3,37
Sonderjyske,8455,6,8,6,10,28,29,-1,30
AC Horsens,8455,7,5,12,13,33,58,-25,27
Lyngby,8455,8,4,9,11,30,44,-14,21
Randers FC,8455,9,5,6,13,23,43,-20,21
Silkeborg IF,8455,10,5,4,13,26,45,-19,19
AGF Aarhus,8455,11,4,7,11,17,37,-20,19
FC Midtjylla,8456,1,19,7,4,66,40,26,64
Brondby,8456,2,19,5,6,69,39,30,62
FC Nords,8456,3,13,9,8,75,51,24,48
Copenhagen,8456,4,14,5,11,61,49,12,47
AaB,8456,5,9,12,9,40,42,-2,39
AC Horsens,8456,6,6,14,10,36,52,-16,32
Sonderjyske,8456,7,8,6,10,28,29,-1,30
Lyngby,8456,8,4,9,11,31,44,-13,21
AGF Aarhus,8456,9,5,6,11,17,36,-19,21
Randers FC,8456,10,5,6,13,23,44,-21,21
Silkeborg IF,8456,11,5,3,14,25,45,-20,18
Brondby,8457,1,20,7,3,71,35,36,67
FC Midtjylla,8457,2,18,7,5,65,38,27,61
FC Nords,8457,3,15,8,7,82,52,30,53
Copenhagen,8457,4,14,5,11,57,45,12,47
AaB,8457,5,7,13,10,35,41,-6,34
Sonderjyske,8457,6,8,6,10,28,29,-1,30
AC Horsens,8457,7,5,14,11,32,57,-25,29
Randers FC,8457,8,6,6,12,25,40,-15,24
Silkeborg IF,8457,9,6,3,13,26,44,-18,21
Lyngby,8457,10,3,9,12,27,46,-19,18
AGF Aarhus,8457,11,4,6,12,16,37,-21,18
Brondby,8458,1,20,7,3,71,34,37,67
FC Midtjylla,8458,2,18,5,7,59,42,17,59
Copenhagen,8458,3,16,5,9,62,40,22,53
FC Nords,8458,4,13,7,10,70,52,18,46
AaB,8458,5,8,13,9,38,39,-1,37
AC Horsens,8458,6,6,13,11,33,52,-19,31
Sonderjyske,8458,7,8,6,10,28,29,-1,30
Randers FC,8458,8,5,7,12,24,40,-16,22
Silkeborg IF,8458,9,6,3,13,29,45,-16,21
Lyngby,8458,10,3,10,11,27,45,-18,19
AGF Aarhus,8458,11,4,6,12,17,40,-23,18
Brondby,8459,1,20,6,4,69,34,35,66
FC Midtjylla,8459,2,19,5,6,68,42,26,62
FC Nords,8459,3,15,6,9,75,53,22,51
Copenhagen,8459,4,13,6,11,56,46,10,45
AaB,8459,5,8,13,9,40,43,-3,37
AC Horsens,8459,6,7,12,11,38,54,-16,33
Sonderjyske,8459,7,8,6,10,28,29,-1,30
Silkeborg IF,8459,8,6,3,13,29,44,-15,21
Lyngby,8459,9,4,9,11,28,45,-17,21
Randers FC,8459,10,5,6,13,24,41,-17,21
AGF Aarhus,8459,11,4,6,12,16,40,-24,18
FC Midtjylla,8460,1,21,5,4,65,36,29,68
Brondby,8460,2,20,6,4,65,30,35,66
FC Nords,8460,3,15,7,8,75,50,25,52
Copenhagen,8460,4,13,6,11,58,46,12,45
AaB,8460,5,7,12,11,37,44,-7,33
Sonderjyske,8460,6,8,6,10,28,29,-1,30
AC Horsens,8460,7,5,14,11,33,53,-20,29
Randers FC,8460,8,6,6,12,25,39,-14,24
Silkeborg IF,8460,9,6,3,13,27,44,-17,21
Lyngby,8460,10,3,9,12,26,46,-20,18
AGF Aarhus,8460,11,4,6,12,16,38,-22,18
Brondby,8461,1,20,5,5,68,39,29,65
FC Midtjylla,8461,2,19,4,7,67,41,26,61
FC Nords,8461,3,15,6,9,77,55,22,51
Copenhagen,8461,4,14,5,11,58,44,14,47
AaB,8461,5,8,12,10,40,47,-7,36
AC Horsens,8461,6,8,12,10,38,48,-10,36
Sonderjyske,8461,7,8,6,10,28,29,-1,30
Lyngby,8461,8,4,9,11,28,44,-16,21
Silkeborg IF,8461,9,6,3,13,26,44,-18,21
Randers FC,8461,10,5,6,13,23,41,-18,21
AGF Aarhus,8461,11,4,6,12,16,37,-21,18
Brondby,8462,1,21,6,3,71,33,38,69
FC Midtjylla,8462,2,19,5,6,64,38,26,62
FC Nords,8462,3,15,6,9,73,48,25,51
Copenhagen,8462,4,14,4,12,55,45,10,46
AC Horsens,8462,5,8,13,9,40,50,-10,37
Sonderjyske,8462,6,8,6,10,28,29,-1,30
AaB,8462,7,6,12,12,32,47,-15,30
Randers FC,8462,8,6,6,12,25,40,-15,24
Silkeborg IF,8462,9,5,4,13,26,45,-19,19
AGF Aarhus,8462,10,4,7,11,17,37,-20,19
Lyngby,8462,11,3,9,12,27,46,-19,18
Brondby,8463,1,21,5,4,71,31,40,68
FC Midtjylla,8463,2,19,4,7,60,39,21,61
FC Nords,8463,3,14,6,10,74,50,24,48
Copenhagen,8463,4,14,5,11,54,41,13,47
AaB,8463,5,9,12,9,36,42,-6,39
AC Horsens,8463,6,7,12,11,34,52,-18,33
Sonderjyske,8463,7,8,6,10,28,29,-1,30
Randers FC,8463,8,5,7,12,24,40,-16,22
Lyngby,8463,9,3,10,11,27,45,-18,19
Silkeborg IF,8463,10,5,4,13,27,46,-19,19
AGF Aarhus,8463,11,4,7,11,18,38,-20,19
Brondby,8464,1,22,6,2,75,31,44,72
FC Midtjylla,8464,2,18,4,8,61,45,16,58
FC Nords,8464,3,16,6,8,74,48,26,54
Copenhagen,8464,4,14,6,10,60,42,18,48
AaB,8464,5,7,11,12,38,46,-8,32
AC Horsens,8464,6,6,13,11,34,56,-22,31
Sonderjyske,8464,7,8,6,10,28,29,-1,30
Lyngby,8464,8,4,9,11,28,44,-16,21
Silkeborg IF,8464,8,6,3,13,28,44,-16,21
Randers FC,8464,10,5,6,13,23,41,-18,21
AGF Aarhus,8464,11,4,6,12,16,39,-23,18
Brondby,8465,1,22,5,3,73,36,37,71
FC Midtjylla,8465,2,20,5,5,71,40,31,65
FC Nords,8465,3,13,7,10,74,56,18,46
Copenhagen,8465,4,13,5,12,55,50,5,44
AaB,8465,5,7,13,10,34,39,-5,34
AC Horsens,8465,6,6,15,9,35,47,-12,33
Sonderjyske,8465,7,8,6,10,28,29,-1,30
Randers FC,8465,8,6,6,12,24,39,-15,24
Silkeborg IF,8465,9,6,3,13,30,44,-14,21
Lyngby,8465,10,3,9,12,26,45,-19,18
AGF Aarhus,8465,11,4,6,12,16,41,-25,18
Brondby,8466,1,22,6,2,74,30,44,72
FC Midtjylla,8466,2,19,5,6,68,43,25,62
FC Nords,8466,3,15,7,8,77,52,25,52
Copenhagen,8466,4,13,4,13,55,52,3,43
AaB,8466,5,7,12,11,35,44,-9,33
AC Horsens,8466,6,7,12,11,41,55,-14,33
Sonderjyske,8466,7,8,6,10,28,29,-1,30
Lyngby,8466,8,4,9,11,30,46,-16,21
Randers FC,8466,9,5,6,13,25,43,-18,21
Silkeborg IF,8466,10,5,4,13,26,45,-19,19
AGF Aarhus,8466,11,4,7,11,17,37,-20,19
Brondby,8467,1,20,8,2,71,34,37,68
FC Midtjylla,8467,2,19,5,6,65,38,27,62
FC Nords,8467,3,14,7,9,75,52,23,49
Copenhagen,8467,4,13,5,12,57,50,7,44
AaB,8467,5,8,12,10,42,44,-2,36
AC Horsens,8467,6,7,13,10,40,58,-18,34
Sonderjyske,8467,7,8,6,10,28,29,-1,30
Randers FC,8467,8,5,7,12,25,41,-16,22
AGF Aarhus,8467,9,5,6,11,19,38,-19,21
Lyngby,8467,10,3,10,11,28,46,-18,19
Silkeborg IF,8467,11,5,3,14,27,47,-20,18
FC Midtjylla,8468,1,21,5,4,64,35,29,68
Brondby,8468,2,20,6,4,71,36,35,66
Copenhagen,8468,3,14,7,9,61,45,16,49
FC Nords,8468,4,12,8,10,72,54,18,44
AaB,8468,5,7,12,11,35,42,-7,33
AC Horsens,8468,6,6,14,10,34,51,-17,32
Sonderjyske,8468,7,8,6,10,28,29,-1,30
Lyngby,8468,8,4,9,11,29,44,-15,21
Silkeborg IF,8468,9,6,3,13,26,44,-18,21
Randers FC,8468,10,5,6,13,23,42,-19,21
AGF Aarhus,8468,11,4,6,12,16,37,-21,18
Brondby,8469,1,20,7,3,74,33,41,67
FC Midtjylla,8469,2,20,5,5,70,40,30,65
FC Nords,8469,3,13,8,9,74,56,18,47
Copenhagen,8469,4,14,5,11,58,46,12,47
AC Horsens,8469,5,8,12,10,38,50,-12,36
AaB,8469,6,6,13,11,33,48,-15,31
Sonderjyske,8469,7,8,6,10,28,29,-1,30
Randers FC,8469,8,5,7,12,24,40,-16,22
Silkeborg IF,8469,9,6,3,13,28,46,-18,21
Lyngby,8469,10,3,10,11,27,45,-18,19
AGF Aarhus,8469,11,4,6,12,18,39,-21,18
Brondby,8470,1,20,7,3,73,34,39,67
FC Midtjylla,8470,2,21,4,5,68,38,30,67
Copenhagen,8470,3,15,4,11,59,46,13,49
FC Nords,8470,4,13,7,10,71,57,14,46
AaB,8470,5,8,12,10,38,42,-4,36
Sonderjyske,8470,6,8,6,10,28,29,-1,30
AC Horsens,8470,7,5,14,11,32,50,-18,29
Lyngby,8470,8,4,9,11,31,44,-13,21
Silkeborg IF,8470,9,6,3,13,27,44,-17,21
Randers FC,8470,10,5,6,13,23,44,-21,21
AGF Aarhus,8470,11,4,6,12,16,38,-22,18
Brondby,8471,1,20,7,3,66,31,35,67
FC Midtjylla,8471,2,20,6,4,67,36,31,66
FC Nords,8471,3,13,9,8,70,48,22,48
Copenhagen,8471,4,12,7,11,53,45,8,43
AC Horsens,8471,5,7,13,10,36,53,-17,34
AaB,8471,6,7,12,11,36,41,-5,33
Sonderjyske,8471,7,8,6,10,28,29,-1,30
Lyngby,8471,8,4,9,11,29,46,-17,21
Randers FC,8471,9,5,6,13,25,42,-17,21
Silkeborg IF,8471,10,5,4,13,27,46,-19,19
AGF Aarhus,8471,11,4,7,11,18,38,-20,19
Brondby,8472,1,21,7,2,72,30,42,70
FC Midtjylla,8472,2,18,7,5,67,43,24,61
FC Nords,8472,3,15,6,9,75,52,23,51
Copenhagen,8472,4,13,6,11,58,46,12,45
AC Horsens,8472,5,7,14,9,37,51,-14,35
Sonderjyske,8472,6,8,6,10,28,29,-1,30
AaB,8472,7,6,12,12,38,51,-13,30
Lyngby,8472,8,4,9,11,28,44,-16,21
Randers FC,8472,9,5,6,13,23,41,-18,21
Silkeborg IF,8472,10,5,4,13,26,45,-19,19
AGF Aarhus,8472,11,4,7,11,17,37,-20,19
FC Midtjylla,8473,1,21,4,5,70,38,32,67
Brondby,8473,2,20,6,4,72,37,35,66
FC Nords,8473,3,15,7,8,71,49,22,52
Copenhagen,8473,4,12,6,12,53,46,7,42
AaB,8473,5,7,12,11,37,46,-9,33
AC Horsens,8473,6,6,15,9,38,51,-13,33
Sonderjyske,8473,7,8,6,10,28,29,-1,30
Lyngby,8473,8,4,9,11,31,45,-14,21
Silkeborg IF,8473,9,6,3,13,26,44,-18,21
Randers FC,8473,10,5,6,13,24,44,-20,21
AGF Aarhus,8473,11,4,6,12,16,37,-21,18
Brondby,8474,1,21,6,3,68,29,39,69
FC Midtjylla,8474,2,20,4,6,66,41,25,64
FC Nords,8474,3,13,8,9,73,52,21,47
Copenhagen,8474,4,14,5,11,61,46,15,47
AC Horsens,8474,5,7,13,10,36,52,-16,34
AaB,8474,6,7,12,11,34,44,-10,33
Sonderjyske,8474,7,8,6,10,28,29,-1,30
Lyngby,8474,8,4,9,11,27,44,-17,21
Randers FC,8474,9,5,6,13,23,40,-17,21
AGF Aarhus,8474,10,5,6,11,17,36,-19,21
Silkeborg IF,8474,11,5,3,14,25,45,-20,18
Brondby,8475,1,20,8,2,71,34,37,68
FC Midtjylla,8475,2,19,6,5,62,37,25,63
Copenhagen,8475,3,14,6,10,56,41,15,48
FC Nords,8475,4,13,7,10,75,57,18,46
AaB,8475,5,8,13,9,39,41,-2,37
Sonderjyske,8475,6,8,6,10,28,29,-1,30
AC Horsens,8475,7,5,14,11,36,55,-19,29
Randers FC,8475,8,5,7,12,26,42,-16,22
Silkeborg IF,8475,9,6,3,13,27,44,-17,21
Lyngby,8475,10,3,10,11,29,47,-18,19
AGF Aarhus,8475,11,4,6,12,16,38,-22,18
Brondby,8476,1,19,7,4,69,35,34,64
FC Midtjylla,8476,2,17,7,6,62,41,21,58
FC Nords,8476,3,15,8,7,78,51,27,53
Copenhagen,8476,4,14,5,11,57,45,12,47
AaB,8476,5,7,15,8,36,39,-3,36
AC Horsens,8476,6,6,14,10,37,54,-17,32
Sonderjyske,8476,7,8,6,10,28,29,-1,30
Randers FC,8476,8,6,6,12,26,40,-14,24
AGF Aarhus,8476,9,5,6,11,17,36,-19,21
Lyngby,8476,10,3,9,12,27,47,-20,18
Silkeborg IF,8476,11,5,3,14,25,45,-20,18
FC Midtjylla,8477,1,20,5,5,67,38,29,65
Brondby,8477,2,18,5,7,68,41,27,59
Copenhagen,8477,3,15,4,11,64,48,16,49
FC Nords,8477,4,13,6,11,70,57,13,45
AaB,8477,5,10,11,9,41,39,2,41
AC Horsens,8477,6,8,13,9,38,51,-13,37
Sonderjyske,8477,7,8,6,10,28,29,-1,30
Lyngby,8477,8,4,9,11,30,46,-16,21
Randers FC,8477,9,5,6,13,25,43,-18,21
AGF Aarhus,8477,10,5,6,11,20,38,-18,21
Silkeborg IF,8477,11,5,3,14,27,48,-21,18
FC Midtjylla,8478,1,21,5,4,71,40,31,68
Brondby,8478,2,20,6,4,72,36,36,66
FC Nords,8478,3,13,6,11,70,52,18,45
Copenhagen,8478,4,13,5,12,58,50,8,44
AaB,8478,5,8,14,8,43,45,-2,38
AC Horsens,8478,6,6,14,10,35,52,-17,32
Sonderjyske,8478,7,8,6,10,28,29,-1,30
Randers FC,8478,8,6,6,12,25,39,-14,24
Silkeborg IF,8478,9,5,4,13,26,45,-19,19
AGF Aarhus,8478,10,4,7,11,17,37,-20,19
Lyngby,8478,11,3,9,12,26,46,-20,18
Brondby,8479,1,20,6,4,67,32,35,66
FC Midtjylla,8479,2,19,5,6,65,41,24,62
Copenhagen,8479,3,15,5,10,61,42,19,50
FC Nords,8479,4,14,7,9,77,52,25,49
AaB,8479,5,8,11,11,35,44,-9,35
AC Horsens,8479,6,7,12,11,39,59,-20,33
Sonderjyske,8479,7,8,6,10,28,29,-1,30
Randers FC,8479,8,6,6,12,25,40,-15,24
Silkeborg IF,8479,9,6,3,13,26,44,-18,21
Lyngby,8479,10,3,9,12,27,46,-19,18
AGF Aarhus,8479,11,4,6,12,16,37,-21,18
Brondby,8480,1,23,5,2,74,29,45,74
FC Midtjylla,8480,2,20,5,5,71,41,30,65
FC Nords,8480,3,15,6,9,74,50,24,51
Copenhagen,8480,4,13,6,11,55,46,9,45
AC Horsens,8480,5,6,13,11,32,52,-20,31
Sonderjyske,8480,6,8,6,10,28,29,-1,30
AaB,8480,7,6,11,13,33,47,-14,29
Randers FC,8480,8,6,6,12,25,40,-15,24
Silkeborg IF,8480,9,6,3,13,27,44,-17,21
Lyngby,8480,10,3,9,12,27,46,-19,18
AGF Aarhus,8480,11,4,6,12,16,38,-22,18
Brondby,8481,1,21,6,3,67,31,36,69
FC Midtjylla,8481,2,21,4,5,70,38,32,67
FC Nords,8481,3,13,7,10,74,56,18,46
Copenhagen,8481,4,13,6,11,57,47,10,45
AaB,8481,5,9,12,9,40,43,-3,39
Sonderjyske,8481,6,8,6,10,28,29,-1,30
AC Horsens,8481,7,5,13,12,31,50,-19,28
Randers FC,8481,8,5,7,12,24,40,-16,22
Lyngby,8481,9,3,10,11,27,45,-18,19
Silkeborg IF,8481,10,5,4,13,25,44,-19,19
AGF Aarhus,8481,11,4,7,11,16,36,-20,19
Brondby,8482,1,20,5,5,72,38,34,65
FC Midtjylla,8482,2,20,5,5,69,38,31,65
Copenhagen,8482,3,15,5,10,62,44,18,50
FC Nords,8482,4,14,6,10,70,58,12,48
AaB,8482,5,7,13,10,38,40,-2,34
AC Horsens,8482,6,6,14,10,36,55,-19,32
Sonderjyske,8482,7,8,6,10,28,29,-1,30
Randers FC,8482,8,5,7,12,23,39,-16,22
Silkeborg IF,8482,9,6,3,13,27,44,-17,21
Lyngby,8482,10,3,10,11,26,44,-18,19
AGF Aarhus,8482,11,4,6,12,16,38,-22,18
Brondby,8483,1,21,6,3,66,29,37,69
FC Midtjylla,8483,2,20,4,6,66,37,29,64
FC Nords,8483,3,14,7,9,70,54,16,49
Copenhagen,8483,4,12,4,14,52,46,6,40
AC Horsens,8483,5,8,13,9,39,50,-11,37
AaB,8483,6,8,12,10,39,42,-3,36
Sonderjyske,8483,7,8,6,10,28,29,-1,30
Randers FC,8483,8,5,7,12,25,41,-16,22
AGF Aarhus,8483,9,5,6,11,18,37,-19,21
Lyngby,8483,10,3,10,11,28,46,-18,19
Silkeborg IF,8483,11,5,3,14,26,46,-20,18
Brondby,8484,1,20,8,2,71,34,37,68
FC Midtjylla,8484,2,20,5,5,63,34,29,65
FC Nords,8484,3,14,8,8,72,50,22,50
Copenhagen,8484,4,13,5,12,54,44,10,44
AaB,8484,5,7,13,10,39,46,-7,34
Sonderjyske,8484,6,8,6,10,28,29,-1,30
AC Horsens,8484,7,5,15,10,36,53,-17,30
Lyngby,8484,8,4,9,11,29,44,-15,21
Silkeborg IF,8484,9,6,3,13,26,44,-18,21
Randers FC,8484,10,5,6,13,23,42,-19,21
AGF Aarhus,8484,11,4,6,12,16,37,-21,18
Brondby,8485,1,21,5,4,73,33,40,68
FC Midtjylla,8485,2,21,4,5,67,38,29,67
Copenhagen,8485,3,15,5,10,60,44,16,50
FC Nords,8485,4,13,7,10,69,54,15,46
AaB,8485,5,7,12,11,38,46,-8,33
Sonderjyske,8485,6,8,6,10,28,29,-1,30
AC Horsens,8485,7,5,15,10,33,51,-18,30
Lyngby,8485,8,4,9,11,28,44,-16,21
Silkeborg IF,8485,9,6,3,13,26,44,-18,21
Randers FC,8485,10,5,6,13,23,41,-18,21
AGF Aarhus,8485,11,4,6,12,16,37,-21,18
Brondby,8486,1,22,6,2,77,33,44,72
FC Midtjylla,8486,2,20,4,6,65,41,24,64
FC Nords,8486,3,14,6,10,74,53,21,48
Copenhagen,8486,4,13,4,13,58,50,8,43
AaB,8486,5,8,11,11,40,47,-7,35
AC Horsens,8486,6,7,13,10,36,52,-16,34
Sonderjyske,8486,7,8,6,10,28,29,-1,30
Randers FC,8486,8,6,6,12,25,40,-15,24
Silkeborg IF,8486,9,6,3,13,27,45,-18,21
Lyngby,8486,10,3,9,12,27,46,-19,18
AGF Aarhus,8486,11,4,6,12,17,38,-21,18
Brondby,8487,1,20,5,5,69,36,33,65
FC Midtjylla,8487,2,19,4,7,63,40,23,61
Copenhagen,8487,3,14,7,9,58,42,16,49
FC Nords,8487,4,13,9,8,74,53,21,48
AC Horsens,8487,5,7,14,9,39,50,-11,35
AaB,8487,6,7,13,10,37,45,-8,34
Sonderjyske,8487,7,8,6,10,28,29,-1,30
Lyngby,8487,8,4,9,11,29,46,-17,21
Randers FC,8487,9,5,6,13,25,42,-17,21
Silkeborg IF,8487,10,6,3,13,26,44,-18,21
AGF Aarhus,8487,11,4,6,12,16,37,-21,18
FC Midtjylla,8488,1,20,4,6,67,37,30,64
Brondby,8488,2,19,6,5,67,33,34,63
FC Nords,8488,3,14,7,9,69,50,19,49
Copenhagen,8488,4,15,4,11,60,46,14,49
AaB,8488,5,9,11,10,41,46,-5,38
AC Horsens,8488,6,7,12,11,36,54,-18,33
Sonderjyske,8488,7,8,6,10,28,29,-1,30
Lyngby,8488,8,4,9,11,31,47,-16,21
Randers FC,8488,9,5,6,13,26,44,-18,21
AGF Aarhus,8488,10,5,6,11,18,37,-19,21
Silkeborg IF,8488,11,5,3,14,26,46,-20,18
Brondby,8489,1,20,6,4,67,33,34,66
FC Midtjylla,8489,2,19,4,7,65,39,26,61
Copenhagen,8489,3,17,4,9,67,42,25,55
FC Nords,8489,4,14,7,9,73,55,18,49
AaB,8489,5,8,11,11,38,40,-2,35
Sonderjyske,8489,6,8,6,10,28,29,-1,30
AC Horsens,8489,7,5,14,11,30,57,-27,29
Randers FC,8489,8,5,7,12,25,41,-16,22
Lyngby,8489,9,3,10,11,28,46,-18,19
Silkeborg IF,8489,10,5,4,13,25,44,-19,19
AGF Aarhus,8489,11,4,7,11,16,36,-20,19
Brondby,8490,1,22,5,3,72,31,41,71
FC Midtjylla,8490,2,17,6,7,62,44,18,57
FC Nords,8490,3,16,6,8,77,51,26,54
Copenhagen,8490,4,13,6,11,55,45,10,45
AaB,8490,5,7,13,10,37,43,-6,34
AC Horsens,8490,6,6,14,10,37,52,-15,32
Sonderjyske,8490,7,8,6,10,28,29,-1,30
Randers FC,8490,8,5,7,12,23,39,-16,22
Lyngby,8490,9,3,10,11,26,44,-18,19
Silkeborg IF,8490,10,5,4,13,26,45,-19,19
AGF Aarhus,8490,11,4,7,11,17,37,-20,19
FC Midtjylla,8491,1,20,6,4,68,40,28,66
Brondby,8491,2,19,7,4,69,37,32,64
FC Nords,8491,3,14,8,8,75,50,25,50
Copenhagen,8491,4,13,5,12,58,47,11,44
AaB,8491,5,8,12,10,37,42,-5,36
AC Horsens,8491,6,6,14,10,36,53,-17,32
Sonderjyske,8491,7,8,6,10,28,29,-1,30
Randers FC,8491,8,6,6,12,26,41,-15,24
Silkeborg IF,8491,9,6,3,13,27,45,-18,21
Lyngby,8491,10,3,9,12,28,47,-19,18
AGF Aarhus,8491,11,4,6,12,17,38,-21,18
Brondby,8492,1,21,5,4,70,33,37,68
FC Midtjylla,8492,2,19,5,6,64,41,23,62
FC Nords,8492,3,15,6,9,78,52,26,51
Copenhagen,8492,4,13,5,12,56,45,11,44
AaB,8492,5,9,11,10,38,43,-5,38
AC Horsens,8492,6,6,14,10,37,55,-18,32
Sonderjyske,8492,7,8,6,10,28,29,-1,30
Randers FC,8492,8,6,6,12,25,40,-15,24
AGF Aarhus,8492,9,5,6,11,19,37,-18,21
Lyngby,8492,10,3,9,12,27,46,-19,18
Silkeborg IF,8492,11,5,3,14,26,47,-21,18
Brondby,8493,1,22,5,3,77,29,48,71
FC Midtjylla,8493,2,18,6,6,67,46,21,60
FC Nords,8493,3,15,6,9,78,53,25,51
Copenhagen,8493,4,15,4,11,59,46,13,49
AaB,8493,5,7,13,10,36,46,-10,34
Sonderjyske,8493,6,8,6,10,28,29,-1,30
AC Horsens,8493,7,5,14,11,35,58,-23,29
Randers FC,8493,8,6,6,12,25,39,-14,24
AGF Aarhus,8493,9,5,6,11,17,36,-19,21
Lyngby,8493,10,3,9,12,26,46,-20,18
Silkeborg IF,8493,11,5,3,14,25,45,-20,18
FC Midtjylla,8494,1,22,4,4,72,38,34,70
Brondby,8494,2,20,6,4,71,33,38,66
FC Nords,8494,3,15,6,9,73,54,19,51
Copenhagen,8494,4,14,5,11,55,42,13,47
AaB,8494,5,6,13,11,34,44,-10,31
Sonderjyske,8494,6,8,6,10,28,29,-1,30
AC Horsens,8494,7,5,14,11,33,53,-20,29
Randers FC,8494,8,5,7,12,23,39,-16,22
Lyngby,8494,9,3,10,11,26,44,-18,19
Silkeborg IF,8494,10,5,4,13,26,45,-19,19
AGF Aarhus,8494,11,4,7,11,17,37,-20,19
Brondby,8495,1,21,6,3,71,33,38,69
FC Midtjylla,8495,2,18,5,7,62,40,22,59
FC Nords,8495,3,13,7,10,69,52,17,46
Copenhagen,8495,4,14,4,12,55,43,12,46
AC Horsens,8495,5,8,14,8,36,47,-11,38
AaB,8495,6,8,12,10,38,42,-4,36
Sonderjyske,8495,7,8,6,10,28,29,-1,30
Lyngby,8495,8,4,9,11,28,45,-17,21
Randers FC,8495,9,5,6,13,24,41,-17,21
AGF Aarhus,8495,10,5,6,11,21,40,-19,21
Silkeborg IF,8495,11,5,3,14,29,49,-20,18
Brondby,8496,1,21,6,3,72,32,40,69
FC Midtjylla,8496,2,21,4,5,70,38,32,67
FC Nords,8496,3,13,8,9,72,53,19,47
Copenhagen,8496,4,14,4,12,58,45,13,46
AC Horsens,8496,5,8,12,10,38,55,-17,36
Sonderjyske,8496,6,8,6,10,28,29,-1,30
AaB,8496,7,6,12,12,36,49,-13,30
Randers FC,8496,8,5,7,12,23,39,-16,22
AGF Aarhus,8496,9,5,6,11,17,36,-19,21
Lyngby,8496,10,3,10,11,26,44,-18,19
Silkeborg IF,8496,11,5,3,14,25,45,-20,18
Brondby,8497,1,19,8,3,69,34,35,65
FC Midtjylla,8497,2,19,6,5,62,38,24,63
FC Nords,8497,3,13,8,9,71,52,19,47
Copenhagen,8497,4,13,6,11,55,44,11,45
AaB,8497,5,8,13,9,38,38,0,37
AC Horsens,8497,6,7,13,10,33,48,-15,34
Sonderjyske,8497,7,8,6,10,28,29,-1,30
Lyngby,8497,8,4,9,11,28,45,-17,21
Randers FC,8497,9,5,6,13,24,41,-17,21
Silkeborg IF,8497,10,5,4,13,26,45,-19,19
AGF Aarhus,8497,11,4,7,11,17,37,-20,19
Brondby,8498,1,21,5,4,73,34,39,68
FC Midtjylla,8498,2,18,6,6,66,41,25,60
FC Nords,8498,3,15,6,9,75,54,21,51
Copenhagen,8498,4,14,4,12,60,50,10,46
AaB,8498,5,9,12,9,44,45,-1,39
AC Horsens,8498,6,6,13,11,32,52,-20,31
Sonderjyske,8498,7,8,6,10,28,29,-1,30
Lyngby,8498,8,4,9,11,30,44,-14,21
Silkeborg IF,8498,9,6,3,13,27,45,-18,21
Randers FC,8498,10,5,6,13,23,43,-20,21
AGF Aarhus,8498,11,4,6,12,17,38,-21,18
Brondby,8499,1,22,6,2,73,30,43,72
FC Midtjylla,8499,2,18,4,8,60,42,18,58
FC Nords,8499,3,16,6,8,76,51,25,54
Copenhagen,8499,4,14,4,12,55,47,8,46
AC Horsens,8499,5,7,13,10,38,53,-15,34
AaB,8499,6,7,11,12,35,40,-5,32
Sonderjyske,8499,7,8,6,10,28,29,-1,30
Randers FC,8499,8,5,7,12,25,41,-16,22
AGF Aarhus,8499,9,5,6,11,18,37,-19,21
Lyngby,8499,10,3,10,11,28,46,-18,19
Silkeborg IF,8499,11,5,3,14,26,46,-20,18
Brondby,8500,1,20,6,4,74,33,41,66
FC Midtjylla,8500,2,18,7,5,65,42,23,61
FC Nords,8500,3,15,7,8,76,52,24,52
Copenhagen,8500,4,13,5,12,55,49,6,44
AaB,8500,5,7,14,9,40,45,-5,35
AC Horsens,8500,6,6,15,9,37,52,-15,33
Sonderjyske,8500,7,8,6,10,28,29,-1,30
Randers FC,8500,8,6,6,12,25,40,-15,24
AGF Aarhus,8500,9,5,6,11,19,36,-17,21
Lyngby,8500,10,3,9,12,27,46,-19,18
Silkeborg IF,8500,11,5,3,14,25,47,-22,18
Brondby,8501,1,22,6,2,70,27,43,72
FC Midtjylla,8501,2,19,5,6,63,42,21,62
Copenhagen,8501,3,15,4,11,56,43,13,49
FC Nords,8501,4,14,6,10,72,52,20,48
AaB,8501,5,7,11,12,37,42,-5,32
AC Horsens,8501,6,6,14,10,32,50,-18,32
Sonderjyske,8501,7,8,6,10,28,29,-1,30
Randers FC,8501,8,6,6,12,25,40,-15,24
Silkeborg IF,8501,9,5,4,13,26,45,-19,19
AGF Aarhus,8501,10,4,7,11,17,37,-20,19
Lyngby,8501,11,3,9,12,27,46,-19,18
Brondby,8502,1,22,6,2,71,31,40,72
FC Midtjylla,8502,2,19,5,6,65,39,26,62
FC Nords,8502,3,14,6,10,73,51,22,48
Copenhagen,8502,4,13,6,11,57,46,11,45
AC Horsens,8502,5,8,12,10,37,52,-15,36
AaB,8502,6,7,11,12,36,46,-10,32
Sonderjyske,8502,7,8,6,10,28,29,-1,30
Randers FC,8502,8,5,7,12,23,39,-16,22
Silkeborg IF,8502,9,6,3,13,28,46,-18,21
Lyngby,8502,10,3,10,11,26,44,-18,19
AGF Aarhus,8502,11,4,6,12,18,39,-21,18
Brondby,8503,1,20,7,3,71,33,38,67
FC Midtjylla,8503,2,20,5,5,72,37,35,65
FC Nords,8503,3,12,8,10,72,57,15,44
Copenhagen,8503,4,13,5,12,58,50,8,44
AaB,8503,5,10,11,9,46,46,0,41
AC Horsens,8503,6,6,14,10,33,55,-22,32
Sonderjyske,8503,7,8,6,10,28,29,-1,30
Randers FC,8503,8,5,7,12,25,41,-16,22
Silkeborg IF,8503,9,6,3,13,26,44,-18,21
Lyngby,8503,10,3,10,11,28,46,-18,19
AGF Aarhus,8503,11,4,6,12,16,37,-21,18
Brondby,8504,1,21,6,3,70,32,38,69
FC Midtjylla,8504,2,18,5,7,62,42,20,59
FC Nords,8504,3,15,7,8,74,49,25,52
Copenhagen,8504,4,13,8,9,60,46,14,47
AaB,8504,5,8,11,11,38,43,-5,35
AC Horsens,8504,6,6,13,11,37,55,-18,31
Sonderjyske,8504,7,8,6,10,28,29,-1,30
Randers FC,8504,8,6,6,12,24,39,-15,24
AGF Aarhus,8504,9,5,6,11,18,36,-18,21
Lyngby,8504,10,3,9,12,26,45,-19,18
Silkeborg IF,8504,11,5,3,14,25,46,-21,18
Brondby,8505,1,21,5,4,70,31,39,68
FC Midtjylla,8505,2,20,5,5,64,37,27,65
Copenhagen,8505,3,15,4,11,59,43,16,49
FC Nords,8505,4,14,6,10,72,51,21,48
AaB,8505,5,9,12,9,36,40,-4,39
Sonderjyske,8505,6,8,6,10,28,29,-1,30
AC Horsens,8505,7,5,12,13,30,55,-25,27
Silkeborg IF,8505,8,6,3,13,28,44,-16,21
Lyngby,8505,9,4,9,11,28,45,-17,21
Randers FC,8505,10,5,6,13,24,41,-17,21
AGF Aarhus,8505,11,4,6,12,16,39,-23,18
Brondby,8506,1,21,5,4,70,33,37,68
FC Midtjylla,8506,2,17,6,7,62,43,19,57
Copenhagen,8506,3,15,5,10,65,46,19,50
FC Nords,8506,4,13,7,10,69,53,16,46
AC Horsens,8506,5,10,12,8,43,50,-7,42
AaB,8506,6,7,11,12,37,47,-10,32
Sonderjyske,8506,7,8,6,10,28,29,-1,30
Lyngby,8506,8,4,9,11,30,45,-15,21
Silkeborg IF,8506,9,6,3,13,27,45,-18,21
Randers FC,8506,10,5,6,13,24,43,-19,21
AGF Aarhus,8506,11,4,6,12,17,38,-21,18
Brondby,8507,1,21,6,3,77,30,47,69
FC Midtjylla,8507,2,20,5,5,66,45,21,65
FC Nords,8507,3,13,8,9,74,53,21,47
Copenhagen,8507,4,13,6,11,55,45,10,45
AC Horsens,8507,5,7,13,10,39,51,-12,34
AaB,8507,6,7,12,11,36,49,-13,33
Sonderjyske,8507,7,8,6,10,28,29,-1,30
Randers FC,8507,8,6,6,12,25,40,-15,24
AGF Aarhus,8507,9,5,6,11,17,36,-19,21
Lyngby,8507,10,3,9,12,27,46,-19,18
Silkeborg IF,8507,11,5,3,14,25,45,-20,18
Brondby,8508,1,20,6,4,65,33,32,66
FC Midtjylla,8508,2,19,4,7,66,41,25,61
FC Nords,8508,3,16,7,7,77,46,31,55
Copenhagen,8508,4,13,6,11,60,49,11,45
AaB,8508,5,7,14,9,34,38,-4,35
AC Horsens,8508,6,6,13,11,34,55,-21,31
Sonderjyske,8508,7,8,6,10,28,29,-1,30
Lyngby,8508,8,4,9,11,29,44,-15,21
Silkeborg IF,8508,9,6,3,13,26,44,-18,21
Randers FC,8508,10,5,6,13,23,42,-19,21
AGF Aarhus,8508,11,4,6,12,16,37,-21,18
Brondby,8509,1,19,7,4,69,35,34,64
FC Midtjylla,8509,2,19,4,7,62,42,20,61
FC Nords,8509,3,14,7,9,75,56,19,49
Copenhagen,8509,4,15,4,11,63,45,18,49
AC Horsens,8509,5,8,13,9,38,50,-12,37
AaB,8509,6,8,11,11,39,44,-5,35
Sonderjyske,8509,7,8,6,10,28,29,-1,30
Randers FC,8509,8,5,7,12,23,39,-16,22
Silkeborg IF,8509,9,6,3,13,29,47,-18,21
Lyngby,8509,10,3,10,11,26,44,-18,19
AGF Aarhus,8509,11,4,6,12,19,40,-21,18
Brondby,8510,1,21,6,3,71,36,35,69
FC Midtjylla,8510,2,18,6,6,62,42,20,60
FC Nords,8510,3,17,6,7,80,46,34,57
Copenhagen,8510,4,12,6,12,54,46,8,42
AC Horsens,8510,5,7,14,9,38,53,-15,35
Sonderjyske,8510,6,8,6,10,28,29,-1,30
AaB,8510,7,6,12,12,35,43,-8,30
Randers FC,8510,8,6,6,12,24,39,-15,24
Silkeborg IF,8510,9,6,3,13,26,44,-18,21
Lyngby,8510,10,3,9,12,26,45,-19,18
AGF Aarhus,8510,11,4,6,12,16,37,-21,18
FC Midtjylla,8511,1,20,5,5,66,38,28,65
Brondby,8511,2,19,7,4,71,41,30,64
FC Nords,8511,3,14,6,10,76,54,22,48
Copenhagen,8511,4,14,5,11,59,47,12,47
AaB,8511,5,8,13,9,37,38,-1,37
AC Horsens,8511,6,5,16,9,35,52,-17,31
Sonderjyske,8511,7,8,6,10,28,29,-1,30
Randers FC,8511,8,6,6,12,24,39,-15,24
Silkeborg IF,8511,9,6,3,13,27,45,-18,21
Lyngby,8511,10,3,9,12,26,45,-19,18
AGF Aarhus,8511,11,4,6,12,17,38,-21,18
Brondby,8512,1,21,6,3,72,31,41,69
FC Midtjylla,8512,2,19,4,7,67,44,23,61
FC Nords,8512,3,14,7,9,71,54,17,49
Copenhagen,8512,4,14,5,11,60,44,16,47
AC Horsens,8512,5,8,12,10,39,53,-14,36
AaB,8512,6,7,12,11,38,47,-9,33
Sonderjyske,8512,7,8,6,10,28,29,-1,30
Lyngby,8512,8,4,9,11,29,45,-16,21
Randers FC,8512,9,5,6,13,24,42,-18,21
Silkeborg IF,8512,10,5,4,13,26,45,-19,19
AGF Aarhus,8512,11,4,7,11,17,37,-20,19
Brondby,8513,1,22,6,2,71,29,42,72
FC Midtjylla,8513,2,18,4,8,63,45,18,58
FC Nords,8513,3,15,7,8,78,54,24,52
Copenhagen,8513,4,14,5,11,57,42,15,47
AC Horsens,8513,5,7,13,10,38,52,-14,34
AaB,8513,6,6,13,11,34,45,-11,31
Sonderjyske,8513,7,8,6,10,28,29,-1,30
Randers FC,8513,8,6,6,12,26,39,-13,24
Silkeborg IF,8513,9,6,3,13,27,45,-18,21
Lyngby,8513,10,3,9,12,26,47,-21,18
AGF Aarhus,8513,11,4,6,12,17,38,-21,18
Brondby,8514,1,20,7,3,65,30,35,67
FC Midtjylla,8514,2,18,6,6,66,41,25,60
FC Nords,8514,3,13,9,8,73,49,24,48
Copenhagen,8514,4,14,5,11,56,46,10,47
AaB,8514,5,9,12,9,38,40,-2,39
AC Horsens,8514,6,6,13,11,34,52,-18,31
Sonderjyske,8514,7,8,6,10,28,29,-1,30
Randers FC,8514,8,6,6,12,25,39,-14,24
Silkeborg IF,8514,9,6,3,13,29,46,-17,21
Lyngby,8514,10,3,9,12,26,46,-20,18
AGF Aarhus,8514,11,4,6,12,18,40,-22,18
FC Midtjylla,8515,1,21,4,5,72,35,37,67
Brondby,8515,2,20,7,3,67,31,36,67
FC Nords,8515,3,13,9,8,72,53,19,48
Copenhagen,8515,4,12,8,10,56,46,10,44
AC Horsens,8515,5,7,13,10,38,52,-14,34
AaB,8515,6,6,13,11,36,50,-14,31
Sonderjyske,8515,7,8,6,10,28,29,-1,30
Randers FC,8515,8,6,6,12,26,39,-13,24
Silkeborg IF,8515,9,6,3,13,28,44,-16,21
Lyngby,8515,10,3,9,12,26,47,-21,18
AGF Aarhus,8515,11,4,6,12,16,39,-23,18
Brondby,8516,1,22,5,3,79,34,45,71
FC Midtjylla,8516,2,20,4,6,66,43,23,64
FC Nords,8516,3,14,6,10,70,55,15,48
Copenhagen,8516,4,14,4,12,56,48,8,46
AaB,8516,5,9,11,10,41,39,2,38
Sonderjyske,8516,6,8,6,10,28,29,-1,30
AC Horsens,8516,7,6,12,12,36,55,-19,30
Randers FC,8516,8,6,6,12,25,40,-15,24
Silkeborg IF,8516,9,5,4,13,27,46,-19,19
AGF Aarhus,8516,10,4,7,11,18,38,-20,19
Lyngby,8516,11,3,9,12,27,46,-19,18
Brondby,8517,1,20,6,4,69,33,36,66
FC Midtjylla,8517,2,19,5,6,65,38,27,62
FC Nords,8517,3,14,8,8,81,53,28,50
Copenhagen,8517,4,14,6,10,57,45,12,48
AaB,8517,5,8,11,11,38,48,-10,35
AC Horsens,8517,6,6,14,10,34,53,-19,32
Sonderjyske,8517,7,8,6,10,28,29,-1,30
Lyngby,8517,8,4,9,11,29,44,-15,21
Randers FC,8517,9,5,6,13,23,42,-19,21
Silkeborg IF,8517,10,5,4,13,27,46,-19,19
AGF Aarhus,8517,11,4,7,11,18,38,-20,19
Brondby,8518,1,21,7,2,69,31,38,70
FC Midtjylla,8518,2,18,5,7,71,46,25,59
FC Nords,8518,3,15,6,9,74,51,23,51
Copenhagen,8518,4,14,4,12,60,46,14,46
AaB,8518,5,8,14,8,38,39,-1,38
Sonderjyske,8518,6,8,6,10,28,29,-1,30
AC Horsens,8518,7,5,14,11,33,58,-25,29
Randers FC,8518,8,5,7,12,23,39,-16,22
Silkeborg IF,8518,9,6,3,13,27,45,-18,21
Lyngby,8518,10,3,10,11,26,44,-18,19
AGF Aarhus,8518,11,4,6,12,17,38,-21,18
Brondby,8519,1,21,7,2,69,28,41,70
FC Midtjylla,8519,2,18,6,6,61,37,24,60
FC Nords,8519,3,14,7,9,78,56,22,49
Copenhagen,8519,4,13,5,12,58,50,8,44
AaB,8519,5,8,12,10,36,42,-6,36
AC Horsens,8519,6,6,15,9,40,55,-15,33
Sonderjyske,8519,7,8,6,10,28,29,-1,30
Lyngby,8519,8,4,9,11,27,44,-17,21
Randers FC,8519,9,5,6,13,23,40,-17,21
AGF Aarhus,8519,10,5,6,11,18,37,-19,21
Silkeborg IF,8519,11,5,3,14,26,46,-20,18
FC Midtjylla,8520,1,21,5,4,67,36,31,68
Brondby,8520,2,20,7,3,73,34,39,67
FC Nords,8520,3,15,6,9,78,53,25,51
Copenhagen,8520,4,13,5,12,52,45,7,44
AC Horsens,8520,5,7,13,10,36,53,-17,34
Sonderjyske,8520,6,8,6,10,28,29,-1,30
AaB,8520,7,6,12,12,34,45,-11,30
Randers FC,8520,8,5,7,12,23,39,-16,22
Lyngby,8520,9,3,10,11,26,44,-18,19
Silkeborg IF,8520,10,5,4,13,27,46,-19,19
AGF Aarhus,8520,11,4,7,11,18,38,-20,19
Brondby,8521,1,22,5,3,76,31,45,71
FC Midtjylla,8521,2,19,5,6,68,40,28,62
FC Nords,8521,3,15,6,9,72,56,16,51
Copenhagen,8521,4,14,6,10,56,40,16,48
AC Horsens,8521,5,7,12,11,32,51,-19,33
Sonderjyske,8521,6,8,6,10,28,29,-1,30
AaB,8521,7,6,12,12,34,46,-12,30
Lyngby,8521,8,4,9,11,28,44,-16,21
Silkeborg IF,8521,9,6,3,13,28,46,-18,21
Randers FC,8521,10,5,6,13,23,41,-18,21
AGF Aarhus,8521,11,4,6,12,18,39,-21,18
Brondby,8522,1,22,5,3,72,33,39,71
FC Midtjylla,8522,2,18,5,7,65,41,24,59
FC Nords,8522,3,16,6,8,80,51,29,54
Copenhagen,8522,4,14,4,12,55,48,7,46
AaB,8522,5,8,11,11,38,47,-9,35
AC Horsens,8522,6,6,13,11,39,55,-16,31
Sonderjyske,8522,7,8,6,10,28,29,-1,30
Lyngby,8522,8,4,9,11,29,45,-16,21
Silkeborg IF,8522,9,6,3,13,27,44,-17,21
Randers FC,8522,10,5,6,13,24,42,-18,21
AGF Aarhus,8522,11,4,6,12,16,38,-22,18
FC Midtjylla,8523,1,21,4,5,70,38,32,67
Brondby,8523,2,19,7,4,67,32,35,64
Copenhagen,8523,3,16,4,10,59,44,15,52
FC Nords,8523,4,13,8,9,70,53,17,47
AaB,8523,5,7,11,12,37,45,-8,32
AC Horsens,8523,6,6,14,10,35,52,-17,32
Sonderjyske,8523,7,8,6,10,28,29,-1,30
Lyngby,8523,8,4,9,11,28,45,-17,21
Randers FC,8523,9,5,6,13,24,41,-17,21
Silkeborg IF,8523,10,5,4,13,28,47,-19,19
AGF Aarhus,8523,11,4,7,11,19,39,-20,19
Brondby,8524,1,21,5,4,72,37,35,68
FC Midtjylla,8524,2,20,5,5,67,38,29,65
FC Nords,8524,3,15,6,9,73,48,25,51
Copenhagen,8524,4,15,4,11,63,50,13,49
AaB,8524,5,8,11,11,37,45,-8,35
Sonderjyske,8524,6,8,6,10,28,29,-1,30
AC Horsens,8524,7,5,13,12,35,55,-20,28
Randers FC,8524,8,6,6,12,26,40,-14,24
Silkeborg IF,8524,9,6,3,13,29,44,-15,21
Lyngby,8524,10,3,9,12,27,47,-20,18
AGF Aarhus,8524,11,4,6,12,16,40,-24,18
Brondby,8525,1,20,7,3,70,33,37,67
FC Midtjylla,8525,2,20,5,5,65,35,30,65
Copenhagen,8525,3,14,6,10,57,43,14,48
FC Nords,8525,4,13,8,9,70,48,22,47
AaB,8525,5,7,12,11,37,45,-8,33
AC Horsens,8525,6,6,14,10,33,54,-21,32
Sonderjyske,8525,7,8,6,10,28,29,-1,30
Randers FC,8525,8,5,7,12,24,40,-16,22
Silkeborg IF,8525,9,6,3,13,27,44,-17,21
Lyngby,8525,10,3,10,11,27,45,-18,19
AGF Aarhus,8525,11,4,6,12,16,38,-22,18
Brondby,8526,1,22,5,3,72,31,41,71
FC Midtjylla,8526,2,19,4,7,63,42,21,61
FC Nords,8526,3,14,7,9,74,51,23,49
Copenhagen,8526,4,14,5,11,58,45,13,47
AaB,8526,5,8,13,9,38,40,-2,37
Sonderjyske,8526,6,8,6,10,28,29,-1,30
AC Horsens,8526,7,6,12,12,34,56,-22,30
Lyngby,8526,8,4,9,11,28,45,-17,21
Randers FC,8526,9,5,6,13,24,41,-17,21
Silkeborg IF,8526,10,5,4,13,25,44,-19,19
AGF Aarhus,8526,11,4,7,11,16,36,-20,19
Brondby,8527,1,22,5,3,72,30,42,71
FC Midtjylla,8527,2,21,4,5,68,36,32,67
FC Nords,8527,3,14,7,9,71,51,20,49
Copenhagen,8527,4,13,5,12,57,50,7,44
AC Horsens,8527,5,7,12,11,35,53,-18,33
AaB,8527,6,7,11,12,36,45,-9,32
Sonderjyske,8527,7,8,6,10,28,29,-1,30
Randers FC,8527,8,6,6,12,25,40,-15,24
Silkeborg IF,8527,9,6,3,13,28,45,-17,21
Lyngby,8527,10,3,9,12,27,46,-19,18
AGF Aarhus,8527,11,4,6,12,17,39,-22,18
Brondby,8528,1,21,7,2,74,31,43,70
FC Midtjylla,8528,2,19,5,6,62,40,22,62
FC Nords,8528,3,14,8,8,74,52,22,50
Copenhagen,8528,4,13,7,10,59,46,13,46
AC Horsens,8528,5,7,12,11,35,53,-18,33
AaB,8528,6,6,13,11,33,41,-8,31
Sonderjyske,8528,7,8,6,10,28,29,-1,30
Lyngby,8528,8,4,9,11,27,44,-17,21
Randers FC,8528,9,5,6,13,23,40,-17,21
AGF Aarhus,8528,10,5,6,11,19,38,-19,21
Silkeborg IF,8528,11,5,3,14,27,47,-20,18
FC Midtjylla,8529,1,22,4,4,66,34,32,70
Brondby,8529,2,21,5,4,72,36,36,68
FC Nords,8529,3,15,6,9,75,52,23,51
Copenhagen,8529,4,13,4,13,56,47,9,43
AC Horsens,8529,5,7,12,11,37,52,-15,33
AaB,8529,6,7,11,12,37,48,-11,32
Sonderjyske,8529,7,8,6,10,28,29,-1,30
Randers FC,8529,8,6,6,12,28,40,-12,24
AGF Aarhus,8529,9,5,6,11,17,36,-19,21
Silkeborg IF,8529,10,5,3,14,25,45,-20,18
Lyngby,8529,11,3,9,12,27,49,-22,18
Brondby,8530,1,21,6,3,71,34,37,69
FC Midtjylla,8530,2,18,6,6,63,39,24,60
FC Nords,8530,3,15,7,8,75,52,23,52
Copenhagen,8530,4,14,5,11,61,46,15,47
AC Horsens,8530,5,7,14,9,39,54,-15,35
Sonderjyske,8530,6,8,6,10,28,29,-1,30
AaB,8530,7,6,12,12,37,47,-10,30
Randers FC,8530,8,6,6,12,26,40,-14,24
Silkeborg IF,8530,9,6,3,13,27,45,-18,21
Lyngby,8530,10,3,9,12,27,47,-20,18
AGF Aarhus,8530,11,4,6,12,17,38,-21,18
Brondby,8531,1,22,5,3,75,31,44,71
FC Midtjylla,8531,2,20,4,6,65,42,23,64
Copenhagen,8531,3,15,4,11,61,45,16,49
FC Nords,8531,4,14,6,10,70,53,17,48
AaB,8531,5,7,12,11,39,45,-6,33
AC Horsens,8531,6,6,13,11,32,52,-20,31
Sonderjyske,8531,7,8,6,10,28,29,-1,30
Lyngby,8531,8,4,9,11,28,45,-17,21
Silkeborg IF,8531,9,6,3,13,27,44,-17,21
Randers FC,8531,10,5,6,13,24,41,-17,21
AGF Aarhus,8531,11,4,6,12,16,38,-22,18
Brondby,8532,1,20,7,3,68,30,38,67
FC Midtjylla,8532,2,20,4,6,71,37,34,64
FC Nords,8532,3,14,7,9,70,52,18,49
Copenhagen,8532,4,13,6,11,54,40,14,45
AaB,8532,5,7,14,9,36,43,-7,35
AC Horsens,8532,6,7,12,11,33,56,-23,33
Sonderjyske,8532,7,8,6,10,28,29,-1,30
Randers FC,8532,8,5,7,12,23,39,-16,22
AGF Aarhus,8532,9,5,6,11,18,37,-19,21
Lyngby,8532,10,3,10,11,26,44,-18,19
Silkeborg IF,8532,11,5,3,14,26,46,-20,18
Brondby,8533,1,20,6,4,72,36,36,66
FC Midtjylla,8533,2,19,6,5,65,36,29,63
FC Nords,8533,3,17,6,7,77,48,29,57
Copenhagen,8533,4,14,5,11,58,45,13,47
AC Horsens,8533,5,7,12,11,35,54,-19,33
Sonderjyske,8533,6,8,6,10,28,29,-1,30
AaB,8533,7,6,11,13,35,49,-14,29
Randers FC,8533,8,5,7,12,24,40,-16,22
Silkeborg IF,8533,9,6,3,13,30,46,-16,21
Lyngby,8533,10,3,10,11,27,45,-18,19
AGF Aarhus,8533,11,4,6,12,18,41,-23,18
FC Midtjylla,8534,1,21,4,5,70,38,32,67
Brondby,8534,2,19,5,6,67,42,25,62
FC Nords,8534,3,16,6,8,78,50,28,54
Copenhagen,8534,4,15,4,11,63,44,19,49
AaB,8534,5,8,11,11,43,47,-4,35
Sonderjyske,8534,6,8,6,10,28,29,-1,30
AC Horsens,8534,7,6,12,12,32,58,-26,30
Randers FC,8534,8,6,6,12,24,39,-15,24
Silkeborg IF,8534,9,6,3,13,27,45,-18,21
Lyngby,8534,10,3,9,12,26,45,-19,18
AGF Aarhus,8534,11,4,6,12,17,38,-21,18
Brondby,8535,1,22,6,2,73,31,42,72
FC Midtjylla,8535,2,19,6,5,66,41,25,63
FC Nords,8535,3,14,6,10,74,55,19,48
Copenhagen,8535,4,14,6,10,63,46,17,48
AaB,8535,5,7,11,12,34,44,-10,32
AC Horsens,8535,6,6,13,11,35,54,-19,31
Sonderjyske,8535,7,8,6,10,28,29,-1,30
Lyngby,8535,8,4,9,11,28,45,-17,21
Randers FC,8535,9,5,6,13,24,41,-17,21
Silkeborg IF,8535,10,5,4,13,26,45,-19,19
AGF Aarhus,8535,11,4,7,11,17,37,-20,19
Brondby,8536,1,21,5,4,72,31,41,68
FC Midtjylla,8536,2,20,4,6,72,45,27,64
FC Nords,8536,3,14,8,8,73,52,21,50
Copenhagen,8536,4,14,4,12,56,46,10,46
AC Horsens,8536,5,7,13,10,36,53,-17,34
AaB,8536,6,7,12,11,35,43,-8,33
Sonderjyske,8536,7,8,6,10,28,29,-1,30
Randers FC,8536,8,6,6,12,25,40,-15,24
Silkeborg IF,8536,9,6,3,13,26,44,-18,21
Lyngby,8536,10,3,9,12,27,46,-19,18
AGF Aarhus,8536,11,4,6,12,16,37,-21,18
Brondby,8537,1,21,6,3,74,34,40,69
FC Midtjylla,8537,2,19,6,5,63,38,25,63
FC Nords,8537,3,14,8,8,75,49,26,50
Copenhagen,8537,4,13,6,11,58,48,10,45
AaB,8537,5,7,13,10,36,42,-6,34
AC Horsens,8537,6,6,13,11,35,56,-21,31
Sonderjyske,8537,7,8,6,10,28,29,-1,30
Silkeborg IF,8537,8,6,3,13,29,44,-15,21
Lyngby,8537,9,4,9,11,28,44,-16,21
Randers FC,8537,10,5,6,13,23,41,-18,21
AGF Aarhus,8537,11,4,6,12,16,40,-24,18
Brondby,8538,1,22,6,2,75,30,45,72
FC Midtjylla,8538,2,19,5,6,62,37,25,62
FC Nords,8538,3,12,8,10,68,53,15,44
Copenhagen,8538,4,13,5,12,55,46,9,44
AaB,8538,5,8,13,9,37,41,-4,37
AC Horsens,8538,6,7,13,10,37,53,-16,34
Sonderjyske,8538,7,8,6,10,28,29,-1,30
Lyngby,8538,8,4,9,11,28,44,-16,21
Randers FC,8538,9,5,6,13,23,41,-18,21
AGF Aarhus,8538,10,5,6,11,18,37,-19,21
Silkeborg IF,8538,11,5,3,14,26,46,-20,18
Brondby,8539,1,20,6,4,73,36,37,66
FC Midtjylla,8539,2,19,5,6,66,40,26,62
Copenhagen,8539,3,16,5,9,62,40,22,53
FC Nords,8539,4,13,7,10,70,54,16,46
AC Horsens,8539,5,7,13,10,35,54,-19,34
AaB,8539,6,7,12,11,36,44,-8,33
Sonderjyske,8539,7,8,6,10,28,29,-1,30
Randers FC,8539,8,5,7,12,24,40,-16,22
Silkeborg IF,8539,9,6,3,13,26,44,-18,21
Lyngby,8539,10,3,10,11,27,45,-18,19
AGF Aarhus,8539,11,4,6,12,16,37,-21,18
Brondby,8540,1,21,6,3,73,32,41,69
FC Midtjylla,8540,2,18,5,7,59,44,15,59
FC Nords,8540,3,14,7,9,76,54,22,49
Copenhagen,8540,4,13,5,12,60,49,11,44
AaB,8540,5,8,13,9,37,40,-3,37
AC Horsens,8540,6,8,12,10,37,49,-12,36
Sonderjyske,8540,7,8,6,10,28,29,-1,30
Lyngby,8540,8,4,9,11,28,44,-16,21
Silkeborg IF,8540,9,6,3,13,27,44,-17,21
Randers FC,8540,10,5,6,13,23,41,-18,21
AGF Aarhus,8540,11,4,6,12,16,38,-22,18
Brondby,8541,1,22,6,2,71,30,41,72
FC Midtjylla,8541,2,17,6,7,60,41,19,57
Copenhagen,8541,3,16,4,10,58,41,17,52
FC Nords,8541,4,13,9,8,72,49,23,48
AaB,8541,5,7,11,12,35,44,-9,32
AC Horsens,8541,6,6,14,10,36,53,-17,32
Sonderjyske,8541,7,8,6,10,28,29,-1,30
Silkeborg IF,8541,8,6,3,13,29,45,-16,21
Lyngby,8541,9,4,9,11,28,45,-17,21
Randers FC,8541,10,5,6,13,24,41,-17,21
AGF Aarhus,8541,11,4,6,12,17,40,-23,18
Brondby,8542,1,22,5,3,76,32,44,71
FC Midtjylla,8542,2,20,4,6,67,41,26,64
FC Nords,8542,3,16,6,8,74,49,25,54
Copenhagen,8542,4,14,5,11,58,45,13,47
AaB,8542,5,6,13,11,32,44,-12,31
Sonderjyske,8542,6,8,6,10,28,29,-1,30
AC Horsens,8542,7,5,13,12,32,54,-22,28
Randers FC,8542,8,6,6,12,27,39,-12,24
Silkeborg IF,8542,9,6,3,13,30,44,-14,21
Lyngby,8542,10,3,9,12,26,48,-22,18
AGF Aarhus,8542,11,4,6,12,16,41,-25,18
Brondby,8543,1,21,6,3,67,30,37,69
FC Midtjylla,8543,2,18,6,6,63,38,25,60
Copenhagen,8543,3,16,5,9,58,39,19,53
FC Nords,8543,4,14,8,8,72,50,22,50
AaB,8543,5,6,14,10,34,41,-7,32
Sonderjyske,8543,6,8,6,10,28,29,-1,30
AC Horsens,8543,7,5,13,12,31,53,-22,28
Silkeborg IF,8543,8,6,3,13,29,45,-16,21
Lyngby,8543,9,4,9,11,29,46,-17,21
Randers FC,8543,10,5,6,13,25,42,-17,21
AGF Aarhus,8543,11,4,6,12,17,40,-23,18
Brondby,8544,1,22,5,3,70,31,39,71
FC Midtjylla,8544,2,18,6,6,64,42,22,60
Copenhagen,8544,3,15,5,10,60,42,18,50
FC Nords,8544,4,13,6,11,69,52,17,45
AaB,8544,5,7,14,9,37,43,-6,35
AC Horsens,8544,6,6,14,10,35,51,-16,32
Sonderjyske,8544,7,8,6,10,28,29,-1,30
Randers FC,8544,8,5,7,12,25,41,-16,22
Silkeborg IF,8544,9,6,3,13,27,44,-17,21
Lyngby,8544,10,3,10,11,28,46,-18,19
AGF Aarhus,8544,11,4,6,12,16,38,-22,18
FC Midtjylla,8545,1,22,4,4,74,37,37,70
Brondby,8545,2,20,6,4,70,33,37,66
FC Nords,8545,3,13,7,10,70,51,19,46
Copenhagen,8545,4,12,6,12,54,49,5,42
AaB,8545,5,9,11,10,37,44,-7,38
AC Horsens,8545,6,6,14,10,34,51,-17,32
Sonderjyske,8545,7,8,6,10,28,29,-1,30
Lyngby,8545,8,4,9,11,29,44,-15,21
Randers FC,8545,9,5,6,13,23,42,-19,21
AGF Aarhus,8545,10,5,6,11,18,37,-19,21
Silkeborg IF,8545,11,5,3,14,26,46,-20,18
Brondby,8546,1,20,8,2,65,27,38,68
FC Midtjylla,8546,2,20,5,5,66,38,28,65
FC Nords,8546,3,14,8,8,76,53,23,50
Copenhagen,8546,4,14,6,10,60,45,15,48
AC Horsens,8546,5,7,12,11,36,54,-18,33
Sonderjyske,8546,6,8,6,10,28,29,-1,30
AaB,8546,7,6,11,13,35,47,-12,29
Randers FC,8546,8,5,7,12,24,40,-16,22
Silkeborg IF,8546,9,6,3,13,27,44,-17,21
Lyngby,8546,10,3,10,11,27,45,-18,19
AGF Aarhus,8546,11,4,6,12,16,38,-22,18
FC Midtjylla,8547,1,21,4,5,67,35,32,67
Brondby,8547,2,20,6,4,69,34,35,66
Copenhagen,8547,3,15,4,11,62,46,16,49
FC Nords,8547,4,13,8,9,75,56,19,47
AC Horsens,8547,5,8,12,10,34,49,-15,36
Sonderjyske,8547,6,8,6,10,28,29,-1,30
AaB,8547,7,6,12,12,34,47,-13,30
Lyngby,8547,8,4,9,11,28,45,-17,21
Randers FC,8547,9,5,6,13,24,41,-17,21
Silkeborg IF,8547,10,6,3,13,26,44,-18,21
AGF Aarhus,8547,11,4,6,12,16,37,-21,18
Brondby,8548,1,21,5,4,70,33,37,68
FC Midtjylla,8548,2,20,4,6,67,40,27,64
FC Nords,8548,3,14,7,9,69,48,21,49
Copenhagen,8548,4,12,6,12,53,44,9,42
AC Horsens,8548,5,8,13,9,39,51,-12,37
AaB,8548,6,8,11,11,37,45,-8,35
Sonderjyske,8548,7,8,6,10,28,29,-1,30
Randers FC,8548,8,6,6,12,24,39,-15,24
Silkeborg IF,8548,9,6,3,13,26,44,-18,21
Lyngby,8548,10,3,9,12,26,45,-19,18
AGF Aarhus,8548,11,4,6,12,16,37,-21,18
Brondby,8549,1,21,6,3,70,30,40,69
FC Midtjylla,8549,2,20,5,5,67,39,28,65
FC Nords,8549,3,14,8,8,69,48,21,50
Copenhagen,8549,4,13,6,11,57,45,12,45
AaB,8549,5,7,12,11,36,42,-6,33
AC Horsens,8549,6,6,13,11,34,55,-21,31
Sonderjyske,8549,7,8,6,10,28,29,-1,30
Randers FC,8549,8,6,6,12,26,41,-15,24
Silkeborg IF,8549,9,6,3,13,27,44,-17,21
Lyngby,8549,10,3,9,12,28,47,-19,18
AGF Aarhus,8549,11,4,6,12,16,38,-22,18
Brondby,8550,1,22,5,3,73,33,40,71
FC Midtjylla,8550,2,20,6,4,67,39,28,66
FC Nords,8550,3,14,6,10,70,49,21,48
Copenhagen,8550,4,14,5,11,58,44,14,47
AaB,8550,5,6,13,11,36,45,-9,31
AC Horsens,8550,6,6,13,11,34,54,-20,31
Sonderjyske,8550,7,8,6,10,28,29,-1,30
Randers FC,8550,8,5,7,12,23,39,-16,22
Silkeborg IF,8550,9,6,3,13,27,44,-17,21
Lyngby,8550,10,3,10,11,26,44,-18,19
AGF Aarhus,8550,11,4,6,12,16,38,-22,18
Brondby,8551,1,20,7,3,71,33,38,67
FC Midtjylla,8551,2,19,6,5,66,40,26,63
Copenhagen,8551,3,15,6,9,62,44,18,51
FC Nords,8551,4,13,7,10,73,55,18,46
AC Horsens,8551,5,7,13,10,38,55,-17,34
AaB,8551,6,7,11,12,36,45,-9,32
Sonderjyske,8551,7,8,6,10,28,29,-1,30
Randers FC,8551,8,6,6,12,24,39,-15,24
Silkeborg IF,8551,9,5,4,13,25,44,-19,19
AGF Aarhus,8551,10,4,7,11,16,36,-20,19
Lyngby,8551,11,3,9,12,26,45,-19,18
Brondby,8552,1,20,8,2,66,29,37,68
FC Midtjylla,8552,2,19,5,6,66,40,26,62
FC Nords,8552,3,13,9,8,72,50,22,48
Copenhagen,8552,4,13,5,12,56,50,6,44
AC Horsens,8552,5,7,14,9,41,55,-14,35
AaB,8552,6,7,13,10,40,43,-3,34
Sonderjyske,8552,7,8,6,10,28,29,-1,30
Lyngby,8552,8,4,9,11,31,45,-14,21
Randers FC,8552,9,5,6,13,24,44,-20,21
Silkeborg IF,8552,10,5,4,13,28,47,-19,19
AGF Aarhus,8552,11,4,7,11,19,39,-20,19
Brondby,8553,1,21,5,4,74,33,41,68
FC Midtjylla,8553,2,18,5,7,60,38,22,59
FC Nords,8553,3,16,6,8,77,51,26,54
Copenhagen,8553,4,13,5,12,57,46,11,44
AaB,8553,5,8,13,9,36,41,-5,37
AC Horsens,8553,6,6,14,10,30,51,-21,32
Sonderjyske,8553,7,8,6,10,28,29,-1,30
Randers FC,8553,8,5,7,12,24,40,-16,22
Silkeborg IF,8553,9,6,3,13,26,44,-18,21
Lyngby,8553,10,3,10,11,27,45,-18,19
AGF Aarhus,8553,11,4,6,12,16,37,-21,18
Brondby,8554,1,19,8,3,69,34,35,65
FC Midtjylla,8554,2,19,6,5,62,37,25,63
FC Nords,8554,3,15,7,8,73,48,25,52
Copenhagen,8554,4,13,5,12,54,46,8,44
AaB,8554,5,7,13,10,36,39,-3,34
AC Horsens,8554,6,7,13,10,35,51,-16,34
Sonderjyske,8554,7,8,6,10,28,29,-1,30
Randers FC,8554,8,5,7,12,23,39,-16,22
Silkeborg IF,8554,9,6,3,13,27,44,-17,21
Lyngby,8554,10,3,10,11,26,44,-18,19
AGF Aarhus,8554,11,4,6,12,16,38,-22,18
Brondby,8555,1,22,5,3,71,28,43,71
FC Midtjylla,8555,2,18,6,6,66,40,26,60
FC Nords,8555,3,15,6,9,68,48,20,51
Copenhagen,8555,4,14,6,10,55,42,13,48
AaB,8555,5,7,13,10,35,39,-4,34
Sonderjyske,8555,6,8,6,10,28,29,-1,30
AC Horsens,8555,7,5,14,11,33,57,-24,29
Lyngby,8555,8,4,9,11,28,45,-17,21
Randers FC,8555,9,5,6,13,24,41,-17,21
Silkeborg IF,8555,10,5,4,13,26,45,-19,19
AGF Aarhus,8555,11,4,7,11,17,37,-20,19
Brondby,8556,1,21,6,3,68,31,37,69
FC Midtjylla,8556,2,18,4,8,62,46,16,58
FC Nords,8556,3,16,7,7,79,47,32,55
Copenhagen,8556,4,13,5,12,57,44,13,44
AC Horsens,8556,5,7,14,9,36,54,-18,35
AaB,8556,6,7,12,11,35,41,-6,33
Sonderjyske,8556,7,8,6,10,28,29,-1,30
Randers FC,8556,8,6,6,12,25,40,-15,24
AGF Aarhus,8556,9,5,6,11,17,36,-19,21
Lyngby,8556,10,3,9,12,27,46,-19,18
Silkeborg IF,8556,11,5,3,14,25,45,-20,18
Brondby,8557,1,21,6,3,71,32,39,69
FC Midtjylla,8557,2,20,5,5,73,38,35,65
FC Nords,8557,3,14,7,9,75,52,23,49
Copenhagen,8557,4,14,6,10,57,44,13,48
AaB,8557,5,6,13,11,34,46,-12,31
AC Horsens,8557,6,6,13,11,32,56,-24,31
Sonderjyske,8557,7,8,6,10,28,29,-1,30
Lyngby,8557,8,4,9,11,27,44,-17,21
Randers FC,8557,9,5,6,13,23,40,-17,21
Silkeborg IF,8557,10,5,4,13,26,45,-19,19
AGF Aarhus,8557,11,4,7,11,17,37,-20,19
Brondby,8558,1,22,6,2,74,31,43,72
FC Midtjylla,8558,2,19,7,4,67,37,30,64
FC Nords,8558,3,14,8,8,77,52,25,50
Copenhagen,8558,4,13,4,13,54,47,7,43
AaB,8558,5,7,13,10,40,46,-6,34
Sonderjyske,8558,6,8,6,10,28,29,-1,30
AC Horsens,8558,7,6,12,12,32,57,-25,30
Randers FC,8558,8,5,7,12,23,39,-16,22
AGF Aarhus,8558,9,5,6,11,18,36,-18,21
Lyngby,8558,10,3,10,11,26,44,-18,19
Silkeborg IF,8558,11,5,3,14,25,46,-21,18
Brondby,8559,1,21,5,4,72,34,38,68
FC Midtjylla,8559,2,20,4,6,67,42,25,64
Copenhagen,8559,3,16,5,9,58,40,18,53
FC Nords,8559,4,14,6,10,73,52,21,48
AC Horsens,8559,5,7,12,11,33,51,-18,33
Sonderjyske,8559,6,8,6,10,28,29,-1,30
AaB,8559,7,6,12,12,36,46,-10,30
Randers FC,8559,8,6,6,12,24,39,-15,24
AGF Aarhus,8559,9,5,6,11,19,38,-19,21
Lyngby,8559,10,3,9,12,26,45,-19,18
Silkeborg IF,8559,11,5,3,14,27,47,-20,18
FC Midtjylla,8560,1,21,4,5,68,37,31,67
Brondby,8560,2,19,6,5,67,39,28,63
FC Nords,8560,3,13,7,10,72,53,19,46
Copenhagen,8560,4,14,4,12,57,42,15,46
AC Horsens,8560,5,9,12,9,36,48,-12,39
AaB,8560,6,8,11,11,36,43,-7,35
Sonderjyske,8560,7,8,6,10,28,29,-1,30
Randers FC,8560,8,5,7,12,24,40,-16,22
Lyngby,8560,9,3,10,11,27,45,-18,19
Silkeborg IF,8560,10,5,4,13,25,44,-19,19
AGF Aarhus,8560,11,4,7,11,16,36,-20,19
Brondby,8561,1,20,5,5,71,34,37,65
FC Midtjylla,8561,2,20,5,5,72,36,36,65
FC Nords,8561,3,15,6,9,76,58,18,51
Copenhagen,8561,4,15,4,11,59,45,14,49
AC Horsens,8561,5,8,12,10,39,57,-18,36
Sonderjyske,8561,6,8,6,10,28,29,-1,30
AaB,8561,7,6,12,12,40,53,-13,30
Randers FC,8561,8,6,6,12,27,42,-15,24
AGF Aarhus,8561,9,5,6,11,18,37,-19,21
Lyngby,8561,10,3,9,12,29,48,-19,18
Silkeborg IF,8561,11,5,3,14,26,46,-20,18
Brondby,8562,1,21,7,2,71,32,39,70
FC Midtjylla,8562,2,21,4,5,68,39,29,67
FC Nords,8562,3,15,7,8,76,50,26,52
Copenhagen,8562,4,14,4,12,54,42,12,46
AaB,8562,5,7,11,12,35,45,-10,32
Sonderjyske,8562,6,8,6,10,28,29,-1,30
AC Horsens,8562,7,5,13,12,37,59,-22,28
Randers FC,8562,8,6,6,12,24,39,-15,24
AGF Aarhus,8562,9,5,6,11,19,36,-17,21
Lyngby,8562,10,3,9,12,26,45,-19,18
Silkeborg IF,8562,11,5,3,14,25,47,-22,18
FC Midtjylla,8563,1,21,4,5,68,36,32,67
Brondby,8563,2,20,6,4,68,33,35,66
FC Nords,8563,3,14,6,10,73,52,21,48
Copenhagen,8563,4,14,4,12,58,47,11,46
AaB,8563,5,8,11,11,34,42,-8,35
AC Horsens,8563,6,7,13,10,38,55,-17,34
Sonderjyske,8563,7,8,6,10,28,29,-1,30
Lyngby,8563,8,4,9,11,27,44,-17,21
Randers FC,8563,9,5,6,13,23,40,-17,21
Silkeborg IF,8563,10,5,4,13,27,46,-19,19
AGF Aarhus,8563,11,4,7,11,18,38,-20,19
Brondby,8564,1,21,6,3,68,28,40,69
FC Midtjylla,8564,2,20,4,6,67,42,25,64
FC Nords,8564,3,15,7,8,75,51,24,52
Copenhagen,8564,4,13,5,12,56,49,7,44
AC Horsens,8564,5,7,13,10,38,56,-18,34
AaB,8564,6,7,11,12,37,41,-4,32
Sonderjyske,8564,7,8,6,10,28,29,-1,30
Lyngby,8564,8,4,9,11,27,44,-17,21
Silkeborg IF,8564,8,6,3,13,27,44,-17,21
Randers FC,8564,10,5,6,13,23,40,-17,21
AGF Aarhus,8564,11,4,6,12,16,38,-22,18
Brondby,8565,1,20,6,4,69,32,37,66
FC Midtjylla,8565,2,19,5,6,65,37,28,62
Copenhagen,8565,3,16,4,10,62,44,18,52
FC Nords,8565,4,13,6,11,70,58,12,45
AC Horsens,8565,5,8,12,10,34,48,-14,36
AaB,8565,6,8,11,11,34,41,-7,35
Sonderjyske,8565,7,8,6,10,28,29,-1,30
Lyngby,8565,8,4,9,11,30,45,-15,21
Silkeborg IF,8565,9,6,3,13,26,44,-18,21
Randers FC,8565,10,5,6,13,24,43,-19,21
AGF Aarhus,8565,11,4,6,12,16,37,-21,18
Brondby,8566,1,22,6,2,78,33,45,72
FC Midtjylla,8566,2,17,5,8,64,47,17,56
FC Nords,8566,3,14,8,8,73,50,23,50
Copenhagen,8566,4,14,5,11,58,43,15,47
AaB,8566,5,8,13,9,40,47,-7,37
AC Horsens,8566,6,6,13,11,35,54,-19,31
Sonderjyske,8566,7,8,6,10,28,29,-1,30
Randers FC,8566,8,6,6,12,27,41,-14,24
Silkeborg IF,8566,9,5,4,13,25,44,-19,19
AGF Aarhus,8566,10,4,7,11,16,36,-20,19
Lyngby,8566,11,3,9,12,28,48,-20,18
Brondby,8567,1,22,5,3,73,31,42,71
FC Midtjylla,8567,2,21,4,5,67,39,28,67
FC Nords,8567,3,15,6,9,74,52,22,51
Copenhagen,8567,4,12,5,13,55,48,7,41
AC Horsens,8567,5,7,13,10,39,53,-14,34
AaB,8567,6,6,13,11,34,45,-11,31
Sonderjyske,8567,7,8,6,10,28,29,-1,30
Randers FC,8567,8,6,6,12,25,39,-14,24
Silkeborg IF,8567,9,6,3,13,27,45,-18,21
Lyngby,8567,10,3,9,12,26,46,-20,18
AGF Aarhus,8567,11,4,6,12,17,38,-21,18
Brondby,8568,1,21,5,4,68,30,38,68
FC Midtjylla,8568,2,19,5,6,66,44,22,62
FC Nords,8568,3,15,6,9,77,51,26,51
Copenhagen,8568,4,13,5,12,56,51,5,44
AaB,8568,5,9,11,10,38,41,-3,38
AC Horsens,8568,6,7,12,11,36,50,-14,33
Sonderjyske,8568,7,8,6,10,28,29,-1,30
Lyngby,8568,8,4,9,11,28,45,-17,21
Randers FC,8568,9,5,6,13,24,41,-17,21
Silkeborg IF,8568,10,6,3,13,27,45,-18,21
AGF Aarhus,8568,11,4,6,12,17,38,-21,18
Brondby,8569,1,20,6,4,70,35,35,66
FC Midtjylla,8569,2,20,5,5,73,41,32,65
FC Nords,8569,3,17,6,7,82,52,30,57
Copenhagen,8569,4,15,4,11,65,51,14,49
AaB,8569,5,7,11,12,40,47,-7,32
Sonderjyske,8569,6,8,6,10,28,29,-1,30
AC Horsens,8569,7,5,12,13,30,60,-30,27
Randers FC,8569,8,6,6,12,25,40,-15,24
Silkeborg IF,8569,9,6,3,13,26,44,-18,21
Lyngby,8569,10,3,9,12,27,46,-19,18
AGF Aarhus,8569,11,4,6,12,16,37,-21,18
Brondby,8570,1,20,6,4,69,34,35,66
FC Midtjylla,8570,2,20,4,6,68,37,31,64
FC Nords,8570,3,14,8,8,74,52,22,50
Copenhagen,8570,4,13,5,12,56,49,7,44
AC Horsens,8570,5,8,13,9,38,52,-14,37
AaB,8570,6,7,12,11,36,43,-7,33
Sonderjyske,8570,7,8,6,10,28,29,-1,30
Lyngby,8570,8,4,9,11,27,44,-17,21
Randers FC,8570,9,5,6,13,23,40,-17,21
Silkeborg IF,8570,10,5,4,13,26,45,-19,19
AGF Aarhus,8570,11,4,7,11,17,37,-20,19
Brondby,8571,1,22,5,3,77,29,48,71
FC Midtjylla,8571,2,19,4,7,63,44,19,61
FC Nords,8571,3,14,6,10,69,51,18,48
Copenhagen,8571,4,14,5,11,57,42,15,47
AC Horsens,8571,5,9,13,8,36,45,-9,40
Sonderjyske,8571,6,8,6,10,28,29,-1,30
AaB,8571,7,6,11,13,32,49,-17,29
Randers FC,8571,8,5,7,12,25,41,-16,22
Silkeborg IF,8571,9,6,3,13,29,45,-16,21
Lyngby,8571,10,3,10,11,28,46,-18,19
AGF Aarhus,8571,11,4,6,12,17,40,-23,18
Brondby,8572,1,22,6,2,74,30,44,72
FC Midtjylla,8572,2,19,6,5,72,45,27,63
Copenhagen,8572,3,15,5,10,62,44,18,50
FC Nords,8572,4,12,6,12,69,59,10,42
AaB,8572,5,9,11,10,37,42,-5,38
Sonderjyske,8572,6,8,6,10,28,29,-1,30
AC Horsens,8572,7,6,12,12,36,56,-20,30
Lyngby,8572,8,4,9,11,29,45,-16,21
Silkeborg IF,8572,9,6,3,13,26,44,-18,21
Randers FC,8572,10,5,6,13,24,42,-18,21
AGF Aarhus,8572,11,4,6,12,16,37,-21,18
Brondby,8573,1,21,5,4,71,38,33,68
FC Midtjylla,8573,2,20,4,6,66,41,25,64
Copenhagen,8573,3,15,5,10,62,41,21,50
FC Nords,8573,4,13,8,9,69,51,18,47
AaB,8573,5,8,12,10,39,42,-3,36
Sonderjyske,8573,6,8,6,10,28,29,-1,30
AC Horsens,8573,7,6,12,12,35,55,-20,30
Randers FC,8573,8,6,6,12,25,40,-15,24
AGF Aarhus,8573,9,5,6,11,18,37,-19,21
Lyngby,8573,10,3,9,12,27,46,-19,18
Silkeborg IF,8573,11,5,3,14,26,46,-20,18
Brondby,8574,1,21,7,2,76,32,44,70
FC Midtjylla,8574,2,20,5,5,67,38,29,65
Copenhagen,8574,3,13,7,10,59,48,11,46
FC Nords,8574,4,12,7,11,69,58,11,43
AaB,8574,5,8,11,11,40,45,-5,35
AC Horsens,8574,6,7,13,10,36,52,-16,34
Sonderjyske,8574,7,8,6,10,28,29,-1,30
Lyngby,8574,8,4,9,11,29,45,-16,21
Silkeborg IF,8574,9,6,3,13,29,47,-18,21
Randers FC,8574,10,5,6,13,24,42,-18,21
AGF Aarhus,8574,11,4,6,12,19,40,-21,18
FC Midtjylla,8575,1,21,5,4,66,34,32,68
Brondby,8575,2,19,6,5,66,33,33,63
FC Nords,8575,3,14,7,9,76,50,26,49
Copenhagen,8575,4,13,5,12,56,51,5,44
AaB,8575,5,8,12,10,39,44,-5,36
AC Horsens,8575,6,6,15,9,37,54,-17,33
Sonderjyske,8575,7,8,6,10,28,29,-1,30
Randers FC,8575,8,6,6,12,24,39,-15,24
Silkeborg IF,8575,9,6,3,13,29,46,-17,21
Lyngby,8575,10,3,9,12,26,45,-19,18
AGF Aarhus,8575,11,4,6,12,18,40,-22,18
FC Midtjylla,8576,1,20,6,4,65,36,29,66
Brondby,8576,2,19,8,3,70,32,38,65
FC Nords,8576,3,14,7,9,71,53,18,49
Copenhagen,8576,4,13,5,12,53,45,8,44
AaB,8576,5,7,13,10,38,42,-4,34
AC Horsens,8576,6,6,15,9,37,52,-15,33
Sonderjyske,8576,7,8,6,10,28,29,-1,30
Lyngby,8576,8,4,9,11,29,44,-15,21
Silkeborg IF,8576,9,6,3,13,27,45,-18,21
Randers FC,8576,10,5,6,13,23,42,-19,21
AGF Aarhus,8576,11,4,6,12,17,38,-21,18
Brondby,8577,1,22,6,2,73,30,43,72
FC Midtjylla,8577,2,18,6,6,61,40,21,60
FC Nords,8577,3,16,7,7,75,46,29,55
Copenhagen,8577,4,12,6,12,53,43,10,42
AaB,8577,5,8,11,11,34,44,-10,35
Sonderjyske,8577,6,8,6,10,28,29,-1,30
AC Horsens,8577,7,5,14,11,31,50,-19,29
Randers FC,8577,8,6,6,12,25,40,-15,24
AGF Aarhus,8577,9,5,6,11,19,37,-18,21
Lyngby,8577,10,3,9,12,27,46,-19,18
Silkeborg IF,8577,11,5,3,14,26,47,-21,18
FC Midtjylla,8578,1,22,4,4,69,34,35,70
Brondby,8578,2,21,6,3,68,28,40,69
FC Nords,8578,3,13,6,11,71,57,14,45
Copenhagen,8578,4,12,6,12,53,49,4,42
AaB,8578,5,8,12,10,39,42,-3,36
AC Horsens,8578,6,7,12,11,32,48,-16,33
Sonderjyske,8578,7,8,6,10,28,29,-1,30
Lyngby,8578,8,4,9,11,27,44,-17,21
Silkeborg IF,8578,8,6,3,13,27,44,-17,21
Randers FC,8578,10,5,6,13,23,40,-17,21
AGF Aarhus,8578,11,4,6,12,16,38,-22,18
Brondby,8579,1,20,8,2,69,30,39,68
FC Midtjylla,8579,2,20,4,6,61,34,27,64
FC Nords,8579,3,13,7,10,73,55,18,46
Copenhagen,8579,4,13,7,10,57,45,12,46
AaB,8579,5,7,13,10,36,41,-5,34
AC Horsens,8579,6,7,13,10,37,54,-17,34
Sonderjyske,8579,7,8,6,10,28,29,-1,30
Randers FC,8579,8,6,6,12,24,39,-15,24
Silkeborg IF,8579,9,6,3,13,26,44,-18,21
Lyngby,8579,10,3,9,12,26,45,-19,18
AGF Aarhus,8579,11,4,6,12,16,37,-21,18
Brondby,8580,1,23,5,2,73,29,44,74
FC Midtjylla,8580,2,18,4,8,67,43,24,58
FC Nords,8580,3,15,7,8,73,53,20,52
Copenhagen,8580,4,15,4,11,57,43,14,49
AC Horsens,8580,5,7,12,11,33,50,-17,33
Sonderjyske,8580,6,8,6,10,28,29,-1,30
AaB,8580,7,6,12,12,34,45,-11,30
Lyngby,8580,8,4,9,11,28,44,-16,21
Randers FC,8580,9,5,6,13,23,41,-18,21
Silkeborg IF,8580,10,5,4,13,25,44,-19,19
AGF Aarhus,8580,11,4,7,11,16,36,-20,19
Brondby,8581,1,21,5,4,74,32,42,68
FC Midtjylla,8581,2,21,4,5,69,40,29,67
FC Nords,8581,3,14,6,10,73,52,21,48
Copenhagen,8581,4,14,5,11,59,49,10,47
AaB,8581,5,8,11,11,38,47,-9,35
AC Horsens,8581,6,6,13,11,36,55,-19,31
Sonderjyske,8581,7,8,6,10,28,29,-1,30
Randers FC,8581,8,5,7,12,24,40,-16,22
Silkeborg IF,8581,9,6,3,13,28,45,-17,21
Lyngby,8581,10,3,10,11,27,45,-18,19
AGF Aarhus,8581,11,4,6,12,17,39,-22,18
FC Midtjylla,8582,1,22,4,4,70,37,33,70
Brondby,8582,2,18,7,5,66,36,30,61
FC Nords,8582,3,13,8,9,70,51,19,47
Copenhagen,8582,4,13,5,12,53,41,12,44
AaB,8582,5,8,12,10,40,44,-4,36
AC Horsens,8582,6,7,14,9,34,50,-16,35
Sonderjyske,8582,7,8,6,10,28,29,-1,30
Lyngby,8582,8,4,9,11,28,44,-16,21
Randers FC,8582,9,5,6,13,23,41,-18,21
AGF Aarhus,8582,10,5,6,11,17,36,-19,21
Silkeborg IF,8582,11,5,3,14,25,45,-20,18
Brondby,8583,1,22,5,3,73,30,43,71
FC Midtjylla,8583,2,20,4,6,67,40,27,64
Copenhagen,8583,3,15,5,10,63,45,18,50
FC Nords,8583,4,13,7,10,71,55,16,46
AaB,8583,5,8,13,9,41,43,-2,37
Sonderjyske,8583,6,8,6,10,28,29,-1,30
AC Horsens,8583,7,5,12,13,33,61,-28,27
Lyngby,8583,8,4,9,11,31,45,-14,21
Randers FC,8583,9,5,6,13,24,44,-20,21
Silkeborg IF,8583,10,5,4,13,25,44,-19,19
AGF Aarhus,8583,11,4,7,11,16,36,-20,19
Brondby,8584,1,22,5,3,75,31,44,71
FC Midtjylla,8584,2,19,4,7,64,41,23,61
FC Nords,8584,3,14,7,9,77,56,21,49
Copenhagen,8584,4,14,5,11,54,41,13,47
AC Horsens,8584,5,8,13,9,35,48,-13,37
Sonderjyske,8584,6,8,6,10,28,29,-1,30
AaB,8584,7,6,12,12,35,49,-14,30
Randers FC,8584,8,5,7,12,23,39,-16,22
Silkeborg IF,8584,9,6,3,13,26,44,-18,21
Lyngby,8584,10,3,10,11,26,44,-18,19
AGF Aarhus,8584,11,4,6,12,16,37,-21,18
Brondby,8585,1,19,9,2,68,31,37,66
FC Midtjylla,8585,2,18,7,5,62,39,23,61
FC Nords,8585,3,15,8,7,73,46,27,53
Copenhagen,8585,4,14,4,12,59,49,10,46
AC Horsens,8585,5,7,13,10,37,51,-14,34
AaB,8585,6,6,13,11,34,43,-9,31
Sonderjyske,8585,7,8,6,10,28,29,-1,30
Lyngby,8585,8,4,9,11,28,44,-16,21
Silkeborg IF,8585,8,6,3,13,28,44,-16,21
Randers FC,8585,10,5,6,13,23,41,-18,21
AGF Aarhus,8585,11,4,6,12,16,39,-23,18
Brondby,8586,1,20,7,3,69,32,37,67
FC Midtjylla,8586,2,19,5,6,63,38,25,62
FC Nords,8586,3,15,8,7,77,48,29,53
Copenhagen,8586,4,13,5,12,57,48,9,44
AaB,8586,5,8,11,11,37,45,-8,35
AC Horsens,8586,6,7,12,11,35,53,-18,33
Sonderjyske,8586,7,8,6,10,28,29,-1,30
Lyngby,8586,8,4,9,11,30,46,-16,21
Silkeborg IF,8586,9,6,3,13,26,44,-18,21
Randers FC,8586,10,5,6,13,25,43,-18,21
AGF Aarhus,8586,11,4,6,12,16,37,-21,18
FC Midtjylla,8587,1,21,4,5,66,36,30,67
Brondby,8587,2,20,5,5,65,33,32,65
FC Nords,8587,3,15,6,9,72,51,21,51
Copenhagen,8587,4,13,4,13,54,45,9,43
AaB,8587,5,9,12,9,39,38,1,39
AC Horsens,8587,6,6,13,11,34,53,-19,31
Sonderjyske,8587,7,8,6,10,28,29,-1,30
Lyngby,8587,8,4,9,11,28,44,-16,21
Silkeborg IF,8587,9,6,3,13,27,44,-17,21
Randers FC,8587,10,5,6,13,23,41,-18,21
AGF Aarhus,8587,11,4,6,12,16,38,-22,18
Brondby,8588,1,21,5,4,69,31,38,68
FC Midtjylla,8588,2,20,4,6,67,45,22,64
Copenhagen,8588,3,14,6,10,56,41,15,48
FC Nords,8588,4,13,7,10,71,52,19,46
AaB,8588,5,8,13,9,38,41,-3,37
AC Horsens,8588,6,6,13,11,35,52,-17,31
Sonderjyske,8588,7,8,6,10,28,29,-1,30
Lyngby,8588,8,4,9,11,27,44,-17,21
Randers FC,8588,9,5,6,13,23,40,-17,21
AGF Aarhus,8588,10,5,6,11,18,37,-19,21
Silkeborg IF,8588,11,5,3,14,26,46,-20,18
Brondby,8589,1,19,8,3,68,34,34,65
FC Midtjylla,8589,2,18,6,6,62,40,22,60
Copenhagen,8589,3,16,4,10,60,44,16,52
FC Nords,8589,4,14,8,8,77,50,27,50
AC Horsens,8589,5,7,13,10,37,53,-16,34
AaB,8589,6,7,11,12,37,46,-9,32
Sonderjyske,8589,7,8,6,10,28,29,-1,30
Randers FC,8589,8,6,6,12,25,39,-14,24
AGF Aarhus,8589,9,5,6,11,18,37,-19,21
Lyngby,8589,10,3,9,12,26,46,-20,18
Silkeborg IF,8589,10,5,3,14,26,46,-20,18
Brondby,8590,1,21,5,4,72,36,36,68
FC Midtjylla,8590,2,20,5,5,66,34,32,65
FC Nords,8590,3,14,7,9,72,52,20,49
Copenhagen,8590,4,15,4,11,61,44,17,49
AaB,8590,5,8,13,9,40,44,-4,37
Sonderjyske,8590,6,8,6,10,28,29,-1,30
AC Horsens,8590,7,5,12,13,32,59,-27,27
Randers FC,8590,8,5,7,12,26,42,-16,22
Lyngby,8590,9,3,10,11,29,47,-18,19
Silkeborg IF,8590,10,5,4,13,26,45,-19,19
AGF Aarhus,8590,11,4,7,11,17,37,-20,19
Brondby,8591,1,21,6,3,72,32,40,69
FC Midtjylla,8591,2,18,6,6,64,42,22,60
Copenhagen,8591,3,14,6,10,59,46,13,48
FC Nords,8591,4,12,7,11,73,58,15,43
AC Horsens,8591,5,7,15,8,41,50,-9,36
AaB,8591,6,7,14,9,37,44,-7,35
Sonderjyske,8591,7,8,6,10,28,29,-1,30
Randers FC,8591,8,6,6,12,25,39,-14,24
Silkeborg IF,8591,9,6,3,13,26,44,-18,21
Lyngby,8591,10,3,9,12,26,46,-20,18
AGF Aarhus,8591,11,4,6,12,16,37,-21,18
Brondby,8592,1,22,5,3,70,30,40,71
FC Midtjylla,8592,2,20,4,6,69,39,30,64
FC Nords,8592,3,14,6,10,71,51,20,48
Copenhagen,8592,4,14,4,12,58,42,16,46
AaB,8592,5,8,12,10,36,44,-8,36
AC Horsens,8592,6,6,13,11,32,56,-24,31
Sonderjyske,8592,7,8,6,10,28,29,-1,30
Lyngby,8592,8,4,9,11,29,44,-15,21
Silkeborg IF,8592,9,6,3,13,27,45,-18,21
Randers FC,8592,10,5,6,13,23,42,-19,21
AGF Aarhus,8592,11,4,6,12,17,38,-21,18
Brondby,8593,1,22,5,3,70,30,40,71
FC Midtjylla,8593,2,19,5,6,66,42,24,62
FC Nords,8593,3,16,6,8,77,52,25,54
Copenhagen,8593,4,14,6,10,58,45,13,48
Sonderjyske,8593,5,8,6,10,28,29,-1,30
AaB,8593,6,6,12,12,36,46,-10,30
AC Horsens,8593,7,5,14,11,37,55,-18,29
Silkeborg IF,8593,8,6,3,13,28,44,-16,21
Lyngby,8593,9,4,9,11,27,44,-17,21
Randers FC,8593,10,5,6,13,23,40,-17,21
AGF Aarhus,8593,11,4,6,12,16,39,-23,18
Brondby,8594,1,21,6,3,69,31,38,69
FC Midtjylla,8594,2,20,5,5,67,42,25,65
Copenhagen,8594,3,15,4,11,60,41,19,49
FC Nords,8594,4,14,6,10,75,55,20,48
AaB,8594,5,7,12,11,35,42,-7,33
AC Horsens,8594,6,6,13,11,33,54,-21,31
Sonderjyske,8594,7,8,6,10,28,29,-1,30
Randers FC,8594,8,5,7,12,23,39,-16,22
AGF Aarhus,8594,9,5,6,11,19,37,-18,21
Lyngby,8594,10,3,10,11,26,44,-18,19
Silkeborg IF,8594,11,5,3,14,26,47,-21,18
FC Midtjylla,8595,1,21,4,5,68,38,30,67
Brondby,8595,2,20,6,4,69,34,35,66
FC Nords,8595,3,14,7,9,74,51,23,49
Copenhagen,8595,4,14,6,10,57,45,12,48
AaB,8595,5,7,13,10,36,43,-7,34
Sonderjyske,8595,6,8,6,10,28,29,-1,30
AC Horsens,8595,7,6,12,12,33,52,-19,30
Randers FC,8595,8,6,6,12,26,41,-15,24
Silkeborg IF,8595,9,5,4,13,26,45,-19,19
AGF Aarhus,8595,10,4,7,11,17,37,-20,19
Lyngby,8595,11,3,9,12,28,47,-19,18
Brondby,8596,1,20,7,3,70,33,37,67
FC Midtjylla,8596,2,20,5,5,71,38,33,65
FC Nords,8596,3,14,8,8,75,53,22,50
Copenhagen,8596,4,14,6,10,57,44,13,48
AaB,8596,5,7,11,12,35,48,-13,32
Sonderjyske,8596,6,8,6,10,28,29,-1,30
AC Horsens,8596,7,5,15,10,33,51,-18,30
Silkeborg IF,8596,8,6,3,13,28,45,-17,21
Lyngby,8596,9,4,9,11,27,44,-17,21
Randers FC,8596,10,5,6,13,23,40,-17,21
AGF Aarhus,8596,11,4,6,12,17,39,-22,18
Brondby,8597,1,20,7,3,67,30,37,67
FC Midtjylla,8597,2,20,5,5,62,36,26,65
FC Nords,8597,3,13,7,10,71,55,16,46
Copenhagen,8597,4,13,4,13,56,48,8,43
AaB,8597,5,8,12,10,38,41,-3,36
AC Horsens,8597,6,7,15,8,39,49,-10,36
Sonderjyske,8597,7,8,6,10,28,29,-1,30
Randers FC,8597,8,5,7,12,23,39,-16,22
AGF Aarhus,8597,9,5,6,11,18,36,-18,21
Lyngby,8597,10,3,10,11,26,44,-18,19
Silkeborg IF,8597,11,5,3,14,25,46,-21,18
Brondby,8598,1,20,6,4,70,35,35,66
FC Midtjylla,8598,2,18,5,7,58,39,19,59
FC Nords,8598,3,15,7,8,75,48,27,52
Copenhagen,8598,4,15,5,10,62,47,15,50
AaB,8598,5,7,13,10,36,42,-6,34
AC Horsens,8598,6,7,12,11,36,52,-16,33
Sonderjyske,8598,7,8,6,10,28,29,-1,30
Lyngby,8598,8,4,9,11,29,46,-17,21
Randers FC,8598,9,5,6,13,25,42,-17,21
Silkeborg IF,8598,10,6,3,13,26,44,-18,21
AGF Aarhus,8598,11,4,6,12,16,37,-21,18
Brondby,8599,1,21,5,4,72,35,37,68
FC Midtjylla,8599,2,20,5,5,69,38,31,65
Copenhagen,8599,3,14,6,10,59,48,11,48
FC Nords,8599,4,13,6,11,72,55,17,45
AaB,8599,5,10,11,9,44,42,2,41
Sonderjyske,8599,6,8,6,10,28,29,-1,30
AC Horsens,8599,7,5,13,12,34,58,-24,28
Lyngby,8599,8,4,9,11,29,45,-16,21
Randers FC,8599,9,5,6,13,24,42,-18,21
AGF Aarhus,8599,10,5,6,11,18,36,-18,21
Silkeborg IF,8599,11,5,3,14,25,46,-21,18
FC Midtjylla,8600,1,22,4,4,73,36,37,70
Brondby,8600,2,20,6,4,68,34,34,66
FC Nords,8600,3,14,7,9,74,54,20,49
Copenhagen,8600,4,13,5,12,57,48,9,44
AaB,8600,5,8,11,11,37,42,-5,35
AC Horsens,8600,6,6,13,11,33,54,-21,31
Sonderjyske,8600,7,8,6,10,28,29,-1,30
Lyngby,8600,8,4,9,11,30,46,-16,21
Silkeborg IF,8600,9,6,3,13,26,44,-18,21
Randers FC,8600,10,5,6,13,25,43,-18,21
AGF Aarhus,8600,11,4,6,12,16,37,-21,18
Brondby,8601,1,22,5,3,75,28,47,71
FC Midtjylla,8601,2,18,6,6,63,40,23,60
Copenhagen,8601,3,16,5,9,60,41,19,53
FC Nords,8601,4,13,7,10,70,54,16,46
AaB,8601,5,8,12,10,39,47,-8,36
Sonderjyske,8601,6,8,6,10,28,29,-1,30
AC Horsens,8601,7,5,13,12,30,53,-23,28
Randers FC,8601,8,6,6,12,24,39,-15,24
Silkeborg IF,8601,9,5,4,13,26,45,-19,19
AGF Aarhus,8601,10,4,7,11,17,37,-20,19
Lyngby,8601,11,3,9,12,26,45,-19,18
Brondby,8602,1,21,6,3,74,33,41,69
FC Midtjylla,8602,2,19,5,6,67,41,26,62
FC Nords,8602,3,15,8,7,72,47,25,53
Copenhagen,8602,4,13,6,11,55,42,13,45
AaB,8602,5,9,11,10,36,42,-6,38
Sonderjyske,8602,6,8,6,10,28,29,-1,30
AC Horsens,8602,7,5,12,13,35,60,-25,27
Lyngby,8602,8,4,9,11,29,44,-15,21
Randers FC,8602,9,5,6,13,23,42,-19,21
Silkeborg IF,8602,10,5,4,13,25,44,-19,19
AGF Aarhus,8602,11,4,7,11,16,36,-20,19
Brondby,8603,1,20,7,3,70,31,39,67
FC Midtjylla,8603,2,19,4,7,62,41,21,61
FC Nords,8603,3,15,7,8,80,50,30,52
Copenhagen,8603,4,15,4,11,59,47,12,49
AC Horsens,8603,5,8,12,10,35,50,-15,36
Sonderjyske,8603,6,8,6,10,28,29,-1,30
AaB,8603,7,6,12,12,36,49,-13,30
Lyngby,8603,8,4,9,11,29,45,-16,21
Silkeborg IF,8603,9,6,3,13,26,44,-18,21
Randers FC,8603,10,5,6,13,24,42,-18,21
AGF Aarhus,8603,11,4,6,12,16,37,-21,18
Brondby,8604,1,20,6,4,70,33,37,66
FC Midtjylla,8604,2,19,6,5,65,38,27,63
FC Nords,8604,3,16,7,7,79,46,33,55
Copenhagen,8604,4,13,5,12,57,52,5,44
AaB,8604,5,9,11,10,40,43,-3,38
Sonderjyske,8604,6,8,6,10,28,29,-1,30
AC Horsens,8604,7,5,13,12,34,59,-25,28
Lyngby,8604,8,4,9,11,28,45,-17,21
Silkeborg IF,8604,9,6,3,13,27,44,-17,21
Randers FC,8604,10,5,6,13,24,41,-17,21
AGF Aarhus,8604,11,4,6,12,16,38,-22,18
Brondby,8605,1,21,5,4,69,32,37,68
FC Midtjylla,8605,2,19,5,6,67,41,26,62
Copenhagen,8605,3,16,4,10,69,47,22,52
FC Nords,8605,4,12,6,12,69,63,6,42
AaB,8605,5,8,12,10,38,42,-4,36
AC Horsens,8605,6,8,12,10,36,49,-13,36
Sonderjyske,8605,7,8,6,10,28,29,-1,30
Lyngby,8605,8,4,9,11,28,45,-17,21
Randers FC,8605,9,5,6,13,24,41,-17,21
Silkeborg IF,8605,10,6,3,13,28,46,-18,21
AGF Aarhus,8605,11,4,6,12,18,39,-21,18
Brondby,8606,1,21,6,3,69,32,37,69
FC Midtjylla,8606,2,20,4,6,64,39,25,64
FC Nords,8606,3,14,7,9,78,52,26,49
Copenhagen,8606,4,14,5,11,62,50,12,47
AaB,8606,5,6,14,10,38,46,-8,32
AC Horsens,8606,6,6,14,10,37,55,-18,32
Sonderjyske,8606,7,8,6,10,28,29,-1,30
Randers FC,8606,8,5,7,12,26,42,-16,22
AGF Aarhus,8606,9,5,6,11,17,36,-19,21
Lyngby,8606,10,3,10,11,29,47,-18,19
Silkeborg IF,8606,11,5,3,14,25,45,-20,18
Brondby,8607,1,21,7,2,76,34,42,70
FC Midtjylla,8607,2,18,5,7,64,42,22,59
FC Nords,8607,3,15,7,8,77,48,29,52
Copenhagen,8607,4,13,6,11,61,52,9,45
AC Horsens,8607,5,8,12,10,40,57,-17,36
AaB,8607,6,6,13,11,35,46,-11,31
Sonderjyske,8607,7,8,6,10,28,29,-1,30
Randers FC,8607,8,5,7,12,24,40,-16,22
Silkeborg IF,8607,9,6,3,13,28,44,-16,21
Lyngby,8607,10,3,10,11,27,45,-18,19
AGF Aarhus,8607,11,4,6,12,16,39,-23,18
Brondby,8608,1,23,5,2,75,29,46,74
FC Midtjylla,8608,2,19,6,5,65,36,29,63
FC Nords,8608,3,14,7,9,74,54,20,49
Copenhagen,8608,4,13,5,12,59,48,11,44
AC Horsens,8608,5,6,14,10,33,54,-21,32
AaB,8608,6,6,13,11,35,46,-11,31
Sonderjyske,8608,7,8,6,10,28,29,-1,30
Randers FC,8608,8,5,7,12,25,41,-16,22
AGF Aarhus,8608,9,5,6,11,20,39,-19,21
Lyngby,8608,10,3,10,11,28,46,-18,19
Silkeborg IF,8608,11,5,3,14,28,48,-20,18
Brondby,8609,1,20,6,4,72,37,35,66
FC Midtjylla,8609,2,19,5,6,67,43,24,62
FC Nords,8609,3,15,7,8,75,50,25,52
Copenhagen,8609,4,14,5,11,59,43,16,47
AC Horsens,8609,5,7,13,10,36,55,-19,34
AaB,8609,6,7,12,11,37,44,-7,33
Sonderjyske,8609,7,8,6,10,28,29,-1,30
Lyngby,8609,8,4,9,11,29,45,-16,21
Silkeborg IF,8609,9,6,3,13,28,44,-16,21
Randers FC,8609,10,5,6,13,24,42,-18,21
AGF Aarhus,8609,11,4,6,12,16,39,-23,18
Brondby,8610,1,20,7,3,68,32,36,67
FC Midtjylla,8610,2,20,6,4,64,33,31,66
FC Nords,8610,3,14,7,9,71,49,22,49
Copenhagen,8610,4,14,4,12,56,44,12,46
AaB,8610,5,7,12,11,37,44,-7,33
AC Horsens,8610,6,7,12,11,33,53,-20,33
Sonderjyske,8610,7,8,6,10,28,29,-1,30
Lyngby,8610,8,4,9,11,29,45,-16,21
Randers FC,8610,9,5,6,13,24,42,-18,21
AGF Aarhus,8610,10,5,6,11,18,37,-19,21
Silkeborg IF,8610,11,5,3,14,26,46,-20,18
Brondby,8611,1,21,6,3,68,30,38,69
FC Midtjylla,8611,2,21,5,4,67,33,34,68
FC Nords,8611,3,14,6,10,71,53,18,48
Copenhagen,8611,4,14,6,10,57,41,16,48
AaB,8611,5,7,12,11,36,45,-9,33
Sonderjyske,8611,6,8,6,10,28,29,-1,30
AC Horsens,8611,7,5,13,12,30,53,-23,28
Randers FC,8611,8,5,7,12,25,41,-16,22
Silkeborg IF,8611,9,6,3,13,28,44,-16,21
Lyngby,8611,10,3,10,11,28,46,-18,19
AGF Aarhus,8611,11,4,6,12,16,39,-23,18
Brondby,8612,1,22,6,2,73,32,41,72
FC Midtjylla,8612,2,20,4,6,63,39,24,64
FC Nords,8612,3,14,9,7,77,49,28,51
Copenhagen,8612,4,12,6,12,54,44,10,42
AaB,8612,5,6,14,10,34,41,-7,32
AC Horsens,8612,6,6,13,11,35,57,-22,31
Sonderjyske,8612,7,8,6,10,28,29,-1,30
Lyngby,8612,8,4,9,11,29,44,-15,21
Randers FC,8612,9,5,6,13,23,42,-19,21
AGF Aarhus,8612,10,5,6,11,18,37,-19,21
Silkeborg IF,8612,11,5,3,14,26,46,-20,18
Brondby,8613,1,23,5,2,77,27,50,74
FC Midtjylla,8613,2,18,6,6,61,41,20,60
FC Nords,8613,3,13,8,9,70,52,18,47
Copenhagen,8613,4,14,5,11,57,45,12,47
AaB,8613,5,7,12,11,36,44,-8,33
AC Horsens,8613,6,5,16,9,33,51,-18,31
Sonderjyske,8613,7,8,6,10,28,29,-1,30
Lyngby,8613,8,4,9,11,27,44,-17,21
Randers FC,8613,9,5,6,13,23,40,-17,21
Silkeborg IF,8613,10,6,3,13,26,44,-18,21
AGF Aarhus,8613,11,4,6,12,16,37,-21,18
FC Midtjylla,8614,1,21,5,4,70,37,33,68
Brondby,8614,2,20,6,4,71,33,38,66
FC Nords,8614,3,14,8,8,76,53,23,50
Copenhagen,8614,4,14,6,10,62,48,14,48
AaB,8614,5,7,13,10,36,44,-8,34
Sonderjyske,8614,6,8,6,10,28,29,-1,30
AC Horsens,8614,7,5,12,13,31,57,-26,27
Lyngby,8614,8,4,9,11,28,45,-17,21
Randers FC,8614,9,5,6,13,24,41,-17,21
Silkeborg IF,8614,10,6,3,13,28,46,-18,21
AGF Aarhus,8614,11,4,6,12,18,39,-21,18
Brondby,8615,1,20,6,4,66,32,34,66
FC Midtjylla,8615,2,19,7,4,65,37,28,64
FC Nords,8615,3,15,7,8,75,49,26,52
Copenhagen,8615,4,15,5,10,60,45,15,50
AC Horsens,8615,5,7,12,11,41,55,-14,33
Sonderjyske,8615,6,8,6,10,28,29,-1,30
AaB,8615,7,6,11,13,32,47,-15,29
Randers FC,8615,8,6,6,12,25,40,-15,24
Silkeborg IF,8615,9,5,4,13,26,45,-19,19
AGF Aarhus,8615,10,4,7,11,17,37,-20,19
Lyngby,8615,11,3,9,12,27,46,-19,18
Brondby,8616,1,23,5,2,73,33,40,74
FC Midtjylla,8616,2,18,5,7,66,43,23,59
FC Nords,8616,3,15,7,8,77,53,24,52
Copenhagen,8616,4,15,4,11,60,44,16,49
AC Horsens,8616,5,6,13,11,35,52,-17,31
Sonderjyske,8616,6,8,6,10,28,29,-1,30
AaB,8616,7,6,12,12,36,48,-12,30
Lyngby,8616,8,4,9,11,27,44,-17,21
Randers FC,8616,9,5,6,13,23,40,-17,21
AGF Aarhus,8616,10,5,6,11,18,37,-19,21
Silkeborg IF,8616,11,5,3,14,26,46,-20,18
Brondby,8617,1,20,6,4,67,33,34,66
FC Midtjylla,8617,2,20,4,6,64,37,27,64
FC Nords,8617,3,14,8,8,76,51,25,50
Copenhagen,8617,4,13,7,10,58,45,13,46
AC Horsens,8617,5,8,12,10,34,51,-17,36
AaB,8617,6,6,13,11,36,44,-8,31
Sonderjyske,8617,7,8,6,10,28,29,-1,30
Lyngby,8617,8,4,9,11,27,44,-17,21
Randers FC,8617,9,5,6,13,23,40,-17,21
AGF Aarhus,8617,10,5,6,11,17,36,-19,21
Silkeborg IF,8617,11,5,3,14,25,45,-20,18
Brondby,8618,1,21,6,3,75,35,40,69
FC Midtjylla,8618,2,20,4,6,71,41,30,64
FC Nords,8618,3,14,6,10,71,53,18,48
Copenhagen,8618,4,13,4,13,59,51,8,43
AaB,8618,5,9,12,9,41,41,0,39
AC Horsens,8618,6,7,12,11,33,55,-22,33
Sonderjyske,8618,7,8,6,10,28,29,-1,30
Randers FC,8618,8,6,6,12,25,39,-14,24
Silkeborg IF,8618,9,6,3,13,30,45,-15,21
Lyngby,8618,10,3,9,12,26,46,-20,18
AGF Aarhus,8618,11,4,6,12,17,41,-24,18
Brondby,8619,1,20,7,3,68,33,35,67
FC Midtjylla,8619,2,20,5,5,69,40,29,65
FC Nords,8619,3,15,6,9,72,48,24,51
Copenhagen,8619,4,15,5,10,57,41,16,50
AaB,8619,5,7,11,12,39,47,-8,32
Sonderjyske,8619,6,8,6,10,28,29,-1,30
AC Horsens,8619,7,6,12,12,35,57,-22,30
Lyngby,8619,8,4,9,11,30,44,-14,21
AGF Aarhus,8619,9,5,6,11,18,37,-19,21
Randers FC,8619,10,5,6,13,23,43,-20,21
Silkeborg IF,8619,11,5,3,14,26,46,-20,18
Brondby,8620,1,19,7,4,66,33,33,64
FC Midtjylla,8620,2,19,5,6,66,39,27,62
Copenhagen,8620,3,15,4,11,55,42,13,49
FC Nords,8620,4,13,8,9,71,53,18,47
AC Horsens,8620,5,9,12,9,37,49,-12,39
AaB,8620,6,7,12,11,36,41,-5,33
Sonderjyske,8620,7,8,6,10,28,29,-1,30
Lyngby,8620,8,4,9,11,29,46,-17,21
Randers FC,8620,9,5,6,13,25,42,-17,21
AGF Aarhus,8620,10,5,6,11,18,37,-19,21
Silkeborg IF,8620,11,5,3,14,26,46,-20,18
FC Midtjylla,8621,1,21,5,4,72,40,32,68
Brondby,8621,2,20,5,5,72,38,34,65
Copenhagen,8621,3,14,5,11,60,45,15,47
FC Nords,8621,4,12,8,10,70,56,14,44
AaB,8621,5,8,12,10,38,43,-5,36
AC Horsens,8621,6,7,13,10,35,51,-16,34
Sonderjyske,8621,7,8,6,10,28,29,-1,30
Lyngby,8621,8,4,9,11,27,44,-17,21
Randers FC,8621,9,5,6,13,23,40,-17,21
Silkeborg IF,8621,10,5,4,13,26,45,-19,19
AGF Aarhus,8621,11,4,7,11,17,37,-20,19
Brondby,8622,1,21,6,3,71,30,41,69
FC Midtjylla,8622,2,20,4,6,68,41,27,64
FC Nords,8622,3,15,6,9,71,52,19,51
Copenhagen,8622,4,13,6,11,59,46,13,45
AaB,8622,5,8,11,11,40,46,-6,35
AC Horsens,8622,6,6,13,11,33,53,-20,31
Sonderjyske,8622,7,8,6,10,28,29,-1,30
Lyngby,8622,8,4,9,11,28,44,-16,21
Randers FC,8622,9,5,6,13,23,41,-18,21
Silkeborg IF,8622,10,5,4,13,26,45,-19,19
AGF Aarhus,8622,11,4,7,11,17,37,-20,19
Brondby,8623,1,21,6,3,73,30,43,69
FC Midtjylla,8623,2,21,4,5,68,36,32,67
FC Nords,8623,3,14,7,9,72,49,23,49
Copenhagen,8623,4,13,6,11,54,43,11,45
AaB,8623,5,7,11,12,34,49,-15,32
AC Horsens,8623,6,6,14,10,33,53,-20,32
Sonderjyske,8623,7,8,6,10,28,29,-1,30
Lyngby,8623,8,4,9,11,30,45,-15,21
AGF Aarhus,8623,9,5,6,11,18,36,-18,21
Randers FC,8623,10,5,6,13,24,43,-19,21
Silkeborg IF,8623,11,5,3,14,25,46,-21,18
Brondby,8624,1,21,6,3,73,34,39,69
FC Midtjylla,8624,2,19,4,7,65,42,23,61
FC Nords,8624,3,17,6,7,81,50,31,57
Copenhagen,8624,4,14,5,11,57,46,11,47
AaB,8624,5,8,11,11,38,45,-7,35
Sonderjyske,8624,6,8,6,10,28,29,-1,30
AC Horsens,8624,7,5,12,13,32,55,-23,27
Silkeborg IF,8624,8,6,3,13,29,46,-17,21
Lyngby,8624,9,4,9,11,27,44,-17,21
Randers FC,8624,10,5,6,13,23,40,-17,21
AGF Aarhus,8624,11,4,6,12,18,40,-22,18
Brondby,8625,1,20,7,3,67,32,35,67
FC Midtjylla,8625,2,18,5,7,60,39,21,59
Copenhagen,8625,3,17,4,9,65,39,26,55
FC Nords,8625,4,13,8,9,69,52,17,47
AaB,8625,5,8,11,11,34,41,-7,35
AC Horsens,8625,6,6,13,11,33,51,-18,31
Sonderjyske,8625,7,8,6,10,28,29,-1,30
Randers FC,8625,8,5,7,12,25,41,-16,22
AGF Aarhus,8625,9,5,6,11,17,36,-19,21
Lyngby,8625,10,3,10,11,28,46,-18,19
Silkeborg IF,8625,11,5,3,14,25,45,-20,18
Brondby,8626,1,21,6,3,71,32,39,69
FC Midtjylla,8626,2,19,5,6,63,41,22,62
FC Nords,8626,3,16,6,8,73,49,24,54
Copenhagen,8626,4,14,4,12,59,44,15,46
AaB,8626,5,7,12,11,36,45,-9,33
AC Horsens,8626,6,6,13,11,32,49,-17,31
Sonderjyske,8626,7,8,6,10,28,29,-1,30
Lyngby,8626,8,4,9,11,28,44,-16,21
Silkeborg IF,8626,9,6,3,13,28,45,-17,21
Randers FC,8626,10,5,6,13,23,41,-18,21
AGF Aarhus,8626,11,4,6,12,17,39,-22,18
FC Midtjylla,8627,1,21,5,4,65,36,29,68
Brondby,8627,2,20,7,3,71,36,35,67
FC Nords,8627,3,13,8,9,71,51,20,47
Copenhagen,8627,4,13,6,11,54,43,11,45
AC Horsens,8627,5,7,14,9,38,49,-11,35
Sonderjyske,8627,6,8,6,10,28,29,-1,30
AaB,8627,7,6,12,12,34,44,-10,30
Randers FC,8627,8,6,6,12,25,40,-15,24
Silkeborg IF,8627,9,6,3,13,27,45,-18,21
Lyngby,8627,10,3,9,12,27,46,-19,18
AGF Aarhus,8627,11,4,6,12,17,38,-21,18
Brondby,8628,1,19,6,5,68,37,31,63
FC Midtjylla,8628,2,19,5,6,64,39,25,62
FC Nords,8628,3,13,9,8,72,50,22,48
Copenhagen,8628,4,13,6,11,55,44,11,45
AaB,8628,5,10,12,8,42,38,4,42
AC Horsens,8628,6,7,12,11,34,53,-19,33
Sonderjyske,8628,7,8,6,10,28,29,-1,30
Lyngby,8628,8,4,9,11,28,45,-17,21
Randers FC,8628,9,5,6,13,24,41,-17,21
Silkeborg IF,8628,10,6,3,13,27,45,-18,21
AGF Aarhus,8628,11,4,6,12,17,38,-21,18
FC Midtjylla,8629,1,21,5,4,68,35,33,68
Brondby,8629,2,20,6,4,69,32,37,66
FC Nords,8629,3,14,7,9,72,52,20,49
Copenhagen,8629,4,13,8,9,60,45,15,47
AC Horsens,8629,5,7,13,10,36,54,-18,34
Sonderjyske,8629,6,8,6,10,28,29,-1,30
AaB,8629,7,6,11,13,34,47,-13,29
Randers FC,8629,8,5,7,12,23,39,-16,22
Silkeborg IF,8629,9,6,3,13,28,45,-17,21
Lyngby,8629,10,3,10,11,26,44,-18,19
AGF Aarhus,8629,11,4,6,12,17,39,-22,18
Brondby,8630,1,22,5,3,73,31,42,71
FC Midtjylla,8630,2,20,5,5,71,40,31,65
FC Nords,8630,3,15,6,9,76,52,24,51
Copenhagen,8630,4,12,5,13,53,49,4,41
AaB,8630,5,8,11,11,39,46,-7,35
AC Horsens,8630,6,7,12,11,35,55,-20,33
Sonderjyske,8630,7,8,6,10,28,29,-1,30
Randers FC,8630,8,6,6,12,25,39,-14,24
Silkeborg IF,8630,9,5,4,13,28,47,-19,19
AGF Aarhus,8630,10,4,7,11,19,39,-20,19
Lyngby,8630,11,3,9,12,26,46,-20,18
Brondby,8631,1,22,5,3,75,32,43,71
FC Midtjylla,8631,2,18,4,8,60,44,16,58
Copenhagen,8631,3,15,4,11,60,43,17,49
FC Nords,8631,4,13,7,10,71,57,14,46
AC Horsens,8631,5,9,13,8,42,49,-7,40
AaB,8631,6,6,13,11,34,43,-9,31
Sonderjyske,8631,7,8,6,10,28,29,-1,30
Randers FC,8631,8,5,7,12,24,40,-16,22
Lyngby,8631,9,3,10,11,27,45,-18,19
Silkeborg IF,8631,10,5,4,13,25,44,-19,19
AGF Aarhus,8631,11,4,7,11,16,36,-20,19
Brondby,8632,1,22,5,3,75,36,39,71
FC Midtjylla,8632,2,18,5,7,62,42,20,59
FC Nords,8632,3,14,6,10,79,54,25,48
Copenhagen,8632,4,13,4,13,59,49,10,43
AaB,8632,5,10,11,9,39,41,-2,41
AC Horsens,8632,6,7,13,10,35,53,-18,34
Sonderjyske,8632,7,8,6,10,28,29,-1,30
Randers FC,8632,8,6,6,12,25,39,-14,24
Silkeborg IF,8632,9,6,3,13,27,44,-17,21
Lyngby,8632,10,3,9,12,26,46,-20,18
AGF Aarhus,8632,11,4,6,12,16,38,-22,18
Brondby,8633,1,23,5,2,75,30,45,74
FC Midtjylla,8633,2,21,4,5,66,40,26,67
FC Nords,8633,3,15,6,9,73,51,22,51
Copenhagen,8633,4,13,4,13,54,48,6,43
AaB,8633,5,7,12,11,39,44,-5,33
Sonderjyske,8633,6,8,6,10,28,29,-1,30
AC Horsens,8633,7,5,13,12,32,52,-20,28
Randers FC,8633,8,6,6,12,25,40,-15,24
AGF Aarhus,8633,9,5,6,11,19,38,-19,21
Lyngby,8633,10,3,9,12,27,46,-19,18
Silkeborg IF,8633,11,5,3,14,27,47,-20,18
FC Midtjylla,8634,1,20,5,5,65,37,28,65
Brondby,8634,2,18,7,5,68,38,30,61
FC Nords,8634,3,14,7,9,72,50,22,49
Copenhagen,8634,4,14,7,9,58,43,15,49
AaB,8634,5,7,13,10,35,42,-7,34
AC Horsens,8634,6,7,13,10,37,51,-14,34
Sonderjyske,8634,7,8,6,10,28,29,-1,30
Lyngby,8634,8,4,9,11,28,45,-17,21
Randers FC,8634,9,5,6,13,24,41,-17,21
AGF Aarhus,8634,10,5,6,11,20,37,-17,21
Silkeborg IF,8634,11,5,3,14,26,48,-22,18
Brondby,8635,1,21,5,4,71,34,37,68
FC Midtjylla,8635,2,20,4,6,69,45,24,64
FC Nords,8635,3,12,8,10,70,55,15,44
Copenhagen,8635,4,13,5,12,60,47,13,44
AaB,8635,5,9,11,10,44,44,0,38
AC Horsens,8635,6,8,13,9,38,53,-15,37
Sonderjyske,8635,7,8,6,10,28,29,-1,30
Lyngby,8635,8,4,9,11,27,44,-17,21
Randers FC,8635,9,5,6,13,23,40,-17,21
Silkeborg IF,8635,10,5,4,13,26,45,-19,19
AGF Aarhus,8635,11,4,7,11,17,37,-20,19
Brondby,8636,1,23,5,2,72,31,41,74
FC Midtjylla,8636,2,20,4,6,64,38,26,64
FC Nords,8636,3,16,6,8,72,45,27,54
Copenhagen,8636,4,13,4,13,55,47,8,43
AaB,8636,5,7,12,11,36,44,-8,33
Sonderjyske,8636,6,8,6,10,28,29,-1,30
AC Horsens,8636,7,5,13,12,32,52,-20,28
Randers FC,8636,8,5,7,12,25,41,-16,22
AGF Aarhus,8636,9,5,6,11,18,37,-19,21
Lyngby,8636,10,3,10,11,28,46,-18,19
Silkeborg IF,8636,11,5,3,14,26,46,-20,18
Brondby,8637,1,22,6,2,74,32,42,72
FC Midtjylla,8637,2,19,7,4,62,36,26,64
Copenhagen,8637,3,14,5,11,56,42,14,47
FC Nords,8637,4,12,7,11,73,60,13,43
AaB,8637,5,8,12,10,39,41,-2,36
AC Horsens,8637,6,6,13,11,35,54,-19,31
Sonderjyske,8637,7,8,6,10,28,29,-1,30
Randers FC,8637,8,6,6,12,24,39,-15,24
Silkeborg IF,8637,9,5,4,13,27,46,-19,19
AGF Aarhus,8637,10,4,7,11,18,38,-20,19
Lyngby,8637,11,3,9,12,26,45,-19,18
Brondby,8638,1,21,6,3,73,29,44,69
FC Midtjylla,8638,2,19,4,7,68,47,21,61
Copenhagen,8638,3,15,5,10,59,40,19,50
FC Nords,8638,4,14,7,9,71,52,19,49
AC Horsens,8638,5,7,13,10,33,51,-18,34
AaB,8638,6,6,13,11,36,47,-11,31
Sonderjyske,8638,7,8,6,10,28,29,-1,30
Lyngby,8638,8,4,9,11,28,44,-16,21
Randers FC,8638,9,5,6,13,23,41,-18,21
Silkeborg IF,8638,10,5,4,13,25,44,-19,19
AGF Aarhus,8638,11,4,7,11,16,36,-20,19
Brondby,8639,1,21,5,4,68,35,33,68
FC Midtjylla,8639,2,19,6,5,59,34,25,63
FC Nords,8639,3,14,8,8,73,49,24,50
Copenhagen,8639,4,12,5,13,53,45,8,41
AaB,8639,5,8,13,9,39,41,-2,37
AC Horsens,8639,6,7,13,10,33,47,-14,34
Sonderjyske,8639,7,8,6,10,28,29,-1,30
Randers FC,8639,8,5,7,12,24,40,-16,22
Lyngby,8639,9,3,10,11,27,45,-18,19
Silkeborg IF,8639,10,5,4,13,26,45,-19,19
AGF Aarhus,8639,11,4,7,11,17,37,-20,19
Brondby,8640,1,22,6,2,77,31,46,72
FC Midtjylla,8640,2,19,6,5,69,40,29,63
FC Nords,8640,3,14,6,10,72,57,15,48
Copenhagen,8640,4,12,7,11,56,47,9,43
AaB,8640,5,7,13,10,34,42,-8,34
AC Horsens,8640,6,6,14,10,35,52,-17,32
Sonderjyske,8640,7,8,6,10,28,29,-1,30
Lyngby,8640,8,4,9,11,29,44,-15,21
Randers FC,8640,9,5,6,13,23,42,-19,21
Silkeborg IF,8640,10,5,4,13,26,45,-19,19
AGF Aarhus,8640,11,4,7,11,17,37,-20,19
Brondby,8641,1,20,6,4,69,33,36,66
FC Midtjylla,8641,2,19,4,7,63,43,20,61
FC Nords,8641,3,16,7,7,78,47,31,55
Copenhagen,8641,4,15,5,10,60,45,15,50
AaB,8641,5,6,13,11,36,47,-11,31
AC Horsens,8641,6,6,13,11,34,51,-17,31
Sonderjyske,8641,7,8,6,10,28,29,-1,30
Randers FC,8641,8,5,7,12,24,40,-16,22
Silkeborg IF,8641,9,6,3,13,27,44,-17,21
Lyngby,8641,10,3,10,11,27,45,-18,19
AGF Aarhus,8641,11,4,6,12,16,38,-22,18
Brondby,8642,1,22,6,2,70,27,43,72
FC Midtjylla,8642,2,19,4,7,62,40,22,61
FC Nords,8642,3,16,6,8,78,51,27,54
Copenhagen,8642,4,13,5,12,55,47,8,44
AaB,8642,5,7,13,10,33,38,-5,34
Sonderjyske,8642,6,8,6,10,28,29,-1,30
AC Horsens,8642,7,5,14,11,33,54,-21,29
Randers FC,8642,8,5,7,12,25,41,-16,22
Silkeborg IF,8642,9,6,3,13,29,46,-17,21
Lyngby,8642,10,3,10,11,28,46,-18,19
AGF Aarhus,8642,11,4,6,12,18,40,-22,18
Brondby,8643,1,20,6,4,73,38,35,66
FC Midtjylla,8643,2,20,5,5,65,39,26,65
FC Nords,8643,3,14,7,9,72,48,24,49
Copenhagen,8643,4,14,4,12,59,45,14,46
AC Horsens,8643,5,8,13,9,38,49,-11,37
AaB,8643,6,7,11,12,33,47,-14,32
Sonderjyske,8643,7,8,6,10,28,29,-1,30
Lyngby,8643,8,4,9,11,27,44,-17,21
Randers FC,8643,9,5,6,13,23,40,-17,21
Silkeborg IF,8643,10,5,4,13,27,46,-19,19
AGF Aarhus,8643,11,4,7,11,18,38,-20,19
Brondby,8644,1,21,5,4,73,35,38,68
FC Midtjylla,8644,2,20,4,6,70,43,27,64
FC Nords,8644,3,17,6,7,84,53,31,57
Copenhagen,8644,4,13,5,12,57,51,6,44
AaB,8644,5,7,12,11,37,46,-9,33
Sonderjyske,8644,6,8,6,10,28,29,-1,30
AC Horsens,8644,7,5,14,11,39,58,-19,29
Randers FC,8644,8,6,6,12,25,39,-14,24
Silkeborg IF,8644,9,6,3,13,27,44,-17,21
Lyngby,8644,10,3,9,12,26,46,-20,18
AGF Aarhus,8644,11,4,6,12,16,38,-22,18
Brondby,8645,1,21,5,4,72,33,39,68
FC Midtjylla,8645,2,21,5,4,69,37,32,68
FC Nords,8645,3,15,7,8,74,49,25,52
Copenhagen,8645,4,15,4,11,59,46,13,49
AaB,8645,5,7,11,12,34,45,-11,32
Sonderjyske,8645,6,8,6,10,28,29,-1,30
AC Horsens,8645,7,5,12,13,31,55,-24,27
Randers FC,8645,8,6,6,12,25,39,-14,24
Silkeborg IF,8645,9,5,4,13,26,45,-19,19
AGF Aarhus,8645,10,4,7,11,17,37,-20,19
Lyngby,8645,11,3,9,12,26,46,-20,18
Brondby,8646,1,21,5,4,68,31,37,68
FC Midtjylla,8646,2,19,4,7,63,39,24,61
FC Nords,8646,3,15,6,9,70,48,22,51
Copenhagen,8646,4,14,5,11,55,45,10,47
AC Horsens,8646,5,8,13,9,39,48,-9,37
AaB,8646,6,6,13,11,35,45,-10,31
Sonderjyske,8646,7,8,6,10,28,29,-1,30
Randers FC,8646,8,6,6,12,25,39,-14,24
AGF Aarhus,8646,9,5,6,11,18,37,-19,21
Lyngby,8646,10,3,9,12,26,46,-20,18
Silkeborg IF,8646,10,5,3,14,26,46,-20,18
Brondby,8647,1,21,5,4,69,38,31,68
FC Midtjylla,8647,2,20,4,6,66,38,28,64
FC Nords,8647,3,16,6,8,77,48,29,54
Copenhagen,8647,4,14,4,12,61,46,15,46
AaB,8647,5,8,11,11,42,50,-8,35
Sonderjyske,8647,6,8,6,10,28,29,-1,30
AC Horsens,8647,7,6,12,12,36,57,-21,30
Randers FC,8647,8,5,7,12,24,40,-16,22
Silkeborg IF,8647,9,6,3,13,27,44,-17,21
Lyngby,8647,10,3,10,11,27,45,-18,19
AGF Aarhus,8647,11,4,6,12,16,38,-22,18
Brondby,8648,1,21,6,3,71,32,39,69
FC Midtjylla,8648,2,18,6,6,65,44,21,60
Copenhagen,8648,3,16,4,10,58,44,14,52
FC Nords,8648,4,13,8,9,71,52,19,47
AC Horsens,8648,5,7,13,10,41,53,-12,34
AaB,8648,6,7,11,12,37,44,-7,32
Sonderjyske,8648,7,8,6,10,28,29,-1,30
Lyngby,8648,8,4,9,11,30,45,-15,21
AGF Aarhus,8648,9,5,6,11,21,36,-15,21
Randers FC,8648,10,5,6,13,24,43,-19,21
Silkeborg IF,8648,11,5,3,14,25,49,-24,18
Brondby,8649,1,21,6,3,72,33,39,69
FC Midtjylla,8649,2,20,5,5,67,38,29,65
FC Nords,8649,3,13,9,8,71,47,24,48
Copenhagen,8649,4,13,7,10,55,43,12,46
AaB,8649,5,7,12,11,36,45,-9,33
AC Horsens,8649,6,6,13,11,34,55,-21,31
Sonderjyske,8649,7,8,6,10,28,29,-1,30
Randers FC,8649,8,6,6,12,25,40,-15,24
AGF Aarhus,8649,9,5,6,11,20,37,-17,21
Lyngby,8649,10,3,9,12,27,46,-19,18
Silkeborg IF,8649,11,5,3,14,26,48,-22,18
Brondby,8650,1,21,7,2,73,33,40,70
FC Midtjylla,8650,2,19,5,6,62,42,20,62
FC Nords,8650,3,14,9,7,74,48,26,51
Copenhagen,8650,4,12,4,14,53,48,5,40
AaB,8650,5,9,13,8,39,37,2,40
Sonderjyske,8650,6,8,6,10,28,29,-1,30
AC Horsens,8650,7,6,12,12,34,53,-19,30
Lyngby,8650,8,4,9,11,30,45,-15,21
Silkeborg IF,8650,9,6,3,13,27,44,-17,21
Randers FC,8650,10,5,6,13,24,43,-19,21
AGF Aarhus,8650,11,4,6,12,16,38,-22,18
Brondby,8651,1,20,5,5,65,31,34,65
FC Midtjylla,8651,2,19,5,6,62,37,25,62
Copenhagen,8651,3,15,6,9,59,42,17,51
FC Nords,8651,4,14,7,9,70,48,22,49
AaB,8651,5,9,11,10,37,40,-3,38
Sonderjyske,8651,6,8,6,10,28,29,-1,30
AC Horsens,8651,7,6,12,12,34,55,-21,30
Lyngby,8651,8,4,9,11,30,44,-14,21
Silkeborg IF,8651,9,6,3,13,26,44,-18,21
Randers FC,8651,10,5,6,13,23,43,-20,21
AGF Aarhus,8651,11,4,6,12,16,37,-21,18
Brondby,8652,1,20,7,3,68,31,37,67
FC Midtjylla,8652,2,20,6,4,74,39,35,66
Copenhagen,8652,3,14,5,11,57,50,7,47
FC Nords,8652,4,12,9,9,68,50,18,45
AC Horsens,8652,5,7,13,10,35,53,-18,34
AaB,8652,6,7,12,11,35,40,-5,33
Sonderjyske,8652,7,8,6,10,28,29,-1,30
Lyngby,8652,8,4,9,11,28,44,-16,21
Silkeborg IF,8652,9,6,3,13,26,44,-18,21
Randers FC,8652,10,5,6,13,23,41,-18,21
AGF Aarhus,8652,11,4,6,12,16,37,-21,18
Brondby,8653,1,22,5,3,77,32,45,71
FC Midtjylla,8653,2,19,5,6,67,42,25,62
Copenhagen,8653,3,16,4,10,61,45,16,52
FC Nords,8653,4,14,6,10,71,52,19,48
AaB,8653,5,7,11,12,37,49,-12,32
AC Horsens,8653,6,6,13,11,37,56,-19,31
Sonderjyske,8653,7,8,6,10,28,29,-1,30
Randers FC,8653,8,5,7,12,23,39,-16,22
Silkeborg IF,8653,9,6,3,13,29,45,-16,21
Lyngby,8653,10,3,10,11,26,44,-18,19
AGF Aarhus,8653,11,4,6,12,17,40,-23,18
Brondby,8654,1,20,7,3,68,32,36,67
FC Midtjylla,8654,2,20,4,6,64,36,28,64
FC Nords,8654,3,13,6,11,71,58,13,45
Copenhagen,8654,4,13,5,12,57,46,11,44
AaB,8654,5,9,11,10,39,40,-1,38
AC Horsens,8654,6,8,13,9,37,50,-13,37
Sonderjyske,8654,7,8,6,10,28,29,-1,30
Randers FC,8654,8,5,7,12,24,40,-16,22
Silkeborg IF,8654,9,6,3,13,26,44,-18,21
Lyngby,8654,10,3,10,11,27,45,-18,19
AGF Aarhus,8654,11,4,6,12,16,37,-21,18
Brondby,8655,1,20,7,3,70,34,36,67
FC Midtjylla,8655,2,21,4,5,65,39,26,67
Copenhagen,8655,3,13,7,10,58,41,17,46
FC Nords,8655,4,13,6,11,67,51,16,45
AaB,8655,5,8,12,10,34,39,-5,36
AC Horsens,8655,6,6,14,10,35,51,-16,32
Sonderjyske,8655,7,8,6,10,28,29,-1,30
Lyngby,8655,8,4,9,11,29,46,-17,21
Randers FC,8655,9,5,6,13,25,42,-17,21
AGF Aarhus,8655,10,5,6,11,19,36,-17,21
Silkeborg IF,8655,11,5,3,14,25,47,-22,18
Brondby,8656,1,21,6,3,73,32,41,69
FC Midtjylla,8656,2,19,7,4,71,41,30,64
FC Nords,8656,3,14,7,9,72,51,21,49
Copenhagen,8656,4,14,6,10,59,45,14,48
AaB,8656,5,7,12,11,36,44,-8,33
Sonderjyske,8656,6,8,6,10,28,29,-1,30
AC Horsens,8656,7,6,12,12,35,59,-24,30
Randers FC,8656,8,5,7,12,24,40,-16,22
Silkeborg IF,8656,9,6,3,13,28,46,-18,21
Lyngby,8656,10,3,10,11,27,45,-18,19
AGF Aarhus,8656,11,4,6,12,18,39,-21,18
Brondby,8657,1,21,5,4,73,31,42,68
FC Midtjylla,8657,2,18,5,7,63,45,18,59
Copenhagen,8657,3,16,5,9,62,42,20,53
FC Nords,8657,4,14,7,9,73,54,19,49
AaB,8657,5,7,14,9,38,42,-4,35
Sonderjyske,8657,6,8,6,10,28,29,-1,30
AC Horsens,8657,7,5,14,11,34,55,-21,29
Randers FC,8657,8,5,7,12,24,40,-16,22
Silkeborg IF,8657,9,6,3,13,27,44,-17,21
Lyngby,8657,10,3,10,11,27,45,-18,19
AGF Aarhus,8657,11,4,6,12,16,38,-22,18
Brondby,8658,1,22,5,3,75,32,43,71
FC Midtjylla,8658,2,21,4,5,70,43,27,67
FC Nords,8658,3,15,6,9,79,57,22,51
Copenhagen,8658,4,13,6,11,56,45,11,45
AC Horsens,8658,5,6,13,11,33,52,-19,31
Sonderjyske,8658,6,8,6,10,28,29,-1,30
AaB,8658,7,6,12,12,35,45,-10,30
Lyngby,8658,8,4,9,11,28,44,-16,21
Silkeborg IF,8658,9,6,3,13,26,44,-18,21
Randers FC,8658,10,5,6,13,23,41,-18,21
AGF Aarhus,8658,11,4,6,12,16,37,-21,18
Brondby,8659,1,19,8,3,69,35,34,65
FC Midtjylla,8659,2,19,6,5,65,37,28,63
FC Nords,8659,3,14,7,9,72,54,18,49
Copenhagen,8659,4,14,5,11,57,44,13,47
AC Horsens,8659,5,7,14,9,36,49,-13,35
AaB,8659,6,7,12,11,35,41,-6,33
Sonderjyske,8659,7,8,6,10,28,29,-1,30
Lyngby,8659,8,4,9,11,29,44,-15,21
Randers FC,8659,9,5,6,13,23,42,-19,21
Silkeborg IF,8659,10,5,4,13,27,46,-19,19
AGF Aarhus,8659,11,4,7,11,18,38,-20,19
Brondby,8660,1,21,6,3,70,29,41,69
FC Midtjylla,8660,2,19,6,5,63,36,27,63
Copenhagen,8660,3,13,7,10,55,43,12,46
FC Nords,8660,4,12,9,9,73,57,16,45
AaB,8660,5,8,13,9,40,40,0,37
Sonderjyske,8660,6,8,6,10,28,29,-1,30
AC Horsens,8660,7,5,15,10,32,54,-22,30
Lyngby,8660,8,4,9,11,28,45,-17,21
Randers FC,8660,9,5,6,13,24,41,-17,21
AGF Aarhus,8660,10,5,6,11,19,38,-19,21
Silkeborg IF,8660,11,5,3,14,27,47,-20,18
Brondby,8661,1,22,5,3,78,32,46,71
FC Midtjylla,8661,2,20,5,5,67,40,27,65
FC Nords,8661,3,14,7,9,74,55,19,49
Copenhagen,8661,4,13,5,12,59,47,12,44
AaB,8661,5,8,12,10,37,44,-7,36
Sonderjyske,8661,6,8,6,10,28,29,-1,30
AC Horsens,8661,7,6,12,12,31,54,-23,30
Lyngby,8661,8,4,9,11,27,44,-17,21
Randers FC,8661,9,5,6,13,23,40,-17,21
Silkeborg IF,8661,10,6,3,13,26,44,-18,21
AGF Aarhus,8661,11,4,6,12,16,37,-21,18
Brondby,8662,1,20,8,2,70,31,39,68
FC Midtjylla,8662,2,19,5,6,64,37,27,62
Copenhagen,8662,3,16,4,10,58,41,17,52
FC Nords,8662,4,13,8,9,68,49,19,47
AaB,8662,5,7,11,12,37,48,-11,32
AC Horsens,8662,6,6,14,10,33,50,-17,32
Sonderjyske,8662,7,8,6,10,28,29,-1,30
Lyngby,8662,8,4,9,11,29,45,-16,21
Silkeborg IF,8662,9,6,3,13,26,44,-18,21
Randers FC,8662,10,5,6,13,24,42,-18,21
AGF Aarhus,8662,11,4,6,12,16,37,-21,18
Brondby,8663,1,20,8,2,68,30,38,68
FC Midtjylla,8663,2,19,4,7,67,40,27,61
Copenhagen,8663,3,16,5,9,61,40,21,53
FC Nords,8663,4,15,7,8,75,49,26,52
AaB,8663,5,7,12,11,37,45,-8,33
Sonderjyske,8663,6,8,6,10,28,29,-1,30
AC Horsens,8663,7,5,12,13,30,60,-30,27
Randers FC,8663,8,6,6,12,25,40,-15,24
AGF Aarhus,8663,9,5,6,11,17,36,-19,21
Lyngby,8663,10,3,9,12,27,46,-19,18
Silkeborg IF,8663,11,5,3,14,25,45,-20,18
Brondby,8664,1,20,6,4,69,33,36,66
FC Midtjylla,8664,2,18,4,8,64,45,19,58
Copenhagen,8664,3,15,5,10,61,43,18,50
FC Nords,8664,4,14,6,10,74,55,19,48
AC Horsens,8664,5,8,13,9,34,47,-13,37
AaB,8664,6,8,12,10,40,45,-5,36
Sonderjyske,8664,7,8,6,10,28,29,-1,30
Lyngby,8664,8,4,9,11,29,46,-17,21
Silkeborg IF,8664,9,6,3,13,27,44,-17,21
Randers FC,8664,10,5,6,13,25,42,-17,21
AGF Aarhus,8664,11,4,6,12,16,38,-22,18
Brondby,8665,1,20,8,2,71,33,38,68
FC Midtjylla,8665,2,19,6,5,65,38,27,63
FC Nords,8665,3,13,9,8,75,53,22,48
Copenhagen,8665,4,12,7,11,54,45,9,43
AaB,8665,5,8,11,11,36,43,-7,35
AC Horsens,8665,6,6,15,9,35,50,-15,33
Sonderjyske,8665,7,8,6,10,28,29,-1,30
Lyngby,8665,8,4,9,11,27,44,-17,21
Randers FC,8665,9,5,6,13,23,40,-17,21
Silkeborg IF,8665,10,6,3,13,27,45,-18,21
AGF Aarhus,8665,11,4,6,12,17,38,-21,18
Brondby,8666,1,22,6,2,70,28,42,72
FC Midtjylla,8666,2,19,5,6,69,42,27,62
FC Nords,8666,3,13,7,10,71,55,16,46
Copenhagen,8666,4,13,5,12,56,46,10,44
AaB,8666,5,7,14,9,38,43,-5,35
AC Horsens,8666,6,7,13,10,38,54,-16,34
Sonderjyske,8666,7,8,6,10,28,29,-1,30
Lyngby,8666,8,4,9,11,29,45,-16,21
Silkeborg IF,8666,9,6,3,13,28,45,-17,21
Randers FC,8666,10,5,6,13,24,42,-18,21
AGF Aarhus,8666,11,4,6,12,17,39,-22,18
Brondby,8667,1,21,6,3,70,30,40,69
FC Midtjylla,8667,2,19,5,6,66,43,23,62
FC Nords,8667,3,16,7,7,75,48,27,55
Copenhagen,8667,4,12,6,12,56,47,9,42
AaB,8667,5,8,11,11,35,40,-5,35
AC Horsens,8667,6,6,13,11,33,53,-20,31
Sonderjyske,8667,7,8,6,10,28,29,-1,30
Lyngby,8667,8,4,9,11,27,44,-17,21
Randers FC,8667,9,5,6,13,23,40,-17,21
Silkeborg IF,8667,10,6,3,13,26,44,-18,21
AGF Aarhus,8667,11,4,6,12,16,37,-21,18
Brondby,8668,1,21,6,3,73,34,39,69
FC Midtjylla,8668,2,20,4,6,71,43,28,64
FC Nords,8668,3,15,7,8,73,49,24,52
Copenhagen,8668,4,14,5,11,54,44,10,47
AC Horsens,8668,5,6,14,10,38,52,-14,32
Sonderjyske,8668,6,8,6,10,28,29,-1,30
AaB,8668,7,6,12,12,33,46,-13,30
Lyngby,8668,8,4,9,11,27,44,-17,21
Randers FC,8668,9,5,6,13,23,40,-17,21
Silkeborg IF,8668,10,6,3,13,26,44,-18,21
AGF Aarhus,8668,11,4,6,12,16,37,-21,18
Brondby,8669,1,21,5,4,68,34,34,68
FC Midtjylla,8669,2,20,4,6,65,37,28,64
FC Nords,8669,3,15,6,9,76,50,26,51
Copenhagen,8669,4,14,4,12,60,50,10,46
AaB,8669,5,8,12,10,34,41,-7,36
AC Horsens,8669,6,6,13,11,36,53,-17,31
Sonderjyske,8669,7,8,6,10,28,29,-1,30
Randers FC,8669,8,6,6,12,26,41,-15,24
AGF Aarhus,8669,9,5,6,11,17,36,-19,21
Lyngby,8669,10,3,9,12,28,47,-19,18
Silkeborg IF,8669,11,5,3,14,25,45,-20,18
Brondby,8670,1,21,6,3,74,35,39,69
FC Midtjylla,8670,2,18,5,7,64,43,21,59
FC Nords,8670,3,16,6,8,75,49,26,54
Copenhagen,8670,4,13,6,11,59,47,12,45
AaB,8670,5,8,12,10,40,44,-4,36
AC Horsens,8670,6,6,13,11,35,55,-20,31
Sonderjyske,8670,7,8,6,10,28,29,-1,30
Lyngby,8670,8,4,9,11,28,45,-17,21
Silkeborg IF,8670,9,6,3,13,27,44,-17,21
Randers FC,8670,10,5,6,13,24,41,-17,21
AGF Aarhus,8670,11,4,6,12,16,38,-22,18
Brondby,8671,1,20,6,4,70,35,35,66
FC Midtjylla,8671,2,18,4,8,63,40,23,58
FC Nords,8671,3,14,7,9,77,51,26,49
Copenhagen,8671,4,14,5,11,56,46,10,47
AC Horsens,8671,5,10,12,8,39,49,-10,42
AaB,8671,6,6,14,10,33,43,-10,32
Sonderjyske,8671,7,8,6,10,28,29,-1,30
Lyngby,8671,8,4,9,11,27,44,-17,21
Randers FC,8671,9,5,6,13,23,40,-17,21
Silkeborg IF,8671,10,6,3,13,27,45,-18,21
AGF Aarhus,8671,11,4,6,12,17,38,-21,18
Brondby,8672,1,20,6,4,69,34,35,66
FC Midtjylla,8672,2,19,4,7,64,38,26,61
FC Nords,8672,3,15,8,7,71,46,25,53
Copenhagen,8672,4,14,5,11,59,45,14,47
AaB,8672,5,7,13,10,35,42,-7,34
AC Horsens,8672,6,6,14,10,31,50,-19,32
Sonderjyske,8672,7,8,6,10,28,29,-1,30
Lyngby,8672,8,4,9,11,29,45,-16,21
Silkeborg IF,8672,9,6,3,13,27,44,-17,21
Randers FC,8672,10,5,6,13,24,42,-18,21
AGF Aarhus,8672,11,4,6,12,16,38,-22,18
Brondby,8673,1,20,6,4,71,35,36,66
FC Midtjylla,8673,2,20,5,5,68,40,28,65
FC Nords,8673,3,14,8,8,77,55,22,50
Copenhagen,8673,4,15,4,11,57,44,13,49
AaB,8673,5,8,11,11,39,44,-5,35
Sonderjyske,8673,6,8,6,10,28,29,-1,30
AC Horsens,8673,7,5,14,11,35,55,-20,29
Randers FC,8673,8,6,6,12,24,39,-15,24
AGF Aarhus,8673,9,5,6,11,19,37,-18,21
Lyngby,8673,10,3,9,12,26,45,-19,18
Silkeborg IF,8673,11,5,3,14,26,47,-21,18
FC Midtjylla,8674,1,20,6,4,66,37,29,66
Brondby,8674,2,20,5,5,70,37,33,65
FC Nords,8674,3,14,7,9,73,51,22,49
Copenhagen,8674,4,14,6,10,63,49,14,48
AaB,8674,5,6,15,9,37,43,-6,33
AC Horsens,8674,6,6,13,11,34,52,-18,31
Sonderjyske,8674,7,8,6,10,28,29,-1,30
Lyngby,8674,8,4,9,11,29,46,-17,21
Randers FC,8674,9,5,6,13,25,42,-17,21
Silkeborg IF,8674,10,6,3,13,26,44,-18,21
AGF Aarhus,8674,11,4,6,12,16,37,-21,18
Brondby,8675,1,20,7,3,70,34,36,67
FC Midtjylla,8675,2,20,5,5,69,40,29,65
Copenhagen,8675,3,16,5,9,65,42,23,53
FC Nords,8675,4,12,8,10,72,59,13,44
AaB,8675,5,7,12,11,38,45,-7,33
AC Horsens,8675,6,6,13,11,35,55,-20,31
Sonderjyske,8675,7,8,6,10,28,29,-1,30
Randers FC,8675,8,6,6,12,25,39,-14,24
AGF Aarhus,8675,9,5,6,11,18,37,-19,21
Lyngby,8675,10,3,9,12,26,46,-20,18
Silkeborg IF,8675,10,5,3,14,26,46,-20,18
FC Midtjylla,8676,1,21,4,5,67,42,25,67
Brondby,8676,2,20,6,4,69,34,35,66
Copenhagen,8676,3,14,4,12,57,44,13,46
FC Nords,8676,4,13,6,11,75,58,17,45
AC Horsens,8676,5,8,13,9,39,51,-12,37
AaB,8676,6,7,13,10,40,44,-4,34
Sonderjyske,8676,7,8,6,10,28,29,-1,30
Lyngby,8676,8,4,9,11,27,44,-17,21
Randers FC,8676,9,5,6,13,23,40,-17,21
Silkeborg IF,8676,10,6,3,13,26,44,-18,21
AGF Aarhus,8676,11,4,6,12,16,37,-21,18
Brondby,8677,1,22,6,2,77,30,47,72
FC Midtjylla,8677,2,19,5,6,68,41,27,62
FC Nords,8677,3,14,7,9,71,56,15,49
Copenhagen,8677,4,14,4,12,58,45,13,46
AaB,8677,5,8,12,10,42,47,-5,36
Sonderjyske,8677,6,8,6,10,28,29,-1,30
AC Horsens,8677,7,5,14,11,34,57,-23,29
Lyngby,8677,8,4,9,11,30,45,-15,21
Silkeborg IF,8677,9,6,3,13,26,44,-18,21
Randers FC,8677,10,5,6,13,24,43,-19,21
AGF Aarhus,8677,11,4,6,12,16,37,-21,18
Brondby,8678,1,21,5,4,71,31,40,68
FC Midtjylla,8678,2,21,4,5,65,38,27,67
Copenhagen,8678,3,16,5,9,66,47,19,53
FC Nords,8678,4,13,6,11,75,55,20,45
AaB,8678,5,8,12,10,40,44,-4,36
Sonderjyske,8678,6,8,6,10,28,29,-1,30
AC Horsens,8678,7,5,12,13,31,59,-28,27
Randers FC,8678,8,6,6,12,25,40,-15,24
Silkeborg IF,8678,9,6,3,13,28,44,-16,21
Lyngby,8678,10,3,9,12,27,46,-19,18
AGF Aarhus,8678,11,4,6,12,16,39,-23,18
FC Midtjylla,8679,1,22,4,4,68,35,33,70
Brondby,8679,2,20,6,4,67,31,36,66
FC Nords,8679,3,14,8,8,77,51,26,50
Copenhagen,8679,4,12,5,13,54,49,5,41
AC Horsens,8679,5,8,12,10,34,51,-17,36
AaB,8679,6,7,11,12,34,43,-9,32
Sonderjyske,8679,7,8,6,10,28,29,-1,30
Lyngby,8679,8,4,9,11,28,45,-17,21
Silkeborg IF,8679,9,6,3,13,27,44,-17,21
Randers FC,8679,10,5,6,13,24,41,-17,21
AGF Aarhus,8679,11,4,6,12,16,38,-22,18
Brondby,8680,1,21,7,2,75,35,40,70
FC Midtjylla,8680,2,20,4,6,66,38,28,64
FC Nords,8680,3,15,8,7,86,55,31,53
Copenhagen,8680,4,13,5,12,54,46,8,44
AaB,8680,5,8,12,10,41,47,-6,36
Sonderjyske,8680,6,8,6,10,28,29,-1,30
AC Horsens,8680,7,5,12,13,34,61,-27,27
Randers FC,8680,8,6,6,12,25,40,-15,24
Silkeborg IF,8680,9,6,3,13,29,46,-17,21
Lyngby,8680,10,3,9,12,27,46,-19,18
AGF Aarhus,8680,11,4,6,12,18,40,-22,18
Brondby,8681,1,20,7,3,69,32,37,67
FC Midtjylla,8681,2,18,6,6,61,41,20,60
FC Nords,8681,3,14,8,8,75,50,25,50
Copenhagen,8681,4,13,7,10,58,45,13,46
AC Horsens,8681,5,7,14,9,35,48,-13,35
AaB,8681,6,7,12,11,36,44,-8,33
Sonderjyske,8681,7,8,6,10,28,29,-1,30
Randers FC,8681,8,6,6,12,24,39,-15,24
Silkeborg IF,8681,9,6,3,13,26,44,-18,21
Lyngby,8681,10,3,9,12,26,45,-19,18
AGF Aarhus,8681,11,4,6,12,16,37,-21,18
Brondby,8682,1,19,8,3,68,34,34,65
FC Midtjylla,8682,2,18,5,7,65,46,19,59
FC Nords,8682,3,14,9,7,78,51,27,51
Copenhagen,8682,4,14,4,12,55,47,8,46
AC Horsens,8682,5,8,13,9,39,51,-12,37
AaB,8682,6,7,13,10,38,40,-2,34
Sonderjyske,8682,7,8,6,10,28,29,-1,30
Randers FC,8682,8,5,7,12,24,40,-16,22
Silkeborg IF,8682,9,6,3,13,27,45,-18,21
Lyngby,8682,10,3,10,11,27,45,-18,19
AGF Aarhus,8682,11,4,6,12,17,38,-21,18
Brondby,8683,1,20,6,4,66,31,35,66
FC Midtjylla,8683,2,20,4,6,70,38,32,64
FC Nords,8683,3,14,8,8,73,50,23,50
Copenhagen,8683,4,13,5,12,54,47,7,44
AaB,8683,5,9,13,8,37,38,-1,40
Sonderjyske,8683,6,8,6,10,28,29,-1,30
AC Horsens,8683,7,6,12,12,36,58,-22,30
Lyngby,8683,8,4,9,11,28,45,-17,21
Randers FC,8683,9,5,6,13,24,41,-17,21
Silkeborg IF,8683,10,6,3,13,27,45,-18,21
AGF Aarhus,8683,11,4,6,12,17,38,-21,18
Brondby,8684,1,21,5,4,73,32,41,68
FC Midtjylla,8684,2,17,6,7,64,44,20,57
FC Nords,8684,3,16,7,7,77,50,27,55
Copenhagen,8684,4,14,5,11,60,48,12,47
AC Horsens,8684,5,7,13,10,40,56,-16,34
AaB,8684,6,7,12,11,38,48,-10,33
Sonderjyske,8684,7,8,6,10,28,29,-1,30
Randers FC,8684,8,5,7,12,24,40,-16,22
Silkeborg IF,8684,9,6,3,13,27,45,-18,21
Lyngby,8684,10,3,10,11,27,45,-18,19
AGF Aarhus,8684,11,4,6,12,17,38,-21,18
Brondby,8685,1,21,6,3,72,29,43,69
FC Midtjylla,8685,2,19,5,6,65,42,23,62
Copenhagen,8685,3,15,4,11,60,46,14,49
FC Nords,8685,4,13,8,9,70,54,16,47
AaB,8685,5,8,12,10,36,43,-7,36
AC Horsens,8685,6,6,13,11,35,50,-15,31
Sonderjyske,8685,7,8,6,10,28,29,-1,30
Randers FC,8685,8,6,6,12,25,40,-15,24
Silkeborg IF,8685,9,5,4,13,25,44,-19,19
AGF Aarhus,8685,10,4,7,11,16,36,-20,19
Lyngby,8685,11,3,9,12,27,46,-19,18
Brondby,8686,1,20,7,3,72,36,36,67
FC Midtjylla,8686,2,19,5,6,62,41,21,62
FC Nords,8686,3,14,9,7,72,49,23,51
Copenhagen,8686,4,14,6,10,57,41,16,48
AaB,8686,5,7,12,11,39,43,-4,33
AC Horsens,8686,6,6,13,11,34,52,-18,31
Sonderjyske,8686,7,8,6,10,28,29,-1,30
Randers FC,8686,8,6,6,12,28,40,-12,24
AGF Aarhus,8686,9,5,6,11,17,36,-19,21
Silkeborg IF,8686,10,5,3,14,25,45,-20,18
Lyngby,8686,11,3,9,12,27,49,-22,18
Brondby,8687,1,21,7,2,71,32,39,70
FC Midtjylla,8687,2,20,4,6,69,40,29,64
FC Nords,8687,3,14,7,9,72,47,25,49
Copenhagen,8687,4,13,5,12,57,49,8,44
AaB,8687,5,8,12,10,38,44,-6,36
Sonderjyske,8687,6,8,6,10,28,29,-1,30
AC Horsens,8687,7,5,15,10,37,58,-21,30
Lyngby,8687,8,4,9,11,29,44,-15,21
Silkeborg IF,8687,9,6,3,13,26,44,-18,21
Randers FC,8687,10,5,6,13,23,42,-19,21
AGF Aarhus,8687,11,4,6,12,16,37,-21,18
Brondby,8688,1,20,6,4,77,43,34,66
FC Midtjylla,8688,2,20,5,5,68,42,26,65
FC Nords,8688,3,16,6,8,75,46,29,54
Copenhagen,8688,4,12,6,12,55,47,8,42
AC Horsens,8688,5,7,13,10,39,57,-18,34
AaB,8688,6,7,12,11,38,43,-5,33
Sonderjyske,8688,7,8,6,10,28,29,-1,30
Randers FC,8688,8,6,6,12,26,41,-15,24
AGF Aarhus,8688,9,5,6,11,17,36,-19,21
Lyngby,8688,10,3,9,12,28,47,-19,18
Silkeborg IF,8688,11,5,3,14,25,45,-20,18
Brondby,8689,1,22,5,3,75,33,42,71
FC Midtjylla,8689,2,19,5,6,69,43,26,62
FC Nords,8689,3,15,6,9,73,53,20,51
Copenhagen,8689,4,13,6,11,56,44,12,45
AC Horsens,8689,5,6,15,9,37,53,-16,33
AaB,8689,6,6,13,11,35,45,-10,31
Sonderjyske,8689,7,8,6,10,28,29,-1,30
Lyngby,8689,8,4,9,11,28,45,-17,21
Randers FC,8689,9,5,6,13,24,41,-17,21
Silkeborg IF,8689,10,6,3,13,27,45,-18,21
AGF Aarhus,8689,11,4,6,12,17,38,-21,18
Brondby,8690,1,20,6,4,68,31,37,66
FC Midtjylla,8690,2,17,8,5,60,39,21,59
FC Nords,8690,3,13,7,10,70,53,17,46
Copenhagen,8690,4,13,5,12,54,47,7,44
AaB,8690,5,9,12,9,39,39,0,39
AC Horsens,8690,6,9,12,9,40,48,-8,39
Sonderjyske,8690,7,8,6,10,28,29,-1,30
Randers FC,8690,8,6,6,12,25,40,-15,24
Silkeborg IF,8690,9,5,4,13,27,46,-19,19
AGF Aarhus,8690,10,4,7,11,18,38,-20,19
Lyngby,8690,11,3,9,12,27,46,-19,18
Brondby,8691,1,21,6,3,73,34,39,69
FC Midtjylla,8691,2,20,5,5,70,40,30,65
FC Nords,8691,3,14,7,9,77,56,21,49
Copenhagen,8691,4,13,6,11,60,50,10,45
AaB,8691,5,8,11,11,39,46,-7,35
Sonderjyske,8691,6,8,6,10,28,29,-1,30
AC Horsens,8691,7,5,15,10,35,54,-19,30
Randers FC,8691,8,5,7,12,24,40,-16,22
AGF Aarhus,8691,9,5,6,11,19,37,-18,21
Lyngby,8691,10,3,10,11,27,45,-18,19
Silkeborg IF,8691,11,5,3,14,26,47,-21,18
Brondby,8692,1,20,6,4,74,37,37,66
FC Midtjylla,8692,2,20,4,6,67,40,27,64
FC Nords,8692,3,15,7,8,73,50,23,52
Copenhagen,8692,4,14,4,12,62,51,11,46
AC Horsens,8692,5,8,12,10,36,49,-13,36
AaB,8692,6,7,11,12,36,47,-11,32
Sonderjyske,8692,7,8,6,10,28,29,-1,30
Randers FC,8692,8,5,7,12,23,39,-16,22
Silkeborg IF,8692,9,6,3,13,28,46,-18,21
Lyngby,8692,10,3,10,11,26,44,-18,19
AGF Aarhus,8692,11,4,6,12,18,39,-21,18
Brondby,8693,1,20,8,2,73,31,42,68
FC Midtjylla,8693,2,18,5,7,63,40,23,59
Copenhagen,8693,3,14,6,10,59,45,14,48
FC Nords,8693,4,13,7,10,72,58,14,46
AaB,8693,5,8,12,10,41,46,-5,36
AC Horsens,8693,6,7,14,9,35,49,-14,35
Sonderjyske,8693,7,8,6,10,28,29,-1,30
Lyngby,8693,8,4,9,11,27,44,-17,21
Randers FC,8693,9,5,6,13,23,40,-17,21
Silkeborg IF,8693,10,5,4,13,25,44,-19,19
AGF Aarhus,8693,11,4,7,11,16,36,-20,19
Brondby,8694,1,22,6,2,74,32,42,72
FC Midtjylla,8694,2,18,6,6,64,41,23,60
FC Nords,8694,3,14,8,8,73,51,22,50
Copenhagen,8694,4,12,6,12,56,49,7,42
AaB,8694,5,8,12,10,37,40,-3,36
AC Horsens,8694,6,7,12,11,35,52,-17,33
Sonderjyske,8694,7,8,6,10,28,29,-1,30
Lyngby,8694,8,4,9,11,29,46,-17,21
Randers FC,8694,9,5,6,13,25,42,-17,21
Silkeborg IF,8694,10,6,3,13,28,46,-18,21
AGF Aarhus,8694,11,4,6,12,18,39,-21,18
FC Midtjylla,8695,1,20,6,4,69,33,36,66
Brondby,8695,2,19,7,4,68,34,34,64
FC Nords,8695,3,14,6,10,70,56,14,48
Copenhagen,8695,4,14,5,11,57,43,14,47
AaB,8695,5,7,13,10,35,41,-6,34
AC Horsens,8695,6,7,13,10,36,54,-18,34
Sonderjyske,8695,7,8,6,10,28,29,-1,30
Randers FC,8695,8,5,7,12,24,40,-16,22
AGF Aarhus,8695,9,5,6,11,19,36,-17,21
Lyngby,8695,10,3,10,11,27,45,-18,19
Silkeborg IF,8695,11,5,3,14,25,47,-22,18
Brondby,8696,1,20,5,5,69,35,34,65
FC Midtjylla,8696,2,20,4,6,64,37,27,64
Copenhagen,8696,3,15,5,10,59,44,15,50
FC Nords,8696,4,13,6,11,71,52,19,45
AaB,8696,5,8,12,10,37,42,-5,36
AC Horsens,8696,6,8,12,10,38,54,-16,36
Sonderjyske,8696,7,8,6,10,28,29,-1,30
Randers FC,8696,8,6,6,12,25,39,-14,24
Silkeborg IF,8696,9,6,3,13,29,44,-15,21
Lyngby,8696,10,3,9,12,26,46,-20,18
AGF Aarhus,8696,11,4,6,12,16,40,-24,18
Brondby,8697,1,22,6,2,74,31,43,72
FC Midtjylla,8697,2,19,5,6,65,42,23,62
FC Nords,8697,3,13,7,10,74,55,19,46
Copenhagen,8697,4,13,6,11,59,46,13,45
AC Horsens,8697,5,9,12,9,43,55,-12,39
Sonderjyske,8697,6,8,6,10,28,29,-1,30
AaB,8697,7,6,12,12,34,46,-12,30
Randers FC,8697,8,6,6,12,25,40,-15,24
Silkeborg IF,8697,9,5,4,13,26,45,-19,19
AGF Aarhus,8697,10,4,7,11,17,37,-20,19
Lyngby,8697,11,3,9,12,27,46,-19,18
Brondby,8698,1,21,6,3,68,30,38,69
FC Midtjylla,8698,2,19,6,5,67,38,29,63
FC Nords,8698,3,14,8,8,71,48,23,50
Copenhagen,8698,4,13,7,10,60,46,14,46
AaB,8698,5,7,12,11,35,43,-8,33
AC Horsens,8698,6,6,13,11,33,55,-22,31
Sonderjyske,8698,7,8,6,10,28,29,-1,30
Randers FC,8698,8,6,6,12,26,40,-14,24
AGF Aarhus,8698,9,5,6,11,19,37,-18,21
Lyngby,8698,10,3,9,12,27,47,-20,18
Silkeborg IF,8698,11,5,3,14,26,47,-21,18
Brondby,8699,1,22,5,3,70,30,40,71
FC Midtjylla,8699,2,19,4,7,64,39,25,61
Copenhagen,8699,3,16,4,10,59,42,17,52
FC Nords,8699,4,14,7,9,74,55,19,49
AaB,8699,5,7,13,10,36,42,-6,34
Sonderjyske,8699,6,8,6,10,28,29,-1,30
AC Horsens,8699,7,5,13,12,34,55,-21,28
Lyngby,8699,8,4,9,11,29,45,-16,21
Randers FC,8699,9,5,6,13,24,42,-18,21
Silkeborg IF,8699,10,5,4,13,26,45,-19,19
AGF Aarhus,8699,11,4,7,11,17,37,-20,19
Brondby,8700,1,22,6,2,74,29,45,72
FC Midtjylla,8700,2,20,5,5,69,41,28,65
FC Nords,8700,3,14,6,10,73,54,19,48
Copenhagen,8700,4,14,5,11,57,44,13,47
AC Horsens,8700,5,7,13,10,37,55,-18,34
Sonderjyske,8700,6,8,6,10,28,29,-1,30
AaB,8700,7,6,11,13,34,47,-13,29
Randers FC,8700,8,6,6,12,26,39,-13,24
Silkeborg IF,8700,9,5,4,13,26,45,-19,19
AGF Aarhus,8700,10,4,7,11,17,37,-20,19
Lyngby,8700,11,3,9,12,26,47,-21,18
Brondby,8701,1,22,6,2,75,34,41,72
FC Midtjylla,8701,2,19,5,6,66,41,25,62
FC Nords,8701,3,13,6,11,71,57,14,45
Copenhagen,8701,4,13,6,11,60,47,13,45
AaB,8701,5,8,12,10,39,44,-5,36
AC Horsens,8701,6,7,13,10,36,50,-14,34
Sonderjyske,8701,7,8,6,10,28,29,-1,30
Randers FC,8701,8,5,7,12,24,40,-16,22
Lyngby,8701,9,3,10,11,27,45,-18,19
Silkeborg IF,8701,10,5,4,13,26,45,-19,19
AGF Aarhus,8701,11,4,7,11,17,37,-20,19
Brondby,8702,1,21,6,3,69,31,38,69
FC Midtjylla,8702,2,19,6,5,68,41,27,63
Copenhagen,8702,3,15,5,10,57,43,14,50
FC Nords,8702,4,13,8,9,74,54,20,47
AaB,8702,5,6,14,10,37,45,-8,32
AC Horsens,8702,6,6,13,11,36,53,-17,31
Sonderjyske,8702,7,8,6,10,28,29,-1,30
Lyngby,8702,8,4,9,11,29,44,-15,21
Randers FC,8702,9,5,6,13,23,42,-19,21
AGF Aarhus,8702,10,5,6,11,18,37,-19,21
Silkeborg IF,8702,11,5,3,14,26,46,-20,18
Brondby,8703,1,21,5,4,68,35,33,68
FC Midtjylla,8703,2,20,6,4,69,37,32,66
FC Nords,8703,3,15,6,9,70,50,20,51
Copenhagen,8703,4,15,5,10,61,42,19,50
AaB,8703,5,7,12,11,37,42,-5,33
Sonderjyske,8703,6,8,6,10,28,29,-1,30
AC Horsens,8703,7,5,12,13,34,59,-25,27
Lyngby,8703,8,4,9,11,28,44,-16,21
Randers FC,8703,9,5,6,13,23,41,-18,21
Silkeborg IF,8703,10,5,4,13,26,45,-19,19
AGF Aarhus,8703,11,4,7,11,17,37,-20,19
Brondby,8704,1,20,6,4,68,34,34,66
FC Midtjylla,8704,2,20,4,6,63,40,23,64
FC Nords,8704,3,15,7,8,76,52,24,52
Copenhagen,8704,4,16,4,10,59,40,19,52
AaB,8704,5,8,11,11,40,43,-3,35
Sonderjyske,8704,6,8,6,10,28,29,-1,30
AC Horsens,8704,7,5,12,13,33,56,-23,27
Lyngby,8704,8,4,9,11,30,45,-15,21
Randers FC,8704,9,5,6,13,24,43,-19,21
Silkeborg IF,8704,10,5,4,13,28,47,-19,19
AGF Aarhus,8704,11,4,7,11,19,39,-20,19
Brondby,8705,1,20,6,4,68,36,32,66
FC Midtjylla,8705,2,18,8,4,62,35,27,62
Copenhagen,8705,3,14,6,10,62,45,17,48
FC Nords,8705,4,13,7,10,74,56,18,46
AaB,8705,5,8,13,9,37,38,-1,37
AC Horsens,8705,6,6,14,10,38,57,-19,32
Sonderjyske,8705,7,8,6,10,28,29,-1,30
Lyngby,8705,8,4,9,11,27,44,-17,21
Randers FC,8705,9,5,6,13,23,40,-17,21
AGF Aarhus,8705,10,5,6,11,19,37,-18,21
Silkeborg IF,8705,11,5,3,14,26,47,-21,18
Brondby,8706,1,21,6,3,70,31,39,69
FC Midtjylla,8706,2,18,8,4,67,39,28,62
FC Nords,8706,3,15,7,8,78,51,27,52
Copenhagen,8706,4,14,5,11,60,49,11,47
AC Horsens,8706,5,7,13,10,37,54,-17,34
Sonderjyske,8706,6,8,6,10,28,29,-1,30
AaB,8706,7,6,11,13,35,49,-14,29
Randers FC,8706,8,6,6,12,26,40,-14,24
Silkeborg IF,8706,9,6,3,13,27,44,-17,21
Lyngby,8706,10,3,9,12,27,47,-20,18
AGF Aarhus,8706,11,4,6,12,16,38,-22,18
Brondby,8707,1,23,5,2,81,34,47,74
FC Midtjylla,8707,2,20,5,5,64,38,26,65
Copenhagen,8707,3,14,4,12,59,45,14,46
FC Nords,8707,4,12,6,12,67,58,9,42
AaB,8707,5,7,13,10,40,46,-6,34
AC Horsens,8707,6,7,13,10,38,54,-16,34
Sonderjyske,8707,7,8,6,10,28,29,-1,30
Randers FC,8707,8,5,7,12,24,40,-16,22
Silkeborg IF,8707,9,6,3,13,26,44,-18,21
Lyngby,8707,10,3,10,11,27,45,-18,19
AGF Aarhus,8707,11,4,6,12,16,37,-21,18
FC Midtjylla,8708,1,20,5,5,68,37,31,65
Brondby,8708,2,18,7,5,62,34,28,61
FC Nords,8708,3,15,7,8,74,52,22,52
Copenhagen,8708,4,15,5,10,60,45,15,50
AaB,8708,5,7,14,9,40,40,0,35
Sonderjyske,8708,6,8,6,10,28,29,-1,30
AC Horsens,8708,7,5,14,11,34,56,-22,29
Randers FC,8708,8,6,6,12,28,42,-14,24
Silkeborg IF,8708,9,5,4,13,26,45,-19,19
AGF Aarhus,8708,10,4,7,11,17,37,-20,19
Lyngby,8708,11,3,9,12,29,49,-20,18
Brondby,8709,1,22,5,3,75,33,42,71
FC Midtjylla,8709,2,20,4,6,65,40,25,64
FC Nords,8709,3,15,7,8,74,50,24,52
Copenhagen,8709,4,14,4,12,54,42,12,46
AaB,8709,5,8,12,10,36,42,-6,36
Sonderjyske,8709,6,8,6,10,28,29,-1,30
AC Horsens,8709,7,5,12,13,34,57,-23,27
Randers FC,8709,8,6,6,12,27,40,-13,24
Silkeborg IF,8709,9,6,3,13,27,45,-18,21
Lyngby,8709,10,3,9,12,27,48,-21,18
AGF Aarhus,8709,11,4,6,12,17,38,-21,18
Brondby,8710,1,21,5,4,68,33,35,68
FC Midtjylla,8710,2,20,4,6,65,41,24,64
FC Nords,8710,3,15,6,9,79,53,26,51
Copenhagen,8710,4,13,4,13,52,42,10,43
AaB,8710,5,8,12,10,37,43,-6,36
AC Horsens,8710,6,7,13,10,34,49,-15,34
Sonderjyske,8710,7,8,6,10,28,29,-1,30
Lyngby,8710,8,4,9,11,27,44,-17,21
Randers FC,8710,9,5,6,13,23,40,-17,21
AGF Aarhus,8710,10,5,6,11,18,36,-18,21
Silkeborg IF,8710,11,5,3,14,25,46,-21,18
FC Midtjylla,8711,1,20,5,5,64,36,28,65
Brondby,8711,2,19,6,5,66,35,31,63
FC Nords,8711,3,14,8,8,77,55,22,50
Copenhagen,8711,4,14,5,11,56,43,13,47
AC Horsens,8711,5,8,13,9,40,50,-10,37
AaB,8711,6,6,13,11,35,45,-10,31
Sonderjyske,8711,7,8,6,10,28,29,-1,30
Lyngby,8711,8,4,9,11,27,44,-17,21
Randers FC,8711,9,5,6,13,23,40,-17,21
Silkeborg IF,8711,10,6,3,13,28,46,-18,21
AGF Aarhus,8711,11,4,6,12,18,39,-21,18
Brondby,8712,1,22,5,3,76,30,46,71
FC Midtjylla,8712,2,19,5,6,67,40,27,62
Copenhagen,8712,3,15,4,11,55,44,11,49
FC Nords,8712,4,13,7,10,71,55,16,46
AC Horsens,8712,5,7,13,10,39,53,-14,34
AaB,8712,6,7,12,11,35,47,-12,33
Sonderjyske,8712,7,8,6,10,28,29,-1,30
Randers FC,8712,8,6,6,12,27,41,-14,24
Silkeborg IF,8712,9,6,3,13,29,45,-16,21
Lyngby,8712,10,3,9,12,28,48,-20,18
AGF Aarhus,8712,11,4,6,12,17,40,-23,18
Brondby,8713,1,23,5,2,79,31,48,74
FC Midtjylla,8713,2,19,4,7,63,43,20,61
Copenhagen,8713,3,16,4,10,61,44,17,52
FC Nords,8713,4,14,6,10,76,58,18,48
AaB,8713,5,7,11,12,35,44,-9,32
Sonderjyske,8713,6,8,6,10,28,29,-1,30
AC Horsens,8713,7,6,12,12,38,58,-20,30
Lyngby,8713,8,4,9,11,27,44,-17,21
Randers FC,8713,9,5,6,13,23,40,-17,21
Silkeborg IF,8713,10,5,4,13,27,46,-19,19
AGF Aarhus,8713,11,4,7,11,18,38,-20,19
Brondby,8714,1,21,6,3,69,31,38,69
FC Midtjylla,8714,2,20,4,6,72,42,30,64
FC Nords,8714,3,13,9,8,71,52,19,48
Copenhagen,8714,4,14,4,12,59,49,10,46
AaB,8714,5,8,13,9,41,42,-1,37
Sonderjyske,8714,6,8,6,10,28,29,-1,30
AC Horsens,8714,7,5,14,11,34,56,-22,29
Lyngby,8714,8,4,9,11,27,44,-17,21
Randers FC,8714,9,5,6,13,23,40,-17,21
AGF Aarhus,8714,10,5,6,11,19,37,-18,21
Silkeborg IF,8714,11,5,3,14,26,47,-21,18
FC Midtjylla,8715,1,21,5,4,72,38,34,68
Brondby,8715,2,20,6,4,72,36,36,66
FC Nords,8715,3,15,7,8,74,51,23,52
Copenhagen,8715,4,13,4,13,58,48,10,43
AaB,8715,5,8,12,10,39,44,-5,36
Sonderjyske,8715,6,8,6,10,28,29,-1,30
AC Horsens,8715,7,6,12,12,35,59,-24,30
Lyngby,8715,8,4,9,11,29,44,-15,21
Randers FC,8715,9,5,6,13,23,42,-19,21
Silkeborg IF,8715,10,5,4,13,27,46,-19,19
AGF Aarhus,8715,11,4,7,11,18,38,-20,19
Brondby,8716,1,20,6,4,72,35,37,66
FC Midtjylla,8716,2,19,5,6,61,37,24,62
FC Nords,8716,3,15,8,7,73,48,25,53
Copenhagen,8716,4,14,6,10,59,46,13,48
AC Horsens,8716,5,7,12,11,38,51,-13,33
AaB,8716,6,6,13,11,34,46,-12,31
Sonderjyske,8716,7,8,6,10,28,29,-1,30
Lyngby,8716,8,4,9,11,27,44,-17,21
Randers FC,8716,9,5,6,13,23,40,-17,21
AGF Aarhus,8716,10,5,6,11,18,37,-19,21
Silkeborg IF,8716,11,5,3,14,26,46,-20,18
Brondby,8717,1,23,5,2,72,29,43,74
FC Midtjylla,8717,2,18,4,8,59,43,16,58
Copenhagen,8717,3,16,4,10,62,40,22,52
FC Nords,8717,4,13,7,10,68,52,16,46
AaB,8717,5,8,11,11,38,43,-5,35
AC Horsens,8717,6,6,13,11,32,50,-18,31
Sonderjyske,8717,7,8,6,10,28,29,-1,30
Lyngby,8717,8,4,9,11,29,46,-17,21
Silkeborg IF,8717,9,6,3,13,28,45,-17,21
Randers FC,8717,10,5,6,13,25,42,-17,21
AGF Aarhus,8717,11,4,6,12,17,39,-22,18
Brondby,8718,1,22,5,3,75,34,41,71
FC Midtjylla,8718,2,20,5,5,66,40,26,65
FC Nords,8718,3,14,7,9,72,53,19,49
Copenhagen,8718,4,13,6,11,59,45,14,45
AaB,8718,5,7,11,12,35,46,-11,32
AC Horsens,8718,6,6,14,10,38,53,-15,32
Sonderjyske,8718,7,8,6,10,28,29,-1,30
Lyngby,8718,8,4,9,11,28,45,-17,21
Randers FC,8718,9,5,6,13,24,41,-17,21
AGF Aarhus,8718,10,5,6,11,19,38,-19,21
Silkeborg IF,8718,11,5,3,14,27,47,-20,18
Brondby,8719,1,22,6,2,75,31,44,72
FC Midtjylla,8719,2,20,6,4,67,36,31,66
FC Nords,8719,3,13,8,9,71,55,16,47
Copenhagen,8719,4,12,6,12,55,48,7,42
AaB,8719,5,6,14,10,36,42,-6,32
AC Horsens,8719,6,5,16,9,34,52,-18,31
Sonderjyske,8719,7,8,6,10,28,29,-1,30
Randers FC,8719,8,5,7,12,27,43,-16,22
AGF Aarhus,8719,9,5,6,11,19,37,-18,21
Lyngby,8719,10,3,10,11,30,48,-18,19
Silkeborg IF,8719,11,5,3,14,26,47,-21,18
Brondby,8720,1,21,5,4,69,29,40,68
FC Midtjylla,8720,2,19,5,6,70,42,28,62
Copenhagen,8720,3,15,5,10,59,42,17,50
FC Nords,8720,4,13,8,9,75,53,22,47
AC Horsens,8720,5,7,13,10,35,60,-25,34
AaB,8720,6,7,12,11,33,41,-8,33
Sonderjyske,8720,7,8,6,10,28,29,-1,30
Lyngby,8720,8,4,9,11,28,45,-17,21
Randers FC,8720,9,5,6,13,24,41,-17,21
AGF Aarhus,8720,10,5,6,11,18,37,-19,21
Silkeborg IF,8720,11,5,3,14,26,46,-20,18
Brondby,8721,1,21,6,3,72,33,39,69
FC Midtjylla,8721,2,18,5,7,62,43,19,59
FC Nords,8721,3,15,7,8,81,54,27,52
Copenhagen,8721,4,13,8,9,61,46,15,47
AC Horsens,8721,5,7,13,10,35,52,-17,34
AaB,8721,6,7,11,12,37,46,-9,32
Sonderjyske,8721,7,8,6,10,28,29,-1,30
Lyngby,8721,8,4,9,11,28,44,-16,21
Silkeborg IF,8721,9,6,3,13,26,44,-18,21
Randers FC,8721,10,5,6,13,23,41,-18,21
AGF Aarhus,8721,11,4,6,12,16,37,-21,18
FC Midtjylla,8722,1,21,5,4,67,36,31,68
Brondby,8722,2,20,5,5,68,34,34,65
FC Nords,8722,3,15,6,9,73,51,22,51
Copenhagen,8722,4,14,4,12,59,46,13,46
AaB,8722,5,7,12,11,34,42,-8,33
AC Horsens,8722,6,7,12,11,33,51,-18,33
Sonderjyske,8722,7,8,6,10,28,29,-1,30
Randers FC,8722,8,6,6,12,25,40,-15,24
Silkeborg IF,8722,9,5,4,13,25,44,-19,19
AGF Aarhus,8722,10,4,7,11,16,36,-20,19
Lyngby,8722,11,3,9,12,27,46,-19,18
FC Midtjylla,8723,1,21,5,4,73,40,33,68
Brondby,8723,2,18,10,2,73,38,35,64
FC Nords,8723,3,13,8,9,75,58,17,47
Copenhagen,8723,4,13,5,12,58,47,11,44
AaB,8723,5,8,13,9,41,44,-3,37
AC Horsens,8723,6,6,13,11,36,55,-19,31
Sonderjyske,8723,7,8,6,10,28,29,-1,30
Randers FC,8723,8,5,7,12,24,40,-16,22
AGF Aarhus,8723,9,5,6,11,19,37,-18,21
Lyngby,8723,10,3,10,11,27,45,-18,19
Silkeborg IF,8723,11,5,3,14,26,47,-21,18
FC Midtjylla,8724,1,21,4,5,65,37,28,67
Brondby,8724,2,19,5,6,64,36,28,62
FC Nords,8724,3,13,9,8,70,49,21,48
Copenhagen,8724,4,12,6,12,54,45,9,42
AaB,8724,5,8,14,8,39,40,-1,38
AC Horsens,8724,6,7,14,9,38,49,-11,35
Sonderjyske,8724,7,8,6,10,28,29,-1,30
Randers FC,8724,8,5,7,12,25,41,-16,22
Silkeborg IF,8724,9,6,3,13,26,44,-18,21
Lyngby,8724,10,3,10,11,28,46,-18,19
AGF Aarhus,8724,11,4,6,12,16,37,-21,18
FC Midtjylla,8725,1,20,5,5,68,42,26,65
Brondby,8725,2,19,7,4,69,38,31,64
Copenhagen,8725,3,14,6,10,61,44,17,48
FC Nords,8725,4,13,8,9,73,54,19,47
AC Horsens,8725,5,8,12,10,38,50,-12,36
AaB,8725,6,7,12,11,36,43,-7,33
Sonderjyske,8725,7,8,6,10,28,29,-1,30
Randers FC,8725,8,6,6,12,25,40,-15,24
Silkeborg IF,8725,9,5,4,13,25,44,-19,19
AGF Aarhus,8725,10,4,7,11,16,36,-20,19
Lyngby,8725,11,3,9,12,27,46,-19,18
Brondby,8726,1,19,7,4,69,37,32,64
FC Midtjylla,8726,2,19,5,6,67,39,28,62
FC Nords,8726,3,16,6,8,75,51,24,54
Copenhagen,8726,4,13,5,12,57,46,11,44
AaB,8726,5,10,12,8,42,38,4,42
Sonderjyske,8726,6,8,6,10,28,29,-1,30
AC Horsens,8726,7,5,13,12,33,58,-25,28
AGF Aarhus,8726,8,5,6,11,20,36,-16,21
Lyngby,8726,9,4,9,11,28,45,-17,21
Randers FC,8726,10,5,6,13,24,41,-17,21
Silkeborg IF,8726,11,5,3,14,25,48,-23,18
Brondby,8727,1,20,6,4,70,33,37,66
FC Midtjylla,8727,2,20,4,6,67,40,27,64
FC Nords,8727,3,15,7,8,76,52,24,52
Copenhagen,8727,4,13,6,11,58,47,11,45
AaB,8727,5,7,13,10,40,48,-8,34
AC Horsens,8727,6,7,12,11,40,57,-17,33
Sonderjyske,8727,7,8,6,10,28,29,-1,30
Randers FC,8727,8,5,7,12,24,40,-16,22
Silkeborg IF,8727,9,6,3,13,26,44,-18,21
Lyngby,8727,10,3,10,11,27,45,-18,19
AGF Aarhus,8727,11,4,6,12,16,37,-21,18
Brondby,8728,1,21,5,4,75,33,42,68
FC Midtjylla,8728,2,20,4,6,65,42,23,64
Copenhagen,8728,3,16,4,10,63,40,23,52
FC Nords,8728,4,15,6,9,77,50,27,51
AaB,8728,5,7,11,12,35,50,-15,32
Sonderjyske,8728,6,8,6,10,28,29,-1,30
AC Horsens,8728,7,6,12,12,32,58,-26,30
Randers FC,8728,8,5,7,12,23,39,-16,22
AGF Aarhus,8728,9,5,6,11,18,36,-18,21
Lyngby,8728,10,3,10,11,26,44,-18,19
Silkeborg IF,8728,11,5,3,14,25,46,-21,18
Brondby,8729,1,22,5,3,72,30,42,71
FC Midtjylla,8729,2,20,5,5,67,40,27,65
FC Nords,8729,3,13,7,10,69,51,18,46
Copenhagen,8729,4,13,6,11,55,44,11,45
AaB,8729,5,7,13,10,37,43,-6,34
AC Horsens,8729,6,6,14,10,35,53,-18,32
Sonderjyske,8729,7,8,6,10,28,29,-1,30
Lyngby,8729,8,4,9,11,27,44,-17,21
Randers FC,8729,9,5,6,13,23,40,-17,21
Silkeborg IF,8729,10,6,3,13,27,45,-18,21
AGF Aarhus,8729,11,4,6,12,17,38,-21,18
Brondby,8730,1,21,5,4,71,31,40,68
FC Midtjylla,8730,2,20,4,6,65,41,24,64
FC Nords,8730,3,14,6,10,72,53,19,48
Copenhagen,8730,4,14,5,11,59,46,13,47
AaB,8730,5,9,12,9,41,45,-4,39
Sonderjyske,8730,6,8,6,10,28,29,-1,30
AC Horsens,8730,7,6,12,12,35,53,-18,30
Randers FC,8730,8,5,7,12,23,39,-16,22
Lyngby,8730,9,3,10,11,26,44,-18,19
Silkeborg IF,8730,10,5,4,13,25,44,-19,19
AGF Aarhus,8730,11,4,7,11,16,36,-20,19
Brondby,8731,1,20,7,3,73,33,40,67
FC Midtjylla,8731,2,19,5,6,66,41,25,62
FC Nords,8731,3,13,8,9,73,53,20,47
Copenhagen,8731,4,13,6,11,57,47,10,45
AaB,8731,5,8,12,10,35,42,-7,36
AC Horsens,8731,6,7,14,9,35,49,-14,35
Sonderjyske,8731,7,8,6,10,28,29,-1,30
Randers FC,8731,8,5,7,12,25,41,-16,22
Silkeborg IF,8731,9,6,3,13,26,44,-18,21
Lyngby,8731,10,3,10,11,28,46,-18,19
AGF Aarhus,8731,11,4,6,12,16,37,-21,18
Brondby,8732,1,21,5,4,70,35,35,68
FC Midtjylla,8732,2,17,6,7,62,43,19,57
FC Nords,8732,3,15,7,8,73,50,23,52
Copenhagen,8732,4,15,5,10,61,43,18,50
AC Horsens,8732,5,7,13,10,40,53,-13,34
AaB,8732,6,7,12,11,34,42,-8,33
Sonderjyske,8732,7,8,6,10,28,29,-1,30
Randers FC,8732,8,5,7,12,24,40,-16,22
Lyngby,8732,9,3,10,11,27,45,-18,19
Silkeborg IF,8732,10,5,4,13,25,44,-19,19
AGF Aarhus,8732,11,4,7,11,16,36,-20,19
Brondby,8733,1,22,5,3,71,29,42,71
FC Midtjylla,8733,2,21,4,5,71,37,34,67
FC Nords,8733,3,14,6,10,71,51,20,48
Copenhagen,8733,4,14,4,12,57,47,10,46
AaB,8733,5,8,11,11,38,44,-6,35
Sonderjyske,8733,6,8,6,10,28,29,-1,30
AC Horsens,8733,7,6,12,12,32,58,-26,30
Randers FC,8733,8,5,7,12,24,40,-16,22
Silkeborg IF,8733,9,6,3,13,27,44,-17,21
Lyngby,8733,10,3,10,11,27,45,-18,19
AGF Aarhus,8733,11,4,6,12,16,38,-22,18
FC Midtjylla,8734,1,19,7,4,66,40,26,64
Brondby,8734,2,18,7,5,69,40,29,61
FC Nords,8734,3,15,8,7,76,51,25,53
Copenhagen,8734,4,14,4,12,58,46,12,46
AaB,8734,5,8,12,10,39,42,-3,36
AC Horsens,8734,6,7,12,11,37,52,-15,33
Sonderjyske,8734,7,8,6,10,28,29,-1,30
Lyngby,8734,8,4,9,11,30,44,-14,21
AGF Aarhus,8734,9,5,6,11,18,37,-19,21
Randers FC,8734,10,5,6,13,23,43,-20,21
Silkeborg IF,8734,11,5,3,14,26,46,-20,18
Brondby,8735,1,23,5,2,74,31,43,74
FC Midtjylla,8735,2,20,4,6,70,43,27,64
FC Nords,8735,3,15,6,9,79,50,29,51
Copenhagen,8735,4,12,4,14,52,51,1,40
AaB,8735,5,8,11,11,36,40,-4,35
AC Horsens,8735,6,7,12,11,36,58,-22,33
Sonderjyske,8735,7,8,6,10,28,29,-1,30
Lyngby,8735,8,4,9,11,27,44,-17,21
Randers FC,8735,9,5,6,13,23,40,-17,21
AGF Aarhus,8735,10,5,6,11,17,36,-19,21
Silkeborg IF,8735,11,5,3,14,25,45,-20,18
Brondby,8736,1,20,6,4,69,34,35,66
FC Midtjylla,8736,2,18,7,5,63,41,22,61
FC Nords,8736,3,13,9,8,78,58,20,48
Copenhagen,8736,4,14,6,10,60,46,14,48
AaB,8736,5,8,14,8,42,42,0,38
Sonderjyske,8736,6,8,6,10,28,29,-1,30
AC Horsens,8736,7,6,12,12,37,54,-17,30
Randers FC,8736,8,6,6,12,26,40,-14,24
Silkeborg IF,8736,9,6,3,13,30,44,-14,21
Lyngby,8736,10,3,9,12,27,47,-20,18
AGF Aarhus,8736,11,4,6,12,16,41,-25,18
Brondby,8737,1,18,8,4,69,36,33,62
FC Midtjylla,8737,2,18,7,5,67,44,23,61
Copenhagen,8737,3,16,5,9,64,43,21,53
FC Nords,8737,4,14,8,8,73,52,21,50
AC Horsens,8737,5,7,13,10,34,49,-15,34
AaB,8737,6,7,11,12,34,43,-9,32
Sonderjyske,8737,7,8,6,10,28,29,-1,30
Randers FC,8737,8,6,6,12,24,39,-15,24
Silkeborg IF,8737,9,6,3,13,27,44,-17,21
Lyngby,8737,10,3,9,12,26,45,-19,18
AGF Aarhus,8737,11,4,6,12,16,38,-22,18
Brondby,8738,1,22,6,2,69,29,40,72
FC Midtjylla,8738,2,19,5,6,62,38,24,62
FC Nords,8738,3,13,9,8,70,49,21,48
Copenhagen,8738,4,14,5,11,59,44,15,47
AaB,8738,5,8,12,10,37,41,-4,36
Sonderjyske,8738,6,8,6,10,28,29,-1,30
AC Horsens,8738,7,5,13,12,32,54,-22,28
Randers FC,8738,8,6,6,12,24,39,-15,24
AGF Aarhus,8738,9,5,6,11,19,38,-19,21
Lyngby,8738,10,3,9,12,26,45,-19,18
Silkeborg IF,8738,11,5,3,14,27,47,-20,18
FC Midtjylla,8739,1,22,4,4,75,35,40,70
Brondby,8739,2,20,6,4,68,33,35,66
FC Nords,8739,3,14,8,8,70,49,21,50
Copenhagen,8739,4,14,4,12,58,47,11,46
AaB,8739,5,8,11,11,39,46,-7,35
Sonderjyske,8739,6,8,6,10,28,29,-1,30
AC Horsens,8739,7,5,13,12,35,61,-26,28
Randers FC,8739,8,6,6,12,27,41,-14,24
AGF Aarhus,8739,9,5,6,11,17,36,-19,21
Lyngby,8739,10,3,9,12,28,48,-20,18
Silkeborg IF,8739,11,5,3,14,25,45,-20,18
Brondby,8740,1,21,5,4,80,36,44,68
FC Midtjylla,8740,2,19,4,7,68,44,24,61
Copenhagen,8740,3,16,5,9,68,45,23,53
FC Nords,8740,4,13,8,9,73,56,17,47
AaB,8740,5,7,12,11,40,53,-13,33
AC Horsens,8740,6,7,12,11,35,56,-21,33
Sonderjyske,8740,7,8,6,10,28,29,-1,30
Lyngby,8740,8,4,9,11,28,45,-17,21
Randers FC,8740,9,5,6,13,24,41,-17,21
Silkeborg IF,8740,10,6,3,13,27,45,-18,21
AGF Aarhus,8740,11,4,6,12,17,38,-21,18
Brondby,8741,1,19,8,3,68,32,36,65
FC Midtjylla,8741,2,18,6,6,65,45,20,60
FC Nords,8741,3,14,9,7,73,50,23,51
Copenhagen,8741,4,13,6,11,59,44,15,45
AaB,8741,5,8,13,9,40,44,-4,37
AC Horsens,8741,6,5,16,9,35,51,-16,31
Sonderjyske,8741,7,8,6,10,28,29,-1,30
Lyngby,8741,8,4,9,11,30,45,-15,21
Randers FC,8741,9,5,6,13,24,43,-19,21
Silkeborg IF,8741,10,5,4,13,25,44,-19,19
AGF Aarhus,8741,11,4,7,11,16,36,-20,19
Brondby,8742,1,22,5,3,75,31,44,71
FC Midtjylla,8742,2,19,5,6,60,39,21,62
Copenhagen,8742,3,14,5,11,57,45,12,47
FC Nords,8742,4,12,7,11,67,54,13,43
AaB,8742,5,10,12,8,41,39,2,42
Sonderjyske,8742,6,8,6,10,28,29,-1,30
AC Horsens,8742,7,6,12,12,33,51,-18,30
Lyngby,8742,8,4,9,11,28,44,-16,21
Randers FC,8742,9,5,6,13,23,41,-18,21
Silkeborg IF,8742,10,5,4,13,27,46,-19,19
AGF Aarhus,8742,11,4,7,11,18,38,-20,19
Brondby,8743,1,22,6,2,73,31,42,72
FC Midtjylla,8743,2,19,4,7,63,40,23,61
FC Nords,8743,3,15,6,9,73,50,23,51
Copenhagen,8743,4,13,5,12,56,48,8,44
AaB,8743,5,8,12,10,40,44,-4,36
AC Horsens,8743,6,6,13,11,33,51,-18,31
Sonderjyske,8743,7,8,6,10,28,29,-1,30
Lyngby,8743,8,4,9,11,30,46,-16,21
Silkeborg IF,8743,9,6,3,13,29,46,-17,21
Randers FC,8743,10,5,6,13,25,43,-18,21
AGF Aarhus,8743,11,4,6,12,18,40,-22,18
Brondby,8744,1,21,6,3,72,31,41,69
FC Midtjylla,8744,2,20,5,5,66,40,26,65
Copenhagen,8744,3,15,4,11,60,44,16,49
FC Nords,8744,4,14,6,10,76,55,21,48
AaB,8744,5,8,12,10,36,42,-6,36
Sonderjyske,8744,6,8,6,10,28,29,-1,30
AC Horsens,8744,7,5,13,12,35,59,-24,28
Randers FC,8744,8,5,7,12,24,40,-16,22
Lyngby,8744,9,3,10,11,27,45,-18,19
Silkeborg IF,8744,10,5,4,13,25,44,-19,19
AGF Aarhus,8744,11,4,7,11,16,36,-20,19
Brondby,8745,1,21,7,2,73,29,44,70
FC Midtjylla,8745,2,20,5,5,71,40,31,65
FC Nords,8745,3,13,8,9,73,58,15,47
Copenhagen,8745,4,13,6,11,60,52,8,45
AaB,8745,5,8,12,10,38,42,-4,36
Sonderjyske,8745,6,8,6,10,28,29,-1,30
AC Horsens,8745,7,5,14,11,36,56,-20,29
Randers FC,8745,8,5,7,12,24,40,-16,22
Silkeborg IF,8745,9,6,3,13,28,44,-16,21
Lyngby,8745,10,3,10,11,27,45,-18,19
AGF Aarhus,8745,11,4,6,12,16,39,-23,18
Brondby,8746,1,22,5,3,70,32,38,71
FC Midtjylla,8746,2,17,6,7,62,42,20,57
Copenhagen,8746,3,15,6,9,68,45,23,51
FC Nords,8746,4,14,8,8,74,48,26,50
AaB,8746,5,6,14,10,34,46,-12,32
AC Horsens,8746,6,6,13,11,34,55,-21,31
Sonderjyske,8746,7,8,6,10,28,29,-1,30
Randers FC,8746,8,5,7,12,24,40,-16,22
Silkeborg IF,8746,9,6,3,13,29,46,-17,21
Lyngby,8746,10,3,10,11,27,45,-18,19
AGF Aarhus,8746,11,4,6,12,18,40,-22,18
Brondby,8747,1,21,6,3,71,34,37,69
FC Midtjylla,8747,2,17,5,8,60,41,19,56
FC Nords,8747,3,14,7,9,74,53,21,49
Copenhagen,8747,4,15,4,11,55,42,13,49
AaB,8747,5,8,13,9,38,41,-3,37
AC Horsens,8747,6,6,15,9,35,48,-13,33
Sonderjyske,8747,7,8,6,10,28,29,-1,30
Randers FC,8747,8,6,6,12,25,40,-15,24
AGF Aarhus,8747,9,5,6,11,17,36,-19,21
Lyngby,8747,10,3,9,12,27,46,-19,18
Silkeborg IF,8747,11,5,3,14,25,45,-20,18
Brondby,8748,1,20,7,3,69,30,39,67
FC Midtjylla,8748,2,18,6,6,59,41,18,60
FC Nords,8748,3,14,8,8,70,49,21,50
Copenhagen,8748,4,13,6,11,57,43,14,45
AaB,8748,5,8,12,10,38,43,-5,36
AC Horsens,8748,6,7,13,10,37,50,-13,34
Sonderjyske,8748,7,8,6,10,28,29,-1,30
Randers FC,8748,8,6,6,12,24,39,-15,24
Silkeborg IF,8748,9,6,3,13,27,44,-17,21
Lyngby,8748,10,3,9,12,26,45,-19,18
AGF Aarhus,8748,11,4,6,12,16,38,-22,18
Brondby,8749,1,21,7,2,71,30,41,70
FC Midtjylla,8749,2,18,7,5,64,39,25,61
FC Nords,8749,3,13,9,8,74,53,21,48
Copenhagen,8749,4,13,6,11,57,47,10,45
AaB,8749,5,7,14,9,39,43,-4,35
Sonderjyske,8749,6,8,6,10,28,29,-1,30
AC Horsens,8749,7,5,15,10,33,52,-19,30
Silkeborg IF,8749,8,6,3,13,29,44,-15,21
Lyngby,8749,9,4,9,11,29,45,-16,21
Randers FC,8749,10,5,6,13,24,42,-18,21
AGF Aarhus,8749,11,4,6,12,16,40,-24,18
Brondby,8750,1,22,5,3,75,32,43,71
FC Midtjylla,8750,2,20,4,6,69,43,26,64
Copenhagen,8750,3,14,4,12,57,46,11,46
FC Nords,8750,4,13,6,11,71,62,9,45
AaB,8750,5,10,11,9,42,40,2,41
Sonderjyske,8750,6,8,6,10,28,29,-1,30
AC Horsens,8750,7,6,12,12,37,54,-17,30
Randers FC,8750,8,6,6,12,26,40,-14,24
Silkeborg IF,8750,9,5,4,13,27,46,-19,19
AGF Aarhus,8750,10,4,7,11,18,38,-20,19
Lyngby,8750,11,3,9,12,27,47,-20,18
Brondby,8751,1,20,5,5,66,32,34,65
FC Midtjylla,8751,2,19,4,7,68,48,20,61
FC Nords,8751,3,16,6,8,76,48,28,54
Copenhagen,8751,4,14,5,11,58,47,11,47
AaB,8751,5,9,11,10,47,45,2,38
AC Horsens,8751,6,6,13,11,36,57,-21,31
Sonderjyske,8751,7,8,6,10,28,29,-1,30
Lyngby,8751,8,4,9,11,27,44,-17,21
Randers FC,8751,9,5,6,13,23,40,-17,21
Silkeborg IF,8751,10,6,3,13,27,45,-18,21
AGF Aarhus,8751,11,4,6,12,17,38,-21,18
Brondby,8752,1,21,6,3,69,30,39,69
FC Midtjylla,8752,2,20,5,5,69,39,30,65
FC Nords,8752,3,14,8,8,70,50,20,50
Copenhagen,8752,4,14,5,11,57,42,15,47
AaB,8752,5,7,12,11,37,47,-10,33
Sonderjyske,8752,6,8,6,10,28,29,-1,30
AC Horsens,8752,7,5,14,11,33,53,-20,29
Randers FC,8752,8,5,7,12,25,41,-16,22
AGF Aarhus,8752,9,5,6,11,18,36,-18,21
Lyngby,8752,10,3,10,11,28,46,-18,19
Silkeborg IF,8752,11,5,3,14,25,46,-21,18
Brondby,8753,1,23,5,2,77,31,46,74
FC Midtjylla,8753,2,20,4,6,64,42,22,64
Copenhagen,8753,3,15,4,11,60,46,14,49
FC Nords,8753,4,14,6,10,74,51,23,48
AaB,8753,5,7,12,11,38,43,-5,33
Sonderjyske,8753,6,8,6,10,28,29,-1,30
AC Horsens,8753,7,5,13,12,36,62,-26,28
Lyngby,8753,8,4,9,11,28,45,-17,21
Randers FC,8753,9,5,6,13,24,41,-17,21
Silkeborg IF,8753,10,5,4,13,26,45,-19,19
AGF Aarhus,8753,11,4,7,11,17,37,-20,19
Brondby,8754,1,20,7,3,70,33,37,67
FC Midtjylla,8754,2,20,5,5,67,40,27,65
Copenhagen,8754,3,14,6,10,59,46,13,48
FC Nords,8754,4,13,8,9,77,54,23,47
AaB,8754,5,7,15,8,36,39,-3,36
Sonderjyske,8754,6,8,6,10,28,29,-1,30
AC Horsens,8754,7,5,13,12,33,56,-23,28
Lyngby,8754,8,4,9,11,29,45,-16,21
Silkeborg IF,8754,9,6,3,13,27,45,-18,21
Randers FC,8754,10,5,6,13,24,42,-18,21
AGF Aarhus,8754,11,4,6,12,17,38,-21,18
Brondby,8755,1,23,5,2,76,30,46,74
FC Midtjylla,8755,2,20,4,6,66,38,28,64
FC Nords,8755,3,14,7,9,74,52,22,49
Copenhagen,8755,4,13,4,13,56,49,7,43
AaB,8755,5,9,12,9,39,42,-3,39
Sonderjyske,8755,6,8,6,10,28,29,-1,30
AC Horsens,8755,7,5,12,13,31,57,-26,27
Randers FC,8755,8,5,7,12,24,40,-16,22
AGF Aarhus,8755,9,5,6,11,19,37,-18,21
Lyngby,8755,10,3,10,11,27,45,-18,19
Silkeborg IF,8755,11,5,3,14,26,47,-21,18
Brondby,8756,1,21,7,2,70,28,42,70
FC Midtjylla,8756,2,17,7,6,59,39,20,58
FC Nords,8756,3,13,8,9,70,52,18,47
Copenhagen,8756,4,14,5,11,56,43,13,47
AaB,8756,5,8,13,9,34,37,-3,37
AC Horsens,8756,6,6,14,10,33,49,-16,32
Sonderjyske,8756,7,8,6,10,28,29,-1,30
Randers FC,8756,8,5,7,12,24,40,-16,22
AGF Aarhus,8756,9,5,6,11,17,36,-19,21
Lyngby,8756,10,3,10,11,27,45,-18,19
Silkeborg IF,8756,11,5,3,14,25,45,-20,18
Brondby,8757,1,21,6,3,70,32,38,69
FC Midtjylla,8757,2,19,5,6,66,41,25,62
FC Nords,8757,3,14,6,10,73,60,13,48
Copenhagen,8757,4,14,4,12,61,48,13,46
AaB,8757,5,8,13,9,42,41,1,37
AC Horsens,8757,6,6,14,10,35,51,-16,32
Sonderjyske,8757,7,8,6,10,28,29,-1,30
Lyngby,8757,8,4,9,11,27,44,-17,21
Randers FC,8757,9,5,6,13,23,40,-17,21
AGF Aarhus,8757,10,5,6,11,18,37,-19,21
Silkeborg IF,8757,11,5,3,14,26,46,-20,18
Brondby,8758,1,21,6,3,70,31,39,69
FC Midtjylla,8758,2,20,5,5,73,39,34,65
FC Nords,8758,3,13,9,8,72,51,21,48
Copenhagen,8758,4,12,7,11,57,46,11,43
AaB,8758,5,6,15,9,37,48,-11,33
AC Horsens,8758,6,6,14,10,34,54,-20,32
Sonderjyske,8758,7,8,6,10,28,29,-1,30
Randers FC,8758,8,5,7,12,23,39,-16,22
AGF Aarhus,8758,9,5,6,11,18,37,-19,21
Lyngby,8758,10,3,10,11,26,44,-18,19
Silkeborg IF,8758,11,5,3,14,26,46,-20,18
Brondby,8759,1,19,8,3,72,36,36,65
FC Midtjylla,8759,2,19,4,7,63,40,23,61
FC Nords,8759,3,15,7,8,75,49,26,52
Copenhagen,8759,4,15,5,10,60,42,18,50
AaB,8759,5,7,14,9,38,44,-6,35
Sonderjyske,8759,6,8,6,10,28,29,-1,30
AC Horsens,8759,7,5,14,11,33,56,-23,29
Randers FC,8759,8,6,6,12,25,40,-15,24
AGF Aarhus,8759,9,5,6,11,19,37,-18,21
Lyngby,8759,10,3,9,12,27,46,-19,18
Silkeborg IF,8759,11,5,3,14,26,47,-21,18
Brondby,8760,1,21,6,3,71,32,39,69
FC Midtjylla,8760,2,20,5,5,64,35,29,65
Copenhagen,8760,3,14,6,10,59,43,16,48
FC Nords,8760,4,13,8,9,72,49,23,47
AaB,8760,5,7,12,11,35,44,-9,33
AC Horsens,8760,6,6,13,11,34,58,-24,31
Sonderjyske,8760,7,8,6,10,28,29,-1,30
Randers FC,8760,8,6,6,12,25,39,-14,24
Silkeborg IF,8760,9,5,4,13,26,45,-19,19
AGF Aarhus,8760,10,4,7,11,17,37,-20,19
Lyngby,8760,11,3,9,12,26,46,-20,18
Brondby,8761,1,22,6,2,68,27,41,72
FC Midtjylla,8761,2,19,5,6,65,39,26,62
Copenhagen,8761,3,15,4,11,58,42,16,49
FC Nords,8761,4,13,7,10,70,53,17,46
AaB,8761,5,8,12,10,39,44,-5,36
Sonderjyske,8761,6,8,6,10,28,29,-1,30
AC Horsens,8761,7,6,12,12,34,55,-21,30
Lyngby,8761,8,4,9,11,28,45,-17,21
Randers FC,8761,9,5,6,13,24,41,-17,21
Silkeborg IF,8761,10,5,4,13,25,44,-19,19
AGF Aarhus,8761,11,4,7,11,16,36,-20,19
Brondby,8762,1,21,6,3,71,31,40,69
FC Midtjylla,8762,2,20,5,5,71,41,30,65
FC Nords,8762,3,15,7,8,77,52,25,52
Copenhagen,8762,4,12,4,14,55,50,5,40
AaB,8762,5,8,13,9,37,42,-5,37
AC Horsens,8762,6,6,13,11,32,53,-21,31
Sonderjyske,8762,7,8,6,10,28,29,-1,30
Randers FC,8762,8,6,6,12,26,39,-13,24
Silkeborg IF,8762,9,5,4,13,26,45,-19,19
AGF Aarhus,8762,10,4,7,11,17,37,-20,19
Lyngby,8762,11,3,9,12,26,47,-21,18
Brondby,8763,1,21,6,3,70,31,39,69
FC Midtjylla,8763,2,19,6,5,66,41,25,63
FC Nords,8763,3,15,7,8,76,55,21,52
Copenhagen,8763,4,13,7,10,54,41,13,46
AaB,8763,5,7,12,11,36,43,-7,33
Sonderjyske,8763,6,8,6,10,28,29,-1,30
AC Horsens,8763,7,6,12,12,37,54,-17,30
Lyngby,8763,8,4,9,11,29,44,-15,21
Randers FC,8763,9,5,6,13,23,42,-19,21
Silkeborg IF,8763,10,5,4,13,27,46,-19,19
AGF Aarhus,8763,11,4,7,11,18,38,-20,19
Brondby,8764,1,21,6,3,73,33,40,69
FC Midtjylla,8764,2,20,5,5,66,39,27,65
FC Nords,8764,3,15,7,8,74,50,24,52
Copenhagen,8764,4,12,7,11,55,49,6,43
AaB,8764,5,7,12,11,36,42,-6,33
AC Horsens,8764,6,6,13,11,38,55,-17,31
Sonderjyske,8764,7,8,6,10,28,29,-1,30
Randers FC,8764,8,6,6,12,27,41,-14,24
Silkeborg IF,8764,9,6,3,13,26,44,-18,21
Lyngby,8764,10,3,9,12,28,48,-20,18
AGF Aarhus,8764,11,4,6,12,16,37,-21,18
Brondby,8765,1,21,7,2,69,30,39,70
FC Midtjylla,8765,2,19,4,7,63,41,22,61
FC Nords,8765,3,16,7,7,86,47,39,55
Copenhagen,8765,4,15,5,10,63,51,12,50
Sonderjyske,8765,5,8,6,10,28,29,-1,30
AaB,8765,6,6,12,12,35,48,-13,30
AC Horsens,8765,7,5,13,12,34,59,-25,28
Randers FC,8765,8,5,7,12,24,40,-16,22
Lyngby,8765,9,3,10,11,27,45,-18,19
Silkeborg IF,8765,10,5,4,13,25,44,-19,19
AGF Aarhus,8765,11,4,7,11,16,36,-20,19
Brondby,8766,1,22,5,3,74,31,43,71
FC Midtjylla,8766,2,20,4,6,66,42,24,64
FC Nords,8766,3,14,7,9,73,56,17,49
Copenhagen,8766,4,15,4,11,61,44,17,49
AaB,8766,5,6,13,11,36,44,-8,31
AC Horsens,8766,6,6,13,11,34,53,-19,31
Sonderjyske,8766,7,8,6,10,28,29,-1,30
Lyngby,8766,8,4,9,11,29,44,-15,21
Randers FC,8766,9,5,6,13,23,42,-19,21
AGF Aarhus,8766,10,5,6,11,18,37,-19,21
Silkeborg IF,8766,11,5,3,14,26,46,-20,18
Brondby,8767,1,21,7,2,80,37,43,70
FC Midtjylla,8767,2,21,5,4,74,40,34,68
FC Nords,8767,3,13,8,9,73,58,15,47
Copenhagen,8767,4,14,4,12,57,46,11,46
AaB,8767,5,7,11,12,38,45,-7,32
AC Horsens,8767,6,6,13,11,37,59,-22,31
Sonderjyske,8767,7,8,6,10,28,29,-1,30
Lyngby,8767,8,4,9,11,28,45,-17,21
Randers FC,8767,9,5,6,13,24,41,-17,21
Silkeborg IF,8767,10,6,3,13,26,44,-18,21
AGF Aarhus,8767,11,4,6,12,16,37,-21,18
FC Midtjylla,8768,1,21,4,5,69,40,29,67
Brondby,8768,2,18,7,5,65,34,31,61
Copenhagen,8768,3,15,4,11,59,42,17,49
FC Nords,8768,4,13,7,10,66,51,15,46
AC Horsens,8768,5,8,13,9,35,47,-12,37
AaB,8768,6,7,13,10,35,41,-6,34
Sonderjyske,8768,7,8,6,10,28,29,-1,30
Randers FC,8768,8,5,7,12,24,40,-16,22
Silkeborg IF,8768,9,6,3,13,27,45,-18,21
Lyngby,8768,10,3,10,11,27,45,-18,19
AGF Aarhus,8768,11,4,6,12,17,38,-21,18
Brondby,8769,1,21,6,3,70,30,40,69
FC Midtjylla,8769,2,19,5,6,63,40,23,62
FC Nords,8769,3,16,6,8,77,47,30,54
Copenhagen,8769,4,14,5,11,55,48,7,47
AaB,8769,5,8,12,10,40,45,-5,36
Sonderjyske,8769,6,8,6,10,28,29,-1,30
AC Horsens,8769,7,5,12,13,34,55,-21,27
Lyngby,8769,8,4,9,11,28,44,-16,21
Randers FC,8769,9,5,6,13,23,41,-18,21
AGF Aarhus,8769,10,5,6,11,18,36,-18,21
Silkeborg IF,8769,11,5,3,14,25,46,-21,18
Brondby,8770,1,20,6,4,66,32,34,66
FC Midtjylla,8770,2,20,5,5,70,41,29,65
Copenhagen,8770,3,15,4,11,63,48,15,49
FC Nords,8770,4,14,6,10,72,54,18,48
AaB,8770,5,9,11,10,38,40,-2,38
Sonderjyske,8770,6,8,6,10,28,29,-1,30
AC Horsens,8770,7,6,12,12,35,55,-20,30
Lyngby,8770,8,4,9,11,28,44,-16,21
Silkeborg IF,8770,9,6,3,13,27,44,-17,21
Randers FC,8770,10,5,6,13,23,41,-18,21
AGF Aarhus,8770,11,4,6,12,16,38,-22,18
Brondby,8771,1,23,5,2,74,32,42,74
FC Midtjylla,8771,2,19,5,6,65,40,25,62
FC Nords,8771,3,16,6,8,83,49,34,54
Copenhagen,8771,4,14,4,12,57,51,6,46
AaB,8771,5,6,13,11,36,46,-10,31
Sonderjyske,8771,6,8,6,10,28,29,-1,30
AC Horsens,8771,7,5,13,12,33,56,-23,28
Lyngby,8771,8,4,9,11,29,46,-17,21
Randers FC,8771,9,5,6,13,25,42,-17,21
Silkeborg IF,8771,10,5,4,13,26,45,-19,19
AGF Aarhus,8771,11,4,7,11,17,37,-20,19
Brondby,8772,1,21,6,3,72,33,39,69
FC Midtjylla,8772,2,19,4,7,68,46,22,61
FC Nords,8772,3,15,6,9,75,53,22,51
Copenhagen,8772,4,15,5,10,60,42,18,50
AC Horsens,8772,5,7,12,11,33,50,-17,33
AaB,8772,6,7,11,12,38,48,-10,32
Sonderjyske,8772,7,8,6,10,28,29,-1,30
Silkeborg IF,8772,8,6,3,13,30,46,-16,21
Lyngby,8772,9,4,9,11,28,44,-16,21
Randers FC,8772,10,5,6,13,23,41,-18,21
AGF Aarhus,8772,11,4,6,12,18,41,-23,18
Brondby,8773,1,21,6,3,73,30,43,69
FC Midtjylla,8773,2,20,5,5,64,37,27,65
FC Nords,8773,3,15,6,9,76,53,23,51
Copenhagen,8773,4,14,6,10,56,43,13,48
AaB,8773,5,7,11,12,36,48,-12,32
Sonderjyske,8773,6,8,6,10,28,29,-1,30
AC Horsens,8773,7,6,12,12,34,54,-20,30
Lyngby,8773,8,4,9,11,29,45,-16,21
Silkeborg IF,8773,9,6,3,13,28,44,-16,21
Randers FC,8773,10,5,6,13,24,42,-18,21
AGF Aarhus,8773,11,4,6,12,16,39,-23,18
FC Midtjylla,8774,1,22,4,4,72,36,36,70
Brondby,8774,2,21,5,4,74,33,41,68
Copenhagen,8774,3,13,6,11,55,46,9,45
FC Nords,8774,4,12,7,11,68,53,15,43
AaB,8774,5,7,13,10,35,46,-11,34
AC Horsens,8774,6,7,13,10,33,49,-16,34
Sonderjyske,8774,7,8,6,10,28,29,-1,30
Lyngby,8774,8,4,9,11,28,45,-17,21
Randers FC,8774,9,5,6,13,24,41,-17,21
Silkeborg IF,8774,10,5,4,13,28,47,-19,19
AGF Aarhus,8774,11,4,7,11,19,39,-20,19
Brondby,8775,1,21,6,3,68,30,38,69
FC Midtjylla,8775,2,21,4,5,68,43,25,67
Copenhagen,8775,3,15,4,11,63,44,19,49
FC Nords,8775,4,13,7,10,69,51,18,46
AaB,8775,5,7,11,12,38,47,-9,32
AC Horsens,8775,6,6,14,10,33,50,-17,32
Sonderjyske,8775,7,8,6,10,28,29,-1,30
Randers FC,8775,8,6,6,12,25,39,-14,24
Silkeborg IF,8775,9,6,3,13,28,44,-16,21
Lyngby,8775,10,3,9,12,26,46,-20,18
AGF Aarhus,8775,11,4,6,12,16,39,-23,18
Brondby,8776,1,20,8,2,68,31,37,68
FC Midtjylla,8776,2,19,7,4,64,36,28,64
FC Nords,8776,3,14,7,9,74,49,25,49
Copenhagen,8776,4,14,6,10,57,42,15,48
AaB,8776,5,7,12,11,36,45,-9,33
Sonderjyske,8776,6,8,6,10,28,29,-1,30
AC Horsens,8776,7,6,12,12,34,56,-22,30
Randers FC,8776,8,6,6,12,26,39,-13,24
Silkeborg IF,8776,9,6,3,13,29,47,-18,21
Lyngby,8776,10,3,9,12,26,47,-21,18
AGF Aarhus,8776,11,4,6,12,19,40,-21,18
Brondby,8777,1,22,5,3,73,31,42,71
FC Midtjylla,8777,2,19,4,7,61,37,24,61
FC Nords,8777,3,16,6,8,75,50,25,54
Copenhagen,8777,4,13,4,13,55,47,8,43
AaB,8777,5,9,11,10,38,42,-4,38
Sonderjyske,8777,6,8,6,10,28,29,-1,30
AC Horsens,8777,7,6,12,12,32,53,-21,30
Randers FC,8777,8,6,6,12,27,39,-12,24
Silkeborg IF,8777,9,6,3,13,26,44,-18,21
AGF Aarhus,8777,10,4,6,12,16,37,-21,18
Lyngby,8777,11,3,9,12,26,48,-22,18
Brondby,8778,1,20,7,3,68,31,37,67
FC Midtjylla,8778,2,20,5,5,63,37,26,65
FC Nords,8778,3,14,7,9,70,48,22,49
Copenhagen,8778,4,14,5,11,56,45,11,47
AaB,8778,5,8,12,10,37,41,-4,36
Sonderjyske,8778,6,8,6,10,28,29,-1,30
AC Horsens,8778,7,5,14,11,32,50,-18,29
Randers FC,8778,8,5,7,12,24,40,-16,22
Silkeborg IF,8778,9,6,3,13,32,44,-12,21
Lyngby,8778,10,3,10,11,27,45,-18,19
AGF Aarhus,8778,11,4,6,12,16,43,-27,18
Brondby,8779,1,20,7,3,68,31,37,67
FC Midtjylla,8779,2,18,6,6,64,40,24,60
FC Nords,8779,3,17,6,7,79,48,31,57
Copenhagen,8779,4,13,6,11,53,44,9,45
AaB,8779,5,7,12,11,38,45,-7,33
AC Horsens,8779,6,6,13,11,35,55,-20,31
Sonderjyske,8779,7,8,6,10,28,29,-1,30
Lyngby,8779,8,4,9,11,30,47,-17,21
Silkeborg IF,8779,9,6,3,13,28,45,-17,21
Randers FC,8779,10,5,6,13,26,43,-17,21
AGF Aarhus,8779,11,4,6,12,17,39,-22,18
Brondby,8780,1,19,6,5,71,38,33,63
FC Midtjylla,8780,2,18,8,4,68,43,25,62
FC Nords,8780,3,14,8,8,80,56,24,50
Copenhagen,8780,4,15,5,10,60,46,14,50
AaB,8780,5,7,13,10,39,45,-6,34
AC Horsens,8780,6,6,14,10,36,52,-16,32
Sonderjyske,8780,7,8,6,10,28,29,-1,30
Randers FC,8780,8,6,6,12,25,40,-15,24
Silkeborg IF,8780,9,6,3,13,27,45,-18,21
Lyngby,8780,10,3,9,12,27,46,-19,18
AGF Aarhus,8780,11,4,6,12,17,38,-21,18
Brondby,8781,1,21,7,2,74,29,45,70
FC Midtjylla,8781,2,19,6,5,67,38,29,63
Copenhagen,8781,3,14,5,11,54,44,10,47
FC Nords,8781,4,12,7,11,67,58,9,43
AC Horsens,8781,5,7,15,8,36,48,-12,36
AaB,8781,6,7,12,11,37,44,-7,33
Sonderjyske,8781,7,8,6,10,28,29,-1,30
Lyngby,8781,8,4,9,11,27,44,-17,21
Randers FC,8781,9,5,6,13,23,40,-17,21
Silkeborg IF,8781,10,5,4,13,25,44,-19,19
AGF Aarhus,8781,11,4,7,11,16,36,-20,19
Brondby,8782,1,23,5,2,73,27,46,74
FC Midtjylla,8782,2,19,4,7,62,37,25,61
FC Nords,8782,3,14,6,10,71,55,16,48
Copenhagen,8782,4,14,4,12,52,42,10,46
AC Horsens,8782,5,7,13,10,34,50,-16,34
AaB,8782,6,7,12,11,35,42,-7,33
Sonderjyske,8782,7,8,6,10,28,29,-1,30
Lyngby,8782,8,4,9,11,28,44,-16,21
Silkeborg IF,8782,9,6,3,13,26,44,-18,21
Randers FC,8782,10,5,6,13,23,41,-18,21
AGF Aarhus,8782,11,4,6,12,16,37,-21,18
Brondby,8783,1,21,5,4,67,34,33,68
FC Midtjylla,8783,2,18,6,6,60,38,22,60
FC Nords,8783,3,16,7,7,81,48,33,55
Copenhagen,8783,4,13,5,12,58,48,10,44
AaB,8783,5,7,13,10,37,43,-6,34
AC Horsens,8783,6,6,14,10,35,53,-18,32
Sonderjyske,8783,7,8,6,10,28,29,-1,30
Lyngby,8783,8,4,9,11,27,44,-17,21
Randers FC,8783,9,5,6,13,23,40,-17,21
AGF Aarhus,8783,10,5,6,11,19,37,-18,21
Silkeborg IF,8783,11,5,3,14,26,47,-21,18
Brondby,8784,1,21,6,3,69,32,37,69
FC Midtjylla,8784,2,20,5,5,71,40,31,65
FC Nords,8784,3,13,7,10,75,59,16,46
Copenhagen,8784,4,12,8,10,62,51,11,44
AaB,8784,5,7,13,10,39,46,-7,34
AC Horsens,8784,6,7,13,10,39,53,-14,34
Sonderjyske,8784,7,8,6,10,28,29,-1,30
Lyngby,8784,8,4,9,11,28,44,-16,21
Randers FC,8784,9,5,6,13,23,41,-18,21
Silkeborg IF,8784,10,5,4,13,25,44,-19,19
AGF Aarhus,8784,11,4,7,11,16,36,-20,19
Brondby,8785,1,21,7,2,73,29,44,70
FC Midtjylla,8785,2,18,6,6,66,46,20,60
FC Nords,8785,3,15,8,7,75,47,28,53
Copenhagen,8785,4,13,7,10,57,45,12,46
AaB,8785,5,7,13,10,36,43,-7,34
Sonderjyske,8785,6,8,6,10,28,29,-1,30
AC Horsens,8785,7,5,13,12,33,56,-23,28
Randers FC,8785,8,5,7,12,24,40,-16,22
AGF Aarhus,8785,9,5,6,11,19,37,-18,21
Lyngby,8785,10,3,10,11,27,45,-18,19
Silkeborg IF,8785,11,5,3,14,26,47,-21,18
Brondby,8786,1,20,6,4,67,32,35,66
FC Midtjylla,8786,2,18,7,5,62,38,24,61
FC Nords,8786,3,14,7,9,74,54,20,49
Copenhagen,8786,4,13,6,11,56,43,13,45
AaB,8786,5,9,11,10,39,43,-4,38
AC Horsens,8786,6,7,13,10,35,49,-14,34
Sonderjyske,8786,7,8,6,10,28,29,-1,30
Randers FC,8786,8,6,6,12,24,39,-15,24
Silkeborg IF,8786,9,6,3,13,28,46,-18,21
Lyngby,8786,10,3,9,12,26,45,-19,18
AGF Aarhus,8786,11,4,6,12,18,39,-21,18
Brondby,8787,1,21,6,3,69,31,38,69
FC Midtjylla,8787,2,19,5,6,63,39,24,62
FC Nords,8787,3,13,7,10,69,53,16,46
Copenhagen,8787,4,13,5,12,53,43,10,44
AC Horsens,8787,5,8,13,9,36,48,-12,37
AaB,8787,6,8,12,10,39,41,-2,36
Sonderjyske,8787,7,8,6,10,28,29,-1,30
Randers FC,8787,8,5,7,12,25,41,-16,22
Silkeborg IF,8787,9,6,3,13,27,44,-17,21
Lyngby,8787,10,3,10,11,28,46,-18,19
AGF Aarhus,8787,11,4,6,12,16,38,-22,18
Brondby,8788,1,19,5,6,65,36,29,62
FC Midtjylla,8788,2,18,5,7,63,41,22,59
FC Nords,8788,3,17,6,7,76,48,28,57
Copenhagen,8788,4,13,6,11,57,45,12,45
AaB,8788,5,8,12,10,37,40,-3,36
AC Horsens,8788,6,7,14,9,33,47,-14,35
Sonderjyske,8788,7,8,6,10,28,29,-1,30
Randers FC,8788,8,6,6,12,28,42,-14,24
Silkeborg IF,8788,9,5,4,13,27,46,-19,19
AGF Aarhus,8788,10,4,7,11,18,38,-20,19
Lyngby,8788,11,3,9,12,29,49,-20,18
Brondby,8789,1,20,6,4,69,34,35,66
FC Midtjylla,8789,2,20,5,5,68,39,29,65
FC Nords,8789,3,13,8,9,70,52,18,47
Copenhagen,8789,4,13,6,11,59,49,10,45
AaB,8789,5,8,12,10,38,40,-2,36
AC Horsens,8789,6,7,13,10,37,53,-16,34
Sonderjyske,8789,7,8,6,10,28,29,-1,30
Lyngby,8789,8,4,9,11,28,45,-17,21
Randers FC,8789,9,5,6,13,24,41,-17,21
Silkeborg IF,8789,10,5,4,13,26,45,-19,19
AGF Aarhus,8789,11,4,7,11,17,37,-20,19
Brondby,8790,1,22,6,2,73,30,43,72
FC Midtjylla,8790,2,18,6,6,62,39,23,60
FC Nords,8790,3,13,8,9,72,51,21,47
Copenhagen,8790,4,13,6,11,58,47,11,45
AaB,8790,5,8,12,10,41,45,-4,36
AC Horsens,8790,6,7,12,11,35,55,-20,33
Sonderjyske,8790,7,8,6,10,28,29,-1,30
Randers FC,8790,8,6,6,12,25,39,-14,24
Silkeborg IF,8790,9,6,3,13,26,44,-18,21
Lyngby,8790,10,3,9,12,26,46,-20,18
AGF Aarhus,8790,11,4,6,12,16,37,-21,18
Brondby,8791,1,21,6,3,70,30,40,69
FC Midtjylla,8791,2,20,5,5,73,41,32,65
Copenhagen,8791,3,14,6,10,56,45,11,48
FC Nords,8791,4,13,7,10,73,57,16,46
AaB,8791,5,6,14,10,37,43,-6,32
AC Horsens,8791,6,6,14,10,35,54,-19,32
Sonderjyske,8791,7,8,6,10,28,29,-1,30
Lyngby,8791,8,4,9,11,29,45,-16,21
Randers FC,8791,9,5,6,13,24,42,-18,21
Silkeborg IF,8791,10,5,4,13,25,44,-19,19
AGF Aarhus,8791,11,4,7,11,16,36,-20,19
Brondby,8792,1,20,7,3,70,32,38,67
FC Midtjylla,8792,2,20,5,5,65,37,28,65
FC Nords,8792,3,16,6,8,75,47,28,54
Copenhagen,8792,4,14,5,11,59,46,13,47
AaB,8792,5,8,11,11,37,45,-8,35
Sonderjyske,8792,6,8,6,10,28,29,-1,30
AC Horsens,8792,7,5,12,13,31,56,-25,27
Silkeborg IF,8792,8,6,3,13,30,46,-16,21
Lyngby,8792,9,4,9,11,27,44,-17,21
Randers FC,8792,10,5,6,13,23,40,-17,21
AGF Aarhus,8792,11,4,6,12,18,41,-23,18
Brondby,8793,1,21,7,2,70,30,40,70
FC Midtjylla,8793,2,19,5,6,64,38,26,62
FC Nords,8793,3,13,8,9,73,50,23,47
Copenhagen,8793,4,14,5,11,58,48,10,47
AaB,8793,5,7,13,10,36,41,-5,34
AC Horsens,8793,6,7,12,11,38,58,-20,33
Sonderjyske,8793,7,8,6,10,28,29,-1,30
Randers FC,8793,8,6,6,12,25,40,-15,24
Silkeborg IF,8793,9,6,3,13,31,47,-16,21
Lyngby,8793,10,3,9,12,27,46,-19,18
AGF Aarhus,8793,11,4,6,12,19,42,-23,18
Brondby,8794,1,20,6,4,68,33,35,66
FC Midtjylla,8794,2,20,5,5,69,37,32,65
FC Nords,8794,3,15,7,8,78,49,29,52
Copenhagen,8794,4,13,5,12,54,48,6,44
AaB,8794,5,8,11,11,38,49,-11,35
AC Horsens,8794,6,6,14,10,33,50,-17,32
Sonderjyske,8794,7,8,6,10,28,29,-1,30
Randers FC,8794,8,5,7,12,24,40,-16,22
Silkeborg IF,8794,9,6,3,13,26,44,-18,21
Lyngby,8794,10,3,10,11,27,45,-18,19
AGF Aarhus,8794,11,4,6,12,16,37,-21,18
Brondby,8795,1,23,5,2,73,30,43,74
FC Midtjylla,8795,2,18,5,7,59,37,22,59
FC Nords,8795,3,14,7,9,73,52,21,49
Copenhagen,8795,4,13,7,10,55,44,11,46
AaB,8795,5,7,13,10,37,43,-6,34
AC Horsens,8795,6,6,13,11,34,51,-17,31
Sonderjyske,8795,7,8,6,10,28,29,-1,30
Lyngby,8795,8,4,9,11,28,44,-16,21
Randers FC,8795,9,5,6,13,23,41,-18,21
Silkeborg IF,8795,10,5,4,13,26,45,-19,19
AGF Aarhus,8795,11,4,7,11,17,37,-20,19
Brondby,8796,1,20,7,3,73,36,37,67
FC Midtjylla,8796,2,19,6,5,68,39,29,63
FC Nords,8796,3,14,7,9,73,54,19,49
Copenhagen,8796,4,13,6,11,59,49,10,45
AC Horsens,8796,5,8,13,9,40,49,-9,37
AaB,8796,6,7,11,12,36,48,-12,32
Sonderjyske,8796,7,8,6,10,28,29,-1,30
Randers FC,8796,8,6,6,12,26,41,-15,24
Silkeborg IF,8796,9,6,3,13,26,44,-18,21
Lyngby,8796,10,3,9,12,28,47,-19,18
AGF Aarhus,8796,11,4,6,12,16,37,-21,18
Brondby,8797,1,19,7,4,70,36,34,64
FC Midtjylla,8797,2,18,7,5,68,44,24,61
FC Nords,8797,3,14,7,9,72,54,18,49
Copenhagen,8797,4,12,5,13,56,49,7,41
AC Horsens,8797,5,9,13,8,40,48,-8,40
AaB,8797,6,8,13,9,39,40,-1,37
Sonderjyske,8797,7,8,6,10,28,29,-1,30
Randers FC,8797,8,6,6,12,24,39,-15,24
AGF Aarhus,8797,9,5,6,11,17,36,-19,21
Lyngby,8797,10,3,9,12,26,45,-19,18
Silkeborg IF,8797,11,5,3,14,25,45,-20,18
Brondby,8798,1,21,6,3,74,31,43,69
FC Midtjylla,8798,2,18,7,5,63,38,25,61
Copenhagen,8798,3,14,6,10,59,46,13,48
FC Nords,8798,4,13,7,10,69,53,16,46
AaB,8798,5,8,13,9,39,43,-4,37
AC Horsens,8798,6,6,13,11,33,52,-19,31
Sonderjyske,8798,7,8,6,10,28,29,-1,30
Lyngby,8798,8,4,9,11,29,44,-15,21
Randers FC,8798,9,5,6,13,23,42,-19,21
AGF Aarhus,8798,10,5,6,11,18,37,-19,21
Silkeborg IF,8798,11,5,3,14,26,46,-20,18
Brondby,8799,1,20,7,3,74,36,38,67
FC Midtjylla,8799,2,20,4,6,66,44,22,64
FC Nords,8799,3,14,7,9,75,52,23,49
Copenhagen,8799,4,13,5,12,56,47,9,44
AaB,8799,5,8,13,9,36,39,-3,37
AC Horsens,8799,6,7,12,11,39,54,-15,33
Sonderjyske,8799,7,8,6,10,28,29,-1,30
Lyngby,8799,8,4,9,11,28,45,-17,21
Randers FC,8799,9,5,6,13,24,41,-17,21
AGF Aarhus,8799,10,5,6,11,19,36,-17,21
Silkeborg IF,8799,11,5,3,14,25,47,-22,18
Brondby,8800,1,21,6,3,72,33,39,69
FC Midtjylla,8800,2,20,5,5,71,43,28,65
FC Nords,8800,3,13,6,11,75,55,20,45
Copenhagen,8800,4,12,6,12,54,50,4,42
AC Horsens,8800,5,9,12,9,39,51,-12,39
AaB,8800,6,8,11,11,39,44,-5,35
Sonderjyske,8800,7,8,6,10,28,29,-1,30
Randers FC,8800,8,6,6,12,24,39,-15,24
Silkeborg IF,8800,9,6,3,13,29,45,-16,21
Lyngby,8800,10,3,9,12,26,45,-19,18
AGF Aarhus,8800,11,4,6,12,17,40,-23,18
FC Midtjylla,8801,1,20,6,4,67,38,29,66
Brondby,8801,2,20,5,5,71,31,40,65
FC Nords,8801,3,13,8,9,73,56,17,47
Copenhagen,8801,4,13,6,11,61,50,11,45
AaB,8801,5,8,13,9,35,37,-2,37
AC Horsens,8801,6,6,14,10,33,54,-21,32
Sonderjyske,8801,7,8,6,10,28,29,-1,30
Lyngby,8801,8,4,9,11,28,44,-16,21
Randers FC,8801,9,5,6,13,23,41,-18,21
Silkeborg IF,8801,10,5,4,13,26,45,-19,19
AGF Aarhus,8801,11,4,7,11,17,37,-20,19
Brondby,8802,1,22,5,3,72,29,43,71
FC Midtjylla,8802,2,18,4,8,59,41,18,58
Copenhagen,8802,3,15,4,11,57,45,12,49
FC Nords,8802,4,14,6,10,75,52,23,48
AaB,8802,5,9,11,10,40,42,-2,38
AC Horsens,8802,6,7,12,11,33,53,-20,33
Sonderjyske,8802,7,8,6,10,28,29,-1,30
Lyngby,8802,8,4,9,11,28,45,-17,21
Randers FC,8802,9,5,6,13,24,41,-17,21
Silkeborg IF,8802,10,6,3,13,26,44,-18,21
AGF Aarhus,8802,11,4,6,12,16,37,-21,18
Brondby,8803,1,20,6,4,69,35,34,66
FC Midtjylla,8803,2,20,5,5,68,38,30,65
FC Nords,8803,3,16,6,8,79,50,29,54
Copenhagen,8803,4,13,5,12,56,47,9,44
AaB,8803,5,8,11,11,37,47,-10,35
AC Horsens,8803,6,6,13,11,32,50,-18,31
Sonderjyske,8803,7,8,6,10,28,29,-1,30
Randers FC,8803,8,6,6,12,25,40,-15,24
AGF Aarhus,8803,9,5,6,11,18,37,-19,21
Lyngby,8803,10,3,9,12,27,46,-19,18
Silkeborg IF,8803,11,5,3,14,26,46,-20,18
Brondby,8804,1,22,5,3,77,32,45,71
FC Midtjylla,8804,2,18,6,6,65,45,20,60
FC Nords,8804,3,13,9,8,71,49,22,48
Copenhagen,8804,4,13,6,11,54,42,12,45
AaB,8804,5,7,14,9,36,44,-8,35
AC Horsens,8804,6,6,14,10,33,50,-17,32
Sonderjyske,8804,7,8,6,10,28,29,-1,30
Randers FC,8804,8,5,7,12,24,40,-16,22
AGF Aarhus,8804,9,5,6,11,18,37,-19,21
Lyngby,8804,10,3,10,11,27,45,-18,19
Silkeborg IF,8804,11,5,3,14,26,46,-20,18
Brondby,8805,1,21,7,2,79,35,44,70
FC Midtjylla,8805,2,20,5,5,66,39,27,65
FC Nords,8805,3,16,7,7,73,47,26,55
Copenhagen,8805,4,14,4,12,57,45,12,46
Sonderjyske,8805,5,8,6,10,28,29,-1,30
AaB,8805,6,6,12,12,36,47,-11,30
AC Horsens,8805,7,5,13,12,32,56,-24,28
Randers FC,8805,8,5,7,12,23,39,-16,22
Lyngby,8805,9,3,10,11,26,44,-18,19
Silkeborg IF,8805,10,5,4,13,27,46,-19,19
AGF Aarhus,8805,11,4,7,11,18,38,-20,19
FC Midtjylla,8806,1,21,5,4,68,35,33,68
Brondby,8806,2,20,6,4,67,32,35,66
Copenhagen,8806,3,14,5,11,56,43,13,47
FC Nords,8806,4,12,8,10,70,57,13,44
AC Horsens,8806,5,8,12,10,38,49,-11,36
AaB,8806,6,7,12,11,37,46,-9,33
Sonderjyske,8806,7,8,6,10,28,29,-1,30
Randers FC,8806,8,5,7,12,24,40,-16,22
Lyngby,8806,9,3,10,11,27,45,-18,19
Silkeborg IF,8806,10,5,4,13,26,45,-19,19
AGF Aarhus,8806,11,4,7,11,17,37,-20,19
Brondby,8807,1,20,5,5,69,34,35,65
FC Midtjylla,8807,2,20,4,6,65,38,27,64
FC Nords,8807,3,15,6,9,77,53,24,51
Copenhagen,8807,4,12,5,13,54,49,5,41
AC Horsens,8807,5,9,12,9,37,50,-13,39
AaB,8807,6,8,12,10,38,42,-4,36
Sonderjyske,8807,7,8,6,10,28,29,-1,30
Randers FC,8807,8,5,7,12,24,40,-16,22
Silkeborg IF,8807,9,6,3,13,27,44,-17,21
Lyngby,8807,10,3,10,11,27,45,-18,19
AGF Aarhus,8807,11,4,6,12,16,38,-22,18
Brondby,8808,1,21,6,3,69,29,40,69
FC Midtjylla,8808,2,18,4,8,61,45,16,58
FC Nords,8808,3,14,7,9,72,51,21,49
Copenhagen,8808,4,14,7,9,60,39,21,49
AaB,8808,5,10,11,9,38,40,-2,41
Sonderjyske,8808,6,8,6,10,28,29,-1,30
AC Horsens,8808,7,5,13,12,33,55,-22,28
Randers FC,8808,8,5,7,12,23,39,-16,22
Silkeborg IF,8808,9,6,3,13,27,44,-17,21
Lyngby,8808,10,3,10,11,26,44,-18,19
AGF Aarhus,8808,11,4,6,12,16,38,-22,18
Brondby,8809,1,22,5,3,78,30,48,71
FC Midtjylla,8809,2,19,5,6,65,44,21,62
FC Nords,8809,3,14,6,10,69,56,13,48
Copenhagen,8809,4,14,4,12,58,46,12,46
AaB,8809,5,9,11,10,39,38,1,38
AC Horsens,8809,6,6,13,11,32,53,-21,31
Sonderjyske,8809,7,8,6,10,28,29,-1,30
Randers FC,8809,8,6,6,12,27,39,-12,24
Silkeborg IF,8809,9,6,3,13,29,47,-18,21
AGF Aarhus,8809,10,4,6,12,19,40,-21,18
Lyngby,8809,11,3,9,12,26,48,-22,18
FC Midtjylla,8810,1,20,6,4,69,37,32,66
Brondby,8810,2,20,5,5,72,32,40,65
FC Nords,8810,3,15,6,9,76,51,25,51
Copenhagen,8810,4,14,6,10,57,44,13,48
AaB,8810,5,7,12,11,34,51,-17,33
AC Horsens,8810,6,6,13,11,37,56,-19,31
Sonderjyske,8810,7,8,6,10,28,29,-1,30
Randers FC,8810,8,5,7,12,24,40,-16,22
AGF Aarhus,8810,9,5,6,11,18,37,-19,21
Lyngby,8810,10,3,10,11,27,45,-18,19
Silkeborg IF,8810,11,5,3,14,26,46,-20,18
Brondby,8811,1,22,6,2,70,27,43,72
FC Midtjylla,8811,2,18,6,6,63,40,23,60
Copenhagen,8811,3,14,7,9,61,43,18,49
FC Nords,8811,4,14,7,9,74,57,17,49
AaB,8811,5,6,13,11,36,45,-9,31
AC Horsens,8811,6,6,13,11,32,50,-18,31
Sonderjyske,8811,7,8,6,10,28,29,-1,30
Randers FC,8811,8,5,7,12,24,40,-16,22
Silkeborg IF,8811,9,6,3,13,27,45,-18,21
Lyngby,8811,10,3,10,11,27,45,-18,19
AGF Aarhus,8811,11,4,6,12,17,38,-21,18
Brondby,8812,1,23,5,2,76,31,45,74
FC Midtjylla,8812,2,18,4,8,62,41,21,58
FC Nords,8812,3,14,7,9,75,54,21,49
Copenhagen,8812,4,14,5,11,56,43,13,47
AaB,8812,5,8,12,10,42,45,-3,36
AC Horsens,8812,6,6,13,11,34,57,-23,31
Sonderjyske,8812,7,8,6,10,28,29,-1,30
Lyngby,8812,8,4,9,11,30,46,-16,21
Randers FC,8812,9,5,6,13,25,43,-18,21
Silkeborg IF,8812,10,5,4,13,26,45,-19,19
AGF Aarhus,8812,11,4,7,11,17,37,-20,19
Brondby,8813,1,22,5,3,73,34,39,71
FC Midtjylla,8813,2,19,5,6,63,43,20,62
FC Nords,8813,3,15,7,8,76,50,26,52
Copenhagen,8813,4,13,6,11,59,46,13,45
AaB,8813,5,6,14,10,37,43,-6,32
AC Horsens,8813,6,6,13,11,34,52,-18,31
Sonderjyske,8813,7,8,6,10,28,29,-1,30
Lyngby,8813,8,4,9,11,27,44,-17,21
Randers FC,8813,9,5,6,13,23,40,-17,21
AGF Aarhus,8813,10,5,6,11,20,39,-19,21
Silkeborg IF,8813,11,5,3,14,28,48,-20,18
FC Midtjylla,8814,1,22,4,4,67,34,33,70
Brondby,8814,2,20,6,4,67,35,32,66
FC Nords,8814,3,14,6,10,72,51,21,48
Copenhagen,8814,4,14,5,11,58,45,13,47
AaB,8814,5,7,13,10,35,42,-7,34
Sonderjyske,8814,6,8,6,10,28,29,-1,30
AC Horsens,8814,7,5,14,11,37,55,-18,29
Lyngby,8814,8,4,9,11,28,45,-17,21
Randers FC,8814,9,5,6,13,24,41,-17,21
AGF Aarhus,8814,10,5,6,11,17,36,-19,21
Silkeborg IF,8814,11,5,3,14,25,45,-20,18
Brondby,8815,1,21,7,2,76,30,46,70
FC Midtjylla,8815,2,19,6,5,66,39,27,63
Copenhagen,8815,3,14,6,10,62,46,16,48
FC Nords,8815,4,12,9,9,73,59,14,45
AaB,8815,5,7,12,11,35,45,-10,33
AC Horsens,8815,6,5,16,9,35,54,-19,31
Sonderjyske,8815,7,8,6,10,28,29,-1,30
Randers FC,8815,8,6,6,12,25,40,-15,24
Silkeborg IF,8815,9,5,4,13,26,45,-19,19
AGF Aarhus,8815,10,4,7,11,17,37,-20,19
Lyngby,8815,11,3,9,12,27,46,-19,18
Brondby,8816,1,20,7,3,69,32,37,67
FC Midtjylla,8816,2,19,5,6,64,38,26,62
FC Nords,8816,3,14,6,10,75,54,21,48
Copenhagen,8816,4,13,7,10,54,43,11,46
AaB,8816,5,7,15,8,39,41,-2,36
AC Horsens,8816,6,6,14,10,32,51,-19,32
Sonderjyske,8816,7,8,6,10,28,29,-1,30
Randers FC,8816,8,5,7,12,24,40,-16,22
Silkeborg IF,8816,9,6,3,13,29,47,-18,21
Lyngby,8816,10,3,10,11,27,45,-18,19
AGF Aarhus,8816,11,4,6,12,19,40,-21,18
Brondby,8817,1,20,6,4,64,32,32,66
FC Midtjylla,8817,2,19,6,5,62,37,25,63
FC Nords,8817,3,14,9,7,77,50,27,51
Copenhagen,8817,4,13,7,10,59,46,13,46
AaB,8817,5,7,13,10,36,42,-6,34
Sonderjyske,8817,6,8,6,10,28,29,-1,30
AC Horsens,8817,7,5,15,10,36,53,-17,30
Randers FC,8817,8,6,6,12,25,40,-15,24
Silkeborg IF,8817,9,6,3,13,27,44,-17,21
Lyngby,8817,10,3,9,12,27,46,-19,18
AGF Aarhus,8817,11,4,6,12,16,38,-22,18
Brondby,8818,1,23,5,2,73,28,45,74
FC Midtjylla,8818,2,19,5,6,62,39,23,62
Copenhagen,8818,3,14,5,11,57,44,13,47
FC Nords,8818,4,13,7,10,72,50,22,46
AaB,8818,5,7,13,10,38,43,-5,34
AC Horsens,8818,6,6,13,11,33,57,-24,31
Sonderjyske,8818,7,8,6,10,28,29,-1,30
Lyngby,8818,8,4,9,11,27,44,-17,21
Randers FC,8818,9,5,6,13,23,40,-17,21
Silkeborg IF,8818,10,5,4,13,26,45,-19,19
AGF Aarhus,8818,11,4,7,11,17,37,-20,19
Brondby,8819,1,21,7,2,72,32,40,70
FC Midtjylla,8819,2,20,4,6,66,40,26,64
FC Nords,8819,3,15,7,8,76,52,24,52
Copenhagen,8819,4,13,5,12,59,47,12,44
AaB,8819,5,7,13,10,37,43,-6,34
Sonderjyske,8819,6,8,6,10,28,29,-1,30
AC Horsens,8819,7,6,12,12,34,56,-22,30
Lyngby,8819,8,4,9,11,28,45,-17,21
Randers FC,8819,9,5,6,13,24,41,-17,21
AGF Aarhus,8819,10,5,6,11,17,36,-19,21
Silkeborg IF,8819,11,5,3,14,25,45,-20,18
Brondby,8820,1,18,7,5,65,38,27,61
FC Midtjylla,8820,2,17,6,7,61,42,19,57
FC Nords,8820,3,16,7,7,78,48,30,55
Copenhagen,8820,4,15,5,10,60,42,18,50
AaB,8820,5,8,13,9,37,39,-2,37
AC Horsens,8820,6,7,12,11,34,52,-18,33
Sonderjyske,8820,7,8,6,10,28,29,-1,30
Randers FC,8820,8,5,7,12,24,40,-16,22
AGF Aarhus,8820,9,5,6,11,17,36,-19,21
Lyngby,8820,10,3,10,11,27,45,-18,19
Silkeborg IF,8820,11,5,3,14,25,45,-20,18
Brondby,8821,1,21,5,4,68,31,37,68
FC Midtjylla,8821,2,21,4,5,80,39,41,67
FC Nords,8821,3,14,7,9,71,53,18,49
Copenhagen,8821,4,14,4,12,57,46,11,46
AC Horsens,8821,5,8,12,10,35,58,-23,36
Sonderjyske,8821,6,8,6,10,28,29,-1,30
AaB,8821,7,6,12,12,33,43,-10,30
Randers FC,8821,8,6,6,12,24,39,-15,24
Silkeborg IF,8821,9,5,4,13,25,44,-19,19
AGF Aarhus,8821,10,4,7,11,16,36,-20,19
Lyngby,8821,11,3,9,12,26,45,-19,18
Brondby,8822,1,20,6,4,68,30,38,66
FC Midtjylla,8822,2,19,5,6,65,40,25,62
FC Nords,8822,3,14,7,9,71,50,21,49
Copenhagen,8822,4,14,5,11,54,42,12,47
AaB,8822,5,9,11,10,38,43,-5,38
AC Horsens,8822,6,7,12,11,34,51,-17,33
Sonderjyske,8822,7,8,6,10,28,29,-1,30
Lyngby,8822,8,4,9,11,29,45,-16,21
Randers FC,8822,9,5,6,13,24,42,-18,21
AGF Aarhus,8822,10,5,6,11,17,36,-19,21
Silkeborg IF,8822,11,5,3,14,25,45,-20,18
Brondby,8823,1,21,6,3,73,33,40,69
FC Midtjylla,8823,2,20,4,6,67,38,29,64
FC Nords,8823,3,14,6,10,67,52,15,48
Copenhagen,8823,4,14,5,11,57,42,15,47
AaB,8823,5,7,13,10,36,43,-7,34
AC Horsens,8823,6,6,14,10,32,50,-18,32
Sonderjyske,8823,7,8,6,10,28,29,-1,30
Lyngby,8823,8,4,9,11,27,44,-17,21
Silkeborg IF,8823,8,6,3,13,27,44,-17,21
Randers FC,8823,10,5,6,13,23,40,-17,21
AGF Aarhus,8823,11,4,6,12,16,38,-22,18
Brondby,8824,1,20,6,4,66,31,35,66
FC Midtjylla,8824,2,20,6,4,64,34,30,66
FC Nords,8824,3,14,7,9,71,47,24,49
Copenhagen,8824,4,14,4,12,56,45,11,46
AC Horsens,8824,5,8,13,9,41,55,-14,37
Sonderjyske,8824,6,8,6,10,28,29,-1,30
AaB,8824,7,6,12,12,33,45,-12,30
Randers FC,8824,8,6,6,12,26,40,-14,24
Silkeborg IF,8824,9,6,3,13,28,45,-17,21
Lyngby,8824,10,3,9,12,27,47,-20,18
AGF Aarhus,8824,11,4,6,12,17,39,-22,18
Brondby,8825,1,21,5,4,69,32,37,68
FC Midtjylla,8825,2,20,5,5,64,40,24,65
Copenhagen,8825,3,15,4,11,60,46,14,49
FC Nords,8825,4,14,6,10,72,52,20,48
AC Horsens,8825,5,7,13,10,40,53,-13,34
AaB,8825,6,7,11,12,34,42,-8,32
Sonderjyske,8825,7,8,6,10,28,29,-1,30
Randers FC,8825,8,5,7,12,24,40,-16,22
Lyngby,8825,9,3,10,11,27,45,-18,19
Silkeborg IF,8825,10,5,4,13,28,47,-19,19
AGF Aarhus,8825,11,4,7,11,19,39,-20,19
Brondby,8826,1,20,6,4,69,33,36,66
FC Midtjylla,8826,2,20,4,6,67,39,28,64
FC Nords,8826,3,14,7,9,75,53,22,49
Copenhagen,8826,4,13,6,11,55,45,10,45
AaB,8826,5,9,12,9,42,42,0,39
AC Horsens,8826,6,6,13,11,32,54,-22,31
Sonderjyske,8826,7,8,6,10,28,29,-1,30
Silkeborg IF,8826,8,6,3,13,29,46,-17,21
Lyngby,8826,9,4,9,11,27,44,-17,21
Randers FC,8826,10,5,6,13,23,40,-17,21
AGF Aarhus,8826,11,4,6,12,18,40,-22,18
Brondby,8827,1,21,7,2,74,34,40,70
FC Midtjylla,8827,2,19,5,6,68,41,27,62
FC Nords,8827,3,13,10,7,71,49,22,49
Copenhagen,8827,4,14,6,10,61,46,15,48
AaB,8827,5,7,13,10,36,43,-7,34
Sonderjyske,8827,6,8,6,10,28,29,-1,30
AC Horsens,8827,7,5,13,12,33,56,-23,28
Randers FC,8827,8,5,7,12,23,39,-16,22
Silkeborg IF,8827,9,6,3,13,29,45,-16,21
Lyngby,8827,10,3,10,11,26,44,-18,19
AGF Aarhus,8827,11,4,6,12,17,40,-23,18
Brondby,8828,1,20,5,5,69,33,36,65
FC Midtjylla,8828,2,19,7,4,69,41,28,64
FC Nords,8828,3,16,7,7,75,47,28,55
Copenhagen,8828,4,13,5,12,59,51,8,44
AaB,8828,5,8,12,10,38,44,-6,36
Sonderjyske,8828,6,8,6,10,28,29,-1,30
AC Horsens,8828,7,5,14,11,35,55,-20,29
Randers FC,8828,8,6,6,12,25,39,-14,24
Silkeborg IF,8828,9,6,3,13,28,45,-17,21
Lyngby,8828,10,3,9,12,26,46,-20,18
AGF Aarhus,8828,11,4,6,12,17,39,-22,18
FC Midtjylla,8829,1,21,4,5,66,37,29,67
Brondby,8829,2,19,7,4,71,33,38,64
FC Nords,8829,3,13,7,10,76,58,18,46
Copenhagen,8829,4,13,5,12,56,48,8,44
AaB,8829,5,9,12,9,42,44,-2,39
AC Horsens,8829,6,7,13,10,36,53,-17,34
Sonderjyske,8829,7,8,6,10,28,29,-1,30
Randers FC,8829,8,5,7,12,23,39,-16,22
Lyngby,8829,9,3,10,11,26,44,-18,19
Silkeborg IF,8829,10,5,4,13,26,45,-19,19
AGF Aarhus,8829,11,4,7,11,17,37,-20,19
Brondby,8830,1,21,6,3,73,34,39,69
FC Midtjylla,8830,2,19,6,5,67,41,26,63
FC Nords,8830,3,13,7,10,72,52,20,46
Copenhagen,8830,4,13,6,11,58,45,13,45
AC Horsens,8830,5,8,14,8,40,52,-12,38
AaB,8830,6,7,11,12,38,50,-12,32
Sonderjyske,8830,7,8,6,10,28,29,-1,30
Lyngby,8830,8,4,9,11,28,44,-16,21
Randers FC,8830,9,5,6,13,23,41,-18,21
AGF Aarhus,8830,10,5,6,11,18,37,-19,21
Silkeborg IF,8830,11,5,3,14,26,46,-20,18
Brondby,8831,1,20,6,4,69,32,37,66
FC Midtjylla,8831,2,20,4,6,65,41,24,64
FC Nords,8831,3,14,7,9,73,50,23,49
Copenhagen,8831,4,13,6,11,55,44,11,45
AaB,8831,5,8,13,9,40,43,-3,37
AC Horsens,8831,6,6,14,10,34,52,-18,32
Sonderjyske,8831,7,8,6,10,28,29,-1,30
Randers FC,8831,8,5,7,12,24,40,-16,22
Silkeborg IF,8831,9,6,3,13,28,45,-17,21
Lyngby,8831,10,3,10,11,27,45,-18,19
AGF Aarhus,8831,11,4,6,12,17,39,-22,18
Brondby,8832,1,22,6,2,75,33,42,72
FC Midtjylla,8832,2,19,4,7,68,41,27,61
FC Nords,8832,3,14,6,10,73,58,15,48
Copenhagen,8832,4,14,4,12,60,46,14,46
AaB,8832,5,8,12,10,39,41,-2,36
AC Horsens,8832,6,6,14,10,36,58,-22,32
Sonderjyske,8832,7,8,6,10,28,29,-1,30
Randers FC,8832,8,6,6,12,26,40,-14,24
Silkeborg IF,8832,9,6,3,13,31,44,-13,21
Lyngby,8832,10,3,9,12,27,47,-20,18
AGF Aarhus,8832,11,4,6,12,16,42,-26,18
Brondby,8833,1,21,7,2,66,28,38,70
FC Midtjylla,8833,2,19,5,6,63,38,25,62
FC Nords,8833,3,15,7,8,73,47,26,52
Copenhagen,8833,4,13,5,12,54,47,7,44
AaB,8833,5,7,13,10,34,39,-5,34
Sonderjyske,8833,6,8,6,10,28,29,-1,30
AC Horsens,8833,7,5,15,10,31,48,-17,30
Lyngby,8833,8,4,9,11,29,45,-16,21
Silkeborg IF,8833,8,6,3,13,29,45,-16,21
Randers FC,8833,10,5,6,13,24,42,-18,21
AGF Aarhus,8833,11,4,6,12,17,40,-23,18
Brondby,8834,1,21,7,2,69,29,40,70
FC Midtjylla,8834,2,19,5,6,64,39,25,62
FC Nords,8834,3,15,6,9,72,52,20,51
Copenhagen,8834,4,12,4,14,50,42,8,40
AC Horsens,8834,5,7,15,8,35,47,-12,36
AaB,8834,6,7,13,10,33,40,-7,34
Sonderjyske,8834,7,8,6,10,28,29,-1,30
Lyngby,8834,8,4,9,11,28,44,-16,21
Randers FC,8834,9,5,6,13,23,41,-18,21
AGF Aarhus,8834,10,5,6,11,19,38,-19,21
Silkeborg IF,8834,11,5,3,14,27,47,-20,18
Brondby,8835,1,20,7,3,70,35,35,67
FC Midtjylla,8835,2,20,5,5,69,35,34,65
FC Nords,8835,3,13,7,10,68,52,16,46
Copenhagen,8835,4,14,4,12,58,48,10,46
AaB,8835,5,7,14,9,35,39,-4,35
AC Horsens,8835,6,7,13,10,35,52,-17,34
Sonderjyske,8835,7,8,6,10,28,29,-1,30
Randers FC,8835,8,5,7,12,25,41,-16,22
Silkeborg IF,8835,9,6,3,13,27,45,-18,21
Lyngby,8835,10,3,10,11,28,46,-18,19
AGF Aarhus,8835,11,4,6,12,17,38,-21,18
Brondby,8836,1,19,7,4,65,32,33,64
FC Midtjylla,8836,2,18,7,5,63,38,25,61
FC Nords,8836,3,14,9,7,70,47,23,51
Copenhagen,8836,4,14,6,10,57,42,15,48
AC Horsens,8836,5,7,13,10,34,48,-14,34
AaB,8836,6,7,12,11,34,42,-8,33
Sonderjyske,8836,7,8,6,10,28,29,-1,30
Randers FC,8836,8,5,7,12,24,40,-16,22
AGF Aarhus,8836,9,5,6,11,19,36,-17,21
Lyngby,8836,10,3,10,11,27,45,-18,19
Silkeborg IF,8836,11,5,3,14,25,47,-22,18
Brondby,8837,1,22,5,3,73,29,44,71
FC Midtjylla,8837,2,19,6,5,65,39,26,63
Copenhagen,8837,3,15,5,10,62,42,20,50
FC Nords,8837,4,14,7,9,72,52,20,49
Sonderjyske,8837,5,8,6,10,28,29,-1,30
AaB,8837,6,6,12,12,34,48,-14,30
AC Horsens,8837,7,5,15,10,34,56,-22,30
Lyngby,8837,8,4,9,11,31,44,-13,21
Silkeborg IF,8837,9,6,3,13,29,44,-15,21
Randers FC,8837,10,5,6,13,23,44,-21,21
AGF Aarhus,8837,11,4,6,12,16,40,-24,18
Brondby,8838,1,20,6,4,71,32,39,66
FC Midtjylla,8838,2,19,5,6,63,37,26,62
FC Nords,8838,3,15,7,8,76,55,21,52
Copenhagen,8838,4,13,5,12,57,49,8,44
AC Horsens,8838,5,8,13,9,38,50,-12,37
AaB,8838,6,7,12,11,36,44,-8,33
Sonderjyske,8838,7,8,6,10,28,29,-1,30
Lyngby,8838,8,4,9,11,27,44,-17,21
Randers FC,8838,9,5,6,13,23,40,-17,21
AGF Aarhus,8838,10,5,6,11,17,36,-19,21
Silkeborg IF,8838,11,5,3,14,25,45,-20,18
Brondby,8839,1,23,5,2,74,32,42,74
FC Midtjylla,8839,2,18,4,8,64,46,18,58
FC Nords,8839,3,14,7,9,74,53,21,49
Copenhagen,8839,4,14,5,11,60,45,15,47
AaB,8839,5,7,13,10,36,42,-6,34
AC Horsens,8839,6,6,14,10,35,51,-16,32
Sonderjyske,8839,7,8,6,10,28,29,-1,30
Randers FC,8839,8,5,7,12,24,40,-16,22
AGF Aarhus,8839,9,5,6,11,19,37,-18,21
Lyngby,8839,10,3,10,11,27,45,-18,19
Silkeborg IF,8839,11,5,3,14,26,47,-21,18
Brondby,8840,1,22,5,3,70,32,38,71
FC Midtjylla,8840,2,20,5,5,64,35,29,65
FC Nords,8840,3,15,7,8,75,50,25,52
Copenhagen,8840,4,13,4,13,56,47,9,43
AaB,8840,5,8,11,11,36,42,-6,35
Sonderjyske,8840,6,8,6,10,28,29,-1,30
AC Horsens,8840,7,6,12,12,34,55,-21,30
Lyngby,8840,8,4,9,11,27,44,-17,21
Randers FC,8840,9,5,6,13,23,40,-17,21
Silkeborg IF,8840,10,5,4,13,25,44,-19,19
AGF Aarhus,8840,11,4,7,11,16,36,-20,19
Brondby,8841,1,21,6,3,70,35,35,69
FC Midtjylla,8841,2,17,7,6,65,43,22,58
FC Nords,8841,3,14,9,7,74,46,28,51
Copenhagen,8841,4,15,5,10,63,45,18,50
AaB,8841,5,7,12,11,37,44,-7,33
AC Horsens,8841,6,6,13,11,37,59,-22,31
Sonderjyske,8841,7,8,6,10,28,29,-1,30
Lyngby,8841,8,4,9,11,28,44,-16,21
Silkeborg IF,8841,9,6,3,13,28,45,-17,21
Randers FC,8841,10,5,6,13,23,41,-18,21
AGF Aarhus,8841,11,4,6,12,17,39,-22,18
Brondby,8842,1,20,7,3,70,32,38,67
FC Midtjylla,8842,2,18,5,7,65,45,20,59
FC Nords,8842,3,16,7,7,82,49,33,55
Copenhagen,8842,4,13,6,11,56,48,8,45
AaB,8842,5,7,15,8,36,39,-3,36
Sonderjyske,8842,6,8,6,10,28,29,-1,30
AC Horsens,8842,7,5,14,11,34,56,-22,29
Randers FC,8842,8,5,7,12,24,40,-16,22
Silkeborg IF,8842,9,6,3,13,29,45,-16,21
Lyngby,8842,10,3,10,11,27,45,-18,19
AGF Aarhus,8842,11,4,6,12,17,40,-23,18
Brondby,8843,1,20,6,4,66,33,33,66
FC Midtjylla,8843,2,20,5,5,63,36,27,65
FC Nords,8843,3,14,8,8,71,49,22,50
Copenhagen,8843,4,15,5,10,58,40,18,50
AaB,8843,5,7,12,11,35,42,-7,33
Sonderjyske,8843,6,8,6,10,28,29,-1,30
AC Horsens,8843,7,6,12,12,32,51,-19,30
Randers FC,8843,8,5,7,12,23,39,-16,22
Silkeborg IF,8843,9,6,3,13,27,44,-17,21
Lyngby,8843,10,3,10,11,26,44,-18,19
AGF Aarhus,8843,11,4,6,12,16,38,-22,18
Brondby,8844,1,21,6,3,72,36,36,69
FC Midtjylla,8844,2,19,6,5,69,40,29,63
FC Nords,8844,3,13,8,9,68,49,19,47
Copenhagen,8844,4,13,7,10,56,44,12,46
AaB,8844,5,8,11,11,37,44,-7,35
AC Horsens,8844,6,6,14,10,36,51,-15,32
Sonderjyske,8844,7,8,6,10,28,29,-1,30
Lyngby,8844,8,4,9,11,27,44,-17,21
Silkeborg IF,8844,8,6,3,13,27,44,-17,21
Randers FC,8844,10,5,6,13,23,40,-17,21
AGF Aarhus,8844,11,4,6,12,16,38,-22,18
Brondby,8845,1,21,7,2,70,31,39,70
FC Midtjylla,8845,2,19,4,7,65,40,25,61
FC Nords,8845,3,14,6,10,74,53,21,48
Copenhagen,8845,4,14,6,10,59,44,15,48
AaB,8845,5,9,12,9,38,40,-2,39
Sonderjyske,8845,6,8,6,10,28,29,-1,30
AC Horsens,8845,7,5,13,12,31,55,-24,28
Randers FC,8845,8,5,7,12,23,39,-16,22
Silkeborg IF,8845,9,6,3,13,27,45,-18,21
Lyngby,8845,10,3,10,11,26,44,-18,19
AGF Aarhus,8845,11,4,6,12,17,38,-21,18
Brondby,8846,1,22,6,2,78,31,47,72
FC Midtjylla,8846,2,20,4,6,66,39,27,64
FC Nords,8846,3,14,7,9,70,52,18,49
Copenhagen,8846,4,13,4,13,54,46,8,43
AC Horsens,8846,5,7,13,10,35,50,-15,34
AaB,8846,6,7,12,11,35,46,-11,33
Sonderjyske,8846,7,8,6,10,28,29,-1,30
Randers FC,8846,8,5,7,12,24,40,-16,22
Silkeborg IF,8846,9,6,3,13,27,45,-18,21
Lyngby,8846,10,3,10,11,27,45,-18,19
AGF Aarhus,8846,11,4,6,12,17,38,-21,18
Brondby,8847,1,21,5,4,69,30,39,68
FC Midtjylla,8847,2,20,5,5,63,37,26,65
FC Nords,8847,3,12,8,10,70,53,17,44
Copenhagen,8847,4,13,5,12,54,45,9,44
AaB,8847,5,9,11,10,35,39,-4,38
AC Horsens,8847,6,8,12,10,37,50,-13,36
Sonderjyske,8847,7,8,6,10,28,29,-1,30
Lyngby,8847,8,4,9,11,31,45,-14,21
Silkeborg IF,8847,9,6,3,13,26,44,-18,21
Randers FC,8847,10,5,6,13,24,44,-20,21
AGF Aarhus,8847,11,4,6,12,16,37,-21,18
Brondby,8848,1,20,7,3,70,33,37,67
FC Midtjylla,8848,2,19,6,5,66,39,27,63
FC Nords,8848,3,13,8,9,76,56,20,47
Copenhagen,8848,4,14,5,11,59,44,15,47
AaB,8848,5,7,13,10,36,44,-8,34
AC Horsens,8848,6,6,15,9,36,53,-17,33
Sonderjyske,8848,7,8,6,10,28,29,-1,30
Randers FC,8848,8,5,7,12,23,39,-16,22
Silkeborg IF,8848,9,6,3,13,30,44,-14,21
Lyngby,8848,10,3,10,11,26,44,-18,19
AGF Aarhus,8848,11,4,6,12,16,41,-25,18
FC Midtjylla,8849,1,21,5,4,71,35,36,68
Brondby,8849,2,18,8,4,71,39,32,62
FC Nords,8849,3,14,7,9,76,56,20,49
Copenhagen,8849,4,13,5,12,55,45,10,44
AaB,8849,5,8,12,10,37,44,-7,36
AC Horsens,8849,6,7,13,10,38,55,-17,34
Sonderjyske,8849,7,8,6,10,28,29,-1,30
Silkeborg IF,8849,8,6,3,13,28,44,-16,21
Lyngby,8849,9,4,9,11,28,45,-17,21
Randers FC,8849,10,5,6,13,24,41,-17,21
AGF Aarhus,8849,11,4,6,12,16,39,-23,18
Brondby,8850,1,21,6,3,70,32,38,69
FC Midtjylla,8850,2,17,5,8,62,43,19,56
FC Nords,8850,3,15,6,9,71,51,20,51
Copenhagen,8850,4,14,6,10,60,44,16,48
AC Horsens,8850,5,8,12,10,37,52,-15,36
AaB,8850,6,8,11,11,36,40,-4,35
Sonderjyske,8850,7,8,6,10,28,29,-1,30
Randers FC,8850,8,5,7,12,24,40,-16,22
Silkeborg IF,8850,9,6,3,13,27,45,-18,21
Lyngby,8850,10,3,10,11,27,45,-18,19
AGF Aarhus,8850,11,4,6,12,17,38,-21,18
Brondby,8851,1,21,6,3,67,31,36,69
FC Midtjylla,8851,2,19,6,5,63,37,26,63
Copenhagen,8851,3,16,5,9,62,41,21,53
FC Nords,8851,4,13,6,11,71,53,18,45
AC Horsens,8851,5,7,13,10,40,53,-13,34
Sonderjyske,8851,6,8,6,10,28,29,-1,30
AaB,8851,7,6,12,12,34,48,-14,30
Lyngby,8851,8,4,9,11,29,44,-15,21
Randers FC,8851,9,5,6,13,23,42,-19,21
Silkeborg IF,8851,10,5,4,13,27,46,-19,19
AGF Aarhus,8851,11,4,7,11,18,38,-20,19
FC Midtjylla,8852,1,21,4,5,70,37,33,67
Brondby,8852,2,19,8,3,64,31,33,65
FC Nords,8852,3,13,8,9,70,50,20,47
Copenhagen,8852,4,13,7,10,56,44,12,46
AaB,8852,5,7,13,10,34,43,-9,34
AC Horsens,8852,6,7,12,11,36,51,-15,33
Sonderjyske,8852,7,8,6,10,28,29,-1,30
Lyngby,8852,8,4,9,11,27,44,-17,21
Randers FC,8852,9,5,6,13,23,40,-17,21
AGF Aarhus,8852,10,5,6,11,17,36,-19,21
Silkeborg IF,8852,11,5,3,14,25,45,-20,18
Brondby,8853,1,21,6,3,72,33,39,69
FC Midtjylla,8853,2,20,5,5,68,39,29,65
Copenhagen,8853,3,15,4,11,57,44,13,49
FC Nords,8853,4,12,8,10,70,56,14,44
AaB,8853,5,8,14,8,41,41,0,38
Sonderjyske,8853,6,8,6,10,28,29,-1,30
AC Horsens,8853,7,5,13,12,31,52,-21,28
Randers FC,8853,8,5,7,12,25,41,-16,22
AGF Aarhus,8853,9,5,6,11,17,36,-19,21
Lyngby,8853,10,3,10,11,28,46,-18,19
Silkeborg IF,8853,11,5,3,14,25,45,-20,18
Brondby,8854,1,22,5,3,72,27,45,71
FC Midtjylla,8854,2,17,4,9,57,42,15,55
Copenhagen,8854,3,16,4,10,56,39,17,52
FC Nords,8854,4,13,6,11,67,58,9,45
AaB,8854,5,9,11,10,38,39,-1,38
AC Horsens,8854,6,8,12,10,39,50,-11,36
Sonderjyske,8854,7,8,6,10,28,29,-1,30
Randers FC,8854,8,6,6,12,27,40,-13,24
Silkeborg IF,8854,9,6,3,13,27,45,-18,21
Lyngby,8854,10,3,9,12,27,48,-21,18
AGF Aarhus,8854,11,4,6,12,17,38,-21,18
Brondby,8855,1,21,6,3,73,31,42,69
FC Midtjylla,8855,2,21,4,5,73,40,33,67
FC Nords,8855,3,15,7,8,73,49,24,52
Copenhagen,8855,4,13,5,12,55,46,9,44
AaB,8855,5,7,11,12,35,46,-11,32
AC Horsens,8855,6,6,13,11,33,56,-23,31
Sonderjyske,8855,7,8,6,10,28,29,-1,30
Randers FC,8855,8,6,6,12,25,39,-14,24
AGF Aarhus,8855,9,5,6,11,18,37,-19,21
Lyngby,8855,10,3,9,12,26,46,-20,18
Silkeborg IF,8855,10,5,3,14,26,46,-20,18
Brondby,8856,1,22,5,3,70,28,42,71
FC Midtjylla,8856,2,20,5,5,66,37,29,65
FC Nords,8856,3,16,6,8,75,50,25,54
Copenhagen,8856,4,12,6,12,56,49,7,42
AaB,8856,5,7,12,11,36,43,-7,33
Sonderjyske,8856,6,8,6,10,28,29,-1,30
AC Horsens,8856,7,5,14,11,35,57,-22,29
Randers FC,8856,8,6,6,12,24,39,-15,24
Silkeborg IF,8856,9,6,3,13,26,44,-18,21
Lyngby,8856,10,3,9,12,26,45,-19,18
AGF Aarhus,8856,11,4,6,12,16,37,-21,18
Brondby,8857,1,20,7,3,68,32,36,67
FC Midtjylla,8857,2,20,6,4,67,35,32,66
FC Nords,8857,3,14,8,8,69,46,23,50
Copenhagen,8857,4,13,5,12,53,45,8,44
AaB,8857,5,7,12,11,38,46,-8,33
AC Horsens,8857,6,6,14,10,34,51,-17,32
Sonderjyske,8857,7,8,6,10,28,29,-1,30
Lyngby,8857,8,4,9,11,28,44,-16,21
Randers FC,8857,9,5,6,13,23,41,-18,21
AGF Aarhus,8857,10,5,6,11,19,37,-18,21
Silkeborg IF,8857,11,5,3,14,26,47,-21,18
Brondby,8858,1,19,8,3,68,34,34,65
FC Midtjylla,8858,2,20,5,5,69,38,31,65
Copenhagen,8858,3,16,4,10,60,46,14,52
FC Nords,8858,4,14,8,8,75,50,25,50
AC Horsens,8858,5,6,14,10,33,52,-19,32
Sonderjyske,8858,6,8,6,10,28,29,-1,30
AaB,8858,7,6,11,13,34,45,-11,29
Silkeborg IF,8858,8,6,3,13,28,44,-16,21
Lyngby,8858,9,4,9,11,28,45,-17,21
Randers FC,8858,10,5,6,13,24,41,-17,21
AGF Aarhus,8858,11,4,6,12,16,39,-23,18
Brondby,8859,1,20,6,4,72,37,35,66
FC Midtjylla,8859,2,20,6,4,69,37,32,66
FC Nords,8859,3,14,8,8,77,52,25,50
Copenhagen,8859,4,14,5,11,59,44,15,47
AaB,8859,5,8,11,11,38,44,-6,35
Sonderjyske,8859,6,8,6,10,28,29,-1,30
AC Horsens,8859,7,6,12,12,33,60,-27,30
Randers FC,8859,8,6,6,12,26,40,-14,24
Silkeborg IF,8859,9,6,3,13,28,45,-17,21
Lyngby,8859,10,3,9,12,27,47,-20,18
AGF Aarhus,8859,11,4,6,12,17,39,-22,18
Brondby,8860,1,21,5,4,70,34,36,68
FC Midtjylla,8860,2,20,4,6,66,36,30,64
FC Nords,8860,3,15,7,8,78,53,25,52
Copenhagen,8860,4,14,5,11,60,49,11,47
AaB,8860,5,8,11,11,36,44,-8,35
Sonderjyske,8860,6,8,6,10,28,29,-1,30
AC Horsens,8860,7,5,14,11,33,53,-20,29
Randers FC,8860,8,6,6,12,24,39,-15,24
Silkeborg IF,8860,9,5,4,13,26,45,-19,19
AGF Aarhus,8860,10,4,7,11,17,37,-20,19
Lyngby,8860,11,3,9,12,26,45,-19,18
Brondby,8861,1,19,8,3,69,35,34,65
FC Midtjylla,8861,2,20,5,5,71,43,28,65
Copenhagen,8861,3,15,5,10,61,41,20,50
FC Nords,8861,4,13,7,10,71,53,18,46
AaB,8861,5,8,13,9,38,41,-3,37
Sonderjyske,8861,6,8,6,10,28,29,-1,30
AC Horsens,8861,7,6,12,12,34,57,-23,30
Lyngby,8861,8,4,9,11,28,45,-17,21
Randers FC,8861,9,5,6,13,24,41,-17,21
Silkeborg IF,8861,10,6,3,13,26,44,-18,21
AGF Aarhus,8861,11,4,6,12,16,37,-21,18
Brondby,8862,1,20,7,3,70,35,35,67
FC Midtjylla,8862,2,19,4,7,63,38,25,61
FC Nords,8862,3,15,6,9,77,54,23,51
Copenhagen,8862,4,14,6,10,58,42,16,48
AaB,8862,5,8,13,9,39,41,-2,37
Sonderjyske,8862,6,8,6,10,28,29,-1,30
AC Horsens,8862,7,6,12,12,36,59,-23,30
Randers FC,8862,8,6,6,12,25,40,-15,24
Silkeborg IF,8862,9,6,3,13,27,44,-17,21
Lyngby,8862,10,3,9,12,27,46,-19,18
AGF Aarhus,8862,11,4,6,12,16,38,-22,18
Brondby,8863,1,20,6,4,68,33,35,66
FC Midtjylla,8863,2,19,5,6,67,41,26,62
FC Nords,8863,3,14,8,8,70,47,23,50
Copenhagen,8863,4,14,5,11,57,47,10,47
AC Horsens,8863,5,8,12,10,39,51,-12,36
AaB,8863,6,7,12,11,36,44,-8,33
Sonderjyske,8863,7,8,6,10,28,29,-1,30
Lyngby,8863,8,4,9,11,28,45,-17,21
Randers FC,8863,9,5,6,13,24,41,-17,21
Silkeborg IF,8863,10,5,4,13,26,45,-19,19
AGF Aarhus,8863,11,4,7,11,17,37,-20,19
Brondby,8864,1,20,7,3,65,28,37,67
FC Midtjylla,8864,2,19,4,7,67,40,27,61
FC Nords,8864,3,15,6,9,73,49,24,51
Copenhagen,8864,4,15,5,10,57,44,13,50
AaB,8864,5,7,12,11,38,44,-6,33
AC Horsens,8864,6,7,12,11,37,58,-21,33
Sonderjyske,8864,7,8,6,10,28,29,-1,30
Lyngby,8864,8,4,9,11,28,45,-17,21
Silkeborg IF,8864,8,6,3,13,28,45,-17,21
Randers FC,8864,10,5,6,13,24,41,-17,21
AGF Aarhus,8864,11,4,6,12,17,39,-22,18
Brondby,8865,1,21,7,2,72,29,43,70
FC Midtjylla,8865,2,19,4,7,63,43,20,61
FC Nords,8865,3,15,7,8,80,54,26,52
Copenhagen,8865,4,13,5,12,56,47,9,44
AaB,8865,5,8,11,11,37,47,-10,35
AC Horsens,8865,6,6,14,10,40,54,-14,32
Sonderjyske,8865,7,8,6,10,28,29,-1,30
Lyngby,8865,8,4,9,11,27,44,-17,21
Randers FC,8865,9,5,6,13,23,40,-17,21
Silkeborg IF,8865,10,6,3,13,28,46,-18,21
AGF Aarhus,8865,11,4,6,12,18,39,-21,18
Brondby,8866,1,20,6,4,69,33,36,66
FC Midtjylla,8866,2,20,5,5,68,39,29,65
Copenhagen,8866,3,14,6,10,57,44,13,48
FC Nords,8866,4,13,7,10,69,52,17,46
AaB,8866,5,8,12,10,39,43,-4,36
AC Horsens,8866,6,6,14,10,34,51,-17,32
Sonderjyske,8866,7,8,6,10,28,29,-1,30
Lyngby,8866,8,4,9,11,28,44,-16,21
Silkeborg IF,8866,9,6,3,13,27,45,-18,21
Randers FC,8866,10,5,6,13,23,41,-18,21
AGF Aarhus,8866,11,4,6,12,17,38,-21,18
Brondby,8867,1,22,5,3,74,33,41,71
FC Midtjylla,8867,2,18,6,6,60,41,19,60
FC Nords,8867,3,14,8,8,74,52,22,50
Copenhagen,8867,4,15,4,11,60,43,17,49
AaB,8867,5,7,13,10,36,42,-6,34
Sonderjyske,8867,6,8,6,10,28,29,-1,30
AC Horsens,8867,7,6,12,12,34,53,-19,30
Randers FC,8867,8,5,7,12,24,40,-16,22
Lyngby,8867,9,3,10,11,27,45,-18,19
Silkeborg IF,8867,10,5,4,13,27,46,-19,19
AGF Aarhus,8867,11,4,7,11,18,38,-20,19
Brondby,8868,1,19,8,3,71,34,37,65
FC Midtjylla,8868,2,19,7,4,66,40,26,64
FC Nords,8868,3,13,8,9,69,53,16,47
Copenhagen,8868,4,13,6,11,59,48,11,45
AC Horsens,8868,5,7,14,9,41,52,-11,35
AaB,8868,6,6,15,9,37,42,-5,33
Sonderjyske,8868,7,8,6,10,28,29,-1,30
Lyngby,8868,8,4,9,11,29,45,-16,21
Randers FC,8868,9,5,6,13,24,42,-18,21
AGF Aarhus,8868,10,5,6,11,19,37,-18,21
Silkeborg IF,8868,11,5,3,14,26,47,-21,18
Brondby,8869,1,21,6,3,78,33,45,69
FC Midtjylla,8869,2,20,4,6,66,39,27,64
FC Nords,8869,3,13,7,10,70,60,10,46
Copenhagen,8869,4,13,4,13,55,47,8,43
AC Horsens,8869,5,8,13,9,37,47,-10,37
AaB,8869,6,8,12,10,36,42,-6,36
Sonderjyske,8869,7,8,6,10,28,29,-1,30
Randers FC,8869,8,5,7,12,24,40,-16,22
Silkeborg IF,8869,9,6,3,13,27,45,-18,21
Lyngby,8869,10,3,10,11,27,45,-18,19
AGF Aarhus,8869,11,4,6,12,17,38,-21,18
Brondby,8870,1,19,7,4,66,36,30,64
FC Midtjylla,8870,2,18,4,8,63,43,20,58
FC Nords,8870,3,15,7,8,76,50,26,52
Copenhagen,8870,4,14,5,11,60,47,13,47
AC Horsens,8870,5,8,13,9,40,51,-11,37
AaB,8870,6,8,12,10,40,44,-4,36
Sonderjyske,8870,7,8,6,10,28,29,-1,30
Randers FC,8870,8,5,7,12,24,40,-16,22
Silkeborg IF,8870,9,6,3,13,26,44,-18,21
Lyngby,8870,10,3,10,11,27,45,-18,19
AGF Aarhus,8870,11,4,6,12,16,37,-21,18
FC Midtjylla,8871,1,21,5,4,73,42,31,68
Brondby,8871,2,19,7,4,70,35,35,64
FC Nords,8871,3,14,6,10,75,57,18,48
Copenhagen,8871,4,13,5,12,57,47,10,44
AC Horsens,8871,5,8,12,10,39,49,-10,36
AaB,8871,6,8,11,11,39,49,-10,35
Sonderjyske,8871,7,8,6,10,28,29,-1,30
Lyngby,8871,8,4,9,11,30,47,-17,21
Silkeborg IF,8871,9,6,3,13,27,44,-17,21
Randers FC,8871,10,5,6,13,26,43,-17,21
AGF Aarhus,8871,11,4,6,12,16,38,-22,18
Brondby,8872,1,19,8,3,72,33,39,65
FC Midtjylla,8872,2,19,5,6,64,44,20,62
FC Nords,8872,3,13,8,9,76,53,23,47
Copenhagen,8872,4,14,5,11,58,43,15,47
AaB,8872,5,8,12,10,36,44,-8,36
AC Horsens,8872,6,7,14,9,32,47,-15,35
Sonderjyske,8872,7,8,6,10,28,29,-1,30
Lyngby,8872,8,4,9,11,27,44,-17,21
Randers FC,8872,9,5,6,13,23,40,-17,21
Silkeborg IF,8872,10,5,4,13,26,45,-19,19
AGF Aarhus,8872,11,4,7,11,17,37,-20,19
Brondby,8873,1,21,5,4,74,35,39,68
FC Midtjylla,8873,2,21,4,5,70,38,32,67
FC Nords,8873,3,14,6,10,80,55,25,48
Copenhagen,8873,4,12,5,13,56,51,5,41
AaB,8873,5,9,11,10,38,48,-10,38
AC Horsens,8873,6,7,13,10,39,56,-17,34
Sonderjyske,8873,7,8,6,10,28,29,-1,30
Lyngby,8873,8,4,9,11,28,44,-16,21
Silkeborg IF,8873,9,6,3,13,27,45,-18,21
Randers FC,8873,10,5,6,13,23,41,-18,21
AGF Aarhus,8873,11,4,6,12,17,38,-21,18
Brondby,8874,1,20,7,3,68,34,34,67
FC Midtjylla,8874,2,20,6,4,68,39,29,66
FC Nords,8874,3,14,8,8,79,55,24,50
Copenhagen,8874,4,13,6,11,62,49,13,45
AaB,8874,5,8,11,11,38,45,-7,35
Sonderjyske,8874,6,8,6,10,28,29,-1,30
AC Horsens,8874,7,5,14,11,40,59,-19,29
Randers FC,8874,8,5,7,12,23,39,-16,22
Lyngby,8874,9,3,10,11,26,44,-18,19
Silkeborg IF,8874,10,5,4,13,25,44,-19,19
AGF Aarhus,8874,11,4,7,11,16,36,-20,19
Brondby,8875,1,21,6,3,72,32,40,69
FC Midtjylla,8875,2,20,6,4,68,37,31,66
FC Nords,8875,3,13,7,10,75,55,20,46
Copenhagen,8875,4,13,5,12,54,49,5,44
AaB,8875,5,8,12,10,38,42,-4,36
AC Horsens,8875,6,6,14,10,37,55,-18,32
Sonderjyske,8875,7,8,6,10,28,29,-1,30
Randers FC,8875,8,5,7,12,24,40,-16,22
AGF Aarhus,8875,9,5,6,11,19,37,-18,21
Lyngby,8875,10,3,10,11,27,45,-18,19
Silkeborg IF,8875,11,5,3,14,26,47,-21,18
Brondby,8876,1,21,5,4,71,34,37,68
FC Midtjylla,8876,2,20,6,4,73,40,33,66
FC Nords,8876,3,15,7,8,81,54,27,52
Copenhagen,8876,4,13,5,12,59,49,10,44
AaB,8876,5,6,14,10,39,46,-7,32
AC Horsens,8876,6,6,13,11,34,60,-26,31
Sonderjyske,8876,7,8,6,10,28,29,-1,30
Lyngby,8876,8,4,9,11,28,45,-17,21
Randers FC,8876,9,5,6,13,24,41,-17,21
AGF Aarhus,8876,10,5,6,11,18,36,-18,21
Silkeborg IF,8876,11,5,3,14,25,46,-21,18
Brondby,8877,1,21,6,3,71,29,42,69
FC Midtjylla,8877,2,21,4,5,69,40,29,67
FC Nords,8877,3,13,6,11,70,54,16,45
Copenhagen,8877,4,13,5,12,58,48,10,44
AC Horsens,8877,5,8,12,10,36,54,-18,36
AaB,8877,6,8,11,11,40,45,-5,35
Sonderjyske,8877,7,8,6,10,28,29,-1,30
Lyngby,8877,8,4,9,11,27,44,-17,21
Randers FC,8877,9,5,6,13,23,40,-17,21
AGF Aarhus,8877,10,5,6,11,18,37,-19,21
Silkeborg IF,8877,11,5,3,14,26,46,-20,18
Brondby,8878,1,19,7,4,69,36,33,64
FC Midtjylla,8878,2,19,6,5,66,42,24,63
FC Nords,8878,3,15,8,7,73,46,27,53
Copenhagen,8878,4,13,7,10,58,43,15,46
AaB,8878,5,7,15,8,41,42,-1,36
Sonderjyske,8878,6,8,6,10,28,29,-1,30
AC Horsens,8878,7,5,13,12,33,57,-24,28
Lyngby,8878,8,4,9,11,28,44,-16,21
Randers FC,8878,9,5,6,13,23,41,-18,21
AGF Aarhus,8878,10,5,6,11,17,36,-19,21
Silkeborg IF,8878,11,5,3,14,25,45,-20,18
Brondby,8879,1,20,6,4,75,37,38,66
FC Midtjylla,8879,2,19,5,6,66,43,23,62
FC Nords,8879,3,14,7,9,72,51,21,49
Copenhagen,8879,4,13,6,11,56,47,9,45
AC Horsens,8879,5,7,14,9,40,53,-13,35
AaB,8879,6,6,16,8,37,41,-4,34
Sonderjyske,8879,7,8,6,10,28,29,-1,30
Randers FC,8879,8,5,7,12,25,41,-16,22
Silkeborg IF,8879,9,6,3,13,28,46,-18,21
Lyngby,8879,10,3,10,11,28,46,-18,19
AGF Aarhus,8879,11,4,6,12,18,39,-21,18
Brondby,8880,1,21,5,4,72,33,39,68
FC Midtjylla,8880,2,18,5,7,62,42,20,59
FC Nords,8880,3,15,7,8,71,49,22,52
AaB,8880,4,11,11,8,43,38,5,44
Copenhagen,8880,5,13,4,13,58,50,8,43
Sonderjyske,8880,6,8,6,10,28,29,-1,30
AC Horsens,8880,7,6,12,12,35,55,-20,30
Randers FC,8880,8,6,6,12,24,39,-15,24
Silkeborg IF,8880,9,5,4,13,27,46,-19,19
AGF Aarhus,8880,10,4,7,11,18,38,-20,19
Lyngby,8880,11,3,9,12,26,45,-19,18
FC Midtjylla,8881,1,20,6,4,64,36,28,66
Brondby,8881,2,20,5,5,70,34,36,65
FC Nords,8881,3,13,9,8,74,53,21,48
Copenhagen,8881,4,14,5,11,59,44,15,47
AC Horsens,8881,5,8,12,10,36,51,-15,36
AaB,8881,6,6,13,11,34,45,-11,31
Sonderjyske,8881,7,8,6,10,28,29,-1,30
Randers FC,8881,8,5,7,12,25,41,-16,22
Silkeborg IF,8881,9,6,3,13,29,45,-16,21
Lyngby,8881,10,3,10,11,28,46,-18,19
AGF Aarhus,8881,11,4,6,12,17,40,-23,18
Brondby,8882,1,20,6,4,69,34,35,66
FC Midtjylla,8882,2,20,6,4,65,36,29,66
FC Nords,8882,3,14,6,10,74,55,19,48
Copenhagen,8882,4,14,5,11,59,46,13,47
AaB,8882,5,7,13,10,35,41,-6,34
AC Horsens,8882,6,6,14,10,35,51,-16,32
Sonderjyske,8882,7,8,6,10,28,29,-1,30
Randers FC,8882,8,5,7,12,25,41,-16,22
Lyngby,8882,9,3,10,11,28,46,-18,19
Silkeborg IF,8882,10,5,4,13,29,48,-19,19
AGF Aarhus,8882,11,4,7,11,20,40,-20,19
Brondby,8883,1,22,5,3,70,29,41,71
FC Midtjylla,8883,2,20,4,6,73,40,33,64
FC Nords,8883,3,14,6,10,69,56,13,48
Copenhagen,8883,4,14,4,12,58,46,12,46
AaB,8883,5,8,12,10,36,42,-6,36
AC Horsens,8883,6,6,13,11,36,55,-19,31
Sonderjyske,8883,7,8,6,10,28,29,-1,30
Randers FC,8883,8,6,6,12,24,39,-15,24
AGF Aarhus,8883,9,5,6,11,17,36,-19,21
Lyngby,8883,10,3,9,12,26,45,-19,18
Silkeborg IF,8883,11,5,3,14,25,45,-20,18
FC Midtjylla,8884,1,21,4,5,73,40,33,67
Brondby,8884,2,20,5,5,69,35,34,65
Copenhagen,8884,3,15,4,11,63,49,14,49
FC Nords,8884,4,13,7,10,73,57,16,46
AaB,8884,5,8,12,10,42,49,-7,36
AC Horsens,8884,6,6,14,10,39,55,-16,32
Sonderjyske,8884,7,8,6,10,28,29,-1,30
Lyngby,8884,8,4,9,11,29,46,-17,21
Randers FC,8884,9,5,6,13,25,42,-17,21
Silkeborg IF,8884,10,5,4,13,25,44,-19,19
AGF Aarhus,8884,11,4,7,11,16,36,-20,19
Brondby,8885,1,20,6,4,67,33,34,66
FC Midtjylla,8885,2,19,5,6,66,40,26,62
Copenhagen,8885,3,16,4,10,61,41,20,52
FC Nords,8885,4,13,7,10,72,55,17,46
AaB,8885,5,8,11,11,37,44,-7,35
AC Horsens,8885,6,7,13,10,37,53,-16,34
Sonderjyske,8885,7,8,6,10,28,29,-1,30
Randers FC,8885,8,6,6,12,26,41,-15,24
AGF Aarhus,8885,9,5,6,11,20,38,-18,21
Lyngby,8885,10,3,9,12,28,47,-19,18
Silkeborg IF,8885,11,5,3,14,27,48,-21,18
Brondby,8886,1,20,6,4,73,37,36,66
FC Midtjylla,8886,2,19,4,7,70,46,24,61
FC Nords,8886,3,14,6,10,78,56,22,48
Copenhagen,8886,4,14,5,11,62,52,10,47
AaB,8886,5,10,11,9,39,39,0,41
AC Horsens,8886,6,7,12,11,36,54,-18,33
Sonderjyske,8886,7,8,6,10,28,29,-1,30
Randers FC,8886,8,6,6,12,25,40,-15,24
AGF Aarhus,8886,9,5,6,11,19,36,-17,21
Lyngby,8886,10,3,9,12,27,46,-19,18
Silkeborg IF,8886,11,5,3,14,25,47,-22,18
Brondby,8887,1,20,7,3,70,34,36,67
FC Midtjylla,8887,2,18,8,4,65,39,26,62
FC Nords,8887,3,14,9,7,73,48,25,51
Copenhagen,8887,4,12,5,13,54,49,5,41
AC Horsens,8887,5,8,12,10,39,50,-11,36
AaB,8887,6,7,13,10,36,43,-7,34
Sonderjyske,8887,7,8,6,10,28,29,-1,30
Lyngby,8887,8,4,9,11,29,46,-17,21
Randers FC,8887,9,5,6,13,25,42,-17,21
Silkeborg IF,8887,10,6,3,13,26,44,-18,21
AGF Aarhus,8887,11,4,6,12,16,37,-21,18
Brondby,8888,1,23,5,2,74,32,42,74
FC Midtjylla,8888,2,18,4,8,63,44,19,58
FC Nords,8888,3,15,6,9,72,46,26,51
Copenhagen,8888,4,14,4,12,55,43,12,46
AaB,8888,5,8,11,11,36,45,-9,35
AC Horsens,8888,6,7,12,11,39,55,-16,33
Sonderjyske,8888,7,8,6,10,28,29,-1,30
Silkeborg IF,8888,8,6,3,13,28,44,-16,21
Lyngby,8888,9,4,9,11,27,44,-17,21
Randers FC,8888,10,5,6,13,23,40,-17,21
AGF Aarhus,8888,11,4,6,12,16,39,-23,18
Brondby,8889,1,22,6,2,74,31,43,72
FC Midtjylla,8889,2,18,5,7,65,43,22,59
FC Nords,8889,3,16,6,8,74,47,27,54
Copenhagen,8889,4,13,6,11,58,45,13,45
AaB,8889,5,7,12,11,34,44,-10,33
Sonderjyske,8889,6,8,6,10,28,29,-1,30
AC Horsens,8889,7,5,15,10,33,54,-21,30
Randers FC,8889,8,6,6,12,26,40,-14,24
AGF Aarhus,8889,9,5,6,11,19,37,-18,21
Lyngby,8889,10,3,9,12,27,47,-20,18
Silkeborg IF,8889,11,5,3,14,26,47,-21,18
Brondby,8890,1,20,6,4,74,39,35,66
FC Midtjylla,8890,2,18,6,6,63,41,22,60
FC Nords,8890,3,15,6,9,79,55,24,51
Copenhagen,8890,4,14,6,10,58,44,14,48
AaB,8890,5,9,12,9,42,42,0,39
Sonderjyske,8890,6,8,6,10,28,29,-1,30
AC Horsens,8890,7,5,14,11,33,54,-21,29
Lyngby,8890,8,4,9,11,27,44,-17,21
Randers FC,8890,9,5,6,13,23,40,-17,21
Silkeborg IF,8890,10,6,3,13,27,45,-18,21
AGF Aarhus,8890,11,4,6,12,17,38,-21,18
Brondby,8891,1,20,5,5,68,33,35,65
FC Midtjylla,8891,2,19,6,5,65,40,25,63
FC Nords,8891,3,14,8,8,77,53,24,50
Copenhagen,8891,4,14,5,11,58,49,9,47
AC Horsens,8891,5,7,14,9,38,51,-13,35
AaB,8891,6,7,12,11,42,48,-6,33
Sonderjyske,8891,7,8,6,10,28,29,-1,30
Randers FC,8891,8,6,6,12,27,39,-12,24
Silkeborg IF,8891,9,6,3,13,28,46,-18,21
AGF Aarhus,8891,10,4,6,12,18,39,-21,18
Lyngby,8891,11,3,9,12,26,48,-22,18
FC Midtjylla,8892,1,21,4,5,72,39,33,67
Brondby,8892,2,19,7,4,68,37,31,64
FC Nords,8892,3,15,6,9,70,48,22,51
Copenhagen,8892,4,14,5,11,57,45,12,47
AaB,8892,5,7,13,10,38,44,-6,34
AC Horsens,8892,6,6,13,11,31,49,-18,31
Sonderjyske,8892,7,8,6,10,28,29,-1,30
Randers FC,8892,8,6,6,12,25,40,-15,24
AGF Aarhus,8892,9,5,6,11,17,36,-19,21
Lyngby,8892,10,3,9,12,27,46,-19,18
Silkeborg IF,8892,11,5,3,14,25,45,-20,18
Brondby,8893,1,21,6,3,72,32,40,69
FC Midtjylla,8893,2,18,7,5,65,42,23,61
FC Nords,8893,3,13,8,9,72,52,20,47
Copenhagen,8893,4,13,6,11,58,46,12,45
AaB,8893,5,8,13,9,38,42,-4,37
AC Horsens,8893,6,6,14,10,34,51,-17,32
Sonderjyske,8893,7,8,6,10,28,29,-1,30
Lyngby,8893,8,4,9,11,28,44,-16,21
Randers FC,8893,9,5,6,13,23,41,-18,21
Silkeborg IF,8893,10,5,4,13,25,44,-19,19
AGF Aarhus,8893,11,4,7,11,16,36,-20,19
Brondby,8894,1,22,6,2,76,32,44,72
FC Midtjylla,8894,2,19,7,4,70,43,27,64
FC Nords,8894,3,13,8,9,72,56,16,47
Copenhagen,8894,4,12,5,13,55,49,6,41
AaB,8894,5,7,14,9,38,42,-4,35
AC Horsens,8894,6,6,14,10,39,54,-15,32
Sonderjyske,8894,7,8,6,10,28,29,-1,30
Randers FC,8894,8,5,7,12,24,40,-16,22
Lyngby,8894,9,3,10,11,27,45,-18,19
Silkeborg IF,8894,10,5,4,13,26,45,-19,19
AGF Aarhus,8894,11,4,7,11,17,37,-20,19
Brondby,8895,1,21,7,2,71,32,39,70
FC Midtjylla,8895,2,18,5,7,64,43,21,59
FC Nords,8895,3,15,6,9,72,49,23,51
Copenhagen,8895,4,15,5,10,57,39,18,50
AaB,8895,5,8,11,11,37,44,-7,35
Sonderjyske,8895,6,8,6,10,28,29,-1,30
AC Horsens,8895,7,5,14,11,35,55,-20,29
Randers FC,8895,8,5,7,12,24,40,-16,22
Silkeborg IF,8895,9,6,3,13,30,44,-14,21
Lyngby,8895,10,3,10,11,27,45,-18,19
AGF Aarhus,8895,11,4,6,12,16,41,-25,18
Brondby,8896,1,20,6,4,70,34,36,66
FC Midtjylla,8896,2,19,5,6,66,40,26,62
Copenhagen,8896,3,15,4,11,62,49,13,49
FC Nords,8896,4,13,9,8,72,51,21,48
AaB,8896,5,8,12,10,40,43,-3,36
AC Horsens,8896,6,7,12,11,36,55,-19,33
Sonderjyske,8896,7,8,6,10,28,29,-1,30
Lyngby,8896,8,4,9,11,28,45,-17,21
Silkeborg IF,8896,8,6,3,13,28,45,-17,21
Randers FC,8896,10,5,6,13,24,41,-17,21
AGF Aarhus,8896,11,4,6,12,17,39,-22,18
Brondby,8897,1,20,6,4,69,31,38,66
FC Midtjylla,8897,2,19,6,5,69,44,25,63
FC Nords,8897,3,13,8,9,74,54,20,47
Copenhagen,8897,4,13,6,11,59,50,9,45
AaB,8897,5,9,12,9,45,42,3,39
AC Horsens,8897,6,7,12,11,42,63,-21,33
Sonderjyske,8897,7,8,6,10,28,29,-1,30
Randers FC,8897,8,6,6,12,25,40,-15,24
Silkeborg IF,8897,9,5,4,13,26,45,-19,19
AGF Aarhus,8897,10,4,7,11,17,37,-20,19
Lyngby,8897,11,3,9,12,27,46,-19,18
Brondby,8898,1,20,7,3,72,35,37,67
FC Midtjylla,8898,2,20,5,5,72,39,33,65
FC Nords,8898,3,14,8,8,72,50,22,50
Copenhagen,8898,4,13,7,10,57,47,10,46
AaB,8898,5,8,13,9,37,40,-3,37
Sonderjyske,8898,6,8,6,10,28,29,-1,30
AC Horsens,8898,7,5,12,13,32,57,-25,27
Silkeborg IF,8898,8,6,3,13,28,44,-16,21
Lyngby,8898,9,4,9,11,27,44,-17,21
Randers FC,8898,10,5,6,13,23,40,-17,21
AGF Aarhus,8898,11,4,6,12,16,39,-23,18
Brondby,8899,1,22,5,3,71,30,41,71
FC Midtjylla,8899,2,21,4,5,71,37,34,67
FC Nords,8899,3,16,6,8,76,51,25,54
Copenhagen,8899,4,13,4,13,53,46,7,43
AC Horsens,8899,5,6,13,11,33,56,-23,31
Sonderjyske,8899,6,8,6,10,28,29,-1,30
AaB,8899,7,6,12,12,34,44,-10,30
Lyngby,8899,8,4,9,11,30,44,-14,21
Silkeborg IF,8899,9,6,3,13,29,45,-16,21
Randers FC,8899,10,5,6,13,23,43,-20,21
AGF Aarhus,8899,11,4,6,12,17,40,-23,18
Brondby,8900,1,22,6,2,82,30,52,72
FC Midtjylla,8900,2,20,5,5,72,45,27,65
FC Nords,8900,3,15,6,9,70,51,19,51
Copenhagen,8900,4,13,5,12,56,47,9,44
AaB,8900,5,7,13,10,39,44,-5,34
Sonderjyske,8900,6,8,6,10,28,29,-1,30
AC Horsens,8900,7,5,13,12,31,59,-28,28
Randers FC,8900,8,6,6,12,25,39,-14,24
Silkeborg IF,8900,9,6,3,13,28,46,-18,21
Lyngby,8900,10,3,9,12,26,46,-20,18
AGF Aarhus,8900,11,4,6,12,18,39,-21,18
Brondby,8901,1,19,8,3,65,29,36,65
FC Midtjylla,8901,2,18,6,6,60,40,20,60
FC Nords,8901,3,15,7,8,81,51,30,52
Copenhagen,8901,4,14,6,10,56,42,14,48
AaB,8901,5,7,13,10,39,43,-4,34
AC Horsens,8901,6,5,16,9,33,55,-22,31
Sonderjyske,8901,7,8,6,10,28,29,-1,30
Lyngby,8901,8,4,9,11,27,44,-17,21
Randers FC,8901,9,5,6,13,23,40,-17,21
Silkeborg IF,8901,10,5,4,13,27,46,-19,19
AGF Aarhus,8901,11,4,7,11,18,38,-20,19
Brondby,8902,1,19,7,4,67,34,33,64
FC Midtjylla,8902,2,20,4,6,67,40,27,64
FC Nords,8902,3,14,8,8,73,51,22,50
Copenhagen,8902,4,15,4,11,58,43,15,49
AaB,8902,5,7,13,10,37,43,-6,34
AC Horsens,8902,6,7,12,11,36,53,-17,33
Sonderjyske,8902,7,8,6,10,28,29,-1,30
Lyngby,8902,8,4,9,11,29,44,-15,21
Randers FC,8902,9,5,6,13,23,42,-19,21
Silkeborg IF,8902,10,5,4,13,26,45,-19,19
AGF Aarhus,8902,11,4,7,11,17,37,-20,19
Brondby,8903,1,21,5,4,75,38,37,68
FC Midtjylla,8903,2,19,4,7,63,41,22,61
FC Nords,8903,3,16,7,7,78,49,29,55
Copenhagen,8903,4,16,4,10,67,45,22,52
AaB,8903,5,7,12,11,34,43,-9,33
Sonderjyske,8903,6,8,6,10,28,29,-1,30
AC Horsens,8903,7,5,12,13,36,63,-27,27
Lyngby,8903,8,4,9,11,30,47,-17,21
Randers FC,8903,9,5,6,13,26,43,-17,21
AGF Aarhus,8903,10,5,6,11,18,37,-19,21
Silkeborg IF,8903,11,5,3,14,26,46,-20,18
Brondby,8904,1,21,6,3,74,33,41,69
FC Midtjylla,8904,2,21,4,5,71,45,26,67
FC Nords,8904,3,14,7,9,75,55,20,49
Copenhagen,8904,4,13,5,12,55,45,10,44
AaB,8904,5,8,12,10,36,41,-5,36
Sonderjyske,8904,6,8,6,10,28,29,-1,30
AC Horsens,8904,7,6,12,12,36,54,-18,30
Randers FC,8904,8,6,6,12,24,39,-15,24
AGF Aarhus,8904,9,5,6,11,20,37,-17,21
Lyngby,8904,10,3,9,12,26,45,-19,18
Silkeborg IF,8904,11,5,3,14,26,48,-22,18
Brondby,8905,1,19,8,3,67,29,38,65
FC Midtjylla,8905,2,20,5,5,68,40,28,65
Copenhagen,8905,3,14,7,9,58,42,16,49
FC Nords,8905,4,12,10,8,69,52,17,46
AaB,8905,5,6,15,9,34,42,-8,33
Sonderjyske,8905,6,8,6,10,28,29,-1,30
AC Horsens,8905,7,5,15,10,34,51,-17,30
Randers FC,8905,8,6,6,12,26,40,-14,24
Silkeborg IF,8905,9,6,3,13,26,44,-18,21
Lyngby,8905,10,3,9,12,27,47,-20,18
AGF Aarhus,8905,11,4,6,12,16,37,-21,18
Brondby,8906,1,22,5,3,68,29,39,71
FC Midtjylla,8906,2,18,5,7,62,40,22,59
FC Nords,8906,3,15,7,8,74,49,25,52
Copenhagen,8906,4,14,5,11,56,43,13,47
AaB,8906,5,8,11,11,36,43,-7,35
Sonderjyske,8906,6,8,6,10,28,29,-1,30
AC Horsens,8906,7,5,15,10,34,52,-18,30
Randers FC,8906,8,5,7,12,23,39,-16,22
Silkeborg IF,8906,9,6,3,13,28,46,-18,21
Lyngby,8906,10,3,10,11,26,44,-18,19
AGF Aarhus,8906,11,4,6,12,18,39,-21,18
FC Midtjylla,8907,1,21,5,4,67,37,30,68
Brondby,8907,2,20,6,4,69,35,34,66
FC Nords,8907,3,15,7,8,74,49,25,52
Copenhagen,8907,4,14,4,12,59,45,14,46
AaB,8907,5,7,13,10,37,43,-6,34
Sonderjyske,8907,6,8,6,10,28,29,-1,30
AC Horsens,8907,7,5,13,12,31,54,-23,28
Randers FC,8907,8,5,7,12,24,40,-16,22
Silkeborg IF,8907,9,6,3,13,26,44,-18,21
Lyngby,8907,10,3,10,11,27,45,-18,19
AGF Aarhus,8907,11,4,6,12,16,37,-21,18
Brondby,8908,1,18,6,6,64,37,27,60
FC Midtjylla,8908,2,18,6,6,60,39,21,60
FC Nords,8908,3,15,7,8,72,48,24,52
Copenhagen,8908,4,14,5,11,58,43,15,47
AaB,8908,5,9,12,9,38,37,1,39
AC Horsens,8908,6,8,12,10,40,54,-14,36
Sonderjyske,8908,7,8,6,10,28,29,-1,30
Silkeborg IF,8908,8,6,3,13,29,45,-16,21
Lyngby,8908,9,4,9,11,28,44,-16,21
Randers FC,8908,10,5,6,13,23,41,-18,21
AGF Aarhus,8908,11,4,6,12,17,40,-23,18
Brondby,8909,1,21,6,3,74,34,40,69
FC Midtjylla,8909,2,20,5,5,68,39,29,65
FC Nords,8909,3,13,6,11,70,54,16,45
Copenhagen,8909,4,12,5,13,57,55,2,41
AC Horsens,8909,5,8,14,8,39,49,-10,38
AaB,8909,6,8,12,10,40,43,-3,36
Sonderjyske,8909,7,8,6,10,28,29,-1,30
Lyngby,8909,8,4,9,11,30,46,-16,21
Silkeborg IF,8909,9,6,3,13,26,44,-18,21
Randers FC,8909,10,5,6,13,25,43,-18,21
AGF Aarhus,8909,11,4,6,12,16,37,-21,18
Brondby,8910,1,22,5,3,73,29,44,71
FC Midtjylla,8910,2,18,5,7,61,40,21,59
Copenhagen,8910,3,15,5,10,58,43,15,50
FC Nords,8910,4,14,7,9,72,49,23,49
AC Horsens,8910,5,7,14,9,32,48,-16,35
Sonderjyske,8910,6,8,6,10,28,29,-1,30
AaB,8910,7,6,12,12,34,47,-13,30
Lyngby,8910,8,4,9,11,27,44,-17,21
Silkeborg IF,8910,8,6,3,13,27,44,-17,21
Randers FC,8910,10,5,6,13,23,40,-17,21
AGF Aarhus,8910,11,4,6,12,16,38,-22,18
FC Midtjylla,8911,1,21,5,4,70,41,29,68
Brondby,8911,2,20,6,4,68,30,38,66
FC Nords,8911,3,15,7,8,72,49,23,52
Copenhagen,8911,4,13,5,12,58,47,11,44
AaB,8911,5,7,12,11,35,43,-8,33
AC Horsens,8911,6,6,13,11,35,54,-19,31
Sonderjyske,8911,7,8,6,10,28,29,-1,30
Lyngby,8911,8,4,9,11,29,46,-17,21
Randers FC,8911,9,5,6,13,25,42,-17,21
AGF Aarhus,8911,10,5,6,11,19,37,-18,21
Silkeborg IF,8911,11,5,3,14,26,47,-21,18
FC Midtjylla,8912,1,20,6,4,68,38,30,66
Brondby,8912,2,19,7,4,71,37,34,64
FC Nords,8912,3,14,7,9,72,53,19,49
Copenhagen,8912,4,14,4,12,59,47,12,46
AaB,8912,5,9,11,10,40,41,-1,38
AC Horsens,8912,6,6,13,11,36,56,-20,31
Sonderjyske,8912,7,8,6,10,28,29,-1,30
Lyngby,8912,8,4,9,11,30,44,-14,21
Silkeborg IF,8912,9,6,3,13,27,44,-17,21
Randers FC,8912,10,5,6,13,23,43,-20,21
AGF Aarhus,8912,11,4,6,12,16,38,-22,18
Brondby,8913,1,21,5,4,71,35,36,68
FC Midtjylla,8913,2,19,5,6,64,39,25,62
FC Nords,8913,3,15,6,9,73,50,23,51
Copenhagen,8913,4,14,4,12,55,43,12,46
AC Horsens,8913,5,8,12,10,39,52,-13,36
AaB,8913,6,7,12,11,32,41,-9,33
Sonderjyske,8913,7,8,6,10,28,29,-1,30
Randers FC,8913,8,5,7,12,24,40,-16,22
Silkeborg IF,8913,9,6,3,13,26,44,-18,21
Lyngby,8913,10,3,10,11,27,45,-18,19
AGF Aarhus,8913,11,4,6,12,16,37,-21,18
Brondby,8914,1,19,6,5,69,33,36,63
FC Midtjylla,8914,2,18,5,7,61,40,21,59
FC Nords,8914,3,15,6,9,78,53,25,51
Copenhagen,8914,4,14,5,11,56,43,13,47
AaB,8914,5,10,11,9,41,46,-5,41
AC Horsens,8914,6,6,15,9,35,51,-16,33
Sonderjyske,8914,7,8,6,10,28,29,-1,30
Randers FC,8914,8,5,7,12,26,42,-16,22
AGF Aarhus,8914,9,5,6,11,17,36,-19,21
Lyngby,8914,10,3,10,11,29,47,-18,19
Silkeborg IF,8914,11,5,3,14,25,45,-20,18
Brondby,8915,1,22,5,3,74,31,43,71
FC Midtjylla,8915,2,19,4,7,67,41,26,61
Copenhagen,8915,3,14,4,12,57,49,8,46
FC Nords,8915,4,13,6,11,69,54,15,45
AaB,8915,5,9,11,10,39,43,-4,38
AC Horsens,8915,6,8,12,10,33,47,-14,36
Sonderjyske,8915,7,8,6,10,28,29,-1,30
Lyngby,8915,8,4,9,11,27,44,-17,21
Randers FC,8915,9,5,6,13,23,40,-17,21
Silkeborg IF,8915,10,5,4,13,26,45,-19,19
AGF Aarhus,8915,11,4,7,11,17,37,-20,19
Brondby,8916,1,20,8,2,70,32,38,68
FC Midtjylla,8916,2,19,6,5,69,41,28,63
FC Nords,8916,3,15,6,9,75,53,22,51
Copenhagen,8916,4,13,5,12,58,46,12,44
AaB,8916,5,8,12,10,34,42,-8,36
Sonderjyske,8916,6,8,6,10,28,29,-1,30
AC Horsens,8916,7,5,15,10,34,52,-18,30
Randers FC,8916,8,5,7,12,24,40,-16,22
AGF Aarhus,8916,9,5,6,11,17,36,-19,21
Lyngby,8916,10,3,10,11,27,45,-18,19
Silkeborg IF,8916,11,5,3,14,25,45,-20,18
Brondby,8917,1,22,5,3,70,31,39,71
FC Midtjylla,8917,2,19,6,5,63,36,27,63
FC Nords,8917,3,14,7,9,72,51,21,49
Copenhagen,8917,4,13,5,12,56,46,10,44
AaB,8917,5,7,12,11,34,42,-8,33
AC Horsens,8917,6,6,15,9,34,49,-15,33
Sonderjyske,8917,7,8,6,10,28,29,-1,30
Randers FC,8917,8,5,7,12,24,40,-16,22
Silkeborg IF,8917,9,6,3,13,27,45,-18,21
Lyngby,8917,10,3,10,11,27,45,-18,19
AGF Aarhus,8917,11,4,6,12,17,38,-21,18
FC Midtjylla,8918,1,21,5,4,66,35,31,68
Brondby,8918,2,20,5,5,68,32,36,65
FC Nords,8918,3,13,8,9,75,54,21,47
Copenhagen,8918,4,14,4,12,62,49,13,46
AaB,8918,5,8,12,10,38,47,-9,36
AC Horsens,8918,6,6,14,10,34,52,-18,32
Sonderjyske,8918,7,8,6,10,28,29,-1,30
Randers FC,8918,8,6,6,12,27,40,-13,24
Silkeborg IF,8918,9,6,3,13,29,44,-15,21
Lyngby,8918,10,3,9,12,27,48,-21,18
AGF Aarhus,8918,11,4,6,12,16,40,-24,18
Brondby,8919,1,21,6,3,71,31,40,69
FC Midtjylla,8919,2,19,6,5,71,48,23,63
FC Nords,8919,3,14,6,10,72,53,19,48
Copenhagen,8919,4,14,5,11,59,47,12,47
AaB,8919,5,8,12,10,42,43,-1,36
AC Horsens,8919,6,6,13,11,36,55,-19,31
Sonderjyske,8919,7,8,6,10,28,29,-1,30
Randers FC,8919,8,6,6,12,25,40,-15,24
Silkeborg IF,8919,9,5,4,13,25,44,-19,19
AGF Aarhus,8919,10,4,7,11,16,36,-20,19
Lyngby,8919,11,3,9,12,27,46,-19,18
Brondby,8920,1,20,7,3,74,36,38,67
FC Midtjylla,8920,2,20,5,5,68,38,30,65
FC Nords,8920,3,15,6,9,77,53,24,51
Copenhagen,8920,4,13,5,12,57,48,9,44
AaB,8920,5,8,11,11,34,42,-8,35
AC Horsens,8920,6,7,12,11,36,55,-19,33
Sonderjyske,8920,7,8,6,10,28,29,-1,30
Randers FC,8920,8,5,7,12,24,40,-16,22
AGF Aarhus,8920,9,5,6,11,20,39,-19,21
Lyngby,8920,10,3,10,11,27,45,-18,19
Silkeborg IF,8920,11,5,3,14,28,48,-20,18
Brondby,8921,1,21,7,2,69,31,38,70
FC Midtjylla,8921,2,18,5,7,63,38,25,59
FC Nords,8921,3,15,6,9,72,49,23,51
Copenhagen,8921,4,15,4,11,60,43,17,49
AaB,8921,5,8,13,9,40,43,-3,37
Sonderjyske,8921,6,8,6,10,28,29,-1,30
AC Horsens,8921,7,5,13,12,34,60,-26,28
Lyngby,8921,8,4,9,11,27,44,-17,21
Randers FC,8921,9,5,6,13,23,40,-17,21
Silkeborg IF,8921,10,6,3,13,26,44,-18,21
AGF Aarhus,8921,11,4,6,12,16,37,-21,18
Brondby,8922,1,20,6,4,75,39,36,66
FC Midtjylla,8922,2,18,7,5,64,41,23,61
FC Nords,8922,3,15,6,9,80,56,24,51
Copenhagen,8922,4,14,5,11,58,44,14,47
AC Horsens,8922,5,7,14,9,36,49,-13,35
AaB,8922,6,7,12,11,36,46,-10,33
Sonderjyske,8922,7,8,6,10,28,29,-1,30
Randers FC,8922,8,6,6,12,25,40,-15,24
Silkeborg IF,8922,9,6,3,13,27,45,-18,21
Lyngby,8922,10,3,9,12,27,46,-19,18
AGF Aarhus,8922,11,4,6,12,17,38,-21,18
FC Midtjylla,8923,1,22,4,4,68,36,32,70
Brondby,8923,2,21,5,4,72,33,39,68
FC Nords,8923,3,15,6,9,77,52,25,51
Copenhagen,8923,4,12,4,14,57,51,6,40
AC Horsens,8923,5,7,13,10,32,49,-17,34
AaB,8923,6,7,12,11,37,48,-11,33
Sonderjyske,8923,7,8,6,10,28,29,-1,30
Lyngby,8923,8,4,9,11,28,45,-17,21
Randers FC,8923,9,5,6,13,24,41,-17,21
Silkeborg IF,8923,10,5,4,13,26,45,-19,19
AGF Aarhus,8923,11,4,7,11,17,37,-20,19
Brondby,8924,1,21,7,2,74,30,44,70
FC Midtjylla,8924,2,21,5,4,65,35,30,68
FC Nords,8924,3,15,6,9,73,48,25,51
Copenhagen,8924,4,12,6,12,54,45,9,42
AC Horsens,8924,5,7,12,11,33,56,-23,33
Sonderjyske,8924,6,8,6,10,28,29,-1,30
AaB,8924,7,6,12,12,36,47,-11,30
Lyngby,8924,8,4,9,11,31,45,-14,21
Silkeborg IF,8924,9,6,3,13,29,45,-16,21
Randers FC,8924,10,5,6,13,24,44,-20,21
AGF Aarhus,8924,11,4,6,12,17,40,-23,18
Brondby,8925,1,19,6,5,70,36,34,63
FC Midtjylla,8925,2,19,6,5,67,41,26,63
FC Nords,8925,3,15,7,8,81,55,26,52
Copenhagen,8925,4,15,4,11,58,43,15,49
AaB,8925,5,9,11,10,38,44,-6,38
Sonderjyske,8925,6,8,6,10,28,29,-1,30
AC Horsens,8925,7,6,12,12,33,54,-21,30
Randers FC,8925,8,5,7,12,23,39,-16,22
Silkeborg IF,8925,9,6,3,13,28,44,-16,21
Lyngby,8925,10,3,10,11,26,44,-18,19
AGF Aarhus,8925,11,4,6,12,16,39,-23,18
Brondby,8926,1,20,6,4,70,33,37,66
FC Midtjylla,8926,2,20,4,6,65,38,27,64
FC Nords,8926,3,14,6,10,74,53,21,48
Copenhagen,8926,4,14,5,11,57,47,10,47
AC Horsens,8926,5,8,12,10,40,53,-13,36
AaB,8926,6,7,13,10,36,44,-8,34
Sonderjyske,8926,7,8,6,10,28,29,-1,30
Randers FC,8926,8,6,6,12,25,39,-14,24
Silkeborg IF,8926,9,6,3,13,26,44,-18,21
Lyngby,8926,10,3,9,12,26,46,-20,18
AGF Aarhus,8926,11,4,6,12,16,37,-21,18
Brondby,8927,1,21,6,3,72,32,40,69
FC Midtjylla,8927,2,19,6,5,64,39,25,63
FC Nords,8927,3,14,8,8,78,53,25,50
Copenhagen,8927,4,14,5,11,58,48,10,47
AaB,8927,5,7,13,10,36,44,-8,34
Sonderjyske,8927,6,8,6,10,28,29,-1,30
AC Horsens,8927,7,6,12,12,35,53,-18,30
Lyngby,8927,8,4,9,11,28,44,-16,21
Randers FC,8927,9,5,6,13,23,41,-18,21
AGF Aarhus,8927,10,5,6,11,18,37,-19,21
Silkeborg IF,8927,11,5,3,14,26,46,-20,18
FC Midtjylla,8928,1,20,5,5,67,36,31,65
Brondby,8928,2,19,7,4,69,36,33,64
FC Nords,8928,3,13,8,9,69,50,19,47
Copenhagen,8928,4,13,4,13,55,46,9,43
AaB,8928,5,9,12,9,38,42,-4,39
AC Horsens,8928,6,7,14,9,36,50,-14,35
Sonderjyske,8928,7,8,6,10,28,29,-1,30
Randers FC,8928,8,6,6,12,24,39,-15,24
Silkeborg IF,8928,9,6,3,13,27,44,-17,21
Lyngby,8928,10,3,9,12,26,45,-19,18
AGF Aarhus,8928,11,4,6,12,16,38,-22,18
Brondby,8929,1,21,5,4,68,34,34,68
FC Midtjylla,8929,2,18,5,7,67,44,23,59
Copenhagen,8929,3,15,6,9,62,43,19,51
FC Nords,8929,4,13,7,10,70,53,17,46
AC Horsens,8929,5,7,14,9,38,51,-13,35
AaB,8929,6,7,13,10,36,42,-6,34
Sonderjyske,8929,7,8,6,10,28,29,-1,30
Randers FC,8929,8,5,7,12,24,40,-16,22
Lyngby,8929,9,3,10,11,27,45,-18,19
Silkeborg IF,8929,10,5,4,13,25,44,-19,19
AGF Aarhus,8929,11,4,7,11,16,36,-20,19
Brondby,8930,1,20,8,2,67,30,37,68
FC Midtjylla,8930,2,19,5,6,64,42,22,62
FC Nords,8930,3,15,7,8,82,49,33,52
Copenhagen,8930,4,12,6,12,54,48,6,42
AC Horsens,8930,5,7,14,9,35,53,-18,35
AaB,8930,6,6,14,10,34,40,-6,32
Sonderjyske,8930,7,8,6,10,28,29,-1,30
Lyngby,8930,8,4,9,11,29,45,-16,21
Randers FC,8930,9,5,6,13,24,42,-18,21
AGF Aarhus,8930,10,5,6,11,18,37,-19,21
Silkeborg IF,8930,11,5,3,14,26,46,-20,18
Brondby,8931,1,21,6,3,68,30,38,69
FC Midtjylla,8931,2,21,5,4,67,37,30,68
FC Nords,8931,3,14,8,8,68,47,21,50
Copenhagen,8931,4,14,4,12,57,46,11,46
AC Horsens,8931,5,7,12,11,37,52,-15,33
Sonderjyske,8931,6,8,6,10,28,29,-1,30
AaB,8931,7,6,11,13,34,45,-11,29
Lyngby,8931,8,4,9,11,28,44,-16,21
Silkeborg IF,8931,9,6,3,13,26,44,-18,21
Randers FC,8931,10,5,6,13,23,41,-18,21
AGF Aarhus,8931,11,4,6,12,16,37,-21,18
Brondby,8932,1,21,6,3,70,32,38,69
FC Midtjylla,8932,2,19,4,7,62,42,20,61
Copenhagen,8932,3,15,6,9,61,41,20,51
FC Nords,8932,4,13,7,10,75,54,21,46
AaB,8932,5,8,13,9,39,44,-5,37
Sonderjyske,8932,6,8,6,10,28,29,-1,30
AC Horsens,8932,7,6,12,12,32,52,-20,30
Silkeborg IF,8932,8,6,3,13,28,44,-16,21
Lyngby,8932,9,4,9,11,28,45,-17,21
Randers FC,8932,10,5,6,13,24,41,-17,21
AGF Aarhus,8932,11,4,6,12,16,39,-23,18
Brondby,8933,1,23,5,2,76,28,48,74
FC Midtjylla,8933,2,19,6,5,65,37,28,63
FC Nords,8933,3,14,7,9,71,53,18,49
Copenhagen,8933,4,14,5,11,57,45,12,47
AaB,8933,5,7,11,12,35,49,-14,32
Sonderjyske,8933,6,8,6,10,28,29,-1,30
AC Horsens,8933,7,6,12,12,37,55,-18,30
Lyngby,8933,8,4,9,11,29,44,-15,21
Randers FC,8933,9,5,6,13,23,42,-19,21
AGF Aarhus,8933,10,5,6,11,18,37,-19,21
Silkeborg IF,8933,11,5,3,14,26,46,-20,18
Brondby,8934,1,19,7,4,68,33,35,64
FC Midtjylla,8934,2,19,7,4,67,38,29,64
Copenhagen,8934,3,13,8,9,57,42,15,47
FC Nords,8934,4,13,7,10,68,55,13,46
AC Horsens,8934,5,7,14,9,36,47,-11,35
AaB,8934,6,7,13,10,36,43,-7,34
Sonderjyske,8934,7,8,6,10,28,29,-1,30
Lyngby,8934,8,4,9,11,30,44,-14,21
AGF Aarhus,8934,9,5,6,11,17,36,-19,21
Randers FC,8934,10,5,6,13,23,43,-20,21
Silkeborg IF,8934,11,5,3,14,25,45,-20,18
Brondby,8935,1,21,5,4,70,35,35,68
FC Midtjylla,8935,2,21,4,5,67,38,29,67
FC Nords,8935,3,14,7,9,73,54,19,49
Copenhagen,8935,4,13,4,13,58,47,11,43
AaB,8935,5,8,12,10,39,43,-4,36
AC Horsens,8935,6,7,12,11,39,55,-16,33
Sonderjyske,8935,7,8,6,10,28,29,-1,30
Silkeborg IF,8935,8,6,3,13,29,46,-17,21
Lyngby,8935,9,4,9,11,27,44,-17,21
Randers FC,8935,10,5,6,13,23,40,-17,21
AGF Aarhus,8935,11,4,6,12,18,40,-22,18
FC Midtjylla,8936,1,21,4,5,65,36,29,67
Brondby,8936,2,19,8,3,65,31,34,65
Copenhagen,8936,3,14,6,10,54,40,14,48
FC Nords,8936,4,13,8,9,73,51,22,47
AaB,8936,5,6,14,10,37,43,-6,32
AC Horsens,8936,6,6,14,10,34,53,-19,32
Sonderjyske,8936,7,8,6,10,28,29,-1,30
Randers FC,8936,8,6,6,12,25,40,-15,24
AGF Aarhus,8936,9,5,6,11,19,36,-17,21
Lyngby,8936,10,3,9,12,27,46,-19,18
Silkeborg IF,8936,11,5,3,14,25,47,-22,18
Brondby,8937,1,20,7,3,75,36,39,67
FC Midtjylla,8937,2,20,4,6,66,39,27,64
FC Nords,8937,3,15,6,9,76,52,24,51
Copenhagen,8937,4,15,4,11,62,48,14,49
AaB,8937,5,7,12,11,37,45,-8,33
AC Horsens,8937,6,6,13,11,35,57,-22,31
Sonderjyske,8937,7,8,6,10,28,29,-1,30
Randers FC,8937,8,5,7,12,23,39,-16,22
Lyngby,8937,9,3,10,11,26,44,-18,19
Silkeborg IF,8937,10,5,4,13,27,46,-19,19
AGF Aarhus,8937,11,4,7,11,18,38,-20,19
Brondby,8938,1,19,7,4,70,35,35,64
FC Midtjylla,8938,2,18,6,6,60,37,23,60
FC Nords,8938,3,14,8,8,71,49,22,50
Copenhagen,8938,4,15,4,11,59,46,13,49
AaB,8938,5,8,12,10,40,45,-5,36
AC Horsens,8938,6,7,13,10,38,52,-14,34
Sonderjyske,8938,7,8,6,10,28,29,-1,30
Randers FC,8938,8,6,6,12,26,40,-14,24
Silkeborg IF,8938,9,5,4,13,25,44,-19,19
AGF Aarhus,8938,10,4,7,11,16,36,-20,19
Lyngby,8938,11,3,9,12,27,47,-20,18
FC Midtjylla,8939,1,21,5,4,68,37,31,68
Brondby,8939,2,19,5,6,69,37,32,62
FC Nords,8939,3,15,8,7,75,47,28,53
Copenhagen,8939,4,14,5,11,60,49,11,47
AC Horsens,8939,5,7,13,10,37,53,-16,34
Sonderjyske,8939,6,8,6,10,28,29,-1,30
AaB,8939,7,6,12,12,34,46,-12,30
Lyngby,8939,8,4,9,11,28,44,-16,21
Silkeborg IF,8939,9,6,3,13,27,45,-18,21
Randers FC,8939,10,5,6,13,23,41,-18,21
AGF Aarhus,8939,11,4,6,12,17,38,-21,18
Brondby,8940,1,19,7,4,66,34,32,64
FC Midtjylla,8940,2,19,5,6,62,37,25,62
Copenhagen,8940,3,14,6,10,55,39,16,48
FC Nords,8940,4,12,8,10,68,53,15,44
AC Horsens,8940,5,8,14,8,36,48,-12,38
AaB,8940,6,7,14,9,36,38,-2,35
Sonderjyske,8940,7,8,6,10,28,29,-1,30
Lyngby,8940,8,4,9,11,29,45,-16,21
Silkeborg IF,8940,9,6,3,13,29,46,-17,21
Randers FC,8940,10,5,6,13,24,42,-18,21
AGF Aarhus,8940,11,4,6,12,18,40,-22,18
FC Midtjylla,8941,1,21,5,4,68,35,33,68
Brondby,8941,2,19,7,4,70,35,35,64
FC Nords,8941,3,12,10,8,73,54,19,46
Copenhagen,8941,4,13,7,10,56,42,14,46
AaB,8941,5,7,13,10,37,42,-5,34
AC Horsens,8941,6,6,14,10,33,55,-22,32
Sonderjyske,8941,7,8,6,10,28,29,-1,30
Randers FC,8941,8,5,7,12,23,39,-16,22
Silkeborg IF,8941,9,6,3,13,27,44,-17,21
Lyngby,8941,10,3,10,11,26,44,-18,19
AGF Aarhus,8941,11,4,6,12,16,38,-22,18
Brondby,8942,1,21,6,3,70,32,38,69
FC Midtjylla,8942,2,19,5,6,62,38,24,62
FC Nords,8942,3,14,8,8,72,49,23,50
Copenhagen,8942,4,13,6,11,55,43,12,45
AaB,8942,5,8,13,9,38,42,-4,37
Sonderjyske,8942,6,8,6,10,28,29,-1,30
AC Horsens,8942,7,6,12,12,34,53,-19,30
Lyngby,8942,8,4,9,11,29,44,-15,21
Randers FC,8942,9,5,6,13,23,42,-19,21
AGF Aarhus,8942,10,5,6,11,18,37,-19,21
Silkeborg IF,8942,11,5,3,14,26,46,-20,18
Brondby,8943,1,19,8,3,69,34,35,65
FC Midtjylla,8943,2,19,5,6,61,38,23,62
FC Nords,8943,3,16,7,7,77,46,31,55
Copenhagen,8943,4,14,4,12,58,48,10,46
AaB,8943,5,8,11,11,40,43,-3,35
AC Horsens,8943,6,6,13,11,32,54,-22,31
Sonderjyske,8943,7,8,6,10,28,29,-1,30
Lyngby,8943,8,4,9,11,27,44,-17,21
Randers FC,8943,9,5,6,13,23,40,-17,21
Silkeborg IF,8943,10,6,3,13,26,44,-18,21
AGF Aarhus,8943,11,4,6,12,16,37,-21,18
Brondby,8944,1,21,5,4,67,30,37,68
FC Midtjylla,8944,2,19,5,6,64,37,27,62
FC Nords,8944,3,14,7,9,75,49,26,49
Copenhagen,8944,4,14,6,10,57,42,15,48
AaB,8944,5,7,13,10,35,43,-8,34
AC Horsens,8944,6,6,14,10,33,56,-23,32
Sonderjyske,8944,7,8,6,10,28,29,-1,30
Lyngby,8944,8,4,9,11,30,44,-14,21
Silkeborg IF,8944,9,6,3,13,29,45,-16,21
Randers FC,8944,10,5,6,13,23,43,-20,21
AGF Aarhus,8944,11,4,6,12,17,40,-23,18
Brondby,8945,1,21,5,4,69,32,37,68
FC Midtjylla,8945,2,19,6,5,62,38,24,63
FC Nords,8945,3,14,7,9,72,51,21,49
Copenhagen,8945,4,14,6,10,58,43,15,48
AaB,8945,5,8,11,11,38,44,-6,35
AC Horsens,8945,6,6,13,11,34,51,-17,31
Sonderjyske,8945,7,8,6,10,28,29,-1,30
Lyngby,8945,8,4,9,11,29,46,-17,21
Silkeborg IF,8945,9,6,3,13,27,44,-17,21
Randers FC,8945,10,5,6,13,25,42,-17,21
AGF Aarhus,8945,11,4,6,12,16,38,-22,18
Brondby,8946,1,22,5,3,72,31,41,71
FC Midtjylla,8946,2,19,4,7,65,46,19,61
Copenhagen,8946,3,15,5,10,61,41,20,50
FC Nords,8946,4,12,8,10,71,57,14,44
AC Horsens,8946,5,8,12,10,37,49,-12,36
AaB,8946,6,7,12,11,36,44,-8,33
Sonderjyske,8946,7,8,6,10,28,29,-1,30
Lyngby,8946,8,4,9,11,28,44,-16,21
Silkeborg IF,8946,9,6,3,13,27,44,-17,21
Randers FC,8946,10,5,6,13,23,41,-18,21
AGF Aarhus,8946,11,4,6,12,16,38,-22,18
Brondby,8947,1,20,6,4,69,35,34,66
FC Midtjylla,8947,2,20,6,4,67,35,32,66
FC Nords,8947,3,15,7,8,75,49,26,52
Copenhagen,8947,4,14,5,11,59,43,16,47
AaB,8947,5,6,13,11,34,46,-12,31
AC Horsens,8947,6,6,13,11,33,55,-22,31
Sonderjyske,8947,7,8,6,10,28,29,-1,30
Randers FC,8947,8,6,6,12,24,39,-15,24
Silkeborg IF,8947,9,6,3,13,28,44,-16,21
Lyngby,8947,10,3,9,12,26,45,-19,18
AGF Aarhus,8947,11,4,6,12,16,39,-23,18
Brondby,8948,1,21,6,3,75,36,39,69
FC Midtjylla,8948,2,21,4,5,70,41,29,67
Copenhagen,8948,3,14,5,11,57,45,12,47
FC Nords,8948,4,12,7,11,68,54,14,43
AC Horsens,8948,5,8,12,10,35,51,-16,36
AaB,8948,6,7,12,11,38,42,-4,33
Sonderjyske,8948,7,8,6,10,28,29,-1,30
Silkeborg IF,8948,8,6,3,13,28,45,-17,21
Lyngby,8948,9,4,9,11,27,44,-17,21
Randers FC,8948,10,5,6,13,23,40,-17,21
AGF Aarhus,8948,11,4,6,12,17,39,-22,18
FC Midtjylla,8949,1,21,4,5,66,38,28,67
Brondby,8949,2,20,6,4,78,37,41,66
FC Nords,8949,3,16,6,8,75,48,27,54
Copenhagen,8949,4,14,6,10,60,45,15,48
AaB,8949,5,6,13,11,34,46,-12,31
Sonderjyske,8949,6,8,6,10,28,29,-1,30
AC Horsens,8949,7,5,13,12,35,60,-25,28
Lyngby,8949,8,4,9,11,27,44,-17,21
Randers FC,8949,9,5,6,13,23,40,-17,21
Silkeborg IF,8949,10,5,4,13,26,45,-19,19
AGF Aarhus,8949,11,4,7,11,17,37,-20,19
Brondby,8950,1,21,6,3,71,32,39,69
FC Midtjylla,8950,2,20,4,6,65,38,27,64
Copenhagen,8950,3,16,4,10,61,40,21,52
FC Nords,8950,4,14,7,9,70,49,21,49
AaB,8950,5,7,11,12,36,49,-13,32
Sonderjyske,8950,6,8,6,10,28,29,-1,30
AC Horsens,8950,7,6,12,12,33,54,-21,30
Lyngby,8950,8,4,9,11,31,44,-13,21
AGF Aarhus,8950,9,5,6,11,17,36,-19,21
Randers FC,8950,10,5,6,13,23,44,-21,21
Silkeborg IF,8950,11,5,3,14,25,45,-20,18
Brondby,8951,1,21,6,3,71,30,41,69
FC Midtjylla,8951,2,21,4,5,71,38,33,67
FC Nords,8951,3,15,6,9,76,52,24,51
Copenhagen,8951,4,12,5,13,54,50,4,41
AaB,8951,5,8,12,10,35,41,-6,36
AC Horsens,8951,6,6,13,11,35,57,-22,31
Sonderjyske,8951,7,8,6,10,28,29,-1,30
Lyngby,8951,8,4,9,11,30,45,-15,21
Silkeborg IF,8951,9,6,3,13,28,44,-16,21
Randers FC,8951,10,5,6,13,24,43,-19,21
AGF Aarhus,8951,11,4,6,12,16,39,-23,18
Brondby,8952,1,21,6,3,72,32,40,69
FC Midtjylla,8952,2,19,5,6,64,37,27,62
FC Nords,8952,3,15,6,9,70,49,21,51
Copenhagen,8952,4,14,4,12,57,46,11,46
AaB,8952,5,8,11,11,36,44,-8,35
AC Horsens,8952,6,6,14,10,34,51,-17,32
Sonderjyske,8952,7,8,6,10,28,29,-1,30
Randers FC,8952,8,5,7,12,26,42,-16,22
AGF Aarhus,8952,9,5,6,11,18,37,-19,21
Lyngby,8952,10,3,10,11,29,47,-18,19
Silkeborg IF,8952,11,5,3,14,26,46,-20,18
Brondby,8953,1,20,8,2,66,28,38,68
FC Midtjylla,8953,2,20,5,5,64,37,27,65
Copenhagen,8953,3,14,6,10,58,44,14,48
FC Nords,8953,4,12,7,11,68,57,11,43
AaB,8953,5,8,12,10,40,41,-1,36
AC Horsens,8953,6,6,14,10,36,51,-15,32
Sonderjyske,8953,7,8,6,10,28,29,-1,30
Randers FC,8953,8,6,6,12,25,39,-14,24
Silkeborg IF,8953,9,6,3,13,28,45,-17,21
Lyngby,8953,10,3,9,12,26,46,-20,18
AGF Aarhus,8953,11,4,6,12,17,39,-22,18
Brondby,8954,1,21,6,3,69,30,39,69
FC Midtjylla,8954,2,19,5,6,63,37,26,62
FC Nords,8954,3,16,6,8,74,48,26,54
Copenhagen,8954,4,14,4,12,57,47,10,46
AaB,8954,5,8,11,11,40,44,-4,35
Sonderjyske,8954,6,8,6,10,28,29,-1,30
AC Horsens,8954,7,6,12,12,31,54,-23,30
Randers FC,8954,8,6,6,12,24,39,-15,24
Silkeborg IF,8954,9,5,4,13,26,45,-19,19
AGF Aarhus,8954,10,4,7,11,17,37,-20,19
Lyngby,8954,11,3,9,12,26,45,-19,18
Brondby,8955,1,20,5,5,70,34,36,65
FC Midtjylla,8955,2,19,4,7,62,41,21,61
FC Nords,8955,3,16,7,7,75,46,29,55
Copenhagen,8955,4,14,4,12,57,50,7,46
AaB,8955,5,8,12,10,38,41,-3,36
AC Horsens,8955,6,7,12,11,36,52,-16,33
Sonderjyske,8955,7,8,6,10,28,29,-1,30
Lyngby,8955,8,4,9,11,27,44,-17,21
Randers FC,8955,9,5,6,13,23,40,-17,21
AGF Aarhus,8955,10,5,6,11,18,36,-18,21
Silkeborg IF,8955,11,5,3,14,25,46,-21,18
FC Midtjylla,8956,1,21,5,4,74,40,34,68
Brondby,8956,2,20,6,4,67,34,33,66
FC Nords,8956,3,13,8,9,71,51,20,47
Copenhagen,8956,4,13,5,12,55,47,8,44
AC Horsens,8956,5,8,12,10,38,52,-14,36
AaB,8956,6,7,12,11,37,44,-7,33
Sonderjyske,8956,7,8,6,10,28,29,-1,30
Lyngby,8956,8,4,9,11,27,44,-17,21
Randers FC,8956,9,5,6,13,23,40,-17,21
Silkeborg IF,8956,10,5,4,13,25,44,-19,19
AGF Aarhus,8956,11,4,7,11,16,36,-20,19
Brondby,8957,1,23,5,2,75,31,44,74
FC Midtjylla,8957,2,20,4,6,69,39,30,64
Copenhagen,8957,3,14,6,10,59,44,15,48
FC Nords,8957,4,13,6,11,77,58,19,45
AaB,8957,5,7,13,10,35,46,-11,34
Sonderjyske,8957,6,8,6,10,28,29,-1,30
AC Horsens,8957,7,5,14,11,31,54,-23,29
Randers FC,8957,8,6,6,12,27,41,-14,24
Silkeborg IF,8957,9,6,3,13,27,45,-18,21
Lyngby,8957,10,3,9,12,28,48,-20,18
AGF Aarhus,8957,11,4,6,12,17,38,-21,18
FC Midtjylla,8958,1,22,4,4,72,38,34,70
Brondby,8958,2,21,5,4,77,38,39,68
FC Nords,8958,3,13,8,9,73,54,19,47
Copenhagen,8958,4,12,6,12,56,49,7,42
AaB,8958,5,7,13,10,37,45,-8,34
AC Horsens,8958,6,7,12,11,39,56,-17,33
Sonderjyske,8958,7,8,6,10,28,29,-1,30
Lyngby,8958,8,4,9,11,29,45,-16,21
Randers FC,8958,9,5,6,13,24,42,-18,21
AGF Aarhus,8958,10,5,6,11,18,36,-18,21
Silkeborg IF,8958,11,5,3,14,25,46,-21,18
Brondby,8959,1,21,5,4,70,34,36,68
FC Midtjylla,8959,2,20,4,6,65,37,28,64
Copenhagen,8959,3,16,4,10,63,46,17,52
FC Nords,8959,4,13,6,11,69,53,16,45
AaB,8959,5,10,11,9,40,43,-3,41
Sonderjyske,8959,6,8,6,10,28,29,-1,30
AC Horsens,8959,7,5,12,13,32,52,-20,27
Randers FC,8959,8,5,7,12,23,39,-16,22
Silkeborg IF,8959,9,6,3,13,28,44,-16,21
Lyngby,8959,10,3,10,11,26,44,-18,19
AGF Aarhus,8959,11,4,6,12,16,39,-23,18
Brondby,8960,1,21,6,3,71,34,37,69
FC Midtjylla,8960,2,19,5,6,60,35,25,62
FC Nords,8960,3,14,8,8,74,52,22,50
Copenhagen,8960,4,13,6,11,57,46,11,45
AaB,8960,5,8,12,10,40,43,-3,36
AC Horsens,8960,6,6,13,11,36,54,-18,31
Sonderjyske,8960,7,8,6,10,28,29,-1,30
Randers FC,8960,8,5,7,12,23,39,-16,22
AGF Aarhus,8960,9,5,6,11,17,36,-19,21
Lyngby,8960,10,3,10,11,26,44,-18,19
Silkeborg IF,8960,11,5,3,14,25,45,-20,18
Brondby,8961,1,21,7,2,74,35,39,70
FC Midtjylla,8961,2,19,5,6,68,43,25,62
FC Nords,8961,3,13,9,8,73,52,21,48
Copenhagen,8961,4,13,6,11,57,48,9,45
AaB,8961,5,8,13,9,39,41,-2,37
Sonderjyske,8961,6,8,6,10,28,29,-1,30
AC Horsens,8961,7,5,14,11,37,55,-18,29
Randers FC,8961,8,6,6,12,25,40,-15,24
AGF Aarhus,8961,9,5,6,11,18,36,-18,21
Lyngby,8961,10,3,9,12,27,46,-19,18
Silkeborg IF,8961,11,5,3,14,25,46,-21,18
Brondby,8962,1,22,6,2,72,32,40,72
FC Midtjylla,8962,2,18,5,7,61,42,19,59
FC Nords,8962,3,16,6,8,81,52,29,54
Copenhagen,8962,4,14,5,11,59,48,11,47
AC Horsens,8962,5,6,15,9,34,49,-15,33
Sonderjyske,8962,6,8,6,10,28,29,-1,30
AaB,8962,7,6,11,13,39,49,-10,29
Randers FC,8962,8,6,6,12,25,39,-14,24
Silkeborg IF,8962,9,6,3,13,28,46,-18,21
Lyngby,8962,10,3,9,12,26,46,-20,18
AGF Aarhus,8962,11,4,6,12,18,39,-21,18
Brondby,8963,1,21,7,2,72,31,41,70
FC Midtjylla,8963,2,19,6,5,62,35,27,63
FC Nords,8963,3,13,7,10,72,58,14,46
Copenhagen,8963,4,12,9,9,57,44,13,45
AaB,8963,5,7,14,9,36,37,-1,35
Sonderjyske,8963,6,8,6,10,28,29,-1,30
AC Horsens,8963,7,5,15,10,33,53,-20,30
Silkeborg IF,8963,8,6,3,13,28,44,-16,21
Lyngby,8963,9,4,9,11,27,44,-17,21
Randers FC,8963,10,5,6,13,23,40,-17,21
AGF Aarhus,8963,11,4,6,12,16,39,-23,18
Brondby,8964,1,22,5,3,72,34,38,71
FC Midtjylla,8964,2,20,4,6,69,42,27,64
Copenhagen,8964,3,15,5,10,66,45,21,50
FC Nords,8964,4,12,6,12,69,59,10,42
AC Horsens,8964,5,8,13,9,41,53,-12,37
AaB,8964,6,7,11,12,37,47,-10,32
Sonderjyske,8964,7,8,6,10,28,29,-1,30
Randers FC,8964,8,6,6,12,25,40,-15,24
Silkeborg IF,8964,9,6,3,13,27,44,-17,21
Lyngby,8964,10,3,9,12,27,46,-19,18
AGF Aarhus,8964,11,4,6,12,16,38,-22,18
Brondby,8965,1,22,6,2,75,30,45,72
FC Midtjylla,8965,2,19,5,6,64,42,22,62
FC Nords,8965,3,13,8,9,75,54,21,47
Copenhagen,8965,4,14,5,11,61,47,14,47
AaB,8965,5,7,12,11,38,45,-7,33
AC Horsens,8965,6,7,12,11,37,58,-21,33
Sonderjyske,8965,7,8,6,10,28,29,-1,30
Lyngby,8965,8,4,9,11,30,45,-15,21
Silkeborg IF,8965,9,6,3,13,27,44,-17,21
Randers FC,8965,10,5,6,13,24,43,-19,21
AGF Aarhus,8965,11,4,6,12,16,38,-22,18
Brondby,8966,1,23,5,2,71,29,42,74
FC Midtjylla,8966,2,19,5,6,66,40,26,62
FC Nords,8966,3,14,7,9,72,49,23,49
Copenhagen,8966,4,13,6,11,54,43,11,45
AaB,8966,5,7,12,11,34,40,-6,33
AC Horsens,8966,6,6,13,11,31,53,-22,31
Sonderjyske,8966,7,8,6,10,28,29,-1,30
Randers FC,8966,8,6,6,12,25,39,-14,24
Silkeborg IF,8966,9,6,3,13,27,44,-17,21
Lyngby,8966,10,3,9,12,26,46,-20,18
AGF Aarhus,8966,11,4,6,12,16,38,-22,18
Brondby,8967,1,21,5,4,68,32,36,68
FC Midtjylla,8967,2,20,5,5,62,35,27,65
FC Nords,8967,3,14,8,8,76,49,27,50
Copenhagen,8967,4,15,4,11,59,45,14,49
AC Horsens,8967,5,7,12,11,33,53,-20,33
Sonderjyske,8967,6,8,6,10,28,29,-1,30
AaB,8967,7,6,12,12,34,44,-10,30
Randers FC,8967,8,5,7,12,24,40,-16,22
Silkeborg IF,8967,9,6,3,13,28,45,-17,21
Lyngby,8967,10,3,10,11,27,45,-18,19
AGF Aarhus,8967,11,4,6,12,17,39,-22,18
Brondby,8968,1,19,6,5,64,31,33,63
FC Midtjylla,8968,2,19,4,7,66,44,22,61
FC Nords,8968,3,17,6,7,76,47,29,57
Copenhagen,8968,4,13,6,11,58,46,12,45
AaB,8968,5,8,12,10,37,43,-6,36
AC Horsens,8968,6,7,12,11,35,51,-16,33
Sonderjyske,8968,7,8,6,10,28,29,-1,30
Randers FC,8968,8,5,7,12,23,39,-16,22
AGF Aarhus,8968,9,5,6,11,17,36,-19,21
Lyngby,8968,10,3,10,11,26,44,-18,19
Silkeborg IF,8968,11,5,3,14,25,45,-20,18
FC Midtjylla,8969,1,21,4,5,69,39,30,67
Brondby,8969,2,19,7,4,67,33,34,64
FC Nords,8969,3,14,6,10,75,52,23,48
Copenhagen,8969,4,13,5,12,55,45,10,44
AaB,8969,5,8,12,10,38,45,-7,36
AC Horsens,8969,6,7,14,9,34,50,-16,35
Sonderjyske,8969,7,8,6,10,28,29,-1,30
Lyngby,8969,8,4,9,11,29,44,-15,21
Silkeborg IF,8969,9,6,3,13,27,44,-17,21
Randers FC,8969,10,5,6,13,23,42,-19,21
AGF Aarhus,8969,11,4,6,12,16,38,-22,18
Brondby,8970,1,20,5,5,69,36,33,65
FC Midtjylla,8970,2,19,4,7,67,46,21,61
FC Nords,8970,3,14,8,8,74,51,23,50
Copenhagen,8970,4,15,4,11,61,45,16,49
AC Horsens,8970,5,8,13,9,40,48,-8,37
AaB,8970,6,7,12,11,37,48,-11,33
Sonderjyske,8970,7,8,6,10,28,29,-1,30
Randers FC,8970,8,5,7,12,23,39,-16,22
Silkeborg IF,8970,9,6,3,13,27,45,-18,21
Lyngby,8970,10,3,10,11,26,44,-18,19
AGF Aarhus,8970,11,4,6,12,17,38,-21,18
FC Midtjylla,8971,1,21,5,4,68,37,31,68
Brondby,8971,2,20,5,5,71,35,36,65
Copenhagen,8971,3,15,6,9,57,40,17,51
FC Nords,8971,4,13,7,10,75,55,20,46
AC Horsens,8971,5,7,12,11,37,56,-19,33
AaB,8971,6,7,11,12,36,47,-11,32
Sonderjyske,8971,7,8,6,10,28,29,-1,30
Randers FC,8971,8,6,6,12,24,39,-15,24
Silkeborg IF,8971,9,6,3,13,27,45,-18,21
Lyngby,8971,10,3,9,12,26,45,-19,18
AGF Aarhus,8971,11,4,6,12,17,38,-21,18
Brondby,8972,1,21,5,4,73,34,39,68
FC Midtjylla,8972,2,18,5,7,63,42,21,59
Copenhagen,8972,3,16,5,9,58,40,18,53
FC Nords,8972,4,13,7,10,70,50,20,46
AaB,8972,5,9,12,9,38,40,-2,39
Sonderjyske,8972,6,8,6,10,28,29,-1,30
AC Horsens,8972,7,5,14,11,34,56,-22,29
Lyngby,8972,8,4,9,11,29,44,-15,21
Randers FC,8972,9,5,6,13,23,42,-19,21
Silkeborg IF,8972,10,5,4,13,28,47,-19,19
AGF Aarhus,8972,11,4,7,11,19,39,-20,19
Brondby,8973,1,21,6,3,69,29,40,69
FC Midtjylla,8973,2,19,4,7,64,40,24,61
Copenhagen,8973,3,14,6,10,60,44,16,48
FC Nords,8973,4,13,6,11,65,48,17,45
AaB,8973,5,8,12,10,39,46,-7,36
AC Horsens,8973,6,8,12,10,35,51,-16,36
Sonderjyske,8973,7,8,6,10,28,29,-1,30
Randers FC,8973,8,6,6,12,25,39,-14,24
Silkeborg IF,8973,9,6,3,13,27,45,-18,21
Lyngby,8973,10,3,9,12,26,46,-20,18
AGF Aarhus,8973,11,4,6,12,17,38,-21,18
Brondby,8974,1,21,6,3,72,31,41,69
FC Midtjylla,8974,2,20,5,5,69,42,27,65
Copenhagen,8974,3,13,7,10,56,45,11,46
FC Nords,8974,4,12,9,9,69,52,17,45
AaB,8974,5,8,13,9,37,39,-2,37
Sonderjyske,8974,6,8,6,10,28,29,-1,30
AC Horsens,8974,7,5,14,11,34,54,-20,29
Randers FC,8974,8,5,7,12,24,40,-16,22
Silkeborg IF,8974,9,6,3,13,27,44,-17,21
Lyngby,8974,10,3,10,11,27,45,-18,19
AGF Aarhus,8974,11,4,6,12,16,38,-22,18
Brondby,8975,1,20,8,2,68,31,37,68
FC Midtjylla,8975,2,20,6,4,67,38,29,66
FC Nords,8975,3,13,9,8,73,52,21,48
Copenhagen,8975,4,14,5,11,58,43,15,47
AaB,8975,5,7,12,11,36,44,-8,33
Sonderjyske,8975,6,8,6,10,28,29,-1,30
AC Horsens,8975,7,5,14,11,34,54,-20,29
Randers FC,8975,8,6,6,12,25,40,-15,24
Silkeborg IF,8975,9,6,3,13,27,45,-18,21
Lyngby,8975,10,3,9,12,27,46,-19,18
AGF Aarhus,8975,11,4,6,12,17,38,-21,18
Brondby,8976,1,20,6,4,69,33,36,66
FC Midtjylla,8976,2,19,5,6,64,39,25,62
Copenhagen,8976,3,15,5,10,58,41,17,50
FC Nords,8976,4,13,7,10,69,55,14,46
AaB,8976,5,8,13,9,39,39,0,37
AC Horsens,8976,6,7,12,11,31,49,-18,33
Sonderjyske,8976,7,8,6,10,28,29,-1,30
Randers FC,8976,8,5,7,12,24,40,-16,22
Silkeborg IF,8976,9,6,3,13,28,46,-18,21
Lyngby,8976,10,3,10,11,27,45,-18,19
AGF Aarhus,8976,11,4,6,12,18,39,-21,18
Brondby,8977,1,21,6,3,74,36,38,69
FC Midtjylla,8977,2,20,5,5,63,35,28,65
Copenhagen,8977,3,15,5,10,58,40,18,50
FC Nords,8977,4,13,8,9,74,53,21,47
AaB,8977,5,8,12,10,37,42,-5,36
Sonderjyske,8977,6,8,6,10,28,29,-1,30
AC Horsens,8977,7,5,12,13,30,56,-26,27
Lyngby,8977,8,4,9,11,28,44,-16,21
Randers FC,8977,9,5,6,13,23,41,-18,21
Silkeborg IF,8977,10,5,4,13,25,44,-19,19
AGF Aarhus,8977,11,4,7,11,16,36,-20,19
Brondby,8978,1,21,6,3,72,33,39,69
FC Midtjylla,8978,2,21,4,5,68,37,31,67
FC Nords,8978,3,14,6,10,75,55,20,48
Copenhagen,8978,4,14,5,11,59,45,14,47
AaB,8978,5,8,11,11,38,47,-9,35
Sonderjyske,8978,6,8,6,10,28,29,-1,30
AC Horsens,8978,7,6,12,12,35,56,-21,30
Randers FC,8978,8,6,6,12,25,40,-15,24
AGF Aarhus,8978,9,5,6,11,19,36,-17,21
Lyngby,8978,10,3,9,12,27,46,-19,18
Silkeborg IF,8978,11,5,3,14,25,47,-22,18
Brondby,8979,1,21,7,2,70,31,39,70
FC Midtjylla,8979,2,20,5,5,69,42,27,65
FC Nords,8979,3,15,7,8,77,49,28,52
Copenhagen,8979,4,13,6,11,56,45,11,45
AC Horsens,8979,5,6,13,11,34,55,-21,31
Sonderjyske,8979,6,8,6,10,28,29,-1,30
AaB,8979,7,6,12,12,35,45,-10,30
Randers FC,8979,8,5,7,12,24,40,-16,22
Lyngby,8979,9,3,10,11,27,45,-18,19
Silkeborg IF,8979,10,5,4,13,26,45,-19,19
AGF Aarhus,8979,11,4,7,11,17,37,-20,19
FC Midtjylla,8980,1,20,4,6,64,38,26,64
Brondby,8980,2,19,6,5,67,35,32,63
Copenhagen,8980,3,16,5,9,59,41,18,53
FC Nords,8980,4,12,6,12,67,54,13,42
AC Horsens,8980,5,8,13,9,43,52,-9,37
AaB,8980,6,8,12,10,40,46,-6,36
Sonderjyske,8980,7,8,6,10,28,29,-1,30
Lyngby,8980,8,4,9,11,28,45,-17,21
Silkeborg IF,8980,9,6,3,13,27,44,-17,21
Randers FC,8980,10,5,6,13,24,41,-17,21
AGF Aarhus,8980,11,4,6,12,16,38,-22,18
Brondby,8981,1,22,6,2,70,30,40,72
FC Midtjylla,8981,2,21,4,5,69,37,32,67
FC Nords,8981,3,14,7,9,73,49,24,49
Copenhagen,8981,4,12,7,11,57,48,9,43
AaB,8981,5,6,13,11,35,44,-9,31
AC Horsens,8981,6,6,13,11,32,54,-22,31
Sonderjyske,8981,7,8,6,10,28,29,-1,30
Lyngby,8981,8,4,9,11,27,44,-17,21
Randers FC,8981,9,5,6,13,23,40,-17,21
AGF Aarhus,8981,10,5,6,11,17,36,-19,21
Silkeborg IF,8981,11,5,3,14,25,45,-20,18
FC Midtjylla,8982,1,21,5,4,70,37,33,68
Brondby,8982,2,20,6,4,67,34,33,66
FC Nords,8982,3,15,7,8,74,53,21,52
Copenhagen,8982,4,15,5,10,61,43,18,50
AaB,8982,5,7,11,12,36,45,-9,32
Sonderjyske,8982,6,8,6,10,28,29,-1,30
AC Horsens,8982,7,5,12,13,31,53,-22,27
Lyngby,8982,8,4,9,11,28,45,-17,21
Randers FC,8982,9,5,6,13,24,41,-17,21
Silkeborg IF,8982,10,5,4,13,25,44,-19,19
AGF Aarhus,8982,11,4,7,11,16,36,-20,19
Brondby,8983,1,21,7,2,70,32,38,70
FC Midtjylla,8983,2,18,6,6,63,39,24,60
FC Nords,8983,3,13,7,10,73,57,16,46
Copenhagen,8983,4,13,7,10,59,46,13,46
AC Horsens,8983,5,7,14,9,34,48,-14,35
AaB,8983,6,7,13,10,38,41,-3,34
Sonderjyske,8983,7,8,6,10,28,29,-1,30
Randers FC,8983,8,6,6,12,25,39,-14,24
Silkeborg IF,8983,9,5,4,13,26,45,-19,19
AGF Aarhus,8983,10,4,7,11,17,37,-20,19
Lyngby,8983,11,3,9,12,26,46,-20,18
Brondby,8984,1,20,5,5,70,36,34,65
FC Midtjylla,8984,2,20,5,5,68,41,27,65
Copenhagen,8984,3,16,4,10,61,44,17,52
FC Nords,8984,4,15,6,9,75,50,25,51
AaB,8984,5,7,11,12,34,44,-10,32
AC Horsens,8984,6,6,13,11,32,51,-19,31
Sonderjyske,8984,7,8,6,10,28,29,-1,30
Lyngby,8984,8,4,9,11,28,44,-16,21
Silkeborg IF,8984,9,6,3,13,27,45,-18,21
Randers FC,8984,10,5,6,13,23,41,-18,21
AGF Aarhus,8984,11,4,6,12,17,38,-21,18
Brondby,8985,1,22,5,3,75,30,45,71
FC Midtjylla,8985,2,19,6,5,66,39,27,63
FC Nords,8985,3,15,6,9,76,58,18,51
Copenhagen,8985,4,15,5,10,59,41,18,50
Sonderjyske,8985,5,8,6,10,28,29,-1,30
AaB,8985,6,6,12,12,31,43,-12,30
AC Horsens,8985,7,6,12,12,37,59,-22,30
Lyngby,8985,8,4,9,11,28,45,-17,21
Randers FC,8985,9,5,6,13,24,41,-17,21
AGF Aarhus,8985,10,5,6,11,19,37,-18,21
Silkeborg IF,8985,11,5,3,14,26,47,-21,18
Brondby,8986,1,19,6,5,69,34,35,63
FC Midtjylla,8986,2,18,5,7,61,43,18,59
FC Nords,8986,3,16,7,7,74,48,26,55
Copenhagen,8986,4,13,8,9,57,41,16,47
AaB,8986,5,8,12,10,40,44,-4,36
AC Horsens,8986,6,7,12,11,36,53,-17,33
Sonderjyske,8986,7,8,6,10,28,29,-1,30
Randers FC,8986,8,6,6,12,25,39,-14,24
Silkeborg IF,8986,9,6,3,13,26,44,-18,21
Lyngby,8986,10,3,9,12,26,46,-20,18
AGF Aarhus,8986,11,4,6,12,16,37,-21,18
Brondby,8987,1,22,6,2,86,30,56,72
FC Midtjylla,8987,2,18,5,7,62,44,18,59
FC Nords,8987,3,15,7,8,73,55,18,52
Copenhagen,8987,4,13,5,12,54,43,11,44
AaB,8987,5,8,12,10,40,47,-7,36
AC Horsens,8987,6,6,13,11,34,56,-22,31
Sonderjyske,8987,7,8,6,10,28,29,-1,30
Silkeborg IF,8987,8,6,3,13,29,45,-16,21
Lyngby,8987,9,4,9,11,28,45,-17,21
Randers FC,8987,10,5,6,13,24,41,-17,21
AGF Aarhus,8987,11,4,6,12,17,40,-23,18
FC Midtjylla,8988,1,20,5,5,62,37,25,65
Brondby,8988,2,18,7,5,67,35,32,61
Copenhagen,8988,3,14,5,11,59,46,13,47
FC Nords,8988,4,13,7,10,69,54,15,46
AaB,8988,5,9,12,9,44,42,2,39
AC Horsens,8988,6,8,12,10,37,50,-13,36
Sonderjyske,8988,7,8,6,10,28,29,-1,30
Randers FC,8988,8,5,7,12,24,40,-16,22
Lyngby,8988,9,3,10,11,27,45,-18,19
Silkeborg IF,8988,10,5,4,13,25,44,-19,19
AGF Aarhus,8988,11,4,7,11,16,36,-20,19
Brondby,8989,1,21,6,3,74,31,43,69
FC Midtjylla,8989,2,20,4,6,66,41,25,64
FC Nords,8989,3,15,6,9,71,47,24,51
Copenhagen,8989,4,14,6,10,59,46,13,48
AaB,8989,5,7,11,12,38,49,-11,32
AC Horsens,8989,6,6,13,11,35,55,-20,31
Sonderjyske,8989,7,8,6,10,28,29,-1,30
Randers FC,8989,8,6,6,12,26,41,-15,24
Silkeborg IF,8989,9,6,3,13,29,46,-17,21
Lyngby,8989,10,3,9,12,28,47,-19,18
AGF Aarhus,8989,11,4,6,12,18,40,-22,18
Brondby,8990,1,21,6,3,77,34,43,69
FC Midtjylla,8990,2,20,5,5,70,45,25,65
FC Nords,8990,3,13,10,7,75,52,23,49
Copenhagen,8990,4,14,5,11,58,43,15,47
AC Horsens,8990,5,7,13,10,34,50,-16,34
Sonderjyske,8990,6,8,6,10,28,29,-1,30
AaB,8990,7,6,11,13,35,51,-16,29
Lyngby,8990,8,4,9,11,28,44,-16,21
Silkeborg IF,8990,8,6,3,13,28,44,-16,21
Randers FC,8990,10,5,6,13,23,41,-18,21
AGF Aarhus,8990,11,4,6,12,16,39,-23,18
Brondby,8991,1,22,5,3,68,31,37,71
FC Midtjylla,8991,2,20,4,6,69,38,31,64
FC Nords,8991,3,16,6,8,76,48,28,54
Copenhagen,8991,4,13,5,12,58,50,8,44
AC Horsens,8991,5,7,12,11,34,54,-20,33
Sonderjyske,8991,6,8,6,10,28,29,-1,30
AaB,8991,7,6,12,12,33,43,-10,30
Randers FC,8991,8,5,7,12,24,40,-16,22
Silkeborg IF,8991,9,6,3,13,27,45,-18,21
Lyngby,8991,10,3,10,11,27,45,-18,19
AGF Aarhus,8991,11,4,6,12,17,38,-21,18
FC Midtjylla,8992,1,21,5,4,71,38,33,68
Brondby,8992,2,19,6,5,67,34,33,63
FC Nords,8992,3,13,8,9,70,49,21,47
Copenhagen,8992,4,12,8,10,57,45,12,44
AaB,8992,5,8,13,9,35,38,-3,37
AC Horsens,8992,6,7,12,11,36,58,-22,33
Sonderjyske,8992,7,8,6,10,28,29,-1,30
Lyngby,8992,8,4,9,11,28,45,-17,21
Randers FC,8992,9,5,6,13,24,41,-17,21
Silkeborg IF,8992,10,5,4,13,26,45,-19,19
AGF Aarhus,8992,11,4,7,11,17,37,-20,19
Brondby,8993,1,20,6,4,71,36,35,66
FC Midtjylla,8993,2,20,4,6,71,42,29,64
FC Nords,8993,3,14,7,9,70,54,16,49
Copenhagen,8993,4,13,6,11,57,46,11,45
AaB,8993,5,7,14,9,37,41,-4,35
AC Horsens,8993,6,7,13,10,36,49,-13,34
Sonderjyske,8993,7,8,6,10,28,29,-1,30
Lyngby,8993,8,4,9,11,28,45,-17,21
Randers FC,8993,9,5,6,13,24,41,-17,21
AGF Aarhus,8993,10,5,6,11,18,37,-19,21
Silkeborg IF,8993,11,5,3,14,26,46,-20,18
FC Midtjylla,8994,1,20,5,5,66,39,27,65
Brondby,8994,2,19,7,4,66,31,35,64
Copenhagen,8994,3,14,5,11,56,43,13,47
FC Nords,8994,4,13,7,10,70,51,19,46
AaB,8994,5,10,12,8,38,38,0,42
Sonderjyske,8994,6,8,6,10,28,29,-1,30
AC Horsens,8994,7,5,14,11,35,55,-20,29
Randers FC,8994,8,6,6,12,25,40,-15,24
Silkeborg IF,8994,9,6,3,13,28,45,-17,21
Lyngby,8994,10,3,9,12,27,46,-19,18
AGF Aarhus,8994,11,4,6,12,17,39,-22,18
FC Midtjylla,8995,1,22,4,4,72,35,37,70
Brondby,8995,2,21,5,4,67,31,36,68
FC Nords,8995,3,14,6,10,73,51,22,48
Copenhagen,8995,4,13,4,13,55,49,6,43
AaB,8995,5,10,11,9,39,42,-3,41
Sonderjyske,8995,6,8,6,10,28,29,-1,30
AC Horsens,8995,7,5,12,13,33,57,-24,27
Randers FC,8995,8,6,6,12,24,39,-15,24
Silkeborg IF,8995,9,6,3,13,26,44,-18,21
Lyngby,8995,10,3,9,12,26,45,-19,18
AGF Aarhus,8995,11,4,6,12,16,37,-21,18
Brondby,8996,1,21,5,4,72,35,37,68
FC Midtjylla,8996,2,21,5,4,68,38,30,68
FC Nords,8996,3,14,8,8,75,53,22,50
Copenhagen,8996,4,14,5,11,59,46,13,47
AaB,8996,5,7,11,12,35,44,-9,32
Sonderjyske,8996,6,8,6,10,28,29,-1,30
AC Horsens,8996,7,5,14,11,36,55,-19,29
Lyngby,8996,8,4,9,11,27,44,-17,21
Randers FC,8996,9,5,6,13,23,40,-17,21
Silkeborg IF,8996,10,6,3,13,26,44,-18,21
AGF Aarhus,8996,11,4,6,12,16,37,-21,18
Brondby,8997,1,21,6,3,73,32,41,69
FC Midtjylla,8997,2,20,6,4,66,37,29,66
FC Nords,8997,3,14,6,10,74,53,21,48
Copenhagen,8997,4,13,7,10,58,49,9,46
AaB,8997,5,7,13,10,35,42,-7,34
Sonderjyske,8997,6,8,6,10,28,29,-1,30
AC Horsens,8997,7,6,12,12,37,56,-19,30
Randers FC,8997,8,6,6,12,24,39,-15,24
Silkeborg IF,8997,9,6,3,13,26,44,-18,21
Lyngby,8997,10,3,9,12,26,45,-19,18
AGF Aarhus,8997,11,4,6,12,16,37,-21,18
Brondby,8998,1,21,6,3,71,34,37,69
FC Midtjylla,8998,2,19,6,5,68,41,27,63
Copenhagen,8998,3,14,5,11,60,49,11,47
FC Nords,8998,4,13,7,10,71,53,18,46
AC Horsens,8998,5,7,14,9,39,51,-12,35
AaB,8998,6,7,12,11,37,44,-7,33
Sonderjyske,8998,7,8,6,10,28,29,-1,30
Randers FC,8998,8,6,6,12,25,39,-14,24
AGF Aarhus,8998,9,5,6,11,18,37,-19,21
Lyngby,8998,10,3,9,12,26,46,-20,18
Silkeborg IF,8998,10,5,3,14,26,46,-20,18
Brondby,8999,1,22,5,3,75,37,38,71
FC Midtjylla,8999,2,19,4,7,67,42,25,61
FC Nords,8999,3,15,6,9,77,52,25,51
Copenhagen,8999,4,14,4,12,57,46,11,46
AC Horsens,8999,5,8,12,10,39,49,-10,36
AaB,8999,6,7,11,12,35,50,-15,32
Sonderjyske,8999,7,8,6,10,28,29,-1,30
Lyngby,8999,8,4,9,11,29,44,-15,21
Randers FC,8999,9,5,6,13,23,42,-19,21
AGF Aarhus,8999,10,5,6,11,17,36,-19,21
Silkeborg IF,8999,11,5,3,14,25,45,-20,18
Brondby,9000,1,20,7,3,73,37,36,67
FC Midtjylla,9000,2,20,6,4,71,39,32,66
Copenhagen,9000,3,13,4,13,57,50,7,43
FC Nords,9000,4,12,6,12,69,59,10,42
AaB,9000,5,9,12,9,39,38,1,39
AC Horsens,9000,6,7,15,8,39,51,-12,36
Sonderjyske,9000,7,8,6,10,28,29,-1,30
Randers FC,9000,8,5,7,12,25,41,-16,22
AGF Aarhus,9000,9,5,6,11,19,37,-18,21
Lyngby,9000,10,3,10,11,28,46,-18,19
Silkeborg IF,9000,11,5,3,14,26,47,-21,18
Brondby,9001,1,20,7,3,69,32,37,67
FC Midtjylla,9001,2,19,7,4,71,40,31,64
Copenhagen,9001,3,14,5,11,55,43,12,47
FC Nords,9001,4,13,7,10,71,54,17,46
AaB,9001,5,9,11,10,39,45,-6,38
Sonderjyske,9001,6,8,6,10,28,29,-1,30
AC Horsens,9001,7,5,15,10,36,53,-17,30
Randers FC,9001,8,6,6,12,26,40,-14,24
Silkeborg IF,9001,9,6,3,13,28,46,-18,21
Lyngby,9001,10,3,9,12,27,47,-20,18
AGF Aarhus,9001,11,4,6,12,18,39,-21,18
Brondby,9002,1,23,5,2,78,30,48,74
FC Midtjylla,9002,2,20,4,6,66,41,25,64
FC Nords,9002,3,14,6,10,76,53,23,48
Copenhagen,9002,4,13,6,11,56,49,7,45
AaB,9002,5,7,12,11,37,45,-8,33
AC Horsens,9002,6,6,13,11,34,55,-21,31
Sonderjyske,9002,7,8,6,10,28,29,-1,30
Randers FC,9002,8,6,6,12,24,39,-15,24
Silkeborg IF,9002,9,6,3,13,28,44,-16,21
Lyngby,9002,10,3,9,12,26,45,-19,18
AGF Aarhus,9002,11,4,6,12,16,39,-23,18
Brondby,9003,1,21,5,4,75,33,42,68
FC Midtjylla,9003,2,19,5,6,61,40,21,62
FC Nords,9003,3,15,7,8,78,50,28,52
Copenhagen,9003,4,13,6,11,59,48,11,45
AaB,9003,5,7,13,10,36,44,-8,34
AC Horsens,9003,6,6,14,10,36,56,-20,32
Sonderjyske,9003,7,8,6,10,28,29,-1,30
Randers FC,9003,8,6,6,12,27,42,-15,24
Silkeborg IF,9003,9,6,3,13,28,44,-16,21
Lyngby,9003,10,3,9,12,29,48,-19,18
AGF Aarhus,9003,11,4,6,12,16,39,-23,18
Brondby,9004,1,23,5,2,82,28,54,74
FC Midtjylla,9004,2,18,6,6,62,42,20,60
FC Nords,9004,3,13,8,9,72,55,17,47
Copenhagen,9004,4,13,6,11,55,48,7,45
AaB,9004,5,6,15,9,37,45,-8,33
AC Horsens,9004,6,6,14,10,36,52,-16,32
Sonderjyske,9004,7,8,6,10,28,29,-1,30
Lyngby,9004,8,4,9,11,27,44,-17,21
Randers FC,9004,9,5,6,13,23,40,-17,21
AGF Aarhus,9004,10,5,6,11,20,38,-18,21
Silkeborg IF,9004,11,5,3,14,27,48,-21,18
Brondby,9005,1,20,6,4,67,32,35,66
FC Midtjylla,9005,2,19,6,5,64,36,28,63
FC Nords,9005,3,15,6,9,72,49,23,51
Copenhagen,9005,4,14,6,10,60,46,14,48
AC Horsens,9005,5,7,13,10,34,48,-14,34
AaB,9005,6,7,11,12,39,51,-12,32
Sonderjyske,9005,7,8,6,10,28,29,-1,30
Randers FC,9005,8,6,6,12,24,39,-15,24
Silkeborg IF,9005,9,6,3,13,28,46,-18,21
Lyngby,9005,10,3,9,12,26,45,-19,18
AGF Aarhus,9005,11,4,6,12,18,39,-21,18
Brondby,9006,1,22,6,2,71,29,42,72
FC Midtjylla,9006,2,20,4,6,69,39,30,64
FC Nords,9006,3,15,7,8,74,48,26,52
Copenhagen,9006,4,12,5,13,52,46,6,41
AaB,9006,5,7,14,9,32,37,-5,35
Sonderjyske,9006,6,8,6,10,28,29,-1,30
AC Horsens,9006,7,5,14,11,32,57,-25,29
Lyngby,9006,8,4,9,11,28,44,-16,21
Randers FC,9006,9,5,6,13,23,41,-18,21
AGF Aarhus,9006,10,5,6,11,19,37,-18,21
Silkeborg IF,9006,11,5,3,14,26,47,-21,18
Brondby,9007,1,22,5,3,74,31,43,71
FC Midtjylla,9007,2,19,6,5,64,39,25,63
Copenhagen,9007,3,15,5,10,60,46,14,50
FC Nords,9007,4,13,7,10,71,57,14,46
AaB,9007,5,7,12,11,42,46,-4,33
Sonderjyske,9007,6,8,6,10,28,29,-1,30
AC Horsens,9007,7,5,15,10,34,52,-18,30
Randers FC,9007,8,6,6,12,26,41,-15,24
Silkeborg IF,9007,9,5,4,13,26,45,-19,19
AGF Aarhus,9007,10,4,7,11,17,37,-20,19
Lyngby,9007,11,3,9,12,28,47,-19,18
FC Midtjylla,9008,1,20,5,5,68,36,32,65
Brondby,9008,2,19,6,5,68,37,31,63
FC Nords,9008,3,17,6,7,77,46,31,57
Copenhagen,9008,4,13,4,13,57,50,7,43
AC Horsens,9008,5,7,13,10,39,54,-15,34
AaB,9008,6,7,12,11,36,48,-12,33
Sonderjyske,9008,7,8,6,10,28,29,-1,30
Randers FC,9008,8,6,6,12,24,39,-15,24
Silkeborg IF,9008,9,6,3,13,29,45,-16,21
Lyngby,9008,10,3,9,12,26,45,-19,18
AGF Aarhus,9008,11,4,6,12,17,40,-23,18
Brondby,9009,1,22,6,2,73,30,43,72
FC Midtjylla,9009,2,19,5,6,61,39,22,62
Copenhagen,9009,3,15,5,10,56,41,15,50
FC Nords,9009,4,12,6,12,67,55,12,42
AaB,9009,5,8,12,10,39,41,-2,36
AC Horsens,9009,6,7,12,11,34,50,-16,33
Sonderjyske,9009,7,8,6,10,28,29,-1,30
Randers FC,9009,8,6,6,12,25,39,-14,24
Silkeborg IF,9009,9,5,4,13,25,44,-19,19
AGF Aarhus,9009,10,4,7,11,16,36,-20,19
Lyngby,9009,11,3,9,12,26,46,-20,18
Brondby,9010,1,20,6,4,72,35,37,66
FC Midtjylla,9010,2,17,6,7,64,48,16,57
Copenhagen,9010,3,16,4,10,66,44,22,52
FC Nords,9010,4,13,7,10,74,56,18,46
AC Horsens,9010,5,8,14,8,43,54,-11,38
AaB,9010,6,7,13,10,36,44,-8,34
Sonderjyske,9010,7,8,6,10,28,29,-1,30
Lyngby,9010,8,4,9,11,29,44,-15,21
Silkeborg IF,9010,9,6,3,13,26,44,-18,21
Randers FC,9010,10,5,6,13,23,42,-19,21
AGF Aarhus,9010,11,4,6,12,16,37,-21,18
FC Midtjylla,9011,1,21,5,4,66,36,30,68
Brondby,9011,2,20,5,5,71,35,36,65
FC Nords,9011,3,13,7,10,70,54,16,46
Copenhagen,9011,4,13,6,11,54,44,10,45
AC Horsens,9011,5,8,12,10,38,50,-12,36
AaB,9011,6,8,11,11,39,45,-6,35
Sonderjyske,9011,7,8,6,10,28,29,-1,30
Randers FC,9011,8,6,6,12,25,40,-15,24
AGF Aarhus,9011,9,5,6,11,17,36,-19,21
Lyngby,9011,10,3,9,12,27,46,-19,18
Silkeborg IF,9011,11,5,3,14,25,45,-20,18
Brondby,9012,1,21,6,3,69,30,39,69
FC Midtjylla,9012,2,19,5,6,63,40,23,62
FC Nords,9012,3,14,6,10,76,56,20,48
Copenhagen,9012,4,14,5,11,57,47,10,47
AaB,9012,5,8,12,10,38,42,-4,36
AC Horsens,9012,6,7,12,11,36,50,-14,33
Sonderjyske,9012,7,8,6,10,28,29,-1,30
Lyngby,9012,8,4,9,11,30,46,-16,21
Silkeborg IF,9012,9,6,3,13,27,44,-17,21
Randers FC,9012,10,5,6,13,25,43,-18,21
AGF Aarhus,9012,11,4,6,12,16,38,-22,18
Brondby,9013,1,20,6,4,70,30,40,66
FC Midtjylla,9013,2,19,6,5,65,38,27,63
FC Nords,9013,3,15,7,8,78,55,23,52
Copenhagen,9013,4,13,6,11,55,48,7,45
AaB,9013,5,8,11,11,39,46,-7,35
AC Horsens,9013,6,7,12,11,38,54,-16,33
Sonderjyske,9013,7,8,6,10,28,29,-1,30
Randers FC,9013,8,6,6,12,25,39,-14,24
AGF Aarhus,9013,9,5,6,11,21,37,-16,21
Lyngby,9013,10,3,9,12,26,46,-20,18
Silkeborg IF,9013,11,5,3,14,26,49,-23,18
Brondby,9014,1,22,6,2,75,29,46,72
FC Midtjylla,9014,2,19,6,5,65,39,26,63
FC Nords,9014,3,14,7,9,70,51,19,49
Copenhagen,9014,4,13,6,11,58,45,13,45
AC Horsens,9014,5,7,14,9,37,49,-12,35
Sonderjyske,9014,6,8,6,10,28,29,-1,30
AaB,9014,7,6,11,13,35,53,-18,29
Lyngby,9014,8,4,9,11,28,45,-17,21
Randers FC,9014,9,5,6,13,24,41,-17,21
Silkeborg IF,9014,10,6,3,13,27,45,-18,21
AGF Aarhus,9014,11,4,6,12,17,38,-21,18
FC Midtjylla,9015,1,20,5,5,66,38,28,65
Brondby,9015,2,19,5,6,70,42,28,62
Copenhagen,9015,3,16,5,9,64,43,21,53
FC Nords,9015,4,14,7,9,76,54,22,49
AC Horsens,9015,5,7,14,9,41,53,-12,35
Sonderjyske,9015,6,8,6,10,28,29,-1,30
AaB,9015,7,6,12,12,37,50,-13,30
Randers FC,9015,8,6,6,12,24,39,-15,24
Silkeborg IF,9015,9,6,3,13,28,45,-17,21
Lyngby,9015,10,3,9,12,26,45,-19,18
AGF Aarhus,9015,11,4,6,12,17,39,-22,18
FC Midtjylla,9016,1,22,4,4,74,36,38,70
Brondby,9016,2,19,8,3,71,35,36,65
Copenhagen,9016,3,13,7,10,59,46,13,46
FC Nords,9016,4,13,6,11,71,56,15,45
AaB,9016,5,7,14,9,38,45,-7,35
Sonderjyske,9016,6,8,6,10,28,29,-1,30
AC Horsens,9016,7,5,15,10,38,59,-21,30
Lyngby,9016,8,4,9,11,29,46,-17,21
Silkeborg IF,9016,9,6,3,13,28,45,-17,21
Randers FC,9016,10,5,6,13,25,42,-17,21
AGF Aarhus,9016,11,4,6,12,17,39,-22,18
Brondby,9017,1,21,5,4,69,32,37,68
FC Midtjylla,9017,2,21,4,5,72,40,32,67
Copenhagen,9017,3,17,4,9,61,43,18,55
FC Nords,9017,4,12,7,11,72,58,14,43
AC Horsens,9017,5,7,12,11,40,57,-17,33
Sonderjyske,9017,6,8,6,10,28,29,-1,30
AaB,9017,7,6,12,12,37,47,-10,30
Lyngby,9017,8,4,9,11,28,45,-17,21
Randers FC,9017,9,5,6,13,24,41,-17,21
Silkeborg IF,9017,10,6,3,13,27,45,-18,21
AGF Aarhus,9017,11,4,6,12,17,38,-21,18
Brondby,9018,1,21,6,3,68,33,35,69
FC Midtjylla,9018,2,20,5,5,65,36,29,65
FC Nords,9018,3,14,7,9,73,53,20,49
Copenhagen,9018,4,13,6,11,58,45,13,45
AaB,9018,5,7,13,10,38,43,-5,34
Sonderjyske,9018,6,8,6,10,28,29,-1,30
AC Horsens,9018,7,5,15,10,34,52,-18,30
Randers FC,9018,8,5,7,12,24,40,-16,22
Silkeborg IF,9018,9,6,3,13,27,45,-18,21
Lyngby,9018,10,3,10,11,27,45,-18,19
AGF Aarhus,9018,11,4,6,12,17,38,-21,18
Brondby,9019,1,21,5,4,69,35,34,68
FC Midtjylla,9019,2,19,6,5,68,39,29,63
FC Nords,9019,3,16,7,7,78,49,29,55
Copenhagen,9019,4,14,5,11,57,42,15,47
AaB,9019,5,8,11,11,38,45,-7,35
Sonderjyske,9019,6,8,6,10,28,29,-1,30
AC Horsens,9019,7,5,12,13,30,56,-26,27
Lyngby,9019,8,4,9,11,28,45,-17,21
Silkeborg IF,9019,8,6,3,13,28,45,-17,21
Randers FC,9019,10,5,6,13,24,41,-17,21
AGF Aarhus,9019,11,4,6,12,17,39,-22,18
Brondby,9020,1,21,7,2,76,33,43,70
FC Midtjylla,9020,2,20,5,5,67,40,27,65
FC Nords,9020,3,14,7,9,79,55,24,49
Copenhagen,9020,4,13,5,12,55,45,10,44
AaB,9020,5,8,12,10,37,45,-8,36
Sonderjyske,9020,6,8,6,10,28,29,-1,30
AC Horsens,9020,7,6,12,12,36,58,-22,30
Randers FC,9020,8,6,6,12,24,39,-15,24
Silkeborg IF,9020,9,6,3,13,26,44,-18,21
Lyngby,9020,10,3,9,12,26,45,-19,18
AGF Aarhus,9020,11,4,6,12,16,37,-21,18
Brondby,9021,1,20,7,3,69,32,37,67
FC Midtjylla,9021,2,18,7,5,64,39,25,61
Copenhagen,9021,3,16,4,10,60,46,14,52
FC Nords,9021,4,14,7,9,73,53,20,49
AC Horsens,9021,5,6,14,10,37,51,-14,32
AaB,9021,6,6,13,11,36,44,-8,31
Sonderjyske,9021,7,8,6,10,28,29,-1,30
Lyngby,9021,8,4,9,11,28,44,-16,21
Randers FC,9021,9,5,6,13,23,41,-18,21
Silkeborg IF,9021,10,5,4,13,25,44,-19,19
AGF Aarhus,9021,11,4,7,11,16,36,-20,19
Brondby,9022,1,20,7,3,69,30,39,67
FC Midtjylla,9022,2,20,5,5,67,38,29,65
FC Nords,9022,3,14,8,8,73,51,22,50
Copenhagen,9022,4,12,6,12,53,45,8,42
AaB,9022,5,7,13,10,36,43,-7,34
AC Horsens,9022,6,7,13,10,36,53,-17,34
Sonderjyske,9022,7,8,6,10,28,29,-1,30
Randers FC,9022,8,6,6,12,25,40,-15,24
Silkeborg IF,9022,9,5,4,13,25,44,-19,19
AGF Aarhus,9022,10,4,7,11,16,36,-20,19
Lyngby,9022,11,3,9,12,27,46,-19,18
Brondby,9023,1,20,7,3,69,31,38,67
FC Midtjylla,9023,2,19,7,4,63,37,26,64
FC Nords,9023,3,13,8,9,71,53,18,47
Copenhagen,9023,4,13,7,10,58,48,10,46
AaB,9023,5,9,11,10,45,44,1,38
Sonderjyske,9023,6,8,6,10,28,29,-1,30
AC Horsens,9023,7,5,14,11,36,55,-19,29
Randers FC,9023,8,5,7,12,24,40,-16,22
AGF Aarhus,9023,9,5,6,11,17,36,-19,21
Lyngby,9023,10,3,10,11,27,45,-18,19
Silkeborg IF,9023,11,5,3,14,25,45,-20,18
Brondby,9024,1,22,5,3,73,33,40,71
FC Midtjylla,9024,2,20,5,5,63,38,25,65
FC Nords,9024,3,14,7,9,76,50,26,49
Copenhagen,9024,4,13,5,12,57,48,9,44
AaB,9024,5,6,14,10,35,44,-9,32
AC Horsens,9024,6,6,14,10,35,52,-17,32
Sonderjyske,9024,7,8,6,10,28,29,-1,30
Lyngby,9024,8,4,9,11,29,45,-16,21
Randers FC,9024,9,5,6,13,24,42,-18,21
AGF Aarhus,9024,10,5,6,11,18,36,-18,21
Silkeborg IF,9024,11,5,3,14,25,46,-21,18
FC Midtjylla,9025,1,20,5,5,68,36,32,65
Brondby,9025,2,19,6,5,70,36,34,63
FC Nords,9025,3,13,9,8,72,53,19,48
Copenhagen,9025,4,14,5,11,56,43,13,47
AaB,9025,5,8,12,10,43,50,-7,36
AC Horsens,9025,6,6,15,9,37,54,-17,33
Sonderjyske,9025,7,8,6,10,28,29,-1,30
Lyngby,9025,8,4,9,11,27,44,-17,21
Randers FC,9025,9,5,6,13,23,40,-17,21
Silkeborg IF,9025,10,6,3,13,27,45,-18,21
AGF Aarhus,9025,11,4,6,12,17,38,-21,18
Brondby,9026,1,21,6,3,74,33,41,69
FC Midtjylla,9026,2,19,6,5,66,41,25,63
FC Nords,9026,3,14,8,8,74,53,21,50
Copenhagen,9026,4,13,4,13,56,51,5,43
AC Horsens,9026,5,6,16,8,35,48,-13,34
AaB,9026,6,7,12,11,37,42,-5,33
Sonderjyske,9026,7,8,6,10,28,29,-1,30
Randers FC,9026,8,5,7,12,23,39,-16,22
Silkeborg IF,9026,9,6,3,13,27,44,-17,21
Lyngby,9026,10,3,10,11,26,44,-18,19
AGF Aarhus,9026,11,4,6,12,16,38,-22,18
Brondby,9027,1,23,5,2,71,30,41,74
FC Midtjylla,9027,2,18,5,7,64,43,21,59
FC Nords,9027,3,16,6,8,75,48,27,54
Copenhagen,9027,4,13,4,13,56,48,8,43
AC Horsens,9027,5,7,13,10,38,54,-16,34
AaB,9027,6,7,11,12,32,39,-7,32
Sonderjyske,9027,7,8,6,10,28,29,-1,30
Lyngby,9027,8,4,9,11,28,44,-16,21
Randers FC,9027,9,5,6,13,23,41,-18,21
Silkeborg IF,9027,10,5,4,13,25,44,-19,19
AGF Aarhus,9027,11,4,7,11,16,36,-20,19
Brondby,9028,1,19,8,3,70,35,35,65
FC Midtjylla,9028,2,19,5,6,68,40,28,62
FC Nords,9028,3,15,8,7,75,51,24,53
Copenhagen,9028,4,14,4,12,57,45,12,46
AaB,9028,5,7,13,10,38,45,-7,34
AC Horsens,9028,6,7,12,11,36,54,-18,33
Sonderjyske,9028,7,8,6,10,28,29,-1,30
Randers FC,9028,8,5,7,12,24,40,-16,22
AGF Aarhus,9028,9,5,6,11,18,36,-18,21
Lyngby,9028,10,3,10,11,27,45,-18,19
Silkeborg IF,9028,11,5,3,14,25,46,-21,18
Brondby,9029,1,20,5,5,71,36,35,65
FC Midtjylla,9029,2,19,5,6,65,45,20,62
Copenhagen,9029,3,16,4,10,61,40,21,52
FC Nords,9029,4,15,6,9,74,53,21,51
AaB,9029,5,9,12,9,44,42,2,39
Sonderjyske,9029,6,8,6,10,28,29,-1,30
AC Horsens,9029,7,5,12,13,33,58,-25,27
Randers FC,9029,8,6,6,12,26,40,-14,24
AGF Aarhus,9029,9,5,6,11,19,37,-18,21
Lyngby,9029,10,3,9,12,27,47,-20,18
Silkeborg IF,9029,11,5,3,14,26,47,-21,18
Brondby,9030,1,21,6,3,76,32,44,69
FC Midtjylla,9030,2,21,4,5,66,40,26,67
FC Nords,9030,3,14,6,10,72,51,21,48
Copenhagen,9030,4,14,5,11,59,46,13,47
AaB,9030,5,8,11,11,40,47,-7,35
Sonderjyske,9030,6,8,6,10,28,29,-1,30
AC Horsens,9030,7,6,12,12,35,58,-23,30
Randers FC,9030,8,6,6,12,26,40,-14,24
Silkeborg IF,9030,9,6,3,13,26,44,-18,21
Lyngby,9030,10,3,9,12,27,47,-20,18
AGF Aarhus,9030,11,4,6,12,16,37,-21,18
Brondby,9031,1,22,5,3,74,32,42,71
FC Midtjylla,9031,2,21,4,5,68,39,29,67
FC Nords,9031,3,14,6,10,76,55,21,48
Copenhagen,9031,4,13,4,13,56,49,7,43
AC Horsens,9031,5,8,12,10,38,55,-17,36
AaB,9031,6,7,11,12,36,44,-8,32
Sonderjyske,9031,7,8,6,10,28,29,-1,30
Lyngby,9031,8,4,9,11,28,45,-17,21
Silkeborg IF,9031,8,6,3,13,28,45,-17,21
Randers FC,9031,10,5,6,13,24,41,-17,21
AGF Aarhus,9031,11,4,6,12,17,39,-22,18
Brondby,9032,1,20,6,4,69,33,36,66
FC Midtjylla,9032,2,18,5,7,64,43,21,59
FC Nords,9032,3,17,6,7,76,46,30,57
Copenhagen,9032,4,13,5,12,55,48,7,44
AaB,9032,5,7,14,9,38,42,-4,35
AC Horsens,9032,6,6,14,10,37,53,-16,32
Sonderjyske,9032,7,8,6,10,28,29,-1,30
Lyngby,9032,8,4,9,11,28,44,-16,21
Randers FC,9032,9,5,6,13,23,41,-18,21
AGF Aarhus,9032,10,5,6,11,19,37,-18,21
Silkeborg IF,9032,11,5,3,14,26,47,-21,18
Brondby,9033,1,20,7,3,70,30,40,67
FC Midtjylla,9033,2,18,7,5,65,38,27,61
Copenhagen,9033,3,14,5,11,59,44,15,47
FC Nords,9033,4,13,7,10,70,53,17,46
AaB,9033,5,8,12,10,35,46,-11,36
AC Horsens,9033,6,7,14,9,35,49,-14,35
Sonderjyske,9033,7,8,6,10,28,29,-1,30
Lyngby,9033,8,4,9,11,29,45,-16,21
Silkeborg IF,9033,9,6,3,13,27,45,-18,21
Randers FC,9033,10,5,6,13,24,42,-18,21
AGF Aarhus,9033,11,4,6,12,17,38,-21,18
Brondby,9034,1,21,7,2,70,32,38,70
FC Midtjylla,9034,2,17,6,7,61,41,20,57
FC Nords,9034,3,16,6,8,84,58,26,54
Copenhagen,9034,4,13,5,12,55,46,9,44
AC Horsens,9034,5,7,13,10,38,52,-14,34
AaB,9034,6,6,15,9,38,43,-5,33
Sonderjyske,9034,7,8,6,10,28,29,-1,30
Randers FC,9034,8,5,7,12,23,39,-16,22
Silkeborg IF,9034,9,6,3,13,27,45,-18,21
Lyngby,9034,10,3,10,11,26,44,-18,19
AGF Aarhus,9034,11,4,6,12,17,38,-21,18
Brondby,9035,1,21,6,3,68,28,40,69
FC Midtjylla,9035,2,20,4,6,63,37,26,64
Copenhagen,9035,3,17,4,9,59,39,20,55
FC Nords,9035,4,13,8,9,69,50,19,47
AaB,9035,5,7,11,12,33,43,-10,32
Sonderjyske,9035,6,8,6,10,28,29,-1,30
AC Horsens,9035,7,5,13,12,33,54,-21,28
Lyngby,9035,8,4,9,11,28,44,-16,21
Silkeborg IF,9035,9,6,3,13,28,46,-18,21
Randers FC,9035,10,5,6,13,23,41,-18,21
AGF Aarhus,9035,11,4,6,12,18,39,-21,18
Brondby,9036,1,20,7,3,70,32,38,67
FC Midtjylla,9036,2,18,5,7,62,44,18,59
Copenhagen,9036,3,14,6,10,57,43,14,48
FC Nords,9036,4,13,6,11,68,51,17,45
AaB,9036,5,9,11,10,37,40,-3,38
AC Horsens,9036,6,8,13,9,41,51,-10,37
Sonderjyske,9036,7,8,6,10,28,29,-1,30
Randers FC,9036,8,5,7,12,24,40,-16,22
Lyngby,9036,9,3,10,11,27,45,-18,19
Silkeborg IF,9036,10,5,4,13,25,44,-19,19
AGF Aarhus,9036,11,4,7,11,16,36,-20,19
Brondby,9037,1,21,5,4,71,32,39,68
FC Midtjylla,9037,2,17,7,6,59,39,20,58
FC Nords,9037,3,15,7,8,75,51,24,52
Copenhagen,9037,4,16,4,10,63,44,19,52
AaB,9037,5,7,13,10,37,44,-7,34
Sonderjyske,9037,6,8,6,10,28,29,-1,30
AC Horsens,9037,7,5,14,11,33,54,-21,29
Randers FC,9037,8,6,6,12,26,39,-13,24
Silkeborg IF,9037,9,5,4,13,26,45,-19,19
AGF Aarhus,9037,10,4,7,11,17,37,-20,19
Lyngby,9037,11,3,9,12,26,47,-21,18
Brondby,9038,1,19,7,4,64,34,30,64
FC Midtjylla,9038,2,18,5,7,62,41,21,59
FC Nords,9038,3,16,7,7,80,48,32,55
Copenhagen,9038,4,14,6,10,57,43,14,48
AaB,9038,5,9,11,10,38,44,-6,38
Sonderjyske,9038,6,8,6,10,28,29,-1,30
AC Horsens,9038,7,6,12,12,39,56,-17,30
Randers FC,9038,8,5,7,12,23,39,-16,22
Silkeborg IF,9038,9,6,3,13,28,45,-17,21
Lyngby,9038,10,3,10,11,26,44,-18,19
AGF Aarhus,9038,11,4,6,12,17,39,-22,18
Brondby,9039,1,21,7,2,69,30,39,70
FC Midtjylla,9039,2,19,4,7,63,38,25,61
Copenhagen,9039,3,15,5,10,59,44,15,50
FC Nords,9039,4,12,6,12,66,54,12,42
AaB,9039,5,10,11,9,39,40,-1,41
AC Horsens,9039,6,6,13,11,37,53,-16,31
Sonderjyske,9039,7,8,6,10,28,29,-1,30
Lyngby,9039,8,4,9,11,28,44,-16,21
Randers FC,9039,9,5,6,13,23,41,-18,21
Silkeborg IF,9039,10,5,4,13,27,46,-19,19
AGF Aarhus,9039,11,4,7,11,18,38,-20,19
FC Midtjylla,9040,1,19,6,5,64,38,26,63
Brondby,9040,2,18,8,4,65,33,32,62
Copenhagen,9040,3,15,6,9,60,42,18,51
FC Nords,9040,4,13,9,8,75,51,24,48
AaB,9040,5,8,11,11,35,41,-6,35
AC Horsens,9040,6,6,14,10,32,52,-20,32
Sonderjyske,9040,7,8,6,10,28,29,-1,30
Randers FC,9040,8,6,6,12,25,40,-15,24
Silkeborg IF,9040,9,6,3,13,26,44,-18,21
Lyngby,9040,10,3,9,12,27,46,-19,18
AGF Aarhus,9040,11,4,6,12,16,37,-21,18
Brondby,9041,1,21,5,4,70,35,35,68
FC Midtjylla,9041,2,20,5,5,68,37,31,65
FC Nords,9041,3,15,7,8,74,51,23,52
Copenhagen,9041,4,16,4,10,60,42,18,52
Sonderjyske,9041,5,8,6,10,28,29,-1,30
AaB,9041,6,6,12,12,37,48,-11,30
AC Horsens,9041,7,5,13,12,33,55,-22,28
Lyngby,9041,8,4,9,11,30,46,-16,21
Silkeborg IF,9041,9,6,3,13,27,45,-18,21
Randers FC,9041,10,5,6,13,25,43,-18,21
AGF Aarhus,9041,11,4,6,12,17,38,-21,18
Brondby,9042,1,21,5,4,77,34,43,68
FC Midtjylla,9042,2,19,5,6,64,40,24,62
Copenhagen,9042,3,15,5,10,62,46,16,50
FC Nords,9042,4,14,7,9,75,61,14,49
AaB,9042,5,8,11,11,37,42,-5,35
AC Horsens,9042,6,6,13,11,38,56,-18,31
Sonderjyske,9042,7,8,6,10,28,29,-1,30
Randers FC,9042,8,6,6,12,25,40,-15,24
AGF Aarhus,9042,9,5,6,11,18,37,-19,21
Lyngby,9042,10,3,9,12,27,46,-19,18
Silkeborg IF,9042,11,5,3,14,26,46,-20,18
Brondby,9043,1,21,6,3,70,32,38,69
FC Midtjylla,9043,2,21,4,5,70,38,32,67
FC Nords,9043,3,14,7,9,72,54,18,49
Copenhagen,9043,4,12,6,12,55,48,7,42
AC Horsens,9043,5,7,14,9,35,49,-14,35
AaB,9043,6,6,13,11,34,41,-7,31
Sonderjyske,9043,7,8,6,10,28,29,-1,30
Randers FC,9043,8,6,6,12,25,40,-15,24
Silkeborg IF,9043,9,6,3,13,29,45,-16,21
Lyngby,9043,10,3,9,12,27,46,-19,18
AGF Aarhus,9043,11,4,6,12,17,40,-23,18
Brondby,9044,1,22,6,2,78,31,47,72
FC Midtjylla,9044,2,19,5,6,62,38,24,62
FC Nords,9044,3,12,10,8,76,57,19,46
Copenhagen,9044,4,13,6,11,59,49,10,45
AaB,9044,5,7,14,9,39,47,-8,35
AC Horsens,9044,6,6,13,11,39,57,-18,31
Sonderjyske,9044,7,8,6,10,28,29,-1,30
Lyngby,9044,8,4,9,11,27,44,-17,21
Randers FC,9044,9,5,6,13,23,40,-17,21
AGF Aarhus,9044,10,5,6,11,18,37,-19,21
Silkeborg IF,9044,11,5,3,14,26,46,-20,18
FC Midtjylla,9045,1,21,5,4,69,36,33,68
Brondby,9045,2,19,6,5,68,36,32,63
FC Nords,9045,3,13,7,10,72,55,17,46
Copenhagen,9045,4,13,5,12,53,44,9,44
AaB,9045,5,9,12,9,42,42,0,39
AC Horsens,9045,6,7,13,10,36,53,-17,34
Sonderjyske,9045,7,8,6,10,28,29,-1,30
Lyngby,9045,8,4,9,11,29,45,-16,21
Silkeborg IF,9045,9,6,3,13,28,44,-16,21
Randers FC,9045,10,5,6,13,24,42,-18,21
AGF Aarhus,9045,11,4,6,12,16,39,-23,18
Brondby,9046,1,22,6,2,73,31,42,72
FC Midtjylla,9046,2,18,5,7,61,41,20,59
FC Nords,9046,3,15,7,8,74,51,23,52
Copenhagen,9046,4,13,7,10,53,40,13,46
AaB,9046,5,6,14,10,32,39,-7,32
AC Horsens,9046,6,6,13,11,33,50,-17,31
Sonderjyske,9046,7,8,6,10,28,29,-1,30
Lyngby,9046,8,4,9,11,29,46,-17,21
Randers FC,9046,9,5,6,13,25,42,-17,21
Silkeborg IF,9046,10,5,4,13,26,45,-19,19
AGF Aarhus,9046,11,4,7,11,17,37,-20,19
Brondby,9047,1,21,6,3,68,31,37,69
FC Midtjylla,9047,2,18,7,5,67,39,28,61
Copenhagen,9047,3,15,5,10,57,42,15,50
FC Nords,9047,4,13,8,9,68,48,20,47
AaB,9047,5,7,14,9,34,37,-3,35
Sonderjyske,9047,6,8,6,10,28,29,-1,30
AC Horsens,9047,7,6,12,12,32,55,-23,30
Randers FC,9047,8,6,6,12,24,39,-15,24
Silkeborg IF,9047,9,6,3,13,27,45,-18,21
Lyngby,9047,10,3,9,12,26,45,-19,18
AGF Aarhus,9047,11,4,6,12,17,38,-21,18
Brondby,9048,1,22,6,2,70,30,40,72
FC Midtjylla,9048,2,18,6,6,67,43,24,60
FC Nords,9048,3,16,6,8,80,52,28,54
Copenhagen,9048,4,12,5,13,53,49,4,41
AaB,9048,5,7,13,10,36,42,-6,34
AC Horsens,9048,6,7,12,11,39,55,-16,33
Sonderjyske,9048,7,8,6,10,28,29,-1,30
Lyngby,9048,8,4,9,11,29,44,-15,21
Randers FC,9048,9,5,6,13,23,42,-19,21
AGF Aarhus,9048,10,5,6,11,18,37,-19,21
Silkeborg IF,9048,11,5,3,14,26,46,-20,18
Brondby,9049,1,20,5,5,71,40,31,65
FC Midtjylla,9049,2,17,7,6,63,43,20,58
FC Nords,9049,3,14,9,7,75,50,25,51
Copenhagen,9049,4,13,5,12,61,50,11,44
AaB,9049,5,8,13,9,38,42,-4,37
AC Horsens,9049,6,8,13,9,42,51,-9,37
Sonderjyske,9049,7,8,6,10,28,29,-1,30
Randers FC,9049,8,5,7,12,24,40,-16,22
Silkeborg IF,9049,9,6,3,13,26,44,-18,21
Lyngby,9049,10,3,10,11,27,45,-18,19
AGF Aarhus,9049,11,4,6,12,16,37,-21,18
Brondby,9050,1,19,8,3,69,33,36,65
FC Midtjylla,9050,2,19,5,6,68,43,25,62
FC Nords,9050,3,15,7,8,79,54,25,52
Copenhagen,9050,4,13,5,12,57,51,6,44
AaB,9050,5,9,11,10,39,43,-4,38
AC Horsens,9050,6,6,14,10,36,50,-14,32
Sonderjyske,9050,7,8,6,10,28,29,-1,30
Randers FC,9050,8,5,7,12,23,39,-16,22
Silkeborg IF,9050,9,6,3,13,27,45,-18,21
Lyngby,9050,10,3,10,11,26,44,-18,19
AGF Aarhus,9050,11,4,6,12,17,38,-21,18
FC Midtjylla,9051,1,21,5,4,71,39,32,68
Brondby,9051,2,20,5,5,68,32,36,65
FC Nords,9051,3,14,8,8,73,51,22,50
Copenhagen,9051,4,14,5,11,59,44,15,47
AC Horsens,9051,5,6,14,10,38,55,-17,32
AaB,9051,6,6,13,11,35,49,-14,31
Sonderjyske,9051,7,8,6,10,28,29,-1,30
Randers FC,9051,8,6,6,12,27,39,-12,24
AGF Aarhus,9051,9,5,6,11,17,36,-19,21
Silkeborg IF,9051,10,5,3,14,25,45,-20,18
Lyngby,9051,11,3,9,12,26,48,-22,18
Brondby,9052,1,20,6,4,69,32,37,66
FC Midtjylla,9052,2,20,5,5,66,37,29,65
FC Nords,9052,3,14,6,10,76,58,18,48
Copenhagen,9052,4,14,6,10,55,40,15,48
AC Horsens,9052,5,7,13,10,35,52,-17,34
AaB,9052,6,7,12,11,39,47,-8,33
Sonderjyske,9052,7,8,6,10,28,29,-1,30
Lyngby,9052,8,4,9,11,29,45,-16,21
Randers FC,9052,9,5,6,13,24,42,-18,21
Silkeborg IF,9052,10,5,4,13,29,48,-19,19
AGF Aarhus,9052,11,4,7,11,20,40,-20,19
Brondby,9053,1,21,6,3,71,30,41,69
FC Midtjylla,9053,2,20,5,5,65,40,25,65
Copenhagen,9053,3,15,4,11,56,42,14,49
FC Nords,9053,4,12,7,11,67,54,13,43
AaB,9053,5,8,13,9,38,41,-3,37
AC Horsens,9053,6,6,13,11,35,51,-16,31
Sonderjyske,9053,7,8,6,10,28,29,-1,30
Randers FC,9053,8,6,6,12,26,41,-15,24
Silkeborg IF,9053,9,6,3,13,26,44,-18,21
Lyngby,9053,10,3,9,12,28,47,-19,18
AGF Aarhus,9053,11,4,6,12,16,37,-21,18
Brondby,9054,1,20,6,4,66,30,36,66
FC Midtjylla,9054,2,18,5,7,69,42,27,59
FC Nords,9054,3,15,8,7,80,49,31,53
Copenhagen,9054,4,13,4,13,57,54,3,43
AaB,9054,5,8,13,9,39,41,-2,37
AC Horsens,9054,6,8,12,10,35,56,-21,36
Sonderjyske,9054,7,8,6,10,28,29,-1,30
Randers FC,9054,8,6,6,12,24,39,-15,24
AGF Aarhus,9054,9,5,6,11,21,39,-18,21
Lyngby,9054,10,3,9,12,26,45,-19,18
Silkeborg IF,9054,11,5,3,14,28,49,-21,18
Brondby,9055,1,21,7,2,76,35,41,70
FC Midtjylla,9055,2,20,4,6,69,42,27,64
FC Nords,9055,3,14,7,9,79,51,28,49
Copenhagen,9055,4,13,4,13,56,48,8,43
AaB,9055,5,8,12,10,38,45,-7,36
AC Horsens,9055,6,6,14,10,35,58,-23,32
Sonderjyske,9055,7,8,6,10,28,29,-1,30
Lyngby,9055,8,4,9,11,27,44,-17,21
Randers FC,9055,9,5,6,13,23,40,-17,21
AGF Aarhus,9055,10,5,6,11,19,36,-17,21
Silkeborg IF,9055,11,5,3,14,25,47,-22,18
Brondby,9056,1,21,6,3,67,30,37,69
FC Midtjylla,9056,2,18,6,6,61,37,24,60
FC Nords,9056,3,14,8,8,75,54,21,50
Copenhagen,9056,4,12,7,11,57,46,11,43
AaB,9056,5,8,12,10,39,41,-2,36
AC Horsens,9056,6,7,13,10,34,51,-17,34
Sonderjyske,9056,7,8,6,10,28,29,-1,30
Randers FC,9056,8,6,6,12,25,40,-15,24
Silkeborg IF,9056,9,6,3,13,27,44,-17,21
Lyngby,9056,10,3,9,12,27,46,-19,18
AGF Aarhus,9056,11,4,6,12,16,38,-22,18
Brondby,9057,1,20,6,4,69,33,36,66
FC Midtjylla,9057,2,18,4,8,61,48,13,58
Copenhagen,9057,3,15,5,10,59,41,18,50
FC Nords,9057,4,13,7,10,71,56,15,46
AaB,9057,5,8,13,9,40,40,0,37
AC Horsens,9057,6,7,15,8,37,45,-8,36
Sonderjyske,9057,7,8,6,10,28,29,-1,30
Randers FC,9057,8,5,7,12,24,40,-16,22
Lyngby,9057,9,3,10,11,27,45,-18,19
Silkeborg IF,9057,10,5,4,13,26,45,-19,19
AGF Aarhus,9057,11,4,7,11,17,37,-20,19
Brondby,9058,1,20,5,5,74,42,32,65
FC Midtjylla,9058,2,19,6,5,67,39,28,63
FC Nords,9058,3,14,8,8,72,51,21,50
Copenhagen,9058,4,13,5,12,55,48,7,44
AC Horsens,9058,5,9,12,9,41,48,-7,39
AaB,9058,6,7,12,11,36,43,-7,33
Sonderjyske,9058,7,8,6,10,28,29,-1,30
Randers FC,9058,8,6,6,12,24,39,-15,24
Silkeborg IF,9058,9,6,3,13,27,44,-17,21
Lyngby,9058,10,3,9,12,26,45,-19,18
AGF Aarhus,9058,11,4,6,12,16,38,-22,18
Brondby,9059,1,22,5,3,71,32,39,71
FC Midtjylla,9059,2,19,4,7,63,38,25,61
FC Nords,9059,3,15,6,9,75,53,22,51
Copenhagen,9059,4,14,4,12,55,44,11,46
AaB,9059,5,8,11,11,36,44,-8,35
AC Horsens,9059,6,7,12,11,39,54,-15,33
Sonderjyske,9059,7,8,6,10,28,29,-1,30
Randers FC,9059,8,6,6,12,24,39,-15,24
AGF Aarhus,9059,9,5,6,11,20,38,-18,21
Lyngby,9059,10,3,9,12,26,45,-19,18
Silkeborg IF,9059,11,5,3,14,27,48,-21,18
FC Midtjylla,9060,1,20,6,4,66,38,28,66
Brondby,9060,2,20,5,5,71,35,36,65
FC Nords,9060,3,15,7,8,75,52,23,52
Copenhagen,9060,4,14,5,11,58,45,13,47
AaB,9060,5,7,12,11,34,45,-11,33
AC Horsens,9060,6,6,13,11,38,53,-15,31
Sonderjyske,9060,7,8,6,10,28,29,-1,30
Lyngby,9060,8,4,9,11,28,45,-17,21
Randers FC,9060,9,5,6,13,24,41,-17,21
Silkeborg IF,9060,10,5,4,13,25,44,-19,19
AGF Aarhus,9060,11,4,7,11,16,36,-20,19
Brondby,9061,1,21,6,3,74,34,40,69
FC Midtjylla,9061,2,19,5,6,68,44,24,62
Copenhagen,9061,3,16,4,10,64,46,18,52
FC Nords,9061,4,14,6,10,73,54,19,48
AaB,9061,5,7,12,11,39,45,-6,33
AC Horsens,9061,6,6,13,11,35,56,-21,31
Sonderjyske,9061,7,8,6,10,28,29,-1,30
Randers FC,9061,8,6,6,12,24,39,-15,24
Silkeborg IF,9061,9,5,4,13,26,45,-19,19
AGF Aarhus,9061,10,4,7,11,17,37,-20,19
Lyngby,9061,11,3,9,12,26,45,-19,18
Brondby,9062,1,21,6,3,70,32,38,69
FC Midtjylla,9062,2,19,5,6,69,47,22,62
FC Nords,9062,3,15,8,7,80,49,31,53
Copenhagen,9062,4,13,6,11,58,49,9,45
AaB,9062,5,8,12,10,37,41,-4,36
Sonderjyske,9062,6,8,6,10,28,29,-1,30
AC Horsens,9062,7,5,13,12,34,56,-22,28
Lyngby,9062,8,4,9,11,27,44,-17,21
Randers FC,9062,9,5,6,13,23,40,-17,21
Silkeborg IF,9062,10,5,4,13,26,45,-19,19
AGF Aarhus,9062,11,4,7,11,17,37,-20,19
Brondby,9063,1,22,5,3,69,29,40,71
FC Midtjylla,9063,2,18,5,7,61,39,22,59
Copenhagen,9063,3,14,6,10,59,43,16,48
FC Nords,9063,4,13,8,9,70,48,22,47
AaB,9063,5,9,12,9,38,40,-2,39
Sonderjyske,9063,6,8,6,10,28,29,-1,30
AC Horsens,9063,7,6,12,12,31,55,-24,30
Lyngby,9063,8,4,9,11,30,44,-14,21
Silkeborg IF,9063,9,6,3,13,27,45,-18,21
Randers FC,9063,10,5,6,13,23,43,-20,21
AGF Aarhus,9063,11,4,6,12,17,38,-21,18
FC Midtjylla,9064,1,21,5,4,68,38,30,68
Brondby,9064,2,20,7,3,70,32,38,67
Copenhagen,9064,3,14,6,10,61,46,15,48
FC Nords,9064,4,12,8,10,70,56,14,44
AaB,9064,5,7,12,11,38,45,-7,33
AC Horsens,9064,6,6,14,10,38,54,-16,32
Sonderjyske,9064,7,8,6,10,28,29,-1,30
Lyngby,9064,8,4,9,11,28,45,-17,21
Randers FC,9064,9,5,6,13,24,41,-17,21
Silkeborg IF,9064,10,6,3,13,28,46,-18,21
AGF Aarhus,9064,11,4,6,12,18,39,-21,18
Brondby,9065,1,22,6,2,73,29,44,72
FC Midtjylla,9065,2,18,6,6,62,36,26,60
FC Nords,9065,3,14,8,8,71,48,23,50
Copenhagen,9065,4,14,5,11,59,47,12,47
AC Horsens,9065,5,7,12,11,34,51,-17,33
AaB,9065,6,7,11,12,34,48,-14,32
Sonderjyske,9065,7,8,6,10,28,29,-1,30
Lyngby,9065,8,4,9,11,27,44,-17,21
Randers FC,9065,9,5,6,13,23,40,-17,21
Silkeborg IF,9065,10,5,4,13,27,46,-19,19
AGF Aarhus,9065,11,4,7,11,18,38,-20,19
Brondby,9066,1,20,7,3,72,34,38,67
FC Midtjylla,9066,2,20,5,5,66,41,25,65
FC Nords,9066,3,14,7,9,73,52,21,49
Copenhagen,9066,4,13,7,10,58,44,14,46
AaB,9066,5,7,13,10,36,41,-5,34
AC Horsens,9066,6,6,13,11,39,58,-19,31
Sonderjyske,9066,7,8,6,10,28,29,-1,30
Randers FC,9066,8,6,6,12,28,40,-12,24
Silkeborg IF,9066,9,5,4,13,27,46,-19,19
AGF Aarhus,9066,10,4,7,11,18,38,-20,19
Lyngby,9066,11,3,9,12,27,49,-22,18
Brondby,9067,1,20,6,4,76,40,36,66
FC Midtjylla,9067,2,20,5,5,66,40,26,65
FC Nords,9067,3,15,7,8,77,52,25,52
Copenhagen,9067,4,13,5,12,57,50,7,44
AaB,9067,5,7,13,10,37,41,-4,34
AC Horsens,9067,6,6,14,10,34,50,-16,32
Sonderjyske,9067,7,8,6,10,28,29,-1,30
Randers FC,9067,8,6,6,12,25,40,-15,24
Silkeborg IF,9067,9,5,4,13,26,45,-19,19
AGF Aarhus,9067,10,4,7,11,17,37,-20,19
Lyngby,9067,11,3,9,12,27,46,-19,18
Brondby,9068,1,21,6,3,74,34,40,69
FC Midtjylla,9068,2,20,4,6,73,48,25,64
FC Nords,9068,3,13,9,8,72,51,21,48
Copenhagen,9068,4,13,6,11,61,50,11,45
AaB,9068,5,8,12,10,42,46,-4,36
AC Horsens,9068,6,6,13,11,36,55,-19,31
Sonderjyske,9068,7,8,6,10,28,29,-1,30
Randers FC,9068,8,5,7,12,25,41,-16,22
Lyngby,9068,9,3,10,11,28,46,-18,19
Silkeborg IF,9068,10,5,4,13,28,47,-19,19
AGF Aarhus,9068,11,4,7,11,19,39,-20,19
Brondby,9069,1,21,7,2,71,31,40,70
FC Midtjylla,9069,2,19,5,6,62,41,21,62
FC Nords,9069,3,15,7,8,81,47,34,52
Copenhagen,9069,4,13,5,12,54,47,7,44
AaB,9069,5,9,12,9,39,41,-2,39
Sonderjyske,9069,6,8,6,10,28,29,-1,30
AC Horsens,9069,7,5,12,13,30,56,-26,27
Lyngby,9069,8,4,9,11,29,46,-17,21
Silkeborg IF,9069,9,6,3,13,27,44,-17,21
Randers FC,9069,10,5,6,13,25,42,-17,21
AGF Aarhus,9069,11,4,6,12,16,38,-22,18
Brondby,9070,1,21,6,3,69,29,40,69
FC Midtjylla,9070,2,21,4,5,68,39,29,67
FC Nords,9070,3,15,6,9,75,54,21,51
Copenhagen,9070,4,12,5,13,54,47,7,41
AaB,9070,5,8,12,10,37,40,-3,36
AC Horsens,9070,6,6,13,11,35,55,-20,31
Sonderjyske,9070,7,8,6,10,28,29,-1,30
Silkeborg IF,9070,8,6,3,13,32,45,-13,21
Lyngby,9070,9,4,9,11,30,45,-15,21
Randers FC,9070,10,5,6,13,24,43,-19,21
AGF Aarhus,9070,11,4,6,12,17,43,-26,18
Brondby,9071,1,21,7,2,75,30,45,70
FC Midtjylla,9071,2,18,5,7,62,44,18,59
Copenhagen,9071,3,15,6,9,61,43,18,51
FC Nords,9071,4,12,7,11,67,52,15,43
AC Horsens,9071,5,7,14,9,38,50,-12,35
AaB,9071,6,7,13,10,38,48,-10,34
Sonderjyske,9071,7,8,6,10,28,29,-1,30
Lyngby,9071,8,4,9,11,28,45,-17,21
Randers FC,9071,9,5,6,13,24,41,-17,21
AGF Aarhus,9071,10,5,6,11,19,36,-17,21
Silkeborg IF,9071,11,5,3,14,25,47,-22,18
Brondby,9072,1,21,6,3,71,29,42,69
FC Midtjylla,9072,2,20,5,5,66,41,25,65
FC Nords,9072,3,15,6,9,76,51,25,51
Copenhagen,9072,4,13,5,12,53,44,9,44
AaB,9072,5,7,12,11,36,44,-8,33
AC Horsens,9072,6,6,14,10,35,54,-19,32
Sonderjyske,9072,7,8,6,10,28,29,-1,30
Randers FC,9072,8,6,6,12,24,39,-15,24
Silkeborg IF,9072,9,6,3,13,26,44,-18,21
Lyngby,9072,10,3,9,12,26,45,-19,18
AGF Aarhus,9072,11,4,6,12,16,37,-21,18
Brondby,9073,1,21,6,3,72,33,39,69
FC Midtjylla,9073,2,20,4,6,68,39,29,64
Copenhagen,9073,3,15,5,10,59,42,17,50
FC Nords,9073,4,12,9,9,70,55,15,45
AaB,9073,5,8,12,10,41,47,-6,36
Sonderjyske,9073,6,8,6,10,28,29,-1,30
AC Horsens,9073,7,5,14,11,37,57,-20,29
Lyngby,9073,8,4,9,11,27,44,-17,21
Silkeborg IF,9073,8,6,3,13,27,44,-17,21
Randers FC,9073,10,5,6,13,23,40,-17,21
AGF Aarhus,9073,11,4,6,12,16,38,-22,18
Brondby,9074,1,22,5,3,72,31,41,71
FC Midtjylla,9074,2,21,5,4,65,35,30,68
FC Nords,9074,3,13,7,10,70,52,18,46
Copenhagen,9074,4,12,6,12,55,47,8,42
AaB,9074,5,7,13,10,37,43,-6,34
AC Horsens,9074,6,5,16,9,36,53,-17,31
Sonderjyske,9074,7,8,6,10,28,29,-1,30
Randers FC,9074,8,5,7,12,23,39,-16,22
Lyngby,9074,9,3,10,11,26,44,-18,19
Silkeborg IF,9074,10,5,4,13,25,44,-19,19
AGF Aarhus,9074,11,4,7,11,16,36,-20,19
Brondby,9075,1,22,5,3,70,32,38,71
FC Midtjylla,9075,2,19,4,7,65,43,22,61
FC Nords,9075,3,15,7,8,73,46,27,52
Copenhagen,9075,4,14,5,11,56,44,12,47
AaB,9075,5,8,12,10,37,41,-4,36
Sonderjyske,9075,6,8,6,10,28,29,-1,30
AC Horsens,9075,7,5,13,12,32,53,-21,28
Randers FC,9075,8,6,6,12,25,39,-14,24
AGF Aarhus,9075,9,5,6,11,18,36,-18,21
Lyngby,9075,10,3,9,12,26,46,-20,18
Silkeborg IF,9075,11,5,3,14,25,46,-21,18
Brondby,9076,1,20,6,4,70,33,37,66
FC Midtjylla,9076,2,19,6,5,63,37,26,63
FC Nords,9076,3,14,8,8,75,53,22,50
Copenhagen,9076,4,13,6,11,58,45,13,45
AaB,9076,5,7,13,10,37,43,-6,34
AC Horsens,9076,6,7,13,10,34,52,-18,34
Sonderjyske,9076,7,8,6,10,28,29,-1,30
Randers FC,9076,8,6,6,12,24,39,-15,24
AGF Aarhus,9076,9,5,6,11,18,37,-19,21
Lyngby,9076,10,3,9,12,26,45,-19,18
Silkeborg IF,9076,11,5,3,14,26,46,-20,18
Brondby,9077,1,20,7,3,70,32,38,67
FC Midtjylla,9077,2,20,4,6,69,40,29,64
Copenhagen,9077,3,16,5,9,59,40,19,53
FC Nords,9077,4,12,7,11,69,55,14,43
AaB,9077,5,8,13,9,38,42,-4,37
Sonderjyske,9077,6,8,6,10,28,29,-1,30
AC Horsens,9077,7,6,12,12,33,55,-22,30
Randers FC,9077,8,5,7,12,25,41,-16,22
Silkeborg IF,9077,9,6,3,13,28,45,-17,21
Lyngby,9077,10,3,10,11,28,46,-18,19
AGF Aarhus,9077,11,4,6,12,17,39,-22,18
Brondby,9078,1,22,6,2,73,32,41,72
FC Midtjylla,9078,2,19,6,5,70,41,29,63
FC Nords,9078,3,13,8,9,74,53,21,47
Copenhagen,9078,4,13,6,11,55,44,11,45
AaB,9078,5,8,11,11,37,42,-5,35
AC Horsens,9078,6,6,13,11,33,56,-23,31
Sonderjyske,9078,7,8,6,10,28,29,-1,30
Randers FC,9078,8,5,7,12,25,41,-16,22
Lyngby,9078,9,3,10,11,28,46,-18,19
Silkeborg IF,9078,10,5,4,13,25,44,-19,19
AGF Aarhus,9078,11,4,7,11,16,36,-20,19
Brondby,9079,1,21,6,3,70,32,38,69
FC Midtjylla,9079,2,18,5,7,64,44,20,59
FC Nords,9079,3,15,7,8,77,54,23,52
Copenhagen,9079,4,13,5,12,56,45,11,44
AaB,9079,5,9,11,10,42,41,1,38
AC Horsens,9079,6,7,12,11,35,54,-19,33
Sonderjyske,9079,7,8,6,10,28,29,-1,30
Randers FC,9079,8,6,6,12,25,40,-15,24
Silkeborg IF,9079,9,6,3,13,26,44,-18,21
Lyngby,9079,10,3,9,12,27,46,-19,18
AGF Aarhus,9079,11,4,6,12,16,37,-21,18
Brondby,9080,1,22,5,3,75,31,44,71
FC Midtjylla,9080,2,20,4,6,64,37,27,64
Copenhagen,9080,3,16,4,10,60,42,18,52
FC Nords,9080,4,15,6,9,75,52,23,51
AaB,9080,5,7,11,12,34,45,-11,32
Sonderjyske,9080,6,8,6,10,28,29,-1,30
AC Horsens,9080,7,5,12,13,29,56,-27,27
Randers FC,9080,8,6,6,12,26,41,-15,24
Silkeborg IF,9080,9,5,4,13,26,45,-19,19
AGF Aarhus,9080,10,4,7,11,17,37,-20,19
Lyngby,9080,11,3,9,12,28,47,-19,18
Brondby,9081,1,21,7,2,70,29,41,70
FC Midtjylla,9081,2,19,5,6,66,40,26,62
FC Nords,9081,3,16,6,8,78,49,29,54
Copenhagen,9081,4,12,6,12,56,50,6,42
AaB,9081,5,7,12,11,38,46,-8,33
AC Horsens,9081,6,6,14,10,38,58,-20,32
Sonderjyske,9081,7,8,6,10,28,29,-1,30
Randers FC,9081,8,6,6,12,26,39,-13,24
Silkeborg IF,9081,9,5,4,13,27,46,-19,19
AGF Aarhus,9081,10,4,7,11,18,38,-20,19
Lyngby,9081,11,3,9,12,26,47,-21,18
Brondby,9082,1,20,7,3,70,34,36,67
FC Midtjylla,9082,2,20,4,6,66,39,27,64
FC Nords,9082,3,13,8,9,74,54,20,47
Copenhagen,9082,4,13,4,13,56,48,8,43
AaB,9082,5,9,13,8,42,40,2,40
AC Horsens,9082,6,6,14,10,31,50,-19,32
Sonderjyske,9082,7,8,6,10,28,29,-1,30
Randers FC,9082,8,5,7,12,25,41,-16,22
Lyngby,9082,9,3,10,11,28,46,-18,19
Silkeborg IF,9082,10,5,4,13,26,45,-19,19
AGF Aarhus,9082,11,4,7,11,17,37,-20,19
Brondby,9083,1,21,5,4,69,35,34,68
FC Midtjylla,9083,2,18,5,7,70,46,24,59
FC Nords,9083,3,15,7,8,76,49,27,52
Copenhagen,9083,4,15,4,11,58,44,14,49
AC Horsens,9083,5,8,12,10,39,57,-18,36
AaB,9083,6,6,13,11,35,42,-7,31
Sonderjyske,9083,7,8,6,10,28,29,-1,30
Lyngby,9083,8,4,9,11,28,44,-16,21
Randers FC,9083,9,5,6,13,23,41,-18,21
AGF Aarhus,9083,10,5,6,11,17,36,-19,21
Silkeborg IF,9083,11,5,3,14,25,45,-20,18
Brondby,9084,1,22,6,2,74,32,42,72
FC Midtjylla,9084,2,19,5,6,67,42,25,62
FC Nords,9084,3,14,7,9,75,55,20,49
Copenhagen,9084,4,13,5,12,57,45,12,44
AaB,9084,5,9,12,9,42,44,-2,39
Sonderjyske,9084,6,8,6,10,28,29,-1,30
AC Horsens,9084,7,5,13,12,31,54,-23,28
Randers FC,9084,8,6,6,12,25,40,-15,24
Silkeborg IF,9084,9,6,3,13,27,45,-18,21
Lyngby,9084,10,3,9,12,27,46,-19,18
AGF Aarhus,9084,11,4,6,12,17,38,-21,18
Brondby,9085,1,20,6,4,70,35,35,66
FC Midtjylla,9085,2,19,6,5,66,42,24,63
FC Nords,9085,3,15,7,8,74,50,24,52
Copenhagen,9085,4,15,4,11,59,43,16,49
AaB,9085,5,7,11,12,36,44,-8,32
AC Horsens,9085,6,6,14,10,33,50,-17,32
Sonderjyske,9085,7,8,6,10,28,29,-1,30
Lyngby,9085,8,4,9,11,29,44,-15,21
Randers FC,9085,9,5,6,13,23,42,-19,21
Silkeborg IF,9085,10,5,4,13,26,45,-19,19
AGF Aarhus,9085,11,4,7,11,17,37,-20,19
Brondby,9086,1,22,6,2,72,30,42,72
FC Midtjylla,9086,2,20,4,6,66,38,28,64
FC Nords,9086,3,14,6,10,71,52,19,48
Copenhagen,9086,4,13,5,12,54,45,9,44
AaB,9086,5,9,11,10,38,41,-3,38
Sonderjyske,9086,6,8,6,10,28,29,-1,30
AC Horsens,9086,7,6,12,12,33,54,-21,30
Lyngby,9086,8,4,9,11,27,44,-17,21
Randers FC,9086,9,5,6,13,23,40,-17,21
Silkeborg IF,9086,10,6,3,13,26,44,-18,21
AGF Aarhus,9086,11,4,6,12,16,37,-21,18
FC Midtjylla,9087,1,20,5,5,65,37,28,65
Brondby,9087,2,18,8,4,71,39,32,62
FC Nords,9087,3,13,9,8,71,50,21,48
Copenhagen,9087,4,13,7,10,61,47,14,46
AaB,9087,5,8,13,9,41,45,-4,37
AC Horsens,9087,6,6,14,10,33,50,-17,32
Sonderjyske,9087,7,8,6,10,28,29,-1,30
Randers FC,9087,8,6,6,12,26,41,-15,24
Silkeborg IF,9087,9,6,3,13,28,45,-17,21
Lyngby,9087,10,3,9,12,28,47,-19,18
AGF Aarhus,9087,11,4,6,12,17,39,-22,18
Brondby,9088,1,21,7,2,72,29,43,70
FC Midtjylla,9088,2,19,6,5,65,41,24,63
FC Nords,9088,3,14,7,9,72,50,22,49
Copenhagen,9088,4,13,4,13,57,46,11,43
AaB,9088,5,8,12,10,38,46,-8,36
AC Horsens,9088,6,6,14,10,37,55,-18,32
Sonderjyske,9088,7,8,6,10,28,29,-1,30
Randers FC,9088,8,5,7,12,24,40,-16,22
Silkeborg IF,9088,9,6,3,13,27,44,-17,21
Lyngby,9088,10,3,10,11,27,45,-18,19
AGF Aarhus,9088,11,4,6,12,16,38,-22,18
Brondby,9089,1,20,6,4,72,36,36,66
FC Midtjylla,9089,2,19,5,6,64,43,21,62
FC Nords,9089,3,16,7,7,75,46,29,55
Copenhagen,9089,4,13,5,12,56,45,11,44
AC Horsens,9089,5,7,13,10,39,52,-13,34
AaB,9089,6,6,14,10,34,44,-10,32
Sonderjyske,9089,7,8,6,10,28,29,-1,30
Lyngby,9089,8,4,9,11,28,44,-16,21
Silkeborg IF,9089,9,6,3,13,27,45,-18,21
Randers FC,9089,10,5,6,13,23,41,-18,21
AGF Aarhus,9089,11,4,6,12,17,38,-21,18
Brondby,9090,1,21,6,3,69,30,39,69
FC Midtjylla,9090,2,19,6,5,64,39,25,63
FC Nords,9090,3,13,7,10,70,53,17,46
Copenhagen,9090,4,14,4,12,56,42,14,46
AaB,9090,5,7,14,9,37,42,-5,35
AC Horsens,9090,6,7,13,10,33,49,-16,34
Sonderjyske,9090,7,8,6,10,28,29,-1,30
Randers FC,9090,8,6,6,12,25,39,-14,24
Silkeborg IF,9090,9,5,4,13,26,45,-19,19
AGF Aarhus,9090,10,4,7,11,17,37,-20,19
Lyngby,9090,11,3,9,12,26,46,-20,18
Brondby,9091,1,20,7,3,75,38,37,67
FC Midtjylla,9091,2,18,6,6,65,42,23,60
FC Nords,9091,3,16,6,8,76,50,26,54
Copenhagen,9091,4,14,5,11,62,49,13,47
AaB,9091,5,8,12,10,41,44,-3,36
Sonderjyske,9091,6,8,6,10,28,29,-1,30
AC Horsens,9091,7,6,12,12,33,55,-22,30
Randers FC,9091,8,6,6,12,25,39,-14,24
Silkeborg IF,9091,9,6,3,13,27,44,-17,21
Lyngby,9091,10,3,9,12,26,46,-20,18
AGF Aarhus,9091,11,4,6,12,16,38,-22,18
FC Midtjylla,9092,1,20,5,5,65,37,28,65
Brondby,9092,2,19,5,6,64,34,30,62
FC Nords,9092,3,15,7,8,71,47,24,52
Copenhagen,9092,4,14,5,11,54,40,14,47
AaB,9092,5,10,11,9,35,36,-1,41
Sonderjyske,9092,6,8,6,10,28,29,-1,30
AC Horsens,9092,7,5,13,12,32,53,-21,28
Randers FC,9092,8,6,6,12,26,40,-14,24
AGF Aarhus,9092,9,5,6,11,18,37,-19,21
Lyngby,9092,10,3,9,12,27,47,-20,18
Silkeborg IF,9092,11,5,3,14,26,46,-20,18
Brondby,9093,1,21,6,3,80,33,47,69
FC Midtjylla,9093,2,20,6,4,72,40,32,66
FC Nords,9093,3,14,7,9,77,57,20,49
Copenhagen,9093,4,13,4,13,59,53,6,43
AaB,9093,5,9,13,8,40,39,1,40
Sonderjyske,9093,6,8,6,10,28,29,-1,30
AC Horsens,9093,7,5,12,13,34,66,-32,27
Randers FC,9093,8,5,7,12,24,40,-16,22
Silkeborg IF,9093,9,6,3,13,27,44,-17,21
Lyngby,9093,10,3,10,11,27,45,-18,19
AGF Aarhus,9093,11,4,6,12,16,38,-22,18
Brondby,9094,1,22,6,2,77,33,44,72
FC Midtjylla,9094,2,19,4,7,62,43,19,61
FC Nords,9094,3,14,8,8,73,49,24,50
Copenhagen,9094,4,15,4,11,62,44,18,49
AC Horsens,9094,5,7,12,11,37,57,-20,33
Sonderjyske,9094,6,8,6,10,28,29,-1,30
AaB,9094,7,6,12,12,34,45,-11,30
Randers FC,9094,8,5,7,12,23,39,-16,22
AGF Aarhus,9094,9,5,6,11,18,36,-18,21
Lyngby,9094,10,3,10,11,26,44,-18,19
Silkeborg IF,9094,11,5,3,14,25,46,-21,18
Brondby,9095,1,20,5,5,67,34,33,65
FC Midtjylla,9095,2,19,7,4,62,36,26,64
FC Nords,9095,3,14,7,9,74,51,23,49
Copenhagen,9095,4,14,5,11,57,43,14,47
AaB,9095,5,8,13,9,37,39,-2,37
Sonderjyske,9095,6,8,6,10,28,29,-1,30
AC Horsens,9095,7,5,15,10,35,55,-20,30
Randers FC,9095,8,5,7,12,25,41,-16,22
Lyngby,9095,9,3,10,11,28,46,-18,19
Silkeborg IF,9095,10,5,4,13,26,45,-19,19
AGF Aarhus,9095,11,4,7,11,17,37,-20,19
Brondby,9096,1,21,6,3,79,36,43,69
FC Midtjylla,9096,2,20,4,6,69,44,25,64
Copenhagen,9096,3,16,5,9,63,41,22,53
FC Nords,9096,4,13,6,11,74,57,17,45
AaB,9096,5,7,13,10,36,46,-10,34
Sonderjyske,9096,6,8,6,10,28,29,-1,30
AC Horsens,9096,7,5,14,11,35,58,-23,29
Randers FC,9096,8,5,7,12,24,40,-16,22
AGF Aarhus,9096,9,5,6,11,17,36,-19,21
Lyngby,9096,10,3,10,11,27,45,-18,19
Silkeborg IF,9096,11,5,3,14,25,45,-20,18
FC Midtjylla,9097,1,22,4,4,66,35,31,70
Brondby,9097,2,21,6,3,74,31,43,69
FC Nords,9097,3,15,6,9,80,56,24,51
Copenhagen,9097,4,13,4,13,56,50,6,43
AC Horsens,9097,5,7,13,10,35,50,-15,34
Sonderjyske,9097,6,8,6,10,28,29,-1,30
AaB,9097,7,6,11,13,36,51,-15,29
Lyngby,9097,8,4,9,11,29,45,-16,21
Silkeborg IF,9097,9,6,3,13,27,44,-17,21
Randers FC,9097,10,5,6,13,24,42,-18,21
AGF Aarhus,9097,11,4,6,12,16,38,-22,18
Brondby,9098,1,21,5,4,72,32,40,68
FC Midtjylla,9098,2,20,5,5,67,39,28,65
Copenhagen,9098,3,14,6,10,58,42,16,48
FC Nords,9098,4,13,8,9,72,52,20,47
AC Horsens,9098,5,7,13,10,34,50,-16,34
AaB,9098,6,6,13,11,34,48,-14,31
Sonderjyske,9098,7,8,6,10,28,29,-1,30
Lyngby,9098,8,4,9,11,29,45,-16,21
Randers FC,9098,9,5,6,13,24,42,-18,21
AGF Aarhus,9098,10,5,6,11,18,37,-19,21
Silkeborg IF,9098,11,5,3,14,26,46,-20,18
Brondby,9099,1,22,6,2,74,33,41,72
FC Midtjylla,9099,2,18,5,7,64,45,19,59
FC Nords,9099,3,15,8,7,79,52,27,53
Copenhagen,9099,4,13,4,13,60,52,8,43
AC Horsens,9099,5,7,13,10,39,53,-14,34
AaB,9099,6,6,14,10,38,45,-7,32
Sonderjyske,9099,7,8,6,10,28,29,-1,30
Lyngby,9099,8,4,9,11,28,44,-16,21
Randers FC,9099,9,5,6,13,23,41,-18,21
AGF Aarhus,9099,10,5,6,11,18,37,-19,21
Silkeborg IF,9099,11,5,3,14,26,46,-20,18
Brondby,9100,1,21,6,3,68,31,37,69
FC Midtjylla,9100,2,18,5,7,62,42,20,59
FC Nords,9100,3,14,9,7,74,49,25,51
Copenhagen,9100,4,14,5,11,61,48,13,47
AaB,9100,5,8,11,11,38,41,-3,35
AC Horsens,9100,6,6,14,10,33,51,-18,32
Sonderjyske,9100,7,8,6,10,28,29,-1,30
Lyngby,9100,8,4,9,11,28,45,-17,21
Randers FC,9100,9,5,6,13,24,41,-17,21
Silkeborg IF,9100,10,5,4,13,25,44,-19,19
AGF Aarhus,9100,11,4,7,11,16,36,-20,19
FC Midtjylla,9101,1,19,7,4,64,36,28,64
Brondby,9101,2,19,6,5,68,36,32,63
FC Nords,9101,3,14,8,8,76,54,22,50
Copenhagen,9101,4,14,5,11,58,44,14,47
AaB,9101,5,9,12,9,36,37,-1,39
Sonderjyske,9101,6,8,6,10,28,29,-1,30
AC Horsens,9101,7,5,14,11,33,54,-21,29
Randers FC,9101,8,5,7,12,23,39,-16,22
AGF Aarhus,9101,9,5,6,11,18,37,-19,21
Lyngby,9101,10,3,10,11,26,44,-18,19
Silkeborg IF,9101,11,5,3,14,26,46,-20,18
Brondby,9102,1,20,7,3,70,32,38,67
FC Midtjylla,9102,2,20,5,5,68,41,27,65
FC Nords,9102,3,14,8,8,76,55,21,50
Copenhagen,9102,4,13,6,11,58,46,12,45
AaB,9102,5,8,11,11,39,45,-6,35
AC Horsens,9102,6,6,13,11,36,54,-18,31
Sonderjyske,9102,7,8,6,10,28,29,-1,30
Randers FC,9102,8,6,6,12,25,40,-15,24
AGF Aarhus,9102,9,5,6,11,20,38,-18,21
Lyngby,9102,10,3,9,12,27,46,-19,18
Silkeborg IF,9102,11,5,3,14,27,48,-21,18
Brondby,9103,1,22,6,2,74,33,41,72
FC Midtjylla,9103,2,19,5,6,70,43,27,62
FC Nords,9103,3,15,6,9,76,51,25,51
Copenhagen,9103,4,14,6,10,61,46,15,48
AaB,9103,5,8,11,11,40,45,-5,35
Sonderjyske,9103,6,8,6,10,28,29,-1,30
AC Horsens,9103,7,5,12,13,32,61,-29,27
Lyngby,9103,8,4,9,11,29,44,-15,21
Randers FC,9103,9,5,6,13,23,42,-19,21
AGF Aarhus,9103,10,5,6,11,17,36,-19,21
Silkeborg IF,9103,11,5,3,14,25,45,-20,18
Brondby,9104,1,20,6,4,67,32,35,66
FC Midtjylla,9104,2,19,5,6,67,39,28,62
FC Nords,9104,3,14,8,8,70,49,21,50
Copenhagen,9104,4,13,6,11,58,45,13,45
AaB,9104,5,9,12,9,39,43,-4,39
Sonderjyske,9104,6,8,6,10,28,29,-1,30
AC Horsens,9104,7,5,15,10,33,52,-19,30
Silkeborg IF,9104,8,6,3,13,28,44,-16,21
Lyngby,9104,9,4,9,11,27,44,-17,21
Randers FC,9104,10,5,6,13,23,40,-17,21
AGF Aarhus,9104,11,4,6,12,16,39,-23,18
Brondby,9105,1,22,5,3,72,29,43,71
FC Midtjylla,9105,2,20,5,5,65,37,28,65
FC Nords,9105,3,14,7,9,73,54,19,49
Copenhagen,9105,4,13,5,12,56,47,9,44
AaB,9105,5,7,13,10,37,43,-6,34
Sonderjyske,9105,6,8,6,10,28,29,-1,30
AC Horsens,9105,7,5,15,10,34,53,-19,30
Randers FC,9105,8,6,6,12,25,39,-14,24
Silkeborg IF,9105,9,5,4,13,26,45,-19,19
AGF Aarhus,9105,10,4,7,11,17,37,-20,19
Lyngby,9105,11,3,9,12,26,46,-20,18
Brondby,9106,1,19,5,6,66,36,30,62
FC Midtjylla,9106,2,18,6,6,64,38,26,60
FC Nords,9106,3,15,7,8,79,54,25,52
Copenhagen,9106,4,14,4,12,56,46,10,46
AaB,9106,5,9,13,8,40,37,3,40
AC Horsens,9106,6,7,13,10,36,56,-20,34
Sonderjyske,9106,7,8,6,10,28,29,-1,30
Randers FC,9106,8,6,6,12,25,40,-15,24
Silkeborg IF,9106,9,5,4,13,27,46,-19,19
AGF Aarhus,9106,10,4,7,11,18,38,-20,19
Lyngby,9106,11,3,9,12,27,46,-19,18
FC Midtjylla,9107,1,21,5,4,68,36,32,68
Brondby,9107,2,19,6,5,70,35,35,63
FC Nords,9107,3,15,8,7,74,48,26,53
Copenhagen,9107,4,12,6,12,53,48,5,42
AaB,9107,5,8,13,9,38,39,-1,37
Sonderjyske,9107,6,8,6,10,28,29,-1,30
AC Horsens,9107,7,5,14,11,32,55,-23,29
Lyngby,9107,8,4,9,11,27,44,-17,21
Randers FC,9107,9,5,6,13,23,40,-17,21
Silkeborg IF,9107,10,5,4,13,26,45,-19,19
AGF Aarhus,9107,11,4,7,11,17,37,-20,19
Brondby,9108,1,22,5,3,71,32,39,71
FC Midtjylla,9108,2,19,6,5,62,37,25,63
FC Nords,9108,3,14,8,8,79,53,26,50
Copenhagen,9108,4,14,6,10,59,44,15,48
AaB,9108,5,7,12,11,37,46,-9,33
Sonderjyske,9108,6,8,6,10,28,29,-1,30
AC Horsens,9108,7,5,13,12,32,54,-22,28
Lyngby,9108,8,4,9,11,28,44,-16,21
Randers FC,9108,9,5,6,13,23,41,-18,21
AGF Aarhus,9108,10,5,6,11,18,36,-18,21
Silkeborg IF,9108,11,5,3,14,25,46,-21,18
Brondby,9109,1,21,6,3,73,33,40,69
FC Midtjylla,9109,2,20,5,5,69,41,28,65
Copenhagen,9109,3,14,5,11,58,45,13,47
FC Nords,9109,4,13,7,10,74,58,16,46
AaB,9109,5,8,12,10,39,43,-4,36
AC Horsens,9109,6,6,13,11,35,54,-19,31
Sonderjyske,9109,7,8,6,10,28,29,-1,30
Randers FC,9109,8,5,7,12,24,40,-16,22
Silkeborg IF,9109,9,6,3,13,27,44,-17,21
Lyngby,9109,10,3,10,11,27,45,-18,19
AGF Aarhus,9109,11,4,6,12,16,38,-22,18
FC Midtjylla,9110,1,20,6,4,66,37,29,66
Brondby,9110,2,20,5,5,68,34,34,65
FC Nords,9110,3,14,7,9,72,53,19,49
Copenhagen,9110,4,14,4,12,64,51,13,46
AC Horsens,9110,5,8,13,9,40,52,-12,37
AaB,9110,6,7,11,12,38,47,-9,32
Sonderjyske,9110,7,8,6,10,28,29,-1,30
Randers FC,9110,8,6,6,12,25,39,-14,24
Silkeborg IF,9110,9,5,4,13,25,44,-19,19
AGF Aarhus,9110,10,4,7,11,16,36,-20,19
Lyngby,9110,11,3,9,12,26,46,-20,18
Brondby,9111,1,21,5,4,73,34,39,68
FC Midtjylla,9111,2,20,4,6,72,42,30,64
Copenhagen,9111,3,16,4,10,62,46,16,52
FC Nords,9111,4,12,7,11,75,60,15,43
AaB,9111,5,8,12,10,39,47,-8,36
AC Horsens,9111,6,7,12,11,34,52,-18,33
Sonderjyske,9111,7,8,6,10,28,29,-1,30
Randers FC,9111,8,5,7,12,24,40,-16,22
Lyngby,9111,9,3,10,11,27,45,-18,19
Silkeborg IF,9111,10,5,4,13,26,45,-19,19
AGF Aarhus,9111,11,4,7,11,17,37,-20,19
Brondby,9112,1,21,7,2,72,32,40,70
FC Midtjylla,9112,2,20,5,5,65,37,28,65
FC Nords,9112,3,14,8,8,78,54,24,50
Copenhagen,9112,4,13,5,12,59,48,11,44
AC Horsens,9112,5,7,13,10,35,50,-15,34
Sonderjyske,9112,6,8,6,10,28,29,-1,30
AaB,9112,7,6,12,12,32,46,-14,30
Randers FC,9112,8,5,7,12,25,41,-16,22
AGF Aarhus,9112,9,5,6,11,17,36,-19,21
Lyngby,9112,10,3,10,11,28,46,-18,19
Silkeborg IF,9112,11,5,3,14,25,45,-20,18
Brondby,9113,1,21,7,2,69,30,39,70
FC Midtjylla,9113,2,19,6,5,62,37,25,63
FC Nords,9113,3,14,9,7,77,53,24,51
Copenhagen,9113,4,14,6,10,58,44,14,48
AaB,9113,5,6,13,11,34,41,-7,31
Sonderjyske,9113,6,8,6,10,28,29,-1,30
AC Horsens,9113,7,5,13,12,36,57,-21,28
Lyngby,9113,8,4,9,11,27,44,-17,21
Randers FC,9113,9,5,6,13,23,40,-17,21
AGF Aarhus,9113,10,5,6,11,19,37,-18,21
Silkeborg IF,9113,11,5,3,14,26,47,-21,18
Brondby,9114,1,20,6,4,68,35,33,66
FC Midtjylla,9114,2,20,5,5,67,36,31,65
FC Nords,9114,3,14,7,9,74,52,22,49
Copenhagen,9114,4,13,5,12,53,43,10,44
AC Horsens,9114,5,7,14,9,37,52,-15,35
AaB,9114,6,7,13,10,36,43,-7,34
Sonderjyske,9114,7,8,6,10,28,29,-1,30
Randers FC,9114,8,6,6,12,24,39,-15,24
Silkeborg IF,9114,9,6,3,13,27,44,-17,21
Lyngby,9114,10,3,9,12,26,45,-19,18
AGF Aarhus,9114,11,4,6,12,16,38,-22,18
FC Midtjylla,9115,1,22,4,4,70,36,34,70
Brondby,9115,2,21,5,4,73,35,38,68
FC Nords,9115,3,14,7,9,71,52,19,49
Copenhagen,9115,4,15,4,11,62,43,19,49
Sonderjyske,9115,5,8,6,10,28,29,-1,30
AaB,9115,6,6,12,12,32,46,-14,30
AC Horsens,9115,7,5,14,11,33,55,-22,29
Lyngby,9115,8,4,9,11,27,44,-17,21
Randers FC,9115,9,5,6,13,23,40,-17,21
Silkeborg IF,9115,10,5,4,13,26,45,-19,19
AGF Aarhus,9115,11,4,7,11,17,37,-20,19
Brondby,9116,1,20,6,4,69,35,34,66
FC Midtjylla,9116,2,20,4,6,63,38,25,64
Copenhagen,9116,3,15,4,11,58,42,16,49
FC Nords,9116,4,13,7,10,72,54,18,46
AaB,9116,5,9,12,9,37,39,-2,39
AC Horsens,9116,6,6,13,11,31,48,-17,31
Sonderjyske,9116,7,8,6,10,28,29,-1,30
Randers FC,9116,8,5,7,12,24,40,-16,22
Lyngby,9116,9,3,10,11,27,45,-18,19
Silkeborg IF,9116,10,5,4,13,26,45,-19,19
AGF Aarhus,9116,11,4,7,11,17,37,-20,19
Brondby,9117,1,22,6,2,79,28,51,72
FC Midtjylla,9117,2,19,4,7,64,47,17,61
FC Nords,9117,3,14,7,9,77,53,24,49
Copenhagen,9117,4,14,6,10,60,47,13,48
AC Horsens,9117,5,6,14,10,36,56,-20,32
AaB,9117,6,6,13,11,34,45,-11,31
Sonderjyske,9117,7,8,6,10,28,29,-1,30
Randers FC,9117,8,6,6,12,27,39,-12,24
Silkeborg IF,9117,9,5,4,13,26,45,-19,19
AGF Aarhus,9117,10,4,7,11,17,37,-20,19
Lyngby,9117,11,3,9,12,26,48,-22,18
Brondby,9118,1,20,6,4,72,35,37,66
FC Midtjylla,9118,2,19,5,6,65,44,21,62
Copenhagen,9118,3,15,5,10,59,43,16,50
FC Nords,9118,4,14,6,10,72,54,18,48
AaB,9118,5,9,11,10,42,40,2,38
AC Horsens,9118,6,6,13,11,36,56,-20,31
Sonderjyske,9118,7,8,6,10,28,29,-1,30
Lyngby,9118,8,4,9,11,28,44,-16,21
Randers FC,9118,9,5,6,13,23,41,-18,21
Silkeborg IF,9118,10,5,4,13,26,45,-19,19
AGF Aarhus,9118,11,4,7,11,17,37,-20,19
Brondby,9119,1,21,6,3,68,32,36,69
FC Midtjylla,9119,2,20,5,5,68,39,29,65
FC Nords,9119,3,14,7,9,74,51,23,49
Copenhagen,9119,4,14,4,12,58,47,11,46
AaB,9119,5,8,11,11,37,44,-7,35
AC Horsens,9119,6,6,13,11,34,52,-18,31
Sonderjyske,9119,7,8,6,10,28,29,-1,30
Randers FC,9119,8,6,6,12,25,39,-14,24
Silkeborg IF,9119,9,6,3,13,28,44,-16,21
Lyngby,9119,10,3,9,12,26,46,-20,18
AGF Aarhus,9119,11,4,6,12,16,39,-23,18
Brondby,9120,1,21,6,3,69,31,38,69
FC Midtjylla,9120,2,21,4,5,68,39,29,67
FC Nords,9120,3,13,7,10,73,53,20,46
Copenhagen,9120,4,14,4,12,58,48,10,46
AaB,9120,5,8,11,11,37,45,-8,35
AC Horsens,9120,6,7,12,11,36,51,-15,33
Sonderjyske,9120,7,8,6,10,28,29,-1,30
Randers FC,9120,8,6,6,12,24,39,-15,24
AGF Aarhus,9120,9,5,6,11,18,36,-18,21
Lyngby,9120,10,3,9,12,26,45,-19,18
Silkeborg IF,9120,11,5,3,14,25,46,-21,18
FC Midtjylla,9121,1,21,4,5,70,38,32,67
Brondby,9121,2,20,5,5,67,35,32,65
FC Nords,9121,3,15,7,8,71,48,23,52
Copenhagen,9121,4,13,5,12,57,46,11,44
AaB,9121,5,7,13,10,34,41,-7,34
AC Horsens,9121,6,7,12,11,35,52,-17,33
Sonderjyske,9121,7,8,6,10,28,29,-1,30
Randers FC,9121,8,5,7,12,23,39,-16,22
Lyngby,9121,9,3,10,11,26,44,-18,19
Silkeborg IF,9121,10,5,4,13,26,45,-19,19
AGF Aarhus,9121,11,4,7,11,17,37,-20,19
Brondby,9122,1,22,6,2,72,31,41,72
FC Midtjylla,9122,2,19,6,5,65,40,25,63
FC Nords,9122,3,14,8,8,76,51,25,50
Copenhagen,9122,4,13,6,11,55,43,12,45
AaB,9122,5,6,13,11,34,44,-10,31
AC Horsens,9122,6,6,13,11,36,55,-19,31
Sonderjyske,9122,7,8,6,10,28,29,-1,30
Randers FC,9122,8,6,6,12,25,40,-15,24
Silkeborg IF,9122,9,6,3,13,27,44,-17,21
Lyngby,9122,10,3,9,12,27,46,-19,18
AGF Aarhus,9122,11,4,6,12,16,38,-22,18
Brondby,9123,1,19,8,3,68,33,35,65
FC Midtjylla,9123,2,19,6,5,63,37,26,63
FC Nords,9123,3,16,7,7,79,46,33,55
Copenhagen,9123,4,13,6,11,53,44,9,45
AaB,9123,5,6,14,10,32,38,-6,32
AC Horsens,9123,6,6,13,11,33,56,-23,31
Sonderjyske,9123,7,8,6,10,28,29,-1,30
Randers FC,9123,8,6,6,12,24,39,-15,24
Silkeborg IF,9123,9,6,3,13,26,44,-18,21
Lyngby,9123,10,3,9,12,26,45,-19,18
AGF Aarhus,9123,11,4,6,12,16,37,-21,18
Brondby,9124,1,21,7,2,74,35,39,70
FC Midtjylla,9124,2,21,5,4,72,35,37,68
FC Nords,9124,3,13,8,9,73,55,18,47
Copenhagen,9124,4,12,5,13,55,50,5,41
AC Horsens,9124,5,7,14,9,35,47,-12,35
AaB,9124,6,6,13,11,34,47,-13,31
Sonderjyske,9124,7,8,6,10,28,29,-1,30
Randers FC,9124,8,6,6,12,24,39,-15,24
Silkeborg IF,9124,9,5,4,13,27,46,-19,19
AGF Aarhus,9124,10,4,7,11,18,38,-20,19
Lyngby,9124,11,3,9,12,26,45,-19,18
Brondby,9125,1,22,5,3,75,34,41,71
FC Midtjylla,9125,2,19,5,6,67,40,27,62
Copenhagen,9125,3,15,5,10,60,43,17,50
FC Nords,9125,4,14,7,9,73,50,23,49
AaB,9125,5,7,11,12,34,47,-13,32
AC Horsens,9125,6,6,13,11,33,54,-21,31
Sonderjyske,9125,7,8,6,10,28,29,-1,30
Lyngby,9125,8,4,9,11,28,45,-17,21
Randers FC,9125,9,5,6,13,24,41,-17,21
AGF Aarhus,9125,10,5,6,11,17,36,-19,21
Silkeborg IF,9125,11,5,3,14,25,45,-20,18
Brondby,9126,1,23,5,2,81,29,52,74
FC Midtjylla,9126,2,20,4,6,72,46,26,64
FC Nords,9126,3,13,8,9,69,54,15,47
Copenhagen,9126,4,14,5,11,58,43,15,47
AaB,9126,5,6,14,10,35,49,-14,32
Sonderjyske,9126,6,8,6,10,28,29,-1,30
AC Horsens,9126,7,5,14,11,32,52,-20,29
Lyngby,9126,8,4,9,11,28,45,-17,21
Randers FC,9126,9,5,6,13,24,41,-17,21
AGF Aarhus,9126,10,5,6,11,18,37,-19,21
Silkeborg IF,9126,11,5,3,14,26,46,-20,18
FC Midtjylla,9127,1,21,5,4,69,37,32,68
Brondby,9127,2,18,6,6,67,41,26,60
Copenhagen,9127,3,15,5,10,63,45,18,50
FC Nords,9127,4,13,8,9,72,50,22,47
AaB,9127,5,7,13,10,37,46,-9,34
AC Horsens,9127,6,7,13,10,40,55,-15,34
Sonderjyske,9127,7,8,6,10,28,29,-1,30
Lyngby,9127,8,4,9,11,29,45,-16,21
Silkeborg IF,9127,9,6,3,13,26,44,-18,21
Randers FC,9127,10,5,6,13,24,42,-18,21
AGF Aarhus,9127,11,4,6,12,16,37,-21,18
Brondby,9128,1,21,7,2,71,33,38,70
FC Midtjylla,9128,2,19,5,6,63,37,26,62
FC Nords,9128,3,14,7,9,72,51,21,49
Copenhagen,9128,4,13,6,11,56,44,12,45
AaB,9128,5,7,15,8,37,39,-2,36
Sonderjyske,9128,6,8,6,10,28,29,-1,30
AC Horsens,9128,7,5,14,11,33,54,-21,29
Lyngby,9128,8,4,9,11,28,45,-17,21
Randers FC,9128,9,5,6,13,24,41,-17,21
AGF Aarhus,9128,10,5,6,11,17,36,-19,21
Silkeborg IF,9128,11,5,3,14,25,45,-20,18
Brondby,9129,1,21,6,3,76,35,41,69
FC Midtjylla,9129,2,20,4,6,68,41,27,64
FC Nords,9129,3,15,6,9,74,53,21,51
Copenhagen,9129,4,13,4,13,56,48,8,43
AaB,9129,5,8,11,11,37,42,-5,35
AC Horsens,9129,6,7,13,10,38,56,-18,34
Sonderjyske,9129,7,8,6,10,28,29,-1,30
Randers FC,9129,8,6,6,12,25,40,-15,24
Silkeborg IF,9129,9,6,3,13,27,44,-17,21
Lyngby,9129,10,3,9,12,27,46,-19,18
AGF Aarhus,9129,11,4,6,12,16,38,-22,18
Brondby,9130,1,20,8,2,70,30,40,68
FC Midtjylla,9130,2,20,6,4,66,37,29,66
FC Nords,9130,3,12,9,9,70,53,17,45
Copenhagen,9130,4,13,6,11,54,42,12,45
AaB,9130,5,7,12,11,36,45,-9,33
AC Horsens,9130,6,6,15,9,32,47,-15,33
Sonderjyske,9130,7,8,6,10,28,29,-1,30
Randers FC,9130,8,5,7,12,25,41,-16,22
Silkeborg IF,9130,9,6,3,13,26,44,-18,21
Lyngby,9130,10,3,10,11,28,46,-18,19
AGF Aarhus,9130,11,4,6,12,16,37,-21,18
FC Midtjylla,9131,1,22,4,4,66,34,32,70
Brondby,9131,2,20,6,4,70,35,35,66
FC Nords,9131,3,14,7,9,74,50,24,49
Copenhagen,9131,4,13,5,12,62,49,13,44
AaB,9131,5,7,12,11,38,46,-8,33
AC Horsens,9131,6,7,12,11,37,59,-22,33
Sonderjyske,9131,7,8,6,10,28,29,-1,30
Lyngby,9131,8,4,9,11,27,44,-17,21
Randers FC,9131,9,5,6,13,23,40,-17,21
AGF Aarhus,9131,10,5,6,11,18,37,-19,21
Silkeborg IF,9131,11,5,3,14,26,46,-20,18
Brondby,9132,1,21,5,4,76,35,41,68
FC Midtjylla,9132,2,21,5,4,67,34,33,68
Copenhagen,9132,3,14,6,10,60,45,15,48
FC Nords,9132,4,13,7,10,74,59,15,46
AC Horsens,9132,5,7,12,11,34,53,-19,33
AaB,9132,6,7,11,12,37,48,-11,32
Sonderjyske,9132,7,8,6,10,28,29,-1,30
Lyngby,9132,8,4,9,11,29,45,-16,21
Randers FC,9132,9,5,6,13,24,42,-18,21
Silkeborg IF,9132,10,5,4,13,26,45,-19,19
AGF Aarhus,9132,11,4,7,11,17,37,-20,19
Brondby,9133,1,22,6,2,72,33,39,72
FC Midtjylla,9133,2,18,5,7,60,38,22,59
FC Nords,9133,3,14,7,9,72,51,21,49
Copenhagen,9133,4,13,6,11,54,42,12,45
AaB,9133,5,8,13,9,39,41,-2,37
AC Horsens,9133,6,6,13,11,34,52,-18,31
Sonderjyske,9133,7,8,6,10,28,29,-1,30
Randers FC,9133,8,6,6,12,26,41,-15,24
Silkeborg IF,9133,9,5,4,13,27,46,-19,19
AGF Aarhus,9133,10,4,7,11,18,38,-20,19
Lyngby,9133,11,3,9,12,28,47,-19,18
Brondby,9134,1,21,5,4,73,34,39,68
FC Midtjylla,9134,2,21,4,5,67,38,29,67
FC Nords,9134,3,14,6,10,69,52,17,48
Copenhagen,9134,4,13,4,13,56,47,9,43
AC Horsens,9134,5,8,12,10,38,52,-14,36
AaB,9134,6,8,11,11,37,43,-6,35
Sonderjyske,9134,7,8,6,10,28,29,-1,30
Lyngby,9134,8,4,9,11,29,46,-17,21
Randers FC,9134,9,5,6,13,25,42,-17,21
AGF Aarhus,9134,10,5,6,11,18,37,-19,21
Silkeborg IF,9134,11,5,3,14,26,46,-20,18
Brondby,9135,1,22,5,3,72,32,40,71
FC Midtjylla,9135,2,20,4,6,70,42,28,64
Copenhagen,9135,3,16,4,10,62,42,20,52
FC Nords,9135,4,12,8,10,68,54,14,44
AC Horsens,9135,5,7,13,10,35,50,-15,34
Sonderjyske,9135,6,8,6,10,28,29,-1,30
AaB,9135,7,6,12,12,35,48,-13,30
Lyngby,9135,8,4,9,11,28,45,-17,21
Randers FC,9135,9,5,6,13,24,41,-17,21
Silkeborg IF,9135,10,6,3,13,27,45,-18,21
AGF Aarhus,9135,11,4,6,12,17,38,-21,18
FC Midtjylla,9136,1,21,5,4,66,36,30,68
Brondby,9136,2,19,6,5,67,35,32,63
FC Nords,9136,3,15,7,8,75,53,22,52
Copenhagen,9136,4,13,5,12,54,42,12,44
AaB,9136,5,7,13,10,38,42,-4,34
AC Horsens,9136,6,7,12,11,33,51,-18,33
Sonderjyske,9136,7,8,6,10,28,29,-1,30
Randers FC,9136,8,6,6,12,26,39,-13,24
AGF Aarhus,9136,9,5,6,11,17,36,-19,21
Silkeborg IF,9136,10,5,3,14,25,45,-20,18
Lyngby,9136,11,3,9,12,26,47,-21,18
Brondby,9137,1,20,6,4,69,32,37,66
FC Midtjylla,9137,2,19,4,7,64,41,23,61
Copenhagen,9137,3,15,5,10,60,42,18,50
FC Nords,9137,4,12,9,9,71,56,15,45
AC Horsens,9137,5,8,13,9,36,47,-11,37
AaB,9137,6,7,13,10,37,45,-8,34
Sonderjyske,9137,7,8,6,10,28,29,-1,30
Lyngby,9137,8,4,9,11,30,47,-17,21
Randers FC,9137,9,5,6,13,26,43,-17,21
Silkeborg IF,9137,10,5,4,13,25,44,-19,19
AGF Aarhus,9137,11,4,7,11,16,36,-20,19
Brondby,9138,1,20,8,2,72,31,41,68
FC Midtjylla,9138,2,19,7,4,67,39,28,64
FC Nords,9138,3,13,8,9,74,54,20,47
Copenhagen,9138,4,13,4,13,57,50,7,43
AaB,9138,5,9,12,9,41,44,-3,39
AC Horsens,9138,6,6,13,11,32,51,-19,31
Sonderjyske,9138,7,8,6,10,28,29,-1,30
Lyngby,9138,8,4,9,11,29,46,-17,21
Silkeborg IF,9138,9,6,3,13,27,44,-17,21
Randers FC,9138,10,5,6,13,25,42,-17,21
AGF Aarhus,9138,11,4,6,12,16,38,-22,18
Brondby,9139,1,23,5,2,72,31,41,74
FC Midtjylla,9139,2,20,5,5,71,38,33,65
FC Nords,9139,3,14,6,10,71,57,14,48
Copenhagen,9139,4,13,5,12,61,50,11,44
AaB,9139,5,9,11,10,38,42,-4,38
Sonderjyske,9139,6,8,6,10,28,29,-1,30
AC Horsens,9139,7,5,12,13,33,54,-21,27
Lyngby,9139,8,4,9,11,28,44,-16,21
Silkeborg IF,9139,9,6,3,13,26,44,-18,21
Randers FC,9139,10,5,6,13,23,41,-18,21
AGF Aarhus,9139,11,4,6,12,16,37,-21,18
FC Midtjylla,9140,1,19,6,5,66,38,28,63
Brondby,9140,2,19,5,6,72,41,31,62
FC Nords,9140,3,15,7,8,77,56,21,52
Copenhagen,9140,4,15,4,11,61,47,14,49
AC Horsens,9140,5,8,13,9,41,50,-9,37
AaB,9140,6,7,11,12,36,47,-11,32
Sonderjyske,9140,7,8,6,10,28,29,-1,30
Lyngby,9140,8,4,9,11,28,44,-16,21
Silkeborg IF,9140,9,6,3,13,26,44,-18,21
Randers FC,9140,10,5,6,13,23,41,-18,21
AGF Aarhus,9140,11,4,6,12,16,37,-21,18
Brondby,9141,1,21,6,3,71,32,39,69
FC Midtjylla,9141,2,19,4,7,65,41,24,61
Copenhagen,9141,3,14,5,11,57,44,13,47
FC Nords,9141,4,13,6,11,70,57,13,45
AaB,9141,5,8,12,10,39,42,-3,36
AC Horsens,9141,6,7,15,8,35,47,-12,36
Sonderjyske,9141,7,8,6,10,28,29,-1,30
Randers FC,9141,8,5,7,12,24,40,-16,22
Silkeborg IF,9141,9,6,3,13,26,44,-18,21
Lyngby,9141,10,3,10,11,27,45,-18,19
AGF Aarhus,9141,11,4,6,12,16,37,-21,18
Brondby,9142,1,20,6,4,65,31,34,66
FC Midtjylla,9142,2,19,7,4,66,38,28,64
FC Nords,9142,3,14,7,9,72,49,23,49
Copenhagen,9142,4,13,5,12,57,47,10,44
AC Horsens,9142,5,9,12,9,36,47,-11,39
AaB,9142,6,7,11,12,34,44,-10,32
Sonderjyske,9142,7,8,6,10,28,29,-1,30
Lyngby,9142,8,4,9,11,27,44,-17,21
Randers FC,9142,9,5,6,13,23,40,-17,21
AGF Aarhus,9142,10,5,6,11,17,36,-19,21
Silkeborg IF,9142,11,5,3,14,25,45,-20,18
Brondby,9143,1,21,6,3,71,34,37,69
FC Midtjylla,9143,2,20,5,5,69,40,29,65
Copenhagen,9143,3,15,4,11,57,43,14,49
FC Nords,9143,4,14,6,10,71,49,22,48
AaB,9143,5,7,12,11,36,45,-9,33
AC Horsens,9143,6,6,13,11,33,52,-19,31
Sonderjyske,9143,7,8,6,10,28,29,-1,30
Lyngby,9143,8,4,9,11,29,45,-16,21
Randers FC,9143,9,5,6,13,24,42,-18,21
AGF Aarhus,9143,10,5,6,11,17,36,-19,21
Silkeborg IF,9143,11,5,3,14,25,45,-20,18
Brondby,9144,1,21,6,3,70,30,40,69
FC Midtjylla,9144,2,18,5,7,63,41,22,59
Copenhagen,9144,3,15,5,10,59,44,15,50
FC Nords,9144,4,14,6,10,74,55,19,48
AaB,9144,5,9,12,9,40,39,1,39
Sonderjyske,9144,6,8,6,10,28,29,-1,30
AC Horsens,9144,7,5,14,11,34,57,-23,29
Lyngby,9144,8,4,9,11,29,45,-16,21
Silkeborg IF,9144,9,6,3,13,27,45,-18,21
Randers FC,9144,10,5,6,13,24,42,-18,21
AGF Aarhus,9144,11,4,6,12,17,38,-21,18
Brondby,9145,1,21,6,3,74,32,42,69
FC Midtjylla,9145,2,18,6,6,59,39,20,60
FC Nords,9145,3,15,6,9,75,51,24,51
Copenhagen,9145,4,14,6,10,59,44,15,48
AaB,9145,5,7,13,10,35,43,-8,34
AC Horsens,9145,6,6,13,11,32,51,-19,31
Sonderjyske,9145,7,8,6,10,28,29,-1,30
Silkeborg IF,9145,8,6,3,13,28,45,-17,21
Lyngby,9145,9,4,9,11,27,44,-17,21
Randers FC,9145,10,5,6,13,23,40,-17,21
AGF Aarhus,9145,11,4,6,12,17,39,-22,18
Brondby,9146,1,22,6,2,79,29,50,72
FC Midtjylla,9146,2,20,4,6,71,44,27,64
Copenhagen,9146,3,15,5,10,63,47,16,50
FC Nords,9146,4,13,8,9,72,55,17,47
AC Horsens,9146,5,6,13,11,36,57,-21,31
Sonderjyske,9146,6,8,6,10,28,29,-1,30
AaB,9146,7,6,12,12,35,50,-15,30
Randers FC,9146,8,5,7,12,25,41,-16,22
Lyngby,9146,9,3,10,11,28,46,-18,19
Silkeborg IF,9146,10,5,4,13,25,44,-19,19
AGF Aarhus,9146,11,4,7,11,16,36,-20,19
FC Midtjylla,9147,1,21,4,5,67,41,26,67
Brondby,9147,2,19,6,5,67,35,32,63
Copenhagen,9147,3,15,4,11,61,42,19,49
FC Nords,9147,4,13,7,10,72,53,19,46
AC Horsens,9147,5,8,12,10,36,52,-16,36
AaB,9147,6,8,11,11,36,42,-6,35
Sonderjyske,9147,7,8,6,10,28,29,-1,30
Randers FC,9147,8,6,6,12,24,39,-15,24
Silkeborg IF,9147,9,6,3,13,26,44,-18,21
Lyngby,9147,10,3,9,12,26,45,-19,18
AGF Aarhus,9147,11,4,6,12,16,37,-21,18
Brondby,9148,1,20,8,2,71,33,38,68
FC Midtjylla,9148,2,20,4,6,67,40,27,64
FC Nords,9148,3,15,7,8,79,53,26,52
Copenhagen,9148,4,14,5,11,62,48,14,47
AaB,9148,5,7,11,12,39,48,-9,32
AC Horsens,9148,6,6,13,11,36,58,-22,31
Sonderjyske,9148,7,8,6,10,28,29,-1,30
Randers FC,9148,8,5,7,12,24,40,-16,22
Lyngby,9148,9,3,10,11,27,45,-18,19
Silkeborg IF,9148,10,5,4,13,26,45,-19,19
AGF Aarhus,9148,11,4,7,11,17,37,-20,19
Brondby,9149,1,19,8,3,68,33,35,65
FC Midtjylla,9149,2,20,5,5,65,38,27,65
FC Nords,9149,3,14,7,9,79,51,28,49
Copenhagen,9149,4,14,6,10,59,50,9,48
AC Horsens,9149,5,7,13,10,36,53,-17,34
AaB,9149,6,6,13,11,33,41,-8,31
Sonderjyske,9149,7,8,6,10,28,29,-1,30
Lyngby,9149,8,4,9,11,31,45,-14,21
AGF Aarhus,9149,9,5,6,11,18,37,-19,21
Randers FC,9149,10,5,6,13,24,44,-20,21
Silkeborg IF,9149,11,5,3,14,26,46,-20,18
Brondby,9150,1,20,7,3,66,32,34,67
FC Midtjylla,9150,2,20,5,5,69,41,28,65
FC Nords,9150,3,14,8,8,79,53,26,50
Copenhagen,9150,4,13,7,10,60,47,13,46
AaB,9150,5,8,11,11,40,51,-11,35
Sonderjyske,9150,6,8,6,10,28,29,-1,30
AC Horsens,9150,7,6,12,12,38,54,-16,30
Silkeborg IF,9150,8,6,3,13,28,44,-16,21
Lyngby,9150,9,4,9,11,28,45,-17,21
Randers FC,9150,10,5,6,13,24,41,-17,21
AGF Aarhus,9150,11,4,6,12,16,39,-23,18
Brondby,9151,1,21,6,3,73,31,42,69
FC Midtjylla,9151,2,19,6,5,64,42,22,63
FC Nords,9151,3,14,7,9,72,51,21,49
Copenhagen,9151,4,14,4,12,56,45,11,46
AaB,9151,5,8,12,10,39,44,-5,36
AC Horsens,9151,6,6,13,11,36,53,-17,31
Sonderjyske,9151,7,8,6,10,28,29,-1,30
Randers FC,9151,8,6,6,12,25,39,-14,24
Silkeborg IF,9151,9,6,3,13,29,44,-15,21
Lyngby,9151,10,3,9,12,26,46,-20,18
AGF Aarhus,9151,11,4,6,12,16,40,-24,18
Brondby,9152,1,21,5,4,75,35,40,68
FC Midtjylla,9152,2,19,5,6,66,39,27,62
FC Nords,9152,3,16,6,8,71,51,20,54
Copenhagen,9152,4,14,5,11,60,46,14,47
AaB,9152,5,7,12,11,36,46,-10,33
AC Horsens,9152,6,6,13,11,35,52,-17,31
Sonderjyske,9152,7,8,6,10,28,29,-1,30
Randers FC,9152,8,5,7,12,23,39,-16,22
Silkeborg IF,9152,9,6,3,13,28,45,-17,21
Lyngby,9152,10,3,10,11,26,44,-18,19
AGF Aarhus,9152,11,4,6,12,17,39,-22,18
Brondby,9153,1,22,5,3,73,33,40,71
FC Midtjylla,9153,2,19,4,7,68,45,23,61
Copenhagen,9153,3,15,5,10,62,45,17,50
FC Nords,9153,4,14,7,9,73,51,22,49
AaB,9153,5,7,13,10,42,48,-6,34
Sonderjyske,9153,6,8,6,10,28,29,-1,30
AC Horsens,9153,7,6,12,12,35,57,-22,30
Lyngby,9153,8,4,9,11,28,45,-17,21
Randers FC,9153,9,5,6,13,24,41,-17,21
Silkeborg IF,9153,10,6,3,13,28,46,-18,21
AGF Aarhus,9153,11,4,6,12,18,39,-21,18
FC Midtjylla,9154,1,20,6,4,66,38,28,66
Brondby,9154,2,19,7,4,71,35,36,64
Copenhagen,9154,3,14,6,10,57,42,15,48
FC Nords,9154,4,12,8,10,70,52,18,44
AC Horsens,9154,5,7,14,9,35,50,-15,35
AaB,9154,6,7,13,10,40,48,-8,34
Sonderjyske,9154,7,8,6,10,28,29,-1,30
Randers FC,9154,8,5,7,12,26,42,-16,22
Lyngby,9154,9,3,10,11,29,47,-18,19
Silkeborg IF,9154,10,5,4,13,25,44,-19,19
AGF Aarhus,9154,11,4,7,11,16,36,-20,19
Brondby,9155,1,19,9,2,63,27,36,66
FC Midtjylla,9155,2,19,7,4,62,34,28,64
FC Nords,9155,3,14,8,8,69,46,23,50
Copenhagen,9155,4,14,5,11,55,41,14,47
AaB,9155,5,6,14,10,31,39,-8,32
AC Horsens,9155,6,6,13,11,33,52,-19,31
Sonderjyske,9155,7,8,6,10,28,29,-1,30
Randers FC,9155,8,6,6,12,25,40,-15,24
Silkeborg IF,9155,9,6,3,13,26,44,-18,21
Lyngby,9155,10,3,9,12,27,46,-19,18
AGF Aarhus,9155,11,4,6,12,16,37,-21,18
Brondby,9156,1,21,6,3,75,37,38,69
FC Midtjylla,9156,2,20,6,4,67,36,31,66
FC Nords,9156,3,14,7,9,76,58,18,49
Copenhagen,9156,4,13,6,11,58,46,12,45
AaB,9156,5,6,14,10,37,43,-6,32
AC Horsens,9156,6,6,13,11,35,54,-19,31
Sonderjyske,9156,7,8,6,10,28,29,-1,30
Randers FC,9156,8,5,7,12,24,40,-16,22
Silkeborg IF,9156,9,6,3,13,27,45,-18,21
Lyngby,9156,10,3,10,11,27,45,-18,19
AGF Aarhus,9156,11,4,6,12,17,38,-21,18
Brondby,9157,1,21,7,2,73,31,42,70
FC Midtjylla,9157,2,18,6,6,63,41,22,60
FC Nords,9157,3,14,8,8,75,54,21,50
Copenhagen,9157,4,14,4,12,59,45,14,46
AaB,9157,5,8,11,11,37,43,-6,35
AC Horsens,9157,6,6,14,10,37,56,-19,32
Sonderjyske,9157,7,8,6,10,28,29,-1,30
Lyngby,9157,8,4,9,11,28,44,-16,21
Silkeborg IF,9157,9,6,3,13,28,46,-18,21
Randers FC,9157,10,5,6,13,23,41,-18,21
AGF Aarhus,9157,11,4,6,12,18,39,-21,18
FC Midtjylla,9158,1,21,4,5,70,40,30,67
Brondby,9158,2,20,6,4,71,35,36,66
Copenhagen,9158,3,14,6,10,62,44,18,48
FC Nords,9158,4,13,8,9,69,53,16,47
AC Horsens,9158,5,6,15,9,37,53,-16,33
AaB,9158,6,7,11,12,35,45,-10,32
Sonderjyske,9158,7,8,6,10,28,29,-1,30
Silkeborg IF,9158,8,6,3,13,29,44,-15,21
Lyngby,9158,9,4,9,11,28,44,-16,21
Randers FC,9158,10,5,6,13,23,41,-18,21
AGF Aarhus,9158,11,4,6,12,16,40,-24,18
FC Midtjylla,9159,1,22,4,4,71,36,35,70
Brondby,9159,2,19,6,5,69,37,32,63
Copenhagen,9159,3,15,5,10,60,43,17,50
FC Nords,9159,4,14,7,9,70,53,17,49
AaB,9159,5,6,13,11,36,45,-9,31
AC Horsens,9159,6,6,13,11,36,54,-18,31
Sonderjyske,9159,7,8,6,10,28,29,-1,30
Randers FC,9159,8,6,6,12,24,39,-15,24
AGF Aarhus,9159,9,5,6,11,17,36,-19,21
Lyngby,9159,10,3,9,12,26,45,-19,18
Silkeborg IF,9159,11,5,3,14,25,45,-20,18
Brondby,9160,1,19,8,3,72,35,37,65
FC Midtjylla,9160,2,18,6,6,65,41,24,60
Copenhagen,9160,3,15,5,10,58,47,11,50
FC Nords,9160,4,14,6,10,76,59,17,48
AaB,9160,5,7,14,9,40,44,-4,35
AC Horsens,9160,6,7,13,10,39,50,-11,34
Sonderjyske,9160,7,8,6,10,28,29,-1,30
Lyngby,9160,8,4,9,11,29,45,-16,21
Silkeborg IF,9160,9,6,3,13,26,44,-18,21
Randers FC,9160,10,5,6,13,24,42,-18,21
AGF Aarhus,9160,11,4,6,12,16,37,-21,18
FC Midtjylla,9161,1,20,6,4,64,33,31,66
Brondby,9161,2,18,7,5,66,36,30,61
FC Nords,9161,3,16,6,8,77,52,25,54
Copenhagen,9161,4,14,6,10,59,46,13,48
AaB,9161,5,8,12,10,41,41,0,36
Sonderjyske,9161,6,8,6,10,28,29,-1,30
AC Horsens,9161,7,5,13,12,32,57,-25,28
Lyngby,9161,8,4,9,11,27,44,-17,21
Randers FC,9161,9,5,6,13,23,40,-17,21
Silkeborg IF,9161,10,5,4,13,26,45,-19,19
AGF Aarhus,9161,11,4,7,11,17,37,-20,19
Brondby,9162,1,23,5,2,73,30,43,74
FC Midtjylla,9162,2,18,6,6,62,37,25,60
FC Nords,9162,3,14,6,10,75,56,19,48
Copenhagen,9162,4,14,5,11,59,43,16,47
AaB,9162,5,9,11,10,39,45,-6,38
Sonderjyske,9162,6,8,6,10,28,29,-1,30
AC Horsens,9162,7,5,13,12,33,56,-23,28
Randers FC,9162,8,6,6,12,26,41,-15,24
Silkeborg IF,9162,9,6,3,13,28,46,-18,21
Lyngby,9162,10,3,9,12,28,47,-19,18
AGF Aarhus,9162,11,4,6,12,18,39,-21,18
Brondby,9163,1,21,6,3,73,31,42,69
FC Midtjylla,9163,2,21,4,5,67,38,29,67
FC Nords,9163,3,13,8,9,75,51,24,47
Copenhagen,9163,4,14,5,11,55,43,12,47
AaB,9163,5,6,14,10,35,44,-9,32
AC Horsens,9163,6,6,13,11,33,57,-24,31
Sonderjyske,9163,7,8,6,10,28,29,-1,30
Lyngby,9163,8,4,9,11,28,45,-17,21
Randers FC,9163,9,5,6,13,24,41,-17,21
Silkeborg IF,9163,10,6,3,13,27,45,-18,21
AGF Aarhus,9163,11,4,6,12,17,38,-21,18
Brondby,9164,1,20,6,4,71,35,36,66
FC Midtjylla,9164,2,18,6,6,65,41,24,60
FC Nords,9164,3,14,9,7,73,49,24,51
Copenhagen,9164,4,14,5,11,55,42,13,47
AC Horsens,9164,5,8,13,9,34,49,-15,37
AaB,9164,6,6,13,11,32,40,-8,31
Sonderjyske,9164,7,8,6,10,28,29,-1,30
Randers FC,9164,8,5,7,12,24,40,-16,22
Lyngby,9164,9,3,10,11,27,45,-18,19
Silkeborg IF,9164,10,5,4,13,25,44,-19,19
AGF Aarhus,9164,11,4,7,11,16,36,-20,19
Brondby,9165,1,21,6,3,73,35,38,69
FC Midtjylla,9165,2,19,6,5,69,40,29,63
FC Nords,9165,3,15,7,8,76,50,26,52
Copenhagen,9165,4,12,6,12,54,46,8,42
AaB,9165,5,7,13,10,39,44,-5,34
AC Horsens,9165,6,7,12,11,41,63,-22,33
Sonderjyske,9165,7,8,6,10,28,29,-1,30
Randers FC,9165,8,6,6,12,26,41,-15,24
AGF Aarhus,9165,9,5,6,11,19,37,-18,21
Lyngby,9165,10,3,9,12,28,47,-19,18
Silkeborg IF,9165,11,5,3,14,26,47,-21,18
Brondby,9166,1,21,7,2,74,35,39,70
FC Midtjylla,9166,2,19,5,6,66,43,23,62
Copenhagen,9166,3,14,6,10,61,46,15,48
FC Nords,9166,4,12,8,10,71,54,17,44
AaB,9166,5,8,11,11,39,44,-5,35
AC Horsens,9166,6,6,15,9,37,52,-15,33
Sonderjyske,9166,7,8,6,10,28,29,-1,30
Lyngby,9166,8,4,9,11,28,45,-17,21
Randers FC,9166,9,5,6,13,24,41,-17,21
Silkeborg IF,9166,10,6,3,13,27,45,-18,21
AGF Aarhus,9166,11,4,6,12,17,38,-21,18
Brondby,9167,1,21,5,4,71,33,38,68
FC Midtjylla,9167,2,21,4,5,66,36,30,67
Copenhagen,9167,3,16,4,10,63,44,19,52
FC Nords,9167,4,12,8,10,69,52,17,44
AaB,9167,5,7,12,11,38,48,-10,33
AC Horsens,9167,6,6,13,11,37,57,-20,31
Sonderjyske,9167,7,8,6,10,28,29,-1,30
Randers FC,9167,8,6,6,12,25,40,-15,24
Silkeborg IF,9167,9,5,4,13,26,45,-19,19
AGF Aarhus,9167,10,4,7,11,17,37,-20,19
Lyngby,9167,11,3,9,12,27,46,-19,18
Brondby,9168,1,21,5,4,71,34,37,68
FC Midtjylla,9168,2,20,5,5,67,39,28,65
FC Nords,9168,3,15,6,9,72,50,22,51
Copenhagen,9168,4,13,4,13,55,50,5,43
AaB,9168,5,10,12,8,43,37,6,42
Sonderjyske,9168,6,8,6,10,28,29,-1,30
AC Horsens,9168,7,5,12,13,33,57,-24,27
Randers FC,9168,8,6,6,12,26,39,-13,24
Silkeborg IF,9168,9,6,3,13,29,46,-17,21
Lyngby,9168,10,3,9,12,26,47,-21,18
AGF Aarhus,9168,11,4,6,12,18,40,-22,18
FC Midtjylla,9169,1,20,5,5,69,36,33,65
Brondby,9169,2,19,7,4,69,37,32,64
FC Nords,9169,3,15,6,9,79,58,21,51
Copenhagen,9169,4,15,5,10,62,46,16,50
AaB,9169,5,8,12,10,41,41,0,36
Sonderjyske,9169,6,8,6,10,28,29,-1,30
AC Horsens,9169,7,5,13,12,33,61,-28,28
Lyngby,9169,8,4,9,11,27,44,-17,21
Randers FC,9169,9,5,6,13,23,40,-17,21
AGF Aarhus,9169,10,5,6,11,19,36,-17,21
Silkeborg IF,9169,11,5,3,14,25,47,-22,18
Brondby,9170,1,21,6,3,74,33,41,69
FC Midtjylla,9170,2,20,6,4,75,39,36,66
Copenhagen,9170,3,15,6,9,56,40,16,51
FC Nords,9170,4,12,6,12,72,63,9,42
AaB,9170,5,7,12,11,35,43,-8,33
AC Horsens,9170,6,7,12,11,36,56,-20,33
Sonderjyske,9170,7,8,6,10,28,29,-1,30
Randers FC,9170,8,6,6,12,24,39,-15,24
Silkeborg IF,9170,9,6,3,13,28,45,-17,21
Lyngby,9170,10,3,9,12,26,45,-19,18
AGF Aarhus,9170,11,4,6,12,17,39,-22,18
Brondby,9171,1,21,5,4,71,33,38,68
FC Midtjylla,9171,2,19,5,6,65,42,23,62
Copenhagen,9171,3,17,4,9,63,41,22,55
FC Nords,9171,4,13,6,11,72,55,17,45
AaB,9171,5,7,13,10,36,42,-6,34
AC Horsens,9171,6,6,13,11,35,55,-20,31
Sonderjyske,9171,7,8,6,10,28,29,-1,30
Randers FC,9171,8,5,7,12,24,40,-16,22
Silkeborg IF,9171,9,6,3,13,28,44,-16,21
Lyngby,9171,10,3,10,11,27,45,-18,19
AGF Aarhus,9171,11,4,6,12,16,39,-23,18
Brondby,9172,1,23,5,2,77,35,42,74
FC Midtjylla,9172,2,17,5,8,64,45,19,56
FC Nords,9172,3,15,7,8,77,50,27,52
Copenhagen,9172,4,12,5,13,56,55,1,41
AaB,9172,5,9,12,9,47,44,3,39
AC Horsens,9172,6,7,12,11,37,55,-18,33
Sonderjyske,9172,7,8,6,10,28,29,-1,30
Lyngby,9172,8,4,9,11,30,46,-16,21
Silkeborg IF,9172,9,6,3,13,26,44,-18,21
Randers FC,9172,10,5,6,13,25,43,-18,21
AGF Aarhus,9172,11,4,6,12,16,37,-21,18
Brondby,9173,1,22,6,2,73,30,43,72
FC Midtjylla,9173,2,19,6,5,65,38,27,63
FC Nords,9173,3,14,6,10,74,54,20,48
Copenhagen,9173,4,13,7,10,59,44,15,46
AaB,9173,5,7,12,11,36,43,-7,33
AC Horsens,9173,6,6,13,11,33,57,-24,31
Sonderjyske,9173,7,8,6,10,28,29,-1,30
Randers FC,9173,8,5,7,12,24,40,-16,22
Lyngby,9173,9,3,10,11,27,45,-18,19
Silkeborg IF,9173,10,5,4,13,26,45,-19,19
AGF Aarhus,9173,11,4,7,11,17,37,-20,19
Brondby,9174,1,22,5,3,79,31,48,71
FC Midtjylla,9174,2,20,4,6,62,41,21,64
Copenhagen,9174,3,15,5,10,61,43,18,50
FC Nords,9174,4,14,7,9,75,55,20,49
AaB,9174,5,7,12,11,36,45,-9,33
Sonderjyske,9174,6,8,6,10,28,29,-1,30
AC Horsens,9174,7,5,13,12,34,58,-24,28
Lyngby,9174,8,4,9,11,28,45,-17,21
Randers FC,9174,9,5,6,13,24,41,-17,21
AGF Aarhus,9174,10,5,6,11,18,37,-19,21
Silkeborg IF,9174,11,5,3,14,26,46,-20,18
Brondby,9175,1,21,6,3,66,29,37,69
FC Midtjylla,9175,2,18,5,7,62,40,22,59
FC Nords,9175,3,16,6,8,77,54,23,54
Copenhagen,9175,4,14,5,11,57,44,13,47
AaB,9175,5,9,11,10,42,42,0,38
Sonderjyske,9175,6,8,6,10,28,29,-1,30
AC Horsens,9175,7,5,13,12,32,53,-21,28
Lyngby,9175,8,4,9,11,31,45,-14,21
Silkeborg IF,9175,9,6,3,13,28,46,-18,21
Randers FC,9175,10,5,6,13,24,44,-20,21
AGF Aarhus,9175,11,4,6,12,18,39,-21,18
Brondby,9176,1,20,8,2,70,33,37,68
FC Midtjylla,9176,2,18,6,6,63,42,21,60
FC Nords,9176,3,14,7,9,75,52,23,49
Copenhagen,9176,4,14,6,10,61,45,16,48
AaB,9176,5,7,15,8,40,43,-3,36
Sonderjyske,9176,6,8,6,10,28,29,-1,30
AC Horsens,9176,7,5,14,11,32,52,-20,29
Randers FC,9176,8,5,7,12,24,40,-16,22
AGF Aarhus,9176,9,5,6,11,20,36,-16,21
Lyngby,9176,10,3,10,11,27,45,-18,19
Silkeborg IF,9176,11,5,3,14,25,48,-23,18
Brondby,9177,1,21,6,3,72,32,40,69
FC Midtjylla,9177,2,20,4,6,65,40,25,64
FC Nords,9177,3,14,7,9,74,54,20,49
Copenhagen,9177,4,13,5,12,60,49,11,44
AaB,9177,5,9,12,9,40,43,-3,39
Sonderjyske,9177,6,8,6,10,28,29,-1,30
AC Horsens,9177,7,6,12,12,37,56,-19,30
Lyngby,9177,8,4,9,11,29,44,-15,21
AGF Aarhus,9177,9,5,6,11,20,36,-16,21
Randers FC,9177,10,5,6,13,23,42,-19,21
Silkeborg IF,9177,11,5,3,14,25,48,-23,18
Brondby,9178,1,20,6,4,72,37,35,66
FC Midtjylla,9178,2,19,6,5,66,38,28,63
FC Nords,9178,3,16,7,7,82,50,32,55
Copenhagen,9178,4,14,5,11,62,49,13,47
AaB,9178,5,7,11,12,37,51,-14,32
AC Horsens,9178,6,6,13,11,33,53,-20,31
Sonderjyske,9178,7,8,6,10,28,29,-1,30
Randers FC,9178,8,6,6,12,25,40,-15,24
Silkeborg IF,9178,9,6,3,13,27,45,-18,21
Lyngby,9178,10,3,9,12,27,46,-19,18
AGF Aarhus,9178,11,4,6,12,17,38,-21,18
Brondby,9179,1,22,6,2,74,28,46,72
FC Midtjylla,9179,2,19,6,5,68,38,30,63
FC Nords,9179,3,14,6,10,70,50,20,48
Copenhagen,9179,4,14,5,11,56,45,11,47
AaB,9179,5,8,12,10,37,41,-4,36
Sonderjyske,9179,6,8,6,10,28,29,-1,30
AC Horsens,9179,7,5,13,12,31,60,-29,28
Lyngby,9179,8,4,9,11,27,44,-17,21
Randers FC,9179,9,5,6,13,23,40,-17,21
Silkeborg IF,9179,10,6,3,13,26,44,-18,21
AGF Aarhus,9179,11,4,6,12,16,37,-21,18
FC Midtjylla,9180,1,22,4,4,70,37,33,70
Brondby,9180,2,20,5,5,69,35,34,65
Copenhagen,9180,3,16,4,10,61,42,19,52
FC Nords,9180,4,13,6,11,74,53,21,45
AC Horsens,9180,5,7,12,11,34,55,-21,33
AaB,9180,6,7,11,12,35,47,-12,32
Sonderjyske,9180,7,8,6,10,28,29,-1,30
Randers FC,9180,8,5,7,12,23,39,-16,22
Lyngby,9180,9,3,10,11,26,44,-18,19
Silkeborg IF,9180,10,5,4,13,26,45,-19,19
AGF Aarhus,9180,11,4,7,11,17,37,-20,19
Brondby,9181,1,21,6,3,72,33,39,69
FC Midtjylla,9181,2,19,5,6,63,39,24,62
FC Nords,9181,3,14,8,8,76,52,24,50
Copenhagen,9181,4,14,4,12,58,48,10,46
AC Horsens,9181,5,7,13,10,40,55,-15,34
AaB,9181,6,7,12,11,35,43,-8,33
Sonderjyske,9181,7,8,6,10,28,29,-1,30
Lyngby,9181,8,4,9,11,31,45,-14,21
AGF Aarhus,9181,9,5,6,11,19,36,-17,21
Randers FC,9181,10,5,6,13,24,44,-20,21
Silkeborg IF,9181,11,5,3,14,25,47,-22,18
Brondby,9182,1,22,5,3,73,35,38,71
FC Midtjylla,9182,2,19,6,5,62,36,26,63
FC Nords,9182,3,14,7,9,74,50,24,49
Copenhagen,9182,4,14,5,11,55,42,13,47
AaB,9182,5,7,14,9,37,41,-4,35
Sonderjyske,9182,6,8,6,10,28,29,-1,30
AC Horsens,9182,7,5,13,12,31,54,-23,28
Randers FC,9182,8,6,6,12,24,39,-15,24
Silkeborg IF,9182,9,6,3,13,29,45,-16,21
Lyngby,9182,10,3,9,12,26,45,-19,18
AGF Aarhus,9182,11,4,6,12,17,40,-23,18
FC Midtjylla,9183,1,22,4,4,76,36,40,70
Brondby,9183,2,21,5,4,71,31,40,68
FC Nords,9183,3,15,6,9,76,49,27,51
Copenhagen,9183,4,12,4,14,52,50,2,40
AaB,9183,5,9,11,10,41,47,-6,38
Sonderjyske,9183,6,8,6,10,28,29,-1,30
AC Horsens,9183,7,6,12,12,33,62,-29,30
Randers FC,9183,8,6,6,12,26,40,-14,24
Silkeborg IF,9183,9,6,3,13,26,44,-18,21
Lyngby,9183,10,3,9,12,27,47,-20,18
AGF Aarhus,9183,11,4,6,12,16,37,-21,18
Brondby,9184,1,21,7,2,72,31,41,70
FC Midtjylla,9184,2,19,6,5,65,40,25,63
FC Nords,9184,3,15,7,8,77,53,24,52
Copenhagen,9184,4,14,5,11,55,42,13,47
AC Horsens,9184,5,6,13,11,35,55,-20,31
Sonderjyske,9184,6,8,6,10,28,29,-1,30
AaB,9184,7,6,12,12,35,44,-9,30
Lyngby,9184,8,4,9,11,30,44,-14,21
AGF Aarhus,9184,9,5,6,11,18,37,-19,21
Randers FC,9184,10,5,6,13,23,43,-20,21
Silkeborg IF,9184,11,5,3,14,26,46,-20,18
Brondby,9185,1,19,9,2,66,29,37,66
FC Midtjylla,9185,2,19,5,6,64,40,24,62
FC Nords,9185,3,16,7,7,74,48,26,55
Copenhagen,9185,4,13,5,12,58,46,12,44
AaB,9185,5,7,12,11,36,44,-8,33
AC Horsens,9185,6,7,12,11,36,53,-17,33
Sonderjyske,9185,7,8,6,10,28,29,-1,30
Lyngby,9185,8,4,9,11,29,44,-15,21
Silkeborg IF,9185,9,6,3,13,27,44,-17,21
Randers FC,9185,10,5,6,13,23,42,-19,21
AGF Aarhus,9185,11,4,6,12,16,38,-22,18
Brondby,9186,1,21,5,4,73,32,41,68
FC Midtjylla,9186,2,21,5,4,65,35,30,68
Copenhagen,9186,3,14,5,11,61,45,16,47
FC Nords,9186,4,12,8,10,68,52,16,44
AaB,9186,5,8,11,11,37,46,-9,35
AC Horsens,9186,6,6,14,10,37,57,-20,32
Sonderjyske,9186,7,8,6,10,28,29,-1,30
Randers FC,9186,8,6,6,12,26,40,-14,24
Silkeborg IF,9186,9,6,3,13,27,44,-17,21
Lyngby,9186,10,3,9,12,27,47,-20,18
AGF Aarhus,9186,11,4,6,12,16,38,-22,18
Brondby,9187,1,20,8,2,71,29,42,68
FC Midtjylla,9187,2,17,8,5,62,39,23,59
FC Nords,9187,3,14,7,9,69,47,22,49
Copenhagen,9187,4,13,6,11,57,47,10,45
AC Horsens,9187,5,7,14,9,34,52,-18,35
AaB,9187,6,7,13,10,37,42,-5,34
Sonderjyske,9187,7,8,6,10,28,29,-1,30
Randers FC,9187,8,5,7,12,24,40,-16,22
Silkeborg IF,9187,9,6,3,13,28,45,-17,21
Lyngby,9187,10,3,10,11,27,45,-18,19
AGF Aarhus,9187,11,4,6,12,17,39,-22,18
Brondby,9188,1,22,6,2,72,31,41,72
FC Midtjylla,9188,2,20,4,6,70,40,30,64
FC Nords,9188,3,14,6,10,72,53,19,48
Copenhagen,9188,4,14,4,12,55,47,8,46
AaB,9188,5,8,11,11,35,40,-5,35
AC Horsens,9188,6,6,13,11,33,52,-19,31
Sonderjyske,9188,7,8,6,10,28,29,-1,30
Randers FC,9188,8,6,6,12,26,39,-13,24
AGF Aarhus,9188,9,5,6,11,18,37,-19,21
Silkeborg IF,9188,10,5,3,14,26,46,-20,18
Lyngby,9188,11,3,9,12,26,47,-21,18
Brondby,9189,1,20,6,4,69,31,38,66
FC Midtjylla,9189,2,19,5,6,66,40,26,62
FC Nords,9189,3,15,7,8,75,49,26,52
Copenhagen,9189,4,14,5,11,55,44,11,47
AaB,9189,5,9,11,10,36,40,-4,38
Sonderjyske,9189,6,8,6,10,28,29,-1,30
AC Horsens,9189,7,6,12,12,31,54,-23,30
Lyngby,9189,8,4,9,11,29,44,-15,21
Silkeborg IF,9189,9,6,3,13,27,44,-17,21
Randers FC,9189,10,5,6,13,23,42,-19,21
AGF Aarhus,9189,11,4,6,12,16,38,-22,18
FC Midtjylla,9190,1,20,4,6,65,37,28,64
Brondby,9190,2,18,7,5,66,35,31,61
FC Nords,9190,3,14,8,8,73,51,22,50
Copenhagen,9190,4,15,4,11,56,43,13,49
AC Horsens,9190,5,9,13,8,39,49,-10,40
Sonderjyske,9190,6,8,6,10,28,29,-1,30
AaB,9190,7,6,12,12,34,44,-10,30
Lyngby,9190,8,4,9,11,29,44,-15,21
Silkeborg IF,9190,9,6,3,13,26,44,-18,21
Randers FC,9190,10,5,6,13,23,42,-19,21
AGF Aarhus,9190,11,4,6,12,16,37,-21,18
FC Midtjylla,9191,1,21,5,4,71,38,33,68
Brondby,9191,2,20,7,3,70,30,40,67
FC Nords,9191,3,14,7,9,74,52,22,49
Copenhagen,9191,4,13,6,11,57,46,11,45
AaB,9191,5,7,13,10,40,52,-12,34
Sonderjyske,9191,6,8,6,10,28,29,-1,30
AC Horsens,9191,7,5,14,11,34,54,-20,29
Lyngby,9191,8,4,9,11,29,44,-15,21
Silkeborg IF,9191,9,6,3,13,29,45,-16,21
Randers FC,9191,10,5,6,13,23,42,-19,21
AGF Aarhus,9191,11,4,6,12,17,40,-23,18
Brondby,9192,1,19,7,4,68,33,35,64
FC Midtjylla,9192,2,19,6,5,62,36,26,63
FC Nords,9192,3,16,7,7,74,49,25,55
Copenhagen,9192,4,13,5,12,54,43,11,44
AC Horsens,9192,5,8,13,9,38,49,-11,37
Sonderjyske,9192,6,8,6,10,28,29,-1,30
AaB,9192,7,6,12,12,36,48,-12,30
Lyngby,9192,8,4,9,11,31,45,-14,21
Randers FC,9192,9,5,6,13,24,44,-20,21
Silkeborg IF,9192,10,5,4,13,25,44,-19,19
AGF Aarhus,9192,11,4,7,11,16,36,-20,19
Brondby,9193,1,20,6,4,72,34,38,66
FC Midtjylla,9193,2,19,5,6,68,42,26,62
Copenhagen,9193,3,15,5,10,61,44,17,50
FC Nords,9193,4,14,7,9,74,57,17,49
AC Horsens,9193,5,7,13,10,36,55,-19,34
AaB,9193,6,7,12,11,37,42,-5,33
Sonderjyske,9193,7,8,6,10,28,29,-1,30
Lyngby,9193,8,4,9,11,28,45,-17,21
Randers FC,9193,9,5,6,13,24,41,-17,21
Silkeborg IF,9193,10,5,4,13,26,45,-19,19
AGF Aarhus,9193,11,4,7,11,17,37,-20,19
Brondby,9194,1,21,7,2,70,30,40,70
FC Midtjylla,9194,2,17,7,6,60,38,22,58
FC Nords,9194,3,15,6,9,71,49,22,51
Copenhagen,9194,4,13,6,11,55,44,11,45
AaB,9194,5,8,12,10,35,41,-6,36
AC Horsens,9194,6,7,12,11,33,48,-15,33
Sonderjyske,9194,7,8,6,10,28,29,-1,30
Randers FC,9194,8,5,7,12,24,40,-16,22
Silkeborg IF,9194,9,6,3,13,27,44,-17,21
Lyngby,9194,10,3,10,11,27,45,-18,19
AGF Aarhus,9194,11,4,6,12,16,38,-22,18
Brondby,9195,1,20,8,2,68,30,38,68
FC Midtjylla,9195,2,20,5,5,64,38,26,65
FC Nords,9195,3,13,9,8,76,53,23,48
Copenhagen,9195,4,12,7,11,54,46,8,43
AaB,9195,5,7,13,10,35,43,-8,34
AC Horsens,9195,6,7,12,11,38,51,-13,33
Sonderjyske,9195,7,8,6,10,28,29,-1,30
Randers FC,9195,8,5,7,12,24,40,-16,22
Lyngby,9195,9,3,10,11,27,45,-18,19
Silkeborg IF,9195,10,5,4,13,25,44,-19,19
AGF Aarhus,9195,11,4,7,11,16,36,-20,19
Brondby,9196,1,20,5,5,74,37,37,65
FC Midtjylla,9196,2,20,5,5,67,39,28,65
FC Nords,9196,3,13,9,8,76,55,21,48
Copenhagen,9196,4,13,5,12,57,49,8,44
AC Horsens,9196,5,8,13,9,38,51,-13,37
AaB,9196,6,7,13,10,38,45,-7,34
Sonderjyske,9196,7,8,6,10,28,29,-1,30
Lyngby,9196,8,4,9,11,28,45,-17,21
Randers FC,9196,9,5,6,13,24,41,-17,21
Silkeborg IF,9196,10,5,4,13,25,44,-19,19
AGF Aarhus,9196,11,4,7,11,16,36,-20,19
Brondby,9197,1,20,5,5,69,34,35,65
FC Midtjylla,9197,2,19,4,7,64,43,21,61
FC Nords,9197,3,14,8,8,75,50,25,50
Copenhagen,9197,4,14,5,11,57,46,11,47
AaB,9197,5,8,13,9,38,42,-4,37
AC Horsens,9197,6,7,13,10,34,48,-14,34
Sonderjyske,9197,7,8,6,10,28,29,-1,30
Lyngby,9197,8,4,9,11,28,44,-16,21
Randers FC,9197,9,5,6,13,23,41,-18,21
AGF Aarhus,9197,10,5,6,11,19,37,-18,21
Silkeborg IF,9197,11,5,3,14,26,47,-21,18
Brondby,9198,1,21,5,4,69,31,38,68
FC Midtjylla,9198,2,19,6,5,65,42,23,63
FC Nords,9198,3,15,7,8,76,48,28,52
Copenhagen,9198,4,13,4,13,54,49,5,43
AaB,9198,5,8,12,10,38,43,-5,36
AC Horsens,9198,6,7,12,11,34,49,-15,33
Sonderjyske,9198,7,8,6,10,28,29,-1,30
Lyngby,9198,8,4,9,11,28,45,-17,21
Randers FC,9198,9,5,6,13,24,41,-17,21
Silkeborg IF,9198,10,5,4,13,27,46,-19,19
AGF Aarhus,9198,11,4,7,11,18,38,-20,19
FC Midtjylla,9199,1,22,4,4,70,36,34,70
Brondby,9199,2,21,6,3,72,33,39,69
FC Nords,9199,3,14,7,9,71,51,20,49
Copenhagen,9199,4,13,4,13,54,49,5,43
AaB,9199,5,7,13,10,38,43,-5,34
Sonderjyske,9199,6,8,6,10,28,29,-1,30
AC Horsens,9199,7,6,12,12,35,54,-19,30
Randers FC,9199,8,5,7,12,24,40,-16,22
Silkeborg IF,9199,9,6,3,13,26,44,-18,21
Lyngby,9199,10,3,10,11,27,45,-18,19
AGF Aarhus,9199,11,4,6,12,16,37,-21,18
Brondby,9200,1,21,6,3,73,34,39,69
FC Midtjylla,9200,2,18,4,8,63,43,20,58
FC Nords,9200,3,15,7,8,74,50,24,52
Copenhagen,9200,4,13,4,13,56,45,11,43
AaB,9200,5,8,13,9,38,41,-3,37
AC Horsens,9200,6,8,12,10,35,52,-17,36
Sonderjyske,9200,7,8,6,10,28,29,-1,30
Silkeborg IF,9200,8,6,3,13,30,46,-16,21
Lyngby,9200,9,4,9,11,28,44,-16,21
Randers FC,9200,10,5,6,13,23,41,-18,21
AGF Aarhus,9200,11,4,6,12,18,41,-23,18
Brondby,9201,1,21,7,2,72,32,40,70
FC Midtjylla,9201,2,18,5,7,65,43,22,59
FC Nords,9201,3,13,8,9,69,52,17,47
Copenhagen,9201,4,13,5,12,57,49,8,44
AaB,9201,5,8,14,8,41,41,0,38
AC Horsens,9201,6,7,13,10,36,49,-13,34
Sonderjyske,9201,7,8,6,10,28,29,-1,30
Lyngby,9201,8,4,9,11,29,45,-16,21
Silkeborg IF,9201,9,6,3,13,26,44,-18,21
Randers FC,9201,10,5,6,13,24,42,-18,21
AGF Aarhus,9201,11,4,6,12,16,37,-21,18
Brondby,9202,1,18,8,4,66,33,33,62
FC Midtjylla,9202,2,18,7,5,65,42,23,61
FC Nords,9202,3,16,7,7,78,48,30,55
Copenhagen,9202,4,14,6,10,59,45,14,48
AaB,9202,5,6,14,10,39,46,-7,32
AC Horsens,9202,6,6,14,10,36,55,-19,32
Sonderjyske,9202,7,8,6,10,28,29,-1,30
Randers FC,9202,8,5,7,12,24,40,-16,22
AGF Aarhus,9202,9,5,6,11,18,36,-18,21
Lyngby,9202,10,3,10,11,27,45,-18,19
Silkeborg IF,9202,11,5,3,14,25,46,-21,18
Brondby,9203,1,20,5,5,65,30,35,65
FC Midtjylla,9203,2,20,5,5,62,39,23,65
FC Nords,9203,3,14,8,8,76,49,27,50
Copenhagen,9203,4,14,5,11,56,47,9,47
AC Horsens,9203,5,8,12,10,38,51,-13,36
AaB,9203,6,6,13,11,37,44,-7,31
Sonderjyske,9203,7,8,6,10,28,29,-1,30
Randers FC,9203,8,5,7,12,24,40,-16,22
Lyngby,9203,9,3,10,11,27,45,-18,19
Silkeborg IF,9203,10,5,4,13,26,45,-19,19
AGF Aarhus,9203,11,4,7,11,17,37,-20,19
Brondby,9204,1,21,6,3,74,36,38,69
FC Midtjylla,9204,2,21,4,5,72,39,33,67
FC Nords,9204,3,13,7,10,72,54,18,46
Copenhagen,9204,4,13,5,12,56,49,7,44
AaB,9204,5,9,11,10,41,42,-1,38
AC Horsens,9204,6,6,13,11,34,55,-21,31
Sonderjyske,9204,7,8,6,10,28,29,-1,30
Silkeborg IF,9204,8,6,3,13,28,44,-16,21
Lyngby,9204,9,4,9,11,28,45,-17,21
Randers FC,9204,10,5,6,13,24,41,-17,21
AGF Aarhus,9204,11,4,6,12,16,39,-23,18
Brondby,9205,1,21,6,3,70,29,41,69
FC Midtjylla,9205,2,20,5,5,66,37,29,65
FC Nords,9205,3,14,7,9,72,53,19,49
Copenhagen,9205,4,14,5,11,56,43,13,47
AaB,9205,5,8,13,9,35,39,-4,37
Sonderjyske,9205,6,8,6,10,28,29,-1,30
AC Horsens,9205,7,5,12,13,31,55,-24,27
Silkeborg IF,9205,8,6,3,13,28,44,-16,21
Lyngby,9205,9,4,9,11,27,44,-17,21
Randers FC,9205,10,5,6,13,23,40,-17,21
AGF Aarhus,9205,11,4,6,12,16,39,-23,18
Brondby,9206,1,22,5,3,79,31,48,71
FC Midtjylla,9206,2,17,4,9,59,46,13,55
FC Nords,9206,3,14,6,10,74,56,18,48
Copenhagen,9206,4,14,6,10,61,46,15,48
AaB,9206,5,9,12,9,39,40,-1,39
AC Horsens,9206,6,7,13,10,34,53,-19,34
Sonderjyske,9206,7,8,6,10,28,29,-1,30
Randers FC,9206,8,6,6,12,24,39,-15,24
Silkeborg IF,9206,9,6,3,13,27,44,-17,21
Lyngby,9206,10,3,9,12,26,45,-19,18
AGF Aarhus,9206,11,4,6,12,16,38,-22,18
Brondby,9207,1,21,6,3,72,33,39,69
FC Midtjylla,9207,2,18,6,6,62,40,22,60
FC Nords,9207,3,15,8,7,77,49,28,53
Copenhagen,9207,4,14,7,9,61,46,15,49
AaB,9207,5,7,12,11,33,43,-10,33
Sonderjyske,9207,6,8,6,10,28,29,-1,30
AC Horsens,9207,7,5,13,12,35,55,-20,28
Randers FC,9207,8,5,7,12,24,40,-16,22
AGF Aarhus,9207,9,5,6,11,19,37,-18,21
Lyngby,9207,10,3,10,11,27,45,-18,19
Silkeborg IF,9207,11,5,3,14,26,47,-21,18
Brondby,9208,1,20,7,3,69,33,36,67
FC Midtjylla,9208,2,18,5,7,63,43,20,59
FC Nords,9208,3,15,8,7,77,51,26,53
Copenhagen,9208,4,15,4,11,63,49,14,49
AaB,9208,5,8,12,10,39,42,-3,36
Sonderjyske,9208,6,8,6,10,28,29,-1,30
AC Horsens,9208,7,6,12,12,34,53,-19,30
Randers FC,9208,8,6,6,12,24,39,-15,24
Silkeborg IF,9208,9,6,3,13,27,45,-18,21
Lyngby,9208,10,3,9,12,26,45,-19,18
AGF Aarhus,9208,11,4,6,12,17,38,-21,18
Brondby,9209,1,23,5,2,73,29,44,74
FC Midtjylla,9209,2,21,4,5,70,38,32,67
FC Nords,9209,3,13,6,11,69,57,12,45
Copenhagen,9209,4,13,5,12,57,46,11,44
AaB,9209,5,7,13,10,34,40,-6,34
AC Horsens,9209,6,6,13,11,33,52,-19,31
Sonderjyske,9209,7,8,6,10,28,29,-1,30
Randers FC,9209,8,6,6,12,24,39,-15,24
Silkeborg IF,9209,9,6,3,13,26,44,-18,21
Lyngby,9209,10,3,9,12,26,45,-19,18
AGF Aarhus,9209,11,4,6,12,16,37,-21,18
Brondby,9210,1,21,5,4,68,32,36,68
FC Midtjylla,9210,2,20,5,5,70,42,28,65
FC Nords,9210,3,14,7,9,72,53,19,49
Copenhagen,9210,4,14,6,10,59,42,17,48
AaB,9210,5,7,12,11,38,48,-10,33
AC Horsens,9210,6,6,13,11,38,54,-16,31
Sonderjyske,9210,7,8,6,10,28,29,-1,30
Randers FC,9210,8,5,7,12,26,42,-16,22
Silkeborg IF,9210,9,6,3,13,29,46,-17,21
Lyngby,9210,10,3,10,11,29,47,-18,19
AGF Aarhus,9210,11,4,6,12,18,40,-22,18
Brondby,9211,1,20,7,3,74,36,38,67
FC Midtjylla,9211,2,19,6,5,73,44,29,63
Copenhagen,9211,3,14,7,9,62,46,16,49
FC Nords,9211,4,13,7,10,75,60,15,46
AC Horsens,9211,5,7,13,10,38,51,-13,34
AaB,9211,6,7,12,11,38,49,-11,33
Sonderjyske,9211,7,8,6,10,28,29,-1,30
Randers FC,9211,8,5,7,12,25,41,-16,22
Lyngby,9211,9,3,10,11,28,46,-18,19
Silkeborg IF,9211,10,5,4,13,27,46,-19,19
AGF Aarhus,9211,11,4,7,11,18,38,-20,19
FC Midtjylla,9212,1,21,5,4,69,39,30,68
Brondby,9212,2,20,6,4,71,36,35,66
Copenhagen,9212,3,14,6,10,56,42,14,48
FC Nords,9212,4,13,8,9,74,53,21,47
AaB,9212,5,6,14,10,36,43,-7,32
AC Horsens,9212,6,6,13,11,34,53,-19,31
Sonderjyske,9212,7,8,6,10,28,29,-1,30
Lyngby,9212,8,4,9,11,28,45,-17,21
Randers FC,9212,9,5,6,13,24,41,-17,21
AGF Aarhus,9212,10,5,6,11,18,36,-18,21
Silkeborg IF,9212,11,5,3,14,25,46,-21,18
Brondby,9213,1,20,6,4,72,33,39,66
FC Midtjylla,9213,2,20,6,4,66,36,30,66
FC Nords,9213,3,14,8,8,74,51,23,50
Copenhagen,9213,4,15,4,11,61,47,14,49
AC Horsens,9213,5,7,12,11,35,54,-19,33
Sonderjyske,9213,6,8,6,10,28,29,-1,30
AaB,9213,7,6,12,12,37,50,-13,30
Lyngby,9213,8,4,9,11,28,44,-16,21
Silkeborg IF,9213,9,6,3,13,27,45,-18,21
Randers FC,9213,10,5,6,13,23,41,-18,21
AGF Aarhus,9213,11,4,6,12,17,38,-21,18
FC Midtjylla,9214,1,21,4,5,71,43,28,67
Brondby,9214,2,20,5,5,71,35,36,65
FC Nords,9214,3,16,7,7,81,49,32,55
Copenhagen,9214,4,13,5,12,59,50,9,44
AaB,9214,5,7,13,10,40,48,-8,34
Sonderjyske,9214,6,8,6,10,28,29,-1,30
AC Horsens,9214,7,5,14,11,35,58,-23,29
Randers FC,9214,8,6,6,12,25,40,-15,24
Silkeborg IF,9214,9,6,3,13,27,44,-17,21
Lyngby,9214,10,3,9,12,27,46,-19,18
AGF Aarhus,9214,11,4,6,12,16,38,-22,18
Brondby,9215,1,20,5,5,65,33,32,65
FC Midtjylla,9215,2,19,6,5,66,40,26,63
FC Nords,9215,3,15,6,9,77,51,26,51
Copenhagen,9215,4,13,6,11,54,47,7,45
AaB,9215,5,8,13,9,39,38,1,37
AC Horsens,9215,6,6,14,10,34,52,-18,32
Sonderjyske,9215,7,8,6,10,28,29,-1,30
Lyngby,9215,8,4,9,11,28,44,-16,21
Randers FC,9215,9,5,6,13,23,41,-18,21
Silkeborg IF,9215,10,5,4,13,27,46,-19,19
AGF Aarhus,9215,11,4,7,11,18,38,-20,19
Brondby,9216,1,20,6,4,72,33,39,66
FC Midtjylla,9216,2,19,7,4,64,38,26,64
FC Nords,9216,3,15,6,9,73,49,24,51
Copenhagen,9216,4,14,4,12,59,48,11,46
AC Horsens,9216,5,7,13,10,39,54,-15,34
AaB,9216,6,7,12,11,33,44,-11,33
Sonderjyske,9216,7,8,6,10,28,29,-1,30
Lyngby,9216,8,4,9,11,28,45,-17,21
Randers FC,9216,9,5,6,13,24,41,-17,21
AGF Aarhus,9216,10,5,6,11,18,36,-18,21
Silkeborg IF,9216,11,5,3,14,25,46,-21,18
Brondby,9217,1,20,5,5,69,36,33,65
FC Midtjylla,9217,2,19,5,6,67,41,26,62
Copenhagen,9217,3,16,5,9,62,43,19,53
FC Nords,9217,4,13,7,10,74,56,18,46
AC Horsens,9217,5,8,12,10,38,53,-15,36
AaB,9217,6,7,12,11,38,45,-7,33
Sonderjyske,9217,7,8,6,10,28,29,-1,30
Randers FC,9217,8,5,7,12,23,39,-16,22
Silkeborg IF,9217,9,6,3,13,28,44,-16,21
Lyngby,9217,10,3,10,11,26,44,-18,19
AGF Aarhus,9217,11,4,6,12,16,39,-23,18
Brondby,9218,1,21,7,2,73,31,42,70
FC Midtjylla,9218,2,18,5,7,65,45,20,59
FC Nords,9218,3,13,8,9,72,54,18,47
Copenhagen,9218,4,13,5,12,55,46,9,44
AaB,9218,5,8,14,8,41,40,1,38
AC Horsens,9218,6,7,13,10,35,51,-16,34
Sonderjyske,9218,7,8,6,10,28,29,-1,30
Randers FC,9218,8,5,7,12,26,42,-16,22
Silkeborg IF,9218,9,6,3,13,27,45,-18,21
Lyngby,9218,10,3,10,11,29,47,-18,19
AGF Aarhus,9218,11,4,6,12,17,38,-21,18
Brondby,9219,1,20,7,3,71,34,37,67
FC Midtjylla,9219,2,20,4,6,69,41,28,64
Copenhagen,9219,3,15,6,9,63,44,19,51
FC Nords,9219,4,13,6,11,72,59,13,45
AC Horsens,9219,5,7,13,10,35,50,-15,34
AaB,9219,6,7,12,11,40,48,-8,33
Sonderjyske,9219,7,8,6,10,28,29,-1,30
Randers FC,9219,8,5,7,12,26,42,-16,22
Silkeborg IF,9219,9,6,3,13,29,44,-15,21
Lyngby,9219,10,3,10,11,29,47,-18,19
AGF Aarhus,9219,11,4,6,12,16,40,-24,18
Brondby,9220,1,21,6,3,70,33,37,69
FC Midtjylla,9220,2,19,5,6,64,36,28,62
FC Nords,9220,3,14,6,10,72,52,20,48
Copenhagen,9220,4,14,5,11,57,44,13,47
AaB,9220,5,8,13,9,34,38,-4,37
AC Horsens,9220,6,6,13,11,36,56,-20,31
Sonderjyske,9220,7,8,6,10,28,29,-1,30
Lyngby,9220,8,4,9,11,29,46,-17,21
Randers FC,9220,9,5,6,13,25,42,-17,21
Silkeborg IF,9220,10,5,4,13,27,46,-19,19
AGF Aarhus,9220,11,4,7,11,18,38,-20,19
Brondby,9221,1,21,6,3,72,29,43,69
FC Midtjylla,9221,2,20,5,5,69,39,30,65
FC Nords,9221,3,13,8,9,73,56,17,47
Copenhagen,9221,4,13,4,13,56,48,8,43
AaB,9221,5,9,11,10,39,43,-4,38
AC Horsens,9221,6,6,14,10,34,54,-20,32
Sonderjyske,9221,7,8,6,10,28,29,-1,30
Randers FC,9221,8,6,6,12,27,42,-15,24
Silkeborg IF,9221,9,6,3,13,27,45,-18,21
Lyngby,9221,10,3,9,12,29,48,-19,18
AGF Aarhus,9221,11,4,6,12,17,38,-21,18
Brondby,9222,1,22,6,2,71,30,41,72
FC Midtjylla,9222,2,18,5,7,61,39,22,59
FC Nords,9222,3,15,6,9,73,52,21,51
Copenhagen,9222,4,13,6,11,58,45,13,45
AaB,9222,5,7,13,10,39,44,-5,34
AC Horsens,9222,6,6,14,10,35,53,-18,32
Sonderjyske,9222,7,8,6,10,28,29,-1,30
Randers FC,9222,8,5,7,12,23,39,-16,22
Silkeborg IF,9222,9,6,3,13,27,45,-18,21
Lyngby,9222,10,3,10,11,26,44,-18,19
AGF Aarhus,9222,11,4,6,12,17,38,-21,18
FC Midtjylla,9223,1,20,5,5,68,36,32,65
Brondby,9223,2,19,7,4,64,32,32,64
Copenhagen,9223,3,15,5,10,60,44,16,50
FC Nords,9223,4,14,6,10,71,52,19,48
AaB,9223,5,8,12,10,39,47,-8,36
AC Horsens,9223,6,6,13,11,36,53,-17,31
Sonderjyske,9223,7,8,6,10,28,29,-1,30
Randers FC,9223,8,5,7,12,24,40,-16,22
Silkeborg IF,9223,9,6,3,13,28,44,-16,21
Lyngby,9223,10,3,10,11,27,45,-18,19
AGF Aarhus,9223,11,4,6,12,16,39,-23,18
FC Midtjylla,9224,1,20,5,5,69,40,29,65
Brondby,9224,2,18,6,6,67,39,28,60
FC Nords,9224,3,15,8,7,80,51,29,53
Copenhagen,9224,4,14,6,10,57,42,15,48
AaB,9224,5,7,13,10,33,38,-5,34
AC Horsens,9224,6,7,12,11,38,60,-22,33
Sonderjyske,9224,7,8,6,10,28,29,-1,30
Randers FC,9224,8,6,6,12,24,39,-15,24
AGF Aarhus,9224,9,5,6,11,18,37,-19,21
Lyngby,9224,10,3,9,12,26,45,-19,18
Silkeborg IF,9224,11,5,3,14,26,46,-20,18
FC Midtjylla,9225,1,22,4,4,67,34,33,70
Brondby,9225,2,19,5,6,66,36,30,62
FC Nords,9225,3,16,6,8,79,51,28,54
Copenhagen,9225,4,13,4,13,55,47,8,43
AaB,9225,5,8,11,11,39,46,-7,35
AC Horsens,9225,6,7,12,11,34,52,-18,33
Sonderjyske,9225,7,8,6,10,28,29,-1,30
Randers FC,9225,8,6,6,12,25,39,-14,24
AGF Aarhus,9225,9,5,6,11,18,37,-19,21
Lyngby,9225,10,3,9,12,26,46,-20,18
Silkeborg IF,9225,10,5,3,14,26,46,-20,18
Brondby,9226,1,19,7,4,67,39,28,64
FC Midtjylla,9226,2,18,6,6,67,43,24,60
FC Nords,9226,3,15,6,9,77,52,25,51
Copenhagen,9226,4,14,5,11,63,47,16,47
AaB,9226,5,8,13,9,43,46,-3,37
AC Horsens,9226,6,7,13,10,34,50,-16,34
Sonderjyske,9226,7,8,6,10,28,29,-1,30
Lyngby,9226,8,4,9,11,27,44,-17,21
Randers FC,9226,9,5,6,13,23,40,-17,21
Silkeborg IF,9226,10,6,3,13,26,44,-18,21
AGF Aarhus,9226,11,4,6,12,16,37,-21,18
Brondby,9227,1,21,6,3,72,33,39,69
FC Midtjylla,9227,2,20,5,5,70,42,28,65
FC Nords,9227,3,14,7,9,76,52,24,49
Copenhagen,9227,4,14,6,10,58,43,15,48
AaB,9227,5,6,15,9,34,40,-6,33
Sonderjyske,9227,6,8,6,10,28,29,-1,30
AC Horsens,9227,7,5,13,12,36,62,-26,28
Randers FC,9227,8,6,6,12,25,40,-15,24
Silkeborg IF,9227,9,5,4,13,27,46,-19,19
AGF Aarhus,9227,10,4,7,11,18,38,-20,19
Lyngby,9227,11,3,9,12,27,46,-19,18
Brondby,9228,1,19,6,5,66,34,32,63
FC Midtjylla,9228,2,19,6,5,63,38,25,63
FC Nords,9228,3,13,10,7,73,51,22,49
Copenhagen,9228,4,14,6,10,59,44,15,48
AaB,9228,5,8,13,9,37,40,-3,37
AC Horsens,9228,6,6,13,11,33,50,-17,31
Sonderjyske,9228,7,8,6,10,28,29,-1,30
Lyngby,9228,8,4,9,11,29,45,-16,21
Silkeborg IF,9228,9,6,3,13,27,44,-17,21
Randers FC,9228,10,5,6,13,24,42,-18,21
AGF Aarhus,9228,11,4,6,12,16,38,-22,18
Brondby,9229,1,22,5,3,72,30,42,71
FC Midtjylla,9229,2,19,4,7,64,43,21,61
FC Nords,9229,3,14,6,10,76,52,24,48
Copenhagen,9229,4,14,4,12,54,43,11,46
AC Horsens,9229,5,8,12,10,37,54,-17,36
AaB,9229,6,8,11,11,38,45,-7,35
Sonderjyske,9229,7,8,6,10,28,29,-1,30
Randers FC,9229,8,6,6,12,26,39,-13,24
Silkeborg IF,9229,9,5,4,13,25,44,-19,19
AGF Aarhus,9229,10,4,7,11,16,36,-20,19
Lyngby,9229,11,3,9,12,26,47,-21,18
Brondby,9230,1,19,8,3,69,37,32,65
FC Midtjylla,9230,2,19,4,7,66,45,21,61
FC Nords,9230,3,15,7,8,79,51,28,52
Copenhagen,9230,4,13,6,11,56,46,10,45
AaB,9230,5,7,13,10,36,42,-6,34
AC Horsens,9230,6,6,16,8,37,48,-11,34
Sonderjyske,9230,7,8,6,10,28,29,-1,30
Silkeborg IF,9230,8,6,3,13,28,45,-17,21
Lyngby,9230,9,4,9,11,27,44,-17,21
Randers FC,9230,10,5,6,13,23,40,-17,21
AGF Aarhus,9230,11,4,6,12,17,39,-22,18
Brondby,9231,1,21,5,4,73,38,35,68
FC Midtjylla,9231,2,18,4,8,66,42,24,58
Copenhagen,9231,3,16,4,10,61,44,17,52
FC Nords,9231,4,15,6,9,77,53,24,51
AaB,9231,5,9,11,10,39,43,-4,38
Sonderjyske,9231,6,8,6,10,28,29,-1,30
AC Horsens,9231,7,6,12,12,35,57,-22,30
Lyngby,9231,8,4,9,11,28,45,-17,21
Randers FC,9231,9,5,6,13,24,41,-17,21
AGF Aarhus,9231,10,5,6,11,18,36,-18,21
Silkeborg IF,9231,11,5,3,14,25,46,-21,18
FC Midtjylla,9232,1,22,4,4,69,39,30,70
Brondby,9232,2,21,6,3,73,34,39,69
FC Nords,9232,3,13,7,10,70,54,16,46
Copenhagen,9232,4,13,5,12,53,42,11,44
AaB,9232,5,8,11,11,41,43,-2,35
AC Horsens,9232,6,6,13,11,31,51,-20,31
Sonderjyske,9232,7,8,6,10,28,29,-1,30
Randers FC,9232,8,5,7,12,24,40,-16,22
AGF Aarhus,9232,9,5,6,11,18,36,-18,21
Lyngby,9232,10,3,10,11,27,45,-18,19
Silkeborg IF,9232,11,5,3,14,25,46,-21,18
Brondby,9233,1,21,7,2,73,29,44,70
FC Midtjylla,9233,2,20,5,5,69,39,30,65
FC Nords,9233,3,15,7,8,74,51,23,52
Copenhagen,9233,4,14,5,11,60,44,16,47
Sonderjyske,9233,5,8,6,10,28,29,-1,30
AaB,9233,6,6,12,12,33,49,-16,30
AC Horsens,9233,7,6,12,12,34,57,-23,30
Randers FC,9233,8,5,7,12,24,40,-16,22
Lyngby,9233,9,3,10,11,27,45,-18,19
Silkeborg IF,9233,10,5,4,13,27,46,-19,19
AGF Aarhus,9233,11,4,7,11,18,38,-20,19
FC Midtjylla,9234,1,20,6,4,72,36,36,66
Brondby,9234,2,20,6,4,68,33,35,66
FC Nords,9234,3,14,8,8,75,52,23,50
Copenhagen,9234,4,14,5,11,57,51,6,47
AaB,9234,5,7,12,11,39,44,-5,33
AC Horsens,9234,6,6,13,11,35,56,-21,31
Sonderjyske,9234,7,8,6,10,28,29,-1,30
Lyngby,9234,8,4,9,11,30,45,-15,21
Silkeborg IF,9234,9,6,3,13,28,45,-17,21
Randers FC,9234,10,5,6,13,24,43,-19,21
AGF Aarhus,9234,11,4,6,12,17,39,-22,18
Brondby,9235,1,21,6,3,71,36,35,69
FC Midtjylla,9235,2,20,5,5,62,34,28,65
FC Nords,9235,3,14,7,9,73,51,22,49
Copenhagen,9235,4,12,6,12,57,53,4,42
AaB,9235,5,9,12,9,45,41,4,39
Sonderjyske,9235,6,8,6,10,28,29,-1,30
AC Horsens,9235,7,5,14,11,35,54,-19,29
Silkeborg IF,9235,8,6,3,13,28,45,-17,21
Lyngby,9235,9,4,9,11,27,44,-17,21
Randers FC,9235,10,5,6,13,23,40,-17,21
AGF Aarhus,9235,11,4,6,12,17,39,-22,18
Brondby,9236,1,20,7,3,71,32,39,67
FC Midtjylla,9236,2,20,5,5,64,36,28,65
FC Nords,9236,3,16,6,8,80,54,26,54
Copenhagen,9236,4,14,5,11,56,43,13,47
AaB,9236,5,7,13,10,39,47,-8,34
Sonderjyske,9236,6,8,6,10,28,29,-1,30
AC Horsens,9236,7,5,12,13,32,56,-24,27
Lyngby,9236,8,4,9,11,29,45,-16,21
Randers FC,9236,9,5,6,13,24,42,-18,21
AGF Aarhus,9236,10,5,6,11,18,37,-19,21
Silkeborg IF,9236,11,5,3,14,26,46,-20,18
Brondby,9237,1,21,7,2,73,30,43,70
FC Midtjylla,9237,2,17,6,7,60,44,16,57
Copenhagen,9237,3,13,6,11,60,45,15,45
FC Nords,9237,4,12,8,10,71,57,14,44
AaB,9237,5,9,12,9,40,41,-1,39
AC Horsens,9237,6,8,13,9,36,49,-13,37
Sonderjyske,9237,7,8,6,10,28,29,-1,30
Lyngby,9237,8,4,9,11,29,44,-15,21
Silkeborg IF,9237,9,6,3,13,28,45,-17,21
Randers FC,9237,10,5,6,13,23,42,-19,21
AGF Aarhus,9237,11,4,6,12,17,39,-22,18
Brondby,9238,1,21,5,4,67,30,37,68
FC Midtjylla,9238,2,19,5,6,63,40,23,62
FC Nords,9238,3,14,8,8,75,51,24,50
Copenhagen,9238,4,14,6,10,56,43,13,48
AaB,9238,5,6,14,10,35,43,-8,32
AC Horsens,9238,6,6,14,10,36,51,-15,32
Sonderjyske,9238,7,8,6,10,28,29,-1,30
Randers FC,9238,8,6,6,12,24,39,-15,24
AGF Aarhus,9238,9,5,6,11,17,36,-19,21
Lyngby,9238,10,3,9,12,26,45,-19,18
Silkeborg IF,9238,11,5,3,14,25,45,-20,18
Brondby,9239,1,21,6,3,69,29,40,69
FC Midtjylla,9239,2,19,5,6,65,38,27,62
FC Nords,9239,3,14,6,10,71,54,17,48
Copenhagen,9239,4,14,5,11,59,43,16,47
AC Horsens,9239,5,8,12,10,38,53,-15,36
AaB,9239,6,7,12,11,35,46,-11,33
Sonderjyske,9239,7,8,6,10,28,29,-1,30
Randers FC,9239,8,6,6,12,25,40,-15,24
Silkeborg IF,9239,9,6,3,13,27,45,-18,21
Lyngby,9239,10,3,9,12,27,46,-19,18
AGF Aarhus,9239,11,4,6,12,17,38,-21,18
Brondby,9240,1,21,5,4,69,32,37,68
FC Midtjylla,9240,2,21,5,4,69,37,32,68
FC Nords,9240,3,16,6,8,77,48,29,54
Copenhagen,9240,4,13,5,12,56,48,8,44
AaB,9240,5,8,11,11,37,41,-4,35
Sonderjyske,9240,6,8,6,10,28,29,-1,30
AC Horsens,9240,7,5,12,13,30,58,-28,27
Randers FC,9240,8,5,7,12,24,40,-16,22
AGF Aarhus,9240,9,5,6,11,17,36,-19,21
Lyngby,9240,10,3,10,11,27,45,-18,19
Silkeborg IF,9240,11,5,3,14,25,45,-20,18
Brondby,9241,1,22,6,2,72,27,45,72
FC Midtjylla,9241,2,18,6,6,66,41,25,60
FC Nords,9241,3,13,7,10,74,57,17,46
Copenhagen,9241,4,13,6,11,56,45,11,45
AaB,9241,5,7,14,9,35,42,-7,35
AC Horsens,9241,6,6,15,9,33,50,-17,33
Sonderjyske,9241,7,8,6,10,28,29,-1,30
Lyngby,9241,8,4,9,11,27,44,-17,21
Randers FC,9241,9,5,6,13,23,40,-17,21
Silkeborg IF,9241,10,5,4,13,25,44,-19,19
AGF Aarhus,9241,11,4,7,11,16,36,-20,19
Brondby,9242,1,20,7,3,70,32,38,67
FC Midtjylla,9242,2,20,5,5,67,38,29,65
FC Nords,9242,3,14,7,9,72,50,22,49
Copenhagen,9242,4,15,4,11,62,45,17,49
AaB,9242,5,8,11,11,38,46,-8,35
Sonderjyske,9242,6,8,6,10,28,29,-1,30
AC Horsens,9242,7,6,12,12,35,59,-24,30
Lyngby,9242,8,4,9,11,29,45,-16,21
Randers FC,9242,9,5,6,13,24,42,-18,21
Silkeborg IF,9242,10,5,4,13,26,45,-19,19
AGF Aarhus,9242,11,4,7,11,17,37,-20,19
Brondby,9243,1,21,6,3,69,30,39,69
FC Midtjylla,9243,2,20,6,4,67,39,28,66
FC Nords,9243,3,14,6,10,74,54,20,48
Copenhagen,9243,4,13,5,12,56,48,8,44
AaB,9243,5,8,13,9,39,42,-3,37
Sonderjyske,9243,6,8,6,10,28,29,-1,30
AC Horsens,9243,7,6,12,12,39,57,-18,30
Randers FC,9243,8,6,6,12,25,40,-15,24
Silkeborg IF,9243,9,5,4,13,26,45,-19,19
AGF Aarhus,9243,10,4,7,11,17,37,-20,19
Lyngby,9243,11,3,9,12,27,46,-19,18
Brondby,9244,1,20,6,4,66,31,35,66
FC Midtjylla,9244,2,19,4,7,60,39,21,61
FC Nords,9244,3,17,6,7,78,48,30,57
Copenhagen,9244,4,13,6,11,55,43,12,45
AC Horsens,9244,5,7,13,10,35,50,-15,34
AaB,9244,6,7,11,12,36,45,-9,32
Sonderjyske,9244,7,8,6,10,28,29,-1,30
Silkeborg IF,9244,8,6,3,13,29,46,-17,21
Lyngby,9244,9,4,9,11,28,45,-17,21
Randers FC,9244,10,5,6,13,24,41,-17,21
AGF Aarhus,9244,11,4,6,12,18,40,-22,18
Brondby,9245,1,23,5,2,76,28,48,74
FC Midtjylla,9245,2,21,4,5,70,40,30,67
FC Nords,9245,3,13,8,9,76,54,22,47
Copenhagen,9245,4,13,4,13,59,55,4,43
AaB,9245,5,7,12,11,35,45,-10,33
AC Horsens,9245,6,6,13,11,36,56,-20,31
Sonderjyske,9245,7,8,6,10,28,29,-1,30
Randers FC,9245,8,5,7,12,25,41,-16,22
AGF Aarhus,9245,9,5,6,11,19,38,-19,21
Lyngby,9245,10,3,10,11,28,46,-18,19
Silkeborg IF,9245,11,5,3,14,27,47,-20,18
Brondby,9246,1,23,5,2,78,33,45,74
FC Midtjylla,9246,2,19,5,6,72,45,27,62
FC Nords,9246,3,14,7,9,81,56,25,49
Copenhagen,9246,4,13,5,12,57,51,6,44
AaB,9246,5,6,15,9,37,44,-7,33
AC Horsens,9246,6,6,13,11,33,55,-22,31
Sonderjyske,9246,7,8,6,10,28,29,-1,30
Randers FC,9246,8,6,6,12,25,40,-15,24
Silkeborg IF,9246,9,5,4,13,26,45,-19,19
AGF Aarhus,9246,10,4,7,11,17,37,-20,19
Lyngby,9246,11,3,9,12,27,46,-19,18
Brondby,9247,1,21,7,2,73,31,42,70
FC Midtjylla,9247,2,19,6,5,65,40,25,63
FC Nords,9247,3,13,8,9,76,54,22,47
Copenhagen,9247,4,14,5,11,58,47,11,47
AaB,9247,5,8,12,10,41,45,-4,36
Sonderjyske,9247,6,8,6,10,28,29,-1,30
AC Horsens,9247,7,5,14,11,35,57,-22,29
Lyngby,9247,8,4,9,11,28,45,-17,21
Silkeborg IF,9247,8,6,3,13,28,45,-17,21
Randers FC,9247,10,5,6,13,24,41,-17,21
AGF Aarhus,9247,11,4,6,12,17,39,-22,18
FC Midtjylla,9248,1,22,4,4,73,37,36,70
Brondby,9248,2,20,6,4,70,34,36,66
FC Nords,9248,3,14,6,10,73,54,19,48
Copenhagen,9248,4,13,4,13,55,49,6,43
AaB,9248,5,8,13,9,42,42,0,37
AC Horsens,9248,6,6,13,11,34,57,-23,31
Sonderjyske,9248,7,8,6,10,28,29,-1,30
Lyngby,9248,8,4,9,11,32,47,-15,21
Silkeborg IF,9248,9,6,3,13,26,44,-18,21
Randers FC,9248,10,5,6,13,26,45,-19,21
AGF Aarhus,9248,11,4,6,12,16,37,-21,18
FC Midtjylla,9249,1,22,4,4,66,33,33,70
Brondby,9249,2,19,6,5,68,34,34,63
Copenhagen,9249,3,15,4,11,58,43,15,49
FC Nords,9249,4,13,7,10,76,53,23,46
AaB,9249,5,7,14,9,34,40,-6,35
AC Horsens,9249,6,6,13,11,33,58,-25,31
Sonderjyske,9249,7,8,6,10,28,29,-1,30
Silkeborg IF,9249,8,6,3,13,29,45,-16,21
Lyngby,9249,9,4,9,11,29,46,-17,21
Randers FC,9249,10,5,6,13,25,42,-17,21
AGF Aarhus,9249,11,4,6,12,17,40,-23,18
Brondby,9250,1,22,6,2,70,30,40,72
FC Midtjylla,9250,2,20,5,5,66,40,26,65
FC Nords,9250,3,15,6,9,76,49,27,51
Copenhagen,9250,4,14,4,12,54,43,11,46
AaB,9250,5,7,11,12,34,42,-8,32
Sonderjyske,9250,6,8,6,10,28,29,-1,30
AC Horsens,9250,7,6,12,12,31,53,-22,30
Randers FC,9250,8,6,6,12,26,41,-15,24
AGF Aarhus,9250,9,5,6,11,18,37,-19,21
Lyngby,9250,10,3,9,12,28,47,-19,18
Silkeborg IF,9250,11,5,3,14,26,46,-20,18
FC Midtjylla,9251,1,21,4,5,69,36,33,67
Brondby,9251,2,20,6,4,67,33,34,66
FC Nords,9251,3,15,7,8,74,49,25,52
Copenhagen,9251,4,14,5,11,55,42,13,47
AC Horsens,9251,5,6,14,10,35,54,-19,32
Sonderjyske,9251,6,8,6,10,28,29,-1,30
AaB,9251,7,6,12,12,32,44,-12,30
Randers FC,9251,8,6,6,12,24,39,-15,24
AGF Aarhus,9251,9,5,6,11,18,36,-18,21
Lyngby,9251,10,3,9,12,26,45,-19,18
Silkeborg IF,9251,11,5,3,14,25,46,-21,18
Brondby,9252,1,21,7,2,68,27,41,70
FC Midtjylla,9252,2,19,6,5,64,40,24,63
FC Nords,9252,3,13,10,7,73,51,22,49
Copenhagen,9252,4,14,5,11,57,43,14,47
AaB,9252,5,6,14,10,34,42,-8,32
Sonderjyske,9252,6,8,6,10,28,29,-1,30
AC Horsens,9252,7,5,14,11,33,52,-19,29
Lyngby,9252,8,4,9,11,28,44,-16,21
Silkeborg IF,9252,9,6,3,13,28,45,-17,21
Randers FC,9252,10,5,6,13,23,41,-18,21
AGF Aarhus,9252,11,4,6,12,17,39,-22,18
Brondby,9253,1,19,5,6,65,33,32,62
FC Midtjylla,9253,2,19,5,6,61,37,24,62
FC Nords,9253,3,15,6,9,74,51,23,51
Copenhagen,9253,4,14,5,11,55,41,14,47
AaB,9253,5,9,12,9,42,41,1,39
AC Horsens,9253,6,7,13,10,34,54,-20,34
Sonderjyske,9253,7,8,6,10,28,29,-1,30
Randers FC,9253,8,6,6,12,26,39,-13,24
Silkeborg IF,9253,9,6,3,13,27,45,-18,21
Lyngby,9253,10,3,9,12,26,47,-21,18
AGF Aarhus,9253,11,4,6,12,17,38,-21,18
Brondby,9254,1,21,6,3,73,34,39,69
FC Midtjylla,9254,2,19,5,6,69,41,28,62
FC Nords,9254,3,15,7,8,74,49,25,52
Copenhagen,9254,4,13,4,13,54,48,6,43
AaB,9254,5,9,12,9,39,39,0,39
Sonderjyske,9254,6,8,6,10,28,29,-1,30
AC Horsens,9254,7,6,12,12,36,60,-24,30
Lyngby,9254,8,4,9,11,27,44,-17,21
Randers FC,9254,9,5,6,13,23,40,-17,21
Silkeborg IF,9254,10,6,3,13,26,44,-18,21
AGF Aarhus,9254,11,4,6,12,16,37,-21,18
FC Midtjylla,9255,1,20,5,5,67,39,28,65
Brondby,9255,2,19,6,5,66,34,32,63
FC Nords,9255,3,14,8,8,71,49,22,50
Copenhagen,9255,4,14,7,9,58,40,18,49
AaB,9255,5,7,14,9,37,41,-4,35
Sonderjyske,9255,6,8,6,10,28,29,-1,30
AC Horsens,9255,7,5,14,11,31,53,-22,29
Lyngby,9255,8,4,9,11,27,44,-17,21
Randers FC,9255,9,5,6,13,23,40,-17,21
AGF Aarhus,9255,10,5,6,11,18,37,-19,21
Silkeborg IF,9255,11,5,3,14,26,46,-20,18
Brondby,9256,1,21,6,3,70,31,39,69
FC Midtjylla,9256,2,20,4,6,62,37,25,64
FC Nords,9256,3,14,6,10,74,53,21,48
Copenhagen,9256,4,14,5,11,59,49,10,47
AC Horsens,9256,5,8,13,9,39,51,-12,37
Sonderjyske,9256,6,8,6,10,28,29,-1,30
AaB,9256,7,6,12,12,33,42,-9,30
Lyngby,9256,8,4,9,11,27,44,-17,21
Randers FC,9256,9,5,6,13,23,40,-17,21
AGF Aarhus,9256,10,5,6,11,19,38,-19,21
Silkeborg IF,9256,11,5,3,14,27,47,-20,18
Brondby,9257,1,21,6,3,77,33,44,69
FC Midtjylla,9257,2,20,5,5,69,39,30,65
Copenhagen,9257,3,14,6,10,58,45,13,48
FC Nords,9257,4,13,8,9,74,59,15,47
AaB,9257,5,7,12,11,37,45,-8,33
Sonderjyske,9257,6,8,6,10,28,29,-1,30
AC Horsens,9257,7,5,15,10,35,55,-20,30
Randers FC,9257,8,6,6,12,25,39,-14,24
AGF Aarhus,9257,9,5,6,11,19,37,-18,21
Lyngby,9257,10,3,9,12,26,46,-20,18
Silkeborg IF,9257,11,5,3,14,26,47,-21,18
Brondby,9258,1,20,5,5,72,36,36,65
FC Midtjylla,9258,2,17,5,8,62,46,16,56
FC Nords,9258,3,14,7,9,73,50,23,49
Copenhagen,9258,4,14,4,12,58,50,8,46
AC Horsens,9258,5,10,12,8,40,47,-7,42
AaB,9258,6,9,11,10,42,44,-2,38
Sonderjyske,9258,7,8,6,10,28,29,-1,30
Randers FC,9258,8,6,6,12,25,40,-15,24
Silkeborg IF,9258,9,5,4,13,28,47,-19,19
AGF Aarhus,9258,10,4,7,11,19,39,-20,19
Lyngby,9258,11,3,9,12,27,46,-19,18
Brondby,9259,1,21,7,2,68,30,38,70
FC Midtjylla,9259,2,18,5,7,64,44,20,59
FC Nords,9259,3,14,7,9,75,52,23,49
Copenhagen,9259,4,14,4,12,58,45,13,46
AaB,9259,5,8,13,9,39,42,-3,37
AC Horsens,9259,6,6,14,10,37,54,-17,32
Sonderjyske,9259,7,8,6,10,28,29,-1,30
Randers FC,9259,8,5,7,12,25,41,-16,22
Silkeborg IF,9259,9,6,3,13,26,44,-18,21
Lyngby,9259,10,3,10,11,28,46,-18,19
AGF Aarhus,9259,11,4,6,12,16,37,-21,18
Brondby,9260,1,21,5,4,71,34,37,68
FC Midtjylla,9260,2,20,5,5,69,39,30,65
FC Nords,9260,3,16,7,7,84,51,33,55
Copenhagen,9260,4,14,5,11,60,49,11,47
AC Horsens,9260,5,6,13,11,35,58,-23,31
Sonderjyske,9260,6,8,6,10,28,29,-1,30
AaB,9260,7,6,11,13,33,47,-14,29
Randers FC,9260,8,5,7,12,24,40,-16,22
AGF Aarhus,9260,9,5,6,11,18,37,-19,21
Lyngby,9260,10,3,10,11,27,45,-18,19
Silkeborg IF,9260,11,5,3,14,26,46,-20,18
Brondby,9261,1,21,5,4,74,36,38,68
FC Midtjylla,9261,2,20,4,6,65,38,27,64
Copenhagen,9261,3,15,4,11,59,47,12,49
FC Nords,9261,4,14,6,10,73,56,17,48
AaB,9261,5,8,11,11,37,41,-4,35
AC Horsens,9261,6,7,12,11,36,52,-16,33
Sonderjyske,9261,7,8,6,10,28,29,-1,30
Randers FC,9261,8,6,6,12,25,39,-14,24
Silkeborg IF,9261,9,6,3,13,28,45,-17,21
Lyngby,9261,10,3,9,12,26,46,-20,18
AGF Aarhus,9261,11,4,6,12,17,39,-22,18
FC Midtjylla,9262,1,21,4,5,68,38,30,67
Brondby,9262,2,18,8,4,66,33,33,62
FC Nords,9262,3,15,7,8,74,49,25,52
Copenhagen,9262,4,14,5,11,57,44,13,47
AaB,9262,5,7,12,11,37,45,-8,33
AC Horsens,9262,6,7,12,11,35,54,-19,33
Sonderjyske,9262,7,8,6,10,28,29,-1,30
Lyngby,9262,8,4,9,11,28,44,-16,21
Silkeborg IF,9262,9,6,3,13,28,45,-17,21
Randers FC,9262,10,5,6,13,23,41,-18,21
AGF Aarhus,9262,11,4,6,12,17,39,-22,18
Brondby,9263,1,21,6,3,68,30,38,69
FC Midtjylla,9263,2,20,5,5,64,38,26,65
FC Nords,9263,3,13,7,10,68,49,19,46
Copenhagen,9263,4,13,5,12,55,45,10,44
AaB,9263,5,9,12,9,37,38,-1,39
AC Horsens,9263,6,6,13,11,31,49,-18,31
Sonderjyske,9263,7,8,6,10,28,29,-1,30
Randers FC,9263,8,6,6,12,26,39,-13,24
Silkeborg IF,9263,9,5,4,13,25,44,-19,19
AGF Aarhus,9263,10,4,7,11,16,36,-20,19
Lyngby,9263,11,3,9,12,26,47,-21,18
FC Midtjylla,9264,1,21,5,4,71,37,34,68
Brondby,9264,2,20,6,4,66,33,33,66
Copenhagen,9264,3,15,4,11,61,45,16,49
FC Nords,9264,4,13,7,10,72,58,14,46
AC Horsens,9264,5,7,13,10,38,53,-15,34
AaB,9264,6,7,11,12,35,43,-8,32
Sonderjyske,9264,7,8,6,10,28,29,-1,30
Lyngby,9264,8,4,9,11,29,45,-16,21
Silkeborg IF,9264,9,6,3,13,26,44,-18,21
Randers FC,9264,10,5,6,13,24,42,-18,21
AGF Aarhus,9264,11,4,6,12,16,37,-21,18
FC Midtjylla,9265,1,21,5,4,73,40,33,68
Brondby,9265,2,20,6,4,73,36,37,66
FC Nords,9265,3,13,7,10,76,57,19,46
Copenhagen,9265,4,13,6,11,55,47,8,45
AC Horsens,9265,5,8,12,10,38,52,-14,36
AaB,9265,6,6,14,10,34,43,-9,32
Sonderjyske,9265,7,8,6,10,28,29,-1,30
Lyngby,9265,8,4,9,11,27,44,-17,21
Silkeborg IF,9265,8,6,3,13,27,44,-17,21
Randers FC,9265,10,5,6,13,23,40,-17,21
AGF Aarhus,9265,11,4,6,12,16,38,-22,18
Brondby,9266,1,22,5,3,74,32,42,71
FC Midtjylla,9266,2,20,5,5,71,40,31,65
Copenhagen,9266,3,14,5,11,63,50,13,47
FC Nords,9266,4,13,7,10,71,56,15,46
AaB,9266,5,8,12,10,43,47,-4,36
Sonderjyske,9266,6,8,6,10,28,29,-1,30
AC Horsens,9266,7,6,12,12,37,60,-23,30
Lyngby,9266,8,4,9,11,30,46,-16,21
Randers FC,9266,9,5,6,13,25,43,-18,21
Silkeborg IF,9266,10,5,4,13,27,46,-19,19
AGF Aarhus,9266,11,4,7,11,18,38,-20,19
Brondby,9267,1,19,7,4,66,31,35,64
FC Midtjylla,9267,2,18,5,7,65,44,21,59
Copenhagen,9267,3,16,4,10,60,43,17,52
FC Nords,9267,4,14,8,8,73,51,22,50
AC Horsens,9267,5,8,13,9,37,47,-10,37
AaB,9267,6,6,13,11,35,46,-11,31
Sonderjyske,9267,7,8,6,10,28,29,-1,30
Lyngby,9267,8,4,9,11,28,44,-16,21
Silkeborg IF,9267,9,6,3,13,27,45,-18,21
Randers FC,9267,10,5,6,13,23,41,-18,21
AGF Aarhus,9267,11,4,6,12,17,38,-21,18
FC Midtjylla,9268,1,19,6,5,67,41,26,63
Brondby,9268,2,18,7,5,69,42,27,61
Copenhagen,9268,3,15,5,10,62,42,20,50
FC Nords,9268,4,14,6,10,73,53,20,48
AaB,9268,5,8,12,10,38,42,-4,36
AC Horsens,9268,6,7,14,9,37,52,-15,35
Sonderjyske,9268,7,8,6,10,28,29,-1,30
Lyngby,9268,8,4,9,11,28,45,-17,21
Randers FC,9268,9,5,6,13,24,41,-17,21
AGF Aarhus,9268,10,5,6,11,21,40,-19,21
Silkeborg IF,9268,11,5,3,14,29,49,-20,18
Brondby,9269,1,21,5,4,70,34,36,68
FC Midtjylla,9269,2,18,6,6,67,41,26,60
Copenhagen,9269,3,16,4,10,60,43,17,52
FC Nords,9269,4,14,8,8,75,51,24,50
AaB,9269,5,7,13,10,37,42,-5,34
Sonderjyske,9269,6,8,6,10,28,29,-1,30
AC Horsens,9269,7,6,12,12,32,56,-24,30
Lyngby,9269,8,4,9,11,28,45,-17,21
Randers FC,9269,9,5,6,13,24,41,-17,21
AGF Aarhus,9269,10,5,6,11,17,36,-19,21
Silkeborg IF,9269,11,5,3,14,25,45,-20,18
Brondby,9270,1,20,5,5,68,38,30,65
FC Midtjylla,9270,2,19,5,6,66,39,27,62
Copenhagen,9270,3,16,4,10,60,43,17,52
FC Nords,9270,4,15,6,9,76,49,27,51
AaB,9270,5,8,12,10,36,41,-5,36
Sonderjyske,9270,6,8,6,10,28,29,-1,30
AC Horsens,9270,7,6,12,12,32,54,-22,30
Lyngby,9270,8,4,9,11,28,45,-17,21
Randers FC,9270,9,5,6,13,24,41,-17,21
Silkeborg IF,9270,10,5,4,13,25,44,-19,19
AGF Aarhus,9270,11,4,7,11,16,36,-20,19
Brondby,9271,1,21,6,3,72,31,41,69
FC Midtjylla,9271,2,19,4,7,63,42,21,61
FC Nords,9271,3,16,7,7,81,52,29,55
Copenhagen,9271,4,15,5,10,61,46,15,50
AaB,9271,5,7,12,11,35,46,-11,33
Sonderjyske,9271,6,8,6,10,28,29,-1,30
AC Horsens,9271,7,5,12,13,33,54,-21,27
Lyngby,9271,8,4,9,11,27,44,-17,21
Randers FC,9271,9,5,6,13,23,40,-17,21
Silkeborg IF,9271,10,5,4,13,27,46,-19,19
AGF Aarhus,9271,11,4,7,11,18,38,-20,19
Brondby,9272,1,22,5,3,73,33,40,71
FC Midtjylla,9272,2,20,4,6,74,41,33,64
FC Nords,9272,3,14,7,9,73,56,17,49
Copenhagen,9272,4,13,5,12,57,49,8,44
AaB,9272,5,9,11,10,39,43,-4,38
Sonderjyske,9272,6,8,6,10,28,29,-1,30
AC Horsens,9272,7,6,12,12,33,53,-20,30
Randers FC,9272,8,6,6,12,29,40,-11,24
Silkeborg IF,9272,9,6,3,13,26,44,-18,21
AGF Aarhus,9272,10,4,6,12,16,37,-21,18
Lyngby,9272,11,3,9,12,27,50,-23,18
Brondby,9273,1,22,5,3,70,30,40,71
FC Midtjylla,9273,2,18,5,7,60,39,21,59
FC Nords,9273,3,14,7,9,74,54,20,49
Copenhagen,9273,4,15,4,11,57,43,14,49
AaB,9273,5,8,13,9,40,42,-2,37
Sonderjyske,9273,6,8,6,10,28,29,-1,30
AC Horsens,9273,7,5,14,11,31,50,-19,29
Lyngby,9273,8,4,9,11,31,47,-16,21
Randers FC,9273,9,5,6,13,26,44,-18,21
Silkeborg IF,9273,10,5,4,13,25,44,-19,19
AGF Aarhus,9273,11,4,7,11,16,36,-20,19
FC Midtjylla,9274,1,21,5,4,70,37,33,68
Brondby,9274,2,20,7,3,69,33,36,67
FC Nords,9274,3,14,7,9,72,50,22,49
Copenhagen,9274,4,13,6,11,53,43,10,45
AaB,9274,5,7,11,12,35,43,-8,32
AC Horsens,9274,6,6,14,10,35,54,-19,32
Sonderjyske,9274,7,8,6,10,28,29,-1,30
Lyngby,9274,8,4,9,11,28,45,-17,21
Randers FC,9274,9,5,6,13,24,41,-17,21
Silkeborg IF,9274,10,6,3,13,26,44,-18,21
AGF Aarhus,9274,11,4,6,12,16,37,-21,18
Brondby,9275,1,21,7,2,69,28,41,70
FC Midtjylla,9275,2,18,5,7,65,43,22,59
FC Nords,9275,3,13,7,10,71,51,20,46
Copenhagen,9275,4,13,7,10,55,44,11,46
AaB,9275,5,8,12,10,36,42,-6,36
AC Horsens,9275,6,7,14,9,33,47,-14,35
Sonderjyske,9275,7,8,6,10,28,29,-1,30
Randers FC,9275,8,5,7,12,24,40,-16,22
Lyngby,9275,9,3,10,11,27,45,-18,19
Silkeborg IF,9275,10,5,4,13,26,45,-19,19
AGF Aarhus,9275,11,4,7,11,17,37,-20,19
Brondby,9276,1,21,7,2,73,31,42,70
FC Midtjylla,9276,2,20,5,5,67,38,29,65
FC Nords,9276,3,14,7,9,73,53,20,49
Copenhagen,9276,4,14,6,10,61,48,13,48
AC Horsens,9276,5,6,13,11,36,56,-20,31
Sonderjyske,9276,6,8,6,10,28,29,-1,30
AaB,9276,7,6,12,12,36,46,-10,30
Lyngby,9276,8,4,9,11,29,45,-16,21
Silkeborg IF,9276,9,6,3,13,26,44,-18,21
Randers FC,9276,10,5,6,13,24,42,-18,21
AGF Aarhus,9276,11,4,6,12,16,37,-21,18
Brondby,9277,1,20,6,4,70,37,33,66
FC Midtjylla,9277,2,20,4,6,69,39,30,64
FC Nords,9277,3,13,6,11,68,55,13,45
Copenhagen,9277,4,13,5,12,56,48,8,44
AC Horsens,9277,5,9,12,9,42,51,-9,39
AaB,9277,6,9,11,10,42,43,-1,38
Sonderjyske,9277,7,8,6,10,28,29,-1,30
Silkeborg IF,9277,8,6,3,13,29,44,-15,21
Lyngby,9277,9,4,9,11,28,45,-17,21
Randers FC,9277,10,5,6,13,24,41,-17,21
AGF Aarhus,9277,11,4,6,12,16,40,-24,18
Brondby,9278,1,21,7,2,74,33,41,70
FC Midtjylla,9278,2,21,4,5,69,37,32,67
Copenhagen,9278,3,14,5,11,59,46,13,47
FC Nords,9278,4,12,8,10,70,59,11,44
AaB,9278,5,7,13,10,38,44,-6,34
Sonderjyske,9278,6,8,6,10,28,29,-1,30
AC Horsens,9278,7,5,15,10,33,50,-17,30
Randers FC,9278,8,5,7,12,23,39,-16,22
Silkeborg IF,9278,9,6,3,13,27,44,-17,21
Lyngby,9278,10,3,10,11,26,44,-18,19
AGF Aarhus,9278,11,4,6,12,16,38,-22,18
Brondby,9279,1,21,7,2,72,32,40,70
FC Midtjylla,9279,2,21,5,4,67,36,31,68
FC Nords,9279,3,14,6,10,74,53,21,48
Copenhagen,9279,4,12,4,14,54,49,5,40
AaB,9279,5,9,11,10,38,44,-6,38
AC Horsens,9279,6,6,13,11,36,53,-17,31
Sonderjyske,9279,7,8,6,10,28,29,-1,30
Lyngby,9279,8,4,9,11,28,44,-16,21
Randers FC,9279,9,5,6,13,23,41,-18,21
Silkeborg IF,9279,10,5,4,13,26,45,-19,19
AGF Aarhus,9279,11,4,7,11,17,37,-20,19
Brondby,9280,1,21,5,4,70,33,37,68
FC Midtjylla,9280,2,20,4,6,65,36,29,64
FC Nords,9280,3,15,7,8,76,50,26,52
Copenhagen,9280,4,14,5,11,56,45,11,47
AaB,9280,5,7,13,10,35,41,-6,34
Sonderjyske,9280,6,8,6,10,28,29,-1,30
AC Horsens,9280,7,6,12,12,34,57,-23,30
Randers FC,9280,8,5,7,12,25,41,-16,22
Silkeborg IF,9280,9,6,3,13,28,44,-16,21
Lyngby,9280,10,3,10,11,28,46,-18,19
AGF Aarhus,9280,11,4,6,12,16,39,-23,18
Brondby,9281,1,22,5,3,77,30,47,71
FC Midtjylla,9281,2,19,4,7,65,42,23,61
FC Nords,9281,3,14,8,8,74,54,20,50
Copenhagen,9281,4,14,6,10,59,44,15,48
AaB,9281,5,8,13,9,39,44,-5,37
Sonderjyske,9281,6,8,6,10,28,29,-1,30
AC Horsens,9281,7,5,12,13,36,62,-26,27
Randers FC,9281,8,6,6,12,26,40,-14,24
Silkeborg IF,9281,9,5,4,13,27,46,-19,19
AGF Aarhus,9281,10,4,7,11,18,38,-20,19
Lyngby,9281,11,3,9,12,27,47,-20,18
FC Midtjylla,9282,1,21,5,4,71,41,30,68
Brondby,9282,2,20,6,4,73,34,39,66
FC Nords,9282,3,14,7,9,69,50,19,49
Copenhagen,9282,4,13,6,11,55,44,11,45
AaB,9282,5,8,12,10,40,45,-5,36
Sonderjyske,9282,6,8,6,10,28,29,-1,30
AC Horsens,9282,7,5,14,11,33,53,-20,29
Randers FC,9282,8,6,6,12,25,39,-14,24
Silkeborg IF,9282,9,5,4,13,26,45,-19,19
AGF Aarhus,9282,10,4,7,11,17,37,-20,19
Lyngby,9282,11,3,9,12,26,46,-20,18
FC Midtjylla,9283,1,21,5,4,67,34,33,68
Brondby,9283,2,20,5,5,74,45,29,65
Copenhagen,9283,3,15,4,11,64,48,16,49
FC Nords,9283,4,13,7,10,71,55,16,46
AaB,9283,5,9,11,10,42,43,-1,38
Sonderjyske,9283,6,8,6,10,28,29,-1,30
AC Horsens,9283,7,6,12,12,39,58,-19,30
Randers FC,9283,8,6,6,12,25,39,-14,24
AGF Aarhus,9283,9,5,6,11,18,36,-18,21
Lyngby,9283,10,3,9,12,26,46,-20,18
Silkeborg IF,9283,11,5,3,14,25,46,-21,18
FC Midtjylla,9284,1,20,5,5,70,35,35,65
Brondby,9284,2,19,6,5,65,41,24,63
Copenhagen,9284,3,16,4,10,63,44,19,52
FC Nords,9284,4,14,6,10,75,51,24,48
AC Horsens,9284,5,7,13,10,35,55,-20,34
AaB,9284,6,7,12,11,35,43,-8,33
Sonderjyske,9284,7,8,6,10,28,29,-1,30
Randers FC,9284,8,6,6,12,25,40,-15,24
Silkeborg IF,9284,9,6,3,13,29,45,-16,21
Lyngby,9284,10,3,9,12,27,46,-19,18
AGF Aarhus,9284,11,4,6,12,17,40,-23,18
Brondby,9285,1,19,6,5,70,35,35,63
FC Midtjylla,9285,2,19,4,7,59,40,19,61
Copenhagen,9285,3,15,5,10,65,46,19,50
FC Nords,9285,4,13,9,8,74,55,19,48
AaB,9285,5,8,12,10,40,44,-4,36
AC Horsens,9285,6,8,12,10,42,56,-14,36
Sonderjyske,9285,7,8,6,10,28,29,-1,30
Lyngby,9285,8,4,9,11,28,44,-16,21
Randers FC,9285,9,5,6,13,23,41,-18,21
AGF Aarhus,9285,10,5,6,11,20,38,-18,21
Silkeborg IF,9285,11,5,3,14,27,48,-21,18
Brondby,9286,1,20,7,3,69,34,35,67
FC Midtjylla,9286,2,18,6,6,61,39,22,60
FC Nords,9286,3,14,7,9,72,53,19,49
Copenhagen,9286,4,14,5,11,55,42,13,47
AC Horsens,9286,5,8,12,10,36,49,-13,36
AaB,9286,6,8,11,11,39,41,-2,35
Sonderjyske,9286,7,8,6,10,28,29,-1,30
Randers FC,9286,8,5,7,12,24,40,-16,22
Silkeborg IF,9286,9,6,3,13,26,44,-18,21
Lyngby,9286,10,3,10,11,27,45,-18,19
AGF Aarhus,9286,11,4,6,12,16,37,-21,18
Brondby,9287,1,20,6,4,74,34,40,66
FC Midtjylla,9287,2,17,7,6,61,39,22,58
FC Nords,9287,3,14,8,8,72,53,19,50
Copenhagen,9287,4,14,4,12,54,43,11,46
AC Horsens,9287,5,9,12,9,39,51,-12,39
AaB,9287,6,7,13,10,35,41,-6,34
Sonderjyske,9287,7,8,6,10,28,29,-1,30
Lyngby,9287,8,4,9,11,27,44,-17,21
Randers FC,9287,9,5,6,13,23,40,-17,21
AGF Aarhus,9287,10,5,6,11,18,37,-19,21
Silkeborg IF,9287,11,5,3,14,26,46,-20,18
Brondby,9288,1,22,6,2,73,31,42,72
FC Midtjylla,9288,2,20,4,6,71,42,29,64
Copenhagen,9288,3,14,7,9,59,41,18,49
FC Nords,9288,4,13,7,10,72,57,15,46
AaB,9288,5,6,14,10,37,44,-7,32
Sonderjyske,9288,6,8,6,10,28,29,-1,30
AC Horsens,9288,7,5,14,11,34,57,-23,29
Lyngby,9288,8,4,9,11,28,44,-16,21
Randers FC,9288,9,5,6,13,23,41,-18,21
AGF Aarhus,9288,10,5,6,11,19,37,-18,21
Silkeborg IF,9288,11,5,3,14,26,47,-21,18
Brondby,9289,1,22,6,2,69,29,40,72
FC Midtjylla,9289,2,20,5,5,67,36,31,65
FC Nords,9289,3,14,7,9,70,53,17,49
Copenhagen,9289,4,14,5,11,57,43,14,47
AaB,9289,5,7,12,11,33,40,-7,33
Sonderjyske,9289,6,8,6,10,28,29,-1,30
AC Horsens,9289,7,5,13,12,30,51,-21,28
Lyngby,9289,8,4,9,11,30,45,-15,21
Silkeborg IF,9289,9,6,3,13,29,46,-17,21
Randers FC,9289,10,5,6,13,24,43,-19,21
AGF Aarhus,9289,11,4,6,12,18,40,-22,18
Brondby,9290,1,22,5,3,72,30,42,71
FC Midtjylla,9290,2,19,5,6,63,38,25,62
FC Nords,9290,3,13,7,10,72,51,21,46
Copenhagen,9290,4,13,5,12,58,48,10,44
AaB,9290,5,8,13,9,39,44,-5,37
AC Horsens,9290,6,7,13,10,35,54,-19,34
Sonderjyske,9290,7,8,6,10,28,29,-1,30
Randers FC,9290,8,6,6,12,26,41,-15,24
AGF Aarhus,9290,9,5,6,11,17,36,-19,21
Lyngby,9290,10,3,9,12,28,47,-19,18
Silkeborg IF,9290,11,5,3,14,25,45,-20,18
Brondby,9291,1,19,8,3,70,35,35,65
FC Midtjylla,9291,2,19,4,7,65,41,24,61
FC Nords,9291,3,15,7,8,75,53,22,52
Copenhagen,9291,4,14,6,10,61,49,12,48
AaB,9291,5,8,11,11,41,43,-2,35
AC Horsens,9291,6,6,14,10,37,54,-17,32
Sonderjyske,9291,7,8,6,10,28,29,-1,30
Lyngby,9291,8,4,9,11,29,46,-17,21
Randers FC,9291,9,5,6,13,25,42,-17,21
Silkeborg IF,9291,10,5,4,13,25,44,-19,19
AGF Aarhus,9291,11,4,7,11,16,36,-20,19
Brondby,9292,1,23,5,2,75,29,46,74
FC Midtjylla,9292,2,18,5,7,61,41,20,59
Copenhagen,9292,3,14,5,11,55,42,13,47
FC Nords,9292,4,13,6,11,71,51,20,45
AaB,9292,5,7,14,9,39,45,-6,35
AC Horsens,9292,6,7,13,10,36,55,-19,34
Sonderjyske,9292,7,8,6,10,28,29,-1,30
Lyngby,9292,8,4,9,11,27,44,-17,21
Randers FC,9292,9,5,6,13,23,40,-17,21
Silkeborg IF,9292,10,6,3,13,26,44,-18,21
AGF Aarhus,9292,11,4,6,12,16,37,-21,18
Brondby,9293,1,19,7,4,70,37,33,64
FC Midtjylla,9293,2,19,6,5,71,42,29,63
FC Nords,9293,3,15,7,8,79,51,28,52
Copenhagen,9293,4,14,5,11,61,49,12,47
AC Horsens,9293,5,8,13,9,38,50,-12,37
Sonderjyske,9293,6,8,6,10,28,29,-1,30
AaB,9293,7,6,12,12,34,50,-16,30
Randers FC,9293,8,5,7,12,23,39,-16,22
AGF Aarhus,9293,9,5,6,11,18,36,-18,21
Lyngby,9293,10,3,10,11,26,44,-18,19
Silkeborg IF,9293,11,5,3,14,25,46,-21,18
Brondby,9294,1,22,6,2,74,28,46,72
FC Midtjylla,9294,2,18,4,8,62,44,18,58
FC Nords,9294,3,14,7,9,69,47,22,49
Copenhagen,9294,4,14,6,10,61,44,17,48
AaB,9294,5,7,13,10,36,41,-5,34
AC Horsens,9294,6,7,12,11,33,57,-24,33
Sonderjyske,9294,7,8,6,10,28,29,-1,30
Randers FC,9294,8,6,6,12,27,41,-14,24
AGF Aarhus,9294,9,5,6,11,18,37,-19,21
Lyngby,9294,10,3,9,12,28,48,-20,18
Silkeborg IF,9294,11,5,3,14,26,46,-20,18
Brondby,9295,1,19,8,3,69,35,34,65
FC Midtjylla,9295,2,19,6,5,67,41,26,63
FC Nords,9295,3,14,8,8,77,53,24,50
Copenhagen,9295,4,14,6,10,64,48,16,48
AaB,9295,5,7,14,9,34,38,-4,35
Sonderjyske,9295,6,8,6,10,28,29,-1,30
AC Horsens,9295,7,6,12,12,35,57,-22,30
Randers FC,9295,8,5,7,12,24,40,-16,22
Silkeborg IF,9295,9,6,3,13,27,45,-18,21
Lyngby,9295,10,3,10,11,27,45,-18,19
AGF Aarhus,9295,11,4,6,12,17,38,-21,18
Brondby,9296,1,22,5,3,73,30,43,71
FC Midtjylla,9296,2,17,7,6,63,43,20,58
Copenhagen,9296,3,16,5,9,59,39,20,53
FC Nords,9296,4,12,8,10,68,56,12,44
AC Horsens,9296,5,7,13,10,36,50,-14,34
AaB,9296,6,7,12,11,37,44,-7,33
Sonderjyske,9296,7,8,6,10,28,29,-1,30
Lyngby,9296,8,4,9,11,28,45,-17,21
Randers FC,9296,9,5,6,13,24,41,-17,21
Silkeborg IF,9296,10,6,3,13,26,44,-18,21
AGF Aarhus,9296,11,4,6,12,16,37,-21,18
Brondby,9297,1,20,6,4,70,35,35,66
FC Midtjylla,9297,2,20,5,5,66,37,29,65
Copenhagen,9297,3,14,6,10,57,41,16,48
FC Nords,9297,4,13,8,9,70,51,19,47
AC Horsens,9297,5,7,13,10,40,55,-15,34
AaB,9297,6,6,14,10,35,45,-10,32
Sonderjyske,9297,7,8,6,10,28,29,-1,30
Lyngby,9297,8,4,9,11,29,45,-16,21
Silkeborg IF,9297,9,6,3,13,26,44,-18,21
Randers FC,9297,10,5,6,13,24,42,-18,21
AGF Aarhus,9297,11,4,6,12,16,37,-21,18
Brondby,9298,1,20,7,3,68,32,36,67
FC Midtjylla,9298,2,20,4,6,65,35,30,64
FC Nords,9298,3,14,7,9,75,52,23,49
Copenhagen,9298,4,13,6,11,53,44,9,45
AC Horsens,9298,5,8,12,10,38,53,-15,36
AaB,9298,6,7,12,11,35,44,-9,33
Sonderjyske,9298,7,8,6,10,28,29,-1,30
Randers FC,9298,8,5,7,12,23,39,-16,22
Silkeborg IF,9298,9,6,3,13,26,44,-18,21
Lyngby,9298,10,3,10,11,26,44,-18,19
AGF Aarhus,9298,11,4,6,12,16,37,-21,18
Brondby,9299,1,21,6,3,75,33,42,69
FC Midtjylla,9299,2,19,5,6,62,38,24,62
FC Nords,9299,3,14,6,10,68,50,18,48
Copenhagen,9299,4,14,5,11,57,44,13,47
AaB,9299,5,8,11,11,36,44,-8,35
AC Horsens,9299,6,7,13,10,40,55,-15,34
Sonderjyske,9299,7,8,6,10,28,29,-1,30
Lyngby,9299,8,4,9,11,29,45,-16,21
Randers FC,9299,9,5,6,13,24,42,-18,21
Silkeborg IF,9299,10,5,4,13,27,46,-19,19
AGF Aarhus,9299,11,4,7,11,18,38,-20,19
Brondby,9300,1,21,5,4,70,31,39,68
FC Midtjylla,9300,2,20,4,6,63,40,23,64
Copenhagen,9300,3,14,5,11,59,46,13,47
FC Nords,9300,4,12,8,10,67,50,17,44
AaB,9300,5,9,12,9,39,40,-1,39
AC Horsens,9300,6,6,14,10,36,53,-17,32
Sonderjyske,9300,7,8,6,10,28,29,-1,30
Randers FC,9300,8,6,6,12,25,40,-15,24
Silkeborg IF,9300,9,6,3,13,26,44,-18,21
Lyngby,9300,10,3,9,12,27,46,-19,18
AGF Aarhus,9300,11,4,6,12,16,37,-21,18
Brondby,9301,1,20,8,2,69,31,38,68
FC Midtjylla,9301,2,20,6,4,69,37,32,66
Copenhagen,9301,3,15,5,10,61,45,16,50
FC Nords,9301,4,13,7,10,71,53,18,46
AaB,9301,5,7,11,12,36,49,-13,32
AC Horsens,9301,6,6,13,11,37,54,-17,31
Sonderjyske,9301,7,8,6,10,28,29,-1,30
Randers FC,9301,8,5,7,12,25,41,-16,22
Silkeborg IF,9301,9,6,3,13,26,44,-18,21
Lyngby,9301,10,3,10,11,28,46,-18,19
AGF Aarhus,9301,11,4,6,12,16,37,-21,18
Brondby,9302,1,22,5,3,71,32,39,71
FC Midtjylla,9302,2,18,5,7,61,42,19,59
FC Nords,9302,3,16,6,8,80,51,29,54
Copenhagen,9302,4,13,5,12,57,49,8,44
AaB,9302,5,8,11,11,39,45,-6,35
AC Horsens,9302,6,6,14,10,35,50,-15,32
Sonderjyske,9302,7,8,6,10,28,29,-1,30
Lyngby,9302,8,4,9,11,30,45,-15,21
Randers FC,9302,9,5,6,13,24,43,-19,21
Silkeborg IF,9302,10,5,4,13,25,44,-19,19
AGF Aarhus,9302,11,4,7,11,16,36,-20,19
Brondby,9303,1,20,7,3,69,34,35,67
FC Midtjylla,9303,2,19,5,6,65,40,25,62
FC Nords,9303,3,15,6,9,72,49,23,51
Copenhagen,9303,4,13,7,10,58,46,12,46
AaB,9303,5,7,13,10,34,41,-7,34
AC Horsens,9303,6,6,14,10,37,51,-14,32
Sonderjyske,9303,7,8,6,10,28,29,-1,30
Randers FC,9303,8,5,7,12,25,41,-16,22
Silkeborg IF,9303,9,6,3,13,28,44,-16,21
Lyngby,9303,10,3,10,11,28,46,-18,19
AGF Aarhus,9303,11,4,6,12,16,39,-23,18
Brondby,9304,1,23,5,2,72,26,46,74
FC Midtjylla,9304,2,21,4,5,65,37,28,67
FC Nords,9304,3,13,7,10,67,51,16,46
Copenhagen,9304,4,14,4,12,57,46,11,46
AaB,9304,5,6,13,11,33,43,-10,31
AC Horsens,9304,6,6,13,11,34,51,-17,31
Sonderjyske,9304,7,8,6,10,28,29,-1,30
Randers FC,9304,8,6,6,12,26,41,-15,24
Silkeborg IF,9304,9,6,3,13,27,45,-18,21
Lyngby,9304,10,3,9,12,28,47,-19,18
AGF Aarhus,9304,11,4,6,12,17,38,-21,18
Brondby,9305,1,21,6,3,70,33,37,69
FC Midtjylla,9305,2,19,6,5,65,37,28,63
FC Nords,9305,3,14,6,10,75,56,19,48
Copenhagen,9305,4,14,5,11,60,46,14,47
AC Horsens,9305,5,8,13,9,37,51,-14,37
Sonderjyske,9305,6,8,6,10,28,29,-1,30
AaB,9305,7,6,12,12,33,43,-10,30
Lyngby,9305,8,4,9,11,27,44,-17,21
Randers FC,9305,9,5,6,13,23,40,-17,21
Silkeborg IF,9305,10,6,3,13,28,46,-18,21
AGF Aarhus,9305,11,4,6,12,18,39,-21,18
Brondby,9306,1,22,5,3,71,33,38,71
FC Midtjylla,9306,2,18,5,7,63,39,24,59
FC Nords,9306,3,15,7,8,71,49,22,52
Copenhagen,9306,4,13,5,12,57,47,10,44
AC Horsens,9306,5,7,14,9,36,50,-14,35
AaB,9306,6,6,14,10,37,43,-6,32
Sonderjyske,9306,7,8,6,10,28,29,-1,30
Lyngby,9306,8,4,9,11,32,47,-15,21
Randers FC,9306,9,5,6,13,26,45,-19,21
Silkeborg IF,9306,10,5,4,13,28,47,-19,19
AGF Aarhus,9306,11,4,7,11,19,39,-20,19
Brondby,9307,1,21,7,2,73,33,40,70
FC Midtjylla,9307,2,19,4,7,64,46,18,61
FC Nords,9307,3,14,6,10,74,54,20,48
Copenhagen,9307,4,14,5,11,61,46,15,47
AaB,9307,5,8,11,11,39,43,-4,35
AC Horsens,9307,6,7,13,10,36,51,-15,34
Sonderjyske,9307,7,8,6,10,28,29,-1,30
Randers FC,9307,8,6,6,12,24,39,-15,24
Silkeborg IF,9307,9,6,3,13,28,44,-16,21
Lyngby,9307,10,3,9,12,26,45,-19,18
AGF Aarhus,9307,11,4,6,12,16,39,-23,18
Brondby,9308,1,21,6,3,76,35,41,69
FC Midtjylla,9308,2,18,5,7,60,40,20,59
FC Nords,9308,3,16,6,8,73,48,25,54
Copenhagen,9308,4,14,4,12,59,45,14,46
AaB,9308,5,8,12,10,40,46,-6,36
AC Horsens,9308,6,6,13,11,33,53,-20,31
Sonderjyske,9308,7,8,6,10,28,29,-1,30
Randers FC,9308,8,6,6,12,25,40,-15,24
Silkeborg IF,9308,9,6,3,13,28,44,-16,21
Lyngby,9308,10,3,9,12,27,46,-19,18
AGF Aarhus,9308,11,4,6,12,16,39,-23,18
Brondby,9309,1,21,6,3,70,33,37,69
FC Midtjylla,9309,2,21,4,5,67,37,30,67
FC Nords,9309,3,13,7,10,70,51,19,46
Copenhagen,9309,4,14,4,12,59,47,12,46
AaB,9309,5,8,12,10,40,44,-4,36
AC Horsens,9309,6,6,13,11,33,53,-20,31
Sonderjyske,9309,7,8,6,10,28,29,-1,30
Randers FC,9309,8,6,6,12,24,39,-15,24
AGF Aarhus,9309,9,5,6,11,19,37,-18,21
Lyngby,9309,10,3,9,12,26,45,-19,18
Silkeborg IF,9309,11,5,3,14,26,47,-21,18
Brondby,9310,1,22,5,3,71,32,39,71
FC Midtjylla,9310,2,20,5,5,64,36,28,65
Copenhagen,9310,3,15,5,10,67,45,22,50
FC Nords,9310,4,14,7,9,72,51,21,49
AaB,9310,5,7,12,11,37,42,-5,33
Sonderjyske,9310,6,8,6,10,28,29,-1,30
AC Horsens,9310,7,5,12,13,30,61,-31,27
Randers FC,9310,8,5,7,12,23,39,-16,22
Silkeborg IF,9310,9,6,3,13,26,44,-18,21
Lyngby,9310,10,3,10,11,26,44,-18,19
AGF Aarhus,9310,11,4,6,12,16,37,-21,18
Brondby,9311,1,18,7,5,69,37,32,61
FC Midtjylla,9311,2,18,5,7,64,44,20,59
FC Nords,9311,3,15,7,8,82,55,27,52
Copenhagen,9311,4,15,5,10,61,45,16,50
AaB,9311,5,8,12,10,40,45,-5,36
AC Horsens,9311,6,8,12,10,34,50,-16,36
Sonderjyske,9311,7,8,6,10,28,29,-1,30
Lyngby,9311,8,4,9,11,27,44,-17,21
Randers FC,9311,9,5,6,13,23,40,-17,21
Silkeborg IF,9311,10,5,4,13,25,44,-19,19
AGF Aarhus,9311,11,4,7,11,16,36,-20,19
Brondby,9312,1,21,6,3,71,33,38,69
FC Midtjylla,9312,2,18,6,6,62,39,23,60
FC Nords,9312,3,14,8,8,71,48,23,50
Copenhagen,9312,4,14,5,11,57,45,12,47
AaB,9312,5,7,12,11,34,41,-7,33
AC Horsens,9312,6,6,15,9,35,50,-15,33
Sonderjyske,9312,7,8,6,10,28,29,-1,30
Randers FC,9312,8,5,7,12,23,39,-16,22
Silkeborg IF,9312,9,6,3,13,26,44,-18,21
Lyngby,9312,10,3,10,11,26,44,-18,19
AGF Aarhus,9312,11,4,6,12,16,37,-21,18
Brondby,9313,1,23,5,2,75,30,45,74
FC Midtjylla,9313,2,19,4,7,64,43,21,61
FC Nords,9313,3,16,6,8,80,49,31,54
Copenhagen,9313,4,14,5,11,60,46,14,47
AaB,9313,5,7,12,11,35,45,-10,33
Sonderjyske,9313,6,8,6,10,28,29,-1,30
AC Horsens,9313,7,5,12,13,31,58,-27,27
Randers FC,9313,8,5,7,12,24,40,-16,22
Silkeborg IF,9313,9,6,3,13,27,44,-17,21
Lyngby,9313,10,3,10,11,27,45,-18,19
AGF Aarhus,9313,11,4,6,12,16,38,-22,18
Brondby,9314,1,21,5,4,70,30,40,68
FC Midtjylla,9314,2,20,5,5,64,36,28,65
Copenhagen,9314,3,14,6,10,57,42,15,48
FC Nords,9314,4,12,7,11,70,58,12,43
AaB,9314,5,8,12,10,37,40,-3,36
AC Horsens,9314,6,7,13,10,33,51,-18,34
Sonderjyske,9314,7,8,6,10,28,29,-1,30
Lyngby,9314,8,4,9,11,30,45,-15,21
Silkeborg IF,9314,9,6,3,13,27,45,-18,21
Randers FC,9314,10,5,6,13,24,43,-19,21
AGF Aarhus,9314,11,4,6,12,17,38,-21,18
Brondby,9315,1,22,5,3,72,28,44,71
FC Midtjylla,9315,2,21,4,5,70,36,34,67
FC Nords,9315,3,14,7,9,72,51,21,49
Copenhagen,9315,4,14,5,11,57,47,10,47
AC Horsens,9315,5,6,13,11,35,55,-20,31
Sonderjyske,9315,6,8,6,10,28,29,-1,30
AaB,9315,7,6,12,12,39,54,-15,30
Randers FC,9315,8,5,7,12,25,41,-16,22
AGF Aarhus,9315,9,5,6,11,18,36,-18,21
Lyngby,9315,10,3,10,11,28,46,-18,19
Silkeborg IF,9315,11,5,3,14,25,46,-21,18
Brondby,9316,1,20,8,2,71,31,40,68
FC Midtjylla,9316,2,20,5,5,68,41,27,65
FC Nords,9316,3,14,8,8,73,46,27,50
Copenhagen,9316,4,14,5,11,54,42,12,47
AaB,9316,5,8,12,10,37,43,-6,36
Sonderjyske,9316,6,8,6,10,28,29,-1,30
AC Horsens,9316,7,5,12,13,34,60,-26,27
Randers FC,9316,8,5,7,12,23,39,-16,22
Silkeborg IF,9316,9,6,3,13,27,44,-17,21
Lyngby,9316,10,3,10,11,26,44,-18,19
AGF Aarhus,9316,11,4,6,12,16,38,-22,18
Brondby,9317,1,20,7,3,71,30,41,67
FC Midtjylla,9317,2,19,6,5,65,39,26,63
FC Nords,9317,3,15,7,8,74,50,24,52
Copenhagen,9317,4,13,6,11,56,46,10,45
AC Horsens,9317,5,6,15,9,38,54,-16,33
AaB,9317,6,7,11,12,36,47,-11,32
Sonderjyske,9317,7,8,6,10,28,29,-1,30
Lyngby,9317,8,4,9,11,28,45,-17,21
Randers FC,9317,9,5,6,13,24,41,-17,21
Silkeborg IF,9317,10,5,4,13,26,45,-19,19
AGF Aarhus,9317,11,4,7,11,17,37,-20,19
Brondby,9318,1,22,5,3,73,28,45,71
FC Midtjylla,9318,2,19,5,6,70,43,27,62
Copenhagen,9318,3,14,7,9,61,45,16,49
FC Nords,9318,4,13,7,10,75,59,16,46
AaB,9318,5,8,12,10,39,44,-5,36
Sonderjyske,9318,6,8,6,10,28,29,-1,30
AC Horsens,9318,7,6,12,12,36,61,-25,30
Randers FC,9318,8,6,6,12,25,40,-15,24
AGF Aarhus,9318,9,5,6,11,18,37,-19,21
Lyngby,9318,10,3,9,12,27,46,-19,18
Silkeborg IF,9318,11,5,3,14,26,46,-20,18
Brondby,9319,1,20,6,4,74,34,40,66
FC Midtjylla,9319,2,20,5,5,62,35,27,65
FC Nords,9319,3,13,9,8,71,49,22,48
Copenhagen,9319,4,14,4,12,58,46,12,46
AaB,9319,5,8,11,11,35,47,-12,35
AC Horsens,9319,6,7,13,10,38,53,-15,34
Sonderjyske,9319,7,8,6,10,28,29,-1,30
Randers FC,9319,8,5,7,12,24,40,-16,22
AGF Aarhus,9319,9,5,6,11,18,36,-18,21
Lyngby,9319,10,3,10,11,27,45,-18,19
Silkeborg IF,9319,11,5,3,14,25,46,-21,18
Brondby,9320,1,19,7,4,66,36,30,64
FC Midtjylla,9320,2,19,6,5,66,38,28,63
Copenhagen,9320,3,13,7,10,52,45,7,46
FC Nords,9320,4,13,6,11,74,58,16,45
AaB,9320,5,9,13,8,42,37,5,40
AC Horsens,9320,6,7,13,10,36,48,-12,34
Sonderjyske,9320,7,8,6,10,28,29,-1,30
Lyngby,9320,8,4,9,11,29,46,-17,21
Randers FC,9320,9,5,6,13,25,42,-17,21
AGF Aarhus,9320,10,5,6,11,18,36,-18,21
Silkeborg IF,9320,11,5,3,14,25,46,-21,18
Brondby,9321,1,22,5,3,76,36,40,71
FC Midtjylla,9321,2,19,6,5,67,38,29,63
FC Nords,9321,3,15,6,9,75,53,22,51
Copenhagen,9321,4,13,6,11,56,46,10,45
AaB,9321,5,7,12,11,39,46,-7,33
AC Horsens,9321,6,6,13,11,34,54,-20,31
Sonderjyske,9321,7,8,6,10,28,29,-1,30
Lyngby,9321,8,4,9,11,27,44,-17,21
Randers FC,9321,9,5,6,13,23,40,-17,21
AGF Aarhus,9321,10,5,6,11,17,36,-19,21
Silkeborg IF,9321,11,5,3,14,25,45,-20,18
FC Midtjylla,9322,1,21,5,4,70,38,32,68
Brondby,9322,2,20,6,4,73,36,37,66
FC Nords,9322,3,15,6,9,74,50,24,51
Copenhagen,9322,4,13,6,11,59,46,13,45
AaB,9322,5,8,11,11,36,45,-9,35
Sonderjyske,9322,6,8,6,10,28,29,-1,30
AC Horsens,9322,7,6,12,12,32,55,-23,30
Lyngby,9322,8,4,9,11,27,44,-17,21
Randers FC,9322,9,5,6,13,23,40,-17,21
Silkeborg IF,9322,10,6,3,13,28,46,-18,21
AGF Aarhus,9322,11,4,6,12,18,39,-21,18
Brondby,9323,1,22,5,3,78,31,47,71
FC Midtjylla,9323,2,19,4,7,66,44,22,61
Copenhagen,9323,3,15,5,10,60,45,15,50
FC Nords,9323,4,13,6,11,68,51,17,45
AaB,9323,5,7,13,10,36,44,-8,34
AC Horsens,9323,6,7,13,10,35,54,-19,34
Sonderjyske,9323,7,8,6,10,28,29,-1,30
Randers FC,9323,8,5,7,12,23,39,-16,22
AGF Aarhus,9323,9,5,6,11,19,38,-19,21
Lyngby,9323,10,3,10,11,26,44,-18,19
Silkeborg IF,9323,11,5,3,14,27,47,-20,18
Brondby,9324,1,21,6,3,72,34,38,69
FC Midtjylla,9324,2,19,6,5,66,39,27,63
FC Nords,9324,3,16,6,8,79,53,26,54
Copenhagen,9324,4,12,7,11,54,47,7,43
AaB,9324,5,7,13,10,37,42,-5,34
Sonderjyske,9324,6,8,6,10,28,29,-1,30
AC Horsens,9324,7,5,14,11,34,53,-19,29
Randers FC,9324,8,6,6,12,24,39,-15,24
Silkeborg IF,9324,9,6,3,13,29,45,-16,21
Lyngby,9324,10,3,9,12,26,45,-19,18
AGF Aarhus,9324,11,4,6,12,17,40,-23,18
Brondby,9325,1,22,5,3,71,31,40,71
FC Midtjylla,9325,2,19,7,4,65,38,27,64
FC Nords,9325,3,14,7,9,73,54,19,49
Copenhagen,9325,4,13,5,12,53,46,7,44
AaB,9325,5,8,12,10,39,40,-1,36
Sonderjyske,9325,6,8,6,10,28,29,-1,30
AC Horsens,9325,7,5,14,11,34,52,-18,29
Lyngby,9325,8,4,9,11,27,44,-17,21
Randers FC,9325,9,5,6,13,23,40,-17,21
AGF Aarhus,9325,10,5,6,11,18,36,-18,21
Silkeborg IF,9325,11,5,3,14,25,46,-21,18
Brondby,9326,1,21,7,2,72,32,40,70
FC Midtjylla,9326,2,17,5,8,59,46,13,56
FC Nords,9326,3,15,7,8,78,51,27,52
Copenhagen,9326,4,13,5,12,56,44,12,44
AaB,9326,5,8,13,9,39,41,-2,37
AC Horsens,9326,6,7,13,10,37,53,-16,34
Sonderjyske,9326,7,8,6,10,28,29,-1,30
Randers FC,9326,8,6,6,12,26,40,-14,24
AGF Aarhus,9326,9,5,6,11,17,36,-19,21
Lyngby,9326,10,3,9,12,27,47,-20,18
Silkeborg IF,9326,11,5,3,14,25,45,-20,18
Brondby,9327,1,21,6,3,69,31,38,69
FC Midtjylla,9327,2,20,5,5,64,35,29,65
FC Nords,9327,3,14,7,9,70,50,20,49
Copenhagen,9327,4,14,5,11,57,45,12,47
AaB,9327,5,8,11,11,36,43,-7,35
Sonderjyske,9327,6,8,6,10,28,29,-1,30
AC Horsens,9327,7,5,14,11,34,52,-18,29
Randers FC,9327,8,5,7,12,23,39,-16,22
Silkeborg IF,9327,9,6,3,13,30,44,-14,21
Lyngby,9327,10,3,10,11,26,44,-18,19
AGF Aarhus,9327,11,4,6,12,16,41,-25,18
FC Midtjylla,9328,1,21,5,4,68,37,31,68
Brondby,9328,2,20,7,3,69,32,37,67
FC Nords,9328,3,14,8,8,81,53,28,50
Copenhagen,9328,4,13,5,12,55,50,5,44
AaB,9328,5,7,13,10,39,44,-5,34
Sonderjyske,9328,6,8,6,10,28,29,-1,30
AC Horsens,9328,7,5,14,11,36,58,-22,29
Lyngby,9328,8,4,9,11,28,45,-17,21
Randers FC,9328,9,5,6,13,24,41,-17,21
Silkeborg IF,9328,10,6,3,13,26,44,-18,21
AGF Aarhus,9328,11,4,6,12,16,37,-21,18
Brondby,9329,1,22,5,3,73,30,43,71
FC Midtjylla,9329,2,19,5,6,64,41,23,62
Copenhagen,9329,3,15,5,10,61,41,20,50
FC Nords,9329,4,12,8,10,71,58,13,44
AaB,9329,5,6,15,9,36,43,-7,33
AC Horsens,9329,6,6,14,10,34,52,-18,32
Sonderjyske,9329,7,8,6,10,28,29,-1,30
Lyngby,9329,8,4,9,11,27,44,-17,21
Randers FC,9329,9,5,6,13,23,40,-17,21
Silkeborg IF,9329,10,6,3,13,27,45,-18,21
AGF Aarhus,9329,11,4,6,12,17,38,-21,18
Brondby,9330,1,20,7,3,66,31,35,67
FC Midtjylla,9330,2,19,4,7,61,36,25,61
FC Nords,9330,3,15,6,9,79,51,28,51
Copenhagen,9330,4,14,5,11,60,47,13,47
AC Horsens,9330,5,9,12,9,40,53,-13,39
Sonderjyske,9330,6,8,6,10,28,29,-1,30
AaB,9330,7,6,12,12,32,46,-14,30
Randers FC,9330,8,5,7,12,25,41,-16,22
Lyngby,9330,9,3,10,11,28,46,-18,19
Silkeborg IF,9330,10,5,4,13,28,47,-19,19
AGF Aarhus,9330,11,4,7,11,19,39,-20,19
Brondby,9331,1,21,7,2,71,29,42,70
FC Midtjylla,9331,2,20,5,5,63,41,22,65
FC Nords,9331,3,13,8,9,73,53,20,47
Copenhagen,9331,4,13,6,11,55,44,11,45
AC Horsens,9331,5,7,14,9,39,52,-13,35
Sonderjyske,9331,6,8,6,10,28,29,-1,30
AaB,9331,7,6,12,12,33,41,-8,30
Randers FC,9331,8,5,7,12,24,40,-16,22
Silkeborg IF,9331,9,6,3,13,26,44,-18,21
Lyngby,9331,10,3,10,11,27,45,-18,19
AGF Aarhus,9331,11,4,6,12,16,37,-21,18
FC Midtjylla,9332,1,21,5,4,71,39,32,68
Brondby,9332,2,20,5,5,67,35,32,65
FC Nords,9332,3,14,6,10,74,56,18,48
Copenhagen,9332,4,13,6,11,58,45,13,45
AaB,9332,5,9,12,9,41,41,0,39
Sonderjyske,9332,6,8,6,10,28,29,-1,30
AC Horsens,9332,7,5,14,11,34,55,-21,29
Lyngby,9332,8,4,9,11,28,45,-17,21
Randers FC,9332,9,5,6,13,24,41,-17,21
Silkeborg IF,9332,10,6,3,13,28,46,-18,21
AGF Aarhus,9332,11,4,6,12,18,39,-21,18
Brondby,9333,1,22,6,2,74,31,43,72
FC Midtjylla,9333,2,18,6,6,67,42,25,60
Copenhagen,9333,3,16,5,9,62,41,21,53
FC Nords,9333,4,12,8,10,72,57,15,44
AaB,9333,5,8,12,10,39,44,-5,36
Sonderjyske,9333,6,8,6,10,28,29,-1,30
AC Horsens,9333,7,5,13,12,35,60,-25,28
Lyngby,9333,8,4,9,11,29,45,-16,21
Randers FC,9333,9,5,6,13,24,42,-18,21
Silkeborg IF,9333,10,5,4,13,27,46,-19,19
AGF Aarhus,9333,11,4,7,11,18,38,-20,19
Brondby,9334,1,20,6,4,69,33,36,66
FC Midtjylla,9334,2,20,4,6,67,38,29,64
FC Nords,9334,3,14,8,8,75,52,23,50
Copenhagen,9334,4,14,5,11,59,49,10,47
AaB,9334,5,7,13,10,34,42,-8,34
AC Horsens,9334,6,7,12,11,39,55,-16,33
Sonderjyske,9334,7,8,6,10,28,29,-1,30
Lyngby,9334,8,4,9,11,28,45,-17,21
Randers FC,9334,9,5,6,13,24,41,-17,21
Silkeborg IF,9334,10,5,4,13,26,45,-19,19
AGF Aarhus,9334,11,4,7,11,17,37,-20,19
Brondby,9335,1,23,5,2,78,33,45,74
FC Midtjylla,9335,2,19,5,6,69,39,30,62
Copenhagen,9335,3,14,6,10,57,44,13,48
FC Nords,9335,4,12,8,10,67,50,17,44
AaB,9335,5,7,13,10,39,46,-7,34
Sonderjyske,9335,6,8,6,10,28,29,-1,30
AC Horsens,9335,7,5,15,10,36,60,-24,30
Randers FC,9335,8,6,6,12,27,41,-14,24
Silkeborg IF,9335,9,5,4,13,25,44,-19,19
AGF Aarhus,9335,10,4,7,11,16,36,-20,19
Lyngby,9335,11,3,9,12,28,48,-20,18
Brondby,9336,1,22,5,3,73,33,40,71
FC Midtjylla,9336,2,20,4,6,72,40,32,64
Copenhagen,9336,3,15,5,10,59,43,16,50
FC Nords,9336,4,13,7,10,72,54,18,46
AaB,9336,5,8,12,10,35,42,-7,36
Sonderjyske,9336,6,8,6,10,28,29,-1,30
AC Horsens,9336,7,5,13,12,33,58,-25,28
Randers FC,9336,8,6,6,12,24,39,-15,24
AGF Aarhus,9336,9,5,6,11,18,37,-19,21
Lyngby,9336,10,3,9,12,26,45,-19,18
Silkeborg IF,9336,11,5,3,14,26,46,-20,18
Brondby,9337,1,21,6,3,70,30,40,69
FC Midtjylla,9337,2,18,5,7,65,43,22,59
FC Nords,9337,3,14,7,9,70,50,20,49
Copenhagen,9337,4,15,4,11,57,41,16,49
AaB,9337,5,8,14,8,41,43,-2,38
Sonderjyske,9337,6,8,6,10,28,29,-1,30
AC Horsens,9337,7,6,12,12,32,54,-22,30
Lyngby,9337,8,4,9,11,27,44,-17,21
Randers FC,9337,9,5,6,13,23,40,-17,21
AGF Aarhus,9337,10,5,6,11,17,36,-19,21
Silkeborg IF,9337,11,5,3,14,25,45,-20,18
FC Midtjylla,9338,1,20,5,5,70,35,35,65
Brondby,9338,2,20,5,5,70,36,34,65
FC Nords,9338,3,15,6,9,77,52,25,51
Copenhagen,9338,4,14,4,12,59,49,10,46
AaB,9338,5,8,12,10,36,41,-5,36
AC Horsens,9338,6,7,12,11,34,59,-25,33
Sonderjyske,9338,7,8,6,10,28,29,-1,30
Silkeborg IF,9338,8,6,3,13,29,44,-15,21
Lyngby,9338,9,4,9,11,28,44,-16,21
Randers FC,9338,10,5,6,13,23,41,-18,21
AGF Aarhus,9338,11,4,6,12,16,40,-24,18
Brondby,9339,1,21,7,2,69,30,39,70
FC Midtjylla,9339,2,19,7,4,66,36,30,64
FC Nords,9339,3,13,8,9,71,50,21,47
Copenhagen,9339,4,13,5,12,57,48,9,44
AC Horsens,9339,5,8,12,10,34,50,-16,36
AaB,9339,6,7,11,12,36,45,-9,32
Sonderjyske,9339,7,8,6,10,28,29,-1,30
Lyngby,9339,8,4,9,11,27,44,-17,21
Randers FC,9339,9,5,6,13,23,40,-17,21
Silkeborg IF,9339,10,6,3,13,28,46,-18,21
AGF Aarhus,9339,11,4,6,12,18,39,-21,18
Brondby,9340,1,20,7,3,72,36,36,67
FC Midtjylla,9340,2,20,5,5,68,40,28,65
Copenhagen,9340,3,16,5,9,61,41,20,53
FC Nords,9340,4,14,6,10,76,57,19,48
AaB,9340,5,7,12,11,38,42,-4,33
Sonderjyske,9340,6,8,6,10,28,29,-1,30
AC Horsens,9340,7,5,13,12,32,57,-25,28
Randers FC,9340,8,5,7,12,24,40,-16,22
Silkeborg IF,9340,9,6,3,13,29,44,-15,21
Lyngby,9340,10,3,10,11,27,45,-18,19
AGF Aarhus,9340,11,4,6,12,16,40,-24,18
Brondby,9341,1,22,5,3,71,29,42,71
FC Midtjylla,9341,2,20,4,6,69,35,34,64
FC Nords,9341,3,14,6,10,73,60,13,48
Copenhagen,9341,4,13,5,12,57,49,8,44
AaB,9341,5,8,12,10,41,48,-7,36
AC Horsens,9341,6,7,12,11,36,52,-16,33
Sonderjyske,9341,7,8,6,10,28,29,-1,30
Lyngby,9341,8,4,9,11,29,45,-16,21
Randers FC,9341,9,5,6,13,24,42,-18,21
AGF Aarhus,9341,10,5,6,11,17,36,-19,21
Silkeborg IF,9341,11,5,3,14,25,45,-20,18
Brondby,9342,1,20,6,4,69,32,37,66
FC Midtjylla,9342,2,18,8,4,67,41,26,62
FC Nords,9342,3,14,8,8,73,53,20,50
Copenhagen,9342,4,14,6,10,60,46,14,48
AaB,9342,5,8,12,10,38,42,-4,36
Sonderjyske,9342,6,8,6,10,28,29,-1,30
AC Horsens,9342,7,6,12,12,33,52,-19,30
Randers FC,9342,8,6,6,12,24,39,-15,24
AGF Aarhus,9342,9,5,6,11,17,36,-19,21
Lyngby,9342,10,3,9,12,26,45,-19,18
Silkeborg IF,9342,11,5,3,14,25,45,-20,18
Brondby,9343,1,22,5,3,76,30,46,71
FC Midtjylla,9343,2,20,4,6,66,38,28,64
Copenhagen,9343,3,15,5,10,57,42,15,50
FC Nords,9343,4,13,8,9,73,52,21,47
AaB,9343,5,7,12,11,38,48,-10,33
Sonderjyske,9343,6,8,6,10,28,29,-1,30
AC Horsens,9343,7,6,12,12,30,56,-26,30
Lyngby,9343,8,4,9,11,29,44,-15,21
AGF Aarhus,9343,9,5,6,11,18,36,-18,21
Randers FC,9343,10,5,6,13,23,42,-19,21
Silkeborg IF,9343,11,5,3,14,25,46,-21,18
Brondby,9344,1,22,5,3,72,32,40,71
FC Midtjylla,9344,2,20,4,6,68,44,24,64
FC Nords,9344,3,14,7,9,71,49,22,49
Copenhagen,9344,4,13,5,12,57,49,8,44
AC Horsens,9344,5,9,12,9,38,49,-11,39
Sonderjyske,9344,6,8,6,10,28,29,-1,30
AaB,9344,7,6,11,13,36,45,-9,29
Lyngby,9344,8,4,9,11,30,46,-16,21
Randers FC,9344,9,5,6,13,25,43,-18,21
AGF Aarhus,9344,10,5,6,11,18,37,-19,21
Silkeborg IF,9344,11,5,3,14,26,46,-20,18
Brondby,9345,1,21,6,3,72,33,39,69
FC Midtjylla,9345,2,18,5,7,64,42,22,59
FC Nords,9345,3,15,6,9,76,55,21,51
Copenhagen,9345,4,14,6,10,58,43,15,48
AaB,9345,5,8,11,11,38,42,-4,35
AC Horsens,9345,6,6,14,10,34,53,-19,32
Sonderjyske,9345,7,8,6,10,28,29,-1,30
Randers FC,9345,8,6,6,12,25,40,-15,24
AGF Aarhus,9345,9,5,6,11,19,38,-19,21
Lyngby,9345,10,3,9,12,27,46,-19,18
Silkeborg IF,9345,11,5,3,14,27,47,-20,18
Brondby,9346,1,22,5,3,77,32,45,71
FC Midtjylla,9346,2,20,5,5,63,36,27,65
FC Nords,9346,3,14,6,10,77,56,21,48
Copenhagen,9346,4,14,5,11,55,44,11,47
AaB,9346,5,8,11,11,39,49,-10,35
Sonderjyske,9346,6,8,6,10,28,29,-1,30
AC Horsens,9346,7,6,12,12,36,56,-20,30
Lyngby,9346,8,4,9,11,28,44,-16,21
Randers FC,9346,9,5,6,13,23,41,-18,21
AGF Aarhus,9346,10,5,6,11,18,37,-19,21
Silkeborg IF,9346,11,5,3,14,26,46,-20,18
Brondby,9347,1,20,7,3,71,33,38,67
FC Midtjylla,9347,2,19,4,7,59,40,19,61
FC Nords,9347,3,16,7,7,78,47,31,55
Copenhagen,9347,4,14,5,11,60,50,10,47
AC Horsens,9347,5,7,13,10,39,52,-13,34
Sonderjyske,9347,6,8,6,10,28,29,-1,30
AaB,9347,7,6,12,12,35,46,-11,30
Randers FC,9347,8,5,7,12,24,40,-16,22
Lyngby,9347,9,3,10,11,27,45,-18,19
Silkeborg IF,9347,10,5,4,13,27,46,-19,19
AGF Aarhus,9347,11,4,7,11,18,38,-20,19
Brondby,9348,1,21,6,3,73,31,42,69
FC Midtjylla,9348,2,18,4,8,62,41,21,58
FC Nords,9348,3,13,8,9,76,55,21,47
Copenhagen,9348,4,13,7,10,56,42,14,46
AaB,9348,5,9,12,9,38,40,-2,39
AC Horsens,9348,6,7,13,10,34,56,-22,34
Sonderjyske,9348,7,8,6,10,28,29,-1,30
Lyngby,9348,8,4,9,11,27,44,-17,21
Randers FC,9348,9,5,6,13,23,40,-17,21
Silkeborg IF,9348,10,5,4,13,26,45,-19,19
AGF Aarhus,9348,11,4,7,11,17,37,-20,19
FC Midtjylla,9349,1,21,5,4,68,37,31,68
Brondby,9349,2,18,5,7,62,36,26,59
Copenhagen,9349,3,14,7,9,58,43,15,49
FC Nords,9349,4,14,6,10,70,49,21,48
AaB,9349,5,8,13,9,36,40,-4,37
AC Horsens,9349,6,6,14,10,36,51,-15,32
Sonderjyske,9349,7,8,6,10,28,29,-1,30
Silkeborg IF,9349,8,6,3,13,29,45,-16,21
Lyngby,9349,9,4,9,11,27,44,-17,21
Randers FC,9349,10,5,6,13,23,40,-17,21
AGF Aarhus,9349,11,4,6,12,17,40,-23,18
Brondby,9350,1,22,6,2,72,30,42,72
FC Midtjylla,9350,2,18,5,7,60,38,22,59
FC Nords,9350,3,15,6,9,76,49,27,51
Copenhagen,9350,4,14,4,12,60,46,14,46
AC Horsens,9350,5,7,13,10,35,56,-21,34
AaB,9350,6,7,12,11,35,45,-10,33
Sonderjyske,9350,7,8,6,10,28,29,-1,30
Lyngby,9350,8,4,9,11,31,45,-14,21
Silkeborg IF,9350,9,6,3,13,30,45,-15,21
Randers FC,9350,10,5,6,13,24,44,-20,21
AGF Aarhus,9350,11,4,6,12,17,41,-24,18
Brondby,9351,1,20,5,5,70,37,33,65
FC Midtjylla,9351,2,19,5,6,69,42,27,62
FC Nords,9351,3,15,6,9,72,51,21,51
Copenhagen,9351,4,15,5,10,60,42,18,50
AaB,9351,5,8,12,10,38,43,-5,36
AC Horsens,9351,6,6,13,11,35,55,-20,31
Sonderjyske,9351,7,8,6,10,28,29,-1,30
Lyngby,9351,8,4,9,11,29,45,-16,21
Randers FC,9351,9,5,6,13,24,42,-18,21
AGF Aarhus,9351,10,5,6,11,17,36,-19,21
Silkeborg IF,9351,11,5,3,14,25,45,-20,18
Brondby,9352,1,20,6,4,71,34,37,66
FC Midtjylla,9352,2,19,4,7,61,40,21,61
FC Nords,9352,3,15,6,9,77,50,27,51
Copenhagen,9352,4,15,5,10,57,43,14,50
AaB,9352,5,9,11,10,38,42,-4,38
Sonderjyske,9352,6,8,6,10,28,29,-1,30
AC Horsens,9352,7,5,14,11,32,53,-21,29
Randers FC,9352,8,5,7,12,24,40,-16,22
Lyngby,9352,9,3,10,11,27,45,-18,19
Silkeborg IF,9352,10,5,4,13,26,45,-19,19
AGF Aarhus,9352,11,4,7,11,17,37,-20,19
Brondby,9353,1,20,8,2,68,30,38,68
FC Midtjylla,9353,2,20,6,4,63,36,27,66
FC Nords,9353,3,15,7,8,78,51,27,52
Copenhagen,9353,4,13,5,12,55,47,8,44
AaB,9353,5,7,11,12,34,42,-8,32
AC Horsens,9353,6,6,13,11,33,51,-18,31
Sonderjyske,9353,7,8,6,10,28,29,-1,30
Lyngby,9353,8,4,9,11,29,45,-16,21
Randers FC,9353,9,5,6,13,24,42,-18,21
Silkeborg IF,9353,10,5,4,13,27,46,-19,19
AGF Aarhus,9353,11,4,7,11,18,38,-20,19
Brondby,9354,1,22,5,3,76,31,45,71
FC Midtjylla,9354,2,19,4,7,65,43,22,61
FC Nords,9354,3,15,6,9,76,55,21,51
Copenhagen,9354,4,14,4,12,60,51,9,46
AC Horsens,9354,5,8,12,10,35,50,-15,36
AaB,9354,6,7,11,12,36,44,-8,32
Sonderjyske,9354,7,8,6,10,28,29,-1,30
Randers FC,9354,8,6,6,12,24,39,-15,24
Silkeborg IF,9354,9,6,3,13,27,45,-18,21
Lyngby,9354,10,3,9,12,26,45,-19,18
AGF Aarhus,9354,11,4,6,12,17,38,-21,18
Brondby,9355,1,20,6,4,66,33,33,66
FC Midtjylla,9355,2,20,4,6,69,40,29,64
FC Nords,9355,3,13,7,10,72,54,18,46
Copenhagen,9355,4,14,4,12,60,48,12,46
AC Horsens,9355,5,8,13,9,37,49,-12,37
AaB,9355,6,8,12,10,38,44,-6,36
Sonderjyske,9355,7,8,6,10,28,29,-1,30
Lyngby,9355,8,4,9,11,29,44,-15,21
Silkeborg IF,9355,9,6,3,13,27,44,-17,21
Randers FC,9355,10,5,6,13,23,42,-19,21
AGF Aarhus,9355,11,4,6,12,16,38,-22,18
Brondby,9356,1,20,5,5,71,34,37,65
FC Midtjylla,9356,2,18,5,7,65,45,20,59
FC Nords,9356,3,16,7,7,79,50,29,55
Copenhagen,9356,4,14,4,12,58,50,8,46
AaB,9356,5,8,12,10,39,44,-5,36
AC Horsens,9356,6,7,13,10,39,54,-15,34
Sonderjyske,9356,7,8,6,10,28,29,-1,30
Lyngby,9356,8,4,9,11,28,44,-16,21
Randers FC,9356,9,5,6,13,23,41,-18,21
Silkeborg IF,9356,10,5,4,13,28,47,-19,19
AGF Aarhus,9356,11,4,7,11,19,39,-20,19
Brondby,9357,1,20,7,3,68,32,36,67
FC Midtjylla,9357,2,19,7,4,68,40,28,64
Copenhagen,9357,3,14,6,10,59,44,15,48
FC Nords,9357,4,13,7,10,73,55,18,46
AaB,9357,5,8,11,11,40,44,-4,35
AC Horsens,9357,6,7,12,11,38,57,-19,33
Sonderjyske,9357,7,8,6,10,28,29,-1,30
Randers FC,9357,8,6,6,12,25,40,-15,24
Silkeborg IF,9357,9,5,4,13,27,46,-19,19
AGF Aarhus,9357,10,4,7,11,18,38,-20,19
Lyngby,9357,11,3,9,12,27,46,-19,18
Brondby,9358,1,22,5,3,73,31,42,71
FC Midtjylla,9358,2,18,6,6,65,44,21,60
FC Nords,9358,3,14,7,9,76,53,23,49
Copenhagen,9358,4,14,4,12,59,48,11,46
AaB,9358,5,8,13,9,40,41,-1,37
AC Horsens,9358,6,6,13,11,36,58,-22,31
Sonderjyske,9358,7,8,6,10,28,29,-1,30
Randers FC,9358,8,6,6,12,25,40,-15,24
AGF Aarhus,9358,9,5,6,11,18,37,-19,21
Lyngby,9358,10,3,9,12,27,46,-19,18
Silkeborg IF,9358,11,5,3,14,26,46,-20,18
Brondby,9359,1,19,8,3,68,34,34,65
FC Midtjylla,9359,2,19,5,6,64,41,23,62
Copenhagen,9359,3,16,5,9,58,39,19,53
FC Nords,9359,4,13,8,9,72,51,21,47
AaB,9359,5,8,11,11,36,42,-6,35
Sonderjyske,9359,6,8,6,10,28,29,-1,30
AC Horsens,9359,7,5,15,10,32,49,-17,30
Lyngby,9359,8,4,9,11,28,45,-17,21
Silkeborg IF,9359,9,6,3,13,27,44,-17,21
Randers FC,9359,10,5,6,13,24,41,-17,21
AGF Aarhus,9359,11,4,6,12,16,38,-22,18
Brondby,9360,1,21,7,2,71,32,39,70
FC Midtjylla,9360,2,19,5,6,64,40,24,62
FC Nords,9360,3,13,8,9,72,53,19,47
Copenhagen,9360,4,14,4,12,56,43,13,46
AaB,9360,5,8,11,11,38,44,-6,35
AC Horsens,9360,6,7,13,10,35,50,-15,34
Sonderjyske,9360,7,8,6,10,28,29,-1,30
Randers FC,9360,8,6,6,12,25,40,-15,24
Silkeborg IF,9360,9,6,3,13,26,44,-18,21
Lyngby,9360,10,3,9,12,27,46,-19,18
AGF Aarhus,9360,11,4,6,12,16,37,-21,18
Brondby,9361,1,22,6,2,77,31,46,72
FC Midtjylla,9361,2,20,4,6,69,42,27,64
FC Nords,9361,3,15,7,8,76,54,22,52
Copenhagen,9361,4,14,5,11,61,47,14,47
Sonderjyske,9361,5,8,6,10,28,29,-1,30
AaB,9361,6,6,12,12,35,48,-13,30
AC Horsens,9361,7,6,12,12,33,55,-22,30
Lyngby,9361,8,4,9,11,27,44,-17,21
Randers FC,9361,9,5,6,13,23,40,-17,21
Silkeborg IF,9361,10,6,3,13,26,44,-18,21
AGF Aarhus,9361,11,4,6,12,16,37,-21,18
Brondby,9362,1,20,5,5,70,35,35,65
FC Midtjylla,9362,2,20,5,5,66,40,26,65
FC Nords,9362,3,15,7,8,80,54,26,52
Copenhagen,9362,4,14,4,12,59,45,14,46
AaB,9362,5,7,13,10,38,46,-8,34
AC Horsens,9362,6,7,12,11,35,54,-19,33
Sonderjyske,9362,7,8,6,10,28,29,-1,30
Randers FC,9362,8,6,6,12,24,39,-15,24
Silkeborg IF,9362,9,5,4,13,26,45,-19,19
AGF Aarhus,9362,10,4,7,11,17,37,-20,19
Lyngby,9362,11,3,9,12,26,45,-19,18
Brondby,9363,1,20,5,5,69,39,30,65
FC Midtjylla,9363,2,20,5,5,65,38,27,65
FC Nords,9363,3,15,8,7,83,49,34,53
Copenhagen,9363,4,14,6,10,61,45,16,48
AaB,9363,5,6,13,11,35,43,-8,31
AC Horsens,9363,6,6,13,11,35,60,-25,31
Sonderjyske,9363,7,8,6,10,28,29,-1,30
Randers FC,9363,8,6,6,12,26,41,-15,24
Silkeborg IF,9363,9,6,3,13,29,46,-17,21
Lyngby,9363,10,3,9,12,28,47,-19,18
AGF Aarhus,9363,11,4,6,12,18,40,-22,18
Brondby,9364,1,21,6,3,76,34,42,69
FC Midtjylla,9364,2,21,4,5,70,36,34,67
FC Nords,9364,3,14,7,9,76,53,23,49
Copenhagen,9364,4,13,4,13,56,54,2,43
AaB,9364,5,8,12,10,40,43,-3,36
AC Horsens,9364,6,6,13,11,36,60,-24,31
Sonderjyske,9364,7,8,6,10,28,29,-1,30
Randers FC,9364,8,5,7,12,23,39,-16,22
Silkeborg IF,9364,9,6,3,13,28,45,-17,21
Lyngby,9364,10,3,10,11,26,44,-18,19
AGF Aarhus,9364,11,4,6,12,17,39,-22,18
Brondby,9365,1,20,7,3,68,32,36,67
FC Midtjylla,9365,2,19,5,6,61,37,24,62
FC Nords,9365,3,15,7,8,74,49,25,52
Copenhagen,9365,4,13,6,11,57,43,14,45
AC Horsens,9365,5,7,14,9,34,50,-16,35
AaB,9365,6,6,13,11,35,44,-9,31
Sonderjyske,9365,7,8,6,10,28,29,-1,30
Randers FC,9365,8,6,6,12,24,39,-15,24
Silkeborg IF,9365,9,6,3,13,28,44,-16,21
Lyngby,9365,10,3,9,12,26,45,-19,18
AGF Aarhus,9365,11,4,6,12,16,39,-23,18
Brondby,9366,1,21,5,4,76,36,40,68
FC Midtjylla,9366,2,18,5,7,62,45,17,59
FC Nords,9366,3,16,6,8,78,50,28,54
Copenhagen,9366,4,13,7,10,56,44,12,46
AaB,9366,5,7,13,10,38,45,-7,34
AC Horsens,9366,6,6,14,10,37,53,-16,32
Sonderjyske,9366,7,8,6,10,28,29,-1,30
Randers FC,9366,8,6,6,12,26,41,-15,24
Silkeborg IF,9366,9,5,4,13,27,46,-19,19
AGF Aarhus,9366,10,4,7,11,18,38,-20,19
Lyngby,9366,11,3,9,12,28,47,-19,18
Brondby,9367,1,19,8,3,69,33,36,65
FC Midtjylla,9367,2,20,5,5,69,38,31,65
Copenhagen,9367,3,15,5,10,68,48,20,50
FC Nords,9367,4,14,7,9,70,49,21,49
AaB,9367,5,9,11,10,36,43,-7,38
Sonderjyske,9367,6,8,6,10,28,29,-1,30
AC Horsens,9367,7,5,12,13,36,63,-27,27
Randers FC,9367,8,6,6,12,26,40,-14,24
Silkeborg IF,9367,9,6,3,13,28,46,-18,21
Lyngby,9367,10,3,9,12,27,47,-20,18
AGF Aarhus,9367,11,4,6,12,18,39,-21,18
Brondby,9368,1,22,5,3,76,28,48,71
FC Midtjylla,9368,2,19,4,7,61,38,23,61
FC Nords,9368,3,14,6,10,70,55,15,48
Copenhagen,9368,4,14,5,11,56,42,14,47
AaB,9368,5,8,12,10,33,42,-9,36
AC Horsens,9368,6,6,14,10,34,51,-17,32
Sonderjyske,9368,7,8,6,10,28,29,-1,30
Lyngby,9368,8,4,9,11,28,44,-16,21
Silkeborg IF,9368,9,6,3,13,27,44,-17,21
Randers FC,9368,10,5,6,13,23,41,-18,21
AGF Aarhus,9368,11,4,6,12,16,38,-22,18
Brondby,9369,1,22,6,2,76,29,47,72
FC Midtjylla,9369,2,18,5,7,65,46,19,59
FC Nords,9369,3,14,7,9,71,53,18,49
Copenhagen,9369,4,13,6,11,54,43,11,45
AC Horsens,9369,5,7,14,9,35,49,-14,35
AaB,9369,6,7,12,11,41,48,-7,33
Sonderjyske,9369,7,8,6,10,28,29,-1,30
Randers FC,9369,8,5,7,12,24,40,-16,22
AGF Aarhus,9369,9,5,6,11,20,37,-17,21
Lyngby,9369,10,3,10,11,27,45,-18,19
Silkeborg IF,9369,11,5,3,14,26,48,-22,18
Brondby,9370,1,23,5,2,75,30,45,74
FC Midtjylla,9370,2,20,5,5,66,36,30,65
FC Nords,9370,3,13,6,11,70,54,16,45
Copenhagen,9370,4,12,5,13,53,49,4,41
AaB,9370,5,8,12,10,42,43,-1,36
AC Horsens,9370,6,7,13,10,31,51,-20,34
Sonderjyske,9370,7,8,6,10,28,29,-1,30
Silkeborg IF,9370,8,6,3,13,28,44,-16,21
Lyngby,9370,9,4,9,11,27,44,-17,21
Randers FC,9370,10,5,6,13,23,40,-17,21
AGF Aarhus,9370,11,4,6,12,16,39,-23,18
Brondby,9371,1,23,5,2,79,32,47,74
FC Midtjylla,9371,2,20,4,6,67,40,27,64
FC Nords,9371,3,14,6,10,76,57,19,48
Copenhagen,9371,4,13,4,13,56,52,4,43
AaB,9371,5,9,11,10,39,41,-2,38
Sonderjyske,9371,6,8,6,10,28,29,-1,30
AC Horsens,9371,7,6,12,12,33,54,-21,30
Silkeborg IF,9371,8,6,3,13,28,45,-17,21
Lyngby,9371,9,4,9,11,27,44,-17,21
Randers FC,9371,10,5,6,13,23,40,-17,21
AGF Aarhus,9371,11,4,6,12,17,39,-22,18
FC Midtjylla,9372,1,21,4,5,70,41,29,67
Brondby,9372,2,19,6,5,69,37,32,63
FC Nords,9372,3,14,7,9,75,51,24,49
Copenhagen,9372,4,14,5,11,61,50,11,47
AaB,9372,5,9,11,10,36,43,-7,38
AC Horsens,9372,6,6,13,11,36,51,-15,31
Sonderjyske,9372,7,8,6,10,28,29,-1,30
Lyngby,9372,8,4,9,11,30,45,-15,21
Silkeborg IF,9372,9,6,3,13,26,44,-18,21
Randers FC,9372,10,5,6,13,24,43,-19,21
AGF Aarhus,9372,11,4,6,12,16,37,-21,18
Brondby,9373,1,23,5,2,75,31,44,74
FC Midtjylla,9373,2,17,5,8,61,42,19,56
FC Nords,9373,3,14,8,8,75,54,21,50
Copenhagen,9373,4,14,5,11,56,42,14,47
AaB,9373,5,7,13,10,37,44,-7,34
AC Horsens,9373,6,5,16,9,34,51,-17,31
Sonderjyske,9373,7,8,6,10,28,29,-1,30
Randers FC,9373,8,5,7,12,23,39,-16,22
Silkeborg IF,9373,9,6,3,13,28,45,-17,21
Lyngby,9373,10,3,10,11,26,44,-18,19
AGF Aarhus,9373,11,4,6,12,17,39,-22,18
Brondby,9374,1,21,7,2,68,29,39,70
FC Midtjylla,9374,2,19,4,7,63,43,20,61
FC Nords,9374,3,13,10,7,74,49,25,49
Copenhagen,9374,4,14,5,11,57,43,14,47
AC Horsens,9374,5,7,14,9,38,51,-13,35
Sonderjyske,9374,6,8,6,10,28,29,-1,30
AaB,9374,7,6,12,12,33,44,-11,30
Randers FC,9374,8,6,6,12,24,39,-15,24
AGF Aarhus,9374,9,5,6,11,17,36,-19,21
Lyngby,9374,10,3,9,12,26,45,-19,18
Silkeborg IF,9374,11,5,3,14,25,45,-20,18
Brondby,9375,1,21,7,2,75,33,42,70
FC Midtjylla,9375,2,19,4,7,63,45,18,61
FC Nords,9375,3,14,8,8,78,51,27,50
Copenhagen,9375,4,13,5,12,60,49,11,44
AaB,9375,5,7,13,10,35,40,-5,34
AC Horsens,9375,6,7,13,10,35,54,-19,34
Sonderjyske,9375,7,8,6,10,28,29,-1,30
Silkeborg IF,9375,8,6,3,13,28,44,-16,21
Lyngby,9375,9,4,9,11,28,45,-17,21
Randers FC,9375,10,5,6,13,24,41,-17,21
AGF Aarhus,9375,11,4,6,12,16,39,-23,18
Brondby,9376,1,21,6,3,70,31,39,69
FC Midtjylla,9376,2,20,6,4,61,34,27,66
FC Nords,9376,3,15,6,9,74,49,25,51
Copenhagen,9376,4,12,5,13,54,50,4,41
AC Horsens,9376,5,7,13,10,37,51,-14,34
AaB,9376,6,7,12,11,36,43,-7,33
Sonderjyske,9376,7,8,6,10,28,29,-1,30
Randers FC,9376,8,6,6,12,25,39,-14,24
Silkeborg IF,9376,9,6,3,13,27,44,-17,21
Lyngby,9376,10,3,9,12,26,46,-20,18
AGF Aarhus,9376,11,4,6,12,16,38,-22,18
Brondby,9377,1,21,5,4,69,34,35,68
FC Midtjylla,9377,2,18,4,8,61,41,20,58
FC Nords,9377,3,15,7,8,73,46,27,52
Copenhagen,9377,4,14,5,11,58,47,11,47
AaB,9377,5,8,13,9,39,42,-3,37
AC Horsens,9377,6,7,12,11,39,55,-16,33
Sonderjyske,9377,7,8,6,10,28,29,-1,30
Randers FC,9377,8,6,6,12,24,39,-15,24
Silkeborg IF,9377,9,6,3,13,29,44,-15,21
Lyngby,9377,10,3,9,12,26,45,-19,18
AGF Aarhus,9377,11,4,6,12,16,40,-24,18
Brondby,9378,1,20,6,4,71,32,39,66
FC Midtjylla,9378,2,19,5,6,67,42,25,62
FC Nords,9378,3,14,7,9,74,54,20,49
Copenhagen,9378,4,14,6,10,56,43,13,48
AaB,9378,5,8,12,10,45,50,-5,36
AC Horsens,9378,6,7,12,11,34,52,-18,33
Sonderjyske,9378,7,8,6,10,28,29,-1,30
Randers FC,9378,8,6,6,12,26,40,-14,24
Silkeborg IF,9378,9,5,4,13,25,44,-19,19
AGF Aarhus,9378,10,4,7,11,16,36,-20,19
Lyngby,9378,11,3,9,12,27,47,-20,18
Brondby,9379,1,20,7,3,65,28,37,67
FC Midtjylla,9379,2,19,6,5,69,40,29,63
Copenhagen,9379,3,15,5,10,61,45,16,50
FC Nords,9379,4,14,6,10,70,53,17,48
AaB,9379,5,7,14,9,41,45,-4,35
Sonderjyske,9379,6,8,6,10,28,29,-1,30
AC Horsens,9379,7,5,14,11,34,55,-21,29
Lyngby,9379,8,4,9,11,29,44,-15,21
AGF Aarhus,9379,9,5,6,11,18,36,-18,21
Randers FC,9379,10,5,6,13,23,42,-19,21
Silkeborg IF,9379,11,5,3,14,25,46,-21,18
Brondby,9380,1,21,7,2,77,35,42,70
FC Midtjylla,9380,2,20,5,5,69,39,30,65
Copenhagen,9380,3,15,5,10,63,42,21,50
FC Nords,9380,4,13,7,10,71,51,20,46
AaB,9380,5,7,11,12,34,52,-18,32
AC Horsens,9380,6,6,13,11,36,57,-21,31
Sonderjyske,9380,7,8,6,10,28,29,-1,30
Lyngby,9380,8,4,9,11,28,44,-16,21
Randers FC,9380,9,5,6,13,23,41,-18,21
Silkeborg IF,9380,10,5,4,13,27,46,-19,19
AGF Aarhus,9380,11,4,7,11,18,38,-20,19
Brondby,9381,1,23,5,2,77,30,47,74
FC Midtjylla,9381,2,18,6,6,66,41,25,60
FC Nords,9381,3,16,6,8,76,51,25,54
Copenhagen,9381,4,14,4,12,57,48,9,46
AaB,9381,5,7,12,11,34,45,-11,33
Sonderjyske,9381,6,8,6,10,28,29,-1,30
AC Horsens,9381,7,5,13,12,35,56,-21,28
Lyngby,9381,8,4,9,11,28,44,-16,21
Silkeborg IF,9381,9,6,3,13,27,45,-18,21
Randers FC,9381,10,5,6,13,23,41,-18,21
AGF Aarhus,9381,11,4,6,12,17,38,-21,18
Brondby,9382,1,21,6,3,72,34,38,69
FC Midtjylla,9382,2,20,4,6,70,43,27,64
FC Nords,9382,3,14,7,9,74,52,22,49
Copenhagen,9382,4,14,5,11,61,47,14,47
AaB,9382,5,7,12,11,36,46,-10,33
AC Horsens,9382,6,7,12,11,38,55,-17,33
Sonderjyske,9382,7,8,6,10,28,29,-1,30
Lyngby,9382,8,4,9,11,27,44,-17,21
Randers FC,9382,9,5,6,13,23,40,-17,21
Silkeborg IF,9382,10,5,4,13,25,44,-19,19
AGF Aarhus,9382,11,4,7,11,16,36,-20,19
Brondby,9383,1,21,6,3,71,34,37,69
FC Midtjylla,9383,2,19,6,5,61,37,24,63
FC Nords,9383,3,13,6,11,69,51,18,45
Copenhagen,9383,4,13,6,11,60,48,12,45
AaB,9383,5,9,11,10,37,40,-3,38
AC Horsens,9383,6,7,13,10,40,54,-14,34
Sonderjyske,9383,7,8,6,10,28,29,-1,30
Randers FC,9383,8,6,6,12,25,40,-15,24
Silkeborg IF,9383,9,6,3,13,27,44,-17,21
Lyngby,9383,10,3,9,12,27,46,-19,18
AGF Aarhus,9383,11,4,6,12,16,38,-22,18
Brondby,9384,1,22,6,2,77,31,46,72
FC Midtjylla,9384,2,20,5,5,64,37,27,65
FC Nords,9384,3,13,8,9,72,53,19,47
Copenhagen,9384,4,14,5,11,58,44,14,47
AaB,9384,5,7,12,11,37,46,-9,33
Sonderjyske,9384,6,8,6,10,28,29,-1,30
AC Horsens,9384,7,6,12,12,34,57,-23,30
Lyngby,9384,8,4,9,11,27,44,-17,21
Randers FC,9384,9,5,6,13,23,40,-17,21
Silkeborg IF,9384,10,6,3,13,27,45,-18,21
AGF Aarhus,9384,11,4,6,12,17,38,-21,18
Brondby,9385,1,21,6,3,79,32,47,69
FC Midtjylla,9385,2,18,6,6,61,38,23,60
FC Nords,9385,3,14,6,10,73,59,14,48
Copenhagen,9385,4,14,5,11,59,47,12,47
AaB,9385,5,10,11,9,41,41,0,41
Sonderjyske,9385,6,8,6,10,28,29,-1,30
AC Horsens,9385,7,6,12,12,35,57,-22,30
Randers FC,9385,8,5,7,12,24,40,-16,22
Silkeborg IF,9385,9,6,3,13,29,44,-15,21
Lyngby,9385,10,3,10,11,27,45,-18,19
AGF Aarhus,9385,11,4,6,12,16,40,-24,18
Brondby,9386,1,21,7,2,72,31,41,70
FC Midtjylla,9386,2,19,6,5,69,41,28,63
FC Nords,9386,3,14,9,7,74,48,26,51
Copenhagen,9386,4,12,4,14,54,56,-2,40
AaB,9386,5,7,13,10,37,42,-5,34
AC Horsens,9386,6,6,15,9,37,51,-14,33
Sonderjyske,9386,7,8,6,10,28,29,-1,30
Lyngby,9386,8,4,9,11,28,44,-16,21
Randers FC,9386,9,5,6,13,23,41,-18,21
AGF Aarhus,9386,10,5,6,11,19,37,-18,21
Silkeborg IF,9386,11,5,3,14,26,47,-21,18
Brondby,9387,1,19,8,3,69,33,36,65
FC Midtjylla,9387,2,19,6,5,67,40,27,63
FC Nords,9387,3,15,7,8,75,53,22,52
Copenhagen,9387,4,14,5,11,60,45,15,47
AaB,9387,5,8,11,11,35,40,-5,35
AC Horsens,9387,6,6,13,11,33,54,-21,31
Sonderjyske,9387,7,8,6,10,28,29,-1,30
Lyngby,9387,8,4,9,11,29,46,-17,21
Randers FC,9387,9,5,6,13,25,42,-17,21
Silkeborg IF,9387,10,6,3,13,26,44,-18,21
AGF Aarhus,9387,11,4,6,12,16,37,-21,18
Brondby,9388,1,21,5,4,73,38,35,68
FC Midtjylla,9388,2,20,5,5,69,40,29,65
FC Nords,9388,3,15,6,9,76,53,23,51
Copenhagen,9388,4,13,5,12,56,49,7,44
AaB,9388,5,8,13,9,36,39,-3,37
Sonderjyske,9388,6,8,6,10,28,29,-1,30
AC Horsens,9388,7,6,12,12,40,57,-17,30
Randers FC,9388,8,6,6,12,27,41,-14,24
Silkeborg IF,9388,9,6,3,13,27,45,-18,21
Lyngby,9388,10,3,9,12,28,48,-20,18
AGF Aarhus,9388,11,4,6,12,17,38,-21,18
Brondby,9389,1,20,7,3,70,31,39,67
FC Midtjylla,9389,2,20,5,5,64,36,28,65
FC Nords,9389,3,15,7,8,73,49,24,52
Copenhagen,9389,4,13,6,11,55,43,12,45
AaB,9389,5,8,11,11,37,45,-8,35
Sonderjyske,9389,6,8,6,10,28,29,-1,30
AC Horsens,9389,7,6,12,12,33,54,-21,30
Randers FC,9389,8,6,6,12,25,40,-15,24
Silkeborg IF,9389,9,5,4,13,26,45,-19,19
AGF Aarhus,9389,10,4,7,11,17,37,-20,19
Lyngby,9389,11,3,9,12,27,46,-19,18
Brondby,9390,1,23,5,2,75,29,46,74
FC Midtjylla,9390,2,18,7,5,64,40,24,61
FC Nords,9390,3,15,7,8,76,50,26,52
Copenhagen,9390,4,12,6,12,56,51,5,42
AaB,9390,5,8,11,11,39,41,-2,35
Sonderjyske,9390,6,8,6,10,28,29,-1,30
AC Horsens,9390,7,5,14,11,32,57,-25,29
Randers FC,9390,8,6,6,12,25,39,-14,24
Silkeborg IF,9390,9,6,3,13,26,44,-18,21
Lyngby,9390,10,3,9,12,26,46,-20,18
AGF Aarhus,9390,11,4,6,12,16,37,-21,18
Brondby,9391,1,22,5,3,71,31,40,71
FC Midtjylla,9391,2,19,5,6,66,43,23,62
FC Nords,9391,3,14,6,10,74,55,19,48
Copenhagen,9391,4,14,5,11,61,45,16,47
AC Horsens,9391,5,7,13,10,36,51,-15,34
AaB,9391,6,7,12,11,37,46,-9,33
Sonderjyske,9391,7,8,6,10,28,29,-1,30
Lyngby,9391,8,4,9,11,28,45,-17,21
Randers FC,9391,9,5,6,13,24,41,-17,21
Silkeborg IF,9391,10,6,3,13,27,45,-18,21
AGF Aarhus,9391,11,4,6,12,17,38,-21,18
FC Midtjylla,9392,1,20,6,4,69,37,32,66
Brondby,9392,2,19,8,3,68,32,36,65
Copenhagen,9392,3,15,5,10,59,42,17,50
FC Nords,9392,4,12,8,10,68,53,15,44
AaB,9392,5,8,12,10,40,43,-3,36
AC Horsens,9392,6,6,13,11,34,57,-23,31
Sonderjyske,9392,7,8,6,10,28,29,-1,30
Randers FC,9392,8,6,6,12,26,40,-14,24
Silkeborg IF,9392,9,6,3,13,29,46,-17,21
Lyngby,9392,10,3,9,12,27,47,-20,18
AGF Aarhus,9392,11,4,6,12,18,40,-22,18
FC Midtjylla,9393,1,21,5,4,64,35,29,68
Brondby,9393,2,19,7,4,67,32,35,64
Copenhagen,9393,3,15,5,10,58,42,16,50
FC Nords,9393,4,13,9,8,78,54,24,48
AaB,9393,5,6,13,11,35,44,-9,31
AC Horsens,9393,6,6,13,11,31,52,-21,31
Sonderjyske,9393,7,8,6,10,28,29,-1,30
Lyngby,9393,8,4,9,11,29,45,-16,21
Randers FC,9393,9,5,6,13,24,42,-18,21
Silkeborg IF,9393,10,5,4,13,27,46,-19,19
AGF Aarhus,9393,11,4,7,11,18,38,-20,19
Brondby,9394,1,19,6,5,69,37,32,63
FC Midtjylla,9394,2,19,5,6,68,43,25,62
FC Nords,9394,3,15,7,8,76,50,26,52
Copenhagen,9394,4,15,4,11,60,45,15,49
AaB,9394,5,8,11,11,38,45,-7,35
AC Horsens,9394,6,6,15,9,37,54,-17,33
Sonderjyske,9394,7,8,6,10,28,29,-1,30
Lyngby,9394,8,4,9,11,29,44,-15,21
Silkeborg IF,9394,9,6,3,13,28,45,-17,21
Randers FC,9394,10,5,6,13,23,42,-19,21
AGF Aarhus,9394,11,4,6,12,17,39,-22,18
Brondby,9395,1,21,5,4,72,35,37,68
FC Midtjylla,9395,2,20,5,5,66,39,27,65
Copenhagen,9395,3,16,5,9,69,46,23,53
FC Nords,9395,4,13,6,11,75,60,15,45
AaB,9395,5,8,12,10,39,39,0,36
Sonderjyske,9395,6,8,6,10,28,29,-1,30
AC Horsens,9395,7,5,13,12,35,63,-28,28
Lyngby,9395,8,4,9,11,30,45,-15,21
Silkeborg IF,9395,9,6,3,13,26,44,-18,21
Randers FC,9395,10,5,6,13,24,43,-19,21
AGF Aarhus,9395,11,4,6,12,16,37,-21,18
Brondby,9396,1,22,5,3,72,31,41,71
FC Midtjylla,9396,2,18,6,6,60,38,22,60
FC Nords,9396,3,16,6,8,78,50,28,54
Copenhagen,9396,4,14,5,11,54,44,10,47
AC Horsens,9396,5,7,13,10,35,52,-17,34
Sonderjyske,9396,6,8,6,10,28,29,-1,30
AaB,9396,7,6,11,13,34,44,-10,29
Randers FC,9396,8,6,6,12,25,40,-15,24
Silkeborg IF,9396,9,5,4,13,27,46,-19,19
AGF Aarhus,9396,10,4,7,11,18,38,-20,19
Lyngby,9396,11,3,9,12,27,46,-19,18
FC Midtjylla,9397,1,20,5,5,67,39,28,65
Brondby,9397,2,19,6,5,69,37,32,63
FC Nords,9397,3,16,6,8,77,54,23,54
Copenhagen,9397,4,16,4,10,63,44,19,52
AaB,9397,5,8,11,11,40,45,-5,35
Sonderjyske,9397,6,8,6,10,28,29,-1,30
AC Horsens,9397,7,5,12,13,33,56,-23,27
Lyngby,9397,8,4,9,11,28,44,-16,21
Silkeborg IF,9397,9,6,3,13,27,45,-18,21
Randers FC,9397,10,5,6,13,23,41,-18,21
AGF Aarhus,9397,11,4,6,12,17,38,-21,18
Brondby,9398,1,21,7,2,71,31,40,70
FC Midtjylla,9398,2,20,5,5,68,37,31,65
FC Nords,9398,3,14,7,9,70,51,19,49
Copenhagen,9398,4,12,7,11,56,46,10,43
AaB,9398,5,7,14,9,37,42,-5,35
Sonderjyske,9398,6,8,6,10,28,29,-1,30
AC Horsens,9398,7,5,14,11,31,52,-21,29
Randers FC,9398,8,5,7,12,23,39,-16,22
AGF Aarhus,9398,9,5,6,11,17,36,-19,21
Lyngby,9398,10,3,10,11,26,44,-18,19
Silkeborg IF,9398,11,5,3,14,25,45,-20,18
Brondby,9399,1,20,6,4,73,36,37,66
FC Midtjylla,9399,2,19,6,5,65,39,26,63
FC Nords,9399,3,14,8,8,75,51,24,50
Copenhagen,9399,4,15,5,10,60,41,19,50
AaB,9399,5,6,14,10,32,43,-11,32
Sonderjyske,9399,6,8,6,10,28,29,-1,30
AC Horsens,9399,7,5,15,10,34,55,-21,30
Lyngby,9399,8,4,9,11,31,44,-13,21
Silkeborg IF,9399,9,6,3,13,26,44,-18,21
Randers FC,9399,10,5,6,13,23,44,-21,21
AGF Aarhus,9399,11,4,6,12,16,37,-21,18
Brondby,9400,1,20,7,3,69,31,38,67
FC Midtjylla,9400,2,18,7,5,65,39,26,61
Copenhagen,9400,3,15,5,10,58,42,16,50
FC Nords,9400,4,14,7,9,72,53,19,49
AaB,9400,5,7,13,10,36,41,-5,34
AC Horsens,9400,6,6,13,11,33,53,-20,31
Sonderjyske,9400,7,8,6,10,28,29,-1,30
Lyngby,9400,8,4,9,11,27,44,-17,21
Randers FC,9400,9,5,6,13,23,40,-17,21
Silkeborg IF,9400,10,6,3,13,28,46,-18,21
AGF Aarhus,9400,11,4,6,12,18,39,-21,18
Brondby,9401,1,22,5,3,71,29,42,71
FC Midtjylla,9401,2,20,4,6,63,41,22,64
Copenhagen,9401,3,15,6,9,61,40,21,51
FC Nords,9401,4,12,7,11,66,53,13,43
AaB,9401,5,7,12,11,35,41,-6,33
AC Horsens,9401,6,6,14,10,33,51,-18,32
Sonderjyske,9401,7,8,6,10,28,29,-1,30
Randers FC,9401,8,6,6,12,25,40,-15,24
Silkeborg IF,9401,9,5,4,13,26,45,-19,19
AGF Aarhus,9401,10,4,7,11,17,37,-20,19
Lyngby,9401,11,3,9,12,27,46,-19,18
Brondby,9402,1,21,5,4,71,36,35,68
FC Midtjylla,9402,2,20,4,6,69,41,28,64
FC Nords,9402,3,15,6,9,72,47,25,51
Copenhagen,9402,4,14,4,12,59,46,13,46
AaB,9402,5,8,12,10,39,44,-5,36
AC Horsens,9402,6,6,13,11,37,59,-22,31
Sonderjyske,9402,7,8,6,10,28,29,-1,30
Lyngby,9402,8,4,9,11,27,44,-17,21
Silkeborg IF,9402,8,6,3,13,27,44,-17,21
Randers FC,9402,10,5,6,13,23,40,-17,21
AGF Aarhus,9402,11,4,6,12,16,38,-22,18
FC Midtjylla,9403,1,22,4,4,66,34,32,70
Brondby,9403,2,20,6,4,69,32,37,66
FC Nords,9403,3,14,6,10,72,51,21,48
Copenhagen,9403,4,13,5,12,55,44,11,44
AaB,9403,5,8,12,10,36,44,-8,36
AC Horsens,9403,6,6,13,11,34,53,-19,31
Sonderjyske,9403,7,8,6,10,28,29,-1,30
Lyngby,9403,8,4,9,11,30,44,-14,21
Randers FC,9403,9,5,6,13,23,43,-20,21
Silkeborg IF,9403,10,5,4,13,27,46,-19,19
AGF Aarhus,9403,11,4,7,11,18,38,-20,19
Brondby,9404,1,21,6,3,68,31,37,69
FC Midtjylla,9404,2,21,4,5,70,37,33,67
FC Nords,9404,3,15,6,9,77,52,25,51
Copenhagen,9404,4,13,6,11,58,47,11,45
AC Horsens,9404,5,6,14,10,36,56,-20,32
Sonderjyske,9404,6,8,6,10,28,29,-1,30
AaB,9404,7,6,12,12,35,47,-12,30
Lyngby,9404,8,4,9,11,28,45,-17,21
Randers FC,9404,9,5,6,13,24,41,-17,21
Silkeborg IF,9404,10,5,4,13,25,44,-19,19
AGF Aarhus,9404,11,4,7,11,16,36,-20,19
Brondby,9405,1,21,5,4,67,33,34,68
FC Midtjylla,9405,2,19,5,6,69,41,28,62
FC Nords,9405,3,15,7,8,75,49,26,52
Copenhagen,9405,4,13,6,11,56,45,11,45
AaB,9405,5,7,13,10,38,44,-6,34
AC Horsens,9405,6,7,12,11,33,52,-19,33
Sonderjyske,9405,7,8,6,10,28,29,-1,30
Randers FC,9405,8,5,7,12,23,39,-16,22
Lyngby,9405,9,3,10,11,26,44,-18,19
Silkeborg IF,9405,10,5,4,13,26,45,-19,19
AGF Aarhus,9405,11,4,7,11,17,37,-20,19
FC Midtjylla,9406,1,19,6,5,65,40,25,63
Brondby,9406,2,18,7,5,67,39,28,61
Copenhagen,9406,3,15,6,9,59,41,18,51
FC Nords,9406,4,13,9,8,75,53,22,48
AaB,9406,5,7,14,9,36,40,-4,35
AC Horsens,9406,6,6,14,10,37,52,-15,32
Sonderjyske,9406,7,8,6,10,28,29,-1,30
Randers FC,9406,8,6,6,12,25,39,-14,24
Silkeborg IF,9406,9,6,3,13,29,46,-17,21
Lyngby,9406,10,3,9,12,26,46,-20,18
AGF Aarhus,9406,11,4,6,12,18,40,-22,18
Brondby,9407,1,22,6,2,72,31,41,72
FC Midtjylla,9407,2,20,5,5,69,38,31,65
FC Nords,9407,3,14,8,8,72,48,24,50
Copenhagen,9407,4,13,5,12,57,48,9,44
AaB,9407,5,6,14,10,35,42,-7,32
Sonderjyske,9407,6,8,6,10,28,29,-1,30
AC Horsens,9407,7,5,14,11,37,61,-24,29
Lyngby,9407,8,4,9,11,30,45,-15,21
Silkeborg IF,9407,9,6,3,13,29,45,-16,21
Randers FC,9407,10,5,6,13,24,43,-19,21
AGF Aarhus,9407,11,4,6,12,17,40,-23,18
Brondby,9408,1,23,5,2,74,30,44,74
FC Midtjylla,9408,2,19,4,7,64,38,26,61
FC Nords,9408,3,15,6,9,75,52,23,51
Copenhagen,9408,4,14,5,11,58,46,12,47
AC Horsens,9408,5,7,13,10,37,52,-15,34
Sonderjyske,9408,6,8,6,10,28,29,-1,30
AaB,9408,7,6,11,13,34,50,-16,29
Randers FC,9408,8,6,6,12,25,39,-14,24
Silkeborg IF,9408,9,5,4,13,25,44,-19,19
AGF Aarhus,9408,10,4,7,11,16,36,-20,19
Lyngby,9408,11,3,9,12,26,46,-20,18
Brondby,9409,1,21,7,2,72,31,41,70
FC Midtjylla,9409,2,20,5,5,68,39,29,65
FC Nords,9409,3,13,8,9,71,51,20,47
Copenhagen,9409,4,12,7,11,55,45,10,43
AaB,9409,5,8,12,10,40,46,-6,36
Sonderjyske,9409,6,8,6,10,28,29,-1,30
AC Horsens,9409,7,5,15,10,34,54,-20,30
Randers FC,9409,8,5,7,12,25,41,-16,22
AGF Aarhus,9409,9,5,6,11,18,37,-19,21
Lyngby,9409,10,3,10,11,28,46,-18,19
Silkeborg IF,9409,11,5,3,14,26,46,-20,18
Brondby,9410,1,20,6,4,67,33,34,66
FC Midtjylla,9410,2,20,5,5,63,35,28,65
FC Nords,9410,3,13,8,9,73,52,21,47
Copenhagen,9410,4,12,5,13,53,50,3,41
AaB,9410,5,10,11,9,42,40,2,41
AC Horsens,9410,6,6,15,9,34,48,-14,33
Sonderjyske,9410,7,8,6,10,28,29,-1,30
Lyngby,9410,8,4,9,11,29,45,-16,21
Silkeborg IF,9410,9,6,3,13,27,44,-17,21
Randers FC,9410,10,5,6,13,24,42,-18,21
AGF Aarhus,9410,11,4,6,12,16,38,-22,18
FC Midtjylla,9411,1,21,4,5,69,38,31,67
Brondby,9411,2,20,5,5,73,34,39,65
Copenhagen,9411,3,14,6,10,57,40,17,48
FC Nords,9411,4,13,7,10,75,60,15,46
AC Horsens,9411,5,8,12,10,40,58,-18,36
AaB,9411,6,7,12,11,36,46,-10,33
Sonderjyske,9411,7,8,6,10,28,29,-1,30
Lyngby,9411,8,4,9,11,29,45,-16,21
Randers FC,9411,9,5,6,13,24,42,-18,21
AGF Aarhus,9411,10,5,6,11,18,37,-19,21
Silkeborg IF,9411,11,5,3,14,26,46,-20,18
Brondby,9412,1,22,5,3,73,31,42,71
FC Midtjylla,9412,2,19,5,6,67,38,29,62
Copenhagen,9412,3,15,4,11,59,43,16,49
FC Nords,9412,4,12,7,11,69,57,12,43
AC Horsens,9412,5,9,12,9,38,47,-9,39
AaB,9412,6,7,11,12,35,51,-16,32
Sonderjyske,9412,7,8,6,10,28,29,-1,30
Randers FC,9412,8,6,6,12,25,39,-14,24
AGF Aarhus,9412,9,5,6,11,18,36,-18,21
Lyngby,9412,10,3,9,12,26,46,-20,18
Silkeborg IF,9412,11,5,3,14,25,46,-21,18
Brondby,9413,1,21,5,4,70,34,36,68
FC Midtjylla,9413,2,19,6,5,66,37,29,63
Copenhagen,9413,3,15,4,11,58,45,13,49
FC Nords,9413,4,14,6,10,71,54,17,48
AaB,9413,5,9,12,9,41,41,0,39
Sonderjyske,9413,6,8,6,10,28,29,-1,30
AC Horsens,9413,7,5,13,12,34,55,-21,28
Randers FC,9413,8,5,7,12,23,39,-16,22
Lyngby,9413,9,3,10,11,26,44,-18,19
Silkeborg IF,9413,10,5,4,13,26,45,-19,19
AGF Aarhus,9413,11,4,7,11,17,37,-20,19
Brondby,9414,1,20,8,2,70,31,39,68
FC Midtjylla,9414,2,18,5,7,61,41,20,59
FC Nords,9414,3,14,8,8,73,50,23,50
Copenhagen,9414,4,14,5,11,56,44,12,47
AaB,9414,5,8,12,10,39,42,-3,36
AC Horsens,9414,6,6,14,10,34,51,-17,32
Sonderjyske,9414,7,8,6,10,28,29,-1,30
Randers FC,9414,8,5,7,12,24,40,-16,22
Lyngby,9414,9,3,10,11,27,45,-18,19
Silkeborg IF,9414,10,5,4,13,27,46,-19,19
AGF Aarhus,9414,11,4,7,11,18,38,-20,19
Brondby,9415,1,21,6,3,73,34,39,69
FC Midtjylla,9415,2,20,4,6,67,42,25,64
FC Nords,9415,3,14,7,9,73,55,18,49
Copenhagen,9415,4,14,4,12,59,47,12,46
AaB,9415,5,9,11,10,43,45,-2,38
Sonderjyske,9415,6,8,6,10,28,29,-1,30
AC Horsens,9415,7,6,12,12,37,55,-18,30
Randers FC,9415,8,5,7,12,25,41,-16,22
Silkeborg IF,9415,9,6,3,13,28,46,-18,21
Lyngby,9415,10,3,10,11,28,46,-18,19
AGF Aarhus,9415,11,4,6,12,18,39,-21,18
Brondby,9416,1,20,7,3,71,34,37,67
FC Midtjylla,9416,2,20,5,5,69,38,31,65
FC Nords,9416,3,14,7,9,74,54,20,49
Copenhagen,9416,4,14,4,12,60,49,11,46
AC Horsens,9416,5,7,13,10,37,54,-17,34
AaB,9416,6,7,12,11,36,44,-8,33
Sonderjyske,9416,7,8,6,10,28,29,-1,30
Lyngby,9416,8,4,9,11,28,44,-16,21
Silkeborg IF,9416,8,6,3,13,28,44,-16,21
Randers FC,9416,10,5,6,13,23,41,-18,21
AGF Aarhus,9416,11,4,6,12,16,39,-23,18
Brondby,9417,1,19,8,3,69,35,34,65
FC Midtjylla,9417,2,18,7,5,62,38,24,61
Copenhagen,9417,3,16,5,9,58,39,19,53
FC Nords,9417,4,12,8,10,69,51,18,44
AC Horsens,9417,5,7,14,9,34,48,-14,35
AaB,9417,6,6,14,10,34,41,-7,32
Sonderjyske,9417,7,8,6,10,28,29,-1,30
Randers FC,9417,8,6,6,12,27,41,-14,24
AGF Aarhus,9417,9,5,6,11,20,38,-18,21
Lyngby,9417,10,3,9,12,28,48,-20,18
Silkeborg IF,9417,11,5,3,14,27,48,-21,18
FC Midtjylla,9418,1,21,5,4,68,38,30,68
Brondby,9418,2,19,5,6,66,37,29,62
FC Nords,9418,3,13,8,9,72,50,22,47
Copenhagen,9418,4,13,7,10,58,45,13,46
AaB,9418,5,7,14,9,39,41,-2,35
AC Horsens,9418,6,6,15,9,36,54,-18,33
Sonderjyske,9418,7,8,6,10,28,29,-1,30
Randers FC,9418,8,6,6,12,26,39,-13,24
AGF Aarhus,9418,9,5,6,11,17,36,-19,21
Silkeborg IF,9418,10,5,3,14,25,45,-20,18
Lyngby,9418,11,3,9,12,26,47,-21,18
Brondby,9419,1,21,5,4,69,32,37,68
FC Midtjylla,9419,2,21,4,5,67,39,28,67
FC Nords,9419,3,14,8,8,71,49,22,50
Copenhagen,9419,4,12,5,13,53,44,9,41
AaB,9419,5,8,12,10,36,40,-4,36
AC Horsens,9419,6,7,12,11,35,53,-18,33
Sonderjyske,9419,7,8,6,10,28,29,-1,30
Randers FC,9419,8,6,6,12,26,40,-14,24
AGF Aarhus,9419,9,5,6,11,18,36,-18,21
Lyngby,9419,10,3,9,12,27,47,-20,18
Silkeborg IF,9419,11,5,3,14,25,46,-21,18
Brondby,9420,1,22,5,3,74,29,45,71
FC Midtjylla,9420,2,20,4,6,64,40,24,64
Copenhagen,9420,3,14,5,11,59,47,12,47
FC Nords,9420,4,13,7,10,68,52,16,46
AC Horsens,9420,5,9,12,9,37,48,-11,39
Sonderjyske,9420,6,8,6,10,28,29,-1,30
AaB,9420,7,6,11,13,35,47,-12,29
Silkeborg IF,9420,8,6,3,13,28,44,-16,21
Lyngby,9420,9,4,9,11,27,44,-17,21
Randers FC,9420,10,5,6,13,23,40,-17,21
AGF Aarhus,9420,11,4,6,12,16,39,-23,18
Brondby,9421,1,21,5,4,71,31,40,68
FC Midtjylla,9421,2,20,5,5,66,41,25,65
Copenhagen,9421,3,14,5,11,56,45,11,47
FC Nords,9421,4,12,9,9,66,49,17,45
AaB,9421,5,9,12,9,42,41,1,39
Sonderjyske,9421,6,8,6,10,28,29,-1,30
AC Horsens,9421,7,6,12,12,34,54,-20,30
Lyngby,9421,8,4,9,11,29,44,-15,21
AGF Aarhus,9421,9,5,6,11,18,36,-18,21
Randers FC,9421,10,5,6,13,23,42,-19,21
Silkeborg IF,9421,11,5,3,14,25,46,-21,18
Brondby,9422,1,22,5,3,74,33,41,71
FC Midtjylla,9422,2,18,6,6,68,45,23,60
FC Nords,9422,3,17,6,7,76,46,30,57
Copenhagen,9422,4,13,5,12,57,51,6,44
AaB,9422,5,7,11,12,40,46,-6,32
AC Horsens,9422,6,6,13,11,35,55,-20,31
Sonderjyske,9422,7,8,6,10,28,29,-1,30
Randers FC,9422,8,5,7,12,25,41,-16,22
AGF Aarhus,9422,9,5,6,11,18,37,-19,21
Lyngby,9422,10,3,10,11,28,46,-18,19
Silkeborg IF,9422,11,5,3,14,26,46,-20,18
Brondby,9423,1,22,6,2,74,31,43,72
FC Midtjylla,9423,2,19,4,7,64,40,24,61
FC Nords,9423,3,15,6,9,71,52,19,51
Copenhagen,9423,4,14,7,9,61,44,17,49
AaB,9423,5,7,12,11,35,41,-6,33
Sonderjyske,9423,6,8,6,10,28,29,-1,30
AC Horsens,9423,7,5,13,12,31,54,-23,28
Randers FC,9423,8,5,7,12,25,41,-16,22
AGF Aarhus,9423,9,5,6,11,17,36,-19,21
Lyngby,9423,10,3,10,11,28,46,-18,19
Silkeborg IF,9423,11,5,3,14,25,45,-20,18
Brondby,9424,1,22,5,3,70,31,39,71
FC Midtjylla,9424,2,19,4,7,62,41,21,61
FC Nords,9424,3,15,6,9,74,51,23,51
Copenhagen,9424,4,15,6,9,66,46,20,51
AC Horsens,9424,5,6,13,11,35,53,-18,31
Sonderjyske,9424,6,8,6,10,28,29,-1,30
AaB,9424,7,6,12,12,32,43,-11,30
Randers FC,9424,8,5,7,12,23,39,-16,22
Silkeborg IF,9424,9,6,3,13,29,45,-16,21
Lyngby,9424,10,3,10,11,26,44,-18,19
AGF Aarhus,9424,11,4,6,12,17,40,-23,18
Brondby,9425,1,20,7,3,67,30,37,67
FC Midtjylla,9425,2,19,6,5,67,39,28,63
FC Nords,9425,3,14,7,9,68,50,18,49
Copenhagen,9425,4,14,6,10,57,43,14,48
AaB,9425,5,9,12,9,41,40,1,39
Sonderjyske,9425,6,8,6,10,28,29,-1,30
AC Horsens,9425,7,5,12,13,34,58,-24,27
Randers FC,9425,8,5,7,12,23,39,-16,22
AGF Aarhus,9425,9,5,6,11,18,36,-18,21
Lyngby,9425,10,3,10,11,26,44,-18,19
Silkeborg IF,9425,11,5,3,14,25,46,-21,18
FC Midtjylla,9426,1,20,6,4,72,39,33,66
Brondby,9426,2,19,8,3,65,30,35,65
FC Nords,9426,3,15,7,8,77,53,24,52
Copenhagen,9426,4,14,5,11,57,46,11,47
AC Horsens,9426,5,6,14,10,39,55,-16,32
Sonderjyske,9426,6,8,6,10,28,29,-1,30
AaB,9426,7,6,12,12,34,47,-13,30
Lyngby,9426,8,4,9,11,27,44,-17,21
Randers FC,9426,9,5,6,13,23,40,-17,21
Silkeborg IF,9426,10,6,3,13,26,44,-18,21
AGF Aarhus,9426,11,4,6,12,16,37,-21,18
Brondby,9427,1,20,6,4,67,34,33,66
FC Midtjylla,9427,2,18,6,6,61,37,24,60
Copenhagen,9427,3,15,4,11,59,45,14,49
FC Nords,9427,4,14,6,10,74,53,21,48
AaB,9427,5,8,13,9,36,42,-6,37
AC Horsens,9427,6,7,13,10,38,50,-12,34
Sonderjyske,9427,7,8,6,10,28,29,-1,30
Lyngby,9427,8,4,9,11,29,45,-16,21
Randers FC,9427,9,5,6,13,24,42,-18,21
AGF Aarhus,9427,10,5,6,11,17,36,-19,21
Silkeborg IF,9427,11,5,3,14,25,45,-20,18
Brondby,9428,1,21,6,3,75,34,41,69
FC Midtjylla,9428,2,19,6,5,66,40,26,63
Copenhagen,9428,3,14,5,11,59,47,12,47
FC Nords,9428,4,13,7,10,72,55,17,46
AC Horsens,9428,5,8,14,8,34,46,-12,38
Sonderjyske,9428,6,8,6,10,28,29,-1,30
AaB,9428,7,6,12,12,37,47,-10,30
Lyngby,9428,8,4,9,11,27,44,-17,21
Randers FC,9428,9,5,6,13,23,40,-17,21
AGF Aarhus,9428,10,5,6,11,17,36,-19,21
Silkeborg IF,9428,11,5,3,14,25,45,-20,18
Brondby,9429,1,21,6,3,70,31,39,69
FC Midtjylla,9429,2,19,5,6,65,43,22,62
FC Nords,9429,3,14,8,8,75,47,28,50
Copenhagen,9429,4,14,4,12,57,50,7,46
AaB,9429,5,8,12,10,40,44,-4,36
Sonderjyske,9429,6,8,6,10,28,29,-1,30
AC Horsens,9429,7,5,15,10,32,50,-18,30
Randers FC,9429,8,5,7,12,24,40,-16,22
Silkeborg IF,9429,9,6,3,13,28,45,-17,21
Lyngby,9429,10,3,10,11,27,45,-18,19
AGF Aarhus,9429,11,4,6,12,17,39,-22,18
Brondby,9430,1,21,7,2,73,31,42,70
FC Midtjylla,9430,2,21,4,5,66,39,27,67
FC Nords,9430,3,13,7,10,69,50,19,46
Copenhagen,9430,4,12,6,12,55,50,5,42
AC Horsens,9430,5,7,14,9,36,50,-14,35
AaB,9430,6,7,12,11,40,45,-5,33
Sonderjyske,9430,7,8,6,10,28,29,-1,30
Lyngby,9430,8,4,9,11,28,44,-16,21
Silkeborg IF,9430,9,6,3,13,26,44,-18,21
Randers FC,9430,10,5,6,13,23,41,-18,21
AGF Aarhus,9430,11,4,6,12,16,37,-21,18
Brondby,9431,1,21,5,4,76,34,42,68
FC Midtjylla,9431,2,21,4,5,71,41,30,67
FC Nords,9431,3,15,6,9,78,57,21,51
Copenhagen,9431,4,15,5,10,62,47,15,50
Sonderjyske,9431,5,8,6,10,28,29,-1,30
AaB,9431,6,6,12,12,37,50,-13,30
AC Horsens,9431,7,6,12,12,34,55,-21,30
Randers FC,9431,8,6,6,12,25,40,-15,24
Silkeborg IF,9431,9,6,3,13,26,44,-18,21
Lyngby,9431,10,3,9,12,27,46,-19,18
AGF Aarhus,9431,11,4,6,12,16,37,-21,18
Brondby,9432,1,21,6,3,74,34,40,69
FC Midtjylla,9432,2,20,6,4,68,38,30,66
FC Nords,9432,3,14,7,9,75,55,20,49
Copenhagen,9432,4,13,6,11,58,47,11,45
AC Horsens,9432,5,7,13,10,34,51,-17,34
Sonderjyske,9432,6,8,6,10,28,29,-1,30
AaB,9432,7,6,12,12,34,44,-10,30
Randers FC,9432,8,6,6,12,25,40,-15,24
Silkeborg IF,9432,9,6,3,13,28,44,-16,21
Lyngby,9432,10,3,9,12,27,46,-19,18
AGF Aarhus,9432,11,4,6,12,16,39,-23,18
FC Midtjylla,9433,1,21,4,5,75,41,34,67
Brondby,9433,2,20,6,4,70,35,35,66
FC Nords,9433,3,14,7,9,72,55,17,49
Copenhagen,9433,4,14,4,12,57,43,14,46
AaB,9433,5,8,12,10,35,38,-3,36
Sonderjyske,9433,6,8,6,10,28,29,-1,30
AC Horsens,9433,7,5,15,10,33,56,-23,30
Randers FC,9433,8,6,6,12,26,39,-13,24
Silkeborg IF,9433,9,6,3,13,28,44,-16,21
Lyngby,9433,10,3,9,12,26,47,-21,18
AGF Aarhus,9433,11,4,6,12,16,39,-23,18
FC Midtjylla,9434,1,20,5,5,64,37,27,65
Brondby,9434,2,19,7,4,69,34,35,64
Copenhagen,9434,3,16,5,9,64,43,21,53
FC Nords,9434,4,14,6,10,72,56,16,48
AaB,9434,5,8,11,11,40,43,-3,35
Sonderjyske,9434,6,8,6,10,28,29,-1,30
AC Horsens,9434,7,5,14,11,34,56,-22,29
Randers FC,9434,8,5,7,12,24,40,-16,22
Silkeborg IF,9434,9,6,3,13,26,44,-18,21
Lyngby,9434,10,3,10,11,27,45,-18,19
AGF Aarhus,9434,11,4,6,12,16,37,-21,18
Brondby,9435,1,21,5,4,68,32,36,68
FC Midtjylla,9435,2,19,4,7,69,42,27,61
FC Nords,9435,3,15,6,9,72,50,22,51
Copenhagen,9435,4,14,4,12,54,45,9,46
AaB,9435,5,8,12,10,39,45,-6,36
AC Horsens,9435,6,7,13,10,38,52,-14,34
Sonderjyske,9435,7,8,6,10,28,29,-1,30
Randers FC,9435,8,6,6,12,25,40,-15,24
Silkeborg IF,9435,9,6,3,13,28,45,-17,21
Lyngby,9435,10,3,9,12,27,46,-19,18
AGF Aarhus,9435,11,4,6,12,17,39,-22,18
Brondby,9436,1,20,7,3,70,34,36,67
FC Midtjylla,9436,2,20,4,6,68,39,29,64
Copenhagen,9436,3,15,5,10,59,44,15,50
FC Nords,9436,4,14,7,9,70,52,18,49
AC Horsens,9436,5,6,14,10,40,54,-14,32
AaB,9436,6,6,13,11,35,45,-10,31
Sonderjyske,9436,7,8,6,10,28,29,-1,30
Lyngby,9436,8,4,9,11,27,44,-17,21
Randers FC,9436,9,5,6,13,23,40,-17,21
AGF Aarhus,9436,10,5,6,11,18,37,-19,21
Silkeborg IF,9436,11,5,3,14,26,46,-20,18
Brondby,9437,1,22,6,2,74,32,42,72
FC Midtjylla,9437,2,20,5,5,69,42,27,65
FC Nords,9437,3,14,7,9,73,52,21,49
Copenhagen,9437,4,14,5,11,60,45,15,47
AaB,9437,5,7,12,11,37,45,-8,33
Sonderjyske,9437,6,8,6,10,28,29,-1,30
AC Horsens,9437,7,5,13,12,31,54,-23,28
Randers FC,9437,8,5,7,12,23,39,-16,22
Silkeborg IF,9437,9,6,3,13,28,44,-16,21
Lyngby,9437,10,3,10,11,26,44,-18,19
AGF Aarhus,9437,11,4,6,12,16,39,-23,18
Brondby,9438,1,21,7,2,74,31,43,70
FC Midtjylla,9438,2,19,5,6,67,39,28,62
FC Nords,9438,3,15,8,7,75,50,25,53
Copenhagen,9438,4,13,5,12,54,43,11,44
AaB,9438,5,7,11,12,35,48,-13,32
AC Horsens,9438,6,6,14,10,36,56,-20,32
Sonderjyske,9438,7,8,6,10,28,29,-1,30
Randers FC,9438,8,6,6,12,26,40,-14,24
Silkeborg IF,9438,9,6,3,13,27,45,-18,21
Lyngby,9438,10,3,9,12,27,47,-20,18
AGF Aarhus,9438,11,4,6,12,17,38,-21,18
Brondby,9439,1,20,7,3,70,33,37,67
FC Midtjylla,9439,2,19,5,6,63,40,23,62
FC Nords,9439,3,15,6,9,71,49,22,51
Copenhagen,9439,4,15,5,10,60,43,17,50
AC Horsens,9439,5,7,12,11,41,53,-12,33
AaB,9439,6,7,11,12,34,47,-13,32
Sonderjyske,9439,7,8,6,10,28,29,-1,30
Randers FC,9439,8,6,6,12,24,39,-15,24
AGF Aarhus,9439,9,5,6,11,18,37,-19,21
Lyngby,9439,10,3,9,12,26,45,-19,18
Silkeborg IF,9439,11,5,3,14,26,46,-20,18
Brondby,9440,1,21,6,3,70,33,37,69
FC Midtjylla,9440,2,19,5,6,62,39,23,62
FC Nords,9440,3,16,6,8,74,50,24,54
Copenhagen,9440,4,12,4,14,54,50,4,40
AaB,9440,5,9,13,8,43,40,3,40
Sonderjyske,9440,6,8,6,10,28,29,-1,30
AC Horsens,9440,7,6,12,12,36,53,-17,30
Randers FC,9440,8,5,7,12,24,40,-16,22
Lyngby,9440,9,3,10,11,27,45,-18,19
Silkeborg IF,9440,10,5,4,13,26,45,-19,19
AGF Aarhus,9440,11,4,7,11,17,37,-20,19
Brondby,9441,1,22,5,3,76,29,47,71
FC Midtjylla,9441,2,20,4,6,65,39,26,64
FC Nords,9441,3,14,7,9,76,59,17,49
Copenhagen,9441,4,14,4,12,58,49,9,46
AaB,9441,5,7,12,11,36,42,-6,33
AC Horsens,9441,6,7,12,11,37,56,-19,33
Sonderjyske,9441,7,8,6,10,28,29,-1,30
Silkeborg IF,9441,8,6,3,13,29,44,-15,21
Lyngby,9441,9,4,9,11,29,45,-16,21
Randers FC,9441,10,5,6,13,24,42,-18,21
AGF Aarhus,9441,11,4,6,12,16,40,-24,18
Brondby,9442,1,21,7,2,71,30,41,70
FC Midtjylla,9442,2,17,7,6,60,38,22,58
FC Nords,9442,3,14,7,9,71,55,16,49
Copenhagen,9442,4,14,4,12,55,46,9,46
AaB,9442,5,8,14,8,41,38,3,38
Sonderjyske,9442,6,8,6,10,28,29,-1,30
AC Horsens,9442,7,5,15,10,33,50,-17,30
Lyngby,9442,8,4,9,11,27,44,-17,21
Randers FC,9442,9,5,6,13,23,40,-17,21
Silkeborg IF,9442,10,5,4,13,25,44,-19,19
AGF Aarhus,9442,11,4,7,11,16,36,-20,19
Brondby,9443,1,22,5,3,75,32,43,71
FC Midtjylla,9443,2,21,4,5,67,36,31,67
FC Nords,9443,3,13,7,10,73,56,17,46
Copenhagen,9443,4,12,5,13,52,48,4,41
AC Horsens,9443,5,8,13,9,36,49,-13,37
AaB,9443,6,6,14,10,36,44,-8,32
Sonderjyske,9443,7,8,6,10,28,29,-1,30
Lyngby,9443,8,4,9,11,29,44,-15,21
Randers FC,9443,9,5,6,13,23,42,-19,21
Silkeborg IF,9443,10,5,4,13,26,45,-19,19
AGF Aarhus,9443,11,4,7,11,17,37,-20,19
Brondby,9444,1,23,5,2,78,31,47,74
FC Midtjylla,9444,2,20,4,6,65,40,25,64
FC Nords,9444,3,14,7,9,72,55,17,49
Copenhagen,9444,4,14,4,12,58,44,14,46
AC Horsens,9444,5,7,12,11,35,54,-19,33
Sonderjyske,9444,6,8,6,10,28,29,-1,30
AaB,9444,7,6,12,12,33,43,-10,30
Randers FC,9444,8,5,7,12,23,39,-16,22
Silkeborg IF,9444,9,6,3,13,27,45,-18,21
Lyngby,9444,10,3,10,11,26,44,-18,19
AGF Aarhus,9444,11,4,6,12,17,38,-21,18
Brondby,9445,1,20,6,4,73,35,38,66
FC Midtjylla,9445,2,20,5,5,68,42,26,65
FC Nords,9445,3,15,7,8,78,50,28,52
Copenhagen,9445,4,12,5,13,56,53,3,41
AaB,9445,5,8,12,10,43,46,-3,36
AC Horsens,9445,6,7,13,10,36,54,-18,34
Sonderjyske,9445,7,8,6,10,28,29,-1,30
Randers FC,9445,8,6,6,12,27,41,-14,24
Silkeborg IF,9445,9,6,3,13,27,45,-18,21
Lyngby,9445,10,3,9,12,28,48,-20,18
AGF Aarhus,9445,11,4,6,12,17,38,-21,18
Brondby,9446,1,20,6,4,67,31,36,66
FC Midtjylla,9446,2,19,5,6,64,40,24,62
FC Nords,9446,3,16,6,8,77,52,25,54
Copenhagen,9446,4,13,6,11,61,51,10,45
AaB,9446,5,10,11,9,44,44,0,41
Sonderjyske,9446,6,8,6,10,28,29,-1,30
AC Horsens,9446,7,5,12,13,33,54,-21,27
Randers FC,9446,8,6,6,12,25,39,-14,24
Silkeborg IF,9446,9,6,3,13,26,44,-18,21
Lyngby,9446,10,3,9,12,26,46,-20,18
AGF Aarhus,9446,11,4,6,12,16,37,-21,18
Brondby,9447,1,19,7,4,70,33,37,64
FC Midtjylla,9447,2,18,6,6,64,40,24,60
FC Nords,9447,3,12,11,7,69,48,21,47
Copenhagen,9447,4,14,5,11,59,47,12,47
AaB,9447,5,8,13,9,39,43,-4,37
AC Horsens,9447,6,7,14,9,36,52,-16,35
Sonderjyske,9447,7,8,6,10,28,29,-1,30
Randers FC,9447,8,6,6,12,28,42,-14,24
Silkeborg IF,9447,9,6,3,13,26,44,-18,21
Lyngby,9447,10,3,9,12,29,49,-20,18
AGF Aarhus,9447,11,4,6,12,16,37,-21,18
Brondby,9448,1,21,7,2,70,27,43,70
FC Midtjylla,9448,2,20,5,5,65,37,28,65
FC Nords,9448,3,16,6,8,73,50,23,54
Copenhagen,9448,4,12,6,12,53,46,7,42
AaB,9448,5,6,13,11,35,44,-9,31
Sonderjyske,9448,6,8,6,10,28,29,-1,30
AC Horsens,9448,7,5,15,10,33,51,-18,30
Lyngby,9448,8,4,9,11,27,44,-17,21
Randers FC,9448,9,5,6,13,23,40,-17,21
Silkeborg IF,9448,10,5,4,13,26,45,-19,19
AGF Aarhus,9448,11,4,7,11,17,37,-20,19
FC Midtjylla,9449,1,20,5,5,65,37,28,65
Brondby,9449,2,18,9,3,67,33,34,63
FC Nords,9449,3,16,6,8,79,53,26,54
Copenhagen,9449,4,14,6,10,58,45,13,48
AaB,9449,5,6,14,10,33,40,-7,32
Sonderjyske,9449,6,8,6,10,28,29,-1,30
AC Horsens,9449,7,5,14,11,33,53,-20,29
Lyngby,9449,8,4,9,11,28,44,-16,21
Silkeborg IF,9449,9,6,3,13,27,45,-18,21
Randers FC,9449,10,5,6,13,23,41,-18,21
AGF Aarhus,9449,11,4,6,12,17,38,-21,18
Brondby,9450,1,22,6,2,75,30,45,72
FC Midtjylla,9450,2,19,6,5,64,42,22,63
FC Nords,9450,3,13,7,10,71,54,17,46
Copenhagen,9450,4,13,5,12,62,50,12,44
AaB,9450,5,8,12,10,37,41,-4,36
AC Horsens,9450,6,6,14,10,38,56,-18,32
Sonderjyske,9450,7,8,6,10,28,29,-1,30
Silkeborg IF,9450,8,6,3,13,29,45,-16,21
Lyngby,9450,9,4,9,11,27,44,-17,21
Randers FC,9450,10,5,6,13,23,40,-17,21
AGF Aarhus,9450,11,4,6,12,17,40,-23,18
Brondby,9451,1,21,6,3,71,33,38,69
FC Midtjylla,9451,2,19,5,6,67,42,25,62
FC Nords,9451,3,14,7,9,74,53,21,49
Copenhagen,9451,4,15,4,11,58,45,13,49
AaB,9451,5,8,11,11,38,44,-6,35
AC Horsens,9451,6,6,13,11,33,50,-17,31
Sonderjyske,9451,7,8,6,10,28,29,-1,30
Lyngby,9451,8,4,9,11,27,44,-17,21
Randers FC,9451,9,5,6,13,23,40,-17,21
AGF Aarhus,9451,10,5,6,11,17,36,-19,21
Silkeborg IF,9451,11,5,3,14,25,45,-20,18
Brondby,9452,1,20,6,4,75,34,41,66
FC Midtjylla,9452,2,19,5,6,64,43,21,62
Copenhagen,9452,3,16,4,10,63,45,18,52
FC Nords,9452,4,13,7,10,72,57,15,46
AC Horsens,9452,5,7,14,9,39,53,-14,35
AaB,9452,6,7,12,11,38,45,-7,33
Sonderjyske,9452,7,8,6,10,28,29,-1,30
Randers FC,9452,8,6,6,12,24,39,-15,24
Silkeborg IF,9452,9,6,3,13,27,44,-17,21
Lyngby,9452,10,3,9,12,26,45,-19,18
AGF Aarhus,9452,11,4,6,12,16,38,-22,18
Brondby,9453,1,22,5,3,72,30,42,71
FC Midtjylla,9453,2,18,5,7,61,38,23,59
FC Nords,9453,3,14,7,9,74,53,21,49
Copenhagen,9453,4,13,5,12,54,45,9,44
AC Horsens,9453,5,8,13,9,37,50,-13,37
AaB,9453,6,8,11,11,37,45,-8,35
Sonderjyske,9453,7,8,6,10,28,29,-1,30
Lyngby,9453,8,4,9,11,28,45,-17,21
Randers FC,9453,9,5,6,13,24,41,-17,21
Silkeborg IF,9453,10,5,4,13,26,45,-19,19
AGF Aarhus,9453,11,4,7,11,17,37,-20,19
Brondby,9454,1,20,7,3,69,30,39,67
FC Midtjylla,9454,2,19,5,6,67,42,25,62
Copenhagen,9454,3,14,6,10,57,43,14,48
FC Nords,9454,4,13,7,10,74,59,15,46
AaB,9454,5,7,14,9,36,39,-3,35
AC Horsens,9454,6,6,15,9,35,51,-16,33
Sonderjyske,9454,7,8,6,10,28,29,-1,30
Randers FC,9454,8,5,7,12,24,40,-16,22
Lyngby,9454,9,3,10,11,27,45,-18,19
Silkeborg IF,9454,10,5,4,13,27,46,-19,19
AGF Aarhus,9454,11,4,7,11,18,38,-20,19
Brondby,9455,1,23,5,2,73,28,45,74
FC Midtjylla,9455,2,19,5,6,64,36,28,62
FC Nords,9455,3,14,6,10,69,51,18,48
Copenhagen,9455,4,13,4,13,54,48,6,43
AaB,9455,5,8,11,11,36,43,-7,35
AC Horsens,9455,6,7,13,10,33,49,-16,34
Sonderjyske,9455,7,8,6,10,28,29,-1,30
Randers FC,9455,8,6,6,12,26,40,-14,24
Silkeborg IF,9455,9,5,4,13,26,45,-19,19
AGF Aarhus,9455,10,4,7,11,17,37,-20,19
Lyngby,9455,11,3,9,12,27,47,-20,18
Brondby,9456,1,19,7,4,69,36,33,64
FC Midtjylla,9456,2,19,5,6,62,38,24,62
FC Nords,9456,3,15,8,7,78,50,28,53
Copenhagen,9456,4,14,6,10,62,47,15,48
AaB,9456,5,8,13,9,37,40,-3,37
Sonderjyske,9456,6,8,6,10,28,29,-1,30
AC Horsens,9456,7,5,13,12,35,58,-23,28
Randers FC,9456,8,5,7,12,24,40,-16,22
Silkeborg IF,9456,9,6,3,13,27,45,-18,21
Lyngby,9456,10,3,10,11,27,45,-18,19
AGF Aarhus,9456,11,4,6,12,17,38,-21,18
Brondby,9457,1,19,7,4,66,33,33,64
FC Midtjylla,9457,2,19,5,6,67,44,23,62
FC Nords,9457,3,15,7,8,79,50,29,52
Copenhagen,9457,4,14,4,12,58,49,9,46
AaB,9457,5,9,12,9,40,41,-1,39
AC Horsens,9457,6,6,13,11,36,55,-19,31
Sonderjyske,9457,7,8,6,10,28,29,-1,30
Randers FC,9457,8,5,7,12,25,41,-16,22
Silkeborg IF,9457,9,6,3,13,28,46,-18,21
Lyngby,9457,10,3,10,11,28,46,-18,19
AGF Aarhus,9457,11,4,6,12,18,39,-21,18
Brondby,9458,1,20,6,4,72,37,35,66
FC Midtjylla,9458,2,20,5,5,66,38,28,65
FC Nords,9458,3,14,7,9,74,50,24,49
Copenhagen,9458,4,14,4,12,58,47,11,46
AaB,9458,5,9,11,10,40,39,1,38
AC Horsens,9458,6,6,13,11,34,59,-25,31
Sonderjyske,9458,7,8,6,10,28,29,-1,30
Lyngby,9458,8,4,9,11,27,44,-17,21
Randers FC,9458,9,5,6,13,23,40,-17,21
AGF Aarhus,9458,10,5,6,11,19,37,-18,21
Silkeborg IF,9458,11,5,3,14,26,47,-21,18
Brondby,9459,1,20,5,5,70,39,31,65
FC Midtjylla,9459,2,18,4,8,63,47,16,58
FC Nords,9459,3,16,6,8,86,51,35,54
Copenhagen,9459,4,13,5,12,56,47,9,44
AC Horsens,9459,5,9,13,8,39,50,-11,40
AaB,9459,6,7,13,10,40,46,-6,34
Sonderjyske,9459,7,8,6,10,28,29,-1,30
Randers FC,9459,8,5,7,12,24,40,-16,22
Lyngby,9459,9,3,10,11,27,45,-18,19
Silkeborg IF,9459,10,5,4,13,25,44,-19,19
AGF Aarhus,9459,11,4,7,11,16,36,-20,19
FC Midtjylla,9460,1,21,5,4,76,38,38,68
Brondby,9460,2,19,7,4,70,36,34,64
Copenhagen,9460,3,14,6,10,56,44,12,48
FC Nords,9460,4,13,7,10,74,56,18,46
AaB,9460,5,7,13,10,36,42,-6,34
AC Horsens,9460,6,6,14,10,34,56,-22,32
Sonderjyske,9460,7,8,6,10,28,29,-1,30
Randers FC,9460,8,6,6,12,25,39,-14,24
Silkeborg IF,9460,9,5,4,13,26,45,-19,19
AGF Aarhus,9460,10,4,7,11,17,37,-20,19
Lyngby,9460,11,3,9,12,26,46,-20,18
Brondby,9461,1,20,7,3,68,30,38,67
FC Midtjylla,9461,2,19,5,6,64,42,22,62
FC Nords,9461,3,16,6,8,75,49,26,54
Copenhagen,9461,4,13,6,11,52,41,11,45
AC Horsens,9461,5,7,13,10,37,50,-13,34
AaB,9461,6,7,11,12,34,44,-10,32
Sonderjyske,9461,7,8,6,10,28,29,-1,30
Lyngby,9461,8,4,9,11,29,45,-16,21
Silkeborg IF,9461,9,6,3,13,28,44,-16,21
Randers FC,9461,10,5,6,13,24,42,-18,21
AGF Aarhus,9461,11,4,6,12,16,39,-23,18
Brondby,9462,1,22,6,2,73,30,43,72
FC Midtjylla,9462,2,19,6,5,65,38,27,63
Copenhagen,9462,3,13,5,12,55,45,10,44
FC Nords,9462,4,12,7,11,68,55,13,43
AaB,9462,5,8,12,10,37,40,-3,36
AC Horsens,9462,6,8,12,10,36,52,-16,36
Sonderjyske,9462,7,8,6,10,28,29,-1,30
Randers FC,9462,8,5,7,12,25,41,-16,22
AGF Aarhus,9462,9,5,6,11,19,37,-18,21
Lyngby,9462,10,3,10,11,28,46,-18,19
Silkeborg IF,9462,11,5,3,14,26,47,-21,18
FC Midtjylla,9463,1,21,5,4,69,36,33,68
Brondby,9463,2,20,7,3,69,33,36,67
FC Nords,9463,3,14,7,9,79,56,23,49
Copenhagen,9463,4,13,5,12,56,44,12,44
AaB,9463,5,7,13,10,37,45,-8,34
Sonderjyske,9463,6,8,6,10,28,29,-1,30
AC Horsens,9463,7,5,15,10,33,55,-22,30
Lyngby,9463,8,4,9,11,29,44,-15,21
Randers FC,9463,9,5,6,13,23,42,-19,21
AGF Aarhus,9463,10,5,6,11,17,36,-19,21
Silkeborg IF,9463,11,5,3,14,25,45,-20,18
Brondby,9464,1,20,5,5,74,37,37,65
FC Midtjylla,9464,2,19,5,6,67,42,25,62
FC Nords,9464,3,16,6,8,76,48,28,54
Copenhagen,9464,4,15,4,11,57,44,13,49
AC Horsens,9464,5,7,14,9,38,54,-16,35
Sonderjyske,9464,6,8,6,10,28,29,-1,30
AaB,9464,7,6,12,12,36,49,-13,30
Randers FC,9464,8,6,6,12,25,40,-15,24
Silkeborg IF,9464,9,5,4,13,26,45,-19,19
AGF Aarhus,9464,10,4,7,11,17,37,-20,19
Lyngby,9464,11,3,9,12,27,46,-19,18
Brondby,9465,1,19,7,4,67,35,32,64
FC Midtjylla,9465,2,18,7,5,64,38,26,61
FC Nords,9465,3,14,7,9,73,55,18,49
Copenhagen,9465,4,14,6,10,60,43,17,48
AC Horsens,9465,5,7,14,9,33,48,-15,35
AaB,9465,6,7,13,10,37,41,-4,34
Sonderjyske,9465,7,8,6,10,28,29,-1,30
Randers FC,9465,8,6,6,12,25,40,-15,24
Silkeborg IF,9465,9,5,4,13,27,46,-19,19
AGF Aarhus,9465,10,4,7,11,18,38,-20,19
Lyngby,9465,11,3,9,12,27,46,-19,18
Brondby,9466,1,22,5,3,77,32,45,71
FC Midtjylla,9466,2,18,5,7,60,42,18,59
Copenhagen,9466,3,16,4,10,63,42,21,52
FC Nords,9466,4,15,6,9,74,53,21,51
AC Horsens,9466,5,7,12,11,37,55,-18,33
Sonderjyske,9466,6,8,6,10,28,29,-1,30
AaB,9466,7,6,12,12,36,49,-13,30
Randers FC,9466,8,6,6,12,24,39,-15,24
Silkeborg IF,9466,9,6,3,13,28,46,-18,21
Lyngby,9466,10,3,9,12,26,45,-19,18
AGF Aarhus,9466,11,4,6,12,18,39,-21,18
Brondby,9467,1,21,7,2,74,33,41,70
FC Midtjylla,9467,2,18,6,6,61,42,19,60
FC Nords,9467,3,14,8,8,75,52,23,50
Copenhagen,9467,4,13,5,12,57,44,13,44
AC Horsens,9467,5,6,16,8,37,50,-13,34
AaB,9467,6,7,12,11,34,43,-9,33
Sonderjyske,9467,7,8,6,10,28,29,-1,30
Randers FC,9467,8,6,6,12,25,40,-15,24
Silkeborg IF,9467,9,6,3,13,29,44,-15,21
Lyngby,9467,10,3,9,12,27,46,-19,18
AGF Aarhus,9467,11,4,6,12,16,40,-24,18
Brondby,9468,1,22,5,3,74,35,39,71
FC Midtjylla,9468,2,18,5,7,66,43,23,59
FC Nords,9468,3,14,8,8,78,54,24,50
Copenhagen,9468,4,13,6,11,58,49,9,45
AaB,9468,5,8,11,11,39,45,-6,35
AC Horsens,9468,6,7,13,10,37,52,-15,34
Sonderjyske,9468,7,8,6,10,28,29,-1,30
Randers FC,9468,8,6,6,12,26,39,-13,24
Silkeborg IF,9468,9,5,4,13,27,46,-19,19
AGF Aarhus,9468,10,4,7,11,18,38,-20,19
Lyngby,9468,11,3,9,12,26,47,-21,18
Brondby,9469,1,20,7,3,68,32,36,67
FC Midtjylla,9469,2,19,6,5,69,39,30,63
FC Nords,9469,3,15,7,8,77,52,25,52
Copenhagen,9469,4,13,6,11,54,43,11,45
AC Horsens,9469,5,8,12,10,39,56,-17,36
Sonderjyske,9469,6,8,6,10,28,29,-1,30
AaB,9469,7,6,12,12,35,46,-11,30
Lyngby,9469,8,4,9,11,28,44,-16,21
Silkeborg IF,9469,9,6,3,13,28,45,-17,21
Randers FC,9469,10,5,6,13,23,41,-18,21
AGF Aarhus,9469,11,4,6,12,17,39,-22,18
FC Midtjylla,9470,1,21,4,5,69,40,29,67
Brondby,9470,2,18,8,4,63,32,31,62
Copenhagen,9470,3,15,4,11,60,44,16,49
FC Nords,9470,4,13,8,9,75,55,20,47
AaB,9470,5,8,13,9,35,39,-4,37
AC Horsens,9470,6,6,13,11,36,54,-18,31
Sonderjyske,9470,7,8,6,10,28,29,-1,30
Lyngby,9470,8,4,9,11,28,44,-16,21
Randers FC,9470,9,5,6,13,23,41,-18,21
AGF Aarhus,9470,10,5,6,11,17,36,-19,21
Silkeborg IF,9470,11,5,3,14,25,45,-20,18
Brondby,9471,1,20,6,4,69,33,36,66
FC Midtjylla,9471,2,19,4,7,64,44,20,61
Copenhagen,9471,3,17,4,9,61,40,21,55
FC Nords,9471,4,13,6,11,72,55,17,45
AaB,9471,5,8,11,11,39,44,-5,35
AC Horsens,9471,6,7,13,10,39,54,-15,34
Sonderjyske,9471,7,8,6,10,28,29,-1,30
Randers FC,9471,8,6,6,12,25,39,-14,24
AGF Aarhus,9471,9,5,6,11,19,37,-18,21
Lyngby,9471,10,3,9,12,26,46,-20,18
Silkeborg IF,9471,11,5,3,14,26,47,-21,18
Brondby,9472,1,22,6,2,73,31,42,72
FC Midtjylla,9472,2,20,5,5,66,39,27,65
FC Nords,9472,3,13,8,9,66,47,19,47
Copenhagen,9472,4,13,5,12,55,45,10,44
AaB,9472,5,7,12,11,36,44,-8,33
AC Horsens,9472,6,7,12,11,33,49,-16,33
Sonderjyske,9472,7,8,6,10,28,29,-1,30
AGF Aarhus,9472,8,5,6,11,20,36,-16,21
Lyngby,9472,9,4,9,11,28,45,-17,21
Randers FC,9472,10,5,6,13,24,41,-17,21
Silkeborg IF,9472,11,5,3,14,25,48,-23,18
Brondby,9473,1,21,7,2,71,31,40,70
FC Midtjylla,9473,2,20,4,6,69,45,24,64
Copenhagen,9473,3,15,4,11,61,43,18,49
FC Nords,9473,4,13,7,10,70,53,17,46
AaB,9473,5,8,11,11,36,42,-6,35
AC Horsens,9473,6,6,13,11,34,53,-19,31
Sonderjyske,9473,7,8,6,10,28,29,-1,30
Randers FC,9473,8,5,7,12,24,40,-16,22
AGF Aarhus,9473,9,5,6,11,20,38,-18,21
Lyngby,9473,10,3,10,11,27,45,-18,19
Silkeborg IF,9473,11,5,3,14,27,48,-21,18
Brondby,9474,1,22,5,3,69,28,41,71
FC Midtjylla,9474,2,20,6,4,62,34,28,66
FC Nords,9474,3,13,7,10,68,53,15,46
Copenhagen,9474,4,13,5,12,54,44,10,44
AaB,9474,5,8,12,10,37,39,-2,36
AC Horsens,9474,6,6,13,11,32,50,-18,31
Sonderjyske,9474,7,8,6,10,28,29,-1,30
Lyngby,9474,8,4,9,11,28,44,-16,21
Randers FC,9474,9,5,6,13,23,41,-18,21
Silkeborg IF,9474,10,5,4,13,26,45,-19,19
AGF Aarhus,9474,11,4,7,11,17,37,-20,19
Brondby,9475,1,23,5,2,74,28,46,74
FC Midtjylla,9475,2,20,4,6,64,39,25,64
Copenhagen,9475,3,15,4,11,61,44,17,49
FC Nords,9475,4,13,6,11,71,56,15,45
AaB,9475,5,8,12,10,38,43,-5,36
Sonderjyske,9475,6,8,6,10,28,29,-1,30
AC Horsens,9475,7,5,13,12,32,56,-24,28
Randers FC,9475,8,6,6,12,25,40,-15,24
Silkeborg IF,9475,9,6,3,13,27,44,-17,21
Lyngby,9475,10,3,9,12,27,46,-19,18
AGF Aarhus,9475,11,4,6,12,16,38,-22,18
Brondby,9476,1,20,7,3,73,33,40,67
FC Midtjylla,9476,2,21,4,5,71,41,30,67
FC Nords,9476,3,14,6,10,73,58,15,48
Copenhagen,9476,4,13,5,12,58,45,13,44
AaB,9476,5,10,11,9,40,41,-1,41
Sonderjyske,9476,6,8,6,10,28,29,-1,30
AC Horsens,9476,7,5,13,12,35,58,-23,28
Lyngby,9476,8,4,9,11,28,45,-17,21
Randers FC,9476,9,5,6,13,24,41,-17,21
Silkeborg IF,9476,10,6,3,13,27,45,-18,21
AGF Aarhus,9476,11,4,6,12,17,38,-21,18
Brondby,9477,1,19,8,3,73,37,36,65
FC Midtjylla,9477,2,19,7,4,66,39,27,64
FC Nords,9477,3,14,7,9,71,50,21,49
Copenhagen,9477,4,13,8,9,60,46,14,47
AC Horsens,9477,5,6,15,9,37,52,-15,33
AaB,9477,6,6,13,11,39,48,-9,31
Sonderjyske,9477,7,8,6,10,28,29,-1,30
Lyngby,9477,8,4,9,11,29,44,-15,21
AGF Aarhus,9477,9,5,6,11,18,36,-18,21
Randers FC,9477,10,5,6,13,23,42,-19,21
Silkeborg IF,9477,11,5,3,14,25,46,-21,18
Brondby,9478,1,21,6,3,69,33,36,69
FC Midtjylla,9478,2,21,5,4,73,40,33,68
Copenhagen,9478,3,16,4,10,62,42,20,52
FC Nords,9478,4,13,7,10,76,57,19,46
AaB,9478,5,7,12,11,37,45,-8,33
Sonderjyske,9478,6,8,6,10,28,29,-1,30
AC Horsens,9478,7,5,12,13,36,62,-26,27
Randers FC,9478,8,5,7,12,24,40,-16,22
AGF Aarhus,9478,9,5,6,11,19,38,-19,21
Lyngby,9478,10,3,10,11,27,45,-18,19
Silkeborg IF,9478,11,5,3,14,27,47,-20,18
Brondby,9479,1,20,6,4,74,35,39,66
FC Midtjylla,9479,2,19,4,7,67,45,22,61
FC Nords,9479,3,15,6,9,73,54,19,51
Copenhagen,9479,4,15,6,9,60,41,19,51
AC Horsens,9479,5,7,13,10,37,50,-13,34
AaB,9479,6,7,11,12,35,47,-12,32
Sonderjyske,9479,7,8,6,10,28,29,-1,30
Randers FC,9479,8,6,6,12,26,39,-13,24
Silkeborg IF,9479,9,5,4,13,27,46,-19,19
AGF Aarhus,9479,10,4,7,11,18,38,-20,19
Lyngby,9479,11,3,9,12,26,47,-21,18
Brondby,9480,1,22,6,2,70,31,39,72
FC Midtjylla,9480,2,18,6,6,63,41,22,60
FC Nords,9480,3,13,8,9,76,52,24,47
Copenhagen,9480,4,14,5,11,56,44,12,47
AC Horsens,9480,5,7,14,9,37,46,-9,35
AaB,9480,6,6,13,11,35,49,-14,31
Sonderjyske,9480,7,8,6,10,28,29,-1,30
Randers FC,9480,8,6,6,12,25,39,-14,24
AGF Aarhus,9480,9,5,6,11,19,37,-18,21
Lyngby,9480,10,3,9,12,26,46,-20,18
Silkeborg IF,9480,11,5,3,14,26,47,-21,18
Brondby,9481,1,19,6,5,69,35,34,63
FC Midtjylla,9481,2,19,6,5,65,37,28,63
FC Nords,9481,3,17,6,7,80,45,35,57
Copenhagen,9481,4,13,6,11,57,45,12,45
AaB,9481,5,7,12,11,34,46,-12,33
AC Horsens,9481,6,7,12,11,37,60,-23,33
Sonderjyske,9481,7,8,6,10,28,29,-1,30
Lyngby,9481,8,4,9,11,29,44,-15,21
Silkeborg IF,9481,9,6,3,13,28,45,-17,21
Randers FC,9481,10,5,6,13,23,42,-19,21
AGF Aarhus,9481,11,4,6,12,17,39,-22,18
Brondby,9482,1,22,6,2,76,31,45,72
FC Midtjylla,9482,2,20,4,6,69,43,26,64
FC Nords,9482,3,14,6,10,69,54,15,48
Copenhagen,9482,4,14,5,11,58,44,14,47
AaB,9482,5,8,11,11,39,43,-4,35
Sonderjyske,9482,6,8,6,10,28,29,-1,30
AC Horsens,9482,7,6,12,12,35,57,-22,30
Randers FC,9482,8,6,6,12,24,39,-15,24
AGF Aarhus,9482,9,5,6,11,18,36,-18,21
Lyngby,9482,10,3,9,12,26,45,-19,18
Silkeborg IF,9482,11,5,3,14,25,46,-21,18
Brondby,9483,1,22,5,3,69,30,39,71
FC Midtjylla,9483,2,19,5,6,64,40,24,62
FC Nords,9483,3,14,6,10,77,55,22,48
Copenhagen,9483,4,14,5,11,60,49,11,47
AaB,9483,5,8,12,10,38,41,-3,36
AC Horsens,9483,6,6,13,11,37,56,-19,31
Sonderjyske,9483,7,8,6,10,28,29,-1,30
Randers FC,9483,8,6,6,12,24,39,-15,24
Silkeborg IF,9483,9,5,4,13,27,46,-19,19
AGF Aarhus,9483,10,4,7,11,18,38,-20,19
Lyngby,9483,11,3,9,12,26,45,-19,18
Brondby,9484,1,20,7,3,71,36,35,67
FC Midtjylla,9484,2,18,6,6,64,41,23,60
FC Nords,9484,3,15,7,8,77,51,26,52
Copenhagen,9484,4,13,4,13,55,47,8,43
AaB,9484,5,8,13,9,38,41,-3,37
AC Horsens,9484,6,7,13,10,40,55,-15,34
Sonderjyske,9484,7,8,6,10,28,29,-1,30
Randers FC,9484,8,6,6,12,24,39,-15,24
Silkeborg IF,9484,9,5,4,13,26,45,-19,19
AGF Aarhus,9484,10,4,7,11,17,37,-20,19
Lyngby,9484,11,3,9,12,26,45,-19,18
FC Midtjylla,9485,1,19,6,5,64,40,24,63
Brondby,9485,2,18,7,5,67,38,29,61
FC Nords,9485,3,14,8,8,76,53,23,50
Copenhagen,9485,4,14,5,11,59,42,17,47
AaB,9485,5,9,11,10,39,43,-4,38
AC Horsens,9485,6,6,15,9,33,48,-15,33
Sonderjyske,9485,7,8,6,10,28,29,-1,30
Randers FC,9485,8,6,6,12,27,42,-15,24
Silkeborg IF,9485,9,6,3,13,27,44,-17,21
Lyngby,9485,10,3,9,12,29,48,-19,18
AGF Aarhus,9485,11,4,6,12,16,38,-22,18
Brondby,9486,1,21,5,4,72,32,40,68
FC Midtjylla,9486,2,19,5,6,64,41,23,62
FC Nords,9486,3,14,7,9,79,56,23,49
Copenhagen,9486,4,13,5,12,58,50,8,44
AaB,9486,5,8,12,10,39,45,-6,36
AC Horsens,9486,6,7,14,9,36,50,-14,35
Sonderjyske,9486,7,8,6,10,28,29,-1,30
Lyngby,9486,8,4,9,11,29,44,-15,21
Randers FC,9486,9,5,6,13,23,42,-19,21
Silkeborg IF,9486,10,5,4,13,26,45,-19,19
AGF Aarhus,9486,11,4,7,11,17,37,-20,19
FC Midtjylla,9487,1,21,4,5,73,38,35,67
Brondby,9487,2,20,5,5,71,35,36,65
FC Nords,9487,3,15,7,8,73,51,22,52
Copenhagen,9487,4,15,4,11,56,46,10,49
AC Horsens,9487,5,7,12,11,37,55,-18,33
Sonderjyske,9487,6,8,6,10,28,29,-1,30
AaB,9487,7,6,12,12,37,48,-11,30
Randers FC,9487,8,5,7,12,25,41,-16,22
Silkeborg IF,9487,9,6,3,13,27,44,-17,21
Lyngby,9487,10,3,10,11,28,46,-18,19
AGF Aarhus,9487,11,4,6,12,16,38,-22,18
Brondby,9488,1,20,7,3,72,33,39,67
FC Midtjylla,9488,2,20,4,6,69,42,27,64
Copenhagen,9488,3,15,5,10,60,43,17,50
FC Nords,9488,4,14,7,9,74,50,24,49
AC Horsens,9488,5,7,12,11,37,55,-18,33
AaB,9488,6,7,11,12,36,51,-15,32
Sonderjyske,9488,7,8,6,10,28,29,-1,30
Randers FC,9488,8,5,7,12,24,40,-16,22
Lyngby,9488,9,3,10,11,27,45,-18,19
Silkeborg IF,9488,10,5,4,13,26,45,-19,19
AGF Aarhus,9488,11,4,7,11,17,37,-20,19
Brondby,9489,1,22,6,2,75,32,43,72
FC Midtjylla,9489,2,19,5,6,71,46,25,62
FC Nords,9489,3,13,7,10,77,57,20,46
Copenhagen,9489,4,14,4,12,61,54,7,46
AaB,9489,5,8,12,10,38,42,-4,36
AC Horsens,9489,6,6,14,10,37,54,-17,32
Sonderjyske,9489,7,8,6,10,28,29,-1,30
Lyngby,9489,8,4,9,11,28,44,-16,21
Randers FC,9489,9,5,6,13,23,41,-18,21
Silkeborg IF,9489,10,5,4,13,26,45,-19,19
AGF Aarhus,9489,11,4,7,11,17,37,-20,19
FC Midtjylla,9490,1,21,4,5,67,39,28,67
Brondby,9490,2,19,7,4,66,33,33,64
FC Nords,9490,3,14,8,8,72,49,23,50
Copenhagen,9490,4,15,4,11,61,45,16,49
AC Horsens,9490,5,6,14,10,31,47,-16,32
AaB,9490,6,6,13,11,32,42,-10,31
Sonderjyske,9490,7,8,6,10,28,29,-1,30
Randers FC,9490,8,6,6,12,25,39,-14,24
Silkeborg IF,9490,9,6,3,13,28,44,-16,21
Lyngby,9490,10,3,9,12,26,46,-20,18
AGF Aarhus,9490,11,4,6,12,16,39,-23,18
Brondby,9491,1,20,7,3,75,38,37,67
FC Midtjylla,9491,2,19,6,5,73,41,32,63
Copenhagen,9491,3,15,6,9,65,47,18,51
FC Nords,9491,4,13,7,10,72,54,18,46
AaB,9491,5,7,13,10,36,46,-10,34
AC Horsens,9491,6,6,13,11,36,57,-21,31
Sonderjyske,9491,7,8,6,10,28,29,-1,30
Randers FC,9491,8,6,6,12,25,40,-15,24
Silkeborg IF,9491,9,6,3,13,27,45,-18,21
Lyngby,9491,10,3,9,12,27,46,-19,18
AGF Aarhus,9491,11,4,6,12,17,38,-21,18
Brondby,9492,1,20,5,5,71,37,34,65
FC Midtjylla,9492,2,19,6,5,66,41,25,63
FC Nords,9492,3,16,7,7,76,47,29,55
Copenhagen,9492,4,13,4,13,52,43,9,43
AaB,9492,5,7,13,10,38,45,-7,34
AC Horsens,9492,6,7,13,10,37,53,-16,34
Sonderjyske,9492,7,8,6,10,28,29,-1,30
Lyngby,9492,8,4,9,11,27,44,-17,21
Randers FC,9492,9,5,6,13,23,40,-17,21
Silkeborg IF,9492,10,5,4,13,26,45,-19,19
AGF Aarhus,9492,11,4,7,11,17,37,-20,19
Brondby,9493,1,21,7,2,70,31,39,70
FC Midtjylla,9493,2,19,6,5,64,36,28,63
FC Nords,9493,3,14,8,8,72,48,24,50
Copenhagen,9493,4,13,7,10,58,45,13,46
AaB,9493,5,7,12,11,36,43,-7,33
Sonderjyske,9493,6,8,6,10,28,29,-1,30
AC Horsens,9493,7,6,12,12,33,56,-23,30
Randers FC,9493,8,6,6,12,26,40,-14,24
Silkeborg IF,9493,9,6,3,13,28,46,-18,21
Lyngby,9493,10,3,9,12,27,47,-20,18
AGF Aarhus,9493,11,4,6,12,18,39,-21,18
Brondby,9494,1,22,6,2,74,33,41,72
FC Midtjylla,9494,2,20,4,6,68,39,29,64
FC Nords,9494,3,16,6,8,77,52,25,54
Copenhagen,9494,4,13,4,13,55,46,9,43
AaB,9494,5,8,12,10,35,43,-8,36
Sonderjyske,9494,6,8,6,10,28,29,-1,30
AC Horsens,9494,7,5,12,13,33,55,-22,27
Randers FC,9494,8,5,7,12,24,40,-16,22
Lyngby,9494,9,3,10,11,27,45,-18,19
Silkeborg IF,9494,10,5,4,13,26,45,-19,19
AGF Aarhus,9494,11,4,7,11,17,37,-20,19
Brondby,9495,1,20,8,2,71,32,39,68
FC Midtjylla,9495,2,17,7,6,62,40,22,58
FC Nords,9495,3,13,9,8,70,49,21,48
Copenhagen,9495,4,13,6,11,56,46,10,45
AaB,9495,5,10,12,8,37,36,1,42
Sonderjyske,9495,6,8,6,10,28,29,-1,30
AC Horsens,9495,7,5,14,11,34,53,-19,29
Randers FC,9495,8,5,7,12,25,41,-16,22
AGF Aarhus,9495,9,5,6,11,18,37,-19,21
Lyngby,9495,10,3,10,11,28,46,-18,19
Silkeborg IF,9495,11,5,3,14,26,46,-20,18
Brondby,9496,1,20,6,4,70,33,37,66
FC Midtjylla,9496,2,19,4,7,65,46,19,61
FC Nords,9496,3,14,7,9,71,48,23,49
Copenhagen,9496,4,14,6,10,58,42,16,48
AaB,9496,5,10,11,9,38,39,-1,41
Sonderjyske,9496,6,8,6,10,28,29,-1,30
AC Horsens,9496,7,6,12,12,34,54,-20,30
Randers FC,9496,8,6,6,12,25,39,-14,24
Silkeborg IF,9496,9,6,3,13,27,44,-17,21
Lyngby,9496,10,3,9,12,26,46,-20,18
AGF Aarhus,9496,11,4,6,12,16,38,-22,18
Brondby,9497,1,21,5,4,68,31,37,68
FC Midtjylla,9497,2,21,4,5,63,34,29,67
Copenhagen,9497,3,14,5,11,59,46,13,47
FC Nords,9497,4,13,7,10,71,53,18,46
AC Horsens,9497,5,7,13,10,35,51,-16,34
AaB,9497,6,7,12,11,39,46,-7,33
Sonderjyske,9497,7,8,6,10,28,29,-1,30
Randers FC,9497,8,6,6,12,24,39,-15,24
Silkeborg IF,9497,9,6,3,13,26,44,-18,21
Lyngby,9497,10,3,9,12,26,45,-19,18
AGF Aarhus,9497,11,4,6,12,16,37,-21,18
Brondby,9498,1,21,6,3,72,32,40,69
FC Midtjylla,9498,2,19,4,7,67,44,23,61
Copenhagen,9498,3,15,5,10,58,41,17,50
FC Nords,9498,4,14,6,10,72,54,18,48
AaB,9498,5,7,13,10,39,45,-6,34
AC Horsens,9498,6,7,12,11,35,53,-18,33
Sonderjyske,9498,7,8,6,10,28,29,-1,30
Randers FC,9498,8,5,7,12,24,40,-16,22
Silkeborg IF,9498,9,6,3,13,28,46,-18,21
Lyngby,9498,10,3,10,11,27,45,-18,19
AGF Aarhus,9498,11,4,6,12,18,39,-21,18
Brondby,9499,1,23,5,2,77,27,50,74
FC Midtjylla,9499,2,18,5,7,61,41,20,59
FC Nords,9499,3,14,8,8,75,52,23,50
Copenhagen,9499,4,14,5,11,57,47,10,47
AC Horsens,9499,5,7,12,11,32,51,-19,33
AaB,9499,6,6,13,11,36,46,-10,31
Sonderjyske,9499,7,8,6,10,28,29,-1,30
Randers FC,9499,8,6,6,12,25,40,-15,24
Silkeborg IF,9499,9,6,3,13,28,45,-17,21
Lyngby,9499,10,3,9,12,27,46,-19,18
AGF Aarhus,9499,11,4,6,12,17,39,-22,18
FC Midtjylla,9500,1,21,4,5,65,38,27,67
Brondby,9500,2,20,6,4,70,34,36,66
Copenhagen,9500,3,15,4,11,59,44,15,49
FC Nords,9500,4,13,6,11,74,57,17,45
AC Horsens,9500,5,8,12,10,37,52,-15,36
AaB,9500,6,7,12,11,39,45,-6,33
Sonderjyske,9500,7,8,6,10,28,29,-1,30
Lyngby,9500,8,4,9,11,28,44,-16,21
Silkeborg IF,9500,9,6,3,13,29,47,-18,21
Randers FC,9500,10,5,6,13,23,41,-18,21
AGF Aarhus,9500,11,4,6,12,19,40,-21,18
Brondby,9501,1,21,5,4,72,36,36,68
FC Midtjylla,9501,2,18,6,6,65,42,23,60
FC Nords,9501,3,15,7,8,73,49,24,52
Copenhagen,9501,4,15,4,11,56,44,12,49
AaB,9501,5,9,12,9,38,37,1,39
Sonderjyske,9501,6,8,6,10,28,29,-1,30
AC Horsens,9501,7,5,12,13,33,55,-22,27
Lyngby,9501,8,4,9,11,29,45,-16,21
Randers FC,9501,9,5,6,13,24,42,-18,21
Silkeborg IF,9501,10,5,4,13,25,44,-19,19
AGF Aarhus,9501,11,4,7,11,16,36,-20,19
Brondby,9502,1,22,6,2,70,27,43,72
FC Midtjylla,9502,2,19,6,5,65,38,27,63
FC Nords,9502,3,13,8,9,70,53,17,47
Copenhagen,9502,4,12,7,11,52,43,9,43
AaB,9502,5,7,13,10,36,42,-6,34
AC Horsens,9502,6,6,14,10,34,50,-16,32
Sonderjyske,9502,7,8,6,10,28,29,-1,30
Randers FC,9502,8,5,7,12,25,41,-16,22
AGF Aarhus,9502,9,5,6,11,18,37,-19,21
Lyngby,9502,10,3,10,11,28,46,-18,19
Silkeborg IF,9502,11,5,3,14,26,46,-20,18
Brondby,9503,1,20,7,3,73,34,39,67
FC Midtjylla,9503,2,20,5,5,68,37,31,65
FC Nords,9503,3,13,8,9,76,58,18,47
Copenhagen,9503,4,12,5,13,56,54,2,41
AC Horsens,9503,5,8,13,9,41,51,-10,37
AaB,9503,6,7,14,9,36,42,-6,35
Sonderjyske,9503,7,8,6,10,28,29,-1,30
Lyngby,9503,8,4,9,11,27,44,-17,21
Randers FC,9503,9,5,6,13,23,40,-17,21
Silkeborg IF,9503,10,6,3,13,29,47,-18,21
AGF Aarhus,9503,11,4,6,12,19,40,-21,18
Brondby,9504,1,20,5,5,73,39,34,65
FC Midtjylla,9504,2,20,5,5,69,41,28,65
FC Nords,9504,3,15,6,9,76,53,23,51
Copenhagen,9504,4,14,4,12,60,52,8,46
AaB,9504,5,9,12,9,40,41,-1,39
Sonderjyske,9504,6,8,6,10,28,29,-1,30
AC Horsens,9504,7,6,12,12,34,52,-18,30
Randers FC,9504,8,5,7,12,23,39,-16,22
AGF Aarhus,9504,9,5,6,11,19,37,-18,21
Lyngby,9504,10,3,10,11,26,44,-18,19
Silkeborg IF,9504,11,5,3,14,26,47,-21,18
Brondby,9505,1,21,5,4,73,32,41,68
FC Midtjylla,9505,2,18,5,7,63,46,17,59
FC Nords,9505,3,15,7,8,75,51,24,52
Copenhagen,9505,4,13,5,12,58,47,11,44
AC Horsens,9505,5,8,13,9,43,51,-8,37
AaB,9505,6,7,13,10,36,47,-11,34
Sonderjyske,9505,7,8,6,10,28,29,-1,30
Randers FC,9505,8,6,6,12,24,39,-15,24
AGF Aarhus,9505,9,5,6,11,17,36,-19,21
Lyngby,9505,10,3,9,12,26,45,-19,18
Silkeborg IF,9505,11,5,3,14,25,45,-20,18
Brondby,9506,1,21,6,3,72,35,37,69
FC Midtjylla,9506,2,20,4,6,70,42,28,64
Copenhagen,9506,3,17,4,9,64,43,21,55
FC Nords,9506,4,14,6,10,78,52,26,48
Sonderjyske,9506,5,8,6,10,28,29,-1,30
AaB,9506,6,6,12,12,39,57,-18,30
AC Horsens,9506,7,5,14,11,33,53,-20,29
Randers FC,9506,8,6,6,12,25,40,-15,24
Silkeborg IF,9506,9,6,3,13,27,44,-17,21
Lyngby,9506,10,3,9,12,27,46,-19,18
AGF Aarhus,9506,11,4,6,12,16,38,-22,18
Brondby,9507,1,22,5,3,76,28,48,71
FC Midtjylla,9507,2,19,5,6,65,42,23,62
Copenhagen,9507,3,14,5,11,56,46,10,47
FC Nords,9507,4,13,7,10,71,57,14,46
AaB,9507,5,8,11,11,37,43,-6,35
AC Horsens,9507,6,7,13,10,37,52,-15,34
Sonderjyske,9507,7,8,6,10,28,29,-1,30
Randers FC,9507,8,5,7,12,24,40,-16,22
Lyngby,9507,9,3,10,11,27,45,-18,19
Silkeborg IF,9507,10,5,4,13,26,45,-19,19
AGF Aarhus,9507,11,4,7,11,17,37,-20,19
Brondby,9508,1,20,7,3,70,30,40,67
FC Midtjylla,9508,2,20,6,4,67,38,29,66
FC Nords,9508,3,14,6,10,76,59,17,48
Copenhagen,9508,4,14,6,10,61,48,13,48
AaB,9508,5,7,11,12,41,48,-7,32
AC Horsens,9508,6,6,14,10,38,56,-18,32
Sonderjyske,9508,7,8,6,10,28,29,-1,30
Randers FC,9508,8,6,6,12,24,39,-15,24
Silkeborg IF,9508,9,6,3,13,26,44,-18,21
Lyngby,9508,10,3,9,12,26,45,-19,18
AGF Aarhus,9508,11,4,6,12,16,37,-21,18
Brondby,9509,1,21,6,3,75,35,40,69
FC Midtjylla,9509,2,20,5,5,70,40,30,65
FC Nords,9509,3,15,6,9,72,55,17,51
Copenhagen,9509,4,13,5,12,58,46,12,44
AaB,9509,5,7,12,11,37,44,-7,33
AC Horsens,9509,6,6,14,10,36,54,-18,32
Sonderjyske,9509,7,8,6,10,28,29,-1,30
Lyngby,9509,8,4,9,11,28,44,-16,21
Randers FC,9509,9,5,6,13,23,41,-18,21
AGF Aarhus,9509,10,5,6,11,17,36,-19,21
Silkeborg IF,9509,11,5,3,14,25,45,-20,18
Brondby,9510,1,20,6,4,67,33,34,66
FC Midtjylla,9510,2,17,8,5,60,38,22,59
Copenhagen,9510,3,16,5,9,62,43,19,53
FC Nords,9510,4,13,9,8,73,50,23,48
AaB,9510,5,8,13,9,36,38,-2,37
Sonderjyske,9510,6,8,6,10,28,29,-1,30
AC Horsens,9510,7,5,13,12,36,58,-22,28
Randers FC,9510,8,6,6,12,25,40,-15,24
Silkeborg IF,9510,9,5,4,13,25,44,-19,19
AGF Aarhus,9510,10,4,7,11,16,36,-20,19
Lyngby,9510,11,3,9,12,27,46,-19,18
FC Midtjylla,9511,1,20,6,4,69,39,30,66
Brondby,9511,2,19,7,4,67,34,33,64
Copenhagen,9511,3,14,6,10,57,42,15,48
FC Nords,9511,4,13,7,10,67,49,18,46
AaB,9511,5,9,11,10,40,45,-5,38
Sonderjyske,9511,6,8,6,10,28,29,-1,30
AC Horsens,9511,7,5,15,10,37,54,-17,30
Randers FC,9511,8,5,7,12,23,39,-16,22
Silkeborg IF,9511,9,6,3,13,29,46,-17,21
Lyngby,9511,10,3,10,11,26,44,-18,19
AGF Aarhus,9511,11,4,6,12,18,40,-22,18
Brondby,9512,1,20,6,4,70,32,38,66
FC Midtjylla,9512,2,20,6,4,67,36,31,66
FC Nords,9512,3,14,7,9,70,51,19,49
Copenhagen,9512,4,13,4,13,55,50,5,43
AaB,9512,5,8,13,9,38,40,-2,37
AC Horsens,9512,6,7,12,11,34,51,-17,33
Sonderjyske,9512,7,8,6,10,28,29,-1,30
Lyngby,9512,8,4,9,11,27,44,-17,21
Randers FC,9512,9,5,6,13,23,40,-17,21
Silkeborg IF,9512,10,6,3,13,27,45,-18,21
AGF Aarhus,9512,11,4,6,12,17,38,-21,18
Brondby,9513,1,20,7,3,70,31,39,67
FC Midtjylla,9513,2,20,6,4,70,37,33,66
FC Nords,9513,3,15,6,9,69,50,19,51
Copenhagen,9513,4,13,6,11,58,48,10,45
AaB,9513,5,8,11,11,41,47,-6,35
Sonderjyske,9513,6,8,6,10,28,29,-1,30
AC Horsens,9513,7,6,12,12,33,54,-21,30
Randers FC,9513,8,5,7,12,25,41,-16,22
AGF Aarhus,9513,9,5,6,11,18,37,-19,21
Lyngby,9513,10,3,10,11,28,46,-18,19
Silkeborg IF,9513,11,5,3,14,26,46,-20,18
Brondby,9514,1,21,6,3,68,30,38,69
FC Midtjylla,9514,2,19,6,5,62,39,23,63
FC Nords,9514,3,14,7,9,71,50,21,49
Copenhagen,9514,4,14,5,11,57,41,16,47
AaB,9514,5,8,12,10,38,43,-5,36
Sonderjyske,9514,6,8,6,10,28,29,-1,30
AC Horsens,9514,7,5,14,11,34,53,-19,29
Randers FC,9514,8,6,6,12,24,39,-15,24
Silkeborg IF,9514,9,6,3,13,29,46,-17,21
Lyngby,9514,10,3,9,12,26,45,-19,18
AGF Aarhus,9514,11,4,6,12,18,40,-22,18
Brondby,9515,1,22,6,2,75,31,44,72
FC Midtjylla,9515,2,20,4,6,64,40,24,64
FC Nords,9515,3,13,8,9,70,50,20,47
Copenhagen,9515,4,14,4,12,57,47,10,46
AC Horsens,9515,5,7,13,10,35,49,-14,34
AaB,9515,6,7,11,12,34,44,-10,32
Sonderjyske,9515,7,8,6,10,28,29,-1,30
Randers FC,9515,8,6,6,12,26,39,-13,24
Silkeborg IF,9515,9,6,3,13,30,46,-16,21
Lyngby,9515,10,3,9,12,26,47,-21,18
AGF Aarhus,9515,11,4,6,12,18,41,-23,18
FC Midtjylla,9516,1,21,4,5,66,37,29,67
Brondby,9516,2,20,6,4,69,33,36,66
FC Nords,9516,3,15,6,9,70,48,22,51
Copenhagen,9516,4,15,4,11,60,44,16,49
AaB,9516,5,7,12,11,34,41,-7,33
Sonderjyske,9516,6,8,6,10,28,29,-1,30
AC Horsens,9516,7,5,14,11,31,53,-22,29
Randers FC,9516,8,6,6,12,24,39,-15,24
Silkeborg IF,9516,9,5,4,13,27,46,-19,19
AGF Aarhus,9516,10,4,7,11,18,38,-20,19
Lyngby,9516,11,3,9,12,26,45,-19,18
Brondby,9517,1,21,5,4,72,36,36,68
FC Midtjylla,9517,2,21,4,5,70,39,31,67
Copenhagen,9517,3,15,5,10,57,44,13,50
FC Nords,9517,4,14,6,10,75,55,20,48
AaB,9517,5,7,11,12,39,47,-8,32
AC Horsens,9517,6,6,13,11,34,52,-18,31
Sonderjyske,9517,7,8,6,10,28,29,-1,30
Randers FC,9517,8,5,7,12,24,40,-16,22
Silkeborg IF,9517,9,6,3,13,27,44,-17,21
Lyngby,9517,10,3,10,11,27,45,-18,19
AGF Aarhus,9517,11,4,6,12,16,38,-22,18
Brondby,9518,1,19,8,3,64,29,35,65
FC Midtjylla,9518,2,20,4,6,64,38,26,64
FC Nords,9518,3,14,7,9,68,49,19,49
Copenhagen,9518,4,13,7,10,55,42,13,46
AaB,9518,5,8,13,9,37,39,-2,37
AC Horsens,9518,6,6,13,11,32,49,-17,31
Sonderjyske,9518,7,8,6,10,28,29,-1,30
Randers FC,9518,8,6,6,12,25,39,-14,24
Silkeborg IF,9518,9,5,4,13,25,44,-19,19
AGF Aarhus,9518,10,4,7,11,16,36,-20,19
Lyngby,9518,11,3,9,12,26,46,-20,18
FC Midtjylla,9519,1,20,5,5,70,44,26,65
Brondby,9519,2,19,7,4,72,37,35,64
Copenhagen,9519,3,15,4,11,62,43,19,49
FC Nords,9519,4,12,8,10,72,58,14,44
AC Horsens,9519,5,7,15,8,42,51,-9,36
AaB,9519,6,8,11,11,38,49,-11,35
Sonderjyske,9519,7,8,6,10,28,29,-1,30
Randers FC,9519,8,5,7,12,24,40,-16,22
Silkeborg IF,9519,9,6,3,13,31,44,-13,21
Lyngby,9519,10,3,10,11,27,45,-18,19
AGF Aarhus,9519,11,4,6,12,16,42,-26,18
Brondby,9520,1,20,5,5,72,36,36,65
FC Midtjylla,9520,2,19,5,6,64,43,21,62
FC Nords,9520,3,16,7,7,77,48,29,55
Copenhagen,9520,4,13,4,13,58,50,8,43
AaB,9520,5,9,11,10,37,40,-3,38
AC Horsens,9520,6,7,12,11,37,54,-17,33
Sonderjyske,9520,7,8,6,10,28,29,-1,30
Lyngby,9520,8,4,9,11,27,44,-17,21
Randers FC,9520,9,5,6,13,23,40,-17,21
Silkeborg IF,9520,10,6,3,13,26,44,-18,21
AGF Aarhus,9520,11,4,6,12,16,37,-21,18
Brondby,9521,1,21,5,4,70,31,39,68
FC Midtjylla,9521,2,18,5,7,63,39,24,59
Copenhagen,9521,3,16,4,10,59,43,16,52
FC Nords,9521,4,15,6,9,73,47,26,51
AaB,9521,5,8,12,10,35,44,-9,36
Sonderjyske,9521,6,8,6,10,28,29,-1,30
AC Horsens,9521,7,6,12,12,31,53,-22,30
Lyngby,9521,8,4,9,11,31,44,-13,21
Silkeborg IF,9521,9,6,3,13,30,45,-15,21
Randers FC,9521,10,5,6,13,23,44,-21,21
AGF Aarhus,9521,11,4,6,12,17,41,-24,18
Brondby,9522,1,21,6,3,74,35,39,69
FC Midtjylla,9522,2,18,6,6,63,42,21,60
Copenhagen,9522,3,16,4,10,65,46,19,52
FC Nords,9522,4,13,7,10,71,57,14,46
AC Horsens,9522,5,8,13,9,44,52,-8,37
Sonderjyske,9522,6,8,6,10,28,29,-1,30
AaB,9522,7,6,12,12,34,45,-11,30
Lyngby,9522,8,4,9,11,30,46,-16,21
Randers FC,9522,9,5,6,13,25,43,-18,21
Silkeborg IF,9522,10,5,4,13,27,46,-19,19
AGF Aarhus,9522,11,4,7,11,18,38,-20,19
FC Midtjylla,9523,1,20,4,6,64,38,26,64
Brondby,9523,2,18,8,4,68,36,32,62
FC Nords,9523,3,14,8,8,77,53,24,50
Copenhagen,9523,4,13,7,10,58,44,14,46
AC Horsens,9523,5,8,13,9,37,53,-16,37
AaB,9523,6,7,12,11,36,42,-6,33
Sonderjyske,9523,7,8,6,10,28,29,-1,30
Randers FC,9523,8,6,6,12,24,39,-15,24
Silkeborg IF,9523,9,6,3,13,27,45,-18,21
Lyngby,9523,10,3,9,12,26,45,-19,18
AGF Aarhus,9523,11,4,6,12,17,38,-21,18
Brondby,9524,1,20,8,2,70,31,39,68
FC Midtjylla,9524,2,19,6,5,69,43,26,63
FC Nords,9524,3,13,8,9,74,50,24,47
Copenhagen,9524,4,13,8,9,55,41,14,47
AaB,9524,5,7,13,10,36,43,-7,34
AC Horsens,9524,6,6,13,11,32,54,-22,31
Sonderjyske,9524,7,8,6,10,28,29,-1,30
Randers FC,9524,8,5,7,12,24,40,-16,22
Lyngby,9524,9,3,10,11,27,45,-18,19
Silkeborg IF,9524,10,5,4,13,27,46,-19,19
AGF Aarhus,9524,11,4,7,11,18,38,-20,19
Brondby,9525,1,22,5,3,72,29,43,71
FC Midtjylla,9525,2,20,4,6,63,37,26,64
FC Nords,9525,3,14,6,10,67,50,17,48
Copenhagen,9525,4,13,4,13,56,50,6,43
AaB,9525,5,9,11,10,41,41,0,38
AC Horsens,9525,6,7,12,11,36,54,-18,33
Sonderjyske,9525,7,8,6,10,28,29,-1,30
Lyngby,9525,8,4,9,11,29,46,-17,21
Silkeborg IF,9525,9,6,3,13,27,44,-17,21
Randers FC,9525,10,5,6,13,25,42,-17,21
AGF Aarhus,9525,11,4,6,12,16,38,-22,18
Brondby,9526,1,22,5,3,75,32,43,71
FC Midtjylla,9526,2,20,4,6,64,36,28,64
FC Nords,9526,3,14,7,9,71,52,19,49
Copenhagen,9526,4,12,6,12,52,44,8,42
AaB,9526,5,8,12,10,37,44,-7,36
AC Horsens,9526,6,6,14,10,36,53,-17,32
Sonderjyske,9526,7,8,6,10,28,29,-1,30
Lyngby,9526,8,4,9,11,29,45,-16,21
Silkeborg IF,9526,9,6,3,13,26,44,-18,21
Randers FC,9526,10,5,6,13,24,42,-18,21
AGF Aarhus,9526,11,4,6,12,16,37,-21,18
Brondby,9527,1,22,6,2,71,31,40,72
FC Midtjylla,9527,2,19,4,7,65,43,22,61
FC Nords,9527,3,16,6,8,78,50,28,54
Copenhagen,9527,4,14,5,11,58,47,11,47
AC Horsens,9527,5,6,13,11,35,54,-19,31
Sonderjyske,9527,6,8,6,10,28,29,-1,30
AaB,9527,7,6,12,12,37,45,-8,30
Lyngby,9527,8,4,9,11,30,47,-17,21
Silkeborg IF,9527,9,6,3,13,27,44,-17,21
Randers FC,9527,10,5,6,13,26,43,-17,21
AGF Aarhus,9527,11,4,6,12,16,38,-22,18
Brondby,9528,1,21,6,3,67,27,40,69
FC Midtjylla,9528,2,21,4,5,64,36,28,67
Copenhagen,9528,3,15,5,10,57,42,15,50
FC Nords,9528,4,14,7,9,71,49,22,49
AC Horsens,9528,5,6,13,11,33,53,-20,31
Sonderjyske,9528,6,8,6,10,28,29,-1,30
AaB,9528,7,6,11,13,33,44,-11,29
Lyngby,9528,8,4,9,11,28,44,-16,21
Silkeborg IF,9528,9,6,3,13,26,44,-18,21
Randers FC,9528,10,5,6,13,23,41,-18,21
AGF Aarhus,9528,11,4,6,12,16,37,-21,18
Brondby,9529,1,22,5,3,73,33,40,71
FC Midtjylla,9529,2,19,5,6,65,42,23,62
FC Nords,9529,3,15,7,8,75,51,24,52
Copenhagen,9529,4,15,4,11,61,45,16,49
AC Horsens,9529,5,6,13,11,40,58,-18,31
Sonderjyske,9529,6,8,6,10,28,29,-1,30
AaB,9529,7,6,12,12,38,49,-11,30
Randers FC,9529,8,6,6,12,24,39,-15,24
Silkeborg IF,9529,9,5,4,13,25,44,-19,19
AGF Aarhus,9529,10,4,7,11,16,36,-20,19
Lyngby,9529,11,3,9,12,26,45,-19,18
FC Midtjylla,9530,1,21,5,4,72,35,37,68
Brondby,9530,2,19,6,5,65,34,31,63
FC Nords,9530,3,16,6,8,80,53,27,54
Copenhagen,9530,4,13,5,12,56,49,7,44
AaB,9530,5,7,13,10,37,44,-7,34
AC Horsens,9530,6,6,13,11,33,54,-21,31
Sonderjyske,9530,7,8,6,10,28,29,-1,30
Randers FC,9530,8,6,6,12,25,39,-14,24
Silkeborg IF,9530,9,5,4,13,26,45,-19,19
AGF Aarhus,9530,10,4,7,11,17,37,-20,19
Lyngby,9530,11,3,9,12,26,46,-20,18
Brondby,9531,1,21,7,2,76,34,42,70
FC Midtjylla,9531,2,19,5,6,68,41,27,62
FC Nords,9531,3,15,6,9,74,54,20,51
Copenhagen,9531,4,14,5,11,60,49,11,47
AaB,9531,5,7,13,10,33,39,-6,34
Sonderjyske,9531,6,8,6,10,28,29,-1,30
AC Horsens,9531,7,5,14,11,33,53,-20,29
Silkeborg IF,9531,8,6,3,13,30,46,-16,21
Lyngby,9531,9,4,9,11,27,44,-17,21
Randers FC,9531,10,5,6,13,23,40,-17,21
AGF Aarhus,9531,11,4,6,12,18,41,-23,18
Brondby,9532,1,22,5,3,72,32,40,71
FC Midtjylla,9532,2,20,6,4,66,36,30,66
FC Nords,9532,3,15,7,8,75,51,24,52
Copenhagen,9532,4,13,4,13,57,48,9,43
AaB,9532,5,7,13,10,37,44,-7,34
Sonderjyske,9532,6,8,6,10,28,29,-1,30
AC Horsens,9532,7,5,13,12,33,55,-22,28
Randers FC,9532,8,6,6,12,30,41,-11,24
Silkeborg IF,9532,9,5,4,13,26,45,-19,19
AGF Aarhus,9532,10,4,7,11,17,37,-20,19
Lyngby,9532,11,3,9,12,28,51,-23,18
Brondby,9533,1,21,6,3,71,31,40,69
FC Midtjylla,9533,2,20,5,5,64,38,26,65
FC Nords,9533,3,15,6,9,75,50,25,51
Copenhagen,9533,4,13,5,12,59,46,13,44
AaB,9533,5,7,13,10,39,47,-8,34
AC Horsens,9533,6,6,13,11,33,55,-22,31
Sonderjyske,9533,7,8,6,10,28,29,-1,30
Randers FC,9533,8,5,7,12,24,40,-16,22
Silkeborg IF,9533,9,6,3,13,26,44,-18,21
Lyngby,9533,10,3,10,11,27,45,-18,19
AGF Aarhus,9533,11,4,6,12,16,37,-21,18
Brondby,9534,1,20,6,4,68,31,37,66
FC Midtjylla,9534,2,19,4,7,67,42,25,61
Copenhagen,9534,3,14,7,9,59,43,16,49
FC Nords,9534,4,13,8,9,73,55,18,47
AC Horsens,9534,5,8,13,9,38,52,-14,37
AaB,9534,6,7,12,11,40,48,-8,33
Sonderjyske,9534,7,8,6,10,28,29,-1,30
Lyngby,9534,8,4,9,11,30,44,-14,21
Silkeborg IF,9534,9,6,3,13,26,44,-18,21
Randers FC,9534,10,5,6,13,23,43,-20,21
AGF Aarhus,9534,11,4,6,12,16,37,-21,18
Brondby,9535,1,22,5,3,69,30,39,71
FC Midtjylla,9535,2,22,4,4,71,37,34,70
FC Nords,9535,3,14,7,9,74,51,23,49
Copenhagen,9535,4,14,4,12,58,45,13,46
Sonderjyske,9535,5,8,6,10,28,29,-1,30
AaB,9535,6,6,12,12,32,44,-12,30
AC Horsens,9535,7,6,12,12,33,56,-23,30
Lyngby,9535,8,4,9,11,28,44,-16,21
Silkeborg IF,9535,9,6,3,13,27,45,-18,21
Randers FC,9535,10,5,6,13,23,41,-18,21
AGF Aarhus,9535,11,4,6,12,17,38,-21,18
Brondby,9536,1,23,5,2,68,27,41,74
FC Midtjylla,9536,2,20,5,5,68,36,32,65
FC Nords,9536,3,14,6,10,69,50,19,48
Copenhagen,9536,4,12,6,12,53,45,8,42
AaB,9536,5,8,13,9,36,40,-4,37
Sonderjyske,9536,6,8,6,10,28,29,-1,30
AC Horsens,9536,7,5,13,12,33,55,-22,28
Randers FC,9536,8,5,7,12,23,39,-16,22
Silkeborg IF,9536,9,6,3,13,28,44,-16,21
Lyngby,9536,10,3,10,11,26,44,-18,19
AGF Aarhus,9536,11,4,6,12,16,39,-23,18
FC Midtjylla,9537,1,22,4,4,71,37,34,70
Brondby,9537,2,19,6,5,66,34,32,63
Copenhagen,9537,3,15,5,10,65,44,21,50
FC Nords,9537,4,14,8,8,71,51,20,50
AC Horsens,9537,5,6,13,11,36,54,-18,31
Sonderjyske,9537,6,8,6,10,28,29,-1,30
AaB,9537,7,6,12,12,36,51,-15,30
Randers FC,9537,8,5,7,12,23,39,-16,22
AGF Aarhus,9537,9,5,6,11,17,36,-19,21
Lyngby,9537,10,3,10,11,26,44,-18,19
Silkeborg IF,9537,11,5,3,14,25,45,-20,18
Brondby,9538,1,21,7,2,73,30,43,70
FC Midtjylla,9538,2,20,5,5,66,40,26,65
FC Nords,9538,3,15,6,9,74,56,18,51
Copenhagen,9538,4,13,5,12,58,48,10,44
AC Horsens,9538,5,7,12,11,41,56,-15,33
AaB,9538,6,7,11,12,37,45,-8,32
Sonderjyske,9538,7,8,6,10,28,29,-1,30
Silkeborg IF,9538,8,6,3,13,29,44,-15,21
Lyngby,9538,9,4,9,11,28,45,-17,21
Randers FC,9538,10,5,6,13,24,41,-17,21
AGF Aarhus,9538,11,4,6,12,16,40,-24,18
Brondby,9539,1,21,5,4,71,33,38,68
FC Midtjylla,9539,2,20,4,6,60,35,25,64
FC Nords,9539,3,14,7,9,73,52,21,49
Copenhagen,9539,4,15,4,11,58,42,16,49
AaB,9539,5,7,13,10,34,39,-5,34
AC Horsens,9539,6,6,13,11,34,55,-21,31
Sonderjyske,9539,7,8,6,10,28,29,-1,30
Randers FC,9539,8,6,6,12,24,39,-15,24
Silkeborg IF,9539,9,5,4,13,25,44,-19,19
AGF Aarhus,9539,10,4,7,11,16,36,-20,19
Lyngby,9539,11,3,9,12,26,45,-19,18
Brondby,9540,1,21,7,2,71,32,39,70
FC Midtjylla,9540,2,20,4,6,71,47,24,64
FC Nords,9540,3,14,7,9,73,53,20,49
Copenhagen,9540,4,14,5,11,58,42,16,47
AaB,9540,5,7,12,11,34,40,-6,33
Sonderjyske,9540,6,8,6,10,28,29,-1,30
AC Horsens,9540,7,5,15,10,35,54,-19,30
Randers FC,9540,8,6,6,12,26,39,-13,24
Silkeborg IF,9540,9,6,3,13,26,44,-18,21
Lyngby,9540,10,3,9,12,26,47,-21,18
AGF Aarhus,9540,11,4,6,12,16,37,-21,18
Brondby,9541,1,20,6,4,73,34,39,66
FC Midtjylla,9541,2,18,5,7,63,41,22,59
FC Nords,9541,3,16,6,8,72,48,24,54
Copenhagen,9541,4,14,5,11,59,47,12,47
AC Horsens,9541,5,8,12,10,39,53,-14,36
AaB,9541,6,7,12,11,40,49,-9,33
Sonderjyske,9541,7,8,6,10,28,29,-1,30
Randers FC,9541,8,6,6,12,26,40,-14,24
Silkeborg IF,9541,9,6,3,13,28,45,-17,21
Lyngby,9541,10,3,9,12,27,47,-20,18
AGF Aarhus,9541,11,4,6,12,17,39,-22,18
Brondby,9542,1,19,7,4,67,34,33,64
FC Midtjylla,9542,2,19,4,7,69,39,30,61
FC Nords,9542,3,15,7,8,72,52,20,52
Copenhagen,9542,4,13,6,11,55,43,12,45
AaB,9542,5,8,13,9,38,40,-2,37
AC Horsens,9542,6,7,13,10,34,53,-19,34
Sonderjyske,9542,7,8,6,10,28,29,-1,30
Lyngby,9542,8,4,9,11,27,44,-17,21
Randers FC,9542,9,5,6,13,23,40,-17,21
Silkeborg IF,9542,10,6,3,13,26,44,-18,21
AGF Aarhus,9542,11,4,6,12,16,37,-21,18
Brondby,9543,1,20,6,4,67,30,37,66
FC Midtjylla,9543,2,20,6,4,67,37,30,66
Copenhagen,9543,3,15,5,10,60,43,17,50
FC Nords,9543,4,13,7,10,70,53,17,46
AaB,9543,5,7,14,9,34,40,-6,35
Sonderjyske,9543,6,8,6,10,28,29,-1,30
AC Horsens,9543,7,5,14,11,33,54,-21,29
Lyngby,9543,8,4,9,11,28,44,-16,21
Randers FC,9543,9,5,6,13,23,41,-18,21
Silkeborg IF,9543,10,5,4,13,26,45,-19,19
AGF Aarhus,9543,11,4,7,11,17,37,-20,19
Brondby,9544,1,20,6,4,73,35,38,66
FC Midtjylla,9544,2,19,4,7,66,43,23,61
FC Nords,9544,3,15,7,8,76,53,23,52
Copenhagen,9544,4,15,5,10,60,44,16,50
AC Horsens,9544,5,7,14,9,40,54,-14,35
Sonderjyske,9544,6,8,6,10,28,29,-1,30
AaB,9544,7,6,12,12,37,49,-12,30
Randers FC,9544,8,5,7,12,24,40,-16,22
Lyngby,9544,9,3,10,11,27,45,-18,19
Silkeborg IF,9544,10,5,4,13,27,46,-19,19
AGF Aarhus,9544,11,4,7,11,18,38,-20,19
Brondby,9545,1,21,6,3,71,34,37,69
FC Midtjylla,9545,2,21,4,5,65,35,30,67
FC Nords,9545,3,15,7,8,75,50,25,52
Copenhagen,9545,4,13,5,12,56,47,9,44
AaB,9545,5,7,11,12,37,45,-8,32
AC Horsens,9545,6,6,13,11,35,54,-19,31
Sonderjyske,9545,7,8,6,10,28,29,-1,30
Randers FC,9545,8,6,6,12,26,41,-15,24
Silkeborg IF,9545,9,5,4,13,26,45,-19,19
AGF Aarhus,9545,10,4,7,11,17,37,-20,19
Lyngby,9545,11,3,9,12,28,47,-19,18
Brondby,9546,1,21,6,3,72,37,35,69
FC Midtjylla,9546,2,21,4,5,75,39,36,67
FC Nords,9546,3,15,6,9,77,50,27,51
Copenhagen,9546,4,13,6,11,56,49,7,45
AC Horsens,9546,5,7,13,10,40,52,-12,34
Sonderjyske,9546,6,8,6,10,28,29,-1,30
AaB,9546,7,6,11,13,34,53,-19,29
Randers FC,9546,8,5,7,12,23,39,-16,22
Lyngby,9546,9,3,10,11,26,44,-18,19
Silkeborg IF,9546,10,5,4,13,26,45,-19,19
AGF Aarhus,9546,11,4,7,11,17,37,-20,19
Brondby,9547,1,20,8,2,67,30,37,68
FC Midtjylla,9547,2,20,6,4,69,39,30,66
FC Nords,9547,3,14,7,9,74,50,24,49
Copenhagen,9547,4,13,5,12,54,46,8,44
AaB,9547,5,7,14,9,37,41,-4,35
Sonderjyske,9547,6,8,6,10,28,29,-1,30
AC Horsens,9547,7,6,12,12,35,56,-21,30
Randers FC,9547,8,6,6,12,25,40,-15,24
Silkeborg IF,9547,9,5,4,13,26,45,-19,19
AGF Aarhus,9547,10,4,7,11,17,37,-20,19
Lyngby,9547,11,3,9,12,27,46,-19,18
Brondby,9548,1,21,7,2,79,31,48,70
FC Midtjylla,9548,2,19,6,5,64,39,25,63
FC Nords,9548,3,13,7,10,74,54,20,46
Copenhagen,9548,4,13,6,11,55,46,9,45
AaB,9548,5,8,12,10,41,47,-6,36
AC Horsens,9548,6,7,12,11,40,62,-22,33
Sonderjyske,9548,7,8,6,10,28,29,-1,30
Lyngby,9548,8,4,9,11,29,45,-16,21
Randers FC,9548,9,5,6,13,24,42,-18,21
AGF Aarhus,9548,10,5,6,11,17,36,-19,21
Silkeborg IF,9548,11,5,3,14,25,45,-20,18
Brondby,9549,1,19,6,5,68,36,32,63
FC Midtjylla,9549,2,17,8,5,61,41,20,59
FC Nords,9549,3,14,8,8,72,50,22,50
Copenhagen,9549,4,15,4,11,59,43,16,49
AaB,9549,5,8,13,9,37,39,-2,37
AC Horsens,9549,6,7,13,10,36,50,-14,34
Sonderjyske,9549,7,8,6,10,28,29,-1,30
Lyngby,9549,8,4,9,11,30,45,-15,21
Randers FC,9549,9,5,6,13,24,43,-19,21
Silkeborg IF,9549,10,5,4,13,26,45,-19,19
AGF Aarhus,9549,11,4,7,11,17,37,-20,19
Brondby,9550,1,19,7,4,69,36,33,64
FC Midtjylla,9550,2,17,7,6,60,39,21,58
Copenhagen,9550,3,16,4,10,62,41,21,52
FC Nords,9550,4,14,8,8,69,50,19,50
AaB,9550,5,9,11,10,40,41,-1,38
Sonderjyske,9550,6,8,6,10,28,29,-1,30
AC Horsens,9550,7,5,15,10,32,51,-19,30
Randers FC,9550,8,5,7,12,24,40,-16,22
AGF Aarhus,9550,9,5,6,11,18,37,-19,21
Lyngby,9550,10,3,10,11,27,45,-18,19
Silkeborg IF,9550,11,5,3,14,26,46,-20,18
Brondby,9551,1,21,6,3,71,36,35,69
FC Midtjylla,9551,2,18,8,4,68,39,29,62
Copenhagen,9551,3,15,6,9,61,38,23,51
FC Nords,9551,4,14,6,10,70,57,13,48
AaB,9551,5,7,12,11,36,43,-7,33
Sonderjyske,9551,6,8,6,10,28,29,-1,30
AC Horsens,9551,7,5,14,11,33,52,-19,29
Lyngby,9551,8,4,9,11,28,45,-17,21
Silkeborg IF,9551,8,6,3,13,28,45,-17,21
Randers FC,9551,10,5,6,13,24,41,-17,21
AGF Aarhus,9551,11,4,6,12,17,39,-22,18
Brondby,9552,1,22,5,3,75,34,41,71
FC Midtjylla,9552,2,19,6,5,70,36,34,63
FC Nords,9552,3,13,7,10,74,57,17,46
Copenhagen,9552,4,14,4,12,58,46,12,46
AaB,9552,5,8,11,11,36,50,-14,35
AC Horsens,9552,6,7,13,10,34,50,-16,34
Sonderjyske,9552,7,8,6,10,28,29,-1,30
Randers FC,9552,8,5,7,12,24,40,-16,22
Lyngby,9552,9,3,10,11,27,45,-18,19
Silkeborg IF,9552,10,5,4,13,26,45,-19,19
AGF Aarhus,9552,11,4,7,11,17,37,-20,19
Brondby,9553,1,22,6,2,74,32,42,72
FC Midtjylla,9553,2,21,5,4,70,35,35,68
FC Nords,9553,3,14,6,10,72,54,18,48
Copenhagen,9553,4,13,4,13,57,51,6,43
AaB,9553,5,9,11,10,40,43,-3,38
Sonderjyske,9553,6,8,6,10,28,29,-1,30
AC Horsens,9553,7,5,12,13,37,61,-24,27
Lyngby,9553,8,4,9,11,28,45,-17,21
Randers FC,9553,9,5,6,13,24,41,-17,21
Silkeborg IF,9553,10,6,3,13,28,46,-18,21
AGF Aarhus,9553,11,4,6,12,18,39,-21,18
Brondby,9554,1,21,6,3,73,33,40,69
FC Midtjylla,9554,2,20,5,5,63,39,24,65
FC Nords,9554,3,14,7,9,74,52,22,49
Copenhagen,9554,4,13,5,12,56,46,10,44
AC Horsens,9554,5,7,13,10,34,48,-14,34
AaB,9554,6,6,14,10,34,42,-8,32
Sonderjyske,9554,7,8,6,10,28,29,-1,30
Lyngby,9554,8,4,9,11,27,44,-17,21
Randers FC,9554,9,5,6,13,23,40,-17,21
Silkeborg IF,9554,10,5,4,13,25,44,-19,19
AGF Aarhus,9554,11,4,7,11,16,36,-20,19
Brondby,9555,1,22,6,2,73,29,44,72
FC Midtjylla,9555,2,20,5,5,68,42,26,65
FC Nords,9555,3,15,6,9,75,51,24,51
Copenhagen,9555,4,12,4,14,55,52,3,40
AaB,9555,5,7,13,10,38,44,-6,34
AC Horsens,9555,6,6,14,10,33,50,-17,32
Sonderjyske,9555,7,8,6,10,28,29,-1,30
Lyngby,9555,8,4,9,11,28,45,-17,21
Silkeborg IF,9555,9,6,3,13,27,44,-17,21
Randers FC,9555,10,5,6,13,24,41,-17,21
AGF Aarhus,9555,11,4,6,12,16,38,-22,18
Brondby,9556,1,21,6,3,68,29,39,69
FC Midtjylla,9556,2,20,5,5,65,38,27,65
Copenhagen,9556,3,17,4,9,62,40,22,55
FC Nords,9556,4,12,8,10,69,53,16,44
AaB,9556,5,6,13,11,34,42,-8,31
Sonderjyske,9556,6,8,6,10,28,29,-1,30
AC Horsens,9556,7,5,14,11,34,56,-22,29
Lyngby,9556,8,4,9,11,28,45,-17,21
Randers FC,9556,9,5,6,13,24,41,-17,21
AGF Aarhus,9556,10,5,6,11,17,36,-19,21
Silkeborg IF,9556,11,5,3,14,25,45,-20,18
Brondby,9557,1,20,6,4,70,40,30,66
FC Midtjylla,9557,2,19,6,5,65,39,26,63
FC Nords,9557,3,16,7,7,85,48,37,55
Copenhagen,9557,4,14,5,11,58,45,13,47
AaB,9557,5,7,12,11,35,43,-8,33
Sonderjyske,9557,6,8,6,10,28,29,-1,30
AC Horsens,9557,7,5,14,11,33,57,-24,29
Randers FC,9557,8,6,6,12,24,39,-15,24
Silkeborg IF,9557,9,6,3,13,27,45,-18,21
Lyngby,9557,10,3,9,12,26,45,-19,18
AGF Aarhus,9557,11,4,6,12,17,38,-21,18
Brondby,9558,1,20,6,4,69,34,35,66
FC Midtjylla,9558,2,18,6,6,59,37,22,60
FC Nords,9558,3,14,7,9,73,52,21,49
Copenhagen,9558,4,14,6,10,61,44,17,48
AC Horsens,9558,5,7,15,8,38,49,-11,36
AaB,9558,6,7,12,11,34,44,-10,33
Sonderjyske,9558,7,8,6,10,28,29,-1,30
Randers FC,9558,8,6,6,12,26,40,-14,24
Silkeborg IF,9558,9,5,4,13,27,46,-19,19
AGF Aarhus,9558,10,4,7,11,18,38,-20,19
Lyngby,9558,11,3,9,12,27,47,-20,18
Brondby,9559,1,22,6,2,73,32,41,72
FC Midtjylla,9559,2,19,5,6,70,39,31,62
FC Nords,9559,3,15,6,9,76,54,22,51
Copenhagen,9559,4,14,4,12,56,46,10,46
AaB,9559,5,8,12,10,37,46,-9,36
Sonderjyske,9559,6,8,6,10,28,29,-1,30
AC Horsens,9559,7,5,13,12,35,56,-21,28
Randers FC,9559,8,6,6,12,25,40,-15,24
AGF Aarhus,9559,9,5,6,11,18,37,-19,21
Lyngby,9559,10,3,9,12,27,46,-19,18
Silkeborg IF,9559,11,5,3,14,26,46,-20,18
Brondby,9560,1,20,7,3,71,32,39,67
FC Midtjylla,9560,2,20,6,4,63,35,28,66
Copenhagen,9560,3,15,6,9,56,39,17,51
FC Nords,9560,4,13,7,10,70,54,16,46
AaB,9560,5,6,13,11,37,45,-8,31
AC Horsens,9560,6,6,13,11,34,52,-18,31
Sonderjyske,9560,7,8,6,10,28,29,-1,30
Randers FC,9560,8,6,6,12,25,40,-15,24
Silkeborg IF,9560,9,5,4,13,26,45,-19,19
AGF Aarhus,9560,10,4,7,11,17,37,-20,19
Lyngby,9560,11,3,9,12,27,46,-19,18
Brondby,9561,1,20,6,4,74,32,42,66
FC Midtjylla,9561,2,20,5,5,66,38,28,65
Copenhagen,9561,3,14,7,9,59,44,15,49
FC Nords,9561,4,13,7,10,70,55,15,46
AaB,9561,5,7,13,10,36,46,-10,34
AC Horsens,9561,6,7,12,11,38,54,-16,33
Sonderjyske,9561,7,8,6,10,28,29,-1,30
Lyngby,9561,8,4,9,11,29,45,-16,21
Silkeborg IF,9561,9,6,3,13,28,44,-16,21
Randers FC,9561,10,5,6,13,24,42,-18,21
AGF Aarhus,9561,11,4,6,12,16,39,-23,18
Brondby,9562,1,20,8,2,67,29,38,68
FC Midtjylla,9562,2,19,4,7,62,41,21,61
Copenhagen,9562,3,16,5,9,62,42,20,53
FC Nords,9562,4,14,8,8,75,53,22,50
AaB,9562,5,6,13,11,36,44,-8,31
Sonderjyske,9562,6,8,6,10,28,29,-1,30
AC Horsens,9562,7,6,12,12,32,51,-19,30
Lyngby,9562,8,4,9,11,28,44,-16,21
Silkeborg IF,9562,9,6,3,13,26,44,-18,21
Randers FC,9562,10,5,6,13,23,41,-18,21
AGF Aarhus,9562,11,4,6,12,16,37,-21,18
Brondby,9563,1,22,5,3,70,32,38,71
FC Midtjylla,9563,2,19,5,6,67,41,26,62
Copenhagen,9563,3,15,4,11,56,42,14,49
FC Nords,9563,4,14,6,10,75,56,19,48
AaB,9563,5,7,13,10,39,44,-5,34
AC Horsens,9563,6,6,13,11,37,55,-18,31
Sonderjyske,9563,7,8,6,10,28,29,-1,30
Lyngby,9563,8,4,9,11,30,45,-15,21
Randers FC,9563,9,5,6,13,24,43,-19,21
AGF Aarhus,9563,10,5,6,11,19,38,-19,21
Silkeborg IF,9563,11,5,3,14,27,47,-20,18
Brondby,9564,1,20,6,4,73,34,39,66
FC Midtjylla,9564,2,19,5,6,62,39,23,62
FC Nords,9564,3,14,6,10,67,52,15,48
Copenhagen,9564,4,14,5,11,54,42,12,47
AaB,9564,5,9,11,10,38,39,-1,38
AC Horsens,9564,6,7,13,10,35,49,-14,34
Sonderjyske,9564,7,8,6,10,28,29,-1,30
Randers FC,9564,8,6,6,12,25,39,-14,24
Silkeborg IF,9564,9,6,3,13,27,45,-18,21
Lyngby,9564,10,3,9,12,26,46,-20,18
AGF Aarhus,9564,11,4,6,12,17,38,-21,18
Brondby,9565,1,21,7,2,72,32,40,70
FC Midtjylla,9565,2,19,5,6,63,38,25,62
Copenhagen,9565,3,14,6,10,56,43,13,48
FC Nords,9565,4,13,8,9,69,49,20,47
AC Horsens,9565,5,7,13,10,39,51,-12,34
AaB,9565,6,6,13,11,36,48,-12,31
Sonderjyske,9565,7,8,6,10,28,29,-1,30
Silkeborg IF,9565,8,6,3,13,29,45,-16,21
Lyngby,9565,9,4,9,11,28,44,-16,21
Randers FC,9565,10,5,6,13,23,41,-18,21
AGF Aarhus,9565,11,4,6,12,17,40,-23,18
Brondby,9566,1,20,6,4,69,33,36,66
FC Midtjylla,9566,2,19,6,5,64,38,26,63
Copenhagen,9566,3,15,5,10,60,43,17,50
FC Nords,9566,4,14,6,10,73,55,18,48
AaB,9566,5,7,13,10,39,46,-7,34
AC Horsens,9566,6,6,14,10,34,50,-16,32
Sonderjyske,9566,7,8,6,10,28,29,-1,30
Randers FC,9566,8,5,7,12,23,39,-16,22
Lyngby,9566,9,3,10,11,26,44,-18,19
Silkeborg IF,9566,10,5,4,13,26,45,-19,19
AGF Aarhus,9566,11,4,7,11,17,37,-20,19
Brondby,9567,1,21,5,4,70,34,36,68
FC Midtjylla,9567,2,20,5,5,67,39,28,65
FC Nords,9567,3,14,7,9,72,52,20,49
Copenhagen,9567,4,14,5,11,61,43,18,47
AC Horsens,9567,5,8,12,10,34,49,-15,36
Sonderjyske,9567,6,8,6,10,28,29,-1,30
AaB,9567,7,6,12,12,35,48,-13,30
Randers FC,9567,8,5,7,12,24,40,-16,22
Silkeborg IF,9567,9,6,3,13,26,44,-18,21
Lyngby,9567,10,3,10,11,27,45,-18,19
AGF Aarhus,9567,11,4,6,12,16,37,-21,18
Brondby,9568,1,21,5,4,70,32,38,68
FC Midtjylla,9568,2,21,4,5,65,37,28,67
FC Nords,9568,3,15,6,9,74,49,25,51
Copenhagen,9568,4,15,4,11,59,44,15,49
AC Horsens,9568,5,6,13,11,32,54,-22,31
Sonderjyske,9568,6,8,6,10,28,29,-1,30
AaB,9568,7,6,12,12,35,45,-10,30
Randers FC,9568,8,6,6,12,25,40,-15,24
Silkeborg IF,9568,9,5,4,13,26,45,-19,19
AGF Aarhus,9568,10,4,7,11,17,37,-20,19
Lyngby,9568,11,3,9,12,27,46,-19,18
Brondby,9569,1,22,6,2,72,29,43,72
FC Midtjylla,9569,2,19,7,4,61,35,26,64
FC Nords,9569,3,13,7,10,68,50,18,46
Copenhagen,9569,4,13,5,12,54,45,9,44
AC Horsens,9569,5,8,12,10,34,48,-14,36
AaB,9569,6,7,11,12,34,42,-8,32
Sonderjyske,9569,7,8,6,10,28,29,-1,30
Randers FC,9569,8,6,6,12,25,39,-14,24
Silkeborg IF,9569,9,6,3,13,27,44,-17,21
Lyngby,9569,10,3,9,12,26,46,-20,18
AGF Aarhus,9569,11,4,6,12,16,38,-22,18
Brondby,9570,1,21,5,4,67,31,36,68
FC Midtjylla,9570,2,19,5,6,66,38,28,62
FC Nords,9570,3,14,6,10,71,51,20,48
Copenhagen,9570,4,14,6,10,55,43,12,48
AaB,9570,5,8,11,11,38,42,-4,35
AC Horsens,9570,6,7,13,10,33,51,-18,34
Sonderjyske,9570,7,8,6,10,28,29,-1,30
Randers FC,9570,8,5,7,12,26,42,-16,22
AGF Aarhus,9570,9,5,6,11,17,36,-19,21
Lyngby,9570,10,3,10,11,29,47,-18,19
Silkeborg IF,9570,11,5,3,14,25,45,-20,18
Brondby,9571,1,22,6,2,78,30,48,72
FC Midtjylla,9571,2,19,5,6,63,37,26,62
FC Nords,9571,3,13,7,10,73,61,12,46
Copenhagen,9571,4,13,6,11,56,45,11,45
AaB,9571,5,8,12,10,39,45,-6,36
AC Horsens,9571,6,6,14,10,35,52,-17,32
Sonderjyske,9571,7,8,6,10,28,29,-1,30
Lyngby,9571,8,4,9,11,29,45,-16,21
AGF Aarhus,9571,9,5,6,11,19,36,-17,21
Randers FC,9571,10,5,6,13,24,42,-18,21
Silkeborg IF,9571,11,5,3,14,25,47,-22,18
Brondby,9572,1,21,5,4,70,34,36,68
FC Midtjylla,9572,2,19,4,7,67,41,26,61
FC Nords,9572,3,14,7,9,75,54,21,49
Copenhagen,9572,4,14,5,11,59,45,14,47
AC Horsens,9572,5,8,12,10,43,59,-16,36
AaB,9572,6,7,13,10,38,45,-7,34
Sonderjyske,9572,7,8,6,10,28,29,-1,30
Lyngby,9572,8,4,9,11,28,45,-17,21
Randers FC,9572,9,5,6,13,24,41,-17,21
AGF Aarhus,9572,10,5,6,11,19,37,-18,21
Silkeborg IF,9572,11,5,3,14,26,47,-21,18
Brondby,9573,1,21,7,2,69,29,40,70
FC Midtjylla,9573,2,19,5,6,63,37,26,62
FC Nords,9573,3,15,6,9,77,51,26,51
Copenhagen,9573,4,13,6,11,56,47,9,45
AaB,9573,5,7,12,11,36,43,-7,33
AC Horsens,9573,6,7,12,11,35,55,-20,33
Sonderjyske,9573,7,8,6,10,28,29,-1,30
Randers FC,9573,8,6,6,12,26,40,-14,24
Silkeborg IF,9573,9,6,3,13,27,45,-18,21
Lyngby,9573,10,3,9,12,27,47,-20,18
AGF Aarhus,9573,11,4,6,12,17,38,-21,18
Brondby,9574,1,21,5,4,71,31,40,68
FC Midtjylla,9574,2,18,5,7,62,42,20,59
FC Nords,9574,3,14,7,9,75,53,22,49
AaB,9574,4,11,11,8,41,40,1,44
Copenhagen,9574,5,13,4,13,56,48,8,43
AC Horsens,9574,6,7,12,11,42,59,-17,33
Sonderjyske,9574,7,8,6,10,28,29,-1,30
Lyngby,9574,8,4,9,11,28,44,-16,21
Randers FC,9574,9,5,6,13,23,41,-18,21
AGF Aarhus,9574,10,5,6,11,19,37,-18,21
Silkeborg IF,9574,11,5,3,14,26,47,-21,18
Brondby,9575,1,22,5,3,69,29,40,71
FC Midtjylla,9575,2,20,4,6,69,43,26,64
FC Nords,9575,3,15,6,9,75,54,21,51
Copenhagen,9575,4,15,4,11,63,44,19,49
AC Horsens,9575,5,6,13,11,32,51,-19,31
Sonderjyske,9575,6,8,6,10,28,29,-1,30
AaB,9575,7,6,12,12,33,46,-13,30
Lyngby,9575,8,4,9,11,30,45,-15,21
Randers FC,9575,9,5,6,13,24,43,-19,21
AGF Aarhus,9575,10,5,6,11,20,39,-19,21
Silkeborg IF,9575,11,5,3,14,28,48,-20,18
Brondby,9576,1,21,6,3,69,32,37,69
FC Midtjylla,9576,2,20,5,5,65,36,29,65
FC Nords,9576,3,14,6,10,71,51,20,48
Copenhagen,9576,4,13,7,10,60,47,13,46
AC Horsens,9576,5,7,13,10,38,54,-16,34
AaB,9576,6,6,13,11,37,46,-9,31
Sonderjyske,9576,7,8,6,10,28,29,-1,30
Randers FC,9576,8,5,7,12,24,40,-16,22
Lyngby,9576,9,3,10,11,27,45,-18,19
Silkeborg IF,9576,10,5,4,13,27,46,-19,19
AGF Aarhus,9576,11,4,7,11,18,38,-20,19
Brondby,9577,1,19,7,4,68,35,33,64
FC Midtjylla,9577,2,19,6,5,69,45,24,63
FC Nords,9577,3,14,6,10,71,52,19,48
Copenhagen,9577,4,14,5,11,60,43,17,47
AaB,9577,5,9,11,10,38,44,-6,38
AC Horsens,9577,6,7,13,10,39,52,-13,34
Sonderjyske,9577,7,8,6,10,28,29,-1,30
Randers FC,9577,8,5,7,12,23,39,-16,22
Silkeborg IF,9577,9,6,3,13,26,44,-18,21
Lyngby,9577,10,3,10,11,26,44,-18,19
AGF Aarhus,9577,11,4,6,12,16,37,-21,18
Brondby,9578,1,21,7,2,70,29,41,70
FC Midtjylla,9578,2,18,4,8,62,43,19,58
Copenhagen,9578,3,15,6,9,61,44,17,51
FC Nords,9578,4,14,6,10,70,52,18,48
AaB,9578,5,7,13,10,38,42,-4,34
AC Horsens,9578,6,7,12,11,35,52,-17,33
Sonderjyske,9578,7,8,6,10,28,29,-1,30
Lyngby,9578,8,4,9,11,28,45,-17,21
Randers FC,9578,9,5,6,13,24,41,-17,21
Silkeborg IF,9578,10,6,3,13,27,45,-18,21
AGF Aarhus,9578,11,4,6,12,17,38,-21,18
Brondby,9579,1,21,5,4,70,33,37,68
FC Midtjylla,9579,2,20,4,6,69,37,32,64
FC Nords,9579,3,16,6,8,77,50,27,54
Copenhagen,9579,4,15,4,11,60,51,9,49
AaB,9579,5,7,12,11,36,45,-9,33
Sonderjyske,9579,6,8,6,10,28,29,-1,30
AC Horsens,9579,7,5,13,12,30,52,-22,28
Randers FC,9579,8,5,7,12,24,40,-16,22
Silkeborg IF,9579,9,6,3,13,31,44,-13,21
Lyngby,9579,10,3,10,11,27,45,-18,19
AGF Aarhus,9579,11,4,6,12,16,42,-26,18
Brondby,9580,1,22,5,3,73,30,43,71
FC Midtjylla,9580,2,18,4,8,64,43,21,58
FC Nords,9580,3,16,6,8,79,50,29,54
Copenhagen,9580,4,14,5,11,55,45,10,47
AC Horsens,9580,5,7,13,10,35,55,-20,34
AaB,9580,6,6,13,11,33,42,-9,31
Sonderjyske,9580,7,8,6,10,28,29,-1,30
Lyngby,9580,8,4,9,11,27,44,-17,21
Randers FC,9580,9,5,6,13,23,40,-17,21
Silkeborg IF,9580,10,5,4,13,27,46,-19,19
AGF Aarhus,9580,11,4,7,11,18,38,-20,19
Brondby,9581,1,22,5,3,72,34,38,71
FC Midtjylla,9581,2,19,6,5,63,39,24,63
FC Nords,9581,3,15,7,8,74,48,26,52
Copenhagen,9581,4,13,5,12,60,46,14,44
AaB,9581,5,7,13,10,37,41,-4,34
Sonderjyske,9581,6,8,6,10,28,29,-1,30
AC Horsens,9581,7,6,12,12,32,56,-24,30
Lyngby,9581,8,4,9,11,27,44,-17,21
Randers FC,9581,9,5,6,13,23,40,-17,21
Silkeborg IF,9581,10,5,4,13,25,44,-19,19
AGF Aarhus,9581,11,4,7,11,16,36,-20,19
Brondby,9582,1,22,5,3,74,29,45,71
FC Midtjylla,9582,2,20,4,6,63,46,17,64
Copenhagen,9582,3,14,4,12,55,43,12,46
FC Nords,9582,4,12,6,12,67,56,11,42
AaB,9582,5,10,11,9,46,41,5,41
AC Horsens,9582,6,7,12,11,35,51,-16,33
Sonderjyske,9582,7,8,6,10,28,29,-1,30
Lyngby,9582,8,4,9,11,28,44,-16,21
Silkeborg IF,9582,9,6,3,13,27,44,-17,21
Randers FC,9582,10,5,6,13,23,41,-18,21
AGF Aarhus,9582,11,4,6,12,16,38,-22,18
Brondby,9583,1,21,5,4,72,32,40,68
FC Midtjylla,9583,2,21,4,5,71,38,33,67
FC Nords,9583,3,14,7,9,74,52,22,49
Copenhagen,9583,4,13,6,11,56,47,9,45
AaB,9583,5,7,12,11,36,43,-7,33
AC Horsens,9583,6,7,12,11,35,58,-23,33
Sonderjyske,9583,7,8,6,10,28,29,-1,30
Lyngby,9583,8,4,9,11,28,45,-17,21
Randers FC,9583,9,5,6,13,24,41,-17,21
Silkeborg IF,9583,10,5,4,13,26,45,-19,19
AGF Aarhus,9583,11,4,7,11,17,37,-20,19
Brondby,9584,1,23,5,2,74,27,47,74
FC Midtjylla,9584,2,19,6,5,65,39,26,63
FC Nords,9584,3,14,8,8,76,48,28,50
Copenhagen,9584,4,13,5,12,58,49,9,44
AC Horsens,9584,5,6,14,10,32,53,-21,32
Sonderjyske,9584,6,8,6,10,28,29,-1,30
AaB,9584,7,6,12,12,33,48,-15,30
Lyngby,9584,8,4,9,11,28,45,-17,21
Randers FC,9584,9,5,6,13,24,41,-17,21
AGF Aarhus,9584,10,5,6,11,18,37,-19,21
Silkeborg IF,9584,11,5,3,14,26,46,-20,18
Brondby,9585,1,20,7,3,68,32,36,67
FC Midtjylla,9585,2,19,5,6,66,40,26,62
FC Nords,9585,3,15,6,9,77,51,26,51
Copenhagen,9585,4,13,6,11,59,46,13,45
AaB,9585,5,8,12,10,37,44,-7,36
AC Horsens,9585,6,7,12,11,35,55,-20,33
Sonderjyske,9585,7,8,6,10,28,29,-1,30
Lyngby,9585,8,4,9,11,27,44,-17,21
Randers FC,9585,9,5,6,13,23,40,-17,21
AGF Aarhus,9585,10,5,6,11,17,36,-19,21
Silkeborg IF,9585,11,5,3,14,25,45,-20,18
FC Midtjylla,9586,1,20,6,4,72,42,30,66
Brondby,9586,2,20,5,5,75,40,35,65
FC Nords,9586,3,13,7,10,72,53,19,46
Copenhagen,9586,4,13,6,11,61,46,15,45
AC Horsens,9586,5,8,13,9,42,54,-12,37
AaB,9586,6,7,13,10,39,52,-13,34
Sonderjyske,9586,7,8,6,10,28,29,-1,30
Lyngby,9586,8,4,9,11,28,44,-16,21
Randers FC,9586,9,5,6,13,23,41,-18,21
AGF Aarhus,9586,10,5,6,11,18,36,-18,21
Silkeborg IF,9586,11,5,3,14,25,46,-21,18
Brondby,9587,1,23,5,2,75,31,44,74
FC Midtjylla,9587,2,18,5,7,61,40,21,59
FC Nords,9587,3,15,6,9,77,56,21,51
Copenhagen,9587,4,15,4,11,61,45,16,49
AaB,9587,5,7,13,10,34,40,-6,34
Sonderjyske,9587,6,8,6,10,28,29,-1,30
AC Horsens,9587,7,5,13,12,35,57,-22,28
Lyngby,9587,8,4,9,11,28,45,-17,21
Randers FC,9587,9,5,6,13,24,41,-17,21
Silkeborg IF,9587,10,6,3,13,26,44,-18,21
AGF Aarhus,9587,11,4,6,12,16,37,-21,18
Brondby,9588,1,20,7,3,68,32,36,67
FC Midtjylla,9588,2,19,4,7,67,38,29,61
FC Nords,9588,3,16,7,7,77,49,28,55
Copenhagen,9588,4,15,4,11,55,42,13,49
AaB,9588,5,7,12,11,34,44,-10,33
Sonderjyske,9588,6,8,6,10,28,29,-1,30
AC Horsens,9588,7,6,12,12,34,56,-22,30
Randers FC,9588,8,5,7,12,23,39,-16,22
Silkeborg IF,9588,9,6,3,13,27,44,-17,21
Lyngby,9588,10,3,10,11,26,44,-18,19
AGF Aarhus,9588,11,4,6,12,16,38,-22,18
Brondby,9589,1,21,6,3,69,32,37,69
FC Midtjylla,9589,2,20,5,5,64,35,29,65
FC Nords,9589,3,14,6,10,71,53,18,48
Copenhagen,9589,4,14,5,11,55,40,15,47
AaB,9589,5,8,12,10,36,42,-6,36
Sonderjyske,9589,6,8,6,10,28,29,-1,30
AC Horsens,9589,7,5,14,11,33,52,-19,29
Lyngby,9589,8,4,9,11,27,44,-17,21
Silkeborg IF,9589,8,6,3,13,27,44,-17,21
Randers FC,9589,10,5,6,13,23,40,-17,21
AGF Aarhus,9589,11,4,6,12,16,38,-22,18
Brondby,9590,1,23,5,2,77,30,47,74
FC Midtjylla,9590,2,20,4,6,68,42,26,64
FC Nords,9590,3,14,7,9,75,53,22,49
Copenhagen,9590,4,13,5,12,59,50,9,44
AaB,9590,5,8,12,10,39,46,-7,36
Sonderjyske,9590,6,8,6,10,28,29,-1,30
AC Horsens,9590,7,5,13,12,35,58,-23,28
Lyngby,9590,8,4,9,11,27,44,-17,21
Randers FC,9590,9,5,6,13,23,40,-17,21
Silkeborg IF,9590,10,6,3,13,28,46,-18,21
AGF Aarhus,9590,11,4,6,12,18,39,-21,18
Brondby,9591,1,21,5,4,75,34,41,68
FC Midtjylla,9591,2,18,7,5,67,39,28,61
FC Nords,9591,3,14,8,8,75,49,26,50
Copenhagen,9591,4,12,7,11,59,49,10,43
AaB,9591,5,9,12,9,39,41,-2,39
AC Horsens,9591,6,6,13,11,33,62,-29,31
Sonderjyske,9591,7,8,6,10,28,29,-1,30
Lyngby,9591,8,4,9,11,28,45,-17,21
Randers FC,9591,9,5,6,13,24,41,-17,21
Silkeborg IF,9591,10,6,3,13,26,44,-18,21
AGF Aarhus,9591,11,4,6,12,16,37,-21,18
Brondby,9592,1,20,7,3,68,31,37,67
FC Midtjylla,9592,2,20,5,5,68,37,31,65
FC Nords,9592,3,14,7,9,71,52,19,49
Copenhagen,9592,4,13,8,9,56,42,14,47
AaB,9592,5,7,13,10,34,40,-6,34
Sonderjyske,9592,6,8,6,10,28,29,-1,30
AC Horsens,9592,7,5,14,11,33,54,-21,29
Lyngby,9592,8,4,9,11,28,45,-17,21
Randers FC,9592,9,5,6,13,24,41,-17,21
Silkeborg IF,9592,10,5,4,13,25,44,-19,19
AGF Aarhus,9592,11,4,7,11,16,36,-20,19
Brondby,9593,1,20,6,4,67,33,34,66
FC Midtjylla,9593,2,19,5,6,69,40,29,62
FC Nords,9593,3,14,8,8,74,51,23,50
Copenhagen,9593,4,14,5,11,59,46,13,47
AC Horsens,9593,5,8,12,10,35,52,-17,36
AaB,9593,6,7,12,11,37,45,-8,33
Sonderjyske,9593,7,8,6,10,28,29,-1,30
Randers FC,9593,8,5,7,12,24,40,-16,22
Lyngby,9593,9,3,10,11,27,45,-18,19
Silkeborg IF,9593,10,5,4,13,26,45,-19,19
AGF Aarhus,9593,11,4,7,11,17,37,-20,19
Brondby,9594,1,20,7,3,71,35,36,67
FC Midtjylla,9594,2,18,6,6,66,43,23,60
FC Nords,9594,3,15,7,8,78,51,27,52
Copenhagen,9594,4,13,6,11,56,46,10,45
AaB,9594,5,8,12,10,38,42,-4,36
AC Horsens,9594,6,6,14,10,36,54,-18,32
Sonderjyske,9594,7,8,6,10,28,29,-1,30
Randers FC,9594,8,5,7,12,24,40,-16,22
Silkeborg IF,9594,9,6,3,13,28,46,-18,21
Lyngby,9594,10,3,10,11,27,45,-18,19
AGF Aarhus,9594,11,4,6,12,18,39,-21,18
Brondby,9595,1,22,6,2,76,32,44,72
FC Midtjylla,9595,2,19,7,4,64,35,29,64
FC Nords,9595,3,14,7,9,73,55,18,49
Copenhagen,9595,4,13,6,11,56,43,13,45
AaB,9595,5,7,13,10,34,42,-8,34
Sonderjyske,9595,6,8,6,10,28,29,-1,30
AC Horsens,9595,7,5,13,12,31,53,-22,28
Randers FC,9595,8,5,7,12,23,39,-16,22
Silkeborg IF,9595,9,6,3,13,28,45,-17,21
Lyngby,9595,10,3,10,11,26,44,-18,19
AGF Aarhus,9595,11,4,6,12,17,39,-22,18
Brondby,9596,1,22,5,3,77,33,44,71
FC Midtjylla,9596,2,19,5,6,67,42,25,62
FC Nords,9596,3,16,6,8,77,50,27,54
Copenhagen,9596,4,12,4,14,54,48,6,40
AaB,9596,5,8,12,10,34,45,-11,36
AC Horsens,9596,6,7,12,11,33,50,-17,33
Sonderjyske,9596,7,8,6,10,28,29,-1,30
Randers FC,9596,8,6,6,12,27,40,-13,24
Silkeborg IF,9596,9,5,4,13,27,46,-19,19
AGF Aarhus,9596,10,4,7,11,18,38,-20,19
Lyngby,9596,11,3,9,12,27,48,-21,18
Brondby,9597,1,21,5,4,72,31,41,68
FC Midtjylla,9597,2,20,5,5,65,39,26,65
FC Nords,9597,3,14,6,10,75,53,22,48
Copenhagen,9597,4,13,6,11,60,49,11,45
AaB,9597,5,9,11,10,38,46,-8,38
AC Horsens,9597,6,6,13,11,38,56,-18,31
Sonderjyske,9597,7,8,6,10,28,29,-1,30
Lyngby,9597,8,4,9,11,27,44,-17,21
Silkeborg IF,9597,8,6,3,13,27,44,-17,21
Randers FC,9597,10,5,6,13,23,40,-17,21
AGF Aarhus,9597,11,4,6,12,16,38,-22,18
Brondby,9598,1,21,5,4,69,32,37,68
FC Midtjylla,9598,2,18,6,6,64,37,27,60
FC Nords,9598,3,13,8,9,68,48,20,47
Copenhagen,9598,4,13,6,11,53,43,10,45
AC Horsens,9598,5,8,13,9,35,50,-15,37
AaB,9598,6,8,12,10,36,41,-5,36
Sonderjyske,9598,7,8,6,10,28,29,-1,30
Lyngby,9598,8,4,9,11,28,44,-16,21
Randers FC,9598,9,5,6,13,23,41,-18,21
Silkeborg IF,9598,10,5,4,13,26,45,-19,19
AGF Aarhus,9598,11,4,7,11,17,37,-20,19
Brondby,9599,1,21,6,3,69,33,36,69
FC Midtjylla,9599,2,18,6,6,65,41,24,60
Copenhagen,9599,3,14,6,10,61,46,15,48
FC Nords,9599,4,12,9,9,72,53,19,45
AaB,9599,5,8,11,11,36,43,-7,35
AC Horsens,9599,6,7,14,9,38,51,-13,35
Sonderjyske,9599,7,8,6,10,28,29,-1,30
Silkeborg IF,9599,8,6,3,13,28,44,-16,21
Lyngby,9599,9,4,9,11,28,45,-17,21
Randers FC,9599,10,5,6,13,24,41,-17,21
AGF Aarhus,9599,11,4,6,12,16,39,-23,18
FC Midtjylla,9600,1,19,7,4,63,36,27,64
Brondby,9600,2,18,8,4,66,34,32,62
FC Nords,9600,3,15,8,7,76,50,26,53
Copenhagen,9600,4,12,5,13,54,48,6,41
AaB,9600,5,9,12,9,38,39,-1,39
AC Horsens,9600,6,6,14,10,33,49,-16,32
Sonderjyske,9600,7,8,6,10,28,29,-1,30
Randers FC,9600,8,6,6,12,28,40,-12,24
Silkeborg IF,9600,9,6,3,13,26,44,-18,21
AGF Aarhus,9600,10,4,6,12,16,37,-21,18
Lyngby,9600,11,3,9,12,27,49,-22,18
Brondby,9601,1,19,8,3,67,32,35,65
FC Midtjylla,9601,2,19,6,5,64,36,28,63
FC Nords,9601,3,14,8,8,72,49,23,50
Copenhagen,9601,4,15,5,10,59,43,16,50
AaB,9601,5,8,12,10,38,41,-3,36
Sonderjyske,9601,6,8,6,10,28,29,-1,30
AC Horsens,9601,7,5,13,12,31,56,-25,28
Randers FC,9601,8,5,7,12,25,41,-16,22
Lyngby,9601,9,3,10,11,28,46,-18,19
Silkeborg IF,9601,10,5,4,13,25,44,-19,19
AGF Aarhus,9601,11,4,7,11,16,36,-20,19
Brondby,9602,1,22,5,3,77,34,43,71
FC Midtjylla,9602,2,19,4,7,64,40,24,61
FC Nords,9602,3,15,6,9,77,53,24,51
Copenhagen,9602,4,14,5,11,57,46,11,47
AaB,9602,5,8,12,10,44,49,-5,36
Sonderjyske,9602,6,8,6,10,28,29,-1,30
AC Horsens,9602,7,6,12,12,35,58,-23,30
Randers FC,9602,8,5,7,12,23,39,-16,22
Lyngby,9602,9,3,10,11,26,44,-18,19
Silkeborg IF,9602,10,5,4,13,26,45,-19,19
AGF Aarhus,9602,11,4,7,11,17,37,-20,19
Brondby,9603,1,19,7,4,70,36,34,64
FC Midtjylla,9603,2,19,4,7,64,39,25,61
FC Nords,9603,3,15,7,8,77,52,25,52
Copenhagen,9603,4,15,4,11,54,42,12,49
AC Horsens,9603,5,8,13,9,38,52,-14,37
AaB,9603,6,7,11,12,40,48,-8,32
Sonderjyske,9603,7,8,6,10,28,29,-1,30
Lyngby,9603,8,4,9,11,28,44,-16,21
Silkeborg IF,9603,9,6,3,13,28,45,-17,21
Randers FC,9603,10,5,6,13,23,41,-18,21
AGF Aarhus,9603,11,4,6,12,17,39,-22,18
Brondby,9604,1,21,6,3,70,34,36,69
FC Midtjylla,9604,2,19,5,6,65,38,27,62
FC Nords,9604,3,15,7,8,73,48,25,52
Copenhagen,9604,4,14,5,11,56,41,15,47
AaB,9604,5,8,11,11,38,44,-6,35
Sonderjyske,9604,6,8,6,10,28,29,-1,30
AC Horsens,9604,7,6,12,12,34,57,-23,30
Randers FC,9604,8,6,6,12,25,40,-15,24
Silkeborg IF,9604,9,6,3,13,27,45,-18,21
Lyngby,9604,10,3,9,12,27,46,-19,18
AGF Aarhus,9604,11,4,6,12,17,38,-21,18
Brondby,9605,1,20,6,4,68,32,36,66
FC Midtjylla,9605,2,19,5,6,69,41,28,62
FC Nords,9605,3,14,7,9,74,54,20,49
Copenhagen,9605,4,13,6,11,56,47,9,45
AaB,9605,5,8,12,10,39,43,-4,36
AC Horsens,9605,6,7,14,9,36,51,-15,35
Sonderjyske,9605,7,8,6,10,28,29,-1,30
Randers FC,9605,8,6,6,12,26,41,-15,24
AGF Aarhus,9605,9,5,6,11,18,37,-19,21
Lyngby,9605,10,3,9,12,28,47,-19,18
Silkeborg IF,9605,11,5,3,14,26,46,-20,18
Brondby,9606,1,22,5,3,68,30,38,71
FC Midtjylla,9606,2,20,4,6,66,37,29,64
Copenhagen,9606,3,15,4,11,62,43,19,49
FC Nords,9606,4,14,6,10,72,51,21,48
AaB,9606,5,8,11,11,37,46,-9,35
Sonderjyske,9606,6,8,6,10,28,29,-1,30
AC Horsens,9606,7,6,12,12,31,55,-24,30
Randers FC,9606,8,5,7,12,24,40,-16,22
Silkeborg IF,9606,9,6,3,13,27,45,-18,21
Lyngby,9606,10,3,10,11,27,45,-18,19
AGF Aarhus,9606,11,4,6,12,17,38,-21,18
FC Midtjylla,9607,1,20,5,5,65,35,30,65
Brondby,9607,2,18,6,6,65,36,29,60
FC Nords,9607,3,15,8,7,73,47,26,53
Copenhagen,9607,4,14,5,11,57,44,13,47
AaB,9607,5,8,11,11,36,43,-7,35
AC Horsens,9607,6,7,13,10,37,54,-17,34
Sonderjyske,9607,7,8,6,10,28,29,-1,30
Lyngby,9607,8,4,9,11,28,45,-17,21
Randers FC,9607,9,5,6,13,24,41,-17,21
Silkeborg IF,9607,10,6,3,13,27,45,-18,21
AGF Aarhus,9607,11,4,6,12,17,38,-21,18
Brondby,9608,1,20,7,3,73,33,40,67
FC Midtjylla,9608,2,21,4,5,74,42,32,67
Copenhagen,9608,3,15,5,10,66,45,21,50
FC Nords,9608,4,14,6,10,76,58,18,48
AC Horsens,9608,5,7,12,11,36,64,-28,33
Sonderjyske,9608,6,8,6,10,28,29,-1,30
AaB,9608,7,6,12,12,35,44,-9,30
Lyngby,9608,8,4,9,11,27,44,-17,21
Randers FC,9608,9,5,6,13,23,40,-17,21
Silkeborg IF,9608,10,5,4,13,26,45,-19,19
AGF Aarhus,9608,11,4,7,11,17,37,-20,19
Brondby,9609,1,21,7,2,69,29,40,70
FC Midtjylla,9609,2,20,5,5,65,36,29,65
FC Nords,9609,3,13,7,10,68,54,14,46
Copenhagen,9609,4,13,6,11,56,44,12,45
AaB,9609,5,7,12,11,35,42,-7,33
AC Horsens,9609,6,6,15,9,35,49,-14,33
Sonderjyske,9609,7,8,6,10,28,29,-1,30
Randers FC,9609,8,6,6,12,27,40,-13,24
Silkeborg IF,9609,9,6,3,13,28,45,-17,21
Lyngby,9609,10,3,9,12,27,48,-21,18
AGF Aarhus,9609,11,4,6,12,17,39,-22,18
Brondby,9610,1,21,5,4,77,34,43,68
FC Midtjylla,9610,2,19,5,6,64,44,20,62
FC Nords,9610,3,16,7,7,74,47,27,55
Copenhagen,9610,4,15,4,11,58,42,16,49
AaB,9610,5,7,11,12,37,47,-10,32
Sonderjyske,9610,6,8,6,10,28,29,-1,30
AC Horsens,9610,7,6,12,12,33,55,-22,30
Lyngby,9610,8,4,9,11,28,45,-17,21
Silkeborg IF,9610,9,6,3,13,27,44,-17,21
Randers FC,9610,10,5,6,13,24,41,-17,21
AGF Aarhus,9610,11,4,6,12,16,38,-22,18
Brondby,9611,1,19,7,4,69,34,35,64
FC Midtjylla,9611,2,19,7,4,63,36,27,64
FC Nords,9611,3,15,6,9,72,51,21,51
Copenhagen,9611,4,14,5,11,55,43,12,47
AaB,9611,5,7,14,9,41,44,-3,35
AC Horsens,9611,6,6,13,11,32,50,-18,31
Sonderjyske,9611,7,8,6,10,28,29,-1,30
Lyngby,9611,8,4,9,11,28,44,-16,21
Randers FC,9611,9,5,6,13,23,41,-18,21
AGF Aarhus,9611,10,5,6,11,20,39,-19,21
Silkeborg IF,9611,11,5,3,14,28,48,-20,18
Brondby,9612,1,21,6,3,72,34,38,69
FC Midtjylla,9612,2,20,5,5,70,42,28,65
Copenhagen,9612,3,16,4,10,62,44,18,52
FC Nords,9612,4,13,8,9,70,51,19,47
AC Horsens,9612,5,6,13,11,36,56,-20,31
Sonderjyske,9612,6,8,6,10,28,29,-1,30
AaB,9612,7,6,12,12,35,44,-9,30
Randers FC,9612,8,6,6,12,26,39,-13,24
Silkeborg IF,9612,9,6,3,13,27,44,-17,21
Lyngby,9612,10,3,9,12,26,47,-21,18
AGF Aarhus,9612,11,4,6,12,16,38,-22,18
Brondby,9613,1,21,6,3,70,31,39,69
FC Midtjylla,9613,2,20,5,5,62,35,27,65
FC Nords,9613,3,13,9,8,71,50,21,48
Copenhagen,9613,4,12,7,11,55,45,10,43
AaB,9613,5,8,12,10,35,39,-4,36
AC Horsens,9613,6,6,13,11,32,51,-19,31
Sonderjyske,9613,7,8,6,10,28,29,-1,30
Randers FC,9613,8,6,6,12,26,39,-13,24
Silkeborg IF,9613,9,5,4,13,26,45,-19,19
AGF Aarhus,9613,10,4,7,11,17,37,-20,19
Lyngby,9613,11,3,9,12,26,47,-21,18
FC Midtjylla,9614,1,22,4,4,71,37,34,70
Brondby,9614,2,18,8,4,68,37,31,62
FC Nords,9614,3,14,8,8,75,49,26,50
Copenhagen,9614,4,12,7,11,57,50,7,43
AC Horsens,9614,5,7,13,10,37,53,-16,34
AaB,9614,6,6,14,10,34,42,-8,32
Sonderjyske,9614,7,8,6,10,28,29,-1,30
Randers FC,9614,8,5,7,12,24,40,-16,22
Lyngby,9614,9,3,10,11,27,45,-18,19
Silkeborg IF,9614,10,5,4,13,25,44,-19,19
AGF Aarhus,9614,11,4,7,11,16,36,-20,19
Brondby,9615,1,21,5,4,71,34,37,68
FC Midtjylla,9615,2,19,5,6,67,40,27,62
FC Nords,9615,3,15,8,7,74,48,26,53
Copenhagen,9615,4,13,7,10,57,47,10,46
AaB,9615,5,7,13,10,39,43,-4,34
Sonderjyske,9615,6,8,6,10,28,29,-1,30
AC Horsens,9615,7,6,12,12,35,57,-22,30
Lyngby,9615,8,4,9,11,27,44,-17,21
Randers FC,9615,9,5,6,13,23,40,-17,21
Silkeborg IF,9615,10,5,4,13,27,46,-19,19
AGF Aarhus,9615,11,4,7,11,18,38,-20,19
Brondby,9616,1,22,5,3,75,32,43,71
FC Midtjylla,9616,2,20,4,6,64,40,24,64
FC Nords,9616,3,14,7,9,76,57,19,49
Copenhagen,9616,4,12,6,12,54,45,9,42
AC Horsens,9616,5,8,13,9,35,47,-12,37
AaB,9616,6,6,13,11,36,45,-9,31
Sonderjyske,9616,7,8,6,10,28,29,-1,30
Lyngby,9616,8,4,9,11,29,44,-15,21
Randers FC,9616,9,5,6,13,23,42,-19,21
Silkeborg IF,9616,10,5,4,13,25,44,-19,19
AGF Aarhus,9616,11,4,7,11,16,36,-20,19
Brondby,9617,1,21,6,3,72,30,42,69
FC Midtjylla,9617,2,18,5,7,61,39,22,59
Copenhagen,9617,3,15,5,10,60,45,15,50
FC Nords,9617,4,13,8,9,70,51,19,47
AaB,9617,5,9,11,10,38,45,-7,38
AC Horsens,9617,6,6,13,11,32,49,-17,31
Sonderjyske,9617,7,8,6,10,28,29,-1,30
Randers FC,9617,8,5,7,12,23,39,-16,22
AGF Aarhus,9617,9,5,6,11,18,36,-18,21
Lyngby,9617,10,3,10,11,26,44,-18,19
Silkeborg IF,9617,11,5,3,14,25,46,-21,18
Brondby,9618,1,20,6,4,68,29,39,66
FC Midtjylla,9618,2,18,5,7,65,44,21,59
FC Nords,9618,3,16,7,7,81,52,29,55
Copenhagen,9618,4,14,5,11,58,47,11,47
AC Horsens,9618,5,7,14,9,36,51,-15,35
AaB,9618,6,6,13,11,36,47,-11,31
Sonderjyske,9618,7,8,6,10,28,29,-1,30
Randers FC,9618,8,6,6,12,26,40,-14,24
Silkeborg IF,9618,9,5,4,13,26,45,-19,19
AGF Aarhus,9618,10,4,7,11,17,37,-20,19
Lyngby,9618,11,3,9,12,27,47,-20,18
Brondby,9619,1,23,5,2,77,31,46,74
FC Midtjylla,9619,2,21,4,5,76,38,38,67
Copenhagen,9619,3,14,5,11,60,45,15,47
FC Nords,9619,4,13,7,10,71,58,13,46
AaB,9619,5,8,11,11,38,44,-6,35
Sonderjyske,9619,6,8,6,10,28,29,-1,30
AC Horsens,9619,7,5,12,13,32,64,-32,27
Silkeborg IF,9619,8,6,3,13,28,44,-16,21
Lyngby,9619,9,4,9,11,27,44,-17,21
Randers FC,9619,10,5,6,13,23,40,-17,21
AGF Aarhus,9619,11,4,6,12,16,39,-23,18
Brondby,9620,1,21,6,3,72,30,42,69
FC Midtjylla,9620,2,20,5,5,69,42,27,65
FC Nords,9620,3,15,7,8,79,54,25,52
Copenhagen,9620,4,14,5,11,60,47,13,47
Sonderjyske,9620,5,8,6,10,28,29,-1,30
AaB,9620,6,6,12,12,38,52,-14,30
AC Horsens,9620,7,5,15,10,32,51,-19,30
Randers FC,9620,8,5,7,12,24,40,-16,22
Silkeborg IF,9620,9,6,3,13,27,45,-18,21
Lyngby,9620,10,3,10,11,27,45,-18,19
AGF Aarhus,9620,11,4,6,12,17,38,-21,18
Brondby,9621,1,21,7,2,73,33,40,70
FC Midtjylla,9621,2,20,5,5,69,42,27,65
FC Nords,9621,3,14,7,9,71,48,23,49
Copenhagen,9621,4,13,7,10,57,45,12,46
AaB,9621,5,6,13,11,34,43,-9,31
AC Horsens,9621,6,6,13,11,37,56,-19,31
Sonderjyske,9621,7,8,6,10,28,29,-1,30
Randers FC,9621,8,5,7,12,24,40,-16,22
Silkeborg IF,9621,9,6,3,13,28,45,-17,21
Lyngby,9621,10,3,10,11,27,45,-18,19
AGF Aarhus,9621,11,4,6,12,17,39,-22,18
Brondby,9622,1,20,7,3,66,30,36,67
FC Midtjylla,9622,2,20,5,5,67,39,28,65
FC Nords,9622,3,14,7,9,71,49,22,49
Copenhagen,9622,4,14,6,10,58,42,16,48
AaB,9622,5,8,13,9,38,42,-4,37
Sonderjyske,9622,6,8,6,10,28,29,-1,30
AC Horsens,9622,7,5,12,13,30,54,-24,27
Randers FC,9622,8,5,7,12,26,42,-16,22
Silkeborg IF,9622,9,6,3,13,27,44,-17,21
Lyngby,9622,10,3,10,11,29,47,-18,19
AGF Aarhus,9622,11,4,6,12,16,38,-22,18
Brondby,9623,1,22,5,3,76,30,46,71
FC Midtjylla,9623,2,19,4,7,66,44,22,61
Copenhagen,9623,3,16,5,9,61,42,19,53
FC Nords,9623,4,15,6,9,74,55,19,51
Sonderjyske,9623,5,8,6,10,28,29,-1,30
AaB,9623,6,6,12,12,34,44,-10,30
AC Horsens,9623,7,6,12,12,34,56,-22,30
Randers FC,9623,8,6,6,12,26,39,-13,24
Silkeborg IF,9623,9,6,3,13,28,46,-18,21
Lyngby,9623,10,3,9,12,26,47,-21,18
AGF Aarhus,9623,11,4,6,12,18,39,-21,18
Brondby,9624,1,19,7,4,72,38,34,64
FC Midtjylla,9624,2,20,4,6,71,44,27,64
Copenhagen,9624,3,15,5,10,55,43,12,50
FC Nords,9624,4,13,9,8,73,54,19,48
AaB,9624,5,7,13,10,33,38,-5,34
AC Horsens,9624,6,7,12,11,37,50,-13,33
Sonderjyske,9624,7,8,6,10,28,29,-1,30
Lyngby,9624,8,4,9,11,29,45,-16,21
Randers FC,9624,9,5,6,13,24,42,-18,21
Silkeborg IF,9624,10,5,4,13,26,45,-19,19
AGF Aarhus,9624,11,4,7,11,17,37,-20,19
Brondby,9625,1,20,7,3,69,32,37,67
FC Midtjylla,9625,2,20,5,5,65,40,25,65
Copenhagen,9625,3,14,5,11,58,44,14,47
FC Nords,9625,4,13,7,10,70,53,17,46
AaB,9625,5,8,12,10,36,39,-3,36
AC Horsens,9625,6,7,12,11,38,54,-16,33
Sonderjyske,9625,7,8,6,10,28,29,-1,30
Lyngby,9625,8,4,9,11,27,44,-17,21
Randers FC,9625,9,5,6,13,23,40,-17,21
AGF Aarhus,9625,10,5,6,11,19,36,-17,21
Silkeborg IF,9625,11,5,3,14,25,47,-22,18
Brondby,9626,1,21,6,3,75,31,44,69
FC Midtjylla,9626,2,19,6,5,63,37,26,63
FC Nords,9626,3,13,9,8,70,52,18,48
Copenhagen,9626,4,14,6,10,55,42,13,48
AC Horsens,9626,5,7,13,10,35,49,-14,34
Sonderjyske,9626,6,8,6,10,28,29,-1,30
AaB,9626,7,6,12,12,33,46,-13,30
Silkeborg IF,9626,8,6,3,13,28,44,-16,21
Lyngby,9626,9,4,9,11,28,45,-17,21
Randers FC,9626,10,5,6,13,24,41,-17,21
AGF Aarhus,9626,11,4,6,12,16,39,-23,18
Brondby,9627,1,22,6,2,73,27,46,72
FC Midtjylla,9627,2,19,7,4,68,38,30,64
FC Nords,9627,3,14,8,8,71,52,19,50
Copenhagen,9627,4,12,5,13,57,48,9,41
AaB,9627,5,8,13,9,37,42,-5,37
Sonderjyske,9627,6,8,6,10,28,29,-1,30
AC Horsens,9627,7,5,13,12,34,59,-25,28
Silkeborg IF,9627,8,6,3,13,29,44,-15,21
Lyngby,9627,9,4,9,11,28,44,-16,21
Randers FC,9627,10,5,6,13,23,41,-18,21
AGF Aarhus,9627,11,4,6,12,16,40,-24,18
FC Midtjylla,9628,1,20,4,6,68,39,29,64
Brondby,9628,2,18,7,5,70,38,32,61
FC Nords,9628,3,13,10,7,76,52,24,49
Copenhagen,9628,4,13,6,11,56,46,10,45
AaB,9628,5,7,15,8,35,38,-3,36
AC Horsens,9628,6,7,14,9,39,57,-18,35
Sonderjyske,9628,7,8,6,10,28,29,-1,30
Silkeborg IF,9628,8,6,3,13,30,45,-15,21
Lyngby,9628,9,4,9,11,27,44,-17,21
Randers FC,9628,10,5,6,13,23,40,-17,21
AGF Aarhus,9628,11,4,6,12,17,41,-24,18
Brondby,9629,1,21,5,4,69,36,33,68
FC Midtjylla,9629,2,20,5,5,67,43,24,65
FC Nords,9629,3,14,7,9,74,51,23,49
Copenhagen,9629,4,14,4,12,58,46,12,46
AC Horsens,9629,5,7,14,9,42,52,-10,35
AaB,9629,6,6,13,11,35,43,-8,31
Sonderjyske,9629,7,8,6,10,28,29,-1,30
Randers FC,9629,8,6,6,12,26,39,-13,24
Silkeborg IF,9629,9,6,3,13,27,44,-17,21
Lyngby,9629,10,3,9,12,26,47,-21,18
AGF Aarhus,9629,11,4,6,12,16,38,-22,18
Brondby,9630,1,20,6,4,71,37,34,66
FC Midtjylla,9630,2,19,5,6,64,42,22,62
Copenhagen,9630,3,16,4,10,66,44,22,52
FC Nords,9630,4,14,7,9,72,50,22,49
AC Horsens,9630,5,7,13,10,35,53,-18,34
AaB,9630,6,7,11,12,38,46,-8,32
Sonderjyske,9630,7,8,6,10,28,29,-1,30
Lyngby,9630,8,4,9,11,31,48,-17,21
Randers FC,9630,9,5,6,13,27,44,-17,21
Silkeborg IF,9630,10,5,4,13,26,45,-19,19
AGF Aarhus,9630,11,4,7,11,17,37,-20,19
FC Midtjylla,9631,1,19,6,5,64,39,25,63
Brondby,9631,2,18,8,4,67,36,31,62
FC Nords,9631,3,14,8,8,73,51,22,50
Copenhagen,9631,4,14,4,12,57,46,11,46
AaB,9631,5,9,12,9,39,40,-1,39
AC Horsens,9631,6,7,12,11,36,50,-14,33
Sonderjyske,9631,7,8,6,10,28,29,-1,30
Randers FC,9631,8,6,6,12,25,40,-15,24
AGF Aarhus,9631,9,5,6,11,19,37,-18,21
Lyngby,9631,10,3,9,12,27,46,-19,18
Silkeborg IF,9631,11,5,3,14,26,47,-21,18
Brondby,9632,1,22,5,3,69,30,39,71
FC Midtjylla,9632,2,18,6,6,64,41,23,60
FC Nords,9632,3,14,7,9,77,53,24,49
Copenhagen,9632,4,13,6,11,59,42,17,45
AaB,9632,5,7,14,9,37,40,-3,35
AC Horsens,9632,6,6,14,10,33,59,-26,32
Sonderjyske,9632,7,8,6,10,28,29,-1,30
Silkeborg IF,9632,8,6,3,13,28,44,-16,21
Lyngby,9632,9,4,9,11,28,45,-17,21
Randers FC,9632,10,5,6,13,24,41,-17,21
AGF Aarhus,9632,11,4,6,12,16,39,-23,18
Brondby,9633,1,21,6,3,75,31,44,69
FC Midtjylla,9633,2,18,5,7,61,42,19,59
FC Nords,9633,3,15,7,8,75,50,25,52
Copenhagen,9633,4,15,4,11,58,46,12,49
AaB,9633,5,9,11,10,37,40,-3,38
Sonderjyske,9633,6,8,6,10,28,29,-1,30
AC Horsens,9633,7,5,13,12,32,55,-23,28
Silkeborg IF,9633,8,6,3,13,29,44,-15,21
Lyngby,9633,9,4,9,11,27,44,-17,21
Randers FC,9633,10,5,6,13,23,40,-17,21
AGF Aarhus,9633,11,4,6,12,16,40,-24,18
Brondby,9634,1,21,5,4,74,36,38,68
FC Midtjylla,9634,2,21,4,5,68,38,30,67
Copenhagen,9634,3,15,4,11,61,44,17,49
FC Nords,9634,4,14,6,10,71,53,18,48
AC Horsens,9634,5,8,12,10,38,51,-13,36
Sonderjyske,9634,6,8,6,10,28,29,-1,30
AaB,9634,7,6,11,13,36,52,-16,29
Randers FC,9634,8,5,7,12,23,39,-16,22
AGF Aarhus,9634,9,5,6,11,21,37,-16,21
Lyngby,9634,10,3,10,11,26,44,-18,19
Silkeborg IF,9634,11,5,3,14,26,49,-23,18
Brondby,9635,1,21,6,3,71,33,38,69
FC Midtjylla,9635,2,20,5,5,65,39,26,65
FC Nords,9635,3,15,6,9,74,53,21,51
Copenhagen,9635,4,13,6,11,58,45,13,45
AaB,9635,5,7,12,11,39,47,-8,33
AC Horsens,9635,6,6,13,11,38,54,-16,31
Sonderjyske,9635,7,8,6,10,28,29,-1,30
Randers FC,9635,8,5,7,12,24,40,-16,22
Silkeborg IF,9635,9,6,3,13,26,44,-18,21
Lyngby,9635,10,3,10,11,27,45,-18,19
AGF Aarhus,9635,11,4,6,12,16,37,-21,18
FC Midtjylla,9636,1,19,7,4,64,36,28,64
Brondby,9636,2,18,7,5,65,37,28,61
FC Nords,9636,3,14,9,7,75,51,24,51
Copenhagen,9636,4,14,5,11,59,43,16,47
AC Horsens,9636,5,7,14,9,36,49,-13,35
AaB,9636,6,7,12,11,34,43,-9,33
Sonderjyske,9636,7,8,6,10,28,29,-1,30
Randers FC,9636,8,5,7,12,24,40,-16,22
Silkeborg IF,9636,9,6,3,13,28,45,-17,21
Lyngby,9636,10,3,10,11,27,45,-18,19
AGF Aarhus,9636,11,4,6,12,17,39,-22,18
Brondby,9637,1,20,8,2,71,32,39,68
FC Midtjylla,9637,2,19,6,5,62,37,25,63
FC Nords,9637,3,15,7,8,76,51,25,52
Copenhagen,9637,4,12,7,11,54,44,10,43
AaB,9637,5,7,12,11,34,43,-9,33
AC Horsens,9637,6,6,14,10,33,49,-16,32
Sonderjyske,9637,7,8,6,10,28,29,-1,30
Randers FC,9637,8,5,7,12,23,39,-16,22
AGF Aarhus,9637,9,5,6,11,19,38,-19,21
Lyngby,9637,10,3,10,11,26,44,-18,19
Silkeborg IF,9637,11,5,3,14,27,47,-20,18
FC Midtjylla,9638,1,21,5,4,66,34,32,68
Brondby,9638,2,20,5,5,74,39,35,65
FC Nords,9638,3,15,6,9,73,49,24,51
Copenhagen,9638,4,15,5,10,60,46,14,50
AaB,9638,5,7,11,12,38,49,-11,32
Sonderjyske,9638,6,8,6,10,28,29,-1,30
AC Horsens,9638,7,6,12,12,37,57,-20,30
Lyngby,9638,8,4,9,11,31,45,-14,21
Silkeborg IF,9638,9,6,3,13,29,44,-15,21
Randers FC,9638,10,5,6,13,24,44,-20,21
AGF Aarhus,9638,11,4,6,12,16,40,-24,18
Brondby,9639,1,21,5,4,73,32,41,68
FC Midtjylla,9639,2,19,5,6,64,42,22,62
FC Nords,9639,3,16,6,8,82,53,29,54
Copenhagen,9639,4,14,5,11,62,50,12,47
AaB,9639,5,8,11,11,39,45,-6,35
Sonderjyske,9639,6,8,6,10,28,29,-1,30
AC Horsens,9639,7,6,12,12,38,62,-24,30
Lyngby,9639,8,4,9,11,28,44,-16,21
Silkeborg IF,9639,8,6,3,13,28,44,-16,21
Randers FC,9639,10,5,6,13,23,41,-18,21
AGF Aarhus,9639,11,4,6,12,16,39,-23,18
Brondby,9640,1,21,6,3,68,30,38,69
FC Midtjylla,9640,2,19,5,6,66,41,25,62
Copenhagen,9640,3,16,5,9,58,39,19,53
FC Nords,9640,4,14,7,9,70,48,22,49
AaB,9640,5,7,12,11,34,43,-9,33
Sonderjyske,9640,6,8,6,10,28,29,-1,30
AC Horsens,9640,7,5,13,12,32,53,-21,28
Lyngby,9640,8,4,9,11,30,44,-14,21
Silkeborg IF,9640,9,6,3,13,28,46,-18,21
Randers FC,9640,10,5,6,13,23,43,-20,21
AGF Aarhus,9640,11,4,6,12,18,39,-21,18
Brondby,9641,1,20,6,4,69,35,34,66
FC Midtjylla,9641,2,20,4,6,67,37,30,64
Copenhagen,9641,3,16,5,9,59,39,20,53
FC Nords,9641,4,13,8,9,72,52,20,47
AaB,9641,5,7,12,11,35,45,-10,33
AC Horsens,9641,6,6,13,11,34,54,-20,31
Sonderjyske,9641,7,8,6,10,28,29,-1,30
Lyngby,9641,8,4,9,11,28,44,-16,21
Silkeborg IF,9641,8,6,3,13,28,44,-16,21
Randers FC,9641,10,5,6,13,23,41,-18,21
AGF Aarhus,9641,11,4,6,12,16,39,-23,18
Brondby,9642,1,22,5,3,77,32,45,71
FC Midtjylla,9642,2,19,5,6,67,41,26,62
FC Nords,9642,3,14,7,9,74,57,17,49
Copenhagen,9642,4,14,4,12,60,46,14,46
AaB,9642,5,8,11,11,38,48,-10,35
AC Horsens,9642,6,6,14,10,32,50,-18,32
Sonderjyske,9642,7,8,6,10,28,29,-1,30
Randers FC,9642,8,6,6,12,27,40,-13,24
Silkeborg IF,9642,9,6,3,13,28,44,-16,21
Lyngby,9642,10,3,9,12,27,48,-21,18
AGF Aarhus,9642,11,4,6,12,16,39,-23,18
FC Midtjylla,9643,1,21,4,5,69,40,29,67
Brondby,9643,2,20,6,4,66,33,33,66
FC Nords,9643,3,14,6,10,73,52,21,48
Copenhagen,9643,4,13,4,13,55,46,9,43
AaB,9643,5,10,11,9,45,42,3,41
AC Horsens,9643,6,6,13,11,32,53,-21,31
Sonderjyske,9643,7,8,6,10,28,29,-1,30
Lyngby,9643,8,4,9,11,29,45,-16,21
AGF Aarhus,9643,9,5,6,11,20,36,-16,21
Randers FC,9643,10,5,6,13,24,42,-18,21
Silkeborg IF,9643,11,5,3,14,25,48,-23,18
Brondby,9644,1,20,7,3,68,32,36,67
FC Midtjylla,9644,2,19,6,5,63,38,25,63
Copenhagen,9644,3,15,5,10,61,43,18,50
FC Nords,9644,4,13,8,9,72,51,21,47
AaB,9644,5,8,13,9,39,43,-4,37
Sonderjyske,9644,6,8,6,10,28,29,-1,30
AC Horsens,9644,7,5,13,12,32,54,-22,28
Randers FC,9644,8,6,6,12,26,40,-14,24
AGF Aarhus,9644,9,5,6,11,18,36,-18,21
Lyngby,9644,10,3,9,12,27,47,-20,18
Silkeborg IF,9644,11,5,3,14,25,46,-21,18
FC Midtjylla,9645,1,21,4,5,70,41,29,67
Brondby,9645,2,19,5,6,70,36,34,62
FC Nords,9645,3,16,6,8,75,52,23,54
Copenhagen,9645,4,15,4,11,62,46,16,49
AaB,9645,5,8,11,11,36,43,-7,35
Sonderjyske,9645,6,8,6,10,28,29,-1,30
AC Horsens,9645,7,6,12,12,35,56,-21,30
Randers FC,9645,8,5,7,12,23,39,-16,22
AGF Aarhus,9645,9,5,6,11,18,37,-19,21
Lyngby,9645,10,3,10,11,26,44,-18,19
Silkeborg IF,9645,11,5,3,14,26,46,-20,18
FC Midtjylla,9646,1,20,6,4,69,34,35,66
Brondby,9646,2,20,6,4,66,32,34,66
FC Nords,9646,3,14,6,10,75,53,22,48
Copenhagen,9646,4,14,5,11,59,47,12,47
AaB,9646,5,10,11,9,42,42,0,41
Sonderjyske,9646,6,8,6,10,28,29,-1,30
AC Horsens,9646,7,5,12,13,33,62,-29,27
Randers FC,9646,8,5,7,12,24,40,-16,22
Silkeborg IF,9646,9,6,3,13,28,44,-16,21
Lyngby,9646,10,3,10,11,27,45,-18,19
AGF Aarhus,9646,11,4,6,12,16,39,-23,18
Brondby,9647,1,20,8,2,72,34,38,68
FC Midtjylla,9647,2,19,5,6,70,43,27,62
Copenhagen,9647,3,15,5,10,62,46,16,50
FC Nords,9647,4,13,7,10,76,57,19,46
AC Horsens,9647,5,7,13,10,36,52,-16,34
AaB,9647,6,7,12,11,36,46,-10,33
Sonderjyske,9647,7,8,6,10,28,29,-1,30
Randers FC,9647,8,6,6,12,25,39,-14,24
Silkeborg IF,9647,9,5,4,13,26,45,-19,19
AGF Aarhus,9647,10,4,7,11,17,37,-20,19
Lyngby,9647,11,3,9,12,26,46,-20,18
Brondby,9648,1,22,5,3,68,31,37,71
FC Midtjylla,9648,2,18,5,7,59,40,19,59
Copenhagen,9648,3,15,4,11,59,42,17,49
FC Nords,9648,4,13,7,10,69,50,19,46
AC Horsens,9648,5,8,13,9,34,46,-12,37
AaB,9648,6,7,12,11,37,43,-6,33
Sonderjyske,9648,7,8,6,10,28,29,-1,30
Randers FC,9648,8,6,6,12,27,40,-13,24
Silkeborg IF,9648,9,5,4,13,25,44,-19,19
AGF Aarhus,9648,10,4,7,11,16,36,-20,19
Lyngby,9648,11,3,9,12,27,48,-21,18
Brondby,9649,1,22,5,3,74,30,44,71
FC Midtjylla,9649,2,20,5,5,69,43,26,65
FC Nords,9649,3,15,7,8,73,48,25,52
Copenhagen,9649,4,13,4,13,55,52,3,43
AaB,9649,5,8,13,9,40,40,0,37
Sonderjyske,9649,6,8,6,10,28,29,-1,30
AC Horsens,9649,7,5,12,13,31,55,-24,27
Randers FC,9649,8,6,6,12,25,40,-15,24
Silkeborg IF,9649,9,6,3,13,27,45,-18,21
Lyngby,9649,10,3,9,12,27,46,-19,18
AGF Aarhus,9649,11,4,6,12,17,38,-21,18
Brondby,9650,1,20,7,3,70,33,37,67
FC Midtjylla,9650,2,20,4,6,68,38,30,64
FC Nords,9650,3,14,7,9,70,56,14,49
Copenhagen,9650,4,14,5,11,56,44,12,47
AaB,9650,5,9,11,10,44,41,3,38
Sonderjyske,9650,6,8,6,10,28,29,-1,30
AC Horsens,9650,7,6,12,12,33,55,-22,30
Lyngby,9650,8,4,9,11,28,45,-17,21
Randers FC,9650,9,5,6,13,24,41,-17,21
Silkeborg IF,9650,10,6,3,13,26,44,-18,21
AGF Aarhus,9650,11,4,6,12,16,37,-21,18
Brondby,9651,1,20,6,4,68,33,35,66
FC Midtjylla,9651,2,20,6,4,70,42,28,66
Copenhagen,9651,3,15,4,11,62,45,17,49
FC Nords,9651,4,13,9,8,71,50,21,48
AaB,9651,5,7,13,10,35,43,-8,34
Sonderjyske,9651,6,8,6,10,28,29,-1,30
AC Horsens,9651,7,6,12,12,36,55,-19,30
Randers FC,9651,8,6,6,12,24,39,-15,24
AGF Aarhus,9651,9,5,6,11,18,37,-19,21
Lyngby,9651,10,3,9,12,26,45,-19,18
Silkeborg IF,9651,11,5,3,14,26,46,-20,18
Brondby,9652,1,21,6,3,70,34,36,69
FC Midtjylla,9652,2,18,6,6,67,42,25,60
FC Nords,9652,3,14,8,8,74,52,22,50
Copenhagen,9652,4,14,5,11,57,43,14,47
AaB,9652,5,7,13,10,36,42,-6,34
AC Horsens,9652,6,7,12,11,38,55,-17,33
Sonderjyske,9652,7,8,6,10,28,29,-1,30
Randers FC,9652,8,6,6,12,24,39,-15,24
Silkeborg IF,9652,9,5,4,13,26,45,-19,19
AGF Aarhus,9652,10,4,7,11,17,37,-20,19
Lyngby,9652,11,3,9,12,26,45,-19,18
Brondby,9653,1,20,6,4,68,33,35,66
FC Midtjylla,9653,2,20,5,5,66,39,27,65
FC Nords,9653,3,14,6,10,73,54,19,48
Copenhagen,9653,4,13,5,12,54,43,11,44
AaB,9653,5,9,12,9,41,42,-1,39
AC Horsens,9653,6,7,12,11,34,51,-17,33
Sonderjyske,9653,7,8,6,10,28,29,-1,30
Randers FC,9653,8,5,7,12,25,41,-16,22
Lyngby,9653,9,3,10,11,28,46,-18,19
Silkeborg IF,9653,10,5,4,13,26,45,-19,19
AGF Aarhus,9653,11,4,7,11,17,37,-20,19
Brondby,9654,1,20,7,3,73,35,38,67
FC Midtjylla,9654,2,19,5,6,62,37,25,62
FC Nords,9654,3,14,7,9,70,49,21,49
Copenhagen,9654,4,15,4,11,55,45,10,49
AaB,9654,5,8,12,10,41,42,-1,36
AC Horsens,9654,6,6,13,11,36,55,-19,31
Sonderjyske,9654,7,8,6,10,28,29,-1,30
Lyngby,9654,8,4,9,11,28,45,-17,21
Silkeborg IF,9654,9,6,3,13,27,44,-17,21
Randers FC,9654,10,5,6,13,24,41,-17,21
AGF Aarhus,9654,11,4,6,12,16,38,-22,18
Brondby,9655,1,22,6,2,72,32,40,72
FC Midtjylla,9655,2,17,7,6,61,39,22,58
FC Nords,9655,3,14,7,9,73,50,23,49
Copenhagen,9655,4,13,6,11,59,48,11,45
AaB,9655,5,8,13,9,34,38,-4,37
AC Horsens,9655,6,6,13,11,33,51,-18,31
Sonderjyske,9655,7,8,6,10,28,29,-1,30
Lyngby,9655,8,4,9,11,28,44,-16,21
AGF Aarhus,9655,9,5,6,11,19,36,-17,21
Randers FC,9655,10,5,6,13,23,41,-18,21
Silkeborg IF,9655,11,5,3,14,25,47,-22,18
Brondby,9656,1,19,8,3,68,33,35,65
FC Midtjylla,9656,2,20,5,5,70,42,28,65
FC Nords,9656,3,14,9,7,74,49,25,51
Copenhagen,9656,4,13,4,13,55,48,7,43
AaB,9656,5,7,13,10,36,41,-5,34
AC Horsens,9656,6,7,13,10,35,51,-16,34
Sonderjyske,9656,7,8,6,10,28,29,-1,30
Randers FC,9656,8,6,6,12,25,40,-15,24
Silkeborg IF,9656,9,6,3,13,27,45,-18,21
Lyngby,9656,10,3,9,12,27,46,-19,18
AGF Aarhus,9656,11,4,6,12,17,38,-21,18
Brondby,9657,1,19,7,4,73,40,33,64
FC Midtjylla,9657,2,19,6,5,68,42,26,63
Copenhagen,9657,3,15,5,10,62,45,17,50
FC Nords,9657,4,14,6,10,77,55,22,48
AaB,9657,5,8,13,9,36,40,-4,37
AC Horsens,9657,6,6,13,11,34,54,-20,31
Sonderjyske,9657,7,8,6,10,28,29,-1,30
Randers FC,9657,8,6,6,12,24,39,-15,24
Silkeborg IF,9657,9,6,3,13,27,45,-18,21
Lyngby,9657,10,3,9,12,26,45,-19,18
AGF Aarhus,9657,11,4,6,12,17,38,-21,18
Brondby,9658,1,22,6,2,71,29,42,72
FC Midtjylla,9658,2,20,4,6,68,42,26,64
FC Nords,9658,3,12,8,10,70,56,14,44
Copenhagen,9658,4,13,5,12,58,46,12,44
AaB,9658,5,9,11,10,38,39,-1,38
AC Horsens,9658,6,6,14,10,36,55,-19,32
Sonderjyske,9658,7,8,6,10,28,29,-1,30
Randers FC,9658,8,5,7,12,24,40,-16,22
Silkeborg IF,9658,9,6,3,13,27,45,-18,21
Lyngby,9658,10,3,10,11,27,45,-18,19
AGF Aarhus,9658,11,4,6,12,17,38,-21,18
Brondby,9659,1,20,7,3,68,30,38,67
FC Midtjylla,9659,2,21,4,5,65,34,31,67
Copenhagen,9659,3,14,6,10,55,42,13,48
FC Nords,9659,4,13,7,10,68,53,15,46
AaB,9659,5,7,13,10,36,41,-5,34
Sonderjyske,9659,6,8,6,10,28,29,-1,30
AC Horsens,9659,7,5,15,10,34,52,-18,30
Randers FC,9659,8,5,7,12,23,39,-16,22
Silkeborg IF,9659,9,6,3,13,26,44,-18,21
Lyngby,9659,10,3,10,11,26,44,-18,19
AGF Aarhus,9659,11,4,6,12,16,37,-21,18
Brondby,9660,1,19,6,5,69,40,29,63
FC Midtjylla,9660,2,19,6,5,66,42,24,63
Copenhagen,9660,3,15,5,10,63,44,19,50
FC Nords,9660,4,14,7,9,75,55,20,49
AaB,9660,5,8,11,11,43,45,-2,35
AC Horsens,9660,6,7,13,10,35,51,-16,34
Sonderjyske,9660,7,8,6,10,28,29,-1,30
Randers FC,9660,8,6,6,12,25,40,-15,24
Silkeborg IF,9660,9,6,3,13,29,45,-16,21
Lyngby,9660,10,3,9,12,27,46,-19,18
AGF Aarhus,9660,11,4,6,12,17,40,-23,18
Brondby,9661,1,23,5,2,75,28,47,74
FC Midtjylla,9661,2,20,4,6,67,40,27,64
Copenhagen,9661,3,14,5,11,63,51,12,47
FC Nords,9661,4,13,6,11,73,61,12,45
AaB,9661,5,7,12,11,40,49,-9,33
AC Horsens,9661,6,7,12,11,37,52,-15,33
Sonderjyske,9661,7,8,6,10,28,29,-1,30
Randers FC,9661,8,6,6,12,24,39,-15,24
AGF Aarhus,9661,9,5,6,11,17,36,-19,21
Lyngby,9661,10,3,9,12,26,45,-19,18
Silkeborg IF,9661,11,5,3,14,25,45,-20,18
Brondby,9662,1,19,7,4,67,37,30,64
FC Midtjylla,9662,2,19,5,6,65,40,25,62
FC Nords,9662,3,14,8,8,76,53,23,50
Copenhagen,9662,4,13,5,12,57,49,8,44
AaB,9662,5,9,12,9,44,43,1,39
AC Horsens,9662,6,7,13,10,38,51,-13,34
Sonderjyske,9662,7,8,6,10,28,29,-1,30
Randers FC,9662,8,5,7,12,24,40,-16,22
Silkeborg IF,9662,9,6,3,13,28,44,-16,21
Lyngby,9662,10,3,10,11,27,45,-18,19
AGF Aarhus,9662,11,4,6,12,16,39,-23,18
Brondby,9663,1,22,5,3,71,34,37,71
FC Midtjylla,9663,2,18,6,6,62,38,24,60
FC Nords,9663,3,15,7,8,78,51,27,52
Copenhagen,9663,4,13,5,12,55,48,7,44
AaB,9663,5,7,13,10,37,42,-5,34
AC Horsens,9663,6,6,14,10,36,52,-16,32
Sonderjyske,9663,7,8,6,10,28,29,-1,30
Lyngby,9663,8,4,9,11,30,46,-16,21
Randers FC,9663,9,5,6,13,25,43,-18,21
AGF Aarhus,9663,10,5,6,11,19,37,-18,21
Silkeborg IF,9663,11,5,3,14,26,47,-21,18
Brondby,9664,1,21,6,3,71,32,39,69
FC Midtjylla,9664,2,19,4,7,66,44,22,61
FC Nords,9664,3,15,6,9,73,51,22,51
Copenhagen,9664,4,13,6,11,55,45,10,45
AC Horsens,9664,5,7,14,9,39,52,-13,35
AaB,9664,6,6,14,10,36,42,-6,32
Sonderjyske,9664,7,8,6,10,28,29,-1,30
Randers FC,9664,8,6,6,12,24,39,-15,24
Silkeborg IF,9664,9,6,3,13,26,44,-18,21
Lyngby,9664,10,3,9,12,26,45,-19,18
AGF Aarhus,9664,11,4,6,12,16,37,-21,18
Brondby,9665,1,20,8,2,72,30,42,68
FC Midtjylla,9665,2,20,6,4,68,39,29,66
FC Nords,9665,3,14,7,9,71,50,21,49
Copenhagen,9665,4,13,5,12,55,47,8,44
AaB,9665,5,8,13,9,36,40,-4,37
Sonderjyske,9665,6,8,6,10,28,29,-1,30
AC Horsens,9665,7,5,13,12,34,56,-22,28
Randers FC,9665,8,5,7,12,26,42,-16,22
AGF Aarhus,9665,9,5,6,11,17,36,-19,21
Lyngby,9665,10,3,10,11,29,47,-18,19
Silkeborg IF,9665,11,5,3,14,25,45,-20,18
Brondby,9666,1,20,6,4,68,35,33,66
FC Midtjylla,9666,2,20,5,5,67,41,26,65
Copenhagen,9666,3,16,4,10,66,44,22,52
FC Nords,9666,4,14,6,10,73,50,23,48
AC Horsens,9666,5,7,12,11,32,50,-18,33
AaB,9666,6,7,11,12,39,51,-12,32
Sonderjyske,9666,7,8,6,10,28,29,-1,30
Lyngby,9666,8,4,9,11,29,46,-17,21
Randers FC,9666,9,5,6,13,25,42,-17,21
Silkeborg IF,9666,10,6,3,13,27,45,-18,21
AGF Aarhus,9666,11,4,6,12,17,38,-21,18
Brondby,9667,1,21,6,3,72,31,41,69
FC Midtjylla,9667,2,20,6,4,65,36,29,66
FC Nords,9667,3,15,7,8,74,50,24,52
Copenhagen,9667,4,13,4,13,56,48,8,43
AaB,9667,5,7,12,11,34,41,-7,33
AC Horsens,9667,6,6,13,11,31,52,-21,31
Sonderjyske,9667,7,8,6,10,28,29,-1,30
Randers FC,9667,8,6,6,12,25,40,-15,24
Silkeborg IF,9667,9,6,3,13,29,46,-17,21
Lyngby,9667,10,3,9,12,27,46,-19,18
AGF Aarhus,9667,11,4,6,12,18,40,-22,18
Brondby,9668,1,20,6,4,69,33,36,66
FC Midtjylla,9668,2,20,5,5,65,35,30,65
FC Nords,9668,3,14,8,8,73,52,21,50
Copenhagen,9668,4,13,4,13,55,46,9,43
AaB,9668,5,9,11,10,36,41,-5,38
AC Horsens,9668,6,6,14,10,33,50,-17,32
Sonderjyske,9668,7,8,6,10,28,29,-1,30
Randers FC,9668,8,6,6,12,25,40,-15,24
Silkeborg IF,9668,9,6,3,13,27,44,-17,21
Lyngby,9668,10,3,9,12,27,46,-19,18
AGF Aarhus,9668,11,4,6,12,16,38,-22,18
Brondby,9669,1,21,6,3,68,31,37,69
FC Midtjylla,9669,2,19,5,6,64,40,24,62
Copenhagen,9669,3,15,6,9,57,39,18,51
FC Nords,9669,4,14,6,10,73,53,20,48
AaB,9669,5,7,12,11,35,41,-6,33
AC Horsens,9669,6,6,13,11,35,54,-19,31
Sonderjyske,9669,7,8,6,10,28,29,-1,30
Lyngby,9669,8,4,9,11,28,44,-16,21
Silkeborg IF,9669,9,6,3,13,26,44,-18,21
Randers FC,9669,10,5,6,13,23,41,-18,21
AGF Aarhus,9669,11,4,6,12,16,37,-21,18
Brondby,9670,1,21,6,3,75,37,38,69
FC Midtjylla,9670,2,19,7,4,62,36,26,64
FC Nords,9670,3,15,8,7,78,50,28,53
Copenhagen,9670,4,12,6,12,55,49,6,42
AaB,9670,5,6,14,10,36,45,-9,32
AC Horsens,9670,6,6,13,11,37,52,-15,31
Sonderjyske,9670,7,8,6,10,28,29,-1,30
Randers FC,9670,8,6,6,12,24,39,-15,24
AGF Aarhus,9670,9,5,6,11,17,36,-19,21
Lyngby,9670,10,3,9,12,26,45,-19,18
Silkeborg IF,9670,11,5,3,14,25,45,-20,18
Brondby,9671,1,23,5,2,74,29,45,74
FC Midtjylla,9671,2,20,5,5,67,41,26,65
FC Nords,9671,3,13,7,10,69,50,19,46
Copenhagen,9671,4,13,5,12,55,49,6,44
AC Horsens,9671,5,8,12,10,38,51,-13,36
Sonderjyske,9671,6,8,6,10,28,29,-1,30
AaB,9671,7,6,12,12,36,45,-9,30
Randers FC,9671,8,6,6,12,24,39,-15,24
AGF Aarhus,9671,9,5,6,11,18,36,-18,21
Lyngby,9671,10,3,9,12,26,45,-19,18
Silkeborg IF,9671,11,5,3,14,25,46,-21,18
Brondby,9672,1,21,6,3,71,33,38,69
FC Midtjylla,9672,2,21,5,4,68,34,34,68
FC Nords,9672,3,14,7,9,72,51,21,49
Copenhagen,9672,4,13,5,12,59,49,10,44
AC Horsens,9672,5,7,12,11,34,55,-21,33
AaB,9672,6,7,11,12,33,41,-8,32
Sonderjyske,9672,7,8,6,10,28,29,-1,30
Randers FC,9672,8,6,6,12,25,40,-15,24
Silkeborg IF,9672,9,5,4,13,26,45,-19,19
AGF Aarhus,9672,10,4,7,11,17,37,-20,19
Lyngby,9672,11,3,9,12,27,46,-19,18
Brondby,9673,1,21,6,3,68,30,38,69
FC Midtjylla,9673,2,18,5,7,62,41,21,59
FC Nords,9673,3,15,7,8,72,48,24,52
Copenhagen,9673,4,13,6,11,57,45,12,45
AaB,9673,5,7,13,10,37,42,-5,34
AC Horsens,9673,6,6,15,9,33,49,-16,33
Sonderjyske,9673,7,8,6,10,28,29,-1,30
Randers FC,9673,8,6,6,12,24,39,-15,24
AGF Aarhus,9673,9,5,6,11,19,37,-18,21
Lyngby,9673,10,3,9,12,26,45,-19,18
Silkeborg IF,9673,11,5,3,14,26,47,-21,18
FC Midtjylla,9674,1,21,5,4,69,38,31,68
Brondby,9674,2,19,6,5,70,36,34,63
FC Nords,9674,3,16,7,7,76,50,26,55
Copenhagen,9674,4,13,4,13,60,52,8,43
AC Horsens,9674,5,7,13,10,33,51,-18,34
AaB,9674,6,6,13,11,34,41,-7,31
Sonderjyske,9674,7,8,6,10,28,29,-1,30
Lyngby,9674,8,4,9,11,30,46,-16,21
Randers FC,9674,9,5,6,13,25,43,-18,21
AGF Aarhus,9674,10,5,6,11,19,37,-18,21
Silkeborg IF,9674,11,5,3,14,26,47,-21,18
Brondby,9675,1,21,6,3,72,29,43,69
FC Midtjylla,9675,2,19,5,6,64,39,25,62
FC Nords,9675,3,14,6,10,74,53,21,48
Copenhagen,9675,4,14,6,10,58,45,13,48
AaB,9675,5,7,13,10,35,41,-6,34
AC Horsens,9675,6,6,14,10,34,56,-22,32
Sonderjyske,9675,7,8,6,10,28,29,-1,30
Lyngby,9675,8,4,9,11,28,44,-16,21
Randers FC,9675,9,5,6,13,23,41,-18,21
AGF Aarhus,9675,10,5,6,11,19,38,-19,21
Silkeborg IF,9675,11,5,3,14,27,47,-20,18
Brondby,9676,1,20,7,3,70,33,37,67
FC Midtjylla,9676,2,19,4,7,69,45,24,61
Copenhagen,9676,3,15,6,9,61,44,17,51
FC Nords,9676,4,13,9,8,78,54,24,48
AaB,9676,5,7,12,11,39,47,-8,33
AC Horsens,9676,6,6,14,10,36,56,-20,32
Sonderjyske,9676,7,8,6,10,28,29,-1,30
Lyngby,9676,8,4,9,11,29,45,-16,21
Randers FC,9676,9,5,6,13,24,42,-18,21
Silkeborg IF,9676,10,5,4,13,27,46,-19,19
AGF Aarhus,9676,11,4,7,11,18,38,-20,19
Brondby,9677,1,20,7,3,72,35,37,67
FC Midtjylla,9677,2,20,5,5,68,38,30,65
FC Nords,9677,3,15,7,8,75,53,22,52
Copenhagen,9677,4,13,6,11,58,47,11,45
AaB,9677,5,7,13,10,37,42,-5,34
Sonderjyske,9677,6,8,6,10,28,29,-1,30
AC Horsens,9677,7,6,12,12,38,59,-21,30
Randers FC,9677,8,6,6,12,24,39,-15,24
AGF Aarhus,9677,9,5,6,11,19,36,-17,21
Lyngby,9677,10,3,9,12,26,45,-19,18
Silkeborg IF,9677,11,5,3,14,25,47,-22,18
Brondby,9678,1,22,5,3,79,37,42,71
FC Midtjylla,9678,2,18,5,7,60,42,18,59
FC Nords,9678,3,14,8,8,75,52,23,50
Copenhagen,9678,4,15,5,10,65,43,22,50
AaB,9678,5,7,13,10,38,48,-10,34
Sonderjyske,9678,6,8,6,10,28,29,-1,30
AC Horsens,9678,7,6,12,12,37,58,-21,30
Lyngby,9678,8,4,9,11,28,44,-16,21
Silkeborg IF,9678,9,6,3,13,28,45,-17,21
Randers FC,9678,10,5,6,13,23,41,-18,21
AGF Aarhus,9678,11,4,6,12,17,39,-22,18
Brondby,9679,1,22,6,2,72,31,41,72
FC Midtjylla,9679,2,20,5,5,63,34,29,65
FC Nords,9679,3,14,6,10,74,51,23,48
Copenhagen,9679,4,13,6,11,53,43,10,45
AaB,9679,5,6,14,10,33,43,-10,32
AC Horsens,9679,6,6,13,11,34,53,-19,31
Sonderjyske,9679,7,8,6,10,28,29,-1,30
Randers FC,9679,8,5,7,12,24,40,-16,22
AGF Aarhus,9679,9,5,6,11,18,37,-19,21
Lyngby,9679,10,3,10,11,27,45,-18,19
Silkeborg IF,9679,11,5,3,14,26,46,-20,18
Brondby,9680,1,20,7,3,74,36,38,67
FC Midtjylla,9680,2,19,7,4,64,38,26,64
Copenhagen,9680,3,14,5,11,59,45,14,47
FC Nords,9680,4,13,7,10,69,53,16,46
AC Horsens,9680,5,7,13,10,35,49,-14,34
AaB,9680,6,6,15,9,35,41,-6,33
Sonderjyske,9680,7,8,6,10,28,29,-1,30
Randers FC,9680,8,5,7,12,24,40,-16,22
Silkeborg IF,9680,9,6,3,13,26,44,-18,21
Lyngby,9680,10,3,10,11,27,45,-18,19
AGF Aarhus,9680,11,4,6,12,16,37,-21,18
Brondby,9681,1,21,5,4,73,33,40,68
FC Midtjylla,9681,2,19,5,6,66,37,29,62
FC Nords,9681,3,13,8,9,69,52,17,47
Copenhagen,9681,4,13,8,9,57,43,14,47
AaB,9681,5,8,13,9,36,39,-3,37
AC Horsens,9681,6,6,13,11,36,59,-23,31
Sonderjyske,9681,7,8,6,10,28,29,-1,30
Randers FC,9681,8,6,6,12,25,39,-14,24
Silkeborg IF,9681,9,5,4,13,25,44,-19,19
AGF Aarhus,9681,10,4,7,11,16,36,-20,19
Lyngby,9681,11,3,9,12,26,46,-20,18
Brondby,9682,1,22,6,2,71,26,45,72
FC Midtjylla,9682,2,21,4,5,70,37,33,67
Copenhagen,9682,3,14,5,11,59,47,12,47
FC Nords,9682,4,13,7,10,72,57,15,46
AaB,9682,5,7,13,10,34,43,-9,34
Sonderjyske,9682,6,8,6,10,28,29,-1,30
AC Horsens,9682,7,5,13,12,33,55,-22,28
Randers FC,9682,8,5,7,12,23,39,-16,22
Silkeborg IF,9682,9,6,3,13,29,44,-15,21
Lyngby,9682,10,3,10,11,26,44,-18,19
AGF Aarhus,9682,11,4,6,12,16,40,-24,18
Brondby,9683,1,20,7,3,72,36,36,67
FC Midtjylla,9683,2,19,6,5,63,37,26,63
Copenhagen,9683,3,16,4,10,63,45,18,52
FC Nords,9683,4,13,9,8,74,52,22,48
AaB,9683,5,7,12,11,36,45,-9,33
Sonderjyske,9683,6,8,6,10,28,29,-1,30
AC Horsens,9683,7,5,14,11,34,53,-19,29
Lyngby,9683,8,4,9,11,27,44,-17,21
Randers FC,9683,9,5,6,13,23,40,-17,21
Silkeborg IF,9683,10,5,4,13,26,45,-19,19
AGF Aarhus,9683,11,4,7,11,17,37,-20,19
FC Midtjylla,9684,1,20,6,4,69,39,30,66
Brondby,9684,2,19,8,3,65,29,36,65
Copenhagen,9684,3,15,6,9,59,42,17,51
FC Nords,9684,4,13,7,10,69,53,16,46
AaB,9684,5,7,13,10,38,43,-5,34
Sonderjyske,9684,6,8,6,10,28,29,-1,30
AC Horsens,9684,7,5,14,11,31,51,-20,29
Lyngby,9684,8,4,9,11,30,46,-16,21
Randers FC,9684,9,5,6,13,25,43,-18,21
Silkeborg IF,9684,10,5,4,13,26,45,-19,19
AGF Aarhus,9684,11,4,7,11,17,37,-20,19
Brondby,9685,1,20,8,2,73,34,39,68
FC Midtjylla,9685,2,20,6,4,65,36,29,66
FC Nords,9685,3,13,7,10,70,54,16,46
Copenhagen,9685,4,12,5,13,54,49,5,41
AaB,9685,5,9,12,9,44,40,4,39
AC Horsens,9685,6,6,14,10,36,55,-19,32
Sonderjyske,9685,7,8,6,10,28,29,-1,30
Lyngby,9685,8,4,9,11,29,45,-16,21
Randers FC,9685,9,5,6,13,24,42,-18,21
AGF Aarhus,9685,10,5,6,11,20,38,-18,21
Silkeborg IF,9685,11,5,3,14,27,48,-21,18
Brondby,9686,1,21,6,3,74,34,40,69
FC Midtjylla,9686,2,18,7,5,64,38,26,61
FC Nords,9686,3,15,6,9,71,51,20,51
Copenhagen,9686,4,15,5,10,59,43,16,50
AaB,9686,5,7,11,12,37,45,-8,32
AC Horsens,9686,6,6,13,11,31,51,-20,31
Sonderjyske,9686,7,8,6,10,28,29,-1,30
Randers FC,9686,8,5,7,12,23,39,-16,22
AGF Aarhus,9686,9,5,6,11,18,36,-18,21
Lyngby,9686,10,3,10,11,26,44,-18,19
Silkeborg IF,9686,11,5,3,14,25,46,-21,18
Brondby,9687,1,21,7,2,76,30,46,70
FC Midtjylla,9687,2,19,5,6,63,37,26,62
Copenhagen,9687,3,14,6,10,58,43,15,48
FC Nords,9687,4,13,7,10,68,54,14,46
AC Horsens,9687,5,8,14,8,37,47,-10,38
Sonderjyske,9687,6,8,6,10,28,29,-1,30
AaB,9687,7,6,11,13,31,48,-17,29
Randers FC,9687,8,6,6,12,24,39,-15,24
Silkeborg IF,9687,9,6,3,13,27,45,-18,21
Lyngby,9687,10,3,9,12,26,45,-19,18
AGF Aarhus,9687,11,4,6,12,17,38,-21,18
Brondby,9688,1,21,6,3,71,34,37,69
FC Midtjylla,9688,2,20,6,4,69,38,31,66
Copenhagen,9688,3,15,6,9,61,43,18,51
FC Nords,9688,4,14,6,10,77,56,21,48
Sonderjyske,9688,5,8,6,10,28,29,-1,30
AaB,9688,6,6,12,12,35,45,-10,30
AC Horsens,9688,7,6,12,12,33,56,-23,30
Randers FC,9688,8,6,6,12,28,39,-11,24
AGF Aarhus,9688,9,5,6,11,19,37,-18,21
Silkeborg IF,9688,10,5,3,14,26,47,-21,18
Lyngby,9688,11,3,9,12,26,49,-23,18
Brondby,9689,1,20,8,2,70,33,37,68
FC Midtjylla,9689,2,17,7,6,59,38,21,58
Copenhagen,9689,3,13,7,10,60,47,13,46
FC Nords,9689,4,12,8,10,74,57,17,44
AaB,9689,5,9,12,9,38,39,-1,39
AC Horsens,9689,6,7,14,9,36,49,-13,35
Sonderjyske,9689,7,8,6,10,28,29,-1,30
Lyngby,9689,8,4,9,11,29,46,-17,21
Randers FC,9689,9,5,6,13,25,42,-17,21
Silkeborg IF,9689,10,6,3,13,26,44,-18,21
AGF Aarhus,9689,11,4,6,12,16,37,-21,18
Brondby,9690,1,22,6,2,75,30,45,72
FC Midtjylla,9690,2,19,5,6,66,40,26,62
Copenhagen,9690,3,15,4,11,61,44,17,49
FC Nords,9690,4,13,9,8,69,49,20,48
AaB,9690,5,6,13,11,33,45,-12,31
AC Horsens,9690,6,6,13,11,35,57,-22,31
Sonderjyske,9690,7,8,6,10,28,29,-1,30
Lyngby,9690,8,4,9,11,28,45,-17,21
Silkeborg IF,9690,9,6,3,13,27,44,-17,21
Randers FC,9690,10,5,6,13,24,41,-17,21
AGF Aarhus,9690,11,4,6,12,16,38,-22,18
Brondby,9691,1,22,6,2,72,30,42,72
FC Midtjylla,9691,2,18,5,7,64,44,20,59
Copenhagen,9691,3,15,5,10,60,44,16,50
FC Nords,9691,4,14,6,10,70,49,21,48
AaB,9691,5,8,12,10,36,41,-5,36
Sonderjyske,9691,6,8,6,10,28,29,-1,30
AC Horsens,9691,7,6,12,12,36,56,-20,30
Lyngby,9691,8,4,9,11,28,45,-17,21
Randers FC,9691,9,5,6,13,24,41,-17,21
AGF Aarhus,9691,10,5,6,11,18,37,-19,21
Silkeborg IF,9691,11,5,3,14,26,46,-20,18
Brondby,9692,1,22,5,3,77,34,43,71
FC Midtjylla,9692,2,20,4,6,67,41,26,64
FC Nords,9692,3,14,6,10,74,53,21,48
Copenhagen,9692,4,14,4,12,58,45,13,46
AaB,9692,5,9,11,10,37,40,-3,38
Sonderjyske,9692,6,8,6,10,28,29,-1,30
AC Horsens,9692,7,6,12,12,31,57,-26,30
Randers FC,9692,8,6,6,12,27,39,-12,24
Silkeborg IF,9692,9,6,3,13,27,45,-18,21
AGF Aarhus,9692,10,4,6,12,17,38,-21,18
Lyngby,9692,11,3,9,12,26,48,-22,18
Brondby,9693,1,20,6,4,69,31,38,66
FC Midtjylla,9693,2,18,7,5,62,37,25,61
Copenhagen,9693,3,15,5,10,57,44,13,50
FC Nords,9693,4,14,6,10,73,57,16,48
AaB,9693,5,8,12,10,39,39,0,36
AC Horsens,9693,6,7,12,11,33,51,-18,33
Sonderjyske,9693,7,8,6,10,28,29,-1,30
Lyngby,9693,8,4,9,11,31,44,-13,21
Silkeborg IF,9693,9,6,3,13,27,45,-18,21
Randers FC,9693,10,5,6,13,23,44,-21,21
AGF Aarhus,9693,11,4,6,12,17,38,-21,18
Brondby,9694,1,21,7,2,72,30,42,70
FC Midtjylla,9694,2,18,6,6,61,40,21,60
FC Nords,9694,3,15,8,7,74,48,26,53
Copenhagen,9694,4,14,4,12,59,47,12,46
AaB,9694,5,7,12,11,35,44,-9,33
Sonderjyske,9694,6,8,6,10,28,29,-1,30
AC Horsens,9694,7,5,15,10,33,51,-18,30
Lyngby,9694,8,4,9,11,28,44,-16,21
Randers FC,9694,9,5,6,13,23,41,-18,21
Silkeborg IF,9694,10,5,4,13,26,45,-19,19
AGF Aarhus,9694,11,4,7,11,17,37,-20,19
Brondby,9695,1,22,6,2,73,32,41,72
FC Midtjylla,9695,2,19,4,7,63,42,21,61
FC Nords,9695,3,14,6,10,73,50,23,48
Copenhagen,9695,4,13,6,11,59,47,12,45
AaB,9695,5,8,12,10,38,43,-5,36
AC Horsens,9695,6,6,14,10,34,52,-18,32
Sonderjyske,9695,7,8,6,10,28,29,-1,30
Lyngby,9695,8,4,9,11,28,45,-17,21
Randers FC,9695,9,5,6,13,24,41,-17,21
AGF Aarhus,9695,10,5,6,11,17,36,-19,21
Silkeborg IF,9695,11,5,3,14,25,45,-20,18
Brondby,9696,1,21,5,4,68,32,36,68
FC Midtjylla,9696,2,19,5,6,65,40,25,62
FC Nords,9696,3,15,7,8,79,50,29,52
Copenhagen,9696,4,15,4,11,58,45,13,49
AaB,9696,5,8,11,11,38,44,-6,35
Sonderjyske,9696,6,8,6,10,28,29,-1,30
AC Horsens,9696,7,6,12,12,31,54,-23,30
Randers FC,9696,8,6,6,12,24,39,-15,24
AGF Aarhus,9696,9,5,6,11,17,36,-19,21
Lyngby,9696,10,3,9,12,26,45,-19,18
Silkeborg IF,9696,11,5,3,14,25,45,-20,18
FC Midtjylla,9697,1,20,5,5,72,43,29,65
Brondby,9697,2,18,7,5,67,41,26,61
FC Nords,9697,3,15,6,9,72,49,23,51
Copenhagen,9697,4,15,5,10,59,42,17,50
AaB,9697,5,8,11,11,39,43,-4,35
AC Horsens,9697,6,7,12,11,37,54,-17,33
Sonderjyske,9697,7,8,6,10,28,29,-1,30
Randers FC,9697,8,6,6,12,24,39,-15,24
Silkeborg IF,9697,9,5,4,13,25,44,-19,19
AGF Aarhus,9697,10,4,7,11,16,36,-20,19
Lyngby,9697,11,3,9,12,26,45,-19,18
Brondby,9698,1,20,6,4,71,36,35,66
FC Midtjylla,9698,2,20,5,5,67,39,28,65
Copenhagen,9698,3,15,4,11,61,44,17,49
FC Nords,9698,4,13,6,11,72,55,17,45
AaB,9698,5,10,11,9,41,43,-2,41
Sonderjyske,9698,6,8,6,10,28,29,-1,30
AC Horsens,9698,7,6,12,12,36,57,-21,30
Randers FC,9698,8,6,6,12,27,39,-12,24
AGF Aarhus,9698,9,5,6,11,20,37,-17,21
Lyngby,9698,10,3,9,12,26,48,-22,18
Silkeborg IF,9698,10,5,3,14,26,48,-22,18
Brondby,9699,1,21,6,3,70,33,37,69
FC Midtjylla,9699,2,18,5,7,64,40,24,59
FC Nords,9699,3,13,8,9,73,52,21,47
Copenhagen,9699,4,13,7,10,55,43,12,46
AaB,9699,5,8,13,9,35,39,-4,37
AC Horsens,9699,6,7,13,10,35,51,-16,34
Sonderjyske,9699,7,8,6,10,28,29,-1,30
Lyngby,9699,8,4,9,11,32,45,-13,21
Silkeborg IF,9699,9,6,3,13,27,44,-17,21
Randers FC,9699,10,5,6,13,24,45,-21,21
AGF Aarhus,9699,11,4,6,12,16,38,-22,18
Brondby,9700,1,22,6,2,71,27,44,72
FC Midtjylla,9700,2,20,4,6,68,37,31,64
FC Nords,9700,3,13,8,9,67,50,17,47
Copenhagen,9700,4,13,6,11,58,48,10,45
AaB,9700,5,7,13,10,35,43,-8,34
AC Horsens,9700,6,6,13,11,33,53,-20,31
Sonderjyske,9700,7,8,6,10,28,29,-1,30
Lyngby,9700,8,4,9,11,28,44,-16,21
Silkeborg IF,9700,9,6,3,13,26,44,-18,21
Randers FC,9700,10,5,6,13,23,41,-18,21
AGF Aarhus,9700,11,4,6,12,16,37,-21,18
Brondby,9701,1,22,6,2,76,32,44,72
FC Midtjylla,9701,2,20,5,5,68,42,26,65
FC Nords,9701,3,14,8,8,77,55,22,50
Copenhagen,9701,4,13,6,11,58,45,13,45
AaB,9701,5,7,12,11,36,46,-10,33
Sonderjyske,9701,6,8,6,10,28,29,-1,30
AC Horsens,9701,7,5,13,12,34,55,-21,28
Randers FC,9701,8,6,6,12,25,40,-15,24
Silkeborg IF,9701,9,5,4,13,26,45,-19,19
AGF Aarhus,9701,10,4,7,11,17,37,-20,19
Lyngby,9701,11,3,9,12,27,46,-19,18
Brondby,9702,1,20,5,5,69,37,32,65
FC Midtjylla,9702,2,20,5,5,66,40,26,65
FC Nords,9702,3,14,7,9,70,50,20,49
Copenhagen,9702,4,14,4,12,57,43,14,46
AC Horsens,9702,5,8,14,8,37,47,-10,38
AaB,9702,6,7,11,12,35,43,-8,32
Sonderjyske,9702,7,8,6,10,28,29,-1,30
Randers FC,9702,8,6,6,12,24,39,-15,24
Silkeborg IF,9702,9,6,3,13,27,45,-18,21
Lyngby,9702,10,3,9,12,26,45,-19,18
AGF Aarhus,9702,11,4,6,12,17,38,-21,18
Brondby,9703,1,22,5,3,74,36,38,71
FC Midtjylla,9703,2,19,6,5,68,42,26,63
FC Nords,9703,3,14,6,10,72,51,21,48
Copenhagen,9703,4,13,5,12,57,47,10,44
AaB,9703,5,8,13,9,39,41,-2,37
Sonderjyske,9703,6,8,6,10,28,29,-1,30
AC Horsens,9703,7,5,15,10,34,53,-19,30
Randers FC,9703,8,5,7,12,24,40,-16,22
Lyngby,9703,9,3,10,11,27,45,-18,19
Silkeborg IF,9703,10,5,4,13,26,45,-19,19
AGF Aarhus,9703,11,4,7,11,17,37,-20,19
Brondby,9704,1,21,5,4,67,32,35,68
FC Midtjylla,9704,2,21,5,4,72,39,33,68
FC Nords,9704,3,14,6,10,69,48,21,48
Copenhagen,9704,4,13,6,11,56,46,10,45
AaB,9704,5,8,11,11,36,42,-6,35
AC Horsens,9704,6,6,13,11,32,51,-19,31
Sonderjyske,9704,7,8,6,10,28,29,-1,30
Lyngby,9704,8,4,9,11,30,44,-14,21
Silkeborg IF,9704,9,6,3,13,28,44,-16,21
Randers FC,9704,10,5,6,13,23,43,-20,21
AGF Aarhus,9704,11,4,6,12,16,39,-23,18
Brondby,9705,1,22,6,2,79,33,46,72
FC Midtjylla,9705,2,19,6,5,65,38,27,63
FC Nords,9705,3,14,7,9,79,58,21,49
Copenhagen,9705,4,13,6,11,60,46,14,45
AC Horsens,9705,5,7,14,9,36,51,-15,35
Sonderjyske,9705,6,8,6,10,28,29,-1,30
AaB,9705,7,6,11,13,35,54,-19,29
Silkeborg IF,9705,8,6,3,13,29,44,-15,21
Lyngby,9705,9,4,9,11,27,44,-17,21
Randers FC,9705,10,5,6,13,23,40,-17,21
AGF Aarhus,9705,11,4,6,12,16,40,-24,18
Brondby,9706,1,22,6,2,70,30,40,72
FC Midtjylla,9706,2,19,6,5,65,41,24,63
FC Nords,9706,3,15,7,8,74,49,25,52
Copenhagen,9706,4,14,4,12,58,44,14,46
AaB,9706,5,7,11,12,35,43,-8,32
Sonderjyske,9706,6,8,6,10,28,29,-1,30
AC Horsens,9706,7,6,12,12,32,53,-21,30
Randers FC,9706,8,5,7,12,25,41,-16,22
Lyngby,9706,9,3,10,11,28,46,-18,19
Silkeborg IF,9706,10,5,4,13,26,45,-19,19
AGF Aarhus,9706,11,4,7,11,17,37,-20,19
Brondby,9707,1,22,6,2,76,31,45,72
FC Midtjylla,9707,2,18,4,8,63,41,22,58
FC Nords,9707,3,15,6,9,73,53,20,51
Copenhagen,9707,4,15,5,10,61,44,17,50
AaB,9707,5,8,11,11,35,42,-7,35
Sonderjyske,9707,6,8,6,10,28,29,-1,30
AC Horsens,9707,7,6,12,12,32,55,-23,30
Lyngby,9707,8,4,9,11,28,45,-17,21
Randers FC,9707,9,5,6,13,24,41,-17,21
Silkeborg IF,9707,10,5,4,13,25,44,-19,19
AGF Aarhus,9707,11,4,7,11,16,36,-20,19
Brondby,9708,1,20,6,4,71,34,37,66
FC Midtjylla,9708,2,17,5,8,60,42,18,56
FC Nords,9708,3,14,8,8,76,50,26,50
Copenhagen,9708,4,15,5,10,54,43,11,50
AaB,9708,5,8,13,9,41,43,-2,37
AC Horsens,9708,6,7,13,10,35,51,-16,34
Sonderjyske,9708,7,8,6,10,28,29,-1,30
Lyngby,9708,8,4,9,11,28,44,-16,21
Randers FC,9708,9,5,6,13,23,41,-18,21
AGF Aarhus,9708,10,5,6,11,17,36,-19,21
Silkeborg IF,9708,11,5,3,14,25,45,-20,18
Brondby,9709,1,21,6,3,77,33,44,69
FC Midtjylla,9709,2,21,5,4,76,37,39,68
FC Nords,9709,3,13,9,8,73,52,21,48
Copenhagen,9709,4,14,4,12,57,46,11,46
AaB,9709,5,7,12,11,35,49,-14,33
Sonderjyske,9709,6,8,6,10,28,29,-1,30
AC Horsens,9709,7,6,12,12,32,59,-27,30
Lyngby,9709,8,4,9,11,29,45,-16,21
AGF Aarhus,9709,9,5,6,11,20,37,-17,21
Randers FC,9709,10,5,6,13,24,42,-18,21
Silkeborg IF,9709,11,5,3,14,26,48,-22,18
FC Midtjylla,9710,1,21,5,4,68,35,33,68
Brondby,9710,2,20,5,5,70,35,35,65
Copenhagen,9710,3,15,6,9,59,39,20,51
FC Nords,9710,4,14,6,10,70,54,16,48
AaB,9710,5,7,12,11,35,42,-7,33
Sonderjyske,9710,6,8,6,10,28,29,-1,30
AC Horsens,9710,7,6,12,12,34,57,-23,30
Randers FC,9710,8,6,6,12,24,39,-15,24
Silkeborg IF,9710,9,6,3,13,26,44,-18,21
Lyngby,9710,10,3,9,12,26,45,-19,18
AGF Aarhus,9710,11,4,6,12,16,37,-21,18
Brondby,9711,1,22,5,3,74,32,42,71
FC Midtjylla,9711,2,20,4,6,66,38,28,64
FC Nords,9711,3,14,6,10,73,56,17,48
Copenhagen,9711,4,14,4,12,58,46,12,46
AC Horsens,9711,5,9,12,9,38,50,-12,39
Sonderjyske,9711,6,8,6,10,28,29,-1,30
AaB,9711,7,6,11,13,39,52,-13,29
Randers FC,9711,8,6,6,12,25,40,-15,24
Silkeborg IF,9711,9,6,3,13,26,44,-18,21
Lyngby,9711,10,3,9,12,27,46,-19,18
AGF Aarhus,9711,11,4,6,12,16,37,-21,18
FC Midtjylla,9712,1,21,5,4,69,37,32,68
Brondby,9712,2,20,6,4,68,32,36,66
Copenhagen,9712,3,15,6,9,57,39,18,51
FC Nords,9712,4,13,8,9,71,55,16,47
AaB,9712,5,7,12,11,35,43,-8,33
Sonderjyske,9712,6,8,6,10,28,29,-1,30
AC Horsens,9712,7,5,13,12,29,49,-20,28
Randers FC,9712,8,6,6,12,25,40,-15,24
Silkeborg IF,9712,9,6,3,13,27,44,-17,21
Lyngby,9712,10,3,9,12,27,46,-19,18
AGF Aarhus,9712,11,4,6,12,16,38,-22,18
Brondby,9713,1,21,6,3,71,35,36,69
FC Midtjylla,9713,2,20,5,5,69,41,28,65
FC Nords,9713,3,14,8,8,79,53,26,50
Copenhagen,9713,4,14,6,10,56,43,13,48
AaB,9713,5,6,13,11,38,46,-8,31
Sonderjyske,9713,6,8,6,10,28,29,-1,30
AC Horsens,9713,7,5,14,11,34,55,-21,29
Silkeborg IF,9713,8,6,3,13,29,44,-15,21
Lyngby,9713,9,4,9,11,28,44,-16,21
Randers FC,9713,10,5,6,13,23,41,-18,21
AGF Aarhus,9713,11,4,6,12,16,40,-24,18
Brondby,9714,1,22,6,2,72,31,41,72
FC Midtjylla,9714,2,17,6,7,63,44,19,57
Copenhagen,9714,3,14,6,10,60,45,15,48
FC Nords,9714,4,12,10,8,72,53,19,46
AaB,9714,5,7,13,10,37,44,-7,34
AC Horsens,9714,6,7,13,10,35,48,-13,34
Sonderjyske,9714,7,8,6,10,28,29,-1,30
Lyngby,9714,8,4,9,11,28,44,-16,21
Randers FC,9714,9,5,6,13,23,41,-18,21
Silkeborg IF,9714,10,5,4,13,26,45,-19,19
AGF Aarhus,9714,11,4,7,11,17,37,-20,19
FC Midtjylla,9715,1,21,4,5,67,37,30,67
Brondby,9715,2,20,5,5,67,33,34,65
FC Nords,9715,3,16,6,8,79,50,29,54
Copenhagen,9715,4,12,6,12,54,46,8,42
AaB,9715,5,7,13,10,38,50,-12,34
AC Horsens,9715,6,6,14,10,36,51,-15,32
Sonderjyske,9715,7,8,6,10,28,29,-1,30
Lyngby,9715,8,4,9,11,31,44,-13,21
Silkeborg IF,9715,9,6,3,13,27,45,-18,21
Randers FC,9715,10,5,6,13,23,44,-21,21
AGF Aarhus,9715,11,4,6,12,17,38,-21,18
FC Midtjylla,9716,1,22,4,4,73,40,33,70
Brondby,9716,2,20,6,4,72,35,37,66
Copenhagen,9716,3,14,5,11,56,47,9,47
FC Nords,9716,4,13,7,10,76,54,22,46
AaB,9716,5,6,15,9,38,47,-9,33
AC Horsens,9716,6,6,13,11,35,53,-18,31
Sonderjyske,9716,7,8,6,10,28,29,-1,30
Lyngby,9716,8,4,9,11,29,46,-17,21
Randers FC,9716,9,5,6,13,25,42,-17,21
Silkeborg IF,9716,10,5,4,13,25,44,-19,19
AGF Aarhus,9716,11,4,7,11,16,36,-20,19
FC Midtjylla,9717,1,20,4,6,65,40,25,64
Brondby,9717,2,19,6,5,66,35,31,63
FC Nords,9717,3,14,7,9,70,47,23,49
Copenhagen,9717,4,15,4,11,61,44,17,49
AC Horsens,9717,5,9,12,9,36,49,-13,39
AaB,9717,6,6,13,11,33,42,-9,31
Sonderjyske,9717,7,8,6,10,28,29,-1,30
Randers FC,9717,8,6,6,12,27,40,-13,24
Silkeborg IF,9717,9,6,3,13,27,45,-18,21
Lyngby,9717,10,3,9,12,27,48,-21,18
AGF Aarhus,9717,11,4,6,12,17,38,-21,18
Brondby,9718,1,22,6,2,73,27,46,72
FC Midtjylla,9718,2,21,5,4,68,36,32,68
FC Nords,9718,3,14,7,9,72,51,21,49
Copenhagen,9718,4,13,6,11,56,44,12,45
AC Horsens,9718,5,6,13,11,37,60,-23,31
Sonderjyske,9718,6,8,6,10,28,29,-1,30
AaB,9718,7,6,11,13,35,49,-14,29
Randers FC,9718,8,5,7,12,24,40,-16,22
Silkeborg IF,9718,9,6,3,13,29,45,-16,21
Lyngby,9718,10,3,10,11,27,45,-18,19
AGF Aarhus,9718,11,4,6,12,17,40,-23,18
Brondby,9719,1,21,6,3,71,31,40,69
FC Midtjylla,9719,2,19,5,6,67,42,25,62
Copenhagen,9719,3,15,6,9,63,44,19,51
FC Nords,9719,4,12,7,11,72,59,13,43
AC Horsens,9719,5,8,13,9,38,51,-13,37
AaB,9719,6,7,11,12,35,45,-10,32
Sonderjyske,9719,7,8,6,10,28,29,-1,30
Lyngby,9719,8,4,9,11,31,45,-14,21
Silkeborg IF,9719,9,6,3,13,27,45,-18,21
Randers FC,9719,10,5,6,13,24,44,-20,21
AGF Aarhus,9719,11,4,6,12,17,38,-21,18
Brondby,9720,1,19,8,3,67,33,34,65
FC Midtjylla,9720,2,18,8,4,63,37,26,62
FC Nords,9720,3,13,8,9,74,53,21,47
Copenhagen,9720,4,13,7,10,56,43,13,46
AC Horsens,9720,5,7,14,9,38,52,-14,35
AaB,9720,6,7,13,10,39,45,-6,34
Sonderjyske,9720,7,8,6,10,28,29,-1,30
Randers FC,9720,8,5,7,12,25,41,-16,22
Silkeborg IF,9720,9,6,3,13,27,45,-18,21
Lyngby,9720,10,3,10,11,28,46,-18,19
AGF Aarhus,9720,11,4,6,12,17,38,-21,18
Brondby,9721,1,20,6,4,69,34,35,66
FC Midtjylla,9721,2,17,5,8,63,47,16,56
FC Nords,9721,3,15,6,9,71,49,22,51
Copenhagen,9721,4,15,5,10,61,45,16,50
AC Horsens,9721,5,8,13,9,39,51,-12,37
AaB,9721,6,8,11,11,39,42,-3,35
Sonderjyske,9721,7,8,6,10,28,29,-1,30
Randers FC,9721,8,5,7,12,24,40,-16,22
AGF Aarhus,9721,9,5,6,11,18,37,-19,21
Lyngby,9721,10,3,10,11,27,45,-18,19
Silkeborg IF,9721,11,5,3,14,26,46,-20,18
Brondby,9722,1,21,6,3,72,33,39,69
FC Midtjylla,9722,2,19,5,6,66,39,27,62
FC Nords,9722,3,15,6,9,74,55,19,51
Copenhagen,9722,4,14,5,11,56,43,13,47
AaB,9722,5,8,13,9,36,38,-2,37
Sonderjyske,9722,6,8,6,10,28,29,-1,30
AC Horsens,9722,7,5,13,12,29,51,-22,28
Lyngby,9722,8,4,9,11,30,44,-14,21
Randers FC,9722,9,5,6,13,23,43,-20,21
Silkeborg IF,9722,10,5,4,13,25,44,-19,19
AGF Aarhus,9722,11,4,7,11,16,36,-20,19
Brondby,9723,1,22,6,2,76,32,44,72
FC Midtjylla,9723,2,19,6,5,65,40,25,63
FC Nords,9723,3,13,8,9,78,56,22,47
Copenhagen,9723,4,12,5,13,54,48,6,41
AaB,9723,5,8,14,8,40,41,-1,38
AC Horsens,9723,6,6,13,11,35,57,-22,31
Sonderjyske,9723,7,8,6,10,28,29,-1,30
Randers FC,9723,8,5,7,12,24,40,-16,22
Silkeborg IF,9723,9,6,3,13,27,44,-17,21
Lyngby,9723,10,3,10,11,27,45,-18,19
AGF Aarhus,9723,11,4,6,12,16,38,-22,18
Brondby,9724,1,23,5,2,72,29,43,74
FC Midtjylla,9724,2,19,5,6,65,40,25,62
Copenhagen,9724,3,14,5,11,61,46,15,47
FC Nords,9724,4,13,6,11,72,56,16,45
AaB,9724,5,8,13,9,34,38,-4,37
Sonderjyske,9724,6,8,6,10,28,29,-1,30
AC Horsens,9724,7,5,14,11,30,51,-21,29
Lyngby,9724,8,4,9,11,27,44,-17,21
Randers FC,9724,9,5,6,13,23,40,-17,21
Silkeborg IF,9724,10,6,3,13,26,44,-18,21
AGF Aarhus,9724,11,4,6,12,16,37,-21,18
Brondby,9725,1,21,7,2,75,32,43,70
FC Midtjylla,9725,2,20,4,6,66,43,23,64
FC Nords,9725,3,15,6,9,77,53,24,51
Copenhagen,9725,4,13,5,12,59,47,12,44
AaB,9725,5,8,11,11,41,50,-9,35
AC Horsens,9725,6,6,13,11,36,55,-19,31
Sonderjyske,9725,7,8,6,10,28,29,-1,30
Randers FC,9725,8,5,7,12,23,39,-16,22
Silkeborg IF,9725,9,6,3,13,26,44,-18,21
Lyngby,9725,10,3,10,11,26,44,-18,19
AGF Aarhus,9725,11,4,6,12,16,37,-21,18
FC Midtjylla,9726,1,20,5,5,70,36,34,65
Brondby,9726,2,20,5,5,68,35,33,65
Copenhagen,9726,3,14,6,10,59,46,13,48
FC Nords,9726,4,14,6,10,70,58,12,48
AaB,9726,5,7,13,10,36,42,-6,34
AC Horsens,9726,6,7,13,10,38,50,-12,34
Sonderjyske,9726,7,8,6,10,28,29,-1,30
Lyngby,9726,8,4,9,11,27,44,-17,21
Randers FC,9726,9,5,6,13,23,40,-17,21
Silkeborg IF,9726,10,6,3,13,27,45,-18,21
AGF Aarhus,9726,11,4,6,12,17,38,-21,18
FC Midtjylla,9727,1,20,5,5,69,37,32,65
Brondby,9727,2,19,5,6,71,39,32,62
FC Nords,9727,3,16,6,8,75,48,27,54
Copenhagen,9727,4,15,4,11,59,44,15,49
AC Horsens,9727,5,8,12,10,39,55,-16,36
Sonderjyske,9727,6,8,6,10,28,29,-1,30
AaB,9727,7,6,12,12,36,52,-16,30
Randers FC,9727,8,6,6,12,24,39,-15,24
Silkeborg IF,9727,9,6,3,13,26,44,-18,21
Lyngby,9727,10,3,9,12,26,45,-19,18
AGF Aarhus,9727,11,4,6,12,16,37,-21,18
FC Midtjylla,9728,1,21,5,4,68,37,31,68
Brondby,9728,2,18,7,5,65,35,30,61
Copenhagen,9728,3,15,4,11,57,46,11,49
FC Nords,9728,4,13,9,8,74,52,22,48
AaB,9728,5,8,13,9,42,41,1,37
Sonderjyske,9728,6,8,6,10,28,29,-1,30
AC Horsens,9728,7,5,14,11,35,56,-21,29
Randers FC,9728,8,6,6,12,24,39,-15,24
Silkeborg IF,9728,9,6,3,13,27,45,-18,21
Lyngby,9728,10,3,9,12,26,45,-19,18
AGF Aarhus,9728,11,4,6,12,17,38,-21,18
Brondby,9729,1,20,5,5,69,36,33,65
FC Midtjylla,9729,2,18,5,7,63,43,20,59
FC Nords,9729,3,15,7,8,73,49,24,52
Copenhagen,9729,4,15,5,10,66,44,22,50
AaB,9729,5,8,12,10,39,44,-5,36
AC Horsens,9729,6,6,14,10,35,55,-20,32
Sonderjyske,9729,7,8,6,10,28,29,-1,30
Lyngby,9729,8,4,9,11,30,46,-16,21
Randers FC,9729,9,5,6,13,25,43,-18,21
AGF Aarhus,9729,10,5,6,11,18,36,-18,21
Silkeborg IF,9729,11,5,3,14,25,46,-21,18
Brondby,9730,1,22,5,3,74,33,41,71
FC Midtjylla,9730,2,18,6,6,66,42,24,60
FC Nords,9730,3,15,7,8,75,53,22,52
Copenhagen,9730,4,14,6,10,59,45,14,48
AaB,9730,5,7,12,11,37,45,-8,33
Sonderjyske,9730,6,8,6,10,28,29,-1,30
AC Horsens,9730,7,5,14,11,32,51,-19,29
Lyngby,9730,8,4,9,11,27,44,-17,21
Randers FC,9730,9,5,6,13,23,40,-17,21
AGF Aarhus,9730,10,5,6,11,18,37,-19,21
Silkeborg IF,9730,11,5,3,14,26,46,-20,18
Brondby,9731,1,22,5,3,72,36,36,71
FC Midtjylla,9731,2,21,4,5,74,36,38,67
FC Nords,9731,3,15,6,9,76,57,19,51
Copenhagen,9731,4,14,5,11,59,44,15,47
AC Horsens,9731,5,6,13,11,33,52,-19,31
Sonderjyske,9731,6,8,6,10,28,29,-1,30
AaB,9731,7,6,11,13,35,50,-15,29
Randers FC,9731,8,6,6,12,25,40,-15,24
Silkeborg IF,9731,9,6,3,13,28,45,-17,21
Lyngby,9731,10,3,9,12,27,46,-19,18
AGF Aarhus,9731,11,4,6,12,17,39,-22,18
Brondby,9732,1,21,7,2,72,28,44,70
FC Midtjylla,9732,2,19,6,5,62,37,25,63
Copenhagen,9732,3,14,6,10,58,44,14,48
FC Nords,9732,4,13,8,9,72,55,17,47
AC Horsens,9732,5,7,12,11,34,51,-17,33
AaB,9732,6,6,13,11,32,41,-9,31
Sonderjyske,9732,7,8,6,10,28,29,-1,30
Lyngby,9732,8,4,9,11,28,45,-17,21
Randers FC,9732,9,5,6,13,24,41,-17,21
AGF Aarhus,9732,10,5,6,11,18,37,-19,21
Silkeborg IF,9732,11,5,3,14,26,46,-20,18
Brondby,9733,1,23,5,2,83,28,55,74
FC Midtjylla,9733,2,19,4,7,65,43,22,61
FC Nords,9733,3,13,8,9,70,57,13,47
Copenhagen,9733,4,14,5,11,60,48,12,47
AaB,9733,5,9,11,10,38,44,-6,38
Sonderjyske,9733,6,8,6,10,28,29,-1,30
AC Horsens,9733,7,5,13,12,30,52,-22,28
Lyngby,9733,8,4,9,11,29,46,-17,21
Randers FC,9733,9,5,6,13,25,42,-17,21
Silkeborg IF,9733,10,5,4,13,27,46,-19,19
AGF Aarhus,9733,11,4,7,11,18,38,-20,19
Brondby,9734,1,22,5,3,76,31,45,71
FC Midtjylla,9734,2,18,5,7,63,45,18,59
FC Nords,9734,3,16,6,8,77,50,27,54
Copenhagen,9734,4,14,5,11,57,44,13,47
AaB,9734,5,9,11,10,36,41,-5,38
Sonderjyske,9734,6,8,6,10,28,29,-1,30
AC Horsens,9734,7,5,12,13,32,56,-24,27
Randers FC,9734,8,6,6,12,26,41,-15,24
Silkeborg IF,9734,9,5,4,13,27,46,-19,19
AGF Aarhus,9734,10,4,7,11,18,38,-20,19
Lyngby,9734,11,3,9,12,28,47,-19,18
Brondby,9735,1,21,6,3,74,34,40,69
FC Midtjylla,9735,2,21,4,5,70,41,29,67
FC Nords,9735,3,13,8,9,74,54,20,47
Copenhagen,9735,4,14,4,12,58,46,12,46
AC Horsens,9735,5,7,13,10,38,56,-18,34
AaB,9735,6,7,11,12,38,47,-9,32
Sonderjyske,9735,7,8,6,10,28,29,-1,30
Lyngby,9735,8,4,9,11,28,44,-16,21
Randers FC,9735,9,5,6,13,23,41,-18,21
Silkeborg IF,9735,10,5,4,13,27,46,-19,19
AGF Aarhus,9735,11,4,7,11,18,38,-20,19
Brondby,9736,1,21,6,3,70,30,40,69
FC Midtjylla,9736,2,20,5,5,69,38,31,65
Copenhagen,9736,3,15,5,10,60,45,15,50
FC Nords,9736,4,13,7,10,71,55,16,46
AaB,9736,5,7,11,12,35,44,-9,32
AC Horsens,9736,6,6,14,10,33,52,-19,32
Sonderjyske,9736,7,8,6,10,28,29,-1,30
Randers FC,9736,8,6,6,12,26,40,-14,24
Silkeborg IF,9736,9,6,3,13,28,45,-17,21
Lyngby,9736,10,3,9,12,27,47,-20,18
AGF Aarhus,9736,11,4,6,12,17,39,-22,18
Brondby,9737,1,23,5,2,78,33,45,74
FC Midtjylla,9737,2,18,6,6,63,41,22,60
FC Nords,9737,3,13,8,9,75,57,18,47
Copenhagen,9737,4,13,5,12,59,46,13,44
AC Horsens,9737,5,8,12,10,37,51,-14,36
AaB,9737,6,7,12,11,36,46,-10,33
Sonderjyske,9737,7,8,6,10,28,29,-1,30
Lyngby,9737,8,4,9,11,28,45,-17,21
Randers FC,9737,9,5,6,13,24,41,-17,21
Silkeborg IF,9737,10,5,4,13,26,45,-19,19
AGF Aarhus,9737,11,4,7,11,17,37,-20,19
Brondby,9738,1,21,6,3,71,34,37,69
FC Midtjylla,9738,2,20,4,6,67,37,30,64
Copenhagen,9738,3,15,4,11,61,46,15,49
FC Nords,9738,4,14,6,10,77,57,20,48
AC Horsens,9738,5,7,13,10,36,53,-17,34
AaB,9738,6,7,11,12,34,45,-11,32
Sonderjyske,9738,7,8,6,10,28,29,-1,30
Randers FC,9738,8,6,6,12,24,39,-15,24
AGF Aarhus,9738,9,5,6,11,18,37,-19,21
Lyngby,9738,10,3,9,12,26,45,-19,18
Silkeborg IF,9738,11,5,3,14,26,46,-20,18
Brondby,9739,1,21,5,4,72,32,40,68
FC Midtjylla,9739,2,20,5,5,67,39,28,65
Copenhagen,9739,3,14,5,11,59,47,12,47
FC Nords,9739,4,12,7,11,67,55,12,43
AaB,9739,5,9,11,10,42,46,-4,38
AC Horsens,9739,6,7,13,10,39,53,-14,34
Sonderjyske,9739,7,8,6,10,28,29,-1,30
Randers FC,9739,8,5,7,12,25,41,-16,22
Lyngby,9739,9,3,10,11,28,46,-18,19
Silkeborg IF,9739,10,5,4,13,26,45,-19,19
AGF Aarhus,9739,11,4,7,11,17,37,-20,19
FC Midtjylla,9740,1,20,4,6,65,42,23,64
Brondby,9740,2,19,6,5,70,39,31,63
FC Nords,9740,3,16,7,7,77,50,27,55
Copenhagen,9740,4,13,5,12,53,42,11,44
AaB,9740,5,8,11,11,38,44,-6,35
AC Horsens,9740,6,7,13,10,40,52,-12,34
Sonderjyske,9740,7,8,6,10,28,29,-1,30
Lyngby,9740,8,4,9,11,27,44,-17,21
Randers FC,9740,9,5,6,13,23,40,-17,21
Silkeborg IF,9740,10,5,4,13,26,45,-19,19
AGF Aarhus,9740,11,4,7,11,17,37,-20,19
Brondby,9741,1,21,6,3,73,36,37,69
FC Midtjylla,9741,2,21,5,4,77,38,39,68
FC Nords,9741,3,14,7,9,73,53,20,49
Copenhagen,9741,4,13,6,11,55,45,10,45
AaB,9741,5,8,11,11,38,47,-9,35
Sonderjyske,9741,6,8,6,10,28,29,-1,30
AC Horsens,9741,7,5,13,12,33,56,-23,28
Randers FC,9741,8,5,7,12,23,39,-16,22
AGF Aarhus,9741,9,5,6,11,19,37,-18,21
Lyngby,9741,10,3,10,11,26,44,-18,19
Silkeborg IF,9741,11,5,3,14,26,47,-21,18
Brondby,9742,1,20,6,4,73,35,38,66
FC Midtjylla,9742,2,19,6,5,67,43,24,63
FC Nords,9742,3,15,7,8,76,52,24,52
Copenhagen,9742,4,15,4,11,61,47,14,49
AC Horsens,9742,5,6,14,10,35,54,-19,32
AaB,9742,6,6,13,11,38,45,-7,31
Sonderjyske,9742,7,8,6,10,28,29,-1,30
Randers FC,9742,8,6,6,12,28,41,-13,24
AGF Aarhus,9742,9,5,6,11,20,38,-18,21
Lyngby,9742,10,3,9,12,28,49,-21,18
Silkeborg IF,9742,11,5,3,14,27,48,-21,18
Brondby,9743,1,21,6,3,72,31,41,69
FC Midtjylla,9743,2,19,5,6,65,38,27,62
FC Nords,9743,3,14,8,8,76,53,23,50
Copenhagen,9743,4,13,4,13,57,51,6,43
AaB,9743,5,8,14,8,37,39,-2,38
AC Horsens,9743,6,6,13,11,34,55,-21,31
Sonderjyske,9743,7,8,6,10,28,29,-1,30
Lyngby,9743,8,4,9,11,27,44,-17,21
Randers FC,9743,9,5,6,13,23,40,-17,21
AGF Aarhus,9743,10,5,6,11,17,36,-19,21
Silkeborg IF,9743,11,5,3,14,25,45,-20,18
FC Midtjylla,9744,1,20,5,5,65,38,27,65
Brondby,9744,2,18,6,6,67,43,24,60
FC Nords,9744,3,15,8,7,73,46,27,53
Copenhagen,9744,4,13,5,12,56,45,11,44
AC Horsens,9744,5,8,12,10,39,50,-11,36
AaB,9744,6,7,14,9,37,41,-4,35
Sonderjyske,9744,7,8,6,10,28,29,-1,30
Lyngby,9744,8,4,9,11,27,44,-17,21
Randers FC,9744,9,5,6,13,23,40,-17,21
Silkeborg IF,9744,10,5,4,13,25,44,-19,19
AGF Aarhus,9744,11,4,7,11,16,36,-20,19
FC Midtjylla,9745,1,20,6,4,65,35,30,66
Brondby,9745,2,20,5,5,64,36,28,65
Copenhagen,9745,3,14,6,10,62,45,17,48
FC Nords,9745,4,13,8,9,73,53,20,47
AC Horsens,9745,5,7,13,10,36,52,-16,34
AaB,9745,6,7,12,11,35,40,-5,33
Sonderjyske,9745,7,8,6,10,28,29,-1,30
Lyngby,9745,8,4,9,11,28,44,-16,21
Randers FC,9745,9,5,6,13,23,41,-18,21
AGF Aarhus,9745,10,5,6,11,17,36,-19,21
Silkeborg IF,9745,11,5,3,14,25,45,-20,18
FC Midtjylla,9746,1,21,5,4,65,35,30,68
Brondby,9746,2,20,6,4,71,36,35,66
Copenhagen,9746,3,15,4,11,60,43,17,49
FC Nords,9746,4,14,6,10,71,55,16,48
AaB,9746,5,7,14,9,36,41,-5,35
Sonderjyske,9746,6,8,6,10,28,29,-1,30
AC Horsens,9746,7,5,13,12,34,53,-19,28
Lyngby,9746,8,4,9,11,29,44,-15,21
Silkeborg IF,9746,9,6,3,13,28,44,-16,21
Randers FC,9746,10,5,6,13,23,42,-19,21
AGF Aarhus,9746,11,4,6,12,16,39,-23,18
Brondby,9747,1,20,7,3,70,33,37,67
FC Midtjylla,9747,2,19,5,6,65,39,26,62
FC Nords,9747,3,14,7,9,72,50,22,49
Copenhagen,9747,4,13,6,11,54,44,10,45
AaB,9747,5,7,14,9,36,42,-6,35
AC Horsens,9747,6,7,13,10,36,51,-15,34
Sonderjyske,9747,7,8,6,10,28,29,-1,30
Lyngby,9747,8,4,9,11,28,44,-16,21
Silkeborg IF,9747,9,6,3,13,26,44,-18,21
Randers FC,9747,10,5,6,13,23,41,-18,21
AGF Aarhus,9747,11,4,6,12,16,37,-21,18
Brondby,9748,1,20,6,4,71,33,38,66
FC Midtjylla,9748,2,18,6,6,65,41,24,60
FC Nords,9748,3,16,7,7,76,50,26,55
Copenhagen,9748,4,13,5,12,54,47,7,44
AC Horsens,9748,5,7,13,10,40,54,-14,34
AaB,9748,6,6,15,9,38,45,-7,33
Sonderjyske,9748,7,8,6,10,28,29,-1,30
Randers FC,9748,8,5,7,12,24,40,-16,22
Lyngby,9748,9,3,10,11,27,45,-18,19
Silkeborg IF,9748,10,5,4,13,26,45,-19,19
AGF Aarhus,9748,11,4,7,11,17,37,-20,19
Brondby,9749,1,22,5,3,70,30,40,71
FC Midtjylla,9749,2,18,4,8,66,48,18,58
Copenhagen,9749,3,15,5,10,70,52,18,50
FC Nords,9749,4,13,7,10,72,57,15,46
AaB,9749,5,8,12,10,36,40,-4,36
AC Horsens,9749,6,7,13,10,35,48,-13,34
Sonderjyske,9749,7,8,6,10,28,29,-1,30
Randers FC,9749,8,5,7,12,24,40,-16,22
Silkeborg IF,9749,9,6,3,13,26,44,-18,21
Lyngby,9749,10,3,10,11,27,45,-18,19
AGF Aarhus,9749,11,4,6,12,16,37,-21,18
Brondby,9750,1,20,7,3,67,30,37,67
FC Midtjylla,9750,2,18,6,6,66,41,25,60
FC Nords,9750,3,15,7,8,74,48,26,52
Copenhagen,9750,4,13,7,10,55,42,13,46
AC Horsens,9750,5,7,14,9,34,51,-17,35
AaB,9750,6,6,13,11,34,44,-10,31
Sonderjyske,9750,7,8,6,10,28,29,-1,30
Randers FC,9750,8,6,6,12,27,41,-14,24
AGF Aarhus,9750,9,5,6,11,20,38,-18,21
Lyngby,9750,10,3,9,12,28,48,-20,18
Silkeborg IF,9750,11,5,3,14,27,48,-21,18
Brondby,9751,1,20,6,4,69,31,38,66
FC Midtjylla,9751,2,20,6,4,69,39,30,66
Copenhagen,9751,3,15,5,10,59,47,12,50
FC Nords,9751,4,13,6,11,72,57,15,45
AaB,9751,5,8,11,11,40,43,-3,35
AC Horsens,9751,6,6,14,10,35,53,-18,32
Sonderjyske,9751,7,8,6,10,28,29,-1,30
Randers FC,9751,8,5,7,12,24,40,-16,22
Silkeborg IF,9751,9,6,3,13,27,44,-17,21
Lyngby,9751,10,3,10,11,27,45,-18,19
AGF Aarhus,9751,11,4,6,12,16,38,-22,18
Brondby,9752,1,20,6,4,69,34,35,66
FC Midtjylla,9752,2,19,6,5,64,39,25,63
FC Nords,9752,3,15,8,7,75,51,24,53
Copenhagen,9752,4,13,5,12,58,47,11,44
AC Horsens,9752,5,7,13,10,35,50,-15,34
AaB,9752,6,7,12,11,36,42,-6,33
Sonderjyske,9752,7,8,6,10,28,29,-1,30
Lyngby,9752,8,4,9,11,28,44,-16,21
Silkeborg IF,9752,9,6,3,13,26,44,-18,21
Randers FC,9752,10,5,6,13,23,41,-18,21
AGF Aarhus,9752,11,4,6,12,16,37,-21,18
Brondby,9753,1,20,7,3,72,34,38,67
FC Midtjylla,9753,2,20,5,5,69,41,28,65
Copenhagen,9753,3,17,4,9,65,45,20,55
FC Nords,9753,4,12,8,10,73,58,15,44
AaB,9753,5,6,13,11,39,47,-8,31
AC Horsens,9753,6,6,13,11,32,51,-19,31
Sonderjyske,9753,7,8,6,10,28,29,-1,30
Lyngby,9753,8,4,9,11,28,44,-16,21
Silkeborg IF,9753,9,6,3,13,28,45,-17,21
Randers FC,9753,10,5,6,13,23,41,-18,21
AGF Aarhus,9753,11,4,6,12,17,39,-22,18
Brondby,9754,1,20,7,3,73,32,41,67
FC Midtjylla,9754,2,20,6,4,68,38,30,66
FC Nords,9754,3,14,7,9,76,55,21,49
Copenhagen,9754,4,14,5,11,59,45,14,47
AaB,9754,5,8,11,11,34,41,-7,35
Sonderjyske,9754,6,8,6,10,28,29,-1,30
AC Horsens,9754,7,6,12,12,33,58,-25,30
Randers FC,9754,8,6,6,12,24,39,-15,24
Silkeborg IF,9754,9,5,4,13,27,46,-19,19
AGF Aarhus,9754,10,4,7,11,18,38,-20,19
Lyngby,9754,11,3,9,12,26,45,-19,18
Brondby,9755,1,20,7,3,73,36,37,67
FC Midtjylla,9755,2,19,5,6,65,42,23,62
FC Nords,9755,3,16,7,7,77,45,32,55
Copenhagen,9755,4,13,5,12,58,55,3,44
AaB,9755,5,7,12,11,38,45,-7,33
AC Horsens,9755,6,6,14,10,40,54,-14,32
Sonderjyske,9755,7,8,6,10,28,29,-1,30
Lyngby,9755,8,4,9,11,31,45,-14,21
Silkeborg IF,9755,9,6,3,13,26,44,-18,21
Randers FC,9755,10,5,6,13,24,44,-20,21
AGF Aarhus,9755,11,4,6,12,16,37,-21,18
Brondby,9756,1,20,6,4,71,35,36,66
FC Midtjylla,9756,2,19,4,7,61,40,21,61
FC Nords,9756,3,15,6,9,74,52,22,51
Copenhagen,9756,4,14,5,11,57,42,15,47
AaB,9756,5,8,12,10,38,42,-4,36
AC Horsens,9756,6,7,13,10,35,51,-16,34
Sonderjyske,9756,7,8,6,10,28,29,-1,30
Randers FC,9756,8,6,6,12,25,40,-15,24
Silkeborg IF,9756,9,6,3,13,26,44,-18,21
Lyngby,9756,10,3,9,12,27,46,-19,18
AGF Aarhus,9756,11,4,6,12,16,37,-21,18
Brondby,9757,1,23,5,2,77,30,47,74
FC Midtjylla,9757,2,18,5,7,62,42,20,59
FC Nords,9757,3,14,6,10,75,54,21,48
Copenhagen,9757,4,14,4,12,57,48,9,46
AaB,9757,5,9,12,9,43,46,-3,39
Sonderjyske,9757,6,8,6,10,28,29,-1,30
AC Horsens,9757,7,6,12,12,34,54,-20,30
Lyngby,9757,8,4,9,11,29,45,-16,21
Randers FC,9757,9,5,6,13,24,42,-18,21
AGF Aarhus,9757,10,5,6,11,18,37,-19,21
Silkeborg IF,9757,11,5,3,14,26,46,-20,18
Brondby,9758,1,22,6,2,71,29,42,72
FC Midtjylla,9758,2,18,6,6,67,42,25,60
FC Nords,9758,3,14,7,9,73,53,20,49
Copenhagen,9758,4,14,5,11,60,46,14,47
AaB,9758,5,9,11,10,38,45,-7,38
Sonderjyske,9758,6,8,6,10,28,29,-1,30
AC Horsens,9758,7,5,13,12,34,54,-20,28
Lyngby,9758,8,4,9,11,28,44,-16,21
Randers FC,9758,9,5,6,13,23,41,-18,21
Silkeborg IF,9758,10,5,4,13,26,45,-19,19
AGF Aarhus,9758,11,4,7,11,17,37,-20,19
Brondby,9759,1,21,6,3,75,36,39,69
FC Midtjylla,9759,2,19,7,4,64,37,27,64
FC Nords,9759,3,13,8,9,69,52,17,47
Copenhagen,9759,4,13,5,12,57,47,10,44
AaB,9759,5,7,14,9,34,38,-4,35
AC Horsens,9759,6,6,14,10,35,50,-15,32
Sonderjyske,9759,7,8,6,10,28,29,-1,30
Randers FC,9759,8,5,7,12,24,40,-16,22
AGF Aarhus,9759,9,5,6,11,19,37,-18,21
Lyngby,9759,10,3,10,11,27,45,-18,19
Silkeborg IF,9759,11,5,3,14,26,47,-21,18
Brondby,9760,1,20,6,4,74,38,36,66
FC Midtjylla,9760,2,19,5,6,65,43,22,62
Copenhagen,9760,3,15,6,9,65,45,20,51
FC Nords,9760,4,13,7,10,71,53,18,46
AaB,9760,5,8,13,9,38,43,-5,37
AC Horsens,9760,6,6,13,11,34,51,-17,31
Sonderjyske,9760,7,8,6,10,28,29,-1,30
Randers FC,9760,8,5,7,12,23,39,-16,22
Silkeborg IF,9760,9,6,3,13,28,46,-18,21
Lyngby,9760,10,3,10,11,26,44,-18,19
AGF Aarhus,9760,11,4,6,12,18,39,-21,18
Brondby,9761,1,19,6,5,68,35,33,63
FC Midtjylla,9761,2,18,6,6,61,39,22,60
FC Nords,9761,3,17,6,7,76,48,28,57
Copenhagen,9761,4,13,6,11,58,45,13,45
AaB,9761,5,8,13,9,37,39,-2,37
Sonderjyske,9761,6,8,6,10,28,29,-1,30
AC Horsens,9761,7,5,15,10,33,53,-20,30
Randers FC,9761,8,6,6,12,25,40,-15,24
Silkeborg IF,9761,9,5,4,13,25,44,-19,19
AGF Aarhus,9761,10,4,7,11,16,36,-20,19
Lyngby,9761,11,3,9,12,27,46,-19,18
Brondby,9762,1,21,6,3,71,32,39,69
FC Midtjylla,9762,2,18,6,6,65,40,25,60
FC Nords,9762,3,14,8,8,73,51,22,50
Copenhagen,9762,4,15,4,11,60,46,14,49
AaB,9762,5,7,13,10,39,47,-8,34
Sonderjyske,9762,6,8,6,10,28,29,-1,30
AC Horsens,9762,7,5,15,10,35,53,-18,30
Randers FC,9762,8,6,6,12,27,39,-12,24
Silkeborg IF,9762,9,5,4,13,26,45,-19,19
AGF Aarhus,9762,10,4,7,11,17,37,-20,19
Lyngby,9762,11,3,9,12,26,48,-22,18
FC Midtjylla,9763,1,21,5,4,67,37,30,68
Brondby,9763,2,20,7,3,69,30,39,67
FC Nords,9763,3,14,7,9,78,54,24,49
Copenhagen,9763,4,14,5,11,57,47,10,47
AC Horsens,9763,5,6,14,10,36,50,-14,32
Sonderjyske,9763,6,8,6,10,28,29,-1,30
AaB,9763,7,6,12,12,35,50,-15,30
Lyngby,9763,8,4,9,11,28,44,-16,21
Randers FC,9763,9,5,6,13,23,41,-18,21
Silkeborg IF,9763,10,5,4,13,27,46,-19,19
AGF Aarhus,9763,11,4,7,11,18,38,-20,19
Brondby,9764,1,21,5,4,74,38,36,68
FC Midtjylla,9764,2,19,5,6,63,42,21,62
FC Nords,9764,3,14,7,9,77,55,22,49
Copenhagen,9764,4,12,6,12,55,47,8,42
AaB,9764,5,10,11,9,44,40,4,41
AC Horsens,9764,6,7,12,11,39,56,-17,33
Sonderjyske,9764,7,8,6,10,28,29,-1,30
Lyngby,9764,8,4,9,11,32,46,-14,21
Silkeborg IF,9764,9,6,3,13,27,45,-18,21
Randers FC,9764,10,5,6,13,25,45,-20,21
AGF Aarhus,9764,11,4,6,12,17,38,-21,18
Brondby,9765,1,21,6,3,71,30,41,69
FC Midtjylla,9765,2,21,4,5,68,39,29,67
FC Nords,9765,3,13,8,9,70,53,17,47
Copenhagen,9765,4,12,5,13,55,52,3,41
AC Horsens,9765,5,8,12,10,39,53,-14,36
AaB,9765,6,8,11,11,36,38,-2,35
Sonderjyske,9765,7,8,6,10,28,29,-1,30
Randers FC,9765,8,5,7,12,24,40,-16,22
Silkeborg IF,9765,9,6,3,13,27,44,-17,21
Lyngby,9765,10,3,10,11,27,45,-18,19
AGF Aarhus,9765,11,4,6,12,16,38,-22,18
Brondby,9766,1,21,6,3,74,34,40,69
FC Midtjylla,9766,2,21,5,4,72,39,33,68
FC Nords,9766,3,14,6,10,75,55,20,48
Copenhagen,9766,4,13,5,12,60,48,12,44
AC Horsens,9766,5,7,13,10,35,55,-20,34
AaB,9766,6,7,11,12,35,46,-11,32
Sonderjyske,9766,7,8,6,10,28,29,-1,30
Lyngby,9766,8,4,9,11,30,46,-16,21
Randers FC,9766,9,5,6,13,25,43,-18,21
Silkeborg IF,9766,10,5,4,13,26,45,-19,19
AGF Aarhus,9766,11,4,7,11,17,37,-20,19
Brondby,9767,1,21,6,3,70,30,40,69
FC Midtjylla,9767,2,19,5,6,66,44,22,62
FC Nords,9767,3,13,8,9,71,52,19,47
Copenhagen,9767,4,14,5,11,59,45,14,47
AC Horsens,9767,5,8,13,9,40,51,-11,37
AaB,9767,6,7,11,12,35,45,-10,32
Sonderjyske,9767,7,8,6,10,28,29,-1,30
Lyngby,9767,8,4,9,11,29,46,-17,21
Randers FC,9767,9,5,6,13,25,42,-17,21
Silkeborg IF,9767,10,5,4,13,26,45,-19,19
AGF Aarhus,9767,11,4,7,11,17,37,-20,19
Brondby,9768,1,23,5,2,72,31,41,74
FC Midtjylla,9768,2,19,6,5,63,38,25,63
FC Nords,9768,3,13,7,10,69,49,20,46
Copenhagen,9768,4,13,5,12,61,48,13,44
AaB,9768,5,7,13,10,37,42,-5,34
AC Horsens,9768,6,6,14,10,33,53,-20,32
Sonderjyske,9768,7,8,6,10,28,29,-1,30
Lyngby,9768,8,4,9,11,29,44,-15,21
Randers FC,9768,9,5,6,13,23,42,-19,21
AGF Aarhus,9768,10,5,6,11,18,37,-19,21
Silkeborg IF,9768,11,5,3,14,26,46,-20,18
Brondby,9769,1,21,6,3,68,31,37,69
FC Midtjylla,9769,2,19,4,7,65,42,23,61
FC Nords,9769,3,14,7,9,72,53,19,49
Copenhagen,9769,4,14,6,10,55,39,16,48
AC Horsens,9769,5,7,13,10,37,53,-16,34
AaB,9769,6,7,12,11,38,43,-5,33
Sonderjyske,9769,7,8,6,10,28,29,-1,30
Randers FC,9769,8,5,7,12,24,40,-16,22
AGF Aarhus,9769,9,5,6,11,18,37,-19,21
Lyngby,9769,10,3,10,11,27,45,-18,19
Silkeborg IF,9769,11,5,3,14,26,46,-20,18
Brondby,9770,1,20,7,3,69,30,39,67
FC Midtjylla,9770,2,18,6,6,62,42,20,60
Copenhagen,9770,3,15,5,10,57,40,17,50
FC Nords,9770,4,14,6,10,75,54,21,48
AaB,9770,5,7,14,9,39,44,-5,35
AC Horsens,9770,6,6,14,10,35,53,-18,32
Sonderjyske,9770,7,8,6,10,28,29,-1,30
Randers FC,9770,8,6,6,12,24,39,-15,24
AGF Aarhus,9770,9,5,6,11,17,36,-19,21
Lyngby,9770,10,3,9,12,26,45,-19,18
Silkeborg IF,9770,11,5,3,14,25,45,-20,18
Brondby,9771,1,21,6,3,68,30,38,69
FC Midtjylla,9771,2,19,4,7,60,41,19,61
FC Nords,9771,3,14,8,8,78,50,28,50
Copenhagen,9771,4,13,7,10,58,45,13,46
AaB,9771,5,8,12,10,38,41,-3,36
AC Horsens,9771,6,6,13,11,31,52,-21,31
Sonderjyske,9771,7,8,6,10,28,29,-1,30
Lyngby,9771,8,4,9,11,29,46,-17,21
Randers FC,9771,9,5,6,13,25,42,-17,21
AGF Aarhus,9771,10,5,6,11,19,37,-18,21
Silkeborg IF,9771,11,5,3,14,26,47,-21,18
FC Midtjylla,9772,1,20,6,4,66,35,31,66
Brondby,9772,2,19,8,3,68,31,37,65
FC Nords,9772,3,14,7,9,71,53,18,49
Copenhagen,9772,4,13,6,11,56,46,10,45
AaB,9772,5,9,12,9,39,39,0,39
Sonderjyske,9772,6,8,6,10,28,29,-1,30
AC Horsens,9772,7,5,13,12,31,53,-22,28
Randers FC,9772,8,6,6,12,26,41,-15,24
Silkeborg IF,9772,9,6,3,13,28,45,-17,21
Lyngby,9772,10,3,9,12,28,47,-19,18
AGF Aarhus,9772,11,4,6,12,17,39,-22,18
FC Midtjylla,9773,1,22,4,4,67,37,30,70
Brondby,9773,2,19,7,4,70,36,34,64
FC Nords,9773,3,15,7,8,75,48,27,52
Copenhagen,9773,4,13,4,13,57,49,8,43
AaB,9773,5,8,12,10,40,44,-4,36
Sonderjyske,9773,6,8,6,10,28,29,-1,30
AC Horsens,9773,7,5,14,11,33,54,-21,29
Randers FC,9773,8,6,6,12,25,40,-15,24
AGF Aarhus,9773,9,5,6,11,18,37,-19,21
Lyngby,9773,10,3,9,12,27,46,-19,18
Silkeborg IF,9773,11,5,3,14,26,46,-20,18
Brondby,9774,1,23,5,2,77,30,47,74
FC Midtjylla,9774,2,19,6,5,68,43,25,63
FC Nords,9774,3,14,7,9,71,52,19,49
Copenhagen,9774,4,13,5,12,57,46,11,44
AC Horsens,9774,5,7,12,11,36,54,-18,33
AaB,9774,6,7,11,12,35,45,-10,32
Sonderjyske,9774,7,8,6,10,28,29,-1,30
Randers FC,9774,8,6,6,12,25,40,-15,24
Silkeborg IF,9774,9,6,3,13,26,44,-18,21
Lyngby,9774,10,3,9,12,27,46,-19,18
AGF Aarhus,9774,11,4,6,12,16,37,-21,18
Brondby,9775,1,20,7,3,69,31,38,67
FC Midtjylla,9775,2,19,6,5,64,39,25,63
FC Nords,9775,3,14,9,7,79,48,31,51
Copenhagen,9775,4,14,5,11,56,46,10,47
AaB,9775,5,6,14,10,34,41,-7,32
Sonderjyske,9775,6,8,6,10,28,29,-1,30
AC Horsens,9775,7,5,15,10,32,55,-23,30
Lyngby,9775,8,4,9,11,29,46,-17,21
Randers FC,9775,9,5,6,13,25,42,-17,21
Silkeborg IF,9775,10,5,4,13,26,45,-19,19
AGF Aarhus,9775,11,4,7,11,17,37,-20,19
Brondby,9776,1,20,7,3,70,35,35,67
FC Midtjylla,9776,2,19,6,5,70,43,27,63
FC Nords,9776,3,14,9,7,77,53,24,51
Copenhagen,9776,4,15,5,10,59,41,18,50
AaB,9776,5,6,13,11,35,45,-10,31
Sonderjyske,9776,6,8,6,10,28,29,-1,30
AC Horsens,9776,7,5,14,11,38,58,-20,29
Randers FC,9776,8,5,7,12,23,39,-16,22
AGF Aarhus,9776,9,5,6,11,17,36,-19,21
Lyngby,9776,10,3,10,11,26,44,-18,19
Silkeborg IF,9776,11,5,3,14,25,45,-20,18
Brondby,9777,1,21,5,4,74,35,39,68
FC Midtjylla,9777,2,17,5,8,62,43,19,56
FC Nords,9777,3,16,6,8,76,52,24,54
Copenhagen,9777,4,16,4,10,62,42,20,52
AaB,9777,5,7,12,11,37,47,-10,33
AC Horsens,9777,6,6,14,10,35,53,-18,32
Sonderjyske,9777,7,8,6,10,28,29,-1,30
Randers FC,9777,8,5,7,12,24,40,-16,22
AGF Aarhus,9777,9,5,6,11,17,36,-19,21
Lyngby,9777,10,3,10,11,27,45,-18,19
Silkeborg IF,9777,11,5,3,14,25,45,-20,18
Brondby,9778,1,23,5,2,77,33,44,74
FC Midtjylla,9778,2,19,4,7,64,42,22,61
FC Nords,9778,3,14,6,10,76,55,21,48
Copenhagen,9778,4,14,5,11,60,47,13,47
AaB,9778,5,7,13,10,37,45,-8,34
AC Horsens,9778,6,6,13,11,34,52,-18,31
Sonderjyske,9778,7,8,6,10,28,29,-1,30
Randers FC,9778,8,5,7,12,23,39,-16,22
Lyngby,9778,9,3,10,11,26,44,-18,19
Silkeborg IF,9778,10,5,4,13,25,44,-19,19
AGF Aarhus,9778,11,4,7,11,16,36,-20,19
Brondby,9779,1,21,5,4,74,31,43,68
FC Midtjylla,9779,2,20,4,6,67,41,26,64
FC Nords,9779,3,15,7,8,74,51,23,52
Copenhagen,9779,4,14,4,12,58,47,11,46
AC Horsens,9779,5,7,13,10,36,55,-19,34
AaB,9779,6,6,13,11,37,47,-10,31
Sonderjyske,9779,7,8,6,10,28,29,-1,30
Randers FC,9779,8,5,7,12,24,40,-16,22
Silkeborg IF,9779,9,6,3,13,27,45,-18,21
Lyngby,9779,10,3,10,11,27,45,-18,19
AGF Aarhus,9779,11,4,6,12,17,38,-21,18
Brondby,9780,1,21,6,3,70,31,39,69
FC Midtjylla,9780,2,18,5,7,60,36,24,59
FC Nords,9780,3,15,6,9,74,52,22,51
Copenhagen,9780,4,13,5,12,55,48,7,44
AaB,9780,5,9,11,10,37,40,-3,38
AC Horsens,9780,6,7,13,10,37,52,-15,34
Sonderjyske,9780,7,8,6,10,28,29,-1,30
Lyngby,9780,8,4,9,11,28,45,-17,21
Randers FC,9780,9,5,6,13,24,41,-17,21
AGF Aarhus,9780,10,5,6,11,18,36,-18,21
Silkeborg IF,9780,11,5,3,14,25,46,-21,18
Brondby,9781,1,20,7,3,68,32,36,67
FC Midtjylla,9781,2,21,4,5,70,39,31,67
FC Nords,9781,3,14,7,9,71,54,17,49
Copenhagen,9781,4,14,4,12,59,49,10,46
AaB,9781,5,9,12,9,43,42,1,39
Sonderjyske,9781,6,8,6,10,28,29,-1,30
AC Horsens,9781,7,5,12,13,36,57,-21,27
Lyngby,9781,8,4,9,11,28,44,-16,21
Silkeborg IF,9781,9,6,3,13,26,44,-18,21
Randers FC,9781,10,5,6,13,23,41,-18,21
AGF Aarhus,9781,11,4,6,12,16,37,-21,18
FC Midtjylla,9782,1,21,5,4,70,36,34,68
Brondby,9782,2,20,7,3,70,31,39,67
FC Nords,9782,3,14,6,10,70,54,16,48
Copenhagen,9782,4,13,5,12,56,46,10,44
AaB,9782,5,8,12,10,38,44,-6,36
AC Horsens,9782,6,6,13,11,33,52,-19,31
Sonderjyske,9782,7,8,6,10,28,29,-1,30
Randers FC,9782,8,6,6,12,25,40,-15,24
Silkeborg IF,9782,9,5,4,13,25,44,-19,19
AGF Aarhus,9782,10,4,7,11,16,36,-20,19
Lyngby,9782,11,3,9,12,27,46,-19,18
Brondby,9783,1,19,8,3,69,34,35,65
FC Midtjylla,9783,2,18,6,6,61,40,21,60
FC Nords,9783,3,14,7,9,75,54,21,49
Copenhagen,9783,4,13,7,10,59,46,13,46
AaB,9783,5,7,14,9,36,40,-4,35
AC Horsens,9783,6,7,14,9,39,51,-12,35
Sonderjyske,9783,7,8,6,10,28,29,-1,30
Randers FC,9783,8,6,6,12,26,40,-14,24
Silkeborg IF,9783,9,6,3,13,26,44,-18,21
Lyngby,9783,10,3,9,12,27,47,-20,18
AGF Aarhus,9783,11,4,6,12,16,37,-21,18
Brondby,9784,1,20,7,3,70,33,37,67
FC Midtjylla,9784,2,18,6,6,62,39,23,60
FC Nords,9784,3,14,8,8,77,54,23,50
Copenhagen,9784,4,15,5,10,57,43,14,50
AaB,9784,5,7,13,10,39,45,-6,34
AC Horsens,9784,6,6,13,11,34,51,-17,31
Sonderjyske,9784,7,8,6,10,28,29,-1,30
Randers FC,9784,8,6,6,12,27,39,-12,24
AGF Aarhus,9784,9,5,6,11,19,37,-18,21
Silkeborg IF,9784,10,5,3,14,26,47,-21,18
Lyngby,9784,11,3,9,12,26,48,-22,18
Brondby,9785,1,21,6,3,71,30,41,69
FC Midtjylla,9785,2,20,4,6,65,40,25,64
FC Nords,9785,3,14,8,8,76,53,23,50
Copenhagen,9785,4,14,7,9,60,43,17,49
AaB,9785,5,6,13,11,34,45,-11,31
Sonderjyske,9785,6,8,6,10,28,29,-1,30
AC Horsens,9785,7,6,12,12,35,56,-21,30
Randers FC,9785,8,6,6,12,24,39,-15,24
AGF Aarhus,9785,9,5,6,11,18,36,-18,21
Lyngby,9785,10,3,9,12,26,45,-19,18
Silkeborg IF,9785,11,5,3,14,25,46,-21,18
Brondby,9786,1,21,6,3,70,31,39,69
FC Midtjylla,9786,2,19,5,6,62,38,24,62
FC Nords,9786,3,13,8,9,69,48,21,47
Copenhagen,9786,4,14,5,11,58,44,14,47
AaB,9786,5,8,13,9,38,41,-3,37
AC Horsens,9786,6,6,13,11,31,52,-21,31
Sonderjyske,9786,7,8,6,10,28,29,-1,30
Randers FC,9786,8,6,6,12,25,40,-15,24
Silkeborg IF,9786,9,6,3,13,26,44,-18,21
Lyngby,9786,10,3,9,12,27,46,-19,18
AGF Aarhus,9786,11,4,6,12,16,37,-21,18
FC Midtjylla,9787,1,20,4,6,69,42,27,64
Brondby,9787,2,19,5,6,68,34,34,62
FC Nords,9787,3,15,6,9,73,52,21,51
Copenhagen,9787,4,14,5,11,60,47,13,47
AaB,9787,5,11,11,8,41,39,2,44
Sonderjyske,9787,6,8,6,10,28,29,-1,30
AC Horsens,9787,7,5,13,12,35,58,-23,28
Randers FC,9787,8,6,6,12,25,40,-15,24
Silkeborg IF,9787,9,6,3,13,29,46,-17,21
Lyngby,9787,10,3,9,12,27,46,-19,18
AGF Aarhus,9787,11,4,6,12,18,40,-22,18
Brondby,9788,1,20,6,4,72,37,35,66
FC Midtjylla,9788,2,17,6,7,64,48,16,57
Copenhagen,9788,3,15,6,9,62,44,18,51
FC Nords,9788,4,13,8,9,76,55,21,47
AaB,9788,5,8,14,8,39,40,-1,38
AC Horsens,9788,6,6,14,10,38,53,-15,32
Sonderjyske,9788,7,8,6,10,28,29,-1,30
Lyngby,9788,8,4,9,11,28,44,-16,21
Randers FC,9788,9,5,6,13,23,41,-18,21
Silkeborg IF,9788,10,5,4,13,25,44,-19,19
AGF Aarhus,9788,11,4,7,11,16,36,-20,19
Brondby,9789,1,20,7,3,72,33,39,67
FC Midtjylla,9789,2,19,5,6,68,43,25,62
Copenhagen,9789,3,16,4,10,66,47,19,52
FC Nords,9789,4,14,6,10,71,53,18,48
AaB,9789,5,9,12,9,40,42,-2,39
Sonderjyske,9789,6,8,6,10,28,29,-1,30
AC Horsens,9789,7,5,12,13,30,55,-25,27
Lyngby,9789,8,4,9,11,27,44,-17,21
Randers FC,9789,9,5,6,13,23,40,-17,21
Silkeborg IF,9789,10,5,4,13,26,45,-19,19
AGF Aarhus,9789,11,4,7,11,17,37,-20,19
Brondby,9790,1,22,5,3,78,33,45,71
FC Midtjylla,9790,2,19,6,5,62,39,23,63
FC Nords,9790,3,15,6,9,75,52,23,51
Copenhagen,9790,4,13,4,13,54,48,6,43
AaB,9790,5,8,12,10,35,42,-7,36
AC Horsens,9790,6,6,13,11,35,51,-16,31
Sonderjyske,9790,7,8,6,10,28,29,-1,30
Lyngby,9790,8,4,9,11,28,45,-17,21
Randers FC,9790,9,5,6,13,24,41,-17,21
Silkeborg IF,9790,10,5,4,13,25,44,-19,19
AGF Aarhus,9790,11,4,7,11,16,36,-20,19
Brondby,9791,1,20,7,3,67,30,37,67
FC Midtjylla,9791,2,19,6,5,62,36,26,63
FC Nords,9791,3,14,6,10,72,52,20,48
Copenhagen,9791,4,13,6,11,55,49,6,45
AaB,9791,5,8,11,11,36,42,-6,35
AC Horsens,9791,6,7,14,9,38,47,-9,35
Sonderjyske,9791,7,8,6,10,28,29,-1,30
Lyngby,9791,8,4,9,11,29,44,-15,21
Silkeborg IF,9791,9,6,3,13,27,45,-18,21
Randers FC,9791,10,5,6,13,23,42,-19,21
AGF Aarhus,9791,11,4,6,12,17,38,-21,18
Brondby,9792,1,21,6,3,74,35,39,69
FC Midtjylla,9792,2,21,5,4,68,35,33,68
FC Nords,9792,3,15,6,9,75,55,20,51
Copenhagen,9792,4,12,6,12,58,48,10,42
AC Horsens,9792,5,7,12,11,34,53,-19,33
AaB,9792,6,7,11,12,36,45,-9,32
Sonderjyske,9792,7,8,6,10,28,29,-1,30
Lyngby,9792,8,4,9,11,31,44,-13,21
Silkeborg IF,9792,9,6,3,13,28,45,-17,21
Randers FC,9792,10,5,6,13,23,44,-21,21
AGF Aarhus,9792,11,4,6,12,17,39,-22,18
Brondby,9793,1,20,6,4,69,33,36,66
FC Midtjylla,9793,2,19,4,7,61,41,20,61
FC Nords,9793,3,15,8,7,78,48,30,53
Copenhagen,9793,4,14,4,12,56,44,12,46
AC Horsens,9793,5,8,12,10,33,51,-18,36
AaB,9793,6,7,12,11,38,44,-6,33
Sonderjyske,9793,7,8,6,10,28,29,-1,30
Lyngby,9793,8,4,9,11,29,44,-15,21
AGF Aarhus,9793,9,5,6,11,20,37,-17,21
Randers FC,9793,10,5,6,13,23,42,-19,21
Silkeborg IF,9793,11,5,3,14,26,48,-22,18
Brondby,9794,1,22,6,2,72,31,41,72
FC Midtjylla,9794,2,19,6,5,62,39,23,63
FC Nords,9794,3,15,7,8,74,48,26,52
Copenhagen,9794,4,12,4,14,50,43,7,40
AaB,9794,5,8,12,10,35,41,-6,36
AC Horsens,9794,6,6,13,11,33,50,-17,31
Sonderjyske,9794,7,8,6,10,28,29,-1,30
Randers FC,9794,8,6,6,12,26,39,-13,24
Silkeborg IF,9794,9,6,3,13,27,44,-17,21
Lyngby,9794,10,3,9,12,26,47,-21,18
AGF Aarhus,9794,11,4,6,12,16,38,-22,18
Brondby,9795,1,21,7,2,76,35,41,70
FC Midtjylla,9795,2,20,5,5,67,38,29,65
Copenhagen,9795,3,15,4,11,59,48,11,49
FC Nords,9795,4,13,7,10,68,49,19,46
AaB,9795,5,8,11,11,37,44,-7,35
Sonderjyske,9795,6,8,6,10,28,29,-1,30
AC Horsens,9795,7,6,12,12,32,51,-19,30
Lyngby,9795,8,4,9,11,27,44,-17,21
Randers FC,9795,9,5,6,13,23,40,-17,21
Silkeborg IF,9795,10,6,3,13,26,44,-18,21
AGF Aarhus,9795,11,4,6,12,16,37,-21,18
Brondby,9796,1,22,5,3,74,32,42,71
FC Midtjylla,9796,2,20,5,5,67,40,27,65
FC Nords,9796,3,14,7,9,76,53,23,49
Copenhagen,9796,4,13,5,12,57,48,9,44
AaB,9796,5,8,11,11,40,51,-11,35
AC Horsens,9796,6,6,13,11,39,55,-16,31
Sonderjyske,9796,7,8,6,10,28,29,-1,30
Lyngby,9796,8,4,9,11,30,44,-14,21
AGF Aarhus,9796,9,5,6,11,17,36,-19,21
Randers FC,9796,10,5,6,13,23,43,-20,21
Silkeborg IF,9796,11,5,3,14,25,45,-20,18
Brondby,9797,1,22,5,3,72,31,41,71
FC Midtjylla,9797,2,20,5,5,69,36,33,65
FC Nords,9797,3,14,7,9,71,52,19,49
Copenhagen,9797,4,14,6,10,59,44,15,48
AC Horsens,9797,5,6,13,11,34,53,-19,31
Sonderjyske,9797,6,8,6,10,28,29,-1,30
AaB,9797,7,6,12,12,33,48,-15,30
Lyngby,9797,8,4,9,11,27,44,-17,21
Randers FC,9797,9,5,6,13,23,40,-17,21
Silkeborg IF,9797,10,6,3,13,26,44,-18,21
AGF Aarhus,9797,11,4,6,12,16,37,-21,18
Brondby,9798,1,20,7,3,68,33,35,67
FC Midtjylla,9798,2,19,5,6,64,39,25,62
FC Nords,9798,3,13,7,10,71,52,19,46
Copenhagen,9798,4,14,4,12,59,49,10,46
AaB,9798,5,9,13,8,39,39,0,40
AC Horsens,9798,6,7,12,11,37,52,-15,33
Sonderjyske,9798,7,8,6,10,28,29,-1,30
Randers FC,9798,8,6,6,12,24,39,-15,24
Silkeborg IF,9798,9,5,4,13,26,45,-19,19
AGF Aarhus,9798,10,4,7,11,17,37,-20,19
Lyngby,9798,11,3,9,12,26,45,-19,18
Brondby,9799,1,20,6,4,71,31,40,66
FC Midtjylla,9799,2,20,6,4,64,36,28,66
FC Nords,9799,3,14,6,10,76,56,20,48
Copenhagen,9799,4,13,5,12,58,50,8,44
AaB,9799,5,9,12,9,38,38,0,39
AC Horsens,9799,6,6,13,11,39,61,-22,31
Sonderjyske,9799,7,8,6,10,28,29,-1,30
Lyngby,9799,8,4,9,11,29,44,-15,21
Randers FC,9799,9,5,6,13,23,42,-19,21
Silkeborg IF,9799,10,5,4,13,26,45,-19,19
AGF Aarhus,9799,11,4,7,11,17,37,-20,19
Brondby,9800,1,22,5,3,75,33,42,71
FC Midtjylla,9800,2,19,6,5,65,40,25,63
FC Nords,9800,3,14,8,8,73,51,22,50
Copenhagen,9800,4,14,5,11,56,42,14,47
AaB,9800,5,7,13,10,36,42,-6,34
Sonderjyske,9800,6,8,6,10,28,29,-1,30
AC Horsens,9800,7,5,13,12,32,55,-23,28
Lyngby,9800,8,4,9,11,30,45,-15,21
Randers FC,9800,9,5,6,13,24,43,-19,21
Silkeborg IF,9800,10,5,4,13,27,46,-19,19
AGF Aarhus,9800,11,4,7,11,18,38,-20,19
Brondby,9801,1,20,8,2,69,32,37,68
FC Midtjylla,9801,2,17,6,7,57,39,18,57
FC Nords,9801,3,14,8,8,70,49,21,50
Copenhagen,9801,4,15,5,10,61,44,17,50
AaB,9801,5,8,12,10,39,41,-2,36
Sonderjyske,9801,6,8,6,10,28,29,-1,30
AC Horsens,9801,7,5,15,10,32,49,-17,30
Randers FC,9801,8,5,7,12,23,39,-16,22
Lyngby,9801,9,3,10,11,26,44,-18,19
Silkeborg IF,9801,10,5,4,13,26,45,-19,19
AGF Aarhus,9801,11,4,7,11,17,37,-20,19
Brondby,9802,1,20,8,2,71,31,40,68
FC Midtjylla,9802,2,19,7,4,69,41,28,64
FC Nords,9802,3,15,6,9,75,54,21,51
Copenhagen,9802,4,12,7,11,55,47,8,43
AaB,9802,5,7,14,9,39,43,-4,35
Sonderjyske,9802,6,8,6,10,28,29,-1,30
AC Horsens,9802,7,6,12,12,36,55,-19,30
Randers FC,9802,8,5,7,12,26,42,-16,22
AGF Aarhus,9802,9,5,6,11,19,36,-17,21
Lyngby,9802,10,3,10,11,29,47,-18,19
Silkeborg IF,9802,11,5,3,14,25,47,-22,18
FC Midtjylla,9803,1,22,4,4,71,40,31,70
Brondby,9803,2,19,7,4,68,34,34,64
FC Nords,9803,3,14,7,9,75,52,23,49
Copenhagen,9803,4,14,5,11,57,45,12,47
AaB,9803,5,6,14,10,35,41,-6,32
AC Horsens,9803,6,6,13,11,36,56,-20,31
Sonderjyske,9803,7,8,6,10,28,29,-1,30
Randers FC,9803,8,5,7,12,23,39,-16,22
Silkeborg IF,9803,9,6,3,13,27,44,-17,21
Lyngby,9803,10,3,10,11,26,44,-18,19
AGF Aarhus,9803,11,4,6,12,16,38,-22,18
Brondby,9804,1,22,6,2,72,29,43,72
FC Midtjylla,9804,2,20,4,6,64,38,26,64
FC Nords,9804,3,15,7,8,75,48,27,52
Copenhagen,9804,4,13,4,13,53,44,9,43
AaB,9804,5,8,11,11,36,45,-9,35
Sonderjyske,9804,6,8,6,10,28,29,-1,30
AC Horsens,9804,7,6,12,12,34,56,-22,30
Randers FC,9804,8,5,7,12,24,40,-16,22
AGF Aarhus,9804,9,5,6,11,17,36,-19,21
Lyngby,9804,10,3,10,11,27,45,-18,19
Silkeborg IF,9804,11,5,3,14,25,45,-20,18
Brondby,9805,1,21,5,4,70,32,38,68
FC Midtjylla,9805,2,20,5,5,68,39,29,65
FC Nords,9805,3,14,7,9,76,52,24,49
Copenhagen,9805,4,12,5,13,55,50,5,41
AaB,9805,5,9,12,9,37,41,-4,39
AC Horsens,9805,6,7,12,11,36,54,-18,33
Sonderjyske,9805,7,8,6,10,28,29,-1,30
Randers FC,9805,8,5,7,12,25,41,-16,22
Lyngby,9805,9,3,10,11,28,46,-18,19
Silkeborg IF,9805,10,5,4,13,25,44,-19,19
AGF Aarhus,9805,11,4,7,11,16,36,-20,19
Brondby,9806,1,21,6,3,70,30,40,69
FC Midtjylla,9806,2,20,4,6,63,38,25,64
FC Nords,9806,3,14,7,9,75,54,21,49
Copenhagen,9806,4,14,5,11,58,47,11,47
AC Horsens,9806,5,7,13,10,38,54,-16,34
AaB,9806,6,7,11,12,38,45,-7,32
Sonderjyske,9806,7,8,6,10,28,29,-1,30
Randers FC,9806,8,5,7,12,24,40,-16,22
AGF Aarhus,9806,9,5,6,11,19,37,-18,21
Lyngby,9806,10,3,10,11,27,45,-18,19
Silkeborg IF,9806,11,5,3,14,26,47,-21,18
Brondby,9807,1,20,7,3,66,29,37,67
FC Midtjylla,9807,2,20,4,6,67,39,28,64
Copenhagen,9807,3,14,5,11,59,44,15,47
FC Nords,9807,4,13,7,10,71,53,18,46
AC Horsens,9807,5,8,12,10,38,55,-17,36
AaB,9807,6,8,11,11,38,45,-7,35
Sonderjyske,9807,7,8,6,10,28,29,-1,30
Lyngby,9807,8,4,9,11,29,45,-16,21
Randers FC,9807,9,5,6,13,24,42,-18,21
AGF Aarhus,9807,10,5,6,11,17,36,-19,21
Silkeborg IF,9807,11,5,3,14,25,45,-20,18
Brondby,9808,1,22,5,3,74,32,42,71
FC Midtjylla,9808,2,19,4,7,66,40,26,61
FC Nords,9808,3,15,6,9,72,54,18,51
Copenhagen,9808,4,15,5,10,61,44,17,50
AaB,9808,5,7,12,11,35,43,-8,33
Sonderjyske,9808,6,8,6,10,28,29,-1,30
AC Horsens,9808,7,6,12,12,31,52,-21,30
Randers FC,9808,8,6,6,12,25,39,-14,24
Silkeborg IF,9808,9,6,3,13,29,44,-15,21
Lyngby,9808,10,3,9,12,26,46,-20,18
AGF Aarhus,9808,11,4,6,12,16,40,-24,18
FC Midtjylla,9809,1,20,5,5,67,40,27,65
Brondby,9809,2,19,7,4,68,35,33,64
Copenhagen,9809,3,15,5,10,59,43,16,50
FC Nords,9809,4,12,7,11,73,57,16,43
AaB,9809,5,8,12,10,37,40,-3,36
AC Horsens,9809,6,7,14,9,34,49,-15,35
Sonderjyske,9809,7,8,6,10,28,29,-1,30
Randers FC,9809,8,5,7,12,24,40,-16,22
Silkeborg IF,9809,9,6,3,13,28,44,-16,21
Lyngby,9809,10,3,10,11,27,45,-18,19
AGF Aarhus,9809,11,4,6,12,16,39,-23,18
Brondby,9810,1,22,6,2,77,30,47,72
FC Midtjylla,9810,2,21,4,5,71,39,32,67
FC Nords,9810,3,15,6,9,70,54,16,51
Copenhagen,9810,4,14,4,12,57,47,10,46
AC Horsens,9810,5,6,13,11,34,52,-18,31
Sonderjyske,9810,6,8,6,10,28,29,-1,30
AaB,9810,7,6,11,13,37,50,-13,29
Randers FC,9810,8,5,7,12,23,39,-16,22
Silkeborg IF,9810,9,6,3,13,28,45,-17,21
Lyngby,9810,10,3,10,11,26,44,-18,19
AGF Aarhus,9810,11,4,6,12,17,39,-22,18
Brondby,9811,1,20,7,3,66,29,37,67
FC Midtjylla,9811,2,18,8,4,65,39,26,62
FC Nords,9811,3,13,8,9,74,50,24,47
Copenhagen,9811,4,13,6,11,56,43,13,45
AaB,9811,5,8,13,9,36,40,-4,37
AC Horsens,9811,6,6,14,10,34,56,-22,32
Sonderjyske,9811,7,8,6,10,28,29,-1,30
Randers FC,9811,8,6,6,12,27,39,-12,24
Silkeborg IF,9811,9,6,3,13,28,44,-16,21
Lyngby,9811,10,3,9,12,26,48,-22,18
AGF Aarhus,9811,11,4,6,12,16,39,-23,18
Brondby,9812,1,20,7,3,72,33,39,67
FC Midtjylla,9812,2,21,4,5,68,39,29,67
FC Nords,9812,3,13,8,9,75,55,20,47
Copenhagen,9812,4,14,4,12,61,46,15,46
AaB,9812,5,8,13,9,37,42,-5,37
Sonderjyske,9812,6,8,6,10,28,29,-1,30
AC Horsens,9812,7,6,12,12,32,56,-24,30
Silkeborg IF,9812,8,6,3,13,28,45,-17,21
Lyngby,9812,9,4,9,11,27,44,-17,21
Randers FC,9812,10,5,6,13,23,40,-17,21
AGF Aarhus,9812,11,4,6,12,17,39,-22,18
Brondby,9813,1,20,5,5,69,35,34,65
FC Midtjylla,9813,2,19,5,6,65,40,25,62
Copenhagen,9813,3,15,4,11,58,42,16,49
FC Nords,9813,4,14,6,10,71,54,17,48
AaB,9813,5,9,12,9,40,39,1,39
AC Horsens,9813,6,7,12,11,31,50,-19,33
Sonderjyske,9813,7,8,6,10,28,29,-1,30
Randers FC,9813,8,5,7,12,23,39,-16,22
Silkeborg IF,9813,9,6,3,13,29,46,-17,21
Lyngby,9813,10,3,10,11,26,44,-18,19
AGF Aarhus,9813,11,4,6,12,18,40,-22,18
Brondby,9814,1,22,6,2,71,28,43,72
FC Midtjylla,9814,2,20,4,6,66,39,27,64
FC Nords,9814,3,15,6,9,77,51,26,51
Copenhagen,9814,4,14,5,11,60,45,15,47
AaB,9814,5,7,12,11,34,46,-12,33
Sonderjyske,9814,6,8,6,10,28,29,-1,30
AC Horsens,9814,7,5,13,12,30,55,-25,28
Lyngby,9814,8,4,9,11,29,46,-17,21
Randers FC,9814,9,5,6,13,25,42,-17,21
Silkeborg IF,9814,10,5,4,13,26,45,-19,19
AGF Aarhus,9814,11,4,7,11,17,37,-20,19
Brondby,9815,1,22,5,3,75,33,42,71
FC Midtjylla,9815,2,17,6,7,60,40,20,57
Copenhagen,9815,3,14,6,10,59,45,14,48
FC Nords,9815,4,13,8,9,71,55,16,47
AC Horsens,9815,5,7,14,9,35,48,-13,35
AaB,9815,6,7,13,10,39,44,-5,34
Sonderjyske,9815,7,8,6,10,28,29,-1,30
Lyngby,9815,8,4,9,11,27,44,-17,21
Randers FC,9815,9,5,6,13,23,40,-17,21
Silkeborg IF,9815,10,5,4,13,26,45,-19,19
AGF Aarhus,9815,11,4,7,11,17,37,-20,19
Brondby,9816,1,21,6,3,71,33,38,69
FC Midtjylla,9816,2,20,5,5,69,35,34,65
Copenhagen,9816,3,14,5,11,57,43,14,47
FC Nords,9816,4,12,8,10,68,52,16,44
AaB,9816,5,8,11,11,35,48,-13,35
AC Horsens,9816,6,7,13,10,33,48,-15,34
Sonderjyske,9816,7,8,6,10,28,29,-1,30
Randers FC,9816,8,5,7,12,24,40,-16,22
Lyngby,9816,9,3,10,11,27,45,-18,19
Silkeborg IF,9816,10,5,4,13,26,45,-19,19
AGF Aarhus,9816,11,4,7,11,17,37,-20,19
Brondby,9817,1,20,6,4,71,35,36,66
FC Midtjylla,9817,2,18,7,5,64,41,23,61
FC Nords,9817,3,15,7,8,73,52,21,52
Copenhagen,9817,4,14,5,11,59,42,17,47
AC Horsens,9817,5,7,13,10,36,52,-16,34
AaB,9817,6,6,14,10,36,43,-7,32
Sonderjyske,9817,7,8,6,10,28,29,-1,30
Randers FC,9817,8,5,7,12,24,40,-16,22
AGF Aarhus,9817,9,5,6,11,19,38,-19,21
Lyngby,9817,10,3,10,11,27,45,-18,19
Silkeborg IF,9817,11,5,3,14,27,47,-20,18
Brondby,9818,1,21,6,3,70,30,40,69
FC Midtjylla,9818,2,18,5,7,64,45,19,59
FC Nords,9818,3,14,7,9,75,52,23,49
Copenhagen,9818,4,13,6,11,54,44,10,45
AaB,9818,5,7,15,8,36,38,-2,36
AC Horsens,9818,6,7,13,10,33,49,-16,34
Sonderjyske,9818,7,8,6,10,28,29,-1,30
Randers FC,9818,8,5,7,12,23,39,-16,22
Silkeborg IF,9818,9,6,3,13,27,45,-18,21
Lyngby,9818,10,3,10,11,26,44,-18,19
AGF Aarhus,9818,11,4,6,12,17,38,-21,18
FC Midtjylla,9819,1,20,6,4,66,38,28,66
Brondby,9819,2,19,7,4,65,31,34,64
FC Nords,9819,3,15,8,7,78,49,29,53
Copenhagen,9819,4,12,7,11,53,47,6,43
AaB,9819,5,8,11,11,42,48,-6,35
AC Horsens,9819,6,6,13,11,36,53,-17,31
Sonderjyske,9819,7,8,6,10,28,29,-1,30
Randers FC,9819,8,6,6,12,26,41,-15,24
Silkeborg IF,9819,9,5,4,13,26,45,-19,19
AGF Aarhus,9819,10,4,7,11,17,37,-20,19
Lyngby,9819,11,3,9,12,28,47,-19,18
Brondby,9820,1,21,6,3,74,37,37,69
FC Midtjylla,9820,2,19,4,7,61,39,22,61
FC Nords,9820,3,13,8,9,72,53,19,47
Copenhagen,9820,4,14,5,11,61,45,16,47
AaB,9820,5,9,13,8,41,41,0,40
Sonderjyske,9820,6,8,6,10,28,29,-1,30
AC Horsens,9820,7,6,12,12,35,55,-20,30
Silkeborg IF,9820,8,6,3,13,29,44,-15,21
Lyngby,9820,9,4,9,11,29,45,-16,21
Randers FC,9820,10,5,6,13,24,42,-18,21
AGF Aarhus,9820,11,4,6,12,16,40,-24,18
Brondby,9821,1,22,5,3,73,33,40,71
FC Midtjylla,9821,2,19,5,6,65,41,24,62
FC Nords,9821,3,13,8,9,79,55,24,47
Copenhagen,9821,4,13,5,12,54,43,11,44
AC Horsens,9821,5,8,12,10,35,53,-18,36
AaB,9821,6,8,11,11,34,41,-7,35
Sonderjyske,9821,7,8,6,10,28,29,-1,30
Lyngby,9821,8,4,9,11,28,45,-17,21
Randers FC,9821,9,5,6,13,24,41,-17,21
AGF Aarhus,9821,10,5,6,11,18,37,-19,21
Silkeborg IF,9821,11,5,3,14,26,46,-20,18
FC Midtjylla,9822,1,21,4,5,61,36,25,67
Brondby,9822,2,18,6,6,63,32,31,60
FC Nords,9822,3,14,8,8,75,52,23,50
Copenhagen,9822,4,14,5,11,59,44,15,47
AaB,9822,5,8,13,9,40,41,-1,37
AC Horsens,9822,6,6,14,10,35,54,-19,32
Sonderjyske,9822,7,8,6,10,28,29,-1,30
Lyngby,9822,8,4,9,11,28,44,-16,21
Randers FC,9822,9,5,6,13,23,41,-18,21
Silkeborg IF,9822,10,5,4,13,26,45,-19,19
AGF Aarhus,9822,11,4,7,11,17,37,-20,19
Brondby,9823,1,22,5,3,70,29,41,71
FC Midtjylla,9823,2,17,6,7,60,40,20,57
FC Nords,9823,3,16,6,8,72,45,27,54
Copenhagen,9823,4,13,7,10,57,45,12,46
AaB,9823,5,8,12,10,38,41,-3,36
Sonderjyske,9823,6,8,6,10,28,29,-1,30
AC Horsens,9823,7,5,14,11,31,54,-23,29
Lyngby,9823,8,4,9,11,29,45,-16,21
Randers FC,9823,9,5,6,13,24,42,-18,21
Silkeborg IF,9823,10,5,4,13,26,45,-19,19
AGF Aarhus,9823,11,4,7,11,17,37,-20,19
FC Midtjylla,9824,1,21,4,5,66,38,28,67
Brondby,9824,2,20,5,5,68,35,33,65
FC Nords,9824,3,14,7,9,69,46,23,49
Copenhagen,9824,4,15,4,11,58,43,15,49
AC Horsens,9824,5,7,13,10,34,50,-16,34
AaB,9824,6,7,11,12,36,45,-9,32
Sonderjyske,9824,7,8,6,10,28,29,-1,30
Lyngby,9824,8,4,9,11,28,45,-17,21
Randers FC,9824,9,5,6,13,24,41,-17,21
Silkeborg IF,9824,10,6,3,13,26,44,-18,21
AGF Aarhus,9824,11,4,6,12,16,37,-21,18
Brondby,9825,1,22,6,2,73,30,43,72
FC Midtjylla,9825,2,19,5,6,63,37,26,62
FC Nords,9825,3,15,7,8,74,50,24,52
Copenhagen,9825,4,13,4,13,55,47,8,43
AaB,9825,5,7,12,11,38,46,-8,33
AC Horsens,9825,6,7,12,11,38,57,-19,33
Sonderjyske,9825,7,8,6,10,28,29,-1,30
Randers FC,9825,8,5,7,12,24,40,-16,22
Silkeborg IF,9825,9,6,3,13,28,45,-17,21
Lyngby,9825,10,3,10,11,27,45,-18,19
AGF Aarhus,9825,11,4,6,12,17,39,-22,18
Brondby,9826,1,20,6,4,68,31,37,66
FC Midtjylla,9826,2,20,4,6,68,42,26,64
FC Nords,9826,3,15,7,8,74,51,23,52
Copenhagen,9826,4,13,6,11,55,43,12,45
AaB,9826,5,7,13,10,40,46,-6,34
AC Horsens,9826,6,6,14,10,34,52,-18,32
Sonderjyske,9826,7,8,6,10,28,29,-1,30
Randers FC,9826,8,5,7,12,25,41,-16,22
Lyngby,9826,9,3,10,11,28,46,-18,19
Silkeborg IF,9826,10,5,4,13,28,47,-19,19
AGF Aarhus,9826,11,4,7,11,19,39,-20,19
FC Midtjylla,9827,1,21,4,5,67,38,29,67
Brondby,9827,2,19,8,3,69,33,36,65
FC Nords,9827,3,15,7,8,74,48,26,52
Copenhagen,9827,4,13,5,12,56,50,6,44
AaB,9827,5,8,11,11,41,45,-4,35
AC Horsens,9827,6,6,13,11,35,54,-19,31
Sonderjyske,9827,7,8,6,10,28,29,-1,30
Randers FC,9827,8,6,6,12,27,39,-12,24
AGF Aarhus,9827,9,5,6,11,18,36,-18,21
Silkeborg IF,9827,10,5,3,14,25,46,-21,18
Lyngby,9827,11,3,9,12,26,48,-22,18
Brondby,9828,1,22,5,3,76,33,43,71
FC Midtjylla,9828,2,20,4,6,69,42,27,64
FC Nords,9828,3,14,7,9,73,53,20,49
Copenhagen,9828,4,14,4,12,59,48,11,46
AaB,9828,5,7,12,11,38,45,-7,33
AC Horsens,9828,6,7,12,11,36,56,-20,33
Sonderjyske,9828,7,8,6,10,28,29,-1,30
Randers FC,9828,8,5,7,12,23,39,-16,22
Lyngby,9828,9,3,10,11,26,44,-18,19
Silkeborg IF,9828,10,5,4,13,26,45,-19,19
AGF Aarhus,9828,11,4,7,11,17,37,-20,19
Brondby,9829,1,21,6,3,74,33,41,69
FC Midtjylla,9829,2,21,4,5,65,36,29,67
FC Nords,9829,3,14,7,9,76,50,26,49
Copenhagen,9829,4,13,5,12,56,49,7,44
AaB,9829,5,7,12,11,36,47,-11,33
AC Horsens,9829,6,6,14,10,37,55,-18,32
Sonderjyske,9829,7,8,6,10,28,29,-1,30
Lyngby,9829,8,4,9,11,28,45,-17,21
Randers FC,9829,9,5,6,13,24,41,-17,21
AGF Aarhus,9829,10,5,6,11,19,36,-17,21
Silkeborg IF,9829,11,5,3,14,25,47,-22,18
Brondby,9830,1,21,6,3,73,30,43,69
FC Midtjylla,9830,2,21,4,5,63,35,28,67
Copenhagen,9830,3,15,5,10,57,43,14,50
FC Nords,9830,4,13,6,11,72,54,18,45
AaB,9830,5,7,11,12,35,46,-11,32
AC Horsens,9830,6,6,14,10,32,50,-18,32
Sonderjyske,9830,7,8,6,10,28,29,-1,30
Lyngby,9830,8,4,9,11,29,45,-16,21
Randers FC,9830,9,5,6,13,24,42,-18,21
AGF Aarhus,9830,10,5,6,11,18,37,-19,21
Silkeborg IF,9830,11,5,3,14,26,46,-20,18
Brondby,9831,1,20,5,5,69,38,31,65
FC Midtjylla,9831,2,19,5,6,67,42,25,62
FC Nords,9831,3,14,7,9,74,52,22,49
Copenhagen,9831,4,14,6,10,56,42,14,48
AaB,9831,5,8,12,10,37,39,-2,36
AC Horsens,9831,6,7,13,10,34,50,-16,34
Sonderjyske,9831,7,8,6,10,28,29,-1,30
Randers FC,9831,8,5,7,12,24,40,-16,22
AGF Aarhus,9831,9,5,6,11,18,36,-18,21
Lyngby,9831,10,3,10,11,27,45,-18,19
Silkeborg IF,9831,11,5,3,14,25,46,-21,18
Brondby,9832,1,21,6,3,70,30,40,69
FC Midtjylla,9832,2,18,6,6,65,42,23,60
FC Nords,9832,3,16,6,8,70,47,23,54
Copenhagen,9832,4,14,6,10,58,44,14,48
AaB,9832,5,7,11,12,37,42,-5,32
AC Horsens,9832,6,6,13,11,38,59,-21,31
Sonderjyske,9832,7,8,6,10,28,29,-1,30
Lyngby,9832,8,4,9,11,29,44,-15,21
Silkeborg IF,9832,9,6,3,13,28,46,-18,21
Randers FC,9832,10,5,6,13,23,42,-19,21
AGF Aarhus,9832,11,4,6,12,18,39,-21,18
Brondby,9833,1,21,5,4,69,31,38,68
FC Midtjylla,9833,2,18,5,7,59,38,21,59
Copenhagen,9833,3,17,4,9,67,46,21,55
FC Nords,9833,4,14,6,10,71,53,18,48
AaB,9833,5,8,12,10,35,41,-6,36
Sonderjyske,9833,6,8,6,10,28,29,-1,30
AC Horsens,9833,7,6,12,12,38,56,-18,30
Randers FC,9833,8,6,6,12,27,40,-13,24
Silkeborg IF,9833,9,6,3,13,28,45,-17,21
Lyngby,9833,10,3,9,12,27,48,-21,18
AGF Aarhus,9833,11,4,6,12,17,39,-22,18
Brondby,9834,1,20,6,4,66,32,34,66
FC Midtjylla,9834,2,20,5,5,70,40,30,65
FC Nords,9834,3,15,7,8,80,51,29,52
Copenhagen,9834,4,14,5,11,58,46,12,47
AaB,9834,5,7,13,10,37,42,-5,34
Sonderjyske,9834,6,8,6,10,28,29,-1,30
AC Horsens,9834,7,5,14,11,32,58,-26,29
Randers FC,9834,8,6,6,12,24,39,-15,24
Silkeborg IF,9834,9,6,3,13,28,44,-16,21
Lyngby,9834,10,3,9,12,26,45,-19,18
AGF Aarhus,9834,11,4,6,12,16,39,-23,18
Brondby,9835,1,22,6,2,74,32,42,72
FC Midtjylla,9835,2,19,6,5,67,41,26,63
FC Nords,9835,3,14,6,10,73,56,17,48
Copenhagen,9835,4,14,4,12,60,49,11,46
AaB,9835,5,7,12,11,38,45,-7,33
AC Horsens,9835,6,6,14,10,38,53,-15,32
Sonderjyske,9835,7,8,6,10,28,29,-1,30
Lyngby,9835,8,4,9,11,30,44,-14,21
Randers FC,9835,9,5,6,13,23,43,-20,21
Silkeborg IF,9835,10,5,4,13,26,45,-19,19
AGF Aarhus,9835,11,4,7,11,17,37,-20,19
Brondby,9836,1,21,6,3,68,30,38,69
FC Midtjylla,9836,2,19,5,6,64,40,24,62
FC Nords,9836,3,14,9,7,78,51,27,51
Copenhagen,9836,4,14,5,11,58,47,11,47
AaB,9836,5,6,14,10,37,43,-6,32
AC Horsens,9836,6,6,13,11,33,53,-20,31
Sonderjyske,9836,7,8,6,10,28,29,-1,30
Randers FC,9836,8,5,7,12,25,41,-16,22
AGF Aarhus,9836,9,5,6,11,19,38,-19,21
Lyngby,9836,10,3,10,11,28,46,-18,19
Silkeborg IF,9836,11,5,3,14,27,47,-20,18
FC Midtjylla,9837,1,21,4,5,65,38,27,67
Brondby,9837,2,20,6,4,70,39,31,66
Copenhagen,9837,3,14,5,11,62,50,12,47
FC Nords,9837,4,13,6,11,74,55,19,45
AaB,9837,5,7,14,9,38,42,-4,35
AC Horsens,9837,6,7,13,10,37,48,-11,34
Sonderjyske,9837,7,8,6,10,28,29,-1,30
Lyngby,9837,8,4,9,11,30,44,-14,21
Silkeborg IF,9837,9,6,3,13,27,45,-18,21
Randers FC,9837,10,5,6,13,23,43,-20,21
AGF Aarhus,9837,11,4,6,12,17,38,-21,18
Brondby,9838,1,19,7,4,67,35,32,64
FC Midtjylla,9838,2,20,4,6,67,40,27,64
FC Nords,9838,3,16,6,8,77,49,28,54
Copenhagen,9838,4,13,6,11,59,48,11,45
AaB,9838,5,8,11,11,37,43,-6,35
AC Horsens,9838,6,6,14,10,39,57,-18,32
Sonderjyske,9838,7,8,6,10,28,29,-1,30
Randers FC,9838,8,6,6,12,24,39,-15,24
Silkeborg IF,9838,9,6,3,13,27,45,-18,21
Lyngby,9838,10,3,9,12,26,45,-19,18
AGF Aarhus,9838,11,4,6,12,17,38,-21,18
FC Midtjylla,9839,1,21,5,4,65,37,28,68
Brondby,9839,2,20,7,3,68,30,38,67
FC Nords,9839,3,15,6,9,74,52,22,51
Copenhagen,9839,4,13,5,12,65,53,12,44
AaB,9839,5,8,11,11,39,44,-5,35
Sonderjyske,9839,6,8,6,10,28,29,-1,30
AC Horsens,9839,7,6,12,12,35,56,-21,30
Lyngby,9839,8,4,9,11,27,44,-17,21
Randers FC,9839,9,5,6,13,23,40,-17,21
Silkeborg IF,9839,10,6,3,13,26,44,-18,21
AGF Aarhus,9839,11,4,6,12,16,37,-21,18
Brondby,9840,1,23,5,2,73,29,44,74
FC Midtjylla,9840,2,20,4,6,66,38,28,64
FC Nords,9840,3,15,6,9,74,53,21,51
Copenhagen,9840,4,13,5,12,55,47,8,44
AaB,9840,5,8,11,11,35,41,-6,35
Sonderjyske,9840,6,8,6,10,28,29,-1,30
AC Horsens,9840,7,5,13,12,32,53,-21,28
Randers FC,9840,8,5,7,12,24,40,-16,22
Silkeborg IF,9840,9,6,3,13,29,45,-16,21
Lyngby,9840,10,3,10,11,27,45,-18,19
AGF Aarhus,9840,11,4,6,12,17,40,-23,18
Brondby,9841,1,22,5,3,72,31,41,71
FC Midtjylla,9841,2,20,5,5,65,38,27,65
Copenhagen,9841,3,14,6,10,58,44,14,48
FC Nords,9841,4,12,7,11,68,55,13,43
AaB,9841,5,7,12,11,38,43,-5,33
AC Horsens,9841,6,6,15,9,36,52,-16,33
Sonderjyske,9841,7,8,6,10,28,29,-1,30
Randers FC,9841,8,6,6,12,25,40,-15,24
Silkeborg IF,9841,9,5,4,13,25,44,-19,19
AGF Aarhus,9841,10,4,7,11,16,36,-20,19
Lyngby,9841,11,3,9,12,27,46,-19,18
Brondby,9842,1,21,7,2,74,35,39,70
FC Midtjylla,9842,2,17,5,8,60,43,17,56
Copenhagen,9842,3,15,5,10,62,46,16,50
FC Nords,9842,4,14,6,10,73,53,20,48
AC Horsens,9842,5,8,13,9,42,51,-9,37
AaB,9842,6,7,12,11,39,48,-9,33
Sonderjyske,9842,7,8,6,10,28,29,-1,30
Lyngby,9842,8,4,9,11,29,46,-17,21
Randers FC,9842,9,5,6,13,25,42,-17,21
Silkeborg IF,9842,10,6,3,13,26,44,-18,21
AGF Aarhus,9842,11,4,6,12,16,37,-21,18
Brondby,9843,1,22,5,3,71,30,41,71
FC Midtjylla,9843,2,20,4,6,64,35,29,64
FC Nords,9843,3,14,7,9,70,52,18,49
Copenhagen,9843,4,14,4,12,57,44,13,46
AaB,9843,5,7,13,10,36,43,-7,34
AC Horsens,9843,6,6,13,11,32,52,-20,31
Sonderjyske,9843,7,8,6,10,28,29,-1,30
Lyngby,9843,8,4,9,11,29,45,-16,21
Silkeborg IF,9843,9,6,3,13,28,46,-18,21
Randers FC,9843,10,5,6,13,24,42,-18,21
AGF Aarhus,9843,11,4,6,12,18,39,-21,18
Brondby,9844,1,23,5,2,73,33,40,74
FC Midtjylla,9844,2,19,4,7,62,39,23,61
FC Nords,9844,3,14,7,9,72,50,22,49
Copenhagen,9844,4,12,6,12,53,44,9,42
AaB,9844,5,7,13,10,40,46,-6,34
AC Horsens,9844,6,7,13,10,37,51,-14,34
Sonderjyske,9844,7,8,6,10,28,29,-1,30
Randers FC,9844,8,5,7,12,24,40,-16,22
Silkeborg IF,9844,9,6,3,13,28,45,-17,21
Lyngby,9844,10,3,10,11,27,45,-18,19
AGF Aarhus,9844,11,4,6,12,17,39,-22,18
Brondby,9845,1,21,6,3,70,34,36,69
FC Midtjylla,9845,2,19,6,5,66,37,29,63
Copenhagen,9845,3,13,7,10,60,45,15,46
FC Nords,9845,4,12,9,9,72,57,15,45
AC Horsens,9845,5,7,13,10,35,50,-15,34
AaB,9845,6,6,15,9,40,46,-6,33
Sonderjyske,9845,7,8,6,10,28,29,-1,30
Randers FC,9845,8,5,7,12,24,40,-16,22
Silkeborg IF,9845,9,6,3,13,31,45,-14,21
Lyngby,9845,10,3,10,11,27,45,-18,19
AGF Aarhus,9845,11,4,6,12,17,42,-25,18
Brondby,9846,1,18,7,5,64,35,29,61
FC Midtjylla,9846,2,18,5,7,62,40,22,59
FC Nords,9846,3,15,8,7,75,51,24,53
Copenhagen,9846,4,13,6,11,54,42,12,45
AaB,9846,5,8,13,9,37,40,-3,37
AC Horsens,9846,6,8,13,9,38,48,-10,37
Sonderjyske,9846,7,8,6,10,28,29,-1,30
Lyngby,9846,8,4,9,11,29,44,-15,21
Silkeborg IF,9846,9,6,3,13,29,45,-16,21
Randers FC,9846,10,5,6,13,23,42,-19,21
AGF Aarhus,9846,11,4,6,12,17,40,-23,18
Brondby,9847,1,22,6,2,75,32,43,72
FC Midtjylla,9847,2,20,5,5,67,39,28,65
FC Nords,9847,3,15,6,9,72,55,17,51
Copenhagen,9847,4,12,5,13,57,49,8,41
AaB,9847,5,7,12,11,39,45,-6,33
AC Horsens,9847,6,6,14,10,34,50,-16,32
Sonderjyske,9847,7,8,6,10,28,29,-1,30
Randers FC,9847,8,6,6,12,24,39,-15,24
Silkeborg IF,9847,9,5,4,13,26,45,-19,19
AGF Aarhus,9847,10,4,7,11,17,37,-20,19
Lyngby,9847,11,3,9,12,26,45,-19,18
Brondby,9848,1,21,6,3,70,32,38,69
FC Midtjylla,9848,2,20,4,6,73,43,30,64
FC Nords,9848,3,12,10,8,76,57,19,46
Copenhagen,9848,4,12,5,13,57,50,7,41
AC Horsens,9848,5,8,13,9,40,54,-14,37
AaB,9848,6,8,12,10,39,45,-6,36
Sonderjyske,9848,7,8,6,10,28,29,-1,30
Randers FC,9848,8,6,6,12,26,39,-13,24
Silkeborg IF,9848,9,6,3,13,27,44,-17,21
Lyngby,9848,10,3,9,12,26,47,-21,18
AGF Aarhus,9848,11,4,6,12,16,38,-22,18
Brondby,9849,1,21,6,3,72,31,41,69
FC Midtjylla,9849,2,19,5,6,64,39,25,62
FC Nords,9849,3,16,7,7,78,47,31,55
Copenhagen,9849,4,12,6,12,53,47,6,42
AaB,9849,5,8,12,10,35,43,-8,36
Sonderjyske,9849,6,8,6,10,28,29,-1,30
AC Horsens,9849,7,5,14,11,34,55,-21,29
Randers FC,9849,8,5,7,12,23,39,-16,22
Silkeborg IF,9849,9,6,3,13,27,44,-17,21
Lyngby,9849,10,3,10,11,26,44,-18,19
AGF Aarhus,9849,11,4,6,12,16,38,-22,18
Brondby,9850,1,21,5,4,77,34,43,68
FC Midtjylla,9850,2,20,5,5,67,40,27,65
FC Nords,9850,3,14,7,9,71,56,15,49
Copenhagen,9850,4,13,8,9,57,43,14,47
AaB,9850,5,7,12,11,35,41,-6,33
AC Horsens,9850,6,6,13,11,33,52,-19,31
Sonderjyske,9850,7,8,6,10,28,29,-1,30
Lyngby,9850,8,4,9,11,31,44,-13,21
Silkeborg IF,9850,9,6,3,13,26,44,-18,21
Randers FC,9850,10,5,6,13,23,44,-21,21
AGF Aarhus,9850,11,4,6,12,16,37,-21,18
Brondby,9851,1,22,6,2,75,35,40,72
FC Midtjylla,9851,2,20,4,6,67,38,29,64
FC Nords,9851,3,14,7,9,73,51,22,49
Copenhagen,9851,4,13,5,12,56,48,8,44
AaB,9851,5,7,12,11,36,46,-10,33
AC Horsens,9851,6,7,12,11,33,48,-15,33
Sonderjyske,9851,7,8,6,10,28,29,-1,30
Lyngby,9851,8,4,9,11,28,44,-16,21
Silkeborg IF,9851,9,6,3,13,27,45,-18,21
Randers FC,9851,10,5,6,13,23,41,-18,21
AGF Aarhus,9851,11,4,6,12,17,38,-21,18
Brondby,9852,1,21,5,4,69,35,34,68
FC Midtjylla,9852,2,17,6,7,62,41,21,57
FC Nords,9852,3,15,8,7,77,49,28,53
Copenhagen,9852,4,13,5,12,53,44,9,44
AC Horsens,9852,5,9,12,9,41,50,-9,39
AaB,9852,6,7,12,11,34,43,-9,33
Sonderjyske,9852,7,8,6,10,28,29,-1,30
Randers FC,9852,8,5,7,12,24,40,-16,22
Silkeborg IF,9852,9,6,3,13,28,46,-18,21
Lyngby,9852,10,3,10,11,27,45,-18,19
AGF Aarhus,9852,11,4,6,12,18,39,-21,18
Brondby,9853,1,22,5,3,71,30,41,71
FC Midtjylla,9853,2,19,4,7,67,37,30,61
Copenhagen,9853,3,14,7,9,58,42,16,49
FC Nords,9853,4,12,7,11,70,59,11,43
AaB,9853,5,8,12,10,39,43,-4,36
AC Horsens,9853,6,7,13,10,37,57,-20,34
Sonderjyske,9853,7,8,6,10,28,29,-1,30
Randers FC,9853,8,5,7,12,24,40,-16,22
Silkeborg IF,9853,9,6,3,13,27,44,-17,21
Lyngby,9853,10,3,10,11,27,45,-18,19
AGF Aarhus,9853,11,4,6,12,16,38,-22,18
Brondby,9854,1,21,5,4,68,33,35,68
FC Midtjylla,9854,2,19,5,6,61,37,24,62
FC Nords,9854,3,15,7,8,72,48,24,52
Copenhagen,9854,4,14,5,11,58,45,13,47
AaB,9854,5,7,12,11,34,41,-7,33
AC Horsens,9854,6,7,12,11,33,48,-15,33
Sonderjyske,9854,7,8,6,10,28,29,-1,30
Lyngby,9854,8,4,9,11,29,46,-17,21
Randers FC,9854,9,5,6,13,25,42,-17,21
AGF Aarhus,9854,10,5,6,11,17,36,-19,21
Silkeborg IF,9854,11,5,3,14,25,45,-20,18
FC Midtjylla,9855,1,21,4,5,70,35,35,67
Brondby,9855,2,20,5,5,67,36,31,65
FC Nords,9855,3,15,7,8,71,48,23,52
Copenhagen,9855,4,13,6,11,61,44,17,45
AaB,9855,5,8,13,9,40,44,-4,37
Sonderjyske,9855,6,8,6,10,28,29,-1,30
AC Horsens,9855,7,5,13,12,29,57,-28,28
Randers FC,9855,8,6,6,12,26,39,-13,24
AGF Aarhus,9855,9,5,6,11,18,36,-18,21
Lyngby,9855,10,3,9,12,26,47,-21,18
Silkeborg IF,9855,11,5,3,14,25,46,-21,18
FC Midtjylla,9856,1,21,4,5,70,39,31,67
Brondby,9856,2,19,6,5,67,34,33,63
FC Nords,9856,3,14,8,8,70,48,22,50
Copenhagen,9856,4,15,4,11,60,45,15,49
AaB,9856,5,7,12,11,37,46,-9,33
AC Horsens,9856,6,7,12,11,35,53,-18,33
Sonderjyske,9856,7,8,6,10,28,29,-1,30
Randers FC,9856,8,5,7,12,25,41,-16,22
AGF Aarhus,9856,9,5,6,11,17,36,-19,21
Lyngby,9856,10,3,10,11,28,46,-18,19
Silkeborg IF,9856,11,5,3,14,25,45,-20,18
Brondby,9857,1,20,8,2,68,30,38,68
FC Midtjylla,9857,2,18,6,6,64,39,25,60
FC Nords,9857,3,15,7,8,79,51,28,52
Copenhagen,9857,4,13,6,11,53,43,10,45
AaB,9857,5,8,13,9,37,43,-6,37
Sonderjyske,9857,6,8,6,10,28,29,-1,30
AC Horsens,9857,7,5,14,11,33,54,-21,29
Randers FC,9857,8,6,6,12,25,39,-14,24
Silkeborg IF,9857,9,6,3,13,28,45,-17,21
Lyngby,9857,10,3,9,12,26,46,-20,18
AGF Aarhus,9857,11,4,6,12,17,39,-22,18
Brondby,9858,1,20,6,4,68,36,32,66
FC Midtjylla,9858,2,18,6,6,63,43,20,60
FC Nords,9858,3,15,6,9,75,51,24,51
Copenhagen,9858,4,15,5,10,63,42,21,50
AC Horsens,9858,5,7,13,10,35,50,-15,34
AaB,9858,6,6,14,10,39,47,-8,32
Sonderjyske,9858,7,8,6,10,28,29,-1,30
Lyngby,9858,8,4,9,11,27,44,-17,21
Randers FC,9858,9,5,6,13,23,40,-17,21
Silkeborg IF,9858,10,6,3,13,26,44,-18,21
AGF Aarhus,9858,11,4,6,12,16,37,-21,18
Brondby,9859,1,21,5,4,73,33,40,68
FC Midtjylla,9859,2,19,6,5,64,39,25,63
FC Nords,9859,3,14,8,8,73,51,22,50
Copenhagen,9859,4,14,5,11,53,40,13,47
AC Horsens,9859,5,8,13,9,40,53,-13,37
Sonderjyske,9859,6,8,6,10,28,29,-1,30
AaB,9859,7,6,11,13,34,47,-13,29
Randers FC,9859,8,5,7,12,24,40,-16,22
Silkeborg IF,9859,9,6,3,13,28,45,-17,21
Lyngby,9859,10,3,10,11,27,45,-18,19
AGF Aarhus,9859,11,4,6,12,17,39,-22,18
Brondby,9860,1,20,6,4,71,36,35,66
FC Midtjylla,9860,2,20,6,4,65,38,27,66
FC Nords,9860,3,12,9,9,71,53,18,45
Copenhagen,9860,4,12,7,11,58,49,9,43
AC Horsens,9860,5,7,15,8,37,48,-11,36
AaB,9860,6,7,13,10,39,43,-4,34
Sonderjyske,9860,7,8,6,10,28,29,-1,30
Randers FC,9860,8,5,7,12,25,41,-16,22
Silkeborg IF,9860,9,6,3,13,29,44,-15,21
Lyngby,9860,10,3,10,11,28,46,-18,19
AGF Aarhus,9860,11,4,6,12,16,40,-24,18
Brondby,9861,1,20,6,4,67,31,36,66
FC Midtjylla,9861,2,18,7,5,65,40,25,61
FC Nords,9861,3,13,9,8,73,50,23,48
Copenhagen,9861,4,13,6,11,55,43,12,45
AaB,9861,5,9,13,8,40,40,0,40
AC Horsens,9861,6,6,13,11,33,55,-22,31
Sonderjyske,9861,7,8,6,10,28,29,-1,30
Lyngby,9861,8,4,9,11,29,44,-15,21
Silkeborg IF,9861,9,6,3,13,27,44,-17,21
Randers FC,9861,10,5,6,13,23,42,-19,21
AGF Aarhus,9861,11,4,6,12,16,38,-22,18
Brondby,9862,1,21,6,3,71,32,39,69
FC Midtjylla,9862,2,18,6,6,63,42,21,60
FC Nords,9862,3,15,7,8,75,51,24,52
Copenhagen,9862,4,13,5,12,54,44,10,44
AaB,9862,5,7,13,10,34,41,-7,34
AC Horsens,9862,6,7,13,10,37,50,-13,34
Sonderjyske,9862,7,8,6,10,28,29,-1,30
Lyngby,9862,8,4,9,11,27,44,-17,21
Randers FC,9862,9,5,6,13,23,40,-17,21
Silkeborg IF,9862,10,6,3,13,26,44,-18,21
AGF Aarhus,9862,11,4,6,12,16,37,-21,18
Brondby,9863,1,21,5,4,70,32,38,68
FC Midtjylla,9863,2,20,5,5,64,36,28,65
Copenhagen,9863,3,14,6,10,56,42,14,48
FC Nords,9863,4,13,7,10,69,51,18,46
AaB,9863,5,8,12,10,35,41,-6,36
AC Horsens,9863,6,6,13,11,33,51,-18,31
Sonderjyske,9863,7,8,6,10,28,29,-1,30
Randers FC,9863,8,6,6,12,27,40,-13,24
Silkeborg IF,9863,9,6,3,13,27,44,-17,21
Lyngby,9863,10,3,9,12,27,48,-21,18
AGF Aarhus,9863,11,4,6,12,16,38,-22,18
Brondby,9864,1,22,5,3,71,32,39,71
FC Midtjylla,9864,2,22,4,4,68,36,32,70
FC Nords,9864,3,14,6,10,72,53,19,48
Copenhagen,9864,4,13,5,12,56,44,12,44
AC Horsens,9864,5,7,13,10,36,51,-15,34
Sonderjyske,9864,6,8,6,10,28,29,-1,30
AaB,9864,7,6,11,13,37,50,-13,29
Randers FC,9864,8,6,6,12,25,40,-15,24
Silkeborg IF,9864,9,6,3,13,28,44,-16,21
Lyngby,9864,10,3,9,12,27,46,-19,18
AGF Aarhus,9864,11,4,6,12,16,39,-23,18
Brondby,9865,1,20,8,2,70,31,39,68
FC Midtjylla,9865,2,19,5,6,66,47,19,62
FC Nords,9865,3,15,6,9,80,57,23,51
Copenhagen,9865,4,13,6,11,65,47,18,45
AaB,9865,5,7,14,9,35,39,-4,35
AC Horsens,9865,6,6,13,11,33,54,-21,31
Sonderjyske,9865,7,8,6,10,28,29,-1,30
Lyngby,9865,8,4,9,11,29,46,-17,21
Randers FC,9865,9,5,6,13,25,42,-17,21
AGF Aarhus,9865,10,5,6,11,20,39,-19,21
Silkeborg IF,9865,11,5,3,14,28,48,-20,18
Brondby,9866,1,20,7,3,71,35,36,67
FC Midtjylla,9866,2,20,6,4,69,39,30,66
FC Nords,9866,3,15,7,8,80,50,30,52
Copenhagen,9866,4,15,5,10,65,48,17,50
Sonderjyske,9866,5,8,6,10,28,29,-1,30
AC Horsens,9866,6,6,12,12,35,60,-25,30
AaB,9866,7,6,11,13,34,48,-14,29
Lyngby,9866,8,4,9,11,28,45,-17,21
Silkeborg IF,9866,8,6,3,13,28,45,-17,21
Randers FC,9866,10,5,6,13,24,41,-17,21
AGF Aarhus,9866,11,4,6,12,17,39,-22,18
FC Midtjylla,9867,1,21,4,5,69,39,30,67
Brondby,9867,2,20,6,4,72,35,37,66
FC Nords,9867,3,16,6,8,78,54,24,54
Copenhagen,9867,4,13,5,12,56,47,9,44
AaB,9867,5,7,12,11,36,45,-9,33
AC Horsens,9867,6,6,13,11,38,55,-17,31
Sonderjyske,9867,7,8,6,10,28,29,-1,30
Lyngby,9867,8,4,9,11,28,45,-17,21
Randers FC,9867,9,5,6,13,24,41,-17,21
AGF Aarhus,9867,10,5,6,11,18,36,-18,21
Silkeborg IF,9867,11,5,3,14,25,46,-21,18
Brondby,9868,1,21,6,3,73,32,41,69
FC Midtjylla,9868,2,18,5,7,64,46,18,59
FC Nords,9868,3,15,6,9,82,58,24,51
Copenhagen,9868,4,13,5,12,61,48,13,44
AaB,9868,5,10,11,9,40,40,0,41
AC Horsens,9868,6,6,13,11,34,56,-22,31
Sonderjyske,9868,7,8,6,10,28,29,-1,30
Randers FC,9868,8,6,6,12,25,40,-15,24
Silkeborg IF,9868,9,5,4,13,27,46,-19,19
AGF Aarhus,9868,10,4,7,11,18,38,-20,19
Lyngby,9868,11,3,9,12,27,46,-19,18
Brondby,9869,1,21,6,3,64,28,36,69
FC Midtjylla,9869,2,19,6,5,67,39,28,63
FC Nords,9869,3,15,7,8,78,50,28,52
Copenhagen,9869,4,12,5,13,53,46,7,41
AaB,9869,5,8,13,9,37,41,-4,37
AC Horsens,9869,6,6,13,11,33,54,-21,31
Sonderjyske,9869,7,8,6,10,28,29,-1,30
Lyngby,9869,8,4,9,11,31,45,-14,21
Randers FC,9869,9,5,6,13,24,44,-20,21
Silkeborg IF,9869,10,5,4,13,26,45,-19,19
AGF Aarhus,9869,11,4,7,11,17,37,-20,19
Brondby,9870,1,21,6,3,74,31,43,69
FC Midtjylla,9870,2,20,4,6,64,41,23,64
FC Nords,9870,3,14,6,10,73,53,20,48
Copenhagen,9870,4,13,6,11,55,43,12,45
AaB,9870,5,8,12,10,38,43,-5,36
AC Horsens,9870,6,7,12,11,34,53,-19,33
Sonderjyske,9870,7,8,6,10,28,29,-1,30
Lyngby,9870,8,4,9,11,29,45,-16,21
Silkeborg IF,9870,9,6,3,13,28,45,-17,21
Randers FC,9870,10,5,6,13,24,42,-18,21
AGF Aarhus,9870,11,4,6,12,17,39,-22,18
Brondby,9871,1,21,5,4,69,37,32,68
FC Midtjylla,9871,2,20,4,6,64,40,24,64
Copenhagen,9871,3,15,5,10,64,45,19,50
FC Nords,9871,4,14,6,10,78,52,26,48
AaB,9871,5,9,11,10,39,43,-4,38
Sonderjyske,9871,6,8,6,10,28,29,-1,30
AC Horsens,9871,7,5,13,12,31,54,-23,28
Randers FC,9871,8,5,7,12,24,40,-16,22
Silkeborg IF,9871,9,6,3,13,27,45,-18,21
Lyngby,9871,10,3,10,11,27,45,-18,19
AGF Aarhus,9871,11,4,6,12,17,38,-21,18
Brondby,9872,1,21,5,4,74,37,37,68
FC Midtjylla,9872,2,21,4,5,66,40,26,67
FC Nords,9872,3,14,7,9,74,54,20,49
Copenhagen,9872,4,13,5,12,58,45,13,44
AaB,9872,5,8,11,11,38,43,-5,35
AC Horsens,9872,6,6,14,10,39,56,-17,32
Sonderjyske,9872,7,8,6,10,28,29,-1,30
Randers FC,9872,8,5,7,12,24,40,-16,22
Silkeborg IF,9872,9,6,3,13,28,45,-17,21
Lyngby,9872,10,3,10,11,27,45,-18,19
AGF Aarhus,9872,11,4,6,12,17,39,-22,18
FC Midtjylla,9873,1,19,7,4,63,36,27,64
Brondby,9873,2,18,7,5,66,38,28,61
Copenhagen,9873,3,15,5,10,60,44,16,50
FC Nords,9873,4,12,9,9,71,52,19,45
AaB,9873,5,8,13,9,38,42,-4,37
AC Horsens,9873,6,7,13,10,36,48,-12,34
Sonderjyske,9873,7,8,6,10,28,29,-1,30
Lyngby,9873,8,4,9,11,28,45,-17,21
Randers FC,9873,9,5,6,13,24,41,-17,21
AGF Aarhus,9873,10,5,6,11,19,38,-19,21
Silkeborg IF,9873,11,5,3,14,27,47,-20,18
Brondby,9874,1,20,7,3,69,31,38,67
FC Midtjylla,9874,2,19,5,6,69,41,28,62
Copenhagen,9874,3,16,5,9,60,41,19,53
FC Nords,9874,4,14,9,7,74,51,23,51
AaB,9874,5,7,12,11,36,45,-9,33
Sonderjyske,9874,6,8,6,10,28,29,-1,30
AC Horsens,9874,7,5,12,13,32,57,-25,27
Randers FC,9874,8,5,7,12,25,41,-16,22
Lyngby,9874,9,3,10,11,28,46,-18,19
Silkeborg IF,9874,10,5,4,13,25,44,-19,19
AGF Aarhus,9874,11,4,7,11,16,36,-20,19
Brondby,9875,1,22,5,3,72,29,43,71
FC Midtjylla,9875,2,17,6,7,58,40,18,57
FC Nords,9875,3,16,6,8,75,50,25,54
Copenhagen,9875,4,13,5,12,54,47,7,44
AaB,9875,5,8,12,10,38,39,-1,36
AC Horsens,9875,6,7,12,11,34,52,-18,33
Sonderjyske,9875,7,8,6,10,28,29,-1,30
Lyngby,9875,8,4,9,11,28,45,-17,21
Silkeborg IF,9875,9,6,3,13,27,44,-17,21
Randers FC,9875,10,5,6,13,24,41,-17,21
AGF Aarhus,9875,11,4,6,12,16,38,-22,18
Brondby,9876,1,20,6,4,71,34,37,66
FC Midtjylla,9876,2,19,6,5,69,41,28,63
FC Nords,9876,3,13,8,9,70,52,18,47
Copenhagen,9876,4,14,5,11,59,46,13,47
AaB,9876,5,8,11,11,34,42,-8,35
AC Horsens,9876,6,7,14,9,40,54,-14,35
Sonderjyske,9876,7,8,6,10,28,29,-1,30
Randers FC,9876,8,6,6,12,25,40,-15,24
AGF Aarhus,9876,9,5,6,11,19,36,-17,21
Lyngby,9876,10,3,9,12,27,46,-19,18
Silkeborg IF,9876,11,5,3,14,25,47,-22,18
Brondby,9877,1,21,5,4,75,35,40,68
FC Midtjylla,9877,2,18,7,5,65,43,22,61
FC Nords,9877,3,15,7,8,70,49,21,52
Copenhagen,9877,4,14,5,11,55,42,13,47
AaB,9877,5,8,12,10,39,41,-2,36
Sonderjyske,9877,6,8,6,10,28,29,-1,30
AC Horsens,9877,7,6,12,12,34,54,-20,30
Lyngby,9877,8,4,9,11,27,44,-17,21
Silkeborg IF,9877,8,6,3,13,27,44,-17,21
Randers FC,9877,10,5,6,13,23,40,-17,21
AGF Aarhus,9877,11,4,6,12,16,38,-22,18
FC Midtjylla,9878,1,21,4,5,68,38,30,67
Brondby,9878,2,20,6,4,74,35,39,66
Copenhagen,9878,3,15,6,9,59,43,16,51
FC Nords,9878,4,14,7,9,71,49,22,49
AC Horsens,9878,5,7,12,11,36,54,-18,33
Sonderjyske,9878,6,8,6,10,28,29,-1,30
AaB,9878,7,6,11,13,34,49,-15,29
Randers FC,9878,8,6,6,12,26,41,-15,24
AGF Aarhus,9878,9,5,6,11,17,36,-19,21
Lyngby,9878,10,3,9,12,28,47,-19,18
Silkeborg IF,9878,11,5,3,14,25,45,-20,18
Brondby,9879,1,23,5,2,78,30,48,74
FC Midtjylla,9879,2,19,5,6,65,39,26,62
FC Nords,9879,3,13,6,11,73,57,16,45
Copenhagen,9879,4,13,6,11,61,50,11,45
AaB,9879,5,8,11,11,36,47,-11,35
AC Horsens,9879,6,7,13,10,34,50,-16,34
Sonderjyske,9879,7,8,6,10,28,29,-1,30
Randers FC,9879,8,6,6,12,24,39,-15,24
Silkeborg IF,9879,9,5,4,13,25,44,-19,19
AGF Aarhus,9879,10,4,7,11,16,36,-20,19
Lyngby,9879,11,3,9,12,26,45,-19,18
Brondby,9880,1,21,5,4,70,37,33,68
FC Midtjylla,9880,2,20,5,5,64,38,26,65
FC Nords,9880,3,13,6,11,75,56,19,45
Copenhagen,9880,4,13,5,12,52,43,9,44
AC Horsens,9880,5,8,13,9,40,49,-9,37
AaB,9880,6,8,12,10,37,41,-4,36
Sonderjyske,9880,7,8,6,10,28,29,-1,30
Randers FC,9880,8,6,6,12,25,40,-15,24
Silkeborg IF,9880,9,5,4,13,27,46,-19,19
AGF Aarhus,9880,10,4,7,11,18,38,-20,19
Lyngby,9880,11,3,9,12,27,46,-19,18
Brondby,9881,1,21,5,4,74,35,39,68
FC Midtjylla,9881,2,19,5,6,67,44,23,62
FC Nords,9881,3,15,7,8,79,50,29,52
Copenhagen,9881,4,15,4,11,62,47,15,49
AC Horsens,9881,5,8,12,10,37,54,-17,36
Sonderjyske,9881,6,8,6,10,28,29,-1,30
AaB,9881,7,6,11,13,38,53,-15,29
Lyngby,9881,8,4,9,11,27,44,-17,21
Silkeborg IF,9881,8,6,3,13,27,44,-17,21
Randers FC,9881,10,5,6,13,23,40,-17,21
AGF Aarhus,9881,11,4,6,12,16,38,-22,18
Brondby,9882,1,20,7,3,70,30,40,67
FC Midtjylla,9882,2,18,5,7,62,40,22,59
FC Nords,9882,3,15,7,8,80,50,30,52
Copenhagen,9882,4,15,5,10,59,45,14,50
AC Horsens,9882,5,7,13,10,36,57,-21,34
AaB,9882,6,6,13,11,33,44,-11,31
Sonderjyske,9882,7,8,6,10,28,29,-1,30
Lyngby,9882,8,4,9,11,28,44,-16,21
Randers FC,9882,9,5,6,13,23,41,-18,21
AGF Aarhus,9882,10,5,6,11,18,36,-18,21
Silkeborg IF,9882,11,5,3,14,25,46,-21,18
Brondby,9883,1,20,6,4,71,35,36,66
FC Midtjylla,9883,2,20,4,6,64,40,24,64
Copenhagen,9883,3,15,5,10,64,43,21,50
FC Nords,9883,4,13,7,10,69,53,16,46
AaB,9883,5,8,13,9,39,43,-4,37
AC Horsens,9883,6,6,13,11,32,51,-19,31
Sonderjyske,9883,7,8,6,10,28,29,-1,30
Randers FC,9883,8,6,6,12,25,39,-14,24
Silkeborg IF,9883,9,5,4,13,26,45,-19,19
AGF Aarhus,9883,10,4,7,11,17,37,-20,19
Lyngby,9883,11,3,9,12,26,46,-20,18
Brondby,9884,1,20,5,5,70,37,33,65
FC Midtjylla,9884,2,18,5,7,63,43,20,59
FC Nords,9884,3,16,6,8,73,51,22,54
Copenhagen,9884,4,16,4,10,64,41,23,52
AC Horsens,9884,5,7,14,9,42,53,-11,35
Sonderjyske,9884,6,8,6,10,28,29,-1,30
AaB,9884,7,6,12,12,35,48,-13,30
Randers FC,9884,8,5,7,12,24,40,-16,22
Silkeborg IF,9884,9,6,3,13,27,45,-18,21
Lyngby,9884,10,3,10,11,27,45,-18,19
AGF Aarhus,9884,11,4,6,12,17,38,-21,18
Brondby,9885,1,22,5,3,68,32,36,71
FC Midtjylla,9885,2,19,4,7,66,41,25,61
FC Nords,9885,3,16,6,8,79,48,31,54
Copenhagen,9885,4,14,5,11,60,46,14,47
AaB,9885,5,7,12,11,37,43,-6,33
Sonderjyske,9885,6,8,6,10,28,29,-1,30
AC Horsens,9885,7,6,12,12,33,59,-26,30
Randers FC,9885,8,6,6,12,26,40,-14,24
Silkeborg IF,9885,9,6,3,13,28,46,-18,21
Lyngby,9885,10,3,9,12,27,47,-20,18
AGF Aarhus,9885,11,4,6,12,18,39,-21,18
Brondby,9886,1,21,5,4,71,32,39,68
FC Midtjylla,9886,2,17,5,8,63,45,18,56
FC Nords,9886,3,16,6,8,74,47,27,54
Copenhagen,9886,4,13,6,11,58,49,9,45
AaB,9886,5,8,12,10,36,43,-7,36
AC Horsens,9886,6,7,14,9,40,52,-12,35
Sonderjyske,9886,7,8,6,10,28,29,-1,30
Randers FC,9886,8,5,7,12,24,40,-16,22
Silkeborg IF,9886,9,6,3,13,28,46,-18,21
Lyngby,9886,10,3,10,11,27,45,-18,19
AGF Aarhus,9886,11,4,6,12,18,39,-21,18
Brondby,9887,1,22,6,2,75,29,46,72
FC Midtjylla,9887,2,20,5,5,67,38,29,65
FC Nords,9887,3,14,8,8,74,53,21,50
Copenhagen,9887,4,14,5,11,56,45,11,47
AaB,9887,5,7,12,11,34,41,-7,33
Sonderjyske,9887,6,8,6,10,28,29,-1,30
AC Horsens,9887,7,5,12,13,34,60,-26,27
Randers FC,9887,8,6,6,12,25,40,-15,24
Silkeborg IF,9887,9,6,3,13,27,45,-18,21
Lyngby,9887,10,3,9,12,27,46,-19,18
AGF Aarhus,9887,11,4,6,12,17,38,-21,18
Brondby,9888,1,20,8,2,68,31,37,68
FC Midtjylla,9888,2,20,4,6,65,40,25,64
FC Nords,9888,3,15,8,7,74,48,26,53
Copenhagen,9888,4,13,6,11,58,44,14,45
AC Horsens,9888,5,6,14,10,35,50,-15,32
Sonderjyske,9888,6,8,6,10,28,29,-1,30
AaB,9888,7,6,12,12,37,50,-13,30
Randers FC,9888,8,6,6,12,25,39,-14,24
Silkeborg IF,9888,9,5,4,13,25,44,-19,19
AGF Aarhus,9888,10,4,7,11,16,36,-20,19
Lyngby,9888,11,3,9,12,26,46,-20,18
FC Midtjylla,9889,1,22,4,4,69,35,34,70
Brondby,9889,2,21,6,3,74,33,41,69
FC Nords,9889,3,14,7,9,75,53,22,49
Copenhagen,9889,4,14,4,12,58,48,10,46
AaB,9889,5,8,11,11,36,46,-10,35
Sonderjyske,9889,6,8,6,10,28,29,-1,30
AC Horsens,9889,7,5,12,13,35,58,-23,27
Lyngby,9889,8,4,9,11,28,44,-16,21
Randers FC,9889,9,5,6,13,23,41,-18,21
Silkeborg IF,9889,10,5,4,13,25,44,-19,19
AGF Aarhus,9889,11,4,7,11,16,36,-20,19
FC Midtjylla,9890,1,21,5,4,73,38,35,68
Brondby,9890,2,19,8,3,70,36,34,65
FC Nords,9890,3,12,9,9,74,56,18,45
Copenhagen,9890,4,13,6,11,57,46,11,45
AaB,9890,5,9,12,9,38,41,-3,39
Sonderjyske,9890,6,8,6,10,28,29,-1,30
AC Horsens,9890,7,5,14,11,35,56,-21,29
Lyngby,9890,8,4,9,11,27,44,-17,21
Silkeborg IF,9890,8,6,3,13,27,44,-17,21
Randers FC,9890,10,5,6,13,23,40,-17,21
AGF Aarhus,9890,11,4,6,12,16,38,-22,18
Brondby,9891,1,21,7,2,72,32,40,70
FC Midtjylla,9891,2,20,5,5,69,42,27,65
Copenhagen,9891,3,14,6,10,54,41,13,48
FC Nords,9891,4,13,7,10,70,51,19,46
AaB,9891,5,7,12,11,36,44,-8,33
AC Horsens,9891,6,6,13,11,38,55,-17,31
Sonderjyske,9891,7,8,6,10,28,29,-1,30
Randers FC,9891,8,5,7,12,24,40,-16,22
AGF Aarhus,9891,9,5,6,11,19,37,-18,21
Lyngby,9891,10,3,10,11,27,45,-18,19
Silkeborg IF,9891,11,5,3,14,26,47,-21,18
Brondby,9892,1,22,5,3,76,33,43,71
FC Midtjylla,9892,2,20,4,6,68,40,28,64
FC Nords,9892,3,14,6,10,72,51,21,48
Copenhagen,9892,4,14,5,11,57,45,12,47
AaB,9892,5,7,12,11,36,47,-11,33
AC Horsens,9892,6,7,12,11,36,55,-19,33
Sonderjyske,9892,7,8,6,10,28,29,-1,30
Randers FC,9892,8,6,6,12,26,41,-15,24
Silkeborg IF,9892,9,6,3,13,26,44,-18,21
Lyngby,9892,10,3,9,12,28,47,-19,18
AGF Aarhus,9892,11,4,6,12,16,37,-21,18
FC Midtjylla,9893,1,21,4,5,69,38,31,67
Brondby,9893,2,18,7,5,65,36,29,61
FC Nords,9893,3,16,6,8,75,48,27,54
Copenhagen,9893,4,13,6,11,55,45,10,45
AaB,9893,5,7,13,10,39,44,-5,34
AC Horsens,9893,6,6,14,10,35,53,-18,32
Sonderjyske,9893,7,8,6,10,28,29,-1,30
Lyngby,9893,8,4,9,11,29,44,-15,21
Silkeborg IF,9893,9,6,3,13,27,44,-17,21
Randers FC,9893,10,5,6,13,23,42,-19,21
AGF Aarhus,9893,11,4,6,12,16,38,-22,18
Brondby,9894,1,19,7,4,68,33,35,64
FC Midtjylla,9894,2,19,6,5,67,37,30,63
Copenhagen,9894,3,14,5,11,56,43,13,47
FC Nords,9894,4,13,6,11,67,57,10,45
AC Horsens,9894,5,9,13,8,39,48,-9,40
AaB,9894,6,8,11,11,39,44,-5,35
Sonderjyske,9894,7,8,6,10,28,29,-1,30
Randers FC,9894,8,5,7,12,25,41,-16,22
Lyngby,9894,9,3,10,11,28,46,-18,19
Silkeborg IF,9894,10,5,4,13,26,45,-19,19
AGF Aarhus,9894,11,4,7,11,17,37,-20,19
FC Midtjylla,9895,1,21,5,4,70,37,33,68
Brondby,9895,2,20,5,5,71,41,30,65
FC Nords,9895,3,14,7,9,74,52,22,49
Copenhagen,9895,4,14,5,11,55,42,13,47
AaB,9895,5,8,11,11,35,41,-6,35
AC Horsens,9895,6,6,13,11,34,52,-18,31
Sonderjyske,9895,7,8,6,10,28,29,-1,30
Randers FC,9895,8,6,6,12,24,39,-15,24
Silkeborg IF,9895,9,6,3,13,29,44,-15,21
Lyngby,9895,10,3,9,12,26,45,-19,18
AGF Aarhus,9895,11,4,6,12,16,40,-24,18
Brondby,9896,1,21,7,2,70,30,40,70
FC Midtjylla,9896,2,20,5,5,65,36,29,65
FC Nords,9896,3,13,8,9,74,56,18,47
Copenhagen,9896,4,14,5,11,60,46,14,47
AaB,9896,5,8,12,10,39,44,-5,36
Sonderjyske,9896,6,8,6,10,28,29,-1,30
AC Horsens,9896,7,5,13,12,33,55,-22,28
Lyngby,9896,8,4,9,11,29,46,-17,21
Randers FC,9896,9,5,6,13,25,42,-17,21
Silkeborg IF,9896,10,5,4,13,25,44,-19,19
AGF Aarhus,9896,11,4,7,11,16,36,-20,19
FC Midtjylla,9897,1,20,5,5,66,39,27,65
Brondby,9897,2,19,5,6,68,41,27,62
FC Nords,9897,3,14,7,9,76,52,24,49
Copenhagen,9897,4,14,5,11,58,45,13,47
AaB,9897,5,10,12,8,43,41,2,42
Sonderjyske,9897,6,8,6,10,28,29,-1,30
AC Horsens,9897,7,6,12,12,38,57,-19,30
Randers FC,9897,8,5,7,12,25,41,-16,22
Silkeborg IF,9897,9,6,3,13,27,44,-17,21
Lyngby,9897,10,3,10,11,28,46,-18,19
AGF Aarhus,9897,11,4,6,12,16,38,-22,18
Brondby,9898,1,20,6,4,72,38,34,66
FC Midtjylla,9898,2,18,8,4,68,42,26,62
FC Nords,9898,3,15,8,7,82,54,28,53
Copenhagen,9898,4,14,4,12,58,47,11,46
AaB,9898,5,6,14,10,37,45,-8,32
AC Horsens,9898,6,6,14,10,37,54,-17,32
Sonderjyske,9898,7,8,6,10,28,29,-1,30
Lyngby,9898,8,4,9,11,29,44,-15,21
Silkeborg IF,9898,9,6,3,13,27,44,-17,21
Randers FC,9898,10,5,6,13,23,42,-19,21
AGF Aarhus,9898,11,4,6,12,16,38,-22,18
Brondby,9899,1,21,6,3,76,32,44,69
FC Midtjylla,9899,2,20,4,6,68,41,27,64
Copenhagen,9899,3,15,4,11,60,45,15,49
FC Nords,9899,4,12,8,10,72,57,15,44
AaB,9899,5,8,11,11,37,45,-8,35
AC Horsens,9899,6,7,13,10,34,53,-19,34
Sonderjyske,9899,7,8,6,10,28,29,-1,30
Randers FC,9899,8,6,6,12,24,39,-15,24
Silkeborg IF,9899,9,5,4,13,25,44,-19,19
AGF Aarhus,9899,10,4,7,11,16,36,-20,19
Lyngby,9899,11,3,9,12,26,45,-19,18
FC Midtjylla,9900,1,21,4,5,69,40,29,67
Brondby,9900,2,20,5,5,71,35,36,65
Copenhagen,9900,3,17,4,9,64,38,26,55
FC Nords,9900,4,14,6,10,74,55,19,48
AaB,9900,5,7,11,12,37,51,-14,32
Sonderjyske,9900,6,8,6,10,28,29,-1,30
AC Horsens,9900,7,6,12,12,34,56,-22,30
Randers FC,9900,8,6,6,12,25,39,-14,24
Silkeborg IF,9900,9,6,3,13,27,45,-18,21
Lyngby,9900,10,3,9,12,26,46,-20,18
AGF Aarhus,9900,11,4,6,12,17,38,-21,18
Brondby,9901,1,20,7,3,73,36,37,67
FC Midtjylla,9901,2,18,6,6,63,39,24,60
FC Nords,9901,3,15,7,8,75,53,22,52
Copenhagen,9901,4,16,4,10,61,44,17,52
AaB,9901,5,6,13,11,36,43,-7,31
AC Horsens,9901,6,6,13,11,34,53,-19,31
Sonderjyske,9901,7,8,6,10,28,29,-1,30
Lyngby,9901,8,4,9,11,28,44,-16,21
Randers FC,9901,9,5,6,13,23,41,-18,21
Silkeborg IF,9901,10,5,4,13,27,46,-19,19
AGF Aarhus,9901,11,4,7,11,18,38,-20,19
Brondby,9902,1,21,6,3,70,31,39,69
FC Midtjylla,9902,2,17,6,7,59,41,18,57
FC Nords,9902,3,16,6,8,76,51,25,54
Copenhagen,9902,4,13,6,11,56,45,11,45
AaB,9902,5,8,12,10,41,43,-2,36
AC Horsens,9902,6,6,14,10,33,50,-17,32
Sonderjyske,9902,7,8,6,10,28,29,-1,30
Lyngby,9902,8,4,9,11,29,45,-16,21
Silkeborg IF,9902,9,6,3,13,26,44,-18,21
Randers FC,9902,10,5,6,13,24,42,-18,21
AGF Aarhus,9902,11,4,6,12,16,37,-21,18
Brondby,9903,1,21,6,3,73,35,38,69
FC Midtjylla,9903,2,20,5,5,71,40,31,65
FC Nords,9903,3,15,6,9,75,54,21,51
Copenhagen,9903,4,13,4,13,56,46,10,43
AaB,9903,5,8,12,10,37,44,-7,36
AC Horsens,9903,6,6,13,11,37,56,-19,31
Sonderjyske,9903,7,8,6,10,28,29,-1,30
Randers FC,9903,8,5,7,12,25,41,-16,22
AGF Aarhus,9903,9,5,6,11,18,37,-19,21
Lyngby,9903,10,3,10,11,28,46,-18,19
Silkeborg IF,9903,11,5,3,14,26,46,-20,18
Brondby,9904,1,22,5,3,74,34,40,71
FC Midtjylla,9904,2,20,5,5,68,39,29,65
FC Nords,9904,3,15,7,8,78,53,25,52
Copenhagen,9904,4,13,4,13,58,50,8,43
AaB,9904,5,7,12,11,34,40,-6,33
AC Horsens,9904,6,6,13,11,36,58,-22,31
Sonderjyske,9904,7,8,6,10,28,29,-1,30
Lyngby,9904,8,4,9,11,28,45,-17,21
Randers FC,9904,9,5,6,13,24,41,-17,21
Silkeborg IF,9904,10,6,3,13,26,44,-18,21
AGF Aarhus,9904,11,4,6,12,16,37,-21,18
Brondby,9905,1,21,7,2,69,28,41,70
FC Midtjylla,9905,2,19,6,5,67,37,30,63
Copenhagen,9905,3,15,6,9,55,38,17,51
FC Nords,9905,4,13,6,11,72,55,17,45
AaB,9905,5,8,13,9,38,44,-6,37
Sonderjyske,9905,6,8,6,10,28,29,-1,30
AC Horsens,9905,7,5,12,13,31,56,-25,27
Lyngby,9905,8,4,9,11,31,47,-16,21
Randers FC,9905,9,5,6,13,26,44,-18,21
Silkeborg IF,9905,9,6,3,13,26,44,-18,21
AGF Aarhus,9905,11,4,6,12,16,37,-21,18
Brondby,9906,1,20,6,4,71,35,36,66
FC Midtjylla,9906,2,20,4,6,69,42,27,64
FC Nords,9906,3,14,8,8,73,52,21,50
Copenhagen,9906,4,13,6,11,58,48,10,45
AC Horsens,9906,5,8,12,10,40,51,-11,36
AaB,9906,6,7,12,11,38,47,-9,33
Sonderjyske,9906,7,8,6,10,28,29,-1,30
Randers FC,9906,8,6,6,12,25,40,-15,24
AGF Aarhus,9906,9,5,6,11,18,37,-19,21
Lyngby,9906,10,3,9,12,27,46,-19,18
Silkeborg IF,9906,11,5,3,14,26,46,-20,18
Brondby,9907,1,21,6,3,72,36,36,69
FC Midtjylla,9907,2,20,5,5,63,37,26,65
FC Nords,9907,3,15,7,8,74,50,24,52
Copenhagen,9907,4,13,6,11,56,46,10,45
AaB,9907,5,7,11,12,37,42,-5,32
AC Horsens,9907,6,6,13,11,36,53,-17,31
Sonderjyske,9907,7,8,6,10,28,29,-1,30
Randers FC,9907,8,6,6,12,25,39,-14,24
AGF Aarhus,9907,9,5,6,11,17,36,-19,21
Lyngby,9907,10,3,9,12,26,46,-20,18
Silkeborg IF,9907,11,5,3,14,25,45,-20,18
Brondby,9908,1,23,5,2,75,31,44,74
FC Midtjylla,9908,2,21,4,5,72,35,37,67
FC Nords,9908,3,13,8,9,74,56,18,47
Copenhagen,9908,4,13,5,12,55,44,11,44
AaB,9908,5,7,12,11,37,48,-11,33
Sonderjyske,9908,6,8,6,10,28,29,-1,30
AC Horsens,9908,7,6,12,12,34,59,-25,30
Randers FC,9908,8,5,7,12,24,40,-16,22
Silkeborg IF,9908,9,6,3,13,27,45,-18,21
Lyngby,9908,10,3,10,11,27,45,-18,19
AGF Aarhus,9908,11,4,6,12,17,38,-21,18
Brondby,9909,1,21,7,2,72,31,41,70
FC Midtjylla,9909,2,19,5,6,66,37,29,62
FC Nords,9909,3,13,8,9,74,56,18,47
Copenhagen,9909,4,13,7,10,57,44,13,46
AaB,9909,5,7,14,9,37,43,-6,35
Sonderjyske,9909,6,8,6,10,28,29,-1,30
AC Horsens,9909,7,5,15,10,32,53,-21,30
Randers FC,9909,8,5,7,12,25,41,-16,22
Lyngby,9909,9,3,10,11,28,46,-18,19
Silkeborg IF,9909,10,5,4,13,27,46,-19,19
AGF Aarhus,9909,11,4,7,11,18,38,-20,19
Brondby,9910,1,19,9,2,67,31,36,66
FC Midtjylla,9910,2,19,7,4,68,37,31,64
Copenhagen,9910,3,13,7,10,57,43,14,46
FC Nords,9910,4,12,7,11,68,52,16,43
AC Horsens,9910,5,8,12,10,35,54,-19,36
AaB,9910,6,7,14,9,38,42,-4,35
Sonderjyske,9910,7,8,6,10,28,29,-1,30
Randers FC,9910,8,6,6,12,25,40,-15,24
AGF Aarhus,9910,9,5,6,11,18,36,-18,21
Lyngby,9910,10,3,9,12,27,46,-19,18
Silkeborg IF,9910,11,5,3,14,25,46,-21,18
Brondby,9911,1,20,7,3,67,30,37,67
FC Midtjylla,9911,2,17,6,7,65,44,21,57
FC Nords,9911,3,15,6,9,77,53,24,51
Copenhagen,9911,4,15,4,11,57,46,11,49
AC Horsens,9911,5,7,14,9,39,50,-11,35
AaB,9911,6,7,13,10,34,42,-8,34
Sonderjyske,9911,7,8,6,10,28,29,-1,30
Randers FC,9911,8,6,6,12,25,39,-14,24
Silkeborg IF,9911,9,5,4,13,27,46,-19,19
AGF Aarhus,9911,10,4,7,11,18,38,-20,19
Lyngby,9911,11,3,9,12,26,46,-20,18
FC Midtjylla,9912,1,21,5,4,71,38,33,68
Brondby,9912,2,20,5,5,68,33,35,65
FC Nords,9912,3,14,7,9,73,50,23,49
Copenhagen,9912,4,12,4,14,53,52,1,40
AC Horsens,9912,5,8,13,9,38,52,-14,37
AaB,9912,6,8,12,10,39,43,-4,36
Sonderjyske,9912,7,8,6,10,28,29,-1,30
Lyngby,9912,8,4,9,11,28,44,-16,21
Randers FC,9912,9,5,6,13,23,41,-18,21
AGF Aarhus,9912,10,5,6,11,18,36,-18,21
Silkeborg IF,9912,11,5,3,14,25,46,-21,18
Brondby,9913,1,21,5,4,70,35,35,68
FC Midtjylla,9913,2,18,5,7,60,41,19,59
Copenhagen,9913,3,15,6,9,64,42,22,51
FC Nords,9913,4,13,7,10,73,55,18,46
AaB,9913,5,8,12,10,38,46,-8,36
AC Horsens,9913,6,7,13,10,40,52,-12,34
Sonderjyske,9913,7,8,6,10,28,29,-1,30
Randers FC,9913,8,6,6,12,25,40,-15,24
AGF Aarhus,9913,9,5,6,11,19,38,-19,21
Lyngby,9913,10,3,9,12,27,46,-19,18
Silkeborg IF,9913,11,5,3,14,27,47,-20,18
FC Midtjylla,9914,1,22,4,4,69,39,30,70
Brondby,9914,2,21,6,3,67,30,37,69
FC Nords,9914,3,13,6,11,73,54,19,45
Copenhagen,9914,4,13,5,12,54,43,11,44
AaB,9914,5,8,12,10,35,39,-4,36
Sonderjyske,9914,6,8,6,10,28,29,-1,30
AC Horsens,9914,7,5,15,10,34,53,-19,30
Randers FC,9914,8,5,7,12,24,40,-16,22
Lyngby,9914,9,3,10,11,27,45,-18,19
Silkeborg IF,9914,10,5,4,13,25,44,-19,19
AGF Aarhus,9914,11,4,7,11,16,36,-20,19
Brondby,9915,1,22,6,2,79,32,47,72
FC Midtjylla,9915,2,19,4,7,59,38,21,61
FC Nords,9915,3,14,7,9,71,51,20,49
Copenhagen,9915,4,13,5,12,56,49,7,44
AC Horsens,9915,5,8,12,10,38,51,-13,36
AaB,9915,6,7,12,11,36,44,-8,33
Sonderjyske,9915,7,8,6,10,28,29,-1,30
Randers FC,9915,8,6,6,12,25,39,-14,24
Silkeborg IF,9915,9,5,4,13,26,45,-19,19
AGF Aarhus,9915,10,4,7,11,17,37,-20,19
Lyngby,9915,11,3,9,12,26,46,-20,18
Brondby,9916,1,22,6,2,73,32,41,72
FC Midtjylla,9916,2,18,7,5,60,36,24,61
FC Nords,9916,3,13,7,10,70,54,16,46
Copenhagen,9916,4,12,6,12,59,50,9,42
AaB,9916,5,8,12,10,40,44,-4,36
AC Horsens,9916,6,7,14,9,38,50,-12,35
Sonderjyske,9916,7,8,6,10,28,29,-1,30
Randers FC,9916,8,5,7,12,25,41,-16,22
Silkeborg IF,9916,9,6,3,13,29,46,-17,21
Lyngby,9916,10,3,10,11,28,46,-18,19
AGF Aarhus,9916,11,4,6,12,18,40,-22,18
Brondby,9917,1,20,7,3,76,38,38,67
FC Midtjylla,9917,2,20,5,5,67,40,27,65
FC Nords,9917,3,14,8,8,74,54,20,50
Copenhagen,9917,4,12,6,12,55,47,8,42
AaB,9917,5,9,13,8,43,40,3,40
Sonderjyske,9917,6,8,6,10,28,29,-1,30
AC Horsens,9917,7,5,13,12,34,56,-22,28
Lyngby,9917,8,4,9,11,29,45,-16,21
Randers FC,9917,9,5,6,13,24,42,-18,21
AGF Aarhus,9917,10,5,6,11,19,37,-18,21
Silkeborg IF,9917,11,5,3,14,26,47,-21,18
Brondby,9918,1,21,7,2,71,29,42,70
FC Midtjylla,9918,2,19,5,6,60,36,24,62
FC Nords,9918,3,13,7,10,69,50,19,46
Copenhagen,9918,4,13,5,12,54,47,7,44
AaB,9918,5,9,11,10,39,40,-1,38
AC Horsens,9918,6,7,13,10,34,51,-17,34
Sonderjyske,9918,7,8,6,10,28,29,-1,30
Lyngby,9918,8,4,9,11,28,45,-17,21
Randers FC,9918,9,5,6,13,24,41,-17,21
Silkeborg IF,9918,10,5,4,13,25,44,-19,19
AGF Aarhus,9918,11,4,7,11,16,36,-20,19
Brondby,9919,1,19,6,5,63,31,32,63
FC Midtjylla,9919,2,19,5,6,61,37,24,62
FC Nords,9919,3,16,6,8,75,47,28,54
Copenhagen,9919,4,13,6,11,56,46,10,45
AC Horsens,9919,5,8,13,9,35,48,-13,37
AaB,9919,6,7,12,11,39,46,-7,33
Sonderjyske,9919,7,8,6,10,28,29,-1,30
Lyngby,9919,8,4,9,11,28,44,-16,21
Randers FC,9919,9,5,6,13,23,41,-18,21
AGF Aarhus,9919,10,5,6,11,19,37,-18,21
Silkeborg IF,9919,11,5,3,14,26,47,-21,18
Brondby,9920,1,21,6,3,74,29,45,69
FC Midtjylla,9920,2,21,4,5,64,36,28,67
FC Nords,9920,3,15,6,9,74,51,23,51
Copenhagen,9920,4,14,5,11,56,44,12,47
AaB,9920,5,7,11,12,34,46,-12,32
Sonderjyske,9920,6,8,6,10,28,29,-1,30
AC Horsens,9920,7,6,12,12,32,54,-22,30
Randers FC,9920,8,6,6,12,25,39,-14,24
Silkeborg IF,9920,9,5,4,13,26,45,-19,19
AGF Aarhus,9920,10,4,7,11,17,37,-20,19
Lyngby,9920,11,3,9,12,26,46,-20,18
Brondby,9921,1,23,5,2,75,32,43,74
FC Midtjylla,9921,2,19,5,6,64,41,23,62
Copenhagen,9921,3,14,4,12,60,45,15,46
FC Nords,9921,4,13,6,11,70,55,15,45
AaB,9921,5,8,12,10,37,42,-5,36
AC Horsens,9921,6,7,12,11,35,52,-17,33
Sonderjyske,9921,7,8,6,10,28,29,-1,30
Randers FC,9921,8,5,7,12,23,39,-16,22
AGF Aarhus,9921,9,5,6,11,19,36,-17,21
Lyngby,9921,10,3,10,11,26,44,-18,19
Silkeborg IF,9921,11,5,3,14,25,47,-22,18
Brondby,9922,1,22,5,3,72,32,40,71
FC Midtjylla,9922,2,19,6,5,68,43,25,63
FC Nords,9922,3,15,6,9,76,52,24,51
Copenhagen,9922,4,15,5,10,64,45,19,50
AaB,9922,5,6,13,11,35,44,-9,31
Sonderjyske,9922,6,8,6,10,28,29,-1,30
AC Horsens,9922,7,5,13,12,33,58,-25,28
Randers FC,9922,8,6,6,12,26,39,-13,24
Silkeborg IF,9922,9,6,3,13,26,44,-18,21
Lyngby,9922,10,3,9,12,26,47,-21,18
AGF Aarhus,9922,11,4,6,12,16,37,-21,18
Brondby,9923,1,21,7,2,79,30,49,70
FC Midtjylla,9923,2,19,4,7,64,48,16,61
FC Nords,9923,3,14,7,9,76,53,23,49
Copenhagen,9923,4,15,4,11,59,46,13,49
AaB,9923,5,7,12,11,36,43,-7,33
AC Horsens,9923,6,7,12,11,37,57,-20,33
Sonderjyske,9923,7,8,6,10,28,29,-1,30
Randers FC,9923,8,5,7,12,24,40,-16,22
AGF Aarhus,9923,9,5,6,11,18,37,-19,21
Lyngby,9923,10,3,10,11,27,45,-18,19
Silkeborg IF,9923,11,5,3,14,26,46,-20,18
Brondby,9924,1,22,6,2,76,30,46,72
FC Midtjylla,9924,2,20,4,6,67,39,28,64
FC Nords,9924,3,15,6,9,74,52,22,51
Copenhagen,9924,4,13,4,13,54,50,4,43
AaB,9924,5,8,12,10,36,41,-5,36
Sonderjyske,9924,6,8,6,10,28,29,-1,30
AC Horsens,9924,7,6,12,12,36,57,-21,30
Randers FC,9924,8,5,7,12,24,40,-16,22
Silkeborg IF,9924,9,6,3,13,28,46,-18,21
Lyngby,9924,10,3,10,11,27,45,-18,19
AGF Aarhus,9924,11,4,6,12,18,39,-21,18
Brondby,9925,1,21,7,2,78,32,46,70
FC Midtjylla,9925,2,19,5,6,66,43,23,62
FC Nords,9925,3,15,7,8,79,52,27,52
Copenhagen,9925,4,12,7,11,55,44,11,43
AaB,9925,5,8,13,9,39,44,-5,37
Sonderjyske,9925,6,8,6,10,28,29,-1,30
AC Horsens,9925,7,5,13,12,32,60,-28,28
Randers FC,9925,8,6,6,12,24,39,-15,24
Silkeborg IF,9925,9,6,3,13,28,46,-18,21
Lyngby,9925,10,3,9,12,26,45,-19,18
AGF Aarhus,9925,11,4,6,12,18,39,-21,18
Brondby,9926,1,21,5,4,68,31,37,68
FC Midtjylla,9926,2,19,4,7,65,39,26,61
FC Nords,9926,3,15,6,9,74,51,23,51
Copenhagen,9926,4,14,5,11,55,50,5,47
AaB,9926,5,9,12,9,42,40,2,39
Sonderjyske,9926,6,8,6,10,28,29,-1,30
AC Horsens,9926,7,5,14,11,33,52,-19,29
Lyngby,9926,8,4,9,11,29,44,-15,21
Randers FC,9926,9,5,6,13,23,42,-19,21
Silkeborg IF,9926,10,5,4,13,26,45,-19,19
AGF Aarhus,9926,11,4,7,11,17,37,-20,19
Brondby,9927,1,22,5,3,76,32,44,71
FC Midtjylla,9927,2,19,5,6,64,39,25,62
Copenhagen,9927,3,15,4,11,60,44,16,49
FC Nords,9927,4,14,6,10,72,55,17,48
AaB,9927,5,8,12,10,36,42,-6,36
Sonderjyske,9927,6,8,6,10,28,29,-1,30
AC Horsens,9927,7,6,12,12,36,58,-22,30
Randers FC,9927,8,6,6,12,25,40,-15,24
Silkeborg IF,9927,9,6,3,13,26,44,-18,21
Lyngby,9927,10,3,9,12,27,46,-19,18
AGF Aarhus,9927,11,4,6,12,16,37,-21,18
FC Midtjylla,9928,1,21,4,5,72,37,35,67
Brondby,9928,2,20,5,5,67,33,34,65
Copenhagen,9928,3,15,4,11,60,49,11,49
FC Nords,9928,4,13,6,11,68,54,14,45
AC Horsens,9928,5,9,12,9,45,55,-10,39
AaB,9928,6,7,11,12,33,43,-10,32
Sonderjyske,9928,7,8,6,10,28,29,-1,30
Lyngby,9928,8,4,9,11,28,45,-17,21
Randers FC,9928,9,5,6,13,24,41,-17,21
Silkeborg IF,9928,10,5,4,13,25,44,-19,19
AGF Aarhus,9928,11,4,7,11,16,36,-20,19
Brondby,9929,1,19,7,4,72,34,38,64
FC Midtjylla,9929,2,20,4,6,68,41,27,64
FC Nords,9929,3,14,6,10,71,56,15,48
Copenhagen,9929,4,14,6,10,57,45,12,48
AaB,9929,5,8,12,10,40,43,-3,36
AC Horsens,9929,6,6,15,9,35,50,-15,33
Sonderjyske,9929,7,8,6,10,28,29,-1,30
Randers FC,9929,8,5,7,12,24,40,-16,22
Silkeborg IF,9929,9,6,3,13,26,44,-18,21
Lyngby,9929,10,3,10,11,27,45,-18,19
AGF Aarhus,9929,11,4,6,12,16,37,-21,18
FC Midtjylla,9930,1,22,4,4,78,39,39,70
Brondby,9930,2,20,5,5,71,40,31,65
FC Nords,9930,3,14,7,9,73,52,21,49
Copenhagen,9930,4,13,6,11,59,47,12,45
AaB,9930,5,7,12,11,37,45,-8,33
AC Horsens,9930,6,7,12,11,37,58,-21,33
Sonderjyske,9930,7,8,6,10,28,29,-1,30
Randers FC,9930,8,5,7,12,24,40,-16,22
Silkeborg IF,9930,9,6,3,13,28,45,-17,21
Lyngby,9930,10,3,10,11,27,45,-18,19
AGF Aarhus,9930,11,4,6,12,17,39,-22,18
Brondby,9931,1,21,7,2,67,28,39,70
FC Midtjylla,9931,2,21,4,5,69,35,34,67
FC Nords,9931,3,12,8,10,65,48,17,44
Copenhagen,9931,4,13,5,12,54,47,7,44
AC Horsens,9931,5,8,12,10,37,51,-14,36
AaB,9931,6,7,12,11,34,43,-9,33
Sonderjyske,9931,7,8,6,10,28,29,-1,30
Silkeborg IF,9931,8,6,3,13,28,45,-17,21
Lyngby,9931,9,4,9,11,27,44,-17,21
Randers FC,9931,10,5,6,13,23,40,-17,21
AGF Aarhus,9931,11,4,6,12,17,39,-22,18
Brondby,9932,1,20,8,2,68,31,37,68
FC Midtjylla,9932,2,19,4,7,65,37,28,61
FC Nords,9932,3,13,6,11,75,57,18,45
Copenhagen,9932,4,13,6,11,56,45,11,45
AaB,9932,5,9,13,8,38,39,-1,40
AC Horsens,9932,6,6,15,9,34,53,-19,33
Sonderjyske,9932,7,8,6,10,28,29,-1,30
Randers FC,9932,8,5,7,12,25,41,-16,22
Silkeborg IF,9932,9,6,3,13,27,44,-17,21
Lyngby,9932,10,3,10,11,28,46,-18,19
AGF Aarhus,9932,11,4,6,12,16,38,-22,18
Brondby,9933,1,21,6,3,72,32,40,69
FC Midtjylla,9933,2,19,7,4,67,36,31,64
FC Nords,9933,3,14,7,9,71,51,20,49
Copenhagen,9933,4,14,6,10,57,42,15,48
AC Horsens,9933,5,7,13,10,37,54,-17,34
Sonderjyske,9933,6,8,6,10,28,29,-1,30
AaB,9933,7,6,11,13,34,49,-15,29
Lyngby,9933,8,4,9,11,28,44,-16,21
Silkeborg IF,9933,9,6,3,13,29,47,-18,21
Randers FC,9933,10,5,6,13,23,41,-18,21
AGF Aarhus,9933,11,4,6,12,19,40,-21,18
Brondby,9934,1,22,5,3,73,31,42,71
FC Midtjylla,9934,2,21,5,4,69,38,31,68
FC Nords,9934,3,14,7,9,74,55,19,49
Copenhagen,9934,4,14,4,12,59,45,14,46
AaB,9934,5,6,13,11,37,47,-10,31
Sonderjyske,9934,6,8,6,10,28,29,-1,30
AC Horsens,9934,7,5,14,11,33,55,-22,29
Randers FC,9934,8,5,7,12,23,39,-16,22
AGF Aarhus,9934,9,5,6,11,18,37,-19,21
Lyngby,9934,10,3,10,11,26,44,-18,19
Silkeborg IF,9934,11,5,3,14,26,46,-20,18
Brondby,9935,1,21,6,3,70,28,42,69
FC Midtjylla,9935,2,19,6,5,64,39,25,63
FC Nords,9935,3,14,7,9,70,49,21,49
Copenhagen,9935,4,14,5,11,55,44,11,47
AaB,9935,5,6,15,9,36,41,-5,33
Sonderjyske,9935,6,8,6,10,28,29,-1,30
AC Horsens,9935,7,5,15,10,32,52,-20,30
Lyngby,9935,8,4,9,11,28,44,-16,21
Randers FC,9935,9,5,6,13,23,41,-18,21
AGF Aarhus,9935,10,5,6,11,18,37,-19,21
Silkeborg IF,9935,11,5,3,14,26,46,-20,18
FC Midtjylla,9936,1,20,5,5,71,38,33,65
Brondby,9936,2,18,8,4,64,32,32,62
Copenhagen,9936,3,15,6,9,59,42,17,51
FC Nords,9936,4,14,8,8,73,51,22,50
AaB,9936,5,7,13,10,37,45,-8,34
Sonderjyske,9936,6,8,6,10,28,29,-1,30
AC Horsens,9936,7,5,14,11,32,54,-22,29
Lyngby,9936,8,4,9,11,27,44,-17,21
Randers FC,9936,9,5,6,13,23,40,-17,21
Silkeborg IF,9936,10,5,4,13,26,45,-19,19
AGF Aarhus,9936,11,4,7,11,17,37,-20,19
Brondby,9937,1,21,7,2,70,30,40,70
FC Midtjylla,9937,2,20,4,6,70,39,31,64
Copenhagen,9937,3,13,7,10,58,45,13,46
FC Nords,9937,4,13,7,10,70,59,11,46
AaB,9937,5,8,12,10,40,41,-1,36
AC Horsens,9937,6,6,13,11,32,52,-20,31
Sonderjyske,9937,7,8,6,10,28,29,-1,30
Randers FC,9937,8,5,7,12,24,40,-16,22
Lyngby,9937,9,3,10,11,27,45,-18,19
Silkeborg IF,9937,10,5,4,13,27,46,-19,19
AGF Aarhus,9937,11,4,7,11,18,38,-20,19
Brondby,9938,1,20,5,5,72,32,40,65
FC Midtjylla,9938,2,20,5,5,70,41,29,65
Copenhagen,9938,3,14,6,10,55,41,14,48
FC Nords,9938,4,13,6,11,70,53,17,45
AaB,9938,5,9,11,10,36,43,-7,38
AC Horsens,9938,6,7,13,10,35,54,-19,34
Sonderjyske,9938,7,8,6,10,28,29,-1,30
Randers FC,9938,8,6,6,12,25,39,-14,24
AGF Aarhus,9938,9,5,6,11,17,36,-19,21
Lyngby,9938,10,3,9,12,26,46,-20,18
Silkeborg IF,9938,11,5,3,14,25,45,-20,18
Brondby,9939,1,18,7,5,66,35,31,61
FC Midtjylla,9939,2,17,8,5,62,42,20,59
FC Nords,9939,3,14,8,8,74,52,22,50
Copenhagen,9939,4,14,5,11,61,46,15,47
AC Horsens,9939,5,9,13,8,43,50,-7,40
AaB,9939,6,6,15,9,38,45,-7,33
Sonderjyske,9939,7,8,6,10,28,29,-1,30
Lyngby,9939,8,4,9,11,30,47,-17,21
Randers FC,9939,9,5,6,13,26,43,-17,21
Silkeborg IF,9939,10,5,4,13,25,44,-19,19
AGF Aarhus,9939,11,4,7,11,16,36,-20,19
Brondby,9940,1,19,8,3,69,31,38,65
FC Midtjylla,9940,2,19,6,5,61,33,28,63
Copenhagen,9940,3,15,5,10,61,46,15,50
FC Nords,9940,4,14,7,9,74,54,20,49
AaB,9940,5,7,12,11,36,44,-8,33
AC Horsens,9940,6,7,12,11,34,53,-19,33
Sonderjyske,9940,7,8,6,10,28,29,-1,30
Lyngby,9940,8,4,9,11,28,45,-17,21
Silkeborg IF,9940,9,6,3,13,27,44,-17,21
Randers FC,9940,10,5,6,13,24,41,-17,21
AGF Aarhus,9940,11,4,6,12,16,38,-22,18
Brondby,9941,1,22,5,3,73,29,44,71
FC Midtjylla,9941,2,21,4,5,70,37,33,67
FC Nords,9941,3,15,6,9,74,54,20,51
Copenhagen,9941,4,14,4,12,58,45,13,46
AaB,9941,5,8,11,11,36,46,-10,35
Sonderjyske,9941,6,8,6,10,28,29,-1,30
AC Horsens,9941,7,5,12,13,34,60,-26,27
Lyngby,9941,8,4,9,11,28,45,-17,21
Randers FC,9941,9,5,6,13,24,41,-17,21
Silkeborg IF,9941,10,5,4,13,25,44,-19,19
AGF Aarhus,9941,11,4,7,11,16,36,-20,19
Brondby,9942,1,20,5,5,67,34,33,65
FC Midtjylla,9942,2,20,4,6,68,44,24,64
Copenhagen,9942,3,14,6,10,61,46,15,48
FC Nords,9942,4,13,8,9,72,51,21,47
AC Horsens,9942,5,9,12,9,41,51,-10,39
AaB,9942,6,6,13,11,36,45,-9,31
Sonderjyske,9942,7,8,6,10,28,29,-1,30
Randers FC,9942,8,6,6,12,25,40,-15,24
AGF Aarhus,9942,9,5,6,11,18,36,-18,21
Lyngby,9942,10,3,9,12,27,46,-19,18
Silkeborg IF,9942,11,5,3,14,25,46,-21,18
Brondby,9943,1,19,7,4,66,35,31,64
FC Midtjylla,9943,2,19,5,6,61,37,24,62
Copenhagen,9943,3,15,5,10,58,41,17,50
FC Nords,9943,4,14,6,10,71,49,22,48
AC Horsens,9943,5,7,14,9,38,50,-12,35
AaB,9943,6,7,13,10,32,40,-8,34
Sonderjyske,9943,7,8,6,10,28,29,-1,30
Lyngby,9943,8,4,9,11,28,45,-17,21
Silkeborg IF,9943,9,6,3,13,27,44,-17,21
Randers FC,9943,10,5,6,13,24,41,-17,21
AGF Aarhus,9943,11,4,6,12,16,38,-22,18
Brondby,9944,1,21,6,3,69,28,41,69
FC Midtjylla,9944,2,20,5,5,67,40,27,65
FC Nords,9944,3,15,6,9,72,50,22,51
Copenhagen,9944,4,13,5,12,59,50,9,44
AaB,9944,5,7,12,11,36,43,-7,33
AC Horsens,9944,6,7,12,11,33,51,-18,33
Sonderjyske,9944,7,8,6,10,28,29,-1,30
Randers FC,9944,8,6,6,12,25,39,-14,24
Silkeborg IF,9944,9,5,4,13,26,45,-19,19
AGF Aarhus,9944,10,4,7,11,17,37,-20,19
Lyngby,9944,11,3,9,12,26,46,-20,18
FC Midtjylla,9945,1,20,6,4,72,42,30,66
Brondby,9945,2,19,8,3,70,39,31,65
FC Nords,9945,3,14,7,9,77,53,24,49
Copenhagen,9945,4,13,5,12,59,50,9,44
AaB,9945,5,8,11,11,37,47,-10,35
AC Horsens,9945,6,7,13,10,41,51,-10,34
Sonderjyske,9945,7,8,6,10,28,29,-1,30
Randers FC,9945,8,5,7,12,23,39,-16,22
Silkeborg IF,9945,9,6,3,13,27,45,-18,21
Lyngby,9945,10,3,10,11,26,44,-18,19
AGF Aarhus,9945,11,4,6,12,17,38,-21,18
Brondby,9946,1,21,7,2,73,32,41,70
FC Midtjylla,9946,2,19,5,6,66,37,29,62
Copenhagen,9946,3,14,7,9,58,43,15,49
FC Nords,9946,4,13,8,9,72,52,20,47
AaB,9946,5,8,13,9,35,43,-8,37
Sonderjyske,9946,6,8,6,10,28,29,-1,30
AC Horsens,9946,7,5,12,13,30,53,-23,27
Randers FC,9946,8,5,7,12,24,40,-16,22
Silkeborg IF,9946,9,6,3,13,26,44,-18,21
Lyngby,9946,10,3,10,11,27,45,-18,19
AGF Aarhus,9946,11,4,6,12,16,37,-21,18
Brondby,9947,1,21,5,4,66,32,34,68
FC Midtjylla,9947,2,19,6,5,65,37,28,63
FC Nords,9947,3,14,8,8,71,49,22,50
Copenhagen,9947,4,14,7,9,61,43,18,49
AC Horsens,9947,5,7,13,10,35,51,-16,34
Sonderjyske,9947,6,8,6,10,28,29,-1,30
AaB,9947,7,6,11,13,35,47,-12,29
Randers FC,9947,8,6,6,12,26,39,-13,24
Silkeborg IF,9947,9,6,3,13,27,44,-17,21
Lyngby,9947,10,3,9,12,26,47,-21,18
AGF Aarhus,9947,11,4,6,12,16,38,-22,18
Brondby,9948,1,20,6,4,71,36,35,66
FC Midtjylla,9948,2,20,6,4,67,37,30,66
Copenhagen,9948,3,13,7,10,56,45,11,46
FC Nords,9948,4,12,8,10,68,53,15,44
AaB,9948,5,7,13,10,42,45,-3,34
AC Horsens,9948,6,6,16,8,37,51,-14,34
Sonderjyske,9948,7,8,6,10,28,29,-1,30
Randers FC,9948,8,6,6,12,24,39,-15,24
AGF Aarhus,9948,9,5,6,11,18,37,-19,21
Lyngby,9948,10,3,9,12,26,45,-19,18
Silkeborg IF,9948,11,5,3,14,26,46,-20,18
Brondby,9949,1,20,6,4,75,37,38,66
FC Midtjylla,9949,2,20,5,5,65,40,25,65
FC Nords,9949,3,14,6,10,68,54,14,48
Copenhagen,9949,4,13,4,13,57,44,13,43
AC Horsens,9949,5,8,13,9,36,48,-12,37
AaB,9949,6,7,14,9,37,41,-4,35
Sonderjyske,9949,7,8,6,10,28,29,-1,30
Lyngby,9949,8,4,9,11,28,45,-17,21
Randers FC,9949,9,5,6,13,24,41,-17,21
AGF Aarhus,9949,10,5,6,11,17,36,-19,21
Silkeborg IF,9949,11,5,3,14,25,45,-20,18
FC Midtjylla,9950,1,21,4,5,74,40,34,67
Brondby,9950,2,20,7,3,72,38,34,67
FC Nords,9950,3,15,7,8,77,51,26,52
Copenhagen,9950,4,14,5,11,63,51,12,47
AC Horsens,9950,5,6,14,10,35,55,-20,32
Sonderjyske,9950,6,8,6,10,28,29,-1,30
AaB,9950,7,6,11,13,36,48,-12,29
Randers FC,9950,8,6,6,12,24,39,-15,24
Silkeborg IF,9950,9,6,3,13,26,44,-18,21
Lyngby,9950,10,3,9,12,26,45,-19,18
AGF Aarhus,9950,11,4,6,12,16,37,-21,18
FC Midtjylla,9951,1,21,5,4,71,38,33,68
Brondby,9951,2,19,7,4,71,35,36,64
Copenhagen,9951,3,16,4,10,57,43,14,52
FC Nords,9951,4,13,7,10,75,58,17,46
AaB,9951,5,6,14,10,38,47,-9,32
AC Horsens,9951,6,6,13,11,37,54,-17,31
Sonderjyske,9951,7,8,6,10,28,29,-1,30
Lyngby,9951,8,4,9,11,29,46,-17,21
Randers FC,9951,9,5,6,13,25,42,-17,21
Silkeborg IF,9951,10,5,4,13,27,46,-19,19
AGF Aarhus,9951,11,4,7,11,18,38,-20,19
FC Midtjylla,9952,1,21,5,4,72,37,35,68
Brondby,9952,2,19,8,3,69,35,34,65
FC Nords,9952,3,13,8,9,75,53,22,47
Copenhagen,9952,4,12,5,13,55,50,5,41
AaB,9952,5,9,11,10,39,46,-7,38
AC Horsens,9952,6,7,13,10,39,54,-15,34
Sonderjyske,9952,7,8,6,10,28,29,-1,30
Randers FC,9952,8,6,6,12,24,39,-15,24
Silkeborg IF,9952,9,5,4,13,26,45,-19,19
AGF Aarhus,9952,10,4,7,11,17,37,-20,19
Lyngby,9952,11,3,9,12,26,45,-19,18
Brondby,9953,1,21,5,4,75,37,38,68
FC Midtjylla,9953,2,19,5,6,65,37,28,62
Copenhagen,9953,3,16,4,10,60,42,18,52
FC Nords,9953,4,14,6,10,72,55,17,48
AaB,9953,5,9,12,9,42,40,2,39
Sonderjyske,9953,6,8,6,10,28,29,-1,30
AC Horsens,9953,7,5,12,13,34,63,-29,27
Lyngby,9953,8,4,9,11,28,45,-17,21
Randers FC,9953,9,5,6,13,24,41,-17,21
Silkeborg IF,9953,10,6,3,13,28,46,-18,21
AGF Aarhus,9953,11,4,6,12,18,39,-21,18
Brondby,9954,1,21,6,3,74,31,43,69
FC Midtjylla,9954,2,21,4,5,69,39,30,67
FC Nords,9954,3,15,6,9,75,51,24,51
Copenhagen,9954,4,14,5,11,58,44,14,47
AaB,9954,5,7,11,12,36,47,-11,32
Sonderjyske,9954,6,8,6,10,28,29,-1,30
AC Horsens,9954,7,6,12,12,32,58,-26,30
Randers FC,9954,8,5,7,12,23,39,-16,22
AGF Aarhus,9954,9,5,6,11,17,36,-19,21
Lyngby,9954,10,3,10,11,26,44,-18,19
Silkeborg IF,9954,11,5,3,14,25,45,-20,18
Brondby,9955,1,22,5,3,74,34,40,71
FC Midtjylla,9955,2,20,4,6,70,39,31,64
FC Nords,9955,3,15,7,8,76,50,26,52
Copenhagen,9955,4,14,5,11,55,43,12,47
AC Horsens,9955,5,7,12,11,37,55,-18,33
Sonderjyske,9955,6,8,6,10,28,29,-1,30
AaB,9955,7,6,11,13,36,53,-17,29
Randers FC,9955,8,5,7,12,24,40,-16,22
Silkeborg IF,9955,9,6,3,13,27,45,-18,21
Lyngby,9955,10,3,10,11,27,45,-18,19
AGF Aarhus,9955,11,4,6,12,17,38,-21,18
Brondby,9956,1,20,7,3,69,31,38,67
FC Midtjylla,9956,2,18,6,6,64,40,24,60
FC Nords,9956,3,15,8,7,76,50,26,53
Copenhagen,9956,4,13,5,12,57,47,10,44
AC Horsens,9956,5,7,14,9,38,53,-15,35
AaB,9956,6,7,12,11,36,45,-9,33
Sonderjyske,9956,7,8,6,10,28,29,-1,30
Randers FC,9956,8,6,6,12,25,40,-15,24
Silkeborg IF,9956,9,5,4,13,25,44,-19,19
AGF Aarhus,9956,10,4,7,11,16,36,-20,19
Lyngby,9956,11,3,9,12,27,46,-19,18
FC Midtjylla,9957,1,20,6,4,67,39,28,66
Brondby,9957,2,19,7,4,66,32,34,64
FC Nords,9957,3,15,6,9,78,55,23,51
Copenhagen,9957,4,15,4,11,60,43,17,49
AaB,9957,5,7,12,11,36,42,-6,33
AC Horsens,9957,6,6,13,11,33,55,-22,31
Sonderjyske,9957,7,8,6,10,28,29,-1,30
Randers FC,9957,8,5,7,12,23,39,-16,22
AGF Aarhus,9957,9,5,6,11,18,37,-19,21
Lyngby,9957,10,3,10,11,26,44,-18,19
Silkeborg IF,9957,11,5,3,14,26,46,-20,18
FC Midtjylla,9958,1,21,5,4,70,36,34,68
Brondby,9958,2,19,6,5,65,34,31,63
FC Nords,9958,3,14,6,10,72,52,20,48
Copenhagen,9958,4,13,6,11,56,46,10,45
AaB,9958,5,10,11,9,40,38,2,41
Sonderjyske,9958,6,8,6,10,28,29,-1,30
AC Horsens,9958,7,6,12,12,34,57,-23,30
Randers FC,9958,8,6,6,12,27,39,-12,24
AGF Aarhus,9958,9,5,6,11,19,37,-18,21
Silkeborg IF,9958,10,5,3,14,26,47,-21,18
Lyngby,9958,11,3,9,12,26,48,-22,18
Brondby,9959,1,21,7,2,74,32,42,70
FC Midtjylla,9959,2,19,6,5,65,40,25,63
FC Nords,9959,3,13,8,9,73,51,22,47
Copenhagen,9959,4,12,6,12,57,47,10,42
AaB,9959,5,9,12,9,44,48,-4,39
AC Horsens,9959,6,6,13,11,36,57,-21,31
Sonderjyske,9959,7,8,6,10,28,29,-1,30
Randers FC,9959,8,6,6,12,28,40,-12,24
Silkeborg IF,9959,9,6,3,13,26,44,-18,21
AGF Aarhus,9959,10,4,6,12,16,37,-21,18
Lyngby,9959,11,3,9,12,27,49,-22,18
Brondby,9960,1,23,5,2,74,27,47,74
FC Midtjylla,9960,2,21,4,5,65,38,27,67
Copenhagen,9960,3,14,4,12,55,43,12,46
FC Nords,9960,4,13,6,11,72,54,18,45
AaB,9960,5,8,11,11,39,46,-7,35
Sonderjyske,9960,6,8,6,10,28,29,-1,30
AC Horsens,9960,7,6,12,12,32,55,-23,30
Randers FC,9960,8,6,6,12,24,39,-15,24
Silkeborg IF,9960,9,5,4,13,26,45,-19,19
AGF Aarhus,9960,10,4,7,11,17,37,-20,19
Lyngby,9960,11,3,9,12,26,45,-19,18
Brondby,9961,1,21,5,4,73,36,37,68
FC Midtjylla,9961,2,19,5,6,70,41,29,62
FC Nords,9961,3,15,7,8,75,52,23,52
Copenhagen,9961,4,13,4,13,56,47,9,43
AaB,9961,5,9,11,10,41,44,-3,38
AC Horsens,9961,6,7,12,11,34,55,-21,33
Sonderjyske,9961,7,8,6,10,28,29,-1,30
Lyngby,9961,8,4,9,11,28,45,-17,21
Randers FC,9961,9,5,6,13,24,41,-17,21
AGF Aarhus,9961,10,5,6,11,17,36,-19,21
Silkeborg IF,9961,11,5,3,14,25,45,-20,18
Brondby,9962,1,22,6,2,71,29,42,72
FC Midtjylla,9962,2,19,5,6,61,37,24,62
FC Nords,9962,3,15,6,9,75,52,23,51
Copenhagen,9962,4,13,5,12,54,44,10,44
AaB,9962,5,7,13,10,35,42,-7,34
AC Horsens,9962,6,6,13,11,36,54,-18,31
Sonderjyske,9962,7,8,6,10,28,29,-1,30
Randers FC,9962,8,6,6,12,25,40,-15,24
AGF Aarhus,9962,9,5,6,11,18,37,-19,21
Lyngby,9962,10,3,9,12,27,46,-19,18
Silkeborg IF,9962,11,5,3,14,26,46,-20,18
Brondby,9963,1,21,5,4,75,32,43,68
FC Midtjylla,9963,2,19,5,6,66,42,24,62
FC Nords,9963,3,15,7,8,76,53,23,52
Copenhagen,9963,4,15,4,11,56,44,12,49
AC Horsens,9963,5,8,12,10,34,52,-18,36
Sonderjyske,9963,6,8,6,10,28,29,-1,30
AaB,9963,7,6,11,13,32,42,-10,29
Lyngby,9963,8,4,9,11,28,44,-16,21
Randers FC,9963,9,5,6,13,23,41,-18,21
AGF Aarhus,9963,10,5,6,11,19,37,-18,21
Silkeborg IF,9963,11,5,3,14,26,47,-21,18
Brondby,9964,1,20,5,5,66,34,32,65
FC Midtjylla,9964,2,20,5,5,62,35,27,65
FC Nords,9964,3,16,6,8,74,45,29,54
Copenhagen,9964,4,13,5,12,52,41,11,44
AC Horsens,9964,5,7,13,10,35,52,-17,34
AaB,9964,6,7,12,11,34,42,-8,33
Sonderjyske,9964,7,8,6,10,28,29,-1,30
Randers FC,9964,8,6,6,12,25,39,-14,24
Silkeborg IF,9964,9,6,3,13,29,45,-16,21
Lyngby,9964,10,3,9,12,26,46,-20,18
AGF Aarhus,9964,11,4,6,12,17,40,-23,18
Brondby,9965,1,21,5,4,70,31,39,68
FC Midtjylla,9965,2,21,4,5,64,36,28,67
Copenhagen,9965,3,14,6,10,59,44,15,48
FC Nords,9965,4,13,7,10,74,53,21,46
AaB,9965,5,8,11,11,36,46,-10,35
AC Horsens,9965,6,6,13,11,37,56,-19,31
Sonderjyske,9965,7,8,6,10,28,29,-1,30
Lyngby,9965,8,4,9,11,28,45,-17,21
Randers FC,9965,9,5,6,13,24,41,-17,21
Silkeborg IF,9965,10,6,3,13,26,44,-18,21
AGF Aarhus,9965,11,4,6,12,16,37,-21,18
Brondby,9966,1,21,5,4,72,31,41,68
FC Midtjylla,9966,2,18,7,5,61,38,23,61
FC Nords,9966,3,15,6,9,78,53,25,51
Copenhagen,9966,4,14,5,11,57,45,12,47
AaB,9966,5,8,12,10,36,40,-4,36
AC Horsens,9966,6,6,13,11,35,58,-23,31
Sonderjyske,9966,7,8,6,10,28,29,-1,30
Randers FC,9966,8,6,6,12,25,39,-14,24
Silkeborg IF,9966,9,5,4,13,27,46,-19,19
AGF Aarhus,9966,10,4,7,11,18,38,-20,19
Lyngby,9966,11,3,9,12,26,46,-20,18
Brondby,9967,1,21,6,3,67,31,36,69
FC Midtjylla,9967,2,19,4,7,65,37,28,61
FC Nords,9967,3,14,7,9,73,53,20,49
Copenhagen,9967,4,14,6,10,56,41,15,48
AC Horsens,9967,5,7,13,10,36,54,-18,34
AaB,9967,6,7,12,11,36,43,-7,33
Sonderjyske,9967,7,8,6,10,28,29,-1,30
Randers FC,9967,8,5,7,12,25,41,-16,22
AGF Aarhus,9967,9,5,6,11,18,37,-19,21
Lyngby,9967,10,3,10,11,28,46,-18,19
Silkeborg IF,9967,11,5,3,14,26,46,-20,18
Brondby,9968,1,21,5,4,71,35,36,68
FC Midtjylla,9968,2,20,5,5,68,37,31,65
FC Nords,9968,3,15,6,9,74,52,22,51
Copenhagen,9968,4,14,5,11,57,43,14,47
AaB,9968,5,7,12,11,37,46,-9,33
AC Horsens,9968,6,6,13,11,33,53,-20,31
Sonderjyske,9968,7,8,6,10,28,29,-1,30
Randers FC,9968,8,5,7,12,26,42,-16,22
AGF Aarhus,9968,9,5,6,11,18,37,-19,21
Lyngby,9968,10,3,10,11,29,47,-18,19
Silkeborg IF,9968,11,5,3,14,26,46,-20,18
FC Midtjylla,9969,1,21,4,5,68,37,31,67
Brondby,9969,2,19,6,5,68,35,33,63
Copenhagen,9969,3,15,5,10,63,44,19,50
FC Nords,9969,4,13,8,9,69,52,17,47
AaB,9969,5,8,11,11,39,45,-6,35
AC Horsens,9969,6,7,12,11,33,53,-20,33
Sonderjyske,9969,7,8,6,10,28,29,-1,30
Lyngby,9969,8,4,9,11,30,46,-16,21
Silkeborg IF,9969,9,6,3,13,28,44,-16,21
Randers FC,9969,10,5,6,13,25,43,-18,21
AGF Aarhus,9969,11,4,6,12,16,39,-23,18
Brondby,9970,1,23,5,2,74,27,47,74
FC Midtjylla,9970,2,19,5,6,65,41,24,62
FC Nords,9970,3,13,8,9,71,52,19,47
Copenhagen,9970,4,13,4,13,58,53,5,43
AaB,9970,5,8,12,10,35,41,-6,36
AC Horsens,9970,6,6,14,10,39,54,-15,32
Sonderjyske,9970,7,8,6,10,28,29,-1,30
Lyngby,9970,8,4,9,11,27,44,-17,21
Randers FC,9970,9,5,6,13,23,40,-17,21
Silkeborg IF,9970,10,5,4,13,26,45,-19,19
AGF Aarhus,9970,11,4,7,11,17,37,-20,19
Brondby,9971,1,21,5,4,73,34,39,68
FC Midtjylla,9971,2,19,5,6,66,43,23,62
FC Nords,9971,3,14,7,9,72,51,21,49
Copenhagen,9971,4,15,4,11,59,44,15,49
AaB,9971,5,7,12,11,37,47,-10,33
AC Horsens,9971,6,6,15,9,33,47,-14,33
Sonderjyske,9971,7,8,6,10,28,29,-1,30
Lyngby,9971,8,4,9,11,28,44,-16,21
Silkeborg IF,9971,8,6,3,13,28,44,-16,21
Randers FC,9971,10,5,6,13,23,41,-18,21
AGF Aarhus,9971,11,4,6,12,16,39,-23,18
Brondby,9972,1,21,5,4,70,33,37,68
FC Midtjylla,9972,2,19,5,6,67,40,27,62
FC Nords,9972,3,14,8,8,74,53,21,50
Copenhagen,9972,4,14,5,11,60,45,15,47
AaB,9972,5,8,12,10,38,45,-7,36
AC Horsens,9972,6,6,13,11,35,54,-19,31
Sonderjyske,9972,7,8,6,10,28,29,-1,30
Lyngby,9972,8,4,9,11,27,44,-17,21
Silkeborg IF,9972,8,6,3,13,27,44,-17,21
Randers FC,9972,10,5,6,13,23,40,-17,21
AGF Aarhus,9972,11,4,6,12,16,38,-22,18
Brondby,9973,1,23,5,2,74,32,42,74
FC Midtjylla,9973,2,19,5,6,64,42,22,62
FC Nords,9973,3,14,6,10,77,56,21,48
Copenhagen,9973,4,13,5,12,56,47,9,44
AaB,9973,5,8,11,11,38,42,-4,35
AC Horsens,9973,6,7,12,11,37,53,-16,33
Sonderjyske,9973,7,8,6,10,28,29,-1,30
Randers FC,9973,8,6,6,12,25,40,-15,24
Silkeborg IF,9973,9,5,4,13,27,46,-19,19
AGF Aarhus,9973,10,4,7,11,18,38,-20,19
Lyngby,9973,11,3,9,12,27,46,-19,18
Brondby,9974,1,21,5,4,73,36,37,68
FC Midtjylla,9974,2,20,5,5,67,42,25,65
FC Nords,9974,3,15,6,9,81,55,26,51
Copenhagen,9974,4,12,6,12,62,54,8,42
AaB,9974,5,9,12,9,40,42,-2,39
Sonderjyske,9974,6,8,6,10,28,29,-1,30
AC Horsens,9974,7,5,14,11,35,55,-20,29
Lyngby,9974,8,4,9,11,29,44,-15,21
Silkeborg IF,9974,9,6,3,13,27,44,-17,21
Randers FC,9974,10,5,6,13,23,42,-19,21
AGF Aarhus,9974,11,4,6,12,16,38,-22,18
Brondby,9975,1,21,6,3,72,34,38,69
FC Midtjylla,9975,2,19,6,5,70,44,26,63
FC Nords,9975,3,14,7,9,73,49,24,49
Copenhagen,9975,4,13,6,11,59,48,11,45
AaB,9975,5,8,11,11,43,46,-3,35
AC Horsens,9975,6,7,12,11,34,56,-22,33
Sonderjyske,9975,7,8,6,10,28,29,-1,30
Randers FC,9975,8,5,7,12,24,40,-16,22
Silkeborg IF,9975,9,6,3,13,28,46,-18,21
Lyngby,9975,10,3,10,11,27,45,-18,19
AGF Aarhus,9975,11,4,6,12,18,39,-21,18
Brondby,9976,1,21,7,2,72,28,44,70
FC Midtjylla,9976,2,18,4,8,67,44,23,58
FC Nords,9976,3,14,7,9,71,55,16,49
Copenhagen,9976,4,14,5,11,59,44,15,47
AaB,9976,5,8,12,10,37,44,-7,36
AC Horsens,9976,6,7,13,10,38,55,-17,34
Sonderjyske,9976,7,8,6,10,28,29,-1,30
Randers FC,9976,8,6,6,12,25,40,-15,24
Silkeborg IF,9976,9,6,3,13,28,45,-17,21
Lyngby,9976,10,3,9,12,27,46,-19,18
AGF Aarhus,9976,11,4,6,12,17,39,-22,18
Brondby,9977,1,23,5,2,79,30,49,74
FC Midtjylla,9977,2,20,4,6,67,41,26,64
FC Nords,9977,3,14,7,9,73,52,21,49
Copenhagen,9977,4,14,5,11,57,47,10,47
AC Horsens,9977,5,6,13,11,34,55,-21,31
Sonderjyske,9977,6,8,6,10,28,29,-1,30
AaB,9977,7,6,12,12,36,47,-11,30
Lyngby,9977,8,4,9,11,29,44,-15,21
Randers FC,9977,9,5,6,13,23,42,-19,21
Silkeborg IF,9977,10,5,4,13,26,45,-19,19
AGF Aarhus,9977,11,4,7,11,17,37,-20,19
Brondby,9978,1,23,5,2,75,30,45,74
FC Midtjylla,9978,2,17,5,8,64,48,16,56
FC Nords,9978,3,16,6,8,75,49,26,54
Copenhagen,9978,4,13,5,12,57,48,9,44
AaB,9978,5,8,12,10,40,44,-4,36
AC Horsens,9978,6,6,13,11,33,51,-18,31
Sonderjyske,9978,7,8,6,10,28,29,-1,30
Randers FC,9978,8,6,6,12,27,40,-13,24
Silkeborg IF,9978,9,6,3,13,26,44,-18,21
Lyngby,9978,10,3,9,12,27,48,-21,18
AGF Aarhus,9978,11,4,6,12,16,37,-21,18
Brondby,9979,1,21,7,2,73,33,40,70
FC Midtjylla,9979,2,19,7,4,68,38,30,64
FC Nords,9979,3,14,7,9,73,52,21,49
Copenhagen,9979,4,12,6,12,53,45,8,42
AC Horsens,9979,5,7,14,9,35,49,-14,35
AaB,9979,6,6,13,11,33,44,-11,31
Sonderjyske,9979,7,8,6,10,28,29,-1,30
Randers FC,9979,8,5,7,12,24,40,-16,22
Silkeborg IF,9979,9,6,3,13,28,45,-17,21
Lyngby,9979,10,3,10,11,27,45,-18,19
AGF Aarhus,9979,11,4,6,12,17,39,-22,18
Brondby,9980,1,23,5,2,76,31,45,74
FC Midtjylla,9980,2,20,5,5,64,37,27,65
Copenhagen,9980,3,15,4,11,60,45,15,49
FC Nords,9980,4,12,8,10,68,53,15,44
AC Horsens,9980,5,6,14,10,33,49,-16,32
Sonderjyske,9980,6,8,6,10,28,29,-1,30
AaB,9980,7,6,12,12,33,45,-12,30
Randers FC,9980,8,5,7,12,24,40,-16,22
Lyngby,9980,9,3,10,11,27,45,-18,19
Silkeborg IF,9980,10,5,4,13,27,46,-19,19
AGF Aarhus,9980,11,4,7,11,18,38,-20,19
Brondby,9981,1,22,6,2,71,27,44,72
FC Midtjylla,9981,2,19,5,6,63,40,23,62
FC Nords,9981,3,14,8,8,75,52,23,50
Copenhagen,9981,4,14,4,12,58,44,14,46
AaB,9981,5,7,13,10,38,45,-7,34
Sonderjyske,9981,6,8,6,10,28,29,-1,30
AC Horsens,9981,7,5,14,11,34,57,-23,29
Lyngby,9981,8,4,9,11,30,45,-15,21
Silkeborg IF,9981,9,6,3,13,27,44,-17,21
Randers FC,9981,10,5,6,13,24,43,-19,21
AGF Aarhus,9981,11,4,6,12,16,38,-22,18
Brondby,9982,1,22,5,3,71,30,41,71
FC Midtjylla,9982,2,18,6,6,63,40,23,60
FC Nords,9982,3,16,6,8,71,44,27,54
Copenhagen,9982,4,12,6,12,53,44,9,42
AC Horsens,9982,5,7,14,9,39,55,-16,35
AaB,9982,6,6,13,11,33,43,-10,31
Sonderjyske,9982,7,8,6,10,28,29,-1,30
Randers FC,9982,8,5,7,12,24,40,-16,22
Silkeborg IF,9982,9,6,3,13,26,44,-18,21
Lyngby,9982,10,3,10,11,27,45,-18,19
AGF Aarhus,9982,11,4,6,12,16,37,-21,18
Brondby,9983,1,22,5,3,74,31,43,71
FC Midtjylla,9983,2,19,4,7,64,41,23,61
FC Nords,9983,3,15,6,9,73,51,22,51
Copenhagen,9983,4,14,6,10,60,46,14,48
AC Horsens,9983,5,6,14,10,32,50,-18,32
AaB,9983,6,6,13,11,33,43,-10,31
Sonderjyske,9983,7,8,6,10,28,29,-1,30
Randers FC,9983,8,6,6,12,26,40,-14,24
Silkeborg IF,9983,9,6,3,13,26,44,-18,21
Lyngby,9983,10,3,9,12,27,47,-20,18
AGF Aarhus,9983,11,4,6,12,16,37,-21,18
Brondby,9984,1,23,5,2,73,32,41,74
FC Midtjylla,9984,2,21,4,5,68,39,29,67
Copenhagen,9984,3,14,5,11,60,48,12,47
FC Nords,9984,4,12,6,12,69,54,15,42
AaB,9984,5,8,12,10,40,44,-4,36
Sonderjyske,9984,6,8,6,10,28,29,-1,30
AC Horsens,9984,7,6,12,12,39,58,-19,30
Randers FC,9984,8,5,7,12,24,40,-16,22
AGF Aarhus,9984,9,5,6,11,17,36,-19,21
Lyngby,9984,10,3,10,11,27,45,-18,19
Silkeborg IF,9984,11,5,3,14,25,45,-20,18
Brondby,9985,1,20,6,4,75,37,38,66
FC Midtjylla,9985,2,19,4,7,65,48,17,61
Copenhagen,9985,3,17,4,9,63,40,23,55
FC Nords,9985,4,13,6,11,74,59,15,45
AC Horsens,9985,5,8,12,10,41,52,-11,36
AaB,9985,6,7,12,11,37,45,-8,33
Sonderjyske,9985,7,8,6,10,28,29,-1,30
Randers FC,9985,8,5,7,12,24,40,-16,22
Silkeborg IF,9985,9,6,3,13,27,45,-18,21
Lyngby,9985,10,3,10,11,27,45,-18,19
AGF Aarhus,9985,11,4,6,12,17,38,-21,18
Brondby,9986,1,21,6,3,69,32,37,69
FC Midtjylla,9986,2,18,6,6,63,40,23,60
Copenhagen,9986,3,16,4,10,68,47,21,52
FC Nords,9986,4,15,6,9,76,53,23,51
AaB,9986,5,7,12,11,35,42,-7,33
Sonderjyske,9986,6,8,6,10,28,29,-1,30
AC Horsens,9986,7,6,12,12,32,55,-23,30
Randers FC,9986,8,5,7,12,23,39,-16,22
AGF Aarhus,9986,9,5,6,11,19,37,-18,21
Lyngby,9986,10,3,10,11,26,44,-18,19
Silkeborg IF,9986,11,5,3,14,26,47,-21,18
Brondby,9987,1,21,5,4,70,34,36,68
FC Midtjylla,9987,2,19,6,5,65,41,24,63
FC Nords,9987,3,15,6,9,77,53,24,51
Copenhagen,9987,4,13,6,11,58,48,10,45
AC Horsens,9987,5,7,14,9,41,53,-12,35
AaB,9987,6,6,13,11,36,44,-8,31
Sonderjyske,9987,7,8,6,10,28,29,-1,30
Randers FC,9987,8,5,7,12,25,41,-16,22
AGF Aarhus,9987,9,5,6,11,20,38,-18,21
Lyngby,9987,10,3,10,11,28,46,-18,19
Silkeborg IF,9987,11,5,3,14,27,48,-21,18
Brondby,9988,1,21,6,3,70,34,36,69
FC Midtjylla,9988,2,21,4,5,66,39,27,67
FC Nords,9988,3,14,7,9,73,51,22,49
Copenhagen,9988,4,12,4,14,59,53,6,40
AC Horsens,9988,5,8,12,10,41,53,-12,36
AaB,9988,6,8,11,11,40,45,-5,35
Sonderjyske,9988,7,8,6,10,28,29,-1,30
Lyngby,9988,8,4,9,11,30,44,-14,21
Randers FC,9988,9,5,6,13,23,43,-20,21
Silkeborg IF,9988,10,5,4,13,27,46,-19,19
AGF Aarhus,9988,11,4,7,11,18,38,-20,19
Brondby,9989,1,21,6,3,69,31,38,69
FC Midtjylla,9989,2,20,5,5,70,41,29,65
FC Nords,9989,3,14,6,10,72,52,20,48
Copenhagen,9989,4,14,5,11,59,46,13,47
AaB,9989,5,8,12,10,39,44,-5,36
Sonderjyske,9989,6,8,6,10,28,29,-1,30
AC Horsens,9989,7,6,12,12,35,56,-21,30
Randers FC,9989,8,5,7,12,24,40,-16,22
Lyngby,9989,9,3,10,11,27,45,-18,19
Silkeborg IF,9989,10,5,4,13,26,45,-19,19
AGF Aarhus,9989,11,4,7,11,17,37,-20,19
Brondby,9990,1,21,7,2,74,34,40,70
FC Midtjylla,9990,2,19,4,7,68,42,26,61
FC Nords,9990,3,14,7,9,72,50,22,49
Copenhagen,9990,4,14,5,11,58,46,12,47
AC Horsens,9990,5,7,13,10,34,50,-16,34
AaB,9990,6,7,12,11,36,46,-10,33
Sonderjyske,9990,7,8,6,10,28,29,-1,30
Lyngby,9990,8,4,9,11,27,44,-17,21
Randers FC,9990,9,5,6,13,23,40,-17,21
AGF Aarhus,9990,10,5,6,11,19,37,-18,21
Silkeborg IF,9990,11,5,3,14,26,47,-21,18
Brondby,9991,1,21,5,4,70,33,37,68
FC Midtjylla,9991,2,20,4,6,64,38,26,64
FC Nords,9991,3,16,6,8,73,50,23,54
Copenhagen,9991,4,14,4,12,57,50,7,46
AC Horsens,9991,5,7,12,11,36,52,-16,33
AaB,9991,6,7,11,12,43,46,-3,32
Sonderjyske,9991,7,8,6,10,28,29,-1,30
Lyngby,9991,8,4,9,11,28,45,-17,21
Randers FC,9991,9,5,6,13,24,41,-17,21
AGF Aarhus,9991,10,5,6,11,18,37,-19,21
Silkeborg IF,9991,11,5,3,14,26,46,-20,18
Brondby,9992,1,21,6,3,68,30,38,69
FC Midtjylla,9992,2,19,4,7,66,41,25,61
FC Nords,9992,3,15,7,8,74,51,23,52
Copenhagen,9992,4,14,6,10,59,43,16,48
AC Horsens,9992,5,8,12,10,35,51,-16,36
Sonderjyske,9992,6,8,6,10,28,29,-1,30
AaB,9992,7,6,11,13,32,44,-12,29
Randers FC,9992,8,6,6,12,24,39,-15,24
AGF Aarhus,9992,9,5,6,11,18,37,-19,21
Lyngby,9992,10,3,9,12,26,45,-19,18
Silkeborg IF,9992,11,5,3,14,26,46,-20,18
Brondby,9993,1,22,6,2,72,29,43,72
FC Midtjylla,9993,2,18,4,8,62,41,21,58
FC Nords,9993,3,16,6,8,74,48,26,54
Copenhagen,9993,4,14,5,11,60,46,14,47
AaB,9993,5,7,12,11,37,43,-6,33
AC Horsens,9993,6,6,13,11,37,61,-24,31
Sonderjyske,9993,7,8,6,10,28,29,-1,30
Randers FC,9993,8,5,7,12,24,40,-16,22
Silkeborg IF,9993,9,6,3,13,26,44,-18,21
Lyngby,9993,10,3,10,11,27,45,-18,19
AGF Aarhus,9993,11,4,6,12,16,37,-21,18
Brondby,9994,1,20,8,2,69,30,39,68
FC Midtjylla,9994,2,19,5,6,70,41,29,62
FC Nords,9994,3,14,6,10,73,54,19,48
Copenhagen,9994,4,13,4,13,57,52,5,43
AaB,9994,5,9,12,9,40,43,-3,39
AC Horsens,9994,6,7,13,10,37,52,-15,34
Sonderjyske,9994,7,8,6,10,28,29,-1,30
Lyngby,9994,8,4,9,11,28,45,-17,21
Randers FC,9994,9,5,6,13,24,41,-17,21
Silkeborg IF,9994,10,5,4,13,26,45,-19,19
AGF Aarhus,9994,11,4,7,11,17,37,-20,19
Brondby,9995,1,21,6,3,75,31,44,69
FC Midtjylla,9995,2,21,5,4,70,36,34,68
FC Nords,9995,3,15,7,8,77,52,25,52
Copenhagen,9995,4,12,5,13,56,49,7,41
AaB,9995,5,7,12,11,36,49,-13,33
AC Horsens,9995,6,6,13,11,34,57,-23,31
Sonderjyske,9995,7,8,6,10,28,29,-1,30
Randers FC,9995,8,6,6,12,24,39,-15,24
Silkeborg IF,9995,9,6,3,13,26,44,-18,21
Lyngby,9995,10,3,9,12,26,45,-19,18
AGF Aarhus,9995,11,4,6,12,16,37,-21,18
Brondby,9996,1,19,8,3,71,35,36,65
FC Midtjylla,9996,2,19,7,4,68,39,29,64
FC Nords,9996,3,15,8,7,75,47,28,53
Copenhagen,9996,4,12,5,13,54,52,2,41
AC Horsens,9996,5,7,14,9,39,55,-16,35
AaB,9996,6,7,12,11,34,39,-5,33
Sonderjyske,9996,7,8,6,10,28,29,-1,30
Randers FC,9996,8,6,6,12,24,39,-15,24
AGF Aarhus,9996,9,5,6,11,18,37,-19,21
Lyngby,9996,10,3,9,12,26,45,-19,18
Silkeborg IF,9996,11,5,3,14,26,46,-20,18
Brondby,9997,1,21,5,4,68,29,39,68
FC Midtjylla,9997,2,20,4,6,68,40,28,64
FC Nords,9997,3,16,6,8,75,49,26,54
Copenhagen,9997,4,14,5,11,59,46,13,47
AaB,9997,5,7,12,11,36,42,-6,33
Sonderjyske,9997,6,8,6,10,28,29,-1,30
AC Horsens,9997,7,5,14,11,32,58,-26,29
Randers FC,9997,8,6,6,12,26,40,-14,24
Silkeborg IF,9997,9,5,4,13,25,44,-19,19
AGF Aarhus,9997,10,4,7,11,16,36,-20,19
Lyngby,9997,11,3,9,12,27,47,-20,18
Brondby,9998,1,20,8,2,72,35,37,68
FC Midtjylla,9998,2,19,6,5,64,38,26,63
FC Nords,9998,3,14,8,8,80,54,26,50
Copenhagen,9998,4,13,5,12,60,49,11,44
AaB,9998,5,7,14,9,38,43,-5,35
Sonderjyske,9998,6,8,6,10,28,29,-1,30
AC Horsens,9998,7,5,15,10,32,53,-21,30
Randers FC,9998,8,6,6,12,24,39,-15,24
Silkeborg IF,9998,9,6,3,13,28,45,-17,21
Lyngby,9998,10,3,9,12,26,45,-19,18
AGF Aarhus,9998,11,4,6,12,17,39,-22,18
Brondby,9999,1,22,6,2,75,31,44,72
FC Midtjylla,9999,2,20,5,5,67,40,27,65
FC Nords,9999,3,14,7,9,71,51,20,49
Copenhagen,9999,4,13,5,12,54,44,10,44
AaB,9999,5,7,12,11,34,42,-8,33
Sonderjyske,9999,6,8,6,10,28,29,-1,30
AC Horsens,9999,7,5,15,10,34,53,-19,30
Randers FC,9999,8,6,6,12,24,39,-15,24
Silkeborg IF,9999,9,5,4,13,25,44,-19,19
AGF Aarhus,9999,10,4,7,11,16,36,-20,19
Lyngby,9999,11,3,9,12,26,45,-19,18
