team,n,rank,w,d,l,gf,ga,gd,pts
AEK Athens,0,1,4,2,0,7,1,6,14
PAOK Salonik,0,2,2,2,2,10,6,4,8
P'thinaikos,0,3,2,1,3,6,10,-4,7
Panionios,0,4,1,1,4,4,10,-6,4
AEK Athens,1,1,4,2,0,7,1,6,14
PAOK Salonik,1,2,3,2,1,10,4,6,11
P'thinaikos,1,3,1,1,4,4,10,-6,4
Panionios,1,3,1,1,4,4,10,-6,4
AEK Athens,2,1,4,2,0,7,1,6,14
PAOK Salonik,2,2,2,2,2,9,6,3,8
P'thinaikos,2,3,2,1,3,6,9,-3,7
Panionios,2,4,1,1,4,4,10,-6,4
AEK Athens,3,1,4,2,0,7,1,6,14
PAOK Salonik,3,2,2,2,2,9,8,1,8
P'thinaikos,3,3,2,1,3,8,9,-1,7
Panionios,3,4,1,1,4,4,10,-6,4
AEK Athens,4,1,4,2,0,7,1,6,14
PAOK Salonik,4,2,3,2,1,10,4,6,11
P'thinaikos,4,3,1,1,4,4,10,-6,4
Panionios,4,3,1,1,4,4,10,-6,4
AEK Athens,5,1,4,2,0,7,1,6,14
PAOK Salonik,5,2,2,3,1,9,4,5,9
P'thinaikos,5,3,1,2,3,4,9,-5,5
Panionios,5,4,1,1,4,4,10,-6,4
AEK Athens,6,1,4,2,0,7,1,6,14
PAOK Salonik,6,2,2,3,1,9,4,5,9
P'thinaikos,6,3,1,2,3,4,9,-5,5
Panionios,6,4,1,1,4,4,10,-6,4
AEK Athens,7,1,4,2,0,7,1,6,14
PAOK Salonik,7,2,3,2,1,10,4,6,11
P'thinaikos,7,3,1,1,4,4,10,-6,4
Panionios,7,3,1,1,4,4,10,-6,4
AEK Athens,8,1,4,2,0,7,1,6,14
PAOK Salonik,8,2,2,3,1,10,5,5,9
P'thinaikos,8,3,1,2,3,5,10,-5,5
Panionios,8,4,1,1,4,4,10,-6,4
AEK Athens,9,1,4,2,0,7,1,6,14
PAOK Salonik,9,2,2,3,1,9,4,5,9
P'thinaikos,9,3,1,2,3,4,9,-5,5
Panionios,9,4,1,1,4,4,10,-6,4
AEK Athens,10,1,4,2,0,7,1,6,14
PAOK Salonik,10,2,2,3,1,10,5,5,9
P'thinaikos,10,3,1,2,3,5,10,-5,5
Panionios,10,4,1,1,4,4,10,-6,4
AEK Athens,11,1,4,2,0,7,1,6,14
PAOK Salonik,11,2,2,3,1,10,5,5,9
P'thinaikos,11,3,1,2,3,5,10,-5,5
Panionios,11,4,1,1,4,4,10,-6,4
AEK Athens,12,1,4,2,0,7,1,6,14
PAOK Salonik,12,2,3,2,1,11,5,6,11
P'thinaikos,12,3,1,1,4,5,11,-6,4
Panionios,12,4,1,1,4,4,10,-6,4
AEK Athens,13,1,4,2,0,7,1,6,14
PAOK Salonik,13,2,3,2,1,13,4,9,11
Panionios,13,3,1,1,4,4,10,-6,4
P'thinaikos,13,4,1,1,4,4,13,-9,4
AEK Athens,14,1,4,2,0,7,1,6,14
PAOK Salonik,14,2,2,3,1,10,5,5,9
P'thinaikos,14,3,1,2,3,5,10,-5,5
Panionios,14,4,1,1,4,4,10,-6,4
AEK Athens,15,1,4,2,0,7,1,6,14
PAOK Salonik,15,2,2,2,2,9,5,4,8
P'thinaikos,15,3,2,1,3,5,9,-4,7
Panionios,15,4,1,1,4,4,10,-6,4
AEK Athens,16,1,4,2,0,7,1,6,14
PAOK Salonik,16,2,3,2,1,11,4,7,11
Panionios,16,3,1,1,4,4,10,-6,4
P'thinaikos,16,4,1,1,4,4,11,-7,4
AEK Athens,17,1,4,2,0,7,1,6,14
PAOK Salonik,17,2,2,2,2,9,5,4,8
P'thinaikos,17,3,2,1,3,5,9,-4,7
Panionios,17,4,1,1,4,4,10,-6,4
AEK Athens,18,1,4,2,0,7,1,6,14
PAOK Salonik,18,2,2,2,2,10,7,3,8
P'thinaikos,18,3,2,1,3,7,10,-3,7
Panionios,18,4,1,1,4,4,10,-6,4
AEK Athens,19,1,4,2,0,7,1,6,14
PAOK Salonik,19,2,2,3,1,10,5,5,9
P'thinaikos,19,3,1,2,3,5,10,-5,5
Panionios,19,4,1,1,4,4,10,-6,4
AEK Athens,20,1,4,2,0,7,1,6,14
PAOK Salonik,20,2,2,2,2,9,5,4,8
P'thinaikos,20,3,2,1,3,5,9,-4,7
Panionios,20,4,1,1,4,4,10,-6,4
AEK Athens,21,1,4,2,0,7,1,6,14
PAOK Salonik,21,2,3,2,1,12,4,8,11
Panionios,21,3,1,1,4,4,10,-6,4
P'thinaikos,21,4,1,1,4,4,12,-8,4
AEK Athens,22,1,4,2,0,7,1,6,14
PAOK Salonik,22,2,2,3,1,9,4,5,9
P'thinaikos,22,3,1,2,3,4,9,-5,5
Panionios,22,4,1,1,4,4,10,-6,4
AEK Athens,23,1,4,2,0,7,1,6,14
PAOK Salonik,23,2,3,2,1,11,4,7,11
Panionios,23,3,1,1,4,4,10,-6,4
P'thinaikos,23,4,1,1,4,4,11,-7,4
AEK Athens,24,1,4,2,0,7,1,6,14
PAOK Salonik,24,2,3,2,1,12,5,7,11
Panionios,24,3,1,1,4,4,10,-6,4
P'thinaikos,24,4,1,1,4,5,12,-7,4
AEK Athens,25,1,4,2,0,7,1,6,14
PAOK Salonik,25,2,3,2,1,10,4,6,11
P'thinaikos,25,3,1,1,4,4,10,-6,4
Panionios,25,3,1,1,4,4,10,-6,4
AEK Athens,26,1,4,2,0,7,1,6,14
PAOK Salonik,26,2,3,2,1,10,4,6,11
P'thinaikos,26,3,1,1,4,4,10,-6,4
Panionios,26,3,1,1,4,4,10,-6,4
AEK Athens,27,1,4,2,0,7,1,6,14
PAOK Salonik,27,2,2,2,2,9,6,3,8
P'thinaikos,27,3,2,1,3,6,9,-3,7
Panionios,27,4,1,1,4,4,10,-6,4
AEK Athens,28,1,4,2,0,7,1,6,14
PAOK Salonik,28,2,2,3,1,9,4,5,9
P'thinaikos,28,3,1,2,3,4,9,-5,5
Panionios,28,4,1,1,4,4,10,-6,4
AEK Athens,29,1,4,2,0,7,1,6,14
PAOK Salonik,29,2,3,2,1,12,5,7,11
Panionios,29,3,1,1,4,4,10,-6,4
P'thinaikos,29,4,1,1,4,5,12,-7,4
AEK Athens,30,1,4,2,0,7,1,6,14
PAOK Salonik,30,2,2,3,1,9,4,5,9
P'thinaikos,30,3,1,2,3,4,9,-5,5
Panionios,30,4,1,1,4,4,10,-6,4
AEK Athens,31,1,4,2,0,7,1,6,14
PAOK Salonik,31,2,2,2,2,9,5,4,8
P'thinaikos,31,3,2,1,3,5,9,-4,7
Panionios,31,4,1,1,4,4,10,-6,4
AEK Athens,32,1,4,2,0,7,1,6,14
PAOK Salonik,32,2,2,3,1,10,5,5,9
P'thinaikos,32,3,1,2,3,5,10,-5,5
Panionios,32,4,1,1,4,4,10,-6,4
AEK Athens,33,1,4,2,0,7,1,6,14
PAOK Salonik,33,2,2,3,1,10,5,5,9
P'thinaikos,33,3,1,2,3,5,10,-5,5
Panionios,33,4,1,1,4,4,10,-6,4
AEK Athens,34,1,4,2,0,7,1,6,14
PAOK Salonik,34,2,2,2,2,9,6,3,8
P'thinaikos,34,3,2,1,3,6,9,-3,7
Panionios,34,4,1,1,4,4,10,-6,4
AEK Athens,35,1,4,2,0,7,1,6,14
PAOK Salonik,35,2,3,2,1,15,6,9,11
Panionios,35,3,1,1,4,4,10,-6,4
P'thinaikos,35,4,1,1,4,6,15,-9,4
AEK Athens,36,1,4,2,0,7,1,6,14
PAOK Salonik,36,2,3,2,1,11,5,6,11
P'thinaikos,36,3,1,1,4,5,11,-6,4
Panionios,36,4,1,1,4,4,10,-6,4
AEK Athens,37,1,4,2,0,7,1,6,14
PAOK Salonik,37,2,3,2,1,10,4,6,11
P'thinaikos,37,3,1,1,4,4,10,-6,4
Panionios,37,3,1,1,4,4,10,-6,4
AEK Athens,38,1,4,2,0,7,1,6,14
PAOK Salonik,38,2,2,2,2,9,7,2,8
P'thinaikos,38,3,2,1,3,7,9,-2,7
Panionios,38,4,1,1,4,4,10,-6,4
AEK Athens,39,1,4,2,0,7,1,6,14
PAOK Salonik,39,2,2,2,2,10,6,4,8
P'thinaikos,39,3,2,1,3,6,10,-4,7
Panionios,39,4,1,1,4,4,10,-6,4
AEK Athens,40,1,4,2,0,7,1,6,14
PAOK Salonik,40,2,3,2,1,11,4,7,11
Panionios,40,3,1,1,4,4,10,-6,4
P'thinaikos,40,4,1,1,4,4,11,-7,4
AEK Athens,41,1,4,2,0,7,1,6,14
PAOK Salonik,41,2,3,2,1,12,6,6,11
P'thinaikos,41,3,1,1,4,6,12,-6,4
Panionios,41,4,1,1,4,4,10,-6,4
AEK Athens,42,1,4,2,0,7,1,6,14
PAOK Salonik,42,2,3,2,1,10,4,6,11
P'thinaikos,42,3,1,1,4,4,10,-6,4
Panionios,42,3,1,1,4,4,10,-6,4
AEK Athens,43,1,4,2,0,7,1,6,14
PAOK Salonik,43,2,2,2,2,9,5,4,8
P'thinaikos,43,3,2,1,3,5,9,-4,7
Panionios,43,4,1,1,4,4,10,-6,4
AEK Athens,44,1,4,2,0,7,1,6,14
PAOK Salonik,44,2,3,2,1,11,5,6,11
P'thinaikos,44,3,1,1,4,5,11,-6,4
Panionios,44,4,1,1,4,4,10,-6,4
AEK Athens,45,1,4,2,0,7,1,6,14
PAOK Salonik,45,2,2,3,1,10,5,5,9
P'thinaikos,45,3,1,2,3,5,10,-5,5
Panionios,45,4,1,1,4,4,10,-6,4
AEK Athens,46,1,4,2,0,7,1,6,14
PAOK Salonik,46,2,2,3,1,9,4,5,9
P'thinaikos,46,3,1,2,3,4,9,-5,5
Panionios,46,4,1,1,4,4,10,-6,4
AEK Athens,47,1,4,2,0,7,1,6,14
PAOK Salonik,47,2,3,2,1,12,5,7,11
Panionios,47,3,1,1,4,4,10,-6,4
P'thinaikos,47,4,1,1,4,5,12,-7,4
AEK Athens,48,1,4,2,0,7,1,6,14
PAOK Salonik,48,2,2,3,1,10,5,5,9
P'thinaikos,48,3,1,2,3,5,10,-5,5
Panionios,48,4,1,1,4,4,10,-6,4
AEK Athens,49,1,4,2,0,7,1,6,14
PAOK Salonik,49,2,3,2,1,12,5,7,11
Panionios,49,3,1,1,4,4,10,-6,4
P'thinaikos,49,4,1,1,4,5,12,-7,4
AEK Athens,50,1,4,2,0,7,1,6,14
PAOK Salonik,50,2,2,3,1,10,5,5,9
P'thinaikos,50,3,1,2,3,5,10,-5,5
Panionios,50,4,1,1,4,4,10,-6,4
AEK Athens,51,1,4,2,0,7,1,6,14
PAOK Salonik,51,2,2,2,2,10,7,3,8
P'thinaikos,51,3,2,1,3,7,10,-3,7
Panionios,51,4,1,1,4,4,10,-6,4
AEK Athens,52,1,4,2,0,7,1,6,14
PAOK Salonik,52,2,3,2,1,12,6,6,11
P'thinaikos,52,3,1,1,4,6,12,-6,4
Panionios,52,4,1,1,4,4,10,-6,4
AEK Athens,53,1,4,2,0,7,1,6,14
PAOK Salonik,53,2,3,2,1,13,7,6,11
P'thinaikos,53,3,1,1,4,7,13,-6,4
Panionios,53,4,1,1,4,4,10,-6,4
AEK Athens,54,1,4,2,0,7,1,6,14
PAOK Salonik,54,2,2,2,2,9,8,1,8
P'thinaikos,54,3,2,1,3,8,9,-1,7
Panionios,54,4,1,1,4,4,10,-6,4
AEK Athens,55,1,4,2,0,7,1,6,14
PAOK Salonik,55,2,2,2,2,9,6,3,8
P'thinaikos,55,3,2,1,3,6,9,-3,7
Panionios,55,4,1,1,4,4,10,-6,4
AEK Athens,56,1,4,2,0,7,1,6,14
PAOK Salonik,56,2,3,2,1,10,4,6,11
P'thinaikos,56,3,1,1,4,4,10,-6,4
Panionios,56,3,1,1,4,4,10,-6,4
AEK Athens,57,1,4,2,0,7,1,6,14
PAOK Salonik,57,2,2,3,1,9,4,5,9
P'thinaikos,57,3,1,2,3,4,9,-5,5
Panionios,57,4,1,1,4,4,10,-6,4
AEK Athens,58,1,4,2,0,7,1,6,14
PAOK Salonik,58,2,2,3,1,10,5,5,9
P'thinaikos,58,3,1,2,3,5,10,-5,5
Panionios,58,4,1,1,4,4,10,-6,4
AEK Athens,59,1,4,2,0,7,1,6,14
PAOK Salonik,59,2,3,2,1,11,5,6,11
P'thinaikos,59,3,1,1,4,5,11,-6,4
Panionios,59,4,1,1,4,4,10,-6,4
AEK Athens,60,1,4,2,0,7,1,6,14
PAOK Salonik,60,2,2,3,1,10,5,5,9
P'thinaikos,60,3,1,2,3,5,10,-5,5
Panionios,60,4,1,1,4,4,10,-6,4
AEK Athens,61,1,4,2,0,7,1,6,14
PAOK Salonik,61,2,2,2,2,9,7,2,8
P'thinaikos,61,3,2,1,3,7,9,-2,7
Panionios,61,4,1,1,4,4,10,-6,4
AEK Athens,62,1,4,2,0,7,1,6,14
PAOK Salonik,62,2,3,2,1,14,4,10,11
Panionios,62,3,1,1,4,4,10,-6,4
P'thinaikos,62,4,1,1,4,4,14,-10,4
AEK Athens,63,1,4,2,0,7,1,6,14
PAOK Salonik,63,2,2,2,2,9,7,2,8
P'thinaikos,63,3,2,1,3,7,9,-2,7
Panionios,63,4,1,1,4,4,10,-6,4
AEK Athens,64,1,4,2,0,7,1,6,14
PAOK Salonik,64,2,3,2,1,11,4,7,11
Panionios,64,3,1,1,4,4,10,-6,4
P'thinaikos,64,4,1,1,4,4,11,-7,4
AEK Athens,65,1,4,2,0,7,1,6,14
PAOK Salonik,65,2,2,3,1,9,4,5,9
P'thinaikos,65,3,1,2,3,4,9,-5,5
Panionios,65,4,1,1,4,4,10,-6,4
AEK Athens,66,1,4,2,0,7,1,6,14
PAOK Salonik,66,2,2,2,2,9,7,2,8
P'thinaikos,66,3,2,1,3,7,9,-2,7
Panionios,66,4,1,1,4,4,10,-6,4
AEK Athens,67,1,4,2,0,7,1,6,14
PAOK Salonik,67,2,2,2,2,9,5,4,8
P'thinaikos,67,3,2,1,3,5,9,-4,7
Panionios,67,4,1,1,4,4,10,-6,4
AEK Athens,68,1,4,2,0,7,1,6,14
PAOK Salonik,68,2,2,3,1,11,6,5,9
P'thinaikos,68,3,1,2,3,6,11,-5,5
Panionios,68,4,1,1,4,4,10,-6,4
AEK Athens,69,1,4,2,0,7,1,6,14
PAOK Salonik,69,2,3,2,1,11,4,7,11
Panionios,69,3,1,1,4,4,10,-6,4
P'thinaikos,69,4,1,1,4,4,11,-7,4
AEK Athens,70,1,4,2,0,7,1,6,14
PAOK Salonik,70,2,3,2,1,11,4,7,11
Panionios,70,3,1,1,4,4,10,-6,4
P'thinaikos,70,4,1,1,4,4,11,-7,4
AEK Athens,71,1,4,2,0,7,1,6,14
PAOK Salonik,71,2,2,2,2,9,5,4,8
P'thinaikos,71,3,2,1,3,5,9,-4,7
Panionios,71,4,1,1,4,4,10,-6,4
AEK Athens,72,1,4,2,0,7,1,6,14
PAOK Salonik,72,2,2,2,2,10,6,4,8
P'thinaikos,72,3,2,1,3,6,10,-4,7
Panionios,72,4,1,1,4,4,10,-6,4
AEK Athens,73,1,4,2,0,7,1,6,14
PAOK Salonik,73,2,3,2,1,14,5,9,11
Panionios,73,3,1,1,4,4,10,-6,4
P'thinaikos,73,4,1,1,4,5,14,-9,4
AEK Athens,74,1,4,2,0,7,1,6,14
PAOK Salonik,74,2,2,3,1,11,6,5,9
P'thinaikos,74,3,1,2,3,6,11,-5,5
Panionios,74,4,1,1,4,4,10,-6,4
AEK Athens,75,1,4,2,0,7,1,6,14
PAOK Salonik,75,2,2,2,2,9,5,4,8
P'thinaikos,75,3,2,1,3,5,9,-4,7
Panionios,75,4,1,1,4,4,10,-6,4
AEK Athens,76,1,4,2,0,7,1,6,14
PAOK Salonik,76,2,2,2,2,10,6,4,8
P'thinaikos,76,3,2,1,3,6,10,-4,7
Panionios,76,4,1,1,4,4,10,-6,4
AEK Athens,77,1,4,2,0,7,1,6,14
PAOK Salonik,77,2,3,2,1,14,5,9,11
Panionios,77,3,1,1,4,4,10,-6,4
P'thinaikos,77,4,1,1,4,5,14,-9,4
AEK Athens,78,1,4,2,0,7,1,6,14
PAOK Salonik,78,2,3,2,1,11,4,7,11
Panionios,78,3,1,1,4,4,10,-6,4
P'thinaikos,78,4,1,1,4,4,11,-7,4
AEK Athens,79,1,4,2,0,7,1,6,14
PAOK Salonik,79,2,2,3,1,10,5,5,9
P'thinaikos,79,3,1,2,3,5,10,-5,5
Panionios,79,4,1,1,4,4,10,-6,4
AEK Athens,80,1,4,2,0,7,1,6,14
PAOK Salonik,80,2,2,2,2,10,6,4,8
P'thinaikos,80,3,2,1,3,6,10,-4,7
Panionios,80,4,1,1,4,4,10,-6,4
AEK Athens,81,1,4,2,0,7,1,6,14
PAOK Salonik,81,2,3,2,1,10,4,6,11
P'thinaikos,81,3,1,1,4,4,10,-6,4
Panionios,81,3,1,1,4,4,10,-6,4
AEK Athens,82,1,4,2,0,7,1,6,14
PAOK Salonik,82,2,3,2,1,13,6,7,11
Panionios,82,3,1,1,4,4,10,-6,4
P'thinaikos,82,4,1,1,4,6,13,-7,4
AEK Athens,83,1,4,2,0,7,1,6,14
PAOK Salonik,83,2,2,2,2,10,6,4,8
P'thinaikos,83,3,2,1,3,6,10,-4,7
Panionios,83,4,1,1,4,4,10,-6,4
AEK Athens,84,1,4,2,0,7,1,6,14
PAOK Salonik,84,2,2,3,1,10,5,5,9
P'thinaikos,84,3,1,2,3,5,10,-5,5
Panionios,84,4,1,1,4,4,10,-6,4
AEK Athens,85,1,4,2,0,7,1,6,14
PAOK Salonik,85,2,2,3,1,10,5,5,9
P'thinaikos,85,3,1,2,3,5,10,-5,5
Panionios,85,4,1,1,4,4,10,-6,4
AEK Athens,86,1,4,2,0,7,1,6,14
PAOK Salonik,86,2,2,3,1,10,5,5,9
P'thinaikos,86,3,1,2,3,5,10,-5,5
Panionios,86,4,1,1,4,4,10,-6,4
AEK Athens,87,1,4,2,0,7,1,6,14
PAOK Salonik,87,2,2,2,2,9,6,3,8
P'thinaikos,87,3,2,1,3,6,9,-3,7
Panionios,87,4,1,1,4,4,10,-6,4
AEK Athens,88,1,4,2,0,7,1,6,14
PAOK Salonik,88,2,2,2,2,10,6,4,8
P'thinaikos,88,3,2,1,3,6,10,-4,7
Panionios,88,4,1,1,4,4,10,-6,4
AEK Athens,89,1,4,2,0,7,1,6,14
PAOK Salonik,89,2,2,3,1,9,4,5,9
P'thinaikos,89,3,1,2,3,4,9,-5,5
Panionios,89,4,1,1,4,4,10,-6,4
AEK Athens,90,1,4,2,0,7,1,6,14
PAOK Salonik,90,2,2,3,1,10,5,5,9
P'thinaikos,90,3,1,2,3,5,10,-5,5
Panionios,90,4,1,1,4,4,10,-6,4
AEK Athens,91,1,4,2,0,7,1,6,14
PAOK Salonik,91,2,2,2,2,9,6,3,8
P'thinaikos,91,3,2,1,3,6,9,-3,7
Panionios,91,4,1,1,4,4,10,-6,4
AEK Athens,92,1,4,2,0,7,1,6,14
PAOK Salonik,92,2,2,2,2,9,5,4,8
P'thinaikos,92,3,2,1,3,5,9,-4,7
Panionios,92,4,1,1,4,4,10,-6,4
AEK Athens,93,1,4,2,0,7,1,6,14
PAOK Salonik,93,2,2,2,2,10,6,4,8
P'thinaikos,93,3,2,1,3,6,10,-4,7
Panionios,93,4,1,1,4,4,10,-6,4
AEK Athens,94,1,4,2,0,7,1,6,14
PAOK Salonik,94,2,2,2,2,9,5,4,8
P'thinaikos,94,3,2,1,3,5,9,-4,7
Panionios,94,4,1,1,4,4,10,-6,4
AEK Athens,95,1,4,2,0,7,1,6,14
PAOK Salonik,95,2,2,2,2,9,5,4,8
P'thinaikos,95,3,2,1,3,5,9,-4,7
Panionios,95,4,1,1,4,4,10,-6,4
AEK Athens,96,1,4,2,0,7,1,6,14
PAOK Salonik,96,2,2,3,1,9,4,5,9
P'thinaikos,96,3,1,2,3,4,9,-5,5
Panionios,96,4,1,1,4,4,10,-6,4
AEK Athens,97,1,4,2,0,7,1,6,14
PAOK Salonik,97,2,2,2,2,9,5,4,8
P'thinaikos,97,3,2,1,3,5,9,-4,7
Panionios,97,4,1,1,4,4,10,-6,4
AEK Athens,98,1,4,2,0,7,1,6,14
PAOK Salonik,98,2,2,3,1,10,5,5,9
P'thinaikos,98,3,1,2,3,5,10,-5,5
Panionios,98,4,1,1,4,4,10,-6,4
AEK Athens,99,1,4,2,0,7,1,6,14
PAOK Salonik,99,2,3,2,1,10,4,6,11
P'thinaikos,99,3,1,1,4,4,10,-6,4
Panionios,99,3,1,1,4,4,10,-6,4
AEK Athens,100,1,4,2,0,7,1,6,14
PAOK Salonik,100,2,2,2,2,10,7,3,8
P'thinaikos,100,3,2,1,3,7,10,-3,7
Panionios,100,4,1,1,4,4,10,-6,4
AEK Athens,101,1,4,2,0,7,1,6,14
PAOK Salonik,101,2,2,3,1,9,4,5,9
P'thinaikos,101,3,1,2,3,4,9,-5,5
Panionios,101,4,1,1,4,4,10,-6,4
AEK Athens,102,1,4,2,0,7,1,6,14
PAOK Salonik,102,2,2,3,1,9,4,5,9
P'thinaikos,102,3,1,2,3,4,9,-5,5
Panionios,102,4,1,1,4,4,10,-6,4
AEK Athens,103,1,4,2,0,7,1,6,14
PAOK Salonik,103,2,2,3,1,10,5,5,9
P'thinaikos,103,3,1,2,3,5,10,-5,5
Panionios,103,4,1,1,4,4,10,-6,4
AEK Athens,104,1,4,2,0,7,1,6,14
PAOK Salonik,104,2,2,2,2,10,7,3,8
P'thinaikos,104,3,2,1,3,7,10,-3,7
Panionios,104,4,1,1,4,4,10,-6,4
AEK Athens,105,1,4,2,0,7,1,6,14
PAOK Salonik,105,2,3,2,1,10,4,6,11
P'thinaikos,105,3,1,1,4,4,10,-6,4
Panionios,105,3,1,1,4,4,10,-6,4
AEK Athens,106,1,4,2,0,7,1,6,14
PAOK Salonik,106,2,2,2,2,9,5,4,8
P'thinaikos,106,3,2,1,3,5,9,-4,7
Panionios,106,4,1,1,4,4,10,-6,4
AEK Athens,107,1,4,2,0,7,1,6,14
PAOK Salonik,107,2,2,3,1,10,5,5,9
P'thinaikos,107,3,1,2,3,5,10,-5,5
Panionios,107,4,1,1,4,4,10,-6,4
AEK Athens,108,1,4,2,0,7,1,6,14
PAOK Salonik,108,2,2,3,1,9,4,5,9
P'thinaikos,108,3,1,2,3,4,9,-5,5
Panionios,108,4,1,1,4,4,10,-6,4
AEK Athens,109,1,4,2,0,7,1,6,14
PAOK Salonik,109,2,2,2,2,9,7,2,8
P'thinaikos,109,3,2,1,3,7,9,-2,7
Panionios,109,4,1,1,4,4,10,-6,4
AEK Athens,110,1,4,2,0,7,1,6,14
PAOK Salonik,110,2,2,2,2,10,6,4,8
P'thinaikos,110,3,2,1,3,6,10,-4,7
Panionios,110,4,1,1,4,4,10,-6,4
AEK Athens,111,1,4,2,0,7,1,6,14
PAOK Salonik,111,2,2,3,1,9,4,5,9
P'thinaikos,111,3,1,2,3,4,9,-5,5
Panionios,111,4,1,1,4,4,10,-6,4
AEK Athens,112,1,4,2,0,7,1,6,14
PAOK Salonik,112,2,3,2,1,10,4,6,11
P'thinaikos,112,3,1,1,4,4,10,-6,4
Panionios,112,3,1,1,4,4,10,-6,4
AEK Athens,113,1,4,2,0,7,1,6,14
PAOK Salonik,113,2,3,2,1,11,4,7,11
Panionios,113,3,1,1,4,4,10,-6,4
P'thinaikos,113,4,1,1,4,4,11,-7,4
AEK Athens,114,1,4,2,0,7,1,6,14
PAOK Salonik,114,2,2,3,1,10,5,5,9
P'thinaikos,114,3,1,2,3,5,10,-5,5
Panionios,114,4,1,1,4,4,10,-6,4
AEK Athens,115,1,4,2,0,7,1,6,14
PAOK Salonik,115,2,2,3,1,10,5,5,9
P'thinaikos,115,3,1,2,3,5,10,-5,5
Panionios,115,4,1,1,4,4,10,-6,4
AEK Athens,116,1,4,2,0,7,1,6,14
PAOK Salonik,116,2,3,2,1,11,5,6,11
P'thinaikos,116,3,1,1,4,5,11,-6,4
Panionios,116,4,1,1,4,4,10,-6,4
AEK Athens,117,1,4,2,0,7,1,6,14
PAOK Salonik,117,2,2,2,2,10,7,3,8
P'thinaikos,117,3,2,1,3,7,10,-3,7
Panionios,117,4,1,1,4,4,10,-6,4
AEK Athens,118,1,4,2,0,7,1,6,14
PAOK Salonik,118,2,3,2,1,12,6,6,11
P'thinaikos,118,3,1,1,4,6,12,-6,4
Panionios,118,4,1,1,4,4,10,-6,4
AEK Athens,119,1,4,2,0,7,1,6,14
PAOK Salonik,119,2,2,3,1,9,4,5,9
P'thinaikos,119,3,1,2,3,4,9,-5,5
Panionios,119,4,1,1,4,4,10,-6,4
AEK Athens,120,1,4,2,0,7,1,6,14
PAOK Salonik,120,2,2,2,2,9,6,3,8
P'thinaikos,120,3,2,1,3,6,9,-3,7
Panionios,120,4,1,1,4,4,10,-6,4
AEK Athens,121,1,4,2,0,7,1,6,14
PAOK Salonik,121,2,3,2,1,10,4,6,11
P'thinaikos,121,3,1,1,4,4,10,-6,4
Panionios,121,3,1,1,4,4,10,-6,4
AEK Athens,122,1,4,2,0,7,1,6,14
PAOK Salonik,122,2,2,3,1,9,4,5,9
P'thinaikos,122,3,1,2,3,4,9,-5,5
Panionios,122,4,1,1,4,4,10,-6,4
AEK Athens,123,1,4,2,0,7,1,6,14
PAOK Salonik,123,2,3,2,1,11,4,7,11
Panionios,123,3,1,1,4,4,10,-6,4
P'thinaikos,123,4,1,1,4,4,11,-7,4
AEK Athens,124,1,4,2,0,7,1,6,14
PAOK Salonik,124,2,2,3,1,11,6,5,9
P'thinaikos,124,3,1,2,3,6,11,-5,5
Panionios,124,4,1,1,4,4,10,-6,4
AEK Athens,125,1,4,2,0,7,1,6,14
PAOK Salonik,125,2,3,2,1,11,5,6,11
P'thinaikos,125,3,1,1,4,5,11,-6,4
Panionios,125,4,1,1,4,4,10,-6,4
AEK Athens,126,1,4,2,0,7,1,6,14
PAOK Salonik,126,2,2,3,1,10,5,5,9
P'thinaikos,126,3,1,2,3,5,10,-5,5
Panionios,126,4,1,1,4,4,10,-6,4
AEK Athens,127,1,4,2,0,7,1,6,14
PAOK Salonik,127,2,3,2,1,10,4,6,11
P'thinaikos,127,3,1,1,4,4,10,-6,4
Panionios,127,3,1,1,4,4,10,-6,4
AEK Athens,128,1,4,2,0,7,1,6,14
PAOK Salonik,128,2,3,2,1,10,4,6,11
P'thinaikos,128,3,1,1,4,4,10,-6,4
Panionios,128,3,1,1,4,4,10,-6,4
AEK Athens,129,1,4,2,0,7,1,6,14
PAOK Salonik,129,2,2,2,2,9,6,3,8
P'thinaikos,129,3,2,1,3,6,9,-3,7
Panionios,129,4,1,1,4,4,10,-6,4
AEK Athens,130,1,4,2,0,7,1,6,14
PAOK Salonik,130,2,3,2,1,11,4,7,11
Panionios,130,3,1,1,4,4,10,-6,4
P'thinaikos,130,4,1,1,4,4,11,-7,4
AEK Athens,131,1,4,2,0,7,1,6,14
PAOK Salonik,131,2,3,2,1,10,4,6,11
P'thinaikos,131,3,1,1,4,4,10,-6,4
Panionios,131,3,1,1,4,4,10,-6,4
AEK Athens,132,1,4,2,0,7,1,6,14
PAOK Salonik,132,2,2,2,2,9,5,4,8
P'thinaikos,132,3,2,1,3,5,9,-4,7
Panionios,132,4,1,1,4,4,10,-6,4
AEK Athens,133,1,4,2,0,7,1,6,14
PAOK Salonik,133,2,3,2,1,10,4,6,11
P'thinaikos,133,3,1,1,4,4,10,-6,4
Panionios,133,3,1,1,4,4,10,-6,4
AEK Athens,134,1,4,2,0,7,1,6,14
PAOK Salonik,134,2,2,2,2,9,5,4,8
P'thinaikos,134,3,2,1,3,5,9,-4,7
Panionios,134,4,1,1,4,4,10,-6,4
AEK Athens,135,1,4,2,0,7,1,6,14
PAOK Salonik,135,2,2,2,2,10,8,2,8
P'thinaikos,135,3,2,1,3,8,10,-2,7
Panionios,135,4,1,1,4,4,10,-6,4
AEK Athens,136,1,4,2,0,7,1,6,14
PAOK Salonik,136,2,2,3,1,9,4,5,9
P'thinaikos,136,3,1,2,3,4,9,-5,5
Panionios,136,4,1,1,4,4,10,-6,4
AEK Athens,137,1,4,2,0,7,1,6,14
PAOK Salonik,137,2,3,2,1,10,4,6,11
P'thinaikos,137,3,1,1,4,4,10,-6,4
Panionios,137,3,1,1,4,4,10,-6,4
AEK Athens,138,1,4,2,0,7,1,6,14
PAOK Salonik,138,2,2,3,1,10,5,5,9
P'thinaikos,138,3,1,2,3,5,10,-5,5
Panionios,138,4,1,1,4,4,10,-6,4
AEK Athens,139,1,4,2,0,7,1,6,14
PAOK Salonik,139,2,2,2,2,9,7,2,8
P'thinaikos,139,3,2,1,3,7,9,-2,7
Panionios,139,4,1,1,4,4,10,-6,4
AEK Athens,140,1,4,2,0,7,1,6,14
PAOK Salonik,140,2,3,2,1,11,4,7,11
Panionios,140,3,1,1,4,4,10,-6,4
P'thinaikos,140,4,1,1,4,4,11,-7,4
AEK Athens,141,1,4,2,0,7,1,6,14
PAOK Salonik,141,2,3,2,1,12,4,8,11
Panionios,141,3,1,1,4,4,10,-6,4
P'thinaikos,141,4,1,1,4,4,12,-8,4
AEK Athens,142,1,4,2,0,7,1,6,14
PAOK Salonik,142,2,2,2,2,9,5,4,8
P'thinaikos,142,3,2,1,3,5,9,-4,7
Panionios,142,4,1,1,4,4,10,-6,4
AEK Athens,143,1,4,2,0,7,1,6,14
PAOK Salonik,143,2,2,2,2,9,6,3,8
P'thinaikos,143,3,2,1,3,6,9,-3,7
Panionios,143,4,1,1,4,4,10,-6,4
AEK Athens,144,1,4,2,0,7,1,6,14
PAOK Salonik,144,2,3,2,1,12,5,7,11
Panionios,144,3,1,1,4,4,10,-6,4
P'thinaikos,144,4,1,1,4,5,12,-7,4
AEK Athens,145,1,4,2,0,7,1,6,14
PAOK Salonik,145,2,2,3,1,12,7,5,9
P'thinaikos,145,3,1,2,3,7,12,-5,5
Panionios,145,4,1,1,4,4,10,-6,4
AEK Athens,146,1,4,2,0,7,1,6,14
PAOK Salonik,146,2,3,2,1,11,5,6,11
P'thinaikos,146,3,1,1,4,5,11,-6,4
Panionios,146,4,1,1,4,4,10,-6,4
AEK Athens,147,1,4,2,0,7,1,6,14
PAOK Salonik,147,2,2,3,1,10,5,5,9
P'thinaikos,147,3,1,2,3,5,10,-5,5
Panionios,147,4,1,1,4,4,10,-6,4
AEK Athens,148,1,4,2,0,7,1,6,14
PAOK Salonik,148,2,3,2,1,10,4,6,11
P'thinaikos,148,3,1,1,4,4,10,-6,4
Panionios,148,3,1,1,4,4,10,-6,4
AEK Athens,149,1,4,2,0,7,1,6,14
PAOK Salonik,149,2,3,2,1,10,4,6,11
P'thinaikos,149,3,1,1,4,4,10,-6,4
Panionios,149,3,1,1,4,4,10,-6,4
AEK Athens,150,1,4,2,0,7,1,6,14
PAOK Salonik,150,2,2,3,1,10,5,5,9
P'thinaikos,150,3,1,2,3,5,10,-5,5
Panionios,150,4,1,1,4,4,10,-6,4
AEK Athens,151,1,4,2,0,7,1,6,14
PAOK Salonik,151,2,2,2,2,9,5,4,8
P'thinaikos,151,3,2,1,3,5,9,-4,7
Panionios,151,4,1,1,4,4,10,-6,4
AEK Athens,152,1,4,2,0,7,1,6,14
PAOK Salonik,152,2,2,2,2,10,6,4,8
P'thinaikos,152,3,2,1,3,6,10,-4,7
Panionios,152,4,1,1,4,4,10,-6,4
AEK Athens,153,1,4,2,0,7,1,6,14
PAOK Salonik,153,2,3,2,1,10,4,6,11
P'thinaikos,153,3,1,1,4,4,10,-6,4
Panionios,153,3,1,1,4,4,10,-6,4
AEK Athens,154,1,4,2,0,7,1,6,14
PAOK Salonik,154,2,2,2,2,9,6,3,8
P'thinaikos,154,3,2,1,3,6,9,-3,7
Panionios,154,4,1,1,4,4,10,-6,4
AEK Athens,155,1,4,2,0,7,1,6,14
PAOK Salonik,155,2,3,2,1,10,4,6,11
P'thinaikos,155,3,1,1,4,4,10,-6,4
Panionios,155,3,1,1,4,4,10,-6,4
AEK Athens,156,1,4,2,0,7,1,6,14
PAOK Salonik,156,2,2,2,2,9,7,2,8
P'thinaikos,156,3,2,1,3,7,9,-2,7
Panionios,156,4,1,1,4,4,10,-6,4
AEK Athens,157,1,4,2,0,7,1,6,14
PAOK Salonik,157,2,2,3,1,10,5,5,9
P'thinaikos,157,3,1,2,3,5,10,-5,5
Panionios,157,4,1,1,4,4,10,-6,4
AEK Athens,158,1,4,2,0,7,1,6,14
PAOK Salonik,158,2,3,2,1,11,4,7,11
Panionios,158,3,1,1,4,4,10,-6,4
P'thinaikos,158,4,1,1,4,4,11,-7,4
AEK Athens,159,1,4,2,0,7,1,6,14
PAOK Salonik,159,2,2,3,1,9,4,5,9
P'thinaikos,159,3,1,2,3,4,9,-5,5
Panionios,159,4,1,1,4,4,10,-6,4
AEK Athens,160,1,4,2,0,7,1,6,14
PAOK Salonik,160,2,3,2,1,12,4,8,11
Panionios,160,3,1,1,4,4,10,-6,4
P'thinaikos,160,4,1,1,4,4,12,-8,4
AEK Athens,161,1,4,2,0,7,1,6,14
PAOK Salonik,161,2,2,2,2,10,7,3,8
P'thinaikos,161,3,2,1,3,7,10,-3,7
Panionios,161,4,1,1,4,4,10,-6,4
AEK Athens,162,1,4,2,0,7,1,6,14
PAOK Salonik,162,2,3,2,1,11,5,6,11
P'thinaikos,162,3,1,1,4,5,11,-6,4
Panionios,162,4,1,1,4,4,10,-6,4
AEK Athens,163,1,4,2,0,7,1,6,14
PAOK Salonik,163,2,2,2,2,10,7,3,8
P'thinaikos,163,3,2,1,3,7,10,-3,7
Panionios,163,4,1,1,4,4,10,-6,4
AEK Athens,164,1,4,2,0,7,1,6,14
PAOK Salonik,164,2,2,2,2,11,7,4,8
P'thinaikos,164,3,2,1,3,7,11,-4,7
Panionios,164,4,1,1,4,4,10,-6,4
AEK Athens,165,1,4,2,0,7,1,6,14
PAOK Salonik,165,2,2,2,2,9,5,4,8
P'thinaikos,165,3,2,1,3,5,9,-4,7
Panionios,165,4,1,1,4,4,10,-6,4
AEK Athens,166,1,4,2,0,7,1,6,14
PAOK Salonik,166,2,2,2,2,9,6,3,8
P'thinaikos,166,3,2,1,3,6,9,-3,7
Panionios,166,4,1,1,4,4,10,-6,4
AEK Athens,167,1,4,2,0,7,1,6,14
PAOK Salonik,167,2,2,3,1,10,5,5,9
P'thinaikos,167,3,1,2,3,5,10,-5,5
Panionios,167,4,1,1,4,4,10,-6,4
AEK Athens,168,1,4,2,0,7,1,6,14
PAOK Salonik,168,2,2,2,2,9,5,4,8
P'thinaikos,168,3,2,1,3,5,9,-4,7
Panionios,168,4,1,1,4,4,10,-6,4
AEK Athens,169,1,4,2,0,7,1,6,14
PAOK Salonik,169,2,2,2,2,9,5,4,8
P'thinaikos,169,3,2,1,3,5,9,-4,7
Panionios,169,4,1,1,4,4,10,-6,4
AEK Athens,170,1,4,2,0,7,1,6,14
PAOK Salonik,170,2,2,3,1,10,5,5,9
P'thinaikos,170,3,1,2,3,5,10,-5,5
Panionios,170,4,1,1,4,4,10,-6,4
AEK Athens,171,1,4,2,0,7,1,6,14
PAOK Salonik,171,2,2,3,1,10,5,5,9
P'thinaikos,171,3,1,2,3,5,10,-5,5
Panionios,171,4,1,1,4,4,10,-6,4
AEK Athens,172,1,4,2,0,7,1,6,14
PAOK Salonik,172,2,3,2,1,10,4,6,11
P'thinaikos,172,3,1,1,4,4,10,-6,4
Panionios,172,3,1,1,4,4,10,-6,4
AEK Athens,173,1,4,2,0,7,1,6,14
PAOK Salonik,173,2,2,3,1,10,5,5,9
P'thinaikos,173,3,1,2,3,5,10,-5,5
Panionios,173,4,1,1,4,4,10,-6,4
AEK Athens,174,1,4,2,0,7,1,6,14
PAOK Salonik,174,2,3,2,1,11,5,6,11
P'thinaikos,174,3,1,1,4,5,11,-6,4
Panionios,174,4,1,1,4,4,10,-6,4
AEK Athens,175,1,4,2,0,7,1,6,14
PAOK Salonik,175,2,3,2,1,12,5,7,11
Panionios,175,3,1,1,4,4,10,-6,4
P'thinaikos,175,4,1,1,4,5,12,-7,4
AEK Athens,176,1,4,2,0,7,1,6,14
PAOK Salonik,176,2,2,3,1,11,6,5,9
P'thinaikos,176,3,1,2,3,6,11,-5,5
Panionios,176,4,1,1,4,4,10,-6,4
AEK Athens,177,1,4,2,0,7,1,6,14
PAOK Salonik,177,2,2,2,2,10,6,4,8
P'thinaikos,177,3,2,1,3,6,10,-4,7
Panionios,177,4,1,1,4,4,10,-6,4
AEK Athens,178,1,4,2,0,7,1,6,14
PAOK Salonik,178,2,2,3,1,11,6,5,9
P'thinaikos,178,3,1,2,3,6,11,-5,5
Panionios,178,4,1,1,4,4,10,-6,4
AEK Athens,179,1,4,2,0,7,1,6,14
PAOK Salonik,179,2,2,2,2,9,6,3,8
P'thinaikos,179,3,2,1,3,6,9,-3,7
Panionios,179,4,1,1,4,4,10,-6,4
AEK Athens,180,1,4,2,0,7,1,6,14
PAOK Salonik,180,2,2,2,2,10,7,3,8
P'thinaikos,180,3,2,1,3,7,10,-3,7
Panionios,180,4,1,1,4,4,10,-6,4
AEK Athens,181,1,4,2,0,7,1,6,14
PAOK Salonik,181,2,3,2,1,11,5,6,11
P'thinaikos,181,3,1,1,4,5,11,-6,4
Panionios,181,4,1,1,4,4,10,-6,4
AEK Athens,182,1,4,2,0,7,1,6,14
PAOK Salonik,182,2,2,2,2,9,7,2,8
P'thinaikos,182,3,2,1,3,7,9,-2,7
Panionios,182,4,1,1,4,4,10,-6,4
AEK Athens,183,1,4,2,0,7,1,6,14
PAOK Salonik,183,2,2,2,2,10,8,2,8
P'thinaikos,183,3,2,1,3,8,10,-2,7
Panionios,183,4,1,1,4,4,10,-6,4
AEK Athens,184,1,4,2,0,7,1,6,14
PAOK Salonik,184,2,2,2,2,11,7,4,8
P'thinaikos,184,3,2,1,3,7,11,-4,7
Panionios,184,4,1,1,4,4,10,-6,4
AEK Athens,185,1,4,2,0,7,1,6,14
PAOK Salonik,185,2,2,3,1,10,5,5,9
P'thinaikos,185,3,1,2,3,5,10,-5,5
Panionios,185,4,1,1,4,4,10,-6,4
AEK Athens,186,1,4,2,0,7,1,6,14
PAOK Salonik,186,2,2,2,2,13,9,4,8
P'thinaikos,186,3,2,1,3,9,13,-4,7
Panionios,186,4,1,1,4,4,10,-6,4
AEK Athens,187,1,4,2,0,7,1,6,14
PAOK Salonik,187,2,2,2,2,9,5,4,8
P'thinaikos,187,3,2,1,3,5,9,-4,7
Panionios,187,4,1,1,4,4,10,-6,4
AEK Athens,188,1,4,2,0,7,1,6,14
PAOK Salonik,188,2,3,2,1,10,4,6,11
P'thinaikos,188,3,1,1,4,4,10,-6,4
Panionios,188,3,1,1,4,4,10,-6,4
AEK Athens,189,1,4,2,0,7,1,6,14
PAOK Salonik,189,2,2,2,2,10,8,2,8
P'thinaikos,189,3,2,1,3,8,10,-2,7
Panionios,189,4,1,1,4,4,10,-6,4
AEK Athens,190,1,4,2,0,7,1,6,14
PAOK Salonik,190,2,2,3,1,10,5,5,9
P'thinaikos,190,3,1,2,3,5,10,-5,5
Panionios,190,4,1,1,4,4,10,-6,4
AEK Athens,191,1,4,2,0,7,1,6,14
PAOK Salonik,191,2,2,2,2,9,5,4,8
P'thinaikos,191,3,2,1,3,5,9,-4,7
Panionios,191,4,1,1,4,4,10,-6,4
AEK Athens,192,1,4,2,0,7,1,6,14
PAOK Salonik,192,2,2,2,2,9,5,4,8
P'thinaikos,192,3,2,1,3,5,9,-4,7
Panionios,192,4,1,1,4,4,10,-6,4
AEK Athens,193,1,4,2,0,7,1,6,14
PAOK Salonik,193,2,2,2,2,10,7,3,8
P'thinaikos,193,3,2,1,3,7,10,-3,7
Panionios,193,4,1,1,4,4,10,-6,4
AEK Athens,194,1,4,2,0,7,1,6,14
PAOK Salonik,194,2,2,2,2,9,7,2,8
P'thinaikos,194,3,2,1,3,7,9,-2,7
Panionios,194,4,1,1,4,4,10,-6,4
AEK Athens,195,1,4,2,0,7,1,6,14
PAOK Salonik,195,2,2,2,2,9,5,4,8
P'thinaikos,195,3,2,1,3,5,9,-4,7
Panionios,195,4,1,1,4,4,10,-6,4
AEK Athens,196,1,4,2,0,7,1,6,14
PAOK Salonik,196,2,3,2,1,11,5,6,11
P'thinaikos,196,3,1,1,4,5,11,-6,4
Panionios,196,4,1,1,4,4,10,-6,4
AEK Athens,197,1,4,2,0,7,1,6,14
PAOK Salonik,197,2,3,2,1,11,4,7,11
Panionios,197,3,1,1,4,4,10,-6,4
P'thinaikos,197,4,1,1,4,4,11,-7,4
AEK Athens,198,1,4,2,0,7,1,6,14
PAOK Salonik,198,2,2,2,2,10,6,4,8
P'thinaikos,198,3,2,1,3,6,10,-4,7
Panionios,198,4,1,1,4,4,10,-6,4
AEK Athens,199,1,4,2,0,7,1,6,14
PAOK Salonik,199,2,3,2,1,11,4,7,11
Panionios,199,3,1,1,4,4,10,-6,4
P'thinaikos,199,4,1,1,4,4,11,-7,4
AEK Athens,200,1,4,2,0,7,1,6,14
PAOK Salonik,200,2,2,2,2,9,6,3,8
P'thinaikos,200,3,2,1,3,6,9,-3,7
Panionios,200,4,1,1,4,4,10,-6,4
AEK Athens,201,1,4,2,0,7,1,6,14
PAOK Salonik,201,2,2,3,1,9,4,5,9
P'thinaikos,201,3,1,2,3,4,9,-5,5
Panionios,201,4,1,1,4,4,10,-6,4
AEK Athens,202,1,4,2,0,7,1,6,14
PAOK Salonik,202,2,2,3,1,10,5,5,9
P'thinaikos,202,3,1,2,3,5,10,-5,5
Panionios,202,4,1,1,4,4,10,-6,4
AEK Athens,203,1,4,2,0,7,1,6,14
PAOK Salonik,203,2,3,2,1,10,4,6,11
P'thinaikos,203,3,1,1,4,4,10,-6,4
Panionios,203,3,1,1,4,4,10,-6,4
AEK Athens,204,1,4,2,0,7,1,6,14
PAOK Salonik,204,2,3,2,1,11,5,6,11
P'thinaikos,204,3,1,1,4,5,11,-6,4
Panionios,204,4,1,1,4,4,10,-6,4
AEK Athens,205,1,4,2,0,7,1,6,14
PAOK Salonik,205,2,2,2,2,9,6,3,8
P'thinaikos,205,3,2,1,3,6,9,-3,7
Panionios,205,4,1,1,4,4,10,-6,4
AEK Athens,206,1,4,2,0,7,1,6,14
PAOK Salonik,206,2,2,2,2,10,8,2,8
P'thinaikos,206,3,2,1,3,8,10,-2,7
Panionios,206,4,1,1,4,4,10,-6,4
AEK Athens,207,1,4,2,0,7,1,6,14
PAOK Salonik,207,2,3,2,1,10,4,6,11
P'thinaikos,207,3,1,1,4,4,10,-6,4
Panionios,207,3,1,1,4,4,10,-6,4
AEK Athens,208,1,4,2,0,7,1,6,14
PAOK Salonik,208,2,2,2,2,9,7,2,8
P'thinaikos,208,3,2,1,3,7,9,-2,7
Panionios,208,4,1,1,4,4,10,-6,4
AEK Athens,209,1,4,2,0,7,1,6,14
PAOK Salonik,209,2,2,3,1,9,4,5,9
P'thinaikos,209,3,1,2,3,4,9,-5,5
Panionios,209,4,1,1,4,4,10,-6,4
AEK Athens,210,1,4,2,0,7,1,6,14
PAOK Salonik,210,2,2,3,1,10,5,5,9
P'thinaikos,210,3,1,2,3,5,10,-5,5
Panionios,210,4,1,1,4,4,10,-6,4
AEK Athens,211,1,4,2,0,7,1,6,14
PAOK Salonik,211,2,2,3,1,10,5,5,9
P'thinaikos,211,3,1,2,3,5,10,-5,5
Panionios,211,4,1,1,4,4,10,-6,4
AEK Athens,212,1,4,2,0,7,1,6,14
PAOK Salonik,212,2,2,3,1,11,6,5,9
P'thinaikos,212,3,1,2,3,6,11,-5,5
Panionios,212,4,1,1,4,4,10,-6,4
AEK Athens,213,1,4,2,0,7,1,6,14
PAOK Salonik,213,2,3,2,1,11,4,7,11
Panionios,213,3,1,1,4,4,10,-6,4
P'thinaikos,213,4,1,1,4,4,11,-7,4
AEK Athens,214,1,4,2,0,7,1,6,14
PAOK Salonik,214,2,2,3,1,9,4,5,9
P'thinaikos,214,3,1,2,3,4,9,-5,5
Panionios,214,4,1,1,4,4,10,-6,4
AEK Athens,215,1,4,2,0,7,1,6,14
PAOK Salonik,215,2,3,2,1,10,4,6,11
P'thinaikos,215,3,1,1,4,4,10,-6,4
Panionios,215,3,1,1,4,4,10,-6,4
AEK Athens,216,1,4,2,0,7,1,6,14
PAOK Salonik,216,2,3,2,1,10,4,6,11
P'thinaikos,216,3,1,1,4,4,10,-6,4
Panionios,216,3,1,1,4,4,10,-6,4
AEK Athens,217,1,4,2,0,7,1,6,14
PAOK Salonik,217,2,3,2,1,10,4,6,11
P'thinaikos,217,3,1,1,4,4,10,-6,4
Panionios,217,3,1,1,4,4,10,-6,4
AEK Athens,218,1,4,2,0,7,1,6,14
PAOK Salonik,218,2,2,2,2,10,6,4,8
P'thinaikos,218,3,2,1,3,6,10,-4,7
Panionios,218,4,1,1,4,4,10,-6,4
AEK Athens,219,1,4,2,0,7,1,6,14
PAOK Salonik,219,2,2,2,2,9,5,4,8
P'thinaikos,219,3,2,1,3,5,9,-4,7
Panionios,219,4,1,1,4,4,10,-6,4
AEK Athens,220,1,4,2,0,7,1,6,14
PAOK Salonik,220,2,2,3,1,9,4,5,9
P'thinaikos,220,3,1,2,3,4,9,-5,5
Panionios,220,4,1,1,4,4,10,-6,4
AEK Athens,221,1,4,2,0,7,1,6,14
PAOK Salonik,221,2,2,2,2,9,5,4,8
P'thinaikos,221,3,2,1,3,5,9,-4,7
Panionios,221,4,1,1,4,4,10,-6,4
AEK Athens,222,1,4,2,0,7,1,6,14
PAOK Salonik,222,2,2,2,2,9,5,4,8
P'thinaikos,222,3,2,1,3,5,9,-4,7
Panionios,222,4,1,1,4,4,10,-6,4
AEK Athens,223,1,4,2,0,7,1,6,14
PAOK Salonik,223,2,3,2,1,10,4,6,11
P'thinaikos,223,3,1,1,4,4,10,-6,4
Panionios,223,3,1,1,4,4,10,-6,4
AEK Athens,224,1,4,2,0,7,1,6,14
PAOK Salonik,224,2,3,2,1,11,4,7,11
Panionios,224,3,1,1,4,4,10,-6,4
P'thinaikos,224,4,1,1,4,4,11,-7,4
AEK Athens,225,1,4,2,0,7,1,6,14
PAOK Salonik,225,2,2,2,2,9,6,3,8
P'thinaikos,225,3,2,1,3,6,9,-3,7
Panionios,225,4,1,1,4,4,10,-6,4
AEK Athens,226,1,4,2,0,7,1,6,14
PAOK Salonik,226,2,2,2,2,9,6,3,8
P'thinaikos,226,3,2,1,3,6,9,-3,7
Panionios,226,4,1,1,4,4,10,-6,4
AEK Athens,227,1,4,2,0,7,1,6,14
PAOK Salonik,227,2,2,3,1,10,5,5,9
P'thinaikos,227,3,1,2,3,5,10,-5,5
Panionios,227,4,1,1,4,4,10,-6,4
AEK Athens,228,1,4,2,0,7,1,6,14
PAOK Salonik,228,2,2,2,2,10,6,4,8
P'thinaikos,228,3,2,1,3,6,10,-4,7
Panionios,228,4,1,1,4,4,10,-6,4
AEK Athens,229,1,4,2,0,7,1,6,14
PAOK Salonik,229,2,3,2,1,13,5,8,11
Panionios,229,3,1,1,4,4,10,-6,4
P'thinaikos,229,4,1,1,4,5,13,-8,4
AEK Athens,230,1,4,2,0,7,1,6,14
PAOK Salonik,230,2,2,2,2,9,6,3,8
P'thinaikos,230,3,2,1,3,6,9,-3,7
Panionios,230,4,1,1,4,4,10,-6,4
AEK Athens,231,1,4,2,0,7,1,6,14
PAOK Salonik,231,2,3,2,1,11,5,6,11
P'thinaikos,231,3,1,1,4,5,11,-6,4
Panionios,231,4,1,1,4,4,10,-6,4
AEK Athens,232,1,4,2,0,7,1,6,14
PAOK Salonik,232,2,2,3,1,9,4,5,9
P'thinaikos,232,3,1,2,3,4,9,-5,5
Panionios,232,4,1,1,4,4,10,-6,4
AEK Athens,233,1,4,2,0,7,1,6,14
PAOK Salonik,233,2,2,2,2,9,5,4,8
P'thinaikos,233,3,2,1,3,5,9,-4,7
Panionios,233,4,1,1,4,4,10,-6,4
AEK Athens,234,1,4,2,0,7,1,6,14
PAOK Salonik,234,2,3,2,1,10,4,6,11
P'thinaikos,234,3,1,1,4,4,10,-6,4
Panionios,234,3,1,1,4,4,10,-6,4
AEK Athens,235,1,4,2,0,7,1,6,14
PAOK Salonik,235,2,2,3,1,10,5,5,9
P'thinaikos,235,3,1,2,3,5,10,-5,5
Panionios,235,4,1,1,4,4,10,-6,4
AEK Athens,236,1,4,2,0,7,1,6,14
PAOK Salonik,236,2,3,2,1,11,5,6,11
P'thinaikos,236,3,1,1,4,5,11,-6,4
Panionios,236,4,1,1,4,4,10,-6,4
AEK Athens,237,1,4,2,0,7,1,6,14
PAOK Salonik,237,2,3,2,1,10,4,6,11
P'thinaikos,237,3,1,1,4,4,10,-6,4
Panionios,237,3,1,1,4,4,10,-6,4
AEK Athens,238,1,4,2,0,7,1,6,14
PAOK Salonik,238,2,3,2,1,10,4,6,11
P'thinaikos,238,3,1,1,4,4,10,-6,4
Panionios,238,3,1,1,4,4,10,-6,4
AEK Athens,239,1,4,2,0,7,1,6,14
PAOK Salonik,239,2,2,2,2,9,6,3,8
P'thinaikos,239,3,2,1,3,6,9,-3,7
Panionios,239,4,1,1,4,4,10,-6,4
AEK Athens,240,1,4,2,0,7,1,6,14
PAOK Salonik,240,2,2,3,1,11,6,5,9
P'thinaikos,240,3,1,2,3,6,11,-5,5
Panionios,240,4,1,1,4,4,10,-6,4
AEK Athens,241,1,4,2,0,7,1,6,14
PAOK Salonik,241,2,2,3,1,9,4,5,9
P'thinaikos,241,3,1,2,3,4,9,-5,5
Panionios,241,4,1,1,4,4,10,-6,4
AEK Athens,242,1,4,2,0,7,1,6,14
PAOK Salonik,242,2,3,2,1,11,4,7,11
Panionios,242,3,1,1,4,4,10,-6,4
P'thinaikos,242,4,1,1,4,4,11,-7,4
AEK Athens,243,1,4,2,0,7,1,6,14
PAOK Salonik,243,2,3,2,1,12,5,7,11
Panionios,243,3,1,1,4,4,10,-6,4
P'thinaikos,243,4,1,1,4,5,12,-7,4
AEK Athens,244,1,4,2,0,7,1,6,14
PAOK Salonik,244,2,2,2,2,9,5,4,8
P'thinaikos,244,3,2,1,3,5,9,-4,7
Panionios,244,4,1,1,4,4,10,-6,4
AEK Athens,245,1,4,2,0,7,1,6,14
PAOK Salonik,245,2,2,2,2,10,9,1,8
P'thinaikos,245,3,2,1,3,9,10,-1,7
Panionios,245,4,1,1,4,4,10,-6,4
AEK Athens,246,1,4,2,0,7,1,6,14
PAOK Salonik,246,2,2,2,2,9,6,3,8
P'thinaikos,246,3,2,1,3,6,9,-3,7
Panionios,246,4,1,1,4,4,10,-6,4
AEK Athens,247,1,4,2,0,7,1,6,14
PAOK Salonik,247,2,3,2,1,10,4,6,11
P'thinaikos,247,3,1,1,4,4,10,-6,4
Panionios,247,3,1,1,4,4,10,-6,4
AEK Athens,248,1,4,2,0,7,1,6,14
PAOK Salonik,248,2,3,2,1,12,4,8,11
Panionios,248,3,1,1,4,4,10,-6,4
P'thinaikos,248,4,1,1,4,4,12,-8,4
AEK Athens,249,1,4,2,0,7,1,6,14
PAOK Salonik,249,2,2,3,1,11,6,5,9
P'thinaikos,249,3,1,2,3,6,11,-5,5
Panionios,249,4,1,1,4,4,10,-6,4
AEK Athens,250,1,4,2,0,7,1,6,14
PAOK Salonik,250,2,2,3,1,10,5,5,9
P'thinaikos,250,3,1,2,3,5,10,-5,5
Panionios,250,4,1,1,4,4,10,-6,4
AEK Athens,251,1,4,2,0,7,1,6,14
PAOK Salonik,251,2,3,2,1,12,6,6,11
P'thinaikos,251,3,1,1,4,6,12,-6,4
Panionios,251,4,1,1,4,4,10,-6,4
AEK Athens,252,1,4,2,0,7,1,6,14
PAOK Salonik,252,2,3,2,1,11,5,6,11
P'thinaikos,252,3,1,1,4,5,11,-6,4
Panionios,252,4,1,1,4,4,10,-6,4
AEK Athens,253,1,4,2,0,7,1,6,14
PAOK Salonik,253,2,2,2,2,9,5,4,8
P'thinaikos,253,3,2,1,3,5,9,-4,7
Panionios,253,4,1,1,4,4,10,-6,4
AEK Athens,254,1,4,2,0,7,1,6,14
PAOK Salonik,254,2,3,2,1,10,4,6,11
P'thinaikos,254,3,1,1,4,4,10,-6,4
Panionios,254,3,1,1,4,4,10,-6,4
AEK Athens,255,1,4,2,0,7,1,6,14
PAOK Salonik,255,2,3,2,1,11,5,6,11
P'thinaikos,255,3,1,1,4,5,11,-6,4
Panionios,255,4,1,1,4,4,10,-6,4
AEK Athens,256,1,4,2,0,7,1,6,14
PAOK Salonik,256,2,2,2,2,10,6,4,8
P'thinaikos,256,3,2,1,3,6,10,-4,7
Panionios,256,4,1,1,4,4,10,-6,4
AEK Athens,257,1,4,2,0,7,1,6,14
PAOK Salonik,257,2,2,3,1,9,4,5,9
P'thinaikos,257,3,1,2,3,4,9,-5,5
Panionios,257,4,1,1,4,4,10,-6,4
AEK Athens,258,1,4,2,0,7,1,6,14
PAOK Salonik,258,2,3,2,1,10,4,6,11
P'thinaikos,258,3,1,1,4,4,10,-6,4
Panionios,258,3,1,1,4,4,10,-6,4
AEK Athens,259,1,4,2,0,7,1,6,14
PAOK Salonik,259,2,2,2,2,10,6,4,8
P'thinaikos,259,3,2,1,3,6,10,-4,7
Panionios,259,4,1,1,4,4,10,-6,4
AEK Athens,260,1,4,2,0,7,1,6,14
PAOK Salonik,260,2,2,3,1,10,5,5,9
P'thinaikos,260,3,1,2,3,5,10,-5,5
Panionios,260,4,1,1,4,4,10,-6,4
AEK Athens,261,1,4,2,0,7,1,6,14
PAOK Salonik,261,2,3,2,1,15,5,10,11
Panionios,261,3,1,1,4,4,10,-6,4
P'thinaikos,261,4,1,1,4,5,15,-10,4
AEK Athens,262,1,4,2,0,7,1,6,14
PAOK Salonik,262,2,2,3,1,14,9,5,9
P'thinaikos,262,3,1,2,3,9,14,-5,5
Panionios,262,4,1,1,4,4,10,-6,4
AEK Athens,263,1,4,2,0,7,1,6,14
PAOK Salonik,263,2,2,3,1,9,4,5,9
P'thinaikos,263,3,1,2,3,4,9,-5,5
Panionios,263,4,1,1,4,4,10,-6,4
AEK Athens,264,1,4,2,0,7,1,6,14
PAOK Salonik,264,2,2,3,1,11,6,5,9
P'thinaikos,264,3,1,2,3,6,11,-5,5
Panionios,264,4,1,1,4,4,10,-6,4
AEK Athens,265,1,4,2,0,7,1,6,14
PAOK Salonik,265,2,2,3,1,12,7,5,9
P'thinaikos,265,3,1,2,3,7,12,-5,5
Panionios,265,4,1,1,4,4,10,-6,4
AEK Athens,266,1,4,2,0,7,1,6,14
PAOK Salonik,266,2,3,2,1,11,5,6,11
P'thinaikos,266,3,1,1,4,5,11,-6,4
Panionios,266,4,1,1,4,4,10,-6,4
AEK Athens,267,1,4,2,0,7,1,6,14
PAOK Salonik,267,2,2,2,2,10,6,4,8
P'thinaikos,267,3,2,1,3,6,10,-4,7
Panionios,267,4,1,1,4,4,10,-6,4
AEK Athens,268,1,4,2,0,7,1,6,14
PAOK Salonik,268,2,2,3,1,11,6,5,9
P'thinaikos,268,3,1,2,3,6,11,-5,5
Panionios,268,4,1,1,4,4,10,-6,4
AEK Athens,269,1,4,2,0,7,1,6,14
PAOK Salonik,269,2,2,2,2,10,7,3,8
P'thinaikos,269,3,2,1,3,7,10,-3,7
Panionios,269,4,1,1,4,4,10,-6,4
AEK Athens,270,1,4,2,0,7,1,6,14
PAOK Salonik,270,2,2,3,1,9,4,5,9
P'thinaikos,270,3,1,2,3,4,9,-5,5
Panionios,270,4,1,1,4,4,10,-6,4
AEK Athens,271,1,4,2,0,7,1,6,14
PAOK Salonik,271,2,2,2,2,10,7,3,8
P'thinaikos,271,3,2,1,3,7,10,-3,7
Panionios,271,4,1,1,4,4,10,-6,4
AEK Athens,272,1,4,2,0,7,1,6,14
PAOK Salonik,272,2,3,2,1,10,4,6,11
P'thinaikos,272,3,1,1,4,4,10,-6,4
Panionios,272,3,1,1,4,4,10,-6,4
AEK Athens,273,1,4,2,0,7,1,6,14
PAOK Salonik,273,2,2,2,2,9,6,3,8
P'thinaikos,273,3,2,1,3,6,9,-3,7
Panionios,273,4,1,1,4,4,10,-6,4
AEK Athens,274,1,4,2,0,7,1,6,14
PAOK Salonik,274,2,3,2,1,11,5,6,11
P'thinaikos,274,3,1,1,4,5,11,-6,4
Panionios,274,4,1,1,4,4,10,-6,4
AEK Athens,275,1,4,2,0,7,1,6,14
PAOK Salonik,275,2,2,3,1,10,5,5,9
P'thinaikos,275,3,1,2,3,5,10,-5,5
Panionios,275,4,1,1,4,4,10,-6,4
AEK Athens,276,1,4,2,0,7,1,6,14
PAOK Salonik,276,2,2,2,2,9,7,2,8
P'thinaikos,276,3,2,1,3,7,9,-2,7
Panionios,276,4,1,1,4,4,10,-6,4
AEK Athens,277,1,4,2,0,7,1,6,14
PAOK Salonik,277,2,3,2,1,11,5,6,11
P'thinaikos,277,3,1,1,4,5,11,-6,4
Panionios,277,4,1,1,4,4,10,-6,4
AEK Athens,278,1,4,2,0,7,1,6,14
PAOK Salonik,278,2,3,2,1,10,4,6,11
P'thinaikos,278,3,1,1,4,4,10,-6,4
Panionios,278,3,1,1,4,4,10,-6,4
AEK Athens,279,1,4,2,0,7,1,6,14
PAOK Salonik,279,2,2,2,2,9,5,4,8
P'thinaikos,279,3,2,1,3,5,9,-4,7
Panionios,279,4,1,1,4,4,10,-6,4
AEK Athens,280,1,4,2,0,7,1,6,14
PAOK Salonik,280,2,3,2,1,11,4,7,11
Panionios,280,3,1,1,4,4,10,-6,4
P'thinaikos,280,4,1,1,4,4,11,-7,4
AEK Athens,281,1,4,2,0,7,1,6,14
PAOK Salonik,281,2,3,2,1,10,4,6,11
P'thinaikos,281,3,1,1,4,4,10,-6,4
Panionios,281,3,1,1,4,4,10,-6,4
AEK Athens,282,1,4,2,0,7,1,6,14
PAOK Salonik,282,2,2,3,1,10,5,5,9
P'thinaikos,282,3,1,2,3,5,10,-5,5
Panionios,282,4,1,1,4,4,10,-6,4
AEK Athens,283,1,4,2,0,7,1,6,14
PAOK Salonik,283,2,3,2,1,11,5,6,11
P'thinaikos,283,3,1,1,4,5,11,-6,4
Panionios,283,4,1,1,4,4,10,-6,4
AEK Athens,284,1,4,2,0,7,1,6,14
PAOK Salonik,284,2,3,2,1,11,5,6,11
P'thinaikos,284,3,1,1,4,5,11,-6,4
Panionios,284,4,1,1,4,4,10,-6,4
AEK Athens,285,1,4,2,0,7,1,6,14
PAOK Salonik,285,2,3,2,1,10,4,6,11
P'thinaikos,285,3,1,1,4,4,10,-6,4
Panionios,285,3,1,1,4,4,10,-6,4
AEK Athens,286,1,4,2,0,7,1,6,14
PAOK Salonik,286,2,2,2,2,9,6,3,8
P'thinaikos,286,3,2,1,3,6,9,-3,7
Panionios,286,4,1,1,4,4,10,-6,4
AEK Athens,287,1,4,2,0,7,1,6,14
PAOK Salonik,287,2,2,2,2,9,6,3,8
P'thinaikos,287,3,2,1,3,6,9,-3,7
Panionios,287,4,1,1,4,4,10,-6,4
AEK Athens,288,1,4,2,0,7,1,6,14
PAOK Salonik,288,2,2,2,2,9,6,3,8
P'thinaikos,288,3,2,1,3,6,9,-3,7
Panionios,288,4,1,1,4,4,10,-6,4
AEK Athens,289,1,4,2,0,7,1,6,14
PAOK Salonik,289,2,2,2,2,9,7,2,8
P'thinaikos,289,3,2,1,3,7,9,-2,7
Panionios,289,4,1,1,4,4,10,-6,4
AEK Athens,290,1,4,2,0,7,1,6,14
PAOK Salonik,290,2,2,2,2,11,8,3,8
P'thinaikos,290,3,2,1,3,8,11,-3,7
Panionios,290,4,1,1,4,4,10,-6,4
AEK Athens,291,1,4,2,0,7,1,6,14
PAOK Salonik,291,2,2,2,2,11,8,3,8
P'thinaikos,291,3,2,1,3,8,11,-3,7
Panionios,291,4,1,1,4,4,10,-6,4
AEK Athens,292,1,4,2,0,7,1,6,14
PAOK Salonik,292,2,2,3,1,9,4,5,9
P'thinaikos,292,3,1,2,3,4,9,-5,5
Panionios,292,4,1,1,4,4,10,-6,4
AEK Athens,293,1,4,2,0,7,1,6,14
PAOK Salonik,293,2,2,3,1,10,5,5,9
P'thinaikos,293,3,1,2,3,5,10,-5,5
Panionios,293,4,1,1,4,4,10,-6,4
AEK Athens,294,1,4,2,0,7,1,6,14
PAOK Salonik,294,2,2,2,2,9,5,4,8
P'thinaikos,294,3,2,1,3,5,9,-4,7
Panionios,294,4,1,1,4,4,10,-6,4
AEK Athens,295,1,4,2,0,7,1,6,14
PAOK Salonik,295,2,3,2,1,13,4,9,11
Panionios,295,3,1,1,4,4,10,-6,4
P'thinaikos,295,4,1,1,4,4,13,-9,4
AEK Athens,296,1,4,2,0,7,1,6,14
PAOK Salonik,296,2,2,2,2,9,6,3,8
P'thinaikos,296,3,2,1,3,6,9,-3,7
Panionios,296,4,1,1,4,4,10,-6,4
AEK Athens,297,1,4,2,0,7,1,6,14
PAOK Salonik,297,2,3,2,1,11,4,7,11
Panionios,297,3,1,1,4,4,10,-6,4
P'thinaikos,297,4,1,1,4,4,11,-7,4
AEK Athens,298,1,4,2,0,7,1,6,14
PAOK Salonik,298,2,2,3,1,9,4,5,9
P'thinaikos,298,3,1,2,3,4,9,-5,5
Panionios,298,4,1,1,4,4,10,-6,4
AEK Athens,299,1,4,2,0,7,1,6,14
PAOK Salonik,299,2,2,3,1,10,5,5,9
P'thinaikos,299,3,1,2,3,5,10,-5,5
Panionios,299,4,1,1,4,4,10,-6,4
AEK Athens,300,1,4,2,0,7,1,6,14
PAOK Salonik,300,2,3,2,1,10,4,6,11
P'thinaikos,300,3,1,1,4,4,10,-6,4
Panionios,300,3,1,1,4,4,10,-6,4
AEK Athens,301,1,4,2,0,7,1,6,14
PAOK Salonik,301,2,2,2,2,9,5,4,8
P'thinaikos,301,3,2,1,3,5,9,-4,7
Panionios,301,4,1,1,4,4,10,-6,4
AEK Athens,302,1,4,2,0,7,1,6,14
PAOK Salonik,302,2,2,3,1,9,4,5,9
P'thinaikos,302,3,1,2,3,4,9,-5,5
Panionios,302,4,1,1,4,4,10,-6,4
AEK Athens,303,1,4,2,0,7,1,6,14
PAOK Salonik,303,2,2,3,1,9,4,5,9
P'thinaikos,303,3,1,2,3,4,9,-5,5
Panionios,303,4,1,1,4,4,10,-6,4
AEK Athens,304,1,4,2,0,7,1,6,14
PAOK Salonik,304,2,3,2,1,11,4,7,11
Panionios,304,3,1,1,4,4,10,-6,4
P'thinaikos,304,4,1,1,4,4,11,-7,4
AEK Athens,305,1,4,2,0,7,1,6,14
PAOK Salonik,305,2,2,2,2,9,5,4,8
P'thinaikos,305,3,2,1,3,5,9,-4,7
Panionios,305,4,1,1,4,4,10,-6,4
AEK Athens,306,1,4,2,0,7,1,6,14
PAOK Salonik,306,2,3,2,1,11,4,7,11
Panionios,306,3,1,1,4,4,10,-6,4
P'thinaikos,306,4,1,1,4,4,11,-7,4
AEK Athens,307,1,4,2,0,7,1,6,14
PAOK Salonik,307,2,2,3,1,10,5,5,9
P'thinaikos,307,3,1,2,3,5,10,-5,5
Panionios,307,4,1,1,4,4,10,-6,4
AEK Athens,308,1,4,2,0,7,1,6,14
PAOK Salonik,308,2,3,2,1,10,4,6,11
P'thinaikos,308,3,1,1,4,4,10,-6,4
Panionios,308,3,1,1,4,4,10,-6,4
AEK Athens,309,1,4,2,0,7,1,6,14
PAOK Salonik,309,2,2,2,2,10,6,4,8
P'thinaikos,309,3,2,1,3,6,10,-4,7
Panionios,309,4,1,1,4,4,10,-6,4
AEK Athens,310,1,4,2,0,7,1,6,14
PAOK Salonik,310,2,3,2,1,12,4,8,11
Panionios,310,3,1,1,4,4,10,-6,4
P'thinaikos,310,4,1,1,4,4,12,-8,4
AEK Athens,311,1,4,2,0,7,1,6,14
PAOK Salonik,311,2,2,3,1,10,5,5,9
P'thinaikos,311,3,1,2,3,5,10,-5,5
Panionios,311,4,1,1,4,4,10,-6,4
AEK Athens,312,1,4,2,0,7,1,6,14
PAOK Salonik,312,2,2,3,1,10,5,5,9
P'thinaikos,312,3,1,2,3,5,10,-5,5
Panionios,312,4,1,1,4,4,10,-6,4
AEK Athens,313,1,4,2,0,7,1,6,14
PAOK Salonik,313,2,2,3,1,9,4,5,9
P'thinaikos,313,3,1,2,3,4,9,-5,5
Panionios,313,4,1,1,4,4,10,-6,4
AEK Athens,314,1,4,2,0,7,1,6,14
PAOK Salonik,314,2,2,2,2,9,5,4,8
P'thinaikos,314,3,2,1,3,5,9,-4,7
Panionios,314,4,1,1,4,4,10,-6,4
AEK Athens,315,1,4,2,0,7,1,6,14
PAOK Salonik,315,2,2,2,2,10,6,4,8
P'thinaikos,315,3,2,1,3,6,10,-4,7
Panionios,315,4,1,1,4,4,10,-6,4
AEK Athens,316,1,4,2,0,7,1,6,14
PAOK Salonik,316,2,2,2,2,9,6,3,8
P'thinaikos,316,3,2,1,3,6,9,-3,7
Panionios,316,4,1,1,4,4,10,-6,4
AEK Athens,317,1,4,2,0,7,1,6,14
PAOK Salonik,317,2,2,3,1,10,5,5,9
P'thinaikos,317,3,1,2,3,5,10,-5,5
Panionios,317,4,1,1,4,4,10,-6,4
AEK Athens,318,1,4,2,0,7,1,6,14
PAOK Salonik,318,2,2,2,2,10,6,4,8
P'thinaikos,318,3,2,1,3,6,10,-4,7
Panionios,318,4,1,1,4,4,10,-6,4
AEK Athens,319,1,4,2,0,7,1,6,14
PAOK Salonik,319,2,2,2,2,9,6,3,8
P'thinaikos,319,3,2,1,3,6,9,-3,7
Panionios,319,4,1,1,4,4,10,-6,4
AEK Athens,320,1,4,2,0,7,1,6,14
PAOK Salonik,320,2,2,2,2,9,5,4,8
P'thinaikos,320,3,2,1,3,5,9,-4,7
Panionios,320,4,1,1,4,4,10,-6,4
AEK Athens,321,1,4,2,0,7,1,6,14
PAOK Salonik,321,2,3,2,1,11,5,6,11
P'thinaikos,321,3,1,1,4,5,11,-6,4
Panionios,321,4,1,1,4,4,10,-6,4
AEK Athens,322,1,4,2,0,7,1,6,14
PAOK Salonik,322,2,3,2,1,13,5,8,11
Panionios,322,3,1,1,4,4,10,-6,4
P'thinaikos,322,4,1,1,4,5,13,-8,4
AEK Athens,323,1,4,2,0,7,1,6,14
PAOK Salonik,323,2,2,3,1,10,5,5,9
P'thinaikos,323,3,1,2,3,5,10,-5,5
Panionios,323,4,1,1,4,4,10,-6,4
AEK Athens,324,1,4,2,0,7,1,6,14
PAOK Salonik,324,2,2,3,1,10,5,5,9
P'thinaikos,324,3,1,2,3,5,10,-5,5
Panionios,324,4,1,1,4,4,10,-6,4
AEK Athens,325,1,4,2,0,7,1,6,14
PAOK Salonik,325,2,3,2,1,13,7,6,11
P'thinaikos,325,3,1,1,4,7,13,-6,4
Panionios,325,4,1,1,4,4,10,-6,4
AEK Athens,326,1,4,2,0,7,1,6,14
PAOK Salonik,326,2,2,3,1,10,5,5,9
P'thinaikos,326,3,1,2,3,5,10,-5,5
Panionios,326,4,1,1,4,4,10,-6,4
AEK Athens,327,1,4,2,0,7,1,6,14
PAOK Salonik,327,2,2,2,2,10,7,3,8
P'thinaikos,327,3,2,1,3,7,10,-3,7
Panionios,327,4,1,1,4,4,10,-6,4
AEK Athens,328,1,4,2,0,7,1,6,14
PAOK Salonik,328,2,2,3,1,10,5,5,9
P'thinaikos,328,3,1,2,3,5,10,-5,5
Panionios,328,4,1,1,4,4,10,-6,4
AEK Athens,329,1,4,2,0,7,1,6,14
PAOK Salonik,329,2,2,3,1,10,5,5,9
P'thinaikos,329,3,1,2,3,5,10,-5,5
Panionios,329,4,1,1,4,4,10,-6,4
AEK Athens,330,1,4,2,0,7,1,6,14
PAOK Salonik,330,2,2,3,1,10,5,5,9
P'thinaikos,330,3,1,2,3,5,10,-5,5
Panionios,330,4,1,1,4,4,10,-6,4
AEK Athens,331,1,4,2,0,7,1,6,14
PAOK Salonik,331,2,3,2,1,10,4,6,11
P'thinaikos,331,3,1,1,4,4,10,-6,4
Panionios,331,3,1,1,4,4,10,-6,4
AEK Athens,332,1,4,2,0,7,1,6,14
PAOK Salonik,332,2,2,3,1,10,5,5,9
P'thinaikos,332,3,1,2,3,5,10,-5,5
Panionios,332,4,1,1,4,4,10,-6,4
AEK Athens,333,1,4,2,0,7,1,6,14
PAOK Salonik,333,2,2,3,1,10,5,5,9
P'thinaikos,333,3,1,2,3,5,10,-5,5
Panionios,333,4,1,1,4,4,10,-6,4
AEK Athens,334,1,4,2,0,7,1,6,14
PAOK Salonik,334,2,2,2,2,10,7,3,8
P'thinaikos,334,3,2,1,3,7,10,-3,7
Panionios,334,4,1,1,4,4,10,-6,4
AEK Athens,335,1,4,2,0,7,1,6,14
PAOK Salonik,335,2,3,2,1,11,4,7,11
Panionios,335,3,1,1,4,4,10,-6,4
P'thinaikos,335,4,1,1,4,4,11,-7,4
AEK Athens,336,1,4,2,0,7,1,6,14
PAOK Salonik,336,2,2,2,2,11,7,4,8
P'thinaikos,336,3,2,1,3,7,11,-4,7
Panionios,336,4,1,1,4,4,10,-6,4
AEK Athens,337,1,4,2,0,7,1,6,14
PAOK Salonik,337,2,3,2,1,10,4,6,11
P'thinaikos,337,3,1,1,4,4,10,-6,4
Panionios,337,3,1,1,4,4,10,-6,4
AEK Athens,338,1,4,2,0,7,1,6,14
PAOK Salonik,338,2,2,2,2,9,6,3,8
P'thinaikos,338,3,2,1,3,6,9,-3,7
Panionios,338,4,1,1,4,4,10,-6,4
AEK Athens,339,1,4,2,0,7,1,6,14
PAOK Salonik,339,2,2,2,2,9,6,3,8
P'thinaikos,339,3,2,1,3,6,9,-3,7
Panionios,339,4,1,1,4,4,10,-6,4
AEK Athens,340,1,4,2,0,7,1,6,14
PAOK Salonik,340,2,3,2,1,10,4,6,11
P'thinaikos,340,3,1,1,4,4,10,-6,4
Panionios,340,3,1,1,4,4,10,-6,4
AEK Athens,341,1,4,2,0,7,1,6,14
PAOK Salonik,341,2,3,2,1,13,5,8,11
Panionios,341,3,1,1,4,4,10,-6,4
P'thinaikos,341,4,1,1,4,5,13,-8,4
AEK Athens,342,1,4,2,0,7,1,6,14
PAOK Salonik,342,2,2,2,2,10,7,3,8
P'thinaikos,342,3,2,1,3,7,10,-3,7
Panionios,342,4,1,1,4,4,10,-6,4
AEK Athens,343,1,4,2,0,7,1,6,14
PAOK Salonik,343,2,2,2,2,9,5,4,8
P'thinaikos,343,3,2,1,3,5,9,-4,7
Panionios,343,4,1,1,4,4,10,-6,4
AEK Athens,344,1,4,2,0,7,1,6,14
PAOK Salonik,344,2,2,2,2,9,5,4,8
P'thinaikos,344,3,2,1,3,5,9,-4,7
Panionios,344,4,1,1,4,4,10,-6,4
AEK Athens,345,1,4,2,0,7,1,6,14
PAOK Salonik,345,2,2,2,2,9,5,4,8
P'thinaikos,345,3,2,1,3,5,9,-4,7
Panionios,345,4,1,1,4,4,10,-6,4
AEK Athens,346,1,4,2,0,7,1,6,14
PAOK Salonik,346,2,2,2,2,9,7,2,8
P'thinaikos,346,3,2,1,3,7,9,-2,7
Panionios,346,4,1,1,4,4,10,-6,4
AEK Athens,347,1,4,2,0,7,1,6,14
PAOK Salonik,347,2,2,3,1,11,6,5,9
P'thinaikos,347,3,1,2,3,6,11,-5,5
Panionios,347,4,1,1,4,4,10,-6,4
AEK Athens,348,1,4,2,0,7,1,6,14
PAOK Salonik,348,2,2,3,1,11,6,5,9
P'thinaikos,348,3,1,2,3,6,11,-5,5
Panionios,348,4,1,1,4,4,10,-6,4
AEK Athens,349,1,4,2,0,7,1,6,14
PAOK Salonik,349,2,2,3,1,9,4,5,9
P'thinaikos,349,3,1,2,3,4,9,-5,5
Panionios,349,4,1,1,4,4,10,-6,4
AEK Athens,350,1,4,2,0,7,1,6,14
PAOK Salonik,350,2,2,2,2,10,6,4,8
P'thinaikos,350,3,2,1,3,6,10,-4,7
Panionios,350,4,1,1,4,4,10,-6,4
AEK Athens,351,1,4,2,0,7,1,6,14
PAOK Salonik,351,2,2,2,2,10,6,4,8
P'thinaikos,351,3,2,1,3,6,10,-4,7
Panionios,351,4,1,1,4,4,10,-6,4
AEK Athens,352,1,4,2,0,7,1,6,14
PAOK Salonik,352,2,2,3,1,10,5,5,9
P'thinaikos,352,3,1,2,3,5,10,-5,5
Panionios,352,4,1,1,4,4,10,-6,4
AEK Athens,353,1,4,2,0,7,1,6,14
PAOK Salonik,353,2,3,2,1,12,5,7,11
Panionios,353,3,1,1,4,4,10,-6,4
P'thinaikos,353,4,1,1,4,5,12,-7,4
AEK Athens,354,1,4,2,0,7,1,6,14
PAOK Salonik,354,2,2,3,1,9,4,5,9
P'thinaikos,354,3,1,2,3,4,9,-5,5
Panionios,354,4,1,1,4,4,10,-6,4
AEK Athens,355,1,4,2,0,7,1,6,14
PAOK Salonik,355,2,2,2,2,9,7,2,8
P'thinaikos,355,3,2,1,3,7,9,-2,7
Panionios,355,4,1,1,4,4,10,-6,4
AEK Athens,356,1,4,2,0,7,1,6,14
PAOK Salonik,356,2,3,2,1,12,5,7,11
Panionios,356,3,1,1,4,4,10,-6,4
P'thinaikos,356,4,1,1,4,5,12,-7,4
AEK Athens,357,1,4,2,0,7,1,6,14
PAOK Salonik,357,2,3,2,1,11,4,7,11
Panionios,357,3,1,1,4,4,10,-6,4
P'thinaikos,357,4,1,1,4,4,11,-7,4
AEK Athens,358,1,4,2,0,7,1,6,14
PAOK Salonik,358,2,2,2,2,9,5,4,8
P'thinaikos,358,3,2,1,3,5,9,-4,7
Panionios,358,4,1,1,4,4,10,-6,4
AEK Athens,359,1,4,2,0,7,1,6,14
PAOK Salonik,359,2,3,2,1,10,4,6,11
P'thinaikos,359,3,1,1,4,4,10,-6,4
Panionios,359,3,1,1,4,4,10,-6,4
AEK Athens,360,1,4,2,0,7,1,6,14
PAOK Salonik,360,2,3,2,1,12,4,8,11
Panionios,360,3,1,1,4,4,10,-6,4
P'thinaikos,360,4,1,1,4,4,12,-8,4
AEK Athens,361,1,4,2,0,7,1,6,14
PAOK Salonik,361,2,2,3,1,10,5,5,9
P'thinaikos,361,3,1,2,3,5,10,-5,5
Panionios,361,4,1,1,4,4,10,-6,4
AEK Athens,362,1,4,2,0,7,1,6,14
PAOK Salonik,362,2,2,2,2,10,6,4,8
P'thinaikos,362,3,2,1,3,6,10,-4,7
Panionios,362,4,1,1,4,4,10,-6,4
AEK Athens,363,1,4,2,0,7,1,6,14
PAOK Salonik,363,2,2,2,2,9,6,3,8
P'thinaikos,363,3,2,1,3,6,9,-3,7
Panionios,363,4,1,1,4,4,10,-6,4
AEK Athens,364,1,4,2,0,7,1,6,14
PAOK Salonik,364,2,3,2,1,12,5,7,11
Panionios,364,3,1,1,4,4,10,-6,4
P'thinaikos,364,4,1,1,4,5,12,-7,4
AEK Athens,365,1,4,2,0,7,1,6,14
PAOK Salonik,365,2,2,3,1,9,4,5,9
P'thinaikos,365,3,1,2,3,4,9,-5,5
Panionios,365,4,1,1,4,4,10,-6,4
AEK Athens,366,1,4,2,0,7,1,6,14
PAOK Salonik,366,2,3,2,1,11,5,6,11
P'thinaikos,366,3,1,1,4,5,11,-6,4
Panionios,366,4,1,1,4,4,10,-6,4
AEK Athens,367,1,4,2,0,7,1,6,14
PAOK Salonik,367,2,2,3,1,11,6,5,9
P'thinaikos,367,3,1,2,3,6,11,-5,5
Panionios,367,4,1,1,4,4,10,-6,4
AEK Athens,368,1,4,2,0,7,1,6,14
PAOK Salonik,368,2,2,2,2,10,7,3,8
P'thinaikos,368,3,2,1,3,7,10,-3,7
Panionios,368,4,1,1,4,4,10,-6,4
AEK Athens,369,1,4,2,0,7,1,6,14
PAOK Salonik,369,2,3,2,1,10,4,6,11
P'thinaikos,369,3,1,1,4,4,10,-6,4
Panionios,369,3,1,1,4,4,10,-6,4
AEK Athens,370,1,4,2,0,7,1,6,14
PAOK Salonik,370,2,3,2,1,11,5,6,11
P'thinaikos,370,3,1,1,4,5,11,-6,4
Panionios,370,4,1,1,4,4,10,-6,4
AEK Athens,371,1,4,2,0,7,1,6,14
PAOK Salonik,371,2,2,2,2,9,5,4,8
P'thinaikos,371,3,2,1,3,5,9,-4,7
Panionios,371,4,1,1,4,4,10,-6,4
AEK Athens,372,1,4,2,0,7,1,6,14
PAOK Salonik,372,2,2,2,2,9,6,3,8
P'thinaikos,372,3,2,1,3,6,9,-3,7
Panionios,372,4,1,1,4,4,10,-6,4
AEK Athens,373,1,4,2,0,7,1,6,14
PAOK Salonik,373,2,3,2,1,11,4,7,11
Panionios,373,3,1,1,4,4,10,-6,4
P'thinaikos,373,4,1,1,4,4,11,-7,4
AEK Athens,374,1,4,2,0,7,1,6,14
PAOK Salonik,374,2,2,3,1,10,5,5,9
P'thinaikos,374,3,1,2,3,5,10,-5,5
Panionios,374,4,1,1,4,4,10,-6,4
AEK Athens,375,1,4,2,0,7,1,6,14
PAOK Salonik,375,2,3,2,1,11,5,6,11
P'thinaikos,375,3,1,1,4,5,11,-6,4
Panionios,375,4,1,1,4,4,10,-6,4
AEK Athens,376,1,4,2,0,7,1,6,14
PAOK Salonik,376,2,2,2,2,9,6,3,8
P'thinaikos,376,3,2,1,3,6,9,-3,7
Panionios,376,4,1,1,4,4,10,-6,4
AEK Athens,377,1,4,2,0,7,1,6,14
PAOK Salonik,377,2,2,3,1,11,6,5,9
P'thinaikos,377,3,1,2,3,6,11,-5,5
Panionios,377,4,1,1,4,4,10,-6,4
AEK Athens,378,1,4,2,0,7,1,6,14
PAOK Salonik,378,2,3,2,1,10,4,6,11
P'thinaikos,378,3,1,1,4,4,10,-6,4
Panionios,378,3,1,1,4,4,10,-6,4
AEK Athens,379,1,4,2,0,7,1,6,14
PAOK Salonik,379,2,2,3,1,9,4,5,9
P'thinaikos,379,3,1,2,3,4,9,-5,5
Panionios,379,4,1,1,4,4,10,-6,4
AEK Athens,380,1,4,2,0,7,1,6,14
PAOK Salonik,380,2,2,2,2,11,8,3,8
P'thinaikos,380,3,2,1,3,8,11,-3,7
Panionios,380,4,1,1,4,4,10,-6,4
AEK Athens,381,1,4,2,0,7,1,6,14
PAOK Salonik,381,2,2,3,1,11,6,5,9
P'thinaikos,381,3,1,2,3,6,11,-5,5
Panionios,381,4,1,1,4,4,10,-6,4
AEK Athens,382,1,4,2,0,7,1,6,14
PAOK Salonik,382,2,2,2,2,10,9,1,8
P'thinaikos,382,3,2,1,3,9,10,-1,7
Panionios,382,4,1,1,4,4,10,-6,4
AEK Athens,383,1,4,2,0,7,1,6,14
PAOK Salonik,383,2,3,2,1,12,5,7,11
Panionios,383,3,1,1,4,4,10,-6,4
P'thinaikos,383,4,1,1,4,5,12,-7,4
AEK Athens,384,1,4,2,0,7,1,6,14
PAOK Salonik,384,2,2,2,2,9,5,4,8
P'thinaikos,384,3,2,1,3,5,9,-4,7
Panionios,384,4,1,1,4,4,10,-6,4
AEK Athens,385,1,4,2,0,7,1,6,14
PAOK Salonik,385,2,2,3,1,9,4,5,9
P'thinaikos,385,3,1,2,3,4,9,-5,5
Panionios,385,4,1,1,4,4,10,-6,4
AEK Athens,386,1,4,2,0,7,1,6,14
PAOK Salonik,386,2,2,3,1,9,4,5,9
P'thinaikos,386,3,1,2,3,4,9,-5,5
Panionios,386,4,1,1,4,4,10,-6,4
AEK Athens,387,1,4,2,0,7,1,6,14
PAOK Salonik,387,2,2,2,2,9,6,3,8
P'thinaikos,387,3,2,1,3,6,9,-3,7
Panionios,387,4,1,1,4,4,10,-6,4
AEK Athens,388,1,4,2,0,7,1,6,14
PAOK Salonik,388,2,2,2,2,10,6,4,8
P'thinaikos,388,3,2,1,3,6,10,-4,7
Panionios,388,4,1,1,4,4,10,-6,4
AEK Athens,389,1,4,2,0,7,1,6,14
PAOK Salonik,389,2,2,2,2,10,6,4,8
P'thinaikos,389,3,2,1,3,6,10,-4,7
Panionios,389,4,1,1,4,4,10,-6,4
AEK Athens,390,1,4,2,0,7,1,6,14
PAOK Salonik,390,2,2,3,1,10,5,5,9
P'thinaikos,390,3,1,2,3,5,10,-5,5
Panionios,390,4,1,1,4,4,10,-6,4
AEK Athens,391,1,4,2,0,7,1,6,14
PAOK Salonik,391,2,2,3,1,9,4,5,9
P'thinaikos,391,3,1,2,3,4,9,-5,5
Panionios,391,4,1,1,4,4,10,-6,4
AEK Athens,392,1,4,2,0,7,1,6,14
PAOK Salonik,392,2,2,2,2,10,8,2,8
P'thinaikos,392,3,2,1,3,8,10,-2,7
Panionios,392,4,1,1,4,4,10,-6,4
AEK Athens,393,1,4,2,0,7,1,6,14
PAOK Salonik,393,2,2,2,2,10,7,3,8
P'thinaikos,393,3,2,1,3,7,10,-3,7
Panionios,393,4,1,1,4,4,10,-6,4
AEK Athens,394,1,4,2,0,7,1,6,14
PAOK Salonik,394,2,2,3,1,10,5,5,9
P'thinaikos,394,3,1,2,3,5,10,-5,5
Panionios,394,4,1,1,4,4,10,-6,4
AEK Athens,395,1,4,2,0,7,1,6,14
PAOK Salonik,395,2,3,2,1,12,4,8,11
Panionios,395,3,1,1,4,4,10,-6,4
P'thinaikos,395,4,1,1,4,4,12,-8,4
AEK Athens,396,1,4,2,0,7,1,6,14
PAOK Salonik,396,2,2,2,2,9,7,2,8
P'thinaikos,396,3,2,1,3,7,9,-2,7
Panionios,396,4,1,1,4,4,10,-6,4
AEK Athens,397,1,4,2,0,7,1,6,14
PAOK Salonik,397,2,3,2,1,11,5,6,11
P'thinaikos,397,3,1,1,4,5,11,-6,4
Panionios,397,4,1,1,4,4,10,-6,4
AEK Athens,398,1,4,2,0,7,1,6,14
PAOK Salonik,398,2,2,2,2,9,11,-2,8
P'thinaikos,398,3,2,1,3,11,9,2,7
Panionios,398,4,1,1,4,4,10,-6,4
AEK Athens,399,1,4,2,0,7,1,6,14
PAOK Salonik,399,2,2,2,2,9,5,4,8
P'thinaikos,399,3,2,1,3,5,9,-4,7
Panionios,399,4,1,1,4,4,10,-6,4
AEK Athens,400,1,4,2,0,7,1,6,14
PAOK Salonik,400,2,2,3,1,10,5,5,9
P'thinaikos,400,3,1,2,3,5,10,-5,5
Panionios,400,4,1,1,4,4,10,-6,4
AEK Athens,401,1,4,2,0,7,1,6,14
PAOK Salonik,401,2,2,2,2,10,6,4,8
P'thinaikos,401,3,2,1,3,6,10,-4,7
Panionios,401,4,1,1,4,4,10,-6,4
AEK Athens,402,1,4,2,0,7,1,6,14
PAOK Salonik,402,2,3,2,1,10,4,6,11
P'thinaikos,402,3,1,1,4,4,10,-6,4
Panionios,402,3,1,1,4,4,10,-6,4
AEK Athens,403,1,4,2,0,7,1,6,14
PAOK Salonik,403,2,3,2,1,10,4,6,11
P'thinaikos,403,3,1,1,4,4,10,-6,4
Panionios,403,3,1,1,4,4,10,-6,4
AEK Athens,404,1,4,2,0,7,1,6,14
PAOK Salonik,404,2,2,2,2,10,6,4,8
P'thinaikos,404,3,2,1,3,6,10,-4,7
Panionios,404,4,1,1,4,4,10,-6,4
AEK Athens,405,1,4,2,0,7,1,6,14
PAOK Salonik,405,2,3,2,1,13,7,6,11
P'thinaikos,405,3,1,1,4,7,13,-6,4
Panionios,405,4,1,1,4,4,10,-6,4
AEK Athens,406,1,4,2,0,7,1,6,14
PAOK Salonik,406,2,2,2,2,9,7,2,8
P'thinaikos,406,3,2,1,3,7,9,-2,7
Panionios,406,4,1,1,4,4,10,-6,4
AEK Athens,407,1,4,2,0,7,1,6,14
PAOK Salonik,407,2,2,3,1,10,5,5,9
P'thinaikos,407,3,1,2,3,5,10,-5,5
Panionios,407,4,1,1,4,4,10,-6,4
AEK Athens,408,1,4,2,0,7,1,6,14
PAOK Salonik,408,2,2,2,2,9,5,4,8
P'thinaikos,408,3,2,1,3,5,9,-4,7
Panionios,408,4,1,1,4,4,10,-6,4
AEK Athens,409,1,4,2,0,7,1,6,14
PAOK Salonik,409,2,2,3,1,10,5,5,9
P'thinaikos,409,3,1,2,3,5,10,-5,5
Panionios,409,4,1,1,4,4,10,-6,4
AEK Athens,410,1,4,2,0,7,1,6,14
PAOK Salonik,410,2,2,3,1,10,5,5,9
P'thinaikos,410,3,1,2,3,5,10,-5,5
Panionios,410,4,1,1,4,4,10,-6,4
AEK Athens,411,1,4,2,0,7,1,6,14
PAOK Salonik,411,2,3,2,1,11,4,7,11
Panionios,411,3,1,1,4,4,10,-6,4
P'thinaikos,411,4,1,1,4,4,11,-7,4
AEK Athens,412,1,4,2,0,7,1,6,14
PAOK Salonik,412,2,3,2,1,12,5,7,11
Panionios,412,3,1,1,4,4,10,-6,4
P'thinaikos,412,4,1,1,4,5,12,-7,4
AEK Athens,413,1,4,2,0,7,1,6,14
PAOK Salonik,413,2,2,3,1,9,4,5,9
P'thinaikos,413,3,1,2,3,4,9,-5,5
Panionios,413,4,1,1,4,4,10,-6,4
AEK Athens,414,1,4,2,0,7,1,6,14
PAOK Salonik,414,2,3,2,1,13,5,8,11
Panionios,414,3,1,1,4,4,10,-6,4
P'thinaikos,414,4,1,1,4,5,13,-8,4
AEK Athens,415,1,4,2,0,7,1,6,14
PAOK Salonik,415,2,2,2,2,9,5,4,8
P'thinaikos,415,3,2,1,3,5,9,-4,7
Panionios,415,4,1,1,4,4,10,-6,4
AEK Athens,416,1,4,2,0,7,1,6,14
PAOK Salonik,416,2,2,2,2,9,7,2,8
P'thinaikos,416,3,2,1,3,7,9,-2,7
Panionios,416,4,1,1,4,4,10,-6,4
AEK Athens,417,1,4,2,0,7,1,6,14
PAOK Salonik,417,2,2,3,1,11,6,5,9
P'thinaikos,417,3,1,2,3,6,11,-5,5
Panionios,417,4,1,1,4,4,10,-6,4
AEK Athens,418,1,4,2,0,7,1,6,14
PAOK Salonik,418,2,3,2,1,11,5,6,11
P'thinaikos,418,3,1,1,4,5,11,-6,4
Panionios,418,4,1,1,4,4,10,-6,4
AEK Athens,419,1,4,2,0,7,1,6,14
PAOK Salonik,419,2,3,2,1,10,4,6,11
P'thinaikos,419,3,1,1,4,4,10,-6,4
Panionios,419,3,1,1,4,4,10,-6,4
AEK Athens,420,1,4,2,0,7,1,6,14
PAOK Salonik,420,2,2,2,2,10,7,3,8
P'thinaikos,420,3,2,1,3,7,10,-3,7
Panionios,420,4,1,1,4,4,10,-6,4
AEK Athens,421,1,4,2,0,7,1,6,14
PAOK Salonik,421,2,2,2,2,9,5,4,8
P'thinaikos,421,3,2,1,3,5,9,-4,7
Panionios,421,4,1,1,4,4,10,-6,4
AEK Athens,422,1,4,2,0,7,1,6,14
PAOK Salonik,422,2,2,2,2,10,6,4,8
P'thinaikos,422,3,2,1,3,6,10,-4,7
Panionios,422,4,1,1,4,4,10,-6,4
AEK Athens,423,1,4,2,0,7,1,6,14
PAOK Salonik,423,2,3,2,1,12,5,7,11
Panionios,423,3,1,1,4,4,10,-6,4
P'thinaikos,423,4,1,1,4,5,12,-7,4
AEK Athens,424,1,4,2,0,7,1,6,14
PAOK Salonik,424,2,2,3,1,10,5,5,9
P'thinaikos,424,3,1,2,3,5,10,-5,5
Panionios,424,4,1,1,4,4,10,-6,4
AEK Athens,425,1,4,2,0,7,1,6,14
PAOK Salonik,425,2,3,2,1,11,5,6,11
P'thinaikos,425,3,1,1,4,5,11,-6,4
Panionios,425,4,1,1,4,4,10,-6,4
AEK Athens,426,1,4,2,0,7,1,6,14
PAOK Salonik,426,2,2,2,2,9,5,4,8
P'thinaikos,426,3,2,1,3,5,9,-4,7
Panionios,426,4,1,1,4,4,10,-6,4
AEK Athens,427,1,4,2,0,7,1,6,14
PAOK Salonik,427,2,3,2,1,10,4,6,11
P'thinaikos,427,3,1,1,4,4,10,-6,4
Panionios,427,3,1,1,4,4,10,-6,4
AEK Athens,428,1,4,2,0,7,1,6,14
PAOK Salonik,428,2,2,2,2,9,6,3,8
P'thinaikos,428,3,2,1,3,6,9,-3,7
Panionios,428,4,1,1,4,4,10,-6,4
AEK Athens,429,1,4,2,0,7,1,6,14
PAOK Salonik,429,2,2,2,2,9,6,3,8
P'thinaikos,429,3,2,1,3,6,9,-3,7
Panionios,429,4,1,1,4,4,10,-6,4
AEK Athens,430,1,4,2,0,7,1,6,14
PAOK Salonik,430,2,3,2,1,11,5,6,11
P'thinaikos,430,3,1,1,4,5,11,-6,4
Panionios,430,4,1,1,4,4,10,-6,4
AEK Athens,431,1,4,2,0,7,1,6,14
PAOK Salonik,431,2,2,3,1,10,5,5,9
P'thinaikos,431,3,1,2,3,5,10,-5,5
Panionios,431,4,1,1,4,4,10,-6,4
AEK Athens,432,1,4,2,0,7,1,6,14
PAOK Salonik,432,2,2,2,2,9,5,4,8
P'thinaikos,432,3,2,1,3,5,9,-4,7
Panionios,432,4,1,1,4,4,10,-6,4
AEK Athens,433,1,4,2,0,7,1,6,14
PAOK Salonik,433,2,2,2,2,10,6,4,8
P'thinaikos,433,3,2,1,3,6,10,-4,7
Panionios,433,4,1,1,4,4,10,-6,4
AEK Athens,434,1,4,2,0,7,1,6,14
PAOK Salonik,434,2,2,2,2,9,6,3,8
P'thinaikos,434,3,2,1,3,6,9,-3,7
Panionios,434,4,1,1,4,4,10,-6,4
AEK Athens,435,1,4,2,0,7,1,6,14
PAOK Salonik,435,2,2,2,2,9,6,3,8
P'thinaikos,435,3,2,1,3,6,9,-3,7
Panionios,435,4,1,1,4,4,10,-6,4
AEK Athens,436,1,4,2,0,7,1,6,14
PAOK Salonik,436,2,2,2,2,9,5,4,8
P'thinaikos,436,3,2,1,3,5,9,-4,7
Panionios,436,4,1,1,4,4,10,-6,4
AEK Athens,437,1,4,2,0,7,1,6,14
PAOK Salonik,437,2,3,2,1,10,4,6,11
P'thinaikos,437,3,1,1,4,4,10,-6,4
Panionios,437,3,1,1,4,4,10,-6,4
AEK Athens,438,1,4,2,0,7,1,6,14
PAOK Salonik,438,2,3,2,1,10,4,6,11
P'thinaikos,438,3,1,1,4,4,10,-6,4
Panionios,438,3,1,1,4,4,10,-6,4
AEK Athens,439,1,4,2,0,7,1,6,14
PAOK Salonik,439,2,3,2,1,11,4,7,11
Panionios,439,3,1,1,4,4,10,-6,4
P'thinaikos,439,4,1,1,4,4,11,-7,4
AEK Athens,440,1,4,2,0,7,1,6,14
PAOK Salonik,440,2,3,2,1,11,5,6,11
P'thinaikos,440,3,1,1,4,5,11,-6,4
Panionios,440,4,1,1,4,4,10,-6,4
AEK Athens,441,1,4,2,0,7,1,6,14
PAOK Salonik,441,2,2,2,2,9,5,4,8
P'thinaikos,441,3,2,1,3,5,9,-4,7
Panionios,441,4,1,1,4,4,10,-6,4
AEK Athens,442,1,4,2,0,7,1,6,14
PAOK Salonik,442,2,3,2,1,12,5,7,11
Panionios,442,3,1,1,4,4,10,-6,4
P'thinaikos,442,4,1,1,4,5,12,-7,4
AEK Athens,443,1,4,2,0,7,1,6,14
PAOK Salonik,443,2,2,2,2,11,7,4,8
P'thinaikos,443,3,2,1,3,7,11,-4,7
Panionios,443,4,1,1,4,4,10,-6,4
AEK Athens,444,1,4,2,0,7,1,6,14
PAOK Salonik,444,2,3,2,1,11,4,7,11
Panionios,444,3,1,1,4,4,10,-6,4
P'thinaikos,444,4,1,1,4,4,11,-7,4
AEK Athens,445,1,4,2,0,7,1,6,14
PAOK Salonik,445,2,2,3,1,9,4,5,9
P'thinaikos,445,3,1,2,3,4,9,-5,5
Panionios,445,4,1,1,4,4,10,-6,4
AEK Athens,446,1,4,2,0,7,1,6,14
PAOK Salonik,446,2,2,2,2,9,5,4,8
P'thinaikos,446,3,2,1,3,5,9,-4,7
Panionios,446,4,1,1,4,4,10,-6,4
AEK Athens,447,1,4,2,0,7,1,6,14
PAOK Salonik,447,2,2,3,1,10,5,5,9
P'thinaikos,447,3,1,2,3,5,10,-5,5
Panionios,447,4,1,1,4,4,10,-6,4
AEK Athens,448,1,4,2,0,7,1,6,14
PAOK Salonik,448,2,3,2,1,10,4,6,11
P'thinaikos,448,3,1,1,4,4,10,-6,4
Panionios,448,3,1,1,4,4,10,-6,4
AEK Athens,449,1,4,2,0,7,1,6,14
PAOK Salonik,449,2,3,2,1,11,5,6,11
P'thinaikos,449,3,1,1,4,5,11,-6,4
Panionios,449,4,1,1,4,4,10,-6,4
AEK Athens,450,1,4,2,0,7,1,6,14
PAOK Salonik,450,2,2,3,1,11,6,5,9
P'thinaikos,450,3,1,2,3,6,11,-5,5
Panionios,450,4,1,1,4,4,10,-6,4
AEK Athens,451,1,4,2,0,7,1,6,14
PAOK Salonik,451,2,2,2,2,10,6,4,8
P'thinaikos,451,3,2,1,3,6,10,-4,7
Panionios,451,4,1,1,4,4,10,-6,4
AEK Athens,452,1,4,2,0,7,1,6,14
PAOK Salonik,452,2,3,2,1,11,4,7,11
Panionios,452,3,1,1,4,4,10,-6,4
P'thinaikos,452,4,1,1,4,4,11,-7,4
AEK Athens,453,1,4,2,0,7,1,6,14
PAOK Salonik,453,2,2,3,1,9,4,5,9
P'thinaikos,453,3,1,2,3,4,9,-5,5
Panionios,453,4,1,1,4,4,10,-6,4
AEK Athens,454,1,4,2,0,7,1,6,14
PAOK Salonik,454,2,3,2,1,11,5,6,11
P'thinaikos,454,3,1,1,4,5,11,-6,4
Panionios,454,4,1,1,4,4,10,-6,4
AEK Athens,455,1,4,2,0,7,1,6,14
PAOK Salonik,455,2,3,2,1,12,5,7,11
Panionios,455,3,1,1,4,4,10,-6,4
P'thinaikos,455,4,1,1,4,5,12,-7,4
AEK Athens,456,1,4,2,0,7,1,6,14
PAOK Salonik,456,2,2,2,2,9,5,4,8
P'thinaikos,456,3,2,1,3,5,9,-4,7
Panionios,456,4,1,1,4,4,10,-6,4
AEK Athens,457,1,4,2,0,7,1,6,14
PAOK Salonik,457,2,2,2,2,11,8,3,8
P'thinaikos,457,3,2,1,3,8,11,-3,7
Panionios,457,4,1,1,4,4,10,-6,4
AEK Athens,458,1,4,2,0,7,1,6,14
PAOK Salonik,458,2,3,2,1,10,4,6,11
P'thinaikos,458,3,1,1,4,4,10,-6,4
Panionios,458,3,1,1,4,4,10,-6,4
AEK Athens,459,1,4,2,0,7,1,6,14
PAOK Salonik,459,2,2,2,2,10,7,3,8
P'thinaikos,459,3,2,1,3,7,10,-3,7
Panionios,459,4,1,1,4,4,10,-6,4
AEK Athens,460,1,4,2,0,7,1,6,14
PAOK Salonik,460,2,3,2,1,11,5,6,11
P'thinaikos,460,3,1,1,4,5,11,-6,4
Panionios,460,4,1,1,4,4,10,-6,4
AEK Athens,461,1,4,2,0,7,1,6,14
PAOK Salonik,461,2,3,2,1,11,5,6,11
P'thinaikos,461,3,1,1,4,5,11,-6,4
Panionios,461,4,1,1,4,4,10,-6,4
AEK Athens,462,1,4,2,0,7,1,6,14
PAOK Salonik,462,2,3,2,1,11,4,7,11
Panionios,462,3,1,1,4,4,10,-6,4
P'thinaikos,462,4,1,1,4,4,11,-7,4
AEK Athens,463,1,4,2,0,7,1,6,14
PAOK Salonik,463,2,3,2,1,12,5,7,11
Panionios,463,3,1,1,4,4,10,-6,4
P'thinaikos,463,4,1,1,4,5,12,-7,4
AEK Athens,464,1,4,2,0,7,1,6,14
PAOK Salonik,464,2,2,2,2,9,5,4,8
P'thinaikos,464,3,2,1,3,5,9,-4,7
Panionios,464,4,1,1,4,4,10,-6,4
AEK Athens,465,1,4,2,0,7,1,6,14
PAOK Salonik,465,2,3,2,1,11,5,6,11
P'thinaikos,465,3,1,1,4,5,11,-6,4
Panionios,465,4,1,1,4,4,10,-6,4
AEK Athens,466,1,4,2,0,7,1,6,14
PAOK Salonik,466,2,3,2,1,11,4,7,11
Panionios,466,3,1,1,4,4,10,-6,4
P'thinaikos,466,4,1,1,4,4,11,-7,4
AEK Athens,467,1,4,2,0,7,1,6,14
PAOK Salonik,467,2,2,3,1,10,5,5,9
P'thinaikos,467,3,1,2,3,5,10,-5,5
Panionios,467,4,1,1,4,4,10,-6,4
AEK Athens,468,1,4,2,0,7,1,6,14
PAOK Salonik,468,2,3,2,1,11,5,6,11
P'thinaikos,468,3,1,1,4,5,11,-6,4
Panionios,468,4,1,1,4,4,10,-6,4
AEK Athens,469,1,4,2,0,7,1,6,14
PAOK Salonik,469,2,2,3,1,9,4,5,9
P'thinaikos,469,3,1,2,3,4,9,-5,5
Panionios,469,4,1,1,4,4,10,-6,4
AEK Athens,470,1,4,2,0,7,1,6,14
PAOK Salonik,470,2,2,3,1,9,4,5,9
P'thinaikos,470,3,1,2,3,4,9,-5,5
Panionios,470,4,1,1,4,4,10,-6,4
AEK Athens,471,1,4,2,0,7,1,6,14
PAOK Salonik,471,2,3,2,1,10,4,6,11
P'thinaikos,471,3,1,1,4,4,10,-6,4
Panionios,471,3,1,1,4,4,10,-6,4
AEK Athens,472,1,4,2,0,7,1,6,14
PAOK Salonik,472,2,3,2,1,10,4,6,11
P'thinaikos,472,3,1,1,4,4,10,-6,4
Panionios,472,3,1,1,4,4,10,-6,4
AEK Athens,473,1,4,2,0,7,1,6,14
PAOK Salonik,473,2,2,3,1,9,4,5,9
P'thinaikos,473,3,1,2,3,4,9,-5,5
Panionios,473,4,1,1,4,4,10,-6,4
AEK Athens,474,1,4,2,0,7,1,6,14
PAOK Salonik,474,2,3,2,1,11,4,7,11
Panionios,474,3,1,1,4,4,10,-6,4
P'thinaikos,474,4,1,1,4,4,11,-7,4
AEK Athens,475,1,4,2,0,7,1,6,14
PAOK Salonik,475,2,3,2,1,10,4,6,11
P'thinaikos,475,3,1,1,4,4,10,-6,4
Panionios,475,3,1,1,4,4,10,-6,4
AEK Athens,476,1,4,2,0,7,1,6,14
PAOK Salonik,476,2,2,2,2,9,5,4,8
P'thinaikos,476,3,2,1,3,5,9,-4,7
Panionios,476,4,1,1,4,4,10,-6,4
AEK Athens,477,1,4,2,0,7,1,6,14
PAOK Salonik,477,2,2,2,2,9,6,3,8
P'thinaikos,477,3,2,1,3,6,9,-3,7
Panionios,477,4,1,1,4,4,10,-6,4
AEK Athens,478,1,4,2,0,7,1,6,14
PAOK Salonik,478,2,3,2,1,11,5,6,11
P'thinaikos,478,3,1,1,4,5,11,-6,4
Panionios,478,4,1,1,4,4,10,-6,4
AEK Athens,479,1,4,2,0,7,1,6,14
PAOK Salonik,479,2,3,2,1,13,4,9,11
Panionios,479,3,1,1,4,4,10,-6,4
P'thinaikos,479,4,1,1,4,4,13,-9,4
AEK Athens,480,1,4,2,0,7,1,6,14
PAOK Salonik,480,2,2,3,1,11,6,5,9
P'thinaikos,480,3,1,2,3,6,11,-5,5
Panionios,480,4,1,1,4,4,10,-6,4
AEK Athens,481,1,4,2,0,7,1,6,14
PAOK Salonik,481,2,2,2,2,10,7,3,8
P'thinaikos,481,3,2,1,3,7,10,-3,7
Panionios,481,4,1,1,4,4,10,-6,4
AEK Athens,482,1,4,2,0,7,1,6,14
PAOK Salonik,482,2,2,3,1,11,6,5,9
P'thinaikos,482,3,1,2,3,6,11,-5,5
Panionios,482,4,1,1,4,4,10,-6,4
AEK Athens,483,1,4,2,0,7,1,6,14
PAOK Salonik,483,2,2,3,1,9,4,5,9
P'thinaikos,483,3,1,2,3,4,9,-5,5
Panionios,483,4,1,1,4,4,10,-6,4
AEK Athens,484,1,4,2,0,7,1,6,14
PAOK Salonik,484,2,2,2,2,10,7,3,8
P'thinaikos,484,3,2,1,3,7,10,-3,7
Panionios,484,4,1,1,4,4,10,-6,4
AEK Athens,485,1,4,2,0,7,1,6,14
PAOK Salonik,485,2,2,3,1,11,6,5,9
P'thinaikos,485,3,1,2,3,6,11,-5,5
Panionios,485,4,1,1,4,4,10,-6,4
AEK Athens,486,1,4,2,0,7,1,6,14
PAOK Salonik,486,2,2,2,2,10,6,4,8
P'thinaikos,486,3,2,1,3,6,10,-4,7
Panionios,486,4,1,1,4,4,10,-6,4
AEK Athens,487,1,4,2,0,7,1,6,14
PAOK Salonik,487,2,3,2,1,11,4,7,11
Panionios,487,3,1,1,4,4,10,-6,4
P'thinaikos,487,4,1,1,4,4,11,-7,4
AEK Athens,488,1,4,2,0,7,1,6,14
PAOK Salonik,488,2,3,2,1,10,4,6,11
P'thinaikos,488,3,1,1,4,4,10,-6,4
Panionios,488,3,1,1,4,4,10,-6,4
AEK Athens,489,1,4,2,0,7,1,6,14
PAOK Salonik,489,2,2,2,2,10,6,4,8
P'thinaikos,489,3,2,1,3,6,10,-4,7
Panionios,489,4,1,1,4,4,10,-6,4
AEK Athens,490,1,4,2,0,7,1,6,14
PAOK Salonik,490,2,2,2,2,9,5,4,8
P'thinaikos,490,3,2,1,3,5,9,-4,7
Panionios,490,4,1,1,4,4,10,-6,4
AEK Athens,491,1,4,2,0,7,1,6,14
PAOK Salonik,491,2,2,2,2,9,5,4,8
P'thinaikos,491,3,2,1,3,5,9,-4,7
Panionios,491,4,1,1,4,4,10,-6,4
AEK Athens,492,1,4,2,0,7,1,6,14
PAOK Salonik,492,2,2,3,1,9,4,5,9
P'thinaikos,492,3,1,2,3,4,9,-5,5
Panionios,492,4,1,1,4,4,10,-6,4
AEK Athens,493,1,4,2,0,7,1,6,14
PAOK Salonik,493,2,2,2,2,10,6,4,8
P'thinaikos,493,3,2,1,3,6,10,-4,7
Panionios,493,4,1,1,4,4,10,-6,4
AEK Athens,494,1,4,2,0,7,1,6,14
PAOK Salonik,494,2,2,3,1,10,5,5,9
P'thinaikos,494,3,1,2,3,5,10,-5,5
Panionios,494,4,1,1,4,4,10,-6,4
AEK Athens,495,1,4,2,0,7,1,6,14
PAOK Salonik,495,2,2,3,1,9,4,5,9
P'thinaikos,495,3,1,2,3,4,9,-5,5
Panionios,495,4,1,1,4,4,10,-6,4
AEK Athens,496,1,4,2,0,7,1,6,14
PAOK Salonik,496,2,2,2,2,10,7,3,8
P'thinaikos,496,3,2,1,3,7,10,-3,7
Panionios,496,4,1,1,4,4,10,-6,4
AEK Athens,497,1,4,2,0,7,1,6,14
PAOK Salonik,497,2,3,2,1,13,6,7,11
Panionios,497,3,1,1,4,4,10,-6,4
P'thinaikos,497,4,1,1,4,6,13,-7,4
AEK Athens,498,1,4,2,0,7,1,6,14
PAOK Salonik,498,2,3,2,1,10,4,6,11
P'thinaikos,498,3,1,1,4,4,10,-6,4
Panionios,498,3,1,1,4,4,10,-6,4
AEK Athens,499,1,4,2,0,7,1,6,14
PAOK Salonik,499,2,3,2,1,11,5,6,11
P'thinaikos,499,3,1,1,4,5,11,-6,4
Panionios,499,4,1,1,4,4,10,-6,4
AEK Athens,500,1,4,2,0,7,1,6,14
PAOK Salonik,500,2,2,2,2,9,5,4,8
P'thinaikos,500,3,2,1,3,5,9,-4,7
Panionios,500,4,1,1,4,4,10,-6,4
AEK Athens,501,1,4,2,0,7,1,6,14
PAOK Salonik,501,2,3,2,1,11,5,6,11
P'thinaikos,501,3,1,1,4,5,11,-6,4
Panionios,501,4,1,1,4,4,10,-6,4
AEK Athens,502,1,4,2,0,7,1,6,14
PAOK Salonik,502,2,3,2,1,12,5,7,11
Panionios,502,3,1,1,4,4,10,-6,4
P'thinaikos,502,4,1,1,4,5,12,-7,4
AEK Athens,503,1,4,2,0,7,1,6,14
PAOK Salonik,503,2,2,3,1,9,4,5,9
P'thinaikos,503,3,1,2,3,4,9,-5,5
Panionios,503,4,1,1,4,4,10,-6,4
AEK Athens,504,1,4,2,0,7,1,6,14
PAOK Salonik,504,2,2,2,2,9,5,4,8
P'thinaikos,504,3,2,1,3,5,9,-4,7
Panionios,504,4,1,1,4,4,10,-6,4
AEK Athens,505,1,4,2,0,7,1,6,14
PAOK Salonik,505,2,3,2,1,11,4,7,11
Panionios,505,3,1,1,4,4,10,-6,4
P'thinaikos,505,4,1,1,4,4,11,-7,4
AEK Athens,506,1,4,2,0,7,1,6,14
PAOK Salonik,506,2,2,2,2,10,8,2,8
P'thinaikos,506,3,2,1,3,8,10,-2,7
Panionios,506,4,1,1,4,4,10,-6,4
AEK Athens,507,1,4,2,0,7,1,6,14
PAOK Salonik,507,2,2,3,1,9,4,5,9
P'thinaikos,507,3,1,2,3,4,9,-5,5
Panionios,507,4,1,1,4,4,10,-6,4
AEK Athens,508,1,4,2,0,7,1,6,14
PAOK Salonik,508,2,3,2,1,11,5,6,11
P'thinaikos,508,3,1,1,4,5,11,-6,4
Panionios,508,4,1,1,4,4,10,-6,4
AEK Athens,509,1,4,2,0,7,1,6,14
PAOK Salonik,509,2,3,2,1,10,4,6,11
P'thinaikos,509,3,1,1,4,4,10,-6,4
Panionios,509,3,1,1,4,4,10,-6,4
AEK Athens,510,1,4,2,0,7,1,6,14
PAOK Salonik,510,2,2,2,2,9,7,2,8
P'thinaikos,510,3,2,1,3,7,9,-2,7
Panionios,510,4,1,1,4,4,10,-6,4
AEK Athens,511,1,4,2,0,7,1,6,14
PAOK Salonik,511,2,3,2,1,10,4,6,11
P'thinaikos,511,3,1,1,4,4,10,-6,4
Panionios,511,3,1,1,4,4,10,-6,4
AEK Athens,512,1,4,2,0,7,1,6,14
PAOK Salonik,512,2,2,2,2,9,8,1,8
P'thinaikos,512,3,2,1,3,8,9,-1,7
Panionios,512,4,1,1,4,4,10,-6,4
AEK Athens,513,1,4,2,0,7,1,6,14
PAOK Salonik,513,2,2,2,2,9,6,3,8
P'thinaikos,513,3,2,1,3,6,9,-3,7
Panionios,513,4,1,1,4,4,10,-6,4
AEK Athens,514,1,4,2,0,7,1,6,14
PAOK Salonik,514,2,3,2,1,11,5,6,11
P'thinaikos,514,3,1,1,4,5,11,-6,4
Panionios,514,4,1,1,4,4,10,-6,4
AEK Athens,515,1,4,2,0,7,1,6,14
PAOK Salonik,515,2,2,2,2,9,5,4,8
P'thinaikos,515,3,2,1,3,5,9,-4,7
Panionios,515,4,1,1,4,4,10,-6,4
AEK Athens,516,1,4,2,0,7,1,6,14
PAOK Salonik,516,2,2,3,1,10,5,5,9
P'thinaikos,516,3,1,2,3,5,10,-5,5
Panionios,516,4,1,1,4,4,10,-6,4
AEK Athens,517,1,4,2,0,7,1,6,14
PAOK Salonik,517,2,3,2,1,10,4,6,11
P'thinaikos,517,3,1,1,4,4,10,-6,4
Panionios,517,3,1,1,4,4,10,-6,4
AEK Athens,518,1,4,2,0,7,1,6,14
PAOK Salonik,518,2,3,2,1,12,6,6,11
P'thinaikos,518,3,1,1,4,6,12,-6,4
Panionios,518,4,1,1,4,4,10,-6,4
AEK Athens,519,1,4,2,0,7,1,6,14
PAOK Salonik,519,2,2,3,1,11,6,5,9
P'thinaikos,519,3,1,2,3,6,11,-5,5
Panionios,519,4,1,1,4,4,10,-6,4
AEK Athens,520,1,4,2,0,7,1,6,14
PAOK Salonik,520,2,2,2,2,10,6,4,8
P'thinaikos,520,3,2,1,3,6,10,-4,7
Panionios,520,4,1,1,4,4,10,-6,4
AEK Athens,521,1,4,2,0,7,1,6,14
PAOK Salonik,521,2,3,2,1,12,5,7,11
Panionios,521,3,1,1,4,4,10,-6,4
P'thinaikos,521,4,1,1,4,5,12,-7,4
AEK Athens,522,1,4,2,0,7,1,6,14
PAOK Salonik,522,2,2,2,2,9,6,3,8
P'thinaikos,522,3,2,1,3,6,9,-3,7
Panionios,522,4,1,1,4,4,10,-6,4
AEK Athens,523,1,4,2,0,7,1,6,14
PAOK Salonik,523,2,3,2,1,12,5,7,11
Panionios,523,3,1,1,4,4,10,-6,4
P'thinaikos,523,4,1,1,4,5,12,-7,4
AEK Athens,524,1,4,2,0,7,1,6,14
PAOK Salonik,524,2,3,2,1,10,4,6,11
P'thinaikos,524,3,1,1,4,4,10,-6,4
Panionios,524,3,1,1,4,4,10,-6,4
AEK Athens,525,1,4,2,0,7,1,6,14
PAOK Salonik,525,2,2,2,2,10,9,1,8
P'thinaikos,525,3,2,1,3,9,10,-1,7
Panionios,525,4,1,1,4,4,10,-6,4
AEK Athens,526,1,4,2,0,7,1,6,14
PAOK Salonik,526,2,2,3,1,9,4,5,9
P'thinaikos,526,3,1,2,3,4,9,-5,5
Panionios,526,4,1,1,4,4,10,-6,4
AEK Athens,527,1,4,2,0,7,1,6,14
PAOK Salonik,527,2,3,2,1,10,4,6,11
P'thinaikos,527,3,1,1,4,4,10,-6,4
Panionios,527,3,1,1,4,4,10,-6,4
AEK Athens,528,1,4,2,0,7,1,6,14
PAOK Salonik,528,2,3,2,1,11,4,7,11
Panionios,528,3,1,1,4,4,10,-6,4
P'thinaikos,528,4,1,1,4,4,11,-7,4
AEK Athens,529,1,4,2,0,7,1,6,14
PAOK Salonik,529,2,3,2,1,11,4,7,11
Panionios,529,3,1,1,4,4,10,-6,4
P'thinaikos,529,4,1,1,4,4,11,-7,4
AEK Athens,530,1,4,2,0,7,1,6,14
PAOK Salonik,530,2,2,2,2,10,6,4,8
P'thinaikos,530,3,2,1,3,6,10,-4,7
Panionios,530,4,1,1,4,4,10,-6,4
AEK Athens,531,1,4,2,0,7,1,6,14
PAOK Salonik,531,2,2,2,2,10,6,4,8
P'thinaikos,531,3,2,1,3,6,10,-4,7
Panionios,531,4,1,1,4,4,10,-6,4
AEK Athens,532,1,4,2,0,7,1,6,14
PAOK Salonik,532,2,2,2,2,11,7,4,8
P'thinaikos,532,3,2,1,3,7,11,-4,7
Panionios,532,4,1,1,4,4,10,-6,4
AEK Athens,533,1,4,2,0,7,1,6,14
PAOK Salonik,533,2,2,3,1,9,4,5,9
P'thinaikos,533,3,1,2,3,4,9,-5,5
Panionios,533,4,1,1,4,4,10,-6,4
AEK Athens,534,1,4,2,0,7,1,6,14
PAOK Salonik,534,2,3,2,1,10,4,6,11
P'thinaikos,534,3,1,1,4,4,10,-6,4
Panionios,534,3,1,1,4,4,10,-6,4
AEK Athens,535,1,4,2,0,7,1,6,14
PAOK Salonik,535,2,2,2,2,9,5,4,8
P'thinaikos,535,3,2,1,3,5,9,-4,7
Panionios,535,4,1,1,4,4,10,-6,4
AEK Athens,536,1,4,2,0,7,1,6,14
PAOK Salonik,536,2,3,2,1,10,4,6,11
P'thinaikos,536,3,1,1,4,4,10,-6,4
Panionios,536,3,1,1,4,4,10,-6,4
AEK Athens,537,1,4,2,0,7,1,6,14
PAOK Salonik,537,2,3,2,1,11,4,7,11
Panionios,537,3,1,1,4,4,10,-6,4
P'thinaikos,537,4,1,1,4,4,11,-7,4
AEK Athens,538,1,4,2,0,7,1,6,14
PAOK Salonik,538,2,2,2,2,10,6,4,8
P'thinaikos,538,3,2,1,3,6,10,-4,7
Panionios,538,4,1,1,4,4,10,-6,4
AEK Athens,539,1,4,2,0,7,1,6,14
PAOK Salonik,539,2,2,2,2,10,6,4,8
P'thinaikos,539,3,2,1,3,6,10,-4,7
Panionios,539,4,1,1,4,4,10,-6,4
AEK Athens,540,1,4,2,0,7,1,6,14
PAOK Salonik,540,2,2,3,1,10,5,5,9
P'thinaikos,540,3,1,2,3,5,10,-5,5
Panionios,540,4,1,1,4,4,10,-6,4
AEK Athens,541,1,4,2,0,7,1,6,14
PAOK Salonik,541,2,2,2,2,9,6,3,8
P'thinaikos,541,3,2,1,3,6,9,-3,7
Panionios,541,4,1,1,4,4,10,-6,4
AEK Athens,542,1,4,2,0,7,1,6,14
PAOK Salonik,542,2,2,2,2,9,5,4,8
P'thinaikos,542,3,2,1,3,5,9,-4,7
Panionios,542,4,1,1,4,4,10,-6,4
AEK Athens,543,1,4,2,0,7,1,6,14
PAOK Salonik,543,2,2,2,2,9,6,3,8
P'thinaikos,543,3,2,1,3,6,9,-3,7
Panionios,543,4,1,1,4,4,10,-6,4
AEK Athens,544,1,4,2,0,7,1,6,14
PAOK Salonik,544,2,3,2,1,10,4,6,11
P'thinaikos,544,3,1,1,4,4,10,-6,4
Panionios,544,3,1,1,4,4,10,-6,4
AEK Athens,545,1,4,2,0,7,1,6,14
PAOK Salonik,545,2,2,3,1,9,4,5,9
P'thinaikos,545,3,1,2,3,4,9,-5,5
Panionios,545,4,1,1,4,4,10,-6,4
AEK Athens,546,1,4,2,0,7,1,6,14
PAOK Salonik,546,2,2,2,2,9,5,4,8
P'thinaikos,546,3,2,1,3,5,9,-4,7
Panionios,546,4,1,1,4,4,10,-6,4
AEK Athens,547,1,4,2,0,7,1,6,14
PAOK Salonik,547,2,2,2,2,10,6,4,8
P'thinaikos,547,3,2,1,3,6,10,-4,7
Panionios,547,4,1,1,4,4,10,-6,4
AEK Athens,548,1,4,2,0,7,1,6,14
PAOK Salonik,548,2,3,2,1,12,5,7,11
Panionios,548,3,1,1,4,4,10,-6,4
P'thinaikos,548,4,1,1,4,5,12,-7,4
AEK Athens,549,1,4,2,0,7,1,6,14
PAOK Salonik,549,2,2,3,1,10,5,5,9
P'thinaikos,549,3,1,2,3,5,10,-5,5
Panionios,549,4,1,1,4,4,10,-6,4
AEK Athens,550,1,4,2,0,7,1,6,14
PAOK Salonik,550,2,2,2,2,10,6,4,8
P'thinaikos,550,3,2,1,3,6,10,-4,7
Panionios,550,4,1,1,4,4,10,-6,4
AEK Athens,551,1,4,2,0,7,1,6,14
PAOK Salonik,551,2,3,2,1,10,4,6,11
P'thinaikos,551,3,1,1,4,4,10,-6,4
Panionios,551,3,1,1,4,4,10,-6,4
AEK Athens,552,1,4,2,0,7,1,6,14
PAOK Salonik,552,2,2,3,1,9,4,5,9
P'thinaikos,552,3,1,2,3,4,9,-5,5
Panionios,552,4,1,1,4,4,10,-6,4
AEK Athens,553,1,4,2,0,7,1,6,14
PAOK Salonik,553,2,3,2,1,12,5,7,11
Panionios,553,3,1,1,4,4,10,-6,4
P'thinaikos,553,4,1,1,4,5,12,-7,4
AEK Athens,554,1,4,2,0,7,1,6,14
PAOK Salonik,554,2,2,3,1,10,5,5,9
P'thinaikos,554,3,1,2,3,5,10,-5,5
Panionios,554,4,1,1,4,4,10,-6,4
AEK Athens,555,1,4,2,0,7,1,6,14
PAOK Salonik,555,2,2,2,2,10,6,4,8
P'thinaikos,555,3,2,1,3,6,10,-4,7
Panionios,555,4,1,1,4,4,10,-6,4
AEK Athens,556,1,4,2,0,7,1,6,14
PAOK Salonik,556,2,2,3,1,9,4,5,9
P'thinaikos,556,3,1,2,3,4,9,-5,5
Panionios,556,4,1,1,4,4,10,-6,4
AEK Athens,557,1,4,2,0,7,1,6,14
PAOK Salonik,557,2,2,3,1,9,4,5,9
P'thinaikos,557,3,1,2,3,4,9,-5,5
Panionios,557,4,1,1,4,4,10,-6,4
AEK Athens,558,1,4,2,0,7,1,6,14
PAOK Salonik,558,2,3,2,1,12,5,7,11
Panionios,558,3,1,1,4,4,10,-6,4
P'thinaikos,558,4,1,1,4,5,12,-7,4
AEK Athens,559,1,4,2,0,7,1,6,14
PAOK Salonik,559,2,3,2,1,10,4,6,11
P'thinaikos,559,3,1,1,4,4,10,-6,4
Panionios,559,3,1,1,4,4,10,-6,4
AEK Athens,560,1,4,2,0,7,1,6,14
PAOK Salonik,560,2,3,2,1,14,6,8,11
Panionios,560,3,1,1,4,4,10,-6,4
P'thinaikos,560,4,1,1,4,6,14,-8,4
AEK Athens,561,1,4,2,0,7,1,6,14
PAOK Salonik,561,2,2,3,1,9,4,5,9
P'thinaikos,561,3,1,2,3,4,9,-5,5
Panionios,561,4,1,1,4,4,10,-6,4
AEK Athens,562,1,4,2,0,7,1,6,14
PAOK Salonik,562,2,2,2,2,9,6,3,8
P'thinaikos,562,3,2,1,3,6,9,-3,7
Panionios,562,4,1,1,4,4,10,-6,4
AEK Athens,563,1,4,2,0,7,1,6,14
PAOK Salonik,563,2,2,3,1,11,6,5,9
P'thinaikos,563,3,1,2,3,6,11,-5,5
Panionios,563,4,1,1,4,4,10,-6,4
AEK Athens,564,1,4,2,0,7,1,6,14
PAOK Salonik,564,2,2,2,2,9,5,4,8
P'thinaikos,564,3,2,1,3,5,9,-4,7
Panionios,564,4,1,1,4,4,10,-6,4
AEK Athens,565,1,4,2,0,7,1,6,14
PAOK Salonik,565,2,2,2,2,9,6,3,8
P'thinaikos,565,3,2,1,3,6,9,-3,7
Panionios,565,4,1,1,4,4,10,-6,4
AEK Athens,566,1,4,2,0,7,1,6,14
PAOK Salonik,566,2,3,2,1,10,4,6,11
P'thinaikos,566,3,1,1,4,4,10,-6,4
Panionios,566,3,1,1,4,4,10,-6,4
AEK Athens,567,1,4,2,0,7,1,6,14
PAOK Salonik,567,2,2,2,2,10,6,4,8
P'thinaikos,567,3,2,1,3,6,10,-4,7
Panionios,567,4,1,1,4,4,10,-6,4
AEK Athens,568,1,4,2,0,7,1,6,14
PAOK Salonik,568,2,2,2,2,9,6,3,8
P'thinaikos,568,3,2,1,3,6,9,-3,7
Panionios,568,4,1,1,4,4,10,-6,4
AEK Athens,569,1,4,2,0,7,1,6,14
PAOK Salonik,569,2,3,2,1,10,4,6,11
P'thinaikos,569,3,1,1,4,4,10,-6,4
Panionios,569,3,1,1,4,4,10,-6,4
AEK Athens,570,1,4,2,0,7,1,6,14
PAOK Salonik,570,2,2,2,2,9,5,4,8
P'thinaikos,570,3,2,1,3,5,9,-4,7
Panionios,570,4,1,1,4,4,10,-6,4
AEK Athens,571,1,4,2,0,7,1,6,14
PAOK Salonik,571,2,2,3,1,9,4,5,9
P'thinaikos,571,3,1,2,3,4,9,-5,5
Panionios,571,4,1,1,4,4,10,-6,4
AEK Athens,572,1,4,2,0,7,1,6,14
PAOK Salonik,572,2,2,2,2,9,6,3,8
P'thinaikos,572,3,2,1,3,6,9,-3,7
Panionios,572,4,1,1,4,4,10,-6,4
AEK Athens,573,1,4,2,0,7,1,6,14
PAOK Salonik,573,2,2,2,2,10,6,4,8
P'thinaikos,573,3,2,1,3,6,10,-4,7
Panionios,573,4,1,1,4,4,10,-6,4
AEK Athens,574,1,4,2,0,7,1,6,14
PAOK Salonik,574,2,3,2,1,10,4,6,11
P'thinaikos,574,3,1,1,4,4,10,-6,4
Panionios,574,3,1,1,4,4,10,-6,4
AEK Athens,575,1,4,2,0,7,1,6,14
PAOK Salonik,575,2,2,2,2,9,8,1,8
P'thinaikos,575,3,2,1,3,8,9,-1,7
Panionios,575,4,1,1,4,4,10,-6,4
AEK Athens,576,1,4,2,0,7,1,6,14
PAOK Salonik,576,2,3,2,1,12,4,8,11
Panionios,576,3,1,1,4,4,10,-6,4
P'thinaikos,576,4,1,1,4,4,12,-8,4
AEK Athens,577,1,4,2,0,7,1,6,14
PAOK Salonik,577,2,2,2,2,9,5,4,8
P'thinaikos,577,3,2,1,3,5,9,-4,7
Panionios,577,4,1,1,4,4,10,-6,4
AEK Athens,578,1,4,2,0,7,1,6,14
PAOK Salonik,578,2,2,3,1,9,4,5,9
P'thinaikos,578,3,1,2,3,4,9,-5,5
Panionios,578,4,1,1,4,4,10,-6,4
AEK Athens,579,1,4,2,0,7,1,6,14
PAOK Salonik,579,2,3,2,1,11,5,6,11
P'thinaikos,579,3,1,1,4,5,11,-6,4
Panionios,579,4,1,1,4,4,10,-6,4
AEK Athens,580,1,4,2,0,7,1,6,14
PAOK Salonik,580,2,2,3,1,11,6,5,9
P'thinaikos,580,3,1,2,3,6,11,-5,5
Panionios,580,4,1,1,4,4,10,-6,4
AEK Athens,581,1,4,2,0,7,1,6,14
PAOK Salonik,581,2,2,2,2,9,8,1,8
P'thinaikos,581,3,2,1,3,8,9,-1,7
Panionios,581,4,1,1,4,4,10,-6,4
AEK Athens,582,1,4,2,0,7,1,6,14
PAOK Salonik,582,2,3,2,1,11,4,7,11
Panionios,582,3,1,1,4,4,10,-6,4
P'thinaikos,582,4,1,1,4,4,11,-7,4
AEK Athens,583,1,4,2,0,7,1,6,14
PAOK Salonik,583,2,2,2,2,9,8,1,8
P'thinaikos,583,3,2,1,3,8,9,-1,7
Panionios,583,4,1,1,4,4,10,-6,4
AEK Athens,584,1,4,2,0,7,1,6,14
PAOK Salonik,584,2,2,2,2,10,6,4,8
P'thinaikos,584,3,2,1,3,6,10,-4,7
Panionios,584,4,1,1,4,4,10,-6,4
AEK Athens,585,1,4,2,0,7,1,6,14
PAOK Salonik,585,2,3,2,1,11,4,7,11
Panionios,585,3,1,1,4,4,10,-6,4
P'thinaikos,585,4,1,1,4,4,11,-7,4
AEK Athens,586,1,4,2,0,7,1,6,14
PAOK Salonik,586,2,2,3,1,9,4,5,9
P'thinaikos,586,3,1,2,3,4,9,-5,5
Panionios,586,4,1,1,4,4,10,-6,4
AEK Athens,587,1,4,2,0,7,1,6,14
PAOK Salonik,587,2,2,3,1,10,5,5,9
P'thinaikos,587,3,1,2,3,5,10,-5,5
Panionios,587,4,1,1,4,4,10,-6,4
AEK Athens,588,1,4,2,0,7,1,6,14
PAOK Salonik,588,2,2,3,1,9,4,5,9
P'thinaikos,588,3,1,2,3,4,9,-5,5
Panionios,588,4,1,1,4,4,10,-6,4
AEK Athens,589,1,4,2,0,7,1,6,14
PAOK Salonik,589,2,2,2,2,9,6,3,8
P'thinaikos,589,3,2,1,3,6,9,-3,7
Panionios,589,4,1,1,4,4,10,-6,4
AEK Athens,590,1,4,2,0,7,1,6,14
PAOK Salonik,590,2,2,3,1,11,6,5,9
P'thinaikos,590,3,1,2,3,6,11,-5,5
Panionios,590,4,1,1,4,4,10,-6,4
AEK Athens,591,1,4,2,0,7,1,6,14
PAOK Salonik,591,2,2,2,2,10,6,4,8
P'thinaikos,591,3,2,1,3,6,10,-4,7
Panionios,591,4,1,1,4,4,10,-6,4
AEK Athens,592,1,4,2,0,7,1,6,14
PAOK Salonik,592,2,2,2,2,10,6,4,8
P'thinaikos,592,3,2,1,3,6,10,-4,7
Panionios,592,4,1,1,4,4,10,-6,4
AEK Athens,593,1,4,2,0,7,1,6,14
PAOK Salonik,593,2,2,2,2,9,6,3,8
P'thinaikos,593,3,2,1,3,6,9,-3,7
Panionios,593,4,1,1,4,4,10,-6,4
AEK Athens,594,1,4,2,0,7,1,6,14
PAOK Salonik,594,2,2,3,1,10,5,5,9
P'thinaikos,594,3,1,2,3,5,10,-5,5
Panionios,594,4,1,1,4,4,10,-6,4
AEK Athens,595,1,4,2,0,7,1,6,14
PAOK Salonik,595,2,3,2,1,11,5,6,11
P'thinaikos,595,3,1,1,4,5,11,-6,4
Panionios,595,4,1,1,4,4,10,-6,4
AEK Athens,596,1,4,2,0,7,1,6,14
PAOK Salonik,596,2,2,3,1,10,5,5,9
P'thinaikos,596,3,1,2,3,5,10,-5,5
Panionios,596,4,1,1,4,4,10,-6,4
AEK Athens,597,1,4,2,0,7,1,6,14
PAOK Salonik,597,2,2,3,1,10,5,5,9
P'thinaikos,597,3,1,2,3,5,10,-5,5
Panionios,597,4,1,1,4,4,10,-6,4
AEK Athens,598,1,4,2,0,7,1,6,14
PAOK Salonik,598,2,2,2,2,10,9,1,8
P'thinaikos,598,3,2,1,3,9,10,-1,7
Panionios,598,4,1,1,4,4,10,-6,4
AEK Athens,599,1,4,2,0,7,1,6,14
PAOK Salonik,599,2,3,2,1,11,4,7,11
Panionios,599,3,1,1,4,4,10,-6,4
P'thinaikos,599,4,1,1,4,4,11,-7,4
AEK Athens,600,1,4,2,0,7,1,6,14
PAOK Salonik,600,2,2,3,1,10,5,5,9
P'thinaikos,600,3,1,2,3,5,10,-5,5
Panionios,600,4,1,1,4,4,10,-6,4
AEK Athens,601,1,4,2,0,7,1,6,14
PAOK Salonik,601,2,2,2,2,9,6,3,8
P'thinaikos,601,3,2,1,3,6,9,-3,7
Panionios,601,4,1,1,4,4,10,-6,4
AEK Athens,602,1,4,2,0,7,1,6,14
PAOK Salonik,602,2,2,3,1,10,5,5,9
P'thinaikos,602,3,1,2,3,5,10,-5,5
Panionios,602,4,1,1,4,4,10,-6,4
AEK Athens,603,1,4,2,0,7,1,6,14
PAOK Salonik,603,2,2,2,2,11,9,2,8
P'thinaikos,603,3,2,1,3,9,11,-2,7
Panionios,603,4,1,1,4,4,10,-6,4
AEK Athens,604,1,4,2,0,7,1,6,14
PAOK Salonik,604,2,2,2,2,9,5,4,8
P'thinaikos,604,3,2,1,3,5,9,-4,7
Panionios,604,4,1,1,4,4,10,-6,4
AEK Athens,605,1,4,2,0,7,1,6,14
PAOK Salonik,605,2,2,2,2,10,6,4,8
P'thinaikos,605,3,2,1,3,6,10,-4,7
Panionios,605,4,1,1,4,4,10,-6,4
AEK Athens,606,1,4,2,0,7,1,6,14
PAOK Salonik,606,2,2,2,2,10,6,4,8
P'thinaikos,606,3,2,1,3,6,10,-4,7
Panionios,606,4,1,1,4,4,10,-6,4
AEK Athens,607,1,4,2,0,7,1,6,14
PAOK Salonik,607,2,3,2,1,10,4,6,11
P'thinaikos,607,3,1,1,4,4,10,-6,4
Panionios,607,3,1,1,4,4,10,-6,4
AEK Athens,608,1,4,2,0,7,1,6,14
PAOK Salonik,608,2,2,3,1,10,5,5,9
P'thinaikos,608,3,1,2,3,5,10,-5,5
Panionios,608,4,1,1,4,4,10,-6,4
AEK Athens,609,1,4,2,0,7,1,6,14
PAOK Salonik,609,2,2,3,1,12,7,5,9
P'thinaikos,609,3,1,2,3,7,12,-5,5
Panionios,609,4,1,1,4,4,10,-6,4
AEK Athens,610,1,4,2,0,7,1,6,14
PAOK Salonik,610,2,2,2,2,10,6,4,8
P'thinaikos,610,3,2,1,3,6,10,-4,7
Panionios,610,4,1,1,4,4,10,-6,4
AEK Athens,611,1,4,2,0,7,1,6,14
PAOK Salonik,611,2,3,2,1,12,4,8,11
Panionios,611,3,1,1,4,4,10,-6,4
P'thinaikos,611,4,1,1,4,4,12,-8,4
AEK Athens,612,1,4,2,0,7,1,6,14
PAOK Salonik,612,2,2,2,2,10,6,4,8
P'thinaikos,612,3,2,1,3,6,10,-4,7
Panionios,612,4,1,1,4,4,10,-6,4
AEK Athens,613,1,4,2,0,7,1,6,14
PAOK Salonik,613,2,3,2,1,11,5,6,11
P'thinaikos,613,3,1,1,4,5,11,-6,4
Panionios,613,4,1,1,4,4,10,-6,4
AEK Athens,614,1,4,2,0,7,1,6,14
PAOK Salonik,614,2,2,2,2,9,5,4,8
P'thinaikos,614,3,2,1,3,5,9,-4,7
Panionios,614,4,1,1,4,4,10,-6,4
AEK Athens,615,1,4,2,0,7,1,6,14
PAOK Salonik,615,2,3,2,1,10,4,6,11
P'thinaikos,615,3,1,1,4,4,10,-6,4
Panionios,615,3,1,1,4,4,10,-6,4
AEK Athens,616,1,4,2,0,7,1,6,14
PAOK Salonik,616,2,3,2,1,11,5,6,11
P'thinaikos,616,3,1,1,4,5,11,-6,4
Panionios,616,4,1,1,4,4,10,-6,4
AEK Athens,617,1,4,2,0,7,1,6,14
PAOK Salonik,617,2,2,2,2,10,6,4,8
P'thinaikos,617,3,2,1,3,6,10,-4,7
Panionios,617,4,1,1,4,4,10,-6,4
AEK Athens,618,1,4,2,0,7,1,6,14
PAOK Salonik,618,2,2,3,1,11,6,5,9
P'thinaikos,618,3,1,2,3,6,11,-5,5
Panionios,618,4,1,1,4,4,10,-6,4
AEK Athens,619,1,4,2,0,7,1,6,14
PAOK Salonik,619,2,3,2,1,12,4,8,11
Panionios,619,3,1,1,4,4,10,-6,4
P'thinaikos,619,4,1,1,4,4,12,-8,4
AEK Athens,620,1,4,2,0,7,1,6,14
PAOK Salonik,620,2,2,3,1,10,5,5,9
P'thinaikos,620,3,1,2,3,5,10,-5,5
Panionios,620,4,1,1,4,4,10,-6,4
AEK Athens,621,1,4,2,0,7,1,6,14
PAOK Salonik,621,2,2,2,2,11,7,4,8
P'thinaikos,621,3,2,1,3,7,11,-4,7
Panionios,621,4,1,1,4,4,10,-6,4
AEK Athens,622,1,4,2,0,7,1,6,14
PAOK Salonik,622,2,3,2,1,10,4,6,11
P'thinaikos,622,3,1,1,4,4,10,-6,4
Panionios,622,3,1,1,4,4,10,-6,4
AEK Athens,623,1,4,2,0,7,1,6,14
PAOK Salonik,623,2,2,3,1,10,5,5,9
P'thinaikos,623,3,1,2,3,5,10,-5,5
Panionios,623,4,1,1,4,4,10,-6,4
AEK Athens,624,1,4,2,0,7,1,6,14
PAOK Salonik,624,2,2,3,1,10,5,5,9
P'thinaikos,624,3,1,2,3,5,10,-5,5
Panionios,624,4,1,1,4,4,10,-6,4
AEK Athens,625,1,4,2,0,7,1,6,14
PAOK Salonik,625,2,2,2,2,9,5,4,8
P'thinaikos,625,3,2,1,3,5,9,-4,7
Panionios,625,4,1,1,4,4,10,-6,4
AEK Athens,626,1,4,2,0,7,1,6,14
PAOK Salonik,626,2,2,3,1,10,5,5,9
P'thinaikos,626,3,1,2,3,5,10,-5,5
Panionios,626,4,1,1,4,4,10,-6,4
AEK Athens,627,1,4,2,0,7,1,6,14
PAOK Salonik,627,2,3,2,1,13,7,6,11
P'thinaikos,627,3,1,1,4,7,13,-6,4
Panionios,627,4,1,1,4,4,10,-6,4
AEK Athens,628,1,4,2,0,7,1,6,14
PAOK Salonik,628,2,2,2,2,9,6,3,8
P'thinaikos,628,3,2,1,3,6,9,-3,7
Panionios,628,4,1,1,4,4,10,-6,4
AEK Athens,629,1,4,2,0,7,1,6,14
PAOK Salonik,629,2,2,3,1,10,5,5,9
P'thinaikos,629,3,1,2,3,5,10,-5,5
Panionios,629,4,1,1,4,4,10,-6,4
AEK Athens,630,1,4,2,0,7,1,6,14
PAOK Salonik,630,2,2,2,2,9,6,3,8
P'thinaikos,630,3,2,1,3,6,9,-3,7
Panionios,630,4,1,1,4,4,10,-6,4
AEK Athens,631,1,4,2,0,7,1,6,14
PAOK Salonik,631,2,2,2,2,9,8,1,8
P'thinaikos,631,3,2,1,3,8,9,-1,7
Panionios,631,4,1,1,4,4,10,-6,4
AEK Athens,632,1,4,2,0,7,1,6,14
PAOK Salonik,632,2,3,2,1,11,5,6,11
P'thinaikos,632,3,1,1,4,5,11,-6,4
Panionios,632,4,1,1,4,4,10,-6,4
AEK Athens,633,1,4,2,0,7,1,6,14
PAOK Salonik,633,2,3,2,1,12,6,6,11
P'thinaikos,633,3,1,1,4,6,12,-6,4
Panionios,633,4,1,1,4,4,10,-6,4
AEK Athens,634,1,4,2,0,7,1,6,14
PAOK Salonik,634,2,2,2,2,9,7,2,8
P'thinaikos,634,3,2,1,3,7,9,-2,7
Panionios,634,4,1,1,4,4,10,-6,4
AEK Athens,635,1,4,2,0,7,1,6,14
PAOK Salonik,635,2,3,2,1,13,5,8,11
Panionios,635,3,1,1,4,4,10,-6,4
P'thinaikos,635,4,1,1,4,5,13,-8,4
AEK Athens,636,1,4,2,0,7,1,6,14
PAOK Salonik,636,2,2,3,1,9,4,5,9
P'thinaikos,636,3,1,2,3,4,9,-5,5
Panionios,636,4,1,1,4,4,10,-6,4
AEK Athens,637,1,4,2,0,7,1,6,14
PAOK Salonik,637,2,2,2,2,12,8,4,8
P'thinaikos,637,3,2,1,3,8,12,-4,7
Panionios,637,4,1,1,4,4,10,-6,4
AEK Athens,638,1,4,2,0,7,1,6,14
PAOK Salonik,638,2,3,2,1,12,4,8,11
Panionios,638,3,1,1,4,4,10,-6,4
P'thinaikos,638,4,1,1,4,4,12,-8,4
AEK Athens,639,1,4,2,0,7,1,6,14
PAOK Salonik,639,2,3,2,1,13,6,7,11
Panionios,639,3,1,1,4,4,10,-6,4
P'thinaikos,639,4,1,1,4,6,13,-7,4
AEK Athens,640,1,4,2,0,7,1,6,14
PAOK Salonik,640,2,2,2,2,9,5,4,8
P'thinaikos,640,3,2,1,3,5,9,-4,7
Panionios,640,4,1,1,4,4,10,-6,4
AEK Athens,641,1,4,2,0,7,1,6,14
PAOK Salonik,641,2,3,2,1,12,6,6,11
P'thinaikos,641,3,1,1,4,6,12,-6,4
Panionios,641,4,1,1,4,4,10,-6,4
AEK Athens,642,1,4,2,0,7,1,6,14
PAOK Salonik,642,2,3,2,1,13,6,7,11
Panionios,642,3,1,1,4,4,10,-6,4
P'thinaikos,642,4,1,1,4,6,13,-7,4
AEK Athens,643,1,4,2,0,7,1,6,14
PAOK Salonik,643,2,2,2,2,9,6,3,8
P'thinaikos,643,3,2,1,3,6,9,-3,7
Panionios,643,4,1,1,4,4,10,-6,4
AEK Athens,644,1,4,2,0,7,1,6,14
PAOK Salonik,644,2,3,2,1,12,5,7,11
Panionios,644,3,1,1,4,4,10,-6,4
P'thinaikos,644,4,1,1,4,5,12,-7,4
AEK Athens,645,1,4,2,0,7,1,6,14
PAOK Salonik,645,2,2,3,1,10,5,5,9
P'thinaikos,645,3,1,2,3,5,10,-5,5
Panionios,645,4,1,1,4,4,10,-6,4
AEK Athens,646,1,4,2,0,7,1,6,14
PAOK Salonik,646,2,3,2,1,13,6,7,11
Panionios,646,3,1,1,4,4,10,-6,4
P'thinaikos,646,4,1,1,4,6,13,-7,4
AEK Athens,647,1,4,2,0,7,1,6,14
PAOK Salonik,647,2,2,3,1,9,4,5,9
P'thinaikos,647,3,1,2,3,4,9,-5,5
Panionios,647,4,1,1,4,4,10,-6,4
AEK Athens,648,1,4,2,0,7,1,6,14
PAOK Salonik,648,2,3,2,1,13,5,8,11
Panionios,648,3,1,1,4,4,10,-6,4
P'thinaikos,648,4,1,1,4,5,13,-8,4
AEK Athens,649,1,4,2,0,7,1,6,14
PAOK Salonik,649,2,2,3,1,10,5,5,9
P'thinaikos,649,3,1,2,3,5,10,-5,5
Panionios,649,4,1,1,4,4,10,-6,4
AEK Athens,650,1,4,2,0,7,1,6,14
PAOK Salonik,650,2,2,2,2,10,6,4,8
P'thinaikos,650,3,2,1,3,6,10,-4,7
Panionios,650,4,1,1,4,4,10,-6,4
AEK Athens,651,1,4,2,0,7,1,6,14
PAOK Salonik,651,2,3,2,1,11,4,7,11
Panionios,651,3,1,1,4,4,10,-6,4
P'thinaikos,651,4,1,1,4,4,11,-7,4
AEK Athens,652,1,4,2,0,7,1,6,14
PAOK Salonik,652,2,2,3,1,9,4,5,9
P'thinaikos,652,3,1,2,3,4,9,-5,5
Panionios,652,4,1,1,4,4,10,-6,4
AEK Athens,653,1,4,2,0,7,1,6,14
PAOK Salonik,653,2,3,2,1,10,4,6,11
P'thinaikos,653,3,1,1,4,4,10,-6,4
Panionios,653,3,1,1,4,4,10,-6,4
AEK Athens,654,1,4,2,0,7,1,6,14
PAOK Salonik,654,2,3,2,1,10,4,6,11
P'thinaikos,654,3,1,1,4,4,10,-6,4
Panionios,654,3,1,1,4,4,10,-6,4
AEK Athens,655,1,4,2,0,7,1,6,14
PAOK Salonik,655,2,2,3,1,10,5,5,9
P'thinaikos,655,3,1,2,3,5,10,-5,5
Panionios,655,4,1,1,4,4,10,-6,4
AEK Athens,656,1,4,2,0,7,1,6,14
PAOK Salonik,656,2,2,2,2,10,6,4,8
P'thinaikos,656,3,2,1,3,6,10,-4,7
Panionios,656,4,1,1,4,4,10,-6,4
AEK Athens,657,1,4,2,0,7,1,6,14
PAOK Salonik,657,2,3,2,1,11,5,6,11
P'thinaikos,657,3,1,1,4,5,11,-6,4
Panionios,657,4,1,1,4,4,10,-6,4
AEK Athens,658,1,4,2,0,7,1,6,14
PAOK Salonik,658,2,2,2,2,9,5,4,8
P'thinaikos,658,3,2,1,3,5,9,-4,7
Panionios,658,4,1,1,4,4,10,-6,4
AEK Athens,659,1,4,2,0,7,1,6,14
PAOK Salonik,659,2,2,3,1,10,5,5,9
P'thinaikos,659,3,1,2,3,5,10,-5,5
Panionios,659,4,1,1,4,4,10,-6,4
AEK Athens,660,1,4,2,0,7,1,6,14
PAOK Salonik,660,2,2,3,1,10,5,5,9
P'thinaikos,660,3,1,2,3,5,10,-5,5
Panionios,660,4,1,1,4,4,10,-6,4
AEK Athens,661,1,4,2,0,7,1,6,14
PAOK Salonik,661,2,3,2,1,11,5,6,11
P'thinaikos,661,3,1,1,4,5,11,-6,4
Panionios,661,4,1,1,4,4,10,-6,4
AEK Athens,662,1,4,2,0,7,1,6,14
PAOK Salonik,662,2,2,3,1,9,4,5,9
P'thinaikos,662,3,1,2,3,4,9,-5,5
Panionios,662,4,1,1,4,4,10,-6,4
AEK Athens,663,1,4,2,0,7,1,6,14
PAOK Salonik,663,2,3,2,1,12,4,8,11
Panionios,663,3,1,1,4,4,10,-6,4
P'thinaikos,663,4,1,1,4,4,12,-8,4
AEK Athens,664,1,4,2,0,7,1,6,14
PAOK Salonik,664,2,2,2,2,10,7,3,8
P'thinaikos,664,3,2,1,3,7,10,-3,7
Panionios,664,4,1,1,4,4,10,-6,4
AEK Athens,665,1,4,2,0,7,1,6,14
PAOK Salonik,665,2,2,2,2,9,5,4,8
P'thinaikos,665,3,2,1,3,5,9,-4,7
Panionios,665,4,1,1,4,4,10,-6,4
AEK Athens,666,1,4,2,0,7,1,6,14
PAOK Salonik,666,2,3,2,1,12,6,6,11
P'thinaikos,666,3,1,1,4,6,12,-6,4
Panionios,666,4,1,1,4,4,10,-6,4
AEK Athens,667,1,4,2,0,7,1,6,14
PAOK Salonik,667,2,3,2,1,11,4,7,11
Panionios,667,3,1,1,4,4,10,-6,4
P'thinaikos,667,4,1,1,4,4,11,-7,4
AEK Athens,668,1,4,2,0,7,1,6,14
PAOK Salonik,668,2,2,2,2,9,7,2,8
P'thinaikos,668,3,2,1,3,7,9,-2,7
Panionios,668,4,1,1,4,4,10,-6,4
AEK Athens,669,1,4,2,0,7,1,6,14
PAOK Salonik,669,2,2,2,2,9,5,4,8
P'thinaikos,669,3,2,1,3,5,9,-4,7
Panionios,669,4,1,1,4,4,10,-6,4
AEK Athens,670,1,4,2,0,7,1,6,14
PAOK Salonik,670,2,3,2,1,10,4,6,11
P'thinaikos,670,3,1,1,4,4,10,-6,4
Panionios,670,3,1,1,4,4,10,-6,4
AEK Athens,671,1,4,2,0,7,1,6,14
PAOK Salonik,671,2,2,2,2,9,5,4,8
P'thinaikos,671,3,2,1,3,5,9,-4,7
Panionios,671,4,1,1,4,4,10,-6,4
AEK Athens,672,1,4,2,0,7,1,6,14
PAOK Salonik,672,2,2,3,1,9,4,5,9
P'thinaikos,672,3,1,2,3,4,9,-5,5
Panionios,672,4,1,1,4,4,10,-6,4
AEK Athens,673,1,4,2,0,7,1,6,14
PAOK Salonik,673,2,2,3,1,11,6,5,9
P'thinaikos,673,3,1,2,3,6,11,-5,5
Panionios,673,4,1,1,4,4,10,-6,4
AEK Athens,674,1,4,2,0,7,1,6,14
PAOK Salonik,674,2,3,2,1,11,4,7,11
Panionios,674,3,1,1,4,4,10,-6,4
P'thinaikos,674,4,1,1,4,4,11,-7,4
AEK Athens,675,1,4,2,0,7,1,6,14
PAOK Salonik,675,2,3,2,1,12,4,8,11
Panionios,675,3,1,1,4,4,10,-6,4
P'thinaikos,675,4,1,1,4,4,12,-8,4
AEK Athens,676,1,4,2,0,7,1,6,14
PAOK Salonik,676,2,2,3,1,10,5,5,9
P'thinaikos,676,3,1,2,3,5,10,-5,5
Panionios,676,4,1,1,4,4,10,-6,4
AEK Athens,677,1,4,2,0,7,1,6,14
PAOK Salonik,677,2,2,2,2,9,5,4,8
P'thinaikos,677,3,2,1,3,5,9,-4,7
Panionios,677,4,1,1,4,4,10,-6,4
AEK Athens,678,1,4,2,0,7,1,6,14
PAOK Salonik,678,2,3,2,1,10,4,6,11
P'thinaikos,678,3,1,1,4,4,10,-6,4
Panionios,678,3,1,1,4,4,10,-6,4
AEK Athens,679,1,4,2,0,7,1,6,14
PAOK Salonik,679,2,2,2,2,9,5,4,8
P'thinaikos,679,3,2,1,3,5,9,-4,7
Panionios,679,4,1,1,4,4,10,-6,4
AEK Athens,680,1,4,2,0,7,1,6,14
PAOK Salonik,680,2,3,2,1,10,4,6,11
P'thinaikos,680,3,1,1,4,4,10,-6,4
Panionios,680,3,1,1,4,4,10,-6,4
AEK Athens,681,1,4,2,0,7,1,6,14
PAOK Salonik,681,2,2,3,1,10,5,5,9
P'thinaikos,681,3,1,2,3,5,10,-5,5
Panionios,681,4,1,1,4,4,10,-6,4
AEK Athens,682,1,4,2,0,7,1,6,14
PAOK Salonik,682,2,2,2,2,11,7,4,8
P'thinaikos,682,3,2,1,3,7,11,-4,7
Panionios,682,4,1,1,4,4,10,-6,4
AEK Athens,683,1,4,2,0,7,1,6,14
PAOK Salonik,683,2,3,2,1,12,5,7,11
Panionios,683,3,1,1,4,4,10,-6,4
P'thinaikos,683,4,1,1,4,5,12,-7,4
AEK Athens,684,1,4,2,0,7,1,6,14
PAOK Salonik,684,2,3,2,1,10,4,6,11
P'thinaikos,684,3,1,1,4,4,10,-6,4
Panionios,684,3,1,1,4,4,10,-6,4
AEK Athens,685,1,4,2,0,7,1,6,14
PAOK Salonik,685,2,2,2,2,9,6,3,8
P'thinaikos,685,3,2,1,3,6,9,-3,7
Panionios,685,4,1,1,4,4,10,-6,4
AEK Athens,686,1,4,2,0,7,1,6,14
PAOK Salonik,686,2,2,2,2,9,5,4,8
P'thinaikos,686,3,2,1,3,5,9,-4,7
Panionios,686,4,1,1,4,4,10,-6,4
AEK Athens,687,1,4,2,0,7,1,6,14
PAOK Salonik,687,2,2,3,1,9,4,5,9
P'thinaikos,687,3,1,2,3,4,9,-5,5
Panionios,687,4,1,1,4,4,10,-6,4
AEK Athens,688,1,4,2,0,7,1,6,14
PAOK Salonik,688,2,3,2,1,10,4,6,11
P'thinaikos,688,3,1,1,4,4,10,-6,4
Panionios,688,3,1,1,4,4,10,-6,4
AEK Athens,689,1,4,2,0,7,1,6,14
PAOK Salonik,689,2,2,2,2,10,6,4,8
P'thinaikos,689,3,2,1,3,6,10,-4,7
Panionios,689,4,1,1,4,4,10,-6,4
AEK Athens,690,1,4,2,0,7,1,6,14
PAOK Salonik,690,2,2,3,1,9,4,5,9
P'thinaikos,690,3,1,2,3,4,9,-5,5
Panionios,690,4,1,1,4,4,10,-6,4
AEK Athens,691,1,4,2,0,7,1,6,14
PAOK Salonik,691,2,2,2,2,11,8,3,8
P'thinaikos,691,3,2,1,3,8,11,-3,7
Panionios,691,4,1,1,4,4,10,-6,4
AEK Athens,692,1,4,2,0,7,1,6,14
PAOK Salonik,692,2,2,2,2,9,6,3,8
P'thinaikos,692,3,2,1,3,6,9,-3,7
Panionios,692,4,1,1,4,4,10,-6,4
AEK Athens,693,1,4,2,0,7,1,6,14
PAOK Salonik,693,2,2,2,2,11,7,4,8
P'thinaikos,693,3,2,1,3,7,11,-4,7
Panionios,693,4,1,1,4,4,10,-6,4
AEK Athens,694,1,4,2,0,7,1,6,14
PAOK Salonik,694,2,2,2,2,9,5,4,8
P'thinaikos,694,3,2,1,3,5,9,-4,7
Panionios,694,4,1,1,4,4,10,-6,4
AEK Athens,695,1,4,2,0,7,1,6,14
PAOK Salonik,695,2,2,2,2,10,6,4,8
P'thinaikos,695,3,2,1,3,6,10,-4,7
Panionios,695,4,1,1,4,4,10,-6,4
AEK Athens,696,1,4,2,0,7,1,6,14
PAOK Salonik,696,2,2,3,1,10,5,5,9
P'thinaikos,696,3,1,2,3,5,10,-5,5
Panionios,696,4,1,1,4,4,10,-6,4
AEK Athens,697,1,4,2,0,7,1,6,14
PAOK Salonik,697,2,2,2,2,9,5,4,8
P'thinaikos,697,3,2,1,3,5,9,-4,7
Panionios,697,4,1,1,4,4,10,-6,4
AEK Athens,698,1,4,2,0,7,1,6,14
PAOK Salonik,698,2,2,3,1,10,5,5,9
P'thinaikos,698,3,1,2,3,5,10,-5,5
Panionios,698,4,1,1,4,4,10,-6,4
AEK Athens,699,1,4,2,0,7,1,6,14
PAOK Salonik,699,2,3,2,1,12,5,7,11
Panionios,699,3,1,1,4,4,10,-6,4
P'thinaikos,699,4,1,1,4,5,12,-7,4
AEK Athens,700,1,4,2,0,7,1,6,14
PAOK Salonik,700,2,3,2,1,11,5,6,11
P'thinaikos,700,3,1,1,4,5,11,-6,4
Panionios,700,4,1,1,4,4,10,-6,4
AEK Athens,701,1,4,2,0,7,1,6,14
PAOK Salonik,701,2,3,2,1,11,4,7,11
Panionios,701,3,1,1,4,4,10,-6,4
P'thinaikos,701,4,1,1,4,4,11,-7,4
AEK Athens,702,1,4,2,0,7,1,6,14
PAOK Salonik,702,2,2,2,2,9,7,2,8
P'thinaikos,702,3,2,1,3,7,9,-2,7
Panionios,702,4,1,1,4,4,10,-6,4
AEK Athens,703,1,4,2,0,7,1,6,14
PAOK Salonik,703,2,2,2,2,11,7,4,8
P'thinaikos,703,3,2,1,3,7,11,-4,7
Panionios,703,4,1,1,4,4,10,-6,4
AEK Athens,704,1,4,2,0,7,1,6,14
PAOK Salonik,704,2,2,2,2,10,6,4,8
P'thinaikos,704,3,2,1,3,6,10,-4,7
Panionios,704,4,1,1,4,4,10,-6,4
AEK Athens,705,1,4,2,0,7,1,6,14
PAOK Salonik,705,2,2,2,2,9,5,4,8
P'thinaikos,705,3,2,1,3,5,9,-4,7
Panionios,705,4,1,1,4,4,10,-6,4
AEK Athens,706,1,4,2,0,7,1,6,14
PAOK Salonik,706,2,2,3,1,11,6,5,9
P'thinaikos,706,3,1,2,3,6,11,-5,5
Panionios,706,4,1,1,4,4,10,-6,4
AEK Athens,707,1,4,2,0,7,1,6,14
PAOK Salonik,707,2,2,3,1,10,5,5,9
P'thinaikos,707,3,1,2,3,5,10,-5,5
Panionios,707,4,1,1,4,4,10,-6,4
AEK Athens,708,1,4,2,0,7,1,6,14
PAOK Salonik,708,2,2,2,2,10,7,3,8
P'thinaikos,708,3,2,1,3,7,10,-3,7
Panionios,708,4,1,1,4,4,10,-6,4
AEK Athens,709,1,4,2,0,7,1,6,14
PAOK Salonik,709,2,2,3,1,9,4,5,9
P'thinaikos,709,3,1,2,3,4,9,-5,5
Panionios,709,4,1,1,4,4,10,-6,4
AEK Athens,710,1,4,2,0,7,1,6,14
PAOK Salonik,710,2,2,2,2,9,7,2,8
P'thinaikos,710,3,2,1,3,7,9,-2,7
Panionios,710,4,1,1,4,4,10,-6,4
AEK Athens,711,1,4,2,0,7,1,6,14
PAOK Salonik,711,2,3,2,1,11,5,6,11
P'thinaikos,711,3,1,1,4,5,11,-6,4
Panionios,711,4,1,1,4,4,10,-6,4
AEK Athens,712,1,4,2,0,7,1,6,14
PAOK Salonik,712,2,3,2,1,10,4,6,11
P'thinaikos,712,3,1,1,4,4,10,-6,4
Panionios,712,3,1,1,4,4,10,-6,4
AEK Athens,713,1,4,2,0,7,1,6,14
PAOK Salonik,713,2,3,2,1,12,6,6,11
P'thinaikos,713,3,1,1,4,6,12,-6,4
Panionios,713,4,1,1,4,4,10,-6,4
AEK Athens,714,1,4,2,0,7,1,6,14
PAOK Salonik,714,2,3,2,1,11,5,6,11
P'thinaikos,714,3,1,1,4,5,11,-6,4
Panionios,714,4,1,1,4,4,10,-6,4
AEK Athens,715,1,4,2,0,7,1,6,14
PAOK Salonik,715,2,2,2,2,10,8,2,8
P'thinaikos,715,3,2,1,3,8,10,-2,7
Panionios,715,4,1,1,4,4,10,-6,4
AEK Athens,716,1,4,2,0,7,1,6,14
PAOK Salonik,716,2,3,2,1,12,5,7,11
Panionios,716,3,1,1,4,4,10,-6,4
P'thinaikos,716,4,1,1,4,5,12,-7,4
AEK Athens,717,1,4,2,0,7,1,6,14
PAOK Salonik,717,2,2,3,1,10,5,5,9
P'thinaikos,717,3,1,2,3,5,10,-5,5
Panionios,717,4,1,1,4,4,10,-6,4
AEK Athens,718,1,4,2,0,7,1,6,14
PAOK Salonik,718,2,3,2,1,11,5,6,11
P'thinaikos,718,3,1,1,4,5,11,-6,4
Panionios,718,4,1,1,4,4,10,-6,4
AEK Athens,719,1,4,2,0,7,1,6,14
PAOK Salonik,719,2,3,2,1,10,4,6,11
P'thinaikos,719,3,1,1,4,4,10,-6,4
Panionios,719,3,1,1,4,4,10,-6,4
AEK Athens,720,1,4,2,0,7,1,6,14
PAOK Salonik,720,2,2,3,1,11,6,5,9
P'thinaikos,720,3,1,2,3,6,11,-5,5
Panionios,720,4,1,1,4,4,10,-6,4
AEK Athens,721,1,4,2,0,7,1,6,14
PAOK Salonik,721,2,3,2,1,12,6,6,11
P'thinaikos,721,3,1,1,4,6,12,-6,4
Panionios,721,4,1,1,4,4,10,-6,4
AEK Athens,722,1,4,2,0,7,1,6,14
PAOK Salonik,722,2,2,2,2,10,10,0,8
P'thinaikos,722,3,2,1,3,10,10,0,7
Panionios,722,4,1,1,4,4,10,-6,4
AEK Athens,723,1,4,2,0,7,1,6,14
PAOK Salonik,723,2,2,3,1,10,5,5,9
P'thinaikos,723,3,1,2,3,5,10,-5,5
Panionios,723,4,1,1,4,4,10,-6,4
AEK Athens,724,1,4,2,0,7,1,6,14
PAOK Salonik,724,2,2,3,1,11,6,5,9
P'thinaikos,724,3,1,2,3,6,11,-5,5
Panionios,724,4,1,1,4,4,10,-6,4
AEK Athens,725,1,4,2,0,7,1,6,14
PAOK Salonik,725,2,3,2,1,11,5,6,11
P'thinaikos,725,3,1,1,4,5,11,-6,4
Panionios,725,4,1,1,4,4,10,-6,4
AEK Athens,726,1,4,2,0,7,1,6,14
PAOK Salonik,726,2,2,2,2,9,5,4,8
P'thinaikos,726,3,2,1,3,5,9,-4,7
Panionios,726,4,1,1,4,4,10,-6,4
AEK Athens,727,1,4,2,0,7,1,6,14
PAOK Salonik,727,2,3,2,1,10,4,6,11
P'thinaikos,727,3,1,1,4,4,10,-6,4
Panionios,727,3,1,1,4,4,10,-6,4
AEK Athens,728,1,4,2,0,7,1,6,14
PAOK Salonik,728,2,2,2,2,10,6,4,8
P'thinaikos,728,3,2,1,3,6,10,-4,7
Panionios,728,4,1,1,4,4,10,-6,4
AEK Athens,729,1,4,2,0,7,1,6,14
PAOK Salonik,729,2,2,2,2,9,6,3,8
P'thinaikos,729,3,2,1,3,6,9,-3,7
Panionios,729,4,1,1,4,4,10,-6,4
AEK Athens,730,1,4,2,0,7,1,6,14
PAOK Salonik,730,2,2,2,2,11,7,4,8
P'thinaikos,730,3,2,1,3,7,11,-4,7
Panionios,730,4,1,1,4,4,10,-6,4
AEK Athens,731,1,4,2,0,7,1,6,14
PAOK Salonik,731,2,3,2,1,11,4,7,11
Panionios,731,3,1,1,4,4,10,-6,4
P'thinaikos,731,4,1,1,4,4,11,-7,4
AEK Athens,732,1,4,2,0,7,1,6,14
PAOK Salonik,732,2,2,2,2,10,6,4,8
P'thinaikos,732,3,2,1,3,6,10,-4,7
Panionios,732,4,1,1,4,4,10,-6,4
AEK Athens,733,1,4,2,0,7,1,6,14
PAOK Salonik,733,2,2,2,2,10,6,4,8
P'thinaikos,733,3,2,1,3,6,10,-4,7
Panionios,733,4,1,1,4,4,10,-6,4
AEK Athens,734,1,4,2,0,7,1,6,14
PAOK Salonik,734,2,2,2,2,9,5,4,8
P'thinaikos,734,3,2,1,3,5,9,-4,7
Panionios,734,4,1,1,4,4,10,-6,4
AEK Athens,735,1,4,2,0,7,1,6,14
PAOK Salonik,735,2,3,2,1,11,4,7,11
Panionios,735,3,1,1,4,4,10,-6,4
P'thinaikos,735,4,1,1,4,4,11,-7,4
AEK Athens,736,1,4,2,0,7,1,6,14
PAOK Salonik,736,2,2,3,1,10,5,5,9
P'thinaikos,736,3,1,2,3,5,10,-5,5
Panionios,736,4,1,1,4,4,10,-6,4
AEK Athens,737,1,4,2,0,7,1,6,14
PAOK Salonik,737,2,2,2,2,9,6,3,8
P'thinaikos,737,3,2,1,3,6,9,-3,7
Panionios,737,4,1,1,4,4,10,-6,4
AEK Athens,738,1,4,2,0,7,1,6,14
PAOK Salonik,738,2,2,3,1,11,6,5,9
P'thinaikos,738,3,1,2,3,6,11,-5,5
Panionios,738,4,1,1,4,4,10,-6,4
AEK Athens,739,1,4,2,0,7,1,6,14
PAOK Salonik,739,2,2,3,1,9,4,5,9
P'thinaikos,739,3,1,2,3,4,9,-5,5
Panionios,739,4,1,1,4,4,10,-6,4
AEK Athens,740,1,4,2,0,7,1,6,14
PAOK Salonik,740,2,2,3,1,11,6,5,9
P'thinaikos,740,3,1,2,3,6,11,-5,5
Panionios,740,4,1,1,4,4,10,-6,4
AEK Athens,741,1,4,2,0,7,1,6,14
PAOK Salonik,741,2,2,2,2,10,8,2,8
P'thinaikos,741,3,2,1,3,8,10,-2,7
Panionios,741,4,1,1,4,4,10,-6,4
AEK Athens,742,1,4,2,0,7,1,6,14
PAOK Salonik,742,2,2,2,2,10,7,3,8
P'thinaikos,742,3,2,1,3,7,10,-3,7
Panionios,742,4,1,1,4,4,10,-6,4
AEK Athens,743,1,4,2,0,7,1,6,14
PAOK Salonik,743,2,3,2,1,11,4,7,11
Panionios,743,3,1,1,4,4,10,-6,4
P'thinaikos,743,4,1,1,4,4,11,-7,4
AEK Athens,744,1,4,2,0,7,1,6,14
PAOK Salonik,744,2,2,2,2,11,7,4,8
P'thinaikos,744,3,2,1,3,7,11,-4,7
Panionios,744,4,1,1,4,4,10,-6,4
AEK Athens,745,1,4,2,0,7,1,6,14
PAOK Salonik,745,2,2,2,2,9,5,4,8
P'thinaikos,745,3,2,1,3,5,9,-4,7
Panionios,745,4,1,1,4,4,10,-6,4
AEK Athens,746,1,4,2,0,7,1,6,14
PAOK Salonik,746,2,2,2,2,9,5,4,8
P'thinaikos,746,3,2,1,3,5,9,-4,7
Panionios,746,4,1,1,4,4,10,-6,4
AEK Athens,747,1,4,2,0,7,1,6,14
PAOK Salonik,747,2,3,2,1,10,4,6,11
P'thinaikos,747,3,1,1,4,4,10,-6,4
Panionios,747,3,1,1,4,4,10,-6,4
AEK Athens,748,1,4,2,0,7,1,6,14
PAOK Salonik,748,2,2,3,1,11,6,5,9
P'thinaikos,748,3,1,2,3,6,11,-5,5
Panionios,748,4,1,1,4,4,10,-6,4
AEK Athens,749,1,4,2,0,7,1,6,14
PAOK Salonik,749,2,3,2,1,11,5,6,11
P'thinaikos,749,3,1,1,4,5,11,-6,4
Panionios,749,4,1,1,4,4,10,-6,4
AEK Athens,750,1,4,2,0,7,1,6,14
PAOK Salonik,750,2,2,2,2,9,8,1,8
P'thinaikos,750,3,2,1,3,8,9,-1,7
Panionios,750,4,1,1,4,4,10,-6,4
AEK Athens,751,1,4,2,0,7,1,6,14
PAOK Salonik,751,2,2,2,2,9,9,0,8
P'thinaikos,751,3,2,1,3,9,9,0,7
Panionios,751,4,1,1,4,4,10,-6,4
AEK Athens,752,1,4,2,0,7,1,6,14
PAOK Salonik,752,2,2,2,2,9,7,2,8
P'thinaikos,752,3,2,1,3,7,9,-2,7
Panionios,752,4,1,1,4,4,10,-6,4
AEK Athens,753,1,4,2,0,7,1,6,14
PAOK Salonik,753,2,2,3,1,9,4,5,9
P'thinaikos,753,3,1,2,3,4,9,-5,5
Panionios,753,4,1,1,4,4,10,-6,4
AEK Athens,754,1,4,2,0,7,1,6,14
PAOK Salonik,754,2,2,2,2,9,5,4,8
P'thinaikos,754,3,2,1,3,5,9,-4,7
Panionios,754,4,1,1,4,4,10,-6,4
AEK Athens,755,1,4,2,0,7,1,6,14
PAOK Salonik,755,2,3,2,1,11,4,7,11
Panionios,755,3,1,1,4,4,10,-6,4
P'thinaikos,755,4,1,1,4,4,11,-7,4
AEK Athens,756,1,4,2,0,7,1,6,14
PAOK Salonik,756,2,2,3,1,10,5,5,9
P'thinaikos,756,3,1,2,3,5,10,-5,5
Panionios,756,4,1,1,4,4,10,-6,4
AEK Athens,757,1,4,2,0,7,1,6,14
PAOK Salonik,757,2,3,2,1,12,4,8,11
Panionios,757,3,1,1,4,4,10,-6,4
P'thinaikos,757,4,1,1,4,4,12,-8,4
AEK Athens,758,1,4,2,0,7,1,6,14
PAOK Salonik,758,2,2,2,2,10,6,4,8
P'thinaikos,758,3,2,1,3,6,10,-4,7
Panionios,758,4,1,1,4,4,10,-6,4
AEK Athens,759,1,4,2,0,7,1,6,14
PAOK Salonik,759,2,3,2,1,11,5,6,11
P'thinaikos,759,3,1,1,4,5,11,-6,4
Panionios,759,4,1,1,4,4,10,-6,4
AEK Athens,760,1,4,2,0,7,1,6,14
PAOK Salonik,760,2,2,3,1,10,5,5,9
P'thinaikos,760,3,1,2,3,5,10,-5,5
Panionios,760,4,1,1,4,4,10,-6,4
AEK Athens,761,1,4,2,0,7,1,6,14
PAOK Salonik,761,2,3,2,1,11,4,7,11
Panionios,761,3,1,1,4,4,10,-6,4
P'thinaikos,761,4,1,1,4,4,11,-7,4
AEK Athens,762,1,4,2,0,7,1,6,14
PAOK Salonik,762,2,2,3,1,10,5,5,9
P'thinaikos,762,3,1,2,3,5,10,-5,5
Panionios,762,4,1,1,4,4,10,-6,4
AEK Athens,763,1,4,2,0,7,1,6,14
PAOK Salonik,763,2,2,2,2,12,8,4,8
P'thinaikos,763,3,2,1,3,8,12,-4,7
Panionios,763,4,1,1,4,4,10,-6,4
AEK Athens,764,1,4,2,0,7,1,6,14
PAOK Salonik,764,2,2,2,2,9,7,2,8
P'thinaikos,764,3,2,1,3,7,9,-2,7
Panionios,764,4,1,1,4,4,10,-6,4
AEK Athens,765,1,4,2,0,7,1,6,14
PAOK Salonik,765,2,2,3,1,11,6,5,9
P'thinaikos,765,3,1,2,3,6,11,-5,5
Panionios,765,4,1,1,4,4,10,-6,4
AEK Athens,766,1,4,2,0,7,1,6,14
PAOK Salonik,766,2,2,3,1,9,4,5,9
P'thinaikos,766,3,1,2,3,4,9,-5,5
Panionios,766,4,1,1,4,4,10,-6,4
AEK Athens,767,1,4,2,0,7,1,6,14
PAOK Salonik,767,2,3,2,1,11,4,7,11
Panionios,767,3,1,1,4,4,10,-6,4
P'thinaikos,767,4,1,1,4,4,11,-7,4
AEK Athens,768,1,4,2,0,7,1,6,14
PAOK Salonik,768,2,2,3,1,9,4,5,9
P'thinaikos,768,3,1,2,3,4,9,-5,5
Panionios,768,4,1,1,4,4,10,-6,4
AEK Athens,769,1,4,2,0,7,1,6,14
PAOK Salonik,769,2,2,3,1,10,5,5,9
P'thinaikos,769,3,1,2,3,5,10,-5,5
Panionios,769,4,1,1,4,4,10,-6,4
AEK Athens,770,1,4,2,0,7,1,6,14
PAOK Salonik,770,2,2,2,2,11,7,4,8
P'thinaikos,770,3,2,1,3,7,11,-4,7
Panionios,770,4,1,1,4,4,10,-6,4
AEK Athens,771,1,4,2,0,7,1,6,14
PAOK Salonik,771,2,2,3,1,10,5,5,9
P'thinaikos,771,3,1,2,3,5,10,-5,5
Panionios,771,4,1,1,4,4,10,-6,4
AEK Athens,772,1,4,2,0,7,1,6,14
PAOK Salonik,772,2,2,2,2,11,7,4,8
P'thinaikos,772,3,2,1,3,7,11,-4,7
Panionios,772,4,1,1,4,4,10,-6,4
AEK Athens,773,1,4,2,0,7,1,6,14
PAOK Salonik,773,2,2,3,1,10,5,5,9
P'thinaikos,773,3,1,2,3,5,10,-5,5
Panionios,773,4,1,1,4,4,10,-6,4
AEK Athens,774,1,4,2,0,7,1,6,14
PAOK Salonik,774,2,2,2,2,10,6,4,8
P'thinaikos,774,3,2,1,3,6,10,-4,7
Panionios,774,4,1,1,4,4,10,-6,4
AEK Athens,775,1,4,2,0,7,1,6,14
PAOK Salonik,775,2,3,2,1,11,4,7,11
Panionios,775,3,1,1,4,4,10,-6,4
P'thinaikos,775,4,1,1,4,4,11,-7,4
AEK Athens,776,1,4,2,0,7,1,6,14
PAOK Salonik,776,2,2,2,2,9,5,4,8
P'thinaikos,776,3,2,1,3,5,9,-4,7
Panionios,776,4,1,1,4,4,10,-6,4
AEK Athens,777,1,4,2,0,7,1,6,14
PAOK Salonik,777,2,3,2,1,11,5,6,11
P'thinaikos,777,3,1,1,4,5,11,-6,4
Panionios,777,4,1,1,4,4,10,-6,4
AEK Athens,778,1,4,2,0,7,1,6,14
PAOK Salonik,778,2,2,2,2,9,5,4,8
P'thinaikos,778,3,2,1,3,5,9,-4,7
Panionios,778,4,1,1,4,4,10,-6,4
AEK Athens,779,1,4,2,0,7,1,6,14
PAOK Salonik,779,2,3,2,1,10,4,6,11
P'thinaikos,779,3,1,1,4,4,10,-6,4
Panionios,779,3,1,1,4,4,10,-6,4
AEK Athens,780,1,4,2,0,7,1,6,14
PAOK Salonik,780,2,2,3,1,10,5,5,9
P'thinaikos,780,3,1,2,3,5,10,-5,5
Panionios,780,4,1,1,4,4,10,-6,4
AEK Athens,781,1,4,2,0,7,1,6,14
PAOK Salonik,781,2,2,3,1,9,4,5,9
P'thinaikos,781,3,1,2,3,4,9,-5,5
Panionios,781,4,1,1,4,4,10,-6,4
AEK Athens,782,1,4,2,0,7,1,6,14
PAOK Salonik,782,2,3,2,1,10,4,6,11
P'thinaikos,782,3,1,1,4,4,10,-6,4
Panionios,782,3,1,1,4,4,10,-6,4
AEK Athens,783,1,4,2,0,7,1,6,14
PAOK Salonik,783,2,2,2,2,9,5,4,8
P'thinaikos,783,3,2,1,3,5,9,-4,7
Panionios,783,4,1,1,4,4,10,-6,4
AEK Athens,784,1,4,2,0,7,1,6,14
PAOK Salonik,784,2,3,2,1,10,4,6,11
P'thinaikos,784,3,1,1,4,4,10,-6,4
Panionios,784,3,1,1,4,4,10,-6,4
AEK Athens,785,1,4,2,0,7,1,6,14
PAOK Salonik,785,2,2,3,1,11,6,5,9
P'thinaikos,785,3,1,2,3,6,11,-5,5
Panionios,785,4,1,1,4,4,10,-6,4
AEK Athens,786,1,4,2,0,7,1,6,14
PAOK Salonik,786,2,2,2,2,9,5,4,8
P'thinaikos,786,3,2,1,3,5,9,-4,7
Panionios,786,4,1,1,4,4,10,-6,4
AEK Athens,787,1,4,2,0,7,1,6,14
PAOK Salonik,787,2,3,2,1,10,4,6,11
P'thinaikos,787,3,1,1,4,4,10,-6,4
Panionios,787,3,1,1,4,4,10,-6,4
AEK Athens,788,1,4,2,0,7,1,6,14
PAOK Salonik,788,2,2,3,1,10,5,5,9
P'thinaikos,788,3,1,2,3,5,10,-5,5
Panionios,788,4,1,1,4,4,10,-6,4
AEK Athens,789,1,4,2,0,7,1,6,14
PAOK Salonik,789,2,2,3,1,11,6,5,9
P'thinaikos,789,3,1,2,3,6,11,-5,5
Panionios,789,4,1,1,4,4,10,-6,4
AEK Athens,790,1,4,2,0,7,1,6,14
PAOK Salonik,790,2,3,2,1,10,4,6,11
P'thinaikos,790,3,1,1,4,4,10,-6,4
Panionios,790,3,1,1,4,4,10,-6,4
AEK Athens,791,1,4,2,0,7,1,6,14
PAOK Salonik,791,2,2,2,2,9,6,3,8
P'thinaikos,791,3,2,1,3,6,9,-3,7
Panionios,791,4,1,1,4,4,10,-6,4
AEK Athens,792,1,4,2,0,7,1,6,14
PAOK Salonik,792,2,2,2,2,9,5,4,8
P'thinaikos,792,3,2,1,3,5,9,-4,7
Panionios,792,4,1,1,4,4,10,-6,4
AEK Athens,793,1,4,2,0,7,1,6,14
PAOK Salonik,793,2,2,2,2,10,9,1,8
P'thinaikos,793,3,2,1,3,9,10,-1,7
Panionios,793,4,1,1,4,4,10,-6,4
AEK Athens,794,1,4,2,0,7,1,6,14
PAOK Salonik,794,2,3,2,1,10,4,6,11
P'thinaikos,794,3,1,1,4,4,10,-6,4
Panionios,794,3,1,1,4,4,10,-6,4
AEK Athens,795,1,4,2,0,7,1,6,14
PAOK Salonik,795,2,2,3,1,9,4,5,9
P'thinaikos,795,3,1,2,3,4,9,-5,5
Panionios,795,4,1,1,4,4,10,-6,4
AEK Athens,796,1,4,2,0,7,1,6,14
PAOK Salonik,796,2,2,3,1,9,4,5,9
P'thinaikos,796,3,1,2,3,4,9,-5,5
Panionios,796,4,1,1,4,4,10,-6,4
AEK Athens,797,1,4,2,0,7,1,6,14
PAOK Salonik,797,2,2,3,1,10,5,5,9
P'thinaikos,797,3,1,2,3,5,10,-5,5
Panionios,797,4,1,1,4,4,10,-6,4
AEK Athens,798,1,4,2,0,7,1,6,14
PAOK Salonik,798,2,2,2,2,10,6,4,8
P'thinaikos,798,3,2,1,3,6,10,-4,7
Panionios,798,4,1,1,4,4,10,-6,4
AEK Athens,799,1,4,2,0,7,1,6,14
PAOK Salonik,799,2,2,3,1,10,5,5,9
P'thinaikos,799,3,1,2,3,5,10,-5,5
Panionios,799,4,1,1,4,4,10,-6,4
AEK Athens,800,1,4,2,0,7,1,6,14
PAOK Salonik,800,2,2,3,1,10,5,5,9
P'thinaikos,800,3,1,2,3,5,10,-5,5
Panionios,800,4,1,1,4,4,10,-6,4
AEK Athens,801,1,4,2,0,7,1,6,14
PAOK Salonik,801,2,2,2,2,10,6,4,8
P'thinaikos,801,3,2,1,3,6,10,-4,7
Panionios,801,4,1,1,4,4,10,-6,4
AEK Athens,802,1,4,2,0,7,1,6,14
PAOK Salonik,802,2,3,2,1,11,5,6,11
P'thinaikos,802,3,1,1,4,5,11,-6,4
Panionios,802,4,1,1,4,4,10,-6,4
AEK Athens,803,1,4,2,0,7,1,6,14
PAOK Salonik,803,2,2,2,2,9,6,3,8
P'thinaikos,803,3,2,1,3,6,9,-3,7
Panionios,803,4,1,1,4,4,10,-6,4
AEK Athens,804,1,4,2,0,7,1,6,14
PAOK Salonik,804,2,2,2,2,10,6,4,8
P'thinaikos,804,3,2,1,3,6,10,-4,7
Panionios,804,4,1,1,4,4,10,-6,4
AEK Athens,805,1,4,2,0,7,1,6,14
PAOK Salonik,805,2,3,2,1,10,4,6,11
P'thinaikos,805,3,1,1,4,4,10,-6,4
Panionios,805,3,1,1,4,4,10,-6,4
AEK Athens,806,1,4,2,0,7,1,6,14
PAOK Salonik,806,2,2,3,1,10,5,5,9
P'thinaikos,806,3,1,2,3,5,10,-5,5
Panionios,806,4,1,1,4,4,10,-6,4
AEK Athens,807,1,4,2,0,7,1,6,14
PAOK Salonik,807,2,2,3,1,10,5,5,9
P'thinaikos,807,3,1,2,3,5,10,-5,5
Panionios,807,4,1,1,4,4,10,-6,4
AEK Athens,808,1,4,2,0,7,1,6,14
PAOK Salonik,808,2,3,2,1,10,4,6,11
P'thinaikos,808,3,1,1,4,4,10,-6,4
Panionios,808,3,1,1,4,4,10,-6,4
AEK Athens,809,1,4,2,0,7,1,6,14
PAOK Salonik,809,2,2,3,1,9,4,5,9
P'thinaikos,809,3,1,2,3,4,9,-5,5
Panionios,809,4,1,1,4,4,10,-6,4
AEK Athens,810,1,4,2,0,7,1,6,14
PAOK Salonik,810,2,3,2,1,12,4,8,11
Panionios,810,3,1,1,4,4,10,-6,4
P'thinaikos,810,4,1,1,4,4,12,-8,4
AEK Athens,811,1,4,2,0,7,1,6,14
PAOK Salonik,811,2,2,2,2,10,6,4,8
P'thinaikos,811,3,2,1,3,6,10,-4,7
Panionios,811,4,1,1,4,4,10,-6,4
AEK Athens,812,1,4,2,0,7,1,6,14
PAOK Salonik,812,2,2,3,1,10,5,5,9
P'thinaikos,812,3,1,2,3,5,10,-5,5
Panionios,812,4,1,1,4,4,10,-6,4
AEK Athens,813,1,4,2,0,7,1,6,14
PAOK Salonik,813,2,2,3,1,10,5,5,9
P'thinaikos,813,3,1,2,3,5,10,-5,5
Panionios,813,4,1,1,4,4,10,-6,4
AEK Athens,814,1,4,2,0,7,1,6,14
PAOK Salonik,814,2,3,2,1,10,4,6,11
P'thinaikos,814,3,1,1,4,4,10,-6,4
Panionios,814,3,1,1,4,4,10,-6,4
AEK Athens,815,1,4,2,0,7,1,6,14
PAOK Salonik,815,2,2,2,2,12,8,4,8
P'thinaikos,815,3,2,1,3,8,12,-4,7
Panionios,815,4,1,1,4,4,10,-6,4
AEK Athens,816,1,4,2,0,7,1,6,14
PAOK Salonik,816,2,2,2,2,10,6,4,8
P'thinaikos,816,3,2,1,3,6,10,-4,7
Panionios,816,4,1,1,4,4,10,-6,4
AEK Athens,817,1,4,2,0,7,1,6,14
PAOK Salonik,817,2,2,2,2,9,5,4,8
P'thinaikos,817,3,2,1,3,5,9,-4,7
Panionios,817,4,1,1,4,4,10,-6,4
AEK Athens,818,1,4,2,0,7,1,6,14
PAOK Salonik,818,2,2,3,1,9,4,5,9
P'thinaikos,818,3,1,2,3,4,9,-5,5
Panionios,818,4,1,1,4,4,10,-6,4
AEK Athens,819,1,4,2,0,7,1,6,14
PAOK Salonik,819,2,3,2,1,11,5,6,11
P'thinaikos,819,3,1,1,4,5,11,-6,4
Panionios,819,4,1,1,4,4,10,-6,4
AEK Athens,820,1,4,2,0,7,1,6,14
PAOK Salonik,820,2,3,2,1,12,4,8,11
Panionios,820,3,1,1,4,4,10,-6,4
P'thinaikos,820,4,1,1,4,4,12,-8,4
AEK Athens,821,1,4,2,0,7,1,6,14
PAOK Salonik,821,2,2,3,1,9,4,5,9
P'thinaikos,821,3,1,2,3,4,9,-5,5
Panionios,821,4,1,1,4,4,10,-6,4
AEK Athens,822,1,4,2,0,7,1,6,14
PAOK Salonik,822,2,3,2,1,12,5,7,11
Panionios,822,3,1,1,4,4,10,-6,4
P'thinaikos,822,4,1,1,4,5,12,-7,4
AEK Athens,823,1,4,2,0,7,1,6,14
PAOK Salonik,823,2,2,2,2,10,7,3,8
P'thinaikos,823,3,2,1,3,7,10,-3,7
Panionios,823,4,1,1,4,4,10,-6,4
AEK Athens,824,1,4,2,0,7,1,6,14
PAOK Salonik,824,2,3,2,1,11,5,6,11
P'thinaikos,824,3,1,1,4,5,11,-6,4
Panionios,824,4,1,1,4,4,10,-6,4
AEK Athens,825,1,4,2,0,7,1,6,14
PAOK Salonik,825,2,3,2,1,11,5,6,11
P'thinaikos,825,3,1,1,4,5,11,-6,4
Panionios,825,4,1,1,4,4,10,-6,4
AEK Athens,826,1,4,2,0,7,1,6,14
PAOK Salonik,826,2,2,3,1,9,4,5,9
P'thinaikos,826,3,1,2,3,4,9,-5,5
Panionios,826,4,1,1,4,4,10,-6,4
AEK Athens,827,1,4,2,0,7,1,6,14
PAOK Salonik,827,2,2,3,1,11,6,5,9
P'thinaikos,827,3,1,2,3,6,11,-5,5
Panionios,827,4,1,1,4,4,10,-6,4
AEK Athens,828,1,4,2,0,7,1,6,14
PAOK Salonik,828,2,2,2,2,10,7,3,8
P'thinaikos,828,3,2,1,3,7,10,-3,7
Panionios,828,4,1,1,4,4,10,-6,4
AEK Athens,829,1,4,2,0,7,1,6,14
PAOK Salonik,829,2,2,3,1,9,4,5,9
P'thinaikos,829,3,1,2,3,4,9,-5,5
Panionios,829,4,1,1,4,4,10,-6,4
AEK Athens,830,1,4,2,0,7,1,6,14
PAOK Salonik,830,2,3,2,1,10,4,6,11
P'thinaikos,830,3,1,1,4,4,10,-6,4
Panionios,830,3,1,1,4,4,10,-6,4
AEK Athens,831,1,4,2,0,7,1,6,14
PAOK Salonik,831,2,2,3,1,9,4,5,9
P'thinaikos,831,3,1,2,3,4,9,-5,5
Panionios,831,4,1,1,4,4,10,-6,4
AEK Athens,832,1,4,2,0,7,1,6,14
PAOK Salonik,832,2,2,2,2,9,5,4,8
P'thinaikos,832,3,2,1,3,5,9,-4,7
Panionios,832,4,1,1,4,4,10,-6,4
AEK Athens,833,1,4,2,0,7,1,6,14
PAOK Salonik,833,2,2,2,2,9,6,3,8
P'thinaikos,833,3,2,1,3,6,9,-3,7
Panionios,833,4,1,1,4,4,10,-6,4
AEK Athens,834,1,4,2,0,7,1,6,14
PAOK Salonik,834,2,2,2,2,11,7,4,8
P'thinaikos,834,3,2,1,3,7,11,-4,7
Panionios,834,4,1,1,4,4,10,-6,4
AEK Athens,835,1,4,2,0,7,1,6,14
PAOK Salonik,835,2,2,3,1,9,4,5,9
P'thinaikos,835,3,1,2,3,4,9,-5,5
Panionios,835,4,1,1,4,4,10,-6,4
AEK Athens,836,1,4,2,0,7,1,6,14
PAOK Salonik,836,2,3,2,1,11,5,6,11
P'thinaikos,836,3,1,1,4,5,11,-6,4
Panionios,836,4,1,1,4,4,10,-6,4
AEK Athens,837,1,4,2,0,7,1,6,14
PAOK Salonik,837,2,2,2,2,10,7,3,8
P'thinaikos,837,3,2,1,3,7,10,-3,7
Panionios,837,4,1,1,4,4,10,-6,4
AEK Athens,838,1,4,2,0,7,1,6,14
PAOK Salonik,838,2,2,3,1,11,6,5,9
P'thinaikos,838,3,1,2,3,6,11,-5,5
Panionios,838,4,1,1,4,4,10,-6,4
AEK Athens,839,1,4,2,0,7,1,6,14
PAOK Salonik,839,2,3,2,1,13,4,9,11
Panionios,839,3,1,1,4,4,10,-6,4
P'thinaikos,839,4,1,1,4,4,13,-9,4
AEK Athens,840,1,4,2,0,7,1,6,14
PAOK Salonik,840,2,2,2,2,9,9,0,8
P'thinaikos,840,3,2,1,3,9,9,0,7
Panionios,840,4,1,1,4,4,10,-6,4
AEK Athens,841,1,4,2,0,7,1,6,14
PAOK Salonik,841,2,3,2,1,12,4,8,11
Panionios,841,3,1,1,4,4,10,-6,4
P'thinaikos,841,4,1,1,4,4,12,-8,4
AEK Athens,842,1,4,2,0,7,1,6,14
PAOK Salonik,842,2,2,2,2,10,6,4,8
P'thinaikos,842,3,2,1,3,6,10,-4,7
Panionios,842,4,1,1,4,4,10,-6,4
AEK Athens,843,1,4,2,0,7,1,6,14
PAOK Salonik,843,2,3,2,1,12,6,6,11
P'thinaikos,843,3,1,1,4,6,12,-6,4
Panionios,843,4,1,1,4,4,10,-6,4
AEK Athens,844,1,4,2,0,7,1,6,14
PAOK Salonik,844,2,2,2,2,9,5,4,8
P'thinaikos,844,3,2,1,3,5,9,-4,7
Panionios,844,4,1,1,4,4,10,-6,4
AEK Athens,845,1,4,2,0,7,1,6,14
PAOK Salonik,845,2,2,2,2,9,6,3,8
P'thinaikos,845,3,2,1,3,6,9,-3,7
Panionios,845,4,1,1,4,4,10,-6,4
AEK Athens,846,1,4,2,0,7,1,6,14
PAOK Salonik,846,2,2,3,1,9,4,5,9
P'thinaikos,846,3,1,2,3,4,9,-5,5
Panionios,846,4,1,1,4,4,10,-6,4
AEK Athens,847,1,4,2,0,7,1,6,14
PAOK Salonik,847,2,2,3,1,11,6,5,9
P'thinaikos,847,3,1,2,3,6,11,-5,5
Panionios,847,4,1,1,4,4,10,-6,4
AEK Athens,848,1,4,2,0,7,1,6,14
PAOK Salonik,848,2,2,2,2,11,7,4,8
P'thinaikos,848,3,2,1,3,7,11,-4,7
Panionios,848,4,1,1,4,4,10,-6,4
AEK Athens,849,1,4,2,0,7,1,6,14
PAOK Salonik,849,2,2,2,2,10,6,4,8
P'thinaikos,849,3,2,1,3,6,10,-4,7
Panionios,849,4,1,1,4,4,10,-6,4
AEK Athens,850,1,4,2,0,7,1,6,14
PAOK Salonik,850,2,2,3,1,10,5,5,9
P'thinaikos,850,3,1,2,3,5,10,-5,5
Panionios,850,4,1,1,4,4,10,-6,4
AEK Athens,851,1,4,2,0,7,1,6,14
PAOK Salonik,851,2,2,3,1,12,7,5,9
P'thinaikos,851,3,1,2,3,7,12,-5,5
Panionios,851,4,1,1,4,4,10,-6,4
AEK Athens,852,1,4,2,0,7,1,6,14
PAOK Salonik,852,2,2,3,1,10,5,5,9
P'thinaikos,852,3,1,2,3,5,10,-5,5
Panionios,852,4,1,1,4,4,10,-6,4
AEK Athens,853,1,4,2,0,7,1,6,14
PAOK Salonik,853,2,2,2,2,10,6,4,8
P'thinaikos,853,3,2,1,3,6,10,-4,7
Panionios,853,4,1,1,4,4,10,-6,4
AEK Athens,854,1,4,2,0,7,1,6,14
PAOK Salonik,854,2,2,2,2,10,7,3,8
P'thinaikos,854,3,2,1,3,7,10,-3,7
Panionios,854,4,1,1,4,4,10,-6,4
AEK Athens,855,1,4,2,0,7,1,6,14
PAOK Salonik,855,2,3,2,1,10,4,6,11
P'thinaikos,855,3,1,1,4,4,10,-6,4
Panionios,855,3,1,1,4,4,10,-6,4
AEK Athens,856,1,4,2,0,7,1,6,14
PAOK Salonik,856,2,3,2,1,11,4,7,11
Panionios,856,3,1,1,4,4,10,-6,4
P'thinaikos,856,4,1,1,4,4,11,-7,4
AEK Athens,857,1,4,2,0,7,1,6,14
PAOK Salonik,857,2,2,3,1,11,6,5,9
P'thinaikos,857,3,1,2,3,6,11,-5,5
Panionios,857,4,1,1,4,4,10,-6,4
AEK Athens,858,1,4,2,0,7,1,6,14
PAOK Salonik,858,2,2,2,2,9,5,4,8
P'thinaikos,858,3,2,1,3,5,9,-4,7
Panionios,858,4,1,1,4,4,10,-6,4
AEK Athens,859,1,4,2,0,7,1,6,14
PAOK Salonik,859,2,3,2,1,11,5,6,11
P'thinaikos,859,3,1,1,4,5,11,-6,4
Panionios,859,4,1,1,4,4,10,-6,4
AEK Athens,860,1,4,2,0,7,1,6,14
PAOK Salonik,860,2,2,2,2,9,6,3,8
P'thinaikos,860,3,2,1,3,6,9,-3,7
Panionios,860,4,1,1,4,4,10,-6,4
AEK Athens,861,1,4,2,0,7,1,6,14
PAOK Salonik,861,2,2,2,2,10,6,4,8
P'thinaikos,861,3,2,1,3,6,10,-4,7
Panionios,861,4,1,1,4,4,10,-6,4
AEK Athens,862,1,4,2,0,7,1,6,14
PAOK Salonik,862,2,3,2,1,11,5,6,11
P'thinaikos,862,3,1,1,4,5,11,-6,4
Panionios,862,4,1,1,4,4,10,-6,4
AEK Athens,863,1,4,2,0,7,1,6,14
PAOK Salonik,863,2,2,3,1,11,6,5,9
P'thinaikos,863,3,1,2,3,6,11,-5,5
Panionios,863,4,1,1,4,4,10,-6,4
AEK Athens,864,1,4,2,0,7,1,6,14
PAOK Salonik,864,2,2,2,2,10,6,4,8
P'thinaikos,864,3,2,1,3,6,10,-4,7
Panionios,864,4,1,1,4,4,10,-6,4
AEK Athens,865,1,4,2,0,7,1,6,14
PAOK Salonik,865,2,2,2,2,10,7,3,8
P'thinaikos,865,3,2,1,3,7,10,-3,7
Panionios,865,4,1,1,4,4,10,-6,4
AEK Athens,866,1,4,2,0,7,1,6,14
PAOK Salonik,866,2,2,2,2,11,7,4,8
P'thinaikos,866,3,2,1,3,7,11,-4,7
Panionios,866,4,1,1,4,4,10,-6,4
AEK Athens,867,1,4,2,0,7,1,6,14
PAOK Salonik,867,2,2,2,2,10,6,4,8
P'thinaikos,867,3,2,1,3,6,10,-4,7
Panionios,867,4,1,1,4,4,10,-6,4
AEK Athens,868,1,4,2,0,7,1,6,14
PAOK Salonik,868,2,2,2,2,11,7,4,8
P'thinaikos,868,3,2,1,3,7,11,-4,7
Panionios,868,4,1,1,4,4,10,-6,4
AEK Athens,869,1,4,2,0,7,1,6,14
PAOK Salonik,869,2,2,2,2,10,6,4,8
P'thinaikos,869,3,2,1,3,6,10,-4,7
Panionios,869,4,1,1,4,4,10,-6,4
AEK Athens,870,1,4,2,0,7,1,6,14
PAOK Salonik,870,2,2,3,1,10,5,5,9
P'thinaikos,870,3,1,2,3,5,10,-5,5
Panionios,870,4,1,1,4,4,10,-6,4
AEK Athens,871,1,4,2,0,7,1,6,14
PAOK Salonik,871,2,2,3,1,10,5,5,9
P'thinaikos,871,3,1,2,3,5,10,-5,5
Panionios,871,4,1,1,4,4,10,-6,4
AEK Athens,872,1,4,2,0,7,1,6,14
PAOK Salonik,872,2,3,2,1,10,4,6,11
P'thinaikos,872,3,1,1,4,4,10,-6,4
Panionios,872,3,1,1,4,4,10,-6,4
AEK Athens,873,1,4,2,0,7,1,6,14
PAOK Salonik,873,2,2,2,2,9,7,2,8
P'thinaikos,873,3,2,1,3,7,9,-2,7
Panionios,873,4,1,1,4,4,10,-6,4
AEK Athens,874,1,4,2,0,7,1,6,14
PAOK Salonik,874,2,2,2,2,9,5,4,8
P'thinaikos,874,3,2,1,3,5,9,-4,7
Panionios,874,4,1,1,4,4,10,-6,4
AEK Athens,875,1,4,2,0,7,1,6,14
PAOK Salonik,875,2,3,2,1,10,4,6,11
P'thinaikos,875,3,1,1,4,4,10,-6,4
Panionios,875,3,1,1,4,4,10,-6,4
AEK Athens,876,1,4,2,0,7,1,6,14
PAOK Salonik,876,2,2,3,1,9,4,5,9
P'thinaikos,876,3,1,2,3,4,9,-5,5
Panionios,876,4,1,1,4,4,10,-6,4
AEK Athens,877,1,4,2,0,7,1,6,14
PAOK Salonik,877,2,3,2,1,10,4,6,11
P'thinaikos,877,3,1,1,4,4,10,-6,4
Panionios,877,3,1,1,4,4,10,-6,4
AEK Athens,878,1,4,2,0,7,1,6,14
PAOK Salonik,878,2,2,2,2,9,6,3,8
P'thinaikos,878,3,2,1,3,6,9,-3,7
Panionios,878,4,1,1,4,4,10,-6,4
AEK Athens,879,1,4,2,0,7,1,6,14
PAOK Salonik,879,2,2,2,2,10,6,4,8
P'thinaikos,879,3,2,1,3,6,10,-4,7
Panionios,879,4,1,1,4,4,10,-6,4
AEK Athens,880,1,4,2,0,7,1,6,14
PAOK Salonik,880,2,2,2,2,9,5,4,8
P'thinaikos,880,3,2,1,3,5,9,-4,7
Panionios,880,4,1,1,4,4,10,-6,4
AEK Athens,881,1,4,2,0,7,1,6,14
PAOK Salonik,881,2,2,2,2,9,8,1,8
P'thinaikos,881,3,2,1,3,8,9,-1,7
Panionios,881,4,1,1,4,4,10,-6,4
AEK Athens,882,1,4,2,0,7,1,6,14
PAOK Salonik,882,2,3,2,1,11,4,7,11
Panionios,882,3,1,1,4,4,10,-6,4
P'thinaikos,882,4,1,1,4,4,11,-7,4
AEK Athens,883,1,4,2,0,7,1,6,14
PAOK Salonik,883,2,2,3,1,10,5,5,9
P'thinaikos,883,3,1,2,3,5,10,-5,5
Panionios,883,4,1,1,4,4,10,-6,4
AEK Athens,884,1,4,2,0,7,1,6,14
PAOK Salonik,884,2,3,2,1,12,4,8,11
Panionios,884,3,1,1,4,4,10,-6,4
P'thinaikos,884,4,1,1,4,4,12,-8,4
AEK Athens,885,1,4,2,0,7,1,6,14
PAOK Salonik,885,2,2,2,2,9,5,4,8
P'thinaikos,885,3,2,1,3,5,9,-4,7
Panionios,885,4,1,1,4,4,10,-6,4
AEK Athens,886,1,4,2,0,7,1,6,14
PAOK Salonik,886,2,3,2,1,10,4,6,11
P'thinaikos,886,3,1,1,4,4,10,-6,4
Panionios,886,3,1,1,4,4,10,-6,4
AEK Athens,887,1,4,2,0,7,1,6,14
PAOK Salonik,887,2,2,3,1,10,5,5,9
P'thinaikos,887,3,1,2,3,5,10,-5,5
Panionios,887,4,1,1,4,4,10,-6,4
AEK Athens,888,1,4,2,0,7,1,6,14
PAOK Salonik,888,2,2,2,2,10,6,4,8
P'thinaikos,888,3,2,1,3,6,10,-4,7
Panionios,888,4,1,1,4,4,10,-6,4
AEK Athens,889,1,4,2,0,7,1,6,14
PAOK Salonik,889,2,3,2,1,10,4,6,11
P'thinaikos,889,3,1,1,4,4,10,-6,4
Panionios,889,3,1,1,4,4,10,-6,4
AEK Athens,890,1,4,2,0,7,1,6,14
PAOK Salonik,890,2,2,2,2,9,5,4,8
P'thinaikos,890,3,2,1,3,5,9,-4,7
Panionios,890,4,1,1,4,4,10,-6,4
AEK Athens,891,1,4,2,0,7,1,6,14
PAOK Salonik,891,2,2,3,1,10,5,5,9
P'thinaikos,891,3,1,2,3,5,10,-5,5
Panionios,891,4,1,1,4,4,10,-6,4
AEK Athens,892,1,4,2,0,7,1,6,14
PAOK Salonik,892,2,2,3,1,9,4,5,9
P'thinaikos,892,3,1,2,3,4,9,-5,5
Panionios,892,4,1,1,4,4,10,-6,4
AEK Athens,893,1,4,2,0,7,1,6,14
PAOK Salonik,893,2,2,3,1,11,6,5,9
P'thinaikos,893,3,1,2,3,6,11,-5,5
Panionios,893,4,1,1,4,4,10,-6,4
AEK Athens,894,1,4,2,0,7,1,6,14
PAOK Salonik,894,2,2,3,1,11,6,5,9
P'thinaikos,894,3,1,2,3,6,11,-5,5
Panionios,894,4,1,1,4,4,10,-6,4
AEK Athens,895,1,4,2,0,7,1,6,14
PAOK Salonik,895,2,2,3,1,10,5,5,9
P'thinaikos,895,3,1,2,3,5,10,-5,5
Panionios,895,4,1,1,4,4,10,-6,4
AEK Athens,896,1,4,2,0,7,1,6,14
PAOK Salonik,896,2,2,3,1,10,5,5,9
P'thinaikos,896,3,1,2,3,5,10,-5,5
Panionios,896,4,1,1,4,4,10,-6,4
AEK Athens,897,1,4,2,0,7,1,6,14
PAOK Salonik,897,2,2,2,2,10,7,3,8
P'thinaikos,897,3,2,1,3,7,10,-3,7
Panionios,897,4,1,1,4,4,10,-6,4
AEK Athens,898,1,4,2,0,7,1,6,14
PAOK Salonik,898,2,3,2,1,11,5,6,11
P'thinaikos,898,3,1,1,4,5,11,-6,4
Panionios,898,4,1,1,4,4,10,-6,4
AEK Athens,899,1,4,2,0,7,1,6,14
PAOK Salonik,899,2,3,2,1,11,5,6,11
P'thinaikos,899,3,1,1,4,5,11,-6,4
Panionios,899,4,1,1,4,4,10,-6,4
AEK Athens,900,1,4,2,0,7,1,6,14
PAOK Salonik,900,2,3,2,1,11,5,6,11
P'thinaikos,900,3,1,1,4,5,11,-6,4
Panionios,900,4,1,1,4,4,10,-6,4
AEK Athens,901,1,4,2,0,7,1,6,14
PAOK Salonik,901,2,2,2,2,9,6,3,8
P'thinaikos,901,3,2,1,3,6,9,-3,7
Panionios,901,4,1,1,4,4,10,-6,4
AEK Athens,902,1,4,2,0,7,1,6,14
PAOK Salonik,902,2,3,2,1,10,4,6,11
P'thinaikos,902,3,1,1,4,4,10,-6,4
Panionios,902,3,1,1,4,4,10,-6,4
AEK Athens,903,1,4,2,0,7,1,6,14
PAOK Salonik,903,2,2,2,2,9,6,3,8
P'thinaikos,903,3,2,1,3,6,9,-3,7
Panionios,903,4,1,1,4,4,10,-6,4
AEK Athens,904,1,4,2,0,7,1,6,14
PAOK Salonik,904,2,2,3,1,9,4,5,9
P'thinaikos,904,3,1,2,3,4,9,-5,5
Panionios,904,4,1,1,4,4,10,-6,4
AEK Athens,905,1,4,2,0,7,1,6,14
PAOK Salonik,905,2,2,3,1,10,5,5,9
P'thinaikos,905,3,1,2,3,5,10,-5,5
Panionios,905,4,1,1,4,4,10,-6,4
AEK Athens,906,1,4,2,0,7,1,6,14
PAOK Salonik,906,2,3,2,1,10,4,6,11
P'thinaikos,906,3,1,1,4,4,10,-6,4
Panionios,906,3,1,1,4,4,10,-6,4
AEK Athens,907,1,4,2,0,7,1,6,14
PAOK Salonik,907,2,2,2,2,10,6,4,8
P'thinaikos,907,3,2,1,3,6,10,-4,7
Panionios,907,4,1,1,4,4,10,-6,4
AEK Athens,908,1,4,2,0,7,1,6,14
PAOK Salonik,908,2,2,3,1,10,5,5,9
P'thinaikos,908,3,1,2,3,5,10,-5,5
Panionios,908,4,1,1,4,4,10,-6,4
AEK Athens,909,1,4,2,0,7,1,6,14
PAOK Salonik,909,2,2,2,2,10,7,3,8
P'thinaikos,909,3,2,1,3,7,10,-3,7
Panionios,909,4,1,1,4,4,10,-6,4
AEK Athens,910,1,4,2,0,7,1,6,14
PAOK Salonik,910,2,2,3,1,10,5,5,9
P'thinaikos,910,3,1,2,3,5,10,-5,5
Panionios,910,4,1,1,4,4,10,-6,4
AEK Athens,911,1,4,2,0,7,1,6,14
PAOK Salonik,911,2,2,3,1,9,4,5,9
P'thinaikos,911,3,1,2,3,4,9,-5,5
Panionios,911,4,1,1,4,4,10,-6,4
AEK Athens,912,1,4,2,0,7,1,6,14
PAOK Salonik,912,2,2,3,1,12,7,5,9
P'thinaikos,912,3,1,2,3,7,12,-5,5
Panionios,912,4,1,1,4,4,10,-6,4
AEK Athens,913,1,4,2,0,7,1,6,14
PAOK Salonik,913,2,2,2,2,9,5,4,8
P'thinaikos,913,3,2,1,3,5,9,-4,7
Panionios,913,4,1,1,4,4,10,-6,4
AEK Athens,914,1,4,2,0,7,1,6,14
PAOK Salonik,914,2,2,3,1,9,4,5,9
P'thinaikos,914,3,1,2,3,4,9,-5,5
Panionios,914,4,1,1,4,4,10,-6,4
AEK Athens,915,1,4,2,0,7,1,6,14
PAOK Salonik,915,2,2,3,1,9,4,5,9
P'thinaikos,915,3,1,2,3,4,9,-5,5
Panionios,915,4,1,1,4,4,10,-6,4
AEK Athens,916,1,4,2,0,7,1,6,14
PAOK Salonik,916,2,2,2,2,9,5,4,8
P'thinaikos,916,3,2,1,3,5,9,-4,7
Panionios,916,4,1,1,4,4,10,-6,4
AEK Athens,917,1,4,2,0,7,1,6,14
PAOK Salonik,917,2,2,2,2,11,7,4,8
P'thinaikos,917,3,2,1,3,7,11,-4,7
Panionios,917,4,1,1,4,4,10,-6,4
AEK Athens,918,1,4,2,0,7,1,6,14
PAOK Salonik,918,2,2,2,2,9,5,4,8
P'thinaikos,918,3,2,1,3,5,9,-4,7
Panionios,918,4,1,1,4,4,10,-6,4
AEK Athens,919,1,4,2,0,7,1,6,14
PAOK Salonik,919,2,2,2,2,9,7,2,8
P'thinaikos,919,3,2,1,3,7,9,-2,7
Panionios,919,4,1,1,4,4,10,-6,4
AEK Athens,920,1,4,2,0,7,1,6,14
PAOK Salonik,920,2,2,3,1,9,4,5,9
P'thinaikos,920,3,1,2,3,4,9,-5,5
Panionios,920,4,1,1,4,4,10,-6,4
AEK Athens,921,1,4,2,0,7,1,6,14
PAOK Salonik,921,2,2,3,1,9,4,5,9
P'thinaikos,921,3,1,2,3,4,9,-5,5
Panionios,921,4,1,1,4,4,10,-6,4
AEK Athens,922,1,4,2,0,7,1,6,14
PAOK Salonik,922,2,3,2,1,10,4,6,11
P'thinaikos,922,3,1,1,4,4,10,-6,4
Panionios,922,3,1,1,4,4,10,-6,4
AEK Athens,923,1,4,2,0,7,1,6,14
PAOK Salonik,923,2,2,2,2,9,5,4,8
P'thinaikos,923,3,2,1,3,5,9,-4,7
Panionios,923,4,1,1,4,4,10,-6,4
AEK Athens,924,1,4,2,0,7,1,6,14
PAOK Salonik,924,2,3,2,1,11,5,6,11
P'thinaikos,924,3,1,1,4,5,11,-6,4
Panionios,924,4,1,1,4,4,10,-6,4
AEK Athens,925,1,4,2,0,7,1,6,14
PAOK Salonik,925,2,3,2,1,13,4,9,11
Panionios,925,3,1,1,4,4,10,-6,4
P'thinaikos,925,4,1,1,4,4,13,-9,4
AEK Athens,926,1,4,2,0,7,1,6,14
PAOK Salonik,926,2,3,2,1,10,4,6,11
P'thinaikos,926,3,1,1,4,4,10,-6,4
Panionios,926,3,1,1,4,4,10,-6,4
AEK Athens,927,1,4,2,0,7,1,6,14
PAOK Salonik,927,2,2,2,2,9,5,4,8
P'thinaikos,927,3,2,1,3,5,9,-4,7
Panionios,927,4,1,1,4,4,10,-6,4
AEK Athens,928,1,4,2,0,7,1,6,14
PAOK Salonik,928,2,2,2,2,10,6,4,8
P'thinaikos,928,3,2,1,3,6,10,-4,7
Panionios,928,4,1,1,4,4,10,-6,4
AEK Athens,929,1,4,2,0,7,1,6,14
PAOK Salonik,929,2,2,3,1,11,6,5,9
P'thinaikos,929,3,1,2,3,6,11,-5,5
Panionios,929,4,1,1,4,4,10,-6,4
AEK Athens,930,1,4,2,0,7,1,6,14
PAOK Salonik,930,2,2,3,1,10,5,5,9
P'thinaikos,930,3,1,2,3,5,10,-5,5
Panionios,930,4,1,1,4,4,10,-6,4
AEK Athens,931,1,4,2,0,7,1,6,14
PAOK Salonik,931,2,2,3,1,9,4,5,9
P'thinaikos,931,3,1,2,3,4,9,-5,5
Panionios,931,4,1,1,4,4,10,-6,4
AEK Athens,932,1,4,2,0,7,1,6,14
PAOK Salonik,932,2,2,3,1,9,4,5,9
P'thinaikos,932,3,1,2,3,4,9,-5,5
Panionios,932,4,1,1,4,4,10,-6,4
AEK Athens,933,1,4,2,0,7,1,6,14
PAOK Salonik,933,2,3,2,1,11,4,7,11
Panionios,933,3,1,1,4,4,10,-6,4
P'thinaikos,933,4,1,1,4,4,11,-7,4
AEK Athens,934,1,4,2,0,7,1,6,14
PAOK Salonik,934,2,3,2,1,10,4,6,11
P'thinaikos,934,3,1,1,4,4,10,-6,4
Panionios,934,3,1,1,4,4,10,-6,4
AEK Athens,935,1,4,2,0,7,1,6,14
PAOK Salonik,935,2,2,2,2,9,10,-1,8
P'thinaikos,935,3,2,1,3,10,9,1,7
Panionios,935,4,1,1,4,4,10,-6,4
AEK Athens,936,1,4,2,0,7,1,6,14
PAOK Salonik,936,2,3,2,1,10,4,6,11
P'thinaikos,936,3,1,1,4,4,10,-6,4
Panionios,936,3,1,1,4,4,10,-6,4
AEK Athens,937,1,4,2,0,7,1,6,14
PAOK Salonik,937,2,3,2,1,11,5,6,11
P'thinaikos,937,3,1,1,4,5,11,-6,4
Panionios,937,4,1,1,4,4,10,-6,4
AEK Athens,938,1,4,2,0,7,1,6,14
PAOK Salonik,938,2,2,2,2,10,6,4,8
P'thinaikos,938,3,2,1,3,6,10,-4,7
Panionios,938,4,1,1,4,4,10,-6,4
AEK Athens,939,1,4,2,0,7,1,6,14
PAOK Salonik,939,2,2,2,2,9,8,1,8
P'thinaikos,939,3,2,1,3,8,9,-1,7
Panionios,939,4,1,1,4,4,10,-6,4
AEK Athens,940,1,4,2,0,7,1,6,14
PAOK Salonik,940,2,2,3,1,9,4,5,9
P'thinaikos,940,3,1,2,3,4,9,-5,5
Panionios,940,4,1,1,4,4,10,-6,4
AEK Athens,941,1,4,2,0,7,1,6,14
PAOK Salonik,941,2,3,2,1,12,4,8,11
Panionios,941,3,1,1,4,4,10,-6,4
P'thinaikos,941,4,1,1,4,4,12,-8,4
AEK Athens,942,1,4,2,0,7,1,6,14
PAOK Salonik,942,2,2,3,1,10,5,5,9
P'thinaikos,942,3,1,2,3,5,10,-5,5
Panionios,942,4,1,1,4,4,10,-6,4
AEK Athens,943,1,4,2,0,7,1,6,14
PAOK Salonik,943,2,2,3,1,9,4,5,9
P'thinaikos,943,3,1,2,3,4,9,-5,5
Panionios,943,4,1,1,4,4,10,-6,4
AEK Athens,944,1,4,2,0,7,1,6,14
PAOK Salonik,944,2,2,3,1,11,6,5,9
P'thinaikos,944,3,1,2,3,6,11,-5,5
Panionios,944,4,1,1,4,4,10,-6,4
AEK Athens,945,1,4,2,0,7,1,6,14
PAOK Salonik,945,2,2,3,1,10,5,5,9
P'thinaikos,945,3,1,2,3,5,10,-5,5
Panionios,945,4,1,1,4,4,10,-6,4
AEK Athens,946,1,4,2,0,7,1,6,14
PAOK Salonik,946,2,3,2,1,11,5,6,11
P'thinaikos,946,3,1,1,4,5,11,-6,4
Panionios,946,4,1,1,4,4,10,-6,4
AEK Athens,947,1,4,2,0,7,1,6,14
PAOK Salonik,947,2,2,2,2,11,7,4,8
P'thinaikos,947,3,2,1,3,7,11,-4,7
Panionios,947,4,1,1,4,4,10,-6,4
AEK Athens,948,1,4,2,0,7,1,6,14
PAOK Salonik,948,2,3,2,1,12,6,6,11
P'thinaikos,948,3,1,1,4,6,12,-6,4
Panionios,948,4,1,1,4,4,10,-6,4
AEK Athens,949,1,4,2,0,7,1,6,14
PAOK Salonik,949,2,3,2,1,10,4,6,11
P'thinaikos,949,3,1,1,4,4,10,-6,4
Panionios,949,3,1,1,4,4,10,-6,4
AEK Athens,950,1,4,2,0,7,1,6,14
PAOK Salonik,950,2,3,2,1,10,4,6,11
P'thinaikos,950,3,1,1,4,4,10,-6,4
Panionios,950,3,1,1,4,4,10,-6,4
AEK Athens,951,1,4,2,0,7,1,6,14
PAOK Salonik,951,2,3,2,1,11,5,6,11
P'thinaikos,951,3,1,1,4,5,11,-6,4
Panionios,951,4,1,1,4,4,10,-6,4
AEK Athens,952,1,4,2,0,7,1,6,14
PAOK Salonik,952,2,3,2,1,10,4,6,11
P'thinaikos,952,3,1,1,4,4,10,-6,4
Panionios,952,3,1,1,4,4,10,-6,4
AEK Athens,953,1,4,2,0,7,1,6,14
PAOK Salonik,953,2,2,3,1,9,4,5,9
P'thinaikos,953,3,1,2,3,4,9,-5,5
Panionios,953,4,1,1,4,4,10,-6,4
AEK Athens,954,1,4,2,0,7,1,6,14
PAOK Salonik,954,2,3,2,1,12,5,7,11
Panionios,954,3,1,1,4,4,10,-6,4
P'thinaikos,954,4,1,1,4,5,12,-7,4
AEK Athens,955,1,4,2,0,7,1,6,14
PAOK Salonik,955,2,2,2,2,9,6,3,8
P'thinaikos,955,3,2,1,3,6,9,-3,7
Panionios,955,4,1,1,4,4,10,-6,4
AEK Athens,956,1,4,2,0,7,1,6,14
PAOK Salonik,956,2,2,2,2,9,5,4,8
P'thinaikos,956,3,2,1,3,5,9,-4,7
Panionios,956,4,1,1,4,4,10,-6,4
AEK Athens,957,1,4,2,0,7,1,6,14
PAOK Salonik,957,2,2,2,2,9,7,2,8
P'thinaikos,957,3,2,1,3,7,9,-2,7
Panionios,957,4,1,1,4,4,10,-6,4
AEK Athens,958,1,4,2,0,7,1,6,14
PAOK Salonik,958,2,3,2,1,10,4,6,11
P'thinaikos,958,3,1,1,4,4,10,-6,4
Panionios,958,3,1,1,4,4,10,-6,4
AEK Athens,959,1,4,2,0,7,1,6,14
PAOK Salonik,959,2,3,2,1,10,4,6,11
P'thinaikos,959,3,1,1,4,4,10,-6,4
Panionios,959,3,1,1,4,4,10,-6,4
AEK Athens,960,1,4,2,0,7,1,6,14
PAOK Salonik,960,2,3,2,1,12,5,7,11
Panionios,960,3,1,1,4,4,10,-6,4
P'thinaikos,960,4,1,1,4,5,12,-7,4
AEK Athens,961,1,4,2,0,7,1,6,14
PAOK Salonik,961,2,2,3,1,9,4,5,9
P'thinaikos,961,3,1,2,3,4,9,-5,5
Panionios,961,4,1,1,4,4,10,-6,4
AEK Athens,962,1,4,2,0,7,1,6,14
PAOK Salonik,962,2,2,2,2,9,6,3,8
P'thinaikos,962,3,2,1,3,6,9,-3,7
Panionios,962,4,1,1,4,4,10,-6,4
AEK Athens,963,1,4,2,0,7,1,6,14
PAOK Salonik,963,2,2,2,2,9,7,2,8
P'thinaikos,963,3,2,1,3,7,9,-2,7
Panionios,963,4,1,1,4,4,10,-6,4
AEK Athens,964,1,4,2,0,7,1,6,14
PAOK Salonik,964,2,2,2,2,11,8,3,8
P'thinaikos,964,3,2,1,3,8,11,-3,7
Panionios,964,4,1,1,4,4,10,-6,4
AEK Athens,965,1,4,2,0,7,1,6,14
PAOK Salonik,965,2,2,3,1,10,5,5,9
P'thinaikos,965,3,1,2,3,5,10,-5,5
Panionios,965,4,1,1,4,4,10,-6,4
AEK Athens,966,1,4,2,0,7,1,6,14
PAOK Salonik,966,2,2,2,2,9,5,4,8
P'thinaikos,966,3,2,1,3,5,9,-4,7
Panionios,966,4,1,1,4,4,10,-6,4
AEK Athens,967,1,4,2,0,7,1,6,14
PAOK Salonik,967,2,2,3,1,9,4,5,9
P'thinaikos,967,3,1,2,3,4,9,-5,5
Panionios,967,4,1,1,4,4,10,-6,4
AEK Athens,968,1,4,2,0,7,1,6,14
PAOK Salonik,968,2,2,3,1,10,5,5,9
P'thinaikos,968,3,1,2,3,5,10,-5,5
Panionios,968,4,1,1,4,4,10,-6,4
AEK Athens,969,1,4,2,0,7,1,6,14
PAOK Salonik,969,2,3,2,1,11,5,6,11
P'thinaikos,969,3,1,1,4,5,11,-6,4
Panionios,969,4,1,1,4,4,10,-6,4
AEK Athens,970,1,4,2,0,7,1,6,14
PAOK Salonik,970,2,3,2,1,12,4,8,11
Panionios,970,3,1,1,4,4,10,-6,4
P'thinaikos,970,4,1,1,4,4,12,-8,4
AEK Athens,971,1,4,2,0,7,1,6,14
PAOK Salonik,971,2,2,2,2,9,5,4,8
P'thinaikos,971,3,2,1,3,5,9,-4,7
Panionios,971,4,1,1,4,4,10,-6,4
AEK Athens,972,1,4,2,0,7,1,6,14
PAOK Salonik,972,2,3,2,1,11,5,6,11
P'thinaikos,972,3,1,1,4,5,11,-6,4
Panionios,972,4,1,1,4,4,10,-6,4
AEK Athens,973,1,4,2,0,7,1,6,14
PAOK Salonik,973,2,3,2,1,10,4,6,11
P'thinaikos,973,3,1,1,4,4,10,-6,4
Panionios,973,3,1,1,4,4,10,-6,4
AEK Athens,974,1,4,2,0,7,1,6,14
PAOK Salonik,974,2,3,2,1,11,4,7,11
Panionios,974,3,1,1,4,4,10,-6,4
P'thinaikos,974,4,1,1,4,4,11,-7,4
AEK Athens,975,1,4,2,0,7,1,6,14
PAOK Salonik,975,2,3,2,1,10,4,6,11
P'thinaikos,975,3,1,1,4,4,10,-6,4
Panionios,975,3,1,1,4,4,10,-6,4
AEK Athens,976,1,4,2,0,7,1,6,14
PAOK Salonik,976,2,2,3,1,11,6,5,9
P'thinaikos,976,3,1,2,3,6,11,-5,5
Panionios,976,4,1,1,4,4,10,-6,4
AEK Athens,977,1,4,2,0,7,1,6,14
PAOK Salonik,977,2,3,2,1,10,4,6,11
P'thinaikos,977,3,1,1,4,4,10,-6,4
Panionios,977,3,1,1,4,4,10,-6,4
AEK Athens,978,1,4,2,0,7,1,6,14
PAOK Salonik,978,2,2,3,1,10,5,5,9
P'thinaikos,978,3,1,2,3,5,10,-5,5
Panionios,978,4,1,1,4,4,10,-6,4
AEK Athens,979,1,4,2,0,7,1,6,14
PAOK Salonik,979,2,3,2,1,11,5,6,11
P'thinaikos,979,3,1,1,4,5,11,-6,4
Panionios,979,4,1,1,4,4,10,-6,4
AEK Athens,980,1,4,2,0,7,1,6,14
PAOK Salonik,980,2,2,3,1,10,5,5,9
P'thinaikos,980,3,1,2,3,5,10,-5,5
Panionios,980,4,1,1,4,4,10,-6,4
AEK Athens,981,1,4,2,0,7,1,6,14
PAOK Salonik,981,2,2,2,2,10,8,2,8
P'thinaikos,981,3,2,1,3,8,10,-2,7
Panionios,981,4,1,1,4,4,10,-6,4
AEK Athens,982,1,4,2,0,7,1,6,14
PAOK Salonik,982,2,2,2,2,9,6,3,8
P'thinaikos,982,3,2,1,3,6,9,-3,7
Panionios,982,4,1,1,4,4,10,-6,4
AEK Athens,983,1,4,2,0,7,1,6,14
PAOK Salonik,983,2,3,2,1,12,5,7,11
Panionios,983,3,1,1,4,4,10,-6,4
P'thinaikos,983,4,1,1,4,5,12,-7,4
AEK Athens,984,1,4,2,0,7,1,6,14
PAOK Salonik,984,2,3,2,1,11,5,6,11
P'thinaikos,984,3,1,1,4,5,11,-6,4
Panionios,984,4,1,1,4,4,10,-6,4
AEK Athens,985,1,4,2,0,7,1,6,14
PAOK Salonik,985,2,2,3,1,10,5,5,9
P'thinaikos,985,3,1,2,3,5,10,-5,5
Panionios,985,4,1,1,4,4,10,-6,4
AEK Athens,986,1,4,2,0,7,1,6,14
PAOK Salonik,986,2,2,2,2,10,8,2,8
P'thinaikos,986,3,2,1,3,8,10,-2,7
Panionios,986,4,1,1,4,4,10,-6,4
AEK Athens,987,1,4,2,0,7,1,6,14
PAOK Salonik,987,2,2,3,1,10,5,5,9
P'thinaikos,987,3,1,2,3,5,10,-5,5
Panionios,987,4,1,1,4,4,10,-6,4
AEK Athens,988,1,4,2,0,7,1,6,14
PAOK Salonik,988,2,2,3,1,9,4,5,9
P'thinaikos,988,3,1,2,3,4,9,-5,5
Panionios,988,4,1,1,4,4,10,-6,4
AEK Athens,989,1,4,2,0,7,1,6,14
PAOK Salonik,989,2,2,2,2,11,8,3,8
P'thinaikos,989,3,2,1,3,8,11,-3,7
Panionios,989,4,1,1,4,4,10,-6,4
AEK Athens,990,1,4,2,0,7,1,6,14
PAOK Salonik,990,2,2,3,1,10,5,5,9
P'thinaikos,990,3,1,2,3,5,10,-5,5
Panionios,990,4,1,1,4,4,10,-6,4
AEK Athens,991,1,4,2,0,7,1,6,14
PAOK Salonik,991,2,3,2,1,10,4,6,11
P'thinaikos,991,3,1,1,4,4,10,-6,4
Panionios,991,3,1,1,4,4,10,-6,4
AEK Athens,992,1,4,2,0,7,1,6,14
PAOK Salonik,992,2,2,3,1,10,5,5,9
P'thinaikos,992,3,1,2,3,5,10,-5,5
Panionios,992,4,1,1,4,4,10,-6,4
AEK Athens,993,1,4,2,0,7,1,6,14
PAOK Salonik,993,2,3,2,1,11,4,7,11
Panionios,993,3,1,1,4,4,10,-6,4
P'thinaikos,993,4,1,1,4,4,11,-7,4
AEK Athens,994,1,4,2,0,7,1,6,14
PAOK Salonik,994,2,2,3,1,11,6,5,9
P'thinaikos,994,3,1,2,3,6,11,-5,5
Panionios,994,4,1,1,4,4,10,-6,4
AEK Athens,995,1,4,2,0,7,1,6,14
PAOK Salonik,995,2,3,2,1,11,4,7,11
Panionios,995,3,1,1,4,4,10,-6,4
P'thinaikos,995,4,1,1,4,4,11,-7,4
AEK Athens,996,1,4,2,0,7,1,6,14
PAOK Salonik,996,2,3,2,1,12,4,8,11
Panionios,996,3,1,1,4,4,10,-6,4
P'thinaikos,996,4,1,1,4,4,12,-8,4
AEK Athens,997,1,4,2,0,7,1,6,14
PAOK Salonik,997,2,3,2,1,12,5,7,11
Panionios,997,3,1,1,4,4,10,-6,4
P'thinaikos,997,4,1,1,4,5,12,-7,4
AEK Athens,998,1,4,2,0,7,1,6,14
PAOK Salonik,998,2,3,2,1,11,5,6,11
P'thinaikos,998,3,1,1,4,5,11,-6,4
Panionios,998,4,1,1,4,4,10,-6,4
AEK Athens,999,1,4,2,0,7,1,6,14
PAOK Salonik,999,2,2,3,1,10,5,5,9
P'thinaikos,999,3,1,2,3,5,10,-5,5
Panionios,999,4,1,1,4,4,10,-6,4
AEK Athens,1000,1,4,2,0,7,1,6,14
PAOK Salonik,1000,2,2,2,2,10,7,3,8
P'thinaikos,1000,3,2,1,3,7,10,-3,7
Panionios,1000,4,1,1,4,4,10,-6,4
AEK Athens,1001,1,4,2,0,7,1,6,14
PAOK Salonik,1001,2,2,3,1,10,5,5,9
P'thinaikos,1001,3,1,2,3,5,10,-5,5
Panionios,1001,4,1,1,4,4,10,-6,4
AEK Athens,1002,1,4,2,0,7,1,6,14
PAOK Salonik,1002,2,2,2,2,10,6,4,8
P'thinaikos,1002,3,2,1,3,6,10,-4,7
Panionios,1002,4,1,1,4,4,10,-6,4
AEK Athens,1003,1,4,2,0,7,1,6,14
PAOK Salonik,1003,2,2,3,1,9,4,5,9
P'thinaikos,1003,3,1,2,3,4,9,-5,5
Panionios,1003,4,1,1,4,4,10,-6,4
AEK Athens,1004,1,4,2,0,7,1,6,14
PAOK Salonik,1004,2,3,2,1,11,4,7,11
Panionios,1004,3,1,1,4,4,10,-6,4
P'thinaikos,1004,4,1,1,4,4,11,-7,4
AEK Athens,1005,1,4,2,0,7,1,6,14
PAOK Salonik,1005,2,2,2,2,9,5,4,8
P'thinaikos,1005,3,2,1,3,5,9,-4,7
Panionios,1005,4,1,1,4,4,10,-6,4
AEK Athens,1006,1,4,2,0,7,1,6,14
PAOK Salonik,1006,2,2,3,1,9,4,5,9
P'thinaikos,1006,3,1,2,3,4,9,-5,5
Panionios,1006,4,1,1,4,4,10,-6,4
AEK Athens,1007,1,4,2,0,7,1,6,14
PAOK Salonik,1007,2,2,3,1,11,6,5,9
P'thinaikos,1007,3,1,2,3,6,11,-5,5
Panionios,1007,4,1,1,4,4,10,-6,4
AEK Athens,1008,1,4,2,0,7,1,6,14
PAOK Salonik,1008,2,2,3,1,10,5,5,9
P'thinaikos,1008,3,1,2,3,5,10,-5,5
Panionios,1008,4,1,1,4,4,10,-6,4
AEK Athens,1009,1,4,2,0,7,1,6,14
PAOK Salonik,1009,2,2,3,1,10,5,5,9
P'thinaikos,1009,3,1,2,3,5,10,-5,5
Panionios,1009,4,1,1,4,4,10,-6,4
AEK Athens,1010,1,4,2,0,7,1,6,14
PAOK Salonik,1010,2,2,2,2,9,7,2,8
P'thinaikos,1010,3,2,1,3,7,9,-2,7
Panionios,1010,4,1,1,4,4,10,-6,4
AEK Athens,1011,1,4,2,0,7,1,6,14
PAOK Salonik,1011,2,3,2,1,11,4,7,11
Panionios,1011,3,1,1,4,4,10,-6,4
P'thinaikos,1011,4,1,1,4,4,11,-7,4
AEK Athens,1012,1,4,2,0,7,1,6,14
PAOK Salonik,1012,2,2,3,1,9,4,5,9
P'thinaikos,1012,3,1,2,3,4,9,-5,5
Panionios,1012,4,1,1,4,4,10,-6,4
AEK Athens,1013,1,4,2,0,7,1,6,14
PAOK Salonik,1013,2,2,2,2,10,6,4,8
P'thinaikos,1013,3,2,1,3,6,10,-4,7
Panionios,1013,4,1,1,4,4,10,-6,4
AEK Athens,1014,1,4,2,0,7,1,6,14
PAOK Salonik,1014,2,3,2,1,11,5,6,11
P'thinaikos,1014,3,1,1,4,5,11,-6,4
Panionios,1014,4,1,1,4,4,10,-6,4
AEK Athens,1015,1,4,2,0,7,1,6,14
PAOK Salonik,1015,2,2,3,1,11,6,5,9
P'thinaikos,1015,3,1,2,3,6,11,-5,5
Panionios,1015,4,1,1,4,4,10,-6,4
AEK Athens,1016,1,4,2,0,7,1,6,14
PAOK Salonik,1016,2,2,2,2,9,7,2,8
P'thinaikos,1016,3,2,1,3,7,9,-2,7
Panionios,1016,4,1,1,4,4,10,-6,4
AEK Athens,1017,1,4,2,0,7,1,6,14
PAOK Salonik,1017,2,2,3,1,9,4,5,9
P'thinaikos,1017,3,1,2,3,4,9,-5,5
Panionios,1017,4,1,1,4,4,10,-6,4
AEK Athens,1018,1,4,2,0,7,1,6,14
PAOK Salonik,1018,2,3,2,1,12,5,7,11
Panionios,1018,3,1,1,4,4,10,-6,4
P'thinaikos,1018,4,1,1,4,5,12,-7,4
AEK Athens,1019,1,4,2,0,7,1,6,14
PAOK Salonik,1019,2,2,3,1,11,6,5,9
P'thinaikos,1019,3,1,2,3,6,11,-5,5
Panionios,1019,4,1,1,4,4,10,-6,4
AEK Athens,1020,1,4,2,0,7,1,6,14
PAOK Salonik,1020,2,2,3,1,10,5,5,9
P'thinaikos,1020,3,1,2,3,5,10,-5,5
Panionios,1020,4,1,1,4,4,10,-6,4
AEK Athens,1021,1,4,2,0,7,1,6,14
PAOK Salonik,1021,2,2,2,2,9,5,4,8
P'thinaikos,1021,3,2,1,3,5,9,-4,7
Panionios,1021,4,1,1,4,4,10,-6,4
AEK Athens,1022,1,4,2,0,7,1,6,14
PAOK Salonik,1022,2,2,2,2,10,6,4,8
P'thinaikos,1022,3,2,1,3,6,10,-4,7
Panionios,1022,4,1,1,4,4,10,-6,4
AEK Athens,1023,1,4,2,0,7,1,6,14
PAOK Salonik,1023,2,2,2,2,10,6,4,8
P'thinaikos,1023,3,2,1,3,6,10,-4,7
Panionios,1023,4,1,1,4,4,10,-6,4
AEK Athens,1024,1,4,2,0,7,1,6,14
PAOK Salonik,1024,2,2,3,1,11,6,5,9
P'thinaikos,1024,3,1,2,3,6,11,-5,5
Panionios,1024,4,1,1,4,4,10,-6,4
AEK Athens,1025,1,4,2,0,7,1,6,14
PAOK Salonik,1025,2,2,2,2,10,6,4,8
P'thinaikos,1025,3,2,1,3,6,10,-4,7
Panionios,1025,4,1,1,4,4,10,-6,4
AEK Athens,1026,1,4,2,0,7,1,6,14
PAOK Salonik,1026,2,2,2,2,10,6,4,8
P'thinaikos,1026,3,2,1,3,6,10,-4,7
Panionios,1026,4,1,1,4,4,10,-6,4
AEK Athens,1027,1,4,2,0,7,1,6,14
PAOK Salonik,1027,2,3,2,1,10,4,6,11
P'thinaikos,1027,3,1,1,4,4,10,-6,4
Panionios,1027,3,1,1,4,4,10,-6,4
AEK Athens,1028,1,4,2,0,7,1,6,14
PAOK Salonik,1028,2,2,3,1,10,5,5,9
P'thinaikos,1028,3,1,2,3,5,10,-5,5
Panionios,1028,4,1,1,4,4,10,-6,4
AEK Athens,1029,1,4,2,0,7,1,6,14
PAOK Salonik,1029,2,2,2,2,9,6,3,8
P'thinaikos,1029,3,2,1,3,6,9,-3,7
Panionios,1029,4,1,1,4,4,10,-6,4
AEK Athens,1030,1,4,2,0,7,1,6,14
PAOK Salonik,1030,2,2,2,2,10,6,4,8
P'thinaikos,1030,3,2,1,3,6,10,-4,7
Panionios,1030,4,1,1,4,4,10,-6,4
AEK Athens,1031,1,4,2,0,7,1,6,14
PAOK Salonik,1031,2,3,2,1,10,4,6,11
P'thinaikos,1031,3,1,1,4,4,10,-6,4
Panionios,1031,3,1,1,4,4,10,-6,4
AEK Athens,1032,1,4,2,0,7,1,6,14
PAOK Salonik,1032,2,2,3,1,9,4,5,9
P'thinaikos,1032,3,1,2,3,4,9,-5,5
Panionios,1032,4,1,1,4,4,10,-6,4
AEK Athens,1033,1,4,2,0,7,1,6,14
PAOK Salonik,1033,2,2,3,1,10,5,5,9
P'thinaikos,1033,3,1,2,3,5,10,-5,5
Panionios,1033,4,1,1,4,4,10,-6,4
AEK Athens,1034,1,4,2,0,7,1,6,14
PAOK Salonik,1034,2,2,3,1,11,6,5,9
P'thinaikos,1034,3,1,2,3,6,11,-5,5
Panionios,1034,4,1,1,4,4,10,-6,4
AEK Athens,1035,1,4,2,0,7,1,6,14
PAOK Salonik,1035,2,2,2,2,10,6,4,8
P'thinaikos,1035,3,2,1,3,6,10,-4,7
Panionios,1035,4,1,1,4,4,10,-6,4
AEK Athens,1036,1,4,2,0,7,1,6,14
PAOK Salonik,1036,2,2,2,2,10,7,3,8
P'thinaikos,1036,3,2,1,3,7,10,-3,7
Panionios,1036,4,1,1,4,4,10,-6,4
AEK Athens,1037,1,4,2,0,7,1,6,14
PAOK Salonik,1037,2,3,2,1,11,4,7,11
Panionios,1037,3,1,1,4,4,10,-6,4
P'thinaikos,1037,4,1,1,4,4,11,-7,4
AEK Athens,1038,1,4,2,0,7,1,6,14
PAOK Salonik,1038,2,3,2,1,11,4,7,11
Panionios,1038,3,1,1,4,4,10,-6,4
P'thinaikos,1038,4,1,1,4,4,11,-7,4
AEK Athens,1039,1,4,2,0,7,1,6,14
PAOK Salonik,1039,2,3,2,1,11,4,7,11
Panionios,1039,3,1,1,4,4,10,-6,4
P'thinaikos,1039,4,1,1,4,4,11,-7,4
AEK Athens,1040,1,4,2,0,7,1,6,14
PAOK Salonik,1040,2,3,2,1,10,4,6,11
P'thinaikos,1040,3,1,1,4,4,10,-6,4
Panionios,1040,3,1,1,4,4,10,-6,4
AEK Athens,1041,1,4,2,0,7,1,6,14
PAOK Salonik,1041,2,2,2,2,9,5,4,8
P'thinaikos,1041,3,2,1,3,5,9,-4,7
Panionios,1041,4,1,1,4,4,10,-6,4
AEK Athens,1042,1,4,2,0,7,1,6,14
PAOK Salonik,1042,2,2,2,2,10,6,4,8
P'thinaikos,1042,3,2,1,3,6,10,-4,7
Panionios,1042,4,1,1,4,4,10,-6,4
AEK Athens,1043,1,4,2,0,7,1,6,14
PAOK Salonik,1043,2,2,3,1,9,4,5,9
P'thinaikos,1043,3,1,2,3,4,9,-5,5
Panionios,1043,4,1,1,4,4,10,-6,4
AEK Athens,1044,1,4,2,0,7,1,6,14
PAOK Salonik,1044,2,2,3,1,10,5,5,9
P'thinaikos,1044,3,1,2,3,5,10,-5,5
Panionios,1044,4,1,1,4,4,10,-6,4
AEK Athens,1045,1,4,2,0,7,1,6,14
PAOK Salonik,1045,2,3,2,1,13,7,6,11
P'thinaikos,1045,3,1,1,4,7,13,-6,4
Panionios,1045,4,1,1,4,4,10,-6,4
AEK Athens,1046,1,4,2,0,7,1,6,14
PAOK Salonik,1046,2,2,2,2,9,5,4,8
P'thinaikos,1046,3,2,1,3,5,9,-4,7
Panionios,1046,4,1,1,4,4,10,-6,4
AEK Athens,1047,1,4,2,0,7,1,6,14
PAOK Salonik,1047,2,2,2,2,10,7,3,8
P'thinaikos,1047,3,2,1,3,7,10,-3,7
Panionios,1047,4,1,1,4,4,10,-6,4
AEK Athens,1048,1,4,2,0,7,1,6,14
PAOK Salonik,1048,2,3,2,1,10,4,6,11
P'thinaikos,1048,3,1,1,4,4,10,-6,4
Panionios,1048,3,1,1,4,4,10,-6,4
AEK Athens,1049,1,4,2,0,7,1,6,14
PAOK Salonik,1049,2,3,2,1,13,6,7,11
Panionios,1049,3,1,1,4,4,10,-6,4
P'thinaikos,1049,4,1,1,4,6,13,-7,4
AEK Athens,1050,1,4,2,0,7,1,6,14
PAOK Salonik,1050,2,2,2,2,9,6,3,8
P'thinaikos,1050,3,2,1,3,6,9,-3,7
Panionios,1050,4,1,1,4,4,10,-6,4
AEK Athens,1051,1,4,2,0,7,1,6,14
PAOK Salonik,1051,2,2,2,2,10,6,4,8
P'thinaikos,1051,3,2,1,3,6,10,-4,7
Panionios,1051,4,1,1,4,4,10,-6,4
AEK Athens,1052,1,4,2,0,7,1,6,14
PAOK Salonik,1052,2,2,3,1,10,5,5,9
P'thinaikos,1052,3,1,2,3,5,10,-5,5
Panionios,1052,4,1,1,4,4,10,-6,4
AEK Athens,1053,1,4,2,0,7,1,6,14
PAOK Salonik,1053,2,2,2,2,10,7,3,8
P'thinaikos,1053,3,2,1,3,7,10,-3,7
Panionios,1053,4,1,1,4,4,10,-6,4
AEK Athens,1054,1,4,2,0,7,1,6,14
PAOK Salonik,1054,2,2,3,1,10,5,5,9
P'thinaikos,1054,3,1,2,3,5,10,-5,5
Panionios,1054,4,1,1,4,4,10,-6,4
AEK Athens,1055,1,4,2,0,7,1,6,14
PAOK Salonik,1055,2,2,3,1,9,4,5,9
P'thinaikos,1055,3,1,2,3,4,9,-5,5
Panionios,1055,4,1,1,4,4,10,-6,4
AEK Athens,1056,1,4,2,0,7,1,6,14
PAOK Salonik,1056,2,2,2,2,9,6,3,8
P'thinaikos,1056,3,2,1,3,6,9,-3,7
Panionios,1056,4,1,1,4,4,10,-6,4
AEK Athens,1057,1,4,2,0,7,1,6,14
PAOK Salonik,1057,2,3,2,1,11,5,6,11
P'thinaikos,1057,3,1,1,4,5,11,-6,4
Panionios,1057,4,1,1,4,4,10,-6,4
AEK Athens,1058,1,4,2,0,7,1,6,14
PAOK Salonik,1058,2,2,2,2,9,6,3,8
P'thinaikos,1058,3,2,1,3,6,9,-3,7
Panionios,1058,4,1,1,4,4,10,-6,4
AEK Athens,1059,1,4,2,0,7,1,6,14
PAOK Salonik,1059,2,3,2,1,11,5,6,11
P'thinaikos,1059,3,1,1,4,5,11,-6,4
Panionios,1059,4,1,1,4,4,10,-6,4
AEK Athens,1060,1,4,2,0,7,1,6,14
PAOK Salonik,1060,2,2,2,2,10,7,3,8
P'thinaikos,1060,3,2,1,3,7,10,-3,7
Panionios,1060,4,1,1,4,4,10,-6,4
AEK Athens,1061,1,4,2,0,7,1,6,14
PAOK Salonik,1061,2,2,2,2,9,6,3,8
P'thinaikos,1061,3,2,1,3,6,9,-3,7
Panionios,1061,4,1,1,4,4,10,-6,4
AEK Athens,1062,1,4,2,0,7,1,6,14
PAOK Salonik,1062,2,2,2,2,9,6,3,8
P'thinaikos,1062,3,2,1,3,6,9,-3,7
Panionios,1062,4,1,1,4,4,10,-6,4
AEK Athens,1063,1,4,2,0,7,1,6,14
PAOK Salonik,1063,2,3,2,1,10,4,6,11
P'thinaikos,1063,3,1,1,4,4,10,-6,4
Panionios,1063,3,1,1,4,4,10,-6,4
AEK Athens,1064,1,4,2,0,7,1,6,14
PAOK Salonik,1064,2,2,2,2,9,6,3,8
P'thinaikos,1064,3,2,1,3,6,9,-3,7
Panionios,1064,4,1,1,4,4,10,-6,4
AEK Athens,1065,1,4,2,0,7,1,6,14
PAOK Salonik,1065,2,2,2,2,10,7,3,8
P'thinaikos,1065,3,2,1,3,7,10,-3,7
Panionios,1065,4,1,1,4,4,10,-6,4
AEK Athens,1066,1,4,2,0,7,1,6,14
PAOK Salonik,1066,2,3,2,1,11,5,6,11
P'thinaikos,1066,3,1,1,4,5,11,-6,4
Panionios,1066,4,1,1,4,4,10,-6,4
AEK Athens,1067,1,4,2,0,7,1,6,14
PAOK Salonik,1067,2,2,2,2,10,6,4,8
P'thinaikos,1067,3,2,1,3,6,10,-4,7
Panionios,1067,4,1,1,4,4,10,-6,4
AEK Athens,1068,1,4,2,0,7,1,6,14
PAOK Salonik,1068,2,2,2,2,9,6,3,8
P'thinaikos,1068,3,2,1,3,6,9,-3,7
Panionios,1068,4,1,1,4,4,10,-6,4
AEK Athens,1069,1,4,2,0,7,1,6,14
PAOK Salonik,1069,2,2,2,2,9,6,3,8
P'thinaikos,1069,3,2,1,3,6,9,-3,7
Panionios,1069,4,1,1,4,4,10,-6,4
AEK Athens,1070,1,4,2,0,7,1,6,14
PAOK Salonik,1070,2,2,2,2,9,7,2,8
P'thinaikos,1070,3,2,1,3,7,9,-2,7
Panionios,1070,4,1,1,4,4,10,-6,4
AEK Athens,1071,1,4,2,0,7,1,6,14
PAOK Salonik,1071,2,3,2,1,12,4,8,11
Panionios,1071,3,1,1,4,4,10,-6,4
P'thinaikos,1071,4,1,1,4,4,12,-8,4
AEK Athens,1072,1,4,2,0,7,1,6,14
PAOK Salonik,1072,2,2,3,1,10,5,5,9
P'thinaikos,1072,3,1,2,3,5,10,-5,5
Panionios,1072,4,1,1,4,4,10,-6,4
AEK Athens,1073,1,4,2,0,7,1,6,14
PAOK Salonik,1073,2,2,2,2,9,5,4,8
P'thinaikos,1073,3,2,1,3,5,9,-4,7
Panionios,1073,4,1,1,4,4,10,-6,4
AEK Athens,1074,1,4,2,0,7,1,6,14
PAOK Salonik,1074,2,2,3,1,10,5,5,9
P'thinaikos,1074,3,1,2,3,5,10,-5,5
Panionios,1074,4,1,1,4,4,10,-6,4
AEK Athens,1075,1,4,2,0,7,1,6,14
PAOK Salonik,1075,2,2,3,1,9,4,5,9
P'thinaikos,1075,3,1,2,3,4,9,-5,5
Panionios,1075,4,1,1,4,4,10,-6,4
AEK Athens,1076,1,4,2,0,7,1,6,14
PAOK Salonik,1076,2,2,2,2,10,7,3,8
P'thinaikos,1076,3,2,1,3,7,10,-3,7
Panionios,1076,4,1,1,4,4,10,-6,4
AEK Athens,1077,1,4,2,0,7,1,6,14
PAOK Salonik,1077,2,2,3,1,10,5,5,9
P'thinaikos,1077,3,1,2,3,5,10,-5,5
Panionios,1077,4,1,1,4,4,10,-6,4
AEK Athens,1078,1,4,2,0,7,1,6,14
PAOK Salonik,1078,2,2,2,2,9,6,3,8
P'thinaikos,1078,3,2,1,3,6,9,-3,7
Panionios,1078,4,1,1,4,4,10,-6,4
AEK Athens,1079,1,4,2,0,7,1,6,14
PAOK Salonik,1079,2,2,3,1,9,4,5,9
P'thinaikos,1079,3,1,2,3,4,9,-5,5
Panionios,1079,4,1,1,4,4,10,-6,4
AEK Athens,1080,1,4,2,0,7,1,6,14
PAOK Salonik,1080,2,2,3,1,10,5,5,9
P'thinaikos,1080,3,1,2,3,5,10,-5,5
Panionios,1080,4,1,1,4,4,10,-6,4
AEK Athens,1081,1,4,2,0,7,1,6,14
PAOK Salonik,1081,2,2,3,1,9,4,5,9
P'thinaikos,1081,3,1,2,3,4,9,-5,5
Panionios,1081,4,1,1,4,4,10,-6,4
AEK Athens,1082,1,4,2,0,7,1,6,14
PAOK Salonik,1082,2,2,2,2,9,5,4,8
P'thinaikos,1082,3,2,1,3,5,9,-4,7
Panionios,1082,4,1,1,4,4,10,-6,4
AEK Athens,1083,1,4,2,0,7,1,6,14
PAOK Salonik,1083,2,2,3,1,9,4,5,9
P'thinaikos,1083,3,1,2,3,4,9,-5,5
Panionios,1083,4,1,1,4,4,10,-6,4
AEK Athens,1084,1,4,2,0,7,1,6,14
PAOK Salonik,1084,2,2,3,1,10,5,5,9
P'thinaikos,1084,3,1,2,3,5,10,-5,5
Panionios,1084,4,1,1,4,4,10,-6,4
AEK Athens,1085,1,4,2,0,7,1,6,14
PAOK Salonik,1085,2,2,3,1,9,4,5,9
P'thinaikos,1085,3,1,2,3,4,9,-5,5
Panionios,1085,4,1,1,4,4,10,-6,4
AEK Athens,1086,1,4,2,0,7,1,6,14
PAOK Salonik,1086,2,3,2,1,10,4,6,11
P'thinaikos,1086,3,1,1,4,4,10,-6,4
Panionios,1086,3,1,1,4,4,10,-6,4
AEK Athens,1087,1,4,2,0,7,1,6,14
PAOK Salonik,1087,2,3,2,1,10,4,6,11
P'thinaikos,1087,3,1,1,4,4,10,-6,4
Panionios,1087,3,1,1,4,4,10,-6,4
AEK Athens,1088,1,4,2,0,7,1,6,14
PAOK Salonik,1088,2,2,3,1,9,4,5,9
P'thinaikos,1088,3,1,2,3,4,9,-5,5
Panionios,1088,4,1,1,4,4,10,-6,4
AEK Athens,1089,1,4,2,0,7,1,6,14
PAOK Salonik,1089,2,2,3,1,9,4,5,9
P'thinaikos,1089,3,1,2,3,4,9,-5,5
Panionios,1089,4,1,1,4,4,10,-6,4
AEK Athens,1090,1,4,2,0,7,1,6,14
PAOK Salonik,1090,2,3,2,1,10,4,6,11
P'thinaikos,1090,3,1,1,4,4,10,-6,4
Panionios,1090,3,1,1,4,4,10,-6,4
AEK Athens,1091,1,4,2,0,7,1,6,14
PAOK Salonik,1091,2,2,3,1,9,4,5,9
P'thinaikos,1091,3,1,2,3,4,9,-5,5
Panionios,1091,4,1,1,4,4,10,-6,4
AEK Athens,1092,1,4,2,0,7,1,6,14
PAOK Salonik,1092,2,3,2,1,11,5,6,11
P'thinaikos,1092,3,1,1,4,5,11,-6,4
Panionios,1092,4,1,1,4,4,10,-6,4
AEK Athens,1093,1,4,2,0,7,1,6,14
PAOK Salonik,1093,2,3,2,1,11,4,7,11
Panionios,1093,3,1,1,4,4,10,-6,4
P'thinaikos,1093,4,1,1,4,4,11,-7,4
AEK Athens,1094,1,4,2,0,7,1,6,14
PAOK Salonik,1094,2,2,3,1,11,6,5,9
P'thinaikos,1094,3,1,2,3,6,11,-5,5
Panionios,1094,4,1,1,4,4,10,-6,4
AEK Athens,1095,1,4,2,0,7,1,6,14
PAOK Salonik,1095,2,3,2,1,11,5,6,11
P'thinaikos,1095,3,1,1,4,5,11,-6,4
Panionios,1095,4,1,1,4,4,10,-6,4
AEK Athens,1096,1,4,2,0,7,1,6,14
PAOK Salonik,1096,2,2,3,1,10,5,5,9
P'thinaikos,1096,3,1,2,3,5,10,-5,5
Panionios,1096,4,1,1,4,4,10,-6,4
AEK Athens,1097,1,4,2,0,7,1,6,14
PAOK Salonik,1097,2,2,2,2,9,5,4,8
P'thinaikos,1097,3,2,1,3,5,9,-4,7
Panionios,1097,4,1,1,4,4,10,-6,4
AEK Athens,1098,1,4,2,0,7,1,6,14
PAOK Salonik,1098,2,3,2,1,11,4,7,11
Panionios,1098,3,1,1,4,4,10,-6,4
P'thinaikos,1098,4,1,1,4,4,11,-7,4
AEK Athens,1099,1,4,2,0,7,1,6,14
PAOK Salonik,1099,2,2,3,1,9,4,5,9
P'thinaikos,1099,3,1,2,3,4,9,-5,5
Panionios,1099,4,1,1,4,4,10,-6,4
AEK Athens,1100,1,4,2,0,7,1,6,14
PAOK Salonik,1100,2,2,3,1,9,4,5,9
P'thinaikos,1100,3,1,2,3,4,9,-5,5
Panionios,1100,4,1,1,4,4,10,-6,4
AEK Athens,1101,1,4,2,0,7,1,6,14
PAOK Salonik,1101,2,2,3,1,9,4,5,9
P'thinaikos,1101,3,1,2,3,4,9,-5,5
Panionios,1101,4,1,1,4,4,10,-6,4
AEK Athens,1102,1,4,2,0,7,1,6,14
PAOK Salonik,1102,2,2,2,2,9,7,2,8
P'thinaikos,1102,3,2,1,3,7,9,-2,7
Panionios,1102,4,1,1,4,4,10,-6,4
AEK Athens,1103,1,4,2,0,7,1,6,14
PAOK Salonik,1103,2,2,3,1,10,5,5,9
P'thinaikos,1103,3,1,2,3,5,10,-5,5
Panionios,1103,4,1,1,4,4,10,-6,4
AEK Athens,1104,1,4,2,0,7,1,6,14
PAOK Salonik,1104,2,3,2,1,11,5,6,11
P'thinaikos,1104,3,1,1,4,5,11,-6,4
Panionios,1104,4,1,1,4,4,10,-6,4
AEK Athens,1105,1,4,2,0,7,1,6,14
PAOK Salonik,1105,2,2,3,1,11,6,5,9
P'thinaikos,1105,3,1,2,3,6,11,-5,5
Panionios,1105,4,1,1,4,4,10,-6,4
AEK Athens,1106,1,4,2,0,7,1,6,14
PAOK Salonik,1106,2,2,2,2,10,7,3,8
P'thinaikos,1106,3,2,1,3,7,10,-3,7
Panionios,1106,4,1,1,4,4,10,-6,4
AEK Athens,1107,1,4,2,0,7,1,6,14
PAOK Salonik,1107,2,2,2,2,9,5,4,8
P'thinaikos,1107,3,2,1,3,5,9,-4,7
Panionios,1107,4,1,1,4,4,10,-6,4
AEK Athens,1108,1,4,2,0,7,1,6,14
PAOK Salonik,1108,2,2,2,2,9,6,3,8
P'thinaikos,1108,3,2,1,3,6,9,-3,7
Panionios,1108,4,1,1,4,4,10,-6,4
AEK Athens,1109,1,4,2,0,7,1,6,14
PAOK Salonik,1109,2,2,2,2,9,6,3,8
P'thinaikos,1109,3,2,1,3,6,9,-3,7
Panionios,1109,4,1,1,4,4,10,-6,4
AEK Athens,1110,1,4,2,0,7,1,6,14
PAOK Salonik,1110,2,3,2,1,10,4,6,11
P'thinaikos,1110,3,1,1,4,4,10,-6,4
Panionios,1110,3,1,1,4,4,10,-6,4
AEK Athens,1111,1,4,2,0,7,1,6,14
PAOK Salonik,1111,2,3,2,1,10,4,6,11
P'thinaikos,1111,3,1,1,4,4,10,-6,4
Panionios,1111,3,1,1,4,4,10,-6,4
AEK Athens,1112,1,4,2,0,7,1,6,14
PAOK Salonik,1112,2,3,2,1,10,4,6,11
P'thinaikos,1112,3,1,1,4,4,10,-6,4
Panionios,1112,3,1,1,4,4,10,-6,4
AEK Athens,1113,1,4,2,0,7,1,6,14
PAOK Salonik,1113,2,2,3,1,10,5,5,9
P'thinaikos,1113,3,1,2,3,5,10,-5,5
Panionios,1113,4,1,1,4,4,10,-6,4
AEK Athens,1114,1,4,2,0,7,1,6,14
PAOK Salonik,1114,2,2,2,2,10,6,4,8
P'thinaikos,1114,3,2,1,3,6,10,-4,7
Panionios,1114,4,1,1,4,4,10,-6,4
AEK Athens,1115,1,4,2,0,7,1,6,14
PAOK Salonik,1115,2,2,2,2,9,6,3,8
P'thinaikos,1115,3,2,1,3,6,9,-3,7
Panionios,1115,4,1,1,4,4,10,-6,4
AEK Athens,1116,1,4,2,0,7,1,6,14
PAOK Salonik,1116,2,2,2,2,10,6,4,8
P'thinaikos,1116,3,2,1,3,6,10,-4,7
Panionios,1116,4,1,1,4,4,10,-6,4
AEK Athens,1117,1,4,2,0,7,1,6,14
PAOK Salonik,1117,2,3,2,1,12,5,7,11
Panionios,1117,3,1,1,4,4,10,-6,4
P'thinaikos,1117,4,1,1,4,5,12,-7,4
AEK Athens,1118,1,4,2,0,7,1,6,14
PAOK Salonik,1118,2,2,2,2,9,7,2,8
P'thinaikos,1118,3,2,1,3,7,9,-2,7
Panionios,1118,4,1,1,4,4,10,-6,4
AEK Athens,1119,1,4,2,0,7,1,6,14
PAOK Salonik,1119,2,2,2,2,9,5,4,8
P'thinaikos,1119,3,2,1,3,5,9,-4,7
Panionios,1119,4,1,1,4,4,10,-6,4
AEK Athens,1120,1,4,2,0,7,1,6,14
PAOK Salonik,1120,2,2,2,2,10,6,4,8
P'thinaikos,1120,3,2,1,3,6,10,-4,7
Panionios,1120,4,1,1,4,4,10,-6,4
AEK Athens,1121,1,4,2,0,7,1,6,14
PAOK Salonik,1121,2,3,2,1,11,4,7,11
Panionios,1121,3,1,1,4,4,10,-6,4
P'thinaikos,1121,4,1,1,4,4,11,-7,4
AEK Athens,1122,1,4,2,0,7,1,6,14
PAOK Salonik,1122,2,3,2,1,11,5,6,11
P'thinaikos,1122,3,1,1,4,5,11,-6,4
Panionios,1122,4,1,1,4,4,10,-6,4
AEK Athens,1123,1,4,2,0,7,1,6,14
PAOK Salonik,1123,2,2,3,1,9,4,5,9
P'thinaikos,1123,3,1,2,3,4,9,-5,5
Panionios,1123,4,1,1,4,4,10,-6,4
AEK Athens,1124,1,4,2,0,7,1,6,14
PAOK Salonik,1124,2,3,2,1,11,5,6,11
P'thinaikos,1124,3,1,1,4,5,11,-6,4
Panionios,1124,4,1,1,4,4,10,-6,4
AEK Athens,1125,1,4,2,0,7,1,6,14
PAOK Salonik,1125,2,3,2,1,12,6,6,11
P'thinaikos,1125,3,1,1,4,6,12,-6,4
Panionios,1125,4,1,1,4,4,10,-6,4
AEK Athens,1126,1,4,2,0,7,1,6,14
PAOK Salonik,1126,2,2,3,1,9,4,5,9
P'thinaikos,1126,3,1,2,3,4,9,-5,5
Panionios,1126,4,1,1,4,4,10,-6,4
AEK Athens,1127,1,4,2,0,7,1,6,14
PAOK Salonik,1127,2,3,2,1,10,4,6,11
P'thinaikos,1127,3,1,1,4,4,10,-6,4
Panionios,1127,3,1,1,4,4,10,-6,4
AEK Athens,1128,1,4,2,0,7,1,6,14
PAOK Salonik,1128,2,3,2,1,11,4,7,11
Panionios,1128,3,1,1,4,4,10,-6,4
P'thinaikos,1128,4,1,1,4,4,11,-7,4
AEK Athens,1129,1,4,2,0,7,1,6,14
PAOK Salonik,1129,2,3,2,1,11,5,6,11
P'thinaikos,1129,3,1,1,4,5,11,-6,4
Panionios,1129,4,1,1,4,4,10,-6,4
AEK Athens,1130,1,4,2,0,7,1,6,14
PAOK Salonik,1130,2,2,2,2,9,5,4,8
P'thinaikos,1130,3,2,1,3,5,9,-4,7
Panionios,1130,4,1,1,4,4,10,-6,4
AEK Athens,1131,1,4,2,0,7,1,6,14
PAOK Salonik,1131,2,3,2,1,10,4,6,11
P'thinaikos,1131,3,1,1,4,4,10,-6,4
Panionios,1131,3,1,1,4,4,10,-6,4
AEK Athens,1132,1,4,2,0,7,1,6,14
PAOK Salonik,1132,2,2,3,1,10,5,5,9
P'thinaikos,1132,3,1,2,3,5,10,-5,5
Panionios,1132,4,1,1,4,4,10,-6,4
AEK Athens,1133,1,4,2,0,7,1,6,14
PAOK Salonik,1133,2,3,2,1,11,5,6,11
P'thinaikos,1133,3,1,1,4,5,11,-6,4
Panionios,1133,4,1,1,4,4,10,-6,4
AEK Athens,1134,1,4,2,0,7,1,6,14
PAOK Salonik,1134,2,2,2,2,9,6,3,8
P'thinaikos,1134,3,2,1,3,6,9,-3,7
Panionios,1134,4,1,1,4,4,10,-6,4
AEK Athens,1135,1,4,2,0,7,1,6,14
PAOK Salonik,1135,2,2,2,2,9,5,4,8
P'thinaikos,1135,3,2,1,3,5,9,-4,7
Panionios,1135,4,1,1,4,4,10,-6,4
AEK Athens,1136,1,4,2,0,7,1,6,14
PAOK Salonik,1136,2,2,3,1,11,6,5,9
P'thinaikos,1136,3,1,2,3,6,11,-5,5
Panionios,1136,4,1,1,4,4,10,-6,4
AEK Athens,1137,1,4,2,0,7,1,6,14
PAOK Salonik,1137,2,2,3,1,10,5,5,9
P'thinaikos,1137,3,1,2,3,5,10,-5,5
Panionios,1137,4,1,1,4,4,10,-6,4
AEK Athens,1138,1,4,2,0,7,1,6,14
PAOK Salonik,1138,2,2,3,1,10,5,5,9
P'thinaikos,1138,3,1,2,3,5,10,-5,5
Panionios,1138,4,1,1,4,4,10,-6,4
AEK Athens,1139,1,4,2,0,7,1,6,14
PAOK Salonik,1139,2,3,2,1,11,5,6,11
P'thinaikos,1139,3,1,1,4,5,11,-6,4
Panionios,1139,4,1,1,4,4,10,-6,4
AEK Athens,1140,1,4,2,0,7,1,6,14
PAOK Salonik,1140,2,2,3,1,10,5,5,9
P'thinaikos,1140,3,1,2,3,5,10,-5,5
Panionios,1140,4,1,1,4,4,10,-6,4
AEK Athens,1141,1,4,2,0,7,1,6,14
PAOK Salonik,1141,2,2,3,1,10,5,5,9
P'thinaikos,1141,3,1,2,3,5,10,-5,5
Panionios,1141,4,1,1,4,4,10,-6,4
AEK Athens,1142,1,4,2,0,7,1,6,14
PAOK Salonik,1142,2,2,3,1,12,7,5,9
P'thinaikos,1142,3,1,2,3,7,12,-5,5
Panionios,1142,4,1,1,4,4,10,-6,4
AEK Athens,1143,1,4,2,0,7,1,6,14
PAOK Salonik,1143,2,2,3,1,10,5,5,9
P'thinaikos,1143,3,1,2,3,5,10,-5,5
Panionios,1143,4,1,1,4,4,10,-6,4
AEK Athens,1144,1,4,2,0,7,1,6,14
PAOK Salonik,1144,2,2,2,2,9,5,4,8
P'thinaikos,1144,3,2,1,3,5,9,-4,7
Panionios,1144,4,1,1,4,4,10,-6,4
AEK Athens,1145,1,4,2,0,7,1,6,14
PAOK Salonik,1145,2,2,2,2,9,6,3,8
P'thinaikos,1145,3,2,1,3,6,9,-3,7
Panionios,1145,4,1,1,4,4,10,-6,4
AEK Athens,1146,1,4,2,0,7,1,6,14
PAOK Salonik,1146,2,2,2,2,10,7,3,8
P'thinaikos,1146,3,2,1,3,7,10,-3,7
Panionios,1146,4,1,1,4,4,10,-6,4
AEK Athens,1147,1,4,2,0,7,1,6,14
PAOK Salonik,1147,2,3,2,1,11,5,6,11
P'thinaikos,1147,3,1,1,4,5,11,-6,4
Panionios,1147,4,1,1,4,4,10,-6,4
AEK Athens,1148,1,4,2,0,7,1,6,14
PAOK Salonik,1148,2,2,2,2,10,6,4,8
P'thinaikos,1148,3,2,1,3,6,10,-4,7
Panionios,1148,4,1,1,4,4,10,-6,4
AEK Athens,1149,1,4,2,0,7,1,6,14
PAOK Salonik,1149,2,2,2,2,9,5,4,8
P'thinaikos,1149,3,2,1,3,5,9,-4,7
Panionios,1149,4,1,1,4,4,10,-6,4
AEK Athens,1150,1,4,2,0,7,1,6,14
PAOK Salonik,1150,2,3,2,1,13,5,8,11
Panionios,1150,3,1,1,4,4,10,-6,4
P'thinaikos,1150,4,1,1,4,5,13,-8,4
AEK Athens,1151,1,4,2,0,7,1,6,14
PAOK Salonik,1151,2,2,2,2,9,6,3,8
P'thinaikos,1151,3,2,1,3,6,9,-3,7
Panionios,1151,4,1,1,4,4,10,-6,4
AEK Athens,1152,1,4,2,0,7,1,6,14
PAOK Salonik,1152,2,2,2,2,11,7,4,8
P'thinaikos,1152,3,2,1,3,7,11,-4,7
Panionios,1152,4,1,1,4,4,10,-6,4
AEK Athens,1153,1,4,2,0,7,1,6,14
PAOK Salonik,1153,2,2,3,1,9,4,5,9
P'thinaikos,1153,3,1,2,3,4,9,-5,5
Panionios,1153,4,1,1,4,4,10,-6,4
AEK Athens,1154,1,4,2,0,7,1,6,14
PAOK Salonik,1154,2,2,2,2,9,5,4,8
P'thinaikos,1154,3,2,1,3,5,9,-4,7
Panionios,1154,4,1,1,4,4,10,-6,4
AEK Athens,1155,1,4,2,0,7,1,6,14
PAOK Salonik,1155,2,2,2,2,11,8,3,8
P'thinaikos,1155,3,2,1,3,8,11,-3,7
Panionios,1155,4,1,1,4,4,10,-6,4
AEK Athens,1156,1,4,2,0,7,1,6,14
PAOK Salonik,1156,2,3,2,1,11,5,6,11
P'thinaikos,1156,3,1,1,4,5,11,-6,4
Panionios,1156,4,1,1,4,4,10,-6,4
AEK Athens,1157,1,4,2,0,7,1,6,14
PAOK Salonik,1157,2,3,2,1,12,5,7,11
Panionios,1157,3,1,1,4,4,10,-6,4
P'thinaikos,1157,4,1,1,4,5,12,-7,4
AEK Athens,1158,1,4,2,0,7,1,6,14
PAOK Salonik,1158,2,2,2,2,9,5,4,8
P'thinaikos,1158,3,2,1,3,5,9,-4,7
Panionios,1158,4,1,1,4,4,10,-6,4
AEK Athens,1159,1,4,2,0,7,1,6,14
PAOK Salonik,1159,2,2,2,2,10,6,4,8
P'thinaikos,1159,3,2,1,3,6,10,-4,7
Panionios,1159,4,1,1,4,4,10,-6,4
AEK Athens,1160,1,4,2,0,7,1,6,14
PAOK Salonik,1160,2,2,2,2,10,6,4,8
P'thinaikos,1160,3,2,1,3,6,10,-4,7
Panionios,1160,4,1,1,4,4,10,-6,4
AEK Athens,1161,1,4,2,0,7,1,6,14
PAOK Salonik,1161,2,2,2,2,9,8,1,8
P'thinaikos,1161,3,2,1,3,8,9,-1,7
Panionios,1161,4,1,1,4,4,10,-6,4
AEK Athens,1162,1,4,2,0,7,1,6,14
PAOK Salonik,1162,2,2,2,2,10,6,4,8
P'thinaikos,1162,3,2,1,3,6,10,-4,7
Panionios,1162,4,1,1,4,4,10,-6,4
AEK Athens,1163,1,4,2,0,7,1,6,14
PAOK Salonik,1163,2,3,2,1,10,4,6,11
P'thinaikos,1163,3,1,1,4,4,10,-6,4
Panionios,1163,3,1,1,4,4,10,-6,4
AEK Athens,1164,1,4,2,0,7,1,6,14
PAOK Salonik,1164,2,3,2,1,10,4,6,11
P'thinaikos,1164,3,1,1,4,4,10,-6,4
Panionios,1164,3,1,1,4,4,10,-6,4
AEK Athens,1165,1,4,2,0,7,1,6,14
PAOK Salonik,1165,2,3,2,1,13,5,8,11
Panionios,1165,3,1,1,4,4,10,-6,4
P'thinaikos,1165,4,1,1,4,5,13,-8,4
AEK Athens,1166,1,4,2,0,7,1,6,14
PAOK Salonik,1166,2,2,2,2,10,8,2,8
P'thinaikos,1166,3,2,1,3,8,10,-2,7
Panionios,1166,4,1,1,4,4,10,-6,4
AEK Athens,1167,1,4,2,0,7,1,6,14
PAOK Salonik,1167,2,3,2,1,10,4,6,11
P'thinaikos,1167,3,1,1,4,4,10,-6,4
Panionios,1167,3,1,1,4,4,10,-6,4
AEK Athens,1168,1,4,2,0,7,1,6,14
PAOK Salonik,1168,2,3,2,1,12,5,7,11
Panionios,1168,3,1,1,4,4,10,-6,4
P'thinaikos,1168,4,1,1,4,5,12,-7,4
AEK Athens,1169,1,4,2,0,7,1,6,14
PAOK Salonik,1169,2,2,2,2,10,7,3,8
P'thinaikos,1169,3,2,1,3,7,10,-3,7
Panionios,1169,4,1,1,4,4,10,-6,4
AEK Athens,1170,1,4,2,0,7,1,6,14
PAOK Salonik,1170,2,2,3,1,10,5,5,9
P'thinaikos,1170,3,1,2,3,5,10,-5,5
Panionios,1170,4,1,1,4,4,10,-6,4
AEK Athens,1171,1,4,2,0,7,1,6,14
PAOK Salonik,1171,2,2,2,2,10,11,-1,8
P'thinaikos,1171,3,2,1,3,11,10,1,7
Panionios,1171,4,1,1,4,4,10,-6,4
AEK Athens,1172,1,4,2,0,7,1,6,14
PAOK Salonik,1172,2,2,3,1,9,4,5,9
P'thinaikos,1172,3,1,2,3,4,9,-5,5
Panionios,1172,4,1,1,4,4,10,-6,4
AEK Athens,1173,1,4,2,0,7,1,6,14
PAOK Salonik,1173,2,3,2,1,11,5,6,11
P'thinaikos,1173,3,1,1,4,5,11,-6,4
Panionios,1173,4,1,1,4,4,10,-6,4
AEK Athens,1174,1,4,2,0,7,1,6,14
PAOK Salonik,1174,2,2,3,1,10,5,5,9
P'thinaikos,1174,3,1,2,3,5,10,-5,5
Panionios,1174,4,1,1,4,4,10,-6,4
AEK Athens,1175,1,4,2,0,7,1,6,14
PAOK Salonik,1175,2,3,2,1,10,4,6,11
P'thinaikos,1175,3,1,1,4,4,10,-6,4
Panionios,1175,3,1,1,4,4,10,-6,4
AEK Athens,1176,1,4,2,0,7,1,6,14
PAOK Salonik,1176,2,2,2,2,9,6,3,8
P'thinaikos,1176,3,2,1,3,6,9,-3,7
Panionios,1176,4,1,1,4,4,10,-6,4
AEK Athens,1177,1,4,2,0,7,1,6,14
PAOK Salonik,1177,2,3,2,1,11,5,6,11
P'thinaikos,1177,3,1,1,4,5,11,-6,4
Panionios,1177,4,1,1,4,4,10,-6,4
AEK Athens,1178,1,4,2,0,7,1,6,14
PAOK Salonik,1178,2,2,2,2,9,8,1,8
P'thinaikos,1178,3,2,1,3,8,9,-1,7
Panionios,1178,4,1,1,4,4,10,-6,4
AEK Athens,1179,1,4,2,0,7,1,6,14
PAOK Salonik,1179,2,2,3,1,10,5,5,9
P'thinaikos,1179,3,1,2,3,5,10,-5,5
Panionios,1179,4,1,1,4,4,10,-6,4
AEK Athens,1180,1,4,2,0,7,1,6,14
PAOK Salonik,1180,2,2,2,2,9,5,4,8
P'thinaikos,1180,3,2,1,3,5,9,-4,7
Panionios,1180,4,1,1,4,4,10,-6,4
AEK Athens,1181,1,4,2,0,7,1,6,14
PAOK Salonik,1181,2,3,2,1,13,4,9,11
Panionios,1181,3,1,1,4,4,10,-6,4
P'thinaikos,1181,4,1,1,4,4,13,-9,4
AEK Athens,1182,1,4,2,0,7,1,6,14
PAOK Salonik,1182,2,2,3,1,9,4,5,9
P'thinaikos,1182,3,1,2,3,4,9,-5,5
Panionios,1182,4,1,1,4,4,10,-6,4
AEK Athens,1183,1,4,2,0,7,1,6,14
PAOK Salonik,1183,2,3,2,1,10,4,6,11
P'thinaikos,1183,3,1,1,4,4,10,-6,4
Panionios,1183,3,1,1,4,4,10,-6,4
AEK Athens,1184,1,4,2,0,7,1,6,14
PAOK Salonik,1184,2,2,2,2,9,7,2,8
P'thinaikos,1184,3,2,1,3,7,9,-2,7
Panionios,1184,4,1,1,4,4,10,-6,4
AEK Athens,1185,1,4,2,0,7,1,6,14
PAOK Salonik,1185,2,3,2,1,11,5,6,11
P'thinaikos,1185,3,1,1,4,5,11,-6,4
Panionios,1185,4,1,1,4,4,10,-6,4
AEK Athens,1186,1,4,2,0,7,1,6,14
PAOK Salonik,1186,2,3,2,1,12,4,8,11
Panionios,1186,3,1,1,4,4,10,-6,4
P'thinaikos,1186,4,1,1,4,4,12,-8,4
AEK Athens,1187,1,4,2,0,7,1,6,14
PAOK Salonik,1187,2,2,3,1,10,5,5,9
P'thinaikos,1187,3,1,2,3,5,10,-5,5
Panionios,1187,4,1,1,4,4,10,-6,4
AEK Athens,1188,1,4,2,0,7,1,6,14
PAOK Salonik,1188,2,2,3,1,10,5,5,9
P'thinaikos,1188,3,1,2,3,5,10,-5,5
Panionios,1188,4,1,1,4,4,10,-6,4
AEK Athens,1189,1,4,2,0,7,1,6,14
PAOK Salonik,1189,2,2,3,1,10,5,5,9
P'thinaikos,1189,3,1,2,3,5,10,-5,5
Panionios,1189,4,1,1,4,4,10,-6,4
AEK Athens,1190,1,4,2,0,7,1,6,14
PAOK Salonik,1190,2,2,2,2,11,7,4,8
P'thinaikos,1190,3,2,1,3,7,11,-4,7
Panionios,1190,4,1,1,4,4,10,-6,4
AEK Athens,1191,1,4,2,0,7,1,6,14
PAOK Salonik,1191,2,2,3,1,11,6,5,9
P'thinaikos,1191,3,1,2,3,6,11,-5,5
Panionios,1191,4,1,1,4,4,10,-6,4
AEK Athens,1192,1,4,2,0,7,1,6,14
PAOK Salonik,1192,2,2,3,1,9,4,5,9
P'thinaikos,1192,3,1,2,3,4,9,-5,5
Panionios,1192,4,1,1,4,4,10,-6,4
AEK Athens,1193,1,4,2,0,7,1,6,14
PAOK Salonik,1193,2,3,2,1,11,4,7,11
Panionios,1193,3,1,1,4,4,10,-6,4
P'thinaikos,1193,4,1,1,4,4,11,-7,4
AEK Athens,1194,1,4,2,0,7,1,6,14
PAOK Salonik,1194,2,2,3,1,10,5,5,9
P'thinaikos,1194,3,1,2,3,5,10,-5,5
Panionios,1194,4,1,1,4,4,10,-6,4
AEK Athens,1195,1,4,2,0,7,1,6,14
PAOK Salonik,1195,2,2,2,2,9,5,4,8
P'thinaikos,1195,3,2,1,3,5,9,-4,7
Panionios,1195,4,1,1,4,4,10,-6,4
AEK Athens,1196,1,4,2,0,7,1,6,14
PAOK Salonik,1196,2,2,2,2,10,6,4,8
P'thinaikos,1196,3,2,1,3,6,10,-4,7
Panionios,1196,4,1,1,4,4,10,-6,4
AEK Athens,1197,1,4,2,0,7,1,6,14
PAOK Salonik,1197,2,2,3,1,10,5,5,9
P'thinaikos,1197,3,1,2,3,5,10,-5,5
Panionios,1197,4,1,1,4,4,10,-6,4
AEK Athens,1198,1,4,2,0,7,1,6,14
PAOK Salonik,1198,2,3,2,1,10,4,6,11
P'thinaikos,1198,3,1,1,4,4,10,-6,4
Panionios,1198,3,1,1,4,4,10,-6,4
AEK Athens,1199,1,4,2,0,7,1,6,14
PAOK Salonik,1199,2,2,3,1,10,5,5,9
P'thinaikos,1199,3,1,2,3,5,10,-5,5
Panionios,1199,4,1,1,4,4,10,-6,4
AEK Athens,1200,1,4,2,0,7,1,6,14
PAOK Salonik,1200,2,3,2,1,10,4,6,11
P'thinaikos,1200,3,1,1,4,4,10,-6,4
Panionios,1200,3,1,1,4,4,10,-6,4
AEK Athens,1201,1,4,2,0,7,1,6,14
PAOK Salonik,1201,2,2,3,1,10,5,5,9
P'thinaikos,1201,3,1,2,3,5,10,-5,5
Panionios,1201,4,1,1,4,4,10,-6,4
AEK Athens,1202,1,4,2,0,7,1,6,14
PAOK Salonik,1202,2,2,3,1,10,5,5,9
P'thinaikos,1202,3,1,2,3,5,10,-5,5
Panionios,1202,4,1,1,4,4,10,-6,4
AEK Athens,1203,1,4,2,0,7,1,6,14
PAOK Salonik,1203,2,2,2,2,9,5,4,8
P'thinaikos,1203,3,2,1,3,5,9,-4,7
Panionios,1203,4,1,1,4,4,10,-6,4
AEK Athens,1204,1,4,2,0,7,1,6,14
PAOK Salonik,1204,2,2,2,2,9,5,4,8
P'thinaikos,1204,3,2,1,3,5,9,-4,7
Panionios,1204,4,1,1,4,4,10,-6,4
AEK Athens,1205,1,4,2,0,7,1,6,14
PAOK Salonik,1205,2,3,2,1,10,4,6,11
P'thinaikos,1205,3,1,1,4,4,10,-6,4
Panionios,1205,3,1,1,4,4,10,-6,4
AEK Athens,1206,1,4,2,0,7,1,6,14
PAOK Salonik,1206,2,2,3,1,9,4,5,9
P'thinaikos,1206,3,1,2,3,4,9,-5,5
Panionios,1206,4,1,1,4,4,10,-6,4
AEK Athens,1207,1,4,2,0,7,1,6,14
PAOK Salonik,1207,2,2,2,2,9,5,4,8
P'thinaikos,1207,3,2,1,3,5,9,-4,7
Panionios,1207,4,1,1,4,4,10,-6,4
AEK Athens,1208,1,4,2,0,7,1,6,14
PAOK Salonik,1208,2,2,2,2,9,5,4,8
P'thinaikos,1208,3,2,1,3,5,9,-4,7
Panionios,1208,4,1,1,4,4,10,-6,4
AEK Athens,1209,1,4,2,0,7,1,6,14
PAOK Salonik,1209,2,3,2,1,11,5,6,11
P'thinaikos,1209,3,1,1,4,5,11,-6,4
Panionios,1209,4,1,1,4,4,10,-6,4
AEK Athens,1210,1,4,2,0,7,1,6,14
PAOK Salonik,1210,2,2,3,1,9,4,5,9
P'thinaikos,1210,3,1,2,3,4,9,-5,5
Panionios,1210,4,1,1,4,4,10,-6,4
AEK Athens,1211,1,4,2,0,7,1,6,14
PAOK Salonik,1211,2,2,3,1,10,5,5,9
P'thinaikos,1211,3,1,2,3,5,10,-5,5
Panionios,1211,4,1,1,4,4,10,-6,4
AEK Athens,1212,1,4,2,0,7,1,6,14
PAOK Salonik,1212,2,2,2,2,10,6,4,8
P'thinaikos,1212,3,2,1,3,6,10,-4,7
Panionios,1212,4,1,1,4,4,10,-6,4
AEK Athens,1213,1,4,2,0,7,1,6,14
PAOK Salonik,1213,2,2,3,1,10,5,5,9
P'thinaikos,1213,3,1,2,3,5,10,-5,5
Panionios,1213,4,1,1,4,4,10,-6,4
AEK Athens,1214,1,4,2,0,7,1,6,14
PAOK Salonik,1214,2,2,3,1,10,5,5,9
P'thinaikos,1214,3,1,2,3,5,10,-5,5
Panionios,1214,4,1,1,4,4,10,-6,4
AEK Athens,1215,1,4,2,0,7,1,6,14
PAOK Salonik,1215,2,3,2,1,11,5,6,11
P'thinaikos,1215,3,1,1,4,5,11,-6,4
Panionios,1215,4,1,1,4,4,10,-6,4
AEK Athens,1216,1,4,2,0,7,1,6,14
PAOK Salonik,1216,2,3,2,1,11,5,6,11
P'thinaikos,1216,3,1,1,4,5,11,-6,4
Panionios,1216,4,1,1,4,4,10,-6,4
AEK Athens,1217,1,4,2,0,7,1,6,14
PAOK Salonik,1217,2,3,2,1,12,5,7,11
Panionios,1217,3,1,1,4,4,10,-6,4
P'thinaikos,1217,4,1,1,4,5,12,-7,4
AEK Athens,1218,1,4,2,0,7,1,6,14
PAOK Salonik,1218,2,3,2,1,10,4,6,11
P'thinaikos,1218,3,1,1,4,4,10,-6,4
Panionios,1218,3,1,1,4,4,10,-6,4
AEK Athens,1219,1,4,2,0,7,1,6,14
PAOK Salonik,1219,2,3,2,1,11,5,6,11
P'thinaikos,1219,3,1,1,4,5,11,-6,4
Panionios,1219,4,1,1,4,4,10,-6,4
AEK Athens,1220,1,4,2,0,7,1,6,14
PAOK Salonik,1220,2,2,2,2,9,5,4,8
P'thinaikos,1220,3,2,1,3,5,9,-4,7
Panionios,1220,4,1,1,4,4,10,-6,4
AEK Athens,1221,1,4,2,0,7,1,6,14
PAOK Salonik,1221,2,2,3,1,9,4,5,9
P'thinaikos,1221,3,1,2,3,4,9,-5,5
Panionios,1221,4,1,1,4,4,10,-6,4
AEK Athens,1222,1,4,2,0,7,1,6,14
PAOK Salonik,1222,2,3,2,1,12,4,8,11
Panionios,1222,3,1,1,4,4,10,-6,4
P'thinaikos,1222,4,1,1,4,4,12,-8,4
AEK Athens,1223,1,4,2,0,7,1,6,14
PAOK Salonik,1223,2,3,2,1,10,4,6,11
P'thinaikos,1223,3,1,1,4,4,10,-6,4
Panionios,1223,3,1,1,4,4,10,-6,4
AEK Athens,1224,1,4,2,0,7,1,6,14
PAOK Salonik,1224,2,2,3,1,10,5,5,9
P'thinaikos,1224,3,1,2,3,5,10,-5,5
Panionios,1224,4,1,1,4,4,10,-6,4
AEK Athens,1225,1,4,2,0,7,1,6,14
PAOK Salonik,1225,2,3,2,1,11,4,7,11
Panionios,1225,3,1,1,4,4,10,-6,4
P'thinaikos,1225,4,1,1,4,4,11,-7,4
AEK Athens,1226,1,4,2,0,7,1,6,14
PAOK Salonik,1226,2,3,2,1,11,5,6,11
P'thinaikos,1226,3,1,1,4,5,11,-6,4
Panionios,1226,4,1,1,4,4,10,-6,4
AEK Athens,1227,1,4,2,0,7,1,6,14
PAOK Salonik,1227,2,2,2,2,10,6,4,8
P'thinaikos,1227,3,2,1,3,6,10,-4,7
Panionios,1227,4,1,1,4,4,10,-6,4
AEK Athens,1228,1,4,2,0,7,1,6,14
PAOK Salonik,1228,2,3,2,1,11,5,6,11
P'thinaikos,1228,3,1,1,4,5,11,-6,4
Panionios,1228,4,1,1,4,4,10,-6,4
AEK Athens,1229,1,4,2,0,7,1,6,14
PAOK Salonik,1229,2,3,2,1,10,4,6,11
P'thinaikos,1229,3,1,1,4,4,10,-6,4
Panionios,1229,3,1,1,4,4,10,-6,4
AEK Athens,1230,1,4,2,0,7,1,6,14
PAOK Salonik,1230,2,3,2,1,11,5,6,11
P'thinaikos,1230,3,1,1,4,5,11,-6,4
Panionios,1230,4,1,1,4,4,10,-6,4
AEK Athens,1231,1,4,2,0,7,1,6,14
PAOK Salonik,1231,2,3,2,1,13,5,8,11
Panionios,1231,3,1,1,4,4,10,-6,4
P'thinaikos,1231,4,1,1,4,5,13,-8,4
AEK Athens,1232,1,4,2,0,7,1,6,14
PAOK Salonik,1232,2,2,3,1,12,7,5,9
P'thinaikos,1232,3,1,2,3,7,12,-5,5
Panionios,1232,4,1,1,4,4,10,-6,4
AEK Athens,1233,1,4,2,0,7,1,6,14
PAOK Salonik,1233,2,3,2,1,11,5,6,11
P'thinaikos,1233,3,1,1,4,5,11,-6,4
Panionios,1233,4,1,1,4,4,10,-6,4
AEK Athens,1234,1,4,2,0,7,1,6,14
PAOK Salonik,1234,2,2,3,1,11,6,5,9
P'thinaikos,1234,3,1,2,3,6,11,-5,5
Panionios,1234,4,1,1,4,4,10,-6,4
AEK Athens,1235,1,4,2,0,7,1,6,14
PAOK Salonik,1235,2,2,2,2,10,6,4,8
P'thinaikos,1235,3,2,1,3,6,10,-4,7
Panionios,1235,4,1,1,4,4,10,-6,4
AEK Athens,1236,1,4,2,0,7,1,6,14
PAOK Salonik,1236,2,2,3,1,10,5,5,9
P'thinaikos,1236,3,1,2,3,5,10,-5,5
Panionios,1236,4,1,1,4,4,10,-6,4
AEK Athens,1237,1,4,2,0,7,1,6,14
PAOK Salonik,1237,2,2,2,2,9,5,4,8
P'thinaikos,1237,3,2,1,3,5,9,-4,7
Panionios,1237,4,1,1,4,4,10,-6,4
AEK Athens,1238,1,4,2,0,7,1,6,14
PAOK Salonik,1238,2,2,2,2,11,7,4,8
P'thinaikos,1238,3,2,1,3,7,11,-4,7
Panionios,1238,4,1,1,4,4,10,-6,4
AEK Athens,1239,1,4,2,0,7,1,6,14
PAOK Salonik,1239,2,3,2,1,11,4,7,11
Panionios,1239,3,1,1,4,4,10,-6,4
P'thinaikos,1239,4,1,1,4,4,11,-7,4
AEK Athens,1240,1,4,2,0,7,1,6,14
PAOK Salonik,1240,2,2,3,1,9,4,5,9
P'thinaikos,1240,3,1,2,3,4,9,-5,5
Panionios,1240,4,1,1,4,4,10,-6,4
AEK Athens,1241,1,4,2,0,7,1,6,14
PAOK Salonik,1241,2,2,3,1,10,5,5,9
P'thinaikos,1241,3,1,2,3,5,10,-5,5
Panionios,1241,4,1,1,4,4,10,-6,4
AEK Athens,1242,1,4,2,0,7,1,6,14
PAOK Salonik,1242,2,2,2,2,9,5,4,8
P'thinaikos,1242,3,2,1,3,5,9,-4,7
Panionios,1242,4,1,1,4,4,10,-6,4
AEK Athens,1243,1,4,2,0,7,1,6,14
PAOK Salonik,1243,2,2,2,2,11,7,4,8
P'thinaikos,1243,3,2,1,3,7,11,-4,7
Panionios,1243,4,1,1,4,4,10,-6,4
AEK Athens,1244,1,4,2,0,7,1,6,14
PAOK Salonik,1244,2,3,2,1,11,5,6,11
P'thinaikos,1244,3,1,1,4,5,11,-6,4
Panionios,1244,4,1,1,4,4,10,-6,4
AEK Athens,1245,1,4,2,0,7,1,6,14
PAOK Salonik,1245,2,2,2,2,11,11,0,8
P'thinaikos,1245,3,2,1,3,11,11,0,7
Panionios,1245,4,1,1,4,4,10,-6,4
AEK Athens,1246,1,4,2,0,7,1,6,14
PAOK Salonik,1246,2,2,2,2,9,6,3,8
P'thinaikos,1246,3,2,1,3,6,9,-3,7
Panionios,1246,4,1,1,4,4,10,-6,4
AEK Athens,1247,1,4,2,0,7,1,6,14
PAOK Salonik,1247,2,2,2,2,10,8,2,8
P'thinaikos,1247,3,2,1,3,8,10,-2,7
Panionios,1247,4,1,1,4,4,10,-6,4
AEK Athens,1248,1,4,2,0,7,1,6,14
PAOK Salonik,1248,2,2,2,2,10,6,4,8
P'thinaikos,1248,3,2,1,3,6,10,-4,7
Panionios,1248,4,1,1,4,4,10,-6,4
AEK Athens,1249,1,4,2,0,7,1,6,14
PAOK Salonik,1249,2,2,2,2,9,6,3,8
P'thinaikos,1249,3,2,1,3,6,9,-3,7
Panionios,1249,4,1,1,4,4,10,-6,4
AEK Athens,1250,1,4,2,0,7,1,6,14
PAOK Salonik,1250,2,3,2,1,12,6,6,11
P'thinaikos,1250,3,1,1,4,6,12,-6,4
Panionios,1250,4,1,1,4,4,10,-6,4
AEK Athens,1251,1,4,2,0,7,1,6,14
PAOK Salonik,1251,2,2,2,2,9,5,4,8
P'thinaikos,1251,3,2,1,3,5,9,-4,7
Panionios,1251,4,1,1,4,4,10,-6,4
AEK Athens,1252,1,4,2,0,7,1,6,14
PAOK Salonik,1252,2,2,2,2,9,6,3,8
P'thinaikos,1252,3,2,1,3,6,9,-3,7
Panionios,1252,4,1,1,4,4,10,-6,4
AEK Athens,1253,1,4,2,0,7,1,6,14
PAOK Salonik,1253,2,2,2,2,9,5,4,8
P'thinaikos,1253,3,2,1,3,5,9,-4,7
Panionios,1253,4,1,1,4,4,10,-6,4
AEK Athens,1254,1,4,2,0,7,1,6,14
PAOK Salonik,1254,2,2,3,1,10,5,5,9
P'thinaikos,1254,3,1,2,3,5,10,-5,5
Panionios,1254,4,1,1,4,4,10,-6,4
AEK Athens,1255,1,4,2,0,7,1,6,14
PAOK Salonik,1255,2,2,2,2,9,6,3,8
P'thinaikos,1255,3,2,1,3,6,9,-3,7
Panionios,1255,4,1,1,4,4,10,-6,4
AEK Athens,1256,1,4,2,0,7,1,6,14
PAOK Salonik,1256,2,2,2,2,10,7,3,8
P'thinaikos,1256,3,2,1,3,7,10,-3,7
Panionios,1256,4,1,1,4,4,10,-6,4
AEK Athens,1257,1,4,2,0,7,1,6,14
PAOK Salonik,1257,2,2,3,1,11,6,5,9
P'thinaikos,1257,3,1,2,3,6,11,-5,5
Panionios,1257,4,1,1,4,4,10,-6,4
AEK Athens,1258,1,4,2,0,7,1,6,14
PAOK Salonik,1258,2,3,2,1,10,4,6,11
P'thinaikos,1258,3,1,1,4,4,10,-6,4
Panionios,1258,3,1,1,4,4,10,-6,4
AEK Athens,1259,1,4,2,0,7,1,6,14
PAOK Salonik,1259,2,2,2,2,9,6,3,8
P'thinaikos,1259,3,2,1,3,6,9,-3,7
Panionios,1259,4,1,1,4,4,10,-6,4
AEK Athens,1260,1,4,2,0,7,1,6,14
PAOK Salonik,1260,2,3,2,1,11,4,7,11
Panionios,1260,3,1,1,4,4,10,-6,4
P'thinaikos,1260,4,1,1,4,4,11,-7,4
AEK Athens,1261,1,4,2,0,7,1,6,14
PAOK Salonik,1261,2,3,2,1,12,5,7,11
Panionios,1261,3,1,1,4,4,10,-6,4
P'thinaikos,1261,4,1,1,4,5,12,-7,4
AEK Athens,1262,1,4,2,0,7,1,6,14
PAOK Salonik,1262,2,2,2,2,9,6,3,8
P'thinaikos,1262,3,2,1,3,6,9,-3,7
Panionios,1262,4,1,1,4,4,10,-6,4
AEK Athens,1263,1,4,2,0,7,1,6,14
PAOK Salonik,1263,2,2,3,1,10,5,5,9
P'thinaikos,1263,3,1,2,3,5,10,-5,5
Panionios,1263,4,1,1,4,4,10,-6,4
AEK Athens,1264,1,4,2,0,7,1,6,14
PAOK Salonik,1264,2,2,2,2,10,6,4,8
P'thinaikos,1264,3,2,1,3,6,10,-4,7
Panionios,1264,4,1,1,4,4,10,-6,4
AEK Athens,1265,1,4,2,0,7,1,6,14
PAOK Salonik,1265,2,2,3,1,9,4,5,9
P'thinaikos,1265,3,1,2,3,4,9,-5,5
Panionios,1265,4,1,1,4,4,10,-6,4
AEK Athens,1266,1,4,2,0,7,1,6,14
PAOK Salonik,1266,2,3,2,1,11,5,6,11
P'thinaikos,1266,3,1,1,4,5,11,-6,4
Panionios,1266,4,1,1,4,4,10,-6,4
AEK Athens,1267,1,4,2,0,7,1,6,14
PAOK Salonik,1267,2,2,3,1,9,4,5,9
P'thinaikos,1267,3,1,2,3,4,9,-5,5
Panionios,1267,4,1,1,4,4,10,-6,4
AEK Athens,1268,1,4,2,0,7,1,6,14
PAOK Salonik,1268,2,2,3,1,11,6,5,9
P'thinaikos,1268,3,1,2,3,6,11,-5,5
Panionios,1268,4,1,1,4,4,10,-6,4
AEK Athens,1269,1,4,2,0,7,1,6,14
PAOK Salonik,1269,2,2,2,2,10,8,2,8
P'thinaikos,1269,3,2,1,3,8,10,-2,7
Panionios,1269,4,1,1,4,4,10,-6,4
AEK Athens,1270,1,4,2,0,7,1,6,14
PAOK Salonik,1270,2,3,2,1,11,4,7,11
Panionios,1270,3,1,1,4,4,10,-6,4
P'thinaikos,1270,4,1,1,4,4,11,-7,4
AEK Athens,1271,1,4,2,0,7,1,6,14
PAOK Salonik,1271,2,2,2,2,9,6,3,8
P'thinaikos,1271,3,2,1,3,6,9,-3,7
Panionios,1271,4,1,1,4,4,10,-6,4
AEK Athens,1272,1,4,2,0,7,1,6,14
PAOK Salonik,1272,2,3,2,1,12,5,7,11
Panionios,1272,3,1,1,4,4,10,-6,4
P'thinaikos,1272,4,1,1,4,5,12,-7,4
AEK Athens,1273,1,4,2,0,7,1,6,14
PAOK Salonik,1273,2,3,2,1,13,6,7,11
Panionios,1273,3,1,1,4,4,10,-6,4
P'thinaikos,1273,4,1,1,4,6,13,-7,4
AEK Athens,1274,1,4,2,0,7,1,6,14
PAOK Salonik,1274,2,2,3,1,10,5,5,9
P'thinaikos,1274,3,1,2,3,5,10,-5,5
Panionios,1274,4,1,1,4,4,10,-6,4
AEK Athens,1275,1,4,2,0,7,1,6,14
PAOK Salonik,1275,2,3,2,1,15,6,9,11
Panionios,1275,3,1,1,4,4,10,-6,4
P'thinaikos,1275,4,1,1,4,6,15,-9,4
AEK Athens,1276,1,4,2,0,7,1,6,14
PAOK Salonik,1276,2,2,3,1,10,5,5,9
P'thinaikos,1276,3,1,2,3,5,10,-5,5
Panionios,1276,4,1,1,4,4,10,-6,4
AEK Athens,1277,1,4,2,0,7,1,6,14
PAOK Salonik,1277,2,2,3,1,11,6,5,9
P'thinaikos,1277,3,1,2,3,6,11,-5,5
Panionios,1277,4,1,1,4,4,10,-6,4
AEK Athens,1278,1,4,2,0,7,1,6,14
PAOK Salonik,1278,2,2,2,2,9,6,3,8
P'thinaikos,1278,3,2,1,3,6,9,-3,7
Panionios,1278,4,1,1,4,4,10,-6,4
AEK Athens,1279,1,4,2,0,7,1,6,14
PAOK Salonik,1279,2,3,2,1,11,5,6,11
P'thinaikos,1279,3,1,1,4,5,11,-6,4
Panionios,1279,4,1,1,4,4,10,-6,4
AEK Athens,1280,1,4,2,0,7,1,6,14
PAOK Salonik,1280,2,3,2,1,10,4,6,11
P'thinaikos,1280,3,1,1,4,4,10,-6,4
Panionios,1280,3,1,1,4,4,10,-6,4
AEK Athens,1281,1,4,2,0,7,1,6,14
PAOK Salonik,1281,2,2,3,1,10,5,5,9
P'thinaikos,1281,3,1,2,3,5,10,-5,5
Panionios,1281,4,1,1,4,4,10,-6,4
AEK Athens,1282,1,4,2,0,7,1,6,14
PAOK Salonik,1282,2,3,2,1,11,5,6,11
P'thinaikos,1282,3,1,1,4,5,11,-6,4
Panionios,1282,4,1,1,4,4,10,-6,4
AEK Athens,1283,1,4,2,0,7,1,6,14
PAOK Salonik,1283,2,3,2,1,12,4,8,11
Panionios,1283,3,1,1,4,4,10,-6,4
P'thinaikos,1283,4,1,1,4,4,12,-8,4
AEK Athens,1284,1,4,2,0,7,1,6,14
PAOK Salonik,1284,2,2,3,1,10,5,5,9
P'thinaikos,1284,3,1,2,3,5,10,-5,5
Panionios,1284,4,1,1,4,4,10,-6,4
AEK Athens,1285,1,4,2,0,7,1,6,14
PAOK Salonik,1285,2,3,2,1,10,4,6,11
P'thinaikos,1285,3,1,1,4,4,10,-6,4
Panionios,1285,3,1,1,4,4,10,-6,4
AEK Athens,1286,1,4,2,0,7,1,6,14
PAOK Salonik,1286,2,3,2,1,10,4,6,11
P'thinaikos,1286,3,1,1,4,4,10,-6,4
Panionios,1286,3,1,1,4,4,10,-6,4
AEK Athens,1287,1,4,2,0,7,1,6,14
PAOK Salonik,1287,2,2,2,2,11,8,3,8
P'thinaikos,1287,3,2,1,3,8,11,-3,7
Panionios,1287,4,1,1,4,4,10,-6,4
AEK Athens,1288,1,4,2,0,7,1,6,14
PAOK Salonik,1288,2,2,2,2,10,6,4,8
P'thinaikos,1288,3,2,1,3,6,10,-4,7
Panionios,1288,4,1,1,4,4,10,-6,4
AEK Athens,1289,1,4,2,0,7,1,6,14
PAOK Salonik,1289,2,2,2,2,9,5,4,8
P'thinaikos,1289,3,2,1,3,5,9,-4,7
Panionios,1289,4,1,1,4,4,10,-6,4
AEK Athens,1290,1,4,2,0,7,1,6,14
PAOK Salonik,1290,2,2,3,1,9,4,5,9
P'thinaikos,1290,3,1,2,3,4,9,-5,5
Panionios,1290,4,1,1,4,4,10,-6,4
AEK Athens,1291,1,4,2,0,7,1,6,14
PAOK Salonik,1291,2,2,2,2,9,5,4,8
P'thinaikos,1291,3,2,1,3,5,9,-4,7
Panionios,1291,4,1,1,4,4,10,-6,4
AEK Athens,1292,1,4,2,0,7,1,6,14
PAOK Salonik,1292,2,2,2,2,9,5,4,8
P'thinaikos,1292,3,2,1,3,5,9,-4,7
Panionios,1292,4,1,1,4,4,10,-6,4
AEK Athens,1293,1,4,2,0,7,1,6,14
PAOK Salonik,1293,2,3,2,1,11,5,6,11
P'thinaikos,1293,3,1,1,4,5,11,-6,4
Panionios,1293,4,1,1,4,4,10,-6,4
AEK Athens,1294,1,4,2,0,7,1,6,14
PAOK Salonik,1294,2,3,2,1,12,5,7,11
Panionios,1294,3,1,1,4,4,10,-6,4
P'thinaikos,1294,4,1,1,4,5,12,-7,4
AEK Athens,1295,1,4,2,0,7,1,6,14
PAOK Salonik,1295,2,3,2,1,12,5,7,11
Panionios,1295,3,1,1,4,4,10,-6,4
P'thinaikos,1295,4,1,1,4,5,12,-7,4
AEK Athens,1296,1,4,2,0,7,1,6,14
PAOK Salonik,1296,2,2,2,2,9,6,3,8
P'thinaikos,1296,3,2,1,3,6,9,-3,7
Panionios,1296,4,1,1,4,4,10,-6,4
AEK Athens,1297,1,4,2,0,7,1,6,14
PAOK Salonik,1297,2,2,2,2,9,6,3,8
P'thinaikos,1297,3,2,1,3,6,9,-3,7
Panionios,1297,4,1,1,4,4,10,-6,4
AEK Athens,1298,1,4,2,0,7,1,6,14
PAOK Salonik,1298,2,3,2,1,11,4,7,11
Panionios,1298,3,1,1,4,4,10,-6,4
P'thinaikos,1298,4,1,1,4,4,11,-7,4
AEK Athens,1299,1,4,2,0,7,1,6,14
PAOK Salonik,1299,2,2,3,1,9,4,5,9
P'thinaikos,1299,3,1,2,3,4,9,-5,5
Panionios,1299,4,1,1,4,4,10,-6,4
AEK Athens,1300,1,4,2,0,7,1,6,14
PAOK Salonik,1300,2,2,3,1,9,4,5,9
P'thinaikos,1300,3,1,2,3,4,9,-5,5
Panionios,1300,4,1,1,4,4,10,-6,4
AEK Athens,1301,1,4,2,0,7,1,6,14
PAOK Salonik,1301,2,2,2,2,10,6,4,8
P'thinaikos,1301,3,2,1,3,6,10,-4,7
Panionios,1301,4,1,1,4,4,10,-6,4
AEK Athens,1302,1,4,2,0,7,1,6,14
PAOK Salonik,1302,2,2,3,1,9,4,5,9
P'thinaikos,1302,3,1,2,3,4,9,-5,5
Panionios,1302,4,1,1,4,4,10,-6,4
AEK Athens,1303,1,4,2,0,7,1,6,14
PAOK Salonik,1303,2,3,2,1,10,4,6,11
P'thinaikos,1303,3,1,1,4,4,10,-6,4
Panionios,1303,3,1,1,4,4,10,-6,4
AEK Athens,1304,1,4,2,0,7,1,6,14
PAOK Salonik,1304,2,2,3,1,11,6,5,9
P'thinaikos,1304,3,1,2,3,6,11,-5,5
Panionios,1304,4,1,1,4,4,10,-6,4
AEK Athens,1305,1,4,2,0,7,1,6,14
PAOK Salonik,1305,2,2,2,2,9,6,3,8
P'thinaikos,1305,3,2,1,3,6,9,-3,7
Panionios,1305,4,1,1,4,4,10,-6,4
AEK Athens,1306,1,4,2,0,7,1,6,14
PAOK Salonik,1306,2,3,2,1,11,5,6,11
P'thinaikos,1306,3,1,1,4,5,11,-6,4
Panionios,1306,4,1,1,4,4,10,-6,4
AEK Athens,1307,1,4,2,0,7,1,6,14
PAOK Salonik,1307,2,3,2,1,11,4,7,11
Panionios,1307,3,1,1,4,4,10,-6,4
P'thinaikos,1307,4,1,1,4,4,11,-7,4
AEK Athens,1308,1,4,2,0,7,1,6,14
PAOK Salonik,1308,2,3,2,1,11,5,6,11
P'thinaikos,1308,3,1,1,4,5,11,-6,4
Panionios,1308,4,1,1,4,4,10,-6,4
AEK Athens,1309,1,4,2,0,7,1,6,14
PAOK Salonik,1309,2,2,2,2,9,6,3,8
P'thinaikos,1309,3,2,1,3,6,9,-3,7
Panionios,1309,4,1,1,4,4,10,-6,4
AEK Athens,1310,1,4,2,0,7,1,6,14
PAOK Salonik,1310,2,2,3,1,10,5,5,9
P'thinaikos,1310,3,1,2,3,5,10,-5,5
Panionios,1310,4,1,1,4,4,10,-6,4
AEK Athens,1311,1,4,2,0,7,1,6,14
PAOK Salonik,1311,2,2,2,2,10,6,4,8
P'thinaikos,1311,3,2,1,3,6,10,-4,7
Panionios,1311,4,1,1,4,4,10,-6,4
AEK Athens,1312,1,4,2,0,7,1,6,14
PAOK Salonik,1312,2,3,2,1,11,5,6,11
P'thinaikos,1312,3,1,1,4,5,11,-6,4
Panionios,1312,4,1,1,4,4,10,-6,4
AEK Athens,1313,1,4,2,0,7,1,6,14
PAOK Salonik,1313,2,2,3,1,11,6,5,9
P'thinaikos,1313,3,1,2,3,6,11,-5,5
Panionios,1313,4,1,1,4,4,10,-6,4
AEK Athens,1314,1,4,2,0,7,1,6,14
PAOK Salonik,1314,2,2,2,2,11,7,4,8
P'thinaikos,1314,3,2,1,3,7,11,-4,7
Panionios,1314,4,1,1,4,4,10,-6,4
AEK Athens,1315,1,4,2,0,7,1,6,14
PAOK Salonik,1315,2,3,2,1,10,4,6,11
P'thinaikos,1315,3,1,1,4,4,10,-6,4
Panionios,1315,3,1,1,4,4,10,-6,4
AEK Athens,1316,1,4,2,0,7,1,6,14
PAOK Salonik,1316,2,2,2,2,9,5,4,8
P'thinaikos,1316,3,2,1,3,5,9,-4,7
Panionios,1316,4,1,1,4,4,10,-6,4
AEK Athens,1317,1,4,2,0,7,1,6,14
PAOK Salonik,1317,2,3,2,1,11,4,7,11
Panionios,1317,3,1,1,4,4,10,-6,4
P'thinaikos,1317,4,1,1,4,4,11,-7,4
AEK Athens,1318,1,4,2,0,7,1,6,14
PAOK Salonik,1318,2,2,2,2,10,6,4,8
P'thinaikos,1318,3,2,1,3,6,10,-4,7
Panionios,1318,4,1,1,4,4,10,-6,4
AEK Athens,1319,1,4,2,0,7,1,6,14
PAOK Salonik,1319,2,2,2,2,10,6,4,8
P'thinaikos,1319,3,2,1,3,6,10,-4,7
Panionios,1319,4,1,1,4,4,10,-6,4
AEK Athens,1320,1,4,2,0,7,1,6,14
PAOK Salonik,1320,2,2,2,2,9,5,4,8
P'thinaikos,1320,3,2,1,3,5,9,-4,7
Panionios,1320,4,1,1,4,4,10,-6,4
AEK Athens,1321,1,4,2,0,7,1,6,14
PAOK Salonik,1321,2,3,2,1,12,4,8,11
Panionios,1321,3,1,1,4,4,10,-6,4
P'thinaikos,1321,4,1,1,4,4,12,-8,4
AEK Athens,1322,1,4,2,0,7,1,6,14
PAOK Salonik,1322,2,2,3,1,10,5,5,9
P'thinaikos,1322,3,1,2,3,5,10,-5,5
Panionios,1322,4,1,1,4,4,10,-6,4
AEK Athens,1323,1,4,2,0,7,1,6,14
PAOK Salonik,1323,2,3,2,1,12,5,7,11
Panionios,1323,3,1,1,4,4,10,-6,4
P'thinaikos,1323,4,1,1,4,5,12,-7,4
AEK Athens,1324,1,4,2,0,7,1,6,14
PAOK Salonik,1324,2,2,3,1,10,5,5,9
P'thinaikos,1324,3,1,2,3,5,10,-5,5
Panionios,1324,4,1,1,4,4,10,-6,4
AEK Athens,1325,1,4,2,0,7,1,6,14
PAOK Salonik,1325,2,3,2,1,12,4,8,11
Panionios,1325,3,1,1,4,4,10,-6,4
P'thinaikos,1325,4,1,1,4,4,12,-8,4
AEK Athens,1326,1,4,2,0,7,1,6,14
PAOK Salonik,1326,2,2,2,2,9,5,4,8
P'thinaikos,1326,3,2,1,3,5,9,-4,7
Panionios,1326,4,1,1,4,4,10,-6,4
AEK Athens,1327,1,4,2,0,7,1,6,14
PAOK Salonik,1327,2,2,3,1,11,6,5,9
P'thinaikos,1327,3,1,2,3,6,11,-5,5
Panionios,1327,4,1,1,4,4,10,-6,4
AEK Athens,1328,1,4,2,0,7,1,6,14
PAOK Salonik,1328,2,3,2,1,10,4,6,11
P'thinaikos,1328,3,1,1,4,4,10,-6,4
Panionios,1328,3,1,1,4,4,10,-6,4
AEK Athens,1329,1,4,2,0,7,1,6,14
PAOK Salonik,1329,2,2,3,1,12,7,5,9
P'thinaikos,1329,3,1,2,3,7,12,-5,5
Panionios,1329,4,1,1,4,4,10,-6,4
AEK Athens,1330,1,4,2,0,7,1,6,14
PAOK Salonik,1330,2,2,2,2,10,6,4,8
P'thinaikos,1330,3,2,1,3,6,10,-4,7
Panionios,1330,4,1,1,4,4,10,-6,4
AEK Athens,1331,1,4,2,0,7,1,6,14
PAOK Salonik,1331,2,3,2,1,11,5,6,11
P'thinaikos,1331,3,1,1,4,5,11,-6,4
Panionios,1331,4,1,1,4,4,10,-6,4
AEK Athens,1332,1,4,2,0,7,1,6,14
PAOK Salonik,1332,2,2,2,2,11,7,4,8
P'thinaikos,1332,3,2,1,3,7,11,-4,7
Panionios,1332,4,1,1,4,4,10,-6,4
AEK Athens,1333,1,4,2,0,7,1,6,14
PAOK Salonik,1333,2,2,2,2,10,7,3,8
P'thinaikos,1333,3,2,1,3,7,10,-3,7
Panionios,1333,4,1,1,4,4,10,-6,4
AEK Athens,1334,1,4,2,0,7,1,6,14
PAOK Salonik,1334,2,3,2,1,11,4,7,11
Panionios,1334,3,1,1,4,4,10,-6,4
P'thinaikos,1334,4,1,1,4,4,11,-7,4
AEK Athens,1335,1,4,2,0,7,1,6,14
PAOK Salonik,1335,2,2,3,1,10,5,5,9
P'thinaikos,1335,3,1,2,3,5,10,-5,5
Panionios,1335,4,1,1,4,4,10,-6,4
AEK Athens,1336,1,4,2,0,7,1,6,14
PAOK Salonik,1336,2,3,2,1,12,6,6,11
P'thinaikos,1336,3,1,1,4,6,12,-6,4
Panionios,1336,4,1,1,4,4,10,-6,4
AEK Athens,1337,1,4,2,0,7,1,6,14
PAOK Salonik,1337,2,2,2,2,10,6,4,8
P'thinaikos,1337,3,2,1,3,6,10,-4,7
Panionios,1337,4,1,1,4,4,10,-6,4
AEK Athens,1338,1,4,2,0,7,1,6,14
PAOK Salonik,1338,2,2,3,1,9,4,5,9
P'thinaikos,1338,3,1,2,3,4,9,-5,5
Panionios,1338,4,1,1,4,4,10,-6,4
AEK Athens,1339,1,4,2,0,7,1,6,14
PAOK Salonik,1339,2,2,2,2,10,6,4,8
P'thinaikos,1339,3,2,1,3,6,10,-4,7
Panionios,1339,4,1,1,4,4,10,-6,4
AEK Athens,1340,1,4,2,0,7,1,6,14
PAOK Salonik,1340,2,2,3,1,10,5,5,9
P'thinaikos,1340,3,1,2,3,5,10,-5,5
Panionios,1340,4,1,1,4,4,10,-6,4
AEK Athens,1341,1,4,2,0,7,1,6,14
PAOK Salonik,1341,2,2,3,1,9,4,5,9
P'thinaikos,1341,3,1,2,3,4,9,-5,5
Panionios,1341,4,1,1,4,4,10,-6,4
AEK Athens,1342,1,4,2,0,7,1,6,14
PAOK Salonik,1342,2,2,2,2,9,5,4,8
P'thinaikos,1342,3,2,1,3,5,9,-4,7
Panionios,1342,4,1,1,4,4,10,-6,4
AEK Athens,1343,1,4,2,0,7,1,6,14
PAOK Salonik,1343,2,2,3,1,10,5,5,9
P'thinaikos,1343,3,1,2,3,5,10,-5,5
Panionios,1343,4,1,1,4,4,10,-6,4
AEK Athens,1344,1,4,2,0,7,1,6,14
PAOK Salonik,1344,2,3,2,1,12,4,8,11
Panionios,1344,3,1,1,4,4,10,-6,4
P'thinaikos,1344,4,1,1,4,4,12,-8,4
AEK Athens,1345,1,4,2,0,7,1,6,14
PAOK Salonik,1345,2,2,3,1,10,5,5,9
P'thinaikos,1345,3,1,2,3,5,10,-5,5
Panionios,1345,4,1,1,4,4,10,-6,4
AEK Athens,1346,1,4,2,0,7,1,6,14
PAOK Salonik,1346,2,3,2,1,10,4,6,11
P'thinaikos,1346,3,1,1,4,4,10,-6,4
Panionios,1346,3,1,1,4,4,10,-6,4
AEK Athens,1347,1,4,2,0,7,1,6,14
PAOK Salonik,1347,2,2,2,2,9,8,1,8
P'thinaikos,1347,3,2,1,3,8,9,-1,7
Panionios,1347,4,1,1,4,4,10,-6,4
AEK Athens,1348,1,4,2,0,7,1,6,14
PAOK Salonik,1348,2,3,2,1,10,4,6,11
P'thinaikos,1348,3,1,1,4,4,10,-6,4
Panionios,1348,3,1,1,4,4,10,-6,4
AEK Athens,1349,1,4,2,0,7,1,6,14
PAOK Salonik,1349,2,3,2,1,11,4,7,11
Panionios,1349,3,1,1,4,4,10,-6,4
P'thinaikos,1349,4,1,1,4,4,11,-7,4
AEK Athens,1350,1,4,2,0,7,1,6,14
PAOK Salonik,1350,2,2,2,2,10,8,2,8
P'thinaikos,1350,3,2,1,3,8,10,-2,7
Panionios,1350,4,1,1,4,4,10,-6,4
AEK Athens,1351,1,4,2,0,7,1,6,14
PAOK Salonik,1351,2,2,3,1,10,5,5,9
P'thinaikos,1351,3,1,2,3,5,10,-5,5
Panionios,1351,4,1,1,4,4,10,-6,4
AEK Athens,1352,1,4,2,0,7,1,6,14
PAOK Salonik,1352,2,2,3,1,12,7,5,9
P'thinaikos,1352,3,1,2,3,7,12,-5,5
Panionios,1352,4,1,1,4,4,10,-6,4
AEK Athens,1353,1,4,2,0,7,1,6,14
PAOK Salonik,1353,2,3,2,1,11,4,7,11
Panionios,1353,3,1,1,4,4,10,-6,4
P'thinaikos,1353,4,1,1,4,4,11,-7,4
AEK Athens,1354,1,4,2,0,7,1,6,14
PAOK Salonik,1354,2,3,2,1,10,4,6,11
P'thinaikos,1354,3,1,1,4,4,10,-6,4
Panionios,1354,3,1,1,4,4,10,-6,4
AEK Athens,1355,1,4,2,0,7,1,6,14
PAOK Salonik,1355,2,2,2,2,10,8,2,8
P'thinaikos,1355,3,2,1,3,8,10,-2,7
Panionios,1355,4,1,1,4,4,10,-6,4
AEK Athens,1356,1,4,2,0,7,1,6,14
PAOK Salonik,1356,2,3,2,1,10,4,6,11
P'thinaikos,1356,3,1,1,4,4,10,-6,4
Panionios,1356,3,1,1,4,4,10,-6,4
AEK Athens,1357,1,4,2,0,7,1,6,14
PAOK Salonik,1357,2,2,2,2,9,5,4,8
P'thinaikos,1357,3,2,1,3,5,9,-4,7
Panionios,1357,4,1,1,4,4,10,-6,4
AEK Athens,1358,1,4,2,0,7,1,6,14
PAOK Salonik,1358,2,3,2,1,11,4,7,11
Panionios,1358,3,1,1,4,4,10,-6,4
P'thinaikos,1358,4,1,1,4,4,11,-7,4
AEK Athens,1359,1,4,2,0,7,1,6,14
PAOK Salonik,1359,2,2,3,1,10,5,5,9
P'thinaikos,1359,3,1,2,3,5,10,-5,5
Panionios,1359,4,1,1,4,4,10,-6,4
AEK Athens,1360,1,4,2,0,7,1,6,14
PAOK Salonik,1360,2,3,2,1,11,5,6,11
P'thinaikos,1360,3,1,1,4,5,11,-6,4
Panionios,1360,4,1,1,4,4,10,-6,4
AEK Athens,1361,1,4,2,0,7,1,6,14
PAOK Salonik,1361,2,2,3,1,10,5,5,9
P'thinaikos,1361,3,1,2,3,5,10,-5,5
Panionios,1361,4,1,1,4,4,10,-6,4
AEK Athens,1362,1,4,2,0,7,1,6,14
PAOK Salonik,1362,2,3,2,1,11,4,7,11
Panionios,1362,3,1,1,4,4,10,-6,4
P'thinaikos,1362,4,1,1,4,4,11,-7,4
AEK Athens,1363,1,4,2,0,7,1,6,14
PAOK Salonik,1363,2,2,2,2,9,7,2,8
P'thinaikos,1363,3,2,1,3,7,9,-2,7
Panionios,1363,4,1,1,4,4,10,-6,4
AEK Athens,1364,1,4,2,0,7,1,6,14
PAOK Salonik,1364,2,3,2,1,11,4,7,11
Panionios,1364,3,1,1,4,4,10,-6,4
P'thinaikos,1364,4,1,1,4,4,11,-7,4
AEK Athens,1365,1,4,2,0,7,1,6,14
PAOK Salonik,1365,2,2,2,2,9,5,4,8
P'thinaikos,1365,3,2,1,3,5,9,-4,7
Panionios,1365,4,1,1,4,4,10,-6,4
AEK Athens,1366,1,4,2,0,7,1,6,14
PAOK Salonik,1366,2,2,2,2,9,5,4,8
P'thinaikos,1366,3,2,1,3,5,9,-4,7
Panionios,1366,4,1,1,4,4,10,-6,4
AEK Athens,1367,1,4,2,0,7,1,6,14
PAOK Salonik,1367,2,2,3,1,10,5,5,9
P'thinaikos,1367,3,1,2,3,5,10,-5,5
Panionios,1367,4,1,1,4,4,10,-6,4
AEK Athens,1368,1,4,2,0,7,1,6,14
PAOK Salonik,1368,2,3,2,1,11,5,6,11
P'thinaikos,1368,3,1,1,4,5,11,-6,4
Panionios,1368,4,1,1,4,4,10,-6,4
AEK Athens,1369,1,4,2,0,7,1,6,14
PAOK Salonik,1369,2,2,3,1,9,4,5,9
P'thinaikos,1369,3,1,2,3,4,9,-5,5
Panionios,1369,4,1,1,4,4,10,-6,4
AEK Athens,1370,1,4,2,0,7,1,6,14
PAOK Salonik,1370,2,2,2,2,10,7,3,8
P'thinaikos,1370,3,2,1,3,7,10,-3,7
Panionios,1370,4,1,1,4,4,10,-6,4
AEK Athens,1371,1,4,2,0,7,1,6,14
PAOK Salonik,1371,2,2,2,2,10,7,3,8
P'thinaikos,1371,3,2,1,3,7,10,-3,7
Panionios,1371,4,1,1,4,4,10,-6,4
AEK Athens,1372,1,4,2,0,7,1,6,14
PAOK Salonik,1372,2,2,2,2,10,6,4,8
P'thinaikos,1372,3,2,1,3,6,10,-4,7
Panionios,1372,4,1,1,4,4,10,-6,4
AEK Athens,1373,1,4,2,0,7,1,6,14
PAOK Salonik,1373,2,3,2,1,12,6,6,11
P'thinaikos,1373,3,1,1,4,6,12,-6,4
Panionios,1373,4,1,1,4,4,10,-6,4
AEK Athens,1374,1,4,2,0,7,1,6,14
PAOK Salonik,1374,2,2,3,1,10,5,5,9
P'thinaikos,1374,3,1,2,3,5,10,-5,5
Panionios,1374,4,1,1,4,4,10,-6,4
AEK Athens,1375,1,4,2,0,7,1,6,14
PAOK Salonik,1375,2,3,2,1,12,6,6,11
P'thinaikos,1375,3,1,1,4,6,12,-6,4
Panionios,1375,4,1,1,4,4,10,-6,4
AEK Athens,1376,1,4,2,0,7,1,6,14
PAOK Salonik,1376,2,3,2,1,10,4,6,11
P'thinaikos,1376,3,1,1,4,4,10,-6,4
Panionios,1376,3,1,1,4,4,10,-6,4
AEK Athens,1377,1,4,2,0,7,1,6,14
PAOK Salonik,1377,2,2,2,2,9,5,4,8
P'thinaikos,1377,3,2,1,3,5,9,-4,7
Panionios,1377,4,1,1,4,4,10,-6,4
AEK Athens,1378,1,4,2,0,7,1,6,14
PAOK Salonik,1378,2,2,2,2,9,5,4,8
P'thinaikos,1378,3,2,1,3,5,9,-4,7
Panionios,1378,4,1,1,4,4,10,-6,4
AEK Athens,1379,1,4,2,0,7,1,6,14
PAOK Salonik,1379,2,2,2,2,11,8,3,8
P'thinaikos,1379,3,2,1,3,8,11,-3,7
Panionios,1379,4,1,1,4,4,10,-6,4
AEK Athens,1380,1,4,2,0,7,1,6,14
PAOK Salonik,1380,2,3,2,1,11,4,7,11
Panionios,1380,3,1,1,4,4,10,-6,4
P'thinaikos,1380,4,1,1,4,4,11,-7,4
AEK Athens,1381,1,4,2,0,7,1,6,14
PAOK Salonik,1381,2,3,2,1,11,4,7,11
Panionios,1381,3,1,1,4,4,10,-6,4
P'thinaikos,1381,4,1,1,4,4,11,-7,4
AEK Athens,1382,1,4,2,0,7,1,6,14
PAOK Salonik,1382,2,3,2,1,11,4,7,11
Panionios,1382,3,1,1,4,4,10,-6,4
P'thinaikos,1382,4,1,1,4,4,11,-7,4
AEK Athens,1383,1,4,2,0,7,1,6,14
PAOK Salonik,1383,2,3,2,1,10,4,6,11
P'thinaikos,1383,3,1,1,4,4,10,-6,4
Panionios,1383,3,1,1,4,4,10,-6,4
AEK Athens,1384,1,4,2,0,7,1,6,14
PAOK Salonik,1384,2,2,3,1,9,4,5,9
P'thinaikos,1384,3,1,2,3,4,9,-5,5
Panionios,1384,4,1,1,4,4,10,-6,4
AEK Athens,1385,1,4,2,0,7,1,6,14
PAOK Salonik,1385,2,2,2,2,10,6,4,8
P'thinaikos,1385,3,2,1,3,6,10,-4,7
Panionios,1385,4,1,1,4,4,10,-6,4
AEK Athens,1386,1,4,2,0,7,1,6,14
PAOK Salonik,1386,2,2,2,2,11,7,4,8
P'thinaikos,1386,3,2,1,3,7,11,-4,7
Panionios,1386,4,1,1,4,4,10,-6,4
AEK Athens,1387,1,4,2,0,7,1,6,14
PAOK Salonik,1387,2,3,2,1,10,4,6,11
P'thinaikos,1387,3,1,1,4,4,10,-6,4
Panionios,1387,3,1,1,4,4,10,-6,4
AEK Athens,1388,1,4,2,0,7,1,6,14
PAOK Salonik,1388,2,3,2,1,10,4,6,11
P'thinaikos,1388,3,1,1,4,4,10,-6,4
Panionios,1388,3,1,1,4,4,10,-6,4
AEK Athens,1389,1,4,2,0,7,1,6,14
PAOK Salonik,1389,2,2,2,2,10,6,4,8
P'thinaikos,1389,3,2,1,3,6,10,-4,7
Panionios,1389,4,1,1,4,4,10,-6,4
AEK Athens,1390,1,4,2,0,7,1,6,14
PAOK Salonik,1390,2,3,2,1,11,4,7,11
Panionios,1390,3,1,1,4,4,10,-6,4
P'thinaikos,1390,4,1,1,4,4,11,-7,4
AEK Athens,1391,1,4,2,0,7,1,6,14
PAOK Salonik,1391,2,2,2,2,9,5,4,8
P'thinaikos,1391,3,2,1,3,5,9,-4,7
Panionios,1391,4,1,1,4,4,10,-6,4
AEK Athens,1392,1,4,2,0,7,1,6,14
PAOK Salonik,1392,2,2,2,2,9,5,4,8
P'thinaikos,1392,3,2,1,3,5,9,-4,7
Panionios,1392,4,1,1,4,4,10,-6,4
AEK Athens,1393,1,4,2,0,7,1,6,14
PAOK Salonik,1393,2,2,3,1,10,5,5,9
P'thinaikos,1393,3,1,2,3,5,10,-5,5
Panionios,1393,4,1,1,4,4,10,-6,4
AEK Athens,1394,1,4,2,0,7,1,6,14
PAOK Salonik,1394,2,2,3,1,10,5,5,9
P'thinaikos,1394,3,1,2,3,5,10,-5,5
Panionios,1394,4,1,1,4,4,10,-6,4
AEK Athens,1395,1,4,2,0,7,1,6,14
PAOK Salonik,1395,2,2,3,1,9,4,5,9
P'thinaikos,1395,3,1,2,3,4,9,-5,5
Panionios,1395,4,1,1,4,4,10,-6,4
AEK Athens,1396,1,4,2,0,7,1,6,14
PAOK Salonik,1396,2,2,3,1,11,6,5,9
P'thinaikos,1396,3,1,2,3,6,11,-5,5
Panionios,1396,4,1,1,4,4,10,-6,4
AEK Athens,1397,1,4,2,0,7,1,6,14
PAOK Salonik,1397,2,2,2,2,9,5,4,8
P'thinaikos,1397,3,2,1,3,5,9,-4,7
Panionios,1397,4,1,1,4,4,10,-6,4
AEK Athens,1398,1,4,2,0,7,1,6,14
PAOK Salonik,1398,2,2,2,2,10,6,4,8
P'thinaikos,1398,3,2,1,3,6,10,-4,7
Panionios,1398,4,1,1,4,4,10,-6,4
AEK Athens,1399,1,4,2,0,7,1,6,14
PAOK Salonik,1399,2,2,3,1,9,4,5,9
P'thinaikos,1399,3,1,2,3,4,9,-5,5
Panionios,1399,4,1,1,4,4,10,-6,4
AEK Athens,1400,1,4,2,0,7,1,6,14
PAOK Salonik,1400,2,2,3,1,9,4,5,9
P'thinaikos,1400,3,1,2,3,4,9,-5,5
Panionios,1400,4,1,1,4,4,10,-6,4
AEK Athens,1401,1,4,2,0,7,1,6,14
PAOK Salonik,1401,2,2,2,2,9,5,4,8
P'thinaikos,1401,3,2,1,3,5,9,-4,7
Panionios,1401,4,1,1,4,4,10,-6,4
AEK Athens,1402,1,4,2,0,7,1,6,14
PAOK Salonik,1402,2,2,2,2,11,7,4,8
P'thinaikos,1402,3,2,1,3,7,11,-4,7
Panionios,1402,4,1,1,4,4,10,-6,4
AEK Athens,1403,1,4,2,0,7,1,6,14
PAOK Salonik,1403,2,3,2,1,11,5,6,11
P'thinaikos,1403,3,1,1,4,5,11,-6,4
Panionios,1403,4,1,1,4,4,10,-6,4
AEK Athens,1404,1,4,2,0,7,1,6,14
PAOK Salonik,1404,2,2,2,2,9,5,4,8
P'thinaikos,1404,3,2,1,3,5,9,-4,7
Panionios,1404,4,1,1,4,4,10,-6,4
AEK Athens,1405,1,4,2,0,7,1,6,14
PAOK Salonik,1405,2,2,2,2,11,7,4,8
P'thinaikos,1405,3,2,1,3,7,11,-4,7
Panionios,1405,4,1,1,4,4,10,-6,4
AEK Athens,1406,1,4,2,0,7,1,6,14
PAOK Salonik,1406,2,2,3,1,9,4,5,9
P'thinaikos,1406,3,1,2,3,4,9,-5,5
Panionios,1406,4,1,1,4,4,10,-6,4
AEK Athens,1407,1,4,2,0,7,1,6,14
PAOK Salonik,1407,2,3,2,1,11,5,6,11
P'thinaikos,1407,3,1,1,4,5,11,-6,4
Panionios,1407,4,1,1,4,4,10,-6,4
AEK Athens,1408,1,4,2,0,7,1,6,14
PAOK Salonik,1408,2,2,2,2,10,8,2,8
P'thinaikos,1408,3,2,1,3,8,10,-2,7
Panionios,1408,4,1,1,4,4,10,-6,4
AEK Athens,1409,1,4,2,0,7,1,6,14
PAOK Salonik,1409,2,3,2,1,14,6,8,11
Panionios,1409,3,1,1,4,4,10,-6,4
P'thinaikos,1409,4,1,1,4,6,14,-8,4
AEK Athens,1410,1,4,2,0,7,1,6,14
PAOK Salonik,1410,2,2,2,2,9,5,4,8
P'thinaikos,1410,3,2,1,3,5,9,-4,7
Panionios,1410,4,1,1,4,4,10,-6,4
AEK Athens,1411,1,4,2,0,7,1,6,14
PAOK Salonik,1411,2,2,3,1,10,5,5,9
P'thinaikos,1411,3,1,2,3,5,10,-5,5
Panionios,1411,4,1,1,4,4,10,-6,4
AEK Athens,1412,1,4,2,0,7,1,6,14
PAOK Salonik,1412,2,3,2,1,10,4,6,11
P'thinaikos,1412,3,1,1,4,4,10,-6,4
Panionios,1412,3,1,1,4,4,10,-6,4
AEK Athens,1413,1,4,2,0,7,1,6,14
PAOK Salonik,1413,2,3,2,1,10,4,6,11
P'thinaikos,1413,3,1,1,4,4,10,-6,4
Panionios,1413,3,1,1,4,4,10,-6,4
AEK Athens,1414,1,4,2,0,7,1,6,14
PAOK Salonik,1414,2,3,2,1,10,4,6,11
P'thinaikos,1414,3,1,1,4,4,10,-6,4
Panionios,1414,3,1,1,4,4,10,-6,4
AEK Athens,1415,1,4,2,0,7,1,6,14
PAOK Salonik,1415,2,3,2,1,11,5,6,11
P'thinaikos,1415,3,1,1,4,5,11,-6,4
Panionios,1415,4,1,1,4,4,10,-6,4
AEK Athens,1416,1,4,2,0,7,1,6,14
PAOK Salonik,1416,2,3,2,1,10,4,6,11
P'thinaikos,1416,3,1,1,4,4,10,-6,4
Panionios,1416,3,1,1,4,4,10,-6,4
AEK Athens,1417,1,4,2,0,7,1,6,14
PAOK Salonik,1417,2,2,2,2,10,6,4,8
P'thinaikos,1417,3,2,1,3,6,10,-4,7
Panionios,1417,4,1,1,4,4,10,-6,4
AEK Athens,1418,1,4,2,0,7,1,6,14
PAOK Salonik,1418,2,2,3,1,9,4,5,9
P'thinaikos,1418,3,1,2,3,4,9,-5,5
Panionios,1418,4,1,1,4,4,10,-6,4
AEK Athens,1419,1,4,2,0,7,1,6,14
PAOK Salonik,1419,2,2,3,1,11,6,5,9
P'thinaikos,1419,3,1,2,3,6,11,-5,5
Panionios,1419,4,1,1,4,4,10,-6,4
AEK Athens,1420,1,4,2,0,7,1,6,14
PAOK Salonik,1420,2,3,2,1,11,5,6,11
P'thinaikos,1420,3,1,1,4,5,11,-6,4
Panionios,1420,4,1,1,4,4,10,-6,4
AEK Athens,1421,1,4,2,0,7,1,6,14
PAOK Salonik,1421,2,2,3,1,9,4,5,9
P'thinaikos,1421,3,1,2,3,4,9,-5,5
Panionios,1421,4,1,1,4,4,10,-6,4
AEK Athens,1422,1,4,2,0,7,1,6,14
PAOK Salonik,1422,2,2,3,1,10,5,5,9
P'thinaikos,1422,3,1,2,3,5,10,-5,5
Panionios,1422,4,1,1,4,4,10,-6,4
AEK Athens,1423,1,4,2,0,7,1,6,14
PAOK Salonik,1423,2,2,2,2,9,5,4,8
P'thinaikos,1423,3,2,1,3,5,9,-4,7
Panionios,1423,4,1,1,4,4,10,-6,4
AEK Athens,1424,1,4,2,0,7,1,6,14
PAOK Salonik,1424,2,3,2,1,11,5,6,11
P'thinaikos,1424,3,1,1,4,5,11,-6,4
Panionios,1424,4,1,1,4,4,10,-6,4
AEK Athens,1425,1,4,2,0,7,1,6,14
PAOK Salonik,1425,2,2,2,2,9,5,4,8
P'thinaikos,1425,3,2,1,3,5,9,-4,7
Panionios,1425,4,1,1,4,4,10,-6,4
AEK Athens,1426,1,4,2,0,7,1,6,14
PAOK Salonik,1426,2,2,2,2,10,6,4,8
P'thinaikos,1426,3,2,1,3,6,10,-4,7
Panionios,1426,4,1,1,4,4,10,-6,4
AEK Athens,1427,1,4,2,0,7,1,6,14
PAOK Salonik,1427,2,2,2,2,9,5,4,8
P'thinaikos,1427,3,2,1,3,5,9,-4,7
Panionios,1427,4,1,1,4,4,10,-6,4
AEK Athens,1428,1,4,2,0,7,1,6,14
PAOK Salonik,1428,2,2,2,2,9,5,4,8
P'thinaikos,1428,3,2,1,3,5,9,-4,7
Panionios,1428,4,1,1,4,4,10,-6,4
AEK Athens,1429,1,4,2,0,7,1,6,14
PAOK Salonik,1429,2,3,2,1,11,4,7,11
Panionios,1429,3,1,1,4,4,10,-6,4
P'thinaikos,1429,4,1,1,4,4,11,-7,4
AEK Athens,1430,1,4,2,0,7,1,6,14
PAOK Salonik,1430,2,3,2,1,11,4,7,11
Panionios,1430,3,1,1,4,4,10,-6,4
P'thinaikos,1430,4,1,1,4,4,11,-7,4
AEK Athens,1431,1,4,2,0,7,1,6,14
PAOK Salonik,1431,2,2,2,2,9,5,4,8
P'thinaikos,1431,3,2,1,3,5,9,-4,7
Panionios,1431,4,1,1,4,4,10,-6,4
AEK Athens,1432,1,4,2,0,7,1,6,14
PAOK Salonik,1432,2,2,3,1,11,6,5,9
P'thinaikos,1432,3,1,2,3,6,11,-5,5
Panionios,1432,4,1,1,4,4,10,-6,4
AEK Athens,1433,1,4,2,0,7,1,6,14
PAOK Salonik,1433,2,2,3,1,10,5,5,9
P'thinaikos,1433,3,1,2,3,5,10,-5,5
Panionios,1433,4,1,1,4,4,10,-6,4
AEK Athens,1434,1,4,2,0,7,1,6,14
PAOK Salonik,1434,2,3,2,1,13,5,8,11
Panionios,1434,3,1,1,4,4,10,-6,4
P'thinaikos,1434,4,1,1,4,5,13,-8,4
AEK Athens,1435,1,4,2,0,7,1,6,14
PAOK Salonik,1435,2,3,2,1,10,4,6,11
P'thinaikos,1435,3,1,1,4,4,10,-6,4
Panionios,1435,3,1,1,4,4,10,-6,4
AEK Athens,1436,1,4,2,0,7,1,6,14
PAOK Salonik,1436,2,3,2,1,12,4,8,11
Panionios,1436,3,1,1,4,4,10,-6,4
P'thinaikos,1436,4,1,1,4,4,12,-8,4
AEK Athens,1437,1,4,2,0,7,1,6,14
PAOK Salonik,1437,2,2,2,2,9,5,4,8
P'thinaikos,1437,3,2,1,3,5,9,-4,7
Panionios,1437,4,1,1,4,4,10,-6,4
AEK Athens,1438,1,4,2,0,7,1,6,14
PAOK Salonik,1438,2,2,3,1,10,5,5,9
P'thinaikos,1438,3,1,2,3,5,10,-5,5
Panionios,1438,4,1,1,4,4,10,-6,4
AEK Athens,1439,1,4,2,0,7,1,6,14
PAOK Salonik,1439,2,3,2,1,11,4,7,11
Panionios,1439,3,1,1,4,4,10,-6,4
P'thinaikos,1439,4,1,1,4,4,11,-7,4
AEK Athens,1440,1,4,2,0,7,1,6,14
PAOK Salonik,1440,2,2,2,2,11,7,4,8
P'thinaikos,1440,3,2,1,3,7,11,-4,7
Panionios,1440,4,1,1,4,4,10,-6,4
AEK Athens,1441,1,4,2,0,7,1,6,14
PAOK Salonik,1441,2,2,3,1,9,4,5,9
P'thinaikos,1441,3,1,2,3,4,9,-5,5
Panionios,1441,4,1,1,4,4,10,-6,4
AEK Athens,1442,1,4,2,0,7,1,6,14
PAOK Salonik,1442,2,2,2,2,9,6,3,8
P'thinaikos,1442,3,2,1,3,6,9,-3,7
Panionios,1442,4,1,1,4,4,10,-6,4
AEK Athens,1443,1,4,2,0,7,1,6,14
PAOK Salonik,1443,2,3,2,1,12,4,8,11
Panionios,1443,3,1,1,4,4,10,-6,4
P'thinaikos,1443,4,1,1,4,4,12,-8,4
AEK Athens,1444,1,4,2,0,7,1,6,14
PAOK Salonik,1444,2,2,3,1,10,5,5,9
P'thinaikos,1444,3,1,2,3,5,10,-5,5
Panionios,1444,4,1,1,4,4,10,-6,4
AEK Athens,1445,1,4,2,0,7,1,6,14
PAOK Salonik,1445,2,3,2,1,10,4,6,11
P'thinaikos,1445,3,1,1,4,4,10,-6,4
Panionios,1445,3,1,1,4,4,10,-6,4
AEK Athens,1446,1,4,2,0,7,1,6,14
PAOK Salonik,1446,2,3,2,1,10,4,6,11
P'thinaikos,1446,3,1,1,4,4,10,-6,4
Panionios,1446,3,1,1,4,4,10,-6,4
AEK Athens,1447,1,4,2,0,7,1,6,14
PAOK Salonik,1447,2,2,3,1,10,5,5,9
P'thinaikos,1447,3,1,2,3,5,10,-5,5
Panionios,1447,4,1,1,4,4,10,-6,4
AEK Athens,1448,1,4,2,0,7,1,6,14
PAOK Salonik,1448,2,2,2,2,9,5,4,8
P'thinaikos,1448,3,2,1,3,5,9,-4,7
Panionios,1448,4,1,1,4,4,10,-6,4
AEK Athens,1449,1,4,2,0,7,1,6,14
PAOK Salonik,1449,2,2,3,1,9,4,5,9
P'thinaikos,1449,3,1,2,3,4,9,-5,5
Panionios,1449,4,1,1,4,4,10,-6,4
AEK Athens,1450,1,4,2,0,7,1,6,14
PAOK Salonik,1450,2,2,3,1,10,5,5,9
P'thinaikos,1450,3,1,2,3,5,10,-5,5
Panionios,1450,4,1,1,4,4,10,-6,4
AEK Athens,1451,1,4,2,0,7,1,6,14
PAOK Salonik,1451,2,2,3,1,9,4,5,9
P'thinaikos,1451,3,1,2,3,4,9,-5,5
Panionios,1451,4,1,1,4,4,10,-6,4
AEK Athens,1452,1,4,2,0,7,1,6,14
PAOK Salonik,1452,2,2,3,1,11,6,5,9
P'thinaikos,1452,3,1,2,3,6,11,-5,5
Panionios,1452,4,1,1,4,4,10,-6,4
AEK Athens,1453,1,4,2,0,7,1,6,14
PAOK Salonik,1453,2,2,2,2,11,7,4,8
P'thinaikos,1453,3,2,1,3,7,11,-4,7
Panionios,1453,4,1,1,4,4,10,-6,4
AEK Athens,1454,1,4,2,0,7,1,6,14
PAOK Salonik,1454,2,3,2,1,12,5,7,11
Panionios,1454,3,1,1,4,4,10,-6,4
P'thinaikos,1454,4,1,1,4,5,12,-7,4
AEK Athens,1455,1,4,2,0,7,1,6,14
PAOK Salonik,1455,2,2,2,2,9,6,3,8
P'thinaikos,1455,3,2,1,3,6,9,-3,7
Panionios,1455,4,1,1,4,4,10,-6,4
AEK Athens,1456,1,4,2,0,7,1,6,14
PAOK Salonik,1456,2,2,3,1,9,4,5,9
P'thinaikos,1456,3,1,2,3,4,9,-5,5
Panionios,1456,4,1,1,4,4,10,-6,4
AEK Athens,1457,1,4,2,0,7,1,6,14
PAOK Salonik,1457,2,2,2,2,10,6,4,8
P'thinaikos,1457,3,2,1,3,6,10,-4,7
Panionios,1457,4,1,1,4,4,10,-6,4
AEK Athens,1458,1,4,2,0,7,1,6,14
PAOK Salonik,1458,2,2,2,2,9,5,4,8
P'thinaikos,1458,3,2,1,3,5,9,-4,7
Panionios,1458,4,1,1,4,4,10,-6,4
AEK Athens,1459,1,4,2,0,7,1,6,14
PAOK Salonik,1459,2,2,3,1,9,4,5,9
P'thinaikos,1459,3,1,2,3,4,9,-5,5
Panionios,1459,4,1,1,4,4,10,-6,4
AEK Athens,1460,1,4,2,0,7,1,6,14
PAOK Salonik,1460,2,2,3,1,11,6,5,9
P'thinaikos,1460,3,1,2,3,6,11,-5,5
Panionios,1460,4,1,1,4,4,10,-6,4
AEK Athens,1461,1,4,2,0,7,1,6,14
PAOK Salonik,1461,2,3,2,1,13,5,8,11
Panionios,1461,3,1,1,4,4,10,-6,4
P'thinaikos,1461,4,1,1,4,5,13,-8,4
AEK Athens,1462,1,4,2,0,7,1,6,14
PAOK Salonik,1462,2,2,2,2,9,5,4,8
P'thinaikos,1462,3,2,1,3,5,9,-4,7
Panionios,1462,4,1,1,4,4,10,-6,4
AEK Athens,1463,1,4,2,0,7,1,6,14
PAOK Salonik,1463,2,2,3,1,12,7,5,9
P'thinaikos,1463,3,1,2,3,7,12,-5,5
Panionios,1463,4,1,1,4,4,10,-6,4
AEK Athens,1464,1,4,2,0,7,1,6,14
PAOK Salonik,1464,2,2,3,1,9,4,5,9
P'thinaikos,1464,3,1,2,3,4,9,-5,5
Panionios,1464,4,1,1,4,4,10,-6,4
AEK Athens,1465,1,4,2,0,7,1,6,14
PAOK Salonik,1465,2,2,2,2,9,8,1,8
P'thinaikos,1465,3,2,1,3,8,9,-1,7
Panionios,1465,4,1,1,4,4,10,-6,4
AEK Athens,1466,1,4,2,0,7,1,6,14
PAOK Salonik,1466,2,2,3,1,9,4,5,9
P'thinaikos,1466,3,1,2,3,4,9,-5,5
Panionios,1466,4,1,1,4,4,10,-6,4
AEK Athens,1467,1,4,2,0,7,1,6,14
PAOK Salonik,1467,2,2,2,2,9,6,3,8
P'thinaikos,1467,3,2,1,3,6,9,-3,7
Panionios,1467,4,1,1,4,4,10,-6,4
AEK Athens,1468,1,4,2,0,7,1,6,14
PAOK Salonik,1468,2,3,2,1,11,5,6,11
P'thinaikos,1468,3,1,1,4,5,11,-6,4
Panionios,1468,4,1,1,4,4,10,-6,4
AEK Athens,1469,1,4,2,0,7,1,6,14
PAOK Salonik,1469,2,2,2,2,9,5,4,8
P'thinaikos,1469,3,2,1,3,5,9,-4,7
Panionios,1469,4,1,1,4,4,10,-6,4
AEK Athens,1470,1,4,2,0,7,1,6,14
PAOK Salonik,1470,2,3,2,1,11,4,7,11
Panionios,1470,3,1,1,4,4,10,-6,4
P'thinaikos,1470,4,1,1,4,4,11,-7,4
AEK Athens,1471,1,4,2,0,7,1,6,14
PAOK Salonik,1471,2,3,2,1,11,5,6,11
P'thinaikos,1471,3,1,1,4,5,11,-6,4
Panionios,1471,4,1,1,4,4,10,-6,4
AEK Athens,1472,1,4,2,0,7,1,6,14
PAOK Salonik,1472,2,2,3,1,10,5,5,9
P'thinaikos,1472,3,1,2,3,5,10,-5,5
Panionios,1472,4,1,1,4,4,10,-6,4
AEK Athens,1473,1,4,2,0,7,1,6,14
PAOK Salonik,1473,2,3,2,1,10,4,6,11
P'thinaikos,1473,3,1,1,4,4,10,-6,4
Panionios,1473,3,1,1,4,4,10,-6,4
AEK Athens,1474,1,4,2,0,7,1,6,14
PAOK Salonik,1474,2,2,3,1,11,6,5,9
P'thinaikos,1474,3,1,2,3,6,11,-5,5
Panionios,1474,4,1,1,4,4,10,-6,4
AEK Athens,1475,1,4,2,0,7,1,6,14
PAOK Salonik,1475,2,2,2,2,10,6,4,8
P'thinaikos,1475,3,2,1,3,6,10,-4,7
Panionios,1475,4,1,1,4,4,10,-6,4
AEK Athens,1476,1,4,2,0,7,1,6,14
PAOK Salonik,1476,2,2,3,1,10,5,5,9
P'thinaikos,1476,3,1,2,3,5,10,-5,5
Panionios,1476,4,1,1,4,4,10,-6,4
AEK Athens,1477,1,4,2,0,7,1,6,14
PAOK Salonik,1477,2,2,3,1,10,5,5,9
P'thinaikos,1477,3,1,2,3,5,10,-5,5
Panionios,1477,4,1,1,4,4,10,-6,4
AEK Athens,1478,1,4,2,0,7,1,6,14
PAOK Salonik,1478,2,2,2,2,9,8,1,8
P'thinaikos,1478,3,2,1,3,8,9,-1,7
Panionios,1478,4,1,1,4,4,10,-6,4
AEK Athens,1479,1,4,2,0,7,1,6,14
PAOK Salonik,1479,2,2,2,2,9,5,4,8
P'thinaikos,1479,3,2,1,3,5,9,-4,7
Panionios,1479,4,1,1,4,4,10,-6,4
AEK Athens,1480,1,4,2,0,7,1,6,14
PAOK Salonik,1480,2,2,3,1,9,4,5,9
P'thinaikos,1480,3,1,2,3,4,9,-5,5
Panionios,1480,4,1,1,4,4,10,-6,4
AEK Athens,1481,1,4,2,0,7,1,6,14
PAOK Salonik,1481,2,3,2,1,11,4,7,11
Panionios,1481,3,1,1,4,4,10,-6,4
P'thinaikos,1481,4,1,1,4,4,11,-7,4
AEK Athens,1482,1,4,2,0,7,1,6,14
PAOK Salonik,1482,2,3,2,1,10,4,6,11
P'thinaikos,1482,3,1,1,4,4,10,-6,4
Panionios,1482,3,1,1,4,4,10,-6,4
AEK Athens,1483,1,4,2,0,7,1,6,14
PAOK Salonik,1483,2,3,2,1,11,4,7,11
Panionios,1483,3,1,1,4,4,10,-6,4
P'thinaikos,1483,4,1,1,4,4,11,-7,4
AEK Athens,1484,1,4,2,0,7,1,6,14
PAOK Salonik,1484,2,3,2,1,13,5,8,11
Panionios,1484,3,1,1,4,4,10,-6,4
P'thinaikos,1484,4,1,1,4,5,13,-8,4
AEK Athens,1485,1,4,2,0,7,1,6,14
PAOK Salonik,1485,2,2,2,2,9,6,3,8
P'thinaikos,1485,3,2,1,3,6,9,-3,7
Panionios,1485,4,1,1,4,4,10,-6,4
AEK Athens,1486,1,4,2,0,7,1,6,14
PAOK Salonik,1486,2,2,3,1,10,5,5,9
P'thinaikos,1486,3,1,2,3,5,10,-5,5
Panionios,1486,4,1,1,4,4,10,-6,4
AEK Athens,1487,1,4,2,0,7,1,6,14
PAOK Salonik,1487,2,2,3,1,10,5,5,9
P'thinaikos,1487,3,1,2,3,5,10,-5,5
Panionios,1487,4,1,1,4,4,10,-6,4
AEK Athens,1488,1,4,2,0,7,1,6,14
PAOK Salonik,1488,2,2,3,1,10,5,5,9
P'thinaikos,1488,3,1,2,3,5,10,-5,5
Panionios,1488,4,1,1,4,4,10,-6,4
AEK Athens,1489,1,4,2,0,7,1,6,14
PAOK Salonik,1489,2,3,2,1,12,6,6,11
P'thinaikos,1489,3,1,1,4,6,12,-6,4
Panionios,1489,4,1,1,4,4,10,-6,4
AEK Athens,1490,1,4,2,0,7,1,6,14
PAOK Salonik,1490,2,2,3,1,10,5,5,9
P'thinaikos,1490,3,1,2,3,5,10,-5,5
Panionios,1490,4,1,1,4,4,10,-6,4
AEK Athens,1491,1,4,2,0,7,1,6,14
PAOK Salonik,1491,2,2,3,1,11,6,5,9
P'thinaikos,1491,3,1,2,3,6,11,-5,5
Panionios,1491,4,1,1,4,4,10,-6,4
AEK Athens,1492,1,4,2,0,7,1,6,14
PAOK Salonik,1492,2,2,2,2,10,6,4,8
P'thinaikos,1492,3,2,1,3,6,10,-4,7
Panionios,1492,4,1,1,4,4,10,-6,4
AEK Athens,1493,1,4,2,0,7,1,6,14
PAOK Salonik,1493,2,2,2,2,9,7,2,8
P'thinaikos,1493,3,2,1,3,7,9,-2,7
Panionios,1493,4,1,1,4,4,10,-6,4
AEK Athens,1494,1,4,2,0,7,1,6,14
PAOK Salonik,1494,2,3,2,1,11,5,6,11
P'thinaikos,1494,3,1,1,4,5,11,-6,4
Panionios,1494,4,1,1,4,4,10,-6,4
AEK Athens,1495,1,4,2,0,7,1,6,14
PAOK Salonik,1495,2,3,2,1,10,4,6,11
P'thinaikos,1495,3,1,1,4,4,10,-6,4
Panionios,1495,3,1,1,4,4,10,-6,4
AEK Athens,1496,1,4,2,0,7,1,6,14
PAOK Salonik,1496,2,3,2,1,12,4,8,11
Panionios,1496,3,1,1,4,4,10,-6,4
P'thinaikos,1496,4,1,1,4,4,12,-8,4
AEK Athens,1497,1,4,2,0,7,1,6,14
PAOK Salonik,1497,2,3,2,1,10,4,6,11
P'thinaikos,1497,3,1,1,4,4,10,-6,4
Panionios,1497,3,1,1,4,4,10,-6,4
AEK Athens,1498,1,4,2,0,7,1,6,14
PAOK Salonik,1498,2,2,3,1,9,4,5,9
P'thinaikos,1498,3,1,2,3,4,9,-5,5
Panionios,1498,4,1,1,4,4,10,-6,4
AEK Athens,1499,1,4,2,0,7,1,6,14
PAOK Salonik,1499,2,2,2,2,9,5,4,8
P'thinaikos,1499,3,2,1,3,5,9,-4,7
Panionios,1499,4,1,1,4,4,10,-6,4
AEK Athens,1500,1,4,2,0,7,1,6,14
PAOK Salonik,1500,2,2,3,1,10,5,5,9
P'thinaikos,1500,3,1,2,3,5,10,-5,5
Panionios,1500,4,1,1,4,4,10,-6,4
AEK Athens,1501,1,4,2,0,7,1,6,14
PAOK Salonik,1501,2,3,2,1,12,5,7,11
Panionios,1501,3,1,1,4,4,10,-6,4
P'thinaikos,1501,4,1,1,4,5,12,-7,4
AEK Athens,1502,1,4,2,0,7,1,6,14
PAOK Salonik,1502,2,2,2,2,10,6,4,8
P'thinaikos,1502,3,2,1,3,6,10,-4,7
Panionios,1502,4,1,1,4,4,10,-6,4
AEK Athens,1503,1,4,2,0,7,1,6,14
PAOK Salonik,1503,2,2,2,2,9,5,4,8
P'thinaikos,1503,3,2,1,3,5,9,-4,7
Panionios,1503,4,1,1,4,4,10,-6,4
AEK Athens,1504,1,4,2,0,7,1,6,14
PAOK Salonik,1504,2,2,2,2,9,5,4,8
P'thinaikos,1504,3,2,1,3,5,9,-4,7
Panionios,1504,4,1,1,4,4,10,-6,4
AEK Athens,1505,1,4,2,0,7,1,6,14
PAOK Salonik,1505,2,2,3,1,9,4,5,9
P'thinaikos,1505,3,1,2,3,4,9,-5,5
Panionios,1505,4,1,1,4,4,10,-6,4
AEK Athens,1506,1,4,2,0,7,1,6,14
PAOK Salonik,1506,2,2,3,1,10,5,5,9
P'thinaikos,1506,3,1,2,3,5,10,-5,5
Panionios,1506,4,1,1,4,4,10,-6,4
AEK Athens,1507,1,4,2,0,7,1,6,14
PAOK Salonik,1507,2,2,2,2,11,7,4,8
P'thinaikos,1507,3,2,1,3,7,11,-4,7
Panionios,1507,4,1,1,4,4,10,-6,4
AEK Athens,1508,1,4,2,0,7,1,6,14
PAOK Salonik,1508,2,2,2,2,11,9,2,8
P'thinaikos,1508,3,2,1,3,9,11,-2,7
Panionios,1508,4,1,1,4,4,10,-6,4
AEK Athens,1509,1,4,2,0,7,1,6,14
PAOK Salonik,1509,2,2,2,2,10,6,4,8
P'thinaikos,1509,3,2,1,3,6,10,-4,7
Panionios,1509,4,1,1,4,4,10,-6,4
AEK Athens,1510,1,4,2,0,7,1,6,14
PAOK Salonik,1510,2,2,3,1,10,5,5,9
P'thinaikos,1510,3,1,2,3,5,10,-5,5
Panionios,1510,4,1,1,4,4,10,-6,4
AEK Athens,1511,1,4,2,0,7,1,6,14
PAOK Salonik,1511,2,3,2,1,11,4,7,11
Panionios,1511,3,1,1,4,4,10,-6,4
P'thinaikos,1511,4,1,1,4,4,11,-7,4
AEK Athens,1512,1,4,2,0,7,1,6,14
PAOK Salonik,1512,2,3,2,1,10,4,6,11
P'thinaikos,1512,3,1,1,4,4,10,-6,4
Panionios,1512,3,1,1,4,4,10,-6,4
AEK Athens,1513,1,4,2,0,7,1,6,14
PAOK Salonik,1513,2,2,3,1,10,5,5,9
P'thinaikos,1513,3,1,2,3,5,10,-5,5
Panionios,1513,4,1,1,4,4,10,-6,4
AEK Athens,1514,1,4,2,0,7,1,6,14
PAOK Salonik,1514,2,2,3,1,10,5,5,9
P'thinaikos,1514,3,1,2,3,5,10,-5,5
Panionios,1514,4,1,1,4,4,10,-6,4
AEK Athens,1515,1,4,2,0,7,1,6,14
PAOK Salonik,1515,2,2,2,2,11,7,4,8
P'thinaikos,1515,3,2,1,3,7,11,-4,7
Panionios,1515,4,1,1,4,4,10,-6,4
AEK Athens,1516,1,4,2,0,7,1,6,14
PAOK Salonik,1516,2,3,2,1,10,4,6,11
P'thinaikos,1516,3,1,1,4,4,10,-6,4
Panionios,1516,3,1,1,4,4,10,-6,4
AEK Athens,1517,1,4,2,0,7,1,6,14
PAOK Salonik,1517,2,2,2,2,9,5,4,8
P'thinaikos,1517,3,2,1,3,5,9,-4,7
Panionios,1517,4,1,1,4,4,10,-6,4
AEK Athens,1518,1,4,2,0,7,1,6,14
PAOK Salonik,1518,2,2,3,1,11,6,5,9
P'thinaikos,1518,3,1,2,3,6,11,-5,5
Panionios,1518,4,1,1,4,4,10,-6,4
AEK Athens,1519,1,4,2,0,7,1,6,14
PAOK Salonik,1519,2,2,2,2,9,6,3,8
P'thinaikos,1519,3,2,1,3,6,9,-3,7
Panionios,1519,4,1,1,4,4,10,-6,4
AEK Athens,1520,1,4,2,0,7,1,6,14
PAOK Salonik,1520,2,2,2,2,9,6,3,8
P'thinaikos,1520,3,2,1,3,6,9,-3,7
Panionios,1520,4,1,1,4,4,10,-6,4
AEK Athens,1521,1,4,2,0,7,1,6,14
PAOK Salonik,1521,2,3,2,1,10,4,6,11
P'thinaikos,1521,3,1,1,4,4,10,-6,4
Panionios,1521,3,1,1,4,4,10,-6,4
AEK Athens,1522,1,4,2,0,7,1,6,14
PAOK Salonik,1522,2,3,2,1,11,4,7,11
Panionios,1522,3,1,1,4,4,10,-6,4
P'thinaikos,1522,4,1,1,4,4,11,-7,4
AEK Athens,1523,1,4,2,0,7,1,6,14
PAOK Salonik,1523,2,3,2,1,10,4,6,11
P'thinaikos,1523,3,1,1,4,4,10,-6,4
Panionios,1523,3,1,1,4,4,10,-6,4
AEK Athens,1524,1,4,2,0,7,1,6,14
PAOK Salonik,1524,2,3,2,1,10,4,6,11
P'thinaikos,1524,3,1,1,4,4,10,-6,4
Panionios,1524,3,1,1,4,4,10,-6,4
AEK Athens,1525,1,4,2,0,7,1,6,14
PAOK Salonik,1525,2,3,2,1,12,4,8,11
Panionios,1525,3,1,1,4,4,10,-6,4
P'thinaikos,1525,4,1,1,4,4,12,-8,4
AEK Athens,1526,1,4,2,0,7,1,6,14
PAOK Salonik,1526,2,2,3,1,10,5,5,9
P'thinaikos,1526,3,1,2,3,5,10,-5,5
Panionios,1526,4,1,1,4,4,10,-6,4
AEK Athens,1527,1,4,2,0,7,1,6,14
PAOK Salonik,1527,2,3,2,1,11,5,6,11
P'thinaikos,1527,3,1,1,4,5,11,-6,4
Panionios,1527,4,1,1,4,4,10,-6,4
AEK Athens,1528,1,4,2,0,7,1,6,14
PAOK Salonik,1528,2,2,2,2,9,5,4,8
P'thinaikos,1528,3,2,1,3,5,9,-4,7
Panionios,1528,4,1,1,4,4,10,-6,4
AEK Athens,1529,1,4,2,0,7,1,6,14
PAOK Salonik,1529,2,2,2,2,10,6,4,8
P'thinaikos,1529,3,2,1,3,6,10,-4,7
Panionios,1529,4,1,1,4,4,10,-6,4
AEK Athens,1530,1,4,2,0,7,1,6,14
PAOK Salonik,1530,2,3,2,1,11,5,6,11
P'thinaikos,1530,3,1,1,4,5,11,-6,4
Panionios,1530,4,1,1,4,4,10,-6,4
AEK Athens,1531,1,4,2,0,7,1,6,14
PAOK Salonik,1531,2,2,3,1,9,4,5,9
P'thinaikos,1531,3,1,2,3,4,9,-5,5
Panionios,1531,4,1,1,4,4,10,-6,4
AEK Athens,1532,1,4,2,0,7,1,6,14
PAOK Salonik,1532,2,2,3,1,10,5,5,9
P'thinaikos,1532,3,1,2,3,5,10,-5,5
Panionios,1532,4,1,1,4,4,10,-6,4
AEK Athens,1533,1,4,2,0,7,1,6,14
PAOK Salonik,1533,2,2,3,1,11,6,5,9
P'thinaikos,1533,3,1,2,3,6,11,-5,5
Panionios,1533,4,1,1,4,4,10,-6,4
AEK Athens,1534,1,4,2,0,7,1,6,14
PAOK Salonik,1534,2,3,2,1,12,4,8,11
Panionios,1534,3,1,1,4,4,10,-6,4
P'thinaikos,1534,4,1,1,4,4,12,-8,4
AEK Athens,1535,1,4,2,0,7,1,6,14
PAOK Salonik,1535,2,3,2,1,11,4,7,11
Panionios,1535,3,1,1,4,4,10,-6,4
P'thinaikos,1535,4,1,1,4,4,11,-7,4
AEK Athens,1536,1,4,2,0,7,1,6,14
PAOK Salonik,1536,2,2,2,2,9,5,4,8
P'thinaikos,1536,3,2,1,3,5,9,-4,7
Panionios,1536,4,1,1,4,4,10,-6,4
AEK Athens,1537,1,4,2,0,7,1,6,14
PAOK Salonik,1537,2,3,2,1,12,6,6,11
P'thinaikos,1537,3,1,1,4,6,12,-6,4
Panionios,1537,4,1,1,4,4,10,-6,4
AEK Athens,1538,1,4,2,0,7,1,6,14
PAOK Salonik,1538,2,3,2,1,12,4,8,11
Panionios,1538,3,1,1,4,4,10,-6,4
P'thinaikos,1538,4,1,1,4,4,12,-8,4
AEK Athens,1539,1,4,2,0,7,1,6,14
PAOK Salonik,1539,2,3,2,1,11,5,6,11
P'thinaikos,1539,3,1,1,4,5,11,-6,4
Panionios,1539,4,1,1,4,4,10,-6,4
AEK Athens,1540,1,4,2,0,7,1,6,14
PAOK Salonik,1540,2,2,2,2,9,6,3,8
P'thinaikos,1540,3,2,1,3,6,9,-3,7
Panionios,1540,4,1,1,4,4,10,-6,4
AEK Athens,1541,1,4,2,0,7,1,6,14
PAOK Salonik,1541,2,2,3,1,11,6,5,9
P'thinaikos,1541,3,1,2,3,6,11,-5,5
Panionios,1541,4,1,1,4,4,10,-6,4
AEK Athens,1542,1,4,2,0,7,1,6,14
PAOK Salonik,1542,2,2,2,2,9,7,2,8
P'thinaikos,1542,3,2,1,3,7,9,-2,7
Panionios,1542,4,1,1,4,4,10,-6,4
AEK Athens,1543,1,4,2,0,7,1,6,14
PAOK Salonik,1543,2,2,2,2,10,6,4,8
P'thinaikos,1543,3,2,1,3,6,10,-4,7
Panionios,1543,4,1,1,4,4,10,-6,4
AEK Athens,1544,1,4,2,0,7,1,6,14
PAOK Salonik,1544,2,2,3,1,10,5,5,9
P'thinaikos,1544,3,1,2,3,5,10,-5,5
Panionios,1544,4,1,1,4,4,10,-6,4
AEK Athens,1545,1,4,2,0,7,1,6,14
PAOK Salonik,1545,2,3,2,1,11,5,6,11
P'thinaikos,1545,3,1,1,4,5,11,-6,4
Panionios,1545,4,1,1,4,4,10,-6,4
AEK Athens,1546,1,4,2,0,7,1,6,14
PAOK Salonik,1546,2,2,2,2,9,5,4,8
P'thinaikos,1546,3,2,1,3,5,9,-4,7
Panionios,1546,4,1,1,4,4,10,-6,4
AEK Athens,1547,1,4,2,0,7,1,6,14
PAOK Salonik,1547,2,2,3,1,10,5,5,9
P'thinaikos,1547,3,1,2,3,5,10,-5,5
Panionios,1547,4,1,1,4,4,10,-6,4
AEK Athens,1548,1,4,2,0,7,1,6,14
PAOK Salonik,1548,2,3,2,1,11,5,6,11
P'thinaikos,1548,3,1,1,4,5,11,-6,4
Panionios,1548,4,1,1,4,4,10,-6,4
AEK Athens,1549,1,4,2,0,7,1,6,14
PAOK Salonik,1549,2,3,2,1,11,5,6,11
P'thinaikos,1549,3,1,1,4,5,11,-6,4
Panionios,1549,4,1,1,4,4,10,-6,4
AEK Athens,1550,1,4,2,0,7,1,6,14
PAOK Salonik,1550,2,2,3,1,10,5,5,9
P'thinaikos,1550,3,1,2,3,5,10,-5,5
Panionios,1550,4,1,1,4,4,10,-6,4
AEK Athens,1551,1,4,2,0,7,1,6,14
PAOK Salonik,1551,2,2,2,2,9,5,4,8
P'thinaikos,1551,3,2,1,3,5,9,-4,7
Panionios,1551,4,1,1,4,4,10,-6,4
AEK Athens,1552,1,4,2,0,7,1,6,14
PAOK Salonik,1552,2,2,2,2,9,5,4,8
P'thinaikos,1552,3,2,1,3,5,9,-4,7
Panionios,1552,4,1,1,4,4,10,-6,4
AEK Athens,1553,1,4,2,0,7,1,6,14
PAOK Salonik,1553,2,2,2,2,9,5,4,8
P'thinaikos,1553,3,2,1,3,5,9,-4,7
Panionios,1553,4,1,1,4,4,10,-6,4
AEK Athens,1554,1,4,2,0,7,1,6,14
PAOK Salonik,1554,2,2,2,2,10,6,4,8
P'thinaikos,1554,3,2,1,3,6,10,-4,7
Panionios,1554,4,1,1,4,4,10,-6,4
AEK Athens,1555,1,4,2,0,7,1,6,14
PAOK Salonik,1555,2,3,2,1,13,4,9,11
Panionios,1555,3,1,1,4,4,10,-6,4
P'thinaikos,1555,4,1,1,4,4,13,-9,4
AEK Athens,1556,1,4,2,0,7,1,6,14
PAOK Salonik,1556,2,2,3,1,9,4,5,9
P'thinaikos,1556,3,1,2,3,4,9,-5,5
Panionios,1556,4,1,1,4,4,10,-6,4
AEK Athens,1557,1,4,2,0,7,1,6,14
PAOK Salonik,1557,2,2,2,2,9,5,4,8
P'thinaikos,1557,3,2,1,3,5,9,-4,7
Panionios,1557,4,1,1,4,4,10,-6,4
AEK Athens,1558,1,4,2,0,7,1,6,14
PAOK Salonik,1558,2,2,2,2,10,6,4,8
P'thinaikos,1558,3,2,1,3,6,10,-4,7
Panionios,1558,4,1,1,4,4,10,-6,4
AEK Athens,1559,1,4,2,0,7,1,6,14
PAOK Salonik,1559,2,2,2,2,9,6,3,8
P'thinaikos,1559,3,2,1,3,6,9,-3,7
Panionios,1559,4,1,1,4,4,10,-6,4
AEK Athens,1560,1,4,2,0,7,1,6,14
PAOK Salonik,1560,2,2,3,1,9,4,5,9
P'thinaikos,1560,3,1,2,3,4,9,-5,5
Panionios,1560,4,1,1,4,4,10,-6,4
AEK Athens,1561,1,4,2,0,7,1,6,14
PAOK Salonik,1561,2,3,2,1,10,4,6,11
P'thinaikos,1561,3,1,1,4,4,10,-6,4
Panionios,1561,3,1,1,4,4,10,-6,4
AEK Athens,1562,1,4,2,0,7,1,6,14
PAOK Salonik,1562,2,2,3,1,11,6,5,9
P'thinaikos,1562,3,1,2,3,6,11,-5,5
Panionios,1562,4,1,1,4,4,10,-6,4
AEK Athens,1563,1,4,2,0,7,1,6,14
PAOK Salonik,1563,2,3,2,1,10,4,6,11
P'thinaikos,1563,3,1,1,4,4,10,-6,4
Panionios,1563,3,1,1,4,4,10,-6,4
AEK Athens,1564,1,4,2,0,7,1,6,14
PAOK Salonik,1564,2,2,2,2,9,5,4,8
P'thinaikos,1564,3,2,1,3,5,9,-4,7
Panionios,1564,4,1,1,4,4,10,-6,4
AEK Athens,1565,1,4,2,0,7,1,6,14
PAOK Salonik,1565,2,2,3,1,9,4,5,9
P'thinaikos,1565,3,1,2,3,4,9,-5,5
Panionios,1565,4,1,1,4,4,10,-6,4
AEK Athens,1566,1,4,2,0,7,1,6,14
PAOK Salonik,1566,2,3,2,1,11,4,7,11
Panionios,1566,3,1,1,4,4,10,-6,4
P'thinaikos,1566,4,1,1,4,4,11,-7,4
AEK Athens,1567,1,4,2,0,7,1,6,14
PAOK Salonik,1567,2,2,2,2,9,5,4,8
P'thinaikos,1567,3,2,1,3,5,9,-4,7
Panionios,1567,4,1,1,4,4,10,-6,4
AEK Athens,1568,1,4,2,0,7,1,6,14
PAOK Salonik,1568,2,3,2,1,10,4,6,11
P'thinaikos,1568,3,1,1,4,4,10,-6,4
Panionios,1568,3,1,1,4,4,10,-6,4
AEK Athens,1569,1,4,2,0,7,1,6,14
PAOK Salonik,1569,2,2,3,1,9,4,5,9
P'thinaikos,1569,3,1,2,3,4,9,-5,5
Panionios,1569,4,1,1,4,4,10,-6,4
AEK Athens,1570,1,4,2,0,7,1,6,14
PAOK Salonik,1570,2,2,2,2,9,8,1,8
P'thinaikos,1570,3,2,1,3,8,9,-1,7
Panionios,1570,4,1,1,4,4,10,-6,4
AEK Athens,1571,1,4,2,0,7,1,6,14
PAOK Salonik,1571,2,2,3,1,10,5,5,9
P'thinaikos,1571,3,1,2,3,5,10,-5,5
Panionios,1571,4,1,1,4,4,10,-6,4
AEK Athens,1572,1,4,2,0,7,1,6,14
PAOK Salonik,1572,2,2,2,2,9,5,4,8
P'thinaikos,1572,3,2,1,3,5,9,-4,7
Panionios,1572,4,1,1,4,4,10,-6,4
AEK Athens,1573,1,4,2,0,7,1,6,14
PAOK Salonik,1573,2,2,3,1,9,4,5,9
P'thinaikos,1573,3,1,2,3,4,9,-5,5
Panionios,1573,4,1,1,4,4,10,-6,4
AEK Athens,1574,1,4,2,0,7,1,6,14
PAOK Salonik,1574,2,2,3,1,10,5,5,9
P'thinaikos,1574,3,1,2,3,5,10,-5,5
Panionios,1574,4,1,1,4,4,10,-6,4
AEK Athens,1575,1,4,2,0,7,1,6,14
PAOK Salonik,1575,2,3,2,1,13,5,8,11
Panionios,1575,3,1,1,4,4,10,-6,4
P'thinaikos,1575,4,1,1,4,5,13,-8,4
AEK Athens,1576,1,4,2,0,7,1,6,14
PAOK Salonik,1576,2,2,2,2,10,6,4,8
P'thinaikos,1576,3,2,1,3,6,10,-4,7
Panionios,1576,4,1,1,4,4,10,-6,4
AEK Athens,1577,1,4,2,0,7,1,6,14
PAOK Salonik,1577,2,3,2,1,10,4,6,11
P'thinaikos,1577,3,1,1,4,4,10,-6,4
Panionios,1577,3,1,1,4,4,10,-6,4
AEK Athens,1578,1,4,2,0,7,1,6,14
PAOK Salonik,1578,2,2,3,1,10,5,5,9
P'thinaikos,1578,3,1,2,3,5,10,-5,5
Panionios,1578,4,1,1,4,4,10,-6,4
AEK Athens,1579,1,4,2,0,7,1,6,14
PAOK Salonik,1579,2,2,2,2,9,5,4,8
P'thinaikos,1579,3,2,1,3,5,9,-4,7
Panionios,1579,4,1,1,4,4,10,-6,4
AEK Athens,1580,1,4,2,0,7,1,6,14
PAOK Salonik,1580,2,2,3,1,10,5,5,9
P'thinaikos,1580,3,1,2,3,5,10,-5,5
Panionios,1580,4,1,1,4,4,10,-6,4
AEK Athens,1581,1,4,2,0,7,1,6,14
PAOK Salonik,1581,2,3,2,1,12,4,8,11
Panionios,1581,3,1,1,4,4,10,-6,4
P'thinaikos,1581,4,1,1,4,4,12,-8,4
AEK Athens,1582,1,4,2,0,7,1,6,14
PAOK Salonik,1582,2,2,2,2,9,6,3,8
P'thinaikos,1582,3,2,1,3,6,9,-3,7
Panionios,1582,4,1,1,4,4,10,-6,4
AEK Athens,1583,1,4,2,0,7,1,6,14
PAOK Salonik,1583,2,2,3,1,12,7,5,9
P'thinaikos,1583,3,1,2,3,7,12,-5,5
Panionios,1583,4,1,1,4,4,10,-6,4
AEK Athens,1584,1,4,2,0,7,1,6,14
PAOK Salonik,1584,2,3,2,1,11,5,6,11
P'thinaikos,1584,3,1,1,4,5,11,-6,4
Panionios,1584,4,1,1,4,4,10,-6,4
AEK Athens,1585,1,4,2,0,7,1,6,14
PAOK Salonik,1585,2,2,2,2,9,5,4,8
P'thinaikos,1585,3,2,1,3,5,9,-4,7
Panionios,1585,4,1,1,4,4,10,-6,4
AEK Athens,1586,1,4,2,0,7,1,6,14
PAOK Salonik,1586,2,2,2,2,9,6,3,8
P'thinaikos,1586,3,2,1,3,6,9,-3,7
Panionios,1586,4,1,1,4,4,10,-6,4
AEK Athens,1587,1,4,2,0,7,1,6,14
PAOK Salonik,1587,2,2,2,2,10,6,4,8
P'thinaikos,1587,3,2,1,3,6,10,-4,7
Panionios,1587,4,1,1,4,4,10,-6,4
AEK Athens,1588,1,4,2,0,7,1,6,14
PAOK Salonik,1588,2,2,2,2,9,6,3,8
P'thinaikos,1588,3,2,1,3,6,9,-3,7
Panionios,1588,4,1,1,4,4,10,-6,4
AEK Athens,1589,1,4,2,0,7,1,6,14
PAOK Salonik,1589,2,2,3,1,9,4,5,9
P'thinaikos,1589,3,1,2,3,4,9,-5,5
Panionios,1589,4,1,1,4,4,10,-6,4
AEK Athens,1590,1,4,2,0,7,1,6,14
PAOK Salonik,1590,2,2,3,1,11,6,5,9
P'thinaikos,1590,3,1,2,3,6,11,-5,5
Panionios,1590,4,1,1,4,4,10,-6,4
AEK Athens,1591,1,4,2,0,7,1,6,14
PAOK Salonik,1591,2,3,2,1,10,4,6,11
P'thinaikos,1591,3,1,1,4,4,10,-6,4
Panionios,1591,3,1,1,4,4,10,-6,4
AEK Athens,1592,1,4,2,0,7,1,6,14
PAOK Salonik,1592,2,2,2,2,9,5,4,8
P'thinaikos,1592,3,2,1,3,5,9,-4,7
Panionios,1592,4,1,1,4,4,10,-6,4
AEK Athens,1593,1,4,2,0,7,1,6,14
PAOK Salonik,1593,2,3,2,1,10,4,6,11
P'thinaikos,1593,3,1,1,4,4,10,-6,4
Panionios,1593,3,1,1,4,4,10,-6,4
AEK Athens,1594,1,4,2,0,7,1,6,14
PAOK Salonik,1594,2,2,2,2,10,6,4,8
P'thinaikos,1594,3,2,1,3,6,10,-4,7
Panionios,1594,4,1,1,4,4,10,-6,4
AEK Athens,1595,1,4,2,0,7,1,6,14
PAOK Salonik,1595,2,2,3,1,10,5,5,9
P'thinaikos,1595,3,1,2,3,5,10,-5,5
Panionios,1595,4,1,1,4,4,10,-6,4
AEK Athens,1596,1,4,2,0,7,1,6,14
PAOK Salonik,1596,2,3,2,1,12,5,7,11
Panionios,1596,3,1,1,4,4,10,-6,4
P'thinaikos,1596,4,1,1,4,5,12,-7,4
AEK Athens,1597,1,4,2,0,7,1,6,14
PAOK Salonik,1597,2,2,2,2,9,6,3,8
P'thinaikos,1597,3,2,1,3,6,9,-3,7
Panionios,1597,4,1,1,4,4,10,-6,4
AEK Athens,1598,1,4,2,0,7,1,6,14
PAOK Salonik,1598,2,2,2,2,10,7,3,8
P'thinaikos,1598,3,2,1,3,7,10,-3,7
Panionios,1598,4,1,1,4,4,10,-6,4
AEK Athens,1599,1,4,2,0,7,1,6,14
PAOK Salonik,1599,2,2,2,2,10,7,3,8
P'thinaikos,1599,3,2,1,3,7,10,-3,7
Panionios,1599,4,1,1,4,4,10,-6,4
AEK Athens,1600,1,4,2,0,7,1,6,14
PAOK Salonik,1600,2,3,2,1,10,4,6,11
P'thinaikos,1600,3,1,1,4,4,10,-6,4
Panionios,1600,3,1,1,4,4,10,-6,4
AEK Athens,1601,1,4,2,0,7,1,6,14
PAOK Salonik,1601,2,2,2,2,9,5,4,8
P'thinaikos,1601,3,2,1,3,5,9,-4,7
Panionios,1601,4,1,1,4,4,10,-6,4
AEK Athens,1602,1,4,2,0,7,1,6,14
PAOK Salonik,1602,2,3,2,1,12,5,7,11
Panionios,1602,3,1,1,4,4,10,-6,4
P'thinaikos,1602,4,1,1,4,5,12,-7,4
AEK Athens,1603,1,4,2,0,7,1,6,14
PAOK Salonik,1603,2,2,2,2,10,6,4,8
P'thinaikos,1603,3,2,1,3,6,10,-4,7
Panionios,1603,4,1,1,4,4,10,-6,4
AEK Athens,1604,1,4,2,0,7,1,6,14
PAOK Salonik,1604,2,3,2,1,11,5,6,11
P'thinaikos,1604,3,1,1,4,5,11,-6,4
Panionios,1604,4,1,1,4,4,10,-6,4
AEK Athens,1605,1,4,2,0,7,1,6,14
PAOK Salonik,1605,2,2,3,1,11,6,5,9
P'thinaikos,1605,3,1,2,3,6,11,-5,5
Panionios,1605,4,1,1,4,4,10,-6,4
AEK Athens,1606,1,4,2,0,7,1,6,14
PAOK Salonik,1606,2,2,2,2,11,7,4,8
P'thinaikos,1606,3,2,1,3,7,11,-4,7
Panionios,1606,4,1,1,4,4,10,-6,4
AEK Athens,1607,1,4,2,0,7,1,6,14
PAOK Salonik,1607,2,2,2,2,9,5,4,8
P'thinaikos,1607,3,2,1,3,5,9,-4,7
Panionios,1607,4,1,1,4,4,10,-6,4
AEK Athens,1608,1,4,2,0,7,1,6,14
PAOK Salonik,1608,2,2,3,1,10,5,5,9
P'thinaikos,1608,3,1,2,3,5,10,-5,5
Panionios,1608,4,1,1,4,4,10,-6,4
AEK Athens,1609,1,4,2,0,7,1,6,14
PAOK Salonik,1609,2,2,3,1,10,5,5,9
P'thinaikos,1609,3,1,2,3,5,10,-5,5
Panionios,1609,4,1,1,4,4,10,-6,4
AEK Athens,1610,1,4,2,0,7,1,6,14
PAOK Salonik,1610,2,2,2,2,10,7,3,8
P'thinaikos,1610,3,2,1,3,7,10,-3,7
Panionios,1610,4,1,1,4,4,10,-6,4
AEK Athens,1611,1,4,2,0,7,1,6,14
PAOK Salonik,1611,2,2,2,2,9,6,3,8
P'thinaikos,1611,3,2,1,3,6,9,-3,7
Panionios,1611,4,1,1,4,4,10,-6,4
AEK Athens,1612,1,4,2,0,7,1,6,14
PAOK Salonik,1612,2,2,2,2,9,6,3,8
P'thinaikos,1612,3,2,1,3,6,9,-3,7
Panionios,1612,4,1,1,4,4,10,-6,4
AEK Athens,1613,1,4,2,0,7,1,6,14
PAOK Salonik,1613,2,2,2,2,9,5,4,8
P'thinaikos,1613,3,2,1,3,5,9,-4,7
Panionios,1613,4,1,1,4,4,10,-6,4
AEK Athens,1614,1,4,2,0,7,1,6,14
PAOK Salonik,1614,2,2,2,2,11,8,3,8
P'thinaikos,1614,3,2,1,3,8,11,-3,7
Panionios,1614,4,1,1,4,4,10,-6,4
AEK Athens,1615,1,4,2,0,7,1,6,14
PAOK Salonik,1615,2,2,2,2,9,5,4,8
P'thinaikos,1615,3,2,1,3,5,9,-4,7
Panionios,1615,4,1,1,4,4,10,-6,4
AEK Athens,1616,1,4,2,0,7,1,6,14
PAOK Salonik,1616,2,2,2,2,9,5,4,8
P'thinaikos,1616,3,2,1,3,5,9,-4,7
Panionios,1616,4,1,1,4,4,10,-6,4
AEK Athens,1617,1,4,2,0,7,1,6,14
PAOK Salonik,1617,2,3,2,1,10,4,6,11
P'thinaikos,1617,3,1,1,4,4,10,-6,4
Panionios,1617,3,1,1,4,4,10,-6,4
AEK Athens,1618,1,4,2,0,7,1,6,14
PAOK Salonik,1618,2,2,3,1,9,4,5,9
P'thinaikos,1618,3,1,2,3,4,9,-5,5
Panionios,1618,4,1,1,4,4,10,-6,4
AEK Athens,1619,1,4,2,0,7,1,6,14
PAOK Salonik,1619,2,3,2,1,10,4,6,11
P'thinaikos,1619,3,1,1,4,4,10,-6,4
Panionios,1619,3,1,1,4,4,10,-6,4
AEK Athens,1620,1,4,2,0,7,1,6,14
PAOK Salonik,1620,2,2,3,1,9,4,5,9
P'thinaikos,1620,3,1,2,3,4,9,-5,5
Panionios,1620,4,1,1,4,4,10,-6,4
AEK Athens,1621,1,4,2,0,7,1,6,14
PAOK Salonik,1621,2,2,2,2,9,5,4,8
P'thinaikos,1621,3,2,1,3,5,9,-4,7
Panionios,1621,4,1,1,4,4,10,-6,4
AEK Athens,1622,1,4,2,0,7,1,6,14
PAOK Salonik,1622,2,2,2,2,9,6,3,8
P'thinaikos,1622,3,2,1,3,6,9,-3,7
Panionios,1622,4,1,1,4,4,10,-6,4
AEK Athens,1623,1,4,2,0,7,1,6,14
PAOK Salonik,1623,2,2,2,2,10,6,4,8
P'thinaikos,1623,3,2,1,3,6,10,-4,7
Panionios,1623,4,1,1,4,4,10,-6,4
AEK Athens,1624,1,4,2,0,7,1,6,14
PAOK Salonik,1624,2,2,3,1,11,6,5,9
P'thinaikos,1624,3,1,2,3,6,11,-5,5
Panionios,1624,4,1,1,4,4,10,-6,4
AEK Athens,1625,1,4,2,0,7,1,6,14
PAOK Salonik,1625,2,2,3,1,10,5,5,9
P'thinaikos,1625,3,1,2,3,5,10,-5,5
Panionios,1625,4,1,1,4,4,10,-6,4
AEK Athens,1626,1,4,2,0,7,1,6,14
PAOK Salonik,1626,2,2,2,2,9,6,3,8
P'thinaikos,1626,3,2,1,3,6,9,-3,7
Panionios,1626,4,1,1,4,4,10,-6,4
AEK Athens,1627,1,4,2,0,7,1,6,14
PAOK Salonik,1627,2,3,2,1,10,4,6,11
P'thinaikos,1627,3,1,1,4,4,10,-6,4
Panionios,1627,3,1,1,4,4,10,-6,4
AEK Athens,1628,1,4,2,0,7,1,6,14
PAOK Salonik,1628,2,3,2,1,10,4,6,11
P'thinaikos,1628,3,1,1,4,4,10,-6,4
Panionios,1628,3,1,1,4,4,10,-6,4
AEK Athens,1629,1,4,2,0,7,1,6,14
PAOK Salonik,1629,2,2,2,2,11,7,4,8
P'thinaikos,1629,3,2,1,3,7,11,-4,7
Panionios,1629,4,1,1,4,4,10,-6,4
AEK Athens,1630,1,4,2,0,7,1,6,14
PAOK Salonik,1630,2,3,2,1,12,6,6,11
P'thinaikos,1630,3,1,1,4,6,12,-6,4
Panionios,1630,4,1,1,4,4,10,-6,4
AEK Athens,1631,1,4,2,0,7,1,6,14
PAOK Salonik,1631,2,2,2,2,10,6,4,8
P'thinaikos,1631,3,2,1,3,6,10,-4,7
Panionios,1631,4,1,1,4,4,10,-6,4
AEK Athens,1632,1,4,2,0,7,1,6,14
PAOK Salonik,1632,2,2,2,2,9,5,4,8
P'thinaikos,1632,3,2,1,3,5,9,-4,7
Panionios,1632,4,1,1,4,4,10,-6,4
AEK Athens,1633,1,4,2,0,7,1,6,14
PAOK Salonik,1633,2,2,3,1,9,4,5,9
P'thinaikos,1633,3,1,2,3,4,9,-5,5
Panionios,1633,4,1,1,4,4,10,-6,4
AEK Athens,1634,1,4,2,0,7,1,6,14
PAOK Salonik,1634,2,2,3,1,10,5,5,9
P'thinaikos,1634,3,1,2,3,5,10,-5,5
Panionios,1634,4,1,1,4,4,10,-6,4
AEK Athens,1635,1,4,2,0,7,1,6,14
PAOK Salonik,1635,2,2,2,2,9,5,4,8
P'thinaikos,1635,3,2,1,3,5,9,-4,7
Panionios,1635,4,1,1,4,4,10,-6,4
AEK Athens,1636,1,4,2,0,7,1,6,14
PAOK Salonik,1636,2,2,2,2,9,7,2,8
P'thinaikos,1636,3,2,1,3,7,9,-2,7
Panionios,1636,4,1,1,4,4,10,-6,4
AEK Athens,1637,1,4,2,0,7,1,6,14
PAOK Salonik,1637,2,3,2,1,10,4,6,11
P'thinaikos,1637,3,1,1,4,4,10,-6,4
Panionios,1637,3,1,1,4,4,10,-6,4
AEK Athens,1638,1,4,2,0,7,1,6,14
PAOK Salonik,1638,2,3,2,1,12,6,6,11
P'thinaikos,1638,3,1,1,4,6,12,-6,4
Panionios,1638,4,1,1,4,4,10,-6,4
AEK Athens,1639,1,4,2,0,7,1,6,14
PAOK Salonik,1639,2,2,3,1,10,5,5,9
P'thinaikos,1639,3,1,2,3,5,10,-5,5
Panionios,1639,4,1,1,4,4,10,-6,4
AEK Athens,1640,1,4,2,0,7,1,6,14
PAOK Salonik,1640,2,2,2,2,10,7,3,8
P'thinaikos,1640,3,2,1,3,7,10,-3,7
Panionios,1640,4,1,1,4,4,10,-6,4
AEK Athens,1641,1,4,2,0,7,1,6,14
PAOK Salonik,1641,2,3,2,1,12,5,7,11
Panionios,1641,3,1,1,4,4,10,-6,4
P'thinaikos,1641,4,1,1,4,5,12,-7,4
AEK Athens,1642,1,4,2,0,7,1,6,14
PAOK Salonik,1642,2,2,3,1,10,5,5,9
P'thinaikos,1642,3,1,2,3,5,10,-5,5
Panionios,1642,4,1,1,4,4,10,-6,4
AEK Athens,1643,1,4,2,0,7,1,6,14
PAOK Salonik,1643,2,2,2,2,9,5,4,8
P'thinaikos,1643,3,2,1,3,5,9,-4,7
Panionios,1643,4,1,1,4,4,10,-6,4
AEK Athens,1644,1,4,2,0,7,1,6,14
PAOK Salonik,1644,2,2,2,2,9,7,2,8
P'thinaikos,1644,3,2,1,3,7,9,-2,7
Panionios,1644,4,1,1,4,4,10,-6,4
AEK Athens,1645,1,4,2,0,7,1,6,14
PAOK Salonik,1645,2,3,2,1,10,4,6,11
P'thinaikos,1645,3,1,1,4,4,10,-6,4
Panionios,1645,3,1,1,4,4,10,-6,4
AEK Athens,1646,1,4,2,0,7,1,6,14
PAOK Salonik,1646,2,3,2,1,11,4,7,11
Panionios,1646,3,1,1,4,4,10,-6,4
P'thinaikos,1646,4,1,1,4,4,11,-7,4
AEK Athens,1647,1,4,2,0,7,1,6,14
PAOK Salonik,1647,2,2,2,2,10,8,2,8
P'thinaikos,1647,3,2,1,3,8,10,-2,7
Panionios,1647,4,1,1,4,4,10,-6,4
AEK Athens,1648,1,4,2,0,7,1,6,14
PAOK Salonik,1648,2,2,3,1,10,5,5,9
P'thinaikos,1648,3,1,2,3,5,10,-5,5
Panionios,1648,4,1,1,4,4,10,-6,4
AEK Athens,1649,1,4,2,0,7,1,6,14
PAOK Salonik,1649,2,2,2,2,10,6,4,8
P'thinaikos,1649,3,2,1,3,6,10,-4,7
Panionios,1649,4,1,1,4,4,10,-6,4
AEK Athens,1650,1,4,2,0,7,1,6,14
PAOK Salonik,1650,2,2,2,2,10,6,4,8
P'thinaikos,1650,3,2,1,3,6,10,-4,7
Panionios,1650,4,1,1,4,4,10,-6,4
AEK Athens,1651,1,4,2,0,7,1,6,14
PAOK Salonik,1651,2,2,2,2,10,6,4,8
P'thinaikos,1651,3,2,1,3,6,10,-4,7
Panionios,1651,4,1,1,4,4,10,-6,4
AEK Athens,1652,1,4,2,0,7,1,6,14
PAOK Salonik,1652,2,2,3,1,10,5,5,9
P'thinaikos,1652,3,1,2,3,5,10,-5,5
Panionios,1652,4,1,1,4,4,10,-6,4
AEK Athens,1653,1,4,2,0,7,1,6,14
PAOK Salonik,1653,2,3,2,1,13,5,8,11
Panionios,1653,3,1,1,4,4,10,-6,4
P'thinaikos,1653,4,1,1,4,5,13,-8,4
AEK Athens,1654,1,4,2,0,7,1,6,14
PAOK Salonik,1654,2,3,2,1,12,5,7,11
Panionios,1654,3,1,1,4,4,10,-6,4
P'thinaikos,1654,4,1,1,4,5,12,-7,4
AEK Athens,1655,1,4,2,0,7,1,6,14
PAOK Salonik,1655,2,2,2,2,10,6,4,8
P'thinaikos,1655,3,2,1,3,6,10,-4,7
Panionios,1655,4,1,1,4,4,10,-6,4
AEK Athens,1656,1,4,2,0,7,1,6,14
PAOK Salonik,1656,2,3,2,1,15,6,9,11
Panionios,1656,3,1,1,4,4,10,-6,4
P'thinaikos,1656,4,1,1,4,6,15,-9,4
AEK Athens,1657,1,4,2,0,7,1,6,14
PAOK Salonik,1657,2,3,2,1,13,4,9,11
Panionios,1657,3,1,1,4,4,10,-6,4
P'thinaikos,1657,4,1,1,4,4,13,-9,4
AEK Athens,1658,1,4,2,0,7,1,6,14
PAOK Salonik,1658,2,3,2,1,11,5,6,11
P'thinaikos,1658,3,1,1,4,5,11,-6,4
Panionios,1658,4,1,1,4,4,10,-6,4
AEK Athens,1659,1,4,2,0,7,1,6,14
PAOK Salonik,1659,2,3,2,1,13,4,9,11
Panionios,1659,3,1,1,4,4,10,-6,4
P'thinaikos,1659,4,1,1,4,4,13,-9,4
AEK Athens,1660,1,4,2,0,7,1,6,14
PAOK Salonik,1660,2,2,3,1,10,5,5,9
P'thinaikos,1660,3,1,2,3,5,10,-5,5
Panionios,1660,4,1,1,4,4,10,-6,4
AEK Athens,1661,1,4,2,0,7,1,6,14
PAOK Salonik,1661,2,3,2,1,11,5,6,11
P'thinaikos,1661,3,1,1,4,5,11,-6,4
Panionios,1661,4,1,1,4,4,10,-6,4
AEK Athens,1662,1,4,2,0,7,1,6,14
PAOK Salonik,1662,2,3,2,1,10,4,6,11
P'thinaikos,1662,3,1,1,4,4,10,-6,4
Panionios,1662,3,1,1,4,4,10,-6,4
AEK Athens,1663,1,4,2,0,7,1,6,14
PAOK Salonik,1663,2,2,2,2,10,6,4,8
P'thinaikos,1663,3,2,1,3,6,10,-4,7
Panionios,1663,4,1,1,4,4,10,-6,4
AEK Athens,1664,1,4,2,0,7,1,6,14
PAOK Salonik,1664,2,2,2,2,10,6,4,8
P'thinaikos,1664,3,2,1,3,6,10,-4,7
Panionios,1664,4,1,1,4,4,10,-6,4
AEK Athens,1665,1,4,2,0,7,1,6,14
PAOK Salonik,1665,2,3,2,1,11,4,7,11
Panionios,1665,3,1,1,4,4,10,-6,4
P'thinaikos,1665,4,1,1,4,4,11,-7,4
AEK Athens,1666,1,4,2,0,7,1,6,14
PAOK Salonik,1666,2,2,2,2,10,6,4,8
P'thinaikos,1666,3,2,1,3,6,10,-4,7
Panionios,1666,4,1,1,4,4,10,-6,4
AEK Athens,1667,1,4,2,0,7,1,6,14
PAOK Salonik,1667,2,2,2,2,9,6,3,8
P'thinaikos,1667,3,2,1,3,6,9,-3,7
Panionios,1667,4,1,1,4,4,10,-6,4
AEK Athens,1668,1,4,2,0,7,1,6,14
PAOK Salonik,1668,2,3,2,1,11,5,6,11
P'thinaikos,1668,3,1,1,4,5,11,-6,4
Panionios,1668,4,1,1,4,4,10,-6,4
AEK Athens,1669,1,4,2,0,7,1,6,14
PAOK Salonik,1669,2,2,2,2,11,7,4,8
P'thinaikos,1669,3,2,1,3,7,11,-4,7
Panionios,1669,4,1,1,4,4,10,-6,4
AEK Athens,1670,1,4,2,0,7,1,6,14
PAOK Salonik,1670,2,2,2,2,10,6,4,8
P'thinaikos,1670,3,2,1,3,6,10,-4,7
Panionios,1670,4,1,1,4,4,10,-6,4
AEK Athens,1671,1,4,2,0,7,1,6,14
PAOK Salonik,1671,2,3,2,1,13,7,6,11
P'thinaikos,1671,3,1,1,4,7,13,-6,4
Panionios,1671,4,1,1,4,4,10,-6,4
AEK Athens,1672,1,4,2,0,7,1,6,14
PAOK Salonik,1672,2,3,2,1,14,5,9,11
Panionios,1672,3,1,1,4,4,10,-6,4
P'thinaikos,1672,4,1,1,4,5,14,-9,4
AEK Athens,1673,1,4,2,0,7,1,6,14
PAOK Salonik,1673,2,3,2,1,10,4,6,11
P'thinaikos,1673,3,1,1,4,4,10,-6,4
Panionios,1673,3,1,1,4,4,10,-6,4
AEK Athens,1674,1,4,2,0,7,1,6,14
PAOK Salonik,1674,2,2,2,2,10,6,4,8
P'thinaikos,1674,3,2,1,3,6,10,-4,7
Panionios,1674,4,1,1,4,4,10,-6,4
AEK Athens,1675,1,4,2,0,7,1,6,14
PAOK Salonik,1675,2,2,2,2,10,8,2,8
P'thinaikos,1675,3,2,1,3,8,10,-2,7
Panionios,1675,4,1,1,4,4,10,-6,4
AEK Athens,1676,1,4,2,0,7,1,6,14
PAOK Salonik,1676,2,3,2,1,11,5,6,11
P'thinaikos,1676,3,1,1,4,5,11,-6,4
Panionios,1676,4,1,1,4,4,10,-6,4
AEK Athens,1677,1,4,2,0,7,1,6,14
PAOK Salonik,1677,2,2,2,2,9,7,2,8
P'thinaikos,1677,3,2,1,3,7,9,-2,7
Panionios,1677,4,1,1,4,4,10,-6,4
AEK Athens,1678,1,4,2,0,7,1,6,14
PAOK Salonik,1678,2,2,3,1,10,5,5,9
P'thinaikos,1678,3,1,2,3,5,10,-5,5
Panionios,1678,4,1,1,4,4,10,-6,4
AEK Athens,1679,1,4,2,0,7,1,6,14
PAOK Salonik,1679,2,2,3,1,10,5,5,9
P'thinaikos,1679,3,1,2,3,5,10,-5,5
Panionios,1679,4,1,1,4,4,10,-6,4
AEK Athens,1680,1,4,2,0,7,1,6,14
PAOK Salonik,1680,2,3,2,1,11,5,6,11
P'thinaikos,1680,3,1,1,4,5,11,-6,4
Panionios,1680,4,1,1,4,4,10,-6,4
AEK Athens,1681,1,4,2,0,7,1,6,14
PAOK Salonik,1681,2,2,2,2,10,9,1,8
P'thinaikos,1681,3,2,1,3,9,10,-1,7
Panionios,1681,4,1,1,4,4,10,-6,4
AEK Athens,1682,1,4,2,0,7,1,6,14
PAOK Salonik,1682,2,3,2,1,11,4,7,11
Panionios,1682,3,1,1,4,4,10,-6,4
P'thinaikos,1682,4,1,1,4,4,11,-7,4
AEK Athens,1683,1,4,2,0,7,1,6,14
PAOK Salonik,1683,2,2,3,1,11,6,5,9
P'thinaikos,1683,3,1,2,3,6,11,-5,5
Panionios,1683,4,1,1,4,4,10,-6,4
AEK Athens,1684,1,4,2,0,7,1,6,14
PAOK Salonik,1684,2,3,2,1,12,5,7,11
Panionios,1684,3,1,1,4,4,10,-6,4
P'thinaikos,1684,4,1,1,4,5,12,-7,4
AEK Athens,1685,1,4,2,0,7,1,6,14
PAOK Salonik,1685,2,3,2,1,14,4,10,11
Panionios,1685,3,1,1,4,4,10,-6,4
P'thinaikos,1685,4,1,1,4,4,14,-10,4
AEK Athens,1686,1,4,2,0,7,1,6,14
PAOK Salonik,1686,2,2,3,1,11,6,5,9
P'thinaikos,1686,3,1,2,3,6,11,-5,5
Panionios,1686,4,1,1,4,4,10,-6,4
AEK Athens,1687,1,4,2,0,7,1,6,14
PAOK Salonik,1687,2,2,3,1,10,5,5,9
P'thinaikos,1687,3,1,2,3,5,10,-5,5
Panionios,1687,4,1,1,4,4,10,-6,4
AEK Athens,1688,1,4,2,0,7,1,6,14
PAOK Salonik,1688,2,2,3,1,11,6,5,9
P'thinaikos,1688,3,1,2,3,6,11,-5,5
Panionios,1688,4,1,1,4,4,10,-6,4
AEK Athens,1689,1,4,2,0,7,1,6,14
PAOK Salonik,1689,2,2,2,2,9,6,3,8
P'thinaikos,1689,3,2,1,3,6,9,-3,7
Panionios,1689,4,1,1,4,4,10,-6,4
AEK Athens,1690,1,4,2,0,7,1,6,14
PAOK Salonik,1690,2,3,2,1,11,5,6,11
P'thinaikos,1690,3,1,1,4,5,11,-6,4
Panionios,1690,4,1,1,4,4,10,-6,4
AEK Athens,1691,1,4,2,0,7,1,6,14
PAOK Salonik,1691,2,3,2,1,11,5,6,11
P'thinaikos,1691,3,1,1,4,5,11,-6,4
Panionios,1691,4,1,1,4,4,10,-6,4
AEK Athens,1692,1,4,2,0,7,1,6,14
PAOK Salonik,1692,2,2,3,1,9,4,5,9
P'thinaikos,1692,3,1,2,3,4,9,-5,5
Panionios,1692,4,1,1,4,4,10,-6,4
AEK Athens,1693,1,4,2,0,7,1,6,14
PAOK Salonik,1693,2,2,3,1,9,4,5,9
P'thinaikos,1693,3,1,2,3,4,9,-5,5
Panionios,1693,4,1,1,4,4,10,-6,4
AEK Athens,1694,1,4,2,0,7,1,6,14
PAOK Salonik,1694,2,2,3,1,10,5,5,9
P'thinaikos,1694,3,1,2,3,5,10,-5,5
Panionios,1694,4,1,1,4,4,10,-6,4
AEK Athens,1695,1,4,2,0,7,1,6,14
PAOK Salonik,1695,2,2,3,1,10,5,5,9
P'thinaikos,1695,3,1,2,3,5,10,-5,5
Panionios,1695,4,1,1,4,4,10,-6,4
AEK Athens,1696,1,4,2,0,7,1,6,14
PAOK Salonik,1696,2,2,2,2,9,5,4,8
P'thinaikos,1696,3,2,1,3,5,9,-4,7
Panionios,1696,4,1,1,4,4,10,-6,4
AEK Athens,1697,1,4,2,0,7,1,6,14
PAOK Salonik,1697,2,2,2,2,9,7,2,8
P'thinaikos,1697,3,2,1,3,7,9,-2,7
Panionios,1697,4,1,1,4,4,10,-6,4
AEK Athens,1698,1,4,2,0,7,1,6,14
PAOK Salonik,1698,2,2,3,1,10,5,5,9
P'thinaikos,1698,3,1,2,3,5,10,-5,5
Panionios,1698,4,1,1,4,4,10,-6,4
AEK Athens,1699,1,4,2,0,7,1,6,14
PAOK Salonik,1699,2,2,3,1,9,4,5,9
P'thinaikos,1699,3,1,2,3,4,9,-5,5
Panionios,1699,4,1,1,4,4,10,-6,4
AEK Athens,1700,1,4,2,0,7,1,6,14
PAOK Salonik,1700,2,3,2,1,13,5,8,11
Panionios,1700,3,1,1,4,4,10,-6,4
P'thinaikos,1700,4,1,1,4,5,13,-8,4
AEK Athens,1701,1,4,2,0,7,1,6,14
PAOK Salonik,1701,2,2,3,1,11,6,5,9
P'thinaikos,1701,3,1,2,3,6,11,-5,5
Panionios,1701,4,1,1,4,4,10,-6,4
AEK Athens,1702,1,4,2,0,7,1,6,14
PAOK Salonik,1702,2,2,3,1,9,4,5,9
P'thinaikos,1702,3,1,2,3,4,9,-5,5
Panionios,1702,4,1,1,4,4,10,-6,4
AEK Athens,1703,1,4,2,0,7,1,6,14
PAOK Salonik,1703,2,3,2,1,12,5,7,11
Panionios,1703,3,1,1,4,4,10,-6,4
P'thinaikos,1703,4,1,1,4,5,12,-7,4
AEK Athens,1704,1,4,2,0,7,1,6,14
PAOK Salonik,1704,2,3,2,1,10,4,6,11
P'thinaikos,1704,3,1,1,4,4,10,-6,4
Panionios,1704,3,1,1,4,4,10,-6,4
AEK Athens,1705,1,4,2,0,7,1,6,14
PAOK Salonik,1705,2,2,3,1,10,5,5,9
P'thinaikos,1705,3,1,2,3,5,10,-5,5
Panionios,1705,4,1,1,4,4,10,-6,4
AEK Athens,1706,1,4,2,0,7,1,6,14
PAOK Salonik,1706,2,3,2,1,11,5,6,11
P'thinaikos,1706,3,1,1,4,5,11,-6,4
Panionios,1706,4,1,1,4,4,10,-6,4
AEK Athens,1707,1,4,2,0,7,1,6,14
PAOK Salonik,1707,2,3,2,1,11,4,7,11
Panionios,1707,3,1,1,4,4,10,-6,4
P'thinaikos,1707,4,1,1,4,4,11,-7,4
AEK Athens,1708,1,4,2,0,7,1,6,14
PAOK Salonik,1708,2,3,2,1,10,4,6,11
P'thinaikos,1708,3,1,1,4,4,10,-6,4
Panionios,1708,3,1,1,4,4,10,-6,4
AEK Athens,1709,1,4,2,0,7,1,6,14
PAOK Salonik,1709,2,2,3,1,10,5,5,9
P'thinaikos,1709,3,1,2,3,5,10,-5,5
Panionios,1709,4,1,1,4,4,10,-6,4
AEK Athens,1710,1,4,2,0,7,1,6,14
PAOK Salonik,1710,2,2,3,1,11,6,5,9
P'thinaikos,1710,3,1,2,3,6,11,-5,5
Panionios,1710,4,1,1,4,4,10,-6,4
AEK Athens,1711,1,4,2,0,7,1,6,14
PAOK Salonik,1711,2,3,2,1,10,4,6,11
P'thinaikos,1711,3,1,1,4,4,10,-6,4
Panionios,1711,3,1,1,4,4,10,-6,4
AEK Athens,1712,1,4,2,0,7,1,6,14
PAOK Salonik,1712,2,3,2,1,12,6,6,11
P'thinaikos,1712,3,1,1,4,6,12,-6,4
Panionios,1712,4,1,1,4,4,10,-6,4
AEK Athens,1713,1,4,2,0,7,1,6,14
PAOK Salonik,1713,2,3,2,1,11,5,6,11
P'thinaikos,1713,3,1,1,4,5,11,-6,4
Panionios,1713,4,1,1,4,4,10,-6,4
AEK Athens,1714,1,4,2,0,7,1,6,14
PAOK Salonik,1714,2,3,2,1,10,4,6,11
P'thinaikos,1714,3,1,1,4,4,10,-6,4
Panionios,1714,3,1,1,4,4,10,-6,4
AEK Athens,1715,1,4,2,0,7,1,6,14
PAOK Salonik,1715,2,2,3,1,9,4,5,9
P'thinaikos,1715,3,1,2,3,4,9,-5,5
Panionios,1715,4,1,1,4,4,10,-6,4
AEK Athens,1716,1,4,2,0,7,1,6,14
PAOK Salonik,1716,2,2,2,2,9,5,4,8
P'thinaikos,1716,3,2,1,3,5,9,-4,7
Panionios,1716,4,1,1,4,4,10,-6,4
AEK Athens,1717,1,4,2,0,7,1,6,14
PAOK Salonik,1717,2,3,2,1,13,5,8,11
Panionios,1717,3,1,1,4,4,10,-6,4
P'thinaikos,1717,4,1,1,4,5,13,-8,4
AEK Athens,1718,1,4,2,0,7,1,6,14
PAOK Salonik,1718,2,2,3,1,9,4,5,9
P'thinaikos,1718,3,1,2,3,4,9,-5,5
Panionios,1718,4,1,1,4,4,10,-6,4
AEK Athens,1719,1,4,2,0,7,1,6,14
PAOK Salonik,1719,2,2,3,1,10,5,5,9
P'thinaikos,1719,3,1,2,3,5,10,-5,5
Panionios,1719,4,1,1,4,4,10,-6,4
AEK Athens,1720,1,4,2,0,7,1,6,14
PAOK Salonik,1720,2,2,2,2,10,8,2,8
P'thinaikos,1720,3,2,1,3,8,10,-2,7
Panionios,1720,4,1,1,4,4,10,-6,4
AEK Athens,1721,1,4,2,0,7,1,6,14
PAOK Salonik,1721,2,2,3,1,10,5,5,9
P'thinaikos,1721,3,1,2,3,5,10,-5,5
Panionios,1721,4,1,1,4,4,10,-6,4
AEK Athens,1722,1,4,2,0,7,1,6,14
PAOK Salonik,1722,2,3,2,1,13,5,8,11
Panionios,1722,3,1,1,4,4,10,-6,4
P'thinaikos,1722,4,1,1,4,5,13,-8,4
AEK Athens,1723,1,4,2,0,7,1,6,14
PAOK Salonik,1723,2,3,2,1,12,4,8,11
Panionios,1723,3,1,1,4,4,10,-6,4
P'thinaikos,1723,4,1,1,4,4,12,-8,4
AEK Athens,1724,1,4,2,0,7,1,6,14
PAOK Salonik,1724,2,2,2,2,9,8,1,8
P'thinaikos,1724,3,2,1,3,8,9,-1,7
Panionios,1724,4,1,1,4,4,10,-6,4
AEK Athens,1725,1,4,2,0,7,1,6,14
PAOK Salonik,1725,2,3,2,1,12,5,7,11
Panionios,1725,3,1,1,4,4,10,-6,4
P'thinaikos,1725,4,1,1,4,5,12,-7,4
AEK Athens,1726,1,4,2,0,7,1,6,14
PAOK Salonik,1726,2,2,3,1,10,5,5,9
P'thinaikos,1726,3,1,2,3,5,10,-5,5
Panionios,1726,4,1,1,4,4,10,-6,4
AEK Athens,1727,1,4,2,0,7,1,6,14
PAOK Salonik,1727,2,2,3,1,9,4,5,9
P'thinaikos,1727,3,1,2,3,4,9,-5,5
Panionios,1727,4,1,1,4,4,10,-6,4
AEK Athens,1728,1,4,2,0,7,1,6,14
PAOK Salonik,1728,2,2,3,1,9,4,5,9
P'thinaikos,1728,3,1,2,3,4,9,-5,5
Panionios,1728,4,1,1,4,4,10,-6,4
AEK Athens,1729,1,4,2,0,7,1,6,14
PAOK Salonik,1729,2,2,2,2,9,5,4,8
P'thinaikos,1729,3,2,1,3,5,9,-4,7
Panionios,1729,4,1,1,4,4,10,-6,4
AEK Athens,1730,1,4,2,0,7,1,6,14
PAOK Salonik,1730,2,2,3,1,11,6,5,9
P'thinaikos,1730,3,1,2,3,6,11,-5,5
Panionios,1730,4,1,1,4,4,10,-6,4
AEK Athens,1731,1,4,2,0,7,1,6,14
PAOK Salonik,1731,2,2,3,1,10,5,5,9
P'thinaikos,1731,3,1,2,3,5,10,-5,5
Panionios,1731,4,1,1,4,4,10,-6,4
AEK Athens,1732,1,4,2,0,7,1,6,14
PAOK Salonik,1732,2,3,2,1,10,4,6,11
P'thinaikos,1732,3,1,1,4,4,10,-6,4
Panionios,1732,3,1,1,4,4,10,-6,4
AEK Athens,1733,1,4,2,0,7,1,6,14
PAOK Salonik,1733,2,2,2,2,10,6,4,8
P'thinaikos,1733,3,2,1,3,6,10,-4,7
Panionios,1733,4,1,1,4,4,10,-6,4
AEK Athens,1734,1,4,2,0,7,1,6,14
PAOK Salonik,1734,2,3,2,1,12,5,7,11
Panionios,1734,3,1,1,4,4,10,-6,4
P'thinaikos,1734,4,1,1,4,5,12,-7,4
AEK Athens,1735,1,4,2,0,7,1,6,14
PAOK Salonik,1735,2,3,2,1,13,6,7,11
Panionios,1735,3,1,1,4,4,10,-6,4
P'thinaikos,1735,4,1,1,4,6,13,-7,4
AEK Athens,1736,1,4,2,0,7,1,6,14
PAOK Salonik,1736,2,2,3,1,11,6,5,9
P'thinaikos,1736,3,1,2,3,6,11,-5,5
Panionios,1736,4,1,1,4,4,10,-6,4
AEK Athens,1737,1,4,2,0,7,1,6,14
PAOK Salonik,1737,2,2,2,2,10,7,3,8
P'thinaikos,1737,3,2,1,3,7,10,-3,7
Panionios,1737,4,1,1,4,4,10,-6,4
AEK Athens,1738,1,4,2,0,7,1,6,14
PAOK Salonik,1738,2,2,3,1,10,5,5,9
P'thinaikos,1738,3,1,2,3,5,10,-5,5
Panionios,1738,4,1,1,4,4,10,-6,4
AEK Athens,1739,1,4,2,0,7,1,6,14
PAOK Salonik,1739,2,2,2,2,9,5,4,8
P'thinaikos,1739,3,2,1,3,5,9,-4,7
Panionios,1739,4,1,1,4,4,10,-6,4
AEK Athens,1740,1,4,2,0,7,1,6,14
PAOK Salonik,1740,2,3,2,1,11,4,7,11
Panionios,1740,3,1,1,4,4,10,-6,4
P'thinaikos,1740,4,1,1,4,4,11,-7,4
AEK Athens,1741,1,4,2,0,7,1,6,14
PAOK Salonik,1741,2,2,2,2,10,6,4,8
P'thinaikos,1741,3,2,1,3,6,10,-4,7
Panionios,1741,4,1,1,4,4,10,-6,4
AEK Athens,1742,1,4,2,0,7,1,6,14
PAOK Salonik,1742,2,2,3,1,9,4,5,9
P'thinaikos,1742,3,1,2,3,4,9,-5,5
Panionios,1742,4,1,1,4,4,10,-6,4
AEK Athens,1743,1,4,2,0,7,1,6,14
PAOK Salonik,1743,2,3,2,1,12,5,7,11
Panionios,1743,3,1,1,4,4,10,-6,4
P'thinaikos,1743,4,1,1,4,5,12,-7,4
AEK Athens,1744,1,4,2,0,7,1,6,14
PAOK Salonik,1744,2,2,3,1,10,5,5,9
P'thinaikos,1744,3,1,2,3,5,10,-5,5
Panionios,1744,4,1,1,4,4,10,-6,4
AEK Athens,1745,1,4,2,0,7,1,6,14
PAOK Salonik,1745,2,2,2,2,10,6,4,8
P'thinaikos,1745,3,2,1,3,6,10,-4,7
Panionios,1745,4,1,1,4,4,10,-6,4
AEK Athens,1746,1,4,2,0,7,1,6,14
PAOK Salonik,1746,2,2,3,1,10,5,5,9
P'thinaikos,1746,3,1,2,3,5,10,-5,5
Panionios,1746,4,1,1,4,4,10,-6,4
AEK Athens,1747,1,4,2,0,7,1,6,14
PAOK Salonik,1747,2,3,2,1,11,5,6,11
P'thinaikos,1747,3,1,1,4,5,11,-6,4
Panionios,1747,4,1,1,4,4,10,-6,4
AEK Athens,1748,1,4,2,0,7,1,6,14
PAOK Salonik,1748,2,3,2,1,13,5,8,11
Panionios,1748,3,1,1,4,4,10,-6,4
P'thinaikos,1748,4,1,1,4,5,13,-8,4
AEK Athens,1749,1,4,2,0,7,1,6,14
PAOK Salonik,1749,2,2,2,2,9,5,4,8
P'thinaikos,1749,3,2,1,3,5,9,-4,7
Panionios,1749,4,1,1,4,4,10,-6,4
AEK Athens,1750,1,4,2,0,7,1,6,14
PAOK Salonik,1750,2,3,2,1,11,5,6,11
P'thinaikos,1750,3,1,1,4,5,11,-6,4
Panionios,1750,4,1,1,4,4,10,-6,4
AEK Athens,1751,1,4,2,0,7,1,6,14
PAOK Salonik,1751,2,2,3,1,9,4,5,9
P'thinaikos,1751,3,1,2,3,4,9,-5,5
Panionios,1751,4,1,1,4,4,10,-6,4
AEK Athens,1752,1,4,2,0,7,1,6,14
PAOK Salonik,1752,2,2,2,2,10,7,3,8
P'thinaikos,1752,3,2,1,3,7,10,-3,7
Panionios,1752,4,1,1,4,4,10,-6,4
AEK Athens,1753,1,4,2,0,7,1,6,14
PAOK Salonik,1753,2,3,2,1,11,4,7,11
Panionios,1753,3,1,1,4,4,10,-6,4
P'thinaikos,1753,4,1,1,4,4,11,-7,4
AEK Athens,1754,1,4,2,0,7,1,6,14
PAOK Salonik,1754,2,2,3,1,11,6,5,9
P'thinaikos,1754,3,1,2,3,6,11,-5,5
Panionios,1754,4,1,1,4,4,10,-6,4
AEK Athens,1755,1,4,2,0,7,1,6,14
PAOK Salonik,1755,2,3,2,1,11,4,7,11
Panionios,1755,3,1,1,4,4,10,-6,4
P'thinaikos,1755,4,1,1,4,4,11,-7,4
AEK Athens,1756,1,4,2,0,7,1,6,14
PAOK Salonik,1756,2,2,3,1,11,6,5,9
P'thinaikos,1756,3,1,2,3,6,11,-5,5
Panionios,1756,4,1,1,4,4,10,-6,4
AEK Athens,1757,1,4,2,0,7,1,6,14
PAOK Salonik,1757,2,2,3,1,10,5,5,9
P'thinaikos,1757,3,1,2,3,5,10,-5,5
Panionios,1757,4,1,1,4,4,10,-6,4
AEK Athens,1758,1,4,2,0,7,1,6,14
PAOK Salonik,1758,2,3,2,1,12,6,6,11
P'thinaikos,1758,3,1,1,4,6,12,-6,4
Panionios,1758,4,1,1,4,4,10,-6,4
AEK Athens,1759,1,4,2,0,7,1,6,14
PAOK Salonik,1759,2,2,2,2,9,5,4,8
P'thinaikos,1759,3,2,1,3,5,9,-4,7
Panionios,1759,4,1,1,4,4,10,-6,4
AEK Athens,1760,1,4,2,0,7,1,6,14
PAOK Salonik,1760,2,2,2,2,9,5,4,8
P'thinaikos,1760,3,2,1,3,5,9,-4,7
Panionios,1760,4,1,1,4,4,10,-6,4
AEK Athens,1761,1,4,2,0,7,1,6,14
PAOK Salonik,1761,2,3,2,1,12,6,6,11
P'thinaikos,1761,3,1,1,4,6,12,-6,4
Panionios,1761,4,1,1,4,4,10,-6,4
AEK Athens,1762,1,4,2,0,7,1,6,14
PAOK Salonik,1762,2,2,2,2,9,5,4,8
P'thinaikos,1762,3,2,1,3,5,9,-4,7
Panionios,1762,4,1,1,4,4,10,-6,4
AEK Athens,1763,1,4,2,0,7,1,6,14
PAOK Salonik,1763,2,2,3,1,9,4,5,9
P'thinaikos,1763,3,1,2,3,4,9,-5,5
Panionios,1763,4,1,1,4,4,10,-6,4
AEK Athens,1764,1,4,2,0,7,1,6,14
PAOK Salonik,1764,2,3,2,1,10,4,6,11
P'thinaikos,1764,3,1,1,4,4,10,-6,4
Panionios,1764,3,1,1,4,4,10,-6,4
AEK Athens,1765,1,4,2,0,7,1,6,14
PAOK Salonik,1765,2,3,2,1,11,4,7,11
Panionios,1765,3,1,1,4,4,10,-6,4
P'thinaikos,1765,4,1,1,4,4,11,-7,4
AEK Athens,1766,1,4,2,0,7,1,6,14
PAOK Salonik,1766,2,2,2,2,9,5,4,8
P'thinaikos,1766,3,2,1,3,5,9,-4,7
Panionios,1766,4,1,1,4,4,10,-6,4
AEK Athens,1767,1,4,2,0,7,1,6,14
PAOK Salonik,1767,2,3,2,1,10,4,6,11
P'thinaikos,1767,3,1,1,4,4,10,-6,4
Panionios,1767,3,1,1,4,4,10,-6,4
AEK Athens,1768,1,4,2,0,7,1,6,14
PAOK Salonik,1768,2,2,2,2,10,7,3,8
P'thinaikos,1768,3,2,1,3,7,10,-3,7
Panionios,1768,4,1,1,4,4,10,-6,4
AEK Athens,1769,1,4,2,0,7,1,6,14
PAOK Salonik,1769,2,3,2,1,10,4,6,11
P'thinaikos,1769,3,1,1,4,4,10,-6,4
Panionios,1769,3,1,1,4,4,10,-6,4
AEK Athens,1770,1,4,2,0,7,1,6,14
PAOK Salonik,1770,2,2,2,2,10,6,4,8
P'thinaikos,1770,3,2,1,3,6,10,-4,7
Panionios,1770,4,1,1,4,4,10,-6,4
AEK Athens,1771,1,4,2,0,7,1,6,14
PAOK Salonik,1771,2,3,2,1,13,6,7,11
Panionios,1771,3,1,1,4,4,10,-6,4
P'thinaikos,1771,4,1,1,4,6,13,-7,4
AEK Athens,1772,1,4,2,0,7,1,6,14
PAOK Salonik,1772,2,2,2,2,11,7,4,8
P'thinaikos,1772,3,2,1,3,7,11,-4,7
Panionios,1772,4,1,1,4,4,10,-6,4
AEK Athens,1773,1,4,2,0,7,1,6,14
PAOK Salonik,1773,2,2,2,2,9,6,3,8
P'thinaikos,1773,3,2,1,3,6,9,-3,7
Panionios,1773,4,1,1,4,4,10,-6,4
AEK Athens,1774,1,4,2,0,7,1,6,14
PAOK Salonik,1774,2,2,3,1,10,5,5,9
P'thinaikos,1774,3,1,2,3,5,10,-5,5
Panionios,1774,4,1,1,4,4,10,-6,4
AEK Athens,1775,1,4,2,0,7,1,6,14
PAOK Salonik,1775,2,2,2,2,11,7,4,8
P'thinaikos,1775,3,2,1,3,7,11,-4,7
Panionios,1775,4,1,1,4,4,10,-6,4
AEK Athens,1776,1,4,2,0,7,1,6,14
PAOK Salonik,1776,2,3,2,1,12,4,8,11
Panionios,1776,3,1,1,4,4,10,-6,4
P'thinaikos,1776,4,1,1,4,4,12,-8,4
AEK Athens,1777,1,4,2,0,7,1,6,14
PAOK Salonik,1777,2,3,2,1,11,4,7,11
Panionios,1777,3,1,1,4,4,10,-6,4
P'thinaikos,1777,4,1,1,4,4,11,-7,4
AEK Athens,1778,1,4,2,0,7,1,6,14
PAOK Salonik,1778,2,2,3,1,11,6,5,9
P'thinaikos,1778,3,1,2,3,6,11,-5,5
Panionios,1778,4,1,1,4,4,10,-6,4
AEK Athens,1779,1,4,2,0,7,1,6,14
PAOK Salonik,1779,2,2,3,1,11,6,5,9
P'thinaikos,1779,3,1,2,3,6,11,-5,5
Panionios,1779,4,1,1,4,4,10,-6,4
AEK Athens,1780,1,4,2,0,7,1,6,14
PAOK Salonik,1780,2,3,2,1,11,5,6,11
P'thinaikos,1780,3,1,1,4,5,11,-6,4
Panionios,1780,4,1,1,4,4,10,-6,4
AEK Athens,1781,1,4,2,0,7,1,6,14
PAOK Salonik,1781,2,3,2,1,12,4,8,11
Panionios,1781,3,1,1,4,4,10,-6,4
P'thinaikos,1781,4,1,1,4,4,12,-8,4
AEK Athens,1782,1,4,2,0,7,1,6,14
PAOK Salonik,1782,2,3,2,1,12,6,6,11
P'thinaikos,1782,3,1,1,4,6,12,-6,4
Panionios,1782,4,1,1,4,4,10,-6,4
AEK Athens,1783,1,4,2,0,7,1,6,14
PAOK Salonik,1783,2,2,3,1,10,5,5,9
P'thinaikos,1783,3,1,2,3,5,10,-5,5
Panionios,1783,4,1,1,4,4,10,-6,4
AEK Athens,1784,1,4,2,0,7,1,6,14
PAOK Salonik,1784,2,2,2,2,9,5,4,8
P'thinaikos,1784,3,2,1,3,5,9,-4,7
Panionios,1784,4,1,1,4,4,10,-6,4
AEK Athens,1785,1,4,2,0,7,1,6,14
PAOK Salonik,1785,2,2,2,2,9,5,4,8
P'thinaikos,1785,3,2,1,3,5,9,-4,7
Panionios,1785,4,1,1,4,4,10,-6,4
AEK Athens,1786,1,4,2,0,7,1,6,14
PAOK Salonik,1786,2,3,2,1,11,5,6,11
P'thinaikos,1786,3,1,1,4,5,11,-6,4
Panionios,1786,4,1,1,4,4,10,-6,4
AEK Athens,1787,1,4,2,0,7,1,6,14
PAOK Salonik,1787,2,2,2,2,9,5,4,8
P'thinaikos,1787,3,2,1,3,5,9,-4,7
Panionios,1787,4,1,1,4,4,10,-6,4
AEK Athens,1788,1,4,2,0,7,1,6,14
PAOK Salonik,1788,2,2,3,1,10,5,5,9
P'thinaikos,1788,3,1,2,3,5,10,-5,5
Panionios,1788,4,1,1,4,4,10,-6,4
AEK Athens,1789,1,4,2,0,7,1,6,14
PAOK Salonik,1789,2,3,2,1,10,4,6,11
P'thinaikos,1789,3,1,1,4,4,10,-6,4
Panionios,1789,3,1,1,4,4,10,-6,4
AEK Athens,1790,1,4,2,0,7,1,6,14
PAOK Salonik,1790,2,3,2,1,12,5,7,11
Panionios,1790,3,1,1,4,4,10,-6,4
P'thinaikos,1790,4,1,1,4,5,12,-7,4
AEK Athens,1791,1,4,2,0,7,1,6,14
PAOK Salonik,1791,2,3,2,1,10,4,6,11
P'thinaikos,1791,3,1,1,4,4,10,-6,4
Panionios,1791,3,1,1,4,4,10,-6,4
AEK Athens,1792,1,4,2,0,7,1,6,14
PAOK Salonik,1792,2,2,2,2,9,5,4,8
P'thinaikos,1792,3,2,1,3,5,9,-4,7
Panionios,1792,4,1,1,4,4,10,-6,4
AEK Athens,1793,1,4,2,0,7,1,6,14
PAOK Salonik,1793,2,2,3,1,9,4,5,9
P'thinaikos,1793,3,1,2,3,4,9,-5,5
Panionios,1793,4,1,1,4,4,10,-6,4
AEK Athens,1794,1,4,2,0,7,1,6,14
PAOK Salonik,1794,2,2,2,2,10,8,2,8
P'thinaikos,1794,3,2,1,3,8,10,-2,7
Panionios,1794,4,1,1,4,4,10,-6,4
AEK Athens,1795,1,4,2,0,7,1,6,14
PAOK Salonik,1795,2,2,3,1,10,5,5,9
P'thinaikos,1795,3,1,2,3,5,10,-5,5
Panionios,1795,4,1,1,4,4,10,-6,4
AEK Athens,1796,1,4,2,0,7,1,6,14
PAOK Salonik,1796,2,3,2,1,11,5,6,11
P'thinaikos,1796,3,1,1,4,5,11,-6,4
Panionios,1796,4,1,1,4,4,10,-6,4
AEK Athens,1797,1,4,2,0,7,1,6,14
PAOK Salonik,1797,2,3,2,1,11,5,6,11
P'thinaikos,1797,3,1,1,4,5,11,-6,4
Panionios,1797,4,1,1,4,4,10,-6,4
AEK Athens,1798,1,4,2,0,7,1,6,14
PAOK Salonik,1798,2,2,3,1,9,4,5,9
P'thinaikos,1798,3,1,2,3,4,9,-5,5
Panionios,1798,4,1,1,4,4,10,-6,4
AEK Athens,1799,1,4,2,0,7,1,6,14
PAOK Salonik,1799,2,2,3,1,9,4,5,9
P'thinaikos,1799,3,1,2,3,4,9,-5,5
Panionios,1799,4,1,1,4,4,10,-6,4
AEK Athens,1800,1,4,2,0,7,1,6,14
PAOK Salonik,1800,2,2,2,2,9,6,3,8
P'thinaikos,1800,3,2,1,3,6,9,-3,7
Panionios,1800,4,1,1,4,4,10,-6,4
AEK Athens,1801,1,4,2,0,7,1,6,14
PAOK Salonik,1801,2,3,2,1,12,4,8,11
Panionios,1801,3,1,1,4,4,10,-6,4
P'thinaikos,1801,4,1,1,4,4,12,-8,4
AEK Athens,1802,1,4,2,0,7,1,6,14
PAOK Salonik,1802,2,2,3,1,10,5,5,9
P'thinaikos,1802,3,1,2,3,5,10,-5,5
Panionios,1802,4,1,1,4,4,10,-6,4
AEK Athens,1803,1,4,2,0,7,1,6,14
PAOK Salonik,1803,2,2,3,1,9,4,5,9
P'thinaikos,1803,3,1,2,3,4,9,-5,5
Panionios,1803,4,1,1,4,4,10,-6,4
AEK Athens,1804,1,4,2,0,7,1,6,14
PAOK Salonik,1804,2,3,2,1,11,5,6,11
P'thinaikos,1804,3,1,1,4,5,11,-6,4
Panionios,1804,4,1,1,4,4,10,-6,4
AEK Athens,1805,1,4,2,0,7,1,6,14
PAOK Salonik,1805,2,2,3,1,12,7,5,9
P'thinaikos,1805,3,1,2,3,7,12,-5,5
Panionios,1805,4,1,1,4,4,10,-6,4
AEK Athens,1806,1,4,2,0,7,1,6,14
PAOK Salonik,1806,2,2,3,1,11,6,5,9
P'thinaikos,1806,3,1,2,3,6,11,-5,5
Panionios,1806,4,1,1,4,4,10,-6,4
AEK Athens,1807,1,4,2,0,7,1,6,14
PAOK Salonik,1807,2,2,3,1,11,6,5,9
P'thinaikos,1807,3,1,2,3,6,11,-5,5
Panionios,1807,4,1,1,4,4,10,-6,4
AEK Athens,1808,1,4,2,0,7,1,6,14
PAOK Salonik,1808,2,2,2,2,10,6,4,8
P'thinaikos,1808,3,2,1,3,6,10,-4,7
Panionios,1808,4,1,1,4,4,10,-6,4
AEK Athens,1809,1,4,2,0,7,1,6,14
PAOK Salonik,1809,2,3,2,1,10,4,6,11
P'thinaikos,1809,3,1,1,4,4,10,-6,4
Panionios,1809,3,1,1,4,4,10,-6,4
AEK Athens,1810,1,4,2,0,7,1,6,14
PAOK Salonik,1810,2,3,2,1,11,5,6,11
P'thinaikos,1810,3,1,1,4,5,11,-6,4
Panionios,1810,4,1,1,4,4,10,-6,4
AEK Athens,1811,1,4,2,0,7,1,6,14
PAOK Salonik,1811,2,2,2,2,9,6,3,8
P'thinaikos,1811,3,2,1,3,6,9,-3,7
Panionios,1811,4,1,1,4,4,10,-6,4
AEK Athens,1812,1,4,2,0,7,1,6,14
PAOK Salonik,1812,2,3,2,1,13,5,8,11
Panionios,1812,3,1,1,4,4,10,-6,4
P'thinaikos,1812,4,1,1,4,5,13,-8,4
AEK Athens,1813,1,4,2,0,7,1,6,14
PAOK Salonik,1813,2,3,2,1,10,4,6,11
P'thinaikos,1813,3,1,1,4,4,10,-6,4
Panionios,1813,3,1,1,4,4,10,-6,4
AEK Athens,1814,1,4,2,0,7,1,6,14
PAOK Salonik,1814,2,3,2,1,11,5,6,11
P'thinaikos,1814,3,1,1,4,5,11,-6,4
Panionios,1814,4,1,1,4,4,10,-6,4
AEK Athens,1815,1,4,2,0,7,1,6,14
PAOK Salonik,1815,2,2,2,2,9,5,4,8
P'thinaikos,1815,3,2,1,3,5,9,-4,7
Panionios,1815,4,1,1,4,4,10,-6,4
AEK Athens,1816,1,4,2,0,7,1,6,14
PAOK Salonik,1816,2,2,3,1,10,5,5,9
P'thinaikos,1816,3,1,2,3,5,10,-5,5
Panionios,1816,4,1,1,4,4,10,-6,4
AEK Athens,1817,1,4,2,0,7,1,6,14
PAOK Salonik,1817,2,3,2,1,12,5,7,11
Panionios,1817,3,1,1,4,4,10,-6,4
P'thinaikos,1817,4,1,1,4,5,12,-7,4
AEK Athens,1818,1,4,2,0,7,1,6,14
PAOK Salonik,1818,2,2,2,2,10,8,2,8
P'thinaikos,1818,3,2,1,3,8,10,-2,7
Panionios,1818,4,1,1,4,4,10,-6,4
AEK Athens,1819,1,4,2,0,7,1,6,14
PAOK Salonik,1819,2,2,3,1,13,8,5,9
P'thinaikos,1819,3,1,2,3,8,13,-5,5
Panionios,1819,4,1,1,4,4,10,-6,4
AEK Athens,1820,1,4,2,0,7,1,6,14
PAOK Salonik,1820,2,3,2,1,10,4,6,11
P'thinaikos,1820,3,1,1,4,4,10,-6,4
Panionios,1820,3,1,1,4,4,10,-6,4
AEK Athens,1821,1,4,2,0,7,1,6,14
PAOK Salonik,1821,2,2,3,1,10,5,5,9
P'thinaikos,1821,3,1,2,3,5,10,-5,5
Panionios,1821,4,1,1,4,4,10,-6,4
AEK Athens,1822,1,4,2,0,7,1,6,14
PAOK Salonik,1822,2,2,2,2,10,6,4,8
P'thinaikos,1822,3,2,1,3,6,10,-4,7
Panionios,1822,4,1,1,4,4,10,-6,4
AEK Athens,1823,1,4,2,0,7,1,6,14
PAOK Salonik,1823,2,2,3,1,9,4,5,9
P'thinaikos,1823,3,1,2,3,4,9,-5,5
Panionios,1823,4,1,1,4,4,10,-6,4
AEK Athens,1824,1,4,2,0,7,1,6,14
PAOK Salonik,1824,2,3,2,1,11,4,7,11
Panionios,1824,3,1,1,4,4,10,-6,4
P'thinaikos,1824,4,1,1,4,4,11,-7,4
AEK Athens,1825,1,4,2,0,7,1,6,14
PAOK Salonik,1825,2,2,2,2,9,5,4,8
P'thinaikos,1825,3,2,1,3,5,9,-4,7
Panionios,1825,4,1,1,4,4,10,-6,4
AEK Athens,1826,1,4,2,0,7,1,6,14
PAOK Salonik,1826,2,2,3,1,9,4,5,9
P'thinaikos,1826,3,1,2,3,4,9,-5,5
Panionios,1826,4,1,1,4,4,10,-6,4
AEK Athens,1827,1,4,2,0,7,1,6,14
PAOK Salonik,1827,2,2,2,2,9,5,4,8
P'thinaikos,1827,3,2,1,3,5,9,-4,7
Panionios,1827,4,1,1,4,4,10,-6,4
AEK Athens,1828,1,4,2,0,7,1,6,14
PAOK Salonik,1828,2,2,2,2,9,7,2,8
P'thinaikos,1828,3,2,1,3,7,9,-2,7
Panionios,1828,4,1,1,4,4,10,-6,4
AEK Athens,1829,1,4,2,0,7,1,6,14
PAOK Salonik,1829,2,3,2,1,10,4,6,11
P'thinaikos,1829,3,1,1,4,4,10,-6,4
Panionios,1829,3,1,1,4,4,10,-6,4
AEK Athens,1830,1,4,2,0,7,1,6,14
PAOK Salonik,1830,2,2,2,2,9,6,3,8
P'thinaikos,1830,3,2,1,3,6,9,-3,7
Panionios,1830,4,1,1,4,4,10,-6,4
AEK Athens,1831,1,4,2,0,7,1,6,14
PAOK Salonik,1831,2,2,3,1,10,5,5,9
P'thinaikos,1831,3,1,2,3,5,10,-5,5
Panionios,1831,4,1,1,4,4,10,-6,4
AEK Athens,1832,1,4,2,0,7,1,6,14
PAOK Salonik,1832,2,2,2,2,10,6,4,8
P'thinaikos,1832,3,2,1,3,6,10,-4,7
Panionios,1832,4,1,1,4,4,10,-6,4
AEK Athens,1833,1,4,2,0,7,1,6,14
PAOK Salonik,1833,2,2,2,2,10,6,4,8
P'thinaikos,1833,3,2,1,3,6,10,-4,7
Panionios,1833,4,1,1,4,4,10,-6,4
AEK Athens,1834,1,4,2,0,7,1,6,14
PAOK Salonik,1834,2,2,3,1,9,4,5,9
P'thinaikos,1834,3,1,2,3,4,9,-5,5
Panionios,1834,4,1,1,4,4,10,-6,4
AEK Athens,1835,1,4,2,0,7,1,6,14
PAOK Salonik,1835,2,3,2,1,11,5,6,11
P'thinaikos,1835,3,1,1,4,5,11,-6,4
Panionios,1835,4,1,1,4,4,10,-6,4
AEK Athens,1836,1,4,2,0,7,1,6,14
PAOK Salonik,1836,2,3,2,1,10,4,6,11
P'thinaikos,1836,3,1,1,4,4,10,-6,4
Panionios,1836,3,1,1,4,4,10,-6,4
AEK Athens,1837,1,4,2,0,7,1,6,14
PAOK Salonik,1837,2,3,2,1,10,4,6,11
P'thinaikos,1837,3,1,1,4,4,10,-6,4
Panionios,1837,3,1,1,4,4,10,-6,4
AEK Athens,1838,1,4,2,0,7,1,6,14
PAOK Salonik,1838,2,2,2,2,9,5,4,8
P'thinaikos,1838,3,2,1,3,5,9,-4,7
Panionios,1838,4,1,1,4,4,10,-6,4
AEK Athens,1839,1,4,2,0,7,1,6,14
PAOK Salonik,1839,2,2,2,2,10,6,4,8
P'thinaikos,1839,3,2,1,3,6,10,-4,7
Panionios,1839,4,1,1,4,4,10,-6,4
AEK Athens,1840,1,4,2,0,7,1,6,14
PAOK Salonik,1840,2,2,3,1,11,6,5,9
P'thinaikos,1840,3,1,2,3,6,11,-5,5
Panionios,1840,4,1,1,4,4,10,-6,4
AEK Athens,1841,1,4,2,0,7,1,6,14
PAOK Salonik,1841,2,2,3,1,9,4,5,9
P'thinaikos,1841,3,1,2,3,4,9,-5,5
Panionios,1841,4,1,1,4,4,10,-6,4
AEK Athens,1842,1,4,2,0,7,1,6,14
PAOK Salonik,1842,2,2,2,2,10,6,4,8
P'thinaikos,1842,3,2,1,3,6,10,-4,7
Panionios,1842,4,1,1,4,4,10,-6,4
AEK Athens,1843,1,4,2,0,7,1,6,14
PAOK Salonik,1843,2,3,2,1,11,5,6,11
P'thinaikos,1843,3,1,1,4,5,11,-6,4
Panionios,1843,4,1,1,4,4,10,-6,4
AEK Athens,1844,1,4,2,0,7,1,6,14
PAOK Salonik,1844,2,2,2,2,9,6,3,8
P'thinaikos,1844,3,2,1,3,6,9,-3,7
Panionios,1844,4,1,1,4,4,10,-6,4
AEK Athens,1845,1,4,2,0,7,1,6,14
PAOK Salonik,1845,2,2,2,2,9,5,4,8
P'thinaikos,1845,3,2,1,3,5,9,-4,7
Panionios,1845,4,1,1,4,4,10,-6,4
AEK Athens,1846,1,4,2,0,7,1,6,14
PAOK Salonik,1846,2,2,3,1,12,7,5,9
P'thinaikos,1846,3,1,2,3,7,12,-5,5
Panionios,1846,4,1,1,4,4,10,-6,4
AEK Athens,1847,1,4,2,0,7,1,6,14
PAOK Salonik,1847,2,2,3,1,10,5,5,9
P'thinaikos,1847,3,1,2,3,5,10,-5,5
Panionios,1847,4,1,1,4,4,10,-6,4
AEK Athens,1848,1,4,2,0,7,1,6,14
PAOK Salonik,1848,2,2,3,1,10,5,5,9
P'thinaikos,1848,3,1,2,3,5,10,-5,5
Panionios,1848,4,1,1,4,4,10,-6,4
AEK Athens,1849,1,4,2,0,7,1,6,14
PAOK Salonik,1849,2,2,2,2,10,6,4,8
P'thinaikos,1849,3,2,1,3,6,10,-4,7
Panionios,1849,4,1,1,4,4,10,-6,4
AEK Athens,1850,1,4,2,0,7,1,6,14
PAOK Salonik,1850,2,2,2,2,10,8,2,8
P'thinaikos,1850,3,2,1,3,8,10,-2,7
Panionios,1850,4,1,1,4,4,10,-6,4
AEK Athens,1851,1,4,2,0,7,1,6,14
PAOK Salonik,1851,2,2,3,1,11,6,5,9
P'thinaikos,1851,3,1,2,3,6,11,-5,5
Panionios,1851,4,1,1,4,4,10,-6,4
AEK Athens,1852,1,4,2,0,7,1,6,14
PAOK Salonik,1852,2,2,2,2,9,6,3,8
P'thinaikos,1852,3,2,1,3,6,9,-3,7
Panionios,1852,4,1,1,4,4,10,-6,4
AEK Athens,1853,1,4,2,0,7,1,6,14
PAOK Salonik,1853,2,2,3,1,9,4,5,9
P'thinaikos,1853,3,1,2,3,4,9,-5,5
Panionios,1853,4,1,1,4,4,10,-6,4
AEK Athens,1854,1,4,2,0,7,1,6,14
PAOK Salonik,1854,2,2,3,1,11,6,5,9
P'thinaikos,1854,3,1,2,3,6,11,-5,5
Panionios,1854,4,1,1,4,4,10,-6,4
AEK Athens,1855,1,4,2,0,7,1,6,14
PAOK Salonik,1855,2,2,2,2,9,7,2,8
P'thinaikos,1855,3,2,1,3,7,9,-2,7
Panionios,1855,4,1,1,4,4,10,-6,4
AEK Athens,1856,1,4,2,0,7,1,6,14
PAOK Salonik,1856,2,2,2,2,9,6,3,8
P'thinaikos,1856,3,2,1,3,6,9,-3,7
Panionios,1856,4,1,1,4,4,10,-6,4
AEK Athens,1857,1,4,2,0,7,1,6,14
PAOK Salonik,1857,2,2,2,2,9,5,4,8
P'thinaikos,1857,3,2,1,3,5,9,-4,7
Panionios,1857,4,1,1,4,4,10,-6,4
AEK Athens,1858,1,4,2,0,7,1,6,14
PAOK Salonik,1858,2,2,3,1,9,4,5,9
P'thinaikos,1858,3,1,2,3,4,9,-5,5
Panionios,1858,4,1,1,4,4,10,-6,4
AEK Athens,1859,1,4,2,0,7,1,6,14
PAOK Salonik,1859,2,2,2,2,10,7,3,8
P'thinaikos,1859,3,2,1,3,7,10,-3,7
Panionios,1859,4,1,1,4,4,10,-6,4
AEK Athens,1860,1,4,2,0,7,1,6,14
PAOK Salonik,1860,2,2,3,1,10,5,5,9
P'thinaikos,1860,3,1,2,3,5,10,-5,5
Panionios,1860,4,1,1,4,4,10,-6,4
AEK Athens,1861,1,4,2,0,7,1,6,14
PAOK Salonik,1861,2,2,2,2,9,5,4,8
P'thinaikos,1861,3,2,1,3,5,9,-4,7
Panionios,1861,4,1,1,4,4,10,-6,4
AEK Athens,1862,1,4,2,0,7,1,6,14
PAOK Salonik,1862,2,3,2,1,10,4,6,11
P'thinaikos,1862,3,1,1,4,4,10,-6,4
Panionios,1862,3,1,1,4,4,10,-6,4
AEK Athens,1863,1,4,2,0,7,1,6,14
PAOK Salonik,1863,2,2,2,2,9,6,3,8
P'thinaikos,1863,3,2,1,3,6,9,-3,7
Panionios,1863,4,1,1,4,4,10,-6,4
AEK Athens,1864,1,4,2,0,7,1,6,14
PAOK Salonik,1864,2,3,2,1,12,5,7,11
Panionios,1864,3,1,1,4,4,10,-6,4
P'thinaikos,1864,4,1,1,4,5,12,-7,4
AEK Athens,1865,1,4,2,0,7,1,6,14
PAOK Salonik,1865,2,2,2,2,10,6,4,8
P'thinaikos,1865,3,2,1,3,6,10,-4,7
Panionios,1865,4,1,1,4,4,10,-6,4
AEK Athens,1866,1,4,2,0,7,1,6,14
PAOK Salonik,1866,2,2,2,2,10,6,4,8
P'thinaikos,1866,3,2,1,3,6,10,-4,7
Panionios,1866,4,1,1,4,4,10,-6,4
AEK Athens,1867,1,4,2,0,7,1,6,14
PAOK Salonik,1867,2,3,2,1,10,4,6,11
P'thinaikos,1867,3,1,1,4,4,10,-6,4
Panionios,1867,3,1,1,4,4,10,-6,4
AEK Athens,1868,1,4,2,0,7,1,6,14
PAOK Salonik,1868,2,2,3,1,10,5,5,9
P'thinaikos,1868,3,1,2,3,5,10,-5,5
Panionios,1868,4,1,1,4,4,10,-6,4
AEK Athens,1869,1,4,2,0,7,1,6,14
PAOK Salonik,1869,2,3,2,1,11,5,6,11
P'thinaikos,1869,3,1,1,4,5,11,-6,4
Panionios,1869,4,1,1,4,4,10,-6,4
AEK Athens,1870,1,4,2,0,7,1,6,14
PAOK Salonik,1870,2,2,2,2,10,7,3,8
P'thinaikos,1870,3,2,1,3,7,10,-3,7
Panionios,1870,4,1,1,4,4,10,-6,4
AEK Athens,1871,1,4,2,0,7,1,6,14
PAOK Salonik,1871,2,2,2,2,9,6,3,8
P'thinaikos,1871,3,2,1,3,6,9,-3,7
Panionios,1871,4,1,1,4,4,10,-6,4
AEK Athens,1872,1,4,2,0,7,1,6,14
PAOK Salonik,1872,2,3,2,1,11,5,6,11
P'thinaikos,1872,3,1,1,4,5,11,-6,4
Panionios,1872,4,1,1,4,4,10,-6,4
AEK Athens,1873,1,4,2,0,7,1,6,14
PAOK Salonik,1873,2,2,2,2,10,6,4,8
P'thinaikos,1873,3,2,1,3,6,10,-4,7
Panionios,1873,4,1,1,4,4,10,-6,4
AEK Athens,1874,1,4,2,0,7,1,6,14
PAOK Salonik,1874,2,2,2,2,10,7,3,8
P'thinaikos,1874,3,2,1,3,7,10,-3,7
Panionios,1874,4,1,1,4,4,10,-6,4
AEK Athens,1875,1,4,2,0,7,1,6,14
PAOK Salonik,1875,2,3,2,1,11,4,7,11
Panionios,1875,3,1,1,4,4,10,-6,4
P'thinaikos,1875,4,1,1,4,4,11,-7,4
AEK Athens,1876,1,4,2,0,7,1,6,14
PAOK Salonik,1876,2,2,2,2,9,6,3,8
P'thinaikos,1876,3,2,1,3,6,9,-3,7
Panionios,1876,4,1,1,4,4,10,-6,4
AEK Athens,1877,1,4,2,0,7,1,6,14
PAOK Salonik,1877,2,2,2,2,10,6,4,8
P'thinaikos,1877,3,2,1,3,6,10,-4,7
Panionios,1877,4,1,1,4,4,10,-6,4
AEK Athens,1878,1,4,2,0,7,1,6,14
PAOK Salonik,1878,2,2,2,2,10,6,4,8
P'thinaikos,1878,3,2,1,3,6,10,-4,7
Panionios,1878,4,1,1,4,4,10,-6,4
AEK Athens,1879,1,4,2,0,7,1,6,14
PAOK Salonik,1879,2,3,2,1,10,4,6,11
P'thinaikos,1879,3,1,1,4,4,10,-6,4
Panionios,1879,3,1,1,4,4,10,-6,4
AEK Athens,1880,1,4,2,0,7,1,6,14
PAOK Salonik,1880,2,3,2,1,11,4,7,11
Panionios,1880,3,1,1,4,4,10,-6,4
P'thinaikos,1880,4,1,1,4,4,11,-7,4
AEK Athens,1881,1,4,2,0,7,1,6,14
PAOK Salonik,1881,2,3,2,1,11,4,7,11
Panionios,1881,3,1,1,4,4,10,-6,4
P'thinaikos,1881,4,1,1,4,4,11,-7,4
AEK Athens,1882,1,4,2,0,7,1,6,14
PAOK Salonik,1882,2,2,2,2,10,7,3,8
P'thinaikos,1882,3,2,1,3,7,10,-3,7
Panionios,1882,4,1,1,4,4,10,-6,4
AEK Athens,1883,1,4,2,0,7,1,6,14
PAOK Salonik,1883,2,3,2,1,11,4,7,11
Panionios,1883,3,1,1,4,4,10,-6,4
P'thinaikos,1883,4,1,1,4,4,11,-7,4
AEK Athens,1884,1,4,2,0,7,1,6,14
PAOK Salonik,1884,2,2,2,2,9,8,1,8
P'thinaikos,1884,3,2,1,3,8,9,-1,7
Panionios,1884,4,1,1,4,4,10,-6,4
AEK Athens,1885,1,4,2,0,7,1,6,14
PAOK Salonik,1885,2,3,2,1,13,4,9,11
Panionios,1885,3,1,1,4,4,10,-6,4
P'thinaikos,1885,4,1,1,4,4,13,-9,4
AEK Athens,1886,1,4,2,0,7,1,6,14
PAOK Salonik,1886,2,2,2,2,10,6,4,8
P'thinaikos,1886,3,2,1,3,6,10,-4,7
Panionios,1886,4,1,1,4,4,10,-6,4
AEK Athens,1887,1,4,2,0,7,1,6,14
PAOK Salonik,1887,2,2,3,1,9,4,5,9
P'thinaikos,1887,3,1,2,3,4,9,-5,5
Panionios,1887,4,1,1,4,4,10,-6,4
AEK Athens,1888,1,4,2,0,7,1,6,14
PAOK Salonik,1888,2,3,2,1,10,4,6,11
P'thinaikos,1888,3,1,1,4,4,10,-6,4
Panionios,1888,3,1,1,4,4,10,-6,4
AEK Athens,1889,1,4,2,0,7,1,6,14
PAOK Salonik,1889,2,2,2,2,9,6,3,8
P'thinaikos,1889,3,2,1,3,6,9,-3,7
Panionios,1889,4,1,1,4,4,10,-6,4
AEK Athens,1890,1,4,2,0,7,1,6,14
PAOK Salonik,1890,2,2,3,1,9,4,5,9
P'thinaikos,1890,3,1,2,3,4,9,-5,5
Panionios,1890,4,1,1,4,4,10,-6,4
AEK Athens,1891,1,4,2,0,7,1,6,14
PAOK Salonik,1891,2,2,2,2,9,6,3,8
P'thinaikos,1891,3,2,1,3,6,9,-3,7
Panionios,1891,4,1,1,4,4,10,-6,4
AEK Athens,1892,1,4,2,0,7,1,6,14
PAOK Salonik,1892,2,3,2,1,13,5,8,11
Panionios,1892,3,1,1,4,4,10,-6,4
P'thinaikos,1892,4,1,1,4,5,13,-8,4
AEK Athens,1893,1,4,2,0,7,1,6,14
PAOK Salonik,1893,2,3,2,1,11,4,7,11
Panionios,1893,3,1,1,4,4,10,-6,4
P'thinaikos,1893,4,1,1,4,4,11,-7,4
AEK Athens,1894,1,4,2,0,7,1,6,14
PAOK Salonik,1894,2,2,2,2,11,7,4,8
P'thinaikos,1894,3,2,1,3,7,11,-4,7
Panionios,1894,4,1,1,4,4,10,-6,4
AEK Athens,1895,1,4,2,0,7,1,6,14
PAOK Salonik,1895,2,2,2,2,9,6,3,8
P'thinaikos,1895,3,2,1,3,6,9,-3,7
Panionios,1895,4,1,1,4,4,10,-6,4
AEK Athens,1896,1,4,2,0,7,1,6,14
PAOK Salonik,1896,2,2,2,2,10,7,3,8
P'thinaikos,1896,3,2,1,3,7,10,-3,7
Panionios,1896,4,1,1,4,4,10,-6,4
AEK Athens,1897,1,4,2,0,7,1,6,14
PAOK Salonik,1897,2,3,2,1,10,4,6,11
P'thinaikos,1897,3,1,1,4,4,10,-6,4
Panionios,1897,3,1,1,4,4,10,-6,4
AEK Athens,1898,1,4,2,0,7,1,6,14
PAOK Salonik,1898,2,2,2,2,9,5,4,8
P'thinaikos,1898,3,2,1,3,5,9,-4,7
Panionios,1898,4,1,1,4,4,10,-6,4
AEK Athens,1899,1,4,2,0,7,1,6,14
PAOK Salonik,1899,2,2,3,1,10,5,5,9
P'thinaikos,1899,3,1,2,3,5,10,-5,5
Panionios,1899,4,1,1,4,4,10,-6,4
AEK Athens,1900,1,4,2,0,7,1,6,14
PAOK Salonik,1900,2,2,3,1,9,4,5,9
P'thinaikos,1900,3,1,2,3,4,9,-5,5
Panionios,1900,4,1,1,4,4,10,-6,4
AEK Athens,1901,1,4,2,0,7,1,6,14
PAOK Salonik,1901,2,3,2,1,11,4,7,11
Panionios,1901,3,1,1,4,4,10,-6,4
P'thinaikos,1901,4,1,1,4,4,11,-7,4
AEK Athens,1902,1,4,2,0,7,1,6,14
PAOK Salonik,1902,2,2,3,1,9,4,5,9
P'thinaikos,1902,3,1,2,3,4,9,-5,5
Panionios,1902,4,1,1,4,4,10,-6,4
AEK Athens,1903,1,4,2,0,7,1,6,14
PAOK Salonik,1903,2,2,2,2,10,7,3,8
P'thinaikos,1903,3,2,1,3,7,10,-3,7
Panionios,1903,4,1,1,4,4,10,-6,4
AEK Athens,1904,1,4,2,0,7,1,6,14
PAOK Salonik,1904,2,2,3,1,9,4,5,9
P'thinaikos,1904,3,1,2,3,4,9,-5,5
Panionios,1904,4,1,1,4,4,10,-6,4
AEK Athens,1905,1,4,2,0,7,1,6,14
PAOK Salonik,1905,2,3,2,1,11,4,7,11
Panionios,1905,3,1,1,4,4,10,-6,4
P'thinaikos,1905,4,1,1,4,4,11,-7,4
AEK Athens,1906,1,4,2,0,7,1,6,14
PAOK Salonik,1906,2,3,2,1,11,5,6,11
P'thinaikos,1906,3,1,1,4,5,11,-6,4
Panionios,1906,4,1,1,4,4,10,-6,4
AEK Athens,1907,1,4,2,0,7,1,6,14
PAOK Salonik,1907,2,2,2,2,9,5,4,8
P'thinaikos,1907,3,2,1,3,5,9,-4,7
Panionios,1907,4,1,1,4,4,10,-6,4
AEK Athens,1908,1,4,2,0,7,1,6,14
PAOK Salonik,1908,2,2,2,2,9,5,4,8
P'thinaikos,1908,3,2,1,3,5,9,-4,7
Panionios,1908,4,1,1,4,4,10,-6,4
AEK Athens,1909,1,4,2,0,7,1,6,14
PAOK Salonik,1909,2,2,2,2,9,6,3,8
P'thinaikos,1909,3,2,1,3,6,9,-3,7
Panionios,1909,4,1,1,4,4,10,-6,4
AEK Athens,1910,1,4,2,0,7,1,6,14
PAOK Salonik,1910,2,2,2,2,11,7,4,8
P'thinaikos,1910,3,2,1,3,7,11,-4,7
Panionios,1910,4,1,1,4,4,10,-6,4
AEK Athens,1911,1,4,2,0,7,1,6,14
PAOK Salonik,1911,2,2,3,1,11,6,5,9
P'thinaikos,1911,3,1,2,3,6,11,-5,5
Panionios,1911,4,1,1,4,4,10,-6,4
AEK Athens,1912,1,4,2,0,7,1,6,14
PAOK Salonik,1912,2,2,3,1,9,4,5,9
P'thinaikos,1912,3,1,2,3,4,9,-5,5
Panionios,1912,4,1,1,4,4,10,-6,4
AEK Athens,1913,1,4,2,0,7,1,6,14
PAOK Salonik,1913,2,3,2,1,10,4,6,11
P'thinaikos,1913,3,1,1,4,4,10,-6,4
Panionios,1913,3,1,1,4,4,10,-6,4
AEK Athens,1914,1,4,2,0,7,1,6,14
PAOK Salonik,1914,2,2,2,2,9,6,3,8
P'thinaikos,1914,3,2,1,3,6,9,-3,7
Panionios,1914,4,1,1,4,4,10,-6,4
AEK Athens,1915,1,4,2,0,7,1,6,14
PAOK Salonik,1915,2,3,2,1,10,4,6,11
P'thinaikos,1915,3,1,1,4,4,10,-6,4
Panionios,1915,3,1,1,4,4,10,-6,4
AEK Athens,1916,1,4,2,0,7,1,6,14
PAOK Salonik,1916,2,3,2,1,12,4,8,11
Panionios,1916,3,1,1,4,4,10,-6,4
P'thinaikos,1916,4,1,1,4,4,12,-8,4
AEK Athens,1917,1,4,2,0,7,1,6,14
PAOK Salonik,1917,2,3,2,1,11,5,6,11
P'thinaikos,1917,3,1,1,4,5,11,-6,4
Panionios,1917,4,1,1,4,4,10,-6,4
AEK Athens,1918,1,4,2,0,7,1,6,14
PAOK Salonik,1918,2,2,2,2,10,6,4,8
P'thinaikos,1918,3,2,1,3,6,10,-4,7
Panionios,1918,4,1,1,4,4,10,-6,4
AEK Athens,1919,1,4,2,0,7,1,6,14
PAOK Salonik,1919,2,2,3,1,9,4,5,9
P'thinaikos,1919,3,1,2,3,4,9,-5,5
Panionios,1919,4,1,1,4,4,10,-6,4
AEK Athens,1920,1,4,2,0,7,1,6,14
PAOK Salonik,1920,2,2,2,2,11,7,4,8
P'thinaikos,1920,3,2,1,3,7,11,-4,7
Panionios,1920,4,1,1,4,4,10,-6,4
AEK Athens,1921,1,4,2,0,7,1,6,14
PAOK Salonik,1921,2,3,2,1,11,4,7,11
Panionios,1921,3,1,1,4,4,10,-6,4
P'thinaikos,1921,4,1,1,4,4,11,-7,4
AEK Athens,1922,1,4,2,0,7,1,6,14
PAOK Salonik,1922,2,2,2,2,9,8,1,8
P'thinaikos,1922,3,2,1,3,8,9,-1,7
Panionios,1922,4,1,1,4,4,10,-6,4
AEK Athens,1923,1,4,2,0,7,1,6,14
PAOK Salonik,1923,2,2,2,2,10,6,4,8
P'thinaikos,1923,3,2,1,3,6,10,-4,7
Panionios,1923,4,1,1,4,4,10,-6,4
AEK Athens,1924,1,4,2,0,7,1,6,14
PAOK Salonik,1924,2,2,3,1,10,5,5,9
P'thinaikos,1924,3,1,2,3,5,10,-5,5
Panionios,1924,4,1,1,4,4,10,-6,4
AEK Athens,1925,1,4,2,0,7,1,6,14
PAOK Salonik,1925,2,3,2,1,11,4,7,11
Panionios,1925,3,1,1,4,4,10,-6,4
P'thinaikos,1925,4,1,1,4,4,11,-7,4
AEK Athens,1926,1,4,2,0,7,1,6,14
PAOK Salonik,1926,2,2,2,2,9,6,3,8
P'thinaikos,1926,3,2,1,3,6,9,-3,7
Panionios,1926,4,1,1,4,4,10,-6,4
AEK Athens,1927,1,4,2,0,7,1,6,14
PAOK Salonik,1927,2,3,2,1,10,4,6,11
P'thinaikos,1927,3,1,1,4,4,10,-6,4
Panionios,1927,3,1,1,4,4,10,-6,4
AEK Athens,1928,1,4,2,0,7,1,6,14
PAOK Salonik,1928,2,3,2,1,10,4,6,11
P'thinaikos,1928,3,1,1,4,4,10,-6,4
Panionios,1928,3,1,1,4,4,10,-6,4
AEK Athens,1929,1,4,2,0,7,1,6,14
PAOK Salonik,1929,2,2,2,2,11,7,4,8
P'thinaikos,1929,3,2,1,3,7,11,-4,7
Panionios,1929,4,1,1,4,4,10,-6,4
AEK Athens,1930,1,4,2,0,7,1,6,14
PAOK Salonik,1930,2,2,2,2,9,7,2,8
P'thinaikos,1930,3,2,1,3,7,9,-2,7
Panionios,1930,4,1,1,4,4,10,-6,4
AEK Athens,1931,1,4,2,0,7,1,6,14
PAOK Salonik,1931,2,2,2,2,9,5,4,8
P'thinaikos,1931,3,2,1,3,5,9,-4,7
Panionios,1931,4,1,1,4,4,10,-6,4
AEK Athens,1932,1,4,2,0,7,1,6,14
PAOK Salonik,1932,2,3,2,1,10,4,6,11
P'thinaikos,1932,3,1,1,4,4,10,-6,4
Panionios,1932,3,1,1,4,4,10,-6,4
AEK Athens,1933,1,4,2,0,7,1,6,14
PAOK Salonik,1933,2,2,3,1,11,6,5,9
P'thinaikos,1933,3,1,2,3,6,11,-5,5
Panionios,1933,4,1,1,4,4,10,-6,4
AEK Athens,1934,1,4,2,0,7,1,6,14
PAOK Salonik,1934,2,2,2,2,10,6,4,8
P'thinaikos,1934,3,2,1,3,6,10,-4,7
Panionios,1934,4,1,1,4,4,10,-6,4
AEK Athens,1935,1,4,2,0,7,1,6,14
PAOK Salonik,1935,2,3,2,1,11,5,6,11
P'thinaikos,1935,3,1,1,4,5,11,-6,4
Panionios,1935,4,1,1,4,4,10,-6,4
AEK Athens,1936,1,4,2,0,7,1,6,14
PAOK Salonik,1936,2,3,2,1,11,5,6,11
P'thinaikos,1936,3,1,1,4,5,11,-6,4
Panionios,1936,4,1,1,4,4,10,-6,4
AEK Athens,1937,1,4,2,0,7,1,6,14
PAOK Salonik,1937,2,2,3,1,10,5,5,9
P'thinaikos,1937,3,1,2,3,5,10,-5,5
Panionios,1937,4,1,1,4,4,10,-6,4
AEK Athens,1938,1,4,2,0,7,1,6,14
PAOK Salonik,1938,2,2,2,2,10,6,4,8
P'thinaikos,1938,3,2,1,3,6,10,-4,7
Panionios,1938,4,1,1,4,4,10,-6,4
AEK Athens,1939,1,4,2,0,7,1,6,14
PAOK Salonik,1939,2,3,2,1,12,5,7,11
Panionios,1939,3,1,1,4,4,10,-6,4
P'thinaikos,1939,4,1,1,4,5,12,-7,4
AEK Athens,1940,1,4,2,0,7,1,6,14
PAOK Salonik,1940,2,2,3,1,10,5,5,9
P'thinaikos,1940,3,1,2,3,5,10,-5,5
Panionios,1940,4,1,1,4,4,10,-6,4
AEK Athens,1941,1,4,2,0,7,1,6,14
PAOK Salonik,1941,2,2,3,1,10,5,5,9
P'thinaikos,1941,3,1,2,3,5,10,-5,5
Panionios,1941,4,1,1,4,4,10,-6,4
AEK Athens,1942,1,4,2,0,7,1,6,14
PAOK Salonik,1942,2,2,2,2,11,9,2,8
P'thinaikos,1942,3,2,1,3,9,11,-2,7
Panionios,1942,4,1,1,4,4,10,-6,4
AEK Athens,1943,1,4,2,0,7,1,6,14
PAOK Salonik,1943,2,2,3,1,10,5,5,9
P'thinaikos,1943,3,1,2,3,5,10,-5,5
Panionios,1943,4,1,1,4,4,10,-6,4
AEK Athens,1944,1,4,2,0,7,1,6,14
PAOK Salonik,1944,2,2,2,2,9,6,3,8
P'thinaikos,1944,3,2,1,3,6,9,-3,7
Panionios,1944,4,1,1,4,4,10,-6,4
AEK Athens,1945,1,4,2,0,7,1,6,14
PAOK Salonik,1945,2,2,2,2,9,9,0,8
P'thinaikos,1945,3,2,1,3,9,9,0,7
Panionios,1945,4,1,1,4,4,10,-6,4
AEK Athens,1946,1,4,2,0,7,1,6,14
PAOK Salonik,1946,2,2,3,1,10,5,5,9
P'thinaikos,1946,3,1,2,3,5,10,-5,5
Panionios,1946,4,1,1,4,4,10,-6,4
AEK Athens,1947,1,4,2,0,7,1,6,14
PAOK Salonik,1947,2,3,2,1,11,5,6,11
P'thinaikos,1947,3,1,1,4,5,11,-6,4
Panionios,1947,4,1,1,4,4,10,-6,4
AEK Athens,1948,1,4,2,0,7,1,6,14
PAOK Salonik,1948,2,2,3,1,9,4,5,9
P'thinaikos,1948,3,1,2,3,4,9,-5,5
Panionios,1948,4,1,1,4,4,10,-6,4
AEK Athens,1949,1,4,2,0,7,1,6,14
PAOK Salonik,1949,2,3,2,1,12,6,6,11
P'thinaikos,1949,3,1,1,4,6,12,-6,4
Panionios,1949,4,1,1,4,4,10,-6,4
AEK Athens,1950,1,4,2,0,7,1,6,14
PAOK Salonik,1950,2,2,3,1,10,5,5,9
P'thinaikos,1950,3,1,2,3,5,10,-5,5
Panionios,1950,4,1,1,4,4,10,-6,4
AEK Athens,1951,1,4,2,0,7,1,6,14
PAOK Salonik,1951,2,2,3,1,10,5,5,9
P'thinaikos,1951,3,1,2,3,5,10,-5,5
Panionios,1951,4,1,1,4,4,10,-6,4
AEK Athens,1952,1,4,2,0,7,1,6,14
PAOK Salonik,1952,2,2,2,2,9,5,4,8
P'thinaikos,1952,3,2,1,3,5,9,-4,7
Panionios,1952,4,1,1,4,4,10,-6,4
AEK Athens,1953,1,4,2,0,7,1,6,14
PAOK Salonik,1953,2,2,2,2,9,7,2,8
P'thinaikos,1953,3,2,1,3,7,9,-2,7
Panionios,1953,4,1,1,4,4,10,-6,4
AEK Athens,1954,1,4,2,0,7,1,6,14
PAOK Salonik,1954,2,3,2,1,11,4,7,11
Panionios,1954,3,1,1,4,4,10,-6,4
P'thinaikos,1954,4,1,1,4,4,11,-7,4
AEK Athens,1955,1,4,2,0,7,1,6,14
PAOK Salonik,1955,2,3,2,1,10,4,6,11
P'thinaikos,1955,3,1,1,4,4,10,-6,4
Panionios,1955,3,1,1,4,4,10,-6,4
AEK Athens,1956,1,4,2,0,7,1,6,14
PAOK Salonik,1956,2,2,2,2,9,5,4,8
P'thinaikos,1956,3,2,1,3,5,9,-4,7
Panionios,1956,4,1,1,4,4,10,-6,4
AEK Athens,1957,1,4,2,0,7,1,6,14
PAOK Salonik,1957,2,2,3,1,10,5,5,9
P'thinaikos,1957,3,1,2,3,5,10,-5,5
Panionios,1957,4,1,1,4,4,10,-6,4
AEK Athens,1958,1,4,2,0,7,1,6,14
PAOK Salonik,1958,2,3,2,1,11,5,6,11
P'thinaikos,1958,3,1,1,4,5,11,-6,4
Panionios,1958,4,1,1,4,4,10,-6,4
AEK Athens,1959,1,4,2,0,7,1,6,14
PAOK Salonik,1959,2,3,2,1,10,4,6,11
P'thinaikos,1959,3,1,1,4,4,10,-6,4
Panionios,1959,3,1,1,4,4,10,-6,4
AEK Athens,1960,1,4,2,0,7,1,6,14
PAOK Salonik,1960,2,3,2,1,12,5,7,11
Panionios,1960,3,1,1,4,4,10,-6,4
P'thinaikos,1960,4,1,1,4,5,12,-7,4
AEK Athens,1961,1,4,2,0,7,1,6,14
PAOK Salonik,1961,2,2,3,1,10,5,5,9
P'thinaikos,1961,3,1,2,3,5,10,-5,5
Panionios,1961,4,1,1,4,4,10,-6,4
AEK Athens,1962,1,4,2,0,7,1,6,14
PAOK Salonik,1962,2,3,2,1,12,4,8,11
Panionios,1962,3,1,1,4,4,10,-6,4
P'thinaikos,1962,4,1,1,4,4,12,-8,4
AEK Athens,1963,1,4,2,0,7,1,6,14
PAOK Salonik,1963,2,3,2,1,10,4,6,11
P'thinaikos,1963,3,1,1,4,4,10,-6,4
Panionios,1963,3,1,1,4,4,10,-6,4
AEK Athens,1964,1,4,2,0,7,1,6,14
PAOK Salonik,1964,2,3,2,1,10,4,6,11
P'thinaikos,1964,3,1,1,4,4,10,-6,4
Panionios,1964,3,1,1,4,4,10,-6,4
AEK Athens,1965,1,4,2,0,7,1,6,14
PAOK Salonik,1965,2,2,2,2,10,6,4,8
P'thinaikos,1965,3,2,1,3,6,10,-4,7
Panionios,1965,4,1,1,4,4,10,-6,4
AEK Athens,1966,1,4,2,0,7,1,6,14
PAOK Salonik,1966,2,3,2,1,10,4,6,11
P'thinaikos,1966,3,1,1,4,4,10,-6,4
Panionios,1966,3,1,1,4,4,10,-6,4
AEK Athens,1967,1,4,2,0,7,1,6,14
PAOK Salonik,1967,2,2,2,2,10,6,4,8
P'thinaikos,1967,3,2,1,3,6,10,-4,7
Panionios,1967,4,1,1,4,4,10,-6,4
AEK Athens,1968,1,4,2,0,7,1,6,14
PAOK Salonik,1968,2,3,2,1,10,4,6,11
P'thinaikos,1968,3,1,1,4,4,10,-6,4
Panionios,1968,3,1,1,4,4,10,-6,4
AEK Athens,1969,1,4,2,0,7,1,6,14
PAOK Salonik,1969,2,2,2,2,9,6,3,8
P'thinaikos,1969,3,2,1,3,6,9,-3,7
Panionios,1969,4,1,1,4,4,10,-6,4
AEK Athens,1970,1,4,2,0,7,1,6,14
PAOK Salonik,1970,2,2,2,2,9,7,2,8
P'thinaikos,1970,3,2,1,3,7,9,-2,7
Panionios,1970,4,1,1,4,4,10,-6,4
AEK Athens,1971,1,4,2,0,7,1,6,14
PAOK Salonik,1971,2,3,2,1,11,5,6,11
P'thinaikos,1971,3,1,1,4,5,11,-6,4
Panionios,1971,4,1,1,4,4,10,-6,4
AEK Athens,1972,1,4,2,0,7,1,6,14
PAOK Salonik,1972,2,3,2,1,11,5,6,11
P'thinaikos,1972,3,1,1,4,5,11,-6,4
Panionios,1972,4,1,1,4,4,10,-6,4
AEK Athens,1973,1,4,2,0,7,1,6,14
PAOK Salonik,1973,2,3,2,1,10,4,6,11
P'thinaikos,1973,3,1,1,4,4,10,-6,4
Panionios,1973,3,1,1,4,4,10,-6,4
AEK Athens,1974,1,4,2,0,7,1,6,14
PAOK Salonik,1974,2,3,2,1,12,5,7,11
Panionios,1974,3,1,1,4,4,10,-6,4
P'thinaikos,1974,4,1,1,4,5,12,-7,4
AEK Athens,1975,1,4,2,0,7,1,6,14
PAOK Salonik,1975,2,2,3,1,10,5,5,9
P'thinaikos,1975,3,1,2,3,5,10,-5,5
Panionios,1975,4,1,1,4,4,10,-6,4
AEK Athens,1976,1,4,2,0,7,1,6,14
PAOK Salonik,1976,2,3,2,1,13,4,9,11
Panionios,1976,3,1,1,4,4,10,-6,4
P'thinaikos,1976,4,1,1,4,4,13,-9,4
AEK Athens,1977,1,4,2,0,7,1,6,14
PAOK Salonik,1977,2,2,2,2,9,5,4,8
P'thinaikos,1977,3,2,1,3,5,9,-4,7
Panionios,1977,4,1,1,4,4,10,-6,4
AEK Athens,1978,1,4,2,0,7,1,6,14
PAOK Salonik,1978,2,3,2,1,12,5,7,11
Panionios,1978,3,1,1,4,4,10,-6,4
P'thinaikos,1978,4,1,1,4,5,12,-7,4
AEK Athens,1979,1,4,2,0,7,1,6,14
PAOK Salonik,1979,2,2,3,1,11,6,5,9
P'thinaikos,1979,3,1,2,3,6,11,-5,5
Panionios,1979,4,1,1,4,4,10,-6,4
AEK Athens,1980,1,4,2,0,7,1,6,14
PAOK Salonik,1980,2,2,3,1,10,5,5,9
P'thinaikos,1980,3,1,2,3,5,10,-5,5
Panionios,1980,4,1,1,4,4,10,-6,4
AEK Athens,1981,1,4,2,0,7,1,6,14
PAOK Salonik,1981,2,2,2,2,9,5,4,8
P'thinaikos,1981,3,2,1,3,5,9,-4,7
Panionios,1981,4,1,1,4,4,10,-6,4
AEK Athens,1982,1,4,2,0,7,1,6,14
PAOK Salonik,1982,2,2,2,2,9,5,4,8
P'thinaikos,1982,3,2,1,3,5,9,-4,7
Panionios,1982,4,1,1,4,4,10,-6,4
AEK Athens,1983,1,4,2,0,7,1,6,14
PAOK Salonik,1983,2,2,3,1,9,4,5,9
P'thinaikos,1983,3,1,2,3,4,9,-5,5
Panionios,1983,4,1,1,4,4,10,-6,4
AEK Athens,1984,1,4,2,0,7,1,6,14
PAOK Salonik,1984,2,3,2,1,11,5,6,11
P'thinaikos,1984,3,1,1,4,5,11,-6,4
Panionios,1984,4,1,1,4,4,10,-6,4
AEK Athens,1985,1,4,2,0,7,1,6,14
PAOK Salonik,1985,2,2,3,1,11,6,5,9
P'thinaikos,1985,3,1,2,3,6,11,-5,5
Panionios,1985,4,1,1,4,4,10,-6,4
AEK Athens,1986,1,4,2,0,7,1,6,14
PAOK Salonik,1986,2,2,2,2,9,7,2,8
P'thinaikos,1986,3,2,1,3,7,9,-2,7
Panionios,1986,4,1,1,4,4,10,-6,4
AEK Athens,1987,1,4,2,0,7,1,6,14
PAOK Salonik,1987,2,2,3,1,9,4,5,9
P'thinaikos,1987,3,1,2,3,4,9,-5,5
Panionios,1987,4,1,1,4,4,10,-6,4
AEK Athens,1988,1,4,2,0,7,1,6,14
PAOK Salonik,1988,2,2,3,1,11,6,5,9
P'thinaikos,1988,3,1,2,3,6,11,-5,5
Panionios,1988,4,1,1,4,4,10,-6,4
AEK Athens,1989,1,4,2,0,7,1,6,14
PAOK Salonik,1989,2,3,2,1,10,4,6,11
P'thinaikos,1989,3,1,1,4,4,10,-6,4
Panionios,1989,3,1,1,4,4,10,-6,4
AEK Athens,1990,1,4,2,0,7,1,6,14
PAOK Salonik,1990,2,2,2,2,9,6,3,8
P'thinaikos,1990,3,2,1,3,6,9,-3,7
Panionios,1990,4,1,1,4,4,10,-6,4
AEK Athens,1991,1,4,2,0,7,1,6,14
PAOK Salonik,1991,2,3,2,1,11,5,6,11
P'thinaikos,1991,3,1,1,4,5,11,-6,4
Panionios,1991,4,1,1,4,4,10,-6,4
AEK Athens,1992,1,4,2,0,7,1,6,14
PAOK Salonik,1992,2,3,2,1,13,6,7,11
Panionios,1992,3,1,1,4,4,10,-6,4
P'thinaikos,1992,4,1,1,4,6,13,-7,4
AEK Athens,1993,1,4,2,0,7,1,6,14
PAOK Salonik,1993,2,3,2,1,10,4,6,11
P'thinaikos,1993,3,1,1,4,4,10,-6,4
Panionios,1993,3,1,1,4,4,10,-6,4
AEK Athens,1994,1,4,2,0,7,1,6,14
PAOK Salonik,1994,2,2,3,1,10,5,5,9
P'thinaikos,1994,3,1,2,3,5,10,-5,5
Panionios,1994,4,1,1,4,4,10,-6,4
AEK Athens,1995,1,4,2,0,7,1,6,14
PAOK Salonik,1995,2,2,2,2,10,6,4,8
P'thinaikos,1995,3,2,1,3,6,10,-4,7
Panionios,1995,4,1,1,4,4,10,-6,4
AEK Athens,1996,1,4,2,0,7,1,6,14
PAOK Salonik,1996,2,2,3,1,10,5,5,9
P'thinaikos,1996,3,1,2,3,5,10,-5,5
Panionios,1996,4,1,1,4,4,10,-6,4
AEK Athens,1997,1,4,2,0,7,1,6,14
PAOK Salonik,1997,2,3,2,1,10,4,6,11
P'thinaikos,1997,3,1,1,4,4,10,-6,4
Panionios,1997,3,1,1,4,4,10,-6,4
AEK Athens,1998,1,4,2,0,7,1,6,14
PAOK Salonik,1998,2,3,2,1,12,5,7,11
Panionios,1998,3,1,1,4,4,10,-6,4
P'thinaikos,1998,4,1,1,4,5,12,-7,4
AEK Athens,1999,1,4,2,0,7,1,6,14
PAOK Salonik,1999,2,3,2,1,11,5,6,11
P'thinaikos,1999,3,1,1,4,5,11,-6,4
Panionios,1999,4,1,1,4,4,10,-6,4
AEK Athens,2000,1,4,2,0,7,1,6,14
PAOK Salonik,2000,2,2,2,2,9,5,4,8
P'thinaikos,2000,3,2,1,3,5,9,-4,7
Panionios,2000,4,1,1,4,4,10,-6,4
AEK Athens,2001,1,4,2,0,7,1,6,14
PAOK Salonik,2001,2,2,2,2,9,5,4,8
P'thinaikos,2001,3,2,1,3,5,9,-4,7
Panionios,2001,4,1,1,4,4,10,-6,4
AEK Athens,2002,1,4,2,0,7,1,6,14
PAOK Salonik,2002,2,2,3,1,9,4,5,9
P'thinaikos,2002,3,1,2,3,4,9,-5,5
Panionios,2002,4,1,1,4,4,10,-6,4
AEK Athens,2003,1,4,2,0,7,1,6,14
PAOK Salonik,2003,2,2,3,1,9,4,5,9
P'thinaikos,2003,3,1,2,3,4,9,-5,5
Panionios,2003,4,1,1,4,4,10,-6,4
AEK Athens,2004,1,4,2,0,7,1,6,14
PAOK Salonik,2004,2,2,3,1,11,6,5,9
P'thinaikos,2004,3,1,2,3,6,11,-5,5
Panionios,2004,4,1,1,4,4,10,-6,4
AEK Athens,2005,1,4,2,0,7,1,6,14
PAOK Salonik,2005,2,3,2,1,13,6,7,11
Panionios,2005,3,1,1,4,4,10,-6,4
P'thinaikos,2005,4,1,1,4,6,13,-7,4
AEK Athens,2006,1,4,2,0,7,1,6,14
PAOK Salonik,2006,2,2,3,1,10,5,5,9
P'thinaikos,2006,3,1,2,3,5,10,-5,5
Panionios,2006,4,1,1,4,4,10,-6,4
AEK Athens,2007,1,4,2,0,7,1,6,14
PAOK Salonik,2007,2,2,2,2,9,5,4,8
P'thinaikos,2007,3,2,1,3,5,9,-4,7
Panionios,2007,4,1,1,4,4,10,-6,4
AEK Athens,2008,1,4,2,0,7,1,6,14
PAOK Salonik,2008,2,2,2,2,9,6,3,8
P'thinaikos,2008,3,2,1,3,6,9,-3,7
Panionios,2008,4,1,1,4,4,10,-6,4
AEK Athens,2009,1,4,2,0,7,1,6,14
PAOK Salonik,2009,2,3,2,1,13,5,8,11
Panionios,2009,3,1,1,4,4,10,-6,4
P'thinaikos,2009,4,1,1,4,5,13,-8,4
AEK Athens,2010,1,4,2,0,7,1,6,14
PAOK Salonik,2010,2,3,2,1,13,6,7,11
Panionios,2010,3,1,1,4,4,10,-6,4
P'thinaikos,2010,4,1,1,4,6,13,-7,4
AEK Athens,2011,1,4,2,0,7,1,6,14
PAOK Salonik,2011,2,2,2,2,10,6,4,8
P'thinaikos,2011,3,2,1,3,6,10,-4,7
Panionios,2011,4,1,1,4,4,10,-6,4
AEK Athens,2012,1,4,2,0,7,1,6,14
PAOK Salonik,2012,2,2,2,2,9,5,4,8
P'thinaikos,2012,3,2,1,3,5,9,-4,7
Panionios,2012,4,1,1,4,4,10,-6,4
AEK Athens,2013,1,4,2,0,7,1,6,14
PAOK Salonik,2013,2,3,2,1,10,4,6,11
P'thinaikos,2013,3,1,1,4,4,10,-6,4
Panionios,2013,3,1,1,4,4,10,-6,4
AEK Athens,2014,1,4,2,0,7,1,6,14
PAOK Salonik,2014,2,2,2,2,10,7,3,8
P'thinaikos,2014,3,2,1,3,7,10,-3,7
Panionios,2014,4,1,1,4,4,10,-6,4
AEK Athens,2015,1,4,2,0,7,1,6,14
PAOK Salonik,2015,2,2,2,2,9,6,3,8
P'thinaikos,2015,3,2,1,3,6,9,-3,7
Panionios,2015,4,1,1,4,4,10,-6,4
AEK Athens,2016,1,4,2,0,7,1,6,14
PAOK Salonik,2016,2,2,2,2,9,5,4,8
P'thinaikos,2016,3,2,1,3,5,9,-4,7
Panionios,2016,4,1,1,4,4,10,-6,4
AEK Athens,2017,1,4,2,0,7,1,6,14
PAOK Salonik,2017,2,2,3,1,9,4,5,9
P'thinaikos,2017,3,1,2,3,4,9,-5,5
Panionios,2017,4,1,1,4,4,10,-6,4
AEK Athens,2018,1,4,2,0,7,1,6,14
PAOK Salonik,2018,2,2,2,2,9,5,4,8
P'thinaikos,2018,3,2,1,3,5,9,-4,7
Panionios,2018,4,1,1,4,4,10,-6,4
AEK Athens,2019,1,4,2,0,7,1,6,14
PAOK Salonik,2019,2,2,2,2,9,6,3,8
P'thinaikos,2019,3,2,1,3,6,9,-3,7
Panionios,2019,4,1,1,4,4,10,-6,4
AEK Athens,2020,1,4,2,0,7,1,6,14
PAOK Salonik,2020,2,2,2,2,9,5,4,8
P'thinaikos,2020,3,2,1,3,5,9,-4,7
Panionios,2020,4,1,1,4,4,10,-6,4
AEK Athens,2021,1,4,2,0,7,1,6,14
PAOK Salonik,2021,2,3,2,1,11,5,6,11
P'thinaikos,2021,3,1,1,4,5,11,-6,4
Panionios,2021,4,1,1,4,4,10,-6,4
AEK Athens,2022,1,4,2,0,7,1,6,14
PAOK Salonik,2022,2,2,3,1,10,5,5,9
P'thinaikos,2022,3,1,2,3,5,10,-5,5
Panionios,2022,4,1,1,4,4,10,-6,4
AEK Athens,2023,1,4,2,0,7,1,6,14
PAOK Salonik,2023,2,2,3,1,10,5,5,9
P'thinaikos,2023,3,1,2,3,5,10,-5,5
Panionios,2023,4,1,1,4,4,10,-6,4
AEK Athens,2024,1,4,2,0,7,1,6,14
PAOK Salonik,2024,2,2,2,2,9,5,4,8
P'thinaikos,2024,3,2,1,3,5,9,-4,7
Panionios,2024,4,1,1,4,4,10,-6,4
AEK Athens,2025,1,4,2,0,7,1,6,14
PAOK Salonik,2025,2,3,2,1,11,5,6,11
P'thinaikos,2025,3,1,1,4,5,11,-6,4
Panionios,2025,4,1,1,4,4,10,-6,4
AEK Athens,2026,1,4,2,0,7,1,6,14
PAOK Salonik,2026,2,3,2,1,11,5,6,11
P'thinaikos,2026,3,1,1,4,5,11,-6,4
Panionios,2026,4,1,1,4,4,10,-6,4
AEK Athens,2027,1,4,2,0,7,1,6,14
PAOK Salonik,2027,2,2,3,1,11,6,5,9
P'thinaikos,2027,3,1,2,3,6,11,-5,5
Panionios,2027,4,1,1,4,4,10,-6,4
AEK Athens,2028,1,4,2,0,7,1,6,14
PAOK Salonik,2028,2,3,2,1,12,6,6,11
P'thinaikos,2028,3,1,1,4,6,12,-6,4
Panionios,2028,4,1,1,4,4,10,-6,4
AEK Athens,2029,1,4,2,0,7,1,6,14
PAOK Salonik,2029,2,2,3,1,10,5,5,9
P'thinaikos,2029,3,1,2,3,5,10,-5,5
Panionios,2029,4,1,1,4,4,10,-6,4
AEK Athens,2030,1,4,2,0,7,1,6,14
PAOK Salonik,2030,2,2,2,2,10,6,4,8
P'thinaikos,2030,3,2,1,3,6,10,-4,7
Panionios,2030,4,1,1,4,4,10,-6,4
AEK Athens,2031,1,4,2,0,7,1,6,14
PAOK Salonik,2031,2,2,3,1,10,5,5,9
P'thinaikos,2031,3,1,2,3,5,10,-5,5
Panionios,2031,4,1,1,4,4,10,-6,4
AEK Athens,2032,1,4,2,0,7,1,6,14
PAOK Salonik,2032,2,2,3,1,10,5,5,9
P'thinaikos,2032,3,1,2,3,5,10,-5,5
Panionios,2032,4,1,1,4,4,10,-6,4
AEK Athens,2033,1,4,2,0,7,1,6,14
PAOK Salonik,2033,2,2,3,1,9,4,5,9
P'thinaikos,2033,3,1,2,3,4,9,-5,5
Panionios,2033,4,1,1,4,4,10,-6,4
AEK Athens,2034,1,4,2,0,7,1,6,14
PAOK Salonik,2034,2,2,3,1,9,4,5,9
P'thinaikos,2034,3,1,2,3,4,9,-5,5
Panionios,2034,4,1,1,4,4,10,-6,4
AEK Athens,2035,1,4,2,0,7,1,6,14
PAOK Salonik,2035,2,2,2,2,9,6,3,8
P'thinaikos,2035,3,2,1,3,6,9,-3,7
Panionios,2035,4,1,1,4,4,10,-6,4
AEK Athens,2036,1,4,2,0,7,1,6,14
PAOK Salonik,2036,2,2,3,1,9,4,5,9
P'thinaikos,2036,3,1,2,3,4,9,-5,5
Panionios,2036,4,1,1,4,4,10,-6,4
AEK Athens,2037,1,4,2,0,7,1,6,14
PAOK Salonik,2037,2,2,3,1,9,4,5,9
P'thinaikos,2037,3,1,2,3,4,9,-5,5
Panionios,2037,4,1,1,4,4,10,-6,4
AEK Athens,2038,1,4,2,0,7,1,6,14
PAOK Salonik,2038,2,3,2,1,14,4,10,11
Panionios,2038,3,1,1,4,4,10,-6,4
P'thinaikos,2038,4,1,1,4,4,14,-10,4
AEK Athens,2039,1,4,2,0,7,1,6,14
PAOK Salonik,2039,2,3,2,1,11,5,6,11
P'thinaikos,2039,3,1,1,4,5,11,-6,4
Panionios,2039,4,1,1,4,4,10,-6,4
AEK Athens,2040,1,4,2,0,7,1,6,14
PAOK Salonik,2040,2,2,2,2,10,6,4,8
P'thinaikos,2040,3,2,1,3,6,10,-4,7
Panionios,2040,4,1,1,4,4,10,-6,4
AEK Athens,2041,1,4,2,0,7,1,6,14
PAOK Salonik,2041,2,2,2,2,10,6,4,8
P'thinaikos,2041,3,2,1,3,6,10,-4,7
Panionios,2041,4,1,1,4,4,10,-6,4
AEK Athens,2042,1,4,2,0,7,1,6,14
PAOK Salonik,2042,2,2,3,1,11,6,5,9
P'thinaikos,2042,3,1,2,3,6,11,-5,5
Panionios,2042,4,1,1,4,4,10,-6,4
AEK Athens,2043,1,4,2,0,7,1,6,14
PAOK Salonik,2043,2,3,2,1,10,4,6,11
P'thinaikos,2043,3,1,1,4,4,10,-6,4
Panionios,2043,3,1,1,4,4,10,-6,4
AEK Athens,2044,1,4,2,0,7,1,6,14
PAOK Salonik,2044,2,2,3,1,10,5,5,9
P'thinaikos,2044,3,1,2,3,5,10,-5,5
Panionios,2044,4,1,1,4,4,10,-6,4
AEK Athens,2045,1,4,2,0,7,1,6,14
PAOK Salonik,2045,2,3,2,1,10,4,6,11
P'thinaikos,2045,3,1,1,4,4,10,-6,4
Panionios,2045,3,1,1,4,4,10,-6,4
AEK Athens,2046,1,4,2,0,7,1,6,14
PAOK Salonik,2046,2,2,3,1,10,5,5,9
P'thinaikos,2046,3,1,2,3,5,10,-5,5
Panionios,2046,4,1,1,4,4,10,-6,4
AEK Athens,2047,1,4,2,0,7,1,6,14
PAOK Salonik,2047,2,2,2,2,9,5,4,8
P'thinaikos,2047,3,2,1,3,5,9,-4,7
Panionios,2047,4,1,1,4,4,10,-6,4
AEK Athens,2048,1,4,2,0,7,1,6,14
PAOK Salonik,2048,2,2,3,1,9,4,5,9
P'thinaikos,2048,3,1,2,3,4,9,-5,5
Panionios,2048,4,1,1,4,4,10,-6,4
AEK Athens,2049,1,4,2,0,7,1,6,14
PAOK Salonik,2049,2,2,3,1,10,5,5,9
P'thinaikos,2049,3,1,2,3,5,10,-5,5
Panionios,2049,4,1,1,4,4,10,-6,4
AEK Athens,2050,1,4,2,0,7,1,6,14
PAOK Salonik,2050,2,3,2,1,11,4,7,11
Panionios,2050,3,1,1,4,4,10,-6,4
P'thinaikos,2050,4,1,1,4,4,11,-7,4
AEK Athens,2051,1,4,2,0,7,1,6,14
PAOK Salonik,2051,2,2,2,2,10,6,4,8
P'thinaikos,2051,3,2,1,3,6,10,-4,7
Panionios,2051,4,1,1,4,4,10,-6,4
AEK Athens,2052,1,4,2,0,7,1,6,14
PAOK Salonik,2052,2,2,2,2,9,5,4,8
P'thinaikos,2052,3,2,1,3,5,9,-4,7
Panionios,2052,4,1,1,4,4,10,-6,4
AEK Athens,2053,1,4,2,0,7,1,6,14
PAOK Salonik,2053,2,2,2,2,9,5,4,8
P'thinaikos,2053,3,2,1,3,5,9,-4,7
Panionios,2053,4,1,1,4,4,10,-6,4
AEK Athens,2054,1,4,2,0,7,1,6,14
PAOK Salonik,2054,2,2,3,1,11,6,5,9
P'thinaikos,2054,3,1,2,3,6,11,-5,5
Panionios,2054,4,1,1,4,4,10,-6,4
AEK Athens,2055,1,4,2,0,7,1,6,14
PAOK Salonik,2055,2,2,2,2,10,6,4,8
P'thinaikos,2055,3,2,1,3,6,10,-4,7
Panionios,2055,4,1,1,4,4,10,-6,4
AEK Athens,2056,1,4,2,0,7,1,6,14
PAOK Salonik,2056,2,2,3,1,10,5,5,9
P'thinaikos,2056,3,1,2,3,5,10,-5,5
Panionios,2056,4,1,1,4,4,10,-6,4
AEK Athens,2057,1,4,2,0,7,1,6,14
PAOK Salonik,2057,2,3,2,1,11,4,7,11
Panionios,2057,3,1,1,4,4,10,-6,4
P'thinaikos,2057,4,1,1,4,4,11,-7,4
AEK Athens,2058,1,4,2,0,7,1,6,14
PAOK Salonik,2058,2,2,3,1,9,4,5,9
P'thinaikos,2058,3,1,2,3,4,9,-5,5
Panionios,2058,4,1,1,4,4,10,-6,4
AEK Athens,2059,1,4,2,0,7,1,6,14
PAOK Salonik,2059,2,2,2,2,11,7,4,8
P'thinaikos,2059,3,2,1,3,7,11,-4,7
Panionios,2059,4,1,1,4,4,10,-6,4
AEK Athens,2060,1,4,2,0,7,1,6,14
PAOK Salonik,2060,2,2,2,2,10,8,2,8
P'thinaikos,2060,3,2,1,3,8,10,-2,7
Panionios,2060,4,1,1,4,4,10,-6,4
AEK Athens,2061,1,4,2,0,7,1,6,14
PAOK Salonik,2061,2,2,3,1,11,6,5,9
P'thinaikos,2061,3,1,2,3,6,11,-5,5
Panionios,2061,4,1,1,4,4,10,-6,4
AEK Athens,2062,1,4,2,0,7,1,6,14
PAOK Salonik,2062,2,2,3,1,12,7,5,9
P'thinaikos,2062,3,1,2,3,7,12,-5,5
Panionios,2062,4,1,1,4,4,10,-6,4
AEK Athens,2063,1,4,2,0,7,1,6,14
PAOK Salonik,2063,2,3,2,1,11,5,6,11
P'thinaikos,2063,3,1,1,4,5,11,-6,4
Panionios,2063,4,1,1,4,4,10,-6,4
AEK Athens,2064,1,4,2,0,7,1,6,14
PAOK Salonik,2064,2,2,3,1,11,6,5,9
P'thinaikos,2064,3,1,2,3,6,11,-5,5
Panionios,2064,4,1,1,4,4,10,-6,4
AEK Athens,2065,1,4,2,0,7,1,6,14
PAOK Salonik,2065,2,3,2,1,13,6,7,11
Panionios,2065,3,1,1,4,4,10,-6,4
P'thinaikos,2065,4,1,1,4,6,13,-7,4
AEK Athens,2066,1,4,2,0,7,1,6,14
PAOK Salonik,2066,2,3,2,1,12,6,6,11
P'thinaikos,2066,3,1,1,4,6,12,-6,4
Panionios,2066,4,1,1,4,4,10,-6,4
AEK Athens,2067,1,4,2,0,7,1,6,14
PAOK Salonik,2067,2,2,3,1,9,4,5,9
P'thinaikos,2067,3,1,2,3,4,9,-5,5
Panionios,2067,4,1,1,4,4,10,-6,4
AEK Athens,2068,1,4,2,0,7,1,6,14
PAOK Salonik,2068,2,3,2,1,12,6,6,11
P'thinaikos,2068,3,1,1,4,6,12,-6,4
Panionios,2068,4,1,1,4,4,10,-6,4
AEK Athens,2069,1,4,2,0,7,1,6,14
PAOK Salonik,2069,2,2,2,2,9,5,4,8
P'thinaikos,2069,3,2,1,3,5,9,-4,7
Panionios,2069,4,1,1,4,4,10,-6,4
AEK Athens,2070,1,4,2,0,7,1,6,14
PAOK Salonik,2070,2,2,3,1,10,5,5,9
P'thinaikos,2070,3,1,2,3,5,10,-5,5
Panionios,2070,4,1,1,4,4,10,-6,4
AEK Athens,2071,1,4,2,0,7,1,6,14
PAOK Salonik,2071,2,2,2,2,9,6,3,8
P'thinaikos,2071,3,2,1,3,6,9,-3,7
Panionios,2071,4,1,1,4,4,10,-6,4
AEK Athens,2072,1,4,2,0,7,1,6,14
PAOK Salonik,2072,2,2,3,1,11,6,5,9
P'thinaikos,2072,3,1,2,3,6,11,-5,5
Panionios,2072,4,1,1,4,4,10,-6,4
AEK Athens,2073,1,4,2,0,7,1,6,14
PAOK Salonik,2073,2,2,3,1,11,6,5,9
P'thinaikos,2073,3,1,2,3,6,11,-5,5
Panionios,2073,4,1,1,4,4,10,-6,4
AEK Athens,2074,1,4,2,0,7,1,6,14
PAOK Salonik,2074,2,2,2,2,10,6,4,8
P'thinaikos,2074,3,2,1,3,6,10,-4,7
Panionios,2074,4,1,1,4,4,10,-6,4
AEK Athens,2075,1,4,2,0,7,1,6,14
PAOK Salonik,2075,2,2,3,1,10,5,5,9
P'thinaikos,2075,3,1,2,3,5,10,-5,5
Panionios,2075,4,1,1,4,4,10,-6,4
AEK Athens,2076,1,4,2,0,7,1,6,14
PAOK Salonik,2076,2,2,2,2,10,9,1,8
P'thinaikos,2076,3,2,1,3,9,10,-1,7
Panionios,2076,4,1,1,4,4,10,-6,4
AEK Athens,2077,1,4,2,0,7,1,6,14
PAOK Salonik,2077,2,2,2,2,11,7,4,8
P'thinaikos,2077,3,2,1,3,7,11,-4,7
Panionios,2077,4,1,1,4,4,10,-6,4
AEK Athens,2078,1,4,2,0,7,1,6,14
PAOK Salonik,2078,2,2,2,2,9,5,4,8
P'thinaikos,2078,3,2,1,3,5,9,-4,7
Panionios,2078,4,1,1,4,4,10,-6,4
AEK Athens,2079,1,4,2,0,7,1,6,14
PAOK Salonik,2079,2,3,2,1,12,5,7,11
Panionios,2079,3,1,1,4,4,10,-6,4
P'thinaikos,2079,4,1,1,4,5,12,-7,4
AEK Athens,2080,1,4,2,0,7,1,6,14
PAOK Salonik,2080,2,3,2,1,10,4,6,11
P'thinaikos,2080,3,1,1,4,4,10,-6,4
Panionios,2080,3,1,1,4,4,10,-6,4
AEK Athens,2081,1,4,2,0,7,1,6,14
PAOK Salonik,2081,2,2,2,2,9,7,2,8
P'thinaikos,2081,3,2,1,3,7,9,-2,7
Panionios,2081,4,1,1,4,4,10,-6,4
AEK Athens,2082,1,4,2,0,7,1,6,14
PAOK Salonik,2082,2,3,2,1,10,4,6,11
P'thinaikos,2082,3,1,1,4,4,10,-6,4
Panionios,2082,3,1,1,4,4,10,-6,4
AEK Athens,2083,1,4,2,0,7,1,6,14
PAOK Salonik,2083,2,3,2,1,12,5,7,11
Panionios,2083,3,1,1,4,4,10,-6,4
P'thinaikos,2083,4,1,1,4,5,12,-7,4
AEK Athens,2084,1,4,2,0,7,1,6,14
PAOK Salonik,2084,2,3,2,1,12,4,8,11
Panionios,2084,3,1,1,4,4,10,-6,4
P'thinaikos,2084,4,1,1,4,4,12,-8,4
AEK Athens,2085,1,4,2,0,7,1,6,14
PAOK Salonik,2085,2,2,2,2,9,6,3,8
P'thinaikos,2085,3,2,1,3,6,9,-3,7
Panionios,2085,4,1,1,4,4,10,-6,4
AEK Athens,2086,1,4,2,0,7,1,6,14
PAOK Salonik,2086,2,2,3,1,9,4,5,9
P'thinaikos,2086,3,1,2,3,4,9,-5,5
Panionios,2086,4,1,1,4,4,10,-6,4
AEK Athens,2087,1,4,2,0,7,1,6,14
PAOK Salonik,2087,2,2,3,1,11,6,5,9
P'thinaikos,2087,3,1,2,3,6,11,-5,5
Panionios,2087,4,1,1,4,4,10,-6,4
AEK Athens,2088,1,4,2,0,7,1,6,14
PAOK Salonik,2088,2,2,3,1,11,6,5,9
P'thinaikos,2088,3,1,2,3,6,11,-5,5
Panionios,2088,4,1,1,4,4,10,-6,4
AEK Athens,2089,1,4,2,0,7,1,6,14
PAOK Salonik,2089,2,2,2,2,10,6,4,8
P'thinaikos,2089,3,2,1,3,6,10,-4,7
Panionios,2089,4,1,1,4,4,10,-6,4
AEK Athens,2090,1,4,2,0,7,1,6,14
PAOK Salonik,2090,2,3,2,1,11,5,6,11
P'thinaikos,2090,3,1,1,4,5,11,-6,4
Panionios,2090,4,1,1,4,4,10,-6,4
AEK Athens,2091,1,4,2,0,7,1,6,14
PAOK Salonik,2091,2,2,3,1,10,5,5,9
P'thinaikos,2091,3,1,2,3,5,10,-5,5
Panionios,2091,4,1,1,4,4,10,-6,4
AEK Athens,2092,1,4,2,0,7,1,6,14
PAOK Salonik,2092,2,2,2,2,10,6,4,8
P'thinaikos,2092,3,2,1,3,6,10,-4,7
Panionios,2092,4,1,1,4,4,10,-6,4
AEK Athens,2093,1,4,2,0,7,1,6,14
PAOK Salonik,2093,2,3,2,1,10,4,6,11
P'thinaikos,2093,3,1,1,4,4,10,-6,4
Panionios,2093,3,1,1,4,4,10,-6,4
AEK Athens,2094,1,4,2,0,7,1,6,14
PAOK Salonik,2094,2,2,3,1,11,6,5,9
P'thinaikos,2094,3,1,2,3,6,11,-5,5
Panionios,2094,4,1,1,4,4,10,-6,4
AEK Athens,2095,1,4,2,0,7,1,6,14
PAOK Salonik,2095,2,3,2,1,11,4,7,11
Panionios,2095,3,1,1,4,4,10,-6,4
P'thinaikos,2095,4,1,1,4,4,11,-7,4
AEK Athens,2096,1,4,2,0,7,1,6,14
PAOK Salonik,2096,2,3,2,1,10,4,6,11
P'thinaikos,2096,3,1,1,4,4,10,-6,4
Panionios,2096,3,1,1,4,4,10,-6,4
AEK Athens,2097,1,4,2,0,7,1,6,14
PAOK Salonik,2097,2,2,3,1,10,5,5,9
P'thinaikos,2097,3,1,2,3,5,10,-5,5
Panionios,2097,4,1,1,4,4,10,-6,4
AEK Athens,2098,1,4,2,0,7,1,6,14
PAOK Salonik,2098,2,2,2,2,9,6,3,8
P'thinaikos,2098,3,2,1,3,6,9,-3,7
Panionios,2098,4,1,1,4,4,10,-6,4
AEK Athens,2099,1,4,2,0,7,1,6,14
PAOK Salonik,2099,2,3,2,1,11,5,6,11
P'thinaikos,2099,3,1,1,4,5,11,-6,4
Panionios,2099,4,1,1,4,4,10,-6,4
AEK Athens,2100,1,4,2,0,7,1,6,14
PAOK Salonik,2100,2,3,2,1,11,5,6,11
P'thinaikos,2100,3,1,1,4,5,11,-6,4
Panionios,2100,4,1,1,4,4,10,-6,4
AEK Athens,2101,1,4,2,0,7,1,6,14
PAOK Salonik,2101,2,2,2,2,10,7,3,8
P'thinaikos,2101,3,2,1,3,7,10,-3,7
Panionios,2101,4,1,1,4,4,10,-6,4
AEK Athens,2102,1,4,2,0,7,1,6,14
PAOK Salonik,2102,2,3,2,1,10,4,6,11
P'thinaikos,2102,3,1,1,4,4,10,-6,4
Panionios,2102,3,1,1,4,4,10,-6,4
AEK Athens,2103,1,4,2,0,7,1,6,14
PAOK Salonik,2103,2,3,2,1,10,4,6,11
P'thinaikos,2103,3,1,1,4,4,10,-6,4
Panionios,2103,3,1,1,4,4,10,-6,4
AEK Athens,2104,1,4,2,0,7,1,6,14
PAOK Salonik,2104,2,2,2,2,9,5,4,8
P'thinaikos,2104,3,2,1,3,5,9,-4,7
Panionios,2104,4,1,1,4,4,10,-6,4
AEK Athens,2105,1,4,2,0,7,1,6,14
PAOK Salonik,2105,2,2,3,1,10,5,5,9
P'thinaikos,2105,3,1,2,3,5,10,-5,5
Panionios,2105,4,1,1,4,4,10,-6,4
AEK Athens,2106,1,4,2,0,7,1,6,14
PAOK Salonik,2106,2,2,3,1,9,4,5,9
P'thinaikos,2106,3,1,2,3,4,9,-5,5
Panionios,2106,4,1,1,4,4,10,-6,4
AEK Athens,2107,1,4,2,0,7,1,6,14
PAOK Salonik,2107,2,2,3,1,9,4,5,9
P'thinaikos,2107,3,1,2,3,4,9,-5,5
Panionios,2107,4,1,1,4,4,10,-6,4
AEK Athens,2108,1,4,2,0,7,1,6,14
PAOK Salonik,2108,2,2,3,1,11,6,5,9
P'thinaikos,2108,3,1,2,3,6,11,-5,5
Panionios,2108,4,1,1,4,4,10,-6,4
AEK Athens,2109,1,4,2,0,7,1,6,14
PAOK Salonik,2109,2,2,2,2,10,7,3,8
P'thinaikos,2109,3,2,1,3,7,10,-3,7
Panionios,2109,4,1,1,4,4,10,-6,4
AEK Athens,2110,1,4,2,0,7,1,6,14
PAOK Salonik,2110,2,2,2,2,9,5,4,8
P'thinaikos,2110,3,2,1,3,5,9,-4,7
Panionios,2110,4,1,1,4,4,10,-6,4
AEK Athens,2111,1,4,2,0,7,1,6,14
PAOK Salonik,2111,2,2,2,2,10,7,3,8
P'thinaikos,2111,3,2,1,3,7,10,-3,7
Panionios,2111,4,1,1,4,4,10,-6,4
AEK Athens,2112,1,4,2,0,7,1,6,14
PAOK Salonik,2112,2,3,2,1,12,6,6,11
P'thinaikos,2112,3,1,1,4,6,12,-6,4
Panionios,2112,4,1,1,4,4,10,-6,4
AEK Athens,2113,1,4,2,0,7,1,6,14
PAOK Salonik,2113,2,3,2,1,12,5,7,11
Panionios,2113,3,1,1,4,4,10,-6,4
P'thinaikos,2113,4,1,1,4,5,12,-7,4
AEK Athens,2114,1,4,2,0,7,1,6,14
PAOK Salonik,2114,2,2,2,2,9,7,2,8
P'thinaikos,2114,3,2,1,3,7,9,-2,7
Panionios,2114,4,1,1,4,4,10,-6,4
AEK Athens,2115,1,4,2,0,7,1,6,14
PAOK Salonik,2115,2,2,3,1,9,4,5,9
P'thinaikos,2115,3,1,2,3,4,9,-5,5
Panionios,2115,4,1,1,4,4,10,-6,4
AEK Athens,2116,1,4,2,0,7,1,6,14
PAOK Salonik,2116,2,3,2,1,10,4,6,11
P'thinaikos,2116,3,1,1,4,4,10,-6,4
Panionios,2116,3,1,1,4,4,10,-6,4
AEK Athens,2117,1,4,2,0,7,1,6,14
PAOK Salonik,2117,2,2,2,2,9,6,3,8
P'thinaikos,2117,3,2,1,3,6,9,-3,7
Panionios,2117,4,1,1,4,4,10,-6,4
AEK Athens,2118,1,4,2,0,7,1,6,14
PAOK Salonik,2118,2,3,2,1,10,4,6,11
P'thinaikos,2118,3,1,1,4,4,10,-6,4
Panionios,2118,3,1,1,4,4,10,-6,4
AEK Athens,2119,1,4,2,0,7,1,6,14
PAOK Salonik,2119,2,3,2,1,12,6,6,11
P'thinaikos,2119,3,1,1,4,6,12,-6,4
Panionios,2119,4,1,1,4,4,10,-6,4
AEK Athens,2120,1,4,2,0,7,1,6,14
PAOK Salonik,2120,2,3,2,1,11,4,7,11
Panionios,2120,3,1,1,4,4,10,-6,4
P'thinaikos,2120,4,1,1,4,4,11,-7,4
AEK Athens,2121,1,4,2,0,7,1,6,14
PAOK Salonik,2121,2,3,2,1,11,4,7,11
Panionios,2121,3,1,1,4,4,10,-6,4
P'thinaikos,2121,4,1,1,4,4,11,-7,4
AEK Athens,2122,1,4,2,0,7,1,6,14
PAOK Salonik,2122,2,2,3,1,10,5,5,9
P'thinaikos,2122,3,1,2,3,5,10,-5,5
Panionios,2122,4,1,1,4,4,10,-6,4
AEK Athens,2123,1,4,2,0,7,1,6,14
PAOK Salonik,2123,2,2,2,2,9,5,4,8
P'thinaikos,2123,3,2,1,3,5,9,-4,7
Panionios,2123,4,1,1,4,4,10,-6,4
AEK Athens,2124,1,4,2,0,7,1,6,14
PAOK Salonik,2124,2,2,2,2,9,5,4,8
P'thinaikos,2124,3,2,1,3,5,9,-4,7
Panionios,2124,4,1,1,4,4,10,-6,4
AEK Athens,2125,1,4,2,0,7,1,6,14
PAOK Salonik,2125,2,3,2,1,11,4,7,11
Panionios,2125,3,1,1,4,4,10,-6,4
P'thinaikos,2125,4,1,1,4,4,11,-7,4
AEK Athens,2126,1,4,2,0,7,1,6,14
PAOK Salonik,2126,2,2,3,1,10,5,5,9
P'thinaikos,2126,3,1,2,3,5,10,-5,5
Panionios,2126,4,1,1,4,4,10,-6,4
AEK Athens,2127,1,4,2,0,7,1,6,14
PAOK Salonik,2127,2,2,2,2,12,8,4,8
P'thinaikos,2127,3,2,1,3,8,12,-4,7
Panionios,2127,4,1,1,4,4,10,-6,4
AEK Athens,2128,1,4,2,0,7,1,6,14
PAOK Salonik,2128,2,3,2,1,11,4,7,11
Panionios,2128,3,1,1,4,4,10,-6,4
P'thinaikos,2128,4,1,1,4,4,11,-7,4
AEK Athens,2129,1,4,2,0,7,1,6,14
PAOK Salonik,2129,2,3,2,1,11,5,6,11
P'thinaikos,2129,3,1,1,4,5,11,-6,4
Panionios,2129,4,1,1,4,4,10,-6,4
AEK Athens,2130,1,4,2,0,7,1,6,14
PAOK Salonik,2130,2,3,2,1,11,4,7,11
Panionios,2130,3,1,1,4,4,10,-6,4
P'thinaikos,2130,4,1,1,4,4,11,-7,4
AEK Athens,2131,1,4,2,0,7,1,6,14
PAOK Salonik,2131,2,2,2,2,9,6,3,8
P'thinaikos,2131,3,2,1,3,6,9,-3,7
Panionios,2131,4,1,1,4,4,10,-6,4
AEK Athens,2132,1,4,2,0,7,1,6,14
PAOK Salonik,2132,2,2,3,1,10,5,5,9
P'thinaikos,2132,3,1,2,3,5,10,-5,5
Panionios,2132,4,1,1,4,4,10,-6,4
AEK Athens,2133,1,4,2,0,7,1,6,14
PAOK Salonik,2133,2,2,2,2,9,5,4,8
P'thinaikos,2133,3,2,1,3,5,9,-4,7
Panionios,2133,4,1,1,4,4,10,-6,4
AEK Athens,2134,1,4,2,0,7,1,6,14
PAOK Salonik,2134,2,2,3,1,11,6,5,9
P'thinaikos,2134,3,1,2,3,6,11,-5,5
Panionios,2134,4,1,1,4,4,10,-6,4
AEK Athens,2135,1,4,2,0,7,1,6,14
PAOK Salonik,2135,2,2,2,2,10,6,4,8
P'thinaikos,2135,3,2,1,3,6,10,-4,7
Panionios,2135,4,1,1,4,4,10,-6,4
AEK Athens,2136,1,4,2,0,7,1,6,14
PAOK Salonik,2136,2,2,3,1,10,5,5,9
P'thinaikos,2136,3,1,2,3,5,10,-5,5
Panionios,2136,4,1,1,4,4,10,-6,4
AEK Athens,2137,1,4,2,0,7,1,6,14
PAOK Salonik,2137,2,2,2,2,9,5,4,8
P'thinaikos,2137,3,2,1,3,5,9,-4,7
Panionios,2137,4,1,1,4,4,10,-6,4
AEK Athens,2138,1,4,2,0,7,1,6,14
PAOK Salonik,2138,2,3,2,1,10,4,6,11
P'thinaikos,2138,3,1,1,4,4,10,-6,4
Panionios,2138,3,1,1,4,4,10,-6,4
AEK Athens,2139,1,4,2,0,7,1,6,14
PAOK Salonik,2139,2,2,2,2,9,5,4,8
P'thinaikos,2139,3,2,1,3,5,9,-4,7
Panionios,2139,4,1,1,4,4,10,-6,4
AEK Athens,2140,1,4,2,0,7,1,6,14
PAOK Salonik,2140,2,2,2,2,10,7,3,8
P'thinaikos,2140,3,2,1,3,7,10,-3,7
Panionios,2140,4,1,1,4,4,10,-6,4
AEK Athens,2141,1,4,2,0,7,1,6,14
PAOK Salonik,2141,2,2,3,1,11,6,5,9
P'thinaikos,2141,3,1,2,3,6,11,-5,5
Panionios,2141,4,1,1,4,4,10,-6,4
AEK Athens,2142,1,4,2,0,7,1,6,14
PAOK Salonik,2142,2,2,2,2,10,6,4,8
P'thinaikos,2142,3,2,1,3,6,10,-4,7
Panionios,2142,4,1,1,4,4,10,-6,4
AEK Athens,2143,1,4,2,0,7,1,6,14
PAOK Salonik,2143,2,2,3,1,10,5,5,9
P'thinaikos,2143,3,1,2,3,5,10,-5,5
Panionios,2143,4,1,1,4,4,10,-6,4
AEK Athens,2144,1,4,2,0,7,1,6,14
PAOK Salonik,2144,2,3,2,1,12,5,7,11
Panionios,2144,3,1,1,4,4,10,-6,4
P'thinaikos,2144,4,1,1,4,5,12,-7,4
AEK Athens,2145,1,4,2,0,7,1,6,14
PAOK Salonik,2145,2,3,2,1,11,5,6,11
P'thinaikos,2145,3,1,1,4,5,11,-6,4
Panionios,2145,4,1,1,4,4,10,-6,4
AEK Athens,2146,1,4,2,0,7,1,6,14
PAOK Salonik,2146,2,3,2,1,10,4,6,11
P'thinaikos,2146,3,1,1,4,4,10,-6,4
Panionios,2146,3,1,1,4,4,10,-6,4
AEK Athens,2147,1,4,2,0,7,1,6,14
PAOK Salonik,2147,2,3,2,1,12,5,7,11
Panionios,2147,3,1,1,4,4,10,-6,4
P'thinaikos,2147,4,1,1,4,5,12,-7,4
AEK Athens,2148,1,4,2,0,7,1,6,14
PAOK Salonik,2148,2,2,2,2,9,5,4,8
P'thinaikos,2148,3,2,1,3,5,9,-4,7
Panionios,2148,4,1,1,4,4,10,-6,4
AEK Athens,2149,1,4,2,0,7,1,6,14
PAOK Salonik,2149,2,2,3,1,11,6,5,9
P'thinaikos,2149,3,1,2,3,6,11,-5,5
Panionios,2149,4,1,1,4,4,10,-6,4
AEK Athens,2150,1,4,2,0,7,1,6,14
PAOK Salonik,2150,2,2,2,2,10,6,4,8
P'thinaikos,2150,3,2,1,3,6,10,-4,7
Panionios,2150,4,1,1,4,4,10,-6,4
AEK Athens,2151,1,4,2,0,7,1,6,14
PAOK Salonik,2151,2,2,2,2,10,6,4,8
P'thinaikos,2151,3,2,1,3,6,10,-4,7
Panionios,2151,4,1,1,4,4,10,-6,4
AEK Athens,2152,1,4,2,0,7,1,6,14
PAOK Salonik,2152,2,2,3,1,9,4,5,9
P'thinaikos,2152,3,1,2,3,4,9,-5,5
Panionios,2152,4,1,1,4,4,10,-6,4
AEK Athens,2153,1,4,2,0,7,1,6,14
PAOK Salonik,2153,2,2,2,2,9,5,4,8
P'thinaikos,2153,3,2,1,3,5,9,-4,7
Panionios,2153,4,1,1,4,4,10,-6,4
AEK Athens,2154,1,4,2,0,7,1,6,14
PAOK Salonik,2154,2,2,3,1,11,6,5,9
P'thinaikos,2154,3,1,2,3,6,11,-5,5
Panionios,2154,4,1,1,4,4,10,-6,4
AEK Athens,2155,1,4,2,0,7,1,6,14
PAOK Salonik,2155,2,2,3,1,9,4,5,9
P'thinaikos,2155,3,1,2,3,4,9,-5,5
Panionios,2155,4,1,1,4,4,10,-6,4
AEK Athens,2156,1,4,2,0,7,1,6,14
PAOK Salonik,2156,2,3,2,1,12,6,6,11
P'thinaikos,2156,3,1,1,4,6,12,-6,4
Panionios,2156,4,1,1,4,4,10,-6,4
AEK Athens,2157,1,4,2,0,7,1,6,14
PAOK Salonik,2157,2,2,3,1,9,4,5,9
P'thinaikos,2157,3,1,2,3,4,9,-5,5
Panionios,2157,4,1,1,4,4,10,-6,4
AEK Athens,2158,1,4,2,0,7,1,6,14
PAOK Salonik,2158,2,3,2,1,12,4,8,11
Panionios,2158,3,1,1,4,4,10,-6,4
P'thinaikos,2158,4,1,1,4,4,12,-8,4
AEK Athens,2159,1,4,2,0,7,1,6,14
PAOK Salonik,2159,2,2,3,1,10,5,5,9
P'thinaikos,2159,3,1,2,3,5,10,-5,5
Panionios,2159,4,1,1,4,4,10,-6,4
AEK Athens,2160,1,4,2,0,7,1,6,14
PAOK Salonik,2160,2,2,3,1,10,5,5,9
P'thinaikos,2160,3,1,2,3,5,10,-5,5
Panionios,2160,4,1,1,4,4,10,-6,4
AEK Athens,2161,1,4,2,0,7,1,6,14
PAOK Salonik,2161,2,3,2,1,11,4,7,11
Panionios,2161,3,1,1,4,4,10,-6,4
P'thinaikos,2161,4,1,1,4,4,11,-7,4
AEK Athens,2162,1,4,2,0,7,1,6,14
PAOK Salonik,2162,2,2,2,2,9,5,4,8
P'thinaikos,2162,3,2,1,3,5,9,-4,7
Panionios,2162,4,1,1,4,4,10,-6,4
AEK Athens,2163,1,4,2,0,7,1,6,14
PAOK Salonik,2163,2,2,2,2,9,6,3,8
P'thinaikos,2163,3,2,1,3,6,9,-3,7
Panionios,2163,4,1,1,4,4,10,-6,4
AEK Athens,2164,1,4,2,0,7,1,6,14
PAOK Salonik,2164,2,3,2,1,12,4,8,11
Panionios,2164,3,1,1,4,4,10,-6,4
P'thinaikos,2164,4,1,1,4,4,12,-8,4
AEK Athens,2165,1,4,2,0,7,1,6,14
PAOK Salonik,2165,2,2,2,2,10,7,3,8
P'thinaikos,2165,3,2,1,3,7,10,-3,7
Panionios,2165,4,1,1,4,4,10,-6,4
AEK Athens,2166,1,4,2,0,7,1,6,14
PAOK Salonik,2166,2,2,2,2,10,8,2,8
P'thinaikos,2166,3,2,1,3,8,10,-2,7
Panionios,2166,4,1,1,4,4,10,-6,4
AEK Athens,2167,1,4,2,0,7,1,6,14
PAOK Salonik,2167,2,2,2,2,9,5,4,8
P'thinaikos,2167,3,2,1,3,5,9,-4,7
Panionios,2167,4,1,1,4,4,10,-6,4
AEK Athens,2168,1,4,2,0,7,1,6,14
PAOK Salonik,2168,2,3,2,1,12,4,8,11
Panionios,2168,3,1,1,4,4,10,-6,4
P'thinaikos,2168,4,1,1,4,4,12,-8,4
AEK Athens,2169,1,4,2,0,7,1,6,14
PAOK Salonik,2169,2,2,2,2,10,6,4,8
P'thinaikos,2169,3,2,1,3,6,10,-4,7
Panionios,2169,4,1,1,4,4,10,-6,4
AEK Athens,2170,1,4,2,0,7,1,6,14
PAOK Salonik,2170,2,2,3,1,9,4,5,9
P'thinaikos,2170,3,1,2,3,4,9,-5,5
Panionios,2170,4,1,1,4,4,10,-6,4
AEK Athens,2171,1,4,2,0,7,1,6,14
PAOK Salonik,2171,2,2,2,2,9,6,3,8
P'thinaikos,2171,3,2,1,3,6,9,-3,7
Panionios,2171,4,1,1,4,4,10,-6,4
AEK Athens,2172,1,4,2,0,7,1,6,14
PAOK Salonik,2172,2,2,2,2,10,7,3,8
P'thinaikos,2172,3,2,1,3,7,10,-3,7
Panionios,2172,4,1,1,4,4,10,-6,4
AEK Athens,2173,1,4,2,0,7,1,6,14
PAOK Salonik,2173,2,2,3,1,10,5,5,9
P'thinaikos,2173,3,1,2,3,5,10,-5,5
Panionios,2173,4,1,1,4,4,10,-6,4
AEK Athens,2174,1,4,2,0,7,1,6,14
PAOK Salonik,2174,2,3,2,1,13,6,7,11
Panionios,2174,3,1,1,4,4,10,-6,4
P'thinaikos,2174,4,1,1,4,6,13,-7,4
AEK Athens,2175,1,4,2,0,7,1,6,14
PAOK Salonik,2175,2,2,3,1,12,7,5,9
P'thinaikos,2175,3,1,2,3,7,12,-5,5
Panionios,2175,4,1,1,4,4,10,-6,4
AEK Athens,2176,1,4,2,0,7,1,6,14
PAOK Salonik,2176,2,3,2,1,11,5,6,11
P'thinaikos,2176,3,1,1,4,5,11,-6,4
Panionios,2176,4,1,1,4,4,10,-6,4
AEK Athens,2177,1,4,2,0,7,1,6,14
PAOK Salonik,2177,2,2,2,2,9,7,2,8
P'thinaikos,2177,3,2,1,3,7,9,-2,7
Panionios,2177,4,1,1,4,4,10,-6,4
AEK Athens,2178,1,4,2,0,7,1,6,14
PAOK Salonik,2178,2,2,3,1,10,5,5,9
P'thinaikos,2178,3,1,2,3,5,10,-5,5
Panionios,2178,4,1,1,4,4,10,-6,4
AEK Athens,2179,1,4,2,0,7,1,6,14
PAOK Salonik,2179,2,2,2,2,9,5,4,8
P'thinaikos,2179,3,2,1,3,5,9,-4,7
Panionios,2179,4,1,1,4,4,10,-6,4
AEK Athens,2180,1,4,2,0,7,1,6,14
PAOK Salonik,2180,2,2,3,1,12,7,5,9
P'thinaikos,2180,3,1,2,3,7,12,-5,5
Panionios,2180,4,1,1,4,4,10,-6,4
AEK Athens,2181,1,4,2,0,7,1,6,14
PAOK Salonik,2181,2,2,3,1,10,5,5,9
P'thinaikos,2181,3,1,2,3,5,10,-5,5
Panionios,2181,4,1,1,4,4,10,-6,4
AEK Athens,2182,1,4,2,0,7,1,6,14
PAOK Salonik,2182,2,3,2,1,10,4,6,11
P'thinaikos,2182,3,1,1,4,4,10,-6,4
Panionios,2182,3,1,1,4,4,10,-6,4
AEK Athens,2183,1,4,2,0,7,1,6,14
PAOK Salonik,2183,2,2,2,2,10,6,4,8
P'thinaikos,2183,3,2,1,3,6,10,-4,7
Panionios,2183,4,1,1,4,4,10,-6,4
AEK Athens,2184,1,4,2,0,7,1,6,14
PAOK Salonik,2184,2,2,2,2,9,7,2,8
P'thinaikos,2184,3,2,1,3,7,9,-2,7
Panionios,2184,4,1,1,4,4,10,-6,4
AEK Athens,2185,1,4,2,0,7,1,6,14
PAOK Salonik,2185,2,2,2,2,10,6,4,8
P'thinaikos,2185,3,2,1,3,6,10,-4,7
Panionios,2185,4,1,1,4,4,10,-6,4
AEK Athens,2186,1,4,2,0,7,1,6,14
PAOK Salonik,2186,2,3,2,1,11,5,6,11
P'thinaikos,2186,3,1,1,4,5,11,-6,4
Panionios,2186,4,1,1,4,4,10,-6,4
AEK Athens,2187,1,4,2,0,7,1,6,14
PAOK Salonik,2187,2,2,3,1,11,6,5,9
P'thinaikos,2187,3,1,2,3,6,11,-5,5
Panionios,2187,4,1,1,4,4,10,-6,4
AEK Athens,2188,1,4,2,0,7,1,6,14
PAOK Salonik,2188,2,2,3,1,9,4,5,9
P'thinaikos,2188,3,1,2,3,4,9,-5,5
Panionios,2188,4,1,1,4,4,10,-6,4
AEK Athens,2189,1,4,2,0,7,1,6,14
PAOK Salonik,2189,2,2,2,2,9,7,2,8
P'thinaikos,2189,3,2,1,3,7,9,-2,7
Panionios,2189,4,1,1,4,4,10,-6,4
AEK Athens,2190,1,4,2,0,7,1,6,14
PAOK Salonik,2190,2,2,3,1,9,4,5,9
P'thinaikos,2190,3,1,2,3,4,9,-5,5
Panionios,2190,4,1,1,4,4,10,-6,4
AEK Athens,2191,1,4,2,0,7,1,6,14
PAOK Salonik,2191,2,3,2,1,11,5,6,11
P'thinaikos,2191,3,1,1,4,5,11,-6,4
Panionios,2191,4,1,1,4,4,10,-6,4
AEK Athens,2192,1,4,2,0,7,1,6,14
PAOK Salonik,2192,2,2,2,2,9,5,4,8
P'thinaikos,2192,3,2,1,3,5,9,-4,7
Panionios,2192,4,1,1,4,4,10,-6,4
AEK Athens,2193,1,4,2,0,7,1,6,14
PAOK Salonik,2193,2,2,3,1,11,6,5,9
P'thinaikos,2193,3,1,2,3,6,11,-5,5
Panionios,2193,4,1,1,4,4,10,-6,4
AEK Athens,2194,1,4,2,0,7,1,6,14
PAOK Salonik,2194,2,3,2,1,10,4,6,11
P'thinaikos,2194,3,1,1,4,4,10,-6,4
Panionios,2194,3,1,1,4,4,10,-6,4
AEK Athens,2195,1,4,2,0,7,1,6,14
PAOK Salonik,2195,2,2,2,2,9,6,3,8
P'thinaikos,2195,3,2,1,3,6,9,-3,7
Panionios,2195,4,1,1,4,4,10,-6,4
AEK Athens,2196,1,4,2,0,7,1,6,14
PAOK Salonik,2196,2,3,2,1,11,5,6,11
P'thinaikos,2196,3,1,1,4,5,11,-6,4
Panionios,2196,4,1,1,4,4,10,-6,4
AEK Athens,2197,1,4,2,0,7,1,6,14
PAOK Salonik,2197,2,3,2,1,11,4,7,11
Panionios,2197,3,1,1,4,4,10,-6,4
P'thinaikos,2197,4,1,1,4,4,11,-7,4
AEK Athens,2198,1,4,2,0,7,1,6,14
PAOK Salonik,2198,2,2,2,2,12,8,4,8
P'thinaikos,2198,3,2,1,3,8,12,-4,7
Panionios,2198,4,1,1,4,4,10,-6,4
AEK Athens,2199,1,4,2,0,7,1,6,14
PAOK Salonik,2199,2,2,3,1,9,4,5,9
P'thinaikos,2199,3,1,2,3,4,9,-5,5
Panionios,2199,4,1,1,4,4,10,-6,4
AEK Athens,2200,1,4,2,0,7,1,6,14
PAOK Salonik,2200,2,2,3,1,10,5,5,9
P'thinaikos,2200,3,1,2,3,5,10,-5,5
Panionios,2200,4,1,1,4,4,10,-6,4
AEK Athens,2201,1,4,2,0,7,1,6,14
PAOK Salonik,2201,2,2,2,2,10,7,3,8
P'thinaikos,2201,3,2,1,3,7,10,-3,7
Panionios,2201,4,1,1,4,4,10,-6,4
AEK Athens,2202,1,4,2,0,7,1,6,14
PAOK Salonik,2202,2,2,2,2,10,6,4,8
P'thinaikos,2202,3,2,1,3,6,10,-4,7
Panionios,2202,4,1,1,4,4,10,-6,4
AEK Athens,2203,1,4,2,0,7,1,6,14
PAOK Salonik,2203,2,3,2,1,12,5,7,11
Panionios,2203,3,1,1,4,4,10,-6,4
P'thinaikos,2203,4,1,1,4,5,12,-7,4
AEK Athens,2204,1,4,2,0,7,1,6,14
PAOK Salonik,2204,2,2,2,2,9,5,4,8
P'thinaikos,2204,3,2,1,3,5,9,-4,7
Panionios,2204,4,1,1,4,4,10,-6,4
AEK Athens,2205,1,4,2,0,7,1,6,14
PAOK Salonik,2205,2,2,3,1,9,4,5,9
P'thinaikos,2205,3,1,2,3,4,9,-5,5
Panionios,2205,4,1,1,4,4,10,-6,4
AEK Athens,2206,1,4,2,0,7,1,6,14
PAOK Salonik,2206,2,2,3,1,11,6,5,9
P'thinaikos,2206,3,1,2,3,6,11,-5,5
Panionios,2206,4,1,1,4,4,10,-6,4
AEK Athens,2207,1,4,2,0,7,1,6,14
PAOK Salonik,2207,2,2,2,2,9,5,4,8
P'thinaikos,2207,3,2,1,3,5,9,-4,7
Panionios,2207,4,1,1,4,4,10,-6,4
AEK Athens,2208,1,4,2,0,7,1,6,14
PAOK Salonik,2208,2,2,2,2,10,6,4,8
P'thinaikos,2208,3,2,1,3,6,10,-4,7
Panionios,2208,4,1,1,4,4,10,-6,4
AEK Athens,2209,1,4,2,0,7,1,6,14
PAOK Salonik,2209,2,2,3,1,10,5,5,9
P'thinaikos,2209,3,1,2,3,5,10,-5,5
Panionios,2209,4,1,1,4,4,10,-6,4
AEK Athens,2210,1,4,2,0,7,1,6,14
PAOK Salonik,2210,2,2,2,2,10,7,3,8
P'thinaikos,2210,3,2,1,3,7,10,-3,7
Panionios,2210,4,1,1,4,4,10,-6,4
AEK Athens,2211,1,4,2,0,7,1,6,14
PAOK Salonik,2211,2,2,2,2,10,6,4,8
P'thinaikos,2211,3,2,1,3,6,10,-4,7
Panionios,2211,4,1,1,4,4,10,-6,4
AEK Athens,2212,1,4,2,0,7,1,6,14
PAOK Salonik,2212,2,2,3,1,10,5,5,9
P'thinaikos,2212,3,1,2,3,5,10,-5,5
Panionios,2212,4,1,1,4,4,10,-6,4
AEK Athens,2213,1,4,2,0,7,1,6,14
PAOK Salonik,2213,2,2,2,2,10,6,4,8
P'thinaikos,2213,3,2,1,3,6,10,-4,7
Panionios,2213,4,1,1,4,4,10,-6,4
AEK Athens,2214,1,4,2,0,7,1,6,14
PAOK Salonik,2214,2,2,2,2,9,6,3,8
P'thinaikos,2214,3,2,1,3,6,9,-3,7
Panionios,2214,4,1,1,4,4,10,-6,4
AEK Athens,2215,1,4,2,0,7,1,6,14
PAOK Salonik,2215,2,2,2,2,10,6,4,8
P'thinaikos,2215,3,2,1,3,6,10,-4,7
Panionios,2215,4,1,1,4,4,10,-6,4
AEK Athens,2216,1,4,2,0,7,1,6,14
PAOK Salonik,2216,2,2,2,2,9,6,3,8
P'thinaikos,2216,3,2,1,3,6,9,-3,7
Panionios,2216,4,1,1,4,4,10,-6,4
AEK Athens,2217,1,4,2,0,7,1,6,14
PAOK Salonik,2217,2,2,2,2,9,5,4,8
P'thinaikos,2217,3,2,1,3,5,9,-4,7
Panionios,2217,4,1,1,4,4,10,-6,4
AEK Athens,2218,1,4,2,0,7,1,6,14
PAOK Salonik,2218,2,3,2,1,12,4,8,11
Panionios,2218,3,1,1,4,4,10,-6,4
P'thinaikos,2218,4,1,1,4,4,12,-8,4
AEK Athens,2219,1,4,2,0,7,1,6,14
PAOK Salonik,2219,2,3,2,1,11,4,7,11
Panionios,2219,3,1,1,4,4,10,-6,4
P'thinaikos,2219,4,1,1,4,4,11,-7,4
AEK Athens,2220,1,4,2,0,7,1,6,14
PAOK Salonik,2220,2,2,2,2,9,5,4,8
P'thinaikos,2220,3,2,1,3,5,9,-4,7
Panionios,2220,4,1,1,4,4,10,-6,4
AEK Athens,2221,1,4,2,0,7,1,6,14
PAOK Salonik,2221,2,3,2,1,11,5,6,11
P'thinaikos,2221,3,1,1,4,5,11,-6,4
Panionios,2221,4,1,1,4,4,10,-6,4
AEK Athens,2222,1,4,2,0,7,1,6,14
PAOK Salonik,2222,2,3,2,1,12,4,8,11
Panionios,2222,3,1,1,4,4,10,-6,4
P'thinaikos,2222,4,1,1,4,4,12,-8,4
AEK Athens,2223,1,4,2,0,7,1,6,14
PAOK Salonik,2223,2,2,3,1,9,4,5,9
P'thinaikos,2223,3,1,2,3,4,9,-5,5
Panionios,2223,4,1,1,4,4,10,-6,4
AEK Athens,2224,1,4,2,0,7,1,6,14
PAOK Salonik,2224,2,3,2,1,10,4,6,11
P'thinaikos,2224,3,1,1,4,4,10,-6,4
Panionios,2224,3,1,1,4,4,10,-6,4
AEK Athens,2225,1,4,2,0,7,1,6,14
PAOK Salonik,2225,2,3,2,1,10,4,6,11
P'thinaikos,2225,3,1,1,4,4,10,-6,4
Panionios,2225,3,1,1,4,4,10,-6,4
AEK Athens,2226,1,4,2,0,7,1,6,14
PAOK Salonik,2226,2,3,2,1,11,4,7,11
Panionios,2226,3,1,1,4,4,10,-6,4
P'thinaikos,2226,4,1,1,4,4,11,-7,4
AEK Athens,2227,1,4,2,0,7,1,6,14
PAOK Salonik,2227,2,2,3,1,9,4,5,9
P'thinaikos,2227,3,1,2,3,4,9,-5,5
Panionios,2227,4,1,1,4,4,10,-6,4
AEK Athens,2228,1,4,2,0,7,1,6,14
PAOK Salonik,2228,2,3,2,1,12,4,8,11
Panionios,2228,3,1,1,4,4,10,-6,4
P'thinaikos,2228,4,1,1,4,4,12,-8,4
AEK Athens,2229,1,4,2,0,7,1,6,14
PAOK Salonik,2229,2,2,3,1,11,6,5,9
P'thinaikos,2229,3,1,2,3,6,11,-5,5
Panionios,2229,4,1,1,4,4,10,-6,4
AEK Athens,2230,1,4,2,0,7,1,6,14
PAOK Salonik,2230,2,2,2,2,10,7,3,8
P'thinaikos,2230,3,2,1,3,7,10,-3,7
Panionios,2230,4,1,1,4,4,10,-6,4
AEK Athens,2231,1,4,2,0,7,1,6,14
PAOK Salonik,2231,2,2,3,1,10,5,5,9
P'thinaikos,2231,3,1,2,3,5,10,-5,5
Panionios,2231,4,1,1,4,4,10,-6,4
AEK Athens,2232,1,4,2,0,7,1,6,14
PAOK Salonik,2232,2,2,3,1,9,4,5,9
P'thinaikos,2232,3,1,2,3,4,9,-5,5
Panionios,2232,4,1,1,4,4,10,-6,4
AEK Athens,2233,1,4,2,0,7,1,6,14
PAOK Salonik,2233,2,2,3,1,9,4,5,9
P'thinaikos,2233,3,1,2,3,4,9,-5,5
Panionios,2233,4,1,1,4,4,10,-6,4
AEK Athens,2234,1,4,2,0,7,1,6,14
PAOK Salonik,2234,2,3,2,1,11,5,6,11
P'thinaikos,2234,3,1,1,4,5,11,-6,4
Panionios,2234,4,1,1,4,4,10,-6,4
AEK Athens,2235,1,4,2,0,7,1,6,14
PAOK Salonik,2235,2,3,2,1,13,4,9,11
Panionios,2235,3,1,1,4,4,10,-6,4
P'thinaikos,2235,4,1,1,4,4,13,-9,4
AEK Athens,2236,1,4,2,0,7,1,6,14
PAOK Salonik,2236,2,2,3,1,11,6,5,9
P'thinaikos,2236,3,1,2,3,6,11,-5,5
Panionios,2236,4,1,1,4,4,10,-6,4
AEK Athens,2237,1,4,2,0,7,1,6,14
PAOK Salonik,2237,2,3,2,1,12,4,8,11
Panionios,2237,3,1,1,4,4,10,-6,4
P'thinaikos,2237,4,1,1,4,4,12,-8,4
AEK Athens,2238,1,4,2,0,7,1,6,14
PAOK Salonik,2238,2,3,2,1,11,4,7,11
Panionios,2238,3,1,1,4,4,10,-6,4
P'thinaikos,2238,4,1,1,4,4,11,-7,4
AEK Athens,2239,1,4,2,0,7,1,6,14
PAOK Salonik,2239,2,2,2,2,10,6,4,8
P'thinaikos,2239,3,2,1,3,6,10,-4,7
Panionios,2239,4,1,1,4,4,10,-6,4
AEK Athens,2240,1,4,2,0,7,1,6,14
PAOK Salonik,2240,2,3,2,1,12,6,6,11
P'thinaikos,2240,3,1,1,4,6,12,-6,4
Panionios,2240,4,1,1,4,4,10,-6,4
AEK Athens,2241,1,4,2,0,7,1,6,14
PAOK Salonik,2241,2,2,2,2,9,5,4,8
P'thinaikos,2241,3,2,1,3,5,9,-4,7
Panionios,2241,4,1,1,4,4,10,-6,4
AEK Athens,2242,1,4,2,0,7,1,6,14
PAOK Salonik,2242,2,2,3,1,9,4,5,9
P'thinaikos,2242,3,1,2,3,4,9,-5,5
Panionios,2242,4,1,1,4,4,10,-6,4
AEK Athens,2243,1,4,2,0,7,1,6,14
PAOK Salonik,2243,2,3,2,1,10,4,6,11
P'thinaikos,2243,3,1,1,4,4,10,-6,4
Panionios,2243,3,1,1,4,4,10,-6,4
AEK Athens,2244,1,4,2,0,7,1,6,14
PAOK Salonik,2244,2,2,3,1,10,5,5,9
P'thinaikos,2244,3,1,2,3,5,10,-5,5
Panionios,2244,4,1,1,4,4,10,-6,4
AEK Athens,2245,1,4,2,0,7,1,6,14
PAOK Salonik,2245,2,3,2,1,12,5,7,11
Panionios,2245,3,1,1,4,4,10,-6,4
P'thinaikos,2245,4,1,1,4,5,12,-7,4
AEK Athens,2246,1,4,2,0,7,1,6,14
PAOK Salonik,2246,2,2,2,2,9,5,4,8
P'thinaikos,2246,3,2,1,3,5,9,-4,7
Panionios,2246,4,1,1,4,4,10,-6,4
AEK Athens,2247,1,4,2,0,7,1,6,14
PAOK Salonik,2247,2,2,3,1,9,4,5,9
P'thinaikos,2247,3,1,2,3,4,9,-5,5
Panionios,2247,4,1,1,4,4,10,-6,4
AEK Athens,2248,1,4,2,0,7,1,6,14
PAOK Salonik,2248,2,3,2,1,11,5,6,11
P'thinaikos,2248,3,1,1,4,5,11,-6,4
Panionios,2248,4,1,1,4,4,10,-6,4
AEK Athens,2249,1,4,2,0,7,1,6,14
PAOK Salonik,2249,2,2,2,2,10,6,4,8
P'thinaikos,2249,3,2,1,3,6,10,-4,7
Panionios,2249,4,1,1,4,4,10,-6,4
AEK Athens,2250,1,4,2,0,7,1,6,14
PAOK Salonik,2250,2,2,2,2,10,7,3,8
P'thinaikos,2250,3,2,1,3,7,10,-3,7
Panionios,2250,4,1,1,4,4,10,-6,4
AEK Athens,2251,1,4,2,0,7,1,6,14
PAOK Salonik,2251,2,3,2,1,10,4,6,11
P'thinaikos,2251,3,1,1,4,4,10,-6,4
Panionios,2251,3,1,1,4,4,10,-6,4
AEK Athens,2252,1,4,2,0,7,1,6,14
PAOK Salonik,2252,2,2,3,1,10,5,5,9
P'thinaikos,2252,3,1,2,3,5,10,-5,5
Panionios,2252,4,1,1,4,4,10,-6,4
AEK Athens,2253,1,4,2,0,7,1,6,14
PAOK Salonik,2253,2,2,2,2,9,5,4,8
P'thinaikos,2253,3,2,1,3,5,9,-4,7
Panionios,2253,4,1,1,4,4,10,-6,4
AEK Athens,2254,1,4,2,0,7,1,6,14
PAOK Salonik,2254,2,2,2,2,9,8,1,8
P'thinaikos,2254,3,2,1,3,8,9,-1,7
Panionios,2254,4,1,1,4,4,10,-6,4
AEK Athens,2255,1,4,2,0,7,1,6,14
PAOK Salonik,2255,2,2,3,1,9,4,5,9
P'thinaikos,2255,3,1,2,3,4,9,-5,5
Panionios,2255,4,1,1,4,4,10,-6,4
AEK Athens,2256,1,4,2,0,7,1,6,14
PAOK Salonik,2256,2,2,2,2,9,6,3,8
P'thinaikos,2256,3,2,1,3,6,9,-3,7
Panionios,2256,4,1,1,4,4,10,-6,4
AEK Athens,2257,1,4,2,0,7,1,6,14
PAOK Salonik,2257,2,3,2,1,10,4,6,11
P'thinaikos,2257,3,1,1,4,4,10,-6,4
Panionios,2257,3,1,1,4,4,10,-6,4
AEK Athens,2258,1,4,2,0,7,1,6,14
PAOK Salonik,2258,2,2,2,2,9,6,3,8
P'thinaikos,2258,3,2,1,3,6,9,-3,7
Panionios,2258,4,1,1,4,4,10,-6,4
AEK Athens,2259,1,4,2,0,7,1,6,14
PAOK Salonik,2259,2,2,2,2,9,5,4,8
P'thinaikos,2259,3,2,1,3,5,9,-4,7
Panionios,2259,4,1,1,4,4,10,-6,4
AEK Athens,2260,1,4,2,0,7,1,6,14
PAOK Salonik,2260,2,2,2,2,9,5,4,8
P'thinaikos,2260,3,2,1,3,5,9,-4,7
Panionios,2260,4,1,1,4,4,10,-6,4
AEK Athens,2261,1,4,2,0,7,1,6,14
PAOK Salonik,2261,2,2,3,1,10,5,5,9
P'thinaikos,2261,3,1,2,3,5,10,-5,5
Panionios,2261,4,1,1,4,4,10,-6,4
AEK Athens,2262,1,4,2,0,7,1,6,14
PAOK Salonik,2262,2,2,2,2,10,7,3,8
P'thinaikos,2262,3,2,1,3,7,10,-3,7
Panionios,2262,4,1,1,4,4,10,-6,4
AEK Athens,2263,1,4,2,0,7,1,6,14
PAOK Salonik,2263,2,2,2,2,9,6,3,8
P'thinaikos,2263,3,2,1,3,6,9,-3,7
Panionios,2263,4,1,1,4,4,10,-6,4
AEK Athens,2264,1,4,2,0,7,1,6,14
PAOK Salonik,2264,2,3,2,1,10,4,6,11
P'thinaikos,2264,3,1,1,4,4,10,-6,4
Panionios,2264,3,1,1,4,4,10,-6,4
AEK Athens,2265,1,4,2,0,7,1,6,14
PAOK Salonik,2265,2,3,2,1,10,4,6,11
P'thinaikos,2265,3,1,1,4,4,10,-6,4
Panionios,2265,3,1,1,4,4,10,-6,4
AEK Athens,2266,1,4,2,0,7,1,6,14
PAOK Salonik,2266,2,3,2,1,12,5,7,11
Panionios,2266,3,1,1,4,4,10,-6,4
P'thinaikos,2266,4,1,1,4,5,12,-7,4
AEK Athens,2267,1,4,2,0,7,1,6,14
PAOK Salonik,2267,2,3,2,1,13,6,7,11
Panionios,2267,3,1,1,4,4,10,-6,4
P'thinaikos,2267,4,1,1,4,6,13,-7,4
AEK Athens,2268,1,4,2,0,7,1,6,14
PAOK Salonik,2268,2,2,3,1,10,5,5,9
P'thinaikos,2268,3,1,2,3,5,10,-5,5
Panionios,2268,4,1,1,4,4,10,-6,4
AEK Athens,2269,1,4,2,0,7,1,6,14
PAOK Salonik,2269,2,3,2,1,10,4,6,11
P'thinaikos,2269,3,1,1,4,4,10,-6,4
Panionios,2269,3,1,1,4,4,10,-6,4
AEK Athens,2270,1,4,2,0,7,1,6,14
PAOK Salonik,2270,2,2,2,2,9,8,1,8
P'thinaikos,2270,3,2,1,3,8,9,-1,7
Panionios,2270,4,1,1,4,4,10,-6,4
AEK Athens,2271,1,4,2,0,7,1,6,14
PAOK Salonik,2271,2,2,2,2,9,5,4,8
P'thinaikos,2271,3,2,1,3,5,9,-4,7
Panionios,2271,4,1,1,4,4,10,-6,4
AEK Athens,2272,1,4,2,0,7,1,6,14
PAOK Salonik,2272,2,3,2,1,10,4,6,11
P'thinaikos,2272,3,1,1,4,4,10,-6,4
Panionios,2272,3,1,1,4,4,10,-6,4
AEK Athens,2273,1,4,2,0,7,1,6,14
PAOK Salonik,2273,2,2,2,2,12,8,4,8
P'thinaikos,2273,3,2,1,3,8,12,-4,7
Panionios,2273,4,1,1,4,4,10,-6,4
AEK Athens,2274,1,4,2,0,7,1,6,14
PAOK Salonik,2274,2,2,2,2,9,5,4,8
P'thinaikos,2274,3,2,1,3,5,9,-4,7
Panionios,2274,4,1,1,4,4,10,-6,4
AEK Athens,2275,1,4,2,0,7,1,6,14
PAOK Salonik,2275,2,2,3,1,9,4,5,9
P'thinaikos,2275,3,1,2,3,4,9,-5,5
Panionios,2275,4,1,1,4,4,10,-6,4
AEK Athens,2276,1,4,2,0,7,1,6,14
PAOK Salonik,2276,2,2,2,2,10,6,4,8
P'thinaikos,2276,3,2,1,3,6,10,-4,7
Panionios,2276,4,1,1,4,4,10,-6,4
AEK Athens,2277,1,4,2,0,7,1,6,14
PAOK Salonik,2277,2,3,2,1,12,5,7,11
Panionios,2277,3,1,1,4,4,10,-6,4
P'thinaikos,2277,4,1,1,4,5,12,-7,4
AEK Athens,2278,1,4,2,0,7,1,6,14
PAOK Salonik,2278,2,2,2,2,9,6,3,8
P'thinaikos,2278,3,2,1,3,6,9,-3,7
Panionios,2278,4,1,1,4,4,10,-6,4
AEK Athens,2279,1,4,2,0,7,1,6,14
PAOK Salonik,2279,2,2,3,1,10,5,5,9
P'thinaikos,2279,3,1,2,3,5,10,-5,5
Panionios,2279,4,1,1,4,4,10,-6,4
AEK Athens,2280,1,4,2,0,7,1,6,14
PAOK Salonik,2280,2,2,3,1,10,5,5,9
P'thinaikos,2280,3,1,2,3,5,10,-5,5
Panionios,2280,4,1,1,4,4,10,-6,4
AEK Athens,2281,1,4,2,0,7,1,6,14
PAOK Salonik,2281,2,2,2,2,9,5,4,8
P'thinaikos,2281,3,2,1,3,5,9,-4,7
Panionios,2281,4,1,1,4,4,10,-6,4
AEK Athens,2282,1,4,2,0,7,1,6,14
PAOK Salonik,2282,2,2,2,2,9,6,3,8
P'thinaikos,2282,3,2,1,3,6,9,-3,7
Panionios,2282,4,1,1,4,4,10,-6,4
AEK Athens,2283,1,4,2,0,7,1,6,14
PAOK Salonik,2283,2,3,2,1,10,4,6,11
P'thinaikos,2283,3,1,1,4,4,10,-6,4
Panionios,2283,3,1,1,4,4,10,-6,4
AEK Athens,2284,1,4,2,0,7,1,6,14
PAOK Salonik,2284,2,2,2,2,9,7,2,8
P'thinaikos,2284,3,2,1,3,7,9,-2,7
Panionios,2284,4,1,1,4,4,10,-6,4
AEK Athens,2285,1,4,2,0,7,1,6,14
PAOK Salonik,2285,2,3,2,1,11,4,7,11
Panionios,2285,3,1,1,4,4,10,-6,4
P'thinaikos,2285,4,1,1,4,4,11,-7,4
AEK Athens,2286,1,4,2,0,7,1,6,14
PAOK Salonik,2286,2,3,2,1,13,5,8,11
Panionios,2286,3,1,1,4,4,10,-6,4
P'thinaikos,2286,4,1,1,4,5,13,-8,4
AEK Athens,2287,1,4,2,0,7,1,6,14
PAOK Salonik,2287,2,3,2,1,13,6,7,11
Panionios,2287,3,1,1,4,4,10,-6,4
P'thinaikos,2287,4,1,1,4,6,13,-7,4
AEK Athens,2288,1,4,2,0,7,1,6,14
PAOK Salonik,2288,2,2,2,2,11,7,4,8
P'thinaikos,2288,3,2,1,3,7,11,-4,7
Panionios,2288,4,1,1,4,4,10,-6,4
AEK Athens,2289,1,4,2,0,7,1,6,14
PAOK Salonik,2289,2,3,2,1,10,4,6,11
P'thinaikos,2289,3,1,1,4,4,10,-6,4
Panionios,2289,3,1,1,4,4,10,-6,4
AEK Athens,2290,1,4,2,0,7,1,6,14
PAOK Salonik,2290,2,2,3,1,10,5,5,9
P'thinaikos,2290,3,1,2,3,5,10,-5,5
Panionios,2290,4,1,1,4,4,10,-6,4
AEK Athens,2291,1,4,2,0,7,1,6,14
PAOK Salonik,2291,2,3,2,1,10,4,6,11
P'thinaikos,2291,3,1,1,4,4,10,-6,4
Panionios,2291,3,1,1,4,4,10,-6,4
AEK Athens,2292,1,4,2,0,7,1,6,14
PAOK Salonik,2292,2,2,2,2,10,6,4,8
P'thinaikos,2292,3,2,1,3,6,10,-4,7
Panionios,2292,4,1,1,4,4,10,-6,4
AEK Athens,2293,1,4,2,0,7,1,6,14
PAOK Salonik,2293,2,2,2,2,11,7,4,8
P'thinaikos,2293,3,2,1,3,7,11,-4,7
Panionios,2293,4,1,1,4,4,10,-6,4
AEK Athens,2294,1,4,2,0,7,1,6,14
PAOK Salonik,2294,2,3,2,1,12,5,7,11
Panionios,2294,3,1,1,4,4,10,-6,4
P'thinaikos,2294,4,1,1,4,5,12,-7,4
AEK Athens,2295,1,4,2,0,7,1,6,14
PAOK Salonik,2295,2,3,2,1,11,5,6,11
P'thinaikos,2295,3,1,1,4,5,11,-6,4
Panionios,2295,4,1,1,4,4,10,-6,4
AEK Athens,2296,1,4,2,0,7,1,6,14
PAOK Salonik,2296,2,2,2,2,10,6,4,8
P'thinaikos,2296,3,2,1,3,6,10,-4,7
Panionios,2296,4,1,1,4,4,10,-6,4
AEK Athens,2297,1,4,2,0,7,1,6,14
PAOK Salonik,2297,2,3,2,1,12,6,6,11
P'thinaikos,2297,3,1,1,4,6,12,-6,4
Panionios,2297,4,1,1,4,4,10,-6,4
AEK Athens,2298,1,4,2,0,7,1,6,14
PAOK Salonik,2298,2,3,2,1,11,5,6,11
P'thinaikos,2298,3,1,1,4,5,11,-6,4
Panionios,2298,4,1,1,4,4,10,-6,4
AEK Athens,2299,1,4,2,0,7,1,6,14
PAOK Salonik,2299,2,2,3,1,10,5,5,9
P'thinaikos,2299,3,1,2,3,5,10,-5,5
Panionios,2299,4,1,1,4,4,10,-6,4
AEK Athens,2300,1,4,2,0,7,1,6,14
PAOK Salonik,2300,2,2,2,2,10,6,4,8
P'thinaikos,2300,3,2,1,3,6,10,-4,7
Panionios,2300,4,1,1,4,4,10,-6,4
AEK Athens,2301,1,4,2,0,7,1,6,14
PAOK Salonik,2301,2,3,2,1,12,4,8,11
Panionios,2301,3,1,1,4,4,10,-6,4
P'thinaikos,2301,4,1,1,4,4,12,-8,4
AEK Athens,2302,1,4,2,0,7,1,6,14
PAOK Salonik,2302,2,3,2,1,10,4,6,11
P'thinaikos,2302,3,1,1,4,4,10,-6,4
Panionios,2302,3,1,1,4,4,10,-6,4
AEK Athens,2303,1,4,2,0,7,1,6,14
PAOK Salonik,2303,2,3,2,1,11,5,6,11
P'thinaikos,2303,3,1,1,4,5,11,-6,4
Panionios,2303,4,1,1,4,4,10,-6,4
AEK Athens,2304,1,4,2,0,7,1,6,14
PAOK Salonik,2304,2,2,2,2,9,5,4,8
P'thinaikos,2304,3,2,1,3,5,9,-4,7
Panionios,2304,4,1,1,4,4,10,-6,4
AEK Athens,2305,1,4,2,0,7,1,6,14
PAOK Salonik,2305,2,2,2,2,9,6,3,8
P'thinaikos,2305,3,2,1,3,6,9,-3,7
Panionios,2305,4,1,1,4,4,10,-6,4
AEK Athens,2306,1,4,2,0,7,1,6,14
PAOK Salonik,2306,2,3,2,1,11,4,7,11
Panionios,2306,3,1,1,4,4,10,-6,4
P'thinaikos,2306,4,1,1,4,4,11,-7,4
AEK Athens,2307,1,4,2,0,7,1,6,14
PAOK Salonik,2307,2,2,3,1,10,5,5,9
P'thinaikos,2307,3,1,2,3,5,10,-5,5
Panionios,2307,4,1,1,4,4,10,-6,4
AEK Athens,2308,1,4,2,0,7,1,6,14
PAOK Salonik,2308,2,2,2,2,9,6,3,8
P'thinaikos,2308,3,2,1,3,6,9,-3,7
Panionios,2308,4,1,1,4,4,10,-6,4
AEK Athens,2309,1,4,2,0,7,1,6,14
PAOK Salonik,2309,2,3,2,1,11,4,7,11
Panionios,2309,3,1,1,4,4,10,-6,4
P'thinaikos,2309,4,1,1,4,4,11,-7,4
AEK Athens,2310,1,4,2,0,7,1,6,14
PAOK Salonik,2310,2,3,2,1,13,4,9,11
Panionios,2310,3,1,1,4,4,10,-6,4
P'thinaikos,2310,4,1,1,4,4,13,-9,4
AEK Athens,2311,1,4,2,0,7,1,6,14
PAOK Salonik,2311,2,2,2,2,9,5,4,8
P'thinaikos,2311,3,2,1,3,5,9,-4,7
Panionios,2311,4,1,1,4,4,10,-6,4
AEK Athens,2312,1,4,2,0,7,1,6,14
PAOK Salonik,2312,2,3,2,1,12,6,6,11
P'thinaikos,2312,3,1,1,4,6,12,-6,4
Panionios,2312,4,1,1,4,4,10,-6,4
AEK Athens,2313,1,4,2,0,7,1,6,14
PAOK Salonik,2313,2,3,2,1,13,5,8,11
Panionios,2313,3,1,1,4,4,10,-6,4
P'thinaikos,2313,4,1,1,4,5,13,-8,4
AEK Athens,2314,1,4,2,0,7,1,6,14
PAOK Salonik,2314,2,2,3,1,11,6,5,9
P'thinaikos,2314,3,1,2,3,6,11,-5,5
Panionios,2314,4,1,1,4,4,10,-6,4
AEK Athens,2315,1,4,2,0,7,1,6,14
PAOK Salonik,2315,2,2,3,1,9,4,5,9
P'thinaikos,2315,3,1,2,3,4,9,-5,5
Panionios,2315,4,1,1,4,4,10,-6,4
AEK Athens,2316,1,4,2,0,7,1,6,14
PAOK Salonik,2316,2,2,3,1,9,4,5,9
P'thinaikos,2316,3,1,2,3,4,9,-5,5
Panionios,2316,4,1,1,4,4,10,-6,4
AEK Athens,2317,1,4,2,0,7,1,6,14
PAOK Salonik,2317,2,2,2,2,10,6,4,8
P'thinaikos,2317,3,2,1,3,6,10,-4,7
Panionios,2317,4,1,1,4,4,10,-6,4
AEK Athens,2318,1,4,2,0,7,1,6,14
PAOK Salonik,2318,2,2,3,1,11,6,5,9
P'thinaikos,2318,3,1,2,3,6,11,-5,5
Panionios,2318,4,1,1,4,4,10,-6,4
AEK Athens,2319,1,4,2,0,7,1,6,14
PAOK Salonik,2319,2,2,3,1,12,7,5,9
P'thinaikos,2319,3,1,2,3,7,12,-5,5
Panionios,2319,4,1,1,4,4,10,-6,4
AEK Athens,2320,1,4,2,0,7,1,6,14
PAOK Salonik,2320,2,3,2,1,11,4,7,11
Panionios,2320,3,1,1,4,4,10,-6,4
P'thinaikos,2320,4,1,1,4,4,11,-7,4
AEK Athens,2321,1,4,2,0,7,1,6,14
PAOK Salonik,2321,2,2,2,2,9,8,1,8
P'thinaikos,2321,3,2,1,3,8,9,-1,7
Panionios,2321,4,1,1,4,4,10,-6,4
AEK Athens,2322,1,4,2,0,7,1,6,14
PAOK Salonik,2322,2,3,2,1,10,4,6,11
P'thinaikos,2322,3,1,1,4,4,10,-6,4
Panionios,2322,3,1,1,4,4,10,-6,4
AEK Athens,2323,1,4,2,0,7,1,6,14
PAOK Salonik,2323,2,3,2,1,10,4,6,11
P'thinaikos,2323,3,1,1,4,4,10,-6,4
Panionios,2323,3,1,1,4,4,10,-6,4
AEK Athens,2324,1,4,2,0,7,1,6,14
PAOK Salonik,2324,2,3,2,1,11,4,7,11
Panionios,2324,3,1,1,4,4,10,-6,4
P'thinaikos,2324,4,1,1,4,4,11,-7,4
AEK Athens,2325,1,4,2,0,7,1,6,14
PAOK Salonik,2325,2,3,2,1,10,4,6,11
P'thinaikos,2325,3,1,1,4,4,10,-6,4
Panionios,2325,3,1,1,4,4,10,-6,4
AEK Athens,2326,1,4,2,0,7,1,6,14
PAOK Salonik,2326,2,2,2,2,10,6,4,8
P'thinaikos,2326,3,2,1,3,6,10,-4,7
Panionios,2326,4,1,1,4,4,10,-6,4
AEK Athens,2327,1,4,2,0,7,1,6,14
PAOK Salonik,2327,2,3,2,1,11,4,7,11
Panionios,2327,3,1,1,4,4,10,-6,4
P'thinaikos,2327,4,1,1,4,4,11,-7,4
AEK Athens,2328,1,4,2,0,7,1,6,14
PAOK Salonik,2328,2,2,3,1,11,6,5,9
P'thinaikos,2328,3,1,2,3,6,11,-5,5
Panionios,2328,4,1,1,4,4,10,-6,4
AEK Athens,2329,1,4,2,0,7,1,6,14
PAOK Salonik,2329,2,3,2,1,10,4,6,11
P'thinaikos,2329,3,1,1,4,4,10,-6,4
Panionios,2329,3,1,1,4,4,10,-6,4
AEK Athens,2330,1,4,2,0,7,1,6,14
PAOK Salonik,2330,2,2,2,2,9,6,3,8
P'thinaikos,2330,3,2,1,3,6,9,-3,7
Panionios,2330,4,1,1,4,4,10,-6,4
AEK Athens,2331,1,4,2,0,7,1,6,14
PAOK Salonik,2331,2,3,2,1,11,4,7,11
Panionios,2331,3,1,1,4,4,10,-6,4
P'thinaikos,2331,4,1,1,4,4,11,-7,4
AEK Athens,2332,1,4,2,0,7,1,6,14
PAOK Salonik,2332,2,2,2,2,9,7,2,8
P'thinaikos,2332,3,2,1,3,7,9,-2,7
Panionios,2332,4,1,1,4,4,10,-6,4
AEK Athens,2333,1,4,2,0,7,1,6,14
PAOK Salonik,2333,2,3,2,1,10,4,6,11
P'thinaikos,2333,3,1,1,4,4,10,-6,4
Panionios,2333,3,1,1,4,4,10,-6,4
AEK Athens,2334,1,4,2,0,7,1,6,14
PAOK Salonik,2334,2,2,3,1,10,5,5,9
P'thinaikos,2334,3,1,2,3,5,10,-5,5
Panionios,2334,4,1,1,4,4,10,-6,4
AEK Athens,2335,1,4,2,0,7,1,6,14
PAOK Salonik,2335,2,2,2,2,10,7,3,8
P'thinaikos,2335,3,2,1,3,7,10,-3,7
Panionios,2335,4,1,1,4,4,10,-6,4
AEK Athens,2336,1,4,2,0,7,1,6,14
PAOK Salonik,2336,2,2,2,2,10,6,4,8
P'thinaikos,2336,3,2,1,3,6,10,-4,7
Panionios,2336,4,1,1,4,4,10,-6,4
AEK Athens,2337,1,4,2,0,7,1,6,14
PAOK Salonik,2337,2,3,2,1,11,4,7,11
Panionios,2337,3,1,1,4,4,10,-6,4
P'thinaikos,2337,4,1,1,4,4,11,-7,4
AEK Athens,2338,1,4,2,0,7,1,6,14
PAOK Salonik,2338,2,3,2,1,10,4,6,11
P'thinaikos,2338,3,1,1,4,4,10,-6,4
Panionios,2338,3,1,1,4,4,10,-6,4
AEK Athens,2339,1,4,2,0,7,1,6,14
PAOK Salonik,2339,2,2,2,2,9,5,4,8
P'thinaikos,2339,3,2,1,3,5,9,-4,7
Panionios,2339,4,1,1,4,4,10,-6,4
AEK Athens,2340,1,4,2,0,7,1,6,14
PAOK Salonik,2340,2,2,2,2,9,6,3,8
P'thinaikos,2340,3,2,1,3,6,9,-3,7
Panionios,2340,4,1,1,4,4,10,-6,4
AEK Athens,2341,1,4,2,0,7,1,6,14
PAOK Salonik,2341,2,2,3,1,9,4,5,9
P'thinaikos,2341,3,1,2,3,4,9,-5,5
Panionios,2341,4,1,1,4,4,10,-6,4
AEK Athens,2342,1,4,2,0,7,1,6,14
PAOK Salonik,2342,2,2,3,1,10,5,5,9
P'thinaikos,2342,3,1,2,3,5,10,-5,5
Panionios,2342,4,1,1,4,4,10,-6,4
AEK Athens,2343,1,4,2,0,7,1,6,14
PAOK Salonik,2343,2,3,2,1,12,4,8,11
Panionios,2343,3,1,1,4,4,10,-6,4
P'thinaikos,2343,4,1,1,4,4,12,-8,4
AEK Athens,2344,1,4,2,0,7,1,6,14
PAOK Salonik,2344,2,2,3,1,10,5,5,9
P'thinaikos,2344,3,1,2,3,5,10,-5,5
Panionios,2344,4,1,1,4,4,10,-6,4
AEK Athens,2345,1,4,2,0,7,1,6,14
PAOK Salonik,2345,2,2,2,2,9,5,4,8
P'thinaikos,2345,3,2,1,3,5,9,-4,7
Panionios,2345,4,1,1,4,4,10,-6,4
AEK Athens,2346,1,4,2,0,7,1,6,14
PAOK Salonik,2346,2,3,2,1,10,4,6,11
P'thinaikos,2346,3,1,1,4,4,10,-6,4
Panionios,2346,3,1,1,4,4,10,-6,4
AEK Athens,2347,1,4,2,0,7,1,6,14
PAOK Salonik,2347,2,2,2,2,10,7,3,8
P'thinaikos,2347,3,2,1,3,7,10,-3,7
Panionios,2347,4,1,1,4,4,10,-6,4
AEK Athens,2348,1,4,2,0,7,1,6,14
PAOK Salonik,2348,2,3,2,1,12,4,8,11
Panionios,2348,3,1,1,4,4,10,-6,4
P'thinaikos,2348,4,1,1,4,4,12,-8,4
AEK Athens,2349,1,4,2,0,7,1,6,14
PAOK Salonik,2349,2,2,2,2,10,7,3,8
P'thinaikos,2349,3,2,1,3,7,10,-3,7
Panionios,2349,4,1,1,4,4,10,-6,4
AEK Athens,2350,1,4,2,0,7,1,6,14
PAOK Salonik,2350,2,3,2,1,10,4,6,11
P'thinaikos,2350,3,1,1,4,4,10,-6,4
Panionios,2350,3,1,1,4,4,10,-6,4
AEK Athens,2351,1,4,2,0,7,1,6,14
PAOK Salonik,2351,2,2,2,2,10,6,4,8
P'thinaikos,2351,3,2,1,3,6,10,-4,7
Panionios,2351,4,1,1,4,4,10,-6,4
AEK Athens,2352,1,4,2,0,7,1,6,14
PAOK Salonik,2352,2,2,3,1,10,5,5,9
P'thinaikos,2352,3,1,2,3,5,10,-5,5
Panionios,2352,4,1,1,4,4,10,-6,4
AEK Athens,2353,1,4,2,0,7,1,6,14
PAOK Salonik,2353,2,2,2,2,9,5,4,8
P'thinaikos,2353,3,2,1,3,5,9,-4,7
Panionios,2353,4,1,1,4,4,10,-6,4
AEK Athens,2354,1,4,2,0,7,1,6,14
PAOK Salonik,2354,2,2,2,2,10,7,3,8
P'thinaikos,2354,3,2,1,3,7,10,-3,7
Panionios,2354,4,1,1,4,4,10,-6,4
AEK Athens,2355,1,4,2,0,7,1,6,14
PAOK Salonik,2355,2,3,2,1,11,5,6,11
P'thinaikos,2355,3,1,1,4,5,11,-6,4
Panionios,2355,4,1,1,4,4,10,-6,4
AEK Athens,2356,1,4,2,0,7,1,6,14
PAOK Salonik,2356,2,2,2,2,9,5,4,8
P'thinaikos,2356,3,2,1,3,5,9,-4,7
Panionios,2356,4,1,1,4,4,10,-6,4
AEK Athens,2357,1,4,2,0,7,1,6,14
PAOK Salonik,2357,2,2,3,1,10,5,5,9
P'thinaikos,2357,3,1,2,3,5,10,-5,5
Panionios,2357,4,1,1,4,4,10,-6,4
AEK Athens,2358,1,4,2,0,7,1,6,14
PAOK Salonik,2358,2,3,2,1,10,4,6,11
P'thinaikos,2358,3,1,1,4,4,10,-6,4
Panionios,2358,3,1,1,4,4,10,-6,4
AEK Athens,2359,1,4,2,0,7,1,6,14
PAOK Salonik,2359,2,2,3,1,10,5,5,9
P'thinaikos,2359,3,1,2,3,5,10,-5,5
Panionios,2359,4,1,1,4,4,10,-6,4
AEK Athens,2360,1,4,2,0,7,1,6,14
PAOK Salonik,2360,2,2,3,1,10,5,5,9
P'thinaikos,2360,3,1,2,3,5,10,-5,5
Panionios,2360,4,1,1,4,4,10,-6,4
AEK Athens,2361,1,4,2,0,7,1,6,14
PAOK Salonik,2361,2,3,2,1,10,4,6,11
P'thinaikos,2361,3,1,1,4,4,10,-6,4
Panionios,2361,3,1,1,4,4,10,-6,4
AEK Athens,2362,1,4,2,0,7,1,6,14
PAOK Salonik,2362,2,2,2,2,9,5,4,8
P'thinaikos,2362,3,2,1,3,5,9,-4,7
Panionios,2362,4,1,1,4,4,10,-6,4
AEK Athens,2363,1,4,2,0,7,1,6,14
PAOK Salonik,2363,2,2,3,1,10,5,5,9
P'thinaikos,2363,3,1,2,3,5,10,-5,5
Panionios,2363,4,1,1,4,4,10,-6,4
AEK Athens,2364,1,4,2,0,7,1,6,14
PAOK Salonik,2364,2,3,2,1,13,5,8,11
Panionios,2364,3,1,1,4,4,10,-6,4
P'thinaikos,2364,4,1,1,4,5,13,-8,4
AEK Athens,2365,1,4,2,0,7,1,6,14
PAOK Salonik,2365,2,2,3,1,11,6,5,9
P'thinaikos,2365,3,1,2,3,6,11,-5,5
Panionios,2365,4,1,1,4,4,10,-6,4
AEK Athens,2366,1,4,2,0,7,1,6,14
PAOK Salonik,2366,2,2,2,2,9,7,2,8
P'thinaikos,2366,3,2,1,3,7,9,-2,7
Panionios,2366,4,1,1,4,4,10,-6,4
AEK Athens,2367,1,4,2,0,7,1,6,14
PAOK Salonik,2367,2,2,3,1,10,5,5,9
P'thinaikos,2367,3,1,2,3,5,10,-5,5
Panionios,2367,4,1,1,4,4,10,-6,4
AEK Athens,2368,1,4,2,0,7,1,6,14
PAOK Salonik,2368,2,3,2,1,11,4,7,11
Panionios,2368,3,1,1,4,4,10,-6,4
P'thinaikos,2368,4,1,1,4,4,11,-7,4
AEK Athens,2369,1,4,2,0,7,1,6,14
PAOK Salonik,2369,2,2,3,1,11,6,5,9
P'thinaikos,2369,3,1,2,3,6,11,-5,5
Panionios,2369,4,1,1,4,4,10,-6,4
AEK Athens,2370,1,4,2,0,7,1,6,14
PAOK Salonik,2370,2,3,2,1,10,4,6,11
P'thinaikos,2370,3,1,1,4,4,10,-6,4
Panionios,2370,3,1,1,4,4,10,-6,4
AEK Athens,2371,1,4,2,0,7,1,6,14
PAOK Salonik,2371,2,3,2,1,11,4,7,11
Panionios,2371,3,1,1,4,4,10,-6,4
P'thinaikos,2371,4,1,1,4,4,11,-7,4
AEK Athens,2372,1,4,2,0,7,1,6,14
PAOK Salonik,2372,2,2,3,1,10,5,5,9
P'thinaikos,2372,3,1,2,3,5,10,-5,5
Panionios,2372,4,1,1,4,4,10,-6,4
AEK Athens,2373,1,4,2,0,7,1,6,14
PAOK Salonik,2373,2,2,2,2,9,6,3,8
P'thinaikos,2373,3,2,1,3,6,9,-3,7
Panionios,2373,4,1,1,4,4,10,-6,4
AEK Athens,2374,1,4,2,0,7,1,6,14
PAOK Salonik,2374,2,2,3,1,9,4,5,9
P'thinaikos,2374,3,1,2,3,4,9,-5,5
Panionios,2374,4,1,1,4,4,10,-6,4
AEK Athens,2375,1,4,2,0,7,1,6,14
PAOK Salonik,2375,2,3,2,1,10,4,6,11
P'thinaikos,2375,3,1,1,4,4,10,-6,4
Panionios,2375,3,1,1,4,4,10,-6,4
AEK Athens,2376,1,4,2,0,7,1,6,14
PAOK Salonik,2376,2,3,2,1,13,6,7,11
Panionios,2376,3,1,1,4,4,10,-6,4
P'thinaikos,2376,4,1,1,4,6,13,-7,4
AEK Athens,2377,1,4,2,0,7,1,6,14
PAOK Salonik,2377,2,2,3,1,10,5,5,9
P'thinaikos,2377,3,1,2,3,5,10,-5,5
Panionios,2377,4,1,1,4,4,10,-6,4
AEK Athens,2378,1,4,2,0,7,1,6,14
PAOK Salonik,2378,2,3,2,1,12,5,7,11
Panionios,2378,3,1,1,4,4,10,-6,4
P'thinaikos,2378,4,1,1,4,5,12,-7,4
AEK Athens,2379,1,4,2,0,7,1,6,14
PAOK Salonik,2379,2,2,3,1,9,4,5,9
P'thinaikos,2379,3,1,2,3,4,9,-5,5
Panionios,2379,4,1,1,4,4,10,-6,4
AEK Athens,2380,1,4,2,0,7,1,6,14
PAOK Salonik,2380,2,2,2,2,9,5,4,8
P'thinaikos,2380,3,2,1,3,5,9,-4,7
Panionios,2380,4,1,1,4,4,10,-6,4
AEK Athens,2381,1,4,2,0,7,1,6,14
PAOK Salonik,2381,2,3,2,1,11,5,6,11
P'thinaikos,2381,3,1,1,4,5,11,-6,4
Panionios,2381,4,1,1,4,4,10,-6,4
AEK Athens,2382,1,4,2,0,7,1,6,14
PAOK Salonik,2382,2,2,2,2,9,7,2,8
P'thinaikos,2382,3,2,1,3,7,9,-2,7
Panionios,2382,4,1,1,4,4,10,-6,4
AEK Athens,2383,1,4,2,0,7,1,6,14
PAOK Salonik,2383,2,3,2,1,11,5,6,11
P'thinaikos,2383,3,1,1,4,5,11,-6,4
Panionios,2383,4,1,1,4,4,10,-6,4
AEK Athens,2384,1,4,2,0,7,1,6,14
PAOK Salonik,2384,2,3,2,1,11,4,7,11
Panionios,2384,3,1,1,4,4,10,-6,4
P'thinaikos,2384,4,1,1,4,4,11,-7,4
AEK Athens,2385,1,4,2,0,7,1,6,14
PAOK Salonik,2385,2,2,2,2,10,7,3,8
P'thinaikos,2385,3,2,1,3,7,10,-3,7
Panionios,2385,4,1,1,4,4,10,-6,4
AEK Athens,2386,1,4,2,0,7,1,6,14
PAOK Salonik,2386,2,2,2,2,10,7,3,8
P'thinaikos,2386,3,2,1,3,7,10,-3,7
Panionios,2386,4,1,1,4,4,10,-6,4
AEK Athens,2387,1,4,2,0,7,1,6,14
PAOK Salonik,2387,2,2,2,2,10,7,3,8
P'thinaikos,2387,3,2,1,3,7,10,-3,7
Panionios,2387,4,1,1,4,4,10,-6,4
AEK Athens,2388,1,4,2,0,7,1,6,14
PAOK Salonik,2388,2,2,2,2,9,6,3,8
P'thinaikos,2388,3,2,1,3,6,9,-3,7
Panionios,2388,4,1,1,4,4,10,-6,4
AEK Athens,2389,1,4,2,0,7,1,6,14
PAOK Salonik,2389,2,2,2,2,9,6,3,8
P'thinaikos,2389,3,2,1,3,6,9,-3,7
Panionios,2389,4,1,1,4,4,10,-6,4
AEK Athens,2390,1,4,2,0,7,1,6,14
PAOK Salonik,2390,2,3,2,1,10,4,6,11
P'thinaikos,2390,3,1,1,4,4,10,-6,4
Panionios,2390,3,1,1,4,4,10,-6,4
AEK Athens,2391,1,4,2,0,7,1,6,14
PAOK Salonik,2391,2,2,2,2,9,6,3,8
P'thinaikos,2391,3,2,1,3,6,9,-3,7
Panionios,2391,4,1,1,4,4,10,-6,4
AEK Athens,2392,1,4,2,0,7,1,6,14
PAOK Salonik,2392,2,3,2,1,12,5,7,11
Panionios,2392,3,1,1,4,4,10,-6,4
P'thinaikos,2392,4,1,1,4,5,12,-7,4
AEK Athens,2393,1,4,2,0,7,1,6,14
PAOK Salonik,2393,2,3,2,1,12,4,8,11
Panionios,2393,3,1,1,4,4,10,-6,4
P'thinaikos,2393,4,1,1,4,4,12,-8,4
AEK Athens,2394,1,4,2,0,7,1,6,14
PAOK Salonik,2394,2,2,2,2,10,6,4,8
P'thinaikos,2394,3,2,1,3,6,10,-4,7
Panionios,2394,4,1,1,4,4,10,-6,4
AEK Athens,2395,1,4,2,0,7,1,6,14
PAOK Salonik,2395,2,2,3,1,12,7,5,9
P'thinaikos,2395,3,1,2,3,7,12,-5,5
Panionios,2395,4,1,1,4,4,10,-6,4
AEK Athens,2396,1,4,2,0,7,1,6,14
PAOK Salonik,2396,2,2,2,2,9,5,4,8
P'thinaikos,2396,3,2,1,3,5,9,-4,7
Panionios,2396,4,1,1,4,4,10,-6,4
AEK Athens,2397,1,4,2,0,7,1,6,14
PAOK Salonik,2397,2,3,2,1,13,5,8,11
Panionios,2397,3,1,1,4,4,10,-6,4
P'thinaikos,2397,4,1,1,4,5,13,-8,4
AEK Athens,2398,1,4,2,0,7,1,6,14
PAOK Salonik,2398,2,3,2,1,12,5,7,11
Panionios,2398,3,1,1,4,4,10,-6,4
P'thinaikos,2398,4,1,1,4,5,12,-7,4
AEK Athens,2399,1,4,2,0,7,1,6,14
PAOK Salonik,2399,2,2,2,2,9,5,4,8
P'thinaikos,2399,3,2,1,3,5,9,-4,7
Panionios,2399,4,1,1,4,4,10,-6,4
AEK Athens,2400,1,4,2,0,7,1,6,14
PAOK Salonik,2400,2,2,3,1,9,4,5,9
P'thinaikos,2400,3,1,2,3,4,9,-5,5
Panionios,2400,4,1,1,4,4,10,-6,4
AEK Athens,2401,1,4,2,0,7,1,6,14
PAOK Salonik,2401,2,2,3,1,9,4,5,9
P'thinaikos,2401,3,1,2,3,4,9,-5,5
Panionios,2401,4,1,1,4,4,10,-6,4
AEK Athens,2402,1,4,2,0,7,1,6,14
PAOK Salonik,2402,2,2,3,1,10,5,5,9
P'thinaikos,2402,3,1,2,3,5,10,-5,5
Panionios,2402,4,1,1,4,4,10,-6,4
AEK Athens,2403,1,4,2,0,7,1,6,14
PAOK Salonik,2403,2,2,3,1,10,5,5,9
P'thinaikos,2403,3,1,2,3,5,10,-5,5
Panionios,2403,4,1,1,4,4,10,-6,4
AEK Athens,2404,1,4,2,0,7,1,6,14
PAOK Salonik,2404,2,2,3,1,10,5,5,9
P'thinaikos,2404,3,1,2,3,5,10,-5,5
Panionios,2404,4,1,1,4,4,10,-6,4
AEK Athens,2405,1,4,2,0,7,1,6,14
PAOK Salonik,2405,2,2,2,2,9,6,3,8
P'thinaikos,2405,3,2,1,3,6,9,-3,7
Panionios,2405,4,1,1,4,4,10,-6,4
AEK Athens,2406,1,4,2,0,7,1,6,14
PAOK Salonik,2406,2,2,2,2,9,5,4,8
P'thinaikos,2406,3,2,1,3,5,9,-4,7
Panionios,2406,4,1,1,4,4,10,-6,4
AEK Athens,2407,1,4,2,0,7,1,6,14
PAOK Salonik,2407,2,2,3,1,11,6,5,9
P'thinaikos,2407,3,1,2,3,6,11,-5,5
Panionios,2407,4,1,1,4,4,10,-6,4
AEK Athens,2408,1,4,2,0,7,1,6,14
PAOK Salonik,2408,2,3,2,1,10,4,6,11
P'thinaikos,2408,3,1,1,4,4,10,-6,4
Panionios,2408,3,1,1,4,4,10,-6,4
AEK Athens,2409,1,4,2,0,7,1,6,14
PAOK Salonik,2409,2,2,3,1,10,5,5,9
P'thinaikos,2409,3,1,2,3,5,10,-5,5
Panionios,2409,4,1,1,4,4,10,-6,4
AEK Athens,2410,1,4,2,0,7,1,6,14
PAOK Salonik,2410,2,2,3,1,11,6,5,9
P'thinaikos,2410,3,1,2,3,6,11,-5,5
Panionios,2410,4,1,1,4,4,10,-6,4
AEK Athens,2411,1,4,2,0,7,1,6,14
PAOK Salonik,2411,2,3,2,1,10,4,6,11
P'thinaikos,2411,3,1,1,4,4,10,-6,4
Panionios,2411,3,1,1,4,4,10,-6,4
AEK Athens,2412,1,4,2,0,7,1,6,14
PAOK Salonik,2412,2,2,3,1,9,4,5,9
P'thinaikos,2412,3,1,2,3,4,9,-5,5
Panionios,2412,4,1,1,4,4,10,-6,4
AEK Athens,2413,1,4,2,0,7,1,6,14
PAOK Salonik,2413,2,3,2,1,11,4,7,11
Panionios,2413,3,1,1,4,4,10,-6,4
P'thinaikos,2413,4,1,1,4,4,11,-7,4
AEK Athens,2414,1,4,2,0,7,1,6,14
PAOK Salonik,2414,2,2,2,2,10,6,4,8
P'thinaikos,2414,3,2,1,3,6,10,-4,7
Panionios,2414,4,1,1,4,4,10,-6,4
AEK Athens,2415,1,4,2,0,7,1,6,14
PAOK Salonik,2415,2,2,2,2,9,5,4,8
P'thinaikos,2415,3,2,1,3,5,9,-4,7
Panionios,2415,4,1,1,4,4,10,-6,4
AEK Athens,2416,1,4,2,0,7,1,6,14
PAOK Salonik,2416,2,2,2,2,10,9,1,8
P'thinaikos,2416,3,2,1,3,9,10,-1,7
Panionios,2416,4,1,1,4,4,10,-6,4
AEK Athens,2417,1,4,2,0,7,1,6,14
PAOK Salonik,2417,2,2,2,2,10,6,4,8
P'thinaikos,2417,3,2,1,3,6,10,-4,7
Panionios,2417,4,1,1,4,4,10,-6,4
AEK Athens,2418,1,4,2,0,7,1,6,14
PAOK Salonik,2418,2,2,2,2,9,5,4,8
P'thinaikos,2418,3,2,1,3,5,9,-4,7
Panionios,2418,4,1,1,4,4,10,-6,4
AEK Athens,2419,1,4,2,0,7,1,6,14
PAOK Salonik,2419,2,3,2,1,13,4,9,11
Panionios,2419,3,1,1,4,4,10,-6,4
P'thinaikos,2419,4,1,1,4,4,13,-9,4
AEK Athens,2420,1,4,2,0,7,1,6,14
PAOK Salonik,2420,2,2,3,1,9,4,5,9
P'thinaikos,2420,3,1,2,3,4,9,-5,5
Panionios,2420,4,1,1,4,4,10,-6,4
AEK Athens,2421,1,4,2,0,7,1,6,14
PAOK Salonik,2421,2,2,2,2,10,6,4,8
P'thinaikos,2421,3,2,1,3,6,10,-4,7
Panionios,2421,4,1,1,4,4,10,-6,4
AEK Athens,2422,1,4,2,0,7,1,6,14
PAOK Salonik,2422,2,2,2,2,10,8,2,8
P'thinaikos,2422,3,2,1,3,8,10,-2,7
Panionios,2422,4,1,1,4,4,10,-6,4
AEK Athens,2423,1,4,2,0,7,1,6,14
PAOK Salonik,2423,2,2,3,1,10,5,5,9
P'thinaikos,2423,3,1,2,3,5,10,-5,5
Panionios,2423,4,1,1,4,4,10,-6,4
AEK Athens,2424,1,4,2,0,7,1,6,14
PAOK Salonik,2424,2,2,2,2,10,6,4,8
P'thinaikos,2424,3,2,1,3,6,10,-4,7
Panionios,2424,4,1,1,4,4,10,-6,4
AEK Athens,2425,1,4,2,0,7,1,6,14
PAOK Salonik,2425,2,2,3,1,9,4,5,9
P'thinaikos,2425,3,1,2,3,4,9,-5,5
Panionios,2425,4,1,1,4,4,10,-6,4
AEK Athens,2426,1,4,2,0,7,1,6,14
PAOK Salonik,2426,2,3,2,1,11,5,6,11
P'thinaikos,2426,3,1,1,4,5,11,-6,4
Panionios,2426,4,1,1,4,4,10,-6,4
AEK Athens,2427,1,4,2,0,7,1,6,14
PAOK Salonik,2427,2,2,2,2,10,7,3,8
P'thinaikos,2427,3,2,1,3,7,10,-3,7
Panionios,2427,4,1,1,4,4,10,-6,4
AEK Athens,2428,1,4,2,0,7,1,6,14
PAOK Salonik,2428,2,3,2,1,11,4,7,11
Panionios,2428,3,1,1,4,4,10,-6,4
P'thinaikos,2428,4,1,1,4,4,11,-7,4
AEK Athens,2429,1,4,2,0,7,1,6,14
PAOK Salonik,2429,2,3,2,1,10,4,6,11
P'thinaikos,2429,3,1,1,4,4,10,-6,4
Panionios,2429,3,1,1,4,4,10,-6,4
AEK Athens,2430,1,4,2,0,7,1,6,14
PAOK Salonik,2430,2,2,3,1,9,4,5,9
P'thinaikos,2430,3,1,2,3,4,9,-5,5
Panionios,2430,4,1,1,4,4,10,-6,4
AEK Athens,2431,1,4,2,0,7,1,6,14
PAOK Salonik,2431,2,3,2,1,12,4,8,11
Panionios,2431,3,1,1,4,4,10,-6,4
P'thinaikos,2431,4,1,1,4,4,12,-8,4
AEK Athens,2432,1,4,2,0,7,1,6,14
PAOK Salonik,2432,2,2,3,1,10,5,5,9
P'thinaikos,2432,3,1,2,3,5,10,-5,5
Panionios,2432,4,1,1,4,4,10,-6,4
AEK Athens,2433,1,4,2,0,7,1,6,14
PAOK Salonik,2433,2,2,2,2,10,8,2,8
P'thinaikos,2433,3,2,1,3,8,10,-2,7
Panionios,2433,4,1,1,4,4,10,-6,4
AEK Athens,2434,1,4,2,0,7,1,6,14
PAOK Salonik,2434,2,2,2,2,10,6,4,8
P'thinaikos,2434,3,2,1,3,6,10,-4,7
Panionios,2434,4,1,1,4,4,10,-6,4
AEK Athens,2435,1,4,2,0,7,1,6,14
PAOK Salonik,2435,2,3,2,1,11,5,6,11
P'thinaikos,2435,3,1,1,4,5,11,-6,4
Panionios,2435,4,1,1,4,4,10,-6,4
AEK Athens,2436,1,4,2,0,7,1,6,14
PAOK Salonik,2436,2,2,2,2,10,7,3,8
P'thinaikos,2436,3,2,1,3,7,10,-3,7
Panionios,2436,4,1,1,4,4,10,-6,4
AEK Athens,2437,1,4,2,0,7,1,6,14
PAOK Salonik,2437,2,2,3,1,9,4,5,9
P'thinaikos,2437,3,1,2,3,4,9,-5,5
Panionios,2437,4,1,1,4,4,10,-6,4
AEK Athens,2438,1,4,2,0,7,1,6,14
PAOK Salonik,2438,2,2,3,1,10,5,5,9
P'thinaikos,2438,3,1,2,3,5,10,-5,5
Panionios,2438,4,1,1,4,4,10,-6,4
AEK Athens,2439,1,4,2,0,7,1,6,14
PAOK Salonik,2439,2,2,2,2,9,5,4,8
P'thinaikos,2439,3,2,1,3,5,9,-4,7
Panionios,2439,4,1,1,4,4,10,-6,4
AEK Athens,2440,1,4,2,0,7,1,6,14
PAOK Salonik,2440,2,2,2,2,10,6,4,8
P'thinaikos,2440,3,2,1,3,6,10,-4,7
Panionios,2440,4,1,1,4,4,10,-6,4
AEK Athens,2441,1,4,2,0,7,1,6,14
PAOK Salonik,2441,2,3,2,1,12,6,6,11
P'thinaikos,2441,3,1,1,4,6,12,-6,4
Panionios,2441,4,1,1,4,4,10,-6,4
AEK Athens,2442,1,4,2,0,7,1,6,14
PAOK Salonik,2442,2,2,2,2,12,8,4,8
P'thinaikos,2442,3,2,1,3,8,12,-4,7
Panionios,2442,4,1,1,4,4,10,-6,4
AEK Athens,2443,1,4,2,0,7,1,6,14
PAOK Salonik,2443,2,2,3,1,9,4,5,9
P'thinaikos,2443,3,1,2,3,4,9,-5,5
Panionios,2443,4,1,1,4,4,10,-6,4
AEK Athens,2444,1,4,2,0,7,1,6,14
PAOK Salonik,2444,2,2,2,2,9,5,4,8
P'thinaikos,2444,3,2,1,3,5,9,-4,7
Panionios,2444,4,1,1,4,4,10,-6,4
AEK Athens,2445,1,4,2,0,7,1,6,14
PAOK Salonik,2445,2,3,2,1,11,5,6,11
P'thinaikos,2445,3,1,1,4,5,11,-6,4
Panionios,2445,4,1,1,4,4,10,-6,4
AEK Athens,2446,1,4,2,0,7,1,6,14
PAOK Salonik,2446,2,2,2,2,9,7,2,8
P'thinaikos,2446,3,2,1,3,7,9,-2,7
Panionios,2446,4,1,1,4,4,10,-6,4
AEK Athens,2447,1,4,2,0,7,1,6,14
PAOK Salonik,2447,2,2,2,2,10,6,4,8
P'thinaikos,2447,3,2,1,3,6,10,-4,7
Panionios,2447,4,1,1,4,4,10,-6,4
AEK Athens,2448,1,4,2,0,7,1,6,14
PAOK Salonik,2448,2,2,2,2,9,5,4,8
P'thinaikos,2448,3,2,1,3,5,9,-4,7
Panionios,2448,4,1,1,4,4,10,-6,4
AEK Athens,2449,1,4,2,0,7,1,6,14
PAOK Salonik,2449,2,2,2,2,10,8,2,8
P'thinaikos,2449,3,2,1,3,8,10,-2,7
Panionios,2449,4,1,1,4,4,10,-6,4
AEK Athens,2450,1,4,2,0,7,1,6,14
PAOK Salonik,2450,2,2,2,2,10,6,4,8
P'thinaikos,2450,3,2,1,3,6,10,-4,7
Panionios,2450,4,1,1,4,4,10,-6,4
AEK Athens,2451,1,4,2,0,7,1,6,14
PAOK Salonik,2451,2,2,3,1,10,5,5,9
P'thinaikos,2451,3,1,2,3,5,10,-5,5
Panionios,2451,4,1,1,4,4,10,-6,4
AEK Athens,2452,1,4,2,0,7,1,6,14
PAOK Salonik,2452,2,3,2,1,11,4,7,11
Panionios,2452,3,1,1,4,4,10,-6,4
P'thinaikos,2452,4,1,1,4,4,11,-7,4
AEK Athens,2453,1,4,2,0,7,1,6,14
PAOK Salonik,2453,2,3,2,1,10,4,6,11
P'thinaikos,2453,3,1,1,4,4,10,-6,4
Panionios,2453,3,1,1,4,4,10,-6,4
AEK Athens,2454,1,4,2,0,7,1,6,14
PAOK Salonik,2454,2,2,3,1,10,5,5,9
P'thinaikos,2454,3,1,2,3,5,10,-5,5
Panionios,2454,4,1,1,4,4,10,-6,4
AEK Athens,2455,1,4,2,0,7,1,6,14
PAOK Salonik,2455,2,2,3,1,9,4,5,9
P'thinaikos,2455,3,1,2,3,4,9,-5,5
Panionios,2455,4,1,1,4,4,10,-6,4
AEK Athens,2456,1,4,2,0,7,1,6,14
PAOK Salonik,2456,2,2,2,2,10,6,4,8
P'thinaikos,2456,3,2,1,3,6,10,-4,7
Panionios,2456,4,1,1,4,4,10,-6,4
AEK Athens,2457,1,4,2,0,7,1,6,14
PAOK Salonik,2457,2,3,2,1,12,5,7,11
Panionios,2457,3,1,1,4,4,10,-6,4
P'thinaikos,2457,4,1,1,4,5,12,-7,4
AEK Athens,2458,1,4,2,0,7,1,6,14
PAOK Salonik,2458,2,2,2,2,10,7,3,8
P'thinaikos,2458,3,2,1,3,7,10,-3,7
Panionios,2458,4,1,1,4,4,10,-6,4
AEK Athens,2459,1,4,2,0,7,1,6,14
PAOK Salonik,2459,2,3,2,1,10,4,6,11
P'thinaikos,2459,3,1,1,4,4,10,-6,4
Panionios,2459,3,1,1,4,4,10,-6,4
AEK Athens,2460,1,4,2,0,7,1,6,14
PAOK Salonik,2460,2,3,2,1,11,5,6,11
P'thinaikos,2460,3,1,1,4,5,11,-6,4
Panionios,2460,4,1,1,4,4,10,-6,4
AEK Athens,2461,1,4,2,0,7,1,6,14
PAOK Salonik,2461,2,2,3,1,9,4,5,9
P'thinaikos,2461,3,1,2,3,4,9,-5,5
Panionios,2461,4,1,1,4,4,10,-6,4
AEK Athens,2462,1,4,2,0,7,1,6,14
PAOK Salonik,2462,2,3,2,1,12,5,7,11
Panionios,2462,3,1,1,4,4,10,-6,4
P'thinaikos,2462,4,1,1,4,5,12,-7,4
AEK Athens,2463,1,4,2,0,7,1,6,14
PAOK Salonik,2463,2,2,2,2,10,7,3,8
P'thinaikos,2463,3,2,1,3,7,10,-3,7
Panionios,2463,4,1,1,4,4,10,-6,4
AEK Athens,2464,1,4,2,0,7,1,6,14
PAOK Salonik,2464,2,2,2,2,10,6,4,8
P'thinaikos,2464,3,2,1,3,6,10,-4,7
Panionios,2464,4,1,1,4,4,10,-6,4
AEK Athens,2465,1,4,2,0,7,1,6,14
PAOK Salonik,2465,2,3,2,1,11,5,6,11
P'thinaikos,2465,3,1,1,4,5,11,-6,4
Panionios,2465,4,1,1,4,4,10,-6,4
AEK Athens,2466,1,4,2,0,7,1,6,14
PAOK Salonik,2466,2,2,3,1,10,5,5,9
P'thinaikos,2466,3,1,2,3,5,10,-5,5
Panionios,2466,4,1,1,4,4,10,-6,4
AEK Athens,2467,1,4,2,0,7,1,6,14
PAOK Salonik,2467,2,2,3,1,11,6,5,9
P'thinaikos,2467,3,1,2,3,6,11,-5,5
Panionios,2467,4,1,1,4,4,10,-6,4
AEK Athens,2468,1,4,2,0,7,1,6,14
PAOK Salonik,2468,2,2,2,2,10,6,4,8
P'thinaikos,2468,3,2,1,3,6,10,-4,7
Panionios,2468,4,1,1,4,4,10,-6,4
AEK Athens,2469,1,4,2,0,7,1,6,14
PAOK Salonik,2469,2,2,2,2,9,5,4,8
P'thinaikos,2469,3,2,1,3,5,9,-4,7
Panionios,2469,4,1,1,4,4,10,-6,4
AEK Athens,2470,1,4,2,0,7,1,6,14
PAOK Salonik,2470,2,2,2,2,10,6,4,8
P'thinaikos,2470,3,2,1,3,6,10,-4,7
Panionios,2470,4,1,1,4,4,10,-6,4
AEK Athens,2471,1,4,2,0,7,1,6,14
PAOK Salonik,2471,2,2,2,2,9,6,3,8
P'thinaikos,2471,3,2,1,3,6,9,-3,7
Panionios,2471,4,1,1,4,4,10,-6,4
AEK Athens,2472,1,4,2,0,7,1,6,14
PAOK Salonik,2472,2,2,2,2,9,7,2,8
P'thinaikos,2472,3,2,1,3,7,9,-2,7
Panionios,2472,4,1,1,4,4,10,-6,4
AEK Athens,2473,1,4,2,0,7,1,6,14
PAOK Salonik,2473,2,3,2,1,11,5,6,11
P'thinaikos,2473,3,1,1,4,5,11,-6,4
Panionios,2473,4,1,1,4,4,10,-6,4
AEK Athens,2474,1,4,2,0,7,1,6,14
PAOK Salonik,2474,2,2,2,2,9,6,3,8
P'thinaikos,2474,3,2,1,3,6,9,-3,7
Panionios,2474,4,1,1,4,4,10,-6,4
AEK Athens,2475,1,4,2,0,7,1,6,14
PAOK Salonik,2475,2,2,3,1,10,5,5,9
P'thinaikos,2475,3,1,2,3,5,10,-5,5
Panionios,2475,4,1,1,4,4,10,-6,4
AEK Athens,2476,1,4,2,0,7,1,6,14
PAOK Salonik,2476,2,3,2,1,10,4,6,11
P'thinaikos,2476,3,1,1,4,4,10,-6,4
Panionios,2476,3,1,1,4,4,10,-6,4
AEK Athens,2477,1,4,2,0,7,1,6,14
PAOK Salonik,2477,2,2,2,2,10,6,4,8
P'thinaikos,2477,3,2,1,3,6,10,-4,7
Panionios,2477,4,1,1,4,4,10,-6,4
AEK Athens,2478,1,4,2,0,7,1,6,14
PAOK Salonik,2478,2,3,2,1,10,4,6,11
P'thinaikos,2478,3,1,1,4,4,10,-6,4
Panionios,2478,3,1,1,4,4,10,-6,4
AEK Athens,2479,1,4,2,0,7,1,6,14
PAOK Salonik,2479,2,2,3,1,9,4,5,9
P'thinaikos,2479,3,1,2,3,4,9,-5,5
Panionios,2479,4,1,1,4,4,10,-6,4
AEK Athens,2480,1,4,2,0,7,1,6,14
PAOK Salonik,2480,2,2,2,2,9,6,3,8
P'thinaikos,2480,3,2,1,3,6,9,-3,7
Panionios,2480,4,1,1,4,4,10,-6,4
AEK Athens,2481,1,4,2,0,7,1,6,14
PAOK Salonik,2481,2,3,2,1,10,4,6,11
P'thinaikos,2481,3,1,1,4,4,10,-6,4
Panionios,2481,3,1,1,4,4,10,-6,4
AEK Athens,2482,1,4,2,0,7,1,6,14
PAOK Salonik,2482,2,2,3,1,9,4,5,9
P'thinaikos,2482,3,1,2,3,4,9,-5,5
Panionios,2482,4,1,1,4,4,10,-6,4
AEK Athens,2483,1,4,2,0,7,1,6,14
PAOK Salonik,2483,2,2,3,1,10,5,5,9
P'thinaikos,2483,3,1,2,3,5,10,-5,5
Panionios,2483,4,1,1,4,4,10,-6,4
AEK Athens,2484,1,4,2,0,7,1,6,14
PAOK Salonik,2484,2,2,2,2,9,5,4,8
P'thinaikos,2484,3,2,1,3,5,9,-4,7
Panionios,2484,4,1,1,4,4,10,-6,4
AEK Athens,2485,1,4,2,0,7,1,6,14
PAOK Salonik,2485,2,2,3,1,10,5,5,9
P'thinaikos,2485,3,1,2,3,5,10,-5,5
Panionios,2485,4,1,1,4,4,10,-6,4
AEK Athens,2486,1,4,2,0,7,1,6,14
PAOK Salonik,2486,2,2,3,1,10,5,5,9
P'thinaikos,2486,3,1,2,3,5,10,-5,5
Panionios,2486,4,1,1,4,4,10,-6,4
AEK Athens,2487,1,4,2,0,7,1,6,14
PAOK Salonik,2487,2,3,2,1,10,4,6,11
P'thinaikos,2487,3,1,1,4,4,10,-6,4
Panionios,2487,3,1,1,4,4,10,-6,4
AEK Athens,2488,1,4,2,0,7,1,6,14
PAOK Salonik,2488,2,2,2,2,9,6,3,8
P'thinaikos,2488,3,2,1,3,6,9,-3,7
Panionios,2488,4,1,1,4,4,10,-6,4
AEK Athens,2489,1,4,2,0,7,1,6,14
PAOK Salonik,2489,2,3,2,1,10,4,6,11
P'thinaikos,2489,3,1,1,4,4,10,-6,4
Panionios,2489,3,1,1,4,4,10,-6,4
AEK Athens,2490,1,4,2,0,7,1,6,14
PAOK Salonik,2490,2,3,2,1,11,4,7,11
Panionios,2490,3,1,1,4,4,10,-6,4
P'thinaikos,2490,4,1,1,4,4,11,-7,4
AEK Athens,2491,1,4,2,0,7,1,6,14
PAOK Salonik,2491,2,2,3,1,9,4,5,9
P'thinaikos,2491,3,1,2,3,4,9,-5,5
Panionios,2491,4,1,1,4,4,10,-6,4
AEK Athens,2492,1,4,2,0,7,1,6,14
PAOK Salonik,2492,2,2,3,1,10,5,5,9
P'thinaikos,2492,3,1,2,3,5,10,-5,5
Panionios,2492,4,1,1,4,4,10,-6,4
AEK Athens,2493,1,4,2,0,7,1,6,14
PAOK Salonik,2493,2,2,3,1,9,4,5,9
P'thinaikos,2493,3,1,2,3,4,9,-5,5
Panionios,2493,4,1,1,4,4,10,-6,4
AEK Athens,2494,1,4,2,0,7,1,6,14
PAOK Salonik,2494,2,3,2,1,11,4,7,11
Panionios,2494,3,1,1,4,4,10,-6,4
P'thinaikos,2494,4,1,1,4,4,11,-7,4
AEK Athens,2495,1,4,2,0,7,1,6,14
PAOK Salonik,2495,2,2,3,1,10,5,5,9
P'thinaikos,2495,3,1,2,3,5,10,-5,5
Panionios,2495,4,1,1,4,4,10,-6,4
AEK Athens,2496,1,4,2,0,7,1,6,14
PAOK Salonik,2496,2,2,2,2,9,7,2,8
P'thinaikos,2496,3,2,1,3,7,9,-2,7
Panionios,2496,4,1,1,4,4,10,-6,4
AEK Athens,2497,1,4,2,0,7,1,6,14
PAOK Salonik,2497,2,3,2,1,11,4,7,11
Panionios,2497,3,1,1,4,4,10,-6,4
P'thinaikos,2497,4,1,1,4,4,11,-7,4
AEK Athens,2498,1,4,2,0,7,1,6,14
PAOK Salonik,2498,2,2,3,1,10,5,5,9
P'thinaikos,2498,3,1,2,3,5,10,-5,5
Panionios,2498,4,1,1,4,4,10,-6,4
AEK Athens,2499,1,4,2,0,7,1,6,14
PAOK Salonik,2499,2,2,2,2,9,5,4,8
P'thinaikos,2499,3,2,1,3,5,9,-4,7
Panionios,2499,4,1,1,4,4,10,-6,4
AEK Athens,2500,1,4,2,0,7,1,6,14
PAOK Salonik,2500,2,2,2,2,9,5,4,8
P'thinaikos,2500,3,2,1,3,5,9,-4,7
Panionios,2500,4,1,1,4,4,10,-6,4
AEK Athens,2501,1,4,2,0,7,1,6,14
PAOK Salonik,2501,2,2,2,2,10,6,4,8
P'thinaikos,2501,3,2,1,3,6,10,-4,7
Panionios,2501,4,1,1,4,4,10,-6,4
AEK Athens,2502,1,4,2,0,7,1,6,14
PAOK Salonik,2502,2,2,2,2,10,6,4,8
P'thinaikos,2502,3,2,1,3,6,10,-4,7
Panionios,2502,4,1,1,4,4,10,-6,4
AEK Athens,2503,1,4,2,0,7,1,6,14
PAOK Salonik,2503,2,2,3,1,9,4,5,9
P'thinaikos,2503,3,1,2,3,4,9,-5,5
Panionios,2503,4,1,1,4,4,10,-6,4
AEK Athens,2504,1,4,2,0,7,1,6,14
PAOK Salonik,2504,2,2,2,2,9,5,4,8
P'thinaikos,2504,3,2,1,3,5,9,-4,7
Panionios,2504,4,1,1,4,4,10,-6,4
AEK Athens,2505,1,4,2,0,7,1,6,14
PAOK Salonik,2505,2,2,2,2,10,7,3,8
P'thinaikos,2505,3,2,1,3,7,10,-3,7
Panionios,2505,4,1,1,4,4,10,-6,4
AEK Athens,2506,1,4,2,0,7,1,6,14
PAOK Salonik,2506,2,2,2,2,9,5,4,8
P'thinaikos,2506,3,2,1,3,5,9,-4,7
Panionios,2506,4,1,1,4,4,10,-6,4
AEK Athens,2507,1,4,2,0,7,1,6,14
PAOK Salonik,2507,2,2,2,2,9,5,4,8
P'thinaikos,2507,3,2,1,3,5,9,-4,7
Panionios,2507,4,1,1,4,4,10,-6,4
AEK Athens,2508,1,4,2,0,7,1,6,14
PAOK Salonik,2508,2,3,2,1,11,4,7,11
Panionios,2508,3,1,1,4,4,10,-6,4
P'thinaikos,2508,4,1,1,4,4,11,-7,4
AEK Athens,2509,1,4,2,0,7,1,6,14
PAOK Salonik,2509,2,3,2,1,10,4,6,11
P'thinaikos,2509,3,1,1,4,4,10,-6,4
Panionios,2509,3,1,1,4,4,10,-6,4
AEK Athens,2510,1,4,2,0,7,1,6,14
PAOK Salonik,2510,2,2,2,2,10,6,4,8
P'thinaikos,2510,3,2,1,3,6,10,-4,7
Panionios,2510,4,1,1,4,4,10,-6,4
AEK Athens,2511,1,4,2,0,7,1,6,14
PAOK Salonik,2511,2,2,2,2,10,6,4,8
P'thinaikos,2511,3,2,1,3,6,10,-4,7
Panionios,2511,4,1,1,4,4,10,-6,4
AEK Athens,2512,1,4,2,0,7,1,6,14
PAOK Salonik,2512,2,2,2,2,10,7,3,8
P'thinaikos,2512,3,2,1,3,7,10,-3,7
Panionios,2512,4,1,1,4,4,10,-6,4
AEK Athens,2513,1,4,2,0,7,1,6,14
PAOK Salonik,2513,2,2,2,2,9,6,3,8
P'thinaikos,2513,3,2,1,3,6,9,-3,7
Panionios,2513,4,1,1,4,4,10,-6,4
AEK Athens,2514,1,4,2,0,7,1,6,14
PAOK Salonik,2514,2,2,2,2,9,6,3,8
P'thinaikos,2514,3,2,1,3,6,9,-3,7
Panionios,2514,4,1,1,4,4,10,-6,4
AEK Athens,2515,1,4,2,0,7,1,6,14
PAOK Salonik,2515,2,2,2,2,10,6,4,8
P'thinaikos,2515,3,2,1,3,6,10,-4,7
Panionios,2515,4,1,1,4,4,10,-6,4
AEK Athens,2516,1,4,2,0,7,1,6,14
PAOK Salonik,2516,2,2,3,1,10,5,5,9
P'thinaikos,2516,3,1,2,3,5,10,-5,5
Panionios,2516,4,1,1,4,4,10,-6,4
AEK Athens,2517,1,4,2,0,7,1,6,14
PAOK Salonik,2517,2,2,3,1,10,5,5,9
P'thinaikos,2517,3,1,2,3,5,10,-5,5
Panionios,2517,4,1,1,4,4,10,-6,4
AEK Athens,2518,1,4,2,0,7,1,6,14
PAOK Salonik,2518,2,2,3,1,10,5,5,9
P'thinaikos,2518,3,1,2,3,5,10,-5,5
Panionios,2518,4,1,1,4,4,10,-6,4
AEK Athens,2519,1,4,2,0,7,1,6,14
PAOK Salonik,2519,2,2,3,1,10,5,5,9
P'thinaikos,2519,3,1,2,3,5,10,-5,5
Panionios,2519,4,1,1,4,4,10,-6,4
AEK Athens,2520,1,4,2,0,7,1,6,14
PAOK Salonik,2520,2,2,2,2,9,6,3,8
P'thinaikos,2520,3,2,1,3,6,9,-3,7
Panionios,2520,4,1,1,4,4,10,-6,4
AEK Athens,2521,1,4,2,0,7,1,6,14
PAOK Salonik,2521,2,3,2,1,11,5,6,11
P'thinaikos,2521,3,1,1,4,5,11,-6,4
Panionios,2521,4,1,1,4,4,10,-6,4
AEK Athens,2522,1,4,2,0,7,1,6,14
PAOK Salonik,2522,2,3,2,1,10,4,6,11
P'thinaikos,2522,3,1,1,4,4,10,-6,4
Panionios,2522,3,1,1,4,4,10,-6,4
AEK Athens,2523,1,4,2,0,7,1,6,14
PAOK Salonik,2523,2,3,2,1,11,5,6,11
P'thinaikos,2523,3,1,1,4,5,11,-6,4
Panionios,2523,4,1,1,4,4,10,-6,4
AEK Athens,2524,1,4,2,0,7,1,6,14
PAOK Salonik,2524,2,2,2,2,9,5,4,8
P'thinaikos,2524,3,2,1,3,5,9,-4,7
Panionios,2524,4,1,1,4,4,10,-6,4
AEK Athens,2525,1,4,2,0,7,1,6,14
PAOK Salonik,2525,2,2,2,2,10,8,2,8
P'thinaikos,2525,3,2,1,3,8,10,-2,7
Panionios,2525,4,1,1,4,4,10,-6,4
AEK Athens,2526,1,4,2,0,7,1,6,14
PAOK Salonik,2526,2,2,3,1,11,6,5,9
P'thinaikos,2526,3,1,2,3,6,11,-5,5
Panionios,2526,4,1,1,4,4,10,-6,4
AEK Athens,2527,1,4,2,0,7,1,6,14
PAOK Salonik,2527,2,3,2,1,11,4,7,11
Panionios,2527,3,1,1,4,4,10,-6,4
P'thinaikos,2527,4,1,1,4,4,11,-7,4
AEK Athens,2528,1,4,2,0,7,1,6,14
PAOK Salonik,2528,2,3,2,1,12,6,6,11
P'thinaikos,2528,3,1,1,4,6,12,-6,4
Panionios,2528,4,1,1,4,4,10,-6,4
AEK Athens,2529,1,4,2,0,7,1,6,14
PAOK Salonik,2529,2,2,3,1,9,4,5,9
P'thinaikos,2529,3,1,2,3,4,9,-5,5
Panionios,2529,4,1,1,4,4,10,-6,4
AEK Athens,2530,1,4,2,0,7,1,6,14
PAOK Salonik,2530,2,2,2,2,9,5,4,8
P'thinaikos,2530,3,2,1,3,5,9,-4,7
Panionios,2530,4,1,1,4,4,10,-6,4
AEK Athens,2531,1,4,2,0,7,1,6,14
PAOK Salonik,2531,2,2,2,2,11,8,3,8
P'thinaikos,2531,3,2,1,3,8,11,-3,7
Panionios,2531,4,1,1,4,4,10,-6,4
AEK Athens,2532,1,4,2,0,7,1,6,14
PAOK Salonik,2532,2,3,2,1,12,5,7,11
Panionios,2532,3,1,1,4,4,10,-6,4
P'thinaikos,2532,4,1,1,4,5,12,-7,4
AEK Athens,2533,1,4,2,0,7,1,6,14
PAOK Salonik,2533,2,2,2,2,9,5,4,8
P'thinaikos,2533,3,2,1,3,5,9,-4,7
Panionios,2533,4,1,1,4,4,10,-6,4
AEK Athens,2534,1,4,2,0,7,1,6,14
PAOK Salonik,2534,2,2,3,1,10,5,5,9
P'thinaikos,2534,3,1,2,3,5,10,-5,5
Panionios,2534,4,1,1,4,4,10,-6,4
AEK Athens,2535,1,4,2,0,7,1,6,14
PAOK Salonik,2535,2,3,2,1,10,4,6,11
P'thinaikos,2535,3,1,1,4,4,10,-6,4
Panionios,2535,3,1,1,4,4,10,-6,4
AEK Athens,2536,1,4,2,0,7,1,6,14
PAOK Salonik,2536,2,2,3,1,11,6,5,9
P'thinaikos,2536,3,1,2,3,6,11,-5,5
Panionios,2536,4,1,1,4,4,10,-6,4
AEK Athens,2537,1,4,2,0,7,1,6,14
PAOK Salonik,2537,2,2,3,1,9,4,5,9
P'thinaikos,2537,3,1,2,3,4,9,-5,5
Panionios,2537,4,1,1,4,4,10,-6,4
AEK Athens,2538,1,4,2,0,7,1,6,14
PAOK Salonik,2538,2,3,2,1,12,5,7,11
Panionios,2538,3,1,1,4,4,10,-6,4
P'thinaikos,2538,4,1,1,4,5,12,-7,4
AEK Athens,2539,1,4,2,0,7,1,6,14
PAOK Salonik,2539,2,2,3,1,10,5,5,9
P'thinaikos,2539,3,1,2,3,5,10,-5,5
Panionios,2539,4,1,1,4,4,10,-6,4
AEK Athens,2540,1,4,2,0,7,1,6,14
PAOK Salonik,2540,2,3,2,1,11,5,6,11
P'thinaikos,2540,3,1,1,4,5,11,-6,4
Panionios,2540,4,1,1,4,4,10,-6,4
AEK Athens,2541,1,4,2,0,7,1,6,14
PAOK Salonik,2541,2,3,2,1,15,6,9,11
Panionios,2541,3,1,1,4,4,10,-6,4
P'thinaikos,2541,4,1,1,4,6,15,-9,4
AEK Athens,2542,1,4,2,0,7,1,6,14
PAOK Salonik,2542,2,3,2,1,12,4,8,11
Panionios,2542,3,1,1,4,4,10,-6,4
P'thinaikos,2542,4,1,1,4,4,12,-8,4
AEK Athens,2543,1,4,2,0,7,1,6,14
PAOK Salonik,2543,2,2,3,1,9,4,5,9
P'thinaikos,2543,3,1,2,3,4,9,-5,5
Panionios,2543,4,1,1,4,4,10,-6,4
AEK Athens,2544,1,4,2,0,7,1,6,14
PAOK Salonik,2544,2,3,2,1,10,4,6,11
P'thinaikos,2544,3,1,1,4,4,10,-6,4
Panionios,2544,3,1,1,4,4,10,-6,4
AEK Athens,2545,1,4,2,0,7,1,6,14
PAOK Salonik,2545,2,3,2,1,10,4,6,11
P'thinaikos,2545,3,1,1,4,4,10,-6,4
Panionios,2545,3,1,1,4,4,10,-6,4
AEK Athens,2546,1,4,2,0,7,1,6,14
PAOK Salonik,2546,2,2,2,2,9,7,2,8
P'thinaikos,2546,3,2,1,3,7,9,-2,7
Panionios,2546,4,1,1,4,4,10,-6,4
AEK Athens,2547,1,4,2,0,7,1,6,14
PAOK Salonik,2547,2,2,2,2,9,6,3,8
P'thinaikos,2547,3,2,1,3,6,9,-3,7
Panionios,2547,4,1,1,4,4,10,-6,4
AEK Athens,2548,1,4,2,0,7,1,6,14
PAOK Salonik,2548,2,3,2,1,13,4,9,11
Panionios,2548,3,1,1,4,4,10,-6,4
P'thinaikos,2548,4,1,1,4,4,13,-9,4
AEK Athens,2549,1,4,2,0,7,1,6,14
PAOK Salonik,2549,2,2,3,1,9,4,5,9
P'thinaikos,2549,3,1,2,3,4,9,-5,5
Panionios,2549,4,1,1,4,4,10,-6,4
AEK Athens,2550,1,4,2,0,7,1,6,14
PAOK Salonik,2550,2,3,2,1,10,4,6,11
P'thinaikos,2550,3,1,1,4,4,10,-6,4
Panionios,2550,3,1,1,4,4,10,-6,4
AEK Athens,2551,1,4,2,0,7,1,6,14
PAOK Salonik,2551,2,3,2,1,11,4,7,11
Panionios,2551,3,1,1,4,4,10,-6,4
P'thinaikos,2551,4,1,1,4,4,11,-7,4
AEK Athens,2552,1,4,2,0,7,1,6,14
PAOK Salonik,2552,2,2,2,2,11,7,4,8
P'thinaikos,2552,3,2,1,3,7,11,-4,7
Panionios,2552,4,1,1,4,4,10,-6,4
AEK Athens,2553,1,4,2,0,7,1,6,14
PAOK Salonik,2553,2,2,2,2,9,6,3,8
P'thinaikos,2553,3,2,1,3,6,9,-3,7
Panionios,2553,4,1,1,4,4,10,-6,4
AEK Athens,2554,1,4,2,0,7,1,6,14
PAOK Salonik,2554,2,2,2,2,9,5,4,8
P'thinaikos,2554,3,2,1,3,5,9,-4,7
Panionios,2554,4,1,1,4,4,10,-6,4
AEK Athens,2555,1,4,2,0,7,1,6,14
PAOK Salonik,2555,2,3,2,1,11,5,6,11
P'thinaikos,2555,3,1,1,4,5,11,-6,4
Panionios,2555,4,1,1,4,4,10,-6,4
AEK Athens,2556,1,4,2,0,7,1,6,14
PAOK Salonik,2556,2,2,2,2,10,7,3,8
P'thinaikos,2556,3,2,1,3,7,10,-3,7
Panionios,2556,4,1,1,4,4,10,-6,4
AEK Athens,2557,1,4,2,0,7,1,6,14
PAOK Salonik,2557,2,2,2,2,9,7,2,8
P'thinaikos,2557,3,2,1,3,7,9,-2,7
Panionios,2557,4,1,1,4,4,10,-6,4
AEK Athens,2558,1,4,2,0,7,1,6,14
PAOK Salonik,2558,2,3,2,1,12,5,7,11
Panionios,2558,3,1,1,4,4,10,-6,4
P'thinaikos,2558,4,1,1,4,5,12,-7,4
AEK Athens,2559,1,4,2,0,7,1,6,14
PAOK Salonik,2559,2,2,3,1,9,4,5,9
P'thinaikos,2559,3,1,2,3,4,9,-5,5
Panionios,2559,4,1,1,4,4,10,-6,4
AEK Athens,2560,1,4,2,0,7,1,6,14
PAOK Salonik,2560,2,3,2,1,13,5,8,11
Panionios,2560,3,1,1,4,4,10,-6,4
P'thinaikos,2560,4,1,1,4,5,13,-8,4
AEK Athens,2561,1,4,2,0,7,1,6,14
PAOK Salonik,2561,2,2,2,2,10,6,4,8
P'thinaikos,2561,3,2,1,3,6,10,-4,7
Panionios,2561,4,1,1,4,4,10,-6,4
AEK Athens,2562,1,4,2,0,7,1,6,14
PAOK Salonik,2562,2,3,2,1,11,4,7,11
Panionios,2562,3,1,1,4,4,10,-6,4
P'thinaikos,2562,4,1,1,4,4,11,-7,4
AEK Athens,2563,1,4,2,0,7,1,6,14
PAOK Salonik,2563,2,3,2,1,13,7,6,11
P'thinaikos,2563,3,1,1,4,7,13,-6,4
Panionios,2563,4,1,1,4,4,10,-6,4
AEK Athens,2564,1,4,2,0,7,1,6,14
PAOK Salonik,2564,2,3,2,1,12,5,7,11
Panionios,2564,3,1,1,4,4,10,-6,4
P'thinaikos,2564,4,1,1,4,5,12,-7,4
AEK Athens,2565,1,4,2,0,7,1,6,14
PAOK Salonik,2565,2,2,2,2,9,5,4,8
P'thinaikos,2565,3,2,1,3,5,9,-4,7
Panionios,2565,4,1,1,4,4,10,-6,4
AEK Athens,2566,1,4,2,0,7,1,6,14
PAOK Salonik,2566,2,2,3,1,9,4,5,9
P'thinaikos,2566,3,1,2,3,4,9,-5,5
Panionios,2566,4,1,1,4,4,10,-6,4
AEK Athens,2567,1,4,2,0,7,1,6,14
PAOK Salonik,2567,2,2,3,1,10,5,5,9
P'thinaikos,2567,3,1,2,3,5,10,-5,5
Panionios,2567,4,1,1,4,4,10,-6,4
AEK Athens,2568,1,4,2,0,7,1,6,14
PAOK Salonik,2568,2,2,2,2,10,6,4,8
P'thinaikos,2568,3,2,1,3,6,10,-4,7
Panionios,2568,4,1,1,4,4,10,-6,4
AEK Athens,2569,1,4,2,0,7,1,6,14
PAOK Salonik,2569,2,3,2,1,10,4,6,11
P'thinaikos,2569,3,1,1,4,4,10,-6,4
Panionios,2569,3,1,1,4,4,10,-6,4
AEK Athens,2570,1,4,2,0,7,1,6,14
PAOK Salonik,2570,2,2,3,1,10,5,5,9
P'thinaikos,2570,3,1,2,3,5,10,-5,5
Panionios,2570,4,1,1,4,4,10,-6,4
AEK Athens,2571,1,4,2,0,7,1,6,14
PAOK Salonik,2571,2,2,3,1,9,4,5,9
P'thinaikos,2571,3,1,2,3,4,9,-5,5
Panionios,2571,4,1,1,4,4,10,-6,4
AEK Athens,2572,1,4,2,0,7,1,6,14
PAOK Salonik,2572,2,2,3,1,9,4,5,9
P'thinaikos,2572,3,1,2,3,4,9,-5,5
Panionios,2572,4,1,1,4,4,10,-6,4
AEK Athens,2573,1,4,2,0,7,1,6,14
PAOK Salonik,2573,2,2,3,1,11,6,5,9
P'thinaikos,2573,3,1,2,3,6,11,-5,5
Panionios,2573,4,1,1,4,4,10,-6,4
AEK Athens,2574,1,4,2,0,7,1,6,14
PAOK Salonik,2574,2,2,2,2,9,5,4,8
P'thinaikos,2574,3,2,1,3,5,9,-4,7
Panionios,2574,4,1,1,4,4,10,-6,4
AEK Athens,2575,1,4,2,0,7,1,6,14
PAOK Salonik,2575,2,3,2,1,11,5,6,11
P'thinaikos,2575,3,1,1,4,5,11,-6,4
Panionios,2575,4,1,1,4,4,10,-6,4
AEK Athens,2576,1,4,2,0,7,1,6,14
PAOK Salonik,2576,2,3,2,1,11,5,6,11
P'thinaikos,2576,3,1,1,4,5,11,-6,4
Panionios,2576,4,1,1,4,4,10,-6,4
AEK Athens,2577,1,4,2,0,7,1,6,14
PAOK Salonik,2577,2,3,2,1,11,5,6,11
P'thinaikos,2577,3,1,1,4,5,11,-6,4
Panionios,2577,4,1,1,4,4,10,-6,4
AEK Athens,2578,1,4,2,0,7,1,6,14
PAOK Salonik,2578,2,2,2,2,10,7,3,8
P'thinaikos,2578,3,2,1,3,7,10,-3,7
Panionios,2578,4,1,1,4,4,10,-6,4
AEK Athens,2579,1,4,2,0,7,1,6,14
PAOK Salonik,2579,2,3,2,1,10,4,6,11
P'thinaikos,2579,3,1,1,4,4,10,-6,4
Panionios,2579,3,1,1,4,4,10,-6,4
AEK Athens,2580,1,4,2,0,7,1,6,14
PAOK Salonik,2580,2,2,3,1,11,6,5,9
P'thinaikos,2580,3,1,2,3,6,11,-5,5
Panionios,2580,4,1,1,4,4,10,-6,4
AEK Athens,2581,1,4,2,0,7,1,6,14
PAOK Salonik,2581,2,2,2,2,10,6,4,8
P'thinaikos,2581,3,2,1,3,6,10,-4,7
Panionios,2581,4,1,1,4,4,10,-6,4
AEK Athens,2582,1,4,2,0,7,1,6,14
PAOK Salonik,2582,2,2,2,2,11,7,4,8
P'thinaikos,2582,3,2,1,3,7,11,-4,7
Panionios,2582,4,1,1,4,4,10,-6,4
AEK Athens,2583,1,4,2,0,7,1,6,14
PAOK Salonik,2583,2,3,2,1,11,5,6,11
P'thinaikos,2583,3,1,1,4,5,11,-6,4
Panionios,2583,4,1,1,4,4,10,-6,4
AEK Athens,2584,1,4,2,0,7,1,6,14
PAOK Salonik,2584,2,2,2,2,10,7,3,8
P'thinaikos,2584,3,2,1,3,7,10,-3,7
Panionios,2584,4,1,1,4,4,10,-6,4
AEK Athens,2585,1,4,2,0,7,1,6,14
PAOK Salonik,2585,2,2,3,1,10,5,5,9
P'thinaikos,2585,3,1,2,3,5,10,-5,5
Panionios,2585,4,1,1,4,4,10,-6,4
AEK Athens,2586,1,4,2,0,7,1,6,14
PAOK Salonik,2586,2,3,2,1,10,4,6,11
P'thinaikos,2586,3,1,1,4,4,10,-6,4
Panionios,2586,3,1,1,4,4,10,-6,4
AEK Athens,2587,1,4,2,0,7,1,6,14
PAOK Salonik,2587,2,2,3,1,10,5,5,9
P'thinaikos,2587,3,1,2,3,5,10,-5,5
Panionios,2587,4,1,1,4,4,10,-6,4
AEK Athens,2588,1,4,2,0,7,1,6,14
PAOK Salonik,2588,2,2,2,2,11,7,4,8
P'thinaikos,2588,3,2,1,3,7,11,-4,7
Panionios,2588,4,1,1,4,4,10,-6,4
AEK Athens,2589,1,4,2,0,7,1,6,14
PAOK Salonik,2589,2,3,2,1,11,5,6,11
P'thinaikos,2589,3,1,1,4,5,11,-6,4
Panionios,2589,4,1,1,4,4,10,-6,4
AEK Athens,2590,1,4,2,0,7,1,6,14
PAOK Salonik,2590,2,2,2,2,11,8,3,8
P'thinaikos,2590,3,2,1,3,8,11,-3,7
Panionios,2590,4,1,1,4,4,10,-6,4
AEK Athens,2591,1,4,2,0,7,1,6,14
PAOK Salonik,2591,2,3,2,1,13,5,8,11
Panionios,2591,3,1,1,4,4,10,-6,4
P'thinaikos,2591,4,1,1,4,5,13,-8,4
AEK Athens,2592,1,4,2,0,7,1,6,14
PAOK Salonik,2592,2,3,2,1,12,5,7,11
Panionios,2592,3,1,1,4,4,10,-6,4
P'thinaikos,2592,4,1,1,4,5,12,-7,4
AEK Athens,2593,1,4,2,0,7,1,6,14
PAOK Salonik,2593,2,3,2,1,10,4,6,11
P'thinaikos,2593,3,1,1,4,4,10,-6,4
Panionios,2593,3,1,1,4,4,10,-6,4
AEK Athens,2594,1,4,2,0,7,1,6,14
PAOK Salonik,2594,2,2,2,2,10,7,3,8
P'thinaikos,2594,3,2,1,3,7,10,-3,7
Panionios,2594,4,1,1,4,4,10,-6,4
AEK Athens,2595,1,4,2,0,7,1,6,14
PAOK Salonik,2595,2,2,3,1,9,4,5,9
P'thinaikos,2595,3,1,2,3,4,9,-5,5
Panionios,2595,4,1,1,4,4,10,-6,4
AEK Athens,2596,1,4,2,0,7,1,6,14
PAOK Salonik,2596,2,2,2,2,9,6,3,8
P'thinaikos,2596,3,2,1,3,6,9,-3,7
Panionios,2596,4,1,1,4,4,10,-6,4
AEK Athens,2597,1,4,2,0,7,1,6,14
PAOK Salonik,2597,2,3,2,1,10,4,6,11
P'thinaikos,2597,3,1,1,4,4,10,-6,4
Panionios,2597,3,1,1,4,4,10,-6,4
AEK Athens,2598,1,4,2,0,7,1,6,14
PAOK Salonik,2598,2,2,3,1,12,7,5,9
P'thinaikos,2598,3,1,2,3,7,12,-5,5
Panionios,2598,4,1,1,4,4,10,-6,4
AEK Athens,2599,1,4,2,0,7,1,6,14
PAOK Salonik,2599,2,2,2,2,9,7,2,8
P'thinaikos,2599,3,2,1,3,7,9,-2,7
Panionios,2599,4,1,1,4,4,10,-6,4
AEK Athens,2600,1,4,2,0,7,1,6,14
PAOK Salonik,2600,2,3,2,1,11,5,6,11
P'thinaikos,2600,3,1,1,4,5,11,-6,4
Panionios,2600,4,1,1,4,4,10,-6,4
AEK Athens,2601,1,4,2,0,7,1,6,14
PAOK Salonik,2601,2,3,2,1,11,5,6,11
P'thinaikos,2601,3,1,1,4,5,11,-6,4
Panionios,2601,4,1,1,4,4,10,-6,4
AEK Athens,2602,1,4,2,0,7,1,6,14
PAOK Salonik,2602,2,2,2,2,9,5,4,8
P'thinaikos,2602,3,2,1,3,5,9,-4,7
Panionios,2602,4,1,1,4,4,10,-6,4
AEK Athens,2603,1,4,2,0,7,1,6,14
PAOK Salonik,2603,2,3,2,1,10,4,6,11
P'thinaikos,2603,3,1,1,4,4,10,-6,4
Panionios,2603,3,1,1,4,4,10,-6,4
AEK Athens,2604,1,4,2,0,7,1,6,14
PAOK Salonik,2604,2,2,2,2,9,5,4,8
P'thinaikos,2604,3,2,1,3,5,9,-4,7
Panionios,2604,4,1,1,4,4,10,-6,4
AEK Athens,2605,1,4,2,0,7,1,6,14
PAOK Salonik,2605,2,3,2,1,10,4,6,11
P'thinaikos,2605,3,1,1,4,4,10,-6,4
Panionios,2605,3,1,1,4,4,10,-6,4
AEK Athens,2606,1,4,2,0,7,1,6,14
PAOK Salonik,2606,2,2,3,1,10,5,5,9
P'thinaikos,2606,3,1,2,3,5,10,-5,5
Panionios,2606,4,1,1,4,4,10,-6,4
AEK Athens,2607,1,4,2,0,7,1,6,14
PAOK Salonik,2607,2,2,2,2,10,8,2,8
P'thinaikos,2607,3,2,1,3,8,10,-2,7
Panionios,2607,4,1,1,4,4,10,-6,4
AEK Athens,2608,1,4,2,0,7,1,6,14
PAOK Salonik,2608,2,3,2,1,13,4,9,11
Panionios,2608,3,1,1,4,4,10,-6,4
P'thinaikos,2608,4,1,1,4,4,13,-9,4
AEK Athens,2609,1,4,2,0,7,1,6,14
PAOK Salonik,2609,2,2,3,1,10,5,5,9
P'thinaikos,2609,3,1,2,3,5,10,-5,5
Panionios,2609,4,1,1,4,4,10,-6,4
AEK Athens,2610,1,4,2,0,7,1,6,14
PAOK Salonik,2610,2,2,3,1,11,6,5,9
P'thinaikos,2610,3,1,2,3,6,11,-5,5
Panionios,2610,4,1,1,4,4,10,-6,4
AEK Athens,2611,1,4,2,0,7,1,6,14
PAOK Salonik,2611,2,2,2,2,9,5,4,8
P'thinaikos,2611,3,2,1,3,5,9,-4,7
Panionios,2611,4,1,1,4,4,10,-6,4
AEK Athens,2612,1,4,2,0,7,1,6,14
PAOK Salonik,2612,2,2,2,2,9,6,3,8
P'thinaikos,2612,3,2,1,3,6,9,-3,7
Panionios,2612,4,1,1,4,4,10,-6,4
AEK Athens,2613,1,4,2,0,7,1,6,14
PAOK Salonik,2613,2,3,2,1,12,4,8,11
Panionios,2613,3,1,1,4,4,10,-6,4
P'thinaikos,2613,4,1,1,4,4,12,-8,4
AEK Athens,2614,1,4,2,0,7,1,6,14
PAOK Salonik,2614,2,3,2,1,12,5,7,11
Panionios,2614,3,1,1,4,4,10,-6,4
P'thinaikos,2614,4,1,1,4,5,12,-7,4
AEK Athens,2615,1,4,2,0,7,1,6,14
PAOK Salonik,2615,2,3,2,1,11,5,6,11
P'thinaikos,2615,3,1,1,4,5,11,-6,4
Panionios,2615,4,1,1,4,4,10,-6,4
AEK Athens,2616,1,4,2,0,7,1,6,14
PAOK Salonik,2616,2,3,2,1,10,4,6,11
P'thinaikos,2616,3,1,1,4,4,10,-6,4
Panionios,2616,3,1,1,4,4,10,-6,4
AEK Athens,2617,1,4,2,0,7,1,6,14
PAOK Salonik,2617,2,2,2,2,9,5,4,8
P'thinaikos,2617,3,2,1,3,5,9,-4,7
Panionios,2617,4,1,1,4,4,10,-6,4
AEK Athens,2618,1,4,2,0,7,1,6,14
PAOK Salonik,2618,2,2,3,1,10,5,5,9
P'thinaikos,2618,3,1,2,3,5,10,-5,5
Panionios,2618,4,1,1,4,4,10,-6,4
AEK Athens,2619,1,4,2,0,7,1,6,14
PAOK Salonik,2619,2,2,3,1,10,5,5,9
P'thinaikos,2619,3,1,2,3,5,10,-5,5
Panionios,2619,4,1,1,4,4,10,-6,4
AEK Athens,2620,1,4,2,0,7,1,6,14
PAOK Salonik,2620,2,3,2,1,11,4,7,11
Panionios,2620,3,1,1,4,4,10,-6,4
P'thinaikos,2620,4,1,1,4,4,11,-7,4
AEK Athens,2621,1,4,2,0,7,1,6,14
PAOK Salonik,2621,2,3,2,1,11,4,7,11
Panionios,2621,3,1,1,4,4,10,-6,4
P'thinaikos,2621,4,1,1,4,4,11,-7,4
AEK Athens,2622,1,4,2,0,7,1,6,14
PAOK Salonik,2622,2,2,3,1,11,6,5,9
P'thinaikos,2622,3,1,2,3,6,11,-5,5
Panionios,2622,4,1,1,4,4,10,-6,4
AEK Athens,2623,1,4,2,0,7,1,6,14
PAOK Salonik,2623,2,3,2,1,10,4,6,11
P'thinaikos,2623,3,1,1,4,4,10,-6,4
Panionios,2623,3,1,1,4,4,10,-6,4
AEK Athens,2624,1,4,2,0,7,1,6,14
PAOK Salonik,2624,2,3,2,1,13,4,9,11
Panionios,2624,3,1,1,4,4,10,-6,4
P'thinaikos,2624,4,1,1,4,4,13,-9,4
AEK Athens,2625,1,4,2,0,7,1,6,14
PAOK Salonik,2625,2,2,2,2,9,5,4,8
P'thinaikos,2625,3,2,1,3,5,9,-4,7
Panionios,2625,4,1,1,4,4,10,-6,4
AEK Athens,2626,1,4,2,0,7,1,6,14
PAOK Salonik,2626,2,2,3,1,10,5,5,9
P'thinaikos,2626,3,1,2,3,5,10,-5,5
Panionios,2626,4,1,1,4,4,10,-6,4
AEK Athens,2627,1,4,2,0,7,1,6,14
PAOK Salonik,2627,2,2,3,1,11,6,5,9
P'thinaikos,2627,3,1,2,3,6,11,-5,5
Panionios,2627,4,1,1,4,4,10,-6,4
AEK Athens,2628,1,4,2,0,7,1,6,14
PAOK Salonik,2628,2,2,2,2,9,5,4,8
P'thinaikos,2628,3,2,1,3,5,9,-4,7
Panionios,2628,4,1,1,4,4,10,-6,4
AEK Athens,2629,1,4,2,0,7,1,6,14
PAOK Salonik,2629,2,2,3,1,10,5,5,9
P'thinaikos,2629,3,1,2,3,5,10,-5,5
Panionios,2629,4,1,1,4,4,10,-6,4
AEK Athens,2630,1,4,2,0,7,1,6,14
PAOK Salonik,2630,2,3,2,1,12,5,7,11
Panionios,2630,3,1,1,4,4,10,-6,4
P'thinaikos,2630,4,1,1,4,5,12,-7,4
AEK Athens,2631,1,4,2,0,7,1,6,14
PAOK Salonik,2631,2,3,2,1,11,4,7,11
Panionios,2631,3,1,1,4,4,10,-6,4
P'thinaikos,2631,4,1,1,4,4,11,-7,4
AEK Athens,2632,1,4,2,0,7,1,6,14
PAOK Salonik,2632,2,2,2,2,9,6,3,8
P'thinaikos,2632,3,2,1,3,6,9,-3,7
Panionios,2632,4,1,1,4,4,10,-6,4
AEK Athens,2633,1,4,2,0,7,1,6,14
PAOK Salonik,2633,2,3,2,1,11,5,6,11
P'thinaikos,2633,3,1,1,4,5,11,-6,4
Panionios,2633,4,1,1,4,4,10,-6,4
AEK Athens,2634,1,4,2,0,7,1,6,14
PAOK Salonik,2634,2,2,2,2,9,5,4,8
P'thinaikos,2634,3,2,1,3,5,9,-4,7
Panionios,2634,4,1,1,4,4,10,-6,4
AEK Athens,2635,1,4,2,0,7,1,6,14
PAOK Salonik,2635,2,3,2,1,11,4,7,11
Panionios,2635,3,1,1,4,4,10,-6,4
P'thinaikos,2635,4,1,1,4,4,11,-7,4
AEK Athens,2636,1,4,2,0,7,1,6,14
PAOK Salonik,2636,2,2,3,1,10,5,5,9
P'thinaikos,2636,3,1,2,3,5,10,-5,5
Panionios,2636,4,1,1,4,4,10,-6,4
AEK Athens,2637,1,4,2,0,7,1,6,14
PAOK Salonik,2637,2,2,2,2,10,7,3,8
P'thinaikos,2637,3,2,1,3,7,10,-3,7
Panionios,2637,4,1,1,4,4,10,-6,4
AEK Athens,2638,1,4,2,0,7,1,6,14
PAOK Salonik,2638,2,3,2,1,12,5,7,11
Panionios,2638,3,1,1,4,4,10,-6,4
P'thinaikos,2638,4,1,1,4,5,12,-7,4
AEK Athens,2639,1,4,2,0,7,1,6,14
PAOK Salonik,2639,2,2,3,1,10,5,5,9
P'thinaikos,2639,3,1,2,3,5,10,-5,5
Panionios,2639,4,1,1,4,4,10,-6,4
AEK Athens,2640,1,4,2,0,7,1,6,14
PAOK Salonik,2640,2,2,2,2,10,7,3,8
P'thinaikos,2640,3,2,1,3,7,10,-3,7
Panionios,2640,4,1,1,4,4,10,-6,4
AEK Athens,2641,1,4,2,0,7,1,6,14
PAOK Salonik,2641,2,3,2,1,11,5,6,11
P'thinaikos,2641,3,1,1,4,5,11,-6,4
Panionios,2641,4,1,1,4,4,10,-6,4
AEK Athens,2642,1,4,2,0,7,1,6,14
PAOK Salonik,2642,2,2,2,2,9,5,4,8
P'thinaikos,2642,3,2,1,3,5,9,-4,7
Panionios,2642,4,1,1,4,4,10,-6,4
AEK Athens,2643,1,4,2,0,7,1,6,14
PAOK Salonik,2643,2,3,2,1,11,5,6,11
P'thinaikos,2643,3,1,1,4,5,11,-6,4
Panionios,2643,4,1,1,4,4,10,-6,4
AEK Athens,2644,1,4,2,0,7,1,6,14
PAOK Salonik,2644,2,2,3,1,9,4,5,9
P'thinaikos,2644,3,1,2,3,4,9,-5,5
Panionios,2644,4,1,1,4,4,10,-6,4
AEK Athens,2645,1,4,2,0,7,1,6,14
PAOK Salonik,2645,2,3,2,1,10,4,6,11
P'thinaikos,2645,3,1,1,4,4,10,-6,4
Panionios,2645,3,1,1,4,4,10,-6,4
AEK Athens,2646,1,4,2,0,7,1,6,14
PAOK Salonik,2646,2,2,2,2,9,5,4,8
P'thinaikos,2646,3,2,1,3,5,9,-4,7
Panionios,2646,4,1,1,4,4,10,-6,4
AEK Athens,2647,1,4,2,0,7,1,6,14
PAOK Salonik,2647,2,2,2,2,10,6,4,8
P'thinaikos,2647,3,2,1,3,6,10,-4,7
Panionios,2647,4,1,1,4,4,10,-6,4
AEK Athens,2648,1,4,2,0,7,1,6,14
PAOK Salonik,2648,2,2,2,2,9,5,4,8
P'thinaikos,2648,3,2,1,3,5,9,-4,7
Panionios,2648,4,1,1,4,4,10,-6,4
AEK Athens,2649,1,4,2,0,7,1,6,14
PAOK Salonik,2649,2,2,2,2,9,5,4,8
P'thinaikos,2649,3,2,1,3,5,9,-4,7
Panionios,2649,4,1,1,4,4,10,-6,4
AEK Athens,2650,1,4,2,0,7,1,6,14
PAOK Salonik,2650,2,2,3,1,10,5,5,9
P'thinaikos,2650,3,1,2,3,5,10,-5,5
Panionios,2650,4,1,1,4,4,10,-6,4
AEK Athens,2651,1,4,2,0,7,1,6,14
PAOK Salonik,2651,2,3,2,1,11,5,6,11
P'thinaikos,2651,3,1,1,4,5,11,-6,4
Panionios,2651,4,1,1,4,4,10,-6,4
AEK Athens,2652,1,4,2,0,7,1,6,14
PAOK Salonik,2652,2,3,2,1,11,4,7,11
Panionios,2652,3,1,1,4,4,10,-6,4
P'thinaikos,2652,4,1,1,4,4,11,-7,4
AEK Athens,2653,1,4,2,0,7,1,6,14
PAOK Salonik,2653,2,3,2,1,12,4,8,11
Panionios,2653,3,1,1,4,4,10,-6,4
P'thinaikos,2653,4,1,1,4,4,12,-8,4
AEK Athens,2654,1,4,2,0,7,1,6,14
PAOK Salonik,2654,2,2,2,2,9,5,4,8
P'thinaikos,2654,3,2,1,3,5,9,-4,7
Panionios,2654,4,1,1,4,4,10,-6,4
AEK Athens,2655,1,4,2,0,7,1,6,14
PAOK Salonik,2655,2,3,2,1,11,5,6,11
P'thinaikos,2655,3,1,1,4,5,11,-6,4
Panionios,2655,4,1,1,4,4,10,-6,4
AEK Athens,2656,1,4,2,0,7,1,6,14
PAOK Salonik,2656,2,2,2,2,9,5,4,8
P'thinaikos,2656,3,2,1,3,5,9,-4,7
Panionios,2656,4,1,1,4,4,10,-6,4
AEK Athens,2657,1,4,2,0,7,1,6,14
PAOK Salonik,2657,2,3,2,1,12,6,6,11
P'thinaikos,2657,3,1,1,4,6,12,-6,4
Panionios,2657,4,1,1,4,4,10,-6,4
AEK Athens,2658,1,4,2,0,7,1,6,14
PAOK Salonik,2658,2,2,3,1,10,5,5,9
P'thinaikos,2658,3,1,2,3,5,10,-5,5
Panionios,2658,4,1,1,4,4,10,-6,4
AEK Athens,2659,1,4,2,0,7,1,6,14
PAOK Salonik,2659,2,2,2,2,10,6,4,8
P'thinaikos,2659,3,2,1,3,6,10,-4,7
Panionios,2659,4,1,1,4,4,10,-6,4
AEK Athens,2660,1,4,2,0,7,1,6,14
PAOK Salonik,2660,2,3,2,1,12,4,8,11
Panionios,2660,3,1,1,4,4,10,-6,4
P'thinaikos,2660,4,1,1,4,4,12,-8,4
AEK Athens,2661,1,4,2,0,7,1,6,14
PAOK Salonik,2661,2,2,2,2,9,6,3,8
P'thinaikos,2661,3,2,1,3,6,9,-3,7
Panionios,2661,4,1,1,4,4,10,-6,4
AEK Athens,2662,1,4,2,0,7,1,6,14
PAOK Salonik,2662,2,2,2,2,10,6,4,8
P'thinaikos,2662,3,2,1,3,6,10,-4,7
Panionios,2662,4,1,1,4,4,10,-6,4
AEK Athens,2663,1,4,2,0,7,1,6,14
PAOK Salonik,2663,2,2,3,1,9,4,5,9
P'thinaikos,2663,3,1,2,3,4,9,-5,5
Panionios,2663,4,1,1,4,4,10,-6,4
AEK Athens,2664,1,4,2,0,7,1,6,14
PAOK Salonik,2664,2,3,2,1,11,5,6,11
P'thinaikos,2664,3,1,1,4,5,11,-6,4
Panionios,2664,4,1,1,4,4,10,-6,4
AEK Athens,2665,1,4,2,0,7,1,6,14
PAOK Salonik,2665,2,2,2,2,10,6,4,8
P'thinaikos,2665,3,2,1,3,6,10,-4,7
Panionios,2665,4,1,1,4,4,10,-6,4
AEK Athens,2666,1,4,2,0,7,1,6,14
PAOK Salonik,2666,2,2,2,2,10,6,4,8
P'thinaikos,2666,3,2,1,3,6,10,-4,7
Panionios,2666,4,1,1,4,4,10,-6,4
AEK Athens,2667,1,4,2,0,7,1,6,14
PAOK Salonik,2667,2,3,2,1,13,5,8,11
Panionios,2667,3,1,1,4,4,10,-6,4
P'thinaikos,2667,4,1,1,4,5,13,-8,4
AEK Athens,2668,1,4,2,0,7,1,6,14
PAOK Salonik,2668,2,3,2,1,12,4,8,11
Panionios,2668,3,1,1,4,4,10,-6,4
P'thinaikos,2668,4,1,1,4,4,12,-8,4
AEK Athens,2669,1,4,2,0,7,1,6,14
PAOK Salonik,2669,2,3,2,1,11,5,6,11
P'thinaikos,2669,3,1,1,4,5,11,-6,4
Panionios,2669,4,1,1,4,4,10,-6,4
AEK Athens,2670,1,4,2,0,7,1,6,14
PAOK Salonik,2670,2,2,3,1,10,5,5,9
P'thinaikos,2670,3,1,2,3,5,10,-5,5
Panionios,2670,4,1,1,4,4,10,-6,4
AEK Athens,2671,1,4,2,0,7,1,6,14
PAOK Salonik,2671,2,2,3,1,11,6,5,9
P'thinaikos,2671,3,1,2,3,6,11,-5,5
Panionios,2671,4,1,1,4,4,10,-6,4
AEK Athens,2672,1,4,2,0,7,1,6,14
PAOK Salonik,2672,2,2,2,2,11,8,3,8
P'thinaikos,2672,3,2,1,3,8,11,-3,7
Panionios,2672,4,1,1,4,4,10,-6,4
AEK Athens,2673,1,4,2,0,7,1,6,14
PAOK Salonik,2673,2,2,2,2,9,7,2,8
P'thinaikos,2673,3,2,1,3,7,9,-2,7
Panionios,2673,4,1,1,4,4,10,-6,4
AEK Athens,2674,1,4,2,0,7,1,6,14
PAOK Salonik,2674,2,2,2,2,11,8,3,8
P'thinaikos,2674,3,2,1,3,8,11,-3,7
Panionios,2674,4,1,1,4,4,10,-6,4
AEK Athens,2675,1,4,2,0,7,1,6,14
PAOK Salonik,2675,2,3,2,1,11,5,6,11
P'thinaikos,2675,3,1,1,4,5,11,-6,4
Panionios,2675,4,1,1,4,4,10,-6,4
AEK Athens,2676,1,4,2,0,7,1,6,14
PAOK Salonik,2676,2,3,2,1,10,4,6,11
P'thinaikos,2676,3,1,1,4,4,10,-6,4
Panionios,2676,3,1,1,4,4,10,-6,4
AEK Athens,2677,1,4,2,0,7,1,6,14
PAOK Salonik,2677,2,2,3,1,10,5,5,9
P'thinaikos,2677,3,1,2,3,5,10,-5,5
Panionios,2677,4,1,1,4,4,10,-6,4
AEK Athens,2678,1,4,2,0,7,1,6,14
PAOK Salonik,2678,2,3,2,1,10,4,6,11
P'thinaikos,2678,3,1,1,4,4,10,-6,4
Panionios,2678,3,1,1,4,4,10,-6,4
AEK Athens,2679,1,4,2,0,7,1,6,14
PAOK Salonik,2679,2,2,3,1,12,7,5,9
P'thinaikos,2679,3,1,2,3,7,12,-5,5
Panionios,2679,4,1,1,4,4,10,-6,4
AEK Athens,2680,1,4,2,0,7,1,6,14
PAOK Salonik,2680,2,2,2,2,9,8,1,8
P'thinaikos,2680,3,2,1,3,8,9,-1,7
Panionios,2680,4,1,1,4,4,10,-6,4
AEK Athens,2681,1,4,2,0,7,1,6,14
PAOK Salonik,2681,2,2,2,2,10,6,4,8
P'thinaikos,2681,3,2,1,3,6,10,-4,7
Panionios,2681,4,1,1,4,4,10,-6,4
AEK Athens,2682,1,4,2,0,7,1,6,14
PAOK Salonik,2682,2,2,2,2,10,6,4,8
P'thinaikos,2682,3,2,1,3,6,10,-4,7
Panionios,2682,4,1,1,4,4,10,-6,4
AEK Athens,2683,1,4,2,0,7,1,6,14
PAOK Salonik,2683,2,3,2,1,10,4,6,11
P'thinaikos,2683,3,1,1,4,4,10,-6,4
Panionios,2683,3,1,1,4,4,10,-6,4
AEK Athens,2684,1,4,2,0,7,1,6,14
PAOK Salonik,2684,2,2,2,2,9,6,3,8
P'thinaikos,2684,3,2,1,3,6,9,-3,7
Panionios,2684,4,1,1,4,4,10,-6,4
AEK Athens,2685,1,4,2,0,7,1,6,14
PAOK Salonik,2685,2,3,2,1,12,5,7,11
Panionios,2685,3,1,1,4,4,10,-6,4
P'thinaikos,2685,4,1,1,4,5,12,-7,4
AEK Athens,2686,1,4,2,0,7,1,6,14
PAOK Salonik,2686,2,2,3,1,9,4,5,9
P'thinaikos,2686,3,1,2,3,4,9,-5,5
Panionios,2686,4,1,1,4,4,10,-6,4
AEK Athens,2687,1,4,2,0,7,1,6,14
PAOK Salonik,2687,2,2,2,2,10,8,2,8
P'thinaikos,2687,3,2,1,3,8,10,-2,7
Panionios,2687,4,1,1,4,4,10,-6,4
AEK Athens,2688,1,4,2,0,7,1,6,14
PAOK Salonik,2688,2,3,2,1,12,5,7,11
Panionios,2688,3,1,1,4,4,10,-6,4
P'thinaikos,2688,4,1,1,4,5,12,-7,4
AEK Athens,2689,1,4,2,0,7,1,6,14
PAOK Salonik,2689,2,2,2,2,9,5,4,8
P'thinaikos,2689,3,2,1,3,5,9,-4,7
Panionios,2689,4,1,1,4,4,10,-6,4
AEK Athens,2690,1,4,2,0,7,1,6,14
PAOK Salonik,2690,2,2,3,1,9,4,5,9
P'thinaikos,2690,3,1,2,3,4,9,-5,5
Panionios,2690,4,1,1,4,4,10,-6,4
AEK Athens,2691,1,4,2,0,7,1,6,14
PAOK Salonik,2691,2,2,3,1,11,6,5,9
P'thinaikos,2691,3,1,2,3,6,11,-5,5
Panionios,2691,4,1,1,4,4,10,-6,4
AEK Athens,2692,1,4,2,0,7,1,6,14
PAOK Salonik,2692,2,3,2,1,12,5,7,11
Panionios,2692,3,1,1,4,4,10,-6,4
P'thinaikos,2692,4,1,1,4,5,12,-7,4
AEK Athens,2693,1,4,2,0,7,1,6,14
PAOK Salonik,2693,2,2,2,2,9,5,4,8
P'thinaikos,2693,3,2,1,3,5,9,-4,7
Panionios,2693,4,1,1,4,4,10,-6,4
AEK Athens,2694,1,4,2,0,7,1,6,14
PAOK Salonik,2694,2,3,2,1,10,4,6,11
P'thinaikos,2694,3,1,1,4,4,10,-6,4
Panionios,2694,3,1,1,4,4,10,-6,4
AEK Athens,2695,1,4,2,0,7,1,6,14
PAOK Salonik,2695,2,2,3,1,9,4,5,9
P'thinaikos,2695,3,1,2,3,4,9,-5,5
Panionios,2695,4,1,1,4,4,10,-6,4
AEK Athens,2696,1,4,2,0,7,1,6,14
PAOK Salonik,2696,2,2,3,1,11,6,5,9
P'thinaikos,2696,3,1,2,3,6,11,-5,5
Panionios,2696,4,1,1,4,4,10,-6,4
AEK Athens,2697,1,4,2,0,7,1,6,14
PAOK Salonik,2697,2,2,3,1,10,5,5,9
P'thinaikos,2697,3,1,2,3,5,10,-5,5
Panionios,2697,4,1,1,4,4,10,-6,4
AEK Athens,2698,1,4,2,0,7,1,6,14
PAOK Salonik,2698,2,2,2,2,9,5,4,8
P'thinaikos,2698,3,2,1,3,5,9,-4,7
Panionios,2698,4,1,1,4,4,10,-6,4
AEK Athens,2699,1,4,2,0,7,1,6,14
PAOK Salonik,2699,2,2,3,1,10,5,5,9
P'thinaikos,2699,3,1,2,3,5,10,-5,5
Panionios,2699,4,1,1,4,4,10,-6,4
AEK Athens,2700,1,4,2,0,7,1,6,14
PAOK Salonik,2700,2,2,2,2,10,7,3,8
P'thinaikos,2700,3,2,1,3,7,10,-3,7
Panionios,2700,4,1,1,4,4,10,-6,4
AEK Athens,2701,1,4,2,0,7,1,6,14
PAOK Salonik,2701,2,3,2,1,11,5,6,11
P'thinaikos,2701,3,1,1,4,5,11,-6,4
Panionios,2701,4,1,1,4,4,10,-6,4
AEK Athens,2702,1,4,2,0,7,1,6,14
PAOK Salonik,2702,2,2,2,2,10,6,4,8
P'thinaikos,2702,3,2,1,3,6,10,-4,7
Panionios,2702,4,1,1,4,4,10,-6,4
AEK Athens,2703,1,4,2,0,7,1,6,14
PAOK Salonik,2703,2,2,3,1,12,7,5,9
P'thinaikos,2703,3,1,2,3,7,12,-5,5
Panionios,2703,4,1,1,4,4,10,-6,4
AEK Athens,2704,1,4,2,0,7,1,6,14
PAOK Salonik,2704,2,3,2,1,12,5,7,11
Panionios,2704,3,1,1,4,4,10,-6,4
P'thinaikos,2704,4,1,1,4,5,12,-7,4
AEK Athens,2705,1,4,2,0,7,1,6,14
PAOK Salonik,2705,2,2,3,1,9,4,5,9
P'thinaikos,2705,3,1,2,3,4,9,-5,5
Panionios,2705,4,1,1,4,4,10,-6,4
AEK Athens,2706,1,4,2,0,7,1,6,14
PAOK Salonik,2706,2,3,2,1,12,5,7,11
Panionios,2706,3,1,1,4,4,10,-6,4
P'thinaikos,2706,4,1,1,4,5,12,-7,4
AEK Athens,2707,1,4,2,0,7,1,6,14
PAOK Salonik,2707,2,2,2,2,10,6,4,8
P'thinaikos,2707,3,2,1,3,6,10,-4,7
Panionios,2707,4,1,1,4,4,10,-6,4
AEK Athens,2708,1,4,2,0,7,1,6,14
PAOK Salonik,2708,2,3,2,1,10,4,6,11
P'thinaikos,2708,3,1,1,4,4,10,-6,4
Panionios,2708,3,1,1,4,4,10,-6,4
AEK Athens,2709,1,4,2,0,7,1,6,14
PAOK Salonik,2709,2,2,3,1,9,4,5,9
P'thinaikos,2709,3,1,2,3,4,9,-5,5
Panionios,2709,4,1,1,4,4,10,-6,4
AEK Athens,2710,1,4,2,0,7,1,6,14
PAOK Salonik,2710,2,3,2,1,11,5,6,11
P'thinaikos,2710,3,1,1,4,5,11,-6,4
Panionios,2710,4,1,1,4,4,10,-6,4
AEK Athens,2711,1,4,2,0,7,1,6,14
PAOK Salonik,2711,2,3,2,1,11,4,7,11
Panionios,2711,3,1,1,4,4,10,-6,4
P'thinaikos,2711,4,1,1,4,4,11,-7,4
AEK Athens,2712,1,4,2,0,7,1,6,14
PAOK Salonik,2712,2,2,3,1,9,4,5,9
P'thinaikos,2712,3,1,2,3,4,9,-5,5
Panionios,2712,4,1,1,4,4,10,-6,4
AEK Athens,2713,1,4,2,0,7,1,6,14
PAOK Salonik,2713,2,3,2,1,12,4,8,11
Panionios,2713,3,1,1,4,4,10,-6,4
P'thinaikos,2713,4,1,1,4,4,12,-8,4
AEK Athens,2714,1,4,2,0,7,1,6,14
PAOK Salonik,2714,2,2,3,1,9,4,5,9
P'thinaikos,2714,3,1,2,3,4,9,-5,5
Panionios,2714,4,1,1,4,4,10,-6,4
AEK Athens,2715,1,4,2,0,7,1,6,14
PAOK Salonik,2715,2,3,2,1,13,4,9,11
Panionios,2715,3,1,1,4,4,10,-6,4
P'thinaikos,2715,4,1,1,4,4,13,-9,4
AEK Athens,2716,1,4,2,0,7,1,6,14
PAOK Salonik,2716,2,3,2,1,12,4,8,11
Panionios,2716,3,1,1,4,4,10,-6,4
P'thinaikos,2716,4,1,1,4,4,12,-8,4
AEK Athens,2717,1,4,2,0,7,1,6,14
PAOK Salonik,2717,2,2,2,2,11,7,4,8
P'thinaikos,2717,3,2,1,3,7,11,-4,7
Panionios,2717,4,1,1,4,4,10,-6,4
AEK Athens,2718,1,4,2,0,7,1,6,14
PAOK Salonik,2718,2,2,3,1,10,5,5,9
P'thinaikos,2718,3,1,2,3,5,10,-5,5
Panionios,2718,4,1,1,4,4,10,-6,4
AEK Athens,2719,1,4,2,0,7,1,6,14
PAOK Salonik,2719,2,3,2,1,10,4,6,11
P'thinaikos,2719,3,1,1,4,4,10,-6,4
Panionios,2719,3,1,1,4,4,10,-6,4
AEK Athens,2720,1,4,2,0,7,1,6,14
PAOK Salonik,2720,2,2,3,1,10,5,5,9
P'thinaikos,2720,3,1,2,3,5,10,-5,5
Panionios,2720,4,1,1,4,4,10,-6,4
AEK Athens,2721,1,4,2,0,7,1,6,14
PAOK Salonik,2721,2,2,2,2,10,7,3,8
P'thinaikos,2721,3,2,1,3,7,10,-3,7
Panionios,2721,4,1,1,4,4,10,-6,4
AEK Athens,2722,1,4,2,0,7,1,6,14
PAOK Salonik,2722,2,2,3,1,12,7,5,9
P'thinaikos,2722,3,1,2,3,7,12,-5,5
Panionios,2722,4,1,1,4,4,10,-6,4
AEK Athens,2723,1,4,2,0,7,1,6,14
PAOK Salonik,2723,2,2,3,1,11,6,5,9
P'thinaikos,2723,3,1,2,3,6,11,-5,5
Panionios,2723,4,1,1,4,4,10,-6,4
AEK Athens,2724,1,4,2,0,7,1,6,14
PAOK Salonik,2724,2,2,2,2,9,6,3,8
P'thinaikos,2724,3,2,1,3,6,9,-3,7
Panionios,2724,4,1,1,4,4,10,-6,4
AEK Athens,2725,1,4,2,0,7,1,6,14
PAOK Salonik,2725,2,2,2,2,9,6,3,8
P'thinaikos,2725,3,2,1,3,6,9,-3,7
Panionios,2725,4,1,1,4,4,10,-6,4
AEK Athens,2726,1,4,2,0,7,1,6,14
PAOK Salonik,2726,2,2,2,2,10,7,3,8
P'thinaikos,2726,3,2,1,3,7,10,-3,7
Panionios,2726,4,1,1,4,4,10,-6,4
AEK Athens,2727,1,4,2,0,7,1,6,14
PAOK Salonik,2727,2,2,2,2,9,7,2,8
P'thinaikos,2727,3,2,1,3,7,9,-2,7
Panionios,2727,4,1,1,4,4,10,-6,4
AEK Athens,2728,1,4,2,0,7,1,6,14
PAOK Salonik,2728,2,2,2,2,10,6,4,8
P'thinaikos,2728,3,2,1,3,6,10,-4,7
Panionios,2728,4,1,1,4,4,10,-6,4
AEK Athens,2729,1,4,2,0,7,1,6,14
PAOK Salonik,2729,2,2,2,2,9,5,4,8
P'thinaikos,2729,3,2,1,3,5,9,-4,7
Panionios,2729,4,1,1,4,4,10,-6,4
AEK Athens,2730,1,4,2,0,7,1,6,14
PAOK Salonik,2730,2,3,2,1,11,5,6,11
P'thinaikos,2730,3,1,1,4,5,11,-6,4
Panionios,2730,4,1,1,4,4,10,-6,4
AEK Athens,2731,1,4,2,0,7,1,6,14
PAOK Salonik,2731,2,2,2,2,9,5,4,8
P'thinaikos,2731,3,2,1,3,5,9,-4,7
Panionios,2731,4,1,1,4,4,10,-6,4
AEK Athens,2732,1,4,2,0,7,1,6,14
PAOK Salonik,2732,2,2,3,1,9,4,5,9
P'thinaikos,2732,3,1,2,3,4,9,-5,5
Panionios,2732,4,1,1,4,4,10,-6,4
AEK Athens,2733,1,4,2,0,7,1,6,14
PAOK Salonik,2733,2,2,2,2,10,6,4,8
P'thinaikos,2733,3,2,1,3,6,10,-4,7
Panionios,2733,4,1,1,4,4,10,-6,4
AEK Athens,2734,1,4,2,0,7,1,6,14
PAOK Salonik,2734,2,3,2,1,11,5,6,11
P'thinaikos,2734,3,1,1,4,5,11,-6,4
Panionios,2734,4,1,1,4,4,10,-6,4
AEK Athens,2735,1,4,2,0,7,1,6,14
PAOK Salonik,2735,2,2,2,2,9,6,3,8
P'thinaikos,2735,3,2,1,3,6,9,-3,7
Panionios,2735,4,1,1,4,4,10,-6,4
AEK Athens,2736,1,4,2,0,7,1,6,14
PAOK Salonik,2736,2,2,3,1,9,4,5,9
P'thinaikos,2736,3,1,2,3,4,9,-5,5
Panionios,2736,4,1,1,4,4,10,-6,4
AEK Athens,2737,1,4,2,0,7,1,6,14
PAOK Salonik,2737,2,2,3,1,10,5,5,9
P'thinaikos,2737,3,1,2,3,5,10,-5,5
Panionios,2737,4,1,1,4,4,10,-6,4
AEK Athens,2738,1,4,2,0,7,1,6,14
PAOK Salonik,2738,2,3,2,1,11,5,6,11
P'thinaikos,2738,3,1,1,4,5,11,-6,4
Panionios,2738,4,1,1,4,4,10,-6,4
AEK Athens,2739,1,4,2,0,7,1,6,14
PAOK Salonik,2739,2,3,2,1,11,4,7,11
Panionios,2739,3,1,1,4,4,10,-6,4
P'thinaikos,2739,4,1,1,4,4,11,-7,4
AEK Athens,2740,1,4,2,0,7,1,6,14
PAOK Salonik,2740,2,3,2,1,12,4,8,11
Panionios,2740,3,1,1,4,4,10,-6,4
P'thinaikos,2740,4,1,1,4,4,12,-8,4
AEK Athens,2741,1,4,2,0,7,1,6,14
PAOK Salonik,2741,2,3,2,1,11,5,6,11
P'thinaikos,2741,3,1,1,4,5,11,-6,4
Panionios,2741,4,1,1,4,4,10,-6,4
AEK Athens,2742,1,4,2,0,7,1,6,14
PAOK Salonik,2742,2,2,3,1,10,5,5,9
P'thinaikos,2742,3,1,2,3,5,10,-5,5
Panionios,2742,4,1,1,4,4,10,-6,4
AEK Athens,2743,1,4,2,0,7,1,6,14
PAOK Salonik,2743,2,3,2,1,12,6,6,11
P'thinaikos,2743,3,1,1,4,6,12,-6,4
Panionios,2743,4,1,1,4,4,10,-6,4
AEK Athens,2744,1,4,2,0,7,1,6,14
PAOK Salonik,2744,2,2,2,2,9,6,3,8
P'thinaikos,2744,3,2,1,3,6,9,-3,7
Panionios,2744,4,1,1,4,4,10,-6,4
AEK Athens,2745,1,4,2,0,7,1,6,14
PAOK Salonik,2745,2,3,2,1,10,4,6,11
P'thinaikos,2745,3,1,1,4,4,10,-6,4
Panionios,2745,3,1,1,4,4,10,-6,4
AEK Athens,2746,1,4,2,0,7,1,6,14
PAOK Salonik,2746,2,3,2,1,10,4,6,11
P'thinaikos,2746,3,1,1,4,4,10,-6,4
Panionios,2746,3,1,1,4,4,10,-6,4
AEK Athens,2747,1,4,2,0,7,1,6,14
PAOK Salonik,2747,2,3,2,1,11,5,6,11
P'thinaikos,2747,3,1,1,4,5,11,-6,4
Panionios,2747,4,1,1,4,4,10,-6,4
AEK Athens,2748,1,4,2,0,7,1,6,14
PAOK Salonik,2748,2,2,2,2,9,7,2,8
P'thinaikos,2748,3,2,1,3,7,9,-2,7
Panionios,2748,4,1,1,4,4,10,-6,4
AEK Athens,2749,1,4,2,0,7,1,6,14
PAOK Salonik,2749,2,2,3,1,10,5,5,9
P'thinaikos,2749,3,1,2,3,5,10,-5,5
Panionios,2749,4,1,1,4,4,10,-6,4
AEK Athens,2750,1,4,2,0,7,1,6,14
PAOK Salonik,2750,2,2,3,1,10,5,5,9
P'thinaikos,2750,3,1,2,3,5,10,-5,5
Panionios,2750,4,1,1,4,4,10,-6,4
AEK Athens,2751,1,4,2,0,7,1,6,14
PAOK Salonik,2751,2,3,2,1,11,4,7,11
Panionios,2751,3,1,1,4,4,10,-6,4
P'thinaikos,2751,4,1,1,4,4,11,-7,4
AEK Athens,2752,1,4,2,0,7,1,6,14
PAOK Salonik,2752,2,2,3,1,9,4,5,9
P'thinaikos,2752,3,1,2,3,4,9,-5,5
Panionios,2752,4,1,1,4,4,10,-6,4
AEK Athens,2753,1,4,2,0,7,1,6,14
PAOK Salonik,2753,2,3,2,1,11,4,7,11
Panionios,2753,3,1,1,4,4,10,-6,4
P'thinaikos,2753,4,1,1,4,4,11,-7,4
AEK Athens,2754,1,4,2,0,7,1,6,14
PAOK Salonik,2754,2,3,2,1,11,5,6,11
P'thinaikos,2754,3,1,1,4,5,11,-6,4
Panionios,2754,4,1,1,4,4,10,-6,4
AEK Athens,2755,1,4,2,0,7,1,6,14
PAOK Salonik,2755,2,2,3,1,10,5,5,9
P'thinaikos,2755,3,1,2,3,5,10,-5,5
Panionios,2755,4,1,1,4,4,10,-6,4
AEK Athens,2756,1,4,2,0,7,1,6,14
PAOK Salonik,2756,2,2,2,2,10,6,4,8
P'thinaikos,2756,3,2,1,3,6,10,-4,7
Panionios,2756,4,1,1,4,4,10,-6,4
AEK Athens,2757,1,4,2,0,7,1,6,14
PAOK Salonik,2757,2,3,2,1,13,6,7,11
Panionios,2757,3,1,1,4,4,10,-6,4
P'thinaikos,2757,4,1,1,4,6,13,-7,4
AEK Athens,2758,1,4,2,0,7,1,6,14
PAOK Salonik,2758,2,3,2,1,12,5,7,11
Panionios,2758,3,1,1,4,4,10,-6,4
P'thinaikos,2758,4,1,1,4,5,12,-7,4
AEK Athens,2759,1,4,2,0,7,1,6,14
PAOK Salonik,2759,2,2,2,2,11,7,4,8
P'thinaikos,2759,3,2,1,3,7,11,-4,7
Panionios,2759,4,1,1,4,4,10,-6,4
AEK Athens,2760,1,4,2,0,7,1,6,14
PAOK Salonik,2760,2,3,2,1,11,4,7,11
Panionios,2760,3,1,1,4,4,10,-6,4
P'thinaikos,2760,4,1,1,4,4,11,-7,4
AEK Athens,2761,1,4,2,0,7,1,6,14
PAOK Salonik,2761,2,3,2,1,10,4,6,11
P'thinaikos,2761,3,1,1,4,4,10,-6,4
Panionios,2761,3,1,1,4,4,10,-6,4
AEK Athens,2762,1,4,2,0,7,1,6,14
PAOK Salonik,2762,2,3,2,1,10,4,6,11
P'thinaikos,2762,3,1,1,4,4,10,-6,4
Panionios,2762,3,1,1,4,4,10,-6,4
AEK Athens,2763,1,4,2,0,7,1,6,14
PAOK Salonik,2763,2,3,2,1,12,6,6,11
P'thinaikos,2763,3,1,1,4,6,12,-6,4
Panionios,2763,4,1,1,4,4,10,-6,4
AEK Athens,2764,1,4,2,0,7,1,6,14
PAOK Salonik,2764,2,2,3,1,9,4,5,9
P'thinaikos,2764,3,1,2,3,4,9,-5,5
Panionios,2764,4,1,1,4,4,10,-6,4
AEK Athens,2765,1,4,2,0,7,1,6,14
PAOK Salonik,2765,2,3,2,1,13,5,8,11
Panionios,2765,3,1,1,4,4,10,-6,4
P'thinaikos,2765,4,1,1,4,5,13,-8,4
AEK Athens,2766,1,4,2,0,7,1,6,14
PAOK Salonik,2766,2,3,2,1,11,5,6,11
P'thinaikos,2766,3,1,1,4,5,11,-6,4
Panionios,2766,4,1,1,4,4,10,-6,4
AEK Athens,2767,1,4,2,0,7,1,6,14
PAOK Salonik,2767,2,2,2,2,11,8,3,8
P'thinaikos,2767,3,2,1,3,8,11,-3,7
Panionios,2767,4,1,1,4,4,10,-6,4
AEK Athens,2768,1,4,2,0,7,1,6,14
PAOK Salonik,2768,2,2,2,2,10,6,4,8
P'thinaikos,2768,3,2,1,3,6,10,-4,7
Panionios,2768,4,1,1,4,4,10,-6,4
AEK Athens,2769,1,4,2,0,7,1,6,14
PAOK Salonik,2769,2,2,3,1,10,5,5,9
P'thinaikos,2769,3,1,2,3,5,10,-5,5
Panionios,2769,4,1,1,4,4,10,-6,4
AEK Athens,2770,1,4,2,0,7,1,6,14
PAOK Salonik,2770,2,2,2,2,9,5,4,8
P'thinaikos,2770,3,2,1,3,5,9,-4,7
Panionios,2770,4,1,1,4,4,10,-6,4
AEK Athens,2771,1,4,2,0,7,1,6,14
PAOK Salonik,2771,2,2,2,2,9,5,4,8
P'thinaikos,2771,3,2,1,3,5,9,-4,7
Panionios,2771,4,1,1,4,4,10,-6,4
AEK Athens,2772,1,4,2,0,7,1,6,14
PAOK Salonik,2772,2,3,2,1,11,5,6,11
P'thinaikos,2772,3,1,1,4,5,11,-6,4
Panionios,2772,4,1,1,4,4,10,-6,4
AEK Athens,2773,1,4,2,0,7,1,6,14
PAOK Salonik,2773,2,3,2,1,11,5,6,11
P'thinaikos,2773,3,1,1,4,5,11,-6,4
Panionios,2773,4,1,1,4,4,10,-6,4
AEK Athens,2774,1,4,2,0,7,1,6,14
PAOK Salonik,2774,2,2,3,1,9,4,5,9
P'thinaikos,2774,3,1,2,3,4,9,-5,5
Panionios,2774,4,1,1,4,4,10,-6,4
AEK Athens,2775,1,4,2,0,7,1,6,14
PAOK Salonik,2775,2,2,2,2,10,6,4,8
P'thinaikos,2775,3,2,1,3,6,10,-4,7
Panionios,2775,4,1,1,4,4,10,-6,4
AEK Athens,2776,1,4,2,0,7,1,6,14
PAOK Salonik,2776,2,2,3,1,10,5,5,9
P'thinaikos,2776,3,1,2,3,5,10,-5,5
Panionios,2776,4,1,1,4,4,10,-6,4
AEK Athens,2777,1,4,2,0,7,1,6,14
PAOK Salonik,2777,2,2,3,1,11,6,5,9
P'thinaikos,2777,3,1,2,3,6,11,-5,5
Panionios,2777,4,1,1,4,4,10,-6,4
AEK Athens,2778,1,4,2,0,7,1,6,14
PAOK Salonik,2778,2,2,2,2,9,6,3,8
P'thinaikos,2778,3,2,1,3,6,9,-3,7
Panionios,2778,4,1,1,4,4,10,-6,4
AEK Athens,2779,1,4,2,0,7,1,6,14
PAOK Salonik,2779,2,3,2,1,12,5,7,11
Panionios,2779,3,1,1,4,4,10,-6,4
P'thinaikos,2779,4,1,1,4,5,12,-7,4
AEK Athens,2780,1,4,2,0,7,1,6,14
PAOK Salonik,2780,2,2,2,2,10,7,3,8
P'thinaikos,2780,3,2,1,3,7,10,-3,7
Panionios,2780,4,1,1,4,4,10,-6,4
AEK Athens,2781,1,4,2,0,7,1,6,14
PAOK Salonik,2781,2,3,2,1,11,5,6,11
P'thinaikos,2781,3,1,1,4,5,11,-6,4
Panionios,2781,4,1,1,4,4,10,-6,4
AEK Athens,2782,1,4,2,0,7,1,6,14
PAOK Salonik,2782,2,3,2,1,11,4,7,11
Panionios,2782,3,1,1,4,4,10,-6,4
P'thinaikos,2782,4,1,1,4,4,11,-7,4
AEK Athens,2783,1,4,2,0,7,1,6,14
PAOK Salonik,2783,2,2,2,2,9,6,3,8
P'thinaikos,2783,3,2,1,3,6,9,-3,7
Panionios,2783,4,1,1,4,4,10,-6,4
AEK Athens,2784,1,4,2,0,7,1,6,14
PAOK Salonik,2784,2,2,2,2,9,7,2,8
P'thinaikos,2784,3,2,1,3,7,9,-2,7
Panionios,2784,4,1,1,4,4,10,-6,4
AEK Athens,2785,1,4,2,0,7,1,6,14
PAOK Salonik,2785,2,2,2,2,9,6,3,8
P'thinaikos,2785,3,2,1,3,6,9,-3,7
Panionios,2785,4,1,1,4,4,10,-6,4
AEK Athens,2786,1,4,2,0,7,1,6,14
PAOK Salonik,2786,2,3,2,1,11,5,6,11
P'thinaikos,2786,3,1,1,4,5,11,-6,4
Panionios,2786,4,1,1,4,4,10,-6,4
AEK Athens,2787,1,4,2,0,7,1,6,14
PAOK Salonik,2787,2,2,2,2,9,6,3,8
P'thinaikos,2787,3,2,1,3,6,9,-3,7
Panionios,2787,4,1,1,4,4,10,-6,4
AEK Athens,2788,1,4,2,0,7,1,6,14
PAOK Salonik,2788,2,2,2,2,9,5,4,8
P'thinaikos,2788,3,2,1,3,5,9,-4,7
Panionios,2788,4,1,1,4,4,10,-6,4
AEK Athens,2789,1,4,2,0,7,1,6,14
PAOK Salonik,2789,2,3,2,1,12,6,6,11
P'thinaikos,2789,3,1,1,4,6,12,-6,4
Panionios,2789,4,1,1,4,4,10,-6,4
AEK Athens,2790,1,4,2,0,7,1,6,14
PAOK Salonik,2790,2,2,2,2,10,6,4,8
P'thinaikos,2790,3,2,1,3,6,10,-4,7
Panionios,2790,4,1,1,4,4,10,-6,4
AEK Athens,2791,1,4,2,0,7,1,6,14
PAOK Salonik,2791,2,2,2,2,9,5,4,8
P'thinaikos,2791,3,2,1,3,5,9,-4,7
Panionios,2791,4,1,1,4,4,10,-6,4
AEK Athens,2792,1,4,2,0,7,1,6,14
PAOK Salonik,2792,2,2,2,2,9,5,4,8
P'thinaikos,2792,3,2,1,3,5,9,-4,7
Panionios,2792,4,1,1,4,4,10,-6,4
AEK Athens,2793,1,4,2,0,7,1,6,14
PAOK Salonik,2793,2,2,3,1,10,5,5,9
P'thinaikos,2793,3,1,2,3,5,10,-5,5
Panionios,2793,4,1,1,4,4,10,-6,4
AEK Athens,2794,1,4,2,0,7,1,6,14
PAOK Salonik,2794,2,2,2,2,9,8,1,8
P'thinaikos,2794,3,2,1,3,8,9,-1,7
Panionios,2794,4,1,1,4,4,10,-6,4
AEK Athens,2795,1,4,2,0,7,1,6,14
PAOK Salonik,2795,2,3,2,1,10,4,6,11
P'thinaikos,2795,3,1,1,4,4,10,-6,4
Panionios,2795,3,1,1,4,4,10,-6,4
AEK Athens,2796,1,4,2,0,7,1,6,14
PAOK Salonik,2796,2,2,2,2,9,6,3,8
P'thinaikos,2796,3,2,1,3,6,9,-3,7
Panionios,2796,4,1,1,4,4,10,-6,4
AEK Athens,2797,1,4,2,0,7,1,6,14
PAOK Salonik,2797,2,2,2,2,9,5,4,8
P'thinaikos,2797,3,2,1,3,5,9,-4,7
Panionios,2797,4,1,1,4,4,10,-6,4
AEK Athens,2798,1,4,2,0,7,1,6,14
PAOK Salonik,2798,2,2,2,2,10,6,4,8
P'thinaikos,2798,3,2,1,3,6,10,-4,7
Panionios,2798,4,1,1,4,4,10,-6,4
AEK Athens,2799,1,4,2,0,7,1,6,14
PAOK Salonik,2799,2,3,2,1,11,4,7,11
Panionios,2799,3,1,1,4,4,10,-6,4
P'thinaikos,2799,4,1,1,4,4,11,-7,4
AEK Athens,2800,1,4,2,0,7,1,6,14
PAOK Salonik,2800,2,2,2,2,9,5,4,8
P'thinaikos,2800,3,2,1,3,5,9,-4,7
Panionios,2800,4,1,1,4,4,10,-6,4
AEK Athens,2801,1,4,2,0,7,1,6,14
PAOK Salonik,2801,2,2,3,1,11,6,5,9
P'thinaikos,2801,3,1,2,3,6,11,-5,5
Panionios,2801,4,1,1,4,4,10,-6,4
AEK Athens,2802,1,4,2,0,7,1,6,14
PAOK Salonik,2802,2,2,2,2,10,6,4,8
P'thinaikos,2802,3,2,1,3,6,10,-4,7
Panionios,2802,4,1,1,4,4,10,-6,4
AEK Athens,2803,1,4,2,0,7,1,6,14
PAOK Salonik,2803,2,2,2,2,9,8,1,8
P'thinaikos,2803,3,2,1,3,8,9,-1,7
Panionios,2803,4,1,1,4,4,10,-6,4
AEK Athens,2804,1,4,2,0,7,1,6,14
PAOK Salonik,2804,2,3,2,1,10,4,6,11
P'thinaikos,2804,3,1,1,4,4,10,-6,4
Panionios,2804,3,1,1,4,4,10,-6,4
AEK Athens,2805,1,4,2,0,7,1,6,14
PAOK Salonik,2805,2,3,2,1,11,4,7,11
Panionios,2805,3,1,1,4,4,10,-6,4
P'thinaikos,2805,4,1,1,4,4,11,-7,4
AEK Athens,2806,1,4,2,0,7,1,6,14
PAOK Salonik,2806,2,2,2,2,9,6,3,8
P'thinaikos,2806,3,2,1,3,6,9,-3,7
Panionios,2806,4,1,1,4,4,10,-6,4
AEK Athens,2807,1,4,2,0,7,1,6,14
PAOK Salonik,2807,2,3,2,1,10,4,6,11
P'thinaikos,2807,3,1,1,4,4,10,-6,4
Panionios,2807,3,1,1,4,4,10,-6,4
AEK Athens,2808,1,4,2,0,7,1,6,14
PAOK Salonik,2808,2,2,2,2,9,7,2,8
P'thinaikos,2808,3,2,1,3,7,9,-2,7
Panionios,2808,4,1,1,4,4,10,-6,4
AEK Athens,2809,1,4,2,0,7,1,6,14
PAOK Salonik,2809,2,2,3,1,10,5,5,9
P'thinaikos,2809,3,1,2,3,5,10,-5,5
Panionios,2809,4,1,1,4,4,10,-6,4
AEK Athens,2810,1,4,2,0,7,1,6,14
PAOK Salonik,2810,2,2,3,1,10,5,5,9
P'thinaikos,2810,3,1,2,3,5,10,-5,5
Panionios,2810,4,1,1,4,4,10,-6,4
AEK Athens,2811,1,4,2,0,7,1,6,14
PAOK Salonik,2811,2,2,2,2,9,6,3,8
P'thinaikos,2811,3,2,1,3,6,9,-3,7
Panionios,2811,4,1,1,4,4,10,-6,4
AEK Athens,2812,1,4,2,0,7,1,6,14
PAOK Salonik,2812,2,2,2,2,11,7,4,8
P'thinaikos,2812,3,2,1,3,7,11,-4,7
Panionios,2812,4,1,1,4,4,10,-6,4
AEK Athens,2813,1,4,2,0,7,1,6,14
PAOK Salonik,2813,2,2,2,2,9,6,3,8
P'thinaikos,2813,3,2,1,3,6,9,-3,7
Panionios,2813,4,1,1,4,4,10,-6,4
AEK Athens,2814,1,4,2,0,7,1,6,14
PAOK Salonik,2814,2,2,2,2,10,6,4,8
P'thinaikos,2814,3,2,1,3,6,10,-4,7
Panionios,2814,4,1,1,4,4,10,-6,4
AEK Athens,2815,1,4,2,0,7,1,6,14
PAOK Salonik,2815,2,3,2,1,11,5,6,11
P'thinaikos,2815,3,1,1,4,5,11,-6,4
Panionios,2815,4,1,1,4,4,10,-6,4
AEK Athens,2816,1,4,2,0,7,1,6,14
PAOK Salonik,2816,2,3,2,1,11,4,7,11
Panionios,2816,3,1,1,4,4,10,-6,4
P'thinaikos,2816,4,1,1,4,4,11,-7,4
AEK Athens,2817,1,4,2,0,7,1,6,14
PAOK Salonik,2817,2,2,3,1,10,5,5,9
P'thinaikos,2817,3,1,2,3,5,10,-5,5
Panionios,2817,4,1,1,4,4,10,-6,4
AEK Athens,2818,1,4,2,0,7,1,6,14
PAOK Salonik,2818,2,3,2,1,11,5,6,11
P'thinaikos,2818,3,1,1,4,5,11,-6,4
Panionios,2818,4,1,1,4,4,10,-6,4
AEK Athens,2819,1,4,2,0,7,1,6,14
PAOK Salonik,2819,2,3,2,1,11,5,6,11
P'thinaikos,2819,3,1,1,4,5,11,-6,4
Panionios,2819,4,1,1,4,4,10,-6,4
AEK Athens,2820,1,4,2,0,7,1,6,14
PAOK Salonik,2820,2,2,2,2,9,5,4,8
P'thinaikos,2820,3,2,1,3,5,9,-4,7
Panionios,2820,4,1,1,4,4,10,-6,4
AEK Athens,2821,1,4,2,0,7,1,6,14
PAOK Salonik,2821,2,2,2,2,10,6,4,8
P'thinaikos,2821,3,2,1,3,6,10,-4,7
Panionios,2821,4,1,1,4,4,10,-6,4
AEK Athens,2822,1,4,2,0,7,1,6,14
PAOK Salonik,2822,2,3,2,1,11,5,6,11
P'thinaikos,2822,3,1,1,4,5,11,-6,4
Panionios,2822,4,1,1,4,4,10,-6,4
AEK Athens,2823,1,4,2,0,7,1,6,14
PAOK Salonik,2823,2,2,2,2,10,6,4,8
P'thinaikos,2823,3,2,1,3,6,10,-4,7
Panionios,2823,4,1,1,4,4,10,-6,4
AEK Athens,2824,1,4,2,0,7,1,6,14
PAOK Salonik,2824,2,3,2,1,10,4,6,11
P'thinaikos,2824,3,1,1,4,4,10,-6,4
Panionios,2824,3,1,1,4,4,10,-6,4
AEK Athens,2825,1,4,2,0,7,1,6,14
PAOK Salonik,2825,2,2,3,1,11,6,5,9
P'thinaikos,2825,3,1,2,3,6,11,-5,5
Panionios,2825,4,1,1,4,4,10,-6,4
AEK Athens,2826,1,4,2,0,7,1,6,14
PAOK Salonik,2826,2,3,2,1,12,6,6,11
P'thinaikos,2826,3,1,1,4,6,12,-6,4
Panionios,2826,4,1,1,4,4,10,-6,4
AEK Athens,2827,1,4,2,0,7,1,6,14
PAOK Salonik,2827,2,3,2,1,12,4,8,11
Panionios,2827,3,1,1,4,4,10,-6,4
P'thinaikos,2827,4,1,1,4,4,12,-8,4
AEK Athens,2828,1,4,2,0,7,1,6,14
PAOK Salonik,2828,2,2,2,2,9,7,2,8
P'thinaikos,2828,3,2,1,3,7,9,-2,7
Panionios,2828,4,1,1,4,4,10,-6,4
AEK Athens,2829,1,4,2,0,7,1,6,14
PAOK Salonik,2829,2,2,3,1,10,5,5,9
P'thinaikos,2829,3,1,2,3,5,10,-5,5
Panionios,2829,4,1,1,4,4,10,-6,4
AEK Athens,2830,1,4,2,0,7,1,6,14
PAOK Salonik,2830,2,2,2,2,10,6,4,8
P'thinaikos,2830,3,2,1,3,6,10,-4,7
Panionios,2830,4,1,1,4,4,10,-6,4
AEK Athens,2831,1,4,2,0,7,1,6,14
PAOK Salonik,2831,2,2,2,2,9,6,3,8
P'thinaikos,2831,3,2,1,3,6,9,-3,7
Panionios,2831,4,1,1,4,4,10,-6,4
AEK Athens,2832,1,4,2,0,7,1,6,14
PAOK Salonik,2832,2,2,2,2,9,5,4,8
P'thinaikos,2832,3,2,1,3,5,9,-4,7
Panionios,2832,4,1,1,4,4,10,-6,4
AEK Athens,2833,1,4,2,0,7,1,6,14
PAOK Salonik,2833,2,2,3,1,10,5,5,9
P'thinaikos,2833,3,1,2,3,5,10,-5,5
Panionios,2833,4,1,1,4,4,10,-6,4
AEK Athens,2834,1,4,2,0,7,1,6,14
PAOK Salonik,2834,2,2,2,2,9,6,3,8
P'thinaikos,2834,3,2,1,3,6,9,-3,7
Panionios,2834,4,1,1,4,4,10,-6,4
AEK Athens,2835,1,4,2,0,7,1,6,14
PAOK Salonik,2835,2,2,3,1,9,4,5,9
P'thinaikos,2835,3,1,2,3,4,9,-5,5
Panionios,2835,4,1,1,4,4,10,-6,4
AEK Athens,2836,1,4,2,0,7,1,6,14
PAOK Salonik,2836,2,2,2,2,9,5,4,8
P'thinaikos,2836,3,2,1,3,5,9,-4,7
Panionios,2836,4,1,1,4,4,10,-6,4
AEK Athens,2837,1,4,2,0,7,1,6,14
PAOK Salonik,2837,2,3,2,1,10,4,6,11
P'thinaikos,2837,3,1,1,4,4,10,-6,4
Panionios,2837,3,1,1,4,4,10,-6,4
AEK Athens,2838,1,4,2,0,7,1,6,14
PAOK Salonik,2838,2,2,2,2,9,5,4,8
P'thinaikos,2838,3,2,1,3,5,9,-4,7
Panionios,2838,4,1,1,4,4,10,-6,4
AEK Athens,2839,1,4,2,0,7,1,6,14
PAOK Salonik,2839,2,3,2,1,12,6,6,11
P'thinaikos,2839,3,1,1,4,6,12,-6,4
Panionios,2839,4,1,1,4,4,10,-6,4
AEK Athens,2840,1,4,2,0,7,1,6,14
PAOK Salonik,2840,2,3,2,1,10,4,6,11
P'thinaikos,2840,3,1,1,4,4,10,-6,4
Panionios,2840,3,1,1,4,4,10,-6,4
AEK Athens,2841,1,4,2,0,7,1,6,14
PAOK Salonik,2841,2,2,3,1,9,4,5,9
P'thinaikos,2841,3,1,2,3,4,9,-5,5
Panionios,2841,4,1,1,4,4,10,-6,4
AEK Athens,2842,1,4,2,0,7,1,6,14
PAOK Salonik,2842,2,3,2,1,11,4,7,11
Panionios,2842,3,1,1,4,4,10,-6,4
P'thinaikos,2842,4,1,1,4,4,11,-7,4
AEK Athens,2843,1,4,2,0,7,1,6,14
PAOK Salonik,2843,2,3,2,1,11,4,7,11
Panionios,2843,3,1,1,4,4,10,-6,4
P'thinaikos,2843,4,1,1,4,4,11,-7,4
AEK Athens,2844,1,4,2,0,7,1,6,14
PAOK Salonik,2844,2,2,2,2,11,7,4,8
P'thinaikos,2844,3,2,1,3,7,11,-4,7
Panionios,2844,4,1,1,4,4,10,-6,4
AEK Athens,2845,1,4,2,0,7,1,6,14
PAOK Salonik,2845,2,3,2,1,11,5,6,11
P'thinaikos,2845,3,1,1,4,5,11,-6,4
Panionios,2845,4,1,1,4,4,10,-6,4
AEK Athens,2846,1,4,2,0,7,1,6,14
PAOK Salonik,2846,2,2,2,2,9,6,3,8
P'thinaikos,2846,3,2,1,3,6,9,-3,7
Panionios,2846,4,1,1,4,4,10,-6,4
AEK Athens,2847,1,4,2,0,7,1,6,14
PAOK Salonik,2847,2,3,2,1,11,4,7,11
Panionios,2847,3,1,1,4,4,10,-6,4
P'thinaikos,2847,4,1,1,4,4,11,-7,4
AEK Athens,2848,1,4,2,0,7,1,6,14
PAOK Salonik,2848,2,2,3,1,10,5,5,9
P'thinaikos,2848,3,1,2,3,5,10,-5,5
Panionios,2848,4,1,1,4,4,10,-6,4
AEK Athens,2849,1,4,2,0,7,1,6,14
PAOK Salonik,2849,2,3,2,1,11,5,6,11
P'thinaikos,2849,3,1,1,4,5,11,-6,4
Panionios,2849,4,1,1,4,4,10,-6,4
AEK Athens,2850,1,4,2,0,7,1,6,14
PAOK Salonik,2850,2,2,3,1,10,5,5,9
P'thinaikos,2850,3,1,2,3,5,10,-5,5
Panionios,2850,4,1,1,4,4,10,-6,4
AEK Athens,2851,1,4,2,0,7,1,6,14
PAOK Salonik,2851,2,3,2,1,10,4,6,11
P'thinaikos,2851,3,1,1,4,4,10,-6,4
Panionios,2851,3,1,1,4,4,10,-6,4
AEK Athens,2852,1,4,2,0,7,1,6,14
PAOK Salonik,2852,2,2,2,2,9,6,3,8
P'thinaikos,2852,3,2,1,3,6,9,-3,7
Panionios,2852,4,1,1,4,4,10,-6,4
AEK Athens,2853,1,4,2,0,7,1,6,14
PAOK Salonik,2853,2,3,2,1,11,5,6,11
P'thinaikos,2853,3,1,1,4,5,11,-6,4
Panionios,2853,4,1,1,4,4,10,-6,4
AEK Athens,2854,1,4,2,0,7,1,6,14
PAOK Salonik,2854,2,2,3,1,9,4,5,9
P'thinaikos,2854,3,1,2,3,4,9,-5,5
Panionios,2854,4,1,1,4,4,10,-6,4
AEK Athens,2855,1,4,2,0,7,1,6,14
PAOK Salonik,2855,2,2,2,2,10,6,4,8
P'thinaikos,2855,3,2,1,3,6,10,-4,7
Panionios,2855,4,1,1,4,4,10,-6,4
AEK Athens,2856,1,4,2,0,7,1,6,14
PAOK Salonik,2856,2,2,3,1,11,6,5,9
P'thinaikos,2856,3,1,2,3,6,11,-5,5
Panionios,2856,4,1,1,4,4,10,-6,4
AEK Athens,2857,1,4,2,0,7,1,6,14
PAOK Salonik,2857,2,3,2,1,12,5,7,11
Panionios,2857,3,1,1,4,4,10,-6,4
P'thinaikos,2857,4,1,1,4,5,12,-7,4
AEK Athens,2858,1,4,2,0,7,1,6,14
PAOK Salonik,2858,2,3,2,1,11,4,7,11
Panionios,2858,3,1,1,4,4,10,-6,4
P'thinaikos,2858,4,1,1,4,4,11,-7,4
AEK Athens,2859,1,4,2,0,7,1,6,14
PAOK Salonik,2859,2,2,3,1,10,5,5,9
P'thinaikos,2859,3,1,2,3,5,10,-5,5
Panionios,2859,4,1,1,4,4,10,-6,4
AEK Athens,2860,1,4,2,0,7,1,6,14
PAOK Salonik,2860,2,2,2,2,9,5,4,8
P'thinaikos,2860,3,2,1,3,5,9,-4,7
Panionios,2860,4,1,1,4,4,10,-6,4
AEK Athens,2861,1,4,2,0,7,1,6,14
PAOK Salonik,2861,2,2,3,1,10,5,5,9
P'thinaikos,2861,3,1,2,3,5,10,-5,5
Panionios,2861,4,1,1,4,4,10,-6,4
AEK Athens,2862,1,4,2,0,7,1,6,14
PAOK Salonik,2862,2,2,2,2,10,6,4,8
P'thinaikos,2862,3,2,1,3,6,10,-4,7
Panionios,2862,4,1,1,4,4,10,-6,4
AEK Athens,2863,1,4,2,0,7,1,6,14
PAOK Salonik,2863,2,2,3,1,9,4,5,9
P'thinaikos,2863,3,1,2,3,4,9,-5,5
Panionios,2863,4,1,1,4,4,10,-6,4
AEK Athens,2864,1,4,2,0,7,1,6,14
PAOK Salonik,2864,2,2,2,2,10,7,3,8
P'thinaikos,2864,3,2,1,3,7,10,-3,7
Panionios,2864,4,1,1,4,4,10,-6,4
AEK Athens,2865,1,4,2,0,7,1,6,14
PAOK Salonik,2865,2,2,2,2,9,5,4,8
P'thinaikos,2865,3,2,1,3,5,9,-4,7
Panionios,2865,4,1,1,4,4,10,-6,4
AEK Athens,2866,1,4,2,0,7,1,6,14
PAOK Salonik,2866,2,2,3,1,10,5,5,9
P'thinaikos,2866,3,1,2,3,5,10,-5,5
Panionios,2866,4,1,1,4,4,10,-6,4
AEK Athens,2867,1,4,2,0,7,1,6,14
PAOK Salonik,2867,2,2,2,2,9,5,4,8
P'thinaikos,2867,3,2,1,3,5,9,-4,7
Panionios,2867,4,1,1,4,4,10,-6,4
AEK Athens,2868,1,4,2,0,7,1,6,14
PAOK Salonik,2868,2,2,3,1,10,5,5,9
P'thinaikos,2868,3,1,2,3,5,10,-5,5
Panionios,2868,4,1,1,4,4,10,-6,4
AEK Athens,2869,1,4,2,0,7,1,6,14
PAOK Salonik,2869,2,3,2,1,11,5,6,11
P'thinaikos,2869,3,1,1,4,5,11,-6,4
Panionios,2869,4,1,1,4,4,10,-6,4
AEK Athens,2870,1,4,2,0,7,1,6,14
PAOK Salonik,2870,2,3,2,1,11,4,7,11
Panionios,2870,3,1,1,4,4,10,-6,4
P'thinaikos,2870,4,1,1,4,4,11,-7,4
AEK Athens,2871,1,4,2,0,7,1,6,14
PAOK Salonik,2871,2,2,3,1,10,5,5,9
P'thinaikos,2871,3,1,2,3,5,10,-5,5
Panionios,2871,4,1,1,4,4,10,-6,4
AEK Athens,2872,1,4,2,0,7,1,6,14
PAOK Salonik,2872,2,3,2,1,10,4,6,11
P'thinaikos,2872,3,1,1,4,4,10,-6,4
Panionios,2872,3,1,1,4,4,10,-6,4
AEK Athens,2873,1,4,2,0,7,1,6,14
PAOK Salonik,2873,2,2,2,2,9,6,3,8
P'thinaikos,2873,3,2,1,3,6,9,-3,7
Panionios,2873,4,1,1,4,4,10,-6,4
AEK Athens,2874,1,4,2,0,7,1,6,14
PAOK Salonik,2874,2,3,2,1,11,5,6,11
P'thinaikos,2874,3,1,1,4,5,11,-6,4
Panionios,2874,4,1,1,4,4,10,-6,4
AEK Athens,2875,1,4,2,0,7,1,6,14
PAOK Salonik,2875,2,3,2,1,10,4,6,11
P'thinaikos,2875,3,1,1,4,4,10,-6,4
Panionios,2875,3,1,1,4,4,10,-6,4
AEK Athens,2876,1,4,2,0,7,1,6,14
PAOK Salonik,2876,2,2,2,2,9,5,4,8
P'thinaikos,2876,3,2,1,3,5,9,-4,7
Panionios,2876,4,1,1,4,4,10,-6,4
AEK Athens,2877,1,4,2,0,7,1,6,14
PAOK Salonik,2877,2,3,2,1,12,6,6,11
P'thinaikos,2877,3,1,1,4,6,12,-6,4
Panionios,2877,4,1,1,4,4,10,-6,4
AEK Athens,2878,1,4,2,0,7,1,6,14
PAOK Salonik,2878,2,2,2,2,10,6,4,8
P'thinaikos,2878,3,2,1,3,6,10,-4,7
Panionios,2878,4,1,1,4,4,10,-6,4
AEK Athens,2879,1,4,2,0,7,1,6,14
PAOK Salonik,2879,2,2,2,2,9,5,4,8
P'thinaikos,2879,3,2,1,3,5,9,-4,7
Panionios,2879,4,1,1,4,4,10,-6,4
AEK Athens,2880,1,4,2,0,7,1,6,14
PAOK Salonik,2880,2,2,3,1,10,5,5,9
P'thinaikos,2880,3,1,2,3,5,10,-5,5
Panionios,2880,4,1,1,4,4,10,-6,4
AEK Athens,2881,1,4,2,0,7,1,6,14
PAOK Salonik,2881,2,2,2,2,10,6,4,8
P'thinaikos,2881,3,2,1,3,6,10,-4,7
Panionios,2881,4,1,1,4,4,10,-6,4
AEK Athens,2882,1,4,2,0,7,1,6,14
PAOK Salonik,2882,2,3,2,1,11,5,6,11
P'thinaikos,2882,3,1,1,4,5,11,-6,4
Panionios,2882,4,1,1,4,4,10,-6,4
AEK Athens,2883,1,4,2,0,7,1,6,14
PAOK Salonik,2883,2,3,2,1,10,4,6,11
P'thinaikos,2883,3,1,1,4,4,10,-6,4
Panionios,2883,3,1,1,4,4,10,-6,4
AEK Athens,2884,1,4,2,0,7,1,6,14
PAOK Salonik,2884,2,2,2,2,9,5,4,8
P'thinaikos,2884,3,2,1,3,5,9,-4,7
Panionios,2884,4,1,1,4,4,10,-6,4
AEK Athens,2885,1,4,2,0,7,1,6,14
PAOK Salonik,2885,2,3,2,1,10,4,6,11
P'thinaikos,2885,3,1,1,4,4,10,-6,4
Panionios,2885,3,1,1,4,4,10,-6,4
AEK Athens,2886,1,4,2,0,7,1,6,14
PAOK Salonik,2886,2,3,2,1,12,4,8,11
Panionios,2886,3,1,1,4,4,10,-6,4
P'thinaikos,2886,4,1,1,4,4,12,-8,4
AEK Athens,2887,1,4,2,0,7,1,6,14
PAOK Salonik,2887,2,3,2,1,10,4,6,11
P'thinaikos,2887,3,1,1,4,4,10,-6,4
Panionios,2887,3,1,1,4,4,10,-6,4
AEK Athens,2888,1,4,2,0,7,1,6,14
PAOK Salonik,2888,2,2,2,2,9,7,2,8
P'thinaikos,2888,3,2,1,3,7,9,-2,7
Panionios,2888,4,1,1,4,4,10,-6,4
AEK Athens,2889,1,4,2,0,7,1,6,14
PAOK Salonik,2889,2,2,2,2,10,6,4,8
P'thinaikos,2889,3,2,1,3,6,10,-4,7
Panionios,2889,4,1,1,4,4,10,-6,4
AEK Athens,2890,1,4,2,0,7,1,6,14
PAOK Salonik,2890,2,2,2,2,9,5,4,8
P'thinaikos,2890,3,2,1,3,5,9,-4,7
Panionios,2890,4,1,1,4,4,10,-6,4
AEK Athens,2891,1,4,2,0,7,1,6,14
PAOK Salonik,2891,2,3,2,1,12,6,6,11
P'thinaikos,2891,3,1,1,4,6,12,-6,4
Panionios,2891,4,1,1,4,4,10,-6,4
AEK Athens,2892,1,4,2,0,7,1,6,14
PAOK Salonik,2892,2,3,2,1,10,4,6,11
P'thinaikos,2892,3,1,1,4,4,10,-6,4
Panionios,2892,3,1,1,4,4,10,-6,4
AEK Athens,2893,1,4,2,0,7,1,6,14
PAOK Salonik,2893,2,2,3,1,9,4,5,9
P'thinaikos,2893,3,1,2,3,4,9,-5,5
Panionios,2893,4,1,1,4,4,10,-6,4
AEK Athens,2894,1,4,2,0,7,1,6,14
PAOK Salonik,2894,2,2,3,1,10,5,5,9
P'thinaikos,2894,3,1,2,3,5,10,-5,5
Panionios,2894,4,1,1,4,4,10,-6,4
AEK Athens,2895,1,4,2,0,7,1,6,14
PAOK Salonik,2895,2,3,2,1,12,6,6,11
P'thinaikos,2895,3,1,1,4,6,12,-6,4
Panionios,2895,4,1,1,4,4,10,-6,4
AEK Athens,2896,1,4,2,0,7,1,6,14
PAOK Salonik,2896,2,2,2,2,9,5,4,8
P'thinaikos,2896,3,2,1,3,5,9,-4,7
Panionios,2896,4,1,1,4,4,10,-6,4
AEK Athens,2897,1,4,2,0,7,1,6,14
PAOK Salonik,2897,2,3,2,1,10,4,6,11
P'thinaikos,2897,3,1,1,4,4,10,-6,4
Panionios,2897,3,1,1,4,4,10,-6,4
AEK Athens,2898,1,4,2,0,7,1,6,14
PAOK Salonik,2898,2,2,2,2,11,8,3,8
P'thinaikos,2898,3,2,1,3,8,11,-3,7
Panionios,2898,4,1,1,4,4,10,-6,4
AEK Athens,2899,1,4,2,0,7,1,6,14
PAOK Salonik,2899,2,3,2,1,10,4,6,11
P'thinaikos,2899,3,1,1,4,4,10,-6,4
Panionios,2899,3,1,1,4,4,10,-6,4
AEK Athens,2900,1,4,2,0,7,1,6,14
PAOK Salonik,2900,2,3,2,1,10,4,6,11
P'thinaikos,2900,3,1,1,4,4,10,-6,4
Panionios,2900,3,1,1,4,4,10,-6,4
AEK Athens,2901,1,4,2,0,7,1,6,14
PAOK Salonik,2901,2,3,2,1,10,4,6,11
P'thinaikos,2901,3,1,1,4,4,10,-6,4
Panionios,2901,3,1,1,4,4,10,-6,4
AEK Athens,2902,1,4,2,0,7,1,6,14
PAOK Salonik,2902,2,2,3,1,9,4,5,9
P'thinaikos,2902,3,1,2,3,4,9,-5,5
Panionios,2902,4,1,1,4,4,10,-6,4
AEK Athens,2903,1,4,2,0,7,1,6,14
PAOK Salonik,2903,2,3,2,1,11,5,6,11
P'thinaikos,2903,3,1,1,4,5,11,-6,4
Panionios,2903,4,1,1,4,4,10,-6,4
AEK Athens,2904,1,4,2,0,7,1,6,14
PAOK Salonik,2904,2,3,2,1,11,4,7,11
Panionios,2904,3,1,1,4,4,10,-6,4
P'thinaikos,2904,4,1,1,4,4,11,-7,4
AEK Athens,2905,1,4,2,0,7,1,6,14
PAOK Salonik,2905,2,3,2,1,11,5,6,11
P'thinaikos,2905,3,1,1,4,5,11,-6,4
Panionios,2905,4,1,1,4,4,10,-6,4
AEK Athens,2906,1,4,2,0,7,1,6,14
PAOK Salonik,2906,2,2,3,1,11,6,5,9
P'thinaikos,2906,3,1,2,3,6,11,-5,5
Panionios,2906,4,1,1,4,4,10,-6,4
AEK Athens,2907,1,4,2,0,7,1,6,14
PAOK Salonik,2907,2,3,2,1,11,5,6,11
P'thinaikos,2907,3,1,1,4,5,11,-6,4
Panionios,2907,4,1,1,4,4,10,-6,4
AEK Athens,2908,1,4,2,0,7,1,6,14
PAOK Salonik,2908,2,2,2,2,10,6,4,8
P'thinaikos,2908,3,2,1,3,6,10,-4,7
Panionios,2908,4,1,1,4,4,10,-6,4
AEK Athens,2909,1,4,2,0,7,1,6,14
PAOK Salonik,2909,2,2,2,2,9,7,2,8
P'thinaikos,2909,3,2,1,3,7,9,-2,7
Panionios,2909,4,1,1,4,4,10,-6,4
AEK Athens,2910,1,4,2,0,7,1,6,14
PAOK Salonik,2910,2,3,2,1,10,4,6,11
P'thinaikos,2910,3,1,1,4,4,10,-6,4
Panionios,2910,3,1,1,4,4,10,-6,4
AEK Athens,2911,1,4,2,0,7,1,6,14
PAOK Salonik,2911,2,2,3,1,10,5,5,9
P'thinaikos,2911,3,1,2,3,5,10,-5,5
Panionios,2911,4,1,1,4,4,10,-6,4
AEK Athens,2912,1,4,2,0,7,1,6,14
PAOK Salonik,2912,2,3,2,1,10,4,6,11
P'thinaikos,2912,3,1,1,4,4,10,-6,4
Panionios,2912,3,1,1,4,4,10,-6,4
AEK Athens,2913,1,4,2,0,7,1,6,14
PAOK Salonik,2913,2,2,2,2,9,6,3,8
P'thinaikos,2913,3,2,1,3,6,9,-3,7
Panionios,2913,4,1,1,4,4,10,-6,4
AEK Athens,2914,1,4,2,0,7,1,6,14
PAOK Salonik,2914,2,2,2,2,9,5,4,8
P'thinaikos,2914,3,2,1,3,5,9,-4,7
Panionios,2914,4,1,1,4,4,10,-6,4
AEK Athens,2915,1,4,2,0,7,1,6,14
PAOK Salonik,2915,2,3,2,1,10,4,6,11
P'thinaikos,2915,3,1,1,4,4,10,-6,4
Panionios,2915,3,1,1,4,4,10,-6,4
AEK Athens,2916,1,4,2,0,7,1,6,14
PAOK Salonik,2916,2,2,2,2,9,6,3,8
P'thinaikos,2916,3,2,1,3,6,9,-3,7
Panionios,2916,4,1,1,4,4,10,-6,4
AEK Athens,2917,1,4,2,0,7,1,6,14
PAOK Salonik,2917,2,2,3,1,9,4,5,9
P'thinaikos,2917,3,1,2,3,4,9,-5,5
Panionios,2917,4,1,1,4,4,10,-6,4
AEK Athens,2918,1,4,2,0,7,1,6,14
PAOK Salonik,2918,2,2,2,2,10,6,4,8
P'thinaikos,2918,3,2,1,3,6,10,-4,7
Panionios,2918,4,1,1,4,4,10,-6,4
AEK Athens,2919,1,4,2,0,7,1,6,14
PAOK Salonik,2919,2,3,2,1,11,5,6,11
P'thinaikos,2919,3,1,1,4,5,11,-6,4
Panionios,2919,4,1,1,4,4,10,-6,4
AEK Athens,2920,1,4,2,0,7,1,6,14
PAOK Salonik,2920,2,2,2,2,9,5,4,8
P'thinaikos,2920,3,2,1,3,5,9,-4,7
Panionios,2920,4,1,1,4,4,10,-6,4
AEK Athens,2921,1,4,2,0,7,1,6,14
PAOK Salonik,2921,2,2,2,2,9,6,3,8
P'thinaikos,2921,3,2,1,3,6,9,-3,7
Panionios,2921,4,1,1,4,4,10,-6,4
AEK Athens,2922,1,4,2,0,7,1,6,14
PAOK Salonik,2922,2,3,2,1,11,5,6,11
P'thinaikos,2922,3,1,1,4,5,11,-6,4
Panionios,2922,4,1,1,4,4,10,-6,4
AEK Athens,2923,1,4,2,0,7,1,6,14
PAOK Salonik,2923,2,2,3,1,9,4,5,9
P'thinaikos,2923,3,1,2,3,4,9,-5,5
Panionios,2923,4,1,1,4,4,10,-6,4
AEK Athens,2924,1,4,2,0,7,1,6,14
PAOK Salonik,2924,2,2,3,1,11,6,5,9
P'thinaikos,2924,3,1,2,3,6,11,-5,5
Panionios,2924,4,1,1,4,4,10,-6,4
AEK Athens,2925,1,4,2,0,7,1,6,14
PAOK Salonik,2925,2,3,2,1,11,5,6,11
P'thinaikos,2925,3,1,1,4,5,11,-6,4
Panionios,2925,4,1,1,4,4,10,-6,4
AEK Athens,2926,1,4,2,0,7,1,6,14
PAOK Salonik,2926,2,2,3,1,10,5,5,9
P'thinaikos,2926,3,1,2,3,5,10,-5,5
Panionios,2926,4,1,1,4,4,10,-6,4
AEK Athens,2927,1,4,2,0,7,1,6,14
PAOK Salonik,2927,2,2,3,1,10,5,5,9
P'thinaikos,2927,3,1,2,3,5,10,-5,5
Panionios,2927,4,1,1,4,4,10,-6,4
AEK Athens,2928,1,4,2,0,7,1,6,14
PAOK Salonik,2928,2,2,2,2,10,6,4,8
P'thinaikos,2928,3,2,1,3,6,10,-4,7
Panionios,2928,4,1,1,4,4,10,-6,4
AEK Athens,2929,1,4,2,0,7,1,6,14
PAOK Salonik,2929,2,2,2,2,10,7,3,8
P'thinaikos,2929,3,2,1,3,7,10,-3,7
Panionios,2929,4,1,1,4,4,10,-6,4
AEK Athens,2930,1,4,2,0,7,1,6,14
PAOK Salonik,2930,2,2,3,1,10,5,5,9
P'thinaikos,2930,3,1,2,3,5,10,-5,5
Panionios,2930,4,1,1,4,4,10,-6,4
AEK Athens,2931,1,4,2,0,7,1,6,14
PAOK Salonik,2931,2,2,2,2,9,7,2,8
P'thinaikos,2931,3,2,1,3,7,9,-2,7
Panionios,2931,4,1,1,4,4,10,-6,4
AEK Athens,2932,1,4,2,0,7,1,6,14
PAOK Salonik,2932,2,2,2,2,10,6,4,8
P'thinaikos,2932,3,2,1,3,6,10,-4,7
Panionios,2932,4,1,1,4,4,10,-6,4
AEK Athens,2933,1,4,2,0,7,1,6,14
PAOK Salonik,2933,2,3,2,1,12,4,8,11
Panionios,2933,3,1,1,4,4,10,-6,4
P'thinaikos,2933,4,1,1,4,4,12,-8,4
AEK Athens,2934,1,4,2,0,7,1,6,14
PAOK Salonik,2934,2,2,2,2,9,5,4,8
P'thinaikos,2934,3,2,1,3,5,9,-4,7
Panionios,2934,4,1,1,4,4,10,-6,4
AEK Athens,2935,1,4,2,0,7,1,6,14
PAOK Salonik,2935,2,2,3,1,10,5,5,9
P'thinaikos,2935,3,1,2,3,5,10,-5,5
Panionios,2935,4,1,1,4,4,10,-6,4
AEK Athens,2936,1,4,2,0,7,1,6,14
PAOK Salonik,2936,2,2,2,2,9,5,4,8
P'thinaikos,2936,3,2,1,3,5,9,-4,7
Panionios,2936,4,1,1,4,4,10,-6,4
AEK Athens,2937,1,4,2,0,7,1,6,14
PAOK Salonik,2937,2,3,2,1,11,5,6,11
P'thinaikos,2937,3,1,1,4,5,11,-6,4
Panionios,2937,4,1,1,4,4,10,-6,4
AEK Athens,2938,1,4,2,0,7,1,6,14
PAOK Salonik,2938,2,2,2,2,9,7,2,8
P'thinaikos,2938,3,2,1,3,7,9,-2,7
Panionios,2938,4,1,1,4,4,10,-6,4
AEK Athens,2939,1,4,2,0,7,1,6,14
PAOK Salonik,2939,2,3,2,1,10,4,6,11
P'thinaikos,2939,3,1,1,4,4,10,-6,4
Panionios,2939,3,1,1,4,4,10,-6,4
AEK Athens,2940,1,4,2,0,7,1,6,14
PAOK Salonik,2940,2,2,2,2,9,7,2,8
P'thinaikos,2940,3,2,1,3,7,9,-2,7
Panionios,2940,4,1,1,4,4,10,-6,4
AEK Athens,2941,1,4,2,0,7,1,6,14
PAOK Salonik,2941,2,3,2,1,11,4,7,11
Panionios,2941,3,1,1,4,4,10,-6,4
P'thinaikos,2941,4,1,1,4,4,11,-7,4
AEK Athens,2942,1,4,2,0,7,1,6,14
PAOK Salonik,2942,2,2,2,2,9,5,4,8
P'thinaikos,2942,3,2,1,3,5,9,-4,7
Panionios,2942,4,1,1,4,4,10,-6,4
AEK Athens,2943,1,4,2,0,7,1,6,14
PAOK Salonik,2943,2,2,3,1,9,4,5,9
P'thinaikos,2943,3,1,2,3,4,9,-5,5
Panionios,2943,4,1,1,4,4,10,-6,4
AEK Athens,2944,1,4,2,0,7,1,6,14
PAOK Salonik,2944,2,2,3,1,9,4,5,9
P'thinaikos,2944,3,1,2,3,4,9,-5,5
Panionios,2944,4,1,1,4,4,10,-6,4
AEK Athens,2945,1,4,2,0,7,1,6,14
PAOK Salonik,2945,2,2,2,2,10,7,3,8
P'thinaikos,2945,3,2,1,3,7,10,-3,7
Panionios,2945,4,1,1,4,4,10,-6,4
AEK Athens,2946,1,4,2,0,7,1,6,14
PAOK Salonik,2946,2,3,2,1,10,4,6,11
P'thinaikos,2946,3,1,1,4,4,10,-6,4
Panionios,2946,3,1,1,4,4,10,-6,4
AEK Athens,2947,1,4,2,0,7,1,6,14
PAOK Salonik,2947,2,2,3,1,9,4,5,9
P'thinaikos,2947,3,1,2,3,4,9,-5,5
Panionios,2947,4,1,1,4,4,10,-6,4
AEK Athens,2948,1,4,2,0,7,1,6,14
PAOK Salonik,2948,2,2,2,2,10,9,1,8
P'thinaikos,2948,3,2,1,3,9,10,-1,7
Panionios,2948,4,1,1,4,4,10,-6,4
AEK Athens,2949,1,4,2,0,7,1,6,14
PAOK Salonik,2949,2,2,2,2,10,6,4,8
P'thinaikos,2949,3,2,1,3,6,10,-4,7
Panionios,2949,4,1,1,4,4,10,-6,4
AEK Athens,2950,1,4,2,0,7,1,6,14
PAOK Salonik,2950,2,3,2,1,10,4,6,11
P'thinaikos,2950,3,1,1,4,4,10,-6,4
Panionios,2950,3,1,1,4,4,10,-6,4
AEK Athens,2951,1,4,2,0,7,1,6,14
PAOK Salonik,2951,2,3,2,1,11,4,7,11
Panionios,2951,3,1,1,4,4,10,-6,4
P'thinaikos,2951,4,1,1,4,4,11,-7,4
AEK Athens,2952,1,4,2,0,7,1,6,14
PAOK Salonik,2952,2,2,2,2,9,5,4,8
P'thinaikos,2952,3,2,1,3,5,9,-4,7
Panionios,2952,4,1,1,4,4,10,-6,4
AEK Athens,2953,1,4,2,0,7,1,6,14
PAOK Salonik,2953,2,2,2,2,9,5,4,8
P'thinaikos,2953,3,2,1,3,5,9,-4,7
Panionios,2953,4,1,1,4,4,10,-6,4
AEK Athens,2954,1,4,2,0,7,1,6,14
PAOK Salonik,2954,2,3,2,1,10,4,6,11
P'thinaikos,2954,3,1,1,4,4,10,-6,4
Panionios,2954,3,1,1,4,4,10,-6,4
AEK Athens,2955,1,4,2,0,7,1,6,14
PAOK Salonik,2955,2,2,3,1,12,7,5,9
P'thinaikos,2955,3,1,2,3,7,12,-5,5
Panionios,2955,4,1,1,4,4,10,-6,4
AEK Athens,2956,1,4,2,0,7,1,6,14
PAOK Salonik,2956,2,2,3,1,10,5,5,9
P'thinaikos,2956,3,1,2,3,5,10,-5,5
Panionios,2956,4,1,1,4,4,10,-6,4
AEK Athens,2957,1,4,2,0,7,1,6,14
PAOK Salonik,2957,2,2,3,1,10,5,5,9
P'thinaikos,2957,3,1,2,3,5,10,-5,5
Panionios,2957,4,1,1,4,4,10,-6,4
AEK Athens,2958,1,4,2,0,7,1,6,14
PAOK Salonik,2958,2,2,3,1,9,4,5,9
P'thinaikos,2958,3,1,2,3,4,9,-5,5
Panionios,2958,4,1,1,4,4,10,-6,4
AEK Athens,2959,1,4,2,0,7,1,6,14
PAOK Salonik,2959,2,2,2,2,11,7,4,8
P'thinaikos,2959,3,2,1,3,7,11,-4,7
Panionios,2959,4,1,1,4,4,10,-6,4
AEK Athens,2960,1,4,2,0,7,1,6,14
PAOK Salonik,2960,2,3,2,1,10,4,6,11
P'thinaikos,2960,3,1,1,4,4,10,-6,4
Panionios,2960,3,1,1,4,4,10,-6,4
AEK Athens,2961,1,4,2,0,7,1,6,14
PAOK Salonik,2961,2,3,2,1,11,5,6,11
P'thinaikos,2961,3,1,1,4,5,11,-6,4
Panionios,2961,4,1,1,4,4,10,-6,4
AEK Athens,2962,1,4,2,0,7,1,6,14
PAOK Salonik,2962,2,2,2,2,9,7,2,8
P'thinaikos,2962,3,2,1,3,7,9,-2,7
Panionios,2962,4,1,1,4,4,10,-6,4
AEK Athens,2963,1,4,2,0,7,1,6,14
PAOK Salonik,2963,2,2,3,1,11,6,5,9
P'thinaikos,2963,3,1,2,3,6,11,-5,5
Panionios,2963,4,1,1,4,4,10,-6,4
AEK Athens,2964,1,4,2,0,7,1,6,14
PAOK Salonik,2964,2,3,2,1,10,4,6,11
P'thinaikos,2964,3,1,1,4,4,10,-6,4
Panionios,2964,3,1,1,4,4,10,-6,4
AEK Athens,2965,1,4,2,0,7,1,6,14
PAOK Salonik,2965,2,3,2,1,11,5,6,11
P'thinaikos,2965,3,1,1,4,5,11,-6,4
Panionios,2965,4,1,1,4,4,10,-6,4
AEK Athens,2966,1,4,2,0,7,1,6,14
PAOK Salonik,2966,2,2,2,2,9,8,1,8
P'thinaikos,2966,3,2,1,3,8,9,-1,7
Panionios,2966,4,1,1,4,4,10,-6,4
AEK Athens,2967,1,4,2,0,7,1,6,14
PAOK Salonik,2967,2,2,3,1,10,5,5,9
P'thinaikos,2967,3,1,2,3,5,10,-5,5
Panionios,2967,4,1,1,4,4,10,-6,4
AEK Athens,2968,1,4,2,0,7,1,6,14
PAOK Salonik,2968,2,2,2,2,11,7,4,8
P'thinaikos,2968,3,2,1,3,7,11,-4,7
Panionios,2968,4,1,1,4,4,10,-6,4
AEK Athens,2969,1,4,2,0,7,1,6,14
PAOK Salonik,2969,2,3,2,1,10,4,6,11
P'thinaikos,2969,3,1,1,4,4,10,-6,4
Panionios,2969,3,1,1,4,4,10,-6,4
AEK Athens,2970,1,4,2,0,7,1,6,14
PAOK Salonik,2970,2,2,2,2,9,7,2,8
P'thinaikos,2970,3,2,1,3,7,9,-2,7
Panionios,2970,4,1,1,4,4,10,-6,4
AEK Athens,2971,1,4,2,0,7,1,6,14
PAOK Salonik,2971,2,2,2,2,11,7,4,8
P'thinaikos,2971,3,2,1,3,7,11,-4,7
Panionios,2971,4,1,1,4,4,10,-6,4
AEK Athens,2972,1,4,2,0,7,1,6,14
PAOK Salonik,2972,2,3,2,1,11,4,7,11
Panionios,2972,3,1,1,4,4,10,-6,4
P'thinaikos,2972,4,1,1,4,4,11,-7,4
AEK Athens,2973,1,4,2,0,7,1,6,14
PAOK Salonik,2973,2,3,2,1,12,4,8,11
Panionios,2973,3,1,1,4,4,10,-6,4
P'thinaikos,2973,4,1,1,4,4,12,-8,4
AEK Athens,2974,1,4,2,0,7,1,6,14
PAOK Salonik,2974,2,2,2,2,9,6,3,8
P'thinaikos,2974,3,2,1,3,6,9,-3,7
Panionios,2974,4,1,1,4,4,10,-6,4
AEK Athens,2975,1,4,2,0,7,1,6,14
PAOK Salonik,2975,2,2,3,1,9,4,5,9
P'thinaikos,2975,3,1,2,3,4,9,-5,5
Panionios,2975,4,1,1,4,4,10,-6,4
AEK Athens,2976,1,4,2,0,7,1,6,14
PAOK Salonik,2976,2,2,2,2,10,6,4,8
P'thinaikos,2976,3,2,1,3,6,10,-4,7
Panionios,2976,4,1,1,4,4,10,-6,4
AEK Athens,2977,1,4,2,0,7,1,6,14
PAOK Salonik,2977,2,2,2,2,9,5,4,8
P'thinaikos,2977,3,2,1,3,5,9,-4,7
Panionios,2977,4,1,1,4,4,10,-6,4
AEK Athens,2978,1,4,2,0,7,1,6,14
PAOK Salonik,2978,2,2,2,2,9,5,4,8
P'thinaikos,2978,3,2,1,3,5,9,-4,7
Panionios,2978,4,1,1,4,4,10,-6,4
AEK Athens,2979,1,4,2,0,7,1,6,14
PAOK Salonik,2979,2,3,2,1,10,4,6,11
P'thinaikos,2979,3,1,1,4,4,10,-6,4
Panionios,2979,3,1,1,4,4,10,-6,4
AEK Athens,2980,1,4,2,0,7,1,6,14
PAOK Salonik,2980,2,2,2,2,10,6,4,8
P'thinaikos,2980,3,2,1,3,6,10,-4,7
Panionios,2980,4,1,1,4,4,10,-6,4
AEK Athens,2981,1,4,2,0,7,1,6,14
PAOK Salonik,2981,2,2,3,1,10,5,5,9
P'thinaikos,2981,3,1,2,3,5,10,-5,5
Panionios,2981,4,1,1,4,4,10,-6,4
AEK Athens,2982,1,4,2,0,7,1,6,14
PAOK Salonik,2982,2,3,2,1,10,4,6,11
P'thinaikos,2982,3,1,1,4,4,10,-6,4
Panionios,2982,3,1,1,4,4,10,-6,4
AEK Athens,2983,1,4,2,0,7,1,6,14
PAOK Salonik,2983,2,2,3,1,10,5,5,9
P'thinaikos,2983,3,1,2,3,5,10,-5,5
Panionios,2983,4,1,1,4,4,10,-6,4
AEK Athens,2984,1,4,2,0,7,1,6,14
PAOK Salonik,2984,2,2,3,1,10,5,5,9
P'thinaikos,2984,3,1,2,3,5,10,-5,5
Panionios,2984,4,1,1,4,4,10,-6,4
AEK Athens,2985,1,4,2,0,7,1,6,14
PAOK Salonik,2985,2,2,2,2,9,6,3,8
P'thinaikos,2985,3,2,1,3,6,9,-3,7
Panionios,2985,4,1,1,4,4,10,-6,4
AEK Athens,2986,1,4,2,0,7,1,6,14
PAOK Salonik,2986,2,2,2,2,11,7,4,8
P'thinaikos,2986,3,2,1,3,7,11,-4,7
Panionios,2986,4,1,1,4,4,10,-6,4
AEK Athens,2987,1,4,2,0,7,1,6,14
PAOK Salonik,2987,2,2,2,2,9,6,3,8
P'thinaikos,2987,3,2,1,3,6,9,-3,7
Panionios,2987,4,1,1,4,4,10,-6,4
AEK Athens,2988,1,4,2,0,7,1,6,14
PAOK Salonik,2988,2,2,2,2,9,7,2,8
P'thinaikos,2988,3,2,1,3,7,9,-2,7
Panionios,2988,4,1,1,4,4,10,-6,4
AEK Athens,2989,1,4,2,0,7,1,6,14
PAOK Salonik,2989,2,3,2,1,12,6,6,11
P'thinaikos,2989,3,1,1,4,6,12,-6,4
Panionios,2989,4,1,1,4,4,10,-6,4
AEK Athens,2990,1,4,2,0,7,1,6,14
PAOK Salonik,2990,2,2,3,1,10,5,5,9
P'thinaikos,2990,3,1,2,3,5,10,-5,5
Panionios,2990,4,1,1,4,4,10,-6,4
AEK Athens,2991,1,4,2,0,7,1,6,14
PAOK Salonik,2991,2,2,2,2,9,6,3,8
P'thinaikos,2991,3,2,1,3,6,9,-3,7
Panionios,2991,4,1,1,4,4,10,-6,4
AEK Athens,2992,1,4,2,0,7,1,6,14
PAOK Salonik,2992,2,3,2,1,11,5,6,11
P'thinaikos,2992,3,1,1,4,5,11,-6,4
Panionios,2992,4,1,1,4,4,10,-6,4
AEK Athens,2993,1,4,2,0,7,1,6,14
PAOK Salonik,2993,2,3,2,1,11,5,6,11
P'thinaikos,2993,3,1,1,4,5,11,-6,4
Panionios,2993,4,1,1,4,4,10,-6,4
AEK Athens,2994,1,4,2,0,7,1,6,14
PAOK Salonik,2994,2,2,2,2,9,6,3,8
P'thinaikos,2994,3,2,1,3,6,9,-3,7
Panionios,2994,4,1,1,4,4,10,-6,4
AEK Athens,2995,1,4,2,0,7,1,6,14
PAOK Salonik,2995,2,3,2,1,11,4,7,11
Panionios,2995,3,1,1,4,4,10,-6,4
P'thinaikos,2995,4,1,1,4,4,11,-7,4
AEK Athens,2996,1,4,2,0,7,1,6,14
PAOK Salonik,2996,2,2,2,2,9,6,3,8
P'thinaikos,2996,3,2,1,3,6,9,-3,7
Panionios,2996,4,1,1,4,4,10,-6,4
AEK Athens,2997,1,4,2,0,7,1,6,14
PAOK Salonik,2997,2,2,2,2,10,7,3,8
P'thinaikos,2997,3,2,1,3,7,10,-3,7
Panionios,2997,4,1,1,4,4,10,-6,4
AEK Athens,2998,1,4,2,0,7,1,6,14
PAOK Salonik,2998,2,2,2,2,10,6,4,8
P'thinaikos,2998,3,2,1,3,6,10,-4,7
Panionios,2998,4,1,1,4,4,10,-6,4
AEK Athens,2999,1,4,2,0,7,1,6,14
PAOK Salonik,2999,2,3,2,1,13,5,8,11
Panionios,2999,3,1,1,4,4,10,-6,4
P'thinaikos,2999,4,1,1,4,5,13,-8,4
AEK Athens,3000,1,4,2,0,7,1,6,14
PAOK Salonik,3000,2,3,2,1,12,6,6,11
P'thinaikos,3000,3,1,1,4,6,12,-6,4
Panionios,3000,4,1,1,4,4,10,-6,4
AEK Athens,3001,1,4,2,0,7,1,6,14
PAOK Salonik,3001,2,2,2,2,10,6,4,8
P'thinaikos,3001,3,2,1,3,6,10,-4,7
Panionios,3001,4,1,1,4,4,10,-6,4
AEK Athens,3002,1,4,2,0,7,1,6,14
PAOK Salonik,3002,2,2,2,2,11,7,4,8
P'thinaikos,3002,3,2,1,3,7,11,-4,7
Panionios,3002,4,1,1,4,4,10,-6,4
AEK Athens,3003,1,4,2,0,7,1,6,14
PAOK Salonik,3003,2,2,3,1,9,4,5,9
P'thinaikos,3003,3,1,2,3,4,9,-5,5
Panionios,3003,4,1,1,4,4,10,-6,4
AEK Athens,3004,1,4,2,0,7,1,6,14
PAOK Salonik,3004,2,2,3,1,10,5,5,9
P'thinaikos,3004,3,1,2,3,5,10,-5,5
Panionios,3004,4,1,1,4,4,10,-6,4
AEK Athens,3005,1,4,2,0,7,1,6,14
PAOK Salonik,3005,2,2,2,2,10,8,2,8
P'thinaikos,3005,3,2,1,3,8,10,-2,7
Panionios,3005,4,1,1,4,4,10,-6,4
AEK Athens,3006,1,4,2,0,7,1,6,14
PAOK Salonik,3006,2,2,3,1,10,5,5,9
P'thinaikos,3006,3,1,2,3,5,10,-5,5
Panionios,3006,4,1,1,4,4,10,-6,4
AEK Athens,3007,1,4,2,0,7,1,6,14
PAOK Salonik,3007,2,2,2,2,11,7,4,8
P'thinaikos,3007,3,2,1,3,7,11,-4,7
Panionios,3007,4,1,1,4,4,10,-6,4
AEK Athens,3008,1,4,2,0,7,1,6,14
PAOK Salonik,3008,2,3,2,1,10,4,6,11
P'thinaikos,3008,3,1,1,4,4,10,-6,4
Panionios,3008,3,1,1,4,4,10,-6,4
AEK Athens,3009,1,4,2,0,7,1,6,14
PAOK Salonik,3009,2,3,2,1,11,4,7,11
Panionios,3009,3,1,1,4,4,10,-6,4
P'thinaikos,3009,4,1,1,4,4,11,-7,4
AEK Athens,3010,1,4,2,0,7,1,6,14
PAOK Salonik,3010,2,2,2,2,11,7,4,8
P'thinaikos,3010,3,2,1,3,7,11,-4,7
Panionios,3010,4,1,1,4,4,10,-6,4
AEK Athens,3011,1,4,2,0,7,1,6,14
PAOK Salonik,3011,2,2,2,2,9,6,3,8
P'thinaikos,3011,3,2,1,3,6,9,-3,7
Panionios,3011,4,1,1,4,4,10,-6,4
AEK Athens,3012,1,4,2,0,7,1,6,14
PAOK Salonik,3012,2,2,3,1,10,5,5,9
P'thinaikos,3012,3,1,2,3,5,10,-5,5
Panionios,3012,4,1,1,4,4,10,-6,4
AEK Athens,3013,1,4,2,0,7,1,6,14
PAOK Salonik,3013,2,2,3,1,10,5,5,9
P'thinaikos,3013,3,1,2,3,5,10,-5,5
Panionios,3013,4,1,1,4,4,10,-6,4
AEK Athens,3014,1,4,2,0,7,1,6,14
PAOK Salonik,3014,2,2,3,1,12,7,5,9
P'thinaikos,3014,3,1,2,3,7,12,-5,5
Panionios,3014,4,1,1,4,4,10,-6,4
AEK Athens,3015,1,4,2,0,7,1,6,14
PAOK Salonik,3015,2,2,2,2,10,6,4,8
P'thinaikos,3015,3,2,1,3,6,10,-4,7
Panionios,3015,4,1,1,4,4,10,-6,4
AEK Athens,3016,1,4,2,0,7,1,6,14
PAOK Salonik,3016,2,2,3,1,9,4,5,9
P'thinaikos,3016,3,1,2,3,4,9,-5,5
Panionios,3016,4,1,1,4,4,10,-6,4
AEK Athens,3017,1,4,2,0,7,1,6,14
PAOK Salonik,3017,2,2,3,1,9,4,5,9
P'thinaikos,3017,3,1,2,3,4,9,-5,5
Panionios,3017,4,1,1,4,4,10,-6,4
AEK Athens,3018,1,4,2,0,7,1,6,14
PAOK Salonik,3018,2,3,2,1,12,5,7,11
Panionios,3018,3,1,1,4,4,10,-6,4
P'thinaikos,3018,4,1,1,4,5,12,-7,4
AEK Athens,3019,1,4,2,0,7,1,6,14
PAOK Salonik,3019,2,2,3,1,9,4,5,9
P'thinaikos,3019,3,1,2,3,4,9,-5,5
Panionios,3019,4,1,1,4,4,10,-6,4
AEK Athens,3020,1,4,2,0,7,1,6,14
PAOK Salonik,3020,2,3,2,1,11,4,7,11
Panionios,3020,3,1,1,4,4,10,-6,4
P'thinaikos,3020,4,1,1,4,4,11,-7,4
AEK Athens,3021,1,4,2,0,7,1,6,14
PAOK Salonik,3021,2,2,2,2,9,5,4,8
P'thinaikos,3021,3,2,1,3,5,9,-4,7
Panionios,3021,4,1,1,4,4,10,-6,4
AEK Athens,3022,1,4,2,0,7,1,6,14
PAOK Salonik,3022,2,3,2,1,12,5,7,11
Panionios,3022,3,1,1,4,4,10,-6,4
P'thinaikos,3022,4,1,1,4,5,12,-7,4
AEK Athens,3023,1,4,2,0,7,1,6,14
PAOK Salonik,3023,2,3,2,1,11,4,7,11
Panionios,3023,3,1,1,4,4,10,-6,4
P'thinaikos,3023,4,1,1,4,4,11,-7,4
AEK Athens,3024,1,4,2,0,7,1,6,14
PAOK Salonik,3024,2,2,3,1,9,4,5,9
P'thinaikos,3024,3,1,2,3,4,9,-5,5
Panionios,3024,4,1,1,4,4,10,-6,4
AEK Athens,3025,1,4,2,0,7,1,6,14
PAOK Salonik,3025,2,3,2,1,12,5,7,11
Panionios,3025,3,1,1,4,4,10,-6,4
P'thinaikos,3025,4,1,1,4,5,12,-7,4
AEK Athens,3026,1,4,2,0,7,1,6,14
PAOK Salonik,3026,2,2,2,2,9,6,3,8
P'thinaikos,3026,3,2,1,3,6,9,-3,7
Panionios,3026,4,1,1,4,4,10,-6,4
AEK Athens,3027,1,4,2,0,7,1,6,14
PAOK Salonik,3027,2,3,2,1,11,5,6,11
P'thinaikos,3027,3,1,1,4,5,11,-6,4
Panionios,3027,4,1,1,4,4,10,-6,4
AEK Athens,3028,1,4,2,0,7,1,6,14
PAOK Salonik,3028,2,3,2,1,12,5,7,11
Panionios,3028,3,1,1,4,4,10,-6,4
P'thinaikos,3028,4,1,1,4,5,12,-7,4
AEK Athens,3029,1,4,2,0,7,1,6,14
PAOK Salonik,3029,2,2,3,1,9,4,5,9
P'thinaikos,3029,3,1,2,3,4,9,-5,5
Panionios,3029,4,1,1,4,4,10,-6,4
AEK Athens,3030,1,4,2,0,7,1,6,14
PAOK Salonik,3030,2,2,2,2,10,7,3,8
P'thinaikos,3030,3,2,1,3,7,10,-3,7
Panionios,3030,4,1,1,4,4,10,-6,4
AEK Athens,3031,1,4,2,0,7,1,6,14
PAOK Salonik,3031,2,2,2,2,11,7,4,8
P'thinaikos,3031,3,2,1,3,7,11,-4,7
Panionios,3031,4,1,1,4,4,10,-6,4
AEK Athens,3032,1,4,2,0,7,1,6,14
PAOK Salonik,3032,2,2,2,2,9,6,3,8
P'thinaikos,3032,3,2,1,3,6,9,-3,7
Panionios,3032,4,1,1,4,4,10,-6,4
AEK Athens,3033,1,4,2,0,7,1,6,14
PAOK Salonik,3033,2,3,2,1,13,5,8,11
Panionios,3033,3,1,1,4,4,10,-6,4
P'thinaikos,3033,4,1,1,4,5,13,-8,4
AEK Athens,3034,1,4,2,0,7,1,6,14
PAOK Salonik,3034,2,3,2,1,12,6,6,11
P'thinaikos,3034,3,1,1,4,6,12,-6,4
Panionios,3034,4,1,1,4,4,10,-6,4
AEK Athens,3035,1,4,2,0,7,1,6,14
PAOK Salonik,3035,2,3,2,1,12,6,6,11
P'thinaikos,3035,3,1,1,4,6,12,-6,4
Panionios,3035,4,1,1,4,4,10,-6,4
AEK Athens,3036,1,4,2,0,7,1,6,14
PAOK Salonik,3036,2,2,3,1,9,4,5,9
P'thinaikos,3036,3,1,2,3,4,9,-5,5
Panionios,3036,4,1,1,4,4,10,-6,4
AEK Athens,3037,1,4,2,0,7,1,6,14
PAOK Salonik,3037,2,2,2,2,9,5,4,8
P'thinaikos,3037,3,2,1,3,5,9,-4,7
Panionios,3037,4,1,1,4,4,10,-6,4
AEK Athens,3038,1,4,2,0,7,1,6,14
PAOK Salonik,3038,2,2,2,2,9,6,3,8
P'thinaikos,3038,3,2,1,3,6,9,-3,7
Panionios,3038,4,1,1,4,4,10,-6,4
AEK Athens,3039,1,4,2,0,7,1,6,14
PAOK Salonik,3039,2,2,2,2,10,6,4,8
P'thinaikos,3039,3,2,1,3,6,10,-4,7
Panionios,3039,4,1,1,4,4,10,-6,4
AEK Athens,3040,1,4,2,0,7,1,6,14
PAOK Salonik,3040,2,3,2,1,11,5,6,11
P'thinaikos,3040,3,1,1,4,5,11,-6,4
Panionios,3040,4,1,1,4,4,10,-6,4
AEK Athens,3041,1,4,2,0,7,1,6,14
PAOK Salonik,3041,2,2,3,1,9,4,5,9
P'thinaikos,3041,3,1,2,3,4,9,-5,5
Panionios,3041,4,1,1,4,4,10,-6,4
AEK Athens,3042,1,4,2,0,7,1,6,14
PAOK Salonik,3042,2,3,2,1,11,5,6,11
P'thinaikos,3042,3,1,1,4,5,11,-6,4
Panionios,3042,4,1,1,4,4,10,-6,4
AEK Athens,3043,1,4,2,0,7,1,6,14
PAOK Salonik,3043,2,2,2,2,10,8,2,8
P'thinaikos,3043,3,2,1,3,8,10,-2,7
Panionios,3043,4,1,1,4,4,10,-6,4
AEK Athens,3044,1,4,2,0,7,1,6,14
PAOK Salonik,3044,2,3,2,1,12,4,8,11
Panionios,3044,3,1,1,4,4,10,-6,4
P'thinaikos,3044,4,1,1,4,4,12,-8,4
AEK Athens,3045,1,4,2,0,7,1,6,14
PAOK Salonik,3045,2,3,2,1,12,5,7,11
Panionios,3045,3,1,1,4,4,10,-6,4
P'thinaikos,3045,4,1,1,4,5,12,-7,4
AEK Athens,3046,1,4,2,0,7,1,6,14
PAOK Salonik,3046,2,3,2,1,10,4,6,11
P'thinaikos,3046,3,1,1,4,4,10,-6,4
Panionios,3046,3,1,1,4,4,10,-6,4
AEK Athens,3047,1,4,2,0,7,1,6,14
PAOK Salonik,3047,2,2,2,2,10,7,3,8
P'thinaikos,3047,3,2,1,3,7,10,-3,7
Panionios,3047,4,1,1,4,4,10,-6,4
AEK Athens,3048,1,4,2,0,7,1,6,14
PAOK Salonik,3048,2,3,2,1,11,4,7,11
Panionios,3048,3,1,1,4,4,10,-6,4
P'thinaikos,3048,4,1,1,4,4,11,-7,4
AEK Athens,3049,1,4,2,0,7,1,6,14
PAOK Salonik,3049,2,2,2,2,10,7,3,8
P'thinaikos,3049,3,2,1,3,7,10,-3,7
Panionios,3049,4,1,1,4,4,10,-6,4
AEK Athens,3050,1,4,2,0,7,1,6,14
PAOK Salonik,3050,2,3,2,1,10,4,6,11
P'thinaikos,3050,3,1,1,4,4,10,-6,4
Panionios,3050,3,1,1,4,4,10,-6,4
AEK Athens,3051,1,4,2,0,7,1,6,14
PAOK Salonik,3051,2,2,2,2,10,6,4,8
P'thinaikos,3051,3,2,1,3,6,10,-4,7
Panionios,3051,4,1,1,4,4,10,-6,4
AEK Athens,3052,1,4,2,0,7,1,6,14
PAOK Salonik,3052,2,2,3,1,11,6,5,9
P'thinaikos,3052,3,1,2,3,6,11,-5,5
Panionios,3052,4,1,1,4,4,10,-6,4
AEK Athens,3053,1,4,2,0,7,1,6,14
PAOK Salonik,3053,2,3,2,1,11,4,7,11
Panionios,3053,3,1,1,4,4,10,-6,4
P'thinaikos,3053,4,1,1,4,4,11,-7,4
AEK Athens,3054,1,4,2,0,7,1,6,14
PAOK Salonik,3054,2,2,2,2,9,6,3,8
P'thinaikos,3054,3,2,1,3,6,9,-3,7
Panionios,3054,4,1,1,4,4,10,-6,4
AEK Athens,3055,1,4,2,0,7,1,6,14
PAOK Salonik,3055,2,2,2,2,9,5,4,8
P'thinaikos,3055,3,2,1,3,5,9,-4,7
Panionios,3055,4,1,1,4,4,10,-6,4
AEK Athens,3056,1,4,2,0,7,1,6,14
PAOK Salonik,3056,2,3,2,1,10,4,6,11
P'thinaikos,3056,3,1,1,4,4,10,-6,4
Panionios,3056,3,1,1,4,4,10,-6,4
AEK Athens,3057,1,4,2,0,7,1,6,14
PAOK Salonik,3057,2,2,2,2,9,7,2,8
P'thinaikos,3057,3,2,1,3,7,9,-2,7
Panionios,3057,4,1,1,4,4,10,-6,4
AEK Athens,3058,1,4,2,0,7,1,6,14
PAOK Salonik,3058,2,2,3,1,10,5,5,9
P'thinaikos,3058,3,1,2,3,5,10,-5,5
Panionios,3058,4,1,1,4,4,10,-6,4
AEK Athens,3059,1,4,2,0,7,1,6,14
PAOK Salonik,3059,2,3,2,1,11,5,6,11
P'thinaikos,3059,3,1,1,4,5,11,-6,4
Panionios,3059,4,1,1,4,4,10,-6,4
AEK Athens,3060,1,4,2,0,7,1,6,14
PAOK Salonik,3060,2,2,3,1,9,4,5,9
P'thinaikos,3060,3,1,2,3,4,9,-5,5
Panionios,3060,4,1,1,4,4,10,-6,4
AEK Athens,3061,1,4,2,0,7,1,6,14
PAOK Salonik,3061,2,2,2,2,11,7,4,8
P'thinaikos,3061,3,2,1,3,7,11,-4,7
Panionios,3061,4,1,1,4,4,10,-6,4
AEK Athens,3062,1,4,2,0,7,1,6,14
PAOK Salonik,3062,2,3,2,1,11,4,7,11
Panionios,3062,3,1,1,4,4,10,-6,4
P'thinaikos,3062,4,1,1,4,4,11,-7,4
AEK Athens,3063,1,4,2,0,7,1,6,14
PAOK Salonik,3063,2,2,3,1,10,5,5,9
P'thinaikos,3063,3,1,2,3,5,10,-5,5
Panionios,3063,4,1,1,4,4,10,-6,4
AEK Athens,3064,1,4,2,0,7,1,6,14
PAOK Salonik,3064,2,2,3,1,9,4,5,9
P'thinaikos,3064,3,1,2,3,4,9,-5,5
Panionios,3064,4,1,1,4,4,10,-6,4
AEK Athens,3065,1,4,2,0,7,1,6,14
PAOK Salonik,3065,2,3,2,1,11,4,7,11
Panionios,3065,3,1,1,4,4,10,-6,4
P'thinaikos,3065,4,1,1,4,4,11,-7,4
AEK Athens,3066,1,4,2,0,7,1,6,14
PAOK Salonik,3066,2,2,2,2,9,5,4,8
P'thinaikos,3066,3,2,1,3,5,9,-4,7
Panionios,3066,4,1,1,4,4,10,-6,4
AEK Athens,3067,1,4,2,0,7,1,6,14
PAOK Salonik,3067,2,3,2,1,12,5,7,11
Panionios,3067,3,1,1,4,4,10,-6,4
P'thinaikos,3067,4,1,1,4,5,12,-7,4
AEK Athens,3068,1,4,2,0,7,1,6,14
PAOK Salonik,3068,2,3,2,1,11,4,7,11
Panionios,3068,3,1,1,4,4,10,-6,4
P'thinaikos,3068,4,1,1,4,4,11,-7,4
AEK Athens,3069,1,4,2,0,7,1,6,14
PAOK Salonik,3069,2,3,2,1,11,5,6,11
P'thinaikos,3069,3,1,1,4,5,11,-6,4
Panionios,3069,4,1,1,4,4,10,-6,4
AEK Athens,3070,1,4,2,0,7,1,6,14
PAOK Salonik,3070,2,3,2,1,11,5,6,11
P'thinaikos,3070,3,1,1,4,5,11,-6,4
Panionios,3070,4,1,1,4,4,10,-6,4
AEK Athens,3071,1,4,2,0,7,1,6,14
PAOK Salonik,3071,2,3,2,1,12,5,7,11
Panionios,3071,3,1,1,4,4,10,-6,4
P'thinaikos,3071,4,1,1,4,5,12,-7,4
AEK Athens,3072,1,4,2,0,7,1,6,14
PAOK Salonik,3072,2,2,3,1,9,4,5,9
P'thinaikos,3072,3,1,2,3,4,9,-5,5
Panionios,3072,4,1,1,4,4,10,-6,4
AEK Athens,3073,1,4,2,0,7,1,6,14
PAOK Salonik,3073,2,2,2,2,11,8,3,8
P'thinaikos,3073,3,2,1,3,8,11,-3,7
Panionios,3073,4,1,1,4,4,10,-6,4
AEK Athens,3074,1,4,2,0,7,1,6,14
PAOK Salonik,3074,2,2,2,2,9,5,4,8
P'thinaikos,3074,3,2,1,3,5,9,-4,7
Panionios,3074,4,1,1,4,4,10,-6,4
AEK Athens,3075,1,4,2,0,7,1,6,14
PAOK Salonik,3075,2,2,3,1,10,5,5,9
P'thinaikos,3075,3,1,2,3,5,10,-5,5
Panionios,3075,4,1,1,4,4,10,-6,4
AEK Athens,3076,1,4,2,0,7,1,6,14
PAOK Salonik,3076,2,2,2,2,10,8,2,8
P'thinaikos,3076,3,2,1,3,8,10,-2,7
Panionios,3076,4,1,1,4,4,10,-6,4
AEK Athens,3077,1,4,2,0,7,1,6,14
PAOK Salonik,3077,2,3,2,1,11,5,6,11
P'thinaikos,3077,3,1,1,4,5,11,-6,4
Panionios,3077,4,1,1,4,4,10,-6,4
AEK Athens,3078,1,4,2,0,7,1,6,14
PAOK Salonik,3078,2,3,2,1,12,5,7,11
Panionios,3078,3,1,1,4,4,10,-6,4
P'thinaikos,3078,4,1,1,4,5,12,-7,4
AEK Athens,3079,1,4,2,0,7,1,6,14
PAOK Salonik,3079,2,3,2,1,15,6,9,11
Panionios,3079,3,1,1,4,4,10,-6,4
P'thinaikos,3079,4,1,1,4,6,15,-9,4
AEK Athens,3080,1,4,2,0,7,1,6,14
PAOK Salonik,3080,2,2,3,1,11,6,5,9
P'thinaikos,3080,3,1,2,3,6,11,-5,5
Panionios,3080,4,1,1,4,4,10,-6,4
AEK Athens,3081,1,4,2,0,7,1,6,14
PAOK Salonik,3081,2,3,2,1,10,4,6,11
P'thinaikos,3081,3,1,1,4,4,10,-6,4
Panionios,3081,3,1,1,4,4,10,-6,4
AEK Athens,3082,1,4,2,0,7,1,6,14
PAOK Salonik,3082,2,2,2,2,9,8,1,8
P'thinaikos,3082,3,2,1,3,8,9,-1,7
Panionios,3082,4,1,1,4,4,10,-6,4
AEK Athens,3083,1,4,2,0,7,1,6,14
PAOK Salonik,3083,2,2,2,2,10,6,4,8
P'thinaikos,3083,3,2,1,3,6,10,-4,7
Panionios,3083,4,1,1,4,4,10,-6,4
AEK Athens,3084,1,4,2,0,7,1,6,14
PAOK Salonik,3084,2,2,2,2,9,5,4,8
P'thinaikos,3084,3,2,1,3,5,9,-4,7
Panionios,3084,4,1,1,4,4,10,-6,4
AEK Athens,3085,1,4,2,0,7,1,6,14
PAOK Salonik,3085,2,2,3,1,10,5,5,9
P'thinaikos,3085,3,1,2,3,5,10,-5,5
Panionios,3085,4,1,1,4,4,10,-6,4
AEK Athens,3086,1,4,2,0,7,1,6,14
PAOK Salonik,3086,2,3,2,1,11,4,7,11
Panionios,3086,3,1,1,4,4,10,-6,4
P'thinaikos,3086,4,1,1,4,4,11,-7,4
AEK Athens,3087,1,4,2,0,7,1,6,14
PAOK Salonik,3087,2,2,3,1,10,5,5,9
P'thinaikos,3087,3,1,2,3,5,10,-5,5
Panionios,3087,4,1,1,4,4,10,-6,4
AEK Athens,3088,1,4,2,0,7,1,6,14
PAOK Salonik,3088,2,2,2,2,9,6,3,8
P'thinaikos,3088,3,2,1,3,6,9,-3,7
Panionios,3088,4,1,1,4,4,10,-6,4
AEK Athens,3089,1,4,2,0,7,1,6,14
PAOK Salonik,3089,2,2,2,2,9,8,1,8
P'thinaikos,3089,3,2,1,3,8,9,-1,7
Panionios,3089,4,1,1,4,4,10,-6,4
AEK Athens,3090,1,4,2,0,7,1,6,14
PAOK Salonik,3090,2,3,2,1,10,4,6,11
P'thinaikos,3090,3,1,1,4,4,10,-6,4
Panionios,3090,3,1,1,4,4,10,-6,4
AEK Athens,3091,1,4,2,0,7,1,6,14
PAOK Salonik,3091,2,2,3,1,10,5,5,9
P'thinaikos,3091,3,1,2,3,5,10,-5,5
Panionios,3091,4,1,1,4,4,10,-6,4
AEK Athens,3092,1,4,2,0,7,1,6,14
PAOK Salonik,3092,2,3,2,1,12,6,6,11
P'thinaikos,3092,3,1,1,4,6,12,-6,4
Panionios,3092,4,1,1,4,4,10,-6,4
AEK Athens,3093,1,4,2,0,7,1,6,14
PAOK Salonik,3093,2,2,2,2,9,7,2,8
P'thinaikos,3093,3,2,1,3,7,9,-2,7
Panionios,3093,4,1,1,4,4,10,-6,4
AEK Athens,3094,1,4,2,0,7,1,6,14
PAOK Salonik,3094,2,3,2,1,12,6,6,11
P'thinaikos,3094,3,1,1,4,6,12,-6,4
Panionios,3094,4,1,1,4,4,10,-6,4
AEK Athens,3095,1,4,2,0,7,1,6,14
PAOK Salonik,3095,2,3,2,1,10,4,6,11
P'thinaikos,3095,3,1,1,4,4,10,-6,4
Panionios,3095,3,1,1,4,4,10,-6,4
AEK Athens,3096,1,4,2,0,7,1,6,14
PAOK Salonik,3096,2,2,3,1,9,4,5,9
P'thinaikos,3096,3,1,2,3,4,9,-5,5
Panionios,3096,4,1,1,4,4,10,-6,4
AEK Athens,3097,1,4,2,0,7,1,6,14
PAOK Salonik,3097,2,3,2,1,11,4,7,11
Panionios,3097,3,1,1,4,4,10,-6,4
P'thinaikos,3097,4,1,1,4,4,11,-7,4
AEK Athens,3098,1,4,2,0,7,1,6,14
PAOK Salonik,3098,2,2,2,2,9,6,3,8
P'thinaikos,3098,3,2,1,3,6,9,-3,7
Panionios,3098,4,1,1,4,4,10,-6,4
AEK Athens,3099,1,4,2,0,7,1,6,14
PAOK Salonik,3099,2,2,2,2,11,7,4,8
P'thinaikos,3099,3,2,1,3,7,11,-4,7
Panionios,3099,4,1,1,4,4,10,-6,4
AEK Athens,3100,1,4,2,0,7,1,6,14
PAOK Salonik,3100,2,2,2,2,10,6,4,8
P'thinaikos,3100,3,2,1,3,6,10,-4,7
Panionios,3100,4,1,1,4,4,10,-6,4
AEK Athens,3101,1,4,2,0,7,1,6,14
PAOK Salonik,3101,2,3,2,1,12,5,7,11
Panionios,3101,3,1,1,4,4,10,-6,4
P'thinaikos,3101,4,1,1,4,5,12,-7,4
AEK Athens,3102,1,4,2,0,7,1,6,14
PAOK Salonik,3102,2,2,2,2,9,7,2,8
P'thinaikos,3102,3,2,1,3,7,9,-2,7
Panionios,3102,4,1,1,4,4,10,-6,4
AEK Athens,3103,1,4,2,0,7,1,6,14
PAOK Salonik,3103,2,3,2,1,10,4,6,11
P'thinaikos,3103,3,1,1,4,4,10,-6,4
Panionios,3103,3,1,1,4,4,10,-6,4
AEK Athens,3104,1,4,2,0,7,1,6,14
PAOK Salonik,3104,2,2,2,2,9,6,3,8
P'thinaikos,3104,3,2,1,3,6,9,-3,7
Panionios,3104,4,1,1,4,4,10,-6,4
AEK Athens,3105,1,4,2,0,7,1,6,14
PAOK Salonik,3105,2,2,2,2,9,6,3,8
P'thinaikos,3105,3,2,1,3,6,9,-3,7
Panionios,3105,4,1,1,4,4,10,-6,4
AEK Athens,3106,1,4,2,0,7,1,6,14
PAOK Salonik,3106,2,3,2,1,11,4,7,11
Panionios,3106,3,1,1,4,4,10,-6,4
P'thinaikos,3106,4,1,1,4,4,11,-7,4
AEK Athens,3107,1,4,2,0,7,1,6,14
PAOK Salonik,3107,2,3,2,1,14,4,10,11
Panionios,3107,3,1,1,4,4,10,-6,4
P'thinaikos,3107,4,1,1,4,4,14,-10,4
AEK Athens,3108,1,4,2,0,7,1,6,14
PAOK Salonik,3108,2,2,3,1,10,5,5,9
P'thinaikos,3108,3,1,2,3,5,10,-5,5
Panionios,3108,4,1,1,4,4,10,-6,4
AEK Athens,3109,1,4,2,0,7,1,6,14
PAOK Salonik,3109,2,2,2,2,9,8,1,8
P'thinaikos,3109,3,2,1,3,8,9,-1,7
Panionios,3109,4,1,1,4,4,10,-6,4
AEK Athens,3110,1,4,2,0,7,1,6,14
PAOK Salonik,3110,2,2,2,2,9,8,1,8
P'thinaikos,3110,3,2,1,3,8,9,-1,7
Panionios,3110,4,1,1,4,4,10,-6,4
AEK Athens,3111,1,4,2,0,7,1,6,14
PAOK Salonik,3111,2,2,2,2,11,7,4,8
P'thinaikos,3111,3,2,1,3,7,11,-4,7
Panionios,3111,4,1,1,4,4,10,-6,4
AEK Athens,3112,1,4,2,0,7,1,6,14
PAOK Salonik,3112,2,3,2,1,11,5,6,11
P'thinaikos,3112,3,1,1,4,5,11,-6,4
Panionios,3112,4,1,1,4,4,10,-6,4
AEK Athens,3113,1,4,2,0,7,1,6,14
PAOK Salonik,3113,2,3,2,1,10,4,6,11
P'thinaikos,3113,3,1,1,4,4,10,-6,4
Panionios,3113,3,1,1,4,4,10,-6,4
AEK Athens,3114,1,4,2,0,7,1,6,14
PAOK Salonik,3114,2,2,2,2,9,6,3,8
P'thinaikos,3114,3,2,1,3,6,9,-3,7
Panionios,3114,4,1,1,4,4,10,-6,4
AEK Athens,3115,1,4,2,0,7,1,6,14
PAOK Salonik,3115,2,2,3,1,10,5,5,9
P'thinaikos,3115,3,1,2,3,5,10,-5,5
Panionios,3115,4,1,1,4,4,10,-6,4
AEK Athens,3116,1,4,2,0,7,1,6,14
PAOK Salonik,3116,2,2,2,2,10,6,4,8
P'thinaikos,3116,3,2,1,3,6,10,-4,7
Panionios,3116,4,1,1,4,4,10,-6,4
AEK Athens,3117,1,4,2,0,7,1,6,14
PAOK Salonik,3117,2,3,2,1,10,4,6,11
P'thinaikos,3117,3,1,1,4,4,10,-6,4
Panionios,3117,3,1,1,4,4,10,-6,4
AEK Athens,3118,1,4,2,0,7,1,6,14
PAOK Salonik,3118,2,3,2,1,11,5,6,11
P'thinaikos,3118,3,1,1,4,5,11,-6,4
Panionios,3118,4,1,1,4,4,10,-6,4
AEK Athens,3119,1,4,2,0,7,1,6,14
PAOK Salonik,3119,2,3,2,1,12,6,6,11
P'thinaikos,3119,3,1,1,4,6,12,-6,4
Panionios,3119,4,1,1,4,4,10,-6,4
AEK Athens,3120,1,4,2,0,7,1,6,14
PAOK Salonik,3120,2,2,3,1,10,5,5,9
P'thinaikos,3120,3,1,2,3,5,10,-5,5
Panionios,3120,4,1,1,4,4,10,-6,4
AEK Athens,3121,1,4,2,0,7,1,6,14
PAOK Salonik,3121,2,3,2,1,10,4,6,11
P'thinaikos,3121,3,1,1,4,4,10,-6,4
Panionios,3121,3,1,1,4,4,10,-6,4
AEK Athens,3122,1,4,2,0,7,1,6,14
PAOK Salonik,3122,2,2,3,1,10,5,5,9
P'thinaikos,3122,3,1,2,3,5,10,-5,5
Panionios,3122,4,1,1,4,4,10,-6,4
AEK Athens,3123,1,4,2,0,7,1,6,14
PAOK Salonik,3123,2,2,3,1,10,5,5,9
P'thinaikos,3123,3,1,2,3,5,10,-5,5
Panionios,3123,4,1,1,4,4,10,-6,4
AEK Athens,3124,1,4,2,0,7,1,6,14
PAOK Salonik,3124,2,3,2,1,11,5,6,11
P'thinaikos,3124,3,1,1,4,5,11,-6,4
Panionios,3124,4,1,1,4,4,10,-6,4
AEK Athens,3125,1,4,2,0,7,1,6,14
PAOK Salonik,3125,2,3,2,1,11,5,6,11
P'thinaikos,3125,3,1,1,4,5,11,-6,4
Panionios,3125,4,1,1,4,4,10,-6,4
AEK Athens,3126,1,4,2,0,7,1,6,14
PAOK Salonik,3126,2,2,3,1,9,4,5,9
P'thinaikos,3126,3,1,2,3,4,9,-5,5
Panionios,3126,4,1,1,4,4,10,-6,4
AEK Athens,3127,1,4,2,0,7,1,6,14
PAOK Salonik,3127,2,2,2,2,10,6,4,8
P'thinaikos,3127,3,2,1,3,6,10,-4,7
Panionios,3127,4,1,1,4,4,10,-6,4
AEK Athens,3128,1,4,2,0,7,1,6,14
PAOK Salonik,3128,2,2,3,1,11,6,5,9
P'thinaikos,3128,3,1,2,3,6,11,-5,5
Panionios,3128,4,1,1,4,4,10,-6,4
AEK Athens,3129,1,4,2,0,7,1,6,14
PAOK Salonik,3129,2,3,2,1,11,5,6,11
P'thinaikos,3129,3,1,1,4,5,11,-6,4
Panionios,3129,4,1,1,4,4,10,-6,4
AEK Athens,3130,1,4,2,0,7,1,6,14
PAOK Salonik,3130,2,3,2,1,13,5,8,11
Panionios,3130,3,1,1,4,4,10,-6,4
P'thinaikos,3130,4,1,1,4,5,13,-8,4
AEK Athens,3131,1,4,2,0,7,1,6,14
PAOK Salonik,3131,2,2,3,1,10,5,5,9
P'thinaikos,3131,3,1,2,3,5,10,-5,5
Panionios,3131,4,1,1,4,4,10,-6,4
AEK Athens,3132,1,4,2,0,7,1,6,14
PAOK Salonik,3132,2,3,2,1,10,4,6,11
P'thinaikos,3132,3,1,1,4,4,10,-6,4
Panionios,3132,3,1,1,4,4,10,-6,4
AEK Athens,3133,1,4,2,0,7,1,6,14
PAOK Salonik,3133,2,2,3,1,9,4,5,9
P'thinaikos,3133,3,1,2,3,4,9,-5,5
Panionios,3133,4,1,1,4,4,10,-6,4
AEK Athens,3134,1,4,2,0,7,1,6,14
PAOK Salonik,3134,2,2,3,1,9,4,5,9
P'thinaikos,3134,3,1,2,3,4,9,-5,5
Panionios,3134,4,1,1,4,4,10,-6,4
AEK Athens,3135,1,4,2,0,7,1,6,14
PAOK Salonik,3135,2,3,2,1,11,4,7,11
Panionios,3135,3,1,1,4,4,10,-6,4
P'thinaikos,3135,4,1,1,4,4,11,-7,4
AEK Athens,3136,1,4,2,0,7,1,6,14
PAOK Salonik,3136,2,2,3,1,12,7,5,9
P'thinaikos,3136,3,1,2,3,7,12,-5,5
Panionios,3136,4,1,1,4,4,10,-6,4
AEK Athens,3137,1,4,2,0,7,1,6,14
PAOK Salonik,3137,2,2,2,2,9,5,4,8
P'thinaikos,3137,3,2,1,3,5,9,-4,7
Panionios,3137,4,1,1,4,4,10,-6,4
AEK Athens,3138,1,4,2,0,7,1,6,14
PAOK Salonik,3138,2,3,2,1,12,4,8,11
Panionios,3138,3,1,1,4,4,10,-6,4
P'thinaikos,3138,4,1,1,4,4,12,-8,4
AEK Athens,3139,1,4,2,0,7,1,6,14
PAOK Salonik,3139,2,2,3,1,10,5,5,9
P'thinaikos,3139,3,1,2,3,5,10,-5,5
Panionios,3139,4,1,1,4,4,10,-6,4
AEK Athens,3140,1,4,2,0,7,1,6,14
PAOK Salonik,3140,2,2,2,2,9,6,3,8
P'thinaikos,3140,3,2,1,3,6,9,-3,7
Panionios,3140,4,1,1,4,4,10,-6,4
AEK Athens,3141,1,4,2,0,7,1,6,14
PAOK Salonik,3141,2,3,2,1,10,4,6,11
P'thinaikos,3141,3,1,1,4,4,10,-6,4
Panionios,3141,3,1,1,4,4,10,-6,4
AEK Athens,3142,1,4,2,0,7,1,6,14
PAOK Salonik,3142,2,2,2,2,10,8,2,8
P'thinaikos,3142,3,2,1,3,8,10,-2,7
Panionios,3142,4,1,1,4,4,10,-6,4
AEK Athens,3143,1,4,2,0,7,1,6,14
PAOK Salonik,3143,2,3,2,1,12,4,8,11
Panionios,3143,3,1,1,4,4,10,-6,4
P'thinaikos,3143,4,1,1,4,4,12,-8,4
AEK Athens,3144,1,4,2,0,7,1,6,14
PAOK Salonik,3144,2,2,2,2,9,5,4,8
P'thinaikos,3144,3,2,1,3,5,9,-4,7
Panionios,3144,4,1,1,4,4,10,-6,4
AEK Athens,3145,1,4,2,0,7,1,6,14
PAOK Salonik,3145,2,2,3,1,9,4,5,9
P'thinaikos,3145,3,1,2,3,4,9,-5,5
Panionios,3145,4,1,1,4,4,10,-6,4
AEK Athens,3146,1,4,2,0,7,1,6,14
PAOK Salonik,3146,2,3,2,1,10,4,6,11
P'thinaikos,3146,3,1,1,4,4,10,-6,4
Panionios,3146,3,1,1,4,4,10,-6,4
AEK Athens,3147,1,4,2,0,7,1,6,14
PAOK Salonik,3147,2,2,3,1,10,5,5,9
P'thinaikos,3147,3,1,2,3,5,10,-5,5
Panionios,3147,4,1,1,4,4,10,-6,4
AEK Athens,3148,1,4,2,0,7,1,6,14
PAOK Salonik,3148,2,2,2,2,10,6,4,8
P'thinaikos,3148,3,2,1,3,6,10,-4,7
Panionios,3148,4,1,1,4,4,10,-6,4
AEK Athens,3149,1,4,2,0,7,1,6,14
PAOK Salonik,3149,2,2,2,2,9,5,4,8
P'thinaikos,3149,3,2,1,3,5,9,-4,7
Panionios,3149,4,1,1,4,4,10,-6,4
AEK Athens,3150,1,4,2,0,7,1,6,14
PAOK Salonik,3150,2,3,2,1,10,4,6,11
P'thinaikos,3150,3,1,1,4,4,10,-6,4
Panionios,3150,3,1,1,4,4,10,-6,4
AEK Athens,3151,1,4,2,0,7,1,6,14
PAOK Salonik,3151,2,2,2,2,10,6,4,8
P'thinaikos,3151,3,2,1,3,6,10,-4,7
Panionios,3151,4,1,1,4,4,10,-6,4
AEK Athens,3152,1,4,2,0,7,1,6,14
PAOK Salonik,3152,2,2,2,2,10,7,3,8
P'thinaikos,3152,3,2,1,3,7,10,-3,7
Panionios,3152,4,1,1,4,4,10,-6,4
AEK Athens,3153,1,4,2,0,7,1,6,14
PAOK Salonik,3153,2,2,3,1,9,4,5,9
P'thinaikos,3153,3,1,2,3,4,9,-5,5
Panionios,3153,4,1,1,4,4,10,-6,4
AEK Athens,3154,1,4,2,0,7,1,6,14
PAOK Salonik,3154,2,2,2,2,10,6,4,8
P'thinaikos,3154,3,2,1,3,6,10,-4,7
Panionios,3154,4,1,1,4,4,10,-6,4
AEK Athens,3155,1,4,2,0,7,1,6,14
PAOK Salonik,3155,2,2,2,2,11,7,4,8
P'thinaikos,3155,3,2,1,3,7,11,-4,7
Panionios,3155,4,1,1,4,4,10,-6,4
AEK Athens,3156,1,4,2,0,7,1,6,14
PAOK Salonik,3156,2,2,2,2,9,6,3,8
P'thinaikos,3156,3,2,1,3,6,9,-3,7
Panionios,3156,4,1,1,4,4,10,-6,4
AEK Athens,3157,1,4,2,0,7,1,6,14
PAOK Salonik,3157,2,3,2,1,11,5,6,11
P'thinaikos,3157,3,1,1,4,5,11,-6,4
Panionios,3157,4,1,1,4,4,10,-6,4
AEK Athens,3158,1,4,2,0,7,1,6,14
PAOK Salonik,3158,2,2,2,2,9,7,2,8
P'thinaikos,3158,3,2,1,3,7,9,-2,7
Panionios,3158,4,1,1,4,4,10,-6,4
AEK Athens,3159,1,4,2,0,7,1,6,14
PAOK Salonik,3159,2,2,3,1,9,4,5,9
P'thinaikos,3159,3,1,2,3,4,9,-5,5
Panionios,3159,4,1,1,4,4,10,-6,4
AEK Athens,3160,1,4,2,0,7,1,6,14
PAOK Salonik,3160,2,3,2,1,10,4,6,11
P'thinaikos,3160,3,1,1,4,4,10,-6,4
Panionios,3160,3,1,1,4,4,10,-6,4
AEK Athens,3161,1,4,2,0,7,1,6,14
PAOK Salonik,3161,2,2,3,1,11,6,5,9
P'thinaikos,3161,3,1,2,3,6,11,-5,5
Panionios,3161,4,1,1,4,4,10,-6,4
AEK Athens,3162,1,4,2,0,7,1,6,14
PAOK Salonik,3162,2,3,2,1,11,5,6,11
P'thinaikos,3162,3,1,1,4,5,11,-6,4
Panionios,3162,4,1,1,4,4,10,-6,4
AEK Athens,3163,1,4,2,0,7,1,6,14
PAOK Salonik,3163,2,3,2,1,10,4,6,11
P'thinaikos,3163,3,1,1,4,4,10,-6,4
Panionios,3163,3,1,1,4,4,10,-6,4
AEK Athens,3164,1,4,2,0,7,1,6,14
PAOK Salonik,3164,2,3,2,1,10,4,6,11
P'thinaikos,3164,3,1,1,4,4,10,-6,4
Panionios,3164,3,1,1,4,4,10,-6,4
AEK Athens,3165,1,4,2,0,7,1,6,14
PAOK Salonik,3165,2,2,3,1,10,5,5,9
P'thinaikos,3165,3,1,2,3,5,10,-5,5
Panionios,3165,4,1,1,4,4,10,-6,4
AEK Athens,3166,1,4,2,0,7,1,6,14
PAOK Salonik,3166,2,2,3,1,10,5,5,9
P'thinaikos,3166,3,1,2,3,5,10,-5,5
Panionios,3166,4,1,1,4,4,10,-6,4
AEK Athens,3167,1,4,2,0,7,1,6,14
PAOK Salonik,3167,2,2,3,1,10,5,5,9
P'thinaikos,3167,3,1,2,3,5,10,-5,5
Panionios,3167,4,1,1,4,4,10,-6,4
AEK Athens,3168,1,4,2,0,7,1,6,14
PAOK Salonik,3168,2,2,2,2,9,5,4,8
P'thinaikos,3168,3,2,1,3,5,9,-4,7
Panionios,3168,4,1,1,4,4,10,-6,4
AEK Athens,3169,1,4,2,0,7,1,6,14
PAOK Salonik,3169,2,3,2,1,13,6,7,11
Panionios,3169,3,1,1,4,4,10,-6,4
P'thinaikos,3169,4,1,1,4,6,13,-7,4
AEK Athens,3170,1,4,2,0,7,1,6,14
PAOK Salonik,3170,2,3,2,1,10,4,6,11
P'thinaikos,3170,3,1,1,4,4,10,-6,4
Panionios,3170,3,1,1,4,4,10,-6,4
AEK Athens,3171,1,4,2,0,7,1,6,14
PAOK Salonik,3171,2,2,3,1,11,6,5,9
P'thinaikos,3171,3,1,2,3,6,11,-5,5
Panionios,3171,4,1,1,4,4,10,-6,4
AEK Athens,3172,1,4,2,0,7,1,6,14
PAOK Salonik,3172,2,2,2,2,9,6,3,8
P'thinaikos,3172,3,2,1,3,6,9,-3,7
Panionios,3172,4,1,1,4,4,10,-6,4
AEK Athens,3173,1,4,2,0,7,1,6,14
PAOK Salonik,3173,2,3,2,1,10,4,6,11
P'thinaikos,3173,3,1,1,4,4,10,-6,4
Panionios,3173,3,1,1,4,4,10,-6,4
AEK Athens,3174,1,4,2,0,7,1,6,14
PAOK Salonik,3174,2,2,3,1,9,4,5,9
P'thinaikos,3174,3,1,2,3,4,9,-5,5
Panionios,3174,4,1,1,4,4,10,-6,4
AEK Athens,3175,1,4,2,0,7,1,6,14
PAOK Salonik,3175,2,2,2,2,10,6,4,8
P'thinaikos,3175,3,2,1,3,6,10,-4,7
Panionios,3175,4,1,1,4,4,10,-6,4
AEK Athens,3176,1,4,2,0,7,1,6,14
PAOK Salonik,3176,2,2,2,2,10,6,4,8
P'thinaikos,3176,3,2,1,3,6,10,-4,7
Panionios,3176,4,1,1,4,4,10,-6,4
AEK Athens,3177,1,4,2,0,7,1,6,14
PAOK Salonik,3177,2,2,2,2,10,7,3,8
P'thinaikos,3177,3,2,1,3,7,10,-3,7
Panionios,3177,4,1,1,4,4,10,-6,4
AEK Athens,3178,1,4,2,0,7,1,6,14
PAOK Salonik,3178,2,2,3,1,10,5,5,9
P'thinaikos,3178,3,1,2,3,5,10,-5,5
Panionios,3178,4,1,1,4,4,10,-6,4
AEK Athens,3179,1,4,2,0,7,1,6,14
PAOK Salonik,3179,2,2,2,2,10,6,4,8
P'thinaikos,3179,3,2,1,3,6,10,-4,7
Panionios,3179,4,1,1,4,4,10,-6,4
AEK Athens,3180,1,4,2,0,7,1,6,14
PAOK Salonik,3180,2,2,3,1,11,6,5,9
P'thinaikos,3180,3,1,2,3,6,11,-5,5
Panionios,3180,4,1,1,4,4,10,-6,4
AEK Athens,3181,1,4,2,0,7,1,6,14
PAOK Salonik,3181,2,3,2,1,11,4,7,11
Panionios,3181,3,1,1,4,4,10,-6,4
P'thinaikos,3181,4,1,1,4,4,11,-7,4
AEK Athens,3182,1,4,2,0,7,1,6,14
PAOK Salonik,3182,2,2,2,2,9,5,4,8
P'thinaikos,3182,3,2,1,3,5,9,-4,7
Panionios,3182,4,1,1,4,4,10,-6,4
AEK Athens,3183,1,4,2,0,7,1,6,14
PAOK Salonik,3183,2,2,3,1,11,6,5,9
P'thinaikos,3183,3,1,2,3,6,11,-5,5
Panionios,3183,4,1,1,4,4,10,-6,4
AEK Athens,3184,1,4,2,0,7,1,6,14
PAOK Salonik,3184,2,2,3,1,11,6,5,9
P'thinaikos,3184,3,1,2,3,6,11,-5,5
Panionios,3184,4,1,1,4,4,10,-6,4
AEK Athens,3185,1,4,2,0,7,1,6,14
PAOK Salonik,3185,2,3,2,1,10,4,6,11
P'thinaikos,3185,3,1,1,4,4,10,-6,4
Panionios,3185,3,1,1,4,4,10,-6,4
AEK Athens,3186,1,4,2,0,7,1,6,14
PAOK Salonik,3186,2,3,2,1,10,4,6,11
P'thinaikos,3186,3,1,1,4,4,10,-6,4
Panionios,3186,3,1,1,4,4,10,-6,4
AEK Athens,3187,1,4,2,0,7,1,6,14
PAOK Salonik,3187,2,3,2,1,10,4,6,11
P'thinaikos,3187,3,1,1,4,4,10,-6,4
Panionios,3187,3,1,1,4,4,10,-6,4
AEK Athens,3188,1,4,2,0,7,1,6,14
PAOK Salonik,3188,2,3,2,1,10,4,6,11
P'thinaikos,3188,3,1,1,4,4,10,-6,4
Panionios,3188,3,1,1,4,4,10,-6,4
AEK Athens,3189,1,4,2,0,7,1,6,14
PAOK Salonik,3189,2,2,2,2,9,8,1,8
P'thinaikos,3189,3,2,1,3,8,9,-1,7
Panionios,3189,4,1,1,4,4,10,-6,4
AEK Athens,3190,1,4,2,0,7,1,6,14
PAOK Salonik,3190,2,3,2,1,12,6,6,11
P'thinaikos,3190,3,1,1,4,6,12,-6,4
Panionios,3190,4,1,1,4,4,10,-6,4
AEK Athens,3191,1,4,2,0,7,1,6,14
PAOK Salonik,3191,2,2,3,1,10,5,5,9
P'thinaikos,3191,3,1,2,3,5,10,-5,5
Panionios,3191,4,1,1,4,4,10,-6,4
AEK Athens,3192,1,4,2,0,7,1,6,14
PAOK Salonik,3192,2,2,3,1,10,5,5,9
P'thinaikos,3192,3,1,2,3,5,10,-5,5
Panionios,3192,4,1,1,4,4,10,-6,4
AEK Athens,3193,1,4,2,0,7,1,6,14
PAOK Salonik,3193,2,3,2,1,11,4,7,11
Panionios,3193,3,1,1,4,4,10,-6,4
P'thinaikos,3193,4,1,1,4,4,11,-7,4
AEK Athens,3194,1,4,2,0,7,1,6,14
PAOK Salonik,3194,2,2,2,2,9,5,4,8
P'thinaikos,3194,3,2,1,3,5,9,-4,7
Panionios,3194,4,1,1,4,4,10,-6,4
AEK Athens,3195,1,4,2,0,7,1,6,14
PAOK Salonik,3195,2,2,2,2,11,7,4,8
P'thinaikos,3195,3,2,1,3,7,11,-4,7
Panionios,3195,4,1,1,4,4,10,-6,4
AEK Athens,3196,1,4,2,0,7,1,6,14
PAOK Salonik,3196,2,2,3,1,9,4,5,9
P'thinaikos,3196,3,1,2,3,4,9,-5,5
Panionios,3196,4,1,1,4,4,10,-6,4
AEK Athens,3197,1,4,2,0,7,1,6,14
PAOK Salonik,3197,2,2,2,2,9,6,3,8
P'thinaikos,3197,3,2,1,3,6,9,-3,7
Panionios,3197,4,1,1,4,4,10,-6,4
AEK Athens,3198,1,4,2,0,7,1,6,14
PAOK Salonik,3198,2,2,3,1,10,5,5,9
P'thinaikos,3198,3,1,2,3,5,10,-5,5
Panionios,3198,4,1,1,4,4,10,-6,4
AEK Athens,3199,1,4,2,0,7,1,6,14
PAOK Salonik,3199,2,2,3,1,10,5,5,9
P'thinaikos,3199,3,1,2,3,5,10,-5,5
Panionios,3199,4,1,1,4,4,10,-6,4
AEK Athens,3200,1,4,2,0,7,1,6,14
PAOK Salonik,3200,2,3,2,1,10,4,6,11
P'thinaikos,3200,3,1,1,4,4,10,-6,4
Panionios,3200,3,1,1,4,4,10,-6,4
AEK Athens,3201,1,4,2,0,7,1,6,14
PAOK Salonik,3201,2,3,2,1,11,5,6,11
P'thinaikos,3201,3,1,1,4,5,11,-6,4
Panionios,3201,4,1,1,4,4,10,-6,4
AEK Athens,3202,1,4,2,0,7,1,6,14
PAOK Salonik,3202,2,2,3,1,12,7,5,9
P'thinaikos,3202,3,1,2,3,7,12,-5,5
Panionios,3202,4,1,1,4,4,10,-6,4
AEK Athens,3203,1,4,2,0,7,1,6,14
PAOK Salonik,3203,2,3,2,1,11,4,7,11
Panionios,3203,3,1,1,4,4,10,-6,4
P'thinaikos,3203,4,1,1,4,4,11,-7,4
AEK Athens,3204,1,4,2,0,7,1,6,14
PAOK Salonik,3204,2,2,2,2,10,7,3,8
P'thinaikos,3204,3,2,1,3,7,10,-3,7
Panionios,3204,4,1,1,4,4,10,-6,4
AEK Athens,3205,1,4,2,0,7,1,6,14
PAOK Salonik,3205,2,2,3,1,10,5,5,9
P'thinaikos,3205,3,1,2,3,5,10,-5,5
Panionios,3205,4,1,1,4,4,10,-6,4
AEK Athens,3206,1,4,2,0,7,1,6,14
PAOK Salonik,3206,2,3,2,1,11,4,7,11
Panionios,3206,3,1,1,4,4,10,-6,4
P'thinaikos,3206,4,1,1,4,4,11,-7,4
AEK Athens,3207,1,4,2,0,7,1,6,14
PAOK Salonik,3207,2,2,2,2,10,7,3,8
P'thinaikos,3207,3,2,1,3,7,10,-3,7
Panionios,3207,4,1,1,4,4,10,-6,4
AEK Athens,3208,1,4,2,0,7,1,6,14
PAOK Salonik,3208,2,2,3,1,10,5,5,9
P'thinaikos,3208,3,1,2,3,5,10,-5,5
Panionios,3208,4,1,1,4,4,10,-6,4
AEK Athens,3209,1,4,2,0,7,1,6,14
PAOK Salonik,3209,2,3,2,1,11,5,6,11
P'thinaikos,3209,3,1,1,4,5,11,-6,4
Panionios,3209,4,1,1,4,4,10,-6,4
AEK Athens,3210,1,4,2,0,7,1,6,14
PAOK Salonik,3210,2,2,2,2,10,8,2,8
P'thinaikos,3210,3,2,1,3,8,10,-2,7
Panionios,3210,4,1,1,4,4,10,-6,4
AEK Athens,3211,1,4,2,0,7,1,6,14
PAOK Salonik,3211,2,2,3,1,9,4,5,9
P'thinaikos,3211,3,1,2,3,4,9,-5,5
Panionios,3211,4,1,1,4,4,10,-6,4
AEK Athens,3212,1,4,2,0,7,1,6,14
PAOK Salonik,3212,2,2,2,2,10,6,4,8
P'thinaikos,3212,3,2,1,3,6,10,-4,7
Panionios,3212,4,1,1,4,4,10,-6,4
AEK Athens,3213,1,4,2,0,7,1,6,14
PAOK Salonik,3213,2,3,2,1,12,4,8,11
Panionios,3213,3,1,1,4,4,10,-6,4
P'thinaikos,3213,4,1,1,4,4,12,-8,4
AEK Athens,3214,1,4,2,0,7,1,6,14
PAOK Salonik,3214,2,2,3,1,9,4,5,9
P'thinaikos,3214,3,1,2,3,4,9,-5,5
Panionios,3214,4,1,1,4,4,10,-6,4
AEK Athens,3215,1,4,2,0,7,1,6,14
PAOK Salonik,3215,2,2,2,2,9,6,3,8
P'thinaikos,3215,3,2,1,3,6,9,-3,7
Panionios,3215,4,1,1,4,4,10,-6,4
AEK Athens,3216,1,4,2,0,7,1,6,14
PAOK Salonik,3216,2,2,3,1,9,4,5,9
P'thinaikos,3216,3,1,2,3,4,9,-5,5
Panionios,3216,4,1,1,4,4,10,-6,4
AEK Athens,3217,1,4,2,0,7,1,6,14
PAOK Salonik,3217,2,2,3,1,11,6,5,9
P'thinaikos,3217,3,1,2,3,6,11,-5,5
Panionios,3217,4,1,1,4,4,10,-6,4
AEK Athens,3218,1,4,2,0,7,1,6,14
PAOK Salonik,3218,2,2,3,1,9,4,5,9
P'thinaikos,3218,3,1,2,3,4,9,-5,5
Panionios,3218,4,1,1,4,4,10,-6,4
AEK Athens,3219,1,4,2,0,7,1,6,14
PAOK Salonik,3219,2,2,3,1,10,5,5,9
P'thinaikos,3219,3,1,2,3,5,10,-5,5
Panionios,3219,4,1,1,4,4,10,-6,4
AEK Athens,3220,1,4,2,0,7,1,6,14
PAOK Salonik,3220,2,2,3,1,10,5,5,9
P'thinaikos,3220,3,1,2,3,5,10,-5,5
Panionios,3220,4,1,1,4,4,10,-6,4
AEK Athens,3221,1,4,2,0,7,1,6,14
PAOK Salonik,3221,2,3,2,1,11,4,7,11
Panionios,3221,3,1,1,4,4,10,-6,4
P'thinaikos,3221,4,1,1,4,4,11,-7,4
AEK Athens,3222,1,4,2,0,7,1,6,14
PAOK Salonik,3222,2,3,2,1,11,5,6,11
P'thinaikos,3222,3,1,1,4,5,11,-6,4
Panionios,3222,4,1,1,4,4,10,-6,4
AEK Athens,3223,1,4,2,0,7,1,6,14
PAOK Salonik,3223,2,2,2,2,10,7,3,8
P'thinaikos,3223,3,2,1,3,7,10,-3,7
Panionios,3223,4,1,1,4,4,10,-6,4
AEK Athens,3224,1,4,2,0,7,1,6,14
PAOK Salonik,3224,2,2,2,2,10,6,4,8
P'thinaikos,3224,3,2,1,3,6,10,-4,7
Panionios,3224,4,1,1,4,4,10,-6,4
AEK Athens,3225,1,4,2,0,7,1,6,14
PAOK Salonik,3225,2,2,3,1,10,5,5,9
P'thinaikos,3225,3,1,2,3,5,10,-5,5
Panionios,3225,4,1,1,4,4,10,-6,4
AEK Athens,3226,1,4,2,0,7,1,6,14
PAOK Salonik,3226,2,2,2,2,10,6,4,8
P'thinaikos,3226,3,2,1,3,6,10,-4,7
Panionios,3226,4,1,1,4,4,10,-6,4
AEK Athens,3227,1,4,2,0,7,1,6,14
PAOK Salonik,3227,2,3,2,1,11,5,6,11
P'thinaikos,3227,3,1,1,4,5,11,-6,4
Panionios,3227,4,1,1,4,4,10,-6,4
AEK Athens,3228,1,4,2,0,7,1,6,14
PAOK Salonik,3228,2,3,2,1,10,4,6,11
P'thinaikos,3228,3,1,1,4,4,10,-6,4
Panionios,3228,3,1,1,4,4,10,-6,4
AEK Athens,3229,1,4,2,0,7,1,6,14
PAOK Salonik,3229,2,3,2,1,11,4,7,11
Panionios,3229,3,1,1,4,4,10,-6,4
P'thinaikos,3229,4,1,1,4,4,11,-7,4
AEK Athens,3230,1,4,2,0,7,1,6,14
PAOK Salonik,3230,2,3,2,1,11,4,7,11
Panionios,3230,3,1,1,4,4,10,-6,4
P'thinaikos,3230,4,1,1,4,4,11,-7,4
AEK Athens,3231,1,4,2,0,7,1,6,14
PAOK Salonik,3231,2,3,2,1,10,4,6,11
P'thinaikos,3231,3,1,1,4,4,10,-6,4
Panionios,3231,3,1,1,4,4,10,-6,4
AEK Athens,3232,1,4,2,0,7,1,6,14
PAOK Salonik,3232,2,3,2,1,11,5,6,11
P'thinaikos,3232,3,1,1,4,5,11,-6,4
Panionios,3232,4,1,1,4,4,10,-6,4
AEK Athens,3233,1,4,2,0,7,1,6,14
PAOK Salonik,3233,2,2,3,1,10,5,5,9
P'thinaikos,3233,3,1,2,3,5,10,-5,5
Panionios,3233,4,1,1,4,4,10,-6,4
AEK Athens,3234,1,4,2,0,7,1,6,14
PAOK Salonik,3234,2,2,2,2,10,7,3,8
P'thinaikos,3234,3,2,1,3,7,10,-3,7
Panionios,3234,4,1,1,4,4,10,-6,4
AEK Athens,3235,1,4,2,0,7,1,6,14
PAOK Salonik,3235,2,2,3,1,11,6,5,9
P'thinaikos,3235,3,1,2,3,6,11,-5,5
Panionios,3235,4,1,1,4,4,10,-6,4
AEK Athens,3236,1,4,2,0,7,1,6,14
PAOK Salonik,3236,2,2,3,1,11,6,5,9
P'thinaikos,3236,3,1,2,3,6,11,-5,5
Panionios,3236,4,1,1,4,4,10,-6,4
AEK Athens,3237,1,4,2,0,7,1,6,14
PAOK Salonik,3237,2,3,2,1,11,5,6,11
P'thinaikos,3237,3,1,1,4,5,11,-6,4
Panionios,3237,4,1,1,4,4,10,-6,4
AEK Athens,3238,1,4,2,0,7,1,6,14
PAOK Salonik,3238,2,2,3,1,10,5,5,9
P'thinaikos,3238,3,1,2,3,5,10,-5,5
Panionios,3238,4,1,1,4,4,10,-6,4
AEK Athens,3239,1,4,2,0,7,1,6,14
PAOK Salonik,3239,2,3,2,1,12,4,8,11
Panionios,3239,3,1,1,4,4,10,-6,4
P'thinaikos,3239,4,1,1,4,4,12,-8,4
AEK Athens,3240,1,4,2,0,7,1,6,14
PAOK Salonik,3240,2,2,2,2,10,6,4,8
P'thinaikos,3240,3,2,1,3,6,10,-4,7
Panionios,3240,4,1,1,4,4,10,-6,4
AEK Athens,3241,1,4,2,0,7,1,6,14
PAOK Salonik,3241,2,3,2,1,11,4,7,11
Panionios,3241,3,1,1,4,4,10,-6,4
P'thinaikos,3241,4,1,1,4,4,11,-7,4
AEK Athens,3242,1,4,2,0,7,1,6,14
PAOK Salonik,3242,2,2,2,2,11,7,4,8
P'thinaikos,3242,3,2,1,3,7,11,-4,7
Panionios,3242,4,1,1,4,4,10,-6,4
AEK Athens,3243,1,4,2,0,7,1,6,14
PAOK Salonik,3243,2,2,3,1,11,6,5,9
P'thinaikos,3243,3,1,2,3,6,11,-5,5
Panionios,3243,4,1,1,4,4,10,-6,4
AEK Athens,3244,1,4,2,0,7,1,6,14
PAOK Salonik,3244,2,2,2,2,10,6,4,8
P'thinaikos,3244,3,2,1,3,6,10,-4,7
Panionios,3244,4,1,1,4,4,10,-6,4
AEK Athens,3245,1,4,2,0,7,1,6,14
PAOK Salonik,3245,2,3,2,1,13,5,8,11
Panionios,3245,3,1,1,4,4,10,-6,4
P'thinaikos,3245,4,1,1,4,5,13,-8,4
AEK Athens,3246,1,4,2,0,7,1,6,14
PAOK Salonik,3246,2,2,2,2,9,5,4,8
P'thinaikos,3246,3,2,1,3,5,9,-4,7
Panionios,3246,4,1,1,4,4,10,-6,4
AEK Athens,3247,1,4,2,0,7,1,6,14
PAOK Salonik,3247,2,2,3,1,11,6,5,9
P'thinaikos,3247,3,1,2,3,6,11,-5,5
Panionios,3247,4,1,1,4,4,10,-6,4
AEK Athens,3248,1,4,2,0,7,1,6,14
PAOK Salonik,3248,2,2,2,2,9,6,3,8
P'thinaikos,3248,3,2,1,3,6,9,-3,7
Panionios,3248,4,1,1,4,4,10,-6,4
AEK Athens,3249,1,4,2,0,7,1,6,14
PAOK Salonik,3249,2,2,3,1,10,5,5,9
P'thinaikos,3249,3,1,2,3,5,10,-5,5
Panionios,3249,4,1,1,4,4,10,-6,4
AEK Athens,3250,1,4,2,0,7,1,6,14
PAOK Salonik,3250,2,2,2,2,11,8,3,8
P'thinaikos,3250,3,2,1,3,8,11,-3,7
Panionios,3250,4,1,1,4,4,10,-6,4
AEK Athens,3251,1,4,2,0,7,1,6,14
PAOK Salonik,3251,2,2,3,1,10,5,5,9
P'thinaikos,3251,3,1,2,3,5,10,-5,5
Panionios,3251,4,1,1,4,4,10,-6,4
AEK Athens,3252,1,4,2,0,7,1,6,14
PAOK Salonik,3252,2,2,2,2,9,8,1,8
P'thinaikos,3252,3,2,1,3,8,9,-1,7
Panionios,3252,4,1,1,4,4,10,-6,4
AEK Athens,3253,1,4,2,0,7,1,6,14
PAOK Salonik,3253,2,2,2,2,9,5,4,8
P'thinaikos,3253,3,2,1,3,5,9,-4,7
Panionios,3253,4,1,1,4,4,10,-6,4
AEK Athens,3254,1,4,2,0,7,1,6,14
PAOK Salonik,3254,2,2,2,2,9,7,2,8
P'thinaikos,3254,3,2,1,3,7,9,-2,7
Panionios,3254,4,1,1,4,4,10,-6,4
AEK Athens,3255,1,4,2,0,7,1,6,14
PAOK Salonik,3255,2,2,2,2,9,5,4,8
P'thinaikos,3255,3,2,1,3,5,9,-4,7
Panionios,3255,4,1,1,4,4,10,-6,4
AEK Athens,3256,1,4,2,0,7,1,6,14
PAOK Salonik,3256,2,3,2,1,10,4,6,11
P'thinaikos,3256,3,1,1,4,4,10,-6,4
Panionios,3256,3,1,1,4,4,10,-6,4
AEK Athens,3257,1,4,2,0,7,1,6,14
PAOK Salonik,3257,2,3,2,1,10,4,6,11
P'thinaikos,3257,3,1,1,4,4,10,-6,4
Panionios,3257,3,1,1,4,4,10,-6,4
AEK Athens,3258,1,4,2,0,7,1,6,14
PAOK Salonik,3258,2,3,2,1,12,5,7,11
Panionios,3258,3,1,1,4,4,10,-6,4
P'thinaikos,3258,4,1,1,4,5,12,-7,4
AEK Athens,3259,1,4,2,0,7,1,6,14
PAOK Salonik,3259,2,3,2,1,12,5,7,11
Panionios,3259,3,1,1,4,4,10,-6,4
P'thinaikos,3259,4,1,1,4,5,12,-7,4
AEK Athens,3260,1,4,2,0,7,1,6,14
PAOK Salonik,3260,2,3,2,1,11,5,6,11
P'thinaikos,3260,3,1,1,4,5,11,-6,4
Panionios,3260,4,1,1,4,4,10,-6,4
AEK Athens,3261,1,4,2,0,7,1,6,14
PAOK Salonik,3261,2,2,3,1,9,4,5,9
P'thinaikos,3261,3,1,2,3,4,9,-5,5
Panionios,3261,4,1,1,4,4,10,-6,4
AEK Athens,3262,1,4,2,0,7,1,6,14
PAOK Salonik,3262,2,2,3,1,10,5,5,9
P'thinaikos,3262,3,1,2,3,5,10,-5,5
Panionios,3262,4,1,1,4,4,10,-6,4
AEK Athens,3263,1,4,2,0,7,1,6,14
PAOK Salonik,3263,2,2,3,1,10,5,5,9
P'thinaikos,3263,3,1,2,3,5,10,-5,5
Panionios,3263,4,1,1,4,4,10,-6,4
AEK Athens,3264,1,4,2,0,7,1,6,14
PAOK Salonik,3264,2,2,2,2,10,7,3,8
P'thinaikos,3264,3,2,1,3,7,10,-3,7
Panionios,3264,4,1,1,4,4,10,-6,4
AEK Athens,3265,1,4,2,0,7,1,6,14
PAOK Salonik,3265,2,2,3,1,11,6,5,9
P'thinaikos,3265,3,1,2,3,6,11,-5,5
Panionios,3265,4,1,1,4,4,10,-6,4
AEK Athens,3266,1,4,2,0,7,1,6,14
PAOK Salonik,3266,2,2,2,2,9,7,2,8
P'thinaikos,3266,3,2,1,3,7,9,-2,7
Panionios,3266,4,1,1,4,4,10,-6,4
AEK Athens,3267,1,4,2,0,7,1,6,14
PAOK Salonik,3267,2,3,2,1,10,4,6,11
P'thinaikos,3267,3,1,1,4,4,10,-6,4
Panionios,3267,3,1,1,4,4,10,-6,4
AEK Athens,3268,1,4,2,0,7,1,6,14
PAOK Salonik,3268,2,2,2,2,10,6,4,8
P'thinaikos,3268,3,2,1,3,6,10,-4,7
Panionios,3268,4,1,1,4,4,10,-6,4
AEK Athens,3269,1,4,2,0,7,1,6,14
PAOK Salonik,3269,2,2,3,1,11,6,5,9
P'thinaikos,3269,3,1,2,3,6,11,-5,5
Panionios,3269,4,1,1,4,4,10,-6,4
AEK Athens,3270,1,4,2,0,7,1,6,14
PAOK Salonik,3270,2,2,2,2,10,7,3,8
P'thinaikos,3270,3,2,1,3,7,10,-3,7
Panionios,3270,4,1,1,4,4,10,-6,4
AEK Athens,3271,1,4,2,0,7,1,6,14
PAOK Salonik,3271,2,2,2,2,9,6,3,8
P'thinaikos,3271,3,2,1,3,6,9,-3,7
Panionios,3271,4,1,1,4,4,10,-6,4
AEK Athens,3272,1,4,2,0,7,1,6,14
PAOK Salonik,3272,2,3,2,1,11,5,6,11
P'thinaikos,3272,3,1,1,4,5,11,-6,4
Panionios,3272,4,1,1,4,4,10,-6,4
AEK Athens,3273,1,4,2,0,7,1,6,14
PAOK Salonik,3273,2,3,2,1,11,4,7,11
Panionios,3273,3,1,1,4,4,10,-6,4
P'thinaikos,3273,4,1,1,4,4,11,-7,4
AEK Athens,3274,1,4,2,0,7,1,6,14
PAOK Salonik,3274,2,2,2,2,9,6,3,8
P'thinaikos,3274,3,2,1,3,6,9,-3,7
Panionios,3274,4,1,1,4,4,10,-6,4
AEK Athens,3275,1,4,2,0,7,1,6,14
PAOK Salonik,3275,2,2,3,1,10,5,5,9
P'thinaikos,3275,3,1,2,3,5,10,-5,5
Panionios,3275,4,1,1,4,4,10,-6,4
AEK Athens,3276,1,4,2,0,7,1,6,14
PAOK Salonik,3276,2,3,2,1,10,4,6,11
P'thinaikos,3276,3,1,1,4,4,10,-6,4
Panionios,3276,3,1,1,4,4,10,-6,4
AEK Athens,3277,1,4,2,0,7,1,6,14
PAOK Salonik,3277,2,3,2,1,11,5,6,11
P'thinaikos,3277,3,1,1,4,5,11,-6,4
Panionios,3277,4,1,1,4,4,10,-6,4
AEK Athens,3278,1,4,2,0,7,1,6,14
PAOK Salonik,3278,2,2,3,1,10,5,5,9
P'thinaikos,3278,3,1,2,3,5,10,-5,5
Panionios,3278,4,1,1,4,4,10,-6,4
AEK Athens,3279,1,4,2,0,7,1,6,14
PAOK Salonik,3279,2,3,2,1,10,4,6,11
P'thinaikos,3279,3,1,1,4,4,10,-6,4
Panionios,3279,3,1,1,4,4,10,-6,4
AEK Athens,3280,1,4,2,0,7,1,6,14
PAOK Salonik,3280,2,2,2,2,10,7,3,8
P'thinaikos,3280,3,2,1,3,7,10,-3,7
Panionios,3280,4,1,1,4,4,10,-6,4
AEK Athens,3281,1,4,2,0,7,1,6,14
PAOK Salonik,3281,2,3,2,1,11,5,6,11
P'thinaikos,3281,3,1,1,4,5,11,-6,4
Panionios,3281,4,1,1,4,4,10,-6,4
AEK Athens,3282,1,4,2,0,7,1,6,14
PAOK Salonik,3282,2,2,3,1,9,4,5,9
P'thinaikos,3282,3,1,2,3,4,9,-5,5
Panionios,3282,4,1,1,4,4,10,-6,4
AEK Athens,3283,1,4,2,0,7,1,6,14
PAOK Salonik,3283,2,2,2,2,9,5,4,8
P'thinaikos,3283,3,2,1,3,5,9,-4,7
Panionios,3283,4,1,1,4,4,10,-6,4
AEK Athens,3284,1,4,2,0,7,1,6,14
PAOK Salonik,3284,2,2,3,1,9,4,5,9
P'thinaikos,3284,3,1,2,3,4,9,-5,5
Panionios,3284,4,1,1,4,4,10,-6,4
AEK Athens,3285,1,4,2,0,7,1,6,14
PAOK Salonik,3285,2,2,3,1,11,6,5,9
P'thinaikos,3285,3,1,2,3,6,11,-5,5
Panionios,3285,4,1,1,4,4,10,-6,4
AEK Athens,3286,1,4,2,0,7,1,6,14
PAOK Salonik,3286,2,3,2,1,12,4,8,11
Panionios,3286,3,1,1,4,4,10,-6,4
P'thinaikos,3286,4,1,1,4,4,12,-8,4
AEK Athens,3287,1,4,2,0,7,1,6,14
PAOK Salonik,3287,2,2,2,2,10,7,3,8
P'thinaikos,3287,3,2,1,3,7,10,-3,7
Panionios,3287,4,1,1,4,4,10,-6,4
AEK Athens,3288,1,4,2,0,7,1,6,14
PAOK Salonik,3288,2,3,2,1,11,4,7,11
Panionios,3288,3,1,1,4,4,10,-6,4
P'thinaikos,3288,4,1,1,4,4,11,-7,4
AEK Athens,3289,1,4,2,0,7,1,6,14
PAOK Salonik,3289,2,3,2,1,12,4,8,11
Panionios,3289,3,1,1,4,4,10,-6,4
P'thinaikos,3289,4,1,1,4,4,12,-8,4
AEK Athens,3290,1,4,2,0,7,1,6,14
PAOK Salonik,3290,2,2,2,2,9,5,4,8
P'thinaikos,3290,3,2,1,3,5,9,-4,7
Panionios,3290,4,1,1,4,4,10,-6,4
AEK Athens,3291,1,4,2,0,7,1,6,14
PAOK Salonik,3291,2,3,2,1,11,5,6,11
P'thinaikos,3291,3,1,1,4,5,11,-6,4
Panionios,3291,4,1,1,4,4,10,-6,4
AEK Athens,3292,1,4,2,0,7,1,6,14
PAOK Salonik,3292,2,2,3,1,10,5,5,9
P'thinaikos,3292,3,1,2,3,5,10,-5,5
Panionios,3292,4,1,1,4,4,10,-6,4
AEK Athens,3293,1,4,2,0,7,1,6,14
PAOK Salonik,3293,2,2,3,1,10,5,5,9
P'thinaikos,3293,3,1,2,3,5,10,-5,5
Panionios,3293,4,1,1,4,4,10,-6,4
AEK Athens,3294,1,4,2,0,7,1,6,14
PAOK Salonik,3294,2,3,2,1,10,4,6,11
P'thinaikos,3294,3,1,1,4,4,10,-6,4
Panionios,3294,3,1,1,4,4,10,-6,4
AEK Athens,3295,1,4,2,0,7,1,6,14
PAOK Salonik,3295,2,3,2,1,12,6,6,11
P'thinaikos,3295,3,1,1,4,6,12,-6,4
Panionios,3295,4,1,1,4,4,10,-6,4
AEK Athens,3296,1,4,2,0,7,1,6,14
PAOK Salonik,3296,2,3,2,1,11,4,7,11
Panionios,3296,3,1,1,4,4,10,-6,4
P'thinaikos,3296,4,1,1,4,4,11,-7,4
AEK Athens,3297,1,4,2,0,7,1,6,14
PAOK Salonik,3297,2,2,2,2,10,8,2,8
P'thinaikos,3297,3,2,1,3,8,10,-2,7
Panionios,3297,4,1,1,4,4,10,-6,4
AEK Athens,3298,1,4,2,0,7,1,6,14
PAOK Salonik,3298,2,3,2,1,12,5,7,11
Panionios,3298,3,1,1,4,4,10,-6,4
P'thinaikos,3298,4,1,1,4,5,12,-7,4
AEK Athens,3299,1,4,2,0,7,1,6,14
PAOK Salonik,3299,2,2,2,2,10,7,3,8
P'thinaikos,3299,3,2,1,3,7,10,-3,7
Panionios,3299,4,1,1,4,4,10,-6,4
AEK Athens,3300,1,4,2,0,7,1,6,14
PAOK Salonik,3300,2,3,2,1,11,5,6,11
P'thinaikos,3300,3,1,1,4,5,11,-6,4
Panionios,3300,4,1,1,4,4,10,-6,4
AEK Athens,3301,1,4,2,0,7,1,6,14
PAOK Salonik,3301,2,2,2,2,9,5,4,8
P'thinaikos,3301,3,2,1,3,5,9,-4,7
Panionios,3301,4,1,1,4,4,10,-6,4
AEK Athens,3302,1,4,2,0,7,1,6,14
PAOK Salonik,3302,2,2,2,2,10,6,4,8
P'thinaikos,3302,3,2,1,3,6,10,-4,7
Panionios,3302,4,1,1,4,4,10,-6,4
AEK Athens,3303,1,4,2,0,7,1,6,14
PAOK Salonik,3303,2,2,2,2,9,7,2,8
P'thinaikos,3303,3,2,1,3,7,9,-2,7
Panionios,3303,4,1,1,4,4,10,-6,4
AEK Athens,3304,1,4,2,0,7,1,6,14
PAOK Salonik,3304,2,2,3,1,10,5,5,9
P'thinaikos,3304,3,1,2,3,5,10,-5,5
Panionios,3304,4,1,1,4,4,10,-6,4
AEK Athens,3305,1,4,2,0,7,1,6,14
PAOK Salonik,3305,2,2,2,2,9,5,4,8
P'thinaikos,3305,3,2,1,3,5,9,-4,7
Panionios,3305,4,1,1,4,4,10,-6,4
AEK Athens,3306,1,4,2,0,7,1,6,14
PAOK Salonik,3306,2,2,3,1,10,5,5,9
P'thinaikos,3306,3,1,2,3,5,10,-5,5
Panionios,3306,4,1,1,4,4,10,-6,4
AEK Athens,3307,1,4,2,0,7,1,6,14
PAOK Salonik,3307,2,2,2,2,9,6,3,8
P'thinaikos,3307,3,2,1,3,6,9,-3,7
Panionios,3307,4,1,1,4,4,10,-6,4
AEK Athens,3308,1,4,2,0,7,1,6,14
PAOK Salonik,3308,2,2,3,1,9,4,5,9
P'thinaikos,3308,3,1,2,3,4,9,-5,5
Panionios,3308,4,1,1,4,4,10,-6,4
AEK Athens,3309,1,4,2,0,7,1,6,14
PAOK Salonik,3309,2,2,3,1,11,6,5,9
P'thinaikos,3309,3,1,2,3,6,11,-5,5
Panionios,3309,4,1,1,4,4,10,-6,4
AEK Athens,3310,1,4,2,0,7,1,6,14
PAOK Salonik,3310,2,2,2,2,9,5,4,8
P'thinaikos,3310,3,2,1,3,5,9,-4,7
Panionios,3310,4,1,1,4,4,10,-6,4
AEK Athens,3311,1,4,2,0,7,1,6,14
PAOK Salonik,3311,2,2,3,1,11,6,5,9
P'thinaikos,3311,3,1,2,3,6,11,-5,5
Panionios,3311,4,1,1,4,4,10,-6,4
AEK Athens,3312,1,4,2,0,7,1,6,14
PAOK Salonik,3312,2,2,2,2,9,5,4,8
P'thinaikos,3312,3,2,1,3,5,9,-4,7
Panionios,3312,4,1,1,4,4,10,-6,4
AEK Athens,3313,1,4,2,0,7,1,6,14
PAOK Salonik,3313,2,3,2,1,11,5,6,11
P'thinaikos,3313,3,1,1,4,5,11,-6,4
Panionios,3313,4,1,1,4,4,10,-6,4
AEK Athens,3314,1,4,2,0,7,1,6,14
PAOK Salonik,3314,2,3,2,1,11,5,6,11
P'thinaikos,3314,3,1,1,4,5,11,-6,4
Panionios,3314,4,1,1,4,4,10,-6,4
AEK Athens,3315,1,4,2,0,7,1,6,14
PAOK Salonik,3315,2,2,2,2,9,6,3,8
P'thinaikos,3315,3,2,1,3,6,9,-3,7
Panionios,3315,4,1,1,4,4,10,-6,4
AEK Athens,3316,1,4,2,0,7,1,6,14
PAOK Salonik,3316,2,2,2,2,10,6,4,8
P'thinaikos,3316,3,2,1,3,6,10,-4,7
Panionios,3316,4,1,1,4,4,10,-6,4
AEK Athens,3317,1,4,2,0,7,1,6,14
PAOK Salonik,3317,2,2,2,2,9,6,3,8
P'thinaikos,3317,3,2,1,3,6,9,-3,7
Panionios,3317,4,1,1,4,4,10,-6,4
AEK Athens,3318,1,4,2,0,7,1,6,14
PAOK Salonik,3318,2,2,3,1,10,5,5,9
P'thinaikos,3318,3,1,2,3,5,10,-5,5
Panionios,3318,4,1,1,4,4,10,-6,4
AEK Athens,3319,1,4,2,0,7,1,6,14
PAOK Salonik,3319,2,2,3,1,10,5,5,9
P'thinaikos,3319,3,1,2,3,5,10,-5,5
Panionios,3319,4,1,1,4,4,10,-6,4
AEK Athens,3320,1,4,2,0,7,1,6,14
PAOK Salonik,3320,2,3,2,1,12,5,7,11
Panionios,3320,3,1,1,4,4,10,-6,4
P'thinaikos,3320,4,1,1,4,5,12,-7,4
AEK Athens,3321,1,4,2,0,7,1,6,14
PAOK Salonik,3321,2,2,2,2,9,6,3,8
P'thinaikos,3321,3,2,1,3,6,9,-3,7
Panionios,3321,4,1,1,4,4,10,-6,4
AEK Athens,3322,1,4,2,0,7,1,6,14
PAOK Salonik,3322,2,2,2,2,10,6,4,8
P'thinaikos,3322,3,2,1,3,6,10,-4,7
Panionios,3322,4,1,1,4,4,10,-6,4
AEK Athens,3323,1,4,2,0,7,1,6,14
PAOK Salonik,3323,2,2,2,2,9,5,4,8
P'thinaikos,3323,3,2,1,3,5,9,-4,7
Panionios,3323,4,1,1,4,4,10,-6,4
AEK Athens,3324,1,4,2,0,7,1,6,14
PAOK Salonik,3324,2,3,2,1,11,5,6,11
P'thinaikos,3324,3,1,1,4,5,11,-6,4
Panionios,3324,4,1,1,4,4,10,-6,4
AEK Athens,3325,1,4,2,0,7,1,6,14
PAOK Salonik,3325,2,3,2,1,10,4,6,11
P'thinaikos,3325,3,1,1,4,4,10,-6,4
Panionios,3325,3,1,1,4,4,10,-6,4
AEK Athens,3326,1,4,2,0,7,1,6,14
PAOK Salonik,3326,2,2,2,2,10,8,2,8
P'thinaikos,3326,3,2,1,3,8,10,-2,7
Panionios,3326,4,1,1,4,4,10,-6,4
AEK Athens,3327,1,4,2,0,7,1,6,14
PAOK Salonik,3327,2,2,3,1,10,5,5,9
P'thinaikos,3327,3,1,2,3,5,10,-5,5
Panionios,3327,4,1,1,4,4,10,-6,4
AEK Athens,3328,1,4,2,0,7,1,6,14
PAOK Salonik,3328,2,2,3,1,9,4,5,9
P'thinaikos,3328,3,1,2,3,4,9,-5,5
Panionios,3328,4,1,1,4,4,10,-6,4
AEK Athens,3329,1,4,2,0,7,1,6,14
PAOK Salonik,3329,2,2,3,1,12,7,5,9
P'thinaikos,3329,3,1,2,3,7,12,-5,5
Panionios,3329,4,1,1,4,4,10,-6,4
AEK Athens,3330,1,4,2,0,7,1,6,14
PAOK Salonik,3330,2,3,2,1,12,6,6,11
P'thinaikos,3330,3,1,1,4,6,12,-6,4
Panionios,3330,4,1,1,4,4,10,-6,4
AEK Athens,3331,1,4,2,0,7,1,6,14
PAOK Salonik,3331,2,3,2,1,12,6,6,11
P'thinaikos,3331,3,1,1,4,6,12,-6,4
Panionios,3331,4,1,1,4,4,10,-6,4
AEK Athens,3332,1,4,2,0,7,1,6,14
PAOK Salonik,3332,2,2,3,1,11,6,5,9
P'thinaikos,3332,3,1,2,3,6,11,-5,5
Panionios,3332,4,1,1,4,4,10,-6,4
AEK Athens,3333,1,4,2,0,7,1,6,14
PAOK Salonik,3333,2,3,2,1,12,5,7,11
Panionios,3333,3,1,1,4,4,10,-6,4
P'thinaikos,3333,4,1,1,4,5,12,-7,4
AEK Athens,3334,1,4,2,0,7,1,6,14
PAOK Salonik,3334,2,3,2,1,10,4,6,11
P'thinaikos,3334,3,1,1,4,4,10,-6,4
Panionios,3334,3,1,1,4,4,10,-6,4
AEK Athens,3335,1,4,2,0,7,1,6,14
PAOK Salonik,3335,2,2,3,1,9,4,5,9
P'thinaikos,3335,3,1,2,3,4,9,-5,5
Panionios,3335,4,1,1,4,4,10,-6,4
AEK Athens,3336,1,4,2,0,7,1,6,14
PAOK Salonik,3336,2,3,2,1,12,5,7,11
Panionios,3336,3,1,1,4,4,10,-6,4
P'thinaikos,3336,4,1,1,4,5,12,-7,4
AEK Athens,3337,1,4,2,0,7,1,6,14
PAOK Salonik,3337,2,3,2,1,12,4,8,11
Panionios,3337,3,1,1,4,4,10,-6,4
P'thinaikos,3337,4,1,1,4,4,12,-8,4
AEK Athens,3338,1,4,2,0,7,1,6,14
PAOK Salonik,3338,2,2,3,1,10,5,5,9
P'thinaikos,3338,3,1,2,3,5,10,-5,5
Panionios,3338,4,1,1,4,4,10,-6,4
AEK Athens,3339,1,4,2,0,7,1,6,14
PAOK Salonik,3339,2,2,2,2,9,5,4,8
P'thinaikos,3339,3,2,1,3,5,9,-4,7
Panionios,3339,4,1,1,4,4,10,-6,4
AEK Athens,3340,1,4,2,0,7,1,6,14
PAOK Salonik,3340,2,3,2,1,11,5,6,11
P'thinaikos,3340,3,1,1,4,5,11,-6,4
Panionios,3340,4,1,1,4,4,10,-6,4
AEK Athens,3341,1,4,2,0,7,1,6,14
PAOK Salonik,3341,2,2,2,2,9,5,4,8
P'thinaikos,3341,3,2,1,3,5,9,-4,7
Panionios,3341,4,1,1,4,4,10,-6,4
AEK Athens,3342,1,4,2,0,7,1,6,14
PAOK Salonik,3342,2,2,2,2,9,8,1,8
P'thinaikos,3342,3,2,1,3,8,9,-1,7
Panionios,3342,4,1,1,4,4,10,-6,4
AEK Athens,3343,1,4,2,0,7,1,6,14
PAOK Salonik,3343,2,2,2,2,9,5,4,8
P'thinaikos,3343,3,2,1,3,5,9,-4,7
Panionios,3343,4,1,1,4,4,10,-6,4
AEK Athens,3344,1,4,2,0,7,1,6,14
PAOK Salonik,3344,2,2,3,1,9,4,5,9
P'thinaikos,3344,3,1,2,3,4,9,-5,5
Panionios,3344,4,1,1,4,4,10,-6,4
AEK Athens,3345,1,4,2,0,7,1,6,14
PAOK Salonik,3345,2,2,3,1,10,5,5,9
P'thinaikos,3345,3,1,2,3,5,10,-5,5
Panionios,3345,4,1,1,4,4,10,-6,4
AEK Athens,3346,1,4,2,0,7,1,6,14
PAOK Salonik,3346,2,2,3,1,11,6,5,9
P'thinaikos,3346,3,1,2,3,6,11,-5,5
Panionios,3346,4,1,1,4,4,10,-6,4
AEK Athens,3347,1,4,2,0,7,1,6,14
PAOK Salonik,3347,2,2,3,1,10,5,5,9
P'thinaikos,3347,3,1,2,3,5,10,-5,5
Panionios,3347,4,1,1,4,4,10,-6,4
AEK Athens,3348,1,4,2,0,7,1,6,14
PAOK Salonik,3348,2,3,2,1,12,4,8,11
Panionios,3348,3,1,1,4,4,10,-6,4
P'thinaikos,3348,4,1,1,4,4,12,-8,4
AEK Athens,3349,1,4,2,0,7,1,6,14
PAOK Salonik,3349,2,3,2,1,11,4,7,11
Panionios,3349,3,1,1,4,4,10,-6,4
P'thinaikos,3349,4,1,1,4,4,11,-7,4
AEK Athens,3350,1,4,2,0,7,1,6,14
PAOK Salonik,3350,2,2,2,2,10,6,4,8
P'thinaikos,3350,3,2,1,3,6,10,-4,7
Panionios,3350,4,1,1,4,4,10,-6,4
AEK Athens,3351,1,4,2,0,7,1,6,14
PAOK Salonik,3351,2,2,2,2,10,6,4,8
P'thinaikos,3351,3,2,1,3,6,10,-4,7
Panionios,3351,4,1,1,4,4,10,-6,4
AEK Athens,3352,1,4,2,0,7,1,6,14
PAOK Salonik,3352,2,2,3,1,11,6,5,9
P'thinaikos,3352,3,1,2,3,6,11,-5,5
Panionios,3352,4,1,1,4,4,10,-6,4
AEK Athens,3353,1,4,2,0,7,1,6,14
PAOK Salonik,3353,2,2,3,1,10,5,5,9
P'thinaikos,3353,3,1,2,3,5,10,-5,5
Panionios,3353,4,1,1,4,4,10,-6,4
AEK Athens,3354,1,4,2,0,7,1,6,14
PAOK Salonik,3354,2,3,2,1,10,4,6,11
P'thinaikos,3354,3,1,1,4,4,10,-6,4
Panionios,3354,3,1,1,4,4,10,-6,4
AEK Athens,3355,1,4,2,0,7,1,6,14
PAOK Salonik,3355,2,2,3,1,10,5,5,9
P'thinaikos,3355,3,1,2,3,5,10,-5,5
Panionios,3355,4,1,1,4,4,10,-6,4
AEK Athens,3356,1,4,2,0,7,1,6,14
PAOK Salonik,3356,2,2,3,1,10,5,5,9
P'thinaikos,3356,3,1,2,3,5,10,-5,5
Panionios,3356,4,1,1,4,4,10,-6,4
AEK Athens,3357,1,4,2,0,7,1,6,14
PAOK Salonik,3357,2,3,2,1,11,5,6,11
P'thinaikos,3357,3,1,1,4,5,11,-6,4
Panionios,3357,4,1,1,4,4,10,-6,4
AEK Athens,3358,1,4,2,0,7,1,6,14
PAOK Salonik,3358,2,2,2,2,9,5,4,8
P'thinaikos,3358,3,2,1,3,5,9,-4,7
Panionios,3358,4,1,1,4,4,10,-6,4
AEK Athens,3359,1,4,2,0,7,1,6,14
PAOK Salonik,3359,2,3,2,1,12,5,7,11
Panionios,3359,3,1,1,4,4,10,-6,4
P'thinaikos,3359,4,1,1,4,5,12,-7,4
AEK Athens,3360,1,4,2,0,7,1,6,14
PAOK Salonik,3360,2,2,3,1,10,5,5,9
P'thinaikos,3360,3,1,2,3,5,10,-5,5
Panionios,3360,4,1,1,4,4,10,-6,4
AEK Athens,3361,1,4,2,0,7,1,6,14
PAOK Salonik,3361,2,3,2,1,11,5,6,11
P'thinaikos,3361,3,1,1,4,5,11,-6,4
Panionios,3361,4,1,1,4,4,10,-6,4
AEK Athens,3362,1,4,2,0,7,1,6,14
PAOK Salonik,3362,2,2,2,2,9,6,3,8
P'thinaikos,3362,3,2,1,3,6,9,-3,7
Panionios,3362,4,1,1,4,4,10,-6,4
AEK Athens,3363,1,4,2,0,7,1,6,14
PAOK Salonik,3363,2,2,2,2,9,5,4,8
P'thinaikos,3363,3,2,1,3,5,9,-4,7
Panionios,3363,4,1,1,4,4,10,-6,4
AEK Athens,3364,1,4,2,0,7,1,6,14
PAOK Salonik,3364,2,2,2,2,9,7,2,8
P'thinaikos,3364,3,2,1,3,7,9,-2,7
Panionios,3364,4,1,1,4,4,10,-6,4
AEK Athens,3365,1,4,2,0,7,1,6,14
PAOK Salonik,3365,2,2,2,2,10,8,2,8
P'thinaikos,3365,3,2,1,3,8,10,-2,7
Panionios,3365,4,1,1,4,4,10,-6,4
AEK Athens,3366,1,4,2,0,7,1,6,14
PAOK Salonik,3366,2,3,2,1,10,4,6,11
P'thinaikos,3366,3,1,1,4,4,10,-6,4
Panionios,3366,3,1,1,4,4,10,-6,4
AEK Athens,3367,1,4,2,0,7,1,6,14
PAOK Salonik,3367,2,3,2,1,10,4,6,11
P'thinaikos,3367,3,1,1,4,4,10,-6,4
Panionios,3367,3,1,1,4,4,10,-6,4
AEK Athens,3368,1,4,2,0,7,1,6,14
PAOK Salonik,3368,2,3,2,1,11,5,6,11
P'thinaikos,3368,3,1,1,4,5,11,-6,4
Panionios,3368,4,1,1,4,4,10,-6,4
AEK Athens,3369,1,4,2,0,7,1,6,14
PAOK Salonik,3369,2,2,3,1,10,5,5,9
P'thinaikos,3369,3,1,2,3,5,10,-5,5
Panionios,3369,4,1,1,4,4,10,-6,4
AEK Athens,3370,1,4,2,0,7,1,6,14
PAOK Salonik,3370,2,2,2,2,9,5,4,8
P'thinaikos,3370,3,2,1,3,5,9,-4,7
Panionios,3370,4,1,1,4,4,10,-6,4
AEK Athens,3371,1,4,2,0,7,1,6,14
PAOK Salonik,3371,2,2,2,2,9,8,1,8
P'thinaikos,3371,3,2,1,3,8,9,-1,7
Panionios,3371,4,1,1,4,4,10,-6,4
AEK Athens,3372,1,4,2,0,7,1,6,14
PAOK Salonik,3372,2,2,2,2,9,7,2,8
P'thinaikos,3372,3,2,1,3,7,9,-2,7
Panionios,3372,4,1,1,4,4,10,-6,4
AEK Athens,3373,1,4,2,0,7,1,6,14
PAOK Salonik,3373,2,3,2,1,12,6,6,11
P'thinaikos,3373,3,1,1,4,6,12,-6,4
Panionios,3373,4,1,1,4,4,10,-6,4
AEK Athens,3374,1,4,2,0,7,1,6,14
PAOK Salonik,3374,2,2,2,2,9,5,4,8
P'thinaikos,3374,3,2,1,3,5,9,-4,7
Panionios,3374,4,1,1,4,4,10,-6,4
AEK Athens,3375,1,4,2,0,7,1,6,14
PAOK Salonik,3375,2,3,2,1,11,5,6,11
P'thinaikos,3375,3,1,1,4,5,11,-6,4
Panionios,3375,4,1,1,4,4,10,-6,4
AEK Athens,3376,1,4,2,0,7,1,6,14
PAOK Salonik,3376,2,3,2,1,10,4,6,11
P'thinaikos,3376,3,1,1,4,4,10,-6,4
Panionios,3376,3,1,1,4,4,10,-6,4
AEK Athens,3377,1,4,2,0,7,1,6,14
PAOK Salonik,3377,2,2,2,2,9,5,4,8
P'thinaikos,3377,3,2,1,3,5,9,-4,7
Panionios,3377,4,1,1,4,4,10,-6,4
AEK Athens,3378,1,4,2,0,7,1,6,14
PAOK Salonik,3378,2,2,2,2,10,6,4,8
P'thinaikos,3378,3,2,1,3,6,10,-4,7
Panionios,3378,4,1,1,4,4,10,-6,4
AEK Athens,3379,1,4,2,0,7,1,6,14
PAOK Salonik,3379,2,2,3,1,11,6,5,9
P'thinaikos,3379,3,1,2,3,6,11,-5,5
Panionios,3379,4,1,1,4,4,10,-6,4
AEK Athens,3380,1,4,2,0,7,1,6,14
PAOK Salonik,3380,2,2,3,1,10,5,5,9
P'thinaikos,3380,3,1,2,3,5,10,-5,5
Panionios,3380,4,1,1,4,4,10,-6,4
AEK Athens,3381,1,4,2,0,7,1,6,14
PAOK Salonik,3381,2,3,2,1,13,4,9,11
Panionios,3381,3,1,1,4,4,10,-6,4
P'thinaikos,3381,4,1,1,4,4,13,-9,4
AEK Athens,3382,1,4,2,0,7,1,6,14
PAOK Salonik,3382,2,2,2,2,9,5,4,8
P'thinaikos,3382,3,2,1,3,5,9,-4,7
Panionios,3382,4,1,1,4,4,10,-6,4
AEK Athens,3383,1,4,2,0,7,1,6,14
PAOK Salonik,3383,2,3,2,1,10,4,6,11
P'thinaikos,3383,3,1,1,4,4,10,-6,4
Panionios,3383,3,1,1,4,4,10,-6,4
AEK Athens,3384,1,4,2,0,7,1,6,14
PAOK Salonik,3384,2,2,3,1,9,4,5,9
P'thinaikos,3384,3,1,2,3,4,9,-5,5
Panionios,3384,4,1,1,4,4,10,-6,4
AEK Athens,3385,1,4,2,0,7,1,6,14
PAOK Salonik,3385,2,3,2,1,12,4,8,11
Panionios,3385,3,1,1,4,4,10,-6,4
P'thinaikos,3385,4,1,1,4,4,12,-8,4
AEK Athens,3386,1,4,2,0,7,1,6,14
PAOK Salonik,3386,2,2,2,2,9,5,4,8
P'thinaikos,3386,3,2,1,3,5,9,-4,7
Panionios,3386,4,1,1,4,4,10,-6,4
AEK Athens,3387,1,4,2,0,7,1,6,14
PAOK Salonik,3387,2,2,2,2,9,6,3,8
P'thinaikos,3387,3,2,1,3,6,9,-3,7
Panionios,3387,4,1,1,4,4,10,-6,4
AEK Athens,3388,1,4,2,0,7,1,6,14
PAOK Salonik,3388,2,2,2,2,10,7,3,8
P'thinaikos,3388,3,2,1,3,7,10,-3,7
Panionios,3388,4,1,1,4,4,10,-6,4
AEK Athens,3389,1,4,2,0,7,1,6,14
PAOK Salonik,3389,2,2,2,2,9,7,2,8
P'thinaikos,3389,3,2,1,3,7,9,-2,7
Panionios,3389,4,1,1,4,4,10,-6,4
AEK Athens,3390,1,4,2,0,7,1,6,14
PAOK Salonik,3390,2,2,2,2,11,9,2,8
P'thinaikos,3390,3,2,1,3,9,11,-2,7
Panionios,3390,4,1,1,4,4,10,-6,4
AEK Athens,3391,1,4,2,0,7,1,6,14
PAOK Salonik,3391,2,2,2,2,10,8,2,8
P'thinaikos,3391,3,2,1,3,8,10,-2,7
Panionios,3391,4,1,1,4,4,10,-6,4
AEK Athens,3392,1,4,2,0,7,1,6,14
PAOK Salonik,3392,2,3,2,1,11,5,6,11
P'thinaikos,3392,3,1,1,4,5,11,-6,4
Panionios,3392,4,1,1,4,4,10,-6,4
AEK Athens,3393,1,4,2,0,7,1,6,14
PAOK Salonik,3393,2,2,3,1,9,4,5,9
P'thinaikos,3393,3,1,2,3,4,9,-5,5
Panionios,3393,4,1,1,4,4,10,-6,4
AEK Athens,3394,1,4,2,0,7,1,6,14
PAOK Salonik,3394,2,2,2,2,10,8,2,8
P'thinaikos,3394,3,2,1,3,8,10,-2,7
Panionios,3394,4,1,1,4,4,10,-6,4
AEK Athens,3395,1,4,2,0,7,1,6,14
PAOK Salonik,3395,2,2,3,1,9,4,5,9
P'thinaikos,3395,3,1,2,3,4,9,-5,5
Panionios,3395,4,1,1,4,4,10,-6,4
AEK Athens,3396,1,4,2,0,7,1,6,14
PAOK Salonik,3396,2,3,2,1,11,5,6,11
P'thinaikos,3396,3,1,1,4,5,11,-6,4
Panionios,3396,4,1,1,4,4,10,-6,4
AEK Athens,3397,1,4,2,0,7,1,6,14
PAOK Salonik,3397,2,3,2,1,10,4,6,11
P'thinaikos,3397,3,1,1,4,4,10,-6,4
Panionios,3397,3,1,1,4,4,10,-6,4
AEK Athens,3398,1,4,2,0,7,1,6,14
PAOK Salonik,3398,2,3,2,1,14,5,9,11
Panionios,3398,3,1,1,4,4,10,-6,4
P'thinaikos,3398,4,1,1,4,5,14,-9,4
AEK Athens,3399,1,4,2,0,7,1,6,14
PAOK Salonik,3399,2,2,3,1,10,5,5,9
P'thinaikos,3399,3,1,2,3,5,10,-5,5
Panionios,3399,4,1,1,4,4,10,-6,4
AEK Athens,3400,1,4,2,0,7,1,6,14
PAOK Salonik,3400,2,2,2,2,9,5,4,8
P'thinaikos,3400,3,2,1,3,5,9,-4,7
Panionios,3400,4,1,1,4,4,10,-6,4
AEK Athens,3401,1,4,2,0,7,1,6,14
PAOK Salonik,3401,2,3,2,1,11,5,6,11
P'thinaikos,3401,3,1,1,4,5,11,-6,4
Panionios,3401,4,1,1,4,4,10,-6,4
AEK Athens,3402,1,4,2,0,7,1,6,14
PAOK Salonik,3402,2,2,3,1,9,4,5,9
P'thinaikos,3402,3,1,2,3,4,9,-5,5
Panionios,3402,4,1,1,4,4,10,-6,4
AEK Athens,3403,1,4,2,0,7,1,6,14
PAOK Salonik,3403,2,2,2,2,10,6,4,8
P'thinaikos,3403,3,2,1,3,6,10,-4,7
Panionios,3403,4,1,1,4,4,10,-6,4
AEK Athens,3404,1,4,2,0,7,1,6,14
PAOK Salonik,3404,2,2,2,2,10,6,4,8
P'thinaikos,3404,3,2,1,3,6,10,-4,7
Panionios,3404,4,1,1,4,4,10,-6,4
AEK Athens,3405,1,4,2,0,7,1,6,14
PAOK Salonik,3405,2,2,2,2,10,6,4,8
P'thinaikos,3405,3,2,1,3,6,10,-4,7
Panionios,3405,4,1,1,4,4,10,-6,4
AEK Athens,3406,1,4,2,0,7,1,6,14
PAOK Salonik,3406,2,2,2,2,9,6,3,8
P'thinaikos,3406,3,2,1,3,6,9,-3,7
Panionios,3406,4,1,1,4,4,10,-6,4
AEK Athens,3407,1,4,2,0,7,1,6,14
PAOK Salonik,3407,2,2,3,1,11,6,5,9
P'thinaikos,3407,3,1,2,3,6,11,-5,5
Panionios,3407,4,1,1,4,4,10,-6,4
AEK Athens,3408,1,4,2,0,7,1,6,14
PAOK Salonik,3408,2,3,2,1,11,5,6,11
P'thinaikos,3408,3,1,1,4,5,11,-6,4
Panionios,3408,4,1,1,4,4,10,-6,4
AEK Athens,3409,1,4,2,0,7,1,6,14
PAOK Salonik,3409,2,3,2,1,10,4,6,11
P'thinaikos,3409,3,1,1,4,4,10,-6,4
Panionios,3409,3,1,1,4,4,10,-6,4
AEK Athens,3410,1,4,2,0,7,1,6,14
PAOK Salonik,3410,2,2,3,1,11,6,5,9
P'thinaikos,3410,3,1,2,3,6,11,-5,5
Panionios,3410,4,1,1,4,4,10,-6,4
AEK Athens,3411,1,4,2,0,7,1,6,14
PAOK Salonik,3411,2,2,2,2,9,5,4,8
P'thinaikos,3411,3,2,1,3,5,9,-4,7
Panionios,3411,4,1,1,4,4,10,-6,4
AEK Athens,3412,1,4,2,0,7,1,6,14
PAOK Salonik,3412,2,3,2,1,11,5,6,11
P'thinaikos,3412,3,1,1,4,5,11,-6,4
Panionios,3412,4,1,1,4,4,10,-6,4
AEK Athens,3413,1,4,2,0,7,1,6,14
PAOK Salonik,3413,2,2,3,1,10,5,5,9
P'thinaikos,3413,3,1,2,3,5,10,-5,5
Panionios,3413,4,1,1,4,4,10,-6,4
AEK Athens,3414,1,4,2,0,7,1,6,14
PAOK Salonik,3414,2,2,3,1,10,5,5,9
P'thinaikos,3414,3,1,2,3,5,10,-5,5
Panionios,3414,4,1,1,4,4,10,-6,4
AEK Athens,3415,1,4,2,0,7,1,6,14
PAOK Salonik,3415,2,2,2,2,9,5,4,8
P'thinaikos,3415,3,2,1,3,5,9,-4,7
Panionios,3415,4,1,1,4,4,10,-6,4
AEK Athens,3416,1,4,2,0,7,1,6,14
PAOK Salonik,3416,2,2,2,2,9,6,3,8
P'thinaikos,3416,3,2,1,3,6,9,-3,7
Panionios,3416,4,1,1,4,4,10,-6,4
AEK Athens,3417,1,4,2,0,7,1,6,14
PAOK Salonik,3417,2,3,2,1,11,5,6,11
P'thinaikos,3417,3,1,1,4,5,11,-6,4
Panionios,3417,4,1,1,4,4,10,-6,4
AEK Athens,3418,1,4,2,0,7,1,6,14
PAOK Salonik,3418,2,2,2,2,10,6,4,8
P'thinaikos,3418,3,2,1,3,6,10,-4,7
Panionios,3418,4,1,1,4,4,10,-6,4
AEK Athens,3419,1,4,2,0,7,1,6,14
PAOK Salonik,3419,2,2,2,2,11,8,3,8
P'thinaikos,3419,3,2,1,3,8,11,-3,7
Panionios,3419,4,1,1,4,4,10,-6,4
AEK Athens,3420,1,4,2,0,7,1,6,14
PAOK Salonik,3420,2,2,3,1,11,6,5,9
P'thinaikos,3420,3,1,2,3,6,11,-5,5
Panionios,3420,4,1,1,4,4,10,-6,4
AEK Athens,3421,1,4,2,0,7,1,6,14
PAOK Salonik,3421,2,3,2,1,10,4,6,11
P'thinaikos,3421,3,1,1,4,4,10,-6,4
Panionios,3421,3,1,1,4,4,10,-6,4
AEK Athens,3422,1,4,2,0,7,1,6,14
PAOK Salonik,3422,2,3,2,1,13,5,8,11
Panionios,3422,3,1,1,4,4,10,-6,4
P'thinaikos,3422,4,1,1,4,5,13,-8,4
AEK Athens,3423,1,4,2,0,7,1,6,14
PAOK Salonik,3423,2,2,2,2,9,7,2,8
P'thinaikos,3423,3,2,1,3,7,9,-2,7
Panionios,3423,4,1,1,4,4,10,-6,4
AEK Athens,3424,1,4,2,0,7,1,6,14
PAOK Salonik,3424,2,2,2,2,9,6,3,8
P'thinaikos,3424,3,2,1,3,6,9,-3,7
Panionios,3424,4,1,1,4,4,10,-6,4
AEK Athens,3425,1,4,2,0,7,1,6,14
PAOK Salonik,3425,2,3,2,1,12,5,7,11
Panionios,3425,3,1,1,4,4,10,-6,4
P'thinaikos,3425,4,1,1,4,5,12,-7,4
AEK Athens,3426,1,4,2,0,7,1,6,14
PAOK Salonik,3426,2,2,2,2,9,5,4,8
P'thinaikos,3426,3,2,1,3,5,9,-4,7
Panionios,3426,4,1,1,4,4,10,-6,4
AEK Athens,3427,1,4,2,0,7,1,6,14
PAOK Salonik,3427,2,2,3,1,10,5,5,9
P'thinaikos,3427,3,1,2,3,5,10,-5,5
Panionios,3427,4,1,1,4,4,10,-6,4
AEK Athens,3428,1,4,2,0,7,1,6,14
PAOK Salonik,3428,2,3,2,1,11,4,7,11
Panionios,3428,3,1,1,4,4,10,-6,4
P'thinaikos,3428,4,1,1,4,4,11,-7,4
AEK Athens,3429,1,4,2,0,7,1,6,14
PAOK Salonik,3429,2,2,2,2,9,5,4,8
P'thinaikos,3429,3,2,1,3,5,9,-4,7
Panionios,3429,4,1,1,4,4,10,-6,4
AEK Athens,3430,1,4,2,0,7,1,6,14
PAOK Salonik,3430,2,3,2,1,10,4,6,11
P'thinaikos,3430,3,1,1,4,4,10,-6,4
Panionios,3430,3,1,1,4,4,10,-6,4
AEK Athens,3431,1,4,2,0,7,1,6,14
PAOK Salonik,3431,2,2,3,1,9,4,5,9
P'thinaikos,3431,3,1,2,3,4,9,-5,5
Panionios,3431,4,1,1,4,4,10,-6,4
AEK Athens,3432,1,4,2,0,7,1,6,14
PAOK Salonik,3432,2,2,3,1,10,5,5,9
P'thinaikos,3432,3,1,2,3,5,10,-5,5
Panionios,3432,4,1,1,4,4,10,-6,4
AEK Athens,3433,1,4,2,0,7,1,6,14
PAOK Salonik,3433,2,3,2,1,10,4,6,11
P'thinaikos,3433,3,1,1,4,4,10,-6,4
Panionios,3433,3,1,1,4,4,10,-6,4
AEK Athens,3434,1,4,2,0,7,1,6,14
PAOK Salonik,3434,2,3,2,1,11,4,7,11
Panionios,3434,3,1,1,4,4,10,-6,4
P'thinaikos,3434,4,1,1,4,4,11,-7,4
AEK Athens,3435,1,4,2,0,7,1,6,14
PAOK Salonik,3435,2,3,2,1,11,4,7,11
Panionios,3435,3,1,1,4,4,10,-6,4
P'thinaikos,3435,4,1,1,4,4,11,-7,4
AEK Athens,3436,1,4,2,0,7,1,6,14
PAOK Salonik,3436,2,2,2,2,10,6,4,8
P'thinaikos,3436,3,2,1,3,6,10,-4,7
Panionios,3436,4,1,1,4,4,10,-6,4
AEK Athens,3437,1,4,2,0,7,1,6,14
PAOK Salonik,3437,2,3,2,1,11,4,7,11
Panionios,3437,3,1,1,4,4,10,-6,4
P'thinaikos,3437,4,1,1,4,4,11,-7,4
AEK Athens,3438,1,4,2,0,7,1,6,14
PAOK Salonik,3438,2,2,3,1,11,6,5,9
P'thinaikos,3438,3,1,2,3,6,11,-5,5
Panionios,3438,4,1,1,4,4,10,-6,4
AEK Athens,3439,1,4,2,0,7,1,6,14
PAOK Salonik,3439,2,3,2,1,10,4,6,11
P'thinaikos,3439,3,1,1,4,4,10,-6,4
Panionios,3439,3,1,1,4,4,10,-6,4
AEK Athens,3440,1,4,2,0,7,1,6,14
PAOK Salonik,3440,2,2,3,1,10,5,5,9
P'thinaikos,3440,3,1,2,3,5,10,-5,5
Panionios,3440,4,1,1,4,4,10,-6,4
AEK Athens,3441,1,4,2,0,7,1,6,14
PAOK Salonik,3441,2,2,3,1,10,5,5,9
P'thinaikos,3441,3,1,2,3,5,10,-5,5
Panionios,3441,4,1,1,4,4,10,-6,4
AEK Athens,3442,1,4,2,0,7,1,6,14
PAOK Salonik,3442,2,3,2,1,11,4,7,11
Panionios,3442,3,1,1,4,4,10,-6,4
P'thinaikos,3442,4,1,1,4,4,11,-7,4
AEK Athens,3443,1,4,2,0,7,1,6,14
PAOK Salonik,3443,2,2,3,1,10,5,5,9
P'thinaikos,3443,3,1,2,3,5,10,-5,5
Panionios,3443,4,1,1,4,4,10,-6,4
AEK Athens,3444,1,4,2,0,7,1,6,14
PAOK Salonik,3444,2,2,2,2,9,5,4,8
P'thinaikos,3444,3,2,1,3,5,9,-4,7
Panionios,3444,4,1,1,4,4,10,-6,4
AEK Athens,3445,1,4,2,0,7,1,6,14
PAOK Salonik,3445,2,2,3,1,11,6,5,9
P'thinaikos,3445,3,1,2,3,6,11,-5,5
Panionios,3445,4,1,1,4,4,10,-6,4
AEK Athens,3446,1,4,2,0,7,1,6,14
PAOK Salonik,3446,2,2,3,1,9,4,5,9
P'thinaikos,3446,3,1,2,3,4,9,-5,5
Panionios,3446,4,1,1,4,4,10,-6,4
AEK Athens,3447,1,4,2,0,7,1,6,14
PAOK Salonik,3447,2,2,3,1,9,4,5,9
P'thinaikos,3447,3,1,2,3,4,9,-5,5
Panionios,3447,4,1,1,4,4,10,-6,4
AEK Athens,3448,1,4,2,0,7,1,6,14
PAOK Salonik,3448,2,2,2,2,9,5,4,8
P'thinaikos,3448,3,2,1,3,5,9,-4,7
Panionios,3448,4,1,1,4,4,10,-6,4
AEK Athens,3449,1,4,2,0,7,1,6,14
PAOK Salonik,3449,2,2,3,1,10,5,5,9
P'thinaikos,3449,3,1,2,3,5,10,-5,5
Panionios,3449,4,1,1,4,4,10,-6,4
AEK Athens,3450,1,4,2,0,7,1,6,14
PAOK Salonik,3450,2,2,3,1,9,4,5,9
P'thinaikos,3450,3,1,2,3,4,9,-5,5
Panionios,3450,4,1,1,4,4,10,-6,4
AEK Athens,3451,1,4,2,0,7,1,6,14
PAOK Salonik,3451,2,2,3,1,12,7,5,9
P'thinaikos,3451,3,1,2,3,7,12,-5,5
Panionios,3451,4,1,1,4,4,10,-6,4
AEK Athens,3452,1,4,2,0,7,1,6,14
PAOK Salonik,3452,2,3,2,1,10,4,6,11
P'thinaikos,3452,3,1,1,4,4,10,-6,4
Panionios,3452,3,1,1,4,4,10,-6,4
AEK Athens,3453,1,4,2,0,7,1,6,14
PAOK Salonik,3453,2,2,2,2,9,7,2,8
P'thinaikos,3453,3,2,1,3,7,9,-2,7
Panionios,3453,4,1,1,4,4,10,-6,4
AEK Athens,3454,1,4,2,0,7,1,6,14
PAOK Salonik,3454,2,3,2,1,11,5,6,11
P'thinaikos,3454,3,1,1,4,5,11,-6,4
Panionios,3454,4,1,1,4,4,10,-6,4
AEK Athens,3455,1,4,2,0,7,1,6,14
PAOK Salonik,3455,2,3,2,1,12,5,7,11
Panionios,3455,3,1,1,4,4,10,-6,4
P'thinaikos,3455,4,1,1,4,5,12,-7,4
AEK Athens,3456,1,4,2,0,7,1,6,14
PAOK Salonik,3456,2,2,2,2,10,6,4,8
P'thinaikos,3456,3,2,1,3,6,10,-4,7
Panionios,3456,4,1,1,4,4,10,-6,4
AEK Athens,3457,1,4,2,0,7,1,6,14
PAOK Salonik,3457,2,2,2,2,10,6,4,8
P'thinaikos,3457,3,2,1,3,6,10,-4,7
Panionios,3457,4,1,1,4,4,10,-6,4
AEK Athens,3458,1,4,2,0,7,1,6,14
PAOK Salonik,3458,2,2,3,1,10,5,5,9
P'thinaikos,3458,3,1,2,3,5,10,-5,5
Panionios,3458,4,1,1,4,4,10,-6,4
AEK Athens,3459,1,4,2,0,7,1,6,14
PAOK Salonik,3459,2,3,2,1,11,5,6,11
P'thinaikos,3459,3,1,1,4,5,11,-6,4
Panionios,3459,4,1,1,4,4,10,-6,4
AEK Athens,3460,1,4,2,0,7,1,6,14
PAOK Salonik,3460,2,2,3,1,10,5,5,9
P'thinaikos,3460,3,1,2,3,5,10,-5,5
Panionios,3460,4,1,1,4,4,10,-6,4
AEK Athens,3461,1,4,2,0,7,1,6,14
PAOK Salonik,3461,2,2,2,2,9,6,3,8
P'thinaikos,3461,3,2,1,3,6,9,-3,7
Panionios,3461,4,1,1,4,4,10,-6,4
AEK Athens,3462,1,4,2,0,7,1,6,14
PAOK Salonik,3462,2,2,2,2,9,7,2,8
P'thinaikos,3462,3,2,1,3,7,9,-2,7
Panionios,3462,4,1,1,4,4,10,-6,4
AEK Athens,3463,1,4,2,0,7,1,6,14
PAOK Salonik,3463,2,2,2,2,9,6,3,8
P'thinaikos,3463,3,2,1,3,6,9,-3,7
Panionios,3463,4,1,1,4,4,10,-6,4
AEK Athens,3464,1,4,2,0,7,1,6,14
PAOK Salonik,3464,2,2,3,1,10,5,5,9
P'thinaikos,3464,3,1,2,3,5,10,-5,5
Panionios,3464,4,1,1,4,4,10,-6,4
AEK Athens,3465,1,4,2,0,7,1,6,14
PAOK Salonik,3465,2,3,2,1,12,5,7,11
Panionios,3465,3,1,1,4,4,10,-6,4
P'thinaikos,3465,4,1,1,4,5,12,-7,4
AEK Athens,3466,1,4,2,0,7,1,6,14
PAOK Salonik,3466,2,2,2,2,10,6,4,8
P'thinaikos,3466,3,2,1,3,6,10,-4,7
Panionios,3466,4,1,1,4,4,10,-6,4
AEK Athens,3467,1,4,2,0,7,1,6,14
PAOK Salonik,3467,2,3,2,1,13,4,9,11
Panionios,3467,3,1,1,4,4,10,-6,4
P'thinaikos,3467,4,1,1,4,4,13,-9,4
AEK Athens,3468,1,4,2,0,7,1,6,14
PAOK Salonik,3468,2,3,2,1,11,4,7,11
Panionios,3468,3,1,1,4,4,10,-6,4
P'thinaikos,3468,4,1,1,4,4,11,-7,4
AEK Athens,3469,1,4,2,0,7,1,6,14
PAOK Salonik,3469,2,3,2,1,14,7,7,11
Panionios,3469,3,1,1,4,4,10,-6,4
P'thinaikos,3469,4,1,1,4,7,14,-7,4
AEK Athens,3470,1,4,2,0,7,1,6,14
PAOK Salonik,3470,2,2,3,1,10,5,5,9
P'thinaikos,3470,3,1,2,3,5,10,-5,5
Panionios,3470,4,1,1,4,4,10,-6,4
AEK Athens,3471,1,4,2,0,7,1,6,14
PAOK Salonik,3471,2,2,3,1,11,6,5,9
P'thinaikos,3471,3,1,2,3,6,11,-5,5
Panionios,3471,4,1,1,4,4,10,-6,4
AEK Athens,3472,1,4,2,0,7,1,6,14
PAOK Salonik,3472,2,2,2,2,10,7,3,8
P'thinaikos,3472,3,2,1,3,7,10,-3,7
Panionios,3472,4,1,1,4,4,10,-6,4
AEK Athens,3473,1,4,2,0,7,1,6,14
PAOK Salonik,3473,2,3,2,1,11,5,6,11
P'thinaikos,3473,3,1,1,4,5,11,-6,4
Panionios,3473,4,1,1,4,4,10,-6,4
AEK Athens,3474,1,4,2,0,7,1,6,14
PAOK Salonik,3474,2,2,2,2,9,6,3,8
P'thinaikos,3474,3,2,1,3,6,9,-3,7
Panionios,3474,4,1,1,4,4,10,-6,4
AEK Athens,3475,1,4,2,0,7,1,6,14
PAOK Salonik,3475,2,2,2,2,9,6,3,8
P'thinaikos,3475,3,2,1,3,6,9,-3,7
Panionios,3475,4,1,1,4,4,10,-6,4
AEK Athens,3476,1,4,2,0,7,1,6,14
PAOK Salonik,3476,2,3,2,1,12,5,7,11
Panionios,3476,3,1,1,4,4,10,-6,4
P'thinaikos,3476,4,1,1,4,5,12,-7,4
AEK Athens,3477,1,4,2,0,7,1,6,14
PAOK Salonik,3477,2,3,2,1,12,5,7,11
Panionios,3477,3,1,1,4,4,10,-6,4
P'thinaikos,3477,4,1,1,4,5,12,-7,4
AEK Athens,3478,1,4,2,0,7,1,6,14
PAOK Salonik,3478,2,3,2,1,10,4,6,11
P'thinaikos,3478,3,1,1,4,4,10,-6,4
Panionios,3478,3,1,1,4,4,10,-6,4
AEK Athens,3479,1,4,2,0,7,1,6,14
PAOK Salonik,3479,2,3,2,1,12,5,7,11
Panionios,3479,3,1,1,4,4,10,-6,4
P'thinaikos,3479,4,1,1,4,5,12,-7,4
AEK Athens,3480,1,4,2,0,7,1,6,14
PAOK Salonik,3480,2,3,2,1,11,5,6,11
P'thinaikos,3480,3,1,1,4,5,11,-6,4
Panionios,3480,4,1,1,4,4,10,-6,4
AEK Athens,3481,1,4,2,0,7,1,6,14
PAOK Salonik,3481,2,3,2,1,14,4,10,11
Panionios,3481,3,1,1,4,4,10,-6,4
P'thinaikos,3481,4,1,1,4,4,14,-10,4
AEK Athens,3482,1,4,2,0,7,1,6,14
PAOK Salonik,3482,2,2,3,1,9,4,5,9
P'thinaikos,3482,3,1,2,3,4,9,-5,5
Panionios,3482,4,1,1,4,4,10,-6,4
AEK Athens,3483,1,4,2,0,7,1,6,14
PAOK Salonik,3483,2,2,2,2,9,6,3,8
P'thinaikos,3483,3,2,1,3,6,9,-3,7
Panionios,3483,4,1,1,4,4,10,-6,4
AEK Athens,3484,1,4,2,0,7,1,6,14
PAOK Salonik,3484,2,2,2,2,10,7,3,8
P'thinaikos,3484,3,2,1,3,7,10,-3,7
Panionios,3484,4,1,1,4,4,10,-6,4
AEK Athens,3485,1,4,2,0,7,1,6,14
PAOK Salonik,3485,2,2,2,2,10,6,4,8
P'thinaikos,3485,3,2,1,3,6,10,-4,7
Panionios,3485,4,1,1,4,4,10,-6,4
AEK Athens,3486,1,4,2,0,7,1,6,14
PAOK Salonik,3486,2,2,3,1,10,5,5,9
P'thinaikos,3486,3,1,2,3,5,10,-5,5
Panionios,3486,4,1,1,4,4,10,-6,4
AEK Athens,3487,1,4,2,0,7,1,6,14
PAOK Salonik,3487,2,3,2,1,13,5,8,11
Panionios,3487,3,1,1,4,4,10,-6,4
P'thinaikos,3487,4,1,1,4,5,13,-8,4
AEK Athens,3488,1,4,2,0,7,1,6,14
PAOK Salonik,3488,2,2,3,1,11,6,5,9
P'thinaikos,3488,3,1,2,3,6,11,-5,5
Panionios,3488,4,1,1,4,4,10,-6,4
AEK Athens,3489,1,4,2,0,7,1,6,14
PAOK Salonik,3489,2,2,3,1,11,6,5,9
P'thinaikos,3489,3,1,2,3,6,11,-5,5
Panionios,3489,4,1,1,4,4,10,-6,4
AEK Athens,3490,1,4,2,0,7,1,6,14
PAOK Salonik,3490,2,2,3,1,10,5,5,9
P'thinaikos,3490,3,1,2,3,5,10,-5,5
Panionios,3490,4,1,1,4,4,10,-6,4
AEK Athens,3491,1,4,2,0,7,1,6,14
PAOK Salonik,3491,2,3,2,1,11,4,7,11
Panionios,3491,3,1,1,4,4,10,-6,4
P'thinaikos,3491,4,1,1,4,4,11,-7,4
AEK Athens,3492,1,4,2,0,7,1,6,14
PAOK Salonik,3492,2,2,2,2,9,5,4,8
P'thinaikos,3492,3,2,1,3,5,9,-4,7
Panionios,3492,4,1,1,4,4,10,-6,4
AEK Athens,3493,1,4,2,0,7,1,6,14
PAOK Salonik,3493,2,2,2,2,9,6,3,8
P'thinaikos,3493,3,2,1,3,6,9,-3,7
Panionios,3493,4,1,1,4,4,10,-6,4
AEK Athens,3494,1,4,2,0,7,1,6,14
PAOK Salonik,3494,2,2,2,2,9,5,4,8
P'thinaikos,3494,3,2,1,3,5,9,-4,7
Panionios,3494,4,1,1,4,4,10,-6,4
AEK Athens,3495,1,4,2,0,7,1,6,14
PAOK Salonik,3495,2,3,2,1,11,5,6,11
P'thinaikos,3495,3,1,1,4,5,11,-6,4
Panionios,3495,4,1,1,4,4,10,-6,4
AEK Athens,3496,1,4,2,0,7,1,6,14
PAOK Salonik,3496,2,2,3,1,9,4,5,9
P'thinaikos,3496,3,1,2,3,4,9,-5,5
Panionios,3496,4,1,1,4,4,10,-6,4
AEK Athens,3497,1,4,2,0,7,1,6,14
PAOK Salonik,3497,2,2,3,1,10,5,5,9
P'thinaikos,3497,3,1,2,3,5,10,-5,5
Panionios,3497,4,1,1,4,4,10,-6,4
AEK Athens,3498,1,4,2,0,7,1,6,14
PAOK Salonik,3498,2,3,2,1,11,5,6,11
P'thinaikos,3498,3,1,1,4,5,11,-6,4
Panionios,3498,4,1,1,4,4,10,-6,4
AEK Athens,3499,1,4,2,0,7,1,6,14
PAOK Salonik,3499,2,3,2,1,10,4,6,11
P'thinaikos,3499,3,1,1,4,4,10,-6,4
Panionios,3499,3,1,1,4,4,10,-6,4
AEK Athens,3500,1,4,2,0,7,1,6,14
PAOK Salonik,3500,2,3,2,1,13,4,9,11
Panionios,3500,3,1,1,4,4,10,-6,4
P'thinaikos,3500,4,1,1,4,4,13,-9,4
AEK Athens,3501,1,4,2,0,7,1,6,14
PAOK Salonik,3501,2,3,2,1,12,6,6,11
P'thinaikos,3501,3,1,1,4,6,12,-6,4
Panionios,3501,4,1,1,4,4,10,-6,4
AEK Athens,3502,1,4,2,0,7,1,6,14
PAOK Salonik,3502,2,2,3,1,10,5,5,9
P'thinaikos,3502,3,1,2,3,5,10,-5,5
Panionios,3502,4,1,1,4,4,10,-6,4
AEK Athens,3503,1,4,2,0,7,1,6,14
PAOK Salonik,3503,2,2,2,2,9,7,2,8
P'thinaikos,3503,3,2,1,3,7,9,-2,7
Panionios,3503,4,1,1,4,4,10,-6,4
AEK Athens,3504,1,4,2,0,7,1,6,14
PAOK Salonik,3504,2,2,2,2,9,5,4,8
P'thinaikos,3504,3,2,1,3,5,9,-4,7
Panionios,3504,4,1,1,4,4,10,-6,4
AEK Athens,3505,1,4,2,0,7,1,6,14
PAOK Salonik,3505,2,2,2,2,10,6,4,8
P'thinaikos,3505,3,2,1,3,6,10,-4,7
Panionios,3505,4,1,1,4,4,10,-6,4
AEK Athens,3506,1,4,2,0,7,1,6,14
PAOK Salonik,3506,2,2,3,1,13,8,5,9
P'thinaikos,3506,3,1,2,3,8,13,-5,5
Panionios,3506,4,1,1,4,4,10,-6,4
AEK Athens,3507,1,4,2,0,7,1,6,14
PAOK Salonik,3507,2,3,2,1,10,4,6,11
P'thinaikos,3507,3,1,1,4,4,10,-6,4
Panionios,3507,3,1,1,4,4,10,-6,4
AEK Athens,3508,1,4,2,0,7,1,6,14
PAOK Salonik,3508,2,2,3,1,10,5,5,9
P'thinaikos,3508,3,1,2,3,5,10,-5,5
Panionios,3508,4,1,1,4,4,10,-6,4
AEK Athens,3509,1,4,2,0,7,1,6,14
PAOK Salonik,3509,2,3,2,1,11,4,7,11
Panionios,3509,3,1,1,4,4,10,-6,4
P'thinaikos,3509,4,1,1,4,4,11,-7,4
AEK Athens,3510,1,4,2,0,7,1,6,14
PAOK Salonik,3510,2,2,3,1,10,5,5,9
P'thinaikos,3510,3,1,2,3,5,10,-5,5
Panionios,3510,4,1,1,4,4,10,-6,4
AEK Athens,3511,1,4,2,0,7,1,6,14
PAOK Salonik,3511,2,3,2,1,11,5,6,11
P'thinaikos,3511,3,1,1,4,5,11,-6,4
Panionios,3511,4,1,1,4,4,10,-6,4
AEK Athens,3512,1,4,2,0,7,1,6,14
PAOK Salonik,3512,2,3,2,1,10,4,6,11
P'thinaikos,3512,3,1,1,4,4,10,-6,4
Panionios,3512,3,1,1,4,4,10,-6,4
AEK Athens,3513,1,4,2,0,7,1,6,14
PAOK Salonik,3513,2,3,2,1,12,6,6,11
P'thinaikos,3513,3,1,1,4,6,12,-6,4
Panionios,3513,4,1,1,4,4,10,-6,4
AEK Athens,3514,1,4,2,0,7,1,6,14
PAOK Salonik,3514,2,2,2,2,10,7,3,8
P'thinaikos,3514,3,2,1,3,7,10,-3,7
Panionios,3514,4,1,1,4,4,10,-6,4
AEK Athens,3515,1,4,2,0,7,1,6,14
PAOK Salonik,3515,2,2,3,1,9,4,5,9
P'thinaikos,3515,3,1,2,3,4,9,-5,5
Panionios,3515,4,1,1,4,4,10,-6,4
AEK Athens,3516,1,4,2,0,7,1,6,14
PAOK Salonik,3516,2,3,2,1,11,5,6,11
P'thinaikos,3516,3,1,1,4,5,11,-6,4
Panionios,3516,4,1,1,4,4,10,-6,4
AEK Athens,3517,1,4,2,0,7,1,6,14
PAOK Salonik,3517,2,2,2,2,9,6,3,8
P'thinaikos,3517,3,2,1,3,6,9,-3,7
Panionios,3517,4,1,1,4,4,10,-6,4
AEK Athens,3518,1,4,2,0,7,1,6,14
PAOK Salonik,3518,2,3,2,1,10,4,6,11
P'thinaikos,3518,3,1,1,4,4,10,-6,4
Panionios,3518,3,1,1,4,4,10,-6,4
AEK Athens,3519,1,4,2,0,7,1,6,14
PAOK Salonik,3519,2,2,3,1,10,5,5,9
P'thinaikos,3519,3,1,2,3,5,10,-5,5
Panionios,3519,4,1,1,4,4,10,-6,4
AEK Athens,3520,1,4,2,0,7,1,6,14
PAOK Salonik,3520,2,2,3,1,12,7,5,9
P'thinaikos,3520,3,1,2,3,7,12,-5,5
Panionios,3520,4,1,1,4,4,10,-6,4
AEK Athens,3521,1,4,2,0,7,1,6,14
PAOK Salonik,3521,2,2,2,2,10,6,4,8
P'thinaikos,3521,3,2,1,3,6,10,-4,7
Panionios,3521,4,1,1,4,4,10,-6,4
AEK Athens,3522,1,4,2,0,7,1,6,14
PAOK Salonik,3522,2,3,2,1,15,4,11,11
Panionios,3522,3,1,1,4,4,10,-6,4
P'thinaikos,3522,4,1,1,4,4,15,-11,4
AEK Athens,3523,1,4,2,0,7,1,6,14
PAOK Salonik,3523,2,2,2,2,10,6,4,8
P'thinaikos,3523,3,2,1,3,6,10,-4,7
Panionios,3523,4,1,1,4,4,10,-6,4
AEK Athens,3524,1,4,2,0,7,1,6,14
PAOK Salonik,3524,2,3,2,1,11,5,6,11
P'thinaikos,3524,3,1,1,4,5,11,-6,4
Panionios,3524,4,1,1,4,4,10,-6,4
AEK Athens,3525,1,4,2,0,7,1,6,14
PAOK Salonik,3525,2,2,2,2,9,5,4,8
P'thinaikos,3525,3,2,1,3,5,9,-4,7
Panionios,3525,4,1,1,4,4,10,-6,4
AEK Athens,3526,1,4,2,0,7,1,6,14
PAOK Salonik,3526,2,2,2,2,9,8,1,8
P'thinaikos,3526,3,2,1,3,8,9,-1,7
Panionios,3526,4,1,1,4,4,10,-6,4
AEK Athens,3527,1,4,2,0,7,1,6,14
PAOK Salonik,3527,2,2,2,2,10,7,3,8
P'thinaikos,3527,3,2,1,3,7,10,-3,7
Panionios,3527,4,1,1,4,4,10,-6,4
AEK Athens,3528,1,4,2,0,7,1,6,14
PAOK Salonik,3528,2,2,2,2,10,7,3,8
P'thinaikos,3528,3,2,1,3,7,10,-3,7
Panionios,3528,4,1,1,4,4,10,-6,4
AEK Athens,3529,1,4,2,0,7,1,6,14
PAOK Salonik,3529,2,3,2,1,10,4,6,11
P'thinaikos,3529,3,1,1,4,4,10,-6,4
Panionios,3529,3,1,1,4,4,10,-6,4
AEK Athens,3530,1,4,2,0,7,1,6,14
PAOK Salonik,3530,2,2,2,2,10,6,4,8
P'thinaikos,3530,3,2,1,3,6,10,-4,7
Panionios,3530,4,1,1,4,4,10,-6,4
AEK Athens,3531,1,4,2,0,7,1,6,14
PAOK Salonik,3531,2,2,2,2,10,6,4,8
P'thinaikos,3531,3,2,1,3,6,10,-4,7
Panionios,3531,4,1,1,4,4,10,-6,4
AEK Athens,3532,1,4,2,0,7,1,6,14
PAOK Salonik,3532,2,2,2,2,10,6,4,8
P'thinaikos,3532,3,2,1,3,6,10,-4,7
Panionios,3532,4,1,1,4,4,10,-6,4
AEK Athens,3533,1,4,2,0,7,1,6,14
PAOK Salonik,3533,2,2,3,1,10,5,5,9
P'thinaikos,3533,3,1,2,3,5,10,-5,5
Panionios,3533,4,1,1,4,4,10,-6,4
AEK Athens,3534,1,4,2,0,7,1,6,14
PAOK Salonik,3534,2,3,2,1,11,5,6,11
P'thinaikos,3534,3,1,1,4,5,11,-6,4
Panionios,3534,4,1,1,4,4,10,-6,4
AEK Athens,3535,1,4,2,0,7,1,6,14
PAOK Salonik,3535,2,2,2,2,9,7,2,8
P'thinaikos,3535,3,2,1,3,7,9,-2,7
Panionios,3535,4,1,1,4,4,10,-6,4
AEK Athens,3536,1,4,2,0,7,1,6,14
PAOK Salonik,3536,2,2,3,1,10,5,5,9
P'thinaikos,3536,3,1,2,3,5,10,-5,5
Panionios,3536,4,1,1,4,4,10,-6,4
AEK Athens,3537,1,4,2,0,7,1,6,14
PAOK Salonik,3537,2,2,2,2,9,5,4,8
P'thinaikos,3537,3,2,1,3,5,9,-4,7
Panionios,3537,4,1,1,4,4,10,-6,4
AEK Athens,3538,1,4,2,0,7,1,6,14
PAOK Salonik,3538,2,2,3,1,9,4,5,9
P'thinaikos,3538,3,1,2,3,4,9,-5,5
Panionios,3538,4,1,1,4,4,10,-6,4
AEK Athens,3539,1,4,2,0,7,1,6,14
PAOK Salonik,3539,2,3,2,1,10,4,6,11
P'thinaikos,3539,3,1,1,4,4,10,-6,4
Panionios,3539,3,1,1,4,4,10,-6,4
AEK Athens,3540,1,4,2,0,7,1,6,14
PAOK Salonik,3540,2,3,2,1,11,5,6,11
P'thinaikos,3540,3,1,1,4,5,11,-6,4
Panionios,3540,4,1,1,4,4,10,-6,4
AEK Athens,3541,1,4,2,0,7,1,6,14
PAOK Salonik,3541,2,2,2,2,11,9,2,8
P'thinaikos,3541,3,2,1,3,9,11,-2,7
Panionios,3541,4,1,1,4,4,10,-6,4
AEK Athens,3542,1,4,2,0,7,1,6,14
PAOK Salonik,3542,2,3,2,1,11,5,6,11
P'thinaikos,3542,3,1,1,4,5,11,-6,4
Panionios,3542,4,1,1,4,4,10,-6,4
AEK Athens,3543,1,4,2,0,7,1,6,14
PAOK Salonik,3543,2,3,2,1,10,4,6,11
P'thinaikos,3543,3,1,1,4,4,10,-6,4
Panionios,3543,3,1,1,4,4,10,-6,4
AEK Athens,3544,1,4,2,0,7,1,6,14
PAOK Salonik,3544,2,3,2,1,11,5,6,11
P'thinaikos,3544,3,1,1,4,5,11,-6,4
Panionios,3544,4,1,1,4,4,10,-6,4
AEK Athens,3545,1,4,2,0,7,1,6,14
PAOK Salonik,3545,2,3,2,1,11,4,7,11
Panionios,3545,3,1,1,4,4,10,-6,4
P'thinaikos,3545,4,1,1,4,4,11,-7,4
AEK Athens,3546,1,4,2,0,7,1,6,14
PAOK Salonik,3546,2,3,2,1,12,5,7,11
Panionios,3546,3,1,1,4,4,10,-6,4
P'thinaikos,3546,4,1,1,4,5,12,-7,4
AEK Athens,3547,1,4,2,0,7,1,6,14
PAOK Salonik,3547,2,3,2,1,10,4,6,11
P'thinaikos,3547,3,1,1,4,4,10,-6,4
Panionios,3547,3,1,1,4,4,10,-6,4
AEK Athens,3548,1,4,2,0,7,1,6,14
PAOK Salonik,3548,2,3,2,1,11,5,6,11
P'thinaikos,3548,3,1,1,4,5,11,-6,4
Panionios,3548,4,1,1,4,4,10,-6,4
AEK Athens,3549,1,4,2,0,7,1,6,14
PAOK Salonik,3549,2,2,2,2,11,8,3,8
P'thinaikos,3549,3,2,1,3,8,11,-3,7
Panionios,3549,4,1,1,4,4,10,-6,4
AEK Athens,3550,1,4,2,0,7,1,6,14
PAOK Salonik,3550,2,2,3,1,9,4,5,9
P'thinaikos,3550,3,1,2,3,4,9,-5,5
Panionios,3550,4,1,1,4,4,10,-6,4
AEK Athens,3551,1,4,2,0,7,1,6,14
PAOK Salonik,3551,2,2,3,1,11,6,5,9
P'thinaikos,3551,3,1,2,3,6,11,-5,5
Panionios,3551,4,1,1,4,4,10,-6,4
AEK Athens,3552,1,4,2,0,7,1,6,14
PAOK Salonik,3552,2,3,2,1,11,4,7,11
Panionios,3552,3,1,1,4,4,10,-6,4
P'thinaikos,3552,4,1,1,4,4,11,-7,4
AEK Athens,3553,1,4,2,0,7,1,6,14
PAOK Salonik,3553,2,2,3,1,10,5,5,9
P'thinaikos,3553,3,1,2,3,5,10,-5,5
Panionios,3553,4,1,1,4,4,10,-6,4
AEK Athens,3554,1,4,2,0,7,1,6,14
PAOK Salonik,3554,2,3,2,1,11,5,6,11
P'thinaikos,3554,3,1,1,4,5,11,-6,4
Panionios,3554,4,1,1,4,4,10,-6,4
AEK Athens,3555,1,4,2,0,7,1,6,14
PAOK Salonik,3555,2,2,3,1,10,5,5,9
P'thinaikos,3555,3,1,2,3,5,10,-5,5
Panionios,3555,4,1,1,4,4,10,-6,4
AEK Athens,3556,1,4,2,0,7,1,6,14
PAOK Salonik,3556,2,2,3,1,9,4,5,9
P'thinaikos,3556,3,1,2,3,4,9,-5,5
Panionios,3556,4,1,1,4,4,10,-6,4
AEK Athens,3557,1,4,2,0,7,1,6,14
PAOK Salonik,3557,2,2,2,2,10,6,4,8
P'thinaikos,3557,3,2,1,3,6,10,-4,7
Panionios,3557,4,1,1,4,4,10,-6,4
AEK Athens,3558,1,4,2,0,7,1,6,14
PAOK Salonik,3558,2,3,2,1,10,4,6,11
P'thinaikos,3558,3,1,1,4,4,10,-6,4
Panionios,3558,3,1,1,4,4,10,-6,4
AEK Athens,3559,1,4,2,0,7,1,6,14
PAOK Salonik,3559,2,2,3,1,11,6,5,9
P'thinaikos,3559,3,1,2,3,6,11,-5,5
Panionios,3559,4,1,1,4,4,10,-6,4
AEK Athens,3560,1,4,2,0,7,1,6,14
PAOK Salonik,3560,2,2,3,1,9,4,5,9
P'thinaikos,3560,3,1,2,3,4,9,-5,5
Panionios,3560,4,1,1,4,4,10,-6,4
AEK Athens,3561,1,4,2,0,7,1,6,14
PAOK Salonik,3561,2,3,2,1,11,4,7,11
Panionios,3561,3,1,1,4,4,10,-6,4
P'thinaikos,3561,4,1,1,4,4,11,-7,4
AEK Athens,3562,1,4,2,0,7,1,6,14
PAOK Salonik,3562,2,2,2,2,9,6,3,8
P'thinaikos,3562,3,2,1,3,6,9,-3,7
Panionios,3562,4,1,1,4,4,10,-6,4
AEK Athens,3563,1,4,2,0,7,1,6,14
PAOK Salonik,3563,2,2,2,2,9,5,4,8
P'thinaikos,3563,3,2,1,3,5,9,-4,7
Panionios,3563,4,1,1,4,4,10,-6,4
AEK Athens,3564,1,4,2,0,7,1,6,14
PAOK Salonik,3564,2,3,2,1,10,4,6,11
P'thinaikos,3564,3,1,1,4,4,10,-6,4
Panionios,3564,3,1,1,4,4,10,-6,4
AEK Athens,3565,1,4,2,0,7,1,6,14
PAOK Salonik,3565,2,3,2,1,11,5,6,11
P'thinaikos,3565,3,1,1,4,5,11,-6,4
Panionios,3565,4,1,1,4,4,10,-6,4
AEK Athens,3566,1,4,2,0,7,1,6,14
PAOK Salonik,3566,2,2,2,2,10,7,3,8
P'thinaikos,3566,3,2,1,3,7,10,-3,7
Panionios,3566,4,1,1,4,4,10,-6,4
AEK Athens,3567,1,4,2,0,7,1,6,14
PAOK Salonik,3567,2,2,3,1,12,7,5,9
P'thinaikos,3567,3,1,2,3,7,12,-5,5
Panionios,3567,4,1,1,4,4,10,-6,4
AEK Athens,3568,1,4,2,0,7,1,6,14
PAOK Salonik,3568,2,2,2,2,9,6,3,8
P'thinaikos,3568,3,2,1,3,6,9,-3,7
Panionios,3568,4,1,1,4,4,10,-6,4
AEK Athens,3569,1,4,2,0,7,1,6,14
PAOK Salonik,3569,2,2,2,2,10,7,3,8
P'thinaikos,3569,3,2,1,3,7,10,-3,7
Panionios,3569,4,1,1,4,4,10,-6,4
AEK Athens,3570,1,4,2,0,7,1,6,14
PAOK Salonik,3570,2,3,2,1,11,4,7,11
Panionios,3570,3,1,1,4,4,10,-6,4
P'thinaikos,3570,4,1,1,4,4,11,-7,4
AEK Athens,3571,1,4,2,0,7,1,6,14
PAOK Salonik,3571,2,2,3,1,9,4,5,9
P'thinaikos,3571,3,1,2,3,4,9,-5,5
Panionios,3571,4,1,1,4,4,10,-6,4
AEK Athens,3572,1,4,2,0,7,1,6,14
PAOK Salonik,3572,2,2,3,1,11,6,5,9
P'thinaikos,3572,3,1,2,3,6,11,-5,5
Panionios,3572,4,1,1,4,4,10,-6,4
AEK Athens,3573,1,4,2,0,7,1,6,14
PAOK Salonik,3573,2,2,2,2,9,6,3,8
P'thinaikos,3573,3,2,1,3,6,9,-3,7
Panionios,3573,4,1,1,4,4,10,-6,4
AEK Athens,3574,1,4,2,0,7,1,6,14
PAOK Salonik,3574,2,2,2,2,10,8,2,8
P'thinaikos,3574,3,2,1,3,8,10,-2,7
Panionios,3574,4,1,1,4,4,10,-6,4
AEK Athens,3575,1,4,2,0,7,1,6,14
PAOK Salonik,3575,2,2,2,2,9,6,3,8
P'thinaikos,3575,3,2,1,3,6,9,-3,7
Panionios,3575,4,1,1,4,4,10,-6,4
AEK Athens,3576,1,4,2,0,7,1,6,14
PAOK Salonik,3576,2,2,2,2,9,5,4,8
P'thinaikos,3576,3,2,1,3,5,9,-4,7
Panionios,3576,4,1,1,4,4,10,-6,4
AEK Athens,3577,1,4,2,0,7,1,6,14
PAOK Salonik,3577,2,2,2,2,9,6,3,8
P'thinaikos,3577,3,2,1,3,6,9,-3,7
Panionios,3577,4,1,1,4,4,10,-6,4
AEK Athens,3578,1,4,2,0,7,1,6,14
PAOK Salonik,3578,2,2,2,2,9,6,3,8
P'thinaikos,3578,3,2,1,3,6,9,-3,7
Panionios,3578,4,1,1,4,4,10,-6,4
AEK Athens,3579,1,4,2,0,7,1,6,14
PAOK Salonik,3579,2,3,2,1,11,5,6,11
P'thinaikos,3579,3,1,1,4,5,11,-6,4
Panionios,3579,4,1,1,4,4,10,-6,4
AEK Athens,3580,1,4,2,0,7,1,6,14
PAOK Salonik,3580,2,3,2,1,12,6,6,11
P'thinaikos,3580,3,1,1,4,6,12,-6,4
Panionios,3580,4,1,1,4,4,10,-6,4
AEK Athens,3581,1,4,2,0,7,1,6,14
PAOK Salonik,3581,2,2,2,2,9,6,3,8
P'thinaikos,3581,3,2,1,3,6,9,-3,7
Panionios,3581,4,1,1,4,4,10,-6,4
AEK Athens,3582,1,4,2,0,7,1,6,14
PAOK Salonik,3582,2,3,2,1,11,5,6,11
P'thinaikos,3582,3,1,1,4,5,11,-6,4
Panionios,3582,4,1,1,4,4,10,-6,4
AEK Athens,3583,1,4,2,0,7,1,6,14
PAOK Salonik,3583,2,3,2,1,10,4,6,11
P'thinaikos,3583,3,1,1,4,4,10,-6,4
Panionios,3583,3,1,1,4,4,10,-6,4
AEK Athens,3584,1,4,2,0,7,1,6,14
PAOK Salonik,3584,2,3,2,1,10,4,6,11
P'thinaikos,3584,3,1,1,4,4,10,-6,4
Panionios,3584,3,1,1,4,4,10,-6,4
AEK Athens,3585,1,4,2,0,7,1,6,14
PAOK Salonik,3585,2,2,3,1,9,4,5,9
P'thinaikos,3585,3,1,2,3,4,9,-5,5
Panionios,3585,4,1,1,4,4,10,-6,4
AEK Athens,3586,1,4,2,0,7,1,6,14
PAOK Salonik,3586,2,2,2,2,11,7,4,8
P'thinaikos,3586,3,2,1,3,7,11,-4,7
Panionios,3586,4,1,1,4,4,10,-6,4
AEK Athens,3587,1,4,2,0,7,1,6,14
PAOK Salonik,3587,2,3,2,1,10,4,6,11
P'thinaikos,3587,3,1,1,4,4,10,-6,4
Panionios,3587,3,1,1,4,4,10,-6,4
AEK Athens,3588,1,4,2,0,7,1,6,14
PAOK Salonik,3588,2,2,3,1,10,5,5,9
P'thinaikos,3588,3,1,2,3,5,10,-5,5
Panionios,3588,4,1,1,4,4,10,-6,4
AEK Athens,3589,1,4,2,0,7,1,6,14
PAOK Salonik,3589,2,2,2,2,9,5,4,8
P'thinaikos,3589,3,2,1,3,5,9,-4,7
Panionios,3589,4,1,1,4,4,10,-6,4
AEK Athens,3590,1,4,2,0,7,1,6,14
PAOK Salonik,3590,2,2,3,1,9,4,5,9
P'thinaikos,3590,3,1,2,3,4,9,-5,5
Panionios,3590,4,1,1,4,4,10,-6,4
AEK Athens,3591,1,4,2,0,7,1,6,14
PAOK Salonik,3591,2,2,2,2,12,8,4,8
P'thinaikos,3591,3,2,1,3,8,12,-4,7
Panionios,3591,4,1,1,4,4,10,-6,4
AEK Athens,3592,1,4,2,0,7,1,6,14
PAOK Salonik,3592,2,2,3,1,11,6,5,9
P'thinaikos,3592,3,1,2,3,6,11,-5,5
Panionios,3592,4,1,1,4,4,10,-6,4
AEK Athens,3593,1,4,2,0,7,1,6,14
PAOK Salonik,3593,2,2,2,2,9,5,4,8
P'thinaikos,3593,3,2,1,3,5,9,-4,7
Panionios,3593,4,1,1,4,4,10,-6,4
AEK Athens,3594,1,4,2,0,7,1,6,14
PAOK Salonik,3594,2,2,3,1,10,5,5,9
P'thinaikos,3594,3,1,2,3,5,10,-5,5
Panionios,3594,4,1,1,4,4,10,-6,4
AEK Athens,3595,1,4,2,0,7,1,6,14
PAOK Salonik,3595,2,2,2,2,9,6,3,8
P'thinaikos,3595,3,2,1,3,6,9,-3,7
Panionios,3595,4,1,1,4,4,10,-6,4
AEK Athens,3596,1,4,2,0,7,1,6,14
PAOK Salonik,3596,2,3,2,1,12,5,7,11
Panionios,3596,3,1,1,4,4,10,-6,4
P'thinaikos,3596,4,1,1,4,5,12,-7,4
AEK Athens,3597,1,4,2,0,7,1,6,14
PAOK Salonik,3597,2,3,2,1,13,5,8,11
Panionios,3597,3,1,1,4,4,10,-6,4
P'thinaikos,3597,4,1,1,4,5,13,-8,4
AEK Athens,3598,1,4,2,0,7,1,6,14
PAOK Salonik,3598,2,3,2,1,11,5,6,11
P'thinaikos,3598,3,1,1,4,5,11,-6,4
Panionios,3598,4,1,1,4,4,10,-6,4
AEK Athens,3599,1,4,2,0,7,1,6,14
PAOK Salonik,3599,2,2,3,1,10,5,5,9
P'thinaikos,3599,3,1,2,3,5,10,-5,5
Panionios,3599,4,1,1,4,4,10,-6,4
AEK Athens,3600,1,4,2,0,7,1,6,14
PAOK Salonik,3600,2,2,3,1,11,6,5,9
P'thinaikos,3600,3,1,2,3,6,11,-5,5
Panionios,3600,4,1,1,4,4,10,-6,4
AEK Athens,3601,1,4,2,0,7,1,6,14
PAOK Salonik,3601,2,2,2,2,10,8,2,8
P'thinaikos,3601,3,2,1,3,8,10,-2,7
Panionios,3601,4,1,1,4,4,10,-6,4
AEK Athens,3602,1,4,2,0,7,1,6,14
PAOK Salonik,3602,2,2,3,1,10,5,5,9
P'thinaikos,3602,3,1,2,3,5,10,-5,5
Panionios,3602,4,1,1,4,4,10,-6,4
AEK Athens,3603,1,4,2,0,7,1,6,14
PAOK Salonik,3603,2,2,3,1,9,4,5,9
P'thinaikos,3603,3,1,2,3,4,9,-5,5
Panionios,3603,4,1,1,4,4,10,-6,4
AEK Athens,3604,1,4,2,0,7,1,6,14
PAOK Salonik,3604,2,2,3,1,9,4,5,9
P'thinaikos,3604,3,1,2,3,4,9,-5,5
Panionios,3604,4,1,1,4,4,10,-6,4
AEK Athens,3605,1,4,2,0,7,1,6,14
PAOK Salonik,3605,2,2,2,2,10,7,3,8
P'thinaikos,3605,3,2,1,3,7,10,-3,7
Panionios,3605,4,1,1,4,4,10,-6,4
AEK Athens,3606,1,4,2,0,7,1,6,14
PAOK Salonik,3606,2,2,2,2,9,5,4,8
P'thinaikos,3606,3,2,1,3,5,9,-4,7
Panionios,3606,4,1,1,4,4,10,-6,4
AEK Athens,3607,1,4,2,0,7,1,6,14
PAOK Salonik,3607,2,3,2,1,11,5,6,11
P'thinaikos,3607,3,1,1,4,5,11,-6,4
Panionios,3607,4,1,1,4,4,10,-6,4
AEK Athens,3608,1,4,2,0,7,1,6,14
PAOK Salonik,3608,2,2,2,2,9,5,4,8
P'thinaikos,3608,3,2,1,3,5,9,-4,7
Panionios,3608,4,1,1,4,4,10,-6,4
AEK Athens,3609,1,4,2,0,7,1,6,14
PAOK Salonik,3609,2,2,3,1,10,5,5,9
P'thinaikos,3609,3,1,2,3,5,10,-5,5
Panionios,3609,4,1,1,4,4,10,-6,4
AEK Athens,3610,1,4,2,0,7,1,6,14
PAOK Salonik,3610,2,3,2,1,12,5,7,11
Panionios,3610,3,1,1,4,4,10,-6,4
P'thinaikos,3610,4,1,1,4,5,12,-7,4
AEK Athens,3611,1,4,2,0,7,1,6,14
PAOK Salonik,3611,2,3,2,1,12,6,6,11
P'thinaikos,3611,3,1,1,4,6,12,-6,4
Panionios,3611,4,1,1,4,4,10,-6,4
AEK Athens,3612,1,4,2,0,7,1,6,14
PAOK Salonik,3612,2,2,3,1,10,5,5,9
P'thinaikos,3612,3,1,2,3,5,10,-5,5
Panionios,3612,4,1,1,4,4,10,-6,4
AEK Athens,3613,1,4,2,0,7,1,6,14
PAOK Salonik,3613,2,3,2,1,10,4,6,11
P'thinaikos,3613,3,1,1,4,4,10,-6,4
Panionios,3613,3,1,1,4,4,10,-6,4
AEK Athens,3614,1,4,2,0,7,1,6,14
PAOK Salonik,3614,2,2,2,2,10,6,4,8
P'thinaikos,3614,3,2,1,3,6,10,-4,7
Panionios,3614,4,1,1,4,4,10,-6,4
AEK Athens,3615,1,4,2,0,7,1,6,14
PAOK Salonik,3615,2,2,2,2,10,6,4,8
P'thinaikos,3615,3,2,1,3,6,10,-4,7
Panionios,3615,4,1,1,4,4,10,-6,4
AEK Athens,3616,1,4,2,0,7,1,6,14
PAOK Salonik,3616,2,3,2,1,11,4,7,11
Panionios,3616,3,1,1,4,4,10,-6,4
P'thinaikos,3616,4,1,1,4,4,11,-7,4
AEK Athens,3617,1,4,2,0,7,1,6,14
PAOK Salonik,3617,2,2,2,2,9,5,4,8
P'thinaikos,3617,3,2,1,3,5,9,-4,7
Panionios,3617,4,1,1,4,4,10,-6,4
AEK Athens,3618,1,4,2,0,7,1,6,14
PAOK Salonik,3618,2,2,2,2,9,7,2,8
P'thinaikos,3618,3,2,1,3,7,9,-2,7
Panionios,3618,4,1,1,4,4,10,-6,4
AEK Athens,3619,1,4,2,0,7,1,6,14
PAOK Salonik,3619,2,2,3,1,10,5,5,9
P'thinaikos,3619,3,1,2,3,5,10,-5,5
Panionios,3619,4,1,1,4,4,10,-6,4
AEK Athens,3620,1,4,2,0,7,1,6,14
PAOK Salonik,3620,2,2,3,1,9,4,5,9
P'thinaikos,3620,3,1,2,3,4,9,-5,5
Panionios,3620,4,1,1,4,4,10,-6,4
AEK Athens,3621,1,4,2,0,7,1,6,14
PAOK Salonik,3621,2,2,2,2,9,7,2,8
P'thinaikos,3621,3,2,1,3,7,9,-2,7
Panionios,3621,4,1,1,4,4,10,-6,4
AEK Athens,3622,1,4,2,0,7,1,6,14
PAOK Salonik,3622,2,2,3,1,9,4,5,9
P'thinaikos,3622,3,1,2,3,4,9,-5,5
Panionios,3622,4,1,1,4,4,10,-6,4
AEK Athens,3623,1,4,2,0,7,1,6,14
PAOK Salonik,3623,2,2,3,1,10,5,5,9
P'thinaikos,3623,3,1,2,3,5,10,-5,5
Panionios,3623,4,1,1,4,4,10,-6,4
AEK Athens,3624,1,4,2,0,7,1,6,14
PAOK Salonik,3624,2,3,2,1,10,4,6,11
P'thinaikos,3624,3,1,1,4,4,10,-6,4
Panionios,3624,3,1,1,4,4,10,-6,4
AEK Athens,3625,1,4,2,0,7,1,6,14
PAOK Salonik,3625,2,3,2,1,10,4,6,11
P'thinaikos,3625,3,1,1,4,4,10,-6,4
Panionios,3625,3,1,1,4,4,10,-6,4
AEK Athens,3626,1,4,2,0,7,1,6,14
PAOK Salonik,3626,2,2,3,1,10,5,5,9
P'thinaikos,3626,3,1,2,3,5,10,-5,5
Panionios,3626,4,1,1,4,4,10,-6,4
AEK Athens,3627,1,4,2,0,7,1,6,14
PAOK Salonik,3627,2,3,2,1,11,5,6,11
P'thinaikos,3627,3,1,1,4,5,11,-6,4
Panionios,3627,4,1,1,4,4,10,-6,4
AEK Athens,3628,1,4,2,0,7,1,6,14
PAOK Salonik,3628,2,3,2,1,11,5,6,11
P'thinaikos,3628,3,1,1,4,5,11,-6,4
Panionios,3628,4,1,1,4,4,10,-6,4
AEK Athens,3629,1,4,2,0,7,1,6,14
PAOK Salonik,3629,2,2,2,2,10,8,2,8
P'thinaikos,3629,3,2,1,3,8,10,-2,7
Panionios,3629,4,1,1,4,4,10,-6,4
AEK Athens,3630,1,4,2,0,7,1,6,14
PAOK Salonik,3630,2,2,3,1,11,6,5,9
P'thinaikos,3630,3,1,2,3,6,11,-5,5
Panionios,3630,4,1,1,4,4,10,-6,4
AEK Athens,3631,1,4,2,0,7,1,6,14
PAOK Salonik,3631,2,2,3,1,9,4,5,9
P'thinaikos,3631,3,1,2,3,4,9,-5,5
Panionios,3631,4,1,1,4,4,10,-6,4
AEK Athens,3632,1,4,2,0,7,1,6,14
PAOK Salonik,3632,2,2,2,2,9,7,2,8
P'thinaikos,3632,3,2,1,3,7,9,-2,7
Panionios,3632,4,1,1,4,4,10,-6,4
AEK Athens,3633,1,4,2,0,7,1,6,14
PAOK Salonik,3633,2,2,2,2,9,5,4,8
P'thinaikos,3633,3,2,1,3,5,9,-4,7
Panionios,3633,4,1,1,4,4,10,-6,4
AEK Athens,3634,1,4,2,0,7,1,6,14
PAOK Salonik,3634,2,2,2,2,9,5,4,8
P'thinaikos,3634,3,2,1,3,5,9,-4,7
Panionios,3634,4,1,1,4,4,10,-6,4
AEK Athens,3635,1,4,2,0,7,1,6,14
PAOK Salonik,3635,2,3,2,1,10,4,6,11
P'thinaikos,3635,3,1,1,4,4,10,-6,4
Panionios,3635,3,1,1,4,4,10,-6,4
AEK Athens,3636,1,4,2,0,7,1,6,14
PAOK Salonik,3636,2,2,2,2,9,7,2,8
P'thinaikos,3636,3,2,1,3,7,9,-2,7
Panionios,3636,4,1,1,4,4,10,-6,4
AEK Athens,3637,1,4,2,0,7,1,6,14
PAOK Salonik,3637,2,2,3,1,10,5,5,9
P'thinaikos,3637,3,1,2,3,5,10,-5,5
Panionios,3637,4,1,1,4,4,10,-6,4
AEK Athens,3638,1,4,2,0,7,1,6,14
PAOK Salonik,3638,2,2,2,2,10,7,3,8
P'thinaikos,3638,3,2,1,3,7,10,-3,7
Panionios,3638,4,1,1,4,4,10,-6,4
AEK Athens,3639,1,4,2,0,7,1,6,14
PAOK Salonik,3639,2,2,3,1,10,5,5,9
P'thinaikos,3639,3,1,2,3,5,10,-5,5
Panionios,3639,4,1,1,4,4,10,-6,4
AEK Athens,3640,1,4,2,0,7,1,6,14
PAOK Salonik,3640,2,2,2,2,9,6,3,8
P'thinaikos,3640,3,2,1,3,6,9,-3,7
Panionios,3640,4,1,1,4,4,10,-6,4
AEK Athens,3641,1,4,2,0,7,1,6,14
PAOK Salonik,3641,2,2,2,2,10,6,4,8
P'thinaikos,3641,3,2,1,3,6,10,-4,7
Panionios,3641,4,1,1,4,4,10,-6,4
AEK Athens,3642,1,4,2,0,7,1,6,14
PAOK Salonik,3642,2,3,2,1,11,5,6,11
P'thinaikos,3642,3,1,1,4,5,11,-6,4
Panionios,3642,4,1,1,4,4,10,-6,4
AEK Athens,3643,1,4,2,0,7,1,6,14
PAOK Salonik,3643,2,2,2,2,9,5,4,8
P'thinaikos,3643,3,2,1,3,5,9,-4,7
Panionios,3643,4,1,1,4,4,10,-6,4
AEK Athens,3644,1,4,2,0,7,1,6,14
PAOK Salonik,3644,2,2,2,2,9,7,2,8
P'thinaikos,3644,3,2,1,3,7,9,-2,7
Panionios,3644,4,1,1,4,4,10,-6,4
AEK Athens,3645,1,4,2,0,7,1,6,14
PAOK Salonik,3645,2,2,2,2,9,5,4,8
P'thinaikos,3645,3,2,1,3,5,9,-4,7
Panionios,3645,4,1,1,4,4,10,-6,4
AEK Athens,3646,1,4,2,0,7,1,6,14
PAOK Salonik,3646,2,3,2,1,10,4,6,11
P'thinaikos,3646,3,1,1,4,4,10,-6,4
Panionios,3646,3,1,1,4,4,10,-6,4
AEK Athens,3647,1,4,2,0,7,1,6,14
PAOK Salonik,3647,2,3,2,1,10,4,6,11
P'thinaikos,3647,3,1,1,4,4,10,-6,4
Panionios,3647,3,1,1,4,4,10,-6,4
AEK Athens,3648,1,4,2,0,7,1,6,14
PAOK Salonik,3648,2,3,2,1,10,4,6,11
P'thinaikos,3648,3,1,1,4,4,10,-6,4
Panionios,3648,3,1,1,4,4,10,-6,4
AEK Athens,3649,1,4,2,0,7,1,6,14
PAOK Salonik,3649,2,2,2,2,11,7,4,8
P'thinaikos,3649,3,2,1,3,7,11,-4,7
Panionios,3649,4,1,1,4,4,10,-6,4
AEK Athens,3650,1,4,2,0,7,1,6,14
PAOK Salonik,3650,2,2,2,2,9,7,2,8
P'thinaikos,3650,3,2,1,3,7,9,-2,7
Panionios,3650,4,1,1,4,4,10,-6,4
AEK Athens,3651,1,4,2,0,7,1,6,14
PAOK Salonik,3651,2,2,3,1,10,5,5,9
P'thinaikos,3651,3,1,2,3,5,10,-5,5
Panionios,3651,4,1,1,4,4,10,-6,4
AEK Athens,3652,1,4,2,0,7,1,6,14
PAOK Salonik,3652,2,3,2,1,10,4,6,11
P'thinaikos,3652,3,1,1,4,4,10,-6,4
Panionios,3652,3,1,1,4,4,10,-6,4
AEK Athens,3653,1,4,2,0,7,1,6,14
PAOK Salonik,3653,2,3,2,1,10,4,6,11
P'thinaikos,3653,3,1,1,4,4,10,-6,4
Panionios,3653,3,1,1,4,4,10,-6,4
AEK Athens,3654,1,4,2,0,7,1,6,14
PAOK Salonik,3654,2,2,3,1,10,5,5,9
P'thinaikos,3654,3,1,2,3,5,10,-5,5
Panionios,3654,4,1,1,4,4,10,-6,4
AEK Athens,3655,1,4,2,0,7,1,6,14
PAOK Salonik,3655,2,2,2,2,9,6,3,8
P'thinaikos,3655,3,2,1,3,6,9,-3,7
Panionios,3655,4,1,1,4,4,10,-6,4
AEK Athens,3656,1,4,2,0,7,1,6,14
PAOK Salonik,3656,2,2,3,1,9,4,5,9
P'thinaikos,3656,3,1,2,3,4,9,-5,5
Panionios,3656,4,1,1,4,4,10,-6,4
AEK Athens,3657,1,4,2,0,7,1,6,14
PAOK Salonik,3657,2,2,2,2,9,8,1,8
P'thinaikos,3657,3,2,1,3,8,9,-1,7
Panionios,3657,4,1,1,4,4,10,-6,4
AEK Athens,3658,1,4,2,0,7,1,6,14
PAOK Salonik,3658,2,2,3,1,10,5,5,9
P'thinaikos,3658,3,1,2,3,5,10,-5,5
Panionios,3658,4,1,1,4,4,10,-6,4
AEK Athens,3659,1,4,2,0,7,1,6,14
PAOK Salonik,3659,2,2,2,2,10,8,2,8
P'thinaikos,3659,3,2,1,3,8,10,-2,7
Panionios,3659,4,1,1,4,4,10,-6,4
AEK Athens,3660,1,4,2,0,7,1,6,14
PAOK Salonik,3660,2,2,2,2,9,7,2,8
P'thinaikos,3660,3,2,1,3,7,9,-2,7
Panionios,3660,4,1,1,4,4,10,-6,4
AEK Athens,3661,1,4,2,0,7,1,6,14
PAOK Salonik,3661,2,2,2,2,11,7,4,8
P'thinaikos,3661,3,2,1,3,7,11,-4,7
Panionios,3661,4,1,1,4,4,10,-6,4
AEK Athens,3662,1,4,2,0,7,1,6,14
PAOK Salonik,3662,2,2,2,2,9,5,4,8
P'thinaikos,3662,3,2,1,3,5,9,-4,7
Panionios,3662,4,1,1,4,4,10,-6,4
AEK Athens,3663,1,4,2,0,7,1,6,14
PAOK Salonik,3663,2,2,3,1,10,5,5,9
P'thinaikos,3663,3,1,2,3,5,10,-5,5
Panionios,3663,4,1,1,4,4,10,-6,4
AEK Athens,3664,1,4,2,0,7,1,6,14
PAOK Salonik,3664,2,2,3,1,10,5,5,9
P'thinaikos,3664,3,1,2,3,5,10,-5,5
Panionios,3664,4,1,1,4,4,10,-6,4
AEK Athens,3665,1,4,2,0,7,1,6,14
PAOK Salonik,3665,2,3,2,1,12,6,6,11
P'thinaikos,3665,3,1,1,4,6,12,-6,4
Panionios,3665,4,1,1,4,4,10,-6,4
AEK Athens,3666,1,4,2,0,7,1,6,14
PAOK Salonik,3666,2,2,3,1,9,4,5,9
P'thinaikos,3666,3,1,2,3,4,9,-5,5
Panionios,3666,4,1,1,4,4,10,-6,4
AEK Athens,3667,1,4,2,0,7,1,6,14
PAOK Salonik,3667,2,3,2,1,10,4,6,11
P'thinaikos,3667,3,1,1,4,4,10,-6,4
Panionios,3667,3,1,1,4,4,10,-6,4
AEK Athens,3668,1,4,2,0,7,1,6,14
PAOK Salonik,3668,2,2,3,1,9,4,5,9
P'thinaikos,3668,3,1,2,3,4,9,-5,5
Panionios,3668,4,1,1,4,4,10,-6,4
AEK Athens,3669,1,4,2,0,7,1,6,14
PAOK Salonik,3669,2,3,2,1,14,8,6,11
P'thinaikos,3669,3,1,1,4,8,14,-6,4
Panionios,3669,4,1,1,4,4,10,-6,4
AEK Athens,3670,1,4,2,0,7,1,6,14
PAOK Salonik,3670,2,2,2,2,10,8,2,8
P'thinaikos,3670,3,2,1,3,8,10,-2,7
Panionios,3670,4,1,1,4,4,10,-6,4
AEK Athens,3671,1,4,2,0,7,1,6,14
PAOK Salonik,3671,2,2,3,1,10,5,5,9
P'thinaikos,3671,3,1,2,3,5,10,-5,5
Panionios,3671,4,1,1,4,4,10,-6,4
AEK Athens,3672,1,4,2,0,7,1,6,14
PAOK Salonik,3672,2,2,2,2,9,7,2,8
P'thinaikos,3672,3,2,1,3,7,9,-2,7
Panionios,3672,4,1,1,4,4,10,-6,4
AEK Athens,3673,1,4,2,0,7,1,6,14
PAOK Salonik,3673,2,2,2,2,9,6,3,8
P'thinaikos,3673,3,2,1,3,6,9,-3,7
Panionios,3673,4,1,1,4,4,10,-6,4
AEK Athens,3674,1,4,2,0,7,1,6,14
PAOK Salonik,3674,2,2,2,2,9,5,4,8
P'thinaikos,3674,3,2,1,3,5,9,-4,7
Panionios,3674,4,1,1,4,4,10,-6,4
AEK Athens,3675,1,4,2,0,7,1,6,14
PAOK Salonik,3675,2,2,2,2,9,7,2,8
P'thinaikos,3675,3,2,1,3,7,9,-2,7
Panionios,3675,4,1,1,4,4,10,-6,4
AEK Athens,3676,1,4,2,0,7,1,6,14
PAOK Salonik,3676,2,3,2,1,11,5,6,11
P'thinaikos,3676,3,1,1,4,5,11,-6,4
Panionios,3676,4,1,1,4,4,10,-6,4
AEK Athens,3677,1,4,2,0,7,1,6,14
PAOK Salonik,3677,2,3,2,1,12,5,7,11
Panionios,3677,3,1,1,4,4,10,-6,4
P'thinaikos,3677,4,1,1,4,5,12,-7,4
AEK Athens,3678,1,4,2,0,7,1,6,14
PAOK Salonik,3678,2,3,2,1,10,4,6,11
P'thinaikos,3678,3,1,1,4,4,10,-6,4
Panionios,3678,3,1,1,4,4,10,-6,4
AEK Athens,3679,1,4,2,0,7,1,6,14
PAOK Salonik,3679,2,2,3,1,10,5,5,9
P'thinaikos,3679,3,1,2,3,5,10,-5,5
Panionios,3679,4,1,1,4,4,10,-6,4
AEK Athens,3680,1,4,2,0,7,1,6,14
PAOK Salonik,3680,2,2,2,2,10,6,4,8
P'thinaikos,3680,3,2,1,3,6,10,-4,7
Panionios,3680,4,1,1,4,4,10,-6,4
AEK Athens,3681,1,4,2,0,7,1,6,14
PAOK Salonik,3681,2,2,3,1,9,4,5,9
P'thinaikos,3681,3,1,2,3,4,9,-5,5
Panionios,3681,4,1,1,4,4,10,-6,4
AEK Athens,3682,1,4,2,0,7,1,6,14
PAOK Salonik,3682,2,3,2,1,10,4,6,11
P'thinaikos,3682,3,1,1,4,4,10,-6,4
Panionios,3682,3,1,1,4,4,10,-6,4
AEK Athens,3683,1,4,2,0,7,1,6,14
PAOK Salonik,3683,2,3,2,1,12,4,8,11
Panionios,3683,3,1,1,4,4,10,-6,4
P'thinaikos,3683,4,1,1,4,4,12,-8,4
AEK Athens,3684,1,4,2,0,7,1,6,14
PAOK Salonik,3684,2,2,2,2,9,5,4,8
P'thinaikos,3684,3,2,1,3,5,9,-4,7
Panionios,3684,4,1,1,4,4,10,-6,4
AEK Athens,3685,1,4,2,0,7,1,6,14
PAOK Salonik,3685,2,2,2,2,9,5,4,8
P'thinaikos,3685,3,2,1,3,5,9,-4,7
Panionios,3685,4,1,1,4,4,10,-6,4
AEK Athens,3686,1,4,2,0,7,1,6,14
PAOK Salonik,3686,2,2,2,2,12,8,4,8
P'thinaikos,3686,3,2,1,3,8,12,-4,7
Panionios,3686,4,1,1,4,4,10,-6,4
AEK Athens,3687,1,4,2,0,7,1,6,14
PAOK Salonik,3687,2,2,2,2,9,7,2,8
P'thinaikos,3687,3,2,1,3,7,9,-2,7
Panionios,3687,4,1,1,4,4,10,-6,4
AEK Athens,3688,1,4,2,0,7,1,6,14
PAOK Salonik,3688,2,2,2,2,11,7,4,8
P'thinaikos,3688,3,2,1,3,7,11,-4,7
Panionios,3688,4,1,1,4,4,10,-6,4
AEK Athens,3689,1,4,2,0,7,1,6,14
PAOK Salonik,3689,2,2,2,2,10,6,4,8
P'thinaikos,3689,3,2,1,3,6,10,-4,7
Panionios,3689,4,1,1,4,4,10,-6,4
AEK Athens,3690,1,4,2,0,7,1,6,14
PAOK Salonik,3690,2,3,2,1,12,4,8,11
Panionios,3690,3,1,1,4,4,10,-6,4
P'thinaikos,3690,4,1,1,4,4,12,-8,4
AEK Athens,3691,1,4,2,0,7,1,6,14
PAOK Salonik,3691,2,2,2,2,9,5,4,8
P'thinaikos,3691,3,2,1,3,5,9,-4,7
Panionios,3691,4,1,1,4,4,10,-6,4
AEK Athens,3692,1,4,2,0,7,1,6,14
PAOK Salonik,3692,2,2,2,2,11,8,3,8
P'thinaikos,3692,3,2,1,3,8,11,-3,7
Panionios,3692,4,1,1,4,4,10,-6,4
AEK Athens,3693,1,4,2,0,7,1,6,14
PAOK Salonik,3693,2,2,2,2,11,7,4,8
P'thinaikos,3693,3,2,1,3,7,11,-4,7
Panionios,3693,4,1,1,4,4,10,-6,4
AEK Athens,3694,1,4,2,0,7,1,6,14
PAOK Salonik,3694,2,2,3,1,11,6,5,9
P'thinaikos,3694,3,1,2,3,6,11,-5,5
Panionios,3694,4,1,1,4,4,10,-6,4
AEK Athens,3695,1,4,2,0,7,1,6,14
PAOK Salonik,3695,2,3,2,1,11,5,6,11
P'thinaikos,3695,3,1,1,4,5,11,-6,4
Panionios,3695,4,1,1,4,4,10,-6,4
AEK Athens,3696,1,4,2,0,7,1,6,14
PAOK Salonik,3696,2,2,3,1,11,6,5,9
P'thinaikos,3696,3,1,2,3,6,11,-5,5
Panionios,3696,4,1,1,4,4,10,-6,4
AEK Athens,3697,1,4,2,0,7,1,6,14
PAOK Salonik,3697,2,3,2,1,11,4,7,11
Panionios,3697,3,1,1,4,4,10,-6,4
P'thinaikos,3697,4,1,1,4,4,11,-7,4
AEK Athens,3698,1,4,2,0,7,1,6,14
PAOK Salonik,3698,2,2,3,1,10,5,5,9
P'thinaikos,3698,3,1,2,3,5,10,-5,5
Panionios,3698,4,1,1,4,4,10,-6,4
AEK Athens,3699,1,4,2,0,7,1,6,14
PAOK Salonik,3699,2,2,2,2,9,7,2,8
P'thinaikos,3699,3,2,1,3,7,9,-2,7
Panionios,3699,4,1,1,4,4,10,-6,4
AEK Athens,3700,1,4,2,0,7,1,6,14
PAOK Salonik,3700,2,3,2,1,12,4,8,11
Panionios,3700,3,1,1,4,4,10,-6,4
P'thinaikos,3700,4,1,1,4,4,12,-8,4
AEK Athens,3701,1,4,2,0,7,1,6,14
PAOK Salonik,3701,2,2,2,2,9,5,4,8
P'thinaikos,3701,3,2,1,3,5,9,-4,7
Panionios,3701,4,1,1,4,4,10,-6,4
AEK Athens,3702,1,4,2,0,7,1,6,14
PAOK Salonik,3702,2,3,2,1,13,4,9,11
Panionios,3702,3,1,1,4,4,10,-6,4
P'thinaikos,3702,4,1,1,4,4,13,-9,4
AEK Athens,3703,1,4,2,0,7,1,6,14
PAOK Salonik,3703,2,2,2,2,9,9,0,8
P'thinaikos,3703,3,2,1,3,9,9,0,7
Panionios,3703,4,1,1,4,4,10,-6,4
AEK Athens,3704,1,4,2,0,7,1,6,14
PAOK Salonik,3704,2,3,2,1,14,7,7,11
Panionios,3704,3,1,1,4,4,10,-6,4
P'thinaikos,3704,4,1,1,4,7,14,-7,4
AEK Athens,3705,1,4,2,0,7,1,6,14
PAOK Salonik,3705,2,3,2,1,12,4,8,11
Panionios,3705,3,1,1,4,4,10,-6,4
P'thinaikos,3705,4,1,1,4,4,12,-8,4
AEK Athens,3706,1,4,2,0,7,1,6,14
PAOK Salonik,3706,2,2,2,2,9,5,4,8
P'thinaikos,3706,3,2,1,3,5,9,-4,7
Panionios,3706,4,1,1,4,4,10,-6,4
AEK Athens,3707,1,4,2,0,7,1,6,14
PAOK Salonik,3707,2,2,2,2,11,8,3,8
P'thinaikos,3707,3,2,1,3,8,11,-3,7
Panionios,3707,4,1,1,4,4,10,-6,4
AEK Athens,3708,1,4,2,0,7,1,6,14
PAOK Salonik,3708,2,2,2,2,10,6,4,8
P'thinaikos,3708,3,2,1,3,6,10,-4,7
Panionios,3708,4,1,1,4,4,10,-6,4
AEK Athens,3709,1,4,2,0,7,1,6,14
PAOK Salonik,3709,2,3,2,1,11,4,7,11
Panionios,3709,3,1,1,4,4,10,-6,4
P'thinaikos,3709,4,1,1,4,4,11,-7,4
AEK Athens,3710,1,4,2,0,7,1,6,14
PAOK Salonik,3710,2,2,3,1,10,5,5,9
P'thinaikos,3710,3,1,2,3,5,10,-5,5
Panionios,3710,4,1,1,4,4,10,-6,4
AEK Athens,3711,1,4,2,0,7,1,6,14
PAOK Salonik,3711,2,3,2,1,10,4,6,11
P'thinaikos,3711,3,1,1,4,4,10,-6,4
Panionios,3711,3,1,1,4,4,10,-6,4
AEK Athens,3712,1,4,2,0,7,1,6,14
PAOK Salonik,3712,2,3,2,1,12,4,8,11
Panionios,3712,3,1,1,4,4,10,-6,4
P'thinaikos,3712,4,1,1,4,4,12,-8,4
AEK Athens,3713,1,4,2,0,7,1,6,14
PAOK Salonik,3713,2,2,2,2,9,7,2,8
P'thinaikos,3713,3,2,1,3,7,9,-2,7
Panionios,3713,4,1,1,4,4,10,-6,4
AEK Athens,3714,1,4,2,0,7,1,6,14
PAOK Salonik,3714,2,2,3,1,10,5,5,9
P'thinaikos,3714,3,1,2,3,5,10,-5,5
Panionios,3714,4,1,1,4,4,10,-6,4
AEK Athens,3715,1,4,2,0,7,1,6,14
PAOK Salonik,3715,2,2,2,2,10,6,4,8
P'thinaikos,3715,3,2,1,3,6,10,-4,7
Panionios,3715,4,1,1,4,4,10,-6,4
AEK Athens,3716,1,4,2,0,7,1,6,14
PAOK Salonik,3716,2,2,2,2,10,6,4,8
P'thinaikos,3716,3,2,1,3,6,10,-4,7
Panionios,3716,4,1,1,4,4,10,-6,4
AEK Athens,3717,1,4,2,0,7,1,6,14
PAOK Salonik,3717,2,2,3,1,12,7,5,9
P'thinaikos,3717,3,1,2,3,7,12,-5,5
Panionios,3717,4,1,1,4,4,10,-6,4
AEK Athens,3718,1,4,2,0,7,1,6,14
PAOK Salonik,3718,2,2,2,2,9,6,3,8
P'thinaikos,3718,3,2,1,3,6,9,-3,7
Panionios,3718,4,1,1,4,4,10,-6,4
AEK Athens,3719,1,4,2,0,7,1,6,14
PAOK Salonik,3719,2,2,2,2,9,5,4,8
P'thinaikos,3719,3,2,1,3,5,9,-4,7
Panionios,3719,4,1,1,4,4,10,-6,4
AEK Athens,3720,1,4,2,0,7,1,6,14
PAOK Salonik,3720,2,2,3,1,12,7,5,9
P'thinaikos,3720,3,1,2,3,7,12,-5,5
Panionios,3720,4,1,1,4,4,10,-6,4
AEK Athens,3721,1,4,2,0,7,1,6,14
PAOK Salonik,3721,2,3,2,1,13,4,9,11
Panionios,3721,3,1,1,4,4,10,-6,4
P'thinaikos,3721,4,1,1,4,4,13,-9,4
AEK Athens,3722,1,4,2,0,7,1,6,14
PAOK Salonik,3722,2,2,3,1,10,5,5,9
P'thinaikos,3722,3,1,2,3,5,10,-5,5
Panionios,3722,4,1,1,4,4,10,-6,4
AEK Athens,3723,1,4,2,0,7,1,6,14
PAOK Salonik,3723,2,3,2,1,11,5,6,11
P'thinaikos,3723,3,1,1,4,5,11,-6,4
Panionios,3723,4,1,1,4,4,10,-6,4
AEK Athens,3724,1,4,2,0,7,1,6,14
PAOK Salonik,3724,2,3,2,1,11,5,6,11
P'thinaikos,3724,3,1,1,4,5,11,-6,4
Panionios,3724,4,1,1,4,4,10,-6,4
AEK Athens,3725,1,4,2,0,7,1,6,14
PAOK Salonik,3725,2,3,2,1,12,4,8,11
Panionios,3725,3,1,1,4,4,10,-6,4
P'thinaikos,3725,4,1,1,4,4,12,-8,4
AEK Athens,3726,1,4,2,0,7,1,6,14
PAOK Salonik,3726,2,3,2,1,10,4,6,11
P'thinaikos,3726,3,1,1,4,4,10,-6,4
Panionios,3726,3,1,1,4,4,10,-6,4
AEK Athens,3727,1,4,2,0,7,1,6,14
PAOK Salonik,3727,2,2,2,2,10,6,4,8
P'thinaikos,3727,3,2,1,3,6,10,-4,7
Panionios,3727,4,1,1,4,4,10,-6,4
AEK Athens,3728,1,4,2,0,7,1,6,14
PAOK Salonik,3728,2,3,2,1,12,4,8,11
Panionios,3728,3,1,1,4,4,10,-6,4
P'thinaikos,3728,4,1,1,4,4,12,-8,4
AEK Athens,3729,1,4,2,0,7,1,6,14
PAOK Salonik,3729,2,2,3,1,10,5,5,9
P'thinaikos,3729,3,1,2,3,5,10,-5,5
Panionios,3729,4,1,1,4,4,10,-6,4
AEK Athens,3730,1,4,2,0,7,1,6,14
PAOK Salonik,3730,2,2,2,2,10,7,3,8
P'thinaikos,3730,3,2,1,3,7,10,-3,7
Panionios,3730,4,1,1,4,4,10,-6,4
AEK Athens,3731,1,4,2,0,7,1,6,14
PAOK Salonik,3731,2,3,2,1,12,4,8,11
Panionios,3731,3,1,1,4,4,10,-6,4
P'thinaikos,3731,4,1,1,4,4,12,-8,4
AEK Athens,3732,1,4,2,0,7,1,6,14
PAOK Salonik,3732,2,2,2,2,9,5,4,8
P'thinaikos,3732,3,2,1,3,5,9,-4,7
Panionios,3732,4,1,1,4,4,10,-6,4
AEK Athens,3733,1,4,2,0,7,1,6,14
PAOK Salonik,3733,2,3,2,1,11,5,6,11
P'thinaikos,3733,3,1,1,4,5,11,-6,4
Panionios,3733,4,1,1,4,4,10,-6,4
AEK Athens,3734,1,4,2,0,7,1,6,14
PAOK Salonik,3734,2,2,2,2,10,6,4,8
P'thinaikos,3734,3,2,1,3,6,10,-4,7
Panionios,3734,4,1,1,4,4,10,-6,4
AEK Athens,3735,1,4,2,0,7,1,6,14
PAOK Salonik,3735,2,2,2,2,10,6,4,8
P'thinaikos,3735,3,2,1,3,6,10,-4,7
Panionios,3735,4,1,1,4,4,10,-6,4
AEK Athens,3736,1,4,2,0,7,1,6,14
PAOK Salonik,3736,2,2,3,1,9,4,5,9
P'thinaikos,3736,3,1,2,3,4,9,-5,5
Panionios,3736,4,1,1,4,4,10,-6,4
AEK Athens,3737,1,4,2,0,7,1,6,14
PAOK Salonik,3737,2,2,2,2,11,7,4,8
P'thinaikos,3737,3,2,1,3,7,11,-4,7
Panionios,3737,4,1,1,4,4,10,-6,4
AEK Athens,3738,1,4,2,0,7,1,6,14
PAOK Salonik,3738,2,2,2,2,9,8,1,8
P'thinaikos,3738,3,2,1,3,8,9,-1,7
Panionios,3738,4,1,1,4,4,10,-6,4
AEK Athens,3739,1,4,2,0,7,1,6,14
PAOK Salonik,3739,2,3,2,1,11,5,6,11
P'thinaikos,3739,3,1,1,4,5,11,-6,4
Panionios,3739,4,1,1,4,4,10,-6,4
AEK Athens,3740,1,4,2,0,7,1,6,14
PAOK Salonik,3740,2,2,2,2,9,5,4,8
P'thinaikos,3740,3,2,1,3,5,9,-4,7
Panionios,3740,4,1,1,4,4,10,-6,4
AEK Athens,3741,1,4,2,0,7,1,6,14
PAOK Salonik,3741,2,2,2,2,10,6,4,8
P'thinaikos,3741,3,2,1,3,6,10,-4,7
Panionios,3741,4,1,1,4,4,10,-6,4
AEK Athens,3742,1,4,2,0,7,1,6,14
PAOK Salonik,3742,2,2,2,2,10,6,4,8
P'thinaikos,3742,3,2,1,3,6,10,-4,7
Panionios,3742,4,1,1,4,4,10,-6,4
AEK Athens,3743,1,4,2,0,7,1,6,14
PAOK Salonik,3743,2,2,3,1,9,4,5,9
P'thinaikos,3743,3,1,2,3,4,9,-5,5
Panionios,3743,4,1,1,4,4,10,-6,4
AEK Athens,3744,1,4,2,0,7,1,6,14
PAOK Salonik,3744,2,2,2,2,10,6,4,8
P'thinaikos,3744,3,2,1,3,6,10,-4,7
Panionios,3744,4,1,1,4,4,10,-6,4
AEK Athens,3745,1,4,2,0,7,1,6,14
PAOK Salonik,3745,2,3,2,1,10,4,6,11
P'thinaikos,3745,3,1,1,4,4,10,-6,4
Panionios,3745,3,1,1,4,4,10,-6,4
AEK Athens,3746,1,4,2,0,7,1,6,14
PAOK Salonik,3746,2,2,2,2,9,6,3,8
P'thinaikos,3746,3,2,1,3,6,9,-3,7
Panionios,3746,4,1,1,4,4,10,-6,4
AEK Athens,3747,1,4,2,0,7,1,6,14
PAOK Salonik,3747,2,2,2,2,10,6,4,8
P'thinaikos,3747,3,2,1,3,6,10,-4,7
Panionios,3747,4,1,1,4,4,10,-6,4
AEK Athens,3748,1,4,2,0,7,1,6,14
PAOK Salonik,3748,2,2,2,2,10,6,4,8
P'thinaikos,3748,3,2,1,3,6,10,-4,7
Panionios,3748,4,1,1,4,4,10,-6,4
AEK Athens,3749,1,4,2,0,7,1,6,14
PAOK Salonik,3749,2,3,2,1,12,5,7,11
Panionios,3749,3,1,1,4,4,10,-6,4
P'thinaikos,3749,4,1,1,4,5,12,-7,4
AEK Athens,3750,1,4,2,0,7,1,6,14
PAOK Salonik,3750,2,2,3,1,11,6,5,9
P'thinaikos,3750,3,1,2,3,6,11,-5,5
Panionios,3750,4,1,1,4,4,10,-6,4
AEK Athens,3751,1,4,2,0,7,1,6,14
PAOK Salonik,3751,2,2,3,1,9,4,5,9
P'thinaikos,3751,3,1,2,3,4,9,-5,5
Panionios,3751,4,1,1,4,4,10,-6,4
AEK Athens,3752,1,4,2,0,7,1,6,14
PAOK Salonik,3752,2,3,2,1,13,6,7,11
Panionios,3752,3,1,1,4,4,10,-6,4
P'thinaikos,3752,4,1,1,4,6,13,-7,4
AEK Athens,3753,1,4,2,0,7,1,6,14
PAOK Salonik,3753,2,2,3,1,9,4,5,9
P'thinaikos,3753,3,1,2,3,4,9,-5,5
Panionios,3753,4,1,1,4,4,10,-6,4
AEK Athens,3754,1,4,2,0,7,1,6,14
PAOK Salonik,3754,2,3,2,1,10,4,6,11
P'thinaikos,3754,3,1,1,4,4,10,-6,4
Panionios,3754,3,1,1,4,4,10,-6,4
AEK Athens,3755,1,4,2,0,7,1,6,14
PAOK Salonik,3755,2,2,2,2,9,5,4,8
P'thinaikos,3755,3,2,1,3,5,9,-4,7
Panionios,3755,4,1,1,4,4,10,-6,4
AEK Athens,3756,1,4,2,0,7,1,6,14
PAOK Salonik,3756,2,2,3,1,10,5,5,9
P'thinaikos,3756,3,1,2,3,5,10,-5,5
Panionios,3756,4,1,1,4,4,10,-6,4
AEK Athens,3757,1,4,2,0,7,1,6,14
PAOK Salonik,3757,2,2,2,2,11,7,4,8
P'thinaikos,3757,3,2,1,3,7,11,-4,7
Panionios,3757,4,1,1,4,4,10,-6,4
AEK Athens,3758,1,4,2,0,7,1,6,14
PAOK Salonik,3758,2,2,2,2,11,7,4,8
P'thinaikos,3758,3,2,1,3,7,11,-4,7
Panionios,3758,4,1,1,4,4,10,-6,4
AEK Athens,3759,1,4,2,0,7,1,6,14
PAOK Salonik,3759,2,2,2,2,10,6,4,8
P'thinaikos,3759,3,2,1,3,6,10,-4,7
Panionios,3759,4,1,1,4,4,10,-6,4
AEK Athens,3760,1,4,2,0,7,1,6,14
PAOK Salonik,3760,2,2,2,2,10,7,3,8
P'thinaikos,3760,3,2,1,3,7,10,-3,7
Panionios,3760,4,1,1,4,4,10,-6,4
AEK Athens,3761,1,4,2,0,7,1,6,14
PAOK Salonik,3761,2,3,2,1,11,5,6,11
P'thinaikos,3761,3,1,1,4,5,11,-6,4
Panionios,3761,4,1,1,4,4,10,-6,4
AEK Athens,3762,1,4,2,0,7,1,6,14
PAOK Salonik,3762,2,2,3,1,9,4,5,9
P'thinaikos,3762,3,1,2,3,4,9,-5,5
Panionios,3762,4,1,1,4,4,10,-6,4
AEK Athens,3763,1,4,2,0,7,1,6,14
PAOK Salonik,3763,2,3,2,1,10,4,6,11
P'thinaikos,3763,3,1,1,4,4,10,-6,4
Panionios,3763,3,1,1,4,4,10,-6,4
AEK Athens,3764,1,4,2,0,7,1,6,14
PAOK Salonik,3764,2,2,3,1,10,5,5,9
P'thinaikos,3764,3,1,2,3,5,10,-5,5
Panionios,3764,4,1,1,4,4,10,-6,4
AEK Athens,3765,1,4,2,0,7,1,6,14
PAOK Salonik,3765,2,3,2,1,11,5,6,11
P'thinaikos,3765,3,1,1,4,5,11,-6,4
Panionios,3765,4,1,1,4,4,10,-6,4
AEK Athens,3766,1,4,2,0,7,1,6,14
PAOK Salonik,3766,2,2,3,1,9,4,5,9
P'thinaikos,3766,3,1,2,3,4,9,-5,5
Panionios,3766,4,1,1,4,4,10,-6,4
AEK Athens,3767,1,4,2,0,7,1,6,14
PAOK Salonik,3767,2,2,2,2,9,5,4,8
P'thinaikos,3767,3,2,1,3,5,9,-4,7
Panionios,3767,4,1,1,4,4,10,-6,4
AEK Athens,3768,1,4,2,0,7,1,6,14
PAOK Salonik,3768,2,3,2,1,11,5,6,11
P'thinaikos,3768,3,1,1,4,5,11,-6,4
Panionios,3768,4,1,1,4,4,10,-6,4
AEK Athens,3769,1,4,2,0,7,1,6,14
PAOK Salonik,3769,2,3,2,1,10,4,6,11
P'thinaikos,3769,3,1,1,4,4,10,-6,4
Panionios,3769,3,1,1,4,4,10,-6,4
AEK Athens,3770,1,4,2,0,7,1,6,14
PAOK Salonik,3770,2,2,2,2,9,5,4,8
P'thinaikos,3770,3,2,1,3,5,9,-4,7
Panionios,3770,4,1,1,4,4,10,-6,4
AEK Athens,3771,1,4,2,0,7,1,6,14
PAOK Salonik,3771,2,2,2,2,9,11,-2,8
P'thinaikos,3771,3,2,1,3,11,9,2,7
Panionios,3771,4,1,1,4,4,10,-6,4
AEK Athens,3772,1,4,2,0,7,1,6,14
PAOK Salonik,3772,2,2,2,2,11,8,3,8
P'thinaikos,3772,3,2,1,3,8,11,-3,7
Panionios,3772,4,1,1,4,4,10,-6,4
AEK Athens,3773,1,4,2,0,7,1,6,14
PAOK Salonik,3773,2,2,3,1,9,4,5,9
P'thinaikos,3773,3,1,2,3,4,9,-5,5
Panionios,3773,4,1,1,4,4,10,-6,4
AEK Athens,3774,1,4,2,0,7,1,6,14
PAOK Salonik,3774,2,2,2,2,9,5,4,8
P'thinaikos,3774,3,2,1,3,5,9,-4,7
Panionios,3774,4,1,1,4,4,10,-6,4
AEK Athens,3775,1,4,2,0,7,1,6,14
PAOK Salonik,3775,2,2,2,2,10,6,4,8
P'thinaikos,3775,3,2,1,3,6,10,-4,7
Panionios,3775,4,1,1,4,4,10,-6,4
AEK Athens,3776,1,4,2,0,7,1,6,14
PAOK Salonik,3776,2,2,3,1,10,5,5,9
P'thinaikos,3776,3,1,2,3,5,10,-5,5
Panionios,3776,4,1,1,4,4,10,-6,4
AEK Athens,3777,1,4,2,0,7,1,6,14
PAOK Salonik,3777,2,2,2,2,9,6,3,8
P'thinaikos,3777,3,2,1,3,6,9,-3,7
Panionios,3777,4,1,1,4,4,10,-6,4
AEK Athens,3778,1,4,2,0,7,1,6,14
PAOK Salonik,3778,2,2,3,1,10,5,5,9
P'thinaikos,3778,3,1,2,3,5,10,-5,5
Panionios,3778,4,1,1,4,4,10,-6,4
AEK Athens,3779,1,4,2,0,7,1,6,14
PAOK Salonik,3779,2,3,2,1,11,5,6,11
P'thinaikos,3779,3,1,1,4,5,11,-6,4
Panionios,3779,4,1,1,4,4,10,-6,4
AEK Athens,3780,1,4,2,0,7,1,6,14
PAOK Salonik,3780,2,3,2,1,10,4,6,11
P'thinaikos,3780,3,1,1,4,4,10,-6,4
Panionios,3780,3,1,1,4,4,10,-6,4
AEK Athens,3781,1,4,2,0,7,1,6,14
PAOK Salonik,3781,2,3,2,1,10,4,6,11
P'thinaikos,3781,3,1,1,4,4,10,-6,4
Panionios,3781,3,1,1,4,4,10,-6,4
AEK Athens,3782,1,4,2,0,7,1,6,14
PAOK Salonik,3782,2,2,3,1,11,6,5,9
P'thinaikos,3782,3,1,2,3,6,11,-5,5
Panionios,3782,4,1,1,4,4,10,-6,4
AEK Athens,3783,1,4,2,0,7,1,6,14
PAOK Salonik,3783,2,3,2,1,13,6,7,11
Panionios,3783,3,1,1,4,4,10,-6,4
P'thinaikos,3783,4,1,1,4,6,13,-7,4
AEK Athens,3784,1,4,2,0,7,1,6,14
PAOK Salonik,3784,2,2,2,2,9,5,4,8
P'thinaikos,3784,3,2,1,3,5,9,-4,7
Panionios,3784,4,1,1,4,4,10,-6,4
AEK Athens,3785,1,4,2,0,7,1,6,14
PAOK Salonik,3785,2,3,2,1,11,5,6,11
P'thinaikos,3785,3,1,1,4,5,11,-6,4
Panionios,3785,4,1,1,4,4,10,-6,4
AEK Athens,3786,1,4,2,0,7,1,6,14
PAOK Salonik,3786,2,2,2,2,10,6,4,8
P'thinaikos,3786,3,2,1,3,6,10,-4,7
Panionios,3786,4,1,1,4,4,10,-6,4
AEK Athens,3787,1,4,2,0,7,1,6,14
PAOK Salonik,3787,2,2,2,2,11,7,4,8
P'thinaikos,3787,3,2,1,3,7,11,-4,7
Panionios,3787,4,1,1,4,4,10,-6,4
AEK Athens,3788,1,4,2,0,7,1,6,14
PAOK Salonik,3788,2,2,2,2,10,6,4,8
P'thinaikos,3788,3,2,1,3,6,10,-4,7
Panionios,3788,4,1,1,4,4,10,-6,4
AEK Athens,3789,1,4,2,0,7,1,6,14
PAOK Salonik,3789,2,2,2,2,9,9,0,8
P'thinaikos,3789,3,2,1,3,9,9,0,7
Panionios,3789,4,1,1,4,4,10,-6,4
AEK Athens,3790,1,4,2,0,7,1,6,14
PAOK Salonik,3790,2,2,3,1,10,5,5,9
P'thinaikos,3790,3,1,2,3,5,10,-5,5
Panionios,3790,4,1,1,4,4,10,-6,4
AEK Athens,3791,1,4,2,0,7,1,6,14
PAOK Salonik,3791,2,3,2,1,11,5,6,11
P'thinaikos,3791,3,1,1,4,5,11,-6,4
Panionios,3791,4,1,1,4,4,10,-6,4
AEK Athens,3792,1,4,2,0,7,1,6,14
PAOK Salonik,3792,2,2,2,2,9,5,4,8
P'thinaikos,3792,3,2,1,3,5,9,-4,7
Panionios,3792,4,1,1,4,4,10,-6,4
AEK Athens,3793,1,4,2,0,7,1,6,14
PAOK Salonik,3793,2,2,2,2,9,8,1,8
P'thinaikos,3793,3,2,1,3,8,9,-1,7
Panionios,3793,4,1,1,4,4,10,-6,4
AEK Athens,3794,1,4,2,0,7,1,6,14
PAOK Salonik,3794,2,3,2,1,10,4,6,11
P'thinaikos,3794,3,1,1,4,4,10,-6,4
Panionios,3794,3,1,1,4,4,10,-6,4
AEK Athens,3795,1,4,2,0,7,1,6,14
PAOK Salonik,3795,2,3,2,1,11,5,6,11
P'thinaikos,3795,3,1,1,4,5,11,-6,4
Panionios,3795,4,1,1,4,4,10,-6,4
AEK Athens,3796,1,4,2,0,7,1,6,14
PAOK Salonik,3796,2,2,2,2,9,5,4,8
P'thinaikos,3796,3,2,1,3,5,9,-4,7
Panionios,3796,4,1,1,4,4,10,-6,4
AEK Athens,3797,1,4,2,0,7,1,6,14
PAOK Salonik,3797,2,2,3,1,11,6,5,9
P'thinaikos,3797,3,1,2,3,6,11,-5,5
Panionios,3797,4,1,1,4,4,10,-6,4
AEK Athens,3798,1,4,2,0,7,1,6,14
PAOK Salonik,3798,2,2,2,2,10,6,4,8
P'thinaikos,3798,3,2,1,3,6,10,-4,7
Panionios,3798,4,1,1,4,4,10,-6,4
AEK Athens,3799,1,4,2,0,7,1,6,14
PAOK Salonik,3799,2,2,2,2,10,6,4,8
P'thinaikos,3799,3,2,1,3,6,10,-4,7
Panionios,3799,4,1,1,4,4,10,-6,4
AEK Athens,3800,1,4,2,0,7,1,6,14
PAOK Salonik,3800,2,2,2,2,9,6,3,8
P'thinaikos,3800,3,2,1,3,6,9,-3,7
Panionios,3800,4,1,1,4,4,10,-6,4
AEK Athens,3801,1,4,2,0,7,1,6,14
PAOK Salonik,3801,2,2,3,1,11,6,5,9
P'thinaikos,3801,3,1,2,3,6,11,-5,5
Panionios,3801,4,1,1,4,4,10,-6,4
AEK Athens,3802,1,4,2,0,7,1,6,14
PAOK Salonik,3802,2,2,2,2,9,6,3,8
P'thinaikos,3802,3,2,1,3,6,9,-3,7
Panionios,3802,4,1,1,4,4,10,-6,4
AEK Athens,3803,1,4,2,0,7,1,6,14
PAOK Salonik,3803,2,2,2,2,9,6,3,8
P'thinaikos,3803,3,2,1,3,6,9,-3,7
Panionios,3803,4,1,1,4,4,10,-6,4
AEK Athens,3804,1,4,2,0,7,1,6,14
PAOK Salonik,3804,2,2,2,2,9,6,3,8
P'thinaikos,3804,3,2,1,3,6,9,-3,7
Panionios,3804,4,1,1,4,4,10,-6,4
AEK Athens,3805,1,4,2,0,7,1,6,14
PAOK Salonik,3805,2,2,3,1,9,4,5,9
P'thinaikos,3805,3,1,2,3,4,9,-5,5
Panionios,3805,4,1,1,4,4,10,-6,4
AEK Athens,3806,1,4,2,0,7,1,6,14
PAOK Salonik,3806,2,2,3,1,9,4,5,9
P'thinaikos,3806,3,1,2,3,4,9,-5,5
Panionios,3806,4,1,1,4,4,10,-6,4
AEK Athens,3807,1,4,2,0,7,1,6,14
PAOK Salonik,3807,2,3,2,1,12,5,7,11
Panionios,3807,3,1,1,4,4,10,-6,4
P'thinaikos,3807,4,1,1,4,5,12,-7,4
AEK Athens,3808,1,4,2,0,7,1,6,14
PAOK Salonik,3808,2,2,3,1,10,5,5,9
P'thinaikos,3808,3,1,2,3,5,10,-5,5
Panionios,3808,4,1,1,4,4,10,-6,4
AEK Athens,3809,1,4,2,0,7,1,6,14
PAOK Salonik,3809,2,3,2,1,11,5,6,11
P'thinaikos,3809,3,1,1,4,5,11,-6,4
Panionios,3809,4,1,1,4,4,10,-6,4
AEK Athens,3810,1,4,2,0,7,1,6,14
PAOK Salonik,3810,2,2,3,1,9,4,5,9
P'thinaikos,3810,3,1,2,3,4,9,-5,5
Panionios,3810,4,1,1,4,4,10,-6,4
AEK Athens,3811,1,4,2,0,7,1,6,14
PAOK Salonik,3811,2,2,3,1,9,4,5,9
P'thinaikos,3811,3,1,2,3,4,9,-5,5
Panionios,3811,4,1,1,4,4,10,-6,4
AEK Athens,3812,1,4,2,0,7,1,6,14
PAOK Salonik,3812,2,2,2,2,10,6,4,8
P'thinaikos,3812,3,2,1,3,6,10,-4,7
Panionios,3812,4,1,1,4,4,10,-6,4
AEK Athens,3813,1,4,2,0,7,1,6,14
PAOK Salonik,3813,2,2,2,2,10,6,4,8
P'thinaikos,3813,3,2,1,3,6,10,-4,7
Panionios,3813,4,1,1,4,4,10,-6,4
AEK Athens,3814,1,4,2,0,7,1,6,14
PAOK Salonik,3814,2,3,2,1,10,4,6,11
P'thinaikos,3814,3,1,1,4,4,10,-6,4
Panionios,3814,3,1,1,4,4,10,-6,4
AEK Athens,3815,1,4,2,0,7,1,6,14
PAOK Salonik,3815,2,2,2,2,9,6,3,8
P'thinaikos,3815,3,2,1,3,6,9,-3,7
Panionios,3815,4,1,1,4,4,10,-6,4
AEK Athens,3816,1,4,2,0,7,1,6,14
PAOK Salonik,3816,2,2,2,2,9,6,3,8
P'thinaikos,3816,3,2,1,3,6,9,-3,7
Panionios,3816,4,1,1,4,4,10,-6,4
AEK Athens,3817,1,4,2,0,7,1,6,14
PAOK Salonik,3817,2,3,2,1,10,4,6,11
P'thinaikos,3817,3,1,1,4,4,10,-6,4
Panionios,3817,3,1,1,4,4,10,-6,4
AEK Athens,3818,1,4,2,0,7,1,6,14
PAOK Salonik,3818,2,2,3,1,10,5,5,9
P'thinaikos,3818,3,1,2,3,5,10,-5,5
Panionios,3818,4,1,1,4,4,10,-6,4
AEK Athens,3819,1,4,2,0,7,1,6,14
PAOK Salonik,3819,2,3,2,1,11,4,7,11
Panionios,3819,3,1,1,4,4,10,-6,4
P'thinaikos,3819,4,1,1,4,4,11,-7,4
AEK Athens,3820,1,4,2,0,7,1,6,14
PAOK Salonik,3820,2,3,2,1,13,4,9,11
Panionios,3820,3,1,1,4,4,10,-6,4
P'thinaikos,3820,4,1,1,4,4,13,-9,4
AEK Athens,3821,1,4,2,0,7,1,6,14
PAOK Salonik,3821,2,2,3,1,10,5,5,9
P'thinaikos,3821,3,1,2,3,5,10,-5,5
Panionios,3821,4,1,1,4,4,10,-6,4
AEK Athens,3822,1,4,2,0,7,1,6,14
PAOK Salonik,3822,2,3,2,1,11,4,7,11
Panionios,3822,3,1,1,4,4,10,-6,4
P'thinaikos,3822,4,1,1,4,4,11,-7,4
AEK Athens,3823,1,4,2,0,7,1,6,14
PAOK Salonik,3823,2,3,2,1,13,5,8,11
Panionios,3823,3,1,1,4,4,10,-6,4
P'thinaikos,3823,4,1,1,4,5,13,-8,4
AEK Athens,3824,1,4,2,0,7,1,6,14
PAOK Salonik,3824,2,2,2,2,9,7,2,8
P'thinaikos,3824,3,2,1,3,7,9,-2,7
Panionios,3824,4,1,1,4,4,10,-6,4
AEK Athens,3825,1,4,2,0,7,1,6,14
PAOK Salonik,3825,2,2,2,2,9,8,1,8
P'thinaikos,3825,3,2,1,3,8,9,-1,7
Panionios,3825,4,1,1,4,4,10,-6,4
AEK Athens,3826,1,4,2,0,7,1,6,14
PAOK Salonik,3826,2,2,2,2,9,5,4,8
P'thinaikos,3826,3,2,1,3,5,9,-4,7
Panionios,3826,4,1,1,4,4,10,-6,4
AEK Athens,3827,1,4,2,0,7,1,6,14
PAOK Salonik,3827,2,2,2,2,10,7,3,8
P'thinaikos,3827,3,2,1,3,7,10,-3,7
Panionios,3827,4,1,1,4,4,10,-6,4
AEK Athens,3828,1,4,2,0,7,1,6,14
PAOK Salonik,3828,2,3,2,1,12,6,6,11
P'thinaikos,3828,3,1,1,4,6,12,-6,4
Panionios,3828,4,1,1,4,4,10,-6,4
AEK Athens,3829,1,4,2,0,7,1,6,14
PAOK Salonik,3829,2,3,2,1,11,5,6,11
P'thinaikos,3829,3,1,1,4,5,11,-6,4
Panionios,3829,4,1,1,4,4,10,-6,4
AEK Athens,3830,1,4,2,0,7,1,6,14
PAOK Salonik,3830,2,3,2,1,11,5,6,11
P'thinaikos,3830,3,1,1,4,5,11,-6,4
Panionios,3830,4,1,1,4,4,10,-6,4
AEK Athens,3831,1,4,2,0,7,1,6,14
PAOK Salonik,3831,2,2,3,1,9,4,5,9
P'thinaikos,3831,3,1,2,3,4,9,-5,5
Panionios,3831,4,1,1,4,4,10,-6,4
AEK Athens,3832,1,4,2,0,7,1,6,14
PAOK Salonik,3832,2,2,2,2,9,5,4,8
P'thinaikos,3832,3,2,1,3,5,9,-4,7
Panionios,3832,4,1,1,4,4,10,-6,4
AEK Athens,3833,1,4,2,0,7,1,6,14
PAOK Salonik,3833,2,3,2,1,11,5,6,11
P'thinaikos,3833,3,1,1,4,5,11,-6,4
Panionios,3833,4,1,1,4,4,10,-6,4
AEK Athens,3834,1,4,2,0,7,1,6,14
PAOK Salonik,3834,2,3,2,1,13,7,6,11
P'thinaikos,3834,3,1,1,4,7,13,-6,4
Panionios,3834,4,1,1,4,4,10,-6,4
AEK Athens,3835,1,4,2,0,7,1,6,14
PAOK Salonik,3835,2,2,3,1,11,6,5,9
P'thinaikos,3835,3,1,2,3,6,11,-5,5
Panionios,3835,4,1,1,4,4,10,-6,4
AEK Athens,3836,1,4,2,0,7,1,6,14
PAOK Salonik,3836,2,3,2,1,11,4,7,11
Panionios,3836,3,1,1,4,4,10,-6,4
P'thinaikos,3836,4,1,1,4,4,11,-7,4
AEK Athens,3837,1,4,2,0,7,1,6,14
PAOK Salonik,3837,2,2,3,1,10,5,5,9
P'thinaikos,3837,3,1,2,3,5,10,-5,5
Panionios,3837,4,1,1,4,4,10,-6,4
AEK Athens,3838,1,4,2,0,7,1,6,14
PAOK Salonik,3838,2,3,2,1,10,4,6,11
P'thinaikos,3838,3,1,1,4,4,10,-6,4
Panionios,3838,3,1,1,4,4,10,-6,4
AEK Athens,3839,1,4,2,0,7,1,6,14
PAOK Salonik,3839,2,3,2,1,11,4,7,11
Panionios,3839,3,1,1,4,4,10,-6,4
P'thinaikos,3839,4,1,1,4,4,11,-7,4
AEK Athens,3840,1,4,2,0,7,1,6,14
PAOK Salonik,3840,2,2,3,1,9,4,5,9
P'thinaikos,3840,3,1,2,3,4,9,-5,5
Panionios,3840,4,1,1,4,4,10,-6,4
AEK Athens,3841,1,4,2,0,7,1,6,14
PAOK Salonik,3841,2,2,2,2,10,6,4,8
P'thinaikos,3841,3,2,1,3,6,10,-4,7
Panionios,3841,4,1,1,4,4,10,-6,4
AEK Athens,3842,1,4,2,0,7,1,6,14
PAOK Salonik,3842,2,3,2,1,10,4,6,11
P'thinaikos,3842,3,1,1,4,4,10,-6,4
Panionios,3842,3,1,1,4,4,10,-6,4
AEK Athens,3843,1,4,2,0,7,1,6,14
PAOK Salonik,3843,2,2,2,2,9,5,4,8
P'thinaikos,3843,3,2,1,3,5,9,-4,7
Panionios,3843,4,1,1,4,4,10,-6,4
AEK Athens,3844,1,4,2,0,7,1,6,14
PAOK Salonik,3844,2,2,2,2,10,6,4,8
P'thinaikos,3844,3,2,1,3,6,10,-4,7
Panionios,3844,4,1,1,4,4,10,-6,4
AEK Athens,3845,1,4,2,0,7,1,6,14
PAOK Salonik,3845,2,3,2,1,10,4,6,11
P'thinaikos,3845,3,1,1,4,4,10,-6,4
Panionios,3845,3,1,1,4,4,10,-6,4
AEK Athens,3846,1,4,2,0,7,1,6,14
PAOK Salonik,3846,2,3,2,1,10,4,6,11
P'thinaikos,3846,3,1,1,4,4,10,-6,4
Panionios,3846,3,1,1,4,4,10,-6,4
AEK Athens,3847,1,4,2,0,7,1,6,14
PAOK Salonik,3847,2,2,2,2,10,6,4,8
P'thinaikos,3847,3,2,1,3,6,10,-4,7
Panionios,3847,4,1,1,4,4,10,-6,4
AEK Athens,3848,1,4,2,0,7,1,6,14
PAOK Salonik,3848,2,2,2,2,11,7,4,8
P'thinaikos,3848,3,2,1,3,7,11,-4,7
Panionios,3848,4,1,1,4,4,10,-6,4
AEK Athens,3849,1,4,2,0,7,1,6,14
PAOK Salonik,3849,2,2,2,2,9,8,1,8
P'thinaikos,3849,3,2,1,3,8,9,-1,7
Panionios,3849,4,1,1,4,4,10,-6,4
AEK Athens,3850,1,4,2,0,7,1,6,14
PAOK Salonik,3850,2,3,2,1,12,6,6,11
P'thinaikos,3850,3,1,1,4,6,12,-6,4
Panionios,3850,4,1,1,4,4,10,-6,4
AEK Athens,3851,1,4,2,0,7,1,6,14
PAOK Salonik,3851,2,2,3,1,9,4,5,9
P'thinaikos,3851,3,1,2,3,4,9,-5,5
Panionios,3851,4,1,1,4,4,10,-6,4
AEK Athens,3852,1,4,2,0,7,1,6,14
PAOK Salonik,3852,2,3,2,1,11,5,6,11
P'thinaikos,3852,3,1,1,4,5,11,-6,4
Panionios,3852,4,1,1,4,4,10,-6,4
AEK Athens,3853,1,4,2,0,7,1,6,14
PAOK Salonik,3853,2,3,2,1,10,4,6,11
P'thinaikos,3853,3,1,1,4,4,10,-6,4
Panionios,3853,3,1,1,4,4,10,-6,4
AEK Athens,3854,1,4,2,0,7,1,6,14
PAOK Salonik,3854,2,2,2,2,9,5,4,8
P'thinaikos,3854,3,2,1,3,5,9,-4,7
Panionios,3854,4,1,1,4,4,10,-6,4
AEK Athens,3855,1,4,2,0,7,1,6,14
PAOK Salonik,3855,2,2,2,2,12,8,4,8
P'thinaikos,3855,3,2,1,3,8,12,-4,7
Panionios,3855,4,1,1,4,4,10,-6,4
AEK Athens,3856,1,4,2,0,7,1,6,14
PAOK Salonik,3856,2,2,2,2,10,7,3,8
P'thinaikos,3856,3,2,1,3,7,10,-3,7
Panionios,3856,4,1,1,4,4,10,-6,4
AEK Athens,3857,1,4,2,0,7,1,6,14
PAOK Salonik,3857,2,3,2,1,12,5,7,11
Panionios,3857,3,1,1,4,4,10,-6,4
P'thinaikos,3857,4,1,1,4,5,12,-7,4
AEK Athens,3858,1,4,2,0,7,1,6,14
PAOK Salonik,3858,2,3,2,1,10,4,6,11
P'thinaikos,3858,3,1,1,4,4,10,-6,4
Panionios,3858,3,1,1,4,4,10,-6,4
AEK Athens,3859,1,4,2,0,7,1,6,14
PAOK Salonik,3859,2,2,3,1,11,6,5,9
P'thinaikos,3859,3,1,2,3,6,11,-5,5
Panionios,3859,4,1,1,4,4,10,-6,4
AEK Athens,3860,1,4,2,0,7,1,6,14
PAOK Salonik,3860,2,2,2,2,9,5,4,8
P'thinaikos,3860,3,2,1,3,5,9,-4,7
Panionios,3860,4,1,1,4,4,10,-6,4
AEK Athens,3861,1,4,2,0,7,1,6,14
PAOK Salonik,3861,2,3,2,1,11,5,6,11
P'thinaikos,3861,3,1,1,4,5,11,-6,4
Panionios,3861,4,1,1,4,4,10,-6,4
AEK Athens,3862,1,4,2,0,7,1,6,14
PAOK Salonik,3862,2,3,2,1,15,7,8,11
Panionios,3862,3,1,1,4,4,10,-6,4
P'thinaikos,3862,4,1,1,4,7,15,-8,4
AEK Athens,3863,1,4,2,0,7,1,6,14
PAOK Salonik,3863,2,3,2,1,11,5,6,11
P'thinaikos,3863,3,1,1,4,5,11,-6,4
Panionios,3863,4,1,1,4,4,10,-6,4
AEK Athens,3864,1,4,2,0,7,1,6,14
PAOK Salonik,3864,2,2,3,1,12,7,5,9
P'thinaikos,3864,3,1,2,3,7,12,-5,5
Panionios,3864,4,1,1,4,4,10,-6,4
AEK Athens,3865,1,4,2,0,7,1,6,14
PAOK Salonik,3865,2,2,3,1,9,4,5,9
P'thinaikos,3865,3,1,2,3,4,9,-5,5
Panionios,3865,4,1,1,4,4,10,-6,4
AEK Athens,3866,1,4,2,0,7,1,6,14
PAOK Salonik,3866,2,2,2,2,9,5,4,8
P'thinaikos,3866,3,2,1,3,5,9,-4,7
Panionios,3866,4,1,1,4,4,10,-6,4
AEK Athens,3867,1,4,2,0,7,1,6,14
PAOK Salonik,3867,2,2,2,2,10,6,4,8
P'thinaikos,3867,3,2,1,3,6,10,-4,7
Panionios,3867,4,1,1,4,4,10,-6,4
AEK Athens,3868,1,4,2,0,7,1,6,14
PAOK Salonik,3868,2,2,2,2,9,5,4,8
P'thinaikos,3868,3,2,1,3,5,9,-4,7
Panionios,3868,4,1,1,4,4,10,-6,4
AEK Athens,3869,1,4,2,0,7,1,6,14
PAOK Salonik,3869,2,3,2,1,10,4,6,11
P'thinaikos,3869,3,1,1,4,4,10,-6,4
Panionios,3869,3,1,1,4,4,10,-6,4
AEK Athens,3870,1,4,2,0,7,1,6,14
PAOK Salonik,3870,2,3,2,1,11,5,6,11
P'thinaikos,3870,3,1,1,4,5,11,-6,4
Panionios,3870,4,1,1,4,4,10,-6,4
AEK Athens,3871,1,4,2,0,7,1,6,14
PAOK Salonik,3871,2,3,2,1,10,4,6,11
P'thinaikos,3871,3,1,1,4,4,10,-6,4
Panionios,3871,3,1,1,4,4,10,-6,4
AEK Athens,3872,1,4,2,0,7,1,6,14
PAOK Salonik,3872,2,2,3,1,10,5,5,9
P'thinaikos,3872,3,1,2,3,5,10,-5,5
Panionios,3872,4,1,1,4,4,10,-6,4
AEK Athens,3873,1,4,2,0,7,1,6,14
PAOK Salonik,3873,2,3,2,1,11,4,7,11
Panionios,3873,3,1,1,4,4,10,-6,4
P'thinaikos,3873,4,1,1,4,4,11,-7,4
AEK Athens,3874,1,4,2,0,7,1,6,14
PAOK Salonik,3874,2,2,2,2,9,5,4,8
P'thinaikos,3874,3,2,1,3,5,9,-4,7
Panionios,3874,4,1,1,4,4,10,-6,4
AEK Athens,3875,1,4,2,0,7,1,6,14
PAOK Salonik,3875,2,3,2,1,11,5,6,11
P'thinaikos,3875,3,1,1,4,5,11,-6,4
Panionios,3875,4,1,1,4,4,10,-6,4
AEK Athens,3876,1,4,2,0,7,1,6,14
PAOK Salonik,3876,2,2,3,1,10,5,5,9
P'thinaikos,3876,3,1,2,3,5,10,-5,5
Panionios,3876,4,1,1,4,4,10,-6,4
AEK Athens,3877,1,4,2,0,7,1,6,14
PAOK Salonik,3877,2,2,2,2,9,5,4,8
P'thinaikos,3877,3,2,1,3,5,9,-4,7
Panionios,3877,4,1,1,4,4,10,-6,4
AEK Athens,3878,1,4,2,0,7,1,6,14
PAOK Salonik,3878,2,2,3,1,10,5,5,9
P'thinaikos,3878,3,1,2,3,5,10,-5,5
Panionios,3878,4,1,1,4,4,10,-6,4
AEK Athens,3879,1,4,2,0,7,1,6,14
PAOK Salonik,3879,2,3,2,1,10,4,6,11
P'thinaikos,3879,3,1,1,4,4,10,-6,4
Panionios,3879,3,1,1,4,4,10,-6,4
AEK Athens,3880,1,4,2,0,7,1,6,14
PAOK Salonik,3880,2,2,2,2,9,6,3,8
P'thinaikos,3880,3,2,1,3,6,9,-3,7
Panionios,3880,4,1,1,4,4,10,-6,4
AEK Athens,3881,1,4,2,0,7,1,6,14
PAOK Salonik,3881,2,2,3,1,9,4,5,9
P'thinaikos,3881,3,1,2,3,4,9,-5,5
Panionios,3881,4,1,1,4,4,10,-6,4
AEK Athens,3882,1,4,2,0,7,1,6,14
PAOK Salonik,3882,2,2,2,2,12,8,4,8
P'thinaikos,3882,3,2,1,3,8,12,-4,7
Panionios,3882,4,1,1,4,4,10,-6,4
AEK Athens,3883,1,4,2,0,7,1,6,14
PAOK Salonik,3883,2,3,2,1,11,4,7,11
Panionios,3883,3,1,1,4,4,10,-6,4
P'thinaikos,3883,4,1,1,4,4,11,-7,4
AEK Athens,3884,1,4,2,0,7,1,6,14
PAOK Salonik,3884,2,2,2,2,9,5,4,8
P'thinaikos,3884,3,2,1,3,5,9,-4,7
Panionios,3884,4,1,1,4,4,10,-6,4
AEK Athens,3885,1,4,2,0,7,1,6,14
PAOK Salonik,3885,2,3,2,1,13,6,7,11
Panionios,3885,3,1,1,4,4,10,-6,4
P'thinaikos,3885,4,1,1,4,6,13,-7,4
AEK Athens,3886,1,4,2,0,7,1,6,14
PAOK Salonik,3886,2,3,2,1,12,5,7,11
Panionios,3886,3,1,1,4,4,10,-6,4
P'thinaikos,3886,4,1,1,4,5,12,-7,4
AEK Athens,3887,1,4,2,0,7,1,6,14
PAOK Salonik,3887,2,3,2,1,11,5,6,11
P'thinaikos,3887,3,1,1,4,5,11,-6,4
Panionios,3887,4,1,1,4,4,10,-6,4
AEK Athens,3888,1,4,2,0,7,1,6,14
PAOK Salonik,3888,2,2,3,1,11,6,5,9
P'thinaikos,3888,3,1,2,3,6,11,-5,5
Panionios,3888,4,1,1,4,4,10,-6,4
AEK Athens,3889,1,4,2,0,7,1,6,14
PAOK Salonik,3889,2,3,2,1,10,4,6,11
P'thinaikos,3889,3,1,1,4,4,10,-6,4
Panionios,3889,3,1,1,4,4,10,-6,4
AEK Athens,3890,1,4,2,0,7,1,6,14
PAOK Salonik,3890,2,2,2,2,9,5,4,8
P'thinaikos,3890,3,2,1,3,5,9,-4,7
Panionios,3890,4,1,1,4,4,10,-6,4
AEK Athens,3891,1,4,2,0,7,1,6,14
PAOK Salonik,3891,2,3,2,1,13,7,6,11
P'thinaikos,3891,3,1,1,4,7,13,-6,4
Panionios,3891,4,1,1,4,4,10,-6,4
AEK Athens,3892,1,4,2,0,7,1,6,14
PAOK Salonik,3892,2,2,3,1,11,6,5,9
P'thinaikos,3892,3,1,2,3,6,11,-5,5
Panionios,3892,4,1,1,4,4,10,-6,4
AEK Athens,3893,1,4,2,0,7,1,6,14
PAOK Salonik,3893,2,3,2,1,12,4,8,11
Panionios,3893,3,1,1,4,4,10,-6,4
P'thinaikos,3893,4,1,1,4,4,12,-8,4
AEK Athens,3894,1,4,2,0,7,1,6,14
PAOK Salonik,3894,2,2,3,1,9,4,5,9
P'thinaikos,3894,3,1,2,3,4,9,-5,5
Panionios,3894,4,1,1,4,4,10,-6,4
AEK Athens,3895,1,4,2,0,7,1,6,14
PAOK Salonik,3895,2,3,2,1,10,4,6,11
P'thinaikos,3895,3,1,1,4,4,10,-6,4
Panionios,3895,3,1,1,4,4,10,-6,4
AEK Athens,3896,1,4,2,0,7,1,6,14
PAOK Salonik,3896,2,2,3,1,11,6,5,9
P'thinaikos,3896,3,1,2,3,6,11,-5,5
Panionios,3896,4,1,1,4,4,10,-6,4
AEK Athens,3897,1,4,2,0,7,1,6,14
PAOK Salonik,3897,2,2,3,1,10,5,5,9
P'thinaikos,3897,3,1,2,3,5,10,-5,5
Panionios,3897,4,1,1,4,4,10,-6,4
AEK Athens,3898,1,4,2,0,7,1,6,14
PAOK Salonik,3898,2,3,2,1,11,5,6,11
P'thinaikos,3898,3,1,1,4,5,11,-6,4
Panionios,3898,4,1,1,4,4,10,-6,4
AEK Athens,3899,1,4,2,0,7,1,6,14
PAOK Salonik,3899,2,3,2,1,12,6,6,11
P'thinaikos,3899,3,1,1,4,6,12,-6,4
Panionios,3899,4,1,1,4,4,10,-6,4
AEK Athens,3900,1,4,2,0,7,1,6,14
PAOK Salonik,3900,2,2,2,2,9,5,4,8
P'thinaikos,3900,3,2,1,3,5,9,-4,7
Panionios,3900,4,1,1,4,4,10,-6,4
AEK Athens,3901,1,4,2,0,7,1,6,14
PAOK Salonik,3901,2,3,2,1,10,4,6,11
P'thinaikos,3901,3,1,1,4,4,10,-6,4
Panionios,3901,3,1,1,4,4,10,-6,4
AEK Athens,3902,1,4,2,0,7,1,6,14
PAOK Salonik,3902,2,2,3,1,9,4,5,9
P'thinaikos,3902,3,1,2,3,4,9,-5,5
Panionios,3902,4,1,1,4,4,10,-6,4
AEK Athens,3903,1,4,2,0,7,1,6,14
PAOK Salonik,3903,2,3,2,1,10,4,6,11
P'thinaikos,3903,3,1,1,4,4,10,-6,4
Panionios,3903,3,1,1,4,4,10,-6,4
AEK Athens,3904,1,4,2,0,7,1,6,14
PAOK Salonik,3904,2,3,2,1,12,6,6,11
P'thinaikos,3904,3,1,1,4,6,12,-6,4
Panionios,3904,4,1,1,4,4,10,-6,4
AEK Athens,3905,1,4,2,0,7,1,6,14
PAOK Salonik,3905,2,3,2,1,10,4,6,11
P'thinaikos,3905,3,1,1,4,4,10,-6,4
Panionios,3905,3,1,1,4,4,10,-6,4
AEK Athens,3906,1,4,2,0,7,1,6,14
PAOK Salonik,3906,2,2,3,1,9,4,5,9
P'thinaikos,3906,3,1,2,3,4,9,-5,5
Panionios,3906,4,1,1,4,4,10,-6,4
AEK Athens,3907,1,4,2,0,7,1,6,14
PAOK Salonik,3907,2,3,2,1,11,5,6,11
P'thinaikos,3907,3,1,1,4,5,11,-6,4
Panionios,3907,4,1,1,4,4,10,-6,4
AEK Athens,3908,1,4,2,0,7,1,6,14
PAOK Salonik,3908,2,2,2,2,11,7,4,8
P'thinaikos,3908,3,2,1,3,7,11,-4,7
Panionios,3908,4,1,1,4,4,10,-6,4
AEK Athens,3909,1,4,2,0,7,1,6,14
PAOK Salonik,3909,2,2,3,1,9,4,5,9
P'thinaikos,3909,3,1,2,3,4,9,-5,5
Panionios,3909,4,1,1,4,4,10,-6,4
AEK Athens,3910,1,4,2,0,7,1,6,14
PAOK Salonik,3910,2,3,2,1,11,5,6,11
P'thinaikos,3910,3,1,1,4,5,11,-6,4
Panionios,3910,4,1,1,4,4,10,-6,4
AEK Athens,3911,1,4,2,0,7,1,6,14
PAOK Salonik,3911,2,2,2,2,9,5,4,8
P'thinaikos,3911,3,2,1,3,5,9,-4,7
Panionios,3911,4,1,1,4,4,10,-6,4
AEK Athens,3912,1,4,2,0,7,1,6,14
PAOK Salonik,3912,2,2,2,2,9,5,4,8
P'thinaikos,3912,3,2,1,3,5,9,-4,7
Panionios,3912,4,1,1,4,4,10,-6,4
AEK Athens,3913,1,4,2,0,7,1,6,14
PAOK Salonik,3913,2,2,3,1,10,5,5,9
P'thinaikos,3913,3,1,2,3,5,10,-5,5
Panionios,3913,4,1,1,4,4,10,-6,4
AEK Athens,3914,1,4,2,0,7,1,6,14
PAOK Salonik,3914,2,2,3,1,10,5,5,9
P'thinaikos,3914,3,1,2,3,5,10,-5,5
Panionios,3914,4,1,1,4,4,10,-6,4
AEK Athens,3915,1,4,2,0,7,1,6,14
PAOK Salonik,3915,2,3,2,1,10,4,6,11
P'thinaikos,3915,3,1,1,4,4,10,-6,4
Panionios,3915,3,1,1,4,4,10,-6,4
AEK Athens,3916,1,4,2,0,7,1,6,14
PAOK Salonik,3916,2,3,2,1,11,5,6,11
P'thinaikos,3916,3,1,1,4,5,11,-6,4
Panionios,3916,4,1,1,4,4,10,-6,4
AEK Athens,3917,1,4,2,0,7,1,6,14
PAOK Salonik,3917,2,2,2,2,9,8,1,8
P'thinaikos,3917,3,2,1,3,8,9,-1,7
Panionios,3917,4,1,1,4,4,10,-6,4
AEK Athens,3918,1,4,2,0,7,1,6,14
PAOK Salonik,3918,2,3,2,1,10,4,6,11
P'thinaikos,3918,3,1,1,4,4,10,-6,4
Panionios,3918,3,1,1,4,4,10,-6,4
AEK Athens,3919,1,4,2,0,7,1,6,14
PAOK Salonik,3919,2,3,2,1,11,4,7,11
Panionios,3919,3,1,1,4,4,10,-6,4
P'thinaikos,3919,4,1,1,4,4,11,-7,4
AEK Athens,3920,1,4,2,0,7,1,6,14
PAOK Salonik,3920,2,2,3,1,10,5,5,9
P'thinaikos,3920,3,1,2,3,5,10,-5,5
Panionios,3920,4,1,1,4,4,10,-6,4
AEK Athens,3921,1,4,2,0,7,1,6,14
PAOK Salonik,3921,2,3,2,1,10,4,6,11
P'thinaikos,3921,3,1,1,4,4,10,-6,4
Panionios,3921,3,1,1,4,4,10,-6,4
AEK Athens,3922,1,4,2,0,7,1,6,14
PAOK Salonik,3922,2,2,2,2,9,5,4,8
P'thinaikos,3922,3,2,1,3,5,9,-4,7
Panionios,3922,4,1,1,4,4,10,-6,4
AEK Athens,3923,1,4,2,0,7,1,6,14
PAOK Salonik,3923,2,2,3,1,10,5,5,9
P'thinaikos,3923,3,1,2,3,5,10,-5,5
Panionios,3923,4,1,1,4,4,10,-6,4
AEK Athens,3924,1,4,2,0,7,1,6,14
PAOK Salonik,3924,2,2,2,2,9,5,4,8
P'thinaikos,3924,3,2,1,3,5,9,-4,7
Panionios,3924,4,1,1,4,4,10,-6,4
AEK Athens,3925,1,4,2,0,7,1,6,14
PAOK Salonik,3925,2,2,2,2,10,6,4,8
P'thinaikos,3925,3,2,1,3,6,10,-4,7
Panionios,3925,4,1,1,4,4,10,-6,4
AEK Athens,3926,1,4,2,0,7,1,6,14
PAOK Salonik,3926,2,2,3,1,9,4,5,9
P'thinaikos,3926,3,1,2,3,4,9,-5,5
Panionios,3926,4,1,1,4,4,10,-6,4
AEK Athens,3927,1,4,2,0,7,1,6,14
PAOK Salonik,3927,2,2,3,1,10,5,5,9
P'thinaikos,3927,3,1,2,3,5,10,-5,5
Panionios,3927,4,1,1,4,4,10,-6,4
AEK Athens,3928,1,4,2,0,7,1,6,14
PAOK Salonik,3928,2,2,3,1,10,5,5,9
P'thinaikos,3928,3,1,2,3,5,10,-5,5
Panionios,3928,4,1,1,4,4,10,-6,4
AEK Athens,3929,1,4,2,0,7,1,6,14
PAOK Salonik,3929,2,3,2,1,10,4,6,11
P'thinaikos,3929,3,1,1,4,4,10,-6,4
Panionios,3929,3,1,1,4,4,10,-6,4
AEK Athens,3930,1,4,2,0,7,1,6,14
PAOK Salonik,3930,2,2,2,2,11,8,3,8
P'thinaikos,3930,3,2,1,3,8,11,-3,7
Panionios,3930,4,1,1,4,4,10,-6,4
AEK Athens,3931,1,4,2,0,7,1,6,14
PAOK Salonik,3931,2,2,3,1,10,5,5,9
P'thinaikos,3931,3,1,2,3,5,10,-5,5
Panionios,3931,4,1,1,4,4,10,-6,4
AEK Athens,3932,1,4,2,0,7,1,6,14
PAOK Salonik,3932,2,2,2,2,9,6,3,8
P'thinaikos,3932,3,2,1,3,6,9,-3,7
Panionios,3932,4,1,1,4,4,10,-6,4
AEK Athens,3933,1,4,2,0,7,1,6,14
PAOK Salonik,3933,2,2,2,2,11,7,4,8
P'thinaikos,3933,3,2,1,3,7,11,-4,7
Panionios,3933,4,1,1,4,4,10,-6,4
AEK Athens,3934,1,4,2,0,7,1,6,14
PAOK Salonik,3934,2,2,3,1,9,4,5,9
P'thinaikos,3934,3,1,2,3,4,9,-5,5
Panionios,3934,4,1,1,4,4,10,-6,4
AEK Athens,3935,1,4,2,0,7,1,6,14
PAOK Salonik,3935,2,3,2,1,10,4,6,11
P'thinaikos,3935,3,1,1,4,4,10,-6,4
Panionios,3935,3,1,1,4,4,10,-6,4
AEK Athens,3936,1,4,2,0,7,1,6,14
PAOK Salonik,3936,2,2,2,2,9,5,4,8
P'thinaikos,3936,3,2,1,3,5,9,-4,7
Panionios,3936,4,1,1,4,4,10,-6,4
AEK Athens,3937,1,4,2,0,7,1,6,14
PAOK Salonik,3937,2,2,3,1,11,6,5,9
P'thinaikos,3937,3,1,2,3,6,11,-5,5
Panionios,3937,4,1,1,4,4,10,-6,4
AEK Athens,3938,1,4,2,0,7,1,6,14
PAOK Salonik,3938,2,2,2,2,10,6,4,8
P'thinaikos,3938,3,2,1,3,6,10,-4,7
Panionios,3938,4,1,1,4,4,10,-6,4
AEK Athens,3939,1,4,2,0,7,1,6,14
PAOK Salonik,3939,2,3,2,1,12,5,7,11
Panionios,3939,3,1,1,4,4,10,-6,4
P'thinaikos,3939,4,1,1,4,5,12,-7,4
AEK Athens,3940,1,4,2,0,7,1,6,14
PAOK Salonik,3940,2,3,2,1,10,4,6,11
P'thinaikos,3940,3,1,1,4,4,10,-6,4
Panionios,3940,3,1,1,4,4,10,-6,4
AEK Athens,3941,1,4,2,0,7,1,6,14
PAOK Salonik,3941,2,2,2,2,9,5,4,8
P'thinaikos,3941,3,2,1,3,5,9,-4,7
Panionios,3941,4,1,1,4,4,10,-6,4
AEK Athens,3942,1,4,2,0,7,1,6,14
PAOK Salonik,3942,2,3,2,1,11,5,6,11
P'thinaikos,3942,3,1,1,4,5,11,-6,4
Panionios,3942,4,1,1,4,4,10,-6,4
AEK Athens,3943,1,4,2,0,7,1,6,14
PAOK Salonik,3943,2,2,3,1,11,6,5,9
P'thinaikos,3943,3,1,2,3,6,11,-5,5
Panionios,3943,4,1,1,4,4,10,-6,4
AEK Athens,3944,1,4,2,0,7,1,6,14
PAOK Salonik,3944,2,3,2,1,11,4,7,11
Panionios,3944,3,1,1,4,4,10,-6,4
P'thinaikos,3944,4,1,1,4,4,11,-7,4
AEK Athens,3945,1,4,2,0,7,1,6,14
PAOK Salonik,3945,2,2,2,2,10,6,4,8
P'thinaikos,3945,3,2,1,3,6,10,-4,7
Panionios,3945,4,1,1,4,4,10,-6,4
AEK Athens,3946,1,4,2,0,7,1,6,14
PAOK Salonik,3946,2,3,2,1,11,4,7,11
Panionios,3946,3,1,1,4,4,10,-6,4
P'thinaikos,3946,4,1,1,4,4,11,-7,4
AEK Athens,3947,1,4,2,0,7,1,6,14
PAOK Salonik,3947,2,2,3,1,10,5,5,9
P'thinaikos,3947,3,1,2,3,5,10,-5,5
Panionios,3947,4,1,1,4,4,10,-6,4
AEK Athens,3948,1,4,2,0,7,1,6,14
PAOK Salonik,3948,2,2,2,2,9,7,2,8
P'thinaikos,3948,3,2,1,3,7,9,-2,7
Panionios,3948,4,1,1,4,4,10,-6,4
AEK Athens,3949,1,4,2,0,7,1,6,14
PAOK Salonik,3949,2,2,2,2,9,7,2,8
P'thinaikos,3949,3,2,1,3,7,9,-2,7
Panionios,3949,4,1,1,4,4,10,-6,4
AEK Athens,3950,1,4,2,0,7,1,6,14
PAOK Salonik,3950,2,2,3,1,12,7,5,9
P'thinaikos,3950,3,1,2,3,7,12,-5,5
Panionios,3950,4,1,1,4,4,10,-6,4
AEK Athens,3951,1,4,2,0,7,1,6,14
PAOK Salonik,3951,2,2,2,2,10,6,4,8
P'thinaikos,3951,3,2,1,3,6,10,-4,7
Panionios,3951,4,1,1,4,4,10,-6,4
AEK Athens,3952,1,4,2,0,7,1,6,14
PAOK Salonik,3952,2,3,2,1,10,4,6,11
P'thinaikos,3952,3,1,1,4,4,10,-6,4
Panionios,3952,3,1,1,4,4,10,-6,4
AEK Athens,3953,1,4,2,0,7,1,6,14
PAOK Salonik,3953,2,2,3,1,9,4,5,9
P'thinaikos,3953,3,1,2,3,4,9,-5,5
Panionios,3953,4,1,1,4,4,10,-6,4
AEK Athens,3954,1,4,2,0,7,1,6,14
PAOK Salonik,3954,2,2,3,1,10,5,5,9
P'thinaikos,3954,3,1,2,3,5,10,-5,5
Panionios,3954,4,1,1,4,4,10,-6,4
AEK Athens,3955,1,4,2,0,7,1,6,14
PAOK Salonik,3955,2,2,2,2,9,5,4,8
P'thinaikos,3955,3,2,1,3,5,9,-4,7
Panionios,3955,4,1,1,4,4,10,-6,4
AEK Athens,3956,1,4,2,0,7,1,6,14
PAOK Salonik,3956,2,2,3,1,9,4,5,9
P'thinaikos,3956,3,1,2,3,4,9,-5,5
Panionios,3956,4,1,1,4,4,10,-6,4
AEK Athens,3957,1,4,2,0,7,1,6,14
PAOK Salonik,3957,2,2,2,2,10,6,4,8
P'thinaikos,3957,3,2,1,3,6,10,-4,7
Panionios,3957,4,1,1,4,4,10,-6,4
AEK Athens,3958,1,4,2,0,7,1,6,14
PAOK Salonik,3958,2,2,3,1,9,4,5,9
P'thinaikos,3958,3,1,2,3,4,9,-5,5
Panionios,3958,4,1,1,4,4,10,-6,4
AEK Athens,3959,1,4,2,0,7,1,6,14
PAOK Salonik,3959,2,2,3,1,10,5,5,9
P'thinaikos,3959,3,1,2,3,5,10,-5,5
Panionios,3959,4,1,1,4,4,10,-6,4
AEK Athens,3960,1,4,2,0,7,1,6,14
PAOK Salonik,3960,2,2,3,1,10,5,5,9
P'thinaikos,3960,3,1,2,3,5,10,-5,5
Panionios,3960,4,1,1,4,4,10,-6,4
AEK Athens,3961,1,4,2,0,7,1,6,14
PAOK Salonik,3961,2,2,2,2,9,6,3,8
P'thinaikos,3961,3,2,1,3,6,9,-3,7
Panionios,3961,4,1,1,4,4,10,-6,4
AEK Athens,3962,1,4,2,0,7,1,6,14
PAOK Salonik,3962,2,2,3,1,12,7,5,9
P'thinaikos,3962,3,1,2,3,7,12,-5,5
Panionios,3962,4,1,1,4,4,10,-6,4
AEK Athens,3963,1,4,2,0,7,1,6,14
PAOK Salonik,3963,2,2,2,2,9,7,2,8
P'thinaikos,3963,3,2,1,3,7,9,-2,7
Panionios,3963,4,1,1,4,4,10,-6,4
AEK Athens,3964,1,4,2,0,7,1,6,14
PAOK Salonik,3964,2,2,2,2,9,6,3,8
P'thinaikos,3964,3,2,1,3,6,9,-3,7
Panionios,3964,4,1,1,4,4,10,-6,4
AEK Athens,3965,1,4,2,0,7,1,6,14
PAOK Salonik,3965,2,2,2,2,10,6,4,8
P'thinaikos,3965,3,2,1,3,6,10,-4,7
Panionios,3965,4,1,1,4,4,10,-6,4
AEK Athens,3966,1,4,2,0,7,1,6,14
PAOK Salonik,3966,2,2,2,2,11,7,4,8
P'thinaikos,3966,3,2,1,3,7,11,-4,7
Panionios,3966,4,1,1,4,4,10,-6,4
AEK Athens,3967,1,4,2,0,7,1,6,14
PAOK Salonik,3967,2,2,2,2,12,9,3,8
P'thinaikos,3967,3,2,1,3,9,12,-3,7
Panionios,3967,4,1,1,4,4,10,-6,4
AEK Athens,3968,1,4,2,0,7,1,6,14
PAOK Salonik,3968,2,2,2,2,9,5,4,8
P'thinaikos,3968,3,2,1,3,5,9,-4,7
Panionios,3968,4,1,1,4,4,10,-6,4
AEK Athens,3969,1,4,2,0,7,1,6,14
PAOK Salonik,3969,2,2,2,2,11,7,4,8
P'thinaikos,3969,3,2,1,3,7,11,-4,7
Panionios,3969,4,1,1,4,4,10,-6,4
AEK Athens,3970,1,4,2,0,7,1,6,14
PAOK Salonik,3970,2,2,2,2,10,6,4,8
P'thinaikos,3970,3,2,1,3,6,10,-4,7
Panionios,3970,4,1,1,4,4,10,-6,4
AEK Athens,3971,1,4,2,0,7,1,6,14
PAOK Salonik,3971,2,2,3,1,9,4,5,9
P'thinaikos,3971,3,1,2,3,4,9,-5,5
Panionios,3971,4,1,1,4,4,10,-6,4
AEK Athens,3972,1,4,2,0,7,1,6,14
PAOK Salonik,3972,2,3,2,1,13,6,7,11
Panionios,3972,3,1,1,4,4,10,-6,4
P'thinaikos,3972,4,1,1,4,6,13,-7,4
AEK Athens,3973,1,4,2,0,7,1,6,14
PAOK Salonik,3973,2,2,3,1,9,4,5,9
P'thinaikos,3973,3,1,2,3,4,9,-5,5
Panionios,3973,4,1,1,4,4,10,-6,4
AEK Athens,3974,1,4,2,0,7,1,6,14
PAOK Salonik,3974,2,3,2,1,10,4,6,11
P'thinaikos,3974,3,1,1,4,4,10,-6,4
Panionios,3974,3,1,1,4,4,10,-6,4
AEK Athens,3975,1,4,2,0,7,1,6,14
PAOK Salonik,3975,2,2,3,1,10,5,5,9
P'thinaikos,3975,3,1,2,3,5,10,-5,5
Panionios,3975,4,1,1,4,4,10,-6,4
AEK Athens,3976,1,4,2,0,7,1,6,14
PAOK Salonik,3976,2,2,3,1,11,6,5,9
P'thinaikos,3976,3,1,2,3,6,11,-5,5
Panionios,3976,4,1,1,4,4,10,-6,4
AEK Athens,3977,1,4,2,0,7,1,6,14
PAOK Salonik,3977,2,2,2,2,9,5,4,8
P'thinaikos,3977,3,2,1,3,5,9,-4,7
Panionios,3977,4,1,1,4,4,10,-6,4
AEK Athens,3978,1,4,2,0,7,1,6,14
PAOK Salonik,3978,2,2,3,1,10,5,5,9
P'thinaikos,3978,3,1,2,3,5,10,-5,5
Panionios,3978,4,1,1,4,4,10,-6,4
AEK Athens,3979,1,4,2,0,7,1,6,14
PAOK Salonik,3979,2,2,2,2,10,7,3,8
P'thinaikos,3979,3,2,1,3,7,10,-3,7
Panionios,3979,4,1,1,4,4,10,-6,4
AEK Athens,3980,1,4,2,0,7,1,6,14
PAOK Salonik,3980,2,2,3,1,13,8,5,9
P'thinaikos,3980,3,1,2,3,8,13,-5,5
Panionios,3980,4,1,1,4,4,10,-6,4
AEK Athens,3981,1,4,2,0,7,1,6,14
PAOK Salonik,3981,2,3,2,1,11,4,7,11
Panionios,3981,3,1,1,4,4,10,-6,4
P'thinaikos,3981,4,1,1,4,4,11,-7,4
AEK Athens,3982,1,4,2,0,7,1,6,14
PAOK Salonik,3982,2,2,2,2,10,6,4,8
P'thinaikos,3982,3,2,1,3,6,10,-4,7
Panionios,3982,4,1,1,4,4,10,-6,4
AEK Athens,3983,1,4,2,0,7,1,6,14
PAOK Salonik,3983,2,3,2,1,10,4,6,11
P'thinaikos,3983,3,1,1,4,4,10,-6,4
Panionios,3983,3,1,1,4,4,10,-6,4
AEK Athens,3984,1,4,2,0,7,1,6,14
PAOK Salonik,3984,2,2,3,1,9,4,5,9
P'thinaikos,3984,3,1,2,3,4,9,-5,5
Panionios,3984,4,1,1,4,4,10,-6,4
AEK Athens,3985,1,4,2,0,7,1,6,14
PAOK Salonik,3985,2,2,2,2,9,6,3,8
P'thinaikos,3985,3,2,1,3,6,9,-3,7
Panionios,3985,4,1,1,4,4,10,-6,4
AEK Athens,3986,1,4,2,0,7,1,6,14
PAOK Salonik,3986,2,2,2,2,9,7,2,8
P'thinaikos,3986,3,2,1,3,7,9,-2,7
Panionios,3986,4,1,1,4,4,10,-6,4
AEK Athens,3987,1,4,2,0,7,1,6,14
PAOK Salonik,3987,2,2,3,1,9,4,5,9
P'thinaikos,3987,3,1,2,3,4,9,-5,5
Panionios,3987,4,1,1,4,4,10,-6,4
AEK Athens,3988,1,4,2,0,7,1,6,14
PAOK Salonik,3988,2,2,3,1,10,5,5,9
P'thinaikos,3988,3,1,2,3,5,10,-5,5
Panionios,3988,4,1,1,4,4,10,-6,4
AEK Athens,3989,1,4,2,0,7,1,6,14
PAOK Salonik,3989,2,2,3,1,9,4,5,9
P'thinaikos,3989,3,1,2,3,4,9,-5,5
Panionios,3989,4,1,1,4,4,10,-6,4
AEK Athens,3990,1,4,2,0,7,1,6,14
PAOK Salonik,3990,2,3,2,1,11,5,6,11
P'thinaikos,3990,3,1,1,4,5,11,-6,4
Panionios,3990,4,1,1,4,4,10,-6,4
AEK Athens,3991,1,4,2,0,7,1,6,14
PAOK Salonik,3991,2,2,3,1,10,5,5,9
P'thinaikos,3991,3,1,2,3,5,10,-5,5
Panionios,3991,4,1,1,4,4,10,-6,4
AEK Athens,3992,1,4,2,0,7,1,6,14
PAOK Salonik,3992,2,2,3,1,10,5,5,9
P'thinaikos,3992,3,1,2,3,5,10,-5,5
Panionios,3992,4,1,1,4,4,10,-6,4
AEK Athens,3993,1,4,2,0,7,1,6,14
PAOK Salonik,3993,2,2,3,1,9,4,5,9
P'thinaikos,3993,3,1,2,3,4,9,-5,5
Panionios,3993,4,1,1,4,4,10,-6,4
AEK Athens,3994,1,4,2,0,7,1,6,14
PAOK Salonik,3994,2,2,3,1,11,6,5,9
P'thinaikos,3994,3,1,2,3,6,11,-5,5
Panionios,3994,4,1,1,4,4,10,-6,4
AEK Athens,3995,1,4,2,0,7,1,6,14
PAOK Salonik,3995,2,2,3,1,9,4,5,9
P'thinaikos,3995,3,1,2,3,4,9,-5,5
Panionios,3995,4,1,1,4,4,10,-6,4
AEK Athens,3996,1,4,2,0,7,1,6,14
PAOK Salonik,3996,2,2,3,1,10,5,5,9
P'thinaikos,3996,3,1,2,3,5,10,-5,5
Panionios,3996,4,1,1,4,4,10,-6,4
AEK Athens,3997,1,4,2,0,7,1,6,14
PAOK Salonik,3997,2,3,2,1,11,4,7,11
Panionios,3997,3,1,1,4,4,10,-6,4
P'thinaikos,3997,4,1,1,4,4,11,-7,4
AEK Athens,3998,1,4,2,0,7,1,6,14
PAOK Salonik,3998,2,3,2,1,14,5,9,11
Panionios,3998,3,1,1,4,4,10,-6,4
P'thinaikos,3998,4,1,1,4,5,14,-9,4
AEK Athens,3999,1,4,2,0,7,1,6,14
PAOK Salonik,3999,2,2,3,1,9,4,5,9
P'thinaikos,3999,3,1,2,3,4,9,-5,5
Panionios,3999,4,1,1,4,4,10,-6,4
AEK Athens,4000,1,4,2,0,7,1,6,14
PAOK Salonik,4000,2,2,3,1,9,4,5,9
P'thinaikos,4000,3,1,2,3,4,9,-5,5
Panionios,4000,4,1,1,4,4,10,-6,4
AEK Athens,4001,1,4,2,0,7,1,6,14
PAOK Salonik,4001,2,3,2,1,14,5,9,11
Panionios,4001,3,1,1,4,4,10,-6,4
P'thinaikos,4001,4,1,1,4,5,14,-9,4
AEK Athens,4002,1,4,2,0,7,1,6,14
PAOK Salonik,4002,2,2,2,2,9,6,3,8
P'thinaikos,4002,3,2,1,3,6,9,-3,7
Panionios,4002,4,1,1,4,4,10,-6,4
AEK Athens,4003,1,4,2,0,7,1,6,14
PAOK Salonik,4003,2,2,2,2,10,6,4,8
P'thinaikos,4003,3,2,1,3,6,10,-4,7
Panionios,4003,4,1,1,4,4,10,-6,4
AEK Athens,4004,1,4,2,0,7,1,6,14
PAOK Salonik,4004,2,3,2,1,11,5,6,11
P'thinaikos,4004,3,1,1,4,5,11,-6,4
Panionios,4004,4,1,1,4,4,10,-6,4
AEK Athens,4005,1,4,2,0,7,1,6,14
PAOK Salonik,4005,2,3,2,1,13,4,9,11
Panionios,4005,3,1,1,4,4,10,-6,4
P'thinaikos,4005,4,1,1,4,4,13,-9,4
AEK Athens,4006,1,4,2,0,7,1,6,14
PAOK Salonik,4006,2,2,3,1,9,4,5,9
P'thinaikos,4006,3,1,2,3,4,9,-5,5
Panionios,4006,4,1,1,4,4,10,-6,4
AEK Athens,4007,1,4,2,0,7,1,6,14
PAOK Salonik,4007,2,2,3,1,10,5,5,9
P'thinaikos,4007,3,1,2,3,5,10,-5,5
Panionios,4007,4,1,1,4,4,10,-6,4
AEK Athens,4008,1,4,2,0,7,1,6,14
PAOK Salonik,4008,2,3,2,1,10,4,6,11
P'thinaikos,4008,3,1,1,4,4,10,-6,4
Panionios,4008,3,1,1,4,4,10,-6,4
AEK Athens,4009,1,4,2,0,7,1,6,14
PAOK Salonik,4009,2,3,2,1,11,4,7,11
Panionios,4009,3,1,1,4,4,10,-6,4
P'thinaikos,4009,4,1,1,4,4,11,-7,4
AEK Athens,4010,1,4,2,0,7,1,6,14
PAOK Salonik,4010,2,3,2,1,11,5,6,11
P'thinaikos,4010,3,1,1,4,5,11,-6,4
Panionios,4010,4,1,1,4,4,10,-6,4
AEK Athens,4011,1,4,2,0,7,1,6,14
PAOK Salonik,4011,2,2,3,1,11,6,5,9
P'thinaikos,4011,3,1,2,3,6,11,-5,5
Panionios,4011,4,1,1,4,4,10,-6,4
AEK Athens,4012,1,4,2,0,7,1,6,14
PAOK Salonik,4012,2,3,2,1,11,5,6,11
P'thinaikos,4012,3,1,1,4,5,11,-6,4
Panionios,4012,4,1,1,4,4,10,-6,4
AEK Athens,4013,1,4,2,0,7,1,6,14
PAOK Salonik,4013,2,2,2,2,9,5,4,8
P'thinaikos,4013,3,2,1,3,5,9,-4,7
Panionios,4013,4,1,1,4,4,10,-6,4
AEK Athens,4014,1,4,2,0,7,1,6,14
PAOK Salonik,4014,2,2,2,2,10,7,3,8
P'thinaikos,4014,3,2,1,3,7,10,-3,7
Panionios,4014,4,1,1,4,4,10,-6,4
AEK Athens,4015,1,4,2,0,7,1,6,14
PAOK Salonik,4015,2,2,2,2,9,5,4,8
P'thinaikos,4015,3,2,1,3,5,9,-4,7
Panionios,4015,4,1,1,4,4,10,-6,4
AEK Athens,4016,1,4,2,0,7,1,6,14
PAOK Salonik,4016,2,2,3,1,12,7,5,9
P'thinaikos,4016,3,1,2,3,7,12,-5,5
Panionios,4016,4,1,1,4,4,10,-6,4
AEK Athens,4017,1,4,2,0,7,1,6,14
PAOK Salonik,4017,2,2,2,2,10,6,4,8
P'thinaikos,4017,3,2,1,3,6,10,-4,7
Panionios,4017,4,1,1,4,4,10,-6,4
AEK Athens,4018,1,4,2,0,7,1,6,14
PAOK Salonik,4018,2,2,3,1,9,4,5,9
P'thinaikos,4018,3,1,2,3,4,9,-5,5
Panionios,4018,4,1,1,4,4,10,-6,4
AEK Athens,4019,1,4,2,0,7,1,6,14
PAOK Salonik,4019,2,3,2,1,11,4,7,11
Panionios,4019,3,1,1,4,4,10,-6,4
P'thinaikos,4019,4,1,1,4,4,11,-7,4
AEK Athens,4020,1,4,2,0,7,1,6,14
PAOK Salonik,4020,2,3,2,1,10,4,6,11
P'thinaikos,4020,3,1,1,4,4,10,-6,4
Panionios,4020,3,1,1,4,4,10,-6,4
AEK Athens,4021,1,4,2,0,7,1,6,14
PAOK Salonik,4021,2,3,2,1,10,4,6,11
P'thinaikos,4021,3,1,1,4,4,10,-6,4
Panionios,4021,3,1,1,4,4,10,-6,4
AEK Athens,4022,1,4,2,0,7,1,6,14
PAOK Salonik,4022,2,2,3,1,10,5,5,9
P'thinaikos,4022,3,1,2,3,5,10,-5,5
Panionios,4022,4,1,1,4,4,10,-6,4
AEK Athens,4023,1,4,2,0,7,1,6,14
PAOK Salonik,4023,2,2,3,1,9,4,5,9
P'thinaikos,4023,3,1,2,3,4,9,-5,5
Panionios,4023,4,1,1,4,4,10,-6,4
AEK Athens,4024,1,4,2,0,7,1,6,14
PAOK Salonik,4024,2,2,2,2,10,6,4,8
P'thinaikos,4024,3,2,1,3,6,10,-4,7
Panionios,4024,4,1,1,4,4,10,-6,4
AEK Athens,4025,1,4,2,0,7,1,6,14
PAOK Salonik,4025,2,3,2,1,11,4,7,11
Panionios,4025,3,1,1,4,4,10,-6,4
P'thinaikos,4025,4,1,1,4,4,11,-7,4
AEK Athens,4026,1,4,2,0,7,1,6,14
PAOK Salonik,4026,2,2,3,1,10,5,5,9
P'thinaikos,4026,3,1,2,3,5,10,-5,5
Panionios,4026,4,1,1,4,4,10,-6,4
AEK Athens,4027,1,4,2,0,7,1,6,14
PAOK Salonik,4027,2,2,2,2,11,7,4,8
P'thinaikos,4027,3,2,1,3,7,11,-4,7
Panionios,4027,4,1,1,4,4,10,-6,4
AEK Athens,4028,1,4,2,0,7,1,6,14
PAOK Salonik,4028,2,3,2,1,11,4,7,11
Panionios,4028,3,1,1,4,4,10,-6,4
P'thinaikos,4028,4,1,1,4,4,11,-7,4
AEK Athens,4029,1,4,2,0,7,1,6,14
PAOK Salonik,4029,2,3,2,1,13,4,9,11
Panionios,4029,3,1,1,4,4,10,-6,4
P'thinaikos,4029,4,1,1,4,4,13,-9,4
AEK Athens,4030,1,4,2,0,7,1,6,14
PAOK Salonik,4030,2,2,2,2,9,6,3,8
P'thinaikos,4030,3,2,1,3,6,9,-3,7
Panionios,4030,4,1,1,4,4,10,-6,4
AEK Athens,4031,1,4,2,0,7,1,6,14
PAOK Salonik,4031,2,3,2,1,10,4,6,11
P'thinaikos,4031,3,1,1,4,4,10,-6,4
Panionios,4031,3,1,1,4,4,10,-6,4
AEK Athens,4032,1,4,2,0,7,1,6,14
PAOK Salonik,4032,2,3,2,1,11,4,7,11
Panionios,4032,3,1,1,4,4,10,-6,4
P'thinaikos,4032,4,1,1,4,4,11,-7,4
AEK Athens,4033,1,4,2,0,7,1,6,14
PAOK Salonik,4033,2,3,2,1,11,5,6,11
P'thinaikos,4033,3,1,1,4,5,11,-6,4
Panionios,4033,4,1,1,4,4,10,-6,4
AEK Athens,4034,1,4,2,0,7,1,6,14
PAOK Salonik,4034,2,2,3,1,10,5,5,9
P'thinaikos,4034,3,1,2,3,5,10,-5,5
Panionios,4034,4,1,1,4,4,10,-6,4
AEK Athens,4035,1,4,2,0,7,1,6,14
PAOK Salonik,4035,2,2,2,2,10,6,4,8
P'thinaikos,4035,3,2,1,3,6,10,-4,7
Panionios,4035,4,1,1,4,4,10,-6,4
AEK Athens,4036,1,4,2,0,7,1,6,14
PAOK Salonik,4036,2,2,3,1,10,5,5,9
P'thinaikos,4036,3,1,2,3,5,10,-5,5
Panionios,4036,4,1,1,4,4,10,-6,4
AEK Athens,4037,1,4,2,0,7,1,6,14
PAOK Salonik,4037,2,2,3,1,10,5,5,9
P'thinaikos,4037,3,1,2,3,5,10,-5,5
Panionios,4037,4,1,1,4,4,10,-6,4
AEK Athens,4038,1,4,2,0,7,1,6,14
PAOK Salonik,4038,2,2,2,2,9,8,1,8
P'thinaikos,4038,3,2,1,3,8,9,-1,7
Panionios,4038,4,1,1,4,4,10,-6,4
AEK Athens,4039,1,4,2,0,7,1,6,14
PAOK Salonik,4039,2,2,2,2,9,5,4,8
P'thinaikos,4039,3,2,1,3,5,9,-4,7
Panionios,4039,4,1,1,4,4,10,-6,4
AEK Athens,4040,1,4,2,0,7,1,6,14
PAOK Salonik,4040,2,2,2,2,9,5,4,8
P'thinaikos,4040,3,2,1,3,5,9,-4,7
Panionios,4040,4,1,1,4,4,10,-6,4
AEK Athens,4041,1,4,2,0,7,1,6,14
PAOK Salonik,4041,2,3,2,1,11,5,6,11
P'thinaikos,4041,3,1,1,4,5,11,-6,4
Panionios,4041,4,1,1,4,4,10,-6,4
AEK Athens,4042,1,4,2,0,7,1,6,14
PAOK Salonik,4042,2,3,2,1,10,4,6,11
P'thinaikos,4042,3,1,1,4,4,10,-6,4
Panionios,4042,3,1,1,4,4,10,-6,4
AEK Athens,4043,1,4,2,0,7,1,6,14
PAOK Salonik,4043,2,3,2,1,11,5,6,11
P'thinaikos,4043,3,1,1,4,5,11,-6,4
Panionios,4043,4,1,1,4,4,10,-6,4
AEK Athens,4044,1,4,2,0,7,1,6,14
PAOK Salonik,4044,2,2,2,2,10,6,4,8
P'thinaikos,4044,3,2,1,3,6,10,-4,7
Panionios,4044,4,1,1,4,4,10,-6,4
AEK Athens,4045,1,4,2,0,7,1,6,14
PAOK Salonik,4045,2,2,2,2,9,6,3,8
P'thinaikos,4045,3,2,1,3,6,9,-3,7
Panionios,4045,4,1,1,4,4,10,-6,4
AEK Athens,4046,1,4,2,0,7,1,6,14
PAOK Salonik,4046,2,3,2,1,12,4,8,11
Panionios,4046,3,1,1,4,4,10,-6,4
P'thinaikos,4046,4,1,1,4,4,12,-8,4
AEK Athens,4047,1,4,2,0,7,1,6,14
PAOK Salonik,4047,2,2,2,2,9,7,2,8
P'thinaikos,4047,3,2,1,3,7,9,-2,7
Panionios,4047,4,1,1,4,4,10,-6,4
AEK Athens,4048,1,4,2,0,7,1,6,14
PAOK Salonik,4048,2,2,3,1,10,5,5,9
P'thinaikos,4048,3,1,2,3,5,10,-5,5
Panionios,4048,4,1,1,4,4,10,-6,4
AEK Athens,4049,1,4,2,0,7,1,6,14
PAOK Salonik,4049,2,2,3,1,10,5,5,9
P'thinaikos,4049,3,1,2,3,5,10,-5,5
Panionios,4049,4,1,1,4,4,10,-6,4
AEK Athens,4050,1,4,2,0,7,1,6,14
PAOK Salonik,4050,2,2,3,1,9,4,5,9
P'thinaikos,4050,3,1,2,3,4,9,-5,5
Panionios,4050,4,1,1,4,4,10,-6,4
AEK Athens,4051,1,4,2,0,7,1,6,14
PAOK Salonik,4051,2,2,2,2,10,7,3,8
P'thinaikos,4051,3,2,1,3,7,10,-3,7
Panionios,4051,4,1,1,4,4,10,-6,4
AEK Athens,4052,1,4,2,0,7,1,6,14
PAOK Salonik,4052,2,3,2,1,11,4,7,11
Panionios,4052,3,1,1,4,4,10,-6,4
P'thinaikos,4052,4,1,1,4,4,11,-7,4
AEK Athens,4053,1,4,2,0,7,1,6,14
PAOK Salonik,4053,2,2,2,2,9,7,2,8
P'thinaikos,4053,3,2,1,3,7,9,-2,7
Panionios,4053,4,1,1,4,4,10,-6,4
AEK Athens,4054,1,4,2,0,7,1,6,14
PAOK Salonik,4054,2,2,3,1,10,5,5,9
P'thinaikos,4054,3,1,2,3,5,10,-5,5
Panionios,4054,4,1,1,4,4,10,-6,4
AEK Athens,4055,1,4,2,0,7,1,6,14
PAOK Salonik,4055,2,2,2,2,9,7,2,8
P'thinaikos,4055,3,2,1,3,7,9,-2,7
Panionios,4055,4,1,1,4,4,10,-6,4
AEK Athens,4056,1,4,2,0,7,1,6,14
PAOK Salonik,4056,2,2,2,2,10,6,4,8
P'thinaikos,4056,3,2,1,3,6,10,-4,7
Panionios,4056,4,1,1,4,4,10,-6,4
AEK Athens,4057,1,4,2,0,7,1,6,14
PAOK Salonik,4057,2,2,2,2,9,5,4,8
P'thinaikos,4057,3,2,1,3,5,9,-4,7
Panionios,4057,4,1,1,4,4,10,-6,4
AEK Athens,4058,1,4,2,0,7,1,6,14
PAOK Salonik,4058,2,2,3,1,11,6,5,9
P'thinaikos,4058,3,1,2,3,6,11,-5,5
Panionios,4058,4,1,1,4,4,10,-6,4
AEK Athens,4059,1,4,2,0,7,1,6,14
PAOK Salonik,4059,2,2,3,1,10,5,5,9
P'thinaikos,4059,3,1,2,3,5,10,-5,5
Panionios,4059,4,1,1,4,4,10,-6,4
AEK Athens,4060,1,4,2,0,7,1,6,14
PAOK Salonik,4060,2,2,3,1,10,5,5,9
P'thinaikos,4060,3,1,2,3,5,10,-5,5
Panionios,4060,4,1,1,4,4,10,-6,4
AEK Athens,4061,1,4,2,0,7,1,6,14
PAOK Salonik,4061,2,3,2,1,10,4,6,11
P'thinaikos,4061,3,1,1,4,4,10,-6,4
Panionios,4061,3,1,1,4,4,10,-6,4
AEK Athens,4062,1,4,2,0,7,1,6,14
PAOK Salonik,4062,2,2,3,1,9,4,5,9
P'thinaikos,4062,3,1,2,3,4,9,-5,5
Panionios,4062,4,1,1,4,4,10,-6,4
AEK Athens,4063,1,4,2,0,7,1,6,14
PAOK Salonik,4063,2,2,2,2,10,7,3,8
P'thinaikos,4063,3,2,1,3,7,10,-3,7
Panionios,4063,4,1,1,4,4,10,-6,4
AEK Athens,4064,1,4,2,0,7,1,6,14
PAOK Salonik,4064,2,2,2,2,10,6,4,8
P'thinaikos,4064,3,2,1,3,6,10,-4,7
Panionios,4064,4,1,1,4,4,10,-6,4
AEK Athens,4065,1,4,2,0,7,1,6,14
PAOK Salonik,4065,2,3,2,1,11,4,7,11
Panionios,4065,3,1,1,4,4,10,-6,4
P'thinaikos,4065,4,1,1,4,4,11,-7,4
AEK Athens,4066,1,4,2,0,7,1,6,14
PAOK Salonik,4066,2,2,3,1,9,4,5,9
P'thinaikos,4066,3,1,2,3,4,9,-5,5
Panionios,4066,4,1,1,4,4,10,-6,4
AEK Athens,4067,1,4,2,0,7,1,6,14
PAOK Salonik,4067,2,2,3,1,10,5,5,9
P'thinaikos,4067,3,1,2,3,5,10,-5,5
Panionios,4067,4,1,1,4,4,10,-6,4
AEK Athens,4068,1,4,2,0,7,1,6,14
PAOK Salonik,4068,2,3,2,1,11,5,6,11
P'thinaikos,4068,3,1,1,4,5,11,-6,4
Panionios,4068,4,1,1,4,4,10,-6,4
AEK Athens,4069,1,4,2,0,7,1,6,14
PAOK Salonik,4069,2,3,2,1,11,4,7,11
Panionios,4069,3,1,1,4,4,10,-6,4
P'thinaikos,4069,4,1,1,4,4,11,-7,4
AEK Athens,4070,1,4,2,0,7,1,6,14
PAOK Salonik,4070,2,2,2,2,11,8,3,8
P'thinaikos,4070,3,2,1,3,8,11,-3,7
Panionios,4070,4,1,1,4,4,10,-6,4
AEK Athens,4071,1,4,2,0,7,1,6,14
PAOK Salonik,4071,2,2,2,2,9,5,4,8
P'thinaikos,4071,3,2,1,3,5,9,-4,7
Panionios,4071,4,1,1,4,4,10,-6,4
AEK Athens,4072,1,4,2,0,7,1,6,14
PAOK Salonik,4072,2,3,2,1,12,6,6,11
P'thinaikos,4072,3,1,1,4,6,12,-6,4
Panionios,4072,4,1,1,4,4,10,-6,4
AEK Athens,4073,1,4,2,0,7,1,6,14
PAOK Salonik,4073,2,3,2,1,15,7,8,11
Panionios,4073,3,1,1,4,4,10,-6,4
P'thinaikos,4073,4,1,1,4,7,15,-8,4
AEK Athens,4074,1,4,2,0,7,1,6,14
PAOK Salonik,4074,2,3,2,1,10,4,6,11
P'thinaikos,4074,3,1,1,4,4,10,-6,4
Panionios,4074,3,1,1,4,4,10,-6,4
AEK Athens,4075,1,4,2,0,7,1,6,14
PAOK Salonik,4075,2,2,2,2,9,5,4,8
P'thinaikos,4075,3,2,1,3,5,9,-4,7
Panionios,4075,4,1,1,4,4,10,-6,4
AEK Athens,4076,1,4,2,0,7,1,6,14
PAOK Salonik,4076,2,2,3,1,11,6,5,9
P'thinaikos,4076,3,1,2,3,6,11,-5,5
Panionios,4076,4,1,1,4,4,10,-6,4
AEK Athens,4077,1,4,2,0,7,1,6,14
PAOK Salonik,4077,2,2,3,1,10,5,5,9
P'thinaikos,4077,3,1,2,3,5,10,-5,5
Panionios,4077,4,1,1,4,4,10,-6,4
AEK Athens,4078,1,4,2,0,7,1,6,14
PAOK Salonik,4078,2,2,3,1,10,5,5,9
P'thinaikos,4078,3,1,2,3,5,10,-5,5
Panionios,4078,4,1,1,4,4,10,-6,4
AEK Athens,4079,1,4,2,0,7,1,6,14
PAOK Salonik,4079,2,3,2,1,11,5,6,11
P'thinaikos,4079,3,1,1,4,5,11,-6,4
Panionios,4079,4,1,1,4,4,10,-6,4
AEK Athens,4080,1,4,2,0,7,1,6,14
PAOK Salonik,4080,2,2,3,1,10,5,5,9
P'thinaikos,4080,3,1,2,3,5,10,-5,5
Panionios,4080,4,1,1,4,4,10,-6,4
AEK Athens,4081,1,4,2,0,7,1,6,14
PAOK Salonik,4081,2,2,3,1,11,6,5,9
P'thinaikos,4081,3,1,2,3,6,11,-5,5
Panionios,4081,4,1,1,4,4,10,-6,4
AEK Athens,4082,1,4,2,0,7,1,6,14
PAOK Salonik,4082,2,2,2,2,10,7,3,8
P'thinaikos,4082,3,2,1,3,7,10,-3,7
Panionios,4082,4,1,1,4,4,10,-6,4
AEK Athens,4083,1,4,2,0,7,1,6,14
PAOK Salonik,4083,2,3,2,1,11,4,7,11
Panionios,4083,3,1,1,4,4,10,-6,4
P'thinaikos,4083,4,1,1,4,4,11,-7,4
AEK Athens,4084,1,4,2,0,7,1,6,14
PAOK Salonik,4084,2,3,2,1,13,7,6,11
P'thinaikos,4084,3,1,1,4,7,13,-6,4
Panionios,4084,4,1,1,4,4,10,-6,4
AEK Athens,4085,1,4,2,0,7,1,6,14
PAOK Salonik,4085,2,2,3,1,10,5,5,9
P'thinaikos,4085,3,1,2,3,5,10,-5,5
Panionios,4085,4,1,1,4,4,10,-6,4
AEK Athens,4086,1,4,2,0,7,1,6,14
PAOK Salonik,4086,2,2,2,2,10,6,4,8
P'thinaikos,4086,3,2,1,3,6,10,-4,7
Panionios,4086,4,1,1,4,4,10,-6,4
AEK Athens,4087,1,4,2,0,7,1,6,14
PAOK Salonik,4087,2,2,3,1,9,4,5,9
P'thinaikos,4087,3,1,2,3,4,9,-5,5
Panionios,4087,4,1,1,4,4,10,-6,4
AEK Athens,4088,1,4,2,0,7,1,6,14
PAOK Salonik,4088,2,2,3,1,10,5,5,9
P'thinaikos,4088,3,1,2,3,5,10,-5,5
Panionios,4088,4,1,1,4,4,10,-6,4
AEK Athens,4089,1,4,2,0,7,1,6,14
PAOK Salonik,4089,2,2,2,2,10,7,3,8
P'thinaikos,4089,3,2,1,3,7,10,-3,7
Panionios,4089,4,1,1,4,4,10,-6,4
AEK Athens,4090,1,4,2,0,7,1,6,14
PAOK Salonik,4090,2,3,2,1,13,6,7,11
Panionios,4090,3,1,1,4,4,10,-6,4
P'thinaikos,4090,4,1,1,4,6,13,-7,4
AEK Athens,4091,1,4,2,0,7,1,6,14
PAOK Salonik,4091,2,2,2,2,10,6,4,8
P'thinaikos,4091,3,2,1,3,6,10,-4,7
Panionios,4091,4,1,1,4,4,10,-6,4
AEK Athens,4092,1,4,2,0,7,1,6,14
PAOK Salonik,4092,2,2,2,2,10,6,4,8
P'thinaikos,4092,3,2,1,3,6,10,-4,7
Panionios,4092,4,1,1,4,4,10,-6,4
AEK Athens,4093,1,4,2,0,7,1,6,14
PAOK Salonik,4093,2,2,2,2,10,6,4,8
P'thinaikos,4093,3,2,1,3,6,10,-4,7
Panionios,4093,4,1,1,4,4,10,-6,4
AEK Athens,4094,1,4,2,0,7,1,6,14
PAOK Salonik,4094,2,2,2,2,10,7,3,8
P'thinaikos,4094,3,2,1,3,7,10,-3,7
Panionios,4094,4,1,1,4,4,10,-6,4
AEK Athens,4095,1,4,2,0,7,1,6,14
PAOK Salonik,4095,2,2,3,1,10,5,5,9
P'thinaikos,4095,3,1,2,3,5,10,-5,5
Panionios,4095,4,1,1,4,4,10,-6,4
AEK Athens,4096,1,4,2,0,7,1,6,14
PAOK Salonik,4096,2,2,3,1,11,6,5,9
P'thinaikos,4096,3,1,2,3,6,11,-5,5
Panionios,4096,4,1,1,4,4,10,-6,4
AEK Athens,4097,1,4,2,0,7,1,6,14
PAOK Salonik,4097,2,3,2,1,11,5,6,11
P'thinaikos,4097,3,1,1,4,5,11,-6,4
Panionios,4097,4,1,1,4,4,10,-6,4
AEK Athens,4098,1,4,2,0,7,1,6,14
PAOK Salonik,4098,2,2,2,2,11,8,3,8
P'thinaikos,4098,3,2,1,3,8,11,-3,7
Panionios,4098,4,1,1,4,4,10,-6,4
AEK Athens,4099,1,4,2,0,7,1,6,14
PAOK Salonik,4099,2,2,3,1,11,6,5,9
P'thinaikos,4099,3,1,2,3,6,11,-5,5
Panionios,4099,4,1,1,4,4,10,-6,4
AEK Athens,4100,1,4,2,0,7,1,6,14
PAOK Salonik,4100,2,3,2,1,10,4,6,11
P'thinaikos,4100,3,1,1,4,4,10,-6,4
Panionios,4100,3,1,1,4,4,10,-6,4
AEK Athens,4101,1,4,2,0,7,1,6,14
PAOK Salonik,4101,2,2,2,2,10,7,3,8
P'thinaikos,4101,3,2,1,3,7,10,-3,7
Panionios,4101,4,1,1,4,4,10,-6,4
AEK Athens,4102,1,4,2,0,7,1,6,14
PAOK Salonik,4102,2,2,2,2,10,7,3,8
P'thinaikos,4102,3,2,1,3,7,10,-3,7
Panionios,4102,4,1,1,4,4,10,-6,4
AEK Athens,4103,1,4,2,0,7,1,6,14
PAOK Salonik,4103,2,2,2,2,12,8,4,8
P'thinaikos,4103,3,2,1,3,8,12,-4,7
Panionios,4103,4,1,1,4,4,10,-6,4
AEK Athens,4104,1,4,2,0,7,1,6,14
PAOK Salonik,4104,2,3,2,1,10,4,6,11
P'thinaikos,4104,3,1,1,4,4,10,-6,4
Panionios,4104,3,1,1,4,4,10,-6,4
AEK Athens,4105,1,4,2,0,7,1,6,14
PAOK Salonik,4105,2,2,3,1,10,5,5,9
P'thinaikos,4105,3,1,2,3,5,10,-5,5
Panionios,4105,4,1,1,4,4,10,-6,4
AEK Athens,4106,1,4,2,0,7,1,6,14
PAOK Salonik,4106,2,2,2,2,10,8,2,8
P'thinaikos,4106,3,2,1,3,8,10,-2,7
Panionios,4106,4,1,1,4,4,10,-6,4
AEK Athens,4107,1,4,2,0,7,1,6,14
PAOK Salonik,4107,2,2,3,1,10,5,5,9
P'thinaikos,4107,3,1,2,3,5,10,-5,5
Panionios,4107,4,1,1,4,4,10,-6,4
AEK Athens,4108,1,4,2,0,7,1,6,14
PAOK Salonik,4108,2,2,3,1,9,4,5,9
P'thinaikos,4108,3,1,2,3,4,9,-5,5
Panionios,4108,4,1,1,4,4,10,-6,4
AEK Athens,4109,1,4,2,0,7,1,6,14
PAOK Salonik,4109,2,2,3,1,10,5,5,9
P'thinaikos,4109,3,1,2,3,5,10,-5,5
Panionios,4109,4,1,1,4,4,10,-6,4
AEK Athens,4110,1,4,2,0,7,1,6,14
PAOK Salonik,4110,2,3,2,1,12,4,8,11
Panionios,4110,3,1,1,4,4,10,-6,4
P'thinaikos,4110,4,1,1,4,4,12,-8,4
AEK Athens,4111,1,4,2,0,7,1,6,14
PAOK Salonik,4111,2,2,2,2,9,5,4,8
P'thinaikos,4111,3,2,1,3,5,9,-4,7
Panionios,4111,4,1,1,4,4,10,-6,4
AEK Athens,4112,1,4,2,0,7,1,6,14
PAOK Salonik,4112,2,2,2,2,9,5,4,8
P'thinaikos,4112,3,2,1,3,5,9,-4,7
Panionios,4112,4,1,1,4,4,10,-6,4
AEK Athens,4113,1,4,2,0,7,1,6,14
PAOK Salonik,4113,2,2,2,2,9,6,3,8
P'thinaikos,4113,3,2,1,3,6,9,-3,7
Panionios,4113,4,1,1,4,4,10,-6,4
AEK Athens,4114,1,4,2,0,7,1,6,14
PAOK Salonik,4114,2,3,2,1,12,4,8,11
Panionios,4114,3,1,1,4,4,10,-6,4
P'thinaikos,4114,4,1,1,4,4,12,-8,4
AEK Athens,4115,1,4,2,0,7,1,6,14
PAOK Salonik,4115,2,2,3,1,12,7,5,9
P'thinaikos,4115,3,1,2,3,7,12,-5,5
Panionios,4115,4,1,1,4,4,10,-6,4
AEK Athens,4116,1,4,2,0,7,1,6,14
PAOK Salonik,4116,2,2,2,2,9,6,3,8
P'thinaikos,4116,3,2,1,3,6,9,-3,7
Panionios,4116,4,1,1,4,4,10,-6,4
AEK Athens,4117,1,4,2,0,7,1,6,14
PAOK Salonik,4117,2,2,3,1,10,5,5,9
P'thinaikos,4117,3,1,2,3,5,10,-5,5
Panionios,4117,4,1,1,4,4,10,-6,4
AEK Athens,4118,1,4,2,0,7,1,6,14
PAOK Salonik,4118,2,2,2,2,9,5,4,8
P'thinaikos,4118,3,2,1,3,5,9,-4,7
Panionios,4118,4,1,1,4,4,10,-6,4
AEK Athens,4119,1,4,2,0,7,1,6,14
PAOK Salonik,4119,2,3,2,1,10,4,6,11
P'thinaikos,4119,3,1,1,4,4,10,-6,4
Panionios,4119,3,1,1,4,4,10,-6,4
AEK Athens,4120,1,4,2,0,7,1,6,14
PAOK Salonik,4120,2,2,2,2,10,6,4,8
P'thinaikos,4120,3,2,1,3,6,10,-4,7
Panionios,4120,4,1,1,4,4,10,-6,4
AEK Athens,4121,1,4,2,0,7,1,6,14
PAOK Salonik,4121,2,2,3,1,10,5,5,9
P'thinaikos,4121,3,1,2,3,5,10,-5,5
Panionios,4121,4,1,1,4,4,10,-6,4
AEK Athens,4122,1,4,2,0,7,1,6,14
PAOK Salonik,4122,2,3,2,1,12,5,7,11
Panionios,4122,3,1,1,4,4,10,-6,4
P'thinaikos,4122,4,1,1,4,5,12,-7,4
AEK Athens,4123,1,4,2,0,7,1,6,14
PAOK Salonik,4123,2,3,2,1,11,4,7,11
Panionios,4123,3,1,1,4,4,10,-6,4
P'thinaikos,4123,4,1,1,4,4,11,-7,4
AEK Athens,4124,1,4,2,0,7,1,6,14
PAOK Salonik,4124,2,2,2,2,9,7,2,8
P'thinaikos,4124,3,2,1,3,7,9,-2,7
Panionios,4124,4,1,1,4,4,10,-6,4
AEK Athens,4125,1,4,2,0,7,1,6,14
PAOK Salonik,4125,2,2,3,1,11,6,5,9
P'thinaikos,4125,3,1,2,3,6,11,-5,5
Panionios,4125,4,1,1,4,4,10,-6,4
AEK Athens,4126,1,4,2,0,7,1,6,14
PAOK Salonik,4126,2,2,2,2,10,7,3,8
P'thinaikos,4126,3,2,1,3,7,10,-3,7
Panionios,4126,4,1,1,4,4,10,-6,4
AEK Athens,4127,1,4,2,0,7,1,6,14
PAOK Salonik,4127,2,2,3,1,9,4,5,9
P'thinaikos,4127,3,1,2,3,4,9,-5,5
Panionios,4127,4,1,1,4,4,10,-6,4
AEK Athens,4128,1,4,2,0,7,1,6,14
PAOK Salonik,4128,2,3,2,1,12,6,6,11
P'thinaikos,4128,3,1,1,4,6,12,-6,4
Panionios,4128,4,1,1,4,4,10,-6,4
AEK Athens,4129,1,4,2,0,7,1,6,14
PAOK Salonik,4129,2,2,2,2,9,6,3,8
P'thinaikos,4129,3,2,1,3,6,9,-3,7
Panionios,4129,4,1,1,4,4,10,-6,4
AEK Athens,4130,1,4,2,0,7,1,6,14
PAOK Salonik,4130,2,3,2,1,11,4,7,11
Panionios,4130,3,1,1,4,4,10,-6,4
P'thinaikos,4130,4,1,1,4,4,11,-7,4
AEK Athens,4131,1,4,2,0,7,1,6,14
PAOK Salonik,4131,2,2,2,2,9,7,2,8
P'thinaikos,4131,3,2,1,3,7,9,-2,7
Panionios,4131,4,1,1,4,4,10,-6,4
AEK Athens,4132,1,4,2,0,7,1,6,14
PAOK Salonik,4132,2,3,2,1,15,7,8,11
Panionios,4132,3,1,1,4,4,10,-6,4
P'thinaikos,4132,4,1,1,4,7,15,-8,4
AEK Athens,4133,1,4,2,0,7,1,6,14
PAOK Salonik,4133,2,2,2,2,9,5,4,8
P'thinaikos,4133,3,2,1,3,5,9,-4,7
Panionios,4133,4,1,1,4,4,10,-6,4
AEK Athens,4134,1,4,2,0,7,1,6,14
PAOK Salonik,4134,2,3,2,1,12,6,6,11
P'thinaikos,4134,3,1,1,4,6,12,-6,4
Panionios,4134,4,1,1,4,4,10,-6,4
AEK Athens,4135,1,4,2,0,7,1,6,14
PAOK Salonik,4135,2,3,2,1,11,5,6,11
P'thinaikos,4135,3,1,1,4,5,11,-6,4
Panionios,4135,4,1,1,4,4,10,-6,4
AEK Athens,4136,1,4,2,0,7,1,6,14
PAOK Salonik,4136,2,2,2,2,10,6,4,8
P'thinaikos,4136,3,2,1,3,6,10,-4,7
Panionios,4136,4,1,1,4,4,10,-6,4
AEK Athens,4137,1,4,2,0,7,1,6,14
PAOK Salonik,4137,2,2,3,1,10,5,5,9
P'thinaikos,4137,3,1,2,3,5,10,-5,5
Panionios,4137,4,1,1,4,4,10,-6,4
AEK Athens,4138,1,4,2,0,7,1,6,14
PAOK Salonik,4138,2,2,2,2,9,6,3,8
P'thinaikos,4138,3,2,1,3,6,9,-3,7
Panionios,4138,4,1,1,4,4,10,-6,4
AEK Athens,4139,1,4,2,0,7,1,6,14
PAOK Salonik,4139,2,2,3,1,10,5,5,9
P'thinaikos,4139,3,1,2,3,5,10,-5,5
Panionios,4139,4,1,1,4,4,10,-6,4
AEK Athens,4140,1,4,2,0,7,1,6,14
PAOK Salonik,4140,2,3,2,1,11,4,7,11
Panionios,4140,3,1,1,4,4,10,-6,4
P'thinaikos,4140,4,1,1,4,4,11,-7,4
AEK Athens,4141,1,4,2,0,7,1,6,14
PAOK Salonik,4141,2,2,3,1,9,4,5,9
P'thinaikos,4141,3,1,2,3,4,9,-5,5
Panionios,4141,4,1,1,4,4,10,-6,4
AEK Athens,4142,1,4,2,0,7,1,6,14
PAOK Salonik,4142,2,2,2,2,12,9,3,8
P'thinaikos,4142,3,2,1,3,9,12,-3,7
Panionios,4142,4,1,1,4,4,10,-6,4
AEK Athens,4143,1,4,2,0,7,1,6,14
PAOK Salonik,4143,2,2,3,1,10,5,5,9
P'thinaikos,4143,3,1,2,3,5,10,-5,5
Panionios,4143,4,1,1,4,4,10,-6,4
AEK Athens,4144,1,4,2,0,7,1,6,14
PAOK Salonik,4144,2,3,2,1,12,6,6,11
P'thinaikos,4144,3,1,1,4,6,12,-6,4
Panionios,4144,4,1,1,4,4,10,-6,4
AEK Athens,4145,1,4,2,0,7,1,6,14
PAOK Salonik,4145,2,2,3,1,11,6,5,9
P'thinaikos,4145,3,1,2,3,6,11,-5,5
Panionios,4145,4,1,1,4,4,10,-6,4
AEK Athens,4146,1,4,2,0,7,1,6,14
PAOK Salonik,4146,2,2,2,2,10,6,4,8
P'thinaikos,4146,3,2,1,3,6,10,-4,7
Panionios,4146,4,1,1,4,4,10,-6,4
AEK Athens,4147,1,4,2,0,7,1,6,14
PAOK Salonik,4147,2,2,2,2,9,6,3,8
P'thinaikos,4147,3,2,1,3,6,9,-3,7
Panionios,4147,4,1,1,4,4,10,-6,4
AEK Athens,4148,1,4,2,0,7,1,6,14
PAOK Salonik,4148,2,2,3,1,9,4,5,9
P'thinaikos,4148,3,1,2,3,4,9,-5,5
Panionios,4148,4,1,1,4,4,10,-6,4
AEK Athens,4149,1,4,2,0,7,1,6,14
PAOK Salonik,4149,2,2,3,1,11,6,5,9
P'thinaikos,4149,3,1,2,3,6,11,-5,5
Panionios,4149,4,1,1,4,4,10,-6,4
AEK Athens,4150,1,4,2,0,7,1,6,14
PAOK Salonik,4150,2,2,3,1,10,5,5,9
P'thinaikos,4150,3,1,2,3,5,10,-5,5
Panionios,4150,4,1,1,4,4,10,-6,4
AEK Athens,4151,1,4,2,0,7,1,6,14
PAOK Salonik,4151,2,3,2,1,11,5,6,11
P'thinaikos,4151,3,1,1,4,5,11,-6,4
Panionios,4151,4,1,1,4,4,10,-6,4
AEK Athens,4152,1,4,2,0,7,1,6,14
PAOK Salonik,4152,2,2,2,2,9,5,4,8
P'thinaikos,4152,3,2,1,3,5,9,-4,7
Panionios,4152,4,1,1,4,4,10,-6,4
AEK Athens,4153,1,4,2,0,7,1,6,14
PAOK Salonik,4153,2,2,3,1,10,5,5,9
P'thinaikos,4153,3,1,2,3,5,10,-5,5
Panionios,4153,4,1,1,4,4,10,-6,4
AEK Athens,4154,1,4,2,0,7,1,6,14
PAOK Salonik,4154,2,2,2,2,12,8,4,8
P'thinaikos,4154,3,2,1,3,8,12,-4,7
Panionios,4154,4,1,1,4,4,10,-6,4
AEK Athens,4155,1,4,2,0,7,1,6,14
PAOK Salonik,4155,2,2,3,1,10,5,5,9
P'thinaikos,4155,3,1,2,3,5,10,-5,5
Panionios,4155,4,1,1,4,4,10,-6,4
AEK Athens,4156,1,4,2,0,7,1,6,14
PAOK Salonik,4156,2,2,2,2,11,7,4,8
P'thinaikos,4156,3,2,1,3,7,11,-4,7
Panionios,4156,4,1,1,4,4,10,-6,4
AEK Athens,4157,1,4,2,0,7,1,6,14
PAOK Salonik,4157,2,3,2,1,11,5,6,11
P'thinaikos,4157,3,1,1,4,5,11,-6,4
Panionios,4157,4,1,1,4,4,10,-6,4
AEK Athens,4158,1,4,2,0,7,1,6,14
PAOK Salonik,4158,2,3,2,1,10,4,6,11
P'thinaikos,4158,3,1,1,4,4,10,-6,4
Panionios,4158,3,1,1,4,4,10,-6,4
AEK Athens,4159,1,4,2,0,7,1,6,14
PAOK Salonik,4159,2,2,3,1,10,5,5,9
P'thinaikos,4159,3,1,2,3,5,10,-5,5
Panionios,4159,4,1,1,4,4,10,-6,4
AEK Athens,4160,1,4,2,0,7,1,6,14
PAOK Salonik,4160,2,2,3,1,12,7,5,9
P'thinaikos,4160,3,1,2,3,7,12,-5,5
Panionios,4160,4,1,1,4,4,10,-6,4
AEK Athens,4161,1,4,2,0,7,1,6,14
PAOK Salonik,4161,2,3,2,1,12,6,6,11
P'thinaikos,4161,3,1,1,4,6,12,-6,4
Panionios,4161,4,1,1,4,4,10,-6,4
AEK Athens,4162,1,4,2,0,7,1,6,14
PAOK Salonik,4162,2,2,2,2,9,5,4,8
P'thinaikos,4162,3,2,1,3,5,9,-4,7
Panionios,4162,4,1,1,4,4,10,-6,4
AEK Athens,4163,1,4,2,0,7,1,6,14
PAOK Salonik,4163,2,2,3,1,10,5,5,9
P'thinaikos,4163,3,1,2,3,5,10,-5,5
Panionios,4163,4,1,1,4,4,10,-6,4
AEK Athens,4164,1,4,2,0,7,1,6,14
PAOK Salonik,4164,2,2,2,2,10,7,3,8
P'thinaikos,4164,3,2,1,3,7,10,-3,7
Panionios,4164,4,1,1,4,4,10,-6,4
AEK Athens,4165,1,4,2,0,7,1,6,14
PAOK Salonik,4165,2,3,2,1,13,5,8,11
Panionios,4165,3,1,1,4,4,10,-6,4
P'thinaikos,4165,4,1,1,4,5,13,-8,4
AEK Athens,4166,1,4,2,0,7,1,6,14
PAOK Salonik,4166,2,3,2,1,14,8,6,11
P'thinaikos,4166,3,1,1,4,8,14,-6,4
Panionios,4166,4,1,1,4,4,10,-6,4
AEK Athens,4167,1,4,2,0,7,1,6,14
PAOK Salonik,4167,2,2,3,1,10,5,5,9
P'thinaikos,4167,3,1,2,3,5,10,-5,5
Panionios,4167,4,1,1,4,4,10,-6,4
AEK Athens,4168,1,4,2,0,7,1,6,14
PAOK Salonik,4168,2,2,3,1,10,5,5,9
P'thinaikos,4168,3,1,2,3,5,10,-5,5
Panionios,4168,4,1,1,4,4,10,-6,4
AEK Athens,4169,1,4,2,0,7,1,6,14
PAOK Salonik,4169,2,2,3,1,10,5,5,9
P'thinaikos,4169,3,1,2,3,5,10,-5,5
Panionios,4169,4,1,1,4,4,10,-6,4
AEK Athens,4170,1,4,2,0,7,1,6,14
PAOK Salonik,4170,2,3,2,1,10,4,6,11
P'thinaikos,4170,3,1,1,4,4,10,-6,4
Panionios,4170,3,1,1,4,4,10,-6,4
AEK Athens,4171,1,4,2,0,7,1,6,14
PAOK Salonik,4171,2,2,3,1,10,5,5,9
P'thinaikos,4171,3,1,2,3,5,10,-5,5
Panionios,4171,4,1,1,4,4,10,-6,4
AEK Athens,4172,1,4,2,0,7,1,6,14
PAOK Salonik,4172,2,2,2,2,9,5,4,8
P'thinaikos,4172,3,2,1,3,5,9,-4,7
Panionios,4172,4,1,1,4,4,10,-6,4
AEK Athens,4173,1,4,2,0,7,1,6,14
PAOK Salonik,4173,2,3,2,1,12,5,7,11
Panionios,4173,3,1,1,4,4,10,-6,4
P'thinaikos,4173,4,1,1,4,5,12,-7,4
AEK Athens,4174,1,4,2,0,7,1,6,14
PAOK Salonik,4174,2,2,2,2,9,6,3,8
P'thinaikos,4174,3,2,1,3,6,9,-3,7
Panionios,4174,4,1,1,4,4,10,-6,4
AEK Athens,4175,1,4,2,0,7,1,6,14
PAOK Salonik,4175,2,2,2,2,9,5,4,8
P'thinaikos,4175,3,2,1,3,5,9,-4,7
Panionios,4175,4,1,1,4,4,10,-6,4
AEK Athens,4176,1,4,2,0,7,1,6,14
PAOK Salonik,4176,2,2,2,2,10,6,4,8
P'thinaikos,4176,3,2,1,3,6,10,-4,7
Panionios,4176,4,1,1,4,4,10,-6,4
AEK Athens,4177,1,4,2,0,7,1,6,14
PAOK Salonik,4177,2,2,3,1,10,5,5,9
P'thinaikos,4177,3,1,2,3,5,10,-5,5
Panionios,4177,4,1,1,4,4,10,-6,4
AEK Athens,4178,1,4,2,0,7,1,6,14
PAOK Salonik,4178,2,2,2,2,9,7,2,8
P'thinaikos,4178,3,2,1,3,7,9,-2,7
Panionios,4178,4,1,1,4,4,10,-6,4
AEK Athens,4179,1,4,2,0,7,1,6,14
PAOK Salonik,4179,2,3,2,1,11,5,6,11
P'thinaikos,4179,3,1,1,4,5,11,-6,4
Panionios,4179,4,1,1,4,4,10,-6,4
AEK Athens,4180,1,4,2,0,7,1,6,14
PAOK Salonik,4180,2,3,2,1,10,4,6,11
P'thinaikos,4180,3,1,1,4,4,10,-6,4
Panionios,4180,3,1,1,4,4,10,-6,4
AEK Athens,4181,1,4,2,0,7,1,6,14
PAOK Salonik,4181,2,2,2,2,9,6,3,8
P'thinaikos,4181,3,2,1,3,6,9,-3,7
Panionios,4181,4,1,1,4,4,10,-6,4
AEK Athens,4182,1,4,2,0,7,1,6,14
PAOK Salonik,4182,2,3,2,1,10,4,6,11
P'thinaikos,4182,3,1,1,4,4,10,-6,4
Panionios,4182,3,1,1,4,4,10,-6,4
AEK Athens,4183,1,4,2,0,7,1,6,14
PAOK Salonik,4183,2,2,2,2,9,5,4,8
P'thinaikos,4183,3,2,1,3,5,9,-4,7
Panionios,4183,4,1,1,4,4,10,-6,4
AEK Athens,4184,1,4,2,0,7,1,6,14
PAOK Salonik,4184,2,2,2,2,10,7,3,8
P'thinaikos,4184,3,2,1,3,7,10,-3,7
Panionios,4184,4,1,1,4,4,10,-6,4
AEK Athens,4185,1,4,2,0,7,1,6,14
PAOK Salonik,4185,2,2,2,2,9,9,0,8
P'thinaikos,4185,3,2,1,3,9,9,0,7
Panionios,4185,4,1,1,4,4,10,-6,4
AEK Athens,4186,1,4,2,0,7,1,6,14
PAOK Salonik,4186,2,2,2,2,9,6,3,8
P'thinaikos,4186,3,2,1,3,6,9,-3,7
Panionios,4186,4,1,1,4,4,10,-6,4
AEK Athens,4187,1,4,2,0,7,1,6,14
PAOK Salonik,4187,2,2,2,2,9,6,3,8
P'thinaikos,4187,3,2,1,3,6,9,-3,7
Panionios,4187,4,1,1,4,4,10,-6,4
AEK Athens,4188,1,4,2,0,7,1,6,14
PAOK Salonik,4188,2,2,2,2,9,6,3,8
P'thinaikos,4188,3,2,1,3,6,9,-3,7
Panionios,4188,4,1,1,4,4,10,-6,4
AEK Athens,4189,1,4,2,0,7,1,6,14
PAOK Salonik,4189,2,3,2,1,10,4,6,11
P'thinaikos,4189,3,1,1,4,4,10,-6,4
Panionios,4189,3,1,1,4,4,10,-6,4
AEK Athens,4190,1,4,2,0,7,1,6,14
PAOK Salonik,4190,2,3,2,1,13,4,9,11
Panionios,4190,3,1,1,4,4,10,-6,4
P'thinaikos,4190,4,1,1,4,4,13,-9,4
AEK Athens,4191,1,4,2,0,7,1,6,14
PAOK Salonik,4191,2,2,2,2,9,6,3,8
P'thinaikos,4191,3,2,1,3,6,9,-3,7
Panionios,4191,4,1,1,4,4,10,-6,4
AEK Athens,4192,1,4,2,0,7,1,6,14
PAOK Salonik,4192,2,3,2,1,11,5,6,11
P'thinaikos,4192,3,1,1,4,5,11,-6,4
Panionios,4192,4,1,1,4,4,10,-6,4
AEK Athens,4193,1,4,2,0,7,1,6,14
PAOK Salonik,4193,2,2,2,2,9,5,4,8
P'thinaikos,4193,3,2,1,3,5,9,-4,7
Panionios,4193,4,1,1,4,4,10,-6,4
AEK Athens,4194,1,4,2,0,7,1,6,14
PAOK Salonik,4194,2,2,2,2,9,8,1,8
P'thinaikos,4194,3,2,1,3,8,9,-1,7
Panionios,4194,4,1,1,4,4,10,-6,4
AEK Athens,4195,1,4,2,0,7,1,6,14
PAOK Salonik,4195,2,2,3,1,10,5,5,9
P'thinaikos,4195,3,1,2,3,5,10,-5,5
Panionios,4195,4,1,1,4,4,10,-6,4
AEK Athens,4196,1,4,2,0,7,1,6,14
PAOK Salonik,4196,2,3,2,1,11,4,7,11
Panionios,4196,3,1,1,4,4,10,-6,4
P'thinaikos,4196,4,1,1,4,4,11,-7,4
AEK Athens,4197,1,4,2,0,7,1,6,14
PAOK Salonik,4197,2,2,2,2,9,7,2,8
P'thinaikos,4197,3,2,1,3,7,9,-2,7
Panionios,4197,4,1,1,4,4,10,-6,4
AEK Athens,4198,1,4,2,0,7,1,6,14
PAOK Salonik,4198,2,2,2,2,9,6,3,8
P'thinaikos,4198,3,2,1,3,6,9,-3,7
Panionios,4198,4,1,1,4,4,10,-6,4
AEK Athens,4199,1,4,2,0,7,1,6,14
PAOK Salonik,4199,2,2,3,1,11,6,5,9
P'thinaikos,4199,3,1,2,3,6,11,-5,5
Panionios,4199,4,1,1,4,4,10,-6,4
AEK Athens,4200,1,4,2,0,7,1,6,14
PAOK Salonik,4200,2,3,2,1,11,4,7,11
Panionios,4200,3,1,1,4,4,10,-6,4
P'thinaikos,4200,4,1,1,4,4,11,-7,4
AEK Athens,4201,1,4,2,0,7,1,6,14
PAOK Salonik,4201,2,2,3,1,10,5,5,9
P'thinaikos,4201,3,1,2,3,5,10,-5,5
Panionios,4201,4,1,1,4,4,10,-6,4
AEK Athens,4202,1,4,2,0,7,1,6,14
PAOK Salonik,4202,2,3,2,1,12,5,7,11
Panionios,4202,3,1,1,4,4,10,-6,4
P'thinaikos,4202,4,1,1,4,5,12,-7,4
AEK Athens,4203,1,4,2,0,7,1,6,14
PAOK Salonik,4203,2,3,2,1,12,5,7,11
Panionios,4203,3,1,1,4,4,10,-6,4
P'thinaikos,4203,4,1,1,4,5,12,-7,4
AEK Athens,4204,1,4,2,0,7,1,6,14
PAOK Salonik,4204,2,2,2,2,10,7,3,8
P'thinaikos,4204,3,2,1,3,7,10,-3,7
Panionios,4204,4,1,1,4,4,10,-6,4
AEK Athens,4205,1,4,2,0,7,1,6,14
PAOK Salonik,4205,2,2,3,1,9,4,5,9
P'thinaikos,4205,3,1,2,3,4,9,-5,5
Panionios,4205,4,1,1,4,4,10,-6,4
AEK Athens,4206,1,4,2,0,7,1,6,14
PAOK Salonik,4206,2,2,3,1,9,4,5,9
P'thinaikos,4206,3,1,2,3,4,9,-5,5
Panionios,4206,4,1,1,4,4,10,-6,4
AEK Athens,4207,1,4,2,0,7,1,6,14
PAOK Salonik,4207,2,3,2,1,10,4,6,11
P'thinaikos,4207,3,1,1,4,4,10,-6,4
Panionios,4207,3,1,1,4,4,10,-6,4
AEK Athens,4208,1,4,2,0,7,1,6,14
PAOK Salonik,4208,2,2,3,1,10,5,5,9
P'thinaikos,4208,3,1,2,3,5,10,-5,5
Panionios,4208,4,1,1,4,4,10,-6,4
AEK Athens,4209,1,4,2,0,7,1,6,14
PAOK Salonik,4209,2,2,3,1,9,4,5,9
P'thinaikos,4209,3,1,2,3,4,9,-5,5
Panionios,4209,4,1,1,4,4,10,-6,4
AEK Athens,4210,1,4,2,0,7,1,6,14
PAOK Salonik,4210,2,2,2,2,10,6,4,8
P'thinaikos,4210,3,2,1,3,6,10,-4,7
Panionios,4210,4,1,1,4,4,10,-6,4
AEK Athens,4211,1,4,2,0,7,1,6,14
PAOK Salonik,4211,2,3,2,1,12,6,6,11
P'thinaikos,4211,3,1,1,4,6,12,-6,4
Panionios,4211,4,1,1,4,4,10,-6,4
AEK Athens,4212,1,4,2,0,7,1,6,14
PAOK Salonik,4212,2,2,3,1,10,5,5,9
P'thinaikos,4212,3,1,2,3,5,10,-5,5
Panionios,4212,4,1,1,4,4,10,-6,4
AEK Athens,4213,1,4,2,0,7,1,6,14
PAOK Salonik,4213,2,2,3,1,9,4,5,9
P'thinaikos,4213,3,1,2,3,4,9,-5,5
Panionios,4213,4,1,1,4,4,10,-6,4
AEK Athens,4214,1,4,2,0,7,1,6,14
PAOK Salonik,4214,2,3,2,1,11,5,6,11
P'thinaikos,4214,3,1,1,4,5,11,-6,4
Panionios,4214,4,1,1,4,4,10,-6,4
AEK Athens,4215,1,4,2,0,7,1,6,14
PAOK Salonik,4215,2,3,2,1,14,4,10,11
Panionios,4215,3,1,1,4,4,10,-6,4
P'thinaikos,4215,4,1,1,4,4,14,-10,4
AEK Athens,4216,1,4,2,0,7,1,6,14
PAOK Salonik,4216,2,2,2,2,9,6,3,8
P'thinaikos,4216,3,2,1,3,6,9,-3,7
Panionios,4216,4,1,1,4,4,10,-6,4
AEK Athens,4217,1,4,2,0,7,1,6,14
PAOK Salonik,4217,2,2,2,2,10,6,4,8
P'thinaikos,4217,3,2,1,3,6,10,-4,7
Panionios,4217,4,1,1,4,4,10,-6,4
AEK Athens,4218,1,4,2,0,7,1,6,14
PAOK Salonik,4218,2,2,2,2,9,5,4,8
P'thinaikos,4218,3,2,1,3,5,9,-4,7
Panionios,4218,4,1,1,4,4,10,-6,4
AEK Athens,4219,1,4,2,0,7,1,6,14
PAOK Salonik,4219,2,3,2,1,11,5,6,11
P'thinaikos,4219,3,1,1,4,5,11,-6,4
Panionios,4219,4,1,1,4,4,10,-6,4
AEK Athens,4220,1,4,2,0,7,1,6,14
PAOK Salonik,4220,2,3,2,1,12,5,7,11
Panionios,4220,3,1,1,4,4,10,-6,4
P'thinaikos,4220,4,1,1,4,5,12,-7,4
AEK Athens,4221,1,4,2,0,7,1,6,14
PAOK Salonik,4221,2,2,2,2,10,6,4,8
P'thinaikos,4221,3,2,1,3,6,10,-4,7
Panionios,4221,4,1,1,4,4,10,-6,4
AEK Athens,4222,1,4,2,0,7,1,6,14
PAOK Salonik,4222,2,2,2,2,9,6,3,8
P'thinaikos,4222,3,2,1,3,6,9,-3,7
Panionios,4222,4,1,1,4,4,10,-6,4
AEK Athens,4223,1,4,2,0,7,1,6,14
PAOK Salonik,4223,2,3,2,1,11,4,7,11
Panionios,4223,3,1,1,4,4,10,-6,4
P'thinaikos,4223,4,1,1,4,4,11,-7,4
AEK Athens,4224,1,4,2,0,7,1,6,14
PAOK Salonik,4224,2,3,2,1,10,4,6,11
P'thinaikos,4224,3,1,1,4,4,10,-6,4
Panionios,4224,3,1,1,4,4,10,-6,4
AEK Athens,4225,1,4,2,0,7,1,6,14
PAOK Salonik,4225,2,2,2,2,11,7,4,8
P'thinaikos,4225,3,2,1,3,7,11,-4,7
Panionios,4225,4,1,1,4,4,10,-6,4
AEK Athens,4226,1,4,2,0,7,1,6,14
PAOK Salonik,4226,2,2,3,1,10,5,5,9
P'thinaikos,4226,3,1,2,3,5,10,-5,5
Panionios,4226,4,1,1,4,4,10,-6,4
AEK Athens,4227,1,4,2,0,7,1,6,14
PAOK Salonik,4227,2,3,2,1,12,6,6,11
P'thinaikos,4227,3,1,1,4,6,12,-6,4
Panionios,4227,4,1,1,4,4,10,-6,4
AEK Athens,4228,1,4,2,0,7,1,6,14
PAOK Salonik,4228,2,3,2,1,11,4,7,11
Panionios,4228,3,1,1,4,4,10,-6,4
P'thinaikos,4228,4,1,1,4,4,11,-7,4
AEK Athens,4229,1,4,2,0,7,1,6,14
PAOK Salonik,4229,2,2,3,1,10,5,5,9
P'thinaikos,4229,3,1,2,3,5,10,-5,5
Panionios,4229,4,1,1,4,4,10,-6,4
AEK Athens,4230,1,4,2,0,7,1,6,14
PAOK Salonik,4230,2,2,3,1,10,5,5,9
P'thinaikos,4230,3,1,2,3,5,10,-5,5
Panionios,4230,4,1,1,4,4,10,-6,4
AEK Athens,4231,1,4,2,0,7,1,6,14
PAOK Salonik,4231,2,2,2,2,10,6,4,8
P'thinaikos,4231,3,2,1,3,6,10,-4,7
Panionios,4231,4,1,1,4,4,10,-6,4
AEK Athens,4232,1,4,2,0,7,1,6,14
PAOK Salonik,4232,2,3,2,1,12,5,7,11
Panionios,4232,3,1,1,4,4,10,-6,4
P'thinaikos,4232,4,1,1,4,5,12,-7,4
AEK Athens,4233,1,4,2,0,7,1,6,14
PAOK Salonik,4233,2,3,2,1,11,5,6,11
P'thinaikos,4233,3,1,1,4,5,11,-6,4
Panionios,4233,4,1,1,4,4,10,-6,4
AEK Athens,4234,1,4,2,0,7,1,6,14
PAOK Salonik,4234,2,3,2,1,12,4,8,11
Panionios,4234,3,1,1,4,4,10,-6,4
P'thinaikos,4234,4,1,1,4,4,12,-8,4
AEK Athens,4235,1,4,2,0,7,1,6,14
PAOK Salonik,4235,2,2,3,1,10,5,5,9
P'thinaikos,4235,3,1,2,3,5,10,-5,5
Panionios,4235,4,1,1,4,4,10,-6,4
AEK Athens,4236,1,4,2,0,7,1,6,14
PAOK Salonik,4236,2,2,3,1,9,4,5,9
P'thinaikos,4236,3,1,2,3,4,9,-5,5
Panionios,4236,4,1,1,4,4,10,-6,4
AEK Athens,4237,1,4,2,0,7,1,6,14
PAOK Salonik,4237,2,2,3,1,10,5,5,9
P'thinaikos,4237,3,1,2,3,5,10,-5,5
Panionios,4237,4,1,1,4,4,10,-6,4
AEK Athens,4238,1,4,2,0,7,1,6,14
PAOK Salonik,4238,2,3,2,1,10,4,6,11
P'thinaikos,4238,3,1,1,4,4,10,-6,4
Panionios,4238,3,1,1,4,4,10,-6,4
AEK Athens,4239,1,4,2,0,7,1,6,14
PAOK Salonik,4239,2,2,2,2,10,7,3,8
P'thinaikos,4239,3,2,1,3,7,10,-3,7
Panionios,4239,4,1,1,4,4,10,-6,4
AEK Athens,4240,1,4,2,0,7,1,6,14
PAOK Salonik,4240,2,2,2,2,10,7,3,8
P'thinaikos,4240,3,2,1,3,7,10,-3,7
Panionios,4240,4,1,1,4,4,10,-6,4
AEK Athens,4241,1,4,2,0,7,1,6,14
PAOK Salonik,4241,2,2,2,2,10,7,3,8
P'thinaikos,4241,3,2,1,3,7,10,-3,7
Panionios,4241,4,1,1,4,4,10,-6,4
AEK Athens,4242,1,4,2,0,7,1,6,14
PAOK Salonik,4242,2,2,2,2,11,7,4,8
P'thinaikos,4242,3,2,1,3,7,11,-4,7
Panionios,4242,4,1,1,4,4,10,-6,4
AEK Athens,4243,1,4,2,0,7,1,6,14
PAOK Salonik,4243,2,2,2,2,9,6,3,8
P'thinaikos,4243,3,2,1,3,6,9,-3,7
Panionios,4243,4,1,1,4,4,10,-6,4
AEK Athens,4244,1,4,2,0,7,1,6,14
PAOK Salonik,4244,2,3,2,1,11,4,7,11
Panionios,4244,3,1,1,4,4,10,-6,4
P'thinaikos,4244,4,1,1,4,4,11,-7,4
AEK Athens,4245,1,4,2,0,7,1,6,14
PAOK Salonik,4245,2,2,3,1,10,5,5,9
P'thinaikos,4245,3,1,2,3,5,10,-5,5
Panionios,4245,4,1,1,4,4,10,-6,4
AEK Athens,4246,1,4,2,0,7,1,6,14
PAOK Salonik,4246,2,3,2,1,11,4,7,11
Panionios,4246,3,1,1,4,4,10,-6,4
P'thinaikos,4246,4,1,1,4,4,11,-7,4
AEK Athens,4247,1,4,2,0,7,1,6,14
PAOK Salonik,4247,2,2,3,1,9,4,5,9
P'thinaikos,4247,3,1,2,3,4,9,-5,5
Panionios,4247,4,1,1,4,4,10,-6,4
AEK Athens,4248,1,4,2,0,7,1,6,14
PAOK Salonik,4248,2,3,2,1,11,5,6,11
P'thinaikos,4248,3,1,1,4,5,11,-6,4
Panionios,4248,4,1,1,4,4,10,-6,4
AEK Athens,4249,1,4,2,0,7,1,6,14
PAOK Salonik,4249,2,3,2,1,10,4,6,11
P'thinaikos,4249,3,1,1,4,4,10,-6,4
Panionios,4249,3,1,1,4,4,10,-6,4
AEK Athens,4250,1,4,2,0,7,1,6,14
PAOK Salonik,4250,2,2,2,2,10,6,4,8
P'thinaikos,4250,3,2,1,3,6,10,-4,7
Panionios,4250,4,1,1,4,4,10,-6,4
AEK Athens,4251,1,4,2,0,7,1,6,14
PAOK Salonik,4251,2,3,2,1,10,4,6,11
P'thinaikos,4251,3,1,1,4,4,10,-6,4
Panionios,4251,3,1,1,4,4,10,-6,4
AEK Athens,4252,1,4,2,0,7,1,6,14
PAOK Salonik,4252,2,3,2,1,11,4,7,11
Panionios,4252,3,1,1,4,4,10,-6,4
P'thinaikos,4252,4,1,1,4,4,11,-7,4
AEK Athens,4253,1,4,2,0,7,1,6,14
PAOK Salonik,4253,2,3,2,1,11,5,6,11
P'thinaikos,4253,3,1,1,4,5,11,-6,4
Panionios,4253,4,1,1,4,4,10,-6,4
AEK Athens,4254,1,4,2,0,7,1,6,14
PAOK Salonik,4254,2,2,3,1,10,5,5,9
P'thinaikos,4254,3,1,2,3,5,10,-5,5
Panionios,4254,4,1,1,4,4,10,-6,4
AEK Athens,4255,1,4,2,0,7,1,6,14
PAOK Salonik,4255,2,3,2,1,13,6,7,11
Panionios,4255,3,1,1,4,4,10,-6,4
P'thinaikos,4255,4,1,1,4,6,13,-7,4
AEK Athens,4256,1,4,2,0,7,1,6,14
PAOK Salonik,4256,2,3,2,1,10,4,6,11
P'thinaikos,4256,3,1,1,4,4,10,-6,4
Panionios,4256,3,1,1,4,4,10,-6,4
AEK Athens,4257,1,4,2,0,7,1,6,14
PAOK Salonik,4257,2,2,2,2,9,5,4,8
P'thinaikos,4257,3,2,1,3,5,9,-4,7
Panionios,4257,4,1,1,4,4,10,-6,4
AEK Athens,4258,1,4,2,0,7,1,6,14
PAOK Salonik,4258,2,2,3,1,10,5,5,9
P'thinaikos,4258,3,1,2,3,5,10,-5,5
Panionios,4258,4,1,1,4,4,10,-6,4
AEK Athens,4259,1,4,2,0,7,1,6,14
PAOK Salonik,4259,2,2,3,1,11,6,5,9
P'thinaikos,4259,3,1,2,3,6,11,-5,5
Panionios,4259,4,1,1,4,4,10,-6,4
AEK Athens,4260,1,4,2,0,7,1,6,14
PAOK Salonik,4260,2,3,2,1,10,4,6,11
P'thinaikos,4260,3,1,1,4,4,10,-6,4
Panionios,4260,3,1,1,4,4,10,-6,4
AEK Athens,4261,1,4,2,0,7,1,6,14
PAOK Salonik,4261,2,2,2,2,9,5,4,8
P'thinaikos,4261,3,2,1,3,5,9,-4,7
Panionios,4261,4,1,1,4,4,10,-6,4
AEK Athens,4262,1,4,2,0,7,1,6,14
PAOK Salonik,4262,2,3,2,1,11,5,6,11
P'thinaikos,4262,3,1,1,4,5,11,-6,4
Panionios,4262,4,1,1,4,4,10,-6,4
AEK Athens,4263,1,4,2,0,7,1,6,14
PAOK Salonik,4263,2,3,2,1,10,4,6,11
P'thinaikos,4263,3,1,1,4,4,10,-6,4
Panionios,4263,3,1,1,4,4,10,-6,4
AEK Athens,4264,1,4,2,0,7,1,6,14
PAOK Salonik,4264,2,3,2,1,11,5,6,11
P'thinaikos,4264,3,1,1,4,5,11,-6,4
Panionios,4264,4,1,1,4,4,10,-6,4
AEK Athens,4265,1,4,2,0,7,1,6,14
PAOK Salonik,4265,2,3,2,1,11,4,7,11
Panionios,4265,3,1,1,4,4,10,-6,4
P'thinaikos,4265,4,1,1,4,4,11,-7,4
AEK Athens,4266,1,4,2,0,7,1,6,14
PAOK Salonik,4266,2,3,2,1,10,4,6,11
P'thinaikos,4266,3,1,1,4,4,10,-6,4
Panionios,4266,3,1,1,4,4,10,-6,4
AEK Athens,4267,1,4,2,0,7,1,6,14
PAOK Salonik,4267,2,3,2,1,11,5,6,11
P'thinaikos,4267,3,1,1,4,5,11,-6,4
Panionios,4267,4,1,1,4,4,10,-6,4
AEK Athens,4268,1,4,2,0,7,1,6,14
PAOK Salonik,4268,2,2,2,2,9,7,2,8
P'thinaikos,4268,3,2,1,3,7,9,-2,7
Panionios,4268,4,1,1,4,4,10,-6,4
AEK Athens,4269,1,4,2,0,7,1,6,14
PAOK Salonik,4269,2,3,2,1,11,4,7,11
Panionios,4269,3,1,1,4,4,10,-6,4
P'thinaikos,4269,4,1,1,4,4,11,-7,4
AEK Athens,4270,1,4,2,0,7,1,6,14
PAOK Salonik,4270,2,3,2,1,11,5,6,11
P'thinaikos,4270,3,1,1,4,5,11,-6,4
Panionios,4270,4,1,1,4,4,10,-6,4
AEK Athens,4271,1,4,2,0,7,1,6,14
PAOK Salonik,4271,2,3,2,1,12,6,6,11
P'thinaikos,4271,3,1,1,4,6,12,-6,4
Panionios,4271,4,1,1,4,4,10,-6,4
AEK Athens,4272,1,4,2,0,7,1,6,14
PAOK Salonik,4272,2,3,2,1,10,4,6,11
P'thinaikos,4272,3,1,1,4,4,10,-6,4
Panionios,4272,3,1,1,4,4,10,-6,4
AEK Athens,4273,1,4,2,0,7,1,6,14
PAOK Salonik,4273,2,3,2,1,11,4,7,11
Panionios,4273,3,1,1,4,4,10,-6,4
P'thinaikos,4273,4,1,1,4,4,11,-7,4
AEK Athens,4274,1,4,2,0,7,1,6,14
PAOK Salonik,4274,2,2,2,2,10,7,3,8
P'thinaikos,4274,3,2,1,3,7,10,-3,7
Panionios,4274,4,1,1,4,4,10,-6,4
AEK Athens,4275,1,4,2,0,7,1,6,14
PAOK Salonik,4275,2,2,3,1,9,4,5,9
P'thinaikos,4275,3,1,2,3,4,9,-5,5
Panionios,4275,4,1,1,4,4,10,-6,4
AEK Athens,4276,1,4,2,0,7,1,6,14
PAOK Salonik,4276,2,2,2,2,11,7,4,8
P'thinaikos,4276,3,2,1,3,7,11,-4,7
Panionios,4276,4,1,1,4,4,10,-6,4
AEK Athens,4277,1,4,2,0,7,1,6,14
PAOK Salonik,4277,2,2,3,1,12,7,5,9
P'thinaikos,4277,3,1,2,3,7,12,-5,5
Panionios,4277,4,1,1,4,4,10,-6,4
AEK Athens,4278,1,4,2,0,7,1,6,14
PAOK Salonik,4278,2,3,2,1,10,4,6,11
P'thinaikos,4278,3,1,1,4,4,10,-6,4
Panionios,4278,3,1,1,4,4,10,-6,4
AEK Athens,4279,1,4,2,0,7,1,6,14
PAOK Salonik,4279,2,2,2,2,10,8,2,8
P'thinaikos,4279,3,2,1,3,8,10,-2,7
Panionios,4279,4,1,1,4,4,10,-6,4
AEK Athens,4280,1,4,2,0,7,1,6,14
PAOK Salonik,4280,2,2,3,1,10,5,5,9
P'thinaikos,4280,3,1,2,3,5,10,-5,5
Panionios,4280,4,1,1,4,4,10,-6,4
AEK Athens,4281,1,4,2,0,7,1,6,14
PAOK Salonik,4281,2,2,2,2,9,5,4,8
P'thinaikos,4281,3,2,1,3,5,9,-4,7
Panionios,4281,4,1,1,4,4,10,-6,4
AEK Athens,4282,1,4,2,0,7,1,6,14
PAOK Salonik,4282,2,2,3,1,9,4,5,9
P'thinaikos,4282,3,1,2,3,4,9,-5,5
Panionios,4282,4,1,1,4,4,10,-6,4
AEK Athens,4283,1,4,2,0,7,1,6,14
PAOK Salonik,4283,2,2,3,1,10,5,5,9
P'thinaikos,4283,3,1,2,3,5,10,-5,5
Panionios,4283,4,1,1,4,4,10,-6,4
AEK Athens,4284,1,4,2,0,7,1,6,14
PAOK Salonik,4284,2,2,2,2,11,7,4,8
P'thinaikos,4284,3,2,1,3,7,11,-4,7
Panionios,4284,4,1,1,4,4,10,-6,4
AEK Athens,4285,1,4,2,0,7,1,6,14
PAOK Salonik,4285,2,3,2,1,11,5,6,11
P'thinaikos,4285,3,1,1,4,5,11,-6,4
Panionios,4285,4,1,1,4,4,10,-6,4
AEK Athens,4286,1,4,2,0,7,1,6,14
PAOK Salonik,4286,2,3,2,1,12,5,7,11
Panionios,4286,3,1,1,4,4,10,-6,4
P'thinaikos,4286,4,1,1,4,5,12,-7,4
AEK Athens,4287,1,4,2,0,7,1,6,14
PAOK Salonik,4287,2,3,2,1,11,4,7,11
Panionios,4287,3,1,1,4,4,10,-6,4
P'thinaikos,4287,4,1,1,4,4,11,-7,4
AEK Athens,4288,1,4,2,0,7,1,6,14
PAOK Salonik,4288,2,2,3,1,11,6,5,9
P'thinaikos,4288,3,1,2,3,6,11,-5,5
Panionios,4288,4,1,1,4,4,10,-6,4
AEK Athens,4289,1,4,2,0,7,1,6,14
PAOK Salonik,4289,2,2,3,1,9,4,5,9
P'thinaikos,4289,3,1,2,3,4,9,-5,5
Panionios,4289,4,1,1,4,4,10,-6,4
AEK Athens,4290,1,4,2,0,7,1,6,14
PAOK Salonik,4290,2,2,2,2,9,6,3,8
P'thinaikos,4290,3,2,1,3,6,9,-3,7
Panionios,4290,4,1,1,4,4,10,-6,4
AEK Athens,4291,1,4,2,0,7,1,6,14
PAOK Salonik,4291,2,2,2,2,10,8,2,8
P'thinaikos,4291,3,2,1,3,8,10,-2,7
Panionios,4291,4,1,1,4,4,10,-6,4
AEK Athens,4292,1,4,2,0,7,1,6,14
PAOK Salonik,4292,2,3,2,1,10,4,6,11
P'thinaikos,4292,3,1,1,4,4,10,-6,4
Panionios,4292,3,1,1,4,4,10,-6,4
AEK Athens,4293,1,4,2,0,7,1,6,14
PAOK Salonik,4293,2,2,2,2,10,7,3,8
P'thinaikos,4293,3,2,1,3,7,10,-3,7
Panionios,4293,4,1,1,4,4,10,-6,4
AEK Athens,4294,1,4,2,0,7,1,6,14
PAOK Salonik,4294,2,3,2,1,11,5,6,11
P'thinaikos,4294,3,1,1,4,5,11,-6,4
Panionios,4294,4,1,1,4,4,10,-6,4
AEK Athens,4295,1,4,2,0,7,1,6,14
PAOK Salonik,4295,2,3,2,1,12,6,6,11
P'thinaikos,4295,3,1,1,4,6,12,-6,4
Panionios,4295,4,1,1,4,4,10,-6,4
AEK Athens,4296,1,4,2,0,7,1,6,14
PAOK Salonik,4296,2,3,2,1,12,6,6,11
P'thinaikos,4296,3,1,1,4,6,12,-6,4
Panionios,4296,4,1,1,4,4,10,-6,4
AEK Athens,4297,1,4,2,0,7,1,6,14
PAOK Salonik,4297,2,3,2,1,11,5,6,11
P'thinaikos,4297,3,1,1,4,5,11,-6,4
Panionios,4297,4,1,1,4,4,10,-6,4
AEK Athens,4298,1,4,2,0,7,1,6,14
PAOK Salonik,4298,2,2,2,2,11,8,3,8
P'thinaikos,4298,3,2,1,3,8,11,-3,7
Panionios,4298,4,1,1,4,4,10,-6,4
AEK Athens,4299,1,4,2,0,7,1,6,14
PAOK Salonik,4299,2,2,2,2,9,5,4,8
P'thinaikos,4299,3,2,1,3,5,9,-4,7
Panionios,4299,4,1,1,4,4,10,-6,4
AEK Athens,4300,1,4,2,0,7,1,6,14
PAOK Salonik,4300,2,3,2,1,12,6,6,11
P'thinaikos,4300,3,1,1,4,6,12,-6,4
Panionios,4300,4,1,1,4,4,10,-6,4
AEK Athens,4301,1,4,2,0,7,1,6,14
PAOK Salonik,4301,2,3,2,1,11,4,7,11
Panionios,4301,3,1,1,4,4,10,-6,4
P'thinaikos,4301,4,1,1,4,4,11,-7,4
AEK Athens,4302,1,4,2,0,7,1,6,14
PAOK Salonik,4302,2,2,2,2,10,6,4,8
P'thinaikos,4302,3,2,1,3,6,10,-4,7
Panionios,4302,4,1,1,4,4,10,-6,4
AEK Athens,4303,1,4,2,0,7,1,6,14
PAOK Salonik,4303,2,2,2,2,10,6,4,8
P'thinaikos,4303,3,2,1,3,6,10,-4,7
Panionios,4303,4,1,1,4,4,10,-6,4
AEK Athens,4304,1,4,2,0,7,1,6,14
PAOK Salonik,4304,2,2,3,1,9,4,5,9
P'thinaikos,4304,3,1,2,3,4,9,-5,5
Panionios,4304,4,1,1,4,4,10,-6,4
AEK Athens,4305,1,4,2,0,7,1,6,14
PAOK Salonik,4305,2,2,2,2,11,7,4,8
P'thinaikos,4305,3,2,1,3,7,11,-4,7
Panionios,4305,4,1,1,4,4,10,-6,4
AEK Athens,4306,1,4,2,0,7,1,6,14
PAOK Salonik,4306,2,2,2,2,9,5,4,8
P'thinaikos,4306,3,2,1,3,5,9,-4,7
Panionios,4306,4,1,1,4,4,10,-6,4
AEK Athens,4307,1,4,2,0,7,1,6,14
PAOK Salonik,4307,2,3,2,1,10,4,6,11
P'thinaikos,4307,3,1,1,4,4,10,-6,4
Panionios,4307,3,1,1,4,4,10,-6,4
AEK Athens,4308,1,4,2,0,7,1,6,14
PAOK Salonik,4308,2,3,2,1,11,4,7,11
Panionios,4308,3,1,1,4,4,10,-6,4
P'thinaikos,4308,4,1,1,4,4,11,-7,4
AEK Athens,4309,1,4,2,0,7,1,6,14
PAOK Salonik,4309,2,2,2,2,10,8,2,8
P'thinaikos,4309,3,2,1,3,8,10,-2,7
Panionios,4309,4,1,1,4,4,10,-6,4
AEK Athens,4310,1,4,2,0,7,1,6,14
PAOK Salonik,4310,2,2,2,2,9,5,4,8
P'thinaikos,4310,3,2,1,3,5,9,-4,7
Panionios,4310,4,1,1,4,4,10,-6,4
AEK Athens,4311,1,4,2,0,7,1,6,14
PAOK Salonik,4311,2,2,2,2,9,5,4,8
P'thinaikos,4311,3,2,1,3,5,9,-4,7
Panionios,4311,4,1,1,4,4,10,-6,4
AEK Athens,4312,1,4,2,0,7,1,6,14
PAOK Salonik,4312,2,2,2,2,9,6,3,8
P'thinaikos,4312,3,2,1,3,6,9,-3,7
Panionios,4312,4,1,1,4,4,10,-6,4
AEK Athens,4313,1,4,2,0,7,1,6,14
PAOK Salonik,4313,2,3,2,1,12,5,7,11
Panionios,4313,3,1,1,4,4,10,-6,4
P'thinaikos,4313,4,1,1,4,5,12,-7,4
AEK Athens,4314,1,4,2,0,7,1,6,14
PAOK Salonik,4314,2,3,2,1,12,6,6,11
P'thinaikos,4314,3,1,1,4,6,12,-6,4
Panionios,4314,4,1,1,4,4,10,-6,4
AEK Athens,4315,1,4,2,0,7,1,6,14
PAOK Salonik,4315,2,3,2,1,11,4,7,11
Panionios,4315,3,1,1,4,4,10,-6,4
P'thinaikos,4315,4,1,1,4,4,11,-7,4
AEK Athens,4316,1,4,2,0,7,1,6,14
PAOK Salonik,4316,2,2,3,1,9,4,5,9
P'thinaikos,4316,3,1,2,3,4,9,-5,5
Panionios,4316,4,1,1,4,4,10,-6,4
AEK Athens,4317,1,4,2,0,7,1,6,14
PAOK Salonik,4317,2,3,2,1,10,4,6,11
P'thinaikos,4317,3,1,1,4,4,10,-6,4
Panionios,4317,3,1,1,4,4,10,-6,4
AEK Athens,4318,1,4,2,0,7,1,6,14
PAOK Salonik,4318,2,2,3,1,11,6,5,9
P'thinaikos,4318,3,1,2,3,6,11,-5,5
Panionios,4318,4,1,1,4,4,10,-6,4
AEK Athens,4319,1,4,2,0,7,1,6,14
PAOK Salonik,4319,2,2,2,2,9,6,3,8
P'thinaikos,4319,3,2,1,3,6,9,-3,7
Panionios,4319,4,1,1,4,4,10,-6,4
AEK Athens,4320,1,4,2,0,7,1,6,14
PAOK Salonik,4320,2,3,2,1,10,4,6,11
P'thinaikos,4320,3,1,1,4,4,10,-6,4
Panionios,4320,3,1,1,4,4,10,-6,4
AEK Athens,4321,1,4,2,0,7,1,6,14
PAOK Salonik,4321,2,2,2,2,10,7,3,8
P'thinaikos,4321,3,2,1,3,7,10,-3,7
Panionios,4321,4,1,1,4,4,10,-6,4
AEK Athens,4322,1,4,2,0,7,1,6,14
PAOK Salonik,4322,2,2,3,1,11,6,5,9
P'thinaikos,4322,3,1,2,3,6,11,-5,5
Panionios,4322,4,1,1,4,4,10,-6,4
AEK Athens,4323,1,4,2,0,7,1,6,14
PAOK Salonik,4323,2,2,3,1,11,6,5,9
P'thinaikos,4323,3,1,2,3,6,11,-5,5
Panionios,4323,4,1,1,4,4,10,-6,4
AEK Athens,4324,1,4,2,0,7,1,6,14
PAOK Salonik,4324,2,3,2,1,12,6,6,11
P'thinaikos,4324,3,1,1,4,6,12,-6,4
Panionios,4324,4,1,1,4,4,10,-6,4
AEK Athens,4325,1,4,2,0,7,1,6,14
PAOK Salonik,4325,2,2,2,2,11,8,3,8
P'thinaikos,4325,3,2,1,3,8,11,-3,7
Panionios,4325,4,1,1,4,4,10,-6,4
AEK Athens,4326,1,4,2,0,7,1,6,14
PAOK Salonik,4326,2,3,2,1,11,4,7,11
Panionios,4326,3,1,1,4,4,10,-6,4
P'thinaikos,4326,4,1,1,4,4,11,-7,4
AEK Athens,4327,1,4,2,0,7,1,6,14
PAOK Salonik,4327,2,2,2,2,9,8,1,8
P'thinaikos,4327,3,2,1,3,8,9,-1,7
Panionios,4327,4,1,1,4,4,10,-6,4
AEK Athens,4328,1,4,2,0,7,1,6,14
PAOK Salonik,4328,2,2,2,2,9,5,4,8
P'thinaikos,4328,3,2,1,3,5,9,-4,7
Panionios,4328,4,1,1,4,4,10,-6,4
AEK Athens,4329,1,4,2,0,7,1,6,14
PAOK Salonik,4329,2,2,2,2,9,6,3,8
P'thinaikos,4329,3,2,1,3,6,9,-3,7
Panionios,4329,4,1,1,4,4,10,-6,4
AEK Athens,4330,1,4,2,0,7,1,6,14
PAOK Salonik,4330,2,3,2,1,11,5,6,11
P'thinaikos,4330,3,1,1,4,5,11,-6,4
Panionios,4330,4,1,1,4,4,10,-6,4
AEK Athens,4331,1,4,2,0,7,1,6,14
PAOK Salonik,4331,2,3,2,1,10,4,6,11
P'thinaikos,4331,3,1,1,4,4,10,-6,4
Panionios,4331,3,1,1,4,4,10,-6,4
AEK Athens,4332,1,4,2,0,7,1,6,14
PAOK Salonik,4332,2,2,2,2,10,6,4,8
P'thinaikos,4332,3,2,1,3,6,10,-4,7
Panionios,4332,4,1,1,4,4,10,-6,4
AEK Athens,4333,1,4,2,0,7,1,6,14
PAOK Salonik,4333,2,3,2,1,11,4,7,11
Panionios,4333,3,1,1,4,4,10,-6,4
P'thinaikos,4333,4,1,1,4,4,11,-7,4
AEK Athens,4334,1,4,2,0,7,1,6,14
PAOK Salonik,4334,2,3,2,1,10,4,6,11
P'thinaikos,4334,3,1,1,4,4,10,-6,4
Panionios,4334,3,1,1,4,4,10,-6,4
AEK Athens,4335,1,4,2,0,7,1,6,14
PAOK Salonik,4335,2,2,3,1,10,5,5,9
P'thinaikos,4335,3,1,2,3,5,10,-5,5
Panionios,4335,4,1,1,4,4,10,-6,4
AEK Athens,4336,1,4,2,0,7,1,6,14
PAOK Salonik,4336,2,2,3,1,10,5,5,9
P'thinaikos,4336,3,1,2,3,5,10,-5,5
Panionios,4336,4,1,1,4,4,10,-6,4
AEK Athens,4337,1,4,2,0,7,1,6,14
PAOK Salonik,4337,2,2,3,1,9,4,5,9
P'thinaikos,4337,3,1,2,3,4,9,-5,5
Panionios,4337,4,1,1,4,4,10,-6,4
AEK Athens,4338,1,4,2,0,7,1,6,14
PAOK Salonik,4338,2,3,2,1,10,4,6,11
P'thinaikos,4338,3,1,1,4,4,10,-6,4
Panionios,4338,3,1,1,4,4,10,-6,4
AEK Athens,4339,1,4,2,0,7,1,6,14
PAOK Salonik,4339,2,2,3,1,9,4,5,9
P'thinaikos,4339,3,1,2,3,4,9,-5,5
Panionios,4339,4,1,1,4,4,10,-6,4
AEK Athens,4340,1,4,2,0,7,1,6,14
PAOK Salonik,4340,2,2,2,2,11,8,3,8
P'thinaikos,4340,3,2,1,3,8,11,-3,7
Panionios,4340,4,1,1,4,4,10,-6,4
AEK Athens,4341,1,4,2,0,7,1,6,14
PAOK Salonik,4341,2,3,2,1,12,5,7,11
Panionios,4341,3,1,1,4,4,10,-6,4
P'thinaikos,4341,4,1,1,4,5,12,-7,4
AEK Athens,4342,1,4,2,0,7,1,6,14
PAOK Salonik,4342,2,2,2,2,9,6,3,8
P'thinaikos,4342,3,2,1,3,6,9,-3,7
Panionios,4342,4,1,1,4,4,10,-6,4
AEK Athens,4343,1,4,2,0,7,1,6,14
PAOK Salonik,4343,2,2,2,2,9,5,4,8
P'thinaikos,4343,3,2,1,3,5,9,-4,7
Panionios,4343,4,1,1,4,4,10,-6,4
AEK Athens,4344,1,4,2,0,7,1,6,14
PAOK Salonik,4344,2,2,3,1,11,6,5,9
P'thinaikos,4344,3,1,2,3,6,11,-5,5
Panionios,4344,4,1,1,4,4,10,-6,4
AEK Athens,4345,1,4,2,0,7,1,6,14
PAOK Salonik,4345,2,2,3,1,10,5,5,9
P'thinaikos,4345,3,1,2,3,5,10,-5,5
Panionios,4345,4,1,1,4,4,10,-6,4
AEK Athens,4346,1,4,2,0,7,1,6,14
PAOK Salonik,4346,2,2,3,1,10,5,5,9
P'thinaikos,4346,3,1,2,3,5,10,-5,5
Panionios,4346,4,1,1,4,4,10,-6,4
AEK Athens,4347,1,4,2,0,7,1,6,14
PAOK Salonik,4347,2,2,2,2,10,6,4,8
P'thinaikos,4347,3,2,1,3,6,10,-4,7
Panionios,4347,4,1,1,4,4,10,-6,4
AEK Athens,4348,1,4,2,0,7,1,6,14
PAOK Salonik,4348,2,2,3,1,11,6,5,9
P'thinaikos,4348,3,1,2,3,6,11,-5,5
Panionios,4348,4,1,1,4,4,10,-6,4
AEK Athens,4349,1,4,2,0,7,1,6,14
PAOK Salonik,4349,2,2,2,2,10,7,3,8
P'thinaikos,4349,3,2,1,3,7,10,-3,7
Panionios,4349,4,1,1,4,4,10,-6,4
AEK Athens,4350,1,4,2,0,7,1,6,14
PAOK Salonik,4350,2,2,2,2,9,8,1,8
P'thinaikos,4350,3,2,1,3,8,9,-1,7
Panionios,4350,4,1,1,4,4,10,-6,4
AEK Athens,4351,1,4,2,0,7,1,6,14
PAOK Salonik,4351,2,3,2,1,12,4,8,11
Panionios,4351,3,1,1,4,4,10,-6,4
P'thinaikos,4351,4,1,1,4,4,12,-8,4
AEK Athens,4352,1,4,2,0,7,1,6,14
PAOK Salonik,4352,2,3,2,1,10,4,6,11
P'thinaikos,4352,3,1,1,4,4,10,-6,4
Panionios,4352,3,1,1,4,4,10,-6,4
AEK Athens,4353,1,4,2,0,7,1,6,14
PAOK Salonik,4353,2,2,3,1,9,4,5,9
P'thinaikos,4353,3,1,2,3,4,9,-5,5
Panionios,4353,4,1,1,4,4,10,-6,4
AEK Athens,4354,1,4,2,0,7,1,6,14
PAOK Salonik,4354,2,3,2,1,10,4,6,11
P'thinaikos,4354,3,1,1,4,4,10,-6,4
Panionios,4354,3,1,1,4,4,10,-6,4
AEK Athens,4355,1,4,2,0,7,1,6,14
PAOK Salonik,4355,2,3,2,1,10,4,6,11
P'thinaikos,4355,3,1,1,4,4,10,-6,4
Panionios,4355,3,1,1,4,4,10,-6,4
AEK Athens,4356,1,4,2,0,7,1,6,14
PAOK Salonik,4356,2,3,2,1,12,6,6,11
P'thinaikos,4356,3,1,1,4,6,12,-6,4
Panionios,4356,4,1,1,4,4,10,-6,4
AEK Athens,4357,1,4,2,0,7,1,6,14
PAOK Salonik,4357,2,2,2,2,9,6,3,8
P'thinaikos,4357,3,2,1,3,6,9,-3,7
Panionios,4357,4,1,1,4,4,10,-6,4
AEK Athens,4358,1,4,2,0,7,1,6,14
PAOK Salonik,4358,2,3,2,1,11,5,6,11
P'thinaikos,4358,3,1,1,4,5,11,-6,4
Panionios,4358,4,1,1,4,4,10,-6,4
AEK Athens,4359,1,4,2,0,7,1,6,14
PAOK Salonik,4359,2,3,2,1,11,5,6,11
P'thinaikos,4359,3,1,1,4,5,11,-6,4
Panionios,4359,4,1,1,4,4,10,-6,4
AEK Athens,4360,1,4,2,0,7,1,6,14
PAOK Salonik,4360,2,3,2,1,11,5,6,11
P'thinaikos,4360,3,1,1,4,5,11,-6,4
Panionios,4360,4,1,1,4,4,10,-6,4
AEK Athens,4361,1,4,2,0,7,1,6,14
PAOK Salonik,4361,2,3,2,1,10,4,6,11
P'thinaikos,4361,3,1,1,4,4,10,-6,4
Panionios,4361,3,1,1,4,4,10,-6,4
AEK Athens,4362,1,4,2,0,7,1,6,14
PAOK Salonik,4362,2,3,2,1,11,4,7,11
Panionios,4362,3,1,1,4,4,10,-6,4
P'thinaikos,4362,4,1,1,4,4,11,-7,4
AEK Athens,4363,1,4,2,0,7,1,6,14
PAOK Salonik,4363,2,2,2,2,10,6,4,8
P'thinaikos,4363,3,2,1,3,6,10,-4,7
Panionios,4363,4,1,1,4,4,10,-6,4
AEK Athens,4364,1,4,2,0,7,1,6,14
PAOK Salonik,4364,2,2,3,1,9,4,5,9
P'thinaikos,4364,3,1,2,3,4,9,-5,5
Panionios,4364,4,1,1,4,4,10,-6,4
AEK Athens,4365,1,4,2,0,7,1,6,14
PAOK Salonik,4365,2,3,2,1,11,5,6,11
P'thinaikos,4365,3,1,1,4,5,11,-6,4
Panionios,4365,4,1,1,4,4,10,-6,4
AEK Athens,4366,1,4,2,0,7,1,6,14
PAOK Salonik,4366,2,3,2,1,10,4,6,11
P'thinaikos,4366,3,1,1,4,4,10,-6,4
Panionios,4366,3,1,1,4,4,10,-6,4
AEK Athens,4367,1,4,2,0,7,1,6,14
PAOK Salonik,4367,2,3,2,1,11,4,7,11
Panionios,4367,3,1,1,4,4,10,-6,4
P'thinaikos,4367,4,1,1,4,4,11,-7,4
AEK Athens,4368,1,4,2,0,7,1,6,14
PAOK Salonik,4368,2,2,3,1,9,4,5,9
P'thinaikos,4368,3,1,2,3,4,9,-5,5
Panionios,4368,4,1,1,4,4,10,-6,4
AEK Athens,4369,1,4,2,0,7,1,6,14
PAOK Salonik,4369,2,3,2,1,12,4,8,11
Panionios,4369,3,1,1,4,4,10,-6,4
P'thinaikos,4369,4,1,1,4,4,12,-8,4
AEK Athens,4370,1,4,2,0,7,1,6,14
PAOK Salonik,4370,2,3,2,1,12,5,7,11
Panionios,4370,3,1,1,4,4,10,-6,4
P'thinaikos,4370,4,1,1,4,5,12,-7,4
AEK Athens,4371,1,4,2,0,7,1,6,14
PAOK Salonik,4371,2,2,3,1,10,5,5,9
P'thinaikos,4371,3,1,2,3,5,10,-5,5
Panionios,4371,4,1,1,4,4,10,-6,4
AEK Athens,4372,1,4,2,0,7,1,6,14
PAOK Salonik,4372,2,2,2,2,10,6,4,8
P'thinaikos,4372,3,2,1,3,6,10,-4,7
Panionios,4372,4,1,1,4,4,10,-6,4
AEK Athens,4373,1,4,2,0,7,1,6,14
PAOK Salonik,4373,2,3,2,1,11,4,7,11
Panionios,4373,3,1,1,4,4,10,-6,4
P'thinaikos,4373,4,1,1,4,4,11,-7,4
AEK Athens,4374,1,4,2,0,7,1,6,14
PAOK Salonik,4374,2,2,2,2,10,7,3,8
P'thinaikos,4374,3,2,1,3,7,10,-3,7
Panionios,4374,4,1,1,4,4,10,-6,4
AEK Athens,4375,1,4,2,0,7,1,6,14
PAOK Salonik,4375,2,2,3,1,11,6,5,9
P'thinaikos,4375,3,1,2,3,6,11,-5,5
Panionios,4375,4,1,1,4,4,10,-6,4
AEK Athens,4376,1,4,2,0,7,1,6,14
PAOK Salonik,4376,2,2,3,1,11,6,5,9
P'thinaikos,4376,3,1,2,3,6,11,-5,5
Panionios,4376,4,1,1,4,4,10,-6,4
AEK Athens,4377,1,4,2,0,7,1,6,14
PAOK Salonik,4377,2,3,2,1,11,5,6,11
P'thinaikos,4377,3,1,1,4,5,11,-6,4
Panionios,4377,4,1,1,4,4,10,-6,4
AEK Athens,4378,1,4,2,0,7,1,6,14
PAOK Salonik,4378,2,3,2,1,11,4,7,11
Panionios,4378,3,1,1,4,4,10,-6,4
P'thinaikos,4378,4,1,1,4,4,11,-7,4
AEK Athens,4379,1,4,2,0,7,1,6,14
PAOK Salonik,4379,2,3,2,1,11,4,7,11
Panionios,4379,3,1,1,4,4,10,-6,4
P'thinaikos,4379,4,1,1,4,4,11,-7,4
AEK Athens,4380,1,4,2,0,7,1,6,14
PAOK Salonik,4380,2,3,2,1,10,4,6,11
P'thinaikos,4380,3,1,1,4,4,10,-6,4
Panionios,4380,3,1,1,4,4,10,-6,4
AEK Athens,4381,1,4,2,0,7,1,6,14
PAOK Salonik,4381,2,3,2,1,10,4,6,11
P'thinaikos,4381,3,1,1,4,4,10,-6,4
Panionios,4381,3,1,1,4,4,10,-6,4
AEK Athens,4382,1,4,2,0,7,1,6,14
PAOK Salonik,4382,2,2,2,2,9,5,4,8
P'thinaikos,4382,3,2,1,3,5,9,-4,7
Panionios,4382,4,1,1,4,4,10,-6,4
AEK Athens,4383,1,4,2,0,7,1,6,14
PAOK Salonik,4383,2,2,3,1,10,5,5,9
P'thinaikos,4383,3,1,2,3,5,10,-5,5
Panionios,4383,4,1,1,4,4,10,-6,4
AEK Athens,4384,1,4,2,0,7,1,6,14
PAOK Salonik,4384,2,3,2,1,11,5,6,11
P'thinaikos,4384,3,1,1,4,5,11,-6,4
Panionios,4384,4,1,1,4,4,10,-6,4
AEK Athens,4385,1,4,2,0,7,1,6,14
PAOK Salonik,4385,2,2,2,2,10,6,4,8
P'thinaikos,4385,3,2,1,3,6,10,-4,7
Panionios,4385,4,1,1,4,4,10,-6,4
AEK Athens,4386,1,4,2,0,7,1,6,14
PAOK Salonik,4386,2,2,2,2,12,8,4,8
P'thinaikos,4386,3,2,1,3,8,12,-4,7
Panionios,4386,4,1,1,4,4,10,-6,4
AEK Athens,4387,1,4,2,0,7,1,6,14
PAOK Salonik,4387,2,2,3,1,10,5,5,9
P'thinaikos,4387,3,1,2,3,5,10,-5,5
Panionios,4387,4,1,1,4,4,10,-6,4
AEK Athens,4388,1,4,2,0,7,1,6,14
PAOK Salonik,4388,2,3,2,1,10,4,6,11
P'thinaikos,4388,3,1,1,4,4,10,-6,4
Panionios,4388,3,1,1,4,4,10,-6,4
AEK Athens,4389,1,4,2,0,7,1,6,14
PAOK Salonik,4389,2,2,3,1,9,4,5,9
P'thinaikos,4389,3,1,2,3,4,9,-5,5
Panionios,4389,4,1,1,4,4,10,-6,4
AEK Athens,4390,1,4,2,0,7,1,6,14
PAOK Salonik,4390,2,2,2,2,10,7,3,8
P'thinaikos,4390,3,2,1,3,7,10,-3,7
Panionios,4390,4,1,1,4,4,10,-6,4
AEK Athens,4391,1,4,2,0,7,1,6,14
PAOK Salonik,4391,2,3,2,1,10,4,6,11
P'thinaikos,4391,3,1,1,4,4,10,-6,4
Panionios,4391,3,1,1,4,4,10,-6,4
AEK Athens,4392,1,4,2,0,7,1,6,14
PAOK Salonik,4392,2,3,2,1,12,5,7,11
Panionios,4392,3,1,1,4,4,10,-6,4
P'thinaikos,4392,4,1,1,4,5,12,-7,4
AEK Athens,4393,1,4,2,0,7,1,6,14
PAOK Salonik,4393,2,3,2,1,12,6,6,11
P'thinaikos,4393,3,1,1,4,6,12,-6,4
Panionios,4393,4,1,1,4,4,10,-6,4
AEK Athens,4394,1,4,2,0,7,1,6,14
PAOK Salonik,4394,2,2,2,2,10,6,4,8
P'thinaikos,4394,3,2,1,3,6,10,-4,7
Panionios,4394,4,1,1,4,4,10,-6,4
AEK Athens,4395,1,4,2,0,7,1,6,14
PAOK Salonik,4395,2,2,3,1,10,5,5,9
P'thinaikos,4395,3,1,2,3,5,10,-5,5
Panionios,4395,4,1,1,4,4,10,-6,4
AEK Athens,4396,1,4,2,0,7,1,6,14
PAOK Salonik,4396,2,2,2,2,10,7,3,8
P'thinaikos,4396,3,2,1,3,7,10,-3,7
Panionios,4396,4,1,1,4,4,10,-6,4
AEK Athens,4397,1,4,2,0,7,1,6,14
PAOK Salonik,4397,2,3,2,1,10,4,6,11
P'thinaikos,4397,3,1,1,4,4,10,-6,4
Panionios,4397,3,1,1,4,4,10,-6,4
AEK Athens,4398,1,4,2,0,7,1,6,14
PAOK Salonik,4398,2,2,3,1,9,4,5,9
P'thinaikos,4398,3,1,2,3,4,9,-5,5
Panionios,4398,4,1,1,4,4,10,-6,4
AEK Athens,4399,1,4,2,0,7,1,6,14
PAOK Salonik,4399,2,2,3,1,9,4,5,9
P'thinaikos,4399,3,1,2,3,4,9,-5,5
Panionios,4399,4,1,1,4,4,10,-6,4
AEK Athens,4400,1,4,2,0,7,1,6,14
PAOK Salonik,4400,2,3,2,1,10,4,6,11
P'thinaikos,4400,3,1,1,4,4,10,-6,4
Panionios,4400,3,1,1,4,4,10,-6,4
AEK Athens,4401,1,4,2,0,7,1,6,14
PAOK Salonik,4401,2,3,2,1,11,5,6,11
P'thinaikos,4401,3,1,1,4,5,11,-6,4
Panionios,4401,4,1,1,4,4,10,-6,4
AEK Athens,4402,1,4,2,0,7,1,6,14
PAOK Salonik,4402,2,3,2,1,10,4,6,11
P'thinaikos,4402,3,1,1,4,4,10,-6,4
Panionios,4402,3,1,1,4,4,10,-6,4
AEK Athens,4403,1,4,2,0,7,1,6,14
PAOK Salonik,4403,2,3,2,1,13,6,7,11
Panionios,4403,3,1,1,4,4,10,-6,4
P'thinaikos,4403,4,1,1,4,6,13,-7,4
AEK Athens,4404,1,4,2,0,7,1,6,14
PAOK Salonik,4404,2,2,2,2,10,6,4,8
P'thinaikos,4404,3,2,1,3,6,10,-4,7
Panionios,4404,4,1,1,4,4,10,-6,4
AEK Athens,4405,1,4,2,0,7,1,6,14
PAOK Salonik,4405,2,2,2,2,10,8,2,8
P'thinaikos,4405,3,2,1,3,8,10,-2,7
Panionios,4405,4,1,1,4,4,10,-6,4
AEK Athens,4406,1,4,2,0,7,1,6,14
PAOK Salonik,4406,2,2,2,2,11,9,2,8
P'thinaikos,4406,3,2,1,3,9,11,-2,7
Panionios,4406,4,1,1,4,4,10,-6,4
AEK Athens,4407,1,4,2,0,7,1,6,14
PAOK Salonik,4407,2,2,2,2,9,5,4,8
P'thinaikos,4407,3,2,1,3,5,9,-4,7
Panionios,4407,4,1,1,4,4,10,-6,4
AEK Athens,4408,1,4,2,0,7,1,6,14
PAOK Salonik,4408,2,3,2,1,14,4,10,11
Panionios,4408,3,1,1,4,4,10,-6,4
P'thinaikos,4408,4,1,1,4,4,14,-10,4
AEK Athens,4409,1,4,2,0,7,1,6,14
PAOK Salonik,4409,2,2,2,2,9,5,4,8
P'thinaikos,4409,3,2,1,3,5,9,-4,7
Panionios,4409,4,1,1,4,4,10,-6,4
AEK Athens,4410,1,4,2,0,7,1,6,14
PAOK Salonik,4410,2,2,3,1,10,5,5,9
P'thinaikos,4410,3,1,2,3,5,10,-5,5
Panionios,4410,4,1,1,4,4,10,-6,4
AEK Athens,4411,1,4,2,0,7,1,6,14
PAOK Salonik,4411,2,2,2,2,9,5,4,8
P'thinaikos,4411,3,2,1,3,5,9,-4,7
Panionios,4411,4,1,1,4,4,10,-6,4
AEK Athens,4412,1,4,2,0,7,1,6,14
PAOK Salonik,4412,2,2,3,1,10,5,5,9
P'thinaikos,4412,3,1,2,3,5,10,-5,5
Panionios,4412,4,1,1,4,4,10,-6,4
AEK Athens,4413,1,4,2,0,7,1,6,14
PAOK Salonik,4413,2,2,3,1,10,5,5,9
P'thinaikos,4413,3,1,2,3,5,10,-5,5
Panionios,4413,4,1,1,4,4,10,-6,4
AEK Athens,4414,1,4,2,0,7,1,6,14
PAOK Salonik,4414,2,3,2,1,11,5,6,11
P'thinaikos,4414,3,1,1,4,5,11,-6,4
Panionios,4414,4,1,1,4,4,10,-6,4
AEK Athens,4415,1,4,2,0,7,1,6,14
PAOK Salonik,4415,2,2,3,1,9,4,5,9
P'thinaikos,4415,3,1,2,3,4,9,-5,5
Panionios,4415,4,1,1,4,4,10,-6,4
AEK Athens,4416,1,4,2,0,7,1,6,14
PAOK Salonik,4416,2,2,3,1,10,5,5,9
P'thinaikos,4416,3,1,2,3,5,10,-5,5
Panionios,4416,4,1,1,4,4,10,-6,4
AEK Athens,4417,1,4,2,0,7,1,6,14
PAOK Salonik,4417,2,2,3,1,9,4,5,9
P'thinaikos,4417,3,1,2,3,4,9,-5,5
Panionios,4417,4,1,1,4,4,10,-6,4
AEK Athens,4418,1,4,2,0,7,1,6,14
PAOK Salonik,4418,2,3,2,1,10,4,6,11
P'thinaikos,4418,3,1,1,4,4,10,-6,4
Panionios,4418,3,1,1,4,4,10,-6,4
AEK Athens,4419,1,4,2,0,7,1,6,14
PAOK Salonik,4419,2,2,3,1,9,4,5,9
P'thinaikos,4419,3,1,2,3,4,9,-5,5
Panionios,4419,4,1,1,4,4,10,-6,4
AEK Athens,4420,1,4,2,0,7,1,6,14
PAOK Salonik,4420,2,2,2,2,10,11,-1,8
P'thinaikos,4420,3,2,1,3,11,10,1,7
Panionios,4420,4,1,1,4,4,10,-6,4
AEK Athens,4421,1,4,2,0,7,1,6,14
PAOK Salonik,4421,2,2,2,2,9,6,3,8
P'thinaikos,4421,3,2,1,3,6,9,-3,7
Panionios,4421,4,1,1,4,4,10,-6,4
AEK Athens,4422,1,4,2,0,7,1,6,14
PAOK Salonik,4422,2,2,2,2,9,5,4,8
P'thinaikos,4422,3,2,1,3,5,9,-4,7
Panionios,4422,4,1,1,4,4,10,-6,4
AEK Athens,4423,1,4,2,0,7,1,6,14
PAOK Salonik,4423,2,2,3,1,9,4,5,9
P'thinaikos,4423,3,1,2,3,4,9,-5,5
Panionios,4423,4,1,1,4,4,10,-6,4
AEK Athens,4424,1,4,2,0,7,1,6,14
PAOK Salonik,4424,2,2,2,2,9,5,4,8
P'thinaikos,4424,3,2,1,3,5,9,-4,7
Panionios,4424,4,1,1,4,4,10,-6,4
AEK Athens,4425,1,4,2,0,7,1,6,14
PAOK Salonik,4425,2,2,2,2,10,6,4,8
P'thinaikos,4425,3,2,1,3,6,10,-4,7
Panionios,4425,4,1,1,4,4,10,-6,4
AEK Athens,4426,1,4,2,0,7,1,6,14
PAOK Salonik,4426,2,3,2,1,10,4,6,11
P'thinaikos,4426,3,1,1,4,4,10,-6,4
Panionios,4426,3,1,1,4,4,10,-6,4
AEK Athens,4427,1,4,2,0,7,1,6,14
PAOK Salonik,4427,2,3,2,1,10,4,6,11
P'thinaikos,4427,3,1,1,4,4,10,-6,4
Panionios,4427,3,1,1,4,4,10,-6,4
AEK Athens,4428,1,4,2,0,7,1,6,14
PAOK Salonik,4428,2,2,2,2,9,5,4,8
P'thinaikos,4428,3,2,1,3,5,9,-4,7
Panionios,4428,4,1,1,4,4,10,-6,4
AEK Athens,4429,1,4,2,0,7,1,6,14
PAOK Salonik,4429,2,3,2,1,11,5,6,11
P'thinaikos,4429,3,1,1,4,5,11,-6,4
Panionios,4429,4,1,1,4,4,10,-6,4
AEK Athens,4430,1,4,2,0,7,1,6,14
PAOK Salonik,4430,2,3,2,1,10,4,6,11
P'thinaikos,4430,3,1,1,4,4,10,-6,4
Panionios,4430,3,1,1,4,4,10,-6,4
AEK Athens,4431,1,4,2,0,7,1,6,14
PAOK Salonik,4431,2,3,2,1,13,5,8,11
Panionios,4431,3,1,1,4,4,10,-6,4
P'thinaikos,4431,4,1,1,4,5,13,-8,4
AEK Athens,4432,1,4,2,0,7,1,6,14
PAOK Salonik,4432,2,3,2,1,12,4,8,11
Panionios,4432,3,1,1,4,4,10,-6,4
P'thinaikos,4432,4,1,1,4,4,12,-8,4
AEK Athens,4433,1,4,2,0,7,1,6,14
PAOK Salonik,4433,2,3,2,1,12,4,8,11
Panionios,4433,3,1,1,4,4,10,-6,4
P'thinaikos,4433,4,1,1,4,4,12,-8,4
AEK Athens,4434,1,4,2,0,7,1,6,14
PAOK Salonik,4434,2,2,2,2,9,5,4,8
P'thinaikos,4434,3,2,1,3,5,9,-4,7
Panionios,4434,4,1,1,4,4,10,-6,4
AEK Athens,4435,1,4,2,0,7,1,6,14
PAOK Salonik,4435,2,3,2,1,10,4,6,11
P'thinaikos,4435,3,1,1,4,4,10,-6,4
Panionios,4435,3,1,1,4,4,10,-6,4
AEK Athens,4436,1,4,2,0,7,1,6,14
PAOK Salonik,4436,2,2,2,2,10,6,4,8
P'thinaikos,4436,3,2,1,3,6,10,-4,7
Panionios,4436,4,1,1,4,4,10,-6,4
AEK Athens,4437,1,4,2,0,7,1,6,14
PAOK Salonik,4437,2,3,2,1,13,5,8,11
Panionios,4437,3,1,1,4,4,10,-6,4
P'thinaikos,4437,4,1,1,4,5,13,-8,4
AEK Athens,4438,1,4,2,0,7,1,6,14
PAOK Salonik,4438,2,2,3,1,10,5,5,9
P'thinaikos,4438,3,1,2,3,5,10,-5,5
Panionios,4438,4,1,1,4,4,10,-6,4
AEK Athens,4439,1,4,2,0,7,1,6,14
PAOK Salonik,4439,2,2,2,2,9,6,3,8
P'thinaikos,4439,3,2,1,3,6,9,-3,7
Panionios,4439,4,1,1,4,4,10,-6,4
AEK Athens,4440,1,4,2,0,7,1,6,14
PAOK Salonik,4440,2,2,2,2,10,6,4,8
P'thinaikos,4440,3,2,1,3,6,10,-4,7
Panionios,4440,4,1,1,4,4,10,-6,4
AEK Athens,4441,1,4,2,0,7,1,6,14
PAOK Salonik,4441,2,2,2,2,11,7,4,8
P'thinaikos,4441,3,2,1,3,7,11,-4,7
Panionios,4441,4,1,1,4,4,10,-6,4
AEK Athens,4442,1,4,2,0,7,1,6,14
PAOK Salonik,4442,2,2,2,2,9,5,4,8
P'thinaikos,4442,3,2,1,3,5,9,-4,7
Panionios,4442,4,1,1,4,4,10,-6,4
AEK Athens,4443,1,4,2,0,7,1,6,14
PAOK Salonik,4443,2,2,2,2,10,7,3,8
P'thinaikos,4443,3,2,1,3,7,10,-3,7
Panionios,4443,4,1,1,4,4,10,-6,4
AEK Athens,4444,1,4,2,0,7,1,6,14
PAOK Salonik,4444,2,2,2,2,11,9,2,8
P'thinaikos,4444,3,2,1,3,9,11,-2,7
Panionios,4444,4,1,1,4,4,10,-6,4
AEK Athens,4445,1,4,2,0,7,1,6,14
PAOK Salonik,4445,2,2,2,2,9,5,4,8
P'thinaikos,4445,3,2,1,3,5,9,-4,7
Panionios,4445,4,1,1,4,4,10,-6,4
AEK Athens,4446,1,4,2,0,7,1,6,14
PAOK Salonik,4446,2,2,2,2,9,5,4,8
P'thinaikos,4446,3,2,1,3,5,9,-4,7
Panionios,4446,4,1,1,4,4,10,-6,4
AEK Athens,4447,1,4,2,0,7,1,6,14
PAOK Salonik,4447,2,3,2,1,11,4,7,11
Panionios,4447,3,1,1,4,4,10,-6,4
P'thinaikos,4447,4,1,1,4,4,11,-7,4
AEK Athens,4448,1,4,2,0,7,1,6,14
PAOK Salonik,4448,2,2,3,1,11,6,5,9
P'thinaikos,4448,3,1,2,3,6,11,-5,5
Panionios,4448,4,1,1,4,4,10,-6,4
AEK Athens,4449,1,4,2,0,7,1,6,14
PAOK Salonik,4449,2,3,2,1,11,5,6,11
P'thinaikos,4449,3,1,1,4,5,11,-6,4
Panionios,4449,4,1,1,4,4,10,-6,4
AEK Athens,4450,1,4,2,0,7,1,6,14
PAOK Salonik,4450,2,3,2,1,12,4,8,11
Panionios,4450,3,1,1,4,4,10,-6,4
P'thinaikos,4450,4,1,1,4,4,12,-8,4
AEK Athens,4451,1,4,2,0,7,1,6,14
PAOK Salonik,4451,2,3,2,1,11,5,6,11
P'thinaikos,4451,3,1,1,4,5,11,-6,4
Panionios,4451,4,1,1,4,4,10,-6,4
AEK Athens,4452,1,4,2,0,7,1,6,14
PAOK Salonik,4452,2,2,2,2,9,9,0,8
P'thinaikos,4452,3,2,1,3,9,9,0,7
Panionios,4452,4,1,1,4,4,10,-6,4
AEK Athens,4453,1,4,2,0,7,1,6,14
PAOK Salonik,4453,2,3,2,1,10,4,6,11
P'thinaikos,4453,3,1,1,4,4,10,-6,4
Panionios,4453,3,1,1,4,4,10,-6,4
AEK Athens,4454,1,4,2,0,7,1,6,14
PAOK Salonik,4454,2,3,2,1,10,4,6,11
P'thinaikos,4454,3,1,1,4,4,10,-6,4
Panionios,4454,3,1,1,4,4,10,-6,4
AEK Athens,4455,1,4,2,0,7,1,6,14
PAOK Salonik,4455,2,3,2,1,10,4,6,11
P'thinaikos,4455,3,1,1,4,4,10,-6,4
Panionios,4455,3,1,1,4,4,10,-6,4
AEK Athens,4456,1,4,2,0,7,1,6,14
PAOK Salonik,4456,2,2,2,2,10,6,4,8
P'thinaikos,4456,3,2,1,3,6,10,-4,7
Panionios,4456,4,1,1,4,4,10,-6,4
AEK Athens,4457,1,4,2,0,7,1,6,14
PAOK Salonik,4457,2,3,2,1,12,6,6,11
P'thinaikos,4457,3,1,1,4,6,12,-6,4
Panionios,4457,4,1,1,4,4,10,-6,4
AEK Athens,4458,1,4,2,0,7,1,6,14
PAOK Salonik,4458,2,2,3,1,10,5,5,9
P'thinaikos,4458,3,1,2,3,5,10,-5,5
Panionios,4458,4,1,1,4,4,10,-6,4
AEK Athens,4459,1,4,2,0,7,1,6,14
PAOK Salonik,4459,2,2,2,2,9,6,3,8
P'thinaikos,4459,3,2,1,3,6,9,-3,7
Panionios,4459,4,1,1,4,4,10,-6,4
AEK Athens,4460,1,4,2,0,7,1,6,14
PAOK Salonik,4460,2,2,2,2,10,6,4,8
P'thinaikos,4460,3,2,1,3,6,10,-4,7
Panionios,4460,4,1,1,4,4,10,-6,4
AEK Athens,4461,1,4,2,0,7,1,6,14
PAOK Salonik,4461,2,2,3,1,10,5,5,9
P'thinaikos,4461,3,1,2,3,5,10,-5,5
Panionios,4461,4,1,1,4,4,10,-6,4
AEK Athens,4462,1,4,2,0,7,1,6,14
PAOK Salonik,4462,2,2,3,1,10,5,5,9
P'thinaikos,4462,3,1,2,3,5,10,-5,5
Panionios,4462,4,1,1,4,4,10,-6,4
AEK Athens,4463,1,4,2,0,7,1,6,14
PAOK Salonik,4463,2,2,2,2,9,8,1,8
P'thinaikos,4463,3,2,1,3,8,9,-1,7
Panionios,4463,4,1,1,4,4,10,-6,4
AEK Athens,4464,1,4,2,0,7,1,6,14
PAOK Salonik,4464,2,2,2,2,9,5,4,8
P'thinaikos,4464,3,2,1,3,5,9,-4,7
Panionios,4464,4,1,1,4,4,10,-6,4
AEK Athens,4465,1,4,2,0,7,1,6,14
PAOK Salonik,4465,2,3,2,1,11,5,6,11
P'thinaikos,4465,3,1,1,4,5,11,-6,4
Panionios,4465,4,1,1,4,4,10,-6,4
AEK Athens,4466,1,4,2,0,7,1,6,14
PAOK Salonik,4466,2,2,2,2,10,6,4,8
P'thinaikos,4466,3,2,1,3,6,10,-4,7
Panionios,4466,4,1,1,4,4,10,-6,4
AEK Athens,4467,1,4,2,0,7,1,6,14
PAOK Salonik,4467,2,2,2,2,9,5,4,8
P'thinaikos,4467,3,2,1,3,5,9,-4,7
Panionios,4467,4,1,1,4,4,10,-6,4
AEK Athens,4468,1,4,2,0,7,1,6,14
PAOK Salonik,4468,2,3,2,1,11,5,6,11
P'thinaikos,4468,3,1,1,4,5,11,-6,4
Panionios,4468,4,1,1,4,4,10,-6,4
AEK Athens,4469,1,4,2,0,7,1,6,14
PAOK Salonik,4469,2,2,2,2,9,5,4,8
P'thinaikos,4469,3,2,1,3,5,9,-4,7
Panionios,4469,4,1,1,4,4,10,-6,4
AEK Athens,4470,1,4,2,0,7,1,6,14
PAOK Salonik,4470,2,2,3,1,10,5,5,9
P'thinaikos,4470,3,1,2,3,5,10,-5,5
Panionios,4470,4,1,1,4,4,10,-6,4
AEK Athens,4471,1,4,2,0,7,1,6,14
PAOK Salonik,4471,2,3,2,1,10,4,6,11
P'thinaikos,4471,3,1,1,4,4,10,-6,4
Panionios,4471,3,1,1,4,4,10,-6,4
AEK Athens,4472,1,4,2,0,7,1,6,14
PAOK Salonik,4472,2,2,3,1,9,4,5,9
P'thinaikos,4472,3,1,2,3,4,9,-5,5
Panionios,4472,4,1,1,4,4,10,-6,4
AEK Athens,4473,1,4,2,0,7,1,6,14
PAOK Salonik,4473,2,3,2,1,12,4,8,11
Panionios,4473,3,1,1,4,4,10,-6,4
P'thinaikos,4473,4,1,1,4,4,12,-8,4
AEK Athens,4474,1,4,2,0,7,1,6,14
PAOK Salonik,4474,2,2,3,1,10,5,5,9
P'thinaikos,4474,3,1,2,3,5,10,-5,5
Panionios,4474,4,1,1,4,4,10,-6,4
AEK Athens,4475,1,4,2,0,7,1,6,14
PAOK Salonik,4475,2,3,2,1,10,4,6,11
P'thinaikos,4475,3,1,1,4,4,10,-6,4
Panionios,4475,3,1,1,4,4,10,-6,4
AEK Athens,4476,1,4,2,0,7,1,6,14
PAOK Salonik,4476,2,2,2,2,9,6,3,8
P'thinaikos,4476,3,2,1,3,6,9,-3,7
Panionios,4476,4,1,1,4,4,10,-6,4
AEK Athens,4477,1,4,2,0,7,1,6,14
PAOK Salonik,4477,2,3,2,1,12,5,7,11
Panionios,4477,3,1,1,4,4,10,-6,4
P'thinaikos,4477,4,1,1,4,5,12,-7,4
AEK Athens,4478,1,4,2,0,7,1,6,14
PAOK Salonik,4478,2,3,2,1,10,4,6,11
P'thinaikos,4478,3,1,1,4,4,10,-6,4
Panionios,4478,3,1,1,4,4,10,-6,4
AEK Athens,4479,1,4,2,0,7,1,6,14
PAOK Salonik,4479,2,3,2,1,10,4,6,11
P'thinaikos,4479,3,1,1,4,4,10,-6,4
Panionios,4479,3,1,1,4,4,10,-6,4
AEK Athens,4480,1,4,2,0,7,1,6,14
PAOK Salonik,4480,2,3,2,1,12,4,8,11
Panionios,4480,3,1,1,4,4,10,-6,4
P'thinaikos,4480,4,1,1,4,4,12,-8,4
AEK Athens,4481,1,4,2,0,7,1,6,14
PAOK Salonik,4481,2,2,2,2,10,6,4,8
P'thinaikos,4481,3,2,1,3,6,10,-4,7
Panionios,4481,4,1,1,4,4,10,-6,4
AEK Athens,4482,1,4,2,0,7,1,6,14
PAOK Salonik,4482,2,2,2,2,9,7,2,8
P'thinaikos,4482,3,2,1,3,7,9,-2,7
Panionios,4482,4,1,1,4,4,10,-6,4
AEK Athens,4483,1,4,2,0,7,1,6,14
PAOK Salonik,4483,2,2,3,1,9,4,5,9
P'thinaikos,4483,3,1,2,3,4,9,-5,5
Panionios,4483,4,1,1,4,4,10,-6,4
AEK Athens,4484,1,4,2,0,7,1,6,14
PAOK Salonik,4484,2,3,2,1,11,4,7,11
Panionios,4484,3,1,1,4,4,10,-6,4
P'thinaikos,4484,4,1,1,4,4,11,-7,4
AEK Athens,4485,1,4,2,0,7,1,6,14
PAOK Salonik,4485,2,2,3,1,11,6,5,9
P'thinaikos,4485,3,1,2,3,6,11,-5,5
Panionios,4485,4,1,1,4,4,10,-6,4
AEK Athens,4486,1,4,2,0,7,1,6,14
PAOK Salonik,4486,2,3,2,1,11,4,7,11
Panionios,4486,3,1,1,4,4,10,-6,4
P'thinaikos,4486,4,1,1,4,4,11,-7,4
AEK Athens,4487,1,4,2,0,7,1,6,14
PAOK Salonik,4487,2,3,2,1,11,4,7,11
Panionios,4487,3,1,1,4,4,10,-6,4
P'thinaikos,4487,4,1,1,4,4,11,-7,4
AEK Athens,4488,1,4,2,0,7,1,6,14
PAOK Salonik,4488,2,3,2,1,11,5,6,11
P'thinaikos,4488,3,1,1,4,5,11,-6,4
Panionios,4488,4,1,1,4,4,10,-6,4
AEK Athens,4489,1,4,2,0,7,1,6,14
PAOK Salonik,4489,2,2,3,1,9,4,5,9
P'thinaikos,4489,3,1,2,3,4,9,-5,5
Panionios,4489,4,1,1,4,4,10,-6,4
AEK Athens,4490,1,4,2,0,7,1,6,14
PAOK Salonik,4490,2,3,2,1,11,5,6,11
P'thinaikos,4490,3,1,1,4,5,11,-6,4
Panionios,4490,4,1,1,4,4,10,-6,4
AEK Athens,4491,1,4,2,0,7,1,6,14
PAOK Salonik,4491,2,2,2,2,10,6,4,8
P'thinaikos,4491,3,2,1,3,6,10,-4,7
Panionios,4491,4,1,1,4,4,10,-6,4
AEK Athens,4492,1,4,2,0,7,1,6,14
PAOK Salonik,4492,2,2,3,1,9,4,5,9
P'thinaikos,4492,3,1,2,3,4,9,-5,5
Panionios,4492,4,1,1,4,4,10,-6,4
AEK Athens,4493,1,4,2,0,7,1,6,14
PAOK Salonik,4493,2,3,2,1,13,7,6,11
P'thinaikos,4493,3,1,1,4,7,13,-6,4
Panionios,4493,4,1,1,4,4,10,-6,4
AEK Athens,4494,1,4,2,0,7,1,6,14
PAOK Salonik,4494,2,2,2,2,9,6,3,8
P'thinaikos,4494,3,2,1,3,6,9,-3,7
Panionios,4494,4,1,1,4,4,10,-6,4
AEK Athens,4495,1,4,2,0,7,1,6,14
PAOK Salonik,4495,2,2,2,2,9,5,4,8
P'thinaikos,4495,3,2,1,3,5,9,-4,7
Panionios,4495,4,1,1,4,4,10,-6,4
AEK Athens,4496,1,4,2,0,7,1,6,14
PAOK Salonik,4496,2,2,3,1,11,6,5,9
P'thinaikos,4496,3,1,2,3,6,11,-5,5
Panionios,4496,4,1,1,4,4,10,-6,4
AEK Athens,4497,1,4,2,0,7,1,6,14
PAOK Salonik,4497,2,2,2,2,11,8,3,8
P'thinaikos,4497,3,2,1,3,8,11,-3,7
Panionios,4497,4,1,1,4,4,10,-6,4
AEK Athens,4498,1,4,2,0,7,1,6,14
PAOK Salonik,4498,2,2,2,2,9,5,4,8
P'thinaikos,4498,3,2,1,3,5,9,-4,7
Panionios,4498,4,1,1,4,4,10,-6,4
AEK Athens,4499,1,4,2,0,7,1,6,14
PAOK Salonik,4499,2,3,2,1,11,4,7,11
Panionios,4499,3,1,1,4,4,10,-6,4
P'thinaikos,4499,4,1,1,4,4,11,-7,4
AEK Athens,4500,1,4,2,0,7,1,6,14
PAOK Salonik,4500,2,3,2,1,10,4,6,11
P'thinaikos,4500,3,1,1,4,4,10,-6,4
Panionios,4500,3,1,1,4,4,10,-6,4
AEK Athens,4501,1,4,2,0,7,1,6,14
PAOK Salonik,4501,2,3,2,1,13,5,8,11
Panionios,4501,3,1,1,4,4,10,-6,4
P'thinaikos,4501,4,1,1,4,5,13,-8,4
AEK Athens,4502,1,4,2,0,7,1,6,14
PAOK Salonik,4502,2,3,2,1,11,5,6,11
P'thinaikos,4502,3,1,1,4,5,11,-6,4
Panionios,4502,4,1,1,4,4,10,-6,4
AEK Athens,4503,1,4,2,0,7,1,6,14
PAOK Salonik,4503,2,2,2,2,10,6,4,8
P'thinaikos,4503,3,2,1,3,6,10,-4,7
Panionios,4503,4,1,1,4,4,10,-6,4
AEK Athens,4504,1,4,2,0,7,1,6,14
PAOK Salonik,4504,2,2,2,2,9,6,3,8
P'thinaikos,4504,3,2,1,3,6,9,-3,7
Panionios,4504,4,1,1,4,4,10,-6,4
AEK Athens,4505,1,4,2,0,7,1,6,14
PAOK Salonik,4505,2,2,3,1,10,5,5,9
P'thinaikos,4505,3,1,2,3,5,10,-5,5
Panionios,4505,4,1,1,4,4,10,-6,4
AEK Athens,4506,1,4,2,0,7,1,6,14
PAOK Salonik,4506,2,2,2,2,9,7,2,8
P'thinaikos,4506,3,2,1,3,7,9,-2,7
Panionios,4506,4,1,1,4,4,10,-6,4
AEK Athens,4507,1,4,2,0,7,1,6,14
PAOK Salonik,4507,2,2,3,1,10,5,5,9
P'thinaikos,4507,3,1,2,3,5,10,-5,5
Panionios,4507,4,1,1,4,4,10,-6,4
AEK Athens,4508,1,4,2,0,7,1,6,14
PAOK Salonik,4508,2,2,2,2,10,6,4,8
P'thinaikos,4508,3,2,1,3,6,10,-4,7
Panionios,4508,4,1,1,4,4,10,-6,4
AEK Athens,4509,1,4,2,0,7,1,6,14
PAOK Salonik,4509,2,3,2,1,10,4,6,11
P'thinaikos,4509,3,1,1,4,4,10,-6,4
Panionios,4509,3,1,1,4,4,10,-6,4
AEK Athens,4510,1,4,2,0,7,1,6,14
PAOK Salonik,4510,2,2,3,1,9,4,5,9
P'thinaikos,4510,3,1,2,3,4,9,-5,5
Panionios,4510,4,1,1,4,4,10,-6,4
AEK Athens,4511,1,4,2,0,7,1,6,14
PAOK Salonik,4511,2,3,2,1,10,4,6,11
P'thinaikos,4511,3,1,1,4,4,10,-6,4
Panionios,4511,3,1,1,4,4,10,-6,4
AEK Athens,4512,1,4,2,0,7,1,6,14
PAOK Salonik,4512,2,3,2,1,11,4,7,11
Panionios,4512,3,1,1,4,4,10,-6,4
P'thinaikos,4512,4,1,1,4,4,11,-7,4
AEK Athens,4513,1,4,2,0,7,1,6,14
PAOK Salonik,4513,2,2,3,1,11,6,5,9
P'thinaikos,4513,3,1,2,3,6,11,-5,5
Panionios,4513,4,1,1,4,4,10,-6,4
AEK Athens,4514,1,4,2,0,7,1,6,14
PAOK Salonik,4514,2,2,3,1,11,6,5,9
P'thinaikos,4514,3,1,2,3,6,11,-5,5
Panionios,4514,4,1,1,4,4,10,-6,4
AEK Athens,4515,1,4,2,0,7,1,6,14
PAOK Salonik,4515,2,2,2,2,9,5,4,8
P'thinaikos,4515,3,2,1,3,5,9,-4,7
Panionios,4515,4,1,1,4,4,10,-6,4
AEK Athens,4516,1,4,2,0,7,1,6,14
PAOK Salonik,4516,2,3,2,1,13,5,8,11
Panionios,4516,3,1,1,4,4,10,-6,4
P'thinaikos,4516,4,1,1,4,5,13,-8,4
AEK Athens,4517,1,4,2,0,7,1,6,14
PAOK Salonik,4517,2,2,3,1,10,5,5,9
P'thinaikos,4517,3,1,2,3,5,10,-5,5
Panionios,4517,4,1,1,4,4,10,-6,4
AEK Athens,4518,1,4,2,0,7,1,6,14
PAOK Salonik,4518,2,3,2,1,11,5,6,11
P'thinaikos,4518,3,1,1,4,5,11,-6,4
Panionios,4518,4,1,1,4,4,10,-6,4
AEK Athens,4519,1,4,2,0,7,1,6,14
PAOK Salonik,4519,2,2,3,1,12,7,5,9
P'thinaikos,4519,3,1,2,3,7,12,-5,5
Panionios,4519,4,1,1,4,4,10,-6,4
AEK Athens,4520,1,4,2,0,7,1,6,14
PAOK Salonik,4520,2,3,2,1,12,5,7,11
Panionios,4520,3,1,1,4,4,10,-6,4
P'thinaikos,4520,4,1,1,4,5,12,-7,4
AEK Athens,4521,1,4,2,0,7,1,6,14
PAOK Salonik,4521,2,3,2,1,11,4,7,11
Panionios,4521,3,1,1,4,4,10,-6,4
P'thinaikos,4521,4,1,1,4,4,11,-7,4
AEK Athens,4522,1,4,2,0,7,1,6,14
PAOK Salonik,4522,2,2,2,2,9,7,2,8
P'thinaikos,4522,3,2,1,3,7,9,-2,7
Panionios,4522,4,1,1,4,4,10,-6,4
AEK Athens,4523,1,4,2,0,7,1,6,14
PAOK Salonik,4523,2,3,2,1,10,4,6,11
P'thinaikos,4523,3,1,1,4,4,10,-6,4
Panionios,4523,3,1,1,4,4,10,-6,4
AEK Athens,4524,1,4,2,0,7,1,6,14
PAOK Salonik,4524,2,3,2,1,11,4,7,11
Panionios,4524,3,1,1,4,4,10,-6,4
P'thinaikos,4524,4,1,1,4,4,11,-7,4
AEK Athens,4525,1,4,2,0,7,1,6,14
PAOK Salonik,4525,2,2,2,2,9,7,2,8
P'thinaikos,4525,3,2,1,3,7,9,-2,7
Panionios,4525,4,1,1,4,4,10,-6,4
AEK Athens,4526,1,4,2,0,7,1,6,14
PAOK Salonik,4526,2,3,2,1,11,5,6,11
P'thinaikos,4526,3,1,1,4,5,11,-6,4
Panionios,4526,4,1,1,4,4,10,-6,4
AEK Athens,4527,1,4,2,0,7,1,6,14
PAOK Salonik,4527,2,3,2,1,11,4,7,11
Panionios,4527,3,1,1,4,4,10,-6,4
P'thinaikos,4527,4,1,1,4,4,11,-7,4
AEK Athens,4528,1,4,2,0,7,1,6,14
PAOK Salonik,4528,2,2,2,2,9,6,3,8
P'thinaikos,4528,3,2,1,3,6,9,-3,7
Panionios,4528,4,1,1,4,4,10,-6,4
AEK Athens,4529,1,4,2,0,7,1,6,14
PAOK Salonik,4529,2,3,2,1,11,4,7,11
Panionios,4529,3,1,1,4,4,10,-6,4
P'thinaikos,4529,4,1,1,4,4,11,-7,4
AEK Athens,4530,1,4,2,0,7,1,6,14
PAOK Salonik,4530,2,2,2,2,10,8,2,8
P'thinaikos,4530,3,2,1,3,8,10,-2,7
Panionios,4530,4,1,1,4,4,10,-6,4
AEK Athens,4531,1,4,2,0,7,1,6,14
PAOK Salonik,4531,2,3,2,1,10,4,6,11
P'thinaikos,4531,3,1,1,4,4,10,-6,4
Panionios,4531,3,1,1,4,4,10,-6,4
AEK Athens,4532,1,4,2,0,7,1,6,14
PAOK Salonik,4532,2,2,3,1,10,5,5,9
P'thinaikos,4532,3,1,2,3,5,10,-5,5
Panionios,4532,4,1,1,4,4,10,-6,4
AEK Athens,4533,1,4,2,0,7,1,6,14
PAOK Salonik,4533,2,3,2,1,10,4,6,11
P'thinaikos,4533,3,1,1,4,4,10,-6,4
Panionios,4533,3,1,1,4,4,10,-6,4
AEK Athens,4534,1,4,2,0,7,1,6,14
PAOK Salonik,4534,2,3,2,1,12,6,6,11
P'thinaikos,4534,3,1,1,4,6,12,-6,4
Panionios,4534,4,1,1,4,4,10,-6,4
AEK Athens,4535,1,4,2,0,7,1,6,14
PAOK Salonik,4535,2,2,2,2,9,7,2,8
P'thinaikos,4535,3,2,1,3,7,9,-2,7
Panionios,4535,4,1,1,4,4,10,-6,4
AEK Athens,4536,1,4,2,0,7,1,6,14
PAOK Salonik,4536,2,3,2,1,10,4,6,11
P'thinaikos,4536,3,1,1,4,4,10,-6,4
Panionios,4536,3,1,1,4,4,10,-6,4
AEK Athens,4537,1,4,2,0,7,1,6,14
PAOK Salonik,4537,2,3,2,1,12,5,7,11
Panionios,4537,3,1,1,4,4,10,-6,4
P'thinaikos,4537,4,1,1,4,5,12,-7,4
AEK Athens,4538,1,4,2,0,7,1,6,14
PAOK Salonik,4538,2,3,2,1,12,6,6,11
P'thinaikos,4538,3,1,1,4,6,12,-6,4
Panionios,4538,4,1,1,4,4,10,-6,4
AEK Athens,4539,1,4,2,0,7,1,6,14
PAOK Salonik,4539,2,3,2,1,11,4,7,11
Panionios,4539,3,1,1,4,4,10,-6,4
P'thinaikos,4539,4,1,1,4,4,11,-7,4
AEK Athens,4540,1,4,2,0,7,1,6,14
PAOK Salonik,4540,2,3,2,1,10,4,6,11
P'thinaikos,4540,3,1,1,4,4,10,-6,4
Panionios,4540,3,1,1,4,4,10,-6,4
AEK Athens,4541,1,4,2,0,7,1,6,14
PAOK Salonik,4541,2,2,3,1,9,4,5,9
P'thinaikos,4541,3,1,2,3,4,9,-5,5
Panionios,4541,4,1,1,4,4,10,-6,4
AEK Athens,4542,1,4,2,0,7,1,6,14
PAOK Salonik,4542,2,2,2,2,10,6,4,8
P'thinaikos,4542,3,2,1,3,6,10,-4,7
Panionios,4542,4,1,1,4,4,10,-6,4
AEK Athens,4543,1,4,2,0,7,1,6,14
PAOK Salonik,4543,2,2,2,2,9,5,4,8
P'thinaikos,4543,3,2,1,3,5,9,-4,7
Panionios,4543,4,1,1,4,4,10,-6,4
AEK Athens,4544,1,4,2,0,7,1,6,14
PAOK Salonik,4544,2,2,2,2,9,6,3,8
P'thinaikos,4544,3,2,1,3,6,9,-3,7
Panionios,4544,4,1,1,4,4,10,-6,4
AEK Athens,4545,1,4,2,0,7,1,6,14
PAOK Salonik,4545,2,2,3,1,10,5,5,9
P'thinaikos,4545,3,1,2,3,5,10,-5,5
Panionios,4545,4,1,1,4,4,10,-6,4
AEK Athens,4546,1,4,2,0,7,1,6,14
PAOK Salonik,4546,2,2,2,2,10,6,4,8
P'thinaikos,4546,3,2,1,3,6,10,-4,7
Panionios,4546,4,1,1,4,4,10,-6,4
AEK Athens,4547,1,4,2,0,7,1,6,14
PAOK Salonik,4547,2,3,2,1,10,4,6,11
P'thinaikos,4547,3,1,1,4,4,10,-6,4
Panionios,4547,3,1,1,4,4,10,-6,4
AEK Athens,4548,1,4,2,0,7,1,6,14
PAOK Salonik,4548,2,2,2,2,9,6,3,8
P'thinaikos,4548,3,2,1,3,6,9,-3,7
Panionios,4548,4,1,1,4,4,10,-6,4
AEK Athens,4549,1,4,2,0,7,1,6,14
PAOK Salonik,4549,2,2,2,2,10,6,4,8
P'thinaikos,4549,3,2,1,3,6,10,-4,7
Panionios,4549,4,1,1,4,4,10,-6,4
AEK Athens,4550,1,4,2,0,7,1,6,14
PAOK Salonik,4550,2,2,2,2,9,5,4,8
P'thinaikos,4550,3,2,1,3,5,9,-4,7
Panionios,4550,4,1,1,4,4,10,-6,4
AEK Athens,4551,1,4,2,0,7,1,6,14
PAOK Salonik,4551,2,3,2,1,11,5,6,11
P'thinaikos,4551,3,1,1,4,5,11,-6,4
Panionios,4551,4,1,1,4,4,10,-6,4
AEK Athens,4552,1,4,2,0,7,1,6,14
PAOK Salonik,4552,2,2,2,2,9,6,3,8
P'thinaikos,4552,3,2,1,3,6,9,-3,7
Panionios,4552,4,1,1,4,4,10,-6,4
AEK Athens,4553,1,4,2,0,7,1,6,14
PAOK Salonik,4553,2,2,2,2,9,6,3,8
P'thinaikos,4553,3,2,1,3,6,9,-3,7
Panionios,4553,4,1,1,4,4,10,-6,4
AEK Athens,4554,1,4,2,0,7,1,6,14
PAOK Salonik,4554,2,2,2,2,9,6,3,8
P'thinaikos,4554,3,2,1,3,6,9,-3,7
Panionios,4554,4,1,1,4,4,10,-6,4
AEK Athens,4555,1,4,2,0,7,1,6,14
PAOK Salonik,4555,2,2,3,1,11,6,5,9
P'thinaikos,4555,3,1,2,3,6,11,-5,5
Panionios,4555,4,1,1,4,4,10,-6,4
AEK Athens,4556,1,4,2,0,7,1,6,14
PAOK Salonik,4556,2,2,2,2,10,6,4,8
P'thinaikos,4556,3,2,1,3,6,10,-4,7
Panionios,4556,4,1,1,4,4,10,-6,4
AEK Athens,4557,1,4,2,0,7,1,6,14
PAOK Salonik,4557,2,3,2,1,10,4,6,11
P'thinaikos,4557,3,1,1,4,4,10,-6,4
Panionios,4557,3,1,1,4,4,10,-6,4
AEK Athens,4558,1,4,2,0,7,1,6,14
PAOK Salonik,4558,2,2,3,1,10,5,5,9
P'thinaikos,4558,3,1,2,3,5,10,-5,5
Panionios,4558,4,1,1,4,4,10,-6,4
AEK Athens,4559,1,4,2,0,7,1,6,14
PAOK Salonik,4559,2,2,2,2,10,6,4,8
P'thinaikos,4559,3,2,1,3,6,10,-4,7
Panionios,4559,4,1,1,4,4,10,-6,4
AEK Athens,4560,1,4,2,0,7,1,6,14
PAOK Salonik,4560,2,2,2,2,9,5,4,8
P'thinaikos,4560,3,2,1,3,5,9,-4,7
Panionios,4560,4,1,1,4,4,10,-6,4
AEK Athens,4561,1,4,2,0,7,1,6,14
PAOK Salonik,4561,2,3,2,1,10,4,6,11
P'thinaikos,4561,3,1,1,4,4,10,-6,4
Panionios,4561,3,1,1,4,4,10,-6,4
AEK Athens,4562,1,4,2,0,7,1,6,14
PAOK Salonik,4562,2,2,3,1,9,4,5,9
P'thinaikos,4562,3,1,2,3,4,9,-5,5
Panionios,4562,4,1,1,4,4,10,-6,4
AEK Athens,4563,1,4,2,0,7,1,6,14
PAOK Salonik,4563,2,2,2,2,9,5,4,8
P'thinaikos,4563,3,2,1,3,5,9,-4,7
Panionios,4563,4,1,1,4,4,10,-6,4
AEK Athens,4564,1,4,2,0,7,1,6,14
PAOK Salonik,4564,2,3,2,1,11,4,7,11
Panionios,4564,3,1,1,4,4,10,-6,4
P'thinaikos,4564,4,1,1,4,4,11,-7,4
AEK Athens,4565,1,4,2,0,7,1,6,14
PAOK Salonik,4565,2,2,3,1,11,6,5,9
P'thinaikos,4565,3,1,2,3,6,11,-5,5
Panionios,4565,4,1,1,4,4,10,-6,4
AEK Athens,4566,1,4,2,0,7,1,6,14
PAOK Salonik,4566,2,2,3,1,9,4,5,9
P'thinaikos,4566,3,1,2,3,4,9,-5,5
Panionios,4566,4,1,1,4,4,10,-6,4
AEK Athens,4567,1,4,2,0,7,1,6,14
PAOK Salonik,4567,2,2,2,2,10,8,2,8
P'thinaikos,4567,3,2,1,3,8,10,-2,7
Panionios,4567,4,1,1,4,4,10,-6,4
AEK Athens,4568,1,4,2,0,7,1,6,14
PAOK Salonik,4568,2,3,2,1,11,4,7,11
Panionios,4568,3,1,1,4,4,10,-6,4
P'thinaikos,4568,4,1,1,4,4,11,-7,4
AEK Athens,4569,1,4,2,0,7,1,6,14
PAOK Salonik,4569,2,2,2,2,9,7,2,8
P'thinaikos,4569,3,2,1,3,7,9,-2,7
Panionios,4569,4,1,1,4,4,10,-6,4
AEK Athens,4570,1,4,2,0,7,1,6,14
PAOK Salonik,4570,2,3,2,1,10,4,6,11
P'thinaikos,4570,3,1,1,4,4,10,-6,4
Panionios,4570,3,1,1,4,4,10,-6,4
AEK Athens,4571,1,4,2,0,7,1,6,14
PAOK Salonik,4571,2,2,2,2,9,6,3,8
P'thinaikos,4571,3,2,1,3,6,9,-3,7
Panionios,4571,4,1,1,4,4,10,-6,4
AEK Athens,4572,1,4,2,0,7,1,6,14
PAOK Salonik,4572,2,2,2,2,9,6,3,8
P'thinaikos,4572,3,2,1,3,6,9,-3,7
Panionios,4572,4,1,1,4,4,10,-6,4
AEK Athens,4573,1,4,2,0,7,1,6,14
PAOK Salonik,4573,2,2,2,2,9,6,3,8
P'thinaikos,4573,3,2,1,3,6,9,-3,7
Panionios,4573,4,1,1,4,4,10,-6,4
AEK Athens,4574,1,4,2,0,7,1,6,14
PAOK Salonik,4574,2,3,2,1,11,4,7,11
Panionios,4574,3,1,1,4,4,10,-6,4
P'thinaikos,4574,4,1,1,4,4,11,-7,4
AEK Athens,4575,1,4,2,0,7,1,6,14
PAOK Salonik,4575,2,2,2,2,10,6,4,8
P'thinaikos,4575,3,2,1,3,6,10,-4,7
Panionios,4575,4,1,1,4,4,10,-6,4
AEK Athens,4576,1,4,2,0,7,1,6,14
PAOK Salonik,4576,2,3,2,1,10,4,6,11
P'thinaikos,4576,3,1,1,4,4,10,-6,4
Panionios,4576,3,1,1,4,4,10,-6,4
AEK Athens,4577,1,4,2,0,7,1,6,14
PAOK Salonik,4577,2,2,2,2,10,6,4,8
P'thinaikos,4577,3,2,1,3,6,10,-4,7
Panionios,4577,4,1,1,4,4,10,-6,4
AEK Athens,4578,1,4,2,0,7,1,6,14
PAOK Salonik,4578,2,3,2,1,10,4,6,11
P'thinaikos,4578,3,1,1,4,4,10,-6,4
Panionios,4578,3,1,1,4,4,10,-6,4
AEK Athens,4579,1,4,2,0,7,1,6,14
PAOK Salonik,4579,2,2,3,1,10,5,5,9
P'thinaikos,4579,3,1,2,3,5,10,-5,5
Panionios,4579,4,1,1,4,4,10,-6,4
AEK Athens,4580,1,4,2,0,7,1,6,14
PAOK Salonik,4580,2,2,2,2,10,6,4,8
P'thinaikos,4580,3,2,1,3,6,10,-4,7
Panionios,4580,4,1,1,4,4,10,-6,4
AEK Athens,4581,1,4,2,0,7,1,6,14
PAOK Salonik,4581,2,3,2,1,12,5,7,11
Panionios,4581,3,1,1,4,4,10,-6,4
P'thinaikos,4581,4,1,1,4,5,12,-7,4
AEK Athens,4582,1,4,2,0,7,1,6,14
PAOK Salonik,4582,2,2,3,1,9,4,5,9
P'thinaikos,4582,3,1,2,3,4,9,-5,5
Panionios,4582,4,1,1,4,4,10,-6,4
AEK Athens,4583,1,4,2,0,7,1,6,14
PAOK Salonik,4583,2,3,2,1,12,5,7,11
Panionios,4583,3,1,1,4,4,10,-6,4
P'thinaikos,4583,4,1,1,4,5,12,-7,4
AEK Athens,4584,1,4,2,0,7,1,6,14
PAOK Salonik,4584,2,2,2,2,9,5,4,8
P'thinaikos,4584,3,2,1,3,5,9,-4,7
Panionios,4584,4,1,1,4,4,10,-6,4
AEK Athens,4585,1,4,2,0,7,1,6,14
PAOK Salonik,4585,2,3,2,1,11,4,7,11
Panionios,4585,3,1,1,4,4,10,-6,4
P'thinaikos,4585,4,1,1,4,4,11,-7,4
AEK Athens,4586,1,4,2,0,7,1,6,14
PAOK Salonik,4586,2,2,3,1,10,5,5,9
P'thinaikos,4586,3,1,2,3,5,10,-5,5
Panionios,4586,4,1,1,4,4,10,-6,4
AEK Athens,4587,1,4,2,0,7,1,6,14
PAOK Salonik,4587,2,2,2,2,10,6,4,8
P'thinaikos,4587,3,2,1,3,6,10,-4,7
Panionios,4587,4,1,1,4,4,10,-6,4
AEK Athens,4588,1,4,2,0,7,1,6,14
PAOK Salonik,4588,2,3,2,1,12,4,8,11
Panionios,4588,3,1,1,4,4,10,-6,4
P'thinaikos,4588,4,1,1,4,4,12,-8,4
AEK Athens,4589,1,4,2,0,7,1,6,14
PAOK Salonik,4589,2,3,2,1,10,4,6,11
P'thinaikos,4589,3,1,1,4,4,10,-6,4
Panionios,4589,3,1,1,4,4,10,-6,4
AEK Athens,4590,1,4,2,0,7,1,6,14
PAOK Salonik,4590,2,2,2,2,9,5,4,8
P'thinaikos,4590,3,2,1,3,5,9,-4,7
Panionios,4590,4,1,1,4,4,10,-6,4
AEK Athens,4591,1,4,2,0,7,1,6,14
PAOK Salonik,4591,2,2,2,2,9,8,1,8
P'thinaikos,4591,3,2,1,3,8,9,-1,7
Panionios,4591,4,1,1,4,4,10,-6,4
AEK Athens,4592,1,4,2,0,7,1,6,14
PAOK Salonik,4592,2,2,3,1,10,5,5,9
P'thinaikos,4592,3,1,2,3,5,10,-5,5
Panionios,4592,4,1,1,4,4,10,-6,4
AEK Athens,4593,1,4,2,0,7,1,6,14
PAOK Salonik,4593,2,2,2,2,9,6,3,8
P'thinaikos,4593,3,2,1,3,6,9,-3,7
Panionios,4593,4,1,1,4,4,10,-6,4
AEK Athens,4594,1,4,2,0,7,1,6,14
PAOK Salonik,4594,2,2,2,2,9,5,4,8
P'thinaikos,4594,3,2,1,3,5,9,-4,7
Panionios,4594,4,1,1,4,4,10,-6,4
AEK Athens,4595,1,4,2,0,7,1,6,14
PAOK Salonik,4595,2,2,3,1,11,6,5,9
P'thinaikos,4595,3,1,2,3,6,11,-5,5
Panionios,4595,4,1,1,4,4,10,-6,4
AEK Athens,4596,1,4,2,0,7,1,6,14
PAOK Salonik,4596,2,3,2,1,10,4,6,11
P'thinaikos,4596,3,1,1,4,4,10,-6,4
Panionios,4596,3,1,1,4,4,10,-6,4
AEK Athens,4597,1,4,2,0,7,1,6,14
PAOK Salonik,4597,2,2,2,2,9,5,4,8
P'thinaikos,4597,3,2,1,3,5,9,-4,7
Panionios,4597,4,1,1,4,4,10,-6,4
AEK Athens,4598,1,4,2,0,7,1,6,14
PAOK Salonik,4598,2,2,3,1,11,6,5,9
P'thinaikos,4598,3,1,2,3,6,11,-5,5
Panionios,4598,4,1,1,4,4,10,-6,4
AEK Athens,4599,1,4,2,0,7,1,6,14
PAOK Salonik,4599,2,3,2,1,10,4,6,11
P'thinaikos,4599,3,1,1,4,4,10,-6,4
Panionios,4599,3,1,1,4,4,10,-6,4
AEK Athens,4600,1,4,2,0,7,1,6,14
PAOK Salonik,4600,2,2,2,2,9,6,3,8
P'thinaikos,4600,3,2,1,3,6,9,-3,7
Panionios,4600,4,1,1,4,4,10,-6,4
AEK Athens,4601,1,4,2,0,7,1,6,14
PAOK Salonik,4601,2,2,3,1,11,6,5,9
P'thinaikos,4601,3,1,2,3,6,11,-5,5
Panionios,4601,4,1,1,4,4,10,-6,4
AEK Athens,4602,1,4,2,0,7,1,6,14
PAOK Salonik,4602,2,3,2,1,10,4,6,11
P'thinaikos,4602,3,1,1,4,4,10,-6,4
Panionios,4602,3,1,1,4,4,10,-6,4
AEK Athens,4603,1,4,2,0,7,1,6,14
PAOK Salonik,4603,2,3,2,1,12,6,6,11
P'thinaikos,4603,3,1,1,4,6,12,-6,4
Panionios,4603,4,1,1,4,4,10,-6,4
AEK Athens,4604,1,4,2,0,7,1,6,14
PAOK Salonik,4604,2,2,3,1,11,6,5,9
P'thinaikos,4604,3,1,2,3,6,11,-5,5
Panionios,4604,4,1,1,4,4,10,-6,4
AEK Athens,4605,1,4,2,0,7,1,6,14
PAOK Salonik,4605,2,2,2,2,10,6,4,8
P'thinaikos,4605,3,2,1,3,6,10,-4,7
Panionios,4605,4,1,1,4,4,10,-6,4
AEK Athens,4606,1,4,2,0,7,1,6,14
PAOK Salonik,4606,2,2,2,2,9,7,2,8
P'thinaikos,4606,3,2,1,3,7,9,-2,7
Panionios,4606,4,1,1,4,4,10,-6,4
AEK Athens,4607,1,4,2,0,7,1,6,14
PAOK Salonik,4607,2,2,3,1,10,5,5,9
P'thinaikos,4607,3,1,2,3,5,10,-5,5
Panionios,4607,4,1,1,4,4,10,-6,4
AEK Athens,4608,1,4,2,0,7,1,6,14
PAOK Salonik,4608,2,3,2,1,12,4,8,11
Panionios,4608,3,1,1,4,4,10,-6,4
P'thinaikos,4608,4,1,1,4,4,12,-8,4
AEK Athens,4609,1,4,2,0,7,1,6,14
PAOK Salonik,4609,2,2,2,2,11,7,4,8
P'thinaikos,4609,3,2,1,3,7,11,-4,7
Panionios,4609,4,1,1,4,4,10,-6,4
AEK Athens,4610,1,4,2,0,7,1,6,14
PAOK Salonik,4610,2,3,2,1,11,5,6,11
P'thinaikos,4610,3,1,1,4,5,11,-6,4
Panionios,4610,4,1,1,4,4,10,-6,4
AEK Athens,4611,1,4,2,0,7,1,6,14
PAOK Salonik,4611,2,2,2,2,9,5,4,8
P'thinaikos,4611,3,2,1,3,5,9,-4,7
Panionios,4611,4,1,1,4,4,10,-6,4
AEK Athens,4612,1,4,2,0,7,1,6,14
PAOK Salonik,4612,2,3,2,1,10,4,6,11
P'thinaikos,4612,3,1,1,4,4,10,-6,4
Panionios,4612,3,1,1,4,4,10,-6,4
AEK Athens,4613,1,4,2,0,7,1,6,14
PAOK Salonik,4613,2,3,2,1,11,4,7,11
Panionios,4613,3,1,1,4,4,10,-6,4
P'thinaikos,4613,4,1,1,4,4,11,-7,4
AEK Athens,4614,1,4,2,0,7,1,6,14
PAOK Salonik,4614,2,2,2,2,9,5,4,8
P'thinaikos,4614,3,2,1,3,5,9,-4,7
Panionios,4614,4,1,1,4,4,10,-6,4
AEK Athens,4615,1,4,2,0,7,1,6,14
PAOK Salonik,4615,2,2,3,1,10,5,5,9
P'thinaikos,4615,3,1,2,3,5,10,-5,5
Panionios,4615,4,1,1,4,4,10,-6,4
AEK Athens,4616,1,4,2,0,7,1,6,14
PAOK Salonik,4616,2,2,3,1,10,5,5,9
P'thinaikos,4616,3,1,2,3,5,10,-5,5
Panionios,4616,4,1,1,4,4,10,-6,4
AEK Athens,4617,1,4,2,0,7,1,6,14
PAOK Salonik,4617,2,2,2,2,10,6,4,8
P'thinaikos,4617,3,2,1,3,6,10,-4,7
Panionios,4617,4,1,1,4,4,10,-6,4
AEK Athens,4618,1,4,2,0,7,1,6,14
PAOK Salonik,4618,2,2,2,2,10,6,4,8
P'thinaikos,4618,3,2,1,3,6,10,-4,7
Panionios,4618,4,1,1,4,4,10,-6,4
AEK Athens,4619,1,4,2,0,7,1,6,14
PAOK Salonik,4619,2,3,2,1,10,4,6,11
P'thinaikos,4619,3,1,1,4,4,10,-6,4
Panionios,4619,3,1,1,4,4,10,-6,4
AEK Athens,4620,1,4,2,0,7,1,6,14
PAOK Salonik,4620,2,2,2,2,9,5,4,8
P'thinaikos,4620,3,2,1,3,5,9,-4,7
Panionios,4620,4,1,1,4,4,10,-6,4
AEK Athens,4621,1,4,2,0,7,1,6,14
PAOK Salonik,4621,2,3,2,1,10,4,6,11
P'thinaikos,4621,3,1,1,4,4,10,-6,4
Panionios,4621,3,1,1,4,4,10,-6,4
AEK Athens,4622,1,4,2,0,7,1,6,14
PAOK Salonik,4622,2,2,3,1,10,5,5,9
P'thinaikos,4622,3,1,2,3,5,10,-5,5
Panionios,4622,4,1,1,4,4,10,-6,4
AEK Athens,4623,1,4,2,0,7,1,6,14
PAOK Salonik,4623,2,3,2,1,11,5,6,11
P'thinaikos,4623,3,1,1,4,5,11,-6,4
Panionios,4623,4,1,1,4,4,10,-6,4
AEK Athens,4624,1,4,2,0,7,1,6,14
PAOK Salonik,4624,2,3,2,1,12,4,8,11
Panionios,4624,3,1,1,4,4,10,-6,4
P'thinaikos,4624,4,1,1,4,4,12,-8,4
AEK Athens,4625,1,4,2,0,7,1,6,14
PAOK Salonik,4625,2,2,2,2,9,6,3,8
P'thinaikos,4625,3,2,1,3,6,9,-3,7
Panionios,4625,4,1,1,4,4,10,-6,4
AEK Athens,4626,1,4,2,0,7,1,6,14
PAOK Salonik,4626,2,2,3,1,9,4,5,9
P'thinaikos,4626,3,1,2,3,4,9,-5,5
Panionios,4626,4,1,1,4,4,10,-6,4
AEK Athens,4627,1,4,2,0,7,1,6,14
PAOK Salonik,4627,2,2,2,2,10,7,3,8
P'thinaikos,4627,3,2,1,3,7,10,-3,7
Panionios,4627,4,1,1,4,4,10,-6,4
AEK Athens,4628,1,4,2,0,7,1,6,14
PAOK Salonik,4628,2,2,3,1,9,4,5,9
P'thinaikos,4628,3,1,2,3,4,9,-5,5
Panionios,4628,4,1,1,4,4,10,-6,4
AEK Athens,4629,1,4,2,0,7,1,6,14
PAOK Salonik,4629,2,2,3,1,12,7,5,9
P'thinaikos,4629,3,1,2,3,7,12,-5,5
Panionios,4629,4,1,1,4,4,10,-6,4
AEK Athens,4630,1,4,2,0,7,1,6,14
PAOK Salonik,4630,2,2,2,2,9,5,4,8
P'thinaikos,4630,3,2,1,3,5,9,-4,7
Panionios,4630,4,1,1,4,4,10,-6,4
AEK Athens,4631,1,4,2,0,7,1,6,14
PAOK Salonik,4631,2,3,2,1,10,4,6,11
P'thinaikos,4631,3,1,1,4,4,10,-6,4
Panionios,4631,3,1,1,4,4,10,-6,4
AEK Athens,4632,1,4,2,0,7,1,6,14
PAOK Salonik,4632,2,2,2,2,9,6,3,8
P'thinaikos,4632,3,2,1,3,6,9,-3,7
Panionios,4632,4,1,1,4,4,10,-6,4
AEK Athens,4633,1,4,2,0,7,1,6,14
PAOK Salonik,4633,2,3,2,1,12,5,7,11
Panionios,4633,3,1,1,4,4,10,-6,4
P'thinaikos,4633,4,1,1,4,5,12,-7,4
AEK Athens,4634,1,4,2,0,7,1,6,14
PAOK Salonik,4634,2,2,3,1,10,5,5,9
P'thinaikos,4634,3,1,2,3,5,10,-5,5
Panionios,4634,4,1,1,4,4,10,-6,4
AEK Athens,4635,1,4,2,0,7,1,6,14
PAOK Salonik,4635,2,3,2,1,10,4,6,11
P'thinaikos,4635,3,1,1,4,4,10,-6,4
Panionios,4635,3,1,1,4,4,10,-6,4
AEK Athens,4636,1,4,2,0,7,1,6,14
PAOK Salonik,4636,2,2,2,2,9,5,4,8
P'thinaikos,4636,3,2,1,3,5,9,-4,7
Panionios,4636,4,1,1,4,4,10,-6,4
AEK Athens,4637,1,4,2,0,7,1,6,14
PAOK Salonik,4637,2,2,2,2,10,6,4,8
P'thinaikos,4637,3,2,1,3,6,10,-4,7
Panionios,4637,4,1,1,4,4,10,-6,4
AEK Athens,4638,1,4,2,0,7,1,6,14
PAOK Salonik,4638,2,2,3,1,10,5,5,9
P'thinaikos,4638,3,1,2,3,5,10,-5,5
Panionios,4638,4,1,1,4,4,10,-6,4
AEK Athens,4639,1,4,2,0,7,1,6,14
PAOK Salonik,4639,2,2,2,2,9,6,3,8
P'thinaikos,4639,3,2,1,3,6,9,-3,7
Panionios,4639,4,1,1,4,4,10,-6,4
AEK Athens,4640,1,4,2,0,7,1,6,14
PAOK Salonik,4640,2,2,3,1,10,5,5,9
P'thinaikos,4640,3,1,2,3,5,10,-5,5
Panionios,4640,4,1,1,4,4,10,-6,4
AEK Athens,4641,1,4,2,0,7,1,6,14
PAOK Salonik,4641,2,3,2,1,10,4,6,11
P'thinaikos,4641,3,1,1,4,4,10,-6,4
Panionios,4641,3,1,1,4,4,10,-6,4
AEK Athens,4642,1,4,2,0,7,1,6,14
PAOK Salonik,4642,2,2,3,1,10,5,5,9
P'thinaikos,4642,3,1,2,3,5,10,-5,5
Panionios,4642,4,1,1,4,4,10,-6,4
AEK Athens,4643,1,4,2,0,7,1,6,14
PAOK Salonik,4643,2,2,3,1,11,6,5,9
P'thinaikos,4643,3,1,2,3,6,11,-5,5
Panionios,4643,4,1,1,4,4,10,-6,4
AEK Athens,4644,1,4,2,0,7,1,6,14
PAOK Salonik,4644,2,3,2,1,12,5,7,11
Panionios,4644,3,1,1,4,4,10,-6,4
P'thinaikos,4644,4,1,1,4,5,12,-7,4
AEK Athens,4645,1,4,2,0,7,1,6,14
PAOK Salonik,4645,2,2,3,1,10,5,5,9
P'thinaikos,4645,3,1,2,3,5,10,-5,5
Panionios,4645,4,1,1,4,4,10,-6,4
AEK Athens,4646,1,4,2,0,7,1,6,14
PAOK Salonik,4646,2,3,2,1,11,4,7,11
Panionios,4646,3,1,1,4,4,10,-6,4
P'thinaikos,4646,4,1,1,4,4,11,-7,4
AEK Athens,4647,1,4,2,0,7,1,6,14
PAOK Salonik,4647,2,2,2,2,9,7,2,8
P'thinaikos,4647,3,2,1,3,7,9,-2,7
Panionios,4647,4,1,1,4,4,10,-6,4
AEK Athens,4648,1,4,2,0,7,1,6,14
PAOK Salonik,4648,2,2,2,2,9,6,3,8
P'thinaikos,4648,3,2,1,3,6,9,-3,7
Panionios,4648,4,1,1,4,4,10,-6,4
AEK Athens,4649,1,4,2,0,7,1,6,14
PAOK Salonik,4649,2,2,2,2,9,6,3,8
P'thinaikos,4649,3,2,1,3,6,9,-3,7
Panionios,4649,4,1,1,4,4,10,-6,4
AEK Athens,4650,1,4,2,0,7,1,6,14
PAOK Salonik,4650,2,2,3,1,10,5,5,9
P'thinaikos,4650,3,1,2,3,5,10,-5,5
Panionios,4650,4,1,1,4,4,10,-6,4
AEK Athens,4651,1,4,2,0,7,1,6,14
PAOK Salonik,4651,2,2,2,2,10,6,4,8
P'thinaikos,4651,3,2,1,3,6,10,-4,7
Panionios,4651,4,1,1,4,4,10,-6,4
AEK Athens,4652,1,4,2,0,7,1,6,14
PAOK Salonik,4652,2,2,2,2,10,6,4,8
P'thinaikos,4652,3,2,1,3,6,10,-4,7
Panionios,4652,4,1,1,4,4,10,-6,4
AEK Athens,4653,1,4,2,0,7,1,6,14
PAOK Salonik,4653,2,2,2,2,9,6,3,8
P'thinaikos,4653,3,2,1,3,6,9,-3,7
Panionios,4653,4,1,1,4,4,10,-6,4
AEK Athens,4654,1,4,2,0,7,1,6,14
PAOK Salonik,4654,2,2,3,1,10,5,5,9
P'thinaikos,4654,3,1,2,3,5,10,-5,5
Panionios,4654,4,1,1,4,4,10,-6,4
AEK Athens,4655,1,4,2,0,7,1,6,14
PAOK Salonik,4655,2,2,2,2,9,6,3,8
P'thinaikos,4655,3,2,1,3,6,9,-3,7
Panionios,4655,4,1,1,4,4,10,-6,4
AEK Athens,4656,1,4,2,0,7,1,6,14
PAOK Salonik,4656,2,2,2,2,10,8,2,8
P'thinaikos,4656,3,2,1,3,8,10,-2,7
Panionios,4656,4,1,1,4,4,10,-6,4
AEK Athens,4657,1,4,2,0,7,1,6,14
PAOK Salonik,4657,2,2,2,2,11,7,4,8
P'thinaikos,4657,3,2,1,3,7,11,-4,7
Panionios,4657,4,1,1,4,4,10,-6,4
AEK Athens,4658,1,4,2,0,7,1,6,14
PAOK Salonik,4658,2,2,2,2,9,5,4,8
P'thinaikos,4658,3,2,1,3,5,9,-4,7
Panionios,4658,4,1,1,4,4,10,-6,4
AEK Athens,4659,1,4,2,0,7,1,6,14
PAOK Salonik,4659,2,3,2,1,12,4,8,11
Panionios,4659,3,1,1,4,4,10,-6,4
P'thinaikos,4659,4,1,1,4,4,12,-8,4
AEK Athens,4660,1,4,2,0,7,1,6,14
PAOK Salonik,4660,2,2,2,2,10,6,4,8
P'thinaikos,4660,3,2,1,3,6,10,-4,7
Panionios,4660,4,1,1,4,4,10,-6,4
AEK Athens,4661,1,4,2,0,7,1,6,14
PAOK Salonik,4661,2,3,2,1,12,4,8,11
Panionios,4661,3,1,1,4,4,10,-6,4
P'thinaikos,4661,4,1,1,4,4,12,-8,4
AEK Athens,4662,1,4,2,0,7,1,6,14
PAOK Salonik,4662,2,3,2,1,11,4,7,11
Panionios,4662,3,1,1,4,4,10,-6,4
P'thinaikos,4662,4,1,1,4,4,11,-7,4
AEK Athens,4663,1,4,2,0,7,1,6,14
PAOK Salonik,4663,2,2,2,2,9,5,4,8
P'thinaikos,4663,3,2,1,3,5,9,-4,7
Panionios,4663,4,1,1,4,4,10,-6,4
AEK Athens,4664,1,4,2,0,7,1,6,14
PAOK Salonik,4664,2,3,2,1,12,6,6,11
P'thinaikos,4664,3,1,1,4,6,12,-6,4
Panionios,4664,4,1,1,4,4,10,-6,4
AEK Athens,4665,1,4,2,0,7,1,6,14
PAOK Salonik,4665,2,2,2,2,9,6,3,8
P'thinaikos,4665,3,2,1,3,6,9,-3,7
Panionios,4665,4,1,1,4,4,10,-6,4
AEK Athens,4666,1,4,2,0,7,1,6,14
PAOK Salonik,4666,2,3,2,1,11,5,6,11
P'thinaikos,4666,3,1,1,4,5,11,-6,4
Panionios,4666,4,1,1,4,4,10,-6,4
AEK Athens,4667,1,4,2,0,7,1,6,14
PAOK Salonik,4667,2,3,2,1,11,5,6,11
P'thinaikos,4667,3,1,1,4,5,11,-6,4
Panionios,4667,4,1,1,4,4,10,-6,4
AEK Athens,4668,1,4,2,0,7,1,6,14
PAOK Salonik,4668,2,2,3,1,10,5,5,9
P'thinaikos,4668,3,1,2,3,5,10,-5,5
Panionios,4668,4,1,1,4,4,10,-6,4
AEK Athens,4669,1,4,2,0,7,1,6,14
PAOK Salonik,4669,2,2,2,2,9,6,3,8
P'thinaikos,4669,3,2,1,3,6,9,-3,7
Panionios,4669,4,1,1,4,4,10,-6,4
AEK Athens,4670,1,4,2,0,7,1,6,14
PAOK Salonik,4670,2,2,2,2,9,5,4,8
P'thinaikos,4670,3,2,1,3,5,9,-4,7
Panionios,4670,4,1,1,4,4,10,-6,4
AEK Athens,4671,1,4,2,0,7,1,6,14
PAOK Salonik,4671,2,3,2,1,11,4,7,11
Panionios,4671,3,1,1,4,4,10,-6,4
P'thinaikos,4671,4,1,1,4,4,11,-7,4
AEK Athens,4672,1,4,2,0,7,1,6,14
PAOK Salonik,4672,2,2,3,1,9,4,5,9
P'thinaikos,4672,3,1,2,3,4,9,-5,5
Panionios,4672,4,1,1,4,4,10,-6,4
AEK Athens,4673,1,4,2,0,7,1,6,14
PAOK Salonik,4673,2,3,2,1,11,4,7,11
Panionios,4673,3,1,1,4,4,10,-6,4
P'thinaikos,4673,4,1,1,4,4,11,-7,4
AEK Athens,4674,1,4,2,0,7,1,6,14
PAOK Salonik,4674,2,3,2,1,12,4,8,11
Panionios,4674,3,1,1,4,4,10,-6,4
P'thinaikos,4674,4,1,1,4,4,12,-8,4
AEK Athens,4675,1,4,2,0,7,1,6,14
PAOK Salonik,4675,2,2,2,2,10,6,4,8
P'thinaikos,4675,3,2,1,3,6,10,-4,7
Panionios,4675,4,1,1,4,4,10,-6,4
AEK Athens,4676,1,4,2,0,7,1,6,14
PAOK Salonik,4676,2,2,3,1,11,6,5,9
P'thinaikos,4676,3,1,2,3,6,11,-5,5
Panionios,4676,4,1,1,4,4,10,-6,4
AEK Athens,4677,1,4,2,0,7,1,6,14
PAOK Salonik,4677,2,2,2,2,9,5,4,8
P'thinaikos,4677,3,2,1,3,5,9,-4,7
Panionios,4677,4,1,1,4,4,10,-6,4
AEK Athens,4678,1,4,2,0,7,1,6,14
PAOK Salonik,4678,2,2,3,1,9,4,5,9
P'thinaikos,4678,3,1,2,3,4,9,-5,5
Panionios,4678,4,1,1,4,4,10,-6,4
AEK Athens,4679,1,4,2,0,7,1,6,14
PAOK Salonik,4679,2,2,3,1,9,4,5,9
P'thinaikos,4679,3,1,2,3,4,9,-5,5
Panionios,4679,4,1,1,4,4,10,-6,4
AEK Athens,4680,1,4,2,0,7,1,6,14
PAOK Salonik,4680,2,2,3,1,11,6,5,9
P'thinaikos,4680,3,1,2,3,6,11,-5,5
Panionios,4680,4,1,1,4,4,10,-6,4
AEK Athens,4681,1,4,2,0,7,1,6,14
PAOK Salonik,4681,2,3,2,1,12,4,8,11
Panionios,4681,3,1,1,4,4,10,-6,4
P'thinaikos,4681,4,1,1,4,4,12,-8,4
AEK Athens,4682,1,4,2,0,7,1,6,14
PAOK Salonik,4682,2,2,2,2,10,6,4,8
P'thinaikos,4682,3,2,1,3,6,10,-4,7
Panionios,4682,4,1,1,4,4,10,-6,4
AEK Athens,4683,1,4,2,0,7,1,6,14
PAOK Salonik,4683,2,2,3,1,9,4,5,9
P'thinaikos,4683,3,1,2,3,4,9,-5,5
Panionios,4683,4,1,1,4,4,10,-6,4
AEK Athens,4684,1,4,2,0,7,1,6,14
PAOK Salonik,4684,2,2,2,2,10,7,3,8
P'thinaikos,4684,3,2,1,3,7,10,-3,7
Panionios,4684,4,1,1,4,4,10,-6,4
AEK Athens,4685,1,4,2,0,7,1,6,14
PAOK Salonik,4685,2,2,2,2,9,5,4,8
P'thinaikos,4685,3,2,1,3,5,9,-4,7
Panionios,4685,4,1,1,4,4,10,-6,4
AEK Athens,4686,1,4,2,0,7,1,6,14
PAOK Salonik,4686,2,3,2,1,11,4,7,11
Panionios,4686,3,1,1,4,4,10,-6,4
P'thinaikos,4686,4,1,1,4,4,11,-7,4
AEK Athens,4687,1,4,2,0,7,1,6,14
PAOK Salonik,4687,2,2,3,1,10,5,5,9
P'thinaikos,4687,3,1,2,3,5,10,-5,5
Panionios,4687,4,1,1,4,4,10,-6,4
AEK Athens,4688,1,4,2,0,7,1,6,14
PAOK Salonik,4688,2,2,2,2,9,5,4,8
P'thinaikos,4688,3,2,1,3,5,9,-4,7
Panionios,4688,4,1,1,4,4,10,-6,4
AEK Athens,4689,1,4,2,0,7,1,6,14
PAOK Salonik,4689,2,2,2,2,9,5,4,8
P'thinaikos,4689,3,2,1,3,5,9,-4,7
Panionios,4689,4,1,1,4,4,10,-6,4
AEK Athens,4690,1,4,2,0,7,1,6,14
PAOK Salonik,4690,2,3,2,1,13,4,9,11
Panionios,4690,3,1,1,4,4,10,-6,4
P'thinaikos,4690,4,1,1,4,4,13,-9,4
AEK Athens,4691,1,4,2,0,7,1,6,14
PAOK Salonik,4691,2,2,3,1,11,6,5,9
P'thinaikos,4691,3,1,2,3,6,11,-5,5
Panionios,4691,4,1,1,4,4,10,-6,4
AEK Athens,4692,1,4,2,0,7,1,6,14
PAOK Salonik,4692,2,3,2,1,10,4,6,11
P'thinaikos,4692,3,1,1,4,4,10,-6,4
Panionios,4692,3,1,1,4,4,10,-6,4
AEK Athens,4693,1,4,2,0,7,1,6,14
PAOK Salonik,4693,2,2,2,2,10,7,3,8
P'thinaikos,4693,3,2,1,3,7,10,-3,7
Panionios,4693,4,1,1,4,4,10,-6,4
AEK Athens,4694,1,4,2,0,7,1,6,14
PAOK Salonik,4694,2,3,2,1,11,5,6,11
P'thinaikos,4694,3,1,1,4,5,11,-6,4
Panionios,4694,4,1,1,4,4,10,-6,4
AEK Athens,4695,1,4,2,0,7,1,6,14
PAOK Salonik,4695,2,3,2,1,10,4,6,11
P'thinaikos,4695,3,1,1,4,4,10,-6,4
Panionios,4695,3,1,1,4,4,10,-6,4
AEK Athens,4696,1,4,2,0,7,1,6,14
PAOK Salonik,4696,2,3,2,1,10,4,6,11
P'thinaikos,4696,3,1,1,4,4,10,-6,4
Panionios,4696,3,1,1,4,4,10,-6,4
AEK Athens,4697,1,4,2,0,7,1,6,14
PAOK Salonik,4697,2,2,2,2,9,5,4,8
P'thinaikos,4697,3,2,1,3,5,9,-4,7
Panionios,4697,4,1,1,4,4,10,-6,4
AEK Athens,4698,1,4,2,0,7,1,6,14
PAOK Salonik,4698,2,2,2,2,9,5,4,8
P'thinaikos,4698,3,2,1,3,5,9,-4,7
Panionios,4698,4,1,1,4,4,10,-6,4
AEK Athens,4699,1,4,2,0,7,1,6,14
PAOK Salonik,4699,2,2,2,2,10,6,4,8
P'thinaikos,4699,3,2,1,3,6,10,-4,7
Panionios,4699,4,1,1,4,4,10,-6,4
AEK Athens,4700,1,4,2,0,7,1,6,14
PAOK Salonik,4700,2,2,2,2,12,9,3,8
P'thinaikos,4700,3,2,1,3,9,12,-3,7
Panionios,4700,4,1,1,4,4,10,-6,4
AEK Athens,4701,1,4,2,0,7,1,6,14
PAOK Salonik,4701,2,2,3,1,9,4,5,9
P'thinaikos,4701,3,1,2,3,4,9,-5,5
Panionios,4701,4,1,1,4,4,10,-6,4
AEK Athens,4702,1,4,2,0,7,1,6,14
PAOK Salonik,4702,2,2,3,1,10,5,5,9
P'thinaikos,4702,3,1,2,3,5,10,-5,5
Panionios,4702,4,1,1,4,4,10,-6,4
AEK Athens,4703,1,4,2,0,7,1,6,14
PAOK Salonik,4703,2,3,2,1,11,4,7,11
Panionios,4703,3,1,1,4,4,10,-6,4
P'thinaikos,4703,4,1,1,4,4,11,-7,4
AEK Athens,4704,1,4,2,0,7,1,6,14
PAOK Salonik,4704,2,2,2,2,9,5,4,8
P'thinaikos,4704,3,2,1,3,5,9,-4,7
Panionios,4704,4,1,1,4,4,10,-6,4
AEK Athens,4705,1,4,2,0,7,1,6,14
PAOK Salonik,4705,2,2,3,1,10,5,5,9
P'thinaikos,4705,3,1,2,3,5,10,-5,5
Panionios,4705,4,1,1,4,4,10,-6,4
AEK Athens,4706,1,4,2,0,7,1,6,14
PAOK Salonik,4706,2,3,2,1,10,4,6,11
P'thinaikos,4706,3,1,1,4,4,10,-6,4
Panionios,4706,3,1,1,4,4,10,-6,4
AEK Athens,4707,1,4,2,0,7,1,6,14
PAOK Salonik,4707,2,3,2,1,13,6,7,11
Panionios,4707,3,1,1,4,4,10,-6,4
P'thinaikos,4707,4,1,1,4,6,13,-7,4
AEK Athens,4708,1,4,2,0,7,1,6,14
PAOK Salonik,4708,2,2,3,1,9,4,5,9
P'thinaikos,4708,3,1,2,3,4,9,-5,5
Panionios,4708,4,1,1,4,4,10,-6,4
AEK Athens,4709,1,4,2,0,7,1,6,14
PAOK Salonik,4709,2,2,2,2,11,7,4,8
P'thinaikos,4709,3,2,1,3,7,11,-4,7
Panionios,4709,4,1,1,4,4,10,-6,4
AEK Athens,4710,1,4,2,0,7,1,6,14
PAOK Salonik,4710,2,2,2,2,10,7,3,8
P'thinaikos,4710,3,2,1,3,7,10,-3,7
Panionios,4710,4,1,1,4,4,10,-6,4
AEK Athens,4711,1,4,2,0,7,1,6,14
PAOK Salonik,4711,2,3,2,1,12,5,7,11
Panionios,4711,3,1,1,4,4,10,-6,4
P'thinaikos,4711,4,1,1,4,5,12,-7,4
AEK Athens,4712,1,4,2,0,7,1,6,14
PAOK Salonik,4712,2,3,2,1,10,4,6,11
P'thinaikos,4712,3,1,1,4,4,10,-6,4
Panionios,4712,3,1,1,4,4,10,-6,4
AEK Athens,4713,1,4,2,0,7,1,6,14
PAOK Salonik,4713,2,3,2,1,10,4,6,11
P'thinaikos,4713,3,1,1,4,4,10,-6,4
Panionios,4713,3,1,1,4,4,10,-6,4
AEK Athens,4714,1,4,2,0,7,1,6,14
PAOK Salonik,4714,2,2,3,1,9,4,5,9
P'thinaikos,4714,3,1,2,3,4,9,-5,5
Panionios,4714,4,1,1,4,4,10,-6,4
AEK Athens,4715,1,4,2,0,7,1,6,14
PAOK Salonik,4715,2,3,2,1,11,5,6,11
P'thinaikos,4715,3,1,1,4,5,11,-6,4
Panionios,4715,4,1,1,4,4,10,-6,4
AEK Athens,4716,1,4,2,0,7,1,6,14
PAOK Salonik,4716,2,3,2,1,13,6,7,11
Panionios,4716,3,1,1,4,4,10,-6,4
P'thinaikos,4716,4,1,1,4,6,13,-7,4
AEK Athens,4717,1,4,2,0,7,1,6,14
PAOK Salonik,4717,2,2,3,1,9,4,5,9
P'thinaikos,4717,3,1,2,3,4,9,-5,5
Panionios,4717,4,1,1,4,4,10,-6,4
AEK Athens,4718,1,4,2,0,7,1,6,14
PAOK Salonik,4718,2,2,2,2,10,6,4,8
P'thinaikos,4718,3,2,1,3,6,10,-4,7
Panionios,4718,4,1,1,4,4,10,-6,4
AEK Athens,4719,1,4,2,0,7,1,6,14
PAOK Salonik,4719,2,2,2,2,9,5,4,8
P'thinaikos,4719,3,2,1,3,5,9,-4,7
Panionios,4719,4,1,1,4,4,10,-6,4
AEK Athens,4720,1,4,2,0,7,1,6,14
PAOK Salonik,4720,2,2,3,1,9,4,5,9
P'thinaikos,4720,3,1,2,3,4,9,-5,5
Panionios,4720,4,1,1,4,4,10,-6,4
AEK Athens,4721,1,4,2,0,7,1,6,14
PAOK Salonik,4721,2,2,2,2,9,7,2,8
P'thinaikos,4721,3,2,1,3,7,9,-2,7
Panionios,4721,4,1,1,4,4,10,-6,4
AEK Athens,4722,1,4,2,0,7,1,6,14
PAOK Salonik,4722,2,2,3,1,10,5,5,9
P'thinaikos,4722,3,1,2,3,5,10,-5,5
Panionios,4722,4,1,1,4,4,10,-6,4
AEK Athens,4723,1,4,2,0,7,1,6,14
PAOK Salonik,4723,2,3,2,1,10,4,6,11
P'thinaikos,4723,3,1,1,4,4,10,-6,4
Panionios,4723,3,1,1,4,4,10,-6,4
AEK Athens,4724,1,4,2,0,7,1,6,14
PAOK Salonik,4724,2,2,3,1,12,7,5,9
P'thinaikos,4724,3,1,2,3,7,12,-5,5
Panionios,4724,4,1,1,4,4,10,-6,4
AEK Athens,4725,1,4,2,0,7,1,6,14
PAOK Salonik,4725,2,2,2,2,9,6,3,8
P'thinaikos,4725,3,2,1,3,6,9,-3,7
Panionios,4725,4,1,1,4,4,10,-6,4
AEK Athens,4726,1,4,2,0,7,1,6,14
PAOK Salonik,4726,2,3,2,1,11,4,7,11
Panionios,4726,3,1,1,4,4,10,-6,4
P'thinaikos,4726,4,1,1,4,4,11,-7,4
AEK Athens,4727,1,4,2,0,7,1,6,14
PAOK Salonik,4727,2,2,2,2,9,6,3,8
P'thinaikos,4727,3,2,1,3,6,9,-3,7
Panionios,4727,4,1,1,4,4,10,-6,4
AEK Athens,4728,1,4,2,0,7,1,6,14
PAOK Salonik,4728,2,2,3,1,10,5,5,9
P'thinaikos,4728,3,1,2,3,5,10,-5,5
Panionios,4728,4,1,1,4,4,10,-6,4
AEK Athens,4729,1,4,2,0,7,1,6,14
PAOK Salonik,4729,2,2,2,2,10,6,4,8
P'thinaikos,4729,3,2,1,3,6,10,-4,7
Panionios,4729,4,1,1,4,4,10,-6,4
AEK Athens,4730,1,4,2,0,7,1,6,14
PAOK Salonik,4730,2,2,2,2,9,5,4,8
P'thinaikos,4730,3,2,1,3,5,9,-4,7
Panionios,4730,4,1,1,4,4,10,-6,4
AEK Athens,4731,1,4,2,0,7,1,6,14
PAOK Salonik,4731,2,3,2,1,12,6,6,11
P'thinaikos,4731,3,1,1,4,6,12,-6,4
Panionios,4731,4,1,1,4,4,10,-6,4
AEK Athens,4732,1,4,2,0,7,1,6,14
PAOK Salonik,4732,2,3,2,1,11,5,6,11
P'thinaikos,4732,3,1,1,4,5,11,-6,4
Panionios,4732,4,1,1,4,4,10,-6,4
AEK Athens,4733,1,4,2,0,7,1,6,14
PAOK Salonik,4733,2,2,2,2,9,6,3,8
P'thinaikos,4733,3,2,1,3,6,9,-3,7
Panionios,4733,4,1,1,4,4,10,-6,4
AEK Athens,4734,1,4,2,0,7,1,6,14
PAOK Salonik,4734,2,2,2,2,9,7,2,8
P'thinaikos,4734,3,2,1,3,7,9,-2,7
Panionios,4734,4,1,1,4,4,10,-6,4
AEK Athens,4735,1,4,2,0,7,1,6,14
PAOK Salonik,4735,2,2,2,2,9,6,3,8
P'thinaikos,4735,3,2,1,3,6,9,-3,7
Panionios,4735,4,1,1,4,4,10,-6,4
AEK Athens,4736,1,4,2,0,7,1,6,14
PAOK Salonik,4736,2,3,2,1,10,4,6,11
P'thinaikos,4736,3,1,1,4,4,10,-6,4
Panionios,4736,3,1,1,4,4,10,-6,4
AEK Athens,4737,1,4,2,0,7,1,6,14
PAOK Salonik,4737,2,2,2,2,9,7,2,8
P'thinaikos,4737,3,2,1,3,7,9,-2,7
Panionios,4737,4,1,1,4,4,10,-6,4
AEK Athens,4738,1,4,2,0,7,1,6,14
PAOK Salonik,4738,2,2,2,2,9,7,2,8
P'thinaikos,4738,3,2,1,3,7,9,-2,7
Panionios,4738,4,1,1,4,4,10,-6,4
AEK Athens,4739,1,4,2,0,7,1,6,14
PAOK Salonik,4739,2,3,2,1,10,4,6,11
P'thinaikos,4739,3,1,1,4,4,10,-6,4
Panionios,4739,3,1,1,4,4,10,-6,4
AEK Athens,4740,1,4,2,0,7,1,6,14
PAOK Salonik,4740,2,2,3,1,10,5,5,9
P'thinaikos,4740,3,1,2,3,5,10,-5,5
Panionios,4740,4,1,1,4,4,10,-6,4
AEK Athens,4741,1,4,2,0,7,1,6,14
PAOK Salonik,4741,2,3,2,1,10,4,6,11
P'thinaikos,4741,3,1,1,4,4,10,-6,4
Panionios,4741,3,1,1,4,4,10,-6,4
AEK Athens,4742,1,4,2,0,7,1,6,14
PAOK Salonik,4742,2,2,2,2,9,5,4,8
P'thinaikos,4742,3,2,1,3,5,9,-4,7
Panionios,4742,4,1,1,4,4,10,-6,4
AEK Athens,4743,1,4,2,0,7,1,6,14
PAOK Salonik,4743,2,3,2,1,12,4,8,11
Panionios,4743,3,1,1,4,4,10,-6,4
P'thinaikos,4743,4,1,1,4,4,12,-8,4
AEK Athens,4744,1,4,2,0,7,1,6,14
PAOK Salonik,4744,2,3,2,1,12,4,8,11
Panionios,4744,3,1,1,4,4,10,-6,4
P'thinaikos,4744,4,1,1,4,4,12,-8,4
AEK Athens,4745,1,4,2,0,7,1,6,14
PAOK Salonik,4745,2,2,3,1,9,4,5,9
P'thinaikos,4745,3,1,2,3,4,9,-5,5
Panionios,4745,4,1,1,4,4,10,-6,4
AEK Athens,4746,1,4,2,0,7,1,6,14
PAOK Salonik,4746,2,3,2,1,10,4,6,11
P'thinaikos,4746,3,1,1,4,4,10,-6,4
Panionios,4746,3,1,1,4,4,10,-6,4
AEK Athens,4747,1,4,2,0,7,1,6,14
PAOK Salonik,4747,2,2,3,1,9,4,5,9
P'thinaikos,4747,3,1,2,3,4,9,-5,5
Panionios,4747,4,1,1,4,4,10,-6,4
AEK Athens,4748,1,4,2,0,7,1,6,14
PAOK Salonik,4748,2,2,2,2,9,5,4,8
P'thinaikos,4748,3,2,1,3,5,9,-4,7
Panionios,4748,4,1,1,4,4,10,-6,4
AEK Athens,4749,1,4,2,0,7,1,6,14
PAOK Salonik,4749,2,2,3,1,10,5,5,9
P'thinaikos,4749,3,1,2,3,5,10,-5,5
Panionios,4749,4,1,1,4,4,10,-6,4
AEK Athens,4750,1,4,2,0,7,1,6,14
PAOK Salonik,4750,2,2,2,2,9,5,4,8
P'thinaikos,4750,3,2,1,3,5,9,-4,7
Panionios,4750,4,1,1,4,4,10,-6,4
AEK Athens,4751,1,4,2,0,7,1,6,14
PAOK Salonik,4751,2,3,2,1,11,4,7,11
Panionios,4751,3,1,1,4,4,10,-6,4
P'thinaikos,4751,4,1,1,4,4,11,-7,4
AEK Athens,4752,1,4,2,0,7,1,6,14
PAOK Salonik,4752,2,2,2,2,11,7,4,8
P'thinaikos,4752,3,2,1,3,7,11,-4,7
Panionios,4752,4,1,1,4,4,10,-6,4
AEK Athens,4753,1,4,2,0,7,1,6,14
PAOK Salonik,4753,2,3,2,1,11,5,6,11
P'thinaikos,4753,3,1,1,4,5,11,-6,4
Panionios,4753,4,1,1,4,4,10,-6,4
AEK Athens,4754,1,4,2,0,7,1,6,14
PAOK Salonik,4754,2,2,2,2,10,6,4,8
P'thinaikos,4754,3,2,1,3,6,10,-4,7
Panionios,4754,4,1,1,4,4,10,-6,4
AEK Athens,4755,1,4,2,0,7,1,6,14
PAOK Salonik,4755,2,2,2,2,9,5,4,8
P'thinaikos,4755,3,2,1,3,5,9,-4,7
Panionios,4755,4,1,1,4,4,10,-6,4
AEK Athens,4756,1,4,2,0,7,1,6,14
PAOK Salonik,4756,2,2,3,1,10,5,5,9
P'thinaikos,4756,3,1,2,3,5,10,-5,5
Panionios,4756,4,1,1,4,4,10,-6,4
AEK Athens,4757,1,4,2,0,7,1,6,14
PAOK Salonik,4757,2,3,2,1,11,4,7,11
Panionios,4757,3,1,1,4,4,10,-6,4
P'thinaikos,4757,4,1,1,4,4,11,-7,4
AEK Athens,4758,1,4,2,0,7,1,6,14
PAOK Salonik,4758,2,3,2,1,12,6,6,11
P'thinaikos,4758,3,1,1,4,6,12,-6,4
Panionios,4758,4,1,1,4,4,10,-6,4
AEK Athens,4759,1,4,2,0,7,1,6,14
PAOK Salonik,4759,2,2,2,2,9,7,2,8
P'thinaikos,4759,3,2,1,3,7,9,-2,7
Panionios,4759,4,1,1,4,4,10,-6,4
AEK Athens,4760,1,4,2,0,7,1,6,14
PAOK Salonik,4760,2,2,3,1,9,4,5,9
P'thinaikos,4760,3,1,2,3,4,9,-5,5
Panionios,4760,4,1,1,4,4,10,-6,4
AEK Athens,4761,1,4,2,0,7,1,6,14
PAOK Salonik,4761,2,2,2,2,9,7,2,8
P'thinaikos,4761,3,2,1,3,7,9,-2,7
Panionios,4761,4,1,1,4,4,10,-6,4
AEK Athens,4762,1,4,2,0,7,1,6,14
PAOK Salonik,4762,2,2,3,1,10,5,5,9
P'thinaikos,4762,3,1,2,3,5,10,-5,5
Panionios,4762,4,1,1,4,4,10,-6,4
AEK Athens,4763,1,4,2,0,7,1,6,14
PAOK Salonik,4763,2,2,2,2,9,5,4,8
P'thinaikos,4763,3,2,1,3,5,9,-4,7
Panionios,4763,4,1,1,4,4,10,-6,4
AEK Athens,4764,1,4,2,0,7,1,6,14
PAOK Salonik,4764,2,2,3,1,12,7,5,9
P'thinaikos,4764,3,1,2,3,7,12,-5,5
Panionios,4764,4,1,1,4,4,10,-6,4
AEK Athens,4765,1,4,2,0,7,1,6,14
PAOK Salonik,4765,2,2,3,1,9,4,5,9
P'thinaikos,4765,3,1,2,3,4,9,-5,5
Panionios,4765,4,1,1,4,4,10,-6,4
AEK Athens,4766,1,4,2,0,7,1,6,14
PAOK Salonik,4766,2,2,3,1,10,5,5,9
P'thinaikos,4766,3,1,2,3,5,10,-5,5
Panionios,4766,4,1,1,4,4,10,-6,4
AEK Athens,4767,1,4,2,0,7,1,6,14
PAOK Salonik,4767,2,3,2,1,12,4,8,11
Panionios,4767,3,1,1,4,4,10,-6,4
P'thinaikos,4767,4,1,1,4,4,12,-8,4
AEK Athens,4768,1,4,2,0,7,1,6,14
PAOK Salonik,4768,2,2,2,2,9,6,3,8
P'thinaikos,4768,3,2,1,3,6,9,-3,7
Panionios,4768,4,1,1,4,4,10,-6,4
AEK Athens,4769,1,4,2,0,7,1,6,14
PAOK Salonik,4769,2,2,2,2,10,6,4,8
P'thinaikos,4769,3,2,1,3,6,10,-4,7
Panionios,4769,4,1,1,4,4,10,-6,4
AEK Athens,4770,1,4,2,0,7,1,6,14
PAOK Salonik,4770,2,2,2,2,9,6,3,8
P'thinaikos,4770,3,2,1,3,6,9,-3,7
Panionios,4770,4,1,1,4,4,10,-6,4
AEK Athens,4771,1,4,2,0,7,1,6,14
PAOK Salonik,4771,2,2,3,1,9,4,5,9
P'thinaikos,4771,3,1,2,3,4,9,-5,5
Panionios,4771,4,1,1,4,4,10,-6,4
AEK Athens,4772,1,4,2,0,7,1,6,14
PAOK Salonik,4772,2,3,2,1,12,6,6,11
P'thinaikos,4772,3,1,1,4,6,12,-6,4
Panionios,4772,4,1,1,4,4,10,-6,4
AEK Athens,4773,1,4,2,0,7,1,6,14
PAOK Salonik,4773,2,2,2,2,9,6,3,8
P'thinaikos,4773,3,2,1,3,6,9,-3,7
Panionios,4773,4,1,1,4,4,10,-6,4
AEK Athens,4774,1,4,2,0,7,1,6,14
PAOK Salonik,4774,2,3,2,1,11,5,6,11
P'thinaikos,4774,3,1,1,4,5,11,-6,4
Panionios,4774,4,1,1,4,4,10,-6,4
AEK Athens,4775,1,4,2,0,7,1,6,14
PAOK Salonik,4775,2,2,3,1,10,5,5,9
P'thinaikos,4775,3,1,2,3,5,10,-5,5
Panionios,4775,4,1,1,4,4,10,-6,4
AEK Athens,4776,1,4,2,0,7,1,6,14
PAOK Salonik,4776,2,3,2,1,11,5,6,11
P'thinaikos,4776,3,1,1,4,5,11,-6,4
Panionios,4776,4,1,1,4,4,10,-6,4
AEK Athens,4777,1,4,2,0,7,1,6,14
PAOK Salonik,4777,2,2,2,2,11,7,4,8
P'thinaikos,4777,3,2,1,3,7,11,-4,7
Panionios,4777,4,1,1,4,4,10,-6,4
AEK Athens,4778,1,4,2,0,7,1,6,14
PAOK Salonik,4778,2,2,2,2,9,5,4,8
P'thinaikos,4778,3,2,1,3,5,9,-4,7
Panionios,4778,4,1,1,4,4,10,-6,4
AEK Athens,4779,1,4,2,0,7,1,6,14
PAOK Salonik,4779,2,3,2,1,10,4,6,11
P'thinaikos,4779,3,1,1,4,4,10,-6,4
Panionios,4779,3,1,1,4,4,10,-6,4
AEK Athens,4780,1,4,2,0,7,1,6,14
PAOK Salonik,4780,2,2,2,2,9,5,4,8
P'thinaikos,4780,3,2,1,3,5,9,-4,7
Panionios,4780,4,1,1,4,4,10,-6,4
AEK Athens,4781,1,4,2,0,7,1,6,14
PAOK Salonik,4781,2,3,2,1,11,4,7,11
Panionios,4781,3,1,1,4,4,10,-6,4
P'thinaikos,4781,4,1,1,4,4,11,-7,4
AEK Athens,4782,1,4,2,0,7,1,6,14
PAOK Salonik,4782,2,2,2,2,9,9,0,8
P'thinaikos,4782,3,2,1,3,9,9,0,7
Panionios,4782,4,1,1,4,4,10,-6,4
AEK Athens,4783,1,4,2,0,7,1,6,14
PAOK Salonik,4783,2,3,2,1,11,5,6,11
P'thinaikos,4783,3,1,1,4,5,11,-6,4
Panionios,4783,4,1,1,4,4,10,-6,4
AEK Athens,4784,1,4,2,0,7,1,6,14
PAOK Salonik,4784,2,2,2,2,9,8,1,8
P'thinaikos,4784,3,2,1,3,8,9,-1,7
Panionios,4784,4,1,1,4,4,10,-6,4
AEK Athens,4785,1,4,2,0,7,1,6,14
PAOK Salonik,4785,2,2,3,1,10,5,5,9
P'thinaikos,4785,3,1,2,3,5,10,-5,5
Panionios,4785,4,1,1,4,4,10,-6,4
AEK Athens,4786,1,4,2,0,7,1,6,14
PAOK Salonik,4786,2,2,2,2,12,8,4,8
P'thinaikos,4786,3,2,1,3,8,12,-4,7
Panionios,4786,4,1,1,4,4,10,-6,4
AEK Athens,4787,1,4,2,0,7,1,6,14
PAOK Salonik,4787,2,2,2,2,9,5,4,8
P'thinaikos,4787,3,2,1,3,5,9,-4,7
Panionios,4787,4,1,1,4,4,10,-6,4
AEK Athens,4788,1,4,2,0,7,1,6,14
PAOK Salonik,4788,2,2,2,2,10,6,4,8
P'thinaikos,4788,3,2,1,3,6,10,-4,7
Panionios,4788,4,1,1,4,4,10,-6,4
AEK Athens,4789,1,4,2,0,7,1,6,14
PAOK Salonik,4789,2,3,2,1,11,4,7,11
Panionios,4789,3,1,1,4,4,10,-6,4
P'thinaikos,4789,4,1,1,4,4,11,-7,4
AEK Athens,4790,1,4,2,0,7,1,6,14
PAOK Salonik,4790,2,2,2,2,10,7,3,8
P'thinaikos,4790,3,2,1,3,7,10,-3,7
Panionios,4790,4,1,1,4,4,10,-6,4
AEK Athens,4791,1,4,2,0,7,1,6,14
PAOK Salonik,4791,2,3,2,1,12,6,6,11
P'thinaikos,4791,3,1,1,4,6,12,-6,4
Panionios,4791,4,1,1,4,4,10,-6,4
AEK Athens,4792,1,4,2,0,7,1,6,14
PAOK Salonik,4792,2,3,2,1,11,5,6,11
P'thinaikos,4792,3,1,1,4,5,11,-6,4
Panionios,4792,4,1,1,4,4,10,-6,4
AEK Athens,4793,1,4,2,0,7,1,6,14
PAOK Salonik,4793,2,2,3,1,9,4,5,9
P'thinaikos,4793,3,1,2,3,4,9,-5,5
Panionios,4793,4,1,1,4,4,10,-6,4
AEK Athens,4794,1,4,2,0,7,1,6,14
PAOK Salonik,4794,2,2,3,1,9,4,5,9
P'thinaikos,4794,3,1,2,3,4,9,-5,5
Panionios,4794,4,1,1,4,4,10,-6,4
AEK Athens,4795,1,4,2,0,7,1,6,14
PAOK Salonik,4795,2,3,2,1,12,5,7,11
Panionios,4795,3,1,1,4,4,10,-6,4
P'thinaikos,4795,4,1,1,4,5,12,-7,4
AEK Athens,4796,1,4,2,0,7,1,6,14
PAOK Salonik,4796,2,3,2,1,10,4,6,11
P'thinaikos,4796,3,1,1,4,4,10,-6,4
Panionios,4796,3,1,1,4,4,10,-6,4
AEK Athens,4797,1,4,2,0,7,1,6,14
PAOK Salonik,4797,2,2,3,1,11,6,5,9
P'thinaikos,4797,3,1,2,3,6,11,-5,5
Panionios,4797,4,1,1,4,4,10,-6,4
AEK Athens,4798,1,4,2,0,7,1,6,14
PAOK Salonik,4798,2,2,2,2,9,5,4,8
P'thinaikos,4798,3,2,1,3,5,9,-4,7
Panionios,4798,4,1,1,4,4,10,-6,4
AEK Athens,4799,1,4,2,0,7,1,6,14
PAOK Salonik,4799,2,3,2,1,12,4,8,11
Panionios,4799,3,1,1,4,4,10,-6,4
P'thinaikos,4799,4,1,1,4,4,12,-8,4
AEK Athens,4800,1,4,2,0,7,1,6,14
PAOK Salonik,4800,2,3,2,1,11,5,6,11
P'thinaikos,4800,3,1,1,4,5,11,-6,4
Panionios,4800,4,1,1,4,4,10,-6,4
AEK Athens,4801,1,4,2,0,7,1,6,14
PAOK Salonik,4801,2,3,2,1,12,6,6,11
P'thinaikos,4801,3,1,1,4,6,12,-6,4
Panionios,4801,4,1,1,4,4,10,-6,4
AEK Athens,4802,1,4,2,0,7,1,6,14
PAOK Salonik,4802,2,2,2,2,9,5,4,8
P'thinaikos,4802,3,2,1,3,5,9,-4,7
Panionios,4802,4,1,1,4,4,10,-6,4
AEK Athens,4803,1,4,2,0,7,1,6,14
PAOK Salonik,4803,2,2,3,1,12,7,5,9
P'thinaikos,4803,3,1,2,3,7,12,-5,5
Panionios,4803,4,1,1,4,4,10,-6,4
AEK Athens,4804,1,4,2,0,7,1,6,14
PAOK Salonik,4804,2,3,2,1,13,4,9,11
Panionios,4804,3,1,1,4,4,10,-6,4
P'thinaikos,4804,4,1,1,4,4,13,-9,4
AEK Athens,4805,1,4,2,0,7,1,6,14
PAOK Salonik,4805,2,2,2,2,9,5,4,8
P'thinaikos,4805,3,2,1,3,5,9,-4,7
Panionios,4805,4,1,1,4,4,10,-6,4
AEK Athens,4806,1,4,2,0,7,1,6,14
PAOK Salonik,4806,2,3,2,1,10,4,6,11
P'thinaikos,4806,3,1,1,4,4,10,-6,4
Panionios,4806,3,1,1,4,4,10,-6,4
AEK Athens,4807,1,4,2,0,7,1,6,14
PAOK Salonik,4807,2,2,3,1,9,4,5,9
P'thinaikos,4807,3,1,2,3,4,9,-5,5
Panionios,4807,4,1,1,4,4,10,-6,4
AEK Athens,4808,1,4,2,0,7,1,6,14
PAOK Salonik,4808,2,2,2,2,9,5,4,8
P'thinaikos,4808,3,2,1,3,5,9,-4,7
Panionios,4808,4,1,1,4,4,10,-6,4
AEK Athens,4809,1,4,2,0,7,1,6,14
PAOK Salonik,4809,2,3,2,1,13,6,7,11
Panionios,4809,3,1,1,4,4,10,-6,4
P'thinaikos,4809,4,1,1,4,6,13,-7,4
AEK Athens,4810,1,4,2,0,7,1,6,14
PAOK Salonik,4810,2,2,2,2,10,6,4,8
P'thinaikos,4810,3,2,1,3,6,10,-4,7
Panionios,4810,4,1,1,4,4,10,-6,4
AEK Athens,4811,1,4,2,0,7,1,6,14
PAOK Salonik,4811,2,2,3,1,10,5,5,9
P'thinaikos,4811,3,1,2,3,5,10,-5,5
Panionios,4811,4,1,1,4,4,10,-6,4
AEK Athens,4812,1,4,2,0,7,1,6,14
PAOK Salonik,4812,2,2,2,2,9,6,3,8
P'thinaikos,4812,3,2,1,3,6,9,-3,7
Panionios,4812,4,1,1,4,4,10,-6,4
AEK Athens,4813,1,4,2,0,7,1,6,14
PAOK Salonik,4813,2,2,2,2,10,8,2,8
P'thinaikos,4813,3,2,1,3,8,10,-2,7
Panionios,4813,4,1,1,4,4,10,-6,4
AEK Athens,4814,1,4,2,0,7,1,6,14
PAOK Salonik,4814,2,2,2,2,9,5,4,8
P'thinaikos,4814,3,2,1,3,5,9,-4,7
Panionios,4814,4,1,1,4,4,10,-6,4
AEK Athens,4815,1,4,2,0,7,1,6,14
PAOK Salonik,4815,2,2,2,2,9,8,1,8
P'thinaikos,4815,3,2,1,3,8,9,-1,7
Panionios,4815,4,1,1,4,4,10,-6,4
AEK Athens,4816,1,4,2,0,7,1,6,14
PAOK Salonik,4816,2,2,2,2,9,5,4,8
P'thinaikos,4816,3,2,1,3,5,9,-4,7
Panionios,4816,4,1,1,4,4,10,-6,4
AEK Athens,4817,1,4,2,0,7,1,6,14
PAOK Salonik,4817,2,3,2,1,10,4,6,11
P'thinaikos,4817,3,1,1,4,4,10,-6,4
Panionios,4817,3,1,1,4,4,10,-6,4
AEK Athens,4818,1,4,2,0,7,1,6,14
PAOK Salonik,4818,2,3,2,1,11,5,6,11
P'thinaikos,4818,3,1,1,4,5,11,-6,4
Panionios,4818,4,1,1,4,4,10,-6,4
AEK Athens,4819,1,4,2,0,7,1,6,14
PAOK Salonik,4819,2,3,2,1,10,4,6,11
P'thinaikos,4819,3,1,1,4,4,10,-6,4
Panionios,4819,3,1,1,4,4,10,-6,4
AEK Athens,4820,1,4,2,0,7,1,6,14
PAOK Salonik,4820,2,2,3,1,9,4,5,9
P'thinaikos,4820,3,1,2,3,4,9,-5,5
Panionios,4820,4,1,1,4,4,10,-6,4
AEK Athens,4821,1,4,2,0,7,1,6,14
PAOK Salonik,4821,2,3,2,1,11,4,7,11
Panionios,4821,3,1,1,4,4,10,-6,4
P'thinaikos,4821,4,1,1,4,4,11,-7,4
AEK Athens,4822,1,4,2,0,7,1,6,14
PAOK Salonik,4822,2,2,3,1,11,6,5,9
P'thinaikos,4822,3,1,2,3,6,11,-5,5
Panionios,4822,4,1,1,4,4,10,-6,4
AEK Athens,4823,1,4,2,0,7,1,6,14
PAOK Salonik,4823,2,2,2,2,9,5,4,8
P'thinaikos,4823,3,2,1,3,5,9,-4,7
Panionios,4823,4,1,1,4,4,10,-6,4
AEK Athens,4824,1,4,2,0,7,1,6,14
PAOK Salonik,4824,2,3,2,1,12,5,7,11
Panionios,4824,3,1,1,4,4,10,-6,4
P'thinaikos,4824,4,1,1,4,5,12,-7,4
AEK Athens,4825,1,4,2,0,7,1,6,14
PAOK Salonik,4825,2,2,3,1,10,5,5,9
P'thinaikos,4825,3,1,2,3,5,10,-5,5
Panionios,4825,4,1,1,4,4,10,-6,4
AEK Athens,4826,1,4,2,0,7,1,6,14
PAOK Salonik,4826,2,2,3,1,11,6,5,9
P'thinaikos,4826,3,1,2,3,6,11,-5,5
Panionios,4826,4,1,1,4,4,10,-6,4
AEK Athens,4827,1,4,2,0,7,1,6,14
PAOK Salonik,4827,2,2,3,1,11,6,5,9
P'thinaikos,4827,3,1,2,3,6,11,-5,5
Panionios,4827,4,1,1,4,4,10,-6,4
AEK Athens,4828,1,4,2,0,7,1,6,14
PAOK Salonik,4828,2,2,2,2,10,6,4,8
P'thinaikos,4828,3,2,1,3,6,10,-4,7
Panionios,4828,4,1,1,4,4,10,-6,4
AEK Athens,4829,1,4,2,0,7,1,6,14
PAOK Salonik,4829,2,3,2,1,14,6,8,11
Panionios,4829,3,1,1,4,4,10,-6,4
P'thinaikos,4829,4,1,1,4,6,14,-8,4
AEK Athens,4830,1,4,2,0,7,1,6,14
PAOK Salonik,4830,2,2,2,2,9,6,3,8
P'thinaikos,4830,3,2,1,3,6,9,-3,7
Panionios,4830,4,1,1,4,4,10,-6,4
AEK Athens,4831,1,4,2,0,7,1,6,14
PAOK Salonik,4831,2,2,3,1,10,5,5,9
P'thinaikos,4831,3,1,2,3,5,10,-5,5
Panionios,4831,4,1,1,4,4,10,-6,4
AEK Athens,4832,1,4,2,0,7,1,6,14
PAOK Salonik,4832,2,2,3,1,9,4,5,9
P'thinaikos,4832,3,1,2,3,4,9,-5,5
Panionios,4832,4,1,1,4,4,10,-6,4
AEK Athens,4833,1,4,2,0,7,1,6,14
PAOK Salonik,4833,2,2,3,1,9,4,5,9
P'thinaikos,4833,3,1,2,3,4,9,-5,5
Panionios,4833,4,1,1,4,4,10,-6,4
AEK Athens,4834,1,4,2,0,7,1,6,14
PAOK Salonik,4834,2,3,2,1,10,4,6,11
P'thinaikos,4834,3,1,1,4,4,10,-6,4
Panionios,4834,3,1,1,4,4,10,-6,4
AEK Athens,4835,1,4,2,0,7,1,6,14
PAOK Salonik,4835,2,2,2,2,9,7,2,8
P'thinaikos,4835,3,2,1,3,7,9,-2,7
Panionios,4835,4,1,1,4,4,10,-6,4
AEK Athens,4836,1,4,2,0,7,1,6,14
PAOK Salonik,4836,2,3,2,1,12,4,8,11
Panionios,4836,3,1,1,4,4,10,-6,4
P'thinaikos,4836,4,1,1,4,4,12,-8,4
AEK Athens,4837,1,4,2,0,7,1,6,14
PAOK Salonik,4837,2,2,3,1,9,4,5,9
P'thinaikos,4837,3,1,2,3,4,9,-5,5
Panionios,4837,4,1,1,4,4,10,-6,4
AEK Athens,4838,1,4,2,0,7,1,6,14
PAOK Salonik,4838,2,3,2,1,11,5,6,11
P'thinaikos,4838,3,1,1,4,5,11,-6,4
Panionios,4838,4,1,1,4,4,10,-6,4
AEK Athens,4839,1,4,2,0,7,1,6,14
PAOK Salonik,4839,2,2,2,2,10,6,4,8
P'thinaikos,4839,3,2,1,3,6,10,-4,7
Panionios,4839,4,1,1,4,4,10,-6,4
AEK Athens,4840,1,4,2,0,7,1,6,14
PAOK Salonik,4840,2,2,2,2,9,7,2,8
P'thinaikos,4840,3,2,1,3,7,9,-2,7
Panionios,4840,4,1,1,4,4,10,-6,4
AEK Athens,4841,1,4,2,0,7,1,6,14
PAOK Salonik,4841,2,3,2,1,11,4,7,11
Panionios,4841,3,1,1,4,4,10,-6,4
P'thinaikos,4841,4,1,1,4,4,11,-7,4
AEK Athens,4842,1,4,2,0,7,1,6,14
PAOK Salonik,4842,2,2,2,2,9,5,4,8
P'thinaikos,4842,3,2,1,3,5,9,-4,7
Panionios,4842,4,1,1,4,4,10,-6,4
AEK Athens,4843,1,4,2,0,7,1,6,14
PAOK Salonik,4843,2,2,3,1,11,6,5,9
P'thinaikos,4843,3,1,2,3,6,11,-5,5
Panionios,4843,4,1,1,4,4,10,-6,4
AEK Athens,4844,1,4,2,0,7,1,6,14
PAOK Salonik,4844,2,2,2,2,9,5,4,8
P'thinaikos,4844,3,2,1,3,5,9,-4,7
Panionios,4844,4,1,1,4,4,10,-6,4
AEK Athens,4845,1,4,2,0,7,1,6,14
PAOK Salonik,4845,2,3,2,1,12,5,7,11
Panionios,4845,3,1,1,4,4,10,-6,4
P'thinaikos,4845,4,1,1,4,5,12,-7,4
AEK Athens,4846,1,4,2,0,7,1,6,14
PAOK Salonik,4846,2,2,2,2,9,5,4,8
P'thinaikos,4846,3,2,1,3,5,9,-4,7
Panionios,4846,4,1,1,4,4,10,-6,4
AEK Athens,4847,1,4,2,0,7,1,6,14
PAOK Salonik,4847,2,2,2,2,9,5,4,8
P'thinaikos,4847,3,2,1,3,5,9,-4,7
Panionios,4847,4,1,1,4,4,10,-6,4
AEK Athens,4848,1,4,2,0,7,1,6,14
PAOK Salonik,4848,2,3,2,1,11,5,6,11
P'thinaikos,4848,3,1,1,4,5,11,-6,4
Panionios,4848,4,1,1,4,4,10,-6,4
AEK Athens,4849,1,4,2,0,7,1,6,14
PAOK Salonik,4849,2,3,2,1,11,5,6,11
P'thinaikos,4849,3,1,1,4,5,11,-6,4
Panionios,4849,4,1,1,4,4,10,-6,4
AEK Athens,4850,1,4,2,0,7,1,6,14
PAOK Salonik,4850,2,2,2,2,10,6,4,8
P'thinaikos,4850,3,2,1,3,6,10,-4,7
Panionios,4850,4,1,1,4,4,10,-6,4
AEK Athens,4851,1,4,2,0,7,1,6,14
PAOK Salonik,4851,2,2,2,2,9,6,3,8
P'thinaikos,4851,3,2,1,3,6,9,-3,7
Panionios,4851,4,1,1,4,4,10,-6,4
AEK Athens,4852,1,4,2,0,7,1,6,14
PAOK Salonik,4852,2,3,2,1,12,5,7,11
Panionios,4852,3,1,1,4,4,10,-6,4
P'thinaikos,4852,4,1,1,4,5,12,-7,4
AEK Athens,4853,1,4,2,0,7,1,6,14
PAOK Salonik,4853,2,3,2,1,10,4,6,11
P'thinaikos,4853,3,1,1,4,4,10,-6,4
Panionios,4853,3,1,1,4,4,10,-6,4
AEK Athens,4854,1,4,2,0,7,1,6,14
PAOK Salonik,4854,2,2,2,2,10,8,2,8
P'thinaikos,4854,3,2,1,3,8,10,-2,7
Panionios,4854,4,1,1,4,4,10,-6,4
AEK Athens,4855,1,4,2,0,7,1,6,14
PAOK Salonik,4855,2,2,3,1,11,6,5,9
P'thinaikos,4855,3,1,2,3,6,11,-5,5
Panionios,4855,4,1,1,4,4,10,-6,4
AEK Athens,4856,1,4,2,0,7,1,6,14
PAOK Salonik,4856,2,2,2,2,9,5,4,8
P'thinaikos,4856,3,2,1,3,5,9,-4,7
Panionios,4856,4,1,1,4,4,10,-6,4
AEK Athens,4857,1,4,2,0,7,1,6,14
PAOK Salonik,4857,2,2,2,2,10,6,4,8
P'thinaikos,4857,3,2,1,3,6,10,-4,7
Panionios,4857,4,1,1,4,4,10,-6,4
AEK Athens,4858,1,4,2,0,7,1,6,14
PAOK Salonik,4858,2,3,2,1,11,5,6,11
P'thinaikos,4858,3,1,1,4,5,11,-6,4
Panionios,4858,4,1,1,4,4,10,-6,4
AEK Athens,4859,1,4,2,0,7,1,6,14
PAOK Salonik,4859,2,2,2,2,11,7,4,8
P'thinaikos,4859,3,2,1,3,7,11,-4,7
Panionios,4859,4,1,1,4,4,10,-6,4
AEK Athens,4860,1,4,2,0,7,1,6,14
PAOK Salonik,4860,2,3,2,1,11,5,6,11
P'thinaikos,4860,3,1,1,4,5,11,-6,4
Panionios,4860,4,1,1,4,4,10,-6,4
AEK Athens,4861,1,4,2,0,7,1,6,14
PAOK Salonik,4861,2,2,2,2,9,5,4,8
P'thinaikos,4861,3,2,1,3,5,9,-4,7
Panionios,4861,4,1,1,4,4,10,-6,4
AEK Athens,4862,1,4,2,0,7,1,6,14
PAOK Salonik,4862,2,3,2,1,11,4,7,11
Panionios,4862,3,1,1,4,4,10,-6,4
P'thinaikos,4862,4,1,1,4,4,11,-7,4
AEK Athens,4863,1,4,2,0,7,1,6,14
PAOK Salonik,4863,2,2,3,1,10,5,5,9
P'thinaikos,4863,3,1,2,3,5,10,-5,5
Panionios,4863,4,1,1,4,4,10,-6,4
AEK Athens,4864,1,4,2,0,7,1,6,14
PAOK Salonik,4864,2,3,2,1,12,4,8,11
Panionios,4864,3,1,1,4,4,10,-6,4
P'thinaikos,4864,4,1,1,4,4,12,-8,4
AEK Athens,4865,1,4,2,0,7,1,6,14
PAOK Salonik,4865,2,2,3,1,10,5,5,9
P'thinaikos,4865,3,1,2,3,5,10,-5,5
Panionios,4865,4,1,1,4,4,10,-6,4
AEK Athens,4866,1,4,2,0,7,1,6,14
PAOK Salonik,4866,2,2,3,1,9,4,5,9
P'thinaikos,4866,3,1,2,3,4,9,-5,5
Panionios,4866,4,1,1,4,4,10,-6,4
AEK Athens,4867,1,4,2,0,7,1,6,14
PAOK Salonik,4867,2,2,3,1,10,5,5,9
P'thinaikos,4867,3,1,2,3,5,10,-5,5
Panionios,4867,4,1,1,4,4,10,-6,4
AEK Athens,4868,1,4,2,0,7,1,6,14
PAOK Salonik,4868,2,3,2,1,11,5,6,11
P'thinaikos,4868,3,1,1,4,5,11,-6,4
Panionios,4868,4,1,1,4,4,10,-6,4
AEK Athens,4869,1,4,2,0,7,1,6,14
PAOK Salonik,4869,2,2,2,2,9,5,4,8
P'thinaikos,4869,3,2,1,3,5,9,-4,7
Panionios,4869,4,1,1,4,4,10,-6,4
AEK Athens,4870,1,4,2,0,7,1,6,14
PAOK Salonik,4870,2,2,3,1,10,5,5,9
P'thinaikos,4870,3,1,2,3,5,10,-5,5
Panionios,4870,4,1,1,4,4,10,-6,4
AEK Athens,4871,1,4,2,0,7,1,6,14
PAOK Salonik,4871,2,3,2,1,12,4,8,11
Panionios,4871,3,1,1,4,4,10,-6,4
P'thinaikos,4871,4,1,1,4,4,12,-8,4
AEK Athens,4872,1,4,2,0,7,1,6,14
PAOK Salonik,4872,2,2,3,1,10,5,5,9
P'thinaikos,4872,3,1,2,3,5,10,-5,5
Panionios,4872,4,1,1,4,4,10,-6,4
AEK Athens,4873,1,4,2,0,7,1,6,14
PAOK Salonik,4873,2,2,3,1,10,5,5,9
P'thinaikos,4873,3,1,2,3,5,10,-5,5
Panionios,4873,4,1,1,4,4,10,-6,4
AEK Athens,4874,1,4,2,0,7,1,6,14
PAOK Salonik,4874,2,3,2,1,11,5,6,11
P'thinaikos,4874,3,1,1,4,5,11,-6,4
Panionios,4874,4,1,1,4,4,10,-6,4
AEK Athens,4875,1,4,2,0,7,1,6,14
PAOK Salonik,4875,2,2,2,2,10,8,2,8
P'thinaikos,4875,3,2,1,3,8,10,-2,7
Panionios,4875,4,1,1,4,4,10,-6,4
AEK Athens,4876,1,4,2,0,7,1,6,14
PAOK Salonik,4876,2,2,3,1,10,5,5,9
P'thinaikos,4876,3,1,2,3,5,10,-5,5
Panionios,4876,4,1,1,4,4,10,-6,4
AEK Athens,4877,1,4,2,0,7,1,6,14
PAOK Salonik,4877,2,3,2,1,13,6,7,11
Panionios,4877,3,1,1,4,4,10,-6,4
P'thinaikos,4877,4,1,1,4,6,13,-7,4
AEK Athens,4878,1,4,2,0,7,1,6,14
PAOK Salonik,4878,2,2,2,2,9,5,4,8
P'thinaikos,4878,3,2,1,3,5,9,-4,7
Panionios,4878,4,1,1,4,4,10,-6,4
AEK Athens,4879,1,4,2,0,7,1,6,14
PAOK Salonik,4879,2,3,2,1,13,6,7,11
Panionios,4879,3,1,1,4,4,10,-6,4
P'thinaikos,4879,4,1,1,4,6,13,-7,4
AEK Athens,4880,1,4,2,0,7,1,6,14
PAOK Salonik,4880,2,2,2,2,11,7,4,8
P'thinaikos,4880,3,2,1,3,7,11,-4,7
Panionios,4880,4,1,1,4,4,10,-6,4
AEK Athens,4881,1,4,2,0,7,1,6,14
PAOK Salonik,4881,2,3,2,1,10,4,6,11
P'thinaikos,4881,3,1,1,4,4,10,-6,4
Panionios,4881,3,1,1,4,4,10,-6,4
AEK Athens,4882,1,4,2,0,7,1,6,14
PAOK Salonik,4882,2,2,2,2,9,5,4,8
P'thinaikos,4882,3,2,1,3,5,9,-4,7
Panionios,4882,4,1,1,4,4,10,-6,4
AEK Athens,4883,1,4,2,0,7,1,6,14
PAOK Salonik,4883,2,2,2,2,11,7,4,8
P'thinaikos,4883,3,2,1,3,7,11,-4,7
Panionios,4883,4,1,1,4,4,10,-6,4
AEK Athens,4884,1,4,2,0,7,1,6,14
PAOK Salonik,4884,2,3,2,1,10,4,6,11
P'thinaikos,4884,3,1,1,4,4,10,-6,4
Panionios,4884,3,1,1,4,4,10,-6,4
AEK Athens,4885,1,4,2,0,7,1,6,14
PAOK Salonik,4885,2,2,2,2,10,6,4,8
P'thinaikos,4885,3,2,1,3,6,10,-4,7
Panionios,4885,4,1,1,4,4,10,-6,4
AEK Athens,4886,1,4,2,0,7,1,6,14
PAOK Salonik,4886,2,2,3,1,10,5,5,9
P'thinaikos,4886,3,1,2,3,5,10,-5,5
Panionios,4886,4,1,1,4,4,10,-6,4
AEK Athens,4887,1,4,2,0,7,1,6,14
PAOK Salonik,4887,2,2,2,2,9,5,4,8
P'thinaikos,4887,3,2,1,3,5,9,-4,7
Panionios,4887,4,1,1,4,4,10,-6,4
AEK Athens,4888,1,4,2,0,7,1,6,14
PAOK Salonik,4888,2,2,3,1,10,5,5,9
P'thinaikos,4888,3,1,2,3,5,10,-5,5
Panionios,4888,4,1,1,4,4,10,-6,4
AEK Athens,4889,1,4,2,0,7,1,6,14
PAOK Salonik,4889,2,3,2,1,11,5,6,11
P'thinaikos,4889,3,1,1,4,5,11,-6,4
Panionios,4889,4,1,1,4,4,10,-6,4
AEK Athens,4890,1,4,2,0,7,1,6,14
PAOK Salonik,4890,2,3,2,1,11,4,7,11
Panionios,4890,3,1,1,4,4,10,-6,4
P'thinaikos,4890,4,1,1,4,4,11,-7,4
AEK Athens,4891,1,4,2,0,7,1,6,14
PAOK Salonik,4891,2,2,2,2,9,5,4,8
P'thinaikos,4891,3,2,1,3,5,9,-4,7
Panionios,4891,4,1,1,4,4,10,-6,4
AEK Athens,4892,1,4,2,0,7,1,6,14
PAOK Salonik,4892,2,2,2,2,9,6,3,8
P'thinaikos,4892,3,2,1,3,6,9,-3,7
Panionios,4892,4,1,1,4,4,10,-6,4
AEK Athens,4893,1,4,2,0,7,1,6,14
PAOK Salonik,4893,2,2,3,1,9,4,5,9
P'thinaikos,4893,3,1,2,3,4,9,-5,5
Panionios,4893,4,1,1,4,4,10,-6,4
AEK Athens,4894,1,4,2,0,7,1,6,14
PAOK Salonik,4894,2,3,2,1,12,5,7,11
Panionios,4894,3,1,1,4,4,10,-6,4
P'thinaikos,4894,4,1,1,4,5,12,-7,4
AEK Athens,4895,1,4,2,0,7,1,6,14
PAOK Salonik,4895,2,3,2,1,13,5,8,11
Panionios,4895,3,1,1,4,4,10,-6,4
P'thinaikos,4895,4,1,1,4,5,13,-8,4
AEK Athens,4896,1,4,2,0,7,1,6,14
PAOK Salonik,4896,2,2,2,2,9,6,3,8
P'thinaikos,4896,3,2,1,3,6,9,-3,7
Panionios,4896,4,1,1,4,4,10,-6,4
AEK Athens,4897,1,4,2,0,7,1,6,14
PAOK Salonik,4897,2,3,2,1,11,5,6,11
P'thinaikos,4897,3,1,1,4,5,11,-6,4
Panionios,4897,4,1,1,4,4,10,-6,4
AEK Athens,4898,1,4,2,0,7,1,6,14
PAOK Salonik,4898,2,2,2,2,11,7,4,8
P'thinaikos,4898,3,2,1,3,7,11,-4,7
Panionios,4898,4,1,1,4,4,10,-6,4
AEK Athens,4899,1,4,2,0,7,1,6,14
PAOK Salonik,4899,2,3,2,1,12,4,8,11
Panionios,4899,3,1,1,4,4,10,-6,4
P'thinaikos,4899,4,1,1,4,4,12,-8,4
AEK Athens,4900,1,4,2,0,7,1,6,14
PAOK Salonik,4900,2,3,2,1,11,5,6,11
P'thinaikos,4900,3,1,1,4,5,11,-6,4
Panionios,4900,4,1,1,4,4,10,-6,4
AEK Athens,4901,1,4,2,0,7,1,6,14
PAOK Salonik,4901,2,2,3,1,10,5,5,9
P'thinaikos,4901,3,1,2,3,5,10,-5,5
Panionios,4901,4,1,1,4,4,10,-6,4
AEK Athens,4902,1,4,2,0,7,1,6,14
PAOK Salonik,4902,2,3,2,1,13,4,9,11
Panionios,4902,3,1,1,4,4,10,-6,4
P'thinaikos,4902,4,1,1,4,4,13,-9,4
AEK Athens,4903,1,4,2,0,7,1,6,14
PAOK Salonik,4903,2,2,3,1,10,5,5,9
P'thinaikos,4903,3,1,2,3,5,10,-5,5
Panionios,4903,4,1,1,4,4,10,-6,4
AEK Athens,4904,1,4,2,0,7,1,6,14
PAOK Salonik,4904,2,2,2,2,9,5,4,8
P'thinaikos,4904,3,2,1,3,5,9,-4,7
Panionios,4904,4,1,1,4,4,10,-6,4
AEK Athens,4905,1,4,2,0,7,1,6,14
PAOK Salonik,4905,2,2,2,2,10,6,4,8
P'thinaikos,4905,3,2,1,3,6,10,-4,7
Panionios,4905,4,1,1,4,4,10,-6,4
AEK Athens,4906,1,4,2,0,7,1,6,14
PAOK Salonik,4906,2,2,3,1,9,4,5,9
P'thinaikos,4906,3,1,2,3,4,9,-5,5
Panionios,4906,4,1,1,4,4,10,-6,4
AEK Athens,4907,1,4,2,0,7,1,6,14
PAOK Salonik,4907,2,2,3,1,10,5,5,9
P'thinaikos,4907,3,1,2,3,5,10,-5,5
Panionios,4907,4,1,1,4,4,10,-6,4
AEK Athens,4908,1,4,2,0,7,1,6,14
PAOK Salonik,4908,2,2,3,1,10,5,5,9
P'thinaikos,4908,3,1,2,3,5,10,-5,5
Panionios,4908,4,1,1,4,4,10,-6,4
AEK Athens,4909,1,4,2,0,7,1,6,14
PAOK Salonik,4909,2,2,3,1,9,4,5,9
P'thinaikos,4909,3,1,2,3,4,9,-5,5
Panionios,4909,4,1,1,4,4,10,-6,4
AEK Athens,4910,1,4,2,0,7,1,6,14
PAOK Salonik,4910,2,2,2,2,11,8,3,8
P'thinaikos,4910,3,2,1,3,8,11,-3,7
Panionios,4910,4,1,1,4,4,10,-6,4
AEK Athens,4911,1,4,2,0,7,1,6,14
PAOK Salonik,4911,2,2,2,2,10,6,4,8
P'thinaikos,4911,3,2,1,3,6,10,-4,7
Panionios,4911,4,1,1,4,4,10,-6,4
AEK Athens,4912,1,4,2,0,7,1,6,14
PAOK Salonik,4912,2,2,3,1,10,5,5,9
P'thinaikos,4912,3,1,2,3,5,10,-5,5
Panionios,4912,4,1,1,4,4,10,-6,4
AEK Athens,4913,1,4,2,0,7,1,6,14
PAOK Salonik,4913,2,3,2,1,11,4,7,11
Panionios,4913,3,1,1,4,4,10,-6,4
P'thinaikos,4913,4,1,1,4,4,11,-7,4
AEK Athens,4914,1,4,2,0,7,1,6,14
PAOK Salonik,4914,2,3,2,1,10,4,6,11
P'thinaikos,4914,3,1,1,4,4,10,-6,4
Panionios,4914,3,1,1,4,4,10,-6,4
AEK Athens,4915,1,4,2,0,7,1,6,14
PAOK Salonik,4915,2,2,3,1,9,4,5,9
P'thinaikos,4915,3,1,2,3,4,9,-5,5
Panionios,4915,4,1,1,4,4,10,-6,4
AEK Athens,4916,1,4,2,0,7,1,6,14
PAOK Salonik,4916,2,3,2,1,11,5,6,11
P'thinaikos,4916,3,1,1,4,5,11,-6,4
Panionios,4916,4,1,1,4,4,10,-6,4
AEK Athens,4917,1,4,2,0,7,1,6,14
PAOK Salonik,4917,2,2,3,1,10,5,5,9
P'thinaikos,4917,3,1,2,3,5,10,-5,5
Panionios,4917,4,1,1,4,4,10,-6,4
AEK Athens,4918,1,4,2,0,7,1,6,14
PAOK Salonik,4918,2,2,2,2,10,6,4,8
P'thinaikos,4918,3,2,1,3,6,10,-4,7
Panionios,4918,4,1,1,4,4,10,-6,4
AEK Athens,4919,1,4,2,0,7,1,6,14
PAOK Salonik,4919,2,2,3,1,9,4,5,9
P'thinaikos,4919,3,1,2,3,4,9,-5,5
Panionios,4919,4,1,1,4,4,10,-6,4
AEK Athens,4920,1,4,2,0,7,1,6,14
PAOK Salonik,4920,2,2,2,2,9,5,4,8
P'thinaikos,4920,3,2,1,3,5,9,-4,7
Panionios,4920,4,1,1,4,4,10,-6,4
AEK Athens,4921,1,4,2,0,7,1,6,14
PAOK Salonik,4921,2,3,2,1,11,4,7,11
Panionios,4921,3,1,1,4,4,10,-6,4
P'thinaikos,4921,4,1,1,4,4,11,-7,4
AEK Athens,4922,1,4,2,0,7,1,6,14
PAOK Salonik,4922,2,2,3,1,9,4,5,9
P'thinaikos,4922,3,1,2,3,4,9,-5,5
Panionios,4922,4,1,1,4,4,10,-6,4
AEK Athens,4923,1,4,2,0,7,1,6,14
PAOK Salonik,4923,2,2,2,2,9,6,3,8
P'thinaikos,4923,3,2,1,3,6,9,-3,7
Panionios,4923,4,1,1,4,4,10,-6,4
AEK Athens,4924,1,4,2,0,7,1,6,14
PAOK Salonik,4924,2,2,2,2,9,5,4,8
P'thinaikos,4924,3,2,1,3,5,9,-4,7
Panionios,4924,4,1,1,4,4,10,-6,4
AEK Athens,4925,1,4,2,0,7,1,6,14
PAOK Salonik,4925,2,2,2,2,9,5,4,8
P'thinaikos,4925,3,2,1,3,5,9,-4,7
Panionios,4925,4,1,1,4,4,10,-6,4
AEK Athens,4926,1,4,2,0,7,1,6,14
PAOK Salonik,4926,2,2,3,1,9,4,5,9
P'thinaikos,4926,3,1,2,3,4,9,-5,5
Panionios,4926,4,1,1,4,4,10,-6,4
AEK Athens,4927,1,4,2,0,7,1,6,14
PAOK Salonik,4927,2,3,2,1,11,4,7,11
Panionios,4927,3,1,1,4,4,10,-6,4
P'thinaikos,4927,4,1,1,4,4,11,-7,4
AEK Athens,4928,1,4,2,0,7,1,6,14
PAOK Salonik,4928,2,3,2,1,11,4,7,11
Panionios,4928,3,1,1,4,4,10,-6,4
P'thinaikos,4928,4,1,1,4,4,11,-7,4
AEK Athens,4929,1,4,2,0,7,1,6,14
PAOK Salonik,4929,2,3,2,1,14,7,7,11
Panionios,4929,3,1,1,4,4,10,-6,4
P'thinaikos,4929,4,1,1,4,7,14,-7,4
AEK Athens,4930,1,4,2,0,7,1,6,14
PAOK Salonik,4930,2,2,3,1,9,4,5,9
P'thinaikos,4930,3,1,2,3,4,9,-5,5
Panionios,4930,4,1,1,4,4,10,-6,4
AEK Athens,4931,1,4,2,0,7,1,6,14
PAOK Salonik,4931,2,3,2,1,11,5,6,11
P'thinaikos,4931,3,1,1,4,5,11,-6,4
Panionios,4931,4,1,1,4,4,10,-6,4
AEK Athens,4932,1,4,2,0,7,1,6,14
PAOK Salonik,4932,2,2,2,2,10,6,4,8
P'thinaikos,4932,3,2,1,3,6,10,-4,7
Panionios,4932,4,1,1,4,4,10,-6,4
AEK Athens,4933,1,4,2,0,7,1,6,14
PAOK Salonik,4933,2,2,2,2,9,5,4,8
P'thinaikos,4933,3,2,1,3,5,9,-4,7
Panionios,4933,4,1,1,4,4,10,-6,4
AEK Athens,4934,1,4,2,0,7,1,6,14
PAOK Salonik,4934,2,2,2,2,10,6,4,8
P'thinaikos,4934,3,2,1,3,6,10,-4,7
Panionios,4934,4,1,1,4,4,10,-6,4
AEK Athens,4935,1,4,2,0,7,1,6,14
PAOK Salonik,4935,2,2,2,2,10,7,3,8
P'thinaikos,4935,3,2,1,3,7,10,-3,7
Panionios,4935,4,1,1,4,4,10,-6,4
AEK Athens,4936,1,4,2,0,7,1,6,14
PAOK Salonik,4936,2,2,2,2,10,7,3,8
P'thinaikos,4936,3,2,1,3,7,10,-3,7
Panionios,4936,4,1,1,4,4,10,-6,4
AEK Athens,4937,1,4,2,0,7,1,6,14
PAOK Salonik,4937,2,2,2,2,9,6,3,8
P'thinaikos,4937,3,2,1,3,6,9,-3,7
Panionios,4937,4,1,1,4,4,10,-6,4
AEK Athens,4938,1,4,2,0,7,1,6,14
PAOK Salonik,4938,2,2,3,1,11,6,5,9
P'thinaikos,4938,3,1,2,3,6,11,-5,5
Panionios,4938,4,1,1,4,4,10,-6,4
AEK Athens,4939,1,4,2,0,7,1,6,14
PAOK Salonik,4939,2,2,2,2,9,5,4,8
P'thinaikos,4939,3,2,1,3,5,9,-4,7
Panionios,4939,4,1,1,4,4,10,-6,4
AEK Athens,4940,1,4,2,0,7,1,6,14
PAOK Salonik,4940,2,2,2,2,9,5,4,8
P'thinaikos,4940,3,2,1,3,5,9,-4,7
Panionios,4940,4,1,1,4,4,10,-6,4
AEK Athens,4941,1,4,2,0,7,1,6,14
PAOK Salonik,4941,2,2,2,2,9,5,4,8
P'thinaikos,4941,3,2,1,3,5,9,-4,7
Panionios,4941,4,1,1,4,4,10,-6,4
AEK Athens,4942,1,4,2,0,7,1,6,14
PAOK Salonik,4942,2,2,2,2,9,5,4,8
P'thinaikos,4942,3,2,1,3,5,9,-4,7
Panionios,4942,4,1,1,4,4,10,-6,4
AEK Athens,4943,1,4,2,0,7,1,6,14
PAOK Salonik,4943,2,3,2,1,12,5,7,11
Panionios,4943,3,1,1,4,4,10,-6,4
P'thinaikos,4943,4,1,1,4,5,12,-7,4
AEK Athens,4944,1,4,2,0,7,1,6,14
PAOK Salonik,4944,2,2,2,2,10,6,4,8
P'thinaikos,4944,3,2,1,3,6,10,-4,7
Panionios,4944,4,1,1,4,4,10,-6,4
AEK Athens,4945,1,4,2,0,7,1,6,14
PAOK Salonik,4945,2,2,2,2,9,5,4,8
P'thinaikos,4945,3,2,1,3,5,9,-4,7
Panionios,4945,4,1,1,4,4,10,-6,4
AEK Athens,4946,1,4,2,0,7,1,6,14
PAOK Salonik,4946,2,2,2,2,9,6,3,8
P'thinaikos,4946,3,2,1,3,6,9,-3,7
Panionios,4946,4,1,1,4,4,10,-6,4
AEK Athens,4947,1,4,2,0,7,1,6,14
PAOK Salonik,4947,2,3,2,1,13,4,9,11
Panionios,4947,3,1,1,4,4,10,-6,4
P'thinaikos,4947,4,1,1,4,4,13,-9,4
AEK Athens,4948,1,4,2,0,7,1,6,14
PAOK Salonik,4948,2,3,2,1,11,5,6,11
P'thinaikos,4948,3,1,1,4,5,11,-6,4
Panionios,4948,4,1,1,4,4,10,-6,4
AEK Athens,4949,1,4,2,0,7,1,6,14
PAOK Salonik,4949,2,2,3,1,10,5,5,9
P'thinaikos,4949,3,1,2,3,5,10,-5,5
Panionios,4949,4,1,1,4,4,10,-6,4
AEK Athens,4950,1,4,2,0,7,1,6,14
PAOK Salonik,4950,2,2,3,1,10,5,5,9
P'thinaikos,4950,3,1,2,3,5,10,-5,5
Panionios,4950,4,1,1,4,4,10,-6,4
AEK Athens,4951,1,4,2,0,7,1,6,14
PAOK Salonik,4951,2,3,2,1,11,4,7,11
Panionios,4951,3,1,1,4,4,10,-6,4
P'thinaikos,4951,4,1,1,4,4,11,-7,4
AEK Athens,4952,1,4,2,0,7,1,6,14
PAOK Salonik,4952,2,2,2,2,10,6,4,8
P'thinaikos,4952,3,2,1,3,6,10,-4,7
Panionios,4952,4,1,1,4,4,10,-6,4
AEK Athens,4953,1,4,2,0,7,1,6,14
PAOK Salonik,4953,2,3,2,1,10,4,6,11
P'thinaikos,4953,3,1,1,4,4,10,-6,4
Panionios,4953,3,1,1,4,4,10,-6,4
AEK Athens,4954,1,4,2,0,7,1,6,14
PAOK Salonik,4954,2,2,2,2,10,6,4,8
P'thinaikos,4954,3,2,1,3,6,10,-4,7
Panionios,4954,4,1,1,4,4,10,-6,4
AEK Athens,4955,1,4,2,0,7,1,6,14
PAOK Salonik,4955,2,2,2,2,9,6,3,8
P'thinaikos,4955,3,2,1,3,6,9,-3,7
Panionios,4955,4,1,1,4,4,10,-6,4
AEK Athens,4956,1,4,2,0,7,1,6,14
PAOK Salonik,4956,2,3,2,1,11,5,6,11
P'thinaikos,4956,3,1,1,4,5,11,-6,4
Panionios,4956,4,1,1,4,4,10,-6,4
AEK Athens,4957,1,4,2,0,7,1,6,14
PAOK Salonik,4957,2,2,3,1,10,5,5,9
P'thinaikos,4957,3,1,2,3,5,10,-5,5
Panionios,4957,4,1,1,4,4,10,-6,4
AEK Athens,4958,1,4,2,0,7,1,6,14
PAOK Salonik,4958,2,2,2,2,9,5,4,8
P'thinaikos,4958,3,2,1,3,5,9,-4,7
Panionios,4958,4,1,1,4,4,10,-6,4
AEK Athens,4959,1,4,2,0,7,1,6,14
PAOK Salonik,4959,2,3,2,1,12,4,8,11
Panionios,4959,3,1,1,4,4,10,-6,4
P'thinaikos,4959,4,1,1,4,4,12,-8,4
AEK Athens,4960,1,4,2,0,7,1,6,14
PAOK Salonik,4960,2,2,3,1,10,5,5,9
P'thinaikos,4960,3,1,2,3,5,10,-5,5
Panionios,4960,4,1,1,4,4,10,-6,4
AEK Athens,4961,1,4,2,0,7,1,6,14
PAOK Salonik,4961,2,2,3,1,10,5,5,9
P'thinaikos,4961,3,1,2,3,5,10,-5,5
Panionios,4961,4,1,1,4,4,10,-6,4
AEK Athens,4962,1,4,2,0,7,1,6,14
PAOK Salonik,4962,2,2,2,2,9,6,3,8
P'thinaikos,4962,3,2,1,3,6,9,-3,7
Panionios,4962,4,1,1,4,4,10,-6,4
AEK Athens,4963,1,4,2,0,7,1,6,14
PAOK Salonik,4963,2,3,2,1,10,4,6,11
P'thinaikos,4963,3,1,1,4,4,10,-6,4
Panionios,4963,3,1,1,4,4,10,-6,4
AEK Athens,4964,1,4,2,0,7,1,6,14
PAOK Salonik,4964,2,2,2,2,11,7,4,8
P'thinaikos,4964,3,2,1,3,7,11,-4,7
Panionios,4964,4,1,1,4,4,10,-6,4
AEK Athens,4965,1,4,2,0,7,1,6,14
PAOK Salonik,4965,2,3,2,1,11,5,6,11
P'thinaikos,4965,3,1,1,4,5,11,-6,4
Panionios,4965,4,1,1,4,4,10,-6,4
AEK Athens,4966,1,4,2,0,7,1,6,14
PAOK Salonik,4966,2,3,2,1,12,4,8,11
Panionios,4966,3,1,1,4,4,10,-6,4
P'thinaikos,4966,4,1,1,4,4,12,-8,4
AEK Athens,4967,1,4,2,0,7,1,6,14
PAOK Salonik,4967,2,2,3,1,10,5,5,9
P'thinaikos,4967,3,1,2,3,5,10,-5,5
Panionios,4967,4,1,1,4,4,10,-6,4
AEK Athens,4968,1,4,2,0,7,1,6,14
PAOK Salonik,4968,2,2,2,2,9,5,4,8
P'thinaikos,4968,3,2,1,3,5,9,-4,7
Panionios,4968,4,1,1,4,4,10,-6,4
AEK Athens,4969,1,4,2,0,7,1,6,14
PAOK Salonik,4969,2,2,2,2,9,6,3,8
P'thinaikos,4969,3,2,1,3,6,9,-3,7
Panionios,4969,4,1,1,4,4,10,-6,4
AEK Athens,4970,1,4,2,0,7,1,6,14
PAOK Salonik,4970,2,2,3,1,11,6,5,9
P'thinaikos,4970,3,1,2,3,6,11,-5,5
Panionios,4970,4,1,1,4,4,10,-6,4
AEK Athens,4971,1,4,2,0,7,1,6,14
PAOK Salonik,4971,2,3,2,1,10,4,6,11
P'thinaikos,4971,3,1,1,4,4,10,-6,4
Panionios,4971,3,1,1,4,4,10,-6,4
AEK Athens,4972,1,4,2,0,7,1,6,14
PAOK Salonik,4972,2,2,3,1,9,4,5,9
P'thinaikos,4972,3,1,2,3,4,9,-5,5
Panionios,4972,4,1,1,4,4,10,-6,4
AEK Athens,4973,1,4,2,0,7,1,6,14
PAOK Salonik,4973,2,3,2,1,11,4,7,11
Panionios,4973,3,1,1,4,4,10,-6,4
P'thinaikos,4973,4,1,1,4,4,11,-7,4
AEK Athens,4974,1,4,2,0,7,1,6,14
PAOK Salonik,4974,2,2,2,2,9,7,2,8
P'thinaikos,4974,3,2,1,3,7,9,-2,7
Panionios,4974,4,1,1,4,4,10,-6,4
AEK Athens,4975,1,4,2,0,7,1,6,14
PAOK Salonik,4975,2,3,2,1,11,5,6,11
P'thinaikos,4975,3,1,1,4,5,11,-6,4
Panionios,4975,4,1,1,4,4,10,-6,4
AEK Athens,4976,1,4,2,0,7,1,6,14
PAOK Salonik,4976,2,3,2,1,11,5,6,11
P'thinaikos,4976,3,1,1,4,5,11,-6,4
Panionios,4976,4,1,1,4,4,10,-6,4
AEK Athens,4977,1,4,2,0,7,1,6,14
PAOK Salonik,4977,2,3,2,1,10,4,6,11
P'thinaikos,4977,3,1,1,4,4,10,-6,4
Panionios,4977,3,1,1,4,4,10,-6,4
AEK Athens,4978,1,4,2,0,7,1,6,14
PAOK Salonik,4978,2,2,2,2,10,6,4,8
P'thinaikos,4978,3,2,1,3,6,10,-4,7
Panionios,4978,4,1,1,4,4,10,-6,4
AEK Athens,4979,1,4,2,0,7,1,6,14
PAOK Salonik,4979,2,2,2,2,11,8,3,8
P'thinaikos,4979,3,2,1,3,8,11,-3,7
Panionios,4979,4,1,1,4,4,10,-6,4
AEK Athens,4980,1,4,2,0,7,1,6,14
PAOK Salonik,4980,2,2,3,1,10,5,5,9
P'thinaikos,4980,3,1,2,3,5,10,-5,5
Panionios,4980,4,1,1,4,4,10,-6,4
AEK Athens,4981,1,4,2,0,7,1,6,14
PAOK Salonik,4981,2,2,2,2,9,5,4,8
P'thinaikos,4981,3,2,1,3,5,9,-4,7
Panionios,4981,4,1,1,4,4,10,-6,4
AEK Athens,4982,1,4,2,0,7,1,6,14
PAOK Salonik,4982,2,2,3,1,10,5,5,9
P'thinaikos,4982,3,1,2,3,5,10,-5,5
Panionios,4982,4,1,1,4,4,10,-6,4
AEK Athens,4983,1,4,2,0,7,1,6,14
PAOK Salonik,4983,2,2,3,1,12,7,5,9
P'thinaikos,4983,3,1,2,3,7,12,-5,5
Panionios,4983,4,1,1,4,4,10,-6,4
AEK Athens,4984,1,4,2,0,7,1,6,14
PAOK Salonik,4984,2,3,2,1,10,4,6,11
P'thinaikos,4984,3,1,1,4,4,10,-6,4
Panionios,4984,3,1,1,4,4,10,-6,4
AEK Athens,4985,1,4,2,0,7,1,6,14
PAOK Salonik,4985,2,2,2,2,10,6,4,8
P'thinaikos,4985,3,2,1,3,6,10,-4,7
Panionios,4985,4,1,1,4,4,10,-6,4
AEK Athens,4986,1,4,2,0,7,1,6,14
PAOK Salonik,4986,2,2,3,1,10,5,5,9
P'thinaikos,4986,3,1,2,3,5,10,-5,5
Panionios,4986,4,1,1,4,4,10,-6,4
AEK Athens,4987,1,4,2,0,7,1,6,14
PAOK Salonik,4987,2,2,3,1,11,6,5,9
P'thinaikos,4987,3,1,2,3,6,11,-5,5
Panionios,4987,4,1,1,4,4,10,-6,4
AEK Athens,4988,1,4,2,0,7,1,6,14
PAOK Salonik,4988,2,3,2,1,10,4,6,11
P'thinaikos,4988,3,1,1,4,4,10,-6,4
Panionios,4988,3,1,1,4,4,10,-6,4
AEK Athens,4989,1,4,2,0,7,1,6,14
PAOK Salonik,4989,2,3,2,1,13,4,9,11
Panionios,4989,3,1,1,4,4,10,-6,4
P'thinaikos,4989,4,1,1,4,4,13,-9,4
AEK Athens,4990,1,4,2,0,7,1,6,14
PAOK Salonik,4990,2,3,2,1,12,4,8,11
Panionios,4990,3,1,1,4,4,10,-6,4
P'thinaikos,4990,4,1,1,4,4,12,-8,4
AEK Athens,4991,1,4,2,0,7,1,6,14
PAOK Salonik,4991,2,2,3,1,11,6,5,9
P'thinaikos,4991,3,1,2,3,6,11,-5,5
Panionios,4991,4,1,1,4,4,10,-6,4
AEK Athens,4992,1,4,2,0,7,1,6,14
PAOK Salonik,4992,2,2,2,2,10,6,4,8
P'thinaikos,4992,3,2,1,3,6,10,-4,7
Panionios,4992,4,1,1,4,4,10,-6,4
AEK Athens,4993,1,4,2,0,7,1,6,14
PAOK Salonik,4993,2,2,2,2,9,6,3,8
P'thinaikos,4993,3,2,1,3,6,9,-3,7
Panionios,4993,4,1,1,4,4,10,-6,4
AEK Athens,4994,1,4,2,0,7,1,6,14
PAOK Salonik,4994,2,2,2,2,10,6,4,8
P'thinaikos,4994,3,2,1,3,6,10,-4,7
Panionios,4994,4,1,1,4,4,10,-6,4
AEK Athens,4995,1,4,2,0,7,1,6,14
PAOK Salonik,4995,2,3,2,1,11,5,6,11
P'thinaikos,4995,3,1,1,4,5,11,-6,4
Panionios,4995,4,1,1,4,4,10,-6,4
AEK Athens,4996,1,4,2,0,7,1,6,14
PAOK Salonik,4996,2,2,3,1,10,5,5,9
P'thinaikos,4996,3,1,2,3,5,10,-5,5
Panionios,4996,4,1,1,4,4,10,-6,4
AEK Athens,4997,1,4,2,0,7,1,6,14
PAOK Salonik,4997,2,2,2,2,10,8,2,8
P'thinaikos,4997,3,2,1,3,8,10,-2,7
Panionios,4997,4,1,1,4,4,10,-6,4
AEK Athens,4998,1,4,2,0,7,1,6,14
PAOK Salonik,4998,2,2,2,2,13,10,3,8
P'thinaikos,4998,3,2,1,3,10,13,-3,7
Panionios,4998,4,1,1,4,4,10,-6,4
AEK Athens,4999,1,4,2,0,7,1,6,14
PAOK Salonik,4999,2,2,2,2,10,9,1,8
P'thinaikos,4999,3,2,1,3,9,10,-1,7
Panionios,4999,4,1,1,4,4,10,-6,4
AEK Athens,5000,1,4,2,0,7,1,6,14
PAOK Salonik,5000,2,2,2,2,9,6,3,8
P'thinaikos,5000,3,2,1,3,6,9,-3,7
Panionios,5000,4,1,1,4,4,10,-6,4
AEK Athens,5001,1,4,2,0,7,1,6,14
PAOK Salonik,5001,2,2,2,2,9,5,4,8
P'thinaikos,5001,3,2,1,3,5,9,-4,7
Panionios,5001,4,1,1,4,4,10,-6,4
AEK Athens,5002,1,4,2,0,7,1,6,14
PAOK Salonik,5002,2,2,3,1,10,5,5,9
P'thinaikos,5002,3,1,2,3,5,10,-5,5
Panionios,5002,4,1,1,4,4,10,-6,4
AEK Athens,5003,1,4,2,0,7,1,6,14
PAOK Salonik,5003,2,3,2,1,11,4,7,11
Panionios,5003,3,1,1,4,4,10,-6,4
P'thinaikos,5003,4,1,1,4,4,11,-7,4
AEK Athens,5004,1,4,2,0,7,1,6,14
PAOK Salonik,5004,2,3,2,1,13,6,7,11
Panionios,5004,3,1,1,4,4,10,-6,4
P'thinaikos,5004,4,1,1,4,6,13,-7,4
AEK Athens,5005,1,4,2,0,7,1,6,14
PAOK Salonik,5005,2,2,2,2,10,6,4,8
P'thinaikos,5005,3,2,1,3,6,10,-4,7
Panionios,5005,4,1,1,4,4,10,-6,4
AEK Athens,5006,1,4,2,0,7,1,6,14
PAOK Salonik,5006,2,3,2,1,11,5,6,11
P'thinaikos,5006,3,1,1,4,5,11,-6,4
Panionios,5006,4,1,1,4,4,10,-6,4
AEK Athens,5007,1,4,2,0,7,1,6,14
PAOK Salonik,5007,2,2,2,2,9,5,4,8
P'thinaikos,5007,3,2,1,3,5,9,-4,7
Panionios,5007,4,1,1,4,4,10,-6,4
AEK Athens,5008,1,4,2,0,7,1,6,14
PAOK Salonik,5008,2,2,3,1,11,6,5,9
P'thinaikos,5008,3,1,2,3,6,11,-5,5
Panionios,5008,4,1,1,4,4,10,-6,4
AEK Athens,5009,1,4,2,0,7,1,6,14
PAOK Salonik,5009,2,2,2,2,9,5,4,8
P'thinaikos,5009,3,2,1,3,5,9,-4,7
Panionios,5009,4,1,1,4,4,10,-6,4
AEK Athens,5010,1,4,2,0,7,1,6,14
PAOK Salonik,5010,2,2,3,1,12,7,5,9
P'thinaikos,5010,3,1,2,3,7,12,-5,5
Panionios,5010,4,1,1,4,4,10,-6,4
AEK Athens,5011,1,4,2,0,7,1,6,14
PAOK Salonik,5011,2,2,2,2,9,5,4,8
P'thinaikos,5011,3,2,1,3,5,9,-4,7
Panionios,5011,4,1,1,4,4,10,-6,4
AEK Athens,5012,1,4,2,0,7,1,6,14
PAOK Salonik,5012,2,2,2,2,9,7,2,8
P'thinaikos,5012,3,2,1,3,7,9,-2,7
Panionios,5012,4,1,1,4,4,10,-6,4
AEK Athens,5013,1,4,2,0,7,1,6,14
PAOK Salonik,5013,2,2,3,1,10,5,5,9
P'thinaikos,5013,3,1,2,3,5,10,-5,5
Panionios,5013,4,1,1,4,4,10,-6,4
AEK Athens,5014,1,4,2,0,7,1,6,14
PAOK Salonik,5014,2,2,2,2,11,8,3,8
P'thinaikos,5014,3,2,1,3,8,11,-3,7
Panionios,5014,4,1,1,4,4,10,-6,4
AEK Athens,5015,1,4,2,0,7,1,6,14
PAOK Salonik,5015,2,2,2,2,9,5,4,8
P'thinaikos,5015,3,2,1,3,5,9,-4,7
Panionios,5015,4,1,1,4,4,10,-6,4
AEK Athens,5016,1,4,2,0,7,1,6,14
PAOK Salonik,5016,2,2,3,1,9,4,5,9
P'thinaikos,5016,3,1,2,3,4,9,-5,5
Panionios,5016,4,1,1,4,4,10,-6,4
AEK Athens,5017,1,4,2,0,7,1,6,14
PAOK Salonik,5017,2,2,3,1,9,4,5,9
P'thinaikos,5017,3,1,2,3,4,9,-5,5
Panionios,5017,4,1,1,4,4,10,-6,4
AEK Athens,5018,1,4,2,0,7,1,6,14
PAOK Salonik,5018,2,2,3,1,11,6,5,9
P'thinaikos,5018,3,1,2,3,6,11,-5,5
Panionios,5018,4,1,1,4,4,10,-6,4
AEK Athens,5019,1,4,2,0,7,1,6,14
PAOK Salonik,5019,2,2,2,2,9,5,4,8
P'thinaikos,5019,3,2,1,3,5,9,-4,7
Panionios,5019,4,1,1,4,4,10,-6,4
AEK Athens,5020,1,4,2,0,7,1,6,14
PAOK Salonik,5020,2,3,2,1,10,4,6,11
P'thinaikos,5020,3,1,1,4,4,10,-6,4
Panionios,5020,3,1,1,4,4,10,-6,4
AEK Athens,5021,1,4,2,0,7,1,6,14
PAOK Salonik,5021,2,3,2,1,11,4,7,11
Panionios,5021,3,1,1,4,4,10,-6,4
P'thinaikos,5021,4,1,1,4,4,11,-7,4
AEK Athens,5022,1,4,2,0,7,1,6,14
PAOK Salonik,5022,2,2,2,2,9,5,4,8
P'thinaikos,5022,3,2,1,3,5,9,-4,7
Panionios,5022,4,1,1,4,4,10,-6,4
AEK Athens,5023,1,4,2,0,7,1,6,14
PAOK Salonik,5023,2,3,2,1,11,4,7,11
Panionios,5023,3,1,1,4,4,10,-6,4
P'thinaikos,5023,4,1,1,4,4,11,-7,4
AEK Athens,5024,1,4,2,0,7,1,6,14
PAOK Salonik,5024,2,2,3,1,9,4,5,9
P'thinaikos,5024,3,1,2,3,4,9,-5,5
Panionios,5024,4,1,1,4,4,10,-6,4
AEK Athens,5025,1,4,2,0,7,1,6,14
PAOK Salonik,5025,2,2,2,2,10,6,4,8
P'thinaikos,5025,3,2,1,3,6,10,-4,7
Panionios,5025,4,1,1,4,4,10,-6,4
AEK Athens,5026,1,4,2,0,7,1,6,14
PAOK Salonik,5026,2,2,3,1,9,4,5,9
P'thinaikos,5026,3,1,2,3,4,9,-5,5
Panionios,5026,4,1,1,4,4,10,-6,4
AEK Athens,5027,1,4,2,0,7,1,6,14
PAOK Salonik,5027,2,3,2,1,11,5,6,11
P'thinaikos,5027,3,1,1,4,5,11,-6,4
Panionios,5027,4,1,1,4,4,10,-6,4
AEK Athens,5028,1,4,2,0,7,1,6,14
PAOK Salonik,5028,2,3,2,1,13,5,8,11
Panionios,5028,3,1,1,4,4,10,-6,4
P'thinaikos,5028,4,1,1,4,5,13,-8,4
AEK Athens,5029,1,4,2,0,7,1,6,14
PAOK Salonik,5029,2,2,2,2,11,8,3,8
P'thinaikos,5029,3,2,1,3,8,11,-3,7
Panionios,5029,4,1,1,4,4,10,-6,4
AEK Athens,5030,1,4,2,0,7,1,6,14
PAOK Salonik,5030,2,2,2,2,9,5,4,8
P'thinaikos,5030,3,2,1,3,5,9,-4,7
Panionios,5030,4,1,1,4,4,10,-6,4
AEK Athens,5031,1,4,2,0,7,1,6,14
PAOK Salonik,5031,2,2,3,1,10,5,5,9
P'thinaikos,5031,3,1,2,3,5,10,-5,5
Panionios,5031,4,1,1,4,4,10,-6,4
AEK Athens,5032,1,4,2,0,7,1,6,14
PAOK Salonik,5032,2,2,2,2,9,5,4,8
P'thinaikos,5032,3,2,1,3,5,9,-4,7
Panionios,5032,4,1,1,4,4,10,-6,4
AEK Athens,5033,1,4,2,0,7,1,6,14
PAOK Salonik,5033,2,3,2,1,12,5,7,11
Panionios,5033,3,1,1,4,4,10,-6,4
P'thinaikos,5033,4,1,1,4,5,12,-7,4
AEK Athens,5034,1,4,2,0,7,1,6,14
PAOK Salonik,5034,2,2,3,1,11,6,5,9
P'thinaikos,5034,3,1,2,3,6,11,-5,5
Panionios,5034,4,1,1,4,4,10,-6,4
AEK Athens,5035,1,4,2,0,7,1,6,14
PAOK Salonik,5035,2,2,2,2,9,5,4,8
P'thinaikos,5035,3,2,1,3,5,9,-4,7
Panionios,5035,4,1,1,4,4,10,-6,4
AEK Athens,5036,1,4,2,0,7,1,6,14
PAOK Salonik,5036,2,2,2,2,9,6,3,8
P'thinaikos,5036,3,2,1,3,6,9,-3,7
Panionios,5036,4,1,1,4,4,10,-6,4
AEK Athens,5037,1,4,2,0,7,1,6,14
PAOK Salonik,5037,2,2,3,1,11,6,5,9
P'thinaikos,5037,3,1,2,3,6,11,-5,5
Panionios,5037,4,1,1,4,4,10,-6,4
AEK Athens,5038,1,4,2,0,7,1,6,14
PAOK Salonik,5038,2,2,2,2,9,6,3,8
P'thinaikos,5038,3,2,1,3,6,9,-3,7
Panionios,5038,4,1,1,4,4,10,-6,4
AEK Athens,5039,1,4,2,0,7,1,6,14
PAOK Salonik,5039,2,2,2,2,10,6,4,8
P'thinaikos,5039,3,2,1,3,6,10,-4,7
Panionios,5039,4,1,1,4,4,10,-6,4
AEK Athens,5040,1,4,2,0,7,1,6,14
PAOK Salonik,5040,2,2,3,1,10,5,5,9
P'thinaikos,5040,3,1,2,3,5,10,-5,5
Panionios,5040,4,1,1,4,4,10,-6,4
AEK Athens,5041,1,4,2,0,7,1,6,14
PAOK Salonik,5041,2,2,2,2,10,7,3,8
P'thinaikos,5041,3,2,1,3,7,10,-3,7
Panionios,5041,4,1,1,4,4,10,-6,4
AEK Athens,5042,1,4,2,0,7,1,6,14
PAOK Salonik,5042,2,2,2,2,9,5,4,8
P'thinaikos,5042,3,2,1,3,5,9,-4,7
Panionios,5042,4,1,1,4,4,10,-6,4
AEK Athens,5043,1,4,2,0,7,1,6,14
PAOK Salonik,5043,2,2,2,2,9,6,3,8
P'thinaikos,5043,3,2,1,3,6,9,-3,7
Panionios,5043,4,1,1,4,4,10,-6,4
AEK Athens,5044,1,4,2,0,7,1,6,14
PAOK Salonik,5044,2,3,2,1,11,5,6,11
P'thinaikos,5044,3,1,1,4,5,11,-6,4
Panionios,5044,4,1,1,4,4,10,-6,4
AEK Athens,5045,1,4,2,0,7,1,6,14
PAOK Salonik,5045,2,2,2,2,9,5,4,8
P'thinaikos,5045,3,2,1,3,5,9,-4,7
Panionios,5045,4,1,1,4,4,10,-6,4
AEK Athens,5046,1,4,2,0,7,1,6,14
PAOK Salonik,5046,2,3,2,1,12,6,6,11
P'thinaikos,5046,3,1,1,4,6,12,-6,4
Panionios,5046,4,1,1,4,4,10,-6,4
AEK Athens,5047,1,4,2,0,7,1,6,14
PAOK Salonik,5047,2,2,2,2,11,7,4,8
P'thinaikos,5047,3,2,1,3,7,11,-4,7
Panionios,5047,4,1,1,4,4,10,-6,4
AEK Athens,5048,1,4,2,0,7,1,6,14
PAOK Salonik,5048,2,2,2,2,9,6,3,8
P'thinaikos,5048,3,2,1,3,6,9,-3,7
Panionios,5048,4,1,1,4,4,10,-6,4
AEK Athens,5049,1,4,2,0,7,1,6,14
PAOK Salonik,5049,2,3,2,1,11,4,7,11
Panionios,5049,3,1,1,4,4,10,-6,4
P'thinaikos,5049,4,1,1,4,4,11,-7,4
AEK Athens,5050,1,4,2,0,7,1,6,14
PAOK Salonik,5050,2,2,3,1,10,5,5,9
P'thinaikos,5050,3,1,2,3,5,10,-5,5
Panionios,5050,4,1,1,4,4,10,-6,4
AEK Athens,5051,1,4,2,0,7,1,6,14
PAOK Salonik,5051,2,3,2,1,10,4,6,11
P'thinaikos,5051,3,1,1,4,4,10,-6,4
Panionios,5051,3,1,1,4,4,10,-6,4
AEK Athens,5052,1,4,2,0,7,1,6,14
PAOK Salonik,5052,2,3,2,1,10,4,6,11
P'thinaikos,5052,3,1,1,4,4,10,-6,4
Panionios,5052,3,1,1,4,4,10,-6,4
AEK Athens,5053,1,4,2,0,7,1,6,14
PAOK Salonik,5053,2,2,3,1,10,5,5,9
P'thinaikos,5053,3,1,2,3,5,10,-5,5
Panionios,5053,4,1,1,4,4,10,-6,4
AEK Athens,5054,1,4,2,0,7,1,6,14
PAOK Salonik,5054,2,2,2,2,9,5,4,8
P'thinaikos,5054,3,2,1,3,5,9,-4,7
Panionios,5054,4,1,1,4,4,10,-6,4
AEK Athens,5055,1,4,2,0,7,1,6,14
PAOK Salonik,5055,2,3,2,1,12,5,7,11
Panionios,5055,3,1,1,4,4,10,-6,4
P'thinaikos,5055,4,1,1,4,5,12,-7,4
AEK Athens,5056,1,4,2,0,7,1,6,14
PAOK Salonik,5056,2,2,3,1,9,4,5,9
P'thinaikos,5056,3,1,2,3,4,9,-5,5
Panionios,5056,4,1,1,4,4,10,-6,4
AEK Athens,5057,1,4,2,0,7,1,6,14
PAOK Salonik,5057,2,2,3,1,9,4,5,9
P'thinaikos,5057,3,1,2,3,4,9,-5,5
Panionios,5057,4,1,1,4,4,10,-6,4
AEK Athens,5058,1,4,2,0,7,1,6,14
PAOK Salonik,5058,2,3,2,1,12,5,7,11
Panionios,5058,3,1,1,4,4,10,-6,4
P'thinaikos,5058,4,1,1,4,5,12,-7,4
AEK Athens,5059,1,4,2,0,7,1,6,14
PAOK Salonik,5059,2,2,2,2,9,5,4,8
P'thinaikos,5059,3,2,1,3,5,9,-4,7
Panionios,5059,4,1,1,4,4,10,-6,4
AEK Athens,5060,1,4,2,0,7,1,6,14
PAOK Salonik,5060,2,2,2,2,9,6,3,8
P'thinaikos,5060,3,2,1,3,6,9,-3,7
Panionios,5060,4,1,1,4,4,10,-6,4
AEK Athens,5061,1,4,2,0,7,1,6,14
PAOK Salonik,5061,2,2,2,2,9,5,4,8
P'thinaikos,5061,3,2,1,3,5,9,-4,7
Panionios,5061,4,1,1,4,4,10,-6,4
AEK Athens,5062,1,4,2,0,7,1,6,14
PAOK Salonik,5062,2,3,2,1,11,5,6,11
P'thinaikos,5062,3,1,1,4,5,11,-6,4
Panionios,5062,4,1,1,4,4,10,-6,4
AEK Athens,5063,1,4,2,0,7,1,6,14
PAOK Salonik,5063,2,3,2,1,10,4,6,11
P'thinaikos,5063,3,1,1,4,4,10,-6,4
Panionios,5063,3,1,1,4,4,10,-6,4
AEK Athens,5064,1,4,2,0,7,1,6,14
PAOK Salonik,5064,2,3,2,1,11,4,7,11
Panionios,5064,3,1,1,4,4,10,-6,4
P'thinaikos,5064,4,1,1,4,4,11,-7,4
AEK Athens,5065,1,4,2,0,7,1,6,14
PAOK Salonik,5065,2,3,2,1,12,6,6,11
P'thinaikos,5065,3,1,1,4,6,12,-6,4
Panionios,5065,4,1,1,4,4,10,-6,4
AEK Athens,5066,1,4,2,0,7,1,6,14
PAOK Salonik,5066,2,2,2,2,10,6,4,8
P'thinaikos,5066,3,2,1,3,6,10,-4,7
Panionios,5066,4,1,1,4,4,10,-6,4
AEK Athens,5067,1,4,2,0,7,1,6,14
PAOK Salonik,5067,2,2,2,2,10,7,3,8
P'thinaikos,5067,3,2,1,3,7,10,-3,7
Panionios,5067,4,1,1,4,4,10,-6,4
AEK Athens,5068,1,4,2,0,7,1,6,14
PAOK Salonik,5068,2,2,3,1,10,5,5,9
P'thinaikos,5068,3,1,2,3,5,10,-5,5
Panionios,5068,4,1,1,4,4,10,-6,4
AEK Athens,5069,1,4,2,0,7,1,6,14
PAOK Salonik,5069,2,2,2,2,9,5,4,8
P'thinaikos,5069,3,2,1,3,5,9,-4,7
Panionios,5069,4,1,1,4,4,10,-6,4
AEK Athens,5070,1,4,2,0,7,1,6,14
PAOK Salonik,5070,2,2,3,1,9,4,5,9
P'thinaikos,5070,3,1,2,3,4,9,-5,5
Panionios,5070,4,1,1,4,4,10,-6,4
AEK Athens,5071,1,4,2,0,7,1,6,14
PAOK Salonik,5071,2,2,2,2,9,6,3,8
P'thinaikos,5071,3,2,1,3,6,9,-3,7
Panionios,5071,4,1,1,4,4,10,-6,4
AEK Athens,5072,1,4,2,0,7,1,6,14
PAOK Salonik,5072,2,3,2,1,11,4,7,11
Panionios,5072,3,1,1,4,4,10,-6,4
P'thinaikos,5072,4,1,1,4,4,11,-7,4
AEK Athens,5073,1,4,2,0,7,1,6,14
PAOK Salonik,5073,2,2,2,2,10,7,3,8
P'thinaikos,5073,3,2,1,3,7,10,-3,7
Panionios,5073,4,1,1,4,4,10,-6,4
AEK Athens,5074,1,4,2,0,7,1,6,14
PAOK Salonik,5074,2,2,2,2,11,8,3,8
P'thinaikos,5074,3,2,1,3,8,11,-3,7
Panionios,5074,4,1,1,4,4,10,-6,4
AEK Athens,5075,1,4,2,0,7,1,6,14
PAOK Salonik,5075,2,2,2,2,11,7,4,8
P'thinaikos,5075,3,2,1,3,7,11,-4,7
Panionios,5075,4,1,1,4,4,10,-6,4
AEK Athens,5076,1,4,2,0,7,1,6,14
PAOK Salonik,5076,2,2,2,2,11,7,4,8
P'thinaikos,5076,3,2,1,3,7,11,-4,7
Panionios,5076,4,1,1,4,4,10,-6,4
AEK Athens,5077,1,4,2,0,7,1,6,14
PAOK Salonik,5077,2,2,3,1,10,5,5,9
P'thinaikos,5077,3,1,2,3,5,10,-5,5
Panionios,5077,4,1,1,4,4,10,-6,4
AEK Athens,5078,1,4,2,0,7,1,6,14
PAOK Salonik,5078,2,2,3,1,11,6,5,9
P'thinaikos,5078,3,1,2,3,6,11,-5,5
Panionios,5078,4,1,1,4,4,10,-6,4
AEK Athens,5079,1,4,2,0,7,1,6,14
PAOK Salonik,5079,2,2,2,2,9,5,4,8
P'thinaikos,5079,3,2,1,3,5,9,-4,7
Panionios,5079,4,1,1,4,4,10,-6,4
AEK Athens,5080,1,4,2,0,7,1,6,14
PAOK Salonik,5080,2,2,3,1,10,5,5,9
P'thinaikos,5080,3,1,2,3,5,10,-5,5
Panionios,5080,4,1,1,4,4,10,-6,4
AEK Athens,5081,1,4,2,0,7,1,6,14
PAOK Salonik,5081,2,3,2,1,12,5,7,11
Panionios,5081,3,1,1,4,4,10,-6,4
P'thinaikos,5081,4,1,1,4,5,12,-7,4
AEK Athens,5082,1,4,2,0,7,1,6,14
PAOK Salonik,5082,2,3,2,1,12,5,7,11
Panionios,5082,3,1,1,4,4,10,-6,4
P'thinaikos,5082,4,1,1,4,5,12,-7,4
AEK Athens,5083,1,4,2,0,7,1,6,14
PAOK Salonik,5083,2,3,2,1,12,5,7,11
Panionios,5083,3,1,1,4,4,10,-6,4
P'thinaikos,5083,4,1,1,4,5,12,-7,4
AEK Athens,5084,1,4,2,0,7,1,6,14
PAOK Salonik,5084,2,2,3,1,9,4,5,9
P'thinaikos,5084,3,1,2,3,4,9,-5,5
Panionios,5084,4,1,1,4,4,10,-6,4
AEK Athens,5085,1,4,2,0,7,1,6,14
PAOK Salonik,5085,2,2,3,1,11,6,5,9
P'thinaikos,5085,3,1,2,3,6,11,-5,5
Panionios,5085,4,1,1,4,4,10,-6,4
AEK Athens,5086,1,4,2,0,7,1,6,14
PAOK Salonik,5086,2,3,2,1,12,6,6,11
P'thinaikos,5086,3,1,1,4,6,12,-6,4
Panionios,5086,4,1,1,4,4,10,-6,4
AEK Athens,5087,1,4,2,0,7,1,6,14
PAOK Salonik,5087,2,3,2,1,10,4,6,11
P'thinaikos,5087,3,1,1,4,4,10,-6,4
Panionios,5087,3,1,1,4,4,10,-6,4
AEK Athens,5088,1,4,2,0,7,1,6,14
PAOK Salonik,5088,2,2,2,2,9,6,3,8
P'thinaikos,5088,3,2,1,3,6,9,-3,7
Panionios,5088,4,1,1,4,4,10,-6,4
AEK Athens,5089,1,4,2,0,7,1,6,14
PAOK Salonik,5089,2,3,2,1,11,4,7,11
Panionios,5089,3,1,1,4,4,10,-6,4
P'thinaikos,5089,4,1,1,4,4,11,-7,4
AEK Athens,5090,1,4,2,0,7,1,6,14
PAOK Salonik,5090,2,2,2,2,10,7,3,8
P'thinaikos,5090,3,2,1,3,7,10,-3,7
Panionios,5090,4,1,1,4,4,10,-6,4
AEK Athens,5091,1,4,2,0,7,1,6,14
PAOK Salonik,5091,2,2,2,2,9,7,2,8
P'thinaikos,5091,3,2,1,3,7,9,-2,7
Panionios,5091,4,1,1,4,4,10,-6,4
AEK Athens,5092,1,4,2,0,7,1,6,14
PAOK Salonik,5092,2,2,2,2,9,7,2,8
P'thinaikos,5092,3,2,1,3,7,9,-2,7
Panionios,5092,4,1,1,4,4,10,-6,4
AEK Athens,5093,1,4,2,0,7,1,6,14
PAOK Salonik,5093,2,3,2,1,11,4,7,11
Panionios,5093,3,1,1,4,4,10,-6,4
P'thinaikos,5093,4,1,1,4,4,11,-7,4
AEK Athens,5094,1,4,2,0,7,1,6,14
PAOK Salonik,5094,2,2,2,2,9,6,3,8
P'thinaikos,5094,3,2,1,3,6,9,-3,7
Panionios,5094,4,1,1,4,4,10,-6,4
AEK Athens,5095,1,4,2,0,7,1,6,14
PAOK Salonik,5095,2,2,2,2,10,6,4,8
P'thinaikos,5095,3,2,1,3,6,10,-4,7
Panionios,5095,4,1,1,4,4,10,-6,4
AEK Athens,5096,1,4,2,0,7,1,6,14
PAOK Salonik,5096,2,3,2,1,11,5,6,11
P'thinaikos,5096,3,1,1,4,5,11,-6,4
Panionios,5096,4,1,1,4,4,10,-6,4
AEK Athens,5097,1,4,2,0,7,1,6,14
PAOK Salonik,5097,2,3,2,1,11,4,7,11
Panionios,5097,3,1,1,4,4,10,-6,4
P'thinaikos,5097,4,1,1,4,4,11,-7,4
AEK Athens,5098,1,4,2,0,7,1,6,14
PAOK Salonik,5098,2,2,3,1,11,6,5,9
P'thinaikos,5098,3,1,2,3,6,11,-5,5
Panionios,5098,4,1,1,4,4,10,-6,4
AEK Athens,5099,1,4,2,0,7,1,6,14
PAOK Salonik,5099,2,2,3,1,10,5,5,9
P'thinaikos,5099,3,1,2,3,5,10,-5,5
Panionios,5099,4,1,1,4,4,10,-6,4
AEK Athens,5100,1,4,2,0,7,1,6,14
PAOK Salonik,5100,2,2,2,2,9,5,4,8
P'thinaikos,5100,3,2,1,3,5,9,-4,7
Panionios,5100,4,1,1,4,4,10,-6,4
AEK Athens,5101,1,4,2,0,7,1,6,14
PAOK Salonik,5101,2,3,2,1,10,4,6,11
P'thinaikos,5101,3,1,1,4,4,10,-6,4
Panionios,5101,3,1,1,4,4,10,-6,4
AEK Athens,5102,1,4,2,0,7,1,6,14
PAOK Salonik,5102,2,3,2,1,12,4,8,11
Panionios,5102,3,1,1,4,4,10,-6,4
P'thinaikos,5102,4,1,1,4,4,12,-8,4
AEK Athens,5103,1,4,2,0,7,1,6,14
PAOK Salonik,5103,2,2,2,2,10,6,4,8
P'thinaikos,5103,3,2,1,3,6,10,-4,7
Panionios,5103,4,1,1,4,4,10,-6,4
AEK Athens,5104,1,4,2,0,7,1,6,14
PAOK Salonik,5104,2,2,3,1,10,5,5,9
P'thinaikos,5104,3,1,2,3,5,10,-5,5
Panionios,5104,4,1,1,4,4,10,-6,4
AEK Athens,5105,1,4,2,0,7,1,6,14
PAOK Salonik,5105,2,2,3,1,10,5,5,9
P'thinaikos,5105,3,1,2,3,5,10,-5,5
Panionios,5105,4,1,1,4,4,10,-6,4
AEK Athens,5106,1,4,2,0,7,1,6,14
PAOK Salonik,5106,2,2,3,1,10,5,5,9
P'thinaikos,5106,3,1,2,3,5,10,-5,5
Panionios,5106,4,1,1,4,4,10,-6,4
AEK Athens,5107,1,4,2,0,7,1,6,14
PAOK Salonik,5107,2,2,3,1,10,5,5,9
P'thinaikos,5107,3,1,2,3,5,10,-5,5
Panionios,5107,4,1,1,4,4,10,-6,4
AEK Athens,5108,1,4,2,0,7,1,6,14
PAOK Salonik,5108,2,2,3,1,10,5,5,9
P'thinaikos,5108,3,1,2,3,5,10,-5,5
Panionios,5108,4,1,1,4,4,10,-6,4
AEK Athens,5109,1,4,2,0,7,1,6,14
PAOK Salonik,5109,2,2,2,2,11,8,3,8
P'thinaikos,5109,3,2,1,3,8,11,-3,7
Panionios,5109,4,1,1,4,4,10,-6,4
AEK Athens,5110,1,4,2,0,7,1,6,14
PAOK Salonik,5110,2,2,2,2,9,6,3,8
P'thinaikos,5110,3,2,1,3,6,9,-3,7
Panionios,5110,4,1,1,4,4,10,-6,4
AEK Athens,5111,1,4,2,0,7,1,6,14
PAOK Salonik,5111,2,2,2,2,10,6,4,8
P'thinaikos,5111,3,2,1,3,6,10,-4,7
Panionios,5111,4,1,1,4,4,10,-6,4
AEK Athens,5112,1,4,2,0,7,1,6,14
PAOK Salonik,5112,2,2,3,1,10,5,5,9
P'thinaikos,5112,3,1,2,3,5,10,-5,5
Panionios,5112,4,1,1,4,4,10,-6,4
AEK Athens,5113,1,4,2,0,7,1,6,14
PAOK Salonik,5113,2,3,2,1,10,4,6,11
P'thinaikos,5113,3,1,1,4,4,10,-6,4
Panionios,5113,3,1,1,4,4,10,-6,4
AEK Athens,5114,1,4,2,0,7,1,6,14
PAOK Salonik,5114,2,2,2,2,10,6,4,8
P'thinaikos,5114,3,2,1,3,6,10,-4,7
Panionios,5114,4,1,1,4,4,10,-6,4
AEK Athens,5115,1,4,2,0,7,1,6,14
PAOK Salonik,5115,2,3,2,1,11,5,6,11
P'thinaikos,5115,3,1,1,4,5,11,-6,4
Panionios,5115,4,1,1,4,4,10,-6,4
AEK Athens,5116,1,4,2,0,7,1,6,14
PAOK Salonik,5116,2,3,2,1,10,4,6,11
P'thinaikos,5116,3,1,1,4,4,10,-6,4
Panionios,5116,3,1,1,4,4,10,-6,4
AEK Athens,5117,1,4,2,0,7,1,6,14
PAOK Salonik,5117,2,2,2,2,9,5,4,8
P'thinaikos,5117,3,2,1,3,5,9,-4,7
Panionios,5117,4,1,1,4,4,10,-6,4
AEK Athens,5118,1,4,2,0,7,1,6,14
PAOK Salonik,5118,2,2,3,1,12,7,5,9
P'thinaikos,5118,3,1,2,3,7,12,-5,5
Panionios,5118,4,1,1,4,4,10,-6,4
AEK Athens,5119,1,4,2,0,7,1,6,14
PAOK Salonik,5119,2,2,3,1,9,4,5,9
P'thinaikos,5119,3,1,2,3,4,9,-5,5
Panionios,5119,4,1,1,4,4,10,-6,4
AEK Athens,5120,1,4,2,0,7,1,6,14
PAOK Salonik,5120,2,2,3,1,10,5,5,9
P'thinaikos,5120,3,1,2,3,5,10,-5,5
Panionios,5120,4,1,1,4,4,10,-6,4
AEK Athens,5121,1,4,2,0,7,1,6,14
PAOK Salonik,5121,2,2,2,2,10,6,4,8
P'thinaikos,5121,3,2,1,3,6,10,-4,7
Panionios,5121,4,1,1,4,4,10,-6,4
AEK Athens,5122,1,4,2,0,7,1,6,14
PAOK Salonik,5122,2,3,2,1,11,4,7,11
Panionios,5122,3,1,1,4,4,10,-6,4
P'thinaikos,5122,4,1,1,4,4,11,-7,4
AEK Athens,5123,1,4,2,0,7,1,6,14
PAOK Salonik,5123,2,2,3,1,10,5,5,9
P'thinaikos,5123,3,1,2,3,5,10,-5,5
Panionios,5123,4,1,1,4,4,10,-6,4
AEK Athens,5124,1,4,2,0,7,1,6,14
PAOK Salonik,5124,2,2,2,2,11,7,4,8
P'thinaikos,5124,3,2,1,3,7,11,-4,7
Panionios,5124,4,1,1,4,4,10,-6,4
AEK Athens,5125,1,4,2,0,7,1,6,14
PAOK Salonik,5125,2,3,2,1,10,4,6,11
P'thinaikos,5125,3,1,1,4,4,10,-6,4
Panionios,5125,3,1,1,4,4,10,-6,4
AEK Athens,5126,1,4,2,0,7,1,6,14
PAOK Salonik,5126,2,2,2,2,11,7,4,8
P'thinaikos,5126,3,2,1,3,7,11,-4,7
Panionios,5126,4,1,1,4,4,10,-6,4
AEK Athens,5127,1,4,2,0,7,1,6,14
PAOK Salonik,5127,2,2,3,1,10,5,5,9
P'thinaikos,5127,3,1,2,3,5,10,-5,5
Panionios,5127,4,1,1,4,4,10,-6,4
AEK Athens,5128,1,4,2,0,7,1,6,14
PAOK Salonik,5128,2,3,2,1,12,5,7,11
Panionios,5128,3,1,1,4,4,10,-6,4
P'thinaikos,5128,4,1,1,4,5,12,-7,4
AEK Athens,5129,1,4,2,0,7,1,6,14
PAOK Salonik,5129,2,2,3,1,10,5,5,9
P'thinaikos,5129,3,1,2,3,5,10,-5,5
Panionios,5129,4,1,1,4,4,10,-6,4
AEK Athens,5130,1,4,2,0,7,1,6,14
PAOK Salonik,5130,2,2,2,2,9,5,4,8
P'thinaikos,5130,3,2,1,3,5,9,-4,7
Panionios,5130,4,1,1,4,4,10,-6,4
AEK Athens,5131,1,4,2,0,7,1,6,14
PAOK Salonik,5131,2,2,3,1,10,5,5,9
P'thinaikos,5131,3,1,2,3,5,10,-5,5
Panionios,5131,4,1,1,4,4,10,-6,4
AEK Athens,5132,1,4,2,0,7,1,6,14
PAOK Salonik,5132,2,2,2,2,9,6,3,8
P'thinaikos,5132,3,2,1,3,6,9,-3,7
Panionios,5132,4,1,1,4,4,10,-6,4
AEK Athens,5133,1,4,2,0,7,1,6,14
PAOK Salonik,5133,2,2,2,2,9,5,4,8
P'thinaikos,5133,3,2,1,3,5,9,-4,7
Panionios,5133,4,1,1,4,4,10,-6,4
AEK Athens,5134,1,4,2,0,7,1,6,14
PAOK Salonik,5134,2,2,2,2,9,5,4,8
P'thinaikos,5134,3,2,1,3,5,9,-4,7
Panionios,5134,4,1,1,4,4,10,-6,4
AEK Athens,5135,1,4,2,0,7,1,6,14
PAOK Salonik,5135,2,2,2,2,10,7,3,8
P'thinaikos,5135,3,2,1,3,7,10,-3,7
Panionios,5135,4,1,1,4,4,10,-6,4
AEK Athens,5136,1,4,2,0,7,1,6,14
PAOK Salonik,5136,2,3,2,1,10,4,6,11
P'thinaikos,5136,3,1,1,4,4,10,-6,4
Panionios,5136,3,1,1,4,4,10,-6,4
AEK Athens,5137,1,4,2,0,7,1,6,14
PAOK Salonik,5137,2,3,2,1,11,4,7,11
Panionios,5137,3,1,1,4,4,10,-6,4
P'thinaikos,5137,4,1,1,4,4,11,-7,4
AEK Athens,5138,1,4,2,0,7,1,6,14
PAOK Salonik,5138,2,3,2,1,10,4,6,11
P'thinaikos,5138,3,1,1,4,4,10,-6,4
Panionios,5138,3,1,1,4,4,10,-6,4
AEK Athens,5139,1,4,2,0,7,1,6,14
PAOK Salonik,5139,2,2,3,1,9,4,5,9
P'thinaikos,5139,3,1,2,3,4,9,-5,5
Panionios,5139,4,1,1,4,4,10,-6,4
AEK Athens,5140,1,4,2,0,7,1,6,14
PAOK Salonik,5140,2,2,2,2,9,5,4,8
P'thinaikos,5140,3,2,1,3,5,9,-4,7
Panionios,5140,4,1,1,4,4,10,-6,4
AEK Athens,5141,1,4,2,0,7,1,6,14
PAOK Salonik,5141,2,2,2,2,10,6,4,8
P'thinaikos,5141,3,2,1,3,6,10,-4,7
Panionios,5141,4,1,1,4,4,10,-6,4
AEK Athens,5142,1,4,2,0,7,1,6,14
PAOK Salonik,5142,2,2,3,1,11,6,5,9
P'thinaikos,5142,3,1,2,3,6,11,-5,5
Panionios,5142,4,1,1,4,4,10,-6,4
AEK Athens,5143,1,4,2,0,7,1,6,14
PAOK Salonik,5143,2,3,2,1,13,6,7,11
Panionios,5143,3,1,1,4,4,10,-6,4
P'thinaikos,5143,4,1,1,4,6,13,-7,4
AEK Athens,5144,1,4,2,0,7,1,6,14
PAOK Salonik,5144,2,3,2,1,11,5,6,11
P'thinaikos,5144,3,1,1,4,5,11,-6,4
Panionios,5144,4,1,1,4,4,10,-6,4
AEK Athens,5145,1,4,2,0,7,1,6,14
PAOK Salonik,5145,2,3,2,1,12,4,8,11
Panionios,5145,3,1,1,4,4,10,-6,4
P'thinaikos,5145,4,1,1,4,4,12,-8,4
AEK Athens,5146,1,4,2,0,7,1,6,14
PAOK Salonik,5146,2,2,2,2,9,7,2,8
P'thinaikos,5146,3,2,1,3,7,9,-2,7
Panionios,5146,4,1,1,4,4,10,-6,4
AEK Athens,5147,1,4,2,0,7,1,6,14
PAOK Salonik,5147,2,3,2,1,10,4,6,11
P'thinaikos,5147,3,1,1,4,4,10,-6,4
Panionios,5147,3,1,1,4,4,10,-6,4
AEK Athens,5148,1,4,2,0,7,1,6,14
PAOK Salonik,5148,2,2,3,1,10,5,5,9
P'thinaikos,5148,3,1,2,3,5,10,-5,5
Panionios,5148,4,1,1,4,4,10,-6,4
AEK Athens,5149,1,4,2,0,7,1,6,14
PAOK Salonik,5149,2,2,2,2,9,6,3,8
P'thinaikos,5149,3,2,1,3,6,9,-3,7
Panionios,5149,4,1,1,4,4,10,-6,4
AEK Athens,5150,1,4,2,0,7,1,6,14
PAOK Salonik,5150,2,3,2,1,10,4,6,11
P'thinaikos,5150,3,1,1,4,4,10,-6,4
Panionios,5150,3,1,1,4,4,10,-6,4
AEK Athens,5151,1,4,2,0,7,1,6,14
PAOK Salonik,5151,2,3,2,1,10,4,6,11
P'thinaikos,5151,3,1,1,4,4,10,-6,4
Panionios,5151,3,1,1,4,4,10,-6,4
AEK Athens,5152,1,4,2,0,7,1,6,14
PAOK Salonik,5152,2,3,2,1,10,4,6,11
P'thinaikos,5152,3,1,1,4,4,10,-6,4
Panionios,5152,3,1,1,4,4,10,-6,4
AEK Athens,5153,1,4,2,0,7,1,6,14
PAOK Salonik,5153,2,2,2,2,9,5,4,8
P'thinaikos,5153,3,2,1,3,5,9,-4,7
Panionios,5153,4,1,1,4,4,10,-6,4
AEK Athens,5154,1,4,2,0,7,1,6,14
PAOK Salonik,5154,2,2,2,2,9,6,3,8
P'thinaikos,5154,3,2,1,3,6,9,-3,7
Panionios,5154,4,1,1,4,4,10,-6,4
AEK Athens,5155,1,4,2,0,7,1,6,14
PAOK Salonik,5155,2,2,2,2,9,5,4,8
P'thinaikos,5155,3,2,1,3,5,9,-4,7
Panionios,5155,4,1,1,4,4,10,-6,4
AEK Athens,5156,1,4,2,0,7,1,6,14
PAOK Salonik,5156,2,3,2,1,11,5,6,11
P'thinaikos,5156,3,1,1,4,5,11,-6,4
Panionios,5156,4,1,1,4,4,10,-6,4
AEK Athens,5157,1,4,2,0,7,1,6,14
PAOK Salonik,5157,2,2,2,2,9,5,4,8
P'thinaikos,5157,3,2,1,3,5,9,-4,7
Panionios,5157,4,1,1,4,4,10,-6,4
AEK Athens,5158,1,4,2,0,7,1,6,14
PAOK Salonik,5158,2,2,2,2,10,6,4,8
P'thinaikos,5158,3,2,1,3,6,10,-4,7
Panionios,5158,4,1,1,4,4,10,-6,4
AEK Athens,5159,1,4,2,0,7,1,6,14
PAOK Salonik,5159,2,3,2,1,12,6,6,11
P'thinaikos,5159,3,1,1,4,6,12,-6,4
Panionios,5159,4,1,1,4,4,10,-6,4
AEK Athens,5160,1,4,2,0,7,1,6,14
PAOK Salonik,5160,2,2,2,2,10,6,4,8
P'thinaikos,5160,3,2,1,3,6,10,-4,7
Panionios,5160,4,1,1,4,4,10,-6,4
AEK Athens,5161,1,4,2,0,7,1,6,14
PAOK Salonik,5161,2,2,3,1,10,5,5,9
P'thinaikos,5161,3,1,2,3,5,10,-5,5
Panionios,5161,4,1,1,4,4,10,-6,4
AEK Athens,5162,1,4,2,0,7,1,6,14
PAOK Salonik,5162,2,3,2,1,10,4,6,11
P'thinaikos,5162,3,1,1,4,4,10,-6,4
Panionios,5162,3,1,1,4,4,10,-6,4
AEK Athens,5163,1,4,2,0,7,1,6,14
PAOK Salonik,5163,2,2,2,2,9,7,2,8
P'thinaikos,5163,3,2,1,3,7,9,-2,7
Panionios,5163,4,1,1,4,4,10,-6,4
AEK Athens,5164,1,4,2,0,7,1,6,14
PAOK Salonik,5164,2,2,2,2,10,9,1,8
P'thinaikos,5164,3,2,1,3,9,10,-1,7
Panionios,5164,4,1,1,4,4,10,-6,4
AEK Athens,5165,1,4,2,0,7,1,6,14
PAOK Salonik,5165,2,2,2,2,9,5,4,8
P'thinaikos,5165,3,2,1,3,5,9,-4,7
Panionios,5165,4,1,1,4,4,10,-6,4
AEK Athens,5166,1,4,2,0,7,1,6,14
PAOK Salonik,5166,2,2,2,2,10,6,4,8
P'thinaikos,5166,3,2,1,3,6,10,-4,7
Panionios,5166,4,1,1,4,4,10,-6,4
AEK Athens,5167,1,4,2,0,7,1,6,14
PAOK Salonik,5167,2,2,2,2,10,7,3,8
P'thinaikos,5167,3,2,1,3,7,10,-3,7
Panionios,5167,4,1,1,4,4,10,-6,4
AEK Athens,5168,1,4,2,0,7,1,6,14
PAOK Salonik,5168,2,2,3,1,10,5,5,9
P'thinaikos,5168,3,1,2,3,5,10,-5,5
Panionios,5168,4,1,1,4,4,10,-6,4
AEK Athens,5169,1,4,2,0,7,1,6,14
PAOK Salonik,5169,2,2,2,2,9,6,3,8
P'thinaikos,5169,3,2,1,3,6,9,-3,7
Panionios,5169,4,1,1,4,4,10,-6,4
AEK Athens,5170,1,4,2,0,7,1,6,14
PAOK Salonik,5170,2,2,2,2,10,6,4,8
P'thinaikos,5170,3,2,1,3,6,10,-4,7
Panionios,5170,4,1,1,4,4,10,-6,4
AEK Athens,5171,1,4,2,0,7,1,6,14
PAOK Salonik,5171,2,3,2,1,12,5,7,11
Panionios,5171,3,1,1,4,4,10,-6,4
P'thinaikos,5171,4,1,1,4,5,12,-7,4
AEK Athens,5172,1,4,2,0,7,1,6,14
PAOK Salonik,5172,2,2,2,2,10,6,4,8
P'thinaikos,5172,3,2,1,3,6,10,-4,7
Panionios,5172,4,1,1,4,4,10,-6,4
AEK Athens,5173,1,4,2,0,7,1,6,14
PAOK Salonik,5173,2,2,3,1,10,5,5,9
P'thinaikos,5173,3,1,2,3,5,10,-5,5
Panionios,5173,4,1,1,4,4,10,-6,4
AEK Athens,5174,1,4,2,0,7,1,6,14
PAOK Salonik,5174,2,2,2,2,9,5,4,8
P'thinaikos,5174,3,2,1,3,5,9,-4,7
Panionios,5174,4,1,1,4,4,10,-6,4
AEK Athens,5175,1,4,2,0,7,1,6,14
PAOK Salonik,5175,2,3,2,1,10,4,6,11
P'thinaikos,5175,3,1,1,4,4,10,-6,4
Panionios,5175,3,1,1,4,4,10,-6,4
AEK Athens,5176,1,4,2,0,7,1,6,14
PAOK Salonik,5176,2,2,2,2,9,7,2,8
P'thinaikos,5176,3,2,1,3,7,9,-2,7
Panionios,5176,4,1,1,4,4,10,-6,4
AEK Athens,5177,1,4,2,0,7,1,6,14
PAOK Salonik,5177,2,2,3,1,11,6,5,9
P'thinaikos,5177,3,1,2,3,6,11,-5,5
Panionios,5177,4,1,1,4,4,10,-6,4
AEK Athens,5178,1,4,2,0,7,1,6,14
PAOK Salonik,5178,2,3,2,1,12,4,8,11
Panionios,5178,3,1,1,4,4,10,-6,4
P'thinaikos,5178,4,1,1,4,4,12,-8,4
AEK Athens,5179,1,4,2,0,7,1,6,14
PAOK Salonik,5179,2,2,2,2,10,6,4,8
P'thinaikos,5179,3,2,1,3,6,10,-4,7
Panionios,5179,4,1,1,4,4,10,-6,4
AEK Athens,5180,1,4,2,0,7,1,6,14
PAOK Salonik,5180,2,2,3,1,10,5,5,9
P'thinaikos,5180,3,1,2,3,5,10,-5,5
Panionios,5180,4,1,1,4,4,10,-6,4
AEK Athens,5181,1,4,2,0,7,1,6,14
PAOK Salonik,5181,2,3,2,1,10,4,6,11
P'thinaikos,5181,3,1,1,4,4,10,-6,4
Panionios,5181,3,1,1,4,4,10,-6,4
AEK Athens,5182,1,4,2,0,7,1,6,14
PAOK Salonik,5182,2,2,3,1,9,4,5,9
P'thinaikos,5182,3,1,2,3,4,9,-5,5
Panionios,5182,4,1,1,4,4,10,-6,4
AEK Athens,5183,1,4,2,0,7,1,6,14
PAOK Salonik,5183,2,2,3,1,10,5,5,9
P'thinaikos,5183,3,1,2,3,5,10,-5,5
Panionios,5183,4,1,1,4,4,10,-6,4
AEK Athens,5184,1,4,2,0,7,1,6,14
PAOK Salonik,5184,2,3,2,1,10,4,6,11
P'thinaikos,5184,3,1,1,4,4,10,-6,4
Panionios,5184,3,1,1,4,4,10,-6,4
AEK Athens,5185,1,4,2,0,7,1,6,14
PAOK Salonik,5185,2,2,2,2,9,5,4,8
P'thinaikos,5185,3,2,1,3,5,9,-4,7
Panionios,5185,4,1,1,4,4,10,-6,4
AEK Athens,5186,1,4,2,0,7,1,6,14
PAOK Salonik,5186,2,2,2,2,9,5,4,8
P'thinaikos,5186,3,2,1,3,5,9,-4,7
Panionios,5186,4,1,1,4,4,10,-6,4
AEK Athens,5187,1,4,2,0,7,1,6,14
PAOK Salonik,5187,2,2,3,1,12,7,5,9
P'thinaikos,5187,3,1,2,3,7,12,-5,5
Panionios,5187,4,1,1,4,4,10,-6,4
AEK Athens,5188,1,4,2,0,7,1,6,14
PAOK Salonik,5188,2,3,2,1,20,6,14,11
Panionios,5188,3,1,1,4,4,10,-6,4
P'thinaikos,5188,4,1,1,4,6,20,-14,4
AEK Athens,5189,1,4,2,0,7,1,6,14
PAOK Salonik,5189,2,2,2,2,10,7,3,8
P'thinaikos,5189,3,2,1,3,7,10,-3,7
Panionios,5189,4,1,1,4,4,10,-6,4
AEK Athens,5190,1,4,2,0,7,1,6,14
PAOK Salonik,5190,2,2,3,1,10,5,5,9
P'thinaikos,5190,3,1,2,3,5,10,-5,5
Panionios,5190,4,1,1,4,4,10,-6,4
AEK Athens,5191,1,4,2,0,7,1,6,14
PAOK Salonik,5191,2,2,2,2,9,5,4,8
P'thinaikos,5191,3,2,1,3,5,9,-4,7
Panionios,5191,4,1,1,4,4,10,-6,4
AEK Athens,5192,1,4,2,0,7,1,6,14
PAOK Salonik,5192,2,3,2,1,10,4,6,11
P'thinaikos,5192,3,1,1,4,4,10,-6,4
Panionios,5192,3,1,1,4,4,10,-6,4
AEK Athens,5193,1,4,2,0,7,1,6,14
PAOK Salonik,5193,2,2,3,1,10,5,5,9
P'thinaikos,5193,3,1,2,3,5,10,-5,5
Panionios,5193,4,1,1,4,4,10,-6,4
AEK Athens,5194,1,4,2,0,7,1,6,14
PAOK Salonik,5194,2,2,3,1,10,5,5,9
P'thinaikos,5194,3,1,2,3,5,10,-5,5
Panionios,5194,4,1,1,4,4,10,-6,4
AEK Athens,5195,1,4,2,0,7,1,6,14
PAOK Salonik,5195,2,3,2,1,13,5,8,11
Panionios,5195,3,1,1,4,4,10,-6,4
P'thinaikos,5195,4,1,1,4,5,13,-8,4
AEK Athens,5196,1,4,2,0,7,1,6,14
PAOK Salonik,5196,2,2,3,1,10,5,5,9
P'thinaikos,5196,3,1,2,3,5,10,-5,5
Panionios,5196,4,1,1,4,4,10,-6,4
AEK Athens,5197,1,4,2,0,7,1,6,14
PAOK Salonik,5197,2,2,3,1,10,5,5,9
P'thinaikos,5197,3,1,2,3,5,10,-5,5
Panionios,5197,4,1,1,4,4,10,-6,4
AEK Athens,5198,1,4,2,0,7,1,6,14
PAOK Salonik,5198,2,2,2,2,9,5,4,8
P'thinaikos,5198,3,2,1,3,5,9,-4,7
Panionios,5198,4,1,1,4,4,10,-6,4
AEK Athens,5199,1,4,2,0,7,1,6,14
PAOK Salonik,5199,2,3,2,1,11,5,6,11
P'thinaikos,5199,3,1,1,4,5,11,-6,4
Panionios,5199,4,1,1,4,4,10,-6,4
AEK Athens,5200,1,4,2,0,7,1,6,14
PAOK Salonik,5200,2,2,2,2,9,6,3,8
P'thinaikos,5200,3,2,1,3,6,9,-3,7
Panionios,5200,4,1,1,4,4,10,-6,4
AEK Athens,5201,1,4,2,0,7,1,6,14
PAOK Salonik,5201,2,2,2,2,9,6,3,8
P'thinaikos,5201,3,2,1,3,6,9,-3,7
Panionios,5201,4,1,1,4,4,10,-6,4
AEK Athens,5202,1,4,2,0,7,1,6,14
PAOK Salonik,5202,2,3,2,1,10,4,6,11
P'thinaikos,5202,3,1,1,4,4,10,-6,4
Panionios,5202,3,1,1,4,4,10,-6,4
AEK Athens,5203,1,4,2,0,7,1,6,14
PAOK Salonik,5203,2,2,3,1,9,4,5,9
P'thinaikos,5203,3,1,2,3,4,9,-5,5
Panionios,5203,4,1,1,4,4,10,-6,4
AEK Athens,5204,1,4,2,0,7,1,6,14
PAOK Salonik,5204,2,3,2,1,12,5,7,11
Panionios,5204,3,1,1,4,4,10,-6,4
P'thinaikos,5204,4,1,1,4,5,12,-7,4
AEK Athens,5205,1,4,2,0,7,1,6,14
PAOK Salonik,5205,2,3,2,1,11,5,6,11
P'thinaikos,5205,3,1,1,4,5,11,-6,4
Panionios,5205,4,1,1,4,4,10,-6,4
AEK Athens,5206,1,4,2,0,7,1,6,14
PAOK Salonik,5206,2,3,2,1,12,6,6,11
P'thinaikos,5206,3,1,1,4,6,12,-6,4
Panionios,5206,4,1,1,4,4,10,-6,4
AEK Athens,5207,1,4,2,0,7,1,6,14
PAOK Salonik,5207,2,3,2,1,11,5,6,11
P'thinaikos,5207,3,1,1,4,5,11,-6,4
Panionios,5207,4,1,1,4,4,10,-6,4
AEK Athens,5208,1,4,2,0,7,1,6,14
PAOK Salonik,5208,2,2,2,2,9,6,3,8
P'thinaikos,5208,3,2,1,3,6,9,-3,7
Panionios,5208,4,1,1,4,4,10,-6,4
AEK Athens,5209,1,4,2,0,7,1,6,14
PAOK Salonik,5209,2,2,3,1,10,5,5,9
P'thinaikos,5209,3,1,2,3,5,10,-5,5
Panionios,5209,4,1,1,4,4,10,-6,4
AEK Athens,5210,1,4,2,0,7,1,6,14
PAOK Salonik,5210,2,2,3,1,11,6,5,9
P'thinaikos,5210,3,1,2,3,6,11,-5,5
Panionios,5210,4,1,1,4,4,10,-6,4
AEK Athens,5211,1,4,2,0,7,1,6,14
PAOK Salonik,5211,2,2,2,2,9,6,3,8
P'thinaikos,5211,3,2,1,3,6,9,-3,7
Panionios,5211,4,1,1,4,4,10,-6,4
AEK Athens,5212,1,4,2,0,7,1,6,14
PAOK Salonik,5212,2,3,2,1,15,7,8,11
Panionios,5212,3,1,1,4,4,10,-6,4
P'thinaikos,5212,4,1,1,4,7,15,-8,4
AEK Athens,5213,1,4,2,0,7,1,6,14
PAOK Salonik,5213,2,2,3,1,10,5,5,9
P'thinaikos,5213,3,1,2,3,5,10,-5,5
Panionios,5213,4,1,1,4,4,10,-6,4
AEK Athens,5214,1,4,2,0,7,1,6,14
PAOK Salonik,5214,2,2,2,2,10,6,4,8
P'thinaikos,5214,3,2,1,3,6,10,-4,7
Panionios,5214,4,1,1,4,4,10,-6,4
AEK Athens,5215,1,4,2,0,7,1,6,14
PAOK Salonik,5215,2,2,3,1,10,5,5,9
P'thinaikos,5215,3,1,2,3,5,10,-5,5
Panionios,5215,4,1,1,4,4,10,-6,4
AEK Athens,5216,1,4,2,0,7,1,6,14
PAOK Salonik,5216,2,2,2,2,9,6,3,8
P'thinaikos,5216,3,2,1,3,6,9,-3,7
Panionios,5216,4,1,1,4,4,10,-6,4
AEK Athens,5217,1,4,2,0,7,1,6,14
PAOK Salonik,5217,2,3,2,1,11,4,7,11
Panionios,5217,3,1,1,4,4,10,-6,4
P'thinaikos,5217,4,1,1,4,4,11,-7,4
AEK Athens,5218,1,4,2,0,7,1,6,14
PAOK Salonik,5218,2,2,3,1,10,5,5,9
P'thinaikos,5218,3,1,2,3,5,10,-5,5
Panionios,5218,4,1,1,4,4,10,-6,4
AEK Athens,5219,1,4,2,0,7,1,6,14
PAOK Salonik,5219,2,2,3,1,9,4,5,9
P'thinaikos,5219,3,1,2,3,4,9,-5,5
Panionios,5219,4,1,1,4,4,10,-6,4
AEK Athens,5220,1,4,2,0,7,1,6,14
PAOK Salonik,5220,2,2,3,1,9,4,5,9
P'thinaikos,5220,3,1,2,3,4,9,-5,5
Panionios,5220,4,1,1,4,4,10,-6,4
AEK Athens,5221,1,4,2,0,7,1,6,14
PAOK Salonik,5221,2,2,3,1,9,4,5,9
P'thinaikos,5221,3,1,2,3,4,9,-5,5
Panionios,5221,4,1,1,4,4,10,-6,4
AEK Athens,5222,1,4,2,0,7,1,6,14
PAOK Salonik,5222,2,3,2,1,11,4,7,11
Panionios,5222,3,1,1,4,4,10,-6,4
P'thinaikos,5222,4,1,1,4,4,11,-7,4
AEK Athens,5223,1,4,2,0,7,1,6,14
PAOK Salonik,5223,2,2,2,2,9,6,3,8
P'thinaikos,5223,3,2,1,3,6,9,-3,7
Panionios,5223,4,1,1,4,4,10,-6,4
AEK Athens,5224,1,4,2,0,7,1,6,14
PAOK Salonik,5224,2,3,2,1,10,4,6,11
P'thinaikos,5224,3,1,1,4,4,10,-6,4
Panionios,5224,3,1,1,4,4,10,-6,4
AEK Athens,5225,1,4,2,0,7,1,6,14
PAOK Salonik,5225,2,3,2,1,10,4,6,11
P'thinaikos,5225,3,1,1,4,4,10,-6,4
Panionios,5225,3,1,1,4,4,10,-6,4
AEK Athens,5226,1,4,2,0,7,1,6,14
PAOK Salonik,5226,2,2,3,1,9,4,5,9
P'thinaikos,5226,3,1,2,3,4,9,-5,5
Panionios,5226,4,1,1,4,4,10,-6,4
AEK Athens,5227,1,4,2,0,7,1,6,14
PAOK Salonik,5227,2,3,2,1,11,5,6,11
P'thinaikos,5227,3,1,1,4,5,11,-6,4
Panionios,5227,4,1,1,4,4,10,-6,4
AEK Athens,5228,1,4,2,0,7,1,6,14
PAOK Salonik,5228,2,3,2,1,11,4,7,11
Panionios,5228,3,1,1,4,4,10,-6,4
P'thinaikos,5228,4,1,1,4,4,11,-7,4
AEK Athens,5229,1,4,2,0,7,1,6,14
PAOK Salonik,5229,2,2,2,2,10,6,4,8
P'thinaikos,5229,3,2,1,3,6,10,-4,7
Panionios,5229,4,1,1,4,4,10,-6,4
AEK Athens,5230,1,4,2,0,7,1,6,14
PAOK Salonik,5230,2,2,3,1,10,5,5,9
P'thinaikos,5230,3,1,2,3,5,10,-5,5
Panionios,5230,4,1,1,4,4,10,-6,4
AEK Athens,5231,1,4,2,0,7,1,6,14
PAOK Salonik,5231,2,2,2,2,9,6,3,8
P'thinaikos,5231,3,2,1,3,6,9,-3,7
Panionios,5231,4,1,1,4,4,10,-6,4
AEK Athens,5232,1,4,2,0,7,1,6,14
PAOK Salonik,5232,2,2,2,2,10,6,4,8
P'thinaikos,5232,3,2,1,3,6,10,-4,7
Panionios,5232,4,1,1,4,4,10,-6,4
AEK Athens,5233,1,4,2,0,7,1,6,14
PAOK Salonik,5233,2,2,2,2,10,6,4,8
P'thinaikos,5233,3,2,1,3,6,10,-4,7
Panionios,5233,4,1,1,4,4,10,-6,4
AEK Athens,5234,1,4,2,0,7,1,6,14
PAOK Salonik,5234,2,2,3,1,9,4,5,9
P'thinaikos,5234,3,1,2,3,4,9,-5,5
Panionios,5234,4,1,1,4,4,10,-6,4
AEK Athens,5235,1,4,2,0,7,1,6,14
PAOK Salonik,5235,2,2,3,1,10,5,5,9
P'thinaikos,5235,3,1,2,3,5,10,-5,5
Panionios,5235,4,1,1,4,4,10,-6,4
AEK Athens,5236,1,4,2,0,7,1,6,14
PAOK Salonik,5236,2,2,3,1,11,6,5,9
P'thinaikos,5236,3,1,2,3,6,11,-5,5
Panionios,5236,4,1,1,4,4,10,-6,4
AEK Athens,5237,1,4,2,0,7,1,6,14
PAOK Salonik,5237,2,2,3,1,10,5,5,9
P'thinaikos,5237,3,1,2,3,5,10,-5,5
Panionios,5237,4,1,1,4,4,10,-6,4
AEK Athens,5238,1,4,2,0,7,1,6,14
PAOK Salonik,5238,2,2,2,2,9,8,1,8
P'thinaikos,5238,3,2,1,3,8,9,-1,7
Panionios,5238,4,1,1,4,4,10,-6,4
AEK Athens,5239,1,4,2,0,7,1,6,14
PAOK Salonik,5239,2,3,2,1,12,4,8,11
Panionios,5239,3,1,1,4,4,10,-6,4
P'thinaikos,5239,4,1,1,4,4,12,-8,4
AEK Athens,5240,1,4,2,0,7,1,6,14
PAOK Salonik,5240,2,2,3,1,10,5,5,9
P'thinaikos,5240,3,1,2,3,5,10,-5,5
Panionios,5240,4,1,1,4,4,10,-6,4
AEK Athens,5241,1,4,2,0,7,1,6,14
PAOK Salonik,5241,2,3,2,1,11,5,6,11
P'thinaikos,5241,3,1,1,4,5,11,-6,4
Panionios,5241,4,1,1,4,4,10,-6,4
AEK Athens,5242,1,4,2,0,7,1,6,14
PAOK Salonik,5242,2,3,2,1,10,4,6,11
P'thinaikos,5242,3,1,1,4,4,10,-6,4
Panionios,5242,3,1,1,4,4,10,-6,4
AEK Athens,5243,1,4,2,0,7,1,6,14
PAOK Salonik,5243,2,2,3,1,9,4,5,9
P'thinaikos,5243,3,1,2,3,4,9,-5,5
Panionios,5243,4,1,1,4,4,10,-6,4
AEK Athens,5244,1,4,2,0,7,1,6,14
PAOK Salonik,5244,2,3,2,1,11,4,7,11
Panionios,5244,3,1,1,4,4,10,-6,4
P'thinaikos,5244,4,1,1,4,4,11,-7,4
AEK Athens,5245,1,4,2,0,7,1,6,14
PAOK Salonik,5245,2,3,2,1,13,5,8,11
Panionios,5245,3,1,1,4,4,10,-6,4
P'thinaikos,5245,4,1,1,4,5,13,-8,4
AEK Athens,5246,1,4,2,0,7,1,6,14
PAOK Salonik,5246,2,2,2,2,9,5,4,8
P'thinaikos,5246,3,2,1,3,5,9,-4,7
Panionios,5246,4,1,1,4,4,10,-6,4
AEK Athens,5247,1,4,2,0,7,1,6,14
PAOK Salonik,5247,2,3,2,1,12,6,6,11
P'thinaikos,5247,3,1,1,4,6,12,-6,4
Panionios,5247,4,1,1,4,4,10,-6,4
AEK Athens,5248,1,4,2,0,7,1,6,14
PAOK Salonik,5248,2,2,3,1,10,5,5,9
P'thinaikos,5248,3,1,2,3,5,10,-5,5
Panionios,5248,4,1,1,4,4,10,-6,4
AEK Athens,5249,1,4,2,0,7,1,6,14
PAOK Salonik,5249,2,2,2,2,11,7,4,8
P'thinaikos,5249,3,2,1,3,7,11,-4,7
Panionios,5249,4,1,1,4,4,10,-6,4
AEK Athens,5250,1,4,2,0,7,1,6,14
PAOK Salonik,5250,2,3,2,1,12,6,6,11
P'thinaikos,5250,3,1,1,4,6,12,-6,4
Panionios,5250,4,1,1,4,4,10,-6,4
AEK Athens,5251,1,4,2,0,7,1,6,14
PAOK Salonik,5251,2,2,3,1,10,5,5,9
P'thinaikos,5251,3,1,2,3,5,10,-5,5
Panionios,5251,4,1,1,4,4,10,-6,4
AEK Athens,5252,1,4,2,0,7,1,6,14
PAOK Salonik,5252,2,2,3,1,10,5,5,9
P'thinaikos,5252,3,1,2,3,5,10,-5,5
Panionios,5252,4,1,1,4,4,10,-6,4
AEK Athens,5253,1,4,2,0,7,1,6,14
PAOK Salonik,5253,2,2,3,1,10,5,5,9
P'thinaikos,5253,3,1,2,3,5,10,-5,5
Panionios,5253,4,1,1,4,4,10,-6,4
AEK Athens,5254,1,4,2,0,7,1,6,14
PAOK Salonik,5254,2,3,2,1,11,5,6,11
P'thinaikos,5254,3,1,1,4,5,11,-6,4
Panionios,5254,4,1,1,4,4,10,-6,4
AEK Athens,5255,1,4,2,0,7,1,6,14
PAOK Salonik,5255,2,3,2,1,11,4,7,11
Panionios,5255,3,1,1,4,4,10,-6,4
P'thinaikos,5255,4,1,1,4,4,11,-7,4
AEK Athens,5256,1,4,2,0,7,1,6,14
PAOK Salonik,5256,2,2,3,1,9,4,5,9
P'thinaikos,5256,3,1,2,3,4,9,-5,5
Panionios,5256,4,1,1,4,4,10,-6,4
AEK Athens,5257,1,4,2,0,7,1,6,14
PAOK Salonik,5257,2,2,2,2,10,7,3,8
P'thinaikos,5257,3,2,1,3,7,10,-3,7
Panionios,5257,4,1,1,4,4,10,-6,4
AEK Athens,5258,1,4,2,0,7,1,6,14
PAOK Salonik,5258,2,2,3,1,9,4,5,9
P'thinaikos,5258,3,1,2,3,4,9,-5,5
Panionios,5258,4,1,1,4,4,10,-6,4
AEK Athens,5259,1,4,2,0,7,1,6,14
PAOK Salonik,5259,2,2,3,1,9,4,5,9
P'thinaikos,5259,3,1,2,3,4,9,-5,5
Panionios,5259,4,1,1,4,4,10,-6,4
AEK Athens,5260,1,4,2,0,7,1,6,14
PAOK Salonik,5260,2,2,2,2,9,5,4,8
P'thinaikos,5260,3,2,1,3,5,9,-4,7
Panionios,5260,4,1,1,4,4,10,-6,4
AEK Athens,5261,1,4,2,0,7,1,6,14
PAOK Salonik,5261,2,2,2,2,9,5,4,8
P'thinaikos,5261,3,2,1,3,5,9,-4,7
Panionios,5261,4,1,1,4,4,10,-6,4
AEK Athens,5262,1,4,2,0,7,1,6,14
PAOK Salonik,5262,2,2,3,1,9,4,5,9
P'thinaikos,5262,3,1,2,3,4,9,-5,5
Panionios,5262,4,1,1,4,4,10,-6,4
AEK Athens,5263,1,4,2,0,7,1,6,14
PAOK Salonik,5263,2,2,2,2,9,7,2,8
P'thinaikos,5263,3,2,1,3,7,9,-2,7
Panionios,5263,4,1,1,4,4,10,-6,4
AEK Athens,5264,1,4,2,0,7,1,6,14
PAOK Salonik,5264,2,3,2,1,10,4,6,11
P'thinaikos,5264,3,1,1,4,4,10,-6,4
Panionios,5264,3,1,1,4,4,10,-6,4
AEK Athens,5265,1,4,2,0,7,1,6,14
PAOK Salonik,5265,2,3,2,1,11,4,7,11
Panionios,5265,3,1,1,4,4,10,-6,4
P'thinaikos,5265,4,1,1,4,4,11,-7,4
AEK Athens,5266,1,4,2,0,7,1,6,14
PAOK Salonik,5266,2,3,2,1,12,4,8,11
Panionios,5266,3,1,1,4,4,10,-6,4
P'thinaikos,5266,4,1,1,4,4,12,-8,4
AEK Athens,5267,1,4,2,0,7,1,6,14
PAOK Salonik,5267,2,2,2,2,10,7,3,8
P'thinaikos,5267,3,2,1,3,7,10,-3,7
Panionios,5267,4,1,1,4,4,10,-6,4
AEK Athens,5268,1,4,2,0,7,1,6,14
PAOK Salonik,5268,2,3,2,1,10,4,6,11
P'thinaikos,5268,3,1,1,4,4,10,-6,4
Panionios,5268,3,1,1,4,4,10,-6,4
AEK Athens,5269,1,4,2,0,7,1,6,14
PAOK Salonik,5269,2,3,2,1,10,4,6,11
P'thinaikos,5269,3,1,1,4,4,10,-6,4
Panionios,5269,3,1,1,4,4,10,-6,4
AEK Athens,5270,1,4,2,0,7,1,6,14
PAOK Salonik,5270,2,3,2,1,10,4,6,11
P'thinaikos,5270,3,1,1,4,4,10,-6,4
Panionios,5270,3,1,1,4,4,10,-6,4
AEK Athens,5271,1,4,2,0,7,1,6,14
PAOK Salonik,5271,2,2,2,2,9,5,4,8
P'thinaikos,5271,3,2,1,3,5,9,-4,7
Panionios,5271,4,1,1,4,4,10,-6,4
AEK Athens,5272,1,4,2,0,7,1,6,14
PAOK Salonik,5272,2,2,2,2,10,7,3,8
P'thinaikos,5272,3,2,1,3,7,10,-3,7
Panionios,5272,4,1,1,4,4,10,-6,4
AEK Athens,5273,1,4,2,0,7,1,6,14
PAOK Salonik,5273,2,3,2,1,11,5,6,11
P'thinaikos,5273,3,1,1,4,5,11,-6,4
Panionios,5273,4,1,1,4,4,10,-6,4
AEK Athens,5274,1,4,2,0,7,1,6,14
PAOK Salonik,5274,2,3,2,1,11,5,6,11
P'thinaikos,5274,3,1,1,4,5,11,-6,4
Panionios,5274,4,1,1,4,4,10,-6,4
AEK Athens,5275,1,4,2,0,7,1,6,14
PAOK Salonik,5275,2,2,2,2,9,5,4,8
P'thinaikos,5275,3,2,1,3,5,9,-4,7
Panionios,5275,4,1,1,4,4,10,-6,4
AEK Athens,5276,1,4,2,0,7,1,6,14
PAOK Salonik,5276,2,2,3,1,10,5,5,9
P'thinaikos,5276,3,1,2,3,5,10,-5,5
Panionios,5276,4,1,1,4,4,10,-6,4
AEK Athens,5277,1,4,2,0,7,1,6,14
PAOK Salonik,5277,2,2,2,2,10,7,3,8
P'thinaikos,5277,3,2,1,3,7,10,-3,7
Panionios,5277,4,1,1,4,4,10,-6,4
AEK Athens,5278,1,4,2,0,7,1,6,14
PAOK Salonik,5278,2,2,3,1,10,5,5,9
P'thinaikos,5278,3,1,2,3,5,10,-5,5
Panionios,5278,4,1,1,4,4,10,-6,4
AEK Athens,5279,1,4,2,0,7,1,6,14
PAOK Salonik,5279,2,2,3,1,10,5,5,9
P'thinaikos,5279,3,1,2,3,5,10,-5,5
Panionios,5279,4,1,1,4,4,10,-6,4
AEK Athens,5280,1,4,2,0,7,1,6,14
PAOK Salonik,5280,2,3,2,1,11,5,6,11
P'thinaikos,5280,3,1,1,4,5,11,-6,4
Panionios,5280,4,1,1,4,4,10,-6,4
AEK Athens,5281,1,4,2,0,7,1,6,14
PAOK Salonik,5281,2,2,3,1,9,4,5,9
P'thinaikos,5281,3,1,2,3,4,9,-5,5
Panionios,5281,4,1,1,4,4,10,-6,4
AEK Athens,5282,1,4,2,0,7,1,6,14
PAOK Salonik,5282,2,3,2,1,10,4,6,11
P'thinaikos,5282,3,1,1,4,4,10,-6,4
Panionios,5282,3,1,1,4,4,10,-6,4
AEK Athens,5283,1,4,2,0,7,1,6,14
PAOK Salonik,5283,2,3,2,1,10,4,6,11
P'thinaikos,5283,3,1,1,4,4,10,-6,4
Panionios,5283,3,1,1,4,4,10,-6,4
AEK Athens,5284,1,4,2,0,7,1,6,14
PAOK Salonik,5284,2,2,3,1,10,5,5,9
P'thinaikos,5284,3,1,2,3,5,10,-5,5
Panionios,5284,4,1,1,4,4,10,-6,4
AEK Athens,5285,1,4,2,0,7,1,6,14
PAOK Salonik,5285,2,2,2,2,9,6,3,8
P'thinaikos,5285,3,2,1,3,6,9,-3,7
Panionios,5285,4,1,1,4,4,10,-6,4
AEK Athens,5286,1,4,2,0,7,1,6,14
PAOK Salonik,5286,2,2,2,2,9,5,4,8
P'thinaikos,5286,3,2,1,3,5,9,-4,7
Panionios,5286,4,1,1,4,4,10,-6,4
AEK Athens,5287,1,4,2,0,7,1,6,14
PAOK Salonik,5287,2,3,2,1,12,6,6,11
P'thinaikos,5287,3,1,1,4,6,12,-6,4
Panionios,5287,4,1,1,4,4,10,-6,4
AEK Athens,5288,1,4,2,0,7,1,6,14
PAOK Salonik,5288,2,2,2,2,9,6,3,8
P'thinaikos,5288,3,2,1,3,6,9,-3,7
Panionios,5288,4,1,1,4,4,10,-6,4
AEK Athens,5289,1,4,2,0,7,1,6,14
PAOK Salonik,5289,2,3,2,1,11,5,6,11
P'thinaikos,5289,3,1,1,4,5,11,-6,4
Panionios,5289,4,1,1,4,4,10,-6,4
AEK Athens,5290,1,4,2,0,7,1,6,14
PAOK Salonik,5290,2,3,2,1,10,4,6,11
P'thinaikos,5290,3,1,1,4,4,10,-6,4
Panionios,5290,3,1,1,4,4,10,-6,4
AEK Athens,5291,1,4,2,0,7,1,6,14
PAOK Salonik,5291,2,3,2,1,12,6,6,11
P'thinaikos,5291,3,1,1,4,6,12,-6,4
Panionios,5291,4,1,1,4,4,10,-6,4
AEK Athens,5292,1,4,2,0,7,1,6,14
PAOK Salonik,5292,2,2,2,2,10,7,3,8
P'thinaikos,5292,3,2,1,3,7,10,-3,7
Panionios,5292,4,1,1,4,4,10,-6,4
AEK Athens,5293,1,4,2,0,7,1,6,14
PAOK Salonik,5293,2,2,2,2,9,6,3,8
P'thinaikos,5293,3,2,1,3,6,9,-3,7
Panionios,5293,4,1,1,4,4,10,-6,4
AEK Athens,5294,1,4,2,0,7,1,6,14
PAOK Salonik,5294,2,2,3,1,9,4,5,9
P'thinaikos,5294,3,1,2,3,4,9,-5,5
Panionios,5294,4,1,1,4,4,10,-6,4
AEK Athens,5295,1,4,2,0,7,1,6,14
PAOK Salonik,5295,2,2,2,2,9,5,4,8
P'thinaikos,5295,3,2,1,3,5,9,-4,7
Panionios,5295,4,1,1,4,4,10,-6,4
AEK Athens,5296,1,4,2,0,7,1,6,14
PAOK Salonik,5296,2,2,3,1,9,4,5,9
P'thinaikos,5296,3,1,2,3,4,9,-5,5
Panionios,5296,4,1,1,4,4,10,-6,4
AEK Athens,5297,1,4,2,0,7,1,6,14
PAOK Salonik,5297,2,2,3,1,9,4,5,9
P'thinaikos,5297,3,1,2,3,4,9,-5,5
Panionios,5297,4,1,1,4,4,10,-6,4
AEK Athens,5298,1,4,2,0,7,1,6,14
PAOK Salonik,5298,2,3,2,1,12,5,7,11
Panionios,5298,3,1,1,4,4,10,-6,4
P'thinaikos,5298,4,1,1,4,5,12,-7,4
AEK Athens,5299,1,4,2,0,7,1,6,14
PAOK Salonik,5299,2,2,3,1,11,6,5,9
P'thinaikos,5299,3,1,2,3,6,11,-5,5
Panionios,5299,4,1,1,4,4,10,-6,4
AEK Athens,5300,1,4,2,0,7,1,6,14
PAOK Salonik,5300,2,2,2,2,9,5,4,8
P'thinaikos,5300,3,2,1,3,5,9,-4,7
Panionios,5300,4,1,1,4,4,10,-6,4
AEK Athens,5301,1,4,2,0,7,1,6,14
PAOK Salonik,5301,2,2,2,2,10,9,1,8
P'thinaikos,5301,3,2,1,3,9,10,-1,7
Panionios,5301,4,1,1,4,4,10,-6,4
AEK Athens,5302,1,4,2,0,7,1,6,14
PAOK Salonik,5302,2,2,3,1,12,7,5,9
P'thinaikos,5302,3,1,2,3,7,12,-5,5
Panionios,5302,4,1,1,4,4,10,-6,4
AEK Athens,5303,1,4,2,0,7,1,6,14
PAOK Salonik,5303,2,2,3,1,10,5,5,9
P'thinaikos,5303,3,1,2,3,5,10,-5,5
Panionios,5303,4,1,1,4,4,10,-6,4
AEK Athens,5304,1,4,2,0,7,1,6,14
PAOK Salonik,5304,2,2,2,2,9,6,3,8
P'thinaikos,5304,3,2,1,3,6,9,-3,7
Panionios,5304,4,1,1,4,4,10,-6,4
AEK Athens,5305,1,4,2,0,7,1,6,14
PAOK Salonik,5305,2,2,3,1,11,6,5,9
P'thinaikos,5305,3,1,2,3,6,11,-5,5
Panionios,5305,4,1,1,4,4,10,-6,4
AEK Athens,5306,1,4,2,0,7,1,6,14
PAOK Salonik,5306,2,2,2,2,10,6,4,8
P'thinaikos,5306,3,2,1,3,6,10,-4,7
Panionios,5306,4,1,1,4,4,10,-6,4
AEK Athens,5307,1,4,2,0,7,1,6,14
PAOK Salonik,5307,2,2,3,1,9,4,5,9
P'thinaikos,5307,3,1,2,3,4,9,-5,5
Panionios,5307,4,1,1,4,4,10,-6,4
AEK Athens,5308,1,4,2,0,7,1,6,14
PAOK Salonik,5308,2,3,2,1,11,5,6,11
P'thinaikos,5308,3,1,1,4,5,11,-6,4
Panionios,5308,4,1,1,4,4,10,-6,4
AEK Athens,5309,1,4,2,0,7,1,6,14
PAOK Salonik,5309,2,3,2,1,11,4,7,11
Panionios,5309,3,1,1,4,4,10,-6,4
P'thinaikos,5309,4,1,1,4,4,11,-7,4
AEK Athens,5310,1,4,2,0,7,1,6,14
PAOK Salonik,5310,2,2,2,2,9,6,3,8
P'thinaikos,5310,3,2,1,3,6,9,-3,7
Panionios,5310,4,1,1,4,4,10,-6,4
AEK Athens,5311,1,4,2,0,7,1,6,14
PAOK Salonik,5311,2,2,3,1,9,4,5,9
P'thinaikos,5311,3,1,2,3,4,9,-5,5
Panionios,5311,4,1,1,4,4,10,-6,4
AEK Athens,5312,1,4,2,0,7,1,6,14
PAOK Salonik,5312,2,2,2,2,10,6,4,8
P'thinaikos,5312,3,2,1,3,6,10,-4,7
Panionios,5312,4,1,1,4,4,10,-6,4
AEK Athens,5313,1,4,2,0,7,1,6,14
PAOK Salonik,5313,2,3,2,1,10,4,6,11
P'thinaikos,5313,3,1,1,4,4,10,-6,4
Panionios,5313,3,1,1,4,4,10,-6,4
AEK Athens,5314,1,4,2,0,7,1,6,14
PAOK Salonik,5314,2,3,2,1,11,5,6,11
P'thinaikos,5314,3,1,1,4,5,11,-6,4
Panionios,5314,4,1,1,4,4,10,-6,4
AEK Athens,5315,1,4,2,0,7,1,6,14
PAOK Salonik,5315,2,2,2,2,9,7,2,8
P'thinaikos,5315,3,2,1,3,7,9,-2,7
Panionios,5315,4,1,1,4,4,10,-6,4
AEK Athens,5316,1,4,2,0,7,1,6,14
PAOK Salonik,5316,2,2,2,2,10,6,4,8
P'thinaikos,5316,3,2,1,3,6,10,-4,7
Panionios,5316,4,1,1,4,4,10,-6,4
AEK Athens,5317,1,4,2,0,7,1,6,14
PAOK Salonik,5317,2,2,2,2,9,5,4,8
P'thinaikos,5317,3,2,1,3,5,9,-4,7
Panionios,5317,4,1,1,4,4,10,-6,4
AEK Athens,5318,1,4,2,0,7,1,6,14
PAOK Salonik,5318,2,2,3,1,9,4,5,9
P'thinaikos,5318,3,1,2,3,4,9,-5,5
Panionios,5318,4,1,1,4,4,10,-6,4
AEK Athens,5319,1,4,2,0,7,1,6,14
PAOK Salonik,5319,2,2,3,1,9,4,5,9
P'thinaikos,5319,3,1,2,3,4,9,-5,5
Panionios,5319,4,1,1,4,4,10,-6,4
AEK Athens,5320,1,4,2,0,7,1,6,14
PAOK Salonik,5320,2,2,3,1,11,6,5,9
P'thinaikos,5320,3,1,2,3,6,11,-5,5
Panionios,5320,4,1,1,4,4,10,-6,4
AEK Athens,5321,1,4,2,0,7,1,6,14
PAOK Salonik,5321,2,3,2,1,11,4,7,11
Panionios,5321,3,1,1,4,4,10,-6,4
P'thinaikos,5321,4,1,1,4,4,11,-7,4
AEK Athens,5322,1,4,2,0,7,1,6,14
PAOK Salonik,5322,2,3,2,1,11,5,6,11
P'thinaikos,5322,3,1,1,4,5,11,-6,4
Panionios,5322,4,1,1,4,4,10,-6,4
AEK Athens,5323,1,4,2,0,7,1,6,14
PAOK Salonik,5323,2,2,2,2,10,9,1,8
P'thinaikos,5323,3,2,1,3,9,10,-1,7
Panionios,5323,4,1,1,4,4,10,-6,4
AEK Athens,5324,1,4,2,0,7,1,6,14
PAOK Salonik,5324,2,3,2,1,10,4,6,11
P'thinaikos,5324,3,1,1,4,4,10,-6,4
Panionios,5324,3,1,1,4,4,10,-6,4
AEK Athens,5325,1,4,2,0,7,1,6,14
PAOK Salonik,5325,2,2,2,2,10,8,2,8
P'thinaikos,5325,3,2,1,3,8,10,-2,7
Panionios,5325,4,1,1,4,4,10,-6,4
AEK Athens,5326,1,4,2,0,7,1,6,14
PAOK Salonik,5326,2,3,2,1,13,7,6,11
P'thinaikos,5326,3,1,1,4,7,13,-6,4
Panionios,5326,4,1,1,4,4,10,-6,4
AEK Athens,5327,1,4,2,0,7,1,6,14
PAOK Salonik,5327,2,2,2,2,11,7,4,8
P'thinaikos,5327,3,2,1,3,7,11,-4,7
Panionios,5327,4,1,1,4,4,10,-6,4
AEK Athens,5328,1,4,2,0,7,1,6,14
PAOK Salonik,5328,2,2,3,1,9,4,5,9
P'thinaikos,5328,3,1,2,3,4,9,-5,5
Panionios,5328,4,1,1,4,4,10,-6,4
AEK Athens,5329,1,4,2,0,7,1,6,14
PAOK Salonik,5329,2,2,3,1,10,5,5,9
P'thinaikos,5329,3,1,2,3,5,10,-5,5
Panionios,5329,4,1,1,4,4,10,-6,4
AEK Athens,5330,1,4,2,0,7,1,6,14
PAOK Salonik,5330,2,3,2,1,11,5,6,11
P'thinaikos,5330,3,1,1,4,5,11,-6,4
Panionios,5330,4,1,1,4,4,10,-6,4
AEK Athens,5331,1,4,2,0,7,1,6,14
PAOK Salonik,5331,2,3,2,1,13,6,7,11
Panionios,5331,3,1,1,4,4,10,-6,4
P'thinaikos,5331,4,1,1,4,6,13,-7,4
AEK Athens,5332,1,4,2,0,7,1,6,14
PAOK Salonik,5332,2,2,2,2,9,5,4,8
P'thinaikos,5332,3,2,1,3,5,9,-4,7
Panionios,5332,4,1,1,4,4,10,-6,4
AEK Athens,5333,1,4,2,0,7,1,6,14
PAOK Salonik,5333,2,2,2,2,9,5,4,8
P'thinaikos,5333,3,2,1,3,5,9,-4,7
Panionios,5333,4,1,1,4,4,10,-6,4
AEK Athens,5334,1,4,2,0,7,1,6,14
PAOK Salonik,5334,2,3,2,1,13,4,9,11
Panionios,5334,3,1,1,4,4,10,-6,4
P'thinaikos,5334,4,1,1,4,4,13,-9,4
AEK Athens,5335,1,4,2,0,7,1,6,14
PAOK Salonik,5335,2,3,2,1,11,5,6,11
P'thinaikos,5335,3,1,1,4,5,11,-6,4
Panionios,5335,4,1,1,4,4,10,-6,4
AEK Athens,5336,1,4,2,0,7,1,6,14
PAOK Salonik,5336,2,2,2,2,10,7,3,8
P'thinaikos,5336,3,2,1,3,7,10,-3,7
Panionios,5336,4,1,1,4,4,10,-6,4
AEK Athens,5337,1,4,2,0,7,1,6,14
PAOK Salonik,5337,2,2,2,2,9,7,2,8
P'thinaikos,5337,3,2,1,3,7,9,-2,7
Panionios,5337,4,1,1,4,4,10,-6,4
AEK Athens,5338,1,4,2,0,7,1,6,14
PAOK Salonik,5338,2,2,3,1,11,6,5,9
P'thinaikos,5338,3,1,2,3,6,11,-5,5
Panionios,5338,4,1,1,4,4,10,-6,4
AEK Athens,5339,1,4,2,0,7,1,6,14
PAOK Salonik,5339,2,2,2,2,9,6,3,8
P'thinaikos,5339,3,2,1,3,6,9,-3,7
Panionios,5339,4,1,1,4,4,10,-6,4
AEK Athens,5340,1,4,2,0,7,1,6,14
PAOK Salonik,5340,2,2,2,2,11,7,4,8
P'thinaikos,5340,3,2,1,3,7,11,-4,7
Panionios,5340,4,1,1,4,4,10,-6,4
AEK Athens,5341,1,4,2,0,7,1,6,14
PAOK Salonik,5341,2,2,3,1,10,5,5,9
P'thinaikos,5341,3,1,2,3,5,10,-5,5
Panionios,5341,4,1,1,4,4,10,-6,4
AEK Athens,5342,1,4,2,0,7,1,6,14
PAOK Salonik,5342,2,2,3,1,10,5,5,9
P'thinaikos,5342,3,1,2,3,5,10,-5,5
Panionios,5342,4,1,1,4,4,10,-6,4
AEK Athens,5343,1,4,2,0,7,1,6,14
PAOK Salonik,5343,2,2,2,2,10,6,4,8
P'thinaikos,5343,3,2,1,3,6,10,-4,7
Panionios,5343,4,1,1,4,4,10,-6,4
AEK Athens,5344,1,4,2,0,7,1,6,14
PAOK Salonik,5344,2,2,3,1,10,5,5,9
P'thinaikos,5344,3,1,2,3,5,10,-5,5
Panionios,5344,4,1,1,4,4,10,-6,4
AEK Athens,5345,1,4,2,0,7,1,6,14
PAOK Salonik,5345,2,3,2,1,12,6,6,11
P'thinaikos,5345,3,1,1,4,6,12,-6,4
Panionios,5345,4,1,1,4,4,10,-6,4
AEK Athens,5346,1,4,2,0,7,1,6,14
PAOK Salonik,5346,2,2,3,1,11,6,5,9
P'thinaikos,5346,3,1,2,3,6,11,-5,5
Panionios,5346,4,1,1,4,4,10,-6,4
AEK Athens,5347,1,4,2,0,7,1,6,14
PAOK Salonik,5347,2,2,3,1,9,4,5,9
P'thinaikos,5347,3,1,2,3,4,9,-5,5
Panionios,5347,4,1,1,4,4,10,-6,4
AEK Athens,5348,1,4,2,0,7,1,6,14
PAOK Salonik,5348,2,2,2,2,10,6,4,8
P'thinaikos,5348,3,2,1,3,6,10,-4,7
Panionios,5348,4,1,1,4,4,10,-6,4
AEK Athens,5349,1,4,2,0,7,1,6,14
PAOK Salonik,5349,2,2,2,2,9,5,4,8
P'thinaikos,5349,3,2,1,3,5,9,-4,7
Panionios,5349,4,1,1,4,4,10,-6,4
AEK Athens,5350,1,4,2,0,7,1,6,14
PAOK Salonik,5350,2,2,2,2,9,6,3,8
P'thinaikos,5350,3,2,1,3,6,9,-3,7
Panionios,5350,4,1,1,4,4,10,-6,4
AEK Athens,5351,1,4,2,0,7,1,6,14
PAOK Salonik,5351,2,2,2,2,9,5,4,8
P'thinaikos,5351,3,2,1,3,5,9,-4,7
Panionios,5351,4,1,1,4,4,10,-6,4
AEK Athens,5352,1,4,2,0,7,1,6,14
PAOK Salonik,5352,2,3,2,1,11,4,7,11
Panionios,5352,3,1,1,4,4,10,-6,4
P'thinaikos,5352,4,1,1,4,4,11,-7,4
AEK Athens,5353,1,4,2,0,7,1,6,14
PAOK Salonik,5353,2,2,3,1,10,5,5,9
P'thinaikos,5353,3,1,2,3,5,10,-5,5
Panionios,5353,4,1,1,4,4,10,-6,4
AEK Athens,5354,1,4,2,0,7,1,6,14
PAOK Salonik,5354,2,2,2,2,9,6,3,8
P'thinaikos,5354,3,2,1,3,6,9,-3,7
Panionios,5354,4,1,1,4,4,10,-6,4
AEK Athens,5355,1,4,2,0,7,1,6,14
PAOK Salonik,5355,2,2,3,1,11,6,5,9
P'thinaikos,5355,3,1,2,3,6,11,-5,5
Panionios,5355,4,1,1,4,4,10,-6,4
AEK Athens,5356,1,4,2,0,7,1,6,14
PAOK Salonik,5356,2,2,2,2,9,6,3,8
P'thinaikos,5356,3,2,1,3,6,9,-3,7
Panionios,5356,4,1,1,4,4,10,-6,4
AEK Athens,5357,1,4,2,0,7,1,6,14
PAOK Salonik,5357,2,2,2,2,9,6,3,8
P'thinaikos,5357,3,2,1,3,6,9,-3,7
Panionios,5357,4,1,1,4,4,10,-6,4
AEK Athens,5358,1,4,2,0,7,1,6,14
PAOK Salonik,5358,2,3,2,1,11,4,7,11
Panionios,5358,3,1,1,4,4,10,-6,4
P'thinaikos,5358,4,1,1,4,4,11,-7,4
AEK Athens,5359,1,4,2,0,7,1,6,14
PAOK Salonik,5359,2,2,2,2,10,6,4,8
P'thinaikos,5359,3,2,1,3,6,10,-4,7
Panionios,5359,4,1,1,4,4,10,-6,4
AEK Athens,5360,1,4,2,0,7,1,6,14
PAOK Salonik,5360,2,2,2,2,10,7,3,8
P'thinaikos,5360,3,2,1,3,7,10,-3,7
Panionios,5360,4,1,1,4,4,10,-6,4
AEK Athens,5361,1,4,2,0,7,1,6,14
PAOK Salonik,5361,2,2,2,2,9,7,2,8
P'thinaikos,5361,3,2,1,3,7,9,-2,7
Panionios,5361,4,1,1,4,4,10,-6,4
AEK Athens,5362,1,4,2,0,7,1,6,14
PAOK Salonik,5362,2,2,2,2,9,5,4,8
P'thinaikos,5362,3,2,1,3,5,9,-4,7
Panionios,5362,4,1,1,4,4,10,-6,4
AEK Athens,5363,1,4,2,0,7,1,6,14
PAOK Salonik,5363,2,2,2,2,10,7,3,8
P'thinaikos,5363,3,2,1,3,7,10,-3,7
Panionios,5363,4,1,1,4,4,10,-6,4
AEK Athens,5364,1,4,2,0,7,1,6,14
PAOK Salonik,5364,2,3,2,1,10,4,6,11
P'thinaikos,5364,3,1,1,4,4,10,-6,4
Panionios,5364,3,1,1,4,4,10,-6,4
AEK Athens,5365,1,4,2,0,7,1,6,14
PAOK Salonik,5365,2,2,2,2,10,7,3,8
P'thinaikos,5365,3,2,1,3,7,10,-3,7
Panionios,5365,4,1,1,4,4,10,-6,4
AEK Athens,5366,1,4,2,0,7,1,6,14
PAOK Salonik,5366,2,2,3,1,10,5,5,9
P'thinaikos,5366,3,1,2,3,5,10,-5,5
Panionios,5366,4,1,1,4,4,10,-6,4
AEK Athens,5367,1,4,2,0,7,1,6,14
PAOK Salonik,5367,2,3,2,1,11,4,7,11
Panionios,5367,3,1,1,4,4,10,-6,4
P'thinaikos,5367,4,1,1,4,4,11,-7,4
AEK Athens,5368,1,4,2,0,7,1,6,14
PAOK Salonik,5368,2,2,2,2,10,6,4,8
P'thinaikos,5368,3,2,1,3,6,10,-4,7
Panionios,5368,4,1,1,4,4,10,-6,4
AEK Athens,5369,1,4,2,0,7,1,6,14
PAOK Salonik,5369,2,2,3,1,9,4,5,9
P'thinaikos,5369,3,1,2,3,4,9,-5,5
Panionios,5369,4,1,1,4,4,10,-6,4
AEK Athens,5370,1,4,2,0,7,1,6,14
PAOK Salonik,5370,2,2,3,1,9,4,5,9
P'thinaikos,5370,3,1,2,3,4,9,-5,5
Panionios,5370,4,1,1,4,4,10,-6,4
AEK Athens,5371,1,4,2,0,7,1,6,14
PAOK Salonik,5371,2,2,3,1,11,6,5,9
P'thinaikos,5371,3,1,2,3,6,11,-5,5
Panionios,5371,4,1,1,4,4,10,-6,4
AEK Athens,5372,1,4,2,0,7,1,6,14
PAOK Salonik,5372,2,3,2,1,12,4,8,11
Panionios,5372,3,1,1,4,4,10,-6,4
P'thinaikos,5372,4,1,1,4,4,12,-8,4
AEK Athens,5373,1,4,2,0,7,1,6,14
PAOK Salonik,5373,2,2,2,2,10,7,3,8
P'thinaikos,5373,3,2,1,3,7,10,-3,7
Panionios,5373,4,1,1,4,4,10,-6,4
AEK Athens,5374,1,4,2,0,7,1,6,14
PAOK Salonik,5374,2,2,3,1,12,7,5,9
P'thinaikos,5374,3,1,2,3,7,12,-5,5
Panionios,5374,4,1,1,4,4,10,-6,4
AEK Athens,5375,1,4,2,0,7,1,6,14
PAOK Salonik,5375,2,3,2,1,10,4,6,11
P'thinaikos,5375,3,1,1,4,4,10,-6,4
Panionios,5375,3,1,1,4,4,10,-6,4
AEK Athens,5376,1,4,2,0,7,1,6,14
PAOK Salonik,5376,2,3,2,1,11,5,6,11
P'thinaikos,5376,3,1,1,4,5,11,-6,4
Panionios,5376,4,1,1,4,4,10,-6,4
AEK Athens,5377,1,4,2,0,7,1,6,14
PAOK Salonik,5377,2,2,2,2,10,6,4,8
P'thinaikos,5377,3,2,1,3,6,10,-4,7
Panionios,5377,4,1,1,4,4,10,-6,4
AEK Athens,5378,1,4,2,0,7,1,6,14
PAOK Salonik,5378,2,2,2,2,10,7,3,8
P'thinaikos,5378,3,2,1,3,7,10,-3,7
Panionios,5378,4,1,1,4,4,10,-6,4
AEK Athens,5379,1,4,2,0,7,1,6,14
PAOK Salonik,5379,2,3,2,1,10,4,6,11
P'thinaikos,5379,3,1,1,4,4,10,-6,4
Panionios,5379,3,1,1,4,4,10,-6,4
AEK Athens,5380,1,4,2,0,7,1,6,14
PAOK Salonik,5380,2,2,3,1,9,4,5,9
P'thinaikos,5380,3,1,2,3,4,9,-5,5
Panionios,5380,4,1,1,4,4,10,-6,4
AEK Athens,5381,1,4,2,0,7,1,6,14
PAOK Salonik,5381,2,2,2,2,10,6,4,8
P'thinaikos,5381,3,2,1,3,6,10,-4,7
Panionios,5381,4,1,1,4,4,10,-6,4
AEK Athens,5382,1,4,2,0,7,1,6,14
PAOK Salonik,5382,2,3,2,1,14,4,10,11
Panionios,5382,3,1,1,4,4,10,-6,4
P'thinaikos,5382,4,1,1,4,4,14,-10,4
AEK Athens,5383,1,4,2,0,7,1,6,14
PAOK Salonik,5383,2,2,3,1,10,5,5,9
P'thinaikos,5383,3,1,2,3,5,10,-5,5
Panionios,5383,4,1,1,4,4,10,-6,4
AEK Athens,5384,1,4,2,0,7,1,6,14
PAOK Salonik,5384,2,2,2,2,9,5,4,8
P'thinaikos,5384,3,2,1,3,5,9,-4,7
Panionios,5384,4,1,1,4,4,10,-6,4
AEK Athens,5385,1,4,2,0,7,1,6,14
PAOK Salonik,5385,2,3,2,1,12,5,7,11
Panionios,5385,3,1,1,4,4,10,-6,4
P'thinaikos,5385,4,1,1,4,5,12,-7,4
AEK Athens,5386,1,4,2,0,7,1,6,14
PAOK Salonik,5386,2,2,3,1,10,5,5,9
P'thinaikos,5386,3,1,2,3,5,10,-5,5
Panionios,5386,4,1,1,4,4,10,-6,4
AEK Athens,5387,1,4,2,0,7,1,6,14
PAOK Salonik,5387,2,2,3,1,10,5,5,9
P'thinaikos,5387,3,1,2,3,5,10,-5,5
Panionios,5387,4,1,1,4,4,10,-6,4
AEK Athens,5388,1,4,2,0,7,1,6,14
PAOK Salonik,5388,2,2,2,2,10,6,4,8
P'thinaikos,5388,3,2,1,3,6,10,-4,7
Panionios,5388,4,1,1,4,4,10,-6,4
AEK Athens,5389,1,4,2,0,7,1,6,14
PAOK Salonik,5389,2,3,2,1,12,5,7,11
Panionios,5389,3,1,1,4,4,10,-6,4
P'thinaikos,5389,4,1,1,4,5,12,-7,4
AEK Athens,5390,1,4,2,0,7,1,6,14
PAOK Salonik,5390,2,2,2,2,10,6,4,8
P'thinaikos,5390,3,2,1,3,6,10,-4,7
Panionios,5390,4,1,1,4,4,10,-6,4
AEK Athens,5391,1,4,2,0,7,1,6,14
PAOK Salonik,5391,2,2,2,2,10,7,3,8
P'thinaikos,5391,3,2,1,3,7,10,-3,7
Panionios,5391,4,1,1,4,4,10,-6,4
AEK Athens,5392,1,4,2,0,7,1,6,14
PAOK Salonik,5392,2,3,2,1,11,4,7,11
Panionios,5392,3,1,1,4,4,10,-6,4
P'thinaikos,5392,4,1,1,4,4,11,-7,4
AEK Athens,5393,1,4,2,0,7,1,6,14
PAOK Salonik,5393,2,3,2,1,10,4,6,11
P'thinaikos,5393,3,1,1,4,4,10,-6,4
Panionios,5393,3,1,1,4,4,10,-6,4
AEK Athens,5394,1,4,2,0,7,1,6,14
PAOK Salonik,5394,2,2,2,2,9,6,3,8
P'thinaikos,5394,3,2,1,3,6,9,-3,7
Panionios,5394,4,1,1,4,4,10,-6,4
AEK Athens,5395,1,4,2,0,7,1,6,14
PAOK Salonik,5395,2,2,3,1,10,5,5,9
P'thinaikos,5395,3,1,2,3,5,10,-5,5
Panionios,5395,4,1,1,4,4,10,-6,4
AEK Athens,5396,1,4,2,0,7,1,6,14
PAOK Salonik,5396,2,2,2,2,10,8,2,8
P'thinaikos,5396,3,2,1,3,8,10,-2,7
Panionios,5396,4,1,1,4,4,10,-6,4
AEK Athens,5397,1,4,2,0,7,1,6,14
PAOK Salonik,5397,2,2,2,2,10,7,3,8
P'thinaikos,5397,3,2,1,3,7,10,-3,7
Panionios,5397,4,1,1,4,4,10,-6,4
AEK Athens,5398,1,4,2,0,7,1,6,14
PAOK Salonik,5398,2,2,3,1,10,5,5,9
P'thinaikos,5398,3,1,2,3,5,10,-5,5
Panionios,5398,4,1,1,4,4,10,-6,4
AEK Athens,5399,1,4,2,0,7,1,6,14
PAOK Salonik,5399,2,2,3,1,10,5,5,9
P'thinaikos,5399,3,1,2,3,5,10,-5,5
Panionios,5399,4,1,1,4,4,10,-6,4
AEK Athens,5400,1,4,2,0,7,1,6,14
PAOK Salonik,5400,2,3,2,1,10,4,6,11
P'thinaikos,5400,3,1,1,4,4,10,-6,4
Panionios,5400,3,1,1,4,4,10,-6,4
AEK Athens,5401,1,4,2,0,7,1,6,14
PAOK Salonik,5401,2,2,2,2,10,6,4,8
P'thinaikos,5401,3,2,1,3,6,10,-4,7
Panionios,5401,4,1,1,4,4,10,-6,4
AEK Athens,5402,1,4,2,0,7,1,6,14
PAOK Salonik,5402,2,2,2,2,10,6,4,8
P'thinaikos,5402,3,2,1,3,6,10,-4,7
Panionios,5402,4,1,1,4,4,10,-6,4
AEK Athens,5403,1,4,2,0,7,1,6,14
PAOK Salonik,5403,2,2,3,1,11,6,5,9
P'thinaikos,5403,3,1,2,3,6,11,-5,5
Panionios,5403,4,1,1,4,4,10,-6,4
AEK Athens,5404,1,4,2,0,7,1,6,14
PAOK Salonik,5404,2,2,3,1,11,6,5,9
P'thinaikos,5404,3,1,2,3,6,11,-5,5
Panionios,5404,4,1,1,4,4,10,-6,4
AEK Athens,5405,1,4,2,0,7,1,6,14
PAOK Salonik,5405,2,2,3,1,9,4,5,9
P'thinaikos,5405,3,1,2,3,4,9,-5,5
Panionios,5405,4,1,1,4,4,10,-6,4
AEK Athens,5406,1,4,2,0,7,1,6,14
PAOK Salonik,5406,2,2,2,2,12,8,4,8
P'thinaikos,5406,3,2,1,3,8,12,-4,7
Panionios,5406,4,1,1,4,4,10,-6,4
AEK Athens,5407,1,4,2,0,7,1,6,14
PAOK Salonik,5407,2,2,2,2,9,5,4,8
P'thinaikos,5407,3,2,1,3,5,9,-4,7
Panionios,5407,4,1,1,4,4,10,-6,4
AEK Athens,5408,1,4,2,0,7,1,6,14
PAOK Salonik,5408,2,2,3,1,10,5,5,9
P'thinaikos,5408,3,1,2,3,5,10,-5,5
Panionios,5408,4,1,1,4,4,10,-6,4
AEK Athens,5409,1,4,2,0,7,1,6,14
PAOK Salonik,5409,2,3,2,1,11,5,6,11
P'thinaikos,5409,3,1,1,4,5,11,-6,4
Panionios,5409,4,1,1,4,4,10,-6,4
AEK Athens,5410,1,4,2,0,7,1,6,14
PAOK Salonik,5410,2,3,2,1,12,4,8,11
Panionios,5410,3,1,1,4,4,10,-6,4
P'thinaikos,5410,4,1,1,4,4,12,-8,4
AEK Athens,5411,1,4,2,0,7,1,6,14
PAOK Salonik,5411,2,2,2,2,10,9,1,8
P'thinaikos,5411,3,2,1,3,9,10,-1,7
Panionios,5411,4,1,1,4,4,10,-6,4
AEK Athens,5412,1,4,2,0,7,1,6,14
PAOK Salonik,5412,2,3,2,1,14,5,9,11
Panionios,5412,3,1,1,4,4,10,-6,4
P'thinaikos,5412,4,1,1,4,5,14,-9,4
AEK Athens,5413,1,4,2,0,7,1,6,14
PAOK Salonik,5413,2,3,2,1,11,5,6,11
P'thinaikos,5413,3,1,1,4,5,11,-6,4
Panionios,5413,4,1,1,4,4,10,-6,4
AEK Athens,5414,1,4,2,0,7,1,6,14
PAOK Salonik,5414,2,3,2,1,11,5,6,11
P'thinaikos,5414,3,1,1,4,5,11,-6,4
Panionios,5414,4,1,1,4,4,10,-6,4
AEK Athens,5415,1,4,2,0,7,1,6,14
PAOK Salonik,5415,2,2,2,2,9,6,3,8
P'thinaikos,5415,3,2,1,3,6,9,-3,7
Panionios,5415,4,1,1,4,4,10,-6,4
AEK Athens,5416,1,4,2,0,7,1,6,14
PAOK Salonik,5416,2,2,3,1,12,7,5,9
P'thinaikos,5416,3,1,2,3,7,12,-5,5
Panionios,5416,4,1,1,4,4,10,-6,4
AEK Athens,5417,1,4,2,0,7,1,6,14
PAOK Salonik,5417,2,2,2,2,10,6,4,8
P'thinaikos,5417,3,2,1,3,6,10,-4,7
Panionios,5417,4,1,1,4,4,10,-6,4
AEK Athens,5418,1,4,2,0,7,1,6,14
PAOK Salonik,5418,2,3,2,1,11,5,6,11
P'thinaikos,5418,3,1,1,4,5,11,-6,4
Panionios,5418,4,1,1,4,4,10,-6,4
AEK Athens,5419,1,4,2,0,7,1,6,14
PAOK Salonik,5419,2,2,2,2,10,7,3,8
P'thinaikos,5419,3,2,1,3,7,10,-3,7
Panionios,5419,4,1,1,4,4,10,-6,4
AEK Athens,5420,1,4,2,0,7,1,6,14
PAOK Salonik,5420,2,2,3,1,10,5,5,9
P'thinaikos,5420,3,1,2,3,5,10,-5,5
Panionios,5420,4,1,1,4,4,10,-6,4
AEK Athens,5421,1,4,2,0,7,1,6,14
PAOK Salonik,5421,2,2,3,1,9,4,5,9
P'thinaikos,5421,3,1,2,3,4,9,-5,5
Panionios,5421,4,1,1,4,4,10,-6,4
AEK Athens,5422,1,4,2,0,7,1,6,14
PAOK Salonik,5422,2,3,2,1,12,5,7,11
Panionios,5422,3,1,1,4,4,10,-6,4
P'thinaikos,5422,4,1,1,4,5,12,-7,4
AEK Athens,5423,1,4,2,0,7,1,6,14
PAOK Salonik,5423,2,2,2,2,9,8,1,8
P'thinaikos,5423,3,2,1,3,8,9,-1,7
Panionios,5423,4,1,1,4,4,10,-6,4
AEK Athens,5424,1,4,2,0,7,1,6,14
PAOK Salonik,5424,2,2,3,1,10,5,5,9
P'thinaikos,5424,3,1,2,3,5,10,-5,5
Panionios,5424,4,1,1,4,4,10,-6,4
AEK Athens,5425,1,4,2,0,7,1,6,14
PAOK Salonik,5425,2,2,2,2,9,6,3,8
P'thinaikos,5425,3,2,1,3,6,9,-3,7
Panionios,5425,4,1,1,4,4,10,-6,4
AEK Athens,5426,1,4,2,0,7,1,6,14
PAOK Salonik,5426,2,2,2,2,10,9,1,8
P'thinaikos,5426,3,2,1,3,9,10,-1,7
Panionios,5426,4,1,1,4,4,10,-6,4
AEK Athens,5427,1,4,2,0,7,1,6,14
PAOK Salonik,5427,2,2,3,1,10,5,5,9
P'thinaikos,5427,3,1,2,3,5,10,-5,5
Panionios,5427,4,1,1,4,4,10,-6,4
AEK Athens,5428,1,4,2,0,7,1,6,14
PAOK Salonik,5428,2,2,2,2,10,7,3,8
P'thinaikos,5428,3,2,1,3,7,10,-3,7
Panionios,5428,4,1,1,4,4,10,-6,4
AEK Athens,5429,1,4,2,0,7,1,6,14
PAOK Salonik,5429,2,2,3,1,11,6,5,9
P'thinaikos,5429,3,1,2,3,6,11,-5,5
Panionios,5429,4,1,1,4,4,10,-6,4
AEK Athens,5430,1,4,2,0,7,1,6,14
PAOK Salonik,5430,2,3,2,1,11,4,7,11
Panionios,5430,3,1,1,4,4,10,-6,4
P'thinaikos,5430,4,1,1,4,4,11,-7,4
AEK Athens,5431,1,4,2,0,7,1,6,14
PAOK Salonik,5431,2,2,3,1,11,6,5,9
P'thinaikos,5431,3,1,2,3,6,11,-5,5
Panionios,5431,4,1,1,4,4,10,-6,4
AEK Athens,5432,1,4,2,0,7,1,6,14
PAOK Salonik,5432,2,2,3,1,10,5,5,9
P'thinaikos,5432,3,1,2,3,5,10,-5,5
Panionios,5432,4,1,1,4,4,10,-6,4
AEK Athens,5433,1,4,2,0,7,1,6,14
PAOK Salonik,5433,2,3,2,1,11,5,6,11
P'thinaikos,5433,3,1,1,4,5,11,-6,4
Panionios,5433,4,1,1,4,4,10,-6,4
AEK Athens,5434,1,4,2,0,7,1,6,14
PAOK Salonik,5434,2,2,2,2,9,5,4,8
P'thinaikos,5434,3,2,1,3,5,9,-4,7
Panionios,5434,4,1,1,4,4,10,-6,4
AEK Athens,5435,1,4,2,0,7,1,6,14
PAOK Salonik,5435,2,2,3,1,9,4,5,9
P'thinaikos,5435,3,1,2,3,4,9,-5,5
Panionios,5435,4,1,1,4,4,10,-6,4
AEK Athens,5436,1,4,2,0,7,1,6,14
PAOK Salonik,5436,2,2,3,1,10,5,5,9
P'thinaikos,5436,3,1,2,3,5,10,-5,5
Panionios,5436,4,1,1,4,4,10,-6,4
AEK Athens,5437,1,4,2,0,7,1,6,14
PAOK Salonik,5437,2,2,2,2,9,6,3,8
P'thinaikos,5437,3,2,1,3,6,9,-3,7
Panionios,5437,4,1,1,4,4,10,-6,4
AEK Athens,5438,1,4,2,0,7,1,6,14
PAOK Salonik,5438,2,3,2,1,13,5,8,11
Panionios,5438,3,1,1,4,4,10,-6,4
P'thinaikos,5438,4,1,1,4,5,13,-8,4
AEK Athens,5439,1,4,2,0,7,1,6,14
PAOK Salonik,5439,2,2,2,2,9,5,4,8
P'thinaikos,5439,3,2,1,3,5,9,-4,7
Panionios,5439,4,1,1,4,4,10,-6,4
AEK Athens,5440,1,4,2,0,7,1,6,14
PAOK Salonik,5440,2,2,2,2,9,6,3,8
P'thinaikos,5440,3,2,1,3,6,9,-3,7
Panionios,5440,4,1,1,4,4,10,-6,4
AEK Athens,5441,1,4,2,0,7,1,6,14
PAOK Salonik,5441,2,2,3,1,9,4,5,9
P'thinaikos,5441,3,1,2,3,4,9,-5,5
Panionios,5441,4,1,1,4,4,10,-6,4
AEK Athens,5442,1,4,2,0,7,1,6,14
PAOK Salonik,5442,2,2,2,2,9,5,4,8
P'thinaikos,5442,3,2,1,3,5,9,-4,7
Panionios,5442,4,1,1,4,4,10,-6,4
AEK Athens,5443,1,4,2,0,7,1,6,14
PAOK Salonik,5443,2,3,2,1,12,5,7,11
Panionios,5443,3,1,1,4,4,10,-6,4
P'thinaikos,5443,4,1,1,4,5,12,-7,4
AEK Athens,5444,1,4,2,0,7,1,6,14
PAOK Salonik,5444,2,2,3,1,10,5,5,9
P'thinaikos,5444,3,1,2,3,5,10,-5,5
Panionios,5444,4,1,1,4,4,10,-6,4
AEK Athens,5445,1,4,2,0,7,1,6,14
PAOK Salonik,5445,2,2,2,2,11,9,2,8
P'thinaikos,5445,3,2,1,3,9,11,-2,7
Panionios,5445,4,1,1,4,4,10,-6,4
AEK Athens,5446,1,4,2,0,7,1,6,14
PAOK Salonik,5446,2,2,2,2,9,5,4,8
P'thinaikos,5446,3,2,1,3,5,9,-4,7
Panionios,5446,4,1,1,4,4,10,-6,4
AEK Athens,5447,1,4,2,0,7,1,6,14
PAOK Salonik,5447,2,3,2,1,11,4,7,11
Panionios,5447,3,1,1,4,4,10,-6,4
P'thinaikos,5447,4,1,1,4,4,11,-7,4
AEK Athens,5448,1,4,2,0,7,1,6,14
PAOK Salonik,5448,2,2,3,1,10,5,5,9
P'thinaikos,5448,3,1,2,3,5,10,-5,5
Panionios,5448,4,1,1,4,4,10,-6,4
AEK Athens,5449,1,4,2,0,7,1,6,14
PAOK Salonik,5449,2,2,2,2,9,5,4,8
P'thinaikos,5449,3,2,1,3,5,9,-4,7
Panionios,5449,4,1,1,4,4,10,-6,4
AEK Athens,5450,1,4,2,0,7,1,6,14
PAOK Salonik,5450,2,2,3,1,9,4,5,9
P'thinaikos,5450,3,1,2,3,4,9,-5,5
Panionios,5450,4,1,1,4,4,10,-6,4
AEK Athens,5451,1,4,2,0,7,1,6,14
PAOK Salonik,5451,2,2,2,2,9,5,4,8
P'thinaikos,5451,3,2,1,3,5,9,-4,7
Panionios,5451,4,1,1,4,4,10,-6,4
AEK Athens,5452,1,4,2,0,7,1,6,14
PAOK Salonik,5452,2,2,2,2,9,5,4,8
P'thinaikos,5452,3,2,1,3,5,9,-4,7
Panionios,5452,4,1,1,4,4,10,-6,4
AEK Athens,5453,1,4,2,0,7,1,6,14
PAOK Salonik,5453,2,3,2,1,11,5,6,11
P'thinaikos,5453,3,1,1,4,5,11,-6,4
Panionios,5453,4,1,1,4,4,10,-6,4
AEK Athens,5454,1,4,2,0,7,1,6,14
PAOK Salonik,5454,2,2,3,1,10,5,5,9
P'thinaikos,5454,3,1,2,3,5,10,-5,5
Panionios,5454,4,1,1,4,4,10,-6,4
AEK Athens,5455,1,4,2,0,7,1,6,14
PAOK Salonik,5455,2,3,2,1,10,4,6,11
P'thinaikos,5455,3,1,1,4,4,10,-6,4
Panionios,5455,3,1,1,4,4,10,-6,4
AEK Athens,5456,1,4,2,0,7,1,6,14
PAOK Salonik,5456,2,3,2,1,11,4,7,11
Panionios,5456,3,1,1,4,4,10,-6,4
P'thinaikos,5456,4,1,1,4,4,11,-7,4
AEK Athens,5457,1,4,2,0,7,1,6,14
PAOK Salonik,5457,2,3,2,1,10,4,6,11
P'thinaikos,5457,3,1,1,4,4,10,-6,4
Panionios,5457,3,1,1,4,4,10,-6,4
AEK Athens,5458,1,4,2,0,7,1,6,14
PAOK Salonik,5458,2,3,2,1,10,4,6,11
P'thinaikos,5458,3,1,1,4,4,10,-6,4
Panionios,5458,3,1,1,4,4,10,-6,4
AEK Athens,5459,1,4,2,0,7,1,6,14
PAOK Salonik,5459,2,3,2,1,10,4,6,11
P'thinaikos,5459,3,1,1,4,4,10,-6,4
Panionios,5459,3,1,1,4,4,10,-6,4
AEK Athens,5460,1,4,2,0,7,1,6,14
PAOK Salonik,5460,2,2,3,1,9,4,5,9
P'thinaikos,5460,3,1,2,3,4,9,-5,5
Panionios,5460,4,1,1,4,4,10,-6,4
AEK Athens,5461,1,4,2,0,7,1,6,14
PAOK Salonik,5461,2,3,2,1,13,4,9,11
Panionios,5461,3,1,1,4,4,10,-6,4
P'thinaikos,5461,4,1,1,4,4,13,-9,4
AEK Athens,5462,1,4,2,0,7,1,6,14
PAOK Salonik,5462,2,2,2,2,10,6,4,8
P'thinaikos,5462,3,2,1,3,6,10,-4,7
Panionios,5462,4,1,1,4,4,10,-6,4
AEK Athens,5463,1,4,2,0,7,1,6,14
PAOK Salonik,5463,2,2,2,2,9,5,4,8
P'thinaikos,5463,3,2,1,3,5,9,-4,7
Panionios,5463,4,1,1,4,4,10,-6,4
AEK Athens,5464,1,4,2,0,7,1,6,14
PAOK Salonik,5464,2,2,3,1,10,5,5,9
P'thinaikos,5464,3,1,2,3,5,10,-5,5
Panionios,5464,4,1,1,4,4,10,-6,4
AEK Athens,5465,1,4,2,0,7,1,6,14
PAOK Salonik,5465,2,2,3,1,9,4,5,9
P'thinaikos,5465,3,1,2,3,4,9,-5,5
Panionios,5465,4,1,1,4,4,10,-6,4
AEK Athens,5466,1,4,2,0,7,1,6,14
PAOK Salonik,5466,2,2,3,1,9,4,5,9
P'thinaikos,5466,3,1,2,3,4,9,-5,5
Panionios,5466,4,1,1,4,4,10,-6,4
AEK Athens,5467,1,4,2,0,7,1,6,14
PAOK Salonik,5467,2,2,2,2,10,8,2,8
P'thinaikos,5467,3,2,1,3,8,10,-2,7
Panionios,5467,4,1,1,4,4,10,-6,4
AEK Athens,5468,1,4,2,0,7,1,6,14
PAOK Salonik,5468,2,2,3,1,10,5,5,9
P'thinaikos,5468,3,1,2,3,5,10,-5,5
Panionios,5468,4,1,1,4,4,10,-6,4
AEK Athens,5469,1,4,2,0,7,1,6,14
PAOK Salonik,5469,2,2,2,2,11,7,4,8
P'thinaikos,5469,3,2,1,3,7,11,-4,7
Panionios,5469,4,1,1,4,4,10,-6,4
AEK Athens,5470,1,4,2,0,7,1,6,14
PAOK Salonik,5470,2,2,3,1,9,4,5,9
P'thinaikos,5470,3,1,2,3,4,9,-5,5
Panionios,5470,4,1,1,4,4,10,-6,4
AEK Athens,5471,1,4,2,0,7,1,6,14
PAOK Salonik,5471,2,3,2,1,14,6,8,11
Panionios,5471,3,1,1,4,4,10,-6,4
P'thinaikos,5471,4,1,1,4,6,14,-8,4
AEK Athens,5472,1,4,2,0,7,1,6,14
PAOK Salonik,5472,2,2,2,2,9,5,4,8
P'thinaikos,5472,3,2,1,3,5,9,-4,7
Panionios,5472,4,1,1,4,4,10,-6,4
AEK Athens,5473,1,4,2,0,7,1,6,14
PAOK Salonik,5473,2,2,3,1,10,5,5,9
P'thinaikos,5473,3,1,2,3,5,10,-5,5
Panionios,5473,4,1,1,4,4,10,-6,4
AEK Athens,5474,1,4,2,0,7,1,6,14
PAOK Salonik,5474,2,3,2,1,10,4,6,11
P'thinaikos,5474,3,1,1,4,4,10,-6,4
Panionios,5474,3,1,1,4,4,10,-6,4
AEK Athens,5475,1,4,2,0,7,1,6,14
PAOK Salonik,5475,2,2,3,1,10,5,5,9
P'thinaikos,5475,3,1,2,3,5,10,-5,5
Panionios,5475,4,1,1,4,4,10,-6,4
AEK Athens,5476,1,4,2,0,7,1,6,14
PAOK Salonik,5476,2,2,3,1,10,5,5,9
P'thinaikos,5476,3,1,2,3,5,10,-5,5
Panionios,5476,4,1,1,4,4,10,-6,4
AEK Athens,5477,1,4,2,0,7,1,6,14
PAOK Salonik,5477,2,2,3,1,9,4,5,9
P'thinaikos,5477,3,1,2,3,4,9,-5,5
Panionios,5477,4,1,1,4,4,10,-6,4
AEK Athens,5478,1,4,2,0,7,1,6,14
PAOK Salonik,5478,2,2,3,1,9,4,5,9
P'thinaikos,5478,3,1,2,3,4,9,-5,5
Panionios,5478,4,1,1,4,4,10,-6,4
AEK Athens,5479,1,4,2,0,7,1,6,14
PAOK Salonik,5479,2,2,2,2,9,6,3,8
P'thinaikos,5479,3,2,1,3,6,9,-3,7
Panionios,5479,4,1,1,4,4,10,-6,4
AEK Athens,5480,1,4,2,0,7,1,6,14
PAOK Salonik,5480,2,3,2,1,10,4,6,11
P'thinaikos,5480,3,1,1,4,4,10,-6,4
Panionios,5480,3,1,1,4,4,10,-6,4
AEK Athens,5481,1,4,2,0,7,1,6,14
PAOK Salonik,5481,2,3,2,1,11,5,6,11
P'thinaikos,5481,3,1,1,4,5,11,-6,4
Panionios,5481,4,1,1,4,4,10,-6,4
AEK Athens,5482,1,4,2,0,7,1,6,14
PAOK Salonik,5482,2,2,2,2,10,6,4,8
P'thinaikos,5482,3,2,1,3,6,10,-4,7
Panionios,5482,4,1,1,4,4,10,-6,4
AEK Athens,5483,1,4,2,0,7,1,6,14
PAOK Salonik,5483,2,2,2,2,10,7,3,8
P'thinaikos,5483,3,2,1,3,7,10,-3,7
Panionios,5483,4,1,1,4,4,10,-6,4
AEK Athens,5484,1,4,2,0,7,1,6,14
PAOK Salonik,5484,2,2,2,2,9,8,1,8
P'thinaikos,5484,3,2,1,3,8,9,-1,7
Panionios,5484,4,1,1,4,4,10,-6,4
AEK Athens,5485,1,4,2,0,7,1,6,14
PAOK Salonik,5485,2,2,2,2,12,8,4,8
P'thinaikos,5485,3,2,1,3,8,12,-4,7
Panionios,5485,4,1,1,4,4,10,-6,4
AEK Athens,5486,1,4,2,0,7,1,6,14
PAOK Salonik,5486,2,3,2,1,11,5,6,11
P'thinaikos,5486,3,1,1,4,5,11,-6,4
Panionios,5486,4,1,1,4,4,10,-6,4
AEK Athens,5487,1,4,2,0,7,1,6,14
PAOK Salonik,5487,2,3,2,1,11,4,7,11
Panionios,5487,3,1,1,4,4,10,-6,4
P'thinaikos,5487,4,1,1,4,4,11,-7,4
AEK Athens,5488,1,4,2,0,7,1,6,14
PAOK Salonik,5488,2,2,2,2,9,5,4,8
P'thinaikos,5488,3,2,1,3,5,9,-4,7
Panionios,5488,4,1,1,4,4,10,-6,4
AEK Athens,5489,1,4,2,0,7,1,6,14
PAOK Salonik,5489,2,3,2,1,10,4,6,11
P'thinaikos,5489,3,1,1,4,4,10,-6,4
Panionios,5489,3,1,1,4,4,10,-6,4
AEK Athens,5490,1,4,2,0,7,1,6,14
PAOK Salonik,5490,2,3,2,1,10,4,6,11
P'thinaikos,5490,3,1,1,4,4,10,-6,4
Panionios,5490,3,1,1,4,4,10,-6,4
AEK Athens,5491,1,4,2,0,7,1,6,14
PAOK Salonik,5491,2,2,2,2,9,8,1,8
P'thinaikos,5491,3,2,1,3,8,9,-1,7
Panionios,5491,4,1,1,4,4,10,-6,4
AEK Athens,5492,1,4,2,0,7,1,6,14
PAOK Salonik,5492,2,2,2,2,10,6,4,8
P'thinaikos,5492,3,2,1,3,6,10,-4,7
Panionios,5492,4,1,1,4,4,10,-6,4
AEK Athens,5493,1,4,2,0,7,1,6,14
PAOK Salonik,5493,2,2,2,2,9,5,4,8
P'thinaikos,5493,3,2,1,3,5,9,-4,7
Panionios,5493,4,1,1,4,4,10,-6,4
AEK Athens,5494,1,4,2,0,7,1,6,14
PAOK Salonik,5494,2,2,3,1,9,4,5,9
P'thinaikos,5494,3,1,2,3,4,9,-5,5
Panionios,5494,4,1,1,4,4,10,-6,4
AEK Athens,5495,1,4,2,0,7,1,6,14
PAOK Salonik,5495,2,3,2,1,11,5,6,11
P'thinaikos,5495,3,1,1,4,5,11,-6,4
Panionios,5495,4,1,1,4,4,10,-6,4
AEK Athens,5496,1,4,2,0,7,1,6,14
PAOK Salonik,5496,2,3,2,1,12,5,7,11
Panionios,5496,3,1,1,4,4,10,-6,4
P'thinaikos,5496,4,1,1,4,5,12,-7,4
AEK Athens,5497,1,4,2,0,7,1,6,14
PAOK Salonik,5497,2,2,2,2,9,6,3,8
P'thinaikos,5497,3,2,1,3,6,9,-3,7
Panionios,5497,4,1,1,4,4,10,-6,4
AEK Athens,5498,1,4,2,0,7,1,6,14
PAOK Salonik,5498,2,3,2,1,10,4,6,11
P'thinaikos,5498,3,1,1,4,4,10,-6,4
Panionios,5498,3,1,1,4,4,10,-6,4
AEK Athens,5499,1,4,2,0,7,1,6,14
PAOK Salonik,5499,2,2,3,1,9,4,5,9
P'thinaikos,5499,3,1,2,3,4,9,-5,5
Panionios,5499,4,1,1,4,4,10,-6,4
AEK Athens,5500,1,4,2,0,7,1,6,14
PAOK Salonik,5500,2,2,2,2,10,6,4,8
P'thinaikos,5500,3,2,1,3,6,10,-4,7
Panionios,5500,4,1,1,4,4,10,-6,4
AEK Athens,5501,1,4,2,0,7,1,6,14
PAOK Salonik,5501,2,2,2,2,11,7,4,8
P'thinaikos,5501,3,2,1,3,7,11,-4,7
Panionios,5501,4,1,1,4,4,10,-6,4
AEK Athens,5502,1,4,2,0,7,1,6,14
PAOK Salonik,5502,2,2,2,2,9,6,3,8
P'thinaikos,5502,3,2,1,3,6,9,-3,7
Panionios,5502,4,1,1,4,4,10,-6,4
AEK Athens,5503,1,4,2,0,7,1,6,14
PAOK Salonik,5503,2,2,3,1,10,5,5,9
P'thinaikos,5503,3,1,2,3,5,10,-5,5
Panionios,5503,4,1,1,4,4,10,-6,4
AEK Athens,5504,1,4,2,0,7,1,6,14
PAOK Salonik,5504,2,3,2,1,10,4,6,11
P'thinaikos,5504,3,1,1,4,4,10,-6,4
Panionios,5504,3,1,1,4,4,10,-6,4
AEK Athens,5505,1,4,2,0,7,1,6,14
PAOK Salonik,5505,2,2,3,1,9,4,5,9
P'thinaikos,5505,3,1,2,3,4,9,-5,5
Panionios,5505,4,1,1,4,4,10,-6,4
AEK Athens,5506,1,4,2,0,7,1,6,14
PAOK Salonik,5506,2,2,2,2,10,6,4,8
P'thinaikos,5506,3,2,1,3,6,10,-4,7
Panionios,5506,4,1,1,4,4,10,-6,4
AEK Athens,5507,1,4,2,0,7,1,6,14
PAOK Salonik,5507,2,2,2,2,9,6,3,8
P'thinaikos,5507,3,2,1,3,6,9,-3,7
Panionios,5507,4,1,1,4,4,10,-6,4
AEK Athens,5508,1,4,2,0,7,1,6,14
PAOK Salonik,5508,2,2,2,2,9,5,4,8
P'thinaikos,5508,3,2,1,3,5,9,-4,7
Panionios,5508,4,1,1,4,4,10,-6,4
AEK Athens,5509,1,4,2,0,7,1,6,14
PAOK Salonik,5509,2,2,2,2,10,6,4,8
P'thinaikos,5509,3,2,1,3,6,10,-4,7
Panionios,5509,4,1,1,4,4,10,-6,4
AEK Athens,5510,1,4,2,0,7,1,6,14
PAOK Salonik,5510,2,2,2,2,9,5,4,8
P'thinaikos,5510,3,2,1,3,5,9,-4,7
Panionios,5510,4,1,1,4,4,10,-6,4
AEK Athens,5511,1,4,2,0,7,1,6,14
PAOK Salonik,5511,2,3,2,1,12,4,8,11
Panionios,5511,3,1,1,4,4,10,-6,4
P'thinaikos,5511,4,1,1,4,4,12,-8,4
AEK Athens,5512,1,4,2,0,7,1,6,14
PAOK Salonik,5512,2,2,2,2,10,8,2,8
P'thinaikos,5512,3,2,1,3,8,10,-2,7
Panionios,5512,4,1,1,4,4,10,-6,4
AEK Athens,5513,1,4,2,0,7,1,6,14
PAOK Salonik,5513,2,2,3,1,10,5,5,9
P'thinaikos,5513,3,1,2,3,5,10,-5,5
Panionios,5513,4,1,1,4,4,10,-6,4
AEK Athens,5514,1,4,2,0,7,1,6,14
PAOK Salonik,5514,2,3,2,1,11,5,6,11
P'thinaikos,5514,3,1,1,4,5,11,-6,4
Panionios,5514,4,1,1,4,4,10,-6,4
AEK Athens,5515,1,4,2,0,7,1,6,14
PAOK Salonik,5515,2,2,3,1,10,5,5,9
P'thinaikos,5515,3,1,2,3,5,10,-5,5
Panionios,5515,4,1,1,4,4,10,-6,4
AEK Athens,5516,1,4,2,0,7,1,6,14
PAOK Salonik,5516,2,2,2,2,12,10,2,8
P'thinaikos,5516,3,2,1,3,10,12,-2,7
Panionios,5516,4,1,1,4,4,10,-6,4
AEK Athens,5517,1,4,2,0,7,1,6,14
PAOK Salonik,5517,2,3,2,1,11,4,7,11
Panionios,5517,3,1,1,4,4,10,-6,4
P'thinaikos,5517,4,1,1,4,4,11,-7,4
AEK Athens,5518,1,4,2,0,7,1,6,14
PAOK Salonik,5518,2,2,2,2,9,5,4,8
P'thinaikos,5518,3,2,1,3,5,9,-4,7
Panionios,5518,4,1,1,4,4,10,-6,4
AEK Athens,5519,1,4,2,0,7,1,6,14
PAOK Salonik,5519,2,3,2,1,12,4,8,11
Panionios,5519,3,1,1,4,4,10,-6,4
P'thinaikos,5519,4,1,1,4,4,12,-8,4
AEK Athens,5520,1,4,2,0,7,1,6,14
PAOK Salonik,5520,2,2,3,1,10,5,5,9
P'thinaikos,5520,3,1,2,3,5,10,-5,5
Panionios,5520,4,1,1,4,4,10,-6,4
AEK Athens,5521,1,4,2,0,7,1,6,14
PAOK Salonik,5521,2,2,2,2,11,7,4,8
P'thinaikos,5521,3,2,1,3,7,11,-4,7
Panionios,5521,4,1,1,4,4,10,-6,4
AEK Athens,5522,1,4,2,0,7,1,6,14
PAOK Salonik,5522,2,3,2,1,12,5,7,11
Panionios,5522,3,1,1,4,4,10,-6,4
P'thinaikos,5522,4,1,1,4,5,12,-7,4
AEK Athens,5523,1,4,2,0,7,1,6,14
PAOK Salonik,5523,2,3,2,1,10,4,6,11
P'thinaikos,5523,3,1,1,4,4,10,-6,4
Panionios,5523,3,1,1,4,4,10,-6,4
AEK Athens,5524,1,4,2,0,7,1,6,14
PAOK Salonik,5524,2,2,2,2,9,6,3,8
P'thinaikos,5524,3,2,1,3,6,9,-3,7
Panionios,5524,4,1,1,4,4,10,-6,4
AEK Athens,5525,1,4,2,0,7,1,6,14
PAOK Salonik,5525,2,3,2,1,12,4,8,11
Panionios,5525,3,1,1,4,4,10,-6,4
P'thinaikos,5525,4,1,1,4,4,12,-8,4
AEK Athens,5526,1,4,2,0,7,1,6,14
PAOK Salonik,5526,2,2,2,2,10,8,2,8
P'thinaikos,5526,3,2,1,3,8,10,-2,7
Panionios,5526,4,1,1,4,4,10,-6,4
AEK Athens,5527,1,4,2,0,7,1,6,14
PAOK Salonik,5527,2,2,2,2,9,7,2,8
P'thinaikos,5527,3,2,1,3,7,9,-2,7
Panionios,5527,4,1,1,4,4,10,-6,4
AEK Athens,5528,1,4,2,0,7,1,6,14
PAOK Salonik,5528,2,2,2,2,9,5,4,8
P'thinaikos,5528,3,2,1,3,5,9,-4,7
Panionios,5528,4,1,1,4,4,10,-6,4
AEK Athens,5529,1,4,2,0,7,1,6,14
PAOK Salonik,5529,2,3,2,1,10,4,6,11
P'thinaikos,5529,3,1,1,4,4,10,-6,4
Panionios,5529,3,1,1,4,4,10,-6,4
AEK Athens,5530,1,4,2,0,7,1,6,14
PAOK Salonik,5530,2,2,3,1,9,4,5,9
P'thinaikos,5530,3,1,2,3,4,9,-5,5
Panionios,5530,4,1,1,4,4,10,-6,4
AEK Athens,5531,1,4,2,0,7,1,6,14
PAOK Salonik,5531,2,3,2,1,12,6,6,11
P'thinaikos,5531,3,1,1,4,6,12,-6,4
Panionios,5531,4,1,1,4,4,10,-6,4
AEK Athens,5532,1,4,2,0,7,1,6,14
PAOK Salonik,5532,2,2,2,2,9,5,4,8
P'thinaikos,5532,3,2,1,3,5,9,-4,7
Panionios,5532,4,1,1,4,4,10,-6,4
AEK Athens,5533,1,4,2,0,7,1,6,14
PAOK Salonik,5533,2,2,3,1,10,5,5,9
P'thinaikos,5533,3,1,2,3,5,10,-5,5
Panionios,5533,4,1,1,4,4,10,-6,4
AEK Athens,5534,1,4,2,0,7,1,6,14
PAOK Salonik,5534,2,3,2,1,13,6,7,11
Panionios,5534,3,1,1,4,4,10,-6,4
P'thinaikos,5534,4,1,1,4,6,13,-7,4
AEK Athens,5535,1,4,2,0,7,1,6,14
PAOK Salonik,5535,2,2,2,2,9,6,3,8
P'thinaikos,5535,3,2,1,3,6,9,-3,7
Panionios,5535,4,1,1,4,4,10,-6,4
AEK Athens,5536,1,4,2,0,7,1,6,14
PAOK Salonik,5536,2,2,3,1,10,5,5,9
P'thinaikos,5536,3,1,2,3,5,10,-5,5
Panionios,5536,4,1,1,4,4,10,-6,4
AEK Athens,5537,1,4,2,0,7,1,6,14
PAOK Salonik,5537,2,2,3,1,10,5,5,9
P'thinaikos,5537,3,1,2,3,5,10,-5,5
Panionios,5537,4,1,1,4,4,10,-6,4
AEK Athens,5538,1,4,2,0,7,1,6,14
PAOK Salonik,5538,2,2,3,1,10,5,5,9
P'thinaikos,5538,3,1,2,3,5,10,-5,5
Panionios,5538,4,1,1,4,4,10,-6,4
AEK Athens,5539,1,4,2,0,7,1,6,14
PAOK Salonik,5539,2,2,3,1,11,6,5,9
P'thinaikos,5539,3,1,2,3,6,11,-5,5
Panionios,5539,4,1,1,4,4,10,-6,4
AEK Athens,5540,1,4,2,0,7,1,6,14
PAOK Salonik,5540,2,3,2,1,10,4,6,11
P'thinaikos,5540,3,1,1,4,4,10,-6,4
Panionios,5540,3,1,1,4,4,10,-6,4
AEK Athens,5541,1,4,2,0,7,1,6,14
PAOK Salonik,5541,2,2,2,2,9,5,4,8
P'thinaikos,5541,3,2,1,3,5,9,-4,7
Panionios,5541,4,1,1,4,4,10,-6,4
AEK Athens,5542,1,4,2,0,7,1,6,14
PAOK Salonik,5542,2,3,2,1,11,5,6,11
P'thinaikos,5542,3,1,1,4,5,11,-6,4
Panionios,5542,4,1,1,4,4,10,-6,4
AEK Athens,5543,1,4,2,0,7,1,6,14
PAOK Salonik,5543,2,2,3,1,10,5,5,9
P'thinaikos,5543,3,1,2,3,5,10,-5,5
Panionios,5543,4,1,1,4,4,10,-6,4
AEK Athens,5544,1,4,2,0,7,1,6,14
PAOK Salonik,5544,2,2,3,1,9,4,5,9
P'thinaikos,5544,3,1,2,3,4,9,-5,5
Panionios,5544,4,1,1,4,4,10,-6,4
AEK Athens,5545,1,4,2,0,7,1,6,14
PAOK Salonik,5545,2,2,2,2,10,6,4,8
P'thinaikos,5545,3,2,1,3,6,10,-4,7
Panionios,5545,4,1,1,4,4,10,-6,4
AEK Athens,5546,1,4,2,0,7,1,6,14
PAOK Salonik,5546,2,3,2,1,13,4,9,11
Panionios,5546,3,1,1,4,4,10,-6,4
P'thinaikos,5546,4,1,1,4,4,13,-9,4
AEK Athens,5547,1,4,2,0,7,1,6,14
PAOK Salonik,5547,2,2,2,2,9,5,4,8
P'thinaikos,5547,3,2,1,3,5,9,-4,7
Panionios,5547,4,1,1,4,4,10,-6,4
AEK Athens,5548,1,4,2,0,7,1,6,14
PAOK Salonik,5548,2,3,2,1,11,4,7,11
Panionios,5548,3,1,1,4,4,10,-6,4
P'thinaikos,5548,4,1,1,4,4,11,-7,4
AEK Athens,5549,1,4,2,0,7,1,6,14
PAOK Salonik,5549,2,2,2,2,9,6,3,8
P'thinaikos,5549,3,2,1,3,6,9,-3,7
Panionios,5549,4,1,1,4,4,10,-6,4
AEK Athens,5550,1,4,2,0,7,1,6,14
PAOK Salonik,5550,2,3,2,1,10,4,6,11
P'thinaikos,5550,3,1,1,4,4,10,-6,4
Panionios,5550,3,1,1,4,4,10,-6,4
AEK Athens,5551,1,4,2,0,7,1,6,14
PAOK Salonik,5551,2,2,3,1,9,4,5,9
P'thinaikos,5551,3,1,2,3,4,9,-5,5
Panionios,5551,4,1,1,4,4,10,-6,4
AEK Athens,5552,1,4,2,0,7,1,6,14
PAOK Salonik,5552,2,3,2,1,11,5,6,11
P'thinaikos,5552,3,1,1,4,5,11,-6,4
Panionios,5552,4,1,1,4,4,10,-6,4
AEK Athens,5553,1,4,2,0,7,1,6,14
PAOK Salonik,5553,2,2,3,1,10,5,5,9
P'thinaikos,5553,3,1,2,3,5,10,-5,5
Panionios,5553,4,1,1,4,4,10,-6,4
AEK Athens,5554,1,4,2,0,7,1,6,14
PAOK Salonik,5554,2,2,2,2,11,7,4,8
P'thinaikos,5554,3,2,1,3,7,11,-4,7
Panionios,5554,4,1,1,4,4,10,-6,4
AEK Athens,5555,1,4,2,0,7,1,6,14
PAOK Salonik,5555,2,2,3,1,9,4,5,9
P'thinaikos,5555,3,1,2,3,4,9,-5,5
Panionios,5555,4,1,1,4,4,10,-6,4
AEK Athens,5556,1,4,2,0,7,1,6,14
PAOK Salonik,5556,2,3,2,1,11,5,6,11
P'thinaikos,5556,3,1,1,4,5,11,-6,4
Panionios,5556,4,1,1,4,4,10,-6,4
AEK Athens,5557,1,4,2,0,7,1,6,14
PAOK Salonik,5557,2,2,2,2,9,7,2,8
P'thinaikos,5557,3,2,1,3,7,9,-2,7
Panionios,5557,4,1,1,4,4,10,-6,4
AEK Athens,5558,1,4,2,0,7,1,6,14
PAOK Salonik,5558,2,2,2,2,9,5,4,8
P'thinaikos,5558,3,2,1,3,5,9,-4,7
Panionios,5558,4,1,1,4,4,10,-6,4
AEK Athens,5559,1,4,2,0,7,1,6,14
PAOK Salonik,5559,2,2,2,2,10,6,4,8
P'thinaikos,5559,3,2,1,3,6,10,-4,7
Panionios,5559,4,1,1,4,4,10,-6,4
AEK Athens,5560,1,4,2,0,7,1,6,14
PAOK Salonik,5560,2,3,2,1,11,4,7,11
Panionios,5560,3,1,1,4,4,10,-6,4
P'thinaikos,5560,4,1,1,4,4,11,-7,4
AEK Athens,5561,1,4,2,0,7,1,6,14
PAOK Salonik,5561,2,2,2,2,10,6,4,8
P'thinaikos,5561,3,2,1,3,6,10,-4,7
Panionios,5561,4,1,1,4,4,10,-6,4
AEK Athens,5562,1,4,2,0,7,1,6,14
PAOK Salonik,5562,2,2,3,1,10,5,5,9
P'thinaikos,5562,3,1,2,3,5,10,-5,5
Panionios,5562,4,1,1,4,4,10,-6,4
AEK Athens,5563,1,4,2,0,7,1,6,14
PAOK Salonik,5563,2,2,3,1,9,4,5,9
P'thinaikos,5563,3,1,2,3,4,9,-5,5
Panionios,5563,4,1,1,4,4,10,-6,4
AEK Athens,5564,1,4,2,0,7,1,6,14
PAOK Salonik,5564,2,3,2,1,12,5,7,11
Panionios,5564,3,1,1,4,4,10,-6,4
P'thinaikos,5564,4,1,1,4,5,12,-7,4
AEK Athens,5565,1,4,2,0,7,1,6,14
PAOK Salonik,5565,2,2,3,1,9,4,5,9
P'thinaikos,5565,3,1,2,3,4,9,-5,5
Panionios,5565,4,1,1,4,4,10,-6,4
AEK Athens,5566,1,4,2,0,7,1,6,14
PAOK Salonik,5566,2,2,2,2,9,5,4,8
P'thinaikos,5566,3,2,1,3,5,9,-4,7
Panionios,5566,4,1,1,4,4,10,-6,4
AEK Athens,5567,1,4,2,0,7,1,6,14
PAOK Salonik,5567,2,3,2,1,10,4,6,11
P'thinaikos,5567,3,1,1,4,4,10,-6,4
Panionios,5567,3,1,1,4,4,10,-6,4
AEK Athens,5568,1,4,2,0,7,1,6,14
PAOK Salonik,5568,2,2,3,1,9,4,5,9
P'thinaikos,5568,3,1,2,3,4,9,-5,5
Panionios,5568,4,1,1,4,4,10,-6,4
AEK Athens,5569,1,4,2,0,7,1,6,14
PAOK Salonik,5569,2,3,2,1,12,6,6,11
P'thinaikos,5569,3,1,1,4,6,12,-6,4
Panionios,5569,4,1,1,4,4,10,-6,4
AEK Athens,5570,1,4,2,0,7,1,6,14
PAOK Salonik,5570,2,3,2,1,11,4,7,11
Panionios,5570,3,1,1,4,4,10,-6,4
P'thinaikos,5570,4,1,1,4,4,11,-7,4
AEK Athens,5571,1,4,2,0,7,1,6,14
PAOK Salonik,5571,2,2,3,1,10,5,5,9
P'thinaikos,5571,3,1,2,3,5,10,-5,5
Panionios,5571,4,1,1,4,4,10,-6,4
AEK Athens,5572,1,4,2,0,7,1,6,14
PAOK Salonik,5572,2,2,2,2,9,5,4,8
P'thinaikos,5572,3,2,1,3,5,9,-4,7
Panionios,5572,4,1,1,4,4,10,-6,4
AEK Athens,5573,1,4,2,0,7,1,6,14
PAOK Salonik,5573,2,2,2,2,11,7,4,8
P'thinaikos,5573,3,2,1,3,7,11,-4,7
Panionios,5573,4,1,1,4,4,10,-6,4
AEK Athens,5574,1,4,2,0,7,1,6,14
PAOK Salonik,5574,2,3,2,1,12,4,8,11
Panionios,5574,3,1,1,4,4,10,-6,4
P'thinaikos,5574,4,1,1,4,4,12,-8,4
AEK Athens,5575,1,4,2,0,7,1,6,14
PAOK Salonik,5575,2,2,3,1,9,4,5,9
P'thinaikos,5575,3,1,2,3,4,9,-5,5
Panionios,5575,4,1,1,4,4,10,-6,4
AEK Athens,5576,1,4,2,0,7,1,6,14
PAOK Salonik,5576,2,3,2,1,12,5,7,11
Panionios,5576,3,1,1,4,4,10,-6,4
P'thinaikos,5576,4,1,1,4,5,12,-7,4
AEK Athens,5577,1,4,2,0,7,1,6,14
PAOK Salonik,5577,2,2,3,1,10,5,5,9
P'thinaikos,5577,3,1,2,3,5,10,-5,5
Panionios,5577,4,1,1,4,4,10,-6,4
AEK Athens,5578,1,4,2,0,7,1,6,14
PAOK Salonik,5578,2,2,2,2,9,10,-1,8
P'thinaikos,5578,3,2,1,3,10,9,1,7
Panionios,5578,4,1,1,4,4,10,-6,4
AEK Athens,5579,1,4,2,0,7,1,6,14
PAOK Salonik,5579,2,3,2,1,11,4,7,11
Panionios,5579,3,1,1,4,4,10,-6,4
P'thinaikos,5579,4,1,1,4,4,11,-7,4
AEK Athens,5580,1,4,2,0,7,1,6,14
PAOK Salonik,5580,2,3,2,1,11,4,7,11
Panionios,5580,3,1,1,4,4,10,-6,4
P'thinaikos,5580,4,1,1,4,4,11,-7,4
AEK Athens,5581,1,4,2,0,7,1,6,14
PAOK Salonik,5581,2,3,2,1,12,5,7,11
Panionios,5581,3,1,1,4,4,10,-6,4
P'thinaikos,5581,4,1,1,4,5,12,-7,4
AEK Athens,5582,1,4,2,0,7,1,6,14
PAOK Salonik,5582,2,2,2,2,9,5,4,8
P'thinaikos,5582,3,2,1,3,5,9,-4,7
Panionios,5582,4,1,1,4,4,10,-6,4
AEK Athens,5583,1,4,2,0,7,1,6,14
PAOK Salonik,5583,2,3,2,1,10,4,6,11
P'thinaikos,5583,3,1,1,4,4,10,-6,4
Panionios,5583,3,1,1,4,4,10,-6,4
AEK Athens,5584,1,4,2,0,7,1,6,14
PAOK Salonik,5584,2,2,3,1,10,5,5,9
P'thinaikos,5584,3,1,2,3,5,10,-5,5
Panionios,5584,4,1,1,4,4,10,-6,4
AEK Athens,5585,1,4,2,0,7,1,6,14
PAOK Salonik,5585,2,2,3,1,10,5,5,9
P'thinaikos,5585,3,1,2,3,5,10,-5,5
Panionios,5585,4,1,1,4,4,10,-6,4
AEK Athens,5586,1,4,2,0,7,1,6,14
PAOK Salonik,5586,2,3,2,1,11,5,6,11
P'thinaikos,5586,3,1,1,4,5,11,-6,4
Panionios,5586,4,1,1,4,4,10,-6,4
AEK Athens,5587,1,4,2,0,7,1,6,14
PAOK Salonik,5587,2,2,2,2,9,5,4,8
P'thinaikos,5587,3,2,1,3,5,9,-4,7
Panionios,5587,4,1,1,4,4,10,-6,4
AEK Athens,5588,1,4,2,0,7,1,6,14
PAOK Salonik,5588,2,2,3,1,9,4,5,9
P'thinaikos,5588,3,1,2,3,4,9,-5,5
Panionios,5588,4,1,1,4,4,10,-6,4
AEK Athens,5589,1,4,2,0,7,1,6,14
PAOK Salonik,5589,2,2,2,2,10,7,3,8
P'thinaikos,5589,3,2,1,3,7,10,-3,7
Panionios,5589,4,1,1,4,4,10,-6,4
AEK Athens,5590,1,4,2,0,7,1,6,14
PAOK Salonik,5590,2,2,2,2,9,6,3,8
P'thinaikos,5590,3,2,1,3,6,9,-3,7
Panionios,5590,4,1,1,4,4,10,-6,4
AEK Athens,5591,1,4,2,0,7,1,6,14
PAOK Salonik,5591,2,3,2,1,11,5,6,11
P'thinaikos,5591,3,1,1,4,5,11,-6,4
Panionios,5591,4,1,1,4,4,10,-6,4
AEK Athens,5592,1,4,2,0,7,1,6,14
PAOK Salonik,5592,2,3,2,1,11,5,6,11
P'thinaikos,5592,3,1,1,4,5,11,-6,4
Panionios,5592,4,1,1,4,4,10,-6,4
AEK Athens,5593,1,4,2,0,7,1,6,14
PAOK Salonik,5593,2,2,2,2,9,6,3,8
P'thinaikos,5593,3,2,1,3,6,9,-3,7
Panionios,5593,4,1,1,4,4,10,-6,4
AEK Athens,5594,1,4,2,0,7,1,6,14
PAOK Salonik,5594,2,2,3,1,9,4,5,9
P'thinaikos,5594,3,1,2,3,4,9,-5,5
Panionios,5594,4,1,1,4,4,10,-6,4
AEK Athens,5595,1,4,2,0,7,1,6,14
PAOK Salonik,5595,2,2,2,2,9,5,4,8
P'thinaikos,5595,3,2,1,3,5,9,-4,7
Panionios,5595,4,1,1,4,4,10,-6,4
AEK Athens,5596,1,4,2,0,7,1,6,14
PAOK Salonik,5596,2,3,2,1,10,4,6,11
P'thinaikos,5596,3,1,1,4,4,10,-6,4
Panionios,5596,3,1,1,4,4,10,-6,4
AEK Athens,5597,1,4,2,0,7,1,6,14
PAOK Salonik,5597,2,2,3,1,11,6,5,9
P'thinaikos,5597,3,1,2,3,6,11,-5,5
Panionios,5597,4,1,1,4,4,10,-6,4
AEK Athens,5598,1,4,2,0,7,1,6,14
PAOK Salonik,5598,2,2,2,2,10,8,2,8
P'thinaikos,5598,3,2,1,3,8,10,-2,7
Panionios,5598,4,1,1,4,4,10,-6,4
AEK Athens,5599,1,4,2,0,7,1,6,14
PAOK Salonik,5599,2,3,2,1,10,4,6,11
P'thinaikos,5599,3,1,1,4,4,10,-6,4
Panionios,5599,3,1,1,4,4,10,-6,4
AEK Athens,5600,1,4,2,0,7,1,6,14
PAOK Salonik,5600,2,3,2,1,12,4,8,11
Panionios,5600,3,1,1,4,4,10,-6,4
P'thinaikos,5600,4,1,1,4,4,12,-8,4
AEK Athens,5601,1,4,2,0,7,1,6,14
PAOK Salonik,5601,2,2,3,1,9,4,5,9
P'thinaikos,5601,3,1,2,3,4,9,-5,5
Panionios,5601,4,1,1,4,4,10,-6,4
AEK Athens,5602,1,4,2,0,7,1,6,14
PAOK Salonik,5602,2,3,2,1,12,4,8,11
Panionios,5602,3,1,1,4,4,10,-6,4
P'thinaikos,5602,4,1,1,4,4,12,-8,4
AEK Athens,5603,1,4,2,0,7,1,6,14
PAOK Salonik,5603,2,2,3,1,9,4,5,9
P'thinaikos,5603,3,1,2,3,4,9,-5,5
Panionios,5603,4,1,1,4,4,10,-6,4
AEK Athens,5604,1,4,2,0,7,1,6,14
PAOK Salonik,5604,2,2,2,2,9,6,3,8
P'thinaikos,5604,3,2,1,3,6,9,-3,7
Panionios,5604,4,1,1,4,4,10,-6,4
AEK Athens,5605,1,4,2,0,7,1,6,14
PAOK Salonik,5605,2,2,2,2,9,7,2,8
P'thinaikos,5605,3,2,1,3,7,9,-2,7
Panionios,5605,4,1,1,4,4,10,-6,4
AEK Athens,5606,1,4,2,0,7,1,6,14
PAOK Salonik,5606,2,3,2,1,11,4,7,11
Panionios,5606,3,1,1,4,4,10,-6,4
P'thinaikos,5606,4,1,1,4,4,11,-7,4
AEK Athens,5607,1,4,2,0,7,1,6,14
PAOK Salonik,5607,2,3,2,1,10,4,6,11
P'thinaikos,5607,3,1,1,4,4,10,-6,4
Panionios,5607,3,1,1,4,4,10,-6,4
AEK Athens,5608,1,4,2,0,7,1,6,14
PAOK Salonik,5608,2,3,2,1,11,5,6,11
P'thinaikos,5608,3,1,1,4,5,11,-6,4
Panionios,5608,4,1,1,4,4,10,-6,4
AEK Athens,5609,1,4,2,0,7,1,6,14
PAOK Salonik,5609,2,2,3,1,10,5,5,9
P'thinaikos,5609,3,1,2,3,5,10,-5,5
Panionios,5609,4,1,1,4,4,10,-6,4
AEK Athens,5610,1,4,2,0,7,1,6,14
PAOK Salonik,5610,2,2,3,1,11,6,5,9
P'thinaikos,5610,3,1,2,3,6,11,-5,5
Panionios,5610,4,1,1,4,4,10,-6,4
AEK Athens,5611,1,4,2,0,7,1,6,14
PAOK Salonik,5611,2,2,2,2,10,6,4,8
P'thinaikos,5611,3,2,1,3,6,10,-4,7
Panionios,5611,4,1,1,4,4,10,-6,4
AEK Athens,5612,1,4,2,0,7,1,6,14
PAOK Salonik,5612,2,3,2,1,11,4,7,11
Panionios,5612,3,1,1,4,4,10,-6,4
P'thinaikos,5612,4,1,1,4,4,11,-7,4
AEK Athens,5613,1,4,2,0,7,1,6,14
PAOK Salonik,5613,2,2,3,1,11,6,5,9
P'thinaikos,5613,3,1,2,3,6,11,-5,5
Panionios,5613,4,1,1,4,4,10,-6,4
AEK Athens,5614,1,4,2,0,7,1,6,14
PAOK Salonik,5614,2,2,2,2,10,7,3,8
P'thinaikos,5614,3,2,1,3,7,10,-3,7
Panionios,5614,4,1,1,4,4,10,-6,4
AEK Athens,5615,1,4,2,0,7,1,6,14
PAOK Salonik,5615,2,3,2,1,12,6,6,11
P'thinaikos,5615,3,1,1,4,6,12,-6,4
Panionios,5615,4,1,1,4,4,10,-6,4
AEK Athens,5616,1,4,2,0,7,1,6,14
PAOK Salonik,5616,2,3,2,1,12,5,7,11
Panionios,5616,3,1,1,4,4,10,-6,4
P'thinaikos,5616,4,1,1,4,5,12,-7,4
AEK Athens,5617,1,4,2,0,7,1,6,14
PAOK Salonik,5617,2,2,3,1,9,4,5,9
P'thinaikos,5617,3,1,2,3,4,9,-5,5
Panionios,5617,4,1,1,4,4,10,-6,4
AEK Athens,5618,1,4,2,0,7,1,6,14
PAOK Salonik,5618,2,2,3,1,9,4,5,9
P'thinaikos,5618,3,1,2,3,4,9,-5,5
Panionios,5618,4,1,1,4,4,10,-6,4
AEK Athens,5619,1,4,2,0,7,1,6,14
PAOK Salonik,5619,2,3,2,1,11,5,6,11
P'thinaikos,5619,3,1,1,4,5,11,-6,4
Panionios,5619,4,1,1,4,4,10,-6,4
AEK Athens,5620,1,4,2,0,7,1,6,14
PAOK Salonik,5620,2,2,3,1,10,5,5,9
P'thinaikos,5620,3,1,2,3,5,10,-5,5
Panionios,5620,4,1,1,4,4,10,-6,4
AEK Athens,5621,1,4,2,0,7,1,6,14
PAOK Salonik,5621,2,2,2,2,10,6,4,8
P'thinaikos,5621,3,2,1,3,6,10,-4,7
Panionios,5621,4,1,1,4,4,10,-6,4
AEK Athens,5622,1,4,2,0,7,1,6,14
PAOK Salonik,5622,2,2,3,1,10,5,5,9
P'thinaikos,5622,3,1,2,3,5,10,-5,5
Panionios,5622,4,1,1,4,4,10,-6,4
AEK Athens,5623,1,4,2,0,7,1,6,14
PAOK Salonik,5623,2,3,2,1,11,4,7,11
Panionios,5623,3,1,1,4,4,10,-6,4
P'thinaikos,5623,4,1,1,4,4,11,-7,4
AEK Athens,5624,1,4,2,0,7,1,6,14
PAOK Salonik,5624,2,2,2,2,10,8,2,8
P'thinaikos,5624,3,2,1,3,8,10,-2,7
Panionios,5624,4,1,1,4,4,10,-6,4
AEK Athens,5625,1,4,2,0,7,1,6,14
PAOK Salonik,5625,2,2,3,1,10,5,5,9
P'thinaikos,5625,3,1,2,3,5,10,-5,5
Panionios,5625,4,1,1,4,4,10,-6,4
AEK Athens,5626,1,4,2,0,7,1,6,14
PAOK Salonik,5626,2,3,2,1,11,4,7,11
Panionios,5626,3,1,1,4,4,10,-6,4
P'thinaikos,5626,4,1,1,4,4,11,-7,4
AEK Athens,5627,1,4,2,0,7,1,6,14
PAOK Salonik,5627,2,3,2,1,13,5,8,11
Panionios,5627,3,1,1,4,4,10,-6,4
P'thinaikos,5627,4,1,1,4,5,13,-8,4
AEK Athens,5628,1,4,2,0,7,1,6,14
PAOK Salonik,5628,2,3,2,1,11,5,6,11
P'thinaikos,5628,3,1,1,4,5,11,-6,4
Panionios,5628,4,1,1,4,4,10,-6,4
AEK Athens,5629,1,4,2,0,7,1,6,14
PAOK Salonik,5629,2,2,2,2,10,6,4,8
P'thinaikos,5629,3,2,1,3,6,10,-4,7
Panionios,5629,4,1,1,4,4,10,-6,4
AEK Athens,5630,1,4,2,0,7,1,6,14
PAOK Salonik,5630,2,2,3,1,9,4,5,9
P'thinaikos,5630,3,1,2,3,4,9,-5,5
Panionios,5630,4,1,1,4,4,10,-6,4
AEK Athens,5631,1,4,2,0,7,1,6,14
PAOK Salonik,5631,2,3,2,1,10,4,6,11
P'thinaikos,5631,3,1,1,4,4,10,-6,4
Panionios,5631,3,1,1,4,4,10,-6,4
AEK Athens,5632,1,4,2,0,7,1,6,14
PAOK Salonik,5632,2,2,2,2,9,10,-1,8
P'thinaikos,5632,3,2,1,3,10,9,1,7
Panionios,5632,4,1,1,4,4,10,-6,4
AEK Athens,5633,1,4,2,0,7,1,6,14
PAOK Salonik,5633,2,2,3,1,9,4,5,9
P'thinaikos,5633,3,1,2,3,4,9,-5,5
Panionios,5633,4,1,1,4,4,10,-6,4
AEK Athens,5634,1,4,2,0,7,1,6,14
PAOK Salonik,5634,2,3,2,1,12,4,8,11
Panionios,5634,3,1,1,4,4,10,-6,4
P'thinaikos,5634,4,1,1,4,4,12,-8,4
AEK Athens,5635,1,4,2,0,7,1,6,14
PAOK Salonik,5635,2,3,2,1,11,4,7,11
Panionios,5635,3,1,1,4,4,10,-6,4
P'thinaikos,5635,4,1,1,4,4,11,-7,4
AEK Athens,5636,1,4,2,0,7,1,6,14
PAOK Salonik,5636,2,2,2,2,11,7,4,8
P'thinaikos,5636,3,2,1,3,7,11,-4,7
Panionios,5636,4,1,1,4,4,10,-6,4
AEK Athens,5637,1,4,2,0,7,1,6,14
PAOK Salonik,5637,2,3,2,1,13,4,9,11
Panionios,5637,3,1,1,4,4,10,-6,4
P'thinaikos,5637,4,1,1,4,4,13,-9,4
AEK Athens,5638,1,4,2,0,7,1,6,14
PAOK Salonik,5638,2,2,2,2,9,6,3,8
P'thinaikos,5638,3,2,1,3,6,9,-3,7
Panionios,5638,4,1,1,4,4,10,-6,4
AEK Athens,5639,1,4,2,0,7,1,6,14
PAOK Salonik,5639,2,2,3,1,10,5,5,9
P'thinaikos,5639,3,1,2,3,5,10,-5,5
Panionios,5639,4,1,1,4,4,10,-6,4
AEK Athens,5640,1,4,2,0,7,1,6,14
PAOK Salonik,5640,2,2,3,1,11,6,5,9
P'thinaikos,5640,3,1,2,3,6,11,-5,5
Panionios,5640,4,1,1,4,4,10,-6,4
AEK Athens,5641,1,4,2,0,7,1,6,14
PAOK Salonik,5641,2,2,2,2,10,6,4,8
P'thinaikos,5641,3,2,1,3,6,10,-4,7
Panionios,5641,4,1,1,4,4,10,-6,4
AEK Athens,5642,1,4,2,0,7,1,6,14
PAOK Salonik,5642,2,3,2,1,11,5,6,11
P'thinaikos,5642,3,1,1,4,5,11,-6,4
Panionios,5642,4,1,1,4,4,10,-6,4
AEK Athens,5643,1,4,2,0,7,1,6,14
PAOK Salonik,5643,2,2,2,2,9,5,4,8
P'thinaikos,5643,3,2,1,3,5,9,-4,7
Panionios,5643,4,1,1,4,4,10,-6,4
AEK Athens,5644,1,4,2,0,7,1,6,14
PAOK Salonik,5644,2,3,2,1,11,4,7,11
Panionios,5644,3,1,1,4,4,10,-6,4
P'thinaikos,5644,4,1,1,4,4,11,-7,4
AEK Athens,5645,1,4,2,0,7,1,6,14
PAOK Salonik,5645,2,2,2,2,9,5,4,8
P'thinaikos,5645,3,2,1,3,5,9,-4,7
Panionios,5645,4,1,1,4,4,10,-6,4
AEK Athens,5646,1,4,2,0,7,1,6,14
PAOK Salonik,5646,2,3,2,1,10,4,6,11
P'thinaikos,5646,3,1,1,4,4,10,-6,4
Panionios,5646,3,1,1,4,4,10,-6,4
AEK Athens,5647,1,4,2,0,7,1,6,14
PAOK Salonik,5647,2,2,2,2,9,7,2,8
P'thinaikos,5647,3,2,1,3,7,9,-2,7
Panionios,5647,4,1,1,4,4,10,-6,4
AEK Athens,5648,1,4,2,0,7,1,6,14
PAOK Salonik,5648,2,2,3,1,9,4,5,9
P'thinaikos,5648,3,1,2,3,4,9,-5,5
Panionios,5648,4,1,1,4,4,10,-6,4
AEK Athens,5649,1,4,2,0,7,1,6,14
PAOK Salonik,5649,2,2,3,1,9,4,5,9
P'thinaikos,5649,3,1,2,3,4,9,-5,5
Panionios,5649,4,1,1,4,4,10,-6,4
AEK Athens,5650,1,4,2,0,7,1,6,14
PAOK Salonik,5650,2,2,2,2,11,7,4,8
P'thinaikos,5650,3,2,1,3,7,11,-4,7
Panionios,5650,4,1,1,4,4,10,-6,4
AEK Athens,5651,1,4,2,0,7,1,6,14
PAOK Salonik,5651,2,3,2,1,10,4,6,11
P'thinaikos,5651,3,1,1,4,4,10,-6,4
Panionios,5651,3,1,1,4,4,10,-6,4
AEK Athens,5652,1,4,2,0,7,1,6,14
PAOK Salonik,5652,2,3,2,1,14,4,10,11
Panionios,5652,3,1,1,4,4,10,-6,4
P'thinaikos,5652,4,1,1,4,4,14,-10,4
AEK Athens,5653,1,4,2,0,7,1,6,14
PAOK Salonik,5653,2,2,2,2,9,5,4,8
P'thinaikos,5653,3,2,1,3,5,9,-4,7
Panionios,5653,4,1,1,4,4,10,-6,4
AEK Athens,5654,1,4,2,0,7,1,6,14
PAOK Salonik,5654,2,2,2,2,9,5,4,8
P'thinaikos,5654,3,2,1,3,5,9,-4,7
Panionios,5654,4,1,1,4,4,10,-6,4
AEK Athens,5655,1,4,2,0,7,1,6,14
PAOK Salonik,5655,2,2,2,2,10,6,4,8
P'thinaikos,5655,3,2,1,3,6,10,-4,7
Panionios,5655,4,1,1,4,4,10,-6,4
AEK Athens,5656,1,4,2,0,7,1,6,14
PAOK Salonik,5656,2,2,2,2,10,7,3,8
P'thinaikos,5656,3,2,1,3,7,10,-3,7
Panionios,5656,4,1,1,4,4,10,-6,4
AEK Athens,5657,1,4,2,0,7,1,6,14
PAOK Salonik,5657,2,2,2,2,9,5,4,8
P'thinaikos,5657,3,2,1,3,5,9,-4,7
Panionios,5657,4,1,1,4,4,10,-6,4
AEK Athens,5658,1,4,2,0,7,1,6,14
PAOK Salonik,5658,2,2,2,2,10,7,3,8
P'thinaikos,5658,3,2,1,3,7,10,-3,7
Panionios,5658,4,1,1,4,4,10,-6,4
AEK Athens,5659,1,4,2,0,7,1,6,14
PAOK Salonik,5659,2,2,3,1,10,5,5,9
P'thinaikos,5659,3,1,2,3,5,10,-5,5
Panionios,5659,4,1,1,4,4,10,-6,4
AEK Athens,5660,1,4,2,0,7,1,6,14
PAOK Salonik,5660,2,3,2,1,10,4,6,11
P'thinaikos,5660,3,1,1,4,4,10,-6,4
Panionios,5660,3,1,1,4,4,10,-6,4
AEK Athens,5661,1,4,2,0,7,1,6,14
PAOK Salonik,5661,2,2,3,1,9,4,5,9
P'thinaikos,5661,3,1,2,3,4,9,-5,5
Panionios,5661,4,1,1,4,4,10,-6,4
AEK Athens,5662,1,4,2,0,7,1,6,14
PAOK Salonik,5662,2,2,2,2,10,6,4,8
P'thinaikos,5662,3,2,1,3,6,10,-4,7
Panionios,5662,4,1,1,4,4,10,-6,4
AEK Athens,5663,1,4,2,0,7,1,6,14
PAOK Salonik,5663,2,2,2,2,9,5,4,8
P'thinaikos,5663,3,2,1,3,5,9,-4,7
Panionios,5663,4,1,1,4,4,10,-6,4
AEK Athens,5664,1,4,2,0,7,1,6,14
PAOK Salonik,5664,2,2,2,2,9,5,4,8
P'thinaikos,5664,3,2,1,3,5,9,-4,7
Panionios,5664,4,1,1,4,4,10,-6,4
AEK Athens,5665,1,4,2,0,7,1,6,14
PAOK Salonik,5665,2,3,2,1,11,4,7,11
Panionios,5665,3,1,1,4,4,10,-6,4
P'thinaikos,5665,4,1,1,4,4,11,-7,4
AEK Athens,5666,1,4,2,0,7,1,6,14
PAOK Salonik,5666,2,2,2,2,10,6,4,8
P'thinaikos,5666,3,2,1,3,6,10,-4,7
Panionios,5666,4,1,1,4,4,10,-6,4
AEK Athens,5667,1,4,2,0,7,1,6,14
PAOK Salonik,5667,2,2,2,2,9,5,4,8
P'thinaikos,5667,3,2,1,3,5,9,-4,7
Panionios,5667,4,1,1,4,4,10,-6,4
AEK Athens,5668,1,4,2,0,7,1,6,14
PAOK Salonik,5668,2,3,2,1,12,4,8,11
Panionios,5668,3,1,1,4,4,10,-6,4
P'thinaikos,5668,4,1,1,4,4,12,-8,4
AEK Athens,5669,1,4,2,0,7,1,6,14
PAOK Salonik,5669,2,2,2,2,9,5,4,8
P'thinaikos,5669,3,2,1,3,5,9,-4,7
Panionios,5669,4,1,1,4,4,10,-6,4
AEK Athens,5670,1,4,2,0,7,1,6,14
PAOK Salonik,5670,2,2,2,2,11,7,4,8
P'thinaikos,5670,3,2,1,3,7,11,-4,7
Panionios,5670,4,1,1,4,4,10,-6,4
AEK Athens,5671,1,4,2,0,7,1,6,14
PAOK Salonik,5671,2,3,2,1,11,4,7,11
Panionios,5671,3,1,1,4,4,10,-6,4
P'thinaikos,5671,4,1,1,4,4,11,-7,4
AEK Athens,5672,1,4,2,0,7,1,6,14
PAOK Salonik,5672,2,3,2,1,13,5,8,11
Panionios,5672,3,1,1,4,4,10,-6,4
P'thinaikos,5672,4,1,1,4,5,13,-8,4
AEK Athens,5673,1,4,2,0,7,1,6,14
PAOK Salonik,5673,2,2,3,1,11,6,5,9
P'thinaikos,5673,3,1,2,3,6,11,-5,5
Panionios,5673,4,1,1,4,4,10,-6,4
AEK Athens,5674,1,4,2,0,7,1,6,14
PAOK Salonik,5674,2,3,2,1,11,5,6,11
P'thinaikos,5674,3,1,1,4,5,11,-6,4
Panionios,5674,4,1,1,4,4,10,-6,4
AEK Athens,5675,1,4,2,0,7,1,6,14
PAOK Salonik,5675,2,2,2,2,9,5,4,8
P'thinaikos,5675,3,2,1,3,5,9,-4,7
Panionios,5675,4,1,1,4,4,10,-6,4
AEK Athens,5676,1,4,2,0,7,1,6,14
PAOK Salonik,5676,2,2,3,1,10,5,5,9
P'thinaikos,5676,3,1,2,3,5,10,-5,5
Panionios,5676,4,1,1,4,4,10,-6,4
AEK Athens,5677,1,4,2,0,7,1,6,14
PAOK Salonik,5677,2,2,3,1,11,6,5,9
P'thinaikos,5677,3,1,2,3,6,11,-5,5
Panionios,5677,4,1,1,4,4,10,-6,4
AEK Athens,5678,1,4,2,0,7,1,6,14
PAOK Salonik,5678,2,2,3,1,9,4,5,9
P'thinaikos,5678,3,1,2,3,4,9,-5,5
Panionios,5678,4,1,1,4,4,10,-6,4
AEK Athens,5679,1,4,2,0,7,1,6,14
PAOK Salonik,5679,2,2,2,2,9,6,3,8
P'thinaikos,5679,3,2,1,3,6,9,-3,7
Panionios,5679,4,1,1,4,4,10,-6,4
AEK Athens,5680,1,4,2,0,7,1,6,14
PAOK Salonik,5680,2,2,2,2,10,7,3,8
P'thinaikos,5680,3,2,1,3,7,10,-3,7
Panionios,5680,4,1,1,4,4,10,-6,4
AEK Athens,5681,1,4,2,0,7,1,6,14
PAOK Salonik,5681,2,2,3,1,10,5,5,9
P'thinaikos,5681,3,1,2,3,5,10,-5,5
Panionios,5681,4,1,1,4,4,10,-6,4
AEK Athens,5682,1,4,2,0,7,1,6,14
PAOK Salonik,5682,2,2,2,2,9,5,4,8
P'thinaikos,5682,3,2,1,3,5,9,-4,7
Panionios,5682,4,1,1,4,4,10,-6,4
AEK Athens,5683,1,4,2,0,7,1,6,14
PAOK Salonik,5683,2,3,2,1,12,4,8,11
Panionios,5683,3,1,1,4,4,10,-6,4
P'thinaikos,5683,4,1,1,4,4,12,-8,4
AEK Athens,5684,1,4,2,0,7,1,6,14
PAOK Salonik,5684,2,3,2,1,11,5,6,11
P'thinaikos,5684,3,1,1,4,5,11,-6,4
Panionios,5684,4,1,1,4,4,10,-6,4
AEK Athens,5685,1,4,2,0,7,1,6,14
PAOK Salonik,5685,2,3,2,1,13,4,9,11
Panionios,5685,3,1,1,4,4,10,-6,4
P'thinaikos,5685,4,1,1,4,4,13,-9,4
AEK Athens,5686,1,4,2,0,7,1,6,14
PAOK Salonik,5686,2,2,2,2,9,5,4,8
P'thinaikos,5686,3,2,1,3,5,9,-4,7
Panionios,5686,4,1,1,4,4,10,-6,4
AEK Athens,5687,1,4,2,0,7,1,6,14
PAOK Salonik,5687,2,2,2,2,10,6,4,8
P'thinaikos,5687,3,2,1,3,6,10,-4,7
Panionios,5687,4,1,1,4,4,10,-6,4
AEK Athens,5688,1,4,2,0,7,1,6,14
PAOK Salonik,5688,2,3,2,1,11,5,6,11
P'thinaikos,5688,3,1,1,4,5,11,-6,4
Panionios,5688,4,1,1,4,4,10,-6,4
AEK Athens,5689,1,4,2,0,7,1,6,14
PAOK Salonik,5689,2,3,2,1,12,4,8,11
Panionios,5689,3,1,1,4,4,10,-6,4
P'thinaikos,5689,4,1,1,4,4,12,-8,4
AEK Athens,5690,1,4,2,0,7,1,6,14
PAOK Salonik,5690,2,3,2,1,12,5,7,11
Panionios,5690,3,1,1,4,4,10,-6,4
P'thinaikos,5690,4,1,1,4,5,12,-7,4
AEK Athens,5691,1,4,2,0,7,1,6,14
PAOK Salonik,5691,2,2,2,2,11,8,3,8
P'thinaikos,5691,3,2,1,3,8,11,-3,7
Panionios,5691,4,1,1,4,4,10,-6,4
AEK Athens,5692,1,4,2,0,7,1,6,14
PAOK Salonik,5692,2,2,2,2,9,5,4,8
P'thinaikos,5692,3,2,1,3,5,9,-4,7
Panionios,5692,4,1,1,4,4,10,-6,4
AEK Athens,5693,1,4,2,0,7,1,6,14
PAOK Salonik,5693,2,2,2,2,10,6,4,8
P'thinaikos,5693,3,2,1,3,6,10,-4,7
Panionios,5693,4,1,1,4,4,10,-6,4
AEK Athens,5694,1,4,2,0,7,1,6,14
PAOK Salonik,5694,2,2,3,1,11,6,5,9
P'thinaikos,5694,3,1,2,3,6,11,-5,5
Panionios,5694,4,1,1,4,4,10,-6,4
AEK Athens,5695,1,4,2,0,7,1,6,14
PAOK Salonik,5695,2,3,2,1,13,6,7,11
Panionios,5695,3,1,1,4,4,10,-6,4
P'thinaikos,5695,4,1,1,4,6,13,-7,4
AEK Athens,5696,1,4,2,0,7,1,6,14
PAOK Salonik,5696,2,3,2,1,10,4,6,11
P'thinaikos,5696,3,1,1,4,4,10,-6,4
Panionios,5696,3,1,1,4,4,10,-6,4
AEK Athens,5697,1,4,2,0,7,1,6,14
PAOK Salonik,5697,2,2,2,2,10,6,4,8
P'thinaikos,5697,3,2,1,3,6,10,-4,7
Panionios,5697,4,1,1,4,4,10,-6,4
AEK Athens,5698,1,4,2,0,7,1,6,14
PAOK Salonik,5698,2,2,2,2,9,5,4,8
P'thinaikos,5698,3,2,1,3,5,9,-4,7
Panionios,5698,4,1,1,4,4,10,-6,4
AEK Athens,5699,1,4,2,0,7,1,6,14
PAOK Salonik,5699,2,2,3,1,10,5,5,9
P'thinaikos,5699,3,1,2,3,5,10,-5,5
Panionios,5699,4,1,1,4,4,10,-6,4
AEK Athens,5700,1,4,2,0,7,1,6,14
PAOK Salonik,5700,2,2,3,1,9,4,5,9
P'thinaikos,5700,3,1,2,3,4,9,-5,5
Panionios,5700,4,1,1,4,4,10,-6,4
AEK Athens,5701,1,4,2,0,7,1,6,14
PAOK Salonik,5701,2,3,2,1,15,6,9,11
Panionios,5701,3,1,1,4,4,10,-6,4
P'thinaikos,5701,4,1,1,4,6,15,-9,4
AEK Athens,5702,1,4,2,0,7,1,6,14
PAOK Salonik,5702,2,2,3,1,10,5,5,9
P'thinaikos,5702,3,1,2,3,5,10,-5,5
Panionios,5702,4,1,1,4,4,10,-6,4
AEK Athens,5703,1,4,2,0,7,1,6,14
PAOK Salonik,5703,2,2,2,2,9,6,3,8
P'thinaikos,5703,3,2,1,3,6,9,-3,7
Panionios,5703,4,1,1,4,4,10,-6,4
AEK Athens,5704,1,4,2,0,7,1,6,14
PAOK Salonik,5704,2,2,2,2,10,6,4,8
P'thinaikos,5704,3,2,1,3,6,10,-4,7
Panionios,5704,4,1,1,4,4,10,-6,4
AEK Athens,5705,1,4,2,0,7,1,6,14
PAOK Salonik,5705,2,2,2,2,9,5,4,8
P'thinaikos,5705,3,2,1,3,5,9,-4,7
Panionios,5705,4,1,1,4,4,10,-6,4
AEK Athens,5706,1,4,2,0,7,1,6,14
PAOK Salonik,5706,2,2,3,1,10,5,5,9
P'thinaikos,5706,3,1,2,3,5,10,-5,5
Panionios,5706,4,1,1,4,4,10,-6,4
AEK Athens,5707,1,4,2,0,7,1,6,14
PAOK Salonik,5707,2,2,3,1,9,4,5,9
P'thinaikos,5707,3,1,2,3,4,9,-5,5
Panionios,5707,4,1,1,4,4,10,-6,4
AEK Athens,5708,1,4,2,0,7,1,6,14
PAOK Salonik,5708,2,2,2,2,10,6,4,8
P'thinaikos,5708,3,2,1,3,6,10,-4,7
Panionios,5708,4,1,1,4,4,10,-6,4
AEK Athens,5709,1,4,2,0,7,1,6,14
PAOK Salonik,5709,2,3,2,1,11,4,7,11
Panionios,5709,3,1,1,4,4,10,-6,4
P'thinaikos,5709,4,1,1,4,4,11,-7,4
AEK Athens,5710,1,4,2,0,7,1,6,14
PAOK Salonik,5710,2,2,3,1,11,6,5,9
P'thinaikos,5710,3,1,2,3,6,11,-5,5
Panionios,5710,4,1,1,4,4,10,-6,4
AEK Athens,5711,1,4,2,0,7,1,6,14
PAOK Salonik,5711,2,2,2,2,9,5,4,8
P'thinaikos,5711,3,2,1,3,5,9,-4,7
Panionios,5711,4,1,1,4,4,10,-6,4
AEK Athens,5712,1,4,2,0,7,1,6,14
PAOK Salonik,5712,2,2,3,1,9,4,5,9
P'thinaikos,5712,3,1,2,3,4,9,-5,5
Panionios,5712,4,1,1,4,4,10,-6,4
AEK Athens,5713,1,4,2,0,7,1,6,14
PAOK Salonik,5713,2,2,2,2,9,6,3,8
P'thinaikos,5713,3,2,1,3,6,9,-3,7
Panionios,5713,4,1,1,4,4,10,-6,4
AEK Athens,5714,1,4,2,0,7,1,6,14
PAOK Salonik,5714,2,3,2,1,11,5,6,11
P'thinaikos,5714,3,1,1,4,5,11,-6,4
Panionios,5714,4,1,1,4,4,10,-6,4
AEK Athens,5715,1,4,2,0,7,1,6,14
PAOK Salonik,5715,2,2,3,1,10,5,5,9
P'thinaikos,5715,3,1,2,3,5,10,-5,5
Panionios,5715,4,1,1,4,4,10,-6,4
AEK Athens,5716,1,4,2,0,7,1,6,14
PAOK Salonik,5716,2,2,3,1,9,4,5,9
P'thinaikos,5716,3,1,2,3,4,9,-5,5
Panionios,5716,4,1,1,4,4,10,-6,4
AEK Athens,5717,1,4,2,0,7,1,6,14
PAOK Salonik,5717,2,2,3,1,11,6,5,9
P'thinaikos,5717,3,1,2,3,6,11,-5,5
Panionios,5717,4,1,1,4,4,10,-6,4
AEK Athens,5718,1,4,2,0,7,1,6,14
PAOK Salonik,5718,2,2,2,2,10,6,4,8
P'thinaikos,5718,3,2,1,3,6,10,-4,7
Panionios,5718,4,1,1,4,4,10,-6,4
AEK Athens,5719,1,4,2,0,7,1,6,14
PAOK Salonik,5719,2,2,2,2,9,5,4,8
P'thinaikos,5719,3,2,1,3,5,9,-4,7
Panionios,5719,4,1,1,4,4,10,-6,4
AEK Athens,5720,1,4,2,0,7,1,6,14
PAOK Salonik,5720,2,3,2,1,10,4,6,11
P'thinaikos,5720,3,1,1,4,4,10,-6,4
Panionios,5720,3,1,1,4,4,10,-6,4
AEK Athens,5721,1,4,2,0,7,1,6,14
PAOK Salonik,5721,2,2,2,2,10,7,3,8
P'thinaikos,5721,3,2,1,3,7,10,-3,7
Panionios,5721,4,1,1,4,4,10,-6,4
AEK Athens,5722,1,4,2,0,7,1,6,14
PAOK Salonik,5722,2,3,2,1,10,4,6,11
P'thinaikos,5722,3,1,1,4,4,10,-6,4
Panionios,5722,3,1,1,4,4,10,-6,4
AEK Athens,5723,1,4,2,0,7,1,6,14
PAOK Salonik,5723,2,2,3,1,10,5,5,9
P'thinaikos,5723,3,1,2,3,5,10,-5,5
Panionios,5723,4,1,1,4,4,10,-6,4
AEK Athens,5724,1,4,2,0,7,1,6,14
PAOK Salonik,5724,2,2,2,2,9,5,4,8
P'thinaikos,5724,3,2,1,3,5,9,-4,7
Panionios,5724,4,1,1,4,4,10,-6,4
AEK Athens,5725,1,4,2,0,7,1,6,14
PAOK Salonik,5725,2,2,3,1,9,4,5,9
P'thinaikos,5725,3,1,2,3,4,9,-5,5
Panionios,5725,4,1,1,4,4,10,-6,4
AEK Athens,5726,1,4,2,0,7,1,6,14
PAOK Salonik,5726,2,3,2,1,12,5,7,11
Panionios,5726,3,1,1,4,4,10,-6,4
P'thinaikos,5726,4,1,1,4,5,12,-7,4
AEK Athens,5727,1,4,2,0,7,1,6,14
PAOK Salonik,5727,2,3,2,1,13,6,7,11
Panionios,5727,3,1,1,4,4,10,-6,4
P'thinaikos,5727,4,1,1,4,6,13,-7,4
AEK Athens,5728,1,4,2,0,7,1,6,14
PAOK Salonik,5728,2,2,2,2,10,6,4,8
P'thinaikos,5728,3,2,1,3,6,10,-4,7
Panionios,5728,4,1,1,4,4,10,-6,4
AEK Athens,5729,1,4,2,0,7,1,6,14
PAOK Salonik,5729,2,2,3,1,10,5,5,9
P'thinaikos,5729,3,1,2,3,5,10,-5,5
Panionios,5729,4,1,1,4,4,10,-6,4
AEK Athens,5730,1,4,2,0,7,1,6,14
PAOK Salonik,5730,2,2,2,2,9,7,2,8
P'thinaikos,5730,3,2,1,3,7,9,-2,7
Panionios,5730,4,1,1,4,4,10,-6,4
AEK Athens,5731,1,4,2,0,7,1,6,14
PAOK Salonik,5731,2,2,2,2,9,8,1,8
P'thinaikos,5731,3,2,1,3,8,9,-1,7
Panionios,5731,4,1,1,4,4,10,-6,4
AEK Athens,5732,1,4,2,0,7,1,6,14
PAOK Salonik,5732,2,3,2,1,11,5,6,11
P'thinaikos,5732,3,1,1,4,5,11,-6,4
Panionios,5732,4,1,1,4,4,10,-6,4
AEK Athens,5733,1,4,2,0,7,1,6,14
PAOK Salonik,5733,2,3,2,1,10,4,6,11
P'thinaikos,5733,3,1,1,4,4,10,-6,4
Panionios,5733,3,1,1,4,4,10,-6,4
AEK Athens,5734,1,4,2,0,7,1,6,14
PAOK Salonik,5734,2,3,2,1,12,4,8,11
Panionios,5734,3,1,1,4,4,10,-6,4
P'thinaikos,5734,4,1,1,4,4,12,-8,4
AEK Athens,5735,1,4,2,0,7,1,6,14
PAOK Salonik,5735,2,2,2,2,11,8,3,8
P'thinaikos,5735,3,2,1,3,8,11,-3,7
Panionios,5735,4,1,1,4,4,10,-6,4
AEK Athens,5736,1,4,2,0,7,1,6,14
PAOK Salonik,5736,2,2,3,1,10,5,5,9
P'thinaikos,5736,3,1,2,3,5,10,-5,5
Panionios,5736,4,1,1,4,4,10,-6,4
AEK Athens,5737,1,4,2,0,7,1,6,14
PAOK Salonik,5737,2,2,3,1,9,4,5,9
P'thinaikos,5737,3,1,2,3,4,9,-5,5
Panionios,5737,4,1,1,4,4,10,-6,4
AEK Athens,5738,1,4,2,0,7,1,6,14
PAOK Salonik,5738,2,2,2,2,11,7,4,8
P'thinaikos,5738,3,2,1,3,7,11,-4,7
Panionios,5738,4,1,1,4,4,10,-6,4
AEK Athens,5739,1,4,2,0,7,1,6,14
PAOK Salonik,5739,2,2,2,2,9,6,3,8
P'thinaikos,5739,3,2,1,3,6,9,-3,7
Panionios,5739,4,1,1,4,4,10,-6,4
AEK Athens,5740,1,4,2,0,7,1,6,14
PAOK Salonik,5740,2,2,2,2,9,6,3,8
P'thinaikos,5740,3,2,1,3,6,9,-3,7
Panionios,5740,4,1,1,4,4,10,-6,4
AEK Athens,5741,1,4,2,0,7,1,6,14
PAOK Salonik,5741,2,2,2,2,10,7,3,8
P'thinaikos,5741,3,2,1,3,7,10,-3,7
Panionios,5741,4,1,1,4,4,10,-6,4
AEK Athens,5742,1,4,2,0,7,1,6,14
PAOK Salonik,5742,2,3,2,1,11,4,7,11
Panionios,5742,3,1,1,4,4,10,-6,4
P'thinaikos,5742,4,1,1,4,4,11,-7,4
AEK Athens,5743,1,4,2,0,7,1,6,14
PAOK Salonik,5743,2,2,2,2,9,6,3,8
P'thinaikos,5743,3,2,1,3,6,9,-3,7
Panionios,5743,4,1,1,4,4,10,-6,4
AEK Athens,5744,1,4,2,0,7,1,6,14
PAOK Salonik,5744,2,2,3,1,9,4,5,9
P'thinaikos,5744,3,1,2,3,4,9,-5,5
Panionios,5744,4,1,1,4,4,10,-6,4
AEK Athens,5745,1,4,2,0,7,1,6,14
PAOK Salonik,5745,2,2,2,2,9,5,4,8
P'thinaikos,5745,3,2,1,3,5,9,-4,7
Panionios,5745,4,1,1,4,4,10,-6,4
AEK Athens,5746,1,4,2,0,7,1,6,14
PAOK Salonik,5746,2,3,2,1,11,4,7,11
Panionios,5746,3,1,1,4,4,10,-6,4
P'thinaikos,5746,4,1,1,4,4,11,-7,4
AEK Athens,5747,1,4,2,0,7,1,6,14
PAOK Salonik,5747,2,3,2,1,13,4,9,11
Panionios,5747,3,1,1,4,4,10,-6,4
P'thinaikos,5747,4,1,1,4,4,13,-9,4
AEK Athens,5748,1,4,2,0,7,1,6,14
PAOK Salonik,5748,2,2,2,2,9,7,2,8
P'thinaikos,5748,3,2,1,3,7,9,-2,7
Panionios,5748,4,1,1,4,4,10,-6,4
AEK Athens,5749,1,4,2,0,7,1,6,14
PAOK Salonik,5749,2,2,2,2,9,5,4,8
P'thinaikos,5749,3,2,1,3,5,9,-4,7
Panionios,5749,4,1,1,4,4,10,-6,4
AEK Athens,5750,1,4,2,0,7,1,6,14
PAOK Salonik,5750,2,3,2,1,11,5,6,11
P'thinaikos,5750,3,1,1,4,5,11,-6,4
Panionios,5750,4,1,1,4,4,10,-6,4
AEK Athens,5751,1,4,2,0,7,1,6,14
PAOK Salonik,5751,2,2,2,2,9,7,2,8
P'thinaikos,5751,3,2,1,3,7,9,-2,7
Panionios,5751,4,1,1,4,4,10,-6,4
AEK Athens,5752,1,4,2,0,7,1,6,14
PAOK Salonik,5752,2,3,2,1,11,5,6,11
P'thinaikos,5752,3,1,1,4,5,11,-6,4
Panionios,5752,4,1,1,4,4,10,-6,4
AEK Athens,5753,1,4,2,0,7,1,6,14
PAOK Salonik,5753,2,2,3,1,10,5,5,9
P'thinaikos,5753,3,1,2,3,5,10,-5,5
Panionios,5753,4,1,1,4,4,10,-6,4
AEK Athens,5754,1,4,2,0,7,1,6,14
PAOK Salonik,5754,2,2,2,2,9,5,4,8
P'thinaikos,5754,3,2,1,3,5,9,-4,7
Panionios,5754,4,1,1,4,4,10,-6,4
AEK Athens,5755,1,4,2,0,7,1,6,14
PAOK Salonik,5755,2,2,2,2,9,5,4,8
P'thinaikos,5755,3,2,1,3,5,9,-4,7
Panionios,5755,4,1,1,4,4,10,-6,4
AEK Athens,5756,1,4,2,0,7,1,6,14
PAOK Salonik,5756,2,2,3,1,9,4,5,9
P'thinaikos,5756,3,1,2,3,4,9,-5,5
Panionios,5756,4,1,1,4,4,10,-6,4
AEK Athens,5757,1,4,2,0,7,1,6,14
PAOK Salonik,5757,2,3,2,1,12,5,7,11
Panionios,5757,3,1,1,4,4,10,-6,4
P'thinaikos,5757,4,1,1,4,5,12,-7,4
AEK Athens,5758,1,4,2,0,7,1,6,14
PAOK Salonik,5758,2,2,3,1,11,6,5,9
P'thinaikos,5758,3,1,2,3,6,11,-5,5
Panionios,5758,4,1,1,4,4,10,-6,4
AEK Athens,5759,1,4,2,0,7,1,6,14
PAOK Salonik,5759,2,2,2,2,9,6,3,8
P'thinaikos,5759,3,2,1,3,6,9,-3,7
Panionios,5759,4,1,1,4,4,10,-6,4
AEK Athens,5760,1,4,2,0,7,1,6,14
PAOK Salonik,5760,2,3,2,1,13,4,9,11
Panionios,5760,3,1,1,4,4,10,-6,4
P'thinaikos,5760,4,1,1,4,4,13,-9,4
AEK Athens,5761,1,4,2,0,7,1,6,14
PAOK Salonik,5761,2,2,3,1,10,5,5,9
P'thinaikos,5761,3,1,2,3,5,10,-5,5
Panionios,5761,4,1,1,4,4,10,-6,4
AEK Athens,5762,1,4,2,0,7,1,6,14
PAOK Salonik,5762,2,2,3,1,11,6,5,9
P'thinaikos,5762,3,1,2,3,6,11,-5,5
Panionios,5762,4,1,1,4,4,10,-6,4
AEK Athens,5763,1,4,2,0,7,1,6,14
PAOK Salonik,5763,2,2,2,2,11,8,3,8
P'thinaikos,5763,3,2,1,3,8,11,-3,7
Panionios,5763,4,1,1,4,4,10,-6,4
AEK Athens,5764,1,4,2,0,7,1,6,14
PAOK Salonik,5764,2,3,2,1,10,4,6,11
P'thinaikos,5764,3,1,1,4,4,10,-6,4
Panionios,5764,3,1,1,4,4,10,-6,4
AEK Athens,5765,1,4,2,0,7,1,6,14
PAOK Salonik,5765,2,2,2,2,9,5,4,8
P'thinaikos,5765,3,2,1,3,5,9,-4,7
Panionios,5765,4,1,1,4,4,10,-6,4
AEK Athens,5766,1,4,2,0,7,1,6,14
PAOK Salonik,5766,2,2,2,2,10,7,3,8
P'thinaikos,5766,3,2,1,3,7,10,-3,7
Panionios,5766,4,1,1,4,4,10,-6,4
AEK Athens,5767,1,4,2,0,7,1,6,14
PAOK Salonik,5767,2,3,2,1,10,4,6,11
P'thinaikos,5767,3,1,1,4,4,10,-6,4
Panionios,5767,3,1,1,4,4,10,-6,4
AEK Athens,5768,1,4,2,0,7,1,6,14
PAOK Salonik,5768,2,3,2,1,11,4,7,11
Panionios,5768,3,1,1,4,4,10,-6,4
P'thinaikos,5768,4,1,1,4,4,11,-7,4
AEK Athens,5769,1,4,2,0,7,1,6,14
PAOK Salonik,5769,2,2,2,2,10,6,4,8
P'thinaikos,5769,3,2,1,3,6,10,-4,7
Panionios,5769,4,1,1,4,4,10,-6,4
AEK Athens,5770,1,4,2,0,7,1,6,14
PAOK Salonik,5770,2,2,3,1,10,5,5,9
P'thinaikos,5770,3,1,2,3,5,10,-5,5
Panionios,5770,4,1,1,4,4,10,-6,4
AEK Athens,5771,1,4,2,0,7,1,6,14
PAOK Salonik,5771,2,3,2,1,12,6,6,11
P'thinaikos,5771,3,1,1,4,6,12,-6,4
Panionios,5771,4,1,1,4,4,10,-6,4
AEK Athens,5772,1,4,2,0,7,1,6,14
PAOK Salonik,5772,2,3,2,1,12,4,8,11
Panionios,5772,3,1,1,4,4,10,-6,4
P'thinaikos,5772,4,1,1,4,4,12,-8,4
AEK Athens,5773,1,4,2,0,7,1,6,14
PAOK Salonik,5773,2,2,3,1,10,5,5,9
P'thinaikos,5773,3,1,2,3,5,10,-5,5
Panionios,5773,4,1,1,4,4,10,-6,4
AEK Athens,5774,1,4,2,0,7,1,6,14
PAOK Salonik,5774,2,2,2,2,9,6,3,8
P'thinaikos,5774,3,2,1,3,6,9,-3,7
Panionios,5774,4,1,1,4,4,10,-6,4
AEK Athens,5775,1,4,2,0,7,1,6,14
PAOK Salonik,5775,2,2,3,1,10,5,5,9
P'thinaikos,5775,3,1,2,3,5,10,-5,5
Panionios,5775,4,1,1,4,4,10,-6,4
AEK Athens,5776,1,4,2,0,7,1,6,14
PAOK Salonik,5776,2,2,3,1,10,5,5,9
P'thinaikos,5776,3,1,2,3,5,10,-5,5
Panionios,5776,4,1,1,4,4,10,-6,4
AEK Athens,5777,1,4,2,0,7,1,6,14
PAOK Salonik,5777,2,3,2,1,11,4,7,11
Panionios,5777,3,1,1,4,4,10,-6,4
P'thinaikos,5777,4,1,1,4,4,11,-7,4
AEK Athens,5778,1,4,2,0,7,1,6,14
PAOK Salonik,5778,2,2,3,1,9,4,5,9
P'thinaikos,5778,3,1,2,3,4,9,-5,5
Panionios,5778,4,1,1,4,4,10,-6,4
AEK Athens,5779,1,4,2,0,7,1,6,14
PAOK Salonik,5779,2,2,2,2,9,5,4,8
P'thinaikos,5779,3,2,1,3,5,9,-4,7
Panionios,5779,4,1,1,4,4,10,-6,4
AEK Athens,5780,1,4,2,0,7,1,6,14
PAOK Salonik,5780,2,2,3,1,11,6,5,9
P'thinaikos,5780,3,1,2,3,6,11,-5,5
Panionios,5780,4,1,1,4,4,10,-6,4
AEK Athens,5781,1,4,2,0,7,1,6,14
PAOK Salonik,5781,2,2,2,2,9,5,4,8
P'thinaikos,5781,3,2,1,3,5,9,-4,7
Panionios,5781,4,1,1,4,4,10,-6,4
AEK Athens,5782,1,4,2,0,7,1,6,14
PAOK Salonik,5782,2,3,2,1,11,5,6,11
P'thinaikos,5782,3,1,1,4,5,11,-6,4
Panionios,5782,4,1,1,4,4,10,-6,4
AEK Athens,5783,1,4,2,0,7,1,6,14
PAOK Salonik,5783,2,2,2,2,9,5,4,8
P'thinaikos,5783,3,2,1,3,5,9,-4,7
Panionios,5783,4,1,1,4,4,10,-6,4
AEK Athens,5784,1,4,2,0,7,1,6,14
PAOK Salonik,5784,2,2,2,2,10,9,1,8
P'thinaikos,5784,3,2,1,3,9,10,-1,7
Panionios,5784,4,1,1,4,4,10,-6,4
AEK Athens,5785,1,4,2,0,7,1,6,14
PAOK Salonik,5785,2,2,2,2,9,5,4,8
P'thinaikos,5785,3,2,1,3,5,9,-4,7
Panionios,5785,4,1,1,4,4,10,-6,4
AEK Athens,5786,1,4,2,0,7,1,6,14
PAOK Salonik,5786,2,2,2,2,9,7,2,8
P'thinaikos,5786,3,2,1,3,7,9,-2,7
Panionios,5786,4,1,1,4,4,10,-6,4
AEK Athens,5787,1,4,2,0,7,1,6,14
PAOK Salonik,5787,2,3,2,1,11,4,7,11
Panionios,5787,3,1,1,4,4,10,-6,4
P'thinaikos,5787,4,1,1,4,4,11,-7,4
AEK Athens,5788,1,4,2,0,7,1,6,14
PAOK Salonik,5788,2,2,2,2,10,9,1,8
P'thinaikos,5788,3,2,1,3,9,10,-1,7
Panionios,5788,4,1,1,4,4,10,-6,4
AEK Athens,5789,1,4,2,0,7,1,6,14
PAOK Salonik,5789,2,3,2,1,11,5,6,11
P'thinaikos,5789,3,1,1,4,5,11,-6,4
Panionios,5789,4,1,1,4,4,10,-6,4
AEK Athens,5790,1,4,2,0,7,1,6,14
PAOK Salonik,5790,2,2,2,2,9,5,4,8
P'thinaikos,5790,3,2,1,3,5,9,-4,7
Panionios,5790,4,1,1,4,4,10,-6,4
AEK Athens,5791,1,4,2,0,7,1,6,14
PAOK Salonik,5791,2,2,3,1,10,5,5,9
P'thinaikos,5791,3,1,2,3,5,10,-5,5
Panionios,5791,4,1,1,4,4,10,-6,4
AEK Athens,5792,1,4,2,0,7,1,6,14
PAOK Salonik,5792,2,2,2,2,10,7,3,8
P'thinaikos,5792,3,2,1,3,7,10,-3,7
Panionios,5792,4,1,1,4,4,10,-6,4
AEK Athens,5793,1,4,2,0,7,1,6,14
PAOK Salonik,5793,2,2,2,2,9,5,4,8
P'thinaikos,5793,3,2,1,3,5,9,-4,7
Panionios,5793,4,1,1,4,4,10,-6,4
AEK Athens,5794,1,4,2,0,7,1,6,14
PAOK Salonik,5794,2,2,2,2,9,6,3,8
P'thinaikos,5794,3,2,1,3,6,9,-3,7
Panionios,5794,4,1,1,4,4,10,-6,4
AEK Athens,5795,1,4,2,0,7,1,6,14
PAOK Salonik,5795,2,3,2,1,11,5,6,11
P'thinaikos,5795,3,1,1,4,5,11,-6,4
Panionios,5795,4,1,1,4,4,10,-6,4
AEK Athens,5796,1,4,2,0,7,1,6,14
PAOK Salonik,5796,2,2,3,1,10,5,5,9
P'thinaikos,5796,3,1,2,3,5,10,-5,5
Panionios,5796,4,1,1,4,4,10,-6,4
AEK Athens,5797,1,4,2,0,7,1,6,14
PAOK Salonik,5797,2,3,2,1,12,5,7,11
Panionios,5797,3,1,1,4,4,10,-6,4
P'thinaikos,5797,4,1,1,4,5,12,-7,4
AEK Athens,5798,1,4,2,0,7,1,6,14
PAOK Salonik,5798,2,2,2,2,9,5,4,8
P'thinaikos,5798,3,2,1,3,5,9,-4,7
Panionios,5798,4,1,1,4,4,10,-6,4
AEK Athens,5799,1,4,2,0,7,1,6,14
PAOK Salonik,5799,2,3,2,1,11,4,7,11
Panionios,5799,3,1,1,4,4,10,-6,4
P'thinaikos,5799,4,1,1,4,4,11,-7,4
AEK Athens,5800,1,4,2,0,7,1,6,14
PAOK Salonik,5800,2,2,2,2,9,6,3,8
P'thinaikos,5800,3,2,1,3,6,9,-3,7
Panionios,5800,4,1,1,4,4,10,-6,4
AEK Athens,5801,1,4,2,0,7,1,6,14
PAOK Salonik,5801,2,2,3,1,11,6,5,9
P'thinaikos,5801,3,1,2,3,6,11,-5,5
Panionios,5801,4,1,1,4,4,10,-6,4
AEK Athens,5802,1,4,2,0,7,1,6,14
PAOK Salonik,5802,2,2,2,2,11,7,4,8
P'thinaikos,5802,3,2,1,3,7,11,-4,7
Panionios,5802,4,1,1,4,4,10,-6,4
AEK Athens,5803,1,4,2,0,7,1,6,14
PAOK Salonik,5803,2,2,3,1,9,4,5,9
P'thinaikos,5803,3,1,2,3,4,9,-5,5
Panionios,5803,4,1,1,4,4,10,-6,4
AEK Athens,5804,1,4,2,0,7,1,6,14
PAOK Salonik,5804,2,2,2,2,11,7,4,8
P'thinaikos,5804,3,2,1,3,7,11,-4,7
Panionios,5804,4,1,1,4,4,10,-6,4
AEK Athens,5805,1,4,2,0,7,1,6,14
PAOK Salonik,5805,2,3,2,1,11,4,7,11
Panionios,5805,3,1,1,4,4,10,-6,4
P'thinaikos,5805,4,1,1,4,4,11,-7,4
AEK Athens,5806,1,4,2,0,7,1,6,14
PAOK Salonik,5806,2,3,2,1,10,4,6,11
P'thinaikos,5806,3,1,1,4,4,10,-6,4
Panionios,5806,3,1,1,4,4,10,-6,4
AEK Athens,5807,1,4,2,0,7,1,6,14
PAOK Salonik,5807,2,3,2,1,12,4,8,11
Panionios,5807,3,1,1,4,4,10,-6,4
P'thinaikos,5807,4,1,1,4,4,12,-8,4
AEK Athens,5808,1,4,2,0,7,1,6,14
PAOK Salonik,5808,2,2,2,2,9,5,4,8
P'thinaikos,5808,3,2,1,3,5,9,-4,7
Panionios,5808,4,1,1,4,4,10,-6,4
AEK Athens,5809,1,4,2,0,7,1,6,14
PAOK Salonik,5809,2,2,2,2,9,5,4,8
P'thinaikos,5809,3,2,1,3,5,9,-4,7
Panionios,5809,4,1,1,4,4,10,-6,4
AEK Athens,5810,1,4,2,0,7,1,6,14
PAOK Salonik,5810,2,3,2,1,11,4,7,11
Panionios,5810,3,1,1,4,4,10,-6,4
P'thinaikos,5810,4,1,1,4,4,11,-7,4
AEK Athens,5811,1,4,2,0,7,1,6,14
PAOK Salonik,5811,2,2,3,1,10,5,5,9
P'thinaikos,5811,3,1,2,3,5,10,-5,5
Panionios,5811,4,1,1,4,4,10,-6,4
AEK Athens,5812,1,4,2,0,7,1,6,14
PAOK Salonik,5812,2,3,2,1,11,5,6,11
P'thinaikos,5812,3,1,1,4,5,11,-6,4
Panionios,5812,4,1,1,4,4,10,-6,4
AEK Athens,5813,1,4,2,0,7,1,6,14
PAOK Salonik,5813,2,3,2,1,13,6,7,11
Panionios,5813,3,1,1,4,4,10,-6,4
P'thinaikos,5813,4,1,1,4,6,13,-7,4
AEK Athens,5814,1,4,2,0,7,1,6,14
PAOK Salonik,5814,2,2,2,2,9,5,4,8
P'thinaikos,5814,3,2,1,3,5,9,-4,7
Panionios,5814,4,1,1,4,4,10,-6,4
AEK Athens,5815,1,4,2,0,7,1,6,14
PAOK Salonik,5815,2,2,3,1,10,5,5,9
P'thinaikos,5815,3,1,2,3,5,10,-5,5
Panionios,5815,4,1,1,4,4,10,-6,4
AEK Athens,5816,1,4,2,0,7,1,6,14
PAOK Salonik,5816,2,3,2,1,10,4,6,11
P'thinaikos,5816,3,1,1,4,4,10,-6,4
Panionios,5816,3,1,1,4,4,10,-6,4
AEK Athens,5817,1,4,2,0,7,1,6,14
PAOK Salonik,5817,2,2,2,2,9,7,2,8
P'thinaikos,5817,3,2,1,3,7,9,-2,7
Panionios,5817,4,1,1,4,4,10,-6,4
AEK Athens,5818,1,4,2,0,7,1,6,14
PAOK Salonik,5818,2,3,2,1,10,4,6,11
P'thinaikos,5818,3,1,1,4,4,10,-6,4
Panionios,5818,3,1,1,4,4,10,-6,4
AEK Athens,5819,1,4,2,0,7,1,6,14
PAOK Salonik,5819,2,3,2,1,11,4,7,11
Panionios,5819,3,1,1,4,4,10,-6,4
P'thinaikos,5819,4,1,1,4,4,11,-7,4
AEK Athens,5820,1,4,2,0,7,1,6,14
PAOK Salonik,5820,2,3,2,1,11,5,6,11
P'thinaikos,5820,3,1,1,4,5,11,-6,4
Panionios,5820,4,1,1,4,4,10,-6,4
AEK Athens,5821,1,4,2,0,7,1,6,14
PAOK Salonik,5821,2,2,3,1,11,6,5,9
P'thinaikos,5821,3,1,2,3,6,11,-5,5
Panionios,5821,4,1,1,4,4,10,-6,4
AEK Athens,5822,1,4,2,0,7,1,6,14
PAOK Salonik,5822,2,2,3,1,9,4,5,9
P'thinaikos,5822,3,1,2,3,4,9,-5,5
Panionios,5822,4,1,1,4,4,10,-6,4
AEK Athens,5823,1,4,2,0,7,1,6,14
PAOK Salonik,5823,2,2,2,2,9,6,3,8
P'thinaikos,5823,3,2,1,3,6,9,-3,7
Panionios,5823,4,1,1,4,4,10,-6,4
AEK Athens,5824,1,4,2,0,7,1,6,14
PAOK Salonik,5824,2,2,3,1,10,5,5,9
P'thinaikos,5824,3,1,2,3,5,10,-5,5
Panionios,5824,4,1,1,4,4,10,-6,4
AEK Athens,5825,1,4,2,0,7,1,6,14
PAOK Salonik,5825,2,2,2,2,9,5,4,8
P'thinaikos,5825,3,2,1,3,5,9,-4,7
Panionios,5825,4,1,1,4,4,10,-6,4
AEK Athens,5826,1,4,2,0,7,1,6,14
PAOK Salonik,5826,2,2,2,2,11,7,4,8
P'thinaikos,5826,3,2,1,3,7,11,-4,7
Panionios,5826,4,1,1,4,4,10,-6,4
AEK Athens,5827,1,4,2,0,7,1,6,14
PAOK Salonik,5827,2,3,2,1,10,4,6,11
P'thinaikos,5827,3,1,1,4,4,10,-6,4
Panionios,5827,3,1,1,4,4,10,-6,4
AEK Athens,5828,1,4,2,0,7,1,6,14
PAOK Salonik,5828,2,3,2,1,11,5,6,11
P'thinaikos,5828,3,1,1,4,5,11,-6,4
Panionios,5828,4,1,1,4,4,10,-6,4
AEK Athens,5829,1,4,2,0,7,1,6,14
PAOK Salonik,5829,2,2,2,2,9,5,4,8
P'thinaikos,5829,3,2,1,3,5,9,-4,7
Panionios,5829,4,1,1,4,4,10,-6,4
AEK Athens,5830,1,4,2,0,7,1,6,14
PAOK Salonik,5830,2,3,2,1,13,7,6,11
P'thinaikos,5830,3,1,1,4,7,13,-6,4
Panionios,5830,4,1,1,4,4,10,-6,4
AEK Athens,5831,1,4,2,0,7,1,6,14
PAOK Salonik,5831,2,3,2,1,11,5,6,11
P'thinaikos,5831,3,1,1,4,5,11,-6,4
Panionios,5831,4,1,1,4,4,10,-6,4
AEK Athens,5832,1,4,2,0,7,1,6,14
PAOK Salonik,5832,2,3,2,1,12,5,7,11
Panionios,5832,3,1,1,4,4,10,-6,4
P'thinaikos,5832,4,1,1,4,5,12,-7,4
AEK Athens,5833,1,4,2,0,7,1,6,14
PAOK Salonik,5833,2,2,3,1,10,5,5,9
P'thinaikos,5833,3,1,2,3,5,10,-5,5
Panionios,5833,4,1,1,4,4,10,-6,4
AEK Athens,5834,1,4,2,0,7,1,6,14
PAOK Salonik,5834,2,2,2,2,11,7,4,8
P'thinaikos,5834,3,2,1,3,7,11,-4,7
Panionios,5834,4,1,1,4,4,10,-6,4
AEK Athens,5835,1,4,2,0,7,1,6,14
PAOK Salonik,5835,2,3,2,1,10,4,6,11
P'thinaikos,5835,3,1,1,4,4,10,-6,4
Panionios,5835,3,1,1,4,4,10,-6,4
AEK Athens,5836,1,4,2,0,7,1,6,14
PAOK Salonik,5836,2,2,2,2,10,7,3,8
P'thinaikos,5836,3,2,1,3,7,10,-3,7
Panionios,5836,4,1,1,4,4,10,-6,4
AEK Athens,5837,1,4,2,0,7,1,6,14
PAOK Salonik,5837,2,2,2,2,10,6,4,8
P'thinaikos,5837,3,2,1,3,6,10,-4,7
Panionios,5837,4,1,1,4,4,10,-6,4
AEK Athens,5838,1,4,2,0,7,1,6,14
PAOK Salonik,5838,2,3,2,1,11,4,7,11
Panionios,5838,3,1,1,4,4,10,-6,4
P'thinaikos,5838,4,1,1,4,4,11,-7,4
AEK Athens,5839,1,4,2,0,7,1,6,14
PAOK Salonik,5839,2,3,2,1,11,4,7,11
Panionios,5839,3,1,1,4,4,10,-6,4
P'thinaikos,5839,4,1,1,4,4,11,-7,4
AEK Athens,5840,1,4,2,0,7,1,6,14
PAOK Salonik,5840,2,2,3,1,9,4,5,9
P'thinaikos,5840,3,1,2,3,4,9,-5,5
Panionios,5840,4,1,1,4,4,10,-6,4
AEK Athens,5841,1,4,2,0,7,1,6,14
PAOK Salonik,5841,2,2,3,1,10,5,5,9
P'thinaikos,5841,3,1,2,3,5,10,-5,5
Panionios,5841,4,1,1,4,4,10,-6,4
AEK Athens,5842,1,4,2,0,7,1,6,14
PAOK Salonik,5842,2,2,2,2,9,5,4,8
P'thinaikos,5842,3,2,1,3,5,9,-4,7
Panionios,5842,4,1,1,4,4,10,-6,4
AEK Athens,5843,1,4,2,0,7,1,6,14
PAOK Salonik,5843,2,2,2,2,9,6,3,8
P'thinaikos,5843,3,2,1,3,6,9,-3,7
Panionios,5843,4,1,1,4,4,10,-6,4
AEK Athens,5844,1,4,2,0,7,1,6,14
PAOK Salonik,5844,2,2,2,2,9,6,3,8
P'thinaikos,5844,3,2,1,3,6,9,-3,7
Panionios,5844,4,1,1,4,4,10,-6,4
AEK Athens,5845,1,4,2,0,7,1,6,14
PAOK Salonik,5845,2,3,2,1,10,4,6,11
P'thinaikos,5845,3,1,1,4,4,10,-6,4
Panionios,5845,3,1,1,4,4,10,-6,4
AEK Athens,5846,1,4,2,0,7,1,6,14
PAOK Salonik,5846,2,2,3,1,11,6,5,9
P'thinaikos,5846,3,1,2,3,6,11,-5,5
Panionios,5846,4,1,1,4,4,10,-6,4
AEK Athens,5847,1,4,2,0,7,1,6,14
PAOK Salonik,5847,2,2,2,2,11,7,4,8
P'thinaikos,5847,3,2,1,3,7,11,-4,7
Panionios,5847,4,1,1,4,4,10,-6,4
AEK Athens,5848,1,4,2,0,7,1,6,14
PAOK Salonik,5848,2,3,2,1,10,4,6,11
P'thinaikos,5848,3,1,1,4,4,10,-6,4
Panionios,5848,3,1,1,4,4,10,-6,4
AEK Athens,5849,1,4,2,0,7,1,6,14
PAOK Salonik,5849,2,3,2,1,10,4,6,11
P'thinaikos,5849,3,1,1,4,4,10,-6,4
Panionios,5849,3,1,1,4,4,10,-6,4
AEK Athens,5850,1,4,2,0,7,1,6,14
PAOK Salonik,5850,2,3,2,1,13,7,6,11
P'thinaikos,5850,3,1,1,4,7,13,-6,4
Panionios,5850,4,1,1,4,4,10,-6,4
AEK Athens,5851,1,4,2,0,7,1,6,14
PAOK Salonik,5851,2,3,2,1,12,5,7,11
Panionios,5851,3,1,1,4,4,10,-6,4
P'thinaikos,5851,4,1,1,4,5,12,-7,4
AEK Athens,5852,1,4,2,0,7,1,6,14
PAOK Salonik,5852,2,2,3,1,9,4,5,9
P'thinaikos,5852,3,1,2,3,4,9,-5,5
Panionios,5852,4,1,1,4,4,10,-6,4
AEK Athens,5853,1,4,2,0,7,1,6,14
PAOK Salonik,5853,2,3,2,1,10,4,6,11
P'thinaikos,5853,3,1,1,4,4,10,-6,4
Panionios,5853,3,1,1,4,4,10,-6,4
AEK Athens,5854,1,4,2,0,7,1,6,14
PAOK Salonik,5854,2,2,3,1,10,5,5,9
P'thinaikos,5854,3,1,2,3,5,10,-5,5
Panionios,5854,4,1,1,4,4,10,-6,4
AEK Athens,5855,1,4,2,0,7,1,6,14
PAOK Salonik,5855,2,3,2,1,11,5,6,11
P'thinaikos,5855,3,1,1,4,5,11,-6,4
Panionios,5855,4,1,1,4,4,10,-6,4
AEK Athens,5856,1,4,2,0,7,1,6,14
PAOK Salonik,5856,2,2,3,1,10,5,5,9
P'thinaikos,5856,3,1,2,3,5,10,-5,5
Panionios,5856,4,1,1,4,4,10,-6,4
AEK Athens,5857,1,4,2,0,7,1,6,14
PAOK Salonik,5857,2,3,2,1,11,4,7,11
Panionios,5857,3,1,1,4,4,10,-6,4
P'thinaikos,5857,4,1,1,4,4,11,-7,4
AEK Athens,5858,1,4,2,0,7,1,6,14
PAOK Salonik,5858,2,2,3,1,9,4,5,9
P'thinaikos,5858,3,1,2,3,4,9,-5,5
Panionios,5858,4,1,1,4,4,10,-6,4
AEK Athens,5859,1,4,2,0,7,1,6,14
PAOK Salonik,5859,2,2,2,2,10,6,4,8
P'thinaikos,5859,3,2,1,3,6,10,-4,7
Panionios,5859,4,1,1,4,4,10,-6,4
AEK Athens,5860,1,4,2,0,7,1,6,14
PAOK Salonik,5860,2,2,2,2,9,5,4,8
P'thinaikos,5860,3,2,1,3,5,9,-4,7
Panionios,5860,4,1,1,4,4,10,-6,4
AEK Athens,5861,1,4,2,0,7,1,6,14
PAOK Salonik,5861,2,2,2,2,9,8,1,8
P'thinaikos,5861,3,2,1,3,8,9,-1,7
Panionios,5861,4,1,1,4,4,10,-6,4
AEK Athens,5862,1,4,2,0,7,1,6,14
PAOK Salonik,5862,2,2,3,1,10,5,5,9
P'thinaikos,5862,3,1,2,3,5,10,-5,5
Panionios,5862,4,1,1,4,4,10,-6,4
AEK Athens,5863,1,4,2,0,7,1,6,14
PAOK Salonik,5863,2,3,2,1,14,5,9,11
Panionios,5863,3,1,1,4,4,10,-6,4
P'thinaikos,5863,4,1,1,4,5,14,-9,4
AEK Athens,5864,1,4,2,0,7,1,6,14
PAOK Salonik,5864,2,2,2,2,9,5,4,8
P'thinaikos,5864,3,2,1,3,5,9,-4,7
Panionios,5864,4,1,1,4,4,10,-6,4
AEK Athens,5865,1,4,2,0,7,1,6,14
PAOK Salonik,5865,2,2,3,1,11,6,5,9
P'thinaikos,5865,3,1,2,3,6,11,-5,5
Panionios,5865,4,1,1,4,4,10,-6,4
AEK Athens,5866,1,4,2,0,7,1,6,14
PAOK Salonik,5866,2,2,3,1,9,4,5,9
P'thinaikos,5866,3,1,2,3,4,9,-5,5
Panionios,5866,4,1,1,4,4,10,-6,4
AEK Athens,5867,1,4,2,0,7,1,6,14
PAOK Salonik,5867,2,2,3,1,9,4,5,9
P'thinaikos,5867,3,1,2,3,4,9,-5,5
Panionios,5867,4,1,1,4,4,10,-6,4
AEK Athens,5868,1,4,2,0,7,1,6,14
PAOK Salonik,5868,2,2,3,1,9,4,5,9
P'thinaikos,5868,3,1,2,3,4,9,-5,5
Panionios,5868,4,1,1,4,4,10,-6,4
AEK Athens,5869,1,4,2,0,7,1,6,14
PAOK Salonik,5869,2,3,2,1,11,4,7,11
Panionios,5869,3,1,1,4,4,10,-6,4
P'thinaikos,5869,4,1,1,4,4,11,-7,4
AEK Athens,5870,1,4,2,0,7,1,6,14
PAOK Salonik,5870,2,2,3,1,9,4,5,9
P'thinaikos,5870,3,1,2,3,4,9,-5,5
Panionios,5870,4,1,1,4,4,10,-6,4
AEK Athens,5871,1,4,2,0,7,1,6,14
PAOK Salonik,5871,2,2,3,1,9,4,5,9
P'thinaikos,5871,3,1,2,3,4,9,-5,5
Panionios,5871,4,1,1,4,4,10,-6,4
AEK Athens,5872,1,4,2,0,7,1,6,14
PAOK Salonik,5872,2,3,2,1,10,4,6,11
P'thinaikos,5872,3,1,1,4,4,10,-6,4
Panionios,5872,3,1,1,4,4,10,-6,4
AEK Athens,5873,1,4,2,0,7,1,6,14
PAOK Salonik,5873,2,2,3,1,10,5,5,9
P'thinaikos,5873,3,1,2,3,5,10,-5,5
Panionios,5873,4,1,1,4,4,10,-6,4
AEK Athens,5874,1,4,2,0,7,1,6,14
PAOK Salonik,5874,2,2,3,1,9,4,5,9
P'thinaikos,5874,3,1,2,3,4,9,-5,5
Panionios,5874,4,1,1,4,4,10,-6,4
AEK Athens,5875,1,4,2,0,7,1,6,14
PAOK Salonik,5875,2,2,3,1,10,5,5,9
P'thinaikos,5875,3,1,2,3,5,10,-5,5
Panionios,5875,4,1,1,4,4,10,-6,4
AEK Athens,5876,1,4,2,0,7,1,6,14
PAOK Salonik,5876,2,2,3,1,10,5,5,9
P'thinaikos,5876,3,1,2,3,5,10,-5,5
Panionios,5876,4,1,1,4,4,10,-6,4
AEK Athens,5877,1,4,2,0,7,1,6,14
PAOK Salonik,5877,2,3,2,1,10,4,6,11
P'thinaikos,5877,3,1,1,4,4,10,-6,4
Panionios,5877,3,1,1,4,4,10,-6,4
AEK Athens,5878,1,4,2,0,7,1,6,14
PAOK Salonik,5878,2,2,2,2,9,6,3,8
P'thinaikos,5878,3,2,1,3,6,9,-3,7
Panionios,5878,4,1,1,4,4,10,-6,4
AEK Athens,5879,1,4,2,0,7,1,6,14
PAOK Salonik,5879,2,2,2,2,9,6,3,8
P'thinaikos,5879,3,2,1,3,6,9,-3,7
Panionios,5879,4,1,1,4,4,10,-6,4
AEK Athens,5880,1,4,2,0,7,1,6,14
PAOK Salonik,5880,2,3,2,1,11,5,6,11
P'thinaikos,5880,3,1,1,4,5,11,-6,4
Panionios,5880,4,1,1,4,4,10,-6,4
AEK Athens,5881,1,4,2,0,7,1,6,14
PAOK Salonik,5881,2,2,3,1,11,6,5,9
P'thinaikos,5881,3,1,2,3,6,11,-5,5
Panionios,5881,4,1,1,4,4,10,-6,4
AEK Athens,5882,1,4,2,0,7,1,6,14
PAOK Salonik,5882,2,3,2,1,11,4,7,11
Panionios,5882,3,1,1,4,4,10,-6,4
P'thinaikos,5882,4,1,1,4,4,11,-7,4
AEK Athens,5883,1,4,2,0,7,1,6,14
PAOK Salonik,5883,2,3,2,1,10,4,6,11
P'thinaikos,5883,3,1,1,4,4,10,-6,4
Panionios,5883,3,1,1,4,4,10,-6,4
AEK Athens,5884,1,4,2,0,7,1,6,14
PAOK Salonik,5884,2,2,2,2,9,6,3,8
P'thinaikos,5884,3,2,1,3,6,9,-3,7
Panionios,5884,4,1,1,4,4,10,-6,4
AEK Athens,5885,1,4,2,0,7,1,6,14
PAOK Salonik,5885,2,2,3,1,10,5,5,9
P'thinaikos,5885,3,1,2,3,5,10,-5,5
Panionios,5885,4,1,1,4,4,10,-6,4
AEK Athens,5886,1,4,2,0,7,1,6,14
PAOK Salonik,5886,2,2,2,2,9,6,3,8
P'thinaikos,5886,3,2,1,3,6,9,-3,7
Panionios,5886,4,1,1,4,4,10,-6,4
AEK Athens,5887,1,4,2,0,7,1,6,14
PAOK Salonik,5887,2,2,2,2,9,5,4,8
P'thinaikos,5887,3,2,1,3,5,9,-4,7
Panionios,5887,4,1,1,4,4,10,-6,4
AEK Athens,5888,1,4,2,0,7,1,6,14
PAOK Salonik,5888,2,3,2,1,12,4,8,11
Panionios,5888,3,1,1,4,4,10,-6,4
P'thinaikos,5888,4,1,1,4,4,12,-8,4
AEK Athens,5889,1,4,2,0,7,1,6,14
PAOK Salonik,5889,2,3,2,1,11,4,7,11
Panionios,5889,3,1,1,4,4,10,-6,4
P'thinaikos,5889,4,1,1,4,4,11,-7,4
AEK Athens,5890,1,4,2,0,7,1,6,14
PAOK Salonik,5890,2,3,2,1,13,4,9,11
Panionios,5890,3,1,1,4,4,10,-6,4
P'thinaikos,5890,4,1,1,4,4,13,-9,4
AEK Athens,5891,1,4,2,0,7,1,6,14
PAOK Salonik,5891,2,2,3,1,10,5,5,9
P'thinaikos,5891,3,1,2,3,5,10,-5,5
Panionios,5891,4,1,1,4,4,10,-6,4
AEK Athens,5892,1,4,2,0,7,1,6,14
PAOK Salonik,5892,2,3,2,1,10,4,6,11
P'thinaikos,5892,3,1,1,4,4,10,-6,4
Panionios,5892,3,1,1,4,4,10,-6,4
AEK Athens,5893,1,4,2,0,7,1,6,14
PAOK Salonik,5893,2,2,3,1,9,4,5,9
P'thinaikos,5893,3,1,2,3,4,9,-5,5
Panionios,5893,4,1,1,4,4,10,-6,4
AEK Athens,5894,1,4,2,0,7,1,6,14
PAOK Salonik,5894,2,2,2,2,10,7,3,8
P'thinaikos,5894,3,2,1,3,7,10,-3,7
Panionios,5894,4,1,1,4,4,10,-6,4
AEK Athens,5895,1,4,2,0,7,1,6,14
PAOK Salonik,5895,2,2,3,1,10,5,5,9
P'thinaikos,5895,3,1,2,3,5,10,-5,5
Panionios,5895,4,1,1,4,4,10,-6,4
AEK Athens,5896,1,4,2,0,7,1,6,14
PAOK Salonik,5896,2,3,2,1,11,5,6,11
P'thinaikos,5896,3,1,1,4,5,11,-6,4
Panionios,5896,4,1,1,4,4,10,-6,4
AEK Athens,5897,1,4,2,0,7,1,6,14
PAOK Salonik,5897,2,3,2,1,11,4,7,11
Panionios,5897,3,1,1,4,4,10,-6,4
P'thinaikos,5897,4,1,1,4,4,11,-7,4
AEK Athens,5898,1,4,2,0,7,1,6,14
PAOK Salonik,5898,2,3,2,1,12,5,7,11
Panionios,5898,3,1,1,4,4,10,-6,4
P'thinaikos,5898,4,1,1,4,5,12,-7,4
AEK Athens,5899,1,4,2,0,7,1,6,14
PAOK Salonik,5899,2,2,2,2,9,7,2,8
P'thinaikos,5899,3,2,1,3,7,9,-2,7
Panionios,5899,4,1,1,4,4,10,-6,4
AEK Athens,5900,1,4,2,0,7,1,6,14
PAOK Salonik,5900,2,3,2,1,12,4,8,11
Panionios,5900,3,1,1,4,4,10,-6,4
P'thinaikos,5900,4,1,1,4,4,12,-8,4
AEK Athens,5901,1,4,2,0,7,1,6,14
PAOK Salonik,5901,2,2,2,2,9,5,4,8
P'thinaikos,5901,3,2,1,3,5,9,-4,7
Panionios,5901,4,1,1,4,4,10,-6,4
AEK Athens,5902,1,4,2,0,7,1,6,14
PAOK Salonik,5902,2,3,2,1,11,4,7,11
Panionios,5902,3,1,1,4,4,10,-6,4
P'thinaikos,5902,4,1,1,4,4,11,-7,4
AEK Athens,5903,1,4,2,0,7,1,6,14
PAOK Salonik,5903,2,2,2,2,9,5,4,8
P'thinaikos,5903,3,2,1,3,5,9,-4,7
Panionios,5903,4,1,1,4,4,10,-6,4
AEK Athens,5904,1,4,2,0,7,1,6,14
PAOK Salonik,5904,2,2,3,1,10,5,5,9
P'thinaikos,5904,3,1,2,3,5,10,-5,5
Panionios,5904,4,1,1,4,4,10,-6,4
AEK Athens,5905,1,4,2,0,7,1,6,14
PAOK Salonik,5905,2,2,2,2,9,8,1,8
P'thinaikos,5905,3,2,1,3,8,9,-1,7
Panionios,5905,4,1,1,4,4,10,-6,4
AEK Athens,5906,1,4,2,0,7,1,6,14
PAOK Salonik,5906,2,2,3,1,10,5,5,9
P'thinaikos,5906,3,1,2,3,5,10,-5,5
Panionios,5906,4,1,1,4,4,10,-6,4
AEK Athens,5907,1,4,2,0,7,1,6,14
PAOK Salonik,5907,2,3,2,1,11,4,7,11
Panionios,5907,3,1,1,4,4,10,-6,4
P'thinaikos,5907,4,1,1,4,4,11,-7,4
AEK Athens,5908,1,4,2,0,7,1,6,14
PAOK Salonik,5908,2,2,3,1,10,5,5,9
P'thinaikos,5908,3,1,2,3,5,10,-5,5
Panionios,5908,4,1,1,4,4,10,-6,4
AEK Athens,5909,1,4,2,0,7,1,6,14
PAOK Salonik,5909,2,3,2,1,12,6,6,11
P'thinaikos,5909,3,1,1,4,6,12,-6,4
Panionios,5909,4,1,1,4,4,10,-6,4
AEK Athens,5910,1,4,2,0,7,1,6,14
PAOK Salonik,5910,2,3,2,1,10,4,6,11
P'thinaikos,5910,3,1,1,4,4,10,-6,4
Panionios,5910,3,1,1,4,4,10,-6,4
AEK Athens,5911,1,4,2,0,7,1,6,14
PAOK Salonik,5911,2,3,2,1,10,4,6,11
P'thinaikos,5911,3,1,1,4,4,10,-6,4
Panionios,5911,3,1,1,4,4,10,-6,4
AEK Athens,5912,1,4,2,0,7,1,6,14
PAOK Salonik,5912,2,2,2,2,9,5,4,8
P'thinaikos,5912,3,2,1,3,5,9,-4,7
Panionios,5912,4,1,1,4,4,10,-6,4
AEK Athens,5913,1,4,2,0,7,1,6,14
PAOK Salonik,5913,2,3,2,1,12,4,8,11
Panionios,5913,3,1,1,4,4,10,-6,4
P'thinaikos,5913,4,1,1,4,4,12,-8,4
AEK Athens,5914,1,4,2,0,7,1,6,14
PAOK Salonik,5914,2,2,2,2,9,5,4,8
P'thinaikos,5914,3,2,1,3,5,9,-4,7
Panionios,5914,4,1,1,4,4,10,-6,4
AEK Athens,5915,1,4,2,0,7,1,6,14
PAOK Salonik,5915,2,3,2,1,12,4,8,11
Panionios,5915,3,1,1,4,4,10,-6,4
P'thinaikos,5915,4,1,1,4,4,12,-8,4
AEK Athens,5916,1,4,2,0,7,1,6,14
PAOK Salonik,5916,2,3,2,1,11,5,6,11
P'thinaikos,5916,3,1,1,4,5,11,-6,4
Panionios,5916,4,1,1,4,4,10,-6,4
AEK Athens,5917,1,4,2,0,7,1,6,14
PAOK Salonik,5917,2,2,2,2,9,6,3,8
P'thinaikos,5917,3,2,1,3,6,9,-3,7
Panionios,5917,4,1,1,4,4,10,-6,4
AEK Athens,5918,1,4,2,0,7,1,6,14
PAOK Salonik,5918,2,2,3,1,10,5,5,9
P'thinaikos,5918,3,1,2,3,5,10,-5,5
Panionios,5918,4,1,1,4,4,10,-6,4
AEK Athens,5919,1,4,2,0,7,1,6,14
PAOK Salonik,5919,2,3,2,1,12,4,8,11
Panionios,5919,3,1,1,4,4,10,-6,4
P'thinaikos,5919,4,1,1,4,4,12,-8,4
AEK Athens,5920,1,4,2,0,7,1,6,14
PAOK Salonik,5920,2,2,2,2,9,5,4,8
P'thinaikos,5920,3,2,1,3,5,9,-4,7
Panionios,5920,4,1,1,4,4,10,-6,4
AEK Athens,5921,1,4,2,0,7,1,6,14
PAOK Salonik,5921,2,3,2,1,11,4,7,11
Panionios,5921,3,1,1,4,4,10,-6,4
P'thinaikos,5921,4,1,1,4,4,11,-7,4
AEK Athens,5922,1,4,2,0,7,1,6,14
PAOK Salonik,5922,2,2,2,2,10,7,3,8
P'thinaikos,5922,3,2,1,3,7,10,-3,7
Panionios,5922,4,1,1,4,4,10,-6,4
AEK Athens,5923,1,4,2,0,7,1,6,14
PAOK Salonik,5923,2,3,2,1,10,4,6,11
P'thinaikos,5923,3,1,1,4,4,10,-6,4
Panionios,5923,3,1,1,4,4,10,-6,4
AEK Athens,5924,1,4,2,0,7,1,6,14
PAOK Salonik,5924,2,3,2,1,13,4,9,11
Panionios,5924,3,1,1,4,4,10,-6,4
P'thinaikos,5924,4,1,1,4,4,13,-9,4
AEK Athens,5925,1,4,2,0,7,1,6,14
PAOK Salonik,5925,2,2,3,1,10,5,5,9
P'thinaikos,5925,3,1,2,3,5,10,-5,5
Panionios,5925,4,1,1,4,4,10,-6,4
AEK Athens,5926,1,4,2,0,7,1,6,14
PAOK Salonik,5926,2,2,2,2,10,7,3,8
P'thinaikos,5926,3,2,1,3,7,10,-3,7
Panionios,5926,4,1,1,4,4,10,-6,4
AEK Athens,5927,1,4,2,0,7,1,6,14
PAOK Salonik,5927,2,2,3,1,10,5,5,9
P'thinaikos,5927,3,1,2,3,5,10,-5,5
Panionios,5927,4,1,1,4,4,10,-6,4
AEK Athens,5928,1,4,2,0,7,1,6,14
PAOK Salonik,5928,2,2,2,2,10,6,4,8
P'thinaikos,5928,3,2,1,3,6,10,-4,7
Panionios,5928,4,1,1,4,4,10,-6,4
AEK Athens,5929,1,4,2,0,7,1,6,14
PAOK Salonik,5929,2,3,2,1,10,4,6,11
P'thinaikos,5929,3,1,1,4,4,10,-6,4
Panionios,5929,3,1,1,4,4,10,-6,4
AEK Athens,5930,1,4,2,0,7,1,6,14
PAOK Salonik,5930,2,2,3,1,9,4,5,9
P'thinaikos,5930,3,1,2,3,4,9,-5,5
Panionios,5930,4,1,1,4,4,10,-6,4
AEK Athens,5931,1,4,2,0,7,1,6,14
PAOK Salonik,5931,2,3,2,1,12,4,8,11
Panionios,5931,3,1,1,4,4,10,-6,4
P'thinaikos,5931,4,1,1,4,4,12,-8,4
AEK Athens,5932,1,4,2,0,7,1,6,14
PAOK Salonik,5932,2,3,2,1,10,4,6,11
P'thinaikos,5932,3,1,1,4,4,10,-6,4
Panionios,5932,3,1,1,4,4,10,-6,4
AEK Athens,5933,1,4,2,0,7,1,6,14
PAOK Salonik,5933,2,3,2,1,10,4,6,11
P'thinaikos,5933,3,1,1,4,4,10,-6,4
Panionios,5933,3,1,1,4,4,10,-6,4
AEK Athens,5934,1,4,2,0,7,1,6,14
PAOK Salonik,5934,2,2,2,2,9,6,3,8
P'thinaikos,5934,3,2,1,3,6,9,-3,7
Panionios,5934,4,1,1,4,4,10,-6,4
AEK Athens,5935,1,4,2,0,7,1,6,14
PAOK Salonik,5935,2,3,2,1,10,4,6,11
P'thinaikos,5935,3,1,1,4,4,10,-6,4
Panionios,5935,3,1,1,4,4,10,-6,4
AEK Athens,5936,1,4,2,0,7,1,6,14
PAOK Salonik,5936,2,2,2,2,9,6,3,8
P'thinaikos,5936,3,2,1,3,6,9,-3,7
Panionios,5936,4,1,1,4,4,10,-6,4
AEK Athens,5937,1,4,2,0,7,1,6,14
PAOK Salonik,5937,2,3,2,1,12,5,7,11
Panionios,5937,3,1,1,4,4,10,-6,4
P'thinaikos,5937,4,1,1,4,5,12,-7,4
AEK Athens,5938,1,4,2,0,7,1,6,14
PAOK Salonik,5938,2,2,2,2,9,6,3,8
P'thinaikos,5938,3,2,1,3,6,9,-3,7
Panionios,5938,4,1,1,4,4,10,-6,4
AEK Athens,5939,1,4,2,0,7,1,6,14
PAOK Salonik,5939,2,2,2,2,9,5,4,8
P'thinaikos,5939,3,2,1,3,5,9,-4,7
Panionios,5939,4,1,1,4,4,10,-6,4
AEK Athens,5940,1,4,2,0,7,1,6,14
PAOK Salonik,5940,2,3,2,1,12,5,7,11
Panionios,5940,3,1,1,4,4,10,-6,4
P'thinaikos,5940,4,1,1,4,5,12,-7,4
AEK Athens,5941,1,4,2,0,7,1,6,14
PAOK Salonik,5941,2,3,2,1,10,4,6,11
P'thinaikos,5941,3,1,1,4,4,10,-6,4
Panionios,5941,3,1,1,4,4,10,-6,4
AEK Athens,5942,1,4,2,0,7,1,6,14
PAOK Salonik,5942,2,3,2,1,11,4,7,11
Panionios,5942,3,1,1,4,4,10,-6,4
P'thinaikos,5942,4,1,1,4,4,11,-7,4
AEK Athens,5943,1,4,2,0,7,1,6,14
PAOK Salonik,5943,2,3,2,1,12,4,8,11
Panionios,5943,3,1,1,4,4,10,-6,4
P'thinaikos,5943,4,1,1,4,4,12,-8,4
AEK Athens,5944,1,4,2,0,7,1,6,14
PAOK Salonik,5944,2,3,2,1,10,4,6,11
P'thinaikos,5944,3,1,1,4,4,10,-6,4
Panionios,5944,3,1,1,4,4,10,-6,4
AEK Athens,5945,1,4,2,0,7,1,6,14
PAOK Salonik,5945,2,2,2,2,10,6,4,8
P'thinaikos,5945,3,2,1,3,6,10,-4,7
Panionios,5945,4,1,1,4,4,10,-6,4
AEK Athens,5946,1,4,2,0,7,1,6,14
PAOK Salonik,5946,2,2,3,1,10,5,5,9
P'thinaikos,5946,3,1,2,3,5,10,-5,5
Panionios,5946,4,1,1,4,4,10,-6,4
AEK Athens,5947,1,4,2,0,7,1,6,14
PAOK Salonik,5947,2,3,2,1,11,4,7,11
Panionios,5947,3,1,1,4,4,10,-6,4
P'thinaikos,5947,4,1,1,4,4,11,-7,4
AEK Athens,5948,1,4,2,0,7,1,6,14
PAOK Salonik,5948,2,2,2,2,9,6,3,8
P'thinaikos,5948,3,2,1,3,6,9,-3,7
Panionios,5948,4,1,1,4,4,10,-6,4
AEK Athens,5949,1,4,2,0,7,1,6,14
PAOK Salonik,5949,2,3,2,1,11,5,6,11
P'thinaikos,5949,3,1,1,4,5,11,-6,4
Panionios,5949,4,1,1,4,4,10,-6,4
AEK Athens,5950,1,4,2,0,7,1,6,14
PAOK Salonik,5950,2,2,3,1,10,5,5,9
P'thinaikos,5950,3,1,2,3,5,10,-5,5
Panionios,5950,4,1,1,4,4,10,-6,4
AEK Athens,5951,1,4,2,0,7,1,6,14
PAOK Salonik,5951,2,3,2,1,11,5,6,11
P'thinaikos,5951,3,1,1,4,5,11,-6,4
Panionios,5951,4,1,1,4,4,10,-6,4
AEK Athens,5952,1,4,2,0,7,1,6,14
PAOK Salonik,5952,2,2,3,1,10,5,5,9
P'thinaikos,5952,3,1,2,3,5,10,-5,5
Panionios,5952,4,1,1,4,4,10,-6,4
AEK Athens,5953,1,4,2,0,7,1,6,14
PAOK Salonik,5953,2,2,3,1,10,5,5,9
P'thinaikos,5953,3,1,2,3,5,10,-5,5
Panionios,5953,4,1,1,4,4,10,-6,4
AEK Athens,5954,1,4,2,0,7,1,6,14
PAOK Salonik,5954,2,2,3,1,11,6,5,9
P'thinaikos,5954,3,1,2,3,6,11,-5,5
Panionios,5954,4,1,1,4,4,10,-6,4
AEK Athens,5955,1,4,2,0,7,1,6,14
PAOK Salonik,5955,2,2,2,2,10,6,4,8
P'thinaikos,5955,3,2,1,3,6,10,-4,7
Panionios,5955,4,1,1,4,4,10,-6,4
AEK Athens,5956,1,4,2,0,7,1,6,14
PAOK Salonik,5956,2,3,2,1,10,4,6,11
P'thinaikos,5956,3,1,1,4,4,10,-6,4
Panionios,5956,3,1,1,4,4,10,-6,4
AEK Athens,5957,1,4,2,0,7,1,6,14
PAOK Salonik,5957,2,2,3,1,10,5,5,9
P'thinaikos,5957,3,1,2,3,5,10,-5,5
Panionios,5957,4,1,1,4,4,10,-6,4
AEK Athens,5958,1,4,2,0,7,1,6,14
PAOK Salonik,5958,2,2,3,1,9,4,5,9
P'thinaikos,5958,3,1,2,3,4,9,-5,5
Panionios,5958,4,1,1,4,4,10,-6,4
AEK Athens,5959,1,4,2,0,7,1,6,14
PAOK Salonik,5959,2,3,2,1,12,4,8,11
Panionios,5959,3,1,1,4,4,10,-6,4
P'thinaikos,5959,4,1,1,4,4,12,-8,4
AEK Athens,5960,1,4,2,0,7,1,6,14
PAOK Salonik,5960,2,2,2,2,9,6,3,8
P'thinaikos,5960,3,2,1,3,6,9,-3,7
Panionios,5960,4,1,1,4,4,10,-6,4
AEK Athens,5961,1,4,2,0,7,1,6,14
PAOK Salonik,5961,2,2,2,2,10,6,4,8
P'thinaikos,5961,3,2,1,3,6,10,-4,7
Panionios,5961,4,1,1,4,4,10,-6,4
AEK Athens,5962,1,4,2,0,7,1,6,14
PAOK Salonik,5962,2,3,2,1,10,4,6,11
P'thinaikos,5962,3,1,1,4,4,10,-6,4
Panionios,5962,3,1,1,4,4,10,-6,4
AEK Athens,5963,1,4,2,0,7,1,6,14
PAOK Salonik,5963,2,2,3,1,11,6,5,9
P'thinaikos,5963,3,1,2,3,6,11,-5,5
Panionios,5963,4,1,1,4,4,10,-6,4
AEK Athens,5964,1,4,2,0,7,1,6,14
PAOK Salonik,5964,2,3,2,1,10,4,6,11
P'thinaikos,5964,3,1,1,4,4,10,-6,4
Panionios,5964,3,1,1,4,4,10,-6,4
AEK Athens,5965,1,4,2,0,7,1,6,14
PAOK Salonik,5965,2,2,2,2,9,6,3,8
P'thinaikos,5965,3,2,1,3,6,9,-3,7
Panionios,5965,4,1,1,4,4,10,-6,4
AEK Athens,5966,1,4,2,0,7,1,6,14
PAOK Salonik,5966,2,3,2,1,10,4,6,11
P'thinaikos,5966,3,1,1,4,4,10,-6,4
Panionios,5966,3,1,1,4,4,10,-6,4
AEK Athens,5967,1,4,2,0,7,1,6,14
PAOK Salonik,5967,2,3,2,1,11,4,7,11
Panionios,5967,3,1,1,4,4,10,-6,4
P'thinaikos,5967,4,1,1,4,4,11,-7,4
AEK Athens,5968,1,4,2,0,7,1,6,14
PAOK Salonik,5968,2,2,3,1,10,5,5,9
P'thinaikos,5968,3,1,2,3,5,10,-5,5
Panionios,5968,4,1,1,4,4,10,-6,4
AEK Athens,5969,1,4,2,0,7,1,6,14
PAOK Salonik,5969,2,3,2,1,14,4,10,11
Panionios,5969,3,1,1,4,4,10,-6,4
P'thinaikos,5969,4,1,1,4,4,14,-10,4
AEK Athens,5970,1,4,2,0,7,1,6,14
PAOK Salonik,5970,2,2,2,2,9,6,3,8
P'thinaikos,5970,3,2,1,3,6,9,-3,7
Panionios,5970,4,1,1,4,4,10,-6,4
AEK Athens,5971,1,4,2,0,7,1,6,14
PAOK Salonik,5971,2,2,2,2,9,5,4,8
P'thinaikos,5971,3,2,1,3,5,9,-4,7
Panionios,5971,4,1,1,4,4,10,-6,4
AEK Athens,5972,1,4,2,0,7,1,6,14
PAOK Salonik,5972,2,2,2,2,9,5,4,8
P'thinaikos,5972,3,2,1,3,5,9,-4,7
Panionios,5972,4,1,1,4,4,10,-6,4
AEK Athens,5973,1,4,2,0,7,1,6,14
PAOK Salonik,5973,2,3,2,1,10,4,6,11
P'thinaikos,5973,3,1,1,4,4,10,-6,4
Panionios,5973,3,1,1,4,4,10,-6,4
AEK Athens,5974,1,4,2,0,7,1,6,14
PAOK Salonik,5974,2,2,2,2,9,5,4,8
P'thinaikos,5974,3,2,1,3,5,9,-4,7
Panionios,5974,4,1,1,4,4,10,-6,4
AEK Athens,5975,1,4,2,0,7,1,6,14
PAOK Salonik,5975,2,2,2,2,9,7,2,8
P'thinaikos,5975,3,2,1,3,7,9,-2,7
Panionios,5975,4,1,1,4,4,10,-6,4
AEK Athens,5976,1,4,2,0,7,1,6,14
PAOK Salonik,5976,2,2,3,1,11,6,5,9
P'thinaikos,5976,3,1,2,3,6,11,-5,5
Panionios,5976,4,1,1,4,4,10,-6,4
AEK Athens,5977,1,4,2,0,7,1,6,14
PAOK Salonik,5977,2,3,2,1,11,5,6,11
P'thinaikos,5977,3,1,1,4,5,11,-6,4
Panionios,5977,4,1,1,4,4,10,-6,4
AEK Athens,5978,1,4,2,0,7,1,6,14
PAOK Salonik,5978,2,3,2,1,12,4,8,11
Panionios,5978,3,1,1,4,4,10,-6,4
P'thinaikos,5978,4,1,1,4,4,12,-8,4
AEK Athens,5979,1,4,2,0,7,1,6,14
PAOK Salonik,5979,2,2,3,1,9,4,5,9
P'thinaikos,5979,3,1,2,3,4,9,-5,5
Panionios,5979,4,1,1,4,4,10,-6,4
AEK Athens,5980,1,4,2,0,7,1,6,14
PAOK Salonik,5980,2,3,2,1,11,4,7,11
Panionios,5980,3,1,1,4,4,10,-6,4
P'thinaikos,5980,4,1,1,4,4,11,-7,4
AEK Athens,5981,1,4,2,0,7,1,6,14
PAOK Salonik,5981,2,2,2,2,11,7,4,8
P'thinaikos,5981,3,2,1,3,7,11,-4,7
Panionios,5981,4,1,1,4,4,10,-6,4
AEK Athens,5982,1,4,2,0,7,1,6,14
PAOK Salonik,5982,2,2,2,2,10,6,4,8
P'thinaikos,5982,3,2,1,3,6,10,-4,7
Panionios,5982,4,1,1,4,4,10,-6,4
AEK Athens,5983,1,4,2,0,7,1,6,14
PAOK Salonik,5983,2,3,2,1,11,5,6,11
P'thinaikos,5983,3,1,1,4,5,11,-6,4
Panionios,5983,4,1,1,4,4,10,-6,4
AEK Athens,5984,1,4,2,0,7,1,6,14
PAOK Salonik,5984,2,2,3,1,10,5,5,9
P'thinaikos,5984,3,1,2,3,5,10,-5,5
Panionios,5984,4,1,1,4,4,10,-6,4
AEK Athens,5985,1,4,2,0,7,1,6,14
PAOK Salonik,5985,2,2,2,2,10,6,4,8
P'thinaikos,5985,3,2,1,3,6,10,-4,7
Panionios,5985,4,1,1,4,4,10,-6,4
AEK Athens,5986,1,4,2,0,7,1,6,14
PAOK Salonik,5986,2,2,2,2,9,5,4,8
P'thinaikos,5986,3,2,1,3,5,9,-4,7
Panionios,5986,4,1,1,4,4,10,-6,4
AEK Athens,5987,1,4,2,0,7,1,6,14
PAOK Salonik,5987,2,2,2,2,9,5,4,8
P'thinaikos,5987,3,2,1,3,5,9,-4,7
Panionios,5987,4,1,1,4,4,10,-6,4
AEK Athens,5988,1,4,2,0,7,1,6,14
PAOK Salonik,5988,2,2,2,2,9,7,2,8
P'thinaikos,5988,3,2,1,3,7,9,-2,7
Panionios,5988,4,1,1,4,4,10,-6,4
AEK Athens,5989,1,4,2,0,7,1,6,14
PAOK Salonik,5989,2,2,2,2,9,6,3,8
P'thinaikos,5989,3,2,1,3,6,9,-3,7
Panionios,5989,4,1,1,4,4,10,-6,4
AEK Athens,5990,1,4,2,0,7,1,6,14
PAOK Salonik,5990,2,2,3,1,10,5,5,9
P'thinaikos,5990,3,1,2,3,5,10,-5,5
Panionios,5990,4,1,1,4,4,10,-6,4
AEK Athens,5991,1,4,2,0,7,1,6,14
PAOK Salonik,5991,2,2,3,1,10,5,5,9
P'thinaikos,5991,3,1,2,3,5,10,-5,5
Panionios,5991,4,1,1,4,4,10,-6,4
AEK Athens,5992,1,4,2,0,7,1,6,14
PAOK Salonik,5992,2,2,2,2,10,6,4,8
P'thinaikos,5992,3,2,1,3,6,10,-4,7
Panionios,5992,4,1,1,4,4,10,-6,4
AEK Athens,5993,1,4,2,0,7,1,6,14
PAOK Salonik,5993,2,2,3,1,9,4,5,9
P'thinaikos,5993,3,1,2,3,4,9,-5,5
Panionios,5993,4,1,1,4,4,10,-6,4
AEK Athens,5994,1,4,2,0,7,1,6,14
PAOK Salonik,5994,2,2,2,2,9,7,2,8
P'thinaikos,5994,3,2,1,3,7,9,-2,7
Panionios,5994,4,1,1,4,4,10,-6,4
AEK Athens,5995,1,4,2,0,7,1,6,14
PAOK Salonik,5995,2,3,2,1,11,4,7,11
Panionios,5995,3,1,1,4,4,10,-6,4
P'thinaikos,5995,4,1,1,4,4,11,-7,4
AEK Athens,5996,1,4,2,0,7,1,6,14
PAOK Salonik,5996,2,2,3,1,10,5,5,9
P'thinaikos,5996,3,1,2,3,5,10,-5,5
Panionios,5996,4,1,1,4,4,10,-6,4
AEK Athens,5997,1,4,2,0,7,1,6,14
PAOK Salonik,5997,2,2,2,2,10,8,2,8
P'thinaikos,5997,3,2,1,3,8,10,-2,7
Panionios,5997,4,1,1,4,4,10,-6,4
AEK Athens,5998,1,4,2,0,7,1,6,14
PAOK Salonik,5998,2,2,3,1,10,5,5,9
P'thinaikos,5998,3,1,2,3,5,10,-5,5
Panionios,5998,4,1,1,4,4,10,-6,4
AEK Athens,5999,1,4,2,0,7,1,6,14
PAOK Salonik,5999,2,2,3,1,11,6,5,9
P'thinaikos,5999,3,1,2,3,6,11,-5,5
Panionios,5999,4,1,1,4,4,10,-6,4
AEK Athens,6000,1,4,2,0,7,1,6,14
PAOK Salonik,6000,2,3,2,1,11,4,7,11
Panionios,6000,3,1,1,4,4,10,-6,4
P'thinaikos,6000,4,1,1,4,4,11,-7,4
AEK Athens,6001,1,4,2,0,7,1,6,14
PAOK Salonik,6001,2,2,2,2,9,7,2,8
P'thinaikos,6001,3,2,1,3,7,9,-2,7
Panionios,6001,4,1,1,4,4,10,-6,4
AEK Athens,6002,1,4,2,0,7,1,6,14
PAOK Salonik,6002,2,2,2,2,9,6,3,8
P'thinaikos,6002,3,2,1,3,6,9,-3,7
Panionios,6002,4,1,1,4,4,10,-6,4
AEK Athens,6003,1,4,2,0,7,1,6,14
PAOK Salonik,6003,2,2,2,2,9,8,1,8
P'thinaikos,6003,3,2,1,3,8,9,-1,7
Panionios,6003,4,1,1,4,4,10,-6,4
AEK Athens,6004,1,4,2,0,7,1,6,14
PAOK Salonik,6004,2,2,3,1,9,4,5,9
P'thinaikos,6004,3,1,2,3,4,9,-5,5
Panionios,6004,4,1,1,4,4,10,-6,4
AEK Athens,6005,1,4,2,0,7,1,6,14
PAOK Salonik,6005,2,3,2,1,11,5,6,11
P'thinaikos,6005,3,1,1,4,5,11,-6,4
Panionios,6005,4,1,1,4,4,10,-6,4
AEK Athens,6006,1,4,2,0,7,1,6,14
PAOK Salonik,6006,2,2,3,1,10,5,5,9
P'thinaikos,6006,3,1,2,3,5,10,-5,5
Panionios,6006,4,1,1,4,4,10,-6,4
AEK Athens,6007,1,4,2,0,7,1,6,14
PAOK Salonik,6007,2,2,2,2,10,7,3,8
P'thinaikos,6007,3,2,1,3,7,10,-3,7
Panionios,6007,4,1,1,4,4,10,-6,4
AEK Athens,6008,1,4,2,0,7,1,6,14
PAOK Salonik,6008,2,2,3,1,11,6,5,9
P'thinaikos,6008,3,1,2,3,6,11,-5,5
Panionios,6008,4,1,1,4,4,10,-6,4
AEK Athens,6009,1,4,2,0,7,1,6,14
PAOK Salonik,6009,2,2,3,1,10,5,5,9
P'thinaikos,6009,3,1,2,3,5,10,-5,5
Panionios,6009,4,1,1,4,4,10,-6,4
AEK Athens,6010,1,4,2,0,7,1,6,14
PAOK Salonik,6010,2,2,3,1,10,5,5,9
P'thinaikos,6010,3,1,2,3,5,10,-5,5
Panionios,6010,4,1,1,4,4,10,-6,4
AEK Athens,6011,1,4,2,0,7,1,6,14
PAOK Salonik,6011,2,2,2,2,10,6,4,8
P'thinaikos,6011,3,2,1,3,6,10,-4,7
Panionios,6011,4,1,1,4,4,10,-6,4
AEK Athens,6012,1,4,2,0,7,1,6,14
PAOK Salonik,6012,2,2,2,2,9,5,4,8
P'thinaikos,6012,3,2,1,3,5,9,-4,7
Panionios,6012,4,1,1,4,4,10,-6,4
AEK Athens,6013,1,4,2,0,7,1,6,14
PAOK Salonik,6013,2,2,2,2,9,7,2,8
P'thinaikos,6013,3,2,1,3,7,9,-2,7
Panionios,6013,4,1,1,4,4,10,-6,4
AEK Athens,6014,1,4,2,0,7,1,6,14
PAOK Salonik,6014,2,2,3,1,10,5,5,9
P'thinaikos,6014,3,1,2,3,5,10,-5,5
Panionios,6014,4,1,1,4,4,10,-6,4
AEK Athens,6015,1,4,2,0,7,1,6,14
PAOK Salonik,6015,2,2,3,1,10,5,5,9
P'thinaikos,6015,3,1,2,3,5,10,-5,5
Panionios,6015,4,1,1,4,4,10,-6,4
AEK Athens,6016,1,4,2,0,7,1,6,14
PAOK Salonik,6016,2,3,2,1,10,4,6,11
P'thinaikos,6016,3,1,1,4,4,10,-6,4
Panionios,6016,3,1,1,4,4,10,-6,4
AEK Athens,6017,1,4,2,0,7,1,6,14
PAOK Salonik,6017,2,2,3,1,11,6,5,9
P'thinaikos,6017,3,1,2,3,6,11,-5,5
Panionios,6017,4,1,1,4,4,10,-6,4
AEK Athens,6018,1,4,2,0,7,1,6,14
PAOK Salonik,6018,2,2,3,1,11,6,5,9
P'thinaikos,6018,3,1,2,3,6,11,-5,5
Panionios,6018,4,1,1,4,4,10,-6,4
AEK Athens,6019,1,4,2,0,7,1,6,14
PAOK Salonik,6019,2,2,3,1,9,4,5,9
P'thinaikos,6019,3,1,2,3,4,9,-5,5
Panionios,6019,4,1,1,4,4,10,-6,4
AEK Athens,6020,1,4,2,0,7,1,6,14
PAOK Salonik,6020,2,3,2,1,11,5,6,11
P'thinaikos,6020,3,1,1,4,5,11,-6,4
Panionios,6020,4,1,1,4,4,10,-6,4
AEK Athens,6021,1,4,2,0,7,1,6,14
PAOK Salonik,6021,2,2,2,2,10,6,4,8
P'thinaikos,6021,3,2,1,3,6,10,-4,7
Panionios,6021,4,1,1,4,4,10,-6,4
AEK Athens,6022,1,4,2,0,7,1,6,14
PAOK Salonik,6022,2,2,3,1,11,6,5,9
P'thinaikos,6022,3,1,2,3,6,11,-5,5
Panionios,6022,4,1,1,4,4,10,-6,4
AEK Athens,6023,1,4,2,0,7,1,6,14
PAOK Salonik,6023,2,3,2,1,10,4,6,11
P'thinaikos,6023,3,1,1,4,4,10,-6,4
Panionios,6023,3,1,1,4,4,10,-6,4
AEK Athens,6024,1,4,2,0,7,1,6,14
PAOK Salonik,6024,2,2,2,2,9,5,4,8
P'thinaikos,6024,3,2,1,3,5,9,-4,7
Panionios,6024,4,1,1,4,4,10,-6,4
AEK Athens,6025,1,4,2,0,7,1,6,14
PAOK Salonik,6025,2,2,2,2,9,6,3,8
P'thinaikos,6025,3,2,1,3,6,9,-3,7
Panionios,6025,4,1,1,4,4,10,-6,4
AEK Athens,6026,1,4,2,0,7,1,6,14
PAOK Salonik,6026,2,2,3,1,10,5,5,9
P'thinaikos,6026,3,1,2,3,5,10,-5,5
Panionios,6026,4,1,1,4,4,10,-6,4
AEK Athens,6027,1,4,2,0,7,1,6,14
PAOK Salonik,6027,2,3,2,1,11,5,6,11
P'thinaikos,6027,3,1,1,4,5,11,-6,4
Panionios,6027,4,1,1,4,4,10,-6,4
AEK Athens,6028,1,4,2,0,7,1,6,14
PAOK Salonik,6028,2,2,3,1,11,6,5,9
P'thinaikos,6028,3,1,2,3,6,11,-5,5
Panionios,6028,4,1,1,4,4,10,-6,4
AEK Athens,6029,1,4,2,0,7,1,6,14
PAOK Salonik,6029,2,2,3,1,10,5,5,9
P'thinaikos,6029,3,1,2,3,5,10,-5,5
Panionios,6029,4,1,1,4,4,10,-6,4
AEK Athens,6030,1,4,2,0,7,1,6,14
PAOK Salonik,6030,2,3,2,1,12,4,8,11
Panionios,6030,3,1,1,4,4,10,-6,4
P'thinaikos,6030,4,1,1,4,4,12,-8,4
AEK Athens,6031,1,4,2,0,7,1,6,14
PAOK Salonik,6031,2,2,2,2,9,6,3,8
P'thinaikos,6031,3,2,1,3,6,9,-3,7
Panionios,6031,4,1,1,4,4,10,-6,4
AEK Athens,6032,1,4,2,0,7,1,6,14
PAOK Salonik,6032,2,2,3,1,10,5,5,9
P'thinaikos,6032,3,1,2,3,5,10,-5,5
Panionios,6032,4,1,1,4,4,10,-6,4
AEK Athens,6033,1,4,2,0,7,1,6,14
PAOK Salonik,6033,2,3,2,1,13,6,7,11
Panionios,6033,3,1,1,4,4,10,-6,4
P'thinaikos,6033,4,1,1,4,6,13,-7,4
AEK Athens,6034,1,4,2,0,7,1,6,14
PAOK Salonik,6034,2,2,3,1,10,5,5,9
P'thinaikos,6034,3,1,2,3,5,10,-5,5
Panionios,6034,4,1,1,4,4,10,-6,4
AEK Athens,6035,1,4,2,0,7,1,6,14
PAOK Salonik,6035,2,2,3,1,9,4,5,9
P'thinaikos,6035,3,1,2,3,4,9,-5,5
Panionios,6035,4,1,1,4,4,10,-6,4
AEK Athens,6036,1,4,2,0,7,1,6,14
PAOK Salonik,6036,2,3,2,1,10,4,6,11
P'thinaikos,6036,3,1,1,4,4,10,-6,4
Panionios,6036,3,1,1,4,4,10,-6,4
AEK Athens,6037,1,4,2,0,7,1,6,14
PAOK Salonik,6037,2,2,3,1,9,4,5,9
P'thinaikos,6037,3,1,2,3,4,9,-5,5
Panionios,6037,4,1,1,4,4,10,-6,4
AEK Athens,6038,1,4,2,0,7,1,6,14
PAOK Salonik,6038,2,3,2,1,13,6,7,11
Panionios,6038,3,1,1,4,4,10,-6,4
P'thinaikos,6038,4,1,1,4,6,13,-7,4
AEK Athens,6039,1,4,2,0,7,1,6,14
PAOK Salonik,6039,2,2,3,1,10,5,5,9
P'thinaikos,6039,3,1,2,3,5,10,-5,5
Panionios,6039,4,1,1,4,4,10,-6,4
AEK Athens,6040,1,4,2,0,7,1,6,14
PAOK Salonik,6040,2,2,2,2,9,7,2,8
P'thinaikos,6040,3,2,1,3,7,9,-2,7
Panionios,6040,4,1,1,4,4,10,-6,4
AEK Athens,6041,1,4,2,0,7,1,6,14
PAOK Salonik,6041,2,3,2,1,11,4,7,11
Panionios,6041,3,1,1,4,4,10,-6,4
P'thinaikos,6041,4,1,1,4,4,11,-7,4
AEK Athens,6042,1,4,2,0,7,1,6,14
PAOK Salonik,6042,2,3,2,1,10,4,6,11
P'thinaikos,6042,3,1,1,4,4,10,-6,4
Panionios,6042,3,1,1,4,4,10,-6,4
AEK Athens,6043,1,4,2,0,7,1,6,14
PAOK Salonik,6043,2,2,2,2,9,5,4,8
P'thinaikos,6043,3,2,1,3,5,9,-4,7
Panionios,6043,4,1,1,4,4,10,-6,4
AEK Athens,6044,1,4,2,0,7,1,6,14
PAOK Salonik,6044,2,2,2,2,9,5,4,8
P'thinaikos,6044,3,2,1,3,5,9,-4,7
Panionios,6044,4,1,1,4,4,10,-6,4
AEK Athens,6045,1,4,2,0,7,1,6,14
PAOK Salonik,6045,2,3,2,1,11,5,6,11
P'thinaikos,6045,3,1,1,4,5,11,-6,4
Panionios,6045,4,1,1,4,4,10,-6,4
AEK Athens,6046,1,4,2,0,7,1,6,14
PAOK Salonik,6046,2,3,2,1,12,5,7,11
Panionios,6046,3,1,1,4,4,10,-6,4
P'thinaikos,6046,4,1,1,4,5,12,-7,4
AEK Athens,6047,1,4,2,0,7,1,6,14
PAOK Salonik,6047,2,2,2,2,10,9,1,8
P'thinaikos,6047,3,2,1,3,9,10,-1,7
Panionios,6047,4,1,1,4,4,10,-6,4
AEK Athens,6048,1,4,2,0,7,1,6,14
PAOK Salonik,6048,2,3,2,1,11,4,7,11
Panionios,6048,3,1,1,4,4,10,-6,4
P'thinaikos,6048,4,1,1,4,4,11,-7,4
AEK Athens,6049,1,4,2,0,7,1,6,14
PAOK Salonik,6049,2,3,2,1,10,4,6,11
P'thinaikos,6049,3,1,1,4,4,10,-6,4
Panionios,6049,3,1,1,4,4,10,-6,4
AEK Athens,6050,1,4,2,0,7,1,6,14
PAOK Salonik,6050,2,2,3,1,10,5,5,9
P'thinaikos,6050,3,1,2,3,5,10,-5,5
Panionios,6050,4,1,1,4,4,10,-6,4
AEK Athens,6051,1,4,2,0,7,1,6,14
PAOK Salonik,6051,2,2,3,1,10,5,5,9
P'thinaikos,6051,3,1,2,3,5,10,-5,5
Panionios,6051,4,1,1,4,4,10,-6,4
AEK Athens,6052,1,4,2,0,7,1,6,14
PAOK Salonik,6052,2,2,2,2,10,7,3,8
P'thinaikos,6052,3,2,1,3,7,10,-3,7
Panionios,6052,4,1,1,4,4,10,-6,4
AEK Athens,6053,1,4,2,0,7,1,6,14
PAOK Salonik,6053,2,3,2,1,11,4,7,11
Panionios,6053,3,1,1,4,4,10,-6,4
P'thinaikos,6053,4,1,1,4,4,11,-7,4
AEK Athens,6054,1,4,2,0,7,1,6,14
PAOK Salonik,6054,2,2,3,1,11,6,5,9
P'thinaikos,6054,3,1,2,3,6,11,-5,5
Panionios,6054,4,1,1,4,4,10,-6,4
AEK Athens,6055,1,4,2,0,7,1,6,14
PAOK Salonik,6055,2,2,2,2,10,6,4,8
P'thinaikos,6055,3,2,1,3,6,10,-4,7
Panionios,6055,4,1,1,4,4,10,-6,4
AEK Athens,6056,1,4,2,0,7,1,6,14
PAOK Salonik,6056,2,2,2,2,11,7,4,8
P'thinaikos,6056,3,2,1,3,7,11,-4,7
Panionios,6056,4,1,1,4,4,10,-6,4
AEK Athens,6057,1,4,2,0,7,1,6,14
PAOK Salonik,6057,2,3,2,1,11,5,6,11
P'thinaikos,6057,3,1,1,4,5,11,-6,4
Panionios,6057,4,1,1,4,4,10,-6,4
AEK Athens,6058,1,4,2,0,7,1,6,14
PAOK Salonik,6058,2,3,2,1,11,5,6,11
P'thinaikos,6058,3,1,1,4,5,11,-6,4
Panionios,6058,4,1,1,4,4,10,-6,4
AEK Athens,6059,1,4,2,0,7,1,6,14
PAOK Salonik,6059,2,2,3,1,10,5,5,9
P'thinaikos,6059,3,1,2,3,5,10,-5,5
Panionios,6059,4,1,1,4,4,10,-6,4
AEK Athens,6060,1,4,2,0,7,1,6,14
PAOK Salonik,6060,2,2,3,1,10,5,5,9
P'thinaikos,6060,3,1,2,3,5,10,-5,5
Panionios,6060,4,1,1,4,4,10,-6,4
AEK Athens,6061,1,4,2,0,7,1,6,14
PAOK Salonik,6061,2,2,2,2,9,5,4,8
P'thinaikos,6061,3,2,1,3,5,9,-4,7
Panionios,6061,4,1,1,4,4,10,-6,4
AEK Athens,6062,1,4,2,0,7,1,6,14
PAOK Salonik,6062,2,3,2,1,14,4,10,11
Panionios,6062,3,1,1,4,4,10,-6,4
P'thinaikos,6062,4,1,1,4,4,14,-10,4
AEK Athens,6063,1,4,2,0,7,1,6,14
PAOK Salonik,6063,2,3,2,1,10,4,6,11
P'thinaikos,6063,3,1,1,4,4,10,-6,4
Panionios,6063,3,1,1,4,4,10,-6,4
AEK Athens,6064,1,4,2,0,7,1,6,14
PAOK Salonik,6064,2,3,2,1,10,4,6,11
P'thinaikos,6064,3,1,1,4,4,10,-6,4
Panionios,6064,3,1,1,4,4,10,-6,4
AEK Athens,6065,1,4,2,0,7,1,6,14
PAOK Salonik,6065,2,2,2,2,9,5,4,8
P'thinaikos,6065,3,2,1,3,5,9,-4,7
Panionios,6065,4,1,1,4,4,10,-6,4
AEK Athens,6066,1,4,2,0,7,1,6,14
PAOK Salonik,6066,2,2,3,1,10,5,5,9
P'thinaikos,6066,3,1,2,3,5,10,-5,5
Panionios,6066,4,1,1,4,4,10,-6,4
AEK Athens,6067,1,4,2,0,7,1,6,14
PAOK Salonik,6067,2,3,2,1,10,4,6,11
P'thinaikos,6067,3,1,1,4,4,10,-6,4
Panionios,6067,3,1,1,4,4,10,-6,4
AEK Athens,6068,1,4,2,0,7,1,6,14
PAOK Salonik,6068,2,2,3,1,10,5,5,9
P'thinaikos,6068,3,1,2,3,5,10,-5,5
Panionios,6068,4,1,1,4,4,10,-6,4
AEK Athens,6069,1,4,2,0,7,1,6,14
PAOK Salonik,6069,2,2,2,2,9,5,4,8
P'thinaikos,6069,3,2,1,3,5,9,-4,7
Panionios,6069,4,1,1,4,4,10,-6,4
AEK Athens,6070,1,4,2,0,7,1,6,14
PAOK Salonik,6070,2,3,2,1,11,5,6,11
P'thinaikos,6070,3,1,1,4,5,11,-6,4
Panionios,6070,4,1,1,4,4,10,-6,4
AEK Athens,6071,1,4,2,0,7,1,6,14
PAOK Salonik,6071,2,2,3,1,9,4,5,9
P'thinaikos,6071,3,1,2,3,4,9,-5,5
Panionios,6071,4,1,1,4,4,10,-6,4
AEK Athens,6072,1,4,2,0,7,1,6,14
PAOK Salonik,6072,2,3,2,1,11,5,6,11
P'thinaikos,6072,3,1,1,4,5,11,-6,4
Panionios,6072,4,1,1,4,4,10,-6,4
AEK Athens,6073,1,4,2,0,7,1,6,14
PAOK Salonik,6073,2,2,2,2,10,6,4,8
P'thinaikos,6073,3,2,1,3,6,10,-4,7
Panionios,6073,4,1,1,4,4,10,-6,4
AEK Athens,6074,1,4,2,0,7,1,6,14
PAOK Salonik,6074,2,3,2,1,11,5,6,11
P'thinaikos,6074,3,1,1,4,5,11,-6,4
Panionios,6074,4,1,1,4,4,10,-6,4
AEK Athens,6075,1,4,2,0,7,1,6,14
PAOK Salonik,6075,2,3,2,1,12,6,6,11
P'thinaikos,6075,3,1,1,4,6,12,-6,4
Panionios,6075,4,1,1,4,4,10,-6,4
AEK Athens,6076,1,4,2,0,7,1,6,14
PAOK Salonik,6076,2,2,3,1,10,5,5,9
P'thinaikos,6076,3,1,2,3,5,10,-5,5
Panionios,6076,4,1,1,4,4,10,-6,4
AEK Athens,6077,1,4,2,0,7,1,6,14
PAOK Salonik,6077,2,3,2,1,10,4,6,11
P'thinaikos,6077,3,1,1,4,4,10,-6,4
Panionios,6077,3,1,1,4,4,10,-6,4
AEK Athens,6078,1,4,2,0,7,1,6,14
PAOK Salonik,6078,2,2,2,2,10,7,3,8
P'thinaikos,6078,3,2,1,3,7,10,-3,7
Panionios,6078,4,1,1,4,4,10,-6,4
AEK Athens,6079,1,4,2,0,7,1,6,14
PAOK Salonik,6079,2,3,2,1,12,5,7,11
Panionios,6079,3,1,1,4,4,10,-6,4
P'thinaikos,6079,4,1,1,4,5,12,-7,4
AEK Athens,6080,1,4,2,0,7,1,6,14
PAOK Salonik,6080,2,2,2,2,10,8,2,8
P'thinaikos,6080,3,2,1,3,8,10,-2,7
Panionios,6080,4,1,1,4,4,10,-6,4
AEK Athens,6081,1,4,2,0,7,1,6,14
PAOK Salonik,6081,2,3,2,1,10,4,6,11
P'thinaikos,6081,3,1,1,4,4,10,-6,4
Panionios,6081,3,1,1,4,4,10,-6,4
AEK Athens,6082,1,4,2,0,7,1,6,14
PAOK Salonik,6082,2,3,2,1,13,7,6,11
P'thinaikos,6082,3,1,1,4,7,13,-6,4
Panionios,6082,4,1,1,4,4,10,-6,4
AEK Athens,6083,1,4,2,0,7,1,6,14
PAOK Salonik,6083,2,3,2,1,11,5,6,11
P'thinaikos,6083,3,1,1,4,5,11,-6,4
Panionios,6083,4,1,1,4,4,10,-6,4
AEK Athens,6084,1,4,2,0,7,1,6,14
PAOK Salonik,6084,2,2,3,1,9,4,5,9
P'thinaikos,6084,3,1,2,3,4,9,-5,5
Panionios,6084,4,1,1,4,4,10,-6,4
AEK Athens,6085,1,4,2,0,7,1,6,14
PAOK Salonik,6085,2,2,3,1,12,7,5,9
P'thinaikos,6085,3,1,2,3,7,12,-5,5
Panionios,6085,4,1,1,4,4,10,-6,4
AEK Athens,6086,1,4,2,0,7,1,6,14
PAOK Salonik,6086,2,2,2,2,10,6,4,8
P'thinaikos,6086,3,2,1,3,6,10,-4,7
Panionios,6086,4,1,1,4,4,10,-6,4
AEK Athens,6087,1,4,2,0,7,1,6,14
PAOK Salonik,6087,2,3,2,1,11,5,6,11
P'thinaikos,6087,3,1,1,4,5,11,-6,4
Panionios,6087,4,1,1,4,4,10,-6,4
AEK Athens,6088,1,4,2,0,7,1,6,14
PAOK Salonik,6088,2,2,2,2,9,5,4,8
P'thinaikos,6088,3,2,1,3,5,9,-4,7
Panionios,6088,4,1,1,4,4,10,-6,4
AEK Athens,6089,1,4,2,0,7,1,6,14
PAOK Salonik,6089,2,2,2,2,10,6,4,8
P'thinaikos,6089,3,2,1,3,6,10,-4,7
Panionios,6089,4,1,1,4,4,10,-6,4
AEK Athens,6090,1,4,2,0,7,1,6,14
PAOK Salonik,6090,2,3,2,1,11,5,6,11
P'thinaikos,6090,3,1,1,4,5,11,-6,4
Panionios,6090,4,1,1,4,4,10,-6,4
AEK Athens,6091,1,4,2,0,7,1,6,14
PAOK Salonik,6091,2,2,2,2,9,5,4,8
P'thinaikos,6091,3,2,1,3,5,9,-4,7
Panionios,6091,4,1,1,4,4,10,-6,4
AEK Athens,6092,1,4,2,0,7,1,6,14
PAOK Salonik,6092,2,2,2,2,10,6,4,8
P'thinaikos,6092,3,2,1,3,6,10,-4,7
Panionios,6092,4,1,1,4,4,10,-6,4
AEK Athens,6093,1,4,2,0,7,1,6,14
PAOK Salonik,6093,2,2,2,2,9,5,4,8
P'thinaikos,6093,3,2,1,3,5,9,-4,7
Panionios,6093,4,1,1,4,4,10,-6,4
AEK Athens,6094,1,4,2,0,7,1,6,14
PAOK Salonik,6094,2,2,2,2,9,8,1,8
P'thinaikos,6094,3,2,1,3,8,9,-1,7
Panionios,6094,4,1,1,4,4,10,-6,4
AEK Athens,6095,1,4,2,0,7,1,6,14
PAOK Salonik,6095,2,3,2,1,11,5,6,11
P'thinaikos,6095,3,1,1,4,5,11,-6,4
Panionios,6095,4,1,1,4,4,10,-6,4
AEK Athens,6096,1,4,2,0,7,1,6,14
PAOK Salonik,6096,2,2,3,1,10,5,5,9
P'thinaikos,6096,3,1,2,3,5,10,-5,5
Panionios,6096,4,1,1,4,4,10,-6,4
AEK Athens,6097,1,4,2,0,7,1,6,14
PAOK Salonik,6097,2,2,3,1,10,5,5,9
P'thinaikos,6097,3,1,2,3,5,10,-5,5
Panionios,6097,4,1,1,4,4,10,-6,4
AEK Athens,6098,1,4,2,0,7,1,6,14
PAOK Salonik,6098,2,3,2,1,10,4,6,11
P'thinaikos,6098,3,1,1,4,4,10,-6,4
Panionios,6098,3,1,1,4,4,10,-6,4
AEK Athens,6099,1,4,2,0,7,1,6,14
PAOK Salonik,6099,2,2,3,1,10,5,5,9
P'thinaikos,6099,3,1,2,3,5,10,-5,5
Panionios,6099,4,1,1,4,4,10,-6,4
AEK Athens,6100,1,4,2,0,7,1,6,14
PAOK Salonik,6100,2,3,2,1,10,4,6,11
P'thinaikos,6100,3,1,1,4,4,10,-6,4
Panionios,6100,3,1,1,4,4,10,-6,4
AEK Athens,6101,1,4,2,0,7,1,6,14
PAOK Salonik,6101,2,2,2,2,11,7,4,8
P'thinaikos,6101,3,2,1,3,7,11,-4,7
Panionios,6101,4,1,1,4,4,10,-6,4
AEK Athens,6102,1,4,2,0,7,1,6,14
PAOK Salonik,6102,2,2,3,1,9,4,5,9
P'thinaikos,6102,3,1,2,3,4,9,-5,5
Panionios,6102,4,1,1,4,4,10,-6,4
AEK Athens,6103,1,4,2,0,7,1,6,14
PAOK Salonik,6103,2,2,3,1,10,5,5,9
P'thinaikos,6103,3,1,2,3,5,10,-5,5
Panionios,6103,4,1,1,4,4,10,-6,4
AEK Athens,6104,1,4,2,0,7,1,6,14
PAOK Salonik,6104,2,2,2,2,10,6,4,8
P'thinaikos,6104,3,2,1,3,6,10,-4,7
Panionios,6104,4,1,1,4,4,10,-6,4
AEK Athens,6105,1,4,2,0,7,1,6,14
PAOK Salonik,6105,2,2,3,1,11,6,5,9
P'thinaikos,6105,3,1,2,3,6,11,-5,5
Panionios,6105,4,1,1,4,4,10,-6,4
AEK Athens,6106,1,4,2,0,7,1,6,14
PAOK Salonik,6106,2,2,3,1,10,5,5,9
P'thinaikos,6106,3,1,2,3,5,10,-5,5
Panionios,6106,4,1,1,4,4,10,-6,4
AEK Athens,6107,1,4,2,0,7,1,6,14
PAOK Salonik,6107,2,2,3,1,9,4,5,9
P'thinaikos,6107,3,1,2,3,4,9,-5,5
Panionios,6107,4,1,1,4,4,10,-6,4
AEK Athens,6108,1,4,2,0,7,1,6,14
PAOK Salonik,6108,2,2,3,1,10,5,5,9
P'thinaikos,6108,3,1,2,3,5,10,-5,5
Panionios,6108,4,1,1,4,4,10,-6,4
AEK Athens,6109,1,4,2,0,7,1,6,14
PAOK Salonik,6109,2,2,3,1,12,7,5,9
P'thinaikos,6109,3,1,2,3,7,12,-5,5
Panionios,6109,4,1,1,4,4,10,-6,4
AEK Athens,6110,1,4,2,0,7,1,6,14
PAOK Salonik,6110,2,2,2,2,9,7,2,8
P'thinaikos,6110,3,2,1,3,7,9,-2,7
Panionios,6110,4,1,1,4,4,10,-6,4
AEK Athens,6111,1,4,2,0,7,1,6,14
PAOK Salonik,6111,2,2,2,2,9,5,4,8
P'thinaikos,6111,3,2,1,3,5,9,-4,7
Panionios,6111,4,1,1,4,4,10,-6,4
AEK Athens,6112,1,4,2,0,7,1,6,14
PAOK Salonik,6112,2,3,2,1,11,5,6,11
P'thinaikos,6112,3,1,1,4,5,11,-6,4
Panionios,6112,4,1,1,4,4,10,-6,4
AEK Athens,6113,1,4,2,0,7,1,6,14
PAOK Salonik,6113,2,2,3,1,10,5,5,9
P'thinaikos,6113,3,1,2,3,5,10,-5,5
Panionios,6113,4,1,1,4,4,10,-6,4
AEK Athens,6114,1,4,2,0,7,1,6,14
PAOK Salonik,6114,2,2,2,2,9,6,3,8
P'thinaikos,6114,3,2,1,3,6,9,-3,7
Panionios,6114,4,1,1,4,4,10,-6,4
AEK Athens,6115,1,4,2,0,7,1,6,14
PAOK Salonik,6115,2,2,2,2,10,6,4,8
P'thinaikos,6115,3,2,1,3,6,10,-4,7
Panionios,6115,4,1,1,4,4,10,-6,4
AEK Athens,6116,1,4,2,0,7,1,6,14
PAOK Salonik,6116,2,3,2,1,12,4,8,11
Panionios,6116,3,1,1,4,4,10,-6,4
P'thinaikos,6116,4,1,1,4,4,12,-8,4
AEK Athens,6117,1,4,2,0,7,1,6,14
PAOK Salonik,6117,2,2,2,2,10,6,4,8
P'thinaikos,6117,3,2,1,3,6,10,-4,7
Panionios,6117,4,1,1,4,4,10,-6,4
AEK Athens,6118,1,4,2,0,7,1,6,14
PAOK Salonik,6118,2,3,2,1,13,7,6,11
P'thinaikos,6118,3,1,1,4,7,13,-6,4
Panionios,6118,4,1,1,4,4,10,-6,4
AEK Athens,6119,1,4,2,0,7,1,6,14
PAOK Salonik,6119,2,2,2,2,10,8,2,8
P'thinaikos,6119,3,2,1,3,8,10,-2,7
Panionios,6119,4,1,1,4,4,10,-6,4
AEK Athens,6120,1,4,2,0,7,1,6,14
PAOK Salonik,6120,2,2,2,2,10,7,3,8
P'thinaikos,6120,3,2,1,3,7,10,-3,7
Panionios,6120,4,1,1,4,4,10,-6,4
AEK Athens,6121,1,4,2,0,7,1,6,14
PAOK Salonik,6121,2,2,3,1,10,5,5,9
P'thinaikos,6121,3,1,2,3,5,10,-5,5
Panionios,6121,4,1,1,4,4,10,-6,4
AEK Athens,6122,1,4,2,0,7,1,6,14
PAOK Salonik,6122,2,2,2,2,9,5,4,8
P'thinaikos,6122,3,2,1,3,5,9,-4,7
Panionios,6122,4,1,1,4,4,10,-6,4
AEK Athens,6123,1,4,2,0,7,1,6,14
PAOK Salonik,6123,2,2,2,2,10,6,4,8
P'thinaikos,6123,3,2,1,3,6,10,-4,7
Panionios,6123,4,1,1,4,4,10,-6,4
AEK Athens,6124,1,4,2,0,7,1,6,14
PAOK Salonik,6124,2,2,2,2,10,7,3,8
P'thinaikos,6124,3,2,1,3,7,10,-3,7
Panionios,6124,4,1,1,4,4,10,-6,4
AEK Athens,6125,1,4,2,0,7,1,6,14
PAOK Salonik,6125,2,2,2,2,9,7,2,8
P'thinaikos,6125,3,2,1,3,7,9,-2,7
Panionios,6125,4,1,1,4,4,10,-6,4
AEK Athens,6126,1,4,2,0,7,1,6,14
PAOK Salonik,6126,2,3,2,1,14,6,8,11
Panionios,6126,3,1,1,4,4,10,-6,4
P'thinaikos,6126,4,1,1,4,6,14,-8,4
AEK Athens,6127,1,4,2,0,7,1,6,14
PAOK Salonik,6127,2,2,2,2,9,5,4,8
P'thinaikos,6127,3,2,1,3,5,9,-4,7
Panionios,6127,4,1,1,4,4,10,-6,4
AEK Athens,6128,1,4,2,0,7,1,6,14
PAOK Salonik,6128,2,3,2,1,11,4,7,11
Panionios,6128,3,1,1,4,4,10,-6,4
P'thinaikos,6128,4,1,1,4,4,11,-7,4
AEK Athens,6129,1,4,2,0,7,1,6,14
PAOK Salonik,6129,2,2,2,2,9,5,4,8
P'thinaikos,6129,3,2,1,3,5,9,-4,7
Panionios,6129,4,1,1,4,4,10,-6,4
AEK Athens,6130,1,4,2,0,7,1,6,14
PAOK Salonik,6130,2,2,3,1,11,6,5,9
P'thinaikos,6130,3,1,2,3,6,11,-5,5
Panionios,6130,4,1,1,4,4,10,-6,4
AEK Athens,6131,1,4,2,0,7,1,6,14
PAOK Salonik,6131,2,2,3,1,9,4,5,9
P'thinaikos,6131,3,1,2,3,4,9,-5,5
Panionios,6131,4,1,1,4,4,10,-6,4
AEK Athens,6132,1,4,2,0,7,1,6,14
PAOK Salonik,6132,2,3,2,1,10,4,6,11
P'thinaikos,6132,3,1,1,4,4,10,-6,4
Panionios,6132,3,1,1,4,4,10,-6,4
AEK Athens,6133,1,4,2,0,7,1,6,14
PAOK Salonik,6133,2,2,3,1,9,4,5,9
P'thinaikos,6133,3,1,2,3,4,9,-5,5
Panionios,6133,4,1,1,4,4,10,-6,4
AEK Athens,6134,1,4,2,0,7,1,6,14
PAOK Salonik,6134,2,3,2,1,11,5,6,11
P'thinaikos,6134,3,1,1,4,5,11,-6,4
Panionios,6134,4,1,1,4,4,10,-6,4
AEK Athens,6135,1,4,2,0,7,1,6,14
PAOK Salonik,6135,2,2,3,1,10,5,5,9
P'thinaikos,6135,3,1,2,3,5,10,-5,5
Panionios,6135,4,1,1,4,4,10,-6,4
AEK Athens,6136,1,4,2,0,7,1,6,14
PAOK Salonik,6136,2,2,3,1,10,5,5,9
P'thinaikos,6136,3,1,2,3,5,10,-5,5
Panionios,6136,4,1,1,4,4,10,-6,4
AEK Athens,6137,1,4,2,0,7,1,6,14
PAOK Salonik,6137,2,2,2,2,9,7,2,8
P'thinaikos,6137,3,2,1,3,7,9,-2,7
Panionios,6137,4,1,1,4,4,10,-6,4
AEK Athens,6138,1,4,2,0,7,1,6,14
PAOK Salonik,6138,2,2,2,2,9,6,3,8
P'thinaikos,6138,3,2,1,3,6,9,-3,7
Panionios,6138,4,1,1,4,4,10,-6,4
AEK Athens,6139,1,4,2,0,7,1,6,14
PAOK Salonik,6139,2,3,2,1,12,5,7,11
Panionios,6139,3,1,1,4,4,10,-6,4
P'thinaikos,6139,4,1,1,4,5,12,-7,4
AEK Athens,6140,1,4,2,0,7,1,6,14
PAOK Salonik,6140,2,3,2,1,10,4,6,11
P'thinaikos,6140,3,1,1,4,4,10,-6,4
Panionios,6140,3,1,1,4,4,10,-6,4
AEK Athens,6141,1,4,2,0,7,1,6,14
PAOK Salonik,6141,2,2,2,2,9,6,3,8
P'thinaikos,6141,3,2,1,3,6,9,-3,7
Panionios,6141,4,1,1,4,4,10,-6,4
AEK Athens,6142,1,4,2,0,7,1,6,14
PAOK Salonik,6142,2,2,2,2,9,5,4,8
P'thinaikos,6142,3,2,1,3,5,9,-4,7
Panionios,6142,4,1,1,4,4,10,-6,4
AEK Athens,6143,1,4,2,0,7,1,6,14
PAOK Salonik,6143,2,2,2,2,11,7,4,8
P'thinaikos,6143,3,2,1,3,7,11,-4,7
Panionios,6143,4,1,1,4,4,10,-6,4
AEK Athens,6144,1,4,2,0,7,1,6,14
PAOK Salonik,6144,2,3,2,1,12,5,7,11
Panionios,6144,3,1,1,4,4,10,-6,4
P'thinaikos,6144,4,1,1,4,5,12,-7,4
AEK Athens,6145,1,4,2,0,7,1,6,14
PAOK Salonik,6145,2,2,2,2,9,5,4,8
P'thinaikos,6145,3,2,1,3,5,9,-4,7
Panionios,6145,4,1,1,4,4,10,-6,4
AEK Athens,6146,1,4,2,0,7,1,6,14
PAOK Salonik,6146,2,2,3,1,10,5,5,9
P'thinaikos,6146,3,1,2,3,5,10,-5,5
Panionios,6146,4,1,1,4,4,10,-6,4
AEK Athens,6147,1,4,2,0,7,1,6,14
PAOK Salonik,6147,2,3,2,1,11,4,7,11
Panionios,6147,3,1,1,4,4,10,-6,4
P'thinaikos,6147,4,1,1,4,4,11,-7,4
AEK Athens,6148,1,4,2,0,7,1,6,14
PAOK Salonik,6148,2,3,2,1,12,4,8,11
Panionios,6148,3,1,1,4,4,10,-6,4
P'thinaikos,6148,4,1,1,4,4,12,-8,4
AEK Athens,6149,1,4,2,0,7,1,6,14
PAOK Salonik,6149,2,2,2,2,9,5,4,8
P'thinaikos,6149,3,2,1,3,5,9,-4,7
Panionios,6149,4,1,1,4,4,10,-6,4
AEK Athens,6150,1,4,2,0,7,1,6,14
PAOK Salonik,6150,2,2,3,1,10,5,5,9
P'thinaikos,6150,3,1,2,3,5,10,-5,5
Panionios,6150,4,1,1,4,4,10,-6,4
AEK Athens,6151,1,4,2,0,7,1,6,14
PAOK Salonik,6151,2,2,2,2,9,5,4,8
P'thinaikos,6151,3,2,1,3,5,9,-4,7
Panionios,6151,4,1,1,4,4,10,-6,4
AEK Athens,6152,1,4,2,0,7,1,6,14
PAOK Salonik,6152,2,2,3,1,9,4,5,9
P'thinaikos,6152,3,1,2,3,4,9,-5,5
Panionios,6152,4,1,1,4,4,10,-6,4
AEK Athens,6153,1,4,2,0,7,1,6,14
PAOK Salonik,6153,2,2,2,2,10,8,2,8
P'thinaikos,6153,3,2,1,3,8,10,-2,7
Panionios,6153,4,1,1,4,4,10,-6,4
AEK Athens,6154,1,4,2,0,7,1,6,14
PAOK Salonik,6154,2,2,2,2,10,6,4,8
P'thinaikos,6154,3,2,1,3,6,10,-4,7
Panionios,6154,4,1,1,4,4,10,-6,4
AEK Athens,6155,1,4,2,0,7,1,6,14
PAOK Salonik,6155,2,2,3,1,10,5,5,9
P'thinaikos,6155,3,1,2,3,5,10,-5,5
Panionios,6155,4,1,1,4,4,10,-6,4
AEK Athens,6156,1,4,2,0,7,1,6,14
PAOK Salonik,6156,2,3,2,1,10,4,6,11
P'thinaikos,6156,3,1,1,4,4,10,-6,4
Panionios,6156,3,1,1,4,4,10,-6,4
AEK Athens,6157,1,4,2,0,7,1,6,14
PAOK Salonik,6157,2,3,2,1,13,5,8,11
Panionios,6157,3,1,1,4,4,10,-6,4
P'thinaikos,6157,4,1,1,4,5,13,-8,4
AEK Athens,6158,1,4,2,0,7,1,6,14
PAOK Salonik,6158,2,2,2,2,9,5,4,8
P'thinaikos,6158,3,2,1,3,5,9,-4,7
Panionios,6158,4,1,1,4,4,10,-6,4
AEK Athens,6159,1,4,2,0,7,1,6,14
PAOK Salonik,6159,2,3,2,1,13,4,9,11
Panionios,6159,3,1,1,4,4,10,-6,4
P'thinaikos,6159,4,1,1,4,4,13,-9,4
AEK Athens,6160,1,4,2,0,7,1,6,14
PAOK Salonik,6160,2,3,2,1,10,4,6,11
P'thinaikos,6160,3,1,1,4,4,10,-6,4
Panionios,6160,3,1,1,4,4,10,-6,4
AEK Athens,6161,1,4,2,0,7,1,6,14
PAOK Salonik,6161,2,2,3,1,9,4,5,9
P'thinaikos,6161,3,1,2,3,4,9,-5,5
Panionios,6161,4,1,1,4,4,10,-6,4
AEK Athens,6162,1,4,2,0,7,1,6,14
PAOK Salonik,6162,2,2,2,2,10,6,4,8
P'thinaikos,6162,3,2,1,3,6,10,-4,7
Panionios,6162,4,1,1,4,4,10,-6,4
AEK Athens,6163,1,4,2,0,7,1,6,14
PAOK Salonik,6163,2,3,2,1,12,4,8,11
Panionios,6163,3,1,1,4,4,10,-6,4
P'thinaikos,6163,4,1,1,4,4,12,-8,4
AEK Athens,6164,1,4,2,0,7,1,6,14
PAOK Salonik,6164,2,2,2,2,10,7,3,8
P'thinaikos,6164,3,2,1,3,7,10,-3,7
Panionios,6164,4,1,1,4,4,10,-6,4
AEK Athens,6165,1,4,2,0,7,1,6,14
PAOK Salonik,6165,2,3,2,1,11,4,7,11
Panionios,6165,3,1,1,4,4,10,-6,4
P'thinaikos,6165,4,1,1,4,4,11,-7,4
AEK Athens,6166,1,4,2,0,7,1,6,14
PAOK Salonik,6166,2,2,2,2,10,6,4,8
P'thinaikos,6166,3,2,1,3,6,10,-4,7
Panionios,6166,4,1,1,4,4,10,-6,4
AEK Athens,6167,1,4,2,0,7,1,6,14
PAOK Salonik,6167,2,2,3,1,13,8,5,9
P'thinaikos,6167,3,1,2,3,8,13,-5,5
Panionios,6167,4,1,1,4,4,10,-6,4
AEK Athens,6168,1,4,2,0,7,1,6,14
PAOK Salonik,6168,2,2,2,2,9,6,3,8
P'thinaikos,6168,3,2,1,3,6,9,-3,7
Panionios,6168,4,1,1,4,4,10,-6,4
AEK Athens,6169,1,4,2,0,7,1,6,14
PAOK Salonik,6169,2,2,2,2,9,5,4,8
P'thinaikos,6169,3,2,1,3,5,9,-4,7
Panionios,6169,4,1,1,4,4,10,-6,4
AEK Athens,6170,1,4,2,0,7,1,6,14
PAOK Salonik,6170,2,2,2,2,9,5,4,8
P'thinaikos,6170,3,2,1,3,5,9,-4,7
Panionios,6170,4,1,1,4,4,10,-6,4
AEK Athens,6171,1,4,2,0,7,1,6,14
PAOK Salonik,6171,2,2,3,1,9,4,5,9
P'thinaikos,6171,3,1,2,3,4,9,-5,5
Panionios,6171,4,1,1,4,4,10,-6,4
AEK Athens,6172,1,4,2,0,7,1,6,14
PAOK Salonik,6172,2,2,2,2,9,6,3,8
P'thinaikos,6172,3,2,1,3,6,9,-3,7
Panionios,6172,4,1,1,4,4,10,-6,4
AEK Athens,6173,1,4,2,0,7,1,6,14
PAOK Salonik,6173,2,2,2,2,9,6,3,8
P'thinaikos,6173,3,2,1,3,6,9,-3,7
Panionios,6173,4,1,1,4,4,10,-6,4
AEK Athens,6174,1,4,2,0,7,1,6,14
PAOK Salonik,6174,2,2,2,2,9,6,3,8
P'thinaikos,6174,3,2,1,3,6,9,-3,7
Panionios,6174,4,1,1,4,4,10,-6,4
AEK Athens,6175,1,4,2,0,7,1,6,14
PAOK Salonik,6175,2,3,2,1,12,5,7,11
Panionios,6175,3,1,1,4,4,10,-6,4
P'thinaikos,6175,4,1,1,4,5,12,-7,4
AEK Athens,6176,1,4,2,0,7,1,6,14
PAOK Salonik,6176,2,2,3,1,10,5,5,9
P'thinaikos,6176,3,1,2,3,5,10,-5,5
Panionios,6176,4,1,1,4,4,10,-6,4
AEK Athens,6177,1,4,2,0,7,1,6,14
PAOK Salonik,6177,2,2,2,2,9,6,3,8
P'thinaikos,6177,3,2,1,3,6,9,-3,7
Panionios,6177,4,1,1,4,4,10,-6,4
AEK Athens,6178,1,4,2,0,7,1,6,14
PAOK Salonik,6178,2,2,2,2,12,8,4,8
P'thinaikos,6178,3,2,1,3,8,12,-4,7
Panionios,6178,4,1,1,4,4,10,-6,4
AEK Athens,6179,1,4,2,0,7,1,6,14
PAOK Salonik,6179,2,3,2,1,10,4,6,11
P'thinaikos,6179,3,1,1,4,4,10,-6,4
Panionios,6179,3,1,1,4,4,10,-6,4
AEK Athens,6180,1,4,2,0,7,1,6,14
PAOK Salonik,6180,2,2,3,1,10,5,5,9
P'thinaikos,6180,3,1,2,3,5,10,-5,5
Panionios,6180,4,1,1,4,4,10,-6,4
AEK Athens,6181,1,4,2,0,7,1,6,14
PAOK Salonik,6181,2,3,2,1,10,4,6,11
P'thinaikos,6181,3,1,1,4,4,10,-6,4
Panionios,6181,3,1,1,4,4,10,-6,4
AEK Athens,6182,1,4,2,0,7,1,6,14
PAOK Salonik,6182,2,2,2,2,10,6,4,8
P'thinaikos,6182,3,2,1,3,6,10,-4,7
Panionios,6182,4,1,1,4,4,10,-6,4
AEK Athens,6183,1,4,2,0,7,1,6,14
PAOK Salonik,6183,2,2,2,2,9,6,3,8
P'thinaikos,6183,3,2,1,3,6,9,-3,7
Panionios,6183,4,1,1,4,4,10,-6,4
AEK Athens,6184,1,4,2,0,7,1,6,14
PAOK Salonik,6184,2,3,2,1,11,4,7,11
Panionios,6184,3,1,1,4,4,10,-6,4
P'thinaikos,6184,4,1,1,4,4,11,-7,4
AEK Athens,6185,1,4,2,0,7,1,6,14
PAOK Salonik,6185,2,2,2,2,9,5,4,8
P'thinaikos,6185,3,2,1,3,5,9,-4,7
Panionios,6185,4,1,1,4,4,10,-6,4
AEK Athens,6186,1,4,2,0,7,1,6,14
PAOK Salonik,6186,2,3,2,1,10,4,6,11
P'thinaikos,6186,3,1,1,4,4,10,-6,4
Panionios,6186,3,1,1,4,4,10,-6,4
AEK Athens,6187,1,4,2,0,7,1,6,14
PAOK Salonik,6187,2,2,3,1,11,6,5,9
P'thinaikos,6187,3,1,2,3,6,11,-5,5
Panionios,6187,4,1,1,4,4,10,-6,4
AEK Athens,6188,1,4,2,0,7,1,6,14
PAOK Salonik,6188,2,3,2,1,10,4,6,11
P'thinaikos,6188,3,1,1,4,4,10,-6,4
Panionios,6188,3,1,1,4,4,10,-6,4
AEK Athens,6189,1,4,2,0,7,1,6,14
PAOK Salonik,6189,2,2,2,2,10,6,4,8
P'thinaikos,6189,3,2,1,3,6,10,-4,7
Panionios,6189,4,1,1,4,4,10,-6,4
AEK Athens,6190,1,4,2,0,7,1,6,14
PAOK Salonik,6190,2,2,2,2,10,6,4,8
P'thinaikos,6190,3,2,1,3,6,10,-4,7
Panionios,6190,4,1,1,4,4,10,-6,4
AEK Athens,6191,1,4,2,0,7,1,6,14
PAOK Salonik,6191,2,3,2,1,11,4,7,11
Panionios,6191,3,1,1,4,4,10,-6,4
P'thinaikos,6191,4,1,1,4,4,11,-7,4
AEK Athens,6192,1,4,2,0,7,1,6,14
PAOK Salonik,6192,2,2,3,1,10,5,5,9
P'thinaikos,6192,3,1,2,3,5,10,-5,5
Panionios,6192,4,1,1,4,4,10,-6,4
AEK Athens,6193,1,4,2,0,7,1,6,14
PAOK Salonik,6193,2,2,2,2,9,5,4,8
P'thinaikos,6193,3,2,1,3,5,9,-4,7
Panionios,6193,4,1,1,4,4,10,-6,4
AEK Athens,6194,1,4,2,0,7,1,6,14
PAOK Salonik,6194,2,2,2,2,10,6,4,8
P'thinaikos,6194,3,2,1,3,6,10,-4,7
Panionios,6194,4,1,1,4,4,10,-6,4
AEK Athens,6195,1,4,2,0,7,1,6,14
PAOK Salonik,6195,2,2,3,1,10,5,5,9
P'thinaikos,6195,3,1,2,3,5,10,-5,5
Panionios,6195,4,1,1,4,4,10,-6,4
AEK Athens,6196,1,4,2,0,7,1,6,14
PAOK Salonik,6196,2,3,2,1,10,4,6,11
P'thinaikos,6196,3,1,1,4,4,10,-6,4
Panionios,6196,3,1,1,4,4,10,-6,4
AEK Athens,6197,1,4,2,0,7,1,6,14
PAOK Salonik,6197,2,3,2,1,11,5,6,11
P'thinaikos,6197,3,1,1,4,5,11,-6,4
Panionios,6197,4,1,1,4,4,10,-6,4
AEK Athens,6198,1,4,2,0,7,1,6,14
PAOK Salonik,6198,2,2,2,2,9,5,4,8
P'thinaikos,6198,3,2,1,3,5,9,-4,7
Panionios,6198,4,1,1,4,4,10,-6,4
AEK Athens,6199,1,4,2,0,7,1,6,14
PAOK Salonik,6199,2,2,3,1,10,5,5,9
P'thinaikos,6199,3,1,2,3,5,10,-5,5
Panionios,6199,4,1,1,4,4,10,-6,4
AEK Athens,6200,1,4,2,0,7,1,6,14
PAOK Salonik,6200,2,2,3,1,9,4,5,9
P'thinaikos,6200,3,1,2,3,4,9,-5,5
Panionios,6200,4,1,1,4,4,10,-6,4
AEK Athens,6201,1,4,2,0,7,1,6,14
PAOK Salonik,6201,2,2,2,2,9,5,4,8
P'thinaikos,6201,3,2,1,3,5,9,-4,7
Panionios,6201,4,1,1,4,4,10,-6,4
AEK Athens,6202,1,4,2,0,7,1,6,14
PAOK Salonik,6202,2,3,2,1,11,4,7,11
Panionios,6202,3,1,1,4,4,10,-6,4
P'thinaikos,6202,4,1,1,4,4,11,-7,4
AEK Athens,6203,1,4,2,0,7,1,6,14
PAOK Salonik,6203,2,2,2,2,9,5,4,8
P'thinaikos,6203,3,2,1,3,5,9,-4,7
Panionios,6203,4,1,1,4,4,10,-6,4
AEK Athens,6204,1,4,2,0,7,1,6,14
PAOK Salonik,6204,2,3,2,1,10,4,6,11
P'thinaikos,6204,3,1,1,4,4,10,-6,4
Panionios,6204,3,1,1,4,4,10,-6,4
AEK Athens,6205,1,4,2,0,7,1,6,14
PAOK Salonik,6205,2,3,2,1,12,5,7,11
Panionios,6205,3,1,1,4,4,10,-6,4
P'thinaikos,6205,4,1,1,4,5,12,-7,4
AEK Athens,6206,1,4,2,0,7,1,6,14
PAOK Salonik,6206,2,2,2,2,9,5,4,8
P'thinaikos,6206,3,2,1,3,5,9,-4,7
Panionios,6206,4,1,1,4,4,10,-6,4
AEK Athens,6207,1,4,2,0,7,1,6,14
PAOK Salonik,6207,2,2,2,2,11,7,4,8
P'thinaikos,6207,3,2,1,3,7,11,-4,7
Panionios,6207,4,1,1,4,4,10,-6,4
AEK Athens,6208,1,4,2,0,7,1,6,14
PAOK Salonik,6208,2,3,2,1,11,5,6,11
P'thinaikos,6208,3,1,1,4,5,11,-6,4
Panionios,6208,4,1,1,4,4,10,-6,4
AEK Athens,6209,1,4,2,0,7,1,6,14
PAOK Salonik,6209,2,3,2,1,11,4,7,11
Panionios,6209,3,1,1,4,4,10,-6,4
P'thinaikos,6209,4,1,1,4,4,11,-7,4
AEK Athens,6210,1,4,2,0,7,1,6,14
PAOK Salonik,6210,2,2,2,2,9,5,4,8
P'thinaikos,6210,3,2,1,3,5,9,-4,7
Panionios,6210,4,1,1,4,4,10,-6,4
AEK Athens,6211,1,4,2,0,7,1,6,14
PAOK Salonik,6211,2,2,3,1,10,5,5,9
P'thinaikos,6211,3,1,2,3,5,10,-5,5
Panionios,6211,4,1,1,4,4,10,-6,4
AEK Athens,6212,1,4,2,0,7,1,6,14
PAOK Salonik,6212,2,2,2,2,9,5,4,8
P'thinaikos,6212,3,2,1,3,5,9,-4,7
Panionios,6212,4,1,1,4,4,10,-6,4
AEK Athens,6213,1,4,2,0,7,1,6,14
PAOK Salonik,6213,2,2,2,2,10,6,4,8
P'thinaikos,6213,3,2,1,3,6,10,-4,7
Panionios,6213,4,1,1,4,4,10,-6,4
AEK Athens,6214,1,4,2,0,7,1,6,14
PAOK Salonik,6214,2,2,2,2,10,7,3,8
P'thinaikos,6214,3,2,1,3,7,10,-3,7
Panionios,6214,4,1,1,4,4,10,-6,4
AEK Athens,6215,1,4,2,0,7,1,6,14
PAOK Salonik,6215,2,3,2,1,12,4,8,11
Panionios,6215,3,1,1,4,4,10,-6,4
P'thinaikos,6215,4,1,1,4,4,12,-8,4
AEK Athens,6216,1,4,2,0,7,1,6,14
PAOK Salonik,6216,2,2,3,1,10,5,5,9
P'thinaikos,6216,3,1,2,3,5,10,-5,5
Panionios,6216,4,1,1,4,4,10,-6,4
AEK Athens,6217,1,4,2,0,7,1,6,14
PAOK Salonik,6217,2,2,2,2,10,6,4,8
P'thinaikos,6217,3,2,1,3,6,10,-4,7
Panionios,6217,4,1,1,4,4,10,-6,4
AEK Athens,6218,1,4,2,0,7,1,6,14
PAOK Salonik,6218,2,2,3,1,9,4,5,9
P'thinaikos,6218,3,1,2,3,4,9,-5,5
Panionios,6218,4,1,1,4,4,10,-6,4
AEK Athens,6219,1,4,2,0,7,1,6,14
PAOK Salonik,6219,2,3,2,1,12,4,8,11
Panionios,6219,3,1,1,4,4,10,-6,4
P'thinaikos,6219,4,1,1,4,4,12,-8,4
AEK Athens,6220,1,4,2,0,7,1,6,14
PAOK Salonik,6220,2,2,2,2,9,5,4,8
P'thinaikos,6220,3,2,1,3,5,9,-4,7
Panionios,6220,4,1,1,4,4,10,-6,4
AEK Athens,6221,1,4,2,0,7,1,6,14
PAOK Salonik,6221,2,3,2,1,11,5,6,11
P'thinaikos,6221,3,1,1,4,5,11,-6,4
Panionios,6221,4,1,1,4,4,10,-6,4
AEK Athens,6222,1,4,2,0,7,1,6,14
PAOK Salonik,6222,2,2,2,2,11,7,4,8
P'thinaikos,6222,3,2,1,3,7,11,-4,7
Panionios,6222,4,1,1,4,4,10,-6,4
AEK Athens,6223,1,4,2,0,7,1,6,14
PAOK Salonik,6223,2,3,2,1,11,4,7,11
Panionios,6223,3,1,1,4,4,10,-6,4
P'thinaikos,6223,4,1,1,4,4,11,-7,4
AEK Athens,6224,1,4,2,0,7,1,6,14
PAOK Salonik,6224,2,2,2,2,9,6,3,8
P'thinaikos,6224,3,2,1,3,6,9,-3,7
Panionios,6224,4,1,1,4,4,10,-6,4
AEK Athens,6225,1,4,2,0,7,1,6,14
PAOK Salonik,6225,2,2,3,1,10,5,5,9
P'thinaikos,6225,3,1,2,3,5,10,-5,5
Panionios,6225,4,1,1,4,4,10,-6,4
AEK Athens,6226,1,4,2,0,7,1,6,14
PAOK Salonik,6226,2,2,2,2,10,8,2,8
P'thinaikos,6226,3,2,1,3,8,10,-2,7
Panionios,6226,4,1,1,4,4,10,-6,4
AEK Athens,6227,1,4,2,0,7,1,6,14
PAOK Salonik,6227,2,2,3,1,9,4,5,9
P'thinaikos,6227,3,1,2,3,4,9,-5,5
Panionios,6227,4,1,1,4,4,10,-6,4
AEK Athens,6228,1,4,2,0,7,1,6,14
PAOK Salonik,6228,2,3,2,1,11,5,6,11
P'thinaikos,6228,3,1,1,4,5,11,-6,4
Panionios,6228,4,1,1,4,4,10,-6,4
AEK Athens,6229,1,4,2,0,7,1,6,14
PAOK Salonik,6229,2,2,2,2,9,6,3,8
P'thinaikos,6229,3,2,1,3,6,9,-3,7
Panionios,6229,4,1,1,4,4,10,-6,4
AEK Athens,6230,1,4,2,0,7,1,6,14
PAOK Salonik,6230,2,3,2,1,12,4,8,11
Panionios,6230,3,1,1,4,4,10,-6,4
P'thinaikos,6230,4,1,1,4,4,12,-8,4
AEK Athens,6231,1,4,2,0,7,1,6,14
PAOK Salonik,6231,2,3,2,1,11,4,7,11
Panionios,6231,3,1,1,4,4,10,-6,4
P'thinaikos,6231,4,1,1,4,4,11,-7,4
AEK Athens,6232,1,4,2,0,7,1,6,14
PAOK Salonik,6232,2,2,2,2,9,5,4,8
P'thinaikos,6232,3,2,1,3,5,9,-4,7
Panionios,6232,4,1,1,4,4,10,-6,4
AEK Athens,6233,1,4,2,0,7,1,6,14
PAOK Salonik,6233,2,3,2,1,10,4,6,11
P'thinaikos,6233,3,1,1,4,4,10,-6,4
Panionios,6233,3,1,1,4,4,10,-6,4
AEK Athens,6234,1,4,2,0,7,1,6,14
PAOK Salonik,6234,2,2,2,2,9,5,4,8
P'thinaikos,6234,3,2,1,3,5,9,-4,7
Panionios,6234,4,1,1,4,4,10,-6,4
AEK Athens,6235,1,4,2,0,7,1,6,14
PAOK Salonik,6235,2,3,2,1,11,4,7,11
Panionios,6235,3,1,1,4,4,10,-6,4
P'thinaikos,6235,4,1,1,4,4,11,-7,4
AEK Athens,6236,1,4,2,0,7,1,6,14
PAOK Salonik,6236,2,3,2,1,11,5,6,11
P'thinaikos,6236,3,1,1,4,5,11,-6,4
Panionios,6236,4,1,1,4,4,10,-6,4
AEK Athens,6237,1,4,2,0,7,1,6,14
PAOK Salonik,6237,2,2,3,1,9,4,5,9
P'thinaikos,6237,3,1,2,3,4,9,-5,5
Panionios,6237,4,1,1,4,4,10,-6,4
AEK Athens,6238,1,4,2,0,7,1,6,14
PAOK Salonik,6238,2,2,3,1,10,5,5,9
P'thinaikos,6238,3,1,2,3,5,10,-5,5
Panionios,6238,4,1,1,4,4,10,-6,4
AEK Athens,6239,1,4,2,0,7,1,6,14
PAOK Salonik,6239,2,3,2,1,12,4,8,11
Panionios,6239,3,1,1,4,4,10,-6,4
P'thinaikos,6239,4,1,1,4,4,12,-8,4
AEK Athens,6240,1,4,2,0,7,1,6,14
PAOK Salonik,6240,2,3,2,1,11,4,7,11
Panionios,6240,3,1,1,4,4,10,-6,4
P'thinaikos,6240,4,1,1,4,4,11,-7,4
AEK Athens,6241,1,4,2,0,7,1,6,14
PAOK Salonik,6241,2,2,2,2,10,6,4,8
P'thinaikos,6241,3,2,1,3,6,10,-4,7
Panionios,6241,4,1,1,4,4,10,-6,4
AEK Athens,6242,1,4,2,0,7,1,6,14
PAOK Salonik,6242,2,2,3,1,9,4,5,9
P'thinaikos,6242,3,1,2,3,4,9,-5,5
Panionios,6242,4,1,1,4,4,10,-6,4
AEK Athens,6243,1,4,2,0,7,1,6,14
PAOK Salonik,6243,2,3,2,1,12,4,8,11
Panionios,6243,3,1,1,4,4,10,-6,4
P'thinaikos,6243,4,1,1,4,4,12,-8,4
AEK Athens,6244,1,4,2,0,7,1,6,14
PAOK Salonik,6244,2,3,2,1,12,4,8,11
Panionios,6244,3,1,1,4,4,10,-6,4
P'thinaikos,6244,4,1,1,4,4,12,-8,4
AEK Athens,6245,1,4,2,0,7,1,6,14
PAOK Salonik,6245,2,3,2,1,11,4,7,11
Panionios,6245,3,1,1,4,4,10,-6,4
P'thinaikos,6245,4,1,1,4,4,11,-7,4
AEK Athens,6246,1,4,2,0,7,1,6,14
PAOK Salonik,6246,2,2,2,2,9,5,4,8
P'thinaikos,6246,3,2,1,3,5,9,-4,7
Panionios,6246,4,1,1,4,4,10,-6,4
AEK Athens,6247,1,4,2,0,7,1,6,14
PAOK Salonik,6247,2,3,2,1,11,5,6,11
P'thinaikos,6247,3,1,1,4,5,11,-6,4
Panionios,6247,4,1,1,4,4,10,-6,4
AEK Athens,6248,1,4,2,0,7,1,6,14
PAOK Salonik,6248,2,3,2,1,12,5,7,11
Panionios,6248,3,1,1,4,4,10,-6,4
P'thinaikos,6248,4,1,1,4,5,12,-7,4
AEK Athens,6249,1,4,2,0,7,1,6,14
PAOK Salonik,6249,2,3,2,1,10,4,6,11
P'thinaikos,6249,3,1,1,4,4,10,-6,4
Panionios,6249,3,1,1,4,4,10,-6,4
AEK Athens,6250,1,4,2,0,7,1,6,14
PAOK Salonik,6250,2,2,2,2,10,6,4,8
P'thinaikos,6250,3,2,1,3,6,10,-4,7
Panionios,6250,4,1,1,4,4,10,-6,4
AEK Athens,6251,1,4,2,0,7,1,6,14
PAOK Salonik,6251,2,2,3,1,11,6,5,9
P'thinaikos,6251,3,1,2,3,6,11,-5,5
Panionios,6251,4,1,1,4,4,10,-6,4
AEK Athens,6252,1,4,2,0,7,1,6,14
PAOK Salonik,6252,2,2,2,2,10,6,4,8
P'thinaikos,6252,3,2,1,3,6,10,-4,7
Panionios,6252,4,1,1,4,4,10,-6,4
AEK Athens,6253,1,4,2,0,7,1,6,14
PAOK Salonik,6253,2,2,2,2,9,6,3,8
P'thinaikos,6253,3,2,1,3,6,9,-3,7
Panionios,6253,4,1,1,4,4,10,-6,4
AEK Athens,6254,1,4,2,0,7,1,6,14
PAOK Salonik,6254,2,3,2,1,10,4,6,11
P'thinaikos,6254,3,1,1,4,4,10,-6,4
Panionios,6254,3,1,1,4,4,10,-6,4
AEK Athens,6255,1,4,2,0,7,1,6,14
PAOK Salonik,6255,2,3,2,1,12,4,8,11
Panionios,6255,3,1,1,4,4,10,-6,4
P'thinaikos,6255,4,1,1,4,4,12,-8,4
AEK Athens,6256,1,4,2,0,7,1,6,14
PAOK Salonik,6256,2,2,2,2,9,7,2,8
P'thinaikos,6256,3,2,1,3,7,9,-2,7
Panionios,6256,4,1,1,4,4,10,-6,4
AEK Athens,6257,1,4,2,0,7,1,6,14
PAOK Salonik,6257,2,3,2,1,10,4,6,11
P'thinaikos,6257,3,1,1,4,4,10,-6,4
Panionios,6257,3,1,1,4,4,10,-6,4
AEK Athens,6258,1,4,2,0,7,1,6,14
PAOK Salonik,6258,2,2,3,1,10,5,5,9
P'thinaikos,6258,3,1,2,3,5,10,-5,5
Panionios,6258,4,1,1,4,4,10,-6,4
AEK Athens,6259,1,4,2,0,7,1,6,14
PAOK Salonik,6259,2,2,2,2,9,5,4,8
P'thinaikos,6259,3,2,1,3,5,9,-4,7
Panionios,6259,4,1,1,4,4,10,-6,4
AEK Athens,6260,1,4,2,0,7,1,6,14
PAOK Salonik,6260,2,2,2,2,10,7,3,8
P'thinaikos,6260,3,2,1,3,7,10,-3,7
Panionios,6260,4,1,1,4,4,10,-6,4
AEK Athens,6261,1,4,2,0,7,1,6,14
PAOK Salonik,6261,2,2,2,2,10,6,4,8
P'thinaikos,6261,3,2,1,3,6,10,-4,7
Panionios,6261,4,1,1,4,4,10,-6,4
AEK Athens,6262,1,4,2,0,7,1,6,14
PAOK Salonik,6262,2,2,3,1,10,5,5,9
P'thinaikos,6262,3,1,2,3,5,10,-5,5
Panionios,6262,4,1,1,4,4,10,-6,4
AEK Athens,6263,1,4,2,0,7,1,6,14
PAOK Salonik,6263,2,3,2,1,10,4,6,11
P'thinaikos,6263,3,1,1,4,4,10,-6,4
Panionios,6263,3,1,1,4,4,10,-6,4
AEK Athens,6264,1,4,2,0,7,1,6,14
PAOK Salonik,6264,2,2,3,1,10,5,5,9
P'thinaikos,6264,3,1,2,3,5,10,-5,5
Panionios,6264,4,1,1,4,4,10,-6,4
AEK Athens,6265,1,4,2,0,7,1,6,14
PAOK Salonik,6265,2,2,3,1,10,5,5,9
P'thinaikos,6265,3,1,2,3,5,10,-5,5
Panionios,6265,4,1,1,4,4,10,-6,4
AEK Athens,6266,1,4,2,0,7,1,6,14
PAOK Salonik,6266,2,2,2,2,9,7,2,8
P'thinaikos,6266,3,2,1,3,7,9,-2,7
Panionios,6266,4,1,1,4,4,10,-6,4
AEK Athens,6267,1,4,2,0,7,1,6,14
PAOK Salonik,6267,2,2,3,1,9,4,5,9
P'thinaikos,6267,3,1,2,3,4,9,-5,5
Panionios,6267,4,1,1,4,4,10,-6,4
AEK Athens,6268,1,4,2,0,7,1,6,14
PAOK Salonik,6268,2,2,2,2,9,5,4,8
P'thinaikos,6268,3,2,1,3,5,9,-4,7
Panionios,6268,4,1,1,4,4,10,-6,4
AEK Athens,6269,1,4,2,0,7,1,6,14
PAOK Salonik,6269,2,2,2,2,11,8,3,8
P'thinaikos,6269,3,2,1,3,8,11,-3,7
Panionios,6269,4,1,1,4,4,10,-6,4
AEK Athens,6270,1,4,2,0,7,1,6,14
PAOK Salonik,6270,2,2,2,2,11,7,4,8
P'thinaikos,6270,3,2,1,3,7,11,-4,7
Panionios,6270,4,1,1,4,4,10,-6,4
AEK Athens,6271,1,4,2,0,7,1,6,14
PAOK Salonik,6271,2,3,2,1,10,4,6,11
P'thinaikos,6271,3,1,1,4,4,10,-6,4
Panionios,6271,3,1,1,4,4,10,-6,4
AEK Athens,6272,1,4,2,0,7,1,6,14
PAOK Salonik,6272,2,2,3,1,10,5,5,9
P'thinaikos,6272,3,1,2,3,5,10,-5,5
Panionios,6272,4,1,1,4,4,10,-6,4
AEK Athens,6273,1,4,2,0,7,1,6,14
PAOK Salonik,6273,2,3,2,1,11,4,7,11
Panionios,6273,3,1,1,4,4,10,-6,4
P'thinaikos,6273,4,1,1,4,4,11,-7,4
AEK Athens,6274,1,4,2,0,7,1,6,14
PAOK Salonik,6274,2,3,2,1,11,4,7,11
Panionios,6274,3,1,1,4,4,10,-6,4
P'thinaikos,6274,4,1,1,4,4,11,-7,4
AEK Athens,6275,1,4,2,0,7,1,6,14
PAOK Salonik,6275,2,3,2,1,12,4,8,11
Panionios,6275,3,1,1,4,4,10,-6,4
P'thinaikos,6275,4,1,1,4,4,12,-8,4
AEK Athens,6276,1,4,2,0,7,1,6,14
PAOK Salonik,6276,2,2,3,1,9,4,5,9
P'thinaikos,6276,3,1,2,3,4,9,-5,5
Panionios,6276,4,1,1,4,4,10,-6,4
AEK Athens,6277,1,4,2,0,7,1,6,14
PAOK Salonik,6277,2,2,3,1,10,5,5,9
P'thinaikos,6277,3,1,2,3,5,10,-5,5
Panionios,6277,4,1,1,4,4,10,-6,4
AEK Athens,6278,1,4,2,0,7,1,6,14
PAOK Salonik,6278,2,2,2,2,9,7,2,8
P'thinaikos,6278,3,2,1,3,7,9,-2,7
Panionios,6278,4,1,1,4,4,10,-6,4
AEK Athens,6279,1,4,2,0,7,1,6,14
PAOK Salonik,6279,2,3,2,1,10,4,6,11
P'thinaikos,6279,3,1,1,4,4,10,-6,4
Panionios,6279,3,1,1,4,4,10,-6,4
AEK Athens,6280,1,4,2,0,7,1,6,14
PAOK Salonik,6280,2,2,2,2,9,6,3,8
P'thinaikos,6280,3,2,1,3,6,9,-3,7
Panionios,6280,4,1,1,4,4,10,-6,4
AEK Athens,6281,1,4,2,0,7,1,6,14
PAOK Salonik,6281,2,2,3,1,11,6,5,9
P'thinaikos,6281,3,1,2,3,6,11,-5,5
Panionios,6281,4,1,1,4,4,10,-6,4
AEK Athens,6282,1,4,2,0,7,1,6,14
PAOK Salonik,6282,2,2,2,2,10,6,4,8
P'thinaikos,6282,3,2,1,3,6,10,-4,7
Panionios,6282,4,1,1,4,4,10,-6,4
AEK Athens,6283,1,4,2,0,7,1,6,14
PAOK Salonik,6283,2,2,2,2,10,6,4,8
P'thinaikos,6283,3,2,1,3,6,10,-4,7
Panionios,6283,4,1,1,4,4,10,-6,4
AEK Athens,6284,1,4,2,0,7,1,6,14
PAOK Salonik,6284,2,3,2,1,12,4,8,11
Panionios,6284,3,1,1,4,4,10,-6,4
P'thinaikos,6284,4,1,1,4,4,12,-8,4
AEK Athens,6285,1,4,2,0,7,1,6,14
PAOK Salonik,6285,2,2,2,2,9,5,4,8
P'thinaikos,6285,3,2,1,3,5,9,-4,7
Panionios,6285,4,1,1,4,4,10,-6,4
AEK Athens,6286,1,4,2,0,7,1,6,14
PAOK Salonik,6286,2,2,2,2,9,6,3,8
P'thinaikos,6286,3,2,1,3,6,9,-3,7
Panionios,6286,4,1,1,4,4,10,-6,4
AEK Athens,6287,1,4,2,0,7,1,6,14
PAOK Salonik,6287,2,2,2,2,9,5,4,8
P'thinaikos,6287,3,2,1,3,5,9,-4,7
Panionios,6287,4,1,1,4,4,10,-6,4
AEK Athens,6288,1,4,2,0,7,1,6,14
PAOK Salonik,6288,2,3,2,1,10,4,6,11
P'thinaikos,6288,3,1,1,4,4,10,-6,4
Panionios,6288,3,1,1,4,4,10,-6,4
AEK Athens,6289,1,4,2,0,7,1,6,14
PAOK Salonik,6289,2,2,2,2,9,5,4,8
P'thinaikos,6289,3,2,1,3,5,9,-4,7
Panionios,6289,4,1,1,4,4,10,-6,4
AEK Athens,6290,1,4,2,0,7,1,6,14
PAOK Salonik,6290,2,2,3,1,10,5,5,9
P'thinaikos,6290,3,1,2,3,5,10,-5,5
Panionios,6290,4,1,1,4,4,10,-6,4
AEK Athens,6291,1,4,2,0,7,1,6,14
PAOK Salonik,6291,2,2,3,1,10,5,5,9
P'thinaikos,6291,3,1,2,3,5,10,-5,5
Panionios,6291,4,1,1,4,4,10,-6,4
AEK Athens,6292,1,4,2,0,7,1,6,14
PAOK Salonik,6292,2,3,2,1,10,4,6,11
P'thinaikos,6292,3,1,1,4,4,10,-6,4
Panionios,6292,3,1,1,4,4,10,-6,4
AEK Athens,6293,1,4,2,0,7,1,6,14
PAOK Salonik,6293,2,2,3,1,9,4,5,9
P'thinaikos,6293,3,1,2,3,4,9,-5,5
Panionios,6293,4,1,1,4,4,10,-6,4
AEK Athens,6294,1,4,2,0,7,1,6,14
PAOK Salonik,6294,2,3,2,1,11,4,7,11
Panionios,6294,3,1,1,4,4,10,-6,4
P'thinaikos,6294,4,1,1,4,4,11,-7,4
AEK Athens,6295,1,4,2,0,7,1,6,14
PAOK Salonik,6295,2,2,3,1,9,4,5,9
P'thinaikos,6295,3,1,2,3,4,9,-5,5
Panionios,6295,4,1,1,4,4,10,-6,4
AEK Athens,6296,1,4,2,0,7,1,6,14
PAOK Salonik,6296,2,3,2,1,13,6,7,11
Panionios,6296,3,1,1,4,4,10,-6,4
P'thinaikos,6296,4,1,1,4,6,13,-7,4
AEK Athens,6297,1,4,2,0,7,1,6,14
PAOK Salonik,6297,2,3,2,1,10,4,6,11
P'thinaikos,6297,3,1,1,4,4,10,-6,4
Panionios,6297,3,1,1,4,4,10,-6,4
AEK Athens,6298,1,4,2,0,7,1,6,14
PAOK Salonik,6298,2,2,3,1,10,5,5,9
P'thinaikos,6298,3,1,2,3,5,10,-5,5
Panionios,6298,4,1,1,4,4,10,-6,4
AEK Athens,6299,1,4,2,0,7,1,6,14
PAOK Salonik,6299,2,3,2,1,12,6,6,11
P'thinaikos,6299,3,1,1,4,6,12,-6,4
Panionios,6299,4,1,1,4,4,10,-6,4
AEK Athens,6300,1,4,2,0,7,1,6,14
PAOK Salonik,6300,2,2,2,2,9,6,3,8
P'thinaikos,6300,3,2,1,3,6,9,-3,7
Panionios,6300,4,1,1,4,4,10,-6,4
AEK Athens,6301,1,4,2,0,7,1,6,14
PAOK Salonik,6301,2,3,2,1,11,5,6,11
P'thinaikos,6301,3,1,1,4,5,11,-6,4
Panionios,6301,4,1,1,4,4,10,-6,4
AEK Athens,6302,1,4,2,0,7,1,6,14
PAOK Salonik,6302,2,2,2,2,9,5,4,8
P'thinaikos,6302,3,2,1,3,5,9,-4,7
Panionios,6302,4,1,1,4,4,10,-6,4
AEK Athens,6303,1,4,2,0,7,1,6,14
PAOK Salonik,6303,2,3,2,1,11,5,6,11
P'thinaikos,6303,3,1,1,4,5,11,-6,4
Panionios,6303,4,1,1,4,4,10,-6,4
AEK Athens,6304,1,4,2,0,7,1,6,14
PAOK Salonik,6304,2,2,2,2,9,5,4,8
P'thinaikos,6304,3,2,1,3,5,9,-4,7
Panionios,6304,4,1,1,4,4,10,-6,4
AEK Athens,6305,1,4,2,0,7,1,6,14
PAOK Salonik,6305,2,3,2,1,10,4,6,11
P'thinaikos,6305,3,1,1,4,4,10,-6,4
Panionios,6305,3,1,1,4,4,10,-6,4
AEK Athens,6306,1,4,2,0,7,1,6,14
PAOK Salonik,6306,2,2,3,1,11,6,5,9
P'thinaikos,6306,3,1,2,3,6,11,-5,5
Panionios,6306,4,1,1,4,4,10,-6,4
AEK Athens,6307,1,4,2,0,7,1,6,14
PAOK Salonik,6307,2,3,2,1,11,5,6,11
P'thinaikos,6307,3,1,1,4,5,11,-6,4
Panionios,6307,4,1,1,4,4,10,-6,4
AEK Athens,6308,1,4,2,0,7,1,6,14
PAOK Salonik,6308,2,2,3,1,11,6,5,9
P'thinaikos,6308,3,1,2,3,6,11,-5,5
Panionios,6308,4,1,1,4,4,10,-6,4
AEK Athens,6309,1,4,2,0,7,1,6,14
PAOK Salonik,6309,2,2,3,1,11,6,5,9
P'thinaikos,6309,3,1,2,3,6,11,-5,5
Panionios,6309,4,1,1,4,4,10,-6,4
AEK Athens,6310,1,4,2,0,7,1,6,14
PAOK Salonik,6310,2,2,3,1,9,4,5,9
P'thinaikos,6310,3,1,2,3,4,9,-5,5
Panionios,6310,4,1,1,4,4,10,-6,4
AEK Athens,6311,1,4,2,0,7,1,6,14
PAOK Salonik,6311,2,2,2,2,9,5,4,8
P'thinaikos,6311,3,2,1,3,5,9,-4,7
Panionios,6311,4,1,1,4,4,10,-6,4
AEK Athens,6312,1,4,2,0,7,1,6,14
PAOK Salonik,6312,2,2,2,2,9,6,3,8
P'thinaikos,6312,3,2,1,3,6,9,-3,7
Panionios,6312,4,1,1,4,4,10,-6,4
AEK Athens,6313,1,4,2,0,7,1,6,14
PAOK Salonik,6313,2,2,2,2,9,5,4,8
P'thinaikos,6313,3,2,1,3,5,9,-4,7
Panionios,6313,4,1,1,4,4,10,-6,4
AEK Athens,6314,1,4,2,0,7,1,6,14
PAOK Salonik,6314,2,2,3,1,11,6,5,9
P'thinaikos,6314,3,1,2,3,6,11,-5,5
Panionios,6314,4,1,1,4,4,10,-6,4
AEK Athens,6315,1,4,2,0,7,1,6,14
PAOK Salonik,6315,2,2,3,1,10,5,5,9
P'thinaikos,6315,3,1,2,3,5,10,-5,5
Panionios,6315,4,1,1,4,4,10,-6,4
AEK Athens,6316,1,4,2,0,7,1,6,14
PAOK Salonik,6316,2,3,2,1,13,5,8,11
Panionios,6316,3,1,1,4,4,10,-6,4
P'thinaikos,6316,4,1,1,4,5,13,-8,4
AEK Athens,6317,1,4,2,0,7,1,6,14
PAOK Salonik,6317,2,3,2,1,11,5,6,11
P'thinaikos,6317,3,1,1,4,5,11,-6,4
Panionios,6317,4,1,1,4,4,10,-6,4
AEK Athens,6318,1,4,2,0,7,1,6,14
PAOK Salonik,6318,2,3,2,1,11,5,6,11
P'thinaikos,6318,3,1,1,4,5,11,-6,4
Panionios,6318,4,1,1,4,4,10,-6,4
AEK Athens,6319,1,4,2,0,7,1,6,14
PAOK Salonik,6319,2,2,2,2,10,6,4,8
P'thinaikos,6319,3,2,1,3,6,10,-4,7
Panionios,6319,4,1,1,4,4,10,-6,4
AEK Athens,6320,1,4,2,0,7,1,6,14
PAOK Salonik,6320,2,2,2,2,10,7,3,8
P'thinaikos,6320,3,2,1,3,7,10,-3,7
Panionios,6320,4,1,1,4,4,10,-6,4
AEK Athens,6321,1,4,2,0,7,1,6,14
PAOK Salonik,6321,2,3,2,1,11,4,7,11
Panionios,6321,3,1,1,4,4,10,-6,4
P'thinaikos,6321,4,1,1,4,4,11,-7,4
AEK Athens,6322,1,4,2,0,7,1,6,14
PAOK Salonik,6322,2,3,2,1,10,4,6,11
P'thinaikos,6322,3,1,1,4,4,10,-6,4
Panionios,6322,3,1,1,4,4,10,-6,4
AEK Athens,6323,1,4,2,0,7,1,6,14
PAOK Salonik,6323,2,2,3,1,11,6,5,9
P'thinaikos,6323,3,1,2,3,6,11,-5,5
Panionios,6323,4,1,1,4,4,10,-6,4
AEK Athens,6324,1,4,2,0,7,1,6,14
PAOK Salonik,6324,2,2,2,2,10,7,3,8
P'thinaikos,6324,3,2,1,3,7,10,-3,7
Panionios,6324,4,1,1,4,4,10,-6,4
AEK Athens,6325,1,4,2,0,7,1,6,14
PAOK Salonik,6325,2,2,2,2,10,6,4,8
P'thinaikos,6325,3,2,1,3,6,10,-4,7
Panionios,6325,4,1,1,4,4,10,-6,4
AEK Athens,6326,1,4,2,0,7,1,6,14
PAOK Salonik,6326,2,2,3,1,9,4,5,9
P'thinaikos,6326,3,1,2,3,4,9,-5,5
Panionios,6326,4,1,1,4,4,10,-6,4
AEK Athens,6327,1,4,2,0,7,1,6,14
PAOK Salonik,6327,2,3,2,1,10,4,6,11
P'thinaikos,6327,3,1,1,4,4,10,-6,4
Panionios,6327,3,1,1,4,4,10,-6,4
AEK Athens,6328,1,4,2,0,7,1,6,14
PAOK Salonik,6328,2,2,2,2,10,6,4,8
P'thinaikos,6328,3,2,1,3,6,10,-4,7
Panionios,6328,4,1,1,4,4,10,-6,4
AEK Athens,6329,1,4,2,0,7,1,6,14
PAOK Salonik,6329,2,2,3,1,9,4,5,9
P'thinaikos,6329,3,1,2,3,4,9,-5,5
Panionios,6329,4,1,1,4,4,10,-6,4
AEK Athens,6330,1,4,2,0,7,1,6,14
PAOK Salonik,6330,2,2,3,1,10,5,5,9
P'thinaikos,6330,3,1,2,3,5,10,-5,5
Panionios,6330,4,1,1,4,4,10,-6,4
AEK Athens,6331,1,4,2,0,7,1,6,14
PAOK Salonik,6331,2,2,2,2,10,6,4,8
P'thinaikos,6331,3,2,1,3,6,10,-4,7
Panionios,6331,4,1,1,4,4,10,-6,4
AEK Athens,6332,1,4,2,0,7,1,6,14
PAOK Salonik,6332,2,3,2,1,11,5,6,11
P'thinaikos,6332,3,1,1,4,5,11,-6,4
Panionios,6332,4,1,1,4,4,10,-6,4
AEK Athens,6333,1,4,2,0,7,1,6,14
PAOK Salonik,6333,2,2,3,1,10,5,5,9
P'thinaikos,6333,3,1,2,3,5,10,-5,5
Panionios,6333,4,1,1,4,4,10,-6,4
AEK Athens,6334,1,4,2,0,7,1,6,14
PAOK Salonik,6334,2,3,2,1,12,4,8,11
Panionios,6334,3,1,1,4,4,10,-6,4
P'thinaikos,6334,4,1,1,4,4,12,-8,4
AEK Athens,6335,1,4,2,0,7,1,6,14
PAOK Salonik,6335,2,3,2,1,12,5,7,11
Panionios,6335,3,1,1,4,4,10,-6,4
P'thinaikos,6335,4,1,1,4,5,12,-7,4
AEK Athens,6336,1,4,2,0,7,1,6,14
PAOK Salonik,6336,2,2,3,1,10,5,5,9
P'thinaikos,6336,3,1,2,3,5,10,-5,5
Panionios,6336,4,1,1,4,4,10,-6,4
AEK Athens,6337,1,4,2,0,7,1,6,14
PAOK Salonik,6337,2,3,2,1,10,4,6,11
P'thinaikos,6337,3,1,1,4,4,10,-6,4
Panionios,6337,3,1,1,4,4,10,-6,4
AEK Athens,6338,1,4,2,0,7,1,6,14
PAOK Salonik,6338,2,3,2,1,10,4,6,11
P'thinaikos,6338,3,1,1,4,4,10,-6,4
Panionios,6338,3,1,1,4,4,10,-6,4
AEK Athens,6339,1,4,2,0,7,1,6,14
PAOK Salonik,6339,2,3,2,1,11,4,7,11
Panionios,6339,3,1,1,4,4,10,-6,4
P'thinaikos,6339,4,1,1,4,4,11,-7,4
AEK Athens,6340,1,4,2,0,7,1,6,14
PAOK Salonik,6340,2,2,3,1,11,6,5,9
P'thinaikos,6340,3,1,2,3,6,11,-5,5
Panionios,6340,4,1,1,4,4,10,-6,4
AEK Athens,6341,1,4,2,0,7,1,6,14
PAOK Salonik,6341,2,3,2,1,12,4,8,11
Panionios,6341,3,1,1,4,4,10,-6,4
P'thinaikos,6341,4,1,1,4,4,12,-8,4
AEK Athens,6342,1,4,2,0,7,1,6,14
PAOK Salonik,6342,2,3,2,1,10,4,6,11
P'thinaikos,6342,3,1,1,4,4,10,-6,4
Panionios,6342,3,1,1,4,4,10,-6,4
AEK Athens,6343,1,4,2,0,7,1,6,14
PAOK Salonik,6343,2,2,2,2,9,7,2,8
P'thinaikos,6343,3,2,1,3,7,9,-2,7
Panionios,6343,4,1,1,4,4,10,-6,4
AEK Athens,6344,1,4,2,0,7,1,6,14
PAOK Salonik,6344,2,2,2,2,10,6,4,8
P'thinaikos,6344,3,2,1,3,6,10,-4,7
Panionios,6344,4,1,1,4,4,10,-6,4
AEK Athens,6345,1,4,2,0,7,1,6,14
PAOK Salonik,6345,2,3,2,1,11,5,6,11
P'thinaikos,6345,3,1,1,4,5,11,-6,4
Panionios,6345,4,1,1,4,4,10,-6,4
AEK Athens,6346,1,4,2,0,7,1,6,14
PAOK Salonik,6346,2,2,3,1,10,5,5,9
P'thinaikos,6346,3,1,2,3,5,10,-5,5
Panionios,6346,4,1,1,4,4,10,-6,4
AEK Athens,6347,1,4,2,0,7,1,6,14
PAOK Salonik,6347,2,2,3,1,9,4,5,9
P'thinaikos,6347,3,1,2,3,4,9,-5,5
Panionios,6347,4,1,1,4,4,10,-6,4
AEK Athens,6348,1,4,2,0,7,1,6,14
PAOK Salonik,6348,2,3,2,1,11,5,6,11
P'thinaikos,6348,3,1,1,4,5,11,-6,4
Panionios,6348,4,1,1,4,4,10,-6,4
AEK Athens,6349,1,4,2,0,7,1,6,14
PAOK Salonik,6349,2,3,2,1,11,5,6,11
P'thinaikos,6349,3,1,1,4,5,11,-6,4
Panionios,6349,4,1,1,4,4,10,-6,4
AEK Athens,6350,1,4,2,0,7,1,6,14
PAOK Salonik,6350,2,3,2,1,11,5,6,11
P'thinaikos,6350,3,1,1,4,5,11,-6,4
Panionios,6350,4,1,1,4,4,10,-6,4
AEK Athens,6351,1,4,2,0,7,1,6,14
PAOK Salonik,6351,2,3,2,1,11,4,7,11
Panionios,6351,3,1,1,4,4,10,-6,4
P'thinaikos,6351,4,1,1,4,4,11,-7,4
AEK Athens,6352,1,4,2,0,7,1,6,14
PAOK Salonik,6352,2,2,3,1,9,4,5,9
P'thinaikos,6352,3,1,2,3,4,9,-5,5
Panionios,6352,4,1,1,4,4,10,-6,4
AEK Athens,6353,1,4,2,0,7,1,6,14
PAOK Salonik,6353,2,2,3,1,9,4,5,9
P'thinaikos,6353,3,1,2,3,4,9,-5,5
Panionios,6353,4,1,1,4,4,10,-6,4
AEK Athens,6354,1,4,2,0,7,1,6,14
PAOK Salonik,6354,2,3,2,1,11,4,7,11
Panionios,6354,3,1,1,4,4,10,-6,4
P'thinaikos,6354,4,1,1,4,4,11,-7,4
AEK Athens,6355,1,4,2,0,7,1,6,14
PAOK Salonik,6355,2,2,3,1,12,7,5,9
P'thinaikos,6355,3,1,2,3,7,12,-5,5
Panionios,6355,4,1,1,4,4,10,-6,4
AEK Athens,6356,1,4,2,0,7,1,6,14
PAOK Salonik,6356,2,2,3,1,11,6,5,9
P'thinaikos,6356,3,1,2,3,6,11,-5,5
Panionios,6356,4,1,1,4,4,10,-6,4
AEK Athens,6357,1,4,2,0,7,1,6,14
PAOK Salonik,6357,2,3,2,1,10,4,6,11
P'thinaikos,6357,3,1,1,4,4,10,-6,4
Panionios,6357,3,1,1,4,4,10,-6,4
AEK Athens,6358,1,4,2,0,7,1,6,14
PAOK Salonik,6358,2,2,3,1,9,4,5,9
P'thinaikos,6358,3,1,2,3,4,9,-5,5
Panionios,6358,4,1,1,4,4,10,-6,4
AEK Athens,6359,1,4,2,0,7,1,6,14
PAOK Salonik,6359,2,3,2,1,11,4,7,11
Panionios,6359,3,1,1,4,4,10,-6,4
P'thinaikos,6359,4,1,1,4,4,11,-7,4
AEK Athens,6360,1,4,2,0,7,1,6,14
PAOK Salonik,6360,2,3,2,1,10,4,6,11
P'thinaikos,6360,3,1,1,4,4,10,-6,4
Panionios,6360,3,1,1,4,4,10,-6,4
AEK Athens,6361,1,4,2,0,7,1,6,14
PAOK Salonik,6361,2,3,2,1,11,5,6,11
P'thinaikos,6361,3,1,1,4,5,11,-6,4
Panionios,6361,4,1,1,4,4,10,-6,4
AEK Athens,6362,1,4,2,0,7,1,6,14
PAOK Salonik,6362,2,2,3,1,10,5,5,9
P'thinaikos,6362,3,1,2,3,5,10,-5,5
Panionios,6362,4,1,1,4,4,10,-6,4
AEK Athens,6363,1,4,2,0,7,1,6,14
PAOK Salonik,6363,2,3,2,1,12,5,7,11
Panionios,6363,3,1,1,4,4,10,-6,4
P'thinaikos,6363,4,1,1,4,5,12,-7,4
AEK Athens,6364,1,4,2,0,7,1,6,14
PAOK Salonik,6364,2,2,3,1,10,5,5,9
P'thinaikos,6364,3,1,2,3,5,10,-5,5
Panionios,6364,4,1,1,4,4,10,-6,4
AEK Athens,6365,1,4,2,0,7,1,6,14
PAOK Salonik,6365,2,2,3,1,10,5,5,9
P'thinaikos,6365,3,1,2,3,5,10,-5,5
Panionios,6365,4,1,1,4,4,10,-6,4
AEK Athens,6366,1,4,2,0,7,1,6,14
PAOK Salonik,6366,2,3,2,1,12,4,8,11
Panionios,6366,3,1,1,4,4,10,-6,4
P'thinaikos,6366,4,1,1,4,4,12,-8,4
AEK Athens,6367,1,4,2,0,7,1,6,14
PAOK Salonik,6367,2,2,2,2,9,6,3,8
P'thinaikos,6367,3,2,1,3,6,9,-3,7
Panionios,6367,4,1,1,4,4,10,-6,4
AEK Athens,6368,1,4,2,0,7,1,6,14
PAOK Salonik,6368,2,3,2,1,12,6,6,11
P'thinaikos,6368,3,1,1,4,6,12,-6,4
Panionios,6368,4,1,1,4,4,10,-6,4
AEK Athens,6369,1,4,2,0,7,1,6,14
PAOK Salonik,6369,2,2,3,1,9,4,5,9
P'thinaikos,6369,3,1,2,3,4,9,-5,5
Panionios,6369,4,1,1,4,4,10,-6,4
AEK Athens,6370,1,4,2,0,7,1,6,14
PAOK Salonik,6370,2,2,2,2,9,5,4,8
P'thinaikos,6370,3,2,1,3,5,9,-4,7
Panionios,6370,4,1,1,4,4,10,-6,4
AEK Athens,6371,1,4,2,0,7,1,6,14
PAOK Salonik,6371,2,2,2,2,9,5,4,8
P'thinaikos,6371,3,2,1,3,5,9,-4,7
Panionios,6371,4,1,1,4,4,10,-6,4
AEK Athens,6372,1,4,2,0,7,1,6,14
PAOK Salonik,6372,2,2,3,1,9,4,5,9
P'thinaikos,6372,3,1,2,3,4,9,-5,5
Panionios,6372,4,1,1,4,4,10,-6,4
AEK Athens,6373,1,4,2,0,7,1,6,14
PAOK Salonik,6373,2,3,2,1,12,4,8,11
Panionios,6373,3,1,1,4,4,10,-6,4
P'thinaikos,6373,4,1,1,4,4,12,-8,4
AEK Athens,6374,1,4,2,0,7,1,6,14
PAOK Salonik,6374,2,2,2,2,10,6,4,8
P'thinaikos,6374,3,2,1,3,6,10,-4,7
Panionios,6374,4,1,1,4,4,10,-6,4
AEK Athens,6375,1,4,2,0,7,1,6,14
PAOK Salonik,6375,2,3,2,1,10,4,6,11
P'thinaikos,6375,3,1,1,4,4,10,-6,4
Panionios,6375,3,1,1,4,4,10,-6,4
AEK Athens,6376,1,4,2,0,7,1,6,14
PAOK Salonik,6376,2,2,2,2,9,8,1,8
P'thinaikos,6376,3,2,1,3,8,9,-1,7
Panionios,6376,4,1,1,4,4,10,-6,4
AEK Athens,6377,1,4,2,0,7,1,6,14
PAOK Salonik,6377,2,2,2,2,9,5,4,8
P'thinaikos,6377,3,2,1,3,5,9,-4,7
Panionios,6377,4,1,1,4,4,10,-6,4
AEK Athens,6378,1,4,2,0,7,1,6,14
PAOK Salonik,6378,2,2,3,1,10,5,5,9
P'thinaikos,6378,3,1,2,3,5,10,-5,5
Panionios,6378,4,1,1,4,4,10,-6,4
AEK Athens,6379,1,4,2,0,7,1,6,14
PAOK Salonik,6379,2,3,2,1,11,5,6,11
P'thinaikos,6379,3,1,1,4,5,11,-6,4
Panionios,6379,4,1,1,4,4,10,-6,4
AEK Athens,6380,1,4,2,0,7,1,6,14
PAOK Salonik,6380,2,3,2,1,10,4,6,11
P'thinaikos,6380,3,1,1,4,4,10,-6,4
Panionios,6380,3,1,1,4,4,10,-6,4
AEK Athens,6381,1,4,2,0,7,1,6,14
PAOK Salonik,6381,2,2,2,2,9,5,4,8
P'thinaikos,6381,3,2,1,3,5,9,-4,7
Panionios,6381,4,1,1,4,4,10,-6,4
AEK Athens,6382,1,4,2,0,7,1,6,14
PAOK Salonik,6382,2,2,3,1,10,5,5,9
P'thinaikos,6382,3,1,2,3,5,10,-5,5
Panionios,6382,4,1,1,4,4,10,-6,4
AEK Athens,6383,1,4,2,0,7,1,6,14
PAOK Salonik,6383,2,2,2,2,10,6,4,8
P'thinaikos,6383,3,2,1,3,6,10,-4,7
Panionios,6383,4,1,1,4,4,10,-6,4
AEK Athens,6384,1,4,2,0,7,1,6,14
PAOK Salonik,6384,2,3,2,1,10,4,6,11
P'thinaikos,6384,3,1,1,4,4,10,-6,4
Panionios,6384,3,1,1,4,4,10,-6,4
AEK Athens,6385,1,4,2,0,7,1,6,14
PAOK Salonik,6385,2,3,2,1,11,4,7,11
Panionios,6385,3,1,1,4,4,10,-6,4
P'thinaikos,6385,4,1,1,4,4,11,-7,4
AEK Athens,6386,1,4,2,0,7,1,6,14
PAOK Salonik,6386,2,3,2,1,11,5,6,11
P'thinaikos,6386,3,1,1,4,5,11,-6,4
Panionios,6386,4,1,1,4,4,10,-6,4
AEK Athens,6387,1,4,2,0,7,1,6,14
PAOK Salonik,6387,2,2,3,1,11,6,5,9
P'thinaikos,6387,3,1,2,3,6,11,-5,5
Panionios,6387,4,1,1,4,4,10,-6,4
AEK Athens,6388,1,4,2,0,7,1,6,14
PAOK Salonik,6388,2,2,2,2,11,7,4,8
P'thinaikos,6388,3,2,1,3,7,11,-4,7
Panionios,6388,4,1,1,4,4,10,-6,4
AEK Athens,6389,1,4,2,0,7,1,6,14
PAOK Salonik,6389,2,2,3,1,9,4,5,9
P'thinaikos,6389,3,1,2,3,4,9,-5,5
Panionios,6389,4,1,1,4,4,10,-6,4
AEK Athens,6390,1,4,2,0,7,1,6,14
PAOK Salonik,6390,2,2,2,2,10,6,4,8
P'thinaikos,6390,3,2,1,3,6,10,-4,7
Panionios,6390,4,1,1,4,4,10,-6,4
AEK Athens,6391,1,4,2,0,7,1,6,14
PAOK Salonik,6391,2,3,2,1,11,4,7,11
Panionios,6391,3,1,1,4,4,10,-6,4
P'thinaikos,6391,4,1,1,4,4,11,-7,4
AEK Athens,6392,1,4,2,0,7,1,6,14
PAOK Salonik,6392,2,2,2,2,10,6,4,8
P'thinaikos,6392,3,2,1,3,6,10,-4,7
Panionios,6392,4,1,1,4,4,10,-6,4
AEK Athens,6393,1,4,2,0,7,1,6,14
PAOK Salonik,6393,2,2,2,2,9,6,3,8
P'thinaikos,6393,3,2,1,3,6,9,-3,7
Panionios,6393,4,1,1,4,4,10,-6,4
AEK Athens,6394,1,4,2,0,7,1,6,14
PAOK Salonik,6394,2,2,2,2,9,6,3,8
P'thinaikos,6394,3,2,1,3,6,9,-3,7
Panionios,6394,4,1,1,4,4,10,-6,4
AEK Athens,6395,1,4,2,0,7,1,6,14
PAOK Salonik,6395,2,3,2,1,11,4,7,11
Panionios,6395,3,1,1,4,4,10,-6,4
P'thinaikos,6395,4,1,1,4,4,11,-7,4
AEK Athens,6396,1,4,2,0,7,1,6,14
PAOK Salonik,6396,2,3,2,1,13,6,7,11
Panionios,6396,3,1,1,4,4,10,-6,4
P'thinaikos,6396,4,1,1,4,6,13,-7,4
AEK Athens,6397,1,4,2,0,7,1,6,14
PAOK Salonik,6397,2,2,3,1,9,4,5,9
P'thinaikos,6397,3,1,2,3,4,9,-5,5
Panionios,6397,4,1,1,4,4,10,-6,4
AEK Athens,6398,1,4,2,0,7,1,6,14
PAOK Salonik,6398,2,2,3,1,12,7,5,9
P'thinaikos,6398,3,1,2,3,7,12,-5,5
Panionios,6398,4,1,1,4,4,10,-6,4
AEK Athens,6399,1,4,2,0,7,1,6,14
PAOK Salonik,6399,2,3,2,1,12,6,6,11
P'thinaikos,6399,3,1,1,4,6,12,-6,4
Panionios,6399,4,1,1,4,4,10,-6,4
AEK Athens,6400,1,4,2,0,7,1,6,14
PAOK Salonik,6400,2,2,3,1,10,5,5,9
P'thinaikos,6400,3,1,2,3,5,10,-5,5
Panionios,6400,4,1,1,4,4,10,-6,4
AEK Athens,6401,1,4,2,0,7,1,6,14
PAOK Salonik,6401,2,3,2,1,11,5,6,11
P'thinaikos,6401,3,1,1,4,5,11,-6,4
Panionios,6401,4,1,1,4,4,10,-6,4
AEK Athens,6402,1,4,2,0,7,1,6,14
PAOK Salonik,6402,2,2,2,2,9,5,4,8
P'thinaikos,6402,3,2,1,3,5,9,-4,7
Panionios,6402,4,1,1,4,4,10,-6,4
AEK Athens,6403,1,4,2,0,7,1,6,14
PAOK Salonik,6403,2,2,3,1,9,4,5,9
P'thinaikos,6403,3,1,2,3,4,9,-5,5
Panionios,6403,4,1,1,4,4,10,-6,4
AEK Athens,6404,1,4,2,0,7,1,6,14
PAOK Salonik,6404,2,2,2,2,9,6,3,8
P'thinaikos,6404,3,2,1,3,6,9,-3,7
Panionios,6404,4,1,1,4,4,10,-6,4
AEK Athens,6405,1,4,2,0,7,1,6,14
PAOK Salonik,6405,2,2,2,2,10,7,3,8
P'thinaikos,6405,3,2,1,3,7,10,-3,7
Panionios,6405,4,1,1,4,4,10,-6,4
AEK Athens,6406,1,4,2,0,7,1,6,14
PAOK Salonik,6406,2,3,2,1,10,4,6,11
P'thinaikos,6406,3,1,1,4,4,10,-6,4
Panionios,6406,3,1,1,4,4,10,-6,4
AEK Athens,6407,1,4,2,0,7,1,6,14
PAOK Salonik,6407,2,2,2,2,9,5,4,8
P'thinaikos,6407,3,2,1,3,5,9,-4,7
Panionios,6407,4,1,1,4,4,10,-6,4
AEK Athens,6408,1,4,2,0,7,1,6,14
PAOK Salonik,6408,2,3,2,1,11,4,7,11
Panionios,6408,3,1,1,4,4,10,-6,4
P'thinaikos,6408,4,1,1,4,4,11,-7,4
AEK Athens,6409,1,4,2,0,7,1,6,14
PAOK Salonik,6409,2,3,2,1,10,4,6,11
P'thinaikos,6409,3,1,1,4,4,10,-6,4
Panionios,6409,3,1,1,4,4,10,-6,4
AEK Athens,6410,1,4,2,0,7,1,6,14
PAOK Salonik,6410,2,3,2,1,10,4,6,11
P'thinaikos,6410,3,1,1,4,4,10,-6,4
Panionios,6410,3,1,1,4,4,10,-6,4
AEK Athens,6411,1,4,2,0,7,1,6,14
PAOK Salonik,6411,2,2,2,2,10,7,3,8
P'thinaikos,6411,3,2,1,3,7,10,-3,7
Panionios,6411,4,1,1,4,4,10,-6,4
AEK Athens,6412,1,4,2,0,7,1,6,14
PAOK Salonik,6412,2,2,2,2,10,6,4,8
P'thinaikos,6412,3,2,1,3,6,10,-4,7
Panionios,6412,4,1,1,4,4,10,-6,4
AEK Athens,6413,1,4,2,0,7,1,6,14
PAOK Salonik,6413,2,3,2,1,12,4,8,11
Panionios,6413,3,1,1,4,4,10,-6,4
P'thinaikos,6413,4,1,1,4,4,12,-8,4
AEK Athens,6414,1,4,2,0,7,1,6,14
PAOK Salonik,6414,2,3,2,1,11,4,7,11
Panionios,6414,3,1,1,4,4,10,-6,4
P'thinaikos,6414,4,1,1,4,4,11,-7,4
AEK Athens,6415,1,4,2,0,7,1,6,14
PAOK Salonik,6415,2,2,2,2,9,6,3,8
P'thinaikos,6415,3,2,1,3,6,9,-3,7
Panionios,6415,4,1,1,4,4,10,-6,4
AEK Athens,6416,1,4,2,0,7,1,6,14
PAOK Salonik,6416,2,2,3,1,9,4,5,9
P'thinaikos,6416,3,1,2,3,4,9,-5,5
Panionios,6416,4,1,1,4,4,10,-6,4
AEK Athens,6417,1,4,2,0,7,1,6,14
PAOK Salonik,6417,2,3,2,1,12,6,6,11
P'thinaikos,6417,3,1,1,4,6,12,-6,4
Panionios,6417,4,1,1,4,4,10,-6,4
AEK Athens,6418,1,4,2,0,7,1,6,14
PAOK Salonik,6418,2,3,2,1,10,4,6,11
P'thinaikos,6418,3,1,1,4,4,10,-6,4
Panionios,6418,3,1,1,4,4,10,-6,4
AEK Athens,6419,1,4,2,0,7,1,6,14
PAOK Salonik,6419,2,2,3,1,9,4,5,9
P'thinaikos,6419,3,1,2,3,4,9,-5,5
Panionios,6419,4,1,1,4,4,10,-6,4
AEK Athens,6420,1,4,2,0,7,1,6,14
PAOK Salonik,6420,2,2,3,1,10,5,5,9
P'thinaikos,6420,3,1,2,3,5,10,-5,5
Panionios,6420,4,1,1,4,4,10,-6,4
AEK Athens,6421,1,4,2,0,7,1,6,14
PAOK Salonik,6421,2,2,3,1,9,4,5,9
P'thinaikos,6421,3,1,2,3,4,9,-5,5
Panionios,6421,4,1,1,4,4,10,-6,4
AEK Athens,6422,1,4,2,0,7,1,6,14
PAOK Salonik,6422,2,2,3,1,9,4,5,9
P'thinaikos,6422,3,1,2,3,4,9,-5,5
Panionios,6422,4,1,1,4,4,10,-6,4
AEK Athens,6423,1,4,2,0,7,1,6,14
PAOK Salonik,6423,2,3,2,1,10,4,6,11
P'thinaikos,6423,3,1,1,4,4,10,-6,4
Panionios,6423,3,1,1,4,4,10,-6,4
AEK Athens,6424,1,4,2,0,7,1,6,14
PAOK Salonik,6424,2,3,2,1,12,4,8,11
Panionios,6424,3,1,1,4,4,10,-6,4
P'thinaikos,6424,4,1,1,4,4,12,-8,4
AEK Athens,6425,1,4,2,0,7,1,6,14
PAOK Salonik,6425,2,3,2,1,10,4,6,11
P'thinaikos,6425,3,1,1,4,4,10,-6,4
Panionios,6425,3,1,1,4,4,10,-6,4
AEK Athens,6426,1,4,2,0,7,1,6,14
PAOK Salonik,6426,2,2,3,1,9,4,5,9
P'thinaikos,6426,3,1,2,3,4,9,-5,5
Panionios,6426,4,1,1,4,4,10,-6,4
AEK Athens,6427,1,4,2,0,7,1,6,14
PAOK Salonik,6427,2,2,3,1,9,4,5,9
P'thinaikos,6427,3,1,2,3,4,9,-5,5
Panionios,6427,4,1,1,4,4,10,-6,4
AEK Athens,6428,1,4,2,0,7,1,6,14
PAOK Salonik,6428,2,2,3,1,10,5,5,9
P'thinaikos,6428,3,1,2,3,5,10,-5,5
Panionios,6428,4,1,1,4,4,10,-6,4
AEK Athens,6429,1,4,2,0,7,1,6,14
PAOK Salonik,6429,2,2,2,2,9,6,3,8
P'thinaikos,6429,3,2,1,3,6,9,-3,7
Panionios,6429,4,1,1,4,4,10,-6,4
AEK Athens,6430,1,4,2,0,7,1,6,14
PAOK Salonik,6430,2,2,2,2,10,6,4,8
P'thinaikos,6430,3,2,1,3,6,10,-4,7
Panionios,6430,4,1,1,4,4,10,-6,4
AEK Athens,6431,1,4,2,0,7,1,6,14
PAOK Salonik,6431,2,2,2,2,10,6,4,8
P'thinaikos,6431,3,2,1,3,6,10,-4,7
Panionios,6431,4,1,1,4,4,10,-6,4
AEK Athens,6432,1,4,2,0,7,1,6,14
PAOK Salonik,6432,2,2,3,1,10,5,5,9
P'thinaikos,6432,3,1,2,3,5,10,-5,5
Panionios,6432,4,1,1,4,4,10,-6,4
AEK Athens,6433,1,4,2,0,7,1,6,14
PAOK Salonik,6433,2,2,2,2,9,7,2,8
P'thinaikos,6433,3,2,1,3,7,9,-2,7
Panionios,6433,4,1,1,4,4,10,-6,4
AEK Athens,6434,1,4,2,0,7,1,6,14
PAOK Salonik,6434,2,2,2,2,10,7,3,8
P'thinaikos,6434,3,2,1,3,7,10,-3,7
Panionios,6434,4,1,1,4,4,10,-6,4
AEK Athens,6435,1,4,2,0,7,1,6,14
PAOK Salonik,6435,2,3,2,1,10,4,6,11
P'thinaikos,6435,3,1,1,4,4,10,-6,4
Panionios,6435,3,1,1,4,4,10,-6,4
AEK Athens,6436,1,4,2,0,7,1,6,14
PAOK Salonik,6436,2,2,3,1,9,4,5,9
P'thinaikos,6436,3,1,2,3,4,9,-5,5
Panionios,6436,4,1,1,4,4,10,-6,4
AEK Athens,6437,1,4,2,0,7,1,6,14
PAOK Salonik,6437,2,2,2,2,10,7,3,8
P'thinaikos,6437,3,2,1,3,7,10,-3,7
Panionios,6437,4,1,1,4,4,10,-6,4
AEK Athens,6438,1,4,2,0,7,1,6,14
PAOK Salonik,6438,2,2,2,2,10,6,4,8
P'thinaikos,6438,3,2,1,3,6,10,-4,7
Panionios,6438,4,1,1,4,4,10,-6,4
AEK Athens,6439,1,4,2,0,7,1,6,14
PAOK Salonik,6439,2,2,2,2,9,5,4,8
P'thinaikos,6439,3,2,1,3,5,9,-4,7
Panionios,6439,4,1,1,4,4,10,-6,4
AEK Athens,6440,1,4,2,0,7,1,6,14
PAOK Salonik,6440,2,3,2,1,12,5,7,11
Panionios,6440,3,1,1,4,4,10,-6,4
P'thinaikos,6440,4,1,1,4,5,12,-7,4
AEK Athens,6441,1,4,2,0,7,1,6,14
PAOK Salonik,6441,2,2,3,1,10,5,5,9
P'thinaikos,6441,3,1,2,3,5,10,-5,5
Panionios,6441,4,1,1,4,4,10,-6,4
AEK Athens,6442,1,4,2,0,7,1,6,14
PAOK Salonik,6442,2,2,2,2,9,7,2,8
P'thinaikos,6442,3,2,1,3,7,9,-2,7
Panionios,6442,4,1,1,4,4,10,-6,4
AEK Athens,6443,1,4,2,0,7,1,6,14
PAOK Salonik,6443,2,3,2,1,11,5,6,11
P'thinaikos,6443,3,1,1,4,5,11,-6,4
Panionios,6443,4,1,1,4,4,10,-6,4
AEK Athens,6444,1,4,2,0,7,1,6,14
PAOK Salonik,6444,2,2,3,1,10,5,5,9
P'thinaikos,6444,3,1,2,3,5,10,-5,5
Panionios,6444,4,1,1,4,4,10,-6,4
AEK Athens,6445,1,4,2,0,7,1,6,14
PAOK Salonik,6445,2,2,3,1,11,6,5,9
P'thinaikos,6445,3,1,2,3,6,11,-5,5
Panionios,6445,4,1,1,4,4,10,-6,4
AEK Athens,6446,1,4,2,0,7,1,6,14
PAOK Salonik,6446,2,2,2,2,10,7,3,8
P'thinaikos,6446,3,2,1,3,7,10,-3,7
Panionios,6446,4,1,1,4,4,10,-6,4
AEK Athens,6447,1,4,2,0,7,1,6,14
PAOK Salonik,6447,2,3,2,1,11,4,7,11
Panionios,6447,3,1,1,4,4,10,-6,4
P'thinaikos,6447,4,1,1,4,4,11,-7,4
AEK Athens,6448,1,4,2,0,7,1,6,14
PAOK Salonik,6448,2,2,2,2,10,6,4,8
P'thinaikos,6448,3,2,1,3,6,10,-4,7
Panionios,6448,4,1,1,4,4,10,-6,4
AEK Athens,6449,1,4,2,0,7,1,6,14
PAOK Salonik,6449,2,3,2,1,11,4,7,11
Panionios,6449,3,1,1,4,4,10,-6,4
P'thinaikos,6449,4,1,1,4,4,11,-7,4
AEK Athens,6450,1,4,2,0,7,1,6,14
PAOK Salonik,6450,2,2,2,2,10,7,3,8
P'thinaikos,6450,3,2,1,3,7,10,-3,7
Panionios,6450,4,1,1,4,4,10,-6,4
AEK Athens,6451,1,4,2,0,7,1,6,14
PAOK Salonik,6451,2,2,2,2,9,5,4,8
P'thinaikos,6451,3,2,1,3,5,9,-4,7
Panionios,6451,4,1,1,4,4,10,-6,4
AEK Athens,6452,1,4,2,0,7,1,6,14
PAOK Salonik,6452,2,3,2,1,11,5,6,11
P'thinaikos,6452,3,1,1,4,5,11,-6,4
Panionios,6452,4,1,1,4,4,10,-6,4
AEK Athens,6453,1,4,2,0,7,1,6,14
PAOK Salonik,6453,2,2,3,1,12,7,5,9
P'thinaikos,6453,3,1,2,3,7,12,-5,5
Panionios,6453,4,1,1,4,4,10,-6,4
AEK Athens,6454,1,4,2,0,7,1,6,14
PAOK Salonik,6454,2,2,2,2,10,7,3,8
P'thinaikos,6454,3,2,1,3,7,10,-3,7
Panionios,6454,4,1,1,4,4,10,-6,4
AEK Athens,6455,1,4,2,0,7,1,6,14
PAOK Salonik,6455,2,2,3,1,9,4,5,9
P'thinaikos,6455,3,1,2,3,4,9,-5,5
Panionios,6455,4,1,1,4,4,10,-6,4
AEK Athens,6456,1,4,2,0,7,1,6,14
PAOK Salonik,6456,2,2,2,2,11,7,4,8
P'thinaikos,6456,3,2,1,3,7,11,-4,7
Panionios,6456,4,1,1,4,4,10,-6,4
AEK Athens,6457,1,4,2,0,7,1,6,14
PAOK Salonik,6457,2,3,2,1,13,4,9,11
Panionios,6457,3,1,1,4,4,10,-6,4
P'thinaikos,6457,4,1,1,4,4,13,-9,4
AEK Athens,6458,1,4,2,0,7,1,6,14
PAOK Salonik,6458,2,2,3,1,10,5,5,9
P'thinaikos,6458,3,1,2,3,5,10,-5,5
Panionios,6458,4,1,1,4,4,10,-6,4
AEK Athens,6459,1,4,2,0,7,1,6,14
PAOK Salonik,6459,2,3,2,1,11,5,6,11
P'thinaikos,6459,3,1,1,4,5,11,-6,4
Panionios,6459,4,1,1,4,4,10,-6,4
AEK Athens,6460,1,4,2,0,7,1,6,14
PAOK Salonik,6460,2,2,3,1,9,4,5,9
P'thinaikos,6460,3,1,2,3,4,9,-5,5
Panionios,6460,4,1,1,4,4,10,-6,4
AEK Athens,6461,1,4,2,0,7,1,6,14
PAOK Salonik,6461,2,3,2,1,12,6,6,11
P'thinaikos,6461,3,1,1,4,6,12,-6,4
Panionios,6461,4,1,1,4,4,10,-6,4
AEK Athens,6462,1,4,2,0,7,1,6,14
PAOK Salonik,6462,2,2,3,1,10,5,5,9
P'thinaikos,6462,3,1,2,3,5,10,-5,5
Panionios,6462,4,1,1,4,4,10,-6,4
AEK Athens,6463,1,4,2,0,7,1,6,14
PAOK Salonik,6463,2,2,2,2,9,6,3,8
P'thinaikos,6463,3,2,1,3,6,9,-3,7
Panionios,6463,4,1,1,4,4,10,-6,4
AEK Athens,6464,1,4,2,0,7,1,6,14
PAOK Salonik,6464,2,3,2,1,15,4,11,11
Panionios,6464,3,1,1,4,4,10,-6,4
P'thinaikos,6464,4,1,1,4,4,15,-11,4
AEK Athens,6465,1,4,2,0,7,1,6,14
PAOK Salonik,6465,2,2,2,2,9,5,4,8
P'thinaikos,6465,3,2,1,3,5,9,-4,7
Panionios,6465,4,1,1,4,4,10,-6,4
AEK Athens,6466,1,4,2,0,7,1,6,14
PAOK Salonik,6466,2,2,3,1,10,5,5,9
P'thinaikos,6466,3,1,2,3,5,10,-5,5
Panionios,6466,4,1,1,4,4,10,-6,4
AEK Athens,6467,1,4,2,0,7,1,6,14
PAOK Salonik,6467,2,2,2,2,10,6,4,8
P'thinaikos,6467,3,2,1,3,6,10,-4,7
Panionios,6467,4,1,1,4,4,10,-6,4
AEK Athens,6468,1,4,2,0,7,1,6,14
PAOK Salonik,6468,2,3,2,1,11,5,6,11
P'thinaikos,6468,3,1,1,4,5,11,-6,4
Panionios,6468,4,1,1,4,4,10,-6,4
AEK Athens,6469,1,4,2,0,7,1,6,14
PAOK Salonik,6469,2,2,2,2,9,6,3,8
P'thinaikos,6469,3,2,1,3,6,9,-3,7
Panionios,6469,4,1,1,4,4,10,-6,4
AEK Athens,6470,1,4,2,0,7,1,6,14
PAOK Salonik,6470,2,3,2,1,12,6,6,11
P'thinaikos,6470,3,1,1,4,6,12,-6,4
Panionios,6470,4,1,1,4,4,10,-6,4
AEK Athens,6471,1,4,2,0,7,1,6,14
PAOK Salonik,6471,2,2,2,2,9,6,3,8
P'thinaikos,6471,3,2,1,3,6,9,-3,7
Panionios,6471,4,1,1,4,4,10,-6,4
AEK Athens,6472,1,4,2,0,7,1,6,14
PAOK Salonik,6472,2,2,3,1,10,5,5,9
P'thinaikos,6472,3,1,2,3,5,10,-5,5
Panionios,6472,4,1,1,4,4,10,-6,4
AEK Athens,6473,1,4,2,0,7,1,6,14
PAOK Salonik,6473,2,2,3,1,9,4,5,9
P'thinaikos,6473,3,1,2,3,4,9,-5,5
Panionios,6473,4,1,1,4,4,10,-6,4
AEK Athens,6474,1,4,2,0,7,1,6,14
PAOK Salonik,6474,2,3,2,1,12,5,7,11
Panionios,6474,3,1,1,4,4,10,-6,4
P'thinaikos,6474,4,1,1,4,5,12,-7,4
AEK Athens,6475,1,4,2,0,7,1,6,14
PAOK Salonik,6475,2,3,2,1,10,4,6,11
P'thinaikos,6475,3,1,1,4,4,10,-6,4
Panionios,6475,3,1,1,4,4,10,-6,4
AEK Athens,6476,1,4,2,0,7,1,6,14
PAOK Salonik,6476,2,2,3,1,9,4,5,9
P'thinaikos,6476,3,1,2,3,4,9,-5,5
Panionios,6476,4,1,1,4,4,10,-6,4
AEK Athens,6477,1,4,2,0,7,1,6,14
PAOK Salonik,6477,2,2,2,2,9,5,4,8
P'thinaikos,6477,3,2,1,3,5,9,-4,7
Panionios,6477,4,1,1,4,4,10,-6,4
AEK Athens,6478,1,4,2,0,7,1,6,14
PAOK Salonik,6478,2,2,3,1,9,4,5,9
P'thinaikos,6478,3,1,2,3,4,9,-5,5
Panionios,6478,4,1,1,4,4,10,-6,4
AEK Athens,6479,1,4,2,0,7,1,6,14
PAOK Salonik,6479,2,2,2,2,9,6,3,8
P'thinaikos,6479,3,2,1,3,6,9,-3,7
Panionios,6479,4,1,1,4,4,10,-6,4
AEK Athens,6480,1,4,2,0,7,1,6,14
PAOK Salonik,6480,2,2,3,1,9,4,5,9
P'thinaikos,6480,3,1,2,3,4,9,-5,5
Panionios,6480,4,1,1,4,4,10,-6,4
AEK Athens,6481,1,4,2,0,7,1,6,14
PAOK Salonik,6481,2,2,3,1,11,6,5,9
P'thinaikos,6481,3,1,2,3,6,11,-5,5
Panionios,6481,4,1,1,4,4,10,-6,4
AEK Athens,6482,1,4,2,0,7,1,6,14
PAOK Salonik,6482,2,2,2,2,9,6,3,8
P'thinaikos,6482,3,2,1,3,6,9,-3,7
Panionios,6482,4,1,1,4,4,10,-6,4
AEK Athens,6483,1,4,2,0,7,1,6,14
PAOK Salonik,6483,2,3,2,1,10,4,6,11
P'thinaikos,6483,3,1,1,4,4,10,-6,4
Panionios,6483,3,1,1,4,4,10,-6,4
AEK Athens,6484,1,4,2,0,7,1,6,14
PAOK Salonik,6484,2,3,2,1,10,4,6,11
P'thinaikos,6484,3,1,1,4,4,10,-6,4
Panionios,6484,3,1,1,4,4,10,-6,4
AEK Athens,6485,1,4,2,0,7,1,6,14
PAOK Salonik,6485,2,2,2,2,9,5,4,8
P'thinaikos,6485,3,2,1,3,5,9,-4,7
Panionios,6485,4,1,1,4,4,10,-6,4
AEK Athens,6486,1,4,2,0,7,1,6,14
PAOK Salonik,6486,2,2,3,1,10,5,5,9
P'thinaikos,6486,3,1,2,3,5,10,-5,5
Panionios,6486,4,1,1,4,4,10,-6,4
AEK Athens,6487,1,4,2,0,7,1,6,14
PAOK Salonik,6487,2,2,2,2,10,6,4,8
P'thinaikos,6487,3,2,1,3,6,10,-4,7
Panionios,6487,4,1,1,4,4,10,-6,4
AEK Athens,6488,1,4,2,0,7,1,6,14
PAOK Salonik,6488,2,2,3,1,9,4,5,9
P'thinaikos,6488,3,1,2,3,4,9,-5,5
Panionios,6488,4,1,1,4,4,10,-6,4
AEK Athens,6489,1,4,2,0,7,1,6,14
PAOK Salonik,6489,2,2,2,2,9,6,3,8
P'thinaikos,6489,3,2,1,3,6,9,-3,7
Panionios,6489,4,1,1,4,4,10,-6,4
AEK Athens,6490,1,4,2,0,7,1,6,14
PAOK Salonik,6490,2,3,2,1,13,6,7,11
Panionios,6490,3,1,1,4,4,10,-6,4
P'thinaikos,6490,4,1,1,4,6,13,-7,4
AEK Athens,6491,1,4,2,0,7,1,6,14
PAOK Salonik,6491,2,3,2,1,11,4,7,11
Panionios,6491,3,1,1,4,4,10,-6,4
P'thinaikos,6491,4,1,1,4,4,11,-7,4
AEK Athens,6492,1,4,2,0,7,1,6,14
PAOK Salonik,6492,2,2,3,1,9,4,5,9
P'thinaikos,6492,3,1,2,3,4,9,-5,5
Panionios,6492,4,1,1,4,4,10,-6,4
AEK Athens,6493,1,4,2,0,7,1,6,14
PAOK Salonik,6493,2,2,2,2,10,6,4,8
P'thinaikos,6493,3,2,1,3,6,10,-4,7
Panionios,6493,4,1,1,4,4,10,-6,4
AEK Athens,6494,1,4,2,0,7,1,6,14
PAOK Salonik,6494,2,2,2,2,9,5,4,8
P'thinaikos,6494,3,2,1,3,5,9,-4,7
Panionios,6494,4,1,1,4,4,10,-6,4
AEK Athens,6495,1,4,2,0,7,1,6,14
PAOK Salonik,6495,2,2,2,2,9,5,4,8
P'thinaikos,6495,3,2,1,3,5,9,-4,7
Panionios,6495,4,1,1,4,4,10,-6,4
AEK Athens,6496,1,4,2,0,7,1,6,14
PAOK Salonik,6496,2,3,2,1,12,6,6,11
P'thinaikos,6496,3,1,1,4,6,12,-6,4
Panionios,6496,4,1,1,4,4,10,-6,4
AEK Athens,6497,1,4,2,0,7,1,6,14
PAOK Salonik,6497,2,2,2,2,10,6,4,8
P'thinaikos,6497,3,2,1,3,6,10,-4,7
Panionios,6497,4,1,1,4,4,10,-6,4
AEK Athens,6498,1,4,2,0,7,1,6,14
PAOK Salonik,6498,2,3,2,1,10,4,6,11
P'thinaikos,6498,3,1,1,4,4,10,-6,4
Panionios,6498,3,1,1,4,4,10,-6,4
AEK Athens,6499,1,4,2,0,7,1,6,14
PAOK Salonik,6499,2,2,2,2,9,7,2,8
P'thinaikos,6499,3,2,1,3,7,9,-2,7
Panionios,6499,4,1,1,4,4,10,-6,4
AEK Athens,6500,1,4,2,0,7,1,6,14
PAOK Salonik,6500,2,2,2,2,10,6,4,8
P'thinaikos,6500,3,2,1,3,6,10,-4,7
Panionios,6500,4,1,1,4,4,10,-6,4
AEK Athens,6501,1,4,2,0,7,1,6,14
PAOK Salonik,6501,2,2,3,1,11,6,5,9
P'thinaikos,6501,3,1,2,3,6,11,-5,5
Panionios,6501,4,1,1,4,4,10,-6,4
AEK Athens,6502,1,4,2,0,7,1,6,14
PAOK Salonik,6502,2,3,2,1,13,5,8,11
Panionios,6502,3,1,1,4,4,10,-6,4
P'thinaikos,6502,4,1,1,4,5,13,-8,4
AEK Athens,6503,1,4,2,0,7,1,6,14
PAOK Salonik,6503,2,2,2,2,10,6,4,8
P'thinaikos,6503,3,2,1,3,6,10,-4,7
Panionios,6503,4,1,1,4,4,10,-6,4
AEK Athens,6504,1,4,2,0,7,1,6,14
PAOK Salonik,6504,2,2,3,1,9,4,5,9
P'thinaikos,6504,3,1,2,3,4,9,-5,5
Panionios,6504,4,1,1,4,4,10,-6,4
AEK Athens,6505,1,4,2,0,7,1,6,14
PAOK Salonik,6505,2,2,2,2,9,5,4,8
P'thinaikos,6505,3,2,1,3,5,9,-4,7
Panionios,6505,4,1,1,4,4,10,-6,4
AEK Athens,6506,1,4,2,0,7,1,6,14
PAOK Salonik,6506,2,2,3,1,10,5,5,9
P'thinaikos,6506,3,1,2,3,5,10,-5,5
Panionios,6506,4,1,1,4,4,10,-6,4
AEK Athens,6507,1,4,2,0,7,1,6,14
PAOK Salonik,6507,2,2,2,2,9,6,3,8
P'thinaikos,6507,3,2,1,3,6,9,-3,7
Panionios,6507,4,1,1,4,4,10,-6,4
AEK Athens,6508,1,4,2,0,7,1,6,14
PAOK Salonik,6508,2,2,2,2,9,7,2,8
P'thinaikos,6508,3,2,1,3,7,9,-2,7
Panionios,6508,4,1,1,4,4,10,-6,4
AEK Athens,6509,1,4,2,0,7,1,6,14
PAOK Salonik,6509,2,2,2,2,9,6,3,8
P'thinaikos,6509,3,2,1,3,6,9,-3,7
Panionios,6509,4,1,1,4,4,10,-6,4
AEK Athens,6510,1,4,2,0,7,1,6,14
PAOK Salonik,6510,2,2,3,1,10,5,5,9
P'thinaikos,6510,3,1,2,3,5,10,-5,5
Panionios,6510,4,1,1,4,4,10,-6,4
AEK Athens,6511,1,4,2,0,7,1,6,14
PAOK Salonik,6511,2,3,2,1,11,5,6,11
P'thinaikos,6511,3,1,1,4,5,11,-6,4
Panionios,6511,4,1,1,4,4,10,-6,4
AEK Athens,6512,1,4,2,0,7,1,6,14
PAOK Salonik,6512,2,2,2,2,9,9,0,8
P'thinaikos,6512,3,2,1,3,9,9,0,7
Panionios,6512,4,1,1,4,4,10,-6,4
AEK Athens,6513,1,4,2,0,7,1,6,14
PAOK Salonik,6513,2,3,2,1,11,5,6,11
P'thinaikos,6513,3,1,1,4,5,11,-6,4
Panionios,6513,4,1,1,4,4,10,-6,4
AEK Athens,6514,1,4,2,0,7,1,6,14
PAOK Salonik,6514,2,2,2,2,9,6,3,8
P'thinaikos,6514,3,2,1,3,6,9,-3,7
Panionios,6514,4,1,1,4,4,10,-6,4
AEK Athens,6515,1,4,2,0,7,1,6,14
PAOK Salonik,6515,2,2,3,1,9,4,5,9
P'thinaikos,6515,3,1,2,3,4,9,-5,5
Panionios,6515,4,1,1,4,4,10,-6,4
AEK Athens,6516,1,4,2,0,7,1,6,14
PAOK Salonik,6516,2,2,2,2,10,7,3,8
P'thinaikos,6516,3,2,1,3,7,10,-3,7
Panionios,6516,4,1,1,4,4,10,-6,4
AEK Athens,6517,1,4,2,0,7,1,6,14
PAOK Salonik,6517,2,2,2,2,9,5,4,8
P'thinaikos,6517,3,2,1,3,5,9,-4,7
Panionios,6517,4,1,1,4,4,10,-6,4
AEK Athens,6518,1,4,2,0,7,1,6,14
PAOK Salonik,6518,2,2,2,2,9,7,2,8
P'thinaikos,6518,3,2,1,3,7,9,-2,7
Panionios,6518,4,1,1,4,4,10,-6,4
AEK Athens,6519,1,4,2,0,7,1,6,14
PAOK Salonik,6519,2,2,3,1,10,5,5,9
P'thinaikos,6519,3,1,2,3,5,10,-5,5
Panionios,6519,4,1,1,4,4,10,-6,4
AEK Athens,6520,1,4,2,0,7,1,6,14
PAOK Salonik,6520,2,3,2,1,12,5,7,11
Panionios,6520,3,1,1,4,4,10,-6,4
P'thinaikos,6520,4,1,1,4,5,12,-7,4
AEK Athens,6521,1,4,2,0,7,1,6,14
PAOK Salonik,6521,2,3,2,1,10,4,6,11
P'thinaikos,6521,3,1,1,4,4,10,-6,4
Panionios,6521,3,1,1,4,4,10,-6,4
AEK Athens,6522,1,4,2,0,7,1,6,14
PAOK Salonik,6522,2,2,3,1,10,5,5,9
P'thinaikos,6522,3,1,2,3,5,10,-5,5
Panionios,6522,4,1,1,4,4,10,-6,4
AEK Athens,6523,1,4,2,0,7,1,6,14
PAOK Salonik,6523,2,2,2,2,9,6,3,8
P'thinaikos,6523,3,2,1,3,6,9,-3,7
Panionios,6523,4,1,1,4,4,10,-6,4
AEK Athens,6524,1,4,2,0,7,1,6,14
PAOK Salonik,6524,2,2,2,2,10,6,4,8
P'thinaikos,6524,3,2,1,3,6,10,-4,7
Panionios,6524,4,1,1,4,4,10,-6,4
AEK Athens,6525,1,4,2,0,7,1,6,14
PAOK Salonik,6525,2,2,3,1,9,4,5,9
P'thinaikos,6525,3,1,2,3,4,9,-5,5
Panionios,6525,4,1,1,4,4,10,-6,4
AEK Athens,6526,1,4,2,0,7,1,6,14
PAOK Salonik,6526,2,3,2,1,11,5,6,11
P'thinaikos,6526,3,1,1,4,5,11,-6,4
Panionios,6526,4,1,1,4,4,10,-6,4
AEK Athens,6527,1,4,2,0,7,1,6,14
PAOK Salonik,6527,2,2,2,2,10,6,4,8
P'thinaikos,6527,3,2,1,3,6,10,-4,7
Panionios,6527,4,1,1,4,4,10,-6,4
AEK Athens,6528,1,4,2,0,7,1,6,14
PAOK Salonik,6528,2,2,3,1,10,5,5,9
P'thinaikos,6528,3,1,2,3,5,10,-5,5
Panionios,6528,4,1,1,4,4,10,-6,4
AEK Athens,6529,1,4,2,0,7,1,6,14
PAOK Salonik,6529,2,3,2,1,11,4,7,11
Panionios,6529,3,1,1,4,4,10,-6,4
P'thinaikos,6529,4,1,1,4,4,11,-7,4
AEK Athens,6530,1,4,2,0,7,1,6,14
PAOK Salonik,6530,2,2,3,1,10,5,5,9
P'thinaikos,6530,3,1,2,3,5,10,-5,5
Panionios,6530,4,1,1,4,4,10,-6,4
AEK Athens,6531,1,4,2,0,7,1,6,14
PAOK Salonik,6531,2,2,3,1,10,5,5,9
P'thinaikos,6531,3,1,2,3,5,10,-5,5
Panionios,6531,4,1,1,4,4,10,-6,4
AEK Athens,6532,1,4,2,0,7,1,6,14
PAOK Salonik,6532,2,3,2,1,11,4,7,11
Panionios,6532,3,1,1,4,4,10,-6,4
P'thinaikos,6532,4,1,1,4,4,11,-7,4
AEK Athens,6533,1,4,2,0,7,1,6,14
PAOK Salonik,6533,2,3,2,1,10,4,6,11
P'thinaikos,6533,3,1,1,4,4,10,-6,4
Panionios,6533,3,1,1,4,4,10,-6,4
AEK Athens,6534,1,4,2,0,7,1,6,14
PAOK Salonik,6534,2,2,3,1,9,4,5,9
P'thinaikos,6534,3,1,2,3,4,9,-5,5
Panionios,6534,4,1,1,4,4,10,-6,4
AEK Athens,6535,1,4,2,0,7,1,6,14
PAOK Salonik,6535,2,3,2,1,10,4,6,11
P'thinaikos,6535,3,1,1,4,4,10,-6,4
Panionios,6535,3,1,1,4,4,10,-6,4
AEK Athens,6536,1,4,2,0,7,1,6,14
PAOK Salonik,6536,2,2,3,1,11,6,5,9
P'thinaikos,6536,3,1,2,3,6,11,-5,5
Panionios,6536,4,1,1,4,4,10,-6,4
AEK Athens,6537,1,4,2,0,7,1,6,14
PAOK Salonik,6537,2,3,2,1,11,4,7,11
Panionios,6537,3,1,1,4,4,10,-6,4
P'thinaikos,6537,4,1,1,4,4,11,-7,4
AEK Athens,6538,1,4,2,0,7,1,6,14
PAOK Salonik,6538,2,2,3,1,10,5,5,9
P'thinaikos,6538,3,1,2,3,5,10,-5,5
Panionios,6538,4,1,1,4,4,10,-6,4
AEK Athens,6539,1,4,2,0,7,1,6,14
PAOK Salonik,6539,2,3,2,1,11,4,7,11
Panionios,6539,3,1,1,4,4,10,-6,4
P'thinaikos,6539,4,1,1,4,4,11,-7,4
AEK Athens,6540,1,4,2,0,7,1,6,14
PAOK Salonik,6540,2,2,3,1,9,4,5,9
P'thinaikos,6540,3,1,2,3,4,9,-5,5
Panionios,6540,4,1,1,4,4,10,-6,4
AEK Athens,6541,1,4,2,0,7,1,6,14
PAOK Salonik,6541,2,3,2,1,10,4,6,11
P'thinaikos,6541,3,1,1,4,4,10,-6,4
Panionios,6541,3,1,1,4,4,10,-6,4
AEK Athens,6542,1,4,2,0,7,1,6,14
PAOK Salonik,6542,2,3,2,1,11,5,6,11
P'thinaikos,6542,3,1,1,4,5,11,-6,4
Panionios,6542,4,1,1,4,4,10,-6,4
AEK Athens,6543,1,4,2,0,7,1,6,14
PAOK Salonik,6543,2,3,2,1,13,5,8,11
Panionios,6543,3,1,1,4,4,10,-6,4
P'thinaikos,6543,4,1,1,4,5,13,-8,4
AEK Athens,6544,1,4,2,0,7,1,6,14
PAOK Salonik,6544,2,3,2,1,13,5,8,11
Panionios,6544,3,1,1,4,4,10,-6,4
P'thinaikos,6544,4,1,1,4,5,13,-8,4
AEK Athens,6545,1,4,2,0,7,1,6,14
PAOK Salonik,6545,2,2,3,1,9,4,5,9
P'thinaikos,6545,3,1,2,3,4,9,-5,5
Panionios,6545,4,1,1,4,4,10,-6,4
AEK Athens,6546,1,4,2,0,7,1,6,14
PAOK Salonik,6546,2,2,2,2,9,7,2,8
P'thinaikos,6546,3,2,1,3,7,9,-2,7
Panionios,6546,4,1,1,4,4,10,-6,4
AEK Athens,6547,1,4,2,0,7,1,6,14
PAOK Salonik,6547,2,3,2,1,13,7,6,11
P'thinaikos,6547,3,1,1,4,7,13,-6,4
Panionios,6547,4,1,1,4,4,10,-6,4
AEK Athens,6548,1,4,2,0,7,1,6,14
PAOK Salonik,6548,2,2,2,2,10,7,3,8
P'thinaikos,6548,3,2,1,3,7,10,-3,7
Panionios,6548,4,1,1,4,4,10,-6,4
AEK Athens,6549,1,4,2,0,7,1,6,14
PAOK Salonik,6549,2,3,2,1,11,5,6,11
P'thinaikos,6549,3,1,1,4,5,11,-6,4
Panionios,6549,4,1,1,4,4,10,-6,4
AEK Athens,6550,1,4,2,0,7,1,6,14
PAOK Salonik,6550,2,2,2,2,10,6,4,8
P'thinaikos,6550,3,2,1,3,6,10,-4,7
Panionios,6550,4,1,1,4,4,10,-6,4
AEK Athens,6551,1,4,2,0,7,1,6,14
PAOK Salonik,6551,2,2,2,2,9,6,3,8
P'thinaikos,6551,3,2,1,3,6,9,-3,7
Panionios,6551,4,1,1,4,4,10,-6,4
AEK Athens,6552,1,4,2,0,7,1,6,14
PAOK Salonik,6552,2,3,2,1,10,4,6,11
P'thinaikos,6552,3,1,1,4,4,10,-6,4
Panionios,6552,3,1,1,4,4,10,-6,4
AEK Athens,6553,1,4,2,0,7,1,6,14
PAOK Salonik,6553,2,2,2,2,9,5,4,8
P'thinaikos,6553,3,2,1,3,5,9,-4,7
Panionios,6553,4,1,1,4,4,10,-6,4
AEK Athens,6554,1,4,2,0,7,1,6,14
PAOK Salonik,6554,2,2,2,2,9,6,3,8
P'thinaikos,6554,3,2,1,3,6,9,-3,7
Panionios,6554,4,1,1,4,4,10,-6,4
AEK Athens,6555,1,4,2,0,7,1,6,14
PAOK Salonik,6555,2,2,2,2,10,6,4,8
P'thinaikos,6555,3,2,1,3,6,10,-4,7
Panionios,6555,4,1,1,4,4,10,-6,4
AEK Athens,6556,1,4,2,0,7,1,6,14
PAOK Salonik,6556,2,3,2,1,11,4,7,11
Panionios,6556,3,1,1,4,4,10,-6,4
P'thinaikos,6556,4,1,1,4,4,11,-7,4
AEK Athens,6557,1,4,2,0,7,1,6,14
PAOK Salonik,6557,2,3,2,1,13,7,6,11
P'thinaikos,6557,3,1,1,4,7,13,-6,4
Panionios,6557,4,1,1,4,4,10,-6,4
AEK Athens,6558,1,4,2,0,7,1,6,14
PAOK Salonik,6558,2,2,2,2,9,5,4,8
P'thinaikos,6558,3,2,1,3,5,9,-4,7
Panionios,6558,4,1,1,4,4,10,-6,4
AEK Athens,6559,1,4,2,0,7,1,6,14
PAOK Salonik,6559,2,2,2,2,9,5,4,8
P'thinaikos,6559,3,2,1,3,5,9,-4,7
Panionios,6559,4,1,1,4,4,10,-6,4
AEK Athens,6560,1,4,2,0,7,1,6,14
PAOK Salonik,6560,2,2,3,1,11,6,5,9
P'thinaikos,6560,3,1,2,3,6,11,-5,5
Panionios,6560,4,1,1,4,4,10,-6,4
AEK Athens,6561,1,4,2,0,7,1,6,14
PAOK Salonik,6561,2,2,2,2,9,5,4,8
P'thinaikos,6561,3,2,1,3,5,9,-4,7
Panionios,6561,4,1,1,4,4,10,-6,4
AEK Athens,6562,1,4,2,0,7,1,6,14
PAOK Salonik,6562,2,2,2,2,11,8,3,8
P'thinaikos,6562,3,2,1,3,8,11,-3,7
Panionios,6562,4,1,1,4,4,10,-6,4
AEK Athens,6563,1,4,2,0,7,1,6,14
PAOK Salonik,6563,2,2,2,2,9,6,3,8
P'thinaikos,6563,3,2,1,3,6,9,-3,7
Panionios,6563,4,1,1,4,4,10,-6,4
AEK Athens,6564,1,4,2,0,7,1,6,14
PAOK Salonik,6564,2,3,2,1,10,4,6,11
P'thinaikos,6564,3,1,1,4,4,10,-6,4
Panionios,6564,3,1,1,4,4,10,-6,4
AEK Athens,6565,1,4,2,0,7,1,6,14
PAOK Salonik,6565,2,2,2,2,9,5,4,8
P'thinaikos,6565,3,2,1,3,5,9,-4,7
Panionios,6565,4,1,1,4,4,10,-6,4
AEK Athens,6566,1,4,2,0,7,1,6,14
PAOK Salonik,6566,2,3,2,1,13,5,8,11
Panionios,6566,3,1,1,4,4,10,-6,4
P'thinaikos,6566,4,1,1,4,5,13,-8,4
AEK Athens,6567,1,4,2,0,7,1,6,14
PAOK Salonik,6567,2,3,2,1,12,5,7,11
Panionios,6567,3,1,1,4,4,10,-6,4
P'thinaikos,6567,4,1,1,4,5,12,-7,4
AEK Athens,6568,1,4,2,0,7,1,6,14
PAOK Salonik,6568,2,3,2,1,10,4,6,11
P'thinaikos,6568,3,1,1,4,4,10,-6,4
Panionios,6568,3,1,1,4,4,10,-6,4
AEK Athens,6569,1,4,2,0,7,1,6,14
PAOK Salonik,6569,2,2,2,2,9,5,4,8
P'thinaikos,6569,3,2,1,3,5,9,-4,7
Panionios,6569,4,1,1,4,4,10,-6,4
AEK Athens,6570,1,4,2,0,7,1,6,14
PAOK Salonik,6570,2,2,2,2,9,5,4,8
P'thinaikos,6570,3,2,1,3,5,9,-4,7
Panionios,6570,4,1,1,4,4,10,-6,4
AEK Athens,6571,1,4,2,0,7,1,6,14
PAOK Salonik,6571,2,3,2,1,11,5,6,11
P'thinaikos,6571,3,1,1,4,5,11,-6,4
Panionios,6571,4,1,1,4,4,10,-6,4
AEK Athens,6572,1,4,2,0,7,1,6,14
PAOK Salonik,6572,2,2,3,1,9,4,5,9
P'thinaikos,6572,3,1,2,3,4,9,-5,5
Panionios,6572,4,1,1,4,4,10,-6,4
AEK Athens,6573,1,4,2,0,7,1,6,14
PAOK Salonik,6573,2,3,2,1,10,4,6,11
P'thinaikos,6573,3,1,1,4,4,10,-6,4
Panionios,6573,3,1,1,4,4,10,-6,4
AEK Athens,6574,1,4,2,0,7,1,6,14
PAOK Salonik,6574,2,3,2,1,10,4,6,11
P'thinaikos,6574,3,1,1,4,4,10,-6,4
Panionios,6574,3,1,1,4,4,10,-6,4
AEK Athens,6575,1,4,2,0,7,1,6,14
PAOK Salonik,6575,2,2,2,2,9,7,2,8
P'thinaikos,6575,3,2,1,3,7,9,-2,7
Panionios,6575,4,1,1,4,4,10,-6,4
AEK Athens,6576,1,4,2,0,7,1,6,14
PAOK Salonik,6576,2,3,2,1,11,4,7,11
Panionios,6576,3,1,1,4,4,10,-6,4
P'thinaikos,6576,4,1,1,4,4,11,-7,4
AEK Athens,6577,1,4,2,0,7,1,6,14
PAOK Salonik,6577,2,2,3,1,9,4,5,9
P'thinaikos,6577,3,1,2,3,4,9,-5,5
Panionios,6577,4,1,1,4,4,10,-6,4
AEK Athens,6578,1,4,2,0,7,1,6,14
PAOK Salonik,6578,2,3,2,1,10,4,6,11
P'thinaikos,6578,3,1,1,4,4,10,-6,4
Panionios,6578,3,1,1,4,4,10,-6,4
AEK Athens,6579,1,4,2,0,7,1,6,14
PAOK Salonik,6579,2,2,3,1,10,5,5,9
P'thinaikos,6579,3,1,2,3,5,10,-5,5
Panionios,6579,4,1,1,4,4,10,-6,4
AEK Athens,6580,1,4,2,0,7,1,6,14
PAOK Salonik,6580,2,2,3,1,9,4,5,9
P'thinaikos,6580,3,1,2,3,4,9,-5,5
Panionios,6580,4,1,1,4,4,10,-6,4
AEK Athens,6581,1,4,2,0,7,1,6,14
PAOK Salonik,6581,2,2,3,1,9,4,5,9
P'thinaikos,6581,3,1,2,3,4,9,-5,5
Panionios,6581,4,1,1,4,4,10,-6,4
AEK Athens,6582,1,4,2,0,7,1,6,14
PAOK Salonik,6582,2,2,3,1,12,7,5,9
P'thinaikos,6582,3,1,2,3,7,12,-5,5
Panionios,6582,4,1,1,4,4,10,-6,4
AEK Athens,6583,1,4,2,0,7,1,6,14
PAOK Salonik,6583,2,2,2,2,9,6,3,8
P'thinaikos,6583,3,2,1,3,6,9,-3,7
Panionios,6583,4,1,1,4,4,10,-6,4
AEK Athens,6584,1,4,2,0,7,1,6,14
PAOK Salonik,6584,2,2,3,1,9,4,5,9
P'thinaikos,6584,3,1,2,3,4,9,-5,5
Panionios,6584,4,1,1,4,4,10,-6,4
AEK Athens,6585,1,4,2,0,7,1,6,14
PAOK Salonik,6585,2,2,2,2,10,6,4,8
P'thinaikos,6585,3,2,1,3,6,10,-4,7
Panionios,6585,4,1,1,4,4,10,-6,4
AEK Athens,6586,1,4,2,0,7,1,6,14
PAOK Salonik,6586,2,3,2,1,11,5,6,11
P'thinaikos,6586,3,1,1,4,5,11,-6,4
Panionios,6586,4,1,1,4,4,10,-6,4
AEK Athens,6587,1,4,2,0,7,1,6,14
PAOK Salonik,6587,2,2,3,1,10,5,5,9
P'thinaikos,6587,3,1,2,3,5,10,-5,5
Panionios,6587,4,1,1,4,4,10,-6,4
AEK Athens,6588,1,4,2,0,7,1,6,14
PAOK Salonik,6588,2,3,2,1,10,4,6,11
P'thinaikos,6588,3,1,1,4,4,10,-6,4
Panionios,6588,3,1,1,4,4,10,-6,4
AEK Athens,6589,1,4,2,0,7,1,6,14
PAOK Salonik,6589,2,3,2,1,12,5,7,11
Panionios,6589,3,1,1,4,4,10,-6,4
P'thinaikos,6589,4,1,1,4,5,12,-7,4
AEK Athens,6590,1,4,2,0,7,1,6,14
PAOK Salonik,6590,2,2,2,2,9,6,3,8
P'thinaikos,6590,3,2,1,3,6,9,-3,7
Panionios,6590,4,1,1,4,4,10,-6,4
AEK Athens,6591,1,4,2,0,7,1,6,14
PAOK Salonik,6591,2,2,3,1,11,6,5,9
P'thinaikos,6591,3,1,2,3,6,11,-5,5
Panionios,6591,4,1,1,4,4,10,-6,4
AEK Athens,6592,1,4,2,0,7,1,6,14
PAOK Salonik,6592,2,2,2,2,9,5,4,8
P'thinaikos,6592,3,2,1,3,5,9,-4,7
Panionios,6592,4,1,1,4,4,10,-6,4
AEK Athens,6593,1,4,2,0,7,1,6,14
PAOK Salonik,6593,2,2,2,2,10,7,3,8
P'thinaikos,6593,3,2,1,3,7,10,-3,7
Panionios,6593,4,1,1,4,4,10,-6,4
AEK Athens,6594,1,4,2,0,7,1,6,14
PAOK Salonik,6594,2,2,2,2,9,6,3,8
P'thinaikos,6594,3,2,1,3,6,9,-3,7
Panionios,6594,4,1,1,4,4,10,-6,4
AEK Athens,6595,1,4,2,0,7,1,6,14
PAOK Salonik,6595,2,2,2,2,9,5,4,8
P'thinaikos,6595,3,2,1,3,5,9,-4,7
Panionios,6595,4,1,1,4,4,10,-6,4
AEK Athens,6596,1,4,2,0,7,1,6,14
PAOK Salonik,6596,2,2,3,1,10,5,5,9
P'thinaikos,6596,3,1,2,3,5,10,-5,5
Panionios,6596,4,1,1,4,4,10,-6,4
AEK Athens,6597,1,4,2,0,7,1,6,14
PAOK Salonik,6597,2,3,2,1,13,4,9,11
Panionios,6597,3,1,1,4,4,10,-6,4
P'thinaikos,6597,4,1,1,4,4,13,-9,4
AEK Athens,6598,1,4,2,0,7,1,6,14
PAOK Salonik,6598,2,3,2,1,12,5,7,11
Panionios,6598,3,1,1,4,4,10,-6,4
P'thinaikos,6598,4,1,1,4,5,12,-7,4
AEK Athens,6599,1,4,2,0,7,1,6,14
PAOK Salonik,6599,2,2,3,1,11,6,5,9
P'thinaikos,6599,3,1,2,3,6,11,-5,5
Panionios,6599,4,1,1,4,4,10,-6,4
AEK Athens,6600,1,4,2,0,7,1,6,14
PAOK Salonik,6600,2,3,2,1,14,6,8,11
Panionios,6600,3,1,1,4,4,10,-6,4
P'thinaikos,6600,4,1,1,4,6,14,-8,4
AEK Athens,6601,1,4,2,0,7,1,6,14
PAOK Salonik,6601,2,2,2,2,10,6,4,8
P'thinaikos,6601,3,2,1,3,6,10,-4,7
Panionios,6601,4,1,1,4,4,10,-6,4
AEK Athens,6602,1,4,2,0,7,1,6,14
PAOK Salonik,6602,2,3,2,1,11,5,6,11
P'thinaikos,6602,3,1,1,4,5,11,-6,4
Panionios,6602,4,1,1,4,4,10,-6,4
AEK Athens,6603,1,4,2,0,7,1,6,14
PAOK Salonik,6603,2,2,3,1,9,4,5,9
P'thinaikos,6603,3,1,2,3,4,9,-5,5
Panionios,6603,4,1,1,4,4,10,-6,4
AEK Athens,6604,1,4,2,0,7,1,6,14
PAOK Salonik,6604,2,3,2,1,12,5,7,11
Panionios,6604,3,1,1,4,4,10,-6,4
P'thinaikos,6604,4,1,1,4,5,12,-7,4
AEK Athens,6605,1,4,2,0,7,1,6,14
PAOK Salonik,6605,2,2,2,2,9,8,1,8
P'thinaikos,6605,3,2,1,3,8,9,-1,7
Panionios,6605,4,1,1,4,4,10,-6,4
AEK Athens,6606,1,4,2,0,7,1,6,14
PAOK Salonik,6606,2,2,2,2,10,6,4,8
P'thinaikos,6606,3,2,1,3,6,10,-4,7
Panionios,6606,4,1,1,4,4,10,-6,4
AEK Athens,6607,1,4,2,0,7,1,6,14
PAOK Salonik,6607,2,2,2,2,10,6,4,8
P'thinaikos,6607,3,2,1,3,6,10,-4,7
Panionios,6607,4,1,1,4,4,10,-6,4
AEK Athens,6608,1,4,2,0,7,1,6,14
PAOK Salonik,6608,2,3,2,1,12,5,7,11
Panionios,6608,3,1,1,4,4,10,-6,4
P'thinaikos,6608,4,1,1,4,5,12,-7,4
AEK Athens,6609,1,4,2,0,7,1,6,14
PAOK Salonik,6609,2,2,2,2,11,7,4,8
P'thinaikos,6609,3,2,1,3,7,11,-4,7
Panionios,6609,4,1,1,4,4,10,-6,4
AEK Athens,6610,1,4,2,0,7,1,6,14
PAOK Salonik,6610,2,3,2,1,11,4,7,11
Panionios,6610,3,1,1,4,4,10,-6,4
P'thinaikos,6610,4,1,1,4,4,11,-7,4
AEK Athens,6611,1,4,2,0,7,1,6,14
PAOK Salonik,6611,2,3,2,1,11,5,6,11
P'thinaikos,6611,3,1,1,4,5,11,-6,4
Panionios,6611,4,1,1,4,4,10,-6,4
AEK Athens,6612,1,4,2,0,7,1,6,14
PAOK Salonik,6612,2,3,2,1,14,4,10,11
Panionios,6612,3,1,1,4,4,10,-6,4
P'thinaikos,6612,4,1,1,4,4,14,-10,4
AEK Athens,6613,1,4,2,0,7,1,6,14
PAOK Salonik,6613,2,3,2,1,10,4,6,11
P'thinaikos,6613,3,1,1,4,4,10,-6,4
Panionios,6613,3,1,1,4,4,10,-6,4
AEK Athens,6614,1,4,2,0,7,1,6,14
PAOK Salonik,6614,2,2,2,2,9,6,3,8
P'thinaikos,6614,3,2,1,3,6,9,-3,7
Panionios,6614,4,1,1,4,4,10,-6,4
AEK Athens,6615,1,4,2,0,7,1,6,14
PAOK Salonik,6615,2,3,2,1,11,5,6,11
P'thinaikos,6615,3,1,1,4,5,11,-6,4
Panionios,6615,4,1,1,4,4,10,-6,4
AEK Athens,6616,1,4,2,0,7,1,6,14
PAOK Salonik,6616,2,3,2,1,11,5,6,11
P'thinaikos,6616,3,1,1,4,5,11,-6,4
Panionios,6616,4,1,1,4,4,10,-6,4
AEK Athens,6617,1,4,2,0,7,1,6,14
PAOK Salonik,6617,2,3,2,1,10,4,6,11
P'thinaikos,6617,3,1,1,4,4,10,-6,4
Panionios,6617,3,1,1,4,4,10,-6,4
AEK Athens,6618,1,4,2,0,7,1,6,14
PAOK Salonik,6618,2,3,2,1,10,4,6,11
P'thinaikos,6618,3,1,1,4,4,10,-6,4
Panionios,6618,3,1,1,4,4,10,-6,4
AEK Athens,6619,1,4,2,0,7,1,6,14
PAOK Salonik,6619,2,2,2,2,9,8,1,8
P'thinaikos,6619,3,2,1,3,8,9,-1,7
Panionios,6619,4,1,1,4,4,10,-6,4
AEK Athens,6620,1,4,2,0,7,1,6,14
PAOK Salonik,6620,2,2,3,1,10,5,5,9
P'thinaikos,6620,3,1,2,3,5,10,-5,5
Panionios,6620,4,1,1,4,4,10,-6,4
AEK Athens,6621,1,4,2,0,7,1,6,14
PAOK Salonik,6621,2,2,2,2,9,6,3,8
P'thinaikos,6621,3,2,1,3,6,9,-3,7
Panionios,6621,4,1,1,4,4,10,-6,4
AEK Athens,6622,1,4,2,0,7,1,6,14
PAOK Salonik,6622,2,2,2,2,10,6,4,8
P'thinaikos,6622,3,2,1,3,6,10,-4,7
Panionios,6622,4,1,1,4,4,10,-6,4
AEK Athens,6623,1,4,2,0,7,1,6,14
PAOK Salonik,6623,2,2,3,1,10,5,5,9
P'thinaikos,6623,3,1,2,3,5,10,-5,5
Panionios,6623,4,1,1,4,4,10,-6,4
AEK Athens,6624,1,4,2,0,7,1,6,14
PAOK Salonik,6624,2,2,2,2,9,8,1,8
P'thinaikos,6624,3,2,1,3,8,9,-1,7
Panionios,6624,4,1,1,4,4,10,-6,4
AEK Athens,6625,1,4,2,0,7,1,6,14
PAOK Salonik,6625,2,3,2,1,11,4,7,11
Panionios,6625,3,1,1,4,4,10,-6,4
P'thinaikos,6625,4,1,1,4,4,11,-7,4
AEK Athens,6626,1,4,2,0,7,1,6,14
PAOK Salonik,6626,2,3,2,1,12,5,7,11
Panionios,6626,3,1,1,4,4,10,-6,4
P'thinaikos,6626,4,1,1,4,5,12,-7,4
AEK Athens,6627,1,4,2,0,7,1,6,14
PAOK Salonik,6627,2,2,3,1,10,5,5,9
P'thinaikos,6627,3,1,2,3,5,10,-5,5
Panionios,6627,4,1,1,4,4,10,-6,4
AEK Athens,6628,1,4,2,0,7,1,6,14
PAOK Salonik,6628,2,2,3,1,10,5,5,9
P'thinaikos,6628,3,1,2,3,5,10,-5,5
Panionios,6628,4,1,1,4,4,10,-6,4
AEK Athens,6629,1,4,2,0,7,1,6,14
PAOK Salonik,6629,2,3,2,1,11,5,6,11
P'thinaikos,6629,3,1,1,4,5,11,-6,4
Panionios,6629,4,1,1,4,4,10,-6,4
AEK Athens,6630,1,4,2,0,7,1,6,14
PAOK Salonik,6630,2,2,2,2,9,5,4,8
P'thinaikos,6630,3,2,1,3,5,9,-4,7
Panionios,6630,4,1,1,4,4,10,-6,4
AEK Athens,6631,1,4,2,0,7,1,6,14
PAOK Salonik,6631,2,3,2,1,11,4,7,11
Panionios,6631,3,1,1,4,4,10,-6,4
P'thinaikos,6631,4,1,1,4,4,11,-7,4
AEK Athens,6632,1,4,2,0,7,1,6,14
PAOK Salonik,6632,2,3,2,1,13,4,9,11
Panionios,6632,3,1,1,4,4,10,-6,4
P'thinaikos,6632,4,1,1,4,4,13,-9,4
AEK Athens,6633,1,4,2,0,7,1,6,14
PAOK Salonik,6633,2,3,2,1,10,4,6,11
P'thinaikos,6633,3,1,1,4,4,10,-6,4
Panionios,6633,3,1,1,4,4,10,-6,4
AEK Athens,6634,1,4,2,0,7,1,6,14
PAOK Salonik,6634,2,2,2,2,9,5,4,8
P'thinaikos,6634,3,2,1,3,5,9,-4,7
Panionios,6634,4,1,1,4,4,10,-6,4
AEK Athens,6635,1,4,2,0,7,1,6,14
PAOK Salonik,6635,2,3,2,1,10,4,6,11
P'thinaikos,6635,3,1,1,4,4,10,-6,4
Panionios,6635,3,1,1,4,4,10,-6,4
AEK Athens,6636,1,4,2,0,7,1,6,14
PAOK Salonik,6636,2,2,2,2,10,6,4,8
P'thinaikos,6636,3,2,1,3,6,10,-4,7
Panionios,6636,4,1,1,4,4,10,-6,4
AEK Athens,6637,1,4,2,0,7,1,6,14
PAOK Salonik,6637,2,3,2,1,10,4,6,11
P'thinaikos,6637,3,1,1,4,4,10,-6,4
Panionios,6637,3,1,1,4,4,10,-6,4
AEK Athens,6638,1,4,2,0,7,1,6,14
PAOK Salonik,6638,2,3,2,1,13,5,8,11
Panionios,6638,3,1,1,4,4,10,-6,4
P'thinaikos,6638,4,1,1,4,5,13,-8,4
AEK Athens,6639,1,4,2,0,7,1,6,14
PAOK Salonik,6639,2,2,2,2,9,6,3,8
P'thinaikos,6639,3,2,1,3,6,9,-3,7
Panionios,6639,4,1,1,4,4,10,-6,4
AEK Athens,6640,1,4,2,0,7,1,6,14
PAOK Salonik,6640,2,2,2,2,10,6,4,8
P'thinaikos,6640,3,2,1,3,6,10,-4,7
Panionios,6640,4,1,1,4,4,10,-6,4
AEK Athens,6641,1,4,2,0,7,1,6,14
PAOK Salonik,6641,2,3,2,1,10,4,6,11
P'thinaikos,6641,3,1,1,4,4,10,-6,4
Panionios,6641,3,1,1,4,4,10,-6,4
AEK Athens,6642,1,4,2,0,7,1,6,14
PAOK Salonik,6642,2,2,3,1,10,5,5,9
P'thinaikos,6642,3,1,2,3,5,10,-5,5
Panionios,6642,4,1,1,4,4,10,-6,4
AEK Athens,6643,1,4,2,0,7,1,6,14
PAOK Salonik,6643,2,2,2,2,9,9,0,8
P'thinaikos,6643,3,2,1,3,9,9,0,7
Panionios,6643,4,1,1,4,4,10,-6,4
AEK Athens,6644,1,4,2,0,7,1,6,14
PAOK Salonik,6644,2,3,2,1,11,5,6,11
P'thinaikos,6644,3,1,1,4,5,11,-6,4
Panionios,6644,4,1,1,4,4,10,-6,4
AEK Athens,6645,1,4,2,0,7,1,6,14
PAOK Salonik,6645,2,3,2,1,11,5,6,11
P'thinaikos,6645,3,1,1,4,5,11,-6,4
Panionios,6645,4,1,1,4,4,10,-6,4
AEK Athens,6646,1,4,2,0,7,1,6,14
PAOK Salonik,6646,2,3,2,1,13,5,8,11
Panionios,6646,3,1,1,4,4,10,-6,4
P'thinaikos,6646,4,1,1,4,5,13,-8,4
AEK Athens,6647,1,4,2,0,7,1,6,14
PAOK Salonik,6647,2,2,2,2,9,5,4,8
P'thinaikos,6647,3,2,1,3,5,9,-4,7
Panionios,6647,4,1,1,4,4,10,-6,4
AEK Athens,6648,1,4,2,0,7,1,6,14
PAOK Salonik,6648,2,3,2,1,10,4,6,11
P'thinaikos,6648,3,1,1,4,4,10,-6,4
Panionios,6648,3,1,1,4,4,10,-6,4
AEK Athens,6649,1,4,2,0,7,1,6,14
PAOK Salonik,6649,2,2,2,2,9,6,3,8
P'thinaikos,6649,3,2,1,3,6,9,-3,7
Panionios,6649,4,1,1,4,4,10,-6,4
AEK Athens,6650,1,4,2,0,7,1,6,14
PAOK Salonik,6650,2,3,2,1,11,5,6,11
P'thinaikos,6650,3,1,1,4,5,11,-6,4
Panionios,6650,4,1,1,4,4,10,-6,4
AEK Athens,6651,1,4,2,0,7,1,6,14
PAOK Salonik,6651,2,3,2,1,11,4,7,11
Panionios,6651,3,1,1,4,4,10,-6,4
P'thinaikos,6651,4,1,1,4,4,11,-7,4
AEK Athens,6652,1,4,2,0,7,1,6,14
PAOK Salonik,6652,2,3,2,1,12,5,7,11
Panionios,6652,3,1,1,4,4,10,-6,4
P'thinaikos,6652,4,1,1,4,5,12,-7,4
AEK Athens,6653,1,4,2,0,7,1,6,14
PAOK Salonik,6653,2,2,2,2,10,6,4,8
P'thinaikos,6653,3,2,1,3,6,10,-4,7
Panionios,6653,4,1,1,4,4,10,-6,4
AEK Athens,6654,1,4,2,0,7,1,6,14
PAOK Salonik,6654,2,3,2,1,14,6,8,11
Panionios,6654,3,1,1,4,4,10,-6,4
P'thinaikos,6654,4,1,1,4,6,14,-8,4
AEK Athens,6655,1,4,2,0,7,1,6,14
PAOK Salonik,6655,2,2,3,1,10,5,5,9
P'thinaikos,6655,3,1,2,3,5,10,-5,5
Panionios,6655,4,1,1,4,4,10,-6,4
AEK Athens,6656,1,4,2,0,7,1,6,14
PAOK Salonik,6656,2,2,3,1,10,5,5,9
P'thinaikos,6656,3,1,2,3,5,10,-5,5
Panionios,6656,4,1,1,4,4,10,-6,4
AEK Athens,6657,1,4,2,0,7,1,6,14
PAOK Salonik,6657,2,2,3,1,10,5,5,9
P'thinaikos,6657,3,1,2,3,5,10,-5,5
Panionios,6657,4,1,1,4,4,10,-6,4
AEK Athens,6658,1,4,2,0,7,1,6,14
PAOK Salonik,6658,2,3,2,1,10,4,6,11
P'thinaikos,6658,3,1,1,4,4,10,-6,4
Panionios,6658,3,1,1,4,4,10,-6,4
AEK Athens,6659,1,4,2,0,7,1,6,14
PAOK Salonik,6659,2,3,2,1,12,4,8,11
Panionios,6659,3,1,1,4,4,10,-6,4
P'thinaikos,6659,4,1,1,4,4,12,-8,4
AEK Athens,6660,1,4,2,0,7,1,6,14
PAOK Salonik,6660,2,2,3,1,10,5,5,9
P'thinaikos,6660,3,1,2,3,5,10,-5,5
Panionios,6660,4,1,1,4,4,10,-6,4
AEK Athens,6661,1,4,2,0,7,1,6,14
PAOK Salonik,6661,2,2,2,2,9,6,3,8
P'thinaikos,6661,3,2,1,3,6,9,-3,7
Panionios,6661,4,1,1,4,4,10,-6,4
AEK Athens,6662,1,4,2,0,7,1,6,14
PAOK Salonik,6662,2,2,3,1,9,4,5,9
P'thinaikos,6662,3,1,2,3,4,9,-5,5
Panionios,6662,4,1,1,4,4,10,-6,4
AEK Athens,6663,1,4,2,0,7,1,6,14
PAOK Salonik,6663,2,3,2,1,12,4,8,11
Panionios,6663,3,1,1,4,4,10,-6,4
P'thinaikos,6663,4,1,1,4,4,12,-8,4
AEK Athens,6664,1,4,2,0,7,1,6,14
PAOK Salonik,6664,2,2,2,2,9,5,4,8
P'thinaikos,6664,3,2,1,3,5,9,-4,7
Panionios,6664,4,1,1,4,4,10,-6,4
AEK Athens,6665,1,4,2,0,7,1,6,14
PAOK Salonik,6665,2,2,2,2,9,5,4,8
P'thinaikos,6665,3,2,1,3,5,9,-4,7
Panionios,6665,4,1,1,4,4,10,-6,4
AEK Athens,6666,1,4,2,0,7,1,6,14
PAOK Salonik,6666,2,2,2,2,9,5,4,8
P'thinaikos,6666,3,2,1,3,5,9,-4,7
Panionios,6666,4,1,1,4,4,10,-6,4
AEK Athens,6667,1,4,2,0,7,1,6,14
PAOK Salonik,6667,2,3,2,1,10,4,6,11
P'thinaikos,6667,3,1,1,4,4,10,-6,4
Panionios,6667,3,1,1,4,4,10,-6,4
AEK Athens,6668,1,4,2,0,7,1,6,14
PAOK Salonik,6668,2,2,3,1,9,4,5,9
P'thinaikos,6668,3,1,2,3,4,9,-5,5
Panionios,6668,4,1,1,4,4,10,-6,4
AEK Athens,6669,1,4,2,0,7,1,6,14
PAOK Salonik,6669,2,2,2,2,10,6,4,8
P'thinaikos,6669,3,2,1,3,6,10,-4,7
Panionios,6669,4,1,1,4,4,10,-6,4
AEK Athens,6670,1,4,2,0,7,1,6,14
PAOK Salonik,6670,2,2,3,1,9,4,5,9
P'thinaikos,6670,3,1,2,3,4,9,-5,5
Panionios,6670,4,1,1,4,4,10,-6,4
AEK Athens,6671,1,4,2,0,7,1,6,14
PAOK Salonik,6671,2,2,3,1,10,5,5,9
P'thinaikos,6671,3,1,2,3,5,10,-5,5
Panionios,6671,4,1,1,4,4,10,-6,4
AEK Athens,6672,1,4,2,0,7,1,6,14
PAOK Salonik,6672,2,3,2,1,11,5,6,11
P'thinaikos,6672,3,1,1,4,5,11,-6,4
Panionios,6672,4,1,1,4,4,10,-6,4
AEK Athens,6673,1,4,2,0,7,1,6,14
PAOK Salonik,6673,2,3,2,1,13,6,7,11
Panionios,6673,3,1,1,4,4,10,-6,4
P'thinaikos,6673,4,1,1,4,6,13,-7,4
AEK Athens,6674,1,4,2,0,7,1,6,14
PAOK Salonik,6674,2,3,2,1,10,4,6,11
P'thinaikos,6674,3,1,1,4,4,10,-6,4
Panionios,6674,3,1,1,4,4,10,-6,4
AEK Athens,6675,1,4,2,0,7,1,6,14
PAOK Salonik,6675,2,2,3,1,9,4,5,9
P'thinaikos,6675,3,1,2,3,4,9,-5,5
Panionios,6675,4,1,1,4,4,10,-6,4
AEK Athens,6676,1,4,2,0,7,1,6,14
PAOK Salonik,6676,2,2,2,2,10,6,4,8
P'thinaikos,6676,3,2,1,3,6,10,-4,7
Panionios,6676,4,1,1,4,4,10,-6,4
AEK Athens,6677,1,4,2,0,7,1,6,14
PAOK Salonik,6677,2,3,2,1,11,4,7,11
Panionios,6677,3,1,1,4,4,10,-6,4
P'thinaikos,6677,4,1,1,4,4,11,-7,4
AEK Athens,6678,1,4,2,0,7,1,6,14
PAOK Salonik,6678,2,3,2,1,10,4,6,11
P'thinaikos,6678,3,1,1,4,4,10,-6,4
Panionios,6678,3,1,1,4,4,10,-6,4
AEK Athens,6679,1,4,2,0,7,1,6,14
PAOK Salonik,6679,2,2,2,2,9,5,4,8
P'thinaikos,6679,3,2,1,3,5,9,-4,7
Panionios,6679,4,1,1,4,4,10,-6,4
AEK Athens,6680,1,4,2,0,7,1,6,14
PAOK Salonik,6680,2,3,2,1,12,4,8,11
Panionios,6680,3,1,1,4,4,10,-6,4
P'thinaikos,6680,4,1,1,4,4,12,-8,4
AEK Athens,6681,1,4,2,0,7,1,6,14
PAOK Salonik,6681,2,2,3,1,10,5,5,9
P'thinaikos,6681,3,1,2,3,5,10,-5,5
Panionios,6681,4,1,1,4,4,10,-6,4
AEK Athens,6682,1,4,2,0,7,1,6,14
PAOK Salonik,6682,2,2,2,2,9,6,3,8
P'thinaikos,6682,3,2,1,3,6,9,-3,7
Panionios,6682,4,1,1,4,4,10,-6,4
AEK Athens,6683,1,4,2,0,7,1,6,14
PAOK Salonik,6683,2,3,2,1,11,5,6,11
P'thinaikos,6683,3,1,1,4,5,11,-6,4
Panionios,6683,4,1,1,4,4,10,-6,4
AEK Athens,6684,1,4,2,0,7,1,6,14
PAOK Salonik,6684,2,2,3,1,11,6,5,9
P'thinaikos,6684,3,1,2,3,6,11,-5,5
Panionios,6684,4,1,1,4,4,10,-6,4
AEK Athens,6685,1,4,2,0,7,1,6,14
PAOK Salonik,6685,2,2,3,1,10,5,5,9
P'thinaikos,6685,3,1,2,3,5,10,-5,5
Panionios,6685,4,1,1,4,4,10,-6,4
AEK Athens,6686,1,4,2,0,7,1,6,14
PAOK Salonik,6686,2,3,2,1,11,5,6,11
P'thinaikos,6686,3,1,1,4,5,11,-6,4
Panionios,6686,4,1,1,4,4,10,-6,4
AEK Athens,6687,1,4,2,0,7,1,6,14
PAOK Salonik,6687,2,2,3,1,10,5,5,9
P'thinaikos,6687,3,1,2,3,5,10,-5,5
Panionios,6687,4,1,1,4,4,10,-6,4
AEK Athens,6688,1,4,2,0,7,1,6,14
PAOK Salonik,6688,2,2,3,1,14,9,5,9
P'thinaikos,6688,3,1,2,3,9,14,-5,5
Panionios,6688,4,1,1,4,4,10,-6,4
AEK Athens,6689,1,4,2,0,7,1,6,14
PAOK Salonik,6689,2,3,2,1,11,5,6,11
P'thinaikos,6689,3,1,1,4,5,11,-6,4
Panionios,6689,4,1,1,4,4,10,-6,4
AEK Athens,6690,1,4,2,0,7,1,6,14
PAOK Salonik,6690,2,2,2,2,9,5,4,8
P'thinaikos,6690,3,2,1,3,5,9,-4,7
Panionios,6690,4,1,1,4,4,10,-6,4
AEK Athens,6691,1,4,2,0,7,1,6,14
PAOK Salonik,6691,2,3,2,1,11,5,6,11
P'thinaikos,6691,3,1,1,4,5,11,-6,4
Panionios,6691,4,1,1,4,4,10,-6,4
AEK Athens,6692,1,4,2,0,7,1,6,14
PAOK Salonik,6692,2,2,2,2,9,5,4,8
P'thinaikos,6692,3,2,1,3,5,9,-4,7
Panionios,6692,4,1,1,4,4,10,-6,4
AEK Athens,6693,1,4,2,0,7,1,6,14
PAOK Salonik,6693,2,3,2,1,10,4,6,11
P'thinaikos,6693,3,1,1,4,4,10,-6,4
Panionios,6693,3,1,1,4,4,10,-6,4
AEK Athens,6694,1,4,2,0,7,1,6,14
PAOK Salonik,6694,2,2,3,1,9,4,5,9
P'thinaikos,6694,3,1,2,3,4,9,-5,5
Panionios,6694,4,1,1,4,4,10,-6,4
AEK Athens,6695,1,4,2,0,7,1,6,14
PAOK Salonik,6695,2,2,2,2,9,6,3,8
P'thinaikos,6695,3,2,1,3,6,9,-3,7
Panionios,6695,4,1,1,4,4,10,-6,4
AEK Athens,6696,1,4,2,0,7,1,6,14
PAOK Salonik,6696,2,2,2,2,10,6,4,8
P'thinaikos,6696,3,2,1,3,6,10,-4,7
Panionios,6696,4,1,1,4,4,10,-6,4
AEK Athens,6697,1,4,2,0,7,1,6,14
PAOK Salonik,6697,2,2,2,2,11,7,4,8
P'thinaikos,6697,3,2,1,3,7,11,-4,7
Panionios,6697,4,1,1,4,4,10,-6,4
AEK Athens,6698,1,4,2,0,7,1,6,14
PAOK Salonik,6698,2,3,2,1,11,4,7,11
Panionios,6698,3,1,1,4,4,10,-6,4
P'thinaikos,6698,4,1,1,4,4,11,-7,4
AEK Athens,6699,1,4,2,0,7,1,6,14
PAOK Salonik,6699,2,2,3,1,11,6,5,9
P'thinaikos,6699,3,1,2,3,6,11,-5,5
Panionios,6699,4,1,1,4,4,10,-6,4
AEK Athens,6700,1,4,2,0,7,1,6,14
PAOK Salonik,6700,2,3,2,1,11,4,7,11
Panionios,6700,3,1,1,4,4,10,-6,4
P'thinaikos,6700,4,1,1,4,4,11,-7,4
AEK Athens,6701,1,4,2,0,7,1,6,14
PAOK Salonik,6701,2,3,2,1,10,4,6,11
P'thinaikos,6701,3,1,1,4,4,10,-6,4
Panionios,6701,3,1,1,4,4,10,-6,4
AEK Athens,6702,1,4,2,0,7,1,6,14
PAOK Salonik,6702,2,2,3,1,11,6,5,9
P'thinaikos,6702,3,1,2,3,6,11,-5,5
Panionios,6702,4,1,1,4,4,10,-6,4
AEK Athens,6703,1,4,2,0,7,1,6,14
PAOK Salonik,6703,2,2,3,1,10,5,5,9
P'thinaikos,6703,3,1,2,3,5,10,-5,5
Panionios,6703,4,1,1,4,4,10,-6,4
AEK Athens,6704,1,4,2,0,7,1,6,14
PAOK Salonik,6704,2,2,3,1,10,5,5,9
P'thinaikos,6704,3,1,2,3,5,10,-5,5
Panionios,6704,4,1,1,4,4,10,-6,4
AEK Athens,6705,1,4,2,0,7,1,6,14
PAOK Salonik,6705,2,2,3,1,11,6,5,9
P'thinaikos,6705,3,1,2,3,6,11,-5,5
Panionios,6705,4,1,1,4,4,10,-6,4
AEK Athens,6706,1,4,2,0,7,1,6,14
PAOK Salonik,6706,2,2,2,2,9,6,3,8
P'thinaikos,6706,3,2,1,3,6,9,-3,7
Panionios,6706,4,1,1,4,4,10,-6,4
AEK Athens,6707,1,4,2,0,7,1,6,14
PAOK Salonik,6707,2,2,3,1,11,6,5,9
P'thinaikos,6707,3,1,2,3,6,11,-5,5
Panionios,6707,4,1,1,4,4,10,-6,4
AEK Athens,6708,1,4,2,0,7,1,6,14
PAOK Salonik,6708,2,3,2,1,10,4,6,11
P'thinaikos,6708,3,1,1,4,4,10,-6,4
Panionios,6708,3,1,1,4,4,10,-6,4
AEK Athens,6709,1,4,2,0,7,1,6,14
PAOK Salonik,6709,2,3,2,1,11,5,6,11
P'thinaikos,6709,3,1,1,4,5,11,-6,4
Panionios,6709,4,1,1,4,4,10,-6,4
AEK Athens,6710,1,4,2,0,7,1,6,14
PAOK Salonik,6710,2,2,2,2,9,5,4,8
P'thinaikos,6710,3,2,1,3,5,9,-4,7
Panionios,6710,4,1,1,4,4,10,-6,4
AEK Athens,6711,1,4,2,0,7,1,6,14
PAOK Salonik,6711,2,3,2,1,10,4,6,11
P'thinaikos,6711,3,1,1,4,4,10,-6,4
Panionios,6711,3,1,1,4,4,10,-6,4
AEK Athens,6712,1,4,2,0,7,1,6,14
PAOK Salonik,6712,2,2,3,1,10,5,5,9
P'thinaikos,6712,3,1,2,3,5,10,-5,5
Panionios,6712,4,1,1,4,4,10,-6,4
AEK Athens,6713,1,4,2,0,7,1,6,14
PAOK Salonik,6713,2,3,2,1,11,5,6,11
P'thinaikos,6713,3,1,1,4,5,11,-6,4
Panionios,6713,4,1,1,4,4,10,-6,4
AEK Athens,6714,1,4,2,0,7,1,6,14
PAOK Salonik,6714,2,2,2,2,9,6,3,8
P'thinaikos,6714,3,2,1,3,6,9,-3,7
Panionios,6714,4,1,1,4,4,10,-6,4
AEK Athens,6715,1,4,2,0,7,1,6,14
PAOK Salonik,6715,2,3,2,1,10,4,6,11
P'thinaikos,6715,3,1,1,4,4,10,-6,4
Panionios,6715,3,1,1,4,4,10,-6,4
AEK Athens,6716,1,4,2,0,7,1,6,14
PAOK Salonik,6716,2,2,2,2,10,6,4,8
P'thinaikos,6716,3,2,1,3,6,10,-4,7
Panionios,6716,4,1,1,4,4,10,-6,4
AEK Athens,6717,1,4,2,0,7,1,6,14
PAOK Salonik,6717,2,2,3,1,12,7,5,9
P'thinaikos,6717,3,1,2,3,7,12,-5,5
Panionios,6717,4,1,1,4,4,10,-6,4
AEK Athens,6718,1,4,2,0,7,1,6,14
PAOK Salonik,6718,2,3,2,1,11,5,6,11
P'thinaikos,6718,3,1,1,4,5,11,-6,4
Panionios,6718,4,1,1,4,4,10,-6,4
AEK Athens,6719,1,4,2,0,7,1,6,14
PAOK Salonik,6719,2,3,2,1,12,5,7,11
Panionios,6719,3,1,1,4,4,10,-6,4
P'thinaikos,6719,4,1,1,4,5,12,-7,4
AEK Athens,6720,1,4,2,0,7,1,6,14
PAOK Salonik,6720,2,2,3,1,10,5,5,9
P'thinaikos,6720,3,1,2,3,5,10,-5,5
Panionios,6720,4,1,1,4,4,10,-6,4
AEK Athens,6721,1,4,2,0,7,1,6,14
PAOK Salonik,6721,2,3,2,1,11,5,6,11
P'thinaikos,6721,3,1,1,4,5,11,-6,4
Panionios,6721,4,1,1,4,4,10,-6,4
AEK Athens,6722,1,4,2,0,7,1,6,14
PAOK Salonik,6722,2,2,3,1,11,6,5,9
P'thinaikos,6722,3,1,2,3,6,11,-5,5
Panionios,6722,4,1,1,4,4,10,-6,4
AEK Athens,6723,1,4,2,0,7,1,6,14
PAOK Salonik,6723,2,3,2,1,11,5,6,11
P'thinaikos,6723,3,1,1,4,5,11,-6,4
Panionios,6723,4,1,1,4,4,10,-6,4
AEK Athens,6724,1,4,2,0,7,1,6,14
PAOK Salonik,6724,2,2,2,2,10,6,4,8
P'thinaikos,6724,3,2,1,3,6,10,-4,7
Panionios,6724,4,1,1,4,4,10,-6,4
AEK Athens,6725,1,4,2,0,7,1,6,14
PAOK Salonik,6725,2,2,2,2,9,5,4,8
P'thinaikos,6725,3,2,1,3,5,9,-4,7
Panionios,6725,4,1,1,4,4,10,-6,4
AEK Athens,6726,1,4,2,0,7,1,6,14
PAOK Salonik,6726,2,2,3,1,10,5,5,9
P'thinaikos,6726,3,1,2,3,5,10,-5,5
Panionios,6726,4,1,1,4,4,10,-6,4
AEK Athens,6727,1,4,2,0,7,1,6,14
PAOK Salonik,6727,2,2,2,2,9,6,3,8
P'thinaikos,6727,3,2,1,3,6,9,-3,7
Panionios,6727,4,1,1,4,4,10,-6,4
AEK Athens,6728,1,4,2,0,7,1,6,14
PAOK Salonik,6728,2,2,3,1,10,5,5,9
P'thinaikos,6728,3,1,2,3,5,10,-5,5
Panionios,6728,4,1,1,4,4,10,-6,4
AEK Athens,6729,1,4,2,0,7,1,6,14
PAOK Salonik,6729,2,2,3,1,10,5,5,9
P'thinaikos,6729,3,1,2,3,5,10,-5,5
Panionios,6729,4,1,1,4,4,10,-6,4
AEK Athens,6730,1,4,2,0,7,1,6,14
PAOK Salonik,6730,2,2,2,2,9,5,4,8
P'thinaikos,6730,3,2,1,3,5,9,-4,7
Panionios,6730,4,1,1,4,4,10,-6,4
AEK Athens,6731,1,4,2,0,7,1,6,14
PAOK Salonik,6731,2,3,2,1,10,4,6,11
P'thinaikos,6731,3,1,1,4,4,10,-6,4
Panionios,6731,3,1,1,4,4,10,-6,4
AEK Athens,6732,1,4,2,0,7,1,6,14
PAOK Salonik,6732,2,3,2,1,11,4,7,11
Panionios,6732,3,1,1,4,4,10,-6,4
P'thinaikos,6732,4,1,1,4,4,11,-7,4
AEK Athens,6733,1,4,2,0,7,1,6,14
PAOK Salonik,6733,2,2,2,2,9,5,4,8
P'thinaikos,6733,3,2,1,3,5,9,-4,7
Panionios,6733,4,1,1,4,4,10,-6,4
AEK Athens,6734,1,4,2,0,7,1,6,14
PAOK Salonik,6734,2,2,3,1,10,5,5,9
P'thinaikos,6734,3,1,2,3,5,10,-5,5
Panionios,6734,4,1,1,4,4,10,-6,4
AEK Athens,6735,1,4,2,0,7,1,6,14
PAOK Salonik,6735,2,2,2,2,9,5,4,8
P'thinaikos,6735,3,2,1,3,5,9,-4,7
Panionios,6735,4,1,1,4,4,10,-6,4
AEK Athens,6736,1,4,2,0,7,1,6,14
PAOK Salonik,6736,2,3,2,1,10,4,6,11
P'thinaikos,6736,3,1,1,4,4,10,-6,4
Panionios,6736,3,1,1,4,4,10,-6,4
AEK Athens,6737,1,4,2,0,7,1,6,14
PAOK Salonik,6737,2,2,2,2,10,6,4,8
P'thinaikos,6737,3,2,1,3,6,10,-4,7
Panionios,6737,4,1,1,4,4,10,-6,4
AEK Athens,6738,1,4,2,0,7,1,6,14
PAOK Salonik,6738,2,2,3,1,10,5,5,9
P'thinaikos,6738,3,1,2,3,5,10,-5,5
Panionios,6738,4,1,1,4,4,10,-6,4
AEK Athens,6739,1,4,2,0,7,1,6,14
PAOK Salonik,6739,2,2,3,1,10,5,5,9
P'thinaikos,6739,3,1,2,3,5,10,-5,5
Panionios,6739,4,1,1,4,4,10,-6,4
AEK Athens,6740,1,4,2,0,7,1,6,14
PAOK Salonik,6740,2,3,2,1,12,5,7,11
Panionios,6740,3,1,1,4,4,10,-6,4
P'thinaikos,6740,4,1,1,4,5,12,-7,4
AEK Athens,6741,1,4,2,0,7,1,6,14
PAOK Salonik,6741,2,3,2,1,10,4,6,11
P'thinaikos,6741,3,1,1,4,4,10,-6,4
Panionios,6741,3,1,1,4,4,10,-6,4
AEK Athens,6742,1,4,2,0,7,1,6,14
PAOK Salonik,6742,2,2,3,1,9,4,5,9
P'thinaikos,6742,3,1,2,3,4,9,-5,5
Panionios,6742,4,1,1,4,4,10,-6,4
AEK Athens,6743,1,4,2,0,7,1,6,14
PAOK Salonik,6743,2,2,2,2,10,10,0,8
P'thinaikos,6743,3,2,1,3,10,10,0,7
Panionios,6743,4,1,1,4,4,10,-6,4
AEK Athens,6744,1,4,2,0,7,1,6,14
PAOK Salonik,6744,2,2,2,2,9,7,2,8
P'thinaikos,6744,3,2,1,3,7,9,-2,7
Panionios,6744,4,1,1,4,4,10,-6,4
AEK Athens,6745,1,4,2,0,7,1,6,14
PAOK Salonik,6745,2,2,3,1,12,7,5,9
P'thinaikos,6745,3,1,2,3,7,12,-5,5
Panionios,6745,4,1,1,4,4,10,-6,4
AEK Athens,6746,1,4,2,0,7,1,6,14
PAOK Salonik,6746,2,3,2,1,11,5,6,11
P'thinaikos,6746,3,1,1,4,5,11,-6,4
Panionios,6746,4,1,1,4,4,10,-6,4
AEK Athens,6747,1,4,2,0,7,1,6,14
PAOK Salonik,6747,2,3,2,1,12,4,8,11
Panionios,6747,3,1,1,4,4,10,-6,4
P'thinaikos,6747,4,1,1,4,4,12,-8,4
AEK Athens,6748,1,4,2,0,7,1,6,14
PAOK Salonik,6748,2,2,2,2,10,6,4,8
P'thinaikos,6748,3,2,1,3,6,10,-4,7
Panionios,6748,4,1,1,4,4,10,-6,4
AEK Athens,6749,1,4,2,0,7,1,6,14
PAOK Salonik,6749,2,3,2,1,10,4,6,11
P'thinaikos,6749,3,1,1,4,4,10,-6,4
Panionios,6749,3,1,1,4,4,10,-6,4
AEK Athens,6750,1,4,2,0,7,1,6,14
PAOK Salonik,6750,2,3,2,1,12,5,7,11
Panionios,6750,3,1,1,4,4,10,-6,4
P'thinaikos,6750,4,1,1,4,5,12,-7,4
AEK Athens,6751,1,4,2,0,7,1,6,14
PAOK Salonik,6751,2,2,2,2,10,8,2,8
P'thinaikos,6751,3,2,1,3,8,10,-2,7
Panionios,6751,4,1,1,4,4,10,-6,4
AEK Athens,6752,1,4,2,0,7,1,6,14
PAOK Salonik,6752,2,2,2,2,11,9,2,8
P'thinaikos,6752,3,2,1,3,9,11,-2,7
Panionios,6752,4,1,1,4,4,10,-6,4
AEK Athens,6753,1,4,2,0,7,1,6,14
PAOK Salonik,6753,2,3,2,1,11,5,6,11
P'thinaikos,6753,3,1,1,4,5,11,-6,4
Panionios,6753,4,1,1,4,4,10,-6,4
AEK Athens,6754,1,4,2,0,7,1,6,14
PAOK Salonik,6754,2,2,3,1,9,4,5,9
P'thinaikos,6754,3,1,2,3,4,9,-5,5
Panionios,6754,4,1,1,4,4,10,-6,4
AEK Athens,6755,1,4,2,0,7,1,6,14
PAOK Salonik,6755,2,3,2,1,11,4,7,11
Panionios,6755,3,1,1,4,4,10,-6,4
P'thinaikos,6755,4,1,1,4,4,11,-7,4
AEK Athens,6756,1,4,2,0,7,1,6,14
PAOK Salonik,6756,2,2,2,2,9,6,3,8
P'thinaikos,6756,3,2,1,3,6,9,-3,7
Panionios,6756,4,1,1,4,4,10,-6,4
AEK Athens,6757,1,4,2,0,7,1,6,14
PAOK Salonik,6757,2,3,2,1,10,4,6,11
P'thinaikos,6757,3,1,1,4,4,10,-6,4
Panionios,6757,3,1,1,4,4,10,-6,4
AEK Athens,6758,1,4,2,0,7,1,6,14
PAOK Salonik,6758,2,2,2,2,9,6,3,8
P'thinaikos,6758,3,2,1,3,6,9,-3,7
Panionios,6758,4,1,1,4,4,10,-6,4
AEK Athens,6759,1,4,2,0,7,1,6,14
PAOK Salonik,6759,2,2,3,1,9,4,5,9
P'thinaikos,6759,3,1,2,3,4,9,-5,5
Panionios,6759,4,1,1,4,4,10,-6,4
AEK Athens,6760,1,4,2,0,7,1,6,14
PAOK Salonik,6760,2,2,2,2,9,5,4,8
P'thinaikos,6760,3,2,1,3,5,9,-4,7
Panionios,6760,4,1,1,4,4,10,-6,4
AEK Athens,6761,1,4,2,0,7,1,6,14
PAOK Salonik,6761,2,2,3,1,10,5,5,9
P'thinaikos,6761,3,1,2,3,5,10,-5,5
Panionios,6761,4,1,1,4,4,10,-6,4
AEK Athens,6762,1,4,2,0,7,1,6,14
PAOK Salonik,6762,2,2,3,1,10,5,5,9
P'thinaikos,6762,3,1,2,3,5,10,-5,5
Panionios,6762,4,1,1,4,4,10,-6,4
AEK Athens,6763,1,4,2,0,7,1,6,14
PAOK Salonik,6763,2,2,2,2,9,6,3,8
P'thinaikos,6763,3,2,1,3,6,9,-3,7
Panionios,6763,4,1,1,4,4,10,-6,4
AEK Athens,6764,1,4,2,0,7,1,6,14
PAOK Salonik,6764,2,3,2,1,11,5,6,11
P'thinaikos,6764,3,1,1,4,5,11,-6,4
Panionios,6764,4,1,1,4,4,10,-6,4
AEK Athens,6765,1,4,2,0,7,1,6,14
PAOK Salonik,6765,2,2,2,2,9,6,3,8
P'thinaikos,6765,3,2,1,3,6,9,-3,7
Panionios,6765,4,1,1,4,4,10,-6,4
AEK Athens,6766,1,4,2,0,7,1,6,14
PAOK Salonik,6766,2,3,2,1,10,4,6,11
P'thinaikos,6766,3,1,1,4,4,10,-6,4
Panionios,6766,3,1,1,4,4,10,-6,4
AEK Athens,6767,1,4,2,0,7,1,6,14
PAOK Salonik,6767,2,2,3,1,9,4,5,9
P'thinaikos,6767,3,1,2,3,4,9,-5,5
Panionios,6767,4,1,1,4,4,10,-6,4
AEK Athens,6768,1,4,2,0,7,1,6,14
PAOK Salonik,6768,2,2,3,1,9,4,5,9
P'thinaikos,6768,3,1,2,3,4,9,-5,5
Panionios,6768,4,1,1,4,4,10,-6,4
AEK Athens,6769,1,4,2,0,7,1,6,14
PAOK Salonik,6769,2,2,2,2,9,5,4,8
P'thinaikos,6769,3,2,1,3,5,9,-4,7
Panionios,6769,4,1,1,4,4,10,-6,4
AEK Athens,6770,1,4,2,0,7,1,6,14
PAOK Salonik,6770,2,2,2,2,10,6,4,8
P'thinaikos,6770,3,2,1,3,6,10,-4,7
Panionios,6770,4,1,1,4,4,10,-6,4
AEK Athens,6771,1,4,2,0,7,1,6,14
PAOK Salonik,6771,2,3,2,1,11,4,7,11
Panionios,6771,3,1,1,4,4,10,-6,4
P'thinaikos,6771,4,1,1,4,4,11,-7,4
AEK Athens,6772,1,4,2,0,7,1,6,14
PAOK Salonik,6772,2,3,2,1,10,4,6,11
P'thinaikos,6772,3,1,1,4,4,10,-6,4
Panionios,6772,3,1,1,4,4,10,-6,4
AEK Athens,6773,1,4,2,0,7,1,6,14
PAOK Salonik,6773,2,2,2,2,9,6,3,8
P'thinaikos,6773,3,2,1,3,6,9,-3,7
Panionios,6773,4,1,1,4,4,10,-6,4
AEK Athens,6774,1,4,2,0,7,1,6,14
PAOK Salonik,6774,2,2,2,2,9,7,2,8
P'thinaikos,6774,3,2,1,3,7,9,-2,7
Panionios,6774,4,1,1,4,4,10,-6,4
AEK Athens,6775,1,4,2,0,7,1,6,14
PAOK Salonik,6775,2,2,3,1,10,5,5,9
P'thinaikos,6775,3,1,2,3,5,10,-5,5
Panionios,6775,4,1,1,4,4,10,-6,4
AEK Athens,6776,1,4,2,0,7,1,6,14
PAOK Salonik,6776,2,3,2,1,11,5,6,11
P'thinaikos,6776,3,1,1,4,5,11,-6,4
Panionios,6776,4,1,1,4,4,10,-6,4
AEK Athens,6777,1,4,2,0,7,1,6,14
PAOK Salonik,6777,2,3,2,1,11,5,6,11
P'thinaikos,6777,3,1,1,4,5,11,-6,4
Panionios,6777,4,1,1,4,4,10,-6,4
AEK Athens,6778,1,4,2,0,7,1,6,14
PAOK Salonik,6778,2,3,2,1,11,4,7,11
Panionios,6778,3,1,1,4,4,10,-6,4
P'thinaikos,6778,4,1,1,4,4,11,-7,4
AEK Athens,6779,1,4,2,0,7,1,6,14
PAOK Salonik,6779,2,2,2,2,10,6,4,8
P'thinaikos,6779,3,2,1,3,6,10,-4,7
Panionios,6779,4,1,1,4,4,10,-6,4
AEK Athens,6780,1,4,2,0,7,1,6,14
PAOK Salonik,6780,2,2,3,1,11,6,5,9
P'thinaikos,6780,3,1,2,3,6,11,-5,5
Panionios,6780,4,1,1,4,4,10,-6,4
AEK Athens,6781,1,4,2,0,7,1,6,14
PAOK Salonik,6781,2,3,2,1,10,4,6,11
P'thinaikos,6781,3,1,1,4,4,10,-6,4
Panionios,6781,3,1,1,4,4,10,-6,4
AEK Athens,6782,1,4,2,0,7,1,6,14
PAOK Salonik,6782,2,3,2,1,10,4,6,11
P'thinaikos,6782,3,1,1,4,4,10,-6,4
Panionios,6782,3,1,1,4,4,10,-6,4
AEK Athens,6783,1,4,2,0,7,1,6,14
PAOK Salonik,6783,2,2,2,2,11,7,4,8
P'thinaikos,6783,3,2,1,3,7,11,-4,7
Panionios,6783,4,1,1,4,4,10,-6,4
AEK Athens,6784,1,4,2,0,7,1,6,14
PAOK Salonik,6784,2,2,3,1,10,5,5,9
P'thinaikos,6784,3,1,2,3,5,10,-5,5
Panionios,6784,4,1,1,4,4,10,-6,4
AEK Athens,6785,1,4,2,0,7,1,6,14
PAOK Salonik,6785,2,2,3,1,10,5,5,9
P'thinaikos,6785,3,1,2,3,5,10,-5,5
Panionios,6785,4,1,1,4,4,10,-6,4
AEK Athens,6786,1,4,2,0,7,1,6,14
PAOK Salonik,6786,2,2,3,1,11,6,5,9
P'thinaikos,6786,3,1,2,3,6,11,-5,5
Panionios,6786,4,1,1,4,4,10,-6,4
AEK Athens,6787,1,4,2,0,7,1,6,14
PAOK Salonik,6787,2,2,2,2,9,5,4,8
P'thinaikos,6787,3,2,1,3,5,9,-4,7
Panionios,6787,4,1,1,4,4,10,-6,4
AEK Athens,6788,1,4,2,0,7,1,6,14
PAOK Salonik,6788,2,3,2,1,12,5,7,11
Panionios,6788,3,1,1,4,4,10,-6,4
P'thinaikos,6788,4,1,1,4,5,12,-7,4
AEK Athens,6789,1,4,2,0,7,1,6,14
PAOK Salonik,6789,2,2,2,2,9,5,4,8
P'thinaikos,6789,3,2,1,3,5,9,-4,7
Panionios,6789,4,1,1,4,4,10,-6,4
AEK Athens,6790,1,4,2,0,7,1,6,14
PAOK Salonik,6790,2,2,2,2,9,7,2,8
P'thinaikos,6790,3,2,1,3,7,9,-2,7
Panionios,6790,4,1,1,4,4,10,-6,4
AEK Athens,6791,1,4,2,0,7,1,6,14
PAOK Salonik,6791,2,2,2,2,10,7,3,8
P'thinaikos,6791,3,2,1,3,7,10,-3,7
Panionios,6791,4,1,1,4,4,10,-6,4
AEK Athens,6792,1,4,2,0,7,1,6,14
PAOK Salonik,6792,2,2,2,2,10,6,4,8
P'thinaikos,6792,3,2,1,3,6,10,-4,7
Panionios,6792,4,1,1,4,4,10,-6,4
AEK Athens,6793,1,4,2,0,7,1,6,14
PAOK Salonik,6793,2,2,3,1,10,5,5,9
P'thinaikos,6793,3,1,2,3,5,10,-5,5
Panionios,6793,4,1,1,4,4,10,-6,4
AEK Athens,6794,1,4,2,0,7,1,6,14
PAOK Salonik,6794,2,2,2,2,9,8,1,8
P'thinaikos,6794,3,2,1,3,8,9,-1,7
Panionios,6794,4,1,1,4,4,10,-6,4
AEK Athens,6795,1,4,2,0,7,1,6,14
PAOK Salonik,6795,2,2,2,2,11,7,4,8
P'thinaikos,6795,3,2,1,3,7,11,-4,7
Panionios,6795,4,1,1,4,4,10,-6,4
AEK Athens,6796,1,4,2,0,7,1,6,14
PAOK Salonik,6796,2,2,3,1,9,4,5,9
P'thinaikos,6796,3,1,2,3,4,9,-5,5
Panionios,6796,4,1,1,4,4,10,-6,4
AEK Athens,6797,1,4,2,0,7,1,6,14
PAOK Salonik,6797,2,2,3,1,10,5,5,9
P'thinaikos,6797,3,1,2,3,5,10,-5,5
Panionios,6797,4,1,1,4,4,10,-6,4
AEK Athens,6798,1,4,2,0,7,1,6,14
PAOK Salonik,6798,2,2,2,2,10,6,4,8
P'thinaikos,6798,3,2,1,3,6,10,-4,7
Panionios,6798,4,1,1,4,4,10,-6,4
AEK Athens,6799,1,4,2,0,7,1,6,14
PAOK Salonik,6799,2,3,2,1,10,4,6,11
P'thinaikos,6799,3,1,1,4,4,10,-6,4
Panionios,6799,3,1,1,4,4,10,-6,4
AEK Athens,6800,1,4,2,0,7,1,6,14
PAOK Salonik,6800,2,2,3,1,10,5,5,9
P'thinaikos,6800,3,1,2,3,5,10,-5,5
Panionios,6800,4,1,1,4,4,10,-6,4
AEK Athens,6801,1,4,2,0,7,1,6,14
PAOK Salonik,6801,2,2,2,2,9,7,2,8
P'thinaikos,6801,3,2,1,3,7,9,-2,7
Panionios,6801,4,1,1,4,4,10,-6,4
AEK Athens,6802,1,4,2,0,7,1,6,14
PAOK Salonik,6802,2,2,3,1,9,4,5,9
P'thinaikos,6802,3,1,2,3,4,9,-5,5
Panionios,6802,4,1,1,4,4,10,-6,4
AEK Athens,6803,1,4,2,0,7,1,6,14
PAOK Salonik,6803,2,3,2,1,11,4,7,11
Panionios,6803,3,1,1,4,4,10,-6,4
P'thinaikos,6803,4,1,1,4,4,11,-7,4
AEK Athens,6804,1,4,2,0,7,1,6,14
PAOK Salonik,6804,2,2,2,2,9,5,4,8
P'thinaikos,6804,3,2,1,3,5,9,-4,7
Panionios,6804,4,1,1,4,4,10,-6,4
AEK Athens,6805,1,4,2,0,7,1,6,14
PAOK Salonik,6805,2,2,2,2,9,5,4,8
P'thinaikos,6805,3,2,1,3,5,9,-4,7
Panionios,6805,4,1,1,4,4,10,-6,4
AEK Athens,6806,1,4,2,0,7,1,6,14
PAOK Salonik,6806,2,3,2,1,10,4,6,11
P'thinaikos,6806,3,1,1,4,4,10,-6,4
Panionios,6806,3,1,1,4,4,10,-6,4
AEK Athens,6807,1,4,2,0,7,1,6,14
PAOK Salonik,6807,2,2,2,2,10,6,4,8
P'thinaikos,6807,3,2,1,3,6,10,-4,7
Panionios,6807,4,1,1,4,4,10,-6,4
AEK Athens,6808,1,4,2,0,7,1,6,14
PAOK Salonik,6808,2,3,2,1,12,4,8,11
Panionios,6808,3,1,1,4,4,10,-6,4
P'thinaikos,6808,4,1,1,4,4,12,-8,4
AEK Athens,6809,1,4,2,0,7,1,6,14
PAOK Salonik,6809,2,2,2,2,10,6,4,8
P'thinaikos,6809,3,2,1,3,6,10,-4,7
Panionios,6809,4,1,1,4,4,10,-6,4
AEK Athens,6810,1,4,2,0,7,1,6,14
PAOK Salonik,6810,2,3,2,1,12,4,8,11
Panionios,6810,3,1,1,4,4,10,-6,4
P'thinaikos,6810,4,1,1,4,4,12,-8,4
AEK Athens,6811,1,4,2,0,7,1,6,14
PAOK Salonik,6811,2,2,3,1,10,5,5,9
P'thinaikos,6811,3,1,2,3,5,10,-5,5
Panionios,6811,4,1,1,4,4,10,-6,4
AEK Athens,6812,1,4,2,0,7,1,6,14
PAOK Salonik,6812,2,2,3,1,9,4,5,9
P'thinaikos,6812,3,1,2,3,4,9,-5,5
Panionios,6812,4,1,1,4,4,10,-6,4
AEK Athens,6813,1,4,2,0,7,1,6,14
PAOK Salonik,6813,2,2,3,1,9,4,5,9
P'thinaikos,6813,3,1,2,3,4,9,-5,5
Panionios,6813,4,1,1,4,4,10,-6,4
AEK Athens,6814,1,4,2,0,7,1,6,14
PAOK Salonik,6814,2,3,2,1,11,4,7,11
Panionios,6814,3,1,1,4,4,10,-6,4
P'thinaikos,6814,4,1,1,4,4,11,-7,4
AEK Athens,6815,1,4,2,0,7,1,6,14
PAOK Salonik,6815,2,3,2,1,15,5,10,11
Panionios,6815,3,1,1,4,4,10,-6,4
P'thinaikos,6815,4,1,1,4,5,15,-10,4
AEK Athens,6816,1,4,2,0,7,1,6,14
PAOK Salonik,6816,2,2,2,2,9,7,2,8
P'thinaikos,6816,3,2,1,3,7,9,-2,7
Panionios,6816,4,1,1,4,4,10,-6,4
AEK Athens,6817,1,4,2,0,7,1,6,14
PAOK Salonik,6817,2,2,2,2,10,6,4,8
P'thinaikos,6817,3,2,1,3,6,10,-4,7
Panionios,6817,4,1,1,4,4,10,-6,4
AEK Athens,6818,1,4,2,0,7,1,6,14
PAOK Salonik,6818,2,3,2,1,10,4,6,11
P'thinaikos,6818,3,1,1,4,4,10,-6,4
Panionios,6818,3,1,1,4,4,10,-6,4
AEK Athens,6819,1,4,2,0,7,1,6,14
PAOK Salonik,6819,2,3,2,1,11,5,6,11
P'thinaikos,6819,3,1,1,4,5,11,-6,4
Panionios,6819,4,1,1,4,4,10,-6,4
AEK Athens,6820,1,4,2,0,7,1,6,14
PAOK Salonik,6820,2,3,2,1,14,6,8,11
Panionios,6820,3,1,1,4,4,10,-6,4
P'thinaikos,6820,4,1,1,4,6,14,-8,4
AEK Athens,6821,1,4,2,0,7,1,6,14
PAOK Salonik,6821,2,2,3,1,10,5,5,9
P'thinaikos,6821,3,1,2,3,5,10,-5,5
Panionios,6821,4,1,1,4,4,10,-6,4
AEK Athens,6822,1,4,2,0,7,1,6,14
PAOK Salonik,6822,2,2,3,1,9,4,5,9
P'thinaikos,6822,3,1,2,3,4,9,-5,5
Panionios,6822,4,1,1,4,4,10,-6,4
AEK Athens,6823,1,4,2,0,7,1,6,14
PAOK Salonik,6823,2,2,2,2,10,6,4,8
P'thinaikos,6823,3,2,1,3,6,10,-4,7
Panionios,6823,4,1,1,4,4,10,-6,4
AEK Athens,6824,1,4,2,0,7,1,6,14
PAOK Salonik,6824,2,2,2,2,9,5,4,8
P'thinaikos,6824,3,2,1,3,5,9,-4,7
Panionios,6824,4,1,1,4,4,10,-6,4
AEK Athens,6825,1,4,2,0,7,1,6,14
PAOK Salonik,6825,2,3,2,1,14,6,8,11
Panionios,6825,3,1,1,4,4,10,-6,4
P'thinaikos,6825,4,1,1,4,6,14,-8,4
AEK Athens,6826,1,4,2,0,7,1,6,14
PAOK Salonik,6826,2,2,3,1,9,4,5,9
P'thinaikos,6826,3,1,2,3,4,9,-5,5
Panionios,6826,4,1,1,4,4,10,-6,4
AEK Athens,6827,1,4,2,0,7,1,6,14
PAOK Salonik,6827,2,3,2,1,10,4,6,11
P'thinaikos,6827,3,1,1,4,4,10,-6,4
Panionios,6827,3,1,1,4,4,10,-6,4
AEK Athens,6828,1,4,2,0,7,1,6,14
PAOK Salonik,6828,2,2,2,2,9,6,3,8
P'thinaikos,6828,3,2,1,3,6,9,-3,7
Panionios,6828,4,1,1,4,4,10,-6,4
AEK Athens,6829,1,4,2,0,7,1,6,14
PAOK Salonik,6829,2,2,3,1,10,5,5,9
P'thinaikos,6829,3,1,2,3,5,10,-5,5
Panionios,6829,4,1,1,4,4,10,-6,4
AEK Athens,6830,1,4,2,0,7,1,6,14
PAOK Salonik,6830,2,2,3,1,10,5,5,9
P'thinaikos,6830,3,1,2,3,5,10,-5,5
Panionios,6830,4,1,1,4,4,10,-6,4
AEK Athens,6831,1,4,2,0,7,1,6,14
PAOK Salonik,6831,2,2,3,1,9,4,5,9
P'thinaikos,6831,3,1,2,3,4,9,-5,5
Panionios,6831,4,1,1,4,4,10,-6,4
AEK Athens,6832,1,4,2,0,7,1,6,14
PAOK Salonik,6832,2,3,2,1,11,4,7,11
Panionios,6832,3,1,1,4,4,10,-6,4
P'thinaikos,6832,4,1,1,4,4,11,-7,4
AEK Athens,6833,1,4,2,0,7,1,6,14
PAOK Salonik,6833,2,3,2,1,10,4,6,11
P'thinaikos,6833,3,1,1,4,4,10,-6,4
Panionios,6833,3,1,1,4,4,10,-6,4
AEK Athens,6834,1,4,2,0,7,1,6,14
PAOK Salonik,6834,2,3,2,1,10,4,6,11
P'thinaikos,6834,3,1,1,4,4,10,-6,4
Panionios,6834,3,1,1,4,4,10,-6,4
AEK Athens,6835,1,4,2,0,7,1,6,14
PAOK Salonik,6835,2,2,3,1,9,4,5,9
P'thinaikos,6835,3,1,2,3,4,9,-5,5
Panionios,6835,4,1,1,4,4,10,-6,4
AEK Athens,6836,1,4,2,0,7,1,6,14
PAOK Salonik,6836,2,2,3,1,10,5,5,9
P'thinaikos,6836,3,1,2,3,5,10,-5,5
Panionios,6836,4,1,1,4,4,10,-6,4
AEK Athens,6837,1,4,2,0,7,1,6,14
PAOK Salonik,6837,2,3,2,1,11,5,6,11
P'thinaikos,6837,3,1,1,4,5,11,-6,4
Panionios,6837,4,1,1,4,4,10,-6,4
AEK Athens,6838,1,4,2,0,7,1,6,14
PAOK Salonik,6838,2,2,2,2,9,5,4,8
P'thinaikos,6838,3,2,1,3,5,9,-4,7
Panionios,6838,4,1,1,4,4,10,-6,4
AEK Athens,6839,1,4,2,0,7,1,6,14
PAOK Salonik,6839,2,2,2,2,10,6,4,8
P'thinaikos,6839,3,2,1,3,6,10,-4,7
Panionios,6839,4,1,1,4,4,10,-6,4
AEK Athens,6840,1,4,2,0,7,1,6,14
PAOK Salonik,6840,2,2,3,1,12,7,5,9
P'thinaikos,6840,3,1,2,3,7,12,-5,5
Panionios,6840,4,1,1,4,4,10,-6,4
AEK Athens,6841,1,4,2,0,7,1,6,14
PAOK Salonik,6841,2,2,2,2,10,7,3,8
P'thinaikos,6841,3,2,1,3,7,10,-3,7
Panionios,6841,4,1,1,4,4,10,-6,4
AEK Athens,6842,1,4,2,0,7,1,6,14
PAOK Salonik,6842,2,2,2,2,9,6,3,8
P'thinaikos,6842,3,2,1,3,6,9,-3,7
Panionios,6842,4,1,1,4,4,10,-6,4
AEK Athens,6843,1,4,2,0,7,1,6,14
PAOK Salonik,6843,2,3,2,1,10,4,6,11
P'thinaikos,6843,3,1,1,4,4,10,-6,4
Panionios,6843,3,1,1,4,4,10,-6,4
AEK Athens,6844,1,4,2,0,7,1,6,14
PAOK Salonik,6844,2,2,2,2,9,5,4,8
P'thinaikos,6844,3,2,1,3,5,9,-4,7
Panionios,6844,4,1,1,4,4,10,-6,4
AEK Athens,6845,1,4,2,0,7,1,6,14
PAOK Salonik,6845,2,3,2,1,10,4,6,11
P'thinaikos,6845,3,1,1,4,4,10,-6,4
Panionios,6845,3,1,1,4,4,10,-6,4
AEK Athens,6846,1,4,2,0,7,1,6,14
PAOK Salonik,6846,2,2,2,2,10,6,4,8
P'thinaikos,6846,3,2,1,3,6,10,-4,7
Panionios,6846,4,1,1,4,4,10,-6,4
AEK Athens,6847,1,4,2,0,7,1,6,14
PAOK Salonik,6847,2,2,3,1,11,6,5,9
P'thinaikos,6847,3,1,2,3,6,11,-5,5
Panionios,6847,4,1,1,4,4,10,-6,4
AEK Athens,6848,1,4,2,0,7,1,6,14
PAOK Salonik,6848,2,3,2,1,10,4,6,11
P'thinaikos,6848,3,1,1,4,4,10,-6,4
Panionios,6848,3,1,1,4,4,10,-6,4
AEK Athens,6849,1,4,2,0,7,1,6,14
PAOK Salonik,6849,2,2,2,2,10,6,4,8
P'thinaikos,6849,3,2,1,3,6,10,-4,7
Panionios,6849,4,1,1,4,4,10,-6,4
AEK Athens,6850,1,4,2,0,7,1,6,14
PAOK Salonik,6850,2,3,2,1,11,5,6,11
P'thinaikos,6850,3,1,1,4,5,11,-6,4
Panionios,6850,4,1,1,4,4,10,-6,4
AEK Athens,6851,1,4,2,0,7,1,6,14
PAOK Salonik,6851,2,3,2,1,13,4,9,11
Panionios,6851,3,1,1,4,4,10,-6,4
P'thinaikos,6851,4,1,1,4,4,13,-9,4
AEK Athens,6852,1,4,2,0,7,1,6,14
PAOK Salonik,6852,2,2,2,2,10,6,4,8
P'thinaikos,6852,3,2,1,3,6,10,-4,7
Panionios,6852,4,1,1,4,4,10,-6,4
AEK Athens,6853,1,4,2,0,7,1,6,14
PAOK Salonik,6853,2,2,2,2,9,5,4,8
P'thinaikos,6853,3,2,1,3,5,9,-4,7
Panionios,6853,4,1,1,4,4,10,-6,4
AEK Athens,6854,1,4,2,0,7,1,6,14
PAOK Salonik,6854,2,2,2,2,9,5,4,8
P'thinaikos,6854,3,2,1,3,5,9,-4,7
Panionios,6854,4,1,1,4,4,10,-6,4
AEK Athens,6855,1,4,2,0,7,1,6,14
PAOK Salonik,6855,2,3,2,1,11,5,6,11
P'thinaikos,6855,3,1,1,4,5,11,-6,4
Panionios,6855,4,1,1,4,4,10,-6,4
AEK Athens,6856,1,4,2,0,7,1,6,14
PAOK Salonik,6856,2,3,2,1,12,5,7,11
Panionios,6856,3,1,1,4,4,10,-6,4
P'thinaikos,6856,4,1,1,4,5,12,-7,4
AEK Athens,6857,1,4,2,0,7,1,6,14
PAOK Salonik,6857,2,2,3,1,11,6,5,9
P'thinaikos,6857,3,1,2,3,6,11,-5,5
Panionios,6857,4,1,1,4,4,10,-6,4
AEK Athens,6858,1,4,2,0,7,1,6,14
PAOK Salonik,6858,2,2,3,1,10,5,5,9
P'thinaikos,6858,3,1,2,3,5,10,-5,5
Panionios,6858,4,1,1,4,4,10,-6,4
AEK Athens,6859,1,4,2,0,7,1,6,14
PAOK Salonik,6859,2,2,2,2,9,6,3,8
P'thinaikos,6859,3,2,1,3,6,9,-3,7
Panionios,6859,4,1,1,4,4,10,-6,4
AEK Athens,6860,1,4,2,0,7,1,6,14
PAOK Salonik,6860,2,2,2,2,10,6,4,8
P'thinaikos,6860,3,2,1,3,6,10,-4,7
Panionios,6860,4,1,1,4,4,10,-6,4
AEK Athens,6861,1,4,2,0,7,1,6,14
PAOK Salonik,6861,2,2,2,2,9,5,4,8
P'thinaikos,6861,3,2,1,3,5,9,-4,7
Panionios,6861,4,1,1,4,4,10,-6,4
AEK Athens,6862,1,4,2,0,7,1,6,14
PAOK Salonik,6862,2,3,2,1,13,6,7,11
Panionios,6862,3,1,1,4,4,10,-6,4
P'thinaikos,6862,4,1,1,4,6,13,-7,4
AEK Athens,6863,1,4,2,0,7,1,6,14
PAOK Salonik,6863,2,2,2,2,9,5,4,8
P'thinaikos,6863,3,2,1,3,5,9,-4,7
Panionios,6863,4,1,1,4,4,10,-6,4
AEK Athens,6864,1,4,2,0,7,1,6,14
PAOK Salonik,6864,2,3,2,1,10,4,6,11
P'thinaikos,6864,3,1,1,4,4,10,-6,4
Panionios,6864,3,1,1,4,4,10,-6,4
AEK Athens,6865,1,4,2,0,7,1,6,14
PAOK Salonik,6865,2,2,3,1,10,5,5,9
P'thinaikos,6865,3,1,2,3,5,10,-5,5
Panionios,6865,4,1,1,4,4,10,-6,4
AEK Athens,6866,1,4,2,0,7,1,6,14
PAOK Salonik,6866,2,2,3,1,9,4,5,9
P'thinaikos,6866,3,1,2,3,4,9,-5,5
Panionios,6866,4,1,1,4,4,10,-6,4
AEK Athens,6867,1,4,2,0,7,1,6,14
PAOK Salonik,6867,2,2,2,2,9,7,2,8
P'thinaikos,6867,3,2,1,3,7,9,-2,7
Panionios,6867,4,1,1,4,4,10,-6,4
AEK Athens,6868,1,4,2,0,7,1,6,14
PAOK Salonik,6868,2,2,3,1,10,5,5,9
P'thinaikos,6868,3,1,2,3,5,10,-5,5
Panionios,6868,4,1,1,4,4,10,-6,4
AEK Athens,6869,1,4,2,0,7,1,6,14
PAOK Salonik,6869,2,3,2,1,11,4,7,11
Panionios,6869,3,1,1,4,4,10,-6,4
P'thinaikos,6869,4,1,1,4,4,11,-7,4
AEK Athens,6870,1,4,2,0,7,1,6,14
PAOK Salonik,6870,2,2,2,2,9,7,2,8
P'thinaikos,6870,3,2,1,3,7,9,-2,7
Panionios,6870,4,1,1,4,4,10,-6,4
AEK Athens,6871,1,4,2,0,7,1,6,14
PAOK Salonik,6871,2,3,2,1,14,5,9,11
Panionios,6871,3,1,1,4,4,10,-6,4
P'thinaikos,6871,4,1,1,4,5,14,-9,4
AEK Athens,6872,1,4,2,0,7,1,6,14
PAOK Salonik,6872,2,2,3,1,10,5,5,9
P'thinaikos,6872,3,1,2,3,5,10,-5,5
Panionios,6872,4,1,1,4,4,10,-6,4
AEK Athens,6873,1,4,2,0,7,1,6,14
PAOK Salonik,6873,2,2,3,1,10,5,5,9
P'thinaikos,6873,3,1,2,3,5,10,-5,5
Panionios,6873,4,1,1,4,4,10,-6,4
AEK Athens,6874,1,4,2,0,7,1,6,14
PAOK Salonik,6874,2,3,2,1,13,4,9,11
Panionios,6874,3,1,1,4,4,10,-6,4
P'thinaikos,6874,4,1,1,4,4,13,-9,4
AEK Athens,6875,1,4,2,0,7,1,6,14
PAOK Salonik,6875,2,3,2,1,11,4,7,11
Panionios,6875,3,1,1,4,4,10,-6,4
P'thinaikos,6875,4,1,1,4,4,11,-7,4
AEK Athens,6876,1,4,2,0,7,1,6,14
PAOK Salonik,6876,2,2,3,1,10,5,5,9
P'thinaikos,6876,3,1,2,3,5,10,-5,5
Panionios,6876,4,1,1,4,4,10,-6,4
AEK Athens,6877,1,4,2,0,7,1,6,14
PAOK Salonik,6877,2,2,3,1,10,5,5,9
P'thinaikos,6877,3,1,2,3,5,10,-5,5
Panionios,6877,4,1,1,4,4,10,-6,4
AEK Athens,6878,1,4,2,0,7,1,6,14
PAOK Salonik,6878,2,2,2,2,9,6,3,8
P'thinaikos,6878,3,2,1,3,6,9,-3,7
Panionios,6878,4,1,1,4,4,10,-6,4
AEK Athens,6879,1,4,2,0,7,1,6,14
PAOK Salonik,6879,2,2,2,2,9,7,2,8
P'thinaikos,6879,3,2,1,3,7,9,-2,7
Panionios,6879,4,1,1,4,4,10,-6,4
AEK Athens,6880,1,4,2,0,7,1,6,14
PAOK Salonik,6880,2,3,2,1,12,5,7,11
Panionios,6880,3,1,1,4,4,10,-6,4
P'thinaikos,6880,4,1,1,4,5,12,-7,4
AEK Athens,6881,1,4,2,0,7,1,6,14
PAOK Salonik,6881,2,2,2,2,9,6,3,8
P'thinaikos,6881,3,2,1,3,6,9,-3,7
Panionios,6881,4,1,1,4,4,10,-6,4
AEK Athens,6882,1,4,2,0,7,1,6,14
PAOK Salonik,6882,2,3,2,1,10,4,6,11
P'thinaikos,6882,3,1,1,4,4,10,-6,4
Panionios,6882,3,1,1,4,4,10,-6,4
AEK Athens,6883,1,4,2,0,7,1,6,14
PAOK Salonik,6883,2,3,2,1,10,4,6,11
P'thinaikos,6883,3,1,1,4,4,10,-6,4
Panionios,6883,3,1,1,4,4,10,-6,4
AEK Athens,6884,1,4,2,0,7,1,6,14
PAOK Salonik,6884,2,2,3,1,9,4,5,9
P'thinaikos,6884,3,1,2,3,4,9,-5,5
Panionios,6884,4,1,1,4,4,10,-6,4
AEK Athens,6885,1,4,2,0,7,1,6,14
PAOK Salonik,6885,2,2,2,2,10,7,3,8
P'thinaikos,6885,3,2,1,3,7,10,-3,7
Panionios,6885,4,1,1,4,4,10,-6,4
AEK Athens,6886,1,4,2,0,7,1,6,14
PAOK Salonik,6886,2,3,2,1,11,4,7,11
Panionios,6886,3,1,1,4,4,10,-6,4
P'thinaikos,6886,4,1,1,4,4,11,-7,4
AEK Athens,6887,1,4,2,0,7,1,6,14
PAOK Salonik,6887,2,2,3,1,9,4,5,9
P'thinaikos,6887,3,1,2,3,4,9,-5,5
Panionios,6887,4,1,1,4,4,10,-6,4
AEK Athens,6888,1,4,2,0,7,1,6,14
PAOK Salonik,6888,2,3,2,1,12,5,7,11
Panionios,6888,3,1,1,4,4,10,-6,4
P'thinaikos,6888,4,1,1,4,5,12,-7,4
AEK Athens,6889,1,4,2,0,7,1,6,14
PAOK Salonik,6889,2,2,3,1,9,4,5,9
P'thinaikos,6889,3,1,2,3,4,9,-5,5
Panionios,6889,4,1,1,4,4,10,-6,4
AEK Athens,6890,1,4,2,0,7,1,6,14
PAOK Salonik,6890,2,2,3,1,11,6,5,9
P'thinaikos,6890,3,1,2,3,6,11,-5,5
Panionios,6890,4,1,1,4,4,10,-6,4
AEK Athens,6891,1,4,2,0,7,1,6,14
PAOK Salonik,6891,2,2,2,2,9,6,3,8
P'thinaikos,6891,3,2,1,3,6,9,-3,7
Panionios,6891,4,1,1,4,4,10,-6,4
AEK Athens,6892,1,4,2,0,7,1,6,14
PAOK Salonik,6892,2,3,2,1,10,4,6,11
P'thinaikos,6892,3,1,1,4,4,10,-6,4
Panionios,6892,3,1,1,4,4,10,-6,4
AEK Athens,6893,1,4,2,0,7,1,6,14
PAOK Salonik,6893,2,2,3,1,9,4,5,9
P'thinaikos,6893,3,1,2,3,4,9,-5,5
Panionios,6893,4,1,1,4,4,10,-6,4
AEK Athens,6894,1,4,2,0,7,1,6,14
PAOK Salonik,6894,2,2,3,1,11,6,5,9
P'thinaikos,6894,3,1,2,3,6,11,-5,5
Panionios,6894,4,1,1,4,4,10,-6,4
AEK Athens,6895,1,4,2,0,7,1,6,14
PAOK Salonik,6895,2,2,3,1,11,6,5,9
P'thinaikos,6895,3,1,2,3,6,11,-5,5
Panionios,6895,4,1,1,4,4,10,-6,4
AEK Athens,6896,1,4,2,0,7,1,6,14
PAOK Salonik,6896,2,2,2,2,10,6,4,8
P'thinaikos,6896,3,2,1,3,6,10,-4,7
Panionios,6896,4,1,1,4,4,10,-6,4
AEK Athens,6897,1,4,2,0,7,1,6,14
PAOK Salonik,6897,2,2,2,2,10,6,4,8
P'thinaikos,6897,3,2,1,3,6,10,-4,7
Panionios,6897,4,1,1,4,4,10,-6,4
AEK Athens,6898,1,4,2,0,7,1,6,14
PAOK Salonik,6898,2,2,2,2,9,6,3,8
P'thinaikos,6898,3,2,1,3,6,9,-3,7
Panionios,6898,4,1,1,4,4,10,-6,4
AEK Athens,6899,1,4,2,0,7,1,6,14
PAOK Salonik,6899,2,2,2,2,9,5,4,8
P'thinaikos,6899,3,2,1,3,5,9,-4,7
Panionios,6899,4,1,1,4,4,10,-6,4
AEK Athens,6900,1,4,2,0,7,1,6,14
PAOK Salonik,6900,2,2,3,1,10,5,5,9
P'thinaikos,6900,3,1,2,3,5,10,-5,5
Panionios,6900,4,1,1,4,4,10,-6,4
AEK Athens,6901,1,4,2,0,7,1,6,14
PAOK Salonik,6901,2,2,2,2,9,6,3,8
P'thinaikos,6901,3,2,1,3,6,9,-3,7
Panionios,6901,4,1,1,4,4,10,-6,4
AEK Athens,6902,1,4,2,0,7,1,6,14
PAOK Salonik,6902,2,3,2,1,12,5,7,11
Panionios,6902,3,1,1,4,4,10,-6,4
P'thinaikos,6902,4,1,1,4,5,12,-7,4
AEK Athens,6903,1,4,2,0,7,1,6,14
PAOK Salonik,6903,2,2,3,1,10,5,5,9
P'thinaikos,6903,3,1,2,3,5,10,-5,5
Panionios,6903,4,1,1,4,4,10,-6,4
AEK Athens,6904,1,4,2,0,7,1,6,14
PAOK Salonik,6904,2,2,3,1,10,5,5,9
P'thinaikos,6904,3,1,2,3,5,10,-5,5
Panionios,6904,4,1,1,4,4,10,-6,4
AEK Athens,6905,1,4,2,0,7,1,6,14
PAOK Salonik,6905,2,3,2,1,12,5,7,11
Panionios,6905,3,1,1,4,4,10,-6,4
P'thinaikos,6905,4,1,1,4,5,12,-7,4
AEK Athens,6906,1,4,2,0,7,1,6,14
PAOK Salonik,6906,2,3,2,1,11,4,7,11
Panionios,6906,3,1,1,4,4,10,-6,4
P'thinaikos,6906,4,1,1,4,4,11,-7,4
AEK Athens,6907,1,4,2,0,7,1,6,14
PAOK Salonik,6907,2,2,2,2,10,6,4,8
P'thinaikos,6907,3,2,1,3,6,10,-4,7
Panionios,6907,4,1,1,4,4,10,-6,4
AEK Athens,6908,1,4,2,0,7,1,6,14
PAOK Salonik,6908,2,2,2,2,9,5,4,8
P'thinaikos,6908,3,2,1,3,5,9,-4,7
Panionios,6908,4,1,1,4,4,10,-6,4
AEK Athens,6909,1,4,2,0,7,1,6,14
PAOK Salonik,6909,2,3,2,1,10,4,6,11
P'thinaikos,6909,3,1,1,4,4,10,-6,4
Panionios,6909,3,1,1,4,4,10,-6,4
AEK Athens,6910,1,4,2,0,7,1,6,14
PAOK Salonik,6910,2,2,3,1,11,6,5,9
P'thinaikos,6910,3,1,2,3,6,11,-5,5
Panionios,6910,4,1,1,4,4,10,-6,4
AEK Athens,6911,1,4,2,0,7,1,6,14
PAOK Salonik,6911,2,2,3,1,9,4,5,9
P'thinaikos,6911,3,1,2,3,4,9,-5,5
Panionios,6911,4,1,1,4,4,10,-6,4
AEK Athens,6912,1,4,2,0,7,1,6,14
PAOK Salonik,6912,2,3,2,1,11,4,7,11
Panionios,6912,3,1,1,4,4,10,-6,4
P'thinaikos,6912,4,1,1,4,4,11,-7,4
AEK Athens,6913,1,4,2,0,7,1,6,14
PAOK Salonik,6913,2,3,2,1,10,4,6,11
P'thinaikos,6913,3,1,1,4,4,10,-6,4
Panionios,6913,3,1,1,4,4,10,-6,4
AEK Athens,6914,1,4,2,0,7,1,6,14
PAOK Salonik,6914,2,2,2,2,9,5,4,8
P'thinaikos,6914,3,2,1,3,5,9,-4,7
Panionios,6914,4,1,1,4,4,10,-6,4
AEK Athens,6915,1,4,2,0,7,1,6,14
PAOK Salonik,6915,2,3,2,1,12,5,7,11
Panionios,6915,3,1,1,4,4,10,-6,4
P'thinaikos,6915,4,1,1,4,5,12,-7,4
AEK Athens,6916,1,4,2,0,7,1,6,14
PAOK Salonik,6916,2,3,2,1,10,4,6,11
P'thinaikos,6916,3,1,1,4,4,10,-6,4
Panionios,6916,3,1,1,4,4,10,-6,4
AEK Athens,6917,1,4,2,0,7,1,6,14
PAOK Salonik,6917,2,3,2,1,10,4,6,11
P'thinaikos,6917,3,1,1,4,4,10,-6,4
Panionios,6917,3,1,1,4,4,10,-6,4
AEK Athens,6918,1,4,2,0,7,1,6,14
PAOK Salonik,6918,2,2,3,1,11,6,5,9
P'thinaikos,6918,3,1,2,3,6,11,-5,5
Panionios,6918,4,1,1,4,4,10,-6,4
AEK Athens,6919,1,4,2,0,7,1,6,14
PAOK Salonik,6919,2,2,3,1,10,5,5,9
P'thinaikos,6919,3,1,2,3,5,10,-5,5
Panionios,6919,4,1,1,4,4,10,-6,4
AEK Athens,6920,1,4,2,0,7,1,6,14
PAOK Salonik,6920,2,3,2,1,10,4,6,11
P'thinaikos,6920,3,1,1,4,4,10,-6,4
Panionios,6920,3,1,1,4,4,10,-6,4
AEK Athens,6921,1,4,2,0,7,1,6,14
PAOK Salonik,6921,2,2,3,1,9,4,5,9
P'thinaikos,6921,3,1,2,3,4,9,-5,5
Panionios,6921,4,1,1,4,4,10,-6,4
AEK Athens,6922,1,4,2,0,7,1,6,14
PAOK Salonik,6922,2,2,3,1,10,5,5,9
P'thinaikos,6922,3,1,2,3,5,10,-5,5
Panionios,6922,4,1,1,4,4,10,-6,4
AEK Athens,6923,1,4,2,0,7,1,6,14
PAOK Salonik,6923,2,2,2,2,9,5,4,8
P'thinaikos,6923,3,2,1,3,5,9,-4,7
Panionios,6923,4,1,1,4,4,10,-6,4
AEK Athens,6924,1,4,2,0,7,1,6,14
PAOK Salonik,6924,2,2,2,2,10,6,4,8
P'thinaikos,6924,3,2,1,3,6,10,-4,7
Panionios,6924,4,1,1,4,4,10,-6,4
AEK Athens,6925,1,4,2,0,7,1,6,14
PAOK Salonik,6925,2,3,2,1,11,4,7,11
Panionios,6925,3,1,1,4,4,10,-6,4
P'thinaikos,6925,4,1,1,4,4,11,-7,4
AEK Athens,6926,1,4,2,0,7,1,6,14
PAOK Salonik,6926,2,2,2,2,10,7,3,8
P'thinaikos,6926,3,2,1,3,7,10,-3,7
Panionios,6926,4,1,1,4,4,10,-6,4
AEK Athens,6927,1,4,2,0,7,1,6,14
PAOK Salonik,6927,2,2,2,2,9,6,3,8
P'thinaikos,6927,3,2,1,3,6,9,-3,7
Panionios,6927,4,1,1,4,4,10,-6,4
AEK Athens,6928,1,4,2,0,7,1,6,14
PAOK Salonik,6928,2,2,2,2,9,6,3,8
P'thinaikos,6928,3,2,1,3,6,9,-3,7
Panionios,6928,4,1,1,4,4,10,-6,4
AEK Athens,6929,1,4,2,0,7,1,6,14
PAOK Salonik,6929,2,3,2,1,11,5,6,11
P'thinaikos,6929,3,1,1,4,5,11,-6,4
Panionios,6929,4,1,1,4,4,10,-6,4
AEK Athens,6930,1,4,2,0,7,1,6,14
PAOK Salonik,6930,2,2,2,2,10,7,3,8
P'thinaikos,6930,3,2,1,3,7,10,-3,7
Panionios,6930,4,1,1,4,4,10,-6,4
AEK Athens,6931,1,4,2,0,7,1,6,14
PAOK Salonik,6931,2,2,3,1,9,4,5,9
P'thinaikos,6931,3,1,2,3,4,9,-5,5
Panionios,6931,4,1,1,4,4,10,-6,4
AEK Athens,6932,1,4,2,0,7,1,6,14
PAOK Salonik,6932,2,2,3,1,10,5,5,9
P'thinaikos,6932,3,1,2,3,5,10,-5,5
Panionios,6932,4,1,1,4,4,10,-6,4
AEK Athens,6933,1,4,2,0,7,1,6,14
PAOK Salonik,6933,2,2,2,2,10,8,2,8
P'thinaikos,6933,3,2,1,3,8,10,-2,7
Panionios,6933,4,1,1,4,4,10,-6,4
AEK Athens,6934,1,4,2,0,7,1,6,14
PAOK Salonik,6934,2,3,2,1,12,6,6,11
P'thinaikos,6934,3,1,1,4,6,12,-6,4
Panionios,6934,4,1,1,4,4,10,-6,4
AEK Athens,6935,1,4,2,0,7,1,6,14
PAOK Salonik,6935,2,2,2,2,9,7,2,8
P'thinaikos,6935,3,2,1,3,7,9,-2,7
Panionios,6935,4,1,1,4,4,10,-6,4
AEK Athens,6936,1,4,2,0,7,1,6,14
PAOK Salonik,6936,2,3,2,1,10,4,6,11
P'thinaikos,6936,3,1,1,4,4,10,-6,4
Panionios,6936,3,1,1,4,4,10,-6,4
AEK Athens,6937,1,4,2,0,7,1,6,14
PAOK Salonik,6937,2,3,2,1,13,5,8,11
Panionios,6937,3,1,1,4,4,10,-6,4
P'thinaikos,6937,4,1,1,4,5,13,-8,4
AEK Athens,6938,1,4,2,0,7,1,6,14
PAOK Salonik,6938,2,2,3,1,10,5,5,9
P'thinaikos,6938,3,1,2,3,5,10,-5,5
Panionios,6938,4,1,1,4,4,10,-6,4
AEK Athens,6939,1,4,2,0,7,1,6,14
PAOK Salonik,6939,2,2,2,2,9,5,4,8
P'thinaikos,6939,3,2,1,3,5,9,-4,7
Panionios,6939,4,1,1,4,4,10,-6,4
AEK Athens,6940,1,4,2,0,7,1,6,14
PAOK Salonik,6940,2,2,2,2,9,5,4,8
P'thinaikos,6940,3,2,1,3,5,9,-4,7
Panionios,6940,4,1,1,4,4,10,-6,4
AEK Athens,6941,1,4,2,0,7,1,6,14
PAOK Salonik,6941,2,3,2,1,11,4,7,11
Panionios,6941,3,1,1,4,4,10,-6,4
P'thinaikos,6941,4,1,1,4,4,11,-7,4
AEK Athens,6942,1,4,2,0,7,1,6,14
PAOK Salonik,6942,2,3,2,1,10,4,6,11
P'thinaikos,6942,3,1,1,4,4,10,-6,4
Panionios,6942,3,1,1,4,4,10,-6,4
AEK Athens,6943,1,4,2,0,7,1,6,14
PAOK Salonik,6943,2,2,2,2,9,7,2,8
P'thinaikos,6943,3,2,1,3,7,9,-2,7
Panionios,6943,4,1,1,4,4,10,-6,4
AEK Athens,6944,1,4,2,0,7,1,6,14
PAOK Salonik,6944,2,2,2,2,10,7,3,8
P'thinaikos,6944,3,2,1,3,7,10,-3,7
Panionios,6944,4,1,1,4,4,10,-6,4
AEK Athens,6945,1,4,2,0,7,1,6,14
PAOK Salonik,6945,2,2,3,1,10,5,5,9
P'thinaikos,6945,3,1,2,3,5,10,-5,5
Panionios,6945,4,1,1,4,4,10,-6,4
AEK Athens,6946,1,4,2,0,7,1,6,14
PAOK Salonik,6946,2,2,3,1,9,4,5,9
P'thinaikos,6946,3,1,2,3,4,9,-5,5
Panionios,6946,4,1,1,4,4,10,-6,4
AEK Athens,6947,1,4,2,0,7,1,6,14
PAOK Salonik,6947,2,2,2,2,12,8,4,8
P'thinaikos,6947,3,2,1,3,8,12,-4,7
Panionios,6947,4,1,1,4,4,10,-6,4
AEK Athens,6948,1,4,2,0,7,1,6,14
PAOK Salonik,6948,2,2,3,1,12,7,5,9
P'thinaikos,6948,3,1,2,3,7,12,-5,5
Panionios,6948,4,1,1,4,4,10,-6,4
AEK Athens,6949,1,4,2,0,7,1,6,14
PAOK Salonik,6949,2,2,3,1,11,6,5,9
P'thinaikos,6949,3,1,2,3,6,11,-5,5
Panionios,6949,4,1,1,4,4,10,-6,4
AEK Athens,6950,1,4,2,0,7,1,6,14
PAOK Salonik,6950,2,3,2,1,13,4,9,11
Panionios,6950,3,1,1,4,4,10,-6,4
P'thinaikos,6950,4,1,1,4,4,13,-9,4
AEK Athens,6951,1,4,2,0,7,1,6,14
PAOK Salonik,6951,2,3,2,1,11,5,6,11
P'thinaikos,6951,3,1,1,4,5,11,-6,4
Panionios,6951,4,1,1,4,4,10,-6,4
AEK Athens,6952,1,4,2,0,7,1,6,14
PAOK Salonik,6952,2,2,2,2,10,6,4,8
P'thinaikos,6952,3,2,1,3,6,10,-4,7
Panionios,6952,4,1,1,4,4,10,-6,4
AEK Athens,6953,1,4,2,0,7,1,6,14
PAOK Salonik,6953,2,2,2,2,10,7,3,8
P'thinaikos,6953,3,2,1,3,7,10,-3,7
Panionios,6953,4,1,1,4,4,10,-6,4
AEK Athens,6954,1,4,2,0,7,1,6,14
PAOK Salonik,6954,2,2,2,2,10,6,4,8
P'thinaikos,6954,3,2,1,3,6,10,-4,7
Panionios,6954,4,1,1,4,4,10,-6,4
AEK Athens,6955,1,4,2,0,7,1,6,14
PAOK Salonik,6955,2,2,2,2,10,6,4,8
P'thinaikos,6955,3,2,1,3,6,10,-4,7
Panionios,6955,4,1,1,4,4,10,-6,4
AEK Athens,6956,1,4,2,0,7,1,6,14
PAOK Salonik,6956,2,3,2,1,13,4,9,11
Panionios,6956,3,1,1,4,4,10,-6,4
P'thinaikos,6956,4,1,1,4,4,13,-9,4
AEK Athens,6957,1,4,2,0,7,1,6,14
PAOK Salonik,6957,2,3,2,1,11,5,6,11
P'thinaikos,6957,3,1,1,4,5,11,-6,4
Panionios,6957,4,1,1,4,4,10,-6,4
AEK Athens,6958,1,4,2,0,7,1,6,14
PAOK Salonik,6958,2,3,2,1,10,4,6,11
P'thinaikos,6958,3,1,1,4,4,10,-6,4
Panionios,6958,3,1,1,4,4,10,-6,4
AEK Athens,6959,1,4,2,0,7,1,6,14
PAOK Salonik,6959,2,2,3,1,9,4,5,9
P'thinaikos,6959,3,1,2,3,4,9,-5,5
Panionios,6959,4,1,1,4,4,10,-6,4
AEK Athens,6960,1,4,2,0,7,1,6,14
PAOK Salonik,6960,2,2,3,1,9,4,5,9
P'thinaikos,6960,3,1,2,3,4,9,-5,5
Panionios,6960,4,1,1,4,4,10,-6,4
AEK Athens,6961,1,4,2,0,7,1,6,14
PAOK Salonik,6961,2,3,2,1,12,4,8,11
Panionios,6961,3,1,1,4,4,10,-6,4
P'thinaikos,6961,4,1,1,4,4,12,-8,4
AEK Athens,6962,1,4,2,0,7,1,6,14
PAOK Salonik,6962,2,2,2,2,9,5,4,8
P'thinaikos,6962,3,2,1,3,5,9,-4,7
Panionios,6962,4,1,1,4,4,10,-6,4
AEK Athens,6963,1,4,2,0,7,1,6,14
PAOK Salonik,6963,2,2,3,1,10,5,5,9
P'thinaikos,6963,3,1,2,3,5,10,-5,5
Panionios,6963,4,1,1,4,4,10,-6,4
AEK Athens,6964,1,4,2,0,7,1,6,14
PAOK Salonik,6964,2,2,3,1,10,5,5,9
P'thinaikos,6964,3,1,2,3,5,10,-5,5
Panionios,6964,4,1,1,4,4,10,-6,4
AEK Athens,6965,1,4,2,0,7,1,6,14
PAOK Salonik,6965,2,2,2,2,9,7,2,8
P'thinaikos,6965,3,2,1,3,7,9,-2,7
Panionios,6965,4,1,1,4,4,10,-6,4
AEK Athens,6966,1,4,2,0,7,1,6,14
PAOK Salonik,6966,2,2,3,1,9,4,5,9
P'thinaikos,6966,3,1,2,3,4,9,-5,5
Panionios,6966,4,1,1,4,4,10,-6,4
AEK Athens,6967,1,4,2,0,7,1,6,14
PAOK Salonik,6967,2,2,3,1,10,5,5,9
P'thinaikos,6967,3,1,2,3,5,10,-5,5
Panionios,6967,4,1,1,4,4,10,-6,4
AEK Athens,6968,1,4,2,0,7,1,6,14
PAOK Salonik,6968,2,3,2,1,11,5,6,11
P'thinaikos,6968,3,1,1,4,5,11,-6,4
Panionios,6968,4,1,1,4,4,10,-6,4
AEK Athens,6969,1,4,2,0,7,1,6,14
PAOK Salonik,6969,2,3,2,1,10,4,6,11
P'thinaikos,6969,3,1,1,4,4,10,-6,4
Panionios,6969,3,1,1,4,4,10,-6,4
AEK Athens,6970,1,4,2,0,7,1,6,14
PAOK Salonik,6970,2,2,3,1,10,5,5,9
P'thinaikos,6970,3,1,2,3,5,10,-5,5
Panionios,6970,4,1,1,4,4,10,-6,4
AEK Athens,6971,1,4,2,0,7,1,6,14
PAOK Salonik,6971,2,2,2,2,10,6,4,8
P'thinaikos,6971,3,2,1,3,6,10,-4,7
Panionios,6971,4,1,1,4,4,10,-6,4
AEK Athens,6972,1,4,2,0,7,1,6,14
PAOK Salonik,6972,2,2,3,1,10,5,5,9
P'thinaikos,6972,3,1,2,3,5,10,-5,5
Panionios,6972,4,1,1,4,4,10,-6,4
AEK Athens,6973,1,4,2,0,7,1,6,14
PAOK Salonik,6973,2,2,3,1,11,6,5,9
P'thinaikos,6973,3,1,2,3,6,11,-5,5
Panionios,6973,4,1,1,4,4,10,-6,4
AEK Athens,6974,1,4,2,0,7,1,6,14
PAOK Salonik,6974,2,2,3,1,10,5,5,9
P'thinaikos,6974,3,1,2,3,5,10,-5,5
Panionios,6974,4,1,1,4,4,10,-6,4
AEK Athens,6975,1,4,2,0,7,1,6,14
PAOK Salonik,6975,2,3,2,1,11,5,6,11
P'thinaikos,6975,3,1,1,4,5,11,-6,4
Panionios,6975,4,1,1,4,4,10,-6,4
AEK Athens,6976,1,4,2,0,7,1,6,14
PAOK Salonik,6976,2,2,3,1,12,7,5,9
P'thinaikos,6976,3,1,2,3,7,12,-5,5
Panionios,6976,4,1,1,4,4,10,-6,4
AEK Athens,6977,1,4,2,0,7,1,6,14
PAOK Salonik,6977,2,2,2,2,9,5,4,8
P'thinaikos,6977,3,2,1,3,5,9,-4,7
Panionios,6977,4,1,1,4,4,10,-6,4
AEK Athens,6978,1,4,2,0,7,1,6,14
PAOK Salonik,6978,2,2,3,1,11,6,5,9
P'thinaikos,6978,3,1,2,3,6,11,-5,5
Panionios,6978,4,1,1,4,4,10,-6,4
AEK Athens,6979,1,4,2,0,7,1,6,14
PAOK Salonik,6979,2,2,3,1,10,5,5,9
P'thinaikos,6979,3,1,2,3,5,10,-5,5
Panionios,6979,4,1,1,4,4,10,-6,4
AEK Athens,6980,1,4,2,0,7,1,6,14
PAOK Salonik,6980,2,2,3,1,9,4,5,9
P'thinaikos,6980,3,1,2,3,4,9,-5,5
Panionios,6980,4,1,1,4,4,10,-6,4
AEK Athens,6981,1,4,2,0,7,1,6,14
PAOK Salonik,6981,2,3,2,1,11,5,6,11
P'thinaikos,6981,3,1,1,4,5,11,-6,4
Panionios,6981,4,1,1,4,4,10,-6,4
AEK Athens,6982,1,4,2,0,7,1,6,14
PAOK Salonik,6982,2,2,2,2,10,10,0,8
P'thinaikos,6982,3,2,1,3,10,10,0,7
Panionios,6982,4,1,1,4,4,10,-6,4
AEK Athens,6983,1,4,2,0,7,1,6,14
PAOK Salonik,6983,2,2,3,1,9,4,5,9
P'thinaikos,6983,3,1,2,3,4,9,-5,5
Panionios,6983,4,1,1,4,4,10,-6,4
AEK Athens,6984,1,4,2,0,7,1,6,14
PAOK Salonik,6984,2,3,2,1,11,5,6,11
P'thinaikos,6984,3,1,1,4,5,11,-6,4
Panionios,6984,4,1,1,4,4,10,-6,4
AEK Athens,6985,1,4,2,0,7,1,6,14
PAOK Salonik,6985,2,2,3,1,10,5,5,9
P'thinaikos,6985,3,1,2,3,5,10,-5,5
Panionios,6985,4,1,1,4,4,10,-6,4
AEK Athens,6986,1,4,2,0,7,1,6,14
PAOK Salonik,6986,2,2,2,2,10,6,4,8
P'thinaikos,6986,3,2,1,3,6,10,-4,7
Panionios,6986,4,1,1,4,4,10,-6,4
AEK Athens,6987,1,4,2,0,7,1,6,14
PAOK Salonik,6987,2,2,2,2,9,5,4,8
P'thinaikos,6987,3,2,1,3,5,9,-4,7
Panionios,6987,4,1,1,4,4,10,-6,4
AEK Athens,6988,1,4,2,0,7,1,6,14
PAOK Salonik,6988,2,2,2,2,10,7,3,8
P'thinaikos,6988,3,2,1,3,7,10,-3,7
Panionios,6988,4,1,1,4,4,10,-6,4
AEK Athens,6989,1,4,2,0,7,1,6,14
PAOK Salonik,6989,2,2,2,2,9,5,4,8
P'thinaikos,6989,3,2,1,3,5,9,-4,7
Panionios,6989,4,1,1,4,4,10,-6,4
AEK Athens,6990,1,4,2,0,7,1,6,14
PAOK Salonik,6990,2,2,3,1,10,5,5,9
P'thinaikos,6990,3,1,2,3,5,10,-5,5
Panionios,6990,4,1,1,4,4,10,-6,4
AEK Athens,6991,1,4,2,0,7,1,6,14
PAOK Salonik,6991,2,2,2,2,9,6,3,8
P'thinaikos,6991,3,2,1,3,6,9,-3,7
Panionios,6991,4,1,1,4,4,10,-6,4
AEK Athens,6992,1,4,2,0,7,1,6,14
PAOK Salonik,6992,2,2,3,1,9,4,5,9
P'thinaikos,6992,3,1,2,3,4,9,-5,5
Panionios,6992,4,1,1,4,4,10,-6,4
AEK Athens,6993,1,4,2,0,7,1,6,14
PAOK Salonik,6993,2,2,2,2,9,5,4,8
P'thinaikos,6993,3,2,1,3,5,9,-4,7
Panionios,6993,4,1,1,4,4,10,-6,4
AEK Athens,6994,1,4,2,0,7,1,6,14
PAOK Salonik,6994,2,2,2,2,9,5,4,8
P'thinaikos,6994,3,2,1,3,5,9,-4,7
Panionios,6994,4,1,1,4,4,10,-6,4
AEK Athens,6995,1,4,2,0,7,1,6,14
PAOK Salonik,6995,2,2,3,1,10,5,5,9
P'thinaikos,6995,3,1,2,3,5,10,-5,5
Panionios,6995,4,1,1,4,4,10,-6,4
AEK Athens,6996,1,4,2,0,7,1,6,14
PAOK Salonik,6996,2,2,2,2,9,6,3,8
P'thinaikos,6996,3,2,1,3,6,9,-3,7
Panionios,6996,4,1,1,4,4,10,-6,4
AEK Athens,6997,1,4,2,0,7,1,6,14
PAOK Salonik,6997,2,2,2,2,10,6,4,8
P'thinaikos,6997,3,2,1,3,6,10,-4,7
Panionios,6997,4,1,1,4,4,10,-6,4
AEK Athens,6998,1,4,2,0,7,1,6,14
PAOK Salonik,6998,2,2,2,2,9,5,4,8
P'thinaikos,6998,3,2,1,3,5,9,-4,7
Panionios,6998,4,1,1,4,4,10,-6,4
AEK Athens,6999,1,4,2,0,7,1,6,14
PAOK Salonik,6999,2,2,2,2,10,6,4,8
P'thinaikos,6999,3,2,1,3,6,10,-4,7
Panionios,6999,4,1,1,4,4,10,-6,4
AEK Athens,7000,1,4,2,0,7,1,6,14
PAOK Salonik,7000,2,2,2,2,10,6,4,8
P'thinaikos,7000,3,2,1,3,6,10,-4,7
Panionios,7000,4,1,1,4,4,10,-6,4
AEK Athens,7001,1,4,2,0,7,1,6,14
PAOK Salonik,7001,2,2,3,1,9,4,5,9
P'thinaikos,7001,3,1,2,3,4,9,-5,5
Panionios,7001,4,1,1,4,4,10,-6,4
AEK Athens,7002,1,4,2,0,7,1,6,14
PAOK Salonik,7002,2,3,2,1,11,5,6,11
P'thinaikos,7002,3,1,1,4,5,11,-6,4
Panionios,7002,4,1,1,4,4,10,-6,4
AEK Athens,7003,1,4,2,0,7,1,6,14
PAOK Salonik,7003,2,2,2,2,10,6,4,8
P'thinaikos,7003,3,2,1,3,6,10,-4,7
Panionios,7003,4,1,1,4,4,10,-6,4
AEK Athens,7004,1,4,2,0,7,1,6,14
PAOK Salonik,7004,2,2,2,2,9,6,3,8
P'thinaikos,7004,3,2,1,3,6,9,-3,7
Panionios,7004,4,1,1,4,4,10,-6,4
AEK Athens,7005,1,4,2,0,7,1,6,14
PAOK Salonik,7005,2,2,3,1,9,4,5,9
P'thinaikos,7005,3,1,2,3,4,9,-5,5
Panionios,7005,4,1,1,4,4,10,-6,4
AEK Athens,7006,1,4,2,0,7,1,6,14
PAOK Salonik,7006,2,2,3,1,10,5,5,9
P'thinaikos,7006,3,1,2,3,5,10,-5,5
Panionios,7006,4,1,1,4,4,10,-6,4
AEK Athens,7007,1,4,2,0,7,1,6,14
PAOK Salonik,7007,2,3,2,1,10,4,6,11
P'thinaikos,7007,3,1,1,4,4,10,-6,4
Panionios,7007,3,1,1,4,4,10,-6,4
AEK Athens,7008,1,4,2,0,7,1,6,14
PAOK Salonik,7008,2,2,3,1,9,4,5,9
P'thinaikos,7008,3,1,2,3,4,9,-5,5
Panionios,7008,4,1,1,4,4,10,-6,4
AEK Athens,7009,1,4,2,0,7,1,6,14
PAOK Salonik,7009,2,2,3,1,9,4,5,9
P'thinaikos,7009,3,1,2,3,4,9,-5,5
Panionios,7009,4,1,1,4,4,10,-6,4
AEK Athens,7010,1,4,2,0,7,1,6,14
PAOK Salonik,7010,2,3,2,1,10,4,6,11
P'thinaikos,7010,3,1,1,4,4,10,-6,4
Panionios,7010,3,1,1,4,4,10,-6,4
AEK Athens,7011,1,4,2,0,7,1,6,14
PAOK Salonik,7011,2,2,2,2,10,6,4,8
P'thinaikos,7011,3,2,1,3,6,10,-4,7
Panionios,7011,4,1,1,4,4,10,-6,4
AEK Athens,7012,1,4,2,0,7,1,6,14
PAOK Salonik,7012,2,2,2,2,10,6,4,8
P'thinaikos,7012,3,2,1,3,6,10,-4,7
Panionios,7012,4,1,1,4,4,10,-6,4
AEK Athens,7013,1,4,2,0,7,1,6,14
PAOK Salonik,7013,2,2,2,2,10,6,4,8
P'thinaikos,7013,3,2,1,3,6,10,-4,7
Panionios,7013,4,1,1,4,4,10,-6,4
AEK Athens,7014,1,4,2,0,7,1,6,14
PAOK Salonik,7014,2,2,2,2,10,6,4,8
P'thinaikos,7014,3,2,1,3,6,10,-4,7
Panionios,7014,4,1,1,4,4,10,-6,4
AEK Athens,7015,1,4,2,0,7,1,6,14
PAOK Salonik,7015,2,2,2,2,9,6,3,8
P'thinaikos,7015,3,2,1,3,6,9,-3,7
Panionios,7015,4,1,1,4,4,10,-6,4
AEK Athens,7016,1,4,2,0,7,1,6,14
PAOK Salonik,7016,2,3,2,1,10,4,6,11
P'thinaikos,7016,3,1,1,4,4,10,-6,4
Panionios,7016,3,1,1,4,4,10,-6,4
AEK Athens,7017,1,4,2,0,7,1,6,14
PAOK Salonik,7017,2,2,3,1,10,5,5,9
P'thinaikos,7017,3,1,2,3,5,10,-5,5
Panionios,7017,4,1,1,4,4,10,-6,4
AEK Athens,7018,1,4,2,0,7,1,6,14
PAOK Salonik,7018,2,2,2,2,9,7,2,8
P'thinaikos,7018,3,2,1,3,7,9,-2,7
Panionios,7018,4,1,1,4,4,10,-6,4
AEK Athens,7019,1,4,2,0,7,1,6,14
PAOK Salonik,7019,2,3,2,1,11,4,7,11
Panionios,7019,3,1,1,4,4,10,-6,4
P'thinaikos,7019,4,1,1,4,4,11,-7,4
AEK Athens,7020,1,4,2,0,7,1,6,14
PAOK Salonik,7020,2,3,2,1,11,5,6,11
P'thinaikos,7020,3,1,1,4,5,11,-6,4
Panionios,7020,4,1,1,4,4,10,-6,4
AEK Athens,7021,1,4,2,0,7,1,6,14
PAOK Salonik,7021,2,3,2,1,14,5,9,11
Panionios,7021,3,1,1,4,4,10,-6,4
P'thinaikos,7021,4,1,1,4,5,14,-9,4
AEK Athens,7022,1,4,2,0,7,1,6,14
PAOK Salonik,7022,2,2,2,2,9,7,2,8
P'thinaikos,7022,3,2,1,3,7,9,-2,7
Panionios,7022,4,1,1,4,4,10,-6,4
AEK Athens,7023,1,4,2,0,7,1,6,14
PAOK Salonik,7023,2,2,3,1,10,5,5,9
P'thinaikos,7023,3,1,2,3,5,10,-5,5
Panionios,7023,4,1,1,4,4,10,-6,4
AEK Athens,7024,1,4,2,0,7,1,6,14
PAOK Salonik,7024,2,2,3,1,10,5,5,9
P'thinaikos,7024,3,1,2,3,5,10,-5,5
Panionios,7024,4,1,1,4,4,10,-6,4
AEK Athens,7025,1,4,2,0,7,1,6,14
PAOK Salonik,7025,2,3,2,1,11,5,6,11
P'thinaikos,7025,3,1,1,4,5,11,-6,4
Panionios,7025,4,1,1,4,4,10,-6,4
AEK Athens,7026,1,4,2,0,7,1,6,14
PAOK Salonik,7026,2,2,2,2,10,6,4,8
P'thinaikos,7026,3,2,1,3,6,10,-4,7
Panionios,7026,4,1,1,4,4,10,-6,4
AEK Athens,7027,1,4,2,0,7,1,6,14
PAOK Salonik,7027,2,3,2,1,10,4,6,11
P'thinaikos,7027,3,1,1,4,4,10,-6,4
Panionios,7027,3,1,1,4,4,10,-6,4
AEK Athens,7028,1,4,2,0,7,1,6,14
PAOK Salonik,7028,2,2,2,2,10,6,4,8
P'thinaikos,7028,3,2,1,3,6,10,-4,7
Panionios,7028,4,1,1,4,4,10,-6,4
AEK Athens,7029,1,4,2,0,7,1,6,14
PAOK Salonik,7029,2,3,2,1,10,4,6,11
P'thinaikos,7029,3,1,1,4,4,10,-6,4
Panionios,7029,3,1,1,4,4,10,-6,4
AEK Athens,7030,1,4,2,0,7,1,6,14
PAOK Salonik,7030,2,2,2,2,9,8,1,8
P'thinaikos,7030,3,2,1,3,8,9,-1,7
Panionios,7030,4,1,1,4,4,10,-6,4
AEK Athens,7031,1,4,2,0,7,1,6,14
PAOK Salonik,7031,2,2,2,2,9,5,4,8
P'thinaikos,7031,3,2,1,3,5,9,-4,7
Panionios,7031,4,1,1,4,4,10,-6,4
AEK Athens,7032,1,4,2,0,7,1,6,14
PAOK Salonik,7032,2,2,2,2,10,6,4,8
P'thinaikos,7032,3,2,1,3,6,10,-4,7
Panionios,7032,4,1,1,4,4,10,-6,4
AEK Athens,7033,1,4,2,0,7,1,6,14
PAOK Salonik,7033,2,3,2,1,12,5,7,11
Panionios,7033,3,1,1,4,4,10,-6,4
P'thinaikos,7033,4,1,1,4,5,12,-7,4
AEK Athens,7034,1,4,2,0,7,1,6,14
PAOK Salonik,7034,2,3,2,1,12,6,6,11
P'thinaikos,7034,3,1,1,4,6,12,-6,4
Panionios,7034,4,1,1,4,4,10,-6,4
AEK Athens,7035,1,4,2,0,7,1,6,14
PAOK Salonik,7035,2,2,2,2,9,6,3,8
P'thinaikos,7035,3,2,1,3,6,9,-3,7
Panionios,7035,4,1,1,4,4,10,-6,4
AEK Athens,7036,1,4,2,0,7,1,6,14
PAOK Salonik,7036,2,2,2,2,9,6,3,8
P'thinaikos,7036,3,2,1,3,6,9,-3,7
Panionios,7036,4,1,1,4,4,10,-6,4
AEK Athens,7037,1,4,2,0,7,1,6,14
PAOK Salonik,7037,2,2,2,2,10,6,4,8
P'thinaikos,7037,3,2,1,3,6,10,-4,7
Panionios,7037,4,1,1,4,4,10,-6,4
AEK Athens,7038,1,4,2,0,7,1,6,14
PAOK Salonik,7038,2,3,2,1,10,4,6,11
P'thinaikos,7038,3,1,1,4,4,10,-6,4
Panionios,7038,3,1,1,4,4,10,-6,4
AEK Athens,7039,1,4,2,0,7,1,6,14
PAOK Salonik,7039,2,2,3,1,9,4,5,9
P'thinaikos,7039,3,1,2,3,4,9,-5,5
Panionios,7039,4,1,1,4,4,10,-6,4
AEK Athens,7040,1,4,2,0,7,1,6,14
PAOK Salonik,7040,2,2,2,2,10,6,4,8
P'thinaikos,7040,3,2,1,3,6,10,-4,7
Panionios,7040,4,1,1,4,4,10,-6,4
AEK Athens,7041,1,4,2,0,7,1,6,14
PAOK Salonik,7041,2,3,2,1,11,5,6,11
P'thinaikos,7041,3,1,1,4,5,11,-6,4
Panionios,7041,4,1,1,4,4,10,-6,4
AEK Athens,7042,1,4,2,0,7,1,6,14
PAOK Salonik,7042,2,3,2,1,11,5,6,11
P'thinaikos,7042,3,1,1,4,5,11,-6,4
Panionios,7042,4,1,1,4,4,10,-6,4
AEK Athens,7043,1,4,2,0,7,1,6,14
PAOK Salonik,7043,2,3,2,1,10,4,6,11
P'thinaikos,7043,3,1,1,4,4,10,-6,4
Panionios,7043,3,1,1,4,4,10,-6,4
AEK Athens,7044,1,4,2,0,7,1,6,14
PAOK Salonik,7044,2,3,2,1,11,5,6,11
P'thinaikos,7044,3,1,1,4,5,11,-6,4
Panionios,7044,4,1,1,4,4,10,-6,4
AEK Athens,7045,1,4,2,0,7,1,6,14
PAOK Salonik,7045,2,3,2,1,11,4,7,11
Panionios,7045,3,1,1,4,4,10,-6,4
P'thinaikos,7045,4,1,1,4,4,11,-7,4
AEK Athens,7046,1,4,2,0,7,1,6,14
PAOK Salonik,7046,2,3,2,1,12,5,7,11
Panionios,7046,3,1,1,4,4,10,-6,4
P'thinaikos,7046,4,1,1,4,5,12,-7,4
AEK Athens,7047,1,4,2,0,7,1,6,14
PAOK Salonik,7047,2,2,2,2,10,6,4,8
P'thinaikos,7047,3,2,1,3,6,10,-4,7
Panionios,7047,4,1,1,4,4,10,-6,4
AEK Athens,7048,1,4,2,0,7,1,6,14
PAOK Salonik,7048,2,3,2,1,12,5,7,11
Panionios,7048,3,1,1,4,4,10,-6,4
P'thinaikos,7048,4,1,1,4,5,12,-7,4
AEK Athens,7049,1,4,2,0,7,1,6,14
PAOK Salonik,7049,2,2,2,2,10,7,3,8
P'thinaikos,7049,3,2,1,3,7,10,-3,7
Panionios,7049,4,1,1,4,4,10,-6,4
AEK Athens,7050,1,4,2,0,7,1,6,14
PAOK Salonik,7050,2,3,2,1,10,4,6,11
P'thinaikos,7050,3,1,1,4,4,10,-6,4
Panionios,7050,3,1,1,4,4,10,-6,4
AEK Athens,7051,1,4,2,0,7,1,6,14
PAOK Salonik,7051,2,2,2,2,9,6,3,8
P'thinaikos,7051,3,2,1,3,6,9,-3,7
Panionios,7051,4,1,1,4,4,10,-6,4
AEK Athens,7052,1,4,2,0,7,1,6,14
PAOK Salonik,7052,2,3,2,1,10,4,6,11
P'thinaikos,7052,3,1,1,4,4,10,-6,4
Panionios,7052,3,1,1,4,4,10,-6,4
AEK Athens,7053,1,4,2,0,7,1,6,14
PAOK Salonik,7053,2,2,2,2,10,6,4,8
P'thinaikos,7053,3,2,1,3,6,10,-4,7
Panionios,7053,4,1,1,4,4,10,-6,4
AEK Athens,7054,1,4,2,0,7,1,6,14
PAOK Salonik,7054,2,3,2,1,10,4,6,11
P'thinaikos,7054,3,1,1,4,4,10,-6,4
Panionios,7054,3,1,1,4,4,10,-6,4
AEK Athens,7055,1,4,2,0,7,1,6,14
PAOK Salonik,7055,2,2,2,2,10,6,4,8
P'thinaikos,7055,3,2,1,3,6,10,-4,7
Panionios,7055,4,1,1,4,4,10,-6,4
AEK Athens,7056,1,4,2,0,7,1,6,14
PAOK Salonik,7056,2,2,3,1,10,5,5,9
P'thinaikos,7056,3,1,2,3,5,10,-5,5
Panionios,7056,4,1,1,4,4,10,-6,4
AEK Athens,7057,1,4,2,0,7,1,6,14
PAOK Salonik,7057,2,2,3,1,11,6,5,9
P'thinaikos,7057,3,1,2,3,6,11,-5,5
Panionios,7057,4,1,1,4,4,10,-6,4
AEK Athens,7058,1,4,2,0,7,1,6,14
PAOK Salonik,7058,2,2,3,1,10,5,5,9
P'thinaikos,7058,3,1,2,3,5,10,-5,5
Panionios,7058,4,1,1,4,4,10,-6,4
AEK Athens,7059,1,4,2,0,7,1,6,14
PAOK Salonik,7059,2,2,2,2,9,5,4,8
P'thinaikos,7059,3,2,1,3,5,9,-4,7
Panionios,7059,4,1,1,4,4,10,-6,4
AEK Athens,7060,1,4,2,0,7,1,6,14
PAOK Salonik,7060,2,3,2,1,11,4,7,11
Panionios,7060,3,1,1,4,4,10,-6,4
P'thinaikos,7060,4,1,1,4,4,11,-7,4
AEK Athens,7061,1,4,2,0,7,1,6,14
PAOK Salonik,7061,2,2,2,2,9,5,4,8
P'thinaikos,7061,3,2,1,3,5,9,-4,7
Panionios,7061,4,1,1,4,4,10,-6,4
AEK Athens,7062,1,4,2,0,7,1,6,14
PAOK Salonik,7062,2,2,2,2,10,6,4,8
P'thinaikos,7062,3,2,1,3,6,10,-4,7
Panionios,7062,4,1,1,4,4,10,-6,4
AEK Athens,7063,1,4,2,0,7,1,6,14
PAOK Salonik,7063,2,2,2,2,9,5,4,8
P'thinaikos,7063,3,2,1,3,5,9,-4,7
Panionios,7063,4,1,1,4,4,10,-6,4
AEK Athens,7064,1,4,2,0,7,1,6,14
PAOK Salonik,7064,2,3,2,1,11,4,7,11
Panionios,7064,3,1,1,4,4,10,-6,4
P'thinaikos,7064,4,1,1,4,4,11,-7,4
AEK Athens,7065,1,4,2,0,7,1,6,14
PAOK Salonik,7065,2,3,2,1,13,5,8,11
Panionios,7065,3,1,1,4,4,10,-6,4
P'thinaikos,7065,4,1,1,4,5,13,-8,4
AEK Athens,7066,1,4,2,0,7,1,6,14
PAOK Salonik,7066,2,3,2,1,10,4,6,11
P'thinaikos,7066,3,1,1,4,4,10,-6,4
Panionios,7066,3,1,1,4,4,10,-6,4
AEK Athens,7067,1,4,2,0,7,1,6,14
PAOK Salonik,7067,2,3,2,1,12,5,7,11
Panionios,7067,3,1,1,4,4,10,-6,4
P'thinaikos,7067,4,1,1,4,5,12,-7,4
AEK Athens,7068,1,4,2,0,7,1,6,14
PAOK Salonik,7068,2,2,2,2,10,6,4,8
P'thinaikos,7068,3,2,1,3,6,10,-4,7
Panionios,7068,4,1,1,4,4,10,-6,4
AEK Athens,7069,1,4,2,0,7,1,6,14
PAOK Salonik,7069,2,2,2,2,9,5,4,8
P'thinaikos,7069,3,2,1,3,5,9,-4,7
Panionios,7069,4,1,1,4,4,10,-6,4
AEK Athens,7070,1,4,2,0,7,1,6,14
PAOK Salonik,7070,2,2,2,2,9,6,3,8
P'thinaikos,7070,3,2,1,3,6,9,-3,7
Panionios,7070,4,1,1,4,4,10,-6,4
AEK Athens,7071,1,4,2,0,7,1,6,14
PAOK Salonik,7071,2,2,3,1,9,4,5,9
P'thinaikos,7071,3,1,2,3,4,9,-5,5
Panionios,7071,4,1,1,4,4,10,-6,4
AEK Athens,7072,1,4,2,0,7,1,6,14
PAOK Salonik,7072,2,3,2,1,12,4,8,11
Panionios,7072,3,1,1,4,4,10,-6,4
P'thinaikos,7072,4,1,1,4,4,12,-8,4
AEK Athens,7073,1,4,2,0,7,1,6,14
PAOK Salonik,7073,2,3,2,1,11,4,7,11
Panionios,7073,3,1,1,4,4,10,-6,4
P'thinaikos,7073,4,1,1,4,4,11,-7,4
AEK Athens,7074,1,4,2,0,7,1,6,14
PAOK Salonik,7074,2,3,2,1,11,4,7,11
Panionios,7074,3,1,1,4,4,10,-6,4
P'thinaikos,7074,4,1,1,4,4,11,-7,4
AEK Athens,7075,1,4,2,0,7,1,6,14
PAOK Salonik,7075,2,2,2,2,9,5,4,8
P'thinaikos,7075,3,2,1,3,5,9,-4,7
Panionios,7075,4,1,1,4,4,10,-6,4
AEK Athens,7076,1,4,2,0,7,1,6,14
PAOK Salonik,7076,2,2,2,2,9,7,2,8
P'thinaikos,7076,3,2,1,3,7,9,-2,7
Panionios,7076,4,1,1,4,4,10,-6,4
AEK Athens,7077,1,4,2,0,7,1,6,14
PAOK Salonik,7077,2,3,2,1,12,4,8,11
Panionios,7077,3,1,1,4,4,10,-6,4
P'thinaikos,7077,4,1,1,4,4,12,-8,4
AEK Athens,7078,1,4,2,0,7,1,6,14
PAOK Salonik,7078,2,2,3,1,10,5,5,9
P'thinaikos,7078,3,1,2,3,5,10,-5,5
Panionios,7078,4,1,1,4,4,10,-6,4
AEK Athens,7079,1,4,2,0,7,1,6,14
PAOK Salonik,7079,2,2,2,2,10,9,1,8
P'thinaikos,7079,3,2,1,3,9,10,-1,7
Panionios,7079,4,1,1,4,4,10,-6,4
AEK Athens,7080,1,4,2,0,7,1,6,14
PAOK Salonik,7080,2,2,2,2,9,6,3,8
P'thinaikos,7080,3,2,1,3,6,9,-3,7
Panionios,7080,4,1,1,4,4,10,-6,4
AEK Athens,7081,1,4,2,0,7,1,6,14
PAOK Salonik,7081,2,2,3,1,10,5,5,9
P'thinaikos,7081,3,1,2,3,5,10,-5,5
Panionios,7081,4,1,1,4,4,10,-6,4
AEK Athens,7082,1,4,2,0,7,1,6,14
PAOK Salonik,7082,2,3,2,1,12,4,8,11
Panionios,7082,3,1,1,4,4,10,-6,4
P'thinaikos,7082,4,1,1,4,4,12,-8,4
AEK Athens,7083,1,4,2,0,7,1,6,14
PAOK Salonik,7083,2,2,3,1,10,5,5,9
P'thinaikos,7083,3,1,2,3,5,10,-5,5
Panionios,7083,4,1,1,4,4,10,-6,4
AEK Athens,7084,1,4,2,0,7,1,6,14
PAOK Salonik,7084,2,2,2,2,9,5,4,8
P'thinaikos,7084,3,2,1,3,5,9,-4,7
Panionios,7084,4,1,1,4,4,10,-6,4
AEK Athens,7085,1,4,2,0,7,1,6,14
PAOK Salonik,7085,2,2,3,1,10,5,5,9
P'thinaikos,7085,3,1,2,3,5,10,-5,5
Panionios,7085,4,1,1,4,4,10,-6,4
AEK Athens,7086,1,4,2,0,7,1,6,14
PAOK Salonik,7086,2,2,3,1,11,6,5,9
P'thinaikos,7086,3,1,2,3,6,11,-5,5
Panionios,7086,4,1,1,4,4,10,-6,4
AEK Athens,7087,1,4,2,0,7,1,6,14
PAOK Salonik,7087,2,3,2,1,11,4,7,11
Panionios,7087,3,1,1,4,4,10,-6,4
P'thinaikos,7087,4,1,1,4,4,11,-7,4
AEK Athens,7088,1,4,2,0,7,1,6,14
PAOK Salonik,7088,2,2,2,2,9,7,2,8
P'thinaikos,7088,3,2,1,3,7,9,-2,7
Panionios,7088,4,1,1,4,4,10,-6,4
AEK Athens,7089,1,4,2,0,7,1,6,14
PAOK Salonik,7089,2,2,3,1,9,4,5,9
P'thinaikos,7089,3,1,2,3,4,9,-5,5
Panionios,7089,4,1,1,4,4,10,-6,4
AEK Athens,7090,1,4,2,0,7,1,6,14
PAOK Salonik,7090,2,3,2,1,11,4,7,11
Panionios,7090,3,1,1,4,4,10,-6,4
P'thinaikos,7090,4,1,1,4,4,11,-7,4
AEK Athens,7091,1,4,2,0,7,1,6,14
PAOK Salonik,7091,2,3,2,1,10,4,6,11
P'thinaikos,7091,3,1,1,4,4,10,-6,4
Panionios,7091,3,1,1,4,4,10,-6,4
AEK Athens,7092,1,4,2,0,7,1,6,14
PAOK Salonik,7092,2,2,2,2,9,5,4,8
P'thinaikos,7092,3,2,1,3,5,9,-4,7
Panionios,7092,4,1,1,4,4,10,-6,4
AEK Athens,7093,1,4,2,0,7,1,6,14
PAOK Salonik,7093,2,2,3,1,9,4,5,9
P'thinaikos,7093,3,1,2,3,4,9,-5,5
Panionios,7093,4,1,1,4,4,10,-6,4
AEK Athens,7094,1,4,2,0,7,1,6,14
PAOK Salonik,7094,2,2,2,2,10,7,3,8
P'thinaikos,7094,3,2,1,3,7,10,-3,7
Panionios,7094,4,1,1,4,4,10,-6,4
AEK Athens,7095,1,4,2,0,7,1,6,14
PAOK Salonik,7095,2,2,2,2,9,7,2,8
P'thinaikos,7095,3,2,1,3,7,9,-2,7
Panionios,7095,4,1,1,4,4,10,-6,4
AEK Athens,7096,1,4,2,0,7,1,6,14
PAOK Salonik,7096,2,2,3,1,9,4,5,9
P'thinaikos,7096,3,1,2,3,4,9,-5,5
Panionios,7096,4,1,1,4,4,10,-6,4
AEK Athens,7097,1,4,2,0,7,1,6,14
PAOK Salonik,7097,2,2,2,2,9,5,4,8
P'thinaikos,7097,3,2,1,3,5,9,-4,7
Panionios,7097,4,1,1,4,4,10,-6,4
AEK Athens,7098,1,4,2,0,7,1,6,14
PAOK Salonik,7098,2,2,2,2,9,7,2,8
P'thinaikos,7098,3,2,1,3,7,9,-2,7
Panionios,7098,4,1,1,4,4,10,-6,4
AEK Athens,7099,1,4,2,0,7,1,6,14
PAOK Salonik,7099,2,3,2,1,13,5,8,11
Panionios,7099,3,1,1,4,4,10,-6,4
P'thinaikos,7099,4,1,1,4,5,13,-8,4
AEK Athens,7100,1,4,2,0,7,1,6,14
PAOK Salonik,7100,2,3,2,1,12,5,7,11
Panionios,7100,3,1,1,4,4,10,-6,4
P'thinaikos,7100,4,1,1,4,5,12,-7,4
AEK Athens,7101,1,4,2,0,7,1,6,14
PAOK Salonik,7101,2,2,2,2,9,5,4,8
P'thinaikos,7101,3,2,1,3,5,9,-4,7
Panionios,7101,4,1,1,4,4,10,-6,4
AEK Athens,7102,1,4,2,0,7,1,6,14
PAOK Salonik,7102,2,2,2,2,9,9,0,8
P'thinaikos,7102,3,2,1,3,9,9,0,7
Panionios,7102,4,1,1,4,4,10,-6,4
AEK Athens,7103,1,4,2,0,7,1,6,14
PAOK Salonik,7103,2,3,2,1,10,4,6,11
P'thinaikos,7103,3,1,1,4,4,10,-6,4
Panionios,7103,3,1,1,4,4,10,-6,4
AEK Athens,7104,1,4,2,0,7,1,6,14
PAOK Salonik,7104,2,2,2,2,9,6,3,8
P'thinaikos,7104,3,2,1,3,6,9,-3,7
Panionios,7104,4,1,1,4,4,10,-6,4
AEK Athens,7105,1,4,2,0,7,1,6,14
PAOK Salonik,7105,2,2,2,2,11,7,4,8
P'thinaikos,7105,3,2,1,3,7,11,-4,7
Panionios,7105,4,1,1,4,4,10,-6,4
AEK Athens,7106,1,4,2,0,7,1,6,14
PAOK Salonik,7106,2,2,2,2,9,6,3,8
P'thinaikos,7106,3,2,1,3,6,9,-3,7
Panionios,7106,4,1,1,4,4,10,-6,4
AEK Athens,7107,1,4,2,0,7,1,6,14
PAOK Salonik,7107,2,3,2,1,10,4,6,11
P'thinaikos,7107,3,1,1,4,4,10,-6,4
Panionios,7107,3,1,1,4,4,10,-6,4
AEK Athens,7108,1,4,2,0,7,1,6,14
PAOK Salonik,7108,2,2,3,1,9,4,5,9
P'thinaikos,7108,3,1,2,3,4,9,-5,5
Panionios,7108,4,1,1,4,4,10,-6,4
AEK Athens,7109,1,4,2,0,7,1,6,14
PAOK Salonik,7109,2,2,2,2,11,7,4,8
P'thinaikos,7109,3,2,1,3,7,11,-4,7
Panionios,7109,4,1,1,4,4,10,-6,4
AEK Athens,7110,1,4,2,0,7,1,6,14
PAOK Salonik,7110,2,2,3,1,10,5,5,9
P'thinaikos,7110,3,1,2,3,5,10,-5,5
Panionios,7110,4,1,1,4,4,10,-6,4
AEK Athens,7111,1,4,2,0,7,1,6,14
PAOK Salonik,7111,2,2,3,1,10,5,5,9
P'thinaikos,7111,3,1,2,3,5,10,-5,5
Panionios,7111,4,1,1,4,4,10,-6,4
AEK Athens,7112,1,4,2,0,7,1,6,14
PAOK Salonik,7112,2,3,2,1,11,5,6,11
P'thinaikos,7112,3,1,1,4,5,11,-6,4
Panionios,7112,4,1,1,4,4,10,-6,4
AEK Athens,7113,1,4,2,0,7,1,6,14
PAOK Salonik,7113,2,3,2,1,12,6,6,11
P'thinaikos,7113,3,1,1,4,6,12,-6,4
Panionios,7113,4,1,1,4,4,10,-6,4
AEK Athens,7114,1,4,2,0,7,1,6,14
PAOK Salonik,7114,2,2,3,1,9,4,5,9
P'thinaikos,7114,3,1,2,3,4,9,-5,5
Panionios,7114,4,1,1,4,4,10,-6,4
AEK Athens,7115,1,4,2,0,7,1,6,14
PAOK Salonik,7115,2,2,3,1,10,5,5,9
P'thinaikos,7115,3,1,2,3,5,10,-5,5
Panionios,7115,4,1,1,4,4,10,-6,4
AEK Athens,7116,1,4,2,0,7,1,6,14
PAOK Salonik,7116,2,3,2,1,12,6,6,11
P'thinaikos,7116,3,1,1,4,6,12,-6,4
Panionios,7116,4,1,1,4,4,10,-6,4
AEK Athens,7117,1,4,2,0,7,1,6,14
PAOK Salonik,7117,2,3,2,1,11,4,7,11
Panionios,7117,3,1,1,4,4,10,-6,4
P'thinaikos,7117,4,1,1,4,4,11,-7,4
AEK Athens,7118,1,4,2,0,7,1,6,14
PAOK Salonik,7118,2,3,2,1,12,5,7,11
Panionios,7118,3,1,1,4,4,10,-6,4
P'thinaikos,7118,4,1,1,4,5,12,-7,4
AEK Athens,7119,1,4,2,0,7,1,6,14
PAOK Salonik,7119,2,3,2,1,11,4,7,11
Panionios,7119,3,1,1,4,4,10,-6,4
P'thinaikos,7119,4,1,1,4,4,11,-7,4
AEK Athens,7120,1,4,2,0,7,1,6,14
PAOK Salonik,7120,2,2,2,2,10,8,2,8
P'thinaikos,7120,3,2,1,3,8,10,-2,7
Panionios,7120,4,1,1,4,4,10,-6,4
AEK Athens,7121,1,4,2,0,7,1,6,14
PAOK Salonik,7121,2,2,3,1,10,5,5,9
P'thinaikos,7121,3,1,2,3,5,10,-5,5
Panionios,7121,4,1,1,4,4,10,-6,4
AEK Athens,7122,1,4,2,0,7,1,6,14
PAOK Salonik,7122,2,2,3,1,9,4,5,9
P'thinaikos,7122,3,1,2,3,4,9,-5,5
Panionios,7122,4,1,1,4,4,10,-6,4
AEK Athens,7123,1,4,2,0,7,1,6,14
PAOK Salonik,7123,2,3,2,1,10,4,6,11
P'thinaikos,7123,3,1,1,4,4,10,-6,4
Panionios,7123,3,1,1,4,4,10,-6,4
AEK Athens,7124,1,4,2,0,7,1,6,14
PAOK Salonik,7124,2,2,2,2,10,6,4,8
P'thinaikos,7124,3,2,1,3,6,10,-4,7
Panionios,7124,4,1,1,4,4,10,-6,4
AEK Athens,7125,1,4,2,0,7,1,6,14
PAOK Salonik,7125,2,2,2,2,9,5,4,8
P'thinaikos,7125,3,2,1,3,5,9,-4,7
Panionios,7125,4,1,1,4,4,10,-6,4
AEK Athens,7126,1,4,2,0,7,1,6,14
PAOK Salonik,7126,2,2,2,2,10,6,4,8
P'thinaikos,7126,3,2,1,3,6,10,-4,7
Panionios,7126,4,1,1,4,4,10,-6,4
AEK Athens,7127,1,4,2,0,7,1,6,14
PAOK Salonik,7127,2,2,2,2,9,6,3,8
P'thinaikos,7127,3,2,1,3,6,9,-3,7
Panionios,7127,4,1,1,4,4,10,-6,4
AEK Athens,7128,1,4,2,0,7,1,6,14
PAOK Salonik,7128,2,2,3,1,11,6,5,9
P'thinaikos,7128,3,1,2,3,6,11,-5,5
Panionios,7128,4,1,1,4,4,10,-6,4
AEK Athens,7129,1,4,2,0,7,1,6,14
PAOK Salonik,7129,2,2,2,2,9,6,3,8
P'thinaikos,7129,3,2,1,3,6,9,-3,7
Panionios,7129,4,1,1,4,4,10,-6,4
AEK Athens,7130,1,4,2,0,7,1,6,14
PAOK Salonik,7130,2,3,2,1,11,4,7,11
Panionios,7130,3,1,1,4,4,10,-6,4
P'thinaikos,7130,4,1,1,4,4,11,-7,4
AEK Athens,7131,1,4,2,0,7,1,6,14
PAOK Salonik,7131,2,2,2,2,9,8,1,8
P'thinaikos,7131,3,2,1,3,8,9,-1,7
Panionios,7131,4,1,1,4,4,10,-6,4
AEK Athens,7132,1,4,2,0,7,1,6,14
PAOK Salonik,7132,2,2,2,2,10,7,3,8
P'thinaikos,7132,3,2,1,3,7,10,-3,7
Panionios,7132,4,1,1,4,4,10,-6,4
AEK Athens,7133,1,4,2,0,7,1,6,14
PAOK Salonik,7133,2,2,3,1,9,4,5,9
P'thinaikos,7133,3,1,2,3,4,9,-5,5
Panionios,7133,4,1,1,4,4,10,-6,4
AEK Athens,7134,1,4,2,0,7,1,6,14
PAOK Salonik,7134,2,2,3,1,11,6,5,9
P'thinaikos,7134,3,1,2,3,6,11,-5,5
Panionios,7134,4,1,1,4,4,10,-6,4
AEK Athens,7135,1,4,2,0,7,1,6,14
PAOK Salonik,7135,2,2,3,1,11,6,5,9
P'thinaikos,7135,3,1,2,3,6,11,-5,5
Panionios,7135,4,1,1,4,4,10,-6,4
AEK Athens,7136,1,4,2,0,7,1,6,14
PAOK Salonik,7136,2,2,2,2,12,8,4,8
P'thinaikos,7136,3,2,1,3,8,12,-4,7
Panionios,7136,4,1,1,4,4,10,-6,4
AEK Athens,7137,1,4,2,0,7,1,6,14
PAOK Salonik,7137,2,3,2,1,10,4,6,11
P'thinaikos,7137,3,1,1,4,4,10,-6,4
Panionios,7137,3,1,1,4,4,10,-6,4
AEK Athens,7138,1,4,2,0,7,1,6,14
PAOK Salonik,7138,2,3,2,1,12,5,7,11
Panionios,7138,3,1,1,4,4,10,-6,4
P'thinaikos,7138,4,1,1,4,5,12,-7,4
AEK Athens,7139,1,4,2,0,7,1,6,14
PAOK Salonik,7139,2,2,2,2,10,6,4,8
P'thinaikos,7139,3,2,1,3,6,10,-4,7
Panionios,7139,4,1,1,4,4,10,-6,4
AEK Athens,7140,1,4,2,0,7,1,6,14
PAOK Salonik,7140,2,2,2,2,9,5,4,8
P'thinaikos,7140,3,2,1,3,5,9,-4,7
Panionios,7140,4,1,1,4,4,10,-6,4
AEK Athens,7141,1,4,2,0,7,1,6,14
PAOK Salonik,7141,2,3,2,1,11,5,6,11
P'thinaikos,7141,3,1,1,4,5,11,-6,4
Panionios,7141,4,1,1,4,4,10,-6,4
AEK Athens,7142,1,4,2,0,7,1,6,14
PAOK Salonik,7142,2,2,2,2,9,6,3,8
P'thinaikos,7142,3,2,1,3,6,9,-3,7
Panionios,7142,4,1,1,4,4,10,-6,4
AEK Athens,7143,1,4,2,0,7,1,6,14
PAOK Salonik,7143,2,2,3,1,10,5,5,9
P'thinaikos,7143,3,1,2,3,5,10,-5,5
Panionios,7143,4,1,1,4,4,10,-6,4
AEK Athens,7144,1,4,2,0,7,1,6,14
PAOK Salonik,7144,2,2,3,1,9,4,5,9
P'thinaikos,7144,3,1,2,3,4,9,-5,5
Panionios,7144,4,1,1,4,4,10,-6,4
AEK Athens,7145,1,4,2,0,7,1,6,14
PAOK Salonik,7145,2,2,2,2,9,6,3,8
P'thinaikos,7145,3,2,1,3,6,9,-3,7
Panionios,7145,4,1,1,4,4,10,-6,4
AEK Athens,7146,1,4,2,0,7,1,6,14
PAOK Salonik,7146,2,2,3,1,13,8,5,9
P'thinaikos,7146,3,1,2,3,8,13,-5,5
Panionios,7146,4,1,1,4,4,10,-6,4
AEK Athens,7147,1,4,2,0,7,1,6,14
PAOK Salonik,7147,2,2,2,2,10,6,4,8
P'thinaikos,7147,3,2,1,3,6,10,-4,7
Panionios,7147,4,1,1,4,4,10,-6,4
AEK Athens,7148,1,4,2,0,7,1,6,14
PAOK Salonik,7148,2,2,2,2,10,8,2,8
P'thinaikos,7148,3,2,1,3,8,10,-2,7
Panionios,7148,4,1,1,4,4,10,-6,4
AEK Athens,7149,1,4,2,0,7,1,6,14
PAOK Salonik,7149,2,2,2,2,9,5,4,8
P'thinaikos,7149,3,2,1,3,5,9,-4,7
Panionios,7149,4,1,1,4,4,10,-6,4
AEK Athens,7150,1,4,2,0,7,1,6,14
PAOK Salonik,7150,2,2,2,2,9,5,4,8
P'thinaikos,7150,3,2,1,3,5,9,-4,7
Panionios,7150,4,1,1,4,4,10,-6,4
AEK Athens,7151,1,4,2,0,7,1,6,14
PAOK Salonik,7151,2,2,3,1,9,4,5,9
P'thinaikos,7151,3,1,2,3,4,9,-5,5
Panionios,7151,4,1,1,4,4,10,-6,4
AEK Athens,7152,1,4,2,0,7,1,6,14
PAOK Salonik,7152,2,3,2,1,11,4,7,11
Panionios,7152,3,1,1,4,4,10,-6,4
P'thinaikos,7152,4,1,1,4,4,11,-7,4
AEK Athens,7153,1,4,2,0,7,1,6,14
PAOK Salonik,7153,2,2,3,1,10,5,5,9
P'thinaikos,7153,3,1,2,3,5,10,-5,5
Panionios,7153,4,1,1,4,4,10,-6,4
AEK Athens,7154,1,4,2,0,7,1,6,14
PAOK Salonik,7154,2,3,2,1,12,5,7,11
Panionios,7154,3,1,1,4,4,10,-6,4
P'thinaikos,7154,4,1,1,4,5,12,-7,4
AEK Athens,7155,1,4,2,0,7,1,6,14
PAOK Salonik,7155,2,2,3,1,10,5,5,9
P'thinaikos,7155,3,1,2,3,5,10,-5,5
Panionios,7155,4,1,1,4,4,10,-6,4
AEK Athens,7156,1,4,2,0,7,1,6,14
PAOK Salonik,7156,2,2,2,2,9,5,4,8
P'thinaikos,7156,3,2,1,3,5,9,-4,7
Panionios,7156,4,1,1,4,4,10,-6,4
AEK Athens,7157,1,4,2,0,7,1,6,14
PAOK Salonik,7157,2,3,2,1,11,5,6,11
P'thinaikos,7157,3,1,1,4,5,11,-6,4
Panionios,7157,4,1,1,4,4,10,-6,4
AEK Athens,7158,1,4,2,0,7,1,6,14
PAOK Salonik,7158,2,2,2,2,11,7,4,8
P'thinaikos,7158,3,2,1,3,7,11,-4,7
Panionios,7158,4,1,1,4,4,10,-6,4
AEK Athens,7159,1,4,2,0,7,1,6,14
PAOK Salonik,7159,2,2,2,2,9,5,4,8
P'thinaikos,7159,3,2,1,3,5,9,-4,7
Panionios,7159,4,1,1,4,4,10,-6,4
AEK Athens,7160,1,4,2,0,7,1,6,14
PAOK Salonik,7160,2,3,2,1,10,4,6,11
P'thinaikos,7160,3,1,1,4,4,10,-6,4
Panionios,7160,3,1,1,4,4,10,-6,4
AEK Athens,7161,1,4,2,0,7,1,6,14
PAOK Salonik,7161,2,2,3,1,10,5,5,9
P'thinaikos,7161,3,1,2,3,5,10,-5,5
Panionios,7161,4,1,1,4,4,10,-6,4
AEK Athens,7162,1,4,2,0,7,1,6,14
PAOK Salonik,7162,2,2,3,1,11,6,5,9
P'thinaikos,7162,3,1,2,3,6,11,-5,5
Panionios,7162,4,1,1,4,4,10,-6,4
AEK Athens,7163,1,4,2,0,7,1,6,14
PAOK Salonik,7163,2,2,2,2,9,5,4,8
P'thinaikos,7163,3,2,1,3,5,9,-4,7
Panionios,7163,4,1,1,4,4,10,-6,4
AEK Athens,7164,1,4,2,0,7,1,6,14
PAOK Salonik,7164,2,2,3,1,9,4,5,9
P'thinaikos,7164,3,1,2,3,4,9,-5,5
Panionios,7164,4,1,1,4,4,10,-6,4
AEK Athens,7165,1,4,2,0,7,1,6,14
PAOK Salonik,7165,2,2,2,2,11,8,3,8
P'thinaikos,7165,3,2,1,3,8,11,-3,7
Panionios,7165,4,1,1,4,4,10,-6,4
AEK Athens,7166,1,4,2,0,7,1,6,14
PAOK Salonik,7166,2,2,3,1,10,5,5,9
P'thinaikos,7166,3,1,2,3,5,10,-5,5
Panionios,7166,4,1,1,4,4,10,-6,4
AEK Athens,7167,1,4,2,0,7,1,6,14
PAOK Salonik,7167,2,2,2,2,11,7,4,8
P'thinaikos,7167,3,2,1,3,7,11,-4,7
Panionios,7167,4,1,1,4,4,10,-6,4
AEK Athens,7168,1,4,2,0,7,1,6,14
PAOK Salonik,7168,2,2,3,1,11,6,5,9
P'thinaikos,7168,3,1,2,3,6,11,-5,5
Panionios,7168,4,1,1,4,4,10,-6,4
AEK Athens,7169,1,4,2,0,7,1,6,14
PAOK Salonik,7169,2,2,3,1,10,5,5,9
P'thinaikos,7169,3,1,2,3,5,10,-5,5
Panionios,7169,4,1,1,4,4,10,-6,4
AEK Athens,7170,1,4,2,0,7,1,6,14
PAOK Salonik,7170,2,2,3,1,9,4,5,9
P'thinaikos,7170,3,1,2,3,4,9,-5,5
Panionios,7170,4,1,1,4,4,10,-6,4
AEK Athens,7171,1,4,2,0,7,1,6,14
PAOK Salonik,7171,2,2,2,2,9,6,3,8
P'thinaikos,7171,3,2,1,3,6,9,-3,7
Panionios,7171,4,1,1,4,4,10,-6,4
AEK Athens,7172,1,4,2,0,7,1,6,14
PAOK Salonik,7172,2,3,2,1,10,4,6,11
P'thinaikos,7172,3,1,1,4,4,10,-6,4
Panionios,7172,3,1,1,4,4,10,-6,4
AEK Athens,7173,1,4,2,0,7,1,6,14
PAOK Salonik,7173,2,3,2,1,11,5,6,11
P'thinaikos,7173,3,1,1,4,5,11,-6,4
Panionios,7173,4,1,1,4,4,10,-6,4
AEK Athens,7174,1,4,2,0,7,1,6,14
PAOK Salonik,7174,2,2,3,1,10,5,5,9
P'thinaikos,7174,3,1,2,3,5,10,-5,5
Panionios,7174,4,1,1,4,4,10,-6,4
AEK Athens,7175,1,4,2,0,7,1,6,14
PAOK Salonik,7175,2,2,2,2,9,5,4,8
P'thinaikos,7175,3,2,1,3,5,9,-4,7
Panionios,7175,4,1,1,4,4,10,-6,4
AEK Athens,7176,1,4,2,0,7,1,6,14
PAOK Salonik,7176,2,3,2,1,11,4,7,11
Panionios,7176,3,1,1,4,4,10,-6,4
P'thinaikos,7176,4,1,1,4,4,11,-7,4
AEK Athens,7177,1,4,2,0,7,1,6,14
PAOK Salonik,7177,2,2,3,1,10,5,5,9
P'thinaikos,7177,3,1,2,3,5,10,-5,5
Panionios,7177,4,1,1,4,4,10,-6,4
AEK Athens,7178,1,4,2,0,7,1,6,14
PAOK Salonik,7178,2,2,2,2,9,6,3,8
P'thinaikos,7178,3,2,1,3,6,9,-3,7
Panionios,7178,4,1,1,4,4,10,-6,4
AEK Athens,7179,1,4,2,0,7,1,6,14
PAOK Salonik,7179,2,2,3,1,10,5,5,9
P'thinaikos,7179,3,1,2,3,5,10,-5,5
Panionios,7179,4,1,1,4,4,10,-6,4
AEK Athens,7180,1,4,2,0,7,1,6,14
PAOK Salonik,7180,2,3,2,1,12,5,7,11
Panionios,7180,3,1,1,4,4,10,-6,4
P'thinaikos,7180,4,1,1,4,5,12,-7,4
AEK Athens,7181,1,4,2,0,7,1,6,14
PAOK Salonik,7181,2,2,3,1,11,6,5,9
P'thinaikos,7181,3,1,2,3,6,11,-5,5
Panionios,7181,4,1,1,4,4,10,-6,4
AEK Athens,7182,1,4,2,0,7,1,6,14
PAOK Salonik,7182,2,2,2,2,10,7,3,8
P'thinaikos,7182,3,2,1,3,7,10,-3,7
Panionios,7182,4,1,1,4,4,10,-6,4
AEK Athens,7183,1,4,2,0,7,1,6,14
PAOK Salonik,7183,2,2,2,2,9,6,3,8
P'thinaikos,7183,3,2,1,3,6,9,-3,7
Panionios,7183,4,1,1,4,4,10,-6,4
AEK Athens,7184,1,4,2,0,7,1,6,14
PAOK Salonik,7184,2,3,2,1,11,4,7,11
Panionios,7184,3,1,1,4,4,10,-6,4
P'thinaikos,7184,4,1,1,4,4,11,-7,4
AEK Athens,7185,1,4,2,0,7,1,6,14
PAOK Salonik,7185,2,3,2,1,13,4,9,11
Panionios,7185,3,1,1,4,4,10,-6,4
P'thinaikos,7185,4,1,1,4,4,13,-9,4
AEK Athens,7186,1,4,2,0,7,1,6,14
PAOK Salonik,7186,2,3,2,1,11,4,7,11
Panionios,7186,3,1,1,4,4,10,-6,4
P'thinaikos,7186,4,1,1,4,4,11,-7,4
AEK Athens,7187,1,4,2,0,7,1,6,14
PAOK Salonik,7187,2,2,3,1,11,6,5,9
P'thinaikos,7187,3,1,2,3,6,11,-5,5
Panionios,7187,4,1,1,4,4,10,-6,4
AEK Athens,7188,1,4,2,0,7,1,6,14
PAOK Salonik,7188,2,2,2,2,10,7,3,8
P'thinaikos,7188,3,2,1,3,7,10,-3,7
Panionios,7188,4,1,1,4,4,10,-6,4
AEK Athens,7189,1,4,2,0,7,1,6,14
PAOK Salonik,7189,2,2,2,2,10,6,4,8
P'thinaikos,7189,3,2,1,3,6,10,-4,7
Panionios,7189,4,1,1,4,4,10,-6,4
AEK Athens,7190,1,4,2,0,7,1,6,14
PAOK Salonik,7190,2,3,2,1,12,6,6,11
P'thinaikos,7190,3,1,1,4,6,12,-6,4
Panionios,7190,4,1,1,4,4,10,-6,4
AEK Athens,7191,1,4,2,0,7,1,6,14
PAOK Salonik,7191,2,2,3,1,12,7,5,9
P'thinaikos,7191,3,1,2,3,7,12,-5,5
Panionios,7191,4,1,1,4,4,10,-6,4
AEK Athens,7192,1,4,2,0,7,1,6,14
PAOK Salonik,7192,2,3,2,1,12,6,6,11
P'thinaikos,7192,3,1,1,4,6,12,-6,4
Panionios,7192,4,1,1,4,4,10,-6,4
AEK Athens,7193,1,4,2,0,7,1,6,14
PAOK Salonik,7193,2,3,2,1,10,4,6,11
P'thinaikos,7193,3,1,1,4,4,10,-6,4
Panionios,7193,3,1,1,4,4,10,-6,4
AEK Athens,7194,1,4,2,0,7,1,6,14
PAOK Salonik,7194,2,3,2,1,10,4,6,11
P'thinaikos,7194,3,1,1,4,4,10,-6,4
Panionios,7194,3,1,1,4,4,10,-6,4
AEK Athens,7195,1,4,2,0,7,1,6,14
PAOK Salonik,7195,2,3,2,1,10,4,6,11
P'thinaikos,7195,3,1,1,4,4,10,-6,4
Panionios,7195,3,1,1,4,4,10,-6,4
AEK Athens,7196,1,4,2,0,7,1,6,14
PAOK Salonik,7196,2,2,3,1,11,6,5,9
P'thinaikos,7196,3,1,2,3,6,11,-5,5
Panionios,7196,4,1,1,4,4,10,-6,4
AEK Athens,7197,1,4,2,0,7,1,6,14
PAOK Salonik,7197,2,2,2,2,9,5,4,8
P'thinaikos,7197,3,2,1,3,5,9,-4,7
Panionios,7197,4,1,1,4,4,10,-6,4
AEK Athens,7198,1,4,2,0,7,1,6,14
PAOK Salonik,7198,2,2,2,2,9,5,4,8
P'thinaikos,7198,3,2,1,3,5,9,-4,7
Panionios,7198,4,1,1,4,4,10,-6,4
AEK Athens,7199,1,4,2,0,7,1,6,14
PAOK Salonik,7199,2,3,2,1,12,5,7,11
Panionios,7199,3,1,1,4,4,10,-6,4
P'thinaikos,7199,4,1,1,4,5,12,-7,4
AEK Athens,7200,1,4,2,0,7,1,6,14
PAOK Salonik,7200,2,2,2,2,9,5,4,8
P'thinaikos,7200,3,2,1,3,5,9,-4,7
Panionios,7200,4,1,1,4,4,10,-6,4
AEK Athens,7201,1,4,2,0,7,1,6,14
PAOK Salonik,7201,2,2,3,1,9,4,5,9
P'thinaikos,7201,3,1,2,3,4,9,-5,5
Panionios,7201,4,1,1,4,4,10,-6,4
AEK Athens,7202,1,4,2,0,7,1,6,14
PAOK Salonik,7202,2,2,2,2,10,7,3,8
P'thinaikos,7202,3,2,1,3,7,10,-3,7
Panionios,7202,4,1,1,4,4,10,-6,4
AEK Athens,7203,1,4,2,0,7,1,6,14
PAOK Salonik,7203,2,3,2,1,12,6,6,11
P'thinaikos,7203,3,1,1,4,6,12,-6,4
Panionios,7203,4,1,1,4,4,10,-6,4
AEK Athens,7204,1,4,2,0,7,1,6,14
PAOK Salonik,7204,2,2,2,2,9,8,1,8
P'thinaikos,7204,3,2,1,3,8,9,-1,7
Panionios,7204,4,1,1,4,4,10,-6,4
AEK Athens,7205,1,4,2,0,7,1,6,14
PAOK Salonik,7205,2,3,2,1,10,4,6,11
P'thinaikos,7205,3,1,1,4,4,10,-6,4
Panionios,7205,3,1,1,4,4,10,-6,4
AEK Athens,7206,1,4,2,0,7,1,6,14
PAOK Salonik,7206,2,2,3,1,10,5,5,9
P'thinaikos,7206,3,1,2,3,5,10,-5,5
Panionios,7206,4,1,1,4,4,10,-6,4
AEK Athens,7207,1,4,2,0,7,1,6,14
PAOK Salonik,7207,2,3,2,1,10,4,6,11
P'thinaikos,7207,3,1,1,4,4,10,-6,4
Panionios,7207,3,1,1,4,4,10,-6,4
AEK Athens,7208,1,4,2,0,7,1,6,14
PAOK Salonik,7208,2,2,3,1,9,4,5,9
P'thinaikos,7208,3,1,2,3,4,9,-5,5
Panionios,7208,4,1,1,4,4,10,-6,4
AEK Athens,7209,1,4,2,0,7,1,6,14
PAOK Salonik,7209,2,2,3,1,11,6,5,9
P'thinaikos,7209,3,1,2,3,6,11,-5,5
Panionios,7209,4,1,1,4,4,10,-6,4
AEK Athens,7210,1,4,2,0,7,1,6,14
PAOK Salonik,7210,2,3,2,1,11,4,7,11
Panionios,7210,3,1,1,4,4,10,-6,4
P'thinaikos,7210,4,1,1,4,4,11,-7,4
AEK Athens,7211,1,4,2,0,7,1,6,14
PAOK Salonik,7211,2,2,2,2,9,6,3,8
P'thinaikos,7211,3,2,1,3,6,9,-3,7
Panionios,7211,4,1,1,4,4,10,-6,4
AEK Athens,7212,1,4,2,0,7,1,6,14
PAOK Salonik,7212,2,3,2,1,11,5,6,11
P'thinaikos,7212,3,1,1,4,5,11,-6,4
Panionios,7212,4,1,1,4,4,10,-6,4
AEK Athens,7213,1,4,2,0,7,1,6,14
PAOK Salonik,7213,2,2,2,2,9,5,4,8
P'thinaikos,7213,3,2,1,3,5,9,-4,7
Panionios,7213,4,1,1,4,4,10,-6,4
AEK Athens,7214,1,4,2,0,7,1,6,14
PAOK Salonik,7214,2,2,2,2,11,7,4,8
P'thinaikos,7214,3,2,1,3,7,11,-4,7
Panionios,7214,4,1,1,4,4,10,-6,4
AEK Athens,7215,1,4,2,0,7,1,6,14
PAOK Salonik,7215,2,2,3,1,11,6,5,9
P'thinaikos,7215,3,1,2,3,6,11,-5,5
Panionios,7215,4,1,1,4,4,10,-6,4
AEK Athens,7216,1,4,2,0,7,1,6,14
PAOK Salonik,7216,2,2,2,2,10,6,4,8
P'thinaikos,7216,3,2,1,3,6,10,-4,7
Panionios,7216,4,1,1,4,4,10,-6,4
AEK Athens,7217,1,4,2,0,7,1,6,14
PAOK Salonik,7217,2,2,2,2,10,6,4,8
P'thinaikos,7217,3,2,1,3,6,10,-4,7
Panionios,7217,4,1,1,4,4,10,-6,4
AEK Athens,7218,1,4,2,0,7,1,6,14
PAOK Salonik,7218,2,3,2,1,11,5,6,11
P'thinaikos,7218,3,1,1,4,5,11,-6,4
Panionios,7218,4,1,1,4,4,10,-6,4
AEK Athens,7219,1,4,2,0,7,1,6,14
PAOK Salonik,7219,2,2,3,1,10,5,5,9
P'thinaikos,7219,3,1,2,3,5,10,-5,5
Panionios,7219,4,1,1,4,4,10,-6,4
AEK Athens,7220,1,4,2,0,7,1,6,14
PAOK Salonik,7220,2,2,2,2,11,7,4,8
P'thinaikos,7220,3,2,1,3,7,11,-4,7
Panionios,7220,4,1,1,4,4,10,-6,4
AEK Athens,7221,1,4,2,0,7,1,6,14
PAOK Salonik,7221,2,3,2,1,13,5,8,11
Panionios,7221,3,1,1,4,4,10,-6,4
P'thinaikos,7221,4,1,1,4,5,13,-8,4
AEK Athens,7222,1,4,2,0,7,1,6,14
PAOK Salonik,7222,2,3,2,1,10,4,6,11
P'thinaikos,7222,3,1,1,4,4,10,-6,4
Panionios,7222,3,1,1,4,4,10,-6,4
AEK Athens,7223,1,4,2,0,7,1,6,14
PAOK Salonik,7223,2,3,2,1,10,4,6,11
P'thinaikos,7223,3,1,1,4,4,10,-6,4
Panionios,7223,3,1,1,4,4,10,-6,4
AEK Athens,7224,1,4,2,0,7,1,6,14
PAOK Salonik,7224,2,2,2,2,9,7,2,8
P'thinaikos,7224,3,2,1,3,7,9,-2,7
Panionios,7224,4,1,1,4,4,10,-6,4
AEK Athens,7225,1,4,2,0,7,1,6,14
PAOK Salonik,7225,2,3,2,1,10,4,6,11
P'thinaikos,7225,3,1,1,4,4,10,-6,4
Panionios,7225,3,1,1,4,4,10,-6,4
AEK Athens,7226,1,4,2,0,7,1,6,14
PAOK Salonik,7226,2,2,3,1,9,4,5,9
P'thinaikos,7226,3,1,2,3,4,9,-5,5
Panionios,7226,4,1,1,4,4,10,-6,4
AEK Athens,7227,1,4,2,0,7,1,6,14
PAOK Salonik,7227,2,2,2,2,10,7,3,8
P'thinaikos,7227,3,2,1,3,7,10,-3,7
Panionios,7227,4,1,1,4,4,10,-6,4
AEK Athens,7228,1,4,2,0,7,1,6,14
PAOK Salonik,7228,2,2,3,1,10,5,5,9
P'thinaikos,7228,3,1,2,3,5,10,-5,5
Panionios,7228,4,1,1,4,4,10,-6,4
AEK Athens,7229,1,4,2,0,7,1,6,14
PAOK Salonik,7229,2,2,2,2,11,7,4,8
P'thinaikos,7229,3,2,1,3,7,11,-4,7
Panionios,7229,4,1,1,4,4,10,-6,4
AEK Athens,7230,1,4,2,0,7,1,6,14
PAOK Salonik,7230,2,3,2,1,11,4,7,11
Panionios,7230,3,1,1,4,4,10,-6,4
P'thinaikos,7230,4,1,1,4,4,11,-7,4
AEK Athens,7231,1,4,2,0,7,1,6,14
PAOK Salonik,7231,2,3,2,1,12,6,6,11
P'thinaikos,7231,3,1,1,4,6,12,-6,4
Panionios,7231,4,1,1,4,4,10,-6,4
AEK Athens,7232,1,4,2,0,7,1,6,14
PAOK Salonik,7232,2,2,2,2,9,5,4,8
P'thinaikos,7232,3,2,1,3,5,9,-4,7
Panionios,7232,4,1,1,4,4,10,-6,4
AEK Athens,7233,1,4,2,0,7,1,6,14
PAOK Salonik,7233,2,3,2,1,11,4,7,11
Panionios,7233,3,1,1,4,4,10,-6,4
P'thinaikos,7233,4,1,1,4,4,11,-7,4
AEK Athens,7234,1,4,2,0,7,1,6,14
PAOK Salonik,7234,2,2,2,2,9,7,2,8
P'thinaikos,7234,3,2,1,3,7,9,-2,7
Panionios,7234,4,1,1,4,4,10,-6,4
AEK Athens,7235,1,4,2,0,7,1,6,14
PAOK Salonik,7235,2,2,2,2,10,6,4,8
P'thinaikos,7235,3,2,1,3,6,10,-4,7
Panionios,7235,4,1,1,4,4,10,-6,4
AEK Athens,7236,1,4,2,0,7,1,6,14
PAOK Salonik,7236,2,2,2,2,9,5,4,8
P'thinaikos,7236,3,2,1,3,5,9,-4,7
Panionios,7236,4,1,1,4,4,10,-6,4
AEK Athens,7237,1,4,2,0,7,1,6,14
PAOK Salonik,7237,2,3,2,1,10,4,6,11
P'thinaikos,7237,3,1,1,4,4,10,-6,4
Panionios,7237,3,1,1,4,4,10,-6,4
AEK Athens,7238,1,4,2,0,7,1,6,14
PAOK Salonik,7238,2,3,2,1,10,4,6,11
P'thinaikos,7238,3,1,1,4,4,10,-6,4
Panionios,7238,3,1,1,4,4,10,-6,4
AEK Athens,7239,1,4,2,0,7,1,6,14
PAOK Salonik,7239,2,2,3,1,10,5,5,9
P'thinaikos,7239,3,1,2,3,5,10,-5,5
Panionios,7239,4,1,1,4,4,10,-6,4
AEK Athens,7240,1,4,2,0,7,1,6,14
PAOK Salonik,7240,2,2,2,2,11,8,3,8
P'thinaikos,7240,3,2,1,3,8,11,-3,7
Panionios,7240,4,1,1,4,4,10,-6,4
AEK Athens,7241,1,4,2,0,7,1,6,14
PAOK Salonik,7241,2,3,2,1,12,5,7,11
Panionios,7241,3,1,1,4,4,10,-6,4
P'thinaikos,7241,4,1,1,4,5,12,-7,4
AEK Athens,7242,1,4,2,0,7,1,6,14
PAOK Salonik,7242,2,2,2,2,9,5,4,8
P'thinaikos,7242,3,2,1,3,5,9,-4,7
Panionios,7242,4,1,1,4,4,10,-6,4
AEK Athens,7243,1,4,2,0,7,1,6,14
PAOK Salonik,7243,2,2,2,2,9,6,3,8
P'thinaikos,7243,3,2,1,3,6,9,-3,7
Panionios,7243,4,1,1,4,4,10,-6,4
AEK Athens,7244,1,4,2,0,7,1,6,14
PAOK Salonik,7244,2,2,2,2,11,7,4,8
P'thinaikos,7244,3,2,1,3,7,11,-4,7
Panionios,7244,4,1,1,4,4,10,-6,4
AEK Athens,7245,1,4,2,0,7,1,6,14
PAOK Salonik,7245,2,3,2,1,13,4,9,11
Panionios,7245,3,1,1,4,4,10,-6,4
P'thinaikos,7245,4,1,1,4,4,13,-9,4
AEK Athens,7246,1,4,2,0,7,1,6,14
PAOK Salonik,7246,2,2,2,2,9,7,2,8
P'thinaikos,7246,3,2,1,3,7,9,-2,7
Panionios,7246,4,1,1,4,4,10,-6,4
AEK Athens,7247,1,4,2,0,7,1,6,14
PAOK Salonik,7247,2,3,2,1,12,5,7,11
Panionios,7247,3,1,1,4,4,10,-6,4
P'thinaikos,7247,4,1,1,4,5,12,-7,4
AEK Athens,7248,1,4,2,0,7,1,6,14
PAOK Salonik,7248,2,2,3,1,10,5,5,9
P'thinaikos,7248,3,1,2,3,5,10,-5,5
Panionios,7248,4,1,1,4,4,10,-6,4
AEK Athens,7249,1,4,2,0,7,1,6,14
PAOK Salonik,7249,2,3,2,1,11,4,7,11
Panionios,7249,3,1,1,4,4,10,-6,4
P'thinaikos,7249,4,1,1,4,4,11,-7,4
AEK Athens,7250,1,4,2,0,7,1,6,14
PAOK Salonik,7250,2,3,2,1,12,4,8,11
Panionios,7250,3,1,1,4,4,10,-6,4
P'thinaikos,7250,4,1,1,4,4,12,-8,4
AEK Athens,7251,1,4,2,0,7,1,6,14
PAOK Salonik,7251,2,3,2,1,11,4,7,11
Panionios,7251,3,1,1,4,4,10,-6,4
P'thinaikos,7251,4,1,1,4,4,11,-7,4
AEK Athens,7252,1,4,2,0,7,1,6,14
PAOK Salonik,7252,2,3,2,1,10,4,6,11
P'thinaikos,7252,3,1,1,4,4,10,-6,4
Panionios,7252,3,1,1,4,4,10,-6,4
AEK Athens,7253,1,4,2,0,7,1,6,14
PAOK Salonik,7253,2,3,2,1,11,5,6,11
P'thinaikos,7253,3,1,1,4,5,11,-6,4
Panionios,7253,4,1,1,4,4,10,-6,4
AEK Athens,7254,1,4,2,0,7,1,6,14
PAOK Salonik,7254,2,2,3,1,10,5,5,9
P'thinaikos,7254,3,1,2,3,5,10,-5,5
Panionios,7254,4,1,1,4,4,10,-6,4
AEK Athens,7255,1,4,2,0,7,1,6,14
PAOK Salonik,7255,2,2,2,2,9,7,2,8
P'thinaikos,7255,3,2,1,3,7,9,-2,7
Panionios,7255,4,1,1,4,4,10,-6,4
AEK Athens,7256,1,4,2,0,7,1,6,14
PAOK Salonik,7256,2,3,2,1,14,5,9,11
Panionios,7256,3,1,1,4,4,10,-6,4
P'thinaikos,7256,4,1,1,4,5,14,-9,4
AEK Athens,7257,1,4,2,0,7,1,6,14
PAOK Salonik,7257,2,3,2,1,12,6,6,11
P'thinaikos,7257,3,1,1,4,6,12,-6,4
Panionios,7257,4,1,1,4,4,10,-6,4
AEK Athens,7258,1,4,2,0,7,1,6,14
PAOK Salonik,7258,2,3,2,1,10,4,6,11
P'thinaikos,7258,3,1,1,4,4,10,-6,4
Panionios,7258,3,1,1,4,4,10,-6,4
AEK Athens,7259,1,4,2,0,7,1,6,14
PAOK Salonik,7259,2,3,2,1,12,5,7,11
Panionios,7259,3,1,1,4,4,10,-6,4
P'thinaikos,7259,4,1,1,4,5,12,-7,4
AEK Athens,7260,1,4,2,0,7,1,6,14
PAOK Salonik,7260,2,2,2,2,9,5,4,8
P'thinaikos,7260,3,2,1,3,5,9,-4,7
Panionios,7260,4,1,1,4,4,10,-6,4
AEK Athens,7261,1,4,2,0,7,1,6,14
PAOK Salonik,7261,2,2,3,1,10,5,5,9
P'thinaikos,7261,3,1,2,3,5,10,-5,5
Panionios,7261,4,1,1,4,4,10,-6,4
AEK Athens,7262,1,4,2,0,7,1,6,14
PAOK Salonik,7262,2,2,3,1,9,4,5,9
P'thinaikos,7262,3,1,2,3,4,9,-5,5
Panionios,7262,4,1,1,4,4,10,-6,4
AEK Athens,7263,1,4,2,0,7,1,6,14
PAOK Salonik,7263,2,3,2,1,14,6,8,11
Panionios,7263,3,1,1,4,4,10,-6,4
P'thinaikos,7263,4,1,1,4,6,14,-8,4
AEK Athens,7264,1,4,2,0,7,1,6,14
PAOK Salonik,7264,2,3,2,1,12,5,7,11
Panionios,7264,3,1,1,4,4,10,-6,4
P'thinaikos,7264,4,1,1,4,5,12,-7,4
AEK Athens,7265,1,4,2,0,7,1,6,14
PAOK Salonik,7265,2,2,2,2,10,6,4,8
P'thinaikos,7265,3,2,1,3,6,10,-4,7
Panionios,7265,4,1,1,4,4,10,-6,4
AEK Athens,7266,1,4,2,0,7,1,6,14
PAOK Salonik,7266,2,2,2,2,11,9,2,8
P'thinaikos,7266,3,2,1,3,9,11,-2,7
Panionios,7266,4,1,1,4,4,10,-6,4
AEK Athens,7267,1,4,2,0,7,1,6,14
PAOK Salonik,7267,2,2,2,2,9,8,1,8
P'thinaikos,7267,3,2,1,3,8,9,-1,7
Panionios,7267,4,1,1,4,4,10,-6,4
AEK Athens,7268,1,4,2,0,7,1,6,14
PAOK Salonik,7268,2,2,3,1,10,5,5,9
P'thinaikos,7268,3,1,2,3,5,10,-5,5
Panionios,7268,4,1,1,4,4,10,-6,4
AEK Athens,7269,1,4,2,0,7,1,6,14
PAOK Salonik,7269,2,3,2,1,10,4,6,11
P'thinaikos,7269,3,1,1,4,4,10,-6,4
Panionios,7269,3,1,1,4,4,10,-6,4
AEK Athens,7270,1,4,2,0,7,1,6,14
PAOK Salonik,7270,2,3,2,1,10,4,6,11
P'thinaikos,7270,3,1,1,4,4,10,-6,4
Panionios,7270,3,1,1,4,4,10,-6,4
AEK Athens,7271,1,4,2,0,7,1,6,14
PAOK Salonik,7271,2,2,3,1,10,5,5,9
P'thinaikos,7271,3,1,2,3,5,10,-5,5
Panionios,7271,4,1,1,4,4,10,-6,4
AEK Athens,7272,1,4,2,0,7,1,6,14
PAOK Salonik,7272,2,2,2,2,11,7,4,8
P'thinaikos,7272,3,2,1,3,7,11,-4,7
Panionios,7272,4,1,1,4,4,10,-6,4
AEK Athens,7273,1,4,2,0,7,1,6,14
PAOK Salonik,7273,2,2,2,2,9,8,1,8
P'thinaikos,7273,3,2,1,3,8,9,-1,7
Panionios,7273,4,1,1,4,4,10,-6,4
AEK Athens,7274,1,4,2,0,7,1,6,14
PAOK Salonik,7274,2,3,2,1,11,5,6,11
P'thinaikos,7274,3,1,1,4,5,11,-6,4
Panionios,7274,4,1,1,4,4,10,-6,4
AEK Athens,7275,1,4,2,0,7,1,6,14
PAOK Salonik,7275,2,3,2,1,12,6,6,11
P'thinaikos,7275,3,1,1,4,6,12,-6,4
Panionios,7275,4,1,1,4,4,10,-6,4
AEK Athens,7276,1,4,2,0,7,1,6,14
PAOK Salonik,7276,2,2,2,2,9,5,4,8
P'thinaikos,7276,3,2,1,3,5,9,-4,7
Panionios,7276,4,1,1,4,4,10,-6,4
AEK Athens,7277,1,4,2,0,7,1,6,14
PAOK Salonik,7277,2,2,2,2,10,6,4,8
P'thinaikos,7277,3,2,1,3,6,10,-4,7
Panionios,7277,4,1,1,4,4,10,-6,4
AEK Athens,7278,1,4,2,0,7,1,6,14
PAOK Salonik,7278,2,3,2,1,12,4,8,11
Panionios,7278,3,1,1,4,4,10,-6,4
P'thinaikos,7278,4,1,1,4,4,12,-8,4
AEK Athens,7279,1,4,2,0,7,1,6,14
PAOK Salonik,7279,2,2,3,1,9,4,5,9
P'thinaikos,7279,3,1,2,3,4,9,-5,5
Panionios,7279,4,1,1,4,4,10,-6,4
AEK Athens,7280,1,4,2,0,7,1,6,14
PAOK Salonik,7280,2,2,3,1,11,6,5,9
P'thinaikos,7280,3,1,2,3,6,11,-5,5
Panionios,7280,4,1,1,4,4,10,-6,4
AEK Athens,7281,1,4,2,0,7,1,6,14
PAOK Salonik,7281,2,2,2,2,9,5,4,8
P'thinaikos,7281,3,2,1,3,5,9,-4,7
Panionios,7281,4,1,1,4,4,10,-6,4
AEK Athens,7282,1,4,2,0,7,1,6,14
PAOK Salonik,7282,2,2,3,1,11,6,5,9
P'thinaikos,7282,3,1,2,3,6,11,-5,5
Panionios,7282,4,1,1,4,4,10,-6,4
AEK Athens,7283,1,4,2,0,7,1,6,14
PAOK Salonik,7283,2,2,2,2,10,6,4,8
P'thinaikos,7283,3,2,1,3,6,10,-4,7
Panionios,7283,4,1,1,4,4,10,-6,4
AEK Athens,7284,1,4,2,0,7,1,6,14
PAOK Salonik,7284,2,2,3,1,10,5,5,9
P'thinaikos,7284,3,1,2,3,5,10,-5,5
Panionios,7284,4,1,1,4,4,10,-6,4
AEK Athens,7285,1,4,2,0,7,1,6,14
PAOK Salonik,7285,2,2,2,2,9,5,4,8
P'thinaikos,7285,3,2,1,3,5,9,-4,7
Panionios,7285,4,1,1,4,4,10,-6,4
AEK Athens,7286,1,4,2,0,7,1,6,14
PAOK Salonik,7286,2,2,2,2,10,8,2,8
P'thinaikos,7286,3,2,1,3,8,10,-2,7
Panionios,7286,4,1,1,4,4,10,-6,4
AEK Athens,7287,1,4,2,0,7,1,6,14
PAOK Salonik,7287,2,2,2,2,9,6,3,8
P'thinaikos,7287,3,2,1,3,6,9,-3,7
Panionios,7287,4,1,1,4,4,10,-6,4
AEK Athens,7288,1,4,2,0,7,1,6,14
PAOK Salonik,7288,2,2,3,1,9,4,5,9
P'thinaikos,7288,3,1,2,3,4,9,-5,5
Panionios,7288,4,1,1,4,4,10,-6,4
AEK Athens,7289,1,4,2,0,7,1,6,14
PAOK Salonik,7289,2,3,2,1,13,4,9,11
Panionios,7289,3,1,1,4,4,10,-6,4
P'thinaikos,7289,4,1,1,4,4,13,-9,4
AEK Athens,7290,1,4,2,0,7,1,6,14
PAOK Salonik,7290,2,2,3,1,9,4,5,9
P'thinaikos,7290,3,1,2,3,4,9,-5,5
Panionios,7290,4,1,1,4,4,10,-6,4
AEK Athens,7291,1,4,2,0,7,1,6,14
PAOK Salonik,7291,2,2,3,1,9,4,5,9
P'thinaikos,7291,3,1,2,3,4,9,-5,5
Panionios,7291,4,1,1,4,4,10,-6,4
AEK Athens,7292,1,4,2,0,7,1,6,14
PAOK Salonik,7292,2,2,2,2,10,6,4,8
P'thinaikos,7292,3,2,1,3,6,10,-4,7
Panionios,7292,4,1,1,4,4,10,-6,4
AEK Athens,7293,1,4,2,0,7,1,6,14
PAOK Salonik,7293,2,2,3,1,10,5,5,9
P'thinaikos,7293,3,1,2,3,5,10,-5,5
Panionios,7293,4,1,1,4,4,10,-6,4
AEK Athens,7294,1,4,2,0,7,1,6,14
PAOK Salonik,7294,2,3,2,1,11,5,6,11
P'thinaikos,7294,3,1,1,4,5,11,-6,4
Panionios,7294,4,1,1,4,4,10,-6,4
AEK Athens,7295,1,4,2,0,7,1,6,14
PAOK Salonik,7295,2,3,2,1,14,7,7,11
Panionios,7295,3,1,1,4,4,10,-6,4
P'thinaikos,7295,4,1,1,4,7,14,-7,4
AEK Athens,7296,1,4,2,0,7,1,6,14
PAOK Salonik,7296,2,2,2,2,12,8,4,8
P'thinaikos,7296,3,2,1,3,8,12,-4,7
Panionios,7296,4,1,1,4,4,10,-6,4
AEK Athens,7297,1,4,2,0,7,1,6,14
PAOK Salonik,7297,2,3,2,1,11,5,6,11
P'thinaikos,7297,3,1,1,4,5,11,-6,4
Panionios,7297,4,1,1,4,4,10,-6,4
AEK Athens,7298,1,4,2,0,7,1,6,14
PAOK Salonik,7298,2,3,2,1,11,5,6,11
P'thinaikos,7298,3,1,1,4,5,11,-6,4
Panionios,7298,4,1,1,4,4,10,-6,4
AEK Athens,7299,1,4,2,0,7,1,6,14
PAOK Salonik,7299,2,3,2,1,11,4,7,11
Panionios,7299,3,1,1,4,4,10,-6,4
P'thinaikos,7299,4,1,1,4,4,11,-7,4
AEK Athens,7300,1,4,2,0,7,1,6,14
PAOK Salonik,7300,2,2,2,2,9,5,4,8
P'thinaikos,7300,3,2,1,3,5,9,-4,7
Panionios,7300,4,1,1,4,4,10,-6,4
AEK Athens,7301,1,4,2,0,7,1,6,14
PAOK Salonik,7301,2,2,3,1,10,5,5,9
P'thinaikos,7301,3,1,2,3,5,10,-5,5
Panionios,7301,4,1,1,4,4,10,-6,4
AEK Athens,7302,1,4,2,0,7,1,6,14
PAOK Salonik,7302,2,2,2,2,9,5,4,8
P'thinaikos,7302,3,2,1,3,5,9,-4,7
Panionios,7302,4,1,1,4,4,10,-6,4
AEK Athens,7303,1,4,2,0,7,1,6,14
PAOK Salonik,7303,2,3,2,1,11,5,6,11
P'thinaikos,7303,3,1,1,4,5,11,-6,4
Panionios,7303,4,1,1,4,4,10,-6,4
AEK Athens,7304,1,4,2,0,7,1,6,14
PAOK Salonik,7304,2,2,2,2,10,8,2,8
P'thinaikos,7304,3,2,1,3,8,10,-2,7
Panionios,7304,4,1,1,4,4,10,-6,4
AEK Athens,7305,1,4,2,0,7,1,6,14
PAOK Salonik,7305,2,3,2,1,12,6,6,11
P'thinaikos,7305,3,1,1,4,6,12,-6,4
Panionios,7305,4,1,1,4,4,10,-6,4
AEK Athens,7306,1,4,2,0,7,1,6,14
PAOK Salonik,7306,2,2,3,1,10,5,5,9
P'thinaikos,7306,3,1,2,3,5,10,-5,5
Panionios,7306,4,1,1,4,4,10,-6,4
AEK Athens,7307,1,4,2,0,7,1,6,14
PAOK Salonik,7307,2,2,2,2,9,6,3,8
P'thinaikos,7307,3,2,1,3,6,9,-3,7
Panionios,7307,4,1,1,4,4,10,-6,4
AEK Athens,7308,1,4,2,0,7,1,6,14
PAOK Salonik,7308,2,2,2,2,10,9,1,8
P'thinaikos,7308,3,2,1,3,9,10,-1,7
Panionios,7308,4,1,1,4,4,10,-6,4
AEK Athens,7309,1,4,2,0,7,1,6,14
PAOK Salonik,7309,2,2,2,2,10,6,4,8
P'thinaikos,7309,3,2,1,3,6,10,-4,7
Panionios,7309,4,1,1,4,4,10,-6,4
AEK Athens,7310,1,4,2,0,7,1,6,14
PAOK Salonik,7310,2,2,3,1,10,5,5,9
P'thinaikos,7310,3,1,2,3,5,10,-5,5
Panionios,7310,4,1,1,4,4,10,-6,4
AEK Athens,7311,1,4,2,0,7,1,6,14
PAOK Salonik,7311,2,2,3,1,9,4,5,9
P'thinaikos,7311,3,1,2,3,4,9,-5,5
Panionios,7311,4,1,1,4,4,10,-6,4
AEK Athens,7312,1,4,2,0,7,1,6,14
PAOK Salonik,7312,2,3,2,1,12,5,7,11
Panionios,7312,3,1,1,4,4,10,-6,4
P'thinaikos,7312,4,1,1,4,5,12,-7,4
AEK Athens,7313,1,4,2,0,7,1,6,14
PAOK Salonik,7313,2,2,2,2,9,8,1,8
P'thinaikos,7313,3,2,1,3,8,9,-1,7
Panionios,7313,4,1,1,4,4,10,-6,4
AEK Athens,7314,1,4,2,0,7,1,6,14
PAOK Salonik,7314,2,2,3,1,10,5,5,9
P'thinaikos,7314,3,1,2,3,5,10,-5,5
Panionios,7314,4,1,1,4,4,10,-6,4
AEK Athens,7315,1,4,2,0,7,1,6,14
PAOK Salonik,7315,2,3,2,1,14,6,8,11
Panionios,7315,3,1,1,4,4,10,-6,4
P'thinaikos,7315,4,1,1,4,6,14,-8,4
AEK Athens,7316,1,4,2,0,7,1,6,14
PAOK Salonik,7316,2,3,2,1,10,4,6,11
P'thinaikos,7316,3,1,1,4,4,10,-6,4
Panionios,7316,3,1,1,4,4,10,-6,4
AEK Athens,7317,1,4,2,0,7,1,6,14
PAOK Salonik,7317,2,3,2,1,11,4,7,11
Panionios,7317,3,1,1,4,4,10,-6,4
P'thinaikos,7317,4,1,1,4,4,11,-7,4
AEK Athens,7318,1,4,2,0,7,1,6,14
PAOK Salonik,7318,2,2,3,1,9,4,5,9
P'thinaikos,7318,3,1,2,3,4,9,-5,5
Panionios,7318,4,1,1,4,4,10,-6,4
AEK Athens,7319,1,4,2,0,7,1,6,14
PAOK Salonik,7319,2,2,3,1,10,5,5,9
P'thinaikos,7319,3,1,2,3,5,10,-5,5
Panionios,7319,4,1,1,4,4,10,-6,4
AEK Athens,7320,1,4,2,0,7,1,6,14
PAOK Salonik,7320,2,3,2,1,13,5,8,11
Panionios,7320,3,1,1,4,4,10,-6,4
P'thinaikos,7320,4,1,1,4,5,13,-8,4
AEK Athens,7321,1,4,2,0,7,1,6,14
PAOK Salonik,7321,2,3,2,1,10,4,6,11
P'thinaikos,7321,3,1,1,4,4,10,-6,4
Panionios,7321,3,1,1,4,4,10,-6,4
AEK Athens,7322,1,4,2,0,7,1,6,14
PAOK Salonik,7322,2,3,2,1,10,4,6,11
P'thinaikos,7322,3,1,1,4,4,10,-6,4
Panionios,7322,3,1,1,4,4,10,-6,4
AEK Athens,7323,1,4,2,0,7,1,6,14
PAOK Salonik,7323,2,2,2,2,9,5,4,8
P'thinaikos,7323,3,2,1,3,5,9,-4,7
Panionios,7323,4,1,1,4,4,10,-6,4
AEK Athens,7324,1,4,2,0,7,1,6,14
PAOK Salonik,7324,2,2,2,2,11,7,4,8
P'thinaikos,7324,3,2,1,3,7,11,-4,7
Panionios,7324,4,1,1,4,4,10,-6,4
AEK Athens,7325,1,4,2,0,7,1,6,14
PAOK Salonik,7325,2,2,3,1,9,4,5,9
P'thinaikos,7325,3,1,2,3,4,9,-5,5
Panionios,7325,4,1,1,4,4,10,-6,4
AEK Athens,7326,1,4,2,0,7,1,6,14
PAOK Salonik,7326,2,2,2,2,9,5,4,8
P'thinaikos,7326,3,2,1,3,5,9,-4,7
Panionios,7326,4,1,1,4,4,10,-6,4
AEK Athens,7327,1,4,2,0,7,1,6,14
PAOK Salonik,7327,2,2,2,2,9,6,3,8
P'thinaikos,7327,3,2,1,3,6,9,-3,7
Panionios,7327,4,1,1,4,4,10,-6,4
AEK Athens,7328,1,4,2,0,7,1,6,14
PAOK Salonik,7328,2,2,3,1,11,6,5,9
P'thinaikos,7328,3,1,2,3,6,11,-5,5
Panionios,7328,4,1,1,4,4,10,-6,4
AEK Athens,7329,1,4,2,0,7,1,6,14
PAOK Salonik,7329,2,2,2,2,10,7,3,8
P'thinaikos,7329,3,2,1,3,7,10,-3,7
Panionios,7329,4,1,1,4,4,10,-6,4
AEK Athens,7330,1,4,2,0,7,1,6,14
PAOK Salonik,7330,2,3,2,1,12,5,7,11
Panionios,7330,3,1,1,4,4,10,-6,4
P'thinaikos,7330,4,1,1,4,5,12,-7,4
AEK Athens,7331,1,4,2,0,7,1,6,14
PAOK Salonik,7331,2,2,2,2,9,6,3,8
P'thinaikos,7331,3,2,1,3,6,9,-3,7
Panionios,7331,4,1,1,4,4,10,-6,4
AEK Athens,7332,1,4,2,0,7,1,6,14
PAOK Salonik,7332,2,2,3,1,12,7,5,9
P'thinaikos,7332,3,1,2,3,7,12,-5,5
Panionios,7332,4,1,1,4,4,10,-6,4
AEK Athens,7333,1,4,2,0,7,1,6,14
PAOK Salonik,7333,2,2,2,2,11,7,4,8
P'thinaikos,7333,3,2,1,3,7,11,-4,7
Panionios,7333,4,1,1,4,4,10,-6,4
AEK Athens,7334,1,4,2,0,7,1,6,14
PAOK Salonik,7334,2,2,2,2,11,7,4,8
P'thinaikos,7334,3,2,1,3,7,11,-4,7
Panionios,7334,4,1,1,4,4,10,-6,4
AEK Athens,7335,1,4,2,0,7,1,6,14
PAOK Salonik,7335,2,2,2,2,9,7,2,8
P'thinaikos,7335,3,2,1,3,7,9,-2,7
Panionios,7335,4,1,1,4,4,10,-6,4
AEK Athens,7336,1,4,2,0,7,1,6,14
PAOK Salonik,7336,2,2,3,1,10,5,5,9
P'thinaikos,7336,3,1,2,3,5,10,-5,5
Panionios,7336,4,1,1,4,4,10,-6,4
AEK Athens,7337,1,4,2,0,7,1,6,14
PAOK Salonik,7337,2,2,2,2,10,6,4,8
P'thinaikos,7337,3,2,1,3,6,10,-4,7
Panionios,7337,4,1,1,4,4,10,-6,4
AEK Athens,7338,1,4,2,0,7,1,6,14
PAOK Salonik,7338,2,2,2,2,10,6,4,8
P'thinaikos,7338,3,2,1,3,6,10,-4,7
Panionios,7338,4,1,1,4,4,10,-6,4
AEK Athens,7339,1,4,2,0,7,1,6,14
PAOK Salonik,7339,2,2,3,1,10,5,5,9
P'thinaikos,7339,3,1,2,3,5,10,-5,5
Panionios,7339,4,1,1,4,4,10,-6,4
AEK Athens,7340,1,4,2,0,7,1,6,14
PAOK Salonik,7340,2,2,2,2,9,5,4,8
P'thinaikos,7340,3,2,1,3,5,9,-4,7
Panionios,7340,4,1,1,4,4,10,-6,4
AEK Athens,7341,1,4,2,0,7,1,6,14
PAOK Salonik,7341,2,2,3,1,9,4,5,9
P'thinaikos,7341,3,1,2,3,4,9,-5,5
Panionios,7341,4,1,1,4,4,10,-6,4
AEK Athens,7342,1,4,2,0,7,1,6,14
PAOK Salonik,7342,2,2,3,1,11,6,5,9
P'thinaikos,7342,3,1,2,3,6,11,-5,5
Panionios,7342,4,1,1,4,4,10,-6,4
AEK Athens,7343,1,4,2,0,7,1,6,14
PAOK Salonik,7343,2,3,2,1,10,4,6,11
P'thinaikos,7343,3,1,1,4,4,10,-6,4
Panionios,7343,3,1,1,4,4,10,-6,4
AEK Athens,7344,1,4,2,0,7,1,6,14
PAOK Salonik,7344,2,2,2,2,9,10,-1,8
P'thinaikos,7344,3,2,1,3,10,9,1,7
Panionios,7344,4,1,1,4,4,10,-6,4
AEK Athens,7345,1,4,2,0,7,1,6,14
PAOK Salonik,7345,2,2,3,1,9,4,5,9
P'thinaikos,7345,3,1,2,3,4,9,-5,5
Panionios,7345,4,1,1,4,4,10,-6,4
AEK Athens,7346,1,4,2,0,7,1,6,14
PAOK Salonik,7346,2,2,3,1,9,4,5,9
P'thinaikos,7346,3,1,2,3,4,9,-5,5
Panionios,7346,4,1,1,4,4,10,-6,4
AEK Athens,7347,1,4,2,0,7,1,6,14
PAOK Salonik,7347,2,2,3,1,11,6,5,9
P'thinaikos,7347,3,1,2,3,6,11,-5,5
Panionios,7347,4,1,1,4,4,10,-6,4
AEK Athens,7348,1,4,2,0,7,1,6,14
PAOK Salonik,7348,2,3,2,1,12,5,7,11
Panionios,7348,3,1,1,4,4,10,-6,4
P'thinaikos,7348,4,1,1,4,5,12,-7,4
AEK Athens,7349,1,4,2,0,7,1,6,14
PAOK Salonik,7349,2,2,2,2,10,6,4,8
P'thinaikos,7349,3,2,1,3,6,10,-4,7
Panionios,7349,4,1,1,4,4,10,-6,4
AEK Athens,7350,1,4,2,0,7,1,6,14
PAOK Salonik,7350,2,3,2,1,12,5,7,11
Panionios,7350,3,1,1,4,4,10,-6,4
P'thinaikos,7350,4,1,1,4,5,12,-7,4
AEK Athens,7351,1,4,2,0,7,1,6,14
PAOK Salonik,7351,2,2,3,1,10,5,5,9
P'thinaikos,7351,3,1,2,3,5,10,-5,5
Panionios,7351,4,1,1,4,4,10,-6,4
AEK Athens,7352,1,4,2,0,7,1,6,14
PAOK Salonik,7352,2,2,3,1,10,5,5,9
P'thinaikos,7352,3,1,2,3,5,10,-5,5
Panionios,7352,4,1,1,4,4,10,-6,4
AEK Athens,7353,1,4,2,0,7,1,6,14
PAOK Salonik,7353,2,2,2,2,11,7,4,8
P'thinaikos,7353,3,2,1,3,7,11,-4,7
Panionios,7353,4,1,1,4,4,10,-6,4
AEK Athens,7354,1,4,2,0,7,1,6,14
PAOK Salonik,7354,2,3,2,1,11,5,6,11
P'thinaikos,7354,3,1,1,4,5,11,-6,4
Panionios,7354,4,1,1,4,4,10,-6,4
AEK Athens,7355,1,4,2,0,7,1,6,14
PAOK Salonik,7355,2,3,2,1,13,4,9,11
Panionios,7355,3,1,1,4,4,10,-6,4
P'thinaikos,7355,4,1,1,4,4,13,-9,4
AEK Athens,7356,1,4,2,0,7,1,6,14
PAOK Salonik,7356,2,2,3,1,9,4,5,9
P'thinaikos,7356,3,1,2,3,4,9,-5,5
Panionios,7356,4,1,1,4,4,10,-6,4
AEK Athens,7357,1,4,2,0,7,1,6,14
PAOK Salonik,7357,2,3,2,1,12,6,6,11
P'thinaikos,7357,3,1,1,4,6,12,-6,4
Panionios,7357,4,1,1,4,4,10,-6,4
AEK Athens,7358,1,4,2,0,7,1,6,14
PAOK Salonik,7358,2,2,2,2,10,7,3,8
P'thinaikos,7358,3,2,1,3,7,10,-3,7
Panionios,7358,4,1,1,4,4,10,-6,4
AEK Athens,7359,1,4,2,0,7,1,6,14
PAOK Salonik,7359,2,2,3,1,9,4,5,9
P'thinaikos,7359,3,1,2,3,4,9,-5,5
Panionios,7359,4,1,1,4,4,10,-6,4
AEK Athens,7360,1,4,2,0,7,1,6,14
PAOK Salonik,7360,2,3,2,1,10,4,6,11
P'thinaikos,7360,3,1,1,4,4,10,-6,4
Panionios,7360,3,1,1,4,4,10,-6,4
AEK Athens,7361,1,4,2,0,7,1,6,14
PAOK Salonik,7361,2,2,3,1,9,4,5,9
P'thinaikos,7361,3,1,2,3,4,9,-5,5
Panionios,7361,4,1,1,4,4,10,-6,4
AEK Athens,7362,1,4,2,0,7,1,6,14
PAOK Salonik,7362,2,3,2,1,11,4,7,11
Panionios,7362,3,1,1,4,4,10,-6,4
P'thinaikos,7362,4,1,1,4,4,11,-7,4
AEK Athens,7363,1,4,2,0,7,1,6,14
PAOK Salonik,7363,2,2,2,2,10,6,4,8
P'thinaikos,7363,3,2,1,3,6,10,-4,7
Panionios,7363,4,1,1,4,4,10,-6,4
AEK Athens,7364,1,4,2,0,7,1,6,14
PAOK Salonik,7364,2,3,2,1,12,4,8,11
Panionios,7364,3,1,1,4,4,10,-6,4
P'thinaikos,7364,4,1,1,4,4,12,-8,4
AEK Athens,7365,1,4,2,0,7,1,6,14
PAOK Salonik,7365,2,2,3,1,11,6,5,9
P'thinaikos,7365,3,1,2,3,6,11,-5,5
Panionios,7365,4,1,1,4,4,10,-6,4
AEK Athens,7366,1,4,2,0,7,1,6,14
PAOK Salonik,7366,2,2,2,2,9,6,3,8
P'thinaikos,7366,3,2,1,3,6,9,-3,7
Panionios,7366,4,1,1,4,4,10,-6,4
AEK Athens,7367,1,4,2,0,7,1,6,14
PAOK Salonik,7367,2,2,2,2,10,6,4,8
P'thinaikos,7367,3,2,1,3,6,10,-4,7
Panionios,7367,4,1,1,4,4,10,-6,4
AEK Athens,7368,1,4,2,0,7,1,6,14
PAOK Salonik,7368,2,2,2,2,10,6,4,8
P'thinaikos,7368,3,2,1,3,6,10,-4,7
Panionios,7368,4,1,1,4,4,10,-6,4
AEK Athens,7369,1,4,2,0,7,1,6,14
PAOK Salonik,7369,2,3,2,1,10,4,6,11
P'thinaikos,7369,3,1,1,4,4,10,-6,4
Panionios,7369,3,1,1,4,4,10,-6,4
AEK Athens,7370,1,4,2,0,7,1,6,14
PAOK Salonik,7370,2,2,3,1,10,5,5,9
P'thinaikos,7370,3,1,2,3,5,10,-5,5
Panionios,7370,4,1,1,4,4,10,-6,4
AEK Athens,7371,1,4,2,0,7,1,6,14
PAOK Salonik,7371,2,3,2,1,14,7,7,11
Panionios,7371,3,1,1,4,4,10,-6,4
P'thinaikos,7371,4,1,1,4,7,14,-7,4
AEK Athens,7372,1,4,2,0,7,1,6,14
PAOK Salonik,7372,2,2,3,1,9,4,5,9
P'thinaikos,7372,3,1,2,3,4,9,-5,5
Panionios,7372,4,1,1,4,4,10,-6,4
AEK Athens,7373,1,4,2,0,7,1,6,14
PAOK Salonik,7373,2,3,2,1,10,4,6,11
P'thinaikos,7373,3,1,1,4,4,10,-6,4
Panionios,7373,3,1,1,4,4,10,-6,4
AEK Athens,7374,1,4,2,0,7,1,6,14
PAOK Salonik,7374,2,2,2,2,10,6,4,8
P'thinaikos,7374,3,2,1,3,6,10,-4,7
Panionios,7374,4,1,1,4,4,10,-6,4
AEK Athens,7375,1,4,2,0,7,1,6,14
PAOK Salonik,7375,2,2,3,1,10,5,5,9
P'thinaikos,7375,3,1,2,3,5,10,-5,5
Panionios,7375,4,1,1,4,4,10,-6,4
AEK Athens,7376,1,4,2,0,7,1,6,14
PAOK Salonik,7376,2,3,2,1,10,4,6,11
P'thinaikos,7376,3,1,1,4,4,10,-6,4
Panionios,7376,3,1,1,4,4,10,-6,4
AEK Athens,7377,1,4,2,0,7,1,6,14
PAOK Salonik,7377,2,2,2,2,9,6,3,8
P'thinaikos,7377,3,2,1,3,6,9,-3,7
Panionios,7377,4,1,1,4,4,10,-6,4
AEK Athens,7378,1,4,2,0,7,1,6,14
PAOK Salonik,7378,2,2,3,1,10,5,5,9
P'thinaikos,7378,3,1,2,3,5,10,-5,5
Panionios,7378,4,1,1,4,4,10,-6,4
AEK Athens,7379,1,4,2,0,7,1,6,14
PAOK Salonik,7379,2,3,2,1,10,4,6,11
P'thinaikos,7379,3,1,1,4,4,10,-6,4
Panionios,7379,3,1,1,4,4,10,-6,4
AEK Athens,7380,1,4,2,0,7,1,6,14
PAOK Salonik,7380,2,2,3,1,12,7,5,9
P'thinaikos,7380,3,1,2,3,7,12,-5,5
Panionios,7380,4,1,1,4,4,10,-6,4
AEK Athens,7381,1,4,2,0,7,1,6,14
PAOK Salonik,7381,2,3,2,1,12,5,7,11
Panionios,7381,3,1,1,4,4,10,-6,4
P'thinaikos,7381,4,1,1,4,5,12,-7,4
AEK Athens,7382,1,4,2,0,7,1,6,14
PAOK Salonik,7382,2,3,2,1,11,4,7,11
Panionios,7382,3,1,1,4,4,10,-6,4
P'thinaikos,7382,4,1,1,4,4,11,-7,4
AEK Athens,7383,1,4,2,0,7,1,6,14
PAOK Salonik,7383,2,3,2,1,11,4,7,11
Panionios,7383,3,1,1,4,4,10,-6,4
P'thinaikos,7383,4,1,1,4,4,11,-7,4
AEK Athens,7384,1,4,2,0,7,1,6,14
PAOK Salonik,7384,2,3,2,1,10,4,6,11
P'thinaikos,7384,3,1,1,4,4,10,-6,4
Panionios,7384,3,1,1,4,4,10,-6,4
AEK Athens,7385,1,4,2,0,7,1,6,14
PAOK Salonik,7385,2,2,2,2,9,5,4,8
P'thinaikos,7385,3,2,1,3,5,9,-4,7
Panionios,7385,4,1,1,4,4,10,-6,4
AEK Athens,7386,1,4,2,0,7,1,6,14
PAOK Salonik,7386,2,2,2,2,9,5,4,8
P'thinaikos,7386,3,2,1,3,5,9,-4,7
Panionios,7386,4,1,1,4,4,10,-6,4
AEK Athens,7387,1,4,2,0,7,1,6,14
PAOK Salonik,7387,2,2,2,2,9,6,3,8
P'thinaikos,7387,3,2,1,3,6,9,-3,7
Panionios,7387,4,1,1,4,4,10,-6,4
AEK Athens,7388,1,4,2,0,7,1,6,14
PAOK Salonik,7388,2,3,2,1,14,7,7,11
Panionios,7388,3,1,1,4,4,10,-6,4
P'thinaikos,7388,4,1,1,4,7,14,-7,4
AEK Athens,7389,1,4,2,0,7,1,6,14
PAOK Salonik,7389,2,2,3,1,10,5,5,9
P'thinaikos,7389,3,1,2,3,5,10,-5,5
Panionios,7389,4,1,1,4,4,10,-6,4
AEK Athens,7390,1,4,2,0,7,1,6,14
PAOK Salonik,7390,2,2,3,1,10,5,5,9
P'thinaikos,7390,3,1,2,3,5,10,-5,5
Panionios,7390,4,1,1,4,4,10,-6,4
AEK Athens,7391,1,4,2,0,7,1,6,14
PAOK Salonik,7391,2,3,2,1,12,5,7,11
Panionios,7391,3,1,1,4,4,10,-6,4
P'thinaikos,7391,4,1,1,4,5,12,-7,4
AEK Athens,7392,1,4,2,0,7,1,6,14
PAOK Salonik,7392,2,3,2,1,11,4,7,11
Panionios,7392,3,1,1,4,4,10,-6,4
P'thinaikos,7392,4,1,1,4,4,11,-7,4
AEK Athens,7393,1,4,2,0,7,1,6,14
PAOK Salonik,7393,2,2,2,2,10,6,4,8
P'thinaikos,7393,3,2,1,3,6,10,-4,7
Panionios,7393,4,1,1,4,4,10,-6,4
AEK Athens,7394,1,4,2,0,7,1,6,14
PAOK Salonik,7394,2,2,2,2,9,7,2,8
P'thinaikos,7394,3,2,1,3,7,9,-2,7
Panionios,7394,4,1,1,4,4,10,-6,4
AEK Athens,7395,1,4,2,0,7,1,6,14
PAOK Salonik,7395,2,2,3,1,9,4,5,9
P'thinaikos,7395,3,1,2,3,4,9,-5,5
Panionios,7395,4,1,1,4,4,10,-6,4
AEK Athens,7396,1,4,2,0,7,1,6,14
PAOK Salonik,7396,2,3,2,1,12,5,7,11
Panionios,7396,3,1,1,4,4,10,-6,4
P'thinaikos,7396,4,1,1,4,5,12,-7,4
AEK Athens,7397,1,4,2,0,7,1,6,14
PAOK Salonik,7397,2,3,2,1,12,4,8,11
Panionios,7397,3,1,1,4,4,10,-6,4
P'thinaikos,7397,4,1,1,4,4,12,-8,4
AEK Athens,7398,1,4,2,0,7,1,6,14
PAOK Salonik,7398,2,3,2,1,10,4,6,11
P'thinaikos,7398,3,1,1,4,4,10,-6,4
Panionios,7398,3,1,1,4,4,10,-6,4
AEK Athens,7399,1,4,2,0,7,1,6,14
PAOK Salonik,7399,2,2,2,2,11,7,4,8
P'thinaikos,7399,3,2,1,3,7,11,-4,7
Panionios,7399,4,1,1,4,4,10,-6,4
AEK Athens,7400,1,4,2,0,7,1,6,14
PAOK Salonik,7400,2,3,2,1,11,4,7,11
Panionios,7400,3,1,1,4,4,10,-6,4
P'thinaikos,7400,4,1,1,4,4,11,-7,4
AEK Athens,7401,1,4,2,0,7,1,6,14
PAOK Salonik,7401,2,2,2,2,9,6,3,8
P'thinaikos,7401,3,2,1,3,6,9,-3,7
Panionios,7401,4,1,1,4,4,10,-6,4
AEK Athens,7402,1,4,2,0,7,1,6,14
PAOK Salonik,7402,2,2,3,1,10,5,5,9
P'thinaikos,7402,3,1,2,3,5,10,-5,5
Panionios,7402,4,1,1,4,4,10,-6,4
AEK Athens,7403,1,4,2,0,7,1,6,14
PAOK Salonik,7403,2,2,2,2,9,5,4,8
P'thinaikos,7403,3,2,1,3,5,9,-4,7
Panionios,7403,4,1,1,4,4,10,-6,4
AEK Athens,7404,1,4,2,0,7,1,6,14
PAOK Salonik,7404,2,3,2,1,12,4,8,11
Panionios,7404,3,1,1,4,4,10,-6,4
P'thinaikos,7404,4,1,1,4,4,12,-8,4
AEK Athens,7405,1,4,2,0,7,1,6,14
PAOK Salonik,7405,2,3,2,1,11,5,6,11
P'thinaikos,7405,3,1,1,4,5,11,-6,4
Panionios,7405,4,1,1,4,4,10,-6,4
AEK Athens,7406,1,4,2,0,7,1,6,14
PAOK Salonik,7406,2,3,2,1,13,4,9,11
Panionios,7406,3,1,1,4,4,10,-6,4
P'thinaikos,7406,4,1,1,4,4,13,-9,4
AEK Athens,7407,1,4,2,0,7,1,6,14
PAOK Salonik,7407,2,2,2,2,9,7,2,8
P'thinaikos,7407,3,2,1,3,7,9,-2,7
Panionios,7407,4,1,1,4,4,10,-6,4
AEK Athens,7408,1,4,2,0,7,1,6,14
PAOK Salonik,7408,2,2,2,2,9,7,2,8
P'thinaikos,7408,3,2,1,3,7,9,-2,7
Panionios,7408,4,1,1,4,4,10,-6,4
AEK Athens,7409,1,4,2,0,7,1,6,14
PAOK Salonik,7409,2,2,2,2,9,5,4,8
P'thinaikos,7409,3,2,1,3,5,9,-4,7
Panionios,7409,4,1,1,4,4,10,-6,4
AEK Athens,7410,1,4,2,0,7,1,6,14
PAOK Salonik,7410,2,2,2,2,10,6,4,8
P'thinaikos,7410,3,2,1,3,6,10,-4,7
Panionios,7410,4,1,1,4,4,10,-6,4
AEK Athens,7411,1,4,2,0,7,1,6,14
PAOK Salonik,7411,2,2,2,2,9,5,4,8
P'thinaikos,7411,3,2,1,3,5,9,-4,7
Panionios,7411,4,1,1,4,4,10,-6,4
AEK Athens,7412,1,4,2,0,7,1,6,14
PAOK Salonik,7412,2,2,3,1,11,6,5,9
P'thinaikos,7412,3,1,2,3,6,11,-5,5
Panionios,7412,4,1,1,4,4,10,-6,4
AEK Athens,7413,1,4,2,0,7,1,6,14
PAOK Salonik,7413,2,2,3,1,11,6,5,9
P'thinaikos,7413,3,1,2,3,6,11,-5,5
Panionios,7413,4,1,1,4,4,10,-6,4
AEK Athens,7414,1,4,2,0,7,1,6,14
PAOK Salonik,7414,2,3,2,1,11,4,7,11
Panionios,7414,3,1,1,4,4,10,-6,4
P'thinaikos,7414,4,1,1,4,4,11,-7,4
AEK Athens,7415,1,4,2,0,7,1,6,14
PAOK Salonik,7415,2,2,3,1,10,5,5,9
P'thinaikos,7415,3,1,2,3,5,10,-5,5
Panionios,7415,4,1,1,4,4,10,-6,4
AEK Athens,7416,1,4,2,0,7,1,6,14
PAOK Salonik,7416,2,2,2,2,9,5,4,8
P'thinaikos,7416,3,2,1,3,5,9,-4,7
Panionios,7416,4,1,1,4,4,10,-6,4
AEK Athens,7417,1,4,2,0,7,1,6,14
PAOK Salonik,7417,2,2,3,1,10,5,5,9
P'thinaikos,7417,3,1,2,3,5,10,-5,5
Panionios,7417,4,1,1,4,4,10,-6,4
AEK Athens,7418,1,4,2,0,7,1,6,14
PAOK Salonik,7418,2,2,2,2,9,7,2,8
P'thinaikos,7418,3,2,1,3,7,9,-2,7
Panionios,7418,4,1,1,4,4,10,-6,4
AEK Athens,7419,1,4,2,0,7,1,6,14
PAOK Salonik,7419,2,3,2,1,11,5,6,11
P'thinaikos,7419,3,1,1,4,5,11,-6,4
Panionios,7419,4,1,1,4,4,10,-6,4
AEK Athens,7420,1,4,2,0,7,1,6,14
PAOK Salonik,7420,2,3,2,1,11,4,7,11
Panionios,7420,3,1,1,4,4,10,-6,4
P'thinaikos,7420,4,1,1,4,4,11,-7,4
AEK Athens,7421,1,4,2,0,7,1,6,14
PAOK Salonik,7421,2,3,2,1,11,5,6,11
P'thinaikos,7421,3,1,1,4,5,11,-6,4
Panionios,7421,4,1,1,4,4,10,-6,4
AEK Athens,7422,1,4,2,0,7,1,6,14
PAOK Salonik,7422,2,2,2,2,10,8,2,8
P'thinaikos,7422,3,2,1,3,8,10,-2,7
Panionios,7422,4,1,1,4,4,10,-6,4
AEK Athens,7423,1,4,2,0,7,1,6,14
PAOK Salonik,7423,2,3,2,1,11,4,7,11
Panionios,7423,3,1,1,4,4,10,-6,4
P'thinaikos,7423,4,1,1,4,4,11,-7,4
AEK Athens,7424,1,4,2,0,7,1,6,14
PAOK Salonik,7424,2,3,2,1,11,5,6,11
P'thinaikos,7424,3,1,1,4,5,11,-6,4
Panionios,7424,4,1,1,4,4,10,-6,4
AEK Athens,7425,1,4,2,0,7,1,6,14
PAOK Salonik,7425,2,2,2,2,9,7,2,8
P'thinaikos,7425,3,2,1,3,7,9,-2,7
Panionios,7425,4,1,1,4,4,10,-6,4
AEK Athens,7426,1,4,2,0,7,1,6,14
PAOK Salonik,7426,2,3,2,1,10,4,6,11
P'thinaikos,7426,3,1,1,4,4,10,-6,4
Panionios,7426,3,1,1,4,4,10,-6,4
AEK Athens,7427,1,4,2,0,7,1,6,14
PAOK Salonik,7427,2,2,2,2,10,6,4,8
P'thinaikos,7427,3,2,1,3,6,10,-4,7
Panionios,7427,4,1,1,4,4,10,-6,4
AEK Athens,7428,1,4,2,0,7,1,6,14
PAOK Salonik,7428,2,3,2,1,13,4,9,11
Panionios,7428,3,1,1,4,4,10,-6,4
P'thinaikos,7428,4,1,1,4,4,13,-9,4
AEK Athens,7429,1,4,2,0,7,1,6,14
PAOK Salonik,7429,2,2,2,2,9,6,3,8
P'thinaikos,7429,3,2,1,3,6,9,-3,7
Panionios,7429,4,1,1,4,4,10,-6,4
AEK Athens,7430,1,4,2,0,7,1,6,14
PAOK Salonik,7430,2,2,2,2,9,5,4,8
P'thinaikos,7430,3,2,1,3,5,9,-4,7
Panionios,7430,4,1,1,4,4,10,-6,4
AEK Athens,7431,1,4,2,0,7,1,6,14
PAOK Salonik,7431,2,3,2,1,12,5,7,11
Panionios,7431,3,1,1,4,4,10,-6,4
P'thinaikos,7431,4,1,1,4,5,12,-7,4
AEK Athens,7432,1,4,2,0,7,1,6,14
PAOK Salonik,7432,2,2,3,1,10,5,5,9
P'thinaikos,7432,3,1,2,3,5,10,-5,5
Panionios,7432,4,1,1,4,4,10,-6,4
AEK Athens,7433,1,4,2,0,7,1,6,14
PAOK Salonik,7433,2,2,3,1,9,4,5,9
P'thinaikos,7433,3,1,2,3,4,9,-5,5
Panionios,7433,4,1,1,4,4,10,-6,4
AEK Athens,7434,1,4,2,0,7,1,6,14
PAOK Salonik,7434,2,2,2,2,9,7,2,8
P'thinaikos,7434,3,2,1,3,7,9,-2,7
Panionios,7434,4,1,1,4,4,10,-6,4
AEK Athens,7435,1,4,2,0,7,1,6,14
PAOK Salonik,7435,2,2,3,1,9,4,5,9
P'thinaikos,7435,3,1,2,3,4,9,-5,5
Panionios,7435,4,1,1,4,4,10,-6,4
AEK Athens,7436,1,4,2,0,7,1,6,14
PAOK Salonik,7436,2,2,2,2,9,5,4,8
P'thinaikos,7436,3,2,1,3,5,9,-4,7
Panionios,7436,4,1,1,4,4,10,-6,4
AEK Athens,7437,1,4,2,0,7,1,6,14
PAOK Salonik,7437,2,2,2,2,9,7,2,8
P'thinaikos,7437,3,2,1,3,7,9,-2,7
Panionios,7437,4,1,1,4,4,10,-6,4
AEK Athens,7438,1,4,2,0,7,1,6,14
PAOK Salonik,7438,2,2,2,2,9,8,1,8
P'thinaikos,7438,3,2,1,3,8,9,-1,7
Panionios,7438,4,1,1,4,4,10,-6,4
AEK Athens,7439,1,4,2,0,7,1,6,14
PAOK Salonik,7439,2,2,2,2,10,6,4,8
P'thinaikos,7439,3,2,1,3,6,10,-4,7
Panionios,7439,4,1,1,4,4,10,-6,4
AEK Athens,7440,1,4,2,0,7,1,6,14
PAOK Salonik,7440,2,2,2,2,10,6,4,8
P'thinaikos,7440,3,2,1,3,6,10,-4,7
Panionios,7440,4,1,1,4,4,10,-6,4
AEK Athens,7441,1,4,2,0,7,1,6,14
PAOK Salonik,7441,2,2,2,2,9,9,0,8
P'thinaikos,7441,3,2,1,3,9,9,0,7
Panionios,7441,4,1,1,4,4,10,-6,4
AEK Athens,7442,1,4,2,0,7,1,6,14
PAOK Salonik,7442,2,2,3,1,10,5,5,9
P'thinaikos,7442,3,1,2,3,5,10,-5,5
Panionios,7442,4,1,1,4,4,10,-6,4
AEK Athens,7443,1,4,2,0,7,1,6,14
PAOK Salonik,7443,2,2,3,1,11,6,5,9
P'thinaikos,7443,3,1,2,3,6,11,-5,5
Panionios,7443,4,1,1,4,4,10,-6,4
AEK Athens,7444,1,4,2,0,7,1,6,14
PAOK Salonik,7444,2,3,2,1,12,5,7,11
Panionios,7444,3,1,1,4,4,10,-6,4
P'thinaikos,7444,4,1,1,4,5,12,-7,4
AEK Athens,7445,1,4,2,0,7,1,6,14
PAOK Salonik,7445,2,2,3,1,10,5,5,9
P'thinaikos,7445,3,1,2,3,5,10,-5,5
Panionios,7445,4,1,1,4,4,10,-6,4
AEK Athens,7446,1,4,2,0,7,1,6,14
PAOK Salonik,7446,2,3,2,1,11,5,6,11
P'thinaikos,7446,3,1,1,4,5,11,-6,4
Panionios,7446,4,1,1,4,4,10,-6,4
AEK Athens,7447,1,4,2,0,7,1,6,14
PAOK Salonik,7447,2,2,3,1,10,5,5,9
P'thinaikos,7447,3,1,2,3,5,10,-5,5
Panionios,7447,4,1,1,4,4,10,-6,4
AEK Athens,7448,1,4,2,0,7,1,6,14
PAOK Salonik,7448,2,2,3,1,9,4,5,9
P'thinaikos,7448,3,1,2,3,4,9,-5,5
Panionios,7448,4,1,1,4,4,10,-6,4
AEK Athens,7449,1,4,2,0,7,1,6,14
PAOK Salonik,7449,2,2,3,1,10,5,5,9
P'thinaikos,7449,3,1,2,3,5,10,-5,5
Panionios,7449,4,1,1,4,4,10,-6,4
AEK Athens,7450,1,4,2,0,7,1,6,14
PAOK Salonik,7450,2,2,2,2,9,5,4,8
P'thinaikos,7450,3,2,1,3,5,9,-4,7
Panionios,7450,4,1,1,4,4,10,-6,4
AEK Athens,7451,1,4,2,0,7,1,6,14
PAOK Salonik,7451,2,2,2,2,10,6,4,8
P'thinaikos,7451,3,2,1,3,6,10,-4,7
Panionios,7451,4,1,1,4,4,10,-6,4
AEK Athens,7452,1,4,2,0,7,1,6,14
PAOK Salonik,7452,2,3,2,1,12,4,8,11
Panionios,7452,3,1,1,4,4,10,-6,4
P'thinaikos,7452,4,1,1,4,4,12,-8,4
AEK Athens,7453,1,4,2,0,7,1,6,14
PAOK Salonik,7453,2,3,2,1,10,4,6,11
P'thinaikos,7453,3,1,1,4,4,10,-6,4
Panionios,7453,3,1,1,4,4,10,-6,4
AEK Athens,7454,1,4,2,0,7,1,6,14
PAOK Salonik,7454,2,3,2,1,12,6,6,11
P'thinaikos,7454,3,1,1,4,6,12,-6,4
Panionios,7454,4,1,1,4,4,10,-6,4
AEK Athens,7455,1,4,2,0,7,1,6,14
PAOK Salonik,7455,2,2,3,1,10,5,5,9
P'thinaikos,7455,3,1,2,3,5,10,-5,5
Panionios,7455,4,1,1,4,4,10,-6,4
AEK Athens,7456,1,4,2,0,7,1,6,14
PAOK Salonik,7456,2,2,3,1,12,7,5,9
P'thinaikos,7456,3,1,2,3,7,12,-5,5
Panionios,7456,4,1,1,4,4,10,-6,4
AEK Athens,7457,1,4,2,0,7,1,6,14
PAOK Salonik,7457,2,2,3,1,9,4,5,9
P'thinaikos,7457,3,1,2,3,4,9,-5,5
Panionios,7457,4,1,1,4,4,10,-6,4
AEK Athens,7458,1,4,2,0,7,1,6,14
PAOK Salonik,7458,2,2,2,2,11,7,4,8
P'thinaikos,7458,3,2,1,3,7,11,-4,7
Panionios,7458,4,1,1,4,4,10,-6,4
AEK Athens,7459,1,4,2,0,7,1,6,14
PAOK Salonik,7459,2,3,2,1,10,4,6,11
P'thinaikos,7459,3,1,1,4,4,10,-6,4
Panionios,7459,3,1,1,4,4,10,-6,4
AEK Athens,7460,1,4,2,0,7,1,6,14
PAOK Salonik,7460,2,2,3,1,10,5,5,9
P'thinaikos,7460,3,1,2,3,5,10,-5,5
Panionios,7460,4,1,1,4,4,10,-6,4
AEK Athens,7461,1,4,2,0,7,1,6,14
PAOK Salonik,7461,2,2,2,2,9,6,3,8
P'thinaikos,7461,3,2,1,3,6,9,-3,7
Panionios,7461,4,1,1,4,4,10,-6,4
AEK Athens,7462,1,4,2,0,7,1,6,14
PAOK Salonik,7462,2,2,2,2,11,7,4,8
P'thinaikos,7462,3,2,1,3,7,11,-4,7
Panionios,7462,4,1,1,4,4,10,-6,4
AEK Athens,7463,1,4,2,0,7,1,6,14
PAOK Salonik,7463,2,3,2,1,11,5,6,11
P'thinaikos,7463,3,1,1,4,5,11,-6,4
Panionios,7463,4,1,1,4,4,10,-6,4
AEK Athens,7464,1,4,2,0,7,1,6,14
PAOK Salonik,7464,2,3,2,1,11,4,7,11
Panionios,7464,3,1,1,4,4,10,-6,4
P'thinaikos,7464,4,1,1,4,4,11,-7,4
AEK Athens,7465,1,4,2,0,7,1,6,14
PAOK Salonik,7465,2,3,2,1,11,5,6,11
P'thinaikos,7465,3,1,1,4,5,11,-6,4
Panionios,7465,4,1,1,4,4,10,-6,4
AEK Athens,7466,1,4,2,0,7,1,6,14
PAOK Salonik,7466,2,2,3,1,9,4,5,9
P'thinaikos,7466,3,1,2,3,4,9,-5,5
Panionios,7466,4,1,1,4,4,10,-6,4
AEK Athens,7467,1,4,2,0,7,1,6,14
PAOK Salonik,7467,2,2,2,2,9,7,2,8
P'thinaikos,7467,3,2,1,3,7,9,-2,7
Panionios,7467,4,1,1,4,4,10,-6,4
AEK Athens,7468,1,4,2,0,7,1,6,14
PAOK Salonik,7468,2,2,3,1,11,6,5,9
P'thinaikos,7468,3,1,2,3,6,11,-5,5
Panionios,7468,4,1,1,4,4,10,-6,4
AEK Athens,7469,1,4,2,0,7,1,6,14
PAOK Salonik,7469,2,3,2,1,13,5,8,11
Panionios,7469,3,1,1,4,4,10,-6,4
P'thinaikos,7469,4,1,1,4,5,13,-8,4
AEK Athens,7470,1,4,2,0,7,1,6,14
PAOK Salonik,7470,2,3,2,1,11,5,6,11
P'thinaikos,7470,3,1,1,4,5,11,-6,4
Panionios,7470,4,1,1,4,4,10,-6,4
AEK Athens,7471,1,4,2,0,7,1,6,14
PAOK Salonik,7471,2,2,3,1,10,5,5,9
P'thinaikos,7471,3,1,2,3,5,10,-5,5
Panionios,7471,4,1,1,4,4,10,-6,4
AEK Athens,7472,1,4,2,0,7,1,6,14
PAOK Salonik,7472,2,3,2,1,12,4,8,11
Panionios,7472,3,1,1,4,4,10,-6,4
P'thinaikos,7472,4,1,1,4,4,12,-8,4
AEK Athens,7473,1,4,2,0,7,1,6,14
PAOK Salonik,7473,2,3,2,1,11,5,6,11
P'thinaikos,7473,3,1,1,4,5,11,-6,4
Panionios,7473,4,1,1,4,4,10,-6,4
AEK Athens,7474,1,4,2,0,7,1,6,14
PAOK Salonik,7474,2,2,3,1,9,4,5,9
P'thinaikos,7474,3,1,2,3,4,9,-5,5
Panionios,7474,4,1,1,4,4,10,-6,4
AEK Athens,7475,1,4,2,0,7,1,6,14
PAOK Salonik,7475,2,2,3,1,10,5,5,9
P'thinaikos,7475,3,1,2,3,5,10,-5,5
Panionios,7475,4,1,1,4,4,10,-6,4
AEK Athens,7476,1,4,2,0,7,1,6,14
PAOK Salonik,7476,2,3,2,1,10,4,6,11
P'thinaikos,7476,3,1,1,4,4,10,-6,4
Panionios,7476,3,1,1,4,4,10,-6,4
AEK Athens,7477,1,4,2,0,7,1,6,14
PAOK Salonik,7477,2,2,2,2,10,6,4,8
P'thinaikos,7477,3,2,1,3,6,10,-4,7
Panionios,7477,4,1,1,4,4,10,-6,4
AEK Athens,7478,1,4,2,0,7,1,6,14
PAOK Salonik,7478,2,2,3,1,9,4,5,9
P'thinaikos,7478,3,1,2,3,4,9,-5,5
Panionios,7478,4,1,1,4,4,10,-6,4
AEK Athens,7479,1,4,2,0,7,1,6,14
PAOK Salonik,7479,2,2,2,2,9,5,4,8
P'thinaikos,7479,3,2,1,3,5,9,-4,7
Panionios,7479,4,1,1,4,4,10,-6,4
AEK Athens,7480,1,4,2,0,7,1,6,14
PAOK Salonik,7480,2,2,3,1,10,5,5,9
P'thinaikos,7480,3,1,2,3,5,10,-5,5
Panionios,7480,4,1,1,4,4,10,-6,4
AEK Athens,7481,1,4,2,0,7,1,6,14
PAOK Salonik,7481,2,2,2,2,9,7,2,8
P'thinaikos,7481,3,2,1,3,7,9,-2,7
Panionios,7481,4,1,1,4,4,10,-6,4
AEK Athens,7482,1,4,2,0,7,1,6,14
PAOK Salonik,7482,2,2,2,2,10,8,2,8
P'thinaikos,7482,3,2,1,3,8,10,-2,7
Panionios,7482,4,1,1,4,4,10,-6,4
AEK Athens,7483,1,4,2,0,7,1,6,14
PAOK Salonik,7483,2,3,2,1,12,4,8,11
Panionios,7483,3,1,1,4,4,10,-6,4
P'thinaikos,7483,4,1,1,4,4,12,-8,4
AEK Athens,7484,1,4,2,0,7,1,6,14
PAOK Salonik,7484,2,2,2,2,9,5,4,8
P'thinaikos,7484,3,2,1,3,5,9,-4,7
Panionios,7484,4,1,1,4,4,10,-6,4
AEK Athens,7485,1,4,2,0,7,1,6,14
PAOK Salonik,7485,2,3,2,1,12,6,6,11
P'thinaikos,7485,3,1,1,4,6,12,-6,4
Panionios,7485,4,1,1,4,4,10,-6,4
AEK Athens,7486,1,4,2,0,7,1,6,14
PAOK Salonik,7486,2,2,2,2,9,6,3,8
P'thinaikos,7486,3,2,1,3,6,9,-3,7
Panionios,7486,4,1,1,4,4,10,-6,4
AEK Athens,7487,1,4,2,0,7,1,6,14
PAOK Salonik,7487,2,3,2,1,11,4,7,11
Panionios,7487,3,1,1,4,4,10,-6,4
P'thinaikos,7487,4,1,1,4,4,11,-7,4
AEK Athens,7488,1,4,2,0,7,1,6,14
PAOK Salonik,7488,2,2,2,2,11,7,4,8
P'thinaikos,7488,3,2,1,3,7,11,-4,7
Panionios,7488,4,1,1,4,4,10,-6,4
AEK Athens,7489,1,4,2,0,7,1,6,14
PAOK Salonik,7489,2,2,3,1,9,4,5,9
P'thinaikos,7489,3,1,2,3,4,9,-5,5
Panionios,7489,4,1,1,4,4,10,-6,4
AEK Athens,7490,1,4,2,0,7,1,6,14
PAOK Salonik,7490,2,2,2,2,10,7,3,8
P'thinaikos,7490,3,2,1,3,7,10,-3,7
Panionios,7490,4,1,1,4,4,10,-6,4
AEK Athens,7491,1,4,2,0,7,1,6,14
PAOK Salonik,7491,2,2,3,1,9,4,5,9
P'thinaikos,7491,3,1,2,3,4,9,-5,5
Panionios,7491,4,1,1,4,4,10,-6,4
AEK Athens,7492,1,4,2,0,7,1,6,14
PAOK Salonik,7492,2,3,2,1,10,4,6,11
P'thinaikos,7492,3,1,1,4,4,10,-6,4
Panionios,7492,3,1,1,4,4,10,-6,4
AEK Athens,7493,1,4,2,0,7,1,6,14
PAOK Salonik,7493,2,2,3,1,11,6,5,9
P'thinaikos,7493,3,1,2,3,6,11,-5,5
Panionios,7493,4,1,1,4,4,10,-6,4
AEK Athens,7494,1,4,2,0,7,1,6,14
PAOK Salonik,7494,2,3,2,1,10,4,6,11
P'thinaikos,7494,3,1,1,4,4,10,-6,4
Panionios,7494,3,1,1,4,4,10,-6,4
AEK Athens,7495,1,4,2,0,7,1,6,14
PAOK Salonik,7495,2,3,2,1,12,4,8,11
Panionios,7495,3,1,1,4,4,10,-6,4
P'thinaikos,7495,4,1,1,4,4,12,-8,4
AEK Athens,7496,1,4,2,0,7,1,6,14
PAOK Salonik,7496,2,2,2,2,9,6,3,8
P'thinaikos,7496,3,2,1,3,6,9,-3,7
Panionios,7496,4,1,1,4,4,10,-6,4
AEK Athens,7497,1,4,2,0,7,1,6,14
PAOK Salonik,7497,2,2,2,2,9,9,0,8
P'thinaikos,7497,3,2,1,3,9,9,0,7
Panionios,7497,4,1,1,4,4,10,-6,4
AEK Athens,7498,1,4,2,0,7,1,6,14
PAOK Salonik,7498,2,2,2,2,10,6,4,8
P'thinaikos,7498,3,2,1,3,6,10,-4,7
Panionios,7498,4,1,1,4,4,10,-6,4
AEK Athens,7499,1,4,2,0,7,1,6,14
PAOK Salonik,7499,2,2,3,1,9,4,5,9
P'thinaikos,7499,3,1,2,3,4,9,-5,5
Panionios,7499,4,1,1,4,4,10,-6,4
AEK Athens,7500,1,4,2,0,7,1,6,14
PAOK Salonik,7500,2,2,2,2,10,6,4,8
P'thinaikos,7500,3,2,1,3,6,10,-4,7
Panionios,7500,4,1,1,4,4,10,-6,4
AEK Athens,7501,1,4,2,0,7,1,6,14
PAOK Salonik,7501,2,2,2,2,9,5,4,8
P'thinaikos,7501,3,2,1,3,5,9,-4,7
Panionios,7501,4,1,1,4,4,10,-6,4
AEK Athens,7502,1,4,2,0,7,1,6,14
PAOK Salonik,7502,2,3,2,1,12,5,7,11
Panionios,7502,3,1,1,4,4,10,-6,4
P'thinaikos,7502,4,1,1,4,5,12,-7,4
AEK Athens,7503,1,4,2,0,7,1,6,14
PAOK Salonik,7503,2,2,2,2,9,5,4,8
P'thinaikos,7503,3,2,1,3,5,9,-4,7
Panionios,7503,4,1,1,4,4,10,-6,4
AEK Athens,7504,1,4,2,0,7,1,6,14
PAOK Salonik,7504,2,3,2,1,10,4,6,11
P'thinaikos,7504,3,1,1,4,4,10,-6,4
Panionios,7504,3,1,1,4,4,10,-6,4
AEK Athens,7505,1,4,2,0,7,1,6,14
PAOK Salonik,7505,2,2,3,1,9,4,5,9
P'thinaikos,7505,3,1,2,3,4,9,-5,5
Panionios,7505,4,1,1,4,4,10,-6,4
AEK Athens,7506,1,4,2,0,7,1,6,14
PAOK Salonik,7506,2,3,2,1,14,5,9,11
Panionios,7506,3,1,1,4,4,10,-6,4
P'thinaikos,7506,4,1,1,4,5,14,-9,4
AEK Athens,7507,1,4,2,0,7,1,6,14
PAOK Salonik,7507,2,2,3,1,9,4,5,9
P'thinaikos,7507,3,1,2,3,4,9,-5,5
Panionios,7507,4,1,1,4,4,10,-6,4
AEK Athens,7508,1,4,2,0,7,1,6,14
PAOK Salonik,7508,2,2,2,2,9,5,4,8
P'thinaikos,7508,3,2,1,3,5,9,-4,7
Panionios,7508,4,1,1,4,4,10,-6,4
AEK Athens,7509,1,4,2,0,7,1,6,14
PAOK Salonik,7509,2,3,2,1,11,4,7,11
Panionios,7509,3,1,1,4,4,10,-6,4
P'thinaikos,7509,4,1,1,4,4,11,-7,4
AEK Athens,7510,1,4,2,0,7,1,6,14
PAOK Salonik,7510,2,2,3,1,10,5,5,9
P'thinaikos,7510,3,1,2,3,5,10,-5,5
Panionios,7510,4,1,1,4,4,10,-6,4
AEK Athens,7511,1,4,2,0,7,1,6,14
PAOK Salonik,7511,2,2,2,2,10,7,3,8
P'thinaikos,7511,3,2,1,3,7,10,-3,7
Panionios,7511,4,1,1,4,4,10,-6,4
AEK Athens,7512,1,4,2,0,7,1,6,14
PAOK Salonik,7512,2,2,2,2,9,5,4,8
P'thinaikos,7512,3,2,1,3,5,9,-4,7
Panionios,7512,4,1,1,4,4,10,-6,4
AEK Athens,7513,1,4,2,0,7,1,6,14
PAOK Salonik,7513,2,2,3,1,10,5,5,9
P'thinaikos,7513,3,1,2,3,5,10,-5,5
Panionios,7513,4,1,1,4,4,10,-6,4
AEK Athens,7514,1,4,2,0,7,1,6,14
PAOK Salonik,7514,2,2,2,2,10,7,3,8
P'thinaikos,7514,3,2,1,3,7,10,-3,7
Panionios,7514,4,1,1,4,4,10,-6,4
AEK Athens,7515,1,4,2,0,7,1,6,14
PAOK Salonik,7515,2,2,3,1,10,5,5,9
P'thinaikos,7515,3,1,2,3,5,10,-5,5
Panionios,7515,4,1,1,4,4,10,-6,4
AEK Athens,7516,1,4,2,0,7,1,6,14
PAOK Salonik,7516,2,2,2,2,9,6,3,8
P'thinaikos,7516,3,2,1,3,6,9,-3,7
Panionios,7516,4,1,1,4,4,10,-6,4
AEK Athens,7517,1,4,2,0,7,1,6,14
PAOK Salonik,7517,2,2,2,2,9,5,4,8
P'thinaikos,7517,3,2,1,3,5,9,-4,7
Panionios,7517,4,1,1,4,4,10,-6,4
AEK Athens,7518,1,4,2,0,7,1,6,14
PAOK Salonik,7518,2,2,2,2,9,5,4,8
P'thinaikos,7518,3,2,1,3,5,9,-4,7
Panionios,7518,4,1,1,4,4,10,-6,4
AEK Athens,7519,1,4,2,0,7,1,6,14
PAOK Salonik,7519,2,2,2,2,9,5,4,8
P'thinaikos,7519,3,2,1,3,5,9,-4,7
Panionios,7519,4,1,1,4,4,10,-6,4
AEK Athens,7520,1,4,2,0,7,1,6,14
PAOK Salonik,7520,2,3,2,1,12,6,6,11
P'thinaikos,7520,3,1,1,4,6,12,-6,4
Panionios,7520,4,1,1,4,4,10,-6,4
AEK Athens,7521,1,4,2,0,7,1,6,14
PAOK Salonik,7521,2,3,2,1,10,4,6,11
P'thinaikos,7521,3,1,1,4,4,10,-6,4
Panionios,7521,3,1,1,4,4,10,-6,4
AEK Athens,7522,1,4,2,0,7,1,6,14
PAOK Salonik,7522,2,2,2,2,9,6,3,8
P'thinaikos,7522,3,2,1,3,6,9,-3,7
Panionios,7522,4,1,1,4,4,10,-6,4
AEK Athens,7523,1,4,2,0,7,1,6,14
PAOK Salonik,7523,2,2,2,2,9,5,4,8
P'thinaikos,7523,3,2,1,3,5,9,-4,7
Panionios,7523,4,1,1,4,4,10,-6,4
AEK Athens,7524,1,4,2,0,7,1,6,14
PAOK Salonik,7524,2,2,3,1,11,6,5,9
P'thinaikos,7524,3,1,2,3,6,11,-5,5
Panionios,7524,4,1,1,4,4,10,-6,4
AEK Athens,7525,1,4,2,0,7,1,6,14
PAOK Salonik,7525,2,2,2,2,9,5,4,8
P'thinaikos,7525,3,2,1,3,5,9,-4,7
Panionios,7525,4,1,1,4,4,10,-6,4
AEK Athens,7526,1,4,2,0,7,1,6,14
PAOK Salonik,7526,2,3,2,1,10,4,6,11
P'thinaikos,7526,3,1,1,4,4,10,-6,4
Panionios,7526,3,1,1,4,4,10,-6,4
AEK Athens,7527,1,4,2,0,7,1,6,14
PAOK Salonik,7527,2,2,3,1,10,5,5,9
P'thinaikos,7527,3,1,2,3,5,10,-5,5
Panionios,7527,4,1,1,4,4,10,-6,4
AEK Athens,7528,1,4,2,0,7,1,6,14
PAOK Salonik,7528,2,3,2,1,10,4,6,11
P'thinaikos,7528,3,1,1,4,4,10,-6,4
Panionios,7528,3,1,1,4,4,10,-6,4
AEK Athens,7529,1,4,2,0,7,1,6,14
PAOK Salonik,7529,2,2,2,2,10,6,4,8
P'thinaikos,7529,3,2,1,3,6,10,-4,7
Panionios,7529,4,1,1,4,4,10,-6,4
AEK Athens,7530,1,4,2,0,7,1,6,14
PAOK Salonik,7530,2,3,2,1,10,4,6,11
P'thinaikos,7530,3,1,1,4,4,10,-6,4
Panionios,7530,3,1,1,4,4,10,-6,4
AEK Athens,7531,1,4,2,0,7,1,6,14
PAOK Salonik,7531,2,2,2,2,9,5,4,8
P'thinaikos,7531,3,2,1,3,5,9,-4,7
Panionios,7531,4,1,1,4,4,10,-6,4
AEK Athens,7532,1,4,2,0,7,1,6,14
PAOK Salonik,7532,2,3,2,1,11,5,6,11
P'thinaikos,7532,3,1,1,4,5,11,-6,4
Panionios,7532,4,1,1,4,4,10,-6,4
AEK Athens,7533,1,4,2,0,7,1,6,14
PAOK Salonik,7533,2,3,2,1,13,4,9,11
Panionios,7533,3,1,1,4,4,10,-6,4
P'thinaikos,7533,4,1,1,4,4,13,-9,4
AEK Athens,7534,1,4,2,0,7,1,6,14
PAOK Salonik,7534,2,3,2,1,11,5,6,11
P'thinaikos,7534,3,1,1,4,5,11,-6,4
Panionios,7534,4,1,1,4,4,10,-6,4
AEK Athens,7535,1,4,2,0,7,1,6,14
PAOK Salonik,7535,2,3,2,1,13,6,7,11
Panionios,7535,3,1,1,4,4,10,-6,4
P'thinaikos,7535,4,1,1,4,6,13,-7,4
AEK Athens,7536,1,4,2,0,7,1,6,14
PAOK Salonik,7536,2,2,3,1,12,7,5,9
P'thinaikos,7536,3,1,2,3,7,12,-5,5
Panionios,7536,4,1,1,4,4,10,-6,4
AEK Athens,7537,1,4,2,0,7,1,6,14
PAOK Salonik,7537,2,2,3,1,10,5,5,9
P'thinaikos,7537,3,1,2,3,5,10,-5,5
Panionios,7537,4,1,1,4,4,10,-6,4
AEK Athens,7538,1,4,2,0,7,1,6,14
PAOK Salonik,7538,2,3,2,1,12,4,8,11
Panionios,7538,3,1,1,4,4,10,-6,4
P'thinaikos,7538,4,1,1,4,4,12,-8,4
AEK Athens,7539,1,4,2,0,7,1,6,14
PAOK Salonik,7539,2,3,2,1,11,4,7,11
Panionios,7539,3,1,1,4,4,10,-6,4
P'thinaikos,7539,4,1,1,4,4,11,-7,4
AEK Athens,7540,1,4,2,0,7,1,6,14
PAOK Salonik,7540,2,3,2,1,13,6,7,11
Panionios,7540,3,1,1,4,4,10,-6,4
P'thinaikos,7540,4,1,1,4,6,13,-7,4
AEK Athens,7541,1,4,2,0,7,1,6,14
PAOK Salonik,7541,2,3,2,1,10,4,6,11
P'thinaikos,7541,3,1,1,4,4,10,-6,4
Panionios,7541,3,1,1,4,4,10,-6,4
AEK Athens,7542,1,4,2,0,7,1,6,14
PAOK Salonik,7542,2,3,2,1,12,5,7,11
Panionios,7542,3,1,1,4,4,10,-6,4
P'thinaikos,7542,4,1,1,4,5,12,-7,4
AEK Athens,7543,1,4,2,0,7,1,6,14
PAOK Salonik,7543,2,3,2,1,12,6,6,11
P'thinaikos,7543,3,1,1,4,6,12,-6,4
Panionios,7543,4,1,1,4,4,10,-6,4
AEK Athens,7544,1,4,2,0,7,1,6,14
PAOK Salonik,7544,2,3,2,1,11,4,7,11
Panionios,7544,3,1,1,4,4,10,-6,4
P'thinaikos,7544,4,1,1,4,4,11,-7,4
AEK Athens,7545,1,4,2,0,7,1,6,14
PAOK Salonik,7545,2,2,3,1,11,6,5,9
P'thinaikos,7545,3,1,2,3,6,11,-5,5
Panionios,7545,4,1,1,4,4,10,-6,4
AEK Athens,7546,1,4,2,0,7,1,6,14
PAOK Salonik,7546,2,2,3,1,10,5,5,9
P'thinaikos,7546,3,1,2,3,5,10,-5,5
Panionios,7546,4,1,1,4,4,10,-6,4
AEK Athens,7547,1,4,2,0,7,1,6,14
PAOK Salonik,7547,2,2,2,2,10,8,2,8
P'thinaikos,7547,3,2,1,3,8,10,-2,7
Panionios,7547,4,1,1,4,4,10,-6,4
AEK Athens,7548,1,4,2,0,7,1,6,14
PAOK Salonik,7548,2,3,2,1,11,5,6,11
P'thinaikos,7548,3,1,1,4,5,11,-6,4
Panionios,7548,4,1,1,4,4,10,-6,4
AEK Athens,7549,1,4,2,0,7,1,6,14
PAOK Salonik,7549,2,2,2,2,9,5,4,8
P'thinaikos,7549,3,2,1,3,5,9,-4,7
Panionios,7549,4,1,1,4,4,10,-6,4
AEK Athens,7550,1,4,2,0,7,1,6,14
PAOK Salonik,7550,2,3,2,1,11,4,7,11
Panionios,7550,3,1,1,4,4,10,-6,4
P'thinaikos,7550,4,1,1,4,4,11,-7,4
AEK Athens,7551,1,4,2,0,7,1,6,14
PAOK Salonik,7551,2,3,2,1,13,5,8,11
Panionios,7551,3,1,1,4,4,10,-6,4
P'thinaikos,7551,4,1,1,4,5,13,-8,4
AEK Athens,7552,1,4,2,0,7,1,6,14
PAOK Salonik,7552,2,2,3,1,10,5,5,9
P'thinaikos,7552,3,1,2,3,5,10,-5,5
Panionios,7552,4,1,1,4,4,10,-6,4
AEK Athens,7553,1,4,2,0,7,1,6,14
PAOK Salonik,7553,2,2,2,2,9,6,3,8
P'thinaikos,7553,3,2,1,3,6,9,-3,7
Panionios,7553,4,1,1,4,4,10,-6,4
AEK Athens,7554,1,4,2,0,7,1,6,14
PAOK Salonik,7554,2,3,2,1,12,5,7,11
Panionios,7554,3,1,1,4,4,10,-6,4
P'thinaikos,7554,4,1,1,4,5,12,-7,4
AEK Athens,7555,1,4,2,0,7,1,6,14
PAOK Salonik,7555,2,2,2,2,9,8,1,8
P'thinaikos,7555,3,2,1,3,8,9,-1,7
Panionios,7555,4,1,1,4,4,10,-6,4
AEK Athens,7556,1,4,2,0,7,1,6,14
PAOK Salonik,7556,2,2,2,2,10,6,4,8
P'thinaikos,7556,3,2,1,3,6,10,-4,7
Panionios,7556,4,1,1,4,4,10,-6,4
AEK Athens,7557,1,4,2,0,7,1,6,14
PAOK Salonik,7557,2,2,3,1,11,6,5,9
P'thinaikos,7557,3,1,2,3,6,11,-5,5
Panionios,7557,4,1,1,4,4,10,-6,4
AEK Athens,7558,1,4,2,0,7,1,6,14
PAOK Salonik,7558,2,2,2,2,9,6,3,8
P'thinaikos,7558,3,2,1,3,6,9,-3,7
Panionios,7558,4,1,1,4,4,10,-6,4
AEK Athens,7559,1,4,2,0,7,1,6,14
PAOK Salonik,7559,2,2,3,1,9,4,5,9
P'thinaikos,7559,3,1,2,3,4,9,-5,5
Panionios,7559,4,1,1,4,4,10,-6,4
AEK Athens,7560,1,4,2,0,7,1,6,14
PAOK Salonik,7560,2,2,2,2,9,5,4,8
P'thinaikos,7560,3,2,1,3,5,9,-4,7
Panionios,7560,4,1,1,4,4,10,-6,4
AEK Athens,7561,1,4,2,0,7,1,6,14
PAOK Salonik,7561,2,3,2,1,13,5,8,11
Panionios,7561,3,1,1,4,4,10,-6,4
P'thinaikos,7561,4,1,1,4,5,13,-8,4
AEK Athens,7562,1,4,2,0,7,1,6,14
PAOK Salonik,7562,2,2,3,1,10,5,5,9
P'thinaikos,7562,3,1,2,3,5,10,-5,5
Panionios,7562,4,1,1,4,4,10,-6,4
AEK Athens,7563,1,4,2,0,7,1,6,14
PAOK Salonik,7563,2,2,3,1,9,4,5,9
P'thinaikos,7563,3,1,2,3,4,9,-5,5
Panionios,7563,4,1,1,4,4,10,-6,4
AEK Athens,7564,1,4,2,0,7,1,6,14
PAOK Salonik,7564,2,3,2,1,11,5,6,11
P'thinaikos,7564,3,1,1,4,5,11,-6,4
Panionios,7564,4,1,1,4,4,10,-6,4
AEK Athens,7565,1,4,2,0,7,1,6,14
PAOK Salonik,7565,2,2,2,2,9,7,2,8
P'thinaikos,7565,3,2,1,3,7,9,-2,7
Panionios,7565,4,1,1,4,4,10,-6,4
AEK Athens,7566,1,4,2,0,7,1,6,14
PAOK Salonik,7566,2,2,2,2,9,5,4,8
P'thinaikos,7566,3,2,1,3,5,9,-4,7
Panionios,7566,4,1,1,4,4,10,-6,4
AEK Athens,7567,1,4,2,0,7,1,6,14
PAOK Salonik,7567,2,3,2,1,13,7,6,11
P'thinaikos,7567,3,1,1,4,7,13,-6,4
Panionios,7567,4,1,1,4,4,10,-6,4
AEK Athens,7568,1,4,2,0,7,1,6,14
PAOK Salonik,7568,2,2,2,2,9,5,4,8
P'thinaikos,7568,3,2,1,3,5,9,-4,7
Panionios,7568,4,1,1,4,4,10,-6,4
AEK Athens,7569,1,4,2,0,7,1,6,14
PAOK Salonik,7569,2,2,2,2,10,6,4,8
P'thinaikos,7569,3,2,1,3,6,10,-4,7
Panionios,7569,4,1,1,4,4,10,-6,4
AEK Athens,7570,1,4,2,0,7,1,6,14
PAOK Salonik,7570,2,3,2,1,11,5,6,11
P'thinaikos,7570,3,1,1,4,5,11,-6,4
Panionios,7570,4,1,1,4,4,10,-6,4
AEK Athens,7571,1,4,2,0,7,1,6,14
PAOK Salonik,7571,2,2,3,1,9,4,5,9
P'thinaikos,7571,3,1,2,3,4,9,-5,5
Panionios,7571,4,1,1,4,4,10,-6,4
AEK Athens,7572,1,4,2,0,7,1,6,14
PAOK Salonik,7572,2,2,2,2,10,6,4,8
P'thinaikos,7572,3,2,1,3,6,10,-4,7
Panionios,7572,4,1,1,4,4,10,-6,4
AEK Athens,7573,1,4,2,0,7,1,6,14
PAOK Salonik,7573,2,3,2,1,11,5,6,11
P'thinaikos,7573,3,1,1,4,5,11,-6,4
Panionios,7573,4,1,1,4,4,10,-6,4
AEK Athens,7574,1,4,2,0,7,1,6,14
PAOK Salonik,7574,2,2,3,1,9,4,5,9
P'thinaikos,7574,3,1,2,3,4,9,-5,5
Panionios,7574,4,1,1,4,4,10,-6,4
AEK Athens,7575,1,4,2,0,7,1,6,14
PAOK Salonik,7575,2,3,2,1,11,4,7,11
Panionios,7575,3,1,1,4,4,10,-6,4
P'thinaikos,7575,4,1,1,4,4,11,-7,4
AEK Athens,7576,1,4,2,0,7,1,6,14
PAOK Salonik,7576,2,2,2,2,10,6,4,8
P'thinaikos,7576,3,2,1,3,6,10,-4,7
Panionios,7576,4,1,1,4,4,10,-6,4
AEK Athens,7577,1,4,2,0,7,1,6,14
PAOK Salonik,7577,2,2,3,1,10,5,5,9
P'thinaikos,7577,3,1,2,3,5,10,-5,5
Panionios,7577,4,1,1,4,4,10,-6,4
AEK Athens,7578,1,4,2,0,7,1,6,14
PAOK Salonik,7578,2,3,2,1,11,4,7,11
Panionios,7578,3,1,1,4,4,10,-6,4
P'thinaikos,7578,4,1,1,4,4,11,-7,4
AEK Athens,7579,1,4,2,0,7,1,6,14
PAOK Salonik,7579,2,2,2,2,11,7,4,8
P'thinaikos,7579,3,2,1,3,7,11,-4,7
Panionios,7579,4,1,1,4,4,10,-6,4
AEK Athens,7580,1,4,2,0,7,1,6,14
PAOK Salonik,7580,2,3,2,1,10,4,6,11
P'thinaikos,7580,3,1,1,4,4,10,-6,4
Panionios,7580,3,1,1,4,4,10,-6,4
AEK Athens,7581,1,4,2,0,7,1,6,14
PAOK Salonik,7581,2,2,2,2,9,5,4,8
P'thinaikos,7581,3,2,1,3,5,9,-4,7
Panionios,7581,4,1,1,4,4,10,-6,4
AEK Athens,7582,1,4,2,0,7,1,6,14
PAOK Salonik,7582,2,2,3,1,11,6,5,9
P'thinaikos,7582,3,1,2,3,6,11,-5,5
Panionios,7582,4,1,1,4,4,10,-6,4
AEK Athens,7583,1,4,2,0,7,1,6,14
PAOK Salonik,7583,2,2,3,1,11,6,5,9
P'thinaikos,7583,3,1,2,3,6,11,-5,5
Panionios,7583,4,1,1,4,4,10,-6,4
AEK Athens,7584,1,4,2,0,7,1,6,14
PAOK Salonik,7584,2,2,2,2,10,7,3,8
P'thinaikos,7584,3,2,1,3,7,10,-3,7
Panionios,7584,4,1,1,4,4,10,-6,4
AEK Athens,7585,1,4,2,0,7,1,6,14
PAOK Salonik,7585,2,2,2,2,9,8,1,8
P'thinaikos,7585,3,2,1,3,8,9,-1,7
Panionios,7585,4,1,1,4,4,10,-6,4
AEK Athens,7586,1,4,2,0,7,1,6,14
PAOK Salonik,7586,2,2,3,1,11,6,5,9
P'thinaikos,7586,3,1,2,3,6,11,-5,5
Panionios,7586,4,1,1,4,4,10,-6,4
AEK Athens,7587,1,4,2,0,7,1,6,14
PAOK Salonik,7587,2,3,2,1,11,4,7,11
Panionios,7587,3,1,1,4,4,10,-6,4
P'thinaikos,7587,4,1,1,4,4,11,-7,4
AEK Athens,7588,1,4,2,0,7,1,6,14
PAOK Salonik,7588,2,2,2,2,10,7,3,8
P'thinaikos,7588,3,2,1,3,7,10,-3,7
Panionios,7588,4,1,1,4,4,10,-6,4
AEK Athens,7589,1,4,2,0,7,1,6,14
PAOK Salonik,7589,2,3,2,1,10,4,6,11
P'thinaikos,7589,3,1,1,4,4,10,-6,4
Panionios,7589,3,1,1,4,4,10,-6,4
AEK Athens,7590,1,4,2,0,7,1,6,14
PAOK Salonik,7590,2,2,2,2,9,7,2,8
P'thinaikos,7590,3,2,1,3,7,9,-2,7
Panionios,7590,4,1,1,4,4,10,-6,4
AEK Athens,7591,1,4,2,0,7,1,6,14
PAOK Salonik,7591,2,3,2,1,10,4,6,11
P'thinaikos,7591,3,1,1,4,4,10,-6,4
Panionios,7591,3,1,1,4,4,10,-6,4
AEK Athens,7592,1,4,2,0,7,1,6,14
PAOK Salonik,7592,2,2,3,1,10,5,5,9
P'thinaikos,7592,3,1,2,3,5,10,-5,5
Panionios,7592,4,1,1,4,4,10,-6,4
AEK Athens,7593,1,4,2,0,7,1,6,14
PAOK Salonik,7593,2,2,3,1,10,5,5,9
P'thinaikos,7593,3,1,2,3,5,10,-5,5
Panionios,7593,4,1,1,4,4,10,-6,4
AEK Athens,7594,1,4,2,0,7,1,6,14
PAOK Salonik,7594,2,2,3,1,10,5,5,9
P'thinaikos,7594,3,1,2,3,5,10,-5,5
Panionios,7594,4,1,1,4,4,10,-6,4
AEK Athens,7595,1,4,2,0,7,1,6,14
PAOK Salonik,7595,2,2,2,2,10,6,4,8
P'thinaikos,7595,3,2,1,3,6,10,-4,7
Panionios,7595,4,1,1,4,4,10,-6,4
AEK Athens,7596,1,4,2,0,7,1,6,14
PAOK Salonik,7596,2,2,2,2,11,7,4,8
P'thinaikos,7596,3,2,1,3,7,11,-4,7
Panionios,7596,4,1,1,4,4,10,-6,4
AEK Athens,7597,1,4,2,0,7,1,6,14
PAOK Salonik,7597,2,2,2,2,10,8,2,8
P'thinaikos,7597,3,2,1,3,8,10,-2,7
Panionios,7597,4,1,1,4,4,10,-6,4
AEK Athens,7598,1,4,2,0,7,1,6,14
PAOK Salonik,7598,2,2,2,2,9,7,2,8
P'thinaikos,7598,3,2,1,3,7,9,-2,7
Panionios,7598,4,1,1,4,4,10,-6,4
AEK Athens,7599,1,4,2,0,7,1,6,14
PAOK Salonik,7599,2,3,2,1,13,7,6,11
P'thinaikos,7599,3,1,1,4,7,13,-6,4
Panionios,7599,4,1,1,4,4,10,-6,4
AEK Athens,7600,1,4,2,0,7,1,6,14
PAOK Salonik,7600,2,2,3,1,9,4,5,9
P'thinaikos,7600,3,1,2,3,4,9,-5,5
Panionios,7600,4,1,1,4,4,10,-6,4
AEK Athens,7601,1,4,2,0,7,1,6,14
PAOK Salonik,7601,2,3,2,1,11,4,7,11
Panionios,7601,3,1,1,4,4,10,-6,4
P'thinaikos,7601,4,1,1,4,4,11,-7,4
AEK Athens,7602,1,4,2,0,7,1,6,14
PAOK Salonik,7602,2,2,3,1,9,4,5,9
P'thinaikos,7602,3,1,2,3,4,9,-5,5
Panionios,7602,4,1,1,4,4,10,-6,4
AEK Athens,7603,1,4,2,0,7,1,6,14
PAOK Salonik,7603,2,2,2,2,11,7,4,8
P'thinaikos,7603,3,2,1,3,7,11,-4,7
Panionios,7603,4,1,1,4,4,10,-6,4
AEK Athens,7604,1,4,2,0,7,1,6,14
PAOK Salonik,7604,2,2,3,1,10,5,5,9
P'thinaikos,7604,3,1,2,3,5,10,-5,5
Panionios,7604,4,1,1,4,4,10,-6,4
AEK Athens,7605,1,4,2,0,7,1,6,14
PAOK Salonik,7605,2,3,2,1,11,4,7,11
Panionios,7605,3,1,1,4,4,10,-6,4
P'thinaikos,7605,4,1,1,4,4,11,-7,4
AEK Athens,7606,1,4,2,0,7,1,6,14
PAOK Salonik,7606,2,3,2,1,11,5,6,11
P'thinaikos,7606,3,1,1,4,5,11,-6,4
Panionios,7606,4,1,1,4,4,10,-6,4
AEK Athens,7607,1,4,2,0,7,1,6,14
PAOK Salonik,7607,2,3,2,1,11,5,6,11
P'thinaikos,7607,3,1,1,4,5,11,-6,4
Panionios,7607,4,1,1,4,4,10,-6,4
AEK Athens,7608,1,4,2,0,7,1,6,14
PAOK Salonik,7608,2,2,2,2,9,5,4,8
P'thinaikos,7608,3,2,1,3,5,9,-4,7
Panionios,7608,4,1,1,4,4,10,-6,4
AEK Athens,7609,1,4,2,0,7,1,6,14
PAOK Salonik,7609,2,2,2,2,11,7,4,8
P'thinaikos,7609,3,2,1,3,7,11,-4,7
Panionios,7609,4,1,1,4,4,10,-6,4
AEK Athens,7610,1,4,2,0,7,1,6,14
PAOK Salonik,7610,2,3,2,1,11,5,6,11
P'thinaikos,7610,3,1,1,4,5,11,-6,4
Panionios,7610,4,1,1,4,4,10,-6,4
AEK Athens,7611,1,4,2,0,7,1,6,14
PAOK Salonik,7611,2,2,2,2,9,5,4,8
P'thinaikos,7611,3,2,1,3,5,9,-4,7
Panionios,7611,4,1,1,4,4,10,-6,4
AEK Athens,7612,1,4,2,0,7,1,6,14
PAOK Salonik,7612,2,2,2,2,9,5,4,8
P'thinaikos,7612,3,2,1,3,5,9,-4,7
Panionios,7612,4,1,1,4,4,10,-6,4
AEK Athens,7613,1,4,2,0,7,1,6,14
PAOK Salonik,7613,2,2,2,2,9,5,4,8
P'thinaikos,7613,3,2,1,3,5,9,-4,7
Panionios,7613,4,1,1,4,4,10,-6,4
AEK Athens,7614,1,4,2,0,7,1,6,14
PAOK Salonik,7614,2,2,2,2,9,7,2,8
P'thinaikos,7614,3,2,1,3,7,9,-2,7
Panionios,7614,4,1,1,4,4,10,-6,4
AEK Athens,7615,1,4,2,0,7,1,6,14
PAOK Salonik,7615,2,2,3,1,12,7,5,9
P'thinaikos,7615,3,1,2,3,7,12,-5,5
Panionios,7615,4,1,1,4,4,10,-6,4
AEK Athens,7616,1,4,2,0,7,1,6,14
PAOK Salonik,7616,2,3,2,1,11,5,6,11
P'thinaikos,7616,3,1,1,4,5,11,-6,4
Panionios,7616,4,1,1,4,4,10,-6,4
AEK Athens,7617,1,4,2,0,7,1,6,14
PAOK Salonik,7617,2,3,2,1,10,4,6,11
P'thinaikos,7617,3,1,1,4,4,10,-6,4
Panionios,7617,3,1,1,4,4,10,-6,4
AEK Athens,7618,1,4,2,0,7,1,6,14
PAOK Salonik,7618,2,3,2,1,11,4,7,11
Panionios,7618,3,1,1,4,4,10,-6,4
P'thinaikos,7618,4,1,1,4,4,11,-7,4
AEK Athens,7619,1,4,2,0,7,1,6,14
PAOK Salonik,7619,2,2,2,2,10,6,4,8
P'thinaikos,7619,3,2,1,3,6,10,-4,7
Panionios,7619,4,1,1,4,4,10,-6,4
AEK Athens,7620,1,4,2,0,7,1,6,14
PAOK Salonik,7620,2,2,2,2,9,5,4,8
P'thinaikos,7620,3,2,1,3,5,9,-4,7
Panionios,7620,4,1,1,4,4,10,-6,4
AEK Athens,7621,1,4,2,0,7,1,6,14
PAOK Salonik,7621,2,2,2,2,10,6,4,8
P'thinaikos,7621,3,2,1,3,6,10,-4,7
Panionios,7621,4,1,1,4,4,10,-6,4
AEK Athens,7622,1,4,2,0,7,1,6,14
PAOK Salonik,7622,2,2,2,2,9,5,4,8
P'thinaikos,7622,3,2,1,3,5,9,-4,7
Panionios,7622,4,1,1,4,4,10,-6,4
AEK Athens,7623,1,4,2,0,7,1,6,14
PAOK Salonik,7623,2,2,2,2,10,6,4,8
P'thinaikos,7623,3,2,1,3,6,10,-4,7
Panionios,7623,4,1,1,4,4,10,-6,4
AEK Athens,7624,1,4,2,0,7,1,6,14
PAOK Salonik,7624,2,2,2,2,9,7,2,8
P'thinaikos,7624,3,2,1,3,7,9,-2,7
Panionios,7624,4,1,1,4,4,10,-6,4
AEK Athens,7625,1,4,2,0,7,1,6,14
PAOK Salonik,7625,2,3,2,1,12,6,6,11
P'thinaikos,7625,3,1,1,4,6,12,-6,4
Panionios,7625,4,1,1,4,4,10,-6,4
AEK Athens,7626,1,4,2,0,7,1,6,14
PAOK Salonik,7626,2,3,2,1,11,5,6,11
P'thinaikos,7626,3,1,1,4,5,11,-6,4
Panionios,7626,4,1,1,4,4,10,-6,4
AEK Athens,7627,1,4,2,0,7,1,6,14
PAOK Salonik,7627,2,2,2,2,9,6,3,8
P'thinaikos,7627,3,2,1,3,6,9,-3,7
Panionios,7627,4,1,1,4,4,10,-6,4
AEK Athens,7628,1,4,2,0,7,1,6,14
PAOK Salonik,7628,2,2,3,1,10,5,5,9
P'thinaikos,7628,3,1,2,3,5,10,-5,5
Panionios,7628,4,1,1,4,4,10,-6,4
AEK Athens,7629,1,4,2,0,7,1,6,14
PAOK Salonik,7629,2,3,2,1,12,6,6,11
P'thinaikos,7629,3,1,1,4,6,12,-6,4
Panionios,7629,4,1,1,4,4,10,-6,4
AEK Athens,7630,1,4,2,0,7,1,6,14
PAOK Salonik,7630,2,3,2,1,12,6,6,11
P'thinaikos,7630,3,1,1,4,6,12,-6,4
Panionios,7630,4,1,1,4,4,10,-6,4
AEK Athens,7631,1,4,2,0,7,1,6,14
PAOK Salonik,7631,2,2,2,2,9,6,3,8
P'thinaikos,7631,3,2,1,3,6,9,-3,7
Panionios,7631,4,1,1,4,4,10,-6,4
AEK Athens,7632,1,4,2,0,7,1,6,14
PAOK Salonik,7632,2,2,3,1,12,7,5,9
P'thinaikos,7632,3,1,2,3,7,12,-5,5
Panionios,7632,4,1,1,4,4,10,-6,4
AEK Athens,7633,1,4,2,0,7,1,6,14
PAOK Salonik,7633,2,2,2,2,9,5,4,8
P'thinaikos,7633,3,2,1,3,5,9,-4,7
Panionios,7633,4,1,1,4,4,10,-6,4
AEK Athens,7634,1,4,2,0,7,1,6,14
PAOK Salonik,7634,2,3,2,1,11,4,7,11
Panionios,7634,3,1,1,4,4,10,-6,4
P'thinaikos,7634,4,1,1,4,4,11,-7,4
AEK Athens,7635,1,4,2,0,7,1,6,14
PAOK Salonik,7635,2,3,2,1,12,4,8,11
Panionios,7635,3,1,1,4,4,10,-6,4
P'thinaikos,7635,4,1,1,4,4,12,-8,4
AEK Athens,7636,1,4,2,0,7,1,6,14
PAOK Salonik,7636,2,3,2,1,11,4,7,11
Panionios,7636,3,1,1,4,4,10,-6,4
P'thinaikos,7636,4,1,1,4,4,11,-7,4
AEK Athens,7637,1,4,2,0,7,1,6,14
PAOK Salonik,7637,2,2,3,1,9,4,5,9
P'thinaikos,7637,3,1,2,3,4,9,-5,5
Panionios,7637,4,1,1,4,4,10,-6,4
AEK Athens,7638,1,4,2,0,7,1,6,14
PAOK Salonik,7638,2,3,2,1,10,4,6,11
P'thinaikos,7638,3,1,1,4,4,10,-6,4
Panionios,7638,3,1,1,4,4,10,-6,4
AEK Athens,7639,1,4,2,0,7,1,6,14
PAOK Salonik,7639,2,2,2,2,9,5,4,8
P'thinaikos,7639,3,2,1,3,5,9,-4,7
Panionios,7639,4,1,1,4,4,10,-6,4
AEK Athens,7640,1,4,2,0,7,1,6,14
PAOK Salonik,7640,2,2,3,1,10,5,5,9
P'thinaikos,7640,3,1,2,3,5,10,-5,5
Panionios,7640,4,1,1,4,4,10,-6,4
AEK Athens,7641,1,4,2,0,7,1,6,14
PAOK Salonik,7641,2,3,2,1,11,5,6,11
P'thinaikos,7641,3,1,1,4,5,11,-6,4
Panionios,7641,4,1,1,4,4,10,-6,4
AEK Athens,7642,1,4,2,0,7,1,6,14
PAOK Salonik,7642,2,3,2,1,12,4,8,11
Panionios,7642,3,1,1,4,4,10,-6,4
P'thinaikos,7642,4,1,1,4,4,12,-8,4
AEK Athens,7643,1,4,2,0,7,1,6,14
PAOK Salonik,7643,2,2,3,1,10,5,5,9
P'thinaikos,7643,3,1,2,3,5,10,-5,5
Panionios,7643,4,1,1,4,4,10,-6,4
AEK Athens,7644,1,4,2,0,7,1,6,14
PAOK Salonik,7644,2,3,2,1,11,4,7,11
Panionios,7644,3,1,1,4,4,10,-6,4
P'thinaikos,7644,4,1,1,4,4,11,-7,4
AEK Athens,7645,1,4,2,0,7,1,6,14
PAOK Salonik,7645,2,3,2,1,10,4,6,11
P'thinaikos,7645,3,1,1,4,4,10,-6,4
Panionios,7645,3,1,1,4,4,10,-6,4
AEK Athens,7646,1,4,2,0,7,1,6,14
PAOK Salonik,7646,2,2,3,1,10,5,5,9
P'thinaikos,7646,3,1,2,3,5,10,-5,5
Panionios,7646,4,1,1,4,4,10,-6,4
AEK Athens,7647,1,4,2,0,7,1,6,14
PAOK Salonik,7647,2,3,2,1,11,5,6,11
P'thinaikos,7647,3,1,1,4,5,11,-6,4
Panionios,7647,4,1,1,4,4,10,-6,4
AEK Athens,7648,1,4,2,0,7,1,6,14
PAOK Salonik,7648,2,2,2,2,9,7,2,8
P'thinaikos,7648,3,2,1,3,7,9,-2,7
Panionios,7648,4,1,1,4,4,10,-6,4
AEK Athens,7649,1,4,2,0,7,1,6,14
PAOK Salonik,7649,2,2,2,2,9,5,4,8
P'thinaikos,7649,3,2,1,3,5,9,-4,7
Panionios,7649,4,1,1,4,4,10,-6,4
AEK Athens,7650,1,4,2,0,7,1,6,14
PAOK Salonik,7650,2,2,3,1,10,5,5,9
P'thinaikos,7650,3,1,2,3,5,10,-5,5
Panionios,7650,4,1,1,4,4,10,-6,4
AEK Athens,7651,1,4,2,0,7,1,6,14
PAOK Salonik,7651,2,2,3,1,10,5,5,9
P'thinaikos,7651,3,1,2,3,5,10,-5,5
Panionios,7651,4,1,1,4,4,10,-6,4
AEK Athens,7652,1,4,2,0,7,1,6,14
PAOK Salonik,7652,2,3,2,1,11,4,7,11
Panionios,7652,3,1,1,4,4,10,-6,4
P'thinaikos,7652,4,1,1,4,4,11,-7,4
AEK Athens,7653,1,4,2,0,7,1,6,14
PAOK Salonik,7653,2,3,2,1,10,4,6,11
P'thinaikos,7653,3,1,1,4,4,10,-6,4
Panionios,7653,3,1,1,4,4,10,-6,4
AEK Athens,7654,1,4,2,0,7,1,6,14
PAOK Salonik,7654,2,3,2,1,13,6,7,11
Panionios,7654,3,1,1,4,4,10,-6,4
P'thinaikos,7654,4,1,1,4,6,13,-7,4
AEK Athens,7655,1,4,2,0,7,1,6,14
PAOK Salonik,7655,2,2,2,2,9,5,4,8
P'thinaikos,7655,3,2,1,3,5,9,-4,7
Panionios,7655,4,1,1,4,4,10,-6,4
AEK Athens,7656,1,4,2,0,7,1,6,14
PAOK Salonik,7656,2,3,2,1,12,4,8,11
Panionios,7656,3,1,1,4,4,10,-6,4
P'thinaikos,7656,4,1,1,4,4,12,-8,4
AEK Athens,7657,1,4,2,0,7,1,6,14
PAOK Salonik,7657,2,2,2,2,9,7,2,8
P'thinaikos,7657,3,2,1,3,7,9,-2,7
Panionios,7657,4,1,1,4,4,10,-6,4
AEK Athens,7658,1,4,2,0,7,1,6,14
PAOK Salonik,7658,2,2,2,2,10,6,4,8
P'thinaikos,7658,3,2,1,3,6,10,-4,7
Panionios,7658,4,1,1,4,4,10,-6,4
AEK Athens,7659,1,4,2,0,7,1,6,14
PAOK Salonik,7659,2,2,2,2,9,7,2,8
P'thinaikos,7659,3,2,1,3,7,9,-2,7
Panionios,7659,4,1,1,4,4,10,-6,4
AEK Athens,7660,1,4,2,0,7,1,6,14
PAOK Salonik,7660,2,2,2,2,9,5,4,8
P'thinaikos,7660,3,2,1,3,5,9,-4,7
Panionios,7660,4,1,1,4,4,10,-6,4
AEK Athens,7661,1,4,2,0,7,1,6,14
PAOK Salonik,7661,2,3,2,1,11,4,7,11
Panionios,7661,3,1,1,4,4,10,-6,4
P'thinaikos,7661,4,1,1,4,4,11,-7,4
AEK Athens,7662,1,4,2,0,7,1,6,14
PAOK Salonik,7662,2,2,2,2,9,5,4,8
P'thinaikos,7662,3,2,1,3,5,9,-4,7
Panionios,7662,4,1,1,4,4,10,-6,4
AEK Athens,7663,1,4,2,0,7,1,6,14
PAOK Salonik,7663,2,2,3,1,10,5,5,9
P'thinaikos,7663,3,1,2,3,5,10,-5,5
Panionios,7663,4,1,1,4,4,10,-6,4
AEK Athens,7664,1,4,2,0,7,1,6,14
PAOK Salonik,7664,2,2,3,1,10,5,5,9
P'thinaikos,7664,3,1,2,3,5,10,-5,5
Panionios,7664,4,1,1,4,4,10,-6,4
AEK Athens,7665,1,4,2,0,7,1,6,14
PAOK Salonik,7665,2,3,2,1,10,4,6,11
P'thinaikos,7665,3,1,1,4,4,10,-6,4
Panionios,7665,3,1,1,4,4,10,-6,4
AEK Athens,7666,1,4,2,0,7,1,6,14
PAOK Salonik,7666,2,3,2,1,12,4,8,11
Panionios,7666,3,1,1,4,4,10,-6,4
P'thinaikos,7666,4,1,1,4,4,12,-8,4
AEK Athens,7667,1,4,2,0,7,1,6,14
PAOK Salonik,7667,2,2,2,2,9,5,4,8
P'thinaikos,7667,3,2,1,3,5,9,-4,7
Panionios,7667,4,1,1,4,4,10,-6,4
AEK Athens,7668,1,4,2,0,7,1,6,14
PAOK Salonik,7668,2,2,2,2,9,6,3,8
P'thinaikos,7668,3,2,1,3,6,9,-3,7
Panionios,7668,4,1,1,4,4,10,-6,4
AEK Athens,7669,1,4,2,0,7,1,6,14
PAOK Salonik,7669,2,2,2,2,12,9,3,8
P'thinaikos,7669,3,2,1,3,9,12,-3,7
Panionios,7669,4,1,1,4,4,10,-6,4
AEK Athens,7670,1,4,2,0,7,1,6,14
PAOK Salonik,7670,2,3,2,1,11,4,7,11
Panionios,7670,3,1,1,4,4,10,-6,4
P'thinaikos,7670,4,1,1,4,4,11,-7,4
AEK Athens,7671,1,4,2,0,7,1,6,14
PAOK Salonik,7671,2,3,2,1,10,4,6,11
P'thinaikos,7671,3,1,1,4,4,10,-6,4
Panionios,7671,3,1,1,4,4,10,-6,4
AEK Athens,7672,1,4,2,0,7,1,6,14
PAOK Salonik,7672,2,2,2,2,9,6,3,8
P'thinaikos,7672,3,2,1,3,6,9,-3,7
Panionios,7672,4,1,1,4,4,10,-6,4
AEK Athens,7673,1,4,2,0,7,1,6,14
PAOK Salonik,7673,2,2,2,2,9,7,2,8
P'thinaikos,7673,3,2,1,3,7,9,-2,7
Panionios,7673,4,1,1,4,4,10,-6,4
AEK Athens,7674,1,4,2,0,7,1,6,14
PAOK Salonik,7674,2,2,2,2,10,6,4,8
P'thinaikos,7674,3,2,1,3,6,10,-4,7
Panionios,7674,4,1,1,4,4,10,-6,4
AEK Athens,7675,1,4,2,0,7,1,6,14
PAOK Salonik,7675,2,2,3,1,11,6,5,9
P'thinaikos,7675,3,1,2,3,6,11,-5,5
Panionios,7675,4,1,1,4,4,10,-6,4
AEK Athens,7676,1,4,2,0,7,1,6,14
PAOK Salonik,7676,2,2,2,2,9,6,3,8
P'thinaikos,7676,3,2,1,3,6,9,-3,7
Panionios,7676,4,1,1,4,4,10,-6,4
AEK Athens,7677,1,4,2,0,7,1,6,14
PAOK Salonik,7677,2,2,3,1,10,5,5,9
P'thinaikos,7677,3,1,2,3,5,10,-5,5
Panionios,7677,4,1,1,4,4,10,-6,4
AEK Athens,7678,1,4,2,0,7,1,6,14
PAOK Salonik,7678,2,3,2,1,10,4,6,11
P'thinaikos,7678,3,1,1,4,4,10,-6,4
Panionios,7678,3,1,1,4,4,10,-6,4
AEK Athens,7679,1,4,2,0,7,1,6,14
PAOK Salonik,7679,2,3,2,1,12,6,6,11
P'thinaikos,7679,3,1,1,4,6,12,-6,4
Panionios,7679,4,1,1,4,4,10,-6,4
AEK Athens,7680,1,4,2,0,7,1,6,14
PAOK Salonik,7680,2,2,2,2,9,5,4,8
P'thinaikos,7680,3,2,1,3,5,9,-4,7
Panionios,7680,4,1,1,4,4,10,-6,4
AEK Athens,7681,1,4,2,0,7,1,6,14
PAOK Salonik,7681,2,2,2,2,9,6,3,8
P'thinaikos,7681,3,2,1,3,6,9,-3,7
Panionios,7681,4,1,1,4,4,10,-6,4
AEK Athens,7682,1,4,2,0,7,1,6,14
PAOK Salonik,7682,2,2,2,2,9,5,4,8
P'thinaikos,7682,3,2,1,3,5,9,-4,7
Panionios,7682,4,1,1,4,4,10,-6,4
AEK Athens,7683,1,4,2,0,7,1,6,14
PAOK Salonik,7683,2,3,2,1,13,6,7,11
Panionios,7683,3,1,1,4,4,10,-6,4
P'thinaikos,7683,4,1,1,4,6,13,-7,4
AEK Athens,7684,1,4,2,0,7,1,6,14
PAOK Salonik,7684,2,2,3,1,10,5,5,9
P'thinaikos,7684,3,1,2,3,5,10,-5,5
Panionios,7684,4,1,1,4,4,10,-6,4
AEK Athens,7685,1,4,2,0,7,1,6,14
PAOK Salonik,7685,2,2,2,2,9,5,4,8
P'thinaikos,7685,3,2,1,3,5,9,-4,7
Panionios,7685,4,1,1,4,4,10,-6,4
AEK Athens,7686,1,4,2,0,7,1,6,14
PAOK Salonik,7686,2,2,2,2,10,6,4,8
P'thinaikos,7686,3,2,1,3,6,10,-4,7
Panionios,7686,4,1,1,4,4,10,-6,4
AEK Athens,7687,1,4,2,0,7,1,6,14
PAOK Salonik,7687,2,2,2,2,9,5,4,8
P'thinaikos,7687,3,2,1,3,5,9,-4,7
Panionios,7687,4,1,1,4,4,10,-6,4
AEK Athens,7688,1,4,2,0,7,1,6,14
PAOK Salonik,7688,2,3,2,1,13,5,8,11
Panionios,7688,3,1,1,4,4,10,-6,4
P'thinaikos,7688,4,1,1,4,5,13,-8,4
AEK Athens,7689,1,4,2,0,7,1,6,14
PAOK Salonik,7689,2,3,2,1,11,4,7,11
Panionios,7689,3,1,1,4,4,10,-6,4
P'thinaikos,7689,4,1,1,4,4,11,-7,4
AEK Athens,7690,1,4,2,0,7,1,6,14
PAOK Salonik,7690,2,2,3,1,10,5,5,9
P'thinaikos,7690,3,1,2,3,5,10,-5,5
Panionios,7690,4,1,1,4,4,10,-6,4
AEK Athens,7691,1,4,2,0,7,1,6,14
PAOK Salonik,7691,2,3,2,1,10,4,6,11
P'thinaikos,7691,3,1,1,4,4,10,-6,4
Panionios,7691,3,1,1,4,4,10,-6,4
AEK Athens,7692,1,4,2,0,7,1,6,14
PAOK Salonik,7692,2,3,2,1,11,4,7,11
Panionios,7692,3,1,1,4,4,10,-6,4
P'thinaikos,7692,4,1,1,4,4,11,-7,4
AEK Athens,7693,1,4,2,0,7,1,6,14
PAOK Salonik,7693,2,2,2,2,9,5,4,8
P'thinaikos,7693,3,2,1,3,5,9,-4,7
Panionios,7693,4,1,1,4,4,10,-6,4
AEK Athens,7694,1,4,2,0,7,1,6,14
PAOK Salonik,7694,2,2,3,1,11,6,5,9
P'thinaikos,7694,3,1,2,3,6,11,-5,5
Panionios,7694,4,1,1,4,4,10,-6,4
AEK Athens,7695,1,4,2,0,7,1,6,14
PAOK Salonik,7695,2,2,2,2,9,6,3,8
P'thinaikos,7695,3,2,1,3,6,9,-3,7
Panionios,7695,4,1,1,4,4,10,-6,4
AEK Athens,7696,1,4,2,0,7,1,6,14
PAOK Salonik,7696,2,2,2,2,11,7,4,8
P'thinaikos,7696,3,2,1,3,7,11,-4,7
Panionios,7696,4,1,1,4,4,10,-6,4
AEK Athens,7697,1,4,2,0,7,1,6,14
PAOK Salonik,7697,2,2,3,1,10,5,5,9
P'thinaikos,7697,3,1,2,3,5,10,-5,5
Panionios,7697,4,1,1,4,4,10,-6,4
AEK Athens,7698,1,4,2,0,7,1,6,14
PAOK Salonik,7698,2,2,3,1,9,4,5,9
P'thinaikos,7698,3,1,2,3,4,9,-5,5
Panionios,7698,4,1,1,4,4,10,-6,4
AEK Athens,7699,1,4,2,0,7,1,6,14
PAOK Salonik,7699,2,2,3,1,10,5,5,9
P'thinaikos,7699,3,1,2,3,5,10,-5,5
Panionios,7699,4,1,1,4,4,10,-6,4
AEK Athens,7700,1,4,2,0,7,1,6,14
PAOK Salonik,7700,2,2,2,2,9,5,4,8
P'thinaikos,7700,3,2,1,3,5,9,-4,7
Panionios,7700,4,1,1,4,4,10,-6,4
AEK Athens,7701,1,4,2,0,7,1,6,14
PAOK Salonik,7701,2,2,2,2,9,6,3,8
P'thinaikos,7701,3,2,1,3,6,9,-3,7
Panionios,7701,4,1,1,4,4,10,-6,4
AEK Athens,7702,1,4,2,0,7,1,6,14
PAOK Salonik,7702,2,2,2,2,9,8,1,8
P'thinaikos,7702,3,2,1,3,8,9,-1,7
Panionios,7702,4,1,1,4,4,10,-6,4
AEK Athens,7703,1,4,2,0,7,1,6,14
PAOK Salonik,7703,2,2,2,2,11,7,4,8
P'thinaikos,7703,3,2,1,3,7,11,-4,7
Panionios,7703,4,1,1,4,4,10,-6,4
AEK Athens,7704,1,4,2,0,7,1,6,14
PAOK Salonik,7704,2,2,2,2,9,5,4,8
P'thinaikos,7704,3,2,1,3,5,9,-4,7
Panionios,7704,4,1,1,4,4,10,-6,4
AEK Athens,7705,1,4,2,0,7,1,6,14
PAOK Salonik,7705,2,2,2,2,9,8,1,8
P'thinaikos,7705,3,2,1,3,8,9,-1,7
Panionios,7705,4,1,1,4,4,10,-6,4
AEK Athens,7706,1,4,2,0,7,1,6,14
PAOK Salonik,7706,2,2,3,1,10,5,5,9
P'thinaikos,7706,3,1,2,3,5,10,-5,5
Panionios,7706,4,1,1,4,4,10,-6,4
AEK Athens,7707,1,4,2,0,7,1,6,14
PAOK Salonik,7707,2,3,2,1,11,4,7,11
Panionios,7707,3,1,1,4,4,10,-6,4
P'thinaikos,7707,4,1,1,4,4,11,-7,4
AEK Athens,7708,1,4,2,0,7,1,6,14
PAOK Salonik,7708,2,2,3,1,10,5,5,9
P'thinaikos,7708,3,1,2,3,5,10,-5,5
Panionios,7708,4,1,1,4,4,10,-6,4
AEK Athens,7709,1,4,2,0,7,1,6,14
PAOK Salonik,7709,2,3,2,1,11,4,7,11
Panionios,7709,3,1,1,4,4,10,-6,4
P'thinaikos,7709,4,1,1,4,4,11,-7,4
AEK Athens,7710,1,4,2,0,7,1,6,14
PAOK Salonik,7710,2,2,3,1,12,7,5,9
P'thinaikos,7710,3,1,2,3,7,12,-5,5
Panionios,7710,4,1,1,4,4,10,-6,4
AEK Athens,7711,1,4,2,0,7,1,6,14
PAOK Salonik,7711,2,3,2,1,10,4,6,11
P'thinaikos,7711,3,1,1,4,4,10,-6,4
Panionios,7711,3,1,1,4,4,10,-6,4
AEK Athens,7712,1,4,2,0,7,1,6,14
PAOK Salonik,7712,2,3,2,1,11,5,6,11
P'thinaikos,7712,3,1,1,4,5,11,-6,4
Panionios,7712,4,1,1,4,4,10,-6,4
AEK Athens,7713,1,4,2,0,7,1,6,14
PAOK Salonik,7713,2,3,2,1,13,6,7,11
Panionios,7713,3,1,1,4,4,10,-6,4
P'thinaikos,7713,4,1,1,4,6,13,-7,4
AEK Athens,7714,1,4,2,0,7,1,6,14
PAOK Salonik,7714,2,2,3,1,11,6,5,9
P'thinaikos,7714,3,1,2,3,6,11,-5,5
Panionios,7714,4,1,1,4,4,10,-6,4
AEK Athens,7715,1,4,2,0,7,1,6,14
PAOK Salonik,7715,2,2,2,2,10,6,4,8
P'thinaikos,7715,3,2,1,3,6,10,-4,7
Panionios,7715,4,1,1,4,4,10,-6,4
AEK Athens,7716,1,4,2,0,7,1,6,14
PAOK Salonik,7716,2,2,2,2,10,6,4,8
P'thinaikos,7716,3,2,1,3,6,10,-4,7
Panionios,7716,4,1,1,4,4,10,-6,4
AEK Athens,7717,1,4,2,0,7,1,6,14
PAOK Salonik,7717,2,3,2,1,12,5,7,11
Panionios,7717,3,1,1,4,4,10,-6,4
P'thinaikos,7717,4,1,1,4,5,12,-7,4
AEK Athens,7718,1,4,2,0,7,1,6,14
PAOK Salonik,7718,2,2,2,2,9,5,4,8
P'thinaikos,7718,3,2,1,3,5,9,-4,7
Panionios,7718,4,1,1,4,4,10,-6,4
AEK Athens,7719,1,4,2,0,7,1,6,14
PAOK Salonik,7719,2,3,2,1,11,5,6,11
P'thinaikos,7719,3,1,1,4,5,11,-6,4
Panionios,7719,4,1,1,4,4,10,-6,4
AEK Athens,7720,1,4,2,0,7,1,6,14
PAOK Salonik,7720,2,3,2,1,12,5,7,11
Panionios,7720,3,1,1,4,4,10,-6,4
P'thinaikos,7720,4,1,1,4,5,12,-7,4
AEK Athens,7721,1,4,2,0,7,1,6,14
PAOK Salonik,7721,2,2,3,1,10,5,5,9
P'thinaikos,7721,3,1,2,3,5,10,-5,5
Panionios,7721,4,1,1,4,4,10,-6,4
AEK Athens,7722,1,4,2,0,7,1,6,14
PAOK Salonik,7722,2,3,2,1,12,5,7,11
Panionios,7722,3,1,1,4,4,10,-6,4
P'thinaikos,7722,4,1,1,4,5,12,-7,4
AEK Athens,7723,1,4,2,0,7,1,6,14
PAOK Salonik,7723,2,3,2,1,11,4,7,11
Panionios,7723,3,1,1,4,4,10,-6,4
P'thinaikos,7723,4,1,1,4,4,11,-7,4
AEK Athens,7724,1,4,2,0,7,1,6,14
PAOK Salonik,7724,2,3,2,1,11,4,7,11
Panionios,7724,3,1,1,4,4,10,-6,4
P'thinaikos,7724,4,1,1,4,4,11,-7,4
AEK Athens,7725,1,4,2,0,7,1,6,14
PAOK Salonik,7725,2,2,2,2,9,5,4,8
P'thinaikos,7725,3,2,1,3,5,9,-4,7
Panionios,7725,4,1,1,4,4,10,-6,4
AEK Athens,7726,1,4,2,0,7,1,6,14
PAOK Salonik,7726,2,3,2,1,11,4,7,11
Panionios,7726,3,1,1,4,4,10,-6,4
P'thinaikos,7726,4,1,1,4,4,11,-7,4
AEK Athens,7727,1,4,2,0,7,1,6,14
PAOK Salonik,7727,2,2,2,2,9,5,4,8
P'thinaikos,7727,3,2,1,3,5,9,-4,7
Panionios,7727,4,1,1,4,4,10,-6,4
AEK Athens,7728,1,4,2,0,7,1,6,14
PAOK Salonik,7728,2,2,2,2,9,7,2,8
P'thinaikos,7728,3,2,1,3,7,9,-2,7
Panionios,7728,4,1,1,4,4,10,-6,4
AEK Athens,7729,1,4,2,0,7,1,6,14
PAOK Salonik,7729,2,3,2,1,10,4,6,11
P'thinaikos,7729,3,1,1,4,4,10,-6,4
Panionios,7729,3,1,1,4,4,10,-6,4
AEK Athens,7730,1,4,2,0,7,1,6,14
PAOK Salonik,7730,2,2,2,2,9,5,4,8
P'thinaikos,7730,3,2,1,3,5,9,-4,7
Panionios,7730,4,1,1,4,4,10,-6,4
AEK Athens,7731,1,4,2,0,7,1,6,14
PAOK Salonik,7731,2,2,2,2,10,8,2,8
P'thinaikos,7731,3,2,1,3,8,10,-2,7
Panionios,7731,4,1,1,4,4,10,-6,4
AEK Athens,7732,1,4,2,0,7,1,6,14
PAOK Salonik,7732,2,2,3,1,10,5,5,9
P'thinaikos,7732,3,1,2,3,5,10,-5,5
Panionios,7732,4,1,1,4,4,10,-6,4
AEK Athens,7733,1,4,2,0,7,1,6,14
PAOK Salonik,7733,2,2,2,2,9,5,4,8
P'thinaikos,7733,3,2,1,3,5,9,-4,7
Panionios,7733,4,1,1,4,4,10,-6,4
AEK Athens,7734,1,4,2,0,7,1,6,14
PAOK Salonik,7734,2,2,2,2,10,6,4,8
P'thinaikos,7734,3,2,1,3,6,10,-4,7
Panionios,7734,4,1,1,4,4,10,-6,4
AEK Athens,7735,1,4,2,0,7,1,6,14
PAOK Salonik,7735,2,2,2,2,9,6,3,8
P'thinaikos,7735,3,2,1,3,6,9,-3,7
Panionios,7735,4,1,1,4,4,10,-6,4
AEK Athens,7736,1,4,2,0,7,1,6,14
PAOK Salonik,7736,2,2,3,1,10,5,5,9
P'thinaikos,7736,3,1,2,3,5,10,-5,5
Panionios,7736,4,1,1,4,4,10,-6,4
AEK Athens,7737,1,4,2,0,7,1,6,14
PAOK Salonik,7737,2,3,2,1,11,5,6,11
P'thinaikos,7737,3,1,1,4,5,11,-6,4
Panionios,7737,4,1,1,4,4,10,-6,4
AEK Athens,7738,1,4,2,0,7,1,6,14
PAOK Salonik,7738,2,2,3,1,11,6,5,9
P'thinaikos,7738,3,1,2,3,6,11,-5,5
Panionios,7738,4,1,1,4,4,10,-6,4
AEK Athens,7739,1,4,2,0,7,1,6,14
PAOK Salonik,7739,2,2,2,2,10,6,4,8
P'thinaikos,7739,3,2,1,3,6,10,-4,7
Panionios,7739,4,1,1,4,4,10,-6,4
AEK Athens,7740,1,4,2,0,7,1,6,14
PAOK Salonik,7740,2,2,2,2,10,9,1,8
P'thinaikos,7740,3,2,1,3,9,10,-1,7
Panionios,7740,4,1,1,4,4,10,-6,4
AEK Athens,7741,1,4,2,0,7,1,6,14
PAOK Salonik,7741,2,2,3,1,9,4,5,9
P'thinaikos,7741,3,1,2,3,4,9,-5,5
Panionios,7741,4,1,1,4,4,10,-6,4
AEK Athens,7742,1,4,2,0,7,1,6,14
PAOK Salonik,7742,2,3,2,1,11,4,7,11
Panionios,7742,3,1,1,4,4,10,-6,4
P'thinaikos,7742,4,1,1,4,4,11,-7,4
AEK Athens,7743,1,4,2,0,7,1,6,14
PAOK Salonik,7743,2,2,2,2,9,6,3,8
P'thinaikos,7743,3,2,1,3,6,9,-3,7
Panionios,7743,4,1,1,4,4,10,-6,4
AEK Athens,7744,1,4,2,0,7,1,6,14
PAOK Salonik,7744,2,2,3,1,12,7,5,9
P'thinaikos,7744,3,1,2,3,7,12,-5,5
Panionios,7744,4,1,1,4,4,10,-6,4
AEK Athens,7745,1,4,2,0,7,1,6,14
PAOK Salonik,7745,2,3,2,1,10,4,6,11
P'thinaikos,7745,3,1,1,4,4,10,-6,4
Panionios,7745,3,1,1,4,4,10,-6,4
AEK Athens,7746,1,4,2,0,7,1,6,14
PAOK Salonik,7746,2,2,2,2,10,6,4,8
P'thinaikos,7746,3,2,1,3,6,10,-4,7
Panionios,7746,4,1,1,4,4,10,-6,4
AEK Athens,7747,1,4,2,0,7,1,6,14
PAOK Salonik,7747,2,3,2,1,11,4,7,11
Panionios,7747,3,1,1,4,4,10,-6,4
P'thinaikos,7747,4,1,1,4,4,11,-7,4
AEK Athens,7748,1,4,2,0,7,1,6,14
PAOK Salonik,7748,2,2,3,1,9,4,5,9
P'thinaikos,7748,3,1,2,3,4,9,-5,5
Panionios,7748,4,1,1,4,4,10,-6,4
AEK Athens,7749,1,4,2,0,7,1,6,14
PAOK Salonik,7749,2,2,3,1,9,4,5,9
P'thinaikos,7749,3,1,2,3,4,9,-5,5
Panionios,7749,4,1,1,4,4,10,-6,4
AEK Athens,7750,1,4,2,0,7,1,6,14
PAOK Salonik,7750,2,3,2,1,11,5,6,11
P'thinaikos,7750,3,1,1,4,5,11,-6,4
Panionios,7750,4,1,1,4,4,10,-6,4
AEK Athens,7751,1,4,2,0,7,1,6,14
PAOK Salonik,7751,2,3,2,1,11,5,6,11
P'thinaikos,7751,3,1,1,4,5,11,-6,4
Panionios,7751,4,1,1,4,4,10,-6,4
AEK Athens,7752,1,4,2,0,7,1,6,14
PAOK Salonik,7752,2,3,2,1,11,5,6,11
P'thinaikos,7752,3,1,1,4,5,11,-6,4
Panionios,7752,4,1,1,4,4,10,-6,4
AEK Athens,7753,1,4,2,0,7,1,6,14
PAOK Salonik,7753,2,2,2,2,9,5,4,8
P'thinaikos,7753,3,2,1,3,5,9,-4,7
Panionios,7753,4,1,1,4,4,10,-6,4
AEK Athens,7754,1,4,2,0,7,1,6,14
PAOK Salonik,7754,2,2,2,2,9,7,2,8
P'thinaikos,7754,3,2,1,3,7,9,-2,7
Panionios,7754,4,1,1,4,4,10,-6,4
AEK Athens,7755,1,4,2,0,7,1,6,14
PAOK Salonik,7755,2,2,3,1,10,5,5,9
P'thinaikos,7755,3,1,2,3,5,10,-5,5
Panionios,7755,4,1,1,4,4,10,-6,4
AEK Athens,7756,1,4,2,0,7,1,6,14
PAOK Salonik,7756,2,2,2,2,10,7,3,8
P'thinaikos,7756,3,2,1,3,7,10,-3,7
Panionios,7756,4,1,1,4,4,10,-6,4
AEK Athens,7757,1,4,2,0,7,1,6,14
PAOK Salonik,7757,2,3,2,1,12,6,6,11
P'thinaikos,7757,3,1,1,4,6,12,-6,4
Panionios,7757,4,1,1,4,4,10,-6,4
AEK Athens,7758,1,4,2,0,7,1,6,14
PAOK Salonik,7758,2,2,2,2,11,8,3,8
P'thinaikos,7758,3,2,1,3,8,11,-3,7
Panionios,7758,4,1,1,4,4,10,-6,4
AEK Athens,7759,1,4,2,0,7,1,6,14
PAOK Salonik,7759,2,2,3,1,11,6,5,9
P'thinaikos,7759,3,1,2,3,6,11,-5,5
Panionios,7759,4,1,1,4,4,10,-6,4
AEK Athens,7760,1,4,2,0,7,1,6,14
PAOK Salonik,7760,2,2,2,2,9,5,4,8
P'thinaikos,7760,3,2,1,3,5,9,-4,7
Panionios,7760,4,1,1,4,4,10,-6,4
AEK Athens,7761,1,4,2,0,7,1,6,14
PAOK Salonik,7761,2,2,2,2,9,5,4,8
P'thinaikos,7761,3,2,1,3,5,9,-4,7
Panionios,7761,4,1,1,4,4,10,-6,4
AEK Athens,7762,1,4,2,0,7,1,6,14
PAOK Salonik,7762,2,3,2,1,13,4,9,11
Panionios,7762,3,1,1,4,4,10,-6,4
P'thinaikos,7762,4,1,1,4,4,13,-9,4
AEK Athens,7763,1,4,2,0,7,1,6,14
PAOK Salonik,7763,2,2,3,1,10,5,5,9
P'thinaikos,7763,3,1,2,3,5,10,-5,5
Panionios,7763,4,1,1,4,4,10,-6,4
AEK Athens,7764,1,4,2,0,7,1,6,14
PAOK Salonik,7764,2,3,2,1,10,4,6,11
P'thinaikos,7764,3,1,1,4,4,10,-6,4
Panionios,7764,3,1,1,4,4,10,-6,4
AEK Athens,7765,1,4,2,0,7,1,6,14
PAOK Salonik,7765,2,2,2,2,9,6,3,8
P'thinaikos,7765,3,2,1,3,6,9,-3,7
Panionios,7765,4,1,1,4,4,10,-6,4
AEK Athens,7766,1,4,2,0,7,1,6,14
PAOK Salonik,7766,2,3,2,1,11,4,7,11
Panionios,7766,3,1,1,4,4,10,-6,4
P'thinaikos,7766,4,1,1,4,4,11,-7,4
AEK Athens,7767,1,4,2,0,7,1,6,14
PAOK Salonik,7767,2,3,2,1,10,4,6,11
P'thinaikos,7767,3,1,1,4,4,10,-6,4
Panionios,7767,3,1,1,4,4,10,-6,4
AEK Athens,7768,1,4,2,0,7,1,6,14
PAOK Salonik,7768,2,3,2,1,11,4,7,11
Panionios,7768,3,1,1,4,4,10,-6,4
P'thinaikos,7768,4,1,1,4,4,11,-7,4
AEK Athens,7769,1,4,2,0,7,1,6,14
PAOK Salonik,7769,2,2,2,2,9,6,3,8
P'thinaikos,7769,3,2,1,3,6,9,-3,7
Panionios,7769,4,1,1,4,4,10,-6,4
AEK Athens,7770,1,4,2,0,7,1,6,14
PAOK Salonik,7770,2,2,2,2,10,6,4,8
P'thinaikos,7770,3,2,1,3,6,10,-4,7
Panionios,7770,4,1,1,4,4,10,-6,4
AEK Athens,7771,1,4,2,0,7,1,6,14
PAOK Salonik,7771,2,2,3,1,10,5,5,9
P'thinaikos,7771,3,1,2,3,5,10,-5,5
Panionios,7771,4,1,1,4,4,10,-6,4
AEK Athens,7772,1,4,2,0,7,1,6,14
PAOK Salonik,7772,2,2,3,1,9,4,5,9
P'thinaikos,7772,3,1,2,3,4,9,-5,5
Panionios,7772,4,1,1,4,4,10,-6,4
AEK Athens,7773,1,4,2,0,7,1,6,14
PAOK Salonik,7773,2,3,2,1,10,4,6,11
P'thinaikos,7773,3,1,1,4,4,10,-6,4
Panionios,7773,3,1,1,4,4,10,-6,4
AEK Athens,7774,1,4,2,0,7,1,6,14
PAOK Salonik,7774,2,2,2,2,9,6,3,8
P'thinaikos,7774,3,2,1,3,6,9,-3,7
Panionios,7774,4,1,1,4,4,10,-6,4
AEK Athens,7775,1,4,2,0,7,1,6,14
PAOK Salonik,7775,2,2,2,2,9,5,4,8
P'thinaikos,7775,3,2,1,3,5,9,-4,7
Panionios,7775,4,1,1,4,4,10,-6,4
AEK Athens,7776,1,4,2,0,7,1,6,14
PAOK Salonik,7776,2,2,2,2,9,5,4,8
P'thinaikos,7776,3,2,1,3,5,9,-4,7
Panionios,7776,4,1,1,4,4,10,-6,4
AEK Athens,7777,1,4,2,0,7,1,6,14
PAOK Salonik,7777,2,2,3,1,9,4,5,9
P'thinaikos,7777,3,1,2,3,4,9,-5,5
Panionios,7777,4,1,1,4,4,10,-6,4
AEK Athens,7778,1,4,2,0,7,1,6,14
PAOK Salonik,7778,2,3,2,1,10,4,6,11
P'thinaikos,7778,3,1,1,4,4,10,-6,4
Panionios,7778,3,1,1,4,4,10,-6,4
AEK Athens,7779,1,4,2,0,7,1,6,14
PAOK Salonik,7779,2,3,2,1,12,4,8,11
Panionios,7779,3,1,1,4,4,10,-6,4
P'thinaikos,7779,4,1,1,4,4,12,-8,4
AEK Athens,7780,1,4,2,0,7,1,6,14
PAOK Salonik,7780,2,3,2,1,10,4,6,11
P'thinaikos,7780,3,1,1,4,4,10,-6,4
Panionios,7780,3,1,1,4,4,10,-6,4
AEK Athens,7781,1,4,2,0,7,1,6,14
PAOK Salonik,7781,2,2,3,1,10,5,5,9
P'thinaikos,7781,3,1,2,3,5,10,-5,5
Panionios,7781,4,1,1,4,4,10,-6,4
AEK Athens,7782,1,4,2,0,7,1,6,14
PAOK Salonik,7782,2,2,2,2,9,5,4,8
P'thinaikos,7782,3,2,1,3,5,9,-4,7
Panionios,7782,4,1,1,4,4,10,-6,4
AEK Athens,7783,1,4,2,0,7,1,6,14
PAOK Salonik,7783,2,2,2,2,9,6,3,8
P'thinaikos,7783,3,2,1,3,6,9,-3,7
Panionios,7783,4,1,1,4,4,10,-6,4
AEK Athens,7784,1,4,2,0,7,1,6,14
PAOK Salonik,7784,2,2,2,2,9,5,4,8
P'thinaikos,7784,3,2,1,3,5,9,-4,7
Panionios,7784,4,1,1,4,4,10,-6,4
AEK Athens,7785,1,4,2,0,7,1,6,14
PAOK Salonik,7785,2,2,3,1,9,4,5,9
P'thinaikos,7785,3,1,2,3,4,9,-5,5
Panionios,7785,4,1,1,4,4,10,-6,4
AEK Athens,7786,1,4,2,0,7,1,6,14
PAOK Salonik,7786,2,2,2,2,10,6,4,8
P'thinaikos,7786,3,2,1,3,6,10,-4,7
Panionios,7786,4,1,1,4,4,10,-6,4
AEK Athens,7787,1,4,2,0,7,1,6,14
PAOK Salonik,7787,2,2,2,2,10,6,4,8
P'thinaikos,7787,3,2,1,3,6,10,-4,7
Panionios,7787,4,1,1,4,4,10,-6,4
AEK Athens,7788,1,4,2,0,7,1,6,14
PAOK Salonik,7788,2,2,2,2,10,6,4,8
P'thinaikos,7788,3,2,1,3,6,10,-4,7
Panionios,7788,4,1,1,4,4,10,-6,4
AEK Athens,7789,1,4,2,0,7,1,6,14
PAOK Salonik,7789,2,2,3,1,10,5,5,9
P'thinaikos,7789,3,1,2,3,5,10,-5,5
Panionios,7789,4,1,1,4,4,10,-6,4
AEK Athens,7790,1,4,2,0,7,1,6,14
PAOK Salonik,7790,2,3,2,1,12,4,8,11
Panionios,7790,3,1,1,4,4,10,-6,4
P'thinaikos,7790,4,1,1,4,4,12,-8,4
AEK Athens,7791,1,4,2,0,7,1,6,14
PAOK Salonik,7791,2,2,3,1,9,4,5,9
P'thinaikos,7791,3,1,2,3,4,9,-5,5
Panionios,7791,4,1,1,4,4,10,-6,4
AEK Athens,7792,1,4,2,0,7,1,6,14
PAOK Salonik,7792,2,2,2,2,9,5,4,8
P'thinaikos,7792,3,2,1,3,5,9,-4,7
Panionios,7792,4,1,1,4,4,10,-6,4
AEK Athens,7793,1,4,2,0,7,1,6,14
PAOK Salonik,7793,2,2,2,2,10,6,4,8
P'thinaikos,7793,3,2,1,3,6,10,-4,7
Panionios,7793,4,1,1,4,4,10,-6,4
AEK Athens,7794,1,4,2,0,7,1,6,14
PAOK Salonik,7794,2,2,3,1,9,4,5,9
P'thinaikos,7794,3,1,2,3,4,9,-5,5
Panionios,7794,4,1,1,4,4,10,-6,4
AEK Athens,7795,1,4,2,0,7,1,6,14
PAOK Salonik,7795,2,3,2,1,12,5,7,11
Panionios,7795,3,1,1,4,4,10,-6,4
P'thinaikos,7795,4,1,1,4,5,12,-7,4
AEK Athens,7796,1,4,2,0,7,1,6,14
PAOK Salonik,7796,2,2,3,1,9,4,5,9
P'thinaikos,7796,3,1,2,3,4,9,-5,5
Panionios,7796,4,1,1,4,4,10,-6,4
AEK Athens,7797,1,4,2,0,7,1,6,14
PAOK Salonik,7797,2,3,2,1,10,4,6,11
P'thinaikos,7797,3,1,1,4,4,10,-6,4
Panionios,7797,3,1,1,4,4,10,-6,4
AEK Athens,7798,1,4,2,0,7,1,6,14
PAOK Salonik,7798,2,2,2,2,10,6,4,8
P'thinaikos,7798,3,2,1,3,6,10,-4,7
Panionios,7798,4,1,1,4,4,10,-6,4
AEK Athens,7799,1,4,2,0,7,1,6,14
PAOK Salonik,7799,2,2,2,2,10,6,4,8
P'thinaikos,7799,3,2,1,3,6,10,-4,7
Panionios,7799,4,1,1,4,4,10,-6,4
AEK Athens,7800,1,4,2,0,7,1,6,14
PAOK Salonik,7800,2,2,2,2,9,5,4,8
P'thinaikos,7800,3,2,1,3,5,9,-4,7
Panionios,7800,4,1,1,4,4,10,-6,4
AEK Athens,7801,1,4,2,0,7,1,6,14
PAOK Salonik,7801,2,2,3,1,11,6,5,9
P'thinaikos,7801,3,1,2,3,6,11,-5,5
Panionios,7801,4,1,1,4,4,10,-6,4
AEK Athens,7802,1,4,2,0,7,1,6,14
PAOK Salonik,7802,2,2,3,1,10,5,5,9
P'thinaikos,7802,3,1,2,3,5,10,-5,5
Panionios,7802,4,1,1,4,4,10,-6,4
AEK Athens,7803,1,4,2,0,7,1,6,14
PAOK Salonik,7803,2,2,3,1,9,4,5,9
P'thinaikos,7803,3,1,2,3,4,9,-5,5
Panionios,7803,4,1,1,4,4,10,-6,4
AEK Athens,7804,1,4,2,0,7,1,6,14
PAOK Salonik,7804,2,2,2,2,9,5,4,8
P'thinaikos,7804,3,2,1,3,5,9,-4,7
Panionios,7804,4,1,1,4,4,10,-6,4
AEK Athens,7805,1,4,2,0,7,1,6,14
PAOK Salonik,7805,2,3,2,1,12,5,7,11
Panionios,7805,3,1,1,4,4,10,-6,4
P'thinaikos,7805,4,1,1,4,5,12,-7,4
AEK Athens,7806,1,4,2,0,7,1,6,14
PAOK Salonik,7806,2,3,2,1,12,4,8,11
Panionios,7806,3,1,1,4,4,10,-6,4
P'thinaikos,7806,4,1,1,4,4,12,-8,4
AEK Athens,7807,1,4,2,0,7,1,6,14
PAOK Salonik,7807,2,2,3,1,10,5,5,9
P'thinaikos,7807,3,1,2,3,5,10,-5,5
Panionios,7807,4,1,1,4,4,10,-6,4
AEK Athens,7808,1,4,2,0,7,1,6,14
PAOK Salonik,7808,2,2,2,2,10,6,4,8
P'thinaikos,7808,3,2,1,3,6,10,-4,7
Panionios,7808,4,1,1,4,4,10,-6,4
AEK Athens,7809,1,4,2,0,7,1,6,14
PAOK Salonik,7809,2,2,2,2,9,5,4,8
P'thinaikos,7809,3,2,1,3,5,9,-4,7
Panionios,7809,4,1,1,4,4,10,-6,4
AEK Athens,7810,1,4,2,0,7,1,6,14
PAOK Salonik,7810,2,3,2,1,12,5,7,11
Panionios,7810,3,1,1,4,4,10,-6,4
P'thinaikos,7810,4,1,1,4,5,12,-7,4
AEK Athens,7811,1,4,2,0,7,1,6,14
PAOK Salonik,7811,2,3,2,1,11,5,6,11
P'thinaikos,7811,3,1,1,4,5,11,-6,4
Panionios,7811,4,1,1,4,4,10,-6,4
AEK Athens,7812,1,4,2,0,7,1,6,14
PAOK Salonik,7812,2,3,2,1,11,5,6,11
P'thinaikos,7812,3,1,1,4,5,11,-6,4
Panionios,7812,4,1,1,4,4,10,-6,4
AEK Athens,7813,1,4,2,0,7,1,6,14
PAOK Salonik,7813,2,2,3,1,10,5,5,9
P'thinaikos,7813,3,1,2,3,5,10,-5,5
Panionios,7813,4,1,1,4,4,10,-6,4
AEK Athens,7814,1,4,2,0,7,1,6,14
PAOK Salonik,7814,2,2,2,2,10,7,3,8
P'thinaikos,7814,3,2,1,3,7,10,-3,7
Panionios,7814,4,1,1,4,4,10,-6,4
AEK Athens,7815,1,4,2,0,7,1,6,14
PAOK Salonik,7815,2,2,3,1,10,5,5,9
P'thinaikos,7815,3,1,2,3,5,10,-5,5
Panionios,7815,4,1,1,4,4,10,-6,4
AEK Athens,7816,1,4,2,0,7,1,6,14
PAOK Salonik,7816,2,2,3,1,10,5,5,9
P'thinaikos,7816,3,1,2,3,5,10,-5,5
Panionios,7816,4,1,1,4,4,10,-6,4
AEK Athens,7817,1,4,2,0,7,1,6,14
PAOK Salonik,7817,2,2,3,1,10,5,5,9
P'thinaikos,7817,3,1,2,3,5,10,-5,5
Panionios,7817,4,1,1,4,4,10,-6,4
AEK Athens,7818,1,4,2,0,7,1,6,14
PAOK Salonik,7818,2,2,3,1,10,5,5,9
P'thinaikos,7818,3,1,2,3,5,10,-5,5
Panionios,7818,4,1,1,4,4,10,-6,4
AEK Athens,7819,1,4,2,0,7,1,6,14
PAOK Salonik,7819,2,2,3,1,9,4,5,9
P'thinaikos,7819,3,1,2,3,4,9,-5,5
Panionios,7819,4,1,1,4,4,10,-6,4
AEK Athens,7820,1,4,2,0,7,1,6,14
PAOK Salonik,7820,2,3,2,1,11,5,6,11
P'thinaikos,7820,3,1,1,4,5,11,-6,4
Panionios,7820,4,1,1,4,4,10,-6,4
AEK Athens,7821,1,4,2,0,7,1,6,14
PAOK Salonik,7821,2,2,2,2,11,8,3,8
P'thinaikos,7821,3,2,1,3,8,11,-3,7
Panionios,7821,4,1,1,4,4,10,-6,4
AEK Athens,7822,1,4,2,0,7,1,6,14
PAOK Salonik,7822,2,2,2,2,9,5,4,8
P'thinaikos,7822,3,2,1,3,5,9,-4,7
Panionios,7822,4,1,1,4,4,10,-6,4
AEK Athens,7823,1,4,2,0,7,1,6,14
PAOK Salonik,7823,2,2,3,1,10,5,5,9
P'thinaikos,7823,3,1,2,3,5,10,-5,5
Panionios,7823,4,1,1,4,4,10,-6,4
AEK Athens,7824,1,4,2,0,7,1,6,14
PAOK Salonik,7824,2,2,2,2,9,5,4,8
P'thinaikos,7824,3,2,1,3,5,9,-4,7
Panionios,7824,4,1,1,4,4,10,-6,4
AEK Athens,7825,1,4,2,0,7,1,6,14
PAOK Salonik,7825,2,2,2,2,10,6,4,8
P'thinaikos,7825,3,2,1,3,6,10,-4,7
Panionios,7825,4,1,1,4,4,10,-6,4
AEK Athens,7826,1,4,2,0,7,1,6,14
PAOK Salonik,7826,2,3,2,1,12,5,7,11
Panionios,7826,3,1,1,4,4,10,-6,4
P'thinaikos,7826,4,1,1,4,5,12,-7,4
AEK Athens,7827,1,4,2,0,7,1,6,14
PAOK Salonik,7827,2,2,2,2,9,5,4,8
P'thinaikos,7827,3,2,1,3,5,9,-4,7
Panionios,7827,4,1,1,4,4,10,-6,4
AEK Athens,7828,1,4,2,0,7,1,6,14
PAOK Salonik,7828,2,2,3,1,9,4,5,9
P'thinaikos,7828,3,1,2,3,4,9,-5,5
Panionios,7828,4,1,1,4,4,10,-6,4
AEK Athens,7829,1,4,2,0,7,1,6,14
PAOK Salonik,7829,2,2,3,1,10,5,5,9
P'thinaikos,7829,3,1,2,3,5,10,-5,5
Panionios,7829,4,1,1,4,4,10,-6,4
AEK Athens,7830,1,4,2,0,7,1,6,14
PAOK Salonik,7830,2,3,2,1,11,5,6,11
P'thinaikos,7830,3,1,1,4,5,11,-6,4
Panionios,7830,4,1,1,4,4,10,-6,4
AEK Athens,7831,1,4,2,0,7,1,6,14
PAOK Salonik,7831,2,2,2,2,9,5,4,8
P'thinaikos,7831,3,2,1,3,5,9,-4,7
Panionios,7831,4,1,1,4,4,10,-6,4
AEK Athens,7832,1,4,2,0,7,1,6,14
PAOK Salonik,7832,2,3,2,1,12,4,8,11
Panionios,7832,3,1,1,4,4,10,-6,4
P'thinaikos,7832,4,1,1,4,4,12,-8,4
AEK Athens,7833,1,4,2,0,7,1,6,14
PAOK Salonik,7833,2,2,2,2,9,7,2,8
P'thinaikos,7833,3,2,1,3,7,9,-2,7
Panionios,7833,4,1,1,4,4,10,-6,4
AEK Athens,7834,1,4,2,0,7,1,6,14
PAOK Salonik,7834,2,3,2,1,10,4,6,11
P'thinaikos,7834,3,1,1,4,4,10,-6,4
Panionios,7834,3,1,1,4,4,10,-6,4
AEK Athens,7835,1,4,2,0,7,1,6,14
PAOK Salonik,7835,2,2,3,1,9,4,5,9
P'thinaikos,7835,3,1,2,3,4,9,-5,5
Panionios,7835,4,1,1,4,4,10,-6,4
AEK Athens,7836,1,4,2,0,7,1,6,14
PAOK Salonik,7836,2,2,2,2,10,7,3,8
P'thinaikos,7836,3,2,1,3,7,10,-3,7
Panionios,7836,4,1,1,4,4,10,-6,4
AEK Athens,7837,1,4,2,0,7,1,6,14
PAOK Salonik,7837,2,3,2,1,11,4,7,11
Panionios,7837,3,1,1,4,4,10,-6,4
P'thinaikos,7837,4,1,1,4,4,11,-7,4
AEK Athens,7838,1,4,2,0,7,1,6,14
PAOK Salonik,7838,2,2,2,2,9,5,4,8
P'thinaikos,7838,3,2,1,3,5,9,-4,7
Panionios,7838,4,1,1,4,4,10,-6,4
AEK Athens,7839,1,4,2,0,7,1,6,14
PAOK Salonik,7839,2,2,2,2,9,5,4,8
P'thinaikos,7839,3,2,1,3,5,9,-4,7
Panionios,7839,4,1,1,4,4,10,-6,4
AEK Athens,7840,1,4,2,0,7,1,6,14
PAOK Salonik,7840,2,2,3,1,9,4,5,9
P'thinaikos,7840,3,1,2,3,4,9,-5,5
Panionios,7840,4,1,1,4,4,10,-6,4
AEK Athens,7841,1,4,2,0,7,1,6,14
PAOK Salonik,7841,2,2,2,2,10,7,3,8
P'thinaikos,7841,3,2,1,3,7,10,-3,7
Panionios,7841,4,1,1,4,4,10,-6,4
AEK Athens,7842,1,4,2,0,7,1,6,14
PAOK Salonik,7842,2,2,3,1,10,5,5,9
P'thinaikos,7842,3,1,2,3,5,10,-5,5
Panionios,7842,4,1,1,4,4,10,-6,4
AEK Athens,7843,1,4,2,0,7,1,6,14
PAOK Salonik,7843,2,2,3,1,10,5,5,9
P'thinaikos,7843,3,1,2,3,5,10,-5,5
Panionios,7843,4,1,1,4,4,10,-6,4
AEK Athens,7844,1,4,2,0,7,1,6,14
PAOK Salonik,7844,2,3,2,1,12,4,8,11
Panionios,7844,3,1,1,4,4,10,-6,4
P'thinaikos,7844,4,1,1,4,4,12,-8,4
AEK Athens,7845,1,4,2,0,7,1,6,14
PAOK Salonik,7845,2,2,3,1,9,4,5,9
P'thinaikos,7845,3,1,2,3,4,9,-5,5
Panionios,7845,4,1,1,4,4,10,-6,4
AEK Athens,7846,1,4,2,0,7,1,6,14
PAOK Salonik,7846,2,2,3,1,9,4,5,9
P'thinaikos,7846,3,1,2,3,4,9,-5,5
Panionios,7846,4,1,1,4,4,10,-6,4
AEK Athens,7847,1,4,2,0,7,1,6,14
PAOK Salonik,7847,2,3,2,1,11,4,7,11
Panionios,7847,3,1,1,4,4,10,-6,4
P'thinaikos,7847,4,1,1,4,4,11,-7,4
AEK Athens,7848,1,4,2,0,7,1,6,14
PAOK Salonik,7848,2,2,3,1,9,4,5,9
P'thinaikos,7848,3,1,2,3,4,9,-5,5
Panionios,7848,4,1,1,4,4,10,-6,4
AEK Athens,7849,1,4,2,0,7,1,6,14
PAOK Salonik,7849,2,2,3,1,10,5,5,9
P'thinaikos,7849,3,1,2,3,5,10,-5,5
Panionios,7849,4,1,1,4,4,10,-6,4
AEK Athens,7850,1,4,2,0,7,1,6,14
PAOK Salonik,7850,2,2,3,1,10,5,5,9
P'thinaikos,7850,3,1,2,3,5,10,-5,5
Panionios,7850,4,1,1,4,4,10,-6,4
AEK Athens,7851,1,4,2,0,7,1,6,14
PAOK Salonik,7851,2,2,3,1,9,4,5,9
P'thinaikos,7851,3,1,2,3,4,9,-5,5
Panionios,7851,4,1,1,4,4,10,-6,4
AEK Athens,7852,1,4,2,0,7,1,6,14
PAOK Salonik,7852,2,2,2,2,9,7,2,8
P'thinaikos,7852,3,2,1,3,7,9,-2,7
Panionios,7852,4,1,1,4,4,10,-6,4
AEK Athens,7853,1,4,2,0,7,1,6,14
PAOK Salonik,7853,2,2,3,1,10,5,5,9
P'thinaikos,7853,3,1,2,3,5,10,-5,5
Panionios,7853,4,1,1,4,4,10,-6,4
AEK Athens,7854,1,4,2,0,7,1,6,14
PAOK Salonik,7854,2,3,2,1,13,4,9,11
Panionios,7854,3,1,1,4,4,10,-6,4
P'thinaikos,7854,4,1,1,4,4,13,-9,4
AEK Athens,7855,1,4,2,0,7,1,6,14
PAOK Salonik,7855,2,3,2,1,12,6,6,11
P'thinaikos,7855,3,1,1,4,6,12,-6,4
Panionios,7855,4,1,1,4,4,10,-6,4
AEK Athens,7856,1,4,2,0,7,1,6,14
PAOK Salonik,7856,2,2,3,1,9,4,5,9
P'thinaikos,7856,3,1,2,3,4,9,-5,5
Panionios,7856,4,1,1,4,4,10,-6,4
AEK Athens,7857,1,4,2,0,7,1,6,14
PAOK Salonik,7857,2,2,2,2,9,6,3,8
P'thinaikos,7857,3,2,1,3,6,9,-3,7
Panionios,7857,4,1,1,4,4,10,-6,4
AEK Athens,7858,1,4,2,0,7,1,6,14
PAOK Salonik,7858,2,2,2,2,9,5,4,8
P'thinaikos,7858,3,2,1,3,5,9,-4,7
Panionios,7858,4,1,1,4,4,10,-6,4
AEK Athens,7859,1,4,2,0,7,1,6,14
PAOK Salonik,7859,2,2,2,2,9,5,4,8
P'thinaikos,7859,3,2,1,3,5,9,-4,7
Panionios,7859,4,1,1,4,4,10,-6,4
AEK Athens,7860,1,4,2,0,7,1,6,14
PAOK Salonik,7860,2,2,2,2,9,8,1,8
P'thinaikos,7860,3,2,1,3,8,9,-1,7
Panionios,7860,4,1,1,4,4,10,-6,4
AEK Athens,7861,1,4,2,0,7,1,6,14
PAOK Salonik,7861,2,2,3,1,11,6,5,9
P'thinaikos,7861,3,1,2,3,6,11,-5,5
Panionios,7861,4,1,1,4,4,10,-6,4
AEK Athens,7862,1,4,2,0,7,1,6,14
PAOK Salonik,7862,2,2,2,2,9,7,2,8
P'thinaikos,7862,3,2,1,3,7,9,-2,7
Panionios,7862,4,1,1,4,4,10,-6,4
AEK Athens,7863,1,4,2,0,7,1,6,14
PAOK Salonik,7863,2,2,3,1,10,5,5,9
P'thinaikos,7863,3,1,2,3,5,10,-5,5
Panionios,7863,4,1,1,4,4,10,-6,4
AEK Athens,7864,1,4,2,0,7,1,6,14
PAOK Salonik,7864,2,3,2,1,11,5,6,11
P'thinaikos,7864,3,1,1,4,5,11,-6,4
Panionios,7864,4,1,1,4,4,10,-6,4
AEK Athens,7865,1,4,2,0,7,1,6,14
PAOK Salonik,7865,2,2,2,2,10,6,4,8
P'thinaikos,7865,3,2,1,3,6,10,-4,7
Panionios,7865,4,1,1,4,4,10,-6,4
AEK Athens,7866,1,4,2,0,7,1,6,14
PAOK Salonik,7866,2,2,2,2,11,7,4,8
P'thinaikos,7866,3,2,1,3,7,11,-4,7
Panionios,7866,4,1,1,4,4,10,-6,4
AEK Athens,7867,1,4,2,0,7,1,6,14
PAOK Salonik,7867,2,2,3,1,11,6,5,9
P'thinaikos,7867,3,1,2,3,6,11,-5,5
Panionios,7867,4,1,1,4,4,10,-6,4
AEK Athens,7868,1,4,2,0,7,1,6,14
PAOK Salonik,7868,2,2,3,1,9,4,5,9
P'thinaikos,7868,3,1,2,3,4,9,-5,5
Panionios,7868,4,1,1,4,4,10,-6,4
AEK Athens,7869,1,4,2,0,7,1,6,14
PAOK Salonik,7869,2,2,2,2,9,5,4,8
P'thinaikos,7869,3,2,1,3,5,9,-4,7
Panionios,7869,4,1,1,4,4,10,-6,4
AEK Athens,7870,1,4,2,0,7,1,6,14
PAOK Salonik,7870,2,2,3,1,9,4,5,9
P'thinaikos,7870,3,1,2,3,4,9,-5,5
Panionios,7870,4,1,1,4,4,10,-6,4
AEK Athens,7871,1,4,2,0,7,1,6,14
PAOK Salonik,7871,2,2,3,1,11,6,5,9
P'thinaikos,7871,3,1,2,3,6,11,-5,5
Panionios,7871,4,1,1,4,4,10,-6,4
AEK Athens,7872,1,4,2,0,7,1,6,14
PAOK Salonik,7872,2,3,2,1,11,4,7,11
Panionios,7872,3,1,1,4,4,10,-6,4
P'thinaikos,7872,4,1,1,4,4,11,-7,4
AEK Athens,7873,1,4,2,0,7,1,6,14
PAOK Salonik,7873,2,2,2,2,9,7,2,8
P'thinaikos,7873,3,2,1,3,7,9,-2,7
Panionios,7873,4,1,1,4,4,10,-6,4
AEK Athens,7874,1,4,2,0,7,1,6,14
PAOK Salonik,7874,2,2,2,2,10,6,4,8
P'thinaikos,7874,3,2,1,3,6,10,-4,7
Panionios,7874,4,1,1,4,4,10,-6,4
AEK Athens,7875,1,4,2,0,7,1,6,14
PAOK Salonik,7875,2,2,3,1,10,5,5,9
P'thinaikos,7875,3,1,2,3,5,10,-5,5
Panionios,7875,4,1,1,4,4,10,-6,4
AEK Athens,7876,1,4,2,0,7,1,6,14
PAOK Salonik,7876,2,2,3,1,10,5,5,9
P'thinaikos,7876,3,1,2,3,5,10,-5,5
Panionios,7876,4,1,1,4,4,10,-6,4
AEK Athens,7877,1,4,2,0,7,1,6,14
PAOK Salonik,7877,2,2,3,1,9,4,5,9
P'thinaikos,7877,3,1,2,3,4,9,-5,5
Panionios,7877,4,1,1,4,4,10,-6,4
AEK Athens,7878,1,4,2,0,7,1,6,14
PAOK Salonik,7878,2,2,3,1,10,5,5,9
P'thinaikos,7878,3,1,2,3,5,10,-5,5
Panionios,7878,4,1,1,4,4,10,-6,4
AEK Athens,7879,1,4,2,0,7,1,6,14
PAOK Salonik,7879,2,2,2,2,9,5,4,8
P'thinaikos,7879,3,2,1,3,5,9,-4,7
Panionios,7879,4,1,1,4,4,10,-6,4
AEK Athens,7880,1,4,2,0,7,1,6,14
PAOK Salonik,7880,2,2,2,2,9,5,4,8
P'thinaikos,7880,3,2,1,3,5,9,-4,7
Panionios,7880,4,1,1,4,4,10,-6,4
AEK Athens,7881,1,4,2,0,7,1,6,14
PAOK Salonik,7881,2,3,2,1,12,4,8,11
Panionios,7881,3,1,1,4,4,10,-6,4
P'thinaikos,7881,4,1,1,4,4,12,-8,4
AEK Athens,7882,1,4,2,0,7,1,6,14
PAOK Salonik,7882,2,2,2,2,9,6,3,8
P'thinaikos,7882,3,2,1,3,6,9,-3,7
Panionios,7882,4,1,1,4,4,10,-6,4
AEK Athens,7883,1,4,2,0,7,1,6,14
PAOK Salonik,7883,2,2,2,2,10,6,4,8
P'thinaikos,7883,3,2,1,3,6,10,-4,7
Panionios,7883,4,1,1,4,4,10,-6,4
AEK Athens,7884,1,4,2,0,7,1,6,14
PAOK Salonik,7884,2,2,3,1,10,5,5,9
P'thinaikos,7884,3,1,2,3,5,10,-5,5
Panionios,7884,4,1,1,4,4,10,-6,4
AEK Athens,7885,1,4,2,0,7,1,6,14
PAOK Salonik,7885,2,2,3,1,11,6,5,9
P'thinaikos,7885,3,1,2,3,6,11,-5,5
Panionios,7885,4,1,1,4,4,10,-6,4
AEK Athens,7886,1,4,2,0,7,1,6,14
PAOK Salonik,7886,2,2,3,1,11,6,5,9
P'thinaikos,7886,3,1,2,3,6,11,-5,5
Panionios,7886,4,1,1,4,4,10,-6,4
AEK Athens,7887,1,4,2,0,7,1,6,14
PAOK Salonik,7887,2,2,3,1,10,5,5,9
P'thinaikos,7887,3,1,2,3,5,10,-5,5
Panionios,7887,4,1,1,4,4,10,-6,4
AEK Athens,7888,1,4,2,0,7,1,6,14
PAOK Salonik,7888,2,3,2,1,10,4,6,11
P'thinaikos,7888,3,1,1,4,4,10,-6,4
Panionios,7888,3,1,1,4,4,10,-6,4
AEK Athens,7889,1,4,2,0,7,1,6,14
PAOK Salonik,7889,2,2,2,2,9,5,4,8
P'thinaikos,7889,3,2,1,3,5,9,-4,7
Panionios,7889,4,1,1,4,4,10,-6,4
AEK Athens,7890,1,4,2,0,7,1,6,14
PAOK Salonik,7890,2,3,2,1,12,5,7,11
Panionios,7890,3,1,1,4,4,10,-6,4
P'thinaikos,7890,4,1,1,4,5,12,-7,4
AEK Athens,7891,1,4,2,0,7,1,6,14
PAOK Salonik,7891,2,3,2,1,10,4,6,11
P'thinaikos,7891,3,1,1,4,4,10,-6,4
Panionios,7891,3,1,1,4,4,10,-6,4
AEK Athens,7892,1,4,2,0,7,1,6,14
PAOK Salonik,7892,2,2,2,2,9,9,0,8
P'thinaikos,7892,3,2,1,3,9,9,0,7
Panionios,7892,4,1,1,4,4,10,-6,4
AEK Athens,7893,1,4,2,0,7,1,6,14
PAOK Salonik,7893,2,2,2,2,10,7,3,8
P'thinaikos,7893,3,2,1,3,7,10,-3,7
Panionios,7893,4,1,1,4,4,10,-6,4
AEK Athens,7894,1,4,2,0,7,1,6,14
PAOK Salonik,7894,2,2,3,1,9,4,5,9
P'thinaikos,7894,3,1,2,3,4,9,-5,5
Panionios,7894,4,1,1,4,4,10,-6,4
AEK Athens,7895,1,4,2,0,7,1,6,14
PAOK Salonik,7895,2,3,2,1,13,4,9,11
Panionios,7895,3,1,1,4,4,10,-6,4
P'thinaikos,7895,4,1,1,4,4,13,-9,4
AEK Athens,7896,1,4,2,0,7,1,6,14
PAOK Salonik,7896,2,2,3,1,10,5,5,9
P'thinaikos,7896,3,1,2,3,5,10,-5,5
Panionios,7896,4,1,1,4,4,10,-6,4
AEK Athens,7897,1,4,2,0,7,1,6,14
PAOK Salonik,7897,2,3,2,1,11,5,6,11
P'thinaikos,7897,3,1,1,4,5,11,-6,4
Panionios,7897,4,1,1,4,4,10,-6,4
AEK Athens,7898,1,4,2,0,7,1,6,14
PAOK Salonik,7898,2,2,3,1,9,4,5,9
P'thinaikos,7898,3,1,2,3,4,9,-5,5
Panionios,7898,4,1,1,4,4,10,-6,4
AEK Athens,7899,1,4,2,0,7,1,6,14
PAOK Salonik,7899,2,2,2,2,9,5,4,8
P'thinaikos,7899,3,2,1,3,5,9,-4,7
Panionios,7899,4,1,1,4,4,10,-6,4
AEK Athens,7900,1,4,2,0,7,1,6,14
PAOK Salonik,7900,2,2,2,2,10,6,4,8
P'thinaikos,7900,3,2,1,3,6,10,-4,7
Panionios,7900,4,1,1,4,4,10,-6,4
AEK Athens,7901,1,4,2,0,7,1,6,14
PAOK Salonik,7901,2,3,2,1,11,5,6,11
P'thinaikos,7901,3,1,1,4,5,11,-6,4
Panionios,7901,4,1,1,4,4,10,-6,4
AEK Athens,7902,1,4,2,0,7,1,6,14
PAOK Salonik,7902,2,2,2,2,9,5,4,8
P'thinaikos,7902,3,2,1,3,5,9,-4,7
Panionios,7902,4,1,1,4,4,10,-6,4
AEK Athens,7903,1,4,2,0,7,1,6,14
PAOK Salonik,7903,2,2,2,2,9,5,4,8
P'thinaikos,7903,3,2,1,3,5,9,-4,7
Panionios,7903,4,1,1,4,4,10,-6,4
AEK Athens,7904,1,4,2,0,7,1,6,14
PAOK Salonik,7904,2,2,3,1,10,5,5,9
P'thinaikos,7904,3,1,2,3,5,10,-5,5
Panionios,7904,4,1,1,4,4,10,-6,4
AEK Athens,7905,1,4,2,0,7,1,6,14
PAOK Salonik,7905,2,2,3,1,9,4,5,9
P'thinaikos,7905,3,1,2,3,4,9,-5,5
Panionios,7905,4,1,1,4,4,10,-6,4
AEK Athens,7906,1,4,2,0,7,1,6,14
PAOK Salonik,7906,2,3,2,1,10,4,6,11
P'thinaikos,7906,3,1,1,4,4,10,-6,4
Panionios,7906,3,1,1,4,4,10,-6,4
AEK Athens,7907,1,4,2,0,7,1,6,14
PAOK Salonik,7907,2,3,2,1,10,4,6,11
P'thinaikos,7907,3,1,1,4,4,10,-6,4
Panionios,7907,3,1,1,4,4,10,-6,4
AEK Athens,7908,1,4,2,0,7,1,6,14
PAOK Salonik,7908,2,3,2,1,11,5,6,11
P'thinaikos,7908,3,1,1,4,5,11,-6,4
Panionios,7908,4,1,1,4,4,10,-6,4
AEK Athens,7909,1,4,2,0,7,1,6,14
PAOK Salonik,7909,2,2,2,2,9,5,4,8
P'thinaikos,7909,3,2,1,3,5,9,-4,7
Panionios,7909,4,1,1,4,4,10,-6,4
AEK Athens,7910,1,4,2,0,7,1,6,14
PAOK Salonik,7910,2,3,2,1,11,4,7,11
Panionios,7910,3,1,1,4,4,10,-6,4
P'thinaikos,7910,4,1,1,4,4,11,-7,4
AEK Athens,7911,1,4,2,0,7,1,6,14
PAOK Salonik,7911,2,2,3,1,10,5,5,9
P'thinaikos,7911,3,1,2,3,5,10,-5,5
Panionios,7911,4,1,1,4,4,10,-6,4
AEK Athens,7912,1,4,2,0,7,1,6,14
PAOK Salonik,7912,2,2,3,1,10,5,5,9
P'thinaikos,7912,3,1,2,3,5,10,-5,5
Panionios,7912,4,1,1,4,4,10,-6,4
AEK Athens,7913,1,4,2,0,7,1,6,14
PAOK Salonik,7913,2,3,2,1,10,4,6,11
P'thinaikos,7913,3,1,1,4,4,10,-6,4
Panionios,7913,3,1,1,4,4,10,-6,4
AEK Athens,7914,1,4,2,0,7,1,6,14
PAOK Salonik,7914,2,2,2,2,9,6,3,8
P'thinaikos,7914,3,2,1,3,6,9,-3,7
Panionios,7914,4,1,1,4,4,10,-6,4
AEK Athens,7915,1,4,2,0,7,1,6,14
PAOK Salonik,7915,2,3,2,1,10,4,6,11
P'thinaikos,7915,3,1,1,4,4,10,-6,4
Panionios,7915,3,1,1,4,4,10,-6,4
AEK Athens,7916,1,4,2,0,7,1,6,14
PAOK Salonik,7916,2,3,2,1,10,4,6,11
P'thinaikos,7916,3,1,1,4,4,10,-6,4
Panionios,7916,3,1,1,4,4,10,-6,4
AEK Athens,7917,1,4,2,0,7,1,6,14
PAOK Salonik,7917,2,3,2,1,11,4,7,11
Panionios,7917,3,1,1,4,4,10,-6,4
P'thinaikos,7917,4,1,1,4,4,11,-7,4
AEK Athens,7918,1,4,2,0,7,1,6,14
PAOK Salonik,7918,2,2,2,2,9,7,2,8
P'thinaikos,7918,3,2,1,3,7,9,-2,7
Panionios,7918,4,1,1,4,4,10,-6,4
AEK Athens,7919,1,4,2,0,7,1,6,14
PAOK Salonik,7919,2,2,2,2,10,6,4,8
P'thinaikos,7919,3,2,1,3,6,10,-4,7
Panionios,7919,4,1,1,4,4,10,-6,4
AEK Athens,7920,1,4,2,0,7,1,6,14
PAOK Salonik,7920,2,2,2,2,10,6,4,8
P'thinaikos,7920,3,2,1,3,6,10,-4,7
Panionios,7920,4,1,1,4,4,10,-6,4
AEK Athens,7921,1,4,2,0,7,1,6,14
PAOK Salonik,7921,2,3,2,1,10,4,6,11
P'thinaikos,7921,3,1,1,4,4,10,-6,4
Panionios,7921,3,1,1,4,4,10,-6,4
AEK Athens,7922,1,4,2,0,7,1,6,14
PAOK Salonik,7922,2,2,3,1,9,4,5,9
P'thinaikos,7922,3,1,2,3,4,9,-5,5
Panionios,7922,4,1,1,4,4,10,-6,4
AEK Athens,7923,1,4,2,0,7,1,6,14
PAOK Salonik,7923,2,2,3,1,9,4,5,9
P'thinaikos,7923,3,1,2,3,4,9,-5,5
Panionios,7923,4,1,1,4,4,10,-6,4
AEK Athens,7924,1,4,2,0,7,1,6,14
PAOK Salonik,7924,2,2,2,2,10,6,4,8
P'thinaikos,7924,3,2,1,3,6,10,-4,7
Panionios,7924,4,1,1,4,4,10,-6,4
AEK Athens,7925,1,4,2,0,7,1,6,14
PAOK Salonik,7925,2,2,3,1,9,4,5,9
P'thinaikos,7925,3,1,2,3,4,9,-5,5
Panionios,7925,4,1,1,4,4,10,-6,4
AEK Athens,7926,1,4,2,0,7,1,6,14
PAOK Salonik,7926,2,2,3,1,9,4,5,9
P'thinaikos,7926,3,1,2,3,4,9,-5,5
Panionios,7926,4,1,1,4,4,10,-6,4
AEK Athens,7927,1,4,2,0,7,1,6,14
PAOK Salonik,7927,2,2,3,1,9,4,5,9
P'thinaikos,7927,3,1,2,3,4,9,-5,5
Panionios,7927,4,1,1,4,4,10,-6,4
AEK Athens,7928,1,4,2,0,7,1,6,14
PAOK Salonik,7928,2,2,3,1,10,5,5,9
P'thinaikos,7928,3,1,2,3,5,10,-5,5
Panionios,7928,4,1,1,4,4,10,-6,4
AEK Athens,7929,1,4,2,0,7,1,6,14
PAOK Salonik,7929,2,2,2,2,9,5,4,8
P'thinaikos,7929,3,2,1,3,5,9,-4,7
Panionios,7929,4,1,1,4,4,10,-6,4
AEK Athens,7930,1,4,2,0,7,1,6,14
PAOK Salonik,7930,2,2,3,1,10,5,5,9
P'thinaikos,7930,3,1,2,3,5,10,-5,5
Panionios,7930,4,1,1,4,4,10,-6,4
AEK Athens,7931,1,4,2,0,7,1,6,14
PAOK Salonik,7931,2,3,2,1,13,6,7,11
Panionios,7931,3,1,1,4,4,10,-6,4
P'thinaikos,7931,4,1,1,4,6,13,-7,4
AEK Athens,7932,1,4,2,0,7,1,6,14
PAOK Salonik,7932,2,3,2,1,11,5,6,11
P'thinaikos,7932,3,1,1,4,5,11,-6,4
Panionios,7932,4,1,1,4,4,10,-6,4
AEK Athens,7933,1,4,2,0,7,1,6,14
PAOK Salonik,7933,2,2,2,2,9,5,4,8
P'thinaikos,7933,3,2,1,3,5,9,-4,7
Panionios,7933,4,1,1,4,4,10,-6,4
AEK Athens,7934,1,4,2,0,7,1,6,14
PAOK Salonik,7934,2,2,3,1,10,5,5,9
P'thinaikos,7934,3,1,2,3,5,10,-5,5
Panionios,7934,4,1,1,4,4,10,-6,4
AEK Athens,7935,1,4,2,0,7,1,6,14
PAOK Salonik,7935,2,2,2,2,10,6,4,8
P'thinaikos,7935,3,2,1,3,6,10,-4,7
Panionios,7935,4,1,1,4,4,10,-6,4
AEK Athens,7936,1,4,2,0,7,1,6,14
PAOK Salonik,7936,2,2,3,1,9,4,5,9
P'thinaikos,7936,3,1,2,3,4,9,-5,5
Panionios,7936,4,1,1,4,4,10,-6,4
AEK Athens,7937,1,4,2,0,7,1,6,14
PAOK Salonik,7937,2,2,3,1,10,5,5,9
P'thinaikos,7937,3,1,2,3,5,10,-5,5
Panionios,7937,4,1,1,4,4,10,-6,4
AEK Athens,7938,1,4,2,0,7,1,6,14
PAOK Salonik,7938,2,3,2,1,11,5,6,11
P'thinaikos,7938,3,1,1,4,5,11,-6,4
Panionios,7938,4,1,1,4,4,10,-6,4
AEK Athens,7939,1,4,2,0,7,1,6,14
PAOK Salonik,7939,2,2,2,2,9,6,3,8
P'thinaikos,7939,3,2,1,3,6,9,-3,7
Panionios,7939,4,1,1,4,4,10,-6,4
AEK Athens,7940,1,4,2,0,7,1,6,14
PAOK Salonik,7940,2,3,2,1,12,4,8,11
Panionios,7940,3,1,1,4,4,10,-6,4
P'thinaikos,7940,4,1,1,4,4,12,-8,4
AEK Athens,7941,1,4,2,0,7,1,6,14
PAOK Salonik,7941,2,2,3,1,9,4,5,9
P'thinaikos,7941,3,1,2,3,4,9,-5,5
Panionios,7941,4,1,1,4,4,10,-6,4
AEK Athens,7942,1,4,2,0,7,1,6,14
PAOK Salonik,7942,2,2,2,2,9,6,3,8
P'thinaikos,7942,3,2,1,3,6,9,-3,7
Panionios,7942,4,1,1,4,4,10,-6,4
AEK Athens,7943,1,4,2,0,7,1,6,14
PAOK Salonik,7943,2,2,3,1,10,5,5,9
P'thinaikos,7943,3,1,2,3,5,10,-5,5
Panionios,7943,4,1,1,4,4,10,-6,4
AEK Athens,7944,1,4,2,0,7,1,6,14
PAOK Salonik,7944,2,2,3,1,9,4,5,9
P'thinaikos,7944,3,1,2,3,4,9,-5,5
Panionios,7944,4,1,1,4,4,10,-6,4
AEK Athens,7945,1,4,2,0,7,1,6,14
PAOK Salonik,7945,2,3,2,1,11,4,7,11
Panionios,7945,3,1,1,4,4,10,-6,4
P'thinaikos,7945,4,1,1,4,4,11,-7,4
AEK Athens,7946,1,4,2,0,7,1,6,14
PAOK Salonik,7946,2,2,2,2,9,5,4,8
P'thinaikos,7946,3,2,1,3,5,9,-4,7
Panionios,7946,4,1,1,4,4,10,-6,4
AEK Athens,7947,1,4,2,0,7,1,6,14
PAOK Salonik,7947,2,2,2,2,9,6,3,8
P'thinaikos,7947,3,2,1,3,6,9,-3,7
Panionios,7947,4,1,1,4,4,10,-6,4
AEK Athens,7948,1,4,2,0,7,1,6,14
PAOK Salonik,7948,2,2,2,2,9,5,4,8
P'thinaikos,7948,3,2,1,3,5,9,-4,7
Panionios,7948,4,1,1,4,4,10,-6,4
AEK Athens,7949,1,4,2,0,7,1,6,14
PAOK Salonik,7949,2,2,2,2,9,5,4,8
P'thinaikos,7949,3,2,1,3,5,9,-4,7
Panionios,7949,4,1,1,4,4,10,-6,4
AEK Athens,7950,1,4,2,0,7,1,6,14
PAOK Salonik,7950,2,2,2,2,10,7,3,8
P'thinaikos,7950,3,2,1,3,7,10,-3,7
Panionios,7950,4,1,1,4,4,10,-6,4
AEK Athens,7951,1,4,2,0,7,1,6,14
PAOK Salonik,7951,2,2,2,2,9,6,3,8
P'thinaikos,7951,3,2,1,3,6,9,-3,7
Panionios,7951,4,1,1,4,4,10,-6,4
AEK Athens,7952,1,4,2,0,7,1,6,14
PAOK Salonik,7952,2,3,2,1,12,5,7,11
Panionios,7952,3,1,1,4,4,10,-6,4
P'thinaikos,7952,4,1,1,4,5,12,-7,4
AEK Athens,7953,1,4,2,0,7,1,6,14
PAOK Salonik,7953,2,2,3,1,10,5,5,9
P'thinaikos,7953,3,1,2,3,5,10,-5,5
Panionios,7953,4,1,1,4,4,10,-6,4
AEK Athens,7954,1,4,2,0,7,1,6,14
PAOK Salonik,7954,2,2,3,1,10,5,5,9
P'thinaikos,7954,3,1,2,3,5,10,-5,5
Panionios,7954,4,1,1,4,4,10,-6,4
AEK Athens,7955,1,4,2,0,7,1,6,14
PAOK Salonik,7955,2,2,2,2,9,5,4,8
P'thinaikos,7955,3,2,1,3,5,9,-4,7
Panionios,7955,4,1,1,4,4,10,-6,4
AEK Athens,7956,1,4,2,0,7,1,6,14
PAOK Salonik,7956,2,3,2,1,11,5,6,11
P'thinaikos,7956,3,1,1,4,5,11,-6,4
Panionios,7956,4,1,1,4,4,10,-6,4
AEK Athens,7957,1,4,2,0,7,1,6,14
PAOK Salonik,7957,2,3,2,1,11,4,7,11
Panionios,7957,3,1,1,4,4,10,-6,4
P'thinaikos,7957,4,1,1,4,4,11,-7,4
AEK Athens,7958,1,4,2,0,7,1,6,14
PAOK Salonik,7958,2,3,2,1,12,4,8,11
Panionios,7958,3,1,1,4,4,10,-6,4
P'thinaikos,7958,4,1,1,4,4,12,-8,4
AEK Athens,7959,1,4,2,0,7,1,6,14
PAOK Salonik,7959,2,3,2,1,10,4,6,11
P'thinaikos,7959,3,1,1,4,4,10,-6,4
Panionios,7959,3,1,1,4,4,10,-6,4
AEK Athens,7960,1,4,2,0,7,1,6,14
PAOK Salonik,7960,2,3,2,1,12,6,6,11
P'thinaikos,7960,3,1,1,4,6,12,-6,4
Panionios,7960,4,1,1,4,4,10,-6,4
AEK Athens,7961,1,4,2,0,7,1,6,14
PAOK Salonik,7961,2,2,3,1,10,5,5,9
P'thinaikos,7961,3,1,2,3,5,10,-5,5
Panionios,7961,4,1,1,4,4,10,-6,4
AEK Athens,7962,1,4,2,0,7,1,6,14
PAOK Salonik,7962,2,2,3,1,10,5,5,9
P'thinaikos,7962,3,1,2,3,5,10,-5,5
Panionios,7962,4,1,1,4,4,10,-6,4
AEK Athens,7963,1,4,2,0,7,1,6,14
PAOK Salonik,7963,2,3,2,1,10,4,6,11
P'thinaikos,7963,3,1,1,4,4,10,-6,4
Panionios,7963,3,1,1,4,4,10,-6,4
AEK Athens,7964,1,4,2,0,7,1,6,14
PAOK Salonik,7964,2,2,2,2,9,5,4,8
P'thinaikos,7964,3,2,1,3,5,9,-4,7
Panionios,7964,4,1,1,4,4,10,-6,4
AEK Athens,7965,1,4,2,0,7,1,6,14
PAOK Salonik,7965,2,3,2,1,11,4,7,11
Panionios,7965,3,1,1,4,4,10,-6,4
P'thinaikos,7965,4,1,1,4,4,11,-7,4
AEK Athens,7966,1,4,2,0,7,1,6,14
PAOK Salonik,7966,2,2,3,1,11,6,5,9
P'thinaikos,7966,3,1,2,3,6,11,-5,5
Panionios,7966,4,1,1,4,4,10,-6,4
AEK Athens,7967,1,4,2,0,7,1,6,14
PAOK Salonik,7967,2,2,3,1,10,5,5,9
P'thinaikos,7967,3,1,2,3,5,10,-5,5
Panionios,7967,4,1,1,4,4,10,-6,4
AEK Athens,7968,1,4,2,0,7,1,6,14
PAOK Salonik,7968,2,2,2,2,9,5,4,8
P'thinaikos,7968,3,2,1,3,5,9,-4,7
Panionios,7968,4,1,1,4,4,10,-6,4
AEK Athens,7969,1,4,2,0,7,1,6,14
PAOK Salonik,7969,2,2,3,1,10,5,5,9
P'thinaikos,7969,3,1,2,3,5,10,-5,5
Panionios,7969,4,1,1,4,4,10,-6,4
AEK Athens,7970,1,4,2,0,7,1,6,14
PAOK Salonik,7970,2,2,3,1,10,5,5,9
P'thinaikos,7970,3,1,2,3,5,10,-5,5
Panionios,7970,4,1,1,4,4,10,-6,4
AEK Athens,7971,1,4,2,0,7,1,6,14
PAOK Salonik,7971,2,2,3,1,9,4,5,9
P'thinaikos,7971,3,1,2,3,4,9,-5,5
Panionios,7971,4,1,1,4,4,10,-6,4
AEK Athens,7972,1,4,2,0,7,1,6,14
PAOK Salonik,7972,2,3,2,1,10,4,6,11
P'thinaikos,7972,3,1,1,4,4,10,-6,4
Panionios,7972,3,1,1,4,4,10,-6,4
AEK Athens,7973,1,4,2,0,7,1,6,14
PAOK Salonik,7973,2,3,2,1,11,4,7,11
Panionios,7973,3,1,1,4,4,10,-6,4
P'thinaikos,7973,4,1,1,4,4,11,-7,4
AEK Athens,7974,1,4,2,0,7,1,6,14
PAOK Salonik,7974,2,2,3,1,11,6,5,9
P'thinaikos,7974,3,1,2,3,6,11,-5,5
Panionios,7974,4,1,1,4,4,10,-6,4
AEK Athens,7975,1,4,2,0,7,1,6,14
PAOK Salonik,7975,2,3,2,1,11,4,7,11
Panionios,7975,3,1,1,4,4,10,-6,4
P'thinaikos,7975,4,1,1,4,4,11,-7,4
AEK Athens,7976,1,4,2,0,7,1,6,14
PAOK Salonik,7976,2,2,3,1,9,4,5,9
P'thinaikos,7976,3,1,2,3,4,9,-5,5
Panionios,7976,4,1,1,4,4,10,-6,4
AEK Athens,7977,1,4,2,0,7,1,6,14
PAOK Salonik,7977,2,3,2,1,14,5,9,11
Panionios,7977,3,1,1,4,4,10,-6,4
P'thinaikos,7977,4,1,1,4,5,14,-9,4
AEK Athens,7978,1,4,2,0,7,1,6,14
PAOK Salonik,7978,2,3,2,1,11,4,7,11
Panionios,7978,3,1,1,4,4,10,-6,4
P'thinaikos,7978,4,1,1,4,4,11,-7,4
AEK Athens,7979,1,4,2,0,7,1,6,14
PAOK Salonik,7979,2,3,2,1,11,4,7,11
Panionios,7979,3,1,1,4,4,10,-6,4
P'thinaikos,7979,4,1,1,4,4,11,-7,4
AEK Athens,7980,1,4,2,0,7,1,6,14
PAOK Salonik,7980,2,2,2,2,11,8,3,8
P'thinaikos,7980,3,2,1,3,8,11,-3,7
Panionios,7980,4,1,1,4,4,10,-6,4
AEK Athens,7981,1,4,2,0,7,1,6,14
PAOK Salonik,7981,2,3,2,1,13,7,6,11
P'thinaikos,7981,3,1,1,4,7,13,-6,4
Panionios,7981,4,1,1,4,4,10,-6,4
AEK Athens,7982,1,4,2,0,7,1,6,14
PAOK Salonik,7982,2,2,3,1,9,4,5,9
P'thinaikos,7982,3,1,2,3,4,9,-5,5
Panionios,7982,4,1,1,4,4,10,-6,4
AEK Athens,7983,1,4,2,0,7,1,6,14
PAOK Salonik,7983,2,2,3,1,10,5,5,9
P'thinaikos,7983,3,1,2,3,5,10,-5,5
Panionios,7983,4,1,1,4,4,10,-6,4
AEK Athens,7984,1,4,2,0,7,1,6,14
PAOK Salonik,7984,2,3,2,1,10,4,6,11
P'thinaikos,7984,3,1,1,4,4,10,-6,4
Panionios,7984,3,1,1,4,4,10,-6,4
AEK Athens,7985,1,4,2,0,7,1,6,14
PAOK Salonik,7985,2,2,2,2,9,6,3,8
P'thinaikos,7985,3,2,1,3,6,9,-3,7
Panionios,7985,4,1,1,4,4,10,-6,4
AEK Athens,7986,1,4,2,0,7,1,6,14
PAOK Salonik,7986,2,2,2,2,10,6,4,8
P'thinaikos,7986,3,2,1,3,6,10,-4,7
Panionios,7986,4,1,1,4,4,10,-6,4
AEK Athens,7987,1,4,2,0,7,1,6,14
PAOK Salonik,7987,2,2,2,2,9,5,4,8
P'thinaikos,7987,3,2,1,3,5,9,-4,7
Panionios,7987,4,1,1,4,4,10,-6,4
AEK Athens,7988,1,4,2,0,7,1,6,14
PAOK Salonik,7988,2,2,2,2,9,5,4,8
P'thinaikos,7988,3,2,1,3,5,9,-4,7
Panionios,7988,4,1,1,4,4,10,-6,4
AEK Athens,7989,1,4,2,0,7,1,6,14
PAOK Salonik,7989,2,3,2,1,12,4,8,11
Panionios,7989,3,1,1,4,4,10,-6,4
P'thinaikos,7989,4,1,1,4,4,12,-8,4
AEK Athens,7990,1,4,2,0,7,1,6,14
PAOK Salonik,7990,2,2,3,1,10,5,5,9
P'thinaikos,7990,3,1,2,3,5,10,-5,5
Panionios,7990,4,1,1,4,4,10,-6,4
AEK Athens,7991,1,4,2,0,7,1,6,14
PAOK Salonik,7991,2,2,2,2,10,6,4,8
P'thinaikos,7991,3,2,1,3,6,10,-4,7
Panionios,7991,4,1,1,4,4,10,-6,4
AEK Athens,7992,1,4,2,0,7,1,6,14
PAOK Salonik,7992,2,2,3,1,10,5,5,9
P'thinaikos,7992,3,1,2,3,5,10,-5,5
Panionios,7992,4,1,1,4,4,10,-6,4
AEK Athens,7993,1,4,2,0,7,1,6,14
PAOK Salonik,7993,2,2,2,2,9,6,3,8
P'thinaikos,7993,3,2,1,3,6,9,-3,7
Panionios,7993,4,1,1,4,4,10,-6,4
AEK Athens,7994,1,4,2,0,7,1,6,14
PAOK Salonik,7994,2,2,3,1,9,4,5,9
P'thinaikos,7994,3,1,2,3,4,9,-5,5
Panionios,7994,4,1,1,4,4,10,-6,4
AEK Athens,7995,1,4,2,0,7,1,6,14
PAOK Salonik,7995,2,3,2,1,10,4,6,11
P'thinaikos,7995,3,1,1,4,4,10,-6,4
Panionios,7995,3,1,1,4,4,10,-6,4
AEK Athens,7996,1,4,2,0,7,1,6,14
PAOK Salonik,7996,2,2,2,2,9,5,4,8
P'thinaikos,7996,3,2,1,3,5,9,-4,7
Panionios,7996,4,1,1,4,4,10,-6,4
AEK Athens,7997,1,4,2,0,7,1,6,14
PAOK Salonik,7997,2,3,2,1,10,4,6,11
P'thinaikos,7997,3,1,1,4,4,10,-6,4
Panionios,7997,3,1,1,4,4,10,-6,4
AEK Athens,7998,1,4,2,0,7,1,6,14
PAOK Salonik,7998,2,2,3,1,9,4,5,9
P'thinaikos,7998,3,1,2,3,4,9,-5,5
Panionios,7998,4,1,1,4,4,10,-6,4
AEK Athens,7999,1,4,2,0,7,1,6,14
PAOK Salonik,7999,2,2,2,2,9,5,4,8
P'thinaikos,7999,3,2,1,3,5,9,-4,7
Panionios,7999,4,1,1,4,4,10,-6,4
AEK Athens,8000,1,4,2,0,7,1,6,14
PAOK Salonik,8000,2,3,2,1,12,6,6,11
P'thinaikos,8000,3,1,1,4,6,12,-6,4
Panionios,8000,4,1,1,4,4,10,-6,4
AEK Athens,8001,1,4,2,0,7,1,6,14
PAOK Salonik,8001,2,2,3,1,9,4,5,9
P'thinaikos,8001,3,1,2,3,4,9,-5,5
Panionios,8001,4,1,1,4,4,10,-6,4
AEK Athens,8002,1,4,2,0,7,1,6,14
PAOK Salonik,8002,2,2,3,1,9,4,5,9
P'thinaikos,8002,3,1,2,3,4,9,-5,5
Panionios,8002,4,1,1,4,4,10,-6,4
AEK Athens,8003,1,4,2,0,7,1,6,14
PAOK Salonik,8003,2,3,2,1,13,6,7,11
Panionios,8003,3,1,1,4,4,10,-6,4
P'thinaikos,8003,4,1,1,4,6,13,-7,4
AEK Athens,8004,1,4,2,0,7,1,6,14
PAOK Salonik,8004,2,2,2,2,9,5,4,8
P'thinaikos,8004,3,2,1,3,5,9,-4,7
Panionios,8004,4,1,1,4,4,10,-6,4
AEK Athens,8005,1,4,2,0,7,1,6,14
PAOK Salonik,8005,2,2,3,1,10,5,5,9
P'thinaikos,8005,3,1,2,3,5,10,-5,5
Panionios,8005,4,1,1,4,4,10,-6,4
AEK Athens,8006,1,4,2,0,7,1,6,14
PAOK Salonik,8006,2,2,2,2,10,7,3,8
P'thinaikos,8006,3,2,1,3,7,10,-3,7
Panionios,8006,4,1,1,4,4,10,-6,4
AEK Athens,8007,1,4,2,0,7,1,6,14
PAOK Salonik,8007,2,2,3,1,9,4,5,9
P'thinaikos,8007,3,1,2,3,4,9,-5,5
Panionios,8007,4,1,1,4,4,10,-6,4
AEK Athens,8008,1,4,2,0,7,1,6,14
PAOK Salonik,8008,2,3,2,1,11,4,7,11
Panionios,8008,3,1,1,4,4,10,-6,4
P'thinaikos,8008,4,1,1,4,4,11,-7,4
AEK Athens,8009,1,4,2,0,7,1,6,14
PAOK Salonik,8009,2,2,2,2,9,5,4,8
P'thinaikos,8009,3,2,1,3,5,9,-4,7
Panionios,8009,4,1,1,4,4,10,-6,4
AEK Athens,8010,1,4,2,0,7,1,6,14
PAOK Salonik,8010,2,2,3,1,9,4,5,9
P'thinaikos,8010,3,1,2,3,4,9,-5,5
Panionios,8010,4,1,1,4,4,10,-6,4
AEK Athens,8011,1,4,2,0,7,1,6,14
PAOK Salonik,8011,2,3,2,1,10,4,6,11
P'thinaikos,8011,3,1,1,4,4,10,-6,4
Panionios,8011,3,1,1,4,4,10,-6,4
AEK Athens,8012,1,4,2,0,7,1,6,14
PAOK Salonik,8012,2,2,2,2,10,6,4,8
P'thinaikos,8012,3,2,1,3,6,10,-4,7
Panionios,8012,4,1,1,4,4,10,-6,4
AEK Athens,8013,1,4,2,0,7,1,6,14
PAOK Salonik,8013,2,2,2,2,11,7,4,8
P'thinaikos,8013,3,2,1,3,7,11,-4,7
Panionios,8013,4,1,1,4,4,10,-6,4
AEK Athens,8014,1,4,2,0,7,1,6,14
PAOK Salonik,8014,2,3,2,1,11,5,6,11
P'thinaikos,8014,3,1,1,4,5,11,-6,4
Panionios,8014,4,1,1,4,4,10,-6,4
AEK Athens,8015,1,4,2,0,7,1,6,14
PAOK Salonik,8015,2,2,2,2,9,6,3,8
P'thinaikos,8015,3,2,1,3,6,9,-3,7
Panionios,8015,4,1,1,4,4,10,-6,4
AEK Athens,8016,1,4,2,0,7,1,6,14
PAOK Salonik,8016,2,2,3,1,9,4,5,9
P'thinaikos,8016,3,1,2,3,4,9,-5,5
Panionios,8016,4,1,1,4,4,10,-6,4
AEK Athens,8017,1,4,2,0,7,1,6,14
PAOK Salonik,8017,2,2,3,1,9,4,5,9
P'thinaikos,8017,3,1,2,3,4,9,-5,5
Panionios,8017,4,1,1,4,4,10,-6,4
AEK Athens,8018,1,4,2,0,7,1,6,14
PAOK Salonik,8018,2,3,2,1,10,4,6,11
P'thinaikos,8018,3,1,1,4,4,10,-6,4
Panionios,8018,3,1,1,4,4,10,-6,4
AEK Athens,8019,1,4,2,0,7,1,6,14
PAOK Salonik,8019,2,2,3,1,9,4,5,9
P'thinaikos,8019,3,1,2,3,4,9,-5,5
Panionios,8019,4,1,1,4,4,10,-6,4
AEK Athens,8020,1,4,2,0,7,1,6,14
PAOK Salonik,8020,2,3,2,1,11,4,7,11
Panionios,8020,3,1,1,4,4,10,-6,4
P'thinaikos,8020,4,1,1,4,4,11,-7,4
AEK Athens,8021,1,4,2,0,7,1,6,14
PAOK Salonik,8021,2,2,2,2,9,6,3,8
P'thinaikos,8021,3,2,1,3,6,9,-3,7
Panionios,8021,4,1,1,4,4,10,-6,4
AEK Athens,8022,1,4,2,0,7,1,6,14
PAOK Salonik,8022,2,2,2,2,9,6,3,8
P'thinaikos,8022,3,2,1,3,6,9,-3,7
Panionios,8022,4,1,1,4,4,10,-6,4
AEK Athens,8023,1,4,2,0,7,1,6,14
PAOK Salonik,8023,2,3,2,1,11,5,6,11
P'thinaikos,8023,3,1,1,4,5,11,-6,4
Panionios,8023,4,1,1,4,4,10,-6,4
AEK Athens,8024,1,4,2,0,7,1,6,14
PAOK Salonik,8024,2,3,2,1,10,4,6,11
P'thinaikos,8024,3,1,1,4,4,10,-6,4
Panionios,8024,3,1,1,4,4,10,-6,4
AEK Athens,8025,1,4,2,0,7,1,6,14
PAOK Salonik,8025,2,2,2,2,9,6,3,8
P'thinaikos,8025,3,2,1,3,6,9,-3,7
Panionios,8025,4,1,1,4,4,10,-6,4
AEK Athens,8026,1,4,2,0,7,1,6,14
PAOK Salonik,8026,2,2,2,2,10,7,3,8
P'thinaikos,8026,3,2,1,3,7,10,-3,7
Panionios,8026,4,1,1,4,4,10,-6,4
AEK Athens,8027,1,4,2,0,7,1,6,14
PAOK Salonik,8027,2,3,2,1,10,4,6,11
P'thinaikos,8027,3,1,1,4,4,10,-6,4
Panionios,8027,3,1,1,4,4,10,-6,4
AEK Athens,8028,1,4,2,0,7,1,6,14
PAOK Salonik,8028,2,2,2,2,9,6,3,8
P'thinaikos,8028,3,2,1,3,6,9,-3,7
Panionios,8028,4,1,1,4,4,10,-6,4
AEK Athens,8029,1,4,2,0,7,1,6,14
PAOK Salonik,8029,2,3,2,1,10,4,6,11
P'thinaikos,8029,3,1,1,4,4,10,-6,4
Panionios,8029,3,1,1,4,4,10,-6,4
AEK Athens,8030,1,4,2,0,7,1,6,14
PAOK Salonik,8030,2,3,2,1,10,4,6,11
P'thinaikos,8030,3,1,1,4,4,10,-6,4
Panionios,8030,3,1,1,4,4,10,-6,4
AEK Athens,8031,1,4,2,0,7,1,6,14
PAOK Salonik,8031,2,3,2,1,11,5,6,11
P'thinaikos,8031,3,1,1,4,5,11,-6,4
Panionios,8031,4,1,1,4,4,10,-6,4
AEK Athens,8032,1,4,2,0,7,1,6,14
PAOK Salonik,8032,2,2,2,2,12,9,3,8
P'thinaikos,8032,3,2,1,3,9,12,-3,7
Panionios,8032,4,1,1,4,4,10,-6,4
AEK Athens,8033,1,4,2,0,7,1,6,14
PAOK Salonik,8033,2,2,3,1,9,4,5,9
P'thinaikos,8033,3,1,2,3,4,9,-5,5
Panionios,8033,4,1,1,4,4,10,-6,4
AEK Athens,8034,1,4,2,0,7,1,6,14
PAOK Salonik,8034,2,3,2,1,11,4,7,11
Panionios,8034,3,1,1,4,4,10,-6,4
P'thinaikos,8034,4,1,1,4,4,11,-7,4
AEK Athens,8035,1,4,2,0,7,1,6,14
PAOK Salonik,8035,2,2,2,2,9,5,4,8
P'thinaikos,8035,3,2,1,3,5,9,-4,7
Panionios,8035,4,1,1,4,4,10,-6,4
AEK Athens,8036,1,4,2,0,7,1,6,14
PAOK Salonik,8036,2,3,2,1,11,4,7,11
Panionios,8036,3,1,1,4,4,10,-6,4
P'thinaikos,8036,4,1,1,4,4,11,-7,4
AEK Athens,8037,1,4,2,0,7,1,6,14
PAOK Salonik,8037,2,3,2,1,14,6,8,11
Panionios,8037,3,1,1,4,4,10,-6,4
P'thinaikos,8037,4,1,1,4,6,14,-8,4
AEK Athens,8038,1,4,2,0,7,1,6,14
PAOK Salonik,8038,2,2,3,1,10,5,5,9
P'thinaikos,8038,3,1,2,3,5,10,-5,5
Panionios,8038,4,1,1,4,4,10,-6,4
AEK Athens,8039,1,4,2,0,7,1,6,14
PAOK Salonik,8039,2,2,2,2,11,7,4,8
P'thinaikos,8039,3,2,1,3,7,11,-4,7
Panionios,8039,4,1,1,4,4,10,-6,4
AEK Athens,8040,1,4,2,0,7,1,6,14
PAOK Salonik,8040,2,2,2,2,9,5,4,8
P'thinaikos,8040,3,2,1,3,5,9,-4,7
Panionios,8040,4,1,1,4,4,10,-6,4
AEK Athens,8041,1,4,2,0,7,1,6,14
PAOK Salonik,8041,2,3,2,1,11,4,7,11
Panionios,8041,3,1,1,4,4,10,-6,4
P'thinaikos,8041,4,1,1,4,4,11,-7,4
AEK Athens,8042,1,4,2,0,7,1,6,14
PAOK Salonik,8042,2,2,3,1,11,6,5,9
P'thinaikos,8042,3,1,2,3,6,11,-5,5
Panionios,8042,4,1,1,4,4,10,-6,4
AEK Athens,8043,1,4,2,0,7,1,6,14
PAOK Salonik,8043,2,3,2,1,11,5,6,11
P'thinaikos,8043,3,1,1,4,5,11,-6,4
Panionios,8043,4,1,1,4,4,10,-6,4
AEK Athens,8044,1,4,2,0,7,1,6,14
PAOK Salonik,8044,2,2,2,2,9,6,3,8
P'thinaikos,8044,3,2,1,3,6,9,-3,7
Panionios,8044,4,1,1,4,4,10,-6,4
AEK Athens,8045,1,4,2,0,7,1,6,14
PAOK Salonik,8045,2,2,3,1,9,4,5,9
P'thinaikos,8045,3,1,2,3,4,9,-5,5
Panionios,8045,4,1,1,4,4,10,-6,4
AEK Athens,8046,1,4,2,0,7,1,6,14
PAOK Salonik,8046,2,3,2,1,10,4,6,11
P'thinaikos,8046,3,1,1,4,4,10,-6,4
Panionios,8046,3,1,1,4,4,10,-6,4
AEK Athens,8047,1,4,2,0,7,1,6,14
PAOK Salonik,8047,2,2,2,2,10,6,4,8
P'thinaikos,8047,3,2,1,3,6,10,-4,7
Panionios,8047,4,1,1,4,4,10,-6,4
AEK Athens,8048,1,4,2,0,7,1,6,14
PAOK Salonik,8048,2,2,2,2,11,7,4,8
P'thinaikos,8048,3,2,1,3,7,11,-4,7
Panionios,8048,4,1,1,4,4,10,-6,4
AEK Athens,8049,1,4,2,0,7,1,6,14
PAOK Salonik,8049,2,2,2,2,9,6,3,8
P'thinaikos,8049,3,2,1,3,6,9,-3,7
Panionios,8049,4,1,1,4,4,10,-6,4
AEK Athens,8050,1,4,2,0,7,1,6,14
PAOK Salonik,8050,2,2,3,1,9,4,5,9
P'thinaikos,8050,3,1,2,3,4,9,-5,5
Panionios,8050,4,1,1,4,4,10,-6,4
AEK Athens,8051,1,4,2,0,7,1,6,14
PAOK Salonik,8051,2,2,3,1,11,6,5,9
P'thinaikos,8051,3,1,2,3,6,11,-5,5
Panionios,8051,4,1,1,4,4,10,-6,4
AEK Athens,8052,1,4,2,0,7,1,6,14
PAOK Salonik,8052,2,3,2,1,12,5,7,11
Panionios,8052,3,1,1,4,4,10,-6,4
P'thinaikos,8052,4,1,1,4,5,12,-7,4
AEK Athens,8053,1,4,2,0,7,1,6,14
PAOK Salonik,8053,2,2,3,1,10,5,5,9
P'thinaikos,8053,3,1,2,3,5,10,-5,5
Panionios,8053,4,1,1,4,4,10,-6,4
AEK Athens,8054,1,4,2,0,7,1,6,14
PAOK Salonik,8054,2,2,2,2,9,5,4,8
P'thinaikos,8054,3,2,1,3,5,9,-4,7
Panionios,8054,4,1,1,4,4,10,-6,4
AEK Athens,8055,1,4,2,0,7,1,6,14
PAOK Salonik,8055,2,2,2,2,10,6,4,8
P'thinaikos,8055,3,2,1,3,6,10,-4,7
Panionios,8055,4,1,1,4,4,10,-6,4
AEK Athens,8056,1,4,2,0,7,1,6,14
PAOK Salonik,8056,2,2,2,2,9,5,4,8
P'thinaikos,8056,3,2,1,3,5,9,-4,7
Panionios,8056,4,1,1,4,4,10,-6,4
AEK Athens,8057,1,4,2,0,7,1,6,14
PAOK Salonik,8057,2,2,2,2,12,9,3,8
P'thinaikos,8057,3,2,1,3,9,12,-3,7
Panionios,8057,4,1,1,4,4,10,-6,4
AEK Athens,8058,1,4,2,0,7,1,6,14
PAOK Salonik,8058,2,2,3,1,9,4,5,9
P'thinaikos,8058,3,1,2,3,4,9,-5,5
Panionios,8058,4,1,1,4,4,10,-6,4
AEK Athens,8059,1,4,2,0,7,1,6,14
PAOK Salonik,8059,2,2,3,1,9,4,5,9
P'thinaikos,8059,3,1,2,3,4,9,-5,5
Panionios,8059,4,1,1,4,4,10,-6,4
AEK Athens,8060,1,4,2,0,7,1,6,14
PAOK Salonik,8060,2,2,2,2,9,5,4,8
P'thinaikos,8060,3,2,1,3,5,9,-4,7
Panionios,8060,4,1,1,4,4,10,-6,4
AEK Athens,8061,1,4,2,0,7,1,6,14
PAOK Salonik,8061,2,3,2,1,13,5,8,11
Panionios,8061,3,1,1,4,4,10,-6,4
P'thinaikos,8061,4,1,1,4,5,13,-8,4
AEK Athens,8062,1,4,2,0,7,1,6,14
PAOK Salonik,8062,2,2,3,1,10,5,5,9
P'thinaikos,8062,3,1,2,3,5,10,-5,5
Panionios,8062,4,1,1,4,4,10,-6,4
AEK Athens,8063,1,4,2,0,7,1,6,14
PAOK Salonik,8063,2,2,2,2,9,5,4,8
P'thinaikos,8063,3,2,1,3,5,9,-4,7
Panionios,8063,4,1,1,4,4,10,-6,4
AEK Athens,8064,1,4,2,0,7,1,6,14
PAOK Salonik,8064,2,3,2,1,10,4,6,11
P'thinaikos,8064,3,1,1,4,4,10,-6,4
Panionios,8064,3,1,1,4,4,10,-6,4
AEK Athens,8065,1,4,2,0,7,1,6,14
PAOK Salonik,8065,2,2,2,2,9,6,3,8
P'thinaikos,8065,3,2,1,3,6,9,-3,7
Panionios,8065,4,1,1,4,4,10,-6,4
AEK Athens,8066,1,4,2,0,7,1,6,14
PAOK Salonik,8066,2,2,2,2,10,11,-1,8
P'thinaikos,8066,3,2,1,3,11,10,1,7
Panionios,8066,4,1,1,4,4,10,-6,4
AEK Athens,8067,1,4,2,0,7,1,6,14
PAOK Salonik,8067,2,2,2,2,10,6,4,8
P'thinaikos,8067,3,2,1,3,6,10,-4,7
Panionios,8067,4,1,1,4,4,10,-6,4
AEK Athens,8068,1,4,2,0,7,1,6,14
PAOK Salonik,8068,2,2,2,2,10,6,4,8
P'thinaikos,8068,3,2,1,3,6,10,-4,7
Panionios,8068,4,1,1,4,4,10,-6,4
AEK Athens,8069,1,4,2,0,7,1,6,14
PAOK Salonik,8069,2,2,3,1,9,4,5,9
P'thinaikos,8069,3,1,2,3,4,9,-5,5
Panionios,8069,4,1,1,4,4,10,-6,4
AEK Athens,8070,1,4,2,0,7,1,6,14
PAOK Salonik,8070,2,2,3,1,9,4,5,9
P'thinaikos,8070,3,1,2,3,4,9,-5,5
Panionios,8070,4,1,1,4,4,10,-6,4
AEK Athens,8071,1,4,2,0,7,1,6,14
PAOK Salonik,8071,2,2,2,2,9,6,3,8
P'thinaikos,8071,3,2,1,3,6,9,-3,7
Panionios,8071,4,1,1,4,4,10,-6,4
AEK Athens,8072,1,4,2,0,7,1,6,14
PAOK Salonik,8072,2,2,2,2,10,6,4,8
P'thinaikos,8072,3,2,1,3,6,10,-4,7
Panionios,8072,4,1,1,4,4,10,-6,4
AEK Athens,8073,1,4,2,0,7,1,6,14
PAOK Salonik,8073,2,2,2,2,9,5,4,8
P'thinaikos,8073,3,2,1,3,5,9,-4,7
Panionios,8073,4,1,1,4,4,10,-6,4
AEK Athens,8074,1,4,2,0,7,1,6,14
PAOK Salonik,8074,2,2,3,1,11,6,5,9
P'thinaikos,8074,3,1,2,3,6,11,-5,5
Panionios,8074,4,1,1,4,4,10,-6,4
AEK Athens,8075,1,4,2,0,7,1,6,14
PAOK Salonik,8075,2,3,2,1,11,4,7,11
Panionios,8075,3,1,1,4,4,10,-6,4
P'thinaikos,8075,4,1,1,4,4,11,-7,4
AEK Athens,8076,1,4,2,0,7,1,6,14
PAOK Salonik,8076,2,2,2,2,10,6,4,8
P'thinaikos,8076,3,2,1,3,6,10,-4,7
Panionios,8076,4,1,1,4,4,10,-6,4
AEK Athens,8077,1,4,2,0,7,1,6,14
PAOK Salonik,8077,2,2,2,2,10,6,4,8
P'thinaikos,8077,3,2,1,3,6,10,-4,7
Panionios,8077,4,1,1,4,4,10,-6,4
AEK Athens,8078,1,4,2,0,7,1,6,14
PAOK Salonik,8078,2,2,3,1,9,4,5,9
P'thinaikos,8078,3,1,2,3,4,9,-5,5
Panionios,8078,4,1,1,4,4,10,-6,4
AEK Athens,8079,1,4,2,0,7,1,6,14
PAOK Salonik,8079,2,2,2,2,9,6,3,8
P'thinaikos,8079,3,2,1,3,6,9,-3,7
Panionios,8079,4,1,1,4,4,10,-6,4
AEK Athens,8080,1,4,2,0,7,1,6,14
PAOK Salonik,8080,2,2,3,1,11,6,5,9
P'thinaikos,8080,3,1,2,3,6,11,-5,5
Panionios,8080,4,1,1,4,4,10,-6,4
AEK Athens,8081,1,4,2,0,7,1,6,14
PAOK Salonik,8081,2,3,2,1,11,5,6,11
P'thinaikos,8081,3,1,1,4,5,11,-6,4
Panionios,8081,4,1,1,4,4,10,-6,4
AEK Athens,8082,1,4,2,0,7,1,6,14
PAOK Salonik,8082,2,2,2,2,10,6,4,8
P'thinaikos,8082,3,2,1,3,6,10,-4,7
Panionios,8082,4,1,1,4,4,10,-6,4
AEK Athens,8083,1,4,2,0,7,1,6,14
PAOK Salonik,8083,2,2,2,2,9,6,3,8
P'thinaikos,8083,3,2,1,3,6,9,-3,7
Panionios,8083,4,1,1,4,4,10,-6,4
AEK Athens,8084,1,4,2,0,7,1,6,14
PAOK Salonik,8084,2,3,2,1,12,6,6,11
P'thinaikos,8084,3,1,1,4,6,12,-6,4
Panionios,8084,4,1,1,4,4,10,-6,4
AEK Athens,8085,1,4,2,0,7,1,6,14
PAOK Salonik,8085,2,3,2,1,10,4,6,11
P'thinaikos,8085,3,1,1,4,4,10,-6,4
Panionios,8085,3,1,1,4,4,10,-6,4
AEK Athens,8086,1,4,2,0,7,1,6,14
PAOK Salonik,8086,2,3,2,1,10,4,6,11
P'thinaikos,8086,3,1,1,4,4,10,-6,4
Panionios,8086,3,1,1,4,4,10,-6,4
AEK Athens,8087,1,4,2,0,7,1,6,14
PAOK Salonik,8087,2,2,2,2,9,5,4,8
P'thinaikos,8087,3,2,1,3,5,9,-4,7
Panionios,8087,4,1,1,4,4,10,-6,4
AEK Athens,8088,1,4,2,0,7,1,6,14
PAOK Salonik,8088,2,2,3,1,10,5,5,9
P'thinaikos,8088,3,1,2,3,5,10,-5,5
Panionios,8088,4,1,1,4,4,10,-6,4
AEK Athens,8089,1,4,2,0,7,1,6,14
PAOK Salonik,8089,2,3,2,1,13,4,9,11
Panionios,8089,3,1,1,4,4,10,-6,4
P'thinaikos,8089,4,1,1,4,4,13,-9,4
AEK Athens,8090,1,4,2,0,7,1,6,14
PAOK Salonik,8090,2,3,2,1,11,5,6,11
P'thinaikos,8090,3,1,1,4,5,11,-6,4
Panionios,8090,4,1,1,4,4,10,-6,4
AEK Athens,8091,1,4,2,0,7,1,6,14
PAOK Salonik,8091,2,3,2,1,10,4,6,11
P'thinaikos,8091,3,1,1,4,4,10,-6,4
Panionios,8091,3,1,1,4,4,10,-6,4
AEK Athens,8092,1,4,2,0,7,1,6,14
PAOK Salonik,8092,2,3,2,1,11,4,7,11
Panionios,8092,3,1,1,4,4,10,-6,4
P'thinaikos,8092,4,1,1,4,4,11,-7,4
AEK Athens,8093,1,4,2,0,7,1,6,14
PAOK Salonik,8093,2,2,2,2,9,6,3,8
P'thinaikos,8093,3,2,1,3,6,9,-3,7
Panionios,8093,4,1,1,4,4,10,-6,4
AEK Athens,8094,1,4,2,0,7,1,6,14
PAOK Salonik,8094,2,2,2,2,11,8,3,8
P'thinaikos,8094,3,2,1,3,8,11,-3,7
Panionios,8094,4,1,1,4,4,10,-6,4
AEK Athens,8095,1,4,2,0,7,1,6,14
PAOK Salonik,8095,2,2,2,2,9,5,4,8
P'thinaikos,8095,3,2,1,3,5,9,-4,7
Panionios,8095,4,1,1,4,4,10,-6,4
AEK Athens,8096,1,4,2,0,7,1,6,14
PAOK Salonik,8096,2,3,2,1,12,4,8,11
Panionios,8096,3,1,1,4,4,10,-6,4
P'thinaikos,8096,4,1,1,4,4,12,-8,4
AEK Athens,8097,1,4,2,0,7,1,6,14
PAOK Salonik,8097,2,2,3,1,9,4,5,9
P'thinaikos,8097,3,1,2,3,4,9,-5,5
Panionios,8097,4,1,1,4,4,10,-6,4
AEK Athens,8098,1,4,2,0,7,1,6,14
PAOK Salonik,8098,2,3,2,1,12,6,6,11
P'thinaikos,8098,3,1,1,4,6,12,-6,4
Panionios,8098,4,1,1,4,4,10,-6,4
AEK Athens,8099,1,4,2,0,7,1,6,14
PAOK Salonik,8099,2,2,3,1,9,4,5,9
P'thinaikos,8099,3,1,2,3,4,9,-5,5
Panionios,8099,4,1,1,4,4,10,-6,4
AEK Athens,8100,1,4,2,0,7,1,6,14
PAOK Salonik,8100,2,3,2,1,10,4,6,11
P'thinaikos,8100,3,1,1,4,4,10,-6,4
Panionios,8100,3,1,1,4,4,10,-6,4
AEK Athens,8101,1,4,2,0,7,1,6,14
PAOK Salonik,8101,2,2,2,2,9,5,4,8
P'thinaikos,8101,3,2,1,3,5,9,-4,7
Panionios,8101,4,1,1,4,4,10,-6,4
AEK Athens,8102,1,4,2,0,7,1,6,14
PAOK Salonik,8102,2,2,2,2,9,7,2,8
P'thinaikos,8102,3,2,1,3,7,9,-2,7
Panionios,8102,4,1,1,4,4,10,-6,4
AEK Athens,8103,1,4,2,0,7,1,6,14
PAOK Salonik,8103,2,2,3,1,10,5,5,9
P'thinaikos,8103,3,1,2,3,5,10,-5,5
Panionios,8103,4,1,1,4,4,10,-6,4
AEK Athens,8104,1,4,2,0,7,1,6,14
PAOK Salonik,8104,2,2,3,1,11,6,5,9
P'thinaikos,8104,3,1,2,3,6,11,-5,5
Panionios,8104,4,1,1,4,4,10,-6,4
AEK Athens,8105,1,4,2,0,7,1,6,14
PAOK Salonik,8105,2,2,3,1,9,4,5,9
P'thinaikos,8105,3,1,2,3,4,9,-5,5
Panionios,8105,4,1,1,4,4,10,-6,4
AEK Athens,8106,1,4,2,0,7,1,6,14
PAOK Salonik,8106,2,2,3,1,9,4,5,9
P'thinaikos,8106,3,1,2,3,4,9,-5,5
Panionios,8106,4,1,1,4,4,10,-6,4
AEK Athens,8107,1,4,2,0,7,1,6,14
PAOK Salonik,8107,2,2,2,2,9,6,3,8
P'thinaikos,8107,3,2,1,3,6,9,-3,7
Panionios,8107,4,1,1,4,4,10,-6,4
AEK Athens,8108,1,4,2,0,7,1,6,14
PAOK Salonik,8108,2,3,2,1,12,5,7,11
Panionios,8108,3,1,1,4,4,10,-6,4
P'thinaikos,8108,4,1,1,4,5,12,-7,4
AEK Athens,8109,1,4,2,0,7,1,6,14
PAOK Salonik,8109,2,2,2,2,9,5,4,8
P'thinaikos,8109,3,2,1,3,5,9,-4,7
Panionios,8109,4,1,1,4,4,10,-6,4
AEK Athens,8110,1,4,2,0,7,1,6,14
PAOK Salonik,8110,2,2,3,1,11,6,5,9
P'thinaikos,8110,3,1,2,3,6,11,-5,5
Panionios,8110,4,1,1,4,4,10,-6,4
AEK Athens,8111,1,4,2,0,7,1,6,14
PAOK Salonik,8111,2,2,2,2,9,6,3,8
P'thinaikos,8111,3,2,1,3,6,9,-3,7
Panionios,8111,4,1,1,4,4,10,-6,4
AEK Athens,8112,1,4,2,0,7,1,6,14
PAOK Salonik,8112,2,2,3,1,9,4,5,9
P'thinaikos,8112,3,1,2,3,4,9,-5,5
Panionios,8112,4,1,1,4,4,10,-6,4
AEK Athens,8113,1,4,2,0,7,1,6,14
PAOK Salonik,8113,2,3,2,1,10,4,6,11
P'thinaikos,8113,3,1,1,4,4,10,-6,4
Panionios,8113,3,1,1,4,4,10,-6,4
AEK Athens,8114,1,4,2,0,7,1,6,14
PAOK Salonik,8114,2,3,2,1,11,5,6,11
P'thinaikos,8114,3,1,1,4,5,11,-6,4
Panionios,8114,4,1,1,4,4,10,-6,4
AEK Athens,8115,1,4,2,0,7,1,6,14
PAOK Salonik,8115,2,2,2,2,9,5,4,8
P'thinaikos,8115,3,2,1,3,5,9,-4,7
Panionios,8115,4,1,1,4,4,10,-6,4
AEK Athens,8116,1,4,2,0,7,1,6,14
PAOK Salonik,8116,2,2,3,1,11,6,5,9
P'thinaikos,8116,3,1,2,3,6,11,-5,5
Panionios,8116,4,1,1,4,4,10,-6,4
AEK Athens,8117,1,4,2,0,7,1,6,14
PAOK Salonik,8117,2,2,3,1,11,6,5,9
P'thinaikos,8117,3,1,2,3,6,11,-5,5
Panionios,8117,4,1,1,4,4,10,-6,4
AEK Athens,8118,1,4,2,0,7,1,6,14
PAOK Salonik,8118,2,2,2,2,9,5,4,8
P'thinaikos,8118,3,2,1,3,5,9,-4,7
Panionios,8118,4,1,1,4,4,10,-6,4
AEK Athens,8119,1,4,2,0,7,1,6,14
PAOK Salonik,8119,2,3,2,1,11,4,7,11
Panionios,8119,3,1,1,4,4,10,-6,4
P'thinaikos,8119,4,1,1,4,4,11,-7,4
AEK Athens,8120,1,4,2,0,7,1,6,14
PAOK Salonik,8120,2,2,3,1,11,6,5,9
P'thinaikos,8120,3,1,2,3,6,11,-5,5
Panionios,8120,4,1,1,4,4,10,-6,4
AEK Athens,8121,1,4,2,0,7,1,6,14
PAOK Salonik,8121,2,2,2,2,9,7,2,8
P'thinaikos,8121,3,2,1,3,7,9,-2,7
Panionios,8121,4,1,1,4,4,10,-6,4
AEK Athens,8122,1,4,2,0,7,1,6,14
PAOK Salonik,8122,2,2,3,1,10,5,5,9
P'thinaikos,8122,3,1,2,3,5,10,-5,5
Panionios,8122,4,1,1,4,4,10,-6,4
AEK Athens,8123,1,4,2,0,7,1,6,14
PAOK Salonik,8123,2,3,2,1,11,4,7,11
Panionios,8123,3,1,1,4,4,10,-6,4
P'thinaikos,8123,4,1,1,4,4,11,-7,4
AEK Athens,8124,1,4,2,0,7,1,6,14
PAOK Salonik,8124,2,2,2,2,10,6,4,8
P'thinaikos,8124,3,2,1,3,6,10,-4,7
Panionios,8124,4,1,1,4,4,10,-6,4
AEK Athens,8125,1,4,2,0,7,1,6,14
PAOK Salonik,8125,2,2,2,2,9,7,2,8
P'thinaikos,8125,3,2,1,3,7,9,-2,7
Panionios,8125,4,1,1,4,4,10,-6,4
AEK Athens,8126,1,4,2,0,7,1,6,14
PAOK Salonik,8126,2,2,2,2,10,6,4,8
P'thinaikos,8126,3,2,1,3,6,10,-4,7
Panionios,8126,4,1,1,4,4,10,-6,4
AEK Athens,8127,1,4,2,0,7,1,6,14
PAOK Salonik,8127,2,2,2,2,9,5,4,8
P'thinaikos,8127,3,2,1,3,5,9,-4,7
Panionios,8127,4,1,1,4,4,10,-6,4
AEK Athens,8128,1,4,2,0,7,1,6,14
PAOK Salonik,8128,2,3,2,1,11,5,6,11
P'thinaikos,8128,3,1,1,4,5,11,-6,4
Panionios,8128,4,1,1,4,4,10,-6,4
AEK Athens,8129,1,4,2,0,7,1,6,14
PAOK Salonik,8129,2,2,3,1,10,5,5,9
P'thinaikos,8129,3,1,2,3,5,10,-5,5
Panionios,8129,4,1,1,4,4,10,-6,4
AEK Athens,8130,1,4,2,0,7,1,6,14
PAOK Salonik,8130,2,2,2,2,9,6,3,8
P'thinaikos,8130,3,2,1,3,6,9,-3,7
Panionios,8130,4,1,1,4,4,10,-6,4
AEK Athens,8131,1,4,2,0,7,1,6,14
PAOK Salonik,8131,2,3,2,1,10,4,6,11
P'thinaikos,8131,3,1,1,4,4,10,-6,4
Panionios,8131,3,1,1,4,4,10,-6,4
AEK Athens,8132,1,4,2,0,7,1,6,14
PAOK Salonik,8132,2,2,3,1,10,5,5,9
P'thinaikos,8132,3,1,2,3,5,10,-5,5
Panionios,8132,4,1,1,4,4,10,-6,4
AEK Athens,8133,1,4,2,0,7,1,6,14
PAOK Salonik,8133,2,3,2,1,12,4,8,11
Panionios,8133,3,1,1,4,4,10,-6,4
P'thinaikos,8133,4,1,1,4,4,12,-8,4
AEK Athens,8134,1,4,2,0,7,1,6,14
PAOK Salonik,8134,2,2,2,2,9,5,4,8
P'thinaikos,8134,3,2,1,3,5,9,-4,7
Panionios,8134,4,1,1,4,4,10,-6,4
AEK Athens,8135,1,4,2,0,7,1,6,14
PAOK Salonik,8135,2,3,2,1,11,5,6,11
P'thinaikos,8135,3,1,1,4,5,11,-6,4
Panionios,8135,4,1,1,4,4,10,-6,4
AEK Athens,8136,1,4,2,0,7,1,6,14
PAOK Salonik,8136,2,2,2,2,9,5,4,8
P'thinaikos,8136,3,2,1,3,5,9,-4,7
Panionios,8136,4,1,1,4,4,10,-6,4
AEK Athens,8137,1,4,2,0,7,1,6,14
PAOK Salonik,8137,2,2,3,1,10,5,5,9
P'thinaikos,8137,3,1,2,3,5,10,-5,5
Panionios,8137,4,1,1,4,4,10,-6,4
AEK Athens,8138,1,4,2,0,7,1,6,14
PAOK Salonik,8138,2,3,2,1,11,4,7,11
Panionios,8138,3,1,1,4,4,10,-6,4
P'thinaikos,8138,4,1,1,4,4,11,-7,4
AEK Athens,8139,1,4,2,0,7,1,6,14
PAOK Salonik,8139,2,2,3,1,10,5,5,9
P'thinaikos,8139,3,1,2,3,5,10,-5,5
Panionios,8139,4,1,1,4,4,10,-6,4
AEK Athens,8140,1,4,2,0,7,1,6,14
PAOK Salonik,8140,2,2,3,1,10,5,5,9
P'thinaikos,8140,3,1,2,3,5,10,-5,5
Panionios,8140,4,1,1,4,4,10,-6,4
AEK Athens,8141,1,4,2,0,7,1,6,14
PAOK Salonik,8141,2,3,2,1,11,4,7,11
Panionios,8141,3,1,1,4,4,10,-6,4
P'thinaikos,8141,4,1,1,4,4,11,-7,4
AEK Athens,8142,1,4,2,0,7,1,6,14
PAOK Salonik,8142,2,3,2,1,12,6,6,11
P'thinaikos,8142,3,1,1,4,6,12,-6,4
Panionios,8142,4,1,1,4,4,10,-6,4
AEK Athens,8143,1,4,2,0,7,1,6,14
PAOK Salonik,8143,2,3,2,1,11,4,7,11
Panionios,8143,3,1,1,4,4,10,-6,4
P'thinaikos,8143,4,1,1,4,4,11,-7,4
AEK Athens,8144,1,4,2,0,7,1,6,14
PAOK Salonik,8144,2,2,3,1,10,5,5,9
P'thinaikos,8144,3,1,2,3,5,10,-5,5
Panionios,8144,4,1,1,4,4,10,-6,4
AEK Athens,8145,1,4,2,0,7,1,6,14
PAOK Salonik,8145,2,2,3,1,10,5,5,9
P'thinaikos,8145,3,1,2,3,5,10,-5,5
Panionios,8145,4,1,1,4,4,10,-6,4
AEK Athens,8146,1,4,2,0,7,1,6,14
PAOK Salonik,8146,2,2,2,2,10,6,4,8
P'thinaikos,8146,3,2,1,3,6,10,-4,7
Panionios,8146,4,1,1,4,4,10,-6,4
AEK Athens,8147,1,4,2,0,7,1,6,14
PAOK Salonik,8147,2,2,2,2,10,6,4,8
P'thinaikos,8147,3,2,1,3,6,10,-4,7
Panionios,8147,4,1,1,4,4,10,-6,4
AEK Athens,8148,1,4,2,0,7,1,6,14
PAOK Salonik,8148,2,2,2,2,10,6,4,8
P'thinaikos,8148,3,2,1,3,6,10,-4,7
Panionios,8148,4,1,1,4,4,10,-6,4
AEK Athens,8149,1,4,2,0,7,1,6,14
PAOK Salonik,8149,2,3,2,1,12,5,7,11
Panionios,8149,3,1,1,4,4,10,-6,4
P'thinaikos,8149,4,1,1,4,5,12,-7,4
AEK Athens,8150,1,4,2,0,7,1,6,14
PAOK Salonik,8150,2,2,2,2,10,6,4,8
P'thinaikos,8150,3,2,1,3,6,10,-4,7
Panionios,8150,4,1,1,4,4,10,-6,4
AEK Athens,8151,1,4,2,0,7,1,6,14
PAOK Salonik,8151,2,2,3,1,9,4,5,9
P'thinaikos,8151,3,1,2,3,4,9,-5,5
Panionios,8151,4,1,1,4,4,10,-6,4
AEK Athens,8152,1,4,2,0,7,1,6,14
PAOK Salonik,8152,2,2,2,2,9,6,3,8
P'thinaikos,8152,3,2,1,3,6,9,-3,7
Panionios,8152,4,1,1,4,4,10,-6,4
AEK Athens,8153,1,4,2,0,7,1,6,14
PAOK Salonik,8153,2,2,3,1,11,6,5,9
P'thinaikos,8153,3,1,2,3,6,11,-5,5
Panionios,8153,4,1,1,4,4,10,-6,4
AEK Athens,8154,1,4,2,0,7,1,6,14
PAOK Salonik,8154,2,3,2,1,11,4,7,11
Panionios,8154,3,1,1,4,4,10,-6,4
P'thinaikos,8154,4,1,1,4,4,11,-7,4
AEK Athens,8155,1,4,2,0,7,1,6,14
PAOK Salonik,8155,2,2,3,1,9,4,5,9
P'thinaikos,8155,3,1,2,3,4,9,-5,5
Panionios,8155,4,1,1,4,4,10,-6,4
AEK Athens,8156,1,4,2,0,7,1,6,14
PAOK Salonik,8156,2,2,2,2,10,6,4,8
P'thinaikos,8156,3,2,1,3,6,10,-4,7
Panionios,8156,4,1,1,4,4,10,-6,4
AEK Athens,8157,1,4,2,0,7,1,6,14
PAOK Salonik,8157,2,2,2,2,9,5,4,8
P'thinaikos,8157,3,2,1,3,5,9,-4,7
Panionios,8157,4,1,1,4,4,10,-6,4
AEK Athens,8158,1,4,2,0,7,1,6,14
PAOK Salonik,8158,2,2,2,2,9,5,4,8
P'thinaikos,8158,3,2,1,3,5,9,-4,7
Panionios,8158,4,1,1,4,4,10,-6,4
AEK Athens,8159,1,4,2,0,7,1,6,14
PAOK Salonik,8159,2,3,2,1,11,5,6,11
P'thinaikos,8159,3,1,1,4,5,11,-6,4
Panionios,8159,4,1,1,4,4,10,-6,4
AEK Athens,8160,1,4,2,0,7,1,6,14
PAOK Salonik,8160,2,2,3,1,10,5,5,9
P'thinaikos,8160,3,1,2,3,5,10,-5,5
Panionios,8160,4,1,1,4,4,10,-6,4
AEK Athens,8161,1,4,2,0,7,1,6,14
PAOK Salonik,8161,2,3,2,1,12,5,7,11
Panionios,8161,3,1,1,4,4,10,-6,4
P'thinaikos,8161,4,1,1,4,5,12,-7,4
AEK Athens,8162,1,4,2,0,7,1,6,14
PAOK Salonik,8162,2,2,2,2,11,7,4,8
P'thinaikos,8162,3,2,1,3,7,11,-4,7
Panionios,8162,4,1,1,4,4,10,-6,4
AEK Athens,8163,1,4,2,0,7,1,6,14
PAOK Salonik,8163,2,3,2,1,10,4,6,11
P'thinaikos,8163,3,1,1,4,4,10,-6,4
Panionios,8163,3,1,1,4,4,10,-6,4
AEK Athens,8164,1,4,2,0,7,1,6,14
PAOK Salonik,8164,2,3,2,1,11,4,7,11
Panionios,8164,3,1,1,4,4,10,-6,4
P'thinaikos,8164,4,1,1,4,4,11,-7,4
AEK Athens,8165,1,4,2,0,7,1,6,14
PAOK Salonik,8165,2,3,2,1,11,5,6,11
P'thinaikos,8165,3,1,1,4,5,11,-6,4
Panionios,8165,4,1,1,4,4,10,-6,4
AEK Athens,8166,1,4,2,0,7,1,6,14
PAOK Salonik,8166,2,2,2,2,9,6,3,8
P'thinaikos,8166,3,2,1,3,6,9,-3,7
Panionios,8166,4,1,1,4,4,10,-6,4
AEK Athens,8167,1,4,2,0,7,1,6,14
PAOK Salonik,8167,2,2,2,2,9,6,3,8
P'thinaikos,8167,3,2,1,3,6,9,-3,7
Panionios,8167,4,1,1,4,4,10,-6,4
AEK Athens,8168,1,4,2,0,7,1,6,14
PAOK Salonik,8168,2,2,2,2,9,5,4,8
P'thinaikos,8168,3,2,1,3,5,9,-4,7
Panionios,8168,4,1,1,4,4,10,-6,4
AEK Athens,8169,1,4,2,0,7,1,6,14
PAOK Salonik,8169,2,3,2,1,11,5,6,11
P'thinaikos,8169,3,1,1,4,5,11,-6,4
Panionios,8169,4,1,1,4,4,10,-6,4
AEK Athens,8170,1,4,2,0,7,1,6,14
PAOK Salonik,8170,2,2,3,1,10,5,5,9
P'thinaikos,8170,3,1,2,3,5,10,-5,5
Panionios,8170,4,1,1,4,4,10,-6,4
AEK Athens,8171,1,4,2,0,7,1,6,14
PAOK Salonik,8171,2,2,3,1,11,6,5,9
P'thinaikos,8171,3,1,2,3,6,11,-5,5
Panionios,8171,4,1,1,4,4,10,-6,4
AEK Athens,8172,1,4,2,0,7,1,6,14
PAOK Salonik,8172,2,3,2,1,11,5,6,11
P'thinaikos,8172,3,1,1,4,5,11,-6,4
Panionios,8172,4,1,1,4,4,10,-6,4
AEK Athens,8173,1,4,2,0,7,1,6,14
PAOK Salonik,8173,2,2,2,2,10,6,4,8
P'thinaikos,8173,3,2,1,3,6,10,-4,7
Panionios,8173,4,1,1,4,4,10,-6,4
AEK Athens,8174,1,4,2,0,7,1,6,14
PAOK Salonik,8174,2,3,2,1,11,4,7,11
Panionios,8174,3,1,1,4,4,10,-6,4
P'thinaikos,8174,4,1,1,4,4,11,-7,4
AEK Athens,8175,1,4,2,0,7,1,6,14
PAOK Salonik,8175,2,3,2,1,11,4,7,11
Panionios,8175,3,1,1,4,4,10,-6,4
P'thinaikos,8175,4,1,1,4,4,11,-7,4
AEK Athens,8176,1,4,2,0,7,1,6,14
PAOK Salonik,8176,2,2,2,2,9,5,4,8
P'thinaikos,8176,3,2,1,3,5,9,-4,7
Panionios,8176,4,1,1,4,4,10,-6,4
AEK Athens,8177,1,4,2,0,7,1,6,14
PAOK Salonik,8177,2,2,2,2,9,5,4,8
P'thinaikos,8177,3,2,1,3,5,9,-4,7
Panionios,8177,4,1,1,4,4,10,-6,4
AEK Athens,8178,1,4,2,0,7,1,6,14
PAOK Salonik,8178,2,2,3,1,9,4,5,9
P'thinaikos,8178,3,1,2,3,4,9,-5,5
Panionios,8178,4,1,1,4,4,10,-6,4
AEK Athens,8179,1,4,2,0,7,1,6,14
PAOK Salonik,8179,2,2,3,1,9,4,5,9
P'thinaikos,8179,3,1,2,3,4,9,-5,5
Panionios,8179,4,1,1,4,4,10,-6,4
AEK Athens,8180,1,4,2,0,7,1,6,14
PAOK Salonik,8180,2,3,2,1,10,4,6,11
P'thinaikos,8180,3,1,1,4,4,10,-6,4
Panionios,8180,3,1,1,4,4,10,-6,4
AEK Athens,8181,1,4,2,0,7,1,6,14
PAOK Salonik,8181,2,2,2,2,9,7,2,8
P'thinaikos,8181,3,2,1,3,7,9,-2,7
Panionios,8181,4,1,1,4,4,10,-6,4
AEK Athens,8182,1,4,2,0,7,1,6,14
PAOK Salonik,8182,2,2,3,1,10,5,5,9
P'thinaikos,8182,3,1,2,3,5,10,-5,5
Panionios,8182,4,1,1,4,4,10,-6,4
AEK Athens,8183,1,4,2,0,7,1,6,14
PAOK Salonik,8183,2,2,3,1,11,6,5,9
P'thinaikos,8183,3,1,2,3,6,11,-5,5
Panionios,8183,4,1,1,4,4,10,-6,4
AEK Athens,8184,1,4,2,0,7,1,6,14
PAOK Salonik,8184,2,3,2,1,10,4,6,11
P'thinaikos,8184,3,1,1,4,4,10,-6,4
Panionios,8184,3,1,1,4,4,10,-6,4
AEK Athens,8185,1,4,2,0,7,1,6,14
PAOK Salonik,8185,2,2,2,2,10,6,4,8
P'thinaikos,8185,3,2,1,3,6,10,-4,7
Panionios,8185,4,1,1,4,4,10,-6,4
AEK Athens,8186,1,4,2,0,7,1,6,14
PAOK Salonik,8186,2,2,2,2,9,6,3,8
P'thinaikos,8186,3,2,1,3,6,9,-3,7
Panionios,8186,4,1,1,4,4,10,-6,4
AEK Athens,8187,1,4,2,0,7,1,6,14
PAOK Salonik,8187,2,3,2,1,10,4,6,11
P'thinaikos,8187,3,1,1,4,4,10,-6,4
Panionios,8187,3,1,1,4,4,10,-6,4
AEK Athens,8188,1,4,2,0,7,1,6,14
PAOK Salonik,8188,2,3,2,1,10,4,6,11
P'thinaikos,8188,3,1,1,4,4,10,-6,4
Panionios,8188,3,1,1,4,4,10,-6,4
AEK Athens,8189,1,4,2,0,7,1,6,14
PAOK Salonik,8189,2,3,2,1,11,5,6,11
P'thinaikos,8189,3,1,1,4,5,11,-6,4
Panionios,8189,4,1,1,4,4,10,-6,4
AEK Athens,8190,1,4,2,0,7,1,6,14
PAOK Salonik,8190,2,2,2,2,11,7,4,8
P'thinaikos,8190,3,2,1,3,7,11,-4,7
Panionios,8190,4,1,1,4,4,10,-6,4
AEK Athens,8191,1,4,2,0,7,1,6,14
PAOK Salonik,8191,2,3,2,1,13,4,9,11
Panionios,8191,3,1,1,4,4,10,-6,4
P'thinaikos,8191,4,1,1,4,4,13,-9,4
AEK Athens,8192,1,4,2,0,7,1,6,14
PAOK Salonik,8192,2,2,2,2,9,7,2,8
P'thinaikos,8192,3,2,1,3,7,9,-2,7
Panionios,8192,4,1,1,4,4,10,-6,4
AEK Athens,8193,1,4,2,0,7,1,6,14
PAOK Salonik,8193,2,3,2,1,10,4,6,11
P'thinaikos,8193,3,1,1,4,4,10,-6,4
Panionios,8193,3,1,1,4,4,10,-6,4
AEK Athens,8194,1,4,2,0,7,1,6,14
PAOK Salonik,8194,2,2,2,2,11,9,2,8
P'thinaikos,8194,3,2,1,3,9,11,-2,7
Panionios,8194,4,1,1,4,4,10,-6,4
AEK Athens,8195,1,4,2,0,7,1,6,14
PAOK Salonik,8195,2,3,2,1,10,4,6,11
P'thinaikos,8195,3,1,1,4,4,10,-6,4
Panionios,8195,3,1,1,4,4,10,-6,4
AEK Athens,8196,1,4,2,0,7,1,6,14
PAOK Salonik,8196,2,3,2,1,11,4,7,11
Panionios,8196,3,1,1,4,4,10,-6,4
P'thinaikos,8196,4,1,1,4,4,11,-7,4
AEK Athens,8197,1,4,2,0,7,1,6,14
PAOK Salonik,8197,2,3,2,1,11,4,7,11
Panionios,8197,3,1,1,4,4,10,-6,4
P'thinaikos,8197,4,1,1,4,4,11,-7,4
AEK Athens,8198,1,4,2,0,7,1,6,14
PAOK Salonik,8198,2,2,2,2,9,5,4,8
P'thinaikos,8198,3,2,1,3,5,9,-4,7
Panionios,8198,4,1,1,4,4,10,-6,4
AEK Athens,8199,1,4,2,0,7,1,6,14
PAOK Salonik,8199,2,2,2,2,9,5,4,8
P'thinaikos,8199,3,2,1,3,5,9,-4,7
Panionios,8199,4,1,1,4,4,10,-6,4
AEK Athens,8200,1,4,2,0,7,1,6,14
PAOK Salonik,8200,2,2,3,1,9,4,5,9
P'thinaikos,8200,3,1,2,3,4,9,-5,5
Panionios,8200,4,1,1,4,4,10,-6,4
AEK Athens,8201,1,4,2,0,7,1,6,14
PAOK Salonik,8201,2,2,2,2,10,6,4,8
P'thinaikos,8201,3,2,1,3,6,10,-4,7
Panionios,8201,4,1,1,4,4,10,-6,4
AEK Athens,8202,1,4,2,0,7,1,6,14
PAOK Salonik,8202,2,3,2,1,12,6,6,11
P'thinaikos,8202,3,1,1,4,6,12,-6,4
Panionios,8202,4,1,1,4,4,10,-6,4
AEK Athens,8203,1,4,2,0,7,1,6,14
PAOK Salonik,8203,2,2,2,2,9,5,4,8
P'thinaikos,8203,3,2,1,3,5,9,-4,7
Panionios,8203,4,1,1,4,4,10,-6,4
AEK Athens,8204,1,4,2,0,7,1,6,14
PAOK Salonik,8204,2,2,2,2,12,10,2,8
P'thinaikos,8204,3,2,1,3,10,12,-2,7
Panionios,8204,4,1,1,4,4,10,-6,4
AEK Athens,8205,1,4,2,0,7,1,6,14
PAOK Salonik,8205,2,2,2,2,9,5,4,8
P'thinaikos,8205,3,2,1,3,5,9,-4,7
Panionios,8205,4,1,1,4,4,10,-6,4
AEK Athens,8206,1,4,2,0,7,1,6,14
PAOK Salonik,8206,2,2,2,2,9,6,3,8
P'thinaikos,8206,3,2,1,3,6,9,-3,7
Panionios,8206,4,1,1,4,4,10,-6,4
AEK Athens,8207,1,4,2,0,7,1,6,14
PAOK Salonik,8207,2,3,2,1,10,4,6,11
P'thinaikos,8207,3,1,1,4,4,10,-6,4
Panionios,8207,3,1,1,4,4,10,-6,4
AEK Athens,8208,1,4,2,0,7,1,6,14
PAOK Salonik,8208,2,2,3,1,9,4,5,9
P'thinaikos,8208,3,1,2,3,4,9,-5,5
Panionios,8208,4,1,1,4,4,10,-6,4
AEK Athens,8209,1,4,2,0,7,1,6,14
PAOK Salonik,8209,2,3,2,1,11,5,6,11
P'thinaikos,8209,3,1,1,4,5,11,-6,4
Panionios,8209,4,1,1,4,4,10,-6,4
AEK Athens,8210,1,4,2,0,7,1,6,14
PAOK Salonik,8210,2,3,2,1,12,5,7,11
Panionios,8210,3,1,1,4,4,10,-6,4
P'thinaikos,8210,4,1,1,4,5,12,-7,4
AEK Athens,8211,1,4,2,0,7,1,6,14
PAOK Salonik,8211,2,3,2,1,11,5,6,11
P'thinaikos,8211,3,1,1,4,5,11,-6,4
Panionios,8211,4,1,1,4,4,10,-6,4
AEK Athens,8212,1,4,2,0,7,1,6,14
PAOK Salonik,8212,2,2,2,2,9,8,1,8
P'thinaikos,8212,3,2,1,3,8,9,-1,7
Panionios,8212,4,1,1,4,4,10,-6,4
AEK Athens,8213,1,4,2,0,7,1,6,14
PAOK Salonik,8213,2,2,2,2,9,5,4,8
P'thinaikos,8213,3,2,1,3,5,9,-4,7
Panionios,8213,4,1,1,4,4,10,-6,4
AEK Athens,8214,1,4,2,0,7,1,6,14
PAOK Salonik,8214,2,2,3,1,9,4,5,9
P'thinaikos,8214,3,1,2,3,4,9,-5,5
Panionios,8214,4,1,1,4,4,10,-6,4
AEK Athens,8215,1,4,2,0,7,1,6,14
PAOK Salonik,8215,2,2,3,1,11,6,5,9
P'thinaikos,8215,3,1,2,3,6,11,-5,5
Panionios,8215,4,1,1,4,4,10,-6,4
AEK Athens,8216,1,4,2,0,7,1,6,14
PAOK Salonik,8216,2,2,2,2,9,5,4,8
P'thinaikos,8216,3,2,1,3,5,9,-4,7
Panionios,8216,4,1,1,4,4,10,-6,4
AEK Athens,8217,1,4,2,0,7,1,6,14
PAOK Salonik,8217,2,2,3,1,10,5,5,9
P'thinaikos,8217,3,1,2,3,5,10,-5,5
Panionios,8217,4,1,1,4,4,10,-6,4
AEK Athens,8218,1,4,2,0,7,1,6,14
PAOK Salonik,8218,2,3,2,1,11,4,7,11
Panionios,8218,3,1,1,4,4,10,-6,4
P'thinaikos,8218,4,1,1,4,4,11,-7,4
AEK Athens,8219,1,4,2,0,7,1,6,14
PAOK Salonik,8219,2,2,2,2,10,7,3,8
P'thinaikos,8219,3,2,1,3,7,10,-3,7
Panionios,8219,4,1,1,4,4,10,-6,4
AEK Athens,8220,1,4,2,0,7,1,6,14
PAOK Salonik,8220,2,2,2,2,10,6,4,8
P'thinaikos,8220,3,2,1,3,6,10,-4,7
Panionios,8220,4,1,1,4,4,10,-6,4
AEK Athens,8221,1,4,2,0,7,1,6,14
PAOK Salonik,8221,2,2,2,2,10,6,4,8
P'thinaikos,8221,3,2,1,3,6,10,-4,7
Panionios,8221,4,1,1,4,4,10,-6,4
AEK Athens,8222,1,4,2,0,7,1,6,14
PAOK Salonik,8222,2,2,2,2,9,5,4,8
P'thinaikos,8222,3,2,1,3,5,9,-4,7
Panionios,8222,4,1,1,4,4,10,-6,4
AEK Athens,8223,1,4,2,0,7,1,6,14
PAOK Salonik,8223,2,3,2,1,10,4,6,11
P'thinaikos,8223,3,1,1,4,4,10,-6,4
Panionios,8223,3,1,1,4,4,10,-6,4
AEK Athens,8224,1,4,2,0,7,1,6,14
PAOK Salonik,8224,2,2,2,2,9,8,1,8
P'thinaikos,8224,3,2,1,3,8,9,-1,7
Panionios,8224,4,1,1,4,4,10,-6,4
AEK Athens,8225,1,4,2,0,7,1,6,14
PAOK Salonik,8225,2,2,2,2,9,5,4,8
P'thinaikos,8225,3,2,1,3,5,9,-4,7
Panionios,8225,4,1,1,4,4,10,-6,4
AEK Athens,8226,1,4,2,0,7,1,6,14
PAOK Salonik,8226,2,2,3,1,11,6,5,9
P'thinaikos,8226,3,1,2,3,6,11,-5,5
Panionios,8226,4,1,1,4,4,10,-6,4
AEK Athens,8227,1,4,2,0,7,1,6,14
PAOK Salonik,8227,2,2,2,2,10,7,3,8
P'thinaikos,8227,3,2,1,3,7,10,-3,7
Panionios,8227,4,1,1,4,4,10,-6,4
AEK Athens,8228,1,4,2,0,7,1,6,14
PAOK Salonik,8228,2,2,2,2,9,7,2,8
P'thinaikos,8228,3,2,1,3,7,9,-2,7
Panionios,8228,4,1,1,4,4,10,-6,4
AEK Athens,8229,1,4,2,0,7,1,6,14
PAOK Salonik,8229,2,2,3,1,11,6,5,9
P'thinaikos,8229,3,1,2,3,6,11,-5,5
Panionios,8229,4,1,1,4,4,10,-6,4
AEK Athens,8230,1,4,2,0,7,1,6,14
PAOK Salonik,8230,2,3,2,1,11,4,7,11
Panionios,8230,3,1,1,4,4,10,-6,4
P'thinaikos,8230,4,1,1,4,4,11,-7,4
AEK Athens,8231,1,4,2,0,7,1,6,14
PAOK Salonik,8231,2,2,2,2,11,8,3,8
P'thinaikos,8231,3,2,1,3,8,11,-3,7
Panionios,8231,4,1,1,4,4,10,-6,4
AEK Athens,8232,1,4,2,0,7,1,6,14
PAOK Salonik,8232,2,2,2,2,9,5,4,8
P'thinaikos,8232,3,2,1,3,5,9,-4,7
Panionios,8232,4,1,1,4,4,10,-6,4
AEK Athens,8233,1,4,2,0,7,1,6,14
PAOK Salonik,8233,2,2,2,2,9,6,3,8
P'thinaikos,8233,3,2,1,3,6,9,-3,7
Panionios,8233,4,1,1,4,4,10,-6,4
AEK Athens,8234,1,4,2,0,7,1,6,14
PAOK Salonik,8234,2,3,2,1,11,5,6,11
P'thinaikos,8234,3,1,1,4,5,11,-6,4
Panionios,8234,4,1,1,4,4,10,-6,4
AEK Athens,8235,1,4,2,0,7,1,6,14
PAOK Salonik,8235,2,3,2,1,11,5,6,11
P'thinaikos,8235,3,1,1,4,5,11,-6,4
Panionios,8235,4,1,1,4,4,10,-6,4
AEK Athens,8236,1,4,2,0,7,1,6,14
PAOK Salonik,8236,2,3,2,1,11,5,6,11
P'thinaikos,8236,3,1,1,4,5,11,-6,4
Panionios,8236,4,1,1,4,4,10,-6,4
AEK Athens,8237,1,4,2,0,7,1,6,14
PAOK Salonik,8237,2,2,3,1,11,6,5,9
P'thinaikos,8237,3,1,2,3,6,11,-5,5
Panionios,8237,4,1,1,4,4,10,-6,4
AEK Athens,8238,1,4,2,0,7,1,6,14
PAOK Salonik,8238,2,2,2,2,10,8,2,8
P'thinaikos,8238,3,2,1,3,8,10,-2,7
Panionios,8238,4,1,1,4,4,10,-6,4
AEK Athens,8239,1,4,2,0,7,1,6,14
PAOK Salonik,8239,2,2,3,1,10,5,5,9
P'thinaikos,8239,3,1,2,3,5,10,-5,5
Panionios,8239,4,1,1,4,4,10,-6,4
AEK Athens,8240,1,4,2,0,7,1,6,14
PAOK Salonik,8240,2,3,2,1,10,4,6,11
P'thinaikos,8240,3,1,1,4,4,10,-6,4
Panionios,8240,3,1,1,4,4,10,-6,4
AEK Athens,8241,1,4,2,0,7,1,6,14
PAOK Salonik,8241,2,3,2,1,14,4,10,11
Panionios,8241,3,1,1,4,4,10,-6,4
P'thinaikos,8241,4,1,1,4,4,14,-10,4
AEK Athens,8242,1,4,2,0,7,1,6,14
PAOK Salonik,8242,2,3,2,1,10,4,6,11
P'thinaikos,8242,3,1,1,4,4,10,-6,4
Panionios,8242,3,1,1,4,4,10,-6,4
AEK Athens,8243,1,4,2,0,7,1,6,14
PAOK Salonik,8243,2,3,2,1,11,4,7,11
Panionios,8243,3,1,1,4,4,10,-6,4
P'thinaikos,8243,4,1,1,4,4,11,-7,4
AEK Athens,8244,1,4,2,0,7,1,6,14
PAOK Salonik,8244,2,3,2,1,12,4,8,11
Panionios,8244,3,1,1,4,4,10,-6,4
P'thinaikos,8244,4,1,1,4,4,12,-8,4
AEK Athens,8245,1,4,2,0,7,1,6,14
PAOK Salonik,8245,2,2,3,1,11,6,5,9
P'thinaikos,8245,3,1,2,3,6,11,-5,5
Panionios,8245,4,1,1,4,4,10,-6,4
AEK Athens,8246,1,4,2,0,7,1,6,14
PAOK Salonik,8246,2,2,3,1,9,4,5,9
P'thinaikos,8246,3,1,2,3,4,9,-5,5
Panionios,8246,4,1,1,4,4,10,-6,4
AEK Athens,8247,1,4,2,0,7,1,6,14
PAOK Salonik,8247,2,3,2,1,11,4,7,11
Panionios,8247,3,1,1,4,4,10,-6,4
P'thinaikos,8247,4,1,1,4,4,11,-7,4
AEK Athens,8248,1,4,2,0,7,1,6,14
PAOK Salonik,8248,2,3,2,1,11,5,6,11
P'thinaikos,8248,3,1,1,4,5,11,-6,4
Panionios,8248,4,1,1,4,4,10,-6,4
AEK Athens,8249,1,4,2,0,7,1,6,14
PAOK Salonik,8249,2,2,2,2,10,7,3,8
P'thinaikos,8249,3,2,1,3,7,10,-3,7
Panionios,8249,4,1,1,4,4,10,-6,4
AEK Athens,8250,1,4,2,0,7,1,6,14
PAOK Salonik,8250,2,2,3,1,9,4,5,9
P'thinaikos,8250,3,1,2,3,4,9,-5,5
Panionios,8250,4,1,1,4,4,10,-6,4
AEK Athens,8251,1,4,2,0,7,1,6,14
PAOK Salonik,8251,2,2,2,2,10,6,4,8
P'thinaikos,8251,3,2,1,3,6,10,-4,7
Panionios,8251,4,1,1,4,4,10,-6,4
AEK Athens,8252,1,4,2,0,7,1,6,14
PAOK Salonik,8252,2,2,3,1,9,4,5,9
P'thinaikos,8252,3,1,2,3,4,9,-5,5
Panionios,8252,4,1,1,4,4,10,-6,4
AEK Athens,8253,1,4,2,0,7,1,6,14
PAOK Salonik,8253,2,3,2,1,11,5,6,11
P'thinaikos,8253,3,1,1,4,5,11,-6,4
Panionios,8253,4,1,1,4,4,10,-6,4
AEK Athens,8254,1,4,2,0,7,1,6,14
PAOK Salonik,8254,2,2,3,1,10,5,5,9
P'thinaikos,8254,3,1,2,3,5,10,-5,5
Panionios,8254,4,1,1,4,4,10,-6,4
AEK Athens,8255,1,4,2,0,7,1,6,14
PAOK Salonik,8255,2,2,3,1,10,5,5,9
P'thinaikos,8255,3,1,2,3,5,10,-5,5
Panionios,8255,4,1,1,4,4,10,-6,4
AEK Athens,8256,1,4,2,0,7,1,6,14
PAOK Salonik,8256,2,2,2,2,9,9,0,8
P'thinaikos,8256,3,2,1,3,9,9,0,7
Panionios,8256,4,1,1,4,4,10,-6,4
AEK Athens,8257,1,4,2,0,7,1,6,14
PAOK Salonik,8257,2,2,3,1,10,5,5,9
P'thinaikos,8257,3,1,2,3,5,10,-5,5
Panionios,8257,4,1,1,4,4,10,-6,4
AEK Athens,8258,1,4,2,0,7,1,6,14
PAOK Salonik,8258,2,2,2,2,9,6,3,8
P'thinaikos,8258,3,2,1,3,6,9,-3,7
Panionios,8258,4,1,1,4,4,10,-6,4
AEK Athens,8259,1,4,2,0,7,1,6,14
PAOK Salonik,8259,2,3,2,1,10,4,6,11
P'thinaikos,8259,3,1,1,4,4,10,-6,4
Panionios,8259,3,1,1,4,4,10,-6,4
AEK Athens,8260,1,4,2,0,7,1,6,14
PAOK Salonik,8260,2,3,2,1,13,4,9,11
Panionios,8260,3,1,1,4,4,10,-6,4
P'thinaikos,8260,4,1,1,4,4,13,-9,4
AEK Athens,8261,1,4,2,0,7,1,6,14
PAOK Salonik,8261,2,3,2,1,10,4,6,11
P'thinaikos,8261,3,1,1,4,4,10,-6,4
Panionios,8261,3,1,1,4,4,10,-6,4
AEK Athens,8262,1,4,2,0,7,1,6,14
PAOK Salonik,8262,2,2,3,1,10,5,5,9
P'thinaikos,8262,3,1,2,3,5,10,-5,5
Panionios,8262,4,1,1,4,4,10,-6,4
AEK Athens,8263,1,4,2,0,7,1,6,14
PAOK Salonik,8263,2,2,3,1,10,5,5,9
P'thinaikos,8263,3,1,2,3,5,10,-5,5
Panionios,8263,4,1,1,4,4,10,-6,4
AEK Athens,8264,1,4,2,0,7,1,6,14
PAOK Salonik,8264,2,2,2,2,9,6,3,8
P'thinaikos,8264,3,2,1,3,6,9,-3,7
Panionios,8264,4,1,1,4,4,10,-6,4
AEK Athens,8265,1,4,2,0,7,1,6,14
PAOK Salonik,8265,2,3,2,1,11,4,7,11
Panionios,8265,3,1,1,4,4,10,-6,4
P'thinaikos,8265,4,1,1,4,4,11,-7,4
AEK Athens,8266,1,4,2,0,7,1,6,14
PAOK Salonik,8266,2,2,2,2,9,8,1,8
P'thinaikos,8266,3,2,1,3,8,9,-1,7
Panionios,8266,4,1,1,4,4,10,-6,4
AEK Athens,8267,1,4,2,0,7,1,6,14
PAOK Salonik,8267,2,3,2,1,12,6,6,11
P'thinaikos,8267,3,1,1,4,6,12,-6,4
Panionios,8267,4,1,1,4,4,10,-6,4
AEK Athens,8268,1,4,2,0,7,1,6,14
PAOK Salonik,8268,2,2,2,2,12,8,4,8
P'thinaikos,8268,3,2,1,3,8,12,-4,7
Panionios,8268,4,1,1,4,4,10,-6,4
AEK Athens,8269,1,4,2,0,7,1,6,14
PAOK Salonik,8269,2,2,3,1,10,5,5,9
P'thinaikos,8269,3,1,2,3,5,10,-5,5
Panionios,8269,4,1,1,4,4,10,-6,4
AEK Athens,8270,1,4,2,0,7,1,6,14
PAOK Salonik,8270,2,3,2,1,10,4,6,11
P'thinaikos,8270,3,1,1,4,4,10,-6,4
Panionios,8270,3,1,1,4,4,10,-6,4
AEK Athens,8271,1,4,2,0,7,1,6,14
PAOK Salonik,8271,2,2,2,2,10,7,3,8
P'thinaikos,8271,3,2,1,3,7,10,-3,7
Panionios,8271,4,1,1,4,4,10,-6,4
AEK Athens,8272,1,4,2,0,7,1,6,14
PAOK Salonik,8272,2,3,2,1,11,4,7,11
Panionios,8272,3,1,1,4,4,10,-6,4
P'thinaikos,8272,4,1,1,4,4,11,-7,4
AEK Athens,8273,1,4,2,0,7,1,6,14
PAOK Salonik,8273,2,3,2,1,10,4,6,11
P'thinaikos,8273,3,1,1,4,4,10,-6,4
Panionios,8273,3,1,1,4,4,10,-6,4
AEK Athens,8274,1,4,2,0,7,1,6,14
PAOK Salonik,8274,2,2,3,1,11,6,5,9
P'thinaikos,8274,3,1,2,3,6,11,-5,5
Panionios,8274,4,1,1,4,4,10,-6,4
AEK Athens,8275,1,4,2,0,7,1,6,14
PAOK Salonik,8275,2,3,2,1,11,5,6,11
P'thinaikos,8275,3,1,1,4,5,11,-6,4
Panionios,8275,4,1,1,4,4,10,-6,4
AEK Athens,8276,1,4,2,0,7,1,6,14
PAOK Salonik,8276,2,2,3,1,11,6,5,9
P'thinaikos,8276,3,1,2,3,6,11,-5,5
Panionios,8276,4,1,1,4,4,10,-6,4
AEK Athens,8277,1,4,2,0,7,1,6,14
PAOK Salonik,8277,2,2,2,2,9,5,4,8
P'thinaikos,8277,3,2,1,3,5,9,-4,7
Panionios,8277,4,1,1,4,4,10,-6,4
AEK Athens,8278,1,4,2,0,7,1,6,14
PAOK Salonik,8278,2,2,2,2,9,5,4,8
P'thinaikos,8278,3,2,1,3,5,9,-4,7
Panionios,8278,4,1,1,4,4,10,-6,4
AEK Athens,8279,1,4,2,0,7,1,6,14
PAOK Salonik,8279,2,2,2,2,11,9,2,8
P'thinaikos,8279,3,2,1,3,9,11,-2,7
Panionios,8279,4,1,1,4,4,10,-6,4
AEK Athens,8280,1,4,2,0,7,1,6,14
PAOK Salonik,8280,2,3,2,1,11,5,6,11
P'thinaikos,8280,3,1,1,4,5,11,-6,4
Panionios,8280,4,1,1,4,4,10,-6,4
AEK Athens,8281,1,4,2,0,7,1,6,14
PAOK Salonik,8281,2,2,2,2,9,5,4,8
P'thinaikos,8281,3,2,1,3,5,9,-4,7
Panionios,8281,4,1,1,4,4,10,-6,4
AEK Athens,8282,1,4,2,0,7,1,6,14
PAOK Salonik,8282,2,2,2,2,9,5,4,8
P'thinaikos,8282,3,2,1,3,5,9,-4,7
Panionios,8282,4,1,1,4,4,10,-6,4
AEK Athens,8283,1,4,2,0,7,1,6,14
PAOK Salonik,8283,2,2,3,1,10,5,5,9
P'thinaikos,8283,3,1,2,3,5,10,-5,5
Panionios,8283,4,1,1,4,4,10,-6,4
AEK Athens,8284,1,4,2,0,7,1,6,14
PAOK Salonik,8284,2,3,2,1,13,5,8,11
Panionios,8284,3,1,1,4,4,10,-6,4
P'thinaikos,8284,4,1,1,4,5,13,-8,4
AEK Athens,8285,1,4,2,0,7,1,6,14
PAOK Salonik,8285,2,3,2,1,10,4,6,11
P'thinaikos,8285,3,1,1,4,4,10,-6,4
Panionios,8285,3,1,1,4,4,10,-6,4
AEK Athens,8286,1,4,2,0,7,1,6,14
PAOK Salonik,8286,2,2,3,1,9,4,5,9
P'thinaikos,8286,3,1,2,3,4,9,-5,5
Panionios,8286,4,1,1,4,4,10,-6,4
AEK Athens,8287,1,4,2,0,7,1,6,14
PAOK Salonik,8287,2,2,3,1,10,5,5,9
P'thinaikos,8287,3,1,2,3,5,10,-5,5
Panionios,8287,4,1,1,4,4,10,-6,4
AEK Athens,8288,1,4,2,0,7,1,6,14
PAOK Salonik,8288,2,3,2,1,10,4,6,11
P'thinaikos,8288,3,1,1,4,4,10,-6,4
Panionios,8288,3,1,1,4,4,10,-6,4
AEK Athens,8289,1,4,2,0,7,1,6,14
PAOK Salonik,8289,2,2,3,1,10,5,5,9
P'thinaikos,8289,3,1,2,3,5,10,-5,5
Panionios,8289,4,1,1,4,4,10,-6,4
AEK Athens,8290,1,4,2,0,7,1,6,14
PAOK Salonik,8290,2,2,2,2,10,6,4,8
P'thinaikos,8290,3,2,1,3,6,10,-4,7
Panionios,8290,4,1,1,4,4,10,-6,4
AEK Athens,8291,1,4,2,0,7,1,6,14
PAOK Salonik,8291,2,2,2,2,10,6,4,8
P'thinaikos,8291,3,2,1,3,6,10,-4,7
Panionios,8291,4,1,1,4,4,10,-6,4
AEK Athens,8292,1,4,2,0,7,1,6,14
PAOK Salonik,8292,2,2,3,1,9,4,5,9
P'thinaikos,8292,3,1,2,3,4,9,-5,5
Panionios,8292,4,1,1,4,4,10,-6,4
AEK Athens,8293,1,4,2,0,7,1,6,14
PAOK Salonik,8293,2,3,2,1,11,4,7,11
Panionios,8293,3,1,1,4,4,10,-6,4
P'thinaikos,8293,4,1,1,4,4,11,-7,4
AEK Athens,8294,1,4,2,0,7,1,6,14
PAOK Salonik,8294,2,3,2,1,11,5,6,11
P'thinaikos,8294,3,1,1,4,5,11,-6,4
Panionios,8294,4,1,1,4,4,10,-6,4
AEK Athens,8295,1,4,2,0,7,1,6,14
PAOK Salonik,8295,2,2,3,1,12,7,5,9
P'thinaikos,8295,3,1,2,3,7,12,-5,5
Panionios,8295,4,1,1,4,4,10,-6,4
AEK Athens,8296,1,4,2,0,7,1,6,14
PAOK Salonik,8296,2,2,2,2,10,6,4,8
P'thinaikos,8296,3,2,1,3,6,10,-4,7
Panionios,8296,4,1,1,4,4,10,-6,4
AEK Athens,8297,1,4,2,0,7,1,6,14
PAOK Salonik,8297,2,2,3,1,10,5,5,9
P'thinaikos,8297,3,1,2,3,5,10,-5,5
Panionios,8297,4,1,1,4,4,10,-6,4
AEK Athens,8298,1,4,2,0,7,1,6,14
PAOK Salonik,8298,2,3,2,1,11,5,6,11
P'thinaikos,8298,3,1,1,4,5,11,-6,4
Panionios,8298,4,1,1,4,4,10,-6,4
AEK Athens,8299,1,4,2,0,7,1,6,14
PAOK Salonik,8299,2,2,2,2,11,7,4,8
P'thinaikos,8299,3,2,1,3,7,11,-4,7
Panionios,8299,4,1,1,4,4,10,-6,4
AEK Athens,8300,1,4,2,0,7,1,6,14
PAOK Salonik,8300,2,2,2,2,11,7,4,8
P'thinaikos,8300,3,2,1,3,7,11,-4,7
Panionios,8300,4,1,1,4,4,10,-6,4
AEK Athens,8301,1,4,2,0,7,1,6,14
PAOK Salonik,8301,2,3,2,1,12,6,6,11
P'thinaikos,8301,3,1,1,4,6,12,-6,4
Panionios,8301,4,1,1,4,4,10,-6,4
AEK Athens,8302,1,4,2,0,7,1,6,14
PAOK Salonik,8302,2,2,3,1,12,7,5,9
P'thinaikos,8302,3,1,2,3,7,12,-5,5
Panionios,8302,4,1,1,4,4,10,-6,4
AEK Athens,8303,1,4,2,0,7,1,6,14
PAOK Salonik,8303,2,3,2,1,13,4,9,11
Panionios,8303,3,1,1,4,4,10,-6,4
P'thinaikos,8303,4,1,1,4,4,13,-9,4
AEK Athens,8304,1,4,2,0,7,1,6,14
PAOK Salonik,8304,2,2,2,2,11,8,3,8
P'thinaikos,8304,3,2,1,3,8,11,-3,7
Panionios,8304,4,1,1,4,4,10,-6,4
AEK Athens,8305,1,4,2,0,7,1,6,14
PAOK Salonik,8305,2,3,2,1,10,4,6,11
P'thinaikos,8305,3,1,1,4,4,10,-6,4
Panionios,8305,3,1,1,4,4,10,-6,4
AEK Athens,8306,1,4,2,0,7,1,6,14
PAOK Salonik,8306,2,2,2,2,9,6,3,8
P'thinaikos,8306,3,2,1,3,6,9,-3,7
Panionios,8306,4,1,1,4,4,10,-6,4
AEK Athens,8307,1,4,2,0,7,1,6,14
PAOK Salonik,8307,2,2,2,2,9,7,2,8
P'thinaikos,8307,3,2,1,3,7,9,-2,7
Panionios,8307,4,1,1,4,4,10,-6,4
AEK Athens,8308,1,4,2,0,7,1,6,14
PAOK Salonik,8308,2,2,2,2,9,8,1,8
P'thinaikos,8308,3,2,1,3,8,9,-1,7
Panionios,8308,4,1,1,4,4,10,-6,4
AEK Athens,8309,1,4,2,0,7,1,6,14
PAOK Salonik,8309,2,3,2,1,12,5,7,11
Panionios,8309,3,1,1,4,4,10,-6,4
P'thinaikos,8309,4,1,1,4,5,12,-7,4
AEK Athens,8310,1,4,2,0,7,1,6,14
PAOK Salonik,8310,2,2,2,2,10,8,2,8
P'thinaikos,8310,3,2,1,3,8,10,-2,7
Panionios,8310,4,1,1,4,4,10,-6,4
AEK Athens,8311,1,4,2,0,7,1,6,14
PAOK Salonik,8311,2,2,3,1,11,6,5,9
P'thinaikos,8311,3,1,2,3,6,11,-5,5
Panionios,8311,4,1,1,4,4,10,-6,4
AEK Athens,8312,1,4,2,0,7,1,6,14
PAOK Salonik,8312,2,3,2,1,11,5,6,11
P'thinaikos,8312,3,1,1,4,5,11,-6,4
Panionios,8312,4,1,1,4,4,10,-6,4
AEK Athens,8313,1,4,2,0,7,1,6,14
PAOK Salonik,8313,2,2,3,1,9,4,5,9
P'thinaikos,8313,3,1,2,3,4,9,-5,5
Panionios,8313,4,1,1,4,4,10,-6,4
AEK Athens,8314,1,4,2,0,7,1,6,14
PAOK Salonik,8314,2,3,2,1,10,4,6,11
P'thinaikos,8314,3,1,1,4,4,10,-6,4
Panionios,8314,3,1,1,4,4,10,-6,4
AEK Athens,8315,1,4,2,0,7,1,6,14
PAOK Salonik,8315,2,2,2,2,10,10,0,8
P'thinaikos,8315,3,2,1,3,10,10,0,7
Panionios,8315,4,1,1,4,4,10,-6,4
AEK Athens,8316,1,4,2,0,7,1,6,14
PAOK Salonik,8316,2,3,2,1,11,5,6,11
P'thinaikos,8316,3,1,1,4,5,11,-6,4
Panionios,8316,4,1,1,4,4,10,-6,4
AEK Athens,8317,1,4,2,0,7,1,6,14
PAOK Salonik,8317,2,2,2,2,11,7,4,8
P'thinaikos,8317,3,2,1,3,7,11,-4,7
Panionios,8317,4,1,1,4,4,10,-6,4
AEK Athens,8318,1,4,2,0,7,1,6,14
PAOK Salonik,8318,2,2,3,1,11,6,5,9
P'thinaikos,8318,3,1,2,3,6,11,-5,5
Panionios,8318,4,1,1,4,4,10,-6,4
AEK Athens,8319,1,4,2,0,7,1,6,14
PAOK Salonik,8319,2,2,3,1,10,5,5,9
P'thinaikos,8319,3,1,2,3,5,10,-5,5
Panionios,8319,4,1,1,4,4,10,-6,4
AEK Athens,8320,1,4,2,0,7,1,6,14
PAOK Salonik,8320,2,2,2,2,9,6,3,8
P'thinaikos,8320,3,2,1,3,6,9,-3,7
Panionios,8320,4,1,1,4,4,10,-6,4
AEK Athens,8321,1,4,2,0,7,1,6,14
PAOK Salonik,8321,2,2,3,1,12,7,5,9
P'thinaikos,8321,3,1,2,3,7,12,-5,5
Panionios,8321,4,1,1,4,4,10,-6,4
AEK Athens,8322,1,4,2,0,7,1,6,14
PAOK Salonik,8322,2,3,2,1,11,4,7,11
Panionios,8322,3,1,1,4,4,10,-6,4
P'thinaikos,8322,4,1,1,4,4,11,-7,4
AEK Athens,8323,1,4,2,0,7,1,6,14
PAOK Salonik,8323,2,2,3,1,11,6,5,9
P'thinaikos,8323,3,1,2,3,6,11,-5,5
Panionios,8323,4,1,1,4,4,10,-6,4
AEK Athens,8324,1,4,2,0,7,1,6,14
PAOK Salonik,8324,2,3,2,1,13,5,8,11
Panionios,8324,3,1,1,4,4,10,-6,4
P'thinaikos,8324,4,1,1,4,5,13,-8,4
AEK Athens,8325,1,4,2,0,7,1,6,14
PAOK Salonik,8325,2,3,2,1,10,4,6,11
P'thinaikos,8325,3,1,1,4,4,10,-6,4
Panionios,8325,3,1,1,4,4,10,-6,4
AEK Athens,8326,1,4,2,0,7,1,6,14
PAOK Salonik,8326,2,3,2,1,12,5,7,11
Panionios,8326,3,1,1,4,4,10,-6,4
P'thinaikos,8326,4,1,1,4,5,12,-7,4
AEK Athens,8327,1,4,2,0,7,1,6,14
PAOK Salonik,8327,2,3,2,1,10,4,6,11
P'thinaikos,8327,3,1,1,4,4,10,-6,4
Panionios,8327,3,1,1,4,4,10,-6,4
AEK Athens,8328,1,4,2,0,7,1,6,14
PAOK Salonik,8328,2,2,3,1,10,5,5,9
P'thinaikos,8328,3,1,2,3,5,10,-5,5
Panionios,8328,4,1,1,4,4,10,-6,4
AEK Athens,8329,1,4,2,0,7,1,6,14
PAOK Salonik,8329,2,2,2,2,9,5,4,8
P'thinaikos,8329,3,2,1,3,5,9,-4,7
Panionios,8329,4,1,1,4,4,10,-6,4
AEK Athens,8330,1,4,2,0,7,1,6,14
PAOK Salonik,8330,2,2,2,2,9,7,2,8
P'thinaikos,8330,3,2,1,3,7,9,-2,7
Panionios,8330,4,1,1,4,4,10,-6,4
AEK Athens,8331,1,4,2,0,7,1,6,14
PAOK Salonik,8331,2,3,2,1,10,4,6,11
P'thinaikos,8331,3,1,1,4,4,10,-6,4
Panionios,8331,3,1,1,4,4,10,-6,4
AEK Athens,8332,1,4,2,0,7,1,6,14
PAOK Salonik,8332,2,3,2,1,11,4,7,11
Panionios,8332,3,1,1,4,4,10,-6,4
P'thinaikos,8332,4,1,1,4,4,11,-7,4
AEK Athens,8333,1,4,2,0,7,1,6,14
PAOK Salonik,8333,2,3,2,1,11,5,6,11
P'thinaikos,8333,3,1,1,4,5,11,-6,4
Panionios,8333,4,1,1,4,4,10,-6,4
AEK Athens,8334,1,4,2,0,7,1,6,14
PAOK Salonik,8334,2,3,2,1,12,5,7,11
Panionios,8334,3,1,1,4,4,10,-6,4
P'thinaikos,8334,4,1,1,4,5,12,-7,4
AEK Athens,8335,1,4,2,0,7,1,6,14
PAOK Salonik,8335,2,2,2,2,9,6,3,8
P'thinaikos,8335,3,2,1,3,6,9,-3,7
Panionios,8335,4,1,1,4,4,10,-6,4
AEK Athens,8336,1,4,2,0,7,1,6,14
PAOK Salonik,8336,2,2,2,2,10,7,3,8
P'thinaikos,8336,3,2,1,3,7,10,-3,7
Panionios,8336,4,1,1,4,4,10,-6,4
AEK Athens,8337,1,4,2,0,7,1,6,14
PAOK Salonik,8337,2,2,3,1,10,5,5,9
P'thinaikos,8337,3,1,2,3,5,10,-5,5
Panionios,8337,4,1,1,4,4,10,-6,4
AEK Athens,8338,1,4,2,0,7,1,6,14
PAOK Salonik,8338,2,2,3,1,10,5,5,9
P'thinaikos,8338,3,1,2,3,5,10,-5,5
Panionios,8338,4,1,1,4,4,10,-6,4
AEK Athens,8339,1,4,2,0,7,1,6,14
PAOK Salonik,8339,2,3,2,1,11,5,6,11
P'thinaikos,8339,3,1,1,4,5,11,-6,4
Panionios,8339,4,1,1,4,4,10,-6,4
AEK Athens,8340,1,4,2,0,7,1,6,14
PAOK Salonik,8340,2,2,3,1,9,4,5,9
P'thinaikos,8340,3,1,2,3,4,9,-5,5
Panionios,8340,4,1,1,4,4,10,-6,4
AEK Athens,8341,1,4,2,0,7,1,6,14
PAOK Salonik,8341,2,3,2,1,12,5,7,11
Panionios,8341,3,1,1,4,4,10,-6,4
P'thinaikos,8341,4,1,1,4,5,12,-7,4
AEK Athens,8342,1,4,2,0,7,1,6,14
PAOK Salonik,8342,2,2,2,2,9,6,3,8
P'thinaikos,8342,3,2,1,3,6,9,-3,7
Panionios,8342,4,1,1,4,4,10,-6,4
AEK Athens,8343,1,4,2,0,7,1,6,14
PAOK Salonik,8343,2,3,2,1,11,4,7,11
Panionios,8343,3,1,1,4,4,10,-6,4
P'thinaikos,8343,4,1,1,4,4,11,-7,4
AEK Athens,8344,1,4,2,0,7,1,6,14
PAOK Salonik,8344,2,2,3,1,9,4,5,9
P'thinaikos,8344,3,1,2,3,4,9,-5,5
Panionios,8344,4,1,1,4,4,10,-6,4
AEK Athens,8345,1,4,2,0,7,1,6,14
PAOK Salonik,8345,2,2,2,2,10,6,4,8
P'thinaikos,8345,3,2,1,3,6,10,-4,7
Panionios,8345,4,1,1,4,4,10,-6,4
AEK Athens,8346,1,4,2,0,7,1,6,14
PAOK Salonik,8346,2,3,2,1,11,5,6,11
P'thinaikos,8346,3,1,1,4,5,11,-6,4
Panionios,8346,4,1,1,4,4,10,-6,4
AEK Athens,8347,1,4,2,0,7,1,6,14
PAOK Salonik,8347,2,3,2,1,12,4,8,11
Panionios,8347,3,1,1,4,4,10,-6,4
P'thinaikos,8347,4,1,1,4,4,12,-8,4
AEK Athens,8348,1,4,2,0,7,1,6,14
PAOK Salonik,8348,2,2,3,1,10,5,5,9
P'thinaikos,8348,3,1,2,3,5,10,-5,5
Panionios,8348,4,1,1,4,4,10,-6,4
AEK Athens,8349,1,4,2,0,7,1,6,14
PAOK Salonik,8349,2,2,3,1,11,6,5,9
P'thinaikos,8349,3,1,2,3,6,11,-5,5
Panionios,8349,4,1,1,4,4,10,-6,4
AEK Athens,8350,1,4,2,0,7,1,6,14
PAOK Salonik,8350,2,2,2,2,11,10,1,8
P'thinaikos,8350,3,2,1,3,10,11,-1,7
Panionios,8350,4,1,1,4,4,10,-6,4
AEK Athens,8351,1,4,2,0,7,1,6,14
PAOK Salonik,8351,2,3,2,1,11,5,6,11
P'thinaikos,8351,3,1,1,4,5,11,-6,4
Panionios,8351,4,1,1,4,4,10,-6,4
AEK Athens,8352,1,4,2,0,7,1,6,14
PAOK Salonik,8352,2,2,3,1,11,6,5,9
P'thinaikos,8352,3,1,2,3,6,11,-5,5
Panionios,8352,4,1,1,4,4,10,-6,4
AEK Athens,8353,1,4,2,0,7,1,6,14
PAOK Salonik,8353,2,2,3,1,10,5,5,9
P'thinaikos,8353,3,1,2,3,5,10,-5,5
Panionios,8353,4,1,1,4,4,10,-6,4
AEK Athens,8354,1,4,2,0,7,1,6,14
PAOK Salonik,8354,2,2,3,1,11,6,5,9
P'thinaikos,8354,3,1,2,3,6,11,-5,5
Panionios,8354,4,1,1,4,4,10,-6,4
AEK Athens,8355,1,4,2,0,7,1,6,14
PAOK Salonik,8355,2,3,2,1,10,4,6,11
P'thinaikos,8355,3,1,1,4,4,10,-6,4
Panionios,8355,3,1,1,4,4,10,-6,4
AEK Athens,8356,1,4,2,0,7,1,6,14
PAOK Salonik,8356,2,3,2,1,11,5,6,11
P'thinaikos,8356,3,1,1,4,5,11,-6,4
Panionios,8356,4,1,1,4,4,10,-6,4
AEK Athens,8357,1,4,2,0,7,1,6,14
PAOK Salonik,8357,2,2,3,1,10,5,5,9
P'thinaikos,8357,3,1,2,3,5,10,-5,5
Panionios,8357,4,1,1,4,4,10,-6,4
AEK Athens,8358,1,4,2,0,7,1,6,14
PAOK Salonik,8358,2,2,3,1,10,5,5,9
P'thinaikos,8358,3,1,2,3,5,10,-5,5
Panionios,8358,4,1,1,4,4,10,-6,4
AEK Athens,8359,1,4,2,0,7,1,6,14
PAOK Salonik,8359,2,3,2,1,12,5,7,11
Panionios,8359,3,1,1,4,4,10,-6,4
P'thinaikos,8359,4,1,1,4,5,12,-7,4
AEK Athens,8360,1,4,2,0,7,1,6,14
PAOK Salonik,8360,2,2,2,2,9,6,3,8
P'thinaikos,8360,3,2,1,3,6,9,-3,7
Panionios,8360,4,1,1,4,4,10,-6,4
AEK Athens,8361,1,4,2,0,7,1,6,14
PAOK Salonik,8361,2,3,2,1,10,4,6,11
P'thinaikos,8361,3,1,1,4,4,10,-6,4
Panionios,8361,3,1,1,4,4,10,-6,4
AEK Athens,8362,1,4,2,0,7,1,6,14
PAOK Salonik,8362,2,3,2,1,10,4,6,11
P'thinaikos,8362,3,1,1,4,4,10,-6,4
Panionios,8362,3,1,1,4,4,10,-6,4
AEK Athens,8363,1,4,2,0,7,1,6,14
PAOK Salonik,8363,2,2,2,2,10,7,3,8
P'thinaikos,8363,3,2,1,3,7,10,-3,7
Panionios,8363,4,1,1,4,4,10,-6,4
AEK Athens,8364,1,4,2,0,7,1,6,14
PAOK Salonik,8364,2,2,3,1,9,4,5,9
P'thinaikos,8364,3,1,2,3,4,9,-5,5
Panionios,8364,4,1,1,4,4,10,-6,4
AEK Athens,8365,1,4,2,0,7,1,6,14
PAOK Salonik,8365,2,3,2,1,10,4,6,11
P'thinaikos,8365,3,1,1,4,4,10,-6,4
Panionios,8365,3,1,1,4,4,10,-6,4
AEK Athens,8366,1,4,2,0,7,1,6,14
PAOK Salonik,8366,2,3,2,1,10,4,6,11
P'thinaikos,8366,3,1,1,4,4,10,-6,4
Panionios,8366,3,1,1,4,4,10,-6,4
AEK Athens,8367,1,4,2,0,7,1,6,14
PAOK Salonik,8367,2,2,2,2,9,6,3,8
P'thinaikos,8367,3,2,1,3,6,9,-3,7
Panionios,8367,4,1,1,4,4,10,-6,4
AEK Athens,8368,1,4,2,0,7,1,6,14
PAOK Salonik,8368,2,3,2,1,14,4,10,11
Panionios,8368,3,1,1,4,4,10,-6,4
P'thinaikos,8368,4,1,1,4,4,14,-10,4
AEK Athens,8369,1,4,2,0,7,1,6,14
PAOK Salonik,8369,2,3,2,1,12,5,7,11
Panionios,8369,3,1,1,4,4,10,-6,4
P'thinaikos,8369,4,1,1,4,5,12,-7,4
AEK Athens,8370,1,4,2,0,7,1,6,14
PAOK Salonik,8370,2,2,3,1,9,4,5,9
P'thinaikos,8370,3,1,2,3,4,9,-5,5
Panionios,8370,4,1,1,4,4,10,-6,4
AEK Athens,8371,1,4,2,0,7,1,6,14
PAOK Salonik,8371,2,2,2,2,9,6,3,8
P'thinaikos,8371,3,2,1,3,6,9,-3,7
Panionios,8371,4,1,1,4,4,10,-6,4
AEK Athens,8372,1,4,2,0,7,1,6,14
PAOK Salonik,8372,2,3,2,1,10,4,6,11
P'thinaikos,8372,3,1,1,4,4,10,-6,4
Panionios,8372,3,1,1,4,4,10,-6,4
AEK Athens,8373,1,4,2,0,7,1,6,14
PAOK Salonik,8373,2,3,2,1,13,4,9,11
Panionios,8373,3,1,1,4,4,10,-6,4
P'thinaikos,8373,4,1,1,4,4,13,-9,4
AEK Athens,8374,1,4,2,0,7,1,6,14
PAOK Salonik,8374,2,3,2,1,12,5,7,11
Panionios,8374,3,1,1,4,4,10,-6,4
P'thinaikos,8374,4,1,1,4,5,12,-7,4
AEK Athens,8375,1,4,2,0,7,1,6,14
PAOK Salonik,8375,2,2,3,1,10,5,5,9
P'thinaikos,8375,3,1,2,3,5,10,-5,5
Panionios,8375,4,1,1,4,4,10,-6,4
AEK Athens,8376,1,4,2,0,7,1,6,14
PAOK Salonik,8376,2,2,2,2,9,5,4,8
P'thinaikos,8376,3,2,1,3,5,9,-4,7
Panionios,8376,4,1,1,4,4,10,-6,4
AEK Athens,8377,1,4,2,0,7,1,6,14
PAOK Salonik,8377,2,3,2,1,11,5,6,11
P'thinaikos,8377,3,1,1,4,5,11,-6,4
Panionios,8377,4,1,1,4,4,10,-6,4
AEK Athens,8378,1,4,2,0,7,1,6,14
PAOK Salonik,8378,2,2,2,2,9,7,2,8
P'thinaikos,8378,3,2,1,3,7,9,-2,7
Panionios,8378,4,1,1,4,4,10,-6,4
AEK Athens,8379,1,4,2,0,7,1,6,14
PAOK Salonik,8379,2,3,2,1,12,5,7,11
Panionios,8379,3,1,1,4,4,10,-6,4
P'thinaikos,8379,4,1,1,4,5,12,-7,4
AEK Athens,8380,1,4,2,0,7,1,6,14
PAOK Salonik,8380,2,3,2,1,12,4,8,11
Panionios,8380,3,1,1,4,4,10,-6,4
P'thinaikos,8380,4,1,1,4,4,12,-8,4
AEK Athens,8381,1,4,2,0,7,1,6,14
PAOK Salonik,8381,2,3,2,1,10,4,6,11
P'thinaikos,8381,3,1,1,4,4,10,-6,4
Panionios,8381,3,1,1,4,4,10,-6,4
AEK Athens,8382,1,4,2,0,7,1,6,14
PAOK Salonik,8382,2,2,3,1,10,5,5,9
P'thinaikos,8382,3,1,2,3,5,10,-5,5
Panionios,8382,4,1,1,4,4,10,-6,4
AEK Athens,8383,1,4,2,0,7,1,6,14
PAOK Salonik,8383,2,2,2,2,11,8,3,8
P'thinaikos,8383,3,2,1,3,8,11,-3,7
Panionios,8383,4,1,1,4,4,10,-6,4
AEK Athens,8384,1,4,2,0,7,1,6,14
PAOK Salonik,8384,2,2,2,2,9,8,1,8
P'thinaikos,8384,3,2,1,3,8,9,-1,7
Panionios,8384,4,1,1,4,4,10,-6,4
AEK Athens,8385,1,4,2,0,7,1,6,14
PAOK Salonik,8385,2,3,2,1,10,4,6,11
P'thinaikos,8385,3,1,1,4,4,10,-6,4
Panionios,8385,3,1,1,4,4,10,-6,4
AEK Athens,8386,1,4,2,0,7,1,6,14
PAOK Salonik,8386,2,2,3,1,9,4,5,9
P'thinaikos,8386,3,1,2,3,4,9,-5,5
Panionios,8386,4,1,1,4,4,10,-6,4
AEK Athens,8387,1,4,2,0,7,1,6,14
PAOK Salonik,8387,2,2,3,1,10,5,5,9
P'thinaikos,8387,3,1,2,3,5,10,-5,5
Panionios,8387,4,1,1,4,4,10,-6,4
AEK Athens,8388,1,4,2,0,7,1,6,14
PAOK Salonik,8388,2,2,3,1,9,4,5,9
P'thinaikos,8388,3,1,2,3,4,9,-5,5
Panionios,8388,4,1,1,4,4,10,-6,4
AEK Athens,8389,1,4,2,0,7,1,6,14
PAOK Salonik,8389,2,2,3,1,11,6,5,9
P'thinaikos,8389,3,1,2,3,6,11,-5,5
Panionios,8389,4,1,1,4,4,10,-6,4
AEK Athens,8390,1,4,2,0,7,1,6,14
PAOK Salonik,8390,2,3,2,1,11,5,6,11
P'thinaikos,8390,3,1,1,4,5,11,-6,4
Panionios,8390,4,1,1,4,4,10,-6,4
AEK Athens,8391,1,4,2,0,7,1,6,14
PAOK Salonik,8391,2,2,2,2,10,7,3,8
P'thinaikos,8391,3,2,1,3,7,10,-3,7
Panionios,8391,4,1,1,4,4,10,-6,4
AEK Athens,8392,1,4,2,0,7,1,6,14
PAOK Salonik,8392,2,3,2,1,12,4,8,11
Panionios,8392,3,1,1,4,4,10,-6,4
P'thinaikos,8392,4,1,1,4,4,12,-8,4
AEK Athens,8393,1,4,2,0,7,1,6,14
PAOK Salonik,8393,2,3,2,1,10,4,6,11
P'thinaikos,8393,3,1,1,4,4,10,-6,4
Panionios,8393,3,1,1,4,4,10,-6,4
AEK Athens,8394,1,4,2,0,7,1,6,14
PAOK Salonik,8394,2,3,2,1,10,4,6,11
P'thinaikos,8394,3,1,1,4,4,10,-6,4
Panionios,8394,3,1,1,4,4,10,-6,4
AEK Athens,8395,1,4,2,0,7,1,6,14
PAOK Salonik,8395,2,2,3,1,9,4,5,9
P'thinaikos,8395,3,1,2,3,4,9,-5,5
Panionios,8395,4,1,1,4,4,10,-6,4
AEK Athens,8396,1,4,2,0,7,1,6,14
PAOK Salonik,8396,2,3,2,1,12,4,8,11
Panionios,8396,3,1,1,4,4,10,-6,4
P'thinaikos,8396,4,1,1,4,4,12,-8,4
AEK Athens,8397,1,4,2,0,7,1,6,14
PAOK Salonik,8397,2,2,3,1,10,5,5,9
P'thinaikos,8397,3,1,2,3,5,10,-5,5
Panionios,8397,4,1,1,4,4,10,-6,4
AEK Athens,8398,1,4,2,0,7,1,6,14
PAOK Salonik,8398,2,2,2,2,9,5,4,8
P'thinaikos,8398,3,2,1,3,5,9,-4,7
Panionios,8398,4,1,1,4,4,10,-6,4
AEK Athens,8399,1,4,2,0,7,1,6,14
PAOK Salonik,8399,2,3,2,1,10,4,6,11
P'thinaikos,8399,3,1,1,4,4,10,-6,4
Panionios,8399,3,1,1,4,4,10,-6,4
AEK Athens,8400,1,4,2,0,7,1,6,14
PAOK Salonik,8400,2,2,2,2,10,6,4,8
P'thinaikos,8400,3,2,1,3,6,10,-4,7
Panionios,8400,4,1,1,4,4,10,-6,4
AEK Athens,8401,1,4,2,0,7,1,6,14
PAOK Salonik,8401,2,3,2,1,11,5,6,11
P'thinaikos,8401,3,1,1,4,5,11,-6,4
Panionios,8401,4,1,1,4,4,10,-6,4
AEK Athens,8402,1,4,2,0,7,1,6,14
PAOK Salonik,8402,2,2,3,1,9,4,5,9
P'thinaikos,8402,3,1,2,3,4,9,-5,5
Panionios,8402,4,1,1,4,4,10,-6,4
AEK Athens,8403,1,4,2,0,7,1,6,14
PAOK Salonik,8403,2,2,3,1,10,5,5,9
P'thinaikos,8403,3,1,2,3,5,10,-5,5
Panionios,8403,4,1,1,4,4,10,-6,4
AEK Athens,8404,1,4,2,0,7,1,6,14
PAOK Salonik,8404,2,2,2,2,10,6,4,8
P'thinaikos,8404,3,2,1,3,6,10,-4,7
Panionios,8404,4,1,1,4,4,10,-6,4
AEK Athens,8405,1,4,2,0,7,1,6,14
PAOK Salonik,8405,2,2,2,2,10,6,4,8
P'thinaikos,8405,3,2,1,3,6,10,-4,7
Panionios,8405,4,1,1,4,4,10,-6,4
AEK Athens,8406,1,4,2,0,7,1,6,14
PAOK Salonik,8406,2,2,2,2,9,6,3,8
P'thinaikos,8406,3,2,1,3,6,9,-3,7
Panionios,8406,4,1,1,4,4,10,-6,4
AEK Athens,8407,1,4,2,0,7,1,6,14
PAOK Salonik,8407,2,2,3,1,10,5,5,9
P'thinaikos,8407,3,1,2,3,5,10,-5,5
Panionios,8407,4,1,1,4,4,10,-6,4
AEK Athens,8408,1,4,2,0,7,1,6,14
PAOK Salonik,8408,2,2,3,1,9,4,5,9
P'thinaikos,8408,3,1,2,3,4,9,-5,5
Panionios,8408,4,1,1,4,4,10,-6,4
AEK Athens,8409,1,4,2,0,7,1,6,14
PAOK Salonik,8409,2,3,2,1,11,4,7,11
Panionios,8409,3,1,1,4,4,10,-6,4
P'thinaikos,8409,4,1,1,4,4,11,-7,4
AEK Athens,8410,1,4,2,0,7,1,6,14
PAOK Salonik,8410,2,3,2,1,10,4,6,11
P'thinaikos,8410,3,1,1,4,4,10,-6,4
Panionios,8410,3,1,1,4,4,10,-6,4
AEK Athens,8411,1,4,2,0,7,1,6,14
PAOK Salonik,8411,2,2,2,2,9,5,4,8
P'thinaikos,8411,3,2,1,3,5,9,-4,7
Panionios,8411,4,1,1,4,4,10,-6,4
AEK Athens,8412,1,4,2,0,7,1,6,14
PAOK Salonik,8412,2,2,3,1,10,5,5,9
P'thinaikos,8412,3,1,2,3,5,10,-5,5
Panionios,8412,4,1,1,4,4,10,-6,4
AEK Athens,8413,1,4,2,0,7,1,6,14
PAOK Salonik,8413,2,2,2,2,9,5,4,8
P'thinaikos,8413,3,2,1,3,5,9,-4,7
Panionios,8413,4,1,1,4,4,10,-6,4
AEK Athens,8414,1,4,2,0,7,1,6,14
PAOK Salonik,8414,2,2,2,2,9,9,0,8
P'thinaikos,8414,3,2,1,3,9,9,0,7
Panionios,8414,4,1,1,4,4,10,-6,4
AEK Athens,8415,1,4,2,0,7,1,6,14
PAOK Salonik,8415,2,2,2,2,9,5,4,8
P'thinaikos,8415,3,2,1,3,5,9,-4,7
Panionios,8415,4,1,1,4,4,10,-6,4
AEK Athens,8416,1,4,2,0,7,1,6,14
PAOK Salonik,8416,2,2,3,1,10,5,5,9
P'thinaikos,8416,3,1,2,3,5,10,-5,5
Panionios,8416,4,1,1,4,4,10,-6,4
AEK Athens,8417,1,4,2,0,7,1,6,14
PAOK Salonik,8417,2,2,2,2,10,7,3,8
P'thinaikos,8417,3,2,1,3,7,10,-3,7
Panionios,8417,4,1,1,4,4,10,-6,4
AEK Athens,8418,1,4,2,0,7,1,6,14
PAOK Salonik,8418,2,2,3,1,9,4,5,9
P'thinaikos,8418,3,1,2,3,4,9,-5,5
Panionios,8418,4,1,1,4,4,10,-6,4
AEK Athens,8419,1,4,2,0,7,1,6,14
PAOK Salonik,8419,2,3,2,1,11,4,7,11
Panionios,8419,3,1,1,4,4,10,-6,4
P'thinaikos,8419,4,1,1,4,4,11,-7,4
AEK Athens,8420,1,4,2,0,7,1,6,14
PAOK Salonik,8420,2,2,3,1,11,6,5,9
P'thinaikos,8420,3,1,2,3,6,11,-5,5
Panionios,8420,4,1,1,4,4,10,-6,4
AEK Athens,8421,1,4,2,0,7,1,6,14
PAOK Salonik,8421,2,2,3,1,9,4,5,9
P'thinaikos,8421,3,1,2,3,4,9,-5,5
Panionios,8421,4,1,1,4,4,10,-6,4
AEK Athens,8422,1,4,2,0,7,1,6,14
PAOK Salonik,8422,2,2,3,1,10,5,5,9
P'thinaikos,8422,3,1,2,3,5,10,-5,5
Panionios,8422,4,1,1,4,4,10,-6,4
AEK Athens,8423,1,4,2,0,7,1,6,14
PAOK Salonik,8423,2,3,2,1,11,4,7,11
Panionios,8423,3,1,1,4,4,10,-6,4
P'thinaikos,8423,4,1,1,4,4,11,-7,4
AEK Athens,8424,1,4,2,0,7,1,6,14
PAOK Salonik,8424,2,2,3,1,10,5,5,9
P'thinaikos,8424,3,1,2,3,5,10,-5,5
Panionios,8424,4,1,1,4,4,10,-6,4
AEK Athens,8425,1,4,2,0,7,1,6,14
PAOK Salonik,8425,2,2,2,2,10,7,3,8
P'thinaikos,8425,3,2,1,3,7,10,-3,7
Panionios,8425,4,1,1,4,4,10,-6,4
AEK Athens,8426,1,4,2,0,7,1,6,14
PAOK Salonik,8426,2,3,2,1,11,5,6,11
P'thinaikos,8426,3,1,1,4,5,11,-6,4
Panionios,8426,4,1,1,4,4,10,-6,4
AEK Athens,8427,1,4,2,0,7,1,6,14
PAOK Salonik,8427,2,3,2,1,10,4,6,11
P'thinaikos,8427,3,1,1,4,4,10,-6,4
Panionios,8427,3,1,1,4,4,10,-6,4
AEK Athens,8428,1,4,2,0,7,1,6,14
PAOK Salonik,8428,2,2,3,1,9,4,5,9
P'thinaikos,8428,3,1,2,3,4,9,-5,5
Panionios,8428,4,1,1,4,4,10,-6,4
AEK Athens,8429,1,4,2,0,7,1,6,14
PAOK Salonik,8429,2,2,3,1,11,6,5,9
P'thinaikos,8429,3,1,2,3,6,11,-5,5
Panionios,8429,4,1,1,4,4,10,-6,4
AEK Athens,8430,1,4,2,0,7,1,6,14
PAOK Salonik,8430,2,2,2,2,10,6,4,8
P'thinaikos,8430,3,2,1,3,6,10,-4,7
Panionios,8430,4,1,1,4,4,10,-6,4
AEK Athens,8431,1,4,2,0,7,1,6,14
PAOK Salonik,8431,2,3,2,1,10,4,6,11
P'thinaikos,8431,3,1,1,4,4,10,-6,4
Panionios,8431,3,1,1,4,4,10,-6,4
AEK Athens,8432,1,4,2,0,7,1,6,14
PAOK Salonik,8432,2,3,2,1,12,5,7,11
Panionios,8432,3,1,1,4,4,10,-6,4
P'thinaikos,8432,4,1,1,4,5,12,-7,4
AEK Athens,8433,1,4,2,0,7,1,6,14
PAOK Salonik,8433,2,2,2,2,11,7,4,8
P'thinaikos,8433,3,2,1,3,7,11,-4,7
Panionios,8433,4,1,1,4,4,10,-6,4
AEK Athens,8434,1,4,2,0,7,1,6,14
PAOK Salonik,8434,2,2,2,2,10,7,3,8
P'thinaikos,8434,3,2,1,3,7,10,-3,7
Panionios,8434,4,1,1,4,4,10,-6,4
AEK Athens,8435,1,4,2,0,7,1,6,14
PAOK Salonik,8435,2,3,2,1,10,4,6,11
P'thinaikos,8435,3,1,1,4,4,10,-6,4
Panionios,8435,3,1,1,4,4,10,-6,4
AEK Athens,8436,1,4,2,0,7,1,6,14
PAOK Salonik,8436,2,2,2,2,10,6,4,8
P'thinaikos,8436,3,2,1,3,6,10,-4,7
Panionios,8436,4,1,1,4,4,10,-6,4
AEK Athens,8437,1,4,2,0,7,1,6,14
PAOK Salonik,8437,2,2,3,1,10,5,5,9
P'thinaikos,8437,3,1,2,3,5,10,-5,5
Panionios,8437,4,1,1,4,4,10,-6,4
AEK Athens,8438,1,4,2,0,7,1,6,14
PAOK Salonik,8438,2,2,2,2,9,5,4,8
P'thinaikos,8438,3,2,1,3,5,9,-4,7
Panionios,8438,4,1,1,4,4,10,-6,4
AEK Athens,8439,1,4,2,0,7,1,6,14
PAOK Salonik,8439,2,2,3,1,9,4,5,9
P'thinaikos,8439,3,1,2,3,4,9,-5,5
Panionios,8439,4,1,1,4,4,10,-6,4
AEK Athens,8440,1,4,2,0,7,1,6,14
PAOK Salonik,8440,2,3,2,1,11,5,6,11
P'thinaikos,8440,3,1,1,4,5,11,-6,4
Panionios,8440,4,1,1,4,4,10,-6,4
AEK Athens,8441,1,4,2,0,7,1,6,14
PAOK Salonik,8441,2,3,2,1,11,4,7,11
Panionios,8441,3,1,1,4,4,10,-6,4
P'thinaikos,8441,4,1,1,4,4,11,-7,4
AEK Athens,8442,1,4,2,0,7,1,6,14
PAOK Salonik,8442,2,3,2,1,10,4,6,11
P'thinaikos,8442,3,1,1,4,4,10,-6,4
Panionios,8442,3,1,1,4,4,10,-6,4
AEK Athens,8443,1,4,2,0,7,1,6,14
PAOK Salonik,8443,2,2,2,2,11,8,3,8
P'thinaikos,8443,3,2,1,3,8,11,-3,7
Panionios,8443,4,1,1,4,4,10,-6,4
AEK Athens,8444,1,4,2,0,7,1,6,14
PAOK Salonik,8444,2,3,2,1,12,5,7,11
Panionios,8444,3,1,1,4,4,10,-6,4
P'thinaikos,8444,4,1,1,4,5,12,-7,4
AEK Athens,8445,1,4,2,0,7,1,6,14
PAOK Salonik,8445,2,3,2,1,11,5,6,11
P'thinaikos,8445,3,1,1,4,5,11,-6,4
Panionios,8445,4,1,1,4,4,10,-6,4
AEK Athens,8446,1,4,2,0,7,1,6,14
PAOK Salonik,8446,2,3,2,1,12,5,7,11
Panionios,8446,3,1,1,4,4,10,-6,4
P'thinaikos,8446,4,1,1,4,5,12,-7,4
AEK Athens,8447,1,4,2,0,7,1,6,14
PAOK Salonik,8447,2,2,2,2,9,5,4,8
P'thinaikos,8447,3,2,1,3,5,9,-4,7
Panionios,8447,4,1,1,4,4,10,-6,4
AEK Athens,8448,1,4,2,0,7,1,6,14
PAOK Salonik,8448,2,2,3,1,9,4,5,9
P'thinaikos,8448,3,1,2,3,4,9,-5,5
Panionios,8448,4,1,1,4,4,10,-6,4
AEK Athens,8449,1,4,2,0,7,1,6,14
PAOK Salonik,8449,2,2,3,1,9,4,5,9
P'thinaikos,8449,3,1,2,3,4,9,-5,5
Panionios,8449,4,1,1,4,4,10,-6,4
AEK Athens,8450,1,4,2,0,7,1,6,14
PAOK Salonik,8450,2,2,3,1,10,5,5,9
P'thinaikos,8450,3,1,2,3,5,10,-5,5
Panionios,8450,4,1,1,4,4,10,-6,4
AEK Athens,8451,1,4,2,0,7,1,6,14
PAOK Salonik,8451,2,3,2,1,11,4,7,11
Panionios,8451,3,1,1,4,4,10,-6,4
P'thinaikos,8451,4,1,1,4,4,11,-7,4
AEK Athens,8452,1,4,2,0,7,1,6,14
PAOK Salonik,8452,2,2,2,2,9,6,3,8
P'thinaikos,8452,3,2,1,3,6,9,-3,7
Panionios,8452,4,1,1,4,4,10,-6,4
AEK Athens,8453,1,4,2,0,7,1,6,14
PAOK Salonik,8453,2,2,2,2,9,7,2,8
P'thinaikos,8453,3,2,1,3,7,9,-2,7
Panionios,8453,4,1,1,4,4,10,-6,4
AEK Athens,8454,1,4,2,0,7,1,6,14
PAOK Salonik,8454,2,2,3,1,11,6,5,9
P'thinaikos,8454,3,1,2,3,6,11,-5,5
Panionios,8454,4,1,1,4,4,10,-6,4
AEK Athens,8455,1,4,2,0,7,1,6,14
PAOK Salonik,8455,2,2,2,2,10,7,3,8
P'thinaikos,8455,3,2,1,3,7,10,-3,7
Panionios,8455,4,1,1,4,4,10,-6,4
AEK Athens,8456,1,4,2,0,7,1,6,14
PAOK Salonik,8456,2,2,2,2,9,6,3,8
P'thinaikos,8456,3,2,1,3,6,9,-3,7
Panionios,8456,4,1,1,4,4,10,-6,4
AEK Athens,8457,1,4,2,0,7,1,6,14
PAOK Salonik,8457,2,2,3,1,11,6,5,9
P'thinaikos,8457,3,1,2,3,6,11,-5,5
Panionios,8457,4,1,1,4,4,10,-6,4
AEK Athens,8458,1,4,2,0,7,1,6,14
PAOK Salonik,8458,2,2,3,1,10,5,5,9
P'thinaikos,8458,3,1,2,3,5,10,-5,5
Panionios,8458,4,1,1,4,4,10,-6,4
AEK Athens,8459,1,4,2,0,7,1,6,14
PAOK Salonik,8459,2,2,2,2,9,6,3,8
P'thinaikos,8459,3,2,1,3,6,9,-3,7
Panionios,8459,4,1,1,4,4,10,-6,4
AEK Athens,8460,1,4,2,0,7,1,6,14
PAOK Salonik,8460,2,3,2,1,11,4,7,11
Panionios,8460,3,1,1,4,4,10,-6,4
P'thinaikos,8460,4,1,1,4,4,11,-7,4
AEK Athens,8461,1,4,2,0,7,1,6,14
PAOK Salonik,8461,2,2,3,1,11,6,5,9
P'thinaikos,8461,3,1,2,3,6,11,-5,5
Panionios,8461,4,1,1,4,4,10,-6,4
AEK Athens,8462,1,4,2,0,7,1,6,14
PAOK Salonik,8462,2,2,2,2,9,5,4,8
P'thinaikos,8462,3,2,1,3,5,9,-4,7
Panionios,8462,4,1,1,4,4,10,-6,4
AEK Athens,8463,1,4,2,0,7,1,6,14
PAOK Salonik,8463,2,3,2,1,11,5,6,11
P'thinaikos,8463,3,1,1,4,5,11,-6,4
Panionios,8463,4,1,1,4,4,10,-6,4
AEK Athens,8464,1,4,2,0,7,1,6,14
PAOK Salonik,8464,2,3,2,1,11,4,7,11
Panionios,8464,3,1,1,4,4,10,-6,4
P'thinaikos,8464,4,1,1,4,4,11,-7,4
AEK Athens,8465,1,4,2,0,7,1,6,14
PAOK Salonik,8465,2,2,3,1,11,6,5,9
P'thinaikos,8465,3,1,2,3,6,11,-5,5
Panionios,8465,4,1,1,4,4,10,-6,4
AEK Athens,8466,1,4,2,0,7,1,6,14
PAOK Salonik,8466,2,2,2,2,9,5,4,8
P'thinaikos,8466,3,2,1,3,5,9,-4,7
Panionios,8466,4,1,1,4,4,10,-6,4
AEK Athens,8467,1,4,2,0,7,1,6,14
PAOK Salonik,8467,2,2,3,1,12,7,5,9
P'thinaikos,8467,3,1,2,3,7,12,-5,5
Panionios,8467,4,1,1,4,4,10,-6,4
AEK Athens,8468,1,4,2,0,7,1,6,14
PAOK Salonik,8468,2,2,2,2,9,9,0,8
P'thinaikos,8468,3,2,1,3,9,9,0,7
Panionios,8468,4,1,1,4,4,10,-6,4
AEK Athens,8469,1,4,2,0,7,1,6,14
PAOK Salonik,8469,2,3,2,1,10,4,6,11
P'thinaikos,8469,3,1,1,4,4,10,-6,4
Panionios,8469,3,1,1,4,4,10,-6,4
AEK Athens,8470,1,4,2,0,7,1,6,14
PAOK Salonik,8470,2,2,2,2,9,7,2,8
P'thinaikos,8470,3,2,1,3,7,9,-2,7
Panionios,8470,4,1,1,4,4,10,-6,4
AEK Athens,8471,1,4,2,0,7,1,6,14
PAOK Salonik,8471,2,2,2,2,9,5,4,8
P'thinaikos,8471,3,2,1,3,5,9,-4,7
Panionios,8471,4,1,1,4,4,10,-6,4
AEK Athens,8472,1,4,2,0,7,1,6,14
PAOK Salonik,8472,2,2,3,1,10,5,5,9
P'thinaikos,8472,3,1,2,3,5,10,-5,5
Panionios,8472,4,1,1,4,4,10,-6,4
AEK Athens,8473,1,4,2,0,7,1,6,14
PAOK Salonik,8473,2,3,2,1,11,4,7,11
Panionios,8473,3,1,1,4,4,10,-6,4
P'thinaikos,8473,4,1,1,4,4,11,-7,4
AEK Athens,8474,1,4,2,0,7,1,6,14
PAOK Salonik,8474,2,3,2,1,12,4,8,11
Panionios,8474,3,1,1,4,4,10,-6,4
P'thinaikos,8474,4,1,1,4,4,12,-8,4
AEK Athens,8475,1,4,2,0,7,1,6,14
PAOK Salonik,8475,2,2,2,2,9,6,3,8
P'thinaikos,8475,3,2,1,3,6,9,-3,7
Panionios,8475,4,1,1,4,4,10,-6,4
AEK Athens,8476,1,4,2,0,7,1,6,14
PAOK Salonik,8476,2,3,2,1,11,4,7,11
Panionios,8476,3,1,1,4,4,10,-6,4
P'thinaikos,8476,4,1,1,4,4,11,-7,4
AEK Athens,8477,1,4,2,0,7,1,6,14
PAOK Salonik,8477,2,2,2,2,10,6,4,8
P'thinaikos,8477,3,2,1,3,6,10,-4,7
Panionios,8477,4,1,1,4,4,10,-6,4
AEK Athens,8478,1,4,2,0,7,1,6,14
PAOK Salonik,8478,2,2,2,2,9,5,4,8
P'thinaikos,8478,3,2,1,3,5,9,-4,7
Panionios,8478,4,1,1,4,4,10,-6,4
AEK Athens,8479,1,4,2,0,7,1,6,14
PAOK Salonik,8479,2,3,2,1,11,5,6,11
P'thinaikos,8479,3,1,1,4,5,11,-6,4
Panionios,8479,4,1,1,4,4,10,-6,4
AEK Athens,8480,1,4,2,0,7,1,6,14
PAOK Salonik,8480,2,2,2,2,9,5,4,8
P'thinaikos,8480,3,2,1,3,5,9,-4,7
Panionios,8480,4,1,1,4,4,10,-6,4
AEK Athens,8481,1,4,2,0,7,1,6,14
PAOK Salonik,8481,2,3,2,1,14,4,10,11
Panionios,8481,3,1,1,4,4,10,-6,4
P'thinaikos,8481,4,1,1,4,4,14,-10,4
AEK Athens,8482,1,4,2,0,7,1,6,14
PAOK Salonik,8482,2,3,2,1,13,5,8,11
Panionios,8482,3,1,1,4,4,10,-6,4
P'thinaikos,8482,4,1,1,4,5,13,-8,4
AEK Athens,8483,1,4,2,0,7,1,6,14
PAOK Salonik,8483,2,2,2,2,9,5,4,8
P'thinaikos,8483,3,2,1,3,5,9,-4,7
Panionios,8483,4,1,1,4,4,10,-6,4
AEK Athens,8484,1,4,2,0,7,1,6,14
PAOK Salonik,8484,2,3,2,1,11,5,6,11
P'thinaikos,8484,3,1,1,4,5,11,-6,4
Panionios,8484,4,1,1,4,4,10,-6,4
AEK Athens,8485,1,4,2,0,7,1,6,14
PAOK Salonik,8485,2,2,3,1,10,5,5,9
P'thinaikos,8485,3,1,2,3,5,10,-5,5
Panionios,8485,4,1,1,4,4,10,-6,4
AEK Athens,8486,1,4,2,0,7,1,6,14
PAOK Salonik,8486,2,2,2,2,10,7,3,8
P'thinaikos,8486,3,2,1,3,7,10,-3,7
Panionios,8486,4,1,1,4,4,10,-6,4
AEK Athens,8487,1,4,2,0,7,1,6,14
PAOK Salonik,8487,2,2,2,2,10,6,4,8
P'thinaikos,8487,3,2,1,3,6,10,-4,7
Panionios,8487,4,1,1,4,4,10,-6,4
AEK Athens,8488,1,4,2,0,7,1,6,14
PAOK Salonik,8488,2,2,3,1,10,5,5,9
P'thinaikos,8488,3,1,2,3,5,10,-5,5
Panionios,8488,4,1,1,4,4,10,-6,4
AEK Athens,8489,1,4,2,0,7,1,6,14
PAOK Salonik,8489,2,2,2,2,9,6,3,8
P'thinaikos,8489,3,2,1,3,6,9,-3,7
Panionios,8489,4,1,1,4,4,10,-6,4
AEK Athens,8490,1,4,2,0,7,1,6,14
PAOK Salonik,8490,2,3,2,1,11,4,7,11
Panionios,8490,3,1,1,4,4,10,-6,4
P'thinaikos,8490,4,1,1,4,4,11,-7,4
AEK Athens,8491,1,4,2,0,7,1,6,14
PAOK Salonik,8491,2,2,2,2,10,7,3,8
P'thinaikos,8491,3,2,1,3,7,10,-3,7
Panionios,8491,4,1,1,4,4,10,-6,4
AEK Athens,8492,1,4,2,0,7,1,6,14
PAOK Salonik,8492,2,2,2,2,10,6,4,8
P'thinaikos,8492,3,2,1,3,6,10,-4,7
Panionios,8492,4,1,1,4,4,10,-6,4
AEK Athens,8493,1,4,2,0,7,1,6,14
PAOK Salonik,8493,2,2,2,2,9,5,4,8
P'thinaikos,8493,3,2,1,3,5,9,-4,7
Panionios,8493,4,1,1,4,4,10,-6,4
AEK Athens,8494,1,4,2,0,7,1,6,14
PAOK Salonik,8494,2,3,2,1,10,4,6,11
P'thinaikos,8494,3,1,1,4,4,10,-6,4
Panionios,8494,3,1,1,4,4,10,-6,4
AEK Athens,8495,1,4,2,0,7,1,6,14
PAOK Salonik,8495,2,2,2,2,10,7,3,8
P'thinaikos,8495,3,2,1,3,7,10,-3,7
Panionios,8495,4,1,1,4,4,10,-6,4
AEK Athens,8496,1,4,2,0,7,1,6,14
PAOK Salonik,8496,2,2,2,2,14,10,4,8
P'thinaikos,8496,3,2,1,3,10,14,-4,7
Panionios,8496,4,1,1,4,4,10,-6,4
AEK Athens,8497,1,4,2,0,7,1,6,14
PAOK Salonik,8497,2,3,2,1,11,5,6,11
P'thinaikos,8497,3,1,1,4,5,11,-6,4
Panionios,8497,4,1,1,4,4,10,-6,4
AEK Athens,8498,1,4,2,0,7,1,6,14
PAOK Salonik,8498,2,3,2,1,14,5,9,11
Panionios,8498,3,1,1,4,4,10,-6,4
P'thinaikos,8498,4,1,1,4,5,14,-9,4
AEK Athens,8499,1,4,2,0,7,1,6,14
PAOK Salonik,8499,2,3,2,1,11,4,7,11
Panionios,8499,3,1,1,4,4,10,-6,4
P'thinaikos,8499,4,1,1,4,4,11,-7,4
AEK Athens,8500,1,4,2,0,7,1,6,14
PAOK Salonik,8500,2,2,2,2,10,9,1,8
P'thinaikos,8500,3,2,1,3,9,10,-1,7
Panionios,8500,4,1,1,4,4,10,-6,4
AEK Athens,8501,1,4,2,0,7,1,6,14
PAOK Salonik,8501,2,2,3,1,9,4,5,9
P'thinaikos,8501,3,1,2,3,4,9,-5,5
Panionios,8501,4,1,1,4,4,10,-6,4
AEK Athens,8502,1,4,2,0,7,1,6,14
PAOK Salonik,8502,2,2,2,2,9,5,4,8
P'thinaikos,8502,3,2,1,3,5,9,-4,7
Panionios,8502,4,1,1,4,4,10,-6,4
AEK Athens,8503,1,4,2,0,7,1,6,14
PAOK Salonik,8503,2,3,2,1,11,4,7,11
Panionios,8503,3,1,1,4,4,10,-6,4
P'thinaikos,8503,4,1,1,4,4,11,-7,4
AEK Athens,8504,1,4,2,0,7,1,6,14
PAOK Salonik,8504,2,2,3,1,9,4,5,9
P'thinaikos,8504,3,1,2,3,4,9,-5,5
Panionios,8504,4,1,1,4,4,10,-6,4
AEK Athens,8505,1,4,2,0,7,1,6,14
PAOK Salonik,8505,2,3,2,1,11,5,6,11
P'thinaikos,8505,3,1,1,4,5,11,-6,4
Panionios,8505,4,1,1,4,4,10,-6,4
AEK Athens,8506,1,4,2,0,7,1,6,14
PAOK Salonik,8506,2,2,2,2,9,5,4,8
P'thinaikos,8506,3,2,1,3,5,9,-4,7
Panionios,8506,4,1,1,4,4,10,-6,4
AEK Athens,8507,1,4,2,0,7,1,6,14
PAOK Salonik,8507,2,3,2,1,11,5,6,11
P'thinaikos,8507,3,1,1,4,5,11,-6,4
Panionios,8507,4,1,1,4,4,10,-6,4
AEK Athens,8508,1,4,2,0,7,1,6,14
PAOK Salonik,8508,2,2,2,2,9,5,4,8
P'thinaikos,8508,3,2,1,3,5,9,-4,7
Panionios,8508,4,1,1,4,4,10,-6,4
AEK Athens,8509,1,4,2,0,7,1,6,14
PAOK Salonik,8509,2,2,3,1,10,5,5,9
P'thinaikos,8509,3,1,2,3,5,10,-5,5
Panionios,8509,4,1,1,4,4,10,-6,4
AEK Athens,8510,1,4,2,0,7,1,6,14
PAOK Salonik,8510,2,3,2,1,12,6,6,11
P'thinaikos,8510,3,1,1,4,6,12,-6,4
Panionios,8510,4,1,1,4,4,10,-6,4
AEK Athens,8511,1,4,2,0,7,1,6,14
PAOK Salonik,8511,2,2,3,1,10,5,5,9
P'thinaikos,8511,3,1,2,3,5,10,-5,5
Panionios,8511,4,1,1,4,4,10,-6,4
AEK Athens,8512,1,4,2,0,7,1,6,14
PAOK Salonik,8512,2,2,2,2,10,6,4,8
P'thinaikos,8512,3,2,1,3,6,10,-4,7
Panionios,8512,4,1,1,4,4,10,-6,4
AEK Athens,8513,1,4,2,0,7,1,6,14
PAOK Salonik,8513,2,2,2,2,10,7,3,8
P'thinaikos,8513,3,2,1,3,7,10,-3,7
Panionios,8513,4,1,1,4,4,10,-6,4
AEK Athens,8514,1,4,2,0,7,1,6,14
PAOK Salonik,8514,2,2,2,2,9,5,4,8
P'thinaikos,8514,3,2,1,3,5,9,-4,7
Panionios,8514,4,1,1,4,4,10,-6,4
AEK Athens,8515,1,4,2,0,7,1,6,14
PAOK Salonik,8515,2,2,2,2,10,6,4,8
P'thinaikos,8515,3,2,1,3,6,10,-4,7
Panionios,8515,4,1,1,4,4,10,-6,4
AEK Athens,8516,1,4,2,0,7,1,6,14
PAOK Salonik,8516,2,2,2,2,9,5,4,8
P'thinaikos,8516,3,2,1,3,5,9,-4,7
Panionios,8516,4,1,1,4,4,10,-6,4
AEK Athens,8517,1,4,2,0,7,1,6,14
PAOK Salonik,8517,2,3,2,1,12,6,6,11
P'thinaikos,8517,3,1,1,4,6,12,-6,4
Panionios,8517,4,1,1,4,4,10,-6,4
AEK Athens,8518,1,4,2,0,7,1,6,14
PAOK Salonik,8518,2,2,2,2,9,7,2,8
P'thinaikos,8518,3,2,1,3,7,9,-2,7
Panionios,8518,4,1,1,4,4,10,-6,4
AEK Athens,8519,1,4,2,0,7,1,6,14
PAOK Salonik,8519,2,2,2,2,10,6,4,8
P'thinaikos,8519,3,2,1,3,6,10,-4,7
Panionios,8519,4,1,1,4,4,10,-6,4
AEK Athens,8520,1,4,2,0,7,1,6,14
PAOK Salonik,8520,2,3,2,1,11,5,6,11
P'thinaikos,8520,3,1,1,4,5,11,-6,4
Panionios,8520,4,1,1,4,4,10,-6,4
AEK Athens,8521,1,4,2,0,7,1,6,14
PAOK Salonik,8521,2,3,2,1,11,5,6,11
P'thinaikos,8521,3,1,1,4,5,11,-6,4
Panionios,8521,4,1,1,4,4,10,-6,4
AEK Athens,8522,1,4,2,0,7,1,6,14
PAOK Salonik,8522,2,2,2,2,10,6,4,8
P'thinaikos,8522,3,2,1,3,6,10,-4,7
Panionios,8522,4,1,1,4,4,10,-6,4
AEK Athens,8523,1,4,2,0,7,1,6,14
PAOK Salonik,8523,2,3,2,1,11,5,6,11
P'thinaikos,8523,3,1,1,4,5,11,-6,4
Panionios,8523,4,1,1,4,4,10,-6,4
AEK Athens,8524,1,4,2,0,7,1,6,14
PAOK Salonik,8524,2,2,2,2,9,5,4,8
P'thinaikos,8524,3,2,1,3,5,9,-4,7
Panionios,8524,4,1,1,4,4,10,-6,4
AEK Athens,8525,1,4,2,0,7,1,6,14
PAOK Salonik,8525,2,3,2,1,10,4,6,11
P'thinaikos,8525,3,1,1,4,4,10,-6,4
Panionios,8525,3,1,1,4,4,10,-6,4
AEK Athens,8526,1,4,2,0,7,1,6,14
PAOK Salonik,8526,2,3,2,1,10,4,6,11
P'thinaikos,8526,3,1,1,4,4,10,-6,4
Panionios,8526,3,1,1,4,4,10,-6,4
AEK Athens,8527,1,4,2,0,7,1,6,14
PAOK Salonik,8527,2,3,2,1,10,4,6,11
P'thinaikos,8527,3,1,1,4,4,10,-6,4
Panionios,8527,3,1,1,4,4,10,-6,4
AEK Athens,8528,1,4,2,0,7,1,6,14
PAOK Salonik,8528,2,2,2,2,10,6,4,8
P'thinaikos,8528,3,2,1,3,6,10,-4,7
Panionios,8528,4,1,1,4,4,10,-6,4
AEK Athens,8529,1,4,2,0,7,1,6,14
PAOK Salonik,8529,2,2,3,1,10,5,5,9
P'thinaikos,8529,3,1,2,3,5,10,-5,5
Panionios,8529,4,1,1,4,4,10,-6,4
AEK Athens,8530,1,4,2,0,7,1,6,14
PAOK Salonik,8530,2,2,3,1,9,4,5,9
P'thinaikos,8530,3,1,2,3,4,9,-5,5
Panionios,8530,4,1,1,4,4,10,-6,4
AEK Athens,8531,1,4,2,0,7,1,6,14
PAOK Salonik,8531,2,2,2,2,9,5,4,8
P'thinaikos,8531,3,2,1,3,5,9,-4,7
Panionios,8531,4,1,1,4,4,10,-6,4
AEK Athens,8532,1,4,2,0,7,1,6,14
PAOK Salonik,8532,2,2,3,1,11,6,5,9
P'thinaikos,8532,3,1,2,3,6,11,-5,5
Panionios,8532,4,1,1,4,4,10,-6,4
AEK Athens,8533,1,4,2,0,7,1,6,14
PAOK Salonik,8533,2,3,2,1,11,4,7,11
Panionios,8533,3,1,1,4,4,10,-6,4
P'thinaikos,8533,4,1,1,4,4,11,-7,4
AEK Athens,8534,1,4,2,0,7,1,6,14
PAOK Salonik,8534,2,2,2,2,9,5,4,8
P'thinaikos,8534,3,2,1,3,5,9,-4,7
Panionios,8534,4,1,1,4,4,10,-6,4
AEK Athens,8535,1,4,2,0,7,1,6,14
PAOK Salonik,8535,2,2,2,2,10,6,4,8
P'thinaikos,8535,3,2,1,3,6,10,-4,7
Panionios,8535,4,1,1,4,4,10,-6,4
AEK Athens,8536,1,4,2,0,7,1,6,14
PAOK Salonik,8536,2,3,2,1,10,4,6,11
P'thinaikos,8536,3,1,1,4,4,10,-6,4
Panionios,8536,3,1,1,4,4,10,-6,4
AEK Athens,8537,1,4,2,0,7,1,6,14
PAOK Salonik,8537,2,2,3,1,12,7,5,9
P'thinaikos,8537,3,1,2,3,7,12,-5,5
Panionios,8537,4,1,1,4,4,10,-6,4
AEK Athens,8538,1,4,2,0,7,1,6,14
PAOK Salonik,8538,2,3,2,1,11,5,6,11
P'thinaikos,8538,3,1,1,4,5,11,-6,4
Panionios,8538,4,1,1,4,4,10,-6,4
AEK Athens,8539,1,4,2,0,7,1,6,14
PAOK Salonik,8539,2,3,2,1,10,4,6,11
P'thinaikos,8539,3,1,1,4,4,10,-6,4
Panionios,8539,3,1,1,4,4,10,-6,4
AEK Athens,8540,1,4,2,0,7,1,6,14
PAOK Salonik,8540,2,3,2,1,10,4,6,11
P'thinaikos,8540,3,1,1,4,4,10,-6,4
Panionios,8540,3,1,1,4,4,10,-6,4
AEK Athens,8541,1,4,2,0,7,1,6,14
PAOK Salonik,8541,2,2,3,1,11,6,5,9
P'thinaikos,8541,3,1,2,3,6,11,-5,5
Panionios,8541,4,1,1,4,4,10,-6,4
AEK Athens,8542,1,4,2,0,7,1,6,14
PAOK Salonik,8542,2,3,2,1,12,5,7,11
Panionios,8542,3,1,1,4,4,10,-6,4
P'thinaikos,8542,4,1,1,4,5,12,-7,4
AEK Athens,8543,1,4,2,0,7,1,6,14
PAOK Salonik,8543,2,3,2,1,11,4,7,11
Panionios,8543,3,1,1,4,4,10,-6,4
P'thinaikos,8543,4,1,1,4,4,11,-7,4
AEK Athens,8544,1,4,2,0,7,1,6,14
PAOK Salonik,8544,2,2,2,2,9,6,3,8
P'thinaikos,8544,3,2,1,3,6,9,-3,7
Panionios,8544,4,1,1,4,4,10,-6,4
AEK Athens,8545,1,4,2,0,7,1,6,14
PAOK Salonik,8545,2,2,3,1,9,4,5,9
P'thinaikos,8545,3,1,2,3,4,9,-5,5
Panionios,8545,4,1,1,4,4,10,-6,4
AEK Athens,8546,1,4,2,0,7,1,6,14
PAOK Salonik,8546,2,3,2,1,10,4,6,11
P'thinaikos,8546,3,1,1,4,4,10,-6,4
Panionios,8546,3,1,1,4,4,10,-6,4
AEK Athens,8547,1,4,2,0,7,1,6,14
PAOK Salonik,8547,2,2,3,1,9,4,5,9
P'thinaikos,8547,3,1,2,3,4,9,-5,5
Panionios,8547,4,1,1,4,4,10,-6,4
AEK Athens,8548,1,4,2,0,7,1,6,14
PAOK Salonik,8548,2,3,2,1,11,4,7,11
Panionios,8548,3,1,1,4,4,10,-6,4
P'thinaikos,8548,4,1,1,4,4,11,-7,4
AEK Athens,8549,1,4,2,0,7,1,6,14
PAOK Salonik,8549,2,3,2,1,12,6,6,11
P'thinaikos,8549,3,1,1,4,6,12,-6,4
Panionios,8549,4,1,1,4,4,10,-6,4
AEK Athens,8550,1,4,2,0,7,1,6,14
PAOK Salonik,8550,2,3,2,1,11,5,6,11
P'thinaikos,8550,3,1,1,4,5,11,-6,4
Panionios,8550,4,1,1,4,4,10,-6,4
AEK Athens,8551,1,4,2,0,7,1,6,14
PAOK Salonik,8551,2,3,2,1,13,5,8,11
Panionios,8551,3,1,1,4,4,10,-6,4
P'thinaikos,8551,4,1,1,4,5,13,-8,4
AEK Athens,8552,1,4,2,0,7,1,6,14
PAOK Salonik,8552,2,2,2,2,10,6,4,8
P'thinaikos,8552,3,2,1,3,6,10,-4,7
Panionios,8552,4,1,1,4,4,10,-6,4
AEK Athens,8553,1,4,2,0,7,1,6,14
PAOK Salonik,8553,2,3,2,1,10,4,6,11
P'thinaikos,8553,3,1,1,4,4,10,-6,4
Panionios,8553,3,1,1,4,4,10,-6,4
AEK Athens,8554,1,4,2,0,7,1,6,14
PAOK Salonik,8554,2,2,2,2,9,5,4,8
P'thinaikos,8554,3,2,1,3,5,9,-4,7
Panionios,8554,4,1,1,4,4,10,-6,4
AEK Athens,8555,1,4,2,0,7,1,6,14
PAOK Salonik,8555,2,2,2,2,10,10,0,8
P'thinaikos,8555,3,2,1,3,10,10,0,7
Panionios,8555,4,1,1,4,4,10,-6,4
AEK Athens,8556,1,4,2,0,7,1,6,14
PAOK Salonik,8556,2,2,3,1,12,7,5,9
P'thinaikos,8556,3,1,2,3,7,12,-5,5
Panionios,8556,4,1,1,4,4,10,-6,4
AEK Athens,8557,1,4,2,0,7,1,6,14
PAOK Salonik,8557,2,2,3,1,9,4,5,9
P'thinaikos,8557,3,1,2,3,4,9,-5,5
Panionios,8557,4,1,1,4,4,10,-6,4
AEK Athens,8558,1,4,2,0,7,1,6,14
PAOK Salonik,8558,2,2,2,2,10,6,4,8
P'thinaikos,8558,3,2,1,3,6,10,-4,7
Panionios,8558,4,1,1,4,4,10,-6,4
AEK Athens,8559,1,4,2,0,7,1,6,14
PAOK Salonik,8559,2,2,3,1,11,6,5,9
P'thinaikos,8559,3,1,2,3,6,11,-5,5
Panionios,8559,4,1,1,4,4,10,-6,4
AEK Athens,8560,1,4,2,0,7,1,6,14
PAOK Salonik,8560,2,2,3,1,11,6,5,9
P'thinaikos,8560,3,1,2,3,6,11,-5,5
Panionios,8560,4,1,1,4,4,10,-6,4
AEK Athens,8561,1,4,2,0,7,1,6,14
PAOK Salonik,8561,2,3,2,1,10,4,6,11
P'thinaikos,8561,3,1,1,4,4,10,-6,4
Panionios,8561,3,1,1,4,4,10,-6,4
AEK Athens,8562,1,4,2,0,7,1,6,14
PAOK Salonik,8562,2,3,2,1,11,5,6,11
P'thinaikos,8562,3,1,1,4,5,11,-6,4
Panionios,8562,4,1,1,4,4,10,-6,4
AEK Athens,8563,1,4,2,0,7,1,6,14
PAOK Salonik,8563,2,3,2,1,12,4,8,11
Panionios,8563,3,1,1,4,4,10,-6,4
P'thinaikos,8563,4,1,1,4,4,12,-8,4
AEK Athens,8564,1,4,2,0,7,1,6,14
PAOK Salonik,8564,2,2,2,2,9,7,2,8
P'thinaikos,8564,3,2,1,3,7,9,-2,7
Panionios,8564,4,1,1,4,4,10,-6,4
AEK Athens,8565,1,4,2,0,7,1,6,14
PAOK Salonik,8565,2,3,2,1,10,4,6,11
P'thinaikos,8565,3,1,1,4,4,10,-6,4
Panionios,8565,3,1,1,4,4,10,-6,4
AEK Athens,8566,1,4,2,0,7,1,6,14
PAOK Salonik,8566,2,2,2,2,9,7,2,8
P'thinaikos,8566,3,2,1,3,7,9,-2,7
Panionios,8566,4,1,1,4,4,10,-6,4
AEK Athens,8567,1,4,2,0,7,1,6,14
PAOK Salonik,8567,2,2,3,1,9,4,5,9
P'thinaikos,8567,3,1,2,3,4,9,-5,5
Panionios,8567,4,1,1,4,4,10,-6,4
AEK Athens,8568,1,4,2,0,7,1,6,14
PAOK Salonik,8568,2,2,3,1,11,6,5,9
P'thinaikos,8568,3,1,2,3,6,11,-5,5
Panionios,8568,4,1,1,4,4,10,-6,4
AEK Athens,8569,1,4,2,0,7,1,6,14
PAOK Salonik,8569,2,2,2,2,9,6,3,8
P'thinaikos,8569,3,2,1,3,6,9,-3,7
Panionios,8569,4,1,1,4,4,10,-6,4
AEK Athens,8570,1,4,2,0,7,1,6,14
PAOK Salonik,8570,2,2,3,1,10,5,5,9
P'thinaikos,8570,3,1,2,3,5,10,-5,5
Panionios,8570,4,1,1,4,4,10,-6,4
AEK Athens,8571,1,4,2,0,7,1,6,14
PAOK Salonik,8571,2,3,2,1,12,5,7,11
Panionios,8571,3,1,1,4,4,10,-6,4
P'thinaikos,8571,4,1,1,4,5,12,-7,4
AEK Athens,8572,1,4,2,0,7,1,6,14
PAOK Salonik,8572,2,2,2,2,10,6,4,8
P'thinaikos,8572,3,2,1,3,6,10,-4,7
Panionios,8572,4,1,1,4,4,10,-6,4
AEK Athens,8573,1,4,2,0,7,1,6,14
PAOK Salonik,8573,2,3,2,1,11,5,6,11
P'thinaikos,8573,3,1,1,4,5,11,-6,4
Panionios,8573,4,1,1,4,4,10,-6,4
AEK Athens,8574,1,4,2,0,7,1,6,14
PAOK Salonik,8574,2,2,3,1,9,4,5,9
P'thinaikos,8574,3,1,2,3,4,9,-5,5
Panionios,8574,4,1,1,4,4,10,-6,4
AEK Athens,8575,1,4,2,0,7,1,6,14
PAOK Salonik,8575,2,3,2,1,13,4,9,11
Panionios,8575,3,1,1,4,4,10,-6,4
P'thinaikos,8575,4,1,1,4,4,13,-9,4
AEK Athens,8576,1,4,2,0,7,1,6,14
PAOK Salonik,8576,2,2,2,2,9,5,4,8
P'thinaikos,8576,3,2,1,3,5,9,-4,7
Panionios,8576,4,1,1,4,4,10,-6,4
AEK Athens,8577,1,4,2,0,7,1,6,14
PAOK Salonik,8577,2,2,3,1,10,5,5,9
P'thinaikos,8577,3,1,2,3,5,10,-5,5
Panionios,8577,4,1,1,4,4,10,-6,4
AEK Athens,8578,1,4,2,0,7,1,6,14
PAOK Salonik,8578,2,2,3,1,9,4,5,9
P'thinaikos,8578,3,1,2,3,4,9,-5,5
Panionios,8578,4,1,1,4,4,10,-6,4
AEK Athens,8579,1,4,2,0,7,1,6,14
PAOK Salonik,8579,2,2,3,1,10,5,5,9
P'thinaikos,8579,3,1,2,3,5,10,-5,5
Panionios,8579,4,1,1,4,4,10,-6,4
AEK Athens,8580,1,4,2,0,7,1,6,14
PAOK Salonik,8580,2,2,3,1,9,4,5,9
P'thinaikos,8580,3,1,2,3,4,9,-5,5
Panionios,8580,4,1,1,4,4,10,-6,4
AEK Athens,8581,1,4,2,0,7,1,6,14
PAOK Salonik,8581,2,2,3,1,9,4,5,9
P'thinaikos,8581,3,1,2,3,4,9,-5,5
Panionios,8581,4,1,1,4,4,10,-6,4
AEK Athens,8582,1,4,2,0,7,1,6,14
PAOK Salonik,8582,2,2,2,2,10,7,3,8
P'thinaikos,8582,3,2,1,3,7,10,-3,7
Panionios,8582,4,1,1,4,4,10,-6,4
AEK Athens,8583,1,4,2,0,7,1,6,14
PAOK Salonik,8583,2,2,2,2,9,5,4,8
P'thinaikos,8583,3,2,1,3,5,9,-4,7
Panionios,8583,4,1,1,4,4,10,-6,4
AEK Athens,8584,1,4,2,0,7,1,6,14
PAOK Salonik,8584,2,2,2,2,12,8,4,8
P'thinaikos,8584,3,2,1,3,8,12,-4,7
Panionios,8584,4,1,1,4,4,10,-6,4
AEK Athens,8585,1,4,2,0,7,1,6,14
PAOK Salonik,8585,2,2,2,2,9,6,3,8
P'thinaikos,8585,3,2,1,3,6,9,-3,7
Panionios,8585,4,1,1,4,4,10,-6,4
AEK Athens,8586,1,4,2,0,7,1,6,14
PAOK Salonik,8586,2,2,2,2,11,8,3,8
P'thinaikos,8586,3,2,1,3,8,11,-3,7
Panionios,8586,4,1,1,4,4,10,-6,4
AEK Athens,8587,1,4,2,0,7,1,6,14
PAOK Salonik,8587,2,3,2,1,10,4,6,11
P'thinaikos,8587,3,1,1,4,4,10,-6,4
Panionios,8587,3,1,1,4,4,10,-6,4
AEK Athens,8588,1,4,2,0,7,1,6,14
PAOK Salonik,8588,2,2,2,2,9,5,4,8
P'thinaikos,8588,3,2,1,3,5,9,-4,7
Panionios,8588,4,1,1,4,4,10,-6,4
AEK Athens,8589,1,4,2,0,7,1,6,14
PAOK Salonik,8589,2,3,2,1,10,4,6,11
P'thinaikos,8589,3,1,1,4,4,10,-6,4
Panionios,8589,3,1,1,4,4,10,-6,4
AEK Athens,8590,1,4,2,0,7,1,6,14
PAOK Salonik,8590,2,2,2,2,11,8,3,8
P'thinaikos,8590,3,2,1,3,8,11,-3,7
Panionios,8590,4,1,1,4,4,10,-6,4
AEK Athens,8591,1,4,2,0,7,1,6,14
PAOK Salonik,8591,2,3,2,1,10,4,6,11
P'thinaikos,8591,3,1,1,4,4,10,-6,4
Panionios,8591,3,1,1,4,4,10,-6,4
AEK Athens,8592,1,4,2,0,7,1,6,14
PAOK Salonik,8592,2,3,2,1,13,4,9,11
Panionios,8592,3,1,1,4,4,10,-6,4
P'thinaikos,8592,4,1,1,4,4,13,-9,4
AEK Athens,8593,1,4,2,0,7,1,6,14
PAOK Salonik,8593,2,2,2,2,9,5,4,8
P'thinaikos,8593,3,2,1,3,5,9,-4,7
Panionios,8593,4,1,1,4,4,10,-6,4
AEK Athens,8594,1,4,2,0,7,1,6,14
PAOK Salonik,8594,2,2,2,2,9,5,4,8
P'thinaikos,8594,3,2,1,3,5,9,-4,7
Panionios,8594,4,1,1,4,4,10,-6,4
AEK Athens,8595,1,4,2,0,7,1,6,14
PAOK Salonik,8595,2,2,3,1,9,4,5,9
P'thinaikos,8595,3,1,2,3,4,9,-5,5
Panionios,8595,4,1,1,4,4,10,-6,4
AEK Athens,8596,1,4,2,0,7,1,6,14
PAOK Salonik,8596,2,3,2,1,11,5,6,11
P'thinaikos,8596,3,1,1,4,5,11,-6,4
Panionios,8596,4,1,1,4,4,10,-6,4
AEK Athens,8597,1,4,2,0,7,1,6,14
PAOK Salonik,8597,2,3,2,1,12,5,7,11
Panionios,8597,3,1,1,4,4,10,-6,4
P'thinaikos,8597,4,1,1,4,5,12,-7,4
AEK Athens,8598,1,4,2,0,7,1,6,14
PAOK Salonik,8598,2,2,2,2,9,8,1,8
P'thinaikos,8598,3,2,1,3,8,9,-1,7
Panionios,8598,4,1,1,4,4,10,-6,4
AEK Athens,8599,1,4,2,0,7,1,6,14
PAOK Salonik,8599,2,2,3,1,10,5,5,9
P'thinaikos,8599,3,1,2,3,5,10,-5,5
Panionios,8599,4,1,1,4,4,10,-6,4
AEK Athens,8600,1,4,2,0,7,1,6,14
PAOK Salonik,8600,2,2,2,2,9,6,3,8
P'thinaikos,8600,3,2,1,3,6,9,-3,7
Panionios,8600,4,1,1,4,4,10,-6,4
AEK Athens,8601,1,4,2,0,7,1,6,14
PAOK Salonik,8601,2,2,2,2,10,8,2,8
P'thinaikos,8601,3,2,1,3,8,10,-2,7
Panionios,8601,4,1,1,4,4,10,-6,4
AEK Athens,8602,1,4,2,0,7,1,6,14
PAOK Salonik,8602,2,2,3,1,9,4,5,9
P'thinaikos,8602,3,1,2,3,4,9,-5,5
Panionios,8602,4,1,1,4,4,10,-6,4
AEK Athens,8603,1,4,2,0,7,1,6,14
PAOK Salonik,8603,2,3,2,1,10,4,6,11
P'thinaikos,8603,3,1,1,4,4,10,-6,4
Panionios,8603,3,1,1,4,4,10,-6,4
AEK Athens,8604,1,4,2,0,7,1,6,14
PAOK Salonik,8604,2,2,3,1,11,6,5,9
P'thinaikos,8604,3,1,2,3,6,11,-5,5
Panionios,8604,4,1,1,4,4,10,-6,4
AEK Athens,8605,1,4,2,0,7,1,6,14
PAOK Salonik,8605,2,3,2,1,10,4,6,11
P'thinaikos,8605,3,1,1,4,4,10,-6,4
Panionios,8605,3,1,1,4,4,10,-6,4
AEK Athens,8606,1,4,2,0,7,1,6,14
PAOK Salonik,8606,2,2,3,1,9,4,5,9
P'thinaikos,8606,3,1,2,3,4,9,-5,5
Panionios,8606,4,1,1,4,4,10,-6,4
AEK Athens,8607,1,4,2,0,7,1,6,14
PAOK Salonik,8607,2,3,2,1,10,4,6,11
P'thinaikos,8607,3,1,1,4,4,10,-6,4
Panionios,8607,3,1,1,4,4,10,-6,4
AEK Athens,8608,1,4,2,0,7,1,6,14
PAOK Salonik,8608,2,3,2,1,11,4,7,11
Panionios,8608,3,1,1,4,4,10,-6,4
P'thinaikos,8608,4,1,1,4,4,11,-7,4
AEK Athens,8609,1,4,2,0,7,1,6,14
PAOK Salonik,8609,2,2,3,1,9,4,5,9
P'thinaikos,8609,3,1,2,3,4,9,-5,5
Panionios,8609,4,1,1,4,4,10,-6,4
AEK Athens,8610,1,4,2,0,7,1,6,14
PAOK Salonik,8610,2,2,2,2,11,7,4,8
P'thinaikos,8610,3,2,1,3,7,11,-4,7
Panionios,8610,4,1,1,4,4,10,-6,4
AEK Athens,8611,1,4,2,0,7,1,6,14
PAOK Salonik,8611,2,2,2,2,9,7,2,8
P'thinaikos,8611,3,2,1,3,7,9,-2,7
Panionios,8611,4,1,1,4,4,10,-6,4
AEK Athens,8612,1,4,2,0,7,1,6,14
PAOK Salonik,8612,2,2,2,2,10,8,2,8
P'thinaikos,8612,3,2,1,3,8,10,-2,7
Panionios,8612,4,1,1,4,4,10,-6,4
AEK Athens,8613,1,4,2,0,7,1,6,14
PAOK Salonik,8613,2,2,3,1,11,6,5,9
P'thinaikos,8613,3,1,2,3,6,11,-5,5
Panionios,8613,4,1,1,4,4,10,-6,4
AEK Athens,8614,1,4,2,0,7,1,6,14
PAOK Salonik,8614,2,2,3,1,10,5,5,9
P'thinaikos,8614,3,1,2,3,5,10,-5,5
Panionios,8614,4,1,1,4,4,10,-6,4
AEK Athens,8615,1,4,2,0,7,1,6,14
PAOK Salonik,8615,2,3,2,1,11,5,6,11
P'thinaikos,8615,3,1,1,4,5,11,-6,4
Panionios,8615,4,1,1,4,4,10,-6,4
AEK Athens,8616,1,4,2,0,7,1,6,14
PAOK Salonik,8616,2,2,2,2,11,7,4,8
P'thinaikos,8616,3,2,1,3,7,11,-4,7
Panionios,8616,4,1,1,4,4,10,-6,4
AEK Athens,8617,1,4,2,0,7,1,6,14
PAOK Salonik,8617,2,2,2,2,10,6,4,8
P'thinaikos,8617,3,2,1,3,6,10,-4,7
Panionios,8617,4,1,1,4,4,10,-6,4
AEK Athens,8618,1,4,2,0,7,1,6,14
PAOK Salonik,8618,2,2,3,1,11,6,5,9
P'thinaikos,8618,3,1,2,3,6,11,-5,5
Panionios,8618,4,1,1,4,4,10,-6,4
AEK Athens,8619,1,4,2,0,7,1,6,14
PAOK Salonik,8619,2,2,3,1,10,5,5,9
P'thinaikos,8619,3,1,2,3,5,10,-5,5
Panionios,8619,4,1,1,4,4,10,-6,4
AEK Athens,8620,1,4,2,0,7,1,6,14
PAOK Salonik,8620,2,3,2,1,10,4,6,11
P'thinaikos,8620,3,1,1,4,4,10,-6,4
Panionios,8620,3,1,1,4,4,10,-6,4
AEK Athens,8621,1,4,2,0,7,1,6,14
PAOK Salonik,8621,2,2,2,2,10,6,4,8
P'thinaikos,8621,3,2,1,3,6,10,-4,7
Panionios,8621,4,1,1,4,4,10,-6,4
AEK Athens,8622,1,4,2,0,7,1,6,14
PAOK Salonik,8622,2,3,2,1,13,4,9,11
Panionios,8622,3,1,1,4,4,10,-6,4
P'thinaikos,8622,4,1,1,4,4,13,-9,4
AEK Athens,8623,1,4,2,0,7,1,6,14
PAOK Salonik,8623,2,2,3,1,10,5,5,9
P'thinaikos,8623,3,1,2,3,5,10,-5,5
Panionios,8623,4,1,1,4,4,10,-6,4
AEK Athens,8624,1,4,2,0,7,1,6,14
PAOK Salonik,8624,2,2,3,1,10,5,5,9
P'thinaikos,8624,3,1,2,3,5,10,-5,5
Panionios,8624,4,1,1,4,4,10,-6,4
AEK Athens,8625,1,4,2,0,7,1,6,14
PAOK Salonik,8625,2,3,2,1,10,4,6,11
P'thinaikos,8625,3,1,1,4,4,10,-6,4
Panionios,8625,3,1,1,4,4,10,-6,4
AEK Athens,8626,1,4,2,0,7,1,6,14
PAOK Salonik,8626,2,3,2,1,11,5,6,11
P'thinaikos,8626,3,1,1,4,5,11,-6,4
Panionios,8626,4,1,1,4,4,10,-6,4
AEK Athens,8627,1,4,2,0,7,1,6,14
PAOK Salonik,8627,2,2,2,2,10,6,4,8
P'thinaikos,8627,3,2,1,3,6,10,-4,7
Panionios,8627,4,1,1,4,4,10,-6,4
AEK Athens,8628,1,4,2,0,7,1,6,14
PAOK Salonik,8628,2,3,2,1,11,5,6,11
P'thinaikos,8628,3,1,1,4,5,11,-6,4
Panionios,8628,4,1,1,4,4,10,-6,4
AEK Athens,8629,1,4,2,0,7,1,6,14
PAOK Salonik,8629,2,2,2,2,10,6,4,8
P'thinaikos,8629,3,2,1,3,6,10,-4,7
Panionios,8629,4,1,1,4,4,10,-6,4
AEK Athens,8630,1,4,2,0,7,1,6,14
PAOK Salonik,8630,2,2,2,2,11,7,4,8
P'thinaikos,8630,3,2,1,3,7,11,-4,7
Panionios,8630,4,1,1,4,4,10,-6,4
AEK Athens,8631,1,4,2,0,7,1,6,14
PAOK Salonik,8631,2,2,2,2,10,7,3,8
P'thinaikos,8631,3,2,1,3,7,10,-3,7
Panionios,8631,4,1,1,4,4,10,-6,4
AEK Athens,8632,1,4,2,0,7,1,6,14
PAOK Salonik,8632,2,2,2,2,9,5,4,8
P'thinaikos,8632,3,2,1,3,5,9,-4,7
Panionios,8632,4,1,1,4,4,10,-6,4
AEK Athens,8633,1,4,2,0,7,1,6,14
PAOK Salonik,8633,2,2,3,1,10,5,5,9
P'thinaikos,8633,3,1,2,3,5,10,-5,5
Panionios,8633,4,1,1,4,4,10,-6,4
AEK Athens,8634,1,4,2,0,7,1,6,14
PAOK Salonik,8634,2,2,2,2,9,5,4,8
P'thinaikos,8634,3,2,1,3,5,9,-4,7
Panionios,8634,4,1,1,4,4,10,-6,4
AEK Athens,8635,1,4,2,0,7,1,6,14
PAOK Salonik,8635,2,2,2,2,10,6,4,8
P'thinaikos,8635,3,2,1,3,6,10,-4,7
Panionios,8635,4,1,1,4,4,10,-6,4
AEK Athens,8636,1,4,2,0,7,1,6,14
PAOK Salonik,8636,2,3,2,1,10,4,6,11
P'thinaikos,8636,3,1,1,4,4,10,-6,4
Panionios,8636,3,1,1,4,4,10,-6,4
AEK Athens,8637,1,4,2,0,7,1,6,14
PAOK Salonik,8637,2,2,3,1,10,5,5,9
P'thinaikos,8637,3,1,2,3,5,10,-5,5
Panionios,8637,4,1,1,4,4,10,-6,4
AEK Athens,8638,1,4,2,0,7,1,6,14
PAOK Salonik,8638,2,2,3,1,10,5,5,9
P'thinaikos,8638,3,1,2,3,5,10,-5,5
Panionios,8638,4,1,1,4,4,10,-6,4
AEK Athens,8639,1,4,2,0,7,1,6,14
PAOK Salonik,8639,2,2,2,2,10,6,4,8
P'thinaikos,8639,3,2,1,3,6,10,-4,7
Panionios,8639,4,1,1,4,4,10,-6,4
AEK Athens,8640,1,4,2,0,7,1,6,14
PAOK Salonik,8640,2,2,2,2,9,5,4,8
P'thinaikos,8640,3,2,1,3,5,9,-4,7
Panionios,8640,4,1,1,4,4,10,-6,4
AEK Athens,8641,1,4,2,0,7,1,6,14
PAOK Salonik,8641,2,3,2,1,10,4,6,11
P'thinaikos,8641,3,1,1,4,4,10,-6,4
Panionios,8641,3,1,1,4,4,10,-6,4
AEK Athens,8642,1,4,2,0,7,1,6,14
PAOK Salonik,8642,2,2,2,2,10,7,3,8
P'thinaikos,8642,3,2,1,3,7,10,-3,7
Panionios,8642,4,1,1,4,4,10,-6,4
AEK Athens,8643,1,4,2,0,7,1,6,14
PAOK Salonik,8643,2,2,3,1,9,4,5,9
P'thinaikos,8643,3,1,2,3,4,9,-5,5
Panionios,8643,4,1,1,4,4,10,-6,4
AEK Athens,8644,1,4,2,0,7,1,6,14
PAOK Salonik,8644,2,3,2,1,11,5,6,11
P'thinaikos,8644,3,1,1,4,5,11,-6,4
Panionios,8644,4,1,1,4,4,10,-6,4
AEK Athens,8645,1,4,2,0,7,1,6,14
PAOK Salonik,8645,2,2,3,1,9,4,5,9
P'thinaikos,8645,3,1,2,3,4,9,-5,5
Panionios,8645,4,1,1,4,4,10,-6,4
AEK Athens,8646,1,4,2,0,7,1,6,14
PAOK Salonik,8646,2,3,2,1,10,4,6,11
P'thinaikos,8646,3,1,1,4,4,10,-6,4
Panionios,8646,3,1,1,4,4,10,-6,4
AEK Athens,8647,1,4,2,0,7,1,6,14
PAOK Salonik,8647,2,2,2,2,9,5,4,8
P'thinaikos,8647,3,2,1,3,5,9,-4,7
Panionios,8647,4,1,1,4,4,10,-6,4
AEK Athens,8648,1,4,2,0,7,1,6,14
PAOK Salonik,8648,2,3,2,1,12,5,7,11
Panionios,8648,3,1,1,4,4,10,-6,4
P'thinaikos,8648,4,1,1,4,5,12,-7,4
AEK Athens,8649,1,4,2,0,7,1,6,14
PAOK Salonik,8649,2,2,3,1,11,6,5,9
P'thinaikos,8649,3,1,2,3,6,11,-5,5
Panionios,8649,4,1,1,4,4,10,-6,4
AEK Athens,8650,1,4,2,0,7,1,6,14
PAOK Salonik,8650,2,2,2,2,10,6,4,8
P'thinaikos,8650,3,2,1,3,6,10,-4,7
Panionios,8650,4,1,1,4,4,10,-6,4
AEK Athens,8651,1,4,2,0,7,1,6,14
PAOK Salonik,8651,2,2,2,2,10,6,4,8
P'thinaikos,8651,3,2,1,3,6,10,-4,7
Panionios,8651,4,1,1,4,4,10,-6,4
AEK Athens,8652,1,4,2,0,7,1,6,14
PAOK Salonik,8652,2,2,3,1,10,5,5,9
P'thinaikos,8652,3,1,2,3,5,10,-5,5
Panionios,8652,4,1,1,4,4,10,-6,4
AEK Athens,8653,1,4,2,0,7,1,6,14
PAOK Salonik,8653,2,2,2,2,9,5,4,8
P'thinaikos,8653,3,2,1,3,5,9,-4,7
Panionios,8653,4,1,1,4,4,10,-6,4
AEK Athens,8654,1,4,2,0,7,1,6,14
PAOK Salonik,8654,2,2,2,2,9,5,4,8
P'thinaikos,8654,3,2,1,3,5,9,-4,7
Panionios,8654,4,1,1,4,4,10,-6,4
AEK Athens,8655,1,4,2,0,7,1,6,14
PAOK Salonik,8655,2,3,2,1,11,5,6,11
P'thinaikos,8655,3,1,1,4,5,11,-6,4
Panionios,8655,4,1,1,4,4,10,-6,4
AEK Athens,8656,1,4,2,0,7,1,6,14
PAOK Salonik,8656,2,2,3,1,10,5,5,9
P'thinaikos,8656,3,1,2,3,5,10,-5,5
Panionios,8656,4,1,1,4,4,10,-6,4
AEK Athens,8657,1,4,2,0,7,1,6,14
PAOK Salonik,8657,2,2,2,2,9,5,4,8
P'thinaikos,8657,3,2,1,3,5,9,-4,7
Panionios,8657,4,1,1,4,4,10,-6,4
AEK Athens,8658,1,4,2,0,7,1,6,14
PAOK Salonik,8658,2,3,2,1,10,4,6,11
P'thinaikos,8658,3,1,1,4,4,10,-6,4
Panionios,8658,3,1,1,4,4,10,-6,4
AEK Athens,8659,1,4,2,0,7,1,6,14
PAOK Salonik,8659,2,3,2,1,10,4,6,11
P'thinaikos,8659,3,1,1,4,4,10,-6,4
Panionios,8659,3,1,1,4,4,10,-6,4
AEK Athens,8660,1,4,2,0,7,1,6,14
PAOK Salonik,8660,2,2,2,2,10,6,4,8
P'thinaikos,8660,3,2,1,3,6,10,-4,7
Panionios,8660,4,1,1,4,4,10,-6,4
AEK Athens,8661,1,4,2,0,7,1,6,14
PAOK Salonik,8661,2,2,2,2,9,6,3,8
P'thinaikos,8661,3,2,1,3,6,9,-3,7
Panionios,8661,4,1,1,4,4,10,-6,4
AEK Athens,8662,1,4,2,0,7,1,6,14
PAOK Salonik,8662,2,2,2,2,10,6,4,8
P'thinaikos,8662,3,2,1,3,6,10,-4,7
Panionios,8662,4,1,1,4,4,10,-6,4
AEK Athens,8663,1,4,2,0,7,1,6,14
PAOK Salonik,8663,2,2,2,2,9,5,4,8
P'thinaikos,8663,3,2,1,3,5,9,-4,7
Panionios,8663,4,1,1,4,4,10,-6,4
AEK Athens,8664,1,4,2,0,7,1,6,14
PAOK Salonik,8664,2,3,2,1,12,4,8,11
Panionios,8664,3,1,1,4,4,10,-6,4
P'thinaikos,8664,4,1,1,4,4,12,-8,4
AEK Athens,8665,1,4,2,0,7,1,6,14
PAOK Salonik,8665,2,3,2,1,12,5,7,11
Panionios,8665,3,1,1,4,4,10,-6,4
P'thinaikos,8665,4,1,1,4,5,12,-7,4
AEK Athens,8666,1,4,2,0,7,1,6,14
PAOK Salonik,8666,2,3,2,1,12,4,8,11
Panionios,8666,3,1,1,4,4,10,-6,4
P'thinaikos,8666,4,1,1,4,4,12,-8,4
AEK Athens,8667,1,4,2,0,7,1,6,14
PAOK Salonik,8667,2,2,3,1,10,5,5,9
P'thinaikos,8667,3,1,2,3,5,10,-5,5
Panionios,8667,4,1,1,4,4,10,-6,4
AEK Athens,8668,1,4,2,0,7,1,6,14
PAOK Salonik,8668,2,2,2,2,9,5,4,8
P'thinaikos,8668,3,2,1,3,5,9,-4,7
Panionios,8668,4,1,1,4,4,10,-6,4
AEK Athens,8669,1,4,2,0,7,1,6,14
PAOK Salonik,8669,2,2,2,2,10,6,4,8
P'thinaikos,8669,3,2,1,3,6,10,-4,7
Panionios,8669,4,1,1,4,4,10,-6,4
AEK Athens,8670,1,4,2,0,7,1,6,14
PAOK Salonik,8670,2,2,3,1,9,4,5,9
P'thinaikos,8670,3,1,2,3,4,9,-5,5
Panionios,8670,4,1,1,4,4,10,-6,4
AEK Athens,8671,1,4,2,0,7,1,6,14
PAOK Salonik,8671,2,2,2,2,9,6,3,8
P'thinaikos,8671,3,2,1,3,6,9,-3,7
Panionios,8671,4,1,1,4,4,10,-6,4
AEK Athens,8672,1,4,2,0,7,1,6,14
PAOK Salonik,8672,2,3,2,1,10,4,6,11
P'thinaikos,8672,3,1,1,4,4,10,-6,4
Panionios,8672,3,1,1,4,4,10,-6,4
AEK Athens,8673,1,4,2,0,7,1,6,14
PAOK Salonik,8673,2,2,2,2,9,5,4,8
P'thinaikos,8673,3,2,1,3,5,9,-4,7
Panionios,8673,4,1,1,4,4,10,-6,4
AEK Athens,8674,1,4,2,0,7,1,6,14
PAOK Salonik,8674,2,2,2,2,9,6,3,8
P'thinaikos,8674,3,2,1,3,6,9,-3,7
Panionios,8674,4,1,1,4,4,10,-6,4
AEK Athens,8675,1,4,2,0,7,1,6,14
PAOK Salonik,8675,2,3,2,1,11,4,7,11
Panionios,8675,3,1,1,4,4,10,-6,4
P'thinaikos,8675,4,1,1,4,4,11,-7,4
AEK Athens,8676,1,4,2,0,7,1,6,14
PAOK Salonik,8676,2,2,3,1,10,5,5,9
P'thinaikos,8676,3,1,2,3,5,10,-5,5
Panionios,8676,4,1,1,4,4,10,-6,4
AEK Athens,8677,1,4,2,0,7,1,6,14
PAOK Salonik,8677,2,2,2,2,10,9,1,8
P'thinaikos,8677,3,2,1,3,9,10,-1,7
Panionios,8677,4,1,1,4,4,10,-6,4
AEK Athens,8678,1,4,2,0,7,1,6,14
PAOK Salonik,8678,2,2,3,1,9,4,5,9
P'thinaikos,8678,3,1,2,3,4,9,-5,5
Panionios,8678,4,1,1,4,4,10,-6,4
AEK Athens,8679,1,4,2,0,7,1,6,14
PAOK Salonik,8679,2,3,2,1,10,4,6,11
P'thinaikos,8679,3,1,1,4,4,10,-6,4
Panionios,8679,3,1,1,4,4,10,-6,4
AEK Athens,8680,1,4,2,0,7,1,6,14
PAOK Salonik,8680,2,2,3,1,10,5,5,9
P'thinaikos,8680,3,1,2,3,5,10,-5,5
Panionios,8680,4,1,1,4,4,10,-6,4
AEK Athens,8681,1,4,2,0,7,1,6,14
PAOK Salonik,8681,2,3,2,1,13,6,7,11
Panionios,8681,3,1,1,4,4,10,-6,4
P'thinaikos,8681,4,1,1,4,6,13,-7,4
AEK Athens,8682,1,4,2,0,7,1,6,14
PAOK Salonik,8682,2,2,2,2,10,6,4,8
P'thinaikos,8682,3,2,1,3,6,10,-4,7
Panionios,8682,4,1,1,4,4,10,-6,4
AEK Athens,8683,1,4,2,0,7,1,6,14
PAOK Salonik,8683,2,3,2,1,10,4,6,11
P'thinaikos,8683,3,1,1,4,4,10,-6,4
Panionios,8683,3,1,1,4,4,10,-6,4
AEK Athens,8684,1,4,2,0,7,1,6,14
PAOK Salonik,8684,2,2,3,1,9,4,5,9
P'thinaikos,8684,3,1,2,3,4,9,-5,5
Panionios,8684,4,1,1,4,4,10,-6,4
AEK Athens,8685,1,4,2,0,7,1,6,14
PAOK Salonik,8685,2,2,3,1,10,5,5,9
P'thinaikos,8685,3,1,2,3,5,10,-5,5
Panionios,8685,4,1,1,4,4,10,-6,4
AEK Athens,8686,1,4,2,0,7,1,6,14
PAOK Salonik,8686,2,3,2,1,11,4,7,11
Panionios,8686,3,1,1,4,4,10,-6,4
P'thinaikos,8686,4,1,1,4,4,11,-7,4
AEK Athens,8687,1,4,2,0,7,1,6,14
PAOK Salonik,8687,2,2,2,2,10,6,4,8
P'thinaikos,8687,3,2,1,3,6,10,-4,7
Panionios,8687,4,1,1,4,4,10,-6,4
AEK Athens,8688,1,4,2,0,7,1,6,14
PAOK Salonik,8688,2,2,2,2,9,6,3,8
P'thinaikos,8688,3,2,1,3,6,9,-3,7
Panionios,8688,4,1,1,4,4,10,-6,4
AEK Athens,8689,1,4,2,0,7,1,6,14
PAOK Salonik,8689,2,2,2,2,10,9,1,8
P'thinaikos,8689,3,2,1,3,9,10,-1,7
Panionios,8689,4,1,1,4,4,10,-6,4
AEK Athens,8690,1,4,2,0,7,1,6,14
PAOK Salonik,8690,2,2,2,2,10,6,4,8
P'thinaikos,8690,3,2,1,3,6,10,-4,7
Panionios,8690,4,1,1,4,4,10,-6,4
AEK Athens,8691,1,4,2,0,7,1,6,14
PAOK Salonik,8691,2,2,2,2,9,8,1,8
P'thinaikos,8691,3,2,1,3,8,9,-1,7
Panionios,8691,4,1,1,4,4,10,-6,4
AEK Athens,8692,1,4,2,0,7,1,6,14
PAOK Salonik,8692,2,2,3,1,10,5,5,9
P'thinaikos,8692,3,1,2,3,5,10,-5,5
Panionios,8692,4,1,1,4,4,10,-6,4
AEK Athens,8693,1,4,2,0,7,1,6,14
PAOK Salonik,8693,2,3,2,1,11,4,7,11
Panionios,8693,3,1,1,4,4,10,-6,4
P'thinaikos,8693,4,1,1,4,4,11,-7,4
AEK Athens,8694,1,4,2,0,7,1,6,14
PAOK Salonik,8694,2,3,2,1,10,4,6,11
P'thinaikos,8694,3,1,1,4,4,10,-6,4
Panionios,8694,3,1,1,4,4,10,-6,4
AEK Athens,8695,1,4,2,0,7,1,6,14
PAOK Salonik,8695,2,3,2,1,11,5,6,11
P'thinaikos,8695,3,1,1,4,5,11,-6,4
Panionios,8695,4,1,1,4,4,10,-6,4
AEK Athens,8696,1,4,2,0,7,1,6,14
PAOK Salonik,8696,2,2,2,2,10,6,4,8
P'thinaikos,8696,3,2,1,3,6,10,-4,7
Panionios,8696,4,1,1,4,4,10,-6,4
AEK Athens,8697,1,4,2,0,7,1,6,14
PAOK Salonik,8697,2,2,2,2,9,8,1,8
P'thinaikos,8697,3,2,1,3,8,9,-1,7
Panionios,8697,4,1,1,4,4,10,-6,4
AEK Athens,8698,1,4,2,0,7,1,6,14
PAOK Salonik,8698,2,2,2,2,9,5,4,8
P'thinaikos,8698,3,2,1,3,5,9,-4,7
Panionios,8698,4,1,1,4,4,10,-6,4
AEK Athens,8699,1,4,2,0,7,1,6,14
PAOK Salonik,8699,2,2,2,2,9,6,3,8
P'thinaikos,8699,3,2,1,3,6,9,-3,7
Panionios,8699,4,1,1,4,4,10,-6,4
AEK Athens,8700,1,4,2,0,7,1,6,14
PAOK Salonik,8700,2,2,2,2,9,5,4,8
P'thinaikos,8700,3,2,1,3,5,9,-4,7
Panionios,8700,4,1,1,4,4,10,-6,4
AEK Athens,8701,1,4,2,0,7,1,6,14
PAOK Salonik,8701,2,3,2,1,10,4,6,11
P'thinaikos,8701,3,1,1,4,4,10,-6,4
Panionios,8701,3,1,1,4,4,10,-6,4
AEK Athens,8702,1,4,2,0,7,1,6,14
PAOK Salonik,8702,2,2,3,1,9,4,5,9
P'thinaikos,8702,3,1,2,3,4,9,-5,5
Panionios,8702,4,1,1,4,4,10,-6,4
AEK Athens,8703,1,4,2,0,7,1,6,14
PAOK Salonik,8703,2,2,2,2,11,7,4,8
P'thinaikos,8703,3,2,1,3,7,11,-4,7
Panionios,8703,4,1,1,4,4,10,-6,4
AEK Athens,8704,1,4,2,0,7,1,6,14
PAOK Salonik,8704,2,2,2,2,9,5,4,8
P'thinaikos,8704,3,2,1,3,5,9,-4,7
Panionios,8704,4,1,1,4,4,10,-6,4
AEK Athens,8705,1,4,2,0,7,1,6,14
PAOK Salonik,8705,2,2,3,1,10,5,5,9
P'thinaikos,8705,3,1,2,3,5,10,-5,5
Panionios,8705,4,1,1,4,4,10,-6,4
AEK Athens,8706,1,4,2,0,7,1,6,14
PAOK Salonik,8706,2,3,2,1,13,4,9,11
Panionios,8706,3,1,1,4,4,10,-6,4
P'thinaikos,8706,4,1,1,4,4,13,-9,4
AEK Athens,8707,1,4,2,0,7,1,6,14
PAOK Salonik,8707,2,2,3,1,10,5,5,9
P'thinaikos,8707,3,1,2,3,5,10,-5,5
Panionios,8707,4,1,1,4,4,10,-6,4
AEK Athens,8708,1,4,2,0,7,1,6,14
PAOK Salonik,8708,2,3,2,1,10,4,6,11
P'thinaikos,8708,3,1,1,4,4,10,-6,4
Panionios,8708,3,1,1,4,4,10,-6,4
AEK Athens,8709,1,4,2,0,7,1,6,14
PAOK Salonik,8709,2,2,2,2,10,7,3,8
P'thinaikos,8709,3,2,1,3,7,10,-3,7
Panionios,8709,4,1,1,4,4,10,-6,4
AEK Athens,8710,1,4,2,0,7,1,6,14
PAOK Salonik,8710,2,2,3,1,10,5,5,9
P'thinaikos,8710,3,1,2,3,5,10,-5,5
Panionios,8710,4,1,1,4,4,10,-6,4
AEK Athens,8711,1,4,2,0,7,1,6,14
PAOK Salonik,8711,2,2,2,2,9,6,3,8
P'thinaikos,8711,3,2,1,3,6,9,-3,7
Panionios,8711,4,1,1,4,4,10,-6,4
AEK Athens,8712,1,4,2,0,7,1,6,14
PAOK Salonik,8712,2,2,3,1,9,4,5,9
P'thinaikos,8712,3,1,2,3,4,9,-5,5
Panionios,8712,4,1,1,4,4,10,-6,4
AEK Athens,8713,1,4,2,0,7,1,6,14
PAOK Salonik,8713,2,2,2,2,9,5,4,8
P'thinaikos,8713,3,2,1,3,5,9,-4,7
Panionios,8713,4,1,1,4,4,10,-6,4
AEK Athens,8714,1,4,2,0,7,1,6,14
PAOK Salonik,8714,2,3,2,1,10,4,6,11
P'thinaikos,8714,3,1,1,4,4,10,-6,4
Panionios,8714,3,1,1,4,4,10,-6,4
AEK Athens,8715,1,4,2,0,7,1,6,14
PAOK Salonik,8715,2,2,3,1,11,6,5,9
P'thinaikos,8715,3,1,2,3,6,11,-5,5
Panionios,8715,4,1,1,4,4,10,-6,4
AEK Athens,8716,1,4,2,0,7,1,6,14
PAOK Salonik,8716,2,3,2,1,10,4,6,11
P'thinaikos,8716,3,1,1,4,4,10,-6,4
Panionios,8716,3,1,1,4,4,10,-6,4
AEK Athens,8717,1,4,2,0,7,1,6,14
PAOK Salonik,8717,2,3,2,1,12,4,8,11
Panionios,8717,3,1,1,4,4,10,-6,4
P'thinaikos,8717,4,1,1,4,4,12,-8,4
AEK Athens,8718,1,4,2,0,7,1,6,14
PAOK Salonik,8718,2,3,2,1,11,5,6,11
P'thinaikos,8718,3,1,1,4,5,11,-6,4
Panionios,8718,4,1,1,4,4,10,-6,4
AEK Athens,8719,1,4,2,0,7,1,6,14
PAOK Salonik,8719,2,2,2,2,9,5,4,8
P'thinaikos,8719,3,2,1,3,5,9,-4,7
Panionios,8719,4,1,1,4,4,10,-6,4
AEK Athens,8720,1,4,2,0,7,1,6,14
PAOK Salonik,8720,2,2,3,1,11,6,5,9
P'thinaikos,8720,3,1,2,3,6,11,-5,5
Panionios,8720,4,1,1,4,4,10,-6,4
AEK Athens,8721,1,4,2,0,7,1,6,14
PAOK Salonik,8721,2,2,2,2,10,6,4,8
P'thinaikos,8721,3,2,1,3,6,10,-4,7
Panionios,8721,4,1,1,4,4,10,-6,4
AEK Athens,8722,1,4,2,0,7,1,6,14
PAOK Salonik,8722,2,3,2,1,10,4,6,11
P'thinaikos,8722,3,1,1,4,4,10,-6,4
Panionios,8722,3,1,1,4,4,10,-6,4
AEK Athens,8723,1,4,2,0,7,1,6,14
PAOK Salonik,8723,2,3,2,1,12,5,7,11
Panionios,8723,3,1,1,4,4,10,-6,4
P'thinaikos,8723,4,1,1,4,5,12,-7,4
AEK Athens,8724,1,4,2,0,7,1,6,14
PAOK Salonik,8724,2,3,2,1,12,5,7,11
Panionios,8724,3,1,1,4,4,10,-6,4
P'thinaikos,8724,4,1,1,4,5,12,-7,4
AEK Athens,8725,1,4,2,0,7,1,6,14
PAOK Salonik,8725,2,2,2,2,10,6,4,8
P'thinaikos,8725,3,2,1,3,6,10,-4,7
Panionios,8725,4,1,1,4,4,10,-6,4
AEK Athens,8726,1,4,2,0,7,1,6,14
PAOK Salonik,8726,2,2,2,2,9,5,4,8
P'thinaikos,8726,3,2,1,3,5,9,-4,7
Panionios,8726,4,1,1,4,4,10,-6,4
AEK Athens,8727,1,4,2,0,7,1,6,14
PAOK Salonik,8727,2,2,2,2,9,5,4,8
P'thinaikos,8727,3,2,1,3,5,9,-4,7
Panionios,8727,4,1,1,4,4,10,-6,4
AEK Athens,8728,1,4,2,0,7,1,6,14
PAOK Salonik,8728,2,3,2,1,13,5,8,11
Panionios,8728,3,1,1,4,4,10,-6,4
P'thinaikos,8728,4,1,1,4,5,13,-8,4
AEK Athens,8729,1,4,2,0,7,1,6,14
PAOK Salonik,8729,2,2,2,2,10,6,4,8
P'thinaikos,8729,3,2,1,3,6,10,-4,7
Panionios,8729,4,1,1,4,4,10,-6,4
AEK Athens,8730,1,4,2,0,7,1,6,14
PAOK Salonik,8730,2,2,2,2,10,6,4,8
P'thinaikos,8730,3,2,1,3,6,10,-4,7
Panionios,8730,4,1,1,4,4,10,-6,4
AEK Athens,8731,1,4,2,0,7,1,6,14
PAOK Salonik,8731,2,3,2,1,11,4,7,11
Panionios,8731,3,1,1,4,4,10,-6,4
P'thinaikos,8731,4,1,1,4,4,11,-7,4
AEK Athens,8732,1,4,2,0,7,1,6,14
PAOK Salonik,8732,2,3,2,1,11,4,7,11
Panionios,8732,3,1,1,4,4,10,-6,4
P'thinaikos,8732,4,1,1,4,4,11,-7,4
AEK Athens,8733,1,4,2,0,7,1,6,14
PAOK Salonik,8733,2,3,2,1,15,4,11,11
Panionios,8733,3,1,1,4,4,10,-6,4
P'thinaikos,8733,4,1,1,4,4,15,-11,4
AEK Athens,8734,1,4,2,0,7,1,6,14
PAOK Salonik,8734,2,2,2,2,9,6,3,8
P'thinaikos,8734,3,2,1,3,6,9,-3,7
Panionios,8734,4,1,1,4,4,10,-6,4
AEK Athens,8735,1,4,2,0,7,1,6,14
PAOK Salonik,8735,2,2,3,1,11,6,5,9
P'thinaikos,8735,3,1,2,3,6,11,-5,5
Panionios,8735,4,1,1,4,4,10,-6,4
AEK Athens,8736,1,4,2,0,7,1,6,14
PAOK Salonik,8736,2,2,3,1,9,4,5,9
P'thinaikos,8736,3,1,2,3,4,9,-5,5
Panionios,8736,4,1,1,4,4,10,-6,4
AEK Athens,8737,1,4,2,0,7,1,6,14
PAOK Salonik,8737,2,3,2,1,11,5,6,11
P'thinaikos,8737,3,1,1,4,5,11,-6,4
Panionios,8737,4,1,1,4,4,10,-6,4
AEK Athens,8738,1,4,2,0,7,1,6,14
PAOK Salonik,8738,2,2,3,1,10,5,5,9
P'thinaikos,8738,3,1,2,3,5,10,-5,5
Panionios,8738,4,1,1,4,4,10,-6,4
AEK Athens,8739,1,4,2,0,7,1,6,14
PAOK Salonik,8739,2,2,2,2,9,5,4,8
P'thinaikos,8739,3,2,1,3,5,9,-4,7
Panionios,8739,4,1,1,4,4,10,-6,4
AEK Athens,8740,1,4,2,0,7,1,6,14
PAOK Salonik,8740,2,2,3,1,10,5,5,9
P'thinaikos,8740,3,1,2,3,5,10,-5,5
Panionios,8740,4,1,1,4,4,10,-6,4
AEK Athens,8741,1,4,2,0,7,1,6,14
PAOK Salonik,8741,2,2,2,2,9,6,3,8
P'thinaikos,8741,3,2,1,3,6,9,-3,7
Panionios,8741,4,1,1,4,4,10,-6,4
AEK Athens,8742,1,4,2,0,7,1,6,14
PAOK Salonik,8742,2,3,2,1,11,5,6,11
P'thinaikos,8742,3,1,1,4,5,11,-6,4
Panionios,8742,4,1,1,4,4,10,-6,4
AEK Athens,8743,1,4,2,0,7,1,6,14
PAOK Salonik,8743,2,2,2,2,10,6,4,8
P'thinaikos,8743,3,2,1,3,6,10,-4,7
Panionios,8743,4,1,1,4,4,10,-6,4
AEK Athens,8744,1,4,2,0,7,1,6,14
PAOK Salonik,8744,2,2,3,1,11,6,5,9
P'thinaikos,8744,3,1,2,3,6,11,-5,5
Panionios,8744,4,1,1,4,4,10,-6,4
AEK Athens,8745,1,4,2,0,7,1,6,14
PAOK Salonik,8745,2,3,2,1,11,5,6,11
P'thinaikos,8745,3,1,1,4,5,11,-6,4
Panionios,8745,4,1,1,4,4,10,-6,4
AEK Athens,8746,1,4,2,0,7,1,6,14
PAOK Salonik,8746,2,2,2,2,10,7,3,8
P'thinaikos,8746,3,2,1,3,7,10,-3,7
Panionios,8746,4,1,1,4,4,10,-6,4
AEK Athens,8747,1,4,2,0,7,1,6,14
PAOK Salonik,8747,2,3,2,1,13,6,7,11
Panionios,8747,3,1,1,4,4,10,-6,4
P'thinaikos,8747,4,1,1,4,6,13,-7,4
AEK Athens,8748,1,4,2,0,7,1,6,14
PAOK Salonik,8748,2,2,2,2,10,6,4,8
P'thinaikos,8748,3,2,1,3,6,10,-4,7
Panionios,8748,4,1,1,4,4,10,-6,4
AEK Athens,8749,1,4,2,0,7,1,6,14
PAOK Salonik,8749,2,2,2,2,9,6,3,8
P'thinaikos,8749,3,2,1,3,6,9,-3,7
Panionios,8749,4,1,1,4,4,10,-6,4
AEK Athens,8750,1,4,2,0,7,1,6,14
PAOK Salonik,8750,2,2,2,2,9,8,1,8
P'thinaikos,8750,3,2,1,3,8,9,-1,7
Panionios,8750,4,1,1,4,4,10,-6,4
AEK Athens,8751,1,4,2,0,7,1,6,14
PAOK Salonik,8751,2,3,2,1,10,4,6,11
P'thinaikos,8751,3,1,1,4,4,10,-6,4
Panionios,8751,3,1,1,4,4,10,-6,4
AEK Athens,8752,1,4,2,0,7,1,6,14
PAOK Salonik,8752,2,2,3,1,10,5,5,9
P'thinaikos,8752,3,1,2,3,5,10,-5,5
Panionios,8752,4,1,1,4,4,10,-6,4
AEK Athens,8753,1,4,2,0,7,1,6,14
PAOK Salonik,8753,2,2,2,2,10,9,1,8
P'thinaikos,8753,3,2,1,3,9,10,-1,7
Panionios,8753,4,1,1,4,4,10,-6,4
AEK Athens,8754,1,4,2,0,7,1,6,14
PAOK Salonik,8754,2,2,2,2,9,5,4,8
P'thinaikos,8754,3,2,1,3,5,9,-4,7
Panionios,8754,4,1,1,4,4,10,-6,4
AEK Athens,8755,1,4,2,0,7,1,6,14
PAOK Salonik,8755,2,3,2,1,10,4,6,11
P'thinaikos,8755,3,1,1,4,4,10,-6,4
Panionios,8755,3,1,1,4,4,10,-6,4
AEK Athens,8756,1,4,2,0,7,1,6,14
PAOK Salonik,8756,2,3,2,1,10,4,6,11
P'thinaikos,8756,3,1,1,4,4,10,-6,4
Panionios,8756,3,1,1,4,4,10,-6,4
AEK Athens,8757,1,4,2,0,7,1,6,14
PAOK Salonik,8757,2,2,2,2,9,6,3,8
P'thinaikos,8757,3,2,1,3,6,9,-3,7
Panionios,8757,4,1,1,4,4,10,-6,4
AEK Athens,8758,1,4,2,0,7,1,6,14
PAOK Salonik,8758,2,2,2,2,9,6,3,8
P'thinaikos,8758,3,2,1,3,6,9,-3,7
Panionios,8758,4,1,1,4,4,10,-6,4
AEK Athens,8759,1,4,2,0,7,1,6,14
PAOK Salonik,8759,2,2,2,2,10,6,4,8
P'thinaikos,8759,3,2,1,3,6,10,-4,7
Panionios,8759,4,1,1,4,4,10,-6,4
AEK Athens,8760,1,4,2,0,7,1,6,14
PAOK Salonik,8760,2,2,3,1,10,5,5,9
P'thinaikos,8760,3,1,2,3,5,10,-5,5
Panionios,8760,4,1,1,4,4,10,-6,4
AEK Athens,8761,1,4,2,0,7,1,6,14
PAOK Salonik,8761,2,2,3,1,9,4,5,9
P'thinaikos,8761,3,1,2,3,4,9,-5,5
Panionios,8761,4,1,1,4,4,10,-6,4
AEK Athens,8762,1,4,2,0,7,1,6,14
PAOK Salonik,8762,2,2,2,2,9,6,3,8
P'thinaikos,8762,3,2,1,3,6,9,-3,7
Panionios,8762,4,1,1,4,4,10,-6,4
AEK Athens,8763,1,4,2,0,7,1,6,14
PAOK Salonik,8763,2,2,3,1,10,5,5,9
P'thinaikos,8763,3,1,2,3,5,10,-5,5
Panionios,8763,4,1,1,4,4,10,-6,4
AEK Athens,8764,1,4,2,0,7,1,6,14
PAOK Salonik,8764,2,2,2,2,10,7,3,8
P'thinaikos,8764,3,2,1,3,7,10,-3,7
Panionios,8764,4,1,1,4,4,10,-6,4
AEK Athens,8765,1,4,2,0,7,1,6,14
PAOK Salonik,8765,2,2,2,2,10,6,4,8
P'thinaikos,8765,3,2,1,3,6,10,-4,7
Panionios,8765,4,1,1,4,4,10,-6,4
AEK Athens,8766,1,4,2,0,7,1,6,14
PAOK Salonik,8766,2,2,3,1,11,6,5,9
P'thinaikos,8766,3,1,2,3,6,11,-5,5
Panionios,8766,4,1,1,4,4,10,-6,4
AEK Athens,8767,1,4,2,0,7,1,6,14
PAOK Salonik,8767,2,3,2,1,12,6,6,11
P'thinaikos,8767,3,1,1,4,6,12,-6,4
Panionios,8767,4,1,1,4,4,10,-6,4
AEK Athens,8768,1,4,2,0,7,1,6,14
PAOK Salonik,8768,2,2,3,1,9,4,5,9
P'thinaikos,8768,3,1,2,3,4,9,-5,5
Panionios,8768,4,1,1,4,4,10,-6,4
AEK Athens,8769,1,4,2,0,7,1,6,14
PAOK Salonik,8769,2,2,3,1,10,5,5,9
P'thinaikos,8769,3,1,2,3,5,10,-5,5
Panionios,8769,4,1,1,4,4,10,-6,4
AEK Athens,8770,1,4,2,0,7,1,6,14
PAOK Salonik,8770,2,2,2,2,9,5,4,8
P'thinaikos,8770,3,2,1,3,5,9,-4,7
Panionios,8770,4,1,1,4,4,10,-6,4
AEK Athens,8771,1,4,2,0,7,1,6,14
PAOK Salonik,8771,2,2,3,1,10,5,5,9
P'thinaikos,8771,3,1,2,3,5,10,-5,5
Panionios,8771,4,1,1,4,4,10,-6,4
AEK Athens,8772,1,4,2,0,7,1,6,14
PAOK Salonik,8772,2,2,2,2,9,5,4,8
P'thinaikos,8772,3,2,1,3,5,9,-4,7
Panionios,8772,4,1,1,4,4,10,-6,4
AEK Athens,8773,1,4,2,0,7,1,6,14
PAOK Salonik,8773,2,2,2,2,9,7,2,8
P'thinaikos,8773,3,2,1,3,7,9,-2,7
Panionios,8773,4,1,1,4,4,10,-6,4
AEK Athens,8774,1,4,2,0,7,1,6,14
PAOK Salonik,8774,2,2,2,2,9,6,3,8
P'thinaikos,8774,3,2,1,3,6,9,-3,7
Panionios,8774,4,1,1,4,4,10,-6,4
AEK Athens,8775,1,4,2,0,7,1,6,14
PAOK Salonik,8775,2,3,2,1,10,4,6,11
P'thinaikos,8775,3,1,1,4,4,10,-6,4
Panionios,8775,3,1,1,4,4,10,-6,4
AEK Athens,8776,1,4,2,0,7,1,6,14
PAOK Salonik,8776,2,2,2,2,9,7,2,8
P'thinaikos,8776,3,2,1,3,7,9,-2,7
Panionios,8776,4,1,1,4,4,10,-6,4
AEK Athens,8777,1,4,2,0,7,1,6,14
PAOK Salonik,8777,2,2,3,1,11,6,5,9
P'thinaikos,8777,3,1,2,3,6,11,-5,5
Panionios,8777,4,1,1,4,4,10,-6,4
AEK Athens,8778,1,4,2,0,7,1,6,14
PAOK Salonik,8778,2,2,3,1,10,5,5,9
P'thinaikos,8778,3,1,2,3,5,10,-5,5
Panionios,8778,4,1,1,4,4,10,-6,4
AEK Athens,8779,1,4,2,0,7,1,6,14
PAOK Salonik,8779,2,3,2,1,11,5,6,11
P'thinaikos,8779,3,1,1,4,5,11,-6,4
Panionios,8779,4,1,1,4,4,10,-6,4
AEK Athens,8780,1,4,2,0,7,1,6,14
PAOK Salonik,8780,2,3,2,1,12,4,8,11
Panionios,8780,3,1,1,4,4,10,-6,4
P'thinaikos,8780,4,1,1,4,4,12,-8,4
AEK Athens,8781,1,4,2,0,7,1,6,14
PAOK Salonik,8781,2,3,2,1,12,5,7,11
Panionios,8781,3,1,1,4,4,10,-6,4
P'thinaikos,8781,4,1,1,4,5,12,-7,4
AEK Athens,8782,1,4,2,0,7,1,6,14
PAOK Salonik,8782,2,2,3,1,9,4,5,9
P'thinaikos,8782,3,1,2,3,4,9,-5,5
Panionios,8782,4,1,1,4,4,10,-6,4
AEK Athens,8783,1,4,2,0,7,1,6,14
PAOK Salonik,8783,2,3,2,1,11,5,6,11
P'thinaikos,8783,3,1,1,4,5,11,-6,4
Panionios,8783,4,1,1,4,4,10,-6,4
AEK Athens,8784,1,4,2,0,7,1,6,14
PAOK Salonik,8784,2,3,2,1,11,5,6,11
P'thinaikos,8784,3,1,1,4,5,11,-6,4
Panionios,8784,4,1,1,4,4,10,-6,4
AEK Athens,8785,1,4,2,0,7,1,6,14
PAOK Salonik,8785,2,3,2,1,12,5,7,11
Panionios,8785,3,1,1,4,4,10,-6,4
P'thinaikos,8785,4,1,1,4,5,12,-7,4
AEK Athens,8786,1,4,2,0,7,1,6,14
PAOK Salonik,8786,2,2,3,1,10,5,5,9
P'thinaikos,8786,3,1,2,3,5,10,-5,5
Panionios,8786,4,1,1,4,4,10,-6,4
AEK Athens,8787,1,4,2,0,7,1,6,14
PAOK Salonik,8787,2,2,3,1,10,5,5,9
P'thinaikos,8787,3,1,2,3,5,10,-5,5
Panionios,8787,4,1,1,4,4,10,-6,4
AEK Athens,8788,1,4,2,0,7,1,6,14
PAOK Salonik,8788,2,2,2,2,10,7,3,8
P'thinaikos,8788,3,2,1,3,7,10,-3,7
Panionios,8788,4,1,1,4,4,10,-6,4
AEK Athens,8789,1,4,2,0,7,1,6,14
PAOK Salonik,8789,2,3,2,1,12,6,6,11
P'thinaikos,8789,3,1,1,4,6,12,-6,4
Panionios,8789,4,1,1,4,4,10,-6,4
AEK Athens,8790,1,4,2,0,7,1,6,14
PAOK Salonik,8790,2,2,2,2,10,7,3,8
P'thinaikos,8790,3,2,1,3,7,10,-3,7
Panionios,8790,4,1,1,4,4,10,-6,4
AEK Athens,8791,1,4,2,0,7,1,6,14
PAOK Salonik,8791,2,2,2,2,9,6,3,8
P'thinaikos,8791,3,2,1,3,6,9,-3,7
Panionios,8791,4,1,1,4,4,10,-6,4
AEK Athens,8792,1,4,2,0,7,1,6,14
PAOK Salonik,8792,2,2,3,1,9,4,5,9
P'thinaikos,8792,3,1,2,3,4,9,-5,5
Panionios,8792,4,1,1,4,4,10,-6,4
AEK Athens,8793,1,4,2,0,7,1,6,14
PAOK Salonik,8793,2,2,2,2,9,6,3,8
P'thinaikos,8793,3,2,1,3,6,9,-3,7
Panionios,8793,4,1,1,4,4,10,-6,4
AEK Athens,8794,1,4,2,0,7,1,6,14
PAOK Salonik,8794,2,2,2,2,9,5,4,8
P'thinaikos,8794,3,2,1,3,5,9,-4,7
Panionios,8794,4,1,1,4,4,10,-6,4
AEK Athens,8795,1,4,2,0,7,1,6,14
PAOK Salonik,8795,2,3,2,1,11,4,7,11
Panionios,8795,3,1,1,4,4,10,-6,4
P'thinaikos,8795,4,1,1,4,4,11,-7,4
AEK Athens,8796,1,4,2,0,7,1,6,14
PAOK Salonik,8796,2,2,2,2,9,6,3,8
P'thinaikos,8796,3,2,1,3,6,9,-3,7
Panionios,8796,4,1,1,4,4,10,-6,4
AEK Athens,8797,1,4,2,0,7,1,6,14
PAOK Salonik,8797,2,3,2,1,11,4,7,11
Panionios,8797,3,1,1,4,4,10,-6,4
P'thinaikos,8797,4,1,1,4,4,11,-7,4
AEK Athens,8798,1,4,2,0,7,1,6,14
PAOK Salonik,8798,2,3,2,1,10,4,6,11
P'thinaikos,8798,3,1,1,4,4,10,-6,4
Panionios,8798,3,1,1,4,4,10,-6,4
AEK Athens,8799,1,4,2,0,7,1,6,14
PAOK Salonik,8799,2,3,2,1,10,4,6,11
P'thinaikos,8799,3,1,1,4,4,10,-6,4
Panionios,8799,3,1,1,4,4,10,-6,4
AEK Athens,8800,1,4,2,0,7,1,6,14
PAOK Salonik,8800,2,3,2,1,10,4,6,11
P'thinaikos,8800,3,1,1,4,4,10,-6,4
Panionios,8800,3,1,1,4,4,10,-6,4
AEK Athens,8801,1,4,2,0,7,1,6,14
PAOK Salonik,8801,2,2,2,2,9,5,4,8
P'thinaikos,8801,3,2,1,3,5,9,-4,7
Panionios,8801,4,1,1,4,4,10,-6,4
AEK Athens,8802,1,4,2,0,7,1,6,14
PAOK Salonik,8802,2,2,2,2,9,6,3,8
P'thinaikos,8802,3,2,1,3,6,9,-3,7
Panionios,8802,4,1,1,4,4,10,-6,4
AEK Athens,8803,1,4,2,0,7,1,6,14
PAOK Salonik,8803,2,2,3,1,10,5,5,9
P'thinaikos,8803,3,1,2,3,5,10,-5,5
Panionios,8803,4,1,1,4,4,10,-6,4
AEK Athens,8804,1,4,2,0,7,1,6,14
PAOK Salonik,8804,2,2,2,2,12,9,3,8
P'thinaikos,8804,3,2,1,3,9,12,-3,7
Panionios,8804,4,1,1,4,4,10,-6,4
AEK Athens,8805,1,4,2,0,7,1,6,14
PAOK Salonik,8805,2,3,2,1,11,5,6,11
P'thinaikos,8805,3,1,1,4,5,11,-6,4
Panionios,8805,4,1,1,4,4,10,-6,4
AEK Athens,8806,1,4,2,0,7,1,6,14
PAOK Salonik,8806,2,3,2,1,10,4,6,11
P'thinaikos,8806,3,1,1,4,4,10,-6,4
Panionios,8806,3,1,1,4,4,10,-6,4
AEK Athens,8807,1,4,2,0,7,1,6,14
PAOK Salonik,8807,2,2,2,2,9,6,3,8
P'thinaikos,8807,3,2,1,3,6,9,-3,7
Panionios,8807,4,1,1,4,4,10,-6,4
AEK Athens,8808,1,4,2,0,7,1,6,14
PAOK Salonik,8808,2,2,2,2,9,6,3,8
P'thinaikos,8808,3,2,1,3,6,9,-3,7
Panionios,8808,4,1,1,4,4,10,-6,4
AEK Athens,8809,1,4,2,0,7,1,6,14
PAOK Salonik,8809,2,3,2,1,11,5,6,11
P'thinaikos,8809,3,1,1,4,5,11,-6,4
Panionios,8809,4,1,1,4,4,10,-6,4
AEK Athens,8810,1,4,2,0,7,1,6,14
PAOK Salonik,8810,2,3,2,1,11,4,7,11
Panionios,8810,3,1,1,4,4,10,-6,4
P'thinaikos,8810,4,1,1,4,4,11,-7,4
AEK Athens,8811,1,4,2,0,7,1,6,14
PAOK Salonik,8811,2,3,2,1,10,4,6,11
P'thinaikos,8811,3,1,1,4,4,10,-6,4
Panionios,8811,3,1,1,4,4,10,-6,4
AEK Athens,8812,1,4,2,0,7,1,6,14
PAOK Salonik,8812,2,2,2,2,9,5,4,8
P'thinaikos,8812,3,2,1,3,5,9,-4,7
Panionios,8812,4,1,1,4,4,10,-6,4
AEK Athens,8813,1,4,2,0,7,1,6,14
PAOK Salonik,8813,2,2,3,1,10,5,5,9
P'thinaikos,8813,3,1,2,3,5,10,-5,5
Panionios,8813,4,1,1,4,4,10,-6,4
AEK Athens,8814,1,4,2,0,7,1,6,14
PAOK Salonik,8814,2,2,2,2,10,8,2,8
P'thinaikos,8814,3,2,1,3,8,10,-2,7
Panionios,8814,4,1,1,4,4,10,-6,4
AEK Athens,8815,1,4,2,0,7,1,6,14
PAOK Salonik,8815,2,3,2,1,10,4,6,11
P'thinaikos,8815,3,1,1,4,4,10,-6,4
Panionios,8815,3,1,1,4,4,10,-6,4
AEK Athens,8816,1,4,2,0,7,1,6,14
PAOK Salonik,8816,2,3,2,1,11,5,6,11
P'thinaikos,8816,3,1,1,4,5,11,-6,4
Panionios,8816,4,1,1,4,4,10,-6,4
AEK Athens,8817,1,4,2,0,7,1,6,14
PAOK Salonik,8817,2,3,2,1,10,4,6,11
P'thinaikos,8817,3,1,1,4,4,10,-6,4
Panionios,8817,3,1,1,4,4,10,-6,4
AEK Athens,8818,1,4,2,0,7,1,6,14
PAOK Salonik,8818,2,2,2,2,11,9,2,8
P'thinaikos,8818,3,2,1,3,9,11,-2,7
Panionios,8818,4,1,1,4,4,10,-6,4
AEK Athens,8819,1,4,2,0,7,1,6,14
PAOK Salonik,8819,2,3,2,1,12,4,8,11
Panionios,8819,3,1,1,4,4,10,-6,4
P'thinaikos,8819,4,1,1,4,4,12,-8,4
AEK Athens,8820,1,4,2,0,7,1,6,14
PAOK Salonik,8820,2,2,2,2,10,7,3,8
P'thinaikos,8820,3,2,1,3,7,10,-3,7
Panionios,8820,4,1,1,4,4,10,-6,4
AEK Athens,8821,1,4,2,0,7,1,6,14
PAOK Salonik,8821,2,2,3,1,10,5,5,9
P'thinaikos,8821,3,1,2,3,5,10,-5,5
Panionios,8821,4,1,1,4,4,10,-6,4
AEK Athens,8822,1,4,2,0,7,1,6,14
PAOK Salonik,8822,2,2,2,2,10,8,2,8
P'thinaikos,8822,3,2,1,3,8,10,-2,7
Panionios,8822,4,1,1,4,4,10,-6,4
AEK Athens,8823,1,4,2,0,7,1,6,14
PAOK Salonik,8823,2,2,3,1,10,5,5,9
P'thinaikos,8823,3,1,2,3,5,10,-5,5
Panionios,8823,4,1,1,4,4,10,-6,4
AEK Athens,8824,1,4,2,0,7,1,6,14
PAOK Salonik,8824,2,2,2,2,9,5,4,8
P'thinaikos,8824,3,2,1,3,5,9,-4,7
Panionios,8824,4,1,1,4,4,10,-6,4
AEK Athens,8825,1,4,2,0,7,1,6,14
PAOK Salonik,8825,2,2,2,2,9,6,3,8
P'thinaikos,8825,3,2,1,3,6,9,-3,7
Panionios,8825,4,1,1,4,4,10,-6,4
AEK Athens,8826,1,4,2,0,7,1,6,14
PAOK Salonik,8826,2,2,2,2,10,8,2,8
P'thinaikos,8826,3,2,1,3,8,10,-2,7
Panionios,8826,4,1,1,4,4,10,-6,4
AEK Athens,8827,1,4,2,0,7,1,6,14
PAOK Salonik,8827,2,2,3,1,9,4,5,9
P'thinaikos,8827,3,1,2,3,4,9,-5,5
Panionios,8827,4,1,1,4,4,10,-6,4
AEK Athens,8828,1,4,2,0,7,1,6,14
PAOK Salonik,8828,2,2,3,1,11,6,5,9
P'thinaikos,8828,3,1,2,3,6,11,-5,5
Panionios,8828,4,1,1,4,4,10,-6,4
AEK Athens,8829,1,4,2,0,7,1,6,14
PAOK Salonik,8829,2,3,2,1,10,4,6,11
P'thinaikos,8829,3,1,1,4,4,10,-6,4
Panionios,8829,3,1,1,4,4,10,-6,4
AEK Athens,8830,1,4,2,0,7,1,6,14
PAOK Salonik,8830,2,2,3,1,9,4,5,9
P'thinaikos,8830,3,1,2,3,4,9,-5,5
Panionios,8830,4,1,1,4,4,10,-6,4
AEK Athens,8831,1,4,2,0,7,1,6,14
PAOK Salonik,8831,2,2,2,2,11,7,4,8
P'thinaikos,8831,3,2,1,3,7,11,-4,7
Panionios,8831,4,1,1,4,4,10,-6,4
AEK Athens,8832,1,4,2,0,7,1,6,14
PAOK Salonik,8832,2,3,2,1,11,4,7,11
Panionios,8832,3,1,1,4,4,10,-6,4
P'thinaikos,8832,4,1,1,4,4,11,-7,4
AEK Athens,8833,1,4,2,0,7,1,6,14
PAOK Salonik,8833,2,2,2,2,11,8,3,8
P'thinaikos,8833,3,2,1,3,8,11,-3,7
Panionios,8833,4,1,1,4,4,10,-6,4
AEK Athens,8834,1,4,2,0,7,1,6,14
PAOK Salonik,8834,2,3,2,1,13,4,9,11
Panionios,8834,3,1,1,4,4,10,-6,4
P'thinaikos,8834,4,1,1,4,4,13,-9,4
AEK Athens,8835,1,4,2,0,7,1,6,14
PAOK Salonik,8835,2,2,3,1,10,5,5,9
P'thinaikos,8835,3,1,2,3,5,10,-5,5
Panionios,8835,4,1,1,4,4,10,-6,4
AEK Athens,8836,1,4,2,0,7,1,6,14
PAOK Salonik,8836,2,2,2,2,10,6,4,8
P'thinaikos,8836,3,2,1,3,6,10,-4,7
Panionios,8836,4,1,1,4,4,10,-6,4
AEK Athens,8837,1,4,2,0,7,1,6,14
PAOK Salonik,8837,2,2,2,2,10,6,4,8
P'thinaikos,8837,3,2,1,3,6,10,-4,7
Panionios,8837,4,1,1,4,4,10,-6,4
AEK Athens,8838,1,4,2,0,7,1,6,14
PAOK Salonik,8838,2,2,2,2,10,6,4,8
P'thinaikos,8838,3,2,1,3,6,10,-4,7
Panionios,8838,4,1,1,4,4,10,-6,4
AEK Athens,8839,1,4,2,0,7,1,6,14
PAOK Salonik,8839,2,2,3,1,9,4,5,9
P'thinaikos,8839,3,1,2,3,4,9,-5,5
Panionios,8839,4,1,1,4,4,10,-6,4
AEK Athens,8840,1,4,2,0,7,1,6,14
PAOK Salonik,8840,2,2,3,1,11,6,5,9
P'thinaikos,8840,3,1,2,3,6,11,-5,5
Panionios,8840,4,1,1,4,4,10,-6,4
AEK Athens,8841,1,4,2,0,7,1,6,14
PAOK Salonik,8841,2,2,2,2,9,5,4,8
P'thinaikos,8841,3,2,1,3,5,9,-4,7
Panionios,8841,4,1,1,4,4,10,-6,4
AEK Athens,8842,1,4,2,0,7,1,6,14
PAOK Salonik,8842,2,2,2,2,9,5,4,8
P'thinaikos,8842,3,2,1,3,5,9,-4,7
Panionios,8842,4,1,1,4,4,10,-6,4
AEK Athens,8843,1,4,2,0,7,1,6,14
PAOK Salonik,8843,2,3,2,1,10,4,6,11
P'thinaikos,8843,3,1,1,4,4,10,-6,4
Panionios,8843,3,1,1,4,4,10,-6,4
AEK Athens,8844,1,4,2,0,7,1,6,14
PAOK Salonik,8844,2,2,3,1,10,5,5,9
P'thinaikos,8844,3,1,2,3,5,10,-5,5
Panionios,8844,4,1,1,4,4,10,-6,4
AEK Athens,8845,1,4,2,0,7,1,6,14
PAOK Salonik,8845,2,2,2,2,10,7,3,8
P'thinaikos,8845,3,2,1,3,7,10,-3,7
Panionios,8845,4,1,1,4,4,10,-6,4
AEK Athens,8846,1,4,2,0,7,1,6,14
PAOK Salonik,8846,2,2,3,1,10,5,5,9
P'thinaikos,8846,3,1,2,3,5,10,-5,5
Panionios,8846,4,1,1,4,4,10,-6,4
AEK Athens,8847,1,4,2,0,7,1,6,14
PAOK Salonik,8847,2,3,2,1,10,4,6,11
P'thinaikos,8847,3,1,1,4,4,10,-6,4
Panionios,8847,3,1,1,4,4,10,-6,4
AEK Athens,8848,1,4,2,0,7,1,6,14
PAOK Salonik,8848,2,2,3,1,9,4,5,9
P'thinaikos,8848,3,1,2,3,4,9,-5,5
Panionios,8848,4,1,1,4,4,10,-6,4
AEK Athens,8849,1,4,2,0,7,1,6,14
PAOK Salonik,8849,2,3,2,1,10,4,6,11
P'thinaikos,8849,3,1,1,4,4,10,-6,4
Panionios,8849,3,1,1,4,4,10,-6,4
AEK Athens,8850,1,4,2,0,7,1,6,14
PAOK Salonik,8850,2,2,3,1,11,6,5,9
P'thinaikos,8850,3,1,2,3,6,11,-5,5
Panionios,8850,4,1,1,4,4,10,-6,4
AEK Athens,8851,1,4,2,0,7,1,6,14
PAOK Salonik,8851,2,2,2,2,11,8,3,8
P'thinaikos,8851,3,2,1,3,8,11,-3,7
Panionios,8851,4,1,1,4,4,10,-6,4
AEK Athens,8852,1,4,2,0,7,1,6,14
PAOK Salonik,8852,2,2,2,2,9,5,4,8
P'thinaikos,8852,3,2,1,3,5,9,-4,7
Panionios,8852,4,1,1,4,4,10,-6,4
AEK Athens,8853,1,4,2,0,7,1,6,14
PAOK Salonik,8853,2,2,2,2,10,7,3,8
P'thinaikos,8853,3,2,1,3,7,10,-3,7
Panionios,8853,4,1,1,4,4,10,-6,4
AEK Athens,8854,1,4,2,0,7,1,6,14
PAOK Salonik,8854,2,2,2,2,10,6,4,8
P'thinaikos,8854,3,2,1,3,6,10,-4,7
Panionios,8854,4,1,1,4,4,10,-6,4
AEK Athens,8855,1,4,2,0,7,1,6,14
PAOK Salonik,8855,2,2,3,1,10,5,5,9
P'thinaikos,8855,3,1,2,3,5,10,-5,5
Panionios,8855,4,1,1,4,4,10,-6,4
AEK Athens,8856,1,4,2,0,7,1,6,14
PAOK Salonik,8856,2,3,2,1,11,4,7,11
Panionios,8856,3,1,1,4,4,10,-6,4
P'thinaikos,8856,4,1,1,4,4,11,-7,4
AEK Athens,8857,1,4,2,0,7,1,6,14
PAOK Salonik,8857,2,2,3,1,9,4,5,9
P'thinaikos,8857,3,1,2,3,4,9,-5,5
Panionios,8857,4,1,1,4,4,10,-6,4
AEK Athens,8858,1,4,2,0,7,1,6,14
PAOK Salonik,8858,2,2,2,2,10,7,3,8
P'thinaikos,8858,3,2,1,3,7,10,-3,7
Panionios,8858,4,1,1,4,4,10,-6,4
AEK Athens,8859,1,4,2,0,7,1,6,14
PAOK Salonik,8859,2,2,3,1,10,5,5,9
P'thinaikos,8859,3,1,2,3,5,10,-5,5
Panionios,8859,4,1,1,4,4,10,-6,4
AEK Athens,8860,1,4,2,0,7,1,6,14
PAOK Salonik,8860,2,2,2,2,10,6,4,8
P'thinaikos,8860,3,2,1,3,6,10,-4,7
Panionios,8860,4,1,1,4,4,10,-6,4
AEK Athens,8861,1,4,2,0,7,1,6,14
PAOK Salonik,8861,2,2,2,2,10,6,4,8
P'thinaikos,8861,3,2,1,3,6,10,-4,7
Panionios,8861,4,1,1,4,4,10,-6,4
AEK Athens,8862,1,4,2,0,7,1,6,14
PAOK Salonik,8862,2,2,3,1,10,5,5,9
P'thinaikos,8862,3,1,2,3,5,10,-5,5
Panionios,8862,4,1,1,4,4,10,-6,4
AEK Athens,8863,1,4,2,0,7,1,6,14
PAOK Salonik,8863,2,2,2,2,10,7,3,8
P'thinaikos,8863,3,2,1,3,7,10,-3,7
Panionios,8863,4,1,1,4,4,10,-6,4
AEK Athens,8864,1,4,2,0,7,1,6,14
PAOK Salonik,8864,2,2,2,2,9,7,2,8
P'thinaikos,8864,3,2,1,3,7,9,-2,7
Panionios,8864,4,1,1,4,4,10,-6,4
AEK Athens,8865,1,4,2,0,7,1,6,14
PAOK Salonik,8865,2,2,2,2,10,8,2,8
P'thinaikos,8865,3,2,1,3,8,10,-2,7
Panionios,8865,4,1,1,4,4,10,-6,4
AEK Athens,8866,1,4,2,0,7,1,6,14
PAOK Salonik,8866,2,3,2,1,10,4,6,11
P'thinaikos,8866,3,1,1,4,4,10,-6,4
Panionios,8866,3,1,1,4,4,10,-6,4
AEK Athens,8867,1,4,2,0,7,1,6,14
PAOK Salonik,8867,2,2,3,1,9,4,5,9
P'thinaikos,8867,3,1,2,3,4,9,-5,5
Panionios,8867,4,1,1,4,4,10,-6,4
AEK Athens,8868,1,4,2,0,7,1,6,14
PAOK Salonik,8868,2,2,3,1,9,4,5,9
P'thinaikos,8868,3,1,2,3,4,9,-5,5
Panionios,8868,4,1,1,4,4,10,-6,4
AEK Athens,8869,1,4,2,0,7,1,6,14
PAOK Salonik,8869,2,2,2,2,10,8,2,8
P'thinaikos,8869,3,2,1,3,8,10,-2,7
Panionios,8869,4,1,1,4,4,10,-6,4
AEK Athens,8870,1,4,2,0,7,1,6,14
PAOK Salonik,8870,2,2,2,2,10,7,3,8
P'thinaikos,8870,3,2,1,3,7,10,-3,7
Panionios,8870,4,1,1,4,4,10,-6,4
AEK Athens,8871,1,4,2,0,7,1,6,14
PAOK Salonik,8871,2,2,2,2,9,5,4,8
P'thinaikos,8871,3,2,1,3,5,9,-4,7
Panionios,8871,4,1,1,4,4,10,-6,4
AEK Athens,8872,1,4,2,0,7,1,6,14
PAOK Salonik,8872,2,2,2,2,10,6,4,8
P'thinaikos,8872,3,2,1,3,6,10,-4,7
Panionios,8872,4,1,1,4,4,10,-6,4
AEK Athens,8873,1,4,2,0,7,1,6,14
PAOK Salonik,8873,2,3,2,1,10,4,6,11
P'thinaikos,8873,3,1,1,4,4,10,-6,4
Panionios,8873,3,1,1,4,4,10,-6,4
AEK Athens,8874,1,4,2,0,7,1,6,14
PAOK Salonik,8874,2,2,3,1,11,6,5,9
P'thinaikos,8874,3,1,2,3,6,11,-5,5
Panionios,8874,4,1,1,4,4,10,-6,4
AEK Athens,8875,1,4,2,0,7,1,6,14
PAOK Salonik,8875,2,3,2,1,11,5,6,11
P'thinaikos,8875,3,1,1,4,5,11,-6,4
Panionios,8875,4,1,1,4,4,10,-6,4
AEK Athens,8876,1,4,2,0,7,1,6,14
PAOK Salonik,8876,2,2,2,2,11,7,4,8
P'thinaikos,8876,3,2,1,3,7,11,-4,7
Panionios,8876,4,1,1,4,4,10,-6,4
AEK Athens,8877,1,4,2,0,7,1,6,14
PAOK Salonik,8877,2,2,3,1,10,5,5,9
P'thinaikos,8877,3,1,2,3,5,10,-5,5
Panionios,8877,4,1,1,4,4,10,-6,4
AEK Athens,8878,1,4,2,0,7,1,6,14
PAOK Salonik,8878,2,3,2,1,11,4,7,11
Panionios,8878,3,1,1,4,4,10,-6,4
P'thinaikos,8878,4,1,1,4,4,11,-7,4
AEK Athens,8879,1,4,2,0,7,1,6,14
PAOK Salonik,8879,2,3,2,1,13,4,9,11
Panionios,8879,3,1,1,4,4,10,-6,4
P'thinaikos,8879,4,1,1,4,4,13,-9,4
AEK Athens,8880,1,4,2,0,7,1,6,14
PAOK Salonik,8880,2,2,3,1,10,5,5,9
P'thinaikos,8880,3,1,2,3,5,10,-5,5
Panionios,8880,4,1,1,4,4,10,-6,4
AEK Athens,8881,1,4,2,0,7,1,6,14
PAOK Salonik,8881,2,2,2,2,9,5,4,8
P'thinaikos,8881,3,2,1,3,5,9,-4,7
Panionios,8881,4,1,1,4,4,10,-6,4
AEK Athens,8882,1,4,2,0,7,1,6,14
PAOK Salonik,8882,2,2,2,2,9,5,4,8
P'thinaikos,8882,3,2,1,3,5,9,-4,7
Panionios,8882,4,1,1,4,4,10,-6,4
AEK Athens,8883,1,4,2,0,7,1,6,14
PAOK Salonik,8883,2,2,3,1,10,5,5,9
P'thinaikos,8883,3,1,2,3,5,10,-5,5
Panionios,8883,4,1,1,4,4,10,-6,4
AEK Athens,8884,1,4,2,0,7,1,6,14
PAOK Salonik,8884,2,2,2,2,10,8,2,8
P'thinaikos,8884,3,2,1,3,8,10,-2,7
Panionios,8884,4,1,1,4,4,10,-6,4
AEK Athens,8885,1,4,2,0,7,1,6,14
PAOK Salonik,8885,2,2,2,2,9,5,4,8
P'thinaikos,8885,3,2,1,3,5,9,-4,7
Panionios,8885,4,1,1,4,4,10,-6,4
AEK Athens,8886,1,4,2,0,7,1,6,14
PAOK Salonik,8886,2,2,2,2,10,7,3,8
P'thinaikos,8886,3,2,1,3,7,10,-3,7
Panionios,8886,4,1,1,4,4,10,-6,4
AEK Athens,8887,1,4,2,0,7,1,6,14
PAOK Salonik,8887,2,2,3,1,10,5,5,9
P'thinaikos,8887,3,1,2,3,5,10,-5,5
Panionios,8887,4,1,1,4,4,10,-6,4
AEK Athens,8888,1,4,2,0,7,1,6,14
PAOK Salonik,8888,2,2,3,1,10,5,5,9
P'thinaikos,8888,3,1,2,3,5,10,-5,5
Panionios,8888,4,1,1,4,4,10,-6,4
AEK Athens,8889,1,4,2,0,7,1,6,14
PAOK Salonik,8889,2,2,2,2,10,8,2,8
P'thinaikos,8889,3,2,1,3,8,10,-2,7
Panionios,8889,4,1,1,4,4,10,-6,4
AEK Athens,8890,1,4,2,0,7,1,6,14
PAOK Salonik,8890,2,2,3,1,10,5,5,9
P'thinaikos,8890,3,1,2,3,5,10,-5,5
Panionios,8890,4,1,1,4,4,10,-6,4
AEK Athens,8891,1,4,2,0,7,1,6,14
PAOK Salonik,8891,2,2,2,2,9,5,4,8
P'thinaikos,8891,3,2,1,3,5,9,-4,7
Panionios,8891,4,1,1,4,4,10,-6,4
AEK Athens,8892,1,4,2,0,7,1,6,14
PAOK Salonik,8892,2,2,2,2,11,7,4,8
P'thinaikos,8892,3,2,1,3,7,11,-4,7
Panionios,8892,4,1,1,4,4,10,-6,4
AEK Athens,8893,1,4,2,0,7,1,6,14
PAOK Salonik,8893,2,3,2,1,13,6,7,11
Panionios,8893,3,1,1,4,4,10,-6,4
P'thinaikos,8893,4,1,1,4,6,13,-7,4
AEK Athens,8894,1,4,2,0,7,1,6,14
PAOK Salonik,8894,2,3,2,1,11,4,7,11
Panionios,8894,3,1,1,4,4,10,-6,4
P'thinaikos,8894,4,1,1,4,4,11,-7,4
AEK Athens,8895,1,4,2,0,7,1,6,14
PAOK Salonik,8895,2,2,2,2,9,6,3,8
P'thinaikos,8895,3,2,1,3,6,9,-3,7
Panionios,8895,4,1,1,4,4,10,-6,4
AEK Athens,8896,1,4,2,0,7,1,6,14
PAOK Salonik,8896,2,3,2,1,11,5,6,11
P'thinaikos,8896,3,1,1,4,5,11,-6,4
Panionios,8896,4,1,1,4,4,10,-6,4
AEK Athens,8897,1,4,2,0,7,1,6,14
PAOK Salonik,8897,2,2,2,2,10,6,4,8
P'thinaikos,8897,3,2,1,3,6,10,-4,7
Panionios,8897,4,1,1,4,4,10,-6,4
AEK Athens,8898,1,4,2,0,7,1,6,14
PAOK Salonik,8898,2,3,2,1,11,5,6,11
P'thinaikos,8898,3,1,1,4,5,11,-6,4
Panionios,8898,4,1,1,4,4,10,-6,4
AEK Athens,8899,1,4,2,0,7,1,6,14
PAOK Salonik,8899,2,2,3,1,11,6,5,9
P'thinaikos,8899,3,1,2,3,6,11,-5,5
Panionios,8899,4,1,1,4,4,10,-6,4
AEK Athens,8900,1,4,2,0,7,1,6,14
PAOK Salonik,8900,2,2,2,2,9,5,4,8
P'thinaikos,8900,3,2,1,3,5,9,-4,7
Panionios,8900,4,1,1,4,4,10,-6,4
AEK Athens,8901,1,4,2,0,7,1,6,14
PAOK Salonik,8901,2,2,2,2,9,6,3,8
P'thinaikos,8901,3,2,1,3,6,9,-3,7
Panionios,8901,4,1,1,4,4,10,-6,4
AEK Athens,8902,1,4,2,0,7,1,6,14
PAOK Salonik,8902,2,3,2,1,11,4,7,11
Panionios,8902,3,1,1,4,4,10,-6,4
P'thinaikos,8902,4,1,1,4,4,11,-7,4
AEK Athens,8903,1,4,2,0,7,1,6,14
PAOK Salonik,8903,2,3,2,1,10,4,6,11
P'thinaikos,8903,3,1,1,4,4,10,-6,4
Panionios,8903,3,1,1,4,4,10,-6,4
AEK Athens,8904,1,4,2,0,7,1,6,14
PAOK Salonik,8904,2,3,2,1,13,4,9,11
Panionios,8904,3,1,1,4,4,10,-6,4
P'thinaikos,8904,4,1,1,4,4,13,-9,4
AEK Athens,8905,1,4,2,0,7,1,6,14
PAOK Salonik,8905,2,3,2,1,11,5,6,11
P'thinaikos,8905,3,1,1,4,5,11,-6,4
Panionios,8905,4,1,1,4,4,10,-6,4
AEK Athens,8906,1,4,2,0,7,1,6,14
PAOK Salonik,8906,2,3,2,1,11,4,7,11
Panionios,8906,3,1,1,4,4,10,-6,4
P'thinaikos,8906,4,1,1,4,4,11,-7,4
AEK Athens,8907,1,4,2,0,7,1,6,14
PAOK Salonik,8907,2,2,2,2,9,6,3,8
P'thinaikos,8907,3,2,1,3,6,9,-3,7
Panionios,8907,4,1,1,4,4,10,-6,4
AEK Athens,8908,1,4,2,0,7,1,6,14
PAOK Salonik,8908,2,2,2,2,9,6,3,8
P'thinaikos,8908,3,2,1,3,6,9,-3,7
Panionios,8908,4,1,1,4,4,10,-6,4
AEK Athens,8909,1,4,2,0,7,1,6,14
PAOK Salonik,8909,2,2,2,2,10,8,2,8
P'thinaikos,8909,3,2,1,3,8,10,-2,7
Panionios,8909,4,1,1,4,4,10,-6,4
AEK Athens,8910,1,4,2,0,7,1,6,14
PAOK Salonik,8910,2,2,2,2,10,6,4,8
P'thinaikos,8910,3,2,1,3,6,10,-4,7
Panionios,8910,4,1,1,4,4,10,-6,4
AEK Athens,8911,1,4,2,0,7,1,6,14
PAOK Salonik,8911,2,3,2,1,10,4,6,11
P'thinaikos,8911,3,1,1,4,4,10,-6,4
Panionios,8911,3,1,1,4,4,10,-6,4
AEK Athens,8912,1,4,2,0,7,1,6,14
PAOK Salonik,8912,2,2,2,2,9,5,4,8
P'thinaikos,8912,3,2,1,3,5,9,-4,7
Panionios,8912,4,1,1,4,4,10,-6,4
AEK Athens,8913,1,4,2,0,7,1,6,14
PAOK Salonik,8913,2,2,3,1,10,5,5,9
P'thinaikos,8913,3,1,2,3,5,10,-5,5
Panionios,8913,4,1,1,4,4,10,-6,4
AEK Athens,8914,1,4,2,0,7,1,6,14
PAOK Salonik,8914,2,2,3,1,10,5,5,9
P'thinaikos,8914,3,1,2,3,5,10,-5,5
Panionios,8914,4,1,1,4,4,10,-6,4
AEK Athens,8915,1,4,2,0,7,1,6,14
PAOK Salonik,8915,2,2,2,2,9,6,3,8
P'thinaikos,8915,3,2,1,3,6,9,-3,7
Panionios,8915,4,1,1,4,4,10,-6,4
AEK Athens,8916,1,4,2,0,7,1,6,14
PAOK Salonik,8916,2,2,3,1,9,4,5,9
P'thinaikos,8916,3,1,2,3,4,9,-5,5
Panionios,8916,4,1,1,4,4,10,-6,4
AEK Athens,8917,1,4,2,0,7,1,6,14
PAOK Salonik,8917,2,3,2,1,11,4,7,11
Panionios,8917,3,1,1,4,4,10,-6,4
P'thinaikos,8917,4,1,1,4,4,11,-7,4
AEK Athens,8918,1,4,2,0,7,1,6,14
PAOK Salonik,8918,2,2,3,1,10,5,5,9
P'thinaikos,8918,3,1,2,3,5,10,-5,5
Panionios,8918,4,1,1,4,4,10,-6,4
AEK Athens,8919,1,4,2,0,7,1,6,14
PAOK Salonik,8919,2,3,2,1,13,5,8,11
Panionios,8919,3,1,1,4,4,10,-6,4
P'thinaikos,8919,4,1,1,4,5,13,-8,4
AEK Athens,8920,1,4,2,0,7,1,6,14
PAOK Salonik,8920,2,2,3,1,10,5,5,9
P'thinaikos,8920,3,1,2,3,5,10,-5,5
Panionios,8920,4,1,1,4,4,10,-6,4
AEK Athens,8921,1,4,2,0,7,1,6,14
PAOK Salonik,8921,2,2,2,2,10,6,4,8
P'thinaikos,8921,3,2,1,3,6,10,-4,7
Panionios,8921,4,1,1,4,4,10,-6,4
AEK Athens,8922,1,4,2,0,7,1,6,14
PAOK Salonik,8922,2,2,3,1,12,7,5,9
P'thinaikos,8922,3,1,2,3,7,12,-5,5
Panionios,8922,4,1,1,4,4,10,-6,4
AEK Athens,8923,1,4,2,0,7,1,6,14
PAOK Salonik,8923,2,2,2,2,10,11,-1,8
P'thinaikos,8923,3,2,1,3,11,10,1,7
Panionios,8923,4,1,1,4,4,10,-6,4
AEK Athens,8924,1,4,2,0,7,1,6,14
PAOK Salonik,8924,2,2,2,2,11,7,4,8
P'thinaikos,8924,3,2,1,3,7,11,-4,7
Panionios,8924,4,1,1,4,4,10,-6,4
AEK Athens,8925,1,4,2,0,7,1,6,14
PAOK Salonik,8925,2,3,2,1,11,4,7,11
Panionios,8925,3,1,1,4,4,10,-6,4
P'thinaikos,8925,4,1,1,4,4,11,-7,4
AEK Athens,8926,1,4,2,0,7,1,6,14
PAOK Salonik,8926,2,3,2,1,11,4,7,11
Panionios,8926,3,1,1,4,4,10,-6,4
P'thinaikos,8926,4,1,1,4,4,11,-7,4
AEK Athens,8927,1,4,2,0,7,1,6,14
PAOK Salonik,8927,2,2,3,1,9,4,5,9
P'thinaikos,8927,3,1,2,3,4,9,-5,5
Panionios,8927,4,1,1,4,4,10,-6,4
AEK Athens,8928,1,4,2,0,7,1,6,14
PAOK Salonik,8928,2,2,3,1,9,4,5,9
P'thinaikos,8928,3,1,2,3,4,9,-5,5
Panionios,8928,4,1,1,4,4,10,-6,4
AEK Athens,8929,1,4,2,0,7,1,6,14
PAOK Salonik,8929,2,2,3,1,10,5,5,9
P'thinaikos,8929,3,1,2,3,5,10,-5,5
Panionios,8929,4,1,1,4,4,10,-6,4
AEK Athens,8930,1,4,2,0,7,1,6,14
PAOK Salonik,8930,2,2,2,2,10,6,4,8
P'thinaikos,8930,3,2,1,3,6,10,-4,7
Panionios,8930,4,1,1,4,4,10,-6,4
AEK Athens,8931,1,4,2,0,7,1,6,14
PAOK Salonik,8931,2,2,3,1,10,5,5,9
P'thinaikos,8931,3,1,2,3,5,10,-5,5
Panionios,8931,4,1,1,4,4,10,-6,4
AEK Athens,8932,1,4,2,0,7,1,6,14
PAOK Salonik,8932,2,2,3,1,10,5,5,9
P'thinaikos,8932,3,1,2,3,5,10,-5,5
Panionios,8932,4,1,1,4,4,10,-6,4
AEK Athens,8933,1,4,2,0,7,1,6,14
PAOK Salonik,8933,2,2,2,2,10,8,2,8
P'thinaikos,8933,3,2,1,3,8,10,-2,7
Panionios,8933,4,1,1,4,4,10,-6,4
AEK Athens,8934,1,4,2,0,7,1,6,14
PAOK Salonik,8934,2,3,2,1,12,4,8,11
Panionios,8934,3,1,1,4,4,10,-6,4
P'thinaikos,8934,4,1,1,4,4,12,-8,4
AEK Athens,8935,1,4,2,0,7,1,6,14
PAOK Salonik,8935,2,2,2,2,9,5,4,8
P'thinaikos,8935,3,2,1,3,5,9,-4,7
Panionios,8935,4,1,1,4,4,10,-6,4
AEK Athens,8936,1,4,2,0,7,1,6,14
PAOK Salonik,8936,2,2,2,2,10,6,4,8
P'thinaikos,8936,3,2,1,3,6,10,-4,7
Panionios,8936,4,1,1,4,4,10,-6,4
AEK Athens,8937,1,4,2,0,7,1,6,14
PAOK Salonik,8937,2,2,2,2,10,9,1,8
P'thinaikos,8937,3,2,1,3,9,10,-1,7
Panionios,8937,4,1,1,4,4,10,-6,4
AEK Athens,8938,1,4,2,0,7,1,6,14
PAOK Salonik,8938,2,2,2,2,10,8,2,8
P'thinaikos,8938,3,2,1,3,8,10,-2,7
Panionios,8938,4,1,1,4,4,10,-6,4
AEK Athens,8939,1,4,2,0,7,1,6,14
PAOK Salonik,8939,2,2,3,1,9,4,5,9
P'thinaikos,8939,3,1,2,3,4,9,-5,5
Panionios,8939,4,1,1,4,4,10,-6,4
AEK Athens,8940,1,4,2,0,7,1,6,14
PAOK Salonik,8940,2,3,2,1,11,5,6,11
P'thinaikos,8940,3,1,1,4,5,11,-6,4
Panionios,8940,4,1,1,4,4,10,-6,4
AEK Athens,8941,1,4,2,0,7,1,6,14
PAOK Salonik,8941,2,3,2,1,10,4,6,11
P'thinaikos,8941,3,1,1,4,4,10,-6,4
Panionios,8941,3,1,1,4,4,10,-6,4
AEK Athens,8942,1,4,2,0,7,1,6,14
PAOK Salonik,8942,2,2,2,2,9,7,2,8
P'thinaikos,8942,3,2,1,3,7,9,-2,7
Panionios,8942,4,1,1,4,4,10,-6,4
AEK Athens,8943,1,4,2,0,7,1,6,14
PAOK Salonik,8943,2,3,2,1,10,4,6,11
P'thinaikos,8943,3,1,1,4,4,10,-6,4
Panionios,8943,3,1,1,4,4,10,-6,4
AEK Athens,8944,1,4,2,0,7,1,6,14
PAOK Salonik,8944,2,2,3,1,10,5,5,9
P'thinaikos,8944,3,1,2,3,5,10,-5,5
Panionios,8944,4,1,1,4,4,10,-6,4
AEK Athens,8945,1,4,2,0,7,1,6,14
PAOK Salonik,8945,2,2,2,2,10,6,4,8
P'thinaikos,8945,3,2,1,3,6,10,-4,7
Panionios,8945,4,1,1,4,4,10,-6,4
AEK Athens,8946,1,4,2,0,7,1,6,14
PAOK Salonik,8946,2,2,2,2,10,7,3,8
P'thinaikos,8946,3,2,1,3,7,10,-3,7
Panionios,8946,4,1,1,4,4,10,-6,4
AEK Athens,8947,1,4,2,0,7,1,6,14
PAOK Salonik,8947,2,3,2,1,11,4,7,11
Panionios,8947,3,1,1,4,4,10,-6,4
P'thinaikos,8947,4,1,1,4,4,11,-7,4
AEK Athens,8948,1,4,2,0,7,1,6,14
PAOK Salonik,8948,2,2,2,2,10,8,2,8
P'thinaikos,8948,3,2,1,3,8,10,-2,7
Panionios,8948,4,1,1,4,4,10,-6,4
AEK Athens,8949,1,4,2,0,7,1,6,14
PAOK Salonik,8949,2,3,2,1,11,4,7,11
Panionios,8949,3,1,1,4,4,10,-6,4
P'thinaikos,8949,4,1,1,4,4,11,-7,4
AEK Athens,8950,1,4,2,0,7,1,6,14
PAOK Salonik,8950,2,2,3,1,10,5,5,9
P'thinaikos,8950,3,1,2,3,5,10,-5,5
Panionios,8950,4,1,1,4,4,10,-6,4
AEK Athens,8951,1,4,2,0,7,1,6,14
PAOK Salonik,8951,2,2,2,2,10,7,3,8
P'thinaikos,8951,3,2,1,3,7,10,-3,7
Panionios,8951,4,1,1,4,4,10,-6,4
AEK Athens,8952,1,4,2,0,7,1,6,14
PAOK Salonik,8952,2,2,3,1,9,4,5,9
P'thinaikos,8952,3,1,2,3,4,9,-5,5
Panionios,8952,4,1,1,4,4,10,-6,4
AEK Athens,8953,1,4,2,0,7,1,6,14
PAOK Salonik,8953,2,3,2,1,11,5,6,11
P'thinaikos,8953,3,1,1,4,5,11,-6,4
Panionios,8953,4,1,1,4,4,10,-6,4
AEK Athens,8954,1,4,2,0,7,1,6,14
PAOK Salonik,8954,2,2,3,1,10,5,5,9
P'thinaikos,8954,3,1,2,3,5,10,-5,5
Panionios,8954,4,1,1,4,4,10,-6,4
AEK Athens,8955,1,4,2,0,7,1,6,14
PAOK Salonik,8955,2,2,2,2,10,6,4,8
P'thinaikos,8955,3,2,1,3,6,10,-4,7
Panionios,8955,4,1,1,4,4,10,-6,4
AEK Athens,8956,1,4,2,0,7,1,6,14
PAOK Salonik,8956,2,2,2,2,9,5,4,8
P'thinaikos,8956,3,2,1,3,5,9,-4,7
Panionios,8956,4,1,1,4,4,10,-6,4
AEK Athens,8957,1,4,2,0,7,1,6,14
PAOK Salonik,8957,2,2,3,1,10,5,5,9
P'thinaikos,8957,3,1,2,3,5,10,-5,5
Panionios,8957,4,1,1,4,4,10,-6,4
AEK Athens,8958,1,4,2,0,7,1,6,14
PAOK Salonik,8958,2,2,2,2,10,7,3,8
P'thinaikos,8958,3,2,1,3,7,10,-3,7
Panionios,8958,4,1,1,4,4,10,-6,4
AEK Athens,8959,1,4,2,0,7,1,6,14
PAOK Salonik,8959,2,2,3,1,10,5,5,9
P'thinaikos,8959,3,1,2,3,5,10,-5,5
Panionios,8959,4,1,1,4,4,10,-6,4
AEK Athens,8960,1,4,2,0,7,1,6,14
PAOK Salonik,8960,2,3,2,1,10,4,6,11
P'thinaikos,8960,3,1,1,4,4,10,-6,4
Panionios,8960,3,1,1,4,4,10,-6,4
AEK Athens,8961,1,4,2,0,7,1,6,14
PAOK Salonik,8961,2,3,2,1,10,4,6,11
P'thinaikos,8961,3,1,1,4,4,10,-6,4
Panionios,8961,3,1,1,4,4,10,-6,4
AEK Athens,8962,1,4,2,0,7,1,6,14
PAOK Salonik,8962,2,3,2,1,10,4,6,11
P'thinaikos,8962,3,1,1,4,4,10,-6,4
Panionios,8962,3,1,1,4,4,10,-6,4
AEK Athens,8963,1,4,2,0,7,1,6,14
PAOK Salonik,8963,2,2,2,2,9,5,4,8
P'thinaikos,8963,3,2,1,3,5,9,-4,7
Panionios,8963,4,1,1,4,4,10,-6,4
AEK Athens,8964,1,4,2,0,7,1,6,14
PAOK Salonik,8964,2,2,2,2,9,5,4,8
P'thinaikos,8964,3,2,1,3,5,9,-4,7
Panionios,8964,4,1,1,4,4,10,-6,4
AEK Athens,8965,1,4,2,0,7,1,6,14
PAOK Salonik,8965,2,2,2,2,10,6,4,8
P'thinaikos,8965,3,2,1,3,6,10,-4,7
Panionios,8965,4,1,1,4,4,10,-6,4
AEK Athens,8966,1,4,2,0,7,1,6,14
PAOK Salonik,8966,2,2,2,2,10,6,4,8
P'thinaikos,8966,3,2,1,3,6,10,-4,7
Panionios,8966,4,1,1,4,4,10,-6,4
AEK Athens,8967,1,4,2,0,7,1,6,14
PAOK Salonik,8967,2,2,2,2,9,6,3,8
P'thinaikos,8967,3,2,1,3,6,9,-3,7
Panionios,8967,4,1,1,4,4,10,-6,4
AEK Athens,8968,1,4,2,0,7,1,6,14
PAOK Salonik,8968,2,2,2,2,9,6,3,8
P'thinaikos,8968,3,2,1,3,6,9,-3,7
Panionios,8968,4,1,1,4,4,10,-6,4
AEK Athens,8969,1,4,2,0,7,1,6,14
PAOK Salonik,8969,2,2,3,1,9,4,5,9
P'thinaikos,8969,3,1,2,3,4,9,-5,5
Panionios,8969,4,1,1,4,4,10,-6,4
AEK Athens,8970,1,4,2,0,7,1,6,14
PAOK Salonik,8970,2,2,3,1,9,4,5,9
P'thinaikos,8970,3,1,2,3,4,9,-5,5
Panionios,8970,4,1,1,4,4,10,-6,4
AEK Athens,8971,1,4,2,0,7,1,6,14
PAOK Salonik,8971,2,2,2,2,10,7,3,8
P'thinaikos,8971,3,2,1,3,7,10,-3,7
Panionios,8971,4,1,1,4,4,10,-6,4
AEK Athens,8972,1,4,2,0,7,1,6,14
PAOK Salonik,8972,2,2,3,1,9,4,5,9
P'thinaikos,8972,3,1,2,3,4,9,-5,5
Panionios,8972,4,1,1,4,4,10,-6,4
AEK Athens,8973,1,4,2,0,7,1,6,14
PAOK Salonik,8973,2,2,2,2,10,6,4,8
P'thinaikos,8973,3,2,1,3,6,10,-4,7
Panionios,8973,4,1,1,4,4,10,-6,4
AEK Athens,8974,1,4,2,0,7,1,6,14
PAOK Salonik,8974,2,3,2,1,12,5,7,11
Panionios,8974,3,1,1,4,4,10,-6,4
P'thinaikos,8974,4,1,1,4,5,12,-7,4
AEK Athens,8975,1,4,2,0,7,1,6,14
PAOK Salonik,8975,2,2,3,1,10,5,5,9
P'thinaikos,8975,3,1,2,3,5,10,-5,5
Panionios,8975,4,1,1,4,4,10,-6,4
AEK Athens,8976,1,4,2,0,7,1,6,14
PAOK Salonik,8976,2,2,3,1,12,7,5,9
P'thinaikos,8976,3,1,2,3,7,12,-5,5
Panionios,8976,4,1,1,4,4,10,-6,4
AEK Athens,8977,1,4,2,0,7,1,6,14
PAOK Salonik,8977,2,2,2,2,9,5,4,8
P'thinaikos,8977,3,2,1,3,5,9,-4,7
Panionios,8977,4,1,1,4,4,10,-6,4
AEK Athens,8978,1,4,2,0,7,1,6,14
PAOK Salonik,8978,2,2,2,2,9,6,3,8
P'thinaikos,8978,3,2,1,3,6,9,-3,7
Panionios,8978,4,1,1,4,4,10,-6,4
AEK Athens,8979,1,4,2,0,7,1,6,14
PAOK Salonik,8979,2,2,3,1,9,4,5,9
P'thinaikos,8979,3,1,2,3,4,9,-5,5
Panionios,8979,4,1,1,4,4,10,-6,4
AEK Athens,8980,1,4,2,0,7,1,6,14
PAOK Salonik,8980,2,2,3,1,9,4,5,9
P'thinaikos,8980,3,1,2,3,4,9,-5,5
Panionios,8980,4,1,1,4,4,10,-6,4
AEK Athens,8981,1,4,2,0,7,1,6,14
PAOK Salonik,8981,2,2,2,2,9,6,3,8
P'thinaikos,8981,3,2,1,3,6,9,-3,7
Panionios,8981,4,1,1,4,4,10,-6,4
AEK Athens,8982,1,4,2,0,7,1,6,14
PAOK Salonik,8982,2,2,3,1,10,5,5,9
P'thinaikos,8982,3,1,2,3,5,10,-5,5
Panionios,8982,4,1,1,4,4,10,-6,4
AEK Athens,8983,1,4,2,0,7,1,6,14
PAOK Salonik,8983,2,2,3,1,10,5,5,9
P'thinaikos,8983,3,1,2,3,5,10,-5,5
Panionios,8983,4,1,1,4,4,10,-6,4
AEK Athens,8984,1,4,2,0,7,1,6,14
PAOK Salonik,8984,2,2,2,2,10,8,2,8
P'thinaikos,8984,3,2,1,3,8,10,-2,7
Panionios,8984,4,1,1,4,4,10,-6,4
AEK Athens,8985,1,4,2,0,7,1,6,14
PAOK Salonik,8985,2,2,2,2,10,7,3,8
P'thinaikos,8985,3,2,1,3,7,10,-3,7
Panionios,8985,4,1,1,4,4,10,-6,4
AEK Athens,8986,1,4,2,0,7,1,6,14
PAOK Salonik,8986,2,2,2,2,9,6,3,8
P'thinaikos,8986,3,2,1,3,6,9,-3,7
Panionios,8986,4,1,1,4,4,10,-6,4
AEK Athens,8987,1,4,2,0,7,1,6,14
PAOK Salonik,8987,2,2,3,1,9,4,5,9
P'thinaikos,8987,3,1,2,3,4,9,-5,5
Panionios,8987,4,1,1,4,4,10,-6,4
AEK Athens,8988,1,4,2,0,7,1,6,14
PAOK Salonik,8988,2,2,2,2,10,6,4,8
P'thinaikos,8988,3,2,1,3,6,10,-4,7
Panionios,8988,4,1,1,4,4,10,-6,4
AEK Athens,8989,1,4,2,0,7,1,6,14
PAOK Salonik,8989,2,3,2,1,10,4,6,11
P'thinaikos,8989,3,1,1,4,4,10,-6,4
Panionios,8989,3,1,1,4,4,10,-6,4
AEK Athens,8990,1,4,2,0,7,1,6,14
PAOK Salonik,8990,2,3,2,1,12,5,7,11
Panionios,8990,3,1,1,4,4,10,-6,4
P'thinaikos,8990,4,1,1,4,5,12,-7,4
AEK Athens,8991,1,4,2,0,7,1,6,14
PAOK Salonik,8991,2,3,2,1,11,4,7,11
Panionios,8991,3,1,1,4,4,10,-6,4
P'thinaikos,8991,4,1,1,4,4,11,-7,4
AEK Athens,8992,1,4,2,0,7,1,6,14
PAOK Salonik,8992,2,2,2,2,9,7,2,8
P'thinaikos,8992,3,2,1,3,7,9,-2,7
Panionios,8992,4,1,1,4,4,10,-6,4
AEK Athens,8993,1,4,2,0,7,1,6,14
PAOK Salonik,8993,2,3,2,1,12,4,8,11
Panionios,8993,3,1,1,4,4,10,-6,4
P'thinaikos,8993,4,1,1,4,4,12,-8,4
AEK Athens,8994,1,4,2,0,7,1,6,14
PAOK Salonik,8994,2,2,2,2,9,6,3,8
P'thinaikos,8994,3,2,1,3,6,9,-3,7
Panionios,8994,4,1,1,4,4,10,-6,4
AEK Athens,8995,1,4,2,0,7,1,6,14
PAOK Salonik,8995,2,2,2,2,9,5,4,8
P'thinaikos,8995,3,2,1,3,5,9,-4,7
Panionios,8995,4,1,1,4,4,10,-6,4
AEK Athens,8996,1,4,2,0,7,1,6,14
PAOK Salonik,8996,2,2,2,2,10,6,4,8
P'thinaikos,8996,3,2,1,3,6,10,-4,7
Panionios,8996,4,1,1,4,4,10,-6,4
AEK Athens,8997,1,4,2,0,7,1,6,14
PAOK Salonik,8997,2,3,2,1,12,4,8,11
Panionios,8997,3,1,1,4,4,10,-6,4
P'thinaikos,8997,4,1,1,4,4,12,-8,4
AEK Athens,8998,1,4,2,0,7,1,6,14
PAOK Salonik,8998,2,2,3,1,11,6,5,9
P'thinaikos,8998,3,1,2,3,6,11,-5,5
Panionios,8998,4,1,1,4,4,10,-6,4
AEK Athens,8999,1,4,2,0,7,1,6,14
PAOK Salonik,8999,2,3,2,1,11,4,7,11
Panionios,8999,3,1,1,4,4,10,-6,4
P'thinaikos,8999,4,1,1,4,4,11,-7,4
AEK Athens,9000,1,4,2,0,7,1,6,14
PAOK Salonik,9000,2,3,2,1,12,4,8,11
Panionios,9000,3,1,1,4,4,10,-6,4
P'thinaikos,9000,4,1,1,4,4,12,-8,4
AEK Athens,9001,1,4,2,0,7,1,6,14
PAOK Salonik,9001,2,3,2,1,12,4,8,11
Panionios,9001,3,1,1,4,4,10,-6,4
P'thinaikos,9001,4,1,1,4,4,12,-8,4
AEK Athens,9002,1,4,2,0,7,1,6,14
PAOK Salonik,9002,2,3,2,1,11,5,6,11
P'thinaikos,9002,3,1,1,4,5,11,-6,4
Panionios,9002,4,1,1,4,4,10,-6,4
AEK Athens,9003,1,4,2,0,7,1,6,14
PAOK Salonik,9003,2,2,2,2,9,5,4,8
P'thinaikos,9003,3,2,1,3,5,9,-4,7
Panionios,9003,4,1,1,4,4,10,-6,4
AEK Athens,9004,1,4,2,0,7,1,6,14
PAOK Salonik,9004,2,2,3,1,10,5,5,9
P'thinaikos,9004,3,1,2,3,5,10,-5,5
Panionios,9004,4,1,1,4,4,10,-6,4
AEK Athens,9005,1,4,2,0,7,1,6,14
PAOK Salonik,9005,2,2,3,1,9,4,5,9
P'thinaikos,9005,3,1,2,3,4,9,-5,5
Panionios,9005,4,1,1,4,4,10,-6,4
AEK Athens,9006,1,4,2,0,7,1,6,14
PAOK Salonik,9006,2,3,2,1,10,4,6,11
P'thinaikos,9006,3,1,1,4,4,10,-6,4
Panionios,9006,3,1,1,4,4,10,-6,4
AEK Athens,9007,1,4,2,0,7,1,6,14
PAOK Salonik,9007,2,2,2,2,9,8,1,8
P'thinaikos,9007,3,2,1,3,8,9,-1,7
Panionios,9007,4,1,1,4,4,10,-6,4
AEK Athens,9008,1,4,2,0,7,1,6,14
PAOK Salonik,9008,2,3,2,1,10,4,6,11
P'thinaikos,9008,3,1,1,4,4,10,-6,4
Panionios,9008,3,1,1,4,4,10,-6,4
AEK Athens,9009,1,4,2,0,7,1,6,14
PAOK Salonik,9009,2,3,2,1,15,5,10,11
Panionios,9009,3,1,1,4,4,10,-6,4
P'thinaikos,9009,4,1,1,4,5,15,-10,4
AEK Athens,9010,1,4,2,0,7,1,6,14
PAOK Salonik,9010,2,2,2,2,9,6,3,8
P'thinaikos,9010,3,2,1,3,6,9,-3,7
Panionios,9010,4,1,1,4,4,10,-6,4
AEK Athens,9011,1,4,2,0,7,1,6,14
PAOK Salonik,9011,2,2,3,1,12,7,5,9
P'thinaikos,9011,3,1,2,3,7,12,-5,5
Panionios,9011,4,1,1,4,4,10,-6,4
AEK Athens,9012,1,4,2,0,7,1,6,14
PAOK Salonik,9012,2,2,2,2,9,6,3,8
P'thinaikos,9012,3,2,1,3,6,9,-3,7
Panionios,9012,4,1,1,4,4,10,-6,4
AEK Athens,9013,1,4,2,0,7,1,6,14
PAOK Salonik,9013,2,3,2,1,10,4,6,11
P'thinaikos,9013,3,1,1,4,4,10,-6,4
Panionios,9013,3,1,1,4,4,10,-6,4
AEK Athens,9014,1,4,2,0,7,1,6,14
PAOK Salonik,9014,2,3,2,1,12,5,7,11
Panionios,9014,3,1,1,4,4,10,-6,4
P'thinaikos,9014,4,1,1,4,5,12,-7,4
AEK Athens,9015,1,4,2,0,7,1,6,14
PAOK Salonik,9015,2,3,2,1,12,5,7,11
Panionios,9015,3,1,1,4,4,10,-6,4
P'thinaikos,9015,4,1,1,4,5,12,-7,4
AEK Athens,9016,1,4,2,0,7,1,6,14
PAOK Salonik,9016,2,2,2,2,9,5,4,8
P'thinaikos,9016,3,2,1,3,5,9,-4,7
Panionios,9016,4,1,1,4,4,10,-6,4
AEK Athens,9017,1,4,2,0,7,1,6,14
PAOK Salonik,9017,2,2,2,2,9,5,4,8
P'thinaikos,9017,3,2,1,3,5,9,-4,7
Panionios,9017,4,1,1,4,4,10,-6,4
AEK Athens,9018,1,4,2,0,7,1,6,14
PAOK Salonik,9018,2,3,2,1,11,4,7,11
Panionios,9018,3,1,1,4,4,10,-6,4
P'thinaikos,9018,4,1,1,4,4,11,-7,4
AEK Athens,9019,1,4,2,0,7,1,6,14
PAOK Salonik,9019,2,2,2,2,9,6,3,8
P'thinaikos,9019,3,2,1,3,6,9,-3,7
Panionios,9019,4,1,1,4,4,10,-6,4
AEK Athens,9020,1,4,2,0,7,1,6,14
PAOK Salonik,9020,2,2,2,2,10,6,4,8
P'thinaikos,9020,3,2,1,3,6,10,-4,7
Panionios,9020,4,1,1,4,4,10,-6,4
AEK Athens,9021,1,4,2,0,7,1,6,14
PAOK Salonik,9021,2,3,2,1,12,4,8,11
Panionios,9021,3,1,1,4,4,10,-6,4
P'thinaikos,9021,4,1,1,4,4,12,-8,4
AEK Athens,9022,1,4,2,0,7,1,6,14
PAOK Salonik,9022,2,3,2,1,11,5,6,11
P'thinaikos,9022,3,1,1,4,5,11,-6,4
Panionios,9022,4,1,1,4,4,10,-6,4
AEK Athens,9023,1,4,2,0,7,1,6,14
PAOK Salonik,9023,2,3,2,1,13,6,7,11
Panionios,9023,3,1,1,4,4,10,-6,4
P'thinaikos,9023,4,1,1,4,6,13,-7,4
AEK Athens,9024,1,4,2,0,7,1,6,14
PAOK Salonik,9024,2,2,2,2,9,6,3,8
P'thinaikos,9024,3,2,1,3,6,9,-3,7
Panionios,9024,4,1,1,4,4,10,-6,4
AEK Athens,9025,1,4,2,0,7,1,6,14
PAOK Salonik,9025,2,3,2,1,10,4,6,11
P'thinaikos,9025,3,1,1,4,4,10,-6,4
Panionios,9025,3,1,1,4,4,10,-6,4
AEK Athens,9026,1,4,2,0,7,1,6,14
PAOK Salonik,9026,2,2,2,2,9,5,4,8
P'thinaikos,9026,3,2,1,3,5,9,-4,7
Panionios,9026,4,1,1,4,4,10,-6,4
AEK Athens,9027,1,4,2,0,7,1,6,14
PAOK Salonik,9027,2,2,2,2,9,6,3,8
P'thinaikos,9027,3,2,1,3,6,9,-3,7
Panionios,9027,4,1,1,4,4,10,-6,4
AEK Athens,9028,1,4,2,0,7,1,6,14
PAOK Salonik,9028,2,2,2,2,9,5,4,8
P'thinaikos,9028,3,2,1,3,5,9,-4,7
Panionios,9028,4,1,1,4,4,10,-6,4
AEK Athens,9029,1,4,2,0,7,1,6,14
PAOK Salonik,9029,2,2,2,2,9,5,4,8
P'thinaikos,9029,3,2,1,3,5,9,-4,7
Panionios,9029,4,1,1,4,4,10,-6,4
AEK Athens,9030,1,4,2,0,7,1,6,14
PAOK Salonik,9030,2,3,2,1,11,5,6,11
P'thinaikos,9030,3,1,1,4,5,11,-6,4
Panionios,9030,4,1,1,4,4,10,-6,4
AEK Athens,9031,1,4,2,0,7,1,6,14
PAOK Salonik,9031,2,2,2,2,9,5,4,8
P'thinaikos,9031,3,2,1,3,5,9,-4,7
Panionios,9031,4,1,1,4,4,10,-6,4
AEK Athens,9032,1,4,2,0,7,1,6,14
PAOK Salonik,9032,2,2,2,2,9,6,3,8
P'thinaikos,9032,3,2,1,3,6,9,-3,7
Panionios,9032,4,1,1,4,4,10,-6,4
AEK Athens,9033,1,4,2,0,7,1,6,14
PAOK Salonik,9033,2,2,3,1,10,5,5,9
P'thinaikos,9033,3,1,2,3,5,10,-5,5
Panionios,9033,4,1,1,4,4,10,-6,4
AEK Athens,9034,1,4,2,0,7,1,6,14
PAOK Salonik,9034,2,2,2,2,9,7,2,8
P'thinaikos,9034,3,2,1,3,7,9,-2,7
Panionios,9034,4,1,1,4,4,10,-6,4
AEK Athens,9035,1,4,2,0,7,1,6,14
PAOK Salonik,9035,2,3,2,1,13,5,8,11
Panionios,9035,3,1,1,4,4,10,-6,4
P'thinaikos,9035,4,1,1,4,5,13,-8,4
AEK Athens,9036,1,4,2,0,7,1,6,14
PAOK Salonik,9036,2,2,3,1,9,4,5,9
P'thinaikos,9036,3,1,2,3,4,9,-5,5
Panionios,9036,4,1,1,4,4,10,-6,4
AEK Athens,9037,1,4,2,0,7,1,6,14
PAOK Salonik,9037,2,2,2,2,9,6,3,8
P'thinaikos,9037,3,2,1,3,6,9,-3,7
Panionios,9037,4,1,1,4,4,10,-6,4
AEK Athens,9038,1,4,2,0,7,1,6,14
PAOK Salonik,9038,2,2,2,2,9,5,4,8
P'thinaikos,9038,3,2,1,3,5,9,-4,7
Panionios,9038,4,1,1,4,4,10,-6,4
AEK Athens,9039,1,4,2,0,7,1,6,14
PAOK Salonik,9039,2,2,2,2,10,6,4,8
P'thinaikos,9039,3,2,1,3,6,10,-4,7
Panionios,9039,4,1,1,4,4,10,-6,4
AEK Athens,9040,1,4,2,0,7,1,6,14
PAOK Salonik,9040,2,3,2,1,10,4,6,11
P'thinaikos,9040,3,1,1,4,4,10,-6,4
Panionios,9040,3,1,1,4,4,10,-6,4
AEK Athens,9041,1,4,2,0,7,1,6,14
PAOK Salonik,9041,2,3,2,1,10,4,6,11
P'thinaikos,9041,3,1,1,4,4,10,-6,4
Panionios,9041,3,1,1,4,4,10,-6,4
AEK Athens,9042,1,4,2,0,7,1,6,14
PAOK Salonik,9042,2,2,2,2,12,8,4,8
P'thinaikos,9042,3,2,1,3,8,12,-4,7
Panionios,9042,4,1,1,4,4,10,-6,4
AEK Athens,9043,1,4,2,0,7,1,6,14
PAOK Salonik,9043,2,2,2,2,9,6,3,8
P'thinaikos,9043,3,2,1,3,6,9,-3,7
Panionios,9043,4,1,1,4,4,10,-6,4
AEK Athens,9044,1,4,2,0,7,1,6,14
PAOK Salonik,9044,2,3,2,1,10,4,6,11
P'thinaikos,9044,3,1,1,4,4,10,-6,4
Panionios,9044,3,1,1,4,4,10,-6,4
AEK Athens,9045,1,4,2,0,7,1,6,14
PAOK Salonik,9045,2,3,2,1,10,4,6,11
P'thinaikos,9045,3,1,1,4,4,10,-6,4
Panionios,9045,3,1,1,4,4,10,-6,4
AEK Athens,9046,1,4,2,0,7,1,6,14
PAOK Salonik,9046,2,2,3,1,10,5,5,9
P'thinaikos,9046,3,1,2,3,5,10,-5,5
Panionios,9046,4,1,1,4,4,10,-6,4
AEK Athens,9047,1,4,2,0,7,1,6,14
PAOK Salonik,9047,2,2,3,1,9,4,5,9
P'thinaikos,9047,3,1,2,3,4,9,-5,5
Panionios,9047,4,1,1,4,4,10,-6,4
AEK Athens,9048,1,4,2,0,7,1,6,14
PAOK Salonik,9048,2,2,2,2,10,6,4,8
P'thinaikos,9048,3,2,1,3,6,10,-4,7
Panionios,9048,4,1,1,4,4,10,-6,4
AEK Athens,9049,1,4,2,0,7,1,6,14
PAOK Salonik,9049,2,3,2,1,10,4,6,11
P'thinaikos,9049,3,1,1,4,4,10,-6,4
Panionios,9049,3,1,1,4,4,10,-6,4
AEK Athens,9050,1,4,2,0,7,1,6,14
PAOK Salonik,9050,2,2,2,2,10,6,4,8
P'thinaikos,9050,3,2,1,3,6,10,-4,7
Panionios,9050,4,1,1,4,4,10,-6,4
AEK Athens,9051,1,4,2,0,7,1,6,14
PAOK Salonik,9051,2,3,2,1,10,4,6,11
P'thinaikos,9051,3,1,1,4,4,10,-6,4
Panionios,9051,3,1,1,4,4,10,-6,4
AEK Athens,9052,1,4,2,0,7,1,6,14
PAOK Salonik,9052,2,2,2,2,10,6,4,8
P'thinaikos,9052,3,2,1,3,6,10,-4,7
Panionios,9052,4,1,1,4,4,10,-6,4
AEK Athens,9053,1,4,2,0,7,1,6,14
PAOK Salonik,9053,2,3,2,1,11,4,7,11
Panionios,9053,3,1,1,4,4,10,-6,4
P'thinaikos,9053,4,1,1,4,4,11,-7,4
AEK Athens,9054,1,4,2,0,7,1,6,14
PAOK Salonik,9054,2,2,3,1,11,6,5,9
P'thinaikos,9054,3,1,2,3,6,11,-5,5
Panionios,9054,4,1,1,4,4,10,-6,4
AEK Athens,9055,1,4,2,0,7,1,6,14
PAOK Salonik,9055,2,3,2,1,10,4,6,11
P'thinaikos,9055,3,1,1,4,4,10,-6,4
Panionios,9055,3,1,1,4,4,10,-6,4
AEK Athens,9056,1,4,2,0,7,1,6,14
PAOK Salonik,9056,2,2,2,2,9,6,3,8
P'thinaikos,9056,3,2,1,3,6,9,-3,7
Panionios,9056,4,1,1,4,4,10,-6,4
AEK Athens,9057,1,4,2,0,7,1,6,14
PAOK Salonik,9057,2,3,2,1,11,4,7,11
Panionios,9057,3,1,1,4,4,10,-6,4
P'thinaikos,9057,4,1,1,4,4,11,-7,4
AEK Athens,9058,1,4,2,0,7,1,6,14
PAOK Salonik,9058,2,2,2,2,9,6,3,8
P'thinaikos,9058,3,2,1,3,6,9,-3,7
Panionios,9058,4,1,1,4,4,10,-6,4
AEK Athens,9059,1,4,2,0,7,1,6,14
PAOK Salonik,9059,2,2,2,2,9,5,4,8
P'thinaikos,9059,3,2,1,3,5,9,-4,7
Panionios,9059,4,1,1,4,4,10,-6,4
AEK Athens,9060,1,4,2,0,7,1,6,14
PAOK Salonik,9060,2,3,2,1,10,4,6,11
P'thinaikos,9060,3,1,1,4,4,10,-6,4
Panionios,9060,3,1,1,4,4,10,-6,4
AEK Athens,9061,1,4,2,0,7,1,6,14
PAOK Salonik,9061,2,2,3,1,10,5,5,9
P'thinaikos,9061,3,1,2,3,5,10,-5,5
Panionios,9061,4,1,1,4,4,10,-6,4
AEK Athens,9062,1,4,2,0,7,1,6,14
PAOK Salonik,9062,2,2,2,2,10,6,4,8
P'thinaikos,9062,3,2,1,3,6,10,-4,7
Panionios,9062,4,1,1,4,4,10,-6,4
AEK Athens,9063,1,4,2,0,7,1,6,14
PAOK Salonik,9063,2,3,2,1,10,4,6,11
P'thinaikos,9063,3,1,1,4,4,10,-6,4
Panionios,9063,3,1,1,4,4,10,-6,4
AEK Athens,9064,1,4,2,0,7,1,6,14
PAOK Salonik,9064,2,2,2,2,10,6,4,8
P'thinaikos,9064,3,2,1,3,6,10,-4,7
Panionios,9064,4,1,1,4,4,10,-6,4
AEK Athens,9065,1,4,2,0,7,1,6,14
PAOK Salonik,9065,2,3,2,1,15,6,9,11
Panionios,9065,3,1,1,4,4,10,-6,4
P'thinaikos,9065,4,1,1,4,6,15,-9,4
AEK Athens,9066,1,4,2,0,7,1,6,14
PAOK Salonik,9066,2,2,3,1,10,5,5,9
P'thinaikos,9066,3,1,2,3,5,10,-5,5
Panionios,9066,4,1,1,4,4,10,-6,4
AEK Athens,9067,1,4,2,0,7,1,6,14
PAOK Salonik,9067,2,2,2,2,9,7,2,8
P'thinaikos,9067,3,2,1,3,7,9,-2,7
Panionios,9067,4,1,1,4,4,10,-6,4
AEK Athens,9068,1,4,2,0,7,1,6,14
PAOK Salonik,9068,2,2,2,2,9,5,4,8
P'thinaikos,9068,3,2,1,3,5,9,-4,7
Panionios,9068,4,1,1,4,4,10,-6,4
AEK Athens,9069,1,4,2,0,7,1,6,14
PAOK Salonik,9069,2,2,2,2,9,7,2,8
P'thinaikos,9069,3,2,1,3,7,9,-2,7
Panionios,9069,4,1,1,4,4,10,-6,4
AEK Athens,9070,1,4,2,0,7,1,6,14
PAOK Salonik,9070,2,2,3,1,10,5,5,9
P'thinaikos,9070,3,1,2,3,5,10,-5,5
Panionios,9070,4,1,1,4,4,10,-6,4
AEK Athens,9071,1,4,2,0,7,1,6,14
PAOK Salonik,9071,2,2,2,2,9,5,4,8
P'thinaikos,9071,3,2,1,3,5,9,-4,7
Panionios,9071,4,1,1,4,4,10,-6,4
AEK Athens,9072,1,4,2,0,7,1,6,14
PAOK Salonik,9072,2,2,2,2,9,6,3,8
P'thinaikos,9072,3,2,1,3,6,9,-3,7
Panionios,9072,4,1,1,4,4,10,-6,4
AEK Athens,9073,1,4,2,0,7,1,6,14
PAOK Salonik,9073,2,3,2,1,11,5,6,11
P'thinaikos,9073,3,1,1,4,5,11,-6,4
Panionios,9073,4,1,1,4,4,10,-6,4
AEK Athens,9074,1,4,2,0,7,1,6,14
PAOK Salonik,9074,2,3,2,1,10,4,6,11
P'thinaikos,9074,3,1,1,4,4,10,-6,4
Panionios,9074,3,1,1,4,4,10,-6,4
AEK Athens,9075,1,4,2,0,7,1,6,14
PAOK Salonik,9075,2,2,3,1,10,5,5,9
P'thinaikos,9075,3,1,2,3,5,10,-5,5
Panionios,9075,4,1,1,4,4,10,-6,4
AEK Athens,9076,1,4,2,0,7,1,6,14
PAOK Salonik,9076,2,2,2,2,9,5,4,8
P'thinaikos,9076,3,2,1,3,5,9,-4,7
Panionios,9076,4,1,1,4,4,10,-6,4
AEK Athens,9077,1,4,2,0,7,1,6,14
PAOK Salonik,9077,2,2,2,2,9,8,1,8
P'thinaikos,9077,3,2,1,3,8,9,-1,7
Panionios,9077,4,1,1,4,4,10,-6,4
AEK Athens,9078,1,4,2,0,7,1,6,14
PAOK Salonik,9078,2,2,3,1,11,6,5,9
P'thinaikos,9078,3,1,2,3,6,11,-5,5
Panionios,9078,4,1,1,4,4,10,-6,4
AEK Athens,9079,1,4,2,0,7,1,6,14
PAOK Salonik,9079,2,2,2,2,9,6,3,8
P'thinaikos,9079,3,2,1,3,6,9,-3,7
Panionios,9079,4,1,1,4,4,10,-6,4
AEK Athens,9080,1,4,2,0,7,1,6,14
PAOK Salonik,9080,2,2,2,2,9,5,4,8
P'thinaikos,9080,3,2,1,3,5,9,-4,7
Panionios,9080,4,1,1,4,4,10,-6,4
AEK Athens,9081,1,4,2,0,7,1,6,14
PAOK Salonik,9081,2,3,2,1,10,4,6,11
P'thinaikos,9081,3,1,1,4,4,10,-6,4
Panionios,9081,3,1,1,4,4,10,-6,4
AEK Athens,9082,1,4,2,0,7,1,6,14
PAOK Salonik,9082,2,3,2,1,11,4,7,11
Panionios,9082,3,1,1,4,4,10,-6,4
P'thinaikos,9082,4,1,1,4,4,11,-7,4
AEK Athens,9083,1,4,2,0,7,1,6,14
PAOK Salonik,9083,2,2,2,2,10,8,2,8
P'thinaikos,9083,3,2,1,3,8,10,-2,7
Panionios,9083,4,1,1,4,4,10,-6,4
AEK Athens,9084,1,4,2,0,7,1,6,14
PAOK Salonik,9084,2,2,2,2,10,7,3,8
P'thinaikos,9084,3,2,1,3,7,10,-3,7
Panionios,9084,4,1,1,4,4,10,-6,4
AEK Athens,9085,1,4,2,0,7,1,6,14
PAOK Salonik,9085,2,2,2,2,9,5,4,8
P'thinaikos,9085,3,2,1,3,5,9,-4,7
Panionios,9085,4,1,1,4,4,10,-6,4
AEK Athens,9086,1,4,2,0,7,1,6,14
PAOK Salonik,9086,2,2,2,2,10,6,4,8
P'thinaikos,9086,3,2,1,3,6,10,-4,7
Panionios,9086,4,1,1,4,4,10,-6,4
AEK Athens,9087,1,4,2,0,7,1,6,14
PAOK Salonik,9087,2,3,2,1,11,4,7,11
Panionios,9087,3,1,1,4,4,10,-6,4
P'thinaikos,9087,4,1,1,4,4,11,-7,4
AEK Athens,9088,1,4,2,0,7,1,6,14
PAOK Salonik,9088,2,3,2,1,13,6,7,11
Panionios,9088,3,1,1,4,4,10,-6,4
P'thinaikos,9088,4,1,1,4,6,13,-7,4
AEK Athens,9089,1,4,2,0,7,1,6,14
PAOK Salonik,9089,2,2,2,2,9,5,4,8
P'thinaikos,9089,3,2,1,3,5,9,-4,7
Panionios,9089,4,1,1,4,4,10,-6,4
AEK Athens,9090,1,4,2,0,7,1,6,14
PAOK Salonik,9090,2,2,3,1,11,6,5,9
P'thinaikos,9090,3,1,2,3,6,11,-5,5
Panionios,9090,4,1,1,4,4,10,-6,4
AEK Athens,9091,1,4,2,0,7,1,6,14
PAOK Salonik,9091,2,2,2,2,9,6,3,8
P'thinaikos,9091,3,2,1,3,6,9,-3,7
Panionios,9091,4,1,1,4,4,10,-6,4
AEK Athens,9092,1,4,2,0,7,1,6,14
PAOK Salonik,9092,2,2,2,2,10,6,4,8
P'thinaikos,9092,3,2,1,3,6,10,-4,7
Panionios,9092,4,1,1,4,4,10,-6,4
AEK Athens,9093,1,4,2,0,7,1,6,14
PAOK Salonik,9093,2,2,2,2,9,5,4,8
P'thinaikos,9093,3,2,1,3,5,9,-4,7
Panionios,9093,4,1,1,4,4,10,-6,4
AEK Athens,9094,1,4,2,0,7,1,6,14
PAOK Salonik,9094,2,3,2,1,12,4,8,11
Panionios,9094,3,1,1,4,4,10,-6,4
P'thinaikos,9094,4,1,1,4,4,12,-8,4
AEK Athens,9095,1,4,2,0,7,1,6,14
PAOK Salonik,9095,2,3,2,1,11,5,6,11
P'thinaikos,9095,3,1,1,4,5,11,-6,4
Panionios,9095,4,1,1,4,4,10,-6,4
AEK Athens,9096,1,4,2,0,7,1,6,14
PAOK Salonik,9096,2,2,3,1,10,5,5,9
P'thinaikos,9096,3,1,2,3,5,10,-5,5
Panionios,9096,4,1,1,4,4,10,-6,4
AEK Athens,9097,1,4,2,0,7,1,6,14
PAOK Salonik,9097,2,2,3,1,11,6,5,9
P'thinaikos,9097,3,1,2,3,6,11,-5,5
Panionios,9097,4,1,1,4,4,10,-6,4
AEK Athens,9098,1,4,2,0,7,1,6,14
PAOK Salonik,9098,2,3,2,1,10,4,6,11
P'thinaikos,9098,3,1,1,4,4,10,-6,4
Panionios,9098,3,1,1,4,4,10,-6,4
AEK Athens,9099,1,4,2,0,7,1,6,14
PAOK Salonik,9099,2,3,2,1,12,4,8,11
Panionios,9099,3,1,1,4,4,10,-6,4
P'thinaikos,9099,4,1,1,4,4,12,-8,4
AEK Athens,9100,1,4,2,0,7,1,6,14
PAOK Salonik,9100,2,2,2,2,9,6,3,8
P'thinaikos,9100,3,2,1,3,6,9,-3,7
Panionios,9100,4,1,1,4,4,10,-6,4
AEK Athens,9101,1,4,2,0,7,1,6,14
PAOK Salonik,9101,2,2,2,2,10,7,3,8
P'thinaikos,9101,3,2,1,3,7,10,-3,7
Panionios,9101,4,1,1,4,4,10,-6,4
AEK Athens,9102,1,4,2,0,7,1,6,14
PAOK Salonik,9102,2,3,2,1,11,4,7,11
Panionios,9102,3,1,1,4,4,10,-6,4
P'thinaikos,9102,4,1,1,4,4,11,-7,4
AEK Athens,9103,1,4,2,0,7,1,6,14
PAOK Salonik,9103,2,2,2,2,10,6,4,8
P'thinaikos,9103,3,2,1,3,6,10,-4,7
Panionios,9103,4,1,1,4,4,10,-6,4
AEK Athens,9104,1,4,2,0,7,1,6,14
PAOK Salonik,9104,2,2,2,2,10,6,4,8
P'thinaikos,9104,3,2,1,3,6,10,-4,7
Panionios,9104,4,1,1,4,4,10,-6,4
AEK Athens,9105,1,4,2,0,7,1,6,14
PAOK Salonik,9105,2,3,2,1,13,4,9,11
Panionios,9105,3,1,1,4,4,10,-6,4
P'thinaikos,9105,4,1,1,4,4,13,-9,4
AEK Athens,9106,1,4,2,0,7,1,6,14
PAOK Salonik,9106,2,2,2,2,9,6,3,8
P'thinaikos,9106,3,2,1,3,6,9,-3,7
Panionios,9106,4,1,1,4,4,10,-6,4
AEK Athens,9107,1,4,2,0,7,1,6,14
PAOK Salonik,9107,2,3,2,1,13,4,9,11
Panionios,9107,3,1,1,4,4,10,-6,4
P'thinaikos,9107,4,1,1,4,4,13,-9,4
AEK Athens,9108,1,4,2,0,7,1,6,14
PAOK Salonik,9108,2,2,3,1,9,4,5,9
P'thinaikos,9108,3,1,2,3,4,9,-5,5
Panionios,9108,4,1,1,4,4,10,-6,4
AEK Athens,9109,1,4,2,0,7,1,6,14
PAOK Salonik,9109,2,2,2,2,10,8,2,8
P'thinaikos,9109,3,2,1,3,8,10,-2,7
Panionios,9109,4,1,1,4,4,10,-6,4
AEK Athens,9110,1,4,2,0,7,1,6,14
PAOK Salonik,9110,2,2,2,2,9,6,3,8
P'thinaikos,9110,3,2,1,3,6,9,-3,7
Panionios,9110,4,1,1,4,4,10,-6,4
AEK Athens,9111,1,4,2,0,7,1,6,14
PAOK Salonik,9111,2,2,3,1,9,4,5,9
P'thinaikos,9111,3,1,2,3,4,9,-5,5
Panionios,9111,4,1,1,4,4,10,-6,4
AEK Athens,9112,1,4,2,0,7,1,6,14
PAOK Salonik,9112,2,3,2,1,10,4,6,11
P'thinaikos,9112,3,1,1,4,4,10,-6,4
Panionios,9112,3,1,1,4,4,10,-6,4
AEK Athens,9113,1,4,2,0,7,1,6,14
PAOK Salonik,9113,2,3,2,1,13,5,8,11
Panionios,9113,3,1,1,4,4,10,-6,4
P'thinaikos,9113,4,1,1,4,5,13,-8,4
AEK Athens,9114,1,4,2,0,7,1,6,14
PAOK Salonik,9114,2,3,2,1,12,4,8,11
Panionios,9114,3,1,1,4,4,10,-6,4
P'thinaikos,9114,4,1,1,4,4,12,-8,4
AEK Athens,9115,1,4,2,0,7,1,6,14
PAOK Salonik,9115,2,3,2,1,13,4,9,11
Panionios,9115,3,1,1,4,4,10,-6,4
P'thinaikos,9115,4,1,1,4,4,13,-9,4
AEK Athens,9116,1,4,2,0,7,1,6,14
PAOK Salonik,9116,2,2,2,2,10,7,3,8
P'thinaikos,9116,3,2,1,3,7,10,-3,7
Panionios,9116,4,1,1,4,4,10,-6,4
AEK Athens,9117,1,4,2,0,7,1,6,14
PAOK Salonik,9117,2,2,3,1,11,6,5,9
P'thinaikos,9117,3,1,2,3,6,11,-5,5
Panionios,9117,4,1,1,4,4,10,-6,4
AEK Athens,9118,1,4,2,0,7,1,6,14
PAOK Salonik,9118,2,2,2,2,10,7,3,8
P'thinaikos,9118,3,2,1,3,7,10,-3,7
Panionios,9118,4,1,1,4,4,10,-6,4
AEK Athens,9119,1,4,2,0,7,1,6,14
PAOK Salonik,9119,2,2,2,2,10,6,4,8
P'thinaikos,9119,3,2,1,3,6,10,-4,7
Panionios,9119,4,1,1,4,4,10,-6,4
AEK Athens,9120,1,4,2,0,7,1,6,14
PAOK Salonik,9120,2,2,3,1,10,5,5,9
P'thinaikos,9120,3,1,2,3,5,10,-5,5
Panionios,9120,4,1,1,4,4,10,-6,4
AEK Athens,9121,1,4,2,0,7,1,6,14
PAOK Salonik,9121,2,3,2,1,10,4,6,11
P'thinaikos,9121,3,1,1,4,4,10,-6,4
Panionios,9121,3,1,1,4,4,10,-6,4
AEK Athens,9122,1,4,2,0,7,1,6,14
PAOK Salonik,9122,2,2,2,2,11,7,4,8
P'thinaikos,9122,3,2,1,3,7,11,-4,7
Panionios,9122,4,1,1,4,4,10,-6,4
AEK Athens,9123,1,4,2,0,7,1,6,14
PAOK Salonik,9123,2,2,2,2,9,5,4,8
P'thinaikos,9123,3,2,1,3,5,9,-4,7
Panionios,9123,4,1,1,4,4,10,-6,4
AEK Athens,9124,1,4,2,0,7,1,6,14
PAOK Salonik,9124,2,2,3,1,10,5,5,9
P'thinaikos,9124,3,1,2,3,5,10,-5,5
Panionios,9124,4,1,1,4,4,10,-6,4
AEK Athens,9125,1,4,2,0,7,1,6,14
PAOK Salonik,9125,2,2,2,2,10,6,4,8
P'thinaikos,9125,3,2,1,3,6,10,-4,7
Panionios,9125,4,1,1,4,4,10,-6,4
AEK Athens,9126,1,4,2,0,7,1,6,14
PAOK Salonik,9126,2,3,2,1,11,5,6,11
P'thinaikos,9126,3,1,1,4,5,11,-6,4
Panionios,9126,4,1,1,4,4,10,-6,4
AEK Athens,9127,1,4,2,0,7,1,6,14
PAOK Salonik,9127,2,2,2,2,10,6,4,8
P'thinaikos,9127,3,2,1,3,6,10,-4,7
Panionios,9127,4,1,1,4,4,10,-6,4
AEK Athens,9128,1,4,2,0,7,1,6,14
PAOK Salonik,9128,2,3,2,1,11,4,7,11
Panionios,9128,3,1,1,4,4,10,-6,4
P'thinaikos,9128,4,1,1,4,4,11,-7,4
AEK Athens,9129,1,4,2,0,7,1,6,14
PAOK Salonik,9129,2,2,2,2,10,6,4,8
P'thinaikos,9129,3,2,1,3,6,10,-4,7
Panionios,9129,4,1,1,4,4,10,-6,4
AEK Athens,9130,1,4,2,0,7,1,6,14
PAOK Salonik,9130,2,3,2,1,11,5,6,11
P'thinaikos,9130,3,1,1,4,5,11,-6,4
Panionios,9130,4,1,1,4,4,10,-6,4
AEK Athens,9131,1,4,2,0,7,1,6,14
PAOK Salonik,9131,2,3,2,1,10,4,6,11
P'thinaikos,9131,3,1,1,4,4,10,-6,4
Panionios,9131,3,1,1,4,4,10,-6,4
AEK Athens,9132,1,4,2,0,7,1,6,14
PAOK Salonik,9132,2,2,3,1,9,4,5,9
P'thinaikos,9132,3,1,2,3,4,9,-5,5
Panionios,9132,4,1,1,4,4,10,-6,4
AEK Athens,9133,1,4,2,0,7,1,6,14
PAOK Salonik,9133,2,3,2,1,12,4,8,11
Panionios,9133,3,1,1,4,4,10,-6,4
P'thinaikos,9133,4,1,1,4,4,12,-8,4
AEK Athens,9134,1,4,2,0,7,1,6,14
PAOK Salonik,9134,2,2,2,2,10,6,4,8
P'thinaikos,9134,3,2,1,3,6,10,-4,7
Panionios,9134,4,1,1,4,4,10,-6,4
AEK Athens,9135,1,4,2,0,7,1,6,14
PAOK Salonik,9135,2,2,2,2,9,6,3,8
P'thinaikos,9135,3,2,1,3,6,9,-3,7
Panionios,9135,4,1,1,4,4,10,-6,4
AEK Athens,9136,1,4,2,0,7,1,6,14
PAOK Salonik,9136,2,3,2,1,13,4,9,11
Panionios,9136,3,1,1,4,4,10,-6,4
P'thinaikos,9136,4,1,1,4,4,13,-9,4
AEK Athens,9137,1,4,2,0,7,1,6,14
PAOK Salonik,9137,2,2,2,2,9,5,4,8
P'thinaikos,9137,3,2,1,3,5,9,-4,7
Panionios,9137,4,1,1,4,4,10,-6,4
AEK Athens,9138,1,4,2,0,7,1,6,14
PAOK Salonik,9138,2,2,3,1,10,5,5,9
P'thinaikos,9138,3,1,2,3,5,10,-5,5
Panionios,9138,4,1,1,4,4,10,-6,4
AEK Athens,9139,1,4,2,0,7,1,6,14
PAOK Salonik,9139,2,3,2,1,11,4,7,11
Panionios,9139,3,1,1,4,4,10,-6,4
P'thinaikos,9139,4,1,1,4,4,11,-7,4
AEK Athens,9140,1,4,2,0,7,1,6,14
PAOK Salonik,9140,2,2,2,2,9,5,4,8
P'thinaikos,9140,3,2,1,3,5,9,-4,7
Panionios,9140,4,1,1,4,4,10,-6,4
AEK Athens,9141,1,4,2,0,7,1,6,14
PAOK Salonik,9141,2,2,3,1,11,6,5,9
P'thinaikos,9141,3,1,2,3,6,11,-5,5
Panionios,9141,4,1,1,4,4,10,-6,4
AEK Athens,9142,1,4,2,0,7,1,6,14
PAOK Salonik,9142,2,3,2,1,11,5,6,11
P'thinaikos,9142,3,1,1,4,5,11,-6,4
Panionios,9142,4,1,1,4,4,10,-6,4
AEK Athens,9143,1,4,2,0,7,1,6,14
PAOK Salonik,9143,2,2,3,1,11,6,5,9
P'thinaikos,9143,3,1,2,3,6,11,-5,5
Panionios,9143,4,1,1,4,4,10,-6,4
AEK Athens,9144,1,4,2,0,7,1,6,14
PAOK Salonik,9144,2,2,3,1,10,5,5,9
P'thinaikos,9144,3,1,2,3,5,10,-5,5
Panionios,9144,4,1,1,4,4,10,-6,4
AEK Athens,9145,1,4,2,0,7,1,6,14
PAOK Salonik,9145,2,2,3,1,9,4,5,9
P'thinaikos,9145,3,1,2,3,4,9,-5,5
Panionios,9145,4,1,1,4,4,10,-6,4
AEK Athens,9146,1,4,2,0,7,1,6,14
PAOK Salonik,9146,2,2,2,2,10,6,4,8
P'thinaikos,9146,3,2,1,3,6,10,-4,7
Panionios,9146,4,1,1,4,4,10,-6,4
AEK Athens,9147,1,4,2,0,7,1,6,14
PAOK Salonik,9147,2,2,2,2,9,5,4,8
P'thinaikos,9147,3,2,1,3,5,9,-4,7
Panionios,9147,4,1,1,4,4,10,-6,4
AEK Athens,9148,1,4,2,0,7,1,6,14
PAOK Salonik,9148,2,2,3,1,10,5,5,9
P'thinaikos,9148,3,1,2,3,5,10,-5,5
Panionios,9148,4,1,1,4,4,10,-6,4
AEK Athens,9149,1,4,2,0,7,1,6,14
PAOK Salonik,9149,2,2,2,2,10,9,1,8
P'thinaikos,9149,3,2,1,3,9,10,-1,7
Panionios,9149,4,1,1,4,4,10,-6,4
AEK Athens,9150,1,4,2,0,7,1,6,14
PAOK Salonik,9150,2,2,2,2,9,6,3,8
P'thinaikos,9150,3,2,1,3,6,9,-3,7
Panionios,9150,4,1,1,4,4,10,-6,4
AEK Athens,9151,1,4,2,0,7,1,6,14
PAOK Salonik,9151,2,2,2,2,10,6,4,8
P'thinaikos,9151,3,2,1,3,6,10,-4,7
Panionios,9151,4,1,1,4,4,10,-6,4
AEK Athens,9152,1,4,2,0,7,1,6,14
PAOK Salonik,9152,2,3,2,1,11,5,6,11
P'thinaikos,9152,3,1,1,4,5,11,-6,4
Panionios,9152,4,1,1,4,4,10,-6,4
AEK Athens,9153,1,4,2,0,7,1,6,14
PAOK Salonik,9153,2,2,2,2,10,7,3,8
P'thinaikos,9153,3,2,1,3,7,10,-3,7
Panionios,9153,4,1,1,4,4,10,-6,4
AEK Athens,9154,1,4,2,0,7,1,6,14
PAOK Salonik,9154,2,2,3,1,10,5,5,9
P'thinaikos,9154,3,1,2,3,5,10,-5,5
Panionios,9154,4,1,1,4,4,10,-6,4
AEK Athens,9155,1,4,2,0,7,1,6,14
PAOK Salonik,9155,2,2,2,2,10,7,3,8
P'thinaikos,9155,3,2,1,3,7,10,-3,7
Panionios,9155,4,1,1,4,4,10,-6,4
AEK Athens,9156,1,4,2,0,7,1,6,14
PAOK Salonik,9156,2,2,2,2,9,6,3,8
P'thinaikos,9156,3,2,1,3,6,9,-3,7
Panionios,9156,4,1,1,4,4,10,-6,4
AEK Athens,9157,1,4,2,0,7,1,6,14
PAOK Salonik,9157,2,3,2,1,14,5,9,11
Panionios,9157,3,1,1,4,4,10,-6,4
P'thinaikos,9157,4,1,1,4,5,14,-9,4
AEK Athens,9158,1,4,2,0,7,1,6,14
PAOK Salonik,9158,2,3,2,1,11,5,6,11
P'thinaikos,9158,3,1,1,4,5,11,-6,4
Panionios,9158,4,1,1,4,4,10,-6,4
AEK Athens,9159,1,4,2,0,7,1,6,14
PAOK Salonik,9159,2,2,3,1,10,5,5,9
P'thinaikos,9159,3,1,2,3,5,10,-5,5
Panionios,9159,4,1,1,4,4,10,-6,4
AEK Athens,9160,1,4,2,0,7,1,6,14
PAOK Salonik,9160,2,2,2,2,9,6,3,8
P'thinaikos,9160,3,2,1,3,6,9,-3,7
Panionios,9160,4,1,1,4,4,10,-6,4
AEK Athens,9161,1,4,2,0,7,1,6,14
PAOK Salonik,9161,2,2,2,2,9,5,4,8
P'thinaikos,9161,3,2,1,3,5,9,-4,7
Panionios,9161,4,1,1,4,4,10,-6,4
AEK Athens,9162,1,4,2,0,7,1,6,14
PAOK Salonik,9162,2,2,3,1,10,5,5,9
P'thinaikos,9162,3,1,2,3,5,10,-5,5
Panionios,9162,4,1,1,4,4,10,-6,4
AEK Athens,9163,1,4,2,0,7,1,6,14
PAOK Salonik,9163,2,3,2,1,11,5,6,11
P'thinaikos,9163,3,1,1,4,5,11,-6,4
Panionios,9163,4,1,1,4,4,10,-6,4
AEK Athens,9164,1,4,2,0,7,1,6,14
PAOK Salonik,9164,2,2,2,2,11,8,3,8
P'thinaikos,9164,3,2,1,3,8,11,-3,7
Panionios,9164,4,1,1,4,4,10,-6,4
AEK Athens,9165,1,4,2,0,7,1,6,14
PAOK Salonik,9165,2,3,2,1,11,5,6,11
P'thinaikos,9165,3,1,1,4,5,11,-6,4
Panionios,9165,4,1,1,4,4,10,-6,4
AEK Athens,9166,1,4,2,0,7,1,6,14
PAOK Salonik,9166,2,3,2,1,11,4,7,11
Panionios,9166,3,1,1,4,4,10,-6,4
P'thinaikos,9166,4,1,1,4,4,11,-7,4
AEK Athens,9167,1,4,2,0,7,1,6,14
PAOK Salonik,9167,2,2,2,2,11,8,3,8
P'thinaikos,9167,3,2,1,3,8,11,-3,7
Panionios,9167,4,1,1,4,4,10,-6,4
AEK Athens,9168,1,4,2,0,7,1,6,14
PAOK Salonik,9168,2,2,2,2,10,6,4,8
P'thinaikos,9168,3,2,1,3,6,10,-4,7
Panionios,9168,4,1,1,4,4,10,-6,4
AEK Athens,9169,1,4,2,0,7,1,6,14
PAOK Salonik,9169,2,2,3,1,10,5,5,9
P'thinaikos,9169,3,1,2,3,5,10,-5,5
Panionios,9169,4,1,1,4,4,10,-6,4
AEK Athens,9170,1,4,2,0,7,1,6,14
PAOK Salonik,9170,2,2,2,2,11,7,4,8
P'thinaikos,9170,3,2,1,3,7,11,-4,7
Panionios,9170,4,1,1,4,4,10,-6,4
AEK Athens,9171,1,4,2,0,7,1,6,14
PAOK Salonik,9171,2,2,2,2,9,5,4,8
P'thinaikos,9171,3,2,1,3,5,9,-4,7
Panionios,9171,4,1,1,4,4,10,-6,4
AEK Athens,9172,1,4,2,0,7,1,6,14
PAOK Salonik,9172,2,3,2,1,11,5,6,11
P'thinaikos,9172,3,1,1,4,5,11,-6,4
Panionios,9172,4,1,1,4,4,10,-6,4
AEK Athens,9173,1,4,2,0,7,1,6,14
PAOK Salonik,9173,2,2,2,2,10,6,4,8
P'thinaikos,9173,3,2,1,3,6,10,-4,7
Panionios,9173,4,1,1,4,4,10,-6,4
AEK Athens,9174,1,4,2,0,7,1,6,14
PAOK Salonik,9174,2,2,2,2,9,5,4,8
P'thinaikos,9174,3,2,1,3,5,9,-4,7
Panionios,9174,4,1,1,4,4,10,-6,4
AEK Athens,9175,1,4,2,0,7,1,6,14
PAOK Salonik,9175,2,2,2,2,9,6,3,8
P'thinaikos,9175,3,2,1,3,6,9,-3,7
Panionios,9175,4,1,1,4,4,10,-6,4
AEK Athens,9176,1,4,2,0,7,1,6,14
PAOK Salonik,9176,2,2,2,2,9,5,4,8
P'thinaikos,9176,3,2,1,3,5,9,-4,7
Panionios,9176,4,1,1,4,4,10,-6,4
AEK Athens,9177,1,4,2,0,7,1,6,14
PAOK Salonik,9177,2,2,3,1,9,4,5,9
P'thinaikos,9177,3,1,2,3,4,9,-5,5
Panionios,9177,4,1,1,4,4,10,-6,4
AEK Athens,9178,1,4,2,0,7,1,6,14
PAOK Salonik,9178,2,2,2,2,10,6,4,8
P'thinaikos,9178,3,2,1,3,6,10,-4,7
Panionios,9178,4,1,1,4,4,10,-6,4
AEK Athens,9179,1,4,2,0,7,1,6,14
PAOK Salonik,9179,2,2,3,1,10,5,5,9
P'thinaikos,9179,3,1,2,3,5,10,-5,5
Panionios,9179,4,1,1,4,4,10,-6,4
AEK Athens,9180,1,4,2,0,7,1,6,14
PAOK Salonik,9180,2,2,2,2,10,7,3,8
P'thinaikos,9180,3,2,1,3,7,10,-3,7
Panionios,9180,4,1,1,4,4,10,-6,4
AEK Athens,9181,1,4,2,0,7,1,6,14
PAOK Salonik,9181,2,3,2,1,11,4,7,11
Panionios,9181,3,1,1,4,4,10,-6,4
P'thinaikos,9181,4,1,1,4,4,11,-7,4
AEK Athens,9182,1,4,2,0,7,1,6,14
PAOK Salonik,9182,2,2,3,1,9,4,5,9
P'thinaikos,9182,3,1,2,3,4,9,-5,5
Panionios,9182,4,1,1,4,4,10,-6,4
AEK Athens,9183,1,4,2,0,7,1,6,14
PAOK Salonik,9183,2,3,2,1,15,6,9,11
Panionios,9183,3,1,1,4,4,10,-6,4
P'thinaikos,9183,4,1,1,4,6,15,-9,4
AEK Athens,9184,1,4,2,0,7,1,6,14
PAOK Salonik,9184,2,2,2,2,10,8,2,8
P'thinaikos,9184,3,2,1,3,8,10,-2,7
Panionios,9184,4,1,1,4,4,10,-6,4
AEK Athens,9185,1,4,2,0,7,1,6,14
PAOK Salonik,9185,2,3,2,1,12,4,8,11
Panionios,9185,3,1,1,4,4,10,-6,4
P'thinaikos,9185,4,1,1,4,4,12,-8,4
AEK Athens,9186,1,4,2,0,7,1,6,14
PAOK Salonik,9186,2,2,3,1,9,4,5,9
P'thinaikos,9186,3,1,2,3,4,9,-5,5
Panionios,9186,4,1,1,4,4,10,-6,4
AEK Athens,9187,1,4,2,0,7,1,6,14
PAOK Salonik,9187,2,3,2,1,12,6,6,11
P'thinaikos,9187,3,1,1,4,6,12,-6,4
Panionios,9187,4,1,1,4,4,10,-6,4
AEK Athens,9188,1,4,2,0,7,1,6,14
PAOK Salonik,9188,2,3,2,1,12,5,7,11
Panionios,9188,3,1,1,4,4,10,-6,4
P'thinaikos,9188,4,1,1,4,5,12,-7,4
AEK Athens,9189,1,4,2,0,7,1,6,14
PAOK Salonik,9189,2,2,3,1,9,4,5,9
P'thinaikos,9189,3,1,2,3,4,9,-5,5
Panionios,9189,4,1,1,4,4,10,-6,4
AEK Athens,9190,1,4,2,0,7,1,6,14
PAOK Salonik,9190,2,2,3,1,10,5,5,9
P'thinaikos,9190,3,1,2,3,5,10,-5,5
Panionios,9190,4,1,1,4,4,10,-6,4
AEK Athens,9191,1,4,2,0,7,1,6,14
PAOK Salonik,9191,2,3,2,1,10,4,6,11
P'thinaikos,9191,3,1,1,4,4,10,-6,4
Panionios,9191,3,1,1,4,4,10,-6,4
AEK Athens,9192,1,4,2,0,7,1,6,14
PAOK Salonik,9192,2,2,2,2,9,6,3,8
P'thinaikos,9192,3,2,1,3,6,9,-3,7
Panionios,9192,4,1,1,4,4,10,-6,4
AEK Athens,9193,1,4,2,0,7,1,6,14
PAOK Salonik,9193,2,2,2,2,9,6,3,8
P'thinaikos,9193,3,2,1,3,6,9,-3,7
Panionios,9193,4,1,1,4,4,10,-6,4
AEK Athens,9194,1,4,2,0,7,1,6,14
PAOK Salonik,9194,2,2,3,1,10,5,5,9
P'thinaikos,9194,3,1,2,3,5,10,-5,5
Panionios,9194,4,1,1,4,4,10,-6,4
AEK Athens,9195,1,4,2,0,7,1,6,14
PAOK Salonik,9195,2,2,2,2,9,5,4,8
P'thinaikos,9195,3,2,1,3,5,9,-4,7
Panionios,9195,4,1,1,4,4,10,-6,4
AEK Athens,9196,1,4,2,0,7,1,6,14
PAOK Salonik,9196,2,2,2,2,9,5,4,8
P'thinaikos,9196,3,2,1,3,5,9,-4,7
Panionios,9196,4,1,1,4,4,10,-6,4
AEK Athens,9197,1,4,2,0,7,1,6,14
PAOK Salonik,9197,2,3,2,1,10,4,6,11
P'thinaikos,9197,3,1,1,4,4,10,-6,4
Panionios,9197,3,1,1,4,4,10,-6,4
AEK Athens,9198,1,4,2,0,7,1,6,14
PAOK Salonik,9198,2,3,2,1,11,4,7,11
Panionios,9198,3,1,1,4,4,10,-6,4
P'thinaikos,9198,4,1,1,4,4,11,-7,4
AEK Athens,9199,1,4,2,0,7,1,6,14
PAOK Salonik,9199,2,3,2,1,12,6,6,11
P'thinaikos,9199,3,1,1,4,6,12,-6,4
Panionios,9199,4,1,1,4,4,10,-6,4
AEK Athens,9200,1,4,2,0,7,1,6,14
PAOK Salonik,9200,2,3,2,1,11,5,6,11
P'thinaikos,9200,3,1,1,4,5,11,-6,4
Panionios,9200,4,1,1,4,4,10,-6,4
AEK Athens,9201,1,4,2,0,7,1,6,14
PAOK Salonik,9201,2,2,2,2,9,5,4,8
P'thinaikos,9201,3,2,1,3,5,9,-4,7
Panionios,9201,4,1,1,4,4,10,-6,4
AEK Athens,9202,1,4,2,0,7,1,6,14
PAOK Salonik,9202,2,3,2,1,10,4,6,11
P'thinaikos,9202,3,1,1,4,4,10,-6,4
Panionios,9202,3,1,1,4,4,10,-6,4
AEK Athens,9203,1,4,2,0,7,1,6,14
PAOK Salonik,9203,2,3,2,1,10,4,6,11
P'thinaikos,9203,3,1,1,4,4,10,-6,4
Panionios,9203,3,1,1,4,4,10,-6,4
AEK Athens,9204,1,4,2,0,7,1,6,14
PAOK Salonik,9204,2,2,2,2,10,7,3,8
P'thinaikos,9204,3,2,1,3,7,10,-3,7
Panionios,9204,4,1,1,4,4,10,-6,4
AEK Athens,9205,1,4,2,0,7,1,6,14
PAOK Salonik,9205,2,2,2,2,10,6,4,8
P'thinaikos,9205,3,2,1,3,6,10,-4,7
Panionios,9205,4,1,1,4,4,10,-6,4
AEK Athens,9206,1,4,2,0,7,1,6,14
PAOK Salonik,9206,2,3,2,1,12,5,7,11
Panionios,9206,3,1,1,4,4,10,-6,4
P'thinaikos,9206,4,1,1,4,5,12,-7,4
AEK Athens,9207,1,4,2,0,7,1,6,14
PAOK Salonik,9207,2,2,3,1,9,4,5,9
P'thinaikos,9207,3,1,2,3,4,9,-5,5
Panionios,9207,4,1,1,4,4,10,-6,4
AEK Athens,9208,1,4,2,0,7,1,6,14
PAOK Salonik,9208,2,2,2,2,9,5,4,8
P'thinaikos,9208,3,2,1,3,5,9,-4,7
Panionios,9208,4,1,1,4,4,10,-6,4
AEK Athens,9209,1,4,2,0,7,1,6,14
PAOK Salonik,9209,2,2,3,1,11,6,5,9
P'thinaikos,9209,3,1,2,3,6,11,-5,5
Panionios,9209,4,1,1,4,4,10,-6,4
AEK Athens,9210,1,4,2,0,7,1,6,14
PAOK Salonik,9210,2,2,2,2,11,7,4,8
P'thinaikos,9210,3,2,1,3,7,11,-4,7
Panionios,9210,4,1,1,4,4,10,-6,4
AEK Athens,9211,1,4,2,0,7,1,6,14
PAOK Salonik,9211,2,2,2,2,10,6,4,8
P'thinaikos,9211,3,2,1,3,6,10,-4,7
Panionios,9211,4,1,1,4,4,10,-6,4
AEK Athens,9212,1,4,2,0,7,1,6,14
PAOK Salonik,9212,2,3,2,1,11,5,6,11
P'thinaikos,9212,3,1,1,4,5,11,-6,4
Panionios,9212,4,1,1,4,4,10,-6,4
AEK Athens,9213,1,4,2,0,7,1,6,14
PAOK Salonik,9213,2,3,2,1,11,5,6,11
P'thinaikos,9213,3,1,1,4,5,11,-6,4
Panionios,9213,4,1,1,4,4,10,-6,4
AEK Athens,9214,1,4,2,0,7,1,6,14
PAOK Salonik,9214,2,3,2,1,10,4,6,11
P'thinaikos,9214,3,1,1,4,4,10,-6,4
Panionios,9214,3,1,1,4,4,10,-6,4
AEK Athens,9215,1,4,2,0,7,1,6,14
PAOK Salonik,9215,2,2,2,2,10,6,4,8
P'thinaikos,9215,3,2,1,3,6,10,-4,7
Panionios,9215,4,1,1,4,4,10,-6,4
AEK Athens,9216,1,4,2,0,7,1,6,14
PAOK Salonik,9216,2,2,2,2,10,6,4,8
P'thinaikos,9216,3,2,1,3,6,10,-4,7
Panionios,9216,4,1,1,4,4,10,-6,4
AEK Athens,9217,1,4,2,0,7,1,6,14
PAOK Salonik,9217,2,3,2,1,11,4,7,11
Panionios,9217,3,1,1,4,4,10,-6,4
P'thinaikos,9217,4,1,1,4,4,11,-7,4
AEK Athens,9218,1,4,2,0,7,1,6,14
PAOK Salonik,9218,2,2,2,2,10,6,4,8
P'thinaikos,9218,3,2,1,3,6,10,-4,7
Panionios,9218,4,1,1,4,4,10,-6,4
AEK Athens,9219,1,4,2,0,7,1,6,14
PAOK Salonik,9219,2,2,2,2,10,7,3,8
P'thinaikos,9219,3,2,1,3,7,10,-3,7
Panionios,9219,4,1,1,4,4,10,-6,4
AEK Athens,9220,1,4,2,0,7,1,6,14
PAOK Salonik,9220,2,3,2,1,11,4,7,11
Panionios,9220,3,1,1,4,4,10,-6,4
P'thinaikos,9220,4,1,1,4,4,11,-7,4
AEK Athens,9221,1,4,2,0,7,1,6,14
PAOK Salonik,9221,2,2,3,1,10,5,5,9
P'thinaikos,9221,3,1,2,3,5,10,-5,5
Panionios,9221,4,1,1,4,4,10,-6,4
AEK Athens,9222,1,4,2,0,7,1,6,14
PAOK Salonik,9222,2,2,3,1,10,5,5,9
P'thinaikos,9222,3,1,2,3,5,10,-5,5
Panionios,9222,4,1,1,4,4,10,-6,4
AEK Athens,9223,1,4,2,0,7,1,6,14
PAOK Salonik,9223,2,3,2,1,13,7,6,11
P'thinaikos,9223,3,1,1,4,7,13,-6,4
Panionios,9223,4,1,1,4,4,10,-6,4
AEK Athens,9224,1,4,2,0,7,1,6,14
PAOK Salonik,9224,2,2,3,1,10,5,5,9
P'thinaikos,9224,3,1,2,3,5,10,-5,5
Panionios,9224,4,1,1,4,4,10,-6,4
AEK Athens,9225,1,4,2,0,7,1,6,14
PAOK Salonik,9225,2,2,2,2,10,6,4,8
P'thinaikos,9225,3,2,1,3,6,10,-4,7
Panionios,9225,4,1,1,4,4,10,-6,4
AEK Athens,9226,1,4,2,0,7,1,6,14
PAOK Salonik,9226,2,2,2,2,10,6,4,8
P'thinaikos,9226,3,2,1,3,6,10,-4,7
Panionios,9226,4,1,1,4,4,10,-6,4
AEK Athens,9227,1,4,2,0,7,1,6,14
PAOK Salonik,9227,2,3,2,1,10,4,6,11
P'thinaikos,9227,3,1,1,4,4,10,-6,4
Panionios,9227,3,1,1,4,4,10,-6,4
AEK Athens,9228,1,4,2,0,7,1,6,14
PAOK Salonik,9228,2,2,3,1,10,5,5,9
P'thinaikos,9228,3,1,2,3,5,10,-5,5
Panionios,9228,4,1,1,4,4,10,-6,4
AEK Athens,9229,1,4,2,0,7,1,6,14
PAOK Salonik,9229,2,2,3,1,10,5,5,9
P'thinaikos,9229,3,1,2,3,5,10,-5,5
Panionios,9229,4,1,1,4,4,10,-6,4
AEK Athens,9230,1,4,2,0,7,1,6,14
PAOK Salonik,9230,2,2,3,1,11,6,5,9
P'thinaikos,9230,3,1,2,3,6,11,-5,5
Panionios,9230,4,1,1,4,4,10,-6,4
AEK Athens,9231,1,4,2,0,7,1,6,14
PAOK Salonik,9231,2,2,3,1,11,6,5,9
P'thinaikos,9231,3,1,2,3,6,11,-5,5
Panionios,9231,4,1,1,4,4,10,-6,4
AEK Athens,9232,1,4,2,0,7,1,6,14
PAOK Salonik,9232,2,3,2,1,11,4,7,11
Panionios,9232,3,1,1,4,4,10,-6,4
P'thinaikos,9232,4,1,1,4,4,11,-7,4
AEK Athens,9233,1,4,2,0,7,1,6,14
PAOK Salonik,9233,2,2,2,2,10,6,4,8
P'thinaikos,9233,3,2,1,3,6,10,-4,7
Panionios,9233,4,1,1,4,4,10,-6,4
AEK Athens,9234,1,4,2,0,7,1,6,14
PAOK Salonik,9234,2,3,2,1,10,4,6,11
P'thinaikos,9234,3,1,1,4,4,10,-6,4
Panionios,9234,3,1,1,4,4,10,-6,4
AEK Athens,9235,1,4,2,0,7,1,6,14
PAOK Salonik,9235,2,2,2,2,10,6,4,8
P'thinaikos,9235,3,2,1,3,6,10,-4,7
Panionios,9235,4,1,1,4,4,10,-6,4
AEK Athens,9236,1,4,2,0,7,1,6,14
PAOK Salonik,9236,2,2,2,2,11,7,4,8
P'thinaikos,9236,3,2,1,3,7,11,-4,7
Panionios,9236,4,1,1,4,4,10,-6,4
AEK Athens,9237,1,4,2,0,7,1,6,14
PAOK Salonik,9237,2,2,3,1,10,5,5,9
P'thinaikos,9237,3,1,2,3,5,10,-5,5
Panionios,9237,4,1,1,4,4,10,-6,4
AEK Athens,9238,1,4,2,0,7,1,6,14
PAOK Salonik,9238,2,2,2,2,9,5,4,8
P'thinaikos,9238,3,2,1,3,5,9,-4,7
Panionios,9238,4,1,1,4,4,10,-6,4
AEK Athens,9239,1,4,2,0,7,1,6,14
PAOK Salonik,9239,2,2,2,2,9,5,4,8
P'thinaikos,9239,3,2,1,3,5,9,-4,7
Panionios,9239,4,1,1,4,4,10,-6,4
AEK Athens,9240,1,4,2,0,7,1,6,14
PAOK Salonik,9240,2,2,2,2,9,5,4,8
P'thinaikos,9240,3,2,1,3,5,9,-4,7
Panionios,9240,4,1,1,4,4,10,-6,4
AEK Athens,9241,1,4,2,0,7,1,6,14
PAOK Salonik,9241,2,3,2,1,10,4,6,11
P'thinaikos,9241,3,1,1,4,4,10,-6,4
Panionios,9241,3,1,1,4,4,10,-6,4
AEK Athens,9242,1,4,2,0,7,1,6,14
PAOK Salonik,9242,2,3,2,1,11,4,7,11
Panionios,9242,3,1,1,4,4,10,-6,4
P'thinaikos,9242,4,1,1,4,4,11,-7,4
AEK Athens,9243,1,4,2,0,7,1,6,14
PAOK Salonik,9243,2,3,2,1,10,4,6,11
P'thinaikos,9243,3,1,1,4,4,10,-6,4
Panionios,9243,3,1,1,4,4,10,-6,4
AEK Athens,9244,1,4,2,0,7,1,6,14
PAOK Salonik,9244,2,2,2,2,9,5,4,8
P'thinaikos,9244,3,2,1,3,5,9,-4,7
Panionios,9244,4,1,1,4,4,10,-6,4
AEK Athens,9245,1,4,2,0,7,1,6,14
PAOK Salonik,9245,2,3,2,1,11,5,6,11
P'thinaikos,9245,3,1,1,4,5,11,-6,4
Panionios,9245,4,1,1,4,4,10,-6,4
AEK Athens,9246,1,4,2,0,7,1,6,14
PAOK Salonik,9246,2,2,2,2,10,6,4,8
P'thinaikos,9246,3,2,1,3,6,10,-4,7
Panionios,9246,4,1,1,4,4,10,-6,4
AEK Athens,9247,1,4,2,0,7,1,6,14
PAOK Salonik,9247,2,3,2,1,13,4,9,11
Panionios,9247,3,1,1,4,4,10,-6,4
P'thinaikos,9247,4,1,1,4,4,13,-9,4
AEK Athens,9248,1,4,2,0,7,1,6,14
PAOK Salonik,9248,2,2,3,1,9,4,5,9
P'thinaikos,9248,3,1,2,3,4,9,-5,5
Panionios,9248,4,1,1,4,4,10,-6,4
AEK Athens,9249,1,4,2,0,7,1,6,14
PAOK Salonik,9249,2,2,2,2,10,7,3,8
P'thinaikos,9249,3,2,1,3,7,10,-3,7
Panionios,9249,4,1,1,4,4,10,-6,4
AEK Athens,9250,1,4,2,0,7,1,6,14
PAOK Salonik,9250,2,2,3,1,9,4,5,9
P'thinaikos,9250,3,1,2,3,4,9,-5,5
Panionios,9250,4,1,1,4,4,10,-6,4
AEK Athens,9251,1,4,2,0,7,1,6,14
PAOK Salonik,9251,2,2,2,2,10,7,3,8
P'thinaikos,9251,3,2,1,3,7,10,-3,7
Panionios,9251,4,1,1,4,4,10,-6,4
AEK Athens,9252,1,4,2,0,7,1,6,14
PAOK Salonik,9252,2,3,2,1,11,5,6,11
P'thinaikos,9252,3,1,1,4,5,11,-6,4
Panionios,9252,4,1,1,4,4,10,-6,4
AEK Athens,9253,1,4,2,0,7,1,6,14
PAOK Salonik,9253,2,2,2,2,9,6,3,8
P'thinaikos,9253,3,2,1,3,6,9,-3,7
Panionios,9253,4,1,1,4,4,10,-6,4
AEK Athens,9254,1,4,2,0,7,1,6,14
PAOK Salonik,9254,2,2,2,2,9,6,3,8
P'thinaikos,9254,3,2,1,3,6,9,-3,7
Panionios,9254,4,1,1,4,4,10,-6,4
AEK Athens,9255,1,4,2,0,7,1,6,14
PAOK Salonik,9255,2,2,3,1,10,5,5,9
P'thinaikos,9255,3,1,2,3,5,10,-5,5
Panionios,9255,4,1,1,4,4,10,-6,4
AEK Athens,9256,1,4,2,0,7,1,6,14
PAOK Salonik,9256,2,3,2,1,12,5,7,11
Panionios,9256,3,1,1,4,4,10,-6,4
P'thinaikos,9256,4,1,1,4,5,12,-7,4
AEK Athens,9257,1,4,2,0,7,1,6,14
PAOK Salonik,9257,2,3,2,1,11,4,7,11
Panionios,9257,3,1,1,4,4,10,-6,4
P'thinaikos,9257,4,1,1,4,4,11,-7,4
AEK Athens,9258,1,4,2,0,7,1,6,14
PAOK Salonik,9258,2,3,2,1,12,4,8,11
Panionios,9258,3,1,1,4,4,10,-6,4
P'thinaikos,9258,4,1,1,4,4,12,-8,4
AEK Athens,9259,1,4,2,0,7,1,6,14
PAOK Salonik,9259,2,3,2,1,11,5,6,11
P'thinaikos,9259,3,1,1,4,5,11,-6,4
Panionios,9259,4,1,1,4,4,10,-6,4
AEK Athens,9260,1,4,2,0,7,1,6,14
PAOK Salonik,9260,2,3,2,1,14,4,10,11
Panionios,9260,3,1,1,4,4,10,-6,4
P'thinaikos,9260,4,1,1,4,4,14,-10,4
AEK Athens,9261,1,4,2,0,7,1,6,14
PAOK Salonik,9261,2,2,2,2,9,7,2,8
P'thinaikos,9261,3,2,1,3,7,9,-2,7
Panionios,9261,4,1,1,4,4,10,-6,4
AEK Athens,9262,1,4,2,0,7,1,6,14
PAOK Salonik,9262,2,2,3,1,9,4,5,9
P'thinaikos,9262,3,1,2,3,4,9,-5,5
Panionios,9262,4,1,1,4,4,10,-6,4
AEK Athens,9263,1,4,2,0,7,1,6,14
PAOK Salonik,9263,2,3,2,1,13,6,7,11
Panionios,9263,3,1,1,4,4,10,-6,4
P'thinaikos,9263,4,1,1,4,6,13,-7,4
AEK Athens,9264,1,4,2,0,7,1,6,14
PAOK Salonik,9264,2,2,3,1,10,5,5,9
P'thinaikos,9264,3,1,2,3,5,10,-5,5
Panionios,9264,4,1,1,4,4,10,-6,4
AEK Athens,9265,1,4,2,0,7,1,6,14
PAOK Salonik,9265,2,2,2,2,9,6,3,8
P'thinaikos,9265,3,2,1,3,6,9,-3,7
Panionios,9265,4,1,1,4,4,10,-6,4
AEK Athens,9266,1,4,2,0,7,1,6,14
PAOK Salonik,9266,2,2,2,2,11,11,0,8
P'thinaikos,9266,3,2,1,3,11,11,0,7
Panionios,9266,4,1,1,4,4,10,-6,4
AEK Athens,9267,1,4,2,0,7,1,6,14
PAOK Salonik,9267,2,2,2,2,11,7,4,8
P'thinaikos,9267,3,2,1,3,7,11,-4,7
Panionios,9267,4,1,1,4,4,10,-6,4
AEK Athens,9268,1,4,2,0,7,1,6,14
PAOK Salonik,9268,2,2,3,1,10,5,5,9
P'thinaikos,9268,3,1,2,3,5,10,-5,5
Panionios,9268,4,1,1,4,4,10,-6,4
AEK Athens,9269,1,4,2,0,7,1,6,14
PAOK Salonik,9269,2,3,2,1,11,5,6,11
P'thinaikos,9269,3,1,1,4,5,11,-6,4
Panionios,9269,4,1,1,4,4,10,-6,4
AEK Athens,9270,1,4,2,0,7,1,6,14
PAOK Salonik,9270,2,2,3,1,10,5,5,9
P'thinaikos,9270,3,1,2,3,5,10,-5,5
Panionios,9270,4,1,1,4,4,10,-6,4
AEK Athens,9271,1,4,2,0,7,1,6,14
PAOK Salonik,9271,2,3,2,1,12,4,8,11
Panionios,9271,3,1,1,4,4,10,-6,4
P'thinaikos,9271,4,1,1,4,4,12,-8,4
AEK Athens,9272,1,4,2,0,7,1,6,14
PAOK Salonik,9272,2,3,2,1,12,4,8,11
Panionios,9272,3,1,1,4,4,10,-6,4
P'thinaikos,9272,4,1,1,4,4,12,-8,4
AEK Athens,9273,1,4,2,0,7,1,6,14
PAOK Salonik,9273,2,2,3,1,9,4,5,9
P'thinaikos,9273,3,1,2,3,4,9,-5,5
Panionios,9273,4,1,1,4,4,10,-6,4
AEK Athens,9274,1,4,2,0,7,1,6,14
PAOK Salonik,9274,2,2,2,2,10,6,4,8
P'thinaikos,9274,3,2,1,3,6,10,-4,7
Panionios,9274,4,1,1,4,4,10,-6,4
AEK Athens,9275,1,4,2,0,7,1,6,14
PAOK Salonik,9275,2,2,3,1,9,4,5,9
P'thinaikos,9275,3,1,2,3,4,9,-5,5
Panionios,9275,4,1,1,4,4,10,-6,4
AEK Athens,9276,1,4,2,0,7,1,6,14
PAOK Salonik,9276,2,2,3,1,9,4,5,9
P'thinaikos,9276,3,1,2,3,4,9,-5,5
Panionios,9276,4,1,1,4,4,10,-6,4
AEK Athens,9277,1,4,2,0,7,1,6,14
PAOK Salonik,9277,2,2,2,2,9,6,3,8
P'thinaikos,9277,3,2,1,3,6,9,-3,7
Panionios,9277,4,1,1,4,4,10,-6,4
AEK Athens,9278,1,4,2,0,7,1,6,14
PAOK Salonik,9278,2,2,2,2,9,5,4,8
P'thinaikos,9278,3,2,1,3,5,9,-4,7
Panionios,9278,4,1,1,4,4,10,-6,4
AEK Athens,9279,1,4,2,0,7,1,6,14
PAOK Salonik,9279,2,2,2,2,9,8,1,8
P'thinaikos,9279,3,2,1,3,8,9,-1,7
Panionios,9279,4,1,1,4,4,10,-6,4
AEK Athens,9280,1,4,2,0,7,1,6,14
PAOK Salonik,9280,2,2,3,1,10,5,5,9
P'thinaikos,9280,3,1,2,3,5,10,-5,5
Panionios,9280,4,1,1,4,4,10,-6,4
AEK Athens,9281,1,4,2,0,7,1,6,14
PAOK Salonik,9281,2,3,2,1,12,5,7,11
Panionios,9281,3,1,1,4,4,10,-6,4
P'thinaikos,9281,4,1,1,4,5,12,-7,4
AEK Athens,9282,1,4,2,0,7,1,6,14
PAOK Salonik,9282,2,2,3,1,11,6,5,9
P'thinaikos,9282,3,1,2,3,6,11,-5,5
Panionios,9282,4,1,1,4,4,10,-6,4
AEK Athens,9283,1,4,2,0,7,1,6,14
PAOK Salonik,9283,2,2,3,1,10,5,5,9
P'thinaikos,9283,3,1,2,3,5,10,-5,5
Panionios,9283,4,1,1,4,4,10,-6,4
AEK Athens,9284,1,4,2,0,7,1,6,14
PAOK Salonik,9284,2,3,2,1,10,4,6,11
P'thinaikos,9284,3,1,1,4,4,10,-6,4
Panionios,9284,3,1,1,4,4,10,-6,4
AEK Athens,9285,1,4,2,0,7,1,6,14
PAOK Salonik,9285,2,3,2,1,11,5,6,11
P'thinaikos,9285,3,1,1,4,5,11,-6,4
Panionios,9285,4,1,1,4,4,10,-6,4
AEK Athens,9286,1,4,2,0,7,1,6,14
PAOK Salonik,9286,2,2,3,1,10,5,5,9
P'thinaikos,9286,3,1,2,3,5,10,-5,5
Panionios,9286,4,1,1,4,4,10,-6,4
AEK Athens,9287,1,4,2,0,7,1,6,14
PAOK Salonik,9287,2,3,2,1,13,6,7,11
Panionios,9287,3,1,1,4,4,10,-6,4
P'thinaikos,9287,4,1,1,4,6,13,-7,4
AEK Athens,9288,1,4,2,0,7,1,6,14
PAOK Salonik,9288,2,2,3,1,10,5,5,9
P'thinaikos,9288,3,1,2,3,5,10,-5,5
Panionios,9288,4,1,1,4,4,10,-6,4
AEK Athens,9289,1,4,2,0,7,1,6,14
PAOK Salonik,9289,2,2,3,1,10,5,5,9
P'thinaikos,9289,3,1,2,3,5,10,-5,5
Panionios,9289,4,1,1,4,4,10,-6,4
AEK Athens,9290,1,4,2,0,7,1,6,14
PAOK Salonik,9290,2,3,2,1,10,4,6,11
P'thinaikos,9290,3,1,1,4,4,10,-6,4
Panionios,9290,3,1,1,4,4,10,-6,4
AEK Athens,9291,1,4,2,0,7,1,6,14
PAOK Salonik,9291,2,3,2,1,11,4,7,11
Panionios,9291,3,1,1,4,4,10,-6,4
P'thinaikos,9291,4,1,1,4,4,11,-7,4
AEK Athens,9292,1,4,2,0,7,1,6,14
PAOK Salonik,9292,2,3,2,1,10,4,6,11
P'thinaikos,9292,3,1,1,4,4,10,-6,4
Panionios,9292,3,1,1,4,4,10,-6,4
AEK Athens,9293,1,4,2,0,7,1,6,14
PAOK Salonik,9293,2,2,2,2,10,7,3,8
P'thinaikos,9293,3,2,1,3,7,10,-3,7
Panionios,9293,4,1,1,4,4,10,-6,4
AEK Athens,9294,1,4,2,0,7,1,6,14
PAOK Salonik,9294,2,2,2,2,10,7,3,8
P'thinaikos,9294,3,2,1,3,7,10,-3,7
Panionios,9294,4,1,1,4,4,10,-6,4
AEK Athens,9295,1,4,2,0,7,1,6,14
PAOK Salonik,9295,2,3,2,1,10,4,6,11
P'thinaikos,9295,3,1,1,4,4,10,-6,4
Panionios,9295,3,1,1,4,4,10,-6,4
AEK Athens,9296,1,4,2,0,7,1,6,14
PAOK Salonik,9296,2,2,2,2,9,5,4,8
P'thinaikos,9296,3,2,1,3,5,9,-4,7
Panionios,9296,4,1,1,4,4,10,-6,4
AEK Athens,9297,1,4,2,0,7,1,6,14
PAOK Salonik,9297,2,3,2,1,11,4,7,11
Panionios,9297,3,1,1,4,4,10,-6,4
P'thinaikos,9297,4,1,1,4,4,11,-7,4
AEK Athens,9298,1,4,2,0,7,1,6,14
PAOK Salonik,9298,2,2,2,2,9,6,3,8
P'thinaikos,9298,3,2,1,3,6,9,-3,7
Panionios,9298,4,1,1,4,4,10,-6,4
AEK Athens,9299,1,4,2,0,7,1,6,14
PAOK Salonik,9299,2,3,2,1,12,4,8,11
Panionios,9299,3,1,1,4,4,10,-6,4
P'thinaikos,9299,4,1,1,4,4,12,-8,4
AEK Athens,9300,1,4,2,0,7,1,6,14
PAOK Salonik,9300,2,2,3,1,9,4,5,9
P'thinaikos,9300,3,1,2,3,4,9,-5,5
Panionios,9300,4,1,1,4,4,10,-6,4
AEK Athens,9301,1,4,2,0,7,1,6,14
PAOK Salonik,9301,2,3,2,1,11,5,6,11
P'thinaikos,9301,3,1,1,4,5,11,-6,4
Panionios,9301,4,1,1,4,4,10,-6,4
AEK Athens,9302,1,4,2,0,7,1,6,14
PAOK Salonik,9302,2,2,2,2,10,6,4,8
P'thinaikos,9302,3,2,1,3,6,10,-4,7
Panionios,9302,4,1,1,4,4,10,-6,4
AEK Athens,9303,1,4,2,0,7,1,6,14
PAOK Salonik,9303,2,2,2,2,10,8,2,8
P'thinaikos,9303,3,2,1,3,8,10,-2,7
Panionios,9303,4,1,1,4,4,10,-6,4
AEK Athens,9304,1,4,2,0,7,1,6,14
PAOK Salonik,9304,2,2,3,1,10,5,5,9
P'thinaikos,9304,3,1,2,3,5,10,-5,5
Panionios,9304,4,1,1,4,4,10,-6,4
AEK Athens,9305,1,4,2,0,7,1,6,14
PAOK Salonik,9305,2,2,2,2,10,6,4,8
P'thinaikos,9305,3,2,1,3,6,10,-4,7
Panionios,9305,4,1,1,4,4,10,-6,4
AEK Athens,9306,1,4,2,0,7,1,6,14
PAOK Salonik,9306,2,3,2,1,12,5,7,11
Panionios,9306,3,1,1,4,4,10,-6,4
P'thinaikos,9306,4,1,1,4,5,12,-7,4
AEK Athens,9307,1,4,2,0,7,1,6,14
PAOK Salonik,9307,2,2,2,2,11,7,4,8
P'thinaikos,9307,3,2,1,3,7,11,-4,7
Panionios,9307,4,1,1,4,4,10,-6,4
AEK Athens,9308,1,4,2,0,7,1,6,14
PAOK Salonik,9308,2,3,2,1,11,5,6,11
P'thinaikos,9308,3,1,1,4,5,11,-6,4
Panionios,9308,4,1,1,4,4,10,-6,4
AEK Athens,9309,1,4,2,0,7,1,6,14
PAOK Salonik,9309,2,2,2,2,9,6,3,8
P'thinaikos,9309,3,2,1,3,6,9,-3,7
Panionios,9309,4,1,1,4,4,10,-6,4
AEK Athens,9310,1,4,2,0,7,1,6,14
PAOK Salonik,9310,2,2,2,2,9,7,2,8
P'thinaikos,9310,3,2,1,3,7,9,-2,7
Panionios,9310,4,1,1,4,4,10,-6,4
AEK Athens,9311,1,4,2,0,7,1,6,14
PAOK Salonik,9311,2,2,3,1,9,4,5,9
P'thinaikos,9311,3,1,2,3,4,9,-5,5
Panionios,9311,4,1,1,4,4,10,-6,4
AEK Athens,9312,1,4,2,0,7,1,6,14
PAOK Salonik,9312,2,2,2,2,10,9,1,8
P'thinaikos,9312,3,2,1,3,9,10,-1,7
Panionios,9312,4,1,1,4,4,10,-6,4
AEK Athens,9313,1,4,2,0,7,1,6,14
PAOK Salonik,9313,2,2,2,2,9,5,4,8
P'thinaikos,9313,3,2,1,3,5,9,-4,7
Panionios,9313,4,1,1,4,4,10,-6,4
AEK Athens,9314,1,4,2,0,7,1,6,14
PAOK Salonik,9314,2,2,3,1,10,5,5,9
P'thinaikos,9314,3,1,2,3,5,10,-5,5
Panionios,9314,4,1,1,4,4,10,-6,4
AEK Athens,9315,1,4,2,0,7,1,6,14
PAOK Salonik,9315,2,2,2,2,9,6,3,8
P'thinaikos,9315,3,2,1,3,6,9,-3,7
Panionios,9315,4,1,1,4,4,10,-6,4
AEK Athens,9316,1,4,2,0,7,1,6,14
PAOK Salonik,9316,2,2,2,2,9,6,3,8
P'thinaikos,9316,3,2,1,3,6,9,-3,7
Panionios,9316,4,1,1,4,4,10,-6,4
AEK Athens,9317,1,4,2,0,7,1,6,14
PAOK Salonik,9317,2,2,2,2,10,6,4,8
P'thinaikos,9317,3,2,1,3,6,10,-4,7
Panionios,9317,4,1,1,4,4,10,-6,4
AEK Athens,9318,1,4,2,0,7,1,6,14
PAOK Salonik,9318,2,3,2,1,11,5,6,11
P'thinaikos,9318,3,1,1,4,5,11,-6,4
Panionios,9318,4,1,1,4,4,10,-6,4
AEK Athens,9319,1,4,2,0,7,1,6,14
PAOK Salonik,9319,2,2,3,1,9,4,5,9
P'thinaikos,9319,3,1,2,3,4,9,-5,5
Panionios,9319,4,1,1,4,4,10,-6,4
AEK Athens,9320,1,4,2,0,7,1,6,14
PAOK Salonik,9320,2,2,3,1,11,6,5,9
P'thinaikos,9320,3,1,2,3,6,11,-5,5
Panionios,9320,4,1,1,4,4,10,-6,4
AEK Athens,9321,1,4,2,0,7,1,6,14
PAOK Salonik,9321,2,2,3,1,10,5,5,9
P'thinaikos,9321,3,1,2,3,5,10,-5,5
Panionios,9321,4,1,1,4,4,10,-6,4
AEK Athens,9322,1,4,2,0,7,1,6,14
PAOK Salonik,9322,2,2,2,2,10,6,4,8
P'thinaikos,9322,3,2,1,3,6,10,-4,7
Panionios,9322,4,1,1,4,4,10,-6,4
AEK Athens,9323,1,4,2,0,7,1,6,14
PAOK Salonik,9323,2,2,2,2,9,6,3,8
P'thinaikos,9323,3,2,1,3,6,9,-3,7
Panionios,9323,4,1,1,4,4,10,-6,4
AEK Athens,9324,1,4,2,0,7,1,6,14
PAOK Salonik,9324,2,3,2,1,11,5,6,11
P'thinaikos,9324,3,1,1,4,5,11,-6,4
Panionios,9324,4,1,1,4,4,10,-6,4
AEK Athens,9325,1,4,2,0,7,1,6,14
PAOK Salonik,9325,2,3,2,1,11,4,7,11
Panionios,9325,3,1,1,4,4,10,-6,4
P'thinaikos,9325,4,1,1,4,4,11,-7,4
AEK Athens,9326,1,4,2,0,7,1,6,14
PAOK Salonik,9326,2,2,3,1,9,4,5,9
P'thinaikos,9326,3,1,2,3,4,9,-5,5
Panionios,9326,4,1,1,4,4,10,-6,4
AEK Athens,9327,1,4,2,0,7,1,6,14
PAOK Salonik,9327,2,2,3,1,9,4,5,9
P'thinaikos,9327,3,1,2,3,4,9,-5,5
Panionios,9327,4,1,1,4,4,10,-6,4
AEK Athens,9328,1,4,2,0,7,1,6,14
PAOK Salonik,9328,2,3,2,1,11,5,6,11
P'thinaikos,9328,3,1,1,4,5,11,-6,4
Panionios,9328,4,1,1,4,4,10,-6,4
AEK Athens,9329,1,4,2,0,7,1,6,14
PAOK Salonik,9329,2,3,2,1,11,4,7,11
Panionios,9329,3,1,1,4,4,10,-6,4
P'thinaikos,9329,4,1,1,4,4,11,-7,4
AEK Athens,9330,1,4,2,0,7,1,6,14
PAOK Salonik,9330,2,3,2,1,11,4,7,11
Panionios,9330,3,1,1,4,4,10,-6,4
P'thinaikos,9330,4,1,1,4,4,11,-7,4
AEK Athens,9331,1,4,2,0,7,1,6,14
PAOK Salonik,9331,2,3,2,1,12,4,8,11
Panionios,9331,3,1,1,4,4,10,-6,4
P'thinaikos,9331,4,1,1,4,4,12,-8,4
AEK Athens,9332,1,4,2,0,7,1,6,14
PAOK Salonik,9332,2,3,2,1,12,5,7,11
Panionios,9332,3,1,1,4,4,10,-6,4
P'thinaikos,9332,4,1,1,4,5,12,-7,4
AEK Athens,9333,1,4,2,0,7,1,6,14
PAOK Salonik,9333,2,3,2,1,10,4,6,11
P'thinaikos,9333,3,1,1,4,4,10,-6,4
Panionios,9333,3,1,1,4,4,10,-6,4
AEK Athens,9334,1,4,2,0,7,1,6,14
PAOK Salonik,9334,2,3,2,1,11,5,6,11
P'thinaikos,9334,3,1,1,4,5,11,-6,4
Panionios,9334,4,1,1,4,4,10,-6,4
AEK Athens,9335,1,4,2,0,7,1,6,14
PAOK Salonik,9335,2,2,2,2,9,5,4,8
P'thinaikos,9335,3,2,1,3,5,9,-4,7
Panionios,9335,4,1,1,4,4,10,-6,4
AEK Athens,9336,1,4,2,0,7,1,6,14
PAOK Salonik,9336,2,2,2,2,9,5,4,8
P'thinaikos,9336,3,2,1,3,5,9,-4,7
Panionios,9336,4,1,1,4,4,10,-6,4
AEK Athens,9337,1,4,2,0,7,1,6,14
PAOK Salonik,9337,2,2,2,2,9,5,4,8
P'thinaikos,9337,3,2,1,3,5,9,-4,7
Panionios,9337,4,1,1,4,4,10,-6,4
AEK Athens,9338,1,4,2,0,7,1,6,14
PAOK Salonik,9338,2,3,2,1,10,4,6,11
P'thinaikos,9338,3,1,1,4,4,10,-6,4
Panionios,9338,3,1,1,4,4,10,-6,4
AEK Athens,9339,1,4,2,0,7,1,6,14
PAOK Salonik,9339,2,3,2,1,13,6,7,11
Panionios,9339,3,1,1,4,4,10,-6,4
P'thinaikos,9339,4,1,1,4,6,13,-7,4
AEK Athens,9340,1,4,2,0,7,1,6,14
PAOK Salonik,9340,2,2,2,2,9,6,3,8
P'thinaikos,9340,3,2,1,3,6,9,-3,7
Panionios,9340,4,1,1,4,4,10,-6,4
AEK Athens,9341,1,4,2,0,7,1,6,14
PAOK Salonik,9341,2,3,2,1,10,4,6,11
P'thinaikos,9341,3,1,1,4,4,10,-6,4
Panionios,9341,3,1,1,4,4,10,-6,4
AEK Athens,9342,1,4,2,0,7,1,6,14
PAOK Salonik,9342,2,2,2,2,9,5,4,8
P'thinaikos,9342,3,2,1,3,5,9,-4,7
Panionios,9342,4,1,1,4,4,10,-6,4
AEK Athens,9343,1,4,2,0,7,1,6,14
PAOK Salonik,9343,2,2,3,1,11,6,5,9
P'thinaikos,9343,3,1,2,3,6,11,-5,5
Panionios,9343,4,1,1,4,4,10,-6,4
AEK Athens,9344,1,4,2,0,7,1,6,14
PAOK Salonik,9344,2,2,2,2,10,6,4,8
P'thinaikos,9344,3,2,1,3,6,10,-4,7
Panionios,9344,4,1,1,4,4,10,-6,4
AEK Athens,9345,1,4,2,0,7,1,6,14
PAOK Salonik,9345,2,3,2,1,12,5,7,11
Panionios,9345,3,1,1,4,4,10,-6,4
P'thinaikos,9345,4,1,1,4,5,12,-7,4
AEK Athens,9346,1,4,2,0,7,1,6,14
PAOK Salonik,9346,2,2,2,2,9,5,4,8
P'thinaikos,9346,3,2,1,3,5,9,-4,7
Panionios,9346,4,1,1,4,4,10,-6,4
AEK Athens,9347,1,4,2,0,7,1,6,14
PAOK Salonik,9347,2,2,3,1,11,6,5,9
P'thinaikos,9347,3,1,2,3,6,11,-5,5
Panionios,9347,4,1,1,4,4,10,-6,4
AEK Athens,9348,1,4,2,0,7,1,6,14
PAOK Salonik,9348,2,2,3,1,9,4,5,9
P'thinaikos,9348,3,1,2,3,4,9,-5,5
Panionios,9348,4,1,1,4,4,10,-6,4
AEK Athens,9349,1,4,2,0,7,1,6,14
PAOK Salonik,9349,2,2,2,2,9,6,3,8
P'thinaikos,9349,3,2,1,3,6,9,-3,7
Panionios,9349,4,1,1,4,4,10,-6,4
AEK Athens,9350,1,4,2,0,7,1,6,14
PAOK Salonik,9350,2,3,2,1,12,4,8,11
Panionios,9350,3,1,1,4,4,10,-6,4
P'thinaikos,9350,4,1,1,4,4,12,-8,4
AEK Athens,9351,1,4,2,0,7,1,6,14
PAOK Salonik,9351,2,3,2,1,10,4,6,11
P'thinaikos,9351,3,1,1,4,4,10,-6,4
Panionios,9351,3,1,1,4,4,10,-6,4
AEK Athens,9352,1,4,2,0,7,1,6,14
PAOK Salonik,9352,2,2,2,2,10,6,4,8
P'thinaikos,9352,3,2,1,3,6,10,-4,7
Panionios,9352,4,1,1,4,4,10,-6,4
AEK Athens,9353,1,4,2,0,7,1,6,14
PAOK Salonik,9353,2,3,2,1,13,6,7,11
Panionios,9353,3,1,1,4,4,10,-6,4
P'thinaikos,9353,4,1,1,4,6,13,-7,4
AEK Athens,9354,1,4,2,0,7,1,6,14
PAOK Salonik,9354,2,3,2,1,10,4,6,11
P'thinaikos,9354,3,1,1,4,4,10,-6,4
Panionios,9354,3,1,1,4,4,10,-6,4
AEK Athens,9355,1,4,2,0,7,1,6,14
PAOK Salonik,9355,2,3,2,1,12,4,8,11
Panionios,9355,3,1,1,4,4,10,-6,4
P'thinaikos,9355,4,1,1,4,4,12,-8,4
AEK Athens,9356,1,4,2,0,7,1,6,14
PAOK Salonik,9356,2,2,3,1,10,5,5,9
P'thinaikos,9356,3,1,2,3,5,10,-5,5
Panionios,9356,4,1,1,4,4,10,-6,4
AEK Athens,9357,1,4,2,0,7,1,6,14
PAOK Salonik,9357,2,3,2,1,10,4,6,11
P'thinaikos,9357,3,1,1,4,4,10,-6,4
Panionios,9357,3,1,1,4,4,10,-6,4
AEK Athens,9358,1,4,2,0,7,1,6,14
PAOK Salonik,9358,2,3,2,1,13,4,9,11
Panionios,9358,3,1,1,4,4,10,-6,4
P'thinaikos,9358,4,1,1,4,4,13,-9,4
AEK Athens,9359,1,4,2,0,7,1,6,14
PAOK Salonik,9359,2,2,3,1,11,6,5,9
P'thinaikos,9359,3,1,2,3,6,11,-5,5
Panionios,9359,4,1,1,4,4,10,-6,4
AEK Athens,9360,1,4,2,0,7,1,6,14
PAOK Salonik,9360,2,2,2,2,9,6,3,8
P'thinaikos,9360,3,2,1,3,6,9,-3,7
Panionios,9360,4,1,1,4,4,10,-6,4
AEK Athens,9361,1,4,2,0,7,1,6,14
PAOK Salonik,9361,2,3,2,1,11,5,6,11
P'thinaikos,9361,3,1,1,4,5,11,-6,4
Panionios,9361,4,1,1,4,4,10,-6,4
AEK Athens,9362,1,4,2,0,7,1,6,14
PAOK Salonik,9362,2,2,2,2,9,5,4,8
P'thinaikos,9362,3,2,1,3,5,9,-4,7
Panionios,9362,4,1,1,4,4,10,-6,4
AEK Athens,9363,1,4,2,0,7,1,6,14
PAOK Salonik,9363,2,3,2,1,12,4,8,11
Panionios,9363,3,1,1,4,4,10,-6,4
P'thinaikos,9363,4,1,1,4,4,12,-8,4
AEK Athens,9364,1,4,2,0,7,1,6,14
PAOK Salonik,9364,2,3,2,1,10,4,6,11
P'thinaikos,9364,3,1,1,4,4,10,-6,4
Panionios,9364,3,1,1,4,4,10,-6,4
AEK Athens,9365,1,4,2,0,7,1,6,14
PAOK Salonik,9365,2,3,2,1,12,4,8,11
Panionios,9365,3,1,1,4,4,10,-6,4
P'thinaikos,9365,4,1,1,4,4,12,-8,4
AEK Athens,9366,1,4,2,0,7,1,6,14
PAOK Salonik,9366,2,2,3,1,10,5,5,9
P'thinaikos,9366,3,1,2,3,5,10,-5,5
Panionios,9366,4,1,1,4,4,10,-6,4
AEK Athens,9367,1,4,2,0,7,1,6,14
PAOK Salonik,9367,2,2,3,1,10,5,5,9
P'thinaikos,9367,3,1,2,3,5,10,-5,5
Panionios,9367,4,1,1,4,4,10,-6,4
AEK Athens,9368,1,4,2,0,7,1,6,14
PAOK Salonik,9368,2,2,3,1,10,5,5,9
P'thinaikos,9368,3,1,2,3,5,10,-5,5
Panionios,9368,4,1,1,4,4,10,-6,4
AEK Athens,9369,1,4,2,0,7,1,6,14
PAOK Salonik,9369,2,2,2,2,9,5,4,8
P'thinaikos,9369,3,2,1,3,5,9,-4,7
Panionios,9369,4,1,1,4,4,10,-6,4
AEK Athens,9370,1,4,2,0,7,1,6,14
PAOK Salonik,9370,2,2,3,1,9,4,5,9
P'thinaikos,9370,3,1,2,3,4,9,-5,5
Panionios,9370,4,1,1,4,4,10,-6,4
AEK Athens,9371,1,4,2,0,7,1,6,14
PAOK Salonik,9371,2,2,2,2,10,7,3,8
P'thinaikos,9371,3,2,1,3,7,10,-3,7
Panionios,9371,4,1,1,4,4,10,-6,4
AEK Athens,9372,1,4,2,0,7,1,6,14
PAOK Salonik,9372,2,2,2,2,9,9,0,8
P'thinaikos,9372,3,2,1,3,9,9,0,7
Panionios,9372,4,1,1,4,4,10,-6,4
AEK Athens,9373,1,4,2,0,7,1,6,14
PAOK Salonik,9373,2,2,3,1,9,4,5,9
P'thinaikos,9373,3,1,2,3,4,9,-5,5
Panionios,9373,4,1,1,4,4,10,-6,4
AEK Athens,9374,1,4,2,0,7,1,6,14
PAOK Salonik,9374,2,2,3,1,9,4,5,9
P'thinaikos,9374,3,1,2,3,4,9,-5,5
Panionios,9374,4,1,1,4,4,10,-6,4
AEK Athens,9375,1,4,2,0,7,1,6,14
PAOK Salonik,9375,2,3,2,1,12,4,8,11
Panionios,9375,3,1,1,4,4,10,-6,4
P'thinaikos,9375,4,1,1,4,4,12,-8,4
AEK Athens,9376,1,4,2,0,7,1,6,14
PAOK Salonik,9376,2,3,2,1,10,4,6,11
P'thinaikos,9376,3,1,1,4,4,10,-6,4
Panionios,9376,3,1,1,4,4,10,-6,4
AEK Athens,9377,1,4,2,0,7,1,6,14
PAOK Salonik,9377,2,2,3,1,10,5,5,9
P'thinaikos,9377,3,1,2,3,5,10,-5,5
Panionios,9377,4,1,1,4,4,10,-6,4
AEK Athens,9378,1,4,2,0,7,1,6,14
PAOK Salonik,9378,2,2,3,1,10,5,5,9
P'thinaikos,9378,3,1,2,3,5,10,-5,5
Panionios,9378,4,1,1,4,4,10,-6,4
AEK Athens,9379,1,4,2,0,7,1,6,14
PAOK Salonik,9379,2,2,2,2,10,7,3,8
P'thinaikos,9379,3,2,1,3,7,10,-3,7
Panionios,9379,4,1,1,4,4,10,-6,4
AEK Athens,9380,1,4,2,0,7,1,6,14
PAOK Salonik,9380,2,3,2,1,10,4,6,11
P'thinaikos,9380,3,1,1,4,4,10,-6,4
Panionios,9380,3,1,1,4,4,10,-6,4
AEK Athens,9381,1,4,2,0,7,1,6,14
PAOK Salonik,9381,2,2,3,1,10,5,5,9
P'thinaikos,9381,3,1,2,3,5,10,-5,5
Panionios,9381,4,1,1,4,4,10,-6,4
AEK Athens,9382,1,4,2,0,7,1,6,14
PAOK Salonik,9382,2,2,2,2,9,6,3,8
P'thinaikos,9382,3,2,1,3,6,9,-3,7
Panionios,9382,4,1,1,4,4,10,-6,4
AEK Athens,9383,1,4,2,0,7,1,6,14
PAOK Salonik,9383,2,2,3,1,11,6,5,9
P'thinaikos,9383,3,1,2,3,6,11,-5,5
Panionios,9383,4,1,1,4,4,10,-6,4
AEK Athens,9384,1,4,2,0,7,1,6,14
PAOK Salonik,9384,2,2,3,1,10,5,5,9
P'thinaikos,9384,3,1,2,3,5,10,-5,5
Panionios,9384,4,1,1,4,4,10,-6,4
AEK Athens,9385,1,4,2,0,7,1,6,14
PAOK Salonik,9385,2,2,3,1,9,4,5,9
P'thinaikos,9385,3,1,2,3,4,9,-5,5
Panionios,9385,4,1,1,4,4,10,-6,4
AEK Athens,9386,1,4,2,0,7,1,6,14
PAOK Salonik,9386,2,2,3,1,10,5,5,9
P'thinaikos,9386,3,1,2,3,5,10,-5,5
Panionios,9386,4,1,1,4,4,10,-6,4
AEK Athens,9387,1,4,2,0,7,1,6,14
PAOK Salonik,9387,2,3,2,1,12,4,8,11
Panionios,9387,3,1,1,4,4,10,-6,4
P'thinaikos,9387,4,1,1,4,4,12,-8,4
AEK Athens,9388,1,4,2,0,7,1,6,14
PAOK Salonik,9388,2,2,2,2,11,8,3,8
P'thinaikos,9388,3,2,1,3,8,11,-3,7
Panionios,9388,4,1,1,4,4,10,-6,4
AEK Athens,9389,1,4,2,0,7,1,6,14
PAOK Salonik,9389,2,2,3,1,10,5,5,9
P'thinaikos,9389,3,1,2,3,5,10,-5,5
Panionios,9389,4,1,1,4,4,10,-6,4
AEK Athens,9390,1,4,2,0,7,1,6,14
PAOK Salonik,9390,2,3,2,1,11,5,6,11
P'thinaikos,9390,3,1,1,4,5,11,-6,4
Panionios,9390,4,1,1,4,4,10,-6,4
AEK Athens,9391,1,4,2,0,7,1,6,14
PAOK Salonik,9391,2,2,2,2,9,6,3,8
P'thinaikos,9391,3,2,1,3,6,9,-3,7
Panionios,9391,4,1,1,4,4,10,-6,4
AEK Athens,9392,1,4,2,0,7,1,6,14
PAOK Salonik,9392,2,3,2,1,11,5,6,11
P'thinaikos,9392,3,1,1,4,5,11,-6,4
Panionios,9392,4,1,1,4,4,10,-6,4
AEK Athens,9393,1,4,2,0,7,1,6,14
PAOK Salonik,9393,2,3,2,1,13,5,8,11
Panionios,9393,3,1,1,4,4,10,-6,4
P'thinaikos,9393,4,1,1,4,5,13,-8,4
AEK Athens,9394,1,4,2,0,7,1,6,14
PAOK Salonik,9394,2,3,2,1,13,5,8,11
Panionios,9394,3,1,1,4,4,10,-6,4
P'thinaikos,9394,4,1,1,4,5,13,-8,4
AEK Athens,9395,1,4,2,0,7,1,6,14
PAOK Salonik,9395,2,3,2,1,10,4,6,11
P'thinaikos,9395,3,1,1,4,4,10,-6,4
Panionios,9395,3,1,1,4,4,10,-6,4
AEK Athens,9396,1,4,2,0,7,1,6,14
PAOK Salonik,9396,2,2,3,1,11,6,5,9
P'thinaikos,9396,3,1,2,3,6,11,-5,5
Panionios,9396,4,1,1,4,4,10,-6,4
AEK Athens,9397,1,4,2,0,7,1,6,14
PAOK Salonik,9397,2,2,3,1,10,5,5,9
P'thinaikos,9397,3,1,2,3,5,10,-5,5
Panionios,9397,4,1,1,4,4,10,-6,4
AEK Athens,9398,1,4,2,0,7,1,6,14
PAOK Salonik,9398,2,3,2,1,11,5,6,11
P'thinaikos,9398,3,1,1,4,5,11,-6,4
Panionios,9398,4,1,1,4,4,10,-6,4
AEK Athens,9399,1,4,2,0,7,1,6,14
PAOK Salonik,9399,2,2,2,2,10,6,4,8
P'thinaikos,9399,3,2,1,3,6,10,-4,7
Panionios,9399,4,1,1,4,4,10,-6,4
AEK Athens,9400,1,4,2,0,7,1,6,14
PAOK Salonik,9400,2,2,2,2,10,7,3,8
P'thinaikos,9400,3,2,1,3,7,10,-3,7
Panionios,9400,4,1,1,4,4,10,-6,4
AEK Athens,9401,1,4,2,0,7,1,6,14
PAOK Salonik,9401,2,3,2,1,12,4,8,11
Panionios,9401,3,1,1,4,4,10,-6,4
P'thinaikos,9401,4,1,1,4,4,12,-8,4
AEK Athens,9402,1,4,2,0,7,1,6,14
PAOK Salonik,9402,2,2,2,2,10,7,3,8
P'thinaikos,9402,3,2,1,3,7,10,-3,7
Panionios,9402,4,1,1,4,4,10,-6,4
AEK Athens,9403,1,4,2,0,7,1,6,14
PAOK Salonik,9403,2,3,2,1,11,4,7,11
Panionios,9403,3,1,1,4,4,10,-6,4
P'thinaikos,9403,4,1,1,4,4,11,-7,4
AEK Athens,9404,1,4,2,0,7,1,6,14
PAOK Salonik,9404,2,2,3,1,12,7,5,9
P'thinaikos,9404,3,1,2,3,7,12,-5,5
Panionios,9404,4,1,1,4,4,10,-6,4
AEK Athens,9405,1,4,2,0,7,1,6,14
PAOK Salonik,9405,2,3,2,1,13,7,6,11
P'thinaikos,9405,3,1,1,4,7,13,-6,4
Panionios,9405,4,1,1,4,4,10,-6,4
AEK Athens,9406,1,4,2,0,7,1,6,14
PAOK Salonik,9406,2,2,2,2,9,5,4,8
P'thinaikos,9406,3,2,1,3,5,9,-4,7
Panionios,9406,4,1,1,4,4,10,-6,4
AEK Athens,9407,1,4,2,0,7,1,6,14
PAOK Salonik,9407,2,2,2,2,9,6,3,8
P'thinaikos,9407,3,2,1,3,6,9,-3,7
Panionios,9407,4,1,1,4,4,10,-6,4
AEK Athens,9408,1,4,2,0,7,1,6,14
PAOK Salonik,9408,2,2,2,2,10,6,4,8
P'thinaikos,9408,3,2,1,3,6,10,-4,7
Panionios,9408,4,1,1,4,4,10,-6,4
AEK Athens,9409,1,4,2,0,7,1,6,14
PAOK Salonik,9409,2,2,3,1,10,5,5,9
P'thinaikos,9409,3,1,2,3,5,10,-5,5
Panionios,9409,4,1,1,4,4,10,-6,4
AEK Athens,9410,1,4,2,0,7,1,6,14
PAOK Salonik,9410,2,3,2,1,11,4,7,11
Panionios,9410,3,1,1,4,4,10,-6,4
P'thinaikos,9410,4,1,1,4,4,11,-7,4
AEK Athens,9411,1,4,2,0,7,1,6,14
PAOK Salonik,9411,2,3,2,1,12,5,7,11
Panionios,9411,3,1,1,4,4,10,-6,4
P'thinaikos,9411,4,1,1,4,5,12,-7,4
AEK Athens,9412,1,4,2,0,7,1,6,14
PAOK Salonik,9412,2,3,2,1,12,5,7,11
Panionios,9412,3,1,1,4,4,10,-6,4
P'thinaikos,9412,4,1,1,4,5,12,-7,4
AEK Athens,9413,1,4,2,0,7,1,6,14
PAOK Salonik,9413,2,2,3,1,9,4,5,9
P'thinaikos,9413,3,1,2,3,4,9,-5,5
Panionios,9413,4,1,1,4,4,10,-6,4
AEK Athens,9414,1,4,2,0,7,1,6,14
PAOK Salonik,9414,2,3,2,1,10,4,6,11
P'thinaikos,9414,3,1,1,4,4,10,-6,4
Panionios,9414,3,1,1,4,4,10,-6,4
AEK Athens,9415,1,4,2,0,7,1,6,14
PAOK Salonik,9415,2,3,2,1,14,7,7,11
Panionios,9415,3,1,1,4,4,10,-6,4
P'thinaikos,9415,4,1,1,4,7,14,-7,4
AEK Athens,9416,1,4,2,0,7,1,6,14
PAOK Salonik,9416,2,2,2,2,9,5,4,8
P'thinaikos,9416,3,2,1,3,5,9,-4,7
Panionios,9416,4,1,1,4,4,10,-6,4
AEK Athens,9417,1,4,2,0,7,1,6,14
PAOK Salonik,9417,2,2,3,1,10,5,5,9
P'thinaikos,9417,3,1,2,3,5,10,-5,5
Panionios,9417,4,1,1,4,4,10,-6,4
AEK Athens,9418,1,4,2,0,7,1,6,14
PAOK Salonik,9418,2,3,2,1,10,4,6,11
P'thinaikos,9418,3,1,1,4,4,10,-6,4
Panionios,9418,3,1,1,4,4,10,-6,4
AEK Athens,9419,1,4,2,0,7,1,6,14
PAOK Salonik,9419,2,2,2,2,9,7,2,8
P'thinaikos,9419,3,2,1,3,7,9,-2,7
Panionios,9419,4,1,1,4,4,10,-6,4
AEK Athens,9420,1,4,2,0,7,1,6,14
PAOK Salonik,9420,2,2,3,1,10,5,5,9
P'thinaikos,9420,3,1,2,3,5,10,-5,5
Panionios,9420,4,1,1,4,4,10,-6,4
AEK Athens,9421,1,4,2,0,7,1,6,14
PAOK Salonik,9421,2,2,2,2,9,6,3,8
P'thinaikos,9421,3,2,1,3,6,9,-3,7
Panionios,9421,4,1,1,4,4,10,-6,4
AEK Athens,9422,1,4,2,0,7,1,6,14
PAOK Salonik,9422,2,2,3,1,9,4,5,9
P'thinaikos,9422,3,1,2,3,4,9,-5,5
Panionios,9422,4,1,1,4,4,10,-6,4
AEK Athens,9423,1,4,2,0,7,1,6,14
PAOK Salonik,9423,2,2,3,1,9,4,5,9
P'thinaikos,9423,3,1,2,3,4,9,-5,5
Panionios,9423,4,1,1,4,4,10,-6,4
AEK Athens,9424,1,4,2,0,7,1,6,14
PAOK Salonik,9424,2,2,2,2,9,5,4,8
P'thinaikos,9424,3,2,1,3,5,9,-4,7
Panionios,9424,4,1,1,4,4,10,-6,4
AEK Athens,9425,1,4,2,0,7,1,6,14
PAOK Salonik,9425,2,2,2,2,9,5,4,8
P'thinaikos,9425,3,2,1,3,5,9,-4,7
Panionios,9425,4,1,1,4,4,10,-6,4
AEK Athens,9426,1,4,2,0,7,1,6,14
PAOK Salonik,9426,2,2,2,2,9,5,4,8
P'thinaikos,9426,3,2,1,3,5,9,-4,7
Panionios,9426,4,1,1,4,4,10,-6,4
AEK Athens,9427,1,4,2,0,7,1,6,14
PAOK Salonik,9427,2,2,2,2,11,7,4,8
P'thinaikos,9427,3,2,1,3,7,11,-4,7
Panionios,9427,4,1,1,4,4,10,-6,4
AEK Athens,9428,1,4,2,0,7,1,6,14
PAOK Salonik,9428,2,3,2,1,12,6,6,11
P'thinaikos,9428,3,1,1,4,6,12,-6,4
Panionios,9428,4,1,1,4,4,10,-6,4
AEK Athens,9429,1,4,2,0,7,1,6,14
PAOK Salonik,9429,2,2,2,2,10,6,4,8
P'thinaikos,9429,3,2,1,3,6,10,-4,7
Panionios,9429,4,1,1,4,4,10,-6,4
AEK Athens,9430,1,4,2,0,7,1,6,14
PAOK Salonik,9430,2,2,3,1,10,5,5,9
P'thinaikos,9430,3,1,2,3,5,10,-5,5
Panionios,9430,4,1,1,4,4,10,-6,4
AEK Athens,9431,1,4,2,0,7,1,6,14
PAOK Salonik,9431,2,3,2,1,11,4,7,11
Panionios,9431,3,1,1,4,4,10,-6,4
P'thinaikos,9431,4,1,1,4,4,11,-7,4
AEK Athens,9432,1,4,2,0,7,1,6,14
PAOK Salonik,9432,2,2,2,2,9,6,3,8
P'thinaikos,9432,3,2,1,3,6,9,-3,7
Panionios,9432,4,1,1,4,4,10,-6,4
AEK Athens,9433,1,4,2,0,7,1,6,14
PAOK Salonik,9433,2,2,3,1,10,5,5,9
P'thinaikos,9433,3,1,2,3,5,10,-5,5
Panionios,9433,4,1,1,4,4,10,-6,4
AEK Athens,9434,1,4,2,0,7,1,6,14
PAOK Salonik,9434,2,2,2,2,10,7,3,8
P'thinaikos,9434,3,2,1,3,7,10,-3,7
Panionios,9434,4,1,1,4,4,10,-6,4
AEK Athens,9435,1,4,2,0,7,1,6,14
PAOK Salonik,9435,2,2,3,1,9,4,5,9
P'thinaikos,9435,3,1,2,3,4,9,-5,5
Panionios,9435,4,1,1,4,4,10,-6,4
AEK Athens,9436,1,4,2,0,7,1,6,14
PAOK Salonik,9436,2,2,3,1,9,4,5,9
P'thinaikos,9436,3,1,2,3,4,9,-5,5
Panionios,9436,4,1,1,4,4,10,-6,4
AEK Athens,9437,1,4,2,0,7,1,6,14
PAOK Salonik,9437,2,3,2,1,10,4,6,11
P'thinaikos,9437,3,1,1,4,4,10,-6,4
Panionios,9437,3,1,1,4,4,10,-6,4
AEK Athens,9438,1,4,2,0,7,1,6,14
PAOK Salonik,9438,2,2,2,2,11,7,4,8
P'thinaikos,9438,3,2,1,3,7,11,-4,7
Panionios,9438,4,1,1,4,4,10,-6,4
AEK Athens,9439,1,4,2,0,7,1,6,14
PAOK Salonik,9439,2,3,2,1,11,4,7,11
Panionios,9439,3,1,1,4,4,10,-6,4
P'thinaikos,9439,4,1,1,4,4,11,-7,4
AEK Athens,9440,1,4,2,0,7,1,6,14
PAOK Salonik,9440,2,2,3,1,10,5,5,9
P'thinaikos,9440,3,1,2,3,5,10,-5,5
Panionios,9440,4,1,1,4,4,10,-6,4
AEK Athens,9441,1,4,2,0,7,1,6,14
PAOK Salonik,9441,2,2,2,2,9,5,4,8
P'thinaikos,9441,3,2,1,3,5,9,-4,7
Panionios,9441,4,1,1,4,4,10,-6,4
AEK Athens,9442,1,4,2,0,7,1,6,14
PAOK Salonik,9442,2,3,2,1,12,6,6,11
P'thinaikos,9442,3,1,1,4,6,12,-6,4
Panionios,9442,4,1,1,4,4,10,-6,4
AEK Athens,9443,1,4,2,0,7,1,6,14
PAOK Salonik,9443,2,2,2,2,9,5,4,8
P'thinaikos,9443,3,2,1,3,5,9,-4,7
Panionios,9443,4,1,1,4,4,10,-6,4
AEK Athens,9444,1,4,2,0,7,1,6,14
PAOK Salonik,9444,2,2,3,1,10,5,5,9
P'thinaikos,9444,3,1,2,3,5,10,-5,5
Panionios,9444,4,1,1,4,4,10,-6,4
AEK Athens,9445,1,4,2,0,7,1,6,14
PAOK Salonik,9445,2,3,2,1,10,4,6,11
P'thinaikos,9445,3,1,1,4,4,10,-6,4
Panionios,9445,3,1,1,4,4,10,-6,4
AEK Athens,9446,1,4,2,0,7,1,6,14
PAOK Salonik,9446,2,2,2,2,9,5,4,8
P'thinaikos,9446,3,2,1,3,5,9,-4,7
Panionios,9446,4,1,1,4,4,10,-6,4
AEK Athens,9447,1,4,2,0,7,1,6,14
PAOK Salonik,9447,2,2,3,1,9,4,5,9
P'thinaikos,9447,3,1,2,3,4,9,-5,5
Panionios,9447,4,1,1,4,4,10,-6,4
AEK Athens,9448,1,4,2,0,7,1,6,14
PAOK Salonik,9448,2,2,2,2,10,6,4,8
P'thinaikos,9448,3,2,1,3,6,10,-4,7
Panionios,9448,4,1,1,4,4,10,-6,4
AEK Athens,9449,1,4,2,0,7,1,6,14
PAOK Salonik,9449,2,2,2,2,10,6,4,8
P'thinaikos,9449,3,2,1,3,6,10,-4,7
Panionios,9449,4,1,1,4,4,10,-6,4
AEK Athens,9450,1,4,2,0,7,1,6,14
PAOK Salonik,9450,2,2,3,1,9,4,5,9
P'thinaikos,9450,3,1,2,3,4,9,-5,5
Panionios,9450,4,1,1,4,4,10,-6,4
AEK Athens,9451,1,4,2,0,7,1,6,14
PAOK Salonik,9451,2,3,2,1,13,4,9,11
Panionios,9451,3,1,1,4,4,10,-6,4
P'thinaikos,9451,4,1,1,4,4,13,-9,4
AEK Athens,9452,1,4,2,0,7,1,6,14
PAOK Salonik,9452,2,2,2,2,10,6,4,8
P'thinaikos,9452,3,2,1,3,6,10,-4,7
Panionios,9452,4,1,1,4,4,10,-6,4
AEK Athens,9453,1,4,2,0,7,1,6,14
PAOK Salonik,9453,2,3,2,1,10,4,6,11
P'thinaikos,9453,3,1,1,4,4,10,-6,4
Panionios,9453,3,1,1,4,4,10,-6,4
AEK Athens,9454,1,4,2,0,7,1,6,14
PAOK Salonik,9454,2,2,2,2,11,7,4,8
P'thinaikos,9454,3,2,1,3,7,11,-4,7
Panionios,9454,4,1,1,4,4,10,-6,4
AEK Athens,9455,1,4,2,0,7,1,6,14
PAOK Salonik,9455,2,2,3,1,9,4,5,9
P'thinaikos,9455,3,1,2,3,4,9,-5,5
Panionios,9455,4,1,1,4,4,10,-6,4
AEK Athens,9456,1,4,2,0,7,1,6,14
PAOK Salonik,9456,2,2,3,1,9,4,5,9
P'thinaikos,9456,3,1,2,3,4,9,-5,5
Panionios,9456,4,1,1,4,4,10,-6,4
AEK Athens,9457,1,4,2,0,7,1,6,14
PAOK Salonik,9457,2,2,2,2,9,8,1,8
P'thinaikos,9457,3,2,1,3,8,9,-1,7
Panionios,9457,4,1,1,4,4,10,-6,4
AEK Athens,9458,1,4,2,0,7,1,6,14
PAOK Salonik,9458,2,2,3,1,10,5,5,9
P'thinaikos,9458,3,1,2,3,5,10,-5,5
Panionios,9458,4,1,1,4,4,10,-6,4
AEK Athens,9459,1,4,2,0,7,1,6,14
PAOK Salonik,9459,2,3,2,1,11,4,7,11
Panionios,9459,3,1,1,4,4,10,-6,4
P'thinaikos,9459,4,1,1,4,4,11,-7,4
AEK Athens,9460,1,4,2,0,7,1,6,14
PAOK Salonik,9460,2,2,2,2,9,6,3,8
P'thinaikos,9460,3,2,1,3,6,9,-3,7
Panionios,9460,4,1,1,4,4,10,-6,4
AEK Athens,9461,1,4,2,0,7,1,6,14
PAOK Salonik,9461,2,2,2,2,9,7,2,8
P'thinaikos,9461,3,2,1,3,7,9,-2,7
Panionios,9461,4,1,1,4,4,10,-6,4
AEK Athens,9462,1,4,2,0,7,1,6,14
PAOK Salonik,9462,2,3,2,1,11,5,6,11
P'thinaikos,9462,3,1,1,4,5,11,-6,4
Panionios,9462,4,1,1,4,4,10,-6,4
AEK Athens,9463,1,4,2,0,7,1,6,14
PAOK Salonik,9463,2,2,2,2,9,8,1,8
P'thinaikos,9463,3,2,1,3,8,9,-1,7
Panionios,9463,4,1,1,4,4,10,-6,4
AEK Athens,9464,1,4,2,0,7,1,6,14
PAOK Salonik,9464,2,2,3,1,11,6,5,9
P'thinaikos,9464,3,1,2,3,6,11,-5,5
Panionios,9464,4,1,1,4,4,10,-6,4
AEK Athens,9465,1,4,2,0,7,1,6,14
PAOK Salonik,9465,2,3,2,1,11,5,6,11
P'thinaikos,9465,3,1,1,4,5,11,-6,4
Panionios,9465,4,1,1,4,4,10,-6,4
AEK Athens,9466,1,4,2,0,7,1,6,14
PAOK Salonik,9466,2,2,2,2,9,8,1,8
P'thinaikos,9466,3,2,1,3,8,9,-1,7
Panionios,9466,4,1,1,4,4,10,-6,4
AEK Athens,9467,1,4,2,0,7,1,6,14
PAOK Salonik,9467,2,2,2,2,10,6,4,8
P'thinaikos,9467,3,2,1,3,6,10,-4,7
Panionios,9467,4,1,1,4,4,10,-6,4
AEK Athens,9468,1,4,2,0,7,1,6,14
PAOK Salonik,9468,2,2,3,1,10,5,5,9
P'thinaikos,9468,3,1,2,3,5,10,-5,5
Panionios,9468,4,1,1,4,4,10,-6,4
AEK Athens,9469,1,4,2,0,7,1,6,14
PAOK Salonik,9469,2,3,2,1,12,5,7,11
Panionios,9469,3,1,1,4,4,10,-6,4
P'thinaikos,9469,4,1,1,4,5,12,-7,4
AEK Athens,9470,1,4,2,0,7,1,6,14
PAOK Salonik,9470,2,2,3,1,10,5,5,9
P'thinaikos,9470,3,1,2,3,5,10,-5,5
Panionios,9470,4,1,1,4,4,10,-6,4
AEK Athens,9471,1,4,2,0,7,1,6,14
PAOK Salonik,9471,2,3,2,1,10,4,6,11
P'thinaikos,9471,3,1,1,4,4,10,-6,4
Panionios,9471,3,1,1,4,4,10,-6,4
AEK Athens,9472,1,4,2,0,7,1,6,14
PAOK Salonik,9472,2,2,2,2,9,5,4,8
P'thinaikos,9472,3,2,1,3,5,9,-4,7
Panionios,9472,4,1,1,4,4,10,-6,4
AEK Athens,9473,1,4,2,0,7,1,6,14
PAOK Salonik,9473,2,2,3,1,9,4,5,9
P'thinaikos,9473,3,1,2,3,4,9,-5,5
Panionios,9473,4,1,1,4,4,10,-6,4
AEK Athens,9474,1,4,2,0,7,1,6,14
PAOK Salonik,9474,2,3,2,1,11,4,7,11
Panionios,9474,3,1,1,4,4,10,-6,4
P'thinaikos,9474,4,1,1,4,4,11,-7,4
AEK Athens,9475,1,4,2,0,7,1,6,14
PAOK Salonik,9475,2,2,3,1,10,5,5,9
P'thinaikos,9475,3,1,2,3,5,10,-5,5
Panionios,9475,4,1,1,4,4,10,-6,4
AEK Athens,9476,1,4,2,0,7,1,6,14
PAOK Salonik,9476,2,3,2,1,13,5,8,11
Panionios,9476,3,1,1,4,4,10,-6,4
P'thinaikos,9476,4,1,1,4,5,13,-8,4
AEK Athens,9477,1,4,2,0,7,1,6,14
PAOK Salonik,9477,2,2,2,2,9,6,3,8
P'thinaikos,9477,3,2,1,3,6,9,-3,7
Panionios,9477,4,1,1,4,4,10,-6,4
AEK Athens,9478,1,4,2,0,7,1,6,14
PAOK Salonik,9478,2,2,2,2,10,7,3,8
P'thinaikos,9478,3,2,1,3,7,10,-3,7
Panionios,9478,4,1,1,4,4,10,-6,4
AEK Athens,9479,1,4,2,0,7,1,6,14
PAOK Salonik,9479,2,3,2,1,11,5,6,11
P'thinaikos,9479,3,1,1,4,5,11,-6,4
Panionios,9479,4,1,1,4,4,10,-6,4
AEK Athens,9480,1,4,2,0,7,1,6,14
PAOK Salonik,9480,2,2,2,2,9,5,4,8
P'thinaikos,9480,3,2,1,3,5,9,-4,7
Panionios,9480,4,1,1,4,4,10,-6,4
AEK Athens,9481,1,4,2,0,7,1,6,14
PAOK Salonik,9481,2,2,3,1,9,4,5,9
P'thinaikos,9481,3,1,2,3,4,9,-5,5
Panionios,9481,4,1,1,4,4,10,-6,4
AEK Athens,9482,1,4,2,0,7,1,6,14
PAOK Salonik,9482,2,2,3,1,11,6,5,9
P'thinaikos,9482,3,1,2,3,6,11,-5,5
Panionios,9482,4,1,1,4,4,10,-6,4
AEK Athens,9483,1,4,2,0,7,1,6,14
PAOK Salonik,9483,2,2,3,1,10,5,5,9
P'thinaikos,9483,3,1,2,3,5,10,-5,5
Panionios,9483,4,1,1,4,4,10,-6,4
AEK Athens,9484,1,4,2,0,7,1,6,14
PAOK Salonik,9484,2,2,2,2,9,6,3,8
P'thinaikos,9484,3,2,1,3,6,9,-3,7
Panionios,9484,4,1,1,4,4,10,-6,4
AEK Athens,9485,1,4,2,0,7,1,6,14
PAOK Salonik,9485,2,2,3,1,9,4,5,9
P'thinaikos,9485,3,1,2,3,4,9,-5,5
Panionios,9485,4,1,1,4,4,10,-6,4
AEK Athens,9486,1,4,2,0,7,1,6,14
PAOK Salonik,9486,2,3,2,1,11,4,7,11
Panionios,9486,3,1,1,4,4,10,-6,4
P'thinaikos,9486,4,1,1,4,4,11,-7,4
AEK Athens,9487,1,4,2,0,7,1,6,14
PAOK Salonik,9487,2,2,3,1,11,6,5,9
P'thinaikos,9487,3,1,2,3,6,11,-5,5
Panionios,9487,4,1,1,4,4,10,-6,4
AEK Athens,9488,1,4,2,0,7,1,6,14
PAOK Salonik,9488,2,3,2,1,10,4,6,11
P'thinaikos,9488,3,1,1,4,4,10,-6,4
Panionios,9488,3,1,1,4,4,10,-6,4
AEK Athens,9489,1,4,2,0,7,1,6,14
PAOK Salonik,9489,2,3,2,1,11,5,6,11
P'thinaikos,9489,3,1,1,4,5,11,-6,4
Panionios,9489,4,1,1,4,4,10,-6,4
AEK Athens,9490,1,4,2,0,7,1,6,14
PAOK Salonik,9490,2,2,3,1,10,5,5,9
P'thinaikos,9490,3,1,2,3,5,10,-5,5
Panionios,9490,4,1,1,4,4,10,-6,4
AEK Athens,9491,1,4,2,0,7,1,6,14
PAOK Salonik,9491,2,2,3,1,9,4,5,9
P'thinaikos,9491,3,1,2,3,4,9,-5,5
Panionios,9491,4,1,1,4,4,10,-6,4
AEK Athens,9492,1,4,2,0,7,1,6,14
PAOK Salonik,9492,2,2,3,1,10,5,5,9
P'thinaikos,9492,3,1,2,3,5,10,-5,5
Panionios,9492,4,1,1,4,4,10,-6,4
AEK Athens,9493,1,4,2,0,7,1,6,14
PAOK Salonik,9493,2,2,2,2,10,6,4,8
P'thinaikos,9493,3,2,1,3,6,10,-4,7
Panionios,9493,4,1,1,4,4,10,-6,4
AEK Athens,9494,1,4,2,0,7,1,6,14
PAOK Salonik,9494,2,3,2,1,13,6,7,11
Panionios,9494,3,1,1,4,4,10,-6,4
P'thinaikos,9494,4,1,1,4,6,13,-7,4
AEK Athens,9495,1,4,2,0,7,1,6,14
PAOK Salonik,9495,2,2,3,1,10,5,5,9
P'thinaikos,9495,3,1,2,3,5,10,-5,5
Panionios,9495,4,1,1,4,4,10,-6,4
AEK Athens,9496,1,4,2,0,7,1,6,14
PAOK Salonik,9496,2,2,2,2,9,6,3,8
P'thinaikos,9496,3,2,1,3,6,9,-3,7
Panionios,9496,4,1,1,4,4,10,-6,4
AEK Athens,9497,1,4,2,0,7,1,6,14
PAOK Salonik,9497,2,2,2,2,9,5,4,8
P'thinaikos,9497,3,2,1,3,5,9,-4,7
Panionios,9497,4,1,1,4,4,10,-6,4
AEK Athens,9498,1,4,2,0,7,1,6,14
PAOK Salonik,9498,2,2,2,2,9,5,4,8
P'thinaikos,9498,3,2,1,3,5,9,-4,7
Panionios,9498,4,1,1,4,4,10,-6,4
AEK Athens,9499,1,4,2,0,7,1,6,14
PAOK Salonik,9499,2,3,2,1,10,4,6,11
P'thinaikos,9499,3,1,1,4,4,10,-6,4
Panionios,9499,3,1,1,4,4,10,-6,4
AEK Athens,9500,1,4,2,0,7,1,6,14
PAOK Salonik,9500,2,3,2,1,11,5,6,11
P'thinaikos,9500,3,1,1,4,5,11,-6,4
Panionios,9500,4,1,1,4,4,10,-6,4
AEK Athens,9501,1,4,2,0,7,1,6,14
PAOK Salonik,9501,2,3,2,1,12,5,7,11
Panionios,9501,3,1,1,4,4,10,-6,4
P'thinaikos,9501,4,1,1,4,5,12,-7,4
AEK Athens,9502,1,4,2,0,7,1,6,14
PAOK Salonik,9502,2,2,2,2,10,9,1,8
P'thinaikos,9502,3,2,1,3,9,10,-1,7
Panionios,9502,4,1,1,4,4,10,-6,4
AEK Athens,9503,1,4,2,0,7,1,6,14
PAOK Salonik,9503,2,2,3,1,9,4,5,9
P'thinaikos,9503,3,1,2,3,4,9,-5,5
Panionios,9503,4,1,1,4,4,10,-6,4
AEK Athens,9504,1,4,2,0,7,1,6,14
PAOK Salonik,9504,2,3,2,1,10,4,6,11
P'thinaikos,9504,3,1,1,4,4,10,-6,4
Panionios,9504,3,1,1,4,4,10,-6,4
AEK Athens,9505,1,4,2,0,7,1,6,14
PAOK Salonik,9505,2,3,2,1,11,4,7,11
Panionios,9505,3,1,1,4,4,10,-6,4
P'thinaikos,9505,4,1,1,4,4,11,-7,4
AEK Athens,9506,1,4,2,0,7,1,6,14
PAOK Salonik,9506,2,3,2,1,11,4,7,11
Panionios,9506,3,1,1,4,4,10,-6,4
P'thinaikos,9506,4,1,1,4,4,11,-7,4
AEK Athens,9507,1,4,2,0,7,1,6,14
PAOK Salonik,9507,2,3,2,1,11,5,6,11
P'thinaikos,9507,3,1,1,4,5,11,-6,4
Panionios,9507,4,1,1,4,4,10,-6,4
AEK Athens,9508,1,4,2,0,7,1,6,14
PAOK Salonik,9508,2,3,2,1,12,4,8,11
Panionios,9508,3,1,1,4,4,10,-6,4
P'thinaikos,9508,4,1,1,4,4,12,-8,4
AEK Athens,9509,1,4,2,0,7,1,6,14
PAOK Salonik,9509,2,3,2,1,10,4,6,11
P'thinaikos,9509,3,1,1,4,4,10,-6,4
Panionios,9509,3,1,1,4,4,10,-6,4
AEK Athens,9510,1,4,2,0,7,1,6,14
PAOK Salonik,9510,2,2,3,1,10,5,5,9
P'thinaikos,9510,3,1,2,3,5,10,-5,5
Panionios,9510,4,1,1,4,4,10,-6,4
AEK Athens,9511,1,4,2,0,7,1,6,14
PAOK Salonik,9511,2,3,2,1,10,4,6,11
P'thinaikos,9511,3,1,1,4,4,10,-6,4
Panionios,9511,3,1,1,4,4,10,-6,4
AEK Athens,9512,1,4,2,0,7,1,6,14
PAOK Salonik,9512,2,3,2,1,10,4,6,11
P'thinaikos,9512,3,1,1,4,4,10,-6,4
Panionios,9512,3,1,1,4,4,10,-6,4
AEK Athens,9513,1,4,2,0,7,1,6,14
PAOK Salonik,9513,2,3,2,1,11,5,6,11
P'thinaikos,9513,3,1,1,4,5,11,-6,4
Panionios,9513,4,1,1,4,4,10,-6,4
AEK Athens,9514,1,4,2,0,7,1,6,14
PAOK Salonik,9514,2,3,2,1,11,5,6,11
P'thinaikos,9514,3,1,1,4,5,11,-6,4
Panionios,9514,4,1,1,4,4,10,-6,4
AEK Athens,9515,1,4,2,0,7,1,6,14
PAOK Salonik,9515,2,2,2,2,10,6,4,8
P'thinaikos,9515,3,2,1,3,6,10,-4,7
Panionios,9515,4,1,1,4,4,10,-6,4
AEK Athens,9516,1,4,2,0,7,1,6,14
PAOK Salonik,9516,2,3,2,1,13,5,8,11
Panionios,9516,3,1,1,4,4,10,-6,4
P'thinaikos,9516,4,1,1,4,5,13,-8,4
AEK Athens,9517,1,4,2,0,7,1,6,14
PAOK Salonik,9517,2,2,3,1,10,5,5,9
P'thinaikos,9517,3,1,2,3,5,10,-5,5
Panionios,9517,4,1,1,4,4,10,-6,4
AEK Athens,9518,1,4,2,0,7,1,6,14
PAOK Salonik,9518,2,2,3,1,10,5,5,9
P'thinaikos,9518,3,1,2,3,5,10,-5,5
Panionios,9518,4,1,1,4,4,10,-6,4
AEK Athens,9519,1,4,2,0,7,1,6,14
PAOK Salonik,9519,2,2,2,2,10,6,4,8
P'thinaikos,9519,3,2,1,3,6,10,-4,7
Panionios,9519,4,1,1,4,4,10,-6,4
AEK Athens,9520,1,4,2,0,7,1,6,14
PAOK Salonik,9520,2,3,2,1,11,4,7,11
Panionios,9520,3,1,1,4,4,10,-6,4
P'thinaikos,9520,4,1,1,4,4,11,-7,4
AEK Athens,9521,1,4,2,0,7,1,6,14
PAOK Salonik,9521,2,2,3,1,9,4,5,9
P'thinaikos,9521,3,1,2,3,4,9,-5,5
Panionios,9521,4,1,1,4,4,10,-6,4
AEK Athens,9522,1,4,2,0,7,1,6,14
PAOK Salonik,9522,2,2,2,2,10,6,4,8
P'thinaikos,9522,3,2,1,3,6,10,-4,7
Panionios,9522,4,1,1,4,4,10,-6,4
AEK Athens,9523,1,4,2,0,7,1,6,14
PAOK Salonik,9523,2,2,3,1,10,5,5,9
P'thinaikos,9523,3,1,2,3,5,10,-5,5
Panionios,9523,4,1,1,4,4,10,-6,4
AEK Athens,9524,1,4,2,0,7,1,6,14
PAOK Salonik,9524,2,2,3,1,10,5,5,9
P'thinaikos,9524,3,1,2,3,5,10,-5,5
Panionios,9524,4,1,1,4,4,10,-6,4
AEK Athens,9525,1,4,2,0,7,1,6,14
PAOK Salonik,9525,2,2,3,1,10,5,5,9
P'thinaikos,9525,3,1,2,3,5,10,-5,5
Panionios,9525,4,1,1,4,4,10,-6,4
AEK Athens,9526,1,4,2,0,7,1,6,14
PAOK Salonik,9526,2,2,3,1,9,4,5,9
P'thinaikos,9526,3,1,2,3,4,9,-5,5
Panionios,9526,4,1,1,4,4,10,-6,4
AEK Athens,9527,1,4,2,0,7,1,6,14
PAOK Salonik,9527,2,2,3,1,11,6,5,9
P'thinaikos,9527,3,1,2,3,6,11,-5,5
Panionios,9527,4,1,1,4,4,10,-6,4
AEK Athens,9528,1,4,2,0,7,1,6,14
PAOK Salonik,9528,2,3,2,1,10,4,6,11
P'thinaikos,9528,3,1,1,4,4,10,-6,4
Panionios,9528,3,1,1,4,4,10,-6,4
AEK Athens,9529,1,4,2,0,7,1,6,14
PAOK Salonik,9529,2,2,2,2,10,7,3,8
P'thinaikos,9529,3,2,1,3,7,10,-3,7
Panionios,9529,4,1,1,4,4,10,-6,4
AEK Athens,9530,1,4,2,0,7,1,6,14
PAOK Salonik,9530,2,2,3,1,10,5,5,9
P'thinaikos,9530,3,1,2,3,5,10,-5,5
Panionios,9530,4,1,1,4,4,10,-6,4
AEK Athens,9531,1,4,2,0,7,1,6,14
PAOK Salonik,9531,2,2,2,2,9,5,4,8
P'thinaikos,9531,3,2,1,3,5,9,-4,7
Panionios,9531,4,1,1,4,4,10,-6,4
AEK Athens,9532,1,4,2,0,7,1,6,14
PAOK Salonik,9532,2,3,2,1,12,6,6,11
P'thinaikos,9532,3,1,1,4,6,12,-6,4
Panionios,9532,4,1,1,4,4,10,-6,4
AEK Athens,9533,1,4,2,0,7,1,6,14
PAOK Salonik,9533,2,2,2,2,11,8,3,8
P'thinaikos,9533,3,2,1,3,8,11,-3,7
Panionios,9533,4,1,1,4,4,10,-6,4
AEK Athens,9534,1,4,2,0,7,1,6,14
PAOK Salonik,9534,2,2,2,2,9,6,3,8
P'thinaikos,9534,3,2,1,3,6,9,-3,7
Panionios,9534,4,1,1,4,4,10,-6,4
AEK Athens,9535,1,4,2,0,7,1,6,14
PAOK Salonik,9535,2,2,3,1,11,6,5,9
P'thinaikos,9535,3,1,2,3,6,11,-5,5
Panionios,9535,4,1,1,4,4,10,-6,4
AEK Athens,9536,1,4,2,0,7,1,6,14
PAOK Salonik,9536,2,2,3,1,9,4,5,9
P'thinaikos,9536,3,1,2,3,4,9,-5,5
Panionios,9536,4,1,1,4,4,10,-6,4
AEK Athens,9537,1,4,2,0,7,1,6,14
PAOK Salonik,9537,2,2,2,2,10,6,4,8
P'thinaikos,9537,3,2,1,3,6,10,-4,7
Panionios,9537,4,1,1,4,4,10,-6,4
AEK Athens,9538,1,4,2,0,7,1,6,14
PAOK Salonik,9538,2,2,2,2,10,7,3,8
P'thinaikos,9538,3,2,1,3,7,10,-3,7
Panionios,9538,4,1,1,4,4,10,-6,4
AEK Athens,9539,1,4,2,0,7,1,6,14
PAOK Salonik,9539,2,2,2,2,9,5,4,8
P'thinaikos,9539,3,2,1,3,5,9,-4,7
Panionios,9539,4,1,1,4,4,10,-6,4
AEK Athens,9540,1,4,2,0,7,1,6,14
PAOK Salonik,9540,2,2,2,2,10,7,3,8
P'thinaikos,9540,3,2,1,3,7,10,-3,7
Panionios,9540,4,1,1,4,4,10,-6,4
AEK Athens,9541,1,4,2,0,7,1,6,14
PAOK Salonik,9541,2,2,3,1,10,5,5,9
P'thinaikos,9541,3,1,2,3,5,10,-5,5
Panionios,9541,4,1,1,4,4,10,-6,4
AEK Athens,9542,1,4,2,0,7,1,6,14
PAOK Salonik,9542,2,2,2,2,10,6,4,8
P'thinaikos,9542,3,2,1,3,6,10,-4,7
Panionios,9542,4,1,1,4,4,10,-6,4
AEK Athens,9543,1,4,2,0,7,1,6,14
PAOK Salonik,9543,2,2,2,2,9,6,3,8
P'thinaikos,9543,3,2,1,3,6,9,-3,7
Panionios,9543,4,1,1,4,4,10,-6,4
AEK Athens,9544,1,4,2,0,7,1,6,14
PAOK Salonik,9544,2,3,2,1,10,4,6,11
P'thinaikos,9544,3,1,1,4,4,10,-6,4
Panionios,9544,3,1,1,4,4,10,-6,4
AEK Athens,9545,1,4,2,0,7,1,6,14
PAOK Salonik,9545,2,2,3,1,10,5,5,9
P'thinaikos,9545,3,1,2,3,5,10,-5,5
Panionios,9545,4,1,1,4,4,10,-6,4
AEK Athens,9546,1,4,2,0,7,1,6,14
PAOK Salonik,9546,2,2,2,2,9,5,4,8
P'thinaikos,9546,3,2,1,3,5,9,-4,7
Panionios,9546,4,1,1,4,4,10,-6,4
AEK Athens,9547,1,4,2,0,7,1,6,14
PAOK Salonik,9547,2,3,2,1,11,5,6,11
P'thinaikos,9547,3,1,1,4,5,11,-6,4
Panionios,9547,4,1,1,4,4,10,-6,4
AEK Athens,9548,1,4,2,0,7,1,6,14
PAOK Salonik,9548,2,2,2,2,10,6,4,8
P'thinaikos,9548,3,2,1,3,6,10,-4,7
Panionios,9548,4,1,1,4,4,10,-6,4
AEK Athens,9549,1,4,2,0,7,1,6,14
PAOK Salonik,9549,2,3,2,1,10,4,6,11
P'thinaikos,9549,3,1,1,4,4,10,-6,4
Panionios,9549,3,1,1,4,4,10,-6,4
AEK Athens,9550,1,4,2,0,7,1,6,14
PAOK Salonik,9550,2,3,2,1,12,5,7,11
Panionios,9550,3,1,1,4,4,10,-6,4
P'thinaikos,9550,4,1,1,4,5,12,-7,4
AEK Athens,9551,1,4,2,0,7,1,6,14
PAOK Salonik,9551,2,3,2,1,12,4,8,11
Panionios,9551,3,1,1,4,4,10,-6,4
P'thinaikos,9551,4,1,1,4,4,12,-8,4
AEK Athens,9552,1,4,2,0,7,1,6,14
PAOK Salonik,9552,2,3,2,1,11,5,6,11
P'thinaikos,9552,3,1,1,4,5,11,-6,4
Panionios,9552,4,1,1,4,4,10,-6,4
AEK Athens,9553,1,4,2,0,7,1,6,14
PAOK Salonik,9553,2,3,2,1,12,6,6,11
P'thinaikos,9553,3,1,1,4,6,12,-6,4
Panionios,9553,4,1,1,4,4,10,-6,4
AEK Athens,9554,1,4,2,0,7,1,6,14
PAOK Salonik,9554,2,2,2,2,9,5,4,8
P'thinaikos,9554,3,2,1,3,5,9,-4,7
Panionios,9554,4,1,1,4,4,10,-6,4
AEK Athens,9555,1,4,2,0,7,1,6,14
PAOK Salonik,9555,2,2,2,2,9,6,3,8
P'thinaikos,9555,3,2,1,3,6,9,-3,7
Panionios,9555,4,1,1,4,4,10,-6,4
AEK Athens,9556,1,4,2,0,7,1,6,14
PAOK Salonik,9556,2,2,2,2,10,6,4,8
P'thinaikos,9556,3,2,1,3,6,10,-4,7
Panionios,9556,4,1,1,4,4,10,-6,4
AEK Athens,9557,1,4,2,0,7,1,6,14
PAOK Salonik,9557,2,2,3,1,10,5,5,9
P'thinaikos,9557,3,1,2,3,5,10,-5,5
Panionios,9557,4,1,1,4,4,10,-6,4
AEK Athens,9558,1,4,2,0,7,1,6,14
PAOK Salonik,9558,2,3,2,1,11,5,6,11
P'thinaikos,9558,3,1,1,4,5,11,-6,4
Panionios,9558,4,1,1,4,4,10,-6,4
AEK Athens,9559,1,4,2,0,7,1,6,14
PAOK Salonik,9559,2,2,2,2,9,9,0,8
P'thinaikos,9559,3,2,1,3,9,9,0,7
Panionios,9559,4,1,1,4,4,10,-6,4
AEK Athens,9560,1,4,2,0,7,1,6,14
PAOK Salonik,9560,2,2,2,2,9,5,4,8
P'thinaikos,9560,3,2,1,3,5,9,-4,7
Panionios,9560,4,1,1,4,4,10,-6,4
AEK Athens,9561,1,4,2,0,7,1,6,14
PAOK Salonik,9561,2,3,2,1,11,5,6,11
P'thinaikos,9561,3,1,1,4,5,11,-6,4
Panionios,9561,4,1,1,4,4,10,-6,4
AEK Athens,9562,1,4,2,0,7,1,6,14
PAOK Salonik,9562,2,2,3,1,12,7,5,9
P'thinaikos,9562,3,1,2,3,7,12,-5,5
Panionios,9562,4,1,1,4,4,10,-6,4
AEK Athens,9563,1,4,2,0,7,1,6,14
PAOK Salonik,9563,2,2,2,2,9,5,4,8
P'thinaikos,9563,3,2,1,3,5,9,-4,7
Panionios,9563,4,1,1,4,4,10,-6,4
AEK Athens,9564,1,4,2,0,7,1,6,14
PAOK Salonik,9564,2,2,2,2,10,6,4,8
P'thinaikos,9564,3,2,1,3,6,10,-4,7
Panionios,9564,4,1,1,4,4,10,-6,4
AEK Athens,9565,1,4,2,0,7,1,6,14
PAOK Salonik,9565,2,2,3,1,10,5,5,9
P'thinaikos,9565,3,1,2,3,5,10,-5,5
Panionios,9565,4,1,1,4,4,10,-6,4
AEK Athens,9566,1,4,2,0,7,1,6,14
PAOK Salonik,9566,2,2,3,1,11,6,5,9
P'thinaikos,9566,3,1,2,3,6,11,-5,5
Panionios,9566,4,1,1,4,4,10,-6,4
AEK Athens,9567,1,4,2,0,7,1,6,14
PAOK Salonik,9567,2,2,3,1,10,5,5,9
P'thinaikos,9567,3,1,2,3,5,10,-5,5
Panionios,9567,4,1,1,4,4,10,-6,4
AEK Athens,9568,1,4,2,0,7,1,6,14
PAOK Salonik,9568,2,3,2,1,11,4,7,11
Panionios,9568,3,1,1,4,4,10,-6,4
P'thinaikos,9568,4,1,1,4,4,11,-7,4
AEK Athens,9569,1,4,2,0,7,1,6,14
PAOK Salonik,9569,2,2,2,2,9,5,4,8
P'thinaikos,9569,3,2,1,3,5,9,-4,7
Panionios,9569,4,1,1,4,4,10,-6,4
AEK Athens,9570,1,4,2,0,7,1,6,14
PAOK Salonik,9570,2,2,3,1,10,5,5,9
P'thinaikos,9570,3,1,2,3,5,10,-5,5
Panionios,9570,4,1,1,4,4,10,-6,4
AEK Athens,9571,1,4,2,0,7,1,6,14
PAOK Salonik,9571,2,3,2,1,11,5,6,11
P'thinaikos,9571,3,1,1,4,5,11,-6,4
Panionios,9571,4,1,1,4,4,10,-6,4
AEK Athens,9572,1,4,2,0,7,1,6,14
PAOK Salonik,9572,2,2,2,2,9,5,4,8
P'thinaikos,9572,3,2,1,3,5,9,-4,7
Panionios,9572,4,1,1,4,4,10,-6,4
AEK Athens,9573,1,4,2,0,7,1,6,14
PAOK Salonik,9573,2,2,2,2,11,7,4,8
P'thinaikos,9573,3,2,1,3,7,11,-4,7
Panionios,9573,4,1,1,4,4,10,-6,4
AEK Athens,9574,1,4,2,0,7,1,6,14
PAOK Salonik,9574,2,3,2,1,11,5,6,11
P'thinaikos,9574,3,1,1,4,5,11,-6,4
Panionios,9574,4,1,1,4,4,10,-6,4
AEK Athens,9575,1,4,2,0,7,1,6,14
PAOK Salonik,9575,2,2,3,1,10,5,5,9
P'thinaikos,9575,3,1,2,3,5,10,-5,5
Panionios,9575,4,1,1,4,4,10,-6,4
AEK Athens,9576,1,4,2,0,7,1,6,14
PAOK Salonik,9576,2,2,2,2,10,6,4,8
P'thinaikos,9576,3,2,1,3,6,10,-4,7
Panionios,9576,4,1,1,4,4,10,-6,4
AEK Athens,9577,1,4,2,0,7,1,6,14
PAOK Salonik,9577,2,2,2,2,9,6,3,8
P'thinaikos,9577,3,2,1,3,6,9,-3,7
Panionios,9577,4,1,1,4,4,10,-6,4
AEK Athens,9578,1,4,2,0,7,1,6,14
PAOK Salonik,9578,2,2,2,2,11,7,4,8
P'thinaikos,9578,3,2,1,3,7,11,-4,7
Panionios,9578,4,1,1,4,4,10,-6,4
AEK Athens,9579,1,4,2,0,7,1,6,14
PAOK Salonik,9579,2,3,2,1,10,4,6,11
P'thinaikos,9579,3,1,1,4,4,10,-6,4
Panionios,9579,3,1,1,4,4,10,-6,4
AEK Athens,9580,1,4,2,0,7,1,6,14
PAOK Salonik,9580,2,2,2,2,10,7,3,8
P'thinaikos,9580,3,2,1,3,7,10,-3,7
Panionios,9580,4,1,1,4,4,10,-6,4
AEK Athens,9581,1,4,2,0,7,1,6,14
PAOK Salonik,9581,2,2,3,1,9,4,5,9
P'thinaikos,9581,3,1,2,3,4,9,-5,5
Panionios,9581,4,1,1,4,4,10,-6,4
AEK Athens,9582,1,4,2,0,7,1,6,14
PAOK Salonik,9582,2,2,3,1,10,5,5,9
P'thinaikos,9582,3,1,2,3,5,10,-5,5
Panionios,9582,4,1,1,4,4,10,-6,4
AEK Athens,9583,1,4,2,0,7,1,6,14
PAOK Salonik,9583,2,2,2,2,9,6,3,8
P'thinaikos,9583,3,2,1,3,6,9,-3,7
Panionios,9583,4,1,1,4,4,10,-6,4
AEK Athens,9584,1,4,2,0,7,1,6,14
PAOK Salonik,9584,2,3,2,1,11,4,7,11
Panionios,9584,3,1,1,4,4,10,-6,4
P'thinaikos,9584,4,1,1,4,4,11,-7,4
AEK Athens,9585,1,4,2,0,7,1,6,14
PAOK Salonik,9585,2,2,3,1,10,5,5,9
P'thinaikos,9585,3,1,2,3,5,10,-5,5
Panionios,9585,4,1,1,4,4,10,-6,4
AEK Athens,9586,1,4,2,0,7,1,6,14
PAOK Salonik,9586,2,3,2,1,10,4,6,11
P'thinaikos,9586,3,1,1,4,4,10,-6,4
Panionios,9586,3,1,1,4,4,10,-6,4
AEK Athens,9587,1,4,2,0,7,1,6,14
PAOK Salonik,9587,2,3,2,1,11,4,7,11
Panionios,9587,3,1,1,4,4,10,-6,4
P'thinaikos,9587,4,1,1,4,4,11,-7,4
AEK Athens,9588,1,4,2,0,7,1,6,14
PAOK Salonik,9588,2,3,2,1,11,4,7,11
Panionios,9588,3,1,1,4,4,10,-6,4
P'thinaikos,9588,4,1,1,4,4,11,-7,4
AEK Athens,9589,1,4,2,0,7,1,6,14
PAOK Salonik,9589,2,2,2,2,9,7,2,8
P'thinaikos,9589,3,2,1,3,7,9,-2,7
Panionios,9589,4,1,1,4,4,10,-6,4
AEK Athens,9590,1,4,2,0,7,1,6,14
PAOK Salonik,9590,2,2,3,1,10,5,5,9
P'thinaikos,9590,3,1,2,3,5,10,-5,5
Panionios,9590,4,1,1,4,4,10,-6,4
AEK Athens,9591,1,4,2,0,7,1,6,14
PAOK Salonik,9591,2,2,3,1,9,4,5,9
P'thinaikos,9591,3,1,2,3,4,9,-5,5
Panionios,9591,4,1,1,4,4,10,-6,4
AEK Athens,9592,1,4,2,0,7,1,6,14
PAOK Salonik,9592,2,2,2,2,11,7,4,8
P'thinaikos,9592,3,2,1,3,7,11,-4,7
Panionios,9592,4,1,1,4,4,10,-6,4
AEK Athens,9593,1,4,2,0,7,1,6,14
PAOK Salonik,9593,2,3,2,1,11,4,7,11
Panionios,9593,3,1,1,4,4,10,-6,4
P'thinaikos,9593,4,1,1,4,4,11,-7,4
AEK Athens,9594,1,4,2,0,7,1,6,14
PAOK Salonik,9594,2,2,2,2,10,6,4,8
P'thinaikos,9594,3,2,1,3,6,10,-4,7
Panionios,9594,4,1,1,4,4,10,-6,4
AEK Athens,9595,1,4,2,0,7,1,6,14
PAOK Salonik,9595,2,3,2,1,11,4,7,11
Panionios,9595,3,1,1,4,4,10,-6,4
P'thinaikos,9595,4,1,1,4,4,11,-7,4
AEK Athens,9596,1,4,2,0,7,1,6,14
PAOK Salonik,9596,2,2,3,1,10,5,5,9
P'thinaikos,9596,3,1,2,3,5,10,-5,5
Panionios,9596,4,1,1,4,4,10,-6,4
AEK Athens,9597,1,4,2,0,7,1,6,14
PAOK Salonik,9597,2,3,2,1,12,4,8,11
Panionios,9597,3,1,1,4,4,10,-6,4
P'thinaikos,9597,4,1,1,4,4,12,-8,4
AEK Athens,9598,1,4,2,0,7,1,6,14
PAOK Salonik,9598,2,2,2,2,10,8,2,8
P'thinaikos,9598,3,2,1,3,8,10,-2,7
Panionios,9598,4,1,1,4,4,10,-6,4
AEK Athens,9599,1,4,2,0,7,1,6,14
PAOK Salonik,9599,2,2,2,2,10,6,4,8
P'thinaikos,9599,3,2,1,3,6,10,-4,7
Panionios,9599,4,1,1,4,4,10,-6,4
AEK Athens,9600,1,4,2,0,7,1,6,14
PAOK Salonik,9600,2,3,2,1,11,5,6,11
P'thinaikos,9600,3,1,1,4,5,11,-6,4
Panionios,9600,4,1,1,4,4,10,-6,4
AEK Athens,9601,1,4,2,0,7,1,6,14
PAOK Salonik,9601,2,2,3,1,11,6,5,9
P'thinaikos,9601,3,1,2,3,6,11,-5,5
Panionios,9601,4,1,1,4,4,10,-6,4
AEK Athens,9602,1,4,2,0,7,1,6,14
PAOK Salonik,9602,2,2,2,2,9,6,3,8
P'thinaikos,9602,3,2,1,3,6,9,-3,7
Panionios,9602,4,1,1,4,4,10,-6,4
AEK Athens,9603,1,4,2,0,7,1,6,14
PAOK Salonik,9603,2,3,2,1,11,5,6,11
P'thinaikos,9603,3,1,1,4,5,11,-6,4
Panionios,9603,4,1,1,4,4,10,-6,4
AEK Athens,9604,1,4,2,0,7,1,6,14
PAOK Salonik,9604,2,2,3,1,9,4,5,9
P'thinaikos,9604,3,1,2,3,4,9,-5,5
Panionios,9604,4,1,1,4,4,10,-6,4
AEK Athens,9605,1,4,2,0,7,1,6,14
PAOK Salonik,9605,2,2,2,2,9,5,4,8
P'thinaikos,9605,3,2,1,3,5,9,-4,7
Panionios,9605,4,1,1,4,4,10,-6,4
AEK Athens,9606,1,4,2,0,7,1,6,14
PAOK Salonik,9606,2,2,2,2,9,5,4,8
P'thinaikos,9606,3,2,1,3,5,9,-4,7
Panionios,9606,4,1,1,4,4,10,-6,4
AEK Athens,9607,1,4,2,0,7,1,6,14
PAOK Salonik,9607,2,3,2,1,10,4,6,11
P'thinaikos,9607,3,1,1,4,4,10,-6,4
Panionios,9607,3,1,1,4,4,10,-6,4
AEK Athens,9608,1,4,2,0,7,1,6,14
PAOK Salonik,9608,2,2,2,2,9,5,4,8
P'thinaikos,9608,3,2,1,3,5,9,-4,7
Panionios,9608,4,1,1,4,4,10,-6,4
AEK Athens,9609,1,4,2,0,7,1,6,14
PAOK Salonik,9609,2,2,2,2,10,6,4,8
P'thinaikos,9609,3,2,1,3,6,10,-4,7
Panionios,9609,4,1,1,4,4,10,-6,4
AEK Athens,9610,1,4,2,0,7,1,6,14
PAOK Salonik,9610,2,2,2,2,9,5,4,8
P'thinaikos,9610,3,2,1,3,5,9,-4,7
Panionios,9610,4,1,1,4,4,10,-6,4
AEK Athens,9611,1,4,2,0,7,1,6,14
PAOK Salonik,9611,2,3,2,1,10,4,6,11
P'thinaikos,9611,3,1,1,4,4,10,-6,4
Panionios,9611,3,1,1,4,4,10,-6,4
AEK Athens,9612,1,4,2,0,7,1,6,14
PAOK Salonik,9612,2,3,2,1,11,4,7,11
Panionios,9612,3,1,1,4,4,10,-6,4
P'thinaikos,9612,4,1,1,4,4,11,-7,4
AEK Athens,9613,1,4,2,0,7,1,6,14
PAOK Salonik,9613,2,2,3,1,11,6,5,9
P'thinaikos,9613,3,1,2,3,6,11,-5,5
Panionios,9613,4,1,1,4,4,10,-6,4
AEK Athens,9614,1,4,2,0,7,1,6,14
PAOK Salonik,9614,2,2,3,1,10,5,5,9
P'thinaikos,9614,3,1,2,3,5,10,-5,5
Panionios,9614,4,1,1,4,4,10,-6,4
AEK Athens,9615,1,4,2,0,7,1,6,14
PAOK Salonik,9615,2,3,2,1,11,5,6,11
P'thinaikos,9615,3,1,1,4,5,11,-6,4
Panionios,9615,4,1,1,4,4,10,-6,4
AEK Athens,9616,1,4,2,0,7,1,6,14
PAOK Salonik,9616,2,2,3,1,10,5,5,9
P'thinaikos,9616,3,1,2,3,5,10,-5,5
Panionios,9616,4,1,1,4,4,10,-6,4
AEK Athens,9617,1,4,2,0,7,1,6,14
PAOK Salonik,9617,2,2,3,1,10,5,5,9
P'thinaikos,9617,3,1,2,3,5,10,-5,5
Panionios,9617,4,1,1,4,4,10,-6,4
AEK Athens,9618,1,4,2,0,7,1,6,14
PAOK Salonik,9618,2,3,2,1,12,5,7,11
Panionios,9618,3,1,1,4,4,10,-6,4
P'thinaikos,9618,4,1,1,4,5,12,-7,4
AEK Athens,9619,1,4,2,0,7,1,6,14
PAOK Salonik,9619,2,2,2,2,9,7,2,8
P'thinaikos,9619,3,2,1,3,7,9,-2,7
Panionios,9619,4,1,1,4,4,10,-6,4
AEK Athens,9620,1,4,2,0,7,1,6,14
PAOK Salonik,9620,2,3,2,1,10,4,6,11
P'thinaikos,9620,3,1,1,4,4,10,-6,4
Panionios,9620,3,1,1,4,4,10,-6,4
AEK Athens,9621,1,4,2,0,7,1,6,14
PAOK Salonik,9621,2,3,2,1,11,4,7,11
Panionios,9621,3,1,1,4,4,10,-6,4
P'thinaikos,9621,4,1,1,4,4,11,-7,4
AEK Athens,9622,1,4,2,0,7,1,6,14
PAOK Salonik,9622,2,2,3,1,9,4,5,9
P'thinaikos,9622,3,1,2,3,4,9,-5,5
Panionios,9622,4,1,1,4,4,10,-6,4
AEK Athens,9623,1,4,2,0,7,1,6,14
PAOK Salonik,9623,2,3,2,1,10,4,6,11
P'thinaikos,9623,3,1,1,4,4,10,-6,4
Panionios,9623,3,1,1,4,4,10,-6,4
AEK Athens,9624,1,4,2,0,7,1,6,14
PAOK Salonik,9624,2,2,2,2,9,5,4,8
P'thinaikos,9624,3,2,1,3,5,9,-4,7
Panionios,9624,4,1,1,4,4,10,-6,4
AEK Athens,9625,1,4,2,0,7,1,6,14
PAOK Salonik,9625,2,2,3,1,10,5,5,9
P'thinaikos,9625,3,1,2,3,5,10,-5,5
Panionios,9625,4,1,1,4,4,10,-6,4
AEK Athens,9626,1,4,2,0,7,1,6,14
PAOK Salonik,9626,2,3,2,1,11,4,7,11
Panionios,9626,3,1,1,4,4,10,-6,4
P'thinaikos,9626,4,1,1,4,4,11,-7,4
AEK Athens,9627,1,4,2,0,7,1,6,14
PAOK Salonik,9627,2,3,2,1,11,5,6,11
P'thinaikos,9627,3,1,1,4,5,11,-6,4
Panionios,9627,4,1,1,4,4,10,-6,4
AEK Athens,9628,1,4,2,0,7,1,6,14
PAOK Salonik,9628,2,2,3,1,10,5,5,9
P'thinaikos,9628,3,1,2,3,5,10,-5,5
Panionios,9628,4,1,1,4,4,10,-6,4
AEK Athens,9629,1,4,2,0,7,1,6,14
PAOK Salonik,9629,2,3,2,1,10,4,6,11
P'thinaikos,9629,3,1,1,4,4,10,-6,4
Panionios,9629,3,1,1,4,4,10,-6,4
AEK Athens,9630,1,4,2,0,7,1,6,14
PAOK Salonik,9630,2,3,2,1,13,5,8,11
Panionios,9630,3,1,1,4,4,10,-6,4
P'thinaikos,9630,4,1,1,4,5,13,-8,4
AEK Athens,9631,1,4,2,0,7,1,6,14
PAOK Salonik,9631,2,2,2,2,10,7,3,8
P'thinaikos,9631,3,2,1,3,7,10,-3,7
Panionios,9631,4,1,1,4,4,10,-6,4
AEK Athens,9632,1,4,2,0,7,1,6,14
PAOK Salonik,9632,2,2,3,1,9,4,5,9
P'thinaikos,9632,3,1,2,3,4,9,-5,5
Panionios,9632,4,1,1,4,4,10,-6,4
AEK Athens,9633,1,4,2,0,7,1,6,14
PAOK Salonik,9633,2,2,2,2,11,7,4,8
P'thinaikos,9633,3,2,1,3,7,11,-4,7
Panionios,9633,4,1,1,4,4,10,-6,4
AEK Athens,9634,1,4,2,0,7,1,6,14
PAOK Salonik,9634,2,2,2,2,11,8,3,8
P'thinaikos,9634,3,2,1,3,8,11,-3,7
Panionios,9634,4,1,1,4,4,10,-6,4
AEK Athens,9635,1,4,2,0,7,1,6,14
PAOK Salonik,9635,2,3,2,1,10,4,6,11
P'thinaikos,9635,3,1,1,4,4,10,-6,4
Panionios,9635,3,1,1,4,4,10,-6,4
AEK Athens,9636,1,4,2,0,7,1,6,14
PAOK Salonik,9636,2,3,2,1,14,5,9,11
Panionios,9636,3,1,1,4,4,10,-6,4
P'thinaikos,9636,4,1,1,4,5,14,-9,4
AEK Athens,9637,1,4,2,0,7,1,6,14
PAOK Salonik,9637,2,2,2,2,9,7,2,8
P'thinaikos,9637,3,2,1,3,7,9,-2,7
Panionios,9637,4,1,1,4,4,10,-6,4
AEK Athens,9638,1,4,2,0,7,1,6,14
PAOK Salonik,9638,2,3,2,1,12,6,6,11
P'thinaikos,9638,3,1,1,4,6,12,-6,4
Panionios,9638,4,1,1,4,4,10,-6,4
AEK Athens,9639,1,4,2,0,7,1,6,14
PAOK Salonik,9639,2,2,2,2,9,6,3,8
P'thinaikos,9639,3,2,1,3,6,9,-3,7
Panionios,9639,4,1,1,4,4,10,-6,4
AEK Athens,9640,1,4,2,0,7,1,6,14
PAOK Salonik,9640,2,3,2,1,10,4,6,11
P'thinaikos,9640,3,1,1,4,4,10,-6,4
Panionios,9640,3,1,1,4,4,10,-6,4
AEK Athens,9641,1,4,2,0,7,1,6,14
PAOK Salonik,9641,2,3,2,1,10,4,6,11
P'thinaikos,9641,3,1,1,4,4,10,-6,4
Panionios,9641,3,1,1,4,4,10,-6,4
AEK Athens,9642,1,4,2,0,7,1,6,14
PAOK Salonik,9642,2,2,2,2,9,5,4,8
P'thinaikos,9642,3,2,1,3,5,9,-4,7
Panionios,9642,4,1,1,4,4,10,-6,4
AEK Athens,9643,1,4,2,0,7,1,6,14
PAOK Salonik,9643,2,2,3,1,10,5,5,9
P'thinaikos,9643,3,1,2,3,5,10,-5,5
Panionios,9643,4,1,1,4,4,10,-6,4
AEK Athens,9644,1,4,2,0,7,1,6,14
PAOK Salonik,9644,2,3,2,1,12,6,6,11
P'thinaikos,9644,3,1,1,4,6,12,-6,4
Panionios,9644,4,1,1,4,4,10,-6,4
AEK Athens,9645,1,4,2,0,7,1,6,14
PAOK Salonik,9645,2,2,2,2,11,7,4,8
P'thinaikos,9645,3,2,1,3,7,11,-4,7
Panionios,9645,4,1,1,4,4,10,-6,4
AEK Athens,9646,1,4,2,0,7,1,6,14
PAOK Salonik,9646,2,2,2,2,10,6,4,8
P'thinaikos,9646,3,2,1,3,6,10,-4,7
Panionios,9646,4,1,1,4,4,10,-6,4
AEK Athens,9647,1,4,2,0,7,1,6,14
PAOK Salonik,9647,2,3,2,1,12,4,8,11
Panionios,9647,3,1,1,4,4,10,-6,4
P'thinaikos,9647,4,1,1,4,4,12,-8,4
AEK Athens,9648,1,4,2,0,7,1,6,14
PAOK Salonik,9648,2,2,2,2,9,5,4,8
P'thinaikos,9648,3,2,1,3,5,9,-4,7
Panionios,9648,4,1,1,4,4,10,-6,4
AEK Athens,9649,1,4,2,0,7,1,6,14
PAOK Salonik,9649,2,2,2,2,9,5,4,8
P'thinaikos,9649,3,2,1,3,5,9,-4,7
Panionios,9649,4,1,1,4,4,10,-6,4
AEK Athens,9650,1,4,2,0,7,1,6,14
PAOK Salonik,9650,2,2,2,2,9,5,4,8
P'thinaikos,9650,3,2,1,3,5,9,-4,7
Panionios,9650,4,1,1,4,4,10,-6,4
AEK Athens,9651,1,4,2,0,7,1,6,14
PAOK Salonik,9651,2,2,2,2,9,5,4,8
P'thinaikos,9651,3,2,1,3,5,9,-4,7
Panionios,9651,4,1,1,4,4,10,-6,4
AEK Athens,9652,1,4,2,0,7,1,6,14
PAOK Salonik,9652,2,2,2,2,9,6,3,8
P'thinaikos,9652,3,2,1,3,6,9,-3,7
Panionios,9652,4,1,1,4,4,10,-6,4
AEK Athens,9653,1,4,2,0,7,1,6,14
PAOK Salonik,9653,2,2,2,2,9,7,2,8
P'thinaikos,9653,3,2,1,3,7,9,-2,7
Panionios,9653,4,1,1,4,4,10,-6,4
AEK Athens,9654,1,4,2,0,7,1,6,14
PAOK Salonik,9654,2,3,2,1,12,4,8,11
Panionios,9654,3,1,1,4,4,10,-6,4
P'thinaikos,9654,4,1,1,4,4,12,-8,4
AEK Athens,9655,1,4,2,0,7,1,6,14
PAOK Salonik,9655,2,2,2,2,10,6,4,8
P'thinaikos,9655,3,2,1,3,6,10,-4,7
Panionios,9655,4,1,1,4,4,10,-6,4
AEK Athens,9656,1,4,2,0,7,1,6,14
PAOK Salonik,9656,2,2,3,1,10,5,5,9
P'thinaikos,9656,3,1,2,3,5,10,-5,5
Panionios,9656,4,1,1,4,4,10,-6,4
AEK Athens,9657,1,4,2,0,7,1,6,14
PAOK Salonik,9657,2,3,2,1,11,5,6,11
P'thinaikos,9657,3,1,1,4,5,11,-6,4
Panionios,9657,4,1,1,4,4,10,-6,4
AEK Athens,9658,1,4,2,0,7,1,6,14
PAOK Salonik,9658,2,2,2,2,9,5,4,8
P'thinaikos,9658,3,2,1,3,5,9,-4,7
Panionios,9658,4,1,1,4,4,10,-6,4
AEK Athens,9659,1,4,2,0,7,1,6,14
PAOK Salonik,9659,2,2,2,2,9,5,4,8
P'thinaikos,9659,3,2,1,3,5,9,-4,7
Panionios,9659,4,1,1,4,4,10,-6,4
AEK Athens,9660,1,4,2,0,7,1,6,14
PAOK Salonik,9660,2,2,2,2,10,6,4,8
P'thinaikos,9660,3,2,1,3,6,10,-4,7
Panionios,9660,4,1,1,4,4,10,-6,4
AEK Athens,9661,1,4,2,0,7,1,6,14
PAOK Salonik,9661,2,3,2,1,11,5,6,11
P'thinaikos,9661,3,1,1,4,5,11,-6,4
Panionios,9661,4,1,1,4,4,10,-6,4
AEK Athens,9662,1,4,2,0,7,1,6,14
PAOK Salonik,9662,2,3,2,1,11,5,6,11
P'thinaikos,9662,3,1,1,4,5,11,-6,4
Panionios,9662,4,1,1,4,4,10,-6,4
AEK Athens,9663,1,4,2,0,7,1,6,14
PAOK Salonik,9663,2,2,2,2,9,8,1,8
P'thinaikos,9663,3,2,1,3,8,9,-1,7
Panionios,9663,4,1,1,4,4,10,-6,4
AEK Athens,9664,1,4,2,0,7,1,6,14
PAOK Salonik,9664,2,3,2,1,12,5,7,11
Panionios,9664,3,1,1,4,4,10,-6,4
P'thinaikos,9664,4,1,1,4,5,12,-7,4
AEK Athens,9665,1,4,2,0,7,1,6,14
PAOK Salonik,9665,2,3,2,1,12,4,8,11
Panionios,9665,3,1,1,4,4,10,-6,4
P'thinaikos,9665,4,1,1,4,4,12,-8,4
AEK Athens,9666,1,4,2,0,7,1,6,14
PAOK Salonik,9666,2,3,2,1,10,4,6,11
P'thinaikos,9666,3,1,1,4,4,10,-6,4
Panionios,9666,3,1,1,4,4,10,-6,4
AEK Athens,9667,1,4,2,0,7,1,6,14
PAOK Salonik,9667,2,2,2,2,9,5,4,8
P'thinaikos,9667,3,2,1,3,5,9,-4,7
Panionios,9667,4,1,1,4,4,10,-6,4
AEK Athens,9668,1,4,2,0,7,1,6,14
PAOK Salonik,9668,2,3,2,1,12,5,7,11
Panionios,9668,3,1,1,4,4,10,-6,4
P'thinaikos,9668,4,1,1,4,5,12,-7,4
AEK Athens,9669,1,4,2,0,7,1,6,14
PAOK Salonik,9669,2,2,3,1,10,5,5,9
P'thinaikos,9669,3,1,2,3,5,10,-5,5
Panionios,9669,4,1,1,4,4,10,-6,4
AEK Athens,9670,1,4,2,0,7,1,6,14
PAOK Salonik,9670,2,2,2,2,9,5,4,8
P'thinaikos,9670,3,2,1,3,5,9,-4,7
Panionios,9670,4,1,1,4,4,10,-6,4
AEK Athens,9671,1,4,2,0,7,1,6,14
PAOK Salonik,9671,2,2,3,1,9,4,5,9
P'thinaikos,9671,3,1,2,3,4,9,-5,5
Panionios,9671,4,1,1,4,4,10,-6,4
AEK Athens,9672,1,4,2,0,7,1,6,14
PAOK Salonik,9672,2,2,2,2,10,7,3,8
P'thinaikos,9672,3,2,1,3,7,10,-3,7
Panionios,9672,4,1,1,4,4,10,-6,4
AEK Athens,9673,1,4,2,0,7,1,6,14
PAOK Salonik,9673,2,3,2,1,10,4,6,11
P'thinaikos,9673,3,1,1,4,4,10,-6,4
Panionios,9673,3,1,1,4,4,10,-6,4
AEK Athens,9674,1,4,2,0,7,1,6,14
PAOK Salonik,9674,2,3,2,1,10,4,6,11
P'thinaikos,9674,3,1,1,4,4,10,-6,4
Panionios,9674,3,1,1,4,4,10,-6,4
AEK Athens,9675,1,4,2,0,7,1,6,14
PAOK Salonik,9675,2,3,2,1,11,4,7,11
Panionios,9675,3,1,1,4,4,10,-6,4
P'thinaikos,9675,4,1,1,4,4,11,-7,4
AEK Athens,9676,1,4,2,0,7,1,6,14
PAOK Salonik,9676,2,3,2,1,12,4,8,11
Panionios,9676,3,1,1,4,4,10,-6,4
P'thinaikos,9676,4,1,1,4,4,12,-8,4
AEK Athens,9677,1,4,2,0,7,1,6,14
PAOK Salonik,9677,2,2,3,1,9,4,5,9
P'thinaikos,9677,3,1,2,3,4,9,-5,5
Panionios,9677,4,1,1,4,4,10,-6,4
AEK Athens,9678,1,4,2,0,7,1,6,14
PAOK Salonik,9678,2,3,2,1,13,4,9,11
Panionios,9678,3,1,1,4,4,10,-6,4
P'thinaikos,9678,4,1,1,4,4,13,-9,4
AEK Athens,9679,1,4,2,0,7,1,6,14
PAOK Salonik,9679,2,2,3,1,10,5,5,9
P'thinaikos,9679,3,1,2,3,5,10,-5,5
Panionios,9679,4,1,1,4,4,10,-6,4
AEK Athens,9680,1,4,2,0,7,1,6,14
PAOK Salonik,9680,2,3,2,1,12,6,6,11
P'thinaikos,9680,3,1,1,4,6,12,-6,4
Panionios,9680,4,1,1,4,4,10,-6,4
AEK Athens,9681,1,4,2,0,7,1,6,14
PAOK Salonik,9681,2,2,3,1,10,5,5,9
P'thinaikos,9681,3,1,2,3,5,10,-5,5
Panionios,9681,4,1,1,4,4,10,-6,4
AEK Athens,9682,1,4,2,0,7,1,6,14
PAOK Salonik,9682,2,2,3,1,10,5,5,9
P'thinaikos,9682,3,1,2,3,5,10,-5,5
Panionios,9682,4,1,1,4,4,10,-6,4
AEK Athens,9683,1,4,2,0,7,1,6,14
PAOK Salonik,9683,2,3,2,1,11,5,6,11
P'thinaikos,9683,3,1,1,4,5,11,-6,4
Panionios,9683,4,1,1,4,4,10,-6,4
AEK Athens,9684,1,4,2,0,7,1,6,14
PAOK Salonik,9684,2,3,2,1,11,4,7,11
Panionios,9684,3,1,1,4,4,10,-6,4
P'thinaikos,9684,4,1,1,4,4,11,-7,4
AEK Athens,9685,1,4,2,0,7,1,6,14
PAOK Salonik,9685,2,2,2,2,9,7,2,8
P'thinaikos,9685,3,2,1,3,7,9,-2,7
Panionios,9685,4,1,1,4,4,10,-6,4
AEK Athens,9686,1,4,2,0,7,1,6,14
PAOK Salonik,9686,2,2,2,2,10,6,4,8
P'thinaikos,9686,3,2,1,3,6,10,-4,7
Panionios,9686,4,1,1,4,4,10,-6,4
AEK Athens,9687,1,4,2,0,7,1,6,14
PAOK Salonik,9687,2,3,2,1,10,4,6,11
P'thinaikos,9687,3,1,1,4,4,10,-6,4
Panionios,9687,3,1,1,4,4,10,-6,4
AEK Athens,9688,1,4,2,0,7,1,6,14
PAOK Salonik,9688,2,2,2,2,10,6,4,8
P'thinaikos,9688,3,2,1,3,6,10,-4,7
Panionios,9688,4,1,1,4,4,10,-6,4
AEK Athens,9689,1,4,2,0,7,1,6,14
PAOK Salonik,9689,2,3,2,1,12,4,8,11
Panionios,9689,3,1,1,4,4,10,-6,4
P'thinaikos,9689,4,1,1,4,4,12,-8,4
AEK Athens,9690,1,4,2,0,7,1,6,14
PAOK Salonik,9690,2,2,2,2,9,5,4,8
P'thinaikos,9690,3,2,1,3,5,9,-4,7
Panionios,9690,4,1,1,4,4,10,-6,4
AEK Athens,9691,1,4,2,0,7,1,6,14
PAOK Salonik,9691,2,3,2,1,10,4,6,11
P'thinaikos,9691,3,1,1,4,4,10,-6,4
Panionios,9691,3,1,1,4,4,10,-6,4
AEK Athens,9692,1,4,2,0,7,1,6,14
PAOK Salonik,9692,2,3,2,1,11,4,7,11
Panionios,9692,3,1,1,4,4,10,-6,4
P'thinaikos,9692,4,1,1,4,4,11,-7,4
AEK Athens,9693,1,4,2,0,7,1,6,14
PAOK Salonik,9693,2,2,3,1,9,4,5,9
P'thinaikos,9693,3,1,2,3,4,9,-5,5
Panionios,9693,4,1,1,4,4,10,-6,4
AEK Athens,9694,1,4,2,0,7,1,6,14
PAOK Salonik,9694,2,3,2,1,10,4,6,11
P'thinaikos,9694,3,1,1,4,4,10,-6,4
Panionios,9694,3,1,1,4,4,10,-6,4
AEK Athens,9695,1,4,2,0,7,1,6,14
PAOK Salonik,9695,2,2,3,1,9,4,5,9
P'thinaikos,9695,3,1,2,3,4,9,-5,5
Panionios,9695,4,1,1,4,4,10,-6,4
AEK Athens,9696,1,4,2,0,7,1,6,14
PAOK Salonik,9696,2,2,2,2,9,7,2,8
P'thinaikos,9696,3,2,1,3,7,9,-2,7
Panionios,9696,4,1,1,4,4,10,-6,4
AEK Athens,9697,1,4,2,0,7,1,6,14
PAOK Salonik,9697,2,3,2,1,12,6,6,11
P'thinaikos,9697,3,1,1,4,6,12,-6,4
Panionios,9697,4,1,1,4,4,10,-6,4
AEK Athens,9698,1,4,2,0,7,1,6,14
PAOK Salonik,9698,2,3,2,1,10,4,6,11
P'thinaikos,9698,3,1,1,4,4,10,-6,4
Panionios,9698,3,1,1,4,4,10,-6,4
AEK Athens,9699,1,4,2,0,7,1,6,14
PAOK Salonik,9699,2,3,2,1,12,6,6,11
P'thinaikos,9699,3,1,1,4,6,12,-6,4
Panionios,9699,4,1,1,4,4,10,-6,4
AEK Athens,9700,1,4,2,0,7,1,6,14
PAOK Salonik,9700,2,2,2,2,11,7,4,8
P'thinaikos,9700,3,2,1,3,7,11,-4,7
Panionios,9700,4,1,1,4,4,10,-6,4
AEK Athens,9701,1,4,2,0,7,1,6,14
PAOK Salonik,9701,2,2,3,1,10,5,5,9
P'thinaikos,9701,3,1,2,3,5,10,-5,5
Panionios,9701,4,1,1,4,4,10,-6,4
AEK Athens,9702,1,4,2,0,7,1,6,14
PAOK Salonik,9702,2,2,2,2,10,6,4,8
P'thinaikos,9702,3,2,1,3,6,10,-4,7
Panionios,9702,4,1,1,4,4,10,-6,4
AEK Athens,9703,1,4,2,0,7,1,6,14
PAOK Salonik,9703,2,3,2,1,13,5,8,11
Panionios,9703,3,1,1,4,4,10,-6,4
P'thinaikos,9703,4,1,1,4,5,13,-8,4
AEK Athens,9704,1,4,2,0,7,1,6,14
PAOK Salonik,9704,2,2,2,2,11,7,4,8
P'thinaikos,9704,3,2,1,3,7,11,-4,7
Panionios,9704,4,1,1,4,4,10,-6,4
AEK Athens,9705,1,4,2,0,7,1,6,14
PAOK Salonik,9705,2,2,3,1,10,5,5,9
P'thinaikos,9705,3,1,2,3,5,10,-5,5
Panionios,9705,4,1,1,4,4,10,-6,4
AEK Athens,9706,1,4,2,0,7,1,6,14
PAOK Salonik,9706,2,2,3,1,10,5,5,9
P'thinaikos,9706,3,1,2,3,5,10,-5,5
Panionios,9706,4,1,1,4,4,10,-6,4
AEK Athens,9707,1,4,2,0,7,1,6,14
PAOK Salonik,9707,2,2,2,2,9,6,3,8
P'thinaikos,9707,3,2,1,3,6,9,-3,7
Panionios,9707,4,1,1,4,4,10,-6,4
AEK Athens,9708,1,4,2,0,7,1,6,14
PAOK Salonik,9708,2,3,2,1,10,4,6,11
P'thinaikos,9708,3,1,1,4,4,10,-6,4
Panionios,9708,3,1,1,4,4,10,-6,4
AEK Athens,9709,1,4,2,0,7,1,6,14
PAOK Salonik,9709,2,2,3,1,9,4,5,9
P'thinaikos,9709,3,1,2,3,4,9,-5,5
Panionios,9709,4,1,1,4,4,10,-6,4
AEK Athens,9710,1,4,2,0,7,1,6,14
PAOK Salonik,9710,2,3,2,1,11,5,6,11
P'thinaikos,9710,3,1,1,4,5,11,-6,4
Panionios,9710,4,1,1,4,4,10,-6,4
AEK Athens,9711,1,4,2,0,7,1,6,14
PAOK Salonik,9711,2,2,3,1,10,5,5,9
P'thinaikos,9711,3,1,2,3,5,10,-5,5
Panionios,9711,4,1,1,4,4,10,-6,4
AEK Athens,9712,1,4,2,0,7,1,6,14
PAOK Salonik,9712,2,3,2,1,12,5,7,11
Panionios,9712,3,1,1,4,4,10,-6,4
P'thinaikos,9712,4,1,1,4,5,12,-7,4
AEK Athens,9713,1,4,2,0,7,1,6,14
PAOK Salonik,9713,2,2,2,2,9,6,3,8
P'thinaikos,9713,3,2,1,3,6,9,-3,7
Panionios,9713,4,1,1,4,4,10,-6,4
AEK Athens,9714,1,4,2,0,7,1,6,14
PAOK Salonik,9714,2,2,3,1,10,5,5,9
P'thinaikos,9714,3,1,2,3,5,10,-5,5
Panionios,9714,4,1,1,4,4,10,-6,4
AEK Athens,9715,1,4,2,0,7,1,6,14
PAOK Salonik,9715,2,2,2,2,10,6,4,8
P'thinaikos,9715,3,2,1,3,6,10,-4,7
Panionios,9715,4,1,1,4,4,10,-6,4
AEK Athens,9716,1,4,2,0,7,1,6,14
PAOK Salonik,9716,2,3,2,1,11,5,6,11
P'thinaikos,9716,3,1,1,4,5,11,-6,4
Panionios,9716,4,1,1,4,4,10,-6,4
AEK Athens,9717,1,4,2,0,7,1,6,14
PAOK Salonik,9717,2,2,3,1,9,4,5,9
P'thinaikos,9717,3,1,2,3,4,9,-5,5
Panionios,9717,4,1,1,4,4,10,-6,4
AEK Athens,9718,1,4,2,0,7,1,6,14
PAOK Salonik,9718,2,2,2,2,10,8,2,8
P'thinaikos,9718,3,2,1,3,8,10,-2,7
Panionios,9718,4,1,1,4,4,10,-6,4
AEK Athens,9719,1,4,2,0,7,1,6,14
PAOK Salonik,9719,2,2,2,2,10,6,4,8
P'thinaikos,9719,3,2,1,3,6,10,-4,7
Panionios,9719,4,1,1,4,4,10,-6,4
AEK Athens,9720,1,4,2,0,7,1,6,14
PAOK Salonik,9720,2,2,2,2,10,7,3,8
P'thinaikos,9720,3,2,1,3,7,10,-3,7
Panionios,9720,4,1,1,4,4,10,-6,4
AEK Athens,9721,1,4,2,0,7,1,6,14
PAOK Salonik,9721,2,2,3,1,10,5,5,9
P'thinaikos,9721,3,1,2,3,5,10,-5,5
Panionios,9721,4,1,1,4,4,10,-6,4
AEK Athens,9722,1,4,2,0,7,1,6,14
PAOK Salonik,9722,2,2,3,1,9,4,5,9
P'thinaikos,9722,3,1,2,3,4,9,-5,5
Panionios,9722,4,1,1,4,4,10,-6,4
AEK Athens,9723,1,4,2,0,7,1,6,14
PAOK Salonik,9723,2,2,3,1,10,5,5,9
P'thinaikos,9723,3,1,2,3,5,10,-5,5
Panionios,9723,4,1,1,4,4,10,-6,4
AEK Athens,9724,1,4,2,0,7,1,6,14
PAOK Salonik,9724,2,3,2,1,11,4,7,11
Panionios,9724,3,1,1,4,4,10,-6,4
P'thinaikos,9724,4,1,1,4,4,11,-7,4
AEK Athens,9725,1,4,2,0,7,1,6,14
PAOK Salonik,9725,2,3,2,1,10,4,6,11
P'thinaikos,9725,3,1,1,4,4,10,-6,4
Panionios,9725,3,1,1,4,4,10,-6,4
AEK Athens,9726,1,4,2,0,7,1,6,14
PAOK Salonik,9726,2,3,2,1,12,6,6,11
P'thinaikos,9726,3,1,1,4,6,12,-6,4
Panionios,9726,4,1,1,4,4,10,-6,4
AEK Athens,9727,1,4,2,0,7,1,6,14
PAOK Salonik,9727,2,2,2,2,9,5,4,8
P'thinaikos,9727,3,2,1,3,5,9,-4,7
Panionios,9727,4,1,1,4,4,10,-6,4
AEK Athens,9728,1,4,2,0,7,1,6,14
PAOK Salonik,9728,2,3,2,1,10,4,6,11
P'thinaikos,9728,3,1,1,4,4,10,-6,4
Panionios,9728,3,1,1,4,4,10,-6,4
AEK Athens,9729,1,4,2,0,7,1,6,14
PAOK Salonik,9729,2,2,3,1,10,5,5,9
P'thinaikos,9729,3,1,2,3,5,10,-5,5
Panionios,9729,4,1,1,4,4,10,-6,4
AEK Athens,9730,1,4,2,0,7,1,6,14
PAOK Salonik,9730,2,2,2,2,10,8,2,8
P'thinaikos,9730,3,2,1,3,8,10,-2,7
Panionios,9730,4,1,1,4,4,10,-6,4
AEK Athens,9731,1,4,2,0,7,1,6,14
PAOK Salonik,9731,2,3,2,1,11,4,7,11
Panionios,9731,3,1,1,4,4,10,-6,4
P'thinaikos,9731,4,1,1,4,4,11,-7,4
AEK Athens,9732,1,4,2,0,7,1,6,14
PAOK Salonik,9732,2,2,2,2,10,8,2,8
P'thinaikos,9732,3,2,1,3,8,10,-2,7
Panionios,9732,4,1,1,4,4,10,-6,4
AEK Athens,9733,1,4,2,0,7,1,6,14
PAOK Salonik,9733,2,3,2,1,11,4,7,11
Panionios,9733,3,1,1,4,4,10,-6,4
P'thinaikos,9733,4,1,1,4,4,11,-7,4
AEK Athens,9734,1,4,2,0,7,1,6,14
PAOK Salonik,9734,2,2,2,2,10,6,4,8
P'thinaikos,9734,3,2,1,3,6,10,-4,7
Panionios,9734,4,1,1,4,4,10,-6,4
AEK Athens,9735,1,4,2,0,7,1,6,14
PAOK Salonik,9735,2,2,2,2,9,6,3,8
P'thinaikos,9735,3,2,1,3,6,9,-3,7
Panionios,9735,4,1,1,4,4,10,-6,4
AEK Athens,9736,1,4,2,0,7,1,6,14
PAOK Salonik,9736,2,3,2,1,11,4,7,11
Panionios,9736,3,1,1,4,4,10,-6,4
P'thinaikos,9736,4,1,1,4,4,11,-7,4
AEK Athens,9737,1,4,2,0,7,1,6,14
PAOK Salonik,9737,2,3,2,1,11,5,6,11
P'thinaikos,9737,3,1,1,4,5,11,-6,4
Panionios,9737,4,1,1,4,4,10,-6,4
AEK Athens,9738,1,4,2,0,7,1,6,14
PAOK Salonik,9738,2,2,3,1,10,5,5,9
P'thinaikos,9738,3,1,2,3,5,10,-5,5
Panionios,9738,4,1,1,4,4,10,-6,4
AEK Athens,9739,1,4,2,0,7,1,6,14
PAOK Salonik,9739,2,2,2,2,9,5,4,8
P'thinaikos,9739,3,2,1,3,5,9,-4,7
Panionios,9739,4,1,1,4,4,10,-6,4
AEK Athens,9740,1,4,2,0,7,1,6,14
PAOK Salonik,9740,2,3,2,1,11,5,6,11
P'thinaikos,9740,3,1,1,4,5,11,-6,4
Panionios,9740,4,1,1,4,4,10,-6,4
AEK Athens,9741,1,4,2,0,7,1,6,14
PAOK Salonik,9741,2,3,2,1,11,5,6,11
P'thinaikos,9741,3,1,1,4,5,11,-6,4
Panionios,9741,4,1,1,4,4,10,-6,4
AEK Athens,9742,1,4,2,0,7,1,6,14
PAOK Salonik,9742,2,3,2,1,11,4,7,11
Panionios,9742,3,1,1,4,4,10,-6,4
P'thinaikos,9742,4,1,1,4,4,11,-7,4
AEK Athens,9743,1,4,2,0,7,1,6,14
PAOK Salonik,9743,2,2,3,1,10,5,5,9
P'thinaikos,9743,3,1,2,3,5,10,-5,5
Panionios,9743,4,1,1,4,4,10,-6,4
AEK Athens,9744,1,4,2,0,7,1,6,14
PAOK Salonik,9744,2,3,2,1,11,4,7,11
Panionios,9744,3,1,1,4,4,10,-6,4
P'thinaikos,9744,4,1,1,4,4,11,-7,4
AEK Athens,9745,1,4,2,0,7,1,6,14
PAOK Salonik,9745,2,3,2,1,10,4,6,11
P'thinaikos,9745,3,1,1,4,4,10,-6,4
Panionios,9745,3,1,1,4,4,10,-6,4
AEK Athens,9746,1,4,2,0,7,1,6,14
PAOK Salonik,9746,2,2,2,2,9,5,4,8
P'thinaikos,9746,3,2,1,3,5,9,-4,7
Panionios,9746,4,1,1,4,4,10,-6,4
AEK Athens,9747,1,4,2,0,7,1,6,14
PAOK Salonik,9747,2,2,3,1,10,5,5,9
P'thinaikos,9747,3,1,2,3,5,10,-5,5
Panionios,9747,4,1,1,4,4,10,-6,4
AEK Athens,9748,1,4,2,0,7,1,6,14
PAOK Salonik,9748,2,2,2,2,10,6,4,8
P'thinaikos,9748,3,2,1,3,6,10,-4,7
Panionios,9748,4,1,1,4,4,10,-6,4
AEK Athens,9749,1,4,2,0,7,1,6,14
PAOK Salonik,9749,2,2,2,2,9,5,4,8
P'thinaikos,9749,3,2,1,3,5,9,-4,7
Panionios,9749,4,1,1,4,4,10,-6,4
AEK Athens,9750,1,4,2,0,7,1,6,14
PAOK Salonik,9750,2,2,2,2,11,7,4,8
P'thinaikos,9750,3,2,1,3,7,11,-4,7
Panionios,9750,4,1,1,4,4,10,-6,4
AEK Athens,9751,1,4,2,0,7,1,6,14
PAOK Salonik,9751,2,2,3,1,10,5,5,9
P'thinaikos,9751,3,1,2,3,5,10,-5,5
Panionios,9751,4,1,1,4,4,10,-6,4
AEK Athens,9752,1,4,2,0,7,1,6,14
PAOK Salonik,9752,2,3,2,1,10,4,6,11
P'thinaikos,9752,3,1,1,4,4,10,-6,4
Panionios,9752,3,1,1,4,4,10,-6,4
AEK Athens,9753,1,4,2,0,7,1,6,14
PAOK Salonik,9753,2,2,3,1,9,4,5,9
P'thinaikos,9753,3,1,2,3,4,9,-5,5
Panionios,9753,4,1,1,4,4,10,-6,4
AEK Athens,9754,1,4,2,0,7,1,6,14
PAOK Salonik,9754,2,3,2,1,11,5,6,11
P'thinaikos,9754,3,1,1,4,5,11,-6,4
Panionios,9754,4,1,1,4,4,10,-6,4
AEK Athens,9755,1,4,2,0,7,1,6,14
PAOK Salonik,9755,2,2,3,1,11,6,5,9
P'thinaikos,9755,3,1,2,3,6,11,-5,5
Panionios,9755,4,1,1,4,4,10,-6,4
AEK Athens,9756,1,4,2,0,7,1,6,14
PAOK Salonik,9756,2,2,3,1,9,4,5,9
P'thinaikos,9756,3,1,2,3,4,9,-5,5
Panionios,9756,4,1,1,4,4,10,-6,4
AEK Athens,9757,1,4,2,0,7,1,6,14
PAOK Salonik,9757,2,3,2,1,10,4,6,11
P'thinaikos,9757,3,1,1,4,4,10,-6,4
Panionios,9757,3,1,1,4,4,10,-6,4
AEK Athens,9758,1,4,2,0,7,1,6,14
PAOK Salonik,9758,2,2,3,1,10,5,5,9
P'thinaikos,9758,3,1,2,3,5,10,-5,5
Panionios,9758,4,1,1,4,4,10,-6,4
AEK Athens,9759,1,4,2,0,7,1,6,14
PAOK Salonik,9759,2,2,2,2,10,6,4,8
P'thinaikos,9759,3,2,1,3,6,10,-4,7
Panionios,9759,4,1,1,4,4,10,-6,4
AEK Athens,9760,1,4,2,0,7,1,6,14
PAOK Salonik,9760,2,2,2,2,9,8,1,8
P'thinaikos,9760,3,2,1,3,8,9,-1,7
Panionios,9760,4,1,1,4,4,10,-6,4
AEK Athens,9761,1,4,2,0,7,1,6,14
PAOK Salonik,9761,2,2,3,1,9,4,5,9
P'thinaikos,9761,3,1,2,3,4,9,-5,5
Panionios,9761,4,1,1,4,4,10,-6,4
AEK Athens,9762,1,4,2,0,7,1,6,14
PAOK Salonik,9762,2,2,2,2,9,7,2,8
P'thinaikos,9762,3,2,1,3,7,9,-2,7
Panionios,9762,4,1,1,4,4,10,-6,4
AEK Athens,9763,1,4,2,0,7,1,6,14
PAOK Salonik,9763,2,2,2,2,9,5,4,8
P'thinaikos,9763,3,2,1,3,5,9,-4,7
Panionios,9763,4,1,1,4,4,10,-6,4
AEK Athens,9764,1,4,2,0,7,1,6,14
PAOK Salonik,9764,2,2,2,2,9,5,4,8
P'thinaikos,9764,3,2,1,3,5,9,-4,7
Panionios,9764,4,1,1,4,4,10,-6,4
AEK Athens,9765,1,4,2,0,7,1,6,14
PAOK Salonik,9765,2,2,2,2,9,6,3,8
P'thinaikos,9765,3,2,1,3,6,9,-3,7
Panionios,9765,4,1,1,4,4,10,-6,4
AEK Athens,9766,1,4,2,0,7,1,6,14
PAOK Salonik,9766,2,2,2,2,10,6,4,8
P'thinaikos,9766,3,2,1,3,6,10,-4,7
Panionios,9766,4,1,1,4,4,10,-6,4
AEK Athens,9767,1,4,2,0,7,1,6,14
PAOK Salonik,9767,2,3,2,1,13,4,9,11
Panionios,9767,3,1,1,4,4,10,-6,4
P'thinaikos,9767,4,1,1,4,4,13,-9,4
AEK Athens,9768,1,4,2,0,7,1,6,14
PAOK Salonik,9768,2,2,2,2,9,6,3,8
P'thinaikos,9768,3,2,1,3,6,9,-3,7
Panionios,9768,4,1,1,4,4,10,-6,4
AEK Athens,9769,1,4,2,0,7,1,6,14
PAOK Salonik,9769,2,2,2,2,11,8,3,8
P'thinaikos,9769,3,2,1,3,8,11,-3,7
Panionios,9769,4,1,1,4,4,10,-6,4
AEK Athens,9770,1,4,2,0,7,1,6,14
PAOK Salonik,9770,2,2,2,2,10,6,4,8
P'thinaikos,9770,3,2,1,3,6,10,-4,7
Panionios,9770,4,1,1,4,4,10,-6,4
AEK Athens,9771,1,4,2,0,7,1,6,14
PAOK Salonik,9771,2,2,2,2,9,5,4,8
P'thinaikos,9771,3,2,1,3,5,9,-4,7
Panionios,9771,4,1,1,4,4,10,-6,4
AEK Athens,9772,1,4,2,0,7,1,6,14
PAOK Salonik,9772,2,2,2,2,9,5,4,8
P'thinaikos,9772,3,2,1,3,5,9,-4,7
Panionios,9772,4,1,1,4,4,10,-6,4
AEK Athens,9773,1,4,2,0,7,1,6,14
PAOK Salonik,9773,2,2,2,2,9,6,3,8
P'thinaikos,9773,3,2,1,3,6,9,-3,7
Panionios,9773,4,1,1,4,4,10,-6,4
AEK Athens,9774,1,4,2,0,7,1,6,14
PAOK Salonik,9774,2,2,2,2,9,5,4,8
P'thinaikos,9774,3,2,1,3,5,9,-4,7
Panionios,9774,4,1,1,4,4,10,-6,4
AEK Athens,9775,1,4,2,0,7,1,6,14
PAOK Salonik,9775,2,2,2,2,11,7,4,8
P'thinaikos,9775,3,2,1,3,7,11,-4,7
Panionios,9775,4,1,1,4,4,10,-6,4
AEK Athens,9776,1,4,2,0,7,1,6,14
PAOK Salonik,9776,2,2,3,1,10,5,5,9
P'thinaikos,9776,3,1,2,3,5,10,-5,5
Panionios,9776,4,1,1,4,4,10,-6,4
AEK Athens,9777,1,4,2,0,7,1,6,14
PAOK Salonik,9777,2,3,2,1,13,4,9,11
Panionios,9777,3,1,1,4,4,10,-6,4
P'thinaikos,9777,4,1,1,4,4,13,-9,4
AEK Athens,9778,1,4,2,0,7,1,6,14
PAOK Salonik,9778,2,2,3,1,9,4,5,9
P'thinaikos,9778,3,1,2,3,4,9,-5,5
Panionios,9778,4,1,1,4,4,10,-6,4
AEK Athens,9779,1,4,2,0,7,1,6,14
PAOK Salonik,9779,2,2,2,2,9,5,4,8
P'thinaikos,9779,3,2,1,3,5,9,-4,7
Panionios,9779,4,1,1,4,4,10,-6,4
AEK Athens,9780,1,4,2,0,7,1,6,14
PAOK Salonik,9780,2,3,2,1,10,4,6,11
P'thinaikos,9780,3,1,1,4,4,10,-6,4
Panionios,9780,3,1,1,4,4,10,-6,4
AEK Athens,9781,1,4,2,0,7,1,6,14
PAOK Salonik,9781,2,2,3,1,10,5,5,9
P'thinaikos,9781,3,1,2,3,5,10,-5,5
Panionios,9781,4,1,1,4,4,10,-6,4
AEK Athens,9782,1,4,2,0,7,1,6,14
PAOK Salonik,9782,2,2,2,2,10,6,4,8
P'thinaikos,9782,3,2,1,3,6,10,-4,7
Panionios,9782,4,1,1,4,4,10,-6,4
AEK Athens,9783,1,4,2,0,7,1,6,14
PAOK Salonik,9783,2,3,2,1,11,5,6,11
P'thinaikos,9783,3,1,1,4,5,11,-6,4
Panionios,9783,4,1,1,4,4,10,-6,4
AEK Athens,9784,1,4,2,0,7,1,6,14
PAOK Salonik,9784,2,3,2,1,11,5,6,11
P'thinaikos,9784,3,1,1,4,5,11,-6,4
Panionios,9784,4,1,1,4,4,10,-6,4
AEK Athens,9785,1,4,2,0,7,1,6,14
PAOK Salonik,9785,2,2,2,2,10,7,3,8
P'thinaikos,9785,3,2,1,3,7,10,-3,7
Panionios,9785,4,1,1,4,4,10,-6,4
AEK Athens,9786,1,4,2,0,7,1,6,14
PAOK Salonik,9786,2,3,2,1,10,4,6,11
P'thinaikos,9786,3,1,1,4,4,10,-6,4
Panionios,9786,3,1,1,4,4,10,-6,4
AEK Athens,9787,1,4,2,0,7,1,6,14
PAOK Salonik,9787,2,2,2,2,9,5,4,8
P'thinaikos,9787,3,2,1,3,5,9,-4,7
Panionios,9787,4,1,1,4,4,10,-6,4
AEK Athens,9788,1,4,2,0,7,1,6,14
PAOK Salonik,9788,2,2,3,1,10,5,5,9
P'thinaikos,9788,3,1,2,3,5,10,-5,5
Panionios,9788,4,1,1,4,4,10,-6,4
AEK Athens,9789,1,4,2,0,7,1,6,14
PAOK Salonik,9789,2,2,2,2,10,6,4,8
P'thinaikos,9789,3,2,1,3,6,10,-4,7
Panionios,9789,4,1,1,4,4,10,-6,4
AEK Athens,9790,1,4,2,0,7,1,6,14
PAOK Salonik,9790,2,2,2,2,10,6,4,8
P'thinaikos,9790,3,2,1,3,6,10,-4,7
Panionios,9790,4,1,1,4,4,10,-6,4
AEK Athens,9791,1,4,2,0,7,1,6,14
PAOK Salonik,9791,2,2,2,2,11,8,3,8
P'thinaikos,9791,3,2,1,3,8,11,-3,7
Panionios,9791,4,1,1,4,4,10,-6,4
AEK Athens,9792,1,4,2,0,7,1,6,14
PAOK Salonik,9792,2,3,2,1,10,4,6,11
P'thinaikos,9792,3,1,1,4,4,10,-6,4
Panionios,9792,3,1,1,4,4,10,-6,4
AEK Athens,9793,1,4,2,0,7,1,6,14
PAOK Salonik,9793,2,2,2,2,9,5,4,8
P'thinaikos,9793,3,2,1,3,5,9,-4,7
Panionios,9793,4,1,1,4,4,10,-6,4
AEK Athens,9794,1,4,2,0,7,1,6,14
PAOK Salonik,9794,2,2,2,2,10,6,4,8
P'thinaikos,9794,3,2,1,3,6,10,-4,7
Panionios,9794,4,1,1,4,4,10,-6,4
AEK Athens,9795,1,4,2,0,7,1,6,14
PAOK Salonik,9795,2,2,2,2,9,5,4,8
P'thinaikos,9795,3,2,1,3,5,9,-4,7
Panionios,9795,4,1,1,4,4,10,-6,4
AEK Athens,9796,1,4,2,0,7,1,6,14
PAOK Salonik,9796,2,2,3,1,10,5,5,9
P'thinaikos,9796,3,1,2,3,5,10,-5,5
Panionios,9796,4,1,1,4,4,10,-6,4
AEK Athens,9797,1,4,2,0,7,1,6,14
PAOK Salonik,9797,2,2,2,2,9,5,4,8
P'thinaikos,9797,3,2,1,3,5,9,-4,7
Panionios,9797,4,1,1,4,4,10,-6,4
AEK Athens,9798,1,4,2,0,7,1,6,14
PAOK Salonik,9798,2,2,3,1,10,5,5,9
P'thinaikos,9798,3,1,2,3,5,10,-5,5
Panionios,9798,4,1,1,4,4,10,-6,4
AEK Athens,9799,1,4,2,0,7,1,6,14
PAOK Salonik,9799,2,3,2,1,11,5,6,11
P'thinaikos,9799,3,1,1,4,5,11,-6,4
Panionios,9799,4,1,1,4,4,10,-6,4
AEK Athens,9800,1,4,2,0,7,1,6,14
PAOK Salonik,9800,2,2,2,2,10,7,3,8
P'thinaikos,9800,3,2,1,3,7,10,-3,7
Panionios,9800,4,1,1,4,4,10,-6,4
AEK Athens,9801,1,4,2,0,7,1,6,14
PAOK Salonik,9801,2,2,3,1,10,5,5,9
P'thinaikos,9801,3,1,2,3,5,10,-5,5
Panionios,9801,4,1,1,4,4,10,-6,4
AEK Athens,9802,1,4,2,0,7,1,6,14
PAOK Salonik,9802,2,3,2,1,13,5,8,11
Panionios,9802,3,1,1,4,4,10,-6,4
P'thinaikos,9802,4,1,1,4,5,13,-8,4
AEK Athens,9803,1,4,2,0,7,1,6,14
PAOK Salonik,9803,2,2,3,1,10,5,5,9
P'thinaikos,9803,3,1,2,3,5,10,-5,5
Panionios,9803,4,1,1,4,4,10,-6,4
AEK Athens,9804,1,4,2,0,7,1,6,14
PAOK Salonik,9804,2,3,2,1,10,4,6,11
P'thinaikos,9804,3,1,1,4,4,10,-6,4
Panionios,9804,3,1,1,4,4,10,-6,4
AEK Athens,9805,1,4,2,0,7,1,6,14
PAOK Salonik,9805,2,2,2,2,10,6,4,8
P'thinaikos,9805,3,2,1,3,6,10,-4,7
Panionios,9805,4,1,1,4,4,10,-6,4
AEK Athens,9806,1,4,2,0,7,1,6,14
PAOK Salonik,9806,2,2,2,2,9,7,2,8
P'thinaikos,9806,3,2,1,3,7,9,-2,7
Panionios,9806,4,1,1,4,4,10,-6,4
AEK Athens,9807,1,4,2,0,7,1,6,14
PAOK Salonik,9807,2,3,2,1,10,4,6,11
P'thinaikos,9807,3,1,1,4,4,10,-6,4
Panionios,9807,3,1,1,4,4,10,-6,4
AEK Athens,9808,1,4,2,0,7,1,6,14
PAOK Salonik,9808,2,3,2,1,12,5,7,11
Panionios,9808,3,1,1,4,4,10,-6,4
P'thinaikos,9808,4,1,1,4,5,12,-7,4
AEK Athens,9809,1,4,2,0,7,1,6,14
PAOK Salonik,9809,2,2,3,1,9,4,5,9
P'thinaikos,9809,3,1,2,3,4,9,-5,5
Panionios,9809,4,1,1,4,4,10,-6,4
AEK Athens,9810,1,4,2,0,7,1,6,14
PAOK Salonik,9810,2,2,2,2,9,5,4,8
P'thinaikos,9810,3,2,1,3,5,9,-4,7
Panionios,9810,4,1,1,4,4,10,-6,4
AEK Athens,9811,1,4,2,0,7,1,6,14
PAOK Salonik,9811,2,2,3,1,11,6,5,9
P'thinaikos,9811,3,1,2,3,6,11,-5,5
Panionios,9811,4,1,1,4,4,10,-6,4
AEK Athens,9812,1,4,2,0,7,1,6,14
PAOK Salonik,9812,2,2,3,1,12,7,5,9
P'thinaikos,9812,3,1,2,3,7,12,-5,5
Panionios,9812,4,1,1,4,4,10,-6,4
AEK Athens,9813,1,4,2,0,7,1,6,14
PAOK Salonik,9813,2,2,2,2,9,5,4,8
P'thinaikos,9813,3,2,1,3,5,9,-4,7
Panionios,9813,4,1,1,4,4,10,-6,4
AEK Athens,9814,1,4,2,0,7,1,6,14
PAOK Salonik,9814,2,2,3,1,10,5,5,9
P'thinaikos,9814,3,1,2,3,5,10,-5,5
Panionios,9814,4,1,1,4,4,10,-6,4
AEK Athens,9815,1,4,2,0,7,1,6,14
PAOK Salonik,9815,2,2,2,2,11,7,4,8
P'thinaikos,9815,3,2,1,3,7,11,-4,7
Panionios,9815,4,1,1,4,4,10,-6,4
AEK Athens,9816,1,4,2,0,7,1,6,14
PAOK Salonik,9816,2,3,2,1,12,5,7,11
Panionios,9816,3,1,1,4,4,10,-6,4
P'thinaikos,9816,4,1,1,4,5,12,-7,4
AEK Athens,9817,1,4,2,0,7,1,6,14
PAOK Salonik,9817,2,3,2,1,11,4,7,11
Panionios,9817,3,1,1,4,4,10,-6,4
P'thinaikos,9817,4,1,1,4,4,11,-7,4
AEK Athens,9818,1,4,2,0,7,1,6,14
PAOK Salonik,9818,2,3,2,1,10,4,6,11
P'thinaikos,9818,3,1,1,4,4,10,-6,4
Panionios,9818,3,1,1,4,4,10,-6,4
AEK Athens,9819,1,4,2,0,7,1,6,14
PAOK Salonik,9819,2,2,3,1,10,5,5,9
P'thinaikos,9819,3,1,2,3,5,10,-5,5
Panionios,9819,4,1,1,4,4,10,-6,4
AEK Athens,9820,1,4,2,0,7,1,6,14
PAOK Salonik,9820,2,2,3,1,11,6,5,9
P'thinaikos,9820,3,1,2,3,6,11,-5,5
Panionios,9820,4,1,1,4,4,10,-6,4
AEK Athens,9821,1,4,2,0,7,1,6,14
PAOK Salonik,9821,2,2,3,1,11,6,5,9
P'thinaikos,9821,3,1,2,3,6,11,-5,5
Panionios,9821,4,1,1,4,4,10,-6,4
AEK Athens,9822,1,4,2,0,7,1,6,14
PAOK Salonik,9822,2,2,3,1,9,4,5,9
P'thinaikos,9822,3,1,2,3,4,9,-5,5
Panionios,9822,4,1,1,4,4,10,-6,4
AEK Athens,9823,1,4,2,0,7,1,6,14
PAOK Salonik,9823,2,3,2,1,11,5,6,11
P'thinaikos,9823,3,1,1,4,5,11,-6,4
Panionios,9823,4,1,1,4,4,10,-6,4
AEK Athens,9824,1,4,2,0,7,1,6,14
PAOK Salonik,9824,2,2,3,1,10,5,5,9
P'thinaikos,9824,3,1,2,3,5,10,-5,5
Panionios,9824,4,1,1,4,4,10,-6,4
AEK Athens,9825,1,4,2,0,7,1,6,14
PAOK Salonik,9825,2,2,3,1,10,5,5,9
P'thinaikos,9825,3,1,2,3,5,10,-5,5
Panionios,9825,4,1,1,4,4,10,-6,4
AEK Athens,9826,1,4,2,0,7,1,6,14
PAOK Salonik,9826,2,2,3,1,12,7,5,9
P'thinaikos,9826,3,1,2,3,7,12,-5,5
Panionios,9826,4,1,1,4,4,10,-6,4
AEK Athens,9827,1,4,2,0,7,1,6,14
PAOK Salonik,9827,2,2,2,2,11,7,4,8
P'thinaikos,9827,3,2,1,3,7,11,-4,7
Panionios,9827,4,1,1,4,4,10,-6,4
AEK Athens,9828,1,4,2,0,7,1,6,14
PAOK Salonik,9828,2,2,2,2,9,5,4,8
P'thinaikos,9828,3,2,1,3,5,9,-4,7
Panionios,9828,4,1,1,4,4,10,-6,4
AEK Athens,9829,1,4,2,0,7,1,6,14
PAOK Salonik,9829,2,3,2,1,11,5,6,11
P'thinaikos,9829,3,1,1,4,5,11,-6,4
Panionios,9829,4,1,1,4,4,10,-6,4
AEK Athens,9830,1,4,2,0,7,1,6,14
PAOK Salonik,9830,2,2,3,1,10,5,5,9
P'thinaikos,9830,3,1,2,3,5,10,-5,5
Panionios,9830,4,1,1,4,4,10,-6,4
AEK Athens,9831,1,4,2,0,7,1,6,14
PAOK Salonik,9831,2,2,3,1,10,5,5,9
P'thinaikos,9831,3,1,2,3,5,10,-5,5
Panionios,9831,4,1,1,4,4,10,-6,4
AEK Athens,9832,1,4,2,0,7,1,6,14
PAOK Salonik,9832,2,2,2,2,10,6,4,8
P'thinaikos,9832,3,2,1,3,6,10,-4,7
Panionios,9832,4,1,1,4,4,10,-6,4
AEK Athens,9833,1,4,2,0,7,1,6,14
PAOK Salonik,9833,2,2,3,1,10,5,5,9
P'thinaikos,9833,3,1,2,3,5,10,-5,5
Panionios,9833,4,1,1,4,4,10,-6,4
AEK Athens,9834,1,4,2,0,7,1,6,14
PAOK Salonik,9834,2,2,3,1,11,6,5,9
P'thinaikos,9834,3,1,2,3,6,11,-5,5
Panionios,9834,4,1,1,4,4,10,-6,4
AEK Athens,9835,1,4,2,0,7,1,6,14
PAOK Salonik,9835,2,3,2,1,11,5,6,11
P'thinaikos,9835,3,1,1,4,5,11,-6,4
Panionios,9835,4,1,1,4,4,10,-6,4
AEK Athens,9836,1,4,2,0,7,1,6,14
PAOK Salonik,9836,2,2,2,2,10,6,4,8
P'thinaikos,9836,3,2,1,3,6,10,-4,7
Panionios,9836,4,1,1,4,4,10,-6,4
AEK Athens,9837,1,4,2,0,7,1,6,14
PAOK Salonik,9837,2,2,2,2,10,7,3,8
P'thinaikos,9837,3,2,1,3,7,10,-3,7
Panionios,9837,4,1,1,4,4,10,-6,4
AEK Athens,9838,1,4,2,0,7,1,6,14
PAOK Salonik,9838,2,3,2,1,12,4,8,11
Panionios,9838,3,1,1,4,4,10,-6,4
P'thinaikos,9838,4,1,1,4,4,12,-8,4
AEK Athens,9839,1,4,2,0,7,1,6,14
PAOK Salonik,9839,2,2,3,1,10,5,5,9
P'thinaikos,9839,3,1,2,3,5,10,-5,5
Panionios,9839,4,1,1,4,4,10,-6,4
AEK Athens,9840,1,4,2,0,7,1,6,14
PAOK Salonik,9840,2,2,3,1,10,5,5,9
P'thinaikos,9840,3,1,2,3,5,10,-5,5
Panionios,9840,4,1,1,4,4,10,-6,4
AEK Athens,9841,1,4,2,0,7,1,6,14
PAOK Salonik,9841,2,2,3,1,10,5,5,9
P'thinaikos,9841,3,1,2,3,5,10,-5,5
Panionios,9841,4,1,1,4,4,10,-6,4
AEK Athens,9842,1,4,2,0,7,1,6,14
PAOK Salonik,9842,2,3,2,1,10,4,6,11
P'thinaikos,9842,3,1,1,4,4,10,-6,4
Panionios,9842,3,1,1,4,4,10,-6,4
AEK Athens,9843,1,4,2,0,7,1,6,14
PAOK Salonik,9843,2,2,2,2,10,6,4,8
P'thinaikos,9843,3,2,1,3,6,10,-4,7
Panionios,9843,4,1,1,4,4,10,-6,4
AEK Athens,9844,1,4,2,0,7,1,6,14
PAOK Salonik,9844,2,2,3,1,9,4,5,9
P'thinaikos,9844,3,1,2,3,4,9,-5,5
Panionios,9844,4,1,1,4,4,10,-6,4
AEK Athens,9845,1,4,2,0,7,1,6,14
PAOK Salonik,9845,2,2,2,2,9,5,4,8
P'thinaikos,9845,3,2,1,3,5,9,-4,7
Panionios,9845,4,1,1,4,4,10,-6,4
AEK Athens,9846,1,4,2,0,7,1,6,14
PAOK Salonik,9846,2,2,3,1,12,7,5,9
P'thinaikos,9846,3,1,2,3,7,12,-5,5
Panionios,9846,4,1,1,4,4,10,-6,4
AEK Athens,9847,1,4,2,0,7,1,6,14
PAOK Salonik,9847,2,2,2,2,9,5,4,8
P'thinaikos,9847,3,2,1,3,5,9,-4,7
Panionios,9847,4,1,1,4,4,10,-6,4
AEK Athens,9848,1,4,2,0,7,1,6,14
PAOK Salonik,9848,2,3,2,1,10,4,6,11
P'thinaikos,9848,3,1,1,4,4,10,-6,4
Panionios,9848,3,1,1,4,4,10,-6,4
AEK Athens,9849,1,4,2,0,7,1,6,14
PAOK Salonik,9849,2,3,2,1,10,4,6,11
P'thinaikos,9849,3,1,1,4,4,10,-6,4
Panionios,9849,3,1,1,4,4,10,-6,4
AEK Athens,9850,1,4,2,0,7,1,6,14
PAOK Salonik,9850,2,3,2,1,12,4,8,11
Panionios,9850,3,1,1,4,4,10,-6,4
P'thinaikos,9850,4,1,1,4,4,12,-8,4
AEK Athens,9851,1,4,2,0,7,1,6,14
PAOK Salonik,9851,2,3,2,1,12,5,7,11
Panionios,9851,3,1,1,4,4,10,-6,4
P'thinaikos,9851,4,1,1,4,5,12,-7,4
AEK Athens,9852,1,4,2,0,7,1,6,14
PAOK Salonik,9852,2,3,2,1,11,5,6,11
P'thinaikos,9852,3,1,1,4,5,11,-6,4
Panionios,9852,4,1,1,4,4,10,-6,4
AEK Athens,9853,1,4,2,0,7,1,6,14
PAOK Salonik,9853,2,2,3,1,11,6,5,9
P'thinaikos,9853,3,1,2,3,6,11,-5,5
Panionios,9853,4,1,1,4,4,10,-6,4
AEK Athens,9854,1,4,2,0,7,1,6,14
PAOK Salonik,9854,2,2,3,1,10,5,5,9
P'thinaikos,9854,3,1,2,3,5,10,-5,5
Panionios,9854,4,1,1,4,4,10,-6,4
AEK Athens,9855,1,4,2,0,7,1,6,14
PAOK Salonik,9855,2,3,2,1,11,4,7,11
Panionios,9855,3,1,1,4,4,10,-6,4
P'thinaikos,9855,4,1,1,4,4,11,-7,4
AEK Athens,9856,1,4,2,0,7,1,6,14
PAOK Salonik,9856,2,3,2,1,11,5,6,11
P'thinaikos,9856,3,1,1,4,5,11,-6,4
Panionios,9856,4,1,1,4,4,10,-6,4
AEK Athens,9857,1,4,2,0,7,1,6,14
PAOK Salonik,9857,2,2,2,2,9,7,2,8
P'thinaikos,9857,3,2,1,3,7,9,-2,7
Panionios,9857,4,1,1,4,4,10,-6,4
AEK Athens,9858,1,4,2,0,7,1,6,14
PAOK Salonik,9858,2,3,2,1,10,4,6,11
P'thinaikos,9858,3,1,1,4,4,10,-6,4
Panionios,9858,3,1,1,4,4,10,-6,4
AEK Athens,9859,1,4,2,0,7,1,6,14
PAOK Salonik,9859,2,3,2,1,12,4,8,11
Panionios,9859,3,1,1,4,4,10,-6,4
P'thinaikos,9859,4,1,1,4,4,12,-8,4
AEK Athens,9860,1,4,2,0,7,1,6,14
PAOK Salonik,9860,2,2,2,2,9,6,3,8
P'thinaikos,9860,3,2,1,3,6,9,-3,7
Panionios,9860,4,1,1,4,4,10,-6,4
AEK Athens,9861,1,4,2,0,7,1,6,14
PAOK Salonik,9861,2,2,2,2,9,5,4,8
P'thinaikos,9861,3,2,1,3,5,9,-4,7
Panionios,9861,4,1,1,4,4,10,-6,4
AEK Athens,9862,1,4,2,0,7,1,6,14
PAOK Salonik,9862,2,3,2,1,12,5,7,11
Panionios,9862,3,1,1,4,4,10,-6,4
P'thinaikos,9862,4,1,1,4,5,12,-7,4
AEK Athens,9863,1,4,2,0,7,1,6,14
PAOK Salonik,9863,2,2,3,1,10,5,5,9
P'thinaikos,9863,3,1,2,3,5,10,-5,5
Panionios,9863,4,1,1,4,4,10,-6,4
AEK Athens,9864,1,4,2,0,7,1,6,14
PAOK Salonik,9864,2,3,2,1,11,5,6,11
P'thinaikos,9864,3,1,1,4,5,11,-6,4
Panionios,9864,4,1,1,4,4,10,-6,4
AEK Athens,9865,1,4,2,0,7,1,6,14
PAOK Salonik,9865,2,2,3,1,9,4,5,9
P'thinaikos,9865,3,1,2,3,4,9,-5,5
Panionios,9865,4,1,1,4,4,10,-6,4
AEK Athens,9866,1,4,2,0,7,1,6,14
PAOK Salonik,9866,2,2,2,2,9,8,1,8
P'thinaikos,9866,3,2,1,3,8,9,-1,7
Panionios,9866,4,1,1,4,4,10,-6,4
AEK Athens,9867,1,4,2,0,7,1,6,14
PAOK Salonik,9867,2,3,2,1,12,4,8,11
Panionios,9867,3,1,1,4,4,10,-6,4
P'thinaikos,9867,4,1,1,4,4,12,-8,4
AEK Athens,9868,1,4,2,0,7,1,6,14
PAOK Salonik,9868,2,2,2,2,10,6,4,8
P'thinaikos,9868,3,2,1,3,6,10,-4,7
Panionios,9868,4,1,1,4,4,10,-6,4
AEK Athens,9869,1,4,2,0,7,1,6,14
PAOK Salonik,9869,2,3,2,1,10,4,6,11
P'thinaikos,9869,3,1,1,4,4,10,-6,4
Panionios,9869,3,1,1,4,4,10,-6,4
AEK Athens,9870,1,4,2,0,7,1,6,14
PAOK Salonik,9870,2,3,2,1,11,5,6,11
P'thinaikos,9870,3,1,1,4,5,11,-6,4
Panionios,9870,4,1,1,4,4,10,-6,4
AEK Athens,9871,1,4,2,0,7,1,6,14
PAOK Salonik,9871,2,2,3,1,10,5,5,9
P'thinaikos,9871,3,1,2,3,5,10,-5,5
Panionios,9871,4,1,1,4,4,10,-6,4
AEK Athens,9872,1,4,2,0,7,1,6,14
PAOK Salonik,9872,2,2,2,2,9,6,3,8
P'thinaikos,9872,3,2,1,3,6,9,-3,7
Panionios,9872,4,1,1,4,4,10,-6,4
AEK Athens,9873,1,4,2,0,7,1,6,14
PAOK Salonik,9873,2,2,2,2,9,6,3,8
P'thinaikos,9873,3,2,1,3,6,9,-3,7
Panionios,9873,4,1,1,4,4,10,-6,4
AEK Athens,9874,1,4,2,0,7,1,6,14
PAOK Salonik,9874,2,2,2,2,9,7,2,8
P'thinaikos,9874,3,2,1,3,7,9,-2,7
Panionios,9874,4,1,1,4,4,10,-6,4
AEK Athens,9875,1,4,2,0,7,1,6,14
PAOK Salonik,9875,2,3,2,1,11,5,6,11
P'thinaikos,9875,3,1,1,4,5,11,-6,4
Panionios,9875,4,1,1,4,4,10,-6,4
AEK Athens,9876,1,4,2,0,7,1,6,14
PAOK Salonik,9876,2,3,2,1,10,4,6,11
P'thinaikos,9876,3,1,1,4,4,10,-6,4
Panionios,9876,3,1,1,4,4,10,-6,4
AEK Athens,9877,1,4,2,0,7,1,6,14
PAOK Salonik,9877,2,2,2,2,9,5,4,8
P'thinaikos,9877,3,2,1,3,5,9,-4,7
Panionios,9877,4,1,1,4,4,10,-6,4
AEK Athens,9878,1,4,2,0,7,1,6,14
PAOK Salonik,9878,2,2,3,1,10,5,5,9
P'thinaikos,9878,3,1,2,3,5,10,-5,5
Panionios,9878,4,1,1,4,4,10,-6,4
AEK Athens,9879,1,4,2,0,7,1,6,14
PAOK Salonik,9879,2,3,2,1,12,5,7,11
Panionios,9879,3,1,1,4,4,10,-6,4
P'thinaikos,9879,4,1,1,4,5,12,-7,4
AEK Athens,9880,1,4,2,0,7,1,6,14
PAOK Salonik,9880,2,3,2,1,12,6,6,11
P'thinaikos,9880,3,1,1,4,6,12,-6,4
Panionios,9880,4,1,1,4,4,10,-6,4
AEK Athens,9881,1,4,2,0,7,1,6,14
PAOK Salonik,9881,2,3,2,1,10,4,6,11
P'thinaikos,9881,3,1,1,4,4,10,-6,4
Panionios,9881,3,1,1,4,4,10,-6,4
AEK Athens,9882,1,4,2,0,7,1,6,14
PAOK Salonik,9882,2,2,2,2,9,5,4,8
P'thinaikos,9882,3,2,1,3,5,9,-4,7
Panionios,9882,4,1,1,4,4,10,-6,4
AEK Athens,9883,1,4,2,0,7,1,6,14
PAOK Salonik,9883,2,2,2,2,9,5,4,8
P'thinaikos,9883,3,2,1,3,5,9,-4,7
Panionios,9883,4,1,1,4,4,10,-6,4
AEK Athens,9884,1,4,2,0,7,1,6,14
PAOK Salonik,9884,2,3,2,1,11,5,6,11
P'thinaikos,9884,3,1,1,4,5,11,-6,4
Panionios,9884,4,1,1,4,4,10,-6,4
AEK Athens,9885,1,4,2,0,7,1,6,14
PAOK Salonik,9885,2,3,2,1,11,4,7,11
Panionios,9885,3,1,1,4,4,10,-6,4
P'thinaikos,9885,4,1,1,4,4,11,-7,4
AEK Athens,9886,1,4,2,0,7,1,6,14
PAOK Salonik,9886,2,2,2,2,10,8,2,8
P'thinaikos,9886,3,2,1,3,8,10,-2,7
Panionios,9886,4,1,1,4,4,10,-6,4
AEK Athens,9887,1,4,2,0,7,1,6,14
PAOK Salonik,9887,2,2,3,1,10,5,5,9
P'thinaikos,9887,3,1,2,3,5,10,-5,5
Panionios,9887,4,1,1,4,4,10,-6,4
AEK Athens,9888,1,4,2,0,7,1,6,14
PAOK Salonik,9888,2,3,2,1,12,5,7,11
Panionios,9888,3,1,1,4,4,10,-6,4
P'thinaikos,9888,4,1,1,4,5,12,-7,4
AEK Athens,9889,1,4,2,0,7,1,6,14
PAOK Salonik,9889,2,2,2,2,9,6,3,8
P'thinaikos,9889,3,2,1,3,6,9,-3,7
Panionios,9889,4,1,1,4,4,10,-6,4
AEK Athens,9890,1,4,2,0,7,1,6,14
PAOK Salonik,9890,2,2,3,1,9,4,5,9
P'thinaikos,9890,3,1,2,3,4,9,-5,5
Panionios,9890,4,1,1,4,4,10,-6,4
AEK Athens,9891,1,4,2,0,7,1,6,14
PAOK Salonik,9891,2,2,3,1,10,5,5,9
P'thinaikos,9891,3,1,2,3,5,10,-5,5
Panionios,9891,4,1,1,4,4,10,-6,4
AEK Athens,9892,1,4,2,0,7,1,6,14
PAOK Salonik,9892,2,3,2,1,12,4,8,11
Panionios,9892,3,1,1,4,4,10,-6,4
P'thinaikos,9892,4,1,1,4,4,12,-8,4
AEK Athens,9893,1,4,2,0,7,1,6,14
PAOK Salonik,9893,2,2,2,2,9,5,4,8
P'thinaikos,9893,3,2,1,3,5,9,-4,7
Panionios,9893,4,1,1,4,4,10,-6,4
AEK Athens,9894,1,4,2,0,7,1,6,14
PAOK Salonik,9894,2,2,3,1,11,6,5,9
P'thinaikos,9894,3,1,2,3,6,11,-5,5
Panionios,9894,4,1,1,4,4,10,-6,4
AEK Athens,9895,1,4,2,0,7,1,6,14
PAOK Salonik,9895,2,3,2,1,11,5,6,11
P'thinaikos,9895,3,1,1,4,5,11,-6,4
Panionios,9895,4,1,1,4,4,10,-6,4
AEK Athens,9896,1,4,2,0,7,1,6,14
PAOK Salonik,9896,2,2,2,2,10,7,3,8
P'thinaikos,9896,3,2,1,3,7,10,-3,7
Panionios,9896,4,1,1,4,4,10,-6,4
AEK Athens,9897,1,4,2,0,7,1,6,14
PAOK Salonik,9897,2,3,2,1,11,5,6,11
P'thinaikos,9897,3,1,1,4,5,11,-6,4
Panionios,9897,4,1,1,4,4,10,-6,4
AEK Athens,9898,1,4,2,0,7,1,6,14
PAOK Salonik,9898,2,2,2,2,10,7,3,8
P'thinaikos,9898,3,2,1,3,7,10,-3,7
Panionios,9898,4,1,1,4,4,10,-6,4
AEK Athens,9899,1,4,2,0,7,1,6,14
PAOK Salonik,9899,2,2,3,1,9,4,5,9
P'thinaikos,9899,3,1,2,3,4,9,-5,5
Panionios,9899,4,1,1,4,4,10,-6,4
AEK Athens,9900,1,4,2,0,7,1,6,14
PAOK Salonik,9900,2,3,2,1,10,4,6,11
P'thinaikos,9900,3,1,1,4,4,10,-6,4
Panionios,9900,3,1,1,4,4,10,-6,4
AEK Athens,9901,1,4,2,0,7,1,6,14
PAOK Salonik,9901,2,2,2,2,9,6,3,8
P'thinaikos,9901,3,2,1,3,6,9,-3,7
Panionios,9901,4,1,1,4,4,10,-6,4
AEK Athens,9902,1,4,2,0,7,1,6,14
PAOK Salonik,9902,2,2,2,2,9,6,3,8
P'thinaikos,9902,3,2,1,3,6,9,-3,7
Panionios,9902,4,1,1,4,4,10,-6,4
AEK Athens,9903,1,4,2,0,7,1,6,14
PAOK Salonik,9903,2,2,2,2,9,5,4,8
P'thinaikos,9903,3,2,1,3,5,9,-4,7
Panionios,9903,4,1,1,4,4,10,-6,4
AEK Athens,9904,1,4,2,0,7,1,6,14
PAOK Salonik,9904,2,3,2,1,10,4,6,11
P'thinaikos,9904,3,1,1,4,4,10,-6,4
Panionios,9904,3,1,1,4,4,10,-6,4
AEK Athens,9905,1,4,2,0,7,1,6,14
PAOK Salonik,9905,2,2,3,1,10,5,5,9
P'thinaikos,9905,3,1,2,3,5,10,-5,5
Panionios,9905,4,1,1,4,4,10,-6,4
AEK Athens,9906,1,4,2,0,7,1,6,14
PAOK Salonik,9906,2,3,2,1,11,5,6,11
P'thinaikos,9906,3,1,1,4,5,11,-6,4
Panionios,9906,4,1,1,4,4,10,-6,4
AEK Athens,9907,1,4,2,0,7,1,6,14
PAOK Salonik,9907,2,2,2,2,9,5,4,8
P'thinaikos,9907,3,2,1,3,5,9,-4,7
Panionios,9907,4,1,1,4,4,10,-6,4
AEK Athens,9908,1,4,2,0,7,1,6,14
PAOK Salonik,9908,2,3,2,1,13,6,7,11
Panionios,9908,3,1,1,4,4,10,-6,4
P'thinaikos,9908,4,1,1,4,6,13,-7,4
AEK Athens,9909,1,4,2,0,7,1,6,14
PAOK Salonik,9909,2,2,2,2,10,6,4,8
P'thinaikos,9909,3,2,1,3,6,10,-4,7
Panionios,9909,4,1,1,4,4,10,-6,4
AEK Athens,9910,1,4,2,0,7,1,6,14
PAOK Salonik,9910,2,2,3,1,12,7,5,9
P'thinaikos,9910,3,1,2,3,7,12,-5,5
Panionios,9910,4,1,1,4,4,10,-6,4
AEK Athens,9911,1,4,2,0,7,1,6,14
PAOK Salonik,9911,2,3,2,1,11,5,6,11
P'thinaikos,9911,3,1,1,4,5,11,-6,4
Panionios,9911,4,1,1,4,4,10,-6,4
AEK Athens,9912,1,4,2,0,7,1,6,14
PAOK Salonik,9912,2,3,2,1,11,5,6,11
P'thinaikos,9912,3,1,1,4,5,11,-6,4
Panionios,9912,4,1,1,4,4,10,-6,4
AEK Athens,9913,1,4,2,0,7,1,6,14
PAOK Salonik,9913,2,2,3,1,10,5,5,9
P'thinaikos,9913,3,1,2,3,5,10,-5,5
Panionios,9913,4,1,1,4,4,10,-6,4
AEK Athens,9914,1,4,2,0,7,1,6,14
PAOK Salonik,9914,2,2,2,2,10,7,3,8
P'thinaikos,9914,3,2,1,3,7,10,-3,7
Panionios,9914,4,1,1,4,4,10,-6,4
AEK Athens,9915,1,4,2,0,7,1,6,14
PAOK Salonik,9915,2,2,2,2,11,7,4,8
P'thinaikos,9915,3,2,1,3,7,11,-4,7
Panionios,9915,4,1,1,4,4,10,-6,4
AEK Athens,9916,1,4,2,0,7,1,6,14
PAOK Salonik,9916,2,2,3,1,9,4,5,9
P'thinaikos,9916,3,1,2,3,4,9,-5,5
Panionios,9916,4,1,1,4,4,10,-6,4
AEK Athens,9917,1,4,2,0,7,1,6,14
PAOK Salonik,9917,2,2,2,2,9,5,4,8
P'thinaikos,9917,3,2,1,3,5,9,-4,7
Panionios,9917,4,1,1,4,4,10,-6,4
AEK Athens,9918,1,4,2,0,7,1,6,14
PAOK Salonik,9918,2,2,2,2,10,6,4,8
P'thinaikos,9918,3,2,1,3,6,10,-4,7
Panionios,9918,4,1,1,4,4,10,-6,4
AEK Athens,9919,1,4,2,0,7,1,6,14
PAOK Salonik,9919,2,2,2,2,9,5,4,8
P'thinaikos,9919,3,2,1,3,5,9,-4,7
Panionios,9919,4,1,1,4,4,10,-6,4
AEK Athens,9920,1,4,2,0,7,1,6,14
PAOK Salonik,9920,2,2,2,2,9,6,3,8
P'thinaikos,9920,3,2,1,3,6,9,-3,7
Panionios,9920,4,1,1,4,4,10,-6,4
AEK Athens,9921,1,4,2,0,7,1,6,14
PAOK Salonik,9921,2,2,2,2,9,6,3,8
P'thinaikos,9921,3,2,1,3,6,9,-3,7
Panionios,9921,4,1,1,4,4,10,-6,4
AEK Athens,9922,1,4,2,0,7,1,6,14
PAOK Salonik,9922,2,3,2,1,13,5,8,11
Panionios,9922,3,1,1,4,4,10,-6,4
P'thinaikos,9922,4,1,1,4,5,13,-8,4
AEK Athens,9923,1,4,2,0,7,1,6,14
PAOK Salonik,9923,2,3,2,1,10,4,6,11
P'thinaikos,9923,3,1,1,4,4,10,-6,4
Panionios,9923,3,1,1,4,4,10,-6,4
AEK Athens,9924,1,4,2,0,7,1,6,14
PAOK Salonik,9924,2,3,2,1,11,5,6,11
P'thinaikos,9924,3,1,1,4,5,11,-6,4
Panionios,9924,4,1,1,4,4,10,-6,4
AEK Athens,9925,1,4,2,0,7,1,6,14
PAOK Salonik,9925,2,3,2,1,11,5,6,11
P'thinaikos,9925,3,1,1,4,5,11,-6,4
Panionios,9925,4,1,1,4,4,10,-6,4
AEK Athens,9926,1,4,2,0,7,1,6,14
PAOK Salonik,9926,2,2,3,1,10,5,5,9
P'thinaikos,9926,3,1,2,3,5,10,-5,5
Panionios,9926,4,1,1,4,4,10,-6,4
AEK Athens,9927,1,4,2,0,7,1,6,14
PAOK Salonik,9927,2,2,2,2,9,5,4,8
P'thinaikos,9927,3,2,1,3,5,9,-4,7
Panionios,9927,4,1,1,4,4,10,-6,4
AEK Athens,9928,1,4,2,0,7,1,6,14
PAOK Salonik,9928,2,3,2,1,12,6,6,11
P'thinaikos,9928,3,1,1,4,6,12,-6,4
Panionios,9928,4,1,1,4,4,10,-6,4
AEK Athens,9929,1,4,2,0,7,1,6,14
PAOK Salonik,9929,2,2,3,1,10,5,5,9
P'thinaikos,9929,3,1,2,3,5,10,-5,5
Panionios,9929,4,1,1,4,4,10,-6,4
AEK Athens,9930,1,4,2,0,7,1,6,14
PAOK Salonik,9930,2,3,2,1,11,4,7,11
Panionios,9930,3,1,1,4,4,10,-6,4
P'thinaikos,9930,4,1,1,4,4,11,-7,4
AEK Athens,9931,1,4,2,0,7,1,6,14
PAOK Salonik,9931,2,2,3,1,10,5,5,9
P'thinaikos,9931,3,1,2,3,5,10,-5,5
Panionios,9931,4,1,1,4,4,10,-6,4
AEK Athens,9932,1,4,2,0,7,1,6,14
PAOK Salonik,9932,2,2,2,2,11,8,3,8
P'thinaikos,9932,3,2,1,3,8,11,-3,7
Panionios,9932,4,1,1,4,4,10,-6,4
AEK Athens,9933,1,4,2,0,7,1,6,14
PAOK Salonik,9933,2,2,3,1,10,5,5,9
P'thinaikos,9933,3,1,2,3,5,10,-5,5
Panionios,9933,4,1,1,4,4,10,-6,4
AEK Athens,9934,1,4,2,0,7,1,6,14
PAOK Salonik,9934,2,2,3,1,9,4,5,9
P'thinaikos,9934,3,1,2,3,4,9,-5,5
Panionios,9934,4,1,1,4,4,10,-6,4
AEK Athens,9935,1,4,2,0,7,1,6,14
PAOK Salonik,9935,2,2,3,1,10,5,5,9
P'thinaikos,9935,3,1,2,3,5,10,-5,5
Panionios,9935,4,1,1,4,4,10,-6,4
AEK Athens,9936,1,4,2,0,7,1,6,14
PAOK Salonik,9936,2,3,2,1,11,4,7,11
Panionios,9936,3,1,1,4,4,10,-6,4
P'thinaikos,9936,4,1,1,4,4,11,-7,4
AEK Athens,9937,1,4,2,0,7,1,6,14
PAOK Salonik,9937,2,2,2,2,10,8,2,8
P'thinaikos,9937,3,2,1,3,8,10,-2,7
Panionios,9937,4,1,1,4,4,10,-6,4
AEK Athens,9938,1,4,2,0,7,1,6,14
PAOK Salonik,9938,2,2,2,2,10,7,3,8
P'thinaikos,9938,3,2,1,3,7,10,-3,7
Panionios,9938,4,1,1,4,4,10,-6,4
AEK Athens,9939,1,4,2,0,7,1,6,14
PAOK Salonik,9939,2,2,3,1,11,6,5,9
P'thinaikos,9939,3,1,2,3,6,11,-5,5
Panionios,9939,4,1,1,4,4,10,-6,4
AEK Athens,9940,1,4,2,0,7,1,6,14
PAOK Salonik,9940,2,3,2,1,10,4,6,11
P'thinaikos,9940,3,1,1,4,4,10,-6,4
Panionios,9940,3,1,1,4,4,10,-6,4
AEK Athens,9941,1,4,2,0,7,1,6,14
PAOK Salonik,9941,2,3,2,1,10,4,6,11
P'thinaikos,9941,3,1,1,4,4,10,-6,4
Panionios,9941,3,1,1,4,4,10,-6,4
AEK Athens,9942,1,4,2,0,7,1,6,14
PAOK Salonik,9942,2,3,2,1,10,4,6,11
P'thinaikos,9942,3,1,1,4,4,10,-6,4
Panionios,9942,3,1,1,4,4,10,-6,4
AEK Athens,9943,1,4,2,0,7,1,6,14
PAOK Salonik,9943,2,3,2,1,11,4,7,11
Panionios,9943,3,1,1,4,4,10,-6,4
P'thinaikos,9943,4,1,1,4,4,11,-7,4
AEK Athens,9944,1,4,2,0,7,1,6,14
PAOK Salonik,9944,2,2,2,2,9,6,3,8
P'thinaikos,9944,3,2,1,3,6,9,-3,7
Panionios,9944,4,1,1,4,4,10,-6,4
AEK Athens,9945,1,4,2,0,7,1,6,14
PAOK Salonik,9945,2,2,3,1,9,4,5,9
P'thinaikos,9945,3,1,2,3,4,9,-5,5
Panionios,9945,4,1,1,4,4,10,-6,4
AEK Athens,9946,1,4,2,0,7,1,6,14
PAOK Salonik,9946,2,2,2,2,10,7,3,8
P'thinaikos,9946,3,2,1,3,7,10,-3,7
Panionios,9946,4,1,1,4,4,10,-6,4
AEK Athens,9947,1,4,2,0,7,1,6,14
PAOK Salonik,9947,2,2,3,1,11,6,5,9
P'thinaikos,9947,3,1,2,3,6,11,-5,5
Panionios,9947,4,1,1,4,4,10,-6,4
AEK Athens,9948,1,4,2,0,7,1,6,14
PAOK Salonik,9948,2,2,3,1,11,6,5,9
P'thinaikos,9948,3,1,2,3,6,11,-5,5
Panionios,9948,4,1,1,4,4,10,-6,4
AEK Athens,9949,1,4,2,0,7,1,6,14
PAOK Salonik,9949,2,2,2,2,10,6,4,8
P'thinaikos,9949,3,2,1,3,6,10,-4,7
Panionios,9949,4,1,1,4,4,10,-6,4
AEK Athens,9950,1,4,2,0,7,1,6,14
PAOK Salonik,9950,2,2,3,1,10,5,5,9
P'thinaikos,9950,3,1,2,3,5,10,-5,5
Panionios,9950,4,1,1,4,4,10,-6,4
AEK Athens,9951,1,4,2,0,7,1,6,14
PAOK Salonik,9951,2,2,3,1,10,5,5,9
P'thinaikos,9951,3,1,2,3,5,10,-5,5
Panionios,9951,4,1,1,4,4,10,-6,4
AEK Athens,9952,1,4,2,0,7,1,6,14
PAOK Salonik,9952,2,2,3,1,11,6,5,9
P'thinaikos,9952,3,1,2,3,6,11,-5,5
Panionios,9952,4,1,1,4,4,10,-6,4
AEK Athens,9953,1,4,2,0,7,1,6,14
PAOK Salonik,9953,2,2,3,1,11,6,5,9
P'thinaikos,9953,3,1,2,3,6,11,-5,5
Panionios,9953,4,1,1,4,4,10,-6,4
AEK Athens,9954,1,4,2,0,7,1,6,14
PAOK Salonik,9954,2,3,2,1,12,5,7,11
Panionios,9954,3,1,1,4,4,10,-6,4
P'thinaikos,9954,4,1,1,4,5,12,-7,4
AEK Athens,9955,1,4,2,0,7,1,6,14
PAOK Salonik,9955,2,2,3,1,10,5,5,9
P'thinaikos,9955,3,1,2,3,5,10,-5,5
Panionios,9955,4,1,1,4,4,10,-6,4
AEK Athens,9956,1,4,2,0,7,1,6,14
PAOK Salonik,9956,2,3,2,1,14,4,10,11
Panionios,9956,3,1,1,4,4,10,-6,4
P'thinaikos,9956,4,1,1,4,4,14,-10,4
AEK Athens,9957,1,4,2,0,7,1,6,14
PAOK Salonik,9957,2,2,2,2,10,6,4,8
P'thinaikos,9957,3,2,1,3,6,10,-4,7
Panionios,9957,4,1,1,4,4,10,-6,4
AEK Athens,9958,1,4,2,0,7,1,6,14
PAOK Salonik,9958,2,3,2,1,10,4,6,11
P'thinaikos,9958,3,1,1,4,4,10,-6,4
Panionios,9958,3,1,1,4,4,10,-6,4
AEK Athens,9959,1,4,2,0,7,1,6,14
PAOK Salonik,9959,2,3,2,1,11,4,7,11
Panionios,9959,3,1,1,4,4,10,-6,4
P'thinaikos,9959,4,1,1,4,4,11,-7,4
AEK Athens,9960,1,4,2,0,7,1,6,14
PAOK Salonik,9960,2,2,2,2,9,6,3,8
P'thinaikos,9960,3,2,1,3,6,9,-3,7
Panionios,9960,4,1,1,4,4,10,-6,4
AEK Athens,9961,1,4,2,0,7,1,6,14
PAOK Salonik,9961,2,2,3,1,10,5,5,9
P'thinaikos,9961,3,1,2,3,5,10,-5,5
Panionios,9961,4,1,1,4,4,10,-6,4
AEK Athens,9962,1,4,2,0,7,1,6,14
PAOK Salonik,9962,2,3,2,1,10,4,6,11
P'thinaikos,9962,3,1,1,4,4,10,-6,4
Panionios,9962,3,1,1,4,4,10,-6,4
AEK Athens,9963,1,4,2,0,7,1,6,14
PAOK Salonik,9963,2,3,2,1,11,4,7,11
Panionios,9963,3,1,1,4,4,10,-6,4
P'thinaikos,9963,4,1,1,4,4,11,-7,4
AEK Athens,9964,1,4,2,0,7,1,6,14
PAOK Salonik,9964,2,3,2,1,11,4,7,11
Panionios,9964,3,1,1,4,4,10,-6,4
P'thinaikos,9964,4,1,1,4,4,11,-7,4
AEK Athens,9965,1,4,2,0,7,1,6,14
PAOK Salonik,9965,2,3,2,1,11,4,7,11
Panionios,9965,3,1,1,4,4,10,-6,4
P'thinaikos,9965,4,1,1,4,4,11,-7,4
AEK Athens,9966,1,4,2,0,7,1,6,14
PAOK Salonik,9966,2,2,2,2,9,6,3,8
P'thinaikos,9966,3,2,1,3,6,9,-3,7
Panionios,9966,4,1,1,4,4,10,-6,4
AEK Athens,9967,1,4,2,0,7,1,6,14
PAOK Salonik,9967,2,2,3,1,9,4,5,9
P'thinaikos,9967,3,1,2,3,4,9,-5,5
Panionios,9967,4,1,1,4,4,10,-6,4
AEK Athens,9968,1,4,2,0,7,1,6,14
PAOK Salonik,9968,2,2,2,2,9,7,2,8
P'thinaikos,9968,3,2,1,3,7,9,-2,7
Panionios,9968,4,1,1,4,4,10,-6,4
AEK Athens,9969,1,4,2,0,7,1,6,14
PAOK Salonik,9969,2,2,2,2,9,5,4,8
P'thinaikos,9969,3,2,1,3,5,9,-4,7
Panionios,9969,4,1,1,4,4,10,-6,4
AEK Athens,9970,1,4,2,0,7,1,6,14
PAOK Salonik,9970,2,3,2,1,10,4,6,11
P'thinaikos,9970,3,1,1,4,4,10,-6,4
Panionios,9970,3,1,1,4,4,10,-6,4
AEK Athens,9971,1,4,2,0,7,1,6,14
PAOK Salonik,9971,2,2,3,1,10,5,5,9
P'thinaikos,9971,3,1,2,3,5,10,-5,5
Panionios,9971,4,1,1,4,4,10,-6,4
AEK Athens,9972,1,4,2,0,7,1,6,14
PAOK Salonik,9972,2,2,2,2,9,5,4,8
P'thinaikos,9972,3,2,1,3,5,9,-4,7
Panionios,9972,4,1,1,4,4,10,-6,4
AEK Athens,9973,1,4,2,0,7,1,6,14
PAOK Salonik,9973,2,2,2,2,9,5,4,8
P'thinaikos,9973,3,2,1,3,5,9,-4,7
Panionios,9973,4,1,1,4,4,10,-6,4
AEK Athens,9974,1,4,2,0,7,1,6,14
PAOK Salonik,9974,2,2,3,1,9,4,5,9
P'thinaikos,9974,3,1,2,3,4,9,-5,5
Panionios,9974,4,1,1,4,4,10,-6,4
AEK Athens,9975,1,4,2,0,7,1,6,14
PAOK Salonik,9975,2,2,3,1,10,5,5,9
P'thinaikos,9975,3,1,2,3,5,10,-5,5
Panionios,9975,4,1,1,4,4,10,-6,4
AEK Athens,9976,1,4,2,0,7,1,6,14
PAOK Salonik,9976,2,3,2,1,12,5,7,11
Panionios,9976,3,1,1,4,4,10,-6,4
P'thinaikos,9976,4,1,1,4,5,12,-7,4
AEK Athens,9977,1,4,2,0,7,1,6,14
PAOK Salonik,9977,2,2,2,2,9,6,3,8
P'thinaikos,9977,3,2,1,3,6,9,-3,7
Panionios,9977,4,1,1,4,4,10,-6,4
AEK Athens,9978,1,4,2,0,7,1,6,14
PAOK Salonik,9978,2,2,2,2,10,6,4,8
P'thinaikos,9978,3,2,1,3,6,10,-4,7
Panionios,9978,4,1,1,4,4,10,-6,4
AEK Athens,9979,1,4,2,0,7,1,6,14
PAOK Salonik,9979,2,2,2,2,9,5,4,8
P'thinaikos,9979,3,2,1,3,5,9,-4,7
Panionios,9979,4,1,1,4,4,10,-6,4
AEK Athens,9980,1,4,2,0,7,1,6,14
PAOK Salonik,9980,2,2,3,1,10,5,5,9
P'thinaikos,9980,3,1,2,3,5,10,-5,5
Panionios,9980,4,1,1,4,4,10,-6,4
AEK Athens,9981,1,4,2,0,7,1,6,14
PAOK Salonik,9981,2,3,2,1,10,4,6,11
P'thinaikos,9981,3,1,1,4,4,10,-6,4
Panionios,9981,3,1,1,4,4,10,-6,4
AEK Athens,9982,1,4,2,0,7,1,6,14
PAOK Salonik,9982,2,3,2,1,11,4,7,11
Panionios,9982,3,1,1,4,4,10,-6,4
P'thinaikos,9982,4,1,1,4,4,11,-7,4
AEK Athens,9983,1,4,2,0,7,1,6,14
PAOK Salonik,9983,2,2,3,1,10,5,5,9
P'thinaikos,9983,3,1,2,3,5,10,-5,5
Panionios,9983,4,1,1,4,4,10,-6,4
AEK Athens,9984,1,4,2,0,7,1,6,14
PAOK Salonik,9984,2,2,3,1,9,4,5,9
P'thinaikos,9984,3,1,2,3,4,9,-5,5
Panionios,9984,4,1,1,4,4,10,-6,4
AEK Athens,9985,1,4,2,0,7,1,6,14
PAOK Salonik,9985,2,3,2,1,11,4,7,11
Panionios,9985,3,1,1,4,4,10,-6,4
P'thinaikos,9985,4,1,1,4,4,11,-7,4
AEK Athens,9986,1,4,2,0,7,1,6,14
PAOK Salonik,9986,2,3,2,1,11,5,6,11
P'thinaikos,9986,3,1,1,4,5,11,-6,4
Panionios,9986,4,1,1,4,4,10,-6,4
AEK Athens,9987,1,4,2,0,7,1,6,14
PAOK Salonik,9987,2,2,2,2,9,7,2,8
P'thinaikos,9987,3,2,1,3,7,9,-2,7
Panionios,9987,4,1,1,4,4,10,-6,4
AEK Athens,9988,1,4,2,0,7,1,6,14
PAOK Salonik,9988,2,3,2,1,12,4,8,11
Panionios,9988,3,1,1,4,4,10,-6,4
P'thinaikos,9988,4,1,1,4,4,12,-8,4
AEK Athens,9989,1,4,2,0,7,1,6,14
PAOK Salonik,9989,2,2,3,1,10,5,5,9
P'thinaikos,9989,3,1,2,3,5,10,-5,5
Panionios,9989,4,1,1,4,4,10,-6,4
AEK Athens,9990,1,4,2,0,7,1,6,14
PAOK Salonik,9990,2,3,2,1,11,5,6,11
P'thinaikos,9990,3,1,1,4,5,11,-6,4
Panionios,9990,4,1,1,4,4,10,-6,4
AEK Athens,9991,1,4,2,0,7,1,6,14
PAOK Salonik,9991,2,2,2,2,9,5,4,8
P'thinaikos,9991,3,2,1,3,5,9,-4,7
Panionios,9991,4,1,1,4,4,10,-6,4
AEK Athens,9992,1,4,2,0,7,1,6,14
PAOK Salonik,9992,2,3,2,1,11,5,6,11
P'thinaikos,9992,3,1,1,4,5,11,-6,4
Panionios,9992,4,1,1,4,4,10,-6,4
AEK Athens,9993,1,4,2,0,7,1,6,14
PAOK Salonik,9993,2,2,2,2,11,7,4,8
P'thinaikos,9993,3,2,1,3,7,11,-4,7
Panionios,9993,4,1,1,4,4,10,-6,4
AEK Athens,9994,1,4,2,0,7,1,6,14
PAOK Salonik,9994,2,3,2,1,10,4,6,11
P'thinaikos,9994,3,1,1,4,4,10,-6,4
Panionios,9994,3,1,1,4,4,10,-6,4
AEK Athens,9995,1,4,2,0,7,1,6,14
PAOK Salonik,9995,2,2,2,2,11,9,2,8
P'thinaikos,9995,3,2,1,3,9,11,-2,7
Panionios,9995,4,1,1,4,4,10,-6,4
AEK Athens,9996,1,4,2,0,7,1,6,14
PAOK Salonik,9996,2,3,2,1,10,4,6,11
P'thinaikos,9996,3,1,1,4,4,10,-6,4
Panionios,9996,3,1,1,4,4,10,-6,4
AEK Athens,9997,1,4,2,0,7,1,6,14
PAOK Salonik,9997,2,3,2,1,12,5,7,11
Panionios,9997,3,1,1,4,4,10,-6,4
P'thinaikos,9997,4,1,1,4,5,12,-7,4
AEK Athens,9998,1,4,2,0,7,1,6,14
PAOK Salonik,9998,2,2,2,2,9,5,4,8
P'thinaikos,9998,3,2,1,3,5,9,-4,7
Panionios,9998,4,1,1,4,4,10,-6,4
AEK Athens,9999,1,4,2,0,7,1,6,14
PAOK Salonik,9999,2,3,2,1,10,4,6,11
P'thinaikos,9999,3,1,1,4,4,10,-6,4
Panionios,9999,3,1,1,4,4,10,-6,4
