team,n,rank,w,d,l,gf,ga,gd,pts
Crusaders,0,1,16,6,4,61,31,30,54
Coleraine,0,2,14,10,2,43,23,20,52
Glenavon,0,3,10,9,7,53,43,10,39
Linfield,0,4,11,5,10,39,36,3,38
Cliftonville,0,5,9,4,13,32,33,-1,31
Ballymena,0,6,8,4,14,26,47,-21,28
Glentoran,0,7,6,6,10,24,32,-8,24
Dungannon,0,8,2,4,16,14,47,-33,10
Crusaders,1,1,17,6,3,64,31,33,57
Coleraine,1,2,14,10,2,43,25,18,52
Glenavon,1,3,10,9,7,55,43,12,39
Linfield,1,4,11,5,10,38,36,2,38
Cliftonville,1,5,9,4,13,32,32,0,31
Ballymena,1,6,7,4,15,26,50,-24,25
Glentoran,1,7,6,6,10,24,32,-8,24
Dungannon,1,8,2,4,16,14,47,-33,10
Crusaders,2,1,17,6,3,65,31,34,57
Coleraine,2,2,14,10,2,43,23,20,52
Glenavon,2,3,10,9,7,53,43,10,39
Linfield,2,4,11,5,10,39,37,2,38
Cliftonville,2,5,9,4,13,33,33,0,31
Ballymena,2,6,7,4,15,26,51,-25,25
Glentoran,2,7,6,6,10,24,32,-8,24
Dungannon,2,8,2,4,16,14,47,-33,10
Crusaders,3,1,16,7,3,61,30,31,55
Coleraine,3,2,15,10,1,46,24,22,55
Glenavon,3,3,9,9,8,54,46,8,36
Linfield,3,4,10,5,11,40,40,0,35
Cliftonville,3,5,10,4,12,36,34,2,34
Ballymena,3,6,7,5,14,25,47,-22,26
Glentoran,3,7,6,6,10,24,32,-8,24
Dungannon,3,8,2,4,16,14,47,-33,10
Crusaders,4,1,16,6,4,63,33,30,54
Coleraine,4,2,14,10,2,43,28,15,52
Glenavon,4,3,10,9,7,58,43,15,39
Linfield,4,4,11,5,10,39,37,2,38
Cliftonville,4,5,9,4,13,33,33,0,31
Ballymena,4,6,8,4,14,28,49,-21,28
Glentoran,4,7,6,6,10,24,32,-8,24
Dungannon,4,8,2,4,16,14,47,-33,10
Coleraine,5,1,15,10,1,44,22,22,55
Crusaders,5,2,16,6,4,61,32,29,54
Glenavon,5,3,9,9,8,52,44,8,36
Linfield,5,4,10,5,11,38,38,0,35
Cliftonville,5,5,10,4,12,34,32,2,34
Ballymena,5,6,8,4,14,27,47,-20,28
Glentoran,5,7,6,6,10,24,32,-8,24
Dungannon,5,8,2,4,16,14,47,-33,10
Crusaders,6,1,17,6,3,64,30,34,57
Coleraine,6,2,14,10,2,44,25,19,52
Glenavon,6,3,10,9,7,55,44,11,39
Linfield,6,4,10,5,11,38,41,-3,35
Cliftonville,6,5,10,4,12,37,32,5,34
Ballymena,6,6,7,4,15,25,50,-25,25
Glentoran,6,7,6,6,10,24,32,-8,24
Dungannon,6,8,2,4,16,14,47,-33,10
Crusaders,7,1,17,6,3,63,30,33,57
Coleraine,7,2,14,10,2,43,23,20,52
Glenavon,7,3,10,9,7,53,43,10,39
Linfield,7,4,10,5,11,38,38,0,35
Cliftonville,7,5,10,4,12,34,32,2,34
Ballymena,7,6,7,4,15,25,49,-24,25
Glentoran,7,7,6,6,10,24,32,-8,24
Dungannon,7,8,2,4,16,14,47,-33,10
Crusaders,8,1,17,6,3,65,32,33,57
Coleraine,8,2,15,10,1,46,24,22,55
Glenavon,8,3,9,9,8,54,46,8,36
Linfield,8,4,10,5,11,38,38,0,35
Cliftonville,8,5,10,4,12,34,32,2,34
Ballymena,8,6,7,4,15,27,51,-24,25
Glentoran,8,7,6,6,10,24,32,-8,24
Dungannon,8,8,2,4,16,14,47,-33,10
Crusaders,9,1,17,6,3,63,31,32,57
Coleraine,9,2,14,10,2,43,25,18,52
Glenavon,9,3,10,9,7,55,43,12,39
Linfield,9,4,10,5,11,37,38,-1,35
Cliftonville,9,5,10,4,12,34,31,3,34
Ballymena,9,6,7,4,15,26,49,-23,25
Glentoran,9,7,6,6,10,24,32,-8,24
Dungannon,9,8,2,4,16,14,47,-33,10
Crusaders,10,1,16,7,3,63,32,31,55
Coleraine,10,2,14,11,1,44,23,21,53
Glenavon,10,3,9,10,7,53,44,9,37
Linfield,10,4,10,5,11,38,38,0,35
Cliftonville,10,5,10,4,12,34,32,2,34
Ballymena,10,6,7,5,14,27,49,-22,26
Glentoran,10,7,6,6,10,24,32,-8,24
Dungannon,10,8,2,4,16,14,47,-33,10
Crusaders,11,1,17,6,3,62,30,32,57
Coleraine,11,2,14,11,1,44,23,21,53
Linfield,11,3,11,5,10,41,37,4,38
Glenavon,11,4,9,10,7,53,44,9,37
Cliftonville,11,5,9,4,13,33,35,-2,31
Ballymena,11,6,7,4,15,25,48,-23,25
Glentoran,11,7,6,6,10,24,32,-8,24
Dungannon,11,8,2,4,16,14,47,-33,10
Crusaders,12,1,17,6,3,64,30,34,57
Coleraine,12,2,14,10,2,43,26,17,52
Glenavon,12,3,10,9,7,56,43,13,39
Linfield,12,4,10,5,11,38,38,0,35
Cliftonville,12,5,10,4,12,34,32,2,34
Ballymena,12,6,7,4,15,25,50,-25,25
Glentoran,12,7,6,6,10,24,32,-8,24
Dungannon,12,8,2,4,16,14,47,-33,10
Crusaders,13,1,17,6,3,63,31,32,57
Coleraine,13,2,14,10,2,45,27,18,52
Glenavon,13,3,10,9,7,57,45,12,39
Linfield,13,4,10,6,10,37,36,1,36
Cliftonville,13,5,9,5,12,32,31,1,32
Ballymena,13,6,7,4,15,26,49,-23,25
Glentoran,13,7,6,6,10,24,32,-8,24
Dungannon,13,8,2,4,16,14,47,-33,10
Crusaders,14,1,16,7,3,63,32,31,55
Coleraine,14,2,14,10,2,44,25,19,52
Glenavon,14,3,10,9,7,55,44,11,39
Linfield,14,4,11,5,10,41,36,5,38
Cliftonville,14,5,9,4,13,32,35,-3,31
Ballymena,14,6,7,5,14,27,49,-22,26
Glentoran,14,7,6,6,10,24,32,-8,24
Dungannon,14,8,2,4,16,14,47,-33,10
Crusaders,15,1,17,6,3,64,30,34,57
Coleraine,15,2,14,10,2,43,23,20,52
Glenavon,15,3,10,9,7,53,43,10,39
Linfield,15,4,10,5,11,37,39,-2,35
Cliftonville,15,5,10,4,12,35,31,4,34
Ballymena,15,6,7,4,15,25,50,-25,25
Glentoran,15,7,6,6,10,24,32,-8,24
Dungannon,15,8,2,4,16,14,47,-33,10
Crusaders,16,1,17,6,3,62,30,32,57
Coleraine,16,2,14,10,2,44,26,18,52
Glenavon,16,3,10,9,7,56,44,12,39
Linfield,16,4,11,5,10,39,37,2,38
Cliftonville,16,5,9,4,13,33,33,0,31
Ballymena,16,6,7,4,15,25,48,-23,25
Glentoran,16,7,6,6,10,24,32,-8,24
Dungannon,16,8,2,4,16,14,47,-33,10
Crusaders,17,1,17,6,3,65,33,32,57
Coleraine,17,2,14,11,1,44,23,21,53
Glenavon,17,3,9,10,7,53,44,9,37
Linfield,17,4,10,5,11,37,37,0,35
Cliftonville,17,5,10,4,12,33,31,2,34
Ballymena,17,6,7,4,15,28,51,-23,25
Glentoran,17,7,6,6,10,24,32,-8,24
Dungannon,17,8,2,4,16,14,47,-33,10
Crusaders,18,1,17,6,3,65,31,34,57
Coleraine,18,2,14,10,2,44,26,18,52
Glenavon,18,3,10,9,7,56,44,12,39
Linfield,18,4,10,6,10,38,37,1,36
Cliftonville,18,5,9,5,12,33,32,1,32
Ballymena,18,6,7,4,15,26,51,-25,25
Glentoran,18,7,6,6,10,24,32,-8,24
Dungannon,18,8,2,4,16,14,47,-33,10
Crusaders,19,1,17,6,3,63,30,33,57
Coleraine,19,2,14,10,2,43,26,17,52
Glenavon,19,3,10,9,7,56,43,13,39
Linfield,19,4,11,5,10,41,37,4,38
Cliftonville,19,5,9,4,13,33,35,-2,31
Ballymena,19,6,7,4,15,25,49,-24,25
Glentoran,19,7,6,6,10,24,32,-8,24
Dungannon,19,8,2,4,16,14,47,-33,10
Crusaders,20,1,17,6,3,64,31,33,57
Coleraine,20,2,14,10,2,43,23,20,52
Glenavon,20,3,10,9,7,53,43,10,39
Linfield,20,4,11,5,10,40,36,4,38
Cliftonville,20,5,9,4,13,32,34,-2,31
Ballymena,20,6,7,4,15,26,50,-24,25
Glentoran,20,7,6,6,10,24,32,-8,24
Dungannon,20,8,2,4,16,14,47,-33,10
Crusaders,21,1,17,6,3,63,31,32,57
Coleraine,21,2,15,10,1,44,22,22,55
Linfield,21,3,11,5,10,39,37,2,38
Glenavon,21,4,9,9,8,52,44,8,36
Cliftonville,21,5,9,4,13,33,33,0,31
Ballymena,21,6,7,4,15,26,49,-23,25
Glentoran,21,7,6,6,10,24,32,-8,24
Dungannon,21,8,2,4,16,14,47,-33,10
Crusaders,22,1,17,6,3,65,31,34,57
Coleraine,22,2,15,10,1,45,23,22,55
Linfield,22,3,11,5,10,42,37,5,38
Glenavon,22,4,9,9,8,53,45,8,36
Cliftonville,22,5,9,4,13,33,36,-3,31
Ballymena,22,6,7,4,15,26,51,-25,25
Glentoran,22,7,6,6,10,24,32,-8,24
Dungannon,22,8,2,4,16,14,47,-33,10
Crusaders,23,1,16,6,4,61,31,30,54
Coleraine,23,2,14,10,2,43,24,19,52
Glenavon,23,3,10,9,7,54,43,11,39
Linfield,23,4,10,5,11,37,38,-1,35
Cliftonville,23,5,10,4,12,34,31,3,34
Ballymena,23,6,8,4,14,26,47,-21,28
Glentoran,23,7,6,6,10,24,32,-8,24
Dungannon,23,8,2,4,16,14,47,-33,10
Crusaders,24,1,17,6,3,63,30,33,57
Coleraine,24,2,15,10,1,46,23,23,55
Glenavon,24,3,9,9,8,53,46,7,36
Linfield,24,4,10,6,10,37,36,1,36
Cliftonville,24,5,9,5,12,32,31,1,32
Ballymena,24,6,7,4,15,25,49,-24,25
Glentoran,24,7,6,6,10,24,32,-8,24
Dungannon,24,8,2,4,16,14,47,-33,10
Crusaders,25,1,17,6,3,65,30,35,57
Coleraine,25,2,14,10,2,45,25,20,52
Glenavon,25,3,10,9,7,55,45,10,39
Linfield,25,4,11,5,10,39,37,2,38
Cliftonville,25,5,9,4,13,33,33,0,31
Ballymena,25,6,7,4,15,25,51,-26,25
Glentoran,25,7,6,6,10,24,32,-8,24
Dungannon,25,8,2,4,16,14,47,-33,10
Crusaders,26,1,17,6,3,64,31,33,57
Coleraine,26,2,15,10,1,44,22,22,55
Glenavon,26,3,9,9,8,52,44,8,36
Linfield,26,4,10,6,10,39,38,1,36
Cliftonville,26,5,9,5,12,34,33,1,32
Ballymena,26,6,7,4,15,26,50,-24,25
Glentoran,26,7,6,6,10,24,32,-8,24
Dungannon,26,8,2,4,16,14,47,-33,10
Crusaders,27,1,16,7,3,63,32,31,55
Coleraine,27,2,15,10,1,46,22,24,55
Glenavon,27,3,9,9,8,52,46,6,36
Linfield,27,4,10,5,11,38,38,0,35
Cliftonville,27,5,10,4,12,34,32,2,34
Ballymena,27,6,7,5,14,27,49,-22,26
Glentoran,27,7,6,6,10,24,32,-8,24
Dungannon,27,8,2,4,16,14,47,-33,10
Coleraine,28,1,15,10,1,44,22,22,55
Crusaders,28,2,16,6,4,62,32,30,54
Glenavon,28,3,9,9,8,52,44,8,36
Linfield,28,4,10,6,10,40,39,1,36
Cliftonville,28,5,9,5,12,35,34,1,32
Ballymena,28,6,8,4,14,27,48,-21,28
Glentoran,28,7,6,6,10,24,32,-8,24
Dungannon,28,8,2,4,16,14,47,-33,10
Crusaders,29,1,17,6,3,66,32,34,57
Coleraine,29,2,14,10,2,43,24,19,52
Glenavon,29,3,10,9,7,54,43,11,39
Linfield,29,4,11,5,10,39,37,2,38
Cliftonville,29,5,9,4,13,33,33,0,31
Ballymena,29,6,7,4,15,27,52,-25,25
Glentoran,29,7,6,6,10,24,32,-8,24
Dungannon,29,8,2,4,16,14,47,-33,10
Crusaders,30,1,16,6,4,62,32,30,54
Coleraine,30,2,14,10,2,44,24,20,52
Glenavon,30,3,10,9,7,54,44,10,39
Linfield,30,4,10,5,11,38,38,0,35
Cliftonville,30,5,10,4,12,34,32,2,34
Ballymena,30,6,8,4,14,27,48,-21,28
Glentoran,30,7,6,6,10,24,32,-8,24
Dungannon,30,8,2,4,16,14,47,-33,10
Crusaders,31,1,17,6,3,66,32,34,57
Coleraine,31,2,14,10,2,43,23,20,52
Glenavon,31,3,10,9,7,53,43,10,39
Linfield,31,4,10,5,11,38,41,-3,35
Cliftonville,31,5,10,4,12,37,32,5,34
Ballymena,31,6,7,4,15,27,52,-25,25
Glentoran,31,7,6,6,10,24,32,-8,24
Dungannon,31,8,2,4,16,14,47,-33,10
Crusaders,32,1,17,6,3,65,31,34,57
Coleraine,32,2,14,10,2,44,25,19,52
Glenavon,32,3,10,9,7,55,44,11,39
Linfield,32,4,11,5,10,39,37,2,38
Cliftonville,32,5,9,4,13,33,33,0,31
Ballymena,32,6,7,4,15,26,51,-25,25
Glentoran,32,7,6,6,10,24,32,-8,24
Dungannon,32,8,2,4,16,14,47,-33,10
Coleraine,33,1,15,10,1,44,22,22,55
Crusaders,33,2,16,6,4,61,31,30,54
Glenavon,33,3,9,9,8,52,44,8,36
Linfield,33,4,10,5,11,37,37,0,35
Cliftonville,33,5,10,4,12,33,31,2,34
Ballymena,33,6,8,4,14,26,47,-21,28
Glentoran,33,7,6,6,10,24,32,-8,24
Dungannon,33,8,2,4,16,14,47,-33,10
Crusaders,34,1,17,6,3,65,32,33,57
Coleraine,34,2,14,11,1,44,23,21,53
Glenavon,34,3,9,10,7,53,44,9,37
Linfield,34,4,10,6,10,38,37,1,36
Cliftonville,34,5,9,5,12,33,32,1,32
Ballymena,34,6,7,4,15,27,51,-24,25
Glentoran,34,7,6,6,10,24,32,-8,24
Dungannon,34,8,2,4,16,14,47,-33,10
Crusaders,35,1,16,6,4,61,32,29,54
Coleraine,35,2,14,11,1,45,24,21,53
Glenavon,35,3,9,10,7,54,45,9,37
Linfield,35,4,10,5,11,37,39,-2,35
Cliftonville,35,5,10,4,12,35,31,4,34
Ballymena,35,6,8,4,14,27,47,-20,28
Glentoran,35,7,6,6,10,24,32,-8,24
Dungannon,35,8,2,4,16,14,47,-33,10
Crusaders,36,1,17,6,3,65,31,34,57
Coleraine,36,2,15,10,1,47,24,23,55
Glenavon,36,3,9,9,8,54,47,7,36
Linfield,36,4,10,5,11,37,38,-1,35
Cliftonville,36,5,10,4,12,34,31,3,34
Ballymena,36,6,7,4,15,26,51,-25,25
Glentoran,36,7,6,6,10,24,32,-8,24
Dungannon,36,8,2,4,16,14,47,-33,10
Crusaders,37,1,17,6,3,66,32,34,57
Coleraine,37,2,14,11,1,45,24,21,53
Linfield,37,3,11,5,10,39,36,3,38
Glenavon,37,4,9,10,7,54,45,9,37
Cliftonville,37,5,9,4,13,32,33,-1,31
Ballymena,37,6,7,4,15,27,52,-25,25
Glentoran,37,7,6,6,10,24,32,-8,24
Dungannon,37,8,2,4,16,14,47,-33,10
Crusaders,38,1,16,7,3,62,31,31,55
Coleraine,38,2,15,10,1,49,27,22,55
Glenavon,38,3,9,9,8,57,49,8,36
Linfield,38,4,10,6,10,38,37,1,36
Cliftonville,38,5,9,5,12,33,32,1,32
Ballymena,38,6,7,5,14,26,48,-22,26
Glentoran,38,7,6,6,10,24,32,-8,24
Dungannon,38,8,2,4,16,14,47,-33,10
Crusaders,39,1,16,6,4,61,31,30,54
Coleraine,39,2,14,11,1,44,23,21,53
Glenavon,39,3,9,10,7,53,44,9,37
Linfield,39,4,10,5,11,39,39,0,35
Cliftonville,39,5,10,4,12,35,33,2,34
Ballymena,39,6,8,4,14,26,47,-21,28
Glentoran,39,7,6,6,10,24,32,-8,24
Dungannon,39,8,2,4,16,14,47,-33,10
Crusaders,40,1,16,7,3,61,30,31,55
Coleraine,40,2,14,10,2,44,24,20,52
Glenavon,40,3,10,9,7,54,44,10,39
Linfield,40,4,10,6,10,38,37,1,36
Cliftonville,40,5,9,5,12,33,32,1,32
Ballymena,40,6,7,5,14,25,47,-22,26
Glentoran,40,7,6,6,10,24,32,-8,24
Dungannon,40,8,2,4,16,14,47,-33,10
Crusaders,41,1,16,7,3,62,31,31,55
Coleraine,41,2,15,10,1,46,24,22,55
Linfield,41,3,11,5,10,39,37,2,38
Glenavon,41,4,9,9,8,54,46,8,36
Cliftonville,41,5,9,4,13,33,33,0,31
Ballymena,41,6,7,5,14,26,48,-22,26
Glentoran,41,7,6,6,10,24,32,-8,24
Dungannon,41,8,2,4,16,14,47,-33,10
Crusaders,42,1,17,6,3,64,31,33,57
Coleraine,42,2,14,10,2,44,24,20,52
Glenavon,42,3,10,9,7,54,44,10,39
Linfield,42,4,10,5,11,37,37,0,35
Cliftonville,42,5,10,4,12,33,31,2,34
Ballymena,42,6,7,4,15,26,50,-24,25
Glentoran,42,7,6,6,10,24,32,-8,24
Dungannon,42,8,2,4,16,14,47,-33,10
Crusaders,43,1,17,6,3,65,30,35,57
Coleraine,43,2,14,11,1,46,25,21,53
Glenavon,43,3,9,10,7,55,46,9,37
Linfield,43,4,10,6,10,37,36,1,36
Cliftonville,43,5,9,5,12,32,31,1,32
Ballymena,43,6,7,4,15,25,51,-26,25
Glentoran,43,7,6,6,10,24,32,-8,24
Dungannon,43,8,2,4,16,14,47,-33,10
Crusaders,44,1,17,6,3,63,31,32,57
Coleraine,44,2,14,10,2,43,24,19,52
Glenavon,44,3,10,9,7,54,43,11,39
Linfield,44,4,11,5,10,41,36,5,38
Cliftonville,44,5,9,4,13,32,35,-3,31
Ballymena,44,6,7,4,15,26,49,-23,25
Glentoran,44,7,6,6,10,24,32,-8,24
Dungannon,44,8,2,4,16,14,47,-33,10
Crusaders,45,1,17,6,3,64,32,32,57
Coleraine,45,2,15,10,1,45,23,22,55
Glenavon,45,3,9,9,8,53,45,8,36
Linfield,45,4,10,5,11,38,38,0,35
Cliftonville,45,5,10,4,12,34,32,2,34
Ballymena,45,6,7,4,15,27,50,-23,25
Glentoran,45,7,6,6,10,24,32,-8,24
Dungannon,45,8,2,4,16,14,47,-33,10
Crusaders,46,1,17,6,3,62,30,32,57
Coleraine,46,2,15,10,1,45,22,23,55
Linfield,46,3,11,5,10,40,36,4,38
Glenavon,46,4,9,9,8,52,45,7,36
Cliftonville,46,5,9,4,13,32,34,-2,31
Ballymena,46,6,7,4,15,25,48,-23,25
Glentoran,46,7,6,6,10,24,32,-8,24
Dungannon,46,8,2,4,16,14,47,-33,10
Crusaders,47,1,16,7,3,62,31,31,55
Coleraine,47,2,15,10,1,45,23,22,55
Glenavon,47,3,9,9,8,53,45,8,36
Linfield,47,4,10,5,11,39,41,-2,35
Cliftonville,47,5,10,4,12,37,33,4,34
Ballymena,47,6,7,5,14,26,48,-22,26
Glentoran,47,7,6,6,10,24,32,-8,24
Dungannon,47,8,2,4,16,14,47,-33,10
Crusaders,48,1,17,6,3,68,34,34,57
Coleraine,48,2,14,11,1,44,23,21,53
Linfield,48,3,11,5,10,39,36,3,38
Glenavon,48,4,9,10,7,53,44,9,37
Cliftonville,48,5,9,4,13,32,33,-1,31
Ballymena,48,6,7,4,15,29,54,-25,25
Glentoran,48,7,6,6,10,24,32,-8,24
Dungannon,48,8,2,4,16,14,47,-33,10
Crusaders,49,1,16,7,3,61,30,31,55
Coleraine,49,2,15,10,1,46,24,22,55
Glenavon,49,3,9,9,8,54,46,8,36
Linfield,49,4,10,5,11,38,38,0,35
Cliftonville,49,5,10,4,12,34,32,2,34
Ballymena,49,6,7,5,14,25,47,-22,26
Glentoran,49,7,6,6,10,24,32,-8,24
Dungannon,49,8,2,4,16,14,47,-33,10
Crusaders,50,1,16,6,4,62,32,30,54
Coleraine,50,2,14,10,2,44,24,20,52
Glenavon,50,3,10,9,7,54,44,10,39
Linfield,50,4,11,5,10,39,36,3,38
Cliftonville,50,5,9,4,13,32,33,-1,31
Ballymena,50,6,8,4,14,27,48,-21,28
Glentoran,50,7,6,6,10,24,32,-8,24
Dungannon,50,8,2,4,16,14,47,-33,10
Crusaders,51,1,16,6,4,62,32,30,54
Coleraine,51,2,14,10,2,43,25,18,52
Glenavon,51,3,10,9,7,55,43,12,39
Linfield,51,4,10,6,10,38,37,1,36
Cliftonville,51,5,9,5,12,33,32,1,32
Ballymena,51,6,8,4,14,27,48,-21,28
Glentoran,51,7,6,6,10,24,32,-8,24
Dungannon,51,8,2,4,16,14,47,-33,10
Crusaders,52,1,17,6,3,66,32,34,57
Coleraine,52,2,14,10,2,45,25,20,52
Glenavon,52,3,10,9,7,55,45,10,39
Linfield,52,4,10,5,11,38,39,-1,35
Cliftonville,52,5,10,4,12,35,32,3,34
Ballymena,52,6,7,4,15,27,52,-25,25
Glentoran,52,7,6,6,10,24,32,-8,24
Dungannon,52,8,2,4,16,14,47,-33,10
Crusaders,53,1,17,6,3,64,30,34,57
Coleraine,53,2,14,10,2,45,26,19,52
Glenavon,53,3,10,9,7,56,45,11,39
Linfield,53,4,10,5,11,38,38,0,35
Cliftonville,53,5,10,4,12,34,32,2,34
Ballymena,53,6,7,4,15,25,50,-25,25
Glentoran,53,7,6,6,10,24,32,-8,24
Dungannon,53,8,2,4,16,14,47,-33,10
Crusaders,54,1,17,6,3,64,31,33,57
Coleraine,54,2,15,10,1,44,22,22,55
Linfield,54,3,11,5,10,38,36,2,38
Glenavon,54,4,9,9,8,52,44,8,36
Cliftonville,54,5,9,4,13,32,32,0,31
Ballymena,54,6,7,4,15,26,50,-24,25
Glentoran,54,7,6,6,10,24,32,-8,24
Dungannon,54,8,2,4,16,14,47,-33,10
Crusaders,55,1,16,7,3,63,32,31,55
Coleraine,55,2,15,10,1,47,25,22,55
Glenavon,55,3,9,9,8,55,47,8,36
Linfield,55,4,10,5,11,40,40,0,35
Cliftonville,55,5,10,4,12,36,34,2,34
Ballymena,55,6,7,5,14,27,49,-22,26
Glentoran,55,7,6,6,10,24,32,-8,24
Dungannon,55,8,2,4,16,14,47,-33,10
Crusaders,56,1,17,6,3,63,30,33,57
Coleraine,56,2,14,10,2,46,26,20,52
Glenavon,56,3,10,9,7,56,46,10,39
Linfield,56,4,10,5,11,38,38,0,35
Cliftonville,56,5,10,4,12,34,32,2,34
Ballymena,56,6,7,4,15,25,49,-24,25
Glentoran,56,7,6,6,10,24,32,-8,24
Dungannon,56,8,2,4,16,14,47,-33,10
Crusaders,57,1,16,7,3,61,30,31,55
Coleraine,57,2,15,10,1,46,23,23,55
Linfield,57,3,11,5,10,38,36,2,38
Glenavon,57,4,9,9,8,53,46,7,36
Cliftonville,57,5,9,4,13,32,32,0,31
Ballymena,57,6,7,5,14,25,47,-22,26
Glentoran,57,7,6,6,10,24,32,-8,24
Dungannon,57,8,2,4,16,14,47,-33,10
Crusaders,58,1,17,6,3,64,30,34,57
Coleraine,58,2,15,10,1,45,22,23,55
Linfield,58,3,11,5,10,38,36,2,38
Glenavon,58,4,9,9,8,52,45,7,36
Cliftonville,58,5,9,4,13,32,32,0,31
Ballymena,58,6,7,4,15,25,50,-25,25
Glentoran,58,7,6,6,10,24,32,-8,24
Dungannon,58,8,2,4,16,14,47,-33,10
Crusaders,59,1,17,6,3,64,32,32,57
Coleraine,59,2,15,10,1,47,24,23,55
Glenavon,59,3,9,9,8,54,47,7,36
Linfield,59,4,10,5,11,37,37,0,35
Cliftonville,59,5,10,4,12,33,31,2,34
Ballymena,59,6,7,4,15,27,50,-23,25
Glentoran,59,7,6,6,10,24,32,-8,24
Dungannon,59,8,2,4,16,14,47,-33,10
Crusaders,60,1,16,6,4,63,33,30,54
Coleraine,60,2,14,10,2,43,24,19,52
Glenavon,60,3,10,9,7,54,43,11,39
Linfield,60,4,10,6,10,37,36,1,36
Cliftonville,60,5,9,5,12,32,31,1,32
Ballymena,60,6,8,4,14,28,49,-21,28
Glentoran,60,7,6,6,10,24,32,-8,24
Dungannon,60,8,2,4,16,14,47,-33,10
Crusaders,61,1,16,7,3,61,30,31,55
Coleraine,61,2,15,10,1,45,22,23,55
Glenavon,61,3,9,9,8,52,45,7,36
Linfield,61,4,10,5,11,37,37,0,35
Cliftonville,61,5,10,4,12,33,31,2,34
Ballymena,61,6,7,5,14,25,47,-22,26
Glentoran,61,7,6,6,10,24,32,-8,24
Dungannon,61,8,2,4,16,14,47,-33,10
Crusaders,62,1,17,6,3,65,31,34,57
Coleraine,62,2,15,10,1,44,22,22,55
Linfield,62,3,11,5,10,40,38,2,38
Glenavon,62,4,9,9,8,52,44,8,36
Cliftonville,62,5,9,4,13,34,34,0,31
Ballymena,62,6,7,4,15,26,51,-25,25
Glentoran,62,7,6,6,10,24,32,-8,24
Dungannon,62,8,2,4,16,14,47,-33,10
Crusaders,63,1,16,6,4,62,32,30,54
Coleraine,63,2,14,10,2,43,25,18,52
Glenavon,63,3,10,9,7,55,43,12,39
Linfield,63,4,10,6,10,38,37,1,36
Cliftonville,63,5,9,5,12,33,32,1,32
Ballymena,63,6,8,4,14,27,48,-21,28
Glentoran,63,7,6,6,10,24,32,-8,24
Dungannon,63,8,2,4,16,14,47,-33,10
Crusaders,64,1,17,6,3,64,31,33,57
Coleraine,64,2,15,10,1,46,22,24,55
Glenavon,64,3,9,9,8,52,46,6,36
Linfield,64,4,10,6,10,40,39,1,36
Cliftonville,64,5,9,5,12,35,34,1,32
Ballymena,64,6,7,4,15,26,50,-24,25
Glentoran,64,7,6,6,10,24,32,-8,24
Dungannon,64,8,2,4,16,14,47,-33,10
Crusaders,65,1,16,6,4,62,32,30,54
Coleraine,65,2,14,10,2,43,24,19,52
Glenavon,65,3,10,9,7,54,43,11,39
Linfield,65,4,10,6,10,38,37,1,36
Cliftonville,65,5,9,5,12,33,32,1,32
Ballymena,65,6,8,4,14,27,48,-21,28
Glentoran,65,7,6,6,10,24,32,-8,24
Dungannon,65,8,2,4,16,14,47,-33,10
Crusaders,66,1,16,6,4,62,33,29,54
Coleraine,66,2,14,10,2,44,27,17,52
Glenavon,66,3,10,9,7,57,44,13,39
Linfield,66,4,10,5,11,37,38,-1,35
Cliftonville,66,5,10,4,12,34,31,3,34
Ballymena,66,6,8,4,14,28,48,-20,28
Glentoran,66,7,6,6,10,24,32,-8,24
Dungannon,66,8,2,4,16,14,47,-33,10
Crusaders,67,1,16,7,3,62,31,31,55
Coleraine,67,2,14,11,1,44,23,21,53
Linfield,67,3,11,5,10,39,37,2,38
Glenavon,67,4,9,10,7,53,44,9,37
Cliftonville,67,5,9,4,13,33,33,0,31
Ballymena,67,6,7,5,14,26,48,-22,26
Glentoran,67,7,6,6,10,24,32,-8,24
Dungannon,67,8,2,4,16,14,47,-33,10
Crusaders,68,1,16,7,3,62,31,31,55
Coleraine,68,2,15,10,1,46,24,22,55
Linfield,68,3,11,5,10,39,37,2,38
Glenavon,68,4,9,9,8,54,46,8,36
Cliftonville,68,5,9,4,13,33,33,0,31
Ballymena,68,6,7,5,14,26,48,-22,26
Glentoran,68,7,6,6,10,24,32,-8,24
Dungannon,68,8,2,4,16,14,47,-33,10
Crusaders,69,1,17,6,3,62,30,32,57
Coleraine,69,2,15,10,1,46,24,22,55
Linfield,69,3,11,5,10,40,37,3,38
Glenavon,69,4,9,9,8,54,46,8,36
Cliftonville,69,5,9,4,13,33,34,-1,31
Ballymena,69,6,7,4,15,25,48,-23,25
Glentoran,69,7,6,6,10,24,32,-8,24
Dungannon,69,8,2,4,16,14,47,-33,10
Crusaders,70,1,17,6,3,64,30,34,57
Coleraine,70,2,14,10,2,43,27,16,52
Glenavon,70,3,10,9,7,57,43,14,39
Linfield,70,4,11,5,10,39,36,3,38
Cliftonville,70,5,9,4,13,32,33,-1,31
Ballymena,70,6,7,4,15,25,50,-25,25
Glentoran,70,7,6,6,10,24,32,-8,24
Dungannon,70,8,2,4,16,14,47,-33,10
Crusaders,71,1,16,6,4,61,31,30,54
Coleraine,71,2,14,10,2,45,25,20,52
Glenavon,71,3,10,9,7,55,45,10,39
Linfield,71,4,11,5,10,38,36,2,38
Cliftonville,71,5,9,4,13,32,32,0,31
Ballymena,71,6,8,4,14,26,47,-21,28
Glentoran,71,7,6,6,10,24,32,-8,24
Dungannon,71,8,2,4,16,14,47,-33,10
Crusaders,72,1,16,6,4,61,31,30,54
Coleraine,72,2,14,10,2,43,24,19,52
Glenavon,72,3,10,9,7,54,43,11,39
Linfield,72,4,11,5,10,40,38,2,38
Cliftonville,72,5,9,4,13,34,34,0,31
Ballymena,72,6,8,4,14,26,47,-21,28
Glentoran,72,7,6,6,10,24,32,-8,24
Dungannon,72,8,2,4,16,14,47,-33,10
Crusaders,73,1,17,6,3,65,31,34,57
Coleraine,73,2,14,10,2,43,23,20,52
Glenavon,73,3,10,9,7,53,43,10,39
Linfield,73,4,11,5,10,40,36,4,38
Cliftonville,73,5,9,4,13,32,34,-2,31
Ballymena,73,6,7,4,15,26,51,-25,25
Glentoran,73,7,6,6,10,24,32,-8,24
Dungannon,73,8,2,4,16,14,47,-33,10
Coleraine,74,1,15,10,1,46,23,23,55
Crusaders,74,2,16,6,4,62,34,28,54
Linfield,74,3,11,5,10,40,36,4,38
Glenavon,74,4,9,9,8,53,46,7,36
Cliftonville,74,5,9,4,13,32,34,-2,31
Ballymena,74,6,8,4,14,29,48,-19,28
Glentoran,74,7,6,6,10,24,32,-8,24
Dungannon,74,8,2,4,16,14,47,-33,10
Crusaders,75,1,16,7,3,61,30,31,55
Coleraine,75,2,14,11,1,43,22,21,53
Glenavon,75,3,9,10,7,52,43,9,37
Linfield,75,4,10,5,11,38,38,0,35
Cliftonville,75,5,10,4,12,34,32,2,34
Ballymena,75,6,7,5,14,25,47,-22,26
Glentoran,75,7,6,6,10,24,32,-8,24
Dungannon,75,8,2,4,16,14,47,-33,10
Crusaders,76,1,16,6,4,62,33,29,54
Coleraine,76,2,14,11,1,44,23,21,53
Glenavon,76,3,9,10,7,53,44,9,37
Linfield,76,4,10,5,11,38,39,-1,35
Cliftonville,76,5,10,4,12,35,32,3,34
Ballymena,76,6,8,4,14,28,48,-20,28
Glentoran,76,7,6,6,10,24,32,-8,24
Dungannon,76,8,2,4,16,14,47,-33,10
Crusaders,77,1,17,6,3,63,30,33,57
Coleraine,77,2,15,10,1,47,22,25,55
Glenavon,77,3,9,9,8,52,47,5,36
Linfield,77,4,10,6,10,37,36,1,36
Cliftonville,77,5,9,5,12,32,31,1,32
Ballymena,77,6,7,4,15,25,49,-24,25
Glentoran,77,7,6,6,10,24,32,-8,24
Dungannon,77,8,2,4,16,14,47,-33,10
Crusaders,78,1,17,6,3,65,30,35,57
Coleraine,78,2,15,10,1,46,23,23,55
Linfield,78,3,11,5,10,40,37,3,38
Glenavon,78,4,9,9,8,53,46,7,36
Cliftonville,78,5,9,4,13,33,34,-1,31
Ballymena,78,6,7,4,15,25,51,-26,25
Glentoran,78,7,6,6,10,24,32,-8,24
Dungannon,78,8,2,4,16,14,47,-33,10
Crusaders,79,1,17,6,3,62,30,32,57
Coleraine,79,2,14,11,1,44,23,21,53
Linfield,79,3,11,5,10,39,37,2,38
Glenavon,79,4,9,10,7,53,44,9,37
Cliftonville,79,5,9,4,13,33,33,0,31
Ballymena,79,6,7,4,15,25,48,-23,25
Glentoran,79,7,6,6,10,24,32,-8,24
Dungannon,79,8,2,4,16,14,47,-33,10
Crusaders,80,1,17,6,3,62,30,32,57
Coleraine,80,2,15,10,1,44,22,22,55
Glenavon,80,3,9,9,8,52,44,8,36
Linfield,80,4,10,5,11,37,40,-3,35
Cliftonville,80,5,10,4,12,36,31,5,34
Ballymena,80,6,7,4,15,25,48,-23,25
Glentoran,80,7,6,6,10,24,32,-8,24
Dungannon,80,8,2,4,16,14,47,-33,10
Crusaders,81,1,16,6,4,61,32,29,54
Coleraine,81,2,14,10,2,43,23,20,52
Glenavon,81,3,10,9,7,53,43,10,39
Linfield,81,4,11,5,10,39,37,2,38
Cliftonville,81,5,9,4,13,33,33,0,31
Ballymena,81,6,8,4,14,27,47,-20,28
Glentoran,81,7,6,6,10,24,32,-8,24
Dungannon,81,8,2,4,16,14,47,-33,10
Coleraine,82,1,15,10,1,45,22,23,55
Crusaders,82,2,16,6,4,62,32,30,54
Glenavon,82,3,9,9,8,52,45,7,36
Linfield,82,4,10,5,11,37,37,0,35
Cliftonville,82,5,10,4,12,33,31,2,34
Ballymena,82,6,8,4,14,27,48,-21,28
Glentoran,82,7,6,6,10,24,32,-8,24
Dungannon,82,8,2,4,16,14,47,-33,10
Crusaders,83,1,16,6,4,62,32,30,54
Coleraine,83,2,14,10,2,45,26,19,52
Glenavon,83,3,10,9,7,56,45,11,39
Linfield,83,4,11,5,10,39,37,2,38
Cliftonville,83,5,9,4,13,33,33,0,31
Ballymena,83,6,8,4,14,27,48,-21,28
Glentoran,83,7,6,6,10,24,32,-8,24
Dungannon,83,8,2,4,16,14,47,-33,10
Crusaders,84,1,17,6,3,63,30,33,57
Coleraine,84,2,14,11,1,45,24,21,53
Glenavon,84,3,9,10,7,54,45,9,37
Linfield,84,4,10,5,11,38,38,0,35
Cliftonville,84,5,10,4,12,34,32,2,34
Ballymena,84,6,7,4,15,25,49,-24,25
Glentoran,84,7,6,6,10,24,32,-8,24
Dungannon,84,8,2,4,16,14,47,-33,10
Crusaders,85,1,17,6,3,66,31,35,57
Coleraine,85,2,14,10,2,44,24,20,52
Glenavon,85,3,10,9,7,54,44,10,39
Linfield,85,4,11,5,10,40,37,3,38
Cliftonville,85,5,9,4,13,33,34,-1,31
Ballymena,85,6,7,4,15,26,52,-26,25
Glentoran,85,7,6,6,10,24,32,-8,24
Dungannon,85,8,2,4,16,14,47,-33,10
Coleraine,86,1,15,10,1,46,23,23,55
Crusaders,86,2,16,6,4,63,33,30,54
Linfield,86,3,11,5,10,40,37,3,38
Glenavon,86,4,9,9,8,53,46,7,36
Cliftonville,86,5,9,4,13,33,34,-1,31
Ballymena,86,6,8,4,14,28,49,-21,28
Glentoran,86,7,6,6,10,24,32,-8,24
Dungannon,86,8,2,4,16,14,47,-33,10
Crusaders,87,1,17,6,3,64,31,33,57
Coleraine,87,2,14,11,1,45,24,21,53
Glenavon,87,3,9,10,7,54,45,9,37
Linfield,87,4,10,6,10,39,38,1,36
Cliftonville,87,5,9,5,12,34,33,1,32
Ballymena,87,6,7,4,15,26,50,-24,25
Glentoran,87,7,6,6,10,24,32,-8,24
Dungannon,87,8,2,4,16,14,47,-33,10
Crusaders,88,1,16,7,3,62,31,31,55
Coleraine,88,2,14,11,1,45,24,21,53
Linfield,88,3,11,5,10,40,36,4,38
Glenavon,88,4,9,10,7,54,45,9,37
Cliftonville,88,5,9,4,13,32,34,-2,31
Ballymena,88,6,7,5,14,26,48,-22,26
Glentoran,88,7,6,6,10,24,32,-8,24
Dungannon,88,8,2,4,16,14,47,-33,10
Crusaders,89,1,16,6,4,62,34,28,54
Coleraine,89,2,14,10,2,44,26,18,52
Glenavon,89,3,10,9,7,56,44,12,39
Linfield,89,4,10,5,11,37,38,-1,35
Cliftonville,89,5,10,4,12,34,31,3,34
Ballymena,89,6,8,4,14,29,48,-19,28
Glentoran,89,7,6,6,10,24,32,-8,24
Dungannon,89,8,2,4,16,14,47,-33,10
Crusaders,90,1,17,6,3,65,30,35,57
Coleraine,90,2,14,10,2,44,25,19,52
Glenavon,90,3,10,9,7,55,44,11,39
Linfield,90,4,10,5,11,37,38,-1,35
Cliftonville,90,5,10,4,12,34,31,3,34
Ballymena,90,6,7,4,15,25,51,-26,25
Glentoran,90,7,6,6,10,24,32,-8,24
Dungannon,90,8,2,4,16,14,47,-33,10
Crusaders,91,1,17,6,3,62,30,32,57
Coleraine,91,2,15,10,1,47,25,22,55
Linfield,91,3,11,5,10,40,37,3,38
Glenavon,91,4,9,9,8,55,47,8,36
Cliftonville,91,5,9,4,13,33,34,-1,31
Ballymena,91,6,7,4,15,25,48,-23,25
Glentoran,91,7,6,6,10,24,32,-8,24
Dungannon,91,8,2,4,16,14,47,-33,10
Crusaders,92,1,16,7,3,61,30,31,55
Coleraine,92,2,14,10,2,43,24,19,52
Glenavon,92,3,10,9,7,54,43,11,39
Linfield,92,4,11,5,10,39,37,2,38
Cliftonville,92,5,9,4,13,33,33,0,31
Ballymena,92,6,7,5,14,25,47,-22,26
Glentoran,92,7,6,6,10,24,32,-8,24
Dungannon,92,8,2,4,16,14,47,-33,10
Crusaders,93,1,16,7,3,65,34,31,55
Coleraine,93,2,14,10,2,44,26,18,52
Glenavon,93,3,10,9,7,56,44,12,39
Linfield,93,4,10,5,11,38,38,0,35
Cliftonville,93,5,10,4,12,34,32,2,34
Ballymena,93,6,7,5,14,29,51,-22,26
Glentoran,93,7,6,6,10,24,32,-8,24
Dungannon,93,8,2,4,16,14,47,-33,10
Crusaders,94,1,17,6,3,62,30,32,57
Coleraine,94,2,15,10,1,47,22,25,55
Linfield,94,3,11,5,10,39,37,2,38
Glenavon,94,4,9,9,8,52,47,5,36
Cliftonville,94,5,9,4,13,33,33,0,31
Ballymena,94,6,7,4,15,25,48,-23,25
Glentoran,94,7,6,6,10,24,32,-8,24
Dungannon,94,8,2,4,16,14,47,-33,10
Crusaders,95,1,16,7,3,61,30,31,55
Coleraine,95,2,14,10,2,43,23,20,52
Glenavon,95,3,10,9,7,53,43,10,39
Linfield,95,4,10,6,10,39,38,1,36
Cliftonville,95,5,9,5,12,34,33,1,32
Ballymena,95,6,7,5,14,25,47,-22,26
Glentoran,95,7,6,6,10,24,32,-8,24
Dungannon,95,8,2,4,16,14,47,-33,10
Crusaders,96,1,17,6,3,65,31,34,57
Coleraine,96,2,14,11,1,44,23,21,53
Linfield,96,3,11,5,10,39,37,2,38
Glenavon,96,4,9,10,7,53,44,9,37
Cliftonville,96,5,9,4,13,33,33,0,31
Ballymena,96,6,7,4,15,26,51,-25,25
Glentoran,96,7,6,6,10,24,32,-8,24
Dungannon,96,8,2,4,16,14,47,-33,10
Crusaders,97,1,16,7,3,61,30,31,55
Coleraine,97,2,15,10,1,45,23,22,55
Linfield,97,3,11,5,10,39,37,2,38
Glenavon,97,4,9,9,8,53,45,8,36
Cliftonville,97,5,9,4,13,33,33,0,31
Ballymena,97,6,7,5,14,25,47,-22,26
Glentoran,97,7,6,6,10,24,32,-8,24
Dungannon,97,8,2,4,16,14,47,-33,10
Crusaders,98,1,17,6,3,65,31,34,57
Coleraine,98,2,14,11,1,44,23,21,53
Glenavon,98,3,9,10,7,53,44,9,37
Linfield,98,4,10,6,10,38,37,1,36
Cliftonville,98,5,9,5,12,33,32,1,32
Ballymena,98,6,7,4,15,26,51,-25,25
Glentoran,98,7,6,6,10,24,32,-8,24
Dungannon,98,8,2,4,16,14,47,-33,10
Crusaders,99,1,17,6,3,66,31,35,57
Coleraine,99,2,14,11,1,44,23,21,53
Glenavon,99,3,9,10,7,53,44,9,37
Linfield,99,4,10,5,11,37,37,0,35
Cliftonville,99,5,10,4,12,33,31,2,34
Ballymena,99,6,7,4,15,26,52,-26,25
Glentoran,99,7,6,6,10,24,32,-8,24
Dungannon,99,8,2,4,16,14,47,-33,10
Crusaders,100,1,17,6,3,62,30,32,57
Coleraine,100,2,14,10,2,44,24,20,52
Glenavon,100,3,10,9,7,54,44,10,39
Linfield,100,4,11,5,10,40,36,4,38
Cliftonville,100,5,9,4,13,32,34,-2,31
Ballymena,100,6,7,4,15,25,48,-23,25
Glentoran,100,7,6,6,10,24,32,-8,24
Dungannon,100,8,2,4,16,14,47,-33,10
Crusaders,101,1,16,7,3,62,31,31,55
Coleraine,101,2,14,10,2,43,23,20,52
Glenavon,101,3,10,9,7,53,43,10,39
Linfield,101,4,11,5,10,39,37,2,38
Cliftonville,101,5,9,4,13,33,33,0,31
Ballymena,101,6,7,5,14,26,48,-22,26
Glentoran,101,7,6,6,10,24,32,-8,24
Dungannon,101,8,2,4,16,14,47,-33,10
Crusaders,102,1,16,7,3,63,32,31,55
Coleraine,102,2,14,10,2,43,23,20,52
Glenavon,102,3,10,9,7,53,43,10,39
Linfield,102,4,10,6,10,39,38,1,36
Cliftonville,102,5,9,5,12,34,33,1,32
Ballymena,102,6,7,5,14,27,49,-22,26
Glentoran,102,7,6,6,10,24,32,-8,24
Dungannon,102,8,2,4,16,14,47,-33,10
Crusaders,103,1,17,6,3,66,30,36,57
Coleraine,103,2,14,10,2,43,23,20,52
Glenavon,103,3,10,9,7,53,43,10,39
Linfield,103,4,10,6,10,38,37,1,36
Cliftonville,103,5,9,5,12,33,32,1,32
Ballymena,103,6,7,4,15,25,52,-27,25
Glentoran,103,7,6,6,10,24,32,-8,24
Dungannon,103,8,2,4,16,14,47,-33,10
Crusaders,104,1,17,6,3,65,33,32,57
Coleraine,104,2,15,10,1,44,22,22,55
Linfield,104,3,11,5,10,40,38,2,38
Glenavon,104,4,9,9,8,52,44,8,36
Cliftonville,104,5,9,4,13,34,34,0,31
Ballymena,104,6,7,4,15,28,51,-23,25
Glentoran,104,7,6,6,10,24,32,-8,24
Dungannon,104,8,2,4,16,14,47,-33,10
Crusaders,105,1,16,7,3,61,30,31,55
Coleraine,105,2,15,10,1,45,23,22,55
Glenavon,105,3,9,9,8,53,45,8,36
Linfield,105,4,10,5,11,37,38,-1,35
Cliftonville,105,5,10,4,12,34,31,3,34
Ballymena,105,6,7,5,14,25,47,-22,26
Glentoran,105,7,6,6,10,24,32,-8,24
Dungannon,105,8,2,4,16,14,47,-33,10
Crusaders,106,1,16,7,3,62,31,31,55
Coleraine,106,2,15,10,1,46,24,22,55
Glenavon,106,3,9,9,8,54,46,8,36
Linfield,106,4,10,6,10,38,37,1,36
Cliftonville,106,5,9,5,12,33,32,1,32
Ballymena,106,6,7,5,14,26,48,-22,26
Glentoran,106,7,6,6,10,24,32,-8,24
Dungannon,106,8,2,4,16,14,47,-33,10
Crusaders,107,1,17,6,3,65,31,34,57
Coleraine,107,2,14,11,1,45,24,21,53
Linfield,107,3,11,5,10,40,36,4,38
Glenavon,107,4,9,10,7,54,45,9,37
Cliftonville,107,5,9,4,13,32,34,-2,31
Ballymena,107,6,7,4,15,26,51,-25,25
Glentoran,107,7,6,6,10,24,32,-8,24
Dungannon,107,8,2,4,16,14,47,-33,10
Crusaders,108,1,17,6,3,62,30,32,57
Coleraine,108,2,14,11,1,44,23,21,53
Linfield,108,3,11,5,10,40,36,4,38
Glenavon,108,4,9,10,7,53,44,9,37
Cliftonville,108,5,9,4,13,32,34,-2,31
Ballymena,108,6,7,4,15,25,48,-23,25
Glentoran,108,7,6,6,10,24,32,-8,24
Dungannon,108,8,2,4,16,14,47,-33,10
Crusaders,109,1,16,6,4,63,33,30,54
Coleraine,109,2,14,10,2,44,24,20,52
Glenavon,109,3,10,9,7,54,44,10,39
Linfield,109,4,10,6,10,37,36,1,36
Cliftonville,109,5,9,5,12,32,31,1,32
Ballymena,109,6,8,4,14,28,49,-21,28
Glentoran,109,7,6,6,10,24,32,-8,24
Dungannon,109,8,2,4,16,14,47,-33,10
Crusaders,110,1,17,6,3,65,30,35,57
Coleraine,110,2,14,10,2,43,24,19,52
Glenavon,110,3,10,9,7,54,43,11,39
Linfield,110,4,11,5,10,39,37,2,38
Cliftonville,110,5,9,4,13,33,33,0,31
Ballymena,110,6,7,4,15,25,51,-26,25
Glentoran,110,7,6,6,10,24,32,-8,24
Dungannon,110,8,2,4,16,14,47,-33,10
Crusaders,111,1,17,6,3,63,31,32,57
Coleraine,111,2,15,10,1,45,23,22,55
Linfield,111,3,11,5,10,39,37,2,38
Glenavon,111,4,9,9,8,53,45,8,36
Cliftonville,111,5,9,4,13,33,33,0,31
Ballymena,111,6,7,4,15,26,49,-23,25
Glentoran,111,7,6,6,10,24,32,-8,24
Dungannon,111,8,2,4,16,14,47,-33,10
Crusaders,112,1,17,6,3,64,30,34,57
Coleraine,112,2,14,11,1,45,24,21,53
Glenavon,112,3,9,10,7,54,45,9,37
Linfield,112,4,10,5,11,38,38,0,35
Cliftonville,112,5,10,4,12,34,32,2,34
Ballymena,112,6,7,4,15,25,50,-25,25
Glentoran,112,7,6,6,10,24,32,-8,24
Dungannon,112,8,2,4,16,14,47,-33,10
Crusaders,113,1,16,6,4,62,33,29,54
Coleraine,113,2,14,10,2,45,26,19,52
Glenavon,113,3,10,9,7,56,45,11,39
Linfield,113,4,11,5,10,39,37,2,38
Cliftonville,113,5,9,4,13,33,33,0,31
Ballymena,113,6,8,4,14,28,48,-20,28
Glentoran,113,7,6,6,10,24,32,-8,24
Dungannon,113,8,2,4,16,14,47,-33,10
Coleraine,114,1,15,10,1,47,23,24,55
Crusaders,114,2,16,6,4,61,33,28,54
Linfield,114,3,11,5,10,40,36,4,38
Glenavon,114,4,9,9,8,53,47,6,36
Cliftonville,114,5,9,4,13,32,34,-2,31
Ballymena,114,6,8,4,14,28,47,-19,28
Glentoran,114,7,6,6,10,24,32,-8,24
Dungannon,114,8,2,4,16,14,47,-33,10
Crusaders,115,1,16,7,3,62,31,31,55
Coleraine,115,2,15,10,1,47,23,24,55
Glenavon,115,3,9,9,8,53,47,6,36
Linfield,115,4,10,6,10,38,37,1,36
Cliftonville,115,5,9,5,12,33,32,1,32
Ballymena,115,6,7,5,14,26,48,-22,26
Glentoran,115,7,6,6,10,24,32,-8,24
Dungannon,115,8,2,4,16,14,47,-33,10
Crusaders,116,1,17,6,3,62,30,32,57
Coleraine,116,2,14,10,2,45,26,19,52
Glenavon,116,3,10,9,7,56,45,11,39
Linfield,116,4,11,5,10,39,37,2,38
Cliftonville,116,5,9,4,13,33,33,0,31
Ballymena,116,6,7,4,15,25,48,-23,25
Glentoran,116,7,6,6,10,24,32,-8,24
Dungannon,116,8,2,4,16,14,47,-33,10
Coleraine,117,1,15,10,1,46,22,24,55
Crusaders,117,2,16,6,4,62,32,30,54
Glenavon,117,3,9,9,8,52,46,6,36
Linfield,117,4,10,5,11,37,37,0,35
Cliftonville,117,5,10,4,12,33,31,2,34
Ballymena,117,6,8,4,14,27,48,-21,28
Glentoran,117,7,6,6,10,24,32,-8,24
Dungannon,117,8,2,4,16,14,47,-33,10
Crusaders,118,1,17,6,3,62,30,32,57
Coleraine,118,2,15,10,1,46,23,23,55
Glenavon,118,3,9,9,8,53,46,7,36
Linfield,118,4,10,5,11,39,39,0,35
Cliftonville,118,5,10,4,12,35,33,2,34
Ballymena,118,6,7,4,15,25,48,-23,25
Glentoran,118,7,6,6,10,24,32,-8,24
Dungannon,118,8,2,4,16,14,47,-33,10
Crusaders,119,1,16,7,3,62,31,31,55
Coleraine,119,2,14,10,2,45,27,18,52
Glenavon,119,3,10,9,7,57,45,12,39
Linfield,119,4,10,5,11,38,39,-1,35
Cliftonville,119,5,10,4,12,35,32,3,34
Ballymena,119,6,7,5,14,26,48,-22,26
Glentoran,119,7,6,6,10,24,32,-8,24
Dungannon,119,8,2,4,16,14,47,-33,10
Crusaders,120,1,16,7,3,62,31,31,55
Coleraine,120,2,14,11,1,45,24,21,53
Glenavon,120,3,9,10,7,54,45,9,37
Linfield,120,4,10,5,11,38,38,0,35
Cliftonville,120,5,10,4,12,34,32,2,34
Ballymena,120,6,7,5,14,26,48,-22,26
Glentoran,120,7,6,6,10,24,32,-8,24
Dungannon,120,8,2,4,16,14,47,-33,10
Crusaders,121,1,17,6,3,63,31,32,57
Coleraine,121,2,14,11,1,45,24,21,53
Linfield,121,3,11,5,10,39,36,3,38
Glenavon,121,4,9,10,7,54,45,9,37
Cliftonville,121,5,9,4,13,32,33,-1,31
Ballymena,121,6,7,4,15,26,49,-23,25
Glentoran,121,7,6,6,10,24,32,-8,24
Dungannon,121,8,2,4,16,14,47,-33,10
Crusaders,122,1,16,7,3,62,31,31,55
Coleraine,122,2,15,10,1,47,22,25,55
Glenavon,122,3,9,9,8,52,47,5,36
Linfield,122,4,10,6,10,39,38,1,36
Cliftonville,122,5,9,5,12,34,33,1,32
Ballymena,122,6,7,5,14,26,48,-22,26
Glentoran,122,7,6,6,10,24,32,-8,24
Dungannon,122,8,2,4,16,14,47,-33,10
Crusaders,123,1,17,6,3,64,32,32,57
Coleraine,123,2,14,10,2,43,24,19,52
Glenavon,123,3,10,9,7,54,43,11,39
Linfield,123,4,10,6,10,38,37,1,36
Cliftonville,123,5,9,5,12,33,32,1,32
Ballymena,123,6,7,4,15,27,50,-23,25
Glentoran,123,7,6,6,10,24,32,-8,24
Dungannon,123,8,2,4,16,14,47,-33,10
Crusaders,124,1,16,7,3,62,31,31,55
Coleraine,124,2,14,11,1,43,22,21,53
Glenavon,124,3,9,10,7,52,43,9,37
Linfield,124,4,10,6,10,38,37,1,36
Cliftonville,124,5,9,5,12,33,32,1,32
Ballymena,124,6,7,5,14,26,48,-22,26
Glentoran,124,7,6,6,10,24,32,-8,24
Dungannon,124,8,2,4,16,14,47,-33,10
Crusaders,125,1,17,6,3,65,31,34,57
Coleraine,125,2,15,10,1,47,23,24,55
Glenavon,125,3,9,9,8,53,47,6,36
Linfield,125,4,10,5,11,38,39,-1,35
Cliftonville,125,5,10,4,12,35,32,3,34
Ballymena,125,6,7,4,15,26,51,-25,25
Glentoran,125,7,6,6,10,24,32,-8,24
Dungannon,125,8,2,4,16,14,47,-33,10
Crusaders,126,1,16,7,3,63,32,31,55
Coleraine,126,2,14,11,1,44,23,21,53
Linfield,126,3,11,5,10,38,36,2,38
Glenavon,126,4,9,10,7,53,44,9,37
Cliftonville,126,5,9,4,13,32,32,0,31
Ballymena,126,6,7,5,14,27,49,-22,26
Glentoran,126,7,6,6,10,24,32,-8,24
Dungannon,126,8,2,4,16,14,47,-33,10
Crusaders,127,1,17,6,3,63,30,33,57
Coleraine,127,2,14,10,2,43,25,18,52
Glenavon,127,3,10,9,7,55,43,12,39
Linfield,127,4,10,6,10,37,36,1,36
Cliftonville,127,5,9,5,12,32,31,1,32
Ballymena,127,6,7,4,15,25,49,-24,25
Glentoran,127,7,6,6,10,24,32,-8,24
Dungannon,127,8,2,4,16,14,47,-33,10
Crusaders,128,1,16,7,3,62,31,31,55
Coleraine,128,2,14,10,2,43,23,20,52
Glenavon,128,3,10,9,7,53,43,10,39
Linfield,128,4,10,6,10,38,37,1,36
Cliftonville,128,5,9,5,12,33,32,1,32
Ballymena,128,6,7,5,14,26,48,-22,26
Glentoran,128,7,6,6,10,24,32,-8,24
Dungannon,128,8,2,4,16,14,47,-33,10
Crusaders,129,1,17,6,3,66,30,36,57
Coleraine,129,2,15,10,1,47,25,22,55
Glenavon,129,3,9,9,8,55,47,8,36
Linfield,129,4,10,5,11,37,37,0,35
Cliftonville,129,5,10,4,12,33,31,2,34
Ballymena,129,6,7,4,15,25,52,-27,25
Glentoran,129,7,6,6,10,24,32,-8,24
Dungannon,129,8,2,4,16,14,47,-33,10
Crusaders,130,1,17,6,3,62,30,32,57
Coleraine,130,2,14,10,2,44,26,18,52
Glenavon,130,3,10,9,7,56,44,12,39
Linfield,130,4,10,5,11,38,38,0,35
Cliftonville,130,5,10,4,12,34,32,2,34
Ballymena,130,6,7,4,15,25,48,-23,25
Glentoran,130,7,6,6,10,24,32,-8,24
Dungannon,130,8,2,4,16,14,47,-33,10
Crusaders,131,1,17,6,3,63,31,32,57
Coleraine,131,2,14,10,2,44,25,19,52
Glenavon,131,3,10,9,7,55,44,11,39
Linfield,131,4,11,5,10,39,37,2,38
Cliftonville,131,5,9,4,13,33,33,0,31
Ballymena,131,6,7,4,15,26,49,-23,25
Glentoran,131,7,6,6,10,24,32,-8,24
Dungannon,131,8,2,4,16,14,47,-33,10
Crusaders,132,1,17,6,3,62,30,32,57
Coleraine,132,2,14,11,1,44,23,21,53
Linfield,132,3,11,5,10,39,36,3,38
Glenavon,132,4,9,10,7,53,44,9,37
Cliftonville,132,5,9,4,13,32,33,-1,31
Ballymena,132,6,7,4,15,25,48,-23,25
Glentoran,132,7,6,6,10,24,32,-8,24
Dungannon,132,8,2,4,16,14,47,-33,10
Crusaders,133,1,17,6,3,63,31,32,57
Coleraine,133,2,14,10,2,44,24,20,52
Glenavon,133,3,10,9,7,54,44,10,39
Linfield,133,4,10,5,11,37,38,-1,35
Cliftonville,133,5,10,4,12,34,31,3,34
Ballymena,133,6,7,4,15,26,49,-23,25
Glentoran,133,7,6,6,10,24,32,-8,24
Dungannon,133,8,2,4,16,14,47,-33,10
Crusaders,134,1,17,6,3,64,31,33,57
Coleraine,134,2,14,11,1,44,23,21,53
Glenavon,134,3,9,10,7,53,44,9,37
Linfield,134,4,10,5,11,38,38,0,35
Cliftonville,134,5,10,4,12,34,32,2,34
Ballymena,134,6,7,4,15,26,50,-24,25
Glentoran,134,7,6,6,10,24,32,-8,24
Dungannon,134,8,2,4,16,14,47,-33,10
Crusaders,135,1,16,7,3,63,32,31,55
Coleraine,135,2,15,10,1,45,23,22,55
Linfield,135,3,11,5,10,40,37,3,38
Glenavon,135,4,9,9,8,53,45,8,36
Cliftonville,135,5,9,4,13,33,34,-1,31
Ballymena,135,6,7,5,14,27,49,-22,26
Glentoran,135,7,6,6,10,24,32,-8,24
Dungannon,135,8,2,4,16,14,47,-33,10
Crusaders,136,1,16,6,4,62,33,29,54
Coleraine,136,2,14,10,2,44,24,20,52
Glenavon,136,3,10,9,7,54,44,10,39
Linfield,136,4,11,5,10,39,36,3,38
Cliftonville,136,5,9,4,13,32,33,-1,31
Ballymena,136,6,8,4,14,28,48,-20,28
Glentoran,136,7,6,6,10,24,32,-8,24
Dungannon,136,8,2,4,16,14,47,-33,10
Crusaders,137,1,17,6,3,64,30,34,57
Coleraine,137,2,15,10,1,44,22,22,55
Glenavon,137,3,9,9,8,52,44,8,36
Linfield,137,4,10,5,11,38,39,-1,35
Cliftonville,137,5,10,4,12,35,32,3,34
Ballymena,137,6,7,4,15,25,50,-25,25
Glentoran,137,7,6,6,10,24,32,-8,24
Dungannon,137,8,2,4,16,14,47,-33,10
Crusaders,138,1,16,7,3,62,31,31,55
Coleraine,138,2,14,10,2,43,24,19,52
Glenavon,138,3,10,9,7,54,43,11,39
Linfield,138,4,10,5,11,39,40,-1,35
Cliftonville,138,5,10,4,12,36,33,3,34
Ballymena,138,6,7,5,14,26,48,-22,26
Glentoran,138,7,6,6,10,24,32,-8,24
Dungannon,138,8,2,4,16,14,47,-33,10
Crusaders,139,1,16,7,3,63,32,31,55
Coleraine,139,2,14,10,2,45,26,19,52
Glenavon,139,3,10,9,7,56,45,11,39
Linfield,139,4,11,5,10,40,37,3,38
Cliftonville,139,5,9,4,13,33,34,-1,31
Ballymena,139,6,7,5,14,27,49,-22,26
Glentoran,139,7,6,6,10,24,32,-8,24
Dungannon,139,8,2,4,16,14,47,-33,10
Crusaders,140,1,17,6,3,65,32,33,57
Coleraine,140,2,15,10,1,45,23,22,55
Glenavon,140,3,9,9,8,53,45,8,36
Linfield,140,4,10,5,11,37,37,0,35
Cliftonville,140,5,10,4,12,33,31,2,34
Ballymena,140,6,7,4,15,27,51,-24,25
Glentoran,140,7,6,6,10,24,32,-8,24
Dungannon,140,8,2,4,16,14,47,-33,10
Crusaders,141,1,16,7,3,61,30,31,55
Coleraine,141,2,14,10,2,44,27,17,52
Glenavon,141,3,10,9,7,57,44,13,39
Linfield,141,4,10,5,11,37,38,-1,35
Cliftonville,141,5,10,4,12,34,31,3,34
Ballymena,141,6,7,5,14,25,47,-22,26
Glentoran,141,7,6,6,10,24,32,-8,24
Dungannon,141,8,2,4,16,14,47,-33,10
Crusaders,142,1,17,6,3,62,30,32,57
Coleraine,142,2,15,10,1,45,23,22,55
Linfield,142,3,11,5,10,41,36,5,38
Glenavon,142,4,9,9,8,53,45,8,36
Cliftonville,142,5,9,4,13,32,35,-3,31
Ballymena,142,6,7,4,15,25,48,-23,25
Glentoran,142,7,6,6,10,24,32,-8,24
Dungannon,142,8,2,4,16,14,47,-33,10
Crusaders,143,1,16,7,3,63,32,31,55
Coleraine,143,2,14,10,2,43,25,18,52
Glenavon,143,3,10,9,7,55,43,12,39
Linfield,143,4,10,6,10,37,36,1,36
Cliftonville,143,5,9,5,12,32,31,1,32
Ballymena,143,6,7,5,14,27,49,-22,26
Glentoran,143,7,6,6,10,24,32,-8,24
Dungannon,143,8,2,4,16,14,47,-33,10
Crusaders,144,1,17,6,3,64,30,34,57
Coleraine,144,2,15,10,1,46,23,23,55
Glenavon,144,3,9,9,8,53,46,7,36
Linfield,144,4,10,6,10,37,36,1,36
Cliftonville,144,5,9,5,12,32,31,1,32
Ballymena,144,6,7,4,15,25,50,-25,25
Glentoran,144,7,6,6,10,24,32,-8,24
Dungannon,144,8,2,4,16,14,47,-33,10
Crusaders,145,1,17,6,3,64,31,33,57
Coleraine,145,2,15,10,1,44,22,22,55
Glenavon,145,3,9,9,8,52,44,8,36
Linfield,145,4,10,5,11,38,38,0,35
Cliftonville,145,5,10,4,12,34,32,2,34
Ballymena,145,6,7,4,15,26,50,-24,25
Glentoran,145,7,6,6,10,24,32,-8,24
Dungannon,145,8,2,4,16,14,47,-33,10
Crusaders,146,1,16,7,3,61,30,31,55
Coleraine,146,2,14,10,2,43,23,20,52
Glenavon,146,3,10,9,7,53,43,10,39
Linfield,146,4,10,5,11,37,37,0,35
Cliftonville,146,5,10,4,12,33,31,2,34
Ballymena,146,6,7,5,14,25,47,-22,26
Glentoran,146,7,6,6,10,24,32,-8,24
Dungannon,146,8,2,4,16,14,47,-33,10
Crusaders,147,1,16,7,3,61,30,31,55
Coleraine,147,2,14,10,2,44,25,19,52
Glenavon,147,3,10,9,7,55,44,11,39
Linfield,147,4,11,5,10,38,36,2,38
Cliftonville,147,5,9,4,13,32,32,0,31
Ballymena,147,6,7,5,14,25,47,-22,26
Glentoran,147,7,6,6,10,24,32,-8,24
Dungannon,147,8,2,4,16,14,47,-33,10
Crusaders,148,1,16,7,3,63,32,31,55
Coleraine,148,2,15,10,1,45,22,23,55
Glenavon,148,3,9,9,8,52,45,7,36
Linfield,148,4,10,6,10,39,38,1,36
Cliftonville,148,5,9,5,12,34,33,1,32
Ballymena,148,6,7,5,14,27,49,-22,26
Glentoran,148,7,6,6,10,24,32,-8,24
Dungannon,148,8,2,4,16,14,47,-33,10
Crusaders,149,1,17,6,3,63,31,32,57
Coleraine,149,2,14,11,1,44,23,21,53
Linfield,149,3,11,5,10,39,37,2,38
Glenavon,149,4,9,10,7,53,44,9,37
Cliftonville,149,5,9,4,13,33,33,0,31
Ballymena,149,6,7,4,15,26,49,-23,25
Glentoran,149,7,6,6,10,24,32,-8,24
Dungannon,149,8,2,4,16,14,47,-33,10
Crusaders,150,1,16,7,3,61,30,31,55
Coleraine,150,2,14,10,2,44,24,20,52
Glenavon,150,3,10,9,7,54,44,10,39
Linfield,150,4,11,5,10,38,36,2,38
Cliftonville,150,5,9,4,13,32,32,0,31
Ballymena,150,6,7,5,14,25,47,-22,26
Glentoran,150,7,6,6,10,24,32,-8,24
Dungannon,150,8,2,4,16,14,47,-33,10
Crusaders,151,1,17,6,3,64,30,34,57
Coleraine,151,2,15,10,1,45,23,22,55
Glenavon,151,3,9,9,8,53,45,8,36
Linfield,151,4,10,5,11,37,38,-1,35
Cliftonville,151,5,10,4,12,34,31,3,34
Ballymena,151,6,7,4,15,25,50,-25,25
Glentoran,151,7,6,6,10,24,32,-8,24
Dungannon,151,8,2,4,16,14,47,-33,10
Crusaders,152,1,16,6,4,61,32,29,54
Coleraine,152,2,14,10,2,43,25,18,52
Glenavon,152,3,10,9,7,55,43,12,39
Linfield,152,4,10,6,10,37,36,1,36
Cliftonville,152,5,9,5,12,32,31,1,32
Ballymena,152,6,8,4,14,27,47,-20,28
Glentoran,152,7,6,6,10,24,32,-8,24
Dungannon,152,8,2,4,16,14,47,-33,10
Crusaders,153,1,17,6,3,63,31,32,57
Coleraine,153,2,15,10,1,46,22,24,55
Glenavon,153,3,9,9,8,52,46,6,36
Linfield,153,4,10,6,10,39,38,1,36
Cliftonville,153,5,9,5,12,34,33,1,32
Ballymena,153,6,7,4,15,26,49,-23,25
Glentoran,153,7,6,6,10,24,32,-8,24
Dungannon,153,8,2,4,16,14,47,-33,10
Crusaders,154,1,16,7,3,62,31,31,55
Coleraine,154,2,15,10,1,46,22,24,55
Glenavon,154,3,9,9,8,52,46,6,36
Linfield,154,4,10,5,11,37,37,0,35
Cliftonville,154,5,10,4,12,33,31,2,34
Ballymena,154,6,7,5,14,26,48,-22,26
Glentoran,154,7,6,6,10,24,32,-8,24
Dungannon,154,8,2,4,16,14,47,-33,10
Crusaders,155,1,17,6,3,63,31,32,57
Coleraine,155,2,14,11,1,44,23,21,53
Linfield,155,3,11,5,10,39,37,2,38
Glenavon,155,4,9,10,7,53,44,9,37
Cliftonville,155,5,9,4,13,33,33,0,31
Ballymena,155,6,7,4,15,26,49,-23,25
Glentoran,155,7,6,6,10,24,32,-8,24
Dungannon,155,8,2,4,16,14,47,-33,10
Crusaders,156,1,16,7,3,62,31,31,55
Coleraine,156,2,14,10,2,44,24,20,52
Glenavon,156,3,10,9,7,54,44,10,39
Linfield,156,4,10,5,11,37,38,-1,35
Cliftonville,156,5,10,4,12,34,31,3,34
Ballymena,156,6,7,5,14,26,48,-22,26
Glentoran,156,7,6,6,10,24,32,-8,24
Dungannon,156,8,2,4,16,14,47,-33,10
Crusaders,157,1,16,6,4,61,32,29,54
Coleraine,157,2,14,11,1,44,23,21,53
Glenavon,157,3,9,10,7,53,44,9,37
Linfield,157,4,10,6,10,38,37,1,36
Cliftonville,157,5,9,5,12,33,32,1,32
Ballymena,157,6,8,4,14,27,47,-20,28
Glentoran,157,7,6,6,10,24,32,-8,24
Dungannon,157,8,2,4,16,14,47,-33,10
Crusaders,158,1,17,6,3,65,30,35,57
Coleraine,158,2,14,10,2,43,23,20,52
Glenavon,158,3,10,9,7,53,43,10,39
Linfield,158,4,11,5,10,39,36,3,38
Cliftonville,158,5,9,4,13,32,33,-1,31
Ballymena,158,6,7,4,15,25,51,-26,25
Glentoran,158,7,6,6,10,24,32,-8,24
Dungannon,158,8,2,4,16,14,47,-33,10
Crusaders,159,1,16,6,4,62,32,30,54
Coleraine,159,2,14,11,1,44,23,21,53
Linfield,159,3,11,5,10,39,36,3,38
Glenavon,159,4,9,10,7,53,44,9,37
Cliftonville,159,5,9,4,13,32,33,-1,31
Ballymena,159,6,8,4,14,27,48,-21,28
Glentoran,159,7,6,6,10,24,32,-8,24
Dungannon,159,8,2,4,16,14,47,-33,10
Crusaders,160,1,17,6,3,62,30,32,57
Coleraine,160,2,14,10,2,44,26,18,52
Glenavon,160,3,10,9,7,56,44,12,39
Linfield,160,4,10,6,10,39,38,1,36
Cliftonville,160,5,9,5,12,34,33,1,32
Ballymena,160,6,7,4,15,25,48,-23,25
Glentoran,160,7,6,6,10,24,32,-8,24
Dungannon,160,8,2,4,16,14,47,-33,10
Crusaders,161,1,17,6,3,62,30,32,57
Coleraine,161,2,15,10,1,45,23,22,55
Glenavon,161,3,9,9,8,53,45,8,36
Linfield,161,4,10,5,11,38,38,0,35
Cliftonville,161,5,10,4,12,34,32,2,34
Ballymena,161,6,7,4,15,25,48,-23,25
Glentoran,161,7,6,6,10,24,32,-8,24
Dungannon,161,8,2,4,16,14,47,-33,10
Crusaders,162,1,17,6,3,62,30,32,57
Coleraine,162,2,14,10,2,43,24,19,52
Glenavon,162,3,10,9,7,54,43,11,39
Linfield,162,4,11,5,10,39,36,3,38
Cliftonville,162,5,9,4,13,32,33,-1,31
Ballymena,162,6,7,4,15,25,48,-23,25
Glentoran,162,7,6,6,10,24,32,-8,24
Dungannon,162,8,2,4,16,14,47,-33,10
Crusaders,163,1,17,6,3,62,30,32,57
Coleraine,163,2,15,10,1,45,23,22,55
Linfield,163,3,11,5,10,39,37,2,38
Glenavon,163,4,9,9,8,53,45,8,36
Cliftonville,163,5,9,4,13,33,33,0,31
Ballymena,163,6,7,4,15,25,48,-23,25
Glentoran,163,7,6,6,10,24,32,-8,24
Dungannon,163,8,2,4,16,14,47,-33,10
Crusaders,164,1,16,6,4,61,34,27,54
Coleraine,164,2,14,10,2,44,24,20,52
Glenavon,164,3,10,9,7,54,44,10,39
Linfield,164,4,11,5,10,39,36,3,38
Cliftonville,164,5,9,4,13,32,33,-1,31
Ballymena,164,6,8,4,14,29,47,-18,28
Glentoran,164,7,6,6,10,24,32,-8,24
Dungannon,164,8,2,4,16,14,47,-33,10
Crusaders,165,1,16,7,3,65,34,31,55
Coleraine,165,2,15,10,1,45,22,23,55
Glenavon,165,3,9,9,8,52,45,7,36
Linfield,165,4,10,6,10,37,36,1,36
Cliftonville,165,5,9,5,12,32,31,1,32
Ballymena,165,6,7,5,14,29,51,-22,26
Glentoran,165,7,6,6,10,24,32,-8,24
Dungannon,165,8,2,4,16,14,47,-33,10
Crusaders,166,1,17,6,3,63,31,32,57
Coleraine,166,2,14,10,2,44,25,19,52
Glenavon,166,3,10,9,7,55,44,11,39
Linfield,166,4,11,5,10,40,37,3,38
Cliftonville,166,5,9,4,13,33,34,-1,31
Ballymena,166,6,7,4,15,26,49,-23,25
Glentoran,166,7,6,6,10,24,32,-8,24
Dungannon,166,8,2,4,16,14,47,-33,10
Crusaders,167,1,17,6,3,63,30,33,57
Coleraine,167,2,15,10,1,44,22,22,55
Glenavon,167,3,9,9,8,52,44,8,36
Linfield,167,4,10,6,10,40,39,1,36
Cliftonville,167,5,9,5,12,35,34,1,32
Ballymena,167,6,7,4,15,25,49,-24,25
Glentoran,167,7,6,6,10,24,32,-8,24
Dungannon,167,8,2,4,16,14,47,-33,10
Crusaders,168,1,17,6,3,62,30,32,57
Coleraine,168,2,14,10,2,44,26,18,52
Glenavon,168,3,10,9,7,56,44,12,39
Linfield,168,4,10,6,10,38,37,1,36
Cliftonville,168,5,9,5,12,33,32,1,32
Ballymena,168,6,7,4,15,25,48,-23,25
Glentoran,168,7,6,6,10,24,32,-8,24
Dungannon,168,8,2,4,16,14,47,-33,10
Crusaders,169,1,16,7,3,62,31,31,55
Coleraine,169,2,15,10,1,44,22,22,55
Linfield,169,3,11,5,10,39,36,3,38
Glenavon,169,4,9,9,8,52,44,8,36
Cliftonville,169,5,9,4,13,32,33,-1,31
Ballymena,169,6,7,5,14,26,48,-22,26
Glentoran,169,7,6,6,10,24,32,-8,24
Dungannon,169,8,2,4,16,14,47,-33,10
Crusaders,170,1,17,6,3,63,31,32,57
Coleraine,170,2,14,11,1,45,24,21,53
Linfield,170,3,11,5,10,41,36,5,38
Glenavon,170,4,9,10,7,54,45,9,37
Cliftonville,170,5,9,4,13,32,35,-3,31
Ballymena,170,6,7,4,15,26,49,-23,25
Glentoran,170,7,6,6,10,24,32,-8,24
Dungannon,170,8,2,4,16,14,47,-33,10
Crusaders,171,1,17,6,3,64,32,32,57
Coleraine,171,2,14,10,2,43,26,17,52
Glenavon,171,3,10,9,7,56,43,13,39
Linfield,171,4,11,5,10,42,38,4,38
Cliftonville,171,5,9,4,13,34,36,-2,31
Ballymena,171,6,7,4,15,27,50,-23,25
Glentoran,171,7,6,6,10,24,32,-8,24
Dungannon,171,8,2,4,16,14,47,-33,10
Crusaders,172,1,17,6,3,64,31,33,57
Coleraine,172,2,15,10,1,46,23,23,55
Glenavon,172,3,9,9,8,53,46,7,36
Linfield,172,4,10,6,10,37,36,1,36
Cliftonville,172,5,9,5,12,32,31,1,32
Ballymena,172,6,7,4,15,26,50,-24,25
Glentoran,172,7,6,6,10,24,32,-8,24
Dungannon,172,8,2,4,16,14,47,-33,10
Crusaders,173,1,17,6,3,65,30,35,57
Coleraine,173,2,14,11,1,45,24,21,53
Linfield,173,3,11,5,10,41,39,2,38
Glenavon,173,4,9,10,7,54,45,9,37
Cliftonville,173,5,9,4,13,35,35,0,31
Ballymena,173,6,7,4,15,25,51,-26,25
Glentoran,173,7,6,6,10,24,32,-8,24
Dungannon,173,8,2,4,16,14,47,-33,10
Crusaders,174,1,17,6,3,64,30,34,57
Coleraine,174,2,14,11,1,43,22,21,53
Glenavon,174,3,9,10,7,52,43,9,37
Linfield,174,4,10,6,10,38,37,1,36
Cliftonville,174,5,9,5,12,33,32,1,32
Ballymena,174,6,7,4,15,25,50,-25,25
Glentoran,174,7,6,6,10,24,32,-8,24
Dungannon,174,8,2,4,16,14,47,-33,10
Crusaders,175,1,16,6,4,62,32,30,54
Coleraine,175,2,14,10,2,46,26,20,52
Glenavon,175,3,10,9,7,56,46,10,39
Linfield,175,4,10,5,11,38,39,-1,35
Cliftonville,175,5,10,4,12,35,32,3,34
Ballymena,175,6,8,4,14,27,48,-21,28
Glentoran,175,7,6,6,10,24,32,-8,24
Dungannon,175,8,2,4,16,14,47,-33,10
Crusaders,176,1,16,7,3,62,31,31,55
Coleraine,176,2,14,11,1,44,23,21,53
Glenavon,176,3,9,10,7,53,44,9,37
Linfield,176,4,10,5,11,37,39,-2,35
Cliftonville,176,5,10,4,12,35,31,4,34
Ballymena,176,6,7,5,14,26,48,-22,26
Glentoran,176,7,6,6,10,24,32,-8,24
Dungannon,176,8,2,4,16,14,47,-33,10
Crusaders,177,1,17,6,3,64,31,33,57
Coleraine,177,2,15,10,1,45,23,22,55
Linfield,177,3,11,5,10,40,37,3,38
Glenavon,177,4,9,9,8,53,45,8,36
Cliftonville,177,5,9,4,13,33,34,-1,31
Ballymena,177,6,7,4,15,26,50,-24,25
Glentoran,177,7,6,6,10,24,32,-8,24
Dungannon,177,8,2,4,16,14,47,-33,10
Crusaders,178,1,17,6,3,63,31,32,57
Coleraine,178,2,14,10,2,43,25,18,52
Glenavon,178,3,10,9,7,55,43,12,39
Linfield,178,4,10,5,11,37,37,0,35
Cliftonville,178,5,10,4,12,33,31,2,34
Ballymena,178,6,7,4,15,26,49,-23,25
Glentoran,178,7,6,6,10,24,32,-8,24
Dungannon,178,8,2,4,16,14,47,-33,10
Crusaders,179,1,16,6,4,62,32,30,54
Coleraine,179,2,14,11,1,44,23,21,53
Linfield,179,3,11,5,10,40,37,3,38
Glenavon,179,4,9,10,7,53,44,9,37
Cliftonville,179,5,9,4,13,33,34,-1,31
Ballymena,179,6,8,4,14,27,48,-21,28
Glentoran,179,7,6,6,10,24,32,-8,24
Dungannon,179,8,2,4,16,14,47,-33,10
Crusaders,180,1,17,6,3,65,32,33,57
Coleraine,180,2,14,10,2,44,24,20,52
Glenavon,180,3,10,9,7,54,44,10,39
Linfield,180,4,11,5,10,38,36,2,38
Cliftonville,180,5,9,4,13,32,32,0,31
Ballymena,180,6,7,4,15,27,51,-24,25
Glentoran,180,7,6,6,10,24,32,-8,24
Dungannon,180,8,2,4,16,14,47,-33,10
Crusaders,181,1,17,6,3,62,30,32,57
Coleraine,181,2,14,10,2,44,24,20,52
Glenavon,181,3,10,9,7,54,44,10,39
Linfield,181,4,10,5,11,37,37,0,35
Cliftonville,181,5,10,4,12,33,31,2,34
Ballymena,181,6,7,4,15,25,48,-23,25
Glentoran,181,7,6,6,10,24,32,-8,24
Dungannon,181,8,2,4,16,14,47,-33,10
Crusaders,182,1,17,6,3,63,31,32,57
Coleraine,182,2,14,10,2,44,24,20,52
Glenavon,182,3,10,9,7,54,44,10,39
Linfield,182,4,10,6,10,37,36,1,36
Cliftonville,182,5,9,5,12,32,31,1,32
Ballymena,182,6,7,4,15,26,49,-23,25
Glentoran,182,7,6,6,10,24,32,-8,24
Dungannon,182,8,2,4,16,14,47,-33,10
Crusaders,183,1,17,6,3,64,31,33,57
Coleraine,183,2,15,10,1,44,22,22,55
Glenavon,183,3,9,9,8,52,44,8,36
Linfield,183,4,10,6,10,37,36,1,36
Cliftonville,183,5,9,5,12,32,31,1,32
Ballymena,183,6,7,4,15,26,50,-24,25
Glentoran,183,7,6,6,10,24,32,-8,24
Dungannon,183,8,2,4,16,14,47,-33,10
Crusaders,184,1,16,6,4,63,33,30,54
Coleraine,184,2,14,10,2,43,25,18,52
Glenavon,184,3,10,9,7,55,43,12,39
Linfield,184,4,10,5,11,38,38,0,35
Cliftonville,184,5,10,4,12,34,32,2,34
Ballymena,184,6,8,4,14,28,49,-21,28
Glentoran,184,7,6,6,10,24,32,-8,24
Dungannon,184,8,2,4,16,14,47,-33,10
Crusaders,185,1,17,6,3,63,30,33,57
Coleraine,185,2,15,10,1,45,23,22,55
Glenavon,185,3,9,9,8,53,45,8,36
Linfield,185,4,10,5,11,37,37,0,35
Cliftonville,185,5,10,4,12,33,31,2,34
Ballymena,185,6,7,4,15,25,49,-24,25
Glentoran,185,7,6,6,10,24,32,-8,24
Dungannon,185,8,2,4,16,14,47,-33,10
Crusaders,186,1,16,6,4,62,33,29,54
Coleraine,186,2,14,10,2,43,24,19,52
Glenavon,186,3,10,9,7,54,43,11,39
Linfield,186,4,11,5,10,38,36,2,38
Cliftonville,186,5,9,4,13,32,32,0,31
Ballymena,186,6,8,4,14,28,48,-20,28
Glentoran,186,7,6,6,10,24,32,-8,24
Dungannon,186,8,2,4,16,14,47,-33,10
Crusaders,187,1,16,6,4,61,31,30,54
Coleraine,187,2,14,11,1,44,23,21,53
Linfield,187,3,11,5,10,39,36,3,38
Glenavon,187,4,9,10,7,53,44,9,37
Cliftonville,187,5,9,4,13,32,33,-1,31
Ballymena,187,6,8,4,14,26,47,-21,28
Glentoran,187,7,6,6,10,24,32,-8,24
Dungannon,187,8,2,4,16,14,47,-33,10
Crusaders,188,1,17,6,3,65,30,35,57
Coleraine,188,2,14,10,2,45,26,19,52
Glenavon,188,3,10,9,7,56,45,11,39
Linfield,188,4,10,5,11,37,38,-1,35
Cliftonville,188,5,10,4,12,34,31,3,34
Ballymena,188,6,7,4,15,25,51,-26,25
Glentoran,188,7,6,6,10,24,32,-8,24
Dungannon,188,8,2,4,16,14,47,-33,10
Crusaders,189,1,17,6,3,63,31,32,57
Coleraine,189,2,15,10,1,44,22,22,55
Glenavon,189,3,9,9,8,52,44,8,36
Linfield,189,4,10,6,10,38,37,1,36
Cliftonville,189,5,9,5,12,33,32,1,32
Ballymena,189,6,7,4,15,26,49,-23,25
Glentoran,189,7,6,6,10,24,32,-8,24
Dungannon,189,8,2,4,16,14,47,-33,10
Crusaders,190,1,17,6,3,64,31,33,57
Coleraine,190,2,14,11,1,44,23,21,53
Linfield,190,3,11,5,10,41,38,3,38
Glenavon,190,4,9,10,7,53,44,9,37
Cliftonville,190,5,9,4,13,34,35,-1,31
Ballymena,190,6,7,4,15,26,50,-24,25
Glentoran,190,7,6,6,10,24,32,-8,24
Dungannon,190,8,2,4,16,14,47,-33,10
Crusaders,191,1,17,6,3,66,31,35,57
Coleraine,191,2,15,10,1,46,24,22,55
Linfield,191,3,11,5,10,40,36,4,38
Glenavon,191,4,9,9,8,54,46,8,36
Cliftonville,191,5,9,4,13,32,34,-2,31
Ballymena,191,6,7,4,15,26,52,-26,25
Glentoran,191,7,6,6,10,24,32,-8,24
Dungannon,191,8,2,4,16,14,47,-33,10
Crusaders,192,1,16,7,3,63,32,31,55
Coleraine,192,2,14,10,2,44,24,20,52
Glenavon,192,3,10,9,7,54,44,10,39
Linfield,192,4,10,5,11,37,37,0,35
Cliftonville,192,5,10,4,12,33,31,2,34
Ballymena,192,6,7,5,14,27,49,-22,26
Glentoran,192,7,6,6,10,24,32,-8,24
Dungannon,192,8,2,4,16,14,47,-33,10
Crusaders,193,1,16,7,3,63,32,31,55
Coleraine,193,2,14,11,1,43,22,21,53
Glenavon,193,3,9,10,7,52,43,9,37
Linfield,193,4,10,5,11,37,39,-2,35
Cliftonville,193,5,10,4,12,35,31,4,34
Ballymena,193,6,7,5,14,27,49,-22,26
Glentoran,193,7,6,6,10,24,32,-8,24
Dungannon,193,8,2,4,16,14,47,-33,10
Crusaders,194,1,17,6,3,62,30,32,57
Coleraine,194,2,14,10,2,44,25,19,52
Glenavon,194,3,10,9,7,55,44,11,39
Linfield,194,4,10,6,10,37,36,1,36
Cliftonville,194,5,9,5,12,32,31,1,32
Ballymena,194,6,7,4,15,25,48,-23,25
Glentoran,194,7,6,6,10,24,32,-8,24
Dungannon,194,8,2,4,16,14,47,-33,10
Crusaders,195,1,16,6,4,61,32,29,54
Coleraine,195,2,14,11,1,44,23,21,53
Linfield,195,3,11,5,10,41,38,3,38
Glenavon,195,4,9,10,7,53,44,9,37
Cliftonville,195,5,9,4,13,34,35,-1,31
Ballymena,195,6,8,4,14,27,47,-20,28
Glentoran,195,7,6,6,10,24,32,-8,24
Dungannon,195,8,2,4,16,14,47,-33,10
Crusaders,196,1,17,6,3,65,30,35,57
Coleraine,196,2,14,10,2,45,26,19,52
Glenavon,196,3,10,9,7,56,45,11,39
Linfield,196,4,10,6,10,37,36,1,36
Cliftonville,196,5,9,5,12,32,31,1,32
Ballymena,196,6,7,4,15,25,51,-26,25
Glentoran,196,7,6,6,10,24,32,-8,24
Dungannon,196,8,2,4,16,14,47,-33,10
Crusaders,197,1,16,6,4,61,31,30,54
Coleraine,197,2,14,10,2,46,26,20,52
Glenavon,197,3,10,9,7,56,46,10,39
Linfield,197,4,10,6,10,39,38,1,36
Cliftonville,197,5,9,5,12,34,33,1,32
Ballymena,197,6,8,4,14,26,47,-21,28
Glentoran,197,7,6,6,10,24,32,-8,24
Dungannon,197,8,2,4,16,14,47,-33,10
Crusaders,198,1,16,7,3,61,30,31,55
Coleraine,198,2,15,10,1,47,22,25,55
Glenavon,198,3,9,9,8,52,47,5,36
Linfield,198,4,10,5,11,38,39,-1,35
Cliftonville,198,5,10,4,12,35,32,3,34
Ballymena,198,6,7,5,14,25,47,-22,26
Glentoran,198,7,6,6,10,24,32,-8,24
Dungannon,198,8,2,4,16,14,47,-33,10
Crusaders,199,1,17,6,3,62,30,32,57
Coleraine,199,2,14,10,2,45,25,20,52
Glenavon,199,3,10,9,7,55,45,10,39
Linfield,199,4,10,5,11,37,37,0,35
Cliftonville,199,5,10,4,12,33,31,2,34
Ballymena,199,6,7,4,15,25,48,-23,25
Glentoran,199,7,6,6,10,24,32,-8,24
Dungannon,199,8,2,4,16,14,47,-33,10
Coleraine,200,1,15,10,1,45,23,22,55
Crusaders,200,2,16,6,4,63,33,30,54
Linfield,200,3,11,5,10,38,36,2,38
Glenavon,200,4,9,9,8,53,45,8,36
Cliftonville,200,5,9,4,13,32,32,0,31
Ballymena,200,6,8,4,14,28,49,-21,28
Glentoran,200,7,6,6,10,24,32,-8,24
Dungannon,200,8,2,4,16,14,47,-33,10
Crusaders,201,1,17,6,3,65,30,35,57
Coleraine,201,2,15,10,1,46,24,22,55
Glenavon,201,3,9,9,8,54,46,8,36
Linfield,201,4,10,6,10,38,37,1,36
Cliftonville,201,5,9,5,12,33,32,1,32
Ballymena,201,6,7,4,15,25,51,-26,25
Glentoran,201,7,6,6,10,24,32,-8,24
Dungannon,201,8,2,4,16,14,47,-33,10
Crusaders,202,1,16,6,4,61,31,30,54
Coleraine,202,2,14,10,2,43,23,20,52
Glenavon,202,3,10,9,7,53,43,10,39
Linfield,202,4,10,5,11,37,39,-2,35
Cliftonville,202,5,10,4,12,35,31,4,34
Ballymena,202,6,8,4,14,26,47,-21,28
Glentoran,202,7,6,6,10,24,32,-8,24
Dungannon,202,8,2,4,16,14,47,-33,10
Crusaders,203,1,17,6,3,65,32,33,57
Coleraine,203,2,15,10,1,47,23,24,55
Glenavon,203,3,9,9,8,53,47,6,36
Linfield,203,4,10,5,11,37,37,0,35
Cliftonville,203,5,10,4,12,33,31,2,34
Ballymena,203,6,7,4,15,27,51,-24,25
Glentoran,203,7,6,6,10,24,32,-8,24
Dungannon,203,8,2,4,16,14,47,-33,10
Crusaders,204,1,17,6,3,62,30,32,57
Coleraine,204,2,15,10,1,45,23,22,55
Linfield,204,3,11,5,10,39,37,2,38
Glenavon,204,4,9,9,8,53,45,8,36
Cliftonville,204,5,9,4,13,33,33,0,31
Ballymena,204,6,7,4,15,25,48,-23,25
Glentoran,204,7,6,6,10,24,32,-8,24
Dungannon,204,8,2,4,16,14,47,-33,10
Coleraine,205,1,15,10,1,45,23,22,55
Crusaders,205,2,16,6,4,63,34,29,54
Glenavon,205,3,9,9,8,53,45,8,36
Linfield,205,4,10,6,10,37,36,1,36
Cliftonville,205,5,9,5,12,32,31,1,32
Ballymena,205,6,8,4,14,29,49,-20,28
Glentoran,205,7,6,6,10,24,32,-8,24
Dungannon,205,8,2,4,16,14,47,-33,10
Crusaders,206,1,16,6,4,62,32,30,54
Coleraine,206,2,14,10,2,44,24,20,52
Glenavon,206,3,10,9,7,54,44,10,39
Linfield,206,4,11,5,10,40,37,3,38
Cliftonville,206,5,9,4,13,33,34,-1,31
Ballymena,206,6,8,4,14,27,48,-21,28
Glentoran,206,7,6,6,10,24,32,-8,24
Dungannon,206,8,2,4,16,14,47,-33,10
Crusaders,207,1,17,6,3,63,30,33,57
Coleraine,207,2,14,10,2,44,24,20,52
Glenavon,207,3,10,9,7,54,44,10,39
Linfield,207,4,10,5,11,38,38,0,35
Cliftonville,207,5,10,4,12,34,32,2,34
Ballymena,207,6,7,4,15,25,49,-24,25
Glentoran,207,7,6,6,10,24,32,-8,24
Dungannon,207,8,2,4,16,14,47,-33,10
Crusaders,208,1,17,6,3,62,30,32,57
Coleraine,208,2,14,11,1,45,24,21,53
Linfield,208,3,11,5,10,39,37,2,38
Glenavon,208,4,9,10,7,54,45,9,37
Cliftonville,208,5,9,4,13,33,33,0,31
Ballymena,208,6,7,4,15,25,48,-23,25
Glentoran,208,7,6,6,10,24,32,-8,24
Dungannon,208,8,2,4,16,14,47,-33,10
Crusaders,209,1,16,7,3,61,30,31,55
Coleraine,209,2,15,10,1,45,23,22,55
Linfield,209,3,11,5,10,39,36,3,38
Glenavon,209,4,9,9,8,53,45,8,36
Cliftonville,209,5,9,4,13,32,33,-1,31
Ballymena,209,6,7,5,14,25,47,-22,26
Glentoran,209,7,6,6,10,24,32,-8,24
Dungannon,209,8,2,4,16,14,47,-33,10
Crusaders,210,1,17,6,3,66,31,35,57
Coleraine,210,2,14,10,2,44,25,19,52
Glenavon,210,3,10,9,7,55,44,11,39
Linfield,210,4,11,5,10,39,37,2,38
Cliftonville,210,5,9,4,13,33,33,0,31
Ballymena,210,6,7,4,15,26,52,-26,25
Glentoran,210,7,6,6,10,24,32,-8,24
Dungannon,210,8,2,4,16,14,47,-33,10
Crusaders,211,1,17,6,3,62,30,32,57
Coleraine,211,2,14,10,2,44,24,20,52
Glenavon,211,3,10,9,7,54,44,10,39
Linfield,211,4,10,5,11,39,39,0,35
Cliftonville,211,5,10,4,12,35,33,2,34
Ballymena,211,6,7,4,15,25,48,-23,25
Glentoran,211,7,6,6,10,24,32,-8,24
Dungannon,211,8,2,4,16,14,47,-33,10
Crusaders,212,1,17,6,3,64,31,33,57
Coleraine,212,2,15,10,1,46,24,22,55
Linfield,212,3,11,5,10,38,36,2,38
Glenavon,212,4,9,9,8,54,46,8,36
Cliftonville,212,5,9,4,13,32,32,0,31
Ballymena,212,6,7,4,15,26,50,-24,25
Glentoran,212,7,6,6,10,24,32,-8,24
Dungannon,212,8,2,4,16,14,47,-33,10
Crusaders,213,1,16,6,4,61,32,29,54
Coleraine,213,2,14,11,1,45,24,21,53
Glenavon,213,3,9,10,7,54,45,9,37
Linfield,213,4,10,6,10,38,37,1,36
Cliftonville,213,5,9,5,12,33,32,1,32
Ballymena,213,6,8,4,14,27,47,-20,28
Glentoran,213,7,6,6,10,24,32,-8,24
Dungannon,213,8,2,4,16,14,47,-33,10
Coleraine,214,1,15,10,1,47,22,25,55
Crusaders,214,2,16,6,4,61,31,30,54
Glenavon,214,3,9,9,8,52,47,5,36
Linfield,214,4,10,6,10,38,37,1,36
Cliftonville,214,5,9,5,12,33,32,1,32
Ballymena,214,6,8,4,14,26,47,-21,28
Glentoran,214,7,6,6,10,24,32,-8,24
Dungannon,214,8,2,4,16,14,47,-33,10
Crusaders,215,1,17,6,3,63,31,32,57
Coleraine,215,2,14,11,1,46,25,21,53
Glenavon,215,3,9,10,7,55,46,9,37
Linfield,215,4,10,5,11,37,37,0,35
Cliftonville,215,5,10,4,12,33,31,2,34
Ballymena,215,6,7,4,15,26,49,-23,25
Glentoran,215,7,6,6,10,24,32,-8,24
Dungannon,215,8,2,4,16,14,47,-33,10
Crusaders,216,1,17,6,3,62,30,32,57
Coleraine,216,2,14,11,1,43,22,21,53
Linfield,216,3,11,5,10,39,37,2,38
Glenavon,216,4,9,10,7,52,43,9,37
Cliftonville,216,5,9,4,13,33,33,0,31
Ballymena,216,6,7,4,15,25,48,-23,25
Glentoran,216,7,6,6,10,24,32,-8,24
Dungannon,216,8,2,4,16,14,47,-33,10
Crusaders,217,1,16,7,3,63,32,31,55
Coleraine,217,2,14,10,2,43,24,19,52
Glenavon,217,3,10,9,7,54,43,11,39
Linfield,217,4,10,5,11,37,37,0,35
Cliftonville,217,5,10,4,12,33,31,2,34
Ballymena,217,6,7,5,14,27,49,-22,26
Glentoran,217,7,6,6,10,24,32,-8,24
Dungannon,217,8,2,4,16,14,47,-33,10
Crusaders,218,1,17,6,3,62,30,32,57
Coleraine,218,2,14,10,2,44,24,20,52
Glenavon,218,3,10,9,7,54,44,10,39
Linfield,218,4,10,6,10,38,37,1,36
Cliftonville,218,5,9,5,12,33,32,1,32
Ballymena,218,6,7,4,15,25,48,-23,25
Glentoran,218,7,6,6,10,24,32,-8,24
Dungannon,218,8,2,4,16,14,47,-33,10
Coleraine,219,1,15,10,1,47,23,24,55
Crusaders,219,2,16,6,4,61,32,29,54
Glenavon,219,3,9,9,8,53,47,6,36
Linfield,219,4,10,6,10,37,36,1,36
Cliftonville,219,5,9,5,12,32,31,1,32
Ballymena,219,6,8,4,14,27,47,-20,28
Glentoran,219,7,6,6,10,24,32,-8,24
Dungannon,219,8,2,4,16,14,47,-33,10
Crusaders,220,1,17,6,3,64,31,33,57
Coleraine,220,2,15,10,1,46,24,22,55
Linfield,220,3,11,5,10,40,38,2,38
Glenavon,220,4,9,9,8,54,46,8,36
Cliftonville,220,5,9,4,13,34,34,0,31
Ballymena,220,6,7,4,15,26,50,-24,25
Glentoran,220,7,6,6,10,24,32,-8,24
Dungannon,220,8,2,4,16,14,47,-33,10
Crusaders,221,1,16,6,4,63,34,29,54
Coleraine,221,2,14,11,1,43,22,21,53
Glenavon,221,3,9,10,7,52,43,9,37
Linfield,221,4,10,6,10,38,37,1,36
Cliftonville,221,5,9,5,12,33,32,1,32
Ballymena,221,6,8,4,14,29,49,-20,28
Glentoran,221,7,6,6,10,24,32,-8,24
Dungannon,221,8,2,4,16,14,47,-33,10
Crusaders,222,1,17,6,3,64,30,34,57
Coleraine,222,2,14,10,2,45,25,20,52
Glenavon,222,3,10,9,7,55,45,10,39
Linfield,222,4,11,5,10,38,36,2,38
Cliftonville,222,5,9,4,13,32,32,0,31
Ballymena,222,6,7,4,15,25,50,-25,25
Glentoran,222,7,6,6,10,24,32,-8,24
Dungannon,222,8,2,4,16,14,47,-33,10
Crusaders,223,1,17,6,3,63,31,32,57
Coleraine,223,2,14,10,2,43,24,19,52
Glenavon,223,3,10,9,7,54,43,11,39
Linfield,223,4,10,6,10,38,37,1,36
Cliftonville,223,5,9,5,12,33,32,1,32
Ballymena,223,6,7,4,15,26,49,-23,25
Glentoran,223,7,6,6,10,24,32,-8,24
Dungannon,223,8,2,4,16,14,47,-33,10
Crusaders,224,1,16,7,3,62,31,31,55
Coleraine,224,2,14,11,1,43,22,21,53
Linfield,224,3,11,5,10,39,37,2,38
Glenavon,224,4,9,10,7,52,43,9,37
Cliftonville,224,5,9,4,13,33,33,0,31
Ballymena,224,6,7,5,14,26,48,-22,26
Glentoran,224,7,6,6,10,24,32,-8,24
Dungannon,224,8,2,4,16,14,47,-33,10
Crusaders,225,1,16,6,4,62,32,30,54
Coleraine,225,2,14,10,2,43,23,20,52
Glenavon,225,3,10,9,7,53,43,10,39
Linfield,225,4,11,5,10,38,36,2,38
Cliftonville,225,5,9,4,13,32,32,0,31
Ballymena,225,6,8,4,14,27,48,-21,28
Glentoran,225,7,6,6,10,24,32,-8,24
Dungannon,225,8,2,4,16,14,47,-33,10
Coleraine,226,1,15,10,1,47,24,23,55
Crusaders,226,2,16,6,4,62,32,30,54
Glenavon,226,3,9,9,8,54,47,7,36
Linfield,226,4,10,6,10,37,36,1,36
Cliftonville,226,5,9,5,12,32,31,1,32
Ballymena,226,6,8,4,14,27,48,-21,28
Glentoran,226,7,6,6,10,24,32,-8,24
Dungannon,226,8,2,4,16,14,47,-33,10
Crusaders,227,1,17,6,3,63,31,32,57
Coleraine,227,2,15,10,1,44,22,22,55
Linfield,227,3,11,5,10,39,37,2,38
Glenavon,227,4,9,9,8,52,44,8,36
Cliftonville,227,5,9,4,13,33,33,0,31
Ballymena,227,6,7,4,15,26,49,-23,25
Glentoran,227,7,6,6,10,24,32,-8,24
Dungannon,227,8,2,4,16,14,47,-33,10
Crusaders,228,1,17,6,3,64,32,32,57
Coleraine,228,2,14,10,2,43,24,19,52
Glenavon,228,3,10,9,7,54,43,11,39
Linfield,228,4,11,5,10,40,37,3,38
Cliftonville,228,5,9,4,13,33,34,-1,31
Ballymena,228,6,7,4,15,27,50,-23,25
Glentoran,228,7,6,6,10,24,32,-8,24
Dungannon,228,8,2,4,16,14,47,-33,10
Coleraine,229,1,15,10,1,44,22,22,55
Crusaders,229,2,16,6,4,62,32,30,54
Linfield,229,3,11,5,10,38,36,2,38
Glenavon,229,4,9,9,8,52,44,8,36
Cliftonville,229,5,9,4,13,32,32,0,31
Ballymena,229,6,8,4,14,27,48,-21,28
Glentoran,229,7,6,6,10,24,32,-8,24
Dungannon,229,8,2,4,16,14,47,-33,10
Crusaders,230,1,16,7,3,62,31,31,55
Coleraine,230,2,14,10,2,43,23,20,52
Glenavon,230,3,10,9,7,53,43,10,39
Linfield,230,4,10,6,10,38,37,1,36
Cliftonville,230,5,9,5,12,33,32,1,32
Ballymena,230,6,7,5,14,26,48,-22,26
Glentoran,230,7,6,6,10,24,32,-8,24
Dungannon,230,8,2,4,16,14,47,-33,10
Crusaders,231,1,17,6,3,66,30,36,57
Coleraine,231,2,15,10,1,44,22,22,55
Linfield,231,3,11,5,10,39,37,2,38
Glenavon,231,4,9,9,8,52,44,8,36
Cliftonville,231,5,9,4,13,33,33,0,31
Ballymena,231,6,7,4,15,25,52,-27,25
Glentoran,231,7,6,6,10,24,32,-8,24
Dungannon,231,8,2,4,16,14,47,-33,10
Crusaders,232,1,16,6,4,62,34,28,54
Coleraine,232,2,14,10,2,44,26,18,52
Glenavon,232,3,10,9,7,56,44,12,39
Linfield,232,4,11,5,10,38,36,2,38
Cliftonville,232,5,9,4,13,32,32,0,31
Ballymena,232,6,8,4,14,29,48,-19,28
Glentoran,232,7,6,6,10,24,32,-8,24
Dungannon,232,8,2,4,16,14,47,-33,10
Crusaders,233,1,17,6,3,64,30,34,57
Coleraine,233,2,14,11,1,45,24,21,53
Glenavon,233,3,9,10,7,54,45,9,37
Linfield,233,4,10,6,10,37,36,1,36
Cliftonville,233,5,9,5,12,32,31,1,32
Ballymena,233,6,7,4,15,25,50,-25,25
Glentoran,233,7,6,6,10,24,32,-8,24
Dungannon,233,8,2,4,16,14,47,-33,10
Crusaders,234,1,16,7,3,61,30,31,55
Coleraine,234,2,14,11,1,44,23,21,53
Glenavon,234,3,9,10,7,53,44,9,37
Linfield,234,4,10,6,10,38,37,1,36
Cliftonville,234,5,9,5,12,33,32,1,32
Ballymena,234,6,7,5,14,25,47,-22,26
Glentoran,234,7,6,6,10,24,32,-8,24
Dungannon,234,8,2,4,16,14,47,-33,10
Crusaders,235,1,17,6,3,62,30,32,57
Coleraine,235,2,15,10,1,48,25,23,55
Glenavon,235,3,9,9,8,55,48,7,36
Linfield,235,4,10,5,11,39,39,0,35
Cliftonville,235,5,10,4,12,35,33,2,34
Ballymena,235,6,7,4,15,25,48,-23,25
Glentoran,235,7,6,6,10,24,32,-8,24
Dungannon,235,8,2,4,16,14,47,-33,10
Crusaders,236,1,17,6,3,64,31,33,57
Coleraine,236,2,14,10,2,43,24,19,52
Glenavon,236,3,10,9,7,54,43,11,39
Linfield,236,4,11,5,10,39,36,3,38
Cliftonville,236,5,9,4,13,32,33,-1,31
Ballymena,236,6,7,4,15,26,50,-24,25
Glentoran,236,7,6,6,10,24,32,-8,24
Dungannon,236,8,2,4,16,14,47,-33,10
Crusaders,237,1,16,7,3,61,30,31,55
Coleraine,237,2,14,10,2,44,26,18,52
Glenavon,237,3,10,9,7,56,44,12,39
Linfield,237,4,10,5,11,37,37,0,35
Cliftonville,237,5,10,4,12,33,31,2,34
Ballymena,237,6,7,5,14,25,47,-22,26
Glentoran,237,7,6,6,10,24,32,-8,24
Dungannon,237,8,2,4,16,14,47,-33,10
Crusaders,238,1,16,7,3,62,31,31,55
Coleraine,238,2,15,10,1,48,22,26,55
Linfield,238,3,11,5,10,41,38,3,38
Glenavon,238,4,9,9,8,52,48,4,36
Cliftonville,238,5,9,4,13,34,35,-1,31
Ballymena,238,6,7,5,14,26,48,-22,26
Glentoran,238,7,6,6,10,24,32,-8,24
Dungannon,238,8,2,4,16,14,47,-33,10
Crusaders,239,1,17,6,3,66,30,36,57
Coleraine,239,2,14,11,1,44,23,21,53
Glenavon,239,3,9,10,7,53,44,9,37
Linfield,239,4,10,5,11,37,37,0,35
Cliftonville,239,5,10,4,12,33,31,2,34
Ballymena,239,6,7,4,15,25,52,-27,25
Glentoran,239,7,6,6,10,24,32,-8,24
Dungannon,239,8,2,4,16,14,47,-33,10
Coleraine,240,1,15,10,1,44,22,22,55
Crusaders,240,2,16,6,4,61,32,29,54
Linfield,240,3,11,5,10,39,37,2,38
Glenavon,240,4,9,9,8,52,44,8,36
Cliftonville,240,5,9,4,13,33,33,0,31
Ballymena,240,6,8,4,14,27,47,-20,28
Glentoran,240,7,6,6,10,24,32,-8,24
Dungannon,240,8,2,4,16,14,47,-33,10
Crusaders,241,1,16,7,3,62,31,31,55
Coleraine,241,2,14,10,2,44,24,20,52
Glenavon,241,3,10,9,7,54,44,10,39
Linfield,241,4,11,5,10,39,36,3,38
Cliftonville,241,5,9,4,13,32,33,-1,31
Ballymena,241,6,7,5,14,26,48,-22,26
Glentoran,241,7,6,6,10,24,32,-8,24
Dungannon,241,8,2,4,16,14,47,-33,10
Crusaders,242,1,17,6,3,64,31,33,57
Coleraine,242,2,15,10,1,45,23,22,55
Linfield,242,3,11,5,10,39,37,2,38
Glenavon,242,4,9,9,8,53,45,8,36
Cliftonville,242,5,9,4,13,33,33,0,31
Ballymena,242,6,7,4,15,26,50,-24,25
Glentoran,242,7,6,6,10,24,32,-8,24
Dungannon,242,8,2,4,16,14,47,-33,10
Crusaders,243,1,16,6,4,62,32,30,54
Coleraine,243,2,14,11,1,44,23,21,53
Linfield,243,3,11,5,10,39,37,2,38
Glenavon,243,4,9,10,7,53,44,9,37
Cliftonville,243,5,9,4,13,33,33,0,31
Ballymena,243,6,8,4,14,27,48,-21,28
Glentoran,243,7,6,6,10,24,32,-8,24
Dungannon,243,8,2,4,16,14,47,-33,10
Crusaders,244,1,17,6,3,64,32,32,57
Coleraine,244,2,14,10,2,44,24,20,52
Glenavon,244,3,10,9,7,54,44,10,39
Linfield,244,4,10,5,11,37,37,0,35
Cliftonville,244,5,10,4,12,33,31,2,34
Ballymena,244,6,7,4,15,27,50,-23,25
Glentoran,244,7,6,6,10,24,32,-8,24
Dungannon,244,8,2,4,16,14,47,-33,10
Crusaders,245,1,17,6,3,63,31,32,57
Coleraine,245,2,14,10,2,44,24,20,52
Glenavon,245,3,10,9,7,54,44,10,39
Linfield,245,4,10,6,10,39,38,1,36
Cliftonville,245,5,9,5,12,34,33,1,32
Ballymena,245,6,7,4,15,26,49,-23,25
Glentoran,245,7,6,6,10,24,32,-8,24
Dungannon,245,8,2,4,16,14,47,-33,10
Crusaders,246,1,16,6,4,62,32,30,54
Coleraine,246,2,14,10,2,43,24,19,52
Glenavon,246,3,10,9,7,54,43,11,39
Linfield,246,4,11,5,10,41,38,3,38
Cliftonville,246,5,9,4,13,34,35,-1,31
Ballymena,246,6,8,4,14,27,48,-21,28
Glentoran,246,7,6,6,10,24,32,-8,24
Dungannon,246,8,2,4,16,14,47,-33,10
Crusaders,247,1,16,6,4,63,35,28,54
Coleraine,247,2,14,11,1,43,22,21,53
Linfield,247,3,11,5,10,38,36,2,38
Glenavon,247,4,9,10,7,52,43,9,37
Cliftonville,247,5,9,4,13,32,32,0,31
Ballymena,247,6,8,4,14,30,49,-19,28
Glentoran,247,7,6,6,10,24,32,-8,24
Dungannon,247,8,2,4,16,14,47,-33,10
Crusaders,248,1,17,6,3,66,31,35,57
Coleraine,248,2,14,11,1,44,23,21,53
Glenavon,248,3,9,10,7,53,44,9,37
Linfield,248,4,10,5,11,37,39,-2,35
Cliftonville,248,5,10,4,12,35,31,4,34
Ballymena,248,6,7,4,15,26,52,-26,25
Glentoran,248,7,6,6,10,24,32,-8,24
Dungannon,248,8,2,4,16,14,47,-33,10
Crusaders,249,1,17,6,3,62,30,32,57
Coleraine,249,2,15,10,1,46,23,23,55
Linfield,249,3,11,5,10,38,36,2,38
Glenavon,249,4,9,9,8,53,46,7,36
Cliftonville,249,5,9,4,13,32,32,0,31
Ballymena,249,6,7,4,15,25,48,-23,25
Glentoran,249,7,6,6,10,24,32,-8,24
Dungannon,249,8,2,4,16,14,47,-33,10
Crusaders,250,1,16,7,3,62,31,31,55
Coleraine,250,2,14,11,1,44,23,21,53
Glenavon,250,3,9,10,7,53,44,9,37
Linfield,250,4,10,6,10,39,38,1,36
Cliftonville,250,5,9,5,12,34,33,1,32
Ballymena,250,6,7,5,14,26,48,-22,26
Glentoran,250,7,6,6,10,24,32,-8,24
Dungannon,250,8,2,4,16,14,47,-33,10
Crusaders,251,1,16,6,4,63,35,28,54
Coleraine,251,2,14,11,1,44,23,21,53
Linfield,251,3,11,5,10,42,37,5,38
Glenavon,251,4,9,10,7,53,44,9,37
Cliftonville,251,5,9,4,13,33,36,-3,31
Ballymena,251,6,8,4,14,30,49,-19,28
Glentoran,251,7,6,6,10,24,32,-8,24
Dungannon,251,8,2,4,16,14,47,-33,10
Crusaders,252,1,17,6,3,63,31,32,57
Coleraine,252,2,14,10,2,44,24,20,52
Glenavon,252,3,10,9,7,54,44,10,39
Linfield,252,4,10,5,11,38,38,0,35
Cliftonville,252,5,10,4,12,34,32,2,34
Ballymena,252,6,7,4,15,26,49,-23,25
Glentoran,252,7,6,6,10,24,32,-8,24
Dungannon,252,8,2,4,16,14,47,-33,10
Crusaders,253,1,17,6,3,63,31,32,57
Coleraine,253,2,14,10,2,45,25,20,52
Glenavon,253,3,10,9,7,55,45,10,39
Linfield,253,4,11,5,10,39,36,3,38
Cliftonville,253,5,9,4,13,32,33,-1,31
Ballymena,253,6,7,4,15,26,49,-23,25
Glentoran,253,7,6,6,10,24,32,-8,24
Dungannon,253,8,2,4,16,14,47,-33,10
Crusaders,254,1,16,7,3,62,31,31,55
Coleraine,254,2,15,10,1,44,22,22,55
Glenavon,254,3,9,9,8,52,44,8,36
Linfield,254,4,10,6,10,37,36,1,36
Cliftonville,254,5,9,5,12,32,31,1,32
Ballymena,254,6,7,5,14,26,48,-22,26
Glentoran,254,7,6,6,10,24,32,-8,24
Dungannon,254,8,2,4,16,14,47,-33,10
Crusaders,255,1,16,7,3,62,31,31,55
Coleraine,255,2,14,10,2,43,24,19,52
Glenavon,255,3,10,9,7,54,43,11,39
Linfield,255,4,10,6,10,37,36,1,36
Cliftonville,255,5,9,5,12,32,31,1,32
Ballymena,255,6,7,5,14,26,48,-22,26
Glentoran,255,7,6,6,10,24,32,-8,24
Dungannon,255,8,2,4,16,14,47,-33,10
Crusaders,256,1,17,6,3,63,30,33,57
Coleraine,256,2,14,10,2,45,25,20,52
Glenavon,256,3,10,9,7,55,45,10,39
Linfield,256,4,11,5,10,39,37,2,38
Cliftonville,256,5,9,4,13,33,33,0,31
Ballymena,256,6,7,4,15,25,49,-24,25
Glentoran,256,7,6,6,10,24,32,-8,24
Dungannon,256,8,2,4,16,14,47,-33,10
Crusaders,257,1,17,6,3,64,31,33,57
Coleraine,257,2,14,10,2,44,24,20,52
Glenavon,257,3,10,9,7,54,44,10,39
Linfield,257,4,10,5,11,37,38,-1,35
Cliftonville,257,5,10,4,12,34,31,3,34
Ballymena,257,6,7,4,15,26,50,-24,25
Glentoran,257,7,6,6,10,24,32,-8,24
Dungannon,257,8,2,4,16,14,47,-33,10
Crusaders,258,1,16,6,4,62,33,29,54
Coleraine,258,2,14,11,1,44,23,21,53
Linfield,258,3,11,5,10,38,36,2,38
Glenavon,258,4,9,10,7,53,44,9,37
Cliftonville,258,5,9,4,13,32,32,0,31
Ballymena,258,6,8,4,14,28,48,-20,28
Glentoran,258,7,6,6,10,24,32,-8,24
Dungannon,258,8,2,4,16,14,47,-33,10
Crusaders,259,1,16,7,3,61,30,31,55
Coleraine,259,2,14,11,1,43,22,21,53
Linfield,259,3,11,5,10,38,36,2,38
Glenavon,259,4,9,10,7,52,43,9,37
Cliftonville,259,5,9,4,13,32,32,0,31
Ballymena,259,6,7,5,14,25,47,-22,26
Glentoran,259,7,6,6,10,24,32,-8,24
Dungannon,259,8,2,4,16,14,47,-33,10
Crusaders,260,1,16,7,3,63,32,31,55
Coleraine,260,2,15,10,1,45,23,22,55
Glenavon,260,3,9,9,8,53,45,8,36
Linfield,260,4,10,5,11,39,39,0,35
Cliftonville,260,5,10,4,12,35,33,2,34
Ballymena,260,6,7,5,14,27,49,-22,26
Glentoran,260,7,6,6,10,24,32,-8,24
Dungannon,260,8,2,4,16,14,47,-33,10
Crusaders,261,1,17,6,3,63,31,32,57
Coleraine,261,2,14,10,2,43,23,20,52
Glenavon,261,3,10,9,7,53,43,10,39
Linfield,261,4,11,5,10,40,38,2,38
Cliftonville,261,5,9,4,13,34,34,0,31
Ballymena,261,6,7,4,15,26,49,-23,25
Glentoran,261,7,6,6,10,24,32,-8,24
Dungannon,261,8,2,4,16,14,47,-33,10
Crusaders,262,1,17,6,3,69,34,35,57
Coleraine,262,2,14,10,2,43,23,20,52
Glenavon,262,3,10,9,7,53,43,10,39
Linfield,262,4,11,5,10,39,37,2,38
Cliftonville,262,5,9,4,13,33,33,0,31
Ballymena,262,6,7,4,15,29,55,-26,25
Glentoran,262,7,6,6,10,24,32,-8,24
Dungannon,262,8,2,4,16,14,47,-33,10
Crusaders,263,1,17,6,3,64,31,33,57
Coleraine,263,2,14,11,1,45,24,21,53
Glenavon,263,3,9,10,7,54,45,9,37
Linfield,263,4,10,5,11,39,39,0,35
Cliftonville,263,5,10,4,12,35,33,2,34
Ballymena,263,6,7,4,15,26,50,-24,25
Glentoran,263,7,6,6,10,24,32,-8,24
Dungannon,263,8,2,4,16,14,47,-33,10
Crusaders,264,1,17,6,3,63,31,32,57
Coleraine,264,2,15,10,1,46,24,22,55
Glenavon,264,3,9,9,8,54,46,8,36
Linfield,264,4,10,6,10,38,37,1,36
Cliftonville,264,5,9,5,12,33,32,1,32
Ballymena,264,6,7,4,15,26,49,-23,25
Glentoran,264,7,6,6,10,24,32,-8,24
Dungannon,264,8,2,4,16,14,47,-33,10
Crusaders,265,1,17,6,3,63,31,32,57
Coleraine,265,2,15,10,1,45,23,22,55
Glenavon,265,3,9,9,8,53,45,8,36
Linfield,265,4,10,5,11,37,37,0,35
Cliftonville,265,5,10,4,12,33,31,2,34
Ballymena,265,6,7,4,15,26,49,-23,25
Glentoran,265,7,6,6,10,24,32,-8,24
Dungannon,265,8,2,4,16,14,47,-33,10
Crusaders,266,1,17,6,3,69,31,38,57
Coleraine,266,2,15,10,1,45,23,22,55
Glenavon,266,3,9,9,8,53,45,8,36
Linfield,266,4,10,6,10,38,37,1,36
Cliftonville,266,5,9,5,12,33,32,1,32
Ballymena,266,6,7,4,15,26,55,-29,25
Glentoran,266,7,6,6,10,24,32,-8,24
Dungannon,266,8,2,4,16,14,47,-33,10
Crusaders,267,1,16,6,4,62,33,29,54
Coleraine,267,2,14,11,1,44,23,21,53
Glenavon,267,3,9,10,7,53,44,9,37
Linfield,267,4,10,5,11,38,40,-2,35
Cliftonville,267,5,10,4,12,36,32,4,34
Ballymena,267,6,8,4,14,28,48,-20,28
Glentoran,267,7,6,6,10,24,32,-8,24
Dungannon,267,8,2,4,16,14,47,-33,10
Crusaders,268,1,16,7,3,62,31,31,55
Coleraine,268,2,14,10,2,44,26,18,52
Glenavon,268,3,10,9,7,56,44,12,39
Linfield,268,4,10,5,11,37,38,-1,35
Cliftonville,268,5,10,4,12,34,31,3,34
Ballymena,268,6,7,5,14,26,48,-22,26
Glentoran,268,7,6,6,10,24,32,-8,24
Dungannon,268,8,2,4,16,14,47,-33,10
Crusaders,269,1,17,6,3,62,30,32,57
Coleraine,269,2,14,10,2,44,24,20,52
Glenavon,269,3,10,9,7,54,44,10,39
Linfield,269,4,10,5,11,37,37,0,35
Cliftonville,269,5,10,4,12,33,31,2,34
Ballymena,269,6,7,4,15,25,48,-23,25
Glentoran,269,7,6,6,10,24,32,-8,24
Dungannon,269,8,2,4,16,14,47,-33,10
Crusaders,270,1,17,6,3,66,31,35,57
Coleraine,270,2,15,10,1,45,23,22,55
Glenavon,270,3,9,9,8,53,45,8,36
Linfield,270,4,10,5,11,37,37,0,35
Cliftonville,270,5,10,4,12,33,31,2,34
Ballymena,270,6,7,4,15,26,52,-26,25
Glentoran,270,7,6,6,10,24,32,-8,24
Dungannon,270,8,2,4,16,14,47,-33,10
Crusaders,271,1,17,6,3,64,31,33,57
Coleraine,271,2,14,10,2,44,26,18,52
Glenavon,271,3,10,9,7,56,44,12,39
Linfield,271,4,11,5,10,40,37,3,38
Cliftonville,271,5,9,4,13,33,34,-1,31
Ballymena,271,6,7,4,15,26,50,-24,25
Glentoran,271,7,6,6,10,24,32,-8,24
Dungannon,271,8,2,4,16,14,47,-33,10
Crusaders,272,1,17,6,3,63,31,32,57
Coleraine,272,2,14,11,1,44,23,21,53
Glenavon,272,3,9,10,7,53,44,9,37
Linfield,272,4,10,5,11,38,39,-1,35
Cliftonville,272,5,10,4,12,35,32,3,34
Ballymena,272,6,7,4,15,26,49,-23,25
Glentoran,272,7,6,6,10,24,32,-8,24
Dungannon,272,8,2,4,16,14,47,-33,10
Crusaders,273,1,17,6,3,63,30,33,57
Coleraine,273,2,15,10,1,45,23,22,55
Linfield,273,3,11,5,10,38,36,2,38
Glenavon,273,4,9,9,8,53,45,8,36
Cliftonville,273,5,9,4,13,32,32,0,31
Ballymena,273,6,7,4,15,25,49,-24,25
Glentoran,273,7,6,6,10,24,32,-8,24
Dungannon,273,8,2,4,16,14,47,-33,10
Crusaders,274,1,17,6,3,65,31,34,57
Coleraine,274,2,15,10,1,46,23,23,55
Linfield,274,3,11,5,10,38,36,2,38
Glenavon,274,4,9,9,8,53,46,7,36
Cliftonville,274,5,9,4,13,32,32,0,31
Ballymena,274,6,7,4,15,26,51,-25,25
Glentoran,274,7,6,6,10,24,32,-8,24
Dungannon,274,8,2,4,16,14,47,-33,10
Crusaders,275,1,16,7,3,62,31,31,55
Coleraine,275,2,14,10,2,44,26,18,52
Glenavon,275,3,10,9,7,56,44,12,39
Linfield,275,4,10,6,10,38,37,1,36
Cliftonville,275,5,9,5,12,33,32,1,32
Ballymena,275,6,7,5,14,26,48,-22,26
Glentoran,275,7,6,6,10,24,32,-8,24
Dungannon,275,8,2,4,16,14,47,-33,10
Crusaders,276,1,17,6,3,65,31,34,57
Coleraine,276,2,14,10,2,43,23,20,52
Glenavon,276,3,10,9,7,53,43,10,39
Linfield,276,4,11,5,10,39,37,2,38
Cliftonville,276,5,9,4,13,33,33,0,31
Ballymena,276,6,7,4,15,26,51,-25,25
Glentoran,276,7,6,6,10,24,32,-8,24
Dungannon,276,8,2,4,16,14,47,-33,10
Crusaders,277,1,16,6,4,62,33,29,54
Coleraine,277,2,14,10,2,43,23,20,52
Glenavon,277,3,10,9,7,53,43,10,39
Linfield,277,4,11,5,10,40,37,3,38
Cliftonville,277,5,9,4,13,33,34,-1,31
Ballymena,277,6,8,4,14,28,48,-20,28
Glentoran,277,7,6,6,10,24,32,-8,24
Dungannon,277,8,2,4,16,14,47,-33,10
Crusaders,278,1,16,6,4,62,33,29,54
Coleraine,278,2,14,11,1,44,23,21,53
Glenavon,278,3,9,10,7,53,44,9,37
Linfield,278,4,10,5,11,37,37,0,35
Cliftonville,278,5,10,4,12,33,31,2,34
Ballymena,278,6,8,4,14,28,48,-20,28
Glentoran,278,7,6,6,10,24,32,-8,24
Dungannon,278,8,2,4,16,14,47,-33,10
Crusaders,279,1,16,7,3,62,31,31,55
Coleraine,279,2,14,11,1,45,24,21,53
Linfield,279,3,11,5,10,38,36,2,38
Glenavon,279,4,9,10,7,54,45,9,37
Cliftonville,279,5,9,4,13,32,32,0,31
Ballymena,279,6,7,5,14,26,48,-22,26
Glentoran,279,7,6,6,10,24,32,-8,24
Dungannon,279,8,2,4,16,14,47,-33,10
Crusaders,280,1,17,6,3,63,30,33,57
Coleraine,280,2,14,11,1,44,23,21,53
Glenavon,280,3,9,10,7,53,44,9,37
Linfield,280,4,10,6,10,37,36,1,36
Cliftonville,280,5,9,5,12,32,31,1,32
Ballymena,280,6,7,4,15,25,49,-24,25
Glentoran,280,7,6,6,10,24,32,-8,24
Dungannon,280,8,2,4,16,14,47,-33,10
Crusaders,281,1,16,7,3,61,30,31,55
Coleraine,281,2,15,10,1,47,23,24,55
Linfield,281,3,11,5,10,40,38,2,38
Glenavon,281,4,9,9,8,53,47,6,36
Cliftonville,281,5,9,4,13,34,34,0,31
Ballymena,281,6,7,5,14,25,47,-22,26
Glentoran,281,7,6,6,10,24,32,-8,24
Dungannon,281,8,2,4,16,14,47,-33,10
Coleraine,282,1,15,10,1,46,23,23,55
Crusaders,282,2,16,6,4,62,33,29,54
Glenavon,282,3,9,9,8,53,46,7,36
Linfield,282,4,10,5,11,37,40,-3,35
Cliftonville,282,5,10,4,12,36,31,5,34
Ballymena,282,6,8,4,14,28,48,-20,28
Glentoran,282,7,6,6,10,24,32,-8,24
Dungannon,282,8,2,4,16,14,47,-33,10
Crusaders,283,1,17,6,3,68,31,37,57
Coleraine,283,2,14,10,2,45,29,16,52
Glenavon,283,3,10,9,7,59,45,14,39
Linfield,283,4,10,5,11,37,37,0,35
Cliftonville,283,5,10,4,12,33,31,2,34
Ballymena,283,6,7,4,15,26,54,-28,25
Glentoran,283,7,6,6,10,24,32,-8,24
Dungannon,283,8,2,4,16,14,47,-33,10
Crusaders,284,1,17,6,3,64,32,32,57
Coleraine,284,2,15,10,1,45,23,22,55
Glenavon,284,3,9,9,8,53,45,8,36
Linfield,284,4,10,5,11,38,38,0,35
Cliftonville,284,5,10,4,12,34,32,2,34
Ballymena,284,6,7,4,15,27,50,-23,25
Glentoran,284,7,6,6,10,24,32,-8,24
Dungannon,284,8,2,4,16,14,47,-33,10
Crusaders,285,1,17,6,3,64,31,33,57
Coleraine,285,2,14,10,2,45,26,19,52
Glenavon,285,3,10,9,7,56,45,11,39
Linfield,285,4,10,5,11,37,41,-4,35
Cliftonville,285,5,10,4,12,37,31,6,34
Ballymena,285,6,7,4,15,26,50,-24,25
Glentoran,285,7,6,6,10,24,32,-8,24
Dungannon,285,8,2,4,16,14,47,-33,10
Crusaders,286,1,17,6,3,66,30,36,57
Coleraine,286,2,14,10,2,43,23,20,52
Glenavon,286,3,10,9,7,53,43,10,39
Linfield,286,4,11,5,10,39,36,3,38
Cliftonville,286,5,9,4,13,32,33,-1,31
Ballymena,286,6,7,4,15,25,52,-27,25
Glentoran,286,7,6,6,10,24,32,-8,24
Dungannon,286,8,2,4,16,14,47,-33,10
Crusaders,287,1,17,6,3,65,31,34,57
Coleraine,287,2,14,11,1,43,22,21,53
Glenavon,287,3,9,10,7,52,43,9,37
Linfield,287,4,10,6,10,37,36,1,36
Cliftonville,287,5,9,5,12,32,31,1,32
Ballymena,287,6,7,4,15,26,51,-25,25
Glentoran,287,7,6,6,10,24,32,-8,24
Dungannon,287,8,2,4,16,14,47,-33,10
Crusaders,288,1,16,7,3,61,30,31,55
Coleraine,288,2,14,10,2,43,23,20,52
Glenavon,288,3,10,9,7,53,43,10,39
Linfield,288,4,10,5,11,38,39,-1,35
Cliftonville,288,5,10,4,12,35,32,3,34
Ballymena,288,6,7,5,14,25,47,-22,26
Glentoran,288,7,6,6,10,24,32,-8,24
Dungannon,288,8,2,4,16,14,47,-33,10
Crusaders,289,1,17,6,3,64,30,34,57
Coleraine,289,2,14,10,2,43,25,18,52
Glenavon,289,3,10,9,7,55,43,12,39
Linfield,289,4,10,5,11,37,38,-1,35
Cliftonville,289,5,10,4,12,34,31,3,34
Ballymena,289,6,7,4,15,25,50,-25,25
Glentoran,289,7,6,6,10,24,32,-8,24
Dungannon,289,8,2,4,16,14,47,-33,10
Crusaders,290,1,16,7,3,61,30,31,55
Coleraine,290,2,14,10,2,44,24,20,52
Glenavon,290,3,10,9,7,54,44,10,39
Linfield,290,4,10,5,11,39,39,0,35
Cliftonville,290,5,10,4,12,35,33,2,34
Ballymena,290,6,7,5,14,25,47,-22,26
Glentoran,290,7,6,6,10,24,32,-8,24
Dungannon,290,8,2,4,16,14,47,-33,10
Crusaders,291,1,16,6,4,61,31,30,54
Coleraine,291,2,14,11,1,45,24,21,53
Linfield,291,3,11,5,10,42,37,5,38
Glenavon,291,4,9,10,7,54,45,9,37
Cliftonville,291,5,9,4,13,33,36,-3,31
Ballymena,291,6,8,4,14,26,47,-21,28
Glentoran,291,7,6,6,10,24,32,-8,24
Dungannon,291,8,2,4,16,14,47,-33,10
Crusaders,292,1,16,6,4,63,33,30,54
Coleraine,292,2,14,10,2,44,24,20,52
Glenavon,292,3,10,9,7,54,44,10,39
Linfield,292,4,11,5,10,39,37,2,38
Cliftonville,292,5,9,4,13,33,33,0,31
Ballymena,292,6,8,4,14,28,49,-21,28
Glentoran,292,7,6,6,10,24,32,-8,24
Dungannon,292,8,2,4,16,14,47,-33,10
Crusaders,293,1,17,6,3,63,31,32,57
Coleraine,293,2,14,10,2,43,24,19,52
Glenavon,293,3,10,9,7,54,43,11,39
Linfield,293,4,11,5,10,39,37,2,38
Cliftonville,293,5,9,4,13,33,33,0,31
Ballymena,293,6,7,4,15,26,49,-23,25
Glentoran,293,7,6,6,10,24,32,-8,24
Dungannon,293,8,2,4,16,14,47,-33,10
Crusaders,294,1,16,7,3,62,31,31,55
Coleraine,294,2,15,10,1,45,22,23,55
Glenavon,294,3,9,9,8,52,45,7,36
Linfield,294,4,10,5,11,38,38,0,35
Cliftonville,294,5,10,4,12,34,32,2,34
Ballymena,294,6,7,5,14,26,48,-22,26
Glentoran,294,7,6,6,10,24,32,-8,24
Dungannon,294,8,2,4,16,14,47,-33,10
Crusaders,295,1,17,6,3,63,30,33,57
Coleraine,295,2,14,10,2,44,25,19,52
Glenavon,295,3,10,9,7,55,44,11,39
Linfield,295,4,10,5,11,37,37,0,35
Cliftonville,295,5,10,4,12,33,31,2,34
Ballymena,295,6,7,4,15,25,49,-24,25
Glentoran,295,7,6,6,10,24,32,-8,24
Dungannon,295,8,2,4,16,14,47,-33,10
Coleraine,296,1,15,10,1,44,22,22,55
Crusaders,296,2,16,6,4,62,32,30,54
Glenavon,296,3,9,9,8,52,44,8,36
Linfield,296,4,10,6,10,37,36,1,36
Cliftonville,296,5,9,5,12,32,31,1,32
Ballymena,296,6,8,4,14,27,48,-21,28
Glentoran,296,7,6,6,10,24,32,-8,24
Dungannon,296,8,2,4,16,14,47,-33,10
Crusaders,297,1,17,6,3,63,30,33,57
Coleraine,297,2,14,11,1,43,22,21,53
Linfield,297,3,11,5,10,39,36,3,38
Glenavon,297,4,9,10,7,52,43,9,37
Cliftonville,297,5,9,4,13,32,33,-1,31
Ballymena,297,6,7,4,15,25,49,-24,25
Glentoran,297,7,6,6,10,24,32,-8,24
Dungannon,297,8,2,4,16,14,47,-33,10
Crusaders,298,1,16,6,4,61,34,27,54
Coleraine,298,2,14,10,2,44,25,19,52
Glenavon,298,3,10,9,7,55,44,11,39
Linfield,298,4,10,5,11,37,37,0,35
Cliftonville,298,5,10,4,12,33,31,2,34
Ballymena,298,6,8,4,14,29,47,-18,28
Glentoran,298,7,6,6,10,24,32,-8,24
Dungannon,298,8,2,4,16,14,47,-33,10
Crusaders,299,1,17,6,3,62,30,32,57
Coleraine,299,2,15,10,1,47,25,22,55
Glenavon,299,3,9,9,8,55,47,8,36
Linfield,299,4,10,5,11,37,37,0,35
Cliftonville,299,5,10,4,12,33,31,2,34
Ballymena,299,6,7,4,15,25,48,-23,25
Glentoran,299,7,6,6,10,24,32,-8,24
Dungannon,299,8,2,4,16,14,47,-33,10
Crusaders,300,1,17,6,3,64,32,32,57
Coleraine,300,2,15,10,1,45,22,23,55
Glenavon,300,3,9,9,8,52,45,7,36
Linfield,300,4,10,6,10,37,36,1,36
Cliftonville,300,5,9,5,12,32,31,1,32
Ballymena,300,6,7,4,15,27,50,-23,25
Glentoran,300,7,6,6,10,24,32,-8,24
Dungannon,300,8,2,4,16,14,47,-33,10
Crusaders,301,1,17,6,3,67,31,36,57
Coleraine,301,2,14,11,1,43,22,21,53
Glenavon,301,3,9,10,7,52,43,9,37
Linfield,301,4,10,5,11,37,37,0,35
Cliftonville,301,5,10,4,12,33,31,2,34
Ballymena,301,6,7,4,15,26,53,-27,25
Glentoran,301,7,6,6,10,24,32,-8,24
Dungannon,301,8,2,4,16,14,47,-33,10
Crusaders,302,1,16,7,3,63,32,31,55
Coleraine,302,2,15,10,1,47,23,24,55
Glenavon,302,3,9,9,8,53,47,6,36
Linfield,302,4,10,5,11,38,38,0,35
Cliftonville,302,5,10,4,12,34,32,2,34
Ballymena,302,6,7,5,14,27,49,-22,26
Glentoran,302,7,6,6,10,24,32,-8,24
Dungannon,302,8,2,4,16,14,47,-33,10
Crusaders,303,1,16,7,3,62,31,31,55
Coleraine,303,2,15,10,1,44,22,22,55
Linfield,303,3,11,5,10,39,36,3,38
Glenavon,303,4,9,9,8,52,44,8,36
Cliftonville,303,5,9,4,13,32,33,-1,31
Ballymena,303,6,7,5,14,26,48,-22,26
Glentoran,303,7,6,6,10,24,32,-8,24
Dungannon,303,8,2,4,16,14,47,-33,10
Crusaders,304,1,17,6,3,63,31,32,57
Coleraine,304,2,14,10,2,44,24,20,52
Glenavon,304,3,10,9,7,54,44,10,39
Linfield,304,4,10,5,11,38,38,0,35
Cliftonville,304,5,10,4,12,34,32,2,34
Ballymena,304,6,7,4,15,26,49,-23,25
Glentoran,304,7,6,6,10,24,32,-8,24
Dungannon,304,8,2,4,16,14,47,-33,10
Crusaders,305,1,17,6,3,65,32,33,57
Coleraine,305,2,14,10,2,45,25,20,52
Glenavon,305,3,10,9,7,55,45,10,39
Linfield,305,4,10,5,11,38,39,-1,35
Cliftonville,305,5,10,4,12,35,32,3,34
Ballymena,305,6,7,4,15,27,51,-24,25
Glentoran,305,7,6,6,10,24,32,-8,24
Dungannon,305,8,2,4,16,14,47,-33,10
Crusaders,306,1,16,6,4,61,31,30,54
Coleraine,306,2,14,10,2,43,23,20,52
Glenavon,306,3,10,9,7,53,43,10,39
Linfield,306,4,10,5,11,37,37,0,35
Cliftonville,306,5,10,4,12,33,31,2,34
Ballymena,306,6,8,4,14,26,47,-21,28
Glentoran,306,7,6,6,10,24,32,-8,24
Dungannon,306,8,2,4,16,14,47,-33,10
Crusaders,307,1,16,6,4,63,34,29,54
Coleraine,307,2,14,10,2,45,25,20,52
Glenavon,307,3,10,9,7,55,45,10,39
Linfield,307,4,11,5,10,38,36,2,38
Cliftonville,307,5,9,4,13,32,32,0,31
Ballymena,307,6,8,4,14,29,49,-20,28
Glentoran,307,7,6,6,10,24,32,-8,24
Dungannon,307,8,2,4,16,14,47,-33,10
Crusaders,308,1,17,6,3,63,30,33,57
Coleraine,308,2,14,11,1,44,23,21,53
Linfield,308,3,11,5,10,38,36,2,38
Glenavon,308,4,9,10,7,53,44,9,37
Cliftonville,308,5,9,4,13,32,32,0,31
Ballymena,308,6,7,4,15,25,49,-24,25
Glentoran,308,7,6,6,10,24,32,-8,24
Dungannon,308,8,2,4,16,14,47,-33,10
Crusaders,309,1,17,6,3,62,30,32,57
Coleraine,309,2,14,10,2,43,23,20,52
Glenavon,309,3,10,9,7,53,43,10,39
Linfield,309,4,11,5,10,38,36,2,38
Cliftonville,309,5,9,4,13,32,32,0,31
Ballymena,309,6,7,4,15,25,48,-23,25
Glentoran,309,7,6,6,10,24,32,-8,24
Dungannon,309,8,2,4,16,14,47,-33,10
Crusaders,310,1,16,6,4,62,33,29,54
Coleraine,310,2,14,11,1,43,22,21,53
Linfield,310,3,11,5,10,41,36,5,38
Glenavon,310,4,9,10,7,52,43,9,37
Cliftonville,310,5,9,4,13,32,35,-3,31
Ballymena,310,6,8,4,14,28,48,-20,28
Glentoran,310,7,6,6,10,24,32,-8,24
Dungannon,310,8,2,4,16,14,47,-33,10
Crusaders,311,1,17,6,3,62,30,32,57
Coleraine,311,2,14,10,2,43,23,20,52
Glenavon,311,3,10,9,7,53,43,10,39
Linfield,311,4,11,5,10,39,36,3,38
Cliftonville,311,5,9,4,13,32,33,-1,31
Ballymena,311,6,7,4,15,25,48,-23,25
Glentoran,311,7,6,6,10,24,32,-8,24
Dungannon,311,8,2,4,16,14,47,-33,10
Crusaders,312,1,16,6,4,61,31,30,54
Coleraine,312,2,14,11,1,44,23,21,53
Glenavon,312,3,9,10,7,53,44,9,37
Linfield,312,4,10,5,11,37,39,-2,35
Cliftonville,312,5,10,4,12,35,31,4,34
Ballymena,312,6,8,4,14,26,47,-21,28
Glentoran,312,7,6,6,10,24,32,-8,24
Dungannon,312,8,2,4,16,14,47,-33,10
Crusaders,313,1,17,6,3,64,30,34,57
Coleraine,313,2,14,10,2,45,25,20,52
Glenavon,313,3,10,9,7,55,45,10,39
Linfield,313,4,11,5,10,41,37,4,38
Cliftonville,313,5,9,4,13,33,35,-2,31
Ballymena,313,6,7,4,15,25,50,-25,25
Glentoran,313,7,6,6,10,24,32,-8,24
Dungannon,313,8,2,4,16,14,47,-33,10
Crusaders,314,1,16,7,3,61,30,31,55
Coleraine,314,2,14,10,2,45,25,20,52
Glenavon,314,3,10,9,7,55,45,10,39
Linfield,314,4,10,6,10,37,36,1,36
Cliftonville,314,5,9,5,12,32,31,1,32
Ballymena,314,6,7,5,14,25,47,-22,26
Glentoran,314,7,6,6,10,24,32,-8,24
Dungannon,314,8,2,4,16,14,47,-33,10
Crusaders,315,1,16,7,3,63,32,31,55
Coleraine,315,2,15,10,1,44,22,22,55
Glenavon,315,3,9,9,8,52,44,8,36
Linfield,315,4,10,5,11,37,39,-2,35
Cliftonville,315,5,10,4,12,35,31,4,34
Ballymena,315,6,7,5,14,27,49,-22,26
Glentoran,315,7,6,6,10,24,32,-8,24
Dungannon,315,8,2,4,16,14,47,-33,10
Crusaders,316,1,16,7,3,61,30,31,55
Coleraine,316,2,14,10,2,44,24,20,52
Glenavon,316,3,10,9,7,54,44,10,39
Linfield,316,4,10,5,11,39,39,0,35
Cliftonville,316,5,10,4,12,35,33,2,34
Ballymena,316,6,7,5,14,25,47,-22,26
Glentoran,316,7,6,6,10,24,32,-8,24
Dungannon,316,8,2,4,16,14,47,-33,10
Crusaders,317,1,17,6,3,63,31,32,57
Coleraine,317,2,15,10,1,45,23,22,55
Linfield,317,3,11,5,10,39,36,3,38
Glenavon,317,4,9,9,8,53,45,8,36
Cliftonville,317,5,9,4,13,32,33,-1,31
Ballymena,317,6,7,4,15,26,49,-23,25
Glentoran,317,7,6,6,10,24,32,-8,24
Dungannon,317,8,2,4,16,14,47,-33,10
Crusaders,318,1,17,6,3,63,30,33,57
Coleraine,318,2,14,10,2,43,24,19,52
Glenavon,318,3,10,9,7,54,43,11,39
Linfield,318,4,11,5,10,40,36,4,38
Cliftonville,318,5,9,4,13,32,34,-2,31
Ballymena,318,6,7,4,15,25,49,-24,25
Glentoran,318,7,6,6,10,24,32,-8,24
Dungannon,318,8,2,4,16,14,47,-33,10
Crusaders,319,1,16,6,4,63,34,29,54
Coleraine,319,2,14,10,2,43,24,19,52
Glenavon,319,3,10,9,7,54,43,11,39
Linfield,319,4,10,6,10,37,36,1,36
Cliftonville,319,5,9,5,12,32,31,1,32
Ballymena,319,6,8,4,14,29,49,-20,28
Glentoran,319,7,6,6,10,24,32,-8,24
Dungannon,319,8,2,4,16,14,47,-33,10
Coleraine,320,1,15,10,1,44,22,22,55
Crusaders,320,2,16,6,4,61,32,29,54
Glenavon,320,3,9,9,8,52,44,8,36
Linfield,320,4,10,6,10,37,36,1,36
Cliftonville,320,5,9,5,12,32,31,1,32
Ballymena,320,6,8,4,14,27,47,-20,28
Glentoran,320,7,6,6,10,24,32,-8,24
Dungannon,320,8,2,4,16,14,47,-33,10
Coleraine,321,1,15,10,1,45,22,23,55
Crusaders,321,2,16,6,4,64,35,29,54
Linfield,321,3,11,5,10,40,36,4,38
Glenavon,321,4,9,9,8,52,45,7,36
Cliftonville,321,5,9,4,13,32,34,-2,31
Ballymena,321,6,8,4,14,30,50,-20,28
Glentoran,321,7,6,6,10,24,32,-8,24
Dungannon,321,8,2,4,16,14,47,-33,10
Crusaders,322,1,17,6,3,64,31,33,57
Coleraine,322,2,14,10,2,44,25,19,52
Glenavon,322,3,10,9,7,55,44,11,39
Linfield,322,4,11,5,10,40,36,4,38
Cliftonville,322,5,9,4,13,32,34,-2,31
Ballymena,322,6,7,4,15,26,50,-24,25
Glentoran,322,7,6,6,10,24,32,-8,24
Dungannon,322,8,2,4,16,14,47,-33,10
Crusaders,323,1,17,6,3,62,30,32,57
Coleraine,323,2,14,10,2,45,28,17,52
Glenavon,323,3,10,9,7,58,45,13,39
Linfield,323,4,10,5,11,37,37,0,35
Cliftonville,323,5,10,4,12,33,31,2,34
Ballymena,323,6,7,4,15,25,48,-23,25
Glentoran,323,7,6,6,10,24,32,-8,24
Dungannon,323,8,2,4,16,14,47,-33,10
Crusaders,324,1,17,6,3,63,30,33,57
Coleraine,324,2,14,11,1,43,22,21,53
Linfield,324,3,11,5,10,39,36,3,38
Glenavon,324,4,9,10,7,52,43,9,37
Cliftonville,324,5,9,4,13,32,33,-1,31
Ballymena,324,6,7,4,15,25,49,-24,25
Glentoran,324,7,6,6,10,24,32,-8,24
Dungannon,324,8,2,4,16,14,47,-33,10
Crusaders,325,1,17,6,3,65,31,34,57
Coleraine,325,2,14,11,1,46,25,21,53
Glenavon,325,3,9,10,7,55,46,9,37
Linfield,325,4,10,5,11,38,38,0,35
Cliftonville,325,5,10,4,12,34,32,2,34
Ballymena,325,6,7,4,15,26,51,-25,25
Glentoran,325,7,6,6,10,24,32,-8,24
Dungannon,325,8,2,4,16,14,47,-33,10
Crusaders,326,1,17,6,3,64,31,33,57
Coleraine,326,2,14,10,2,44,25,19,52
Glenavon,326,3,10,9,7,55,44,11,39
Linfield,326,4,10,5,11,37,37,0,35
Cliftonville,326,5,10,4,12,33,31,2,34
Ballymena,326,6,7,4,15,26,50,-24,25
Glentoran,326,7,6,6,10,24,32,-8,24
Dungannon,326,8,2,4,16,14,47,-33,10
Crusaders,327,1,16,7,3,62,31,31,55
Coleraine,327,2,15,10,1,45,22,23,55
Linfield,327,3,11,5,10,41,36,5,38
Glenavon,327,4,9,9,8,52,45,7,36
Cliftonville,327,5,9,4,13,32,35,-3,31
Ballymena,327,6,7,5,14,26,48,-22,26
Glentoran,327,7,6,6,10,24,32,-8,24
Dungannon,327,8,2,4,16,14,47,-33,10
Crusaders,328,1,17,6,3,66,32,34,57
Coleraine,328,2,14,11,1,45,24,21,53
Glenavon,328,3,9,10,7,54,45,9,37
Linfield,328,4,10,6,10,38,37,1,36
Cliftonville,328,5,9,5,12,33,32,1,32
Ballymena,328,6,7,4,15,27,52,-25,25
Glentoran,328,7,6,6,10,24,32,-8,24
Dungannon,328,8,2,4,16,14,47,-33,10
Crusaders,329,1,16,7,3,63,32,31,55
Coleraine,329,2,14,10,2,43,23,20,52
Glenavon,329,3,10,9,7,53,43,10,39
Linfield,329,4,11,5,10,39,37,2,38
Cliftonville,329,5,9,4,13,33,33,0,31
Ballymena,329,6,7,5,14,27,49,-22,26
Glentoran,329,7,6,6,10,24,32,-8,24
Dungannon,329,8,2,4,16,14,47,-33,10
Crusaders,330,1,17,6,3,64,32,32,57
Coleraine,330,2,14,11,1,44,23,21,53
Linfield,330,3,11,5,10,38,36,2,38
Glenavon,330,4,9,10,7,53,44,9,37
Cliftonville,330,5,9,4,13,32,32,0,31
Ballymena,330,6,7,4,15,27,50,-23,25
Glentoran,330,7,6,6,10,24,32,-8,24
Dungannon,330,8,2,4,16,14,47,-33,10
Crusaders,331,1,17,6,3,64,30,34,57
Coleraine,331,2,14,10,2,44,26,18,52
Glenavon,331,3,10,9,7,56,44,12,39
Linfield,331,4,10,6,10,38,37,1,36
Cliftonville,331,5,9,5,12,33,32,1,32
Ballymena,331,6,7,4,15,25,50,-25,25
Glentoran,331,7,6,6,10,24,32,-8,24
Dungannon,331,8,2,4,16,14,47,-33,10
Crusaders,332,1,17,6,3,65,32,33,57
Coleraine,332,2,14,10,2,44,25,19,52
Glenavon,332,3,10,9,7,55,44,11,39
Linfield,332,4,11,5,10,40,36,4,38
Cliftonville,332,5,9,4,13,32,34,-2,31
Ballymena,332,6,7,4,15,27,51,-24,25
Glentoran,332,7,6,6,10,24,32,-8,24
Dungannon,332,8,2,4,16,14,47,-33,10
Coleraine,333,1,15,10,1,46,24,22,55
Crusaders,333,2,16,6,4,64,36,28,54
Glenavon,333,3,9,9,8,54,46,8,36
Linfield,333,4,10,5,11,37,39,-2,35
Cliftonville,333,5,10,4,12,35,31,4,34
Ballymena,333,6,8,4,14,31,50,-19,28
Glentoran,333,7,6,6,10,24,32,-8,24
Dungannon,333,8,2,4,16,14,47,-33,10
Crusaders,334,1,16,7,3,62,31,31,55
Coleraine,334,2,14,11,1,45,24,21,53
Glenavon,334,3,9,10,7,54,45,9,37
Linfield,334,4,10,6,10,37,36,1,36
Cliftonville,334,5,9,5,12,32,31,1,32
Ballymena,334,6,7,5,14,26,48,-22,26
Glentoran,334,7,6,6,10,24,32,-8,24
Dungannon,334,8,2,4,16,14,47,-33,10
Crusaders,335,1,17,6,3,64,30,34,57
Coleraine,335,2,14,11,1,44,23,21,53
Linfield,335,3,11,5,10,40,36,4,38
Glenavon,335,4,9,10,7,53,44,9,37
Cliftonville,335,5,9,4,13,32,34,-2,31
Ballymena,335,6,7,4,15,25,50,-25,25
Glentoran,335,7,6,6,10,24,32,-8,24
Dungannon,335,8,2,4,16,14,47,-33,10
Crusaders,336,1,16,6,4,63,33,30,54
Coleraine,336,2,14,10,2,43,23,20,52
Glenavon,336,3,10,9,7,53,43,10,39
Linfield,336,4,10,5,11,38,38,0,35
Cliftonville,336,5,10,4,12,34,32,2,34
Ballymena,336,6,8,4,14,28,49,-21,28
Glentoran,336,7,6,6,10,24,32,-8,24
Dungannon,336,8,2,4,16,14,47,-33,10
Crusaders,337,1,17,6,3,63,30,33,57
Coleraine,337,2,15,10,1,45,23,22,55
Linfield,337,3,11,5,10,39,36,3,38
Glenavon,337,4,9,9,8,53,45,8,36
Cliftonville,337,5,9,4,13,32,33,-1,31
Ballymena,337,6,7,4,15,25,49,-24,25
Glentoran,337,7,6,6,10,24,32,-8,24
Dungannon,337,8,2,4,16,14,47,-33,10
Crusaders,338,1,17,6,3,64,31,33,57
Coleraine,338,2,14,11,1,46,25,21,53
Glenavon,338,3,9,10,7,55,46,9,37
Linfield,338,4,10,6,10,38,37,1,36
Cliftonville,338,5,9,5,12,33,32,1,32
Ballymena,338,6,7,4,15,26,50,-24,25
Glentoran,338,7,6,6,10,24,32,-8,24
Dungannon,338,8,2,4,16,14,47,-33,10
Crusaders,339,1,16,6,4,61,33,28,54
Coleraine,339,2,14,10,2,44,26,18,52
Glenavon,339,3,10,9,7,56,44,12,39
Linfield,339,4,10,6,10,38,37,1,36
Cliftonville,339,5,9,5,12,33,32,1,32
Ballymena,339,6,8,4,14,28,47,-19,28
Glentoran,339,7,6,6,10,24,32,-8,24
Dungannon,339,8,2,4,16,14,47,-33,10
Crusaders,340,1,17,6,3,64,31,33,57
Coleraine,340,2,14,10,2,43,23,20,52
Glenavon,340,3,10,9,7,53,43,10,39
Linfield,340,4,10,5,11,38,38,0,35
Cliftonville,340,5,10,4,12,34,32,2,34
Ballymena,340,6,7,4,15,26,50,-24,25
Glentoran,340,7,6,6,10,24,32,-8,24
Dungannon,340,8,2,4,16,14,47,-33,10
Coleraine,341,1,15,10,1,45,22,23,55
Crusaders,341,2,16,6,4,62,32,30,54
Linfield,341,3,11,5,10,38,36,2,38
Glenavon,341,4,9,9,8,52,45,7,36
Cliftonville,341,5,9,4,13,32,32,0,31
Ballymena,341,6,8,4,14,27,48,-21,28
Glentoran,341,7,6,6,10,24,32,-8,24
Dungannon,341,8,2,4,16,14,47,-33,10
Crusaders,342,1,16,7,3,64,33,31,55
Coleraine,342,2,15,10,1,46,22,24,55
Linfield,342,3,11,5,10,42,36,6,38
Glenavon,342,4,9,9,8,52,46,6,36
Cliftonville,342,5,9,4,13,32,36,-4,31
Ballymena,342,6,7,5,14,28,50,-22,26
Glentoran,342,7,6,6,10,24,32,-8,24
Dungannon,342,8,2,4,16,14,47,-33,10
Crusaders,343,1,17,6,3,64,31,33,57
Coleraine,343,2,14,11,1,44,23,21,53
Linfield,343,3,11,5,10,38,36,2,38
Glenavon,343,4,9,10,7,53,44,9,37
Cliftonville,343,5,9,4,13,32,32,0,31
Ballymena,343,6,7,4,15,26,50,-24,25
Glentoran,343,7,6,6,10,24,32,-8,24
Dungannon,343,8,2,4,16,14,47,-33,10
Crusaders,344,1,17,6,3,62,30,32,57
Coleraine,344,2,14,10,2,44,25,19,52
Glenavon,344,3,10,9,7,55,44,11,39
Linfield,344,4,10,5,11,38,38,0,35
Cliftonville,344,5,10,4,12,34,32,2,34
Ballymena,344,6,7,4,15,25,48,-23,25
Glentoran,344,7,6,6,10,24,32,-8,24
Dungannon,344,8,2,4,16,14,47,-33,10
Crusaders,345,1,16,6,4,62,33,29,54
Coleraine,345,2,14,10,2,44,24,20,52
Glenavon,345,3,10,9,7,54,44,10,39
Linfield,345,4,10,6,10,39,38,1,36
Cliftonville,345,5,9,5,12,34,33,1,32
Ballymena,345,6,8,4,14,28,48,-20,28
Glentoran,345,7,6,6,10,24,32,-8,24
Dungannon,345,8,2,4,16,14,47,-33,10
Crusaders,346,1,17,6,3,64,30,34,57
Coleraine,346,2,14,10,2,43,24,19,52
Glenavon,346,3,10,9,7,54,43,11,39
Linfield,346,4,11,5,10,41,36,5,38
Cliftonville,346,5,9,4,13,32,35,-3,31
Ballymena,346,6,7,4,15,25,50,-25,25
Glentoran,346,7,6,6,10,24,32,-8,24
Dungannon,346,8,2,4,16,14,47,-33,10
Crusaders,347,1,16,6,4,61,33,28,54
Coleraine,347,2,14,10,2,43,23,20,52
Glenavon,347,3,10,9,7,53,43,10,39
Linfield,347,4,11,5,10,40,37,3,38
Cliftonville,347,5,9,4,13,33,34,-1,31
Ballymena,347,6,8,4,14,28,47,-19,28
Glentoran,347,7,6,6,10,24,32,-8,24
Dungannon,347,8,2,4,16,14,47,-33,10
Crusaders,348,1,16,7,3,64,33,31,55
Coleraine,348,2,14,10,2,45,25,20,52
Glenavon,348,3,10,9,7,55,45,10,39
Linfield,348,4,11,5,10,38,36,2,38
Cliftonville,348,5,9,4,13,32,32,0,31
Ballymena,348,6,7,5,14,28,50,-22,26
Glentoran,348,7,6,6,10,24,32,-8,24
Dungannon,348,8,2,4,16,14,47,-33,10
Crusaders,349,1,16,7,3,63,32,31,55
Coleraine,349,2,15,10,1,46,23,23,55
Glenavon,349,3,9,9,8,53,46,7,36
Linfield,349,4,10,5,11,38,38,0,35
Cliftonville,349,5,10,4,12,34,32,2,34
Ballymena,349,6,7,5,14,27,49,-22,26
Glentoran,349,7,6,6,10,24,32,-8,24
Dungannon,349,8,2,4,16,14,47,-33,10
Coleraine,350,1,15,10,1,45,23,22,55
Crusaders,350,2,16,6,4,63,33,30,54
Linfield,350,3,11,5,10,38,36,2,38
Glenavon,350,4,9,9,8,53,45,8,36
Cliftonville,350,5,9,4,13,32,32,0,31
Ballymena,350,6,8,4,14,28,49,-21,28
Glentoran,350,7,6,6,10,24,32,-8,24
Dungannon,350,8,2,4,16,14,47,-33,10
Crusaders,351,1,16,7,3,61,30,31,55
Coleraine,351,2,14,10,2,44,25,19,52
Glenavon,351,3,10,9,7,55,44,11,39
Linfield,351,4,10,6,10,37,36,1,36
Cliftonville,351,5,9,5,12,32,31,1,32
Ballymena,351,6,7,5,14,25,47,-22,26
Glentoran,351,7,6,6,10,24,32,-8,24
Dungannon,351,8,2,4,16,14,47,-33,10
Crusaders,352,1,17,6,3,65,31,34,57
Coleraine,352,2,15,10,1,44,22,22,55
Linfield,352,3,11,5,10,39,37,2,38
Glenavon,352,4,9,9,8,52,44,8,36
Cliftonville,352,5,9,4,13,33,33,0,31
Ballymena,352,6,7,4,15,26,51,-25,25
Glentoran,352,7,6,6,10,24,32,-8,24
Dungannon,352,8,2,4,16,14,47,-33,10
Coleraine,353,1,15,10,1,45,22,23,55
Crusaders,353,2,16,6,4,62,32,30,54
Linfield,353,3,11,5,10,38,36,2,38
Glenavon,353,4,9,9,8,52,45,7,36
Cliftonville,353,5,9,4,13,32,32,0,31
Ballymena,353,6,8,4,14,27,48,-21,28
Glentoran,353,7,6,6,10,24,32,-8,24
Dungannon,353,8,2,4,16,14,47,-33,10
Crusaders,354,1,16,6,4,61,31,30,54
Coleraine,354,2,14,11,1,44,23,21,53
Linfield,354,3,11,5,10,40,36,4,38
Glenavon,354,4,9,10,7,53,44,9,37
Cliftonville,354,5,9,4,13,32,34,-2,31
Ballymena,354,6,8,4,14,26,47,-21,28
Glentoran,354,7,6,6,10,24,32,-8,24
Dungannon,354,8,2,4,16,14,47,-33,10
Crusaders,355,1,17,6,3,66,30,36,57
Coleraine,355,2,15,10,1,46,22,24,55
Linfield,355,3,11,5,10,39,36,3,38
Glenavon,355,4,9,9,8,52,46,6,36
Cliftonville,355,5,9,4,13,32,33,-1,31
Ballymena,355,6,7,4,15,25,52,-27,25
Glentoran,355,7,6,6,10,24,32,-8,24
Dungannon,355,8,2,4,16,14,47,-33,10
Crusaders,356,1,17,6,3,62,30,32,57
Coleraine,356,2,15,10,1,47,24,23,55
Linfield,356,3,11,5,10,38,36,2,38
Glenavon,356,4,9,9,8,54,47,7,36
Cliftonville,356,5,9,4,13,32,32,0,31
Ballymena,356,6,7,4,15,25,48,-23,25
Glentoran,356,7,6,6,10,24,32,-8,24
Dungannon,356,8,2,4,16,14,47,-33,10
Coleraine,357,1,15,10,1,44,22,22,55
Crusaders,357,2,16,6,4,62,36,26,54
Linfield,357,3,11,5,10,40,37,3,38
Glenavon,357,4,9,9,8,52,44,8,36
Cliftonville,357,5,9,4,13,33,34,-1,31
Ballymena,357,6,8,4,14,31,48,-17,28
Glentoran,357,7,6,6,10,24,32,-8,24
Dungannon,357,8,2,4,16,14,47,-33,10
Crusaders,358,1,17,6,3,64,30,34,57
Coleraine,358,2,14,11,1,44,23,21,53
Glenavon,358,3,9,10,7,53,44,9,37
Linfield,358,4,10,6,10,38,37,1,36
Cliftonville,358,5,9,5,12,33,32,1,32
Ballymena,358,6,7,4,15,25,50,-25,25
Glentoran,358,7,6,6,10,24,32,-8,24
Dungannon,358,8,2,4,16,14,47,-33,10
Crusaders,359,1,17,6,3,63,30,33,57
Coleraine,359,2,15,10,1,47,24,23,55
Glenavon,359,3,9,9,8,54,47,7,36
Linfield,359,4,10,5,11,37,38,-1,35
Cliftonville,359,5,10,4,12,34,31,3,34
Ballymena,359,6,7,4,15,25,49,-24,25
Glentoran,359,7,6,6,10,24,32,-8,24
Dungannon,359,8,2,4,16,14,47,-33,10
Crusaders,360,1,16,7,3,62,31,31,55
Coleraine,360,2,15,10,1,45,23,22,55
Linfield,360,3,11,5,10,38,36,2,38
Glenavon,360,4,9,9,8,53,45,8,36
Cliftonville,360,5,9,4,13,32,32,0,31
Ballymena,360,6,7,5,14,26,48,-22,26
Glentoran,360,7,6,6,10,24,32,-8,24
Dungannon,360,8,2,4,16,14,47,-33,10
Crusaders,361,1,16,6,4,61,31,30,54
Coleraine,361,2,14,10,2,45,26,19,52
Glenavon,361,3,10,9,7,56,45,11,39
Linfield,361,4,11,5,10,38,36,2,38
Cliftonville,361,5,9,4,13,32,32,0,31
Ballymena,361,6,8,4,14,26,47,-21,28
Glentoran,361,7,6,6,10,24,32,-8,24
Dungannon,361,8,2,4,16,14,47,-33,10
Crusaders,362,1,16,7,3,61,30,31,55
Coleraine,362,2,14,10,2,43,23,20,52
Glenavon,362,3,10,9,7,53,43,10,39
Linfield,362,4,10,5,11,37,39,-2,35
Cliftonville,362,5,10,4,12,35,31,4,34
Ballymena,362,6,7,5,14,25,47,-22,26
Glentoran,362,7,6,6,10,24,32,-8,24
Dungannon,362,8,2,4,16,14,47,-33,10
Crusaders,363,1,17,6,3,63,31,32,57
Coleraine,363,2,14,10,2,44,24,20,52
Glenavon,363,3,10,9,7,54,44,10,39
Linfield,363,4,10,6,10,38,37,1,36
Cliftonville,363,5,9,5,12,33,32,1,32
Ballymena,363,6,7,4,15,26,49,-23,25
Glentoran,363,7,6,6,10,24,32,-8,24
Dungannon,363,8,2,4,16,14,47,-33,10
Coleraine,364,1,15,10,1,44,22,22,55
Crusaders,364,2,16,6,4,63,33,30,54
Glenavon,364,3,9,9,8,52,44,8,36
Linfield,364,4,10,5,11,38,38,0,35
Cliftonville,364,5,10,4,12,34,32,2,34
Ballymena,364,6,8,4,14,28,49,-21,28
Glentoran,364,7,6,6,10,24,32,-8,24
Dungannon,364,8,2,4,16,14,47,-33,10
Crusaders,365,1,16,6,4,61,31,30,54
Coleraine,365,2,14,10,2,44,24,20,52
Glenavon,365,3,10,9,7,54,44,10,39
Linfield,365,4,11,5,10,40,38,2,38
Cliftonville,365,5,9,4,13,34,34,0,31
Ballymena,365,6,8,4,14,26,47,-21,28
Glentoran,365,7,6,6,10,24,32,-8,24
Dungannon,365,8,2,4,16,14,47,-33,10
Crusaders,366,1,17,6,3,64,30,34,57
Coleraine,366,2,15,10,1,44,22,22,55
Glenavon,366,3,9,9,8,52,44,8,36
Linfield,366,4,10,5,11,37,37,0,35
Cliftonville,366,5,10,4,12,33,31,2,34
Ballymena,366,6,7,4,15,25,50,-25,25
Glentoran,366,7,6,6,10,24,32,-8,24
Dungannon,366,8,2,4,16,14,47,-33,10
Crusaders,367,1,17,6,3,64,30,34,57
Coleraine,367,2,15,10,1,44,22,22,55
Glenavon,367,3,9,9,8,52,44,8,36
Linfield,367,4,10,5,11,37,38,-1,35
Cliftonville,367,5,10,4,12,34,31,3,34
Ballymena,367,6,7,4,15,25,50,-25,25
Glentoran,367,7,6,6,10,24,32,-8,24
Dungannon,367,8,2,4,16,14,47,-33,10
Crusaders,368,1,16,7,3,61,30,31,55
Coleraine,368,2,15,10,1,46,24,22,55
Glenavon,368,3,9,9,8,54,46,8,36
Linfield,368,4,10,6,10,39,38,1,36
Cliftonville,368,5,9,5,12,34,33,1,32
Ballymena,368,6,7,5,14,25,47,-22,26
Glentoran,368,7,6,6,10,24,32,-8,24
Dungannon,368,8,2,4,16,14,47,-33,10
Crusaders,369,1,17,6,3,64,31,33,57
Coleraine,369,2,15,10,1,44,22,22,55
Linfield,369,3,11,5,10,39,37,2,38
Glenavon,369,4,9,9,8,52,44,8,36
Cliftonville,369,5,9,4,13,33,33,0,31
Ballymena,369,6,7,4,15,26,50,-24,25
Glentoran,369,7,6,6,10,24,32,-8,24
Dungannon,369,8,2,4,16,14,47,-33,10
Crusaders,370,1,17,6,3,65,32,33,57
Coleraine,370,2,15,10,1,44,22,22,55
Glenavon,370,3,9,9,8,52,44,8,36
Linfield,370,4,10,6,10,37,36,1,36
Cliftonville,370,5,9,5,12,32,31,1,32
Ballymena,370,6,7,4,15,27,51,-24,25
Glentoran,370,7,6,6,10,24,32,-8,24
Dungannon,370,8,2,4,16,14,47,-33,10
Crusaders,371,1,16,7,3,62,31,31,55
Coleraine,371,2,14,10,2,43,26,17,52
Glenavon,371,3,10,9,7,56,43,13,39
Linfield,371,4,11,5,10,42,39,3,38
Cliftonville,371,5,9,4,13,35,36,-1,31
Ballymena,371,6,7,5,14,26,48,-22,26
Glentoran,371,7,6,6,10,24,32,-8,24
Dungannon,371,8,2,4,16,14,47,-33,10
Crusaders,372,1,17,6,3,66,31,35,57
Coleraine,372,2,14,10,2,44,24,20,52
Glenavon,372,3,10,9,7,54,44,10,39
Linfield,372,4,11,5,10,40,36,4,38
Cliftonville,372,5,9,4,13,32,34,-2,31
Ballymena,372,6,7,4,15,26,52,-26,25
Glentoran,372,7,6,6,10,24,32,-8,24
Dungannon,372,8,2,4,16,14,47,-33,10
Crusaders,373,1,17,6,3,64,32,32,57
Coleraine,373,2,15,10,1,44,22,22,55
Glenavon,373,3,9,9,8,52,44,8,36
Linfield,373,4,10,5,11,38,38,0,35
Cliftonville,373,5,10,4,12,34,32,2,34
Ballymena,373,6,7,4,15,27,50,-23,25
Glentoran,373,7,6,6,10,24,32,-8,24
Dungannon,373,8,2,4,16,14,47,-33,10
Crusaders,374,1,16,6,4,63,34,29,54
Coleraine,374,2,14,10,2,43,26,17,52
Glenavon,374,3,10,9,7,56,43,13,39
Linfield,374,4,10,5,11,38,39,-1,35
Cliftonville,374,5,10,4,12,35,32,3,34
Ballymena,374,6,8,4,14,29,49,-20,28
Glentoran,374,7,6,6,10,24,32,-8,24
Dungannon,374,8,2,4,16,14,47,-33,10
Crusaders,375,1,17,6,3,63,30,33,57
Coleraine,375,2,15,10,1,45,22,23,55
Linfield,375,3,11,5,10,38,36,2,38
Glenavon,375,4,9,9,8,52,45,7,36
Cliftonville,375,5,9,4,13,32,32,0,31
Ballymena,375,6,7,4,15,25,49,-24,25
Glentoran,375,7,6,6,10,24,32,-8,24
Dungannon,375,8,2,4,16,14,47,-33,10
Crusaders,376,1,16,6,4,61,31,30,54
Coleraine,376,2,14,10,2,43,25,18,52
Glenavon,376,3,10,9,7,55,43,12,39
Linfield,376,4,10,6,10,38,37,1,36
Cliftonville,376,5,9,5,12,33,32,1,32
Ballymena,376,6,8,4,14,26,47,-21,28
Glentoran,376,7,6,6,10,24,32,-8,24
Dungannon,376,8,2,4,16,14,47,-33,10
Coleraine,377,1,15,10,1,45,22,23,55
Crusaders,377,2,16,6,4,63,33,30,54
Glenavon,377,3,9,9,8,52,45,7,36
Linfield,377,4,10,5,11,37,37,0,35
Cliftonville,377,5,10,4,12,33,31,2,34
Ballymena,377,6,8,4,14,28,49,-21,28
Glentoran,377,7,6,6,10,24,32,-8,24
Dungannon,377,8,2,4,16,14,47,-33,10
Crusaders,378,1,16,7,3,61,30,31,55
Coleraine,378,2,15,10,1,46,23,23,55
Linfield,378,3,11,5,10,39,36,3,38
Glenavon,378,4,9,9,8,53,46,7,36
Cliftonville,378,5,9,4,13,32,33,-1,31
Ballymena,378,6,7,5,14,25,47,-22,26
Glentoran,378,7,6,6,10,24,32,-8,24
Dungannon,378,8,2,4,16,14,47,-33,10
Crusaders,379,1,16,7,3,63,32,31,55
Coleraine,379,2,15,10,1,47,23,24,55
Glenavon,379,3,9,9,8,53,47,6,36
Linfield,379,4,10,5,11,38,38,0,35
Cliftonville,379,5,10,4,12,34,32,2,34
Ballymena,379,6,7,5,14,27,49,-22,26
Glentoran,379,7,6,6,10,24,32,-8,24
Dungannon,379,8,2,4,16,14,47,-33,10
Crusaders,380,1,16,7,3,61,30,31,55
Coleraine,380,2,15,10,1,47,23,24,55
Glenavon,380,3,9,9,8,53,47,6,36
Linfield,380,4,10,6,10,38,37,1,36
Cliftonville,380,5,9,5,12,33,32,1,32
Ballymena,380,6,7,5,14,25,47,-22,26
Glentoran,380,7,6,6,10,24,32,-8,24
Dungannon,380,8,2,4,16,14,47,-33,10
Crusaders,381,1,17,6,3,62,30,32,57
Coleraine,381,2,14,10,2,44,25,19,52
Glenavon,381,3,10,9,7,55,44,11,39
Linfield,381,4,11,5,10,42,38,4,38
Cliftonville,381,5,9,4,13,34,36,-2,31
Ballymena,381,6,7,4,15,25,48,-23,25
Glentoran,381,7,6,6,10,24,32,-8,24
Dungannon,381,8,2,4,16,14,47,-33,10
Crusaders,382,1,17,6,3,63,31,32,57
Coleraine,382,2,14,10,2,44,24,20,52
Glenavon,382,3,10,9,7,54,44,10,39
Linfield,382,4,10,5,11,37,41,-4,35
Cliftonville,382,5,10,4,12,37,31,6,34
Ballymena,382,6,7,4,15,26,49,-23,25
Glentoran,382,7,6,6,10,24,32,-8,24
Dungannon,382,8,2,4,16,14,47,-33,10
Crusaders,383,1,17,6,3,63,31,32,57
Coleraine,383,2,14,10,2,44,28,16,52
Glenavon,383,3,10,9,7,58,44,14,39
Linfield,383,4,11,5,10,39,37,2,38
Cliftonville,383,5,9,4,13,33,33,0,31
Ballymena,383,6,7,4,15,26,49,-23,25
Glentoran,383,7,6,6,10,24,32,-8,24
Dungannon,383,8,2,4,16,14,47,-33,10
Crusaders,384,1,17,6,3,65,31,34,57
Coleraine,384,2,14,10,2,45,25,20,52
Glenavon,384,3,10,9,7,55,45,10,39
Linfield,384,4,11,5,10,41,36,5,38
Cliftonville,384,5,9,4,13,32,35,-3,31
Ballymena,384,6,7,4,15,26,51,-25,25
Glentoran,384,7,6,6,10,24,32,-8,24
Dungannon,384,8,2,4,16,14,47,-33,10
Coleraine,385,1,15,10,1,45,23,22,55
Crusaders,385,2,16,6,4,63,33,30,54
Linfield,385,3,11,5,10,40,36,4,38
Glenavon,385,4,9,9,8,53,45,8,36
Cliftonville,385,5,9,4,13,32,34,-2,31
Ballymena,385,6,8,4,14,28,49,-21,28
Glentoran,385,7,6,6,10,24,32,-8,24
Dungannon,385,8,2,4,16,14,47,-33,10
Coleraine,386,1,15,10,1,47,22,25,55
Crusaders,386,2,16,6,4,63,34,29,54
Glenavon,386,3,9,9,8,52,47,5,36
Linfield,386,4,10,6,10,38,37,1,36
Cliftonville,386,5,9,5,12,33,32,1,32
Ballymena,386,6,8,4,14,29,49,-20,28
Glentoran,386,7,6,6,10,24,32,-8,24
Dungannon,386,8,2,4,16,14,47,-33,10
Crusaders,387,1,16,6,4,61,33,28,54
Coleraine,387,2,14,10,2,44,26,18,52
Glenavon,387,3,10,9,7,56,44,12,39
Linfield,387,4,10,5,11,40,40,0,35
Cliftonville,387,5,10,4,12,36,34,2,34
Ballymena,387,6,8,4,14,28,47,-19,28
Glentoran,387,7,6,6,10,24,32,-8,24
Dungannon,387,8,2,4,16,14,47,-33,10
Crusaders,388,1,16,6,4,63,35,28,54
Coleraine,388,2,14,10,2,45,25,20,52
Glenavon,388,3,10,9,7,55,45,10,39
Linfield,388,4,10,5,11,38,38,0,35
Cliftonville,388,5,10,4,12,34,32,2,34
Ballymena,388,6,8,4,14,30,49,-19,28
Glentoran,388,7,6,6,10,24,32,-8,24
Dungannon,388,8,2,4,16,14,47,-33,10
Crusaders,389,1,16,7,3,61,30,31,55
Coleraine,389,2,14,10,2,45,25,20,52
Glenavon,389,3,10,9,7,55,45,10,39
Linfield,389,4,10,6,10,38,37,1,36
Cliftonville,389,5,9,5,12,33,32,1,32
Ballymena,389,6,7,5,14,25,47,-22,26
Glentoran,389,7,6,6,10,24,32,-8,24
Dungannon,389,8,2,4,16,14,47,-33,10
Crusaders,390,1,17,6,3,63,31,32,57
Coleraine,390,2,14,10,2,43,23,20,52
Glenavon,390,3,10,9,7,53,43,10,39
Linfield,390,4,11,5,10,38,36,2,38
Cliftonville,390,5,9,4,13,32,32,0,31
Ballymena,390,6,7,4,15,26,49,-23,25
Glentoran,390,7,6,6,10,24,32,-8,24
Dungannon,390,8,2,4,16,14,47,-33,10
Crusaders,391,1,17,6,3,65,31,34,57
Coleraine,391,2,15,10,1,44,22,22,55
Linfield,391,3,11,5,10,38,36,2,38
Glenavon,391,4,9,9,8,52,44,8,36
Cliftonville,391,5,9,4,13,32,32,0,31
Ballymena,391,6,7,4,15,26,51,-25,25
Glentoran,391,7,6,6,10,24,32,-8,24
Dungannon,391,8,2,4,16,14,47,-33,10
Crusaders,392,1,16,7,3,62,31,31,55
Coleraine,392,2,14,10,2,44,25,19,52
Glenavon,392,3,10,9,7,55,44,11,39
Linfield,392,4,10,5,11,37,38,-1,35
Cliftonville,392,5,10,4,12,34,31,3,34
Ballymena,392,6,7,5,14,26,48,-22,26
Glentoran,392,7,6,6,10,24,32,-8,24
Dungannon,392,8,2,4,16,14,47,-33,10
Crusaders,393,1,17,6,3,63,30,33,57
Coleraine,393,2,14,10,2,44,26,18,52
Glenavon,393,3,10,9,7,56,44,12,39
Linfield,393,4,11,5,10,38,36,2,38
Cliftonville,393,5,9,4,13,32,32,0,31
Ballymena,393,6,7,4,15,25,49,-24,25
Glentoran,393,7,6,6,10,24,32,-8,24
Dungannon,393,8,2,4,16,14,47,-33,10
Crusaders,394,1,16,6,4,63,33,30,54
Coleraine,394,2,14,10,2,46,27,19,52
Glenavon,394,3,10,9,7,57,46,11,39
Linfield,394,4,10,5,11,38,38,0,35
Cliftonville,394,5,10,4,12,34,32,2,34
Ballymena,394,6,8,4,14,28,49,-21,28
Glentoran,394,7,6,6,10,24,32,-8,24
Dungannon,394,8,2,4,16,14,47,-33,10
Crusaders,395,1,17,6,3,64,31,33,57
Coleraine,395,2,14,11,1,44,23,21,53
Glenavon,395,3,9,10,7,53,44,9,37
Linfield,395,4,10,6,10,38,37,1,36
Cliftonville,395,5,9,5,12,33,32,1,32
Ballymena,395,6,7,4,15,26,50,-24,25
Glentoran,395,7,6,6,10,24,32,-8,24
Dungannon,395,8,2,4,16,14,47,-33,10
Crusaders,396,1,16,7,3,61,30,31,55
Coleraine,396,2,14,11,1,44,23,21,53
Linfield,396,3,11,5,10,38,36,2,38
Glenavon,396,4,9,10,7,53,44,9,37
Cliftonville,396,5,9,4,13,32,32,0,31
Ballymena,396,6,7,5,14,25,47,-22,26
Glentoran,396,7,6,6,10,24,32,-8,24
Dungannon,396,8,2,4,16,14,47,-33,10
Crusaders,397,1,17,6,3,62,30,32,57
Coleraine,397,2,14,10,2,44,24,20,52
Glenavon,397,3,10,9,7,54,44,10,39
Linfield,397,4,11,5,10,38,36,2,38
Cliftonville,397,5,9,4,13,32,32,0,31
Ballymena,397,6,7,4,15,25,48,-23,25
Glentoran,397,7,6,6,10,24,32,-8,24
Dungannon,397,8,2,4,16,14,47,-33,10
Crusaders,398,1,16,7,3,62,31,31,55
Coleraine,398,2,15,10,1,45,23,22,55
Linfield,398,3,11,5,10,39,37,2,38
Glenavon,398,4,9,9,8,53,45,8,36
Cliftonville,398,5,9,4,13,33,33,0,31
Ballymena,398,6,7,5,14,26,48,-22,26
Glentoran,398,7,6,6,10,24,32,-8,24
Dungannon,398,8,2,4,16,14,47,-33,10
Coleraine,399,1,15,10,1,46,23,23,55
Crusaders,399,2,16,6,4,61,32,29,54
Glenavon,399,3,9,9,8,53,46,7,36
Linfield,399,4,10,6,10,39,38,1,36
Cliftonville,399,5,9,5,12,34,33,1,32
Ballymena,399,6,8,4,14,27,47,-20,28
Glentoran,399,7,6,6,10,24,32,-8,24
Dungannon,399,8,2,4,16,14,47,-33,10
Crusaders,400,1,16,7,3,61,30,31,55
Coleraine,400,2,14,11,1,44,23,21,53
Linfield,400,3,11,5,10,41,38,3,38
Glenavon,400,4,9,10,7,53,44,9,37
Cliftonville,400,5,9,4,13,34,35,-1,31
Ballymena,400,6,7,5,14,25,47,-22,26
Glentoran,400,7,6,6,10,24,32,-8,24
Dungannon,400,8,2,4,16,14,47,-33,10
Crusaders,401,1,17,6,3,64,30,34,57
Coleraine,401,2,15,10,1,46,23,23,55
Linfield,401,3,11,5,10,39,36,3,38
Glenavon,401,4,9,9,8,53,46,7,36
Cliftonville,401,5,9,4,13,32,33,-1,31
Ballymena,401,6,7,4,15,25,50,-25,25
Glentoran,401,7,6,6,10,24,32,-8,24
Dungannon,401,8,2,4,16,14,47,-33,10
Crusaders,402,1,16,7,3,62,31,31,55
Coleraine,402,2,14,11,1,44,23,21,53
Linfield,402,3,11,5,10,39,36,3,38
Glenavon,402,4,9,10,7,53,44,9,37
Cliftonville,402,5,9,4,13,32,33,-1,31
Ballymena,402,6,7,5,14,26,48,-22,26
Glentoran,402,7,6,6,10,24,32,-8,24
Dungannon,402,8,2,4,16,14,47,-33,10
Crusaders,403,1,16,7,3,63,32,31,55
Coleraine,403,2,15,10,1,46,24,22,55
Glenavon,403,3,9,9,8,54,46,8,36
Linfield,403,4,10,5,11,37,37,0,35
Cliftonville,403,5,10,4,12,33,31,2,34
Ballymena,403,6,7,5,14,27,49,-22,26
Glentoran,403,7,6,6,10,24,32,-8,24
Dungannon,403,8,2,4,16,14,47,-33,10
Coleraine,404,1,15,10,1,47,23,24,55
Crusaders,404,2,16,6,4,61,31,30,54
Glenavon,404,3,9,9,8,53,47,6,36
Linfield,404,4,10,6,10,39,38,1,36
Cliftonville,404,5,9,5,12,34,33,1,32
Ballymena,404,6,8,4,14,26,47,-21,28
Glentoran,404,7,6,6,10,24,32,-8,24
Dungannon,404,8,2,4,16,14,47,-33,10
Crusaders,405,1,16,6,4,63,34,29,54
Coleraine,405,2,14,10,2,45,26,19,52
Glenavon,405,3,10,9,7,56,45,11,39
Linfield,405,4,11,5,10,38,36,2,38
Cliftonville,405,5,9,4,13,32,32,0,31
Ballymena,405,6,8,4,14,29,49,-20,28
Glentoran,405,7,6,6,10,24,32,-8,24
Dungannon,405,8,2,4,16,14,47,-33,10
Crusaders,406,1,17,6,3,63,30,33,57
Coleraine,406,2,15,10,1,45,22,23,55
Glenavon,406,3,9,9,8,52,45,7,36
Linfield,406,4,10,6,10,38,37,1,36
Cliftonville,406,5,9,5,12,33,32,1,32
Ballymena,406,6,7,4,15,25,49,-24,25
Glentoran,406,7,6,6,10,24,32,-8,24
Dungannon,406,8,2,4,16,14,47,-33,10
Coleraine,407,1,15,10,1,47,25,22,55
Crusaders,407,2,16,6,4,61,31,30,54
Linfield,407,3,11,5,10,41,36,5,38
Glenavon,407,4,9,9,8,55,47,8,36
Cliftonville,407,5,9,4,13,32,35,-3,31
Ballymena,407,6,8,4,14,26,47,-21,28
Glentoran,407,7,6,6,10,24,32,-8,24
Dungannon,407,8,2,4,16,14,47,-33,10
Crusaders,408,1,16,7,3,63,32,31,55
Coleraine,408,2,15,10,1,46,24,22,55
Glenavon,408,3,9,9,8,54,46,8,36
Linfield,408,4,10,5,11,37,37,0,35
Cliftonville,408,5,10,4,12,33,31,2,34
Ballymena,408,6,7,5,14,27,49,-22,26
Glentoran,408,7,6,6,10,24,32,-8,24
Dungannon,408,8,2,4,16,14,47,-33,10
Crusaders,409,1,16,6,4,64,35,29,54
Coleraine,409,2,14,10,2,45,26,19,52
Glenavon,409,3,10,9,7,56,45,11,39
Linfield,409,4,10,5,11,38,39,-1,35
Cliftonville,409,5,10,4,12,35,32,3,34
Ballymena,409,6,8,4,14,30,50,-20,28
Glentoran,409,7,6,6,10,24,32,-8,24
Dungannon,409,8,2,4,16,14,47,-33,10
Crusaders,410,1,16,6,4,62,32,30,54
Coleraine,410,2,14,11,1,47,26,21,53
Glenavon,410,3,9,10,7,56,47,9,37
Linfield,410,4,10,5,11,38,38,0,35
Cliftonville,410,5,10,4,12,34,32,2,34
Ballymena,410,6,8,4,14,27,48,-21,28
Glentoran,410,7,6,6,10,24,32,-8,24
Dungannon,410,8,2,4,16,14,47,-33,10
Crusaders,411,1,16,7,3,61,30,31,55
Coleraine,411,2,14,10,2,45,26,19,52
Glenavon,411,3,10,9,7,56,45,11,39
Linfield,411,4,11,5,10,39,36,3,38
Cliftonville,411,5,9,4,13,32,33,-1,31
Ballymena,411,6,7,5,14,25,47,-22,26
Glentoran,411,7,6,6,10,24,32,-8,24
Dungannon,411,8,2,4,16,14,47,-33,10
Crusaders,412,1,17,6,3,63,31,32,57
Coleraine,412,2,14,10,2,44,24,20,52
Glenavon,412,3,10,9,7,54,44,10,39
Linfield,412,4,10,6,10,37,36,1,36
Cliftonville,412,5,9,5,12,32,31,1,32
Ballymena,412,6,7,4,15,26,49,-23,25
Glentoran,412,7,6,6,10,24,32,-8,24
Dungannon,412,8,2,4,16,14,47,-33,10
Crusaders,413,1,17,6,3,63,30,33,57
Coleraine,413,2,15,10,1,45,23,22,55
Glenavon,413,3,9,9,8,53,45,8,36
Linfield,413,4,10,6,10,38,37,1,36
Cliftonville,413,5,9,5,12,33,32,1,32
Ballymena,413,6,7,4,15,25,49,-24,25
Glentoran,413,7,6,6,10,24,32,-8,24
Dungannon,413,8,2,4,16,14,47,-33,10
Crusaders,414,1,17,6,3,65,31,34,57
Coleraine,414,2,15,10,1,45,23,22,55
Glenavon,414,3,9,9,8,53,45,8,36
Linfield,414,4,10,6,10,37,36,1,36
Cliftonville,414,5,9,5,12,32,31,1,32
Ballymena,414,6,7,4,15,26,51,-25,25
Glentoran,414,7,6,6,10,24,32,-8,24
Dungannon,414,8,2,4,16,14,47,-33,10
Crusaders,415,1,17,6,3,64,32,32,57
Coleraine,415,2,15,10,1,46,24,22,55
Glenavon,415,3,9,9,8,54,46,8,36
Linfield,415,4,10,5,11,37,38,-1,35
Cliftonville,415,5,10,4,12,34,31,3,34
Ballymena,415,6,7,4,15,27,50,-23,25
Glentoran,415,7,6,6,10,24,32,-8,24
Dungannon,415,8,2,4,16,14,47,-33,10
Crusaders,416,1,16,7,3,61,30,31,55
Coleraine,416,2,15,10,1,45,23,22,55
Glenavon,416,3,9,9,8,53,45,8,36
Linfield,416,4,10,5,11,37,38,-1,35
Cliftonville,416,5,10,4,12,34,31,3,34
Ballymena,416,6,7,5,14,25,47,-22,26
Glentoran,416,7,6,6,10,24,32,-8,24
Dungannon,416,8,2,4,16,14,47,-33,10
Crusaders,417,1,16,7,3,62,31,31,55
Coleraine,417,2,15,10,1,45,23,22,55
Glenavon,417,3,9,9,8,53,45,8,36
Linfield,417,4,10,6,10,37,36,1,36
Cliftonville,417,5,9,5,12,32,31,1,32
Ballymena,417,6,7,5,14,26,48,-22,26
Glentoran,417,7,6,6,10,24,32,-8,24
Dungannon,417,8,2,4,16,14,47,-33,10
Crusaders,418,1,16,6,4,62,32,30,54
Coleraine,418,2,14,10,2,43,24,19,52
Glenavon,418,3,10,9,7,54,43,11,39
Linfield,418,4,11,5,10,39,37,2,38
Cliftonville,418,5,9,4,13,33,33,0,31
Ballymena,418,6,8,4,14,27,48,-21,28
Glentoran,418,7,6,6,10,24,32,-8,24
Dungannon,418,8,2,4,16,14,47,-33,10
Coleraine,419,1,15,10,1,44,22,22,55
Crusaders,419,2,16,6,4,62,32,30,54
Glenavon,419,3,9,9,8,52,44,8,36
Linfield,419,4,10,5,11,37,38,-1,35
Cliftonville,419,5,10,4,12,34,31,3,34
Ballymena,419,6,8,4,14,27,48,-21,28
Glentoran,419,7,6,6,10,24,32,-8,24
Dungannon,419,8,2,4,16,14,47,-33,10
Crusaders,420,1,17,6,3,65,30,35,57
Coleraine,420,2,14,10,2,43,23,20,52
Glenavon,420,3,10,9,7,53,43,10,39
Linfield,420,4,10,5,11,37,39,-2,35
Cliftonville,420,5,10,4,12,35,31,4,34
Ballymena,420,6,7,4,15,25,51,-26,25
Glentoran,420,7,6,6,10,24,32,-8,24
Dungannon,420,8,2,4,16,14,47,-33,10
Crusaders,421,1,17,6,3,64,30,34,57
Coleraine,421,2,14,11,1,44,23,21,53
Linfield,421,3,11,5,10,40,37,3,38
Glenavon,421,4,9,10,7,53,44,9,37
Cliftonville,421,5,9,4,13,33,34,-1,31
Ballymena,421,6,7,4,15,25,50,-25,25
Glentoran,421,7,6,6,10,24,32,-8,24
Dungannon,421,8,2,4,16,14,47,-33,10
Crusaders,422,1,16,7,3,62,31,31,55
Coleraine,422,2,14,11,1,46,25,21,53
Linfield,422,3,11,5,10,39,37,2,38
Glenavon,422,4,9,10,7,55,46,9,37
Cliftonville,422,5,9,4,13,33,33,0,31
Ballymena,422,6,7,5,14,26,48,-22,26
Glentoran,422,7,6,6,10,24,32,-8,24
Dungannon,422,8,2,4,16,14,47,-33,10
Crusaders,423,1,17,6,3,64,32,32,57
Coleraine,423,2,14,11,1,43,22,21,53
Linfield,423,3,11,5,10,38,36,2,38
Glenavon,423,4,9,10,7,52,43,9,37
Cliftonville,423,5,9,4,13,32,32,0,31
Ballymena,423,6,7,4,15,27,50,-23,25
Glentoran,423,7,6,6,10,24,32,-8,24
Dungannon,423,8,2,4,16,14,47,-33,10
Crusaders,424,1,16,7,3,63,32,31,55
Coleraine,424,2,14,10,2,43,24,19,52
Glenavon,424,3,10,9,7,54,43,11,39
Linfield,424,4,10,5,11,38,38,0,35
Cliftonville,424,5,10,4,12,34,32,2,34
Ballymena,424,6,7,5,14,27,49,-22,26
Glentoran,424,7,6,6,10,24,32,-8,24
Dungannon,424,8,2,4,16,14,47,-33,10
Crusaders,425,1,16,6,4,63,34,29,54
Coleraine,425,2,14,10,2,44,24,20,52
Glenavon,425,3,10,9,7,54,44,10,39
Linfield,425,4,10,6,10,37,36,1,36
Cliftonville,425,5,9,5,12,32,31,1,32
Ballymena,425,6,8,4,14,29,49,-20,28
Glentoran,425,7,6,6,10,24,32,-8,24
Dungannon,425,8,2,4,16,14,47,-33,10
Crusaders,426,1,17,6,3,64,30,34,57
Coleraine,426,2,14,10,2,44,25,19,52
Glenavon,426,3,10,9,7,55,44,11,39
Linfield,426,4,10,5,11,37,37,0,35
Cliftonville,426,5,10,4,12,33,31,2,34
Ballymena,426,6,7,4,15,25,50,-25,25
Glentoran,426,7,6,6,10,24,32,-8,24
Dungannon,426,8,2,4,16,14,47,-33,10
Crusaders,427,1,17,6,3,64,32,32,57
Coleraine,427,2,14,11,1,44,23,21,53
Linfield,427,3,11,5,10,40,36,4,38
Glenavon,427,4,9,10,7,53,44,9,37
Cliftonville,427,5,9,4,13,32,34,-2,31
Ballymena,427,6,7,4,15,27,50,-23,25
Glentoran,427,7,6,6,10,24,32,-8,24
Dungannon,427,8,2,4,16,14,47,-33,10
Crusaders,428,1,16,7,3,63,32,31,55
Coleraine,428,2,14,11,1,45,24,21,53
Linfield,428,3,11,5,10,39,37,2,38
Glenavon,428,4,9,10,7,54,45,9,37
Cliftonville,428,5,9,4,13,33,33,0,31
Ballymena,428,6,7,5,14,27,49,-22,26
Glentoran,428,7,6,6,10,24,32,-8,24
Dungannon,428,8,2,4,16,14,47,-33,10
Crusaders,429,1,17,6,3,64,30,34,57
Coleraine,429,2,14,10,2,44,25,19,52
Glenavon,429,3,10,9,7,55,44,11,39
Linfield,429,4,11,5,10,41,37,4,38
Cliftonville,429,5,9,4,13,33,35,-2,31
Ballymena,429,6,7,4,15,25,50,-25,25
Glentoran,429,7,6,6,10,24,32,-8,24
Dungannon,429,8,2,4,16,14,47,-33,10
Crusaders,430,1,16,6,4,62,32,30,54
Coleraine,430,2,14,10,2,43,24,19,52
Glenavon,430,3,10,9,7,54,43,11,39
Linfield,430,4,10,5,11,37,39,-2,35
Cliftonville,430,5,10,4,12,35,31,4,34
Ballymena,430,6,8,4,14,27,48,-21,28
Glentoran,430,7,6,6,10,24,32,-8,24
Dungannon,430,8,2,4,16,14,47,-33,10
Crusaders,431,1,17,6,3,64,31,33,57
Coleraine,431,2,14,10,2,43,23,20,52
Glenavon,431,3,10,9,7,53,43,10,39
Linfield,431,4,10,6,10,37,36,1,36
Cliftonville,431,5,9,5,12,32,31,1,32
Ballymena,431,6,7,4,15,26,50,-24,25
Glentoran,431,7,6,6,10,24,32,-8,24
Dungannon,431,8,2,4,16,14,47,-33,10
Crusaders,432,1,17,6,3,65,32,33,57
Coleraine,432,2,14,11,1,43,22,21,53
Glenavon,432,3,9,10,7,52,43,9,37
Linfield,432,4,10,5,11,38,40,-2,35
Cliftonville,432,5,10,4,12,36,32,4,34
Ballymena,432,6,7,4,15,27,51,-24,25
Glentoran,432,7,6,6,10,24,32,-8,24
Dungannon,432,8,2,4,16,14,47,-33,10
Coleraine,433,1,15,10,1,46,24,22,55
Crusaders,433,2,16,6,4,62,32,30,54
Linfield,433,3,11,5,10,38,36,2,38
Glenavon,433,4,9,9,8,54,46,8,36
Cliftonville,433,5,9,4,13,32,32,0,31
Ballymena,433,6,8,4,14,27,48,-21,28
Glentoran,433,7,6,6,10,24,32,-8,24
Dungannon,433,8,2,4,16,14,47,-33,10
Crusaders,434,1,16,7,3,62,31,31,55
Coleraine,434,2,14,10,2,43,24,19,52
Glenavon,434,3,10,9,7,54,43,11,39
Linfield,434,4,10,6,10,39,38,1,36
Cliftonville,434,5,9,5,12,34,33,1,32
Ballymena,434,6,7,5,14,26,48,-22,26
Glentoran,434,7,6,6,10,24,32,-8,24
Dungannon,434,8,2,4,16,14,47,-33,10
Crusaders,435,1,17,6,3,65,30,35,57
Coleraine,435,2,15,10,1,49,22,27,55
Linfield,435,3,11,5,10,41,36,5,38
Glenavon,435,4,9,9,8,52,49,3,36
Cliftonville,435,5,9,4,13,32,35,-3,31
Ballymena,435,6,7,4,15,25,51,-26,25
Glentoran,435,7,6,6,10,24,32,-8,24
Dungannon,435,8,2,4,16,14,47,-33,10
Crusaders,436,1,17,6,3,62,30,32,57
Coleraine,436,2,14,10,2,43,26,17,52
Glenavon,436,3,10,9,7,56,43,13,39
Linfield,436,4,10,6,10,38,37,1,36
Cliftonville,436,5,9,5,12,33,32,1,32
Ballymena,436,6,7,4,15,25,48,-23,25
Glentoran,436,7,6,6,10,24,32,-8,24
Dungannon,436,8,2,4,16,14,47,-33,10
Crusaders,437,1,17,6,3,63,31,32,57
Coleraine,437,2,14,10,2,43,25,18,52
Glenavon,437,3,10,9,7,55,43,12,39
Linfield,437,4,11,5,10,38,36,2,38
Cliftonville,437,5,9,4,13,32,32,0,31
Ballymena,437,6,7,4,15,26,49,-23,25
Glentoran,437,7,6,6,10,24,32,-8,24
Dungannon,437,8,2,4,16,14,47,-33,10
Crusaders,438,1,17,6,3,64,32,32,57
Coleraine,438,2,14,10,2,45,25,20,52
Glenavon,438,3,10,9,7,55,45,10,39
Linfield,438,4,10,6,10,37,36,1,36
Cliftonville,438,5,9,5,12,32,31,1,32
Ballymena,438,6,7,4,15,27,50,-23,25
Glentoran,438,7,6,6,10,24,32,-8,24
Dungannon,438,8,2,4,16,14,47,-33,10
Crusaders,439,1,16,7,3,61,30,31,55
Coleraine,439,2,14,10,2,43,26,17,52
Glenavon,439,3,10,9,7,56,43,13,39
Linfield,439,4,10,5,11,37,37,0,35
Cliftonville,439,5,10,4,12,33,31,2,34
Ballymena,439,6,7,5,14,25,47,-22,26
Glentoran,439,7,6,6,10,24,32,-8,24
Dungannon,439,8,2,4,16,14,47,-33,10
Crusaders,440,1,17,6,3,65,30,35,57
Coleraine,440,2,14,10,2,43,26,17,52
Glenavon,440,3,10,9,7,56,43,13,39
Linfield,440,4,10,6,10,38,37,1,36
Cliftonville,440,5,9,5,12,33,32,1,32
Ballymena,440,6,7,4,15,25,51,-26,25
Glentoran,440,7,6,6,10,24,32,-8,24
Dungannon,440,8,2,4,16,14,47,-33,10
Crusaders,441,1,17,6,3,64,32,32,57
Coleraine,441,2,14,10,2,44,24,20,52
Glenavon,441,3,10,9,7,54,44,10,39
Linfield,441,4,10,5,11,37,38,-1,35
Cliftonville,441,5,10,4,12,34,31,3,34
Ballymena,441,6,7,4,15,27,50,-23,25
Glentoran,441,7,6,6,10,24,32,-8,24
Dungannon,441,8,2,4,16,14,47,-33,10
Crusaders,442,1,17,6,3,62,30,32,57
Coleraine,442,2,15,10,1,47,22,25,55
Glenavon,442,3,9,9,8,52,47,5,36
Linfield,442,4,10,5,11,37,39,-2,35
Cliftonville,442,5,10,4,12,35,31,4,34
Ballymena,442,6,7,4,15,25,48,-23,25
Glentoran,442,7,6,6,10,24,32,-8,24
Dungannon,442,8,2,4,16,14,47,-33,10
Crusaders,443,1,16,7,3,61,30,31,55
Coleraine,443,2,14,10,2,44,24,20,52
Glenavon,443,3,10,9,7,54,44,10,39
Linfield,443,4,10,5,11,38,38,0,35
Cliftonville,443,5,10,4,12,34,32,2,34
Ballymena,443,6,7,5,14,25,47,-22,26
Glentoran,443,7,6,6,10,24,32,-8,24
Dungannon,443,8,2,4,16,14,47,-33,10
Crusaders,444,1,17,6,3,63,31,32,57
Coleraine,444,2,14,11,1,45,24,21,53
Linfield,444,3,11,5,10,38,36,2,38
Glenavon,444,4,9,10,7,54,45,9,37
Cliftonville,444,5,9,4,13,32,32,0,31
Ballymena,444,6,7,4,15,26,49,-23,25
Glentoran,444,7,6,6,10,24,32,-8,24
Dungannon,444,8,2,4,16,14,47,-33,10
Crusaders,445,1,16,7,3,63,32,31,55
Coleraine,445,2,14,10,2,44,25,19,52
Glenavon,445,3,10,9,7,55,44,11,39
Linfield,445,4,11,5,10,38,36,2,38
Cliftonville,445,5,9,4,13,32,32,0,31
Ballymena,445,6,7,5,14,27,49,-22,26
Glentoran,445,7,6,6,10,24,32,-8,24
Dungannon,445,8,2,4,16,14,47,-33,10
Crusaders,446,1,16,7,3,61,30,31,55
Coleraine,446,2,15,10,1,48,23,25,55
Glenavon,446,3,9,9,8,53,48,5,36
Linfield,446,4,10,6,10,37,36,1,36
Cliftonville,446,5,9,5,12,32,31,1,32
Ballymena,446,6,7,5,14,25,47,-22,26
Glentoran,446,7,6,6,10,24,32,-8,24
Dungannon,446,8,2,4,16,14,47,-33,10
Crusaders,447,1,17,6,3,62,30,32,57
Coleraine,447,2,15,10,1,46,23,23,55
Glenavon,447,3,9,9,8,53,46,7,36
Linfield,447,4,10,5,11,38,38,0,35
Cliftonville,447,5,10,4,12,34,32,2,34
Ballymena,447,6,7,4,15,25,48,-23,25
Glentoran,447,7,6,6,10,24,32,-8,24
Dungannon,447,8,2,4,16,14,47,-33,10
Crusaders,448,1,16,7,3,62,31,31,55
Coleraine,448,2,14,10,2,44,28,16,52
Glenavon,448,3,10,9,7,58,44,14,39
Linfield,448,4,11,5,10,39,37,2,38
Cliftonville,448,5,9,4,13,33,33,0,31
Ballymena,448,6,7,5,14,26,48,-22,26
Glentoran,448,7,6,6,10,24,32,-8,24
Dungannon,448,8,2,4,16,14,47,-33,10
Crusaders,449,1,17,6,3,65,30,35,57
Coleraine,449,2,14,10,2,43,24,19,52
Glenavon,449,3,10,9,7,54,43,11,39
Linfield,449,4,11,5,10,41,38,3,38
Cliftonville,449,5,9,4,13,34,35,-1,31
Ballymena,449,6,7,4,15,25,51,-26,25
Glentoran,449,7,6,6,10,24,32,-8,24
Dungannon,449,8,2,4,16,14,47,-33,10
Crusaders,450,1,16,7,3,62,31,31,55
Coleraine,450,2,14,10,2,43,23,20,52
Glenavon,450,3,10,9,7,53,43,10,39
Linfield,450,4,10,5,11,39,39,0,35
Cliftonville,450,5,10,4,12,35,33,2,34
Ballymena,450,6,7,5,14,26,48,-22,26
Glentoran,450,7,6,6,10,24,32,-8,24
Dungannon,450,8,2,4,16,14,47,-33,10
Crusaders,451,1,16,6,4,62,32,30,54
Coleraine,451,2,14,10,2,45,25,20,52
Glenavon,451,3,10,9,7,55,45,10,39
Linfield,451,4,10,6,10,37,36,1,36
Cliftonville,451,5,9,5,12,32,31,1,32
Ballymena,451,6,8,4,14,27,48,-21,28
Glentoran,451,7,6,6,10,24,32,-8,24
Dungannon,451,8,2,4,16,14,47,-33,10
Crusaders,452,1,16,7,3,63,32,31,55
Coleraine,452,2,14,10,2,44,24,20,52
Glenavon,452,3,10,9,7,54,44,10,39
Linfield,452,4,10,5,11,37,37,0,35
Cliftonville,452,5,10,4,12,33,31,2,34
Ballymena,452,6,7,5,14,27,49,-22,26
Glentoran,452,7,6,6,10,24,32,-8,24
Dungannon,452,8,2,4,16,14,47,-33,10
Crusaders,453,1,17,6,3,65,31,34,57
Coleraine,453,2,14,10,2,45,25,20,52
Glenavon,453,3,10,9,7,55,45,10,39
Linfield,453,4,10,6,10,38,37,1,36
Cliftonville,453,5,9,5,12,33,32,1,32
Ballymena,453,6,7,4,15,26,51,-25,25
Glentoran,453,7,6,6,10,24,32,-8,24
Dungannon,453,8,2,4,16,14,47,-33,10
Crusaders,454,1,17,6,3,63,31,32,57
Coleraine,454,2,14,10,2,44,24,20,52
Glenavon,454,3,10,9,7,54,44,10,39
Linfield,454,4,10,6,10,38,37,1,36
Cliftonville,454,5,9,5,12,33,32,1,32
Ballymena,454,6,7,4,15,26,49,-23,25
Glentoran,454,7,6,6,10,24,32,-8,24
Dungannon,454,8,2,4,16,14,47,-33,10
Crusaders,455,1,16,6,4,61,32,29,54
Coleraine,455,2,14,10,2,45,26,19,52
Glenavon,455,3,10,9,7,56,45,11,39
Linfield,455,4,10,6,10,39,38,1,36
Cliftonville,455,5,9,5,12,34,33,1,32
Ballymena,455,6,8,4,14,27,47,-20,28
Glentoran,455,7,6,6,10,24,32,-8,24
Dungannon,455,8,2,4,16,14,47,-33,10
Crusaders,456,1,17,6,3,62,30,32,57
Coleraine,456,2,15,10,1,48,23,25,55
Glenavon,456,3,9,9,8,53,48,5,36
Linfield,456,4,10,6,10,38,37,1,36
Cliftonville,456,5,9,5,12,33,32,1,32
Ballymena,456,6,7,4,15,25,48,-23,25
Glentoran,456,7,6,6,10,24,32,-8,24
Dungannon,456,8,2,4,16,14,47,-33,10
Crusaders,457,1,17,6,3,63,30,33,57
Coleraine,457,2,14,10,2,45,27,18,52
Glenavon,457,3,10,9,7,57,45,12,39
Linfield,457,4,11,5,10,39,37,2,38
Cliftonville,457,5,9,4,13,33,33,0,31
Ballymena,457,6,7,4,15,25,49,-24,25
Glentoran,457,7,6,6,10,24,32,-8,24
Dungannon,457,8,2,4,16,14,47,-33,10
Crusaders,458,1,17,6,3,64,30,34,57
Coleraine,458,2,15,10,1,47,22,25,55
Linfield,458,3,11,5,10,41,39,2,38
Glenavon,458,4,9,9,8,52,47,5,36
Cliftonville,458,5,9,4,13,35,35,0,31
Ballymena,458,6,7,4,15,25,50,-25,25
Glentoran,458,7,6,6,10,24,32,-8,24
Dungannon,458,8,2,4,16,14,47,-33,10
Crusaders,459,1,17,6,3,64,30,34,57
Coleraine,459,2,14,10,2,44,25,19,52
Glenavon,459,3,10,9,7,55,44,11,39
Linfield,459,4,11,5,10,38,36,2,38
Cliftonville,459,5,9,4,13,32,32,0,31
Ballymena,459,6,7,4,15,25,50,-25,25
Glentoran,459,7,6,6,10,24,32,-8,24
Dungannon,459,8,2,4,16,14,47,-33,10
Crusaders,460,1,16,7,3,63,32,31,55
Coleraine,460,2,14,11,1,46,25,21,53
Linfield,460,3,11,5,10,38,36,2,38
Glenavon,460,4,9,10,7,55,46,9,37
Cliftonville,460,5,9,4,13,32,32,0,31
Ballymena,460,6,7,5,14,27,49,-22,26
Glentoran,460,7,6,6,10,24,32,-8,24
Dungannon,460,8,2,4,16,14,47,-33,10
Crusaders,461,1,17,6,3,64,30,34,57
Coleraine,461,2,14,10,2,44,24,20,52
Glenavon,461,3,10,9,7,54,44,10,39
Linfield,461,4,11,5,10,38,36,2,38
Cliftonville,461,5,9,4,13,32,32,0,31
Ballymena,461,6,7,4,15,25,50,-25,25
Glentoran,461,7,6,6,10,24,32,-8,24
Dungannon,461,8,2,4,16,14,47,-33,10
Coleraine,462,1,15,10,1,45,22,23,55
Crusaders,462,2,16,6,4,63,34,29,54
Linfield,462,3,11,5,10,39,37,2,38
Glenavon,462,4,9,9,8,52,45,7,36
Cliftonville,462,5,9,4,13,33,33,0,31
Ballymena,462,6,8,4,14,29,49,-20,28
Glentoran,462,7,6,6,10,24,32,-8,24
Dungannon,462,8,2,4,16,14,47,-33,10
Crusaders,463,1,16,6,4,62,32,30,54
Coleraine,463,2,14,10,2,43,24,19,52
Glenavon,463,3,10,9,7,54,43,11,39
Linfield,463,4,11,5,10,38,36,2,38
Cliftonville,463,5,9,4,13,32,32,0,31
Ballymena,463,6,8,4,14,27,48,-21,28
Glentoran,463,7,6,6,10,24,32,-8,24
Dungannon,463,8,2,4,16,14,47,-33,10
Crusaders,464,1,17,6,3,62,30,32,57
Coleraine,464,2,14,10,2,43,23,20,52
Glenavon,464,3,10,9,7,53,43,10,39
Linfield,464,4,10,5,11,37,38,-1,35
Cliftonville,464,5,10,4,12,34,31,3,34
Ballymena,464,6,7,4,15,25,48,-23,25
Glentoran,464,7,6,6,10,24,32,-8,24
Dungannon,464,8,2,4,16,14,47,-33,10
Crusaders,465,1,16,7,3,61,30,31,55
Coleraine,465,2,14,10,2,46,26,20,52
Glenavon,465,3,10,9,7,56,46,10,39
Linfield,465,4,11,5,10,39,36,3,38
Cliftonville,465,5,9,4,13,32,33,-1,31
Ballymena,465,6,7,5,14,25,47,-22,26
Glentoran,465,7,6,6,10,24,32,-8,24
Dungannon,465,8,2,4,16,14,47,-33,10
Crusaders,466,1,17,6,3,64,31,33,57
Coleraine,466,2,15,10,1,46,24,22,55
Glenavon,466,3,9,9,8,54,46,8,36
Linfield,466,4,10,5,11,38,38,0,35
Cliftonville,466,5,10,4,12,34,32,2,34
Ballymena,466,6,7,4,15,26,50,-24,25
Glentoran,466,7,6,6,10,24,32,-8,24
Dungannon,466,8,2,4,16,14,47,-33,10
Crusaders,467,1,16,7,3,61,30,31,55
Coleraine,467,2,14,10,2,45,25,20,52
Glenavon,467,3,10,9,7,55,45,10,39
Linfield,467,4,10,6,10,38,37,1,36
Cliftonville,467,5,9,5,12,33,32,1,32
Ballymena,467,6,7,5,14,25,47,-22,26
Glentoran,467,7,6,6,10,24,32,-8,24
Dungannon,467,8,2,4,16,14,47,-33,10
Crusaders,468,1,17,6,3,65,31,34,57
Coleraine,468,2,15,10,1,46,23,23,55
Glenavon,468,3,9,9,8,53,46,7,36
Linfield,468,4,10,6,10,38,37,1,36
Cliftonville,468,5,9,5,12,33,32,1,32
Ballymena,468,6,7,4,15,26,51,-25,25
Glentoran,468,7,6,6,10,24,32,-8,24
Dungannon,468,8,2,4,16,14,47,-33,10
Crusaders,469,1,16,6,4,63,33,30,54
Coleraine,469,2,14,11,1,43,22,21,53
Linfield,469,3,11,5,10,38,36,2,38
Glenavon,469,4,9,10,7,52,43,9,37
Cliftonville,469,5,9,4,13,32,32,0,31
Ballymena,469,6,8,4,14,28,49,-21,28
Glentoran,469,7,6,6,10,24,32,-8,24
Dungannon,469,8,2,4,16,14,47,-33,10
Crusaders,470,1,17,6,3,62,30,32,57
Coleraine,470,2,14,10,2,44,24,20,52
Glenavon,470,3,10,9,7,54,44,10,39
Linfield,470,4,11,5,10,38,36,2,38
Cliftonville,470,5,9,4,13,32,32,0,31
Ballymena,470,6,7,4,15,25,48,-23,25
Glentoran,470,7,6,6,10,24,32,-8,24
Dungannon,470,8,2,4,16,14,47,-33,10
Crusaders,471,1,16,7,3,62,31,31,55
Coleraine,471,2,14,10,2,43,23,20,52
Glenavon,471,3,10,9,7,53,43,10,39
Linfield,471,4,11,5,10,40,37,3,38
Cliftonville,471,5,9,4,13,33,34,-1,31
Ballymena,471,6,7,5,14,26,48,-22,26
Glentoran,471,7,6,6,10,24,32,-8,24
Dungannon,471,8,2,4,16,14,47,-33,10
Crusaders,472,1,17,6,3,63,30,33,57
Coleraine,472,2,14,10,2,44,24,20,52
Glenavon,472,3,10,9,7,54,44,10,39
Linfield,472,4,10,5,11,37,37,0,35
Cliftonville,472,5,10,4,12,33,31,2,34
Ballymena,472,6,7,4,15,25,49,-24,25
Glentoran,472,7,6,6,10,24,32,-8,24
Dungannon,472,8,2,4,16,14,47,-33,10
Crusaders,473,1,17,6,3,65,31,34,57
Coleraine,473,2,14,11,1,43,22,21,53
Linfield,473,3,11,5,10,39,37,2,38
Glenavon,473,4,9,10,7,52,43,9,37
Cliftonville,473,5,9,4,13,33,33,0,31
Ballymena,473,6,7,4,15,26,51,-25,25
Glentoran,473,7,6,6,10,24,32,-8,24
Dungannon,473,8,2,4,16,14,47,-33,10
Crusaders,474,1,17,6,3,67,31,36,57
Coleraine,474,2,15,10,1,46,22,24,55
Linfield,474,3,11,5,10,40,37,3,38
Glenavon,474,4,9,9,8,52,46,6,36
Cliftonville,474,5,9,4,13,33,34,-1,31
Ballymena,474,6,7,4,15,26,53,-27,25
Glentoran,474,7,6,6,10,24,32,-8,24
Dungannon,474,8,2,4,16,14,47,-33,10
Coleraine,475,1,15,10,1,44,22,22,55
Crusaders,475,2,16,6,4,61,32,29,54
Glenavon,475,3,9,9,8,52,44,8,36
Linfield,475,4,10,5,11,38,39,-1,35
Cliftonville,475,5,10,4,12,35,32,3,34
Ballymena,475,6,8,4,14,27,47,-20,28
Glentoran,475,7,6,6,10,24,32,-8,24
Dungannon,475,8,2,4,16,14,47,-33,10
Crusaders,476,1,17,6,3,64,32,32,57
Coleraine,476,2,14,10,2,44,24,20,52
Glenavon,476,3,10,9,7,54,44,10,39
Linfield,476,4,11,5,10,38,36,2,38
Cliftonville,476,5,9,4,13,32,32,0,31
Ballymena,476,6,7,4,15,27,50,-23,25
Glentoran,476,7,6,6,10,24,32,-8,24
Dungannon,476,8,2,4,16,14,47,-33,10
Crusaders,477,1,16,7,3,62,31,31,55
Coleraine,477,2,14,10,2,43,23,20,52
Glenavon,477,3,10,9,7,53,43,10,39
Linfield,477,4,10,6,10,38,37,1,36
Cliftonville,477,5,9,5,12,33,32,1,32
Ballymena,477,6,7,5,14,26,48,-22,26
Glentoran,477,7,6,6,10,24,32,-8,24
Dungannon,477,8,2,4,16,14,47,-33,10
Crusaders,478,1,16,7,3,61,30,31,55
Coleraine,478,2,14,10,2,46,27,19,52
Glenavon,478,3,10,9,7,57,46,11,39
Linfield,478,4,10,5,11,37,37,0,35
Cliftonville,478,5,10,4,12,33,31,2,34
Ballymena,478,6,7,5,14,25,47,-22,26
Glentoran,478,7,6,6,10,24,32,-8,24
Dungannon,478,8,2,4,16,14,47,-33,10
Crusaders,479,1,16,6,4,61,34,27,54
Coleraine,479,2,14,11,1,43,22,21,53
Glenavon,479,3,9,10,7,52,43,9,37
Linfield,479,4,10,6,10,37,36,1,36
Cliftonville,479,5,9,5,12,32,31,1,32
Ballymena,479,6,8,4,14,29,47,-18,28
Glentoran,479,7,6,6,10,24,32,-8,24
Dungannon,479,8,2,4,16,14,47,-33,10
Crusaders,480,1,17,6,3,65,31,34,57
Coleraine,480,2,14,11,1,45,24,21,53
Glenavon,480,3,9,10,7,54,45,9,37
Linfield,480,4,10,5,11,37,40,-3,35
Cliftonville,480,5,10,4,12,36,31,5,34
Ballymena,480,6,7,4,15,26,51,-25,25
Glentoran,480,7,6,6,10,24,32,-8,24
Dungannon,480,8,2,4,16,14,47,-33,10
Crusaders,481,1,17,6,3,63,31,32,57
Coleraine,481,2,14,10,2,44,24,20,52
Glenavon,481,3,10,9,7,54,44,10,39
Linfield,481,4,10,5,11,38,38,0,35
Cliftonville,481,5,10,4,12,34,32,2,34
Ballymena,481,6,7,4,15,26,49,-23,25
Glentoran,481,7,6,6,10,24,32,-8,24
Dungannon,481,8,2,4,16,14,47,-33,10
Crusaders,482,1,16,7,3,63,32,31,55
Coleraine,482,2,14,10,2,43,23,20,52
Glenavon,482,3,10,9,7,53,43,10,39
Linfield,482,4,11,5,10,38,36,2,38
Cliftonville,482,5,9,4,13,32,32,0,31
Ballymena,482,6,7,5,14,27,49,-22,26
Glentoran,482,7,6,6,10,24,32,-8,24
Dungannon,482,8,2,4,16,14,47,-33,10
Crusaders,483,1,17,6,3,62,30,32,57
Coleraine,483,2,15,10,1,46,24,22,55
Linfield,483,3,11,5,10,38,36,2,38
Glenavon,483,4,9,9,8,54,46,8,36
Cliftonville,483,5,9,4,13,32,32,0,31
Ballymena,483,6,7,4,15,25,48,-23,25
Glentoran,483,7,6,6,10,24,32,-8,24
Dungannon,483,8,2,4,16,14,47,-33,10
Crusaders,484,1,17,6,3,64,32,32,57
Coleraine,484,2,14,11,1,45,24,21,53
Linfield,484,3,11,5,10,40,37,3,38
Glenavon,484,4,9,10,7,54,45,9,37
Cliftonville,484,5,9,4,13,33,34,-1,31
Ballymena,484,6,7,4,15,27,50,-23,25
Glentoran,484,7,6,6,10,24,32,-8,24
Dungannon,484,8,2,4,16,14,47,-33,10
Crusaders,485,1,17,6,3,62,30,32,57
Coleraine,485,2,14,11,1,44,23,21,53
Glenavon,485,3,9,10,7,53,44,9,37
Linfield,485,4,10,6,10,39,38,1,36
Cliftonville,485,5,9,5,12,34,33,1,32
Ballymena,485,6,7,4,15,25,48,-23,25
Glentoran,485,7,6,6,10,24,32,-8,24
Dungannon,485,8,2,4,16,14,47,-33,10
Crusaders,486,1,17,6,3,64,30,34,57
Coleraine,486,2,15,10,1,45,23,22,55
Glenavon,486,3,9,9,8,53,45,8,36
Linfield,486,4,10,6,10,37,36,1,36
Cliftonville,486,5,9,5,12,32,31,1,32
Ballymena,486,6,7,4,15,25,50,-25,25
Glentoran,486,7,6,6,10,24,32,-8,24
Dungannon,486,8,2,4,16,14,47,-33,10
Crusaders,487,1,17,6,3,62,30,32,57
Coleraine,487,2,14,11,1,44,23,21,53
Linfield,487,3,11,5,10,40,38,2,38
Glenavon,487,4,9,10,7,53,44,9,37
Cliftonville,487,5,9,4,13,34,34,0,31
Ballymena,487,6,7,4,15,25,48,-23,25
Glentoran,487,7,6,6,10,24,32,-8,24
Dungannon,487,8,2,4,16,14,47,-33,10
Crusaders,488,1,16,7,3,62,31,31,55
Coleraine,488,2,14,11,1,44,23,21,53
Linfield,488,3,11,5,10,41,36,5,38
Glenavon,488,4,9,10,7,53,44,9,37
Cliftonville,488,5,9,4,13,32,35,-3,31
Ballymena,488,6,7,5,14,26,48,-22,26
Glentoran,488,7,6,6,10,24,32,-8,24
Dungannon,488,8,2,4,16,14,47,-33,10
Crusaders,489,1,17,6,3,63,30,33,57
Coleraine,489,2,14,10,2,45,27,18,52
Glenavon,489,3,10,9,7,57,45,12,39
Linfield,489,4,10,6,10,38,37,1,36
Cliftonville,489,5,9,5,12,33,32,1,32
Ballymena,489,6,7,4,15,25,49,-24,25
Glentoran,489,7,6,6,10,24,32,-8,24
Dungannon,489,8,2,4,16,14,47,-33,10
Crusaders,490,1,16,7,3,63,32,31,55
Coleraine,490,2,14,10,2,44,24,20,52
Glenavon,490,3,10,9,7,54,44,10,39
Linfield,490,4,11,5,10,39,37,2,38
Cliftonville,490,5,9,4,13,33,33,0,31
Ballymena,490,6,7,5,14,27,49,-22,26
Glentoran,490,7,6,6,10,24,32,-8,24
Dungannon,490,8,2,4,16,14,47,-33,10
Crusaders,491,1,16,7,3,64,33,31,55
Coleraine,491,2,14,10,2,44,25,19,52
Glenavon,491,3,10,9,7,55,44,11,39
Linfield,491,4,10,6,10,39,38,1,36
Cliftonville,491,5,9,5,12,34,33,1,32
Ballymena,491,6,7,5,14,28,50,-22,26
Glentoran,491,7,6,6,10,24,32,-8,24
Dungannon,491,8,2,4,16,14,47,-33,10
Crusaders,492,1,17,6,3,63,30,33,57
Coleraine,492,2,14,10,2,44,26,18,52
Glenavon,492,3,10,9,7,56,44,12,39
Linfield,492,4,11,5,10,40,38,2,38
Cliftonville,492,5,9,4,13,34,34,0,31
Ballymena,492,6,7,4,15,25,49,-24,25
Glentoran,492,7,6,6,10,24,32,-8,24
Dungannon,492,8,2,4,16,14,47,-33,10
Crusaders,493,1,17,6,3,65,30,35,57
Coleraine,493,2,14,10,2,44,24,20,52
Glenavon,493,3,10,9,7,54,44,10,39
Linfield,493,4,10,6,10,38,37,1,36
Cliftonville,493,5,9,5,12,33,32,1,32
Ballymena,493,6,7,4,15,25,51,-26,25
Glentoran,493,7,6,6,10,24,32,-8,24
Dungannon,493,8,2,4,16,14,47,-33,10
Crusaders,494,1,17,6,3,66,32,34,57
Coleraine,494,2,15,10,1,45,22,23,55
Linfield,494,3,11,5,10,41,38,3,38
Glenavon,494,4,9,9,8,52,45,7,36
Cliftonville,494,5,9,4,13,34,35,-1,31
Ballymena,494,6,7,4,15,27,52,-25,25
Glentoran,494,7,6,6,10,24,32,-8,24
Dungannon,494,8,2,4,16,14,47,-33,10
Crusaders,495,1,17,6,3,64,31,33,57
Coleraine,495,2,14,10,2,43,23,20,52
Glenavon,495,3,10,9,7,53,43,10,39
Linfield,495,4,11,5,10,38,36,2,38
Cliftonville,495,5,9,4,13,32,32,0,31
Ballymena,495,6,7,4,15,26,50,-24,25
Glentoran,495,7,6,6,10,24,32,-8,24
Dungannon,495,8,2,4,16,14,47,-33,10
Crusaders,496,1,17,6,3,63,31,32,57
Coleraine,496,2,14,11,1,45,24,21,53
Linfield,496,3,11,5,10,39,37,2,38
Glenavon,496,4,9,10,7,54,45,9,37
Cliftonville,496,5,9,4,13,33,33,0,31
Ballymena,496,6,7,4,15,26,49,-23,25
Glentoran,496,7,6,6,10,24,32,-8,24
Dungannon,496,8,2,4,16,14,47,-33,10
Crusaders,497,1,16,7,3,62,31,31,55
Coleraine,497,2,14,11,1,44,23,21,53
Glenavon,497,3,9,10,7,53,44,9,37
Linfield,497,4,10,6,10,38,37,1,36
Cliftonville,497,5,9,5,12,33,32,1,32
Ballymena,497,6,7,5,14,26,48,-22,26
Glentoran,497,7,6,6,10,24,32,-8,24
Dungannon,497,8,2,4,16,14,47,-33,10
Crusaders,498,1,17,6,3,63,30,33,57
Coleraine,498,2,14,10,2,43,24,19,52
Glenavon,498,3,10,9,7,54,43,11,39
Linfield,498,4,10,6,10,38,37,1,36
Cliftonville,498,5,9,5,12,33,32,1,32
Ballymena,498,6,7,4,15,25,49,-24,25
Glentoran,498,7,6,6,10,24,32,-8,24
Dungannon,498,8,2,4,16,14,47,-33,10
Crusaders,499,1,17,6,3,63,31,32,57
Coleraine,499,2,14,10,2,43,24,19,52
Glenavon,499,3,10,9,7,54,43,11,39
Linfield,499,4,10,5,11,37,38,-1,35
Cliftonville,499,5,10,4,12,34,31,3,34
Ballymena,499,6,7,4,15,26,49,-23,25
Glentoran,499,7,6,6,10,24,32,-8,24
Dungannon,499,8,2,4,16,14,47,-33,10
Crusaders,500,1,17,6,3,64,30,34,57
Coleraine,500,2,15,10,1,44,22,22,55
Glenavon,500,3,9,9,8,52,44,8,36
Linfield,500,4,10,6,10,38,37,1,36
Cliftonville,500,5,9,5,12,33,32,1,32
Ballymena,500,6,7,4,15,25,50,-25,25
Glentoran,500,7,6,6,10,24,32,-8,24
Dungannon,500,8,2,4,16,14,47,-33,10
Crusaders,501,1,17,6,3,64,30,34,57
Coleraine,501,2,15,10,1,45,22,23,55
Linfield,501,3,11,5,10,40,36,4,38
Glenavon,501,4,9,9,8,52,45,7,36
Cliftonville,501,5,9,4,13,32,34,-2,31
Ballymena,501,6,7,4,15,25,50,-25,25
Glentoran,501,7,6,6,10,24,32,-8,24
Dungannon,501,8,2,4,16,14,47,-33,10
Crusaders,502,1,17,6,3,63,31,32,57
Coleraine,502,2,14,11,1,43,22,21,53
Glenavon,502,3,9,10,7,52,43,9,37
Linfield,502,4,10,6,10,39,38,1,36
Cliftonville,502,5,9,5,12,34,33,1,32
Ballymena,502,6,7,4,15,26,49,-23,25
Glentoran,502,7,6,6,10,24,32,-8,24
Dungannon,502,8,2,4,16,14,47,-33,10
Crusaders,503,1,16,7,3,65,34,31,55
Coleraine,503,2,15,10,1,46,22,24,55
Glenavon,503,3,9,9,8,52,46,6,36
Linfield,503,4,10,6,10,38,37,1,36
Cliftonville,503,5,9,5,12,33,32,1,32
Ballymena,503,6,7,5,14,29,51,-22,26
Glentoran,503,7,6,6,10,24,32,-8,24
Dungannon,503,8,2,4,16,14,47,-33,10
Crusaders,504,1,16,7,3,62,31,31,55
Coleraine,504,2,14,10,2,44,25,19,52
Glenavon,504,3,10,9,7,55,44,11,39
Linfield,504,4,11,5,10,39,36,3,38
Cliftonville,504,5,9,4,13,32,33,-1,31
Ballymena,504,6,7,5,14,26,48,-22,26
Glentoran,504,7,6,6,10,24,32,-8,24
Dungannon,504,8,2,4,16,14,47,-33,10
Crusaders,505,1,16,7,3,62,31,31,55
Coleraine,505,2,15,10,1,46,24,22,55
Glenavon,505,3,9,9,8,54,46,8,36
Linfield,505,4,10,5,11,39,39,0,35
Cliftonville,505,5,10,4,12,35,33,2,34
Ballymena,505,6,7,5,14,26,48,-22,26
Glentoran,505,7,6,6,10,24,32,-8,24
Dungannon,505,8,2,4,16,14,47,-33,10
Crusaders,506,1,17,6,3,65,31,34,57
Coleraine,506,2,14,11,1,43,22,21,53
Linfield,506,3,11,5,10,44,36,8,38
Glenavon,506,4,9,10,7,52,43,9,37
Cliftonville,506,5,9,4,13,32,38,-6,31
Ballymena,506,6,7,4,15,26,51,-25,25
Glentoran,506,7,6,6,10,24,32,-8,24
Dungannon,506,8,2,4,16,14,47,-33,10
Crusaders,507,1,17,6,3,64,30,34,57
Coleraine,507,2,14,10,2,43,23,20,52
Glenavon,507,3,10,9,7,53,43,10,39
Linfield,507,4,10,6,10,38,37,1,36
Cliftonville,507,5,9,5,12,33,32,1,32
Ballymena,507,6,7,4,15,25,50,-25,25
Glentoran,507,7,6,6,10,24,32,-8,24
Dungannon,507,8,2,4,16,14,47,-33,10
Crusaders,508,1,16,7,3,62,31,31,55
Coleraine,508,2,14,11,1,45,24,21,53
Linfield,508,3,11,5,10,38,36,2,38
Glenavon,508,4,9,10,7,54,45,9,37
Cliftonville,508,5,9,4,13,32,32,0,31
Ballymena,508,6,7,5,14,26,48,-22,26
Glentoran,508,7,6,6,10,24,32,-8,24
Dungannon,508,8,2,4,16,14,47,-33,10
Crusaders,509,1,17,6,3,64,31,33,57
Coleraine,509,2,14,10,2,43,25,18,52
Glenavon,509,3,10,9,7,55,43,12,39
Linfield,509,4,10,6,10,38,37,1,36
Cliftonville,509,5,9,5,12,33,32,1,32
Ballymena,509,6,7,4,15,26,50,-24,25
Glentoran,509,7,6,6,10,24,32,-8,24
Dungannon,509,8,2,4,16,14,47,-33,10
Coleraine,510,1,15,10,1,46,23,23,55
Crusaders,510,2,16,6,4,61,31,30,54
Glenavon,510,3,9,9,8,53,46,7,36
Linfield,510,4,10,6,10,39,38,1,36
Cliftonville,510,5,9,5,12,34,33,1,32
Ballymena,510,6,8,4,14,26,47,-21,28
Glentoran,510,7,6,6,10,24,32,-8,24
Dungannon,510,8,2,4,16,14,47,-33,10
Crusaders,511,1,16,7,3,62,31,31,55
Coleraine,511,2,14,10,2,45,25,20,52
Glenavon,511,3,10,9,7,55,45,10,39
Linfield,511,4,11,5,10,40,37,3,38
Cliftonville,511,5,9,4,13,33,34,-1,31
Ballymena,511,6,7,5,14,26,48,-22,26
Glentoran,511,7,6,6,10,24,32,-8,24
Dungannon,511,8,2,4,16,14,47,-33,10
Crusaders,512,1,16,7,3,62,31,31,55
Coleraine,512,2,15,10,1,45,23,22,55
Glenavon,512,3,9,9,8,53,45,8,36
Linfield,512,4,10,6,10,38,37,1,36
Cliftonville,512,5,9,5,12,33,32,1,32
Ballymena,512,6,7,5,14,26,48,-22,26
Glentoran,512,7,6,6,10,24,32,-8,24
Dungannon,512,8,2,4,16,14,47,-33,10
Crusaders,513,1,17,6,3,64,30,34,57
Coleraine,513,2,15,10,1,46,24,22,55
Linfield,513,3,11,5,10,39,36,3,38
Glenavon,513,4,9,9,8,54,46,8,36
Cliftonville,513,5,9,4,13,32,33,-1,31
Ballymena,513,6,7,4,15,25,50,-25,25
Glentoran,513,7,6,6,10,24,32,-8,24
Dungannon,513,8,2,4,16,14,47,-33,10
Crusaders,514,1,17,6,3,65,31,34,57
Coleraine,514,2,15,10,1,46,24,22,55
Linfield,514,3,11,5,10,38,36,2,38
Glenavon,514,4,9,9,8,54,46,8,36
Cliftonville,514,5,9,4,13,32,32,0,31
Ballymena,514,6,7,4,15,26,51,-25,25
Glentoran,514,7,6,6,10,24,32,-8,24
Dungannon,514,8,2,4,16,14,47,-33,10
Crusaders,515,1,17,6,3,64,31,33,57
Coleraine,515,2,15,10,1,48,26,22,55
Glenavon,515,3,9,9,8,56,48,8,36
Linfield,515,4,10,6,10,37,36,1,36
Cliftonville,515,5,9,5,12,32,31,1,32
Ballymena,515,6,7,4,15,26,50,-24,25
Glentoran,515,7,6,6,10,24,32,-8,24
Dungannon,515,8,2,4,16,14,47,-33,10
Crusaders,516,1,16,7,3,62,31,31,55
Coleraine,516,2,15,10,1,45,23,22,55
Glenavon,516,3,9,9,8,53,45,8,36
Linfield,516,4,10,6,10,40,39,1,36
Cliftonville,516,5,9,5,12,35,34,1,32
Ballymena,516,6,7,5,14,26,48,-22,26
Glentoran,516,7,6,6,10,24,32,-8,24
Dungannon,516,8,2,4,16,14,47,-33,10
Crusaders,517,1,17,6,3,62,30,32,57
Coleraine,517,2,15,10,1,44,22,22,55
Glenavon,517,3,9,9,8,52,44,8,36
Linfield,517,4,10,5,11,38,40,-2,35
Cliftonville,517,5,10,4,12,36,32,4,34
Ballymena,517,6,7,4,15,25,48,-23,25
Glentoran,517,7,6,6,10,24,32,-8,24
Dungannon,517,8,2,4,16,14,47,-33,10
Crusaders,518,1,17,6,3,65,31,34,57
Coleraine,518,2,14,11,1,43,22,21,53
Glenavon,518,3,9,10,7,52,43,9,37
Linfield,518,4,10,5,11,38,40,-2,35
Cliftonville,518,5,10,4,12,36,32,4,34
Ballymena,518,6,7,4,15,26,51,-25,25
Glentoran,518,7,6,6,10,24,32,-8,24
Dungannon,518,8,2,4,16,14,47,-33,10
Crusaders,519,1,17,6,3,63,31,32,57
Coleraine,519,2,14,11,1,43,22,21,53
Glenavon,519,3,9,10,7,52,43,9,37
Linfield,519,4,10,6,10,39,38,1,36
Cliftonville,519,5,9,5,12,34,33,1,32
Ballymena,519,6,7,4,15,26,49,-23,25
Glentoran,519,7,6,6,10,24,32,-8,24
Dungannon,519,8,2,4,16,14,47,-33,10
Crusaders,520,1,17,6,3,64,31,33,57
Coleraine,520,2,14,10,2,44,25,19,52
Glenavon,520,3,10,9,7,55,44,11,39
Linfield,520,4,11,5,10,41,38,3,38
Cliftonville,520,5,9,4,13,34,35,-1,31
Ballymena,520,6,7,4,15,26,50,-24,25
Glentoran,520,7,6,6,10,24,32,-8,24
Dungannon,520,8,2,4,16,14,47,-33,10
Crusaders,521,1,17,6,3,63,31,32,57
Coleraine,521,2,14,11,1,44,23,21,53
Glenavon,521,3,9,10,7,53,44,9,37
Linfield,521,4,10,6,10,37,36,1,36
Cliftonville,521,5,9,5,12,32,31,1,32
Ballymena,521,6,7,4,15,26,49,-23,25
Glentoran,521,7,6,6,10,24,32,-8,24
Dungannon,521,8,2,4,16,14,47,-33,10
Crusaders,522,1,17,6,3,64,31,33,57
Coleraine,522,2,14,10,2,44,26,18,52
Glenavon,522,3,10,9,7,56,44,12,39
Linfield,522,4,10,5,11,37,40,-3,35
Cliftonville,522,5,10,4,12,36,31,5,34
Ballymena,522,6,7,4,15,26,50,-24,25
Glentoran,522,7,6,6,10,24,32,-8,24
Dungannon,522,8,2,4,16,14,47,-33,10
Coleraine,523,1,15,10,1,46,24,22,55
Crusaders,523,2,16,6,4,64,34,30,54
Linfield,523,3,11,5,10,40,37,3,38
Glenavon,523,4,9,9,8,54,46,8,36
Cliftonville,523,5,9,4,13,33,34,-1,31
Ballymena,523,6,8,4,14,29,50,-21,28
Glentoran,523,7,6,6,10,24,32,-8,24
Dungannon,523,8,2,4,16,14,47,-33,10
Crusaders,524,1,17,6,3,64,30,34,57
Coleraine,524,2,14,10,2,44,25,19,52
Glenavon,524,3,10,9,7,55,44,11,39
Linfield,524,4,11,5,10,38,36,2,38
Cliftonville,524,5,9,4,13,32,32,0,31
Ballymena,524,6,7,4,15,25,50,-25,25
Glentoran,524,7,6,6,10,24,32,-8,24
Dungannon,524,8,2,4,16,14,47,-33,10
Crusaders,525,1,16,6,4,62,33,29,54
Coleraine,525,2,14,10,2,43,23,20,52
Glenavon,525,3,10,9,7,53,43,10,39
Linfield,525,4,10,5,11,37,37,0,35
Cliftonville,525,5,10,4,12,33,31,2,34
Ballymena,525,6,8,4,14,28,48,-20,28
Glentoran,525,7,6,6,10,24,32,-8,24
Dungannon,525,8,2,4,16,14,47,-33,10
Crusaders,526,1,17,6,3,63,30,33,57
Coleraine,526,2,14,11,1,43,22,21,53
Linfield,526,3,11,5,10,39,36,3,38
Glenavon,526,4,9,10,7,52,43,9,37
Cliftonville,526,5,9,4,13,32,33,-1,31
Ballymena,526,6,7,4,15,25,49,-24,25
Glentoran,526,7,6,6,10,24,32,-8,24
Dungannon,526,8,2,4,16,14,47,-33,10
Crusaders,527,1,17,6,3,62,30,32,57
Coleraine,527,2,15,10,1,45,23,22,55
Glenavon,527,3,9,9,8,53,45,8,36
Linfield,527,4,10,6,10,38,37,1,36
Cliftonville,527,5,9,5,12,33,32,1,32
Ballymena,527,6,7,4,15,25,48,-23,25
Glentoran,527,7,6,6,10,24,32,-8,24
Dungannon,527,8,2,4,16,14,47,-33,10
Crusaders,528,1,17,6,3,62,30,32,57
Coleraine,528,2,14,10,2,43,23,20,52
Glenavon,528,3,10,9,7,53,43,10,39
Linfield,528,4,10,6,10,38,37,1,36
Cliftonville,528,5,9,5,12,33,32,1,32
Ballymena,528,6,7,4,15,25,48,-23,25
Glentoran,528,7,6,6,10,24,32,-8,24
Dungannon,528,8,2,4,16,14,47,-33,10
Crusaders,529,1,16,7,3,63,32,31,55
Coleraine,529,2,14,10,2,43,26,17,52
Glenavon,529,3,10,9,7,56,43,13,39
Linfield,529,4,11,5,10,40,37,3,38
Cliftonville,529,5,9,4,13,33,34,-1,31
Ballymena,529,6,7,5,14,27,49,-22,26
Glentoran,529,7,6,6,10,24,32,-8,24
Dungannon,529,8,2,4,16,14,47,-33,10
Crusaders,530,1,17,6,3,63,31,32,57
Coleraine,530,2,14,11,1,44,23,21,53
Linfield,530,3,11,5,10,39,37,2,38
Glenavon,530,4,9,10,7,53,44,9,37
Cliftonville,530,5,9,4,13,33,33,0,31
Ballymena,530,6,7,4,15,26,49,-23,25
Glentoran,530,7,6,6,10,24,32,-8,24
Dungannon,530,8,2,4,16,14,47,-33,10
Crusaders,531,1,17,6,3,64,31,33,57
Coleraine,531,2,15,10,1,47,24,23,55
Linfield,531,3,11,5,10,40,36,4,38
Glenavon,531,4,9,9,8,54,47,7,36
Cliftonville,531,5,9,4,13,32,34,-2,31
Ballymena,531,6,7,4,15,26,50,-24,25
Glentoran,531,7,6,6,10,24,32,-8,24
Dungannon,531,8,2,4,16,14,47,-33,10
Crusaders,532,1,17,6,3,67,31,36,57
Coleraine,532,2,14,10,2,44,25,19,52
Glenavon,532,3,10,9,7,55,44,11,39
Linfield,532,4,11,5,10,42,36,6,38
Cliftonville,532,5,9,4,13,32,36,-4,31
Ballymena,532,6,7,4,15,26,53,-27,25
Glentoran,532,7,6,6,10,24,32,-8,24
Dungannon,532,8,2,4,16,14,47,-33,10
Crusaders,533,1,17,6,3,64,31,33,57
Coleraine,533,2,14,11,1,44,23,21,53
Glenavon,533,3,9,10,7,53,44,9,37
Linfield,533,4,10,5,11,37,38,-1,35
Cliftonville,533,5,10,4,12,34,31,3,34
Ballymena,533,6,7,4,15,26,50,-24,25
Glentoran,533,7,6,6,10,24,32,-8,24
Dungannon,533,8,2,4,16,14,47,-33,10
Crusaders,534,1,17,6,3,64,31,33,57
Coleraine,534,2,14,10,2,44,24,20,52
Glenavon,534,3,10,9,7,54,44,10,39
Linfield,534,4,11,5,10,40,37,3,38
Cliftonville,534,5,9,4,13,33,34,-1,31
Ballymena,534,6,7,4,15,26,50,-24,25
Glentoran,534,7,6,6,10,24,32,-8,24
Dungannon,534,8,2,4,16,14,47,-33,10
Crusaders,535,1,17,6,3,64,31,33,57
Coleraine,535,2,14,10,2,43,24,19,52
Glenavon,535,3,10,9,7,54,43,11,39
Linfield,535,4,11,5,10,39,36,3,38
Cliftonville,535,5,9,4,13,32,33,-1,31
Ballymena,535,6,7,4,15,26,50,-24,25
Glentoran,535,7,6,6,10,24,32,-8,24
Dungannon,535,8,2,4,16,14,47,-33,10
Crusaders,536,1,17,6,3,65,33,32,57
Coleraine,536,2,14,10,2,43,23,20,52
Glenavon,536,3,10,9,7,53,43,10,39
Linfield,536,4,10,6,10,37,36,1,36
Cliftonville,536,5,9,5,12,32,31,1,32
Ballymena,536,6,7,4,15,28,51,-23,25
Glentoran,536,7,6,6,10,24,32,-8,24
Dungannon,536,8,2,4,16,14,47,-33,10
Crusaders,537,1,17,6,3,62,30,32,57
Coleraine,537,2,14,11,1,44,23,21,53
Linfield,537,3,11,5,10,40,36,4,38
Glenavon,537,4,9,10,7,53,44,9,37
Cliftonville,537,5,9,4,13,32,34,-2,31
Ballymena,537,6,7,4,15,25,48,-23,25
Glentoran,537,7,6,6,10,24,32,-8,24
Dungannon,537,8,2,4,16,14,47,-33,10
Crusaders,538,1,17,6,3,64,32,32,57
Coleraine,538,2,15,10,1,45,23,22,55
Linfield,538,3,11,5,10,42,37,5,38
Glenavon,538,4,9,9,8,53,45,8,36
Cliftonville,538,5,9,4,13,33,36,-3,31
Ballymena,538,6,7,4,15,27,50,-23,25
Glentoran,538,7,6,6,10,24,32,-8,24
Dungannon,538,8,2,4,16,14,47,-33,10
Crusaders,539,1,16,7,3,62,31,31,55
Coleraine,539,2,14,11,1,43,22,21,53
Glenavon,539,3,9,10,7,52,43,9,37
Linfield,539,4,10,5,11,38,39,-1,35
Cliftonville,539,5,10,4,12,35,32,3,34
Ballymena,539,6,7,5,14,26,48,-22,26
Glentoran,539,7,6,6,10,24,32,-8,24
Dungannon,539,8,2,4,16,14,47,-33,10
Crusaders,540,1,17,6,3,66,31,35,57
Coleraine,540,2,14,10,2,43,23,20,52
Glenavon,540,3,10,9,7,53,43,10,39
Linfield,540,4,10,6,10,38,37,1,36
Cliftonville,540,5,9,5,12,33,32,1,32
Ballymena,540,6,7,4,15,26,52,-26,25
Glentoran,540,7,6,6,10,24,32,-8,24
Dungannon,540,8,2,4,16,14,47,-33,10
Crusaders,541,1,17,6,3,64,30,34,57
Coleraine,541,2,15,10,1,44,22,22,55
Glenavon,541,3,9,9,8,52,44,8,36
Linfield,541,4,10,6,10,37,36,1,36
Cliftonville,541,5,9,5,12,32,31,1,32
Ballymena,541,6,7,4,15,25,50,-25,25
Glentoran,541,7,6,6,10,24,32,-8,24
Dungannon,541,8,2,4,16,14,47,-33,10
Crusaders,542,1,16,7,3,62,31,31,55
Coleraine,542,2,15,10,1,44,22,22,55
Linfield,542,3,11,5,10,39,36,3,38
Glenavon,542,4,9,9,8,52,44,8,36
Cliftonville,542,5,9,4,13,32,33,-1,31
Ballymena,542,6,7,5,14,26,48,-22,26
Glentoran,542,7,6,6,10,24,32,-8,24
Dungannon,542,8,2,4,16,14,47,-33,10
Crusaders,543,1,17,6,3,63,30,33,57
Coleraine,543,2,14,10,2,44,25,19,52
Glenavon,543,3,10,9,7,55,44,11,39
Linfield,543,4,11,5,10,38,36,2,38
Cliftonville,543,5,9,4,13,32,32,0,31
Ballymena,543,6,7,4,15,25,49,-24,25
Glentoran,543,7,6,6,10,24,32,-8,24
Dungannon,543,8,2,4,16,14,47,-33,10
Crusaders,544,1,16,7,3,62,31,31,55
Coleraine,544,2,15,10,1,49,23,26,55
Glenavon,544,3,9,9,8,53,49,4,36
Linfield,544,4,10,6,10,38,37,1,36
Cliftonville,544,5,9,5,12,33,32,1,32
Ballymena,544,6,7,5,14,26,48,-22,26
Glentoran,544,7,6,6,10,24,32,-8,24
Dungannon,544,8,2,4,16,14,47,-33,10
Crusaders,545,1,17,6,3,62,30,32,57
Coleraine,545,2,14,10,2,43,23,20,52
Glenavon,545,3,10,9,7,53,43,10,39
Linfield,545,4,10,5,11,39,39,0,35
Cliftonville,545,5,10,4,12,35,33,2,34
Ballymena,545,6,7,4,15,25,48,-23,25
Glentoran,545,7,6,6,10,24,32,-8,24
Dungannon,545,8,2,4,16,14,47,-33,10
Crusaders,546,1,17,6,3,66,31,35,57
Coleraine,546,2,14,10,2,43,25,18,52
Glenavon,546,3,10,9,7,55,43,12,39
Linfield,546,4,11,5,10,38,36,2,38
Cliftonville,546,5,9,4,13,32,32,0,31
Ballymena,546,6,7,4,15,26,52,-26,25
Glentoran,546,7,6,6,10,24,32,-8,24
Dungannon,546,8,2,4,16,14,47,-33,10
Crusaders,547,1,17,6,3,64,31,33,57
Coleraine,547,2,14,10,2,44,24,20,52
Glenavon,547,3,10,9,7,54,44,10,39
Linfield,547,4,10,5,11,37,37,0,35
Cliftonville,547,5,10,4,12,33,31,2,34
Ballymena,547,6,7,4,15,26,50,-24,25
Glentoran,547,7,6,6,10,24,32,-8,24
Dungannon,547,8,2,4,16,14,47,-33,10
Crusaders,548,1,16,6,4,61,32,29,54
Coleraine,548,2,14,10,2,46,29,17,52
Glenavon,548,3,10,9,7,59,46,13,39
Linfield,548,4,10,5,11,37,37,0,35
Cliftonville,548,5,10,4,12,33,31,2,34
Ballymena,548,6,8,4,14,27,47,-20,28
Glentoran,548,7,6,6,10,24,32,-8,24
Dungannon,548,8,2,4,16,14,47,-33,10
Crusaders,549,1,17,6,3,63,30,33,57
Coleraine,549,2,14,10,2,43,26,17,52
Glenavon,549,3,10,9,7,56,43,13,39
Linfield,549,4,11,5,10,38,36,2,38
Cliftonville,549,5,9,4,13,32,32,0,31
Ballymena,549,6,7,4,15,25,49,-24,25
Glentoran,549,7,6,6,10,24,32,-8,24
Dungannon,549,8,2,4,16,14,47,-33,10
Crusaders,550,1,17,6,3,64,31,33,57
Coleraine,550,2,14,11,1,44,23,21,53
Linfield,550,3,11,5,10,39,36,3,38
Glenavon,550,4,9,10,7,53,44,9,37
Cliftonville,550,5,9,4,13,32,33,-1,31
Ballymena,550,6,7,4,15,26,50,-24,25
Glentoran,550,7,6,6,10,24,32,-8,24
Dungannon,550,8,2,4,16,14,47,-33,10
Crusaders,551,1,16,7,3,62,31,31,55
Coleraine,551,2,15,10,1,46,22,24,55
Linfield,551,3,11,5,10,40,38,2,38
Glenavon,551,4,9,9,8,52,46,6,36
Cliftonville,551,5,9,4,13,34,34,0,31
Ballymena,551,6,7,5,14,26,48,-22,26
Glentoran,551,7,6,6,10,24,32,-8,24
Dungannon,551,8,2,4,16,14,47,-33,10
Crusaders,552,1,17,6,3,66,34,32,57
Coleraine,552,2,15,10,1,44,22,22,55
Glenavon,552,3,9,9,8,52,44,8,36
Linfield,552,4,10,6,10,39,38,1,36
Cliftonville,552,5,9,5,12,34,33,1,32
Ballymena,552,6,7,4,15,29,52,-23,25
Glentoran,552,7,6,6,10,24,32,-8,24
Dungannon,552,8,2,4,16,14,47,-33,10
Crusaders,553,1,17,6,3,62,30,32,57
Coleraine,553,2,14,10,2,44,24,20,52
Glenavon,553,3,10,9,7,54,44,10,39
Linfield,553,4,10,5,11,38,38,0,35
Cliftonville,553,5,10,4,12,34,32,2,34
Ballymena,553,6,7,4,15,25,48,-23,25
Glentoran,553,7,6,6,10,24,32,-8,24
Dungannon,553,8,2,4,16,14,47,-33,10
Crusaders,554,1,16,7,3,62,31,31,55
Coleraine,554,2,14,10,2,43,24,19,52
Glenavon,554,3,10,9,7,54,43,11,39
Linfield,554,4,11,5,10,38,36,2,38
Cliftonville,554,5,9,4,13,32,32,0,31
Ballymena,554,6,7,5,14,26,48,-22,26
Glentoran,554,7,6,6,10,24,32,-8,24
Dungannon,554,8,2,4,16,14,47,-33,10
Crusaders,555,1,16,7,3,62,31,31,55
Coleraine,555,2,15,10,1,44,22,22,55
Glenavon,555,3,9,9,8,52,44,8,36
Linfield,555,4,10,6,10,38,37,1,36
Cliftonville,555,5,9,5,12,33,32,1,32
Ballymena,555,6,7,5,14,26,48,-22,26
Glentoran,555,7,6,6,10,24,32,-8,24
Dungannon,555,8,2,4,16,14,47,-33,10
Crusaders,556,1,16,6,4,62,33,29,54
Coleraine,556,2,14,10,2,44,24,20,52
Glenavon,556,3,10,9,7,54,44,10,39
Linfield,556,4,10,5,11,37,37,0,35
Cliftonville,556,5,10,4,12,33,31,2,34
Ballymena,556,6,8,4,14,28,48,-20,28
Glentoran,556,7,6,6,10,24,32,-8,24
Dungannon,556,8,2,4,16,14,47,-33,10
Crusaders,557,1,17,6,3,63,31,32,57
Coleraine,557,2,14,11,1,45,24,21,53
Linfield,557,3,11,5,10,38,36,2,38
Glenavon,557,4,9,10,7,54,45,9,37
Cliftonville,557,5,9,4,13,32,32,0,31
Ballymena,557,6,7,4,15,26,49,-23,25
Glentoran,557,7,6,6,10,24,32,-8,24
Dungannon,557,8,2,4,16,14,47,-33,10
Crusaders,558,1,16,7,3,64,33,31,55
Coleraine,558,2,15,10,1,45,22,23,55
Glenavon,558,3,9,9,8,52,45,7,36
Linfield,558,4,10,6,10,37,36,1,36
Cliftonville,558,5,9,5,12,32,31,1,32
Ballymena,558,6,7,5,14,28,50,-22,26
Glentoran,558,7,6,6,10,24,32,-8,24
Dungannon,558,8,2,4,16,14,47,-33,10
Coleraine,559,1,15,10,1,46,24,22,55
Crusaders,559,2,16,6,4,64,36,28,54
Glenavon,559,3,9,9,8,54,46,8,36
Linfield,559,4,10,5,11,37,37,0,35
Cliftonville,559,5,10,4,12,33,31,2,34
Ballymena,559,6,8,4,14,31,50,-19,28
Glentoran,559,7,6,6,10,24,32,-8,24
Dungannon,559,8,2,4,16,14,47,-33,10
Crusaders,560,1,16,6,4,61,31,30,54
Coleraine,560,2,14,10,2,46,26,20,52
Glenavon,560,3,10,9,7,56,46,10,39
Linfield,560,4,11,5,10,41,36,5,38
Cliftonville,560,5,9,4,13,32,35,-3,31
Ballymena,560,6,8,4,14,26,47,-21,28
Glentoran,560,7,6,6,10,24,32,-8,24
Dungannon,560,8,2,4,16,14,47,-33,10
Crusaders,561,1,16,6,4,63,33,30,54
Coleraine,561,2,14,10,2,44,24,20,52
Glenavon,561,3,10,9,7,54,44,10,39
Linfield,561,4,10,5,11,37,37,0,35
Cliftonville,561,5,10,4,12,33,31,2,34
Ballymena,561,6,8,4,14,28,49,-21,28
Glentoran,561,7,6,6,10,24,32,-8,24
Dungannon,561,8,2,4,16,14,47,-33,10
Crusaders,562,1,16,7,3,62,31,31,55
Coleraine,562,2,15,10,1,49,23,26,55
Linfield,562,3,11,5,10,42,37,5,38
Glenavon,562,4,9,9,8,53,49,4,36
Cliftonville,562,5,9,4,13,33,36,-3,31
Ballymena,562,6,7,5,14,26,48,-22,26
Glentoran,562,7,6,6,10,24,32,-8,24
Dungannon,562,8,2,4,16,14,47,-33,10
Crusaders,563,1,17,6,3,63,30,33,57
Coleraine,563,2,14,10,2,44,24,20,52
Glenavon,563,3,10,9,7,54,44,10,39
Linfield,563,4,10,5,11,39,42,-3,35
Cliftonville,563,5,10,4,12,38,33,5,34
Ballymena,563,6,7,4,15,25,49,-24,25
Glentoran,563,7,6,6,10,24,32,-8,24
Dungannon,563,8,2,4,16,14,47,-33,10
Crusaders,564,1,16,7,3,62,31,31,55
Coleraine,564,2,14,10,2,43,24,19,52
Glenavon,564,3,10,9,7,54,43,11,39
Linfield,564,4,11,5,10,39,37,2,38
Cliftonville,564,5,9,4,13,33,33,0,31
Ballymena,564,6,7,5,14,26,48,-22,26
Glentoran,564,7,6,6,10,24,32,-8,24
Dungannon,564,8,2,4,16,14,47,-33,10
Crusaders,565,1,17,6,3,65,30,35,57
Coleraine,565,2,15,10,1,47,24,23,55
Glenavon,565,3,9,9,8,54,47,7,36
Linfield,565,4,10,6,10,38,37,1,36
Cliftonville,565,5,9,5,12,33,32,1,32
Ballymena,565,6,7,4,15,25,51,-26,25
Glentoran,565,7,6,6,10,24,32,-8,24
Dungannon,565,8,2,4,16,14,47,-33,10
Crusaders,566,1,17,6,3,64,30,34,57
Coleraine,566,2,14,11,1,46,25,21,53
Glenavon,566,3,9,10,7,55,46,9,37
Linfield,566,4,10,6,10,37,36,1,36
Cliftonville,566,5,9,5,12,32,31,1,32
Ballymena,566,6,7,4,15,25,50,-25,25
Glentoran,566,7,6,6,10,24,32,-8,24
Dungannon,566,8,2,4,16,14,47,-33,10
Crusaders,567,1,17,6,3,63,30,33,57
Coleraine,567,2,14,10,2,44,25,19,52
Glenavon,567,3,10,9,7,55,44,11,39
Linfield,567,4,11,5,10,38,36,2,38
Cliftonville,567,5,9,4,13,32,32,0,31
Ballymena,567,6,7,4,15,25,49,-24,25
Glentoran,567,7,6,6,10,24,32,-8,24
Dungannon,567,8,2,4,16,14,47,-33,10
Coleraine,568,1,15,10,1,46,23,23,55
Crusaders,568,2,16,6,4,61,33,28,54
Glenavon,568,3,9,9,8,53,46,7,36
Linfield,568,4,10,6,10,38,37,1,36
Cliftonville,568,5,9,5,12,33,32,1,32
Ballymena,568,6,8,4,14,28,47,-19,28
Glentoran,568,7,6,6,10,24,32,-8,24
Dungannon,568,8,2,4,16,14,47,-33,10
Crusaders,569,1,17,6,3,65,32,33,57
Coleraine,569,2,14,10,2,43,24,19,52
Glenavon,569,3,10,9,7,54,43,11,39
Linfield,569,4,10,5,11,37,38,-1,35
Cliftonville,569,5,10,4,12,34,31,3,34
Ballymena,569,6,7,4,15,27,51,-24,25
Glentoran,569,7,6,6,10,24,32,-8,24
Dungannon,569,8,2,4,16,14,47,-33,10
Crusaders,570,1,17,6,3,64,31,33,57
Coleraine,570,2,14,10,2,45,25,20,52
Glenavon,570,3,10,9,7,55,45,10,39
Linfield,570,4,11,5,10,38,36,2,38
Cliftonville,570,5,9,4,13,32,32,0,31
Ballymena,570,6,7,4,15,26,50,-24,25
Glentoran,570,7,6,6,10,24,32,-8,24
Dungannon,570,8,2,4,16,14,47,-33,10
Crusaders,571,1,16,7,3,65,34,31,55
Coleraine,571,2,14,11,1,44,23,21,53
Glenavon,571,3,9,10,7,53,44,9,37
Linfield,571,4,10,6,10,38,37,1,36
Cliftonville,571,5,9,5,12,33,32,1,32
Ballymena,571,6,7,5,14,29,51,-22,26
Glentoran,571,7,6,6,10,24,32,-8,24
Dungannon,571,8,2,4,16,14,47,-33,10
Crusaders,572,1,17,6,3,64,30,34,57
Coleraine,572,2,14,10,2,44,25,19,52
Glenavon,572,3,10,9,7,55,44,11,39
Linfield,572,4,11,5,10,38,36,2,38
Cliftonville,572,5,9,4,13,32,32,0,31
Ballymena,572,6,7,4,15,25,50,-25,25
Glentoran,572,7,6,6,10,24,32,-8,24
Dungannon,572,8,2,4,16,14,47,-33,10
Crusaders,573,1,16,7,3,63,32,31,55
Coleraine,573,2,15,10,1,45,23,22,55
Glenavon,573,3,9,9,8,53,45,8,36
Linfield,573,4,10,5,11,38,38,0,35
Cliftonville,573,5,10,4,12,34,32,2,34
Ballymena,573,6,7,5,14,27,49,-22,26
Glentoran,573,7,6,6,10,24,32,-8,24
Dungannon,573,8,2,4,16,14,47,-33,10
Crusaders,574,1,17,6,3,64,30,34,57
Coleraine,574,2,14,10,2,43,26,17,52
Glenavon,574,3,10,9,7,56,43,13,39
Linfield,574,4,10,6,10,38,37,1,36
Cliftonville,574,5,9,5,12,33,32,1,32
Ballymena,574,6,7,4,15,25,50,-25,25
Glentoran,574,7,6,6,10,24,32,-8,24
Dungannon,574,8,2,4,16,14,47,-33,10
Crusaders,575,1,17,6,3,64,32,32,57
Coleraine,575,2,14,10,2,43,23,20,52
Glenavon,575,3,10,9,7,53,43,10,39
Linfield,575,4,10,5,11,38,38,0,35
Cliftonville,575,5,10,4,12,34,32,2,34
Ballymena,575,6,7,4,15,27,50,-23,25
Glentoran,575,7,6,6,10,24,32,-8,24
Dungannon,575,8,2,4,16,14,47,-33,10
Crusaders,576,1,17,6,3,62,30,32,57
Coleraine,576,2,14,10,2,43,25,18,52
Glenavon,576,3,10,9,7,55,43,12,39
Linfield,576,4,10,6,10,38,37,1,36
Cliftonville,576,5,9,5,12,33,32,1,32
Ballymena,576,6,7,4,15,25,48,-23,25
Glentoran,576,7,6,6,10,24,32,-8,24
Dungannon,576,8,2,4,16,14,47,-33,10
Crusaders,577,1,16,7,3,62,31,31,55
Coleraine,577,2,14,10,2,44,26,18,52
Glenavon,577,3,10,9,7,56,44,12,39
Linfield,577,4,11,5,10,39,36,3,38
Cliftonville,577,5,9,4,13,32,33,-1,31
Ballymena,577,6,7,5,14,26,48,-22,26
Glentoran,577,7,6,6,10,24,32,-8,24
Dungannon,577,8,2,4,16,14,47,-33,10
Crusaders,578,1,16,7,3,62,31,31,55
Coleraine,578,2,15,10,1,45,23,22,55
Linfield,578,3,11,5,10,39,37,2,38
Glenavon,578,4,9,9,8,53,45,8,36
Cliftonville,578,5,9,4,13,33,33,0,31
Ballymena,578,6,7,5,14,26,48,-22,26
Glentoran,578,7,6,6,10,24,32,-8,24
Dungannon,578,8,2,4,16,14,47,-33,10
Crusaders,579,1,16,7,3,61,30,31,55
Coleraine,579,2,14,10,2,43,23,20,52
Glenavon,579,3,10,9,7,53,43,10,39
Linfield,579,4,10,6,10,37,36,1,36
Cliftonville,579,5,9,5,12,32,31,1,32
Ballymena,579,6,7,5,14,25,47,-22,26
Glentoran,579,7,6,6,10,24,32,-8,24
Dungannon,579,8,2,4,16,14,47,-33,10
Crusaders,580,1,17,6,3,63,30,33,57
Coleraine,580,2,14,11,1,45,24,21,53
Linfield,580,3,11,5,10,38,36,2,38
Glenavon,580,4,9,10,7,54,45,9,37
Cliftonville,580,5,9,4,13,32,32,0,31
Ballymena,580,6,7,4,15,25,49,-24,25
Glentoran,580,7,6,6,10,24,32,-8,24
Dungannon,580,8,2,4,16,14,47,-33,10
Crusaders,581,1,17,6,3,65,32,33,57
Coleraine,581,2,14,10,2,43,23,20,52
Glenavon,581,3,10,9,7,53,43,10,39
Linfield,581,4,10,6,10,39,38,1,36
Cliftonville,581,5,9,5,12,34,33,1,32
Ballymena,581,6,7,4,15,27,51,-24,25
Glentoran,581,7,6,6,10,24,32,-8,24
Dungannon,581,8,2,4,16,14,47,-33,10
Crusaders,582,1,17,6,3,64,30,34,57
Coleraine,582,2,14,10,2,43,26,17,52
Glenavon,582,3,10,9,7,56,43,13,39
Linfield,582,4,11,5,10,39,37,2,38
Cliftonville,582,5,9,4,13,33,33,0,31
Ballymena,582,6,7,4,15,25,50,-25,25
Glentoran,582,7,6,6,10,24,32,-8,24
Dungannon,582,8,2,4,16,14,47,-33,10
Crusaders,583,1,17,6,3,64,30,34,57
Coleraine,583,2,14,10,2,44,26,18,52
Glenavon,583,3,10,9,7,56,44,12,39
Linfield,583,4,11,5,10,40,37,3,38
Cliftonville,583,5,9,4,13,33,34,-1,31
Ballymena,583,6,7,4,15,25,50,-25,25
Glentoran,583,7,6,6,10,24,32,-8,24
Dungannon,583,8,2,4,16,14,47,-33,10
Crusaders,584,1,16,7,3,64,33,31,55
Coleraine,584,2,14,10,2,44,24,20,52
Glenavon,584,3,10,9,7,54,44,10,39
Linfield,584,4,10,5,11,37,37,0,35
Cliftonville,584,5,10,4,12,33,31,2,34
Ballymena,584,6,7,5,14,28,50,-22,26
Glentoran,584,7,6,6,10,24,32,-8,24
Dungannon,584,8,2,4,16,14,47,-33,10
Crusaders,585,1,17,6,3,64,32,32,57
Coleraine,585,2,14,11,1,44,23,21,53
Glenavon,585,3,9,10,7,53,44,9,37
Linfield,585,4,10,5,11,39,39,0,35
Cliftonville,585,5,10,4,12,35,33,2,34
Ballymena,585,6,7,4,15,27,50,-23,25
Glentoran,585,7,6,6,10,24,32,-8,24
Dungannon,585,8,2,4,16,14,47,-33,10
Crusaders,586,1,17,6,3,63,30,33,57
Coleraine,586,2,14,11,1,45,24,21,53
Glenavon,586,3,9,10,7,54,45,9,37
Linfield,586,4,10,5,11,37,39,-2,35
Cliftonville,586,5,10,4,12,35,31,4,34
Ballymena,586,6,7,4,15,25,49,-24,25
Glentoran,586,7,6,6,10,24,32,-8,24
Dungannon,586,8,2,4,16,14,47,-33,10
Crusaders,587,1,16,7,3,63,32,31,55
Coleraine,587,2,14,10,2,44,26,18,52
Glenavon,587,3,10,9,7,56,44,12,39
Linfield,587,4,10,6,10,37,36,1,36
Cliftonville,587,5,9,5,12,32,31,1,32
Ballymena,587,6,7,5,14,27,49,-22,26
Glentoran,587,7,6,6,10,24,32,-8,24
Dungannon,587,8,2,4,16,14,47,-33,10
Coleraine,588,1,15,10,1,45,22,23,55
Crusaders,588,2,16,6,4,62,32,30,54
Glenavon,588,3,9,9,8,52,45,7,36
Linfield,588,4,10,6,10,38,37,1,36
Cliftonville,588,5,9,5,12,33,32,1,32
Ballymena,588,6,8,4,14,27,48,-21,28
Glentoran,588,7,6,6,10,24,32,-8,24
Dungannon,588,8,2,4,16,14,47,-33,10
Crusaders,589,1,17,6,3,65,32,33,57
Coleraine,589,2,14,10,2,43,23,20,52
Glenavon,589,3,10,9,7,53,43,10,39
Linfield,589,4,11,5,10,40,37,3,38
Cliftonville,589,5,9,4,13,33,34,-1,31
Ballymena,589,6,7,4,15,27,51,-24,25
Glentoran,589,7,6,6,10,24,32,-8,24
Dungannon,589,8,2,4,16,14,47,-33,10
Crusaders,590,1,17,6,3,65,31,34,57
Coleraine,590,2,14,11,1,44,23,21,53
Glenavon,590,3,9,10,7,53,44,9,37
Linfield,590,4,10,5,11,37,39,-2,35
Cliftonville,590,5,10,4,12,35,31,4,34
Ballymena,590,6,7,4,15,26,51,-25,25
Glentoran,590,7,6,6,10,24,32,-8,24
Dungannon,590,8,2,4,16,14,47,-33,10
Coleraine,591,1,15,10,1,44,22,22,55
Crusaders,591,2,16,6,4,62,32,30,54
Glenavon,591,3,9,9,8,52,44,8,36
Linfield,591,4,10,5,11,37,37,0,35
Cliftonville,591,5,10,4,12,33,31,2,34
Ballymena,591,6,8,4,14,27,48,-21,28
Glentoran,591,7,6,6,10,24,32,-8,24
Dungannon,591,8,2,4,16,14,47,-33,10
Crusaders,592,1,16,7,3,63,32,31,55
Coleraine,592,2,14,10,2,43,25,18,52
Glenavon,592,3,10,9,7,55,43,12,39
Linfield,592,4,10,5,11,39,40,-1,35
Cliftonville,592,5,10,4,12,36,33,3,34
Ballymena,592,6,7,5,14,27,49,-22,26
Glentoran,592,7,6,6,10,24,32,-8,24
Dungannon,592,8,2,4,16,14,47,-33,10
Crusaders,593,1,16,6,4,62,32,30,54
Coleraine,593,2,14,11,1,45,24,21,53
Glenavon,593,3,9,10,7,54,45,9,37
Linfield,593,4,10,6,10,38,37,1,36
Cliftonville,593,5,9,5,12,33,32,1,32
Ballymena,593,6,8,4,14,27,48,-21,28
Glentoran,593,7,6,6,10,24,32,-8,24
Dungannon,593,8,2,4,16,14,47,-33,10
Crusaders,594,1,17,6,3,62,30,32,57
Coleraine,594,2,14,10,2,43,25,18,52
Glenavon,594,3,10,9,7,55,43,12,39
Linfield,594,4,10,5,11,37,37,0,35
Cliftonville,594,5,10,4,12,33,31,2,34
Ballymena,594,6,7,4,15,25,48,-23,25
Glentoran,594,7,6,6,10,24,32,-8,24
Dungannon,594,8,2,4,16,14,47,-33,10
Crusaders,595,1,17,6,3,63,30,33,57
Coleraine,595,2,14,11,1,43,22,21,53
Glenavon,595,3,9,10,7,52,43,9,37
Linfield,595,4,10,5,11,38,38,0,35
Cliftonville,595,5,10,4,12,34,32,2,34
Ballymena,595,6,7,4,15,25,49,-24,25
Glentoran,595,7,6,6,10,24,32,-8,24
Dungannon,595,8,2,4,16,14,47,-33,10
Crusaders,596,1,17,6,3,64,31,33,57
Coleraine,596,2,15,10,1,45,22,23,55
Glenavon,596,3,9,9,8,52,45,7,36
Linfield,596,4,10,5,11,37,37,0,35
Cliftonville,596,5,10,4,12,33,31,2,34
Ballymena,596,6,7,4,15,26,50,-24,25
Glentoran,596,7,6,6,10,24,32,-8,24
Dungannon,596,8,2,4,16,14,47,-33,10
Crusaders,597,1,16,6,4,62,33,29,54
Coleraine,597,2,14,11,1,44,23,21,53
Linfield,597,3,11,5,10,38,36,2,38
Glenavon,597,4,9,10,7,53,44,9,37
Cliftonville,597,5,9,4,13,32,32,0,31
Ballymena,597,6,8,4,14,28,48,-20,28
Glentoran,597,7,6,6,10,24,32,-8,24
Dungannon,597,8,2,4,16,14,47,-33,10
Crusaders,598,1,17,6,3,63,31,32,57
Coleraine,598,2,14,10,2,43,23,20,52
Glenavon,598,3,10,9,7,53,43,10,39
Linfield,598,4,11,5,10,39,37,2,38
Cliftonville,598,5,9,4,13,33,33,0,31
Ballymena,598,6,7,4,15,26,49,-23,25
Glentoran,598,7,6,6,10,24,32,-8,24
Dungannon,598,8,2,4,16,14,47,-33,10
Crusaders,599,1,16,7,3,62,31,31,55
Coleraine,599,2,14,10,2,44,24,20,52
Glenavon,599,3,10,9,7,54,44,10,39
Linfield,599,4,10,6,10,37,36,1,36
Cliftonville,599,5,9,5,12,32,31,1,32
Ballymena,599,6,7,5,14,26,48,-22,26
Glentoran,599,7,6,6,10,24,32,-8,24
Dungannon,599,8,2,4,16,14,47,-33,10
Crusaders,600,1,16,6,4,61,32,29,54
Coleraine,600,2,14,11,1,44,23,21,53
Glenavon,600,3,9,10,7,53,44,9,37
Linfield,600,4,10,6,10,38,37,1,36
Cliftonville,600,5,9,5,12,33,32,1,32
Ballymena,600,6,8,4,14,27,47,-20,28
Glentoran,600,7,6,6,10,24,32,-8,24
Dungannon,600,8,2,4,16,14,47,-33,10
Crusaders,601,1,17,6,3,64,31,33,57
Coleraine,601,2,14,10,2,46,26,20,52
Glenavon,601,3,10,9,7,56,46,10,39
Linfield,601,4,11,5,10,38,36,2,38
Cliftonville,601,5,9,4,13,32,32,0,31
Ballymena,601,6,7,4,15,26,50,-24,25
Glentoran,601,7,6,6,10,24,32,-8,24
Dungannon,601,8,2,4,16,14,47,-33,10
Crusaders,602,1,16,6,4,61,31,30,54
Coleraine,602,2,14,11,1,45,24,21,53
Glenavon,602,3,9,10,7,54,45,9,37
Linfield,602,4,10,5,11,38,38,0,35
Cliftonville,602,5,10,4,12,34,32,2,34
Ballymena,602,6,8,4,14,26,47,-21,28
Glentoran,602,7,6,6,10,24,32,-8,24
Dungannon,602,8,2,4,16,14,47,-33,10
Crusaders,603,1,17,6,3,63,31,32,57
Coleraine,603,2,14,11,1,46,25,21,53
Linfield,603,3,11,5,10,40,37,3,38
Glenavon,603,4,9,10,7,55,46,9,37
Cliftonville,603,5,9,4,13,33,34,-1,31
Ballymena,603,6,7,4,15,26,49,-23,25
Glentoran,603,7,6,6,10,24,32,-8,24
Dungannon,603,8,2,4,16,14,47,-33,10
Crusaders,604,1,17,6,3,66,31,35,57
Coleraine,604,2,14,11,1,44,23,21,53
Glenavon,604,3,9,10,7,53,44,9,37
Linfield,604,4,10,5,11,37,39,-2,35
Cliftonville,604,5,10,4,12,35,31,4,34
Ballymena,604,6,7,4,15,26,52,-26,25
Glentoran,604,7,6,6,10,24,32,-8,24
Dungannon,604,8,2,4,16,14,47,-33,10
Crusaders,605,1,17,6,3,64,31,33,57
Coleraine,605,2,15,10,1,47,22,25,55
Glenavon,605,3,9,9,8,52,47,5,36
Linfield,605,4,10,5,11,38,39,-1,35
Cliftonville,605,5,10,4,12,35,32,3,34
Ballymena,605,6,7,4,15,26,50,-24,25
Glentoran,605,7,6,6,10,24,32,-8,24
Dungannon,605,8,2,4,16,14,47,-33,10
Crusaders,606,1,16,6,4,63,33,30,54
Coleraine,606,2,14,10,2,46,26,20,52
Glenavon,606,3,10,9,7,56,46,10,39
Linfield,606,4,10,6,10,38,37,1,36
Cliftonville,606,5,9,5,12,33,32,1,32
Ballymena,606,6,8,4,14,28,49,-21,28
Glentoran,606,7,6,6,10,24,32,-8,24
Dungannon,606,8,2,4,16,14,47,-33,10
Crusaders,607,1,16,7,3,63,32,31,55
Coleraine,607,2,14,10,2,44,25,19,52
Glenavon,607,3,10,9,7,55,44,11,39
Linfield,607,4,11,5,10,38,36,2,38
Cliftonville,607,5,9,4,13,32,32,0,31
Ballymena,607,6,7,5,14,27,49,-22,26
Glentoran,607,7,6,6,10,24,32,-8,24
Dungannon,607,8,2,4,16,14,47,-33,10
Crusaders,608,1,17,6,3,64,30,34,57
Coleraine,608,2,14,10,2,45,25,20,52
Glenavon,608,3,10,9,7,55,45,10,39
Linfield,608,4,10,6,10,38,37,1,36
Cliftonville,608,5,9,5,12,33,32,1,32
Ballymena,608,6,7,4,15,25,50,-25,25
Glentoran,608,7,6,6,10,24,32,-8,24
Dungannon,608,8,2,4,16,14,47,-33,10
Crusaders,609,1,16,7,3,64,33,31,55
Coleraine,609,2,15,10,1,44,22,22,55
Glenavon,609,3,9,9,8,52,44,8,36
Linfield,609,4,10,5,11,38,38,0,35
Cliftonville,609,5,10,4,12,34,32,2,34
Ballymena,609,6,7,5,14,28,50,-22,26
Glentoran,609,7,6,6,10,24,32,-8,24
Dungannon,609,8,2,4,16,14,47,-33,10
Crusaders,610,1,16,7,3,61,30,31,55
Coleraine,610,2,14,11,1,44,23,21,53
Glenavon,610,3,9,10,7,53,44,9,37
Linfield,610,4,10,6,10,39,38,1,36
Cliftonville,610,5,9,5,12,34,33,1,32
Ballymena,610,6,7,5,14,25,47,-22,26
Glentoran,610,7,6,6,10,24,32,-8,24
Dungannon,610,8,2,4,16,14,47,-33,10
Crusaders,611,1,17,6,3,64,31,33,57
Coleraine,611,2,14,10,2,43,23,20,52
Glenavon,611,3,10,9,7,53,43,10,39
Linfield,611,4,10,5,11,37,37,0,35
Cliftonville,611,5,10,4,12,33,31,2,34
Ballymena,611,6,7,4,15,26,50,-24,25
Glentoran,611,7,6,6,10,24,32,-8,24
Dungannon,611,8,2,4,16,14,47,-33,10
Crusaders,612,1,16,7,3,62,31,31,55
Coleraine,612,2,14,10,2,44,26,18,52
Glenavon,612,3,10,9,7,56,44,12,39
Linfield,612,4,11,5,10,40,38,2,38
Cliftonville,612,5,9,4,13,34,34,0,31
Ballymena,612,6,7,5,14,26,48,-22,26
Glentoran,612,7,6,6,10,24,32,-8,24
Dungannon,612,8,2,4,16,14,47,-33,10
Crusaders,613,1,17,6,3,64,31,33,57
Coleraine,613,2,15,10,1,44,22,22,55
Linfield,613,3,11,5,10,40,37,3,38
Glenavon,613,4,9,9,8,52,44,8,36
Cliftonville,613,5,9,4,13,33,34,-1,31
Ballymena,613,6,7,4,15,26,50,-24,25
Glentoran,613,7,6,6,10,24,32,-8,24
Dungannon,613,8,2,4,16,14,47,-33,10
Crusaders,614,1,16,7,3,62,31,31,55
Coleraine,614,2,14,11,1,44,23,21,53
Glenavon,614,3,9,10,7,53,44,9,37
Linfield,614,4,10,6,10,38,37,1,36
Cliftonville,614,5,9,5,12,33,32,1,32
Ballymena,614,6,7,5,14,26,48,-22,26
Glentoran,614,7,6,6,10,24,32,-8,24
Dungannon,614,8,2,4,16,14,47,-33,10
Crusaders,615,1,17,6,3,64,32,32,57
Coleraine,615,2,15,10,1,47,23,24,55
Glenavon,615,3,9,9,8,53,47,6,36
Linfield,615,4,10,6,10,38,37,1,36
Cliftonville,615,5,9,5,12,33,32,1,32
Ballymena,615,6,7,4,15,27,50,-23,25
Glentoran,615,7,6,6,10,24,32,-8,24
Dungannon,615,8,2,4,16,14,47,-33,10
Crusaders,616,1,17,6,3,65,30,35,57
Coleraine,616,2,15,10,1,45,23,22,55
Glenavon,616,3,9,9,8,53,45,8,36
Linfield,616,4,10,6,10,39,38,1,36
Cliftonville,616,5,9,5,12,34,33,1,32
Ballymena,616,6,7,4,15,25,51,-26,25
Glentoran,616,7,6,6,10,24,32,-8,24
Dungannon,616,8,2,4,16,14,47,-33,10
Crusaders,617,1,16,7,3,61,30,31,55
Coleraine,617,2,15,10,1,44,22,22,55
Glenavon,617,3,9,9,8,52,44,8,36
Linfield,617,4,10,6,10,38,37,1,36
Cliftonville,617,5,9,5,12,33,32,1,32
Ballymena,617,6,7,5,14,25,47,-22,26
Glentoran,617,7,6,6,10,24,32,-8,24
Dungannon,617,8,2,4,16,14,47,-33,10
Crusaders,618,1,16,7,3,63,32,31,55
Coleraine,618,2,15,10,1,46,24,22,55
Glenavon,618,3,9,9,8,54,46,8,36
Linfield,618,4,10,5,11,37,37,0,35
Cliftonville,618,5,10,4,12,33,31,2,34
Ballymena,618,6,7,5,14,27,49,-22,26
Glentoran,618,7,6,6,10,24,32,-8,24
Dungannon,618,8,2,4,16,14,47,-33,10
Crusaders,619,1,17,6,3,64,30,34,57
Coleraine,619,2,14,11,1,44,23,21,53
Linfield,619,3,11,5,10,42,39,3,38
Glenavon,619,4,9,10,7,53,44,9,37
Cliftonville,619,5,9,4,13,35,36,-1,31
Ballymena,619,6,7,4,15,25,50,-25,25
Glentoran,619,7,6,6,10,24,32,-8,24
Dungannon,619,8,2,4,16,14,47,-33,10
Crusaders,620,1,17,6,3,64,32,32,57
Coleraine,620,2,14,10,2,44,24,20,52
Glenavon,620,3,10,9,7,54,44,10,39
Linfield,620,4,11,5,10,39,36,3,38
Cliftonville,620,5,9,4,13,32,33,-1,31
Ballymena,620,6,7,4,15,27,50,-23,25
Glentoran,620,7,6,6,10,24,32,-8,24
Dungannon,620,8,2,4,16,14,47,-33,10
Crusaders,621,1,17,6,3,62,30,32,57
Coleraine,621,2,14,10,2,45,25,20,52
Glenavon,621,3,10,9,7,55,45,10,39
Linfield,621,4,10,5,11,38,38,0,35
Cliftonville,621,5,10,4,12,34,32,2,34
Ballymena,621,6,7,4,15,25,48,-23,25
Glentoran,621,7,6,6,10,24,32,-8,24
Dungannon,621,8,2,4,16,14,47,-33,10
Crusaders,622,1,16,7,3,63,32,31,55
Coleraine,622,2,15,10,1,46,23,23,55
Linfield,622,3,11,5,10,40,38,2,38
Glenavon,622,4,9,9,8,53,46,7,36
Cliftonville,622,5,9,4,13,34,34,0,31
Ballymena,622,6,7,5,14,27,49,-22,26
Glentoran,622,7,6,6,10,24,32,-8,24
Dungannon,622,8,2,4,16,14,47,-33,10
Crusaders,623,1,16,6,4,63,33,30,54
Coleraine,623,2,14,10,2,43,23,20,52
Glenavon,623,3,10,9,7,53,43,10,39
Linfield,623,4,11,5,10,38,36,2,38
Cliftonville,623,5,9,4,13,32,32,0,31
Ballymena,623,6,8,4,14,28,49,-21,28
Glentoran,623,7,6,6,10,24,32,-8,24
Dungannon,623,8,2,4,16,14,47,-33,10
Crusaders,624,1,16,7,3,62,31,31,55
Coleraine,624,2,14,11,1,43,22,21,53
Glenavon,624,3,9,10,7,52,43,9,37
Linfield,624,4,10,6,10,37,36,1,36
Cliftonville,624,5,9,5,12,32,31,1,32
Ballymena,624,6,7,5,14,26,48,-22,26
Glentoran,624,7,6,6,10,24,32,-8,24
Dungannon,624,8,2,4,16,14,47,-33,10
Crusaders,625,1,16,6,4,61,31,30,54
Coleraine,625,2,14,11,1,46,25,21,53
Glenavon,625,3,9,10,7,55,46,9,37
Linfield,625,4,10,6,10,37,36,1,36
Cliftonville,625,5,9,5,12,32,31,1,32
Ballymena,625,6,8,4,14,26,47,-21,28
Glentoran,625,7,6,6,10,24,32,-8,24
Dungannon,625,8,2,4,16,14,47,-33,10
Crusaders,626,1,17,6,3,63,31,32,57
Coleraine,626,2,15,10,1,45,23,22,55
Glenavon,626,3,9,9,8,53,45,8,36
Linfield,626,4,10,6,10,38,37,1,36
Cliftonville,626,5,9,5,12,33,32,1,32
Ballymena,626,6,7,4,15,26,49,-23,25
Glentoran,626,7,6,6,10,24,32,-8,24
Dungannon,626,8,2,4,16,14,47,-33,10
Crusaders,627,1,17,6,3,62,30,32,57
Coleraine,627,2,14,10,2,43,24,19,52
Glenavon,627,3,10,9,7,54,43,11,39
Linfield,627,4,10,6,10,40,39,1,36
Cliftonville,627,5,9,5,12,35,34,1,32
Ballymena,627,6,7,4,15,25,48,-23,25
Glentoran,627,7,6,6,10,24,32,-8,24
Dungannon,627,8,2,4,16,14,47,-33,10
Crusaders,628,1,17,6,3,65,31,34,57
Coleraine,628,2,14,10,2,44,25,19,52
Glenavon,628,3,10,9,7,55,44,11,39
Linfield,628,4,10,6,10,39,38,1,36
Cliftonville,628,5,9,5,12,34,33,1,32
Ballymena,628,6,7,4,15,26,51,-25,25
Glentoran,628,7,6,6,10,24,32,-8,24
Dungannon,628,8,2,4,16,14,47,-33,10
Crusaders,629,1,16,7,3,62,31,31,55
Coleraine,629,2,14,10,2,43,23,20,52
Glenavon,629,3,10,9,7,53,43,10,39
Linfield,629,4,10,6,10,37,36,1,36
Cliftonville,629,5,9,5,12,32,31,1,32
Ballymena,629,6,7,5,14,26,48,-22,26
Glentoran,629,7,6,6,10,24,32,-8,24
Dungannon,629,8,2,4,16,14,47,-33,10
Crusaders,630,1,16,7,3,62,31,31,55
Coleraine,630,2,14,11,1,45,24,21,53
Glenavon,630,3,9,10,7,54,45,9,37
Linfield,630,4,10,6,10,38,37,1,36
Cliftonville,630,5,9,5,12,33,32,1,32
Ballymena,630,6,7,5,14,26,48,-22,26
Glentoran,630,7,6,6,10,24,32,-8,24
Dungannon,630,8,2,4,16,14,47,-33,10
Crusaders,631,1,17,6,3,65,31,34,57
Coleraine,631,2,14,10,2,43,24,19,52
Glenavon,631,3,10,9,7,54,43,11,39
Linfield,631,4,10,6,10,38,37,1,36
Cliftonville,631,5,9,5,12,33,32,1,32
Ballymena,631,6,7,4,15,26,51,-25,25
Glentoran,631,7,6,6,10,24,32,-8,24
Dungannon,631,8,2,4,16,14,47,-33,10
Crusaders,632,1,17,6,3,64,31,33,57
Coleraine,632,2,14,11,1,45,24,21,53
Linfield,632,3,11,5,10,39,36,3,38
Glenavon,632,4,9,10,7,54,45,9,37
Cliftonville,632,5,9,4,13,32,33,-1,31
Ballymena,632,6,7,4,15,26,50,-24,25
Glentoran,632,7,6,6,10,24,32,-8,24
Dungannon,632,8,2,4,16,14,47,-33,10
Crusaders,633,1,17,6,3,63,31,32,57
Coleraine,633,2,14,11,1,43,22,21,53
Glenavon,633,3,9,10,7,52,43,9,37
Linfield,633,4,10,5,11,39,39,0,35
Cliftonville,633,5,10,4,12,35,33,2,34
Ballymena,633,6,7,4,15,26,49,-23,25
Glentoran,633,7,6,6,10,24,32,-8,24
Dungannon,633,8,2,4,16,14,47,-33,10
Crusaders,634,1,16,7,3,62,31,31,55
Coleraine,634,2,14,11,1,44,23,21,53
Linfield,634,3,11,5,10,41,37,4,38
Glenavon,634,4,9,10,7,53,44,9,37
Cliftonville,634,5,9,4,13,33,35,-2,31
Ballymena,634,6,7,5,14,26,48,-22,26
Glentoran,634,7,6,6,10,24,32,-8,24
Dungannon,634,8,2,4,16,14,47,-33,10
Crusaders,635,1,16,7,3,63,32,31,55
Coleraine,635,2,14,11,1,44,23,21,53
Glenavon,635,3,9,10,7,53,44,9,37
Linfield,635,4,10,5,11,37,38,-1,35
Cliftonville,635,5,10,4,12,34,31,3,34
Ballymena,635,6,7,5,14,27,49,-22,26
Glentoran,635,7,6,6,10,24,32,-8,24
Dungannon,635,8,2,4,16,14,47,-33,10
Coleraine,636,1,15,10,1,49,25,24,55
Crusaders,636,2,16,6,4,61,31,30,54
Linfield,636,3,11,5,10,38,36,2,38
Glenavon,636,4,9,9,8,55,49,6,36
Cliftonville,636,5,9,4,13,32,32,0,31
Ballymena,636,6,8,4,14,26,47,-21,28
Glentoran,636,7,6,6,10,24,32,-8,24
Dungannon,636,8,2,4,16,14,47,-33,10
Crusaders,637,1,16,7,3,62,31,31,55
Coleraine,637,2,14,10,2,43,27,16,52
Glenavon,637,3,10,9,7,57,43,14,39
Linfield,637,4,11,5,10,39,36,3,38
Cliftonville,637,5,9,4,13,32,33,-1,31
Ballymena,637,6,7,5,14,26,48,-22,26
Glentoran,637,7,6,6,10,24,32,-8,24
Dungannon,637,8,2,4,16,14,47,-33,10
Crusaders,638,1,16,7,3,62,31,31,55
Coleraine,638,2,15,10,1,46,23,23,55
Glenavon,638,3,9,9,8,53,46,7,36
Linfield,638,4,10,5,11,37,37,0,35
Cliftonville,638,5,10,4,12,33,31,2,34
Ballymena,638,6,7,5,14,26,48,-22,26
Glentoran,638,7,6,6,10,24,32,-8,24
Dungannon,638,8,2,4,16,14,47,-33,10
Crusaders,639,1,17,6,3,63,31,32,57
Coleraine,639,2,15,10,1,44,22,22,55
Linfield,639,3,11,5,10,38,36,2,38
Glenavon,639,4,9,9,8,52,44,8,36
Cliftonville,639,5,9,4,13,32,32,0,31
Ballymena,639,6,7,4,15,26,49,-23,25
Glentoran,639,7,6,6,10,24,32,-8,24
Dungannon,639,8,2,4,16,14,47,-33,10
Crusaders,640,1,16,6,4,62,33,29,54
Coleraine,640,2,14,10,2,45,26,19,52
Glenavon,640,3,10,9,7,56,45,11,39
Linfield,640,4,10,6,10,37,36,1,36
Cliftonville,640,5,9,5,12,32,31,1,32
Ballymena,640,6,8,4,14,28,48,-20,28
Glentoran,640,7,6,6,10,24,32,-8,24
Dungannon,640,8,2,4,16,14,47,-33,10
Crusaders,641,1,16,7,3,61,30,31,55
Coleraine,641,2,15,10,1,45,22,23,55
Glenavon,641,3,9,9,8,52,45,7,36
Linfield,641,4,10,6,10,38,37,1,36
Cliftonville,641,5,9,5,12,33,32,1,32
Ballymena,641,6,7,5,14,25,47,-22,26
Glentoran,641,7,6,6,10,24,32,-8,24
Dungannon,641,8,2,4,16,14,47,-33,10
Crusaders,642,1,17,6,3,64,31,33,57
Coleraine,642,2,14,10,2,44,26,18,52
Glenavon,642,3,10,9,7,56,44,12,39
Linfield,642,4,11,5,10,41,36,5,38
Cliftonville,642,5,9,4,13,32,35,-3,31
Ballymena,642,6,7,4,15,26,50,-24,25
Glentoran,642,7,6,6,10,24,32,-8,24
Dungannon,642,8,2,4,16,14,47,-33,10
Crusaders,643,1,16,6,4,62,34,28,54
Coleraine,643,2,14,10,2,45,25,20,52
Glenavon,643,3,10,9,7,55,45,10,39
Linfield,643,4,10,6,10,38,37,1,36
Cliftonville,643,5,9,5,12,33,32,1,32
Ballymena,643,6,8,4,14,29,48,-19,28
Glentoran,643,7,6,6,10,24,32,-8,24
Dungannon,643,8,2,4,16,14,47,-33,10
Crusaders,644,1,16,6,4,62,32,30,54
Coleraine,644,2,14,10,2,45,26,19,52
Glenavon,644,3,10,9,7,56,45,11,39
Linfield,644,4,11,5,10,41,36,5,38
Cliftonville,644,5,9,4,13,32,35,-3,31
Ballymena,644,6,8,4,14,27,48,-21,28
Glentoran,644,7,6,6,10,24,32,-8,24
Dungannon,644,8,2,4,16,14,47,-33,10
Crusaders,645,1,17,6,3,64,30,34,57
Coleraine,645,2,14,11,1,45,24,21,53
Linfield,645,3,11,5,10,39,37,2,38
Glenavon,645,4,9,10,7,54,45,9,37
Cliftonville,645,5,9,4,13,33,33,0,31
Ballymena,645,6,7,4,15,25,50,-25,25
Glentoran,645,7,6,6,10,24,32,-8,24
Dungannon,645,8,2,4,16,14,47,-33,10
Crusaders,646,1,16,7,3,62,31,31,55
Coleraine,646,2,14,10,2,43,24,19,52
Glenavon,646,3,10,9,7,54,43,11,39
Linfield,646,4,10,5,11,37,38,-1,35
Cliftonville,646,5,10,4,12,34,31,3,34
Ballymena,646,6,7,5,14,26,48,-22,26
Glentoran,646,7,6,6,10,24,32,-8,24
Dungannon,646,8,2,4,16,14,47,-33,10
Crusaders,647,1,16,6,4,62,32,30,54
Coleraine,647,2,14,11,1,44,23,21,53
Glenavon,647,3,9,10,7,53,44,9,37
Linfield,647,4,10,5,11,39,39,0,35
Cliftonville,647,5,10,4,12,35,33,2,34
Ballymena,647,6,8,4,14,27,48,-21,28
Glentoran,647,7,6,6,10,24,32,-8,24
Dungannon,647,8,2,4,16,14,47,-33,10
Crusaders,648,1,17,6,3,64,30,34,57
Coleraine,648,2,14,10,2,44,24,20,52
Glenavon,648,3,10,9,7,54,44,10,39
Linfield,648,4,11,5,10,39,37,2,38
Cliftonville,648,5,9,4,13,33,33,0,31
Ballymena,648,6,7,4,15,25,50,-25,25
Glentoran,648,7,6,6,10,24,32,-8,24
Dungannon,648,8,2,4,16,14,47,-33,10
Crusaders,649,1,17,6,3,67,30,37,57
Coleraine,649,2,14,11,1,44,23,21,53
Linfield,649,3,11,5,10,38,36,2,38
Glenavon,649,4,9,10,7,53,44,9,37
Cliftonville,649,5,9,4,13,32,32,0,31
Ballymena,649,6,7,4,15,25,53,-28,25
Glentoran,649,7,6,6,10,24,32,-8,24
Dungannon,649,8,2,4,16,14,47,-33,10
Crusaders,650,1,17,6,3,65,33,32,57
Coleraine,650,2,14,10,2,43,25,18,52
Glenavon,650,3,10,9,7,55,43,12,39
Linfield,650,4,11,5,10,38,36,2,38
Cliftonville,650,5,9,4,13,32,32,0,31
Ballymena,650,6,7,4,15,28,51,-23,25
Glentoran,650,7,6,6,10,24,32,-8,24
Dungannon,650,8,2,4,16,14,47,-33,10
Crusaders,651,1,16,6,4,62,32,30,54
Coleraine,651,2,14,10,2,45,25,20,52
Glenavon,651,3,10,9,7,55,45,10,39
Linfield,651,4,10,5,11,37,38,-1,35
Cliftonville,651,5,10,4,12,34,31,3,34
Ballymena,651,6,8,4,14,27,48,-21,28
Glentoran,651,7,6,6,10,24,32,-8,24
Dungannon,651,8,2,4,16,14,47,-33,10
Crusaders,652,1,17,6,3,63,30,33,57
Coleraine,652,2,14,10,2,44,24,20,52
Glenavon,652,3,10,9,7,54,44,10,39
Linfield,652,4,10,6,10,38,37,1,36
Cliftonville,652,5,9,5,12,33,32,1,32
Ballymena,652,6,7,4,15,25,49,-24,25
Glentoran,652,7,6,6,10,24,32,-8,24
Dungannon,652,8,2,4,16,14,47,-33,10
Coleraine,653,1,15,10,1,44,22,22,55
Crusaders,653,2,16,6,4,61,33,28,54
Linfield,653,3,11,5,10,40,37,3,38
Glenavon,653,4,9,9,8,52,44,8,36
Cliftonville,653,5,9,4,13,33,34,-1,31
Ballymena,653,6,8,4,14,28,47,-19,28
Glentoran,653,7,6,6,10,24,32,-8,24
Dungannon,653,8,2,4,16,14,47,-33,10
Crusaders,654,1,17,6,3,62,30,32,57
Coleraine,654,2,14,10,2,44,26,18,52
Glenavon,654,3,10,9,7,56,44,12,39
Linfield,654,4,11,5,10,39,37,2,38
Cliftonville,654,5,9,4,13,33,33,0,31
Ballymena,654,6,7,4,15,25,48,-23,25
Glentoran,654,7,6,6,10,24,32,-8,24
Dungannon,654,8,2,4,16,14,47,-33,10
Crusaders,655,1,17,6,3,62,30,32,57
Coleraine,655,2,14,10,2,45,25,20,52
Glenavon,655,3,10,9,7,55,45,10,39
Linfield,655,4,11,5,10,40,37,3,38
Cliftonville,655,5,9,4,13,33,34,-1,31
Ballymena,655,6,7,4,15,25,48,-23,25
Glentoran,655,7,6,6,10,24,32,-8,24
Dungannon,655,8,2,4,16,14,47,-33,10
Crusaders,656,1,16,7,3,62,31,31,55
Coleraine,656,2,14,10,2,44,25,19,52
Glenavon,656,3,10,9,7,55,44,11,39
Linfield,656,4,11,5,10,38,36,2,38
Cliftonville,656,5,9,4,13,32,32,0,31
Ballymena,656,6,7,5,14,26,48,-22,26
Glentoran,656,7,6,6,10,24,32,-8,24
Dungannon,656,8,2,4,16,14,47,-33,10
Crusaders,657,1,16,7,3,62,31,31,55
Coleraine,657,2,15,10,1,47,23,24,55
Linfield,657,3,11,5,10,39,36,3,38
Glenavon,657,4,9,9,8,53,47,6,36
Cliftonville,657,5,9,4,13,32,33,-1,31
Ballymena,657,6,7,5,14,26,48,-22,26
Glentoran,657,7,6,6,10,24,32,-8,24
Dungannon,657,8,2,4,16,14,47,-33,10
Crusaders,658,1,16,6,4,61,31,30,54
Coleraine,658,2,14,10,2,43,23,20,52
Glenavon,658,3,10,9,7,53,43,10,39
Linfield,658,4,10,5,11,38,38,0,35
Cliftonville,658,5,10,4,12,34,32,2,34
Ballymena,658,6,8,4,14,26,47,-21,28
Glentoran,658,7,6,6,10,24,32,-8,24
Dungannon,658,8,2,4,16,14,47,-33,10
Crusaders,659,1,17,6,3,63,31,32,57
Coleraine,659,2,15,10,1,47,24,23,55
Linfield,659,3,11,5,10,41,36,5,38
Glenavon,659,4,9,9,8,54,47,7,36
Cliftonville,659,5,9,4,13,32,35,-3,31
Ballymena,659,6,7,4,15,26,49,-23,25
Glentoran,659,7,6,6,10,24,32,-8,24
Dungannon,659,8,2,4,16,14,47,-33,10
Crusaders,660,1,17,6,3,66,30,36,57
Coleraine,660,2,14,10,2,44,24,20,52
Glenavon,660,3,10,9,7,54,44,10,39
Linfield,660,4,11,5,10,39,36,3,38
Cliftonville,660,5,9,4,13,32,33,-1,31
Ballymena,660,6,7,4,15,25,52,-27,25
Glentoran,660,7,6,6,10,24,32,-8,24
Dungannon,660,8,2,4,16,14,47,-33,10
Crusaders,661,1,17,6,3,65,30,35,57
Coleraine,661,2,14,10,2,43,23,20,52
Glenavon,661,3,10,9,7,53,43,10,39
Linfield,661,4,10,6,10,37,36,1,36
Cliftonville,661,5,9,5,12,32,31,1,32
Ballymena,661,6,7,4,15,25,51,-26,25
Glentoran,661,7,6,6,10,24,32,-8,24
Dungannon,661,8,2,4,16,14,47,-33,10
Crusaders,662,1,17,6,3,64,30,34,57
Coleraine,662,2,15,10,1,45,23,22,55
Linfield,662,3,11,5,10,38,36,2,38
Glenavon,662,4,9,9,8,53,45,8,36
Cliftonville,662,5,9,4,13,32,32,0,31
Ballymena,662,6,7,4,15,25,50,-25,25
Glentoran,662,7,6,6,10,24,32,-8,24
Dungannon,662,8,2,4,16,14,47,-33,10
Crusaders,663,1,16,6,4,62,32,30,54
Coleraine,663,2,14,11,1,45,24,21,53
Linfield,663,3,11,5,10,39,37,2,38
Glenavon,663,4,9,10,7,54,45,9,37
Cliftonville,663,5,9,4,13,33,33,0,31
Ballymena,663,6,8,4,14,27,48,-21,28
Glentoran,663,7,6,6,10,24,32,-8,24
Dungannon,663,8,2,4,16,14,47,-33,10
Crusaders,664,1,17,6,3,62,30,32,57
Coleraine,664,2,14,11,1,45,24,21,53
Linfield,664,3,11,5,10,41,36,5,38
Glenavon,664,4,9,10,7,54,45,9,37
Cliftonville,664,5,9,4,13,32,35,-3,31
Ballymena,664,6,7,4,15,25,48,-23,25
Glentoran,664,7,6,6,10,24,32,-8,24
Dungannon,664,8,2,4,16,14,47,-33,10
Crusaders,665,1,17,6,3,63,31,32,57
Coleraine,665,2,14,11,1,44,23,21,53
Glenavon,665,3,9,10,7,53,44,9,37
Linfield,665,4,10,6,10,38,37,1,36
Cliftonville,665,5,9,5,12,33,32,1,32
Ballymena,665,6,7,4,15,26,49,-23,25
Glentoran,665,7,6,6,10,24,32,-8,24
Dungannon,665,8,2,4,16,14,47,-33,10
Crusaders,666,1,16,6,4,61,32,29,54
Coleraine,666,2,14,11,1,45,24,21,53
Linfield,666,3,11,5,10,38,36,2,38
Glenavon,666,4,9,10,7,54,45,9,37
Cliftonville,666,5,9,4,13,32,32,0,31
Ballymena,666,6,8,4,14,27,47,-20,28
Glentoran,666,7,6,6,10,24,32,-8,24
Dungannon,666,8,2,4,16,14,47,-33,10
Crusaders,667,1,16,7,3,61,30,31,55
Coleraine,667,2,14,11,1,46,25,21,53
Linfield,667,3,11,5,10,39,37,2,38
Glenavon,667,4,9,10,7,55,46,9,37
Cliftonville,667,5,9,4,13,33,33,0,31
Ballymena,667,6,7,5,14,25,47,-22,26
Glentoran,667,7,6,6,10,24,32,-8,24
Dungannon,667,8,2,4,16,14,47,-33,10
Crusaders,668,1,17,6,3,66,32,34,57
Coleraine,668,2,15,10,1,45,23,22,55
Glenavon,668,3,9,9,8,53,45,8,36
Linfield,668,4,10,6,10,39,38,1,36
Cliftonville,668,5,9,5,12,34,33,1,32
Ballymena,668,6,7,4,15,27,52,-25,25
Glentoran,668,7,6,6,10,24,32,-8,24
Dungannon,668,8,2,4,16,14,47,-33,10
Crusaders,669,1,17,6,3,64,31,33,57
Coleraine,669,2,14,10,2,43,25,18,52
Glenavon,669,3,10,9,7,55,43,12,39
Linfield,669,4,11,5,10,40,36,4,38
Cliftonville,669,5,9,4,13,32,34,-2,31
Ballymena,669,6,7,4,15,26,50,-24,25
Glentoran,669,7,6,6,10,24,32,-8,24
Dungannon,669,8,2,4,16,14,47,-33,10
Crusaders,670,1,17,6,3,64,31,33,57
Coleraine,670,2,15,10,1,46,23,23,55
Glenavon,670,3,9,9,8,53,46,7,36
Linfield,670,4,10,6,10,39,38,1,36
Cliftonville,670,5,9,5,12,34,33,1,32
Ballymena,670,6,7,4,15,26,50,-24,25
Glentoran,670,7,6,6,10,24,32,-8,24
Dungannon,670,8,2,4,16,14,47,-33,10
Crusaders,671,1,17,6,3,63,31,32,57
Coleraine,671,2,15,10,1,46,22,24,55
Glenavon,671,3,9,9,8,52,46,6,36
Linfield,671,4,10,6,10,38,37,1,36
Cliftonville,671,5,9,5,12,33,32,1,32
Ballymena,671,6,7,4,15,26,49,-23,25
Glentoran,671,7,6,6,10,24,32,-8,24
Dungannon,671,8,2,4,16,14,47,-33,10
Crusaders,672,1,17,6,3,65,31,34,57
Coleraine,672,2,15,10,1,46,23,23,55
Linfield,672,3,11,5,10,39,37,2,38
Glenavon,672,4,9,9,8,53,46,7,36
Cliftonville,672,5,9,4,13,33,33,0,31
Ballymena,672,6,7,4,15,26,51,-25,25
Glentoran,672,7,6,6,10,24,32,-8,24
Dungannon,672,8,2,4,16,14,47,-33,10
Crusaders,673,1,17,6,3,62,30,32,57
Coleraine,673,2,14,10,2,44,24,20,52
Glenavon,673,3,10,9,7,54,44,10,39
Linfield,673,4,10,6,10,38,37,1,36
Cliftonville,673,5,9,5,12,33,32,1,32
Ballymena,673,6,7,4,15,25,48,-23,25
Glentoran,673,7,6,6,10,24,32,-8,24
Dungannon,673,8,2,4,16,14,47,-33,10
Crusaders,674,1,17,6,3,64,32,32,57
Coleraine,674,2,14,10,2,44,26,18,52
Glenavon,674,3,10,9,7,56,44,12,39
Linfield,674,4,10,6,10,38,37,1,36
Cliftonville,674,5,9,5,12,33,32,1,32
Ballymena,674,6,7,4,15,27,50,-23,25
Glentoran,674,7,6,6,10,24,32,-8,24
Dungannon,674,8,2,4,16,14,47,-33,10
Crusaders,675,1,17,6,3,63,31,32,57
Coleraine,675,2,14,10,2,43,23,20,52
Glenavon,675,3,10,9,7,53,43,10,39
Linfield,675,4,11,5,10,40,37,3,38
Cliftonville,675,5,9,4,13,33,34,-1,31
Ballymena,675,6,7,4,15,26,49,-23,25
Glentoran,675,7,6,6,10,24,32,-8,24
Dungannon,675,8,2,4,16,14,47,-33,10
Crusaders,676,1,16,7,3,62,31,31,55
Coleraine,676,2,15,10,1,45,23,22,55
Linfield,676,3,11,5,10,38,36,2,38
Glenavon,676,4,9,9,8,53,45,8,36
Cliftonville,676,5,9,4,13,32,32,0,31
Ballymena,676,6,7,5,14,26,48,-22,26
Glentoran,676,7,6,6,10,24,32,-8,24
Dungannon,676,8,2,4,16,14,47,-33,10
Crusaders,677,1,16,6,4,61,33,28,54
Coleraine,677,2,14,11,1,43,22,21,53
Glenavon,677,3,9,10,7,52,43,9,37
Linfield,677,4,10,5,11,38,38,0,35
Cliftonville,677,5,10,4,12,34,32,2,34
Ballymena,677,6,8,4,14,28,47,-19,28
Glentoran,677,7,6,6,10,24,32,-8,24
Dungannon,677,8,2,4,16,14,47,-33,10
Crusaders,678,1,17,6,3,63,30,33,57
Coleraine,678,2,14,10,2,43,24,19,52
Glenavon,678,3,10,9,7,54,43,11,39
Linfield,678,4,10,6,10,37,36,1,36
Cliftonville,678,5,9,5,12,32,31,1,32
Ballymena,678,6,7,4,15,25,49,-24,25
Glentoran,678,7,6,6,10,24,32,-8,24
Dungannon,678,8,2,4,16,14,47,-33,10
Crusaders,679,1,16,7,3,63,32,31,55
Coleraine,679,2,14,10,2,44,25,19,52
Glenavon,679,3,10,9,7,55,44,11,39
Linfield,679,4,10,5,11,37,37,0,35
Cliftonville,679,5,10,4,12,33,31,2,34
Ballymena,679,6,7,5,14,27,49,-22,26
Glentoran,679,7,6,6,10,24,32,-8,24
Dungannon,679,8,2,4,16,14,47,-33,10
Crusaders,680,1,17,6,3,63,31,32,57
Coleraine,680,2,14,11,1,44,23,21,53
Glenavon,680,3,9,10,7,53,44,9,37
Linfield,680,4,10,6,10,38,37,1,36
Cliftonville,680,5,9,5,12,33,32,1,32
Ballymena,680,6,7,4,15,26,49,-23,25
Glentoran,680,7,6,6,10,24,32,-8,24
Dungannon,680,8,2,4,16,14,47,-33,10
Crusaders,681,1,17,6,3,65,30,35,57
Coleraine,681,2,14,10,2,45,27,18,52
Glenavon,681,3,10,9,7,57,45,12,39
Linfield,681,4,10,5,11,38,38,0,35
Cliftonville,681,5,10,4,12,34,32,2,34
Ballymena,681,6,7,4,15,25,51,-26,25
Glentoran,681,7,6,6,10,24,32,-8,24
Dungannon,681,8,2,4,16,14,47,-33,10
Crusaders,682,1,17,6,3,64,30,34,57
Coleraine,682,2,14,10,2,45,26,19,52
Glenavon,682,3,10,9,7,56,45,11,39
Linfield,682,4,11,5,10,38,36,2,38
Cliftonville,682,5,9,4,13,32,32,0,31
Ballymena,682,6,7,4,15,25,50,-25,25
Glentoran,682,7,6,6,10,24,32,-8,24
Dungannon,682,8,2,4,16,14,47,-33,10
Crusaders,683,1,17,6,3,62,30,32,57
Coleraine,683,2,14,11,1,44,23,21,53
Glenavon,683,3,9,10,7,53,44,9,37
Linfield,683,4,10,5,11,37,37,0,35
Cliftonville,683,5,10,4,12,33,31,2,34
Ballymena,683,6,7,4,15,25,48,-23,25
Glentoran,683,7,6,6,10,24,32,-8,24
Dungannon,683,8,2,4,16,14,47,-33,10
Coleraine,684,1,15,10,1,44,22,22,55
Crusaders,684,2,16,6,4,62,32,30,54
Linfield,684,3,11,5,10,38,36,2,38
Glenavon,684,4,9,9,8,52,44,8,36
Cliftonville,684,5,9,4,13,32,32,0,31
Ballymena,684,6,8,4,14,27,48,-21,28
Glentoran,684,7,6,6,10,24,32,-8,24
Dungannon,684,8,2,4,16,14,47,-33,10
Crusaders,685,1,17,6,3,62,30,32,57
Coleraine,685,2,15,10,1,46,22,24,55
Glenavon,685,3,9,9,8,52,46,6,36
Linfield,685,4,10,6,10,40,39,1,36
Cliftonville,685,5,9,5,12,35,34,1,32
Ballymena,685,6,7,4,15,25,48,-23,25
Glentoran,685,7,6,6,10,24,32,-8,24
Dungannon,685,8,2,4,16,14,47,-33,10
Crusaders,686,1,17,6,3,64,30,34,57
Coleraine,686,2,14,10,2,43,24,19,52
Glenavon,686,3,10,9,7,54,43,11,39
Linfield,686,4,10,6,10,39,38,1,36
Cliftonville,686,5,9,5,12,34,33,1,32
Ballymena,686,6,7,4,15,25,50,-25,25
Glentoran,686,7,6,6,10,24,32,-8,24
Dungannon,686,8,2,4,16,14,47,-33,10
Crusaders,687,1,16,7,3,62,31,31,55
Coleraine,687,2,14,10,2,43,23,20,52
Glenavon,687,3,10,9,7,53,43,10,39
Linfield,687,4,11,5,10,38,36,2,38
Cliftonville,687,5,9,4,13,32,32,0,31
Ballymena,687,6,7,5,14,26,48,-22,26
Glentoran,687,7,6,6,10,24,32,-8,24
Dungannon,687,8,2,4,16,14,47,-33,10
Crusaders,688,1,17,6,3,63,30,33,57
Coleraine,688,2,15,10,1,45,22,23,55
Linfield,688,3,11,5,10,38,36,2,38
Glenavon,688,4,9,9,8,52,45,7,36
Cliftonville,688,5,9,4,13,32,32,0,31
Ballymena,688,6,7,4,15,25,49,-24,25
Glentoran,688,7,6,6,10,24,32,-8,24
Dungannon,688,8,2,4,16,14,47,-33,10
Crusaders,689,1,17,6,3,62,30,32,57
Coleraine,689,2,14,10,2,44,27,17,52
Glenavon,689,3,10,9,7,57,44,13,39
Linfield,689,4,10,6,10,37,36,1,36
Cliftonville,689,5,9,5,12,32,31,1,32
Ballymena,689,6,7,4,15,25,48,-23,25
Glentoran,689,7,6,6,10,24,32,-8,24
Dungannon,689,8,2,4,16,14,47,-33,10
Coleraine,690,1,15,10,1,44,22,22,55
Crusaders,690,2,16,6,4,62,32,30,54
Linfield,690,3,11,5,10,40,36,4,38
Glenavon,690,4,9,9,8,52,44,8,36
Cliftonville,690,5,9,4,13,32,34,-2,31
Ballymena,690,6,8,4,14,27,48,-21,28
Glentoran,690,7,6,6,10,24,32,-8,24
Dungannon,690,8,2,4,16,14,47,-33,10
Crusaders,691,1,17,6,3,63,31,32,57
Coleraine,691,2,14,11,1,43,22,21,53
Glenavon,691,3,9,10,7,52,43,9,37
Linfield,691,4,10,6,10,38,37,1,36
Cliftonville,691,5,9,5,12,33,32,1,32
Ballymena,691,6,7,4,15,26,49,-23,25
Glentoran,691,7,6,6,10,24,32,-8,24
Dungannon,691,8,2,4,16,14,47,-33,10
Crusaders,692,1,16,6,4,61,31,30,54
Coleraine,692,2,14,10,2,43,24,19,52
Glenavon,692,3,10,9,7,54,43,11,39
Linfield,692,4,10,6,10,38,37,1,36
Cliftonville,692,5,9,5,12,33,32,1,32
Ballymena,692,6,8,4,14,26,47,-21,28
Glentoran,692,7,6,6,10,24,32,-8,24
Dungannon,692,8,2,4,16,14,47,-33,10
Crusaders,693,1,17,6,3,67,34,33,57
Coleraine,693,2,14,11,1,43,22,21,53
Linfield,693,3,11,5,10,38,36,2,38
Glenavon,693,4,9,10,7,52,43,9,37
Cliftonville,693,5,9,4,13,32,32,0,31
Ballymena,693,6,7,4,15,29,53,-24,25
Glentoran,693,7,6,6,10,24,32,-8,24
Dungannon,693,8,2,4,16,14,47,-33,10
Crusaders,694,1,16,7,3,62,31,31,55
Coleraine,694,2,14,10,2,44,24,20,52
Glenavon,694,3,10,9,7,54,44,10,39
Linfield,694,4,10,6,10,38,37,1,36
Cliftonville,694,5,9,5,12,33,32,1,32
Ballymena,694,6,7,5,14,26,48,-22,26
Glentoran,694,7,6,6,10,24,32,-8,24
Dungannon,694,8,2,4,16,14,47,-33,10
Crusaders,695,1,17,6,3,63,30,33,57
Coleraine,695,2,14,10,2,44,24,20,52
Glenavon,695,3,10,9,7,54,44,10,39
Linfield,695,4,11,5,10,38,36,2,38
Cliftonville,695,5,9,4,13,32,32,0,31
Ballymena,695,6,7,4,15,25,49,-24,25
Glentoran,695,7,6,6,10,24,32,-8,24
Dungannon,695,8,2,4,16,14,47,-33,10
Crusaders,696,1,17,6,3,64,30,34,57
Coleraine,696,2,15,10,1,44,22,22,55
Glenavon,696,3,9,9,8,52,44,8,36
Linfield,696,4,10,6,10,37,36,1,36
Cliftonville,696,5,9,5,12,32,31,1,32
Ballymena,696,6,7,4,15,25,50,-25,25
Glentoran,696,7,6,6,10,24,32,-8,24
Dungannon,696,8,2,4,16,14,47,-33,10
Crusaders,697,1,17,6,3,65,30,35,57
Coleraine,697,2,14,11,1,45,24,21,53
Linfield,697,3,11,5,10,39,37,2,38
Glenavon,697,4,9,10,7,54,45,9,37
Cliftonville,697,5,9,4,13,33,33,0,31
Ballymena,697,6,7,4,15,25,51,-26,25
Glentoran,697,7,6,6,10,24,32,-8,24
Dungannon,697,8,2,4,16,14,47,-33,10
Crusaders,698,1,17,6,3,64,30,34,57
Coleraine,698,2,15,10,1,47,23,24,55
Linfield,698,3,11,5,10,38,36,2,38
Glenavon,698,4,9,9,8,53,47,6,36
Cliftonville,698,5,9,4,13,32,32,0,31
Ballymena,698,6,7,4,15,25,50,-25,25
Glentoran,698,7,6,6,10,24,32,-8,24
Dungannon,698,8,2,4,16,14,47,-33,10
Crusaders,699,1,16,6,4,62,32,30,54
Coleraine,699,2,14,10,2,43,26,17,52
Glenavon,699,3,10,9,7,56,43,13,39
Linfield,699,4,11,5,10,39,36,3,38
Cliftonville,699,5,9,4,13,32,33,-1,31
Ballymena,699,6,8,4,14,27,48,-21,28
Glentoran,699,7,6,6,10,24,32,-8,24
Dungannon,699,8,2,4,16,14,47,-33,10
Crusaders,700,1,17,6,3,64,30,34,57
Coleraine,700,2,14,10,2,45,26,19,52
Glenavon,700,3,10,9,7,56,45,11,39
Linfield,700,4,10,5,11,38,38,0,35
Cliftonville,700,5,10,4,12,34,32,2,34
Ballymena,700,6,7,4,15,25,50,-25,25
Glentoran,700,7,6,6,10,24,32,-8,24
Dungannon,700,8,2,4,16,14,47,-33,10
Coleraine,701,1,15,10,1,45,23,22,55
Crusaders,701,2,16,6,4,63,33,30,54
Glenavon,701,3,9,9,8,53,45,8,36
Linfield,701,4,10,5,11,37,39,-2,35
Cliftonville,701,5,10,4,12,35,31,4,34
Ballymena,701,6,8,4,14,28,49,-21,28
Glentoran,701,7,6,6,10,24,32,-8,24
Dungannon,701,8,2,4,16,14,47,-33,10
Crusaders,702,1,17,6,3,64,30,34,57
Coleraine,702,2,14,11,1,45,24,21,53
Glenavon,702,3,9,10,7,54,45,9,37
Linfield,702,4,10,5,11,37,37,0,35
Cliftonville,702,5,10,4,12,33,31,2,34
Ballymena,702,6,7,4,15,25,50,-25,25
Glentoran,702,7,6,6,10,24,32,-8,24
Dungannon,702,8,2,4,16,14,47,-33,10
Crusaders,703,1,16,6,4,62,32,30,54
Coleraine,703,2,14,11,1,43,22,21,53
Glenavon,703,3,9,10,7,52,43,9,37
Linfield,703,4,10,6,10,37,36,1,36
Cliftonville,703,5,9,5,12,32,31,1,32
Ballymena,703,6,8,4,14,27,48,-21,28
Glentoran,703,7,6,6,10,24,32,-8,24
Dungannon,703,8,2,4,16,14,47,-33,10
Coleraine,704,1,15,10,1,45,23,22,55
Crusaders,704,2,16,6,4,62,33,29,54
Glenavon,704,3,9,9,8,53,45,8,36
Linfield,704,4,10,5,11,37,37,0,35
Cliftonville,704,5,10,4,12,33,31,2,34
Ballymena,704,6,8,4,14,28,48,-20,28
Glentoran,704,7,6,6,10,24,32,-8,24
Dungannon,704,8,2,4,16,14,47,-33,10
Crusaders,705,1,16,6,4,62,32,30,54
Coleraine,705,2,14,10,2,45,25,20,52
Glenavon,705,3,10,9,7,55,45,10,39
Linfield,705,4,10,6,10,38,37,1,36
Cliftonville,705,5,9,5,12,33,32,1,32
Ballymena,705,6,8,4,14,27,48,-21,28
Glentoran,705,7,6,6,10,24,32,-8,24
Dungannon,705,8,2,4,16,14,47,-33,10
Crusaders,706,1,17,6,3,64,30,34,57
Coleraine,706,2,15,10,1,45,23,22,55
Linfield,706,3,11,5,10,39,36,3,38
Glenavon,706,4,9,9,8,53,45,8,36
Cliftonville,706,5,9,4,13,32,33,-1,31
Ballymena,706,6,7,4,15,25,50,-25,25
Glentoran,706,7,6,6,10,24,32,-8,24
Dungannon,706,8,2,4,16,14,47,-33,10
Crusaders,707,1,16,6,4,62,32,30,54
Coleraine,707,2,14,10,2,44,25,19,52
Glenavon,707,3,10,9,7,55,44,11,39
Linfield,707,4,11,5,10,38,36,2,38
Cliftonville,707,5,9,4,13,32,32,0,31
Ballymena,707,6,8,4,14,27,48,-21,28
Glentoran,707,7,6,6,10,24,32,-8,24
Dungannon,707,8,2,4,16,14,47,-33,10
Crusaders,708,1,16,7,3,62,31,31,55
Coleraine,708,2,14,11,1,44,23,21,53
Linfield,708,3,11,5,10,41,37,4,38
Glenavon,708,4,9,10,7,53,44,9,37
Cliftonville,708,5,9,4,13,33,35,-2,31
Ballymena,708,6,7,5,14,26,48,-22,26
Glentoran,708,7,6,6,10,24,32,-8,24
Dungannon,708,8,2,4,16,14,47,-33,10
Crusaders,709,1,16,6,4,61,32,29,54
Coleraine,709,2,14,10,2,43,25,18,52
Glenavon,709,3,10,9,7,55,43,12,39
Linfield,709,4,10,5,11,37,38,-1,35
Cliftonville,709,5,10,4,12,34,31,3,34
Ballymena,709,6,8,4,14,27,47,-20,28
Glentoran,709,7,6,6,10,24,32,-8,24
Dungannon,709,8,2,4,16,14,47,-33,10
Crusaders,710,1,17,6,3,64,32,32,57
Coleraine,710,2,14,10,2,44,24,20,52
Glenavon,710,3,10,9,7,54,44,10,39
Linfield,710,4,10,6,10,38,37,1,36
Cliftonville,710,5,9,5,12,33,32,1,32
Ballymena,710,6,7,4,15,27,50,-23,25
Glentoran,710,7,6,6,10,24,32,-8,24
Dungannon,710,8,2,4,16,14,47,-33,10
Crusaders,711,1,16,6,4,61,34,27,54
Coleraine,711,2,14,10,2,45,26,19,52
Glenavon,711,3,10,9,7,56,45,11,39
Linfield,711,4,10,5,11,38,38,0,35
Cliftonville,711,5,10,4,12,34,32,2,34
Ballymena,711,6,8,4,14,29,47,-18,28
Glentoran,711,7,6,6,10,24,32,-8,24
Dungannon,711,8,2,4,16,14,47,-33,10
Crusaders,712,1,16,7,3,62,31,31,55
Coleraine,712,2,14,11,1,45,24,21,53
Linfield,712,3,11,5,10,40,37,3,38
Glenavon,712,4,9,10,7,54,45,9,37
Cliftonville,712,5,9,4,13,33,34,-1,31
Ballymena,712,6,7,5,14,26,48,-22,26
Glentoran,712,7,6,6,10,24,32,-8,24
Dungannon,712,8,2,4,16,14,47,-33,10
Crusaders,713,1,17,6,3,63,31,32,57
Coleraine,713,2,14,11,1,43,22,21,53
Glenavon,713,3,9,10,7,52,43,9,37
Linfield,713,4,10,6,10,39,38,1,36
Cliftonville,713,5,9,5,12,34,33,1,32
Ballymena,713,6,7,4,15,26,49,-23,25
Glentoran,713,7,6,6,10,24,32,-8,24
Dungannon,713,8,2,4,16,14,47,-33,10
Crusaders,714,1,17,6,3,65,32,33,57
Coleraine,714,2,14,10,2,44,25,19,52
Glenavon,714,3,10,9,7,55,44,11,39
Linfield,714,4,10,6,10,38,37,1,36
Cliftonville,714,5,9,5,12,33,32,1,32
Ballymena,714,6,7,4,15,27,51,-24,25
Glentoran,714,7,6,6,10,24,32,-8,24
Dungannon,714,8,2,4,16,14,47,-33,10
Crusaders,715,1,17,6,3,65,33,32,57
Coleraine,715,2,15,10,1,46,23,23,55
Glenavon,715,3,9,9,8,53,46,7,36
Linfield,715,4,10,6,10,37,36,1,36
Cliftonville,715,5,9,5,12,32,31,1,32
Ballymena,715,6,7,4,15,28,51,-23,25
Glentoran,715,7,6,6,10,24,32,-8,24
Dungannon,715,8,2,4,16,14,47,-33,10
Crusaders,716,1,17,6,3,63,31,32,57
Coleraine,716,2,14,11,1,44,23,21,53
Linfield,716,3,11,5,10,41,37,4,38
Glenavon,716,4,9,10,7,53,44,9,37
Cliftonville,716,5,9,4,13,33,35,-2,31
Ballymena,716,6,7,4,15,26,49,-23,25
Glentoran,716,7,6,6,10,24,32,-8,24
Dungannon,716,8,2,4,16,14,47,-33,10
Crusaders,717,1,16,6,4,62,32,30,54
Coleraine,717,2,14,10,2,44,25,19,52
Glenavon,717,3,10,9,7,55,44,11,39
Linfield,717,4,10,6,10,38,37,1,36
Cliftonville,717,5,9,5,12,33,32,1,32
Ballymena,717,6,8,4,14,27,48,-21,28
Glentoran,717,7,6,6,10,24,32,-8,24
Dungannon,717,8,2,4,16,14,47,-33,10
Crusaders,718,1,16,7,3,63,32,31,55
Coleraine,718,2,14,10,2,44,25,19,52
Glenavon,718,3,10,9,7,55,44,11,39
Linfield,718,4,10,5,11,38,38,0,35
Cliftonville,718,5,10,4,12,34,32,2,34
Ballymena,718,6,7,5,14,27,49,-22,26
Glentoran,718,7,6,6,10,24,32,-8,24
Dungannon,718,8,2,4,16,14,47,-33,10
Crusaders,719,1,17,6,3,64,31,33,57
Coleraine,719,2,15,10,1,45,23,22,55
Glenavon,719,3,9,9,8,53,45,8,36
Linfield,719,4,10,5,11,37,37,0,35
Cliftonville,719,5,10,4,12,33,31,2,34
Ballymena,719,6,7,4,15,26,50,-24,25
Glentoran,719,7,6,6,10,24,32,-8,24
Dungannon,719,8,2,4,16,14,47,-33,10
Crusaders,720,1,17,6,3,64,31,33,57
Coleraine,720,2,15,10,1,45,23,22,55
Glenavon,720,3,9,9,8,53,45,8,36
Linfield,720,4,10,5,11,37,38,-1,35
Cliftonville,720,5,10,4,12,34,31,3,34
Ballymena,720,6,7,4,15,26,50,-24,25
Glentoran,720,7,6,6,10,24,32,-8,24
Dungannon,720,8,2,4,16,14,47,-33,10
Crusaders,721,1,17,6,3,64,32,32,57
Coleraine,721,2,14,10,2,43,26,17,52
Glenavon,721,3,10,9,7,56,43,13,39
Linfield,721,4,10,5,11,37,37,0,35
Cliftonville,721,5,10,4,12,33,31,2,34
Ballymena,721,6,7,4,15,27,50,-23,25
Glentoran,721,7,6,6,10,24,32,-8,24
Dungannon,721,8,2,4,16,14,47,-33,10
Crusaders,722,1,17,6,3,65,30,35,57
Coleraine,722,2,15,10,1,46,24,22,55
Glenavon,722,3,9,9,8,54,46,8,36
Linfield,722,4,10,6,10,37,36,1,36
Cliftonville,722,5,9,5,12,32,31,1,32
Ballymena,722,6,7,4,15,25,51,-26,25
Glentoran,722,7,6,6,10,24,32,-8,24
Dungannon,722,8,2,4,16,14,47,-33,10
Crusaders,723,1,17,6,3,64,30,34,57
Coleraine,723,2,14,10,2,45,26,19,52
Glenavon,723,3,10,9,7,56,45,11,39
Linfield,723,4,10,5,11,38,38,0,35
Cliftonville,723,5,10,4,12,34,32,2,34
Ballymena,723,6,7,4,15,25,50,-25,25
Glentoran,723,7,6,6,10,24,32,-8,24
Dungannon,723,8,2,4,16,14,47,-33,10
Crusaders,724,1,17,6,3,64,31,33,57
Coleraine,724,2,15,10,1,48,22,26,55
Glenavon,724,3,9,9,8,52,48,4,36
Linfield,724,4,10,6,10,38,37,1,36
Cliftonville,724,5,9,5,12,33,32,1,32
Ballymena,724,6,7,4,15,26,50,-24,25
Glentoran,724,7,6,6,10,24,32,-8,24
Dungannon,724,8,2,4,16,14,47,-33,10
Crusaders,725,1,16,6,4,63,33,30,54
Coleraine,725,2,14,11,1,44,23,21,53
Linfield,725,3,11,5,10,42,38,4,38
Glenavon,725,4,9,10,7,53,44,9,37
Cliftonville,725,5,9,4,13,34,36,-2,31
Ballymena,725,6,8,4,14,28,49,-21,28
Glentoran,725,7,6,6,10,24,32,-8,24
Dungannon,725,8,2,4,16,14,47,-33,10
Crusaders,726,1,17,6,3,65,32,33,57
Coleraine,726,2,15,10,1,46,23,23,55
Linfield,726,3,11,5,10,40,38,2,38
Glenavon,726,4,9,9,8,53,46,7,36
Cliftonville,726,5,9,4,13,34,34,0,31
Ballymena,726,6,7,4,15,27,51,-24,25
Glentoran,726,7,6,6,10,24,32,-8,24
Dungannon,726,8,2,4,16,14,47,-33,10
Crusaders,727,1,16,6,4,62,32,30,54
Coleraine,727,2,14,10,2,43,24,19,52
Glenavon,727,3,10,9,7,54,43,11,39
Linfield,727,4,10,6,10,38,37,1,36
Cliftonville,727,5,9,5,12,33,32,1,32
Ballymena,727,6,8,4,14,27,48,-21,28
Glentoran,727,7,6,6,10,24,32,-8,24
Dungannon,727,8,2,4,16,14,47,-33,10
Crusaders,728,1,17,6,3,66,30,36,57
Coleraine,728,2,15,10,1,46,24,22,55
Glenavon,728,3,9,9,8,54,46,8,36
Linfield,728,4,10,5,11,37,37,0,35
Cliftonville,728,5,10,4,12,33,31,2,34
Ballymena,728,6,7,4,15,25,52,-27,25
Glentoran,728,7,6,6,10,24,32,-8,24
Dungannon,728,8,2,4,16,14,47,-33,10
Crusaders,729,1,16,7,3,62,31,31,55
Coleraine,729,2,14,10,2,43,26,17,52
Glenavon,729,3,10,9,7,56,43,13,39
Linfield,729,4,10,5,11,37,37,0,35
Cliftonville,729,5,10,4,12,33,31,2,34
Ballymena,729,6,7,5,14,26,48,-22,26
Glentoran,729,7,6,6,10,24,32,-8,24
Dungannon,729,8,2,4,16,14,47,-33,10
Crusaders,730,1,16,6,4,62,33,29,54
Coleraine,730,2,14,10,2,44,24,20,52
Glenavon,730,3,10,9,7,54,44,10,39
Linfield,730,4,11,5,10,38,36,2,38
Cliftonville,730,5,9,4,13,32,32,0,31
Ballymena,730,6,8,4,14,28,48,-20,28
Glentoran,730,7,6,6,10,24,32,-8,24
Dungannon,730,8,2,4,16,14,47,-33,10
Crusaders,731,1,16,7,3,61,30,31,55
Coleraine,731,2,14,10,2,44,25,19,52
Glenavon,731,3,10,9,7,55,44,11,39
Linfield,731,4,10,5,11,37,38,-1,35
Cliftonville,731,5,10,4,12,34,31,3,34
Ballymena,731,6,7,5,14,25,47,-22,26
Glentoran,731,7,6,6,10,24,32,-8,24
Dungannon,731,8,2,4,16,14,47,-33,10
Crusaders,732,1,16,7,3,65,34,31,55
Coleraine,732,2,14,11,1,46,25,21,53
Linfield,732,3,11,5,10,42,36,6,38
Glenavon,732,4,9,10,7,55,46,9,37
Cliftonville,732,5,9,4,13,32,36,-4,31
Ballymena,732,6,7,5,14,29,51,-22,26
Glentoran,732,7,6,6,10,24,32,-8,24
Dungannon,732,8,2,4,16,14,47,-33,10
Crusaders,733,1,17,6,3,63,30,33,57
Coleraine,733,2,14,11,1,45,24,21,53
Linfield,733,3,11,5,10,39,36,3,38
Glenavon,733,4,9,10,7,54,45,9,37
Cliftonville,733,5,9,4,13,32,33,-1,31
Ballymena,733,6,7,4,15,25,49,-24,25
Glentoran,733,7,6,6,10,24,32,-8,24
Dungannon,733,8,2,4,16,14,47,-33,10
Crusaders,734,1,16,6,4,62,32,30,54
Coleraine,734,2,14,10,2,43,23,20,52
Glenavon,734,3,10,9,7,53,43,10,39
Linfield,734,4,11,5,10,38,36,2,38
Cliftonville,734,5,9,4,13,32,32,0,31
Ballymena,734,6,8,4,14,27,48,-21,28
Glentoran,734,7,6,6,10,24,32,-8,24
Dungannon,734,8,2,4,16,14,47,-33,10
Crusaders,735,1,17,6,3,63,31,32,57
Coleraine,735,2,15,10,1,46,23,23,55
Linfield,735,3,11,5,10,39,37,2,38
Glenavon,735,4,9,9,8,53,46,7,36
Cliftonville,735,5,9,4,13,33,33,0,31
Ballymena,735,6,7,4,15,26,49,-23,25
Glentoran,735,7,6,6,10,24,32,-8,24
Dungannon,735,8,2,4,16,14,47,-33,10
Crusaders,736,1,17,6,3,64,30,34,57
Coleraine,736,2,14,10,2,45,25,20,52
Glenavon,736,3,10,9,7,55,45,10,39
Linfield,736,4,11,5,10,41,38,3,38
Cliftonville,736,5,9,4,13,34,35,-1,31
Ballymena,736,6,7,4,15,25,50,-25,25
Glentoran,736,7,6,6,10,24,32,-8,24
Dungannon,736,8,2,4,16,14,47,-33,10
Crusaders,737,1,17,6,3,64,30,34,57
Coleraine,737,2,14,10,2,44,25,19,52
Glenavon,737,3,10,9,7,55,44,11,39
Linfield,737,4,10,6,10,38,37,1,36
Cliftonville,737,5,9,5,12,33,32,1,32
Ballymena,737,6,7,4,15,25,50,-25,25
Glentoran,737,7,6,6,10,24,32,-8,24
Dungannon,737,8,2,4,16,14,47,-33,10
Crusaders,738,1,16,7,3,63,32,31,55
Coleraine,738,2,14,11,1,44,23,21,53
Linfield,738,3,11,5,10,43,36,7,38
Glenavon,738,4,9,10,7,53,44,9,37
Cliftonville,738,5,9,4,13,32,37,-5,31
Ballymena,738,6,7,5,14,27,49,-22,26
Glentoran,738,7,6,6,10,24,32,-8,24
Dungannon,738,8,2,4,16,14,47,-33,10
Crusaders,739,1,16,6,4,61,33,28,54
Coleraine,739,2,14,11,1,43,22,21,53
Linfield,739,3,11,5,10,39,37,2,38
Glenavon,739,4,9,10,7,52,43,9,37
Cliftonville,739,5,9,4,13,33,33,0,31
Ballymena,739,6,8,4,14,28,47,-19,28
Glentoran,739,7,6,6,10,24,32,-8,24
Dungannon,739,8,2,4,16,14,47,-33,10
Crusaders,740,1,16,7,3,63,32,31,55
Coleraine,740,2,15,10,1,44,22,22,55
Glenavon,740,3,9,9,8,52,44,8,36
Linfield,740,4,10,6,10,37,36,1,36
Cliftonville,740,5,9,5,12,32,31,1,32
Ballymena,740,6,7,5,14,27,49,-22,26
Glentoran,740,7,6,6,10,24,32,-8,24
Dungannon,740,8,2,4,16,14,47,-33,10
Crusaders,741,1,17,6,3,63,31,32,57
Coleraine,741,2,14,10,2,44,24,20,52
Glenavon,741,3,10,9,7,54,44,10,39
Linfield,741,4,10,6,10,37,36,1,36
Cliftonville,741,5,9,5,12,32,31,1,32
Ballymena,741,6,7,4,15,26,49,-23,25
Glentoran,741,7,6,6,10,24,32,-8,24
Dungannon,741,8,2,4,16,14,47,-33,10
Crusaders,742,1,16,7,3,62,31,31,55
Coleraine,742,2,14,10,2,44,24,20,52
Glenavon,742,3,10,9,7,54,44,10,39
Linfield,742,4,11,5,10,39,37,2,38
Cliftonville,742,5,9,4,13,33,33,0,31
Ballymena,742,6,7,5,14,26,48,-22,26
Glentoran,742,7,6,6,10,24,32,-8,24
Dungannon,742,8,2,4,16,14,47,-33,10
Crusaders,743,1,17,6,3,62,30,32,57
Coleraine,743,2,15,10,1,47,23,24,55
Linfield,743,3,11,5,10,40,37,3,38
Glenavon,743,4,9,9,8,53,47,6,36
Cliftonville,743,5,9,4,13,33,34,-1,31
Ballymena,743,6,7,4,15,25,48,-23,25
Glentoran,743,7,6,6,10,24,32,-8,24
Dungannon,743,8,2,4,16,14,47,-33,10
Crusaders,744,1,16,7,3,63,32,31,55
Coleraine,744,2,15,10,1,46,23,23,55
Linfield,744,3,11,5,10,39,37,2,38
Glenavon,744,4,9,9,8,53,46,7,36
Cliftonville,744,5,9,4,13,33,33,0,31
Ballymena,744,6,7,5,14,27,49,-22,26
Glentoran,744,7,6,6,10,24,32,-8,24
Dungannon,744,8,2,4,16,14,47,-33,10
Crusaders,745,1,17,6,3,65,30,35,57
Coleraine,745,2,14,11,1,45,24,21,53
Glenavon,745,3,9,10,7,54,45,9,37
Linfield,745,4,10,5,11,37,37,0,35
Cliftonville,745,5,10,4,12,33,31,2,34
Ballymena,745,6,7,4,15,25,51,-26,25
Glentoran,745,7,6,6,10,24,32,-8,24
Dungannon,745,8,2,4,16,14,47,-33,10
Crusaders,746,1,16,7,3,64,33,31,55
Coleraine,746,2,14,10,2,43,25,18,52
Glenavon,746,3,10,9,7,55,43,12,39
Linfield,746,4,11,5,10,41,37,4,38
Cliftonville,746,5,9,4,13,33,35,-2,31
Ballymena,746,6,7,5,14,28,50,-22,26
Glentoran,746,7,6,6,10,24,32,-8,24
Dungannon,746,8,2,4,16,14,47,-33,10
Coleraine,747,1,15,10,1,46,23,23,55
Crusaders,747,2,16,6,4,61,31,30,54
Linfield,747,3,11,5,10,41,36,5,38
Glenavon,747,4,9,9,8,53,46,7,36
Cliftonville,747,5,9,4,13,32,35,-3,31
Ballymena,747,6,8,4,14,26,47,-21,28
Glentoran,747,7,6,6,10,24,32,-8,24
Dungannon,747,8,2,4,16,14,47,-33,10
Crusaders,748,1,16,7,3,62,31,31,55
Coleraine,748,2,14,10,2,44,25,19,52
Glenavon,748,3,10,9,7,55,44,11,39
Linfield,748,4,11,5,10,40,36,4,38
Cliftonville,748,5,9,4,13,32,34,-2,31
Ballymena,748,6,7,5,14,26,48,-22,26
Glentoran,748,7,6,6,10,24,32,-8,24
Dungannon,748,8,2,4,16,14,47,-33,10
Crusaders,749,1,17,6,3,64,32,32,57
Coleraine,749,2,14,10,2,44,24,20,52
Glenavon,749,3,10,9,7,54,44,10,39
Linfield,749,4,11,5,10,38,36,2,38
Cliftonville,749,5,9,4,13,32,32,0,31
Ballymena,749,6,7,4,15,27,50,-23,25
Glentoran,749,7,6,6,10,24,32,-8,24
Dungannon,749,8,2,4,16,14,47,-33,10
Coleraine,750,1,15,10,1,45,22,23,55
Crusaders,750,2,16,6,4,63,33,30,54
Linfield,750,3,11,5,10,39,36,3,38
Glenavon,750,4,9,9,8,52,45,7,36
Cliftonville,750,5,9,4,13,32,33,-1,31
Ballymena,750,6,8,4,14,28,49,-21,28
Glentoran,750,7,6,6,10,24,32,-8,24
Dungannon,750,8,2,4,16,14,47,-33,10
Crusaders,751,1,16,6,4,62,33,29,54
Coleraine,751,2,14,10,2,43,23,20,52
Glenavon,751,3,10,9,7,53,43,10,39
Linfield,751,4,10,6,10,38,37,1,36
Cliftonville,751,5,9,5,12,33,32,1,32
Ballymena,751,6,8,4,14,28,48,-20,28
Glentoran,751,7,6,6,10,24,32,-8,24
Dungannon,751,8,2,4,16,14,47,-33,10
Crusaders,752,1,17,6,3,67,31,36,57
Coleraine,752,2,14,11,1,46,25,21,53
Linfield,752,3,11,5,10,41,36,5,38
Glenavon,752,4,9,10,7,55,46,9,37
Cliftonville,752,5,9,4,13,32,35,-3,31
Ballymena,752,6,7,4,15,26,53,-27,25
Glentoran,752,7,6,6,10,24,32,-8,24
Dungannon,752,8,2,4,16,14,47,-33,10
Crusaders,753,1,17,6,3,64,30,34,57
Coleraine,753,2,15,10,1,48,22,26,55
Glenavon,753,3,9,9,8,52,48,4,36
Linfield,753,4,10,6,10,38,37,1,36
Cliftonville,753,5,9,5,12,33,32,1,32
Ballymena,753,6,7,4,15,25,50,-25,25
Glentoran,753,7,6,6,10,24,32,-8,24
Dungannon,753,8,2,4,16,14,47,-33,10
Crusaders,754,1,16,7,3,62,31,31,55
Coleraine,754,2,14,10,2,45,25,20,52
Glenavon,754,3,10,9,7,55,45,10,39
Linfield,754,4,10,5,11,38,39,-1,35
Cliftonville,754,5,10,4,12,35,32,3,34
Ballymena,754,6,7,5,14,26,48,-22,26
Glentoran,754,7,6,6,10,24,32,-8,24
Dungannon,754,8,2,4,16,14,47,-33,10
Crusaders,755,1,16,7,3,62,31,31,55
Coleraine,755,2,15,10,1,51,24,27,55
Glenavon,755,3,9,9,8,54,51,3,36
Linfield,755,4,10,5,11,39,40,-1,35
Cliftonville,755,5,10,4,12,36,33,3,34
Ballymena,755,6,7,5,14,26,48,-22,26
Glentoran,755,7,6,6,10,24,32,-8,24
Dungannon,755,8,2,4,16,14,47,-33,10
Crusaders,756,1,17,6,3,63,30,33,57
Coleraine,756,2,14,10,2,44,25,19,52
Glenavon,756,3,10,9,7,55,44,11,39
Linfield,756,4,11,5,10,38,36,2,38
Cliftonville,756,5,9,4,13,32,32,0,31
Ballymena,756,6,7,4,15,25,49,-24,25
Glentoran,756,7,6,6,10,24,32,-8,24
Dungannon,756,8,2,4,16,14,47,-33,10
Crusaders,757,1,17,6,3,65,30,35,57
Coleraine,757,2,15,10,1,46,24,22,55
Glenavon,757,3,9,9,8,54,46,8,36
Linfield,757,4,10,6,10,40,39,1,36
Cliftonville,757,5,9,5,12,35,34,1,32
Ballymena,757,6,7,4,15,25,51,-26,25
Glentoran,757,7,6,6,10,24,32,-8,24
Dungannon,757,8,2,4,16,14,47,-33,10
Crusaders,758,1,17,6,3,65,32,33,57
Coleraine,758,2,14,11,1,45,24,21,53
Glenavon,758,3,9,10,7,54,45,9,37
Linfield,758,4,10,5,11,38,40,-2,35
Cliftonville,758,5,10,4,12,36,32,4,34
Ballymena,758,6,7,4,15,27,51,-24,25
Glentoran,758,7,6,6,10,24,32,-8,24
Dungannon,758,8,2,4,16,14,47,-33,10
Coleraine,759,1,15,10,1,44,22,22,55
Crusaders,759,2,16,6,4,63,33,30,54
Linfield,759,3,11,5,10,38,36,2,38
Glenavon,759,4,9,9,8,52,44,8,36
Cliftonville,759,5,9,4,13,32,32,0,31
Ballymena,759,6,8,4,14,28,49,-21,28
Glentoran,759,7,6,6,10,24,32,-8,24
Dungannon,759,8,2,4,16,14,47,-33,10
Crusaders,760,1,16,7,3,61,30,31,55
Coleraine,760,2,14,11,1,43,22,21,53
Glenavon,760,3,9,10,7,52,43,9,37
Linfield,760,4,10,6,10,37,36,1,36
Cliftonville,760,5,9,5,12,32,31,1,32
Ballymena,760,6,7,5,14,25,47,-22,26
Glentoran,760,7,6,6,10,24,32,-8,24
Dungannon,760,8,2,4,16,14,47,-33,10
Crusaders,761,1,17,6,3,63,30,33,57
Coleraine,761,2,14,10,2,45,26,19,52
Glenavon,761,3,10,9,7,56,45,11,39
Linfield,761,4,10,6,10,37,36,1,36
Cliftonville,761,5,9,5,12,32,31,1,32
Ballymena,761,6,7,4,15,25,49,-24,25
Glentoran,761,7,6,6,10,24,32,-8,24
Dungannon,761,8,2,4,16,14,47,-33,10
Crusaders,762,1,17,6,3,64,30,34,57
Coleraine,762,2,14,10,2,43,23,20,52
Glenavon,762,3,10,9,7,53,43,10,39
Linfield,762,4,10,5,11,37,37,0,35
Cliftonville,762,5,10,4,12,33,31,2,34
Ballymena,762,6,7,4,15,25,50,-25,25
Glentoran,762,7,6,6,10,24,32,-8,24
Dungannon,762,8,2,4,16,14,47,-33,10
Crusaders,763,1,16,6,4,62,32,30,54
Coleraine,763,2,14,11,1,44,23,21,53
Linfield,763,3,11,5,10,39,36,3,38
Glenavon,763,4,9,10,7,53,44,9,37
Cliftonville,763,5,9,4,13,32,33,-1,31
Ballymena,763,6,8,4,14,27,48,-21,28
Glentoran,763,7,6,6,10,24,32,-8,24
Dungannon,763,8,2,4,16,14,47,-33,10
Crusaders,764,1,16,7,3,62,31,31,55
Coleraine,764,2,15,10,1,45,23,22,55
Glenavon,764,3,9,9,8,53,45,8,36
Linfield,764,4,10,6,10,38,37,1,36
Cliftonville,764,5,9,5,12,33,32,1,32
Ballymena,764,6,7,5,14,26,48,-22,26
Glentoran,764,7,6,6,10,24,32,-8,24
Dungannon,764,8,2,4,16,14,47,-33,10
Crusaders,765,1,17,6,3,66,31,35,57
Coleraine,765,2,14,10,2,44,24,20,52
Glenavon,765,3,10,9,7,54,44,10,39
Linfield,765,4,10,6,10,38,37,1,36
Cliftonville,765,5,9,5,12,33,32,1,32
Ballymena,765,6,7,4,15,26,52,-26,25
Glentoran,765,7,6,6,10,24,32,-8,24
Dungannon,765,8,2,4,16,14,47,-33,10
Crusaders,766,1,17,6,3,64,31,33,57
Coleraine,766,2,14,10,2,45,26,19,52
Glenavon,766,3,10,9,7,56,45,11,39
Linfield,766,4,11,5,10,38,36,2,38
Cliftonville,766,5,9,4,13,32,32,0,31
Ballymena,766,6,7,4,15,26,50,-24,25
Glentoran,766,7,6,6,10,24,32,-8,24
Dungannon,766,8,2,4,16,14,47,-33,10
Crusaders,767,1,17,6,3,62,30,32,57
Coleraine,767,2,14,11,1,44,23,21,53
Glenavon,767,3,9,10,7,53,44,9,37
Linfield,767,4,10,5,11,38,38,0,35
Cliftonville,767,5,10,4,12,34,32,2,34
Ballymena,767,6,7,4,15,25,48,-23,25
Glentoran,767,7,6,6,10,24,32,-8,24
Dungannon,767,8,2,4,16,14,47,-33,10
Crusaders,768,1,16,6,4,61,31,30,54
Coleraine,768,2,14,10,2,43,24,19,52
Glenavon,768,3,10,9,7,54,43,11,39
Linfield,768,4,11,5,10,38,36,2,38
Cliftonville,768,5,9,4,13,32,32,0,31
Ballymena,768,6,8,4,14,26,47,-21,28
Glentoran,768,7,6,6,10,24,32,-8,24
Dungannon,768,8,2,4,16,14,47,-33,10
Crusaders,769,1,17,6,3,64,31,33,57
Coleraine,769,2,14,10,2,44,26,18,52
Glenavon,769,3,10,9,7,56,44,12,39
Linfield,769,4,11,5,10,38,36,2,38
Cliftonville,769,5,9,4,13,32,32,0,31
Ballymena,769,6,7,4,15,26,50,-24,25
Glentoran,769,7,6,6,10,24,32,-8,24
Dungannon,769,8,2,4,16,14,47,-33,10
Crusaders,770,1,16,7,3,62,31,31,55
Coleraine,770,2,14,11,1,43,22,21,53
Glenavon,770,3,9,10,7,52,43,9,37
Linfield,770,4,10,6,10,38,37,1,36
Cliftonville,770,5,9,5,12,33,32,1,32
Ballymena,770,6,7,5,14,26,48,-22,26
Glentoran,770,7,6,6,10,24,32,-8,24
Dungannon,770,8,2,4,16,14,47,-33,10
Crusaders,771,1,16,7,3,62,31,31,55
Coleraine,771,2,15,10,1,44,22,22,55
Glenavon,771,3,9,9,8,52,44,8,36
Linfield,771,4,10,5,11,38,39,-1,35
Cliftonville,771,5,10,4,12,35,32,3,34
Ballymena,771,6,7,5,14,26,48,-22,26
Glentoran,771,7,6,6,10,24,32,-8,24
Dungannon,771,8,2,4,16,14,47,-33,10
Crusaders,772,1,16,7,3,61,30,31,55
Coleraine,772,2,15,10,1,45,22,23,55
Linfield,772,3,11,5,10,40,37,3,38
Glenavon,772,4,9,9,8,52,45,7,36
Cliftonville,772,5,9,4,13,33,34,-1,31
Ballymena,772,6,7,5,14,25,47,-22,26
Glentoran,772,7,6,6,10,24,32,-8,24
Dungannon,772,8,2,4,16,14,47,-33,10
Crusaders,773,1,16,7,3,62,31,31,55
Coleraine,773,2,14,10,2,43,25,18,52
Glenavon,773,3,10,9,7,55,43,12,39
Linfield,773,4,11,5,10,38,36,2,38
Cliftonville,773,5,9,4,13,32,32,0,31
Ballymena,773,6,7,5,14,26,48,-22,26
Glentoran,773,7,6,6,10,24,32,-8,24
Dungannon,773,8,2,4,16,14,47,-33,10
Crusaders,774,1,17,6,3,63,31,32,57
Coleraine,774,2,15,10,1,46,22,24,55
Glenavon,774,3,9,9,8,52,46,6,36
Linfield,774,4,10,5,11,38,38,0,35
Cliftonville,774,5,10,4,12,34,32,2,34
Ballymena,774,6,7,4,15,26,49,-23,25
Glentoran,774,7,6,6,10,24,32,-8,24
Dungannon,774,8,2,4,16,14,47,-33,10
Crusaders,775,1,17,6,3,63,31,32,57
Coleraine,775,2,15,10,1,46,23,23,55
Glenavon,775,3,9,9,8,53,46,7,36
Linfield,775,4,10,6,10,38,37,1,36
Cliftonville,775,5,9,5,12,33,32,1,32
Ballymena,775,6,7,4,15,26,49,-23,25
Glentoran,775,7,6,6,10,24,32,-8,24
Dungannon,775,8,2,4,16,14,47,-33,10
Crusaders,776,1,17,6,3,62,30,32,57
Coleraine,776,2,15,10,1,44,22,22,55
Glenavon,776,3,9,9,8,52,44,8,36
Linfield,776,4,10,6,10,40,39,1,36
Cliftonville,776,5,9,5,12,35,34,1,32
Ballymena,776,6,7,4,15,25,48,-23,25
Glentoran,776,7,6,6,10,24,32,-8,24
Dungannon,776,8,2,4,16,14,47,-33,10
Crusaders,777,1,17,6,3,64,31,33,57
Coleraine,777,2,14,10,2,44,26,18,52
Glenavon,777,3,10,9,7,56,44,12,39
Linfield,777,4,10,5,11,37,37,0,35
Cliftonville,777,5,10,4,12,33,31,2,34
Ballymena,777,6,7,4,15,26,50,-24,25
Glentoran,777,7,6,6,10,24,32,-8,24
Dungannon,777,8,2,4,16,14,47,-33,10
Crusaders,778,1,16,7,3,63,32,31,55
Coleraine,778,2,14,10,2,44,24,20,52
Glenavon,778,3,10,9,7,54,44,10,39
Linfield,778,4,11,5,10,38,36,2,38
Cliftonville,778,5,9,4,13,32,32,0,31
Ballymena,778,6,7,5,14,27,49,-22,26
Glentoran,778,7,6,6,10,24,32,-8,24
Dungannon,778,8,2,4,16,14,47,-33,10
Crusaders,779,1,16,7,3,65,34,31,55
Coleraine,779,2,14,11,1,44,23,21,53
Linfield,779,3,11,5,10,40,36,4,38
Glenavon,779,4,9,10,7,53,44,9,37
Cliftonville,779,5,9,4,13,32,34,-2,31
Ballymena,779,6,7,5,14,29,51,-22,26
Glentoran,779,7,6,6,10,24,32,-8,24
Dungannon,779,8,2,4,16,14,47,-33,10
Crusaders,780,1,16,7,3,62,31,31,55
Coleraine,780,2,14,10,2,45,25,20,52
Glenavon,780,3,10,9,7,55,45,10,39
Linfield,780,4,10,6,10,38,37,1,36
Cliftonville,780,5,9,5,12,33,32,1,32
Ballymena,780,6,7,5,14,26,48,-22,26
Glentoran,780,7,6,6,10,24,32,-8,24
Dungannon,780,8,2,4,16,14,47,-33,10
Crusaders,781,1,16,7,3,61,30,31,55
Coleraine,781,2,15,10,1,45,22,23,55
Linfield,781,3,11,5,10,39,37,2,38
Glenavon,781,4,9,9,8,52,45,7,36
Cliftonville,781,5,9,4,13,33,33,0,31
Ballymena,781,6,7,5,14,25,47,-22,26
Glentoran,781,7,6,6,10,24,32,-8,24
Dungannon,781,8,2,4,16,14,47,-33,10
Coleraine,782,1,15,10,1,46,22,24,55
Crusaders,782,2,16,6,4,62,33,29,54
Linfield,782,3,11,5,10,41,36,5,38
Glenavon,782,4,9,9,8,52,46,6,36
Cliftonville,782,5,9,4,13,32,35,-3,31
Ballymena,782,6,8,4,14,28,48,-20,28
Glentoran,782,7,6,6,10,24,32,-8,24
Dungannon,782,8,2,4,16,14,47,-33,10
Crusaders,783,1,16,7,3,62,31,31,55
Coleraine,783,2,15,10,1,45,23,22,55
Glenavon,783,3,9,9,8,53,45,8,36
Linfield,783,4,10,5,11,38,38,0,35
Cliftonville,783,5,10,4,12,34,32,2,34
Ballymena,783,6,7,5,14,26,48,-22,26
Glentoran,783,7,6,6,10,24,32,-8,24
Dungannon,783,8,2,4,16,14,47,-33,10
Crusaders,784,1,17,6,3,63,30,33,57
Coleraine,784,2,14,11,1,45,24,21,53
Glenavon,784,3,9,10,7,54,45,9,37
Linfield,784,4,10,5,11,37,37,0,35
Cliftonville,784,5,10,4,12,33,31,2,34
Ballymena,784,6,7,4,15,25,49,-24,25
Glentoran,784,7,6,6,10,24,32,-8,24
Dungannon,784,8,2,4,16,14,47,-33,10
Crusaders,785,1,16,6,4,61,31,30,54
Coleraine,785,2,14,10,2,44,24,20,52
Glenavon,785,3,10,9,7,54,44,10,39
Linfield,785,4,11,5,10,40,37,3,38
Cliftonville,785,5,9,4,13,33,34,-1,31
Ballymena,785,6,8,4,14,26,47,-21,28
Glentoran,785,7,6,6,10,24,32,-8,24
Dungannon,785,8,2,4,16,14,47,-33,10
Crusaders,786,1,17,6,3,62,30,32,57
Coleraine,786,2,14,11,1,44,23,21,53
Glenavon,786,3,9,10,7,53,44,9,37
Linfield,786,4,10,6,10,39,38,1,36
Cliftonville,786,5,9,5,12,34,33,1,32
Ballymena,786,6,7,4,15,25,48,-23,25
Glentoran,786,7,6,6,10,24,32,-8,24
Dungannon,786,8,2,4,16,14,47,-33,10
Crusaders,787,1,16,6,4,62,34,28,54
Coleraine,787,2,14,10,2,43,24,19,52
Glenavon,787,3,10,9,7,54,43,11,39
Linfield,787,4,10,6,10,38,37,1,36
Cliftonville,787,5,9,5,12,33,32,1,32
Ballymena,787,6,8,4,14,29,48,-19,28
Glentoran,787,7,6,6,10,24,32,-8,24
Dungannon,787,8,2,4,16,14,47,-33,10
Crusaders,788,1,16,7,3,62,31,31,55
Coleraine,788,2,15,10,1,44,22,22,55
Glenavon,788,3,9,9,8,52,44,8,36
Linfield,788,4,10,6,10,38,37,1,36
Cliftonville,788,5,9,5,12,33,32,1,32
Ballymena,788,6,7,5,14,26,48,-22,26
Glentoran,788,7,6,6,10,24,32,-8,24
Dungannon,788,8,2,4,16,14,47,-33,10
Crusaders,789,1,16,6,4,61,32,29,54
Coleraine,789,2,14,10,2,45,25,20,52
Glenavon,789,3,10,9,7,55,45,10,39
Linfield,789,4,11,5,10,39,37,2,38
Cliftonville,789,5,9,4,13,33,33,0,31
Ballymena,789,6,8,4,14,27,47,-20,28
Glentoran,789,7,6,6,10,24,32,-8,24
Dungannon,789,8,2,4,16,14,47,-33,10
Crusaders,790,1,16,6,4,61,34,27,54
Coleraine,790,2,14,11,1,44,23,21,53
Linfield,790,3,11,5,10,40,37,3,38
Glenavon,790,4,9,10,7,53,44,9,37
Cliftonville,790,5,9,4,13,33,34,-1,31
Ballymena,790,6,8,4,14,29,47,-18,28
Glentoran,790,7,6,6,10,24,32,-8,24
Dungannon,790,8,2,4,16,14,47,-33,10
Crusaders,791,1,16,6,4,61,32,29,54
Coleraine,791,2,14,10,2,44,25,19,52
Glenavon,791,3,10,9,7,55,44,11,39
Linfield,791,4,11,5,10,39,37,2,38
Cliftonville,791,5,9,4,13,33,33,0,31
Ballymena,791,6,8,4,14,27,47,-20,28
Glentoran,791,7,6,6,10,24,32,-8,24
Dungannon,791,8,2,4,16,14,47,-33,10
Crusaders,792,1,16,7,3,61,30,31,55
Coleraine,792,2,14,11,1,45,24,21,53
Glenavon,792,3,9,10,7,54,45,9,37
Linfield,792,4,10,5,11,37,38,-1,35
Cliftonville,792,5,10,4,12,34,31,3,34
Ballymena,792,6,7,5,14,25,47,-22,26
Glentoran,792,7,6,6,10,24,32,-8,24
Dungannon,792,8,2,4,16,14,47,-33,10
Crusaders,793,1,17,6,3,64,30,34,57
Coleraine,793,2,14,10,2,44,25,19,52
Glenavon,793,3,10,9,7,55,44,11,39
Linfield,793,4,10,6,10,37,36,1,36
Cliftonville,793,5,9,5,12,32,31,1,32
Ballymena,793,6,7,4,15,25,50,-25,25
Glentoran,793,7,6,6,10,24,32,-8,24
Dungannon,793,8,2,4,16,14,47,-33,10
Crusaders,794,1,17,6,3,64,31,33,57
Coleraine,794,2,14,10,2,43,23,20,52
Glenavon,794,3,10,9,7,53,43,10,39
Linfield,794,4,10,5,11,37,39,-2,35
Cliftonville,794,5,10,4,12,35,31,4,34
Ballymena,794,6,7,4,15,26,50,-24,25
Glentoran,794,7,6,6,10,24,32,-8,24
Dungannon,794,8,2,4,16,14,47,-33,10
Crusaders,795,1,16,7,3,62,31,31,55
Coleraine,795,2,14,10,2,43,24,19,52
Glenavon,795,3,10,9,7,54,43,11,39
Linfield,795,4,11,5,10,40,36,4,38
Cliftonville,795,5,9,4,13,32,34,-2,31
Ballymena,795,6,7,5,14,26,48,-22,26
Glentoran,795,7,6,6,10,24,32,-8,24
Dungannon,795,8,2,4,16,14,47,-33,10
Crusaders,796,1,17,6,3,64,30,34,57
Coleraine,796,2,14,10,2,43,23,20,52
Glenavon,796,3,10,9,7,53,43,10,39
Linfield,796,4,11,5,10,41,36,5,38
Cliftonville,796,5,9,4,13,32,35,-3,31
Ballymena,796,6,7,4,15,25,50,-25,25
Glentoran,796,7,6,6,10,24,32,-8,24
Dungannon,796,8,2,4,16,14,47,-33,10
Crusaders,797,1,17,6,3,63,31,32,57
Coleraine,797,2,15,10,1,46,23,23,55
Linfield,797,3,11,5,10,39,36,3,38
Glenavon,797,4,9,9,8,53,46,7,36
Cliftonville,797,5,9,4,13,32,33,-1,31
Ballymena,797,6,7,4,15,26,49,-23,25
Glentoran,797,7,6,6,10,24,32,-8,24
Dungannon,797,8,2,4,16,14,47,-33,10
Crusaders,798,1,17,6,3,63,31,32,57
Coleraine,798,2,14,10,2,43,23,20,52
Glenavon,798,3,10,9,7,53,43,10,39
Linfield,798,4,10,6,10,39,38,1,36
Cliftonville,798,5,9,5,12,34,33,1,32
Ballymena,798,6,7,4,15,26,49,-23,25
Glentoran,798,7,6,6,10,24,32,-8,24
Dungannon,798,8,2,4,16,14,47,-33,10
Crusaders,799,1,17,6,3,64,31,33,57
Coleraine,799,2,14,10,2,44,24,20,52
Glenavon,799,3,10,9,7,54,44,10,39
Linfield,799,4,11,5,10,40,38,2,38
Cliftonville,799,5,9,4,13,34,34,0,31
Ballymena,799,6,7,4,15,26,50,-24,25
Glentoran,799,7,6,6,10,24,32,-8,24
Dungannon,799,8,2,4,16,14,47,-33,10
Crusaders,800,1,17,6,3,62,30,32,57
Coleraine,800,2,14,10,2,44,27,17,52
Glenavon,800,3,10,9,7,57,44,13,39
Linfield,800,4,10,5,11,38,38,0,35
Cliftonville,800,5,10,4,12,34,32,2,34
Ballymena,800,6,7,4,15,25,48,-23,25
Glentoran,800,7,6,6,10,24,32,-8,24
Dungannon,800,8,2,4,16,14,47,-33,10
Crusaders,801,1,17,6,3,63,31,32,57
Coleraine,801,2,14,10,2,43,24,19,52
Glenavon,801,3,10,9,7,54,43,11,39
Linfield,801,4,10,6,10,39,38,1,36
Cliftonville,801,5,9,5,12,34,33,1,32
Ballymena,801,6,7,4,15,26,49,-23,25
Glentoran,801,7,6,6,10,24,32,-8,24
Dungannon,801,8,2,4,16,14,47,-33,10
Crusaders,802,1,17,6,3,62,30,32,57
Coleraine,802,2,14,11,1,45,24,21,53
Glenavon,802,3,9,10,7,54,45,9,37
Linfield,802,4,10,5,11,39,39,0,35
Cliftonville,802,5,10,4,12,35,33,2,34
Ballymena,802,6,7,4,15,25,48,-23,25
Glentoran,802,7,6,6,10,24,32,-8,24
Dungannon,802,8,2,4,16,14,47,-33,10
Crusaders,803,1,17,6,3,65,31,34,57
Coleraine,803,2,14,11,1,44,23,21,53
Linfield,803,3,11,5,10,38,36,2,38
Glenavon,803,4,9,10,7,53,44,9,37
Cliftonville,803,5,9,4,13,32,32,0,31
Ballymena,803,6,7,4,15,26,51,-25,25
Glentoran,803,7,6,6,10,24,32,-8,24
Dungannon,803,8,2,4,16,14,47,-33,10
Coleraine,804,1,15,10,1,45,23,22,55
Crusaders,804,2,16,6,4,61,31,30,54
Glenavon,804,3,9,9,8,53,45,8,36
Linfield,804,4,10,5,11,39,41,-2,35
Cliftonville,804,5,10,4,12,37,33,4,34
Ballymena,804,6,8,4,14,26,47,-21,28
Glentoran,804,7,6,6,10,24,32,-8,24
Dungannon,804,8,2,4,16,14,47,-33,10
Crusaders,805,1,17,6,3,63,31,32,57
Coleraine,805,2,14,10,2,43,23,20,52
Glenavon,805,3,10,9,7,53,43,10,39
Linfield,805,4,10,5,11,38,39,-1,35
Cliftonville,805,5,10,4,12,35,32,3,34
Ballymena,805,6,7,4,15,26,49,-23,25
Glentoran,805,7,6,6,10,24,32,-8,24
Dungannon,805,8,2,4,16,14,47,-33,10
Crusaders,806,1,17,6,3,64,31,33,57
Coleraine,806,2,14,10,2,43,23,20,52
Glenavon,806,3,10,9,7,53,43,10,39
Linfield,806,4,11,5,10,39,36,3,38
Cliftonville,806,5,9,4,13,32,33,-1,31
Ballymena,806,6,7,4,15,26,50,-24,25
Glentoran,806,7,6,6,10,24,32,-8,24
Dungannon,806,8,2,4,16,14,47,-33,10
Crusaders,807,1,17,6,3,64,32,32,57
Coleraine,807,2,14,10,2,44,25,19,52
Glenavon,807,3,10,9,7,55,44,11,39
Linfield,807,4,11,5,10,38,36,2,38
Cliftonville,807,5,9,4,13,32,32,0,31
Ballymena,807,6,7,4,15,27,50,-23,25
Glentoran,807,7,6,6,10,24,32,-8,24
Dungannon,807,8,2,4,16,14,47,-33,10
Crusaders,808,1,16,7,3,62,31,31,55
Coleraine,808,2,14,11,1,45,24,21,53
Glenavon,808,3,9,10,7,54,45,9,37
Linfield,808,4,10,6,10,37,36,1,36
Cliftonville,808,5,9,5,12,32,31,1,32
Ballymena,808,6,7,5,14,26,48,-22,26
Glentoran,808,7,6,6,10,24,32,-8,24
Dungannon,808,8,2,4,16,14,47,-33,10
Crusaders,809,1,16,7,3,61,30,31,55
Coleraine,809,2,15,10,1,45,23,22,55
Linfield,809,3,11,5,10,40,36,4,38
Glenavon,809,4,9,9,8,53,45,8,36
Cliftonville,809,5,9,4,13,32,34,-2,31
Ballymena,809,6,7,5,14,25,47,-22,26
Glentoran,809,7,6,6,10,24,32,-8,24
Dungannon,809,8,2,4,16,14,47,-33,10
Crusaders,810,1,17,6,3,62,30,32,57
Coleraine,810,2,14,10,2,44,26,18,52
Glenavon,810,3,10,9,7,56,44,12,39
Linfield,810,4,10,5,11,37,37,0,35
Cliftonville,810,5,10,4,12,33,31,2,34
Ballymena,810,6,7,4,15,25,48,-23,25
Glentoran,810,7,6,6,10,24,32,-8,24
Dungannon,810,8,2,4,16,14,47,-33,10
Crusaders,811,1,17,6,3,63,30,33,57
Coleraine,811,2,14,11,1,45,24,21,53
Glenavon,811,3,9,10,7,54,45,9,37
Linfield,811,4,10,5,11,39,39,0,35
Cliftonville,811,5,10,4,12,35,33,2,34
Ballymena,811,6,7,4,15,25,49,-24,25
Glentoran,811,7,6,6,10,24,32,-8,24
Dungannon,811,8,2,4,16,14,47,-33,10
Crusaders,812,1,16,7,3,62,31,31,55
Coleraine,812,2,15,10,1,44,22,22,55
Glenavon,812,3,9,9,8,52,44,8,36
Linfield,812,4,10,5,11,37,37,0,35
Cliftonville,812,5,10,4,12,33,31,2,34
Ballymena,812,6,7,5,14,26,48,-22,26
Glentoran,812,7,6,6,10,24,32,-8,24
Dungannon,812,8,2,4,16,14,47,-33,10
Crusaders,813,1,16,7,3,62,31,31,55
Coleraine,813,2,15,10,1,47,24,23,55
Linfield,813,3,11,5,10,40,37,3,38
Glenavon,813,4,9,9,8,54,47,7,36
Cliftonville,813,5,9,4,13,33,34,-1,31
Ballymena,813,6,7,5,14,26,48,-22,26
Glentoran,813,7,6,6,10,24,32,-8,24
Dungannon,813,8,2,4,16,14,47,-33,10
Crusaders,814,1,16,6,4,61,31,30,54
Coleraine,814,2,14,11,1,43,22,21,53
Glenavon,814,3,9,10,7,52,43,9,37
Linfield,814,4,10,5,11,37,38,-1,35
Cliftonville,814,5,10,4,12,34,31,3,34
Ballymena,814,6,8,4,14,26,47,-21,28
Glentoran,814,7,6,6,10,24,32,-8,24
Dungannon,814,8,2,4,16,14,47,-33,10
Crusaders,815,1,16,7,3,62,31,31,55
Coleraine,815,2,15,10,1,46,23,23,55
Linfield,815,3,11,5,10,39,37,2,38
Glenavon,815,4,9,9,8,53,46,7,36
Cliftonville,815,5,9,4,13,33,33,0,31
Ballymena,815,6,7,5,14,26,48,-22,26
Glentoran,815,7,6,6,10,24,32,-8,24
Dungannon,815,8,2,4,16,14,47,-33,10
Crusaders,816,1,17,6,3,64,30,34,57
Coleraine,816,2,14,11,1,43,22,21,53
Linfield,816,3,11,5,10,39,37,2,38
Glenavon,816,4,9,10,7,52,43,9,37
Cliftonville,816,5,9,4,13,33,33,0,31
Ballymena,816,6,7,4,15,25,50,-25,25
Glentoran,816,7,6,6,10,24,32,-8,24
Dungannon,816,8,2,4,16,14,47,-33,10
Crusaders,817,1,17,6,3,63,30,33,57
Coleraine,817,2,14,10,2,43,23,20,52
Glenavon,817,3,10,9,7,53,43,10,39
Linfield,817,4,10,6,10,38,37,1,36
Cliftonville,817,5,9,5,12,33,32,1,32
Ballymena,817,6,7,4,15,25,49,-24,25
Glentoran,817,7,6,6,10,24,32,-8,24
Dungannon,817,8,2,4,16,14,47,-33,10
Crusaders,818,1,17,6,3,65,33,32,57
Coleraine,818,2,14,10,2,44,25,19,52
Glenavon,818,3,10,9,7,55,44,11,39
Linfield,818,4,11,5,10,39,37,2,38
Cliftonville,818,5,9,4,13,33,33,0,31
Ballymena,818,6,7,4,15,28,51,-23,25
Glentoran,818,7,6,6,10,24,32,-8,24
Dungannon,818,8,2,4,16,14,47,-33,10
Crusaders,819,1,16,7,3,62,31,31,55
Coleraine,819,2,14,10,2,43,24,19,52
Glenavon,819,3,10,9,7,54,43,11,39
Linfield,819,4,10,6,10,39,38,1,36
Cliftonville,819,5,9,5,12,34,33,1,32
Ballymena,819,6,7,5,14,26,48,-22,26
Glentoran,819,7,6,6,10,24,32,-8,24
Dungannon,819,8,2,4,16,14,47,-33,10
Crusaders,820,1,16,7,3,62,31,31,55
Coleraine,820,2,14,10,2,43,28,15,52
Glenavon,820,3,10,9,7,58,43,15,39
Linfield,820,4,10,5,11,37,37,0,35
Cliftonville,820,5,10,4,12,33,31,2,34
Ballymena,820,6,7,5,14,26,48,-22,26
Glentoran,820,7,6,6,10,24,32,-8,24
Dungannon,820,8,2,4,16,14,47,-33,10
Crusaders,821,1,17,6,3,63,30,33,57
Coleraine,821,2,15,10,1,44,22,22,55
Glenavon,821,3,9,9,8,52,44,8,36
Linfield,821,4,10,5,11,37,37,0,35
Cliftonville,821,5,10,4,12,33,31,2,34
Ballymena,821,6,7,4,15,25,49,-24,25
Glentoran,821,7,6,6,10,24,32,-8,24
Dungannon,821,8,2,4,16,14,47,-33,10
Crusaders,822,1,17,6,3,64,31,33,57
Coleraine,822,2,14,11,1,45,24,21,53
Linfield,822,3,11,5,10,39,37,2,38
Glenavon,822,4,9,10,7,54,45,9,37
Cliftonville,822,5,9,4,13,33,33,0,31
Ballymena,822,6,7,4,15,26,50,-24,25
Glentoran,822,7,6,6,10,24,32,-8,24
Dungannon,822,8,2,4,16,14,47,-33,10
Crusaders,823,1,16,7,3,63,32,31,55
Coleraine,823,2,15,10,1,46,23,23,55
Linfield,823,3,11,5,10,39,36,3,38
Glenavon,823,4,9,9,8,53,46,7,36
Cliftonville,823,5,9,4,13,32,33,-1,31
Ballymena,823,6,7,5,14,27,49,-22,26
Glentoran,823,7,6,6,10,24,32,-8,24
Dungannon,823,8,2,4,16,14,47,-33,10
Crusaders,824,1,16,6,4,62,33,29,54
Coleraine,824,2,14,11,1,43,22,21,53
Glenavon,824,3,9,10,7,52,43,9,37
Linfield,824,4,10,6,10,38,37,1,36
Cliftonville,824,5,9,5,12,33,32,1,32
Ballymena,824,6,8,4,14,28,48,-20,28
Glentoran,824,7,6,6,10,24,32,-8,24
Dungannon,824,8,2,4,16,14,47,-33,10
Crusaders,825,1,16,6,4,62,33,29,54
Coleraine,825,2,14,11,1,44,23,21,53
Glenavon,825,3,9,10,7,53,44,9,37
Linfield,825,4,10,6,10,37,36,1,36
Cliftonville,825,5,9,5,12,32,31,1,32
Ballymena,825,6,8,4,14,28,48,-20,28
Glentoran,825,7,6,6,10,24,32,-8,24
Dungannon,825,8,2,4,16,14,47,-33,10
Crusaders,826,1,16,7,3,61,30,31,55
Coleraine,826,2,15,10,1,45,23,22,55
Glenavon,826,3,9,9,8,53,45,8,36
Linfield,826,4,10,6,10,38,37,1,36
Cliftonville,826,5,9,5,12,33,32,1,32
Ballymena,826,6,7,5,14,25,47,-22,26
Glentoran,826,7,6,6,10,24,32,-8,24
Dungannon,826,8,2,4,16,14,47,-33,10
Crusaders,827,1,16,7,3,62,31,31,55
Coleraine,827,2,14,11,1,44,23,21,53
Linfield,827,3,11,5,10,40,36,4,38
Glenavon,827,4,9,10,7,53,44,9,37
Cliftonville,827,5,9,4,13,32,34,-2,31
Ballymena,827,6,7,5,14,26,48,-22,26
Glentoran,827,7,6,6,10,24,32,-8,24
Dungannon,827,8,2,4,16,14,47,-33,10
Crusaders,828,1,16,6,4,62,32,30,54
Coleraine,828,2,14,11,1,44,23,21,53
Linfield,828,3,11,5,10,39,37,2,38
Glenavon,828,4,9,10,7,53,44,9,37
Cliftonville,828,5,9,4,13,33,33,0,31
Ballymena,828,6,8,4,14,27,48,-21,28
Glentoran,828,7,6,6,10,24,32,-8,24
Dungannon,828,8,2,4,16,14,47,-33,10
Crusaders,829,1,16,7,3,63,32,31,55
Coleraine,829,2,14,10,2,44,26,18,52
Glenavon,829,3,10,9,7,56,44,12,39
Linfield,829,4,10,5,11,37,37,0,35
Cliftonville,829,5,10,4,12,33,31,2,34
Ballymena,829,6,7,5,14,27,49,-22,26
Glentoran,829,7,6,6,10,24,32,-8,24
Dungannon,829,8,2,4,16,14,47,-33,10
Coleraine,830,1,15,10,1,47,23,24,55
Crusaders,830,2,16,6,4,62,34,28,54
Glenavon,830,3,9,9,8,53,47,6,36
Linfield,830,4,10,5,11,37,37,0,35
Cliftonville,830,5,10,4,12,33,31,2,34
Ballymena,830,6,8,4,14,29,48,-19,28
Glentoran,830,7,6,6,10,24,32,-8,24
Dungannon,830,8,2,4,16,14,47,-33,10
Crusaders,831,1,17,6,3,63,30,33,57
Coleraine,831,2,14,10,2,43,23,20,52
Glenavon,831,3,10,9,7,53,43,10,39
Linfield,831,4,10,5,11,39,39,0,35
Cliftonville,831,5,10,4,12,35,33,2,34
Ballymena,831,6,7,4,15,25,49,-24,25
Glentoran,831,7,6,6,10,24,32,-8,24
Dungannon,831,8,2,4,16,14,47,-33,10
Crusaders,832,1,17,6,3,62,30,32,57
Coleraine,832,2,14,10,2,46,26,20,52
Glenavon,832,3,10,9,7,56,46,10,39
Linfield,832,4,11,5,10,40,38,2,38
Cliftonville,832,5,9,4,13,34,34,0,31
Ballymena,832,6,7,4,15,25,48,-23,25
Glentoran,832,7,6,6,10,24,32,-8,24
Dungannon,832,8,2,4,16,14,47,-33,10
Crusaders,833,1,17,6,3,64,31,33,57
Coleraine,833,2,14,11,1,44,23,21,53
Linfield,833,3,11,5,10,43,37,6,38
Glenavon,833,4,9,10,7,53,44,9,37
Cliftonville,833,5,9,4,13,33,37,-4,31
Ballymena,833,6,7,4,15,26,50,-24,25
Glentoran,833,7,6,6,10,24,32,-8,24
Dungannon,833,8,2,4,16,14,47,-33,10
Crusaders,834,1,16,7,3,63,32,31,55
Coleraine,834,2,14,11,1,45,24,21,53
Glenavon,834,3,9,10,7,54,45,9,37
Linfield,834,4,10,5,11,37,37,0,35
Cliftonville,834,5,10,4,12,33,31,2,34
Ballymena,834,6,7,5,14,27,49,-22,26
Glentoran,834,7,6,6,10,24,32,-8,24
Dungannon,834,8,2,4,16,14,47,-33,10
Crusaders,835,1,16,6,4,62,33,29,54
Coleraine,835,2,14,10,2,44,24,20,52
Glenavon,835,3,10,9,7,54,44,10,39
Linfield,835,4,11,5,10,38,36,2,38
Cliftonville,835,5,9,4,13,32,32,0,31
Ballymena,835,6,8,4,14,28,48,-20,28
Glentoran,835,7,6,6,10,24,32,-8,24
Dungannon,835,8,2,4,16,14,47,-33,10
Crusaders,836,1,17,6,3,64,31,33,57
Coleraine,836,2,14,11,1,44,23,21,53
Linfield,836,3,11,5,10,40,38,2,38
Glenavon,836,4,9,10,7,53,44,9,37
Cliftonville,836,5,9,4,13,34,34,0,31
Ballymena,836,6,7,4,15,26,50,-24,25
Glentoran,836,7,6,6,10,24,32,-8,24
Dungannon,836,8,2,4,16,14,47,-33,10
Crusaders,837,1,16,7,3,62,31,31,55
Coleraine,837,2,14,10,2,44,24,20,52
Glenavon,837,3,10,9,7,54,44,10,39
Linfield,837,4,10,6,10,38,37,1,36
Cliftonville,837,5,9,5,12,33,32,1,32
Ballymena,837,6,7,5,14,26,48,-22,26
Glentoran,837,7,6,6,10,24,32,-8,24
Dungannon,837,8,2,4,16,14,47,-33,10
Crusaders,838,1,17,6,3,64,32,32,57
Coleraine,838,2,15,10,1,45,23,22,55
Glenavon,838,3,9,9,8,53,45,8,36
Linfield,838,4,10,5,11,37,38,-1,35
Cliftonville,838,5,10,4,12,34,31,3,34
Ballymena,838,6,7,4,15,27,50,-23,25
Glentoran,838,7,6,6,10,24,32,-8,24
Dungannon,838,8,2,4,16,14,47,-33,10
Crusaders,839,1,16,7,3,65,34,31,55
Coleraine,839,2,14,11,1,44,23,21,53
Glenavon,839,3,9,10,7,53,44,9,37
Linfield,839,4,10,5,11,38,38,0,35
Cliftonville,839,5,10,4,12,34,32,2,34
Ballymena,839,6,7,5,14,29,51,-22,26
Glentoran,839,7,6,6,10,24,32,-8,24
Dungannon,839,8,2,4,16,14,47,-33,10
Crusaders,840,1,17,6,3,66,30,36,57
Coleraine,840,2,15,10,1,45,23,22,55
Linfield,840,3,11,5,10,41,36,5,38
Glenavon,840,4,9,9,8,53,45,8,36
Cliftonville,840,5,9,4,13,32,35,-3,31
Ballymena,840,6,7,4,15,25,52,-27,25
Glentoran,840,7,6,6,10,24,32,-8,24
Dungannon,840,8,2,4,16,14,47,-33,10
Crusaders,841,1,16,6,4,61,31,30,54
Coleraine,841,2,14,10,2,43,23,20,52
Glenavon,841,3,10,9,7,53,43,10,39
Linfield,841,4,11,5,10,38,36,2,38
Cliftonville,841,5,9,4,13,32,32,0,31
Ballymena,841,6,8,4,14,26,47,-21,28
Glentoran,841,7,6,6,10,24,32,-8,24
Dungannon,841,8,2,4,16,14,47,-33,10
Crusaders,842,1,16,7,3,63,32,31,55
Coleraine,842,2,14,10,2,43,26,17,52
Glenavon,842,3,10,9,7,56,43,13,39
Linfield,842,4,10,5,11,38,38,0,35
Cliftonville,842,5,10,4,12,34,32,2,34
Ballymena,842,6,7,5,14,27,49,-22,26
Glentoran,842,7,6,6,10,24,32,-8,24
Dungannon,842,8,2,4,16,14,47,-33,10
Crusaders,843,1,17,6,3,63,30,33,57
Coleraine,843,2,14,11,1,46,25,21,53
Linfield,843,3,11,5,10,40,36,4,38
Glenavon,843,4,9,10,7,55,46,9,37
Cliftonville,843,5,9,4,13,32,34,-2,31
Ballymena,843,6,7,4,15,25,49,-24,25
Glentoran,843,7,6,6,10,24,32,-8,24
Dungannon,843,8,2,4,16,14,47,-33,10
Crusaders,844,1,17,6,3,63,30,33,57
Coleraine,844,2,14,10,2,43,23,20,52
Glenavon,844,3,10,9,7,53,43,10,39
Linfield,844,4,10,5,11,37,39,-2,35
Cliftonville,844,5,10,4,12,35,31,4,34
Ballymena,844,6,7,4,15,25,49,-24,25
Glentoran,844,7,6,6,10,24,32,-8,24
Dungannon,844,8,2,4,16,14,47,-33,10
Crusaders,845,1,17,6,3,62,30,32,57
Coleraine,845,2,14,10,2,45,26,19,52
Glenavon,845,3,10,9,7,56,45,11,39
Linfield,845,4,10,6,10,38,37,1,36
Cliftonville,845,5,9,5,12,33,32,1,32
Ballymena,845,6,7,4,15,25,48,-23,25
Glentoran,845,7,6,6,10,24,32,-8,24
Dungannon,845,8,2,4,16,14,47,-33,10
Crusaders,846,1,17,6,3,63,31,32,57
Coleraine,846,2,14,10,2,43,23,20,52
Glenavon,846,3,10,9,7,53,43,10,39
Linfield,846,4,10,5,11,37,38,-1,35
Cliftonville,846,5,10,4,12,34,31,3,34
Ballymena,846,6,7,4,15,26,49,-23,25
Glentoran,846,7,6,6,10,24,32,-8,24
Dungannon,846,8,2,4,16,14,47,-33,10
Crusaders,847,1,16,7,3,63,32,31,55
Coleraine,847,2,14,10,2,43,23,20,52
Glenavon,847,3,10,9,7,53,43,10,39
Linfield,847,4,11,5,10,41,36,5,38
Cliftonville,847,5,9,4,13,32,35,-3,31
Ballymena,847,6,7,5,14,27,49,-22,26
Glentoran,847,7,6,6,10,24,32,-8,24
Dungannon,847,8,2,4,16,14,47,-33,10
Crusaders,848,1,16,7,3,63,32,31,55
Coleraine,848,2,14,10,2,44,24,20,52
Glenavon,848,3,10,9,7,54,44,10,39
Linfield,848,4,10,5,11,37,39,-2,35
Cliftonville,848,5,10,4,12,35,31,4,34
Ballymena,848,6,7,5,14,27,49,-22,26
Glentoran,848,7,6,6,10,24,32,-8,24
Dungannon,848,8,2,4,16,14,47,-33,10
Crusaders,849,1,16,7,3,63,32,31,55
Coleraine,849,2,15,10,1,44,22,22,55
Glenavon,849,3,9,9,8,52,44,8,36
Linfield,849,4,10,5,11,37,38,-1,35
Cliftonville,849,5,10,4,12,34,31,3,34
Ballymena,849,6,7,5,14,27,49,-22,26
Glentoran,849,7,6,6,10,24,32,-8,24
Dungannon,849,8,2,4,16,14,47,-33,10
Crusaders,850,1,17,6,3,64,32,32,57
Coleraine,850,2,15,10,1,46,24,22,55
Linfield,850,3,11,5,10,39,36,3,38
Glenavon,850,4,9,9,8,54,46,8,36
Cliftonville,850,5,9,4,13,32,33,-1,31
Ballymena,850,6,7,4,15,27,50,-23,25
Glentoran,850,7,6,6,10,24,32,-8,24
Dungannon,850,8,2,4,16,14,47,-33,10
Crusaders,851,1,16,7,3,63,32,31,55
Coleraine,851,2,14,11,1,44,23,21,53
Linfield,851,3,11,5,10,38,36,2,38
Glenavon,851,4,9,10,7,53,44,9,37
Cliftonville,851,5,9,4,13,32,32,0,31
Ballymena,851,6,7,5,14,27,49,-22,26
Glentoran,851,7,6,6,10,24,32,-8,24
Dungannon,851,8,2,4,16,14,47,-33,10
Crusaders,852,1,16,6,4,62,32,30,54
Coleraine,852,2,14,11,1,45,24,21,53
Linfield,852,3,11,5,10,39,36,3,38
Glenavon,852,4,9,10,7,54,45,9,37
Cliftonville,852,5,9,4,13,32,33,-1,31
Ballymena,852,6,8,4,14,27,48,-21,28
Glentoran,852,7,6,6,10,24,32,-8,24
Dungannon,852,8,2,4,16,14,47,-33,10
Coleraine,853,1,15,10,1,46,23,23,55
Crusaders,853,2,16,6,4,63,33,30,54
Linfield,853,3,11,5,10,39,36,3,38
Glenavon,853,4,9,9,8,53,46,7,36
Cliftonville,853,5,9,4,13,32,33,-1,31
Ballymena,853,6,8,4,14,28,49,-21,28
Glentoran,853,7,6,6,10,24,32,-8,24
Dungannon,853,8,2,4,16,14,47,-33,10
Crusaders,854,1,17,6,3,62,30,32,57
Coleraine,854,2,14,11,1,44,23,21,53
Linfield,854,3,11,5,10,39,36,3,38
Glenavon,854,4,9,10,7,53,44,9,37
Cliftonville,854,5,9,4,13,32,33,-1,31
Ballymena,854,6,7,4,15,25,48,-23,25
Glentoran,854,7,6,6,10,24,32,-8,24
Dungannon,854,8,2,4,16,14,47,-33,10
Coleraine,855,1,15,10,1,45,23,22,55
Crusaders,855,2,16,6,4,63,33,30,54
Linfield,855,3,11,5,10,39,37,2,38
Glenavon,855,4,9,9,8,53,45,8,36
Cliftonville,855,5,9,4,13,33,33,0,31
Ballymena,855,6,8,4,14,28,49,-21,28
Glentoran,855,7,6,6,10,24,32,-8,24
Dungannon,855,8,2,4,16,14,47,-33,10
Crusaders,856,1,17,6,3,63,30,33,57
Coleraine,856,2,14,10,2,43,24,19,52
Glenavon,856,3,10,9,7,54,43,11,39
Linfield,856,4,11,5,10,39,36,3,38
Cliftonville,856,5,9,4,13,32,33,-1,31
Ballymena,856,6,7,4,15,25,49,-24,25
Glentoran,856,7,6,6,10,24,32,-8,24
Dungannon,856,8,2,4,16,14,47,-33,10
Crusaders,857,1,16,6,4,61,31,30,54
Coleraine,857,2,14,10,2,44,25,19,52
Glenavon,857,3,10,9,7,55,44,11,39
Linfield,857,4,10,5,11,37,38,-1,35
Cliftonville,857,5,10,4,12,34,31,3,34
Ballymena,857,6,8,4,14,26,47,-21,28
Glentoran,857,7,6,6,10,24,32,-8,24
Dungannon,857,8,2,4,16,14,47,-33,10
Crusaders,858,1,17,6,3,63,31,32,57
Coleraine,858,2,15,10,1,45,23,22,55
Linfield,858,3,11,5,10,38,36,2,38
Glenavon,858,4,9,9,8,53,45,8,36
Cliftonville,858,5,9,4,13,32,32,0,31
Ballymena,858,6,7,4,15,26,49,-23,25
Glentoran,858,7,6,6,10,24,32,-8,24
Dungannon,858,8,2,4,16,14,47,-33,10
Crusaders,859,1,17,6,3,63,30,33,57
Coleraine,859,2,14,10,2,45,25,20,52
Glenavon,859,3,10,9,7,55,45,10,39
Linfield,859,4,11,5,10,39,36,3,38
Cliftonville,859,5,9,4,13,32,33,-1,31
Ballymena,859,6,7,4,15,25,49,-24,25
Glentoran,859,7,6,6,10,24,32,-8,24
Dungannon,859,8,2,4,16,14,47,-33,10
Crusaders,860,1,17,6,3,64,32,32,57
Coleraine,860,2,14,11,1,44,23,21,53
Glenavon,860,3,9,10,7,53,44,9,37
Linfield,860,4,10,6,10,39,38,1,36
Cliftonville,860,5,9,5,12,34,33,1,32
Ballymena,860,6,7,4,15,27,50,-23,25
Glentoran,860,7,6,6,10,24,32,-8,24
Dungannon,860,8,2,4,16,14,47,-33,10
Crusaders,861,1,16,7,3,63,32,31,55
Coleraine,861,2,14,10,2,45,26,19,52
Glenavon,861,3,10,9,7,56,45,11,39
Linfield,861,4,10,6,10,37,36,1,36
Cliftonville,861,5,9,5,12,32,31,1,32
Ballymena,861,6,7,5,14,27,49,-22,26
Glentoran,861,7,6,6,10,24,32,-8,24
Dungannon,861,8,2,4,16,14,47,-33,10
Crusaders,862,1,16,7,3,61,30,31,55
Coleraine,862,2,14,11,1,45,24,21,53
Linfield,862,3,11,5,10,38,36,2,38
Glenavon,862,4,9,10,7,54,45,9,37
Cliftonville,862,5,9,4,13,32,32,0,31
Ballymena,862,6,7,5,14,25,47,-22,26
Glentoran,862,7,6,6,10,24,32,-8,24
Dungannon,862,8,2,4,16,14,47,-33,10
Crusaders,863,1,16,7,3,63,32,31,55
Coleraine,863,2,15,10,1,47,22,25,55
Linfield,863,3,11,5,10,40,38,2,38
Glenavon,863,4,9,9,8,52,47,5,36
Cliftonville,863,5,9,4,13,34,34,0,31
Ballymena,863,6,7,5,14,27,49,-22,26
Glentoran,863,7,6,6,10,24,32,-8,24
Dungannon,863,8,2,4,16,14,47,-33,10
Crusaders,864,1,17,6,3,64,31,33,57
Coleraine,864,2,15,10,1,46,24,22,55
Glenavon,864,3,9,9,8,54,46,8,36
Linfield,864,4,10,6,10,38,37,1,36
Cliftonville,864,5,9,5,12,33,32,1,32
Ballymena,864,6,7,4,15,26,50,-24,25
Glentoran,864,7,6,6,10,24,32,-8,24
Dungannon,864,8,2,4,16,14,47,-33,10
Crusaders,865,1,17,6,3,64,32,32,57
Coleraine,865,2,14,10,2,43,24,19,52
Glenavon,865,3,10,9,7,54,43,11,39
Linfield,865,4,10,5,11,37,37,0,35
Cliftonville,865,5,10,4,12,33,31,2,34
Ballymena,865,6,7,4,15,27,50,-23,25
Glentoran,865,7,6,6,10,24,32,-8,24
Dungannon,865,8,2,4,16,14,47,-33,10
Crusaders,866,1,17,6,3,63,30,33,57
Coleraine,866,2,14,11,1,45,24,21,53
Glenavon,866,3,9,10,7,54,45,9,37
Linfield,866,4,10,6,10,38,37,1,36
Cliftonville,866,5,9,5,12,33,32,1,32
Ballymena,866,6,7,4,15,25,49,-24,25
Glentoran,866,7,6,6,10,24,32,-8,24
Dungannon,866,8,2,4,16,14,47,-33,10
Crusaders,867,1,16,6,4,62,32,30,54
Coleraine,867,2,14,10,2,46,27,19,52
Glenavon,867,3,10,9,7,57,46,11,39
Linfield,867,4,11,5,10,43,37,6,38
Cliftonville,867,5,9,4,13,33,37,-4,31
Ballymena,867,6,8,4,14,27,48,-21,28
Glentoran,867,7,6,6,10,24,32,-8,24
Dungannon,867,8,2,4,16,14,47,-33,10
Crusaders,868,1,17,6,3,64,31,33,57
Coleraine,868,2,15,10,1,45,22,23,55
Linfield,868,3,11,5,10,39,37,2,38
Glenavon,868,4,9,9,8,52,45,7,36
Cliftonville,868,5,9,4,13,33,33,0,31
Ballymena,868,6,7,4,15,26,50,-24,25
Glentoran,868,7,6,6,10,24,32,-8,24
Dungannon,868,8,2,4,16,14,47,-33,10
Crusaders,869,1,17,6,3,63,31,32,57
Coleraine,869,2,15,10,1,46,22,24,55
Glenavon,869,3,9,9,8,52,46,6,36
Linfield,869,4,10,5,11,37,37,0,35
Cliftonville,869,5,10,4,12,33,31,2,34
Ballymena,869,6,7,4,15,26,49,-23,25
Glentoran,869,7,6,6,10,24,32,-8,24
Dungannon,869,8,2,4,16,14,47,-33,10
Crusaders,870,1,17,6,3,67,30,37,57
Coleraine,870,2,14,10,2,43,26,17,52
Glenavon,870,3,10,9,7,56,43,13,39
Linfield,870,4,11,5,10,42,37,5,38
Cliftonville,870,5,9,4,13,33,36,-3,31
Ballymena,870,6,7,4,15,25,53,-28,25
Glentoran,870,7,6,6,10,24,32,-8,24
Dungannon,870,8,2,4,16,14,47,-33,10
Coleraine,871,1,15,10,1,46,24,22,55
Crusaders,871,2,16,6,4,62,32,30,54
Glenavon,871,3,9,9,8,54,46,8,36
Linfield,871,4,10,5,11,38,38,0,35
Cliftonville,871,5,10,4,12,34,32,2,34
Ballymena,871,6,8,4,14,27,48,-21,28
Glentoran,871,7,6,6,10,24,32,-8,24
Dungannon,871,8,2,4,16,14,47,-33,10
Crusaders,872,1,17,6,3,63,30,33,57
Coleraine,872,2,14,10,2,43,25,18,52
Glenavon,872,3,10,9,7,55,43,12,39
Linfield,872,4,10,5,11,38,39,-1,35
Cliftonville,872,5,10,4,12,35,32,3,34
Ballymena,872,6,7,4,15,25,49,-24,25
Glentoran,872,7,6,6,10,24,32,-8,24
Dungannon,872,8,2,4,16,14,47,-33,10
Crusaders,873,1,16,7,3,63,32,31,55
Coleraine,873,2,14,11,1,45,24,21,53
Linfield,873,3,11,5,10,39,37,2,38
Glenavon,873,4,9,10,7,54,45,9,37
Cliftonville,873,5,9,4,13,33,33,0,31
Ballymena,873,6,7,5,14,27,49,-22,26
Glentoran,873,7,6,6,10,24,32,-8,24
Dungannon,873,8,2,4,16,14,47,-33,10
Crusaders,874,1,16,7,3,62,31,31,55
Coleraine,874,2,15,10,1,46,22,24,55
Glenavon,874,3,9,9,8,52,46,6,36
Linfield,874,4,10,6,10,38,37,1,36
Cliftonville,874,5,9,5,12,33,32,1,32
Ballymena,874,6,7,5,14,26,48,-22,26
Glentoran,874,7,6,6,10,24,32,-8,24
Dungannon,874,8,2,4,16,14,47,-33,10
Crusaders,875,1,17,6,3,62,30,32,57
Coleraine,875,2,14,10,2,43,23,20,52
Glenavon,875,3,10,9,7,53,43,10,39
Linfield,875,4,11,5,10,40,38,2,38
Cliftonville,875,5,9,4,13,34,34,0,31
Ballymena,875,6,7,4,15,25,48,-23,25
Glentoran,875,7,6,6,10,24,32,-8,24
Dungannon,875,8,2,4,16,14,47,-33,10
Crusaders,876,1,17,6,3,66,31,35,57
Coleraine,876,2,14,10,2,43,23,20,52
Glenavon,876,3,10,9,7,53,43,10,39
Linfield,876,4,10,5,11,37,37,0,35
Cliftonville,876,5,10,4,12,33,31,2,34
Ballymena,876,6,7,4,15,26,52,-26,25
Glentoran,876,7,6,6,10,24,32,-8,24
Dungannon,876,8,2,4,16,14,47,-33,10
Crusaders,877,1,16,6,4,64,34,30,54
Coleraine,877,2,14,10,2,43,23,20,52
Glenavon,877,3,10,9,7,53,43,10,39
Linfield,877,4,11,5,10,38,36,2,38
Cliftonville,877,5,9,4,13,32,32,0,31
Ballymena,877,6,8,4,14,29,50,-21,28
Glentoran,877,7,6,6,10,24,32,-8,24
Dungannon,877,8,2,4,16,14,47,-33,10
Crusaders,878,1,17,6,3,63,31,32,57
Coleraine,878,2,14,10,2,44,25,19,52
Glenavon,878,3,10,9,7,55,44,11,39
Linfield,878,4,11,5,10,38,36,2,38
Cliftonville,878,5,9,4,13,32,32,0,31
Ballymena,878,6,7,4,15,26,49,-23,25
Glentoran,878,7,6,6,10,24,32,-8,24
Dungannon,878,8,2,4,16,14,47,-33,10
Crusaders,879,1,16,7,3,62,31,31,55
Coleraine,879,2,15,10,1,46,23,23,55
Glenavon,879,3,9,9,8,53,46,7,36
Linfield,879,4,10,5,11,39,39,0,35
Cliftonville,879,5,10,4,12,35,33,2,34
Ballymena,879,6,7,5,14,26,48,-22,26
Glentoran,879,7,6,6,10,24,32,-8,24
Dungannon,879,8,2,4,16,14,47,-33,10
Crusaders,880,1,16,7,3,63,32,31,55
Coleraine,880,2,15,10,1,46,22,24,55
Linfield,880,3,11,5,10,39,37,2,38
Glenavon,880,4,9,9,8,52,46,6,36
Cliftonville,880,5,9,4,13,33,33,0,31
Ballymena,880,6,7,5,14,27,49,-22,26
Glentoran,880,7,6,6,10,24,32,-8,24
Dungannon,880,8,2,4,16,14,47,-33,10
Crusaders,881,1,17,6,3,65,30,35,57
Coleraine,881,2,14,11,1,43,22,21,53
Glenavon,881,3,9,10,7,52,43,9,37
Linfield,881,4,10,6,10,38,37,1,36
Cliftonville,881,5,9,5,12,33,32,1,32
Ballymena,881,6,7,4,15,25,51,-26,25
Glentoran,881,7,6,6,10,24,32,-8,24
Dungannon,881,8,2,4,16,14,47,-33,10
Crusaders,882,1,17,6,3,64,31,33,57
Coleraine,882,2,14,10,2,43,24,19,52
Glenavon,882,3,10,9,7,54,43,11,39
Linfield,882,4,11,5,10,39,37,2,38
Cliftonville,882,5,9,4,13,33,33,0,31
Ballymena,882,6,7,4,15,26,50,-24,25
Glentoran,882,7,6,6,10,24,32,-8,24
Dungannon,882,8,2,4,16,14,47,-33,10
Coleraine,883,1,15,10,1,44,22,22,55
Crusaders,883,2,16,6,4,61,33,28,54
Glenavon,883,3,9,9,8,52,44,8,36
Linfield,883,4,10,5,11,37,37,0,35
Cliftonville,883,5,10,4,12,33,31,2,34
Ballymena,883,6,8,4,14,28,47,-19,28
Glentoran,883,7,6,6,10,24,32,-8,24
Dungannon,883,8,2,4,16,14,47,-33,10
Crusaders,884,1,17,6,3,62,30,32,57
Coleraine,884,2,15,10,1,47,24,23,55
Glenavon,884,3,9,9,8,54,47,7,36
Linfield,884,4,10,5,11,38,39,-1,35
Cliftonville,884,5,10,4,12,35,32,3,34
Ballymena,884,6,7,4,15,25,48,-23,25
Glentoran,884,7,6,6,10,24,32,-8,24
Dungannon,884,8,2,4,16,14,47,-33,10
Crusaders,885,1,17,6,3,62,30,32,57
Coleraine,885,2,14,10,2,43,23,20,52
Glenavon,885,3,10,9,7,53,43,10,39
Linfield,885,4,10,6,10,37,36,1,36
Cliftonville,885,5,9,5,12,32,31,1,32
Ballymena,885,6,7,4,15,25,48,-23,25
Glentoran,885,7,6,6,10,24,32,-8,24
Dungannon,885,8,2,4,16,14,47,-33,10
Crusaders,886,1,16,7,3,61,30,31,55
Coleraine,886,2,15,10,1,47,24,23,55
Glenavon,886,3,9,9,8,54,47,7,36
Linfield,886,4,10,5,11,38,38,0,35
Cliftonville,886,5,10,4,12,34,32,2,34
Ballymena,886,6,7,5,14,25,47,-22,26
Glentoran,886,7,6,6,10,24,32,-8,24
Dungannon,886,8,2,4,16,14,47,-33,10
Crusaders,887,1,17,6,3,64,30,34,57
Coleraine,887,2,15,10,1,49,24,25,55
Linfield,887,3,11,5,10,38,36,2,38
Glenavon,887,4,9,9,8,54,49,5,36
Cliftonville,887,5,9,4,13,32,32,0,31
Ballymena,887,6,7,4,15,25,50,-25,25
Glentoran,887,7,6,6,10,24,32,-8,24
Dungannon,887,8,2,4,16,14,47,-33,10
Crusaders,888,1,16,6,4,63,33,30,54
Coleraine,888,2,14,10,2,43,23,20,52
Glenavon,888,3,10,9,7,53,43,10,39
Linfield,888,4,11,5,10,38,36,2,38
Cliftonville,888,5,9,4,13,32,32,0,31
Ballymena,888,6,8,4,14,28,49,-21,28
Glentoran,888,7,6,6,10,24,32,-8,24
Dungannon,888,8,2,4,16,14,47,-33,10
Crusaders,889,1,17,6,3,65,30,35,57
Coleraine,889,2,14,11,1,45,24,21,53
Glenavon,889,3,9,10,7,54,45,9,37
Linfield,889,4,10,5,11,37,37,0,35
Cliftonville,889,5,10,4,12,33,31,2,34
Ballymena,889,6,7,4,15,25,51,-26,25
Glentoran,889,7,6,6,10,24,32,-8,24
Dungannon,889,8,2,4,16,14,47,-33,10
Crusaders,890,1,17,6,3,63,30,33,57
Coleraine,890,2,14,10,2,45,25,20,52
Glenavon,890,3,10,9,7,55,45,10,39
Linfield,890,4,10,6,10,37,36,1,36
Cliftonville,890,5,9,5,12,32,31,1,32
Ballymena,890,6,7,4,15,25,49,-24,25
Glentoran,890,7,6,6,10,24,32,-8,24
Dungannon,890,8,2,4,16,14,47,-33,10
Crusaders,891,1,17,6,3,63,30,33,57
Coleraine,891,2,14,10,2,44,25,19,52
Glenavon,891,3,10,9,7,55,44,11,39
Linfield,891,4,11,5,10,38,36,2,38
Cliftonville,891,5,9,4,13,32,32,0,31
Ballymena,891,6,7,4,15,25,49,-24,25
Glentoran,891,7,6,6,10,24,32,-8,24
Dungannon,891,8,2,4,16,14,47,-33,10
Crusaders,892,1,17,6,3,63,30,33,57
Coleraine,892,2,14,10,2,43,24,19,52
Glenavon,892,3,10,9,7,54,43,11,39
Linfield,892,4,11,5,10,40,37,3,38
Cliftonville,892,5,9,4,13,33,34,-1,31
Ballymena,892,6,7,4,15,25,49,-24,25
Glentoran,892,7,6,6,10,24,32,-8,24
Dungannon,892,8,2,4,16,14,47,-33,10
Crusaders,893,1,16,6,4,62,32,30,54
Coleraine,893,2,14,11,1,43,22,21,53
Glenavon,893,3,9,10,7,52,43,9,37
Linfield,893,4,10,5,11,37,37,0,35
Cliftonville,893,5,10,4,12,33,31,2,34
Ballymena,893,6,8,4,14,27,48,-21,28
Glentoran,893,7,6,6,10,24,32,-8,24
Dungannon,893,8,2,4,16,14,47,-33,10
Crusaders,894,1,17,6,3,64,32,32,57
Coleraine,894,2,14,11,1,44,23,21,53
Linfield,894,3,11,5,10,38,36,2,38
Glenavon,894,4,9,10,7,53,44,9,37
Cliftonville,894,5,9,4,13,32,32,0,31
Ballymena,894,6,7,4,15,27,50,-23,25
Glentoran,894,7,6,6,10,24,32,-8,24
Dungannon,894,8,2,4,16,14,47,-33,10
Crusaders,895,1,16,7,3,64,33,31,55
Coleraine,895,2,15,10,1,47,23,24,55
Glenavon,895,3,9,9,8,53,47,6,36
Linfield,895,4,10,6,10,38,37,1,36
Cliftonville,895,5,9,5,12,33,32,1,32
Ballymena,895,6,7,5,14,28,50,-22,26
Glentoran,895,7,6,6,10,24,32,-8,24
Dungannon,895,8,2,4,16,14,47,-33,10
Coleraine,896,1,15,10,1,48,23,25,55
Crusaders,896,2,16,6,4,61,32,29,54
Glenavon,896,3,9,9,8,53,48,5,36
Linfield,896,4,10,6,10,38,37,1,36
Cliftonville,896,5,9,5,12,33,32,1,32
Ballymena,896,6,8,4,14,27,47,-20,28
Glentoran,896,7,6,6,10,24,32,-8,24
Dungannon,896,8,2,4,16,14,47,-33,10
Crusaders,897,1,17,6,3,66,30,36,57
Coleraine,897,2,14,10,2,44,24,20,52
Glenavon,897,3,10,9,7,54,44,10,39
Linfield,897,4,10,5,11,37,38,-1,35
Cliftonville,897,5,10,4,12,34,31,3,34
Ballymena,897,6,7,4,15,25,52,-27,25
Glentoran,897,7,6,6,10,24,32,-8,24
Dungannon,897,8,2,4,16,14,47,-33,10
Crusaders,898,1,17,6,3,64,30,34,57
Coleraine,898,2,14,10,2,45,26,19,52
Glenavon,898,3,10,9,7,56,45,11,39
Linfield,898,4,11,5,10,38,36,2,38
Cliftonville,898,5,9,4,13,32,32,0,31
Ballymena,898,6,7,4,15,25,50,-25,25
Glentoran,898,7,6,6,10,24,32,-8,24
Dungannon,898,8,2,4,16,14,47,-33,10
Crusaders,899,1,16,7,3,62,31,31,55
Coleraine,899,2,15,10,1,45,23,22,55
Linfield,899,3,11,5,10,43,36,7,38
Glenavon,899,4,9,9,8,53,45,8,36
Cliftonville,899,5,9,4,13,32,37,-5,31
Ballymena,899,6,7,5,14,26,48,-22,26
Glentoran,899,7,6,6,10,24,32,-8,24
Dungannon,899,8,2,4,16,14,47,-33,10
Crusaders,900,1,17,6,3,63,31,32,57
Coleraine,900,2,15,10,1,46,24,22,55
Glenavon,900,3,9,9,8,54,46,8,36
Linfield,900,4,10,6,10,37,36,1,36
Cliftonville,900,5,9,5,12,32,31,1,32
Ballymena,900,6,7,4,15,26,49,-23,25
Glentoran,900,7,6,6,10,24,32,-8,24
Dungannon,900,8,2,4,16,14,47,-33,10
Crusaders,901,1,17,6,3,63,30,33,57
Coleraine,901,2,15,10,1,46,24,22,55
Glenavon,901,3,9,9,8,54,46,8,36
Linfield,901,4,10,6,10,39,38,1,36
Cliftonville,901,5,9,5,12,34,33,1,32
Ballymena,901,6,7,4,15,25,49,-24,25
Glentoran,901,7,6,6,10,24,32,-8,24
Dungannon,901,8,2,4,16,14,47,-33,10
Crusaders,902,1,17,6,3,63,30,33,57
Coleraine,902,2,14,10,2,45,25,20,52
Glenavon,902,3,10,9,7,55,45,10,39
Linfield,902,4,10,5,11,38,39,-1,35
Cliftonville,902,5,10,4,12,35,32,3,34
Ballymena,902,6,7,4,15,25,49,-24,25
Glentoran,902,7,6,6,10,24,32,-8,24
Dungannon,902,8,2,4,16,14,47,-33,10
Crusaders,903,1,16,7,3,62,31,31,55
Coleraine,903,2,14,10,2,43,26,17,52
Glenavon,903,3,10,9,7,56,43,13,39
Linfield,903,4,10,6,10,37,36,1,36
Cliftonville,903,5,9,5,12,32,31,1,32
Ballymena,903,6,7,5,14,26,48,-22,26
Glentoran,903,7,6,6,10,24,32,-8,24
Dungannon,903,8,2,4,16,14,47,-33,10
Crusaders,904,1,17,6,3,63,31,32,57
Coleraine,904,2,14,10,2,43,23,20,52
Glenavon,904,3,10,9,7,53,43,10,39
Linfield,904,4,10,5,11,37,37,0,35
Cliftonville,904,5,10,4,12,33,31,2,34
Ballymena,904,6,7,4,15,26,49,-23,25
Glentoran,904,7,6,6,10,24,32,-8,24
Dungannon,904,8,2,4,16,14,47,-33,10
Crusaders,905,1,17,6,3,64,30,34,57
Coleraine,905,2,14,10,2,43,23,20,52
Glenavon,905,3,10,9,7,53,43,10,39
Linfield,905,4,11,5,10,39,36,3,38
Cliftonville,905,5,9,4,13,32,33,-1,31
Ballymena,905,6,7,4,15,25,50,-25,25
Glentoran,905,7,6,6,10,24,32,-8,24
Dungannon,905,8,2,4,16,14,47,-33,10
Crusaders,906,1,16,7,3,63,32,31,55
Coleraine,906,2,14,11,1,44,23,21,53
Glenavon,906,3,9,10,7,53,44,9,37
Linfield,906,4,10,5,11,38,38,0,35
Cliftonville,906,5,10,4,12,34,32,2,34
Ballymena,906,6,7,5,14,27,49,-22,26
Glentoran,906,7,6,6,10,24,32,-8,24
Dungannon,906,8,2,4,16,14,47,-33,10
Coleraine,907,1,15,10,1,46,24,22,55
Crusaders,907,2,16,6,4,62,32,30,54
Glenavon,907,3,9,9,8,54,46,8,36
Linfield,907,4,10,5,11,38,38,0,35
Cliftonville,907,5,10,4,12,34,32,2,34
Ballymena,907,6,8,4,14,27,48,-21,28
Glentoran,907,7,6,6,10,24,32,-8,24
Dungannon,907,8,2,4,16,14,47,-33,10
Crusaders,908,1,17,6,3,65,33,32,57
Coleraine,908,2,14,11,1,46,25,21,53
Glenavon,908,3,9,10,7,55,46,9,37
Linfield,908,4,10,6,10,40,39,1,36
Cliftonville,908,5,9,5,12,35,34,1,32
Ballymena,908,6,7,4,15,28,51,-23,25
Glentoran,908,7,6,6,10,24,32,-8,24
Dungannon,908,8,2,4,16,14,47,-33,10
Crusaders,909,1,17,6,3,63,31,32,57
Coleraine,909,2,15,10,1,45,23,22,55
Linfield,909,3,11,5,10,39,36,3,38
Glenavon,909,4,9,9,8,53,45,8,36
Cliftonville,909,5,9,4,13,32,33,-1,31
Ballymena,909,6,7,4,15,26,49,-23,25
Glentoran,909,7,6,6,10,24,32,-8,24
Dungannon,909,8,2,4,16,14,47,-33,10
Crusaders,910,1,17,6,3,65,33,32,57
Coleraine,910,2,14,11,1,45,24,21,53
Glenavon,910,3,9,10,7,54,45,9,37
Linfield,910,4,10,5,11,38,39,-1,35
Cliftonville,910,5,10,4,12,35,32,3,34
Ballymena,910,6,7,4,15,28,51,-23,25
Glentoran,910,7,6,6,10,24,32,-8,24
Dungannon,910,8,2,4,16,14,47,-33,10
Coleraine,911,1,15,10,1,46,22,24,55
Crusaders,911,2,16,6,4,61,31,30,54
Glenavon,911,3,9,9,8,52,46,6,36
Linfield,911,4,10,6,10,38,37,1,36
Cliftonville,911,5,9,5,12,33,32,1,32
Ballymena,911,6,8,4,14,26,47,-21,28
Glentoran,911,7,6,6,10,24,32,-8,24
Dungannon,911,8,2,4,16,14,47,-33,10
Crusaders,912,1,16,6,4,62,35,27,54
Coleraine,912,2,14,10,2,44,24,20,52
Glenavon,912,3,10,9,7,54,44,10,39
Linfield,912,4,10,5,11,37,39,-2,35
Cliftonville,912,5,10,4,12,35,31,4,34
Ballymena,912,6,8,4,14,30,48,-18,28
Glentoran,912,7,6,6,10,24,32,-8,24
Dungannon,912,8,2,4,16,14,47,-33,10
Crusaders,913,1,17,6,3,64,31,33,57
Coleraine,913,2,14,10,2,45,25,20,52
Glenavon,913,3,10,9,7,55,45,10,39
Linfield,913,4,10,5,11,38,38,0,35
Cliftonville,913,5,10,4,12,34,32,2,34
Ballymena,913,6,7,4,15,26,50,-24,25
Glentoran,913,7,6,6,10,24,32,-8,24
Dungannon,913,8,2,4,16,14,47,-33,10
Coleraine,914,1,15,10,1,45,23,22,55
Crusaders,914,2,16,6,4,61,32,29,54
Linfield,914,3,11,5,10,40,37,3,38
Glenavon,914,4,9,9,8,53,45,8,36
Cliftonville,914,5,9,4,13,33,34,-1,31
Ballymena,914,6,8,4,14,27,47,-20,28
Glentoran,914,7,6,6,10,24,32,-8,24
Dungannon,914,8,2,4,16,14,47,-33,10
Crusaders,915,1,16,7,3,63,32,31,55
Coleraine,915,2,14,10,2,44,24,20,52
Glenavon,915,3,10,9,7,54,44,10,39
Linfield,915,4,11,5,10,38,36,2,38
Cliftonville,915,5,9,4,13,32,32,0,31
Ballymena,915,6,7,5,14,27,49,-22,26
Glentoran,915,7,6,6,10,24,32,-8,24
Dungannon,915,8,2,4,16,14,47,-33,10
Crusaders,916,1,16,7,3,64,33,31,55
Coleraine,916,2,15,10,1,45,23,22,55
Linfield,916,3,11,5,10,39,37,2,38
Glenavon,916,4,9,9,8,53,45,8,36
Cliftonville,916,5,9,4,13,33,33,0,31
Ballymena,916,6,7,5,14,28,50,-22,26
Glentoran,916,7,6,6,10,24,32,-8,24
Dungannon,916,8,2,4,16,14,47,-33,10
Crusaders,917,1,16,6,4,61,31,30,54
Coleraine,917,2,14,10,2,44,24,20,52
Glenavon,917,3,10,9,7,54,44,10,39
Linfield,917,4,10,6,10,37,36,1,36
Cliftonville,917,5,9,5,12,32,31,1,32
Ballymena,917,6,8,4,14,26,47,-21,28
Glentoran,917,7,6,6,10,24,32,-8,24
Dungannon,917,8,2,4,16,14,47,-33,10
Crusaders,918,1,17,6,3,62,30,32,57
Coleraine,918,2,14,10,2,43,23,20,52
Glenavon,918,3,10,9,7,53,43,10,39
Linfield,918,4,10,6,10,38,37,1,36
Cliftonville,918,5,9,5,12,33,32,1,32
Ballymena,918,6,7,4,15,25,48,-23,25
Glentoran,918,7,6,6,10,24,32,-8,24
Dungannon,918,8,2,4,16,14,47,-33,10
Crusaders,919,1,16,7,3,62,31,31,55
Coleraine,919,2,14,10,2,44,24,20,52
Glenavon,919,3,10,9,7,54,44,10,39
Linfield,919,4,10,5,11,37,38,-1,35
Cliftonville,919,5,10,4,12,34,31,3,34
Ballymena,919,6,7,5,14,26,48,-22,26
Glentoran,919,7,6,6,10,24,32,-8,24
Dungannon,919,8,2,4,16,14,47,-33,10
Crusaders,920,1,17,6,3,64,32,32,57
Coleraine,920,2,14,10,2,43,23,20,52
Glenavon,920,3,10,9,7,53,43,10,39
Linfield,920,4,10,5,11,38,38,0,35
Cliftonville,920,5,10,4,12,34,32,2,34
Ballymena,920,6,7,4,15,27,50,-23,25
Glentoran,920,7,6,6,10,24,32,-8,24
Dungannon,920,8,2,4,16,14,47,-33,10
Crusaders,921,1,16,6,4,63,34,29,54
Coleraine,921,2,14,11,1,44,23,21,53
Glenavon,921,3,9,10,7,53,44,9,37
Linfield,921,4,10,6,10,38,37,1,36
Cliftonville,921,5,9,5,12,33,32,1,32
Ballymena,921,6,8,4,14,29,49,-20,28
Glentoran,921,7,6,6,10,24,32,-8,24
Dungannon,921,8,2,4,16,14,47,-33,10
Crusaders,922,1,17,6,3,65,30,35,57
Coleraine,922,2,15,10,1,45,23,22,55
Glenavon,922,3,9,9,8,53,45,8,36
Linfield,922,4,10,6,10,38,37,1,36
Cliftonville,922,5,9,5,12,33,32,1,32
Ballymena,922,6,7,4,15,25,51,-26,25
Glentoran,922,7,6,6,10,24,32,-8,24
Dungannon,922,8,2,4,16,14,47,-33,10
Crusaders,923,1,17,6,3,64,30,34,57
Coleraine,923,2,14,10,2,45,27,18,52
Glenavon,923,3,10,9,7,57,45,12,39
Linfield,923,4,10,5,11,38,38,0,35
Cliftonville,923,5,10,4,12,34,32,2,34
Ballymena,923,6,7,4,15,25,50,-25,25
Glentoran,923,7,6,6,10,24,32,-8,24
Dungannon,923,8,2,4,16,14,47,-33,10
Crusaders,924,1,17,6,3,63,30,33,57
Coleraine,924,2,14,10,2,43,23,20,52
Glenavon,924,3,10,9,7,53,43,10,39
Linfield,924,4,11,5,10,38,36,2,38
Cliftonville,924,5,9,4,13,32,32,0,31
Ballymena,924,6,7,4,15,25,49,-24,25
Glentoran,924,7,6,6,10,24,32,-8,24
Dungannon,924,8,2,4,16,14,47,-33,10
Crusaders,925,1,16,7,3,63,32,31,55
Coleraine,925,2,14,11,1,44,23,21,53
Glenavon,925,3,9,10,7,53,44,9,37
Linfield,925,4,10,5,11,38,38,0,35
Cliftonville,925,5,10,4,12,34,32,2,34
Ballymena,925,6,7,5,14,27,49,-22,26
Glentoran,925,7,6,6,10,24,32,-8,24
Dungannon,925,8,2,4,16,14,47,-33,10
Coleraine,926,1,15,10,1,46,23,23,55
Crusaders,926,2,16,6,4,61,31,30,54
Linfield,926,3,11,5,10,39,37,2,38
Glenavon,926,4,9,9,8,53,46,7,36
Cliftonville,926,5,9,4,13,33,33,0,31
Ballymena,926,6,8,4,14,26,47,-21,28
Glentoran,926,7,6,6,10,24,32,-8,24
Dungannon,926,8,2,4,16,14,47,-33,10
Crusaders,927,1,16,6,4,61,31,30,54
Coleraine,927,2,14,11,1,44,23,21,53
Glenavon,927,3,9,10,7,53,44,9,37
Linfield,927,4,10,5,11,37,37,0,35
Cliftonville,927,5,10,4,12,33,31,2,34
Ballymena,927,6,8,4,14,26,47,-21,28
Glentoran,927,7,6,6,10,24,32,-8,24
Dungannon,927,8,2,4,16,14,47,-33,10
Crusaders,928,1,16,7,3,63,32,31,55
Coleraine,928,2,14,10,2,43,25,18,52
Glenavon,928,3,10,9,7,55,43,12,39
Linfield,928,4,10,6,10,39,38,1,36
Cliftonville,928,5,9,5,12,34,33,1,32
Ballymena,928,6,7,5,14,27,49,-22,26
Glentoran,928,7,6,6,10,24,32,-8,24
Dungannon,928,8,2,4,16,14,47,-33,10
Crusaders,929,1,16,7,3,61,30,31,55
Coleraine,929,2,14,11,1,44,23,21,53
Glenavon,929,3,9,10,7,53,44,9,37
Linfield,929,4,10,6,10,37,36,1,36
Cliftonville,929,5,9,5,12,32,31,1,32
Ballymena,929,6,7,5,14,25,47,-22,26
Glentoran,929,7,6,6,10,24,32,-8,24
Dungannon,929,8,2,4,16,14,47,-33,10
Crusaders,930,1,17,6,3,65,32,33,57
Coleraine,930,2,14,10,2,44,25,19,52
Glenavon,930,3,10,9,7,55,44,11,39
Linfield,930,4,10,5,11,37,39,-2,35
Cliftonville,930,5,10,4,12,35,31,4,34
Ballymena,930,6,7,4,15,27,51,-24,25
Glentoran,930,7,6,6,10,24,32,-8,24
Dungannon,930,8,2,4,16,14,47,-33,10
Coleraine,931,1,15,10,1,44,22,22,55
Crusaders,931,2,16,6,4,62,33,29,54
Linfield,931,3,11,5,10,39,36,3,38
Glenavon,931,4,9,9,8,52,44,8,36
Cliftonville,931,5,9,4,13,32,33,-1,31
Ballymena,931,6,8,4,14,28,48,-20,28
Glentoran,931,7,6,6,10,24,32,-8,24
Dungannon,931,8,2,4,16,14,47,-33,10
Crusaders,932,1,17,6,3,66,30,36,57
Coleraine,932,2,14,10,2,43,24,19,52
Glenavon,932,3,10,9,7,54,43,11,39
Linfield,932,4,11,5,10,39,37,2,38
Cliftonville,932,5,9,4,13,33,33,0,31
Ballymena,932,6,7,4,15,25,52,-27,25
Glentoran,932,7,6,6,10,24,32,-8,24
Dungannon,932,8,2,4,16,14,47,-33,10
Crusaders,933,1,16,6,4,61,31,30,54
Coleraine,933,2,14,10,2,43,23,20,52
Glenavon,933,3,10,9,7,53,43,10,39
Linfield,933,4,10,6,10,38,37,1,36
Cliftonville,933,5,9,5,12,33,32,1,32
Ballymena,933,6,8,4,14,26,47,-21,28
Glentoran,933,7,6,6,10,24,32,-8,24
Dungannon,933,8,2,4,16,14,47,-33,10
Coleraine,934,1,15,10,1,46,23,23,55
Crusaders,934,2,16,6,4,62,32,30,54
Linfield,934,3,11,5,10,38,36,2,38
Glenavon,934,4,9,9,8,53,46,7,36
Cliftonville,934,5,9,4,13,32,32,0,31
Ballymena,934,6,8,4,14,27,48,-21,28
Glentoran,934,7,6,6,10,24,32,-8,24
Dungannon,934,8,2,4,16,14,47,-33,10
Crusaders,935,1,17,6,3,63,30,33,57
Coleraine,935,2,14,10,2,45,25,20,52
Glenavon,935,3,10,9,7,55,45,10,39
Linfield,935,4,10,5,11,37,38,-1,35
Cliftonville,935,5,10,4,12,34,31,3,34
Ballymena,935,6,7,4,15,25,49,-24,25
Glentoran,935,7,6,6,10,24,32,-8,24
Dungannon,935,8,2,4,16,14,47,-33,10
Crusaders,936,1,16,7,3,63,32,31,55
Coleraine,936,2,14,10,2,44,25,19,52
Glenavon,936,3,10,9,7,55,44,11,39
Linfield,936,4,10,5,11,38,38,0,35
Cliftonville,936,5,10,4,12,34,32,2,34
Ballymena,936,6,7,5,14,27,49,-22,26
Glentoran,936,7,6,6,10,24,32,-8,24
Dungannon,936,8,2,4,16,14,47,-33,10
Crusaders,937,1,17,6,3,65,32,33,57
Coleraine,937,2,15,10,1,46,22,24,55
Glenavon,937,3,9,9,8,52,46,6,36
Linfield,937,4,10,6,10,38,37,1,36
Cliftonville,937,5,9,5,12,33,32,1,32
Ballymena,937,6,7,4,15,27,51,-24,25
Glentoran,937,7,6,6,10,24,32,-8,24
Dungannon,937,8,2,4,16,14,47,-33,10
Crusaders,938,1,16,7,3,63,32,31,55
Coleraine,938,2,14,10,2,43,23,20,52
Glenavon,938,3,10,9,7,53,43,10,39
Linfield,938,4,11,5,10,39,36,3,38
Cliftonville,938,5,9,4,13,32,33,-1,31
Ballymena,938,6,7,5,14,27,49,-22,26
Glentoran,938,7,6,6,10,24,32,-8,24
Dungannon,938,8,2,4,16,14,47,-33,10
Coleraine,939,1,15,10,1,45,23,22,55
Crusaders,939,2,16,6,4,62,32,30,54
Linfield,939,3,11,5,10,40,37,3,38
Glenavon,939,4,9,9,8,53,45,8,36
Cliftonville,939,5,9,4,13,33,34,-1,31
Ballymena,939,6,8,4,14,27,48,-21,28
Glentoran,939,7,6,6,10,24,32,-8,24
Dungannon,939,8,2,4,16,14,47,-33,10
Crusaders,940,1,16,6,4,62,32,30,54
Coleraine,940,2,14,11,1,43,22,21,53
Glenavon,940,3,9,10,7,52,43,9,37
Linfield,940,4,10,6,10,38,37,1,36
Cliftonville,940,5,9,5,12,33,32,1,32
Ballymena,940,6,8,4,14,27,48,-21,28
Glentoran,940,7,6,6,10,24,32,-8,24
Dungannon,940,8,2,4,16,14,47,-33,10
Crusaders,941,1,17,6,3,62,30,32,57
Coleraine,941,2,14,10,2,43,28,15,52
Glenavon,941,3,10,9,7,58,43,15,39
Linfield,941,4,10,5,11,37,37,0,35
Cliftonville,941,5,10,4,12,33,31,2,34
Ballymena,941,6,7,4,15,25,48,-23,25
Glentoran,941,7,6,6,10,24,32,-8,24
Dungannon,941,8,2,4,16,14,47,-33,10
Crusaders,942,1,17,6,3,64,31,33,57
Coleraine,942,2,15,10,1,45,23,22,55
Glenavon,942,3,9,9,8,53,45,8,36
Linfield,942,4,10,6,10,38,37,1,36
Cliftonville,942,5,9,5,12,33,32,1,32
Ballymena,942,6,7,4,15,26,50,-24,25
Glentoran,942,7,6,6,10,24,32,-8,24
Dungannon,942,8,2,4,16,14,47,-33,10
Crusaders,943,1,17,6,3,63,30,33,57
Coleraine,943,2,15,10,1,46,23,23,55
Glenavon,943,3,9,9,8,53,46,7,36
Linfield,943,4,10,6,10,37,36,1,36
Cliftonville,943,5,9,5,12,32,31,1,32
Ballymena,943,6,7,4,15,25,49,-24,25
Glentoran,943,7,6,6,10,24,32,-8,24
Dungannon,943,8,2,4,16,14,47,-33,10
Crusaders,944,1,17,6,3,63,30,33,57
Coleraine,944,2,14,11,1,43,22,21,53
Linfield,944,3,11,5,10,42,37,5,38
Glenavon,944,4,9,10,7,52,43,9,37
Cliftonville,944,5,9,4,13,33,36,-3,31
Ballymena,944,6,7,4,15,25,49,-24,25
Glentoran,944,7,6,6,10,24,32,-8,24
Dungannon,944,8,2,4,16,14,47,-33,10
Coleraine,945,1,15,10,1,44,22,22,55
Crusaders,945,2,16,6,4,62,32,30,54
Glenavon,945,3,9,9,8,52,44,8,36
Linfield,945,4,10,6,10,39,38,1,36
Cliftonville,945,5,9,5,12,34,33,1,32
Ballymena,945,6,8,4,14,27,48,-21,28
Glentoran,945,7,6,6,10,24,32,-8,24
Dungannon,945,8,2,4,16,14,47,-33,10
Crusaders,946,1,16,7,3,62,31,31,55
Coleraine,946,2,15,10,1,45,23,22,55
Glenavon,946,3,9,9,8,53,45,8,36
Linfield,946,4,10,6,10,39,38,1,36
Cliftonville,946,5,9,5,12,34,33,1,32
Ballymena,946,6,7,5,14,26,48,-22,26
Glentoran,946,7,6,6,10,24,32,-8,24
Dungannon,946,8,2,4,16,14,47,-33,10
Crusaders,947,1,17,6,3,65,31,34,57
Coleraine,947,2,14,11,1,43,22,21,53
Linfield,947,3,11,5,10,39,37,2,38
Glenavon,947,4,9,10,7,52,43,9,37
Cliftonville,947,5,9,4,13,33,33,0,31
Ballymena,947,6,7,4,15,26,51,-25,25
Glentoran,947,7,6,6,10,24,32,-8,24
Dungannon,947,8,2,4,16,14,47,-33,10
Crusaders,948,1,17,6,3,62,30,32,57
Coleraine,948,2,14,10,2,44,24,20,52
Glenavon,948,3,10,9,7,54,44,10,39
Linfield,948,4,10,6,10,38,37,1,36
Cliftonville,948,5,9,5,12,33,32,1,32
Ballymena,948,6,7,4,15,25,48,-23,25
Glentoran,948,7,6,6,10,24,32,-8,24
Dungannon,948,8,2,4,16,14,47,-33,10
Crusaders,949,1,16,6,4,61,31,30,54
Coleraine,949,2,14,11,1,44,23,21,53
Linfield,949,3,11,5,10,38,36,2,38
Glenavon,949,4,9,10,7,53,44,9,37
Cliftonville,949,5,9,4,13,32,32,0,31
Ballymena,949,6,8,4,14,26,47,-21,28
Glentoran,949,7,6,6,10,24,32,-8,24
Dungannon,949,8,2,4,16,14,47,-33,10
Crusaders,950,1,16,6,4,61,32,29,54
Coleraine,950,2,14,10,2,44,24,20,52
Glenavon,950,3,10,9,7,54,44,10,39
Linfield,950,4,10,6,10,37,36,1,36
Cliftonville,950,5,9,5,12,32,31,1,32
Ballymena,950,6,8,4,14,27,47,-20,28
Glentoran,950,7,6,6,10,24,32,-8,24
Dungannon,950,8,2,4,16,14,47,-33,10
Crusaders,951,1,17,6,3,62,30,32,57
Coleraine,951,2,15,10,1,44,22,22,55
Glenavon,951,3,9,9,8,52,44,8,36
Linfield,951,4,10,6,10,37,36,1,36
Cliftonville,951,5,9,5,12,32,31,1,32
Ballymena,951,6,7,4,15,25,48,-23,25
Glentoran,951,7,6,6,10,24,32,-8,24
Dungannon,951,8,2,4,16,14,47,-33,10
Crusaders,952,1,17,6,3,63,30,33,57
Coleraine,952,2,14,10,2,43,23,20,52
Glenavon,952,3,10,9,7,53,43,10,39
Linfield,952,4,10,6,10,37,36,1,36
Cliftonville,952,5,9,5,12,32,31,1,32
Ballymena,952,6,7,4,15,25,49,-24,25
Glentoran,952,7,6,6,10,24,32,-8,24
Dungannon,952,8,2,4,16,14,47,-33,10
Crusaders,953,1,16,7,3,61,30,31,55
Coleraine,953,2,14,10,2,46,26,20,52
Glenavon,953,3,10,9,7,56,46,10,39
Linfield,953,4,10,5,11,37,39,-2,35
Cliftonville,953,5,10,4,12,35,31,4,34
Ballymena,953,6,7,5,14,25,47,-22,26
Glentoran,953,7,6,6,10,24,32,-8,24
Dungannon,953,8,2,4,16,14,47,-33,10
Crusaders,954,1,17,6,3,65,31,34,57
Coleraine,954,2,14,11,1,45,24,21,53
Linfield,954,3,11,5,10,40,37,3,38
Glenavon,954,4,9,10,7,54,45,9,37
Cliftonville,954,5,9,4,13,33,34,-1,31
Ballymena,954,6,7,4,15,26,51,-25,25
Glentoran,954,7,6,6,10,24,32,-8,24
Dungannon,954,8,2,4,16,14,47,-33,10
Crusaders,955,1,17,6,3,65,30,35,57
Coleraine,955,2,14,10,2,43,23,20,52
Glenavon,955,3,10,9,7,53,43,10,39
Linfield,955,4,10,5,11,37,38,-1,35
Cliftonville,955,5,10,4,12,34,31,3,34
Ballymena,955,6,7,4,15,25,51,-26,25
Glentoran,955,7,6,6,10,24,32,-8,24
Dungannon,955,8,2,4,16,14,47,-33,10
Crusaders,956,1,17,6,3,64,32,32,57
Coleraine,956,2,14,10,2,43,23,20,52
Glenavon,956,3,10,9,7,53,43,10,39
Linfield,956,4,10,6,10,38,37,1,36
Cliftonville,956,5,9,5,12,33,32,1,32
Ballymena,956,6,7,4,15,27,50,-23,25
Glentoran,956,7,6,6,10,24,32,-8,24
Dungannon,956,8,2,4,16,14,47,-33,10
Crusaders,957,1,16,7,3,62,31,31,55
Coleraine,957,2,15,10,1,44,22,22,55
Glenavon,957,3,9,9,8,52,44,8,36
Linfield,957,4,10,6,10,37,36,1,36
Cliftonville,957,5,9,5,12,32,31,1,32
Ballymena,957,6,7,5,14,26,48,-22,26
Glentoran,957,7,6,6,10,24,32,-8,24
Dungannon,957,8,2,4,16,14,47,-33,10
Crusaders,958,1,17,6,3,63,31,32,57
Coleraine,958,2,14,10,2,44,26,18,52
Glenavon,958,3,10,9,7,56,44,12,39
Linfield,958,4,10,6,10,37,36,1,36
Cliftonville,958,5,9,5,12,32,31,1,32
Ballymena,958,6,7,4,15,26,49,-23,25
Glentoran,958,7,6,6,10,24,32,-8,24
Dungannon,958,8,2,4,16,14,47,-33,10
Crusaders,959,1,16,6,4,61,31,30,54
Coleraine,959,2,14,11,1,44,23,21,53
Glenavon,959,3,9,10,7,53,44,9,37
Linfield,959,4,10,5,11,37,37,0,35
Cliftonville,959,5,10,4,12,33,31,2,34
Ballymena,959,6,8,4,14,26,47,-21,28
Glentoran,959,7,6,6,10,24,32,-8,24
Dungannon,959,8,2,4,16,14,47,-33,10
Coleraine,960,1,15,10,1,44,22,22,55
Crusaders,960,2,16,6,4,62,32,30,54
Glenavon,960,3,9,9,8,52,44,8,36
Linfield,960,4,10,6,10,38,37,1,36
Cliftonville,960,5,9,5,12,33,32,1,32
Ballymena,960,6,8,4,14,27,48,-21,28
Glentoran,960,7,6,6,10,24,32,-8,24
Dungannon,960,8,2,4,16,14,47,-33,10
Crusaders,961,1,16,7,3,61,30,31,55
Coleraine,961,2,15,10,1,44,22,22,55
Glenavon,961,3,9,9,8,52,44,8,36
Linfield,961,4,10,6,10,38,37,1,36
Cliftonville,961,5,9,5,12,33,32,1,32
Ballymena,961,6,7,5,14,25,47,-22,26
Glentoran,961,7,6,6,10,24,32,-8,24
Dungannon,961,8,2,4,16,14,47,-33,10
Crusaders,962,1,17,6,3,62,30,32,57
Coleraine,962,2,15,10,1,46,23,23,55
Glenavon,962,3,9,9,8,53,46,7,36
Linfield,962,4,10,6,10,38,37,1,36
Cliftonville,962,5,9,5,12,33,32,1,32
Ballymena,962,6,7,4,15,25,48,-23,25
Glentoran,962,7,6,6,10,24,32,-8,24
Dungannon,962,8,2,4,16,14,47,-33,10
Crusaders,963,1,17,6,3,64,31,33,57
Coleraine,963,2,14,10,2,43,23,20,52
Glenavon,963,3,10,9,7,53,43,10,39
Linfield,963,4,10,6,10,39,38,1,36
Cliftonville,963,5,9,5,12,34,33,1,32
Ballymena,963,6,7,4,15,26,50,-24,25
Glentoran,963,7,6,6,10,24,32,-8,24
Dungannon,963,8,2,4,16,14,47,-33,10
Coleraine,964,1,15,10,1,47,25,22,55
Crusaders,964,2,16,6,4,62,35,27,54
Glenavon,964,3,9,9,8,55,47,8,36
Linfield,964,4,10,5,11,39,42,-3,35
Cliftonville,964,5,10,4,12,38,33,5,34
Ballymena,964,6,8,4,14,30,48,-18,28
Glentoran,964,7,6,6,10,24,32,-8,24
Dungannon,964,8,2,4,16,14,47,-33,10
Crusaders,965,1,16,7,3,62,31,31,55
Coleraine,965,2,15,10,1,45,22,23,55
Glenavon,965,3,9,9,8,52,45,7,36
Linfield,965,4,10,6,10,37,36,1,36
Cliftonville,965,5,9,5,12,32,31,1,32
Ballymena,965,6,7,5,14,26,48,-22,26
Glentoran,965,7,6,6,10,24,32,-8,24
Dungannon,965,8,2,4,16,14,47,-33,10
Crusaders,966,1,17,6,3,64,30,34,57
Coleraine,966,2,15,10,1,46,23,23,55
Linfield,966,3,11,5,10,40,36,4,38
Glenavon,966,4,9,9,8,53,46,7,36
Cliftonville,966,5,9,4,13,32,34,-2,31
Ballymena,966,6,7,4,15,25,50,-25,25
Glentoran,966,7,6,6,10,24,32,-8,24
Dungannon,966,8,2,4,16,14,47,-33,10
Crusaders,967,1,16,7,3,62,31,31,55
Coleraine,967,2,14,10,2,44,24,20,52
Glenavon,967,3,10,9,7,54,44,10,39
Linfield,967,4,10,6,10,38,37,1,36
Cliftonville,967,5,9,5,12,33,32,1,32
Ballymena,967,6,7,5,14,26,48,-22,26
Glentoran,967,7,6,6,10,24,32,-8,24
Dungannon,967,8,2,4,16,14,47,-33,10
Coleraine,968,1,15,10,1,46,24,22,55
Crusaders,968,2,16,6,4,61,33,28,54
Linfield,968,3,11,5,10,40,36,4,38
Glenavon,968,4,9,9,8,54,46,8,36
Cliftonville,968,5,9,4,13,32,34,-2,31
Ballymena,968,6,8,4,14,28,47,-19,28
Glentoran,968,7,6,6,10,24,32,-8,24
Dungannon,968,8,2,4,16,14,47,-33,10
Crusaders,969,1,17,6,3,63,31,32,57
Coleraine,969,2,14,11,1,45,24,21,53
Linfield,969,3,11,5,10,40,38,2,38
Glenavon,969,4,9,10,7,54,45,9,37
Cliftonville,969,5,9,4,13,34,34,0,31
Ballymena,969,6,7,4,15,26,49,-23,25
Glentoran,969,7,6,6,10,24,32,-8,24
Dungannon,969,8,2,4,16,14,47,-33,10
Crusaders,970,1,17,6,3,64,30,34,57
Coleraine,970,2,14,10,2,44,24,20,52
Glenavon,970,3,10,9,7,54,44,10,39
Linfield,970,4,10,6,10,38,37,1,36
Cliftonville,970,5,9,5,12,33,32,1,32
Ballymena,970,6,7,4,15,25,50,-25,25
Glentoran,970,7,6,6,10,24,32,-8,24
Dungannon,970,8,2,4,16,14,47,-33,10
Crusaders,971,1,17,6,3,63,30,33,57
Coleraine,971,2,14,10,2,44,24,20,52
Glenavon,971,3,10,9,7,54,44,10,39
Linfield,971,4,11,5,10,39,36,3,38
Cliftonville,971,5,9,4,13,32,33,-1,31
Ballymena,971,6,7,4,15,25,49,-24,25
Glentoran,971,7,6,6,10,24,32,-8,24
Dungannon,971,8,2,4,16,14,47,-33,10
Crusaders,972,1,17,6,3,63,30,33,57
Coleraine,972,2,14,11,1,44,23,21,53
Linfield,972,3,11,5,10,39,37,2,38
Glenavon,972,4,9,10,7,53,44,9,37
Cliftonville,972,5,9,4,13,33,33,0,31
Ballymena,972,6,7,4,15,25,49,-24,25
Glentoran,972,7,6,6,10,24,32,-8,24
Dungannon,972,8,2,4,16,14,47,-33,10
Crusaders,973,1,16,7,3,62,31,31,55
Coleraine,973,2,14,11,1,44,23,21,53
Glenavon,973,3,9,10,7,53,44,9,37
Linfield,973,4,10,5,11,37,37,0,35
Cliftonville,973,5,10,4,12,33,31,2,34
Ballymena,973,6,7,5,14,26,48,-22,26
Glentoran,973,7,6,6,10,24,32,-8,24
Dungannon,973,8,2,4,16,14,47,-33,10
Crusaders,974,1,17,6,3,62,30,32,57
Coleraine,974,2,14,10,2,44,24,20,52
Glenavon,974,3,10,9,7,54,44,10,39
Linfield,974,4,11,5,10,39,37,2,38
Cliftonville,974,5,9,4,13,33,33,0,31
Ballymena,974,6,7,4,15,25,48,-23,25
Glentoran,974,7,6,6,10,24,32,-8,24
Dungannon,974,8,2,4,16,14,47,-33,10
Crusaders,975,1,16,7,3,63,32,31,55
Coleraine,975,2,15,10,1,49,22,27,55
Linfield,975,3,11,5,10,39,37,2,38
Glenavon,975,4,9,9,8,52,49,3,36
Cliftonville,975,5,9,4,13,33,33,0,31
Ballymena,975,6,7,5,14,27,49,-22,26
Glentoran,975,7,6,6,10,24,32,-8,24
Dungannon,975,8,2,4,16,14,47,-33,10
Crusaders,976,1,17,6,3,64,30,34,57
Coleraine,976,2,15,10,1,46,24,22,55
Glenavon,976,3,9,9,8,54,46,8,36
Linfield,976,4,10,5,11,38,40,-2,35
Cliftonville,976,5,10,4,12,36,32,4,34
Ballymena,976,6,7,4,15,25,50,-25,25
Glentoran,976,7,6,6,10,24,32,-8,24
Dungannon,976,8,2,4,16,14,47,-33,10
Crusaders,977,1,16,6,4,62,32,30,54
Coleraine,977,2,14,10,2,44,24,20,52
Glenavon,977,3,10,9,7,54,44,10,39
Linfield,977,4,11,5,10,38,36,2,38
Cliftonville,977,5,9,4,13,32,32,0,31
Ballymena,977,6,8,4,14,27,48,-21,28
Glentoran,977,7,6,6,10,24,32,-8,24
Dungannon,977,8,2,4,16,14,47,-33,10
Crusaders,978,1,16,6,4,62,33,29,54
Coleraine,978,2,14,11,1,43,22,21,53
Glenavon,978,3,9,10,7,52,43,9,37
Linfield,978,4,10,6,10,37,36,1,36
Cliftonville,978,5,9,5,12,32,31,1,32
Ballymena,978,6,8,4,14,28,48,-20,28
Glentoran,978,7,6,6,10,24,32,-8,24
Dungannon,978,8,2,4,16,14,47,-33,10
Crusaders,979,1,17,6,3,65,31,34,57
Coleraine,979,2,14,10,2,44,25,19,52
Glenavon,979,3,10,9,7,55,44,11,39
Linfield,979,4,10,6,10,37,36,1,36
Cliftonville,979,5,9,5,12,32,31,1,32
Ballymena,979,6,7,4,15,26,51,-25,25
Glentoran,979,7,6,6,10,24,32,-8,24
Dungannon,979,8,2,4,16,14,47,-33,10
Crusaders,980,1,17,6,3,66,32,34,57
Coleraine,980,2,14,10,2,43,23,20,52
Glenavon,980,3,10,9,7,53,43,10,39
Linfield,980,4,10,5,11,37,37,0,35
Cliftonville,980,5,10,4,12,33,31,2,34
Ballymena,980,6,7,4,15,27,52,-25,25
Glentoran,980,7,6,6,10,24,32,-8,24
Dungannon,980,8,2,4,16,14,47,-33,10
Crusaders,981,1,17,6,3,65,30,35,57
Coleraine,981,2,14,10,2,45,25,20,52
Glenavon,981,3,10,9,7,55,45,10,39
Linfield,981,4,11,5,10,39,36,3,38
Cliftonville,981,5,9,4,13,32,33,-1,31
Ballymena,981,6,7,4,15,25,51,-26,25
Glentoran,981,7,6,6,10,24,32,-8,24
Dungannon,981,8,2,4,16,14,47,-33,10
Crusaders,982,1,17,6,3,67,32,35,57
Coleraine,982,2,14,11,1,46,25,21,53
Glenavon,982,3,9,10,7,55,46,9,37
Linfield,982,4,10,6,10,39,38,1,36
Cliftonville,982,5,9,5,12,34,33,1,32
Ballymena,982,6,7,4,15,27,53,-26,25
Glentoran,982,7,6,6,10,24,32,-8,24
Dungannon,982,8,2,4,16,14,47,-33,10
Crusaders,983,1,17,6,3,65,30,35,57
Coleraine,983,2,14,11,1,45,24,21,53
Linfield,983,3,11,5,10,38,36,2,38
Glenavon,983,4,9,10,7,54,45,9,37
Cliftonville,983,5,9,4,13,32,32,0,31
Ballymena,983,6,7,4,15,25,51,-26,25
Glentoran,983,7,6,6,10,24,32,-8,24
Dungannon,983,8,2,4,16,14,47,-33,10
Crusaders,984,1,17,6,3,63,31,32,57
Coleraine,984,2,15,10,1,45,23,22,55
Glenavon,984,3,9,9,8,53,45,8,36
Linfield,984,4,10,5,11,38,38,0,35
Cliftonville,984,5,10,4,12,34,32,2,34
Ballymena,984,6,7,4,15,26,49,-23,25
Glentoran,984,7,6,6,10,24,32,-8,24
Dungannon,984,8,2,4,16,14,47,-33,10
Crusaders,985,1,17,6,3,68,31,37,57
Coleraine,985,2,15,10,1,44,22,22,55
Linfield,985,3,11,5,10,40,37,3,38
Glenavon,985,4,9,9,8,52,44,8,36
Cliftonville,985,5,9,4,13,33,34,-1,31
Ballymena,985,6,7,4,15,26,54,-28,25
Glentoran,985,7,6,6,10,24,32,-8,24
Dungannon,985,8,2,4,16,14,47,-33,10
Crusaders,986,1,17,6,3,63,31,32,57
Coleraine,986,2,15,10,1,46,24,22,55
Linfield,986,3,11,5,10,38,36,2,38
Glenavon,986,4,9,9,8,54,46,8,36
Cliftonville,986,5,9,4,13,32,32,0,31
Ballymena,986,6,7,4,15,26,49,-23,25
Glentoran,986,7,6,6,10,24,32,-8,24
Dungannon,986,8,2,4,16,14,47,-33,10
Crusaders,987,1,16,7,3,62,31,31,55
Coleraine,987,2,14,10,2,43,26,17,52
Glenavon,987,3,10,9,7,56,43,13,39
Linfield,987,4,11,5,10,39,37,2,38
Cliftonville,987,5,9,4,13,33,33,0,31
Ballymena,987,6,7,5,14,26,48,-22,26
Glentoran,987,7,6,6,10,24,32,-8,24
Dungannon,987,8,2,4,16,14,47,-33,10
Crusaders,988,1,17,6,3,65,30,35,57
Coleraine,988,2,14,10,2,44,26,18,52
Glenavon,988,3,10,9,7,56,44,12,39
Linfield,988,4,10,5,11,37,37,0,35
Cliftonville,988,5,10,4,12,33,31,2,34
Ballymena,988,6,7,4,15,25,51,-26,25
Glentoran,988,7,6,6,10,24,32,-8,24
Dungannon,988,8,2,4,16,14,47,-33,10
Crusaders,989,1,17,6,3,62,30,32,57
Coleraine,989,2,15,10,1,45,23,22,55
Glenavon,989,3,9,9,8,53,45,8,36
Linfield,989,4,10,5,11,37,39,-2,35
Cliftonville,989,5,10,4,12,35,31,4,34
Ballymena,989,6,7,4,15,25,48,-23,25
Glentoran,989,7,6,6,10,24,32,-8,24
Dungannon,989,8,2,4,16,14,47,-33,10
Crusaders,990,1,17,6,3,66,30,36,57
Coleraine,990,2,15,10,1,45,23,22,55
Glenavon,990,3,9,9,8,53,45,8,36
Linfield,990,4,10,5,11,37,37,0,35
Cliftonville,990,5,10,4,12,33,31,2,34
Ballymena,990,6,7,4,15,25,52,-27,25
Glentoran,990,7,6,6,10,24,32,-8,24
Dungannon,990,8,2,4,16,14,47,-33,10
Crusaders,991,1,16,7,3,62,31,31,55
Coleraine,991,2,15,10,1,46,23,23,55
Glenavon,991,3,9,9,8,53,46,7,36
Linfield,991,4,10,6,10,38,37,1,36
Cliftonville,991,5,9,5,12,33,32,1,32
Ballymena,991,6,7,5,14,26,48,-22,26
Glentoran,991,7,6,6,10,24,32,-8,24
Dungannon,991,8,2,4,16,14,47,-33,10
Crusaders,992,1,16,7,3,62,31,31,55
Coleraine,992,2,14,11,1,44,23,21,53
Linfield,992,3,11,5,10,39,36,3,38
Glenavon,992,4,9,10,7,53,44,9,37
Cliftonville,992,5,9,4,13,32,33,-1,31
Ballymena,992,6,7,5,14,26,48,-22,26
Glentoran,992,7,6,6,10,24,32,-8,24
Dungannon,992,8,2,4,16,14,47,-33,10
Crusaders,993,1,16,6,4,61,31,30,54
Coleraine,993,2,14,11,1,47,26,21,53
Glenavon,993,3,9,10,7,56,47,9,37
Linfield,993,4,10,6,10,38,37,1,36
Cliftonville,993,5,9,5,12,33,32,1,32
Ballymena,993,6,8,4,14,26,47,-21,28
Glentoran,993,7,6,6,10,24,32,-8,24
Dungannon,993,8,2,4,16,14,47,-33,10
Crusaders,994,1,16,6,4,63,34,29,54
Coleraine,994,2,14,11,1,44,23,21,53
Glenavon,994,3,9,10,7,53,44,9,37
Linfield,994,4,10,6,10,37,36,1,36
Cliftonville,994,5,9,5,12,32,31,1,32
Ballymena,994,6,8,4,14,29,49,-20,28
Glentoran,994,7,6,6,10,24,32,-8,24
Dungannon,994,8,2,4,16,14,47,-33,10
Crusaders,995,1,16,6,4,61,32,29,54
Coleraine,995,2,14,10,2,44,24,20,52
Glenavon,995,3,10,9,7,54,44,10,39
Linfield,995,4,10,5,11,38,38,0,35
Cliftonville,995,5,10,4,12,34,32,2,34
Ballymena,995,6,8,4,14,27,47,-20,28
Glentoran,995,7,6,6,10,24,32,-8,24
Dungannon,995,8,2,4,16,14,47,-33,10
Crusaders,996,1,17,6,3,63,30,33,57
Coleraine,996,2,14,11,1,46,25,21,53
Linfield,996,3,11,5,10,38,36,2,38
Glenavon,996,4,9,10,7,55,46,9,37
Cliftonville,996,5,9,4,13,32,32,0,31
Ballymena,996,6,7,4,15,25,49,-24,25
Glentoran,996,7,6,6,10,24,32,-8,24
Dungannon,996,8,2,4,16,14,47,-33,10
Crusaders,997,1,16,6,4,63,33,30,54
Coleraine,997,2,14,10,2,43,23,20,52
Glenavon,997,3,10,9,7,53,43,10,39
Linfield,997,4,11,5,10,40,36,4,38
Cliftonville,997,5,9,4,13,32,34,-2,31
Ballymena,997,6,8,4,14,28,49,-21,28
Glentoran,997,7,6,6,10,24,32,-8,24
Dungannon,997,8,2,4,16,14,47,-33,10
Coleraine,998,1,15,10,1,46,24,22,55
Crusaders,998,2,16,6,4,63,33,30,54
Glenavon,998,3,9,9,8,54,46,8,36
Linfield,998,4,10,6,10,39,38,1,36
Cliftonville,998,5,9,5,12,34,33,1,32
Ballymena,998,6,8,4,14,28,49,-21,28
Glentoran,998,7,6,6,10,24,32,-8,24
Dungannon,998,8,2,4,16,14,47,-33,10
Crusaders,999,1,17,6,3,64,32,32,57
Coleraine,999,2,14,10,2,44,24,20,52
Glenavon,999,3,10,9,7,54,44,10,39
Linfield,999,4,10,5,11,37,39,-2,35
Cliftonville,999,5,10,4,12,35,31,4,34
Ballymena,999,6,7,4,15,27,50,-23,25
Glentoran,999,7,6,6,10,24,32,-8,24
Dungannon,999,8,2,4,16,14,47,-33,10
Crusaders,1000,1,16,6,4,62,32,30,54
Coleraine,1000,2,14,10,2,43,24,19,52
Glenavon,1000,3,10,9,7,54,43,11,39
Linfield,1000,4,11,5,10,40,36,4,38
Cliftonville,1000,5,9,4,13,32,34,-2,31
Ballymena,1000,6,8,4,14,27,48,-21,28
Glentoran,1000,7,6,6,10,24,32,-8,24
Dungannon,1000,8,2,4,16,14,47,-33,10
Crusaders,1001,1,17,6,3,64,32,32,57
Coleraine,1001,2,14,11,1,44,23,21,53
Glenavon,1001,3,9,10,7,53,44,9,37
Linfield,1001,4,10,6,10,37,36,1,36
Cliftonville,1001,5,9,5,12,32,31,1,32
Ballymena,1001,6,7,4,15,27,50,-23,25
Glentoran,1001,7,6,6,10,24,32,-8,24
Dungannon,1001,8,2,4,16,14,47,-33,10
Crusaders,1002,1,16,7,3,63,32,31,55
Coleraine,1002,2,14,10,2,44,24,20,52
Glenavon,1002,3,10,9,7,54,44,10,39
Linfield,1002,4,10,6,10,38,37,1,36
Cliftonville,1002,5,9,5,12,33,32,1,32
Ballymena,1002,6,7,5,14,27,49,-22,26
Glentoran,1002,7,6,6,10,24,32,-8,24
Dungannon,1002,8,2,4,16,14,47,-33,10
Crusaders,1003,1,16,6,4,62,33,29,54
Coleraine,1003,2,14,10,2,44,27,17,52
Glenavon,1003,3,10,9,7,57,44,13,39
Linfield,1003,4,11,5,10,38,36,2,38
Cliftonville,1003,5,9,4,13,32,32,0,31
Ballymena,1003,6,8,4,14,28,48,-20,28
Glentoran,1003,7,6,6,10,24,32,-8,24
Dungannon,1003,8,2,4,16,14,47,-33,10
Crusaders,1004,1,16,7,3,63,32,31,55
Coleraine,1004,2,14,10,2,43,25,18,52
Glenavon,1004,3,10,9,7,55,43,12,39
Linfield,1004,4,11,5,10,39,36,3,38
Cliftonville,1004,5,9,4,13,32,33,-1,31
Ballymena,1004,6,7,5,14,27,49,-22,26
Glentoran,1004,7,6,6,10,24,32,-8,24
Dungannon,1004,8,2,4,16,14,47,-33,10
Crusaders,1005,1,17,6,3,63,30,33,57
Coleraine,1005,2,15,10,1,46,22,24,55
Glenavon,1005,3,9,9,8,52,46,6,36
Linfield,1005,4,10,6,10,38,37,1,36
Cliftonville,1005,5,9,5,12,33,32,1,32
Ballymena,1005,6,7,4,15,25,49,-24,25
Glentoran,1005,7,6,6,10,24,32,-8,24
Dungannon,1005,8,2,4,16,14,47,-33,10
Crusaders,1006,1,17,6,3,64,30,34,57
Coleraine,1006,2,14,10,2,43,23,20,52
Glenavon,1006,3,10,9,7,53,43,10,39
Linfield,1006,4,11,5,10,40,36,4,38
Cliftonville,1006,5,9,4,13,32,34,-2,31
Ballymena,1006,6,7,4,15,25,50,-25,25
Glentoran,1006,7,6,6,10,24,32,-8,24
Dungannon,1006,8,2,4,16,14,47,-33,10
Crusaders,1007,1,17,6,3,63,30,33,57
Coleraine,1007,2,15,10,1,47,23,24,55
Glenavon,1007,3,9,9,8,53,47,6,36
Linfield,1007,4,10,5,11,37,37,0,35
Cliftonville,1007,5,10,4,12,33,31,2,34
Ballymena,1007,6,7,4,15,25,49,-24,25
Glentoran,1007,7,6,6,10,24,32,-8,24
Dungannon,1007,8,2,4,16,14,47,-33,10
Crusaders,1008,1,17,6,3,63,31,32,57
Coleraine,1008,2,14,10,2,43,23,20,52
Glenavon,1008,3,10,9,7,53,43,10,39
Linfield,1008,4,10,5,11,38,38,0,35
Cliftonville,1008,5,10,4,12,34,32,2,34
Ballymena,1008,6,7,4,15,26,49,-23,25
Glentoran,1008,7,6,6,10,24,32,-8,24
Dungannon,1008,8,2,4,16,14,47,-33,10
Crusaders,1009,1,16,7,3,63,32,31,55
Coleraine,1009,2,14,10,2,43,25,18,52
Glenavon,1009,3,10,9,7,55,43,12,39
Linfield,1009,4,10,5,11,38,39,-1,35
Cliftonville,1009,5,10,4,12,35,32,3,34
Ballymena,1009,6,7,5,14,27,49,-22,26
Glentoran,1009,7,6,6,10,24,32,-8,24
Dungannon,1009,8,2,4,16,14,47,-33,10
Crusaders,1010,1,16,6,4,61,31,30,54
Coleraine,1010,2,14,10,2,43,25,18,52
Glenavon,1010,3,10,9,7,55,43,12,39
Linfield,1010,4,11,5,10,38,36,2,38
Cliftonville,1010,5,9,4,13,32,32,0,31
Ballymena,1010,6,8,4,14,26,47,-21,28
Glentoran,1010,7,6,6,10,24,32,-8,24
Dungannon,1010,8,2,4,16,14,47,-33,10
Crusaders,1011,1,17,6,3,65,33,32,57
Coleraine,1011,2,14,10,2,45,25,20,52
Glenavon,1011,3,10,9,7,55,45,10,39
Linfield,1011,4,11,5,10,40,37,3,38
Cliftonville,1011,5,9,4,13,33,34,-1,31
Ballymena,1011,6,7,4,15,28,51,-23,25
Glentoran,1011,7,6,6,10,24,32,-8,24
Dungannon,1011,8,2,4,16,14,47,-33,10
Crusaders,1012,1,17,6,3,63,31,32,57
Coleraine,1012,2,14,10,2,44,26,18,52
Glenavon,1012,3,10,9,7,56,44,12,39
Linfield,1012,4,11,5,10,41,36,5,38
Cliftonville,1012,5,9,4,13,32,35,-3,31
Ballymena,1012,6,7,4,15,26,49,-23,25
Glentoran,1012,7,6,6,10,24,32,-8,24
Dungannon,1012,8,2,4,16,14,47,-33,10
Crusaders,1013,1,16,7,3,62,31,31,55
Coleraine,1013,2,14,11,1,45,24,21,53
Linfield,1013,3,11,5,10,39,36,3,38
Glenavon,1013,4,9,10,7,54,45,9,37
Cliftonville,1013,5,9,4,13,32,33,-1,31
Ballymena,1013,6,7,5,14,26,48,-22,26
Glentoran,1013,7,6,6,10,24,32,-8,24
Dungannon,1013,8,2,4,16,14,47,-33,10
Crusaders,1014,1,17,6,3,63,31,32,57
Coleraine,1014,2,15,10,1,49,25,24,55
Glenavon,1014,3,9,9,8,55,49,6,36
Linfield,1014,4,10,6,10,37,36,1,36
Cliftonville,1014,5,9,5,12,32,31,1,32
Ballymena,1014,6,7,4,15,26,49,-23,25
Glentoran,1014,7,6,6,10,24,32,-8,24
Dungannon,1014,8,2,4,16,14,47,-33,10
Crusaders,1015,1,17,6,3,63,31,32,57
Coleraine,1015,2,15,10,1,47,23,24,55
Linfield,1015,3,11,5,10,39,36,3,38
Glenavon,1015,4,9,9,8,53,47,6,36
Cliftonville,1015,5,9,4,13,32,33,-1,31
Ballymena,1015,6,7,4,15,26,49,-23,25
Glentoran,1015,7,6,6,10,24,32,-8,24
Dungannon,1015,8,2,4,16,14,47,-33,10
Crusaders,1016,1,16,7,3,62,31,31,55
Coleraine,1016,2,14,11,1,46,25,21,53
Linfield,1016,3,11,5,10,39,37,2,38
Glenavon,1016,4,9,10,7,55,46,9,37
Cliftonville,1016,5,9,4,13,33,33,0,31
Ballymena,1016,6,7,5,14,26,48,-22,26
Glentoran,1016,7,6,6,10,24,32,-8,24
Dungannon,1016,8,2,4,16,14,47,-33,10
Crusaders,1017,1,17,6,3,63,30,33,57
Coleraine,1017,2,14,10,2,43,25,18,52
Glenavon,1017,3,10,9,7,55,43,12,39
Linfield,1017,4,10,6,10,38,37,1,36
Cliftonville,1017,5,9,5,12,33,32,1,32
Ballymena,1017,6,7,4,15,25,49,-24,25
Glentoran,1017,7,6,6,10,24,32,-8,24
Dungannon,1017,8,2,4,16,14,47,-33,10
Crusaders,1018,1,16,6,4,61,31,30,54
Coleraine,1018,2,14,10,2,44,25,19,52
Glenavon,1018,3,10,9,7,55,44,11,39
Linfield,1018,4,11,5,10,39,36,3,38
Cliftonville,1018,5,9,4,13,32,33,-1,31
Ballymena,1018,6,8,4,14,26,47,-21,28
Glentoran,1018,7,6,6,10,24,32,-8,24
Dungannon,1018,8,2,4,16,14,47,-33,10
Crusaders,1019,1,17,6,3,63,31,32,57
Coleraine,1019,2,14,11,1,43,22,21,53
Linfield,1019,3,11,5,10,41,39,2,38
Glenavon,1019,4,9,10,7,52,43,9,37
Cliftonville,1019,5,9,4,13,35,35,0,31
Ballymena,1019,6,7,4,15,26,49,-23,25
Glentoran,1019,7,6,6,10,24,32,-8,24
Dungannon,1019,8,2,4,16,14,47,-33,10
Crusaders,1020,1,17,6,3,66,33,33,57
Coleraine,1020,2,15,10,1,45,22,23,55
Linfield,1020,3,11,5,10,39,36,3,38
Glenavon,1020,4,9,9,8,52,45,7,36
Cliftonville,1020,5,9,4,13,32,33,-1,31
Ballymena,1020,6,7,4,15,28,52,-24,25
Glentoran,1020,7,6,6,10,24,32,-8,24
Dungannon,1020,8,2,4,16,14,47,-33,10
Crusaders,1021,1,17,6,3,63,30,33,57
Coleraine,1021,2,14,11,1,45,24,21,53
Linfield,1021,3,11,5,10,39,37,2,38
Glenavon,1021,4,9,10,7,54,45,9,37
Cliftonville,1021,5,9,4,13,33,33,0,31
Ballymena,1021,6,7,4,15,25,49,-24,25
Glentoran,1021,7,6,6,10,24,32,-8,24
Dungannon,1021,8,2,4,16,14,47,-33,10
Crusaders,1022,1,17,6,3,64,30,34,57
Coleraine,1022,2,15,10,1,44,22,22,55
Glenavon,1022,3,9,9,8,52,44,8,36
Linfield,1022,4,10,6,10,38,37,1,36
Cliftonville,1022,5,9,5,12,33,32,1,32
Ballymena,1022,6,7,4,15,25,50,-25,25
Glentoran,1022,7,6,6,10,24,32,-8,24
Dungannon,1022,8,2,4,16,14,47,-33,10
Crusaders,1023,1,17,6,3,63,30,33,57
Coleraine,1023,2,14,10,2,45,27,18,52
Glenavon,1023,3,10,9,7,57,45,12,39
Linfield,1023,4,10,5,11,37,38,-1,35
Cliftonville,1023,5,10,4,12,34,31,3,34
Ballymena,1023,6,7,4,15,25,49,-24,25
Glentoran,1023,7,6,6,10,24,32,-8,24
Dungannon,1023,8,2,4,16,14,47,-33,10
Crusaders,1024,1,17,6,3,63,30,33,57
Coleraine,1024,2,15,10,1,45,22,23,55
Glenavon,1024,3,9,9,8,52,45,7,36
Linfield,1024,4,10,6,10,38,37,1,36
Cliftonville,1024,5,9,5,12,33,32,1,32
Ballymena,1024,6,7,4,15,25,49,-24,25
Glentoran,1024,7,6,6,10,24,32,-8,24
Dungannon,1024,8,2,4,16,14,47,-33,10
Crusaders,1025,1,17,6,3,66,30,36,57
Coleraine,1025,2,14,11,1,45,24,21,53
Glenavon,1025,3,9,10,7,54,45,9,37
Linfield,1025,4,10,5,11,37,37,0,35
Cliftonville,1025,5,10,4,12,33,31,2,34
Ballymena,1025,6,7,4,15,25,52,-27,25
Glentoran,1025,7,6,6,10,24,32,-8,24
Dungannon,1025,8,2,4,16,14,47,-33,10
Crusaders,1026,1,16,6,4,63,33,30,54
Coleraine,1026,2,14,10,2,43,24,19,52
Glenavon,1026,3,10,9,7,54,43,11,39
Linfield,1026,4,11,5,10,40,36,4,38
Cliftonville,1026,5,9,4,13,32,34,-2,31
Ballymena,1026,6,8,4,14,28,49,-21,28
Glentoran,1026,7,6,6,10,24,32,-8,24
Dungannon,1026,8,2,4,16,14,47,-33,10
Crusaders,1027,1,16,7,3,61,30,31,55
Coleraine,1027,2,15,10,1,46,22,24,55
Linfield,1027,3,11,5,10,41,37,4,38
Glenavon,1027,4,9,9,8,52,46,6,36
Cliftonville,1027,5,9,4,13,33,35,-2,31
Ballymena,1027,6,7,5,14,25,47,-22,26
Glentoran,1027,7,6,6,10,24,32,-8,24
Dungannon,1027,8,2,4,16,14,47,-33,10
Coleraine,1028,1,15,10,1,46,22,24,55
Crusaders,1028,2,16,6,4,61,33,28,54
Glenavon,1028,3,9,9,8,52,46,6,36
Linfield,1028,4,10,5,11,37,38,-1,35
Cliftonville,1028,5,10,4,12,34,31,3,34
Ballymena,1028,6,8,4,14,28,47,-19,28
Glentoran,1028,7,6,6,10,24,32,-8,24
Dungannon,1028,8,2,4,16,14,47,-33,10
Crusaders,1029,1,16,7,3,61,30,31,55
Coleraine,1029,2,14,10,2,43,24,19,52
Glenavon,1029,3,10,9,7,54,43,11,39
Linfield,1029,4,11,5,10,38,36,2,38
Cliftonville,1029,5,9,4,13,32,32,0,31
Ballymena,1029,6,7,5,14,25,47,-22,26
Glentoran,1029,7,6,6,10,24,32,-8,24
Dungannon,1029,8,2,4,16,14,47,-33,10
Crusaders,1030,1,16,6,4,61,32,29,54
Coleraine,1030,2,14,10,2,43,25,18,52
Glenavon,1030,3,10,9,7,55,43,12,39
Linfield,1030,4,11,5,10,41,37,4,38
Cliftonville,1030,5,9,4,13,33,35,-2,31
Ballymena,1030,6,8,4,14,27,47,-20,28
Glentoran,1030,7,6,6,10,24,32,-8,24
Dungannon,1030,8,2,4,16,14,47,-33,10
Crusaders,1031,1,17,6,3,64,31,33,57
Coleraine,1031,2,14,11,1,44,23,21,53
Glenavon,1031,3,9,10,7,53,44,9,37
Linfield,1031,4,10,6,10,38,37,1,36
Cliftonville,1031,5,9,5,12,33,32,1,32
Ballymena,1031,6,7,4,15,26,50,-24,25
Glentoran,1031,7,6,6,10,24,32,-8,24
Dungannon,1031,8,2,4,16,14,47,-33,10
Coleraine,1032,1,15,10,1,45,23,22,55
Crusaders,1032,2,16,6,4,61,33,28,54
Linfield,1032,3,11,5,10,41,36,5,38
Glenavon,1032,4,9,9,8,53,45,8,36
Cliftonville,1032,5,9,4,13,32,35,-3,31
Ballymena,1032,6,8,4,14,28,47,-19,28
Glentoran,1032,7,6,6,10,24,32,-8,24
Dungannon,1032,8,2,4,16,14,47,-33,10
Crusaders,1033,1,17,6,3,63,31,32,57
Coleraine,1033,2,14,10,2,43,29,14,52
Glenavon,1033,3,10,9,7,59,43,16,39
Linfield,1033,4,11,5,10,39,36,3,38
Cliftonville,1033,5,9,4,13,32,33,-1,31
Ballymena,1033,6,7,4,15,26,49,-23,25
Glentoran,1033,7,6,6,10,24,32,-8,24
Dungannon,1033,8,2,4,16,14,47,-33,10
Crusaders,1034,1,17,6,3,64,30,34,57
Coleraine,1034,2,14,10,2,43,25,18,52
Glenavon,1034,3,10,9,7,55,43,12,39
Linfield,1034,4,10,5,11,38,38,0,35
Cliftonville,1034,5,10,4,12,34,32,2,34
Ballymena,1034,6,7,4,15,25,50,-25,25
Glentoran,1034,7,6,6,10,24,32,-8,24
Dungannon,1034,8,2,4,16,14,47,-33,10
Crusaders,1035,1,16,7,3,62,31,31,55
Coleraine,1035,2,14,11,1,44,23,21,53
Glenavon,1035,3,9,10,7,53,44,9,37
Linfield,1035,4,10,5,11,38,38,0,35
Cliftonville,1035,5,10,4,12,34,32,2,34
Ballymena,1035,6,7,5,14,26,48,-22,26
Glentoran,1035,7,6,6,10,24,32,-8,24
Dungannon,1035,8,2,4,16,14,47,-33,10
Crusaders,1036,1,17,6,3,63,30,33,57
Coleraine,1036,2,14,10,2,44,24,20,52
Glenavon,1036,3,10,9,7,54,44,10,39
Linfield,1036,4,11,5,10,39,36,3,38
Cliftonville,1036,5,9,4,13,32,33,-1,31
Ballymena,1036,6,7,4,15,25,49,-24,25
Glentoran,1036,7,6,6,10,24,32,-8,24
Dungannon,1036,8,2,4,16,14,47,-33,10
Crusaders,1037,1,17,6,3,64,31,33,57
Coleraine,1037,2,14,11,1,45,24,21,53
Glenavon,1037,3,9,10,7,54,45,9,37
Linfield,1037,4,10,6,10,38,37,1,36
Cliftonville,1037,5,9,5,12,33,32,1,32
Ballymena,1037,6,7,4,15,26,50,-24,25
Glentoran,1037,7,6,6,10,24,32,-8,24
Dungannon,1037,8,2,4,16,14,47,-33,10
Coleraine,1038,1,15,10,1,47,23,24,55
Crusaders,1038,2,16,6,4,62,32,30,54
Linfield,1038,3,11,5,10,39,36,3,38
Glenavon,1038,4,9,9,8,53,47,6,36
Cliftonville,1038,5,9,4,13,32,33,-1,31
Ballymena,1038,6,8,4,14,27,48,-21,28
Glentoran,1038,7,6,6,10,24,32,-8,24
Dungannon,1038,8,2,4,16,14,47,-33,10
Crusaders,1039,1,17,6,3,62,30,32,57
Coleraine,1039,2,14,11,1,44,23,21,53
Glenavon,1039,3,9,10,7,53,44,9,37
Linfield,1039,4,10,6,10,38,37,1,36
Cliftonville,1039,5,9,5,12,33,32,1,32
Ballymena,1039,6,7,4,15,25,48,-23,25
Glentoran,1039,7,6,6,10,24,32,-8,24
Dungannon,1039,8,2,4,16,14,47,-33,10
Coleraine,1040,1,15,10,1,47,25,22,55
Crusaders,1040,2,16,6,4,62,32,30,54
Glenavon,1040,3,9,9,8,55,47,8,36
Linfield,1040,4,10,6,10,37,36,1,36
Cliftonville,1040,5,9,5,12,32,31,1,32
Ballymena,1040,6,8,4,14,27,48,-21,28
Glentoran,1040,7,6,6,10,24,32,-8,24
Dungannon,1040,8,2,4,16,14,47,-33,10
Crusaders,1041,1,16,6,4,61,32,29,54
Coleraine,1041,2,14,11,1,44,23,21,53
Glenavon,1041,3,9,10,7,53,44,9,37
Linfield,1041,4,10,6,10,38,37,1,36
Cliftonville,1041,5,9,5,12,33,32,1,32
Ballymena,1041,6,8,4,14,27,47,-20,28
Glentoran,1041,7,6,6,10,24,32,-8,24
Dungannon,1041,8,2,4,16,14,47,-33,10
Crusaders,1042,1,17,6,3,64,31,33,57
Coleraine,1042,2,14,10,2,45,25,20,52
Glenavon,1042,3,10,9,7,55,45,10,39
Linfield,1042,4,11,5,10,41,37,4,38
Cliftonville,1042,5,9,4,13,33,35,-2,31
Ballymena,1042,6,7,4,15,26,50,-24,25
Glentoran,1042,7,6,6,10,24,32,-8,24
Dungannon,1042,8,2,4,16,14,47,-33,10
Crusaders,1043,1,17,6,3,62,30,32,57
Coleraine,1043,2,14,11,1,44,23,21,53
Glenavon,1043,3,9,10,7,53,44,9,37
Linfield,1043,4,10,5,11,38,38,0,35
Cliftonville,1043,5,10,4,12,34,32,2,34
Ballymena,1043,6,7,4,15,25,48,-23,25
Glentoran,1043,7,6,6,10,24,32,-8,24
Dungannon,1043,8,2,4,16,14,47,-33,10
Crusaders,1044,1,16,7,3,62,31,31,55
Coleraine,1044,2,14,10,2,45,26,19,52
Glenavon,1044,3,10,9,7,56,45,11,39
Linfield,1044,4,10,5,11,37,39,-2,35
Cliftonville,1044,5,10,4,12,35,31,4,34
Ballymena,1044,6,7,5,14,26,48,-22,26
Glentoran,1044,7,6,6,10,24,32,-8,24
Dungannon,1044,8,2,4,16,14,47,-33,10
Crusaders,1045,1,17,6,3,63,31,32,57
Coleraine,1045,2,14,10,2,45,25,20,52
Glenavon,1045,3,10,9,7,55,45,10,39
Linfield,1045,4,11,5,10,41,37,4,38
Cliftonville,1045,5,9,4,13,33,35,-2,31
Ballymena,1045,6,7,4,15,26,49,-23,25
Glentoran,1045,7,6,6,10,24,32,-8,24
Dungannon,1045,8,2,4,16,14,47,-33,10
Crusaders,1046,1,17,6,3,64,31,33,57
Coleraine,1046,2,14,11,1,44,23,21,53
Glenavon,1046,3,9,10,7,53,44,9,37
Linfield,1046,4,10,5,11,38,40,-2,35
Cliftonville,1046,5,10,4,12,36,32,4,34
Ballymena,1046,6,7,4,15,26,50,-24,25
Glentoran,1046,7,6,6,10,24,32,-8,24
Dungannon,1046,8,2,4,16,14,47,-33,10
Crusaders,1047,1,17,6,3,63,31,32,57
Coleraine,1047,2,14,11,1,46,25,21,53
Linfield,1047,3,11,5,10,41,36,5,38
Glenavon,1047,4,9,10,7,55,46,9,37
Cliftonville,1047,5,9,4,13,32,35,-3,31
Ballymena,1047,6,7,4,15,26,49,-23,25
Glentoran,1047,7,6,6,10,24,32,-8,24
Dungannon,1047,8,2,4,16,14,47,-33,10
Crusaders,1048,1,17,6,3,65,31,34,57
Coleraine,1048,2,15,10,1,46,22,24,55
Glenavon,1048,3,9,9,8,52,46,6,36
Linfield,1048,4,10,6,10,39,38,1,36
Cliftonville,1048,5,9,5,12,34,33,1,32
Ballymena,1048,6,7,4,15,26,51,-25,25
Glentoran,1048,7,6,6,10,24,32,-8,24
Dungannon,1048,8,2,4,16,14,47,-33,10
Crusaders,1049,1,17,6,3,62,30,32,57
Coleraine,1049,2,15,10,1,48,24,24,55
Glenavon,1049,3,9,9,8,54,48,6,36
Linfield,1049,4,10,6,10,40,39,1,36
Cliftonville,1049,5,9,5,12,35,34,1,32
Ballymena,1049,6,7,4,15,25,48,-23,25
Glentoran,1049,7,6,6,10,24,32,-8,24
Dungannon,1049,8,2,4,16,14,47,-33,10
Crusaders,1050,1,16,7,3,62,31,31,55
Coleraine,1050,2,15,10,1,45,23,22,55
Linfield,1050,3,11,5,10,39,37,2,38
Glenavon,1050,4,9,9,8,53,45,8,36
Cliftonville,1050,5,9,4,13,33,33,0,31
Ballymena,1050,6,7,5,14,26,48,-22,26
Glentoran,1050,7,6,6,10,24,32,-8,24
Dungannon,1050,8,2,4,16,14,47,-33,10
Crusaders,1051,1,17,6,3,65,31,34,57
Coleraine,1051,2,14,10,2,44,27,17,52
Glenavon,1051,3,10,9,7,57,44,13,39
Linfield,1051,4,11,5,10,39,36,3,38
Cliftonville,1051,5,9,4,13,32,33,-1,31
Ballymena,1051,6,7,4,15,26,51,-25,25
Glentoran,1051,7,6,6,10,24,32,-8,24
Dungannon,1051,8,2,4,16,14,47,-33,10
Crusaders,1052,1,17,6,3,63,30,33,57
Coleraine,1052,2,14,11,1,45,24,21,53
Glenavon,1052,3,9,10,7,54,45,9,37
Linfield,1052,4,10,5,11,39,40,-1,35
Cliftonville,1052,5,10,4,12,36,33,3,34
Ballymena,1052,6,7,4,15,25,49,-24,25
Glentoran,1052,7,6,6,10,24,32,-8,24
Dungannon,1052,8,2,4,16,14,47,-33,10
Crusaders,1053,1,17,6,3,63,31,32,57
Coleraine,1053,2,14,10,2,44,26,18,52
Glenavon,1053,3,10,9,7,56,44,12,39
Linfield,1053,4,11,5,10,38,36,2,38
Cliftonville,1053,5,9,4,13,32,32,0,31
Ballymena,1053,6,7,4,15,26,49,-23,25
Glentoran,1053,7,6,6,10,24,32,-8,24
Dungannon,1053,8,2,4,16,14,47,-33,10
Crusaders,1054,1,16,7,3,62,31,31,55
Coleraine,1054,2,14,10,2,44,24,20,52
Glenavon,1054,3,10,9,7,54,44,10,39
Linfield,1054,4,11,5,10,40,37,3,38
Cliftonville,1054,5,9,4,13,33,34,-1,31
Ballymena,1054,6,7,5,14,26,48,-22,26
Glentoran,1054,7,6,6,10,24,32,-8,24
Dungannon,1054,8,2,4,16,14,47,-33,10
Crusaders,1055,1,16,7,3,61,30,31,55
Coleraine,1055,2,15,10,1,44,22,22,55
Glenavon,1055,3,9,9,8,52,44,8,36
Linfield,1055,4,10,5,11,37,40,-3,35
Cliftonville,1055,5,10,4,12,36,31,5,34
Ballymena,1055,6,7,5,14,25,47,-22,26
Glentoran,1055,7,6,6,10,24,32,-8,24
Dungannon,1055,8,2,4,16,14,47,-33,10
Crusaders,1056,1,17,6,3,64,31,33,57
Coleraine,1056,2,14,10,2,44,25,19,52
Glenavon,1056,3,10,9,7,55,44,11,39
Linfield,1056,4,10,6,10,38,37,1,36
Cliftonville,1056,5,9,5,12,33,32,1,32
Ballymena,1056,6,7,4,15,26,50,-24,25
Glentoran,1056,7,6,6,10,24,32,-8,24
Dungannon,1056,8,2,4,16,14,47,-33,10
Crusaders,1057,1,17,6,3,63,30,33,57
Coleraine,1057,2,14,10,2,44,24,20,52
Glenavon,1057,3,10,9,7,54,44,10,39
Linfield,1057,4,11,5,10,38,36,2,38
Cliftonville,1057,5,9,4,13,32,32,0,31
Ballymena,1057,6,7,4,15,25,49,-24,25
Glentoran,1057,7,6,6,10,24,32,-8,24
Dungannon,1057,8,2,4,16,14,47,-33,10
Crusaders,1058,1,16,7,3,62,31,31,55
Coleraine,1058,2,15,10,1,46,23,23,55
Linfield,1058,3,11,5,10,39,36,3,38
Glenavon,1058,4,9,9,8,53,46,7,36
Cliftonville,1058,5,9,4,13,32,33,-1,31
Ballymena,1058,6,7,5,14,26,48,-22,26
Glentoran,1058,7,6,6,10,24,32,-8,24
Dungannon,1058,8,2,4,16,14,47,-33,10
Crusaders,1059,1,16,7,3,62,31,31,55
Coleraine,1059,2,15,10,1,44,22,22,55
Glenavon,1059,3,9,9,8,52,44,8,36
Linfield,1059,4,10,5,11,38,38,0,35
Cliftonville,1059,5,10,4,12,34,32,2,34
Ballymena,1059,6,7,5,14,26,48,-22,26
Glentoran,1059,7,6,6,10,24,32,-8,24
Dungannon,1059,8,2,4,16,14,47,-33,10
Crusaders,1060,1,16,6,4,62,34,28,54
Coleraine,1060,2,14,10,2,43,23,20,52
Glenavon,1060,3,10,9,7,53,43,10,39
Linfield,1060,4,11,5,10,38,36,2,38
Cliftonville,1060,5,9,4,13,32,32,0,31
Ballymena,1060,6,8,4,14,29,48,-19,28
Glentoran,1060,7,6,6,10,24,32,-8,24
Dungannon,1060,8,2,4,16,14,47,-33,10
Crusaders,1061,1,17,6,3,63,31,32,57
Coleraine,1061,2,14,10,2,44,25,19,52
Glenavon,1061,3,10,9,7,55,44,11,39
Linfield,1061,4,10,6,10,39,38,1,36
Cliftonville,1061,5,9,5,12,34,33,1,32
Ballymena,1061,6,7,4,15,26,49,-23,25
Glentoran,1061,7,6,6,10,24,32,-8,24
Dungannon,1061,8,2,4,16,14,47,-33,10
Crusaders,1062,1,16,6,4,64,35,29,54
Coleraine,1062,2,14,10,2,43,25,18,52
Glenavon,1062,3,10,9,7,55,43,12,39
Linfield,1062,4,10,5,11,38,38,0,35
Cliftonville,1062,5,10,4,12,34,32,2,34
Ballymena,1062,6,8,4,14,30,50,-20,28
Glentoran,1062,7,6,6,10,24,32,-8,24
Dungannon,1062,8,2,4,16,14,47,-33,10
Crusaders,1063,1,16,7,3,61,30,31,55
Coleraine,1063,2,14,10,2,44,25,19,52
Glenavon,1063,3,10,9,7,55,44,11,39
Linfield,1063,4,10,6,10,37,36,1,36
Cliftonville,1063,5,9,5,12,32,31,1,32
Ballymena,1063,6,7,5,14,25,47,-22,26
Glentoran,1063,7,6,6,10,24,32,-8,24
Dungannon,1063,8,2,4,16,14,47,-33,10
Crusaders,1064,1,17,6,3,64,31,33,57
Coleraine,1064,2,14,11,1,44,23,21,53
Glenavon,1064,3,9,10,7,53,44,9,37
Linfield,1064,4,10,6,10,37,36,1,36
Cliftonville,1064,5,9,5,12,32,31,1,32
Ballymena,1064,6,7,4,15,26,50,-24,25
Glentoran,1064,7,6,6,10,24,32,-8,24
Dungannon,1064,8,2,4,16,14,47,-33,10
Crusaders,1065,1,16,6,4,62,32,30,54
Coleraine,1065,2,14,10,2,43,24,19,52
Glenavon,1065,3,10,9,7,54,43,11,39
Linfield,1065,4,11,5,10,40,37,3,38
Cliftonville,1065,5,9,4,13,33,34,-1,31
Ballymena,1065,6,8,4,14,27,48,-21,28
Glentoran,1065,7,6,6,10,24,32,-8,24
Dungannon,1065,8,2,4,16,14,47,-33,10
Crusaders,1066,1,16,7,3,63,32,31,55
Coleraine,1066,2,14,10,2,46,26,20,52
Glenavon,1066,3,10,9,7,56,46,10,39
Linfield,1066,4,11,5,10,38,36,2,38
Cliftonville,1066,5,9,4,13,32,32,0,31
Ballymena,1066,6,7,5,14,27,49,-22,26
Glentoran,1066,7,6,6,10,24,32,-8,24
Dungannon,1066,8,2,4,16,14,47,-33,10
Crusaders,1067,1,17,6,3,62,30,32,57
Coleraine,1067,2,14,11,1,44,23,21,53
Linfield,1067,3,11,5,10,42,36,6,38
Glenavon,1067,4,9,10,7,53,44,9,37
Cliftonville,1067,5,9,4,13,32,36,-4,31
Ballymena,1067,6,7,4,15,25,48,-23,25
Glentoran,1067,7,6,6,10,24,32,-8,24
Dungannon,1067,8,2,4,16,14,47,-33,10
Crusaders,1068,1,17,6,3,63,30,33,57
Coleraine,1068,2,14,11,1,45,24,21,53
Glenavon,1068,3,9,10,7,54,45,9,37
Linfield,1068,4,10,5,11,38,38,0,35
Cliftonville,1068,5,10,4,12,34,32,2,34
Ballymena,1068,6,7,4,15,25,49,-24,25
Glentoran,1068,7,6,6,10,24,32,-8,24
Dungannon,1068,8,2,4,16,14,47,-33,10
Crusaders,1069,1,17,6,3,64,31,33,57
Coleraine,1069,2,15,10,1,45,22,23,55
Linfield,1069,3,11,5,10,39,37,2,38
Glenavon,1069,4,9,9,8,52,45,7,36
Cliftonville,1069,5,9,4,13,33,33,0,31
Ballymena,1069,6,7,4,15,26,50,-24,25
Glentoran,1069,7,6,6,10,24,32,-8,24
Dungannon,1069,8,2,4,16,14,47,-33,10
Crusaders,1070,1,16,7,3,62,31,31,55
Coleraine,1070,2,15,10,1,46,23,23,55
Glenavon,1070,3,9,9,8,53,46,7,36
Linfield,1070,4,10,6,10,40,39,1,36
Cliftonville,1070,5,9,5,12,35,34,1,32
Ballymena,1070,6,7,5,14,26,48,-22,26
Glentoran,1070,7,6,6,10,24,32,-8,24
Dungannon,1070,8,2,4,16,14,47,-33,10
Crusaders,1071,1,16,7,3,62,31,31,55
Coleraine,1071,2,15,10,1,45,23,22,55
Glenavon,1071,3,9,9,8,53,45,8,36
Linfield,1071,4,10,6,10,38,37,1,36
Cliftonville,1071,5,9,5,12,33,32,1,32
Ballymena,1071,6,7,5,14,26,48,-22,26
Glentoran,1071,7,6,6,10,24,32,-8,24
Dungannon,1071,8,2,4,16,14,47,-33,10
Crusaders,1072,1,16,6,4,62,32,30,54
Coleraine,1072,2,14,10,2,44,24,20,52
Glenavon,1072,3,10,9,7,54,44,10,39
Linfield,1072,4,10,5,11,37,37,0,35
Cliftonville,1072,5,10,4,12,33,31,2,34
Ballymena,1072,6,8,4,14,27,48,-21,28
Glentoran,1072,7,6,6,10,24,32,-8,24
Dungannon,1072,8,2,4,16,14,47,-33,10
Crusaders,1073,1,17,6,3,64,30,34,57
Coleraine,1073,2,14,11,1,45,24,21,53
Linfield,1073,3,11,5,10,40,37,3,38
Glenavon,1073,4,9,10,7,54,45,9,37
Cliftonville,1073,5,9,4,13,33,34,-1,31
Ballymena,1073,6,7,4,15,25,50,-25,25
Glentoran,1073,7,6,6,10,24,32,-8,24
Dungannon,1073,8,2,4,16,14,47,-33,10
Crusaders,1074,1,16,7,3,62,31,31,55
Coleraine,1074,2,14,10,2,43,24,19,52
Glenavon,1074,3,10,9,7,54,43,11,39
Linfield,1074,4,10,6,10,38,37,1,36
Cliftonville,1074,5,9,5,12,33,32,1,32
Ballymena,1074,6,7,5,14,26,48,-22,26
Glentoran,1074,7,6,6,10,24,32,-8,24
Dungannon,1074,8,2,4,16,14,47,-33,10
Crusaders,1075,1,16,7,3,62,31,31,55
Coleraine,1075,2,14,11,1,45,24,21,53
Linfield,1075,3,11,5,10,39,36,3,38
Glenavon,1075,4,9,10,7,54,45,9,37
Cliftonville,1075,5,9,4,13,32,33,-1,31
Ballymena,1075,6,7,5,14,26,48,-22,26
Glentoran,1075,7,6,6,10,24,32,-8,24
Dungannon,1075,8,2,4,16,14,47,-33,10
Crusaders,1076,1,16,6,4,61,32,29,54
Coleraine,1076,2,14,10,2,44,25,19,52
Glenavon,1076,3,10,9,7,55,44,11,39
Linfield,1076,4,11,5,10,39,36,3,38
Cliftonville,1076,5,9,4,13,32,33,-1,31
Ballymena,1076,6,8,4,14,27,47,-20,28
Glentoran,1076,7,6,6,10,24,32,-8,24
Dungannon,1076,8,2,4,16,14,47,-33,10
Crusaders,1077,1,17,6,3,63,30,33,57
Coleraine,1077,2,14,10,2,45,25,20,52
Glenavon,1077,3,10,9,7,55,45,10,39
Linfield,1077,4,11,5,10,38,36,2,38
Cliftonville,1077,5,9,4,13,32,32,0,31
Ballymena,1077,6,7,4,15,25,49,-24,25
Glentoran,1077,7,6,6,10,24,32,-8,24
Dungannon,1077,8,2,4,16,14,47,-33,10
Crusaders,1078,1,16,6,4,61,33,28,54
Coleraine,1078,2,14,10,2,45,26,19,52
Glenavon,1078,3,10,9,7,56,45,11,39
Linfield,1078,4,10,5,11,37,37,0,35
Cliftonville,1078,5,10,4,12,33,31,2,34
Ballymena,1078,6,8,4,14,28,47,-19,28
Glentoran,1078,7,6,6,10,24,32,-8,24
Dungannon,1078,8,2,4,16,14,47,-33,10
Crusaders,1079,1,17,6,3,63,30,33,57
Coleraine,1079,2,14,10,2,43,25,18,52
Glenavon,1079,3,10,9,7,55,43,12,39
Linfield,1079,4,10,5,11,38,39,-1,35
Cliftonville,1079,5,10,4,12,35,32,3,34
Ballymena,1079,6,7,4,15,25,49,-24,25
Glentoran,1079,7,6,6,10,24,32,-8,24
Dungannon,1079,8,2,4,16,14,47,-33,10
Crusaders,1080,1,17,6,3,65,33,32,57
Coleraine,1080,2,14,10,2,44,24,20,52
Glenavon,1080,3,10,9,7,54,44,10,39
Linfield,1080,4,10,5,11,38,38,0,35
Cliftonville,1080,5,10,4,12,34,32,2,34
Ballymena,1080,6,7,4,15,28,51,-23,25
Glentoran,1080,7,6,6,10,24,32,-8,24
Dungannon,1080,8,2,4,16,14,47,-33,10
Crusaders,1081,1,17,6,3,64,32,32,57
Coleraine,1081,2,14,10,2,43,23,20,52
Glenavon,1081,3,10,9,7,53,43,10,39
Linfield,1081,4,10,6,10,38,37,1,36
Cliftonville,1081,5,9,5,12,33,32,1,32
Ballymena,1081,6,7,4,15,27,50,-23,25
Glentoran,1081,7,6,6,10,24,32,-8,24
Dungannon,1081,8,2,4,16,14,47,-33,10
Crusaders,1082,1,16,7,3,62,31,31,55
Coleraine,1082,2,14,10,2,43,25,18,52
Glenavon,1082,3,10,9,7,55,43,12,39
Linfield,1082,4,10,6,10,40,39,1,36
Cliftonville,1082,5,9,5,12,35,34,1,32
Ballymena,1082,6,7,5,14,26,48,-22,26
Glentoran,1082,7,6,6,10,24,32,-8,24
Dungannon,1082,8,2,4,16,14,47,-33,10
Crusaders,1083,1,16,7,3,63,32,31,55
Coleraine,1083,2,15,10,1,44,22,22,55
Linfield,1083,3,11,5,10,40,38,2,38
Glenavon,1083,4,9,9,8,52,44,8,36
Cliftonville,1083,5,9,4,13,34,34,0,31
Ballymena,1083,6,7,5,14,27,49,-22,26
Glentoran,1083,7,6,6,10,24,32,-8,24
Dungannon,1083,8,2,4,16,14,47,-33,10
Crusaders,1084,1,17,6,3,63,31,32,57
Coleraine,1084,2,14,11,1,44,23,21,53
Linfield,1084,3,11,5,10,40,38,2,38
Glenavon,1084,4,9,10,7,53,44,9,37
Cliftonville,1084,5,9,4,13,34,34,0,31
Ballymena,1084,6,7,4,15,26,49,-23,25
Glentoran,1084,7,6,6,10,24,32,-8,24
Dungannon,1084,8,2,4,16,14,47,-33,10
Crusaders,1085,1,16,7,3,63,32,31,55
Coleraine,1085,2,14,10,2,44,25,19,52
Glenavon,1085,3,10,9,7,55,44,11,39
Linfield,1085,4,11,5,10,40,37,3,38
Cliftonville,1085,5,9,4,13,33,34,-1,31
Ballymena,1085,6,7,5,14,27,49,-22,26
Glentoran,1085,7,6,6,10,24,32,-8,24
Dungannon,1085,8,2,4,16,14,47,-33,10
Crusaders,1086,1,17,6,3,64,31,33,57
Coleraine,1086,2,15,10,1,45,23,22,55
Linfield,1086,3,11,5,10,38,36,2,38
Glenavon,1086,4,9,9,8,53,45,8,36
Cliftonville,1086,5,9,4,13,32,32,0,31
Ballymena,1086,6,7,4,15,26,50,-24,25
Glentoran,1086,7,6,6,10,24,32,-8,24
Dungannon,1086,8,2,4,16,14,47,-33,10
Crusaders,1087,1,17,6,3,64,30,34,57
Coleraine,1087,2,14,11,1,44,23,21,53
Glenavon,1087,3,9,10,7,53,44,9,37
Linfield,1087,4,10,5,11,37,37,0,35
Cliftonville,1087,5,10,4,12,33,31,2,34
Ballymena,1087,6,7,4,15,25,50,-25,25
Glentoran,1087,7,6,6,10,24,32,-8,24
Dungannon,1087,8,2,4,16,14,47,-33,10
Crusaders,1088,1,17,6,3,63,30,33,57
Coleraine,1088,2,15,10,1,47,22,25,55
Linfield,1088,3,11,5,10,38,36,2,38
Glenavon,1088,4,9,9,8,52,47,5,36
Cliftonville,1088,5,9,4,13,32,32,0,31
Ballymena,1088,6,7,4,15,25,49,-24,25
Glentoran,1088,7,6,6,10,24,32,-8,24
Dungannon,1088,8,2,4,16,14,47,-33,10
Crusaders,1089,1,16,6,4,61,33,28,54
Coleraine,1089,2,14,10,2,44,24,20,52
Glenavon,1089,3,10,9,7,54,44,10,39
Linfield,1089,4,11,5,10,39,36,3,38
Cliftonville,1089,5,9,4,13,32,33,-1,31
Ballymena,1089,6,8,4,14,28,47,-19,28
Glentoran,1089,7,6,6,10,24,32,-8,24
Dungannon,1089,8,2,4,16,14,47,-33,10
Crusaders,1090,1,17,6,3,64,31,33,57
Coleraine,1090,2,14,10,2,43,26,17,52
Glenavon,1090,3,10,9,7,56,43,13,39
Linfield,1090,4,11,5,10,39,37,2,38
Cliftonville,1090,5,9,4,13,33,33,0,31
Ballymena,1090,6,7,4,15,26,50,-24,25
Glentoran,1090,7,6,6,10,24,32,-8,24
Dungannon,1090,8,2,4,16,14,47,-33,10
Crusaders,1091,1,16,7,3,63,32,31,55
Coleraine,1091,2,15,10,1,45,22,23,55
Glenavon,1091,3,9,9,8,52,45,7,36
Linfield,1091,4,10,6,10,38,37,1,36
Cliftonville,1091,5,9,5,12,33,32,1,32
Ballymena,1091,6,7,5,14,27,49,-22,26
Glentoran,1091,7,6,6,10,24,32,-8,24
Dungannon,1091,8,2,4,16,14,47,-33,10
Crusaders,1092,1,16,7,3,63,32,31,55
Coleraine,1092,2,14,10,2,43,24,19,52
Glenavon,1092,3,10,9,7,54,43,11,39
Linfield,1092,4,11,5,10,39,37,2,38
Cliftonville,1092,5,9,4,13,33,33,0,31
Ballymena,1092,6,7,5,14,27,49,-22,26
Glentoran,1092,7,6,6,10,24,32,-8,24
Dungannon,1092,8,2,4,16,14,47,-33,10
Crusaders,1093,1,17,6,3,66,31,35,57
Coleraine,1093,2,14,10,2,43,25,18,52
Glenavon,1093,3,10,9,7,55,43,12,39
Linfield,1093,4,11,5,10,41,38,3,38
Cliftonville,1093,5,9,4,13,34,35,-1,31
Ballymena,1093,6,7,4,15,26,52,-26,25
Glentoran,1093,7,6,6,10,24,32,-8,24
Dungannon,1093,8,2,4,16,14,47,-33,10
Crusaders,1094,1,16,6,4,62,34,28,54
Coleraine,1094,2,14,11,1,44,23,21,53
Linfield,1094,3,11,5,10,39,37,2,38
Glenavon,1094,4,9,10,7,53,44,9,37
Cliftonville,1094,5,9,4,13,33,33,0,31
Ballymena,1094,6,8,4,14,29,48,-19,28
Glentoran,1094,7,6,6,10,24,32,-8,24
Dungannon,1094,8,2,4,16,14,47,-33,10
Crusaders,1095,1,16,7,3,62,31,31,55
Coleraine,1095,2,14,10,2,44,24,20,52
Glenavon,1095,3,10,9,7,54,44,10,39
Linfield,1095,4,10,6,10,40,39,1,36
Cliftonville,1095,5,9,5,12,35,34,1,32
Ballymena,1095,6,7,5,14,26,48,-22,26
Glentoran,1095,7,6,6,10,24,32,-8,24
Dungannon,1095,8,2,4,16,14,47,-33,10
Crusaders,1096,1,16,6,4,61,34,27,54
Coleraine,1096,2,14,11,1,45,24,21,53
Linfield,1096,3,11,5,10,38,36,2,38
Glenavon,1096,4,9,10,7,54,45,9,37
Cliftonville,1096,5,9,4,13,32,32,0,31
Ballymena,1096,6,8,4,14,29,47,-18,28
Glentoran,1096,7,6,6,10,24,32,-8,24
Dungannon,1096,8,2,4,16,14,47,-33,10
Crusaders,1097,1,17,6,3,63,30,33,57
Coleraine,1097,2,15,10,1,46,24,22,55
Glenavon,1097,3,9,9,8,54,46,8,36
Linfield,1097,4,10,5,11,37,38,-1,35
Cliftonville,1097,5,10,4,12,34,31,3,34
Ballymena,1097,6,7,4,15,25,49,-24,25
Glentoran,1097,7,6,6,10,24,32,-8,24
Dungannon,1097,8,2,4,16,14,47,-33,10
Crusaders,1098,1,16,6,4,63,33,30,54
Coleraine,1098,2,14,10,2,46,27,19,52
Glenavon,1098,3,10,9,7,57,46,11,39
Linfield,1098,4,11,5,10,40,37,3,38
Cliftonville,1098,5,9,4,13,33,34,-1,31
Ballymena,1098,6,8,4,14,28,49,-21,28
Glentoran,1098,7,6,6,10,24,32,-8,24
Dungannon,1098,8,2,4,16,14,47,-33,10
Crusaders,1099,1,16,6,4,61,31,30,54
Coleraine,1099,2,14,11,1,45,24,21,53
Linfield,1099,3,11,5,10,39,37,2,38
Glenavon,1099,4,9,10,7,54,45,9,37
Cliftonville,1099,5,9,4,13,33,33,0,31
Ballymena,1099,6,8,4,14,26,47,-21,28
Glentoran,1099,7,6,6,10,24,32,-8,24
Dungannon,1099,8,2,4,16,14,47,-33,10
Crusaders,1100,1,17,6,3,64,32,32,57
Coleraine,1100,2,14,11,1,44,23,21,53
Glenavon,1100,3,9,10,7,53,44,9,37
Linfield,1100,4,10,6,10,39,38,1,36
Cliftonville,1100,5,9,5,12,34,33,1,32
Ballymena,1100,6,7,4,15,27,50,-23,25
Glentoran,1100,7,6,6,10,24,32,-8,24
Dungannon,1100,8,2,4,16,14,47,-33,10
Crusaders,1101,1,17,6,3,63,30,33,57
Coleraine,1101,2,14,11,1,45,24,21,53
Linfield,1101,3,11,5,10,39,37,2,38
Glenavon,1101,4,9,10,7,54,45,9,37
Cliftonville,1101,5,9,4,13,33,33,0,31
Ballymena,1101,6,7,4,15,25,49,-24,25
Glentoran,1101,7,6,6,10,24,32,-8,24
Dungannon,1101,8,2,4,16,14,47,-33,10
Crusaders,1102,1,16,7,3,64,33,31,55
Coleraine,1102,2,14,10,2,44,25,19,52
Glenavon,1102,3,10,9,7,55,44,11,39
Linfield,1102,4,10,5,11,38,39,-1,35
Cliftonville,1102,5,10,4,12,35,32,3,34
Ballymena,1102,6,7,5,14,28,50,-22,26
Glentoran,1102,7,6,6,10,24,32,-8,24
Dungannon,1102,8,2,4,16,14,47,-33,10
Crusaders,1103,1,17,6,3,64,31,33,57
Coleraine,1103,2,14,11,1,43,22,21,53
Linfield,1103,3,11,5,10,42,36,6,38
Glenavon,1103,4,9,10,7,52,43,9,37
Cliftonville,1103,5,9,4,13,32,36,-4,31
Ballymena,1103,6,7,4,15,26,50,-24,25
Glentoran,1103,7,6,6,10,24,32,-8,24
Dungannon,1103,8,2,4,16,14,47,-33,10
Crusaders,1104,1,17,6,3,64,32,32,57
Coleraine,1104,2,14,11,1,44,23,21,53
Linfield,1104,3,11,5,10,38,36,2,38
Glenavon,1104,4,9,10,7,53,44,9,37
Cliftonville,1104,5,9,4,13,32,32,0,31
Ballymena,1104,6,7,4,15,27,50,-23,25
Glentoran,1104,7,6,6,10,24,32,-8,24
Dungannon,1104,8,2,4,16,14,47,-33,10
Crusaders,1105,1,17,6,3,66,32,34,57
Coleraine,1105,2,15,10,1,47,24,23,55
Glenavon,1105,3,9,9,8,54,47,7,36
Linfield,1105,4,10,5,11,39,39,0,35
Cliftonville,1105,5,10,4,12,35,33,2,34
Ballymena,1105,6,7,4,15,27,52,-25,25
Glentoran,1105,7,6,6,10,24,32,-8,24
Dungannon,1105,8,2,4,16,14,47,-33,10
Crusaders,1106,1,16,6,4,63,34,29,54
Coleraine,1106,2,14,10,2,45,26,19,52
Glenavon,1106,3,10,9,7,56,45,11,39
Linfield,1106,4,10,5,11,37,38,-1,35
Cliftonville,1106,5,10,4,12,34,31,3,34
Ballymena,1106,6,8,4,14,29,49,-20,28
Glentoran,1106,7,6,6,10,24,32,-8,24
Dungannon,1106,8,2,4,16,14,47,-33,10
Crusaders,1107,1,16,7,3,61,30,31,55
Coleraine,1107,2,15,10,1,45,23,22,55
Linfield,1107,3,11,5,10,39,37,2,38
Glenavon,1107,4,9,9,8,53,45,8,36
Cliftonville,1107,5,9,4,13,33,33,0,31
Ballymena,1107,6,7,5,14,25,47,-22,26
Glentoran,1107,7,6,6,10,24,32,-8,24
Dungannon,1107,8,2,4,16,14,47,-33,10
Crusaders,1108,1,17,6,3,64,30,34,57
Coleraine,1108,2,15,10,1,45,23,22,55
Glenavon,1108,3,9,9,8,53,45,8,36
Linfield,1108,4,10,5,11,37,37,0,35
Cliftonville,1108,5,10,4,12,33,31,2,34
Ballymena,1108,6,7,4,15,25,50,-25,25
Glentoran,1108,7,6,6,10,24,32,-8,24
Dungannon,1108,8,2,4,16,14,47,-33,10
Coleraine,1109,1,15,10,1,48,25,23,55
Crusaders,1109,2,16,6,4,61,33,28,54
Linfield,1109,3,11,5,10,38,36,2,38
Glenavon,1109,4,9,9,8,55,48,7,36
Cliftonville,1109,5,9,4,13,32,32,0,31
Ballymena,1109,6,8,4,14,28,47,-19,28
Glentoran,1109,7,6,6,10,24,32,-8,24
Dungannon,1109,8,2,4,16,14,47,-33,10
Crusaders,1110,1,17,6,3,65,31,34,57
Coleraine,1110,2,14,10,2,43,29,14,52
Glenavon,1110,3,10,9,7,59,43,16,39
Linfield,1110,4,10,5,11,39,39,0,35
Cliftonville,1110,5,10,4,12,35,33,2,34
Ballymena,1110,6,7,4,15,26,51,-25,25
Glentoran,1110,7,6,6,10,24,32,-8,24
Dungannon,1110,8,2,4,16,14,47,-33,10
Crusaders,1111,1,17,6,3,63,31,32,57
Coleraine,1111,2,14,10,2,44,26,18,52
Glenavon,1111,3,10,9,7,56,44,12,39
Linfield,1111,4,10,5,11,38,38,0,35
Cliftonville,1111,5,10,4,12,34,32,2,34
Ballymena,1111,6,7,4,15,26,49,-23,25
Glentoran,1111,7,6,6,10,24,32,-8,24
Dungannon,1111,8,2,4,16,14,47,-33,10
Crusaders,1112,1,17,6,3,67,32,35,57
Coleraine,1112,2,14,11,1,44,23,21,53
Linfield,1112,3,11,5,10,38,36,2,38
Glenavon,1112,4,9,10,7,53,44,9,37
Cliftonville,1112,5,9,4,13,32,32,0,31
Ballymena,1112,6,7,4,15,27,53,-26,25
Glentoran,1112,7,6,6,10,24,32,-8,24
Dungannon,1112,8,2,4,16,14,47,-33,10
Crusaders,1113,1,16,6,4,62,32,30,54
Coleraine,1113,2,14,11,1,43,22,21,53
Linfield,1113,3,11,5,10,41,39,2,38
Glenavon,1113,4,9,10,7,52,43,9,37
Cliftonville,1113,5,9,4,13,35,35,0,31
Ballymena,1113,6,8,4,14,27,48,-21,28
Glentoran,1113,7,6,6,10,24,32,-8,24
Dungannon,1113,8,2,4,16,14,47,-33,10
Crusaders,1114,1,16,6,4,61,34,27,54
Coleraine,1114,2,14,10,2,44,24,20,52
Glenavon,1114,3,10,9,7,54,44,10,39
Linfield,1114,4,10,6,10,39,38,1,36
Cliftonville,1114,5,9,5,12,34,33,1,32
Ballymena,1114,6,8,4,14,29,47,-18,28
Glentoran,1114,7,6,6,10,24,32,-8,24
Dungannon,1114,8,2,4,16,14,47,-33,10
Crusaders,1115,1,16,7,3,62,31,31,55
Coleraine,1115,2,14,10,2,44,24,20,52
Glenavon,1115,3,10,9,7,54,44,10,39
Linfield,1115,4,10,5,11,38,38,0,35
Cliftonville,1115,5,10,4,12,34,32,2,34
Ballymena,1115,6,7,5,14,26,48,-22,26
Glentoran,1115,7,6,6,10,24,32,-8,24
Dungannon,1115,8,2,4,16,14,47,-33,10
Crusaders,1116,1,17,6,3,65,32,33,57
Coleraine,1116,2,15,10,1,45,23,22,55
Linfield,1116,3,11,5,10,38,36,2,38
Glenavon,1116,4,9,9,8,53,45,8,36
Cliftonville,1116,5,9,4,13,32,32,0,31
Ballymena,1116,6,7,4,15,27,51,-24,25
Glentoran,1116,7,6,6,10,24,32,-8,24
Dungannon,1116,8,2,4,16,14,47,-33,10
Crusaders,1117,1,17,6,3,63,30,33,57
Coleraine,1117,2,14,10,2,44,25,19,52
Glenavon,1117,3,10,9,7,55,44,11,39
Linfield,1117,4,10,6,10,39,38,1,36
Cliftonville,1117,5,9,5,12,34,33,1,32
Ballymena,1117,6,7,4,15,25,49,-24,25
Glentoran,1117,7,6,6,10,24,32,-8,24
Dungannon,1117,8,2,4,16,14,47,-33,10
Crusaders,1118,1,17,6,3,64,31,33,57
Coleraine,1118,2,14,11,1,44,23,21,53
Linfield,1118,3,11,5,10,39,36,3,38
Glenavon,1118,4,9,10,7,53,44,9,37
Cliftonville,1118,5,9,4,13,32,33,-1,31
Ballymena,1118,6,7,4,15,26,50,-24,25
Glentoran,1118,7,6,6,10,24,32,-8,24
Dungannon,1118,8,2,4,16,14,47,-33,10
Crusaders,1119,1,16,7,3,63,32,31,55
Coleraine,1119,2,14,11,1,45,24,21,53
Glenavon,1119,3,9,10,7,54,45,9,37
Linfield,1119,4,10,5,11,38,39,-1,35
Cliftonville,1119,5,10,4,12,35,32,3,34
Ballymena,1119,6,7,5,14,27,49,-22,26
Glentoran,1119,7,6,6,10,24,32,-8,24
Dungannon,1119,8,2,4,16,14,47,-33,10
Crusaders,1120,1,17,6,3,65,31,34,57
Coleraine,1120,2,14,10,2,43,24,19,52
Glenavon,1120,3,10,9,7,54,43,11,39
Linfield,1120,4,11,5,10,39,36,3,38
Cliftonville,1120,5,9,4,13,32,33,-1,31
Ballymena,1120,6,7,4,15,26,51,-25,25
Glentoran,1120,7,6,6,10,24,32,-8,24
Dungannon,1120,8,2,4,16,14,47,-33,10
Crusaders,1121,1,16,7,3,62,31,31,55
Coleraine,1121,2,14,11,1,44,23,21,53
Glenavon,1121,3,9,10,7,53,44,9,37
Linfield,1121,4,10,5,11,40,40,0,35
Cliftonville,1121,5,10,4,12,36,34,2,34
Ballymena,1121,6,7,5,14,26,48,-22,26
Glentoran,1121,7,6,6,10,24,32,-8,24
Dungannon,1121,8,2,4,16,14,47,-33,10
Crusaders,1122,1,17,6,3,65,31,34,57
Coleraine,1122,2,14,10,2,43,24,19,52
Glenavon,1122,3,10,9,7,54,43,11,39
Linfield,1122,4,11,5,10,39,36,3,38
Cliftonville,1122,5,9,4,13,32,33,-1,31
Ballymena,1122,6,7,4,15,26,51,-25,25
Glentoran,1122,7,6,6,10,24,32,-8,24
Dungannon,1122,8,2,4,16,14,47,-33,10
Crusaders,1123,1,16,7,3,61,30,31,55
Coleraine,1123,2,14,11,1,44,23,21,53
Linfield,1123,3,11,5,10,40,37,3,38
Glenavon,1123,4,9,10,7,53,44,9,37
Cliftonville,1123,5,9,4,13,33,34,-1,31
Ballymena,1123,6,7,5,14,25,47,-22,26
Glentoran,1123,7,6,6,10,24,32,-8,24
Dungannon,1123,8,2,4,16,14,47,-33,10
Crusaders,1124,1,17,6,3,64,32,32,57
Coleraine,1124,2,14,11,1,45,24,21,53
Linfield,1124,3,11,5,10,38,36,2,38
Glenavon,1124,4,9,10,7,54,45,9,37
Cliftonville,1124,5,9,4,13,32,32,0,31
Ballymena,1124,6,7,4,15,27,50,-23,25
Glentoran,1124,7,6,6,10,24,32,-8,24
Dungannon,1124,8,2,4,16,14,47,-33,10
Crusaders,1125,1,16,7,3,62,31,31,55
Coleraine,1125,2,15,10,1,48,23,25,55
Linfield,1125,3,11,5,10,39,36,3,38
Glenavon,1125,4,9,9,8,53,48,5,36
Cliftonville,1125,5,9,4,13,32,33,-1,31
Ballymena,1125,6,7,5,14,26,48,-22,26
Glentoran,1125,7,6,6,10,24,32,-8,24
Dungannon,1125,8,2,4,16,14,47,-33,10
Crusaders,1126,1,16,7,3,62,31,31,55
Coleraine,1126,2,15,10,1,45,23,22,55
Glenavon,1126,3,9,9,8,53,45,8,36
Linfield,1126,4,10,6,10,38,37,1,36
Cliftonville,1126,5,9,5,12,33,32,1,32
Ballymena,1126,6,7,5,14,26,48,-22,26
Glentoran,1126,7,6,6,10,24,32,-8,24
Dungannon,1126,8,2,4,16,14,47,-33,10
Crusaders,1127,1,16,7,3,62,31,31,55
Coleraine,1127,2,15,10,1,46,22,24,55
Linfield,1127,3,11,5,10,40,37,3,38
Glenavon,1127,4,9,9,8,52,46,6,36
Cliftonville,1127,5,9,4,13,33,34,-1,31
Ballymena,1127,6,7,5,14,26,48,-22,26
Glentoran,1127,7,6,6,10,24,32,-8,24
Dungannon,1127,8,2,4,16,14,47,-33,10
Crusaders,1128,1,16,6,4,61,31,30,54
Coleraine,1128,2,14,10,2,43,23,20,52
Glenavon,1128,3,10,9,7,53,43,10,39
Linfield,1128,4,11,5,10,39,37,2,38
Cliftonville,1128,5,9,4,13,33,33,0,31
Ballymena,1128,6,8,4,14,26,47,-21,28
Glentoran,1128,7,6,6,10,24,32,-8,24
Dungannon,1128,8,2,4,16,14,47,-33,10
Crusaders,1129,1,16,6,4,63,34,29,54
Coleraine,1129,2,14,11,1,46,25,21,53
Linfield,1129,3,11,5,10,39,36,3,38
Glenavon,1129,4,9,10,7,55,46,9,37
Cliftonville,1129,5,9,4,13,32,33,-1,31
Ballymena,1129,6,8,4,14,29,49,-20,28
Glentoran,1129,7,6,6,10,24,32,-8,24
Dungannon,1129,8,2,4,16,14,47,-33,10
Crusaders,1130,1,17,6,3,66,31,35,57
Coleraine,1130,2,14,10,2,43,24,19,52
Glenavon,1130,3,10,9,7,54,43,11,39
Linfield,1130,4,10,6,10,38,37,1,36
Cliftonville,1130,5,9,5,12,33,32,1,32
Ballymena,1130,6,7,4,15,26,52,-26,25
Glentoran,1130,7,6,6,10,24,32,-8,24
Dungannon,1130,8,2,4,16,14,47,-33,10
Crusaders,1131,1,16,6,4,61,31,30,54
Coleraine,1131,2,14,10,2,46,26,20,52
Glenavon,1131,3,10,9,7,56,46,10,39
Linfield,1131,4,11,5,10,39,36,3,38
Cliftonville,1131,5,9,4,13,32,33,-1,31
Ballymena,1131,6,8,4,14,26,47,-21,28
Glentoran,1131,7,6,6,10,24,32,-8,24
Dungannon,1131,8,2,4,16,14,47,-33,10
Crusaders,1132,1,17,6,3,64,31,33,57
Coleraine,1132,2,15,10,1,46,23,23,55
Linfield,1132,3,11,5,10,39,37,2,38
Glenavon,1132,4,9,9,8,53,46,7,36
Cliftonville,1132,5,9,4,13,33,33,0,31
Ballymena,1132,6,7,4,15,26,50,-24,25
Glentoran,1132,7,6,6,10,24,32,-8,24
Dungannon,1132,8,2,4,16,14,47,-33,10
Crusaders,1133,1,17,6,3,62,30,32,57
Coleraine,1133,2,14,10,2,43,23,20,52
Glenavon,1133,3,10,9,7,53,43,10,39
Linfield,1133,4,10,5,11,37,38,-1,35
Cliftonville,1133,5,10,4,12,34,31,3,34
Ballymena,1133,6,7,4,15,25,48,-23,25
Glentoran,1133,7,6,6,10,24,32,-8,24
Dungannon,1133,8,2,4,16,14,47,-33,10
Crusaders,1134,1,16,6,4,61,32,29,54
Coleraine,1134,2,14,10,2,43,28,15,52
Glenavon,1134,3,10,9,7,58,43,15,39
Linfield,1134,4,11,5,10,38,36,2,38
Cliftonville,1134,5,9,4,13,32,32,0,31
Ballymena,1134,6,8,4,14,27,47,-20,28
Glentoran,1134,7,6,6,10,24,32,-8,24
Dungannon,1134,8,2,4,16,14,47,-33,10
Crusaders,1135,1,17,6,3,65,31,34,57
Coleraine,1135,2,14,10,2,43,26,17,52
Glenavon,1135,3,10,9,7,56,43,13,39
Linfield,1135,4,10,5,11,37,39,-2,35
Cliftonville,1135,5,10,4,12,35,31,4,34
Ballymena,1135,6,7,4,15,26,51,-25,25
Glentoran,1135,7,6,6,10,24,32,-8,24
Dungannon,1135,8,2,4,16,14,47,-33,10
Crusaders,1136,1,16,6,4,61,33,28,54
Coleraine,1136,2,14,10,2,45,25,20,52
Glenavon,1136,3,10,9,7,55,45,10,39
Linfield,1136,4,10,5,11,37,37,0,35
Cliftonville,1136,5,10,4,12,33,31,2,34
Ballymena,1136,6,8,4,14,28,47,-19,28
Glentoran,1136,7,6,6,10,24,32,-8,24
Dungannon,1136,8,2,4,16,14,47,-33,10
Crusaders,1137,1,17,6,3,63,31,32,57
Coleraine,1137,2,15,10,1,46,24,22,55
Glenavon,1137,3,9,9,8,54,46,8,36
Linfield,1137,4,10,5,11,37,37,0,35
Cliftonville,1137,5,10,4,12,33,31,2,34
Ballymena,1137,6,7,4,15,26,49,-23,25
Glentoran,1137,7,6,6,10,24,32,-8,24
Dungannon,1137,8,2,4,16,14,47,-33,10
Crusaders,1138,1,17,6,3,65,32,33,57
Coleraine,1138,2,14,10,2,43,24,19,52
Glenavon,1138,3,10,9,7,54,43,11,39
Linfield,1138,4,11,5,10,38,36,2,38
Cliftonville,1138,5,9,4,13,32,32,0,31
Ballymena,1138,6,7,4,15,27,51,-24,25
Glentoran,1138,7,6,6,10,24,32,-8,24
Dungannon,1138,8,2,4,16,14,47,-33,10
Crusaders,1139,1,17,6,3,64,31,33,57
Coleraine,1139,2,15,10,1,47,23,24,55
Linfield,1139,3,11,5,10,38,36,2,38
Glenavon,1139,4,9,9,8,53,47,6,36
Cliftonville,1139,5,9,4,13,32,32,0,31
Ballymena,1139,6,7,4,15,26,50,-24,25
Glentoran,1139,7,6,6,10,24,32,-8,24
Dungannon,1139,8,2,4,16,14,47,-33,10
Crusaders,1140,1,17,6,3,66,31,35,57
Coleraine,1140,2,14,10,2,47,27,20,52
Glenavon,1140,3,10,9,7,57,47,10,39
Linfield,1140,4,10,5,11,38,39,-1,35
Cliftonville,1140,5,10,4,12,35,32,3,34
Ballymena,1140,6,7,4,15,26,52,-26,25
Glentoran,1140,7,6,6,10,24,32,-8,24
Dungannon,1140,8,2,4,16,14,47,-33,10
Crusaders,1141,1,16,6,4,61,32,29,54
Coleraine,1141,2,14,11,1,43,22,21,53
Linfield,1141,3,11,5,10,38,36,2,38
Glenavon,1141,4,9,10,7,52,43,9,37
Cliftonville,1141,5,9,4,13,32,32,0,31
Ballymena,1141,6,8,4,14,27,47,-20,28
Glentoran,1141,7,6,6,10,24,32,-8,24
Dungannon,1141,8,2,4,16,14,47,-33,10
Crusaders,1142,1,17,6,3,64,31,33,57
Coleraine,1142,2,15,10,1,46,22,24,55
Glenavon,1142,3,9,9,8,52,46,6,36
Linfield,1142,4,10,6,10,38,37,1,36
Cliftonville,1142,5,9,5,12,33,32,1,32
Ballymena,1142,6,7,4,15,26,50,-24,25
Glentoran,1142,7,6,6,10,24,32,-8,24
Dungannon,1142,8,2,4,16,14,47,-33,10
Crusaders,1143,1,16,7,3,63,32,31,55
Coleraine,1143,2,14,11,1,45,24,21,53
Glenavon,1143,3,9,10,7,54,45,9,37
Linfield,1143,4,10,6,10,39,38,1,36
Cliftonville,1143,5,9,5,12,34,33,1,32
Ballymena,1143,6,7,5,14,27,49,-22,26
Glentoran,1143,7,6,6,10,24,32,-8,24
Dungannon,1143,8,2,4,16,14,47,-33,10
Crusaders,1144,1,17,6,3,63,30,33,57
Coleraine,1144,2,14,10,2,44,24,20,52
Glenavon,1144,3,10,9,7,54,44,10,39
Linfield,1144,4,11,5,10,41,39,2,38
Cliftonville,1144,5,9,4,13,35,35,0,31
Ballymena,1144,6,7,4,15,25,49,-24,25
Glentoran,1144,7,6,6,10,24,32,-8,24
Dungannon,1144,8,2,4,16,14,47,-33,10
Crusaders,1145,1,16,6,4,61,31,30,54
Coleraine,1145,2,14,10,2,43,23,20,52
Glenavon,1145,3,10,9,7,53,43,10,39
Linfield,1145,4,10,6,10,38,37,1,36
Cliftonville,1145,5,9,5,12,33,32,1,32
Ballymena,1145,6,8,4,14,26,47,-21,28
Glentoran,1145,7,6,6,10,24,32,-8,24
Dungannon,1145,8,2,4,16,14,47,-33,10
Crusaders,1146,1,17,6,3,64,30,34,57
Coleraine,1146,2,14,10,2,45,26,19,52
Glenavon,1146,3,10,9,7,56,45,11,39
Linfield,1146,4,10,5,11,37,38,-1,35
Cliftonville,1146,5,10,4,12,34,31,3,34
Ballymena,1146,6,7,4,15,25,50,-25,25
Glentoran,1146,7,6,6,10,24,32,-8,24
Dungannon,1146,8,2,4,16,14,47,-33,10
Crusaders,1147,1,16,6,4,62,32,30,54
Coleraine,1147,2,14,11,1,44,23,21,53
Glenavon,1147,3,9,10,7,53,44,9,37
Linfield,1147,4,10,6,10,37,36,1,36
Cliftonville,1147,5,9,5,12,32,31,1,32
Ballymena,1147,6,8,4,14,27,48,-21,28
Glentoran,1147,7,6,6,10,24,32,-8,24
Dungannon,1147,8,2,4,16,14,47,-33,10
Crusaders,1148,1,16,7,3,63,32,31,55
Coleraine,1148,2,15,10,1,45,22,23,55
Linfield,1148,3,11,5,10,38,36,2,38
Glenavon,1148,4,9,9,8,52,45,7,36
Cliftonville,1148,5,9,4,13,32,32,0,31
Ballymena,1148,6,7,5,14,27,49,-22,26
Glentoran,1148,7,6,6,10,24,32,-8,24
Dungannon,1148,8,2,4,16,14,47,-33,10
Crusaders,1149,1,17,6,3,63,31,32,57
Coleraine,1149,2,14,10,2,43,25,18,52
Glenavon,1149,3,10,9,7,55,43,12,39
Linfield,1149,4,10,5,11,37,38,-1,35
Cliftonville,1149,5,10,4,12,34,31,3,34
Ballymena,1149,6,7,4,15,26,49,-23,25
Glentoran,1149,7,6,6,10,24,32,-8,24
Dungannon,1149,8,2,4,16,14,47,-33,10
Crusaders,1150,1,16,6,4,62,32,30,54
Coleraine,1150,2,14,11,1,45,24,21,53
Glenavon,1150,3,9,10,7,54,45,9,37
Linfield,1150,4,10,6,10,37,36,1,36
Cliftonville,1150,5,9,5,12,32,31,1,32
Ballymena,1150,6,8,4,14,27,48,-21,28
Glentoran,1150,7,6,6,10,24,32,-8,24
Dungannon,1150,8,2,4,16,14,47,-33,10
Crusaders,1151,1,17,6,3,64,31,33,57
Coleraine,1151,2,14,10,2,45,25,20,52
Glenavon,1151,3,10,9,7,55,45,10,39
Linfield,1151,4,10,5,11,38,38,0,35
Cliftonville,1151,5,10,4,12,34,32,2,34
Ballymena,1151,6,7,4,15,26,50,-24,25
Glentoran,1151,7,6,6,10,24,32,-8,24
Dungannon,1151,8,2,4,16,14,47,-33,10
Crusaders,1152,1,17,6,3,64,31,33,57
Coleraine,1152,2,15,10,1,44,22,22,55
Glenavon,1152,3,9,9,8,52,44,8,36
Linfield,1152,4,10,6,10,38,37,1,36
Cliftonville,1152,5,9,5,12,33,32,1,32
Ballymena,1152,6,7,4,15,26,50,-24,25
Glentoran,1152,7,6,6,10,24,32,-8,24
Dungannon,1152,8,2,4,16,14,47,-33,10
Crusaders,1153,1,16,7,3,63,32,31,55
Coleraine,1153,2,14,10,2,43,23,20,52
Glenavon,1153,3,10,9,7,53,43,10,39
Linfield,1153,4,11,5,10,38,36,2,38
Cliftonville,1153,5,9,4,13,32,32,0,31
Ballymena,1153,6,7,5,14,27,49,-22,26
Glentoran,1153,7,6,6,10,24,32,-8,24
Dungannon,1153,8,2,4,16,14,47,-33,10
Crusaders,1154,1,17,6,3,64,31,33,57
Coleraine,1154,2,14,10,2,44,27,17,52
Glenavon,1154,3,10,9,7,57,44,13,39
Linfield,1154,4,11,5,10,39,37,2,38
Cliftonville,1154,5,9,4,13,33,33,0,31
Ballymena,1154,6,7,4,15,26,50,-24,25
Glentoran,1154,7,6,6,10,24,32,-8,24
Dungannon,1154,8,2,4,16,14,47,-33,10
Crusaders,1155,1,17,6,3,64,30,34,57
Coleraine,1155,2,15,10,1,45,22,23,55
Glenavon,1155,3,9,9,8,52,45,7,36
Linfield,1155,4,10,6,10,39,38,1,36
Cliftonville,1155,5,9,5,12,34,33,1,32
Ballymena,1155,6,7,4,15,25,50,-25,25
Glentoran,1155,7,6,6,10,24,32,-8,24
Dungannon,1155,8,2,4,16,14,47,-33,10
Crusaders,1156,1,16,7,3,63,32,31,55
Coleraine,1156,2,14,10,2,43,24,19,52
Glenavon,1156,3,10,9,7,54,43,11,39
Linfield,1156,4,10,6,10,39,38,1,36
Cliftonville,1156,5,9,5,12,34,33,1,32
Ballymena,1156,6,7,5,14,27,49,-22,26
Glentoran,1156,7,6,6,10,24,32,-8,24
Dungannon,1156,8,2,4,16,14,47,-33,10
Crusaders,1157,1,17,6,3,63,31,32,57
Coleraine,1157,2,14,10,2,43,23,20,52
Glenavon,1157,3,10,9,7,53,43,10,39
Linfield,1157,4,11,5,10,40,36,4,38
Cliftonville,1157,5,9,4,13,32,34,-2,31
Ballymena,1157,6,7,4,15,26,49,-23,25
Glentoran,1157,7,6,6,10,24,32,-8,24
Dungannon,1157,8,2,4,16,14,47,-33,10
Crusaders,1158,1,17,6,3,64,31,33,57
Coleraine,1158,2,15,10,1,46,22,24,55
Glenavon,1158,3,9,9,8,52,46,6,36
Linfield,1158,4,10,5,11,38,38,0,35
Cliftonville,1158,5,10,4,12,34,32,2,34
Ballymena,1158,6,7,4,15,26,50,-24,25
Glentoran,1158,7,6,6,10,24,32,-8,24
Dungannon,1158,8,2,4,16,14,47,-33,10
Crusaders,1159,1,17,6,3,64,32,32,57
Coleraine,1159,2,14,11,1,44,23,21,53
Glenavon,1159,3,9,10,7,53,44,9,37
Linfield,1159,4,10,5,11,37,38,-1,35
Cliftonville,1159,5,10,4,12,34,31,3,34
Ballymena,1159,6,7,4,15,27,50,-23,25
Glentoran,1159,7,6,6,10,24,32,-8,24
Dungannon,1159,8,2,4,16,14,47,-33,10
Crusaders,1160,1,17,6,3,66,32,34,57
Coleraine,1160,2,15,10,1,44,22,22,55
Glenavon,1160,3,9,9,8,52,44,8,36
Linfield,1160,4,10,6,10,38,37,1,36
Cliftonville,1160,5,9,5,12,33,32,1,32
Ballymena,1160,6,7,4,15,27,52,-25,25
Glentoran,1160,7,6,6,10,24,32,-8,24
Dungannon,1160,8,2,4,16,14,47,-33,10
Crusaders,1161,1,17,6,3,64,32,32,57
Coleraine,1161,2,14,11,1,44,23,21,53
Glenavon,1161,3,9,10,7,53,44,9,37
Linfield,1161,4,10,5,11,37,37,0,35
Cliftonville,1161,5,10,4,12,33,31,2,34
Ballymena,1161,6,7,4,15,27,50,-23,25
Glentoran,1161,7,6,6,10,24,32,-8,24
Dungannon,1161,8,2,4,16,14,47,-33,10
Crusaders,1162,1,17,6,3,62,30,32,57
Coleraine,1162,2,14,10,2,43,24,19,52
Glenavon,1162,3,10,9,7,54,43,11,39
Linfield,1162,4,11,5,10,38,36,2,38
Cliftonville,1162,5,9,4,13,32,32,0,31
Ballymena,1162,6,7,4,15,25,48,-23,25
Glentoran,1162,7,6,6,10,24,32,-8,24
Dungannon,1162,8,2,4,16,14,47,-33,10
Crusaders,1163,1,17,6,3,63,30,33,57
Coleraine,1163,2,14,10,2,43,25,18,52
Glenavon,1163,3,10,9,7,55,43,12,39
Linfield,1163,4,11,5,10,40,36,4,38
Cliftonville,1163,5,9,4,13,32,34,-2,31
Ballymena,1163,6,7,4,15,25,49,-24,25
Glentoran,1163,7,6,6,10,24,32,-8,24
Dungannon,1163,8,2,4,16,14,47,-33,10
Crusaders,1164,1,17,6,3,63,30,33,57
Coleraine,1164,2,15,10,1,45,23,22,55
Glenavon,1164,3,9,9,8,53,45,8,36
Linfield,1164,4,10,5,11,37,37,0,35
Cliftonville,1164,5,10,4,12,33,31,2,34
Ballymena,1164,6,7,4,15,25,49,-24,25
Glentoran,1164,7,6,6,10,24,32,-8,24
Dungannon,1164,8,2,4,16,14,47,-33,10
Crusaders,1165,1,17,6,3,62,30,32,57
Coleraine,1165,2,15,10,1,47,25,22,55
Linfield,1165,3,11,5,10,38,36,2,38
Glenavon,1165,4,9,9,8,55,47,8,36
Cliftonville,1165,5,9,4,13,32,32,0,31
Ballymena,1165,6,7,4,15,25,48,-23,25
Glentoran,1165,7,6,6,10,24,32,-8,24
Dungannon,1165,8,2,4,16,14,47,-33,10
Crusaders,1166,1,17,6,3,65,31,34,57
Coleraine,1166,2,15,10,1,44,22,22,55
Linfield,1166,3,11,5,10,38,36,2,38
Glenavon,1166,4,9,9,8,52,44,8,36
Cliftonville,1166,5,9,4,13,32,32,0,31
Ballymena,1166,6,7,4,15,26,51,-25,25
Glentoran,1166,7,6,6,10,24,32,-8,24
Dungannon,1166,8,2,4,16,14,47,-33,10
Crusaders,1167,1,16,7,3,61,30,31,55
Coleraine,1167,2,14,11,1,45,24,21,53
Linfield,1167,3,11,5,10,39,37,2,38
Glenavon,1167,4,9,10,7,54,45,9,37
Cliftonville,1167,5,9,4,13,33,33,0,31
Ballymena,1167,6,7,5,14,25,47,-22,26
Glentoran,1167,7,6,6,10,24,32,-8,24
Dungannon,1167,8,2,4,16,14,47,-33,10
Crusaders,1168,1,17,6,3,63,31,32,57
Coleraine,1168,2,14,10,2,43,23,20,52
Glenavon,1168,3,10,9,7,53,43,10,39
Linfield,1168,4,10,5,11,37,37,0,35
Cliftonville,1168,5,10,4,12,33,31,2,34
Ballymena,1168,6,7,4,15,26,49,-23,25
Glentoran,1168,7,6,6,10,24,32,-8,24
Dungannon,1168,8,2,4,16,14,47,-33,10
Crusaders,1169,1,16,7,3,63,32,31,55
Coleraine,1169,2,14,10,2,47,27,20,52
Glenavon,1169,3,10,9,7,57,47,10,39
Linfield,1169,4,10,6,10,40,39,1,36
Cliftonville,1169,5,9,5,12,35,34,1,32
Ballymena,1169,6,7,5,14,27,49,-22,26
Glentoran,1169,7,6,6,10,24,32,-8,24
Dungannon,1169,8,2,4,16,14,47,-33,10
Crusaders,1170,1,17,6,3,67,31,36,57
Coleraine,1170,2,14,11,1,46,25,21,53
Glenavon,1170,3,9,10,7,55,46,9,37
Linfield,1170,4,10,6,10,37,36,1,36
Cliftonville,1170,5,9,5,12,32,31,1,32
Ballymena,1170,6,7,4,15,26,53,-27,25
Glentoran,1170,7,6,6,10,24,32,-8,24
Dungannon,1170,8,2,4,16,14,47,-33,10
Crusaders,1171,1,16,7,3,62,31,31,55
Coleraine,1171,2,14,11,1,46,25,21,53
Linfield,1171,3,11,5,10,40,38,2,38
Glenavon,1171,4,9,10,7,55,46,9,37
Cliftonville,1171,5,9,4,13,34,34,0,31
Ballymena,1171,6,7,5,14,26,48,-22,26
Glentoran,1171,7,6,6,10,24,32,-8,24
Dungannon,1171,8,2,4,16,14,47,-33,10
Crusaders,1172,1,16,6,4,61,32,29,54
Coleraine,1172,2,14,10,2,45,25,20,52
Glenavon,1172,3,10,9,7,55,45,10,39
Linfield,1172,4,10,5,11,37,37,0,35
Cliftonville,1172,5,10,4,12,33,31,2,34
Ballymena,1172,6,8,4,14,27,47,-20,28
Glentoran,1172,7,6,6,10,24,32,-8,24
Dungannon,1172,8,2,4,16,14,47,-33,10
Crusaders,1173,1,17,6,3,63,30,33,57
Coleraine,1173,2,14,10,2,44,24,20,52
Glenavon,1173,3,10,9,7,54,44,10,39
Linfield,1173,4,11,5,10,39,37,2,38
Cliftonville,1173,5,9,4,13,33,33,0,31
Ballymena,1173,6,7,4,15,25,49,-24,25
Glentoran,1173,7,6,6,10,24,32,-8,24
Dungannon,1173,8,2,4,16,14,47,-33,10
Crusaders,1174,1,16,6,4,62,34,28,54
Coleraine,1174,2,14,10,2,44,24,20,52
Glenavon,1174,3,10,9,7,54,44,10,39
Linfield,1174,4,11,5,10,38,36,2,38
Cliftonville,1174,5,9,4,13,32,32,0,31
Ballymena,1174,6,8,4,14,29,48,-19,28
Glentoran,1174,7,6,6,10,24,32,-8,24
Dungannon,1174,8,2,4,16,14,47,-33,10
Crusaders,1175,1,16,7,3,65,34,31,55
Coleraine,1175,2,14,11,1,44,23,21,53
Glenavon,1175,3,9,10,7,53,44,9,37
Linfield,1175,4,10,5,11,38,38,0,35
Cliftonville,1175,5,10,4,12,34,32,2,34
Ballymena,1175,6,7,5,14,29,51,-22,26
Glentoran,1175,7,6,6,10,24,32,-8,24
Dungannon,1175,8,2,4,16,14,47,-33,10
Crusaders,1176,1,16,6,4,62,32,30,54
Coleraine,1176,2,14,10,2,44,26,18,52
Glenavon,1176,3,10,9,7,56,44,12,39
Linfield,1176,4,10,6,10,38,37,1,36
Cliftonville,1176,5,9,5,12,33,32,1,32
Ballymena,1176,6,8,4,14,27,48,-21,28
Glentoran,1176,7,6,6,10,24,32,-8,24
Dungannon,1176,8,2,4,16,14,47,-33,10
Crusaders,1177,1,16,7,3,61,30,31,55
Coleraine,1177,2,14,10,2,46,26,20,52
Glenavon,1177,3,10,9,7,56,46,10,39
Linfield,1177,4,11,5,10,38,36,2,38
Cliftonville,1177,5,9,4,13,32,32,0,31
Ballymena,1177,6,7,5,14,25,47,-22,26
Glentoran,1177,7,6,6,10,24,32,-8,24
Dungannon,1177,8,2,4,16,14,47,-33,10
Crusaders,1178,1,16,7,3,61,30,31,55
Coleraine,1178,2,14,10,2,44,25,19,52
Glenavon,1178,3,10,9,7,55,44,11,39
Linfield,1178,4,11,5,10,39,36,3,38
Cliftonville,1178,5,9,4,13,32,33,-1,31
Ballymena,1178,6,7,5,14,25,47,-22,26
Glentoran,1178,7,6,6,10,24,32,-8,24
Dungannon,1178,8,2,4,16,14,47,-33,10
Crusaders,1179,1,17,6,3,65,32,33,57
Coleraine,1179,2,15,10,1,45,22,23,55
Linfield,1179,3,11,5,10,38,36,2,38
Glenavon,1179,4,9,9,8,52,45,7,36
Cliftonville,1179,5,9,4,13,32,32,0,31
Ballymena,1179,6,7,4,15,27,51,-24,25
Glentoran,1179,7,6,6,10,24,32,-8,24
Dungannon,1179,8,2,4,16,14,47,-33,10
Crusaders,1180,1,17,6,3,64,31,33,57
Coleraine,1180,2,15,10,1,45,22,23,55
Linfield,1180,3,11,5,10,39,36,3,38
Glenavon,1180,4,9,9,8,52,45,7,36
Cliftonville,1180,5,9,4,13,32,33,-1,31
Ballymena,1180,6,7,4,15,26,50,-24,25
Glentoran,1180,7,6,6,10,24,32,-8,24
Dungannon,1180,8,2,4,16,14,47,-33,10
Crusaders,1181,1,17,6,3,63,30,33,57
Coleraine,1181,2,14,10,2,45,27,18,52
Glenavon,1181,3,10,9,7,57,45,12,39
Linfield,1181,4,11,5,10,39,37,2,38
Cliftonville,1181,5,9,4,13,33,33,0,31
Ballymena,1181,6,7,4,15,25,49,-24,25
Glentoran,1181,7,6,6,10,24,32,-8,24
Dungannon,1181,8,2,4,16,14,47,-33,10
Crusaders,1182,1,17,6,3,63,31,32,57
Coleraine,1182,2,14,10,2,44,26,18,52
Glenavon,1182,3,10,9,7,56,44,12,39
Linfield,1182,4,11,5,10,40,36,4,38
Cliftonville,1182,5,9,4,13,32,34,-2,31
Ballymena,1182,6,7,4,15,26,49,-23,25
Glentoran,1182,7,6,6,10,24,32,-8,24
Dungannon,1182,8,2,4,16,14,47,-33,10
Crusaders,1183,1,17,6,3,62,30,32,57
Coleraine,1183,2,15,10,1,44,22,22,55
Glenavon,1183,3,9,9,8,52,44,8,36
Linfield,1183,4,10,5,11,39,39,0,35
Cliftonville,1183,5,10,4,12,35,33,2,34
Ballymena,1183,6,7,4,15,25,48,-23,25
Glentoran,1183,7,6,6,10,24,32,-8,24
Dungannon,1183,8,2,4,16,14,47,-33,10
Crusaders,1184,1,17,6,3,62,30,32,57
Coleraine,1184,2,14,10,2,44,25,19,52
Glenavon,1184,3,10,9,7,55,44,11,39
Linfield,1184,4,10,6,10,38,37,1,36
Cliftonville,1184,5,9,5,12,33,32,1,32
Ballymena,1184,6,7,4,15,25,48,-23,25
Glentoran,1184,7,6,6,10,24,32,-8,24
Dungannon,1184,8,2,4,16,14,47,-33,10
Crusaders,1185,1,17,6,3,63,31,32,57
Coleraine,1185,2,14,10,2,43,24,19,52
Glenavon,1185,3,10,9,7,54,43,11,39
Linfield,1185,4,10,6,10,39,38,1,36
Cliftonville,1185,5,9,5,12,34,33,1,32
Ballymena,1185,6,7,4,15,26,49,-23,25
Glentoran,1185,7,6,6,10,24,32,-8,24
Dungannon,1185,8,2,4,16,14,47,-33,10
Crusaders,1186,1,17,6,3,63,31,32,57
Coleraine,1186,2,14,10,2,43,26,17,52
Glenavon,1186,3,10,9,7,56,43,13,39
Linfield,1186,4,11,5,10,39,37,2,38
Cliftonville,1186,5,9,4,13,33,33,0,31
Ballymena,1186,6,7,4,15,26,49,-23,25
Glentoran,1186,7,6,6,10,24,32,-8,24
Dungannon,1186,8,2,4,16,14,47,-33,10
Crusaders,1187,1,17,6,3,63,30,33,57
Coleraine,1187,2,14,10,2,45,26,19,52
Glenavon,1187,3,10,9,7,56,45,11,39
Linfield,1187,4,10,6,10,37,36,1,36
Cliftonville,1187,5,9,5,12,32,31,1,32
Ballymena,1187,6,7,4,15,25,49,-24,25
Glentoran,1187,7,6,6,10,24,32,-8,24
Dungannon,1187,8,2,4,16,14,47,-33,10
Crusaders,1188,1,17,6,3,64,32,32,57
Coleraine,1188,2,14,10,2,44,25,19,52
Glenavon,1188,3,10,9,7,55,44,11,39
Linfield,1188,4,10,6,10,38,37,1,36
Cliftonville,1188,5,9,5,12,33,32,1,32
Ballymena,1188,6,7,4,15,27,50,-23,25
Glentoran,1188,7,6,6,10,24,32,-8,24
Dungannon,1188,8,2,4,16,14,47,-33,10
Coleraine,1189,1,15,10,1,47,22,25,55
Crusaders,1189,2,16,6,4,61,31,30,54
Glenavon,1189,3,9,9,8,52,47,5,36
Linfield,1189,4,10,5,11,40,40,0,35
Cliftonville,1189,5,10,4,12,36,34,2,34
Ballymena,1189,6,8,4,14,26,47,-21,28
Glentoran,1189,7,6,6,10,24,32,-8,24
Dungannon,1189,8,2,4,16,14,47,-33,10
Crusaders,1190,1,17,6,3,64,32,32,57
Coleraine,1190,2,15,10,1,46,23,23,55
Linfield,1190,3,11,5,10,39,37,2,38
Glenavon,1190,4,9,9,8,53,46,7,36
Cliftonville,1190,5,9,4,13,33,33,0,31
Ballymena,1190,6,7,4,15,27,50,-23,25
Glentoran,1190,7,6,6,10,24,32,-8,24
Dungannon,1190,8,2,4,16,14,47,-33,10
Crusaders,1191,1,17,6,3,63,31,32,57
Coleraine,1191,2,14,10,2,45,26,19,52
Glenavon,1191,3,10,9,7,56,45,11,39
Linfield,1191,4,11,5,10,39,37,2,38
Cliftonville,1191,5,9,4,13,33,33,0,31
Ballymena,1191,6,7,4,15,26,49,-23,25
Glentoran,1191,7,6,6,10,24,32,-8,24
Dungannon,1191,8,2,4,16,14,47,-33,10
Crusaders,1192,1,16,6,4,62,32,30,54
Coleraine,1192,2,14,11,1,44,23,21,53
Glenavon,1192,3,9,10,7,53,44,9,37
Linfield,1192,4,10,6,10,38,37,1,36
Cliftonville,1192,5,9,5,12,33,32,1,32
Ballymena,1192,6,8,4,14,27,48,-21,28
Glentoran,1192,7,6,6,10,24,32,-8,24
Dungannon,1192,8,2,4,16,14,47,-33,10
Crusaders,1193,1,16,6,4,62,32,30,54
Coleraine,1193,2,14,10,2,44,24,20,52
Glenavon,1193,3,10,9,7,54,44,10,39
Linfield,1193,4,11,5,10,38,36,2,38
Cliftonville,1193,5,9,4,13,32,32,0,31
Ballymena,1193,6,8,4,14,27,48,-21,28
Glentoran,1193,7,6,6,10,24,32,-8,24
Dungannon,1193,8,2,4,16,14,47,-33,10
Crusaders,1194,1,16,7,3,62,31,31,55
Coleraine,1194,2,15,10,1,45,23,22,55
Glenavon,1194,3,9,9,8,53,45,8,36
Linfield,1194,4,10,5,11,38,38,0,35
Cliftonville,1194,5,10,4,12,34,32,2,34
Ballymena,1194,6,7,5,14,26,48,-22,26
Glentoran,1194,7,6,6,10,24,32,-8,24
Dungannon,1194,8,2,4,16,14,47,-33,10
Crusaders,1195,1,17,6,3,62,30,32,57
Coleraine,1195,2,15,10,1,47,24,23,55
Linfield,1195,3,11,5,10,39,37,2,38
Glenavon,1195,4,9,9,8,54,47,7,36
Cliftonville,1195,5,9,4,13,33,33,0,31
Ballymena,1195,6,7,4,15,25,48,-23,25
Glentoran,1195,7,6,6,10,24,32,-8,24
Dungannon,1195,8,2,4,16,14,47,-33,10
Crusaders,1196,1,16,7,3,61,30,31,55
Coleraine,1196,2,14,10,2,44,24,20,52
Glenavon,1196,3,10,9,7,54,44,10,39
Linfield,1196,4,10,5,11,37,38,-1,35
Cliftonville,1196,5,10,4,12,34,31,3,34
Ballymena,1196,6,7,5,14,25,47,-22,26
Glentoran,1196,7,6,6,10,24,32,-8,24
Dungannon,1196,8,2,4,16,14,47,-33,10
Crusaders,1197,1,17,6,3,62,30,32,57
Coleraine,1197,2,15,10,1,49,23,26,55
Linfield,1197,3,11,5,10,40,36,4,38
Glenavon,1197,4,9,9,8,53,49,4,36
Cliftonville,1197,5,9,4,13,32,34,-2,31
Ballymena,1197,6,7,4,15,25,48,-23,25
Glentoran,1197,7,6,6,10,24,32,-8,24
Dungannon,1197,8,2,4,16,14,47,-33,10
Crusaders,1198,1,16,6,4,61,32,29,54
Coleraine,1198,2,14,11,1,45,24,21,53
Linfield,1198,3,11,5,10,39,37,2,38
Glenavon,1198,4,9,10,7,54,45,9,37
Cliftonville,1198,5,9,4,13,33,33,0,31
Ballymena,1198,6,8,4,14,27,47,-20,28
Glentoran,1198,7,6,6,10,24,32,-8,24
Dungannon,1198,8,2,4,16,14,47,-33,10
Crusaders,1199,1,17,6,3,65,33,32,57
Coleraine,1199,2,14,10,2,43,23,20,52
Glenavon,1199,3,10,9,7,53,43,10,39
Linfield,1199,4,10,5,11,38,39,-1,35
Cliftonville,1199,5,10,4,12,35,32,3,34
Ballymena,1199,6,7,4,15,28,51,-23,25
Glentoran,1199,7,6,6,10,24,32,-8,24
Dungannon,1199,8,2,4,16,14,47,-33,10
Crusaders,1200,1,17,6,3,64,31,33,57
Coleraine,1200,2,14,10,2,43,24,19,52
Glenavon,1200,3,10,9,7,54,43,11,39
Linfield,1200,4,10,5,11,37,38,-1,35
Cliftonville,1200,5,10,4,12,34,31,3,34
Ballymena,1200,6,7,4,15,26,50,-24,25
Glentoran,1200,7,6,6,10,24,32,-8,24
Dungannon,1200,8,2,4,16,14,47,-33,10
Crusaders,1201,1,17,6,3,62,30,32,57
Coleraine,1201,2,14,11,1,43,22,21,53
Glenavon,1201,3,9,10,7,52,43,9,37
Linfield,1201,4,10,6,10,38,37,1,36
Cliftonville,1201,5,9,5,12,33,32,1,32
Ballymena,1201,6,7,4,15,25,48,-23,25
Glentoran,1201,7,6,6,10,24,32,-8,24
Dungannon,1201,8,2,4,16,14,47,-33,10
Crusaders,1202,1,17,6,3,64,30,34,57
Coleraine,1202,2,15,10,1,46,24,22,55
Linfield,1202,3,11,5,10,38,36,2,38
Glenavon,1202,4,9,9,8,54,46,8,36
Cliftonville,1202,5,9,4,13,32,32,0,31
Ballymena,1202,6,7,4,15,25,50,-25,25
Glentoran,1202,7,6,6,10,24,32,-8,24
Dungannon,1202,8,2,4,16,14,47,-33,10
Crusaders,1203,1,17,6,3,63,31,32,57
Coleraine,1203,2,14,10,2,43,24,19,52
Glenavon,1203,3,10,9,7,54,43,11,39
Linfield,1203,4,11,5,10,40,36,4,38
Cliftonville,1203,5,9,4,13,32,34,-2,31
Ballymena,1203,6,7,4,15,26,49,-23,25
Glentoran,1203,7,6,6,10,24,32,-8,24
Dungannon,1203,8,2,4,16,14,47,-33,10
Crusaders,1204,1,16,7,3,63,32,31,55
Coleraine,1204,2,14,11,1,44,23,21,53
Glenavon,1204,3,9,10,7,53,44,9,37
Linfield,1204,4,10,5,11,38,38,0,35
Cliftonville,1204,5,10,4,12,34,32,2,34
Ballymena,1204,6,7,5,14,27,49,-22,26
Glentoran,1204,7,6,6,10,24,32,-8,24
Dungannon,1204,8,2,4,16,14,47,-33,10
Crusaders,1205,1,17,6,3,63,31,32,57
Coleraine,1205,2,15,10,1,46,23,23,55
Glenavon,1205,3,9,9,8,53,46,7,36
Linfield,1205,4,10,5,11,37,38,-1,35
Cliftonville,1205,5,10,4,12,34,31,3,34
Ballymena,1205,6,7,4,15,26,49,-23,25
Glentoran,1205,7,6,6,10,24,32,-8,24
Dungannon,1205,8,2,4,16,14,47,-33,10
Crusaders,1206,1,16,6,4,62,32,30,54
Coleraine,1206,2,14,11,1,44,23,21,53
Linfield,1206,3,11,5,10,40,38,2,38
Glenavon,1206,4,9,10,7,53,44,9,37
Cliftonville,1206,5,9,4,13,34,34,0,31
Ballymena,1206,6,8,4,14,27,48,-21,28
Glentoran,1206,7,6,6,10,24,32,-8,24
Dungannon,1206,8,2,4,16,14,47,-33,10
Crusaders,1207,1,16,7,3,63,32,31,55
Coleraine,1207,2,14,10,2,43,24,19,52
Glenavon,1207,3,10,9,7,54,43,11,39
Linfield,1207,4,11,5,10,39,37,2,38
Cliftonville,1207,5,9,4,13,33,33,0,31
Ballymena,1207,6,7,5,14,27,49,-22,26
Glentoran,1207,7,6,6,10,24,32,-8,24
Dungannon,1207,8,2,4,16,14,47,-33,10
Crusaders,1208,1,16,7,3,64,33,31,55
Coleraine,1208,2,14,10,2,44,25,19,52
Glenavon,1208,3,10,9,7,55,44,11,39
Linfield,1208,4,11,5,10,38,36,2,38
Cliftonville,1208,5,9,4,13,32,32,0,31
Ballymena,1208,6,7,5,14,28,50,-22,26
Glentoran,1208,7,6,6,10,24,32,-8,24
Dungannon,1208,8,2,4,16,14,47,-33,10
Crusaders,1209,1,17,6,3,63,31,32,57
Coleraine,1209,2,14,10,2,45,25,20,52
Glenavon,1209,3,10,9,7,55,45,10,39
Linfield,1209,4,10,6,10,37,36,1,36
Cliftonville,1209,5,9,5,12,32,31,1,32
Ballymena,1209,6,7,4,15,26,49,-23,25
Glentoran,1209,7,6,6,10,24,32,-8,24
Dungannon,1209,8,2,4,16,14,47,-33,10
Crusaders,1210,1,17,6,3,66,33,33,57
Coleraine,1210,2,14,11,1,45,24,21,53
Glenavon,1210,3,9,10,7,54,45,9,37
Linfield,1210,4,10,6,10,38,37,1,36
Cliftonville,1210,5,9,5,12,33,32,1,32
Ballymena,1210,6,7,4,15,28,52,-24,25
Glentoran,1210,7,6,6,10,24,32,-8,24
Dungannon,1210,8,2,4,16,14,47,-33,10
Crusaders,1211,1,16,7,3,62,31,31,55
Coleraine,1211,2,14,10,2,45,26,19,52
Glenavon,1211,3,10,9,7,56,45,11,39
Linfield,1211,4,10,6,10,38,37,1,36
Cliftonville,1211,5,9,5,12,33,32,1,32
Ballymena,1211,6,7,5,14,26,48,-22,26
Glentoran,1211,7,6,6,10,24,32,-8,24
Dungannon,1211,8,2,4,16,14,47,-33,10
Crusaders,1212,1,16,6,4,61,31,30,54
Coleraine,1212,2,14,10,2,43,23,20,52
Glenavon,1212,3,10,9,7,53,43,10,39
Linfield,1212,4,10,6,10,37,36,1,36
Cliftonville,1212,5,9,5,12,32,31,1,32
Ballymena,1212,6,8,4,14,26,47,-21,28
Glentoran,1212,7,6,6,10,24,32,-8,24
Dungannon,1212,8,2,4,16,14,47,-33,10
Crusaders,1213,1,16,7,3,61,30,31,55
Coleraine,1213,2,15,10,1,46,23,23,55
Glenavon,1213,3,9,9,8,53,46,7,36
Linfield,1213,4,10,6,10,38,37,1,36
Cliftonville,1213,5,9,5,12,33,32,1,32
Ballymena,1213,6,7,5,14,25,47,-22,26
Glentoran,1213,7,6,6,10,24,32,-8,24
Dungannon,1213,8,2,4,16,14,47,-33,10
Crusaders,1214,1,17,6,3,64,30,34,57
Coleraine,1214,2,14,10,2,44,24,20,52
Glenavon,1214,3,10,9,7,54,44,10,39
Linfield,1214,4,10,5,11,38,38,0,35
Cliftonville,1214,5,10,4,12,34,32,2,34
Ballymena,1214,6,7,4,15,25,50,-25,25
Glentoran,1214,7,6,6,10,24,32,-8,24
Dungannon,1214,8,2,4,16,14,47,-33,10
Crusaders,1215,1,17,6,3,63,30,33,57
Coleraine,1215,2,14,11,1,44,23,21,53
Linfield,1215,3,11,5,10,39,37,2,38
Glenavon,1215,4,9,10,7,53,44,9,37
Cliftonville,1215,5,9,4,13,33,33,0,31
Ballymena,1215,6,7,4,15,25,49,-24,25
Glentoran,1215,7,6,6,10,24,32,-8,24
Dungannon,1215,8,2,4,16,14,47,-33,10
Crusaders,1216,1,17,6,3,65,30,35,57
Coleraine,1216,2,14,10,2,43,23,20,52
Glenavon,1216,3,10,9,7,53,43,10,39
Linfield,1216,4,10,5,11,37,38,-1,35
Cliftonville,1216,5,10,4,12,34,31,3,34
Ballymena,1216,6,7,4,15,25,51,-26,25
Glentoran,1216,7,6,6,10,24,32,-8,24
Dungannon,1216,8,2,4,16,14,47,-33,10
Crusaders,1217,1,17,6,3,63,31,32,57
Coleraine,1217,2,14,11,1,44,23,21,53
Linfield,1217,3,11,5,10,40,37,3,38
Glenavon,1217,4,9,10,7,53,44,9,37
Cliftonville,1217,5,9,4,13,33,34,-1,31
Ballymena,1217,6,7,4,15,26,49,-23,25
Glentoran,1217,7,6,6,10,24,32,-8,24
Dungannon,1217,8,2,4,16,14,47,-33,10
Crusaders,1218,1,16,7,3,62,31,31,55
Coleraine,1218,2,14,10,2,45,27,18,52
Glenavon,1218,3,10,9,7,57,45,12,39
Linfield,1218,4,10,6,10,37,36,1,36
Cliftonville,1218,5,9,5,12,32,31,1,32
Ballymena,1218,6,7,5,14,26,48,-22,26
Glentoran,1218,7,6,6,10,24,32,-8,24
Dungannon,1218,8,2,4,16,14,47,-33,10
Crusaders,1219,1,17,6,3,64,30,34,57
Coleraine,1219,2,14,10,2,43,24,19,52
Glenavon,1219,3,10,9,7,54,43,11,39
Linfield,1219,4,11,5,10,40,36,4,38
Cliftonville,1219,5,9,4,13,32,34,-2,31
Ballymena,1219,6,7,4,15,25,50,-25,25
Glentoran,1219,7,6,6,10,24,32,-8,24
Dungannon,1219,8,2,4,16,14,47,-33,10
Crusaders,1220,1,17,6,3,64,31,33,57
Coleraine,1220,2,14,11,1,45,24,21,53
Glenavon,1220,3,9,10,7,54,45,9,37
Linfield,1220,4,10,6,10,38,37,1,36
Cliftonville,1220,5,9,5,12,33,32,1,32
Ballymena,1220,6,7,4,15,26,50,-24,25
Glentoran,1220,7,6,6,10,24,32,-8,24
Dungannon,1220,8,2,4,16,14,47,-33,10
Crusaders,1221,1,17,6,3,63,31,32,57
Coleraine,1221,2,14,10,2,43,23,20,52
Glenavon,1221,3,10,9,7,53,43,10,39
Linfield,1221,4,11,5,10,40,38,2,38
Cliftonville,1221,5,9,4,13,34,34,0,31
Ballymena,1221,6,7,4,15,26,49,-23,25
Glentoran,1221,7,6,6,10,24,32,-8,24
Dungannon,1221,8,2,4,16,14,47,-33,10
Crusaders,1222,1,17,6,3,64,31,33,57
Coleraine,1222,2,15,10,1,44,22,22,55
Glenavon,1222,3,9,9,8,52,44,8,36
Linfield,1222,4,10,6,10,38,37,1,36
Cliftonville,1222,5,9,5,12,33,32,1,32
Ballymena,1222,6,7,4,15,26,50,-24,25
Glentoran,1222,7,6,6,10,24,32,-8,24
Dungannon,1222,8,2,4,16,14,47,-33,10
Crusaders,1223,1,17,6,3,63,30,33,57
Coleraine,1223,2,14,10,2,43,24,19,52
Glenavon,1223,3,10,9,7,54,43,11,39
Linfield,1223,4,11,5,10,39,36,3,38
Cliftonville,1223,5,9,4,13,32,33,-1,31
Ballymena,1223,6,7,4,15,25,49,-24,25
Glentoran,1223,7,6,6,10,24,32,-8,24
Dungannon,1223,8,2,4,16,14,47,-33,10
Crusaders,1224,1,17,6,3,64,31,33,57
Coleraine,1224,2,14,10,2,44,24,20,52
Glenavon,1224,3,10,9,7,54,44,10,39
Linfield,1224,4,11,5,10,39,37,2,38
Cliftonville,1224,5,9,4,13,33,33,0,31
Ballymena,1224,6,7,4,15,26,50,-24,25
Glentoran,1224,7,6,6,10,24,32,-8,24
Dungannon,1224,8,2,4,16,14,47,-33,10
Crusaders,1225,1,16,7,3,61,30,31,55
Coleraine,1225,2,14,10,2,43,28,15,52
Glenavon,1225,3,10,9,7,58,43,15,39
Linfield,1225,4,10,6,10,37,36,1,36
Cliftonville,1225,5,9,5,12,32,31,1,32
Ballymena,1225,6,7,5,14,25,47,-22,26
Glentoran,1225,7,6,6,10,24,32,-8,24
Dungannon,1225,8,2,4,16,14,47,-33,10
Crusaders,1226,1,17,6,3,66,31,35,57
Coleraine,1226,2,15,10,1,45,22,23,55
Linfield,1226,3,11,5,10,40,36,4,38
Glenavon,1226,4,9,9,8,52,45,7,36
Cliftonville,1226,5,9,4,13,32,34,-2,31
Ballymena,1226,6,7,4,15,26,52,-26,25
Glentoran,1226,7,6,6,10,24,32,-8,24
Dungannon,1226,8,2,4,16,14,47,-33,10
Crusaders,1227,1,16,7,3,62,31,31,55
Coleraine,1227,2,14,10,2,45,26,19,52
Glenavon,1227,3,10,9,7,56,45,11,39
Linfield,1227,4,10,6,10,39,38,1,36
Cliftonville,1227,5,9,5,12,34,33,1,32
Ballymena,1227,6,7,5,14,26,48,-22,26
Glentoran,1227,7,6,6,10,24,32,-8,24
Dungannon,1227,8,2,4,16,14,47,-33,10
Crusaders,1228,1,17,6,3,65,30,35,57
Coleraine,1228,2,15,10,1,46,24,22,55
Linfield,1228,3,11,5,10,39,37,2,38
Glenavon,1228,4,9,9,8,54,46,8,36
Cliftonville,1228,5,9,4,13,33,33,0,31
Ballymena,1228,6,7,4,15,25,51,-26,25
Glentoran,1228,7,6,6,10,24,32,-8,24
Dungannon,1228,8,2,4,16,14,47,-33,10
Crusaders,1229,1,16,7,3,61,30,31,55
Coleraine,1229,2,14,11,1,44,23,21,53
Glenavon,1229,3,9,10,7,53,44,9,37
Linfield,1229,4,10,6,10,39,38,1,36
Cliftonville,1229,5,9,5,12,34,33,1,32
Ballymena,1229,6,7,5,14,25,47,-22,26
Glentoran,1229,7,6,6,10,24,32,-8,24
Dungannon,1229,8,2,4,16,14,47,-33,10
Crusaders,1230,1,16,6,4,61,31,30,54
Coleraine,1230,2,14,10,2,45,25,20,52
Glenavon,1230,3,10,9,7,55,45,10,39
Linfield,1230,4,10,5,11,37,39,-2,35
Cliftonville,1230,5,10,4,12,35,31,4,34
Ballymena,1230,6,8,4,14,26,47,-21,28
Glentoran,1230,7,6,6,10,24,32,-8,24
Dungannon,1230,8,2,4,16,14,47,-33,10
Crusaders,1231,1,17,6,3,62,30,32,57
Coleraine,1231,2,15,10,1,46,24,22,55
Glenavon,1231,3,9,9,8,54,46,8,36
Linfield,1231,4,10,5,11,38,38,0,35
Cliftonville,1231,5,10,4,12,34,32,2,34
Ballymena,1231,6,7,4,15,25,48,-23,25
Glentoran,1231,7,6,6,10,24,32,-8,24
Dungannon,1231,8,2,4,16,14,47,-33,10
Crusaders,1232,1,16,6,4,61,32,29,54
Coleraine,1232,2,14,10,2,44,24,20,52
Glenavon,1232,3,10,9,7,54,44,10,39
Linfield,1232,4,11,5,10,40,37,3,38
Cliftonville,1232,5,9,4,13,33,34,-1,31
Ballymena,1232,6,8,4,14,27,47,-20,28
Glentoran,1232,7,6,6,10,24,32,-8,24
Dungannon,1232,8,2,4,16,14,47,-33,10
Crusaders,1233,1,17,6,3,66,32,34,57
Coleraine,1233,2,15,10,1,44,22,22,55
Linfield,1233,3,11,5,10,41,38,3,38
Glenavon,1233,4,9,9,8,52,44,8,36
Cliftonville,1233,5,9,4,13,34,35,-1,31
Ballymena,1233,6,7,4,15,27,52,-25,25
Glentoran,1233,7,6,6,10,24,32,-8,24
Dungannon,1233,8,2,4,16,14,47,-33,10
Coleraine,1234,1,15,10,1,44,22,22,55
Crusaders,1234,2,16,6,4,61,31,30,54
Linfield,1234,3,11,5,10,41,39,2,38
Glenavon,1234,4,9,9,8,52,44,8,36
Cliftonville,1234,5,9,4,13,35,35,0,31
Ballymena,1234,6,8,4,14,26,47,-21,28
Glentoran,1234,7,6,6,10,24,32,-8,24
Dungannon,1234,8,2,4,16,14,47,-33,10
Coleraine,1235,1,15,10,1,46,23,23,55
Crusaders,1235,2,16,6,4,63,34,29,54
Glenavon,1235,3,9,9,8,53,46,7,36
Linfield,1235,4,10,6,10,37,36,1,36
Cliftonville,1235,5,9,5,12,32,31,1,32
Ballymena,1235,6,8,4,14,29,49,-20,28
Glentoran,1235,7,6,6,10,24,32,-8,24
Dungannon,1235,8,2,4,16,14,47,-33,10
Crusaders,1236,1,16,6,4,61,33,28,54
Coleraine,1236,2,14,10,2,44,25,19,52
Glenavon,1236,3,10,9,7,55,44,11,39
Linfield,1236,4,10,5,11,39,39,0,35
Cliftonville,1236,5,10,4,12,35,33,2,34
Ballymena,1236,6,8,4,14,28,47,-19,28
Glentoran,1236,7,6,6,10,24,32,-8,24
Dungannon,1236,8,2,4,16,14,47,-33,10
Crusaders,1237,1,16,7,3,63,32,31,55
Coleraine,1237,2,14,10,2,44,24,20,52
Glenavon,1237,3,10,9,7,54,44,10,39
Linfield,1237,4,11,5,10,39,37,2,38
Cliftonville,1237,5,9,4,13,33,33,0,31
Ballymena,1237,6,7,5,14,27,49,-22,26
Glentoran,1237,7,6,6,10,24,32,-8,24
Dungannon,1237,8,2,4,16,14,47,-33,10
Crusaders,1238,1,17,6,3,64,30,34,57
Coleraine,1238,2,14,10,2,45,25,20,52
Glenavon,1238,3,10,9,7,55,45,10,39
Linfield,1238,4,10,5,11,38,40,-2,35
Cliftonville,1238,5,10,4,12,36,32,4,34
Ballymena,1238,6,7,4,15,25,50,-25,25
Glentoran,1238,7,6,6,10,24,32,-8,24
Dungannon,1238,8,2,4,16,14,47,-33,10
Crusaders,1239,1,16,7,3,62,31,31,55
Coleraine,1239,2,14,10,2,43,24,19,52
Glenavon,1239,3,10,9,7,54,43,11,39
Linfield,1239,4,11,5,10,45,36,9,38
Cliftonville,1239,5,9,4,13,32,39,-7,31
Ballymena,1239,6,7,5,14,26,48,-22,26
Glentoran,1239,7,6,6,10,24,32,-8,24
Dungannon,1239,8,2,4,16,14,47,-33,10
Crusaders,1240,1,17,6,3,63,31,32,57
Coleraine,1240,2,14,11,1,44,23,21,53
Linfield,1240,3,11,5,10,41,37,4,38
Glenavon,1240,4,9,10,7,53,44,9,37
Cliftonville,1240,5,9,4,13,33,35,-2,31
Ballymena,1240,6,7,4,15,26,49,-23,25
Glentoran,1240,7,6,6,10,24,32,-8,24
Dungannon,1240,8,2,4,16,14,47,-33,10
Crusaders,1241,1,16,7,3,62,31,31,55
Coleraine,1241,2,14,11,1,43,22,21,53
Glenavon,1241,3,9,10,7,52,43,9,37
Linfield,1241,4,10,5,11,38,39,-1,35
Cliftonville,1241,5,10,4,12,35,32,3,34
Ballymena,1241,6,7,5,14,26,48,-22,26
Glentoran,1241,7,6,6,10,24,32,-8,24
Dungannon,1241,8,2,4,16,14,47,-33,10
Coleraine,1242,1,15,10,1,45,22,23,55
Crusaders,1242,2,16,6,4,61,31,30,54
Glenavon,1242,3,9,9,8,52,45,7,36
Linfield,1242,4,10,5,11,37,37,0,35
Cliftonville,1242,5,10,4,12,33,31,2,34
Ballymena,1242,6,8,4,14,26,47,-21,28
Glentoran,1242,7,6,6,10,24,32,-8,24
Dungannon,1242,8,2,4,16,14,47,-33,10
Crusaders,1243,1,16,7,3,63,32,31,55
Coleraine,1243,2,15,10,1,47,24,23,55
Linfield,1243,3,11,5,10,39,37,2,38
Glenavon,1243,4,9,9,8,54,47,7,36
Cliftonville,1243,5,9,4,13,33,33,0,31
Ballymena,1243,6,7,5,14,27,49,-22,26
Glentoran,1243,7,6,6,10,24,32,-8,24
Dungannon,1243,8,2,4,16,14,47,-33,10
Crusaders,1244,1,16,7,3,61,30,31,55
Coleraine,1244,2,15,10,1,45,23,22,55
Glenavon,1244,3,9,9,8,53,45,8,36
Linfield,1244,4,10,5,11,38,40,-2,35
Cliftonville,1244,5,10,4,12,36,32,4,34
Ballymena,1244,6,7,5,14,25,47,-22,26
Glentoran,1244,7,6,6,10,24,32,-8,24
Dungannon,1244,8,2,4,16,14,47,-33,10
Crusaders,1245,1,17,6,3,63,30,33,57
Coleraine,1245,2,14,10,2,44,24,20,52
Glenavon,1245,3,10,9,7,54,44,10,39
Linfield,1245,4,11,5,10,40,37,3,38
Cliftonville,1245,5,9,4,13,33,34,-1,31
Ballymena,1245,6,7,4,15,25,49,-24,25
Glentoran,1245,7,6,6,10,24,32,-8,24
Dungannon,1245,8,2,4,16,14,47,-33,10
Crusaders,1246,1,17,6,3,67,30,37,57
Coleraine,1246,2,14,10,2,45,25,20,52
Glenavon,1246,3,10,9,7,55,45,10,39
Linfield,1246,4,10,5,11,38,38,0,35
Cliftonville,1246,5,10,4,12,34,32,2,34
Ballymena,1246,6,7,4,15,25,53,-28,25
Glentoran,1246,7,6,6,10,24,32,-8,24
Dungannon,1246,8,2,4,16,14,47,-33,10
Crusaders,1247,1,17,6,3,64,31,33,57
Coleraine,1247,2,15,10,1,46,24,22,55
Linfield,1247,3,11,5,10,39,37,2,38
Glenavon,1247,4,9,9,8,54,46,8,36
Cliftonville,1247,5,9,4,13,33,33,0,31
Ballymena,1247,6,7,4,15,26,50,-24,25
Glentoran,1247,7,6,6,10,24,32,-8,24
Dungannon,1247,8,2,4,16,14,47,-33,10
Crusaders,1248,1,17,6,3,65,33,32,57
Coleraine,1248,2,14,11,1,44,23,21,53
Glenavon,1248,3,9,10,7,53,44,9,37
Linfield,1248,4,10,6,10,37,36,1,36
Cliftonville,1248,5,9,5,12,32,31,1,32
Ballymena,1248,6,7,4,15,28,51,-23,25
Glentoran,1248,7,6,6,10,24,32,-8,24
Dungannon,1248,8,2,4,16,14,47,-33,10
Crusaders,1249,1,17,6,3,65,32,33,57
Coleraine,1249,2,14,11,1,43,22,21,53
Linfield,1249,3,11,5,10,38,36,2,38
Glenavon,1249,4,9,10,7,52,43,9,37
Cliftonville,1249,5,9,4,13,32,32,0,31
Ballymena,1249,6,7,4,15,27,51,-24,25
Glentoran,1249,7,6,6,10,24,32,-8,24
Dungannon,1249,8,2,4,16,14,47,-33,10
Crusaders,1250,1,17,6,3,62,30,32,57
Coleraine,1250,2,15,10,1,45,23,22,55
Glenavon,1250,3,9,9,8,53,45,8,36
Linfield,1250,4,10,6,10,37,36,1,36
Cliftonville,1250,5,9,5,12,32,31,1,32
Ballymena,1250,6,7,4,15,25,48,-23,25
Glentoran,1250,7,6,6,10,24,32,-8,24
Dungannon,1250,8,2,4,16,14,47,-33,10
Crusaders,1251,1,16,7,3,62,31,31,55
Coleraine,1251,2,14,11,1,43,22,21,53
Glenavon,1251,3,9,10,7,52,43,9,37
Linfield,1251,4,10,6,10,37,36,1,36
Cliftonville,1251,5,9,5,12,32,31,1,32
Ballymena,1251,6,7,5,14,26,48,-22,26
Glentoran,1251,7,6,6,10,24,32,-8,24
Dungannon,1251,8,2,4,16,14,47,-33,10
Crusaders,1252,1,16,7,3,63,32,31,55
Coleraine,1252,2,14,10,2,45,26,19,52
Glenavon,1252,3,10,9,7,56,45,11,39
Linfield,1252,4,10,6,10,37,36,1,36
Cliftonville,1252,5,9,5,12,32,31,1,32
Ballymena,1252,6,7,5,14,27,49,-22,26
Glentoran,1252,7,6,6,10,24,32,-8,24
Dungannon,1252,8,2,4,16,14,47,-33,10
Crusaders,1253,1,17,6,3,62,30,32,57
Coleraine,1253,2,14,11,1,43,22,21,53
Glenavon,1253,3,9,10,7,52,43,9,37
Linfield,1253,4,10,5,11,37,38,-1,35
Cliftonville,1253,5,10,4,12,34,31,3,34
Ballymena,1253,6,7,4,15,25,48,-23,25
Glentoran,1253,7,6,6,10,24,32,-8,24
Dungannon,1253,8,2,4,16,14,47,-33,10
Crusaders,1254,1,16,7,3,62,31,31,55
Coleraine,1254,2,14,10,2,44,24,20,52
Glenavon,1254,3,10,9,7,54,44,10,39
Linfield,1254,4,10,6,10,39,38,1,36
Cliftonville,1254,5,9,5,12,34,33,1,32
Ballymena,1254,6,7,5,14,26,48,-22,26
Glentoran,1254,7,6,6,10,24,32,-8,24
Dungannon,1254,8,2,4,16,14,47,-33,10
Crusaders,1255,1,16,6,4,61,33,28,54
Coleraine,1255,2,14,10,2,44,24,20,52
Glenavon,1255,3,10,9,7,54,44,10,39
Linfield,1255,4,10,6,10,38,37,1,36
Cliftonville,1255,5,9,5,12,33,32,1,32
Ballymena,1255,6,8,4,14,28,47,-19,28
Glentoran,1255,7,6,6,10,24,32,-8,24
Dungannon,1255,8,2,4,16,14,47,-33,10
Crusaders,1256,1,17,6,3,62,30,32,57
Coleraine,1256,2,14,10,2,45,25,20,52
Glenavon,1256,3,10,9,7,55,45,10,39
Linfield,1256,4,11,5,10,40,38,2,38
Cliftonville,1256,5,9,4,13,34,34,0,31
Ballymena,1256,6,7,4,15,25,48,-23,25
Glentoran,1256,7,6,6,10,24,32,-8,24
Dungannon,1256,8,2,4,16,14,47,-33,10
Crusaders,1257,1,17,6,3,64,30,34,57
Coleraine,1257,2,14,10,2,45,25,20,52
Glenavon,1257,3,10,9,7,55,45,10,39
Linfield,1257,4,11,5,10,38,36,2,38
Cliftonville,1257,5,9,4,13,32,32,0,31
Ballymena,1257,6,7,4,15,25,50,-25,25
Glentoran,1257,7,6,6,10,24,32,-8,24
Dungannon,1257,8,2,4,16,14,47,-33,10
Crusaders,1258,1,17,6,3,62,30,32,57
Coleraine,1258,2,15,10,1,44,22,22,55
Linfield,1258,3,11,5,10,40,37,3,38
Glenavon,1258,4,9,9,8,52,44,8,36
Cliftonville,1258,5,9,4,13,33,34,-1,31
Ballymena,1258,6,7,4,15,25,48,-23,25
Glentoran,1258,7,6,6,10,24,32,-8,24
Dungannon,1258,8,2,4,16,14,47,-33,10
Crusaders,1259,1,16,7,3,63,32,31,55
Coleraine,1259,2,14,10,2,44,25,19,52
Glenavon,1259,3,10,9,7,55,44,11,39
Linfield,1259,4,11,5,10,41,36,5,38
Cliftonville,1259,5,9,4,13,32,35,-3,31
Ballymena,1259,6,7,5,14,27,49,-22,26
Glentoran,1259,7,6,6,10,24,32,-8,24
Dungannon,1259,8,2,4,16,14,47,-33,10
Coleraine,1260,1,15,10,1,45,23,22,55
Crusaders,1260,2,16,6,4,62,33,29,54
Glenavon,1260,3,9,9,8,53,45,8,36
Linfield,1260,4,10,6,10,37,36,1,36
Cliftonville,1260,5,9,5,12,32,31,1,32
Ballymena,1260,6,8,4,14,28,48,-20,28
Glentoran,1260,7,6,6,10,24,32,-8,24
Dungannon,1260,8,2,4,16,14,47,-33,10
Crusaders,1261,1,16,7,3,63,32,31,55
Coleraine,1261,2,14,11,1,44,23,21,53
Linfield,1261,3,11,5,10,41,36,5,38
Glenavon,1261,4,9,10,7,53,44,9,37
Cliftonville,1261,5,9,4,13,32,35,-3,31
Ballymena,1261,6,7,5,14,27,49,-22,26
Glentoran,1261,7,6,6,10,24,32,-8,24
Dungannon,1261,8,2,4,16,14,47,-33,10
Crusaders,1262,1,17,6,3,65,30,35,57
Coleraine,1262,2,14,11,1,44,23,21,53
Glenavon,1262,3,9,10,7,53,44,9,37
Linfield,1262,4,10,5,11,38,38,0,35
Cliftonville,1262,5,10,4,12,34,32,2,34
Ballymena,1262,6,7,4,15,25,51,-26,25
Glentoran,1262,7,6,6,10,24,32,-8,24
Dungannon,1262,8,2,4,16,14,47,-33,10
Crusaders,1263,1,17,6,3,64,31,33,57
Coleraine,1263,2,15,10,1,46,23,23,55
Glenavon,1263,3,9,9,8,53,46,7,36
Linfield,1263,4,10,5,11,38,38,0,35
Cliftonville,1263,5,10,4,12,34,32,2,34
Ballymena,1263,6,7,4,15,26,50,-24,25
Glentoran,1263,7,6,6,10,24,32,-8,24
Dungannon,1263,8,2,4,16,14,47,-33,10
Crusaders,1264,1,17,6,3,65,31,34,57
Coleraine,1264,2,14,10,2,45,25,20,52
Glenavon,1264,3,10,9,7,55,45,10,39
Linfield,1264,4,10,5,11,37,39,-2,35
Cliftonville,1264,5,10,4,12,35,31,4,34
Ballymena,1264,6,7,4,15,26,51,-25,25
Glentoran,1264,7,6,6,10,24,32,-8,24
Dungannon,1264,8,2,4,16,14,47,-33,10
Crusaders,1265,1,17,6,3,62,30,32,57
Coleraine,1265,2,15,10,1,45,23,22,55
Linfield,1265,3,11,5,10,39,36,3,38
Glenavon,1265,4,9,9,8,53,45,8,36
Cliftonville,1265,5,9,4,13,32,33,-1,31
Ballymena,1265,6,7,4,15,25,48,-23,25
Glentoran,1265,7,6,6,10,24,32,-8,24
Dungannon,1265,8,2,4,16,14,47,-33,10
Crusaders,1266,1,17,6,3,66,33,33,57
Coleraine,1266,2,14,10,2,44,25,19,52
Glenavon,1266,3,10,9,7,55,44,11,39
Linfield,1266,4,11,5,10,40,37,3,38
Cliftonville,1266,5,9,4,13,33,34,-1,31
Ballymena,1266,6,7,4,15,28,52,-24,25
Glentoran,1266,7,6,6,10,24,32,-8,24
Dungannon,1266,8,2,4,16,14,47,-33,10
Crusaders,1267,1,17,6,3,63,30,33,57
Coleraine,1267,2,14,10,2,45,25,20,52
Glenavon,1267,3,10,9,7,55,45,10,39
Linfield,1267,4,10,5,11,37,37,0,35
Cliftonville,1267,5,10,4,12,33,31,2,34
Ballymena,1267,6,7,4,15,25,49,-24,25
Glentoran,1267,7,6,6,10,24,32,-8,24
Dungannon,1267,8,2,4,16,14,47,-33,10
Crusaders,1268,1,17,6,3,65,32,33,57
Coleraine,1268,2,14,11,1,44,23,21,53
Glenavon,1268,3,9,10,7,53,44,9,37
Linfield,1268,4,10,5,11,38,38,0,35
Cliftonville,1268,5,10,4,12,34,32,2,34
Ballymena,1268,6,7,4,15,27,51,-24,25
Glentoran,1268,7,6,6,10,24,32,-8,24
Dungannon,1268,8,2,4,16,14,47,-33,10
Crusaders,1269,1,16,7,3,62,31,31,55
Coleraine,1269,2,14,10,2,44,26,18,52
Glenavon,1269,3,10,9,7,56,44,12,39
Linfield,1269,4,10,6,10,37,36,1,36
Cliftonville,1269,5,9,5,12,32,31,1,32
Ballymena,1269,6,7,5,14,26,48,-22,26
Glentoran,1269,7,6,6,10,24,32,-8,24
Dungannon,1269,8,2,4,16,14,47,-33,10
Crusaders,1270,1,16,6,4,64,34,30,54
Coleraine,1270,2,14,11,1,44,23,21,53
Linfield,1270,3,11,5,10,40,36,4,38
Glenavon,1270,4,9,10,7,53,44,9,37
Cliftonville,1270,5,9,4,13,32,34,-2,31
Ballymena,1270,6,8,4,14,29,50,-21,28
Glentoran,1270,7,6,6,10,24,32,-8,24
Dungannon,1270,8,2,4,16,14,47,-33,10
Crusaders,1271,1,16,7,3,62,31,31,55
Coleraine,1271,2,15,10,1,46,23,23,55
Linfield,1271,3,11,5,10,41,37,4,38
Glenavon,1271,4,9,9,8,53,46,7,36
Cliftonville,1271,5,9,4,13,33,35,-2,31
Ballymena,1271,6,7,5,14,26,48,-22,26
Glentoran,1271,7,6,6,10,24,32,-8,24
Dungannon,1271,8,2,4,16,14,47,-33,10
Crusaders,1272,1,16,7,3,61,30,31,55
Coleraine,1272,2,14,11,1,44,23,21,53
Linfield,1272,3,11,5,10,38,36,2,38
Glenavon,1272,4,9,10,7,53,44,9,37
Cliftonville,1272,5,9,4,13,32,32,0,31
Ballymena,1272,6,7,5,14,25,47,-22,26
Glentoran,1272,7,6,6,10,24,32,-8,24
Dungannon,1272,8,2,4,16,14,47,-33,10
Crusaders,1273,1,17,6,3,64,32,32,57
Coleraine,1273,2,14,11,1,45,24,21,53
Linfield,1273,3,11,5,10,39,36,3,38
Glenavon,1273,4,9,10,7,54,45,9,37
Cliftonville,1273,5,9,4,13,32,33,-1,31
Ballymena,1273,6,7,4,15,27,50,-23,25
Glentoran,1273,7,6,6,10,24,32,-8,24
Dungannon,1273,8,2,4,16,14,47,-33,10
Crusaders,1274,1,17,6,3,64,32,32,57
Coleraine,1274,2,15,10,1,45,22,23,55
Linfield,1274,3,11,5,10,39,37,2,38
Glenavon,1274,4,9,9,8,52,45,7,36
Cliftonville,1274,5,9,4,13,33,33,0,31
Ballymena,1274,6,7,4,15,27,50,-23,25
Glentoran,1274,7,6,6,10,24,32,-8,24
Dungannon,1274,8,2,4,16,14,47,-33,10
Crusaders,1275,1,16,6,4,61,32,29,54
Coleraine,1275,2,14,10,2,44,24,20,52
Glenavon,1275,3,10,9,7,54,44,10,39
Linfield,1275,4,11,5,10,39,37,2,38
Cliftonville,1275,5,9,4,13,33,33,0,31
Ballymena,1275,6,8,4,14,27,47,-20,28
Glentoran,1275,7,6,6,10,24,32,-8,24
Dungannon,1275,8,2,4,16,14,47,-33,10
Coleraine,1276,1,15,10,1,45,23,22,55
Crusaders,1276,2,16,6,4,62,32,30,54
Glenavon,1276,3,9,9,8,53,45,8,36
Linfield,1276,4,10,6,10,37,36,1,36
Cliftonville,1276,5,9,5,12,32,31,1,32
Ballymena,1276,6,8,4,14,27,48,-21,28
Glentoran,1276,7,6,6,10,24,32,-8,24
Dungannon,1276,8,2,4,16,14,47,-33,10
Coleraine,1277,1,15,10,1,45,23,22,55
Crusaders,1277,2,16,6,4,61,31,30,54
Linfield,1277,3,11,5,10,40,37,3,38
Glenavon,1277,4,9,9,8,53,45,8,36
Cliftonville,1277,5,9,4,13,33,34,-1,31
Ballymena,1277,6,8,4,14,26,47,-21,28
Glentoran,1277,7,6,6,10,24,32,-8,24
Dungannon,1277,8,2,4,16,14,47,-33,10
Crusaders,1278,1,16,7,3,62,31,31,55
Coleraine,1278,2,14,11,1,45,24,21,53
Glenavon,1278,3,9,10,7,54,45,9,37
Linfield,1278,4,10,6,10,37,36,1,36
Cliftonville,1278,5,9,5,12,32,31,1,32
Ballymena,1278,6,7,5,14,26,48,-22,26
Glentoran,1278,7,6,6,10,24,32,-8,24
Dungannon,1278,8,2,4,16,14,47,-33,10
Crusaders,1279,1,16,6,4,61,31,30,54
Coleraine,1279,2,14,11,1,44,23,21,53
Glenavon,1279,3,9,10,7,53,44,9,37
Linfield,1279,4,10,5,11,38,39,-1,35
Cliftonville,1279,5,10,4,12,35,32,3,34
Ballymena,1279,6,8,4,14,26,47,-21,28
Glentoran,1279,7,6,6,10,24,32,-8,24
Dungannon,1279,8,2,4,16,14,47,-33,10
Coleraine,1280,1,15,10,1,44,22,22,55
Crusaders,1280,2,16,6,4,63,33,30,54
Linfield,1280,3,11,5,10,38,36,2,38
Glenavon,1280,4,9,9,8,52,44,8,36
Cliftonville,1280,5,9,4,13,32,32,0,31
Ballymena,1280,6,8,4,14,28,49,-21,28
Glentoran,1280,7,6,6,10,24,32,-8,24
Dungannon,1280,8,2,4,16,14,47,-33,10
Crusaders,1281,1,17,6,3,63,31,32,57
Coleraine,1281,2,14,10,2,46,26,20,52
Glenavon,1281,3,10,9,7,56,46,10,39
Linfield,1281,4,10,6,10,38,37,1,36
Cliftonville,1281,5,9,5,12,33,32,1,32
Ballymena,1281,6,7,4,15,26,49,-23,25
Glentoran,1281,7,6,6,10,24,32,-8,24
Dungannon,1281,8,2,4,16,14,47,-33,10
Crusaders,1282,1,17,6,3,63,31,32,57
Coleraine,1282,2,14,10,2,47,27,20,52
Glenavon,1282,3,10,9,7,57,47,10,39
Linfield,1282,4,10,6,10,38,37,1,36
Cliftonville,1282,5,9,5,12,33,32,1,32
Ballymena,1282,6,7,4,15,26,49,-23,25
Glentoran,1282,7,6,6,10,24,32,-8,24
Dungannon,1282,8,2,4,16,14,47,-33,10
Crusaders,1283,1,16,7,3,64,33,31,55
Coleraine,1283,2,14,10,2,44,24,20,52
Glenavon,1283,3,10,9,7,54,44,10,39
Linfield,1283,4,10,6,10,37,36,1,36
Cliftonville,1283,5,9,5,12,32,31,1,32
Ballymena,1283,6,7,5,14,28,50,-22,26
Glentoran,1283,7,6,6,10,24,32,-8,24
Dungannon,1283,8,2,4,16,14,47,-33,10
Crusaders,1284,1,17,6,3,67,32,35,57
Coleraine,1284,2,15,10,1,46,23,23,55
Glenavon,1284,3,9,9,8,53,46,7,36
Linfield,1284,4,10,5,11,37,37,0,35
Cliftonville,1284,5,10,4,12,33,31,2,34
Ballymena,1284,6,7,4,15,27,53,-26,25
Glentoran,1284,7,6,6,10,24,32,-8,24
Dungannon,1284,8,2,4,16,14,47,-33,10
Crusaders,1285,1,16,7,3,62,31,31,55
Coleraine,1285,2,14,10,2,44,24,20,52
Glenavon,1285,3,10,9,7,54,44,10,39
Linfield,1285,4,10,6,10,39,38,1,36
Cliftonville,1285,5,9,5,12,34,33,1,32
Ballymena,1285,6,7,5,14,26,48,-22,26
Glentoran,1285,7,6,6,10,24,32,-8,24
Dungannon,1285,8,2,4,16,14,47,-33,10
Crusaders,1286,1,17,6,3,63,30,33,57
Coleraine,1286,2,15,10,1,45,23,22,55
Glenavon,1286,3,9,9,8,53,45,8,36
Linfield,1286,4,10,6,10,38,37,1,36
Cliftonville,1286,5,9,5,12,33,32,1,32
Ballymena,1286,6,7,4,15,25,49,-24,25
Glentoran,1286,7,6,6,10,24,32,-8,24
Dungannon,1286,8,2,4,16,14,47,-33,10
Crusaders,1287,1,17,6,3,63,30,33,57
Coleraine,1287,2,14,11,1,45,24,21,53
Linfield,1287,3,11,5,10,39,36,3,38
Glenavon,1287,4,9,10,7,54,45,9,37
Cliftonville,1287,5,9,4,13,32,33,-1,31
Ballymena,1287,6,7,4,15,25,49,-24,25
Glentoran,1287,7,6,6,10,24,32,-8,24
Dungannon,1287,8,2,4,16,14,47,-33,10
Crusaders,1288,1,17,6,3,63,31,32,57
Coleraine,1288,2,15,10,1,46,22,24,55
Linfield,1288,3,11,5,10,39,36,3,38
Glenavon,1288,4,9,9,8,52,46,6,36
Cliftonville,1288,5,9,4,13,32,33,-1,31
Ballymena,1288,6,7,4,15,26,49,-23,25
Glentoran,1288,7,6,6,10,24,32,-8,24
Dungannon,1288,8,2,4,16,14,47,-33,10
Crusaders,1289,1,16,7,3,63,32,31,55
Coleraine,1289,2,14,10,2,44,24,20,52
Glenavon,1289,3,10,9,7,54,44,10,39
Linfield,1289,4,10,5,11,38,38,0,35
Cliftonville,1289,5,10,4,12,34,32,2,34
Ballymena,1289,6,7,5,14,27,49,-22,26
Glentoran,1289,7,6,6,10,24,32,-8,24
Dungannon,1289,8,2,4,16,14,47,-33,10
Crusaders,1290,1,17,6,3,62,30,32,57
Coleraine,1290,2,15,10,1,46,24,22,55
Linfield,1290,3,11,5,10,42,36,6,38
Glenavon,1290,4,9,9,8,54,46,8,36
Cliftonville,1290,5,9,4,13,32,36,-4,31
Ballymena,1290,6,7,4,15,25,48,-23,25
Glentoran,1290,7,6,6,10,24,32,-8,24
Dungannon,1290,8,2,4,16,14,47,-33,10
Crusaders,1291,1,16,6,4,61,32,29,54
Coleraine,1291,2,14,10,2,43,24,19,52
Glenavon,1291,3,10,9,7,54,43,11,39
Linfield,1291,4,11,5,10,42,38,4,38
Cliftonville,1291,5,9,4,13,34,36,-2,31
Ballymena,1291,6,8,4,14,27,47,-20,28
Glentoran,1291,7,6,6,10,24,32,-8,24
Dungannon,1291,8,2,4,16,14,47,-33,10
Crusaders,1292,1,17,6,3,62,30,32,57
Coleraine,1292,2,15,10,1,45,22,23,55
Glenavon,1292,3,9,9,8,52,45,7,36
Linfield,1292,4,10,6,10,38,37,1,36
Cliftonville,1292,5,9,5,12,33,32,1,32
Ballymena,1292,6,7,4,15,25,48,-23,25
Glentoran,1292,7,6,6,10,24,32,-8,24
Dungannon,1292,8,2,4,16,14,47,-33,10
Crusaders,1293,1,17,6,3,68,31,37,57
Coleraine,1293,2,15,10,1,45,22,23,55
Linfield,1293,3,11,5,10,38,36,2,38
Glenavon,1293,4,9,9,8,52,45,7,36
Cliftonville,1293,5,9,4,13,32,32,0,31
Ballymena,1293,6,7,4,15,26,54,-28,25
Glentoran,1293,7,6,6,10,24,32,-8,24
Dungannon,1293,8,2,4,16,14,47,-33,10
Crusaders,1294,1,16,6,4,62,33,29,54
Coleraine,1294,2,14,10,2,45,26,19,52
Glenavon,1294,3,10,9,7,56,45,11,39
Linfield,1294,4,11,5,10,38,36,2,38
Cliftonville,1294,5,9,4,13,32,32,0,31
Ballymena,1294,6,8,4,14,28,48,-20,28
Glentoran,1294,7,6,6,10,24,32,-8,24
Dungannon,1294,8,2,4,16,14,47,-33,10
Crusaders,1295,1,16,6,4,61,31,30,54
Coleraine,1295,2,14,11,1,43,22,21,53
Linfield,1295,3,11,5,10,39,36,3,38
Glenavon,1295,4,9,10,7,52,43,9,37
Cliftonville,1295,5,9,4,13,32,33,-1,31
Ballymena,1295,6,8,4,14,26,47,-21,28
Glentoran,1295,7,6,6,10,24,32,-8,24
Dungannon,1295,8,2,4,16,14,47,-33,10
Crusaders,1296,1,17,6,3,63,31,32,57
Coleraine,1296,2,15,10,1,44,22,22,55
Glenavon,1296,3,9,9,8,52,44,8,36
Linfield,1296,4,10,5,11,37,37,0,35
Cliftonville,1296,5,10,4,12,33,31,2,34
Ballymena,1296,6,7,4,15,26,49,-23,25
Glentoran,1296,7,6,6,10,24,32,-8,24
Dungannon,1296,8,2,4,16,14,47,-33,10
Crusaders,1297,1,17,6,3,65,31,34,57
Coleraine,1297,2,14,10,2,43,24,19,52
Glenavon,1297,3,10,9,7,54,43,11,39
Linfield,1297,4,11,5,10,40,36,4,38
Cliftonville,1297,5,9,4,13,32,34,-2,31
Ballymena,1297,6,7,4,15,26,51,-25,25
Glentoran,1297,7,6,6,10,24,32,-8,24
Dungannon,1297,8,2,4,16,14,47,-33,10
Crusaders,1298,1,17,6,3,67,32,35,57
Coleraine,1298,2,15,10,1,45,23,22,55
Glenavon,1298,3,9,9,8,53,45,8,36
Linfield,1298,4,10,5,11,38,38,0,35
Cliftonville,1298,5,10,4,12,34,32,2,34
Ballymena,1298,6,7,4,15,27,53,-26,25
Glentoran,1298,7,6,6,10,24,32,-8,24
Dungannon,1298,8,2,4,16,14,47,-33,10
Crusaders,1299,1,16,7,3,62,31,31,55
Coleraine,1299,2,14,10,2,45,26,19,52
Glenavon,1299,3,10,9,7,56,45,11,39
Linfield,1299,4,11,5,10,38,36,2,38
Cliftonville,1299,5,9,4,13,32,32,0,31
Ballymena,1299,6,7,5,14,26,48,-22,26
Glentoran,1299,7,6,6,10,24,32,-8,24
Dungannon,1299,8,2,4,16,14,47,-33,10
Crusaders,1300,1,16,7,3,62,31,31,55
Coleraine,1300,2,15,10,1,44,22,22,55
Linfield,1300,3,11,5,10,38,36,2,38
Glenavon,1300,4,9,9,8,52,44,8,36
Cliftonville,1300,5,9,4,13,32,32,0,31
Ballymena,1300,6,7,5,14,26,48,-22,26
Glentoran,1300,7,6,6,10,24,32,-8,24
Dungannon,1300,8,2,4,16,14,47,-33,10
Crusaders,1301,1,17,6,3,64,30,34,57
Coleraine,1301,2,15,10,1,44,22,22,55
Glenavon,1301,3,9,9,8,52,44,8,36
Linfield,1301,4,10,6,10,38,37,1,36
Cliftonville,1301,5,9,5,12,33,32,1,32
Ballymena,1301,6,7,4,15,25,50,-25,25
Glentoran,1301,7,6,6,10,24,32,-8,24
Dungannon,1301,8,2,4,16,14,47,-33,10
Crusaders,1302,1,17,6,3,65,33,32,57
Coleraine,1302,2,15,10,1,45,23,22,55
Linfield,1302,3,11,5,10,40,36,4,38
Glenavon,1302,4,9,9,8,53,45,8,36
Cliftonville,1302,5,9,4,13,32,34,-2,31
Ballymena,1302,6,7,4,15,28,51,-23,25
Glentoran,1302,7,6,6,10,24,32,-8,24
Dungannon,1302,8,2,4,16,14,47,-33,10
Crusaders,1303,1,17,6,3,65,31,34,57
Coleraine,1303,2,14,10,2,44,25,19,52
Glenavon,1303,3,10,9,7,55,44,11,39
Linfield,1303,4,10,6,10,38,37,1,36
Cliftonville,1303,5,9,5,12,33,32,1,32
Ballymena,1303,6,7,4,15,26,51,-25,25
Glentoran,1303,7,6,6,10,24,32,-8,24
Dungannon,1303,8,2,4,16,14,47,-33,10
Crusaders,1304,1,17,6,3,63,31,32,57
Coleraine,1304,2,15,10,1,44,22,22,55
Glenavon,1304,3,9,9,8,52,44,8,36
Linfield,1304,4,10,6,10,39,38,1,36
Cliftonville,1304,5,9,5,12,34,33,1,32
Ballymena,1304,6,7,4,15,26,49,-23,25
Glentoran,1304,7,6,6,10,24,32,-8,24
Dungannon,1304,8,2,4,16,14,47,-33,10
Coleraine,1305,1,15,10,1,46,24,22,55
Crusaders,1305,2,16,6,4,63,34,29,54
Glenavon,1305,3,9,9,8,54,46,8,36
Linfield,1305,4,10,5,11,37,39,-2,35
Cliftonville,1305,5,10,4,12,35,31,4,34
Ballymena,1305,6,8,4,14,29,49,-20,28
Glentoran,1305,7,6,6,10,24,32,-8,24
Dungannon,1305,8,2,4,16,14,47,-33,10
Crusaders,1306,1,16,7,3,62,31,31,55
Coleraine,1306,2,14,10,2,43,24,19,52
Glenavon,1306,3,10,9,7,54,43,11,39
Linfield,1306,4,11,5,10,39,36,3,38
Cliftonville,1306,5,9,4,13,32,33,-1,31
Ballymena,1306,6,7,5,14,26,48,-22,26
Glentoran,1306,7,6,6,10,24,32,-8,24
Dungannon,1306,8,2,4,16,14,47,-33,10
Crusaders,1307,1,17,6,3,65,30,35,57
Coleraine,1307,2,14,10,2,43,24,19,52
Glenavon,1307,3,10,9,7,54,43,11,39
Linfield,1307,4,10,6,10,38,37,1,36
Cliftonville,1307,5,9,5,12,33,32,1,32
Ballymena,1307,6,7,4,15,25,51,-26,25
Glentoran,1307,7,6,6,10,24,32,-8,24
Dungannon,1307,8,2,4,16,14,47,-33,10
Crusaders,1308,1,16,7,3,62,31,31,55
Coleraine,1308,2,14,10,2,44,25,19,52
Glenavon,1308,3,10,9,7,55,44,11,39
Linfield,1308,4,10,5,11,37,37,0,35
Cliftonville,1308,5,10,4,12,33,31,2,34
Ballymena,1308,6,7,5,14,26,48,-22,26
Glentoran,1308,7,6,6,10,24,32,-8,24
Dungannon,1308,8,2,4,16,14,47,-33,10
Coleraine,1309,1,15,10,1,45,23,22,55
Crusaders,1309,2,16,6,4,62,33,29,54
Linfield,1309,3,11,5,10,41,37,4,38
Glenavon,1309,4,9,9,8,53,45,8,36
Cliftonville,1309,5,9,4,13,33,35,-2,31
Ballymena,1309,6,8,4,14,28,48,-20,28
Glentoran,1309,7,6,6,10,24,32,-8,24
Dungannon,1309,8,2,4,16,14,47,-33,10
Crusaders,1310,1,17,6,3,64,30,34,57
Coleraine,1310,2,14,10,2,43,24,19,52
Glenavon,1310,3,10,9,7,54,43,11,39
Linfield,1310,4,11,5,10,38,36,2,38
Cliftonville,1310,5,9,4,13,32,32,0,31
Ballymena,1310,6,7,4,15,25,50,-25,25
Glentoran,1310,7,6,6,10,24,32,-8,24
Dungannon,1310,8,2,4,16,14,47,-33,10
Crusaders,1311,1,16,6,4,61,32,29,54
Coleraine,1311,2,14,11,1,44,23,21,53
Glenavon,1311,3,9,10,7,53,44,9,37
Linfield,1311,4,10,6,10,37,36,1,36
Cliftonville,1311,5,9,5,12,32,31,1,32
Ballymena,1311,6,8,4,14,27,47,-20,28
Glentoran,1311,7,6,6,10,24,32,-8,24
Dungannon,1311,8,2,4,16,14,47,-33,10
Crusaders,1312,1,16,6,4,62,33,29,54
Coleraine,1312,2,14,10,2,43,25,18,52
Glenavon,1312,3,10,9,7,55,43,12,39
Linfield,1312,4,10,5,11,37,39,-2,35
Cliftonville,1312,5,10,4,12,35,31,4,34
Ballymena,1312,6,8,4,14,28,48,-20,28
Glentoran,1312,7,6,6,10,24,32,-8,24
Dungannon,1312,8,2,4,16,14,47,-33,10
Crusaders,1313,1,16,6,4,63,33,30,54
Coleraine,1313,2,14,10,2,45,25,20,52
Glenavon,1313,3,10,9,7,55,45,10,39
Linfield,1313,4,10,5,11,38,38,0,35
Cliftonville,1313,5,10,4,12,34,32,2,34
Ballymena,1313,6,8,4,14,28,49,-21,28
Glentoran,1313,7,6,6,10,24,32,-8,24
Dungannon,1313,8,2,4,16,14,47,-33,10
Crusaders,1314,1,17,6,3,62,30,32,57
Coleraine,1314,2,14,11,1,45,24,21,53
Linfield,1314,3,11,5,10,39,37,2,38
Glenavon,1314,4,9,10,7,54,45,9,37
Cliftonville,1314,5,9,4,13,33,33,0,31
Ballymena,1314,6,7,4,15,25,48,-23,25
Glentoran,1314,7,6,6,10,24,32,-8,24
Dungannon,1314,8,2,4,16,14,47,-33,10
Crusaders,1315,1,17,6,3,66,32,34,57
Coleraine,1315,2,14,11,1,45,24,21,53
Linfield,1315,3,11,5,10,38,36,2,38
Glenavon,1315,4,9,10,7,54,45,9,37
Cliftonville,1315,5,9,4,13,32,32,0,31
Ballymena,1315,6,7,4,15,27,52,-25,25
Glentoran,1315,7,6,6,10,24,32,-8,24
Dungannon,1315,8,2,4,16,14,47,-33,10
Crusaders,1316,1,17,6,3,63,31,32,57
Coleraine,1316,2,14,10,2,44,24,20,52
Glenavon,1316,3,10,9,7,54,44,10,39
Linfield,1316,4,10,6,10,38,37,1,36
Cliftonville,1316,5,9,5,12,33,32,1,32
Ballymena,1316,6,7,4,15,26,49,-23,25
Glentoran,1316,7,6,6,10,24,32,-8,24
Dungannon,1316,8,2,4,16,14,47,-33,10
Crusaders,1317,1,17,6,3,65,33,32,57
Coleraine,1317,2,14,11,1,43,22,21,53
Linfield,1317,3,11,5,10,39,37,2,38
Glenavon,1317,4,9,10,7,52,43,9,37
Cliftonville,1317,5,9,4,13,33,33,0,31
Ballymena,1317,6,7,4,15,28,51,-23,25
Glentoran,1317,7,6,6,10,24,32,-8,24
Dungannon,1317,8,2,4,16,14,47,-33,10
Crusaders,1318,1,17,6,3,62,30,32,57
Coleraine,1318,2,15,10,1,45,23,22,55
Linfield,1318,3,11,5,10,39,37,2,38
Glenavon,1318,4,9,9,8,53,45,8,36
Cliftonville,1318,5,9,4,13,33,33,0,31
Ballymena,1318,6,7,4,15,25,48,-23,25
Glentoran,1318,7,6,6,10,24,32,-8,24
Dungannon,1318,8,2,4,16,14,47,-33,10
Crusaders,1319,1,17,6,3,64,32,32,57
Coleraine,1319,2,15,10,1,46,22,24,55
Glenavon,1319,3,9,9,8,52,46,6,36
Linfield,1319,4,10,5,11,37,38,-1,35
Cliftonville,1319,5,10,4,12,34,31,3,34
Ballymena,1319,6,7,4,15,27,50,-23,25
Glentoran,1319,7,6,6,10,24,32,-8,24
Dungannon,1319,8,2,4,16,14,47,-33,10
Crusaders,1320,1,17,6,3,64,30,34,57
Coleraine,1320,2,15,10,1,47,23,24,55
Glenavon,1320,3,9,9,8,53,47,6,36
Linfield,1320,4,10,6,10,38,37,1,36
Cliftonville,1320,5,9,5,12,33,32,1,32
Ballymena,1320,6,7,4,15,25,50,-25,25
Glentoran,1320,7,6,6,10,24,32,-8,24
Dungannon,1320,8,2,4,16,14,47,-33,10
Crusaders,1321,1,17,6,3,62,30,32,57
Coleraine,1321,2,14,10,2,44,24,20,52
Glenavon,1321,3,10,9,7,54,44,10,39
Linfield,1321,4,11,5,10,41,36,5,38
Cliftonville,1321,5,9,4,13,32,35,-3,31
Ballymena,1321,6,7,4,15,25,48,-23,25
Glentoran,1321,7,6,6,10,24,32,-8,24
Dungannon,1321,8,2,4,16,14,47,-33,10
Crusaders,1322,1,17,6,3,65,31,34,57
Coleraine,1322,2,15,10,1,48,23,25,55
Glenavon,1322,3,9,9,8,53,48,5,36
Linfield,1322,4,10,6,10,37,36,1,36
Cliftonville,1322,5,9,5,12,32,31,1,32
Ballymena,1322,6,7,4,15,26,51,-25,25
Glentoran,1322,7,6,6,10,24,32,-8,24
Dungannon,1322,8,2,4,16,14,47,-33,10
Crusaders,1323,1,17,6,3,63,31,32,57
Coleraine,1323,2,14,10,2,44,27,17,52
Glenavon,1323,3,10,9,7,57,44,13,39
Linfield,1323,4,10,5,11,38,38,0,35
Cliftonville,1323,5,10,4,12,34,32,2,34
Ballymena,1323,6,7,4,15,26,49,-23,25
Glentoran,1323,7,6,6,10,24,32,-8,24
Dungannon,1323,8,2,4,16,14,47,-33,10
Crusaders,1324,1,17,6,3,62,30,32,57
Coleraine,1324,2,15,10,1,44,22,22,55
Linfield,1324,3,11,5,10,39,37,2,38
Glenavon,1324,4,9,9,8,52,44,8,36
Cliftonville,1324,5,9,4,13,33,33,0,31
Ballymena,1324,6,7,4,15,25,48,-23,25
Glentoran,1324,7,6,6,10,24,32,-8,24
Dungannon,1324,8,2,4,16,14,47,-33,10
Coleraine,1325,1,15,10,1,45,23,22,55
Crusaders,1325,2,16,6,4,63,33,30,54
Linfield,1325,3,11,5,10,39,37,2,38
Glenavon,1325,4,9,9,8,53,45,8,36
Cliftonville,1325,5,9,4,13,33,33,0,31
Ballymena,1325,6,8,4,14,28,49,-21,28
Glentoran,1325,7,6,6,10,24,32,-8,24
Dungannon,1325,8,2,4,16,14,47,-33,10
Crusaders,1326,1,17,6,3,64,31,33,57
Coleraine,1326,2,14,10,2,43,29,14,52
Glenavon,1326,3,10,9,7,59,43,16,39
Linfield,1326,4,10,6,10,39,38,1,36
Cliftonville,1326,5,9,5,12,34,33,1,32
Ballymena,1326,6,7,4,15,26,50,-24,25
Glentoran,1326,7,6,6,10,24,32,-8,24
Dungannon,1326,8,2,4,16,14,47,-33,10
Crusaders,1327,1,16,6,4,63,33,30,54
Coleraine,1327,2,14,11,1,44,23,21,53
Glenavon,1327,3,9,10,7,53,44,9,37
Linfield,1327,4,10,5,11,37,38,-1,35
Cliftonville,1327,5,10,4,12,34,31,3,34
Ballymena,1327,6,8,4,14,28,49,-21,28
Glentoran,1327,7,6,6,10,24,32,-8,24
Dungannon,1327,8,2,4,16,14,47,-33,10
Crusaders,1328,1,17,6,3,64,32,32,57
Coleraine,1328,2,15,10,1,46,23,23,55
Glenavon,1328,3,9,9,8,53,46,7,36
Linfield,1328,4,10,5,11,38,38,0,35
Cliftonville,1328,5,10,4,12,34,32,2,34
Ballymena,1328,6,7,4,15,27,50,-23,25
Glentoran,1328,7,6,6,10,24,32,-8,24
Dungannon,1328,8,2,4,16,14,47,-33,10
Crusaders,1329,1,17,6,3,63,31,32,57
Coleraine,1329,2,15,10,1,46,23,23,55
Linfield,1329,3,11,5,10,39,36,3,38
Glenavon,1329,4,9,9,8,53,46,7,36
Cliftonville,1329,5,9,4,13,32,33,-1,31
Ballymena,1329,6,7,4,15,26,49,-23,25
Glentoran,1329,7,6,6,10,24,32,-8,24
Dungannon,1329,8,2,4,16,14,47,-33,10
Crusaders,1330,1,17,6,3,66,30,36,57
Coleraine,1330,2,14,10,2,44,28,16,52
Glenavon,1330,3,10,9,7,58,44,14,39
Linfield,1330,4,11,5,10,40,36,4,38
Cliftonville,1330,5,9,4,13,32,34,-2,31
Ballymena,1330,6,7,4,15,25,52,-27,25
Glentoran,1330,7,6,6,10,24,32,-8,24
Dungannon,1330,8,2,4,16,14,47,-33,10
Crusaders,1331,1,16,7,3,62,31,31,55
Coleraine,1331,2,14,10,2,44,24,20,52
Glenavon,1331,3,10,9,7,54,44,10,39
Linfield,1331,4,10,6,10,38,37,1,36
Cliftonville,1331,5,9,5,12,33,32,1,32
Ballymena,1331,6,7,5,14,26,48,-22,26
Glentoran,1331,7,6,6,10,24,32,-8,24
Dungannon,1331,8,2,4,16,14,47,-33,10
Crusaders,1332,1,17,6,3,67,32,35,57
Coleraine,1332,2,15,10,1,44,22,22,55
Linfield,1332,3,11,5,10,38,36,2,38
Glenavon,1332,4,9,9,8,52,44,8,36
Cliftonville,1332,5,9,4,13,32,32,0,31
Ballymena,1332,6,7,4,15,27,53,-26,25
Glentoran,1332,7,6,6,10,24,32,-8,24
Dungannon,1332,8,2,4,16,14,47,-33,10
Crusaders,1333,1,16,7,3,61,30,31,55
Coleraine,1333,2,14,10,2,43,25,18,52
Glenavon,1333,3,10,9,7,55,43,12,39
Linfield,1333,4,11,5,10,38,36,2,38
Cliftonville,1333,5,9,4,13,32,32,0,31
Ballymena,1333,6,7,5,14,25,47,-22,26
Glentoran,1333,7,6,6,10,24,32,-8,24
Dungannon,1333,8,2,4,16,14,47,-33,10
Crusaders,1334,1,16,6,4,62,32,30,54
Coleraine,1334,2,14,11,1,43,22,21,53
Linfield,1334,3,11,5,10,38,36,2,38
Glenavon,1334,4,9,10,7,52,43,9,37
Cliftonville,1334,5,9,4,13,32,32,0,31
Ballymena,1334,6,8,4,14,27,48,-21,28
Glentoran,1334,7,6,6,10,24,32,-8,24
Dungannon,1334,8,2,4,16,14,47,-33,10
Crusaders,1335,1,17,6,3,67,32,35,57
Coleraine,1335,2,14,10,2,46,26,20,52
Glenavon,1335,3,10,9,7,56,46,10,39
Linfield,1335,4,11,5,10,39,36,3,38
Cliftonville,1335,5,9,4,13,32,33,-1,31
Ballymena,1335,6,7,4,15,27,53,-26,25
Glentoran,1335,7,6,6,10,24,32,-8,24
Dungannon,1335,8,2,4,16,14,47,-33,10
Crusaders,1336,1,17,6,3,63,30,33,57
Coleraine,1336,2,14,11,1,45,24,21,53
Glenavon,1336,3,9,10,7,54,45,9,37
Linfield,1336,4,10,6,10,38,37,1,36
Cliftonville,1336,5,9,5,12,33,32,1,32
Ballymena,1336,6,7,4,15,25,49,-24,25
Glentoran,1336,7,6,6,10,24,32,-8,24
Dungannon,1336,8,2,4,16,14,47,-33,10
Crusaders,1337,1,17,6,3,64,32,32,57
Coleraine,1337,2,14,10,2,45,25,20,52
Glenavon,1337,3,10,9,7,55,45,10,39
Linfield,1337,4,10,5,11,37,37,0,35
Cliftonville,1337,5,10,4,12,33,31,2,34
Ballymena,1337,6,7,4,15,27,50,-23,25
Glentoran,1337,7,6,6,10,24,32,-8,24
Dungannon,1337,8,2,4,16,14,47,-33,10
Crusaders,1338,1,16,7,3,63,32,31,55
Coleraine,1338,2,15,10,1,46,23,23,55
Glenavon,1338,3,9,9,8,53,46,7,36
Linfield,1338,4,10,6,10,37,36,1,36
Cliftonville,1338,5,9,5,12,32,31,1,32
Ballymena,1338,6,7,5,14,27,49,-22,26
Glentoran,1338,7,6,6,10,24,32,-8,24
Dungannon,1338,8,2,4,16,14,47,-33,10
Crusaders,1339,1,16,6,4,63,35,28,54
Coleraine,1339,2,14,10,2,44,24,20,52
Glenavon,1339,3,10,9,7,54,44,10,39
Linfield,1339,4,11,5,10,38,36,2,38
Cliftonville,1339,5,9,4,13,32,32,0,31
Ballymena,1339,6,8,4,14,30,49,-19,28
Glentoran,1339,7,6,6,10,24,32,-8,24
Dungannon,1339,8,2,4,16,14,47,-33,10
Crusaders,1340,1,16,7,3,64,33,31,55
Coleraine,1340,2,15,10,1,47,24,23,55
Glenavon,1340,3,9,9,8,54,47,7,36
Linfield,1340,4,10,5,11,37,37,0,35
Cliftonville,1340,5,10,4,12,33,31,2,34
Ballymena,1340,6,7,5,14,28,50,-22,26
Glentoran,1340,7,6,6,10,24,32,-8,24
Dungannon,1340,8,2,4,16,14,47,-33,10
Crusaders,1341,1,16,7,3,63,32,31,55
Coleraine,1341,2,15,10,1,44,22,22,55
Linfield,1341,3,11,5,10,41,37,4,38
Glenavon,1341,4,9,9,8,52,44,8,36
Cliftonville,1341,5,9,4,13,33,35,-2,31
Ballymena,1341,6,7,5,14,27,49,-22,26
Glentoran,1341,7,6,6,10,24,32,-8,24
Dungannon,1341,8,2,4,16,14,47,-33,10
Coleraine,1342,1,15,10,1,45,23,22,55
Crusaders,1342,2,16,6,4,62,32,30,54
Glenavon,1342,3,9,9,8,53,45,8,36
Linfield,1342,4,10,5,11,39,39,0,35
Cliftonville,1342,5,10,4,12,35,33,2,34
Ballymena,1342,6,8,4,14,27,48,-21,28
Glentoran,1342,7,6,6,10,24,32,-8,24
Dungannon,1342,8,2,4,16,14,47,-33,10
Crusaders,1343,1,16,7,3,62,31,31,55
Coleraine,1343,2,15,10,1,46,23,23,55
Linfield,1343,3,11,5,10,38,36,2,38
Glenavon,1343,4,9,9,8,53,46,7,36
Cliftonville,1343,5,9,4,13,32,32,0,31
Ballymena,1343,6,7,5,14,26,48,-22,26
Glentoran,1343,7,6,6,10,24,32,-8,24
Dungannon,1343,8,2,4,16,14,47,-33,10
Crusaders,1344,1,16,7,3,63,32,31,55
Coleraine,1344,2,14,10,2,43,23,20,52
Glenavon,1344,3,10,9,7,53,43,10,39
Linfield,1344,4,10,6,10,38,37,1,36
Cliftonville,1344,5,9,5,12,33,32,1,32
Ballymena,1344,6,7,5,14,27,49,-22,26
Glentoran,1344,7,6,6,10,24,32,-8,24
Dungannon,1344,8,2,4,16,14,47,-33,10
Crusaders,1345,1,16,6,4,62,32,30,54
Coleraine,1345,2,14,11,1,44,23,21,53
Linfield,1345,3,11,5,10,38,36,2,38
Glenavon,1345,4,9,10,7,53,44,9,37
Cliftonville,1345,5,9,4,13,32,32,0,31
Ballymena,1345,6,8,4,14,27,48,-21,28
Glentoran,1345,7,6,6,10,24,32,-8,24
Dungannon,1345,8,2,4,16,14,47,-33,10
Crusaders,1346,1,17,6,3,63,31,32,57
Coleraine,1346,2,15,10,1,47,24,23,55
Glenavon,1346,3,9,9,8,54,47,7,36
Linfield,1346,4,10,5,11,37,38,-1,35
Cliftonville,1346,5,10,4,12,34,31,3,34
Ballymena,1346,6,7,4,15,26,49,-23,25
Glentoran,1346,7,6,6,10,24,32,-8,24
Dungannon,1346,8,2,4,16,14,47,-33,10
Coleraine,1347,1,15,10,1,44,22,22,55
Crusaders,1347,2,16,6,4,61,33,28,54
Glenavon,1347,3,9,9,8,52,44,8,36
Linfield,1347,4,10,6,10,37,36,1,36
Cliftonville,1347,5,9,5,12,32,31,1,32
Ballymena,1347,6,8,4,14,28,47,-19,28
Glentoran,1347,7,6,6,10,24,32,-8,24
Dungannon,1347,8,2,4,16,14,47,-33,10
Crusaders,1348,1,17,6,3,65,32,33,57
Coleraine,1348,2,14,11,1,44,23,21,53
Linfield,1348,3,11,5,10,39,37,2,38
Glenavon,1348,4,9,10,7,53,44,9,37
Cliftonville,1348,5,9,4,13,33,33,0,31
Ballymena,1348,6,7,4,15,27,51,-24,25
Glentoran,1348,7,6,6,10,24,32,-8,24
Dungannon,1348,8,2,4,16,14,47,-33,10
Crusaders,1349,1,17,6,3,64,31,33,57
Coleraine,1349,2,15,10,1,47,24,23,55
Linfield,1349,3,11,5,10,42,37,5,38
Glenavon,1349,4,9,9,8,54,47,7,36
Cliftonville,1349,5,9,4,13,33,36,-3,31
Ballymena,1349,6,7,4,15,26,50,-24,25
Glentoran,1349,7,6,6,10,24,32,-8,24
Dungannon,1349,8,2,4,16,14,47,-33,10
Coleraine,1350,1,15,10,1,45,23,22,55
Crusaders,1350,2,16,6,4,62,32,30,54
Glenavon,1350,3,9,9,8,53,45,8,36
Linfield,1350,4,10,5,11,38,38,0,35
Cliftonville,1350,5,10,4,12,34,32,2,34
Ballymena,1350,6,8,4,14,27,48,-21,28
Glentoran,1350,7,6,6,10,24,32,-8,24
Dungannon,1350,8,2,4,16,14,47,-33,10
Crusaders,1351,1,17,6,3,64,31,33,57
Coleraine,1351,2,14,10,2,45,25,20,52
Glenavon,1351,3,10,9,7,55,45,10,39
Linfield,1351,4,10,6,10,37,36,1,36
Cliftonville,1351,5,9,5,12,32,31,1,32
Ballymena,1351,6,7,4,15,26,50,-24,25
Glentoran,1351,7,6,6,10,24,32,-8,24
Dungannon,1351,8,2,4,16,14,47,-33,10
Coleraine,1352,1,15,10,1,47,25,22,55
Crusaders,1352,2,16,6,4,61,31,30,54
Glenavon,1352,3,9,9,8,55,47,8,36
Linfield,1352,4,10,5,11,38,38,0,35
Cliftonville,1352,5,10,4,12,34,32,2,34
Ballymena,1352,6,8,4,14,26,47,-21,28
Glentoran,1352,7,6,6,10,24,32,-8,24
Dungannon,1352,8,2,4,16,14,47,-33,10
Crusaders,1353,1,17,6,3,63,31,32,57
Coleraine,1353,2,14,10,2,43,24,19,52
Glenavon,1353,3,10,9,7,54,43,11,39
Linfield,1353,4,10,5,11,37,39,-2,35
Cliftonville,1353,5,10,4,12,35,31,4,34
Ballymena,1353,6,7,4,15,26,49,-23,25
Glentoran,1353,7,6,6,10,24,32,-8,24
Dungannon,1353,8,2,4,16,14,47,-33,10
Crusaders,1354,1,17,6,3,63,31,32,57
Coleraine,1354,2,14,11,1,45,24,21,53
Glenavon,1354,3,9,10,7,54,45,9,37
Linfield,1354,4,10,6,10,37,36,1,36
Cliftonville,1354,5,9,5,12,32,31,1,32
Ballymena,1354,6,7,4,15,26,49,-23,25
Glentoran,1354,7,6,6,10,24,32,-8,24
Dungannon,1354,8,2,4,16,14,47,-33,10
Crusaders,1355,1,16,6,4,64,34,30,54
Coleraine,1355,2,14,10,2,46,28,18,52
Glenavon,1355,3,10,9,7,58,46,12,39
Linfield,1355,4,11,5,10,39,36,3,38
Cliftonville,1355,5,9,4,13,32,33,-1,31
Ballymena,1355,6,8,4,14,29,50,-21,28
Glentoran,1355,7,6,6,10,24,32,-8,24
Dungannon,1355,8,2,4,16,14,47,-33,10
Crusaders,1356,1,17,6,3,63,31,32,57
Coleraine,1356,2,15,10,1,49,22,27,55
Glenavon,1356,3,9,9,8,52,49,3,36
Linfield,1356,4,10,5,11,38,38,0,35
Cliftonville,1356,5,10,4,12,34,32,2,34
Ballymena,1356,6,7,4,15,26,49,-23,25
Glentoran,1356,7,6,6,10,24,32,-8,24
Dungannon,1356,8,2,4,16,14,47,-33,10
Crusaders,1357,1,17,6,3,62,30,32,57
Coleraine,1357,2,15,10,1,46,24,22,55
Linfield,1357,3,11,5,10,40,36,4,38
Glenavon,1357,4,9,9,8,54,46,8,36
Cliftonville,1357,5,9,4,13,32,34,-2,31
Ballymena,1357,6,7,4,15,25,48,-23,25
Glentoran,1357,7,6,6,10,24,32,-8,24
Dungannon,1357,8,2,4,16,14,47,-33,10
Crusaders,1358,1,17,6,3,63,31,32,57
Coleraine,1358,2,14,10,2,44,24,20,52
Glenavon,1358,3,10,9,7,54,44,10,39
Linfield,1358,4,11,5,10,42,38,4,38
Cliftonville,1358,5,9,4,13,34,36,-2,31
Ballymena,1358,6,7,4,15,26,49,-23,25
Glentoran,1358,7,6,6,10,24,32,-8,24
Dungannon,1358,8,2,4,16,14,47,-33,10
Crusaders,1359,1,16,7,3,62,31,31,55
Coleraine,1359,2,14,10,2,45,25,20,52
Glenavon,1359,3,10,9,7,55,45,10,39
Linfield,1359,4,10,5,11,38,38,0,35
Cliftonville,1359,5,10,4,12,34,32,2,34
Ballymena,1359,6,7,5,14,26,48,-22,26
Glentoran,1359,7,6,6,10,24,32,-8,24
Dungannon,1359,8,2,4,16,14,47,-33,10
Crusaders,1360,1,17,6,3,64,31,33,57
Coleraine,1360,2,14,10,2,44,24,20,52
Glenavon,1360,3,10,9,7,54,44,10,39
Linfield,1360,4,10,5,11,38,38,0,35
Cliftonville,1360,5,10,4,12,34,32,2,34
Ballymena,1360,6,7,4,15,26,50,-24,25
Glentoran,1360,7,6,6,10,24,32,-8,24
Dungannon,1360,8,2,4,16,14,47,-33,10
Crusaders,1361,1,16,7,3,63,32,31,55
Coleraine,1361,2,15,10,1,48,22,26,55
Glenavon,1361,3,9,9,8,52,48,4,36
Linfield,1361,4,10,6,10,38,37,1,36
Cliftonville,1361,5,9,5,12,33,32,1,32
Ballymena,1361,6,7,5,14,27,49,-22,26
Glentoran,1361,7,6,6,10,24,32,-8,24
Dungannon,1361,8,2,4,16,14,47,-33,10
Crusaders,1362,1,17,6,3,62,30,32,57
Coleraine,1362,2,14,10,2,43,24,19,52
Glenavon,1362,3,10,9,7,54,43,11,39
Linfield,1362,4,10,6,10,38,37,1,36
Cliftonville,1362,5,9,5,12,33,32,1,32
Ballymena,1362,6,7,4,15,25,48,-23,25
Glentoran,1362,7,6,6,10,24,32,-8,24
Dungannon,1362,8,2,4,16,14,47,-33,10
Crusaders,1363,1,16,7,3,64,33,31,55
Coleraine,1363,2,14,10,2,43,25,18,52
Glenavon,1363,3,10,9,7,55,43,12,39
Linfield,1363,4,10,5,11,37,37,0,35
Cliftonville,1363,5,10,4,12,33,31,2,34
Ballymena,1363,6,7,5,14,28,50,-22,26
Glentoran,1363,7,6,6,10,24,32,-8,24
Dungannon,1363,8,2,4,16,14,47,-33,10
Crusaders,1364,1,17,6,3,63,31,32,57
Coleraine,1364,2,15,10,1,44,22,22,55
Glenavon,1364,3,9,9,8,52,44,8,36
Linfield,1364,4,10,5,11,38,38,0,35
Cliftonville,1364,5,10,4,12,34,32,2,34
Ballymena,1364,6,7,4,15,26,49,-23,25
Glentoran,1364,7,6,6,10,24,32,-8,24
Dungannon,1364,8,2,4,16,14,47,-33,10
Crusaders,1365,1,16,7,3,62,31,31,55
Coleraine,1365,2,15,10,1,45,23,22,55
Linfield,1365,3,11,5,10,40,36,4,38
Glenavon,1365,4,9,9,8,53,45,8,36
Cliftonville,1365,5,9,4,13,32,34,-2,31
Ballymena,1365,6,7,5,14,26,48,-22,26
Glentoran,1365,7,6,6,10,24,32,-8,24
Dungannon,1365,8,2,4,16,14,47,-33,10
Crusaders,1366,1,16,7,3,61,30,31,55
Coleraine,1366,2,14,11,1,44,23,21,53
Glenavon,1366,3,9,10,7,53,44,9,37
Linfield,1366,4,10,5,11,38,38,0,35
Cliftonville,1366,5,10,4,12,34,32,2,34
Ballymena,1366,6,7,5,14,25,47,-22,26
Glentoran,1366,7,6,6,10,24,32,-8,24
Dungannon,1366,8,2,4,16,14,47,-33,10
Coleraine,1367,1,15,10,1,45,23,22,55
Crusaders,1367,2,16,6,4,61,31,30,54
Linfield,1367,3,11,5,10,40,36,4,38
Glenavon,1367,4,9,9,8,53,45,8,36
Cliftonville,1367,5,9,4,13,32,34,-2,31
Ballymena,1367,6,8,4,14,26,47,-21,28
Glentoran,1367,7,6,6,10,24,32,-8,24
Dungannon,1367,8,2,4,16,14,47,-33,10
Crusaders,1368,1,17,6,3,63,30,33,57
Coleraine,1368,2,14,11,1,45,24,21,53
Glenavon,1368,3,9,10,7,54,45,9,37
Linfield,1368,4,10,6,10,37,36,1,36
Cliftonville,1368,5,9,5,12,32,31,1,32
Ballymena,1368,6,7,4,15,25,49,-24,25
Glentoran,1368,7,6,6,10,24,32,-8,24
Dungannon,1368,8,2,4,16,14,47,-33,10
Crusaders,1369,1,17,6,3,63,30,33,57
Coleraine,1369,2,14,10,2,44,24,20,52
Glenavon,1369,3,10,9,7,54,44,10,39
Linfield,1369,4,11,5,10,39,37,2,38
Cliftonville,1369,5,9,4,13,33,33,0,31
Ballymena,1369,6,7,4,15,25,49,-24,25
Glentoran,1369,7,6,6,10,24,32,-8,24
Dungannon,1369,8,2,4,16,14,47,-33,10
Crusaders,1370,1,17,6,3,64,30,34,57
Coleraine,1370,2,14,10,2,43,24,19,52
Glenavon,1370,3,10,9,7,54,43,11,39
Linfield,1370,4,11,5,10,38,36,2,38
Cliftonville,1370,5,9,4,13,32,32,0,31
Ballymena,1370,6,7,4,15,25,50,-25,25
Glentoran,1370,7,6,6,10,24,32,-8,24
Dungannon,1370,8,2,4,16,14,47,-33,10
Crusaders,1371,1,16,7,3,63,32,31,55
Coleraine,1371,2,14,10,2,44,25,19,52
Glenavon,1371,3,10,9,7,55,44,11,39
Linfield,1371,4,10,6,10,38,37,1,36
Cliftonville,1371,5,9,5,12,33,32,1,32
Ballymena,1371,6,7,5,14,27,49,-22,26
Glentoran,1371,7,6,6,10,24,32,-8,24
Dungannon,1371,8,2,4,16,14,47,-33,10
Crusaders,1372,1,17,6,3,63,30,33,57
Coleraine,1372,2,14,11,1,45,24,21,53
Linfield,1372,3,11,5,10,39,37,2,38
Glenavon,1372,4,9,10,7,54,45,9,37
Cliftonville,1372,5,9,4,13,33,33,0,31
Ballymena,1372,6,7,4,15,25,49,-24,25
Glentoran,1372,7,6,6,10,24,32,-8,24
Dungannon,1372,8,2,4,16,14,47,-33,10
Crusaders,1373,1,17,6,3,65,33,32,57
Coleraine,1373,2,14,10,2,44,24,20,52
Glenavon,1373,3,10,9,7,54,44,10,39
Linfield,1373,4,10,6,10,39,38,1,36
Cliftonville,1373,5,9,5,12,34,33,1,32
Ballymena,1373,6,7,4,15,28,51,-23,25
Glentoran,1373,7,6,6,10,24,32,-8,24
Dungannon,1373,8,2,4,16,14,47,-33,10
Crusaders,1374,1,17,6,3,64,32,32,57
Coleraine,1374,2,15,10,1,49,25,24,55
Linfield,1374,3,11,5,10,40,37,3,38
Glenavon,1374,4,9,9,8,55,49,6,36
Cliftonville,1374,5,9,4,13,33,34,-1,31
Ballymena,1374,6,7,4,15,27,50,-23,25
Glentoran,1374,7,6,6,10,24,32,-8,24
Dungannon,1374,8,2,4,16,14,47,-33,10
Crusaders,1375,1,16,7,3,63,32,31,55
Coleraine,1375,2,14,10,2,43,23,20,52
Glenavon,1375,3,10,9,7,53,43,10,39
Linfield,1375,4,10,5,11,38,38,0,35
Cliftonville,1375,5,10,4,12,34,32,2,34
Ballymena,1375,6,7,5,14,27,49,-22,26
Glentoran,1375,7,6,6,10,24,32,-8,24
Dungannon,1375,8,2,4,16,14,47,-33,10
Crusaders,1376,1,16,6,4,61,31,30,54
Coleraine,1376,2,14,10,2,45,25,20,52
Glenavon,1376,3,10,9,7,55,45,10,39
Linfield,1376,4,11,5,10,41,37,4,38
Cliftonville,1376,5,9,4,13,33,35,-2,31
Ballymena,1376,6,8,4,14,26,47,-21,28
Glentoran,1376,7,6,6,10,24,32,-8,24
Dungannon,1376,8,2,4,16,14,47,-33,10
Coleraine,1377,1,15,10,1,45,22,23,55
Crusaders,1377,2,16,6,4,61,33,28,54
Linfield,1377,3,11,5,10,38,36,2,38
Glenavon,1377,4,9,9,8,52,45,7,36
Cliftonville,1377,5,9,4,13,32,32,0,31
Ballymena,1377,6,8,4,14,28,47,-19,28
Glentoran,1377,7,6,6,10,24,32,-8,24
Dungannon,1377,8,2,4,16,14,47,-33,10
Crusaders,1378,1,16,6,4,62,33,29,54
Coleraine,1378,2,14,10,2,43,24,19,52
Glenavon,1378,3,10,9,7,54,43,11,39
Linfield,1378,4,11,5,10,39,36,3,38
Cliftonville,1378,5,9,4,13,32,33,-1,31
Ballymena,1378,6,8,4,14,28,48,-20,28
Glentoran,1378,7,6,6,10,24,32,-8,24
Dungannon,1378,8,2,4,16,14,47,-33,10
Crusaders,1379,1,17,6,3,63,30,33,57
Coleraine,1379,2,15,10,1,46,24,22,55
Linfield,1379,3,11,5,10,39,36,3,38
Glenavon,1379,4,9,9,8,54,46,8,36
Cliftonville,1379,5,9,4,13,32,33,-1,31
Ballymena,1379,6,7,4,15,25,49,-24,25
Glentoran,1379,7,6,6,10,24,32,-8,24
Dungannon,1379,8,2,4,16,14,47,-33,10
Crusaders,1380,1,17,6,3,63,30,33,57
Coleraine,1380,2,14,11,1,44,23,21,53
Glenavon,1380,3,9,10,7,53,44,9,37
Linfield,1380,4,10,5,11,41,41,0,35
Cliftonville,1380,5,10,4,12,37,35,2,34
Ballymena,1380,6,7,4,15,25,49,-24,25
Glentoran,1380,7,6,6,10,24,32,-8,24
Dungannon,1380,8,2,4,16,14,47,-33,10
Crusaders,1381,1,16,6,4,61,33,28,54
Coleraine,1381,2,14,10,2,44,25,19,52
Glenavon,1381,3,10,9,7,55,44,11,39
Linfield,1381,4,10,6,10,38,37,1,36
Cliftonville,1381,5,9,5,12,33,32,1,32
Ballymena,1381,6,8,4,14,28,47,-19,28
Glentoran,1381,7,6,6,10,24,32,-8,24
Dungannon,1381,8,2,4,16,14,47,-33,10
Crusaders,1382,1,17,6,3,64,30,34,57
Coleraine,1382,2,14,11,1,44,23,21,53
Linfield,1382,3,11,5,10,41,37,4,38
Glenavon,1382,4,9,10,7,53,44,9,37
Cliftonville,1382,5,9,4,13,33,35,-2,31
Ballymena,1382,6,7,4,15,25,50,-25,25
Glentoran,1382,7,6,6,10,24,32,-8,24
Dungannon,1382,8,2,4,16,14,47,-33,10
Crusaders,1383,1,17,6,3,65,32,33,57
Coleraine,1383,2,15,10,1,45,23,22,55
Linfield,1383,3,11,5,10,41,36,5,38
Glenavon,1383,4,9,9,8,53,45,8,36
Cliftonville,1383,5,9,4,13,32,35,-3,31
Ballymena,1383,6,7,4,15,27,51,-24,25
Glentoran,1383,7,6,6,10,24,32,-8,24
Dungannon,1383,8,2,4,16,14,47,-33,10
Crusaders,1384,1,17,6,3,65,30,35,57
Coleraine,1384,2,14,10,2,43,25,18,52
Glenavon,1384,3,10,9,7,55,43,12,39
Linfield,1384,4,11,5,10,40,37,3,38
Cliftonville,1384,5,9,4,13,33,34,-1,31
Ballymena,1384,6,7,4,15,25,51,-26,25
Glentoran,1384,7,6,6,10,24,32,-8,24
Dungannon,1384,8,2,4,16,14,47,-33,10
Crusaders,1385,1,17,6,3,64,30,34,57
Coleraine,1385,2,15,10,1,45,22,23,55
Linfield,1385,3,11,5,10,39,36,3,38
Glenavon,1385,4,9,9,8,52,45,7,36
Cliftonville,1385,5,9,4,13,32,33,-1,31
Ballymena,1385,6,7,4,15,25,50,-25,25
Glentoran,1385,7,6,6,10,24,32,-8,24
Dungannon,1385,8,2,4,16,14,47,-33,10
Crusaders,1386,1,17,6,3,63,31,32,57
Coleraine,1386,2,15,10,1,46,23,23,55
Linfield,1386,3,11,5,10,38,36,2,38
Glenavon,1386,4,9,9,8,53,46,7,36
Cliftonville,1386,5,9,4,13,32,32,0,31
Ballymena,1386,6,7,4,15,26,49,-23,25
Glentoran,1386,7,6,6,10,24,32,-8,24
Dungannon,1386,8,2,4,16,14,47,-33,10
Crusaders,1387,1,17,6,3,63,31,32,57
Coleraine,1387,2,14,10,2,44,27,17,52
Glenavon,1387,3,10,9,7,57,44,13,39
Linfield,1387,4,11,5,10,39,37,2,38
Cliftonville,1387,5,9,4,13,33,33,0,31
Ballymena,1387,6,7,4,15,26,49,-23,25
Glentoran,1387,7,6,6,10,24,32,-8,24
Dungannon,1387,8,2,4,16,14,47,-33,10
Crusaders,1388,1,17,6,3,62,30,32,57
Coleraine,1388,2,14,10,2,43,26,17,52
Glenavon,1388,3,10,9,7,56,43,13,39
Linfield,1388,4,10,6,10,37,36,1,36
Cliftonville,1388,5,9,5,12,32,31,1,32
Ballymena,1388,6,7,4,15,25,48,-23,25
Glentoran,1388,7,6,6,10,24,32,-8,24
Dungannon,1388,8,2,4,16,14,47,-33,10
Crusaders,1389,1,16,7,3,62,31,31,55
Coleraine,1389,2,14,10,2,45,26,19,52
Glenavon,1389,3,10,9,7,56,45,11,39
Linfield,1389,4,11,5,10,38,36,2,38
Cliftonville,1389,5,9,4,13,32,32,0,31
Ballymena,1389,6,7,5,14,26,48,-22,26
Glentoran,1389,7,6,6,10,24,32,-8,24
Dungannon,1389,8,2,4,16,14,47,-33,10
Crusaders,1390,1,16,7,3,63,32,31,55
Coleraine,1390,2,15,10,1,45,23,22,55
Glenavon,1390,3,9,9,8,53,45,8,36
Linfield,1390,4,10,5,11,39,39,0,35
Cliftonville,1390,5,10,4,12,35,33,2,34
Ballymena,1390,6,7,5,14,27,49,-22,26
Glentoran,1390,7,6,6,10,24,32,-8,24
Dungannon,1390,8,2,4,16,14,47,-33,10
Coleraine,1391,1,15,10,1,46,24,22,55
Crusaders,1391,2,16,6,4,62,32,30,54
Glenavon,1391,3,9,9,8,54,46,8,36
Linfield,1391,4,10,5,11,38,38,0,35
Cliftonville,1391,5,10,4,12,34,32,2,34
Ballymena,1391,6,8,4,14,27,48,-21,28
Glentoran,1391,7,6,6,10,24,32,-8,24
Dungannon,1391,8,2,4,16,14,47,-33,10
Crusaders,1392,1,16,7,3,65,34,31,55
Coleraine,1392,2,14,10,2,45,27,18,52
Glenavon,1392,3,10,9,7,57,45,12,39
Linfield,1392,4,10,6,10,38,37,1,36
Cliftonville,1392,5,9,5,12,33,32,1,32
Ballymena,1392,6,7,5,14,29,51,-22,26
Glentoran,1392,7,6,6,10,24,32,-8,24
Dungannon,1392,8,2,4,16,14,47,-33,10
Crusaders,1393,1,17,6,3,63,30,33,57
Coleraine,1393,2,15,10,1,46,22,24,55
Glenavon,1393,3,9,9,8,52,46,6,36
Linfield,1393,4,10,6,10,38,37,1,36
Cliftonville,1393,5,9,5,12,33,32,1,32
Ballymena,1393,6,7,4,15,25,49,-24,25
Glentoran,1393,7,6,6,10,24,32,-8,24
Dungannon,1393,8,2,4,16,14,47,-33,10
Crusaders,1394,1,17,6,3,64,32,32,57
Coleraine,1394,2,15,10,1,47,23,24,55
Glenavon,1394,3,9,9,8,53,47,6,36
Linfield,1394,4,10,5,11,37,37,0,35
Cliftonville,1394,5,10,4,12,33,31,2,34
Ballymena,1394,6,7,4,15,27,50,-23,25
Glentoran,1394,7,6,6,10,24,32,-8,24
Dungannon,1394,8,2,4,16,14,47,-33,10
Crusaders,1395,1,17,6,3,64,31,33,57
Coleraine,1395,2,14,10,2,43,25,18,52
Glenavon,1395,3,10,9,7,55,43,12,39
Linfield,1395,4,11,5,10,40,36,4,38
Cliftonville,1395,5,9,4,13,32,34,-2,31
Ballymena,1395,6,7,4,15,26,50,-24,25
Glentoran,1395,7,6,6,10,24,32,-8,24
Dungannon,1395,8,2,4,16,14,47,-33,10
Crusaders,1396,1,17,6,3,63,30,33,57
Coleraine,1396,2,14,10,2,43,24,19,52
Glenavon,1396,3,10,9,7,54,43,11,39
Linfield,1396,4,10,5,11,37,37,0,35
Cliftonville,1396,5,10,4,12,33,31,2,34
Ballymena,1396,6,7,4,15,25,49,-24,25
Glentoran,1396,7,6,6,10,24,32,-8,24
Dungannon,1396,8,2,4,16,14,47,-33,10
Coleraine,1397,1,15,10,1,48,24,24,55
Crusaders,1397,2,16,6,4,63,34,29,54
Linfield,1397,3,11,5,10,39,36,3,38
Glenavon,1397,4,9,9,8,54,48,6,36
Cliftonville,1397,5,9,4,13,32,33,-1,31
Ballymena,1397,6,8,4,14,29,49,-20,28
Glentoran,1397,7,6,6,10,24,32,-8,24
Dungannon,1397,8,2,4,16,14,47,-33,10
Crusaders,1398,1,17,6,3,64,31,33,57
Coleraine,1398,2,14,10,2,43,23,20,52
Glenavon,1398,3,10,9,7,53,43,10,39
Linfield,1398,4,10,5,11,37,37,0,35
Cliftonville,1398,5,10,4,12,33,31,2,34
Ballymena,1398,6,7,4,15,26,50,-24,25
Glentoran,1398,7,6,6,10,24,32,-8,24
Dungannon,1398,8,2,4,16,14,47,-33,10
Crusaders,1399,1,17,6,3,66,30,36,57
Coleraine,1399,2,14,10,2,43,25,18,52
Glenavon,1399,3,10,9,7,55,43,12,39
Linfield,1399,4,11,5,10,40,37,3,38
Cliftonville,1399,5,9,4,13,33,34,-1,31
Ballymena,1399,6,7,4,15,25,52,-27,25
Glentoran,1399,7,6,6,10,24,32,-8,24
Dungannon,1399,8,2,4,16,14,47,-33,10
Crusaders,1400,1,17,6,3,64,30,34,57
Coleraine,1400,2,14,10,2,44,24,20,52
Glenavon,1400,3,10,9,7,54,44,10,39
Linfield,1400,4,10,5,11,38,38,0,35
Cliftonville,1400,5,10,4,12,34,32,2,34
Ballymena,1400,6,7,4,15,25,50,-25,25
Glentoran,1400,7,6,6,10,24,32,-8,24
Dungannon,1400,8,2,4,16,14,47,-33,10
Crusaders,1401,1,17,6,3,67,30,37,57
Coleraine,1401,2,14,11,1,43,22,21,53
Glenavon,1401,3,9,10,7,52,43,9,37
Linfield,1401,4,10,6,10,39,38,1,36
Cliftonville,1401,5,9,5,12,34,33,1,32
Ballymena,1401,6,7,4,15,25,53,-28,25
Glentoran,1401,7,6,6,10,24,32,-8,24
Dungannon,1401,8,2,4,16,14,47,-33,10
Crusaders,1402,1,17,6,3,66,34,32,57
Coleraine,1402,2,14,10,2,43,23,20,52
Glenavon,1402,3,10,9,7,53,43,10,39
Linfield,1402,4,10,6,10,38,37,1,36
Cliftonville,1402,5,9,5,12,33,32,1,32
Ballymena,1402,6,7,4,15,29,52,-23,25
Glentoran,1402,7,6,6,10,24,32,-8,24
Dungannon,1402,8,2,4,16,14,47,-33,10
Coleraine,1403,1,15,10,1,44,22,22,55
Crusaders,1403,2,16,6,4,61,32,29,54
Glenavon,1403,3,9,9,8,52,44,8,36
Linfield,1403,4,10,5,11,38,38,0,35
Cliftonville,1403,5,10,4,12,34,32,2,34
Ballymena,1403,6,8,4,14,27,47,-20,28
Glentoran,1403,7,6,6,10,24,32,-8,24
Dungannon,1403,8,2,4,16,14,47,-33,10
Crusaders,1404,1,17,6,3,64,31,33,57
Coleraine,1404,2,14,10,2,43,23,20,52
Glenavon,1404,3,10,9,7,53,43,10,39
Linfield,1404,4,10,5,11,38,38,0,35
Cliftonville,1404,5,10,4,12,34,32,2,34
Ballymena,1404,6,7,4,15,26,50,-24,25
Glentoran,1404,7,6,6,10,24,32,-8,24
Dungannon,1404,8,2,4,16,14,47,-33,10
Crusaders,1405,1,16,7,3,61,30,31,55
Coleraine,1405,2,14,10,2,44,24,20,52
Glenavon,1405,3,10,9,7,54,44,10,39
Linfield,1405,4,11,5,10,39,37,2,38
Cliftonville,1405,5,9,4,13,33,33,0,31
Ballymena,1405,6,7,5,14,25,47,-22,26
Glentoran,1405,7,6,6,10,24,32,-8,24
Dungannon,1405,8,2,4,16,14,47,-33,10
Crusaders,1406,1,16,6,4,63,33,30,54
Coleraine,1406,2,14,11,1,44,23,21,53
Glenavon,1406,3,9,10,7,53,44,9,37
Linfield,1406,4,10,6,10,38,37,1,36
Cliftonville,1406,5,9,5,12,33,32,1,32
Ballymena,1406,6,8,4,14,28,49,-21,28
Glentoran,1406,7,6,6,10,24,32,-8,24
Dungannon,1406,8,2,4,16,14,47,-33,10
Crusaders,1407,1,16,7,3,62,31,31,55
Coleraine,1407,2,15,10,1,47,23,24,55
Linfield,1407,3,11,5,10,40,38,2,38
Glenavon,1407,4,9,9,8,53,47,6,36
Cliftonville,1407,5,9,4,13,34,34,0,31
Ballymena,1407,6,7,5,14,26,48,-22,26
Glentoran,1407,7,6,6,10,24,32,-8,24
Dungannon,1407,8,2,4,16,14,47,-33,10
Crusaders,1408,1,17,6,3,64,31,33,57
Coleraine,1408,2,14,11,1,43,22,21,53
Glenavon,1408,3,9,10,7,52,43,9,37
Linfield,1408,4,10,5,11,38,39,-1,35
Cliftonville,1408,5,10,4,12,35,32,3,34
Ballymena,1408,6,7,4,15,26,50,-24,25
Glentoran,1408,7,6,6,10,24,32,-8,24
Dungannon,1408,8,2,4,16,14,47,-33,10
Crusaders,1409,1,17,6,3,63,31,32,57
Coleraine,1409,2,15,10,1,44,22,22,55
Linfield,1409,3,11,5,10,39,36,3,38
Glenavon,1409,4,9,9,8,52,44,8,36
Cliftonville,1409,5,9,4,13,32,33,-1,31
Ballymena,1409,6,7,4,15,26,49,-23,25
Glentoran,1409,7,6,6,10,24,32,-8,24
Dungannon,1409,8,2,4,16,14,47,-33,10
Crusaders,1410,1,17,6,3,64,31,33,57
Coleraine,1410,2,14,10,2,43,29,14,52
Glenavon,1410,3,10,9,7,59,43,16,39
Linfield,1410,4,11,5,10,39,36,3,38
Cliftonville,1410,5,9,4,13,32,33,-1,31
Ballymena,1410,6,7,4,15,26,50,-24,25
Glentoran,1410,7,6,6,10,24,32,-8,24
Dungannon,1410,8,2,4,16,14,47,-33,10
Crusaders,1411,1,17,6,3,63,30,33,57
Coleraine,1411,2,15,10,1,46,24,22,55
Glenavon,1411,3,9,9,8,54,46,8,36
Linfield,1411,4,10,5,11,37,37,0,35
Cliftonville,1411,5,10,4,12,33,31,2,34
Ballymena,1411,6,7,4,15,25,49,-24,25
Glentoran,1411,7,6,6,10,24,32,-8,24
Dungannon,1411,8,2,4,16,14,47,-33,10
Crusaders,1412,1,17,6,3,64,32,32,57
Coleraine,1412,2,15,10,1,45,23,22,55
Glenavon,1412,3,9,9,8,53,45,8,36
Linfield,1412,4,10,5,11,38,38,0,35
Cliftonville,1412,5,10,4,12,34,32,2,34
Ballymena,1412,6,7,4,15,27,50,-23,25
Glentoran,1412,7,6,6,10,24,32,-8,24
Dungannon,1412,8,2,4,16,14,47,-33,10
Crusaders,1413,1,16,7,3,61,30,31,55
Coleraine,1413,2,14,10,2,43,25,18,52
Glenavon,1413,3,10,9,7,55,43,12,39
Linfield,1413,4,11,5,10,38,36,2,38
Cliftonville,1413,5,9,4,13,32,32,0,31
Ballymena,1413,6,7,5,14,25,47,-22,26
Glentoran,1413,7,6,6,10,24,32,-8,24
Dungannon,1413,8,2,4,16,14,47,-33,10
Crusaders,1414,1,17,6,3,62,30,32,57
Coleraine,1414,2,15,10,1,44,22,22,55
Linfield,1414,3,11,5,10,40,37,3,38
Glenavon,1414,4,9,9,8,52,44,8,36
Cliftonville,1414,5,9,4,13,33,34,-1,31
Ballymena,1414,6,7,4,15,25,48,-23,25
Glentoran,1414,7,6,6,10,24,32,-8,24
Dungannon,1414,8,2,4,16,14,47,-33,10
Coleraine,1415,1,15,10,1,45,23,22,55
Crusaders,1415,2,16,6,4,64,35,29,54
Glenavon,1415,3,9,9,8,53,45,8,36
Linfield,1415,4,10,5,11,38,38,0,35
Cliftonville,1415,5,10,4,12,34,32,2,34
Ballymena,1415,6,8,4,14,30,50,-20,28
Glentoran,1415,7,6,6,10,24,32,-8,24
Dungannon,1415,8,2,4,16,14,47,-33,10
Crusaders,1416,1,17,6,3,62,30,32,57
Coleraine,1416,2,15,10,1,45,23,22,55
Glenavon,1416,3,9,9,8,53,45,8,36
Linfield,1416,4,10,6,10,38,37,1,36
Cliftonville,1416,5,9,5,12,33,32,1,32
Ballymena,1416,6,7,4,15,25,48,-23,25
Glentoran,1416,7,6,6,10,24,32,-8,24
Dungannon,1416,8,2,4,16,14,47,-33,10
Crusaders,1417,1,17,6,3,65,31,34,57
Coleraine,1417,2,14,10,2,44,24,20,52
Glenavon,1417,3,10,9,7,54,44,10,39
Linfield,1417,4,11,5,10,38,36,2,38
Cliftonville,1417,5,9,4,13,32,32,0,31
Ballymena,1417,6,7,4,15,26,51,-25,25
Glentoran,1417,7,6,6,10,24,32,-8,24
Dungannon,1417,8,2,4,16,14,47,-33,10
Crusaders,1418,1,16,6,4,62,32,30,54
Coleraine,1418,2,14,10,2,44,26,18,52
Glenavon,1418,3,10,9,7,56,44,12,39
Linfield,1418,4,10,6,10,39,38,1,36
Cliftonville,1418,5,9,5,12,34,33,1,32
Ballymena,1418,6,8,4,14,27,48,-21,28
Glentoran,1418,7,6,6,10,24,32,-8,24
Dungannon,1418,8,2,4,16,14,47,-33,10
Crusaders,1419,1,16,6,4,61,31,30,54
Coleraine,1419,2,14,10,2,43,25,18,52
Glenavon,1419,3,10,9,7,55,43,12,39
Linfield,1419,4,10,5,11,38,39,-1,35
Cliftonville,1419,5,10,4,12,35,32,3,34
Ballymena,1419,6,8,4,14,26,47,-21,28
Glentoran,1419,7,6,6,10,24,32,-8,24
Dungannon,1419,8,2,4,16,14,47,-33,10
Crusaders,1420,1,16,6,4,62,32,30,54
Coleraine,1420,2,14,10,2,43,24,19,52
Glenavon,1420,3,10,9,7,54,43,11,39
Linfield,1420,4,11,5,10,40,37,3,38
Cliftonville,1420,5,9,4,13,33,34,-1,31
Ballymena,1420,6,8,4,14,27,48,-21,28
Glentoran,1420,7,6,6,10,24,32,-8,24
Dungannon,1420,8,2,4,16,14,47,-33,10
Crusaders,1421,1,16,7,3,61,30,31,55
Coleraine,1421,2,15,10,1,46,23,23,55
Linfield,1421,3,11,5,10,39,37,2,38
Glenavon,1421,4,9,9,8,53,46,7,36
Cliftonville,1421,5,9,4,13,33,33,0,31
Ballymena,1421,6,7,5,14,25,47,-22,26
Glentoran,1421,7,6,6,10,24,32,-8,24
Dungannon,1421,8,2,4,16,14,47,-33,10
Crusaders,1422,1,16,6,4,61,32,29,54
Coleraine,1422,2,14,10,2,43,24,19,52
Glenavon,1422,3,10,9,7,54,43,11,39
Linfield,1422,4,10,6,10,38,37,1,36
Cliftonville,1422,5,9,5,12,33,32,1,32
Ballymena,1422,6,8,4,14,27,47,-20,28
Glentoran,1422,7,6,6,10,24,32,-8,24
Dungannon,1422,8,2,4,16,14,47,-33,10
Crusaders,1423,1,17,6,3,63,30,33,57
Coleraine,1423,2,14,11,1,44,23,21,53
Glenavon,1423,3,9,10,7,53,44,9,37
Linfield,1423,4,10,5,11,39,39,0,35
Cliftonville,1423,5,10,4,12,35,33,2,34
Ballymena,1423,6,7,4,15,25,49,-24,25
Glentoran,1423,7,6,6,10,24,32,-8,24
Dungannon,1423,8,2,4,16,14,47,-33,10
Crusaders,1424,1,16,6,4,61,34,27,54
Coleraine,1424,2,14,11,1,43,22,21,53
Glenavon,1424,3,9,10,7,52,43,9,37
Linfield,1424,4,10,6,10,38,37,1,36
Cliftonville,1424,5,9,5,12,33,32,1,32
Ballymena,1424,6,8,4,14,29,47,-18,28
Glentoran,1424,7,6,6,10,24,32,-8,24
Dungannon,1424,8,2,4,16,14,47,-33,10
Crusaders,1425,1,16,7,3,63,32,31,55
Coleraine,1425,2,14,10,2,44,24,20,52
Glenavon,1425,3,10,9,7,54,44,10,39
Linfield,1425,4,11,5,10,39,36,3,38
Cliftonville,1425,5,9,4,13,32,33,-1,31
Ballymena,1425,6,7,5,14,27,49,-22,26
Glentoran,1425,7,6,6,10,24,32,-8,24
Dungannon,1425,8,2,4,16,14,47,-33,10
Crusaders,1426,1,16,6,4,62,33,29,54
Coleraine,1426,2,14,11,1,44,23,21,53
Linfield,1426,3,11,5,10,39,37,2,38
Glenavon,1426,4,9,10,7,53,44,9,37
Cliftonville,1426,5,9,4,13,33,33,0,31
Ballymena,1426,6,8,4,14,28,48,-20,28
Glentoran,1426,7,6,6,10,24,32,-8,24
Dungannon,1426,8,2,4,16,14,47,-33,10
Crusaders,1427,1,16,7,3,62,31,31,55
Coleraine,1427,2,14,11,1,43,22,21,53
Glenavon,1427,3,9,10,7,52,43,9,37
Linfield,1427,4,10,5,11,38,38,0,35
Cliftonville,1427,5,10,4,12,34,32,2,34
Ballymena,1427,6,7,5,14,26,48,-22,26
Glentoran,1427,7,6,6,10,24,32,-8,24
Dungannon,1427,8,2,4,16,14,47,-33,10
Crusaders,1428,1,16,7,3,63,32,31,55
Coleraine,1428,2,14,10,2,43,23,20,52
Glenavon,1428,3,10,9,7,53,43,10,39
Linfield,1428,4,10,5,11,38,40,-2,35
Cliftonville,1428,5,10,4,12,36,32,4,34
Ballymena,1428,6,7,5,14,27,49,-22,26
Glentoran,1428,7,6,6,10,24,32,-8,24
Dungannon,1428,8,2,4,16,14,47,-33,10
Crusaders,1429,1,16,7,3,62,31,31,55
Coleraine,1429,2,14,11,1,44,23,21,53
Linfield,1429,3,11,5,10,40,36,4,38
Glenavon,1429,4,9,10,7,53,44,9,37
Cliftonville,1429,5,9,4,13,32,34,-2,31
Ballymena,1429,6,7,5,14,26,48,-22,26
Glentoran,1429,7,6,6,10,24,32,-8,24
Dungannon,1429,8,2,4,16,14,47,-33,10
Crusaders,1430,1,16,7,3,62,31,31,55
Coleraine,1430,2,14,11,1,45,24,21,53
Glenavon,1430,3,9,10,7,54,45,9,37
Linfield,1430,4,10,5,11,38,38,0,35
Cliftonville,1430,5,10,4,12,34,32,2,34
Ballymena,1430,6,7,5,14,26,48,-22,26
Glentoran,1430,7,6,6,10,24,32,-8,24
Dungannon,1430,8,2,4,16,14,47,-33,10
Crusaders,1431,1,17,6,3,63,31,32,57
Coleraine,1431,2,14,10,2,43,23,20,52
Glenavon,1431,3,10,9,7,53,43,10,39
Linfield,1431,4,11,5,10,39,37,2,38
Cliftonville,1431,5,9,4,13,33,33,0,31
Ballymena,1431,6,7,4,15,26,49,-23,25
Glentoran,1431,7,6,6,10,24,32,-8,24
Dungannon,1431,8,2,4,16,14,47,-33,10
Crusaders,1432,1,16,7,3,64,33,31,55
Coleraine,1432,2,14,10,2,44,25,19,52
Glenavon,1432,3,10,9,7,55,44,11,39
Linfield,1432,4,11,5,10,39,36,3,38
Cliftonville,1432,5,9,4,13,32,33,-1,31
Ballymena,1432,6,7,5,14,28,50,-22,26
Glentoran,1432,7,6,6,10,24,32,-8,24
Dungannon,1432,8,2,4,16,14,47,-33,10
Crusaders,1433,1,16,7,3,62,31,31,55
Coleraine,1433,2,14,10,2,44,24,20,52
Glenavon,1433,3,10,9,7,54,44,10,39
Linfield,1433,4,11,5,10,38,36,2,38
Cliftonville,1433,5,9,4,13,32,32,0,31
Ballymena,1433,6,7,5,14,26,48,-22,26
Glentoran,1433,7,6,6,10,24,32,-8,24
Dungannon,1433,8,2,4,16,14,47,-33,10
Crusaders,1434,1,17,6,3,62,30,32,57
Coleraine,1434,2,15,10,1,44,22,22,55
Linfield,1434,3,11,5,10,38,36,2,38
Glenavon,1434,4,9,9,8,52,44,8,36
Cliftonville,1434,5,9,4,13,32,32,0,31
Ballymena,1434,6,7,4,15,25,48,-23,25
Glentoran,1434,7,6,6,10,24,32,-8,24
Dungannon,1434,8,2,4,16,14,47,-33,10
Crusaders,1435,1,16,7,3,63,32,31,55
Coleraine,1435,2,14,10,2,43,23,20,52
Glenavon,1435,3,10,9,7,53,43,10,39
Linfield,1435,4,11,5,10,40,36,4,38
Cliftonville,1435,5,9,4,13,32,34,-2,31
Ballymena,1435,6,7,5,14,27,49,-22,26
Glentoran,1435,7,6,6,10,24,32,-8,24
Dungannon,1435,8,2,4,16,14,47,-33,10
Crusaders,1436,1,16,7,3,63,32,31,55
Coleraine,1436,2,14,10,2,43,23,20,52
Glenavon,1436,3,10,9,7,53,43,10,39
Linfield,1436,4,10,5,11,37,37,0,35
Cliftonville,1436,5,10,4,12,33,31,2,34
Ballymena,1436,6,7,5,14,27,49,-22,26
Glentoran,1436,7,6,6,10,24,32,-8,24
Dungannon,1436,8,2,4,16,14,47,-33,10
Crusaders,1437,1,16,7,3,64,33,31,55
Coleraine,1437,2,14,11,1,46,25,21,53
Glenavon,1437,3,9,10,7,55,46,9,37
Linfield,1437,4,10,5,11,38,38,0,35
Cliftonville,1437,5,10,4,12,34,32,2,34
Ballymena,1437,6,7,5,14,28,50,-22,26
Glentoran,1437,7,6,6,10,24,32,-8,24
Dungannon,1437,8,2,4,16,14,47,-33,10
Crusaders,1438,1,17,6,3,64,31,33,57
Coleraine,1438,2,14,11,1,45,24,21,53
Glenavon,1438,3,9,10,7,54,45,9,37
Linfield,1438,4,10,6,10,38,37,1,36
Cliftonville,1438,5,9,5,12,33,32,1,32
Ballymena,1438,6,7,4,15,26,50,-24,25
Glentoran,1438,7,6,6,10,24,32,-8,24
Dungannon,1438,8,2,4,16,14,47,-33,10
Coleraine,1439,1,15,10,1,45,23,22,55
Crusaders,1439,2,16,6,4,62,32,30,54
Glenavon,1439,3,9,9,8,53,45,8,36
Linfield,1439,4,10,6,10,38,37,1,36
Cliftonville,1439,5,9,5,12,33,32,1,32
Ballymena,1439,6,8,4,14,27,48,-21,28
Glentoran,1439,7,6,6,10,24,32,-8,24
Dungannon,1439,8,2,4,16,14,47,-33,10
Crusaders,1440,1,16,7,3,63,32,31,55
Coleraine,1440,2,14,10,2,43,24,19,52
Glenavon,1440,3,10,9,7,54,43,11,39
Linfield,1440,4,11,5,10,38,36,2,38
Cliftonville,1440,5,9,4,13,32,32,0,31
Ballymena,1440,6,7,5,14,27,49,-22,26
Glentoran,1440,7,6,6,10,24,32,-8,24
Dungannon,1440,8,2,4,16,14,47,-33,10
Coleraine,1441,1,15,10,1,45,22,23,55
Crusaders,1441,2,16,6,4,61,32,29,54
Glenavon,1441,3,9,9,8,52,45,7,36
Linfield,1441,4,10,5,11,37,38,-1,35
Cliftonville,1441,5,10,4,12,34,31,3,34
Ballymena,1441,6,8,4,14,27,47,-20,28
Glentoran,1441,7,6,6,10,24,32,-8,24
Dungannon,1441,8,2,4,16,14,47,-33,10
Crusaders,1442,1,16,7,3,61,30,31,55
Coleraine,1442,2,15,10,1,45,22,23,55
Glenavon,1442,3,9,9,8,52,45,7,36
Linfield,1442,4,10,5,11,38,40,-2,35
Cliftonville,1442,5,10,4,12,36,32,4,34
Ballymena,1442,6,7,5,14,25,47,-22,26
Glentoran,1442,7,6,6,10,24,32,-8,24
Dungannon,1442,8,2,4,16,14,47,-33,10
Crusaders,1443,1,17,6,3,65,33,32,57
Coleraine,1443,2,15,10,1,45,23,22,55
Glenavon,1443,3,9,9,8,53,45,8,36
Linfield,1443,4,10,5,11,39,39,0,35
Cliftonville,1443,5,10,4,12,35,33,2,34
Ballymena,1443,6,7,4,15,28,51,-23,25
Glentoran,1443,7,6,6,10,24,32,-8,24
Dungannon,1443,8,2,4,16,14,47,-33,10
Crusaders,1444,1,17,6,3,64,31,33,57
Coleraine,1444,2,15,10,1,46,24,22,55
Glenavon,1444,3,9,9,8,54,46,8,36
Linfield,1444,4,10,5,11,37,38,-1,35
Cliftonville,1444,5,10,4,12,34,31,3,34
Ballymena,1444,6,7,4,15,26,50,-24,25
Glentoran,1444,7,6,6,10,24,32,-8,24
Dungannon,1444,8,2,4,16,14,47,-33,10
Crusaders,1445,1,17,6,3,62,30,32,57
Coleraine,1445,2,14,11,1,44,23,21,53
Glenavon,1445,3,9,10,7,53,44,9,37
Linfield,1445,4,10,5,11,38,39,-1,35
Cliftonville,1445,5,10,4,12,35,32,3,34
Ballymena,1445,6,7,4,15,25,48,-23,25
Glentoran,1445,7,6,6,10,24,32,-8,24
Dungannon,1445,8,2,4,16,14,47,-33,10
Crusaders,1446,1,17,6,3,62,30,32,57
Coleraine,1446,2,15,10,1,45,23,22,55
Glenavon,1446,3,9,9,8,53,45,8,36
Linfield,1446,4,10,5,11,37,38,-1,35
Cliftonville,1446,5,10,4,12,34,31,3,34
Ballymena,1446,6,7,4,15,25,48,-23,25
Glentoran,1446,7,6,6,10,24,32,-8,24
Dungannon,1446,8,2,4,16,14,47,-33,10
Crusaders,1447,1,16,6,4,62,32,30,54
Coleraine,1447,2,14,11,1,43,22,21,53
Linfield,1447,3,11,5,10,40,37,3,38
Glenavon,1447,4,9,10,7,52,43,9,37
Cliftonville,1447,5,9,4,13,33,34,-1,31
Ballymena,1447,6,8,4,14,27,48,-21,28
Glentoran,1447,7,6,6,10,24,32,-8,24
Dungannon,1447,8,2,4,16,14,47,-33,10
Crusaders,1448,1,16,7,3,62,31,31,55
Coleraine,1448,2,14,10,2,43,24,19,52
Glenavon,1448,3,10,9,7,54,43,11,39
Linfield,1448,4,11,5,10,41,36,5,38
Cliftonville,1448,5,9,4,13,32,35,-3,31
Ballymena,1448,6,7,5,14,26,48,-22,26
Glentoran,1448,7,6,6,10,24,32,-8,24
Dungannon,1448,8,2,4,16,14,47,-33,10
Crusaders,1449,1,16,7,3,63,32,31,55
Coleraine,1449,2,14,10,2,44,24,20,52
Glenavon,1449,3,10,9,7,54,44,10,39
Linfield,1449,4,10,6,10,37,36,1,36
Cliftonville,1449,5,9,5,12,32,31,1,32
Ballymena,1449,6,7,5,14,27,49,-22,26
Glentoran,1449,7,6,6,10,24,32,-8,24
Dungannon,1449,8,2,4,16,14,47,-33,10
Crusaders,1450,1,16,7,3,63,32,31,55
Coleraine,1450,2,14,11,1,44,23,21,53
Linfield,1450,3,11,5,10,40,37,3,38
Glenavon,1450,4,9,10,7,53,44,9,37
Cliftonville,1450,5,9,4,13,33,34,-1,31
Ballymena,1450,6,7,5,14,27,49,-22,26
Glentoran,1450,7,6,6,10,24,32,-8,24
Dungannon,1450,8,2,4,16,14,47,-33,10
Crusaders,1451,1,17,6,3,63,30,33,57
Coleraine,1451,2,14,10,2,43,25,18,52
Glenavon,1451,3,10,9,7,55,43,12,39
Linfield,1451,4,11,5,10,39,37,2,38
Cliftonville,1451,5,9,4,13,33,33,0,31
Ballymena,1451,6,7,4,15,25,49,-24,25
Glentoran,1451,7,6,6,10,24,32,-8,24
Dungannon,1451,8,2,4,16,14,47,-33,10
Coleraine,1452,1,15,10,1,48,23,25,55
Crusaders,1452,2,16,6,4,61,34,27,54
Linfield,1452,3,11,5,10,39,36,3,38
Glenavon,1452,4,9,9,8,53,48,5,36
Cliftonville,1452,5,9,4,13,32,33,-1,31
Ballymena,1452,6,8,4,14,29,47,-18,28
Glentoran,1452,7,6,6,10,24,32,-8,24
Dungannon,1452,8,2,4,16,14,47,-33,10
Crusaders,1453,1,17,6,3,63,31,32,57
Coleraine,1453,2,15,10,1,45,22,23,55
Linfield,1453,3,11,5,10,39,37,2,38
Glenavon,1453,4,9,9,8,52,45,7,36
Cliftonville,1453,5,9,4,13,33,33,0,31
Ballymena,1453,6,7,4,15,26,49,-23,25
Glentoran,1453,7,6,6,10,24,32,-8,24
Dungannon,1453,8,2,4,16,14,47,-33,10
Crusaders,1454,1,16,7,3,62,31,31,55
Coleraine,1454,2,14,10,2,44,25,19,52
Glenavon,1454,3,10,9,7,55,44,11,39
Linfield,1454,4,11,5,10,41,37,4,38
Cliftonville,1454,5,9,4,13,33,35,-2,31
Ballymena,1454,6,7,5,14,26,48,-22,26
Glentoran,1454,7,6,6,10,24,32,-8,24
Dungannon,1454,8,2,4,16,14,47,-33,10
Crusaders,1455,1,17,6,3,64,31,33,57
Coleraine,1455,2,14,10,2,43,23,20,52
Glenavon,1455,3,10,9,7,53,43,10,39
Linfield,1455,4,11,5,10,40,36,4,38
Cliftonville,1455,5,9,4,13,32,34,-2,31
Ballymena,1455,6,7,4,15,26,50,-24,25
Glentoran,1455,7,6,6,10,24,32,-8,24
Dungannon,1455,8,2,4,16,14,47,-33,10
Crusaders,1456,1,17,6,3,64,30,34,57
Coleraine,1456,2,14,11,1,43,22,21,53
Linfield,1456,3,11,5,10,38,36,2,38
Glenavon,1456,4,9,10,7,52,43,9,37
Cliftonville,1456,5,9,4,13,32,32,0,31
Ballymena,1456,6,7,4,15,25,50,-25,25
Glentoran,1456,7,6,6,10,24,32,-8,24
Dungannon,1456,8,2,4,16,14,47,-33,10
Crusaders,1457,1,16,7,3,64,33,31,55
Coleraine,1457,2,14,10,2,44,24,20,52
Glenavon,1457,3,10,9,7,54,44,10,39
Linfield,1457,4,10,6,10,38,37,1,36
Cliftonville,1457,5,9,5,12,33,32,1,32
Ballymena,1457,6,7,5,14,28,50,-22,26
Glentoran,1457,7,6,6,10,24,32,-8,24
Dungannon,1457,8,2,4,16,14,47,-33,10
Crusaders,1458,1,17,6,3,65,30,35,57
Coleraine,1458,2,14,11,1,44,23,21,53
Linfield,1458,3,11,5,10,41,36,5,38
Glenavon,1458,4,9,10,7,53,44,9,37
Cliftonville,1458,5,9,4,13,32,35,-3,31
Ballymena,1458,6,7,4,15,25,51,-26,25
Glentoran,1458,7,6,6,10,24,32,-8,24
Dungannon,1458,8,2,4,16,14,47,-33,10
Crusaders,1459,1,16,6,4,62,32,30,54
Coleraine,1459,2,14,10,2,44,24,20,52
Glenavon,1459,3,10,9,7,54,44,10,39
Linfield,1459,4,10,5,11,39,39,0,35
Cliftonville,1459,5,10,4,12,35,33,2,34
Ballymena,1459,6,8,4,14,27,48,-21,28
Glentoran,1459,7,6,6,10,24,32,-8,24
Dungannon,1459,8,2,4,16,14,47,-33,10
Crusaders,1460,1,17,6,3,62,30,32,57
Coleraine,1460,2,14,11,1,44,23,21,53
Glenavon,1460,3,9,10,7,53,44,9,37
Linfield,1460,4,10,6,10,38,37,1,36
Cliftonville,1460,5,9,5,12,33,32,1,32
Ballymena,1460,6,7,4,15,25,48,-23,25
Glentoran,1460,7,6,6,10,24,32,-8,24
Dungannon,1460,8,2,4,16,14,47,-33,10
Crusaders,1461,1,16,7,3,62,31,31,55
Coleraine,1461,2,15,10,1,45,23,22,55
Linfield,1461,3,11,5,10,38,36,2,38
Glenavon,1461,4,9,9,8,53,45,8,36
Cliftonville,1461,5,9,4,13,32,32,0,31
Ballymena,1461,6,7,5,14,26,48,-22,26
Glentoran,1461,7,6,6,10,24,32,-8,24
Dungannon,1461,8,2,4,16,14,47,-33,10
Crusaders,1462,1,17,6,3,63,31,32,57
Coleraine,1462,2,14,10,2,43,24,19,52
Glenavon,1462,3,10,9,7,54,43,11,39
Linfield,1462,4,11,5,10,39,37,2,38
Cliftonville,1462,5,9,4,13,33,33,0,31
Ballymena,1462,6,7,4,15,26,49,-23,25
Glentoran,1462,7,6,6,10,24,32,-8,24
Dungannon,1462,8,2,4,16,14,47,-33,10
Crusaders,1463,1,17,6,3,64,30,34,57
Coleraine,1463,2,15,10,1,44,22,22,55
Linfield,1463,3,11,5,10,41,36,5,38
Glenavon,1463,4,9,9,8,52,44,8,36
Cliftonville,1463,5,9,4,13,32,35,-3,31
Ballymena,1463,6,7,4,15,25,50,-25,25
Glentoran,1463,7,6,6,10,24,32,-8,24
Dungannon,1463,8,2,4,16,14,47,-33,10
Crusaders,1464,1,17,6,3,63,31,32,57
Coleraine,1464,2,14,10,2,43,24,19,52
Glenavon,1464,3,10,9,7,54,43,11,39
Linfield,1464,4,11,5,10,40,37,3,38
Cliftonville,1464,5,9,4,13,33,34,-1,31
Ballymena,1464,6,7,4,15,26,49,-23,25
Glentoran,1464,7,6,6,10,24,32,-8,24
Dungannon,1464,8,2,4,16,14,47,-33,10
Coleraine,1465,1,15,10,1,46,22,24,55
Crusaders,1465,2,16,6,4,62,34,28,54
Glenavon,1465,3,9,9,8,52,46,6,36
Linfield,1465,4,10,5,11,39,40,-1,35
Cliftonville,1465,5,10,4,12,36,33,3,34
Ballymena,1465,6,8,4,14,29,48,-19,28
Glentoran,1465,7,6,6,10,24,32,-8,24
Dungannon,1465,8,2,4,16,14,47,-33,10
Crusaders,1466,1,17,6,3,64,30,34,57
Coleraine,1466,2,14,10,2,44,24,20,52
Glenavon,1466,3,10,9,7,54,44,10,39
Linfield,1466,4,10,6,10,39,38,1,36
Cliftonville,1466,5,9,5,12,34,33,1,32
Ballymena,1466,6,7,4,15,25,50,-25,25
Glentoran,1466,7,6,6,10,24,32,-8,24
Dungannon,1466,8,2,4,16,14,47,-33,10
Crusaders,1467,1,16,7,3,62,31,31,55
Coleraine,1467,2,14,10,2,43,24,19,52
Glenavon,1467,3,10,9,7,54,43,11,39
Linfield,1467,4,10,6,10,37,36,1,36
Cliftonville,1467,5,9,5,12,32,31,1,32
Ballymena,1467,6,7,5,14,26,48,-22,26
Glentoran,1467,7,6,6,10,24,32,-8,24
Dungannon,1467,8,2,4,16,14,47,-33,10
Coleraine,1468,1,15,10,1,45,23,22,55
Crusaders,1468,2,16,6,4,61,33,28,54
Glenavon,1468,3,9,9,8,53,45,8,36
Linfield,1468,4,10,6,10,37,36,1,36
Cliftonville,1468,5,9,5,12,32,31,1,32
Ballymena,1468,6,8,4,14,28,47,-19,28
Glentoran,1468,7,6,6,10,24,32,-8,24
Dungannon,1468,8,2,4,16,14,47,-33,10
Crusaders,1469,1,16,7,3,64,33,31,55
Coleraine,1469,2,14,10,2,44,24,20,52
Glenavon,1469,3,10,9,7,54,44,10,39
Linfield,1469,4,10,6,10,38,37,1,36
Cliftonville,1469,5,9,5,12,33,32,1,32
Ballymena,1469,6,7,5,14,28,50,-22,26
Glentoran,1469,7,6,6,10,24,32,-8,24
Dungannon,1469,8,2,4,16,14,47,-33,10
Crusaders,1470,1,16,6,4,64,34,30,54
Coleraine,1470,2,14,11,1,46,25,21,53
Linfield,1470,3,11,5,10,39,37,2,38
Glenavon,1470,4,9,10,7,55,46,9,37
Cliftonville,1470,5,9,4,13,33,33,0,31
Ballymena,1470,6,8,4,14,29,50,-21,28
Glentoran,1470,7,6,6,10,24,32,-8,24
Dungannon,1470,8,2,4,16,14,47,-33,10
Crusaders,1471,1,17,6,3,62,30,32,57
Coleraine,1471,2,14,10,2,43,24,19,52
Glenavon,1471,3,10,9,7,54,43,11,39
Linfield,1471,4,11,5,10,41,38,3,38
Cliftonville,1471,5,9,4,13,34,35,-1,31
Ballymena,1471,6,7,4,15,25,48,-23,25
Glentoran,1471,7,6,6,10,24,32,-8,24
Dungannon,1471,8,2,4,16,14,47,-33,10
Crusaders,1472,1,17,6,3,64,30,34,57
Coleraine,1472,2,14,11,1,45,24,21,53
Linfield,1472,3,11,5,10,40,37,3,38
Glenavon,1472,4,9,10,7,54,45,9,37
Cliftonville,1472,5,9,4,13,33,34,-1,31
Ballymena,1472,6,7,4,15,25,50,-25,25
Glentoran,1472,7,6,6,10,24,32,-8,24
Dungannon,1472,8,2,4,16,14,47,-33,10
Crusaders,1473,1,16,6,4,62,32,30,54
Coleraine,1473,2,14,11,1,44,23,21,53
Glenavon,1473,3,9,10,7,53,44,9,37
Linfield,1473,4,10,6,10,39,38,1,36
Cliftonville,1473,5,9,5,12,34,33,1,32
Ballymena,1473,6,8,4,14,27,48,-21,28
Glentoran,1473,7,6,6,10,24,32,-8,24
Dungannon,1473,8,2,4,16,14,47,-33,10
Crusaders,1474,1,16,6,4,61,31,30,54
Coleraine,1474,2,14,10,2,43,26,17,52
Glenavon,1474,3,10,9,7,56,43,13,39
Linfield,1474,4,10,6,10,38,37,1,36
Cliftonville,1474,5,9,5,12,33,32,1,32
Ballymena,1474,6,8,4,14,26,47,-21,28
Glentoran,1474,7,6,6,10,24,32,-8,24
Dungannon,1474,8,2,4,16,14,47,-33,10
Crusaders,1475,1,17,6,3,65,32,33,57
Coleraine,1475,2,15,10,1,45,22,23,55
Linfield,1475,3,11,5,10,38,36,2,38
Glenavon,1475,4,9,9,8,52,45,7,36
Cliftonville,1475,5,9,4,13,32,32,0,31
Ballymena,1475,6,7,4,15,27,51,-24,25
Glentoran,1475,7,6,6,10,24,32,-8,24
Dungannon,1475,8,2,4,16,14,47,-33,10
Crusaders,1476,1,16,7,3,62,31,31,55
Coleraine,1476,2,14,10,2,44,24,20,52
Glenavon,1476,3,10,9,7,54,44,10,39
Linfield,1476,4,10,6,10,38,37,1,36
Cliftonville,1476,5,9,5,12,33,32,1,32
Ballymena,1476,6,7,5,14,26,48,-22,26
Glentoran,1476,7,6,6,10,24,32,-8,24
Dungannon,1476,8,2,4,16,14,47,-33,10
Crusaders,1477,1,16,7,3,62,31,31,55
Coleraine,1477,2,14,10,2,45,25,20,52
Glenavon,1477,3,10,9,7,55,45,10,39
Linfield,1477,4,11,5,10,39,37,2,38
Cliftonville,1477,5,9,4,13,33,33,0,31
Ballymena,1477,6,7,5,14,26,48,-22,26
Glentoran,1477,7,6,6,10,24,32,-8,24
Dungannon,1477,8,2,4,16,14,47,-33,10
Crusaders,1478,1,17,6,3,64,30,34,57
Coleraine,1478,2,14,10,2,43,23,20,52
Glenavon,1478,3,10,9,7,53,43,10,39
Linfield,1478,4,10,5,11,37,40,-3,35
Cliftonville,1478,5,10,4,12,36,31,5,34
Ballymena,1478,6,7,4,15,25,50,-25,25
Glentoran,1478,7,6,6,10,24,32,-8,24
Dungannon,1478,8,2,4,16,14,47,-33,10
Crusaders,1479,1,16,7,3,63,32,31,55
Coleraine,1479,2,15,10,1,45,22,23,55
Glenavon,1479,3,9,9,8,52,45,7,36
Linfield,1479,4,10,6,10,38,37,1,36
Cliftonville,1479,5,9,5,12,33,32,1,32
Ballymena,1479,6,7,5,14,27,49,-22,26
Glentoran,1479,7,6,6,10,24,32,-8,24
Dungannon,1479,8,2,4,16,14,47,-33,10
Crusaders,1480,1,17,6,3,63,31,32,57
Coleraine,1480,2,15,10,1,44,22,22,55
Linfield,1480,3,11,5,10,39,36,3,38
Glenavon,1480,4,9,9,8,52,44,8,36
Cliftonville,1480,5,9,4,13,32,33,-1,31
Ballymena,1480,6,7,4,15,26,49,-23,25
Glentoran,1480,7,6,6,10,24,32,-8,24
Dungannon,1480,8,2,4,16,14,47,-33,10
Crusaders,1481,1,17,6,3,63,31,32,57
Coleraine,1481,2,15,10,1,46,23,23,55
Glenavon,1481,3,9,9,8,53,46,7,36
Linfield,1481,4,10,6,10,39,38,1,36
Cliftonville,1481,5,9,5,12,34,33,1,32
Ballymena,1481,6,7,4,15,26,49,-23,25
Glentoran,1481,7,6,6,10,24,32,-8,24
Dungannon,1481,8,2,4,16,14,47,-33,10
Crusaders,1482,1,17,6,3,64,31,33,57
Coleraine,1482,2,14,10,2,43,25,18,52
Glenavon,1482,3,10,9,7,55,43,12,39
Linfield,1482,4,11,5,10,39,36,3,38
Cliftonville,1482,5,9,4,13,32,33,-1,31
Ballymena,1482,6,7,4,15,26,50,-24,25
Glentoran,1482,7,6,6,10,24,32,-8,24
Dungannon,1482,8,2,4,16,14,47,-33,10
Crusaders,1483,1,16,7,3,61,30,31,55
Coleraine,1483,2,14,10,2,43,25,18,52
Glenavon,1483,3,10,9,7,55,43,12,39
Linfield,1483,4,10,6,10,38,37,1,36
Cliftonville,1483,5,9,5,12,33,32,1,32
Ballymena,1483,6,7,5,14,25,47,-22,26
Glentoran,1483,7,6,6,10,24,32,-8,24
Dungannon,1483,8,2,4,16,14,47,-33,10
Crusaders,1484,1,16,7,3,62,31,31,55
Coleraine,1484,2,15,10,1,46,24,22,55
Linfield,1484,3,11,5,10,39,37,2,38
Glenavon,1484,4,9,9,8,54,46,8,36
Cliftonville,1484,5,9,4,13,33,33,0,31
Ballymena,1484,6,7,5,14,26,48,-22,26
Glentoran,1484,7,6,6,10,24,32,-8,24
Dungannon,1484,8,2,4,16,14,47,-33,10
Crusaders,1485,1,16,6,4,62,34,28,54
Coleraine,1485,2,14,10,2,44,24,20,52
Glenavon,1485,3,10,9,7,54,44,10,39
Linfield,1485,4,11,5,10,38,36,2,38
Cliftonville,1485,5,9,4,13,32,32,0,31
Ballymena,1485,6,8,4,14,29,48,-19,28
Glentoran,1485,7,6,6,10,24,32,-8,24
Dungannon,1485,8,2,4,16,14,47,-33,10
Crusaders,1486,1,16,6,4,61,33,28,54
Coleraine,1486,2,14,10,2,43,25,18,52
Glenavon,1486,3,10,9,7,55,43,12,39
Linfield,1486,4,11,5,10,39,37,2,38
Cliftonville,1486,5,9,4,13,33,33,0,31
Ballymena,1486,6,8,4,14,28,47,-19,28
Glentoran,1486,7,6,6,10,24,32,-8,24
Dungannon,1486,8,2,4,16,14,47,-33,10
Crusaders,1487,1,17,6,3,63,31,32,57
Coleraine,1487,2,14,10,2,44,24,20,52
Glenavon,1487,3,10,9,7,54,44,10,39
Linfield,1487,4,10,5,11,38,38,0,35
Cliftonville,1487,5,10,4,12,34,32,2,34
Ballymena,1487,6,7,4,15,26,49,-23,25
Glentoran,1487,7,6,6,10,24,32,-8,24
Dungannon,1487,8,2,4,16,14,47,-33,10
Crusaders,1488,1,16,6,4,63,33,30,54
Coleraine,1488,2,14,10,2,44,26,18,52
Glenavon,1488,3,10,9,7,56,44,12,39
Linfield,1488,4,10,6,10,38,37,1,36
Cliftonville,1488,5,9,5,12,33,32,1,32
Ballymena,1488,6,8,4,14,28,49,-21,28
Glentoran,1488,7,6,6,10,24,32,-8,24
Dungannon,1488,8,2,4,16,14,47,-33,10
Crusaders,1489,1,17,6,3,66,31,35,57
Coleraine,1489,2,14,10,2,43,25,18,52
Glenavon,1489,3,10,9,7,55,43,12,39
Linfield,1489,4,11,5,10,38,36,2,38
Cliftonville,1489,5,9,4,13,32,32,0,31
Ballymena,1489,6,7,4,15,26,52,-26,25
Glentoran,1489,7,6,6,10,24,32,-8,24
Dungannon,1489,8,2,4,16,14,47,-33,10
Crusaders,1490,1,17,6,3,62,30,32,57
Coleraine,1490,2,14,10,2,43,25,18,52
Glenavon,1490,3,10,9,7,55,43,12,39
Linfield,1490,4,11,5,10,38,36,2,38
Cliftonville,1490,5,9,4,13,32,32,0,31
Ballymena,1490,6,7,4,15,25,48,-23,25
Glentoran,1490,7,6,6,10,24,32,-8,24
Dungannon,1490,8,2,4,16,14,47,-33,10
Coleraine,1491,1,15,10,1,45,22,23,55
Crusaders,1491,2,16,6,4,61,32,29,54
Glenavon,1491,3,9,9,8,52,45,7,36
Linfield,1491,4,10,5,11,38,38,0,35
Cliftonville,1491,5,10,4,12,34,32,2,34
Ballymena,1491,6,8,4,14,27,47,-20,28
Glentoran,1491,7,6,6,10,24,32,-8,24
Dungannon,1491,8,2,4,16,14,47,-33,10
Crusaders,1492,1,17,6,3,64,31,33,57
Coleraine,1492,2,15,10,1,44,22,22,55
Glenavon,1492,3,9,9,8,52,44,8,36
Linfield,1492,4,10,6,10,37,36,1,36
Cliftonville,1492,5,9,5,12,32,31,1,32
Ballymena,1492,6,7,4,15,26,50,-24,25
Glentoran,1492,7,6,6,10,24,32,-8,24
Dungannon,1492,8,2,4,16,14,47,-33,10
Crusaders,1493,1,17,6,3,63,31,32,57
Coleraine,1493,2,14,11,1,45,24,21,53
Linfield,1493,3,11,5,10,39,37,2,38
Glenavon,1493,4,9,10,7,54,45,9,37
Cliftonville,1493,5,9,4,13,33,33,0,31
Ballymena,1493,6,7,4,15,26,49,-23,25
Glentoran,1493,7,6,6,10,24,32,-8,24
Dungannon,1493,8,2,4,16,14,47,-33,10
Crusaders,1494,1,17,6,3,63,30,33,57
Coleraine,1494,2,14,10,2,45,27,18,52
Glenavon,1494,3,10,9,7,57,45,12,39
Linfield,1494,4,10,5,11,38,38,0,35
Cliftonville,1494,5,10,4,12,34,32,2,34
Ballymena,1494,6,7,4,15,25,49,-24,25
Glentoran,1494,7,6,6,10,24,32,-8,24
Dungannon,1494,8,2,4,16,14,47,-33,10
Crusaders,1495,1,17,6,3,64,30,34,57
Coleraine,1495,2,14,11,1,45,24,21,53
Linfield,1495,3,11,5,10,39,36,3,38
Glenavon,1495,4,9,10,7,54,45,9,37
Cliftonville,1495,5,9,4,13,32,33,-1,31
Ballymena,1495,6,7,4,15,25,50,-25,25
Glentoran,1495,7,6,6,10,24,32,-8,24
Dungannon,1495,8,2,4,16,14,47,-33,10
Crusaders,1496,1,17,6,3,63,30,33,57
Coleraine,1496,2,15,10,1,46,24,22,55
Linfield,1496,3,11,5,10,39,36,3,38
Glenavon,1496,4,9,9,8,54,46,8,36
Cliftonville,1496,5,9,4,13,32,33,-1,31
Ballymena,1496,6,7,4,15,25,49,-24,25
Glentoran,1496,7,6,6,10,24,32,-8,24
Dungannon,1496,8,2,4,16,14,47,-33,10
Crusaders,1497,1,17,6,3,66,32,34,57
Coleraine,1497,2,14,10,2,43,24,19,52
Glenavon,1497,3,10,9,7,54,43,11,39
Linfield,1497,4,11,5,10,38,36,2,38
Cliftonville,1497,5,9,4,13,32,32,0,31
Ballymena,1497,6,7,4,15,27,52,-25,25
Glentoran,1497,7,6,6,10,24,32,-8,24
Dungannon,1497,8,2,4,16,14,47,-33,10
Crusaders,1498,1,16,6,4,62,36,26,54
Coleraine,1498,2,14,10,2,43,29,14,52
Glenavon,1498,3,10,9,7,59,43,16,39
Linfield,1498,4,10,6,10,37,36,1,36
Cliftonville,1498,5,9,5,12,32,31,1,32
Ballymena,1498,6,8,4,14,31,48,-17,28
Glentoran,1498,7,6,6,10,24,32,-8,24
Dungannon,1498,8,2,4,16,14,47,-33,10
Crusaders,1499,1,17,6,3,64,31,33,57
Coleraine,1499,2,14,10,2,43,24,19,52
Glenavon,1499,3,10,9,7,54,43,11,39
Linfield,1499,4,10,5,11,37,38,-1,35
Cliftonville,1499,5,10,4,12,34,31,3,34
Ballymena,1499,6,7,4,15,26,50,-24,25
Glentoran,1499,7,6,6,10,24,32,-8,24
Dungannon,1499,8,2,4,16,14,47,-33,10
Crusaders,1500,1,17,6,3,63,31,32,57
Coleraine,1500,2,14,10,2,44,24,20,52
Glenavon,1500,3,10,9,7,54,44,10,39
Linfield,1500,4,11,5,10,38,36,2,38
Cliftonville,1500,5,9,4,13,32,32,0,31
Ballymena,1500,6,7,4,15,26,49,-23,25
Glentoran,1500,7,6,6,10,24,32,-8,24
Dungannon,1500,8,2,4,16,14,47,-33,10
Crusaders,1501,1,17,6,3,65,31,34,57
Coleraine,1501,2,14,11,1,44,23,21,53
Glenavon,1501,3,9,10,7,53,44,9,37
Linfield,1501,4,10,6,10,38,37,1,36
Cliftonville,1501,5,9,5,12,33,32,1,32
Ballymena,1501,6,7,4,15,26,51,-25,25
Glentoran,1501,7,6,6,10,24,32,-8,24
Dungannon,1501,8,2,4,16,14,47,-33,10
Crusaders,1502,1,17,6,3,63,30,33,57
Coleraine,1502,2,14,10,2,44,24,20,52
Glenavon,1502,3,10,9,7,54,44,10,39
Linfield,1502,4,11,5,10,40,38,2,38
Cliftonville,1502,5,9,4,13,34,34,0,31
Ballymena,1502,6,7,4,15,25,49,-24,25
Glentoran,1502,7,6,6,10,24,32,-8,24
Dungannon,1502,8,2,4,16,14,47,-33,10
Crusaders,1503,1,17,6,3,62,30,32,57
Coleraine,1503,2,14,10,2,44,25,19,52
Glenavon,1503,3,10,9,7,55,44,11,39
Linfield,1503,4,10,5,11,38,38,0,35
Cliftonville,1503,5,10,4,12,34,32,2,34
Ballymena,1503,6,7,4,15,25,48,-23,25
Glentoran,1503,7,6,6,10,24,32,-8,24
Dungannon,1503,8,2,4,16,14,47,-33,10
Crusaders,1504,1,16,6,4,61,32,29,54
Coleraine,1504,2,14,10,2,43,24,19,52
Glenavon,1504,3,10,9,7,54,43,11,39
Linfield,1504,4,11,5,10,39,37,2,38
Cliftonville,1504,5,9,4,13,33,33,0,31
Ballymena,1504,6,8,4,14,27,47,-20,28
Glentoran,1504,7,6,6,10,24,32,-8,24
Dungannon,1504,8,2,4,16,14,47,-33,10
Crusaders,1505,1,17,6,3,64,30,34,57
Coleraine,1505,2,15,10,1,49,25,24,55
Glenavon,1505,3,9,9,8,55,49,6,36
Linfield,1505,4,10,5,11,38,38,0,35
Cliftonville,1505,5,10,4,12,34,32,2,34
Ballymena,1505,6,7,4,15,25,50,-25,25
Glentoran,1505,7,6,6,10,24,32,-8,24
Dungannon,1505,8,2,4,16,14,47,-33,10
Crusaders,1506,1,17,6,3,65,32,33,57
Coleraine,1506,2,15,10,1,46,23,23,55
Glenavon,1506,3,9,9,8,53,46,7,36
Linfield,1506,4,10,5,11,37,37,0,35
Cliftonville,1506,5,10,4,12,33,31,2,34
Ballymena,1506,6,7,4,15,27,51,-24,25
Glentoran,1506,7,6,6,10,24,32,-8,24
Dungannon,1506,8,2,4,16,14,47,-33,10
Crusaders,1507,1,17,6,3,63,31,32,57
Coleraine,1507,2,14,10,2,43,25,18,52
Glenavon,1507,3,10,9,7,55,43,12,39
Linfield,1507,4,11,5,10,40,36,4,38
Cliftonville,1507,5,9,4,13,32,34,-2,31
Ballymena,1507,6,7,4,15,26,49,-23,25
Glentoran,1507,7,6,6,10,24,32,-8,24
Dungannon,1507,8,2,4,16,14,47,-33,10
Crusaders,1508,1,16,6,4,63,33,30,54
Coleraine,1508,2,14,10,2,43,23,20,52
Glenavon,1508,3,10,9,7,53,43,10,39
Linfield,1508,4,11,5,10,38,36,2,38
Cliftonville,1508,5,9,4,13,32,32,0,31
Ballymena,1508,6,8,4,14,28,49,-21,28
Glentoran,1508,7,6,6,10,24,32,-8,24
Dungannon,1508,8,2,4,16,14,47,-33,10
Crusaders,1509,1,16,7,3,62,31,31,55
Coleraine,1509,2,14,10,2,44,25,19,52
Glenavon,1509,3,10,9,7,55,44,11,39
Linfield,1509,4,11,5,10,39,36,3,38
Cliftonville,1509,5,9,4,13,32,33,-1,31
Ballymena,1509,6,7,5,14,26,48,-22,26
Glentoran,1509,7,6,6,10,24,32,-8,24
Dungannon,1509,8,2,4,16,14,47,-33,10
Crusaders,1510,1,16,7,3,63,32,31,55
Coleraine,1510,2,14,10,2,44,24,20,52
Glenavon,1510,3,10,9,7,54,44,10,39
Linfield,1510,4,11,5,10,40,37,3,38
Cliftonville,1510,5,9,4,13,33,34,-1,31
Ballymena,1510,6,7,5,14,27,49,-22,26
Glentoran,1510,7,6,6,10,24,32,-8,24
Dungannon,1510,8,2,4,16,14,47,-33,10
Crusaders,1511,1,17,6,3,63,31,32,57
Coleraine,1511,2,15,10,1,47,25,22,55
Glenavon,1511,3,9,9,8,55,47,8,36
Linfield,1511,4,10,5,11,38,38,0,35
Cliftonville,1511,5,10,4,12,34,32,2,34
Ballymena,1511,6,7,4,15,26,49,-23,25
Glentoran,1511,7,6,6,10,24,32,-8,24
Dungannon,1511,8,2,4,16,14,47,-33,10
Coleraine,1512,1,15,10,1,44,22,22,55
Crusaders,1512,2,16,6,4,61,32,29,54
Glenavon,1512,3,9,9,8,52,44,8,36
Linfield,1512,4,10,6,10,38,37,1,36
Cliftonville,1512,5,9,5,12,33,32,1,32
Ballymena,1512,6,8,4,14,27,47,-20,28
Glentoran,1512,7,6,6,10,24,32,-8,24
Dungannon,1512,8,2,4,16,14,47,-33,10
Coleraine,1513,1,15,10,1,45,22,23,55
Crusaders,1513,2,16,6,4,61,31,30,54
Glenavon,1513,3,9,9,8,52,45,7,36
Linfield,1513,4,10,5,11,38,38,0,35
Cliftonville,1513,5,10,4,12,34,32,2,34
Ballymena,1513,6,8,4,14,26,47,-21,28
Glentoran,1513,7,6,6,10,24,32,-8,24
Dungannon,1513,8,2,4,16,14,47,-33,10
Crusaders,1514,1,16,6,4,63,33,30,54
Coleraine,1514,2,14,10,2,45,27,18,52
Glenavon,1514,3,10,9,7,57,45,12,39
Linfield,1514,4,10,6,10,37,36,1,36
Cliftonville,1514,5,9,5,12,32,31,1,32
Ballymena,1514,6,8,4,14,28,49,-21,28
Glentoran,1514,7,6,6,10,24,32,-8,24
Dungannon,1514,8,2,4,16,14,47,-33,10
Crusaders,1515,1,16,7,3,63,32,31,55
Coleraine,1515,2,14,10,2,44,25,19,52
Glenavon,1515,3,10,9,7,55,44,11,39
Linfield,1515,4,11,5,10,39,36,3,38
Cliftonville,1515,5,9,4,13,32,33,-1,31
Ballymena,1515,6,7,5,14,27,49,-22,26
Glentoran,1515,7,6,6,10,24,32,-8,24
Dungannon,1515,8,2,4,16,14,47,-33,10
Crusaders,1516,1,17,6,3,65,32,33,57
Coleraine,1516,2,14,11,1,45,24,21,53
Glenavon,1516,3,9,10,7,54,45,9,37
Linfield,1516,4,10,6,10,40,39,1,36
Cliftonville,1516,5,9,5,12,35,34,1,32
Ballymena,1516,6,7,4,15,27,51,-24,25
Glentoran,1516,7,6,6,10,24,32,-8,24
Dungannon,1516,8,2,4,16,14,47,-33,10
Crusaders,1517,1,16,7,3,63,32,31,55
Coleraine,1517,2,14,11,1,44,23,21,53
Glenavon,1517,3,9,10,7,53,44,9,37
Linfield,1517,4,10,6,10,37,36,1,36
Cliftonville,1517,5,9,5,12,32,31,1,32
Ballymena,1517,6,7,5,14,27,49,-22,26
Glentoran,1517,7,6,6,10,24,32,-8,24
Dungannon,1517,8,2,4,16,14,47,-33,10
Crusaders,1518,1,17,6,3,62,30,32,57
Coleraine,1518,2,14,10,2,46,26,20,52
Glenavon,1518,3,10,9,7,56,46,10,39
Linfield,1518,4,10,6,10,38,37,1,36
Cliftonville,1518,5,9,5,12,33,32,1,32
Ballymena,1518,6,7,4,15,25,48,-23,25
Glentoran,1518,7,6,6,10,24,32,-8,24
Dungannon,1518,8,2,4,16,14,47,-33,10
Crusaders,1519,1,17,6,3,63,31,32,57
Coleraine,1519,2,15,10,1,45,23,22,55
Linfield,1519,3,11,5,10,39,37,2,38
Glenavon,1519,4,9,9,8,53,45,8,36
Cliftonville,1519,5,9,4,13,33,33,0,31
Ballymena,1519,6,7,4,15,26,49,-23,25
Glentoran,1519,7,6,6,10,24,32,-8,24
Dungannon,1519,8,2,4,16,14,47,-33,10
Coleraine,1520,1,15,10,1,48,23,25,55
Crusaders,1520,2,16,6,4,61,33,28,54
Glenavon,1520,3,9,9,8,53,48,5,36
Linfield,1520,4,10,5,11,37,37,0,35
Cliftonville,1520,5,10,4,12,33,31,2,34
Ballymena,1520,6,8,4,14,28,47,-19,28
Glentoran,1520,7,6,6,10,24,32,-8,24
Dungannon,1520,8,2,4,16,14,47,-33,10
Crusaders,1521,1,17,6,3,64,31,33,57
Coleraine,1521,2,14,11,1,45,24,21,53
Glenavon,1521,3,9,10,7,54,45,9,37
Linfield,1521,4,10,5,11,39,40,-1,35
Cliftonville,1521,5,10,4,12,36,33,3,34
Ballymena,1521,6,7,4,15,26,50,-24,25
Glentoran,1521,7,6,6,10,24,32,-8,24
Dungannon,1521,8,2,4,16,14,47,-33,10
Crusaders,1522,1,16,7,3,61,30,31,55
Coleraine,1522,2,14,11,1,44,23,21,53
Linfield,1522,3,11,5,10,40,36,4,38
Glenavon,1522,4,9,10,7,53,44,9,37
Cliftonville,1522,5,9,4,13,32,34,-2,31
Ballymena,1522,6,7,5,14,25,47,-22,26
Glentoran,1522,7,6,6,10,24,32,-8,24
Dungannon,1522,8,2,4,16,14,47,-33,10
Crusaders,1523,1,17,6,3,65,31,34,57
Coleraine,1523,2,14,10,2,45,25,20,52
Glenavon,1523,3,10,9,7,55,45,10,39
Linfield,1523,4,11,5,10,39,36,3,38
Cliftonville,1523,5,9,4,13,32,33,-1,31
Ballymena,1523,6,7,4,15,26,51,-25,25
Glentoran,1523,7,6,6,10,24,32,-8,24
Dungannon,1523,8,2,4,16,14,47,-33,10
Crusaders,1524,1,16,7,3,62,31,31,55
Coleraine,1524,2,14,11,1,43,22,21,53
Glenavon,1524,3,9,10,7,52,43,9,37
Linfield,1524,4,10,6,10,37,36,1,36
Cliftonville,1524,5,9,5,12,32,31,1,32
Ballymena,1524,6,7,5,14,26,48,-22,26
Glentoran,1524,7,6,6,10,24,32,-8,24
Dungannon,1524,8,2,4,16,14,47,-33,10
Crusaders,1525,1,16,6,4,62,32,30,54
Coleraine,1525,2,14,10,2,43,23,20,52
Glenavon,1525,3,10,9,7,53,43,10,39
Linfield,1525,4,10,6,10,39,38,1,36
Cliftonville,1525,5,9,5,12,34,33,1,32
Ballymena,1525,6,8,4,14,27,48,-21,28
Glentoran,1525,7,6,6,10,24,32,-8,24
Dungannon,1525,8,2,4,16,14,47,-33,10
Crusaders,1526,1,17,6,3,64,31,33,57
Coleraine,1526,2,14,10,2,44,24,20,52
Glenavon,1526,3,10,9,7,54,44,10,39
Linfield,1526,4,10,5,11,38,38,0,35
Cliftonville,1526,5,10,4,12,34,32,2,34
Ballymena,1526,6,7,4,15,26,50,-24,25
Glentoran,1526,7,6,6,10,24,32,-8,24
Dungannon,1526,8,2,4,16,14,47,-33,10
Crusaders,1527,1,17,6,3,67,31,36,57
Coleraine,1527,2,14,11,1,45,24,21,53
Linfield,1527,3,11,5,10,40,38,2,38
Glenavon,1527,4,9,10,7,54,45,9,37
Cliftonville,1527,5,9,4,13,34,34,0,31
Ballymena,1527,6,7,4,15,26,53,-27,25
Glentoran,1527,7,6,6,10,24,32,-8,24
Dungannon,1527,8,2,4,16,14,47,-33,10
Crusaders,1528,1,17,6,3,66,32,34,57
Coleraine,1528,2,14,10,2,43,23,20,52
Glenavon,1528,3,10,9,7,53,43,10,39
Linfield,1528,4,11,5,10,42,37,5,38
Cliftonville,1528,5,9,4,13,33,36,-3,31
Ballymena,1528,6,7,4,15,27,52,-25,25
Glentoran,1528,7,6,6,10,24,32,-8,24
Dungannon,1528,8,2,4,16,14,47,-33,10
Crusaders,1529,1,16,6,4,62,32,30,54
Coleraine,1529,2,14,10,2,44,24,20,52
Glenavon,1529,3,10,9,7,54,44,10,39
Linfield,1529,4,11,5,10,39,36,3,38
Cliftonville,1529,5,9,4,13,32,33,-1,31
Ballymena,1529,6,8,4,14,27,48,-21,28
Glentoran,1529,7,6,6,10,24,32,-8,24
Dungannon,1529,8,2,4,16,14,47,-33,10
Crusaders,1530,1,17,6,3,62,30,32,57
Coleraine,1530,2,14,10,2,43,25,18,52
Glenavon,1530,3,10,9,7,55,43,12,39
Linfield,1530,4,11,5,10,39,37,2,38
Cliftonville,1530,5,9,4,13,33,33,0,31
Ballymena,1530,6,7,4,15,25,48,-23,25
Glentoran,1530,7,6,6,10,24,32,-8,24
Dungannon,1530,8,2,4,16,14,47,-33,10
Crusaders,1531,1,16,6,4,62,32,30,54
Coleraine,1531,2,14,10,2,43,23,20,52
Glenavon,1531,3,10,9,7,53,43,10,39
Linfield,1531,4,11,5,10,38,36,2,38
Cliftonville,1531,5,9,4,13,32,32,0,31
Ballymena,1531,6,8,4,14,27,48,-21,28
Glentoran,1531,7,6,6,10,24,32,-8,24
Dungannon,1531,8,2,4,16,14,47,-33,10
Crusaders,1532,1,17,6,3,64,32,32,57
Coleraine,1532,2,14,10,2,44,26,18,52
Glenavon,1532,3,10,9,7,56,44,12,39
Linfield,1532,4,10,5,11,37,37,0,35
Cliftonville,1532,5,10,4,12,33,31,2,34
Ballymena,1532,6,7,4,15,27,50,-23,25
Glentoran,1532,7,6,6,10,24,32,-8,24
Dungannon,1532,8,2,4,16,14,47,-33,10
Crusaders,1533,1,16,7,3,62,31,31,55
Coleraine,1533,2,14,11,1,44,23,21,53
Glenavon,1533,3,9,10,7,53,44,9,37
Linfield,1533,4,10,6,10,37,36,1,36
Cliftonville,1533,5,9,5,12,32,31,1,32
Ballymena,1533,6,7,5,14,26,48,-22,26
Glentoran,1533,7,6,6,10,24,32,-8,24
Dungannon,1533,8,2,4,16,14,47,-33,10
Crusaders,1534,1,17,6,3,62,30,32,57
Coleraine,1534,2,14,11,1,44,23,21,53
Glenavon,1534,3,9,10,7,53,44,9,37
Linfield,1534,4,10,6,10,37,36,1,36
Cliftonville,1534,5,9,5,12,32,31,1,32
Ballymena,1534,6,7,4,15,25,48,-23,25
Glentoran,1534,7,6,6,10,24,32,-8,24
Dungannon,1534,8,2,4,16,14,47,-33,10
Crusaders,1535,1,17,6,3,63,31,32,57
Coleraine,1535,2,15,10,1,47,23,24,55
Glenavon,1535,3,9,9,8,53,47,6,36
Linfield,1535,4,10,6,10,39,38,1,36
Cliftonville,1535,5,9,5,12,34,33,1,32
Ballymena,1535,6,7,4,15,26,49,-23,25
Glentoran,1535,7,6,6,10,24,32,-8,24
Dungannon,1535,8,2,4,16,14,47,-33,10
Crusaders,1536,1,16,6,4,62,33,29,54
Coleraine,1536,2,14,10,2,45,25,20,52
Glenavon,1536,3,10,9,7,55,45,10,39
Linfield,1536,4,10,6,10,38,37,1,36
Cliftonville,1536,5,9,5,12,33,32,1,32
Ballymena,1536,6,8,4,14,28,48,-20,28
Glentoran,1536,7,6,6,10,24,32,-8,24
Dungannon,1536,8,2,4,16,14,47,-33,10
Crusaders,1537,1,16,6,4,62,33,29,54
Coleraine,1537,2,14,10,2,44,24,20,52
Glenavon,1537,3,10,9,7,54,44,10,39
Linfield,1537,4,10,5,11,39,39,0,35
Cliftonville,1537,5,10,4,12,35,33,2,34
Ballymena,1537,6,8,4,14,28,48,-20,28
Glentoran,1537,7,6,6,10,24,32,-8,24
Dungannon,1537,8,2,4,16,14,47,-33,10
Crusaders,1538,1,16,6,4,62,32,30,54
Coleraine,1538,2,14,11,1,44,23,21,53
Linfield,1538,3,11,5,10,40,37,3,38
Glenavon,1538,4,9,10,7,53,44,9,37
Cliftonville,1538,5,9,4,13,33,34,-1,31
Ballymena,1538,6,8,4,14,27,48,-21,28
Glentoran,1538,7,6,6,10,24,32,-8,24
Dungannon,1538,8,2,4,16,14,47,-33,10
Crusaders,1539,1,16,7,3,61,30,31,55
Coleraine,1539,2,15,10,1,44,22,22,55
Linfield,1539,3,11,5,10,40,37,3,38
Glenavon,1539,4,9,9,8,52,44,8,36
Cliftonville,1539,5,9,4,13,33,34,-1,31
Ballymena,1539,6,7,5,14,25,47,-22,26
Glentoran,1539,7,6,6,10,24,32,-8,24
Dungannon,1539,8,2,4,16,14,47,-33,10
Crusaders,1540,1,16,7,3,63,32,31,55
Coleraine,1540,2,14,11,1,44,23,21,53
Linfield,1540,3,11,5,10,39,36,3,38
Glenavon,1540,4,9,10,7,53,44,9,37
Cliftonville,1540,5,9,4,13,32,33,-1,31
Ballymena,1540,6,7,5,14,27,49,-22,26
Glentoran,1540,7,6,6,10,24,32,-8,24
Dungannon,1540,8,2,4,16,14,47,-33,10
Crusaders,1541,1,16,6,4,63,34,29,54
Coleraine,1541,2,14,11,1,43,22,21,53
Linfield,1541,3,11,5,10,38,36,2,38
Glenavon,1541,4,9,10,7,52,43,9,37
Cliftonville,1541,5,9,4,13,32,32,0,31
Ballymena,1541,6,8,4,14,29,49,-20,28
Glentoran,1541,7,6,6,10,24,32,-8,24
Dungannon,1541,8,2,4,16,14,47,-33,10
Crusaders,1542,1,17,6,3,63,30,33,57
Coleraine,1542,2,15,10,1,45,23,22,55
Linfield,1542,3,11,5,10,39,36,3,38
Glenavon,1542,4,9,9,8,53,45,8,36
Cliftonville,1542,5,9,4,13,32,33,-1,31
Ballymena,1542,6,7,4,15,25,49,-24,25
Glentoran,1542,7,6,6,10,24,32,-8,24
Dungannon,1542,8,2,4,16,14,47,-33,10
Crusaders,1543,1,16,7,3,63,32,31,55
Coleraine,1543,2,15,10,1,44,22,22,55
Linfield,1543,3,11,5,10,39,36,3,38
Glenavon,1543,4,9,9,8,52,44,8,36
Cliftonville,1543,5,9,4,13,32,33,-1,31
Ballymena,1543,6,7,5,14,27,49,-22,26
Glentoran,1543,7,6,6,10,24,32,-8,24
Dungannon,1543,8,2,4,16,14,47,-33,10
Coleraine,1544,1,15,10,1,46,24,22,55
Crusaders,1544,2,16,6,4,61,31,30,54
Linfield,1544,3,11,5,10,40,37,3,38
Glenavon,1544,4,9,9,8,54,46,8,36
Cliftonville,1544,5,9,4,13,33,34,-1,31
Ballymena,1544,6,8,4,14,26,47,-21,28
Glentoran,1544,7,6,6,10,24,32,-8,24
Dungannon,1544,8,2,4,16,14,47,-33,10
Crusaders,1545,1,16,7,3,64,33,31,55
Coleraine,1545,2,14,11,1,44,23,21,53
Linfield,1545,3,11,5,10,41,37,4,38
Glenavon,1545,4,9,10,7,53,44,9,37
Cliftonville,1545,5,9,4,13,33,35,-2,31
Ballymena,1545,6,7,5,14,28,50,-22,26
Glentoran,1545,7,6,6,10,24,32,-8,24
Dungannon,1545,8,2,4,16,14,47,-33,10
Crusaders,1546,1,16,6,4,61,31,30,54
Coleraine,1546,2,14,10,2,44,26,18,52
Glenavon,1546,3,10,9,7,56,44,12,39
Linfield,1546,4,10,5,11,37,38,-1,35
Cliftonville,1546,5,10,4,12,34,31,3,34
Ballymena,1546,6,8,4,14,26,47,-21,28
Glentoran,1546,7,6,6,10,24,32,-8,24
Dungannon,1546,8,2,4,16,14,47,-33,10
Crusaders,1547,1,16,7,3,64,33,31,55
Coleraine,1547,2,14,10,2,43,24,19,52
Glenavon,1547,3,10,9,7,54,43,11,39
Linfield,1547,4,10,6,10,38,37,1,36
Cliftonville,1547,5,9,5,12,33,32,1,32
Ballymena,1547,6,7,5,14,28,50,-22,26
Glentoran,1547,7,6,6,10,24,32,-8,24
Dungannon,1547,8,2,4,16,14,47,-33,10
Crusaders,1548,1,17,6,3,63,30,33,57
Coleraine,1548,2,14,11,1,44,23,21,53
Glenavon,1548,3,9,10,7,53,44,9,37
Linfield,1548,4,10,6,10,38,37,1,36
Cliftonville,1548,5,9,5,12,33,32,1,32
Ballymena,1548,6,7,4,15,25,49,-24,25
Glentoran,1548,7,6,6,10,24,32,-8,24
Dungannon,1548,8,2,4,16,14,47,-33,10
Crusaders,1549,1,16,7,3,62,31,31,55
Coleraine,1549,2,14,10,2,43,26,17,52
Glenavon,1549,3,10,9,7,56,43,13,39
Linfield,1549,4,11,5,10,39,37,2,38
Cliftonville,1549,5,9,4,13,33,33,0,31
Ballymena,1549,6,7,5,14,26,48,-22,26
Glentoran,1549,7,6,6,10,24,32,-8,24
Dungannon,1549,8,2,4,16,14,47,-33,10
Crusaders,1550,1,17,6,3,63,31,32,57
Coleraine,1550,2,14,10,2,43,25,18,52
Glenavon,1550,3,10,9,7,55,43,12,39
Linfield,1550,4,11,5,10,40,38,2,38
Cliftonville,1550,5,9,4,13,34,34,0,31
Ballymena,1550,6,7,4,15,26,49,-23,25
Glentoran,1550,7,6,6,10,24,32,-8,24
Dungannon,1550,8,2,4,16,14,47,-33,10
Crusaders,1551,1,17,6,3,64,30,34,57
Coleraine,1551,2,14,10,2,44,26,18,52
Glenavon,1551,3,10,9,7,56,44,12,39
Linfield,1551,4,10,6,10,38,37,1,36
Cliftonville,1551,5,9,5,12,33,32,1,32
Ballymena,1551,6,7,4,15,25,50,-25,25
Glentoran,1551,7,6,6,10,24,32,-8,24
Dungannon,1551,8,2,4,16,14,47,-33,10
Crusaders,1552,1,17,6,3,65,33,32,57
Coleraine,1552,2,14,10,2,45,26,19,52
Glenavon,1552,3,10,9,7,56,45,11,39
Linfield,1552,4,11,5,10,38,36,2,38
Cliftonville,1552,5,9,4,13,32,32,0,31
Ballymena,1552,6,7,4,15,28,51,-23,25
Glentoran,1552,7,6,6,10,24,32,-8,24
Dungannon,1552,8,2,4,16,14,47,-33,10
Coleraine,1553,1,15,10,1,45,23,22,55
Crusaders,1553,2,16,6,4,62,32,30,54
Glenavon,1553,3,9,9,8,53,45,8,36
Linfield,1553,4,10,6,10,37,36,1,36
Cliftonville,1553,5,9,5,12,32,31,1,32
Ballymena,1553,6,8,4,14,27,48,-21,28
Glentoran,1553,7,6,6,10,24,32,-8,24
Dungannon,1553,8,2,4,16,14,47,-33,10
Crusaders,1554,1,17,6,3,62,30,32,57
Coleraine,1554,2,15,10,1,45,23,22,55
Linfield,1554,3,11,5,10,39,36,3,38
Glenavon,1554,4,9,9,8,53,45,8,36
Cliftonville,1554,5,9,4,13,32,33,-1,31
Ballymena,1554,6,7,4,15,25,48,-23,25
Glentoran,1554,7,6,6,10,24,32,-8,24
Dungannon,1554,8,2,4,16,14,47,-33,10
Crusaders,1555,1,16,7,3,63,32,31,55
Coleraine,1555,2,14,10,2,43,23,20,52
Glenavon,1555,3,10,9,7,53,43,10,39
Linfield,1555,4,11,5,10,38,36,2,38
Cliftonville,1555,5,9,4,13,32,32,0,31
Ballymena,1555,6,7,5,14,27,49,-22,26
Glentoran,1555,7,6,6,10,24,32,-8,24
Dungannon,1555,8,2,4,16,14,47,-33,10
Crusaders,1556,1,16,7,3,63,32,31,55
Coleraine,1556,2,15,10,1,45,23,22,55
Linfield,1556,3,11,5,10,40,36,4,38
Glenavon,1556,4,9,9,8,53,45,8,36
Cliftonville,1556,5,9,4,13,32,34,-2,31
Ballymena,1556,6,7,5,14,27,49,-22,26
Glentoran,1556,7,6,6,10,24,32,-8,24
Dungannon,1556,8,2,4,16,14,47,-33,10
Crusaders,1557,1,16,6,4,62,32,30,54
Coleraine,1557,2,14,10,2,44,26,18,52
Glenavon,1557,3,10,9,7,56,44,12,39
Linfield,1557,4,11,5,10,38,36,2,38
Cliftonville,1557,5,9,4,13,32,32,0,31
Ballymena,1557,6,8,4,14,27,48,-21,28
Glentoran,1557,7,6,6,10,24,32,-8,24
Dungannon,1557,8,2,4,16,14,47,-33,10
Crusaders,1558,1,17,6,3,63,31,32,57
Coleraine,1558,2,14,11,1,43,22,21,53
Linfield,1558,3,11,5,10,40,38,2,38
Glenavon,1558,4,9,10,7,52,43,9,37
Cliftonville,1558,5,9,4,13,34,34,0,31
Ballymena,1558,6,7,4,15,26,49,-23,25
Glentoran,1558,7,6,6,10,24,32,-8,24
Dungannon,1558,8,2,4,16,14,47,-33,10
Crusaders,1559,1,17,6,3,64,31,33,57
Coleraine,1559,2,14,10,2,43,23,20,52
Glenavon,1559,3,10,9,7,53,43,10,39
Linfield,1559,4,10,6,10,39,38,1,36
Cliftonville,1559,5,9,5,12,34,33,1,32
Ballymena,1559,6,7,4,15,26,50,-24,25
Glentoran,1559,7,6,6,10,24,32,-8,24
Dungannon,1559,8,2,4,16,14,47,-33,10
Crusaders,1560,1,17,6,3,63,30,33,57
Coleraine,1560,2,14,11,1,44,23,21,53
Linfield,1560,3,11,5,10,38,36,2,38
Glenavon,1560,4,9,10,7,53,44,9,37
Cliftonville,1560,5,9,4,13,32,32,0,31
Ballymena,1560,6,7,4,15,25,49,-24,25
Glentoran,1560,7,6,6,10,24,32,-8,24
Dungannon,1560,8,2,4,16,14,47,-33,10
Crusaders,1561,1,17,6,3,63,31,32,57
Coleraine,1561,2,14,10,2,44,24,20,52
Glenavon,1561,3,10,9,7,54,44,10,39
Linfield,1561,4,11,5,10,39,37,2,38
Cliftonville,1561,5,9,4,13,33,33,0,31
Ballymena,1561,6,7,4,15,26,49,-23,25
Glentoran,1561,7,6,6,10,24,32,-8,24
Dungannon,1561,8,2,4,16,14,47,-33,10
Crusaders,1562,1,16,7,3,62,31,31,55
Coleraine,1562,2,15,10,1,45,22,23,55
Glenavon,1562,3,9,9,8,52,45,7,36
Linfield,1562,4,10,5,11,37,37,0,35
Cliftonville,1562,5,10,4,12,33,31,2,34
Ballymena,1562,6,7,5,14,26,48,-22,26
Glentoran,1562,7,6,6,10,24,32,-8,24
Dungannon,1562,8,2,4,16,14,47,-33,10
Crusaders,1563,1,16,7,3,61,30,31,55
Coleraine,1563,2,15,10,1,45,23,22,55
Glenavon,1563,3,9,9,8,53,45,8,36
Linfield,1563,4,10,6,10,38,37,1,36
Cliftonville,1563,5,9,5,12,33,32,1,32
Ballymena,1563,6,7,5,14,25,47,-22,26
Glentoran,1563,7,6,6,10,24,32,-8,24
Dungannon,1563,8,2,4,16,14,47,-33,10
Crusaders,1564,1,17,6,3,64,32,32,57
Coleraine,1564,2,14,10,2,45,26,19,52
Glenavon,1564,3,10,9,7,56,45,11,39
Linfield,1564,4,10,6,10,37,36,1,36
Cliftonville,1564,5,9,5,12,32,31,1,32
Ballymena,1564,6,7,4,15,27,50,-23,25
Glentoran,1564,7,6,6,10,24,32,-8,24
Dungannon,1564,8,2,4,16,14,47,-33,10
Crusaders,1565,1,17,6,3,63,31,32,57
Coleraine,1565,2,14,10,2,43,23,20,52
Glenavon,1565,3,10,9,7,53,43,10,39
Linfield,1565,4,10,6,10,37,36,1,36
Cliftonville,1565,5,9,5,12,32,31,1,32
Ballymena,1565,6,7,4,15,26,49,-23,25
Glentoran,1565,7,6,6,10,24,32,-8,24
Dungannon,1565,8,2,4,16,14,47,-33,10
Crusaders,1566,1,17,6,3,66,33,33,57
Coleraine,1566,2,14,11,1,43,22,21,53
Glenavon,1566,3,9,10,7,52,43,9,37
Linfield,1566,4,10,6,10,37,36,1,36
Cliftonville,1566,5,9,5,12,32,31,1,32
Ballymena,1566,6,7,4,15,28,52,-24,25
Glentoran,1566,7,6,6,10,24,32,-8,24
Dungannon,1566,8,2,4,16,14,47,-33,10
Crusaders,1567,1,17,6,3,63,31,32,57
Coleraine,1567,2,14,10,2,43,25,18,52
Glenavon,1567,3,10,9,7,55,43,12,39
Linfield,1567,4,11,5,10,39,37,2,38
Cliftonville,1567,5,9,4,13,33,33,0,31
Ballymena,1567,6,7,4,15,26,49,-23,25
Glentoran,1567,7,6,6,10,24,32,-8,24
Dungannon,1567,8,2,4,16,14,47,-33,10
Crusaders,1568,1,16,6,4,61,31,30,54
Coleraine,1568,2,14,10,2,43,25,18,52
Glenavon,1568,3,10,9,7,55,43,12,39
Linfield,1568,4,11,5,10,40,37,3,38
Cliftonville,1568,5,9,4,13,33,34,-1,31
Ballymena,1568,6,8,4,14,26,47,-21,28
Glentoran,1568,7,6,6,10,24,32,-8,24
Dungannon,1568,8,2,4,16,14,47,-33,10
Crusaders,1569,1,17,6,3,65,31,34,57
Coleraine,1569,2,14,10,2,45,26,19,52
Glenavon,1569,3,10,9,7,56,45,11,39
Linfield,1569,4,10,6,10,37,36,1,36
Cliftonville,1569,5,9,5,12,32,31,1,32
Ballymena,1569,6,7,4,15,26,51,-25,25
Glentoran,1569,7,6,6,10,24,32,-8,24
Dungannon,1569,8,2,4,16,14,47,-33,10
Crusaders,1570,1,16,6,4,61,31,30,54
Coleraine,1570,2,14,10,2,43,24,19,52
Glenavon,1570,3,10,9,7,54,43,11,39
Linfield,1570,4,11,5,10,41,37,4,38
Cliftonville,1570,5,9,4,13,33,35,-2,31
Ballymena,1570,6,8,4,14,26,47,-21,28
Glentoran,1570,7,6,6,10,24,32,-8,24
Dungannon,1570,8,2,4,16,14,47,-33,10
Crusaders,1571,1,17,6,3,64,31,33,57
Coleraine,1571,2,14,10,2,43,24,19,52
Glenavon,1571,3,10,9,7,54,43,11,39
Linfield,1571,4,10,5,11,37,38,-1,35
Cliftonville,1571,5,10,4,12,34,31,3,34
Ballymena,1571,6,7,4,15,26,50,-24,25
Glentoran,1571,7,6,6,10,24,32,-8,24
Dungannon,1571,8,2,4,16,14,47,-33,10
Crusaders,1572,1,17,6,3,65,33,32,57
Coleraine,1572,2,15,10,1,46,22,24,55
Linfield,1572,3,11,5,10,39,37,2,38
Glenavon,1572,4,9,9,8,52,46,6,36
Cliftonville,1572,5,9,4,13,33,33,0,31
Ballymena,1572,6,7,4,15,28,51,-23,25
Glentoran,1572,7,6,6,10,24,32,-8,24
Dungannon,1572,8,2,4,16,14,47,-33,10
Crusaders,1573,1,16,7,3,62,31,31,55
Coleraine,1573,2,14,11,1,47,26,21,53
Glenavon,1573,3,9,10,7,56,47,9,37
Linfield,1573,4,10,5,11,38,38,0,35
Cliftonville,1573,5,10,4,12,34,32,2,34
Ballymena,1573,6,7,5,14,26,48,-22,26
Glentoran,1573,7,6,6,10,24,32,-8,24
Dungannon,1573,8,2,4,16,14,47,-33,10
Crusaders,1574,1,16,7,3,63,32,31,55
Coleraine,1574,2,15,10,1,46,22,24,55
Linfield,1574,3,11,5,10,39,37,2,38
Glenavon,1574,4,9,9,8,52,46,6,36
Cliftonville,1574,5,9,4,13,33,33,0,31
Ballymena,1574,6,7,5,14,27,49,-22,26
Glentoran,1574,7,6,6,10,24,32,-8,24
Dungannon,1574,8,2,4,16,14,47,-33,10
Crusaders,1575,1,16,6,4,61,31,30,54
Coleraine,1575,2,14,10,2,43,23,20,52
Glenavon,1575,3,10,9,7,53,43,10,39
Linfield,1575,4,11,5,10,39,37,2,38
Cliftonville,1575,5,9,4,13,33,33,0,31
Ballymena,1575,6,8,4,14,26,47,-21,28
Glentoran,1575,7,6,6,10,24,32,-8,24
Dungannon,1575,8,2,4,16,14,47,-33,10
Crusaders,1576,1,17,6,3,63,31,32,57
Coleraine,1576,2,14,11,1,45,24,21,53
Glenavon,1576,3,9,10,7,54,45,9,37
Linfield,1576,4,10,5,11,37,37,0,35
Cliftonville,1576,5,10,4,12,33,31,2,34
Ballymena,1576,6,7,4,15,26,49,-23,25
Glentoran,1576,7,6,6,10,24,32,-8,24
Dungannon,1576,8,2,4,16,14,47,-33,10
Crusaders,1577,1,17,6,3,63,31,32,57
Coleraine,1577,2,15,10,1,46,24,22,55
Linfield,1577,3,11,5,10,38,36,2,38
Glenavon,1577,4,9,9,8,54,46,8,36
Cliftonville,1577,5,9,4,13,32,32,0,31
Ballymena,1577,6,7,4,15,26,49,-23,25
Glentoran,1577,7,6,6,10,24,32,-8,24
Dungannon,1577,8,2,4,16,14,47,-33,10
Crusaders,1578,1,17,6,3,62,30,32,57
Coleraine,1578,2,15,10,1,46,22,24,55
Glenavon,1578,3,9,9,8,52,46,6,36
Linfield,1578,4,10,6,10,39,38,1,36
Cliftonville,1578,5,9,5,12,34,33,1,32
Ballymena,1578,6,7,4,15,25,48,-23,25
Glentoran,1578,7,6,6,10,24,32,-8,24
Dungannon,1578,8,2,4,16,14,47,-33,10
Crusaders,1579,1,17,6,3,65,33,32,57
Coleraine,1579,2,14,10,2,45,28,17,52
Glenavon,1579,3,10,9,7,58,45,13,39
Linfield,1579,4,10,6,10,38,37,1,36
Cliftonville,1579,5,9,5,12,33,32,1,32
Ballymena,1579,6,7,4,15,28,51,-23,25
Glentoran,1579,7,6,6,10,24,32,-8,24
Dungannon,1579,8,2,4,16,14,47,-33,10
Crusaders,1580,1,16,7,3,62,31,31,55
Coleraine,1580,2,14,10,2,43,26,17,52
Glenavon,1580,3,10,9,7,56,43,13,39
Linfield,1580,4,10,6,10,38,37,1,36
Cliftonville,1580,5,9,5,12,33,32,1,32
Ballymena,1580,6,7,5,14,26,48,-22,26
Glentoran,1580,7,6,6,10,24,32,-8,24
Dungannon,1580,8,2,4,16,14,47,-33,10
Crusaders,1581,1,16,6,4,62,32,30,54
Coleraine,1581,2,14,10,2,45,25,20,52
Glenavon,1581,3,10,9,7,55,45,10,39
Linfield,1581,4,10,5,11,37,37,0,35
Cliftonville,1581,5,10,4,12,33,31,2,34
Ballymena,1581,6,8,4,14,27,48,-21,28
Glentoran,1581,7,6,6,10,24,32,-8,24
Dungannon,1581,8,2,4,16,14,47,-33,10
Crusaders,1582,1,16,7,3,62,31,31,55
Coleraine,1582,2,15,10,1,46,23,23,55
Linfield,1582,3,11,5,10,38,36,2,38
Glenavon,1582,4,9,9,8,53,46,7,36
Cliftonville,1582,5,9,4,13,32,32,0,31
Ballymena,1582,6,7,5,14,26,48,-22,26
Glentoran,1582,7,6,6,10,24,32,-8,24
Dungannon,1582,8,2,4,16,14,47,-33,10
Crusaders,1583,1,17,6,3,64,31,33,57
Coleraine,1583,2,14,10,2,44,25,19,52
Glenavon,1583,3,10,9,7,55,44,11,39
Linfield,1583,4,11,5,10,39,37,2,38
Cliftonville,1583,5,9,4,13,33,33,0,31
Ballymena,1583,6,7,4,15,26,50,-24,25
Glentoran,1583,7,6,6,10,24,32,-8,24
Dungannon,1583,8,2,4,16,14,47,-33,10
Crusaders,1584,1,16,6,4,61,31,30,54
Coleraine,1584,2,14,11,1,44,23,21,53
Glenavon,1584,3,9,10,7,53,44,9,37
Linfield,1584,4,10,5,11,37,37,0,35
Cliftonville,1584,5,10,4,12,33,31,2,34
Ballymena,1584,6,8,4,14,26,47,-21,28
Glentoran,1584,7,6,6,10,24,32,-8,24
Dungannon,1584,8,2,4,16,14,47,-33,10
Crusaders,1585,1,16,6,4,62,33,29,54
Coleraine,1585,2,14,11,1,46,25,21,53
Glenavon,1585,3,9,10,7,55,46,9,37
Linfield,1585,4,10,5,11,39,41,-2,35
Cliftonville,1585,5,10,4,12,37,33,4,34
Ballymena,1585,6,8,4,14,28,48,-20,28
Glentoran,1585,7,6,6,10,24,32,-8,24
Dungannon,1585,8,2,4,16,14,47,-33,10
Crusaders,1586,1,17,6,3,64,30,34,57
Coleraine,1586,2,14,10,2,44,25,19,52
Glenavon,1586,3,10,9,7,55,44,11,39
Linfield,1586,4,11,5,10,39,37,2,38
Cliftonville,1586,5,9,4,13,33,33,0,31
Ballymena,1586,6,7,4,15,25,50,-25,25
Glentoran,1586,7,6,6,10,24,32,-8,24
Dungannon,1586,8,2,4,16,14,47,-33,10
Crusaders,1587,1,17,6,3,64,32,32,57
Coleraine,1587,2,14,10,2,45,25,20,52
Glenavon,1587,3,10,9,7,55,45,10,39
Linfield,1587,4,11,5,10,39,37,2,38
Cliftonville,1587,5,9,4,13,33,33,0,31
Ballymena,1587,6,7,4,15,27,50,-23,25
Glentoran,1587,7,6,6,10,24,32,-8,24
Dungannon,1587,8,2,4,16,14,47,-33,10
Crusaders,1588,1,16,7,3,63,32,31,55
Coleraine,1588,2,14,10,2,44,25,19,52
Glenavon,1588,3,10,9,7,55,44,11,39
Linfield,1588,4,10,6,10,37,36,1,36
Cliftonville,1588,5,9,5,12,32,31,1,32
Ballymena,1588,6,7,5,14,27,49,-22,26
Glentoran,1588,7,6,6,10,24,32,-8,24
Dungannon,1588,8,2,4,16,14,47,-33,10
Crusaders,1589,1,17,6,3,64,32,32,57
Coleraine,1589,2,14,10,2,44,24,20,52
Glenavon,1589,3,10,9,7,54,44,10,39
Linfield,1589,4,11,5,10,39,37,2,38
Cliftonville,1589,5,9,4,13,33,33,0,31
Ballymena,1589,6,7,4,15,27,50,-23,25
Glentoran,1589,7,6,6,10,24,32,-8,24
Dungannon,1589,8,2,4,16,14,47,-33,10
Crusaders,1590,1,16,6,4,62,32,30,54
Coleraine,1590,2,14,11,1,46,25,21,53
Linfield,1590,3,11,5,10,40,36,4,38
Glenavon,1590,4,9,10,7,55,46,9,37
Cliftonville,1590,5,9,4,13,32,34,-2,31
Ballymena,1590,6,8,4,14,27,48,-21,28
Glentoran,1590,7,6,6,10,24,32,-8,24
Dungannon,1590,8,2,4,16,14,47,-33,10
Crusaders,1591,1,17,6,3,62,30,32,57
Coleraine,1591,2,14,10,2,44,25,19,52
Glenavon,1591,3,10,9,7,55,44,11,39
Linfield,1591,4,11,5,10,40,36,4,38
Cliftonville,1591,5,9,4,13,32,34,-2,31
Ballymena,1591,6,7,4,15,25,48,-23,25
Glentoran,1591,7,6,6,10,24,32,-8,24
Dungannon,1591,8,2,4,16,14,47,-33,10
Crusaders,1592,1,17,6,3,65,31,34,57
Coleraine,1592,2,14,10,2,43,25,18,52
Glenavon,1592,3,10,9,7,55,43,12,39
Linfield,1592,4,10,5,11,37,37,0,35
Cliftonville,1592,5,10,4,12,33,31,2,34
Ballymena,1592,6,7,4,15,26,51,-25,25
Glentoran,1592,7,6,6,10,24,32,-8,24
Dungannon,1592,8,2,4,16,14,47,-33,10
Coleraine,1593,1,15,10,1,46,24,22,55
Crusaders,1593,2,16,6,4,62,32,30,54
Linfield,1593,3,11,5,10,40,37,3,38
Glenavon,1593,4,9,9,8,54,46,8,36
Cliftonville,1593,5,9,4,13,33,34,-1,31
Ballymena,1593,6,8,4,14,27,48,-21,28
Glentoran,1593,7,6,6,10,24,32,-8,24
Dungannon,1593,8,2,4,16,14,47,-33,10
Crusaders,1594,1,16,7,3,62,31,31,55
Coleraine,1594,2,15,10,1,46,22,24,55
Linfield,1594,3,11,5,10,40,36,4,38
Glenavon,1594,4,9,9,8,52,46,6,36
Cliftonville,1594,5,9,4,13,32,34,-2,31
Ballymena,1594,6,7,5,14,26,48,-22,26
Glentoran,1594,7,6,6,10,24,32,-8,24
Dungannon,1594,8,2,4,16,14,47,-33,10
Crusaders,1595,1,17,6,3,63,31,32,57
Coleraine,1595,2,14,11,1,45,24,21,53
Linfield,1595,3,11,5,10,40,36,4,38
Glenavon,1595,4,9,10,7,54,45,9,37
Cliftonville,1595,5,9,4,13,32,34,-2,31
Ballymena,1595,6,7,4,15,26,49,-23,25
Glentoran,1595,7,6,6,10,24,32,-8,24
Dungannon,1595,8,2,4,16,14,47,-33,10
Crusaders,1596,1,16,6,4,63,33,30,54
Coleraine,1596,2,14,10,2,44,25,19,52
Glenavon,1596,3,10,9,7,55,44,11,39
Linfield,1596,4,11,5,10,40,38,2,38
Cliftonville,1596,5,9,4,13,34,34,0,31
Ballymena,1596,6,8,4,14,28,49,-21,28
Glentoran,1596,7,6,6,10,24,32,-8,24
Dungannon,1596,8,2,4,16,14,47,-33,10
Crusaders,1597,1,17,6,3,62,30,32,57
Coleraine,1597,2,14,10,2,43,24,19,52
Glenavon,1597,3,10,9,7,54,43,11,39
Linfield,1597,4,11,5,10,42,38,4,38
Cliftonville,1597,5,9,4,13,34,36,-2,31
Ballymena,1597,6,7,4,15,25,48,-23,25
Glentoran,1597,7,6,6,10,24,32,-8,24
Dungannon,1597,8,2,4,16,14,47,-33,10
Crusaders,1598,1,17,6,3,62,30,32,57
Coleraine,1598,2,14,10,2,44,25,19,52
Glenavon,1598,3,10,9,7,55,44,11,39
Linfield,1598,4,10,5,11,37,38,-1,35
Cliftonville,1598,5,10,4,12,34,31,3,34
Ballymena,1598,6,7,4,15,25,48,-23,25
Glentoran,1598,7,6,6,10,24,32,-8,24
Dungannon,1598,8,2,4,16,14,47,-33,10
Crusaders,1599,1,16,7,3,61,30,31,55
Coleraine,1599,2,15,10,1,46,24,22,55
Glenavon,1599,3,9,9,8,54,46,8,36
Linfield,1599,4,10,5,11,38,38,0,35
Cliftonville,1599,5,10,4,12,34,32,2,34
Ballymena,1599,6,7,5,14,25,47,-22,26
Glentoran,1599,7,6,6,10,24,32,-8,24
Dungannon,1599,8,2,4,16,14,47,-33,10
Crusaders,1600,1,17,6,3,64,30,34,57
Coleraine,1600,2,14,11,1,44,23,21,53
Glenavon,1600,3,9,10,7,53,44,9,37
Linfield,1600,4,10,6,10,38,37,1,36
Cliftonville,1600,5,9,5,12,33,32,1,32
Ballymena,1600,6,7,4,15,25,50,-25,25
Glentoran,1600,7,6,6,10,24,32,-8,24
Dungannon,1600,8,2,4,16,14,47,-33,10
Crusaders,1601,1,17,6,3,63,30,33,57
Coleraine,1601,2,15,10,1,44,22,22,55
Linfield,1601,3,11,5,10,38,36,2,38
Glenavon,1601,4,9,9,8,52,44,8,36
Cliftonville,1601,5,9,4,13,32,32,0,31
Ballymena,1601,6,7,4,15,25,49,-24,25
Glentoran,1601,7,6,6,10,24,32,-8,24
Dungannon,1601,8,2,4,16,14,47,-33,10
Crusaders,1602,1,16,7,3,64,33,31,55
Coleraine,1602,2,14,10,2,44,24,20,52
Glenavon,1602,3,10,9,7,54,44,10,39
Linfield,1602,4,10,6,10,38,37,1,36
Cliftonville,1602,5,9,5,12,33,32,1,32
Ballymena,1602,6,7,5,14,28,50,-22,26
Glentoran,1602,7,6,6,10,24,32,-8,24
Dungannon,1602,8,2,4,16,14,47,-33,10
Crusaders,1603,1,16,7,3,61,30,31,55
Coleraine,1603,2,14,10,2,44,25,19,52
Glenavon,1603,3,10,9,7,55,44,11,39
Linfield,1603,4,10,6,10,38,37,1,36
Cliftonville,1603,5,9,5,12,33,32,1,32
Ballymena,1603,6,7,5,14,25,47,-22,26
Glentoran,1603,7,6,6,10,24,32,-8,24
Dungannon,1603,8,2,4,16,14,47,-33,10
Crusaders,1604,1,16,7,3,61,30,31,55
Coleraine,1604,2,14,10,2,44,24,20,52
Glenavon,1604,3,10,9,7,54,44,10,39
Linfield,1604,4,10,5,11,38,38,0,35
Cliftonville,1604,5,10,4,12,34,32,2,34
Ballymena,1604,6,7,5,14,25,47,-22,26
Glentoran,1604,7,6,6,10,24,32,-8,24
Dungannon,1604,8,2,4,16,14,47,-33,10
Crusaders,1605,1,16,6,4,61,34,27,54
Coleraine,1605,2,14,10,2,43,24,19,52
Glenavon,1605,3,10,9,7,54,43,11,39
Linfield,1605,4,11,5,10,39,36,3,38
Cliftonville,1605,5,9,4,13,32,33,-1,31
Ballymena,1605,6,8,4,14,29,47,-18,28
Glentoran,1605,7,6,6,10,24,32,-8,24
Dungannon,1605,8,2,4,16,14,47,-33,10
Crusaders,1606,1,17,6,3,63,31,32,57
Coleraine,1606,2,14,10,2,43,23,20,52
Glenavon,1606,3,10,9,7,53,43,10,39
Linfield,1606,4,11,5,10,40,38,2,38
Cliftonville,1606,5,9,4,13,34,34,0,31
Ballymena,1606,6,7,4,15,26,49,-23,25
Glentoran,1606,7,6,6,10,24,32,-8,24
Dungannon,1606,8,2,4,16,14,47,-33,10
Coleraine,1607,1,15,10,1,45,22,23,55
Crusaders,1607,2,16,6,4,63,33,30,54
Glenavon,1607,3,9,9,8,52,45,7,36
Linfield,1607,4,10,5,11,37,38,-1,35
Cliftonville,1607,5,10,4,12,34,31,3,34
Ballymena,1607,6,8,4,14,28,49,-21,28
Glentoran,1607,7,6,6,10,24,32,-8,24
Dungannon,1607,8,2,4,16,14,47,-33,10
Crusaders,1608,1,16,6,4,61,31,30,54
Coleraine,1608,2,14,11,1,44,23,21,53
Linfield,1608,3,11,5,10,39,36,3,38
Glenavon,1608,4,9,10,7,53,44,9,37
Cliftonville,1608,5,9,4,13,32,33,-1,31
Ballymena,1608,6,8,4,14,26,47,-21,28
Glentoran,1608,7,6,6,10,24,32,-8,24
Dungannon,1608,8,2,4,16,14,47,-33,10
Crusaders,1609,1,17,6,3,63,30,33,57
Coleraine,1609,2,14,10,2,44,24,20,52
Glenavon,1609,3,10,9,7,54,44,10,39
Linfield,1609,4,11,5,10,41,36,5,38
Cliftonville,1609,5,9,4,13,32,35,-3,31
Ballymena,1609,6,7,4,15,25,49,-24,25
Glentoran,1609,7,6,6,10,24,32,-8,24
Dungannon,1609,8,2,4,16,14,47,-33,10
Crusaders,1610,1,17,6,3,63,31,32,57
Coleraine,1610,2,15,10,1,45,23,22,55
Glenavon,1610,3,9,9,8,53,45,8,36
Linfield,1610,4,10,5,11,37,39,-2,35
Cliftonville,1610,5,10,4,12,35,31,4,34
Ballymena,1610,6,7,4,15,26,49,-23,25
Glentoran,1610,7,6,6,10,24,32,-8,24
Dungannon,1610,8,2,4,16,14,47,-33,10
Crusaders,1611,1,17,6,3,64,31,33,57
Coleraine,1611,2,14,10,2,45,26,19,52
Glenavon,1611,3,10,9,7,56,45,11,39
Linfield,1611,4,10,6,10,38,37,1,36
Cliftonville,1611,5,9,5,12,33,32,1,32
Ballymena,1611,6,7,4,15,26,50,-24,25
Glentoran,1611,7,6,6,10,24,32,-8,24
Dungannon,1611,8,2,4,16,14,47,-33,10
Crusaders,1612,1,16,7,3,64,33,31,55
Coleraine,1612,2,14,11,1,46,25,21,53
Linfield,1612,3,11,5,10,40,36,4,38
Glenavon,1612,4,9,10,7,55,46,9,37
Cliftonville,1612,5,9,4,13,32,34,-2,31
Ballymena,1612,6,7,5,14,28,50,-22,26
Glentoran,1612,7,6,6,10,24,32,-8,24
Dungannon,1612,8,2,4,16,14,47,-33,10
Crusaders,1613,1,16,6,4,61,31,30,54
Coleraine,1613,2,14,10,2,43,23,20,52
Glenavon,1613,3,10,9,7,53,43,10,39
Linfield,1613,4,11,5,10,40,37,3,38
Cliftonville,1613,5,9,4,13,33,34,-1,31
Ballymena,1613,6,8,4,14,26,47,-21,28
Glentoran,1613,7,6,6,10,24,32,-8,24
Dungannon,1613,8,2,4,16,14,47,-33,10
Crusaders,1614,1,17,6,3,65,31,34,57
Coleraine,1614,2,14,10,2,45,25,20,52
Glenavon,1614,3,10,9,7,55,45,10,39
Linfield,1614,4,11,5,10,39,36,3,38
Cliftonville,1614,5,9,4,13,32,33,-1,31
Ballymena,1614,6,7,4,15,26,51,-25,25
Glentoran,1614,7,6,6,10,24,32,-8,24
Dungannon,1614,8,2,4,16,14,47,-33,10
Crusaders,1615,1,16,6,4,63,34,29,54
Coleraine,1615,2,14,10,2,43,23,20,52
Glenavon,1615,3,10,9,7,53,43,10,39
Linfield,1615,4,10,6,10,38,37,1,36
Cliftonville,1615,5,9,5,12,33,32,1,32
Ballymena,1615,6,8,4,14,29,49,-20,28
Glentoran,1615,7,6,6,10,24,32,-8,24
Dungannon,1615,8,2,4,16,14,47,-33,10
Crusaders,1616,1,17,6,3,64,30,34,57
Coleraine,1616,2,14,10,2,43,25,18,52
Glenavon,1616,3,10,9,7,55,43,12,39
Linfield,1616,4,11,5,10,38,36,2,38
Cliftonville,1616,5,9,4,13,32,32,0,31
Ballymena,1616,6,7,4,15,25,50,-25,25
Glentoran,1616,7,6,6,10,24,32,-8,24
Dungannon,1616,8,2,4,16,14,47,-33,10
Crusaders,1617,1,16,6,4,61,31,30,54
Coleraine,1617,2,14,10,2,43,24,19,52
Glenavon,1617,3,10,9,7,54,43,11,39
Linfield,1617,4,10,6,10,37,36,1,36
Cliftonville,1617,5,9,5,12,32,31,1,32
Ballymena,1617,6,8,4,14,26,47,-21,28
Glentoran,1617,7,6,6,10,24,32,-8,24
Dungannon,1617,8,2,4,16,14,47,-33,10
Crusaders,1618,1,17,6,3,63,30,33,57
Coleraine,1618,2,14,11,1,46,25,21,53
Linfield,1618,3,11,5,10,39,37,2,38
Glenavon,1618,4,9,10,7,55,46,9,37
Cliftonville,1618,5,9,4,13,33,33,0,31
Ballymena,1618,6,7,4,15,25,49,-24,25
Glentoran,1618,7,6,6,10,24,32,-8,24
Dungannon,1618,8,2,4,16,14,47,-33,10
Crusaders,1619,1,16,6,4,61,31,30,54
Coleraine,1619,2,14,11,1,44,23,21,53
Linfield,1619,3,11,5,10,39,37,2,38
Glenavon,1619,4,9,10,7,53,44,9,37
Cliftonville,1619,5,9,4,13,33,33,0,31
Ballymena,1619,6,8,4,14,26,47,-21,28
Glentoran,1619,7,6,6,10,24,32,-8,24
Dungannon,1619,8,2,4,16,14,47,-33,10
Crusaders,1620,1,16,7,3,62,31,31,55
Coleraine,1620,2,15,10,1,46,24,22,55
Linfield,1620,3,11,5,10,41,38,3,38
Glenavon,1620,4,9,9,8,54,46,8,36
Cliftonville,1620,5,9,4,13,34,35,-1,31
Ballymena,1620,6,7,5,14,26,48,-22,26
Glentoran,1620,7,6,6,10,24,32,-8,24
Dungannon,1620,8,2,4,16,14,47,-33,10
Crusaders,1621,1,16,7,3,63,32,31,55
Coleraine,1621,2,15,10,1,48,22,26,55
Linfield,1621,3,11,5,10,39,36,3,38
Glenavon,1621,4,9,9,8,52,48,4,36
Cliftonville,1621,5,9,4,13,32,33,-1,31
Ballymena,1621,6,7,5,14,27,49,-22,26
Glentoran,1621,7,6,6,10,24,32,-8,24
Dungannon,1621,8,2,4,16,14,47,-33,10
Crusaders,1622,1,16,6,4,62,33,29,54
Coleraine,1622,2,14,10,2,44,24,20,52
Glenavon,1622,3,10,9,7,54,44,10,39
Linfield,1622,4,11,5,10,39,37,2,38
Cliftonville,1622,5,9,4,13,33,33,0,31
Ballymena,1622,6,8,4,14,28,48,-20,28
Glentoran,1622,7,6,6,10,24,32,-8,24
Dungannon,1622,8,2,4,16,14,47,-33,10
Crusaders,1623,1,17,6,3,65,30,35,57
Coleraine,1623,2,15,10,1,44,22,22,55
Linfield,1623,3,11,5,10,40,37,3,38
Glenavon,1623,4,9,9,8,52,44,8,36
Cliftonville,1623,5,9,4,13,33,34,-1,31
Ballymena,1623,6,7,4,15,25,51,-26,25
Glentoran,1623,7,6,6,10,24,32,-8,24
Dungannon,1623,8,2,4,16,14,47,-33,10
Crusaders,1624,1,16,6,4,63,33,30,54
Coleraine,1624,2,14,11,1,43,22,21,53
Linfield,1624,3,11,5,10,38,36,2,38
Glenavon,1624,4,9,10,7,52,43,9,37
Cliftonville,1624,5,9,4,13,32,32,0,31
Ballymena,1624,6,8,4,14,28,49,-21,28
Glentoran,1624,7,6,6,10,24,32,-8,24
Dungannon,1624,8,2,4,16,14,47,-33,10
Crusaders,1625,1,16,7,3,62,31,31,55
Coleraine,1625,2,14,11,1,46,25,21,53
Glenavon,1625,3,9,10,7,55,46,9,37
Linfield,1625,4,10,5,11,38,39,-1,35
Cliftonville,1625,5,10,4,12,35,32,3,34
Ballymena,1625,6,7,5,14,26,48,-22,26
Glentoran,1625,7,6,6,10,24,32,-8,24
Dungannon,1625,8,2,4,16,14,47,-33,10
Crusaders,1626,1,17,6,3,65,30,35,57
Coleraine,1626,2,15,10,1,47,24,23,55
Linfield,1626,3,11,5,10,38,36,2,38
Glenavon,1626,4,9,9,8,54,47,7,36
Cliftonville,1626,5,9,4,13,32,32,0,31
Ballymena,1626,6,7,4,15,25,51,-26,25
Glentoran,1626,7,6,6,10,24,32,-8,24
Dungannon,1626,8,2,4,16,14,47,-33,10
Crusaders,1627,1,17,6,3,65,32,33,57
Coleraine,1627,2,14,11,1,44,23,21,53
Glenavon,1627,3,9,10,7,53,44,9,37
Linfield,1627,4,10,5,11,38,38,0,35
Cliftonville,1627,5,10,4,12,34,32,2,34
Ballymena,1627,6,7,4,15,27,51,-24,25
Glentoran,1627,7,6,6,10,24,32,-8,24
Dungannon,1627,8,2,4,16,14,47,-33,10
Crusaders,1628,1,17,6,3,64,31,33,57
Coleraine,1628,2,14,11,1,43,22,21,53
Glenavon,1628,3,9,10,7,52,43,9,37
Linfield,1628,4,10,5,11,37,39,-2,35
Cliftonville,1628,5,10,4,12,35,31,4,34
Ballymena,1628,6,7,4,15,26,50,-24,25
Glentoran,1628,7,6,6,10,24,32,-8,24
Dungannon,1628,8,2,4,16,14,47,-33,10
Crusaders,1629,1,17,6,3,63,31,32,57
Coleraine,1629,2,15,10,1,45,22,23,55
Linfield,1629,3,11,5,10,40,36,4,38
Glenavon,1629,4,9,9,8,52,45,7,36
Cliftonville,1629,5,9,4,13,32,34,-2,31
Ballymena,1629,6,7,4,15,26,49,-23,25
Glentoran,1629,7,6,6,10,24,32,-8,24
Dungannon,1629,8,2,4,16,14,47,-33,10
Crusaders,1630,1,17,6,3,63,30,33,57
Coleraine,1630,2,14,11,1,44,23,21,53
Glenavon,1630,3,9,10,7,53,44,9,37
Linfield,1630,4,10,6,10,38,37,1,36
Cliftonville,1630,5,9,5,12,33,32,1,32
Ballymena,1630,6,7,4,15,25,49,-24,25
Glentoran,1630,7,6,6,10,24,32,-8,24
Dungannon,1630,8,2,4,16,14,47,-33,10
Crusaders,1631,1,17,6,3,65,33,32,57
Coleraine,1631,2,14,10,2,44,25,19,52
Glenavon,1631,3,10,9,7,55,44,11,39
Linfield,1631,4,10,6,10,37,36,1,36
Cliftonville,1631,5,9,5,12,32,31,1,32
Ballymena,1631,6,7,4,15,28,51,-23,25
Glentoran,1631,7,6,6,10,24,32,-8,24
Dungannon,1631,8,2,4,16,14,47,-33,10
Crusaders,1632,1,17,6,3,63,31,32,57
Coleraine,1632,2,15,10,1,45,23,22,55
Glenavon,1632,3,9,9,8,53,45,8,36
Linfield,1632,4,10,5,11,37,39,-2,35
Cliftonville,1632,5,10,4,12,35,31,4,34
Ballymena,1632,6,7,4,15,26,49,-23,25
Glentoran,1632,7,6,6,10,24,32,-8,24
Dungannon,1632,8,2,4,16,14,47,-33,10
Crusaders,1633,1,17,6,3,62,30,32,57
Coleraine,1633,2,14,10,2,43,25,18,52
Glenavon,1633,3,10,9,7,55,43,12,39
Linfield,1633,4,10,6,10,39,38,1,36
Cliftonville,1633,5,9,5,12,34,33,1,32
Ballymena,1633,6,7,4,15,25,48,-23,25
Glentoran,1633,7,6,6,10,24,32,-8,24
Dungannon,1633,8,2,4,16,14,47,-33,10
Crusaders,1634,1,16,7,3,64,33,31,55
Coleraine,1634,2,15,10,1,46,24,22,55
Glenavon,1634,3,9,9,8,54,46,8,36
Linfield,1634,4,10,6,10,38,37,1,36
Cliftonville,1634,5,9,5,12,33,32,1,32
Ballymena,1634,6,7,5,14,28,50,-22,26
Glentoran,1634,7,6,6,10,24,32,-8,24
Dungannon,1634,8,2,4,16,14,47,-33,10
Crusaders,1635,1,17,6,3,62,30,32,57
Coleraine,1635,2,15,10,1,46,22,24,55
Glenavon,1635,3,9,9,8,52,46,6,36
Linfield,1635,4,10,5,11,38,38,0,35
Cliftonville,1635,5,10,4,12,34,32,2,34
Ballymena,1635,6,7,4,15,25,48,-23,25
Glentoran,1635,7,6,6,10,24,32,-8,24
Dungannon,1635,8,2,4,16,14,47,-33,10
Crusaders,1636,1,17,6,3,63,31,32,57
Coleraine,1636,2,14,11,1,44,23,21,53
Linfield,1636,3,11,5,10,38,36,2,38
Glenavon,1636,4,9,10,7,53,44,9,37
Cliftonville,1636,5,9,4,13,32,32,0,31
Ballymena,1636,6,7,4,15,26,49,-23,25
Glentoran,1636,7,6,6,10,24,32,-8,24
Dungannon,1636,8,2,4,16,14,47,-33,10
Crusaders,1637,1,17,6,3,65,32,33,57
Coleraine,1637,2,14,11,1,43,22,21,53
Glenavon,1637,3,9,10,7,52,43,9,37
Linfield,1637,4,10,5,11,37,41,-4,35
Cliftonville,1637,5,10,4,12,37,31,6,34
Ballymena,1637,6,7,4,15,27,51,-24,25
Glentoran,1637,7,6,6,10,24,32,-8,24
Dungannon,1637,8,2,4,16,14,47,-33,10
Crusaders,1638,1,16,7,3,62,31,31,55
Coleraine,1638,2,15,10,1,45,23,22,55
Glenavon,1638,3,9,9,8,53,45,8,36
Linfield,1638,4,10,6,10,39,38,1,36
Cliftonville,1638,5,9,5,12,34,33,1,32
Ballymena,1638,6,7,5,14,26,48,-22,26
Glentoran,1638,7,6,6,10,24,32,-8,24
Dungannon,1638,8,2,4,16,14,47,-33,10
Crusaders,1639,1,17,6,3,64,32,32,57
Coleraine,1639,2,14,10,2,44,25,19,52
Glenavon,1639,3,10,9,7,55,44,11,39
Linfield,1639,4,11,5,10,38,36,2,38
Cliftonville,1639,5,9,4,13,32,32,0,31
Ballymena,1639,6,7,4,15,27,50,-23,25
Glentoran,1639,7,6,6,10,24,32,-8,24
Dungannon,1639,8,2,4,16,14,47,-33,10
Crusaders,1640,1,17,6,3,63,31,32,57
Coleraine,1640,2,14,11,1,45,24,21,53
Glenavon,1640,3,9,10,7,54,45,9,37
Linfield,1640,4,10,6,10,37,36,1,36
Cliftonville,1640,5,9,5,12,32,31,1,32
Ballymena,1640,6,7,4,15,26,49,-23,25
Glentoran,1640,7,6,6,10,24,32,-8,24
Dungannon,1640,8,2,4,16,14,47,-33,10
Crusaders,1641,1,17,6,3,64,31,33,57
Coleraine,1641,2,14,10,2,45,25,20,52
Glenavon,1641,3,10,9,7,55,45,10,39
Linfield,1641,4,11,5,10,38,36,2,38
Cliftonville,1641,5,9,4,13,32,32,0,31
Ballymena,1641,6,7,4,15,26,50,-24,25
Glentoran,1641,7,6,6,10,24,32,-8,24
Dungannon,1641,8,2,4,16,14,47,-33,10
Crusaders,1642,1,16,7,3,63,32,31,55
Coleraine,1642,2,14,10,2,43,24,19,52
Glenavon,1642,3,10,9,7,54,43,11,39
Linfield,1642,4,10,5,11,38,38,0,35
Cliftonville,1642,5,10,4,12,34,32,2,34
Ballymena,1642,6,7,5,14,27,49,-22,26
Glentoran,1642,7,6,6,10,24,32,-8,24
Dungannon,1642,8,2,4,16,14,47,-33,10
Crusaders,1643,1,17,6,3,65,31,34,57
Coleraine,1643,2,14,10,2,46,26,20,52
Glenavon,1643,3,10,9,7,56,46,10,39
Linfield,1643,4,10,6,10,38,37,1,36
Cliftonville,1643,5,9,5,12,33,32,1,32
Ballymena,1643,6,7,4,15,26,51,-25,25
Glentoran,1643,7,6,6,10,24,32,-8,24
Dungannon,1643,8,2,4,16,14,47,-33,10
Crusaders,1644,1,17,6,3,62,30,32,57
Coleraine,1644,2,15,10,1,45,22,23,55
Glenavon,1644,3,9,9,8,52,45,7,36
Linfield,1644,4,10,6,10,39,38,1,36
Cliftonville,1644,5,9,5,12,34,33,1,32
Ballymena,1644,6,7,4,15,25,48,-23,25
Glentoran,1644,7,6,6,10,24,32,-8,24
Dungannon,1644,8,2,4,16,14,47,-33,10
Crusaders,1645,1,17,6,3,64,31,33,57
Coleraine,1645,2,14,10,2,43,27,16,52
Glenavon,1645,3,10,9,7,57,43,14,39
Linfield,1645,4,11,5,10,38,36,2,38
Cliftonville,1645,5,9,4,13,32,32,0,31
Ballymena,1645,6,7,4,15,26,50,-24,25
Glentoran,1645,7,6,6,10,24,32,-8,24
Dungannon,1645,8,2,4,16,14,47,-33,10
Crusaders,1646,1,17,6,3,62,30,32,57
Coleraine,1646,2,15,10,1,46,23,23,55
Glenavon,1646,3,9,9,8,53,46,7,36
Linfield,1646,4,10,5,11,38,39,-1,35
Cliftonville,1646,5,10,4,12,35,32,3,34
Ballymena,1646,6,7,4,15,25,48,-23,25
Glentoran,1646,7,6,6,10,24,32,-8,24
Dungannon,1646,8,2,4,16,14,47,-33,10
Crusaders,1647,1,16,6,4,62,32,30,54
Coleraine,1647,2,14,11,1,44,23,21,53
Glenavon,1647,3,9,10,7,53,44,9,37
Linfield,1647,4,10,6,10,38,37,1,36
Cliftonville,1647,5,9,5,12,33,32,1,32
Ballymena,1647,6,8,4,14,27,48,-21,28
Glentoran,1647,7,6,6,10,24,32,-8,24
Dungannon,1647,8,2,4,16,14,47,-33,10
Coleraine,1648,1,15,10,1,47,24,23,55
Crusaders,1648,2,16,6,4,62,32,30,54
Linfield,1648,3,11,5,10,39,37,2,38
Glenavon,1648,4,9,9,8,54,47,7,36
Cliftonville,1648,5,9,4,13,33,33,0,31
Ballymena,1648,6,8,4,14,27,48,-21,28
Glentoran,1648,7,6,6,10,24,32,-8,24
Dungannon,1648,8,2,4,16,14,47,-33,10
Crusaders,1649,1,17,6,3,63,31,32,57
Coleraine,1649,2,15,10,1,47,24,23,55
Glenavon,1649,3,9,9,8,54,47,7,36
Linfield,1649,4,10,6,10,37,36,1,36
Cliftonville,1649,5,9,5,12,32,31,1,32
Ballymena,1649,6,7,4,15,26,49,-23,25
Glentoran,1649,7,6,6,10,24,32,-8,24
Dungannon,1649,8,2,4,16,14,47,-33,10
Crusaders,1650,1,16,7,3,61,30,31,55
Coleraine,1650,2,14,11,1,45,24,21,53
Glenavon,1650,3,9,10,7,54,45,9,37
Linfield,1650,4,10,6,10,37,36,1,36
Cliftonville,1650,5,9,5,12,32,31,1,32
Ballymena,1650,6,7,5,14,25,47,-22,26
Glentoran,1650,7,6,6,10,24,32,-8,24
Dungannon,1650,8,2,4,16,14,47,-33,10
Crusaders,1651,1,17,6,3,64,32,32,57
Coleraine,1651,2,14,10,2,44,28,16,52
Glenavon,1651,3,10,9,7,58,44,14,39
Linfield,1651,4,11,5,10,42,36,6,38
Cliftonville,1651,5,9,4,13,32,36,-4,31
Ballymena,1651,6,7,4,15,27,50,-23,25
Glentoran,1651,7,6,6,10,24,32,-8,24
Dungannon,1651,8,2,4,16,14,47,-33,10
Crusaders,1652,1,17,6,3,64,31,33,57
Coleraine,1652,2,14,11,1,45,24,21,53
Linfield,1652,3,11,5,10,41,36,5,38
Glenavon,1652,4,9,10,7,54,45,9,37
Cliftonville,1652,5,9,4,13,32,35,-3,31
Ballymena,1652,6,7,4,15,26,50,-24,25
Glentoran,1652,7,6,6,10,24,32,-8,24
Dungannon,1652,8,2,4,16,14,47,-33,10
Crusaders,1653,1,16,7,3,63,32,31,55
Coleraine,1653,2,15,10,1,45,23,22,55
Glenavon,1653,3,9,9,8,53,45,8,36
Linfield,1653,4,10,5,11,37,37,0,35
Cliftonville,1653,5,10,4,12,33,31,2,34
Ballymena,1653,6,7,5,14,27,49,-22,26
Glentoran,1653,7,6,6,10,24,32,-8,24
Dungannon,1653,8,2,4,16,14,47,-33,10
Crusaders,1654,1,17,6,3,65,33,32,57
Coleraine,1654,2,14,10,2,44,24,20,52
Glenavon,1654,3,10,9,7,54,44,10,39
Linfield,1654,4,11,5,10,39,37,2,38
Cliftonville,1654,5,9,4,13,33,33,0,31
Ballymena,1654,6,7,4,15,28,51,-23,25
Glentoran,1654,7,6,6,10,24,32,-8,24
Dungannon,1654,8,2,4,16,14,47,-33,10
Crusaders,1655,1,17,6,3,64,32,32,57
Coleraine,1655,2,14,10,2,43,26,17,52
Glenavon,1655,3,10,9,7,56,43,13,39
Linfield,1655,4,10,5,11,37,37,0,35
Cliftonville,1655,5,10,4,12,33,31,2,34
Ballymena,1655,6,7,4,15,27,50,-23,25
Glentoran,1655,7,6,6,10,24,32,-8,24
Dungannon,1655,8,2,4,16,14,47,-33,10
Crusaders,1656,1,17,6,3,64,30,34,57
Coleraine,1656,2,14,11,1,44,23,21,53
Glenavon,1656,3,9,10,7,53,44,9,37
Linfield,1656,4,10,5,11,38,38,0,35
Cliftonville,1656,5,10,4,12,34,32,2,34
Ballymena,1656,6,7,4,15,25,50,-25,25
Glentoran,1656,7,6,6,10,24,32,-8,24
Dungannon,1656,8,2,4,16,14,47,-33,10
Crusaders,1657,1,16,7,3,63,32,31,55
Coleraine,1657,2,14,10,2,43,23,20,52
Glenavon,1657,3,10,9,7,53,43,10,39
Linfield,1657,4,10,5,11,37,37,0,35
Cliftonville,1657,5,10,4,12,33,31,2,34
Ballymena,1657,6,7,5,14,27,49,-22,26
Glentoran,1657,7,6,6,10,24,32,-8,24
Dungannon,1657,8,2,4,16,14,47,-33,10
Crusaders,1658,1,17,6,3,65,32,33,57
Coleraine,1658,2,14,10,2,45,26,19,52
Glenavon,1658,3,10,9,7,56,45,11,39
Linfield,1658,4,10,5,11,38,38,0,35
Cliftonville,1658,5,10,4,12,34,32,2,34
Ballymena,1658,6,7,4,15,27,51,-24,25
Glentoran,1658,7,6,6,10,24,32,-8,24
Dungannon,1658,8,2,4,16,14,47,-33,10
Crusaders,1659,1,17,6,3,63,31,32,57
Coleraine,1659,2,14,10,2,44,24,20,52
Glenavon,1659,3,10,9,7,54,44,10,39
Linfield,1659,4,10,6,10,38,37,1,36
Cliftonville,1659,5,9,5,12,33,32,1,32
Ballymena,1659,6,7,4,15,26,49,-23,25
Glentoran,1659,7,6,6,10,24,32,-8,24
Dungannon,1659,8,2,4,16,14,47,-33,10
Crusaders,1660,1,17,6,3,64,31,33,57
Coleraine,1660,2,15,10,1,45,23,22,55
Glenavon,1660,3,9,9,8,53,45,8,36
Linfield,1660,4,10,6,10,38,37,1,36
Cliftonville,1660,5,9,5,12,33,32,1,32
Ballymena,1660,6,7,4,15,26,50,-24,25
Glentoran,1660,7,6,6,10,24,32,-8,24
Dungannon,1660,8,2,4,16,14,47,-33,10
Crusaders,1661,1,16,6,4,62,33,29,54
Coleraine,1661,2,14,10,2,46,26,20,52
Glenavon,1661,3,10,9,7,56,46,10,39
Linfield,1661,4,10,6,10,37,36,1,36
Cliftonville,1661,5,9,5,12,32,31,1,32
Ballymena,1661,6,8,4,14,28,48,-20,28
Glentoran,1661,7,6,6,10,24,32,-8,24
Dungannon,1661,8,2,4,16,14,47,-33,10
Crusaders,1662,1,17,6,3,63,31,32,57
Coleraine,1662,2,14,10,2,46,26,20,52
Glenavon,1662,3,10,9,7,56,46,10,39
Linfield,1662,4,10,6,10,38,37,1,36
Cliftonville,1662,5,9,5,12,33,32,1,32
Ballymena,1662,6,7,4,15,26,49,-23,25
Glentoran,1662,7,6,6,10,24,32,-8,24
Dungannon,1662,8,2,4,16,14,47,-33,10
Crusaders,1663,1,17,6,3,65,31,34,57
Coleraine,1663,2,14,10,2,44,26,18,52
Glenavon,1663,3,10,9,7,56,44,12,39
Linfield,1663,4,10,6,10,39,38,1,36
Cliftonville,1663,5,9,5,12,34,33,1,32
Ballymena,1663,6,7,4,15,26,51,-25,25
Glentoran,1663,7,6,6,10,24,32,-8,24
Dungannon,1663,8,2,4,16,14,47,-33,10
Crusaders,1664,1,16,7,3,64,33,31,55
Coleraine,1664,2,15,10,1,46,23,23,55
Glenavon,1664,3,9,9,8,53,46,7,36
Linfield,1664,4,10,6,10,37,36,1,36
Cliftonville,1664,5,9,5,12,32,31,1,32
Ballymena,1664,6,7,5,14,28,50,-22,26
Glentoran,1664,7,6,6,10,24,32,-8,24
Dungannon,1664,8,2,4,16,14,47,-33,10
Crusaders,1665,1,16,6,4,61,32,29,54
Coleraine,1665,2,14,10,2,43,23,20,52
Glenavon,1665,3,10,9,7,53,43,10,39
Linfield,1665,4,11,5,10,39,36,3,38
Cliftonville,1665,5,9,4,13,32,33,-1,31
Ballymena,1665,6,8,4,14,27,47,-20,28
Glentoran,1665,7,6,6,10,24,32,-8,24
Dungannon,1665,8,2,4,16,14,47,-33,10
Crusaders,1666,1,17,6,3,64,30,34,57
Coleraine,1666,2,14,10,2,44,24,20,52
Glenavon,1666,3,10,9,7,54,44,10,39
Linfield,1666,4,11,5,10,39,36,3,38
Cliftonville,1666,5,9,4,13,32,33,-1,31
Ballymena,1666,6,7,4,15,25,50,-25,25
Glentoran,1666,7,6,6,10,24,32,-8,24
Dungannon,1666,8,2,4,16,14,47,-33,10
Crusaders,1667,1,17,6,3,63,30,33,57
Coleraine,1667,2,15,10,1,46,24,22,55
Linfield,1667,3,11,5,10,38,36,2,38
Glenavon,1667,4,9,9,8,54,46,8,36
Cliftonville,1667,5,9,4,13,32,32,0,31
Ballymena,1667,6,7,4,15,25,49,-24,25
Glentoran,1667,7,6,6,10,24,32,-8,24
Dungannon,1667,8,2,4,16,14,47,-33,10
Crusaders,1668,1,17,6,3,62,30,32,57
Coleraine,1668,2,14,10,2,43,24,19,52
Glenavon,1668,3,10,9,7,54,43,11,39
Linfield,1668,4,10,5,11,37,37,0,35
Cliftonville,1668,5,10,4,12,33,31,2,34
Ballymena,1668,6,7,4,15,25,48,-23,25
Glentoran,1668,7,6,6,10,24,32,-8,24
Dungannon,1668,8,2,4,16,14,47,-33,10
Crusaders,1669,1,16,6,4,63,33,30,54
Coleraine,1669,2,14,10,2,44,25,19,52
Glenavon,1669,3,10,9,7,55,44,11,39
Linfield,1669,4,10,5,11,39,39,0,35
Cliftonville,1669,5,10,4,12,35,33,2,34
Ballymena,1669,6,8,4,14,28,49,-21,28
Glentoran,1669,7,6,6,10,24,32,-8,24
Dungannon,1669,8,2,4,16,14,47,-33,10
Crusaders,1670,1,16,7,3,62,31,31,55
Coleraine,1670,2,15,10,1,44,22,22,55
Linfield,1670,3,11,5,10,41,39,2,38
Glenavon,1670,4,9,9,8,52,44,8,36
Cliftonville,1670,5,9,4,13,35,35,0,31
Ballymena,1670,6,7,5,14,26,48,-22,26
Glentoran,1670,7,6,6,10,24,32,-8,24
Dungannon,1670,8,2,4,16,14,47,-33,10
Crusaders,1671,1,17,6,3,65,31,34,57
Coleraine,1671,2,15,10,1,45,23,22,55
Linfield,1671,3,11,5,10,41,37,4,38
Glenavon,1671,4,9,9,8,53,45,8,36
Cliftonville,1671,5,9,4,13,33,35,-2,31
Ballymena,1671,6,7,4,15,26,51,-25,25
Glentoran,1671,7,6,6,10,24,32,-8,24
Dungannon,1671,8,2,4,16,14,47,-33,10
Crusaders,1672,1,17,6,3,64,32,32,57
Coleraine,1672,2,14,10,2,44,24,20,52
Glenavon,1672,3,10,9,7,54,44,10,39
Linfield,1672,4,11,5,10,38,36,2,38
Cliftonville,1672,5,9,4,13,32,32,0,31
Ballymena,1672,6,7,4,15,27,50,-23,25
Glentoran,1672,7,6,6,10,24,32,-8,24
Dungannon,1672,8,2,4,16,14,47,-33,10
Crusaders,1673,1,16,7,3,62,31,31,55
Coleraine,1673,2,15,10,1,45,22,23,55
Glenavon,1673,3,9,9,8,52,45,7,36
Linfield,1673,4,10,5,11,37,37,0,35
Cliftonville,1673,5,10,4,12,33,31,2,34
Ballymena,1673,6,7,5,14,26,48,-22,26
Glentoran,1673,7,6,6,10,24,32,-8,24
Dungannon,1673,8,2,4,16,14,47,-33,10
Crusaders,1674,1,17,6,3,62,30,32,57
Coleraine,1674,2,15,10,1,47,25,22,55
Glenavon,1674,3,9,9,8,55,47,8,36
Linfield,1674,4,10,6,10,39,38,1,36
Cliftonville,1674,5,9,5,12,34,33,1,32
Ballymena,1674,6,7,4,15,25,48,-23,25
Glentoran,1674,7,6,6,10,24,32,-8,24
Dungannon,1674,8,2,4,16,14,47,-33,10
Crusaders,1675,1,17,6,3,63,31,32,57
Coleraine,1675,2,15,10,1,45,22,23,55
Glenavon,1675,3,9,9,8,52,45,7,36
Linfield,1675,4,10,6,10,39,38,1,36
Cliftonville,1675,5,9,5,12,34,33,1,32
Ballymena,1675,6,7,4,15,26,49,-23,25
Glentoran,1675,7,6,6,10,24,32,-8,24
Dungannon,1675,8,2,4,16,14,47,-33,10
Crusaders,1676,1,17,6,3,66,32,34,57
Coleraine,1676,2,14,11,1,45,24,21,53
Linfield,1676,3,11,5,10,39,37,2,38
Glenavon,1676,4,9,10,7,54,45,9,37
Cliftonville,1676,5,9,4,13,33,33,0,31
Ballymena,1676,6,7,4,15,27,52,-25,25
Glentoran,1676,7,6,6,10,24,32,-8,24
Dungannon,1676,8,2,4,16,14,47,-33,10
Crusaders,1677,1,16,6,4,62,32,30,54
Coleraine,1677,2,14,11,1,45,24,21,53
Glenavon,1677,3,9,10,7,54,45,9,37
Linfield,1677,4,10,6,10,37,36,1,36
Cliftonville,1677,5,9,5,12,32,31,1,32
Ballymena,1677,6,8,4,14,27,48,-21,28
Glentoran,1677,7,6,6,10,24,32,-8,24
Dungannon,1677,8,2,4,16,14,47,-33,10
Crusaders,1678,1,16,6,4,62,33,29,54
Coleraine,1678,2,14,10,2,44,24,20,52
Glenavon,1678,3,10,9,7,54,44,10,39
Linfield,1678,4,11,5,10,40,36,4,38
Cliftonville,1678,5,9,4,13,32,34,-2,31
Ballymena,1678,6,8,4,14,28,48,-20,28
Glentoran,1678,7,6,6,10,24,32,-8,24
Dungannon,1678,8,2,4,16,14,47,-33,10
Crusaders,1679,1,16,7,3,65,34,31,55
Coleraine,1679,2,14,10,2,43,24,19,52
Glenavon,1679,3,10,9,7,54,43,11,39
Linfield,1679,4,10,6,10,37,36,1,36
Cliftonville,1679,5,9,5,12,32,31,1,32
Ballymena,1679,6,7,5,14,29,51,-22,26
Glentoran,1679,7,6,6,10,24,32,-8,24
Dungannon,1679,8,2,4,16,14,47,-33,10
Crusaders,1680,1,16,7,3,62,31,31,55
Coleraine,1680,2,15,10,1,44,22,22,55
Linfield,1680,3,11,5,10,39,37,2,38
Glenavon,1680,4,9,9,8,52,44,8,36
Cliftonville,1680,5,9,4,13,33,33,0,31
Ballymena,1680,6,7,5,14,26,48,-22,26
Glentoran,1680,7,6,6,10,24,32,-8,24
Dungannon,1680,8,2,4,16,14,47,-33,10
Coleraine,1681,1,15,10,1,45,23,22,55
Crusaders,1681,2,16,6,4,62,32,30,54
Glenavon,1681,3,9,9,8,53,45,8,36
Linfield,1681,4,10,6,10,39,38,1,36
Cliftonville,1681,5,9,5,12,34,33,1,32
Ballymena,1681,6,8,4,14,27,48,-21,28
Glentoran,1681,7,6,6,10,24,32,-8,24
Dungannon,1681,8,2,4,16,14,47,-33,10
Crusaders,1682,1,17,6,3,64,30,34,57
Coleraine,1682,2,15,10,1,44,22,22,55
Linfield,1682,3,11,5,10,40,36,4,38
Glenavon,1682,4,9,9,8,52,44,8,36
Cliftonville,1682,5,9,4,13,32,34,-2,31
Ballymena,1682,6,7,4,15,25,50,-25,25
Glentoran,1682,7,6,6,10,24,32,-8,24
Dungannon,1682,8,2,4,16,14,47,-33,10
Crusaders,1683,1,17,6,3,63,31,32,57
Coleraine,1683,2,14,10,2,43,24,19,52
Glenavon,1683,3,10,9,7,54,43,11,39
Linfield,1683,4,10,6,10,38,37,1,36
Cliftonville,1683,5,9,5,12,33,32,1,32
Ballymena,1683,6,7,4,15,26,49,-23,25
Glentoran,1683,7,6,6,10,24,32,-8,24
Dungannon,1683,8,2,4,16,14,47,-33,10
Crusaders,1684,1,17,6,3,64,30,34,57
Coleraine,1684,2,14,10,2,44,26,18,52
Glenavon,1684,3,10,9,7,56,44,12,39
Linfield,1684,4,10,6,10,38,37,1,36
Cliftonville,1684,5,9,5,12,33,32,1,32
Ballymena,1684,6,7,4,15,25,50,-25,25
Glentoran,1684,7,6,6,10,24,32,-8,24
Dungannon,1684,8,2,4,16,14,47,-33,10
Crusaders,1685,1,16,6,4,64,34,30,54
Coleraine,1685,2,14,10,2,45,25,20,52
Glenavon,1685,3,10,9,7,55,45,10,39
Linfield,1685,4,10,6,10,38,37,1,36
Cliftonville,1685,5,9,5,12,33,32,1,32
Ballymena,1685,6,8,4,14,29,50,-21,28
Glentoran,1685,7,6,6,10,24,32,-8,24
Dungannon,1685,8,2,4,16,14,47,-33,10
Crusaders,1686,1,16,6,4,62,32,30,54
Coleraine,1686,2,14,10,2,44,24,20,52
Glenavon,1686,3,10,9,7,54,44,10,39
Linfield,1686,4,10,6,10,38,37,1,36
Cliftonville,1686,5,9,5,12,33,32,1,32
Ballymena,1686,6,8,4,14,27,48,-21,28
Glentoran,1686,7,6,6,10,24,32,-8,24
Dungannon,1686,8,2,4,16,14,47,-33,10
Crusaders,1687,1,17,6,3,66,32,34,57
Coleraine,1687,2,14,10,2,44,24,20,52
Glenavon,1687,3,10,9,7,54,44,10,39
Linfield,1687,4,10,6,10,39,38,1,36
Cliftonville,1687,5,9,5,12,34,33,1,32
Ballymena,1687,6,7,4,15,27,52,-25,25
Glentoran,1687,7,6,6,10,24,32,-8,24
Dungannon,1687,8,2,4,16,14,47,-33,10
Crusaders,1688,1,17,6,3,64,30,34,57
Coleraine,1688,2,15,10,1,45,22,23,55
Linfield,1688,3,11,5,10,40,36,4,38
Glenavon,1688,4,9,9,8,52,45,7,36
Cliftonville,1688,5,9,4,13,32,34,-2,31
Ballymena,1688,6,7,4,15,25,50,-25,25
Glentoran,1688,7,6,6,10,24,32,-8,24
Dungannon,1688,8,2,4,16,14,47,-33,10
Crusaders,1689,1,16,6,4,63,33,30,54
Coleraine,1689,2,14,11,1,44,23,21,53
Glenavon,1689,3,9,10,7,53,44,9,37
Linfield,1689,4,10,6,10,38,37,1,36
Cliftonville,1689,5,9,5,12,33,32,1,32
Ballymena,1689,6,8,4,14,28,49,-21,28
Glentoran,1689,7,6,6,10,24,32,-8,24
Dungannon,1689,8,2,4,16,14,47,-33,10
Crusaders,1690,1,17,6,3,63,31,32,57
Coleraine,1690,2,15,10,1,44,22,22,55
Linfield,1690,3,11,5,10,44,36,8,38
Glenavon,1690,4,9,9,8,52,44,8,36
Cliftonville,1690,5,9,4,13,32,38,-6,31
Ballymena,1690,6,7,4,15,26,49,-23,25
Glentoran,1690,7,6,6,10,24,32,-8,24
Dungannon,1690,8,2,4,16,14,47,-33,10
Crusaders,1691,1,17,6,3,64,31,33,57
Coleraine,1691,2,15,10,1,45,23,22,55
Glenavon,1691,3,9,9,8,53,45,8,36
Linfield,1691,4,10,5,11,38,38,0,35
Cliftonville,1691,5,10,4,12,34,32,2,34
Ballymena,1691,6,7,4,15,26,50,-24,25
Glentoran,1691,7,6,6,10,24,32,-8,24
Dungannon,1691,8,2,4,16,14,47,-33,10
Crusaders,1692,1,16,7,3,62,31,31,55
Coleraine,1692,2,14,10,2,45,25,20,52
Glenavon,1692,3,10,9,7,55,45,10,39
Linfield,1692,4,11,5,10,39,36,3,38
Cliftonville,1692,5,9,4,13,32,33,-1,31
Ballymena,1692,6,7,5,14,26,48,-22,26
Glentoran,1692,7,6,6,10,24,32,-8,24
Dungannon,1692,8,2,4,16,14,47,-33,10
Crusaders,1693,1,16,7,3,62,31,31,55
Coleraine,1693,2,14,10,2,44,24,20,52
Glenavon,1693,3,10,9,7,54,44,10,39
Linfield,1693,4,11,5,10,42,36,6,38
Cliftonville,1693,5,9,4,13,32,36,-4,31
Ballymena,1693,6,7,5,14,26,48,-22,26
Glentoran,1693,7,6,6,10,24,32,-8,24
Dungannon,1693,8,2,4,16,14,47,-33,10
Crusaders,1694,1,17,6,3,63,30,33,57
Coleraine,1694,2,14,10,2,44,25,19,52
Glenavon,1694,3,10,9,7,55,44,11,39
Linfield,1694,4,11,5,10,39,37,2,38
Cliftonville,1694,5,9,4,13,33,33,0,31
Ballymena,1694,6,7,4,15,25,49,-24,25
Glentoran,1694,7,6,6,10,24,32,-8,24
Dungannon,1694,8,2,4,16,14,47,-33,10
Crusaders,1695,1,17,6,3,64,32,32,57
Coleraine,1695,2,15,10,1,45,22,23,55
Linfield,1695,3,11,5,10,38,36,2,38
Glenavon,1695,4,9,9,8,52,45,7,36
Cliftonville,1695,5,9,4,13,32,32,0,31
Ballymena,1695,6,7,4,15,27,50,-23,25
Glentoran,1695,7,6,6,10,24,32,-8,24
Dungannon,1695,8,2,4,16,14,47,-33,10
Crusaders,1696,1,17,6,3,62,30,32,57
Coleraine,1696,2,14,10,2,43,24,19,52
Glenavon,1696,3,10,9,7,54,43,11,39
Linfield,1696,4,10,5,11,37,37,0,35
Cliftonville,1696,5,10,4,12,33,31,2,34
Ballymena,1696,6,7,4,15,25,48,-23,25
Glentoran,1696,7,6,6,10,24,32,-8,24
Dungannon,1696,8,2,4,16,14,47,-33,10
Crusaders,1697,1,17,6,3,64,32,32,57
Coleraine,1697,2,14,11,1,45,24,21,53
Linfield,1697,3,11,5,10,38,36,2,38
Glenavon,1697,4,9,10,7,54,45,9,37
Cliftonville,1697,5,9,4,13,32,32,0,31
Ballymena,1697,6,7,4,15,27,50,-23,25
Glentoran,1697,7,6,6,10,24,32,-8,24
Dungannon,1697,8,2,4,16,14,47,-33,10
Crusaders,1698,1,16,6,4,62,33,29,54
Coleraine,1698,2,14,11,1,44,23,21,53
Glenavon,1698,3,9,10,7,53,44,9,37
Linfield,1698,4,10,5,11,37,38,-1,35
Cliftonville,1698,5,10,4,12,34,31,3,34
Ballymena,1698,6,8,4,14,28,48,-20,28
Glentoran,1698,7,6,6,10,24,32,-8,24
Dungannon,1698,8,2,4,16,14,47,-33,10
Crusaders,1699,1,16,7,3,61,30,31,55
Coleraine,1699,2,14,11,1,44,23,21,53
Glenavon,1699,3,9,10,7,53,44,9,37
Linfield,1699,4,10,6,10,38,37,1,36
Cliftonville,1699,5,9,5,12,33,32,1,32
Ballymena,1699,6,7,5,14,25,47,-22,26
Glentoran,1699,7,6,6,10,24,32,-8,24
Dungannon,1699,8,2,4,16,14,47,-33,10
Crusaders,1700,1,17,6,3,62,30,32,57
Coleraine,1700,2,15,10,1,45,23,22,55
Glenavon,1700,3,9,9,8,53,45,8,36
Linfield,1700,4,10,5,11,37,38,-1,35
Cliftonville,1700,5,10,4,12,34,31,3,34
Ballymena,1700,6,7,4,15,25,48,-23,25
Glentoran,1700,7,6,6,10,24,32,-8,24
Dungannon,1700,8,2,4,16,14,47,-33,10
Crusaders,1701,1,17,6,3,63,30,33,57
Coleraine,1701,2,14,11,1,44,23,21,53
Glenavon,1701,3,9,10,7,53,44,9,37
Linfield,1701,4,10,5,11,37,37,0,35
Cliftonville,1701,5,10,4,12,33,31,2,34
Ballymena,1701,6,7,4,15,25,49,-24,25
Glentoran,1701,7,6,6,10,24,32,-8,24
Dungannon,1701,8,2,4,16,14,47,-33,10
Crusaders,1702,1,16,6,4,61,32,29,54
Coleraine,1702,2,14,11,1,44,23,21,53
Glenavon,1702,3,9,10,7,53,44,9,37
Linfield,1702,4,10,5,11,37,37,0,35
Cliftonville,1702,5,10,4,12,33,31,2,34
Ballymena,1702,6,8,4,14,27,47,-20,28
Glentoran,1702,7,6,6,10,24,32,-8,24
Dungannon,1702,8,2,4,16,14,47,-33,10
Crusaders,1703,1,17,6,3,64,30,34,57
Coleraine,1703,2,14,10,2,44,24,20,52
Glenavon,1703,3,10,9,7,54,44,10,39
Linfield,1703,4,10,5,11,40,41,-1,35
Cliftonville,1703,5,10,4,12,37,34,3,34
Ballymena,1703,6,7,4,15,25,50,-25,25
Glentoran,1703,7,6,6,10,24,32,-8,24
Dungannon,1703,8,2,4,16,14,47,-33,10
Crusaders,1704,1,16,7,3,63,32,31,55
Coleraine,1704,2,14,10,2,43,24,19,52
Glenavon,1704,3,10,9,7,54,43,11,39
Linfield,1704,4,10,6,10,39,38,1,36
Cliftonville,1704,5,9,5,12,34,33,1,32
Ballymena,1704,6,7,5,14,27,49,-22,26
Glentoran,1704,7,6,6,10,24,32,-8,24
Dungannon,1704,8,2,4,16,14,47,-33,10
Crusaders,1705,1,16,7,3,64,33,31,55
Coleraine,1705,2,15,10,1,47,23,24,55
Linfield,1705,3,11,5,10,39,37,2,38
Glenavon,1705,4,9,9,8,53,47,6,36
Cliftonville,1705,5,9,4,13,33,33,0,31
Ballymena,1705,6,7,5,14,28,50,-22,26
Glentoran,1705,7,6,6,10,24,32,-8,24
Dungannon,1705,8,2,4,16,14,47,-33,10
Crusaders,1706,1,17,6,3,64,32,32,57
Coleraine,1706,2,15,10,1,47,23,24,55
Glenavon,1706,3,9,9,8,53,47,6,36
Linfield,1706,4,10,5,11,37,37,0,35
Cliftonville,1706,5,10,4,12,33,31,2,34
Ballymena,1706,6,7,4,15,27,50,-23,25
Glentoran,1706,7,6,6,10,24,32,-8,24
Dungannon,1706,8,2,4,16,14,47,-33,10
Crusaders,1707,1,17,6,3,65,31,34,57
Coleraine,1707,2,14,10,2,43,24,19,52
Glenavon,1707,3,10,9,7,54,43,11,39
Linfield,1707,4,11,5,10,38,36,2,38
Cliftonville,1707,5,9,4,13,32,32,0,31
Ballymena,1707,6,7,4,15,26,51,-25,25
Glentoran,1707,7,6,6,10,24,32,-8,24
Dungannon,1707,8,2,4,16,14,47,-33,10
Crusaders,1708,1,17,6,3,65,30,35,57
Coleraine,1708,2,14,11,1,43,22,21,53
Glenavon,1708,3,9,10,7,52,43,9,37
Linfield,1708,4,10,6,10,38,37,1,36
Cliftonville,1708,5,9,5,12,33,32,1,32
Ballymena,1708,6,7,4,15,25,51,-26,25
Glentoran,1708,7,6,6,10,24,32,-8,24
Dungannon,1708,8,2,4,16,14,47,-33,10
Crusaders,1709,1,16,6,4,63,33,30,54
Coleraine,1709,2,14,10,2,43,23,20,52
Glenavon,1709,3,10,9,7,53,43,10,39
Linfield,1709,4,10,6,10,37,36,1,36
Cliftonville,1709,5,9,5,12,32,31,1,32
Ballymena,1709,6,8,4,14,28,49,-21,28
Glentoran,1709,7,6,6,10,24,32,-8,24
Dungannon,1709,8,2,4,16,14,47,-33,10
Crusaders,1710,1,17,6,3,65,31,34,57
Coleraine,1710,2,14,10,2,45,25,20,52
Glenavon,1710,3,10,9,7,55,45,10,39
Linfield,1710,4,10,5,11,37,39,-2,35
Cliftonville,1710,5,10,4,12,35,31,4,34
Ballymena,1710,6,7,4,15,26,51,-25,25
Glentoran,1710,7,6,6,10,24,32,-8,24
Dungannon,1710,8,2,4,16,14,47,-33,10
Crusaders,1711,1,16,7,3,62,31,31,55
Coleraine,1711,2,15,10,1,47,24,23,55
Linfield,1711,3,11,5,10,39,36,3,38
Glenavon,1711,4,9,9,8,54,47,7,36
Cliftonville,1711,5,9,4,13,32,33,-1,31
Ballymena,1711,6,7,5,14,26,48,-22,26
Glentoran,1711,7,6,6,10,24,32,-8,24
Dungannon,1711,8,2,4,16,14,47,-33,10
Crusaders,1712,1,17,6,3,63,30,33,57
Coleraine,1712,2,14,10,2,43,24,19,52
Glenavon,1712,3,10,9,7,54,43,11,39
Linfield,1712,4,10,5,11,37,37,0,35
Cliftonville,1712,5,10,4,12,33,31,2,34
Ballymena,1712,6,7,4,15,25,49,-24,25
Glentoran,1712,7,6,6,10,24,32,-8,24
Dungannon,1712,8,2,4,16,14,47,-33,10
Crusaders,1713,1,16,6,4,62,32,30,54
Coleraine,1713,2,14,11,1,44,23,21,53
Glenavon,1713,3,9,10,7,53,44,9,37
Linfield,1713,4,10,5,11,39,39,0,35
Cliftonville,1713,5,10,4,12,35,33,2,34
Ballymena,1713,6,8,4,14,27,48,-21,28
Glentoran,1713,7,6,6,10,24,32,-8,24
Dungannon,1713,8,2,4,16,14,47,-33,10
Crusaders,1714,1,17,6,3,63,30,33,57
Coleraine,1714,2,14,11,1,44,23,21,53
Linfield,1714,3,11,5,10,38,36,2,38
Glenavon,1714,4,9,10,7,53,44,9,37
Cliftonville,1714,5,9,4,13,32,32,0,31
Ballymena,1714,6,7,4,15,25,49,-24,25
Glentoran,1714,7,6,6,10,24,32,-8,24
Dungannon,1714,8,2,4,16,14,47,-33,10
Crusaders,1715,1,17,6,3,63,30,33,57
Coleraine,1715,2,15,10,1,44,22,22,55
Glenavon,1715,3,9,9,8,52,44,8,36
Linfield,1715,4,10,6,10,39,38,1,36
Cliftonville,1715,5,9,5,12,34,33,1,32
Ballymena,1715,6,7,4,15,25,49,-24,25
Glentoran,1715,7,6,6,10,24,32,-8,24
Dungannon,1715,8,2,4,16,14,47,-33,10
Crusaders,1716,1,17,6,3,63,31,32,57
Coleraine,1716,2,15,10,1,45,23,22,55
Linfield,1716,3,11,5,10,40,36,4,38
Glenavon,1716,4,9,9,8,53,45,8,36
Cliftonville,1716,5,9,4,13,32,34,-2,31
Ballymena,1716,6,7,4,15,26,49,-23,25
Glentoran,1716,7,6,6,10,24,32,-8,24
Dungannon,1716,8,2,4,16,14,47,-33,10
Crusaders,1717,1,17,6,3,65,32,33,57
Coleraine,1717,2,14,10,2,44,24,20,52
Glenavon,1717,3,10,9,7,54,44,10,39
Linfield,1717,4,11,5,10,41,38,3,38
Cliftonville,1717,5,9,4,13,34,35,-1,31
Ballymena,1717,6,7,4,15,27,51,-24,25
Glentoran,1717,7,6,6,10,24,32,-8,24
Dungannon,1717,8,2,4,16,14,47,-33,10
Crusaders,1718,1,17,6,3,64,31,33,57
Coleraine,1718,2,14,11,1,46,25,21,53
Glenavon,1718,3,9,10,7,55,46,9,37
Linfield,1718,4,10,5,11,37,37,0,35
Cliftonville,1718,5,10,4,12,33,31,2,34
Ballymena,1718,6,7,4,15,26,50,-24,25
Glentoran,1718,7,6,6,10,24,32,-8,24
Dungannon,1718,8,2,4,16,14,47,-33,10
Coleraine,1719,1,15,10,1,45,22,23,55
Crusaders,1719,2,16,6,4,61,31,30,54
Linfield,1719,3,11,5,10,40,37,3,38
Glenavon,1719,4,9,9,8,52,45,7,36
Cliftonville,1719,5,9,4,13,33,34,-1,31
Ballymena,1719,6,8,4,14,26,47,-21,28
Glentoran,1719,7,6,6,10,24,32,-8,24
Dungannon,1719,8,2,4,16,14,47,-33,10
Crusaders,1720,1,17,6,3,66,30,36,57
Coleraine,1720,2,15,10,1,47,23,24,55
Linfield,1720,3,11,5,10,40,37,3,38
Glenavon,1720,4,9,9,8,53,47,6,36
Cliftonville,1720,5,9,4,13,33,34,-1,31
Ballymena,1720,6,7,4,15,25,52,-27,25
Glentoran,1720,7,6,6,10,24,32,-8,24
Dungannon,1720,8,2,4,16,14,47,-33,10
Crusaders,1721,1,16,7,3,63,32,31,55
Coleraine,1721,2,14,11,1,44,23,21,53
Glenavon,1721,3,9,10,7,53,44,9,37
Linfield,1721,4,10,5,11,37,37,0,35
Cliftonville,1721,5,10,4,12,33,31,2,34
Ballymena,1721,6,7,5,14,27,49,-22,26
Glentoran,1721,7,6,6,10,24,32,-8,24
Dungannon,1721,8,2,4,16,14,47,-33,10
Crusaders,1722,1,16,6,4,62,32,30,54
Coleraine,1722,2,14,10,2,43,23,20,52
Glenavon,1722,3,10,9,7,53,43,10,39
Linfield,1722,4,10,5,11,38,38,0,35
Cliftonville,1722,5,10,4,12,34,32,2,34
Ballymena,1722,6,8,4,14,27,48,-21,28
Glentoran,1722,7,6,6,10,24,32,-8,24
Dungannon,1722,8,2,4,16,14,47,-33,10
Crusaders,1723,1,16,6,4,62,33,29,54
Coleraine,1723,2,14,11,1,44,23,21,53
Glenavon,1723,3,9,10,7,53,44,9,37
Linfield,1723,4,10,6,10,37,36,1,36
Cliftonville,1723,5,9,5,12,32,31,1,32
Ballymena,1723,6,8,4,14,28,48,-20,28
Glentoran,1723,7,6,6,10,24,32,-8,24
Dungannon,1723,8,2,4,16,14,47,-33,10
Crusaders,1724,1,17,6,3,64,31,33,57
Coleraine,1724,2,14,10,2,44,24,20,52
Glenavon,1724,3,10,9,7,54,44,10,39
Linfield,1724,4,10,5,11,37,37,0,35
Cliftonville,1724,5,10,4,12,33,31,2,34
Ballymena,1724,6,7,4,15,26,50,-24,25
Glentoran,1724,7,6,6,10,24,32,-8,24
Dungannon,1724,8,2,4,16,14,47,-33,10
Crusaders,1725,1,17,6,3,65,31,34,57
Coleraine,1725,2,15,10,1,46,24,22,55
Glenavon,1725,3,9,9,8,54,46,8,36
Linfield,1725,4,10,6,10,38,37,1,36
Cliftonville,1725,5,9,5,12,33,32,1,32
Ballymena,1725,6,7,4,15,26,51,-25,25
Glentoran,1725,7,6,6,10,24,32,-8,24
Dungannon,1725,8,2,4,16,14,47,-33,10
Coleraine,1726,1,15,10,1,46,23,23,55
Crusaders,1726,2,16,6,4,63,33,30,54
Glenavon,1726,3,9,9,8,53,46,7,36
Linfield,1726,4,10,6,10,40,39,1,36
Cliftonville,1726,5,9,5,12,35,34,1,32
Ballymena,1726,6,8,4,14,28,49,-21,28
Glentoran,1726,7,6,6,10,24,32,-8,24
Dungannon,1726,8,2,4,16,14,47,-33,10
Crusaders,1727,1,17,6,3,63,31,32,57
Coleraine,1727,2,14,11,1,44,23,21,53
Linfield,1727,3,11,5,10,40,38,2,38
Glenavon,1727,4,9,10,7,53,44,9,37
Cliftonville,1727,5,9,4,13,34,34,0,31
Ballymena,1727,6,7,4,15,26,49,-23,25
Glentoran,1727,7,6,6,10,24,32,-8,24
Dungannon,1727,8,2,4,16,14,47,-33,10
Crusaders,1728,1,17,6,3,64,32,32,57
Coleraine,1728,2,14,11,1,44,23,21,53
Linfield,1728,3,11,5,10,39,37,2,38
Glenavon,1728,4,9,10,7,53,44,9,37
Cliftonville,1728,5,9,4,13,33,33,0,31
Ballymena,1728,6,7,4,15,27,50,-23,25
Glentoran,1728,7,6,6,10,24,32,-8,24
Dungannon,1728,8,2,4,16,14,47,-33,10
Crusaders,1729,1,16,7,3,61,30,31,55
Coleraine,1729,2,15,10,1,45,23,22,55
Linfield,1729,3,11,5,10,40,36,4,38
Glenavon,1729,4,9,9,8,53,45,8,36
Cliftonville,1729,5,9,4,13,32,34,-2,31
Ballymena,1729,6,7,5,14,25,47,-22,26
Glentoran,1729,7,6,6,10,24,32,-8,24
Dungannon,1729,8,2,4,16,14,47,-33,10
Crusaders,1730,1,17,6,3,63,30,33,57
Coleraine,1730,2,14,11,1,46,25,21,53
Glenavon,1730,3,9,10,7,55,46,9,37
Linfield,1730,4,10,6,10,37,36,1,36
Cliftonville,1730,5,9,5,12,32,31,1,32
Ballymena,1730,6,7,4,15,25,49,-24,25
Glentoran,1730,7,6,6,10,24,32,-8,24
Dungannon,1730,8,2,4,16,14,47,-33,10
Crusaders,1731,1,17,6,3,63,31,32,57
Coleraine,1731,2,14,10,2,44,24,20,52
Glenavon,1731,3,10,9,7,54,44,10,39
Linfield,1731,4,11,5,10,40,37,3,38
Cliftonville,1731,5,9,4,13,33,34,-1,31
Ballymena,1731,6,7,4,15,26,49,-23,25
Glentoran,1731,7,6,6,10,24,32,-8,24
Dungannon,1731,8,2,4,16,14,47,-33,10
Crusaders,1732,1,16,7,3,63,32,31,55
Coleraine,1732,2,14,10,2,43,24,19,52
Glenavon,1732,3,10,9,7,54,43,11,39
Linfield,1732,4,11,5,10,41,37,4,38
Cliftonville,1732,5,9,4,13,33,35,-2,31
Ballymena,1732,6,7,5,14,27,49,-22,26
Glentoran,1732,7,6,6,10,24,32,-8,24
Dungannon,1732,8,2,4,16,14,47,-33,10
Crusaders,1733,1,17,6,3,62,30,32,57
Coleraine,1733,2,14,10,2,45,25,20,52
Glenavon,1733,3,10,9,7,55,45,10,39
Linfield,1733,4,10,6,10,37,36,1,36
Cliftonville,1733,5,9,5,12,32,31,1,32
Ballymena,1733,6,7,4,15,25,48,-23,25
Glentoran,1733,7,6,6,10,24,32,-8,24
Dungannon,1733,8,2,4,16,14,47,-33,10
Crusaders,1734,1,17,6,3,62,30,32,57
Coleraine,1734,2,14,11,1,44,23,21,53
Glenavon,1734,3,9,10,7,53,44,9,37
Linfield,1734,4,10,5,11,37,37,0,35
Cliftonville,1734,5,10,4,12,33,31,2,34
Ballymena,1734,6,7,4,15,25,48,-23,25
Glentoran,1734,7,6,6,10,24,32,-8,24
Dungannon,1734,8,2,4,16,14,47,-33,10
Crusaders,1735,1,16,7,3,61,30,31,55
Coleraine,1735,2,14,10,2,43,25,18,52
Glenavon,1735,3,10,9,7,55,43,12,39
Linfield,1735,4,10,5,11,39,39,0,35
Cliftonville,1735,5,10,4,12,35,33,2,34
Ballymena,1735,6,7,5,14,25,47,-22,26
Glentoran,1735,7,6,6,10,24,32,-8,24
Dungannon,1735,8,2,4,16,14,47,-33,10
Crusaders,1736,1,17,6,3,64,32,32,57
Coleraine,1736,2,14,11,1,45,24,21,53
Linfield,1736,3,11,5,10,39,37,2,38
Glenavon,1736,4,9,10,7,54,45,9,37
Cliftonville,1736,5,9,4,13,33,33,0,31
Ballymena,1736,6,7,4,15,27,50,-23,25
Glentoran,1736,7,6,6,10,24,32,-8,24
Dungannon,1736,8,2,4,16,14,47,-33,10
Crusaders,1737,1,17,6,3,63,31,32,57
Coleraine,1737,2,15,10,1,44,22,22,55
Glenavon,1737,3,9,9,8,52,44,8,36
Linfield,1737,4,10,6,10,37,36,1,36
Cliftonville,1737,5,9,5,12,32,31,1,32
Ballymena,1737,6,7,4,15,26,49,-23,25
Glentoran,1737,7,6,6,10,24,32,-8,24
Dungannon,1737,8,2,4,16,14,47,-33,10
Crusaders,1738,1,17,6,3,62,30,32,57
Coleraine,1738,2,14,11,1,46,25,21,53
Linfield,1738,3,11,5,10,39,37,2,38
Glenavon,1738,4,9,10,7,55,46,9,37
Cliftonville,1738,5,9,4,13,33,33,0,31
Ballymena,1738,6,7,4,15,25,48,-23,25
Glentoran,1738,7,6,6,10,24,32,-8,24
Dungannon,1738,8,2,4,16,14,47,-33,10
Crusaders,1739,1,17,6,3,63,31,32,57
Coleraine,1739,2,14,10,2,43,23,20,52
Glenavon,1739,3,10,9,7,53,43,10,39
Linfield,1739,4,11,5,10,39,36,3,38
Cliftonville,1739,5,9,4,13,32,33,-1,31
Ballymena,1739,6,7,4,15,26,49,-23,25
Glentoran,1739,7,6,6,10,24,32,-8,24
Dungannon,1739,8,2,4,16,14,47,-33,10
Crusaders,1740,1,17,6,3,67,30,37,57
Coleraine,1740,2,14,10,2,44,24,20,52
Glenavon,1740,3,10,9,7,54,44,10,39
Linfield,1740,4,10,6,10,38,37,1,36
Cliftonville,1740,5,9,5,12,33,32,1,32
Ballymena,1740,6,7,4,15,25,53,-28,25
Glentoran,1740,7,6,6,10,24,32,-8,24
Dungannon,1740,8,2,4,16,14,47,-33,10
Crusaders,1741,1,17,6,3,65,31,34,57
Coleraine,1741,2,15,10,1,44,22,22,55
Linfield,1741,3,11,5,10,41,36,5,38
Glenavon,1741,4,9,9,8,52,44,8,36
Cliftonville,1741,5,9,4,13,32,35,-3,31
Ballymena,1741,6,7,4,15,26,51,-25,25
Glentoran,1741,7,6,6,10,24,32,-8,24
Dungannon,1741,8,2,4,16,14,47,-33,10
Crusaders,1742,1,17,6,3,66,32,34,57
Coleraine,1742,2,14,10,2,43,23,20,52
Glenavon,1742,3,10,9,7,53,43,10,39
Linfield,1742,4,10,6,10,38,37,1,36
Cliftonville,1742,5,9,5,12,33,32,1,32
Ballymena,1742,6,7,4,15,27,52,-25,25
Glentoran,1742,7,6,6,10,24,32,-8,24
Dungannon,1742,8,2,4,16,14,47,-33,10
Crusaders,1743,1,17,6,3,64,30,34,57
Coleraine,1743,2,14,11,1,44,23,21,53
Linfield,1743,3,11,5,10,40,36,4,38
Glenavon,1743,4,9,10,7,53,44,9,37
Cliftonville,1743,5,9,4,13,32,34,-2,31
Ballymena,1743,6,7,4,15,25,50,-25,25
Glentoran,1743,7,6,6,10,24,32,-8,24
Dungannon,1743,8,2,4,16,14,47,-33,10
Crusaders,1744,1,17,6,3,64,32,32,57
Coleraine,1744,2,15,10,1,45,22,23,55
Linfield,1744,3,11,5,10,39,36,3,38
Glenavon,1744,4,9,9,8,52,45,7,36
Cliftonville,1744,5,9,4,13,32,33,-1,31
Ballymena,1744,6,7,4,15,27,50,-23,25
Glentoran,1744,7,6,6,10,24,32,-8,24
Dungannon,1744,8,2,4,16,14,47,-33,10
Crusaders,1745,1,16,7,3,63,32,31,55
Coleraine,1745,2,14,10,2,45,25,20,52
Glenavon,1745,3,10,9,7,55,45,10,39
Linfield,1745,4,10,5,11,38,38,0,35
Cliftonville,1745,5,10,4,12,34,32,2,34
Ballymena,1745,6,7,5,14,27,49,-22,26
Glentoran,1745,7,6,6,10,24,32,-8,24
Dungannon,1745,8,2,4,16,14,47,-33,10
Crusaders,1746,1,16,6,4,63,33,30,54
Coleraine,1746,2,14,10,2,43,23,20,52
Glenavon,1746,3,10,9,7,53,43,10,39
Linfield,1746,4,10,5,11,38,38,0,35
Cliftonville,1746,5,10,4,12,34,32,2,34
Ballymena,1746,6,8,4,14,28,49,-21,28
Glentoran,1746,7,6,6,10,24,32,-8,24
Dungannon,1746,8,2,4,16,14,47,-33,10
Crusaders,1747,1,16,7,3,61,30,31,55
Coleraine,1747,2,14,10,2,45,25,20,52
Glenavon,1747,3,10,9,7,55,45,10,39
Linfield,1747,4,10,6,10,38,37,1,36
Cliftonville,1747,5,9,5,12,33,32,1,32
Ballymena,1747,6,7,5,14,25,47,-22,26
Glentoran,1747,7,6,6,10,24,32,-8,24
Dungannon,1747,8,2,4,16,14,47,-33,10
Crusaders,1748,1,16,6,4,62,32,30,54
Coleraine,1748,2,14,11,1,43,22,21,53
Linfield,1748,3,11,5,10,40,38,2,38
Glenavon,1748,4,9,10,7,52,43,9,37
Cliftonville,1748,5,9,4,13,34,34,0,31
Ballymena,1748,6,8,4,14,27,48,-21,28
Glentoran,1748,7,6,6,10,24,32,-8,24
Dungannon,1748,8,2,4,16,14,47,-33,10
Crusaders,1749,1,17,6,3,63,31,32,57
Coleraine,1749,2,14,10,2,44,25,19,52
Glenavon,1749,3,10,9,7,55,44,11,39
Linfield,1749,4,10,5,11,38,38,0,35
Cliftonville,1749,5,10,4,12,34,32,2,34
Ballymena,1749,6,7,4,15,26,49,-23,25
Glentoran,1749,7,6,6,10,24,32,-8,24
Dungannon,1749,8,2,4,16,14,47,-33,10
Crusaders,1750,1,17,6,3,62,30,32,57
Coleraine,1750,2,14,10,2,45,28,17,52
Glenavon,1750,3,10,9,7,58,45,13,39
Linfield,1750,4,11,5,10,39,37,2,38
Cliftonville,1750,5,9,4,13,33,33,0,31
Ballymena,1750,6,7,4,15,25,48,-23,25
Glentoran,1750,7,6,6,10,24,32,-8,24
Dungannon,1750,8,2,4,16,14,47,-33,10
Coleraine,1751,1,15,10,1,46,22,24,55
Crusaders,1751,2,16,6,4,61,34,27,54
Glenavon,1751,3,9,9,8,52,46,6,36
Linfield,1751,4,10,5,11,38,38,0,35
Cliftonville,1751,5,10,4,12,34,32,2,34
Ballymena,1751,6,8,4,14,29,47,-18,28
Glentoran,1751,7,6,6,10,24,32,-8,24
Dungannon,1751,8,2,4,16,14,47,-33,10
Crusaders,1752,1,17,6,3,65,31,34,57
Coleraine,1752,2,15,10,1,45,22,23,55
Linfield,1752,3,11,5,10,42,36,6,38
Glenavon,1752,4,9,9,8,52,45,7,36
Cliftonville,1752,5,9,4,13,32,36,-4,31
Ballymena,1752,6,7,4,15,26,51,-25,25
Glentoran,1752,7,6,6,10,24,32,-8,24
Dungannon,1752,8,2,4,16,14,47,-33,10
Crusaders,1753,1,16,6,4,62,32,30,54
Coleraine,1753,2,14,10,2,43,25,18,52
Glenavon,1753,3,10,9,7,55,43,12,39
Linfield,1753,4,10,5,11,37,37,0,35
Cliftonville,1753,5,10,4,12,33,31,2,34
Ballymena,1753,6,8,4,14,27,48,-21,28
Glentoran,1753,7,6,6,10,24,32,-8,24
Dungannon,1753,8,2,4,16,14,47,-33,10
Crusaders,1754,1,17,6,3,65,30,35,57
Coleraine,1754,2,14,11,1,43,22,21,53
Glenavon,1754,3,9,10,7,52,43,9,37
Linfield,1754,4,10,6,10,39,38,1,36
Cliftonville,1754,5,9,5,12,34,33,1,32
Ballymena,1754,6,7,4,15,25,51,-26,25
Glentoran,1754,7,6,6,10,24,32,-8,24
Dungannon,1754,8,2,4,16,14,47,-33,10
Coleraine,1755,1,15,10,1,45,22,23,55
Crusaders,1755,2,16,6,4,64,35,29,54
Glenavon,1755,3,9,9,8,52,45,7,36
Linfield,1755,4,10,5,11,37,37,0,35
Cliftonville,1755,5,10,4,12,33,31,2,34
Ballymena,1755,6,8,4,14,30,50,-20,28
Glentoran,1755,7,6,6,10,24,32,-8,24
Dungannon,1755,8,2,4,16,14,47,-33,10
Crusaders,1756,1,17,6,3,62,30,32,57
Coleraine,1756,2,15,10,1,47,23,24,55
Glenavon,1756,3,9,9,8,53,47,6,36
Linfield,1756,4,10,5,11,38,39,-1,35
Cliftonville,1756,5,10,4,12,35,32,3,34
Ballymena,1756,6,7,4,15,25,48,-23,25
Glentoran,1756,7,6,6,10,24,32,-8,24
Dungannon,1756,8,2,4,16,14,47,-33,10
Crusaders,1757,1,17,6,3,63,31,32,57
Coleraine,1757,2,14,10,2,45,27,18,52
Glenavon,1757,3,10,9,7,57,45,12,39
Linfield,1757,4,10,5,11,38,38,0,35
Cliftonville,1757,5,10,4,12,34,32,2,34
Ballymena,1757,6,7,4,15,26,49,-23,25
Glentoran,1757,7,6,6,10,24,32,-8,24
Dungannon,1757,8,2,4,16,14,47,-33,10
Crusaders,1758,1,17,6,3,62,30,32,57
Coleraine,1758,2,14,10,2,44,24,20,52
Glenavon,1758,3,10,9,7,54,44,10,39
Linfield,1758,4,11,5,10,39,37,2,38
Cliftonville,1758,5,9,4,13,33,33,0,31
Ballymena,1758,6,7,4,15,25,48,-23,25
Glentoran,1758,7,6,6,10,24,32,-8,24
Dungannon,1758,8,2,4,16,14,47,-33,10
Crusaders,1759,1,16,6,4,63,35,28,54
Coleraine,1759,2,14,10,2,44,24,20,52
Glenavon,1759,3,10,9,7,54,44,10,39
Linfield,1759,4,11,5,10,38,36,2,38
Cliftonville,1759,5,9,4,13,32,32,0,31
Ballymena,1759,6,8,4,14,30,49,-19,28
Glentoran,1759,7,6,6,10,24,32,-8,24
Dungannon,1759,8,2,4,16,14,47,-33,10
Crusaders,1760,1,17,6,3,64,31,33,57
Coleraine,1760,2,14,11,1,45,24,21,53
Glenavon,1760,3,9,10,7,54,45,9,37
Linfield,1760,4,10,6,10,38,37,1,36
Cliftonville,1760,5,9,5,12,33,32,1,32
Ballymena,1760,6,7,4,15,26,50,-24,25
Glentoran,1760,7,6,6,10,24,32,-8,24
Dungannon,1760,8,2,4,16,14,47,-33,10
Crusaders,1761,1,17,6,3,66,30,36,57
Coleraine,1761,2,14,10,2,43,23,20,52
Glenavon,1761,3,10,9,7,53,43,10,39
Linfield,1761,4,10,5,11,38,39,-1,35
Cliftonville,1761,5,10,4,12,35,32,3,34
Ballymena,1761,6,7,4,15,25,52,-27,25
Glentoran,1761,7,6,6,10,24,32,-8,24
Dungannon,1761,8,2,4,16,14,47,-33,10
Crusaders,1762,1,17,6,3,62,30,32,57
Coleraine,1762,2,15,10,1,45,22,23,55
Linfield,1762,3,11,5,10,39,37,2,38
Glenavon,1762,4,9,9,8,52,45,7,36
Cliftonville,1762,5,9,4,13,33,33,0,31
Ballymena,1762,6,7,4,15,25,48,-23,25
Glentoran,1762,7,6,6,10,24,32,-8,24
Dungannon,1762,8,2,4,16,14,47,-33,10
Crusaders,1763,1,17,6,3,63,30,33,57
Coleraine,1763,2,14,11,1,45,24,21,53
Linfield,1763,3,11,5,10,40,37,3,38
Glenavon,1763,4,9,10,7,54,45,9,37
Cliftonville,1763,5,9,4,13,33,34,-1,31
Ballymena,1763,6,7,4,15,25,49,-24,25
Glentoran,1763,7,6,6,10,24,32,-8,24
Dungannon,1763,8,2,4,16,14,47,-33,10
Crusaders,1764,1,17,6,3,65,32,33,57
Coleraine,1764,2,14,10,2,44,24,20,52
Glenavon,1764,3,10,9,7,54,44,10,39
Linfield,1764,4,11,5,10,43,38,5,38
Cliftonville,1764,5,9,4,13,34,37,-3,31
Ballymena,1764,6,7,4,15,27,51,-24,25
Glentoran,1764,7,6,6,10,24,32,-8,24
Dungannon,1764,8,2,4,16,14,47,-33,10
Crusaders,1765,1,16,6,4,62,32,30,54
Coleraine,1765,2,14,11,1,44,23,21,53
Glenavon,1765,3,9,10,7,53,44,9,37
Linfield,1765,4,10,6,10,38,37,1,36
Cliftonville,1765,5,9,5,12,33,32,1,32
Ballymena,1765,6,8,4,14,27,48,-21,28
Glentoran,1765,7,6,6,10,24,32,-8,24
Dungannon,1765,8,2,4,16,14,47,-33,10
Crusaders,1766,1,17,6,3,63,31,32,57
Coleraine,1766,2,14,10,2,44,26,18,52
Glenavon,1766,3,10,9,7,56,44,12,39
Linfield,1766,4,10,5,11,37,37,0,35
Cliftonville,1766,5,10,4,12,33,31,2,34
Ballymena,1766,6,7,4,15,26,49,-23,25
Glentoran,1766,7,6,6,10,24,32,-8,24
Dungannon,1766,8,2,4,16,14,47,-33,10
Crusaders,1767,1,17,6,3,64,32,32,57
Coleraine,1767,2,14,11,1,43,22,21,53
Glenavon,1767,3,9,10,7,52,43,9,37
Linfield,1767,4,10,6,10,37,36,1,36
Cliftonville,1767,5,9,5,12,32,31,1,32
Ballymena,1767,6,7,4,15,27,50,-23,25
Glentoran,1767,7,6,6,10,24,32,-8,24
Dungannon,1767,8,2,4,16,14,47,-33,10
Crusaders,1768,1,17,6,3,64,32,32,57
Coleraine,1768,2,14,10,2,44,24,20,52
Glenavon,1768,3,10,9,7,54,44,10,39
Linfield,1768,4,10,6,10,40,39,1,36
Cliftonville,1768,5,9,5,12,35,34,1,32
Ballymena,1768,6,7,4,15,27,50,-23,25
Glentoran,1768,7,6,6,10,24,32,-8,24
Dungannon,1768,8,2,4,16,14,47,-33,10
Crusaders,1769,1,17,6,3,64,30,34,57
Coleraine,1769,2,14,10,2,45,26,19,52
Glenavon,1769,3,10,9,7,56,45,11,39
Linfield,1769,4,11,5,10,42,36,6,38
Cliftonville,1769,5,9,4,13,32,36,-4,31
Ballymena,1769,6,7,4,15,25,50,-25,25
Glentoran,1769,7,6,6,10,24,32,-8,24
Dungannon,1769,8,2,4,16,14,47,-33,10
Crusaders,1770,1,17,6,3,67,34,33,57
Coleraine,1770,2,14,10,2,45,27,18,52
Glenavon,1770,3,10,9,7,57,45,12,39
Linfield,1770,4,10,5,11,37,38,-1,35
Cliftonville,1770,5,10,4,12,34,31,3,34
Ballymena,1770,6,7,4,15,29,53,-24,25
Glentoran,1770,7,6,6,10,24,32,-8,24
Dungannon,1770,8,2,4,16,14,47,-33,10
Coleraine,1771,1,15,10,1,44,22,22,55
Crusaders,1771,2,16,6,4,61,31,30,54
Glenavon,1771,3,9,9,8,52,44,8,36
Linfield,1771,4,10,5,11,37,38,-1,35
Cliftonville,1771,5,10,4,12,34,31,3,34
Ballymena,1771,6,8,4,14,26,47,-21,28
Glentoran,1771,7,6,6,10,24,32,-8,24
Dungannon,1771,8,2,4,16,14,47,-33,10
Crusaders,1772,1,16,6,4,62,32,30,54
Coleraine,1772,2,14,10,2,44,25,19,52
Glenavon,1772,3,10,9,7,55,44,11,39
Linfield,1772,4,10,5,11,38,38,0,35
Cliftonville,1772,5,10,4,12,34,32,2,34
Ballymena,1772,6,8,4,14,27,48,-21,28
Glentoran,1772,7,6,6,10,24,32,-8,24
Dungannon,1772,8,2,4,16,14,47,-33,10
Crusaders,1773,1,17,6,3,66,30,36,57
Coleraine,1773,2,15,10,1,46,24,22,55
Glenavon,1773,3,9,9,8,54,46,8,36
Linfield,1773,4,10,6,10,38,37,1,36
Cliftonville,1773,5,9,5,12,33,32,1,32
Ballymena,1773,6,7,4,15,25,52,-27,25
Glentoran,1773,7,6,6,10,24,32,-8,24
Dungannon,1773,8,2,4,16,14,47,-33,10
Crusaders,1774,1,17,6,3,65,31,34,57
Coleraine,1774,2,14,11,1,47,26,21,53
Linfield,1774,3,11,5,10,38,36,2,38
Glenavon,1774,4,9,10,7,56,47,9,37
Cliftonville,1774,5,9,4,13,32,32,0,31
Ballymena,1774,6,7,4,15,26,51,-25,25
Glentoran,1774,7,6,6,10,24,32,-8,24
Dungannon,1774,8,2,4,16,14,47,-33,10
Crusaders,1775,1,17,6,3,63,31,32,57
Coleraine,1775,2,15,10,1,46,23,23,55
Glenavon,1775,3,9,9,8,53,46,7,36
Linfield,1775,4,10,6,10,39,38,1,36
Cliftonville,1775,5,9,5,12,34,33,1,32
Ballymena,1775,6,7,4,15,26,49,-23,25
Glentoran,1775,7,6,6,10,24,32,-8,24
Dungannon,1775,8,2,4,16,14,47,-33,10
Crusaders,1776,1,17,6,3,63,31,32,57
Coleraine,1776,2,14,11,1,44,23,21,53
Linfield,1776,3,11,5,10,39,37,2,38
Glenavon,1776,4,9,10,7,53,44,9,37
Cliftonville,1776,5,9,4,13,33,33,0,31
Ballymena,1776,6,7,4,15,26,49,-23,25
Glentoran,1776,7,6,6,10,24,32,-8,24
Dungannon,1776,8,2,4,16,14,47,-33,10
Crusaders,1777,1,17,6,3,64,31,33,57
Coleraine,1777,2,14,11,1,44,23,21,53
Linfield,1777,3,11,5,10,39,36,3,38
Glenavon,1777,4,9,10,7,53,44,9,37
Cliftonville,1777,5,9,4,13,32,33,-1,31
Ballymena,1777,6,7,4,15,26,50,-24,25
Glentoran,1777,7,6,6,10,24,32,-8,24
Dungannon,1777,8,2,4,16,14,47,-33,10
Crusaders,1778,1,17,6,3,63,30,33,57
Coleraine,1778,2,14,10,2,44,24,20,52
Glenavon,1778,3,10,9,7,54,44,10,39
Linfield,1778,4,10,6,10,38,37,1,36
Cliftonville,1778,5,9,5,12,33,32,1,32
Ballymena,1778,6,7,4,15,25,49,-24,25
Glentoran,1778,7,6,6,10,24,32,-8,24
Dungannon,1778,8,2,4,16,14,47,-33,10
Crusaders,1779,1,16,6,4,62,32,30,54
Coleraine,1779,2,14,11,1,45,24,21,53
Glenavon,1779,3,9,10,7,54,45,9,37
Linfield,1779,4,10,5,11,38,39,-1,35
Cliftonville,1779,5,10,4,12,35,32,3,34
Ballymena,1779,6,8,4,14,27,48,-21,28
Glentoran,1779,7,6,6,10,24,32,-8,24
Dungannon,1779,8,2,4,16,14,47,-33,10
Crusaders,1780,1,17,6,3,67,33,34,57
Coleraine,1780,2,15,10,1,44,22,22,55
Glenavon,1780,3,9,9,8,52,44,8,36
Linfield,1780,4,10,5,11,37,38,-1,35
Cliftonville,1780,5,10,4,12,34,31,3,34
Ballymena,1780,6,7,4,15,28,53,-25,25
Glentoran,1780,7,6,6,10,24,32,-8,24
Dungannon,1780,8,2,4,16,14,47,-33,10
Coleraine,1781,1,15,10,1,46,24,22,55
Crusaders,1781,2,16,6,4,62,33,29,54
Linfield,1781,3,11,5,10,40,37,3,38
Glenavon,1781,4,9,9,8,54,46,8,36
Cliftonville,1781,5,9,4,13,33,34,-1,31
Ballymena,1781,6,8,4,14,28,48,-20,28
Glentoran,1781,7,6,6,10,24,32,-8,24
Dungannon,1781,8,2,4,16,14,47,-33,10
Crusaders,1782,1,17,6,3,64,32,32,57
Coleraine,1782,2,14,10,2,45,25,20,52
Glenavon,1782,3,10,9,7,55,45,10,39
Linfield,1782,4,11,5,10,40,37,3,38
Cliftonville,1782,5,9,4,13,33,34,-1,31
Ballymena,1782,6,7,4,15,27,50,-23,25
Glentoran,1782,7,6,6,10,24,32,-8,24
Dungannon,1782,8,2,4,16,14,47,-33,10
Crusaders,1783,1,17,6,3,63,30,33,57
Coleraine,1783,2,14,10,2,43,24,19,52
Glenavon,1783,3,10,9,7,54,43,11,39
Linfield,1783,4,11,5,10,40,36,4,38
Cliftonville,1783,5,9,4,13,32,34,-2,31
Ballymena,1783,6,7,4,15,25,49,-24,25
Glentoran,1783,7,6,6,10,24,32,-8,24
Dungannon,1783,8,2,4,16,14,47,-33,10
Crusaders,1784,1,16,7,3,61,30,31,55
Coleraine,1784,2,14,11,1,44,23,21,53
Linfield,1784,3,11,5,10,42,36,6,38
Glenavon,1784,4,9,10,7,53,44,9,37
Cliftonville,1784,5,9,4,13,32,36,-4,31
Ballymena,1784,6,7,5,14,25,47,-22,26
Glentoran,1784,7,6,6,10,24,32,-8,24
Dungannon,1784,8,2,4,16,14,47,-33,10
Coleraine,1785,1,15,10,1,44,22,22,55
Crusaders,1785,2,16,6,4,61,32,29,54
Linfield,1785,3,11,5,10,38,36,2,38
Glenavon,1785,4,9,9,8,52,44,8,36
Cliftonville,1785,5,9,4,13,32,32,0,31
Ballymena,1785,6,8,4,14,27,47,-20,28
Glentoran,1785,7,6,6,10,24,32,-8,24
Dungannon,1785,8,2,4,16,14,47,-33,10
Crusaders,1786,1,16,7,3,62,31,31,55
Coleraine,1786,2,15,10,1,46,23,23,55
Linfield,1786,3,11,5,10,39,36,3,38
Glenavon,1786,4,9,9,8,53,46,7,36
Cliftonville,1786,5,9,4,13,32,33,-1,31
Ballymena,1786,6,7,5,14,26,48,-22,26
Glentoran,1786,7,6,6,10,24,32,-8,24
Dungannon,1786,8,2,4,16,14,47,-33,10
Crusaders,1787,1,17,6,3,64,32,32,57
Coleraine,1787,2,15,10,1,44,22,22,55
Glenavon,1787,3,9,9,8,52,44,8,36
Linfield,1787,4,10,5,11,37,37,0,35
Cliftonville,1787,5,10,4,12,33,31,2,34
Ballymena,1787,6,7,4,15,27,50,-23,25
Glentoran,1787,7,6,6,10,24,32,-8,24
Dungannon,1787,8,2,4,16,14,47,-33,10
Crusaders,1788,1,17,6,3,64,31,33,57
Coleraine,1788,2,15,10,1,44,22,22,55
Glenavon,1788,3,9,9,8,52,44,8,36
Linfield,1788,4,10,6,10,37,36,1,36
Cliftonville,1788,5,9,5,12,32,31,1,32
Ballymena,1788,6,7,4,15,26,50,-24,25
Glentoran,1788,7,6,6,10,24,32,-8,24
Dungannon,1788,8,2,4,16,14,47,-33,10
Crusaders,1789,1,17,6,3,63,31,32,57
Coleraine,1789,2,14,10,2,43,23,20,52
Glenavon,1789,3,10,9,7,53,43,10,39
Linfield,1789,4,10,5,11,37,38,-1,35
Cliftonville,1789,5,10,4,12,34,31,3,34
Ballymena,1789,6,7,4,15,26,49,-23,25
Glentoran,1789,7,6,6,10,24,32,-8,24
Dungannon,1789,8,2,4,16,14,47,-33,10
Crusaders,1790,1,17,6,3,62,30,32,57
Coleraine,1790,2,15,10,1,48,26,22,55
Linfield,1790,3,11,5,10,39,37,2,38
Glenavon,1790,4,9,9,8,56,48,8,36
Cliftonville,1790,5,9,4,13,33,33,0,31
Ballymena,1790,6,7,4,15,25,48,-23,25
Glentoran,1790,7,6,6,10,24,32,-8,24
Dungannon,1790,8,2,4,16,14,47,-33,10
Crusaders,1791,1,17,6,3,64,31,33,57
Coleraine,1791,2,14,10,2,44,24,20,52
Glenavon,1791,3,10,9,7,54,44,10,39
Linfield,1791,4,10,6,10,37,36,1,36
Cliftonville,1791,5,9,5,12,32,31,1,32
Ballymena,1791,6,7,4,15,26,50,-24,25
Glentoran,1791,7,6,6,10,24,32,-8,24
Dungannon,1791,8,2,4,16,14,47,-33,10
Coleraine,1792,1,15,10,1,45,23,22,55
Crusaders,1792,2,16,6,4,63,34,29,54
Linfield,1792,3,11,5,10,39,36,3,38
Glenavon,1792,4,9,9,8,53,45,8,36
Cliftonville,1792,5,9,4,13,32,33,-1,31
Ballymena,1792,6,8,4,14,29,49,-20,28
Glentoran,1792,7,6,6,10,24,32,-8,24
Dungannon,1792,8,2,4,16,14,47,-33,10
Crusaders,1793,1,17,6,3,65,32,33,57
Coleraine,1793,2,15,10,1,47,22,25,55
Linfield,1793,3,11,5,10,39,37,2,38
Glenavon,1793,4,9,9,8,52,47,5,36
Cliftonville,1793,5,9,4,13,33,33,0,31
Ballymena,1793,6,7,4,15,27,51,-24,25
Glentoran,1793,7,6,6,10,24,32,-8,24
Dungannon,1793,8,2,4,16,14,47,-33,10
Crusaders,1794,1,17,6,3,64,32,32,57
Coleraine,1794,2,14,10,2,44,26,18,52
Glenavon,1794,3,10,9,7,56,44,12,39
Linfield,1794,4,11,5,10,39,36,3,38
Cliftonville,1794,5,9,4,13,32,33,-1,31
Ballymena,1794,6,7,4,15,27,50,-23,25
Glentoran,1794,7,6,6,10,24,32,-8,24
Dungannon,1794,8,2,4,16,14,47,-33,10
Crusaders,1795,1,17,6,3,62,30,32,57
Coleraine,1795,2,15,10,1,45,23,22,55
Glenavon,1795,3,9,9,8,53,45,8,36
Linfield,1795,4,10,5,11,37,37,0,35
Cliftonville,1795,5,10,4,12,33,31,2,34
Ballymena,1795,6,7,4,15,25,48,-23,25
Glentoran,1795,7,6,6,10,24,32,-8,24
Dungannon,1795,8,2,4,16,14,47,-33,10
Crusaders,1796,1,16,7,3,62,31,31,55
Coleraine,1796,2,14,10,2,44,24,20,52
Glenavon,1796,3,10,9,7,54,44,10,39
Linfield,1796,4,10,5,11,37,37,0,35
Cliftonville,1796,5,10,4,12,33,31,2,34
Ballymena,1796,6,7,5,14,26,48,-22,26
Glentoran,1796,7,6,6,10,24,32,-8,24
Dungannon,1796,8,2,4,16,14,47,-33,10
Crusaders,1797,1,17,6,3,63,30,33,57
Coleraine,1797,2,14,10,2,44,24,20,52
Glenavon,1797,3,10,9,7,54,44,10,39
Linfield,1797,4,11,5,10,39,37,2,38
Cliftonville,1797,5,9,4,13,33,33,0,31
Ballymena,1797,6,7,4,15,25,49,-24,25
Glentoran,1797,7,6,6,10,24,32,-8,24
Dungannon,1797,8,2,4,16,14,47,-33,10
Crusaders,1798,1,17,6,3,66,32,34,57
Coleraine,1798,2,14,10,2,43,23,20,52
Glenavon,1798,3,10,9,7,53,43,10,39
Linfield,1798,4,10,5,11,37,38,-1,35
Cliftonville,1798,5,10,4,12,34,31,3,34
Ballymena,1798,6,7,4,15,27,52,-25,25
Glentoran,1798,7,6,6,10,24,32,-8,24
Dungannon,1798,8,2,4,16,14,47,-33,10
Crusaders,1799,1,17,6,3,63,30,33,57
Coleraine,1799,2,15,10,1,45,22,23,55
Glenavon,1799,3,9,9,8,52,45,7,36
Linfield,1799,4,10,6,10,38,37,1,36
Cliftonville,1799,5,9,5,12,33,32,1,32
Ballymena,1799,6,7,4,15,25,49,-24,25
Glentoran,1799,7,6,6,10,24,32,-8,24
Dungannon,1799,8,2,4,16,14,47,-33,10
Crusaders,1800,1,17,6,3,63,31,32,57
Coleraine,1800,2,15,10,1,45,23,22,55
Glenavon,1800,3,9,9,8,53,45,8,36
Linfield,1800,4,10,6,10,38,37,1,36
Cliftonville,1800,5,9,5,12,33,32,1,32
Ballymena,1800,6,7,4,15,26,49,-23,25
Glentoran,1800,7,6,6,10,24,32,-8,24
Dungannon,1800,8,2,4,16,14,47,-33,10
Crusaders,1801,1,16,7,3,61,30,31,55
Coleraine,1801,2,15,10,1,46,22,24,55
Glenavon,1801,3,9,9,8,52,46,6,36
Linfield,1801,4,10,5,11,38,39,-1,35
Cliftonville,1801,5,10,4,12,35,32,3,34
Ballymena,1801,6,7,5,14,25,47,-22,26
Glentoran,1801,7,6,6,10,24,32,-8,24
Dungannon,1801,8,2,4,16,14,47,-33,10
Crusaders,1802,1,17,6,3,62,30,32,57
Coleraine,1802,2,15,10,1,45,23,22,55
Glenavon,1802,3,9,9,8,53,45,8,36
Linfield,1802,4,10,6,10,37,36,1,36
Cliftonville,1802,5,9,5,12,32,31,1,32
Ballymena,1802,6,7,4,15,25,48,-23,25
Glentoran,1802,7,6,6,10,24,32,-8,24
Dungannon,1802,8,2,4,16,14,47,-33,10
Crusaders,1803,1,17,6,3,63,31,32,57
Coleraine,1803,2,14,10,2,44,24,20,52
Glenavon,1803,3,10,9,7,54,44,10,39
Linfield,1803,4,10,5,11,37,38,-1,35
Cliftonville,1803,5,10,4,12,34,31,3,34
Ballymena,1803,6,7,4,15,26,49,-23,25
Glentoran,1803,7,6,6,10,24,32,-8,24
Dungannon,1803,8,2,4,16,14,47,-33,10
Coleraine,1804,1,15,10,1,45,23,22,55
Crusaders,1804,2,16,6,4,61,32,29,54
Linfield,1804,3,11,5,10,40,36,4,38
Glenavon,1804,4,9,9,8,53,45,8,36
Cliftonville,1804,5,9,4,13,32,34,-2,31
Ballymena,1804,6,8,4,14,27,47,-20,28
Glentoran,1804,7,6,6,10,24,32,-8,24
Dungannon,1804,8,2,4,16,14,47,-33,10
Crusaders,1805,1,17,6,3,64,30,34,57
Coleraine,1805,2,14,10,2,43,24,19,52
Glenavon,1805,3,10,9,7,54,43,11,39
Linfield,1805,4,10,5,11,37,37,0,35
Cliftonville,1805,5,10,4,12,33,31,2,34
Ballymena,1805,6,7,4,15,25,50,-25,25
Glentoran,1805,7,6,6,10,24,32,-8,24
Dungannon,1805,8,2,4,16,14,47,-33,10
Crusaders,1806,1,16,7,3,62,31,31,55
Coleraine,1806,2,15,10,1,46,23,23,55
Linfield,1806,3,11,5,10,39,36,3,38
Glenavon,1806,4,9,9,8,53,46,7,36
Cliftonville,1806,5,9,4,13,32,33,-1,31
Ballymena,1806,6,7,5,14,26,48,-22,26
Glentoran,1806,7,6,6,10,24,32,-8,24
Dungannon,1806,8,2,4,16,14,47,-33,10
Crusaders,1807,1,16,7,3,63,32,31,55
Coleraine,1807,2,14,10,2,43,23,20,52
Glenavon,1807,3,10,9,7,53,43,10,39
Linfield,1807,4,10,5,11,37,38,-1,35
Cliftonville,1807,5,10,4,12,34,31,3,34
Ballymena,1807,6,7,5,14,27,49,-22,26
Glentoran,1807,7,6,6,10,24,32,-8,24
Dungannon,1807,8,2,4,16,14,47,-33,10
Crusaders,1808,1,16,6,4,61,32,29,54
Coleraine,1808,2,14,11,1,44,23,21,53
Glenavon,1808,3,9,10,7,53,44,9,37
Linfield,1808,4,10,5,11,37,37,0,35
Cliftonville,1808,5,10,4,12,33,31,2,34
Ballymena,1808,6,8,4,14,27,47,-20,28
Glentoran,1808,7,6,6,10,24,32,-8,24
Dungannon,1808,8,2,4,16,14,47,-33,10
Crusaders,1809,1,17,6,3,63,31,32,57
Coleraine,1809,2,15,10,1,44,22,22,55
Linfield,1809,3,11,5,10,39,37,2,38
Glenavon,1809,4,9,9,8,52,44,8,36
Cliftonville,1809,5,9,4,13,33,33,0,31
Ballymena,1809,6,7,4,15,26,49,-23,25
Glentoran,1809,7,6,6,10,24,32,-8,24
Dungannon,1809,8,2,4,16,14,47,-33,10
Crusaders,1810,1,17,6,3,65,32,33,57
Coleraine,1810,2,14,10,2,44,26,18,52
Glenavon,1810,3,10,9,7,56,44,12,39
Linfield,1810,4,10,6,10,39,38,1,36
Cliftonville,1810,5,9,5,12,34,33,1,32
Ballymena,1810,6,7,4,15,27,51,-24,25
Glentoran,1810,7,6,6,10,24,32,-8,24
Dungannon,1810,8,2,4,16,14,47,-33,10
Crusaders,1811,1,16,6,4,63,34,29,54
Coleraine,1811,2,14,10,2,43,23,20,52
Glenavon,1811,3,10,9,7,53,43,10,39
Linfield,1811,4,10,5,11,37,38,-1,35
Cliftonville,1811,5,10,4,12,34,31,3,34
Ballymena,1811,6,8,4,14,29,49,-20,28
Glentoran,1811,7,6,6,10,24,32,-8,24
Dungannon,1811,8,2,4,16,14,47,-33,10
Crusaders,1812,1,16,7,3,63,32,31,55
Coleraine,1812,2,15,10,1,45,23,22,55
Glenavon,1812,3,9,9,8,53,45,8,36
Linfield,1812,4,10,6,10,39,38,1,36
Cliftonville,1812,5,9,5,12,34,33,1,32
Ballymena,1812,6,7,5,14,27,49,-22,26
Glentoran,1812,7,6,6,10,24,32,-8,24
Dungannon,1812,8,2,4,16,14,47,-33,10
Crusaders,1813,1,17,6,3,63,31,32,57
Coleraine,1813,2,14,10,2,43,24,19,52
Glenavon,1813,3,10,9,7,54,43,11,39
Linfield,1813,4,11,5,10,39,37,2,38
Cliftonville,1813,5,9,4,13,33,33,0,31
Ballymena,1813,6,7,4,15,26,49,-23,25
Glentoran,1813,7,6,6,10,24,32,-8,24
Dungannon,1813,8,2,4,16,14,47,-33,10
Crusaders,1814,1,16,6,4,62,32,30,54
Coleraine,1814,2,14,10,2,44,24,20,52
Glenavon,1814,3,10,9,7,54,44,10,39
Linfield,1814,4,10,6,10,38,37,1,36
Cliftonville,1814,5,9,5,12,33,32,1,32
Ballymena,1814,6,8,4,14,27,48,-21,28
Glentoran,1814,7,6,6,10,24,32,-8,24
Dungannon,1814,8,2,4,16,14,47,-33,10
Crusaders,1815,1,17,6,3,64,31,33,57
Coleraine,1815,2,14,11,1,43,22,21,53
Glenavon,1815,3,9,10,7,52,43,9,37
Linfield,1815,4,10,6,10,38,37,1,36
Cliftonville,1815,5,9,5,12,33,32,1,32
Ballymena,1815,6,7,4,15,26,50,-24,25
Glentoran,1815,7,6,6,10,24,32,-8,24
Dungannon,1815,8,2,4,16,14,47,-33,10
Crusaders,1816,1,16,7,3,62,31,31,55
Coleraine,1816,2,14,10,2,43,25,18,52
Glenavon,1816,3,10,9,7,55,43,12,39
Linfield,1816,4,10,5,11,38,38,0,35
Cliftonville,1816,5,10,4,12,34,32,2,34
Ballymena,1816,6,7,5,14,26,48,-22,26
Glentoran,1816,7,6,6,10,24,32,-8,24
Dungannon,1816,8,2,4,16,14,47,-33,10
Crusaders,1817,1,17,6,3,63,31,32,57
Coleraine,1817,2,14,10,2,45,27,18,52
Glenavon,1817,3,10,9,7,57,45,12,39
Linfield,1817,4,10,6,10,39,38,1,36
Cliftonville,1817,5,9,5,12,34,33,1,32
Ballymena,1817,6,7,4,15,26,49,-23,25
Glentoran,1817,7,6,6,10,24,32,-8,24
Dungannon,1817,8,2,4,16,14,47,-33,10
Crusaders,1818,1,16,7,3,61,30,31,55
Coleraine,1818,2,14,10,2,43,24,19,52
Glenavon,1818,3,10,9,7,54,43,11,39
Linfield,1818,4,10,6,10,37,36,1,36
Cliftonville,1818,5,9,5,12,32,31,1,32
Ballymena,1818,6,7,5,14,25,47,-22,26
Glentoran,1818,7,6,6,10,24,32,-8,24
Dungannon,1818,8,2,4,16,14,47,-33,10
Crusaders,1819,1,16,7,3,63,32,31,55
Coleraine,1819,2,14,10,2,44,25,19,52
Glenavon,1819,3,10,9,7,55,44,11,39
Linfield,1819,4,10,6,10,37,36,1,36
Cliftonville,1819,5,9,5,12,32,31,1,32
Ballymena,1819,6,7,5,14,27,49,-22,26
Glentoran,1819,7,6,6,10,24,32,-8,24
Dungannon,1819,8,2,4,16,14,47,-33,10
Crusaders,1820,1,17,6,3,65,32,33,57
Coleraine,1820,2,15,10,1,45,23,22,55
Linfield,1820,3,11,5,10,41,38,3,38
Glenavon,1820,4,9,9,8,53,45,8,36
Cliftonville,1820,5,9,4,13,34,35,-1,31
Ballymena,1820,6,7,4,15,27,51,-24,25
Glentoran,1820,7,6,6,10,24,32,-8,24
Dungannon,1820,8,2,4,16,14,47,-33,10
Crusaders,1821,1,16,6,4,61,31,30,54
Coleraine,1821,2,14,10,2,43,24,19,52
Glenavon,1821,3,10,9,7,54,43,11,39
Linfield,1821,4,10,5,11,38,40,-2,35
Cliftonville,1821,5,10,4,12,36,32,4,34
Ballymena,1821,6,8,4,14,26,47,-21,28
Glentoran,1821,7,6,6,10,24,32,-8,24
Dungannon,1821,8,2,4,16,14,47,-33,10
Crusaders,1822,1,17,6,3,64,32,32,57
Coleraine,1822,2,14,10,2,44,24,20,52
Glenavon,1822,3,10,9,7,54,44,10,39
Linfield,1822,4,10,5,11,37,39,-2,35
Cliftonville,1822,5,10,4,12,35,31,4,34
Ballymena,1822,6,7,4,15,27,50,-23,25
Glentoran,1822,7,6,6,10,24,32,-8,24
Dungannon,1822,8,2,4,16,14,47,-33,10
Crusaders,1823,1,17,6,3,63,30,33,57
Coleraine,1823,2,15,10,1,44,22,22,55
Glenavon,1823,3,9,9,8,52,44,8,36
Linfield,1823,4,10,6,10,37,36,1,36
Cliftonville,1823,5,9,5,12,32,31,1,32
Ballymena,1823,6,7,4,15,25,49,-24,25
Glentoran,1823,7,6,6,10,24,32,-8,24
Dungannon,1823,8,2,4,16,14,47,-33,10
Crusaders,1824,1,17,6,3,62,30,32,57
Coleraine,1824,2,15,10,1,45,22,23,55
Glenavon,1824,3,9,9,8,52,45,7,36
Linfield,1824,4,10,6,10,38,37,1,36
Cliftonville,1824,5,9,5,12,33,32,1,32
Ballymena,1824,6,7,4,15,25,48,-23,25
Glentoran,1824,7,6,6,10,24,32,-8,24
Dungannon,1824,8,2,4,16,14,47,-33,10
Crusaders,1825,1,17,6,3,64,32,32,57
Coleraine,1825,2,14,10,2,43,23,20,52
Glenavon,1825,3,10,9,7,53,43,10,39
Linfield,1825,4,10,5,11,37,37,0,35
Cliftonville,1825,5,10,4,12,33,31,2,34
Ballymena,1825,6,7,4,15,27,50,-23,25
Glentoran,1825,7,6,6,10,24,32,-8,24
Dungannon,1825,8,2,4,16,14,47,-33,10
Crusaders,1826,1,16,7,3,61,30,31,55
Coleraine,1826,2,15,10,1,45,23,22,55
Glenavon,1826,3,9,9,8,53,45,8,36
Linfield,1826,4,10,5,11,38,38,0,35
Cliftonville,1826,5,10,4,12,34,32,2,34
Ballymena,1826,6,7,5,14,25,47,-22,26
Glentoran,1826,7,6,6,10,24,32,-8,24
Dungannon,1826,8,2,4,16,14,47,-33,10
Crusaders,1827,1,17,6,3,65,30,35,57
Coleraine,1827,2,15,10,1,45,23,22,55
Glenavon,1827,3,9,9,8,53,45,8,36
Linfield,1827,4,10,5,11,38,39,-1,35
Cliftonville,1827,5,10,4,12,35,32,3,34
Ballymena,1827,6,7,4,15,25,51,-26,25
Glentoran,1827,7,6,6,10,24,32,-8,24
Dungannon,1827,8,2,4,16,14,47,-33,10
Coleraine,1828,1,15,10,1,45,23,22,55
Crusaders,1828,2,16,6,4,63,33,30,54
Linfield,1828,3,11,5,10,39,37,2,38
Glenavon,1828,4,9,9,8,53,45,8,36
Cliftonville,1828,5,9,4,13,33,33,0,31
Ballymena,1828,6,8,4,14,28,49,-21,28
Glentoran,1828,7,6,6,10,24,32,-8,24
Dungannon,1828,8,2,4,16,14,47,-33,10
Crusaders,1829,1,17,6,3,66,30,36,57
Coleraine,1829,2,14,10,2,43,24,19,52
Glenavon,1829,3,10,9,7,54,43,11,39
Linfield,1829,4,10,6,10,38,37,1,36
Cliftonville,1829,5,9,5,12,33,32,1,32
Ballymena,1829,6,7,4,15,25,52,-27,25
Glentoran,1829,7,6,6,10,24,32,-8,24
Dungannon,1829,8,2,4,16,14,47,-33,10
Crusaders,1830,1,17,6,3,65,31,34,57
Coleraine,1830,2,14,11,1,45,24,21,53
Linfield,1830,3,11,5,10,41,36,5,38
Glenavon,1830,4,9,10,7,54,45,9,37
Cliftonville,1830,5,9,4,13,32,35,-3,31
Ballymena,1830,6,7,4,15,26,51,-25,25
Glentoran,1830,7,6,6,10,24,32,-8,24
Dungannon,1830,8,2,4,16,14,47,-33,10
Crusaders,1831,1,16,6,4,61,32,29,54
Coleraine,1831,2,14,11,1,46,25,21,53
Glenavon,1831,3,9,10,7,55,46,9,37
Linfield,1831,4,10,6,10,38,37,1,36
Cliftonville,1831,5,9,5,12,33,32,1,32
Ballymena,1831,6,8,4,14,27,47,-20,28
Glentoran,1831,7,6,6,10,24,32,-8,24
Dungannon,1831,8,2,4,16,14,47,-33,10
Crusaders,1832,1,17,6,3,64,30,34,57
Coleraine,1832,2,15,10,1,46,22,24,55
Glenavon,1832,3,9,9,8,52,46,6,36
Linfield,1832,4,10,5,11,38,38,0,35
Cliftonville,1832,5,10,4,12,34,32,2,34
Ballymena,1832,6,7,4,15,25,50,-25,25
Glentoran,1832,7,6,6,10,24,32,-8,24
Dungannon,1832,8,2,4,16,14,47,-33,10
Crusaders,1833,1,17,6,3,62,30,32,57
Coleraine,1833,2,14,11,1,44,23,21,53
Glenavon,1833,3,9,10,7,53,44,9,37
Linfield,1833,4,10,6,10,37,36,1,36
Cliftonville,1833,5,9,5,12,32,31,1,32
Ballymena,1833,6,7,4,15,25,48,-23,25
Glentoran,1833,7,6,6,10,24,32,-8,24
Dungannon,1833,8,2,4,16,14,47,-33,10
Crusaders,1834,1,17,6,3,62,30,32,57
Coleraine,1834,2,14,11,1,44,23,21,53
Glenavon,1834,3,9,10,7,53,44,9,37
Linfield,1834,4,10,6,10,38,37,1,36
Cliftonville,1834,5,9,5,12,33,32,1,32
Ballymena,1834,6,7,4,15,25,48,-23,25
Glentoran,1834,7,6,6,10,24,32,-8,24
Dungannon,1834,8,2,4,16,14,47,-33,10
Crusaders,1835,1,16,7,3,64,33,31,55
Coleraine,1835,2,14,10,2,44,24,20,52
Glenavon,1835,3,10,9,7,54,44,10,39
Linfield,1835,4,10,6,10,38,37,1,36
Cliftonville,1835,5,9,5,12,33,32,1,32
Ballymena,1835,6,7,5,14,28,50,-22,26
Glentoran,1835,7,6,6,10,24,32,-8,24
Dungannon,1835,8,2,4,16,14,47,-33,10
Crusaders,1836,1,16,6,4,62,32,30,54
Coleraine,1836,2,14,10,2,44,26,18,52
Glenavon,1836,3,10,9,7,56,44,12,39
Linfield,1836,4,11,5,10,38,36,2,38
Cliftonville,1836,5,9,4,13,32,32,0,31
Ballymena,1836,6,8,4,14,27,48,-21,28
Glentoran,1836,7,6,6,10,24,32,-8,24
Dungannon,1836,8,2,4,16,14,47,-33,10
Crusaders,1837,1,16,7,3,63,32,31,55
Coleraine,1837,2,14,10,2,44,25,19,52
Glenavon,1837,3,10,9,7,55,44,11,39
Linfield,1837,4,11,5,10,39,37,2,38
Cliftonville,1837,5,9,4,13,33,33,0,31
Ballymena,1837,6,7,5,14,27,49,-22,26
Glentoran,1837,7,6,6,10,24,32,-8,24
Dungannon,1837,8,2,4,16,14,47,-33,10
Coleraine,1838,1,15,10,1,47,24,23,55
Crusaders,1838,2,16,6,4,64,34,30,54
Linfield,1838,3,11,5,10,40,37,3,38
Glenavon,1838,4,9,9,8,54,47,7,36
Cliftonville,1838,5,9,4,13,33,34,-1,31
Ballymena,1838,6,8,4,14,29,50,-21,28
Glentoran,1838,7,6,6,10,24,32,-8,24
Dungannon,1838,8,2,4,16,14,47,-33,10
Crusaders,1839,1,17,6,3,62,30,32,57
Coleraine,1839,2,14,10,2,44,25,19,52
Glenavon,1839,3,10,9,7,55,44,11,39
Linfield,1839,4,10,5,11,38,38,0,35
Cliftonville,1839,5,10,4,12,34,32,2,34
Ballymena,1839,6,7,4,15,25,48,-23,25
Glentoran,1839,7,6,6,10,24,32,-8,24
Dungannon,1839,8,2,4,16,14,47,-33,10
Crusaders,1840,1,16,7,3,62,31,31,55
Coleraine,1840,2,15,10,1,47,24,23,55
Linfield,1840,3,11,5,10,39,37,2,38
Glenavon,1840,4,9,9,8,54,47,7,36
Cliftonville,1840,5,9,4,13,33,33,0,31
Ballymena,1840,6,7,5,14,26,48,-22,26
Glentoran,1840,7,6,6,10,24,32,-8,24
Dungannon,1840,8,2,4,16,14,47,-33,10
Crusaders,1841,1,17,6,3,62,30,32,57
Coleraine,1841,2,14,11,1,43,22,21,53
Linfield,1841,3,11,5,10,38,36,2,38
Glenavon,1841,4,9,10,7,52,43,9,37
Cliftonville,1841,5,9,4,13,32,32,0,31
Ballymena,1841,6,7,4,15,25,48,-23,25
Glentoran,1841,7,6,6,10,24,32,-8,24
Dungannon,1841,8,2,4,16,14,47,-33,10
Crusaders,1842,1,17,6,3,62,30,32,57
Coleraine,1842,2,14,11,1,46,25,21,53
Glenavon,1842,3,9,10,7,55,46,9,37
Linfield,1842,4,10,5,11,37,37,0,35
Cliftonville,1842,5,10,4,12,33,31,2,34
Ballymena,1842,6,7,4,15,25,48,-23,25
Glentoran,1842,7,6,6,10,24,32,-8,24
Dungannon,1842,8,2,4,16,14,47,-33,10
Crusaders,1843,1,17,6,3,62,30,32,57
Coleraine,1843,2,14,10,2,44,26,18,52
Glenavon,1843,3,10,9,7,56,44,12,39
Linfield,1843,4,10,6,10,38,37,1,36
Cliftonville,1843,5,9,5,12,33,32,1,32
Ballymena,1843,6,7,4,15,25,48,-23,25
Glentoran,1843,7,6,6,10,24,32,-8,24
Dungannon,1843,8,2,4,16,14,47,-33,10
Crusaders,1844,1,17,6,3,64,31,33,57
Coleraine,1844,2,14,10,2,43,25,18,52
Glenavon,1844,3,10,9,7,55,43,12,39
Linfield,1844,4,10,6,10,38,37,1,36
Cliftonville,1844,5,9,5,12,33,32,1,32
Ballymena,1844,6,7,4,15,26,50,-24,25
Glentoran,1844,7,6,6,10,24,32,-8,24
Dungannon,1844,8,2,4,16,14,47,-33,10
Crusaders,1845,1,16,7,3,62,31,31,55
Coleraine,1845,2,14,10,2,43,25,18,52
Glenavon,1845,3,10,9,7,55,43,12,39
Linfield,1845,4,11,5,10,40,38,2,38
Cliftonville,1845,5,9,4,13,34,34,0,31
Ballymena,1845,6,7,5,14,26,48,-22,26
Glentoran,1845,7,6,6,10,24,32,-8,24
Dungannon,1845,8,2,4,16,14,47,-33,10
Crusaders,1846,1,16,7,3,65,34,31,55
Coleraine,1846,2,15,10,1,46,24,22,55
Glenavon,1846,3,9,9,8,54,46,8,36
Linfield,1846,4,10,5,11,38,38,0,35
Cliftonville,1846,5,10,4,12,34,32,2,34
Ballymena,1846,6,7,5,14,29,51,-22,26
Glentoran,1846,7,6,6,10,24,32,-8,24
Dungannon,1846,8,2,4,16,14,47,-33,10
Crusaders,1847,1,16,7,3,63,32,31,55
Coleraine,1847,2,15,10,1,44,22,22,55
Glenavon,1847,3,9,9,8,52,44,8,36
Linfield,1847,4,10,5,11,37,37,0,35
Cliftonville,1847,5,10,4,12,33,31,2,34
Ballymena,1847,6,7,5,14,27,49,-22,26
Glentoran,1847,7,6,6,10,24,32,-8,24
Dungannon,1847,8,2,4,16,14,47,-33,10
Crusaders,1848,1,17,6,3,63,31,32,57
Coleraine,1848,2,14,10,2,43,24,19,52
Glenavon,1848,3,10,9,7,54,43,11,39
Linfield,1848,4,11,5,10,38,36,2,38
Cliftonville,1848,5,9,4,13,32,32,0,31
Ballymena,1848,6,7,4,15,26,49,-23,25
Glentoran,1848,7,6,6,10,24,32,-8,24
Dungannon,1848,8,2,4,16,14,47,-33,10
Crusaders,1849,1,16,7,3,63,32,31,55
Coleraine,1849,2,14,10,2,44,25,19,52
Glenavon,1849,3,10,9,7,55,44,11,39
Linfield,1849,4,10,6,10,40,39,1,36
Cliftonville,1849,5,9,5,12,35,34,1,32
Ballymena,1849,6,7,5,14,27,49,-22,26
Glentoran,1849,7,6,6,10,24,32,-8,24
Dungannon,1849,8,2,4,16,14,47,-33,10
Crusaders,1850,1,16,7,3,63,32,31,55
Coleraine,1850,2,14,10,2,44,27,17,52
Glenavon,1850,3,10,9,7,57,44,13,39
Linfield,1850,4,10,6,10,38,37,1,36
Cliftonville,1850,5,9,5,12,33,32,1,32
Ballymena,1850,6,7,5,14,27,49,-22,26
Glentoran,1850,7,6,6,10,24,32,-8,24
Dungannon,1850,8,2,4,16,14,47,-33,10
Coleraine,1851,1,15,10,1,45,23,22,55
Crusaders,1851,2,16,6,4,61,33,28,54
Glenavon,1851,3,9,9,8,53,45,8,36
Linfield,1851,4,10,6,10,38,37,1,36
Cliftonville,1851,5,9,5,12,33,32,1,32
Ballymena,1851,6,8,4,14,28,47,-19,28
Glentoran,1851,7,6,6,10,24,32,-8,24
Dungannon,1851,8,2,4,16,14,47,-33,10
Crusaders,1852,1,17,6,3,62,30,32,57
Coleraine,1852,2,15,10,1,45,23,22,55
Glenavon,1852,3,9,9,8,53,45,8,36
Linfield,1852,4,10,6,10,37,36,1,36
Cliftonville,1852,5,9,5,12,32,31,1,32
Ballymena,1852,6,7,4,15,25,48,-23,25
Glentoran,1852,7,6,6,10,24,32,-8,24
Dungannon,1852,8,2,4,16,14,47,-33,10
Crusaders,1853,1,17,6,3,62,30,32,57
Coleraine,1853,2,14,10,2,43,24,19,52
Glenavon,1853,3,10,9,7,54,43,11,39
Linfield,1853,4,11,5,10,42,37,5,38
Cliftonville,1853,5,9,4,13,33,36,-3,31
Ballymena,1853,6,7,4,15,25,48,-23,25
Glentoran,1853,7,6,6,10,24,32,-8,24
Dungannon,1853,8,2,4,16,14,47,-33,10
Crusaders,1854,1,16,6,4,62,36,26,54
Coleraine,1854,2,14,10,2,44,24,20,52
Glenavon,1854,3,10,9,7,54,44,10,39
Linfield,1854,4,11,5,10,41,38,3,38
Cliftonville,1854,5,9,4,13,34,35,-1,31
Ballymena,1854,6,8,4,14,31,48,-17,28
Glentoran,1854,7,6,6,10,24,32,-8,24
Dungannon,1854,8,2,4,16,14,47,-33,10
Crusaders,1855,1,17,6,3,66,31,35,57
Coleraine,1855,2,14,10,2,45,25,20,52
Glenavon,1855,3,10,9,7,55,45,10,39
Linfield,1855,4,10,5,11,37,37,0,35
Cliftonville,1855,5,10,4,12,33,31,2,34
Ballymena,1855,6,7,4,15,26,52,-26,25
Glentoran,1855,7,6,6,10,24,32,-8,24
Dungannon,1855,8,2,4,16,14,47,-33,10
Crusaders,1856,1,17,6,3,63,31,32,57
Coleraine,1856,2,15,10,1,45,22,23,55
Glenavon,1856,3,9,9,8,52,45,7,36
Linfield,1856,4,10,6,10,37,36,1,36
Cliftonville,1856,5,9,5,12,32,31,1,32
Ballymena,1856,6,7,4,15,26,49,-23,25
Glentoran,1856,7,6,6,10,24,32,-8,24
Dungannon,1856,8,2,4,16,14,47,-33,10
Coleraine,1857,1,15,10,1,46,24,22,55
Crusaders,1857,2,16,6,4,62,32,30,54
Linfield,1857,3,11,5,10,40,36,4,38
Glenavon,1857,4,9,9,8,54,46,8,36
Cliftonville,1857,5,9,4,13,32,34,-2,31
Ballymena,1857,6,8,4,14,27,48,-21,28
Glentoran,1857,7,6,6,10,24,32,-8,24
Dungannon,1857,8,2,4,16,14,47,-33,10
Crusaders,1858,1,16,7,3,62,31,31,55
Coleraine,1858,2,15,10,1,45,23,22,55
Glenavon,1858,3,9,9,8,53,45,8,36
Linfield,1858,4,10,6,10,38,37,1,36
Cliftonville,1858,5,9,5,12,33,32,1,32
Ballymena,1858,6,7,5,14,26,48,-22,26
Glentoran,1858,7,6,6,10,24,32,-8,24
Dungannon,1858,8,2,4,16,14,47,-33,10
Crusaders,1859,1,17,6,3,65,31,34,57
Coleraine,1859,2,14,10,2,43,24,19,52
Glenavon,1859,3,10,9,7,54,43,11,39
Linfield,1859,4,10,5,11,37,37,0,35
Cliftonville,1859,5,10,4,12,33,31,2,34
Ballymena,1859,6,7,4,15,26,51,-25,25
Glentoran,1859,7,6,6,10,24,32,-8,24
Dungannon,1859,8,2,4,16,14,47,-33,10
Crusaders,1860,1,17,6,3,63,30,33,57
Coleraine,1860,2,14,11,1,44,23,21,53
Linfield,1860,3,11,5,10,39,36,3,38
Glenavon,1860,4,9,10,7,53,44,9,37
Cliftonville,1860,5,9,4,13,32,33,-1,31
Ballymena,1860,6,7,4,15,25,49,-24,25
Glentoran,1860,7,6,6,10,24,32,-8,24
Dungannon,1860,8,2,4,16,14,47,-33,10
Crusaders,1861,1,17,6,3,63,31,32,57
Coleraine,1861,2,14,11,1,43,22,21,53
Linfield,1861,3,11,5,10,39,36,3,38
Glenavon,1861,4,9,10,7,52,43,9,37
Cliftonville,1861,5,9,4,13,32,33,-1,31
Ballymena,1861,6,7,4,15,26,49,-23,25
Glentoran,1861,7,6,6,10,24,32,-8,24
Dungannon,1861,8,2,4,16,14,47,-33,10
Crusaders,1862,1,16,7,3,63,32,31,55
Coleraine,1862,2,15,10,1,45,23,22,55
Glenavon,1862,3,9,9,8,53,45,8,36
Linfield,1862,4,10,6,10,38,37,1,36
Cliftonville,1862,5,9,5,12,33,32,1,32
Ballymena,1862,6,7,5,14,27,49,-22,26
Glentoran,1862,7,6,6,10,24,32,-8,24
Dungannon,1862,8,2,4,16,14,47,-33,10
Crusaders,1863,1,16,7,3,64,33,31,55
Coleraine,1863,2,15,10,1,45,23,22,55
Glenavon,1863,3,9,9,8,53,45,8,36
Linfield,1863,4,10,5,11,38,38,0,35
Cliftonville,1863,5,10,4,12,34,32,2,34
Ballymena,1863,6,7,5,14,28,50,-22,26
Glentoran,1863,7,6,6,10,24,32,-8,24
Dungannon,1863,8,2,4,16,14,47,-33,10
Crusaders,1864,1,16,7,3,64,33,31,55
Coleraine,1864,2,15,10,1,44,22,22,55
Linfield,1864,3,11,5,10,38,36,2,38
Glenavon,1864,4,9,9,8,52,44,8,36
Cliftonville,1864,5,9,4,13,32,32,0,31
Ballymena,1864,6,7,5,14,28,50,-22,26
Glentoran,1864,7,6,6,10,24,32,-8,24
Dungannon,1864,8,2,4,16,14,47,-33,10
Crusaders,1865,1,16,7,3,64,33,31,55
Coleraine,1865,2,15,10,1,47,24,23,55
Linfield,1865,3,11,5,10,39,36,3,38
Glenavon,1865,4,9,9,8,54,47,7,36
Cliftonville,1865,5,9,4,13,32,33,-1,31
Ballymena,1865,6,7,5,14,28,50,-22,26
Glentoran,1865,7,6,6,10,24,32,-8,24
Dungannon,1865,8,2,4,16,14,47,-33,10
Coleraine,1866,1,15,10,1,47,25,22,55
Crusaders,1866,2,16,6,4,63,34,29,54
Glenavon,1866,3,9,9,8,55,47,8,36
Linfield,1866,4,10,6,10,37,36,1,36
Cliftonville,1866,5,9,5,12,32,31,1,32
Ballymena,1866,6,8,4,14,29,49,-20,28
Glentoran,1866,7,6,6,10,24,32,-8,24
Dungannon,1866,8,2,4,16,14,47,-33,10
Crusaders,1867,1,16,7,3,63,32,31,55
Coleraine,1867,2,14,10,2,44,24,20,52
Glenavon,1867,3,10,9,7,54,44,10,39
Linfield,1867,4,11,5,10,39,37,2,38
Cliftonville,1867,5,9,4,13,33,33,0,31
Ballymena,1867,6,7,5,14,27,49,-22,26
Glentoran,1867,7,6,6,10,24,32,-8,24
Dungannon,1867,8,2,4,16,14,47,-33,10
Crusaders,1868,1,16,7,3,62,31,31,55
Coleraine,1868,2,15,10,1,46,24,22,55
Glenavon,1868,3,9,9,8,54,46,8,36
Linfield,1868,4,10,6,10,37,36,1,36
Cliftonville,1868,5,9,5,12,32,31,1,32
Ballymena,1868,6,7,5,14,26,48,-22,26
Glentoran,1868,7,6,6,10,24,32,-8,24
Dungannon,1868,8,2,4,16,14,47,-33,10
Crusaders,1869,1,17,6,3,62,30,32,57
Coleraine,1869,2,14,10,2,44,24,20,52
Glenavon,1869,3,10,9,7,54,44,10,39
Linfield,1869,4,10,5,11,38,38,0,35
Cliftonville,1869,5,10,4,12,34,32,2,34
Ballymena,1869,6,7,4,15,25,48,-23,25
Glentoran,1869,7,6,6,10,24,32,-8,24
Dungannon,1869,8,2,4,16,14,47,-33,10
Crusaders,1870,1,17,6,3,63,30,33,57
Coleraine,1870,2,15,10,1,47,23,24,55
Glenavon,1870,3,9,9,8,53,47,6,36
Linfield,1870,4,10,5,11,37,37,0,35
Cliftonville,1870,5,10,4,12,33,31,2,34
Ballymena,1870,6,7,4,15,25,49,-24,25
Glentoran,1870,7,6,6,10,24,32,-8,24
Dungannon,1870,8,2,4,16,14,47,-33,10
Crusaders,1871,1,17,6,3,66,32,34,57
Coleraine,1871,2,14,10,2,45,25,20,52
Glenavon,1871,3,10,9,7,55,45,10,39
Linfield,1871,4,11,5,10,39,37,2,38
Cliftonville,1871,5,9,4,13,33,33,0,31
Ballymena,1871,6,7,4,15,27,52,-25,25
Glentoran,1871,7,6,6,10,24,32,-8,24
Dungannon,1871,8,2,4,16,14,47,-33,10
Crusaders,1872,1,17,6,3,64,30,34,57
Coleraine,1872,2,14,10,2,44,24,20,52
Glenavon,1872,3,10,9,7,54,44,10,39
Linfield,1872,4,11,5,10,40,38,2,38
Cliftonville,1872,5,9,4,13,34,34,0,31
Ballymena,1872,6,7,4,15,25,50,-25,25
Glentoran,1872,7,6,6,10,24,32,-8,24
Dungannon,1872,8,2,4,16,14,47,-33,10
Crusaders,1873,1,17,6,3,62,30,32,57
Coleraine,1873,2,15,10,1,45,23,22,55
Linfield,1873,3,11,5,10,39,36,3,38
Glenavon,1873,4,9,9,8,53,45,8,36
Cliftonville,1873,5,9,4,13,32,33,-1,31
Ballymena,1873,6,7,4,15,25,48,-23,25
Glentoran,1873,7,6,6,10,24,32,-8,24
Dungannon,1873,8,2,4,16,14,47,-33,10
Crusaders,1874,1,16,6,4,61,33,28,54
Coleraine,1874,2,14,11,1,45,24,21,53
Glenavon,1874,3,9,10,7,54,45,9,37
Linfield,1874,4,10,6,10,39,38,1,36
Cliftonville,1874,5,9,5,12,34,33,1,32
Ballymena,1874,6,8,4,14,28,47,-19,28
Glentoran,1874,7,6,6,10,24,32,-8,24
Dungannon,1874,8,2,4,16,14,47,-33,10
Crusaders,1875,1,16,7,3,62,31,31,55
Coleraine,1875,2,14,10,2,43,23,20,52
Glenavon,1875,3,10,9,7,53,43,10,39
Linfield,1875,4,11,5,10,40,38,2,38
Cliftonville,1875,5,9,4,13,34,34,0,31
Ballymena,1875,6,7,5,14,26,48,-22,26
Glentoran,1875,7,6,6,10,24,32,-8,24
Dungannon,1875,8,2,4,16,14,47,-33,10
Crusaders,1876,1,17,6,3,63,30,33,57
Coleraine,1876,2,15,10,1,49,25,24,55
Linfield,1876,3,11,5,10,39,37,2,38
Glenavon,1876,4,9,9,8,55,49,6,36
Cliftonville,1876,5,9,4,13,33,33,0,31
Ballymena,1876,6,7,4,15,25,49,-24,25
Glentoran,1876,7,6,6,10,24,32,-8,24
Dungannon,1876,8,2,4,16,14,47,-33,10
Crusaders,1877,1,17,6,3,63,31,32,57
Coleraine,1877,2,14,11,1,44,23,21,53
Linfield,1877,3,11,5,10,39,37,2,38
Glenavon,1877,4,9,10,7,53,44,9,37
Cliftonville,1877,5,9,4,13,33,33,0,31
Ballymena,1877,6,7,4,15,26,49,-23,25
Glentoran,1877,7,6,6,10,24,32,-8,24
Dungannon,1877,8,2,4,16,14,47,-33,10
Crusaders,1878,1,17,6,3,65,30,35,57
Coleraine,1878,2,14,11,1,43,22,21,53
Glenavon,1878,3,9,10,7,52,43,9,37
Linfield,1878,4,10,6,10,39,38,1,36
Cliftonville,1878,5,9,5,12,34,33,1,32
Ballymena,1878,6,7,4,15,25,51,-26,25
Glentoran,1878,7,6,6,10,24,32,-8,24
Dungannon,1878,8,2,4,16,14,47,-33,10
Coleraine,1879,1,15,10,1,45,23,22,55
Crusaders,1879,2,16,6,4,61,32,29,54
Glenavon,1879,3,9,9,8,53,45,8,36
Linfield,1879,4,10,6,10,38,37,1,36
Cliftonville,1879,5,9,5,12,33,32,1,32
Ballymena,1879,6,8,4,14,27,47,-20,28
Glentoran,1879,7,6,6,10,24,32,-8,24
Dungannon,1879,8,2,4,16,14,47,-33,10
Crusaders,1880,1,16,7,3,66,35,31,55
Coleraine,1880,2,14,10,2,43,24,19,52
Glenavon,1880,3,10,9,7,54,43,11,39
Linfield,1880,4,10,6,10,38,37,1,36
Cliftonville,1880,5,9,5,12,33,32,1,32
Ballymena,1880,6,7,5,14,30,52,-22,26
Glentoran,1880,7,6,6,10,24,32,-8,24
Dungannon,1880,8,2,4,16,14,47,-33,10
Crusaders,1881,1,16,6,4,61,31,30,54
Coleraine,1881,2,14,11,1,46,25,21,53
Glenavon,1881,3,9,10,7,55,46,9,37
Linfield,1881,4,10,5,11,38,38,0,35
Cliftonville,1881,5,10,4,12,34,32,2,34
Ballymena,1881,6,8,4,14,26,47,-21,28
Glentoran,1881,7,6,6,10,24,32,-8,24
Dungannon,1881,8,2,4,16,14,47,-33,10
Crusaders,1882,1,17,6,3,64,30,34,57
Coleraine,1882,2,14,10,2,43,23,20,52
Glenavon,1882,3,10,9,7,53,43,10,39
Linfield,1882,4,10,5,11,37,37,0,35
Cliftonville,1882,5,10,4,12,33,31,2,34
Ballymena,1882,6,7,4,15,25,50,-25,25
Glentoran,1882,7,6,6,10,24,32,-8,24
Dungannon,1882,8,2,4,16,14,47,-33,10
Crusaders,1883,1,17,6,3,63,30,33,57
Coleraine,1883,2,15,10,1,45,23,22,55
Linfield,1883,3,11,5,10,38,36,2,38
Glenavon,1883,4,9,9,8,53,45,8,36
Cliftonville,1883,5,9,4,13,32,32,0,31
Ballymena,1883,6,7,4,15,25,49,-24,25
Glentoran,1883,7,6,6,10,24,32,-8,24
Dungannon,1883,8,2,4,16,14,47,-33,10
Crusaders,1884,1,16,6,4,61,31,30,54
Coleraine,1884,2,14,10,2,44,25,19,52
Glenavon,1884,3,10,9,7,55,44,11,39
Linfield,1884,4,10,5,11,37,40,-3,35
Cliftonville,1884,5,10,4,12,36,31,5,34
Ballymena,1884,6,8,4,14,26,47,-21,28
Glentoran,1884,7,6,6,10,24,32,-8,24
Dungannon,1884,8,2,4,16,14,47,-33,10
Crusaders,1885,1,17,6,3,65,31,34,57
Coleraine,1885,2,14,11,1,45,24,21,53
Linfield,1885,3,11,5,10,38,36,2,38
Glenavon,1885,4,9,10,7,54,45,9,37
Cliftonville,1885,5,9,4,13,32,32,0,31
Ballymena,1885,6,7,4,15,26,51,-25,25
Glentoran,1885,7,6,6,10,24,32,-8,24
Dungannon,1885,8,2,4,16,14,47,-33,10
Crusaders,1886,1,16,7,3,62,31,31,55
Coleraine,1886,2,14,11,1,43,22,21,53
Glenavon,1886,3,9,10,7,52,43,9,37
Linfield,1886,4,10,6,10,40,39,1,36
Cliftonville,1886,5,9,5,12,35,34,1,32
Ballymena,1886,6,7,5,14,26,48,-22,26
Glentoran,1886,7,6,6,10,24,32,-8,24
Dungannon,1886,8,2,4,16,14,47,-33,10
Crusaders,1887,1,16,7,3,62,31,31,55
Coleraine,1887,2,15,10,1,46,22,24,55
Linfield,1887,3,11,5,10,39,37,2,38
Glenavon,1887,4,9,9,8,52,46,6,36
Cliftonville,1887,5,9,4,13,33,33,0,31
Ballymena,1887,6,7,5,14,26,48,-22,26
Glentoran,1887,7,6,6,10,24,32,-8,24
Dungannon,1887,8,2,4,16,14,47,-33,10
Crusaders,1888,1,17,6,3,63,30,33,57
Coleraine,1888,2,14,10,2,43,24,19,52
Glenavon,1888,3,10,9,7,54,43,11,39
Linfield,1888,4,10,5,11,37,37,0,35
Cliftonville,1888,5,10,4,12,33,31,2,34
Ballymena,1888,6,7,4,15,25,49,-24,25
Glentoran,1888,7,6,6,10,24,32,-8,24
Dungannon,1888,8,2,4,16,14,47,-33,10
Crusaders,1889,1,16,7,3,61,30,31,55
Coleraine,1889,2,14,10,2,44,26,18,52
Glenavon,1889,3,10,9,7,56,44,12,39
Linfield,1889,4,11,5,10,38,36,2,38
Cliftonville,1889,5,9,4,13,32,32,0,31
Ballymena,1889,6,7,5,14,25,47,-22,26
Glentoran,1889,7,6,6,10,24,32,-8,24
Dungannon,1889,8,2,4,16,14,47,-33,10
Crusaders,1890,1,16,7,3,61,30,31,55
Coleraine,1890,2,15,10,1,47,25,22,55
Linfield,1890,3,11,5,10,42,38,4,38
Glenavon,1890,4,9,9,8,55,47,8,36
Cliftonville,1890,5,9,4,13,34,36,-2,31
Ballymena,1890,6,7,5,14,25,47,-22,26
Glentoran,1890,7,6,6,10,24,32,-8,24
Dungannon,1890,8,2,4,16,14,47,-33,10
Crusaders,1891,1,17,6,3,63,31,32,57
Coleraine,1891,2,15,10,1,46,22,24,55
Linfield,1891,3,11,5,10,40,37,3,38
Glenavon,1891,4,9,9,8,52,46,6,36
Cliftonville,1891,5,9,4,13,33,34,-1,31
Ballymena,1891,6,7,4,15,26,49,-23,25
Glentoran,1891,7,6,6,10,24,32,-8,24
Dungannon,1891,8,2,4,16,14,47,-33,10
Crusaders,1892,1,17,6,3,65,31,34,57
Coleraine,1892,2,14,10,2,43,29,14,52
Glenavon,1892,3,10,9,7,59,43,16,39
Linfield,1892,4,10,5,11,37,37,0,35
Cliftonville,1892,5,10,4,12,33,31,2,34
Ballymena,1892,6,7,4,15,26,51,-25,25
Glentoran,1892,7,6,6,10,24,32,-8,24
Dungannon,1892,8,2,4,16,14,47,-33,10
Crusaders,1893,1,17,6,3,66,33,33,57
Coleraine,1893,2,14,10,2,43,23,20,52
Glenavon,1893,3,10,9,7,53,43,10,39
Linfield,1893,4,11,5,10,39,36,3,38
Cliftonville,1893,5,9,4,13,32,33,-1,31
Ballymena,1893,6,7,4,15,28,52,-24,25
Glentoran,1893,7,6,6,10,24,32,-8,24
Dungannon,1893,8,2,4,16,14,47,-33,10
Crusaders,1894,1,17,6,3,66,30,36,57
Coleraine,1894,2,15,10,1,46,23,23,55
Glenavon,1894,3,9,9,8,53,46,7,36
Linfield,1894,4,10,6,10,38,37,1,36
Cliftonville,1894,5,9,5,12,33,32,1,32
Ballymena,1894,6,7,4,15,25,52,-27,25
Glentoran,1894,7,6,6,10,24,32,-8,24
Dungannon,1894,8,2,4,16,14,47,-33,10
Coleraine,1895,1,15,10,1,45,23,22,55
Crusaders,1895,2,16,6,4,63,35,28,54
Linfield,1895,3,11,5,10,39,37,2,38
Glenavon,1895,4,9,9,8,53,45,8,36
Cliftonville,1895,5,9,4,13,33,33,0,31
Ballymena,1895,6,8,4,14,30,49,-19,28
Glentoran,1895,7,6,6,10,24,32,-8,24
Dungannon,1895,8,2,4,16,14,47,-33,10
Crusaders,1896,1,17,6,3,64,31,33,57
Coleraine,1896,2,14,11,1,47,26,21,53
Glenavon,1896,3,9,10,7,56,47,9,37
Linfield,1896,4,10,5,11,38,38,0,35
Cliftonville,1896,5,10,4,12,34,32,2,34
Ballymena,1896,6,7,4,15,26,50,-24,25
Glentoran,1896,7,6,6,10,24,32,-8,24
Dungannon,1896,8,2,4,16,14,47,-33,10
Crusaders,1897,1,17,6,3,63,30,33,57
Coleraine,1897,2,15,10,1,44,22,22,55
Glenavon,1897,3,9,9,8,52,44,8,36
Linfield,1897,4,10,6,10,37,36,1,36
Cliftonville,1897,5,9,5,12,32,31,1,32
Ballymena,1897,6,7,4,15,25,49,-24,25
Glentoran,1897,7,6,6,10,24,32,-8,24
Dungannon,1897,8,2,4,16,14,47,-33,10
Crusaders,1898,1,17,6,3,62,30,32,57
Coleraine,1898,2,14,10,2,43,23,20,52
Glenavon,1898,3,10,9,7,53,43,10,39
Linfield,1898,4,11,5,10,38,36,2,38
Cliftonville,1898,5,9,4,13,32,32,0,31
Ballymena,1898,6,7,4,15,25,48,-23,25
Glentoran,1898,7,6,6,10,24,32,-8,24
Dungannon,1898,8,2,4,16,14,47,-33,10
Crusaders,1899,1,16,6,4,63,35,28,54
Coleraine,1899,2,14,10,2,47,29,18,52
Glenavon,1899,3,10,9,7,59,47,12,39
Linfield,1899,4,10,6,10,38,37,1,36
Cliftonville,1899,5,9,5,12,33,32,1,32
Ballymena,1899,6,8,4,14,30,49,-19,28
Glentoran,1899,7,6,6,10,24,32,-8,24
Dungannon,1899,8,2,4,16,14,47,-33,10
Crusaders,1900,1,17,6,3,63,31,32,57
Coleraine,1900,2,14,11,1,44,23,21,53
Linfield,1900,3,11,5,10,41,38,3,38
Glenavon,1900,4,9,10,7,53,44,9,37
Cliftonville,1900,5,9,4,13,34,35,-1,31
Ballymena,1900,6,7,4,15,26,49,-23,25
Glentoran,1900,7,6,6,10,24,32,-8,24
Dungannon,1900,8,2,4,16,14,47,-33,10
Crusaders,1901,1,16,7,3,63,32,31,55
Coleraine,1901,2,15,10,1,45,22,23,55
Glenavon,1901,3,9,9,8,52,45,7,36
Linfield,1901,4,10,5,11,38,38,0,35
Cliftonville,1901,5,10,4,12,34,32,2,34
Ballymena,1901,6,7,5,14,27,49,-22,26
Glentoran,1901,7,6,6,10,24,32,-8,24
Dungannon,1901,8,2,4,16,14,47,-33,10
Crusaders,1902,1,16,7,3,62,31,31,55
Coleraine,1902,2,14,10,2,45,25,20,52
Glenavon,1902,3,10,9,7,55,45,10,39
Linfield,1902,4,11,5,10,41,37,4,38
Cliftonville,1902,5,9,4,13,33,35,-2,31
Ballymena,1902,6,7,5,14,26,48,-22,26
Glentoran,1902,7,6,6,10,24,32,-8,24
Dungannon,1902,8,2,4,16,14,47,-33,10
Crusaders,1903,1,17,6,3,62,30,32,57
Coleraine,1903,2,14,10,2,43,23,20,52
Glenavon,1903,3,10,9,7,53,43,10,39
Linfield,1903,4,10,6,10,39,38,1,36
Cliftonville,1903,5,9,5,12,34,33,1,32
Ballymena,1903,6,7,4,15,25,48,-23,25
Glentoran,1903,7,6,6,10,24,32,-8,24
Dungannon,1903,8,2,4,16,14,47,-33,10
Crusaders,1904,1,16,7,3,61,30,31,55
Coleraine,1904,2,14,10,2,44,24,20,52
Glenavon,1904,3,10,9,7,54,44,10,39
Linfield,1904,4,11,5,10,40,36,4,38
Cliftonville,1904,5,9,4,13,32,34,-2,31
Ballymena,1904,6,7,5,14,25,47,-22,26
Glentoran,1904,7,6,6,10,24,32,-8,24
Dungannon,1904,8,2,4,16,14,47,-33,10
Crusaders,1905,1,17,6,3,63,31,32,57
Coleraine,1905,2,14,10,2,44,25,19,52
Glenavon,1905,3,10,9,7,55,44,11,39
Linfield,1905,4,11,5,10,38,36,2,38
Cliftonville,1905,5,9,4,13,32,32,0,31
Ballymena,1905,6,7,4,15,26,49,-23,25
Glentoran,1905,7,6,6,10,24,32,-8,24
Dungannon,1905,8,2,4,16,14,47,-33,10
Coleraine,1906,1,15,10,1,45,23,22,55
Crusaders,1906,2,16,6,4,62,32,30,54
Linfield,1906,3,11,5,10,42,36,6,38
Glenavon,1906,4,9,9,8,53,45,8,36
Cliftonville,1906,5,9,4,13,32,36,-4,31
Ballymena,1906,6,8,4,14,27,48,-21,28
Glentoran,1906,7,6,6,10,24,32,-8,24
Dungannon,1906,8,2,4,16,14,47,-33,10
Crusaders,1907,1,17,6,3,63,31,32,57
Coleraine,1907,2,14,10,2,44,24,20,52
Glenavon,1907,3,10,9,7,54,44,10,39
Linfield,1907,4,10,6,10,37,36,1,36
Cliftonville,1907,5,9,5,12,32,31,1,32
Ballymena,1907,6,7,4,15,26,49,-23,25
Glentoran,1907,7,6,6,10,24,32,-8,24
Dungannon,1907,8,2,4,16,14,47,-33,10
Crusaders,1908,1,17,6,3,63,31,32,57
Coleraine,1908,2,15,10,1,45,23,22,55
Glenavon,1908,3,9,9,8,53,45,8,36
Linfield,1908,4,10,6,10,38,37,1,36
Cliftonville,1908,5,9,5,12,33,32,1,32
Ballymena,1908,6,7,4,15,26,49,-23,25
Glentoran,1908,7,6,6,10,24,32,-8,24
Dungannon,1908,8,2,4,16,14,47,-33,10
Crusaders,1909,1,16,7,3,61,30,31,55
Coleraine,1909,2,14,10,2,44,27,17,52
Glenavon,1909,3,10,9,7,57,44,13,39
Linfield,1909,4,10,6,10,37,36,1,36
Cliftonville,1909,5,9,5,12,32,31,1,32
Ballymena,1909,6,7,5,14,25,47,-22,26
Glentoran,1909,7,6,6,10,24,32,-8,24
Dungannon,1909,8,2,4,16,14,47,-33,10
Crusaders,1910,1,16,7,3,61,30,31,55
Coleraine,1910,2,14,11,1,44,23,21,53
Linfield,1910,3,11,5,10,41,37,4,38
Glenavon,1910,4,9,10,7,53,44,9,37
Cliftonville,1910,5,9,4,13,33,35,-2,31
Ballymena,1910,6,7,5,14,25,47,-22,26
Glentoran,1910,7,6,6,10,24,32,-8,24
Dungannon,1910,8,2,4,16,14,47,-33,10
Crusaders,1911,1,17,6,3,64,30,34,57
Coleraine,1911,2,14,10,2,45,25,20,52
Glenavon,1911,3,10,9,7,55,45,10,39
Linfield,1911,4,10,6,10,38,37,1,36
Cliftonville,1911,5,9,5,12,33,32,1,32
Ballymena,1911,6,7,4,15,25,50,-25,25
Glentoran,1911,7,6,6,10,24,32,-8,24
Dungannon,1911,8,2,4,16,14,47,-33,10
Crusaders,1912,1,17,6,3,62,30,32,57
Coleraine,1912,2,15,10,1,47,22,25,55
Glenavon,1912,3,9,9,8,52,47,5,36
Linfield,1912,4,10,6,10,38,37,1,36
Cliftonville,1912,5,9,5,12,33,32,1,32
Ballymena,1912,6,7,4,15,25,48,-23,25
Glentoran,1912,7,6,6,10,24,32,-8,24
Dungannon,1912,8,2,4,16,14,47,-33,10
Crusaders,1913,1,17,6,3,63,30,33,57
Coleraine,1913,2,15,10,1,46,22,24,55
Linfield,1913,3,11,5,10,42,37,5,38
Glenavon,1913,4,9,9,8,52,46,6,36
Cliftonville,1913,5,9,4,13,33,36,-3,31
Ballymena,1913,6,7,4,15,25,49,-24,25
Glentoran,1913,7,6,6,10,24,32,-8,24
Dungannon,1913,8,2,4,16,14,47,-33,10
Crusaders,1914,1,17,6,3,63,31,32,57
Coleraine,1914,2,14,10,2,45,25,20,52
Glenavon,1914,3,10,9,7,55,45,10,39
Linfield,1914,4,11,5,10,41,36,5,38
Cliftonville,1914,5,9,4,13,32,35,-3,31
Ballymena,1914,6,7,4,15,26,49,-23,25
Glentoran,1914,7,6,6,10,24,32,-8,24
Dungannon,1914,8,2,4,16,14,47,-33,10
Crusaders,1915,1,17,6,3,65,31,34,57
Coleraine,1915,2,15,10,1,45,22,23,55
Glenavon,1915,3,9,9,8,52,45,7,36
Linfield,1915,4,10,5,11,37,37,0,35
Cliftonville,1915,5,10,4,12,33,31,2,34
Ballymena,1915,6,7,4,15,26,51,-25,25
Glentoran,1915,7,6,6,10,24,32,-8,24
Dungannon,1915,8,2,4,16,14,47,-33,10
Crusaders,1916,1,17,6,3,66,32,34,57
Coleraine,1916,2,14,11,1,43,22,21,53
Linfield,1916,3,11,5,10,38,36,2,38
Glenavon,1916,4,9,10,7,52,43,9,37
Cliftonville,1916,5,9,4,13,32,32,0,31
Ballymena,1916,6,7,4,15,27,52,-25,25
Glentoran,1916,7,6,6,10,24,32,-8,24
Dungannon,1916,8,2,4,16,14,47,-33,10
Crusaders,1917,1,16,7,3,62,31,31,55
Coleraine,1917,2,14,11,1,44,23,21,53
Linfield,1917,3,11,5,10,39,37,2,38
Glenavon,1917,4,9,10,7,53,44,9,37
Cliftonville,1917,5,9,4,13,33,33,0,31
Ballymena,1917,6,7,5,14,26,48,-22,26
Glentoran,1917,7,6,6,10,24,32,-8,24
Dungannon,1917,8,2,4,16,14,47,-33,10
Crusaders,1918,1,17,6,3,62,30,32,57
Coleraine,1918,2,14,10,2,44,26,18,52
Glenavon,1918,3,10,9,7,56,44,12,39
Linfield,1918,4,11,5,10,38,36,2,38
Cliftonville,1918,5,9,4,13,32,32,0,31
Ballymena,1918,6,7,4,15,25,48,-23,25
Glentoran,1918,7,6,6,10,24,32,-8,24
Dungannon,1918,8,2,4,16,14,47,-33,10
Crusaders,1919,1,16,7,3,61,30,31,55
Coleraine,1919,2,15,10,1,44,22,22,55
Glenavon,1919,3,9,9,8,52,44,8,36
Linfield,1919,4,10,5,11,37,37,0,35
Cliftonville,1919,5,10,4,12,33,31,2,34
Ballymena,1919,6,7,5,14,25,47,-22,26
Glentoran,1919,7,6,6,10,24,32,-8,24
Dungannon,1919,8,2,4,16,14,47,-33,10
Crusaders,1920,1,17,6,3,63,30,33,57
Coleraine,1920,2,14,10,2,45,25,20,52
Glenavon,1920,3,10,9,7,55,45,10,39
Linfield,1920,4,10,6,10,38,37,1,36
Cliftonville,1920,5,9,5,12,33,32,1,32
Ballymena,1920,6,7,4,15,25,49,-24,25
Glentoran,1920,7,6,6,10,24,32,-8,24
Dungannon,1920,8,2,4,16,14,47,-33,10
Crusaders,1921,1,17,6,3,62,30,32,57
Coleraine,1921,2,15,10,1,45,22,23,55
Glenavon,1921,3,9,9,8,52,45,7,36
Linfield,1921,4,10,6,10,38,37,1,36
Cliftonville,1921,5,9,5,12,33,32,1,32
Ballymena,1921,6,7,4,15,25,48,-23,25
Glentoran,1921,7,6,6,10,24,32,-8,24
Dungannon,1921,8,2,4,16,14,47,-33,10
Crusaders,1922,1,17,6,3,66,32,34,57
Coleraine,1922,2,14,11,1,45,24,21,53
Linfield,1922,3,11,5,10,38,36,2,38
Glenavon,1922,4,9,10,7,54,45,9,37
Cliftonville,1922,5,9,4,13,32,32,0,31
Ballymena,1922,6,7,4,15,27,52,-25,25
Glentoran,1922,7,6,6,10,24,32,-8,24
Dungannon,1922,8,2,4,16,14,47,-33,10
Crusaders,1923,1,16,6,4,62,33,29,54
Coleraine,1923,2,14,10,2,45,25,20,52
Glenavon,1923,3,10,9,7,55,45,10,39
Linfield,1923,4,10,6,10,40,39,1,36
Cliftonville,1923,5,9,5,12,35,34,1,32
Ballymena,1923,6,8,4,14,28,48,-20,28
Glentoran,1923,7,6,6,10,24,32,-8,24
Dungannon,1923,8,2,4,16,14,47,-33,10
Crusaders,1924,1,17,6,3,66,30,36,57
Coleraine,1924,2,15,10,1,44,22,22,55
Glenavon,1924,3,9,9,8,52,44,8,36
Linfield,1924,4,10,6,10,38,37,1,36
Cliftonville,1924,5,9,5,12,33,32,1,32
Ballymena,1924,6,7,4,15,25,52,-27,25
Glentoran,1924,7,6,6,10,24,32,-8,24
Dungannon,1924,8,2,4,16,14,47,-33,10
Crusaders,1925,1,17,6,3,62,30,32,57
Coleraine,1925,2,15,10,1,45,22,23,55
Linfield,1925,3,11,5,10,39,37,2,38
Glenavon,1925,4,9,9,8,52,45,7,36
Cliftonville,1925,5,9,4,13,33,33,0,31
Ballymena,1925,6,7,4,15,25,48,-23,25
Glentoran,1925,7,6,6,10,24,32,-8,24
Dungannon,1925,8,2,4,16,14,47,-33,10
Crusaders,1926,1,17,6,3,64,31,33,57
Coleraine,1926,2,14,11,1,44,23,21,53
Glenavon,1926,3,9,10,7,53,44,9,37
Linfield,1926,4,10,6,10,38,37,1,36
Cliftonville,1926,5,9,5,12,33,32,1,32
Ballymena,1926,6,7,4,15,26,50,-24,25
Glentoran,1926,7,6,6,10,24,32,-8,24
Dungannon,1926,8,2,4,16,14,47,-33,10
Crusaders,1927,1,16,6,4,62,32,30,54
Coleraine,1927,2,14,10,2,44,24,20,52
Glenavon,1927,3,10,9,7,54,44,10,39
Linfield,1927,4,10,5,11,37,38,-1,35
Cliftonville,1927,5,10,4,12,34,31,3,34
Ballymena,1927,6,8,4,14,27,48,-21,28
Glentoran,1927,7,6,6,10,24,32,-8,24
Dungannon,1927,8,2,4,16,14,47,-33,10
Crusaders,1928,1,17,6,3,64,31,33,57
Coleraine,1928,2,14,10,2,45,26,19,52
Glenavon,1928,3,10,9,7,56,45,11,39
Linfield,1928,4,10,5,11,37,38,-1,35
Cliftonville,1928,5,10,4,12,34,31,3,34
Ballymena,1928,6,7,4,15,26,50,-24,25
Glentoran,1928,7,6,6,10,24,32,-8,24
Dungannon,1928,8,2,4,16,14,47,-33,10
Coleraine,1929,1,15,10,1,47,24,23,55
Crusaders,1929,2,16,6,4,62,32,30,54
Glenavon,1929,3,9,9,8,54,47,7,36
Linfield,1929,4,10,5,11,37,40,-3,35
Cliftonville,1929,5,10,4,12,36,31,5,34
Ballymena,1929,6,8,4,14,27,48,-21,28
Glentoran,1929,7,6,6,10,24,32,-8,24
Dungannon,1929,8,2,4,16,14,47,-33,10
Crusaders,1930,1,16,6,4,61,31,30,54
Coleraine,1930,2,14,11,1,44,23,21,53
Glenavon,1930,3,9,10,7,53,44,9,37
Linfield,1930,4,10,5,11,37,38,-1,35
Cliftonville,1930,5,10,4,12,34,31,3,34
Ballymena,1930,6,8,4,14,26,47,-21,28
Glentoran,1930,7,6,6,10,24,32,-8,24
Dungannon,1930,8,2,4,16,14,47,-33,10
Crusaders,1931,1,17,6,3,63,31,32,57
Coleraine,1931,2,14,11,1,43,22,21,53
Glenavon,1931,3,9,10,7,52,43,9,37
Linfield,1931,4,10,5,11,38,38,0,35
Cliftonville,1931,5,10,4,12,34,32,2,34
Ballymena,1931,6,7,4,15,26,49,-23,25
Glentoran,1931,7,6,6,10,24,32,-8,24
Dungannon,1931,8,2,4,16,14,47,-33,10
Crusaders,1932,1,16,7,3,62,31,31,55
Coleraine,1932,2,14,10,2,43,23,20,52
Glenavon,1932,3,10,9,7,53,43,10,39
Linfield,1932,4,10,6,10,38,37,1,36
Cliftonville,1932,5,9,5,12,33,32,1,32
Ballymena,1932,6,7,5,14,26,48,-22,26
Glentoran,1932,7,6,6,10,24,32,-8,24
Dungannon,1932,8,2,4,16,14,47,-33,10
Crusaders,1933,1,16,7,3,62,31,31,55
Coleraine,1933,2,14,10,2,45,25,20,52
Glenavon,1933,3,10,9,7,55,45,10,39
Linfield,1933,4,10,6,10,38,37,1,36
Cliftonville,1933,5,9,5,12,33,32,1,32
Ballymena,1933,6,7,5,14,26,48,-22,26
Glentoran,1933,7,6,6,10,24,32,-8,24
Dungannon,1933,8,2,4,16,14,47,-33,10
Crusaders,1934,1,17,6,3,64,30,34,57
Coleraine,1934,2,15,10,1,45,23,22,55
Linfield,1934,3,11,5,10,39,36,3,38
Glenavon,1934,4,9,9,8,53,45,8,36
Cliftonville,1934,5,9,4,13,32,33,-1,31
Ballymena,1934,6,7,4,15,25,50,-25,25
Glentoran,1934,7,6,6,10,24,32,-8,24
Dungannon,1934,8,2,4,16,14,47,-33,10
Crusaders,1935,1,17,6,3,63,31,32,57
Coleraine,1935,2,14,10,2,44,26,18,52
Glenavon,1935,3,10,9,7,56,44,12,39
Linfield,1935,4,10,6,10,40,39,1,36
Cliftonville,1935,5,9,5,12,35,34,1,32
Ballymena,1935,6,7,4,15,26,49,-23,25
Glentoran,1935,7,6,6,10,24,32,-8,24
Dungannon,1935,8,2,4,16,14,47,-33,10
Crusaders,1936,1,16,7,3,63,32,31,55
Coleraine,1936,2,15,10,1,44,22,22,55
Glenavon,1936,3,9,9,8,52,44,8,36
Linfield,1936,4,10,6,10,38,37,1,36
Cliftonville,1936,5,9,5,12,33,32,1,32
Ballymena,1936,6,7,5,14,27,49,-22,26
Glentoran,1936,7,6,6,10,24,32,-8,24
Dungannon,1936,8,2,4,16,14,47,-33,10
Crusaders,1937,1,17,6,3,63,30,33,57
Coleraine,1937,2,15,10,1,46,22,24,55
Glenavon,1937,3,9,9,8,52,46,6,36
Linfield,1937,4,10,6,10,38,37,1,36
Cliftonville,1937,5,9,5,12,33,32,1,32
Ballymena,1937,6,7,4,15,25,49,-24,25
Glentoran,1937,7,6,6,10,24,32,-8,24
Dungannon,1937,8,2,4,16,14,47,-33,10
Crusaders,1938,1,16,6,4,61,32,29,54
Coleraine,1938,2,14,11,1,46,25,21,53
Linfield,1938,3,11,5,10,39,36,3,38
Glenavon,1938,4,9,10,7,55,46,9,37
Cliftonville,1938,5,9,4,13,32,33,-1,31
Ballymena,1938,6,8,4,14,27,47,-20,28
Glentoran,1938,7,6,6,10,24,32,-8,24
Dungannon,1938,8,2,4,16,14,47,-33,10
Coleraine,1939,1,15,10,1,44,22,22,55
Crusaders,1939,2,16,6,4,61,31,30,54
Glenavon,1939,3,9,9,8,52,44,8,36
Linfield,1939,4,10,6,10,37,36,1,36
Cliftonville,1939,5,9,5,12,32,31,1,32
Ballymena,1939,6,8,4,14,26,47,-21,28
Glentoran,1939,7,6,6,10,24,32,-8,24
Dungannon,1939,8,2,4,16,14,47,-33,10
Crusaders,1940,1,16,7,3,63,32,31,55
Coleraine,1940,2,14,10,2,43,24,19,52
Glenavon,1940,3,10,9,7,54,43,11,39
Linfield,1940,4,10,5,11,37,37,0,35
Cliftonville,1940,5,10,4,12,33,31,2,34
Ballymena,1940,6,7,5,14,27,49,-22,26
Glentoran,1940,7,6,6,10,24,32,-8,24
Dungannon,1940,8,2,4,16,14,47,-33,10
Crusaders,1941,1,17,6,3,62,30,32,57
Coleraine,1941,2,14,10,2,43,24,19,52
Glenavon,1941,3,10,9,7,54,43,11,39
Linfield,1941,4,11,5,10,39,37,2,38
Cliftonville,1941,5,9,4,13,33,33,0,31
Ballymena,1941,6,7,4,15,25,48,-23,25
Glentoran,1941,7,6,6,10,24,32,-8,24
Dungannon,1941,8,2,4,16,14,47,-33,10
Crusaders,1942,1,16,7,3,63,32,31,55
Coleraine,1942,2,14,10,2,43,23,20,52
Glenavon,1942,3,10,9,7,53,43,10,39
Linfield,1942,4,10,6,10,37,36,1,36
Cliftonville,1942,5,9,5,12,32,31,1,32
Ballymena,1942,6,7,5,14,27,49,-22,26
Glentoran,1942,7,6,6,10,24,32,-8,24
Dungannon,1942,8,2,4,16,14,47,-33,10
Crusaders,1943,1,17,6,3,64,31,33,57
Coleraine,1943,2,14,10,2,44,24,20,52
Glenavon,1943,3,10,9,7,54,44,10,39
Linfield,1943,4,10,6,10,38,37,1,36
Cliftonville,1943,5,9,5,12,33,32,1,32
Ballymena,1943,6,7,4,15,26,50,-24,25
Glentoran,1943,7,6,6,10,24,32,-8,24
Dungannon,1943,8,2,4,16,14,47,-33,10
Crusaders,1944,1,17,6,3,64,31,33,57
Coleraine,1944,2,14,10,2,43,23,20,52
Glenavon,1944,3,10,9,7,53,43,10,39
Linfield,1944,4,10,5,11,38,38,0,35
Cliftonville,1944,5,10,4,12,34,32,2,34
Ballymena,1944,6,7,4,15,26,50,-24,25
Glentoran,1944,7,6,6,10,24,32,-8,24
Dungannon,1944,8,2,4,16,14,47,-33,10
Coleraine,1945,1,15,10,1,48,23,25,55
Crusaders,1945,2,16,6,4,61,32,29,54
Linfield,1945,3,11,5,10,39,36,3,38
Glenavon,1945,4,9,9,8,53,48,5,36
Cliftonville,1945,5,9,4,13,32,33,-1,31
Ballymena,1945,6,8,4,14,27,47,-20,28
Glentoran,1945,7,6,6,10,24,32,-8,24
Dungannon,1945,8,2,4,16,14,47,-33,10
Crusaders,1946,1,17,6,3,62,30,32,57
Coleraine,1946,2,14,11,1,45,24,21,53
Glenavon,1946,3,9,10,7,54,45,9,37
Linfield,1946,4,10,5,11,37,38,-1,35
Cliftonville,1946,5,10,4,12,34,31,3,34
Ballymena,1946,6,7,4,15,25,48,-23,25
Glentoran,1946,7,6,6,10,24,32,-8,24
Dungannon,1946,8,2,4,16,14,47,-33,10
Crusaders,1947,1,17,6,3,63,30,33,57
Coleraine,1947,2,14,10,2,44,25,19,52
Glenavon,1947,3,10,9,7,55,44,11,39
Linfield,1947,4,10,6,10,37,36,1,36
Cliftonville,1947,5,9,5,12,32,31,1,32
Ballymena,1947,6,7,4,15,25,49,-24,25
Glentoran,1947,7,6,6,10,24,32,-8,24
Dungannon,1947,8,2,4,16,14,47,-33,10
Crusaders,1948,1,16,7,3,63,32,31,55
Coleraine,1948,2,14,11,1,46,25,21,53
Glenavon,1948,3,9,10,7,55,46,9,37
Linfield,1948,4,10,5,11,37,38,-1,35
Cliftonville,1948,5,10,4,12,34,31,3,34
Ballymena,1948,6,7,5,14,27,49,-22,26
Glentoran,1948,7,6,6,10,24,32,-8,24
Dungannon,1948,8,2,4,16,14,47,-33,10
Crusaders,1949,1,16,7,3,63,32,31,55
Coleraine,1949,2,14,10,2,44,25,19,52
Glenavon,1949,3,10,9,7,55,44,11,39
Linfield,1949,4,11,5,10,41,36,5,38
Cliftonville,1949,5,9,4,13,32,35,-3,31
Ballymena,1949,6,7,5,14,27,49,-22,26
Glentoran,1949,7,6,6,10,24,32,-8,24
Dungannon,1949,8,2,4,16,14,47,-33,10
Crusaders,1950,1,17,6,3,62,30,32,57
Coleraine,1950,2,14,10,2,45,25,20,52
Glenavon,1950,3,10,9,7,55,45,10,39
Linfield,1950,4,10,5,11,38,38,0,35
Cliftonville,1950,5,10,4,12,34,32,2,34
Ballymena,1950,6,7,4,15,25,48,-23,25
Glentoran,1950,7,6,6,10,24,32,-8,24
Dungannon,1950,8,2,4,16,14,47,-33,10
Crusaders,1951,1,17,6,3,64,31,33,57
Coleraine,1951,2,14,10,2,44,25,19,52
Glenavon,1951,3,10,9,7,55,44,11,39
Linfield,1951,4,10,6,10,38,37,1,36
Cliftonville,1951,5,9,5,12,33,32,1,32
Ballymena,1951,6,7,4,15,26,50,-24,25
Glentoran,1951,7,6,6,10,24,32,-8,24
Dungannon,1951,8,2,4,16,14,47,-33,10
Crusaders,1952,1,17,6,3,64,31,33,57
Coleraine,1952,2,14,10,2,43,24,19,52
Glenavon,1952,3,10,9,7,54,43,11,39
Linfield,1952,4,11,5,10,38,36,2,38
Cliftonville,1952,5,9,4,13,32,32,0,31
Ballymena,1952,6,7,4,15,26,50,-24,25
Glentoran,1952,7,6,6,10,24,32,-8,24
Dungannon,1952,8,2,4,16,14,47,-33,10
Crusaders,1953,1,16,7,3,63,32,31,55
Coleraine,1953,2,14,11,1,45,24,21,53
Linfield,1953,3,11,5,10,40,36,4,38
Glenavon,1953,4,9,10,7,54,45,9,37
Cliftonville,1953,5,9,4,13,32,34,-2,31
Ballymena,1953,6,7,5,14,27,49,-22,26
Glentoran,1953,7,6,6,10,24,32,-8,24
Dungannon,1953,8,2,4,16,14,47,-33,10
Coleraine,1954,1,15,10,1,46,23,23,55
Crusaders,1954,2,16,6,4,62,32,30,54
Linfield,1954,3,11,5,10,39,37,2,38
Glenavon,1954,4,9,9,8,53,46,7,36
Cliftonville,1954,5,9,4,13,33,33,0,31
Ballymena,1954,6,8,4,14,27,48,-21,28
Glentoran,1954,7,6,6,10,24,32,-8,24
Dungannon,1954,8,2,4,16,14,47,-33,10
Crusaders,1955,1,16,7,3,61,30,31,55
Coleraine,1955,2,14,10,2,43,23,20,52
Glenavon,1955,3,10,9,7,53,43,10,39
Linfield,1955,4,11,5,10,40,37,3,38
Cliftonville,1955,5,9,4,13,33,34,-1,31
Ballymena,1955,6,7,5,14,25,47,-22,26
Glentoran,1955,7,6,6,10,24,32,-8,24
Dungannon,1955,8,2,4,16,14,47,-33,10
Crusaders,1956,1,17,6,3,67,32,35,57
Coleraine,1956,2,15,10,1,47,24,23,55
Glenavon,1956,3,9,9,8,54,47,7,36
Linfield,1956,4,10,6,10,37,36,1,36
Cliftonville,1956,5,9,5,12,32,31,1,32
Ballymena,1956,6,7,4,15,27,53,-26,25
Glentoran,1956,7,6,6,10,24,32,-8,24
Dungannon,1956,8,2,4,16,14,47,-33,10
Crusaders,1957,1,17,6,3,65,31,34,57
Coleraine,1957,2,14,10,2,43,23,20,52
Glenavon,1957,3,10,9,7,53,43,10,39
Linfield,1957,4,10,6,10,37,36,1,36
Cliftonville,1957,5,9,5,12,32,31,1,32
Ballymena,1957,6,7,4,15,26,51,-25,25
Glentoran,1957,7,6,6,10,24,32,-8,24
Dungannon,1957,8,2,4,16,14,47,-33,10
Coleraine,1958,1,15,10,1,46,23,23,55
Crusaders,1958,2,16,6,4,61,34,27,54
Linfield,1958,3,11,5,10,39,36,3,38
Glenavon,1958,4,9,9,8,53,46,7,36
Cliftonville,1958,5,9,4,13,32,33,-1,31
Ballymena,1958,6,8,4,14,29,47,-18,28
Glentoran,1958,7,6,6,10,24,32,-8,24
Dungannon,1958,8,2,4,16,14,47,-33,10
Crusaders,1959,1,16,7,3,64,33,31,55
Coleraine,1959,2,14,10,2,43,23,20,52
Glenavon,1959,3,10,9,7,53,43,10,39
Linfield,1959,4,10,6,10,37,36,1,36
Cliftonville,1959,5,9,5,12,32,31,1,32
Ballymena,1959,6,7,5,14,28,50,-22,26
Glentoran,1959,7,6,6,10,24,32,-8,24
Dungannon,1959,8,2,4,16,14,47,-33,10
Coleraine,1960,1,15,10,1,44,22,22,55
Crusaders,1960,2,16,6,4,61,32,29,54
Linfield,1960,3,11,5,10,40,37,3,38
Glenavon,1960,4,9,9,8,52,44,8,36
Cliftonville,1960,5,9,4,13,33,34,-1,31
Ballymena,1960,6,8,4,14,27,47,-20,28
Glentoran,1960,7,6,6,10,24,32,-8,24
Dungannon,1960,8,2,4,16,14,47,-33,10
Crusaders,1961,1,16,6,4,62,34,28,54
Coleraine,1961,2,14,11,1,44,23,21,53
Glenavon,1961,3,9,10,7,53,44,9,37
Linfield,1961,4,10,6,10,38,37,1,36
Cliftonville,1961,5,9,5,12,33,32,1,32
Ballymena,1961,6,8,4,14,29,48,-19,28
Glentoran,1961,7,6,6,10,24,32,-8,24
Dungannon,1961,8,2,4,16,14,47,-33,10
Crusaders,1962,1,16,6,4,61,32,29,54
Coleraine,1962,2,14,10,2,44,24,20,52
Glenavon,1962,3,10,9,7,54,44,10,39
Linfield,1962,4,11,5,10,39,37,2,38
Cliftonville,1962,5,9,4,13,33,33,0,31
Ballymena,1962,6,8,4,14,27,47,-20,28
Glentoran,1962,7,6,6,10,24,32,-8,24
Dungannon,1962,8,2,4,16,14,47,-33,10
Crusaders,1963,1,17,6,3,62,30,32,57
Coleraine,1963,2,15,10,1,46,22,24,55
Linfield,1963,3,11,5,10,42,38,4,38
Glenavon,1963,4,9,9,8,52,46,6,36
Cliftonville,1963,5,9,4,13,34,36,-2,31
Ballymena,1963,6,7,4,15,25,48,-23,25
Glentoran,1963,7,6,6,10,24,32,-8,24
Dungannon,1963,8,2,4,16,14,47,-33,10
Crusaders,1964,1,17,6,3,63,30,33,57
Coleraine,1964,2,14,11,1,44,23,21,53
Glenavon,1964,3,9,10,7,53,44,9,37
Linfield,1964,4,10,5,11,37,38,-1,35
Cliftonville,1964,5,10,4,12,34,31,3,34
Ballymena,1964,6,7,4,15,25,49,-24,25
Glentoran,1964,7,6,6,10,24,32,-8,24
Dungannon,1964,8,2,4,16,14,47,-33,10
Crusaders,1965,1,17,6,3,66,30,36,57
Coleraine,1965,2,14,11,1,44,23,21,53
Linfield,1965,3,11,5,10,38,36,2,38
Glenavon,1965,4,9,10,7,53,44,9,37
Cliftonville,1965,5,9,4,13,32,32,0,31
Ballymena,1965,6,7,4,15,25,52,-27,25
Glentoran,1965,7,6,6,10,24,32,-8,24
Dungannon,1965,8,2,4,16,14,47,-33,10
Crusaders,1966,1,16,7,3,64,33,31,55
Coleraine,1966,2,14,10,2,44,24,20,52
Glenavon,1966,3,10,9,7,54,44,10,39
Linfield,1966,4,11,5,10,40,38,2,38
Cliftonville,1966,5,9,4,13,34,34,0,31
Ballymena,1966,6,7,5,14,28,50,-22,26
Glentoran,1966,7,6,6,10,24,32,-8,24
Dungannon,1966,8,2,4,16,14,47,-33,10
Crusaders,1967,1,16,6,4,62,32,30,54
Coleraine,1967,2,14,11,1,44,23,21,53
Linfield,1967,3,11,5,10,38,36,2,38
Glenavon,1967,4,9,10,7,53,44,9,37
Cliftonville,1967,5,9,4,13,32,32,0,31
Ballymena,1967,6,8,4,14,27,48,-21,28
Glentoran,1967,7,6,6,10,24,32,-8,24
Dungannon,1967,8,2,4,16,14,47,-33,10
Crusaders,1968,1,16,7,3,63,32,31,55
Coleraine,1968,2,14,11,1,45,24,21,53
Glenavon,1968,3,9,10,7,54,45,9,37
Linfield,1968,4,10,5,11,39,40,-1,35
Cliftonville,1968,5,10,4,12,36,33,3,34
Ballymena,1968,6,7,5,14,27,49,-22,26
Glentoran,1968,7,6,6,10,24,32,-8,24
Dungannon,1968,8,2,4,16,14,47,-33,10
Crusaders,1969,1,16,6,4,63,35,28,54
Coleraine,1969,2,14,10,2,43,23,20,52
Glenavon,1969,3,10,9,7,53,43,10,39
Linfield,1969,4,11,5,10,40,37,3,38
Cliftonville,1969,5,9,4,13,33,34,-1,31
Ballymena,1969,6,8,4,14,30,49,-19,28
Glentoran,1969,7,6,6,10,24,32,-8,24
Dungannon,1969,8,2,4,16,14,47,-33,10
Coleraine,1970,1,15,10,1,44,22,22,55
Crusaders,1970,2,16,6,4,61,31,30,54
Linfield,1970,3,11,5,10,39,37,2,38
Glenavon,1970,4,9,9,8,52,44,8,36
Cliftonville,1970,5,9,4,13,33,33,0,31
Ballymena,1970,6,8,4,14,26,47,-21,28
Glentoran,1970,7,6,6,10,24,32,-8,24
Dungannon,1970,8,2,4,16,14,47,-33,10
Crusaders,1971,1,16,6,4,62,34,28,54
Coleraine,1971,2,14,10,2,43,25,18,52
Glenavon,1971,3,10,9,7,55,43,12,39
Linfield,1971,4,10,5,11,38,41,-3,35
Cliftonville,1971,5,10,4,12,37,32,5,34
Ballymena,1971,6,8,4,14,29,48,-19,28
Glentoran,1971,7,6,6,10,24,32,-8,24
Dungannon,1971,8,2,4,16,14,47,-33,10
Coleraine,1972,1,15,10,1,45,22,23,55
Crusaders,1972,2,16,6,4,61,32,29,54
Glenavon,1972,3,9,9,8,52,45,7,36
Linfield,1972,4,10,5,11,38,39,-1,35
Cliftonville,1972,5,10,4,12,35,32,3,34
Ballymena,1972,6,8,4,14,27,47,-20,28
Glentoran,1972,7,6,6,10,24,32,-8,24
Dungannon,1972,8,2,4,16,14,47,-33,10
Crusaders,1973,1,17,6,3,63,30,33,57
Coleraine,1973,2,14,10,2,43,25,18,52
Glenavon,1973,3,10,9,7,55,43,12,39
Linfield,1973,4,10,6,10,37,36,1,36
Cliftonville,1973,5,9,5,12,32,31,1,32
Ballymena,1973,6,7,4,15,25,49,-24,25
Glentoran,1973,7,6,6,10,24,32,-8,24
Dungannon,1973,8,2,4,16,14,47,-33,10
Crusaders,1974,1,17,6,3,63,30,33,57
Coleraine,1974,2,14,10,2,45,26,19,52
Glenavon,1974,3,10,9,7,56,45,11,39
Linfield,1974,4,10,6,10,38,37,1,36
Cliftonville,1974,5,9,5,12,33,32,1,32
Ballymena,1974,6,7,4,15,25,49,-24,25
Glentoran,1974,7,6,6,10,24,32,-8,24
Dungannon,1974,8,2,4,16,14,47,-33,10
Crusaders,1975,1,16,7,3,63,32,31,55
Coleraine,1975,2,14,11,1,45,24,21,53
Linfield,1975,3,11,5,10,41,38,3,38
Glenavon,1975,4,9,10,7,54,45,9,37
Cliftonville,1975,5,9,4,13,34,35,-1,31
Ballymena,1975,6,7,5,14,27,49,-22,26
Glentoran,1975,7,6,6,10,24,32,-8,24
Dungannon,1975,8,2,4,16,14,47,-33,10
Coleraine,1976,1,15,10,1,47,23,24,55
Crusaders,1976,2,16,6,4,61,31,30,54
Linfield,1976,3,11,5,10,40,38,2,38
Glenavon,1976,4,9,9,8,53,47,6,36
Cliftonville,1976,5,9,4,13,34,34,0,31
Ballymena,1976,6,8,4,14,26,47,-21,28
Glentoran,1976,7,6,6,10,24,32,-8,24
Dungannon,1976,8,2,4,16,14,47,-33,10
Crusaders,1977,1,16,6,4,62,33,29,54
Coleraine,1977,2,14,11,1,44,23,21,53
Glenavon,1977,3,9,10,7,53,44,9,37
Linfield,1977,4,10,5,11,37,37,0,35
Cliftonville,1977,5,10,4,12,33,31,2,34
Ballymena,1977,6,8,4,14,28,48,-20,28
Glentoran,1977,7,6,6,10,24,32,-8,24
Dungannon,1977,8,2,4,16,14,47,-33,10
Crusaders,1978,1,16,6,4,61,31,30,54
Coleraine,1978,2,14,10,2,43,24,19,52
Glenavon,1978,3,10,9,7,54,43,11,39
Linfield,1978,4,11,5,10,38,36,2,38
Cliftonville,1978,5,9,4,13,32,32,0,31
Ballymena,1978,6,8,4,14,26,47,-21,28
Glentoran,1978,7,6,6,10,24,32,-8,24
Dungannon,1978,8,2,4,16,14,47,-33,10
Crusaders,1979,1,17,6,3,65,33,32,57
Coleraine,1979,2,14,11,1,44,23,21,53
Linfield,1979,3,11,5,10,39,37,2,38
Glenavon,1979,4,9,10,7,53,44,9,37
Cliftonville,1979,5,9,4,13,33,33,0,31
Ballymena,1979,6,7,4,15,28,51,-23,25
Glentoran,1979,7,6,6,10,24,32,-8,24
Dungannon,1979,8,2,4,16,14,47,-33,10
Crusaders,1980,1,16,6,4,62,33,29,54
Coleraine,1980,2,14,11,1,45,24,21,53
Glenavon,1980,3,9,10,7,54,45,9,37
Linfield,1980,4,10,5,11,37,37,0,35
Cliftonville,1980,5,10,4,12,33,31,2,34
Ballymena,1980,6,8,4,14,28,48,-20,28
Glentoran,1980,7,6,6,10,24,32,-8,24
Dungannon,1980,8,2,4,16,14,47,-33,10
Crusaders,1981,1,16,7,3,62,31,31,55
Coleraine,1981,2,14,10,2,44,24,20,52
Glenavon,1981,3,10,9,7,54,44,10,39
Linfield,1981,4,11,5,10,38,36,2,38
Cliftonville,1981,5,9,4,13,32,32,0,31
Ballymena,1981,6,7,5,14,26,48,-22,26
Glentoran,1981,7,6,6,10,24,32,-8,24
Dungannon,1981,8,2,4,16,14,47,-33,10
Crusaders,1982,1,17,6,3,64,32,32,57
Coleraine,1982,2,14,11,1,43,22,21,53
Linfield,1982,3,11,5,10,39,36,3,38
Glenavon,1982,4,9,10,7,52,43,9,37
Cliftonville,1982,5,9,4,13,32,33,-1,31
Ballymena,1982,6,7,4,15,27,50,-23,25
Glentoran,1982,7,6,6,10,24,32,-8,24
Dungannon,1982,8,2,4,16,14,47,-33,10
Crusaders,1983,1,16,7,3,62,31,31,55
Coleraine,1983,2,15,10,1,48,24,24,55
Linfield,1983,3,11,5,10,38,36,2,38
Glenavon,1983,4,9,9,8,54,48,6,36
Cliftonville,1983,5,9,4,13,32,32,0,31
Ballymena,1983,6,7,5,14,26,48,-22,26
Glentoran,1983,7,6,6,10,24,32,-8,24
Dungannon,1983,8,2,4,16,14,47,-33,10
Crusaders,1984,1,16,7,3,64,33,31,55
Coleraine,1984,2,14,10,2,43,24,19,52
Glenavon,1984,3,10,9,7,54,43,11,39
Linfield,1984,4,11,5,10,39,37,2,38
Cliftonville,1984,5,9,4,13,33,33,0,31
Ballymena,1984,6,7,5,14,28,50,-22,26
Glentoran,1984,7,6,6,10,24,32,-8,24
Dungannon,1984,8,2,4,16,14,47,-33,10
Crusaders,1985,1,17,6,3,63,31,32,57
Coleraine,1985,2,14,10,2,45,25,20,52
Glenavon,1985,3,10,9,7,55,45,10,39
Linfield,1985,4,11,5,10,39,36,3,38
Cliftonville,1985,5,9,4,13,32,33,-1,31
Ballymena,1985,6,7,4,15,26,49,-23,25
Glentoran,1985,7,6,6,10,24,32,-8,24
Dungannon,1985,8,2,4,16,14,47,-33,10
Crusaders,1986,1,17,6,3,65,30,35,57
Coleraine,1986,2,14,11,1,44,23,21,53
Glenavon,1986,3,9,10,7,53,44,9,37
Linfield,1986,4,10,5,11,37,38,-1,35
Cliftonville,1986,5,10,4,12,34,31,3,34
Ballymena,1986,6,7,4,15,25,51,-26,25
Glentoran,1986,7,6,6,10,24,32,-8,24
Dungannon,1986,8,2,4,16,14,47,-33,10
Crusaders,1987,1,16,7,3,62,31,31,55
Coleraine,1987,2,15,10,1,44,22,22,55
Glenavon,1987,3,9,9,8,52,44,8,36
Linfield,1987,4,10,5,11,37,38,-1,35
Cliftonville,1987,5,10,4,12,34,31,3,34
Ballymena,1987,6,7,5,14,26,48,-22,26
Glentoran,1987,7,6,6,10,24,32,-8,24
Dungannon,1987,8,2,4,16,14,47,-33,10
Crusaders,1988,1,17,6,3,63,30,33,57
Coleraine,1988,2,14,10,2,43,24,19,52
Glenavon,1988,3,10,9,7,54,43,11,39
Linfield,1988,4,10,5,11,38,39,-1,35
Cliftonville,1988,5,10,4,12,35,32,3,34
Ballymena,1988,6,7,4,15,25,49,-24,25
Glentoran,1988,7,6,6,10,24,32,-8,24
Dungannon,1988,8,2,4,16,14,47,-33,10
Crusaders,1989,1,16,7,3,61,30,31,55
Coleraine,1989,2,14,10,2,44,26,18,52
Glenavon,1989,3,10,9,7,56,44,12,39
Linfield,1989,4,10,5,11,37,37,0,35
Cliftonville,1989,5,10,4,12,33,31,2,34
Ballymena,1989,6,7,5,14,25,47,-22,26
Glentoran,1989,7,6,6,10,24,32,-8,24
Dungannon,1989,8,2,4,16,14,47,-33,10
Crusaders,1990,1,17,6,3,62,30,32,57
Coleraine,1990,2,14,10,2,44,26,18,52
Glenavon,1990,3,10,9,7,56,44,12,39
Linfield,1990,4,10,6,10,38,37,1,36
Cliftonville,1990,5,9,5,12,33,32,1,32
Ballymena,1990,6,7,4,15,25,48,-23,25
Glentoran,1990,7,6,6,10,24,32,-8,24
Dungannon,1990,8,2,4,16,14,47,-33,10
Crusaders,1991,1,17,6,3,64,30,34,57
Coleraine,1991,2,14,11,1,44,23,21,53
Linfield,1991,3,11,5,10,39,37,2,38
Glenavon,1991,4,9,10,7,53,44,9,37
Cliftonville,1991,5,9,4,13,33,33,0,31
Ballymena,1991,6,7,4,15,25,50,-25,25
Glentoran,1991,7,6,6,10,24,32,-8,24
Dungannon,1991,8,2,4,16,14,47,-33,10
Crusaders,1992,1,16,7,3,62,31,31,55
Coleraine,1992,2,15,10,1,44,22,22,55
Glenavon,1992,3,9,9,8,52,44,8,36
Linfield,1992,4,10,6,10,38,37,1,36
Cliftonville,1992,5,9,5,12,33,32,1,32
Ballymena,1992,6,7,5,14,26,48,-22,26
Glentoran,1992,7,6,6,10,24,32,-8,24
Dungannon,1992,8,2,4,16,14,47,-33,10
Crusaders,1993,1,16,7,3,63,32,31,55
Coleraine,1993,2,14,10,2,44,25,19,52
Glenavon,1993,3,10,9,7,55,44,11,39
Linfield,1993,4,10,6,10,38,37,1,36
Cliftonville,1993,5,9,5,12,33,32,1,32
Ballymena,1993,6,7,5,14,27,49,-22,26
Glentoran,1993,7,6,6,10,24,32,-8,24
Dungannon,1993,8,2,4,16,14,47,-33,10
Crusaders,1994,1,17,6,3,63,30,33,57
Coleraine,1994,2,15,10,1,46,23,23,55
Linfield,1994,3,11,5,10,39,37,2,38
Glenavon,1994,4,9,9,8,53,46,7,36
Cliftonville,1994,5,9,4,13,33,33,0,31
Ballymena,1994,6,7,4,15,25,49,-24,25
Glentoran,1994,7,6,6,10,24,32,-8,24
Dungannon,1994,8,2,4,16,14,47,-33,10
Crusaders,1995,1,16,7,3,61,30,31,55
Coleraine,1995,2,14,10,2,43,24,19,52
Glenavon,1995,3,10,9,7,54,43,11,39
Linfield,1995,4,10,6,10,37,36,1,36
Cliftonville,1995,5,9,5,12,32,31,1,32
Ballymena,1995,6,7,5,14,25,47,-22,26
Glentoran,1995,7,6,6,10,24,32,-8,24
Dungannon,1995,8,2,4,16,14,47,-33,10
Crusaders,1996,1,16,7,3,61,30,31,55
Coleraine,1996,2,15,10,1,45,23,22,55
Linfield,1996,3,11,5,10,40,36,4,38
Glenavon,1996,4,9,9,8,53,45,8,36
Cliftonville,1996,5,9,4,13,32,34,-2,31
Ballymena,1996,6,7,5,14,25,47,-22,26
Glentoran,1996,7,6,6,10,24,32,-8,24
Dungannon,1996,8,2,4,16,14,47,-33,10
Crusaders,1997,1,17,6,3,63,30,33,57
Coleraine,1997,2,14,11,1,44,23,21,53
Linfield,1997,3,11,5,10,39,36,3,38
Glenavon,1997,4,9,10,7,53,44,9,37
Cliftonville,1997,5,9,4,13,32,33,-1,31
Ballymena,1997,6,7,4,15,25,49,-24,25
Glentoran,1997,7,6,6,10,24,32,-8,24
Dungannon,1997,8,2,4,16,14,47,-33,10
Crusaders,1998,1,17,6,3,64,31,33,57
Coleraine,1998,2,15,10,1,45,23,22,55
Linfield,1998,3,11,5,10,39,36,3,38
Glenavon,1998,4,9,9,8,53,45,8,36
Cliftonville,1998,5,9,4,13,32,33,-1,31
Ballymena,1998,6,7,4,15,26,50,-24,25
Glentoran,1998,7,6,6,10,24,32,-8,24
Dungannon,1998,8,2,4,16,14,47,-33,10
Crusaders,1999,1,17,6,3,63,30,33,57
Coleraine,1999,2,14,10,2,43,23,20,52
Glenavon,1999,3,10,9,7,53,43,10,39
Linfield,1999,4,11,5,10,39,36,3,38
Cliftonville,1999,5,9,4,13,32,33,-1,31
Ballymena,1999,6,7,4,15,25,49,-24,25
Glentoran,1999,7,6,6,10,24,32,-8,24
Dungannon,1999,8,2,4,16,14,47,-33,10
Crusaders,2000,1,17,6,3,65,30,35,57
Coleraine,2000,2,14,11,1,45,24,21,53
Linfield,2000,3,11,5,10,42,37,5,38
Glenavon,2000,4,9,10,7,54,45,9,37
Cliftonville,2000,5,9,4,13,33,36,-3,31
Ballymena,2000,6,7,4,15,25,51,-26,25
Glentoran,2000,7,6,6,10,24,32,-8,24
Dungannon,2000,8,2,4,16,14,47,-33,10
Crusaders,2001,1,17,6,3,64,31,33,57
Coleraine,2001,2,14,10,2,44,25,19,52
Glenavon,2001,3,10,9,7,55,44,11,39
Linfield,2001,4,10,6,10,37,36,1,36
Cliftonville,2001,5,9,5,12,32,31,1,32
Ballymena,2001,6,7,4,15,26,50,-24,25
Glentoran,2001,7,6,6,10,24,32,-8,24
Dungannon,2001,8,2,4,16,14,47,-33,10
Coleraine,2002,1,15,10,1,44,22,22,55
Crusaders,2002,2,16,6,4,62,33,29,54
Glenavon,2002,3,9,9,8,52,44,8,36
Linfield,2002,4,10,6,10,38,37,1,36
Cliftonville,2002,5,9,5,12,33,32,1,32
Ballymena,2002,6,8,4,14,28,48,-20,28
Glentoran,2002,7,6,6,10,24,32,-8,24
Dungannon,2002,8,2,4,16,14,47,-33,10
Crusaders,2003,1,17,6,3,64,30,34,57
Coleraine,2003,2,14,10,2,44,24,20,52
Glenavon,2003,3,10,9,7,54,44,10,39
Linfield,2003,4,11,5,10,38,36,2,38
Cliftonville,2003,5,9,4,13,32,32,0,31
Ballymena,2003,6,7,4,15,25,50,-25,25
Glentoran,2003,7,6,6,10,24,32,-8,24
Dungannon,2003,8,2,4,16,14,47,-33,10
Crusaders,2004,1,17,6,3,62,30,32,57
Coleraine,2004,2,14,10,2,44,24,20,52
Glenavon,2004,3,10,9,7,54,44,10,39
Linfield,2004,4,10,6,10,38,37,1,36
Cliftonville,2004,5,9,5,12,33,32,1,32
Ballymena,2004,6,7,4,15,25,48,-23,25
Glentoran,2004,7,6,6,10,24,32,-8,24
Dungannon,2004,8,2,4,16,14,47,-33,10
Crusaders,2005,1,17,6,3,64,30,34,57
Coleraine,2005,2,14,11,1,45,24,21,53
Linfield,2005,3,11,5,10,40,37,3,38
Glenavon,2005,4,9,10,7,54,45,9,37
Cliftonville,2005,5,9,4,13,33,34,-1,31
Ballymena,2005,6,7,4,15,25,50,-25,25
Glentoran,2005,7,6,6,10,24,32,-8,24
Dungannon,2005,8,2,4,16,14,47,-33,10
Crusaders,2006,1,17,6,3,63,31,32,57
Coleraine,2006,2,15,10,1,45,23,22,55
Glenavon,2006,3,9,9,8,53,45,8,36
Linfield,2006,4,10,6,10,40,39,1,36
Cliftonville,2006,5,9,5,12,35,34,1,32
Ballymena,2006,6,7,4,15,26,49,-23,25
Glentoran,2006,7,6,6,10,24,32,-8,24
Dungannon,2006,8,2,4,16,14,47,-33,10
Crusaders,2007,1,16,6,4,61,31,30,54
Coleraine,2007,2,14,11,1,46,25,21,53
Linfield,2007,3,11,5,10,40,37,3,38
Glenavon,2007,4,9,10,7,55,46,9,37
Cliftonville,2007,5,9,4,13,33,34,-1,31
Ballymena,2007,6,8,4,14,26,47,-21,28
Glentoran,2007,7,6,6,10,24,32,-8,24
Dungannon,2007,8,2,4,16,14,47,-33,10
Crusaders,2008,1,16,7,3,63,32,31,55
Coleraine,2008,2,14,11,1,46,25,21,53
Linfield,2008,3,11,5,10,39,37,2,38
Glenavon,2008,4,9,10,7,55,46,9,37
Cliftonville,2008,5,9,4,13,33,33,0,31
Ballymena,2008,6,7,5,14,27,49,-22,26
Glentoran,2008,7,6,6,10,24,32,-8,24
Dungannon,2008,8,2,4,16,14,47,-33,10
Crusaders,2009,1,16,7,3,63,32,31,55
Coleraine,2009,2,14,10,2,43,23,20,52
Glenavon,2009,3,10,9,7,53,43,10,39
Linfield,2009,4,10,6,10,38,37,1,36
Cliftonville,2009,5,9,5,12,33,32,1,32
Ballymena,2009,6,7,5,14,27,49,-22,26
Glentoran,2009,7,6,6,10,24,32,-8,24
Dungannon,2009,8,2,4,16,14,47,-33,10
Crusaders,2010,1,16,7,3,63,32,31,55
Coleraine,2010,2,14,10,2,44,24,20,52
Glenavon,2010,3,10,9,7,54,44,10,39
Linfield,2010,4,10,6,10,38,37,1,36
Cliftonville,2010,5,9,5,12,33,32,1,32
Ballymena,2010,6,7,5,14,27,49,-22,26
Glentoran,2010,7,6,6,10,24,32,-8,24
Dungannon,2010,8,2,4,16,14,47,-33,10
Crusaders,2011,1,16,7,3,63,32,31,55
Coleraine,2011,2,14,11,1,43,22,21,53
Linfield,2011,3,11,5,10,39,37,2,38
Glenavon,2011,4,9,10,7,52,43,9,37
Cliftonville,2011,5,9,4,13,33,33,0,31
Ballymena,2011,6,7,5,14,27,49,-22,26
Glentoran,2011,7,6,6,10,24,32,-8,24
Dungannon,2011,8,2,4,16,14,47,-33,10
Crusaders,2012,1,17,6,3,63,31,32,57
Coleraine,2012,2,14,10,2,45,26,19,52
Glenavon,2012,3,10,9,7,56,45,11,39
Linfield,2012,4,10,5,11,38,38,0,35
Cliftonville,2012,5,10,4,12,34,32,2,34
Ballymena,2012,6,7,4,15,26,49,-23,25
Glentoran,2012,7,6,6,10,24,32,-8,24
Dungannon,2012,8,2,4,16,14,47,-33,10
Crusaders,2013,1,16,6,4,62,33,29,54
Coleraine,2013,2,14,10,2,43,28,15,52
Glenavon,2013,3,10,9,7,58,43,15,39
Linfield,2013,4,10,5,11,37,38,-1,35
Cliftonville,2013,5,10,4,12,34,31,3,34
Ballymena,2013,6,8,4,14,28,48,-20,28
Glentoran,2013,7,6,6,10,24,32,-8,24
Dungannon,2013,8,2,4,16,14,47,-33,10
Crusaders,2014,1,16,6,4,63,33,30,54
Coleraine,2014,2,14,11,1,46,25,21,53
Glenavon,2014,3,9,10,7,55,46,9,37
Linfield,2014,4,10,6,10,38,37,1,36
Cliftonville,2014,5,9,5,12,33,32,1,32
Ballymena,2014,6,8,4,14,28,49,-21,28
Glentoran,2014,7,6,6,10,24,32,-8,24
Dungannon,2014,8,2,4,16,14,47,-33,10
Crusaders,2015,1,17,6,3,64,32,32,57
Coleraine,2015,2,15,10,1,45,22,23,55
Linfield,2015,3,11,5,10,40,36,4,38
Glenavon,2015,4,9,9,8,52,45,7,36
Cliftonville,2015,5,9,4,13,32,34,-2,31
Ballymena,2015,6,7,4,15,27,50,-23,25
Glentoran,2015,7,6,6,10,24,32,-8,24
Dungannon,2015,8,2,4,16,14,47,-33,10
Crusaders,2016,1,16,6,4,61,33,28,54
Coleraine,2016,2,14,10,2,45,26,19,52
Glenavon,2016,3,10,9,7,56,45,11,39
Linfield,2016,4,11,5,10,39,36,3,38
Cliftonville,2016,5,9,4,13,32,33,-1,31
Ballymena,2016,6,8,4,14,28,47,-19,28
Glentoran,2016,7,6,6,10,24,32,-8,24
Dungannon,2016,8,2,4,16,14,47,-33,10
Crusaders,2017,1,16,7,3,63,32,31,55
Coleraine,2017,2,14,10,2,43,24,19,52
Glenavon,2017,3,10,9,7,54,43,11,39
Linfield,2017,4,11,5,10,39,36,3,38
Cliftonville,2017,5,9,4,13,32,33,-1,31
Ballymena,2017,6,7,5,14,27,49,-22,26
Glentoran,2017,7,6,6,10,24,32,-8,24
Dungannon,2017,8,2,4,16,14,47,-33,10
Crusaders,2018,1,17,6,3,63,31,32,57
Coleraine,2018,2,14,10,2,43,25,18,52
Glenavon,2018,3,10,9,7,55,43,12,39
Linfield,2018,4,11,5,10,39,37,2,38
Cliftonville,2018,5,9,4,13,33,33,0,31
Ballymena,2018,6,7,4,15,26,49,-23,25
Glentoran,2018,7,6,6,10,24,32,-8,24
Dungannon,2018,8,2,4,16,14,47,-33,10
Crusaders,2019,1,17,6,3,62,30,32,57
Coleraine,2019,2,15,10,1,46,22,24,55
Linfield,2019,3,11,5,10,38,36,2,38
Glenavon,2019,4,9,9,8,52,46,6,36
Cliftonville,2019,5,9,4,13,32,32,0,31
Ballymena,2019,6,7,4,15,25,48,-23,25
Glentoran,2019,7,6,6,10,24,32,-8,24
Dungannon,2019,8,2,4,16,14,47,-33,10
Crusaders,2020,1,17,6,3,65,31,34,57
Coleraine,2020,2,14,11,1,44,23,21,53
Glenavon,2020,3,9,10,7,53,44,9,37
Linfield,2020,4,10,5,11,37,37,0,35
Cliftonville,2020,5,10,4,12,33,31,2,34
Ballymena,2020,6,7,4,15,26,51,-25,25
Glentoran,2020,7,6,6,10,24,32,-8,24
Dungannon,2020,8,2,4,16,14,47,-33,10
Crusaders,2021,1,16,7,3,61,30,31,55
Coleraine,2021,2,15,10,1,45,23,22,55
Glenavon,2021,3,9,9,8,53,45,8,36
Linfield,2021,4,10,6,10,38,37,1,36
Cliftonville,2021,5,9,5,12,33,32,1,32
Ballymena,2021,6,7,5,14,25,47,-22,26
Glentoran,2021,7,6,6,10,24,32,-8,24
Dungannon,2021,8,2,4,16,14,47,-33,10
Crusaders,2022,1,17,6,3,64,30,34,57
Coleraine,2022,2,14,11,1,44,23,21,53
Linfield,2022,3,11,5,10,39,36,3,38
Glenavon,2022,4,9,10,7,53,44,9,37
Cliftonville,2022,5,9,4,13,32,33,-1,31
Ballymena,2022,6,7,4,15,25,50,-25,25
Glentoran,2022,7,6,6,10,24,32,-8,24
Dungannon,2022,8,2,4,16,14,47,-33,10
Crusaders,2023,1,16,6,4,61,31,30,54
Coleraine,2023,2,14,10,2,43,24,19,52
Glenavon,2023,3,10,9,7,54,43,11,39
Linfield,2023,4,11,5,10,39,37,2,38
Cliftonville,2023,5,9,4,13,33,33,0,31
Ballymena,2023,6,8,4,14,26,47,-21,28
Glentoran,2023,7,6,6,10,24,32,-8,24
Dungannon,2023,8,2,4,16,14,47,-33,10
Crusaders,2024,1,17,6,3,63,31,32,57
Coleraine,2024,2,15,10,1,49,22,27,55
Glenavon,2024,3,9,9,8,52,49,3,36
Linfield,2024,4,10,6,10,38,37,1,36
Cliftonville,2024,5,9,5,12,33,32,1,32
Ballymena,2024,6,7,4,15,26,49,-23,25
Glentoran,2024,7,6,6,10,24,32,-8,24
Dungannon,2024,8,2,4,16,14,47,-33,10
Crusaders,2025,1,16,7,3,63,32,31,55
Coleraine,2025,2,14,11,1,45,24,21,53
Glenavon,2025,3,9,10,7,54,45,9,37
Linfield,2025,4,10,5,11,38,38,0,35
Cliftonville,2025,5,10,4,12,34,32,2,34
Ballymena,2025,6,7,5,14,27,49,-22,26
Glentoran,2025,7,6,6,10,24,32,-8,24
Dungannon,2025,8,2,4,16,14,47,-33,10
Crusaders,2026,1,16,7,3,64,33,31,55
Coleraine,2026,2,14,11,1,45,24,21,53
Glenavon,2026,3,9,10,7,54,45,9,37
Linfield,2026,4,10,5,11,37,37,0,35
Cliftonville,2026,5,10,4,12,33,31,2,34
Ballymena,2026,6,7,5,14,28,50,-22,26
Glentoran,2026,7,6,6,10,24,32,-8,24
Dungannon,2026,8,2,4,16,14,47,-33,10
Crusaders,2027,1,17,6,3,62,30,32,57
Coleraine,2027,2,14,11,1,45,24,21,53
Linfield,2027,3,11,5,10,38,36,2,38
Glenavon,2027,4,9,10,7,54,45,9,37
Cliftonville,2027,5,9,4,13,32,32,0,31
Ballymena,2027,6,7,4,15,25,48,-23,25
Glentoran,2027,7,6,6,10,24,32,-8,24
Dungannon,2027,8,2,4,16,14,47,-33,10
Coleraine,2028,1,15,10,1,45,23,22,55
Crusaders,2028,2,16,6,4,63,34,29,54
Linfield,2028,3,11,5,10,39,37,2,38
Glenavon,2028,4,9,9,8,53,45,8,36
Cliftonville,2028,5,9,4,13,33,33,0,31
Ballymena,2028,6,8,4,14,29,49,-20,28
Glentoran,2028,7,6,6,10,24,32,-8,24
Dungannon,2028,8,2,4,16,14,47,-33,10
Crusaders,2029,1,17,6,3,65,32,33,57
Coleraine,2029,2,15,10,1,47,23,24,55
Glenavon,2029,3,9,9,8,53,47,6,36
Linfield,2029,4,10,5,11,38,38,0,35
Cliftonville,2029,5,10,4,12,34,32,2,34
Ballymena,2029,6,7,4,15,27,51,-24,25
Glentoran,2029,7,6,6,10,24,32,-8,24
Dungannon,2029,8,2,4,16,14,47,-33,10
Crusaders,2030,1,17,6,3,63,31,32,57
Coleraine,2030,2,14,11,1,45,24,21,53
Linfield,2030,3,11,5,10,41,38,3,38
Glenavon,2030,4,9,10,7,54,45,9,37
Cliftonville,2030,5,9,4,13,34,35,-1,31
Ballymena,2030,6,7,4,15,26,49,-23,25
Glentoran,2030,7,6,6,10,24,32,-8,24
Dungannon,2030,8,2,4,16,14,47,-33,10
Crusaders,2031,1,16,6,4,61,32,29,54
Coleraine,2031,2,14,11,1,44,23,21,53
Linfield,2031,3,11,5,10,38,36,2,38
Glenavon,2031,4,9,10,7,53,44,9,37
Cliftonville,2031,5,9,4,13,32,32,0,31
Ballymena,2031,6,8,4,14,27,47,-20,28
Glentoran,2031,7,6,6,10,24,32,-8,24
Dungannon,2031,8,2,4,16,14,47,-33,10
Crusaders,2032,1,17,6,3,64,32,32,57
Coleraine,2032,2,15,10,1,46,23,23,55
Linfield,2032,3,11,5,10,39,36,3,38
Glenavon,2032,4,9,9,8,53,46,7,36
Cliftonville,2032,5,9,4,13,32,33,-1,31
Ballymena,2032,6,7,4,15,27,50,-23,25
Glentoran,2032,7,6,6,10,24,32,-8,24
Dungannon,2032,8,2,4,16,14,47,-33,10
Crusaders,2033,1,16,7,3,64,33,31,55
Coleraine,2033,2,14,10,2,45,27,18,52
Glenavon,2033,3,10,9,7,57,45,12,39
Linfield,2033,4,10,6,10,39,38,1,36
Cliftonville,2033,5,9,5,12,34,33,1,32
Ballymena,2033,6,7,5,14,28,50,-22,26
Glentoran,2033,7,6,6,10,24,32,-8,24
Dungannon,2033,8,2,4,16,14,47,-33,10
Crusaders,2034,1,17,6,3,63,30,33,57
Coleraine,2034,2,14,10,2,43,24,19,52
Glenavon,2034,3,10,9,7,54,43,11,39
Linfield,2034,4,10,5,11,37,37,0,35
Cliftonville,2034,5,10,4,12,33,31,2,34
Ballymena,2034,6,7,4,15,25,49,-24,25
Glentoran,2034,7,6,6,10,24,32,-8,24
Dungannon,2034,8,2,4,16,14,47,-33,10
Crusaders,2035,1,16,7,3,62,31,31,55
Coleraine,2035,2,15,10,1,46,22,24,55
Glenavon,2035,3,9,9,8,52,46,6,36
Linfield,2035,4,10,6,10,37,36,1,36
Cliftonville,2035,5,9,5,12,32,31,1,32
Ballymena,2035,6,7,5,14,26,48,-22,26
Glentoran,2035,7,6,6,10,24,32,-8,24
Dungannon,2035,8,2,4,16,14,47,-33,10
Crusaders,2036,1,17,6,3,65,30,35,57
Coleraine,2036,2,15,10,1,45,22,23,55
Glenavon,2036,3,9,9,8,52,45,7,36
Linfield,2036,4,10,6,10,38,37,1,36
Cliftonville,2036,5,9,5,12,33,32,1,32
Ballymena,2036,6,7,4,15,25,51,-26,25
Glentoran,2036,7,6,6,10,24,32,-8,24
Dungannon,2036,8,2,4,16,14,47,-33,10
Crusaders,2037,1,16,6,4,61,32,29,54
Coleraine,2037,2,14,10,2,44,25,19,52
Glenavon,2037,3,10,9,7,55,44,11,39
Linfield,2037,4,11,5,10,38,36,2,38
Cliftonville,2037,5,9,4,13,32,32,0,31
Ballymena,2037,6,8,4,14,27,47,-20,28
Glentoran,2037,7,6,6,10,24,32,-8,24
Dungannon,2037,8,2,4,16,14,47,-33,10
Crusaders,2038,1,17,6,3,63,31,32,57
Coleraine,2038,2,14,10,2,43,23,20,52
Glenavon,2038,3,10,9,7,53,43,10,39
Linfield,2038,4,11,5,10,38,36,2,38
Cliftonville,2038,5,9,4,13,32,32,0,31
Ballymena,2038,6,7,4,15,26,49,-23,25
Glentoran,2038,7,6,6,10,24,32,-8,24
Dungannon,2038,8,2,4,16,14,47,-33,10
Crusaders,2039,1,16,7,3,62,31,31,55
Coleraine,2039,2,14,11,1,44,23,21,53
Glenavon,2039,3,9,10,7,53,44,9,37
Linfield,2039,4,10,6,10,37,36,1,36
Cliftonville,2039,5,9,5,12,32,31,1,32
Ballymena,2039,6,7,5,14,26,48,-22,26
Glentoran,2039,7,6,6,10,24,32,-8,24
Dungannon,2039,8,2,4,16,14,47,-33,10
Crusaders,2040,1,16,7,3,63,32,31,55
Coleraine,2040,2,15,10,1,46,22,24,55
Glenavon,2040,3,9,9,8,52,46,6,36
Linfield,2040,4,10,5,11,38,38,0,35
Cliftonville,2040,5,10,4,12,34,32,2,34
Ballymena,2040,6,7,5,14,27,49,-22,26
Glentoran,2040,7,6,6,10,24,32,-8,24
Dungannon,2040,8,2,4,16,14,47,-33,10
Crusaders,2041,1,17,6,3,65,30,35,57
Coleraine,2041,2,14,10,2,43,23,20,52
Glenavon,2041,3,10,9,7,53,43,10,39
Linfield,2041,4,10,6,10,39,38,1,36
Cliftonville,2041,5,9,5,12,34,33,1,32
Ballymena,2041,6,7,4,15,25,51,-26,25
Glentoran,2041,7,6,6,10,24,32,-8,24
Dungannon,2041,8,2,4,16,14,47,-33,10
Crusaders,2042,1,16,6,4,62,32,30,54
Coleraine,2042,2,14,11,1,43,22,21,53
Glenavon,2042,3,9,10,7,52,43,9,37
Linfield,2042,4,10,5,11,39,39,0,35
Cliftonville,2042,5,10,4,12,35,33,2,34
Ballymena,2042,6,8,4,14,27,48,-21,28
Glentoran,2042,7,6,6,10,24,32,-8,24
Dungannon,2042,8,2,4,16,14,47,-33,10
Crusaders,2043,1,16,7,3,62,31,31,55
Coleraine,2043,2,14,10,2,43,23,20,52
Glenavon,2043,3,10,9,7,53,43,10,39
Linfield,2043,4,11,5,10,40,37,3,38
Cliftonville,2043,5,9,4,13,33,34,-1,31
Ballymena,2043,6,7,5,14,26,48,-22,26
Glentoran,2043,7,6,6,10,24,32,-8,24
Dungannon,2043,8,2,4,16,14,47,-33,10
Coleraine,2044,1,15,10,1,46,24,22,55
Crusaders,2044,2,16,6,4,61,34,27,54
Glenavon,2044,3,9,9,8,54,46,8,36
Linfield,2044,4,10,5,11,37,38,-1,35
Cliftonville,2044,5,10,4,12,34,31,3,34
Ballymena,2044,6,8,4,14,29,47,-18,28
Glentoran,2044,7,6,6,10,24,32,-8,24
Dungannon,2044,8,2,4,16,14,47,-33,10
Crusaders,2045,1,17,6,3,62,30,32,57
Coleraine,2045,2,14,10,2,43,24,19,52
Glenavon,2045,3,10,9,7,54,43,11,39
Linfield,2045,4,10,6,10,38,37,1,36
Cliftonville,2045,5,9,5,12,33,32,1,32
Ballymena,2045,6,7,4,15,25,48,-23,25
Glentoran,2045,7,6,6,10,24,32,-8,24
Dungannon,2045,8,2,4,16,14,47,-33,10
Crusaders,2046,1,17,6,3,62,30,32,57
Coleraine,2046,2,14,10,2,45,26,19,52
Glenavon,2046,3,10,9,7,56,45,11,39
Linfield,2046,4,10,5,11,37,37,0,35
Cliftonville,2046,5,10,4,12,33,31,2,34
Ballymena,2046,6,7,4,15,25,48,-23,25
Glentoran,2046,7,6,6,10,24,32,-8,24
Dungannon,2046,8,2,4,16,14,47,-33,10
Crusaders,2047,1,17,6,3,64,30,34,57
Coleraine,2047,2,15,10,1,44,22,22,55
Glenavon,2047,3,9,9,8,52,44,8,36
Linfield,2047,4,10,5,11,38,38,0,35
Cliftonville,2047,5,10,4,12,34,32,2,34
Ballymena,2047,6,7,4,15,25,50,-25,25
Glentoran,2047,7,6,6,10,24,32,-8,24
Dungannon,2047,8,2,4,16,14,47,-33,10
Crusaders,2048,1,16,6,4,61,33,28,54
Coleraine,2048,2,14,10,2,45,25,20,52
Glenavon,2048,3,10,9,7,55,45,10,39
Linfield,2048,4,10,6,10,37,36,1,36
Cliftonville,2048,5,9,5,12,32,31,1,32
Ballymena,2048,6,8,4,14,28,47,-19,28
Glentoran,2048,7,6,6,10,24,32,-8,24
Dungannon,2048,8,2,4,16,14,47,-33,10
Crusaders,2049,1,16,7,3,62,31,31,55
Coleraine,2049,2,14,11,1,44,23,21,53
Glenavon,2049,3,9,10,7,53,44,9,37
Linfield,2049,4,10,6,10,38,37,1,36
Cliftonville,2049,5,9,5,12,33,32,1,32
Ballymena,2049,6,7,5,14,26,48,-22,26
Glentoran,2049,7,6,6,10,24,32,-8,24
Dungannon,2049,8,2,4,16,14,47,-33,10
Crusaders,2050,1,17,6,3,64,30,34,57
Coleraine,2050,2,14,10,2,43,26,17,52
Glenavon,2050,3,10,9,7,56,43,13,39
Linfield,2050,4,10,6,10,39,38,1,36
Cliftonville,2050,5,9,5,12,34,33,1,32
Ballymena,2050,6,7,4,15,25,50,-25,25
Glentoran,2050,7,6,6,10,24,32,-8,24
Dungannon,2050,8,2,4,16,14,47,-33,10
Crusaders,2051,1,17,6,3,62,30,32,57
Coleraine,2051,2,15,10,1,45,23,22,55
Glenavon,2051,3,9,9,8,53,45,8,36
Linfield,2051,4,10,6,10,37,36,1,36
Cliftonville,2051,5,9,5,12,32,31,1,32
Ballymena,2051,6,7,4,15,25,48,-23,25
Glentoran,2051,7,6,6,10,24,32,-8,24
Dungannon,2051,8,2,4,16,14,47,-33,10
Crusaders,2052,1,16,6,4,61,32,29,54
Coleraine,2052,2,14,10,2,44,25,19,52
Glenavon,2052,3,10,9,7,55,44,11,39
Linfield,2052,4,10,6,10,40,39,1,36
Cliftonville,2052,5,9,5,12,35,34,1,32
Ballymena,2052,6,8,4,14,27,47,-20,28
Glentoran,2052,7,6,6,10,24,32,-8,24
Dungannon,2052,8,2,4,16,14,47,-33,10
Crusaders,2053,1,16,7,3,62,31,31,55
Coleraine,2053,2,15,10,1,46,23,23,55
Glenavon,2053,3,9,9,8,53,46,7,36
Linfield,2053,4,10,6,10,37,36,1,36
Cliftonville,2053,5,9,5,12,32,31,1,32
Ballymena,2053,6,7,5,14,26,48,-22,26
Glentoran,2053,7,6,6,10,24,32,-8,24
Dungannon,2053,8,2,4,16,14,47,-33,10
Crusaders,2054,1,16,6,4,61,31,30,54
Coleraine,2054,2,14,10,2,43,25,18,52
Glenavon,2054,3,10,9,7,55,43,12,39
Linfield,2054,4,10,6,10,37,36,1,36
Cliftonville,2054,5,9,5,12,32,31,1,32
Ballymena,2054,6,8,4,14,26,47,-21,28
Glentoran,2054,7,6,6,10,24,32,-8,24
Dungannon,2054,8,2,4,16,14,47,-33,10
Crusaders,2055,1,16,7,3,62,31,31,55
Coleraine,2055,2,15,10,1,46,23,23,55
Glenavon,2055,3,9,9,8,53,46,7,36
Linfield,2055,4,10,6,10,37,36,1,36
Cliftonville,2055,5,9,5,12,32,31,1,32
Ballymena,2055,6,7,5,14,26,48,-22,26
Glentoran,2055,7,6,6,10,24,32,-8,24
Dungannon,2055,8,2,4,16,14,47,-33,10
Crusaders,2056,1,17,6,3,63,31,32,57
Coleraine,2056,2,14,10,2,45,25,20,52
Glenavon,2056,3,10,9,7,55,45,10,39
Linfield,2056,4,10,5,11,38,38,0,35
Cliftonville,2056,5,10,4,12,34,32,2,34
Ballymena,2056,6,7,4,15,26,49,-23,25
Glentoran,2056,7,6,6,10,24,32,-8,24
Dungannon,2056,8,2,4,16,14,47,-33,10
Crusaders,2057,1,16,7,3,62,31,31,55
Coleraine,2057,2,14,10,2,43,25,18,52
Glenavon,2057,3,10,9,7,55,43,12,39
Linfield,2057,4,10,5,11,37,37,0,35
Cliftonville,2057,5,10,4,12,33,31,2,34
Ballymena,2057,6,7,5,14,26,48,-22,26
Glentoran,2057,7,6,6,10,24,32,-8,24
Dungannon,2057,8,2,4,16,14,47,-33,10
Crusaders,2058,1,16,6,4,63,33,30,54
Coleraine,2058,2,14,10,2,43,23,20,52
Glenavon,2058,3,10,9,7,53,43,10,39
Linfield,2058,4,11,5,10,40,38,2,38
Cliftonville,2058,5,9,4,13,34,34,0,31
Ballymena,2058,6,8,4,14,28,49,-21,28
Glentoran,2058,7,6,6,10,24,32,-8,24
Dungannon,2058,8,2,4,16,14,47,-33,10
Crusaders,2059,1,17,6,3,66,32,34,57
Coleraine,2059,2,15,10,1,46,22,24,55
Linfield,2059,3,11,5,10,38,36,2,38
Glenavon,2059,4,9,9,8,52,46,6,36
Cliftonville,2059,5,9,4,13,32,32,0,31
Ballymena,2059,6,7,4,15,27,52,-25,25
Glentoran,2059,7,6,6,10,24,32,-8,24
Dungannon,2059,8,2,4,16,14,47,-33,10
Crusaders,2060,1,16,6,4,61,31,30,54
Coleraine,2060,2,14,10,2,43,25,18,52
Glenavon,2060,3,10,9,7,55,43,12,39
Linfield,2060,4,10,6,10,37,36,1,36
Cliftonville,2060,5,9,5,12,32,31,1,32
Ballymena,2060,6,8,4,14,26,47,-21,28
Glentoran,2060,7,6,6,10,24,32,-8,24
Dungannon,2060,8,2,4,16,14,47,-33,10
Crusaders,2061,1,16,7,3,62,31,31,55
Coleraine,2061,2,14,11,1,45,24,21,53
Linfield,2061,3,11,5,10,38,36,2,38
Glenavon,2061,4,9,10,7,54,45,9,37
Cliftonville,2061,5,9,4,13,32,32,0,31
Ballymena,2061,6,7,5,14,26,48,-22,26
Glentoran,2061,7,6,6,10,24,32,-8,24
Dungannon,2061,8,2,4,16,14,47,-33,10
Crusaders,2062,1,16,7,3,62,31,31,55
Coleraine,2062,2,14,10,2,45,25,20,52
Glenavon,2062,3,10,9,7,55,45,10,39
Linfield,2062,4,10,6,10,38,37,1,36
Cliftonville,2062,5,9,5,12,33,32,1,32
Ballymena,2062,6,7,5,14,26,48,-22,26
Glentoran,2062,7,6,6,10,24,32,-8,24
Dungannon,2062,8,2,4,16,14,47,-33,10
Crusaders,2063,1,17,6,3,64,30,34,57
Coleraine,2063,2,14,11,1,45,24,21,53
Glenavon,2063,3,9,10,7,54,45,9,37
Linfield,2063,4,10,6,10,41,40,1,36
Cliftonville,2063,5,9,5,12,36,35,1,32
Ballymena,2063,6,7,4,15,25,50,-25,25
Glentoran,2063,7,6,6,10,24,32,-8,24
Dungannon,2063,8,2,4,16,14,47,-33,10
Crusaders,2064,1,17,6,3,63,31,32,57
Coleraine,2064,2,14,10,2,44,24,20,52
Glenavon,2064,3,10,9,7,54,44,10,39
Linfield,2064,4,10,6,10,38,37,1,36
Cliftonville,2064,5,9,5,12,33,32,1,32
Ballymena,2064,6,7,4,15,26,49,-23,25
Glentoran,2064,7,6,6,10,24,32,-8,24
Dungannon,2064,8,2,4,16,14,47,-33,10
Crusaders,2065,1,16,6,4,62,32,30,54
Coleraine,2065,2,14,11,1,44,23,21,53
Glenavon,2065,3,9,10,7,53,44,9,37
Linfield,2065,4,10,6,10,37,36,1,36
Cliftonville,2065,5,9,5,12,32,31,1,32
Ballymena,2065,6,8,4,14,27,48,-21,28
Glentoran,2065,7,6,6,10,24,32,-8,24
Dungannon,2065,8,2,4,16,14,47,-33,10
Crusaders,2066,1,16,6,4,61,31,30,54
Coleraine,2066,2,14,10,2,43,23,20,52
Glenavon,2066,3,10,9,7,53,43,10,39
Linfield,2066,4,11,5,10,42,36,6,38
Cliftonville,2066,5,9,4,13,32,36,-4,31
Ballymena,2066,6,8,4,14,26,47,-21,28
Glentoran,2066,7,6,6,10,24,32,-8,24
Dungannon,2066,8,2,4,16,14,47,-33,10
Crusaders,2067,1,17,6,3,62,30,32,57
Coleraine,2067,2,14,11,1,44,23,21,53
Linfield,2067,3,11,5,10,38,36,2,38
Glenavon,2067,4,9,10,7,53,44,9,37
Cliftonville,2067,5,9,4,13,32,32,0,31
Ballymena,2067,6,7,4,15,25,48,-23,25
Glentoran,2067,7,6,6,10,24,32,-8,24
Dungannon,2067,8,2,4,16,14,47,-33,10
Crusaders,2068,1,17,6,3,65,31,34,57
Coleraine,2068,2,14,11,1,43,22,21,53
Glenavon,2068,3,9,10,7,52,43,9,37
Linfield,2068,4,10,5,11,37,37,0,35
Cliftonville,2068,5,10,4,12,33,31,2,34
Ballymena,2068,6,7,4,15,26,51,-25,25
Glentoran,2068,7,6,6,10,24,32,-8,24
Dungannon,2068,8,2,4,16,14,47,-33,10
Crusaders,2069,1,17,6,3,64,31,33,57
Coleraine,2069,2,14,10,2,46,26,20,52
Glenavon,2069,3,10,9,7,56,46,10,39
Linfield,2069,4,10,6,10,37,36,1,36
Cliftonville,2069,5,9,5,12,32,31,1,32
Ballymena,2069,6,7,4,15,26,50,-24,25
Glentoran,2069,7,6,6,10,24,32,-8,24
Dungannon,2069,8,2,4,16,14,47,-33,10
Crusaders,2070,1,16,6,4,63,33,30,54
Coleraine,2070,2,14,10,2,44,24,20,52
Glenavon,2070,3,10,9,7,54,44,10,39
Linfield,2070,4,11,5,10,39,37,2,38
Cliftonville,2070,5,9,4,13,33,33,0,31
Ballymena,2070,6,8,4,14,28,49,-21,28
Glentoran,2070,7,6,6,10,24,32,-8,24
Dungannon,2070,8,2,4,16,14,47,-33,10
Crusaders,2071,1,16,6,4,63,34,29,54
Coleraine,2071,2,14,11,1,45,24,21,53
Linfield,2071,3,11,5,10,38,36,2,38
Glenavon,2071,4,9,10,7,54,45,9,37
Cliftonville,2071,5,9,4,13,32,32,0,31
Ballymena,2071,6,8,4,14,29,49,-20,28
Glentoran,2071,7,6,6,10,24,32,-8,24
Dungannon,2071,8,2,4,16,14,47,-33,10
Crusaders,2072,1,16,7,3,62,31,31,55
Coleraine,2072,2,14,10,2,44,24,20,52
Glenavon,2072,3,10,9,7,54,44,10,39
Linfield,2072,4,10,6,10,38,37,1,36
Cliftonville,2072,5,9,5,12,33,32,1,32
Ballymena,2072,6,7,5,14,26,48,-22,26
Glentoran,2072,7,6,6,10,24,32,-8,24
Dungannon,2072,8,2,4,16,14,47,-33,10
Crusaders,2073,1,16,7,3,62,31,31,55
Coleraine,2073,2,15,10,1,45,22,23,55
Linfield,2073,3,11,5,10,40,36,4,38
Glenavon,2073,4,9,9,8,52,45,7,36
Cliftonville,2073,5,9,4,13,32,34,-2,31
Ballymena,2073,6,7,5,14,26,48,-22,26
Glentoran,2073,7,6,6,10,24,32,-8,24
Dungannon,2073,8,2,4,16,14,47,-33,10
Crusaders,2074,1,16,7,3,62,31,31,55
Coleraine,2074,2,15,10,1,45,23,22,55
Linfield,2074,3,11,5,10,41,39,2,38
Glenavon,2074,4,9,9,8,53,45,8,36
Cliftonville,2074,5,9,4,13,35,35,0,31
Ballymena,2074,6,7,5,14,26,48,-22,26
Glentoran,2074,7,6,6,10,24,32,-8,24
Dungannon,2074,8,2,4,16,14,47,-33,10
Crusaders,2075,1,16,7,3,63,32,31,55
Coleraine,2075,2,14,10,2,44,24,20,52
Glenavon,2075,3,10,9,7,54,44,10,39
Linfield,2075,4,11,5,10,38,36,2,38
Cliftonville,2075,5,9,4,13,32,32,0,31
Ballymena,2075,6,7,5,14,27,49,-22,26
Glentoran,2075,7,6,6,10,24,32,-8,24
Dungannon,2075,8,2,4,16,14,47,-33,10
Crusaders,2076,1,17,6,3,63,31,32,57
Coleraine,2076,2,14,10,2,43,23,20,52
Glenavon,2076,3,10,9,7,53,43,10,39
Linfield,2076,4,10,6,10,38,37,1,36
Cliftonville,2076,5,9,5,12,33,32,1,32
Ballymena,2076,6,7,4,15,26,49,-23,25
Glentoran,2076,7,6,6,10,24,32,-8,24
Dungannon,2076,8,2,4,16,14,47,-33,10
Crusaders,2077,1,16,7,3,64,33,31,55
Coleraine,2077,2,14,10,2,43,24,19,52
Glenavon,2077,3,10,9,7,54,43,11,39
Linfield,2077,4,11,5,10,39,36,3,38
Cliftonville,2077,5,9,4,13,32,33,-1,31
Ballymena,2077,6,7,5,14,28,50,-22,26
Glentoran,2077,7,6,6,10,24,32,-8,24
Dungannon,2077,8,2,4,16,14,47,-33,10
Crusaders,2078,1,17,6,3,64,32,32,57
Coleraine,2078,2,15,10,1,47,24,23,55
Glenavon,2078,3,9,9,8,54,47,7,36
Linfield,2078,4,10,5,11,38,38,0,35
Cliftonville,2078,5,10,4,12,34,32,2,34
Ballymena,2078,6,7,4,15,27,50,-23,25
Glentoran,2078,7,6,6,10,24,32,-8,24
Dungannon,2078,8,2,4,16,14,47,-33,10
Crusaders,2079,1,17,6,3,64,31,33,57
Coleraine,2079,2,14,10,2,44,27,17,52
Glenavon,2079,3,10,9,7,57,44,13,39
Linfield,2079,4,11,5,10,39,36,3,38
Cliftonville,2079,5,9,4,13,32,33,-1,31
Ballymena,2079,6,7,4,15,26,50,-24,25
Glentoran,2079,7,6,6,10,24,32,-8,24
Dungannon,2079,8,2,4,16,14,47,-33,10
Coleraine,2080,1,15,10,1,46,24,22,55
Crusaders,2080,2,16,6,4,62,34,28,54
Glenavon,2080,3,9,9,8,54,46,8,36
Linfield,2080,4,10,5,11,38,40,-2,35
Cliftonville,2080,5,10,4,12,36,32,4,34
Ballymena,2080,6,8,4,14,29,48,-19,28
Glentoran,2080,7,6,6,10,24,32,-8,24
Dungannon,2080,8,2,4,16,14,47,-33,10
Crusaders,2081,1,17,6,3,66,30,36,57
Coleraine,2081,2,15,10,1,45,23,22,55
Glenavon,2081,3,9,9,8,53,45,8,36
Linfield,2081,4,10,6,10,37,36,1,36
Cliftonville,2081,5,9,5,12,32,31,1,32
Ballymena,2081,6,7,4,15,25,52,-27,25
Glentoran,2081,7,6,6,10,24,32,-8,24
Dungannon,2081,8,2,4,16,14,47,-33,10
Coleraine,2082,1,15,10,1,45,23,22,55
Crusaders,2082,2,16,6,4,62,32,30,54
Glenavon,2082,3,9,9,8,53,45,8,36
Linfield,2082,4,10,5,11,37,37,0,35
Cliftonville,2082,5,10,4,12,33,31,2,34
Ballymena,2082,6,8,4,14,27,48,-21,28
Glentoran,2082,7,6,6,10,24,32,-8,24
Dungannon,2082,8,2,4,16,14,47,-33,10
Crusaders,2083,1,16,7,3,62,31,31,55
Coleraine,2083,2,14,10,2,44,24,20,52
Glenavon,2083,3,10,9,7,54,44,10,39
Linfield,2083,4,10,5,11,38,38,0,35
Cliftonville,2083,5,10,4,12,34,32,2,34
Ballymena,2083,6,7,5,14,26,48,-22,26
Glentoran,2083,7,6,6,10,24,32,-8,24
Dungannon,2083,8,2,4,16,14,47,-33,10
Crusaders,2084,1,16,7,3,62,31,31,55
Coleraine,2084,2,15,10,1,45,23,22,55
Linfield,2084,3,11,5,10,38,36,2,38
Glenavon,2084,4,9,9,8,53,45,8,36
Cliftonville,2084,5,9,4,13,32,32,0,31
Ballymena,2084,6,7,5,14,26,48,-22,26
Glentoran,2084,7,6,6,10,24,32,-8,24
Dungannon,2084,8,2,4,16,14,47,-33,10
Crusaders,2085,1,16,6,4,61,31,30,54
Coleraine,2085,2,14,10,2,45,25,20,52
Glenavon,2085,3,10,9,7,55,45,10,39
Linfield,2085,4,10,5,11,37,38,-1,35
Cliftonville,2085,5,10,4,12,34,31,3,34
Ballymena,2085,6,8,4,14,26,47,-21,28
Glentoran,2085,7,6,6,10,24,32,-8,24
Dungannon,2085,8,2,4,16,14,47,-33,10
Coleraine,2086,1,15,10,1,46,23,23,55
Crusaders,2086,2,16,6,4,62,33,29,54
Glenavon,2086,3,9,9,8,53,46,7,36
Linfield,2086,4,10,6,10,39,38,1,36
Cliftonville,2086,5,9,5,12,34,33,1,32
Ballymena,2086,6,8,4,14,28,48,-20,28
Glentoran,2086,7,6,6,10,24,32,-8,24
Dungannon,2086,8,2,4,16,14,47,-33,10
Crusaders,2087,1,16,7,3,62,31,31,55
Coleraine,2087,2,15,10,1,44,22,22,55
Glenavon,2087,3,9,9,8,52,44,8,36
Linfield,2087,4,10,5,11,37,37,0,35
Cliftonville,2087,5,10,4,12,33,31,2,34
Ballymena,2087,6,7,5,14,26,48,-22,26
Glentoran,2087,7,6,6,10,24,32,-8,24
Dungannon,2087,8,2,4,16,14,47,-33,10
Crusaders,2088,1,17,6,3,63,30,33,57
Coleraine,2088,2,15,10,1,46,24,22,55
Glenavon,2088,3,9,9,8,54,46,8,36
Linfield,2088,4,10,6,10,39,38,1,36
Cliftonville,2088,5,9,5,12,34,33,1,32
Ballymena,2088,6,7,4,15,25,49,-24,25
Glentoran,2088,7,6,6,10,24,32,-8,24
Dungannon,2088,8,2,4,16,14,47,-33,10
Crusaders,2089,1,16,7,3,63,32,31,55
Coleraine,2089,2,14,11,1,45,24,21,53
Glenavon,2089,3,9,10,7,54,45,9,37
Linfield,2089,4,10,5,11,37,38,-1,35
Cliftonville,2089,5,10,4,12,34,31,3,34
Ballymena,2089,6,7,5,14,27,49,-22,26
Glentoran,2089,7,6,6,10,24,32,-8,24
Dungannon,2089,8,2,4,16,14,47,-33,10
Crusaders,2090,1,16,7,3,63,32,31,55
Coleraine,2090,2,14,11,1,43,22,21,53
Linfield,2090,3,11,5,10,42,39,3,38
Glenavon,2090,4,9,10,7,52,43,9,37
Cliftonville,2090,5,9,4,13,35,36,-1,31
Ballymena,2090,6,7,5,14,27,49,-22,26
Glentoran,2090,7,6,6,10,24,32,-8,24
Dungannon,2090,8,2,4,16,14,47,-33,10
Crusaders,2091,1,16,7,3,63,32,31,55
Coleraine,2091,2,14,11,1,45,24,21,53
Linfield,2091,3,11,5,10,38,36,2,38
Glenavon,2091,4,9,10,7,54,45,9,37
Cliftonville,2091,5,9,4,13,32,32,0,31
Ballymena,2091,6,7,5,14,27,49,-22,26
Glentoran,2091,7,6,6,10,24,32,-8,24
Dungannon,2091,8,2,4,16,14,47,-33,10
Crusaders,2092,1,17,6,3,64,31,33,57
Coleraine,2092,2,14,11,1,44,23,21,53
Glenavon,2092,3,9,10,7,53,44,9,37
Linfield,2092,4,10,5,11,37,37,0,35
Cliftonville,2092,5,10,4,12,33,31,2,34
Ballymena,2092,6,7,4,15,26,50,-24,25
Glentoran,2092,7,6,6,10,24,32,-8,24
Dungannon,2092,8,2,4,16,14,47,-33,10
Crusaders,2093,1,16,7,3,62,31,31,55
Coleraine,2093,2,14,10,2,43,24,19,52
Glenavon,2093,3,10,9,7,54,43,11,39
Linfield,2093,4,10,6,10,37,36,1,36
Cliftonville,2093,5,9,5,12,32,31,1,32
Ballymena,2093,6,7,5,14,26,48,-22,26
Glentoran,2093,7,6,6,10,24,32,-8,24
Dungannon,2093,8,2,4,16,14,47,-33,10
Crusaders,2094,1,16,7,3,62,31,31,55
Coleraine,2094,2,15,10,1,47,22,25,55
Linfield,2094,3,11,5,10,39,36,3,38
Glenavon,2094,4,9,9,8,52,47,5,36
Cliftonville,2094,5,9,4,13,32,33,-1,31
Ballymena,2094,6,7,5,14,26,48,-22,26
Glentoran,2094,7,6,6,10,24,32,-8,24
Dungannon,2094,8,2,4,16,14,47,-33,10
Crusaders,2095,1,16,6,4,62,32,30,54
Coleraine,2095,2,14,10,2,44,25,19,52
Glenavon,2095,3,10,9,7,55,44,11,39
Linfield,2095,4,10,6,10,40,39,1,36
Cliftonville,2095,5,9,5,12,35,34,1,32
Ballymena,2095,6,8,4,14,27,48,-21,28
Glentoran,2095,7,6,6,10,24,32,-8,24
Dungannon,2095,8,2,4,16,14,47,-33,10
Crusaders,2096,1,17,6,3,64,31,33,57
Coleraine,2096,2,15,10,1,46,24,22,55
Glenavon,2096,3,9,9,8,54,46,8,36
Linfield,2096,4,10,5,11,37,37,0,35
Cliftonville,2096,5,10,4,12,33,31,2,34
Ballymena,2096,6,7,4,15,26,50,-24,25
Glentoran,2096,7,6,6,10,24,32,-8,24
Dungannon,2096,8,2,4,16,14,47,-33,10
Crusaders,2097,1,17,6,3,63,31,32,57
Coleraine,2097,2,14,10,2,43,24,19,52
Glenavon,2097,3,10,9,7,54,43,11,39
Linfield,2097,4,11,5,10,39,37,2,38
Cliftonville,2097,5,9,4,13,33,33,0,31
Ballymena,2097,6,7,4,15,26,49,-23,25
Glentoran,2097,7,6,6,10,24,32,-8,24
Dungannon,2097,8,2,4,16,14,47,-33,10
Crusaders,2098,1,17,6,3,63,31,32,57
Coleraine,2098,2,14,10,2,44,26,18,52
Glenavon,2098,3,10,9,7,56,44,12,39
Linfield,2098,4,11,5,10,38,36,2,38
Cliftonville,2098,5,9,4,13,32,32,0,31
Ballymena,2098,6,7,4,15,26,49,-23,25
Glentoran,2098,7,6,6,10,24,32,-8,24
Dungannon,2098,8,2,4,16,14,47,-33,10
Crusaders,2099,1,17,6,3,65,30,35,57
Coleraine,2099,2,15,10,1,45,22,23,55
Glenavon,2099,3,9,9,8,52,45,7,36
Linfield,2099,4,10,5,11,38,40,-2,35
Cliftonville,2099,5,10,4,12,36,32,4,34
Ballymena,2099,6,7,4,15,25,51,-26,25
Glentoran,2099,7,6,6,10,24,32,-8,24
Dungannon,2099,8,2,4,16,14,47,-33,10
Crusaders,2100,1,17,6,3,64,30,34,57
Coleraine,2100,2,15,10,1,45,23,22,55
Linfield,2100,3,11,5,10,38,36,2,38
Glenavon,2100,4,9,9,8,53,45,8,36
Cliftonville,2100,5,9,4,13,32,32,0,31
Ballymena,2100,6,7,4,15,25,50,-25,25
Glentoran,2100,7,6,6,10,24,32,-8,24
Dungannon,2100,8,2,4,16,14,47,-33,10
Crusaders,2101,1,17,6,3,64,30,34,57
Coleraine,2101,2,14,11,1,44,23,21,53
Linfield,2101,3,11,5,10,40,36,4,38
Glenavon,2101,4,9,10,7,53,44,9,37
Cliftonville,2101,5,9,4,13,32,34,-2,31
Ballymena,2101,6,7,4,15,25,50,-25,25
Glentoran,2101,7,6,6,10,24,32,-8,24
Dungannon,2101,8,2,4,16,14,47,-33,10
Crusaders,2102,1,17,6,3,62,30,32,57
Coleraine,2102,2,14,11,1,45,24,21,53
Glenavon,2102,3,9,10,7,54,45,9,37
Linfield,2102,4,10,6,10,38,37,1,36
Cliftonville,2102,5,9,5,12,33,32,1,32
Ballymena,2102,6,7,4,15,25,48,-23,25
Glentoran,2102,7,6,6,10,24,32,-8,24
Dungannon,2102,8,2,4,16,14,47,-33,10
Crusaders,2103,1,17,6,3,62,30,32,57
Coleraine,2103,2,14,10,2,43,25,18,52
Glenavon,2103,3,10,9,7,55,43,12,39
Linfield,2103,4,10,6,10,38,37,1,36
Cliftonville,2103,5,9,5,12,33,32,1,32
Ballymena,2103,6,7,4,15,25,48,-23,25
Glentoran,2103,7,6,6,10,24,32,-8,24
Dungannon,2103,8,2,4,16,14,47,-33,10
Crusaders,2104,1,17,6,3,65,30,35,57
Coleraine,2104,2,15,10,1,45,23,22,55
Linfield,2104,3,11,5,10,41,39,2,38
Glenavon,2104,4,9,9,8,53,45,8,36
Cliftonville,2104,5,9,4,13,35,35,0,31
Ballymena,2104,6,7,4,15,25,51,-26,25
Glentoran,2104,7,6,6,10,24,32,-8,24
Dungannon,2104,8,2,4,16,14,47,-33,10
Crusaders,2105,1,16,7,3,62,31,31,55
Coleraine,2105,2,14,10,2,43,25,18,52
Glenavon,2105,3,10,9,7,55,43,12,39
Linfield,2105,4,11,5,10,39,36,3,38
Cliftonville,2105,5,9,4,13,32,33,-1,31
Ballymena,2105,6,7,5,14,26,48,-22,26
Glentoran,2105,7,6,6,10,24,32,-8,24
Dungannon,2105,8,2,4,16,14,47,-33,10
Crusaders,2106,1,16,7,3,62,31,31,55
Coleraine,2106,2,15,10,1,46,24,22,55
Linfield,2106,3,11,5,10,39,36,3,38
Glenavon,2106,4,9,9,8,54,46,8,36
Cliftonville,2106,5,9,4,13,32,33,-1,31
Ballymena,2106,6,7,5,14,26,48,-22,26
Glentoran,2106,7,6,6,10,24,32,-8,24
Dungannon,2106,8,2,4,16,14,47,-33,10
Coleraine,2107,1,15,10,1,47,25,22,55
Crusaders,2107,2,16,6,4,62,33,29,54
Glenavon,2107,3,9,9,8,55,47,8,36
Linfield,2107,4,10,5,11,37,37,0,35
Cliftonville,2107,5,10,4,12,33,31,2,34
Ballymena,2107,6,8,4,14,28,48,-20,28
Glentoran,2107,7,6,6,10,24,32,-8,24
Dungannon,2107,8,2,4,16,14,47,-33,10
Crusaders,2108,1,17,6,3,62,30,32,57
Coleraine,2108,2,15,10,1,45,22,23,55
Linfield,2108,3,11,5,10,39,37,2,38
Glenavon,2108,4,9,9,8,52,45,7,36
Cliftonville,2108,5,9,4,13,33,33,0,31
Ballymena,2108,6,7,4,15,25,48,-23,25
Glentoran,2108,7,6,6,10,24,32,-8,24
Dungannon,2108,8,2,4,16,14,47,-33,10
Crusaders,2109,1,17,6,3,62,30,32,57
Coleraine,2109,2,14,10,2,45,25,20,52
Glenavon,2109,3,10,9,7,55,45,10,39
Linfield,2109,4,11,5,10,39,36,3,38
Cliftonville,2109,5,9,4,13,32,33,-1,31
Ballymena,2109,6,7,4,15,25,48,-23,25
Glentoran,2109,7,6,6,10,24,32,-8,24
Dungannon,2109,8,2,4,16,14,47,-33,10
Crusaders,2110,1,17,6,3,66,32,34,57
Coleraine,2110,2,14,11,1,45,24,21,53
Glenavon,2110,3,9,10,7,54,45,9,37
Linfield,2110,4,10,5,11,37,39,-2,35
Cliftonville,2110,5,10,4,12,35,31,4,34
Ballymena,2110,6,7,4,15,27,52,-25,25
Glentoran,2110,7,6,6,10,24,32,-8,24
Dungannon,2110,8,2,4,16,14,47,-33,10
Crusaders,2111,1,16,6,4,62,32,30,54
Coleraine,2111,2,14,10,2,44,25,19,52
Glenavon,2111,3,10,9,7,55,44,11,39
Linfield,2111,4,11,5,10,40,37,3,38
Cliftonville,2111,5,9,4,13,33,34,-1,31
Ballymena,2111,6,8,4,14,27,48,-21,28
Glentoran,2111,7,6,6,10,24,32,-8,24
Dungannon,2111,8,2,4,16,14,47,-33,10
Crusaders,2112,1,16,7,3,63,32,31,55
Coleraine,2112,2,14,11,1,44,23,21,53
Glenavon,2112,3,9,10,7,53,44,9,37
Linfield,2112,4,10,5,11,39,39,0,35
Cliftonville,2112,5,10,4,12,35,33,2,34
Ballymena,2112,6,7,5,14,27,49,-22,26
Glentoran,2112,7,6,6,10,24,32,-8,24
Dungannon,2112,8,2,4,16,14,47,-33,10
Crusaders,2113,1,17,6,3,66,32,34,57
Coleraine,2113,2,14,10,2,43,23,20,52
Glenavon,2113,3,10,9,7,53,43,10,39
Linfield,2113,4,10,6,10,37,36,1,36
Cliftonville,2113,5,9,5,12,32,31,1,32
Ballymena,2113,6,7,4,15,27,52,-25,25
Glentoran,2113,7,6,6,10,24,32,-8,24
Dungannon,2113,8,2,4,16,14,47,-33,10
Coleraine,2114,1,15,10,1,46,22,24,55
Crusaders,2114,2,16,6,4,61,31,30,54
Linfield,2114,3,11,5,10,38,36,2,38
Glenavon,2114,4,9,9,8,52,46,6,36
Cliftonville,2114,5,9,4,13,32,32,0,31
Ballymena,2114,6,8,4,14,26,47,-21,28
Glentoran,2114,7,6,6,10,24,32,-8,24
Dungannon,2114,8,2,4,16,14,47,-33,10
Crusaders,2115,1,17,6,3,63,31,32,57
Coleraine,2115,2,14,11,1,44,23,21,53
Glenavon,2115,3,9,10,7,53,44,9,37
Linfield,2115,4,10,6,10,38,37,1,36
Cliftonville,2115,5,9,5,12,33,32,1,32
Ballymena,2115,6,7,4,15,26,49,-23,25
Glentoran,2115,7,6,6,10,24,32,-8,24
Dungannon,2115,8,2,4,16,14,47,-33,10
Crusaders,2116,1,17,6,3,64,32,32,57
Coleraine,2116,2,15,10,1,45,22,23,55
Glenavon,2116,3,9,9,8,52,45,7,36
Linfield,2116,4,10,5,11,37,40,-3,35
Cliftonville,2116,5,10,4,12,36,31,5,34
Ballymena,2116,6,7,4,15,27,50,-23,25
Glentoran,2116,7,6,6,10,24,32,-8,24
Dungannon,2116,8,2,4,16,14,47,-33,10
Crusaders,2117,1,16,7,3,62,31,31,55
Coleraine,2117,2,14,10,2,43,24,19,52
Glenavon,2117,3,10,9,7,54,43,11,39
Linfield,2117,4,10,6,10,37,36,1,36
Cliftonville,2117,5,9,5,12,32,31,1,32
Ballymena,2117,6,7,5,14,26,48,-22,26
Glentoran,2117,7,6,6,10,24,32,-8,24
Dungannon,2117,8,2,4,16,14,47,-33,10
Crusaders,2118,1,16,6,4,63,34,29,54
Coleraine,2118,2,14,10,2,44,24,20,52
Glenavon,2118,3,10,9,7,54,44,10,39
Linfield,2118,4,11,5,10,39,37,2,38
Cliftonville,2118,5,9,4,13,33,33,0,31
Ballymena,2118,6,8,4,14,29,49,-20,28
Glentoran,2118,7,6,6,10,24,32,-8,24
Dungannon,2118,8,2,4,16,14,47,-33,10
Crusaders,2119,1,17,6,3,63,31,32,57
Coleraine,2119,2,14,10,2,45,25,20,52
Glenavon,2119,3,10,9,7,55,45,10,39
Linfield,2119,4,10,5,11,38,38,0,35
Cliftonville,2119,5,10,4,12,34,32,2,34
Ballymena,2119,6,7,4,15,26,49,-23,25
Glentoran,2119,7,6,6,10,24,32,-8,24
Dungannon,2119,8,2,4,16,14,47,-33,10
Crusaders,2120,1,17,6,3,65,31,34,57
Coleraine,2120,2,14,10,2,44,24,20,52
Glenavon,2120,3,10,9,7,54,44,10,39
Linfield,2120,4,11,5,10,39,37,2,38
Cliftonville,2120,5,9,4,13,33,33,0,31
Ballymena,2120,6,7,4,15,26,51,-25,25
Glentoran,2120,7,6,6,10,24,32,-8,24
Dungannon,2120,8,2,4,16,14,47,-33,10
Crusaders,2121,1,17,6,3,62,30,32,57
Coleraine,2121,2,14,11,1,45,24,21,53
Glenavon,2121,3,9,10,7,54,45,9,37
Linfield,2121,4,10,5,11,39,39,0,35
Cliftonville,2121,5,10,4,12,35,33,2,34
Ballymena,2121,6,7,4,15,25,48,-23,25
Glentoran,2121,7,6,6,10,24,32,-8,24
Dungannon,2121,8,2,4,16,14,47,-33,10
Crusaders,2122,1,16,7,3,62,31,31,55
Coleraine,2122,2,14,10,2,43,25,18,52
Glenavon,2122,3,10,9,7,55,43,12,39
Linfield,2122,4,11,5,10,38,36,2,38
Cliftonville,2122,5,9,4,13,32,32,0,31
Ballymena,2122,6,7,5,14,26,48,-22,26
Glentoran,2122,7,6,6,10,24,32,-8,24
Dungannon,2122,8,2,4,16,14,47,-33,10
Crusaders,2123,1,17,6,3,66,30,36,57
Coleraine,2123,2,14,10,2,44,24,20,52
Glenavon,2123,3,10,9,7,54,44,10,39
Linfield,2123,4,10,5,11,38,38,0,35
Cliftonville,2123,5,10,4,12,34,32,2,34
Ballymena,2123,6,7,4,15,25,52,-27,25
Glentoran,2123,7,6,6,10,24,32,-8,24
Dungannon,2123,8,2,4,16,14,47,-33,10
Coleraine,2124,1,15,10,1,46,24,22,55
Crusaders,2124,2,16,6,4,61,32,29,54
Linfield,2124,3,11,5,10,39,36,3,38
Glenavon,2124,4,9,9,8,54,46,8,36
Cliftonville,2124,5,9,4,13,32,33,-1,31
Ballymena,2124,6,8,4,14,27,47,-20,28
Glentoran,2124,7,6,6,10,24,32,-8,24
Dungannon,2124,8,2,4,16,14,47,-33,10
Crusaders,2125,1,17,6,3,65,32,33,57
Coleraine,2125,2,14,10,2,43,26,17,52
Glenavon,2125,3,10,9,7,56,43,13,39
Linfield,2125,4,10,6,10,37,36,1,36
Cliftonville,2125,5,9,5,12,32,31,1,32
Ballymena,2125,6,7,4,15,27,51,-24,25
Glentoran,2125,7,6,6,10,24,32,-8,24
Dungannon,2125,8,2,4,16,14,47,-33,10
Crusaders,2126,1,16,6,4,63,33,30,54
Coleraine,2126,2,14,10,2,44,24,20,52
Glenavon,2126,3,10,9,7,54,44,10,39
Linfield,2126,4,10,5,11,38,38,0,35
Cliftonville,2126,5,10,4,12,34,32,2,34
Ballymena,2126,6,8,4,14,28,49,-21,28
Glentoran,2126,7,6,6,10,24,32,-8,24
Dungannon,2126,8,2,4,16,14,47,-33,10
Crusaders,2127,1,17,6,3,66,32,34,57
Coleraine,2127,2,14,10,2,43,23,20,52
Glenavon,2127,3,10,9,7,53,43,10,39
Linfield,2127,4,11,5,10,39,36,3,38
Cliftonville,2127,5,9,4,13,32,33,-1,31
Ballymena,2127,6,7,4,15,27,52,-25,25
Glentoran,2127,7,6,6,10,24,32,-8,24
Dungannon,2127,8,2,4,16,14,47,-33,10
Crusaders,2128,1,17,6,3,63,31,32,57
Coleraine,2128,2,14,11,1,43,22,21,53
Linfield,2128,3,11,5,10,40,36,4,38
Glenavon,2128,4,9,10,7,52,43,9,37
Cliftonville,2128,5,9,4,13,32,34,-2,31
Ballymena,2128,6,7,4,15,26,49,-23,25
Glentoran,2128,7,6,6,10,24,32,-8,24
Dungannon,2128,8,2,4,16,14,47,-33,10
Crusaders,2129,1,17,6,3,64,31,33,57
Coleraine,2129,2,14,10,2,44,25,19,52
Glenavon,2129,3,10,9,7,55,44,11,39
Linfield,2129,4,10,5,11,37,37,0,35
Cliftonville,2129,5,10,4,12,33,31,2,34
Ballymena,2129,6,7,4,15,26,50,-24,25
Glentoran,2129,7,6,6,10,24,32,-8,24
Dungannon,2129,8,2,4,16,14,47,-33,10
Crusaders,2130,1,16,7,3,62,31,31,55
Coleraine,2130,2,15,10,1,44,22,22,55
Glenavon,2130,3,9,9,8,52,44,8,36
Linfield,2130,4,10,5,11,37,37,0,35
Cliftonville,2130,5,10,4,12,33,31,2,34
Ballymena,2130,6,7,5,14,26,48,-22,26
Glentoran,2130,7,6,6,10,24,32,-8,24
Dungannon,2130,8,2,4,16,14,47,-33,10
Crusaders,2131,1,16,7,3,62,31,31,55
Coleraine,2131,2,14,10,2,44,24,20,52
Glenavon,2131,3,10,9,7,54,44,10,39
Linfield,2131,4,10,5,11,37,37,0,35
Cliftonville,2131,5,10,4,12,33,31,2,34
Ballymena,2131,6,7,5,14,26,48,-22,26
Glentoran,2131,7,6,6,10,24,32,-8,24
Dungannon,2131,8,2,4,16,14,47,-33,10
Crusaders,2132,1,17,6,3,66,30,36,57
Coleraine,2132,2,14,10,2,44,24,20,52
Glenavon,2132,3,10,9,7,54,44,10,39
Linfield,2132,4,10,6,10,37,36,1,36
Cliftonville,2132,5,9,5,12,32,31,1,32
Ballymena,2132,6,7,4,15,25,52,-27,25
Glentoran,2132,7,6,6,10,24,32,-8,24
Dungannon,2132,8,2,4,16,14,47,-33,10
Crusaders,2133,1,16,7,3,63,32,31,55
Coleraine,2133,2,14,10,2,43,25,18,52
Glenavon,2133,3,10,9,7,55,43,12,39
Linfield,2133,4,11,5,10,38,36,2,38
Cliftonville,2133,5,9,4,13,32,32,0,31
Ballymena,2133,6,7,5,14,27,49,-22,26
Glentoran,2133,7,6,6,10,24,32,-8,24
Dungannon,2133,8,2,4,16,14,47,-33,10
Coleraine,2134,1,15,10,1,45,23,22,55
Crusaders,2134,2,16,6,4,61,31,30,54
Glenavon,2134,3,9,9,8,53,45,8,36
Linfield,2134,4,10,5,11,37,37,0,35
Cliftonville,2134,5,10,4,12,33,31,2,34
Ballymena,2134,6,8,4,14,26,47,-21,28
Glentoran,2134,7,6,6,10,24,32,-8,24
Dungannon,2134,8,2,4,16,14,47,-33,10
Crusaders,2135,1,16,6,4,63,34,29,54
Coleraine,2135,2,14,11,1,44,23,21,53
Glenavon,2135,3,9,10,7,53,44,9,37
Linfield,2135,4,10,5,11,38,38,0,35
Cliftonville,2135,5,10,4,12,34,32,2,34
Ballymena,2135,6,8,4,14,29,49,-20,28
Glentoran,2135,7,6,6,10,24,32,-8,24
Dungannon,2135,8,2,4,16,14,47,-33,10
Crusaders,2136,1,17,6,3,63,31,32,57
Coleraine,2136,2,14,10,2,43,24,19,52
Glenavon,2136,3,10,9,7,54,43,11,39
Linfield,2136,4,10,6,10,37,36,1,36
Cliftonville,2136,5,9,5,12,32,31,1,32
Ballymena,2136,6,7,4,15,26,49,-23,25
Glentoran,2136,7,6,6,10,24,32,-8,24
Dungannon,2136,8,2,4,16,14,47,-33,10
Coleraine,2137,1,15,10,1,46,22,24,55
Crusaders,2137,2,16,6,4,62,34,28,54
Glenavon,2137,3,9,9,8,52,46,6,36
Linfield,2137,4,10,6,10,39,38,1,36
Cliftonville,2137,5,9,5,12,34,33,1,32
Ballymena,2137,6,8,4,14,29,48,-19,28
Glentoran,2137,7,6,6,10,24,32,-8,24
Dungannon,2137,8,2,4,16,14,47,-33,10
Crusaders,2138,1,17,6,3,63,31,32,57
Coleraine,2138,2,14,10,2,45,27,18,52
Glenavon,2138,3,10,9,7,57,45,12,39
Linfield,2138,4,11,5,10,38,36,2,38
Cliftonville,2138,5,9,4,13,32,32,0,31
Ballymena,2138,6,7,4,15,26,49,-23,25
Glentoran,2138,7,6,6,10,24,32,-8,24
Dungannon,2138,8,2,4,16,14,47,-33,10
Crusaders,2139,1,17,6,3,64,32,32,57
Coleraine,2139,2,14,10,2,44,24,20,52
Glenavon,2139,3,10,9,7,54,44,10,39
Linfield,2139,4,11,5,10,38,36,2,38
Cliftonville,2139,5,9,4,13,32,32,0,31
Ballymena,2139,6,7,4,15,27,50,-23,25
Glentoran,2139,7,6,6,10,24,32,-8,24
Dungannon,2139,8,2,4,16,14,47,-33,10
Crusaders,2140,1,16,7,3,63,32,31,55
Coleraine,2140,2,15,10,1,45,22,23,55
Linfield,2140,3,11,5,10,39,37,2,38
Glenavon,2140,4,9,9,8,52,45,7,36
Cliftonville,2140,5,9,4,13,33,33,0,31
Ballymena,2140,6,7,5,14,27,49,-22,26
Glentoran,2140,7,6,6,10,24,32,-8,24
Dungannon,2140,8,2,4,16,14,47,-33,10
Crusaders,2141,1,16,6,4,61,32,29,54
Coleraine,2141,2,14,10,2,45,25,20,52
Glenavon,2141,3,10,9,7,55,45,10,39
Linfield,2141,4,10,5,11,38,38,0,35
Cliftonville,2141,5,10,4,12,34,32,2,34
Ballymena,2141,6,8,4,14,27,47,-20,28
Glentoran,2141,7,6,6,10,24,32,-8,24
Dungannon,2141,8,2,4,16,14,47,-33,10
Crusaders,2142,1,16,7,3,63,32,31,55
Coleraine,2142,2,14,10,2,43,24,19,52
Glenavon,2142,3,10,9,7,54,43,11,39
Linfield,2142,4,11,5,10,38,36,2,38
Cliftonville,2142,5,9,4,13,32,32,0,31
Ballymena,2142,6,7,5,14,27,49,-22,26
Glentoran,2142,7,6,6,10,24,32,-8,24
Dungannon,2142,8,2,4,16,14,47,-33,10
Crusaders,2143,1,16,6,4,61,32,29,54
Coleraine,2143,2,14,10,2,44,24,20,52
Glenavon,2143,3,10,9,7,54,44,10,39
Linfield,2143,4,10,5,11,38,39,-1,35
Cliftonville,2143,5,10,4,12,35,32,3,34
Ballymena,2143,6,8,4,14,27,47,-20,28
Glentoran,2143,7,6,6,10,24,32,-8,24
Dungannon,2143,8,2,4,16,14,47,-33,10
Crusaders,2144,1,17,6,3,63,30,33,57
Coleraine,2144,2,14,11,1,45,24,21,53
Glenavon,2144,3,9,10,7,54,45,9,37
Linfield,2144,4,10,5,11,37,37,0,35
Cliftonville,2144,5,10,4,12,33,31,2,34
Ballymena,2144,6,7,4,15,25,49,-24,25
Glentoran,2144,7,6,6,10,24,32,-8,24
Dungannon,2144,8,2,4,16,14,47,-33,10
Coleraine,2145,1,15,10,1,45,22,23,55
Crusaders,2145,2,16,6,4,61,31,30,54
Glenavon,2145,3,9,9,8,52,45,7,36
Linfield,2145,4,10,5,11,38,39,-1,35
Cliftonville,2145,5,10,4,12,35,32,3,34
Ballymena,2145,6,8,4,14,26,47,-21,28
Glentoran,2145,7,6,6,10,24,32,-8,24
Dungannon,2145,8,2,4,16,14,47,-33,10
Crusaders,2146,1,17,6,3,63,30,33,57
Coleraine,2146,2,14,10,2,44,25,19,52
Glenavon,2146,3,10,9,7,55,44,11,39
Linfield,2146,4,11,5,10,41,37,4,38
Cliftonville,2146,5,9,4,13,33,35,-2,31
Ballymena,2146,6,7,4,15,25,49,-24,25
Glentoran,2146,7,6,6,10,24,32,-8,24
Dungannon,2146,8,2,4,16,14,47,-33,10
Crusaders,2147,1,17,6,3,65,31,34,57
Coleraine,2147,2,14,10,2,44,24,20,52
Glenavon,2147,3,10,9,7,54,44,10,39
Linfield,2147,4,11,5,10,40,36,4,38
Cliftonville,2147,5,9,4,13,32,34,-2,31
Ballymena,2147,6,7,4,15,26,51,-25,25
Glentoran,2147,7,6,6,10,24,32,-8,24
Dungannon,2147,8,2,4,16,14,47,-33,10
Crusaders,2148,1,16,6,4,62,32,30,54
Coleraine,2148,2,14,11,1,45,24,21,53
Linfield,2148,3,11,5,10,40,36,4,38
Glenavon,2148,4,9,10,7,54,45,9,37
Cliftonville,2148,5,9,4,13,32,34,-2,31
Ballymena,2148,6,8,4,14,27,48,-21,28
Glentoran,2148,7,6,6,10,24,32,-8,24
Dungannon,2148,8,2,4,16,14,47,-33,10
Crusaders,2149,1,17,6,3,62,30,32,57
Coleraine,2149,2,14,11,1,45,24,21,53
Glenavon,2149,3,9,10,7,54,45,9,37
Linfield,2149,4,10,5,11,37,37,0,35
Cliftonville,2149,5,10,4,12,33,31,2,34
Ballymena,2149,6,7,4,15,25,48,-23,25
Glentoran,2149,7,6,6,10,24,32,-8,24
Dungannon,2149,8,2,4,16,14,47,-33,10
Crusaders,2150,1,16,7,3,64,33,31,55
Coleraine,2150,2,14,10,2,43,24,19,52
Glenavon,2150,3,10,9,7,54,43,11,39
Linfield,2150,4,10,5,11,37,38,-1,35
Cliftonville,2150,5,10,4,12,34,31,3,34
Ballymena,2150,6,7,5,14,28,50,-22,26
Glentoran,2150,7,6,6,10,24,32,-8,24
Dungannon,2150,8,2,4,16,14,47,-33,10
Crusaders,2151,1,17,6,3,63,30,33,57
Coleraine,2151,2,14,10,2,43,23,20,52
Glenavon,2151,3,10,9,7,53,43,10,39
Linfield,2151,4,10,6,10,38,37,1,36
Cliftonville,2151,5,9,5,12,33,32,1,32
Ballymena,2151,6,7,4,15,25,49,-24,25
Glentoran,2151,7,6,6,10,24,32,-8,24
Dungannon,2151,8,2,4,16,14,47,-33,10
Crusaders,2152,1,17,6,3,65,32,33,57
Coleraine,2152,2,14,10,2,44,24,20,52
Glenavon,2152,3,10,9,7,54,44,10,39
Linfield,2152,4,11,5,10,40,38,2,38
Cliftonville,2152,5,9,4,13,34,34,0,31
Ballymena,2152,6,7,4,15,27,51,-24,25
Glentoran,2152,7,6,6,10,24,32,-8,24
Dungannon,2152,8,2,4,16,14,47,-33,10
Crusaders,2153,1,16,6,4,62,34,28,54
Coleraine,2153,2,14,10,2,44,24,20,52
Glenavon,2153,3,10,9,7,54,44,10,39
Linfield,2153,4,10,6,10,37,36,1,36
Cliftonville,2153,5,9,5,12,32,31,1,32
Ballymena,2153,6,8,4,14,29,48,-19,28
Glentoran,2153,7,6,6,10,24,32,-8,24
Dungannon,2153,8,2,4,16,14,47,-33,10
Crusaders,2154,1,16,7,3,62,31,31,55
Coleraine,2154,2,15,10,1,47,22,25,55
Linfield,2154,3,11,5,10,39,37,2,38
Glenavon,2154,4,9,9,8,52,47,5,36
Cliftonville,2154,5,9,4,13,33,33,0,31
Ballymena,2154,6,7,5,14,26,48,-22,26
Glentoran,2154,7,6,6,10,24,32,-8,24
Dungannon,2154,8,2,4,16,14,47,-33,10
Crusaders,2155,1,17,6,3,65,30,35,57
Coleraine,2155,2,15,10,1,47,22,25,55
Linfield,2155,3,11,5,10,38,36,2,38
Glenavon,2155,4,9,9,8,52,47,5,36
Cliftonville,2155,5,9,4,13,32,32,0,31
Ballymena,2155,6,7,4,15,25,51,-26,25
Glentoran,2155,7,6,6,10,24,32,-8,24
Dungannon,2155,8,2,4,16,14,47,-33,10
Crusaders,2156,1,17,6,3,64,31,33,57
Coleraine,2156,2,14,10,2,43,26,17,52
Glenavon,2156,3,10,9,7,56,43,13,39
Linfield,2156,4,11,5,10,39,37,2,38
Cliftonville,2156,5,9,4,13,33,33,0,31
Ballymena,2156,6,7,4,15,26,50,-24,25
Glentoran,2156,7,6,6,10,24,32,-8,24
Dungannon,2156,8,2,4,16,14,47,-33,10
Crusaders,2157,1,17,6,3,62,30,32,57
Coleraine,2157,2,15,10,1,45,22,23,55
Glenavon,2157,3,9,9,8,52,45,7,36
Linfield,2157,4,10,6,10,40,39,1,36
Cliftonville,2157,5,9,5,12,35,34,1,32
Ballymena,2157,6,7,4,15,25,48,-23,25
Glentoran,2157,7,6,6,10,24,32,-8,24
Dungannon,2157,8,2,4,16,14,47,-33,10
Crusaders,2158,1,17,6,3,64,31,33,57
Coleraine,2158,2,14,10,2,44,26,18,52
Glenavon,2158,3,10,9,7,56,44,12,39
Linfield,2158,4,11,5,10,38,36,2,38
Cliftonville,2158,5,9,4,13,32,32,0,31
Ballymena,2158,6,7,4,15,26,50,-24,25
Glentoran,2158,7,6,6,10,24,32,-8,24
Dungannon,2158,8,2,4,16,14,47,-33,10
Crusaders,2159,1,17,6,3,63,31,32,57
Coleraine,2159,2,14,11,1,44,23,21,53
Glenavon,2159,3,9,10,7,53,44,9,37
Linfield,2159,4,10,5,11,37,38,-1,35
Cliftonville,2159,5,10,4,12,34,31,3,34
Ballymena,2159,6,7,4,15,26,49,-23,25
Glentoran,2159,7,6,6,10,24,32,-8,24
Dungannon,2159,8,2,4,16,14,47,-33,10
Crusaders,2160,1,17,6,3,64,32,32,57
Coleraine,2160,2,15,10,1,46,23,23,55
Glenavon,2160,3,9,9,8,53,46,7,36
Linfield,2160,4,10,6,10,38,37,1,36
Cliftonville,2160,5,9,5,12,33,32,1,32
Ballymena,2160,6,7,4,15,27,50,-23,25
Glentoran,2160,7,6,6,10,24,32,-8,24
Dungannon,2160,8,2,4,16,14,47,-33,10
Crusaders,2161,1,16,7,3,63,32,31,55
Coleraine,2161,2,15,10,1,46,23,23,55
Linfield,2161,3,11,5,10,38,36,2,38
Glenavon,2161,4,9,9,8,53,46,7,36
Cliftonville,2161,5,9,4,13,32,32,0,31
Ballymena,2161,6,7,5,14,27,49,-22,26
Glentoran,2161,7,6,6,10,24,32,-8,24
Dungannon,2161,8,2,4,16,14,47,-33,10
Crusaders,2162,1,17,6,3,63,31,32,57
Coleraine,2162,2,14,10,2,44,24,20,52
Glenavon,2162,3,10,9,7,54,44,10,39
Linfield,2162,4,11,5,10,39,37,2,38
Cliftonville,2162,5,9,4,13,33,33,0,31
Ballymena,2162,6,7,4,15,26,49,-23,25
Glentoran,2162,7,6,6,10,24,32,-8,24
Dungannon,2162,8,2,4,16,14,47,-33,10
Crusaders,2163,1,16,7,3,62,31,31,55
Coleraine,2163,2,14,10,2,43,25,18,52
Glenavon,2163,3,10,9,7,55,43,12,39
Linfield,2163,4,11,5,10,43,36,7,38
Cliftonville,2163,5,9,4,13,32,37,-5,31
Ballymena,2163,6,7,5,14,26,48,-22,26
Glentoran,2163,7,6,6,10,24,32,-8,24
Dungannon,2163,8,2,4,16,14,47,-33,10
Crusaders,2164,1,16,6,4,62,32,30,54
Coleraine,2164,2,14,10,2,44,27,17,52
Glenavon,2164,3,10,9,7,57,44,13,39
Linfield,2164,4,10,5,11,37,37,0,35
Cliftonville,2164,5,10,4,12,33,31,2,34
Ballymena,2164,6,8,4,14,27,48,-21,28
Glentoran,2164,7,6,6,10,24,32,-8,24
Dungannon,2164,8,2,4,16,14,47,-33,10
Crusaders,2165,1,17,6,3,64,32,32,57
Coleraine,2165,2,15,10,1,45,23,22,55
Linfield,2165,3,11,5,10,38,36,2,38
Glenavon,2165,4,9,9,8,53,45,8,36
Cliftonville,2165,5,9,4,13,32,32,0,31
Ballymena,2165,6,7,4,15,27,50,-23,25
Glentoran,2165,7,6,6,10,24,32,-8,24
Dungannon,2165,8,2,4,16,14,47,-33,10
Crusaders,2166,1,16,6,4,62,32,30,54
Coleraine,2166,2,14,11,1,44,23,21,53
Linfield,2166,3,11,5,10,40,37,3,38
Glenavon,2166,4,9,10,7,53,44,9,37
Cliftonville,2166,5,9,4,13,33,34,-1,31
Ballymena,2166,6,8,4,14,27,48,-21,28
Glentoran,2166,7,6,6,10,24,32,-8,24
Dungannon,2166,8,2,4,16,14,47,-33,10
Crusaders,2167,1,17,6,3,62,30,32,57
Coleraine,2167,2,14,11,1,45,24,21,53
Glenavon,2167,3,9,10,7,54,45,9,37
Linfield,2167,4,10,5,11,39,39,0,35
Cliftonville,2167,5,10,4,12,35,33,2,34
Ballymena,2167,6,7,4,15,25,48,-23,25
Glentoran,2167,7,6,6,10,24,32,-8,24
Dungannon,2167,8,2,4,16,14,47,-33,10
Crusaders,2168,1,16,7,3,63,32,31,55
Coleraine,2168,2,15,10,1,46,22,24,55
Glenavon,2168,3,9,9,8,52,46,6,36
Linfield,2168,4,10,6,10,38,37,1,36
Cliftonville,2168,5,9,5,12,33,32,1,32
Ballymena,2168,6,7,5,14,27,49,-22,26
Glentoran,2168,7,6,6,10,24,32,-8,24
Dungannon,2168,8,2,4,16,14,47,-33,10
Coleraine,2169,1,15,10,1,44,22,22,55
Crusaders,2169,2,16,6,4,61,31,30,54
Linfield,2169,3,11,5,10,40,36,4,38
Glenavon,2169,4,9,9,8,52,44,8,36
Cliftonville,2169,5,9,4,13,32,34,-2,31
Ballymena,2169,6,8,4,14,26,47,-21,28
Glentoran,2169,7,6,6,10,24,32,-8,24
Dungannon,2169,8,2,4,16,14,47,-33,10
Crusaders,2170,1,17,6,3,65,33,32,57
Coleraine,2170,2,15,10,1,46,24,22,55
Glenavon,2170,3,9,9,8,54,46,8,36
Linfield,2170,4,10,6,10,37,36,1,36
Cliftonville,2170,5,9,5,12,32,31,1,32
Ballymena,2170,6,7,4,15,28,51,-23,25
Glentoran,2170,7,6,6,10,24,32,-8,24
Dungannon,2170,8,2,4,16,14,47,-33,10
Crusaders,2171,1,16,6,4,61,31,30,54
Coleraine,2171,2,14,10,2,44,25,19,52
Glenavon,2171,3,10,9,7,55,44,11,39
Linfield,2171,4,10,5,11,37,37,0,35
Cliftonville,2171,5,10,4,12,33,31,2,34
Ballymena,2171,6,8,4,14,26,47,-21,28
Glentoran,2171,7,6,6,10,24,32,-8,24
Dungannon,2171,8,2,4,16,14,47,-33,10
Crusaders,2172,1,17,6,3,64,30,34,57
Coleraine,2172,2,14,10,2,43,26,17,52
Glenavon,2172,3,10,9,7,56,43,13,39
Linfield,2172,4,10,6,10,39,38,1,36
Cliftonville,2172,5,9,5,12,34,33,1,32
Ballymena,2172,6,7,4,15,25,50,-25,25
Glentoran,2172,7,6,6,10,24,32,-8,24
Dungannon,2172,8,2,4,16,14,47,-33,10
Crusaders,2173,1,16,7,3,64,33,31,55
Coleraine,2173,2,14,10,2,44,25,19,52
Glenavon,2173,3,10,9,7,55,44,11,39
Linfield,2173,4,11,5,10,39,36,3,38
Cliftonville,2173,5,9,4,13,32,33,-1,31
Ballymena,2173,6,7,5,14,28,50,-22,26
Glentoran,2173,7,6,6,10,24,32,-8,24
Dungannon,2173,8,2,4,16,14,47,-33,10
Crusaders,2174,1,17,6,3,62,30,32,57
Coleraine,2174,2,14,10,2,45,26,19,52
Glenavon,2174,3,10,9,7,56,45,11,39
Linfield,2174,4,11,5,10,39,37,2,38
Cliftonville,2174,5,9,4,13,33,33,0,31
Ballymena,2174,6,7,4,15,25,48,-23,25
Glentoran,2174,7,6,6,10,24,32,-8,24
Dungannon,2174,8,2,4,16,14,47,-33,10
Crusaders,2175,1,16,7,3,63,32,31,55
Coleraine,2175,2,15,10,1,45,22,23,55
Glenavon,2175,3,9,9,8,52,45,7,36
Linfield,2175,4,10,5,11,37,37,0,35
Cliftonville,2175,5,10,4,12,33,31,2,34
Ballymena,2175,6,7,5,14,27,49,-22,26
Glentoran,2175,7,6,6,10,24,32,-8,24
Dungannon,2175,8,2,4,16,14,47,-33,10
Crusaders,2176,1,17,6,3,62,30,32,57
Coleraine,2176,2,15,10,1,45,22,23,55
Glenavon,2176,3,9,9,8,52,45,7,36
Linfield,2176,4,10,5,11,37,38,-1,35
Cliftonville,2176,5,10,4,12,34,31,3,34
Ballymena,2176,6,7,4,15,25,48,-23,25
Glentoran,2176,7,6,6,10,24,32,-8,24
Dungannon,2176,8,2,4,16,14,47,-33,10
Crusaders,2177,1,16,7,3,61,30,31,55
Coleraine,2177,2,14,11,1,44,23,21,53
Glenavon,2177,3,9,10,7,53,44,9,37
Linfield,2177,4,10,5,11,39,39,0,35
Cliftonville,2177,5,10,4,12,35,33,2,34
Ballymena,2177,6,7,5,14,25,47,-22,26
Glentoran,2177,7,6,6,10,24,32,-8,24
Dungannon,2177,8,2,4,16,14,47,-33,10
Crusaders,2178,1,16,7,3,62,31,31,55
Coleraine,2178,2,14,11,1,45,24,21,53
Glenavon,2178,3,9,10,7,54,45,9,37
Linfield,2178,4,10,5,11,37,37,0,35
Cliftonville,2178,5,10,4,12,33,31,2,34
Ballymena,2178,6,7,5,14,26,48,-22,26
Glentoran,2178,7,6,6,10,24,32,-8,24
Dungannon,2178,8,2,4,16,14,47,-33,10
Crusaders,2179,1,17,6,3,64,30,34,57
Coleraine,2179,2,14,10,2,45,25,20,52
Glenavon,2179,3,10,9,7,55,45,10,39
Linfield,2179,4,11,5,10,38,36,2,38
Cliftonville,2179,5,9,4,13,32,32,0,31
Ballymena,2179,6,7,4,15,25,50,-25,25
Glentoran,2179,7,6,6,10,24,32,-8,24
Dungannon,2179,8,2,4,16,14,47,-33,10
Crusaders,2180,1,16,7,3,64,33,31,55
Coleraine,2180,2,15,10,1,46,24,22,55
Glenavon,2180,3,9,9,8,54,46,8,36
Linfield,2180,4,10,5,11,37,37,0,35
Cliftonville,2180,5,10,4,12,33,31,2,34
Ballymena,2180,6,7,5,14,28,50,-22,26
Glentoran,2180,7,6,6,10,24,32,-8,24
Dungannon,2180,8,2,4,16,14,47,-33,10
Crusaders,2181,1,17,6,3,65,30,35,57
Coleraine,2181,2,14,10,2,45,25,20,52
Glenavon,2181,3,10,9,7,55,45,10,39
Linfield,2181,4,10,5,11,37,37,0,35
Cliftonville,2181,5,10,4,12,33,31,2,34
Ballymena,2181,6,7,4,15,25,51,-26,25
Glentoran,2181,7,6,6,10,24,32,-8,24
Dungannon,2181,8,2,4,16,14,47,-33,10
Crusaders,2182,1,16,7,3,64,33,31,55
Coleraine,2182,2,14,11,1,43,22,21,53
Glenavon,2182,3,9,10,7,52,43,9,37
Linfield,2182,4,10,5,11,39,39,0,35
Cliftonville,2182,5,10,4,12,35,33,2,34
Ballymena,2182,6,7,5,14,28,50,-22,26
Glentoran,2182,7,6,6,10,24,32,-8,24
Dungannon,2182,8,2,4,16,14,47,-33,10
Crusaders,2183,1,17,6,3,63,31,32,57
Coleraine,2183,2,15,10,1,45,23,22,55
Glenavon,2183,3,9,9,8,53,45,8,36
Linfield,2183,4,10,6,10,37,36,1,36
Cliftonville,2183,5,9,5,12,32,31,1,32
Ballymena,2183,6,7,4,15,26,49,-23,25
Glentoran,2183,7,6,6,10,24,32,-8,24
Dungannon,2183,8,2,4,16,14,47,-33,10
Crusaders,2184,1,17,6,3,63,30,33,57
Coleraine,2184,2,14,10,2,43,23,20,52
Glenavon,2184,3,10,9,7,53,43,10,39
Linfield,2184,4,10,5,11,38,38,0,35
Cliftonville,2184,5,10,4,12,34,32,2,34
Ballymena,2184,6,7,4,15,25,49,-24,25
Glentoran,2184,7,6,6,10,24,32,-8,24
Dungannon,2184,8,2,4,16,14,47,-33,10
Crusaders,2185,1,17,6,3,64,31,33,57
Coleraine,2185,2,14,10,2,43,23,20,52
Glenavon,2185,3,10,9,7,53,43,10,39
Linfield,2185,4,10,5,11,37,37,0,35
Cliftonville,2185,5,10,4,12,33,31,2,34
Ballymena,2185,6,7,4,15,26,50,-24,25
Glentoran,2185,7,6,6,10,24,32,-8,24
Dungannon,2185,8,2,4,16,14,47,-33,10
Crusaders,2186,1,16,6,4,63,33,30,54
Coleraine,2186,2,14,10,2,44,24,20,52
Glenavon,2186,3,10,9,7,54,44,10,39
Linfield,2186,4,11,5,10,39,36,3,38
Cliftonville,2186,5,9,4,13,32,33,-1,31
Ballymena,2186,6,8,4,14,28,49,-21,28
Glentoran,2186,7,6,6,10,24,32,-8,24
Dungannon,2186,8,2,4,16,14,47,-33,10
Crusaders,2187,1,17,6,3,62,30,32,57
Coleraine,2187,2,15,10,1,46,24,22,55
Linfield,2187,3,11,5,10,39,36,3,38
Glenavon,2187,4,9,9,8,54,46,8,36
Cliftonville,2187,5,9,4,13,32,33,-1,31
Ballymena,2187,6,7,4,15,25,48,-23,25
Glentoran,2187,7,6,6,10,24,32,-8,24
Dungannon,2187,8,2,4,16,14,47,-33,10
Crusaders,2188,1,16,6,4,63,35,28,54
Coleraine,2188,2,14,10,2,43,24,19,52
Glenavon,2188,3,10,9,7,54,43,11,39
Linfield,2188,4,11,5,10,38,36,2,38
Cliftonville,2188,5,9,4,13,32,32,0,31
Ballymena,2188,6,8,4,14,30,49,-19,28
Glentoran,2188,7,6,6,10,24,32,-8,24
Dungannon,2188,8,2,4,16,14,47,-33,10
Crusaders,2189,1,16,6,4,61,31,30,54
Coleraine,2189,2,14,11,1,46,25,21,53
Linfield,2189,3,11,5,10,39,37,2,38
Glenavon,2189,4,9,10,7,55,46,9,37
Cliftonville,2189,5,9,4,13,33,33,0,31
Ballymena,2189,6,8,4,14,26,47,-21,28
Glentoran,2189,7,6,6,10,24,32,-8,24
Dungannon,2189,8,2,4,16,14,47,-33,10
Crusaders,2190,1,17,6,3,65,30,35,57
Coleraine,2190,2,15,10,1,46,23,23,55
Linfield,2190,3,11,5,10,38,36,2,38
Glenavon,2190,4,9,9,8,53,46,7,36
Cliftonville,2190,5,9,4,13,32,32,0,31
Ballymena,2190,6,7,4,15,25,51,-26,25
Glentoran,2190,7,6,6,10,24,32,-8,24
Dungannon,2190,8,2,4,16,14,47,-33,10
Coleraine,2191,1,15,10,1,45,23,22,55
Crusaders,2191,2,16,6,4,61,33,28,54
Linfield,2191,3,11,5,10,39,36,3,38
Glenavon,2191,4,9,9,8,53,45,8,36
Cliftonville,2191,5,9,4,13,32,33,-1,31
Ballymena,2191,6,8,4,14,28,47,-19,28
Glentoran,2191,7,6,6,10,24,32,-8,24
Dungannon,2191,8,2,4,16,14,47,-33,10
Crusaders,2192,1,17,6,3,65,33,32,57
Coleraine,2192,2,15,10,1,48,23,25,55
Linfield,2192,3,11,5,10,39,37,2,38
Glenavon,2192,4,9,9,8,53,48,5,36
Cliftonville,2192,5,9,4,13,33,33,0,31
Ballymena,2192,6,7,4,15,28,51,-23,25
Glentoran,2192,7,6,6,10,24,32,-8,24
Dungannon,2192,8,2,4,16,14,47,-33,10
Crusaders,2193,1,17,6,3,63,31,32,57
Coleraine,2193,2,15,10,1,45,23,22,55
Linfield,2193,3,11,5,10,39,37,2,38
Glenavon,2193,4,9,9,8,53,45,8,36
Cliftonville,2193,5,9,4,13,33,33,0,31
Ballymena,2193,6,7,4,15,26,49,-23,25
Glentoran,2193,7,6,6,10,24,32,-8,24
Dungannon,2193,8,2,4,16,14,47,-33,10
Crusaders,2194,1,16,7,3,63,32,31,55
Coleraine,2194,2,14,10,2,44,28,16,52
Glenavon,2194,3,10,9,7,58,44,14,39
Linfield,2194,4,11,5,10,40,38,2,38
Cliftonville,2194,5,9,4,13,34,34,0,31
Ballymena,2194,6,7,5,14,27,49,-22,26
Glentoran,2194,7,6,6,10,24,32,-8,24
Dungannon,2194,8,2,4,16,14,47,-33,10
Crusaders,2195,1,16,6,4,61,31,30,54
Coleraine,2195,2,14,10,2,43,23,20,52
Glenavon,2195,3,10,9,7,53,43,10,39
Linfield,2195,4,11,5,10,40,37,3,38
Cliftonville,2195,5,9,4,13,33,34,-1,31
Ballymena,2195,6,8,4,14,26,47,-21,28
Glentoran,2195,7,6,6,10,24,32,-8,24
Dungannon,2195,8,2,4,16,14,47,-33,10
Crusaders,2196,1,16,6,4,61,31,30,54
Coleraine,2196,2,14,10,2,43,26,17,52
Glenavon,2196,3,10,9,7,56,43,13,39
Linfield,2196,4,11,5,10,40,37,3,38
Cliftonville,2196,5,9,4,13,33,34,-1,31
Ballymena,2196,6,8,4,14,26,47,-21,28
Glentoran,2196,7,6,6,10,24,32,-8,24
Dungannon,2196,8,2,4,16,14,47,-33,10
Crusaders,2197,1,16,7,3,62,31,31,55
Coleraine,2197,2,14,11,1,45,24,21,53
Glenavon,2197,3,9,10,7,54,45,9,37
Linfield,2197,4,10,6,10,39,38,1,36
Cliftonville,2197,5,9,5,12,34,33,1,32
Ballymena,2197,6,7,5,14,26,48,-22,26
Glentoran,2197,7,6,6,10,24,32,-8,24
Dungannon,2197,8,2,4,16,14,47,-33,10
Crusaders,2198,1,17,6,3,64,30,34,57
Coleraine,2198,2,14,10,2,44,24,20,52
Glenavon,2198,3,10,9,7,54,44,10,39
Linfield,2198,4,11,5,10,41,38,3,38
Cliftonville,2198,5,9,4,13,34,35,-1,31
Ballymena,2198,6,7,4,15,25,50,-25,25
Glentoran,2198,7,6,6,10,24,32,-8,24
Dungannon,2198,8,2,4,16,14,47,-33,10
Crusaders,2199,1,17,6,3,62,30,32,57
Coleraine,2199,2,15,10,1,46,24,22,55
Glenavon,2199,3,9,9,8,54,46,8,36
Linfield,2199,4,10,6,10,38,37,1,36
Cliftonville,2199,5,9,5,12,33,32,1,32
Ballymena,2199,6,7,4,15,25,48,-23,25
Glentoran,2199,7,6,6,10,24,32,-8,24
Dungannon,2199,8,2,4,16,14,47,-33,10
Crusaders,2200,1,16,7,3,63,32,31,55
Coleraine,2200,2,14,10,2,43,24,19,52
Glenavon,2200,3,10,9,7,54,43,11,39
Linfield,2200,4,11,5,10,39,37,2,38
Cliftonville,2200,5,9,4,13,33,33,0,31
Ballymena,2200,6,7,5,14,27,49,-22,26
Glentoran,2200,7,6,6,10,24,32,-8,24
Dungannon,2200,8,2,4,16,14,47,-33,10
Crusaders,2201,1,17,6,3,63,31,32,57
Coleraine,2201,2,14,11,1,44,23,21,53
Glenavon,2201,3,9,10,7,53,44,9,37
Linfield,2201,4,10,5,11,37,37,0,35
Cliftonville,2201,5,10,4,12,33,31,2,34
Ballymena,2201,6,7,4,15,26,49,-23,25
Glentoran,2201,7,6,6,10,24,32,-8,24
Dungannon,2201,8,2,4,16,14,47,-33,10
Crusaders,2202,1,17,6,3,63,30,33,57
Coleraine,2202,2,14,11,1,43,22,21,53
Glenavon,2202,3,9,10,7,52,43,9,37
Linfield,2202,4,10,6,10,37,36,1,36
Cliftonville,2202,5,9,5,12,32,31,1,32
Ballymena,2202,6,7,4,15,25,49,-24,25
Glentoran,2202,7,6,6,10,24,32,-8,24
Dungannon,2202,8,2,4,16,14,47,-33,10
Crusaders,2203,1,16,6,4,61,31,30,54
Coleraine,2203,2,14,11,1,44,23,21,53
Linfield,2203,3,11,5,10,40,37,3,38
Glenavon,2203,4,9,10,7,53,44,9,37
Cliftonville,2203,5,9,4,13,33,34,-1,31
Ballymena,2203,6,8,4,14,26,47,-21,28
Glentoran,2203,7,6,6,10,24,32,-8,24
Dungannon,2203,8,2,4,16,14,47,-33,10
Crusaders,2204,1,16,6,4,61,31,30,54
Coleraine,2204,2,14,10,2,43,24,19,52
Glenavon,2204,3,10,9,7,54,43,11,39
Linfield,2204,4,11,5,10,39,37,2,38
Cliftonville,2204,5,9,4,13,33,33,0,31
Ballymena,2204,6,8,4,14,26,47,-21,28
Glentoran,2204,7,6,6,10,24,32,-8,24
Dungannon,2204,8,2,4,16,14,47,-33,10
Crusaders,2205,1,17,6,3,63,30,33,57
Coleraine,2205,2,14,10,2,43,23,20,52
Glenavon,2205,3,10,9,7,53,43,10,39
Linfield,2205,4,11,5,10,41,37,4,38
Cliftonville,2205,5,9,4,13,33,35,-2,31
Ballymena,2205,6,7,4,15,25,49,-24,25
Glentoran,2205,7,6,6,10,24,32,-8,24
Dungannon,2205,8,2,4,16,14,47,-33,10
Crusaders,2206,1,17,6,3,64,31,33,57
Coleraine,2206,2,14,10,2,43,26,17,52
Glenavon,2206,3,10,9,7,56,43,13,39
Linfield,2206,4,11,5,10,38,36,2,38
Cliftonville,2206,5,9,4,13,32,32,0,31
Ballymena,2206,6,7,4,15,26,50,-24,25
Glentoran,2206,7,6,6,10,24,32,-8,24
Dungannon,2206,8,2,4,16,14,47,-33,10
Crusaders,2207,1,17,6,3,64,31,33,57
Coleraine,2207,2,14,10,2,43,25,18,52
Glenavon,2207,3,10,9,7,55,43,12,39
Linfield,2207,4,11,5,10,39,36,3,38
Cliftonville,2207,5,9,4,13,32,33,-1,31
Ballymena,2207,6,7,4,15,26,50,-24,25
Glentoran,2207,7,6,6,10,24,32,-8,24
Dungannon,2207,8,2,4,16,14,47,-33,10
Coleraine,2208,1,15,10,1,46,24,22,55
Crusaders,2208,2,16,6,4,62,33,29,54
Linfield,2208,3,11,5,10,38,36,2,38
Glenavon,2208,4,9,9,8,54,46,8,36
Cliftonville,2208,5,9,4,13,32,32,0,31
Ballymena,2208,6,8,4,14,28,48,-20,28
Glentoran,2208,7,6,6,10,24,32,-8,24
Dungannon,2208,8,2,4,16,14,47,-33,10
Coleraine,2209,1,15,10,1,45,22,23,55
Crusaders,2209,2,16,6,4,61,31,30,54
Linfield,2209,3,11,5,10,41,38,3,38
Glenavon,2209,4,9,9,8,52,45,7,36
Cliftonville,2209,5,9,4,13,34,35,-1,31
Ballymena,2209,6,8,4,14,26,47,-21,28
Glentoran,2209,7,6,6,10,24,32,-8,24
Dungannon,2209,8,2,4,16,14,47,-33,10
Crusaders,2210,1,17,6,3,64,32,32,57
Coleraine,2210,2,15,10,1,45,22,23,55
Linfield,2210,3,11,5,10,40,37,3,38
Glenavon,2210,4,9,9,8,52,45,7,36
Cliftonville,2210,5,9,4,13,33,34,-1,31
Ballymena,2210,6,7,4,15,27,50,-23,25
Glentoran,2210,7,6,6,10,24,32,-8,24
Dungannon,2210,8,2,4,16,14,47,-33,10
Crusaders,2211,1,17,6,3,62,30,32,57
Coleraine,2211,2,14,10,2,44,24,20,52
Glenavon,2211,3,10,9,7,54,44,10,39
Linfield,2211,4,10,6,10,38,37,1,36
Cliftonville,2211,5,9,5,12,33,32,1,32
Ballymena,2211,6,7,4,15,25,48,-23,25
Glentoran,2211,7,6,6,10,24,32,-8,24
Dungannon,2211,8,2,4,16,14,47,-33,10
Crusaders,2212,1,16,7,3,61,30,31,55
Coleraine,2212,2,14,10,2,44,24,20,52
Glenavon,2212,3,10,9,7,54,44,10,39
Linfield,2212,4,10,6,10,38,37,1,36
Cliftonville,2212,5,9,5,12,33,32,1,32
Ballymena,2212,6,7,5,14,25,47,-22,26
Glentoran,2212,7,6,6,10,24,32,-8,24
Dungannon,2212,8,2,4,16,14,47,-33,10
Coleraine,2213,1,15,10,1,44,22,22,55
Crusaders,2213,2,16,6,4,61,31,30,54
Glenavon,2213,3,9,9,8,52,44,8,36
Linfield,2213,4,10,6,10,38,37,1,36
Cliftonville,2213,5,9,5,12,33,32,1,32
Ballymena,2213,6,8,4,14,26,47,-21,28
Glentoran,2213,7,6,6,10,24,32,-8,24
Dungannon,2213,8,2,4,16,14,47,-33,10
Crusaders,2214,1,17,6,3,64,32,32,57
Coleraine,2214,2,14,10,2,44,27,17,52
Glenavon,2214,3,10,9,7,57,44,13,39
Linfield,2214,4,11,5,10,38,36,2,38
Cliftonville,2214,5,9,4,13,32,32,0,31
Ballymena,2214,6,7,4,15,27,50,-23,25
Glentoran,2214,7,6,6,10,24,32,-8,24
Dungannon,2214,8,2,4,16,14,47,-33,10
Crusaders,2215,1,17,6,3,65,31,34,57
Coleraine,2215,2,14,11,1,45,24,21,53
Linfield,2215,3,11,5,10,38,36,2,38
Glenavon,2215,4,9,10,7,54,45,9,37
Cliftonville,2215,5,9,4,13,32,32,0,31
Ballymena,2215,6,7,4,15,26,51,-25,25
Glentoran,2215,7,6,6,10,24,32,-8,24
Dungannon,2215,8,2,4,16,14,47,-33,10
Crusaders,2216,1,16,6,4,62,32,30,54
Coleraine,2216,2,14,10,2,44,24,20,52
Glenavon,2216,3,10,9,7,54,44,10,39
Linfield,2216,4,11,5,10,39,37,2,38
Cliftonville,2216,5,9,4,13,33,33,0,31
Ballymena,2216,6,8,4,14,27,48,-21,28
Glentoran,2216,7,6,6,10,24,32,-8,24
Dungannon,2216,8,2,4,16,14,47,-33,10
Crusaders,2217,1,16,6,4,62,33,29,54
Coleraine,2217,2,14,10,2,43,24,19,52
Glenavon,2217,3,10,9,7,54,43,11,39
Linfield,2217,4,10,6,10,37,36,1,36
Cliftonville,2217,5,9,5,12,32,31,1,32
Ballymena,2217,6,8,4,14,28,48,-20,28
Glentoran,2217,7,6,6,10,24,32,-8,24
Dungannon,2217,8,2,4,16,14,47,-33,10
Crusaders,2218,1,16,6,4,62,32,30,54
Coleraine,2218,2,14,11,1,44,23,21,53
Linfield,2218,3,11,5,10,40,38,2,38
Glenavon,2218,4,9,10,7,53,44,9,37
Cliftonville,2218,5,9,4,13,34,34,0,31
Ballymena,2218,6,8,4,14,27,48,-21,28
Glentoran,2218,7,6,6,10,24,32,-8,24
Dungannon,2218,8,2,4,16,14,47,-33,10
Crusaders,2219,1,16,7,3,62,31,31,55
Coleraine,2219,2,14,11,1,45,24,21,53
Glenavon,2219,3,9,10,7,54,45,9,37
Linfield,2219,4,10,5,11,38,39,-1,35
Cliftonville,2219,5,10,4,12,35,32,3,34
Ballymena,2219,6,7,5,14,26,48,-22,26
Glentoran,2219,7,6,6,10,24,32,-8,24
Dungannon,2219,8,2,4,16,14,47,-33,10
Crusaders,2220,1,16,7,3,62,31,31,55
Coleraine,2220,2,15,10,1,46,22,24,55
Linfield,2220,3,11,5,10,42,38,4,38
Glenavon,2220,4,9,9,8,52,46,6,36
Cliftonville,2220,5,9,4,13,34,36,-2,31
Ballymena,2220,6,7,5,14,26,48,-22,26
Glentoran,2220,7,6,6,10,24,32,-8,24
Dungannon,2220,8,2,4,16,14,47,-33,10
Crusaders,2221,1,16,7,3,64,33,31,55
Coleraine,2221,2,14,10,2,44,25,19,52
Glenavon,2221,3,10,9,7,55,44,11,39
Linfield,2221,4,11,5,10,39,37,2,38
Cliftonville,2221,5,9,4,13,33,33,0,31
Ballymena,2221,6,7,5,14,28,50,-22,26
Glentoran,2221,7,6,6,10,24,32,-8,24
Dungannon,2221,8,2,4,16,14,47,-33,10
Crusaders,2222,1,16,7,3,62,31,31,55
Coleraine,2222,2,14,11,1,45,24,21,53
Linfield,2222,3,11,5,10,40,37,3,38
Glenavon,2222,4,9,10,7,54,45,9,37
Cliftonville,2222,5,9,4,13,33,34,-1,31
Ballymena,2222,6,7,5,14,26,48,-22,26
Glentoran,2222,7,6,6,10,24,32,-8,24
Dungannon,2222,8,2,4,16,14,47,-33,10
Crusaders,2223,1,16,6,4,63,33,30,54
Coleraine,2223,2,14,11,1,45,24,21,53
Linfield,2223,3,11,5,10,41,38,3,38
Glenavon,2223,4,9,10,7,54,45,9,37
Cliftonville,2223,5,9,4,13,34,35,-1,31
Ballymena,2223,6,8,4,14,28,49,-21,28
Glentoran,2223,7,6,6,10,24,32,-8,24
Dungannon,2223,8,2,4,16,14,47,-33,10
Crusaders,2224,1,16,7,3,61,30,31,55
Coleraine,2224,2,14,10,2,43,28,15,52
Glenavon,2224,3,10,9,7,58,43,15,39
Linfield,2224,4,11,5,10,39,36,3,38
Cliftonville,2224,5,9,4,13,32,33,-1,31
Ballymena,2224,6,7,5,14,25,47,-22,26
Glentoran,2224,7,6,6,10,24,32,-8,24
Dungannon,2224,8,2,4,16,14,47,-33,10
Crusaders,2225,1,17,6,3,65,33,32,57
Coleraine,2225,2,15,10,1,44,22,22,55
Linfield,2225,3,11,5,10,41,37,4,38
Glenavon,2225,4,9,9,8,52,44,8,36
Cliftonville,2225,5,9,4,13,33,35,-2,31
Ballymena,2225,6,7,4,15,28,51,-23,25
Glentoran,2225,7,6,6,10,24,32,-8,24
Dungannon,2225,8,2,4,16,14,47,-33,10
Crusaders,2226,1,16,7,3,62,31,31,55
Coleraine,2226,2,15,10,1,45,23,22,55
Glenavon,2226,3,9,9,8,53,45,8,36
Linfield,2226,4,10,6,10,38,37,1,36
Cliftonville,2226,5,9,5,12,33,32,1,32
Ballymena,2226,6,7,5,14,26,48,-22,26
Glentoran,2226,7,6,6,10,24,32,-8,24
Dungannon,2226,8,2,4,16,14,47,-33,10
Crusaders,2227,1,16,7,3,64,33,31,55
Coleraine,2227,2,15,10,1,45,23,22,55
Linfield,2227,3,11,5,10,39,36,3,38
Glenavon,2227,4,9,9,8,53,45,8,36
Cliftonville,2227,5,9,4,13,32,33,-1,31
Ballymena,2227,6,7,5,14,28,50,-22,26
Glentoran,2227,7,6,6,10,24,32,-8,24
Dungannon,2227,8,2,4,16,14,47,-33,10
Crusaders,2228,1,16,7,3,61,30,31,55
Coleraine,2228,2,15,10,1,45,23,22,55
Glenavon,2228,3,9,9,8,53,45,8,36
Linfield,2228,4,10,5,11,37,37,0,35
Cliftonville,2228,5,10,4,12,33,31,2,34
Ballymena,2228,6,7,5,14,25,47,-22,26
Glentoran,2228,7,6,6,10,24,32,-8,24
Dungannon,2228,8,2,4,16,14,47,-33,10
Coleraine,2229,1,15,10,1,46,23,23,55
Crusaders,2229,2,16,6,4,63,33,30,54
Glenavon,2229,3,9,9,8,53,46,7,36
Linfield,2229,4,10,6,10,37,36,1,36
Cliftonville,2229,5,9,5,12,32,31,1,32
Ballymena,2229,6,8,4,14,28,49,-21,28
Glentoran,2229,7,6,6,10,24,32,-8,24
Dungannon,2229,8,2,4,16,14,47,-33,10
Crusaders,2230,1,17,6,3,65,31,34,57
Coleraine,2230,2,15,10,1,45,23,22,55
Glenavon,2230,3,9,9,8,53,45,8,36
Linfield,2230,4,10,6,10,38,37,1,36
Cliftonville,2230,5,9,5,12,33,32,1,32
Ballymena,2230,6,7,4,15,26,51,-25,25
Glentoran,2230,7,6,6,10,24,32,-8,24
Dungannon,2230,8,2,4,16,14,47,-33,10
Crusaders,2231,1,16,7,3,61,30,31,55
Coleraine,2231,2,15,10,1,45,22,23,55
Linfield,2231,3,11,5,10,39,36,3,38
Glenavon,2231,4,9,9,8,52,45,7,36
Cliftonville,2231,5,9,4,13,32,33,-1,31
Ballymena,2231,6,7,5,14,25,47,-22,26
Glentoran,2231,7,6,6,10,24,32,-8,24
Dungannon,2231,8,2,4,16,14,47,-33,10
Crusaders,2232,1,17,6,3,66,31,35,57
Coleraine,2232,2,14,10,2,43,24,19,52
Glenavon,2232,3,10,9,7,54,43,11,39
Linfield,2232,4,11,5,10,41,37,4,38
Cliftonville,2232,5,9,4,13,33,35,-2,31
Ballymena,2232,6,7,4,15,26,52,-26,25
Glentoran,2232,7,6,6,10,24,32,-8,24
Dungannon,2232,8,2,4,16,14,47,-33,10
Crusaders,2233,1,17,6,3,66,32,34,57
Coleraine,2233,2,15,10,1,44,22,22,55
Glenavon,2233,3,9,9,8,52,44,8,36
Linfield,2233,4,10,6,10,38,37,1,36
Cliftonville,2233,5,9,5,12,33,32,1,32
Ballymena,2233,6,7,4,15,27,52,-25,25
Glentoran,2233,7,6,6,10,24,32,-8,24
Dungannon,2233,8,2,4,16,14,47,-33,10
Crusaders,2234,1,17,6,3,68,30,38,57
Coleraine,2234,2,15,10,1,44,22,22,55
Glenavon,2234,3,9,9,8,52,44,8,36
Linfield,2234,4,10,6,10,38,37,1,36
Cliftonville,2234,5,9,5,12,33,32,1,32
Ballymena,2234,6,7,4,15,25,54,-29,25
Glentoran,2234,7,6,6,10,24,32,-8,24
Dungannon,2234,8,2,4,16,14,47,-33,10
Crusaders,2235,1,17,6,3,65,32,33,57
Coleraine,2235,2,14,11,1,47,26,21,53
Linfield,2235,3,11,5,10,38,36,2,38
Glenavon,2235,4,9,10,7,56,47,9,37
Cliftonville,2235,5,9,4,13,32,32,0,31
Ballymena,2235,6,7,4,15,27,51,-24,25
Glentoran,2235,7,6,6,10,24,32,-8,24
Dungannon,2235,8,2,4,16,14,47,-33,10
Crusaders,2236,1,17,6,3,63,30,33,57
Coleraine,2236,2,14,10,2,43,24,19,52
Glenavon,2236,3,10,9,7,54,43,11,39
Linfield,2236,4,10,6,10,38,37,1,36
Cliftonville,2236,5,9,5,12,33,32,1,32
Ballymena,2236,6,7,4,15,25,49,-24,25
Glentoran,2236,7,6,6,10,24,32,-8,24
Dungannon,2236,8,2,4,16,14,47,-33,10
Crusaders,2237,1,17,6,3,64,30,34,57
Coleraine,2237,2,15,10,1,48,23,25,55
Linfield,2237,3,11,5,10,40,37,3,38
Glenavon,2237,4,9,9,8,53,48,5,36
Cliftonville,2237,5,9,4,13,33,34,-1,31
Ballymena,2237,6,7,4,15,25,50,-25,25
Glentoran,2237,7,6,6,10,24,32,-8,24
Dungannon,2237,8,2,4,16,14,47,-33,10
Crusaders,2238,1,16,6,4,62,33,29,54
Coleraine,2238,2,14,11,1,46,25,21,53
Linfield,2238,3,11,5,10,38,36,2,38
Glenavon,2238,4,9,10,7,55,46,9,37
Cliftonville,2238,5,9,4,13,32,32,0,31
Ballymena,2238,6,8,4,14,28,48,-20,28
Glentoran,2238,7,6,6,10,24,32,-8,24
Dungannon,2238,8,2,4,16,14,47,-33,10
Crusaders,2239,1,16,7,3,63,32,31,55
Coleraine,2239,2,15,10,1,47,24,23,55
Glenavon,2239,3,9,9,8,54,47,7,36
Linfield,2239,4,10,6,10,38,37,1,36
Cliftonville,2239,5,9,5,12,33,32,1,32
Ballymena,2239,6,7,5,14,27,49,-22,26
Glentoran,2239,7,6,6,10,24,32,-8,24
Dungannon,2239,8,2,4,16,14,47,-33,10
Crusaders,2240,1,16,6,4,62,32,30,54
Coleraine,2240,2,14,10,2,44,24,20,52
Glenavon,2240,3,10,9,7,54,44,10,39
Linfield,2240,4,11,5,10,38,36,2,38
Cliftonville,2240,5,9,4,13,32,32,0,31
Ballymena,2240,6,8,4,14,27,48,-21,28
Glentoran,2240,7,6,6,10,24,32,-8,24
Dungannon,2240,8,2,4,16,14,47,-33,10
Crusaders,2241,1,17,6,3,65,31,34,57
Coleraine,2241,2,14,11,1,44,23,21,53
Glenavon,2241,3,9,10,7,53,44,9,37
Linfield,2241,4,10,6,10,38,37,1,36
Cliftonville,2241,5,9,5,12,33,32,1,32
Ballymena,2241,6,7,4,15,26,51,-25,25
Glentoran,2241,7,6,6,10,24,32,-8,24
Dungannon,2241,8,2,4,16,14,47,-33,10
Crusaders,2242,1,16,7,3,61,30,31,55
Coleraine,2242,2,14,11,1,43,22,21,53
Glenavon,2242,3,9,10,7,52,43,9,37
Linfield,2242,4,10,5,11,39,41,-2,35
Cliftonville,2242,5,10,4,12,37,33,4,34
Ballymena,2242,6,7,5,14,25,47,-22,26
Glentoran,2242,7,6,6,10,24,32,-8,24
Dungannon,2242,8,2,4,16,14,47,-33,10
Crusaders,2243,1,17,6,3,63,31,32,57
Coleraine,2243,2,14,10,2,43,25,18,52
Glenavon,2243,3,10,9,7,55,43,12,39
Linfield,2243,4,10,6,10,38,37,1,36
Cliftonville,2243,5,9,5,12,33,32,1,32
Ballymena,2243,6,7,4,15,26,49,-23,25
Glentoran,2243,7,6,6,10,24,32,-8,24
Dungannon,2243,8,2,4,16,14,47,-33,10
Crusaders,2244,1,17,6,3,65,32,33,57
Coleraine,2244,2,14,10,2,44,24,20,52
Glenavon,2244,3,10,9,7,54,44,10,39
Linfield,2244,4,10,5,11,37,38,-1,35
Cliftonville,2244,5,10,4,12,34,31,3,34
Ballymena,2244,6,7,4,15,27,51,-24,25
Glentoran,2244,7,6,6,10,24,32,-8,24
Dungannon,2244,8,2,4,16,14,47,-33,10
Crusaders,2245,1,17,6,3,63,30,33,57
Coleraine,2245,2,14,11,1,45,24,21,53
Glenavon,2245,3,9,10,7,54,45,9,37
Linfield,2245,4,10,6,10,39,38,1,36
Cliftonville,2245,5,9,5,12,34,33,1,32
Ballymena,2245,6,7,4,15,25,49,-24,25
Glentoran,2245,7,6,6,10,24,32,-8,24
Dungannon,2245,8,2,4,16,14,47,-33,10
Crusaders,2246,1,17,6,3,63,30,33,57
Coleraine,2246,2,14,11,1,44,23,21,53
Glenavon,2246,3,9,10,7,53,44,9,37
Linfield,2246,4,10,6,10,38,37,1,36
Cliftonville,2246,5,9,5,12,33,32,1,32
Ballymena,2246,6,7,4,15,25,49,-24,25
Glentoran,2246,7,6,6,10,24,32,-8,24
Dungannon,2246,8,2,4,16,14,47,-33,10
Crusaders,2247,1,17,6,3,64,31,33,57
Coleraine,2247,2,14,11,1,45,24,21,53
Linfield,2247,3,11,5,10,40,37,3,38
Glenavon,2247,4,9,10,7,54,45,9,37
Cliftonville,2247,5,9,4,13,33,34,-1,31
Ballymena,2247,6,7,4,15,26,50,-24,25
Glentoran,2247,7,6,6,10,24,32,-8,24
Dungannon,2247,8,2,4,16,14,47,-33,10
Crusaders,2248,1,17,6,3,62,30,32,57
Coleraine,2248,2,15,10,1,45,23,22,55
Glenavon,2248,3,9,9,8,53,45,8,36
Linfield,2248,4,10,5,11,37,37,0,35
Cliftonville,2248,5,10,4,12,33,31,2,34
Ballymena,2248,6,7,4,15,25,48,-23,25
Glentoran,2248,7,6,6,10,24,32,-8,24
Dungannon,2248,8,2,4,16,14,47,-33,10
Crusaders,2249,1,16,7,3,64,33,31,55
Coleraine,2249,2,14,10,2,44,25,19,52
Glenavon,2249,3,10,9,7,55,44,11,39
Linfield,2249,4,10,6,10,38,37,1,36
Cliftonville,2249,5,9,5,12,33,32,1,32
Ballymena,2249,6,7,5,14,28,50,-22,26
Glentoran,2249,7,6,6,10,24,32,-8,24
Dungannon,2249,8,2,4,16,14,47,-33,10
Crusaders,2250,1,16,7,3,64,33,31,55
Coleraine,2250,2,14,11,1,43,22,21,53
Glenavon,2250,3,9,10,7,52,43,9,37
Linfield,2250,4,10,6,10,37,36,1,36
Cliftonville,2250,5,9,5,12,32,31,1,32
Ballymena,2250,6,7,5,14,28,50,-22,26
Glentoran,2250,7,6,6,10,24,32,-8,24
Dungannon,2250,8,2,4,16,14,47,-33,10
Crusaders,2251,1,17,6,3,62,30,32,57
Coleraine,2251,2,14,11,1,43,22,21,53
Linfield,2251,3,11,5,10,39,37,2,38
Glenavon,2251,4,9,10,7,52,43,9,37
Cliftonville,2251,5,9,4,13,33,33,0,31
Ballymena,2251,6,7,4,15,25,48,-23,25
Glentoran,2251,7,6,6,10,24,32,-8,24
Dungannon,2251,8,2,4,16,14,47,-33,10
Crusaders,2252,1,16,7,3,63,32,31,55
Coleraine,2252,2,14,10,2,43,23,20,52
Glenavon,2252,3,10,9,7,53,43,10,39
Linfield,2252,4,11,5,10,38,36,2,38
Cliftonville,2252,5,9,4,13,32,32,0,31
Ballymena,2252,6,7,5,14,27,49,-22,26
Glentoran,2252,7,6,6,10,24,32,-8,24
Dungannon,2252,8,2,4,16,14,47,-33,10
Crusaders,2253,1,16,7,3,62,31,31,55
Coleraine,2253,2,14,11,1,45,24,21,53
Linfield,2253,3,11,5,10,38,36,2,38
Glenavon,2253,4,9,10,7,54,45,9,37
Cliftonville,2253,5,9,4,13,32,32,0,31
Ballymena,2253,6,7,5,14,26,48,-22,26
Glentoran,2253,7,6,6,10,24,32,-8,24
Dungannon,2253,8,2,4,16,14,47,-33,10
Crusaders,2254,1,17,6,3,62,30,32,57
Coleraine,2254,2,14,10,2,43,23,20,52
Glenavon,2254,3,10,9,7,53,43,10,39
Linfield,2254,4,10,6,10,38,37,1,36
Cliftonville,2254,5,9,5,12,33,32,1,32
Ballymena,2254,6,7,4,15,25,48,-23,25
Glentoran,2254,7,6,6,10,24,32,-8,24
Dungannon,2254,8,2,4,16,14,47,-33,10
Crusaders,2255,1,17,6,3,64,31,33,57
Coleraine,2255,2,14,10,2,43,24,19,52
Glenavon,2255,3,10,9,7,54,43,11,39
Linfield,2255,4,10,6,10,37,36,1,36
Cliftonville,2255,5,9,5,12,32,31,1,32
Ballymena,2255,6,7,4,15,26,50,-24,25
Glentoran,2255,7,6,6,10,24,32,-8,24
Dungannon,2255,8,2,4,16,14,47,-33,10
Crusaders,2256,1,16,7,3,64,33,31,55
Coleraine,2256,2,14,11,1,43,22,21,53
Glenavon,2256,3,9,10,7,52,43,9,37
Linfield,2256,4,10,6,10,37,36,1,36
Cliftonville,2256,5,9,5,12,32,31,1,32
Ballymena,2256,6,7,5,14,28,50,-22,26
Glentoran,2256,7,6,6,10,24,32,-8,24
Dungannon,2256,8,2,4,16,14,47,-33,10
Crusaders,2257,1,16,6,4,61,36,25,54
Coleraine,2257,2,14,11,1,46,25,21,53
Glenavon,2257,3,9,10,7,55,46,9,37
Linfield,2257,4,10,5,11,38,38,0,35
Cliftonville,2257,5,10,4,12,34,32,2,34
Ballymena,2257,6,8,4,14,31,47,-16,28
Glentoran,2257,7,6,6,10,24,32,-8,24
Dungannon,2257,8,2,4,16,14,47,-33,10
Crusaders,2258,1,17,6,3,64,31,33,57
Coleraine,2258,2,14,11,1,44,23,21,53
Glenavon,2258,3,9,10,7,53,44,9,37
Linfield,2258,4,10,5,11,38,38,0,35
Cliftonville,2258,5,10,4,12,34,32,2,34
Ballymena,2258,6,7,4,15,26,50,-24,25
Glentoran,2258,7,6,6,10,24,32,-8,24
Dungannon,2258,8,2,4,16,14,47,-33,10
Crusaders,2259,1,17,6,3,63,31,32,57
Coleraine,2259,2,15,10,1,45,23,22,55
Glenavon,2259,3,9,9,8,53,45,8,36
Linfield,2259,4,10,6,10,38,37,1,36
Cliftonville,2259,5,9,5,12,33,32,1,32
Ballymena,2259,6,7,4,15,26,49,-23,25
Glentoran,2259,7,6,6,10,24,32,-8,24
Dungannon,2259,8,2,4,16,14,47,-33,10
Crusaders,2260,1,17,6,3,65,31,34,57
Coleraine,2260,2,14,10,2,43,24,19,52
Glenavon,2260,3,10,9,7,54,43,11,39
Linfield,2260,4,10,6,10,37,36,1,36
Cliftonville,2260,5,9,5,12,32,31,1,32
Ballymena,2260,6,7,4,15,26,51,-25,25
Glentoran,2260,7,6,6,10,24,32,-8,24
Dungannon,2260,8,2,4,16,14,47,-33,10
Crusaders,2261,1,17,6,3,62,30,32,57
Coleraine,2261,2,15,10,1,45,23,22,55
Linfield,2261,3,11,5,10,40,37,3,38
Glenavon,2261,4,9,9,8,53,45,8,36
Cliftonville,2261,5,9,4,13,33,34,-1,31
Ballymena,2261,6,7,4,15,25,48,-23,25
Glentoran,2261,7,6,6,10,24,32,-8,24
Dungannon,2261,8,2,4,16,14,47,-33,10
Crusaders,2262,1,17,6,3,66,31,35,57
Coleraine,2262,2,15,10,1,45,22,23,55
Linfield,2262,3,11,5,10,40,37,3,38
Glenavon,2262,4,9,9,8,52,45,7,36
Cliftonville,2262,5,9,4,13,33,34,-1,31
Ballymena,2262,6,7,4,15,26,52,-26,25
Glentoran,2262,7,6,6,10,24,32,-8,24
Dungannon,2262,8,2,4,16,14,47,-33,10
Crusaders,2263,1,16,7,3,63,32,31,55
Coleraine,2263,2,14,11,1,44,23,21,53
Glenavon,2263,3,9,10,7,53,44,9,37
Linfield,2263,4,10,5,11,38,38,0,35
Cliftonville,2263,5,10,4,12,34,32,2,34
Ballymena,2263,6,7,5,14,27,49,-22,26
Glentoran,2263,7,6,6,10,24,32,-8,24
Dungannon,2263,8,2,4,16,14,47,-33,10
Crusaders,2264,1,17,6,3,64,32,32,57
Coleraine,2264,2,14,10,2,43,26,17,52
Glenavon,2264,3,10,9,7,56,43,13,39
Linfield,2264,4,10,5,11,37,39,-2,35
Cliftonville,2264,5,10,4,12,35,31,4,34
Ballymena,2264,6,7,4,15,27,50,-23,25
Glentoran,2264,7,6,6,10,24,32,-8,24
Dungannon,2264,8,2,4,16,14,47,-33,10
Crusaders,2265,1,16,6,4,62,32,30,54
Coleraine,2265,2,14,10,2,43,25,18,52
Glenavon,2265,3,10,9,7,55,43,12,39
Linfield,2265,4,10,6,10,38,37,1,36
Cliftonville,2265,5,9,5,12,33,32,1,32
Ballymena,2265,6,8,4,14,27,48,-21,28
Glentoran,2265,7,6,6,10,24,32,-8,24
Dungannon,2265,8,2,4,16,14,47,-33,10
Crusaders,2266,1,17,6,3,64,30,34,57
Coleraine,2266,2,14,10,2,44,27,17,52
Glenavon,2266,3,10,9,7,57,44,13,39
Linfield,2266,4,11,5,10,39,37,2,38
Cliftonville,2266,5,9,4,13,33,33,0,31
Ballymena,2266,6,7,4,15,25,50,-25,25
Glentoran,2266,7,6,6,10,24,32,-8,24
Dungannon,2266,8,2,4,16,14,47,-33,10
Coleraine,2267,1,15,10,1,45,22,23,55
Crusaders,2267,2,16,6,4,61,31,30,54
Glenavon,2267,3,9,9,8,52,45,7,36
Linfield,2267,4,10,5,11,38,38,0,35
Cliftonville,2267,5,10,4,12,34,32,2,34
Ballymena,2267,6,8,4,14,26,47,-21,28
Glentoran,2267,7,6,6,10,24,32,-8,24
Dungannon,2267,8,2,4,16,14,47,-33,10
Crusaders,2268,1,16,6,4,62,33,29,54
Coleraine,2268,2,14,11,1,44,23,21,53
Linfield,2268,3,11,5,10,40,37,3,38
Glenavon,2268,4,9,10,7,53,44,9,37
Cliftonville,2268,5,9,4,13,33,34,-1,31
Ballymena,2268,6,8,4,14,28,48,-20,28
Glentoran,2268,7,6,6,10,24,32,-8,24
Dungannon,2268,8,2,4,16,14,47,-33,10
Crusaders,2269,1,16,7,3,62,31,31,55
Coleraine,2269,2,15,10,1,45,23,22,55
Glenavon,2269,3,9,9,8,53,45,8,36
Linfield,2269,4,10,6,10,38,37,1,36
Cliftonville,2269,5,9,5,12,33,32,1,32
Ballymena,2269,6,7,5,14,26,48,-22,26
Glentoran,2269,7,6,6,10,24,32,-8,24
Dungannon,2269,8,2,4,16,14,47,-33,10
Crusaders,2270,1,17,6,3,64,31,33,57
Coleraine,2270,2,14,11,1,44,23,21,53
Linfield,2270,3,11,5,10,39,36,3,38
Glenavon,2270,4,9,10,7,53,44,9,37
Cliftonville,2270,5,9,4,13,32,33,-1,31
Ballymena,2270,6,7,4,15,26,50,-24,25
Glentoran,2270,7,6,6,10,24,32,-8,24
Dungannon,2270,8,2,4,16,14,47,-33,10
Crusaders,2271,1,17,6,3,62,30,32,57
Coleraine,2271,2,14,10,2,43,24,19,52
Glenavon,2271,3,10,9,7,54,43,11,39
Linfield,2271,4,10,5,11,37,37,0,35
Cliftonville,2271,5,10,4,12,33,31,2,34
Ballymena,2271,6,7,4,15,25,48,-23,25
Glentoran,2271,7,6,6,10,24,32,-8,24
Dungannon,2271,8,2,4,16,14,47,-33,10
Crusaders,2272,1,17,6,3,64,31,33,57
Coleraine,2272,2,14,11,1,44,23,21,53
Glenavon,2272,3,9,10,7,53,44,9,37
Linfield,2272,4,10,6,10,38,37,1,36
Cliftonville,2272,5,9,5,12,33,32,1,32
Ballymena,2272,6,7,4,15,26,50,-24,25
Glentoran,2272,7,6,6,10,24,32,-8,24
Dungannon,2272,8,2,4,16,14,47,-33,10
Crusaders,2273,1,16,7,3,62,31,31,55
Coleraine,2273,2,15,10,1,45,23,22,55
Glenavon,2273,3,9,9,8,53,45,8,36
Linfield,2273,4,10,5,11,37,37,0,35
Cliftonville,2273,5,10,4,12,33,31,2,34
Ballymena,2273,6,7,5,14,26,48,-22,26
Glentoran,2273,7,6,6,10,24,32,-8,24
Dungannon,2273,8,2,4,16,14,47,-33,10
Crusaders,2274,1,17,6,3,66,30,36,57
Coleraine,2274,2,14,11,1,46,25,21,53
Glenavon,2274,3,9,10,7,55,46,9,37
Linfield,2274,4,10,6,10,38,37,1,36
Cliftonville,2274,5,9,5,12,33,32,1,32
Ballymena,2274,6,7,4,15,25,52,-27,25
Glentoran,2274,7,6,6,10,24,32,-8,24
Dungannon,2274,8,2,4,16,14,47,-33,10
Crusaders,2275,1,17,6,3,66,30,36,57
Coleraine,2275,2,14,10,2,43,25,18,52
Glenavon,2275,3,10,9,7,55,43,12,39
Linfield,2275,4,10,6,10,38,37,1,36
Cliftonville,2275,5,9,5,12,33,32,1,32
Ballymena,2275,6,7,4,15,25,52,-27,25
Glentoran,2275,7,6,6,10,24,32,-8,24
Dungannon,2275,8,2,4,16,14,47,-33,10
Crusaders,2276,1,17,6,3,65,31,34,57
Coleraine,2276,2,15,10,1,45,23,22,55
Glenavon,2276,3,9,9,8,53,45,8,36
Linfield,2276,4,10,5,11,38,38,0,35
Cliftonville,2276,5,10,4,12,34,32,2,34
Ballymena,2276,6,7,4,15,26,51,-25,25
Glentoran,2276,7,6,6,10,24,32,-8,24
Dungannon,2276,8,2,4,16,14,47,-33,10
Crusaders,2277,1,16,7,3,62,31,31,55
Coleraine,2277,2,15,10,1,44,22,22,55
Glenavon,2277,3,9,9,8,52,44,8,36
Linfield,2277,4,10,6,10,39,38,1,36
Cliftonville,2277,5,9,5,12,34,33,1,32
Ballymena,2277,6,7,5,14,26,48,-22,26
Glentoran,2277,7,6,6,10,24,32,-8,24
Dungannon,2277,8,2,4,16,14,47,-33,10
Crusaders,2278,1,17,6,3,63,30,33,57
Coleraine,2278,2,14,11,1,43,22,21,53
Glenavon,2278,3,9,10,7,52,43,9,37
Linfield,2278,4,10,5,11,37,37,0,35
Cliftonville,2278,5,10,4,12,33,31,2,34
Ballymena,2278,6,7,4,15,25,49,-24,25
Glentoran,2278,7,6,6,10,24,32,-8,24
Dungannon,2278,8,2,4,16,14,47,-33,10
Crusaders,2279,1,16,7,3,62,31,31,55
Coleraine,2279,2,14,10,2,43,24,19,52
Glenavon,2279,3,10,9,7,54,43,11,39
Linfield,2279,4,10,6,10,39,38,1,36
Cliftonville,2279,5,9,5,12,34,33,1,32
Ballymena,2279,6,7,5,14,26,48,-22,26
Glentoran,2279,7,6,6,10,24,32,-8,24
Dungannon,2279,8,2,4,16,14,47,-33,10
Crusaders,2280,1,16,6,4,61,33,28,54
Coleraine,2280,2,14,10,2,45,25,20,52
Glenavon,2280,3,10,9,7,55,45,10,39
Linfield,2280,4,10,6,10,38,37,1,36
Cliftonville,2280,5,9,5,12,33,32,1,32
Ballymena,2280,6,8,4,14,28,47,-19,28
Glentoran,2280,7,6,6,10,24,32,-8,24
Dungannon,2280,8,2,4,16,14,47,-33,10
Crusaders,2281,1,16,7,3,62,31,31,55
Coleraine,2281,2,14,10,2,43,23,20,52
Glenavon,2281,3,10,9,7,53,43,10,39
Linfield,2281,4,10,5,11,37,37,0,35
Cliftonville,2281,5,10,4,12,33,31,2,34
Ballymena,2281,6,7,5,14,26,48,-22,26
Glentoran,2281,7,6,6,10,24,32,-8,24
Dungannon,2281,8,2,4,16,14,47,-33,10
Crusaders,2282,1,16,6,4,62,33,29,54
Coleraine,2282,2,14,11,1,45,24,21,53
Linfield,2282,3,11,5,10,40,38,2,38
Glenavon,2282,4,9,10,7,54,45,9,37
Cliftonville,2282,5,9,4,13,34,34,0,31
Ballymena,2282,6,8,4,14,28,48,-20,28
Glentoran,2282,7,6,6,10,24,32,-8,24
Dungannon,2282,8,2,4,16,14,47,-33,10
Crusaders,2283,1,17,6,3,64,30,34,57
Coleraine,2283,2,15,10,1,45,22,23,55
Glenavon,2283,3,9,9,8,52,45,7,36
Linfield,2283,4,10,5,11,38,38,0,35
Cliftonville,2283,5,10,4,12,34,32,2,34
Ballymena,2283,6,7,4,15,25,50,-25,25
Glentoran,2283,7,6,6,10,24,32,-8,24
Dungannon,2283,8,2,4,16,14,47,-33,10
Crusaders,2284,1,16,7,3,62,31,31,55
Coleraine,2284,2,15,10,1,46,24,22,55
Glenavon,2284,3,9,9,8,54,46,8,36
Linfield,2284,4,10,6,10,38,37,1,36
Cliftonville,2284,5,9,5,12,33,32,1,32
Ballymena,2284,6,7,5,14,26,48,-22,26
Glentoran,2284,7,6,6,10,24,32,-8,24
Dungannon,2284,8,2,4,16,14,47,-33,10
Crusaders,2285,1,17,6,3,63,30,33,57
Coleraine,2285,2,14,11,1,44,23,21,53
Linfield,2285,3,11,5,10,41,36,5,38
Glenavon,2285,4,9,10,7,53,44,9,37
Cliftonville,2285,5,9,4,13,32,35,-3,31
Ballymena,2285,6,7,4,15,25,49,-24,25
Glentoran,2285,7,6,6,10,24,32,-8,24
Dungannon,2285,8,2,4,16,14,47,-33,10
Coleraine,2286,1,15,10,1,47,24,23,55
Crusaders,2286,2,16,6,4,61,33,28,54
Glenavon,2286,3,9,9,8,54,47,7,36
Linfield,2286,4,10,5,11,38,38,0,35
Cliftonville,2286,5,10,4,12,34,32,2,34
Ballymena,2286,6,8,4,14,28,47,-19,28
Glentoran,2286,7,6,6,10,24,32,-8,24
Dungannon,2286,8,2,4,16,14,47,-33,10
Crusaders,2287,1,16,7,3,64,33,31,55
Coleraine,2287,2,14,10,2,43,23,20,52
Glenavon,2287,3,10,9,7,53,43,10,39
Linfield,2287,4,10,6,10,38,37,1,36
Cliftonville,2287,5,9,5,12,33,32,1,32
Ballymena,2287,6,7,5,14,28,50,-22,26
Glentoran,2287,7,6,6,10,24,32,-8,24
Dungannon,2287,8,2,4,16,14,47,-33,10
Crusaders,2288,1,16,7,3,64,33,31,55
Coleraine,2288,2,15,10,1,45,23,22,55
Glenavon,2288,3,9,9,8,53,45,8,36
Linfield,2288,4,10,6,10,38,37,1,36
Cliftonville,2288,5,9,5,12,33,32,1,32
Ballymena,2288,6,7,5,14,28,50,-22,26
Glentoran,2288,7,6,6,10,24,32,-8,24
Dungannon,2288,8,2,4,16,14,47,-33,10
Crusaders,2289,1,16,6,4,61,32,29,54
Coleraine,2289,2,14,11,1,45,24,21,53
Glenavon,2289,3,9,10,7,54,45,9,37
Linfield,2289,4,10,5,11,38,38,0,35
Cliftonville,2289,5,10,4,12,34,32,2,34
Ballymena,2289,6,8,4,14,27,47,-20,28
Glentoran,2289,7,6,6,10,24,32,-8,24
Dungannon,2289,8,2,4,16,14,47,-33,10
Crusaders,2290,1,17,6,3,63,30,33,57
Coleraine,2290,2,14,10,2,43,24,19,52
Glenavon,2290,3,10,9,7,54,43,11,39
Linfield,2290,4,11,5,10,38,36,2,38
Cliftonville,2290,5,9,4,13,32,32,0,31
Ballymena,2290,6,7,4,15,25,49,-24,25
Glentoran,2290,7,6,6,10,24,32,-8,24
Dungannon,2290,8,2,4,16,14,47,-33,10
Crusaders,2291,1,16,6,4,62,32,30,54
Coleraine,2291,2,14,11,1,44,23,21,53
Glenavon,2291,3,9,10,7,53,44,9,37
Linfield,2291,4,10,5,11,37,37,0,35
Cliftonville,2291,5,10,4,12,33,31,2,34
Ballymena,2291,6,8,4,14,27,48,-21,28
Glentoran,2291,7,6,6,10,24,32,-8,24
Dungannon,2291,8,2,4,16,14,47,-33,10
Crusaders,2292,1,16,6,4,61,31,30,54
Coleraine,2292,2,14,11,1,44,23,21,53
Linfield,2292,3,11,5,10,41,37,4,38
Glenavon,2292,4,9,10,7,53,44,9,37
Cliftonville,2292,5,9,4,13,33,35,-2,31
Ballymena,2292,6,8,4,14,26,47,-21,28
Glentoran,2292,7,6,6,10,24,32,-8,24
Dungannon,2292,8,2,4,16,14,47,-33,10
Crusaders,2293,1,17,6,3,64,31,33,57
Coleraine,2293,2,15,10,1,46,24,22,55
Linfield,2293,3,11,5,10,39,37,2,38
Glenavon,2293,4,9,9,8,54,46,8,36
Cliftonville,2293,5,9,4,13,33,33,0,31
Ballymena,2293,6,7,4,15,26,50,-24,25
Glentoran,2293,7,6,6,10,24,32,-8,24
Dungannon,2293,8,2,4,16,14,47,-33,10
Crusaders,2294,1,17,6,3,62,30,32,57
Coleraine,2294,2,15,10,1,47,24,23,55
Glenavon,2294,3,9,9,8,54,47,7,36
Linfield,2294,4,10,6,10,37,36,1,36
Cliftonville,2294,5,9,5,12,32,31,1,32
Ballymena,2294,6,7,4,15,25,48,-23,25
Glentoran,2294,7,6,6,10,24,32,-8,24
Dungannon,2294,8,2,4,16,14,47,-33,10
Crusaders,2295,1,17,6,3,62,30,32,57
Coleraine,2295,2,14,10,2,43,23,20,52
Glenavon,2295,3,10,9,7,53,43,10,39
Linfield,2295,4,10,6,10,37,36,1,36
Cliftonville,2295,5,9,5,12,32,31,1,32
Ballymena,2295,6,7,4,15,25,48,-23,25
Glentoran,2295,7,6,6,10,24,32,-8,24
Dungannon,2295,8,2,4,16,14,47,-33,10
Crusaders,2296,1,17,6,3,65,32,33,57
Coleraine,2296,2,14,11,1,44,23,21,53
Glenavon,2296,3,9,10,7,53,44,9,37
Linfield,2296,4,10,5,11,37,38,-1,35
Cliftonville,2296,5,10,4,12,34,31,3,34
Ballymena,2296,6,7,4,15,27,51,-24,25
Glentoran,2296,7,6,6,10,24,32,-8,24
Dungannon,2296,8,2,4,16,14,47,-33,10
Crusaders,2297,1,16,7,3,64,33,31,55
Coleraine,2297,2,14,11,1,44,23,21,53
Linfield,2297,3,11,5,10,38,36,2,38
Glenavon,2297,4,9,10,7,53,44,9,37
Cliftonville,2297,5,9,4,13,32,32,0,31
Ballymena,2297,6,7,5,14,28,50,-22,26
Glentoran,2297,7,6,6,10,24,32,-8,24
Dungannon,2297,8,2,4,16,14,47,-33,10
Crusaders,2298,1,16,6,4,64,34,30,54
Coleraine,2298,2,14,10,2,43,24,19,52
Glenavon,2298,3,10,9,7,54,43,11,39
Linfield,2298,4,10,6,10,39,38,1,36
Cliftonville,2298,5,9,5,12,34,33,1,32
Ballymena,2298,6,8,4,14,29,50,-21,28
Glentoran,2298,7,6,6,10,24,32,-8,24
Dungannon,2298,8,2,4,16,14,47,-33,10
Crusaders,2299,1,16,6,4,62,33,29,54
Coleraine,2299,2,14,11,1,44,23,21,53
Glenavon,2299,3,9,10,7,53,44,9,37
Linfield,2299,4,10,6,10,37,36,1,36
Cliftonville,2299,5,9,5,12,32,31,1,32
Ballymena,2299,6,8,4,14,28,48,-20,28
Glentoran,2299,7,6,6,10,24,32,-8,24
Dungannon,2299,8,2,4,16,14,47,-33,10
Crusaders,2300,1,17,6,3,64,31,33,57
Coleraine,2300,2,15,10,1,46,24,22,55
Glenavon,2300,3,9,9,8,54,46,8,36
Linfield,2300,4,10,5,11,38,38,0,35
Cliftonville,2300,5,10,4,12,34,32,2,34
Ballymena,2300,6,7,4,15,26,50,-24,25
Glentoran,2300,7,6,6,10,24,32,-8,24
Dungannon,2300,8,2,4,16,14,47,-33,10
Crusaders,2301,1,17,6,3,62,30,32,57
Coleraine,2301,2,14,10,2,43,23,20,52
Glenavon,2301,3,10,9,7,53,43,10,39
Linfield,2301,4,10,6,10,38,37,1,36
Cliftonville,2301,5,9,5,12,33,32,1,32
Ballymena,2301,6,7,4,15,25,48,-23,25
Glentoran,2301,7,6,6,10,24,32,-8,24
Dungannon,2301,8,2,4,16,14,47,-33,10
Crusaders,2302,1,17,6,3,64,30,34,57
Coleraine,2302,2,14,10,2,43,24,19,52
Glenavon,2302,3,10,9,7,54,43,11,39
Linfield,2302,4,11,5,10,39,37,2,38
Cliftonville,2302,5,9,4,13,33,33,0,31
Ballymena,2302,6,7,4,15,25,50,-25,25
Glentoran,2302,7,6,6,10,24,32,-8,24
Dungannon,2302,8,2,4,16,14,47,-33,10
Coleraine,2303,1,15,10,1,44,22,22,55
Crusaders,2303,2,16,6,4,61,32,29,54
Glenavon,2303,3,9,9,8,52,44,8,36
Linfield,2303,4,10,5,11,37,38,-1,35
Cliftonville,2303,5,10,4,12,34,31,3,34
Ballymena,2303,6,8,4,14,27,47,-20,28
Glentoran,2303,7,6,6,10,24,32,-8,24
Dungannon,2303,8,2,4,16,14,47,-33,10
Crusaders,2304,1,17,6,3,64,30,34,57
Coleraine,2304,2,14,10,2,43,26,17,52
Glenavon,2304,3,10,9,7,56,43,13,39
Linfield,2304,4,11,5,10,40,37,3,38
Cliftonville,2304,5,9,4,13,33,34,-1,31
Ballymena,2304,6,7,4,15,25,50,-25,25
Glentoran,2304,7,6,6,10,24,32,-8,24
Dungannon,2304,8,2,4,16,14,47,-33,10
Crusaders,2305,1,17,6,3,63,30,33,57
Coleraine,2305,2,14,10,2,46,26,20,52
Glenavon,2305,3,10,9,7,56,46,10,39
Linfield,2305,4,11,5,10,39,36,3,38
Cliftonville,2305,5,9,4,13,32,33,-1,31
Ballymena,2305,6,7,4,15,25,49,-24,25
Glentoran,2305,7,6,6,10,24,32,-8,24
Dungannon,2305,8,2,4,16,14,47,-33,10
Crusaders,2306,1,17,6,3,62,30,32,57
Coleraine,2306,2,14,11,1,44,23,21,53
Glenavon,2306,3,9,10,7,53,44,9,37
Linfield,2306,4,10,6,10,38,37,1,36
Cliftonville,2306,5,9,5,12,33,32,1,32
Ballymena,2306,6,7,4,15,25,48,-23,25
Glentoran,2306,7,6,6,10,24,32,-8,24
Dungannon,2306,8,2,4,16,14,47,-33,10
Crusaders,2307,1,16,7,3,63,32,31,55
Coleraine,2307,2,15,10,1,47,23,24,55
Linfield,2307,3,11,5,10,40,36,4,38
Glenavon,2307,4,9,9,8,53,47,6,36
Cliftonville,2307,5,9,4,13,32,34,-2,31
Ballymena,2307,6,7,5,14,27,49,-22,26
Glentoran,2307,7,6,6,10,24,32,-8,24
Dungannon,2307,8,2,4,16,14,47,-33,10
Crusaders,2308,1,16,7,3,62,31,31,55
Coleraine,2308,2,14,11,1,46,25,21,53
Glenavon,2308,3,9,10,7,55,46,9,37
Linfield,2308,4,10,5,11,37,38,-1,35
Cliftonville,2308,5,10,4,12,34,31,3,34
Ballymena,2308,6,7,5,14,26,48,-22,26
Glentoran,2308,7,6,6,10,24,32,-8,24
Dungannon,2308,8,2,4,16,14,47,-33,10
Crusaders,2309,1,17,6,3,64,31,33,57
Coleraine,2309,2,14,10,2,43,27,16,52
Glenavon,2309,3,10,9,7,57,43,14,39
Linfield,2309,4,11,5,10,38,36,2,38
Cliftonville,2309,5,9,4,13,32,32,0,31
Ballymena,2309,6,7,4,15,26,50,-24,25
Glentoran,2309,7,6,6,10,24,32,-8,24
Dungannon,2309,8,2,4,16,14,47,-33,10
Crusaders,2310,1,16,6,4,63,33,30,54
Coleraine,2310,2,14,10,2,44,24,20,52
Glenavon,2310,3,10,9,7,54,44,10,39
Linfield,2310,4,11,5,10,39,37,2,38
Cliftonville,2310,5,9,4,13,33,33,0,31
Ballymena,2310,6,8,4,14,28,49,-21,28
Glentoran,2310,7,6,6,10,24,32,-8,24
Dungannon,2310,8,2,4,16,14,47,-33,10
Crusaders,2311,1,17,6,3,66,31,35,57
Coleraine,2311,2,15,10,1,44,22,22,55
Glenavon,2311,3,9,9,8,52,44,8,36
Linfield,2311,4,10,6,10,38,37,1,36
Cliftonville,2311,5,9,5,12,33,32,1,32
Ballymena,2311,6,7,4,15,26,52,-26,25
Glentoran,2311,7,6,6,10,24,32,-8,24
Dungannon,2311,8,2,4,16,14,47,-33,10
Crusaders,2312,1,17,6,3,63,31,32,57
Coleraine,2312,2,14,10,2,43,25,18,52
Glenavon,2312,3,10,9,7,55,43,12,39
Linfield,2312,4,11,5,10,41,39,2,38
Cliftonville,2312,5,9,4,13,35,35,0,31
Ballymena,2312,6,7,4,15,26,49,-23,25
Glentoran,2312,7,6,6,10,24,32,-8,24
Dungannon,2312,8,2,4,16,14,47,-33,10
Crusaders,2313,1,16,6,4,63,33,30,54
Coleraine,2313,2,14,11,1,45,24,21,53
Linfield,2313,3,11,5,10,41,36,5,38
Glenavon,2313,4,9,10,7,54,45,9,37
Cliftonville,2313,5,9,4,13,32,35,-3,31
Ballymena,2313,6,8,4,14,28,49,-21,28
Glentoran,2313,7,6,6,10,24,32,-8,24
Dungannon,2313,8,2,4,16,14,47,-33,10
Crusaders,2314,1,16,6,4,63,33,30,54
Coleraine,2314,2,14,10,2,43,27,16,52
Glenavon,2314,3,10,9,7,57,43,14,39
Linfield,2314,4,11,5,10,40,37,3,38
Cliftonville,2314,5,9,4,13,33,34,-1,31
Ballymena,2314,6,8,4,14,28,49,-21,28
Glentoran,2314,7,6,6,10,24,32,-8,24
Dungannon,2314,8,2,4,16,14,47,-33,10
Crusaders,2315,1,17,6,3,62,30,32,57
Coleraine,2315,2,14,10,2,44,24,20,52
Glenavon,2315,3,10,9,7,54,44,10,39
Linfield,2315,4,10,5,11,37,38,-1,35
Cliftonville,2315,5,10,4,12,34,31,3,34
Ballymena,2315,6,7,4,15,25,48,-23,25
Glentoran,2315,7,6,6,10,24,32,-8,24
Dungannon,2315,8,2,4,16,14,47,-33,10
Crusaders,2316,1,17,6,3,63,30,33,57
Coleraine,2316,2,14,10,2,43,25,18,52
Glenavon,2316,3,10,9,7,55,43,12,39
Linfield,2316,4,10,5,11,38,39,-1,35
Cliftonville,2316,5,10,4,12,35,32,3,34
Ballymena,2316,6,7,4,15,25,49,-24,25
Glentoran,2316,7,6,6,10,24,32,-8,24
Dungannon,2316,8,2,4,16,14,47,-33,10
Crusaders,2317,1,17,6,3,63,30,33,57
Coleraine,2317,2,14,10,2,43,25,18,52
Glenavon,2317,3,10,9,7,55,43,12,39
Linfield,2317,4,10,5,11,38,38,0,35
Cliftonville,2317,5,10,4,12,34,32,2,34
Ballymena,2317,6,7,4,15,25,49,-24,25
Glentoran,2317,7,6,6,10,24,32,-8,24
Dungannon,2317,8,2,4,16,14,47,-33,10
Coleraine,2318,1,15,10,1,44,22,22,55
Crusaders,2318,2,16,6,4,61,31,30,54
Glenavon,2318,3,9,9,8,52,44,8,36
Linfield,2318,4,10,6,10,40,39,1,36
Cliftonville,2318,5,9,5,12,35,34,1,32
Ballymena,2318,6,8,4,14,26,47,-21,28
Glentoran,2318,7,6,6,10,24,32,-8,24
Dungannon,2318,8,2,4,16,14,47,-33,10
Crusaders,2319,1,17,6,3,64,31,33,57
Coleraine,2319,2,15,10,1,45,22,23,55
Glenavon,2319,3,9,9,8,52,45,7,36
Linfield,2319,4,10,5,11,37,38,-1,35
Cliftonville,2319,5,10,4,12,34,31,3,34
Ballymena,2319,6,7,4,15,26,50,-24,25
Glentoran,2319,7,6,6,10,24,32,-8,24
Dungannon,2319,8,2,4,16,14,47,-33,10
Crusaders,2320,1,16,7,3,61,30,31,55
Coleraine,2320,2,14,11,1,45,24,21,53
Glenavon,2320,3,9,10,7,54,45,9,37
Linfield,2320,4,10,6,10,38,37,1,36
Cliftonville,2320,5,9,5,12,33,32,1,32
Ballymena,2320,6,7,5,14,25,47,-22,26
Glentoran,2320,7,6,6,10,24,32,-8,24
Dungannon,2320,8,2,4,16,14,47,-33,10
Crusaders,2321,1,16,7,3,63,32,31,55
Coleraine,2321,2,14,11,1,44,23,21,53
Glenavon,2321,3,9,10,7,53,44,9,37
Linfield,2321,4,10,5,11,38,39,-1,35
Cliftonville,2321,5,10,4,12,35,32,3,34
Ballymena,2321,6,7,5,14,27,49,-22,26
Glentoran,2321,7,6,6,10,24,32,-8,24
Dungannon,2321,8,2,4,16,14,47,-33,10
Crusaders,2322,1,17,6,3,63,31,32,57
Coleraine,2322,2,15,10,1,47,22,25,55
Glenavon,2322,3,9,9,8,52,47,5,36
Linfield,2322,4,10,5,11,38,39,-1,35
Cliftonville,2322,5,10,4,12,35,32,3,34
Ballymena,2322,6,7,4,15,26,49,-23,25
Glentoran,2322,7,6,6,10,24,32,-8,24
Dungannon,2322,8,2,4,16,14,47,-33,10
Crusaders,2323,1,17,6,3,63,31,32,57
Coleraine,2323,2,14,10,2,44,24,20,52
Glenavon,2323,3,10,9,7,54,44,10,39
Linfield,2323,4,10,5,11,39,39,0,35
Cliftonville,2323,5,10,4,12,35,33,2,34
Ballymena,2323,6,7,4,15,26,49,-23,25
Glentoran,2323,7,6,6,10,24,32,-8,24
Dungannon,2323,8,2,4,16,14,47,-33,10
Crusaders,2324,1,16,6,4,61,34,27,54
Coleraine,2324,2,14,11,1,43,22,21,53
Linfield,2324,3,11,5,10,38,36,2,38
Glenavon,2324,4,9,10,7,52,43,9,37
Cliftonville,2324,5,9,4,13,32,32,0,31
Ballymena,2324,6,8,4,14,29,47,-18,28
Glentoran,2324,7,6,6,10,24,32,-8,24
Dungannon,2324,8,2,4,16,14,47,-33,10
Coleraine,2325,1,15,10,1,48,25,23,55
Crusaders,2325,2,16,6,4,61,32,29,54
Glenavon,2325,3,9,9,8,55,48,7,36
Linfield,2325,4,10,5,11,38,38,0,35
Cliftonville,2325,5,10,4,12,34,32,2,34
Ballymena,2325,6,8,4,14,27,47,-20,28
Glentoran,2325,7,6,6,10,24,32,-8,24
Dungannon,2325,8,2,4,16,14,47,-33,10
Crusaders,2326,1,16,6,4,61,32,29,54
Coleraine,2326,2,14,10,2,44,25,19,52
Glenavon,2326,3,10,9,7,55,44,11,39
Linfield,2326,4,10,5,11,38,38,0,35
Cliftonville,2326,5,10,4,12,34,32,2,34
Ballymena,2326,6,8,4,14,27,47,-20,28
Glentoran,2326,7,6,6,10,24,32,-8,24
Dungannon,2326,8,2,4,16,14,47,-33,10
Crusaders,2327,1,17,6,3,66,31,35,57
Coleraine,2327,2,14,10,2,43,25,18,52
Glenavon,2327,3,10,9,7,55,43,12,39
Linfield,2327,4,11,5,10,40,36,4,38
Cliftonville,2327,5,9,4,13,32,34,-2,31
Ballymena,2327,6,7,4,15,26,52,-26,25
Glentoran,2327,7,6,6,10,24,32,-8,24
Dungannon,2327,8,2,4,16,14,47,-33,10
Crusaders,2328,1,17,6,3,63,30,33,57
Coleraine,2328,2,15,10,1,47,25,22,55
Linfield,2328,3,11,5,10,39,37,2,38
Glenavon,2328,4,9,9,8,55,47,8,36
Cliftonville,2328,5,9,4,13,33,33,0,31
Ballymena,2328,6,7,4,15,25,49,-24,25
Glentoran,2328,7,6,6,10,24,32,-8,24
Dungannon,2328,8,2,4,16,14,47,-33,10
Crusaders,2329,1,17,6,3,64,32,32,57
Coleraine,2329,2,14,10,2,44,24,20,52
Glenavon,2329,3,10,9,7,54,44,10,39
Linfield,2329,4,10,5,11,38,38,0,35
Cliftonville,2329,5,10,4,12,34,32,2,34
Ballymena,2329,6,7,4,15,27,50,-23,25
Glentoran,2329,7,6,6,10,24,32,-8,24
Dungannon,2329,8,2,4,16,14,47,-33,10
Crusaders,2330,1,17,6,3,63,31,32,57
Coleraine,2330,2,14,11,1,44,23,21,53
Linfield,2330,3,11,5,10,40,36,4,38
Glenavon,2330,4,9,10,7,53,44,9,37
Cliftonville,2330,5,9,4,13,32,34,-2,31
Ballymena,2330,6,7,4,15,26,49,-23,25
Glentoran,2330,7,6,6,10,24,32,-8,24
Dungannon,2330,8,2,4,16,14,47,-33,10
Crusaders,2331,1,17,6,3,64,32,32,57
Coleraine,2331,2,14,10,2,44,25,19,52
Glenavon,2331,3,10,9,7,55,44,11,39
Linfield,2331,4,10,6,10,38,37,1,36
Cliftonville,2331,5,9,5,12,33,32,1,32
Ballymena,2331,6,7,4,15,27,50,-23,25
Glentoran,2331,7,6,6,10,24,32,-8,24
Dungannon,2331,8,2,4,16,14,47,-33,10
Crusaders,2332,1,16,7,3,62,31,31,55
Coleraine,2332,2,14,11,1,45,24,21,53
Glenavon,2332,3,9,10,7,54,45,9,37
Linfield,2332,4,10,6,10,39,38,1,36
Cliftonville,2332,5,9,5,12,34,33,1,32
Ballymena,2332,6,7,5,14,26,48,-22,26
Glentoran,2332,7,6,6,10,24,32,-8,24
Dungannon,2332,8,2,4,16,14,47,-33,10
Crusaders,2333,1,17,6,3,62,30,32,57
Coleraine,2333,2,14,11,1,44,23,21,53
Linfield,2333,3,11,5,10,40,37,3,38
Glenavon,2333,4,9,10,7,53,44,9,37
Cliftonville,2333,5,9,4,13,33,34,-1,31
Ballymena,2333,6,7,4,15,25,48,-23,25
Glentoran,2333,7,6,6,10,24,32,-8,24
Dungannon,2333,8,2,4,16,14,47,-33,10
Crusaders,2334,1,16,6,4,62,32,30,54
Coleraine,2334,2,14,10,2,43,25,18,52
Glenavon,2334,3,10,9,7,55,43,12,39
Linfield,2334,4,10,5,11,38,38,0,35
Cliftonville,2334,5,10,4,12,34,32,2,34
Ballymena,2334,6,8,4,14,27,48,-21,28
Glentoran,2334,7,6,6,10,24,32,-8,24
Dungannon,2334,8,2,4,16,14,47,-33,10
Coleraine,2335,1,15,10,1,45,23,22,55
Crusaders,2335,2,16,6,4,62,32,30,54
Glenavon,2335,3,9,9,8,53,45,8,36
Linfield,2335,4,10,5,11,38,44,-6,35
Cliftonville,2335,5,10,4,12,40,32,8,34
Ballymena,2335,6,8,4,14,27,48,-21,28
Glentoran,2335,7,6,6,10,24,32,-8,24
Dungannon,2335,8,2,4,16,14,47,-33,10
Crusaders,2336,1,17,6,3,65,30,35,57
Coleraine,2336,2,14,10,2,45,26,19,52
Glenavon,2336,3,10,9,7,56,45,11,39
Linfield,2336,4,10,6,10,38,37,1,36
Cliftonville,2336,5,9,5,12,33,32,1,32
Ballymena,2336,6,7,4,15,25,51,-26,25
Glentoran,2336,7,6,6,10,24,32,-8,24
Dungannon,2336,8,2,4,16,14,47,-33,10
Crusaders,2337,1,17,6,3,67,32,35,57
Coleraine,2337,2,14,11,1,45,24,21,53
Glenavon,2337,3,9,10,7,54,45,9,37
Linfield,2337,4,10,5,11,38,38,0,35
Cliftonville,2337,5,10,4,12,34,32,2,34
Ballymena,2337,6,7,4,15,27,53,-26,25
Glentoran,2337,7,6,6,10,24,32,-8,24
Dungannon,2337,8,2,4,16,14,47,-33,10
Crusaders,2338,1,16,7,3,62,31,31,55
Coleraine,2338,2,15,10,1,46,24,22,55
Linfield,2338,3,11,5,10,39,36,3,38
Glenavon,2338,4,9,9,8,54,46,8,36
Cliftonville,2338,5,9,4,13,32,33,-1,31
Ballymena,2338,6,7,5,14,26,48,-22,26
Glentoran,2338,7,6,6,10,24,32,-8,24
Dungannon,2338,8,2,4,16,14,47,-33,10
Crusaders,2339,1,17,6,3,64,30,34,57
Coleraine,2339,2,15,10,1,46,23,23,55
Linfield,2339,3,11,5,10,40,36,4,38
Glenavon,2339,4,9,9,8,53,46,7,36
Cliftonville,2339,5,9,4,13,32,34,-2,31
Ballymena,2339,6,7,4,15,25,50,-25,25
Glentoran,2339,7,6,6,10,24,32,-8,24
Dungannon,2339,8,2,4,16,14,47,-33,10
Coleraine,2340,1,15,10,1,46,24,22,55
Crusaders,2340,2,16,6,4,61,31,30,54
Linfield,2340,3,11,5,10,41,38,3,38
Glenavon,2340,4,9,9,8,54,46,8,36
Cliftonville,2340,5,9,4,13,34,35,-1,31
Ballymena,2340,6,8,4,14,26,47,-21,28
Glentoran,2340,7,6,6,10,24,32,-8,24
Dungannon,2340,8,2,4,16,14,47,-33,10
Crusaders,2341,1,17,6,3,64,30,34,57
Coleraine,2341,2,14,11,1,43,22,21,53
Glenavon,2341,3,9,10,7,52,43,9,37
Linfield,2341,4,10,5,11,37,37,0,35
Cliftonville,2341,5,10,4,12,33,31,2,34
Ballymena,2341,6,7,4,15,25,50,-25,25
Glentoran,2341,7,6,6,10,24,32,-8,24
Dungannon,2341,8,2,4,16,14,47,-33,10
Crusaders,2342,1,17,6,3,63,30,33,57
Coleraine,2342,2,14,10,2,45,26,19,52
Glenavon,2342,3,10,9,7,56,45,11,39
Linfield,2342,4,10,5,11,39,40,-1,35
Cliftonville,2342,5,10,4,12,36,33,3,34
Ballymena,2342,6,7,4,15,25,49,-24,25
Glentoran,2342,7,6,6,10,24,32,-8,24
Dungannon,2342,8,2,4,16,14,47,-33,10
Crusaders,2343,1,16,7,3,61,30,31,55
Coleraine,2343,2,14,10,2,43,23,20,52
Glenavon,2343,3,10,9,7,53,43,10,39
Linfield,2343,4,10,5,11,37,39,-2,35
Cliftonville,2343,5,10,4,12,35,31,4,34
Ballymena,2343,6,7,5,14,25,47,-22,26
Glentoran,2343,7,6,6,10,24,32,-8,24
Dungannon,2343,8,2,4,16,14,47,-33,10
Crusaders,2344,1,17,6,3,65,32,33,57
Coleraine,2344,2,14,10,2,45,29,16,52
Glenavon,2344,3,10,9,7,59,45,14,39
Linfield,2344,4,11,5,10,40,38,2,38
Cliftonville,2344,5,9,4,13,34,34,0,31
Ballymena,2344,6,7,4,15,27,51,-24,25
Glentoran,2344,7,6,6,10,24,32,-8,24
Dungannon,2344,8,2,4,16,14,47,-33,10
Crusaders,2345,1,17,6,3,66,32,34,57
Coleraine,2345,2,15,10,1,46,22,24,55
Linfield,2345,3,11,5,10,40,37,3,38
Glenavon,2345,4,9,9,8,52,46,6,36
Cliftonville,2345,5,9,4,13,33,34,-1,31
Ballymena,2345,6,7,4,15,27,52,-25,25
Glentoran,2345,7,6,6,10,24,32,-8,24
Dungannon,2345,8,2,4,16,14,47,-33,10
Coleraine,2346,1,15,10,1,45,23,22,55
Crusaders,2346,2,16,6,4,61,34,27,54
Linfield,2346,3,11,5,10,38,36,2,38
Glenavon,2346,4,9,9,8,53,45,8,36
Cliftonville,2346,5,9,4,13,32,32,0,31
Ballymena,2346,6,8,4,14,29,47,-18,28
Glentoran,2346,7,6,6,10,24,32,-8,24
Dungannon,2346,8,2,4,16,14,47,-33,10
Crusaders,2347,1,16,7,3,61,30,31,55
Coleraine,2347,2,15,10,1,44,22,22,55
Glenavon,2347,3,9,9,8,52,44,8,36
Linfield,2347,4,10,6,10,38,37,1,36
Cliftonville,2347,5,9,5,12,33,32,1,32
Ballymena,2347,6,7,5,14,25,47,-22,26
Glentoran,2347,7,6,6,10,24,32,-8,24
Dungannon,2347,8,2,4,16,14,47,-33,10
Crusaders,2348,1,17,6,3,67,31,36,57
Coleraine,2348,2,14,10,2,44,24,20,52
Glenavon,2348,3,10,9,7,54,44,10,39
Linfield,2348,4,11,5,10,38,36,2,38
Cliftonville,2348,5,9,4,13,32,32,0,31
Ballymena,2348,6,7,4,15,26,53,-27,25
Glentoran,2348,7,6,6,10,24,32,-8,24
Dungannon,2348,8,2,4,16,14,47,-33,10
Crusaders,2349,1,16,6,4,61,31,30,54
Coleraine,2349,2,14,11,1,43,22,21,53
Glenavon,2349,3,9,10,7,52,43,9,37
Linfield,2349,4,10,6,10,38,37,1,36
Cliftonville,2349,5,9,5,12,33,32,1,32
Ballymena,2349,6,8,4,14,26,47,-21,28
Glentoran,2349,7,6,6,10,24,32,-8,24
Dungannon,2349,8,2,4,16,14,47,-33,10
Crusaders,2350,1,17,6,3,65,32,33,57
Coleraine,2350,2,14,10,2,45,29,16,52
Glenavon,2350,3,10,9,7,59,45,14,39
Linfield,2350,4,11,5,10,40,36,4,38
Cliftonville,2350,5,9,4,13,32,34,-2,31
Ballymena,2350,6,7,4,15,27,51,-24,25
Glentoran,2350,7,6,6,10,24,32,-8,24
Dungannon,2350,8,2,4,16,14,47,-33,10
Crusaders,2351,1,16,7,3,62,31,31,55
Coleraine,2351,2,14,10,2,44,27,17,52
Glenavon,2351,3,10,9,7,57,44,13,39
Linfield,2351,4,10,6,10,37,36,1,36
Cliftonville,2351,5,9,5,12,32,31,1,32
Ballymena,2351,6,7,5,14,26,48,-22,26
Glentoran,2351,7,6,6,10,24,32,-8,24
Dungannon,2351,8,2,4,16,14,47,-33,10
Crusaders,2352,1,17,6,3,64,31,33,57
Coleraine,2352,2,14,11,1,44,23,21,53
Linfield,2352,3,11,5,10,40,37,3,38
Glenavon,2352,4,9,10,7,53,44,9,37
Cliftonville,2352,5,9,4,13,33,34,-1,31
Ballymena,2352,6,7,4,15,26,50,-24,25
Glentoran,2352,7,6,6,10,24,32,-8,24
Dungannon,2352,8,2,4,16,14,47,-33,10
Crusaders,2353,1,16,6,4,62,32,30,54
Coleraine,2353,2,14,10,2,43,25,18,52
Glenavon,2353,3,10,9,7,55,43,12,39
Linfield,2353,4,10,6,10,37,36,1,36
Cliftonville,2353,5,9,5,12,32,31,1,32
Ballymena,2353,6,8,4,14,27,48,-21,28
Glentoran,2353,7,6,6,10,24,32,-8,24
Dungannon,2353,8,2,4,16,14,47,-33,10
Crusaders,2354,1,16,6,4,62,32,30,54
Coleraine,2354,2,14,11,1,46,25,21,53
Glenavon,2354,3,9,10,7,55,46,9,37
Linfield,2354,4,10,6,10,37,36,1,36
Cliftonville,2354,5,9,5,12,32,31,1,32
Ballymena,2354,6,8,4,14,27,48,-21,28
Glentoran,2354,7,6,6,10,24,32,-8,24
Dungannon,2354,8,2,4,16,14,47,-33,10
Crusaders,2355,1,17,6,3,63,31,32,57
Coleraine,2355,2,14,10,2,43,27,16,52
Glenavon,2355,3,10,9,7,57,43,14,39
Linfield,2355,4,11,5,10,39,37,2,38
Cliftonville,2355,5,9,4,13,33,33,0,31
Ballymena,2355,6,7,4,15,26,49,-23,25
Glentoran,2355,7,6,6,10,24,32,-8,24
Dungannon,2355,8,2,4,16,14,47,-33,10
Crusaders,2356,1,16,7,3,62,31,31,55
Coleraine,2356,2,15,10,1,45,22,23,55
Glenavon,2356,3,9,9,8,52,45,7,36
Linfield,2356,4,10,6,10,38,37,1,36
Cliftonville,2356,5,9,5,12,33,32,1,32
Ballymena,2356,6,7,5,14,26,48,-22,26
Glentoran,2356,7,6,6,10,24,32,-8,24
Dungannon,2356,8,2,4,16,14,47,-33,10
Crusaders,2357,1,16,7,3,62,31,31,55
Coleraine,2357,2,15,10,1,47,24,23,55
Linfield,2357,3,11,5,10,39,37,2,38
Glenavon,2357,4,9,9,8,54,47,7,36
Cliftonville,2357,5,9,4,13,33,33,0,31
Ballymena,2357,6,7,5,14,26,48,-22,26
Glentoran,2357,7,6,6,10,24,32,-8,24
Dungannon,2357,8,2,4,16,14,47,-33,10
Coleraine,2358,1,15,10,1,47,22,25,55
Crusaders,2358,2,16,6,4,61,31,30,54
Glenavon,2358,3,9,9,8,52,47,5,36
Linfield,2358,4,10,5,11,37,37,0,35
Cliftonville,2358,5,10,4,12,33,31,2,34
Ballymena,2358,6,8,4,14,26,47,-21,28
Glentoran,2358,7,6,6,10,24,32,-8,24
Dungannon,2358,8,2,4,16,14,47,-33,10
Crusaders,2359,1,16,6,4,61,31,30,54
Coleraine,2359,2,14,11,1,44,23,21,53
Glenavon,2359,3,9,10,7,53,44,9,37
Linfield,2359,4,10,6,10,37,36,1,36
Cliftonville,2359,5,9,5,12,32,31,1,32
Ballymena,2359,6,8,4,14,26,47,-21,28
Glentoran,2359,7,6,6,10,24,32,-8,24
Dungannon,2359,8,2,4,16,14,47,-33,10
Crusaders,2360,1,17,6,3,64,31,33,57
Coleraine,2360,2,14,11,1,44,23,21,53
Glenavon,2360,3,9,10,7,53,44,9,37
Linfield,2360,4,10,5,11,38,38,0,35
Cliftonville,2360,5,10,4,12,34,32,2,34
Ballymena,2360,6,7,4,15,26,50,-24,25
Glentoran,2360,7,6,6,10,24,32,-8,24
Dungannon,2360,8,2,4,16,14,47,-33,10
Crusaders,2361,1,17,6,3,63,30,33,57
Coleraine,2361,2,14,10,2,43,25,18,52
Glenavon,2361,3,10,9,7,55,43,12,39
Linfield,2361,4,11,5,10,38,36,2,38
Cliftonville,2361,5,9,4,13,32,32,0,31
Ballymena,2361,6,7,4,15,25,49,-24,25
Glentoran,2361,7,6,6,10,24,32,-8,24
Dungannon,2361,8,2,4,16,14,47,-33,10
Crusaders,2362,1,17,6,3,67,32,35,57
Coleraine,2362,2,15,10,1,45,22,23,55
Linfield,2362,3,11,5,10,38,36,2,38
Glenavon,2362,4,9,9,8,52,45,7,36
Cliftonville,2362,5,9,4,13,32,32,0,31
Ballymena,2362,6,7,4,15,27,53,-26,25
Glentoran,2362,7,6,6,10,24,32,-8,24
Dungannon,2362,8,2,4,16,14,47,-33,10
Crusaders,2363,1,16,7,3,62,31,31,55
Coleraine,2363,2,14,10,2,44,25,19,52
Glenavon,2363,3,10,9,7,55,44,11,39
Linfield,2363,4,11,5,10,38,36,2,38
Cliftonville,2363,5,9,4,13,32,32,0,31
Ballymena,2363,6,7,5,14,26,48,-22,26
Glentoran,2363,7,6,6,10,24,32,-8,24
Dungannon,2363,8,2,4,16,14,47,-33,10
Crusaders,2364,1,16,7,3,61,30,31,55
Coleraine,2364,2,14,10,2,43,23,20,52
Glenavon,2364,3,10,9,7,53,43,10,39
Linfield,2364,4,10,5,11,39,39,0,35
Cliftonville,2364,5,10,4,12,35,33,2,34
Ballymena,2364,6,7,5,14,25,47,-22,26
Glentoran,2364,7,6,6,10,24,32,-8,24
Dungannon,2364,8,2,4,16,14,47,-33,10
Crusaders,2365,1,17,6,3,62,30,32,57
Coleraine,2365,2,14,10,2,45,26,19,52
Glenavon,2365,3,10,9,7,56,45,11,39
Linfield,2365,4,11,5,10,39,36,3,38
Cliftonville,2365,5,9,4,13,32,33,-1,31
Ballymena,2365,6,7,4,15,25,48,-23,25
Glentoran,2365,7,6,6,10,24,32,-8,24
Dungannon,2365,8,2,4,16,14,47,-33,10
Crusaders,2366,1,17,6,3,65,33,32,57
Coleraine,2366,2,15,10,1,45,22,23,55
Glenavon,2366,3,9,9,8,52,45,7,36
Linfield,2366,4,10,6,10,38,37,1,36
Cliftonville,2366,5,9,5,12,33,32,1,32
Ballymena,2366,6,7,4,15,28,51,-23,25
Glentoran,2366,7,6,6,10,24,32,-8,24
Dungannon,2366,8,2,4,16,14,47,-33,10
Crusaders,2367,1,16,7,3,64,33,31,55
Coleraine,2367,2,14,10,2,43,24,19,52
Glenavon,2367,3,10,9,7,54,43,11,39
Linfield,2367,4,10,6,10,39,38,1,36
Cliftonville,2367,5,9,5,12,34,33,1,32
Ballymena,2367,6,7,5,14,28,50,-22,26
Glentoran,2367,7,6,6,10,24,32,-8,24
Dungannon,2367,8,2,4,16,14,47,-33,10
Crusaders,2368,1,17,6,3,62,30,32,57
Coleraine,2368,2,14,10,2,43,24,19,52
Glenavon,2368,3,10,9,7,54,43,11,39
Linfield,2368,4,11,5,10,39,36,3,38
Cliftonville,2368,5,9,4,13,32,33,-1,31
Ballymena,2368,6,7,4,15,25,48,-23,25
Glentoran,2368,7,6,6,10,24,32,-8,24
Dungannon,2368,8,2,4,16,14,47,-33,10
Crusaders,2369,1,17,6,3,63,30,33,57
Coleraine,2369,2,14,11,1,45,24,21,53
Glenavon,2369,3,9,10,7,54,45,9,37
Linfield,2369,4,10,6,10,38,37,1,36
Cliftonville,2369,5,9,5,12,33,32,1,32
Ballymena,2369,6,7,4,15,25,49,-24,25
Glentoran,2369,7,6,6,10,24,32,-8,24
Dungannon,2369,8,2,4,16,14,47,-33,10
Crusaders,2370,1,17,6,3,63,31,32,57
Coleraine,2370,2,14,10,2,44,24,20,52
Glenavon,2370,3,10,9,7,54,44,10,39
Linfield,2370,4,11,5,10,39,36,3,38
Cliftonville,2370,5,9,4,13,32,33,-1,31
Ballymena,2370,6,7,4,15,26,49,-23,25
Glentoran,2370,7,6,6,10,24,32,-8,24
Dungannon,2370,8,2,4,16,14,47,-33,10
Crusaders,2371,1,16,6,4,62,33,29,54
Coleraine,2371,2,14,10,2,45,26,19,52
Glenavon,2371,3,10,9,7,56,45,11,39
Linfield,2371,4,10,5,11,39,39,0,35
Cliftonville,2371,5,10,4,12,35,33,2,34
Ballymena,2371,6,8,4,14,28,48,-20,28
Glentoran,2371,7,6,6,10,24,32,-8,24
Dungannon,2371,8,2,4,16,14,47,-33,10
Crusaders,2372,1,16,6,4,61,31,30,54
Coleraine,2372,2,14,10,2,43,23,20,52
Glenavon,2372,3,10,9,7,53,43,10,39
Linfield,2372,4,10,5,11,37,37,0,35
Cliftonville,2372,5,10,4,12,33,31,2,34
Ballymena,2372,6,8,4,14,26,47,-21,28
Glentoran,2372,7,6,6,10,24,32,-8,24
Dungannon,2372,8,2,4,16,14,47,-33,10
Crusaders,2373,1,17,6,3,66,32,34,57
Coleraine,2373,2,15,10,1,45,23,22,55
Linfield,2373,3,11,5,10,39,36,3,38
Glenavon,2373,4,9,9,8,53,45,8,36
Cliftonville,2373,5,9,4,13,32,33,-1,31
Ballymena,2373,6,7,4,15,27,52,-25,25
Glentoran,2373,7,6,6,10,24,32,-8,24
Dungannon,2373,8,2,4,16,14,47,-33,10
Crusaders,2374,1,17,6,3,66,33,33,57
Coleraine,2374,2,14,10,2,45,25,20,52
Glenavon,2374,3,10,9,7,55,45,10,39
Linfield,2374,4,10,5,11,39,40,-1,35
Cliftonville,2374,5,10,4,12,36,33,3,34
Ballymena,2374,6,7,4,15,28,52,-24,25
Glentoran,2374,7,6,6,10,24,32,-8,24
Dungannon,2374,8,2,4,16,14,47,-33,10
Coleraine,2375,1,15,10,1,44,22,22,55
Crusaders,2375,2,16,6,4,62,32,30,54
Linfield,2375,3,11,5,10,38,36,2,38
Glenavon,2375,4,9,9,8,52,44,8,36
Cliftonville,2375,5,9,4,13,32,32,0,31
Ballymena,2375,6,8,4,14,27,48,-21,28
Glentoran,2375,7,6,6,10,24,32,-8,24
Dungannon,2375,8,2,4,16,14,47,-33,10
Crusaders,2376,1,16,7,3,63,32,31,55
Coleraine,2376,2,14,10,2,44,26,18,52
Glenavon,2376,3,10,9,7,56,44,12,39
Linfield,2376,4,10,6,10,38,37,1,36
Cliftonville,2376,5,9,5,12,33,32,1,32
Ballymena,2376,6,7,5,14,27,49,-22,26
Glentoran,2376,7,6,6,10,24,32,-8,24
Dungannon,2376,8,2,4,16,14,47,-33,10
Crusaders,2377,1,17,6,3,62,30,32,57
Coleraine,2377,2,14,10,2,44,24,20,52
Glenavon,2377,3,10,9,7,54,44,10,39
Linfield,2377,4,10,6,10,39,38,1,36
Cliftonville,2377,5,9,5,12,34,33,1,32
Ballymena,2377,6,7,4,15,25,48,-23,25
Glentoran,2377,7,6,6,10,24,32,-8,24
Dungannon,2377,8,2,4,16,14,47,-33,10
Crusaders,2378,1,17,6,3,66,34,32,57
Coleraine,2378,2,15,10,1,46,22,24,55
Linfield,2378,3,11,5,10,39,37,2,38
Glenavon,2378,4,9,9,8,52,46,6,36
Cliftonville,2378,5,9,4,13,33,33,0,31
Ballymena,2378,6,7,4,15,29,52,-23,25
Glentoran,2378,7,6,6,10,24,32,-8,24
Dungannon,2378,8,2,4,16,14,47,-33,10
Crusaders,2379,1,17,6,3,62,30,32,57
Coleraine,2379,2,14,11,1,44,23,21,53
Linfield,2379,3,11,5,10,39,37,2,38
Glenavon,2379,4,9,10,7,53,44,9,37
Cliftonville,2379,5,9,4,13,33,33,0,31
Ballymena,2379,6,7,4,15,25,48,-23,25
Glentoran,2379,7,6,6,10,24,32,-8,24
Dungannon,2379,8,2,4,16,14,47,-33,10
Crusaders,2380,1,17,6,3,65,31,34,57
Coleraine,2380,2,14,11,1,47,26,21,53
Linfield,2380,3,11,5,10,38,36,2,38
Glenavon,2380,4,9,10,7,56,47,9,37
Cliftonville,2380,5,9,4,13,32,32,0,31
Ballymena,2380,6,7,4,15,26,51,-25,25
Glentoran,2380,7,6,6,10,24,32,-8,24
Dungannon,2380,8,2,4,16,14,47,-33,10
Crusaders,2381,1,16,6,4,63,34,29,54
Coleraine,2381,2,14,10,2,44,24,20,52
Glenavon,2381,3,10,9,7,54,44,10,39
Linfield,2381,4,10,6,10,38,37,1,36
Cliftonville,2381,5,9,5,12,33,32,1,32
Ballymena,2381,6,8,4,14,29,49,-20,28
Glentoran,2381,7,6,6,10,24,32,-8,24
Dungannon,2381,8,2,4,16,14,47,-33,10
Crusaders,2382,1,17,6,3,63,31,32,57
Coleraine,2382,2,14,10,2,43,23,20,52
Glenavon,2382,3,10,9,7,53,43,10,39
Linfield,2382,4,10,5,11,38,38,0,35
Cliftonville,2382,5,10,4,12,34,32,2,34
Ballymena,2382,6,7,4,15,26,49,-23,25
Glentoran,2382,7,6,6,10,24,32,-8,24
Dungannon,2382,8,2,4,16,14,47,-33,10
Crusaders,2383,1,16,6,4,61,33,28,54
Coleraine,2383,2,14,10,2,44,25,19,52
Glenavon,2383,3,10,9,7,55,44,11,39
Linfield,2383,4,11,5,10,40,36,4,38
Cliftonville,2383,5,9,4,13,32,34,-2,31
Ballymena,2383,6,8,4,14,28,47,-19,28
Glentoran,2383,7,6,6,10,24,32,-8,24
Dungannon,2383,8,2,4,16,14,47,-33,10
Crusaders,2384,1,17,6,3,64,31,33,57
Coleraine,2384,2,14,10,2,43,23,20,52
Glenavon,2384,3,10,9,7,53,43,10,39
Linfield,2384,4,10,6,10,38,37,1,36
Cliftonville,2384,5,9,5,12,33,32,1,32
Ballymena,2384,6,7,4,15,26,50,-24,25
Glentoran,2384,7,6,6,10,24,32,-8,24
Dungannon,2384,8,2,4,16,14,47,-33,10
Crusaders,2385,1,16,6,4,62,33,29,54
Coleraine,2385,2,14,10,2,44,25,19,52
Glenavon,2385,3,10,9,7,55,44,11,39
Linfield,2385,4,11,5,10,38,36,2,38
Cliftonville,2385,5,9,4,13,32,32,0,31
Ballymena,2385,6,8,4,14,28,48,-20,28
Glentoran,2385,7,6,6,10,24,32,-8,24
Dungannon,2385,8,2,4,16,14,47,-33,10
Crusaders,2386,1,17,6,3,62,30,32,57
Coleraine,2386,2,15,10,1,46,22,24,55
Linfield,2386,3,11,5,10,39,36,3,38
Glenavon,2386,4,9,9,8,52,46,6,36
Cliftonville,2386,5,9,4,13,32,33,-1,31
Ballymena,2386,6,7,4,15,25,48,-23,25
Glentoran,2386,7,6,6,10,24,32,-8,24
Dungannon,2386,8,2,4,16,14,47,-33,10
Crusaders,2387,1,17,6,3,63,30,33,57
Coleraine,2387,2,15,10,1,45,23,22,55
Glenavon,2387,3,9,9,8,53,45,8,36
Linfield,2387,4,10,6,10,39,38,1,36
Cliftonville,2387,5,9,5,12,34,33,1,32
Ballymena,2387,6,7,4,15,25,49,-24,25
Glentoran,2387,7,6,6,10,24,32,-8,24
Dungannon,2387,8,2,4,16,14,47,-33,10
Crusaders,2388,1,17,6,3,63,31,32,57
Coleraine,2388,2,14,10,2,43,24,19,52
Glenavon,2388,3,10,9,7,54,43,11,39
Linfield,2388,4,11,5,10,39,36,3,38
Cliftonville,2388,5,9,4,13,32,33,-1,31
Ballymena,2388,6,7,4,15,26,49,-23,25
Glentoran,2388,7,6,6,10,24,32,-8,24
Dungannon,2388,8,2,4,16,14,47,-33,10
Crusaders,2389,1,17,6,3,63,30,33,57
Coleraine,2389,2,14,10,2,44,24,20,52
Glenavon,2389,3,10,9,7,54,44,10,39
Linfield,2389,4,11,5,10,39,36,3,38
Cliftonville,2389,5,9,4,13,32,33,-1,31
Ballymena,2389,6,7,4,15,25,49,-24,25
Glentoran,2389,7,6,6,10,24,32,-8,24
Dungannon,2389,8,2,4,16,14,47,-33,10
Crusaders,2390,1,17,6,3,64,30,34,57
Coleraine,2390,2,14,10,2,45,26,19,52
Glenavon,2390,3,10,9,7,56,45,11,39
Linfield,2390,4,11,5,10,40,37,3,38
Cliftonville,2390,5,9,4,13,33,34,-1,31
Ballymena,2390,6,7,4,15,25,50,-25,25
Glentoran,2390,7,6,6,10,24,32,-8,24
Dungannon,2390,8,2,4,16,14,47,-33,10
Coleraine,2391,1,15,10,1,45,23,22,55
Crusaders,2391,2,16,6,4,62,32,30,54
Linfield,2391,3,11,5,10,39,37,2,38
Glenavon,2391,4,9,9,8,53,45,8,36
Cliftonville,2391,5,9,4,13,33,33,0,31
Ballymena,2391,6,8,4,14,27,48,-21,28
Glentoran,2391,7,6,6,10,24,32,-8,24
Dungannon,2391,8,2,4,16,14,47,-33,10
Crusaders,2392,1,16,6,4,61,31,30,54
Coleraine,2392,2,14,10,2,43,23,20,52
Glenavon,2392,3,10,9,7,53,43,10,39
Linfield,2392,4,10,5,11,39,39,0,35
Cliftonville,2392,5,10,4,12,35,33,2,34
Ballymena,2392,6,8,4,14,26,47,-21,28
Glentoran,2392,7,6,6,10,24,32,-8,24
Dungannon,2392,8,2,4,16,14,47,-33,10
Crusaders,2393,1,17,6,3,65,33,32,57
Coleraine,2393,2,15,10,1,45,22,23,55
Glenavon,2393,3,9,9,8,52,45,7,36
Linfield,2393,4,10,6,10,37,36,1,36
Cliftonville,2393,5,9,5,12,32,31,1,32
Ballymena,2393,6,7,4,15,28,51,-23,25
Glentoran,2393,7,6,6,10,24,32,-8,24
Dungannon,2393,8,2,4,16,14,47,-33,10
Crusaders,2394,1,17,6,3,64,31,33,57
Coleraine,2394,2,15,10,1,44,22,22,55
Linfield,2394,3,11,5,10,40,36,4,38
Glenavon,2394,4,9,9,8,52,44,8,36
Cliftonville,2394,5,9,4,13,32,34,-2,31
Ballymena,2394,6,7,4,15,26,50,-24,25
Glentoran,2394,7,6,6,10,24,32,-8,24
Dungannon,2394,8,2,4,16,14,47,-33,10
Crusaders,2395,1,16,7,3,63,32,31,55
Coleraine,2395,2,14,10,2,44,24,20,52
Glenavon,2395,3,10,9,7,54,44,10,39
Linfield,2395,4,11,5,10,40,37,3,38
Cliftonville,2395,5,9,4,13,33,34,-1,31
Ballymena,2395,6,7,5,14,27,49,-22,26
Glentoran,2395,7,6,6,10,24,32,-8,24
Dungannon,2395,8,2,4,16,14,47,-33,10
Crusaders,2396,1,17,6,3,66,32,34,57
Coleraine,2396,2,15,10,1,48,23,25,55
Glenavon,2396,3,9,9,8,53,48,5,36
Linfield,2396,4,10,6,10,37,36,1,36
Cliftonville,2396,5,9,5,12,32,31,1,32
Ballymena,2396,6,7,4,15,27,52,-25,25
Glentoran,2396,7,6,6,10,24,32,-8,24
Dungannon,2396,8,2,4,16,14,47,-33,10
Crusaders,2397,1,17,6,3,62,30,32,57
Coleraine,2397,2,14,10,2,44,25,19,52
Glenavon,2397,3,10,9,7,55,44,11,39
Linfield,2397,4,11,5,10,38,36,2,38
Cliftonville,2397,5,9,4,13,32,32,0,31
Ballymena,2397,6,7,4,15,25,48,-23,25
Glentoran,2397,7,6,6,10,24,32,-8,24
Dungannon,2397,8,2,4,16,14,47,-33,10
Crusaders,2398,1,17,6,3,62,30,32,57
Coleraine,2398,2,14,10,2,43,25,18,52
Glenavon,2398,3,10,9,7,55,43,12,39
Linfield,2398,4,11,5,10,40,36,4,38
Cliftonville,2398,5,9,4,13,32,34,-2,31
Ballymena,2398,6,7,4,15,25,48,-23,25
Glentoran,2398,7,6,6,10,24,32,-8,24
Dungannon,2398,8,2,4,16,14,47,-33,10
Crusaders,2399,1,17,6,3,63,30,33,57
Coleraine,2399,2,14,10,2,43,24,19,52
Glenavon,2399,3,10,9,7,54,43,11,39
Linfield,2399,4,11,5,10,38,36,2,38
Cliftonville,2399,5,9,4,13,32,32,0,31
Ballymena,2399,6,7,4,15,25,49,-24,25
Glentoran,2399,7,6,6,10,24,32,-8,24
Dungannon,2399,8,2,4,16,14,47,-33,10
Crusaders,2400,1,17,6,3,63,31,32,57
Coleraine,2400,2,15,10,1,46,22,24,55
Glenavon,2400,3,9,9,8,52,46,6,36
Linfield,2400,4,10,5,11,37,37,0,35
Cliftonville,2400,5,10,4,12,33,31,2,34
Ballymena,2400,6,7,4,15,26,49,-23,25
Glentoran,2400,7,6,6,10,24,32,-8,24
Dungannon,2400,8,2,4,16,14,47,-33,10
Crusaders,2401,1,17,6,3,64,30,34,57
Coleraine,2401,2,15,10,1,46,22,24,55
Linfield,2401,3,11,5,10,42,40,2,38
Glenavon,2401,4,9,9,8,52,46,6,36
Cliftonville,2401,5,9,4,13,36,36,0,31
Ballymena,2401,6,7,4,15,25,50,-25,25
Glentoran,2401,7,6,6,10,24,32,-8,24
Dungannon,2401,8,2,4,16,14,47,-33,10
Crusaders,2402,1,17,6,3,65,30,35,57
Coleraine,2402,2,15,10,1,45,22,23,55
Glenavon,2402,3,9,9,8,52,45,7,36
Linfield,2402,4,10,6,10,38,37,1,36
Cliftonville,2402,5,9,5,12,33,32,1,32
Ballymena,2402,6,7,4,15,25,51,-26,25
Glentoran,2402,7,6,6,10,24,32,-8,24
Dungannon,2402,8,2,4,16,14,47,-33,10
Crusaders,2403,1,16,7,3,62,31,31,55
Coleraine,2403,2,14,11,1,44,23,21,53
Linfield,2403,3,11,5,10,38,36,2,38
Glenavon,2403,4,9,10,7,53,44,9,37
Cliftonville,2403,5,9,4,13,32,32,0,31
Ballymena,2403,6,7,5,14,26,48,-22,26
Glentoran,2403,7,6,6,10,24,32,-8,24
Dungannon,2403,8,2,4,16,14,47,-33,10
Crusaders,2404,1,16,7,3,62,31,31,55
Coleraine,2404,2,14,10,2,44,24,20,52
Glenavon,2404,3,10,9,7,54,44,10,39
Linfield,2404,4,11,5,10,38,36,2,38
Cliftonville,2404,5,9,4,13,32,32,0,31
Ballymena,2404,6,7,5,14,26,48,-22,26
Glentoran,2404,7,6,6,10,24,32,-8,24
Dungannon,2404,8,2,4,16,14,47,-33,10
Crusaders,2405,1,16,7,3,61,30,31,55
Coleraine,2405,2,15,10,1,46,24,22,55
Glenavon,2405,3,9,9,8,54,46,8,36
Linfield,2405,4,10,6,10,39,38,1,36
Cliftonville,2405,5,9,5,12,34,33,1,32
Ballymena,2405,6,7,5,14,25,47,-22,26
Glentoran,2405,7,6,6,10,24,32,-8,24
Dungannon,2405,8,2,4,16,14,47,-33,10
Crusaders,2406,1,17,6,3,64,31,33,57
Coleraine,2406,2,14,10,2,45,26,19,52
Glenavon,2406,3,10,9,7,56,45,11,39
Linfield,2406,4,11,5,10,40,36,4,38
Cliftonville,2406,5,9,4,13,32,34,-2,31
Ballymena,2406,6,7,4,15,26,50,-24,25
Glentoran,2406,7,6,6,10,24,32,-8,24
Dungannon,2406,8,2,4,16,14,47,-33,10
Crusaders,2407,1,17,6,3,62,30,32,57
Coleraine,2407,2,14,10,2,43,24,19,52
Glenavon,2407,3,10,9,7,54,43,11,39
Linfield,2407,4,11,5,10,39,36,3,38
Cliftonville,2407,5,9,4,13,32,33,-1,31
Ballymena,2407,6,7,4,15,25,48,-23,25
Glentoran,2407,7,6,6,10,24,32,-8,24
Dungannon,2407,8,2,4,16,14,47,-33,10
Crusaders,2408,1,17,6,3,63,31,32,57
Coleraine,2408,2,14,11,1,45,24,21,53
Glenavon,2408,3,9,10,7,54,45,9,37
Linfield,2408,4,10,5,11,39,39,0,35
Cliftonville,2408,5,10,4,12,35,33,2,34
Ballymena,2408,6,7,4,15,26,49,-23,25
Glentoran,2408,7,6,6,10,24,32,-8,24
Dungannon,2408,8,2,4,16,14,47,-33,10
Crusaders,2409,1,17,6,3,65,32,33,57
Coleraine,2409,2,15,10,1,46,24,22,55
Glenavon,2409,3,9,9,8,54,46,8,36
Linfield,2409,4,10,6,10,38,37,1,36
Cliftonville,2409,5,9,5,12,33,32,1,32
Ballymena,2409,6,7,4,15,27,51,-24,25
Glentoran,2409,7,6,6,10,24,32,-8,24
Dungannon,2409,8,2,4,16,14,47,-33,10
Crusaders,2410,1,16,7,3,62,31,31,55
Coleraine,2410,2,15,10,1,46,23,23,55
Linfield,2410,3,11,5,10,40,38,2,38
Glenavon,2410,4,9,9,8,53,46,7,36
Cliftonville,2410,5,9,4,13,34,34,0,31
Ballymena,2410,6,7,5,14,26,48,-22,26
Glentoran,2410,7,6,6,10,24,32,-8,24
Dungannon,2410,8,2,4,16,14,47,-33,10
Crusaders,2411,1,16,7,3,62,31,31,55
Coleraine,2411,2,15,10,1,45,22,23,55
Glenavon,2411,3,9,9,8,52,45,7,36
Linfield,2411,4,10,6,10,37,36,1,36
Cliftonville,2411,5,9,5,12,32,31,1,32
Ballymena,2411,6,7,5,14,26,48,-22,26
Glentoran,2411,7,6,6,10,24,32,-8,24
Dungannon,2411,8,2,4,16,14,47,-33,10
Coleraine,2412,1,15,10,1,46,23,23,55
Crusaders,2412,2,16,6,4,61,31,30,54
Glenavon,2412,3,9,9,8,53,46,7,36
Linfield,2412,4,10,5,11,38,38,0,35
Cliftonville,2412,5,10,4,12,34,32,2,34
Ballymena,2412,6,8,4,14,26,47,-21,28
Glentoran,2412,7,6,6,10,24,32,-8,24
Dungannon,2412,8,2,4,16,14,47,-33,10
Crusaders,2413,1,17,6,3,65,30,35,57
Coleraine,2413,2,15,10,1,45,23,22,55
Glenavon,2413,3,9,9,8,53,45,8,36
Linfield,2413,4,10,5,11,38,39,-1,35
Cliftonville,2413,5,10,4,12,35,32,3,34
Ballymena,2413,6,7,4,15,25,51,-26,25
Glentoran,2413,7,6,6,10,24,32,-8,24
Dungannon,2413,8,2,4,16,14,47,-33,10
Crusaders,2414,1,17,6,3,64,30,34,57
Coleraine,2414,2,15,10,1,46,22,24,55
Linfield,2414,3,11,5,10,38,36,2,38
Glenavon,2414,4,9,9,8,52,46,6,36
Cliftonville,2414,5,9,4,13,32,32,0,31
Ballymena,2414,6,7,4,15,25,50,-25,25
Glentoran,2414,7,6,6,10,24,32,-8,24
Dungannon,2414,8,2,4,16,14,47,-33,10
Crusaders,2415,1,17,6,3,63,31,32,57
Coleraine,2415,2,14,11,1,44,23,21,53
Linfield,2415,3,11,5,10,41,38,3,38
Glenavon,2415,4,9,10,7,53,44,9,37
Cliftonville,2415,5,9,4,13,34,35,-1,31
Ballymena,2415,6,7,4,15,26,49,-23,25
Glentoran,2415,7,6,6,10,24,32,-8,24
Dungannon,2415,8,2,4,16,14,47,-33,10
Crusaders,2416,1,17,6,3,64,32,32,57
Coleraine,2416,2,14,11,1,45,24,21,53
Linfield,2416,3,11,5,10,39,36,3,38
Glenavon,2416,4,9,10,7,54,45,9,37
Cliftonville,2416,5,9,4,13,32,33,-1,31
Ballymena,2416,6,7,4,15,27,50,-23,25
Glentoran,2416,7,6,6,10,24,32,-8,24
Dungannon,2416,8,2,4,16,14,47,-33,10
Coleraine,2417,1,15,10,1,45,23,22,55
Crusaders,2417,2,16,6,4,63,34,29,54
Linfield,2417,3,11,5,10,38,36,2,38
Glenavon,2417,4,9,9,8,53,45,8,36
Cliftonville,2417,5,9,4,13,32,32,0,31
Ballymena,2417,6,8,4,14,29,49,-20,28
Glentoran,2417,7,6,6,10,24,32,-8,24
Dungannon,2417,8,2,4,16,14,47,-33,10
Crusaders,2418,1,16,7,3,62,31,31,55
Coleraine,2418,2,14,11,1,45,24,21,53
Linfield,2418,3,11,5,10,39,36,3,38
Glenavon,2418,4,9,10,7,54,45,9,37
Cliftonville,2418,5,9,4,13,32,33,-1,31
Ballymena,2418,6,7,5,14,26,48,-22,26
Glentoran,2418,7,6,6,10,24,32,-8,24
Dungannon,2418,8,2,4,16,14,47,-33,10
Crusaders,2419,1,17,6,3,65,31,34,57
Coleraine,2419,2,15,10,1,46,23,23,55
Linfield,2419,3,11,5,10,38,36,2,38
Glenavon,2419,4,9,9,8,53,46,7,36
Cliftonville,2419,5,9,4,13,32,32,0,31
Ballymena,2419,6,7,4,15,26,51,-25,25
Glentoran,2419,7,6,6,10,24,32,-8,24
Dungannon,2419,8,2,4,16,14,47,-33,10
Crusaders,2420,1,17,6,3,64,31,33,57
Coleraine,2420,2,14,10,2,43,26,17,52
Glenavon,2420,3,10,9,7,56,43,13,39
Linfield,2420,4,11,5,10,40,37,3,38
Cliftonville,2420,5,9,4,13,33,34,-1,31
Ballymena,2420,6,7,4,15,26,50,-24,25
Glentoran,2420,7,6,6,10,24,32,-8,24
Dungannon,2420,8,2,4,16,14,47,-33,10
Coleraine,2421,1,15,10,1,45,22,23,55
Crusaders,2421,2,16,6,4,63,33,30,54
Glenavon,2421,3,9,9,8,52,45,7,36
Linfield,2421,4,10,6,10,38,37,1,36
Cliftonville,2421,5,9,5,12,33,32,1,32
Ballymena,2421,6,8,4,14,28,49,-21,28
Glentoran,2421,7,6,6,10,24,32,-8,24
Dungannon,2421,8,2,4,16,14,47,-33,10
Crusaders,2422,1,17,6,3,63,30,33,57
Coleraine,2422,2,14,10,2,43,23,20,52
Glenavon,2422,3,10,9,7,53,43,10,39
Linfield,2422,4,11,5,10,39,37,2,38
Cliftonville,2422,5,9,4,13,33,33,0,31
Ballymena,2422,6,7,4,15,25,49,-24,25
Glentoran,2422,7,6,6,10,24,32,-8,24
Dungannon,2422,8,2,4,16,14,47,-33,10
Crusaders,2423,1,17,6,3,64,32,32,57
Coleraine,2423,2,14,11,1,44,23,21,53
Linfield,2423,3,11,5,10,40,37,3,38
Glenavon,2423,4,9,10,7,53,44,9,37
Cliftonville,2423,5,9,4,13,33,34,-1,31
Ballymena,2423,6,7,4,15,27,50,-23,25
Glentoran,2423,7,6,6,10,24,32,-8,24
Dungannon,2423,8,2,4,16,14,47,-33,10
Crusaders,2424,1,17,6,3,65,32,33,57
Coleraine,2424,2,14,10,2,44,24,20,52
Glenavon,2424,3,10,9,7,54,44,10,39
Linfield,2424,4,10,6,10,38,37,1,36
Cliftonville,2424,5,9,5,12,33,32,1,32
Ballymena,2424,6,7,4,15,27,51,-24,25
Glentoran,2424,7,6,6,10,24,32,-8,24
Dungannon,2424,8,2,4,16,14,47,-33,10
Crusaders,2425,1,17,6,3,63,31,32,57
Coleraine,2425,2,15,10,1,46,23,23,55
Glenavon,2425,3,9,9,8,53,46,7,36
Linfield,2425,4,10,5,11,38,38,0,35
Cliftonville,2425,5,10,4,12,34,32,2,34
Ballymena,2425,6,7,4,15,26,49,-23,25
Glentoran,2425,7,6,6,10,24,32,-8,24
Dungannon,2425,8,2,4,16,14,47,-33,10
Crusaders,2426,1,16,7,3,63,32,31,55
Coleraine,2426,2,14,10,2,44,24,20,52
Glenavon,2426,3,10,9,7,54,44,10,39
Linfield,2426,4,10,5,11,37,37,0,35
Cliftonville,2426,5,10,4,12,33,31,2,34
Ballymena,2426,6,7,5,14,27,49,-22,26
Glentoran,2426,7,6,6,10,24,32,-8,24
Dungannon,2426,8,2,4,16,14,47,-33,10
Crusaders,2427,1,16,7,3,62,31,31,55
Coleraine,2427,2,14,11,1,45,24,21,53
Linfield,2427,3,11,5,10,38,36,2,38
Glenavon,2427,4,9,10,7,54,45,9,37
Cliftonville,2427,5,9,4,13,32,32,0,31
Ballymena,2427,6,7,5,14,26,48,-22,26
Glentoran,2427,7,6,6,10,24,32,-8,24
Dungannon,2427,8,2,4,16,14,47,-33,10
Crusaders,2428,1,17,6,3,64,32,32,57
Coleraine,2428,2,15,10,1,45,22,23,55
Glenavon,2428,3,9,9,8,52,45,7,36
Linfield,2428,4,10,5,11,37,37,0,35
Cliftonville,2428,5,10,4,12,33,31,2,34
Ballymena,2428,6,7,4,15,27,50,-23,25
Glentoran,2428,7,6,6,10,24,32,-8,24
Dungannon,2428,8,2,4,16,14,47,-33,10
Crusaders,2429,1,16,6,4,62,32,30,54
Coleraine,2429,2,14,10,2,43,23,20,52
Glenavon,2429,3,10,9,7,53,43,10,39
Linfield,2429,4,10,5,11,38,38,0,35
Cliftonville,2429,5,10,4,12,34,32,2,34
Ballymena,2429,6,8,4,14,27,48,-21,28
Glentoran,2429,7,6,6,10,24,32,-8,24
Dungannon,2429,8,2,4,16,14,47,-33,10
Crusaders,2430,1,17,6,3,63,31,32,57
Coleraine,2430,2,14,10,2,44,25,19,52
Glenavon,2430,3,10,9,7,55,44,11,39
Linfield,2430,4,11,5,10,38,36,2,38
Cliftonville,2430,5,9,4,13,32,32,0,31
Ballymena,2430,6,7,4,15,26,49,-23,25
Glentoran,2430,7,6,6,10,24,32,-8,24
Dungannon,2430,8,2,4,16,14,47,-33,10
Crusaders,2431,1,17,6,3,65,30,35,57
Coleraine,2431,2,14,11,1,43,22,21,53
Linfield,2431,3,11,5,10,41,38,3,38
Glenavon,2431,4,9,10,7,52,43,9,37
Cliftonville,2431,5,9,4,13,34,35,-1,31
Ballymena,2431,6,7,4,15,25,51,-26,25
Glentoran,2431,7,6,6,10,24,32,-8,24
Dungannon,2431,8,2,4,16,14,47,-33,10
Crusaders,2432,1,17,6,3,65,31,34,57
Coleraine,2432,2,14,10,2,46,26,20,52
Glenavon,2432,3,10,9,7,56,46,10,39
Linfield,2432,4,10,5,11,37,37,0,35
Cliftonville,2432,5,10,4,12,33,31,2,34
Ballymena,2432,6,7,4,15,26,51,-25,25
Glentoran,2432,7,6,6,10,24,32,-8,24
Dungannon,2432,8,2,4,16,14,47,-33,10
Crusaders,2433,1,17,6,3,63,30,33,57
Coleraine,2433,2,15,10,1,44,22,22,55
Linfield,2433,3,11,5,10,41,37,4,38
Glenavon,2433,4,9,9,8,52,44,8,36
Cliftonville,2433,5,9,4,13,33,35,-2,31
Ballymena,2433,6,7,4,15,25,49,-24,25
Glentoran,2433,7,6,6,10,24,32,-8,24
Dungannon,2433,8,2,4,16,14,47,-33,10
Crusaders,2434,1,16,6,4,62,32,30,54
Coleraine,2434,2,14,10,2,45,25,20,52
Glenavon,2434,3,10,9,7,55,45,10,39
Linfield,2434,4,10,5,11,37,40,-3,35
Cliftonville,2434,5,10,4,12,36,31,5,34
Ballymena,2434,6,8,4,14,27,48,-21,28
Glentoran,2434,7,6,6,10,24,32,-8,24
Dungannon,2434,8,2,4,16,14,47,-33,10
Crusaders,2435,1,17,6,3,63,31,32,57
Coleraine,2435,2,15,10,1,45,23,22,55
Linfield,2435,3,11,5,10,39,37,2,38
Glenavon,2435,4,9,9,8,53,45,8,36
Cliftonville,2435,5,9,4,13,33,33,0,31
Ballymena,2435,6,7,4,15,26,49,-23,25
Glentoran,2435,7,6,6,10,24,32,-8,24
Dungannon,2435,8,2,4,16,14,47,-33,10
Crusaders,2436,1,16,6,4,61,31,30,54
Coleraine,2436,2,14,11,1,43,22,21,53
Linfield,2436,3,11,5,10,40,38,2,38
Glenavon,2436,4,9,10,7,52,43,9,37
Cliftonville,2436,5,9,4,13,34,34,0,31
Ballymena,2436,6,8,4,14,26,47,-21,28
Glentoran,2436,7,6,6,10,24,32,-8,24
Dungannon,2436,8,2,4,16,14,47,-33,10
Crusaders,2437,1,17,6,3,63,30,33,57
Coleraine,2437,2,15,10,1,45,23,22,55
Glenavon,2437,3,9,9,8,53,45,8,36
Linfield,2437,4,10,5,11,38,38,0,35
Cliftonville,2437,5,10,4,12,34,32,2,34
Ballymena,2437,6,7,4,15,25,49,-24,25
Glentoran,2437,7,6,6,10,24,32,-8,24
Dungannon,2437,8,2,4,16,14,47,-33,10
Crusaders,2438,1,17,6,3,63,30,33,57
Coleraine,2438,2,15,10,1,45,22,23,55
Glenavon,2438,3,9,9,8,52,45,7,36
Linfield,2438,4,10,5,11,38,39,-1,35
Cliftonville,2438,5,10,4,12,35,32,3,34
Ballymena,2438,6,7,4,15,25,49,-24,25
Glentoran,2438,7,6,6,10,24,32,-8,24
Dungannon,2438,8,2,4,16,14,47,-33,10
Crusaders,2439,1,16,6,4,61,33,28,54
Coleraine,2439,2,14,11,1,45,24,21,53
Glenavon,2439,3,9,10,7,54,45,9,37
Linfield,2439,4,10,5,11,37,37,0,35
Cliftonville,2439,5,10,4,12,33,31,2,34
Ballymena,2439,6,8,4,14,28,47,-19,28
Glentoran,2439,7,6,6,10,24,32,-8,24
Dungannon,2439,8,2,4,16,14,47,-33,10
Crusaders,2440,1,16,6,4,61,32,29,54
Coleraine,2440,2,14,10,2,43,25,18,52
Glenavon,2440,3,10,9,7,55,43,12,39
Linfield,2440,4,10,5,11,37,38,-1,35
Cliftonville,2440,5,10,4,12,34,31,3,34
Ballymena,2440,6,8,4,14,27,47,-20,28
Glentoran,2440,7,6,6,10,24,32,-8,24
Dungannon,2440,8,2,4,16,14,47,-33,10
Crusaders,2441,1,16,7,3,63,32,31,55
Coleraine,2441,2,15,10,1,47,23,24,55
Linfield,2441,3,11,5,10,38,36,2,38
Glenavon,2441,4,9,9,8,53,47,6,36
Cliftonville,2441,5,9,4,13,32,32,0,31
Ballymena,2441,6,7,5,14,27,49,-22,26
Glentoran,2441,7,6,6,10,24,32,-8,24
Dungannon,2441,8,2,4,16,14,47,-33,10
Crusaders,2442,1,17,6,3,65,32,33,57
Coleraine,2442,2,14,10,2,44,25,19,52
Glenavon,2442,3,10,9,7,55,44,11,39
Linfield,2442,4,11,5,10,38,36,2,38
Cliftonville,2442,5,9,4,13,32,32,0,31
Ballymena,2442,6,7,4,15,27,51,-24,25
Glentoran,2442,7,6,6,10,24,32,-8,24
Dungannon,2442,8,2,4,16,14,47,-33,10
Crusaders,2443,1,17,6,3,63,30,33,57
Coleraine,2443,2,14,11,1,44,23,21,53
Glenavon,2443,3,9,10,7,53,44,9,37
Linfield,2443,4,10,6,10,38,37,1,36
Cliftonville,2443,5,9,5,12,33,32,1,32
Ballymena,2443,6,7,4,15,25,49,-24,25
Glentoran,2443,7,6,6,10,24,32,-8,24
Dungannon,2443,8,2,4,16,14,47,-33,10
Crusaders,2444,1,16,6,4,62,32,30,54
Coleraine,2444,2,14,11,1,44,23,21,53
Linfield,2444,3,11,5,10,38,36,2,38
Glenavon,2444,4,9,10,7,53,44,9,37
Cliftonville,2444,5,9,4,13,32,32,0,31
Ballymena,2444,6,8,4,14,27,48,-21,28
Glentoran,2444,7,6,6,10,24,32,-8,24
Dungannon,2444,8,2,4,16,14,47,-33,10
Crusaders,2445,1,17,6,3,62,30,32,57
Coleraine,2445,2,15,10,1,46,22,24,55
Glenavon,2445,3,9,9,8,52,46,6,36
Linfield,2445,4,10,6,10,38,37,1,36
Cliftonville,2445,5,9,5,12,33,32,1,32
Ballymena,2445,6,7,4,15,25,48,-23,25
Glentoran,2445,7,6,6,10,24,32,-8,24
Dungannon,2445,8,2,4,16,14,47,-33,10
Crusaders,2446,1,17,6,3,62,30,32,57
Coleraine,2446,2,15,10,1,45,23,22,55
Linfield,2446,3,11,5,10,38,36,2,38
Glenavon,2446,4,9,9,8,53,45,8,36
Cliftonville,2446,5,9,4,13,32,32,0,31
Ballymena,2446,6,7,4,15,25,48,-23,25
Glentoran,2446,7,6,6,10,24,32,-8,24
Dungannon,2446,8,2,4,16,14,47,-33,10
Crusaders,2447,1,17,6,3,63,30,33,57
Coleraine,2447,2,15,10,1,45,22,23,55
Glenavon,2447,3,9,9,8,52,45,7,36
Linfield,2447,4,10,5,11,37,39,-2,35
Cliftonville,2447,5,10,4,12,35,31,4,34
Ballymena,2447,6,7,4,15,25,49,-24,25
Glentoran,2447,7,6,6,10,24,32,-8,24
Dungannon,2447,8,2,4,16,14,47,-33,10
Crusaders,2448,1,17,6,3,64,31,33,57
Coleraine,2448,2,15,10,1,44,22,22,55
Glenavon,2448,3,9,9,8,52,44,8,36
Linfield,2448,4,10,5,11,37,37,0,35
Cliftonville,2448,5,10,4,12,33,31,2,34
Ballymena,2448,6,7,4,15,26,50,-24,25
Glentoran,2448,7,6,6,10,24,32,-8,24
Dungannon,2448,8,2,4,16,14,47,-33,10
Crusaders,2449,1,16,6,4,62,32,30,54
Coleraine,2449,2,14,10,2,44,27,17,52
Glenavon,2449,3,10,9,7,57,44,13,39
Linfield,2449,4,10,5,11,39,40,-1,35
Cliftonville,2449,5,10,4,12,36,33,3,34
Ballymena,2449,6,8,4,14,27,48,-21,28
Glentoran,2449,7,6,6,10,24,32,-8,24
Dungannon,2449,8,2,4,16,14,47,-33,10
Crusaders,2450,1,17,6,3,65,30,35,57
Coleraine,2450,2,14,10,2,44,25,19,52
Glenavon,2450,3,10,9,7,55,44,11,39
Linfield,2450,4,11,5,10,39,36,3,38
Cliftonville,2450,5,9,4,13,32,33,-1,31
Ballymena,2450,6,7,4,15,25,51,-26,25
Glentoran,2450,7,6,6,10,24,32,-8,24
Dungannon,2450,8,2,4,16,14,47,-33,10
Crusaders,2451,1,17,6,3,64,31,33,57
Coleraine,2451,2,14,11,1,46,25,21,53
Glenavon,2451,3,9,10,7,55,46,9,37
Linfield,2451,4,10,6,10,38,37,1,36
Cliftonville,2451,5,9,5,12,33,32,1,32
Ballymena,2451,6,7,4,15,26,50,-24,25
Glentoran,2451,7,6,6,10,24,32,-8,24
Dungannon,2451,8,2,4,16,14,47,-33,10
Crusaders,2452,1,17,6,3,63,30,33,57
Coleraine,2452,2,15,10,1,45,22,23,55
Linfield,2452,3,11,5,10,41,36,5,38
Glenavon,2452,4,9,9,8,52,45,7,36
Cliftonville,2452,5,9,4,13,32,35,-3,31
Ballymena,2452,6,7,4,15,25,49,-24,25
Glentoran,2452,7,6,6,10,24,32,-8,24
Dungannon,2452,8,2,4,16,14,47,-33,10
Coleraine,2453,1,15,10,1,45,23,22,55
Crusaders,2453,2,16,6,4,61,32,29,54
Glenavon,2453,3,9,9,8,53,45,8,36
Linfield,2453,4,10,5,11,39,41,-2,35
Cliftonville,2453,5,10,4,12,37,33,4,34
Ballymena,2453,6,8,4,14,27,47,-20,28
Glentoran,2453,7,6,6,10,24,32,-8,24
Dungannon,2453,8,2,4,16,14,47,-33,10
Crusaders,2454,1,17,6,3,62,30,32,57
Coleraine,2454,2,14,11,1,43,22,21,53
Glenavon,2454,3,9,10,7,52,43,9,37
Linfield,2454,4,10,6,10,38,37,1,36
Cliftonville,2454,5,9,5,12,33,32,1,32
Ballymena,2454,6,7,4,15,25,48,-23,25
Glentoran,2454,7,6,6,10,24,32,-8,24
Dungannon,2454,8,2,4,16,14,47,-33,10
Crusaders,2455,1,17,6,3,63,31,32,57
Coleraine,2455,2,14,10,2,44,26,18,52
Glenavon,2455,3,10,9,7,56,44,12,39
Linfield,2455,4,10,6,10,39,38,1,36
Cliftonville,2455,5,9,5,12,34,33,1,32
Ballymena,2455,6,7,4,15,26,49,-23,25
Glentoran,2455,7,6,6,10,24,32,-8,24
Dungannon,2455,8,2,4,16,14,47,-33,10
Crusaders,2456,1,16,6,4,63,33,30,54
Coleraine,2456,2,14,10,2,45,25,20,52
Glenavon,2456,3,10,9,7,55,45,10,39
Linfield,2456,4,10,5,11,37,38,-1,35
Cliftonville,2456,5,10,4,12,34,31,3,34
Ballymena,2456,6,8,4,14,28,49,-21,28
Glentoran,2456,7,6,6,10,24,32,-8,24
Dungannon,2456,8,2,4,16,14,47,-33,10
Crusaders,2457,1,16,6,4,61,31,30,54
Coleraine,2457,2,14,10,2,43,25,18,52
Glenavon,2457,3,10,9,7,55,43,12,39
Linfield,2457,4,10,6,10,38,37,1,36
Cliftonville,2457,5,9,5,12,33,32,1,32
Ballymena,2457,6,8,4,14,26,47,-21,28
Glentoran,2457,7,6,6,10,24,32,-8,24
Dungannon,2457,8,2,4,16,14,47,-33,10
Crusaders,2458,1,17,6,3,62,30,32,57
Coleraine,2458,2,15,10,1,45,22,23,55
Linfield,2458,3,11,5,10,38,36,2,38
Glenavon,2458,4,9,9,8,52,45,7,36
Cliftonville,2458,5,9,4,13,32,32,0,31
Ballymena,2458,6,7,4,15,25,48,-23,25
Glentoran,2458,7,6,6,10,24,32,-8,24
Dungannon,2458,8,2,4,16,14,47,-33,10
Crusaders,2459,1,17,6,3,64,30,34,57
Coleraine,2459,2,15,10,1,44,22,22,55
Glenavon,2459,3,9,9,8,52,44,8,36
Linfield,2459,4,10,5,11,37,37,0,35
Cliftonville,2459,5,10,4,12,33,31,2,34
Ballymena,2459,6,7,4,15,25,50,-25,25
Glentoran,2459,7,6,6,10,24,32,-8,24
Dungannon,2459,8,2,4,16,14,47,-33,10
Crusaders,2460,1,17,6,3,63,31,32,57
Coleraine,2460,2,15,10,1,46,24,22,55
Linfield,2460,3,11,5,10,40,38,2,38
Glenavon,2460,4,9,9,8,54,46,8,36
Cliftonville,2460,5,9,4,13,34,34,0,31
Ballymena,2460,6,7,4,15,26,49,-23,25
Glentoran,2460,7,6,6,10,24,32,-8,24
Dungannon,2460,8,2,4,16,14,47,-33,10
Crusaders,2461,1,16,6,4,61,32,29,54
Coleraine,2461,2,14,11,1,45,24,21,53
Linfield,2461,3,11,5,10,39,36,3,38
Glenavon,2461,4,9,10,7,54,45,9,37
Cliftonville,2461,5,9,4,13,32,33,-1,31
Ballymena,2461,6,8,4,14,27,47,-20,28
Glentoran,2461,7,6,6,10,24,32,-8,24
Dungannon,2461,8,2,4,16,14,47,-33,10
Crusaders,2462,1,16,6,4,65,35,30,54
Coleraine,2462,2,14,11,1,43,22,21,53
Linfield,2462,3,11,5,10,40,36,4,38
Glenavon,2462,4,9,10,7,52,43,9,37
Cliftonville,2462,5,9,4,13,32,34,-2,31
Ballymena,2462,6,8,4,14,30,51,-21,28
Glentoran,2462,7,6,6,10,24,32,-8,24
Dungannon,2462,8,2,4,16,14,47,-33,10
Crusaders,2463,1,17,6,3,64,30,34,57
Coleraine,2463,2,14,10,2,44,24,20,52
Glenavon,2463,3,10,9,7,54,44,10,39
Linfield,2463,4,11,5,10,40,36,4,38
Cliftonville,2463,5,9,4,13,32,34,-2,31
Ballymena,2463,6,7,4,15,25,50,-25,25
Glentoran,2463,7,6,6,10,24,32,-8,24
Dungannon,2463,8,2,4,16,14,47,-33,10
Crusaders,2464,1,16,6,4,62,32,30,54
Coleraine,2464,2,14,10,2,43,23,20,52
Glenavon,2464,3,10,9,7,53,43,10,39
Linfield,2464,4,10,5,11,37,38,-1,35
Cliftonville,2464,5,10,4,12,34,31,3,34
Ballymena,2464,6,8,4,14,27,48,-21,28
Glentoran,2464,7,6,6,10,24,32,-8,24
Dungannon,2464,8,2,4,16,14,47,-33,10
Crusaders,2465,1,16,7,3,64,33,31,55
Coleraine,2465,2,15,10,1,46,23,23,55
Linfield,2465,3,11,5,10,39,37,2,38
Glenavon,2465,4,9,9,8,53,46,7,36
Cliftonville,2465,5,9,4,13,33,33,0,31
Ballymena,2465,6,7,5,14,28,50,-22,26
Glentoran,2465,7,6,6,10,24,32,-8,24
Dungannon,2465,8,2,4,16,14,47,-33,10
Crusaders,2466,1,17,6,3,63,30,33,57
Coleraine,2466,2,14,11,1,45,24,21,53
Linfield,2466,3,11,5,10,40,37,3,38
Glenavon,2466,4,9,10,7,54,45,9,37
Cliftonville,2466,5,9,4,13,33,34,-1,31
Ballymena,2466,6,7,4,15,25,49,-24,25
Glentoran,2466,7,6,6,10,24,32,-8,24
Dungannon,2466,8,2,4,16,14,47,-33,10
Crusaders,2467,1,17,6,3,66,33,33,57
Coleraine,2467,2,14,10,2,45,25,20,52
Glenavon,2467,3,10,9,7,55,45,10,39
Linfield,2467,4,11,5,10,41,36,5,38
Cliftonville,2467,5,9,4,13,32,35,-3,31
Ballymena,2467,6,7,4,15,28,52,-24,25
Glentoran,2467,7,6,6,10,24,32,-8,24
Dungannon,2467,8,2,4,16,14,47,-33,10
Crusaders,2468,1,16,6,4,61,31,30,54
Coleraine,2468,2,14,10,2,44,25,19,52
Glenavon,2468,3,10,9,7,55,44,11,39
Linfield,2468,4,11,5,10,39,37,2,38
Cliftonville,2468,5,9,4,13,33,33,0,31
Ballymena,2468,6,8,4,14,26,47,-21,28
Glentoran,2468,7,6,6,10,24,32,-8,24
Dungannon,2468,8,2,4,16,14,47,-33,10
Crusaders,2469,1,17,6,3,63,31,32,57
Coleraine,2469,2,14,10,2,43,24,19,52
Glenavon,2469,3,10,9,7,54,43,11,39
Linfield,2469,4,11,5,10,41,36,5,38
Cliftonville,2469,5,9,4,13,32,35,-3,31
Ballymena,2469,6,7,4,15,26,49,-23,25
Glentoran,2469,7,6,6,10,24,32,-8,24
Dungannon,2469,8,2,4,16,14,47,-33,10
Crusaders,2470,1,16,6,4,62,32,30,54
Coleraine,2470,2,14,11,1,44,23,21,53
Glenavon,2470,3,9,10,7,53,44,9,37
Linfield,2470,4,10,6,10,37,36,1,36
Cliftonville,2470,5,9,5,12,32,31,1,32
Ballymena,2470,6,8,4,14,27,48,-21,28
Glentoran,2470,7,6,6,10,24,32,-8,24
Dungannon,2470,8,2,4,16,14,47,-33,10
Crusaders,2471,1,17,6,3,64,31,33,57
Coleraine,2471,2,15,10,1,45,23,22,55
Linfield,2471,3,11,5,10,39,36,3,38
Glenavon,2471,4,9,9,8,53,45,8,36
Cliftonville,2471,5,9,4,13,32,33,-1,31
Ballymena,2471,6,7,4,15,26,50,-24,25
Glentoran,2471,7,6,6,10,24,32,-8,24
Dungannon,2471,8,2,4,16,14,47,-33,10
Crusaders,2472,1,17,6,3,64,31,33,57
Coleraine,2472,2,14,10,2,44,24,20,52
Glenavon,2472,3,10,9,7,54,44,10,39
Linfield,2472,4,11,5,10,40,37,3,38
Cliftonville,2472,5,9,4,13,33,34,-1,31
Ballymena,2472,6,7,4,15,26,50,-24,25
Glentoran,2472,7,6,6,10,24,32,-8,24
Dungannon,2472,8,2,4,16,14,47,-33,10
Crusaders,2473,1,17,6,3,64,31,33,57
Coleraine,2473,2,14,11,1,45,24,21,53
Linfield,2473,3,11,5,10,39,37,2,38
Glenavon,2473,4,9,10,7,54,45,9,37
Cliftonville,2473,5,9,4,13,33,33,0,31
Ballymena,2473,6,7,4,15,26,50,-24,25
Glentoran,2473,7,6,6,10,24,32,-8,24
Dungannon,2473,8,2,4,16,14,47,-33,10
Crusaders,2474,1,17,6,3,64,31,33,57
Coleraine,2474,2,14,10,2,44,25,19,52
Glenavon,2474,3,10,9,7,55,44,11,39
Linfield,2474,4,10,5,11,38,38,0,35
Cliftonville,2474,5,10,4,12,34,32,2,34
Ballymena,2474,6,7,4,15,26,50,-24,25
Glentoran,2474,7,6,6,10,24,32,-8,24
Dungannon,2474,8,2,4,16,14,47,-33,10
Crusaders,2475,1,16,7,3,64,33,31,55
Coleraine,2475,2,14,10,2,43,23,20,52
Glenavon,2475,3,10,9,7,53,43,10,39
Linfield,2475,4,10,6,10,39,38,1,36
Cliftonville,2475,5,9,5,12,34,33,1,32
Ballymena,2475,6,7,5,14,28,50,-22,26
Glentoran,2475,7,6,6,10,24,32,-8,24
Dungannon,2475,8,2,4,16,14,47,-33,10
Crusaders,2476,1,17,6,3,65,30,35,57
Coleraine,2476,2,14,11,1,45,24,21,53
Glenavon,2476,3,9,10,7,54,45,9,37
Linfield,2476,4,10,6,10,38,37,1,36
Cliftonville,2476,5,9,5,12,33,32,1,32
Ballymena,2476,6,7,4,15,25,51,-26,25
Glentoran,2476,7,6,6,10,24,32,-8,24
Dungannon,2476,8,2,4,16,14,47,-33,10
Crusaders,2477,1,17,6,3,64,31,33,57
Coleraine,2477,2,14,10,2,43,23,20,52
Glenavon,2477,3,10,9,7,53,43,10,39
Linfield,2477,4,10,5,11,38,40,-2,35
Cliftonville,2477,5,10,4,12,36,32,4,34
Ballymena,2477,6,7,4,15,26,50,-24,25
Glentoran,2477,7,6,6,10,24,32,-8,24
Dungannon,2477,8,2,4,16,14,47,-33,10
Crusaders,2478,1,16,7,3,63,32,31,55
Coleraine,2478,2,15,10,1,45,23,22,55
Linfield,2478,3,11,5,10,39,37,2,38
Glenavon,2478,4,9,9,8,53,45,8,36
Cliftonville,2478,5,9,4,13,33,33,0,31
Ballymena,2478,6,7,5,14,27,49,-22,26
Glentoran,2478,7,6,6,10,24,32,-8,24
Dungannon,2478,8,2,4,16,14,47,-33,10
Crusaders,2479,1,16,7,3,61,30,31,55
Coleraine,2479,2,15,10,1,45,23,22,55
Glenavon,2479,3,9,9,8,53,45,8,36
Linfield,2479,4,10,5,11,37,37,0,35
Cliftonville,2479,5,10,4,12,33,31,2,34
Ballymena,2479,6,7,5,14,25,47,-22,26
Glentoran,2479,7,6,6,10,24,32,-8,24
Dungannon,2479,8,2,4,16,14,47,-33,10
Coleraine,2480,1,15,10,1,46,23,23,55
Crusaders,2480,2,16,6,4,61,32,29,54
Glenavon,2480,3,9,9,8,53,46,7,36
Linfield,2480,4,10,6,10,38,37,1,36
Cliftonville,2480,5,9,5,12,33,32,1,32
Ballymena,2480,6,8,4,14,27,47,-20,28
Glentoran,2480,7,6,6,10,24,32,-8,24
Dungannon,2480,8,2,4,16,14,47,-33,10
Crusaders,2481,1,16,6,4,63,33,30,54
Coleraine,2481,2,14,10,2,44,26,18,52
Glenavon,2481,3,10,9,7,56,44,12,39
Linfield,2481,4,10,6,10,38,37,1,36
Cliftonville,2481,5,9,5,12,33,32,1,32
Ballymena,2481,6,8,4,14,28,49,-21,28
Glentoran,2481,7,6,6,10,24,32,-8,24
Dungannon,2481,8,2,4,16,14,47,-33,10
Crusaders,2482,1,16,6,4,61,33,28,54
Coleraine,2482,2,14,10,2,43,24,19,52
Glenavon,2482,3,10,9,7,54,43,11,39
Linfield,2482,4,11,5,10,39,37,2,38
Cliftonville,2482,5,9,4,13,33,33,0,31
Ballymena,2482,6,8,4,14,28,47,-19,28
Glentoran,2482,7,6,6,10,24,32,-8,24
Dungannon,2482,8,2,4,16,14,47,-33,10
Crusaders,2483,1,17,6,3,62,30,32,57
Coleraine,2483,2,14,10,2,44,24,20,52
Glenavon,2483,3,10,9,7,54,44,10,39
Linfield,2483,4,11,5,10,39,37,2,38
Cliftonville,2483,5,9,4,13,33,33,0,31
Ballymena,2483,6,7,4,15,25,48,-23,25
Glentoran,2483,7,6,6,10,24,32,-8,24
Dungannon,2483,8,2,4,16,14,47,-33,10
Crusaders,2484,1,17,6,3,66,31,35,57
Coleraine,2484,2,14,11,1,44,23,21,53
Glenavon,2484,3,9,10,7,53,44,9,37
Linfield,2484,4,10,6,10,37,36,1,36
Cliftonville,2484,5,9,5,12,32,31,1,32
Ballymena,2484,6,7,4,15,26,52,-26,25
Glentoran,2484,7,6,6,10,24,32,-8,24
Dungannon,2484,8,2,4,16,14,47,-33,10
Crusaders,2485,1,16,7,3,63,32,31,55
Coleraine,2485,2,15,10,1,45,22,23,55
Glenavon,2485,3,9,9,8,52,45,7,36
Linfield,2485,4,10,5,11,38,38,0,35
Cliftonville,2485,5,10,4,12,34,32,2,34
Ballymena,2485,6,7,5,14,27,49,-22,26
Glentoran,2485,7,6,6,10,24,32,-8,24
Dungannon,2485,8,2,4,16,14,47,-33,10
Crusaders,2486,1,17,6,3,64,31,33,57
Coleraine,2486,2,14,10,2,44,24,20,52
Glenavon,2486,3,10,9,7,54,44,10,39
Linfield,2486,4,10,5,11,37,37,0,35
Cliftonville,2486,5,10,4,12,33,31,2,34
Ballymena,2486,6,7,4,15,26,50,-24,25
Glentoran,2486,7,6,6,10,24,32,-8,24
Dungannon,2486,8,2,4,16,14,47,-33,10
Crusaders,2487,1,17,6,3,65,32,33,57
Coleraine,2487,2,14,10,2,43,24,19,52
Glenavon,2487,3,10,9,7,54,43,11,39
Linfield,2487,4,10,5,11,38,39,-1,35
Cliftonville,2487,5,10,4,12,35,32,3,34
Ballymena,2487,6,7,4,15,27,51,-24,25
Glentoran,2487,7,6,6,10,24,32,-8,24
Dungannon,2487,8,2,4,16,14,47,-33,10
Crusaders,2488,1,17,6,3,65,30,35,57
Coleraine,2488,2,14,11,1,45,24,21,53
Glenavon,2488,3,9,10,7,54,45,9,37
Linfield,2488,4,10,6,10,39,38,1,36
Cliftonville,2488,5,9,5,12,34,33,1,32
Ballymena,2488,6,7,4,15,25,51,-26,25
Glentoran,2488,7,6,6,10,24,32,-8,24
Dungannon,2488,8,2,4,16,14,47,-33,10
Crusaders,2489,1,16,7,3,63,32,31,55
Coleraine,2489,2,15,10,1,44,22,22,55
Glenavon,2489,3,9,9,8,52,44,8,36
Linfield,2489,4,10,5,11,37,37,0,35
Cliftonville,2489,5,10,4,12,33,31,2,34
Ballymena,2489,6,7,5,14,27,49,-22,26
Glentoran,2489,7,6,6,10,24,32,-8,24
Dungannon,2489,8,2,4,16,14,47,-33,10
Crusaders,2490,1,17,6,3,63,31,32,57
Coleraine,2490,2,15,10,1,45,23,22,55
Glenavon,2490,3,9,9,8,53,45,8,36
Linfield,2490,4,10,6,10,37,36,1,36
Cliftonville,2490,5,9,5,12,32,31,1,32
Ballymena,2490,6,7,4,15,26,49,-23,25
Glentoran,2490,7,6,6,10,24,32,-8,24
Dungannon,2490,8,2,4,16,14,47,-33,10
Crusaders,2491,1,16,7,3,63,32,31,55
Coleraine,2491,2,15,10,1,44,22,22,55
Glenavon,2491,3,9,9,8,52,44,8,36
Linfield,2491,4,10,5,11,38,38,0,35
Cliftonville,2491,5,10,4,12,34,32,2,34
Ballymena,2491,6,7,5,14,27,49,-22,26
Glentoran,2491,7,6,6,10,24,32,-8,24
Dungannon,2491,8,2,4,16,14,47,-33,10
Crusaders,2492,1,16,7,3,63,32,31,55
Coleraine,2492,2,15,10,1,47,25,22,55
Linfield,2492,3,11,5,10,39,37,2,38
Glenavon,2492,4,9,9,8,55,47,8,36
Cliftonville,2492,5,9,4,13,33,33,0,31
Ballymena,2492,6,7,5,14,27,49,-22,26
Glentoran,2492,7,6,6,10,24,32,-8,24
Dungannon,2492,8,2,4,16,14,47,-33,10
Crusaders,2493,1,17,6,3,64,30,34,57
Coleraine,2493,2,14,11,1,44,23,21,53
Linfield,2493,3,11,5,10,40,36,4,38
Glenavon,2493,4,9,10,7,53,44,9,37
Cliftonville,2493,5,9,4,13,32,34,-2,31
Ballymena,2493,6,7,4,15,25,50,-25,25
Glentoran,2493,7,6,6,10,24,32,-8,24
Dungannon,2493,8,2,4,16,14,47,-33,10
Crusaders,2494,1,16,6,4,61,31,30,54
Coleraine,2494,2,14,10,2,43,24,19,52
Glenavon,2494,3,10,9,7,54,43,11,39
Linfield,2494,4,10,5,11,38,39,-1,35
Cliftonville,2494,5,10,4,12,35,32,3,34
Ballymena,2494,6,8,4,14,26,47,-21,28
Glentoran,2494,7,6,6,10,24,32,-8,24
Dungannon,2494,8,2,4,16,14,47,-33,10
Crusaders,2495,1,17,6,3,65,31,34,57
Coleraine,2495,2,14,10,2,44,25,19,52
Glenavon,2495,3,10,9,7,55,44,11,39
Linfield,2495,4,10,5,11,38,38,0,35
Cliftonville,2495,5,10,4,12,34,32,2,34
Ballymena,2495,6,7,4,15,26,51,-25,25
Glentoran,2495,7,6,6,10,24,32,-8,24
Dungannon,2495,8,2,4,16,14,47,-33,10
Crusaders,2496,1,17,6,3,63,31,32,57
Coleraine,2496,2,14,10,2,43,23,20,52
Glenavon,2496,3,10,9,7,53,43,10,39
Linfield,2496,4,10,5,11,38,38,0,35
Cliftonville,2496,5,10,4,12,34,32,2,34
Ballymena,2496,6,7,4,15,26,49,-23,25
Glentoran,2496,7,6,6,10,24,32,-8,24
Dungannon,2496,8,2,4,16,14,47,-33,10
Crusaders,2497,1,17,6,3,62,30,32,57
Coleraine,2497,2,14,11,1,44,23,21,53
Glenavon,2497,3,9,10,7,53,44,9,37
Linfield,2497,4,10,5,11,39,40,-1,35
Cliftonville,2497,5,10,4,12,36,33,3,34
Ballymena,2497,6,7,4,15,25,48,-23,25
Glentoran,2497,7,6,6,10,24,32,-8,24
Dungannon,2497,8,2,4,16,14,47,-33,10
Crusaders,2498,1,16,7,3,63,32,31,55
Coleraine,2498,2,14,10,2,45,25,20,52
Glenavon,2498,3,10,9,7,55,45,10,39
Linfield,2498,4,10,6,10,37,36,1,36
Cliftonville,2498,5,9,5,12,32,31,1,32
Ballymena,2498,6,7,5,14,27,49,-22,26
Glentoran,2498,7,6,6,10,24,32,-8,24
Dungannon,2498,8,2,4,16,14,47,-33,10
Crusaders,2499,1,17,6,3,64,31,33,57
Coleraine,2499,2,14,10,2,45,27,18,52
Glenavon,2499,3,10,9,7,57,45,12,39
Linfield,2499,4,11,5,10,40,38,2,38
Cliftonville,2499,5,9,4,13,34,34,0,31
Ballymena,2499,6,7,4,15,26,50,-24,25
Glentoran,2499,7,6,6,10,24,32,-8,24
Dungannon,2499,8,2,4,16,14,47,-33,10
Crusaders,2500,1,17,6,3,63,30,33,57
Coleraine,2500,2,14,10,2,43,24,19,52
Glenavon,2500,3,10,9,7,54,43,11,39
Linfield,2500,4,11,5,10,38,36,2,38
Cliftonville,2500,5,9,4,13,32,32,0,31
Ballymena,2500,6,7,4,15,25,49,-24,25
Glentoran,2500,7,6,6,10,24,32,-8,24
Dungannon,2500,8,2,4,16,14,47,-33,10
Crusaders,2501,1,17,6,3,64,30,34,57
Coleraine,2501,2,14,11,1,44,23,21,53
Linfield,2501,3,11,5,10,39,37,2,38
Glenavon,2501,4,9,10,7,53,44,9,37
Cliftonville,2501,5,9,4,13,33,33,0,31
Ballymena,2501,6,7,4,15,25,50,-25,25
Glentoran,2501,7,6,6,10,24,32,-8,24
Dungannon,2501,8,2,4,16,14,47,-33,10
Crusaders,2502,1,16,6,4,61,35,26,54
Coleraine,2502,2,14,11,1,44,23,21,53
Linfield,2502,3,11,5,10,38,36,2,38
Glenavon,2502,4,9,10,7,53,44,9,37
Cliftonville,2502,5,9,4,13,32,32,0,31
Ballymena,2502,6,8,4,14,30,47,-17,28
Glentoran,2502,7,6,6,10,24,32,-8,24
Dungannon,2502,8,2,4,16,14,47,-33,10
Crusaders,2503,1,17,6,3,64,31,33,57
Coleraine,2503,2,14,11,1,44,23,21,53
Linfield,2503,3,11,5,10,39,36,3,38
Glenavon,2503,4,9,10,7,53,44,9,37
Cliftonville,2503,5,9,4,13,32,33,-1,31
Ballymena,2503,6,7,4,15,26,50,-24,25
Glentoran,2503,7,6,6,10,24,32,-8,24
Dungannon,2503,8,2,4,16,14,47,-33,10
Coleraine,2504,1,15,10,1,47,25,22,55
Crusaders,2504,2,16,6,4,62,36,26,54
Glenavon,2504,3,9,9,8,55,47,8,36
Linfield,2504,4,10,6,10,37,36,1,36
Cliftonville,2504,5,9,5,12,32,31,1,32
Ballymena,2504,6,8,4,14,31,48,-17,28
Glentoran,2504,7,6,6,10,24,32,-8,24
Dungannon,2504,8,2,4,16,14,47,-33,10
Crusaders,2505,1,17,6,3,64,32,32,57
Coleraine,2505,2,14,11,1,44,23,21,53
Linfield,2505,3,11,5,10,38,36,2,38
Glenavon,2505,4,9,10,7,53,44,9,37
Cliftonville,2505,5,9,4,13,32,32,0,31
Ballymena,2505,6,7,4,15,27,50,-23,25
Glentoran,2505,7,6,6,10,24,32,-8,24
Dungannon,2505,8,2,4,16,14,47,-33,10
Crusaders,2506,1,16,6,4,61,32,29,54
Coleraine,2506,2,14,10,2,44,24,20,52
Glenavon,2506,3,10,9,7,54,44,10,39
Linfield,2506,4,10,6,10,38,37,1,36
Cliftonville,2506,5,9,5,12,33,32,1,32
Ballymena,2506,6,8,4,14,27,47,-20,28
Glentoran,2506,7,6,6,10,24,32,-8,24
Dungannon,2506,8,2,4,16,14,47,-33,10
Crusaders,2507,1,17,6,3,63,30,33,57
Coleraine,2507,2,14,10,2,44,27,17,52
Glenavon,2507,3,10,9,7,57,44,13,39
Linfield,2507,4,11,5,10,39,36,3,38
Cliftonville,2507,5,9,4,13,32,33,-1,31
Ballymena,2507,6,7,4,15,25,49,-24,25
Glentoran,2507,7,6,6,10,24,32,-8,24
Dungannon,2507,8,2,4,16,14,47,-33,10
Crusaders,2508,1,17,6,3,63,30,33,57
Coleraine,2508,2,15,10,1,45,23,22,55
Glenavon,2508,3,9,9,8,53,45,8,36
Linfield,2508,4,10,6,10,37,36,1,36
Cliftonville,2508,5,9,5,12,32,31,1,32
Ballymena,2508,6,7,4,15,25,49,-24,25
Glentoran,2508,7,6,6,10,24,32,-8,24
Dungannon,2508,8,2,4,16,14,47,-33,10
Crusaders,2509,1,17,6,3,65,31,34,57
Coleraine,2509,2,15,10,1,46,23,23,55
Glenavon,2509,3,9,9,8,53,46,7,36
Linfield,2509,4,10,5,11,37,39,-2,35
Cliftonville,2509,5,10,4,12,35,31,4,34
Ballymena,2509,6,7,4,15,26,51,-25,25
Glentoran,2509,7,6,6,10,24,32,-8,24
Dungannon,2509,8,2,4,16,14,47,-33,10
Crusaders,2510,1,17,6,3,65,30,35,57
Coleraine,2510,2,14,10,2,43,23,20,52
Glenavon,2510,3,10,9,7,53,43,10,39
Linfield,2510,4,11,5,10,38,36,2,38
Cliftonville,2510,5,9,4,13,32,32,0,31
Ballymena,2510,6,7,4,15,25,51,-26,25
Glentoran,2510,7,6,6,10,24,32,-8,24
Dungannon,2510,8,2,4,16,14,47,-33,10
Crusaders,2511,1,17,6,3,63,30,33,57
Coleraine,2511,2,15,10,1,46,23,23,55
Linfield,2511,3,11,5,10,39,37,2,38
Glenavon,2511,4,9,9,8,53,46,7,36
Cliftonville,2511,5,9,4,13,33,33,0,31
Ballymena,2511,6,7,4,15,25,49,-24,25
Glentoran,2511,7,6,6,10,24,32,-8,24
Dungannon,2511,8,2,4,16,14,47,-33,10
Crusaders,2512,1,16,6,4,61,32,29,54
Coleraine,2512,2,14,10,2,43,23,20,52
Glenavon,2512,3,10,9,7,53,43,10,39
Linfield,2512,4,10,5,11,37,37,0,35
Cliftonville,2512,5,10,4,12,33,31,2,34
Ballymena,2512,6,8,4,14,27,47,-20,28
Glentoran,2512,7,6,6,10,24,32,-8,24
Dungannon,2512,8,2,4,16,14,47,-33,10
Crusaders,2513,1,17,6,3,65,31,34,57
Coleraine,2513,2,14,10,2,45,25,20,52
Glenavon,2513,3,10,9,7,55,45,10,39
Linfield,2513,4,10,6,10,37,36,1,36
Cliftonville,2513,5,9,5,12,32,31,1,32
Ballymena,2513,6,7,4,15,26,51,-25,25
Glentoran,2513,7,6,6,10,24,32,-8,24
Dungannon,2513,8,2,4,16,14,47,-33,10
Crusaders,2514,1,16,7,3,61,30,31,55
Coleraine,2514,2,15,10,1,46,22,24,55
Linfield,2514,3,11,5,10,42,37,5,38
Glenavon,2514,4,9,9,8,52,46,6,36
Cliftonville,2514,5,9,4,13,33,36,-3,31
Ballymena,2514,6,7,5,14,25,47,-22,26
Glentoran,2514,7,6,6,10,24,32,-8,24
Dungannon,2514,8,2,4,16,14,47,-33,10
Crusaders,2515,1,16,7,3,62,31,31,55
Coleraine,2515,2,14,10,2,43,23,20,52
Glenavon,2515,3,10,9,7,53,43,10,39
Linfield,2515,4,11,5,10,39,37,2,38
Cliftonville,2515,5,9,4,13,33,33,0,31
Ballymena,2515,6,7,5,14,26,48,-22,26
Glentoran,2515,7,6,6,10,24,32,-8,24
Dungannon,2515,8,2,4,16,14,47,-33,10
Crusaders,2516,1,16,7,3,64,33,31,55
Coleraine,2516,2,14,11,1,43,22,21,53
Glenavon,2516,3,9,10,7,52,43,9,37
Linfield,2516,4,10,5,11,38,38,0,35
Cliftonville,2516,5,10,4,12,34,32,2,34
Ballymena,2516,6,7,5,14,28,50,-22,26
Glentoran,2516,7,6,6,10,24,32,-8,24
Dungannon,2516,8,2,4,16,14,47,-33,10
Coleraine,2517,1,15,10,1,45,23,22,55
Crusaders,2517,2,16,6,4,61,34,27,54
Glenavon,2517,3,9,9,8,53,45,8,36
Linfield,2517,4,10,6,10,38,37,1,36
Cliftonville,2517,5,9,5,12,33,32,1,32
Ballymena,2517,6,8,4,14,29,47,-18,28
Glentoran,2517,7,6,6,10,24,32,-8,24
Dungannon,2517,8,2,4,16,14,47,-33,10
Crusaders,2518,1,16,7,3,66,35,31,55
Coleraine,2518,2,14,10,2,46,27,19,52
Glenavon,2518,3,10,9,7,57,46,11,39
Linfield,2518,4,11,5,10,39,36,3,38
Cliftonville,2518,5,9,4,13,32,33,-1,31
Ballymena,2518,6,7,5,14,30,52,-22,26
Glentoran,2518,7,6,6,10,24,32,-8,24
Dungannon,2518,8,2,4,16,14,47,-33,10
Crusaders,2519,1,17,6,3,64,31,33,57
Coleraine,2519,2,14,10,2,45,25,20,52
Glenavon,2519,3,10,9,7,55,45,10,39
Linfield,2519,4,10,5,11,37,38,-1,35
Cliftonville,2519,5,10,4,12,34,31,3,34
Ballymena,2519,6,7,4,15,26,50,-24,25
Glentoran,2519,7,6,6,10,24,32,-8,24
Dungannon,2519,8,2,4,16,14,47,-33,10
Crusaders,2520,1,16,7,3,63,32,31,55
Coleraine,2520,2,14,10,2,44,24,20,52
Glenavon,2520,3,10,9,7,54,44,10,39
Linfield,2520,4,11,5,10,40,37,3,38
Cliftonville,2520,5,9,4,13,33,34,-1,31
Ballymena,2520,6,7,5,14,27,49,-22,26
Glentoran,2520,7,6,6,10,24,32,-8,24
Dungannon,2520,8,2,4,16,14,47,-33,10
Crusaders,2521,1,17,6,3,62,30,32,57
Coleraine,2521,2,14,11,1,44,23,21,53
Glenavon,2521,3,9,10,7,53,44,9,37
Linfield,2521,4,10,6,10,38,37,1,36
Cliftonville,2521,5,9,5,12,33,32,1,32
Ballymena,2521,6,7,4,15,25,48,-23,25
Glentoran,2521,7,6,6,10,24,32,-8,24
Dungannon,2521,8,2,4,16,14,47,-33,10
Crusaders,2522,1,17,6,3,64,31,33,57
Coleraine,2522,2,14,10,2,44,27,17,52
Glenavon,2522,3,10,9,7,57,44,13,39
Linfield,2522,4,10,5,11,39,40,-1,35
Cliftonville,2522,5,10,4,12,36,33,3,34
Ballymena,2522,6,7,4,15,26,50,-24,25
Glentoran,2522,7,6,6,10,24,32,-8,24
Dungannon,2522,8,2,4,16,14,47,-33,10
Crusaders,2523,1,16,6,4,62,33,29,54
Coleraine,2523,2,14,10,2,44,25,19,52
Glenavon,2523,3,10,9,7,55,44,11,39
Linfield,2523,4,10,6,10,38,37,1,36
Cliftonville,2523,5,9,5,12,33,32,1,32
Ballymena,2523,6,8,4,14,28,48,-20,28
Glentoran,2523,7,6,6,10,24,32,-8,24
Dungannon,2523,8,2,4,16,14,47,-33,10
Crusaders,2524,1,17,6,3,63,31,32,57
Coleraine,2524,2,14,10,2,44,28,16,52
Glenavon,2524,3,10,9,7,58,44,14,39
Linfield,2524,4,10,5,11,39,39,0,35
Cliftonville,2524,5,10,4,12,35,33,2,34
Ballymena,2524,6,7,4,15,26,49,-23,25
Glentoran,2524,7,6,6,10,24,32,-8,24
Dungannon,2524,8,2,4,16,14,47,-33,10
Crusaders,2525,1,17,6,3,63,30,33,57
Coleraine,2525,2,15,10,1,46,22,24,55
Linfield,2525,3,11,5,10,39,36,3,38
Glenavon,2525,4,9,9,8,52,46,6,36
Cliftonville,2525,5,9,4,13,32,33,-1,31
Ballymena,2525,6,7,4,15,25,49,-24,25
Glentoran,2525,7,6,6,10,24,32,-8,24
Dungannon,2525,8,2,4,16,14,47,-33,10
Crusaders,2526,1,17,6,3,64,32,32,57
Coleraine,2526,2,14,10,2,44,24,20,52
Glenavon,2526,3,10,9,7,54,44,10,39
Linfield,2526,4,10,6,10,38,37,1,36
Cliftonville,2526,5,9,5,12,33,32,1,32
Ballymena,2526,6,7,4,15,27,50,-23,25
Glentoran,2526,7,6,6,10,24,32,-8,24
Dungannon,2526,8,2,4,16,14,47,-33,10
Crusaders,2527,1,17,6,3,63,30,33,57
Coleraine,2527,2,14,10,2,44,25,19,52
Glenavon,2527,3,10,9,7,55,44,11,39
Linfield,2527,4,10,6,10,37,36,1,36
Cliftonville,2527,5,9,5,12,32,31,1,32
Ballymena,2527,6,7,4,15,25,49,-24,25
Glentoran,2527,7,6,6,10,24,32,-8,24
Dungannon,2527,8,2,4,16,14,47,-33,10
Crusaders,2528,1,17,6,3,64,32,32,57
Coleraine,2528,2,15,10,1,46,23,23,55
Glenavon,2528,3,9,9,8,53,46,7,36
Linfield,2528,4,10,6,10,37,36,1,36
Cliftonville,2528,5,9,5,12,32,31,1,32
Ballymena,2528,6,7,4,15,27,50,-23,25
Glentoran,2528,7,6,6,10,24,32,-8,24
Dungannon,2528,8,2,4,16,14,47,-33,10
Crusaders,2529,1,17,6,3,63,30,33,57
Coleraine,2529,2,14,10,2,44,24,20,52
Glenavon,2529,3,10,9,7,54,44,10,39
Linfield,2529,4,11,5,10,42,36,6,38
Cliftonville,2529,5,9,4,13,32,36,-4,31
Ballymena,2529,6,7,4,15,25,49,-24,25
Glentoran,2529,7,6,6,10,24,32,-8,24
Dungannon,2529,8,2,4,16,14,47,-33,10
Crusaders,2530,1,17,6,3,62,30,32,57
Coleraine,2530,2,15,10,1,44,22,22,55
Glenavon,2530,3,9,9,8,52,44,8,36
Linfield,2530,4,10,5,11,39,39,0,35
Cliftonville,2530,5,10,4,12,35,33,2,34
Ballymena,2530,6,7,4,15,25,48,-23,25
Glentoran,2530,7,6,6,10,24,32,-8,24
Dungannon,2530,8,2,4,16,14,47,-33,10
Crusaders,2531,1,16,7,3,62,31,31,55
Coleraine,2531,2,15,10,1,48,23,25,55
Linfield,2531,3,11,5,10,38,36,2,38
Glenavon,2531,4,9,9,8,53,48,5,36
Cliftonville,2531,5,9,4,13,32,32,0,31
Ballymena,2531,6,7,5,14,26,48,-22,26
Glentoran,2531,7,6,6,10,24,32,-8,24
Dungannon,2531,8,2,4,16,14,47,-33,10
Crusaders,2532,1,16,7,3,62,31,31,55
Coleraine,2532,2,14,11,1,45,24,21,53
Linfield,2532,3,11,5,10,39,36,3,38
Glenavon,2532,4,9,10,7,54,45,9,37
Cliftonville,2532,5,9,4,13,32,33,-1,31
Ballymena,2532,6,7,5,14,26,48,-22,26
Glentoran,2532,7,6,6,10,24,32,-8,24
Dungannon,2532,8,2,4,16,14,47,-33,10
Coleraine,2533,1,15,10,1,46,22,24,55
Crusaders,2533,2,16,6,4,62,33,29,54
Linfield,2533,3,11,5,10,39,37,2,38
Glenavon,2533,4,9,9,8,52,46,6,36
Cliftonville,2533,5,9,4,13,33,33,0,31
Ballymena,2533,6,8,4,14,28,48,-20,28
Glentoran,2533,7,6,6,10,24,32,-8,24
Dungannon,2533,8,2,4,16,14,47,-33,10
Crusaders,2534,1,17,6,3,63,31,32,57
Coleraine,2534,2,14,10,2,43,23,20,52
Glenavon,2534,3,10,9,7,53,43,10,39
Linfield,2534,4,10,6,10,38,37,1,36
Cliftonville,2534,5,9,5,12,33,32,1,32
Ballymena,2534,6,7,4,15,26,49,-23,25
Glentoran,2534,7,6,6,10,24,32,-8,24
Dungannon,2534,8,2,4,16,14,47,-33,10
Crusaders,2535,1,17,6,3,62,30,32,57
Coleraine,2535,2,15,10,1,45,22,23,55
Linfield,2535,3,11,5,10,39,37,2,38
Glenavon,2535,4,9,9,8,52,45,7,36
Cliftonville,2535,5,9,4,13,33,33,0,31
Ballymena,2535,6,7,4,15,25,48,-23,25
Glentoran,2535,7,6,6,10,24,32,-8,24
Dungannon,2535,8,2,4,16,14,47,-33,10
Crusaders,2536,1,16,6,4,61,32,29,54
Coleraine,2536,2,14,10,2,45,26,19,52
Glenavon,2536,3,10,9,7,56,45,11,39
Linfield,2536,4,10,6,10,37,36,1,36
Cliftonville,2536,5,9,5,12,32,31,1,32
Ballymena,2536,6,8,4,14,27,47,-20,28
Glentoran,2536,7,6,6,10,24,32,-8,24
Dungannon,2536,8,2,4,16,14,47,-33,10
Crusaders,2537,1,16,6,4,62,32,30,54
Coleraine,2537,2,14,10,2,44,25,19,52
Glenavon,2537,3,10,9,7,55,44,11,39
Linfield,2537,4,11,5,10,40,38,2,38
Cliftonville,2537,5,9,4,13,34,34,0,31
Ballymena,2537,6,8,4,14,27,48,-21,28
Glentoran,2537,7,6,6,10,24,32,-8,24
Dungannon,2537,8,2,4,16,14,47,-33,10
Crusaders,2538,1,17,6,3,64,31,33,57
Coleraine,2538,2,14,10,2,45,25,20,52
Glenavon,2538,3,10,9,7,55,45,10,39
Linfield,2538,4,10,5,11,38,39,-1,35
Cliftonville,2538,5,10,4,12,35,32,3,34
Ballymena,2538,6,7,4,15,26,50,-24,25
Glentoran,2538,7,6,6,10,24,32,-8,24
Dungannon,2538,8,2,4,16,14,47,-33,10
Crusaders,2539,1,16,7,3,61,30,31,55
Coleraine,2539,2,14,11,1,45,24,21,53
Linfield,2539,3,11,5,10,39,37,2,38
Glenavon,2539,4,9,10,7,54,45,9,37
Cliftonville,2539,5,9,4,13,33,33,0,31
Ballymena,2539,6,7,5,14,25,47,-22,26
Glentoran,2539,7,6,6,10,24,32,-8,24
Dungannon,2539,8,2,4,16,14,47,-33,10
Crusaders,2540,1,17,6,3,63,31,32,57
Coleraine,2540,2,15,10,1,46,23,23,55
Linfield,2540,3,11,5,10,42,38,4,38
Glenavon,2540,4,9,9,8,53,46,7,36
Cliftonville,2540,5,9,4,13,34,36,-2,31
Ballymena,2540,6,7,4,15,26,49,-23,25
Glentoran,2540,7,6,6,10,24,32,-8,24
Dungannon,2540,8,2,4,16,14,47,-33,10
Crusaders,2541,1,16,7,3,62,31,31,55
Coleraine,2541,2,14,10,2,44,24,20,52
Glenavon,2541,3,10,9,7,54,44,10,39
Linfield,2541,4,10,6,10,38,37,1,36
Cliftonville,2541,5,9,5,12,33,32,1,32
Ballymena,2541,6,7,5,14,26,48,-22,26
Glentoran,2541,7,6,6,10,24,32,-8,24
Dungannon,2541,8,2,4,16,14,47,-33,10
Crusaders,2542,1,17,6,3,64,32,32,57
Coleraine,2542,2,15,10,1,47,23,24,55
Linfield,2542,3,11,5,10,40,37,3,38
Glenavon,2542,4,9,9,8,53,47,6,36
Cliftonville,2542,5,9,4,13,33,34,-1,31
Ballymena,2542,6,7,4,15,27,50,-23,25
Glentoran,2542,7,6,6,10,24,32,-8,24
Dungannon,2542,8,2,4,16,14,47,-33,10
Crusaders,2543,1,16,6,4,61,32,29,54
Coleraine,2543,2,14,10,2,43,23,20,52
Glenavon,2543,3,10,9,7,53,43,10,39
Linfield,2543,4,10,5,11,37,38,-1,35
Cliftonville,2543,5,10,4,12,34,31,3,34
Ballymena,2543,6,8,4,14,27,47,-20,28
Glentoran,2543,7,6,6,10,24,32,-8,24
Dungannon,2543,8,2,4,16,14,47,-33,10
Coleraine,2544,1,15,10,1,46,24,22,55
Crusaders,2544,2,16,6,4,62,32,30,54
Linfield,2544,3,11,5,10,39,37,2,38
Glenavon,2544,4,9,9,8,54,46,8,36
Cliftonville,2544,5,9,4,13,33,33,0,31
Ballymena,2544,6,8,4,14,27,48,-21,28
Glentoran,2544,7,6,6,10,24,32,-8,24
Dungannon,2544,8,2,4,16,14,47,-33,10
Crusaders,2545,1,17,6,3,65,30,35,57
Coleraine,2545,2,15,10,1,45,22,23,55
Glenavon,2545,3,9,9,8,52,45,7,36
Linfield,2545,4,10,5,11,37,39,-2,35
Cliftonville,2545,5,10,4,12,35,31,4,34
Ballymena,2545,6,7,4,15,25,51,-26,25
Glentoran,2545,7,6,6,10,24,32,-8,24
Dungannon,2545,8,2,4,16,14,47,-33,10
Crusaders,2546,1,17,6,3,63,31,32,57
Coleraine,2546,2,14,10,2,45,25,20,52
Glenavon,2546,3,10,9,7,55,45,10,39
Linfield,2546,4,10,5,11,38,38,0,35
Cliftonville,2546,5,10,4,12,34,32,2,34
Ballymena,2546,6,7,4,15,26,49,-23,25
Glentoran,2546,7,6,6,10,24,32,-8,24
Dungannon,2546,8,2,4,16,14,47,-33,10
Crusaders,2547,1,16,7,3,62,31,31,55
Coleraine,2547,2,15,10,1,45,22,23,55
Glenavon,2547,3,9,9,8,52,45,7,36
Linfield,2547,4,10,6,10,39,38,1,36
Cliftonville,2547,5,9,5,12,34,33,1,32
Ballymena,2547,6,7,5,14,26,48,-22,26
Glentoran,2547,7,6,6,10,24,32,-8,24
Dungannon,2547,8,2,4,16,14,47,-33,10
Crusaders,2548,1,17,6,3,64,31,33,57
Coleraine,2548,2,14,11,1,46,25,21,53
Glenavon,2548,3,9,10,7,55,46,9,37
Linfield,2548,4,10,5,11,37,37,0,35
Cliftonville,2548,5,10,4,12,33,31,2,34
Ballymena,2548,6,7,4,15,26,50,-24,25
Glentoran,2548,7,6,6,10,24,32,-8,24
Dungannon,2548,8,2,4,16,14,47,-33,10
Crusaders,2549,1,17,6,3,64,31,33,57
Coleraine,2549,2,15,10,1,45,23,22,55
Linfield,2549,3,11,5,10,41,36,5,38
Glenavon,2549,4,9,9,8,53,45,8,36
Cliftonville,2549,5,9,4,13,32,35,-3,31
Ballymena,2549,6,7,4,15,26,50,-24,25
Glentoran,2549,7,6,6,10,24,32,-8,24
Dungannon,2549,8,2,4,16,14,47,-33,10
Crusaders,2550,1,17,6,3,64,32,32,57
Coleraine,2550,2,15,10,1,44,22,22,55
Linfield,2550,3,11,5,10,40,36,4,38
Glenavon,2550,4,9,9,8,52,44,8,36
Cliftonville,2550,5,9,4,13,32,34,-2,31
Ballymena,2550,6,7,4,15,27,50,-23,25
Glentoran,2550,7,6,6,10,24,32,-8,24
Dungannon,2550,8,2,4,16,14,47,-33,10
Crusaders,2551,1,17,6,3,65,32,33,57
Coleraine,2551,2,14,10,2,43,23,20,52
Glenavon,2551,3,10,9,7,53,43,10,39
Linfield,2551,4,10,6,10,39,38,1,36
Cliftonville,2551,5,9,5,12,34,33,1,32
Ballymena,2551,6,7,4,15,27,51,-24,25
Glentoran,2551,7,6,6,10,24,32,-8,24
Dungannon,2551,8,2,4,16,14,47,-33,10
Crusaders,2552,1,17,6,3,65,30,35,57
Coleraine,2552,2,14,10,2,44,25,19,52
Glenavon,2552,3,10,9,7,55,44,11,39
Linfield,2552,4,11,5,10,39,36,3,38
Cliftonville,2552,5,9,4,13,32,33,-1,31
Ballymena,2552,6,7,4,15,25,51,-26,25
Glentoran,2552,7,6,6,10,24,32,-8,24
Dungannon,2552,8,2,4,16,14,47,-33,10
Crusaders,2553,1,16,7,3,61,30,31,55
Coleraine,2553,2,15,10,1,46,23,23,55
Glenavon,2553,3,9,9,8,53,46,7,36
Linfield,2553,4,10,6,10,38,37,1,36
Cliftonville,2553,5,9,5,12,33,32,1,32
Ballymena,2553,6,7,5,14,25,47,-22,26
Glentoran,2553,7,6,6,10,24,32,-8,24
Dungannon,2553,8,2,4,16,14,47,-33,10
Crusaders,2554,1,17,6,3,64,32,32,57
Coleraine,2554,2,14,10,2,43,25,18,52
Glenavon,2554,3,10,9,7,55,43,12,39
Linfield,2554,4,11,5,10,39,37,2,38
Cliftonville,2554,5,9,4,13,33,33,0,31
Ballymena,2554,6,7,4,15,27,50,-23,25
Glentoran,2554,7,6,6,10,24,32,-8,24
Dungannon,2554,8,2,4,16,14,47,-33,10
Coleraine,2555,1,15,10,1,46,24,22,55
Crusaders,2555,2,16,6,4,61,31,30,54
Linfield,2555,3,11,5,10,42,37,5,38
Glenavon,2555,4,9,9,8,54,46,8,36
Cliftonville,2555,5,9,4,13,33,36,-3,31
Ballymena,2555,6,8,4,14,26,47,-21,28
Glentoran,2555,7,6,6,10,24,32,-8,24
Dungannon,2555,8,2,4,16,14,47,-33,10
Crusaders,2556,1,17,6,3,65,32,33,57
Coleraine,2556,2,14,11,1,45,24,21,53
Glenavon,2556,3,9,10,7,54,45,9,37
Linfield,2556,4,10,6,10,40,39,1,36
Cliftonville,2556,5,9,5,12,35,34,1,32
Ballymena,2556,6,7,4,15,27,51,-24,25
Glentoran,2556,7,6,6,10,24,32,-8,24
Dungannon,2556,8,2,4,16,14,47,-33,10
Crusaders,2557,1,16,7,3,63,32,31,55
Coleraine,2557,2,14,10,2,44,24,20,52
Glenavon,2557,3,10,9,7,54,44,10,39
Linfield,2557,4,11,5,10,38,36,2,38
Cliftonville,2557,5,9,4,13,32,32,0,31
Ballymena,2557,6,7,5,14,27,49,-22,26
Glentoran,2557,7,6,6,10,24,32,-8,24
Dungannon,2557,8,2,4,16,14,47,-33,10
Coleraine,2558,1,15,10,1,45,23,22,55
Crusaders,2558,2,16,6,4,61,32,29,54
Glenavon,2558,3,9,9,8,53,45,8,36
Linfield,2558,4,10,6,10,38,37,1,36
Cliftonville,2558,5,9,5,12,33,32,1,32
Ballymena,2558,6,8,4,14,27,47,-20,28
Glentoran,2558,7,6,6,10,24,32,-8,24
Dungannon,2558,8,2,4,16,14,47,-33,10
Coleraine,2559,1,15,10,1,46,23,23,55
Crusaders,2559,2,16,6,4,61,33,28,54
Glenavon,2559,3,9,9,8,53,46,7,36
Linfield,2559,4,10,6,10,38,37,1,36
Cliftonville,2559,5,9,5,12,33,32,1,32
Ballymena,2559,6,8,4,14,28,47,-19,28
Glentoran,2559,7,6,6,10,24,32,-8,24
Dungannon,2559,8,2,4,16,14,47,-33,10
Crusaders,2560,1,17,6,3,65,33,32,57
Coleraine,2560,2,14,10,2,43,23,20,52
Glenavon,2560,3,10,9,7,53,43,10,39
Linfield,2560,4,10,6,10,37,36,1,36
Cliftonville,2560,5,9,5,12,32,31,1,32
Ballymena,2560,6,7,4,15,28,51,-23,25
Glentoran,2560,7,6,6,10,24,32,-8,24
Dungannon,2560,8,2,4,16,14,47,-33,10
Coleraine,2561,1,15,10,1,45,23,22,55
Crusaders,2561,2,16,6,4,62,32,30,54
Linfield,2561,3,11,5,10,38,36,2,38
Glenavon,2561,4,9,9,8,53,45,8,36
Cliftonville,2561,5,9,4,13,32,32,0,31
Ballymena,2561,6,8,4,14,27,48,-21,28
Glentoran,2561,7,6,6,10,24,32,-8,24
Dungannon,2561,8,2,4,16,14,47,-33,10
Crusaders,2562,1,17,6,3,65,31,34,57
Coleraine,2562,2,14,10,2,46,26,20,52
Glenavon,2562,3,10,9,7,56,46,10,39
Linfield,2562,4,11,5,10,39,36,3,38
Cliftonville,2562,5,9,4,13,32,33,-1,31
Ballymena,2562,6,7,4,15,26,51,-25,25
Glentoran,2562,7,6,6,10,24,32,-8,24
Dungannon,2562,8,2,4,16,14,47,-33,10
Crusaders,2563,1,17,6,3,65,30,35,57
Coleraine,2563,2,14,11,1,43,22,21,53
Linfield,2563,3,11,5,10,39,36,3,38
Glenavon,2563,4,9,10,7,52,43,9,37
Cliftonville,2563,5,9,4,13,32,33,-1,31
Ballymena,2563,6,7,4,15,25,51,-26,25
Glentoran,2563,7,6,6,10,24,32,-8,24
Dungannon,2563,8,2,4,16,14,47,-33,10
Crusaders,2564,1,17,6,3,63,31,32,57
Coleraine,2564,2,15,10,1,44,22,22,55
Glenavon,2564,3,9,9,8,52,44,8,36
Linfield,2564,4,10,6,10,39,38,1,36
Cliftonville,2564,5,9,5,12,34,33,1,32
Ballymena,2564,6,7,4,15,26,49,-23,25
Glentoran,2564,7,6,6,10,24,32,-8,24
Dungannon,2564,8,2,4,16,14,47,-33,10
Crusaders,2565,1,16,7,3,62,31,31,55
Coleraine,2565,2,14,11,1,45,24,21,53
Glenavon,2565,3,9,10,7,54,45,9,37
Linfield,2565,4,10,5,11,38,38,0,35
Cliftonville,2565,5,10,4,12,34,32,2,34
Ballymena,2565,6,7,5,14,26,48,-22,26
Glentoran,2565,7,6,6,10,24,32,-8,24
Dungannon,2565,8,2,4,16,14,47,-33,10
Crusaders,2566,1,17,6,3,64,31,33,57
Coleraine,2566,2,15,10,1,45,22,23,55
Linfield,2566,3,11,5,10,39,36,3,38
Glenavon,2566,4,9,9,8,52,45,7,36
Cliftonville,2566,5,9,4,13,32,33,-1,31
Ballymena,2566,6,7,4,15,26,50,-24,25
Glentoran,2566,7,6,6,10,24,32,-8,24
Dungannon,2566,8,2,4,16,14,47,-33,10
Crusaders,2567,1,17,6,3,63,31,32,57
Coleraine,2567,2,14,10,2,43,25,18,52
Glenavon,2567,3,10,9,7,55,43,12,39
Linfield,2567,4,11,5,10,40,38,2,38
Cliftonville,2567,5,9,4,13,34,34,0,31
Ballymena,2567,6,7,4,15,26,49,-23,25
Glentoran,2567,7,6,6,10,24,32,-8,24
Dungannon,2567,8,2,4,16,14,47,-33,10
Crusaders,2568,1,17,6,3,63,31,32,57
Coleraine,2568,2,15,10,1,44,22,22,55
Linfield,2568,3,11,5,10,38,36,2,38
Glenavon,2568,4,9,9,8,52,44,8,36
Cliftonville,2568,5,9,4,13,32,32,0,31
Ballymena,2568,6,7,4,15,26,49,-23,25
Glentoran,2568,7,6,6,10,24,32,-8,24
Dungannon,2568,8,2,4,16,14,47,-33,10
Crusaders,2569,1,17,6,3,62,30,32,57
Coleraine,2569,2,14,10,2,45,25,20,52
Glenavon,2569,3,10,9,7,55,45,10,39
Linfield,2569,4,10,6,10,37,36,1,36
Cliftonville,2569,5,9,5,12,32,31,1,32
Ballymena,2569,6,7,4,15,25,48,-23,25
Glentoran,2569,7,6,6,10,24,32,-8,24
Dungannon,2569,8,2,4,16,14,47,-33,10
Crusaders,2570,1,17,6,3,63,30,33,57
Coleraine,2570,2,14,10,2,43,24,19,52
Glenavon,2570,3,10,9,7,54,43,11,39
Linfield,2570,4,11,5,10,38,36,2,38
Cliftonville,2570,5,9,4,13,32,32,0,31
Ballymena,2570,6,7,4,15,25,49,-24,25
Glentoran,2570,7,6,6,10,24,32,-8,24
Dungannon,2570,8,2,4,16,14,47,-33,10
Crusaders,2571,1,17,6,3,64,32,32,57
Coleraine,2571,2,14,10,2,44,25,19,52
Glenavon,2571,3,10,9,7,55,44,11,39
Linfield,2571,4,10,6,10,37,36,1,36
Cliftonville,2571,5,9,5,12,32,31,1,32
Ballymena,2571,6,7,4,15,27,50,-23,25
Glentoran,2571,7,6,6,10,24,32,-8,24
Dungannon,2571,8,2,4,16,14,47,-33,10
Crusaders,2572,1,16,6,4,61,31,30,54
Coleraine,2572,2,14,10,2,44,25,19,52
Glenavon,2572,3,10,9,7,55,44,11,39
Linfield,2572,4,11,5,10,38,36,2,38
Cliftonville,2572,5,9,4,13,32,32,0,31
Ballymena,2572,6,8,4,14,26,47,-21,28
Glentoran,2572,7,6,6,10,24,32,-8,24
Dungannon,2572,8,2,4,16,14,47,-33,10
Coleraine,2573,1,15,10,1,45,22,23,55
Crusaders,2573,2,16,6,4,62,32,30,54
Glenavon,2573,3,9,9,8,52,45,7,36
Linfield,2573,4,10,5,11,37,38,-1,35
Cliftonville,2573,5,10,4,12,34,31,3,34
Ballymena,2573,6,8,4,14,27,48,-21,28
Glentoran,2573,7,6,6,10,24,32,-8,24
Dungannon,2573,8,2,4,16,14,47,-33,10
Crusaders,2574,1,16,7,3,61,30,31,55
Coleraine,2574,2,14,10,2,43,23,20,52
Glenavon,2574,3,10,9,7,53,43,10,39
Linfield,2574,4,10,6,10,39,38,1,36
Cliftonville,2574,5,9,5,12,34,33,1,32
Ballymena,2574,6,7,5,14,25,47,-22,26
Glentoran,2574,7,6,6,10,24,32,-8,24
Dungannon,2574,8,2,4,16,14,47,-33,10
Crusaders,2575,1,17,6,3,64,31,33,57
Coleraine,2575,2,15,10,1,46,22,24,55
Linfield,2575,3,11,5,10,40,38,2,38
Glenavon,2575,4,9,9,8,52,46,6,36
Cliftonville,2575,5,9,4,13,34,34,0,31
Ballymena,2575,6,7,4,15,26,50,-24,25
Glentoran,2575,7,6,6,10,24,32,-8,24
Dungannon,2575,8,2,4,16,14,47,-33,10
Crusaders,2576,1,17,6,3,63,30,33,57
Coleraine,2576,2,15,10,1,45,22,23,55
Linfield,2576,3,11,5,10,39,36,3,38
Glenavon,2576,4,9,9,8,52,45,7,36
Cliftonville,2576,5,9,4,13,32,33,-1,31
Ballymena,2576,6,7,4,15,25,49,-24,25
Glentoran,2576,7,6,6,10,24,32,-8,24
Dungannon,2576,8,2,4,16,14,47,-33,10
Crusaders,2577,1,17,6,3,64,31,33,57
Coleraine,2577,2,14,11,1,44,23,21,53
Linfield,2577,3,11,5,10,38,36,2,38
Glenavon,2577,4,9,10,7,53,44,9,37
Cliftonville,2577,5,9,4,13,32,32,0,31
Ballymena,2577,6,7,4,15,26,50,-24,25
Glentoran,2577,7,6,6,10,24,32,-8,24
Dungannon,2577,8,2,4,16,14,47,-33,10
Crusaders,2578,1,16,7,3,63,32,31,55
Coleraine,2578,2,14,10,2,43,25,18,52
Glenavon,2578,3,10,9,7,55,43,12,39
Linfield,2578,4,11,5,10,38,36,2,38
Cliftonville,2578,5,9,4,13,32,32,0,31
Ballymena,2578,6,7,5,14,27,49,-22,26
Glentoran,2578,7,6,6,10,24,32,-8,24
Dungannon,2578,8,2,4,16,14,47,-33,10
Crusaders,2579,1,17,6,3,63,30,33,57
Coleraine,2579,2,15,10,1,47,23,24,55
Linfield,2579,3,11,5,10,38,36,2,38
Glenavon,2579,4,9,9,8,53,47,6,36
Cliftonville,2579,5,9,4,13,32,32,0,31
Ballymena,2579,6,7,4,15,25,49,-24,25
Glentoran,2579,7,6,6,10,24,32,-8,24
Dungannon,2579,8,2,4,16,14,47,-33,10
Crusaders,2580,1,16,7,3,62,31,31,55
Coleraine,2580,2,14,10,2,43,24,19,52
Glenavon,2580,3,10,9,7,54,43,11,39
Linfield,2580,4,10,5,11,37,41,-4,35
Cliftonville,2580,5,10,4,12,37,31,6,34
Ballymena,2580,6,7,5,14,26,48,-22,26
Glentoran,2580,7,6,6,10,24,32,-8,24
Dungannon,2580,8,2,4,16,14,47,-33,10
Crusaders,2581,1,17,6,3,65,33,32,57
Coleraine,2581,2,14,10,2,43,26,17,52
Glenavon,2581,3,10,9,7,56,43,13,39
Linfield,2581,4,11,5,10,39,36,3,38
Cliftonville,2581,5,9,4,13,32,33,-1,31
Ballymena,2581,6,7,4,15,28,51,-23,25
Glentoran,2581,7,6,6,10,24,32,-8,24
Dungannon,2581,8,2,4,16,14,47,-33,10
Coleraine,2582,1,15,10,1,45,23,22,55
Crusaders,2582,2,16,6,4,61,32,29,54
Linfield,2582,3,11,5,10,39,37,2,38
Glenavon,2582,4,9,9,8,53,45,8,36
Cliftonville,2582,5,9,4,13,33,33,0,31
Ballymena,2582,6,8,4,14,27,47,-20,28
Glentoran,2582,7,6,6,10,24,32,-8,24
Dungannon,2582,8,2,4,16,14,47,-33,10
Crusaders,2583,1,17,6,3,65,30,35,57
Coleraine,2583,2,14,10,2,43,23,20,52
Glenavon,2583,3,10,9,7,53,43,10,39
Linfield,2583,4,10,6,10,38,37,1,36
Cliftonville,2583,5,9,5,12,33,32,1,32
Ballymena,2583,6,7,4,15,25,51,-26,25
Glentoran,2583,7,6,6,10,24,32,-8,24
Dungannon,2583,8,2,4,16,14,47,-33,10
Crusaders,2584,1,17,6,3,63,30,33,57
Coleraine,2584,2,14,10,2,43,26,17,52
Glenavon,2584,3,10,9,7,56,43,13,39
Linfield,2584,4,11,5,10,38,36,2,38
Cliftonville,2584,5,9,4,13,32,32,0,31
Ballymena,2584,6,7,4,15,25,49,-24,25
Glentoran,2584,7,6,6,10,24,32,-8,24
Dungannon,2584,8,2,4,16,14,47,-33,10
Crusaders,2585,1,16,6,4,61,31,30,54
Coleraine,2585,2,14,10,2,44,26,18,52
Glenavon,2585,3,10,9,7,56,44,12,39
Linfield,2585,4,11,5,10,40,38,2,38
Cliftonville,2585,5,9,4,13,34,34,0,31
Ballymena,2585,6,8,4,14,26,47,-21,28
Glentoran,2585,7,6,6,10,24,32,-8,24
Dungannon,2585,8,2,4,16,14,47,-33,10
Crusaders,2586,1,16,7,3,64,33,31,55
Coleraine,2586,2,15,10,1,46,22,24,55
Glenavon,2586,3,9,9,8,52,46,6,36
Linfield,2586,4,10,5,11,38,38,0,35
Cliftonville,2586,5,10,4,12,34,32,2,34
Ballymena,2586,6,7,5,14,28,50,-22,26
Glentoran,2586,7,6,6,10,24,32,-8,24
Dungannon,2586,8,2,4,16,14,47,-33,10
Crusaders,2587,1,17,6,3,63,30,33,57
Coleraine,2587,2,15,10,1,47,23,24,55
Linfield,2587,3,11,5,10,40,38,2,38
Glenavon,2587,4,9,9,8,53,47,6,36
Cliftonville,2587,5,9,4,13,34,34,0,31
Ballymena,2587,6,7,4,15,25,49,-24,25
Glentoran,2587,7,6,6,10,24,32,-8,24
Dungannon,2587,8,2,4,16,14,47,-33,10
Crusaders,2588,1,16,6,4,61,31,30,54
Coleraine,2588,2,14,10,2,44,25,19,52
Glenavon,2588,3,10,9,7,55,44,11,39
Linfield,2588,4,11,5,10,40,36,4,38
Cliftonville,2588,5,9,4,13,32,34,-2,31
Ballymena,2588,6,8,4,14,26,47,-21,28
Glentoran,2588,7,6,6,10,24,32,-8,24
Dungannon,2588,8,2,4,16,14,47,-33,10
Crusaders,2589,1,17,6,3,66,31,35,57
Coleraine,2589,2,14,10,2,43,24,19,52
Glenavon,2589,3,10,9,7,54,43,11,39
Linfield,2589,4,11,5,10,41,37,4,38
Cliftonville,2589,5,9,4,13,33,35,-2,31
Ballymena,2589,6,7,4,15,26,52,-26,25
Glentoran,2589,7,6,6,10,24,32,-8,24
Dungannon,2589,8,2,4,16,14,47,-33,10
Crusaders,2590,1,17,6,3,63,30,33,57
Coleraine,2590,2,14,11,1,44,23,21,53
Linfield,2590,3,11,5,10,38,36,2,38
Glenavon,2590,4,9,10,7,53,44,9,37
Cliftonville,2590,5,9,4,13,32,32,0,31
Ballymena,2590,6,7,4,15,25,49,-24,25
Glentoran,2590,7,6,6,10,24,32,-8,24
Dungannon,2590,8,2,4,16,14,47,-33,10
Crusaders,2591,1,16,7,3,63,32,31,55
Coleraine,2591,2,15,10,1,46,22,24,55
Linfield,2591,3,11,5,10,38,36,2,38
Glenavon,2591,4,9,9,8,52,46,6,36
Cliftonville,2591,5,9,4,13,32,32,0,31
Ballymena,2591,6,7,5,14,27,49,-22,26
Glentoran,2591,7,6,6,10,24,32,-8,24
Dungannon,2591,8,2,4,16,14,47,-33,10
Crusaders,2592,1,17,6,3,65,30,35,57
Coleraine,2592,2,14,10,2,43,24,19,52
Glenavon,2592,3,10,9,7,54,43,11,39
Linfield,2592,4,10,6,10,37,36,1,36
Cliftonville,2592,5,9,5,12,32,31,1,32
Ballymena,2592,6,7,4,15,25,51,-26,25
Glentoran,2592,7,6,6,10,24,32,-8,24
Dungannon,2592,8,2,4,16,14,47,-33,10
Crusaders,2593,1,16,7,3,63,32,31,55
Coleraine,2593,2,14,10,2,45,26,19,52
Glenavon,2593,3,10,9,7,56,45,11,39
Linfield,2593,4,10,6,10,37,36,1,36
Cliftonville,2593,5,9,5,12,32,31,1,32
Ballymena,2593,6,7,5,14,27,49,-22,26
Glentoran,2593,7,6,6,10,24,32,-8,24
Dungannon,2593,8,2,4,16,14,47,-33,10
Crusaders,2594,1,17,6,3,64,31,33,57
Coleraine,2594,2,14,10,2,43,23,20,52
Glenavon,2594,3,10,9,7,53,43,10,39
Linfield,2594,4,10,6,10,37,36,1,36
Cliftonville,2594,5,9,5,12,32,31,1,32
Ballymena,2594,6,7,4,15,26,50,-24,25
Glentoran,2594,7,6,6,10,24,32,-8,24
Dungannon,2594,8,2,4,16,14,47,-33,10
Crusaders,2595,1,16,6,4,62,33,29,54
Coleraine,2595,2,14,11,1,43,22,21,53
Linfield,2595,3,11,5,10,38,36,2,38
Glenavon,2595,4,9,10,7,52,43,9,37
Cliftonville,2595,5,9,4,13,32,32,0,31
Ballymena,2595,6,8,4,14,28,48,-20,28
Glentoran,2595,7,6,6,10,24,32,-8,24
Dungannon,2595,8,2,4,16,14,47,-33,10
Crusaders,2596,1,17,6,3,64,30,34,57
Coleraine,2596,2,14,10,2,45,25,20,52
Glenavon,2596,3,10,9,7,55,45,10,39
Linfield,2596,4,11,5,10,39,36,3,38
Cliftonville,2596,5,9,4,13,32,33,-1,31
Ballymena,2596,6,7,4,15,25,50,-25,25
Glentoran,2596,7,6,6,10,24,32,-8,24
Dungannon,2596,8,2,4,16,14,47,-33,10
Crusaders,2597,1,17,6,3,64,32,32,57
Coleraine,2597,2,14,11,1,44,23,21,53
Linfield,2597,3,11,5,10,41,36,5,38
Glenavon,2597,4,9,10,7,53,44,9,37
Cliftonville,2597,5,9,4,13,32,35,-3,31
Ballymena,2597,6,7,4,15,27,50,-23,25
Glentoran,2597,7,6,6,10,24,32,-8,24
Dungannon,2597,8,2,4,16,14,47,-33,10
Crusaders,2598,1,16,6,4,62,34,28,54
Coleraine,2598,2,14,11,1,44,23,21,53
Glenavon,2598,3,9,10,7,53,44,9,37
Linfield,2598,4,10,5,11,37,37,0,35
Cliftonville,2598,5,10,4,12,33,31,2,34
Ballymena,2598,6,8,4,14,29,48,-19,28
Glentoran,2598,7,6,6,10,24,32,-8,24
Dungannon,2598,8,2,4,16,14,47,-33,10
Crusaders,2599,1,16,7,3,63,32,31,55
Coleraine,2599,2,15,10,1,47,23,24,55
Linfield,2599,3,11,5,10,39,36,3,38
Glenavon,2599,4,9,9,8,53,47,6,36
Cliftonville,2599,5,9,4,13,32,33,-1,31
Ballymena,2599,6,7,5,14,27,49,-22,26
Glentoran,2599,7,6,6,10,24,32,-8,24
Dungannon,2599,8,2,4,16,14,47,-33,10
Crusaders,2600,1,17,6,3,63,30,33,57
Coleraine,2600,2,14,11,1,44,23,21,53
Glenavon,2600,3,9,10,7,53,44,9,37
Linfield,2600,4,10,6,10,38,37,1,36
Cliftonville,2600,5,9,5,12,33,32,1,32
Ballymena,2600,6,7,4,15,25,49,-24,25
Glentoran,2600,7,6,6,10,24,32,-8,24
Dungannon,2600,8,2,4,16,14,47,-33,10
Crusaders,2601,1,17,6,3,63,31,32,57
Coleraine,2601,2,14,11,1,43,22,21,53
Glenavon,2601,3,9,10,7,52,43,9,37
Linfield,2601,4,10,5,11,38,38,0,35
Cliftonville,2601,5,10,4,12,34,32,2,34
Ballymena,2601,6,7,4,15,26,49,-23,25
Glentoran,2601,7,6,6,10,24,32,-8,24
Dungannon,2601,8,2,4,16,14,47,-33,10
Crusaders,2602,1,16,6,4,62,32,30,54
Coleraine,2602,2,14,10,2,43,24,19,52
Glenavon,2602,3,10,9,7,54,43,11,39
Linfield,2602,4,10,5,11,38,38,0,35
Cliftonville,2602,5,10,4,12,34,32,2,34
Ballymena,2602,6,8,4,14,27,48,-21,28
Glentoran,2602,7,6,6,10,24,32,-8,24
Dungannon,2602,8,2,4,16,14,47,-33,10
Crusaders,2603,1,16,7,3,62,31,31,55
Coleraine,2603,2,15,10,1,45,22,23,55
Glenavon,2603,3,9,9,8,52,45,7,36
Linfield,2603,4,10,6,10,38,37,1,36
Cliftonville,2603,5,9,5,12,33,32,1,32
Ballymena,2603,6,7,5,14,26,48,-22,26
Glentoran,2603,7,6,6,10,24,32,-8,24
Dungannon,2603,8,2,4,16,14,47,-33,10
Crusaders,2604,1,16,7,3,62,31,31,55
Coleraine,2604,2,14,11,1,45,24,21,53
Glenavon,2604,3,9,10,7,54,45,9,37
Linfield,2604,4,10,6,10,37,36,1,36
Cliftonville,2604,5,9,5,12,32,31,1,32
Ballymena,2604,6,7,5,14,26,48,-22,26
Glentoran,2604,7,6,6,10,24,32,-8,24
Dungannon,2604,8,2,4,16,14,47,-33,10
Crusaders,2605,1,16,7,3,62,31,31,55
Coleraine,2605,2,14,10,2,44,25,19,52
Glenavon,2605,3,10,9,7,55,44,11,39
Linfield,2605,4,11,5,10,44,37,7,38
Cliftonville,2605,5,9,4,13,33,38,-5,31
Ballymena,2605,6,7,5,14,26,48,-22,26
Glentoran,2605,7,6,6,10,24,32,-8,24
Dungannon,2605,8,2,4,16,14,47,-33,10
Crusaders,2606,1,17,6,3,63,30,33,57
Coleraine,2606,2,14,10,2,44,24,20,52
Glenavon,2606,3,10,9,7,54,44,10,39
Linfield,2606,4,11,5,10,38,36,2,38
Cliftonville,2606,5,9,4,13,32,32,0,31
Ballymena,2606,6,7,4,15,25,49,-24,25
Glentoran,2606,7,6,6,10,24,32,-8,24
Dungannon,2606,8,2,4,16,14,47,-33,10
Crusaders,2607,1,16,7,3,62,31,31,55
Coleraine,2607,2,14,11,1,43,22,21,53
Linfield,2607,3,11,5,10,39,37,2,38
Glenavon,2607,4,9,10,7,52,43,9,37
Cliftonville,2607,5,9,4,13,33,33,0,31
Ballymena,2607,6,7,5,14,26,48,-22,26
Glentoran,2607,7,6,6,10,24,32,-8,24
Dungannon,2607,8,2,4,16,14,47,-33,10
Crusaders,2608,1,16,6,4,62,32,30,54
Coleraine,2608,2,14,11,1,43,22,21,53
Glenavon,2608,3,9,10,7,52,43,9,37
Linfield,2608,4,10,5,11,38,38,0,35
Cliftonville,2608,5,10,4,12,34,32,2,34
Ballymena,2608,6,8,4,14,27,48,-21,28
Glentoran,2608,7,6,6,10,24,32,-8,24
Dungannon,2608,8,2,4,16,14,47,-33,10
Crusaders,2609,1,17,6,3,63,30,33,57
Coleraine,2609,2,14,10,2,44,27,17,52
Glenavon,2609,3,10,9,7,57,44,13,39
Linfield,2609,4,10,5,11,37,37,0,35
Cliftonville,2609,5,10,4,12,33,31,2,34
Ballymena,2609,6,7,4,15,25,49,-24,25
Glentoran,2609,7,6,6,10,24,32,-8,24
Dungannon,2609,8,2,4,16,14,47,-33,10
Crusaders,2610,1,17,6,3,62,30,32,57
Coleraine,2610,2,15,10,1,45,23,22,55
Glenavon,2610,3,9,9,8,53,45,8,36
Linfield,2610,4,10,5,11,37,38,-1,35
Cliftonville,2610,5,10,4,12,34,31,3,34
Ballymena,2610,6,7,4,15,25,48,-23,25
Glentoran,2610,7,6,6,10,24,32,-8,24
Dungannon,2610,8,2,4,16,14,47,-33,10
Crusaders,2611,1,16,7,3,63,32,31,55
Coleraine,2611,2,14,10,2,43,25,18,52
Glenavon,2611,3,10,9,7,55,43,12,39
Linfield,2611,4,10,5,11,38,40,-2,35
Cliftonville,2611,5,10,4,12,36,32,4,34
Ballymena,2611,6,7,5,14,27,49,-22,26
Glentoran,2611,7,6,6,10,24,32,-8,24
Dungannon,2611,8,2,4,16,14,47,-33,10
Crusaders,2612,1,16,6,4,62,33,29,54
Coleraine,2612,2,14,10,2,44,24,20,52
Glenavon,2612,3,10,9,7,54,44,10,39
Linfield,2612,4,10,6,10,38,37,1,36
Cliftonville,2612,5,9,5,12,33,32,1,32
Ballymena,2612,6,8,4,14,28,48,-20,28
Glentoran,2612,7,6,6,10,24,32,-8,24
Dungannon,2612,8,2,4,16,14,47,-33,10
Crusaders,2613,1,17,6,3,64,32,32,57
Coleraine,2613,2,14,10,2,43,24,19,52
Glenavon,2613,3,10,9,7,54,43,11,39
Linfield,2613,4,11,5,10,40,36,4,38
Cliftonville,2613,5,9,4,13,32,34,-2,31
Ballymena,2613,6,7,4,15,27,50,-23,25
Glentoran,2613,7,6,6,10,24,32,-8,24
Dungannon,2613,8,2,4,16,14,47,-33,10
Crusaders,2614,1,17,6,3,68,35,33,57
Coleraine,2614,2,15,10,1,45,22,23,55
Linfield,2614,3,11,5,10,39,36,3,38
Glenavon,2614,4,9,9,8,52,45,7,36
Cliftonville,2614,5,9,4,13,32,33,-1,31
Ballymena,2614,6,7,4,15,30,54,-24,25
Glentoran,2614,7,6,6,10,24,32,-8,24
Dungannon,2614,8,2,4,16,14,47,-33,10
Crusaders,2615,1,16,6,4,62,33,29,54
Coleraine,2615,2,14,10,2,44,24,20,52
Glenavon,2615,3,10,9,7,54,44,10,39
Linfield,2615,4,11,5,10,39,36,3,38
Cliftonville,2615,5,9,4,13,32,33,-1,31
Ballymena,2615,6,8,4,14,28,48,-20,28
Glentoran,2615,7,6,6,10,24,32,-8,24
Dungannon,2615,8,2,4,16,14,47,-33,10
Crusaders,2616,1,17,6,3,67,31,36,57
Coleraine,2616,2,14,11,1,45,24,21,53
Glenavon,2616,3,9,10,7,54,45,9,37
Linfield,2616,4,10,5,11,38,38,0,35
Cliftonville,2616,5,10,4,12,34,32,2,34
Ballymena,2616,6,7,4,15,26,53,-27,25
Glentoran,2616,7,6,6,10,24,32,-8,24
Dungannon,2616,8,2,4,16,14,47,-33,10
Coleraine,2617,1,15,10,1,45,22,23,55
Crusaders,2617,2,16,6,4,62,33,29,54
Glenavon,2617,3,9,9,8,52,45,7,36
Linfield,2617,4,10,6,10,39,38,1,36
Cliftonville,2617,5,9,5,12,34,33,1,32
Ballymena,2617,6,8,4,14,28,48,-20,28
Glentoran,2617,7,6,6,10,24,32,-8,24
Dungannon,2617,8,2,4,16,14,47,-33,10
Crusaders,2618,1,16,7,3,62,31,31,55
Coleraine,2618,2,15,10,1,44,22,22,55
Linfield,2618,3,11,5,10,39,36,3,38
Glenavon,2618,4,9,9,8,52,44,8,36
Cliftonville,2618,5,9,4,13,32,33,-1,31
Ballymena,2618,6,7,5,14,26,48,-22,26
Glentoran,2618,7,6,6,10,24,32,-8,24
Dungannon,2618,8,2,4,16,14,47,-33,10
Crusaders,2619,1,16,6,4,62,33,29,54
Coleraine,2619,2,14,10,2,44,24,20,52
Glenavon,2619,3,10,9,7,54,44,10,39
Linfield,2619,4,10,6,10,38,37,1,36
Cliftonville,2619,5,9,5,12,33,32,1,32
Ballymena,2619,6,8,4,14,28,48,-20,28
Glentoran,2619,7,6,6,10,24,32,-8,24
Dungannon,2619,8,2,4,16,14,47,-33,10
Crusaders,2620,1,17,6,3,65,30,35,57
Coleraine,2620,2,14,10,2,44,24,20,52
Glenavon,2620,3,10,9,7,54,44,10,39
Linfield,2620,4,10,6,10,39,38,1,36
Cliftonville,2620,5,9,5,12,34,33,1,32
Ballymena,2620,6,7,4,15,25,51,-26,25
Glentoran,2620,7,6,6,10,24,32,-8,24
Dungannon,2620,8,2,4,16,14,47,-33,10
Crusaders,2621,1,17,6,3,67,31,36,57
Coleraine,2621,2,14,10,2,44,24,20,52
Glenavon,2621,3,10,9,7,54,44,10,39
Linfield,2621,4,10,6,10,40,39,1,36
Cliftonville,2621,5,9,5,12,35,34,1,32
Ballymena,2621,6,7,4,15,26,53,-27,25
Glentoran,2621,7,6,6,10,24,32,-8,24
Dungannon,2621,8,2,4,16,14,47,-33,10
Crusaders,2622,1,17,6,3,63,30,33,57
Coleraine,2622,2,14,11,1,44,23,21,53
Glenavon,2622,3,9,10,7,53,44,9,37
Linfield,2622,4,10,6,10,37,36,1,36
Cliftonville,2622,5,9,5,12,32,31,1,32
Ballymena,2622,6,7,4,15,25,49,-24,25
Glentoran,2622,7,6,6,10,24,32,-8,24
Dungannon,2622,8,2,4,16,14,47,-33,10
Crusaders,2623,1,16,7,3,64,33,31,55
Coleraine,2623,2,14,10,2,43,24,19,52
Glenavon,2623,3,10,9,7,54,43,11,39
Linfield,2623,4,10,5,11,38,38,0,35
Cliftonville,2623,5,10,4,12,34,32,2,34
Ballymena,2623,6,7,5,14,28,50,-22,26
Glentoran,2623,7,6,6,10,24,32,-8,24
Dungannon,2623,8,2,4,16,14,47,-33,10
Crusaders,2624,1,17,6,3,66,30,36,57
Coleraine,2624,2,14,11,1,44,23,21,53
Linfield,2624,3,11,5,10,41,37,4,38
Glenavon,2624,4,9,10,7,53,44,9,37
Cliftonville,2624,5,9,4,13,33,35,-2,31
Ballymena,2624,6,7,4,15,25,52,-27,25
Glentoran,2624,7,6,6,10,24,32,-8,24
Dungannon,2624,8,2,4,16,14,47,-33,10
Crusaders,2625,1,16,6,4,61,32,29,54
Coleraine,2625,2,14,11,1,43,22,21,53
Glenavon,2625,3,9,10,7,52,43,9,37
Linfield,2625,4,10,6,10,38,37,1,36
Cliftonville,2625,5,9,5,12,33,32,1,32
Ballymena,2625,6,8,4,14,27,47,-20,28
Glentoran,2625,7,6,6,10,24,32,-8,24
Dungannon,2625,8,2,4,16,14,47,-33,10
Crusaders,2626,1,16,6,4,62,34,28,54
Coleraine,2626,2,14,10,2,44,26,18,52
Glenavon,2626,3,10,9,7,56,44,12,39
Linfield,2626,4,11,5,10,39,37,2,38
Cliftonville,2626,5,9,4,13,33,33,0,31
Ballymena,2626,6,8,4,14,29,48,-19,28
Glentoran,2626,7,6,6,10,24,32,-8,24
Dungannon,2626,8,2,4,16,14,47,-33,10
Crusaders,2627,1,17,6,3,63,31,32,57
Coleraine,2627,2,14,10,2,43,25,18,52
Glenavon,2627,3,10,9,7,55,43,12,39
Linfield,2627,4,11,5,10,39,37,2,38
Cliftonville,2627,5,9,4,13,33,33,0,31
Ballymena,2627,6,7,4,15,26,49,-23,25
Glentoran,2627,7,6,6,10,24,32,-8,24
Dungannon,2627,8,2,4,16,14,47,-33,10
Crusaders,2628,1,16,7,3,62,31,31,55
Coleraine,2628,2,14,10,2,43,23,20,52
Glenavon,2628,3,10,9,7,53,43,10,39
Linfield,2628,4,11,5,10,38,36,2,38
Cliftonville,2628,5,9,4,13,32,32,0,31
Ballymena,2628,6,7,5,14,26,48,-22,26
Glentoran,2628,7,6,6,10,24,32,-8,24
Dungannon,2628,8,2,4,16,14,47,-33,10
Crusaders,2629,1,16,6,4,62,34,28,54
Coleraine,2629,2,14,10,2,44,25,19,52
Glenavon,2629,3,10,9,7,55,44,11,39
Linfield,2629,4,10,5,11,37,37,0,35
Cliftonville,2629,5,10,4,12,33,31,2,34
Ballymena,2629,6,8,4,14,29,48,-19,28
Glentoran,2629,7,6,6,10,24,32,-8,24
Dungannon,2629,8,2,4,16,14,47,-33,10
Crusaders,2630,1,16,7,3,62,31,31,55
Coleraine,2630,2,14,10,2,44,25,19,52
Glenavon,2630,3,10,9,7,55,44,11,39
Linfield,2630,4,10,6,10,38,37,1,36
Cliftonville,2630,5,9,5,12,33,32,1,32
Ballymena,2630,6,7,5,14,26,48,-22,26
Glentoran,2630,7,6,6,10,24,32,-8,24
Dungannon,2630,8,2,4,16,14,47,-33,10
Coleraine,2631,1,15,10,1,47,23,24,55
Crusaders,2631,2,16,6,4,62,32,30,54
Glenavon,2631,3,9,9,8,53,47,6,36
Linfield,2631,4,10,6,10,38,37,1,36
Cliftonville,2631,5,9,5,12,33,32,1,32
Ballymena,2631,6,8,4,14,27,48,-21,28
Glentoran,2631,7,6,6,10,24,32,-8,24
Dungannon,2631,8,2,4,16,14,47,-33,10
Crusaders,2632,1,16,7,3,63,32,31,55
Coleraine,2632,2,15,10,1,44,22,22,55
Linfield,2632,3,11,5,10,39,37,2,38
Glenavon,2632,4,9,9,8,52,44,8,36
Cliftonville,2632,5,9,4,13,33,33,0,31
Ballymena,2632,6,7,5,14,27,49,-22,26
Glentoran,2632,7,6,6,10,24,32,-8,24
Dungannon,2632,8,2,4,16,14,47,-33,10
Crusaders,2633,1,16,7,3,61,30,31,55
Coleraine,2633,2,14,10,2,43,23,20,52
Glenavon,2633,3,10,9,7,53,43,10,39
Linfield,2633,4,11,5,10,38,36,2,38
Cliftonville,2633,5,9,4,13,32,32,0,31
Ballymena,2633,6,7,5,14,25,47,-22,26
Glentoran,2633,7,6,6,10,24,32,-8,24
Dungannon,2633,8,2,4,16,14,47,-33,10
Crusaders,2634,1,16,7,3,62,31,31,55
Coleraine,2634,2,14,10,2,44,25,19,52
Glenavon,2634,3,10,9,7,55,44,11,39
Linfield,2634,4,10,6,10,37,36,1,36
Cliftonville,2634,5,9,5,12,32,31,1,32
Ballymena,2634,6,7,5,14,26,48,-22,26
Glentoran,2634,7,6,6,10,24,32,-8,24
Dungannon,2634,8,2,4,16,14,47,-33,10
Crusaders,2635,1,17,6,3,67,31,36,57
Coleraine,2635,2,15,10,1,46,23,23,55
Linfield,2635,3,11,5,10,38,36,2,38
Glenavon,2635,4,9,9,8,53,46,7,36
Cliftonville,2635,5,9,4,13,32,32,0,31
Ballymena,2635,6,7,4,15,26,53,-27,25
Glentoran,2635,7,6,6,10,24,32,-8,24
Dungannon,2635,8,2,4,16,14,47,-33,10
Crusaders,2636,1,17,6,3,63,30,33,57
Coleraine,2636,2,15,10,1,44,22,22,55
Glenavon,2636,3,9,9,8,52,44,8,36
Linfield,2636,4,10,5,11,37,37,0,35
Cliftonville,2636,5,10,4,12,33,31,2,34
Ballymena,2636,6,7,4,15,25,49,-24,25
Glentoran,2636,7,6,6,10,24,32,-8,24
Dungannon,2636,8,2,4,16,14,47,-33,10
Crusaders,2637,1,16,7,3,62,31,31,55
Coleraine,2637,2,15,10,1,45,22,23,55
Glenavon,2637,3,9,9,8,52,45,7,36
Linfield,2637,4,10,6,10,38,37,1,36
Cliftonville,2637,5,9,5,12,33,32,1,32
Ballymena,2637,6,7,5,14,26,48,-22,26
Glentoran,2637,7,6,6,10,24,32,-8,24
Dungannon,2637,8,2,4,16,14,47,-33,10
Crusaders,2638,1,17,6,3,63,31,32,57
Coleraine,2638,2,14,10,2,44,24,20,52
Glenavon,2638,3,10,9,7,54,44,10,39
Linfield,2638,4,10,5,11,37,39,-2,35
Cliftonville,2638,5,10,4,12,35,31,4,34
Ballymena,2638,6,7,4,15,26,49,-23,25
Glentoran,2638,7,6,6,10,24,32,-8,24
Dungannon,2638,8,2,4,16,14,47,-33,10
Crusaders,2639,1,17,6,3,63,30,33,57
Coleraine,2639,2,15,10,1,45,23,22,55
Linfield,2639,3,11,5,10,39,36,3,38
Glenavon,2639,4,9,9,8,53,45,8,36
Cliftonville,2639,5,9,4,13,32,33,-1,31
Ballymena,2639,6,7,4,15,25,49,-24,25
Glentoran,2639,7,6,6,10,24,32,-8,24
Dungannon,2639,8,2,4,16,14,47,-33,10
Crusaders,2640,1,17,6,3,64,31,33,57
Coleraine,2640,2,14,10,2,44,25,19,52
Glenavon,2640,3,10,9,7,55,44,11,39
Linfield,2640,4,10,5,11,39,39,0,35
Cliftonville,2640,5,10,4,12,35,33,2,34
Ballymena,2640,6,7,4,15,26,50,-24,25
Glentoran,2640,7,6,6,10,24,32,-8,24
Dungannon,2640,8,2,4,16,14,47,-33,10
Crusaders,2641,1,17,6,3,63,31,32,57
Coleraine,2641,2,15,10,1,48,23,25,55
Linfield,2641,3,11,5,10,39,36,3,38
Glenavon,2641,4,9,9,8,53,48,5,36
Cliftonville,2641,5,9,4,13,32,33,-1,31
Ballymena,2641,6,7,4,15,26,49,-23,25
Glentoran,2641,7,6,6,10,24,32,-8,24
Dungannon,2641,8,2,4,16,14,47,-33,10
Crusaders,2642,1,16,7,3,62,31,31,55
Coleraine,2642,2,15,10,1,47,23,24,55
Linfield,2642,3,11,5,10,40,37,3,38
Glenavon,2642,4,9,9,8,53,47,6,36
Cliftonville,2642,5,9,4,13,33,34,-1,31
Ballymena,2642,6,7,5,14,26,48,-22,26
Glentoran,2642,7,6,6,10,24,32,-8,24
Dungannon,2642,8,2,4,16,14,47,-33,10
Crusaders,2643,1,17,6,3,62,30,32,57
Coleraine,2643,2,15,10,1,45,22,23,55
Glenavon,2643,3,9,9,8,52,45,7,36
Linfield,2643,4,10,5,11,38,38,0,35
Cliftonville,2643,5,10,4,12,34,32,2,34
Ballymena,2643,6,7,4,15,25,48,-23,25
Glentoran,2643,7,6,6,10,24,32,-8,24
Dungannon,2643,8,2,4,16,14,47,-33,10
Crusaders,2644,1,16,6,4,61,32,29,54
Coleraine,2644,2,14,10,2,44,24,20,52
Glenavon,2644,3,10,9,7,54,44,10,39
Linfield,2644,4,10,6,10,39,38,1,36
Cliftonville,2644,5,9,5,12,34,33,1,32
Ballymena,2644,6,8,4,14,27,47,-20,28
Glentoran,2644,7,6,6,10,24,32,-8,24
Dungannon,2644,8,2,4,16,14,47,-33,10
Crusaders,2645,1,17,6,3,65,31,34,57
Coleraine,2645,2,14,11,1,43,22,21,53
Linfield,2645,3,11,5,10,40,36,4,38
Glenavon,2645,4,9,10,7,52,43,9,37
Cliftonville,2645,5,9,4,13,32,34,-2,31
Ballymena,2645,6,7,4,15,26,51,-25,25
Glentoran,2645,7,6,6,10,24,32,-8,24
Dungannon,2645,8,2,4,16,14,47,-33,10
Crusaders,2646,1,17,6,3,63,31,32,57
Coleraine,2646,2,14,11,1,44,23,21,53
Linfield,2646,3,11,5,10,39,37,2,38
Glenavon,2646,4,9,10,7,53,44,9,37
Cliftonville,2646,5,9,4,13,33,33,0,31
Ballymena,2646,6,7,4,15,26,49,-23,25
Glentoran,2646,7,6,6,10,24,32,-8,24
Dungannon,2646,8,2,4,16,14,47,-33,10
Crusaders,2647,1,16,7,3,63,32,31,55
Coleraine,2647,2,14,10,2,43,23,20,52
Glenavon,2647,3,10,9,7,53,43,10,39
Linfield,2647,4,10,5,11,38,38,0,35
Cliftonville,2647,5,10,4,12,34,32,2,34
Ballymena,2647,6,7,5,14,27,49,-22,26
Glentoran,2647,7,6,6,10,24,32,-8,24
Dungannon,2647,8,2,4,16,14,47,-33,10
Crusaders,2648,1,16,7,3,62,31,31,55
Coleraine,2648,2,14,10,2,43,23,20,52
Glenavon,2648,3,10,9,7,53,43,10,39
Linfield,2648,4,11,5,10,39,37,2,38
Cliftonville,2648,5,9,4,13,33,33,0,31
Ballymena,2648,6,7,5,14,26,48,-22,26
Glentoran,2648,7,6,6,10,24,32,-8,24
Dungannon,2648,8,2,4,16,14,47,-33,10
Crusaders,2649,1,17,6,3,65,31,34,57
Coleraine,2649,2,14,10,2,43,23,20,52
Glenavon,2649,3,10,9,7,53,43,10,39
Linfield,2649,4,11,5,10,41,37,4,38
Cliftonville,2649,5,9,4,13,33,35,-2,31
Ballymena,2649,6,7,4,15,26,51,-25,25
Glentoran,2649,7,6,6,10,24,32,-8,24
Dungannon,2649,8,2,4,16,14,47,-33,10
Crusaders,2650,1,16,6,4,63,33,30,54
Coleraine,2650,2,14,10,2,43,23,20,52
Glenavon,2650,3,10,9,7,53,43,10,39
Linfield,2650,4,10,5,11,38,38,0,35
Cliftonville,2650,5,10,4,12,34,32,2,34
Ballymena,2650,6,8,4,14,28,49,-21,28
Glentoran,2650,7,6,6,10,24,32,-8,24
Dungannon,2650,8,2,4,16,14,47,-33,10
Crusaders,2651,1,17,6,3,66,34,32,57
Coleraine,2651,2,15,10,1,45,23,22,55
Linfield,2651,3,11,5,10,43,37,6,38
Glenavon,2651,4,9,9,8,53,45,8,36
Cliftonville,2651,5,9,4,13,33,37,-4,31
Ballymena,2651,6,7,4,15,29,52,-23,25
Glentoran,2651,7,6,6,10,24,32,-8,24
Dungannon,2651,8,2,4,16,14,47,-33,10
Crusaders,2652,1,16,6,4,63,33,30,54
Coleraine,2652,2,14,10,2,45,26,19,52
Glenavon,2652,3,10,9,7,56,45,11,39
Linfield,2652,4,11,5,10,38,36,2,38
Cliftonville,2652,5,9,4,13,32,32,0,31
Ballymena,2652,6,8,4,14,28,49,-21,28
Glentoran,2652,7,6,6,10,24,32,-8,24
Dungannon,2652,8,2,4,16,14,47,-33,10
Crusaders,2653,1,17,6,3,64,30,34,57
Coleraine,2653,2,14,11,1,45,24,21,53
Glenavon,2653,3,9,10,7,54,45,9,37
Linfield,2653,4,10,5,11,37,38,-1,35
Cliftonville,2653,5,10,4,12,34,31,3,34
Ballymena,2653,6,7,4,15,25,50,-25,25
Glentoran,2653,7,6,6,10,24,32,-8,24
Dungannon,2653,8,2,4,16,14,47,-33,10
Crusaders,2654,1,17,6,3,63,30,33,57
Coleraine,2654,2,14,11,1,44,23,21,53
Glenavon,2654,3,9,10,7,53,44,9,37
Linfield,2654,4,10,6,10,39,38,1,36
Cliftonville,2654,5,9,5,12,34,33,1,32
Ballymena,2654,6,7,4,15,25,49,-24,25
Glentoran,2654,7,6,6,10,24,32,-8,24
Dungannon,2654,8,2,4,16,14,47,-33,10
Crusaders,2655,1,16,7,3,62,31,31,55
Coleraine,2655,2,14,11,1,45,24,21,53
Linfield,2655,3,11,5,10,38,36,2,38
Glenavon,2655,4,9,10,7,54,45,9,37
Cliftonville,2655,5,9,4,13,32,32,0,31
Ballymena,2655,6,7,5,14,26,48,-22,26
Glentoran,2655,7,6,6,10,24,32,-8,24
Dungannon,2655,8,2,4,16,14,47,-33,10
Crusaders,2656,1,16,7,3,61,30,31,55
Coleraine,2656,2,14,11,1,44,23,21,53
Glenavon,2656,3,9,10,7,53,44,9,37
Linfield,2656,4,10,5,11,38,40,-2,35
Cliftonville,2656,5,10,4,12,36,32,4,34
Ballymena,2656,6,7,5,14,25,47,-22,26
Glentoran,2656,7,6,6,10,24,32,-8,24
Dungannon,2656,8,2,4,16,14,47,-33,10
Crusaders,2657,1,16,7,3,63,32,31,55
Coleraine,2657,2,15,10,1,46,24,22,55
Linfield,2657,3,11,5,10,39,36,3,38
Glenavon,2657,4,9,9,8,54,46,8,36
Cliftonville,2657,5,9,4,13,32,33,-1,31
Ballymena,2657,6,7,5,14,27,49,-22,26
Glentoran,2657,7,6,6,10,24,32,-8,24
Dungannon,2657,8,2,4,16,14,47,-33,10
Crusaders,2658,1,17,6,3,65,32,33,57
Coleraine,2658,2,15,10,1,45,23,22,55
Glenavon,2658,3,9,9,8,53,45,8,36
Linfield,2658,4,10,5,11,38,38,0,35
Cliftonville,2658,5,10,4,12,34,32,2,34
Ballymena,2658,6,7,4,15,27,51,-24,25
Glentoran,2658,7,6,6,10,24,32,-8,24
Dungannon,2658,8,2,4,16,14,47,-33,10
Crusaders,2659,1,16,7,3,64,33,31,55
Coleraine,2659,2,14,10,2,44,26,18,52
Glenavon,2659,3,10,9,7,56,44,12,39
Linfield,2659,4,10,6,10,38,37,1,36
Cliftonville,2659,5,9,5,12,33,32,1,32
Ballymena,2659,6,7,5,14,28,50,-22,26
Glentoran,2659,7,6,6,10,24,32,-8,24
Dungannon,2659,8,2,4,16,14,47,-33,10
Crusaders,2660,1,17,6,3,63,30,33,57
Coleraine,2660,2,14,10,2,43,26,17,52
Glenavon,2660,3,10,9,7,56,43,13,39
Linfield,2660,4,10,6,10,39,38,1,36
Cliftonville,2660,5,9,5,12,34,33,1,32
Ballymena,2660,6,7,4,15,25,49,-24,25
Glentoran,2660,7,6,6,10,24,32,-8,24
Dungannon,2660,8,2,4,16,14,47,-33,10
Crusaders,2661,1,16,7,3,63,32,31,55
Coleraine,2661,2,15,10,1,45,23,22,55
Glenavon,2661,3,9,9,8,53,45,8,36
Linfield,2661,4,10,6,10,38,37,1,36
Cliftonville,2661,5,9,5,12,33,32,1,32
Ballymena,2661,6,7,5,14,27,49,-22,26
Glentoran,2661,7,6,6,10,24,32,-8,24
Dungannon,2661,8,2,4,16,14,47,-33,10
Crusaders,2662,1,17,6,3,65,32,33,57
Coleraine,2662,2,14,10,2,44,26,18,52
Glenavon,2662,3,10,9,7,56,44,12,39
Linfield,2662,4,11,5,10,39,37,2,38
Cliftonville,2662,5,9,4,13,33,33,0,31
Ballymena,2662,6,7,4,15,27,51,-24,25
Glentoran,2662,7,6,6,10,24,32,-8,24
Dungannon,2662,8,2,4,16,14,47,-33,10
Crusaders,2663,1,17,6,3,62,30,32,57
Coleraine,2663,2,14,10,2,44,25,19,52
Glenavon,2663,3,10,9,7,55,44,11,39
Linfield,2663,4,11,5,10,40,36,4,38
Cliftonville,2663,5,9,4,13,32,34,-2,31
Ballymena,2663,6,7,4,15,25,48,-23,25
Glentoran,2663,7,6,6,10,24,32,-8,24
Dungannon,2663,8,2,4,16,14,47,-33,10
Crusaders,2664,1,17,6,3,62,30,32,57
Coleraine,2664,2,14,10,2,43,23,20,52
Glenavon,2664,3,10,9,7,53,43,10,39
Linfield,2664,4,11,5,10,38,36,2,38
Cliftonville,2664,5,9,4,13,32,32,0,31
Ballymena,2664,6,7,4,15,25,48,-23,25
Glentoran,2664,7,6,6,10,24,32,-8,24
Dungannon,2664,8,2,4,16,14,47,-33,10
Crusaders,2665,1,16,6,4,62,32,30,54
Coleraine,2665,2,14,11,1,45,24,21,53
Glenavon,2665,3,9,10,7,54,45,9,37
Linfield,2665,4,10,6,10,39,38,1,36
Cliftonville,2665,5,9,5,12,34,33,1,32
Ballymena,2665,6,8,4,14,27,48,-21,28
Glentoran,2665,7,6,6,10,24,32,-8,24
Dungannon,2665,8,2,4,16,14,47,-33,10
Coleraine,2666,1,15,10,1,46,23,23,55
Crusaders,2666,2,16,6,4,62,32,30,54
Glenavon,2666,3,9,9,8,53,46,7,36
Linfield,2666,4,10,6,10,37,36,1,36
Cliftonville,2666,5,9,5,12,32,31,1,32
Ballymena,2666,6,8,4,14,27,48,-21,28
Glentoran,2666,7,6,6,10,24,32,-8,24
Dungannon,2666,8,2,4,16,14,47,-33,10
Crusaders,2667,1,16,6,4,63,33,30,54
Coleraine,2667,2,14,10,2,43,25,18,52
Glenavon,2667,3,10,9,7,55,43,12,39
Linfield,2667,4,10,5,11,39,39,0,35
Cliftonville,2667,5,10,4,12,35,33,2,34
Ballymena,2667,6,8,4,14,28,49,-21,28
Glentoran,2667,7,6,6,10,24,32,-8,24
Dungannon,2667,8,2,4,16,14,47,-33,10
Crusaders,2668,1,16,6,4,61,32,29,54
Coleraine,2668,2,14,10,2,43,23,20,52
Glenavon,2668,3,10,9,7,53,43,10,39
Linfield,2668,4,10,5,11,38,39,-1,35
Cliftonville,2668,5,10,4,12,35,32,3,34
Ballymena,2668,6,8,4,14,27,47,-20,28
Glentoran,2668,7,6,6,10,24,32,-8,24
Dungannon,2668,8,2,4,16,14,47,-33,10
Crusaders,2669,1,17,6,3,65,30,35,57
Coleraine,2669,2,14,11,1,44,23,21,53
Linfield,2669,3,11,5,10,41,37,4,38
Glenavon,2669,4,9,10,7,53,44,9,37
Cliftonville,2669,5,9,4,13,33,35,-2,31
Ballymena,2669,6,7,4,15,25,51,-26,25
Glentoran,2669,7,6,6,10,24,32,-8,24
Dungannon,2669,8,2,4,16,14,47,-33,10
Crusaders,2670,1,17,6,3,64,31,33,57
Coleraine,2670,2,14,10,2,43,25,18,52
Glenavon,2670,3,10,9,7,55,43,12,39
Linfield,2670,4,10,6,10,39,38,1,36
Cliftonville,2670,5,9,5,12,34,33,1,32
Ballymena,2670,6,7,4,15,26,50,-24,25
Glentoran,2670,7,6,6,10,24,32,-8,24
Dungannon,2670,8,2,4,16,14,47,-33,10
Crusaders,2671,1,17,6,3,64,30,34,57
Coleraine,2671,2,14,10,2,45,25,20,52
Glenavon,2671,3,10,9,7,55,45,10,39
Linfield,2671,4,10,5,11,38,39,-1,35
Cliftonville,2671,5,10,4,12,35,32,3,34
Ballymena,2671,6,7,4,15,25,50,-25,25
Glentoran,2671,7,6,6,10,24,32,-8,24
Dungannon,2671,8,2,4,16,14,47,-33,10
Crusaders,2672,1,16,7,3,62,31,31,55
Coleraine,2672,2,14,11,1,44,23,21,53
Linfield,2672,3,11,5,10,39,37,2,38
Glenavon,2672,4,9,10,7,53,44,9,37
Cliftonville,2672,5,9,4,13,33,33,0,31
Ballymena,2672,6,7,5,14,26,48,-22,26
Glentoran,2672,7,6,6,10,24,32,-8,24
Dungannon,2672,8,2,4,16,14,47,-33,10
Crusaders,2673,1,17,6,3,67,32,35,57
Coleraine,2673,2,15,10,1,46,23,23,55
Glenavon,2673,3,9,9,8,53,46,7,36
Linfield,2673,4,10,5,11,37,38,-1,35
Cliftonville,2673,5,10,4,12,34,31,3,34
Ballymena,2673,6,7,4,15,27,53,-26,25
Glentoran,2673,7,6,6,10,24,32,-8,24
Dungannon,2673,8,2,4,16,14,47,-33,10
Crusaders,2674,1,17,6,3,64,31,33,57
Coleraine,2674,2,14,11,1,44,23,21,53
Glenavon,2674,3,9,10,7,53,44,9,37
Linfield,2674,4,10,6,10,38,37,1,36
Cliftonville,2674,5,9,5,12,33,32,1,32
Ballymena,2674,6,7,4,15,26,50,-24,25
Glentoran,2674,7,6,6,10,24,32,-8,24
Dungannon,2674,8,2,4,16,14,47,-33,10
Crusaders,2675,1,17,6,3,62,30,32,57
Coleraine,2675,2,15,10,1,45,23,22,55
Linfield,2675,3,11,5,10,38,36,2,38
Glenavon,2675,4,9,9,8,53,45,8,36
Cliftonville,2675,5,9,4,13,32,32,0,31
Ballymena,2675,6,7,4,15,25,48,-23,25
Glentoran,2675,7,6,6,10,24,32,-8,24
Dungannon,2675,8,2,4,16,14,47,-33,10
Crusaders,2676,1,16,6,4,62,32,30,54
Coleraine,2676,2,14,10,2,47,31,16,52
Glenavon,2676,3,10,9,7,61,47,14,39
Linfield,2676,4,10,5,11,37,37,0,35
Cliftonville,2676,5,10,4,12,33,31,2,34
Ballymena,2676,6,8,4,14,27,48,-21,28
Glentoran,2676,7,6,6,10,24,32,-8,24
Dungannon,2676,8,2,4,16,14,47,-33,10
Crusaders,2677,1,16,6,4,62,34,28,54
Coleraine,2677,2,14,11,1,45,24,21,53
Glenavon,2677,3,9,10,7,54,45,9,37
Linfield,2677,4,10,6,10,38,37,1,36
Cliftonville,2677,5,9,5,12,33,32,1,32
Ballymena,2677,6,8,4,14,29,48,-19,28
Glentoran,2677,7,6,6,10,24,32,-8,24
Dungannon,2677,8,2,4,16,14,47,-33,10
Crusaders,2678,1,17,6,3,64,30,34,57
Coleraine,2678,2,14,10,2,43,24,19,52
Glenavon,2678,3,10,9,7,54,43,11,39
Linfield,2678,4,10,5,11,37,38,-1,35
Cliftonville,2678,5,10,4,12,34,31,3,34
Ballymena,2678,6,7,4,15,25,50,-25,25
Glentoran,2678,7,6,6,10,24,32,-8,24
Dungannon,2678,8,2,4,16,14,47,-33,10
Crusaders,2679,1,17,6,3,62,30,32,57
Coleraine,2679,2,15,10,1,47,23,24,55
Linfield,2679,3,11,5,10,39,37,2,38
Glenavon,2679,4,9,9,8,53,47,6,36
Cliftonville,2679,5,9,4,13,33,33,0,31
Ballymena,2679,6,7,4,15,25,48,-23,25
Glentoran,2679,7,6,6,10,24,32,-8,24
Dungannon,2679,8,2,4,16,14,47,-33,10
Crusaders,2680,1,16,6,4,61,31,30,54
Coleraine,2680,2,14,10,2,44,24,20,52
Glenavon,2680,3,10,9,7,54,44,10,39
Linfield,2680,4,10,5,11,37,37,0,35
Cliftonville,2680,5,10,4,12,33,31,2,34
Ballymena,2680,6,8,4,14,26,47,-21,28
Glentoran,2680,7,6,6,10,24,32,-8,24
Dungannon,2680,8,2,4,16,14,47,-33,10
Crusaders,2681,1,17,6,3,64,32,32,57
Coleraine,2681,2,15,10,1,46,24,22,55
Linfield,2681,3,11,5,10,41,37,4,38
Glenavon,2681,4,9,9,8,54,46,8,36
Cliftonville,2681,5,9,4,13,33,35,-2,31
Ballymena,2681,6,7,4,15,27,50,-23,25
Glentoran,2681,7,6,6,10,24,32,-8,24
Dungannon,2681,8,2,4,16,14,47,-33,10
Crusaders,2682,1,16,7,3,62,31,31,55
Coleraine,2682,2,14,11,1,43,22,21,53
Glenavon,2682,3,9,10,7,52,43,9,37
Linfield,2682,4,10,6,10,37,36,1,36
Cliftonville,2682,5,9,5,12,32,31,1,32
Ballymena,2682,6,7,5,14,26,48,-22,26
Glentoran,2682,7,6,6,10,24,32,-8,24
Dungannon,2682,8,2,4,16,14,47,-33,10
Crusaders,2683,1,17,6,3,63,31,32,57
Coleraine,2683,2,14,10,2,44,25,19,52
Glenavon,2683,3,10,9,7,55,44,11,39
Linfield,2683,4,10,6,10,37,36,1,36
Cliftonville,2683,5,9,5,12,32,31,1,32
Ballymena,2683,6,7,4,15,26,49,-23,25
Glentoran,2683,7,6,6,10,24,32,-8,24
Dungannon,2683,8,2,4,16,14,47,-33,10
Crusaders,2684,1,16,7,3,61,30,31,55
Coleraine,2684,2,14,10,2,43,23,20,52
Glenavon,2684,3,10,9,7,53,43,10,39
Linfield,2684,4,10,5,11,39,39,0,35
Cliftonville,2684,5,10,4,12,35,33,2,34
Ballymena,2684,6,7,5,14,25,47,-22,26
Glentoran,2684,7,6,6,10,24,32,-8,24
Dungannon,2684,8,2,4,16,14,47,-33,10
Crusaders,2685,1,17,6,3,62,30,32,57
Coleraine,2685,2,14,10,2,43,23,20,52
Glenavon,2685,3,10,9,7,53,43,10,39
Linfield,2685,4,11,5,10,38,36,2,38
Cliftonville,2685,5,9,4,13,32,32,0,31
Ballymena,2685,6,7,4,15,25,48,-23,25
Glentoran,2685,7,6,6,10,24,32,-8,24
Dungannon,2685,8,2,4,16,14,47,-33,10
Coleraine,2686,1,15,10,1,48,22,26,55
Crusaders,2686,2,16,6,4,61,31,30,54
Linfield,2686,3,11,5,10,38,36,2,38
Glenavon,2686,4,9,9,8,52,48,4,36
Cliftonville,2686,5,9,4,13,32,32,0,31
Ballymena,2686,6,8,4,14,26,47,-21,28
Glentoran,2686,7,6,6,10,24,32,-8,24
Dungannon,2686,8,2,4,16,14,47,-33,10
Crusaders,2687,1,17,6,3,64,32,32,57
Coleraine,2687,2,14,11,1,45,24,21,53
Glenavon,2687,3,9,10,7,54,45,9,37
Linfield,2687,4,10,5,11,38,38,0,35
Cliftonville,2687,5,10,4,12,34,32,2,34
Ballymena,2687,6,7,4,15,27,50,-23,25
Glentoran,2687,7,6,6,10,24,32,-8,24
Dungannon,2687,8,2,4,16,14,47,-33,10
Crusaders,2688,1,17,6,3,66,31,35,57
Coleraine,2688,2,14,10,2,43,23,20,52
Glenavon,2688,3,10,9,7,53,43,10,39
Linfield,2688,4,10,6,10,39,38,1,36
Cliftonville,2688,5,9,5,12,34,33,1,32
Ballymena,2688,6,7,4,15,26,52,-26,25
Glentoran,2688,7,6,6,10,24,32,-8,24
Dungannon,2688,8,2,4,16,14,47,-33,10
Crusaders,2689,1,17,6,3,63,31,32,57
Coleraine,2689,2,14,10,2,43,24,19,52
Glenavon,2689,3,10,9,7,54,43,11,39
Linfield,2689,4,11,5,10,39,37,2,38
Cliftonville,2689,5,9,4,13,33,33,0,31
Ballymena,2689,6,7,4,15,26,49,-23,25
Glentoran,2689,7,6,6,10,24,32,-8,24
Dungannon,2689,8,2,4,16,14,47,-33,10
Crusaders,2690,1,17,6,3,63,31,32,57
Coleraine,2690,2,15,10,1,46,24,22,55
Glenavon,2690,3,9,9,8,54,46,8,36
Linfield,2690,4,10,5,11,37,38,-1,35
Cliftonville,2690,5,10,4,12,34,31,3,34
Ballymena,2690,6,7,4,15,26,49,-23,25
Glentoran,2690,7,6,6,10,24,32,-8,24
Dungannon,2690,8,2,4,16,14,47,-33,10
Crusaders,2691,1,17,6,3,62,30,32,57
Coleraine,2691,2,15,10,1,45,23,22,55
Glenavon,2691,3,9,9,8,53,45,8,36
Linfield,2691,4,10,5,11,38,38,0,35
Cliftonville,2691,5,10,4,12,34,32,2,34
Ballymena,2691,6,7,4,15,25,48,-23,25
Glentoran,2691,7,6,6,10,24,32,-8,24
Dungannon,2691,8,2,4,16,14,47,-33,10
Crusaders,2692,1,17,6,3,64,30,34,57
Coleraine,2692,2,14,10,2,43,24,19,52
Glenavon,2692,3,10,9,7,54,43,11,39
Linfield,2692,4,11,5,10,39,37,2,38
Cliftonville,2692,5,9,4,13,33,33,0,31
Ballymena,2692,6,7,4,15,25,50,-25,25
Glentoran,2692,7,6,6,10,24,32,-8,24
Dungannon,2692,8,2,4,16,14,47,-33,10
Crusaders,2693,1,17,6,3,62,30,32,57
Coleraine,2693,2,15,10,1,46,23,23,55
Linfield,2693,3,11,5,10,39,36,3,38
Glenavon,2693,4,9,9,8,53,46,7,36
Cliftonville,2693,5,9,4,13,32,33,-1,31
Ballymena,2693,6,7,4,15,25,48,-23,25
Glentoran,2693,7,6,6,10,24,32,-8,24
Dungannon,2693,8,2,4,16,14,47,-33,10
Crusaders,2694,1,17,6,3,63,31,32,57
Coleraine,2694,2,14,10,2,43,26,17,52
Glenavon,2694,3,10,9,7,56,43,13,39
Linfield,2694,4,11,5,10,40,38,2,38
Cliftonville,2694,5,9,4,13,34,34,0,31
Ballymena,2694,6,7,4,15,26,49,-23,25
Glentoran,2694,7,6,6,10,24,32,-8,24
Dungannon,2694,8,2,4,16,14,47,-33,10
Crusaders,2695,1,17,6,3,63,31,32,57
Coleraine,2695,2,14,10,2,44,27,17,52
Glenavon,2695,3,10,9,7,57,44,13,39
Linfield,2695,4,10,5,11,37,38,-1,35
Cliftonville,2695,5,10,4,12,34,31,3,34
Ballymena,2695,6,7,4,15,26,49,-23,25
Glentoran,2695,7,6,6,10,24,32,-8,24
Dungannon,2695,8,2,4,16,14,47,-33,10
Coleraine,2696,1,15,10,1,48,23,25,55
Crusaders,2696,2,16,6,4,62,33,29,54
Glenavon,2696,3,9,9,8,53,48,5,36
Linfield,2696,4,10,6,10,38,37,1,36
Cliftonville,2696,5,9,5,12,33,32,1,32
Ballymena,2696,6,8,4,14,28,48,-20,28
Glentoran,2696,7,6,6,10,24,32,-8,24
Dungannon,2696,8,2,4,16,14,47,-33,10
Crusaders,2697,1,17,6,3,63,31,32,57
Coleraine,2697,2,15,10,1,45,23,22,55
Glenavon,2697,3,9,9,8,53,45,8,36
Linfield,2697,4,10,6,10,38,37,1,36
Cliftonville,2697,5,9,5,12,33,32,1,32
Ballymena,2697,6,7,4,15,26,49,-23,25
Glentoran,2697,7,6,6,10,24,32,-8,24
Dungannon,2697,8,2,4,16,14,47,-33,10
Crusaders,2698,1,17,6,3,63,31,32,57
Coleraine,2698,2,14,10,2,44,25,19,52
Glenavon,2698,3,10,9,7,55,44,11,39
Linfield,2698,4,11,5,10,39,36,3,38
Cliftonville,2698,5,9,4,13,32,33,-1,31
Ballymena,2698,6,7,4,15,26,49,-23,25
Glentoran,2698,7,6,6,10,24,32,-8,24
Dungannon,2698,8,2,4,16,14,47,-33,10
Crusaders,2699,1,17,6,3,65,30,35,57
Coleraine,2699,2,15,10,1,45,23,22,55
Linfield,2699,3,11,5,10,38,36,2,38
Glenavon,2699,4,9,9,8,53,45,8,36
Cliftonville,2699,5,9,4,13,32,32,0,31
Ballymena,2699,6,7,4,15,25,51,-26,25
Glentoran,2699,7,6,6,10,24,32,-8,24
Dungannon,2699,8,2,4,16,14,47,-33,10
Crusaders,2700,1,17,6,3,63,31,32,57
Coleraine,2700,2,14,11,1,45,24,21,53
Glenavon,2700,3,9,10,7,54,45,9,37
Linfield,2700,4,10,5,11,37,37,0,35
Cliftonville,2700,5,10,4,12,33,31,2,34
Ballymena,2700,6,7,4,15,26,49,-23,25
Glentoran,2700,7,6,6,10,24,32,-8,24
Dungannon,2700,8,2,4,16,14,47,-33,10
Crusaders,2701,1,17,6,3,63,30,33,57
Coleraine,2701,2,14,10,2,44,24,20,52
Glenavon,2701,3,10,9,7,54,44,10,39
Linfield,2701,4,11,5,10,38,36,2,38
Cliftonville,2701,5,9,4,13,32,32,0,31
Ballymena,2701,6,7,4,15,25,49,-24,25
Glentoran,2701,7,6,6,10,24,32,-8,24
Dungannon,2701,8,2,4,16,14,47,-33,10
Crusaders,2702,1,16,6,4,62,32,30,54
Coleraine,2702,2,14,10,2,44,25,19,52
Glenavon,2702,3,10,9,7,55,44,11,39
Linfield,2702,4,10,5,11,37,37,0,35
Cliftonville,2702,5,10,4,12,33,31,2,34
Ballymena,2702,6,8,4,14,27,48,-21,28
Glentoran,2702,7,6,6,10,24,32,-8,24
Dungannon,2702,8,2,4,16,14,47,-33,10
Crusaders,2703,1,17,6,3,66,30,36,57
Coleraine,2703,2,14,10,2,44,24,20,52
Glenavon,2703,3,10,9,7,54,44,10,39
Linfield,2703,4,11,5,10,39,36,3,38
Cliftonville,2703,5,9,4,13,32,33,-1,31
Ballymena,2703,6,7,4,15,25,52,-27,25
Glentoran,2703,7,6,6,10,24,32,-8,24
Dungannon,2703,8,2,4,16,14,47,-33,10
Crusaders,2704,1,16,7,3,62,31,31,55
Coleraine,2704,2,15,10,1,48,24,24,55
Glenavon,2704,3,9,9,8,54,48,6,36
Linfield,2704,4,10,5,11,37,37,0,35
Cliftonville,2704,5,10,4,12,33,31,2,34
Ballymena,2704,6,7,5,14,26,48,-22,26
Glentoran,2704,7,6,6,10,24,32,-8,24
Dungannon,2704,8,2,4,16,14,47,-33,10
Crusaders,2705,1,17,6,3,65,30,35,57
Coleraine,2705,2,15,10,1,45,22,23,55
Linfield,2705,3,11,5,10,39,37,2,38
Glenavon,2705,4,9,9,8,52,45,7,36
Cliftonville,2705,5,9,4,13,33,33,0,31
Ballymena,2705,6,7,4,15,25,51,-26,25
Glentoran,2705,7,6,6,10,24,32,-8,24
Dungannon,2705,8,2,4,16,14,47,-33,10
Coleraine,2706,1,15,10,1,45,22,23,55
Crusaders,2706,2,16,6,4,61,31,30,54
Glenavon,2706,3,9,9,8,52,45,7,36
Linfield,2706,4,10,6,10,39,38,1,36
Cliftonville,2706,5,9,5,12,34,33,1,32
Ballymena,2706,6,8,4,14,26,47,-21,28
Glentoran,2706,7,6,6,10,24,32,-8,24
Dungannon,2706,8,2,4,16,14,47,-33,10
Crusaders,2707,1,17,6,3,64,30,34,57
Coleraine,2707,2,15,10,1,46,24,22,55
Linfield,2707,3,11,5,10,41,36,5,38
Glenavon,2707,4,9,9,8,54,46,8,36
Cliftonville,2707,5,9,4,13,32,35,-3,31
Ballymena,2707,6,7,4,15,25,50,-25,25
Glentoran,2707,7,6,6,10,24,32,-8,24
Dungannon,2707,8,2,4,16,14,47,-33,10
Crusaders,2708,1,16,7,3,62,31,31,55
Coleraine,2708,2,14,11,1,44,23,21,53
Linfield,2708,3,11,5,10,38,36,2,38
Glenavon,2708,4,9,10,7,53,44,9,37
Cliftonville,2708,5,9,4,13,32,32,0,31
Ballymena,2708,6,7,5,14,26,48,-22,26
Glentoran,2708,7,6,6,10,24,32,-8,24
Dungannon,2708,8,2,4,16,14,47,-33,10
Crusaders,2709,1,16,6,4,62,32,30,54
Coleraine,2709,2,14,10,2,44,24,20,52
Glenavon,2709,3,10,9,7,54,44,10,39
Linfield,2709,4,10,5,11,37,37,0,35
Cliftonville,2709,5,10,4,12,33,31,2,34
Ballymena,2709,6,8,4,14,27,48,-21,28
Glentoran,2709,7,6,6,10,24,32,-8,24
Dungannon,2709,8,2,4,16,14,47,-33,10
Crusaders,2710,1,16,6,4,63,34,29,54
Coleraine,2710,2,14,10,2,44,24,20,52
Glenavon,2710,3,10,9,7,54,44,10,39
Linfield,2710,4,11,5,10,40,36,4,38
Cliftonville,2710,5,9,4,13,32,34,-2,31
Ballymena,2710,6,8,4,14,29,49,-20,28
Glentoran,2710,7,6,6,10,24,32,-8,24
Dungannon,2710,8,2,4,16,14,47,-33,10
Coleraine,2711,1,15,10,1,44,22,22,55
Crusaders,2711,2,16,6,4,62,33,29,54
Glenavon,2711,3,9,9,8,52,44,8,36
Linfield,2711,4,10,5,11,37,37,0,35
Cliftonville,2711,5,10,4,12,33,31,2,34
Ballymena,2711,6,8,4,14,28,48,-20,28
Glentoran,2711,7,6,6,10,24,32,-8,24
Dungannon,2711,8,2,4,16,14,47,-33,10
Crusaders,2712,1,17,6,3,64,30,34,57
Coleraine,2712,2,14,11,1,44,23,21,53
Linfield,2712,3,11,5,10,38,36,2,38
Glenavon,2712,4,9,10,7,53,44,9,37
Cliftonville,2712,5,9,4,13,32,32,0,31
Ballymena,2712,6,7,4,15,25,50,-25,25
Glentoran,2712,7,6,6,10,24,32,-8,24
Dungannon,2712,8,2,4,16,14,47,-33,10
Crusaders,2713,1,16,6,4,62,32,30,54
Coleraine,2713,2,14,10,2,45,25,20,52
Glenavon,2713,3,10,9,7,55,45,10,39
Linfield,2713,4,11,5,10,40,37,3,38
Cliftonville,2713,5,9,4,13,33,34,-1,31
Ballymena,2713,6,8,4,14,27,48,-21,28
Glentoran,2713,7,6,6,10,24,32,-8,24
Dungannon,2713,8,2,4,16,14,47,-33,10
Crusaders,2714,1,16,6,4,64,34,30,54
Coleraine,2714,2,14,10,2,45,28,17,52
Glenavon,2714,3,10,9,7,58,45,13,39
Linfield,2714,4,11,5,10,41,36,5,38
Cliftonville,2714,5,9,4,13,32,35,-3,31
Ballymena,2714,6,8,4,14,29,50,-21,28
Glentoran,2714,7,6,6,10,24,32,-8,24
Dungannon,2714,8,2,4,16,14,47,-33,10
Crusaders,2715,1,17,6,3,65,31,34,57
Coleraine,2715,2,14,10,2,43,25,18,52
Glenavon,2715,3,10,9,7,55,43,12,39
Linfield,2715,4,11,5,10,39,37,2,38
Cliftonville,2715,5,9,4,13,33,33,0,31
Ballymena,2715,6,7,4,15,26,51,-25,25
Glentoran,2715,7,6,6,10,24,32,-8,24
Dungannon,2715,8,2,4,16,14,47,-33,10
Crusaders,2716,1,17,6,3,64,30,34,57
Coleraine,2716,2,14,10,2,44,25,19,52
Glenavon,2716,3,10,9,7,55,44,11,39
Linfield,2716,4,10,5,11,37,37,0,35
Cliftonville,2716,5,10,4,12,33,31,2,34
Ballymena,2716,6,7,4,15,25,50,-25,25
Glentoran,2716,7,6,6,10,24,32,-8,24
Dungannon,2716,8,2,4,16,14,47,-33,10
Crusaders,2717,1,16,6,4,61,32,29,54
Coleraine,2717,2,14,10,2,44,25,19,52
Glenavon,2717,3,10,9,7,55,44,11,39
Linfield,2717,4,11,5,10,38,36,2,38
Cliftonville,2717,5,9,4,13,32,32,0,31
Ballymena,2717,6,8,4,14,27,47,-20,28
Glentoran,2717,7,6,6,10,24,32,-8,24
Dungannon,2717,8,2,4,16,14,47,-33,10
Crusaders,2718,1,17,6,3,67,31,36,57
Coleraine,2718,2,14,10,2,44,25,19,52
Glenavon,2718,3,10,9,7,55,44,11,39
Linfield,2718,4,11,5,10,38,36,2,38
Cliftonville,2718,5,9,4,13,32,32,0,31
Ballymena,2718,6,7,4,15,26,53,-27,25
Glentoran,2718,7,6,6,10,24,32,-8,24
Dungannon,2718,8,2,4,16,14,47,-33,10
Crusaders,2719,1,16,7,3,62,31,31,55
Coleraine,2719,2,14,10,2,44,25,19,52
Glenavon,2719,3,10,9,7,55,44,11,39
Linfield,2719,4,11,5,10,38,36,2,38
Cliftonville,2719,5,9,4,13,32,32,0,31
Ballymena,2719,6,7,5,14,26,48,-22,26
Glentoran,2719,7,6,6,10,24,32,-8,24
Dungannon,2719,8,2,4,16,14,47,-33,10
Crusaders,2720,1,17,6,3,64,30,34,57
Coleraine,2720,2,14,10,2,44,24,20,52
Glenavon,2720,3,10,9,7,54,44,10,39
Linfield,2720,4,10,6,10,38,37,1,36
Cliftonville,2720,5,9,5,12,33,32,1,32
Ballymena,2720,6,7,4,15,25,50,-25,25
Glentoran,2720,7,6,6,10,24,32,-8,24
Dungannon,2720,8,2,4,16,14,47,-33,10
Crusaders,2721,1,17,6,3,62,30,32,57
Coleraine,2721,2,15,10,1,44,22,22,55
Glenavon,2721,3,9,9,8,52,44,8,36
Linfield,2721,4,10,6,10,37,36,1,36
Cliftonville,2721,5,9,5,12,32,31,1,32
Ballymena,2721,6,7,4,15,25,48,-23,25
Glentoran,2721,7,6,6,10,24,32,-8,24
Dungannon,2721,8,2,4,16,14,47,-33,10
Crusaders,2722,1,16,7,3,62,31,31,55
Coleraine,2722,2,14,10,2,45,26,19,52
Glenavon,2722,3,10,9,7,56,45,11,39
Linfield,2722,4,10,6,10,38,37,1,36
Cliftonville,2722,5,9,5,12,33,32,1,32
Ballymena,2722,6,7,5,14,26,48,-22,26
Glentoran,2722,7,6,6,10,24,32,-8,24
Dungannon,2722,8,2,4,16,14,47,-33,10
Crusaders,2723,1,17,6,3,64,32,32,57
Coleraine,2723,2,14,11,1,44,23,21,53
Linfield,2723,3,11,5,10,39,37,2,38
Glenavon,2723,4,9,10,7,53,44,9,37
Cliftonville,2723,5,9,4,13,33,33,0,31
Ballymena,2723,6,7,4,15,27,50,-23,25
Glentoran,2723,7,6,6,10,24,32,-8,24
Dungannon,2723,8,2,4,16,14,47,-33,10
Crusaders,2724,1,16,6,4,63,33,30,54
Coleraine,2724,2,14,10,2,44,24,20,52
Glenavon,2724,3,10,9,7,54,44,10,39
Linfield,2724,4,11,5,10,39,37,2,38
Cliftonville,2724,5,9,4,13,33,33,0,31
Ballymena,2724,6,8,4,14,28,49,-21,28
Glentoran,2724,7,6,6,10,24,32,-8,24
Dungannon,2724,8,2,4,16,14,47,-33,10
Crusaders,2725,1,17,6,3,63,30,33,57
Coleraine,2725,2,15,10,1,47,24,23,55
Glenavon,2725,3,9,9,8,54,47,7,36
Linfield,2725,4,10,6,10,37,36,1,36
Cliftonville,2725,5,9,5,12,32,31,1,32
Ballymena,2725,6,7,4,15,25,49,-24,25
Glentoran,2725,7,6,6,10,24,32,-8,24
Dungannon,2725,8,2,4,16,14,47,-33,10
Crusaders,2726,1,16,6,4,61,31,30,54
Coleraine,2726,2,14,10,2,46,26,20,52
Glenavon,2726,3,10,9,7,56,46,10,39
Linfield,2726,4,11,5,10,39,36,3,38
Cliftonville,2726,5,9,4,13,32,33,-1,31
Ballymena,2726,6,8,4,14,26,47,-21,28
Glentoran,2726,7,6,6,10,24,32,-8,24
Dungannon,2726,8,2,4,16,14,47,-33,10
Crusaders,2727,1,17,6,3,63,31,32,57
Coleraine,2727,2,14,10,2,43,23,20,52
Glenavon,2727,3,10,9,7,53,43,10,39
Linfield,2727,4,11,5,10,39,36,3,38
Cliftonville,2727,5,9,4,13,32,33,-1,31
Ballymena,2727,6,7,4,15,26,49,-23,25
Glentoran,2727,7,6,6,10,24,32,-8,24
Dungannon,2727,8,2,4,16,14,47,-33,10
Crusaders,2728,1,17,6,3,64,30,34,57
Coleraine,2728,2,14,11,1,44,23,21,53
Linfield,2728,3,11,5,10,39,36,3,38
Glenavon,2728,4,9,10,7,53,44,9,37
Cliftonville,2728,5,9,4,13,32,33,-1,31
Ballymena,2728,6,7,4,15,25,50,-25,25
Glentoran,2728,7,6,6,10,24,32,-8,24
Dungannon,2728,8,2,4,16,14,47,-33,10
Crusaders,2729,1,17,6,3,64,31,33,57
Coleraine,2729,2,14,10,2,44,24,20,52
Glenavon,2729,3,10,9,7,54,44,10,39
Linfield,2729,4,11,5,10,39,36,3,38
Cliftonville,2729,5,9,4,13,32,33,-1,31
Ballymena,2729,6,7,4,15,26,50,-24,25
Glentoran,2729,7,6,6,10,24,32,-8,24
Dungannon,2729,8,2,4,16,14,47,-33,10
Crusaders,2730,1,16,6,4,61,32,29,54
Coleraine,2730,2,14,10,2,44,25,19,52
Glenavon,2730,3,10,9,7,55,44,11,39
Linfield,2730,4,10,6,10,37,36,1,36
Cliftonville,2730,5,9,5,12,32,31,1,32
Ballymena,2730,6,8,4,14,27,47,-20,28
Glentoran,2730,7,6,6,10,24,32,-8,24
Dungannon,2730,8,2,4,16,14,47,-33,10
Crusaders,2731,1,17,6,3,64,32,32,57
Coleraine,2731,2,14,11,1,46,25,21,53
Glenavon,2731,3,9,10,7,55,46,9,37
Linfield,2731,4,10,5,11,37,38,-1,35
Cliftonville,2731,5,10,4,12,34,31,3,34
Ballymena,2731,6,7,4,15,27,50,-23,25
Glentoran,2731,7,6,6,10,24,32,-8,24
Dungannon,2731,8,2,4,16,14,47,-33,10
Crusaders,2732,1,17,6,3,62,30,32,57
Coleraine,2732,2,14,10,2,43,24,19,52
Glenavon,2732,3,10,9,7,54,43,11,39
Linfield,2732,4,10,6,10,37,36,1,36
Cliftonville,2732,5,9,5,12,32,31,1,32
Ballymena,2732,6,7,4,15,25,48,-23,25
Glentoran,2732,7,6,6,10,24,32,-8,24
Dungannon,2732,8,2,4,16,14,47,-33,10
Crusaders,2733,1,17,6,3,65,31,34,57
Coleraine,2733,2,14,10,2,44,24,20,52
Glenavon,2733,3,10,9,7,54,44,10,39
Linfield,2733,4,10,5,11,37,37,0,35
Cliftonville,2733,5,10,4,12,33,31,2,34
Ballymena,2733,6,7,4,15,26,51,-25,25
Glentoran,2733,7,6,6,10,24,32,-8,24
Dungannon,2733,8,2,4,16,14,47,-33,10
Crusaders,2734,1,17,6,3,64,30,34,57
Coleraine,2734,2,14,10,2,44,24,20,52
Glenavon,2734,3,10,9,7,54,44,10,39
Linfield,2734,4,11,5,10,39,37,2,38
Cliftonville,2734,5,9,4,13,33,33,0,31
Ballymena,2734,6,7,4,15,25,50,-25,25
Glentoran,2734,7,6,6,10,24,32,-8,24
Dungannon,2734,8,2,4,16,14,47,-33,10
Crusaders,2735,1,17,6,3,63,30,33,57
Coleraine,2735,2,15,10,1,46,23,23,55
Glenavon,2735,3,9,9,8,53,46,7,36
Linfield,2735,4,10,6,10,37,36,1,36
Cliftonville,2735,5,9,5,12,32,31,1,32
Ballymena,2735,6,7,4,15,25,49,-24,25
Glentoran,2735,7,6,6,10,24,32,-8,24
Dungannon,2735,8,2,4,16,14,47,-33,10
Crusaders,2736,1,16,6,4,61,32,29,54
Coleraine,2736,2,14,10,2,44,24,20,52
Glenavon,2736,3,10,9,7,54,44,10,39
Linfield,2736,4,11,5,10,38,36,2,38
Cliftonville,2736,5,9,4,13,32,32,0,31
Ballymena,2736,6,8,4,14,27,47,-20,28
Glentoran,2736,7,6,6,10,24,32,-8,24
Dungannon,2736,8,2,4,16,14,47,-33,10
Crusaders,2737,1,17,6,3,62,30,32,57
Coleraine,2737,2,15,10,1,47,23,24,55
Linfield,2737,3,11,5,10,40,36,4,38
Glenavon,2737,4,9,9,8,53,47,6,36
Cliftonville,2737,5,9,4,13,32,34,-2,31
Ballymena,2737,6,7,4,15,25,48,-23,25
Glentoran,2737,7,6,6,10,24,32,-8,24
Dungannon,2737,8,2,4,16,14,47,-33,10
Crusaders,2738,1,16,6,4,63,33,30,54
Coleraine,2738,2,14,11,1,45,24,21,53
Glenavon,2738,3,9,10,7,54,45,9,37
Linfield,2738,4,10,5,11,37,38,-1,35
Cliftonville,2738,5,10,4,12,34,31,3,34
Ballymena,2738,6,8,4,14,28,49,-21,28
Glentoran,2738,7,6,6,10,24,32,-8,24
Dungannon,2738,8,2,4,16,14,47,-33,10
Crusaders,2739,1,17,6,3,67,30,37,57
Coleraine,2739,2,15,10,1,46,23,23,55
Glenavon,2739,3,9,9,8,53,46,7,36
Linfield,2739,4,10,6,10,38,37,1,36
Cliftonville,2739,5,9,5,12,33,32,1,32
Ballymena,2739,6,7,4,15,25,53,-28,25
Glentoran,2739,7,6,6,10,24,32,-8,24
Dungannon,2739,8,2,4,16,14,47,-33,10
Crusaders,2740,1,17,6,3,64,30,34,57
Coleraine,2740,2,14,10,2,44,27,17,52
Glenavon,2740,3,10,9,7,57,44,13,39
Linfield,2740,4,10,5,11,37,37,0,35
Cliftonville,2740,5,10,4,12,33,31,2,34
Ballymena,2740,6,7,4,15,25,50,-25,25
Glentoran,2740,7,6,6,10,24,32,-8,24
Dungannon,2740,8,2,4,16,14,47,-33,10
Crusaders,2741,1,16,6,4,62,32,30,54
Coleraine,2741,2,14,10,2,43,25,18,52
Glenavon,2741,3,10,9,7,55,43,12,39
Linfield,2741,4,11,5,10,39,36,3,38
Cliftonville,2741,5,9,4,13,32,33,-1,31
Ballymena,2741,6,8,4,14,27,48,-21,28
Glentoran,2741,7,6,6,10,24,32,-8,24
Dungannon,2741,8,2,4,16,14,47,-33,10
Crusaders,2742,1,17,6,3,65,31,34,57
Coleraine,2742,2,14,10,2,43,25,18,52
Glenavon,2742,3,10,9,7,55,43,12,39
Linfield,2742,4,11,5,10,39,36,3,38
Cliftonville,2742,5,9,4,13,32,33,-1,31
Ballymena,2742,6,7,4,15,26,51,-25,25
Glentoran,2742,7,6,6,10,24,32,-8,24
Dungannon,2742,8,2,4,16,14,47,-33,10
Crusaders,2743,1,17,6,3,64,30,34,57
Coleraine,2743,2,14,10,2,45,26,19,52
Glenavon,2743,3,10,9,7,56,45,11,39
Linfield,2743,4,11,5,10,43,37,6,38
Cliftonville,2743,5,9,4,13,33,37,-4,31
Ballymena,2743,6,7,4,15,25,50,-25,25
Glentoran,2743,7,6,6,10,24,32,-8,24
Dungannon,2743,8,2,4,16,14,47,-33,10
Crusaders,2744,1,17,6,3,63,31,32,57
Coleraine,2744,2,14,10,2,43,27,16,52
Glenavon,2744,3,10,9,7,57,43,14,39
Linfield,2744,4,11,5,10,40,38,2,38
Cliftonville,2744,5,9,4,13,34,34,0,31
Ballymena,2744,6,7,4,15,26,49,-23,25
Glentoran,2744,7,6,6,10,24,32,-8,24
Dungannon,2744,8,2,4,16,14,47,-33,10
Crusaders,2745,1,17,6,3,64,32,32,57
Coleraine,2745,2,15,10,1,45,22,23,55
Linfield,2745,3,11,5,10,40,36,4,38
Glenavon,2745,4,9,9,8,52,45,7,36
Cliftonville,2745,5,9,4,13,32,34,-2,31
Ballymena,2745,6,7,4,15,27,50,-23,25
Glentoran,2745,7,6,6,10,24,32,-8,24
Dungannon,2745,8,2,4,16,14,47,-33,10
Crusaders,2746,1,17,6,3,64,31,33,57
Coleraine,2746,2,15,10,1,45,23,22,55
Glenavon,2746,3,9,9,8,53,45,8,36
Linfield,2746,4,10,6,10,37,36,1,36
Cliftonville,2746,5,9,5,12,32,31,1,32
Ballymena,2746,6,7,4,15,26,50,-24,25
Glentoran,2746,7,6,6,10,24,32,-8,24
Dungannon,2746,8,2,4,16,14,47,-33,10
Crusaders,2747,1,17,6,3,64,31,33,57
Coleraine,2747,2,14,10,2,43,23,20,52
Glenavon,2747,3,10,9,7,53,43,10,39
Linfield,2747,4,10,5,11,37,39,-2,35
Cliftonville,2747,5,10,4,12,35,31,4,34
Ballymena,2747,6,7,4,15,26,50,-24,25
Glentoran,2747,7,6,6,10,24,32,-8,24
Dungannon,2747,8,2,4,16,14,47,-33,10
Crusaders,2748,1,17,6,3,63,31,32,57
Coleraine,2748,2,15,10,1,47,22,25,55
Linfield,2748,3,11,5,10,39,37,2,38
Glenavon,2748,4,9,9,8,52,47,5,36
Cliftonville,2748,5,9,4,13,33,33,0,31
Ballymena,2748,6,7,4,15,26,49,-23,25
Glentoran,2748,7,6,6,10,24,32,-8,24
Dungannon,2748,8,2,4,16,14,47,-33,10
Crusaders,2749,1,16,7,3,62,31,31,55
Coleraine,2749,2,15,10,1,46,22,24,55
Linfield,2749,3,11,5,10,39,37,2,38
Glenavon,2749,4,9,9,8,52,46,6,36
Cliftonville,2749,5,9,4,13,33,33,0,31
Ballymena,2749,6,7,5,14,26,48,-22,26
Glentoran,2749,7,6,6,10,24,32,-8,24
Dungannon,2749,8,2,4,16,14,47,-33,10
Crusaders,2750,1,17,6,3,63,31,32,57
Coleraine,2750,2,15,10,1,45,23,22,55
Glenavon,2750,3,9,9,8,53,45,8,36
Linfield,2750,4,10,6,10,37,36,1,36
Cliftonville,2750,5,9,5,12,32,31,1,32
Ballymena,2750,6,7,4,15,26,49,-23,25
Glentoran,2750,7,6,6,10,24,32,-8,24
Dungannon,2750,8,2,4,16,14,47,-33,10
Crusaders,2751,1,17,6,3,65,31,34,57
Coleraine,2751,2,14,10,2,43,24,19,52
Glenavon,2751,3,10,9,7,54,43,11,39
Linfield,2751,4,11,5,10,41,39,2,38
Cliftonville,2751,5,9,4,13,35,35,0,31
Ballymena,2751,6,7,4,15,26,51,-25,25
Glentoran,2751,7,6,6,10,24,32,-8,24
Dungannon,2751,8,2,4,16,14,47,-33,10
Crusaders,2752,1,17,6,3,63,30,33,57
Coleraine,2752,2,14,10,2,43,27,16,52
Glenavon,2752,3,10,9,7,57,43,14,39
Linfield,2752,4,10,6,10,39,38,1,36
Cliftonville,2752,5,9,5,12,34,33,1,32
Ballymena,2752,6,7,4,15,25,49,-24,25
Glentoran,2752,7,6,6,10,24,32,-8,24
Dungannon,2752,8,2,4,16,14,47,-33,10
Crusaders,2753,1,16,6,4,62,33,29,54
Coleraine,2753,2,14,10,2,43,24,19,52
Glenavon,2753,3,10,9,7,54,43,11,39
Linfield,2753,4,11,5,10,39,37,2,38
Cliftonville,2753,5,9,4,13,33,33,0,31
Ballymena,2753,6,8,4,14,28,48,-20,28
Glentoran,2753,7,6,6,10,24,32,-8,24
Dungannon,2753,8,2,4,16,14,47,-33,10
Crusaders,2754,1,16,7,3,61,30,31,55
Coleraine,2754,2,14,11,1,44,23,21,53
Linfield,2754,3,11,5,10,41,38,3,38
Glenavon,2754,4,9,10,7,53,44,9,37
Cliftonville,2754,5,9,4,13,34,35,-1,31
Ballymena,2754,6,7,5,14,25,47,-22,26
Glentoran,2754,7,6,6,10,24,32,-8,24
Dungannon,2754,8,2,4,16,14,47,-33,10
Crusaders,2755,1,16,7,3,61,30,31,55
Coleraine,2755,2,15,10,1,44,22,22,55
Glenavon,2755,3,9,9,8,52,44,8,36
Linfield,2755,4,10,5,11,38,38,0,35
Cliftonville,2755,5,10,4,12,34,32,2,34
Ballymena,2755,6,7,5,14,25,47,-22,26
Glentoran,2755,7,6,6,10,24,32,-8,24
Dungannon,2755,8,2,4,16,14,47,-33,10
Crusaders,2756,1,17,6,3,65,31,34,57
Coleraine,2756,2,14,11,1,46,25,21,53
Linfield,2756,3,11,5,10,38,36,2,38
Glenavon,2756,4,9,10,7,55,46,9,37
Cliftonville,2756,5,9,4,13,32,32,0,31
Ballymena,2756,6,7,4,15,26,51,-25,25
Glentoran,2756,7,6,6,10,24,32,-8,24
Dungannon,2756,8,2,4,16,14,47,-33,10
Crusaders,2757,1,16,7,3,61,30,31,55
Coleraine,2757,2,14,10,2,43,24,19,52
Glenavon,2757,3,10,9,7,54,43,11,39
Linfield,2757,4,10,6,10,37,36,1,36
Cliftonville,2757,5,9,5,12,32,31,1,32
Ballymena,2757,6,7,5,14,25,47,-22,26
Glentoran,2757,7,6,6,10,24,32,-8,24
Dungannon,2757,8,2,4,16,14,47,-33,10
Crusaders,2758,1,16,6,4,61,31,30,54
Coleraine,2758,2,14,11,1,44,23,21,53
Glenavon,2758,3,9,10,7,53,44,9,37
Linfield,2758,4,10,6,10,38,37,1,36
Cliftonville,2758,5,9,5,12,33,32,1,32
Ballymena,2758,6,8,4,14,26,47,-21,28
Glentoran,2758,7,6,6,10,24,32,-8,24
Dungannon,2758,8,2,4,16,14,47,-33,10
Crusaders,2759,1,17,6,3,64,31,33,57
Coleraine,2759,2,15,10,1,44,22,22,55
Glenavon,2759,3,9,9,8,52,44,8,36
Linfield,2759,4,10,5,11,38,38,0,35
Cliftonville,2759,5,10,4,12,34,32,2,34
Ballymena,2759,6,7,4,15,26,50,-24,25
Glentoran,2759,7,6,6,10,24,32,-8,24
Dungannon,2759,8,2,4,16,14,47,-33,10
Crusaders,2760,1,17,6,3,63,31,32,57
Coleraine,2760,2,15,10,1,47,25,22,55
Linfield,2760,3,11,5,10,40,37,3,38
Glenavon,2760,4,9,9,8,55,47,8,36
Cliftonville,2760,5,9,4,13,33,34,-1,31
Ballymena,2760,6,7,4,15,26,49,-23,25
Glentoran,2760,7,6,6,10,24,32,-8,24
Dungannon,2760,8,2,4,16,14,47,-33,10
Coleraine,2761,1,15,10,1,48,24,24,55
Crusaders,2761,2,16,6,4,62,32,30,54
Glenavon,2761,3,9,9,8,54,48,6,36
Linfield,2761,4,10,6,10,39,38,1,36
Cliftonville,2761,5,9,5,12,34,33,1,32
Ballymena,2761,6,8,4,14,27,48,-21,28
Glentoran,2761,7,6,6,10,24,32,-8,24
Dungannon,2761,8,2,4,16,14,47,-33,10
Crusaders,2762,1,17,6,3,63,31,32,57
Coleraine,2762,2,14,10,2,44,24,20,52
Glenavon,2762,3,10,9,7,54,44,10,39
Linfield,2762,4,10,6,10,41,40,1,36
Cliftonville,2762,5,9,5,12,36,35,1,32
Ballymena,2762,6,7,4,15,26,49,-23,25
Glentoran,2762,7,6,6,10,24,32,-8,24
Dungannon,2762,8,2,4,16,14,47,-33,10
Crusaders,2763,1,17,6,3,63,31,32,57
Coleraine,2763,2,14,11,1,44,23,21,53
Glenavon,2763,3,9,10,7,53,44,9,37
Linfield,2763,4,10,5,11,37,37,0,35
Cliftonville,2763,5,10,4,12,33,31,2,34
Ballymena,2763,6,7,4,15,26,49,-23,25
Glentoran,2763,7,6,6,10,24,32,-8,24
Dungannon,2763,8,2,4,16,14,47,-33,10
Crusaders,2764,1,16,7,3,63,32,31,55
Coleraine,2764,2,14,11,1,44,23,21,53
Glenavon,2764,3,9,10,7,53,44,9,37
Linfield,2764,4,10,5,11,38,39,-1,35
Cliftonville,2764,5,10,4,12,35,32,3,34
Ballymena,2764,6,7,5,14,27,49,-22,26
Glentoran,2764,7,6,6,10,24,32,-8,24
Dungannon,2764,8,2,4,16,14,47,-33,10
Crusaders,2765,1,16,6,4,63,33,30,54
Coleraine,2765,2,14,10,2,46,29,17,52
Glenavon,2765,3,10,9,7,59,46,13,39
Linfield,2765,4,11,5,10,41,36,5,38
Cliftonville,2765,5,9,4,13,32,35,-3,31
Ballymena,2765,6,8,4,14,28,49,-21,28
Glentoran,2765,7,6,6,10,24,32,-8,24
Dungannon,2765,8,2,4,16,14,47,-33,10
Crusaders,2766,1,17,6,3,63,30,33,57
Coleraine,2766,2,14,10,2,44,24,20,52
Glenavon,2766,3,10,9,7,54,44,10,39
Linfield,2766,4,11,5,10,39,36,3,38
Cliftonville,2766,5,9,4,13,32,33,-1,31
Ballymena,2766,6,7,4,15,25,49,-24,25
Glentoran,2766,7,6,6,10,24,32,-8,24
Dungannon,2766,8,2,4,16,14,47,-33,10
Crusaders,2767,1,16,6,4,61,31,30,54
Coleraine,2767,2,14,10,2,43,24,19,52
Glenavon,2767,3,10,9,7,54,43,11,39
Linfield,2767,4,11,5,10,43,39,4,38
Cliftonville,2767,5,9,4,13,35,37,-2,31
Ballymena,2767,6,8,4,14,26,47,-21,28
Glentoran,2767,7,6,6,10,24,32,-8,24
Dungannon,2767,8,2,4,16,14,47,-33,10
Crusaders,2768,1,17,6,3,65,31,34,57
Coleraine,2768,2,14,10,2,43,25,18,52
Glenavon,2768,3,10,9,7,55,43,12,39
Linfield,2768,4,11,5,10,40,36,4,38
Cliftonville,2768,5,9,4,13,32,34,-2,31
Ballymena,2768,6,7,4,15,26,51,-25,25
Glentoran,2768,7,6,6,10,24,32,-8,24
Dungannon,2768,8,2,4,16,14,47,-33,10
Crusaders,2769,1,16,6,4,62,33,29,54
Coleraine,2769,2,14,10,2,45,25,20,52
Glenavon,2769,3,10,9,7,55,45,10,39
Linfield,2769,4,10,5,11,38,40,-2,35
Cliftonville,2769,5,10,4,12,36,32,4,34
Ballymena,2769,6,8,4,14,28,48,-20,28
Glentoran,2769,7,6,6,10,24,32,-8,24
Dungannon,2769,8,2,4,16,14,47,-33,10
Crusaders,2770,1,16,6,4,63,33,30,54
Coleraine,2770,2,14,10,2,44,24,20,52
Glenavon,2770,3,10,9,7,54,44,10,39
Linfield,2770,4,11,5,10,39,36,3,38
Cliftonville,2770,5,9,4,13,32,33,-1,31
Ballymena,2770,6,8,4,14,28,49,-21,28
Glentoran,2770,7,6,6,10,24,32,-8,24
Dungannon,2770,8,2,4,16,14,47,-33,10
Crusaders,2771,1,17,6,3,67,30,37,57
Coleraine,2771,2,14,10,2,43,23,20,52
Glenavon,2771,3,10,9,7,53,43,10,39
Linfield,2771,4,11,5,10,38,36,2,38
Cliftonville,2771,5,9,4,13,32,32,0,31
Ballymena,2771,6,7,4,15,25,53,-28,25
Glentoran,2771,7,6,6,10,24,32,-8,24
Dungannon,2771,8,2,4,16,14,47,-33,10
Crusaders,2772,1,17,6,3,63,30,33,57
Coleraine,2772,2,14,11,1,43,22,21,53
Glenavon,2772,3,9,10,7,52,43,9,37
Linfield,2772,4,10,5,11,37,38,-1,35
Cliftonville,2772,5,10,4,12,34,31,3,34
Ballymena,2772,6,7,4,15,25,49,-24,25
Glentoran,2772,7,6,6,10,24,32,-8,24
Dungannon,2772,8,2,4,16,14,47,-33,10
Crusaders,2773,1,17,6,3,64,30,34,57
Coleraine,2773,2,15,10,1,45,23,22,55
Glenavon,2773,3,9,9,8,53,45,8,36
Linfield,2773,4,10,5,11,39,39,0,35
Cliftonville,2773,5,10,4,12,35,33,2,34
Ballymena,2773,6,7,4,15,25,50,-25,25
Glentoran,2773,7,6,6,10,24,32,-8,24
Dungannon,2773,8,2,4,16,14,47,-33,10
Crusaders,2774,1,17,6,3,64,31,33,57
Coleraine,2774,2,15,10,1,44,22,22,55
Linfield,2774,3,11,5,10,38,36,2,38
Glenavon,2774,4,9,9,8,52,44,8,36
Cliftonville,2774,5,9,4,13,32,32,0,31
Ballymena,2774,6,7,4,15,26,50,-24,25
Glentoran,2774,7,6,6,10,24,32,-8,24
Dungannon,2774,8,2,4,16,14,47,-33,10
Crusaders,2775,1,17,6,3,62,30,32,57
Coleraine,2775,2,14,11,1,44,23,21,53
Glenavon,2775,3,9,10,7,53,44,9,37
Linfield,2775,4,10,5,11,38,38,0,35
Cliftonville,2775,5,10,4,12,34,32,2,34
Ballymena,2775,6,7,4,15,25,48,-23,25
Glentoran,2775,7,6,6,10,24,32,-8,24
Dungannon,2775,8,2,4,16,14,47,-33,10
Crusaders,2776,1,17,6,3,65,31,34,57
Coleraine,2776,2,15,10,1,45,23,22,55
Linfield,2776,3,11,5,10,39,37,2,38
Glenavon,2776,4,9,9,8,53,45,8,36
Cliftonville,2776,5,9,4,13,33,33,0,31
Ballymena,2776,6,7,4,15,26,51,-25,25
Glentoran,2776,7,6,6,10,24,32,-8,24
Dungannon,2776,8,2,4,16,14,47,-33,10
Crusaders,2777,1,17,6,3,65,33,32,57
Coleraine,2777,2,14,11,1,44,23,21,53
Glenavon,2777,3,9,10,7,53,44,9,37
Linfield,2777,4,10,5,11,38,39,-1,35
Cliftonville,2777,5,10,4,12,35,32,3,34
Ballymena,2777,6,7,4,15,28,51,-23,25
Glentoran,2777,7,6,6,10,24,32,-8,24
Dungannon,2777,8,2,4,16,14,47,-33,10
Crusaders,2778,1,16,7,3,61,30,31,55
Coleraine,2778,2,15,10,1,45,23,22,55
Glenavon,2778,3,9,9,8,53,45,8,36
Linfield,2778,4,10,5,11,38,38,0,35
Cliftonville,2778,5,10,4,12,34,32,2,34
Ballymena,2778,6,7,5,14,25,47,-22,26
Glentoran,2778,7,6,6,10,24,32,-8,24
Dungannon,2778,8,2,4,16,14,47,-33,10
Crusaders,2779,1,16,6,4,63,33,30,54
Coleraine,2779,2,14,11,1,45,24,21,53
Glenavon,2779,3,9,10,7,54,45,9,37
Linfield,2779,4,10,6,10,38,37,1,36
Cliftonville,2779,5,9,5,12,33,32,1,32
Ballymena,2779,6,8,4,14,28,49,-21,28
Glentoran,2779,7,6,6,10,24,32,-8,24
Dungannon,2779,8,2,4,16,14,47,-33,10
Crusaders,2780,1,16,6,4,61,31,30,54
Coleraine,2780,2,14,10,2,43,23,20,52
Glenavon,2780,3,10,9,7,53,43,10,39
Linfield,2780,4,10,5,11,37,37,0,35
Cliftonville,2780,5,10,4,12,33,31,2,34
Ballymena,2780,6,8,4,14,26,47,-21,28
Glentoran,2780,7,6,6,10,24,32,-8,24
Dungannon,2780,8,2,4,16,14,47,-33,10
Crusaders,2781,1,16,7,3,62,31,31,55
Coleraine,2781,2,14,10,2,45,26,19,52
Glenavon,2781,3,10,9,7,56,45,11,39
Linfield,2781,4,10,6,10,37,36,1,36
Cliftonville,2781,5,9,5,12,32,31,1,32
Ballymena,2781,6,7,5,14,26,48,-22,26
Glentoran,2781,7,6,6,10,24,32,-8,24
Dungannon,2781,8,2,4,16,14,47,-33,10
Crusaders,2782,1,17,6,3,63,31,32,57
Coleraine,2782,2,15,10,1,46,23,23,55
Glenavon,2782,3,9,9,8,53,46,7,36
Linfield,2782,4,10,5,11,38,38,0,35
Cliftonville,2782,5,10,4,12,34,32,2,34
Ballymena,2782,6,7,4,15,26,49,-23,25
Glentoran,2782,7,6,6,10,24,32,-8,24
Dungannon,2782,8,2,4,16,14,47,-33,10
Crusaders,2783,1,17,6,3,64,31,33,57
Coleraine,2783,2,14,11,1,44,23,21,53
Glenavon,2783,3,9,10,7,53,44,9,37
Linfield,2783,4,10,5,11,38,38,0,35
Cliftonville,2783,5,10,4,12,34,32,2,34
Ballymena,2783,6,7,4,15,26,50,-24,25
Glentoran,2783,7,6,6,10,24,32,-8,24
Dungannon,2783,8,2,4,16,14,47,-33,10
Crusaders,2784,1,16,6,4,61,31,30,54
Coleraine,2784,2,14,10,2,45,25,20,52
Glenavon,2784,3,10,9,7,55,45,10,39
Linfield,2784,4,10,5,11,37,37,0,35
Cliftonville,2784,5,10,4,12,33,31,2,34
Ballymena,2784,6,8,4,14,26,47,-21,28
Glentoran,2784,7,6,6,10,24,32,-8,24
Dungannon,2784,8,2,4,16,14,47,-33,10
Coleraine,2785,1,15,10,1,44,22,22,55
Crusaders,2785,2,16,6,4,61,31,30,54
Linfield,2785,3,11,5,10,40,37,3,38
Glenavon,2785,4,9,9,8,52,44,8,36
Cliftonville,2785,5,9,4,13,33,34,-1,31
Ballymena,2785,6,8,4,14,26,47,-21,28
Glentoran,2785,7,6,6,10,24,32,-8,24
Dungannon,2785,8,2,4,16,14,47,-33,10
Crusaders,2786,1,16,6,4,62,32,30,54
Coleraine,2786,2,14,10,2,44,25,19,52
Glenavon,2786,3,10,9,7,55,44,11,39
Linfield,2786,4,11,5,10,39,37,2,38
Cliftonville,2786,5,9,4,13,33,33,0,31
Ballymena,2786,6,8,4,14,27,48,-21,28
Glentoran,2786,7,6,6,10,24,32,-8,24
Dungannon,2786,8,2,4,16,14,47,-33,10
Crusaders,2787,1,17,6,3,63,31,32,57
Coleraine,2787,2,14,10,2,44,24,20,52
Glenavon,2787,3,10,9,7,54,44,10,39
Linfield,2787,4,10,6,10,39,38,1,36
Cliftonville,2787,5,9,5,12,34,33,1,32
Ballymena,2787,6,7,4,15,26,49,-23,25
Glentoran,2787,7,6,6,10,24,32,-8,24
Dungannon,2787,8,2,4,16,14,47,-33,10
Crusaders,2788,1,17,6,3,66,31,35,57
Coleraine,2788,2,14,10,2,44,25,19,52
Glenavon,2788,3,10,9,7,55,44,11,39
Linfield,2788,4,11,5,10,40,37,3,38
Cliftonville,2788,5,9,4,13,33,34,-1,31
Ballymena,2788,6,7,4,15,26,52,-26,25
Glentoran,2788,7,6,6,10,24,32,-8,24
Dungannon,2788,8,2,4,16,14,47,-33,10
Crusaders,2789,1,17,6,3,65,30,35,57
Coleraine,2789,2,15,10,1,44,22,22,55
Glenavon,2789,3,9,9,8,52,44,8,36
Linfield,2789,4,10,5,11,37,40,-3,35
Cliftonville,2789,5,10,4,12,36,31,5,34
Ballymena,2789,6,7,4,15,25,51,-26,25
Glentoran,2789,7,6,6,10,24,32,-8,24
Dungannon,2789,8,2,4,16,14,47,-33,10
Crusaders,2790,1,17,6,3,63,31,32,57
Coleraine,2790,2,15,10,1,45,22,23,55
Glenavon,2790,3,9,9,8,52,45,7,36
Linfield,2790,4,10,5,11,37,37,0,35
Cliftonville,2790,5,10,4,12,33,31,2,34
Ballymena,2790,6,7,4,15,26,49,-23,25
Glentoran,2790,7,6,6,10,24,32,-8,24
Dungannon,2790,8,2,4,16,14,47,-33,10
Coleraine,2791,1,15,10,1,45,23,22,55
Crusaders,2791,2,16,6,4,62,32,30,54
Glenavon,2791,3,9,9,8,53,45,8,36
Linfield,2791,4,10,6,10,39,38,1,36
Cliftonville,2791,5,9,5,12,34,33,1,32
Ballymena,2791,6,8,4,14,27,48,-21,28
Glentoran,2791,7,6,6,10,24,32,-8,24
Dungannon,2791,8,2,4,16,14,47,-33,10
Crusaders,2792,1,17,6,3,63,31,32,57
Coleraine,2792,2,14,11,1,44,23,21,53
Linfield,2792,3,11,5,10,41,37,4,38
Glenavon,2792,4,9,10,7,53,44,9,37
Cliftonville,2792,5,9,4,13,33,35,-2,31
Ballymena,2792,6,7,4,15,26,49,-23,25
Glentoran,2792,7,6,6,10,24,32,-8,24
Dungannon,2792,8,2,4,16,14,47,-33,10
Crusaders,2793,1,17,6,3,63,31,32,57
Coleraine,2793,2,15,10,1,45,22,23,55
Glenavon,2793,3,9,9,8,52,45,7,36
Linfield,2793,4,10,5,11,37,37,0,35
Cliftonville,2793,5,10,4,12,33,31,2,34
Ballymena,2793,6,7,4,15,26,49,-23,25
Glentoran,2793,7,6,6,10,24,32,-8,24
Dungannon,2793,8,2,4,16,14,47,-33,10
Crusaders,2794,1,17,6,3,65,30,35,57
Coleraine,2794,2,14,11,1,44,23,21,53
Linfield,2794,3,11,5,10,42,37,5,38
Glenavon,2794,4,9,10,7,53,44,9,37
Cliftonville,2794,5,9,4,13,33,36,-3,31
Ballymena,2794,6,7,4,15,25,51,-26,25
Glentoran,2794,7,6,6,10,24,32,-8,24
Dungannon,2794,8,2,4,16,14,47,-33,10
Crusaders,2795,1,16,6,4,62,33,29,54
Coleraine,2795,2,14,10,2,44,27,17,52
Glenavon,2795,3,10,9,7,57,44,13,39
Linfield,2795,4,11,5,10,39,36,3,38
Cliftonville,2795,5,9,4,13,32,33,-1,31
Ballymena,2795,6,8,4,14,28,48,-20,28
Glentoran,2795,7,6,6,10,24,32,-8,24
Dungannon,2795,8,2,4,16,14,47,-33,10
Crusaders,2796,1,16,6,4,61,31,30,54
Coleraine,2796,2,14,10,2,44,27,17,52
Glenavon,2796,3,10,9,7,57,44,13,39
Linfield,2796,4,11,5,10,40,37,3,38
Cliftonville,2796,5,9,4,13,33,34,-1,31
Ballymena,2796,6,8,4,14,26,47,-21,28
Glentoran,2796,7,6,6,10,24,32,-8,24
Dungannon,2796,8,2,4,16,14,47,-33,10
Crusaders,2797,1,16,7,3,62,31,31,55
Coleraine,2797,2,15,10,1,45,22,23,55
Glenavon,2797,3,9,9,8,52,45,7,36
Linfield,2797,4,10,5,11,37,39,-2,35
Cliftonville,2797,5,10,4,12,35,31,4,34
Ballymena,2797,6,7,5,14,26,48,-22,26
Glentoran,2797,7,6,6,10,24,32,-8,24
Dungannon,2797,8,2,4,16,14,47,-33,10
Coleraine,2798,1,15,10,1,46,22,24,55
Crusaders,2798,2,16,6,4,62,32,30,54
Linfield,2798,3,11,5,10,40,36,4,38
Glenavon,2798,4,9,9,8,52,46,6,36
Cliftonville,2798,5,9,4,13,32,34,-2,31
Ballymena,2798,6,8,4,14,27,48,-21,28
Glentoran,2798,7,6,6,10,24,32,-8,24
Dungannon,2798,8,2,4,16,14,47,-33,10
Crusaders,2799,1,17,6,3,64,31,33,57
Coleraine,2799,2,15,10,1,47,23,24,55
Linfield,2799,3,11,5,10,39,37,2,38
Glenavon,2799,4,9,9,8,53,47,6,36
Cliftonville,2799,5,9,4,13,33,33,0,31
Ballymena,2799,6,7,4,15,26,50,-24,25
Glentoran,2799,7,6,6,10,24,32,-8,24
Dungannon,2799,8,2,4,16,14,47,-33,10
Crusaders,2800,1,17,6,3,62,30,32,57
Coleraine,2800,2,14,11,1,44,23,21,53
Glenavon,2800,3,9,10,7,53,44,9,37
Linfield,2800,4,10,5,11,38,39,-1,35
Cliftonville,2800,5,10,4,12,35,32,3,34
Ballymena,2800,6,7,4,15,25,48,-23,25
Glentoran,2800,7,6,6,10,24,32,-8,24
Dungannon,2800,8,2,4,16,14,47,-33,10
Crusaders,2801,1,16,7,3,62,31,31,55
Coleraine,2801,2,14,10,2,43,23,20,52
Glenavon,2801,3,10,9,7,53,43,10,39
Linfield,2801,4,10,6,10,38,37,1,36
Cliftonville,2801,5,9,5,12,33,32,1,32
Ballymena,2801,6,7,5,14,26,48,-22,26
Glentoran,2801,7,6,6,10,24,32,-8,24
Dungannon,2801,8,2,4,16,14,47,-33,10
Crusaders,2802,1,17,6,3,63,30,33,57
Coleraine,2802,2,15,10,1,48,23,25,55
Linfield,2802,3,11,5,10,39,37,2,38
Glenavon,2802,4,9,9,8,53,48,5,36
Cliftonville,2802,5,9,4,13,33,33,0,31
Ballymena,2802,6,7,4,15,25,49,-24,25
Glentoran,2802,7,6,6,10,24,32,-8,24
Dungannon,2802,8,2,4,16,14,47,-33,10
Crusaders,2803,1,16,6,4,62,34,28,54
Coleraine,2803,2,14,11,1,44,23,21,53
Glenavon,2803,3,9,10,7,53,44,9,37
Linfield,2803,4,10,6,10,38,37,1,36
Cliftonville,2803,5,9,5,12,33,32,1,32
Ballymena,2803,6,8,4,14,29,48,-19,28
Glentoran,2803,7,6,6,10,24,32,-8,24
Dungannon,2803,8,2,4,16,14,47,-33,10
Crusaders,2804,1,17,6,3,63,31,32,57
Coleraine,2804,2,14,11,1,45,24,21,53
Linfield,2804,3,11,5,10,38,36,2,38
Glenavon,2804,4,9,10,7,54,45,9,37
Cliftonville,2804,5,9,4,13,32,32,0,31
Ballymena,2804,6,7,4,15,26,49,-23,25
Glentoran,2804,7,6,6,10,24,32,-8,24
Dungannon,2804,8,2,4,16,14,47,-33,10
Crusaders,2805,1,17,6,3,63,31,32,57
Coleraine,2805,2,15,10,1,45,23,22,55
Linfield,2805,3,11,5,10,39,36,3,38
Glenavon,2805,4,9,9,8,53,45,8,36
Cliftonville,2805,5,9,4,13,32,33,-1,31
Ballymena,2805,6,7,4,15,26,49,-23,25
Glentoran,2805,7,6,6,10,24,32,-8,24
Dungannon,2805,8,2,4,16,14,47,-33,10
Crusaders,2806,1,16,7,3,61,30,31,55
Coleraine,2806,2,14,10,2,46,26,20,52
Glenavon,2806,3,10,9,7,56,46,10,39
Linfield,2806,4,11,5,10,40,36,4,38
Cliftonville,2806,5,9,4,13,32,34,-2,31
Ballymena,2806,6,7,5,14,25,47,-22,26
Glentoran,2806,7,6,6,10,24,32,-8,24
Dungannon,2806,8,2,4,16,14,47,-33,10
Crusaders,2807,1,17,6,3,63,31,32,57
Coleraine,2807,2,14,11,1,44,23,21,53
Linfield,2807,3,11,5,10,40,38,2,38
Glenavon,2807,4,9,10,7,53,44,9,37
Cliftonville,2807,5,9,4,13,34,34,0,31
Ballymena,2807,6,7,4,15,26,49,-23,25
Glentoran,2807,7,6,6,10,24,32,-8,24
Dungannon,2807,8,2,4,16,14,47,-33,10
Crusaders,2808,1,17,6,3,64,31,33,57
Coleraine,2808,2,14,10,2,43,24,19,52
Glenavon,2808,3,10,9,7,54,43,11,39
Linfield,2808,4,10,5,11,37,38,-1,35
Cliftonville,2808,5,10,4,12,34,31,3,34
Ballymena,2808,6,7,4,15,26,50,-24,25
Glentoran,2808,7,6,6,10,24,32,-8,24
Dungannon,2808,8,2,4,16,14,47,-33,10
Crusaders,2809,1,16,6,4,61,31,30,54
Coleraine,2809,2,14,11,1,44,23,21,53
Glenavon,2809,3,9,10,7,53,44,9,37
Linfield,2809,4,10,5,11,37,38,-1,35
Cliftonville,2809,5,10,4,12,34,31,3,34
Ballymena,2809,6,8,4,14,26,47,-21,28
Glentoran,2809,7,6,6,10,24,32,-8,24
Dungannon,2809,8,2,4,16,14,47,-33,10
Crusaders,2810,1,17,6,3,63,30,33,57
Coleraine,2810,2,14,10,2,44,25,19,52
Glenavon,2810,3,10,9,7,55,44,11,39
Linfield,2810,4,11,5,10,38,36,2,38
Cliftonville,2810,5,9,4,13,32,32,0,31
Ballymena,2810,6,7,4,15,25,49,-24,25
Glentoran,2810,7,6,6,10,24,32,-8,24
Dungannon,2810,8,2,4,16,14,47,-33,10
Crusaders,2811,1,17,6,3,63,31,32,57
Coleraine,2811,2,14,10,2,44,24,20,52
Glenavon,2811,3,10,9,7,54,44,10,39
Linfield,2811,4,11,5,10,40,36,4,38
Cliftonville,2811,5,9,4,13,32,34,-2,31
Ballymena,2811,6,7,4,15,26,49,-23,25
Glentoran,2811,7,6,6,10,24,32,-8,24
Dungannon,2811,8,2,4,16,14,47,-33,10
Crusaders,2812,1,16,7,3,62,31,31,55
Coleraine,2812,2,14,10,2,43,23,20,52
Glenavon,2812,3,10,9,7,53,43,10,39
Linfield,2812,4,11,5,10,40,37,3,38
Cliftonville,2812,5,9,4,13,33,34,-1,31
Ballymena,2812,6,7,5,14,26,48,-22,26
Glentoran,2812,7,6,6,10,24,32,-8,24
Dungannon,2812,8,2,4,16,14,47,-33,10
Crusaders,2813,1,16,7,3,62,31,31,55
Coleraine,2813,2,14,10,2,44,24,20,52
Glenavon,2813,3,10,9,7,54,44,10,39
Linfield,2813,4,10,5,11,37,38,-1,35
Cliftonville,2813,5,10,4,12,34,31,3,34
Ballymena,2813,6,7,5,14,26,48,-22,26
Glentoran,2813,7,6,6,10,24,32,-8,24
Dungannon,2813,8,2,4,16,14,47,-33,10
Crusaders,2814,1,17,6,3,64,32,32,57
Coleraine,2814,2,14,11,1,44,23,21,53
Glenavon,2814,3,9,10,7,53,44,9,37
Linfield,2814,4,10,6,10,40,39,1,36
Cliftonville,2814,5,9,5,12,35,34,1,32
Ballymena,2814,6,7,4,15,27,50,-23,25
Glentoran,2814,7,6,6,10,24,32,-8,24
Dungannon,2814,8,2,4,16,14,47,-33,10
Crusaders,2815,1,17,6,3,65,32,33,57
Coleraine,2815,2,15,10,1,47,24,23,55
Glenavon,2815,3,9,9,8,54,47,7,36
Linfield,2815,4,10,6,10,37,36,1,36
Cliftonville,2815,5,9,5,12,32,31,1,32
Ballymena,2815,6,7,4,15,27,51,-24,25
Glentoran,2815,7,6,6,10,24,32,-8,24
Dungannon,2815,8,2,4,16,14,47,-33,10
Crusaders,2816,1,17,6,3,63,31,32,57
Coleraine,2816,2,14,11,1,44,23,21,53
Glenavon,2816,3,9,10,7,53,44,9,37
Linfield,2816,4,10,5,11,37,37,0,35
Cliftonville,2816,5,10,4,12,33,31,2,34
Ballymena,2816,6,7,4,15,26,49,-23,25
Glentoran,2816,7,6,6,10,24,32,-8,24
Dungannon,2816,8,2,4,16,14,47,-33,10
Crusaders,2817,1,17,6,3,63,31,32,57
Coleraine,2817,2,14,10,2,43,23,20,52
Glenavon,2817,3,10,9,7,53,43,10,39
Linfield,2817,4,10,6,10,37,36,1,36
Cliftonville,2817,5,9,5,12,32,31,1,32
Ballymena,2817,6,7,4,15,26,49,-23,25
Glentoran,2817,7,6,6,10,24,32,-8,24
Dungannon,2817,8,2,4,16,14,47,-33,10
Crusaders,2818,1,16,7,3,62,31,31,55
Coleraine,2818,2,14,11,1,45,24,21,53
Glenavon,2818,3,9,10,7,54,45,9,37
Linfield,2818,4,10,6,10,38,37,1,36
Cliftonville,2818,5,9,5,12,33,32,1,32
Ballymena,2818,6,7,5,14,26,48,-22,26
Glentoran,2818,7,6,6,10,24,32,-8,24
Dungannon,2818,8,2,4,16,14,47,-33,10
Crusaders,2819,1,17,6,3,64,30,34,57
Coleraine,2819,2,14,10,2,44,24,20,52
Glenavon,2819,3,10,9,7,54,44,10,39
Linfield,2819,4,11,5,10,40,38,2,38
Cliftonville,2819,5,9,4,13,34,34,0,31
Ballymena,2819,6,7,4,15,25,50,-25,25
Glentoran,2819,7,6,6,10,24,32,-8,24
Dungannon,2819,8,2,4,16,14,47,-33,10
Coleraine,2820,1,15,10,1,45,23,22,55
Crusaders,2820,2,16,6,4,65,35,30,54
Glenavon,2820,3,9,9,8,53,45,8,36
Linfield,2820,4,10,6,10,38,37,1,36
Cliftonville,2820,5,9,5,12,33,32,1,32
Ballymena,2820,6,8,4,14,30,51,-21,28
Glentoran,2820,7,6,6,10,24,32,-8,24
Dungannon,2820,8,2,4,16,14,47,-33,10
Crusaders,2821,1,17,6,3,66,32,34,57
Coleraine,2821,2,15,10,1,46,23,23,55
Linfield,2821,3,11,5,10,38,36,2,38
Glenavon,2821,4,9,9,8,53,46,7,36
Cliftonville,2821,5,9,4,13,32,32,0,31
Ballymena,2821,6,7,4,15,27,52,-25,25
Glentoran,2821,7,6,6,10,24,32,-8,24
Dungannon,2821,8,2,4,16,14,47,-33,10
Crusaders,2822,1,16,6,4,62,32,30,54
Coleraine,2822,2,14,11,1,44,23,21,53
Glenavon,2822,3,9,10,7,53,44,9,37
Linfield,2822,4,10,5,11,39,39,0,35
Cliftonville,2822,5,10,4,12,35,33,2,34
Ballymena,2822,6,8,4,14,27,48,-21,28
Glentoran,2822,7,6,6,10,24,32,-8,24
Dungannon,2822,8,2,4,16,14,47,-33,10
Crusaders,2823,1,16,7,3,62,31,31,55
Coleraine,2823,2,14,11,1,44,23,21,53
Linfield,2823,3,11,5,10,40,38,2,38
Glenavon,2823,4,9,10,7,53,44,9,37
Cliftonville,2823,5,9,4,13,34,34,0,31
Ballymena,2823,6,7,5,14,26,48,-22,26
Glentoran,2823,7,6,6,10,24,32,-8,24
Dungannon,2823,8,2,4,16,14,47,-33,10
Crusaders,2824,1,17,6,3,64,30,34,57
Coleraine,2824,2,14,10,2,44,25,19,52
Glenavon,2824,3,10,9,7,55,44,11,39
Linfield,2824,4,10,5,11,38,38,0,35
Cliftonville,2824,5,10,4,12,34,32,2,34
Ballymena,2824,6,7,4,15,25,50,-25,25
Glentoran,2824,7,6,6,10,24,32,-8,24
Dungannon,2824,8,2,4,16,14,47,-33,10
Crusaders,2825,1,17,6,3,65,33,32,57
Coleraine,2825,2,15,10,1,45,23,22,55
Glenavon,2825,3,9,9,8,53,45,8,36
Linfield,2825,4,10,6,10,37,36,1,36
Cliftonville,2825,5,9,5,12,32,31,1,32
Ballymena,2825,6,7,4,15,28,51,-23,25
Glentoran,2825,7,6,6,10,24,32,-8,24
Dungannon,2825,8,2,4,16,14,47,-33,10
Crusaders,2826,1,17,6,3,64,30,34,57
Coleraine,2826,2,14,10,2,44,24,20,52
Glenavon,2826,3,10,9,7,54,44,10,39
Linfield,2826,4,10,5,11,37,37,0,35
Cliftonville,2826,5,10,4,12,33,31,2,34
Ballymena,2826,6,7,4,15,25,50,-25,25
Glentoran,2826,7,6,6,10,24,32,-8,24
Dungannon,2826,8,2,4,16,14,47,-33,10
Crusaders,2827,1,17,6,3,63,31,32,57
Coleraine,2827,2,14,10,2,43,24,19,52
Glenavon,2827,3,10,9,7,54,43,11,39
Linfield,2827,4,11,5,10,39,37,2,38
Cliftonville,2827,5,9,4,13,33,33,0,31
Ballymena,2827,6,7,4,15,26,49,-23,25
Glentoran,2827,7,6,6,10,24,32,-8,24
Dungannon,2827,8,2,4,16,14,47,-33,10
Crusaders,2828,1,16,6,4,61,31,30,54
Coleraine,2828,2,14,11,1,43,22,21,53
Linfield,2828,3,11,5,10,38,36,2,38
Glenavon,2828,4,9,10,7,52,43,9,37
Cliftonville,2828,5,9,4,13,32,32,0,31
Ballymena,2828,6,8,4,14,26,47,-21,28
Glentoran,2828,7,6,6,10,24,32,-8,24
Dungannon,2828,8,2,4,16,14,47,-33,10
Crusaders,2829,1,16,6,4,61,32,29,54
Coleraine,2829,2,14,11,1,44,23,21,53
Linfield,2829,3,11,5,10,40,37,3,38
Glenavon,2829,4,9,10,7,53,44,9,37
Cliftonville,2829,5,9,4,13,33,34,-1,31
Ballymena,2829,6,8,4,14,27,47,-20,28
Glentoran,2829,7,6,6,10,24,32,-8,24
Dungannon,2829,8,2,4,16,14,47,-33,10
Crusaders,2830,1,16,7,3,63,32,31,55
Coleraine,2830,2,15,10,1,47,24,23,55
Linfield,2830,3,11,5,10,41,37,4,38
Glenavon,2830,4,9,9,8,54,47,7,36
Cliftonville,2830,5,9,4,13,33,35,-2,31
Ballymena,2830,6,7,5,14,27,49,-22,26
Glentoran,2830,7,6,6,10,24,32,-8,24
Dungannon,2830,8,2,4,16,14,47,-33,10
Crusaders,2831,1,17,6,3,63,31,32,57
Coleraine,2831,2,14,10,2,43,24,19,52
Glenavon,2831,3,10,9,7,54,43,11,39
Linfield,2831,4,11,5,10,42,38,4,38
Cliftonville,2831,5,9,4,13,34,36,-2,31
Ballymena,2831,6,7,4,15,26,49,-23,25
Glentoran,2831,7,6,6,10,24,32,-8,24
Dungannon,2831,8,2,4,16,14,47,-33,10
Crusaders,2832,1,17,6,3,62,30,32,57
Coleraine,2832,2,15,10,1,45,23,22,55
Linfield,2832,3,11,5,10,40,38,2,38
Glenavon,2832,4,9,9,8,53,45,8,36
Cliftonville,2832,5,9,4,13,34,34,0,31
Ballymena,2832,6,7,4,15,25,48,-23,25
Glentoran,2832,7,6,6,10,24,32,-8,24
Dungannon,2832,8,2,4,16,14,47,-33,10
Crusaders,2833,1,16,6,4,62,32,30,54
Coleraine,2833,2,14,10,2,44,24,20,52
Glenavon,2833,3,10,9,7,54,44,10,39
Linfield,2833,4,10,5,11,38,38,0,35
Cliftonville,2833,5,10,4,12,34,32,2,34
Ballymena,2833,6,8,4,14,27,48,-21,28
Glentoran,2833,7,6,6,10,24,32,-8,24
Dungannon,2833,8,2,4,16,14,47,-33,10
Crusaders,2834,1,16,7,3,63,32,31,55
Coleraine,2834,2,15,10,1,45,23,22,55
Linfield,2834,3,11,5,10,38,36,2,38
Glenavon,2834,4,9,9,8,53,45,8,36
Cliftonville,2834,5,9,4,13,32,32,0,31
Ballymena,2834,6,7,5,14,27,49,-22,26
Glentoran,2834,7,6,6,10,24,32,-8,24
Dungannon,2834,8,2,4,16,14,47,-33,10
Crusaders,2835,1,16,7,3,63,32,31,55
Coleraine,2835,2,15,10,1,47,24,23,55
Linfield,2835,3,11,5,10,38,36,2,38
Glenavon,2835,4,9,9,8,54,47,7,36
Cliftonville,2835,5,9,4,13,32,32,0,31
Ballymena,2835,6,7,5,14,27,49,-22,26
Glentoran,2835,7,6,6,10,24,32,-8,24
Dungannon,2835,8,2,4,16,14,47,-33,10
Crusaders,2836,1,17,6,3,65,32,33,57
Coleraine,2836,2,14,11,1,45,24,21,53
Linfield,2836,3,11,5,10,40,38,2,38
Glenavon,2836,4,9,10,7,54,45,9,37
Cliftonville,2836,5,9,4,13,34,34,0,31
Ballymena,2836,6,7,4,15,27,51,-24,25
Glentoran,2836,7,6,6,10,24,32,-8,24
Dungannon,2836,8,2,4,16,14,47,-33,10
Crusaders,2837,1,17,6,3,64,30,34,57
Coleraine,2837,2,14,10,2,43,29,14,52
Glenavon,2837,3,10,9,7,59,43,16,39
Linfield,2837,4,11,5,10,38,36,2,38
Cliftonville,2837,5,9,4,13,32,32,0,31
Ballymena,2837,6,7,4,15,25,50,-25,25
Glentoran,2837,7,6,6,10,24,32,-8,24
Dungannon,2837,8,2,4,16,14,47,-33,10
Crusaders,2838,1,17,6,3,64,30,34,57
Coleraine,2838,2,14,11,1,44,23,21,53
Glenavon,2838,3,9,10,7,53,44,9,37
Linfield,2838,4,10,6,10,38,37,1,36
Cliftonville,2838,5,9,5,12,33,32,1,32
Ballymena,2838,6,7,4,15,25,50,-25,25
Glentoran,2838,7,6,6,10,24,32,-8,24
Dungannon,2838,8,2,4,16,14,47,-33,10
Crusaders,2839,1,16,7,3,64,33,31,55
Coleraine,2839,2,14,10,2,43,24,19,52
Glenavon,2839,3,10,9,7,54,43,11,39
Linfield,2839,4,10,5,11,37,38,-1,35
Cliftonville,2839,5,10,4,12,34,31,3,34
Ballymena,2839,6,7,5,14,28,50,-22,26
Glentoran,2839,7,6,6,10,24,32,-8,24
Dungannon,2839,8,2,4,16,14,47,-33,10
Crusaders,2840,1,16,6,4,61,31,30,54
Coleraine,2840,2,14,11,1,44,23,21,53
Linfield,2840,3,11,5,10,40,37,3,38
Glenavon,2840,4,9,10,7,53,44,9,37
Cliftonville,2840,5,9,4,13,33,34,-1,31
Ballymena,2840,6,8,4,14,26,47,-21,28
Glentoran,2840,7,6,6,10,24,32,-8,24
Dungannon,2840,8,2,4,16,14,47,-33,10
Crusaders,2841,1,17,6,3,64,30,34,57
Coleraine,2841,2,14,11,1,46,25,21,53
Linfield,2841,3,11,5,10,40,37,3,38
Glenavon,2841,4,9,10,7,55,46,9,37
Cliftonville,2841,5,9,4,13,33,34,-1,31
Ballymena,2841,6,7,4,15,25,50,-25,25
Glentoran,2841,7,6,6,10,24,32,-8,24
Dungannon,2841,8,2,4,16,14,47,-33,10
Crusaders,2842,1,16,7,3,62,31,31,55
Coleraine,2842,2,15,10,1,45,22,23,55
Glenavon,2842,3,9,9,8,52,45,7,36
Linfield,2842,4,10,5,11,37,38,-1,35
Cliftonville,2842,5,10,4,12,34,31,3,34
Ballymena,2842,6,7,5,14,26,48,-22,26
Glentoran,2842,7,6,6,10,24,32,-8,24
Dungannon,2842,8,2,4,16,14,47,-33,10
Crusaders,2843,1,17,6,3,67,30,37,57
Coleraine,2843,2,14,10,2,43,23,20,52
Glenavon,2843,3,10,9,7,53,43,10,39
Linfield,2843,4,11,5,10,38,36,2,38
Cliftonville,2843,5,9,4,13,32,32,0,31
Ballymena,2843,6,7,4,15,25,53,-28,25
Glentoran,2843,7,6,6,10,24,32,-8,24
Dungannon,2843,8,2,4,16,14,47,-33,10
Crusaders,2844,1,17,6,3,65,32,33,57
Coleraine,2844,2,15,10,1,47,22,25,55
Linfield,2844,3,11,5,10,40,37,3,38
Glenavon,2844,4,9,9,8,52,47,5,36
Cliftonville,2844,5,9,4,13,33,34,-1,31
Ballymena,2844,6,7,4,15,27,51,-24,25
Glentoran,2844,7,6,6,10,24,32,-8,24
Dungannon,2844,8,2,4,16,14,47,-33,10
Coleraine,2845,1,15,10,1,44,22,22,55
Crusaders,2845,2,16,6,4,62,32,30,54
Glenavon,2845,3,9,9,8,52,44,8,36
Linfield,2845,4,10,6,10,37,36,1,36
Cliftonville,2845,5,9,5,12,32,31,1,32
Ballymena,2845,6,8,4,14,27,48,-21,28
Glentoran,2845,7,6,6,10,24,32,-8,24
Dungannon,2845,8,2,4,16,14,47,-33,10
Coleraine,2846,1,15,10,1,46,24,22,55
Crusaders,2846,2,16,6,4,63,33,30,54
Glenavon,2846,3,9,9,8,54,46,8,36
Linfield,2846,4,10,5,11,38,38,0,35
Cliftonville,2846,5,10,4,12,34,32,2,34
Ballymena,2846,6,8,4,14,28,49,-21,28
Glentoran,2846,7,6,6,10,24,32,-8,24
Dungannon,2846,8,2,4,16,14,47,-33,10
Crusaders,2847,1,17,6,3,62,30,32,57
Coleraine,2847,2,14,10,2,45,25,20,52
Glenavon,2847,3,10,9,7,55,45,10,39
Linfield,2847,4,10,6,10,37,36,1,36
Cliftonville,2847,5,9,5,12,32,31,1,32
Ballymena,2847,6,7,4,15,25,48,-23,25
Glentoran,2847,7,6,6,10,24,32,-8,24
Dungannon,2847,8,2,4,16,14,47,-33,10
Crusaders,2848,1,17,6,3,65,31,34,57
Coleraine,2848,2,15,10,1,46,23,23,55
Linfield,2848,3,11,5,10,38,36,2,38
Glenavon,2848,4,9,9,8,53,46,7,36
Cliftonville,2848,5,9,4,13,32,32,0,31
Ballymena,2848,6,7,4,15,26,51,-25,25
Glentoran,2848,7,6,6,10,24,32,-8,24
Dungannon,2848,8,2,4,16,14,47,-33,10
Crusaders,2849,1,17,6,3,64,32,32,57
Coleraine,2849,2,15,10,1,45,22,23,55
Linfield,2849,3,11,5,10,41,37,4,38
Glenavon,2849,4,9,9,8,52,45,7,36
Cliftonville,2849,5,9,4,13,33,35,-2,31
Ballymena,2849,6,7,4,15,27,50,-23,25
Glentoran,2849,7,6,6,10,24,32,-8,24
Dungannon,2849,8,2,4,16,14,47,-33,10
Coleraine,2850,1,15,10,1,45,23,22,55
Crusaders,2850,2,16,6,4,64,34,30,54
Linfield,2850,3,11,5,10,40,38,2,38
Glenavon,2850,4,9,9,8,53,45,8,36
Cliftonville,2850,5,9,4,13,34,34,0,31
Ballymena,2850,6,8,4,14,29,50,-21,28
Glentoran,2850,7,6,6,10,24,32,-8,24
Dungannon,2850,8,2,4,16,14,47,-33,10
Crusaders,2851,1,17,6,3,64,31,33,57
Coleraine,2851,2,14,11,1,44,23,21,53
Glenavon,2851,3,9,10,7,53,44,9,37
Linfield,2851,4,10,5,11,37,37,0,35
Cliftonville,2851,5,10,4,12,33,31,2,34
Ballymena,2851,6,7,4,15,26,50,-24,25
Glentoran,2851,7,6,6,10,24,32,-8,24
Dungannon,2851,8,2,4,16,14,47,-33,10
Crusaders,2852,1,16,7,3,62,31,31,55
Coleraine,2852,2,14,10,2,44,26,18,52
Glenavon,2852,3,10,9,7,56,44,12,39
Linfield,2852,4,11,5,10,39,36,3,38
Cliftonville,2852,5,9,4,13,32,33,-1,31
Ballymena,2852,6,7,5,14,26,48,-22,26
Glentoran,2852,7,6,6,10,24,32,-8,24
Dungannon,2852,8,2,4,16,14,47,-33,10
Crusaders,2853,1,17,6,3,63,31,32,57
Coleraine,2853,2,14,10,2,44,24,20,52
Glenavon,2853,3,10,9,7,54,44,10,39
Linfield,2853,4,11,5,10,39,37,2,38
Cliftonville,2853,5,9,4,13,33,33,0,31
Ballymena,2853,6,7,4,15,26,49,-23,25
Glentoran,2853,7,6,6,10,24,32,-8,24
Dungannon,2853,8,2,4,16,14,47,-33,10
Coleraine,2854,1,15,10,1,46,23,23,55
Crusaders,2854,2,16,6,4,62,32,30,54
Linfield,2854,3,11,5,10,42,36,6,38
Glenavon,2854,4,9,9,8,53,46,7,36
Cliftonville,2854,5,9,4,13,32,36,-4,31
Ballymena,2854,6,8,4,14,27,48,-21,28
Glentoran,2854,7,6,6,10,24,32,-8,24
Dungannon,2854,8,2,4,16,14,47,-33,10
Crusaders,2855,1,16,7,3,61,30,31,55
Coleraine,2855,2,14,10,2,43,25,18,52
Glenavon,2855,3,10,9,7,55,43,12,39
Linfield,2855,4,10,6,10,37,36,1,36
Cliftonville,2855,5,9,5,12,32,31,1,32
Ballymena,2855,6,7,5,14,25,47,-22,26
Glentoran,2855,7,6,6,10,24,32,-8,24
Dungannon,2855,8,2,4,16,14,47,-33,10
Crusaders,2856,1,17,6,3,63,30,33,57
Coleraine,2856,2,14,11,1,43,22,21,53
Glenavon,2856,3,9,10,7,52,43,9,37
Linfield,2856,4,10,6,10,38,37,1,36
Cliftonville,2856,5,9,5,12,33,32,1,32
Ballymena,2856,6,7,4,15,25,49,-24,25
Glentoran,2856,7,6,6,10,24,32,-8,24
Dungannon,2856,8,2,4,16,14,47,-33,10
Crusaders,2857,1,17,6,3,64,32,32,57
Coleraine,2857,2,15,10,1,47,22,25,55
Linfield,2857,3,11,5,10,38,36,2,38
Glenavon,2857,4,9,9,8,52,47,5,36
Cliftonville,2857,5,9,4,13,32,32,0,31
Ballymena,2857,6,7,4,15,27,50,-23,25
Glentoran,2857,7,6,6,10,24,32,-8,24
Dungannon,2857,8,2,4,16,14,47,-33,10
Crusaders,2858,1,17,6,3,65,30,35,57
Coleraine,2858,2,14,11,1,44,23,21,53
Linfield,2858,3,11,5,10,39,37,2,38
Glenavon,2858,4,9,10,7,53,44,9,37
Cliftonville,2858,5,9,4,13,33,33,0,31
Ballymena,2858,6,7,4,15,25,51,-26,25
Glentoran,2858,7,6,6,10,24,32,-8,24
Dungannon,2858,8,2,4,16,14,47,-33,10
Crusaders,2859,1,16,7,3,63,32,31,55
Coleraine,2859,2,14,11,1,43,22,21,53
Glenavon,2859,3,9,10,7,52,43,9,37
Linfield,2859,4,10,5,11,37,37,0,35
Cliftonville,2859,5,10,4,12,33,31,2,34
Ballymena,2859,6,7,5,14,27,49,-22,26
Glentoran,2859,7,6,6,10,24,32,-8,24
Dungannon,2859,8,2,4,16,14,47,-33,10
Crusaders,2860,1,16,7,3,63,32,31,55
Coleraine,2860,2,14,10,2,46,26,20,52
Glenavon,2860,3,10,9,7,56,46,10,39
Linfield,2860,4,10,5,11,37,37,0,35
Cliftonville,2860,5,10,4,12,33,31,2,34
Ballymena,2860,6,7,5,14,27,49,-22,26
Glentoran,2860,7,6,6,10,24,32,-8,24
Dungannon,2860,8,2,4,16,14,47,-33,10
Coleraine,2861,1,15,10,1,45,23,22,55
Crusaders,2861,2,16,6,4,62,32,30,54
Linfield,2861,3,11,5,10,40,36,4,38
Glenavon,2861,4,9,9,8,53,45,8,36
Cliftonville,2861,5,9,4,13,32,34,-2,31
Ballymena,2861,6,8,4,14,27,48,-21,28
Glentoran,2861,7,6,6,10,24,32,-8,24
Dungannon,2861,8,2,4,16,14,47,-33,10
Coleraine,2862,1,15,10,1,44,22,22,55
Crusaders,2862,2,16,6,4,61,31,30,54
Glenavon,2862,3,9,9,8,52,44,8,36
Linfield,2862,4,10,6,10,38,37,1,36
Cliftonville,2862,5,9,5,12,33,32,1,32
Ballymena,2862,6,8,4,14,26,47,-21,28
Glentoran,2862,7,6,6,10,24,32,-8,24
Dungannon,2862,8,2,4,16,14,47,-33,10
Crusaders,2863,1,16,7,3,61,30,31,55
Coleraine,2863,2,15,10,1,44,22,22,55
Glenavon,2863,3,9,9,8,52,44,8,36
Linfield,2863,4,10,6,10,38,37,1,36
Cliftonville,2863,5,9,5,12,33,32,1,32
Ballymena,2863,6,7,5,14,25,47,-22,26
Glentoran,2863,7,6,6,10,24,32,-8,24
Dungannon,2863,8,2,4,16,14,47,-33,10
Crusaders,2864,1,17,6,3,63,30,33,57
Coleraine,2864,2,14,10,2,44,24,20,52
Glenavon,2864,3,10,9,7,54,44,10,39
Linfield,2864,4,11,5,10,39,37,2,38
Cliftonville,2864,5,9,4,13,33,33,0,31
Ballymena,2864,6,7,4,15,25,49,-24,25
Glentoran,2864,7,6,6,10,24,32,-8,24
Dungannon,2864,8,2,4,16,14,47,-33,10
Crusaders,2865,1,16,7,3,64,33,31,55
Coleraine,2865,2,14,10,2,44,24,20,52
Glenavon,2865,3,10,9,7,54,44,10,39
Linfield,2865,4,10,6,10,38,37,1,36
Cliftonville,2865,5,9,5,12,33,32,1,32
Ballymena,2865,6,7,5,14,28,50,-22,26
Glentoran,2865,7,6,6,10,24,32,-8,24
Dungannon,2865,8,2,4,16,14,47,-33,10
Crusaders,2866,1,17,6,3,63,30,33,57
Coleraine,2866,2,14,10,2,44,25,19,52
Glenavon,2866,3,10,9,7,55,44,11,39
Linfield,2866,4,10,5,11,38,39,-1,35
Cliftonville,2866,5,10,4,12,35,32,3,34
Ballymena,2866,6,7,4,15,25,49,-24,25
Glentoran,2866,7,6,6,10,24,32,-8,24
Dungannon,2866,8,2,4,16,14,47,-33,10
Crusaders,2867,1,16,6,4,63,35,28,54
Coleraine,2867,2,14,10,2,44,24,20,52
Glenavon,2867,3,10,9,7,54,44,10,39
Linfield,2867,4,10,5,11,38,38,0,35
Cliftonville,2867,5,10,4,12,34,32,2,34
Ballymena,2867,6,8,4,14,30,49,-19,28
Glentoran,2867,7,6,6,10,24,32,-8,24
Dungannon,2867,8,2,4,16,14,47,-33,10
Crusaders,2868,1,17,6,3,63,31,32,57
Coleraine,2868,2,14,10,2,43,26,17,52
Glenavon,2868,3,10,9,7,56,43,13,39
Linfield,2868,4,10,5,11,37,38,-1,35
Cliftonville,2868,5,10,4,12,34,31,3,34
Ballymena,2868,6,7,4,15,26,49,-23,25
Glentoran,2868,7,6,6,10,24,32,-8,24
Dungannon,2868,8,2,4,16,14,47,-33,10
Crusaders,2869,1,16,7,3,64,33,31,55
Coleraine,2869,2,15,10,1,46,22,24,55
Glenavon,2869,3,9,9,8,52,46,6,36
Linfield,2869,4,10,6,10,39,38,1,36
Cliftonville,2869,5,9,5,12,34,33,1,32
Ballymena,2869,6,7,5,14,28,50,-22,26
Glentoran,2869,7,6,6,10,24,32,-8,24
Dungannon,2869,8,2,4,16,14,47,-33,10
Crusaders,2870,1,17,6,3,65,32,33,57
Coleraine,2870,2,15,10,1,46,23,23,55
Linfield,2870,3,11,5,10,41,36,5,38
Glenavon,2870,4,9,9,8,53,46,7,36
Cliftonville,2870,5,9,4,13,32,35,-3,31
Ballymena,2870,6,7,4,15,27,51,-24,25
Glentoran,2870,7,6,6,10,24,32,-8,24
Dungannon,2870,8,2,4,16,14,47,-33,10
Coleraine,2871,1,15,10,1,46,22,24,55
Crusaders,2871,2,16,6,4,62,34,28,54
Glenavon,2871,3,9,9,8,52,46,6,36
Linfield,2871,4,10,6,10,38,37,1,36
Cliftonville,2871,5,9,5,12,33,32,1,32
Ballymena,2871,6,8,4,14,29,48,-19,28
Glentoran,2871,7,6,6,10,24,32,-8,24
Dungannon,2871,8,2,4,16,14,47,-33,10
Crusaders,2872,1,17,6,3,63,30,33,57
Coleraine,2872,2,14,11,1,44,23,21,53
Glenavon,2872,3,9,10,7,53,44,9,37
Linfield,2872,4,10,6,10,38,37,1,36
Cliftonville,2872,5,9,5,12,33,32,1,32
Ballymena,2872,6,7,4,15,25,49,-24,25
Glentoran,2872,7,6,6,10,24,32,-8,24
Dungannon,2872,8,2,4,16,14,47,-33,10
Crusaders,2873,1,17,6,3,65,30,35,57
Coleraine,2873,2,14,10,2,44,24,20,52
Glenavon,2873,3,10,9,7,54,44,10,39
Linfield,2873,4,11,5,10,38,36,2,38
Cliftonville,2873,5,9,4,13,32,32,0,31
Ballymena,2873,6,7,4,15,25,51,-26,25
Glentoran,2873,7,6,6,10,24,32,-8,24
Dungannon,2873,8,2,4,16,14,47,-33,10
Crusaders,2874,1,16,7,3,62,31,31,55
Coleraine,2874,2,14,11,1,45,24,21,53
Glenavon,2874,3,9,10,7,54,45,9,37
Linfield,2874,4,10,5,11,38,38,0,35
Cliftonville,2874,5,10,4,12,34,32,2,34
Ballymena,2874,6,7,5,14,26,48,-22,26
Glentoran,2874,7,6,6,10,24,32,-8,24
Dungannon,2874,8,2,4,16,14,47,-33,10
Crusaders,2875,1,17,6,3,63,31,32,57
Coleraine,2875,2,14,11,1,44,23,21,53
Linfield,2875,3,11,5,10,39,37,2,38
Glenavon,2875,4,9,10,7,53,44,9,37
Cliftonville,2875,5,9,4,13,33,33,0,31
Ballymena,2875,6,7,4,15,26,49,-23,25
Glentoran,2875,7,6,6,10,24,32,-8,24
Dungannon,2875,8,2,4,16,14,47,-33,10
Crusaders,2876,1,17,6,3,64,31,33,57
Coleraine,2876,2,14,10,2,43,25,18,52
Glenavon,2876,3,10,9,7,55,43,12,39
Linfield,2876,4,10,6,10,38,37,1,36
Cliftonville,2876,5,9,5,12,33,32,1,32
Ballymena,2876,6,7,4,15,26,50,-24,25
Glentoran,2876,7,6,6,10,24,32,-8,24
Dungannon,2876,8,2,4,16,14,47,-33,10
Coleraine,2877,1,15,10,1,45,22,23,55
Crusaders,2877,2,16,6,4,62,32,30,54
Glenavon,2877,3,9,9,8,52,45,7,36
Linfield,2877,4,10,6,10,39,38,1,36
Cliftonville,2877,5,9,5,12,34,33,1,32
Ballymena,2877,6,8,4,14,27,48,-21,28
Glentoran,2877,7,6,6,10,24,32,-8,24
Dungannon,2877,8,2,4,16,14,47,-33,10
Crusaders,2878,1,17,6,3,64,32,32,57
Coleraine,2878,2,14,10,2,43,24,19,52
Glenavon,2878,3,10,9,7,54,43,11,39
Linfield,2878,4,11,5,10,38,36,2,38
Cliftonville,2878,5,9,4,13,32,32,0,31
Ballymena,2878,6,7,4,15,27,50,-23,25
Glentoran,2878,7,6,6,10,24,32,-8,24
Dungannon,2878,8,2,4,16,14,47,-33,10
Crusaders,2879,1,17,6,3,66,32,34,57
Coleraine,2879,2,14,10,2,43,25,18,52
Glenavon,2879,3,10,9,7,55,43,12,39
Linfield,2879,4,11,5,10,40,37,3,38
Cliftonville,2879,5,9,4,13,33,34,-1,31
Ballymena,2879,6,7,4,15,27,52,-25,25
Glentoran,2879,7,6,6,10,24,32,-8,24
Dungannon,2879,8,2,4,16,14,47,-33,10
Crusaders,2880,1,16,7,3,64,33,31,55
Coleraine,2880,2,14,10,2,44,24,20,52
Glenavon,2880,3,10,9,7,54,44,10,39
Linfield,2880,4,10,5,11,38,39,-1,35
Cliftonville,2880,5,10,4,12,35,32,3,34
Ballymena,2880,6,7,5,14,28,50,-22,26
Glentoran,2880,7,6,6,10,24,32,-8,24
Dungannon,2880,8,2,4,16,14,47,-33,10
Crusaders,2881,1,17,6,3,62,30,32,57
Coleraine,2881,2,14,10,2,45,25,20,52
Glenavon,2881,3,10,9,7,55,45,10,39
Linfield,2881,4,10,5,11,37,37,0,35
Cliftonville,2881,5,10,4,12,33,31,2,34
Ballymena,2881,6,7,4,15,25,48,-23,25
Glentoran,2881,7,6,6,10,24,32,-8,24
Dungannon,2881,8,2,4,16,14,47,-33,10
Crusaders,2882,1,16,7,3,62,31,31,55
Coleraine,2882,2,14,10,2,45,26,19,52
Glenavon,2882,3,10,9,7,56,45,11,39
Linfield,2882,4,11,5,10,40,38,2,38
Cliftonville,2882,5,9,4,13,34,34,0,31
Ballymena,2882,6,7,5,14,26,48,-22,26
Glentoran,2882,7,6,6,10,24,32,-8,24
Dungannon,2882,8,2,4,16,14,47,-33,10
Crusaders,2883,1,17,6,3,63,30,33,57
Coleraine,2883,2,14,10,2,44,24,20,52
Glenavon,2883,3,10,9,7,54,44,10,39
Linfield,2883,4,10,5,11,39,39,0,35
Cliftonville,2883,5,10,4,12,35,33,2,34
Ballymena,2883,6,7,4,15,25,49,-24,25
Glentoran,2883,7,6,6,10,24,32,-8,24
Dungannon,2883,8,2,4,16,14,47,-33,10
Crusaders,2884,1,17,6,3,63,31,32,57
Coleraine,2884,2,14,10,2,46,26,20,52
Glenavon,2884,3,10,9,7,56,46,10,39
Linfield,2884,4,10,5,11,38,38,0,35
Cliftonville,2884,5,10,4,12,34,32,2,34
Ballymena,2884,6,7,4,15,26,49,-23,25
Glentoran,2884,7,6,6,10,24,32,-8,24
Dungannon,2884,8,2,4,16,14,47,-33,10
Crusaders,2885,1,17,6,3,63,31,32,57
Coleraine,2885,2,14,10,2,43,23,20,52
Glenavon,2885,3,10,9,7,53,43,10,39
Linfield,2885,4,10,5,11,37,38,-1,35
Cliftonville,2885,5,10,4,12,34,31,3,34
Ballymena,2885,6,7,4,15,26,49,-23,25
Glentoran,2885,7,6,6,10,24,32,-8,24
Dungannon,2885,8,2,4,16,14,47,-33,10
Crusaders,2886,1,16,7,3,63,32,31,55
Coleraine,2886,2,14,11,1,44,23,21,53
Glenavon,2886,3,9,10,7,53,44,9,37
Linfield,2886,4,10,6,10,38,37,1,36
Cliftonville,2886,5,9,5,12,33,32,1,32
Ballymena,2886,6,7,5,14,27,49,-22,26
Glentoran,2886,7,6,6,10,24,32,-8,24
Dungannon,2886,8,2,4,16,14,47,-33,10
Crusaders,2887,1,16,6,4,62,33,29,54
Coleraine,2887,2,14,10,2,44,27,17,52
Glenavon,2887,3,10,9,7,57,44,13,39
Linfield,2887,4,10,5,11,39,39,0,35
Cliftonville,2887,5,10,4,12,35,33,2,34
Ballymena,2887,6,8,4,14,28,48,-20,28
Glentoran,2887,7,6,6,10,24,32,-8,24
Dungannon,2887,8,2,4,16,14,47,-33,10
Crusaders,2888,1,17,6,3,62,30,32,57
Coleraine,2888,2,15,10,1,45,22,23,55
Glenavon,2888,3,9,9,8,52,45,7,36
Linfield,2888,4,10,6,10,38,37,1,36
Cliftonville,2888,5,9,5,12,33,32,1,32
Ballymena,2888,6,7,4,15,25,48,-23,25
Glentoran,2888,7,6,6,10,24,32,-8,24
Dungannon,2888,8,2,4,16,14,47,-33,10
Crusaders,2889,1,17,6,3,64,30,34,57
Coleraine,2889,2,14,11,1,43,22,21,53
Glenavon,2889,3,9,10,7,52,43,9,37
Linfield,2889,4,10,5,11,39,39,0,35
Cliftonville,2889,5,10,4,12,35,33,2,34
Ballymena,2889,6,7,4,15,25,50,-25,25
Glentoran,2889,7,6,6,10,24,32,-8,24
Dungannon,2889,8,2,4,16,14,47,-33,10
Crusaders,2890,1,16,7,3,61,30,31,55
Coleraine,2890,2,15,10,1,45,22,23,55
Glenavon,2890,3,9,9,8,52,45,7,36
Linfield,2890,4,10,6,10,39,38,1,36
Cliftonville,2890,5,9,5,12,34,33,1,32
Ballymena,2890,6,7,5,14,25,47,-22,26
Glentoran,2890,7,6,6,10,24,32,-8,24
Dungannon,2890,8,2,4,16,14,47,-33,10
Crusaders,2891,1,17,6,3,64,32,32,57
Coleraine,2891,2,14,10,2,45,26,19,52
Glenavon,2891,3,10,9,7,56,45,11,39
Linfield,2891,4,11,5,10,39,36,3,38
Cliftonville,2891,5,9,4,13,32,33,-1,31
Ballymena,2891,6,7,4,15,27,50,-23,25
Glentoran,2891,7,6,6,10,24,32,-8,24
Dungannon,2891,8,2,4,16,14,47,-33,10
Crusaders,2892,1,17,6,3,64,32,32,57
Coleraine,2892,2,15,10,1,47,22,25,55
Glenavon,2892,3,9,9,8,52,47,5,36
Linfield,2892,4,10,6,10,37,36,1,36
Cliftonville,2892,5,9,5,12,32,31,1,32
Ballymena,2892,6,7,4,15,27,50,-23,25
Glentoran,2892,7,6,6,10,24,32,-8,24
Dungannon,2892,8,2,4,16,14,47,-33,10
Coleraine,2893,1,15,10,1,46,24,22,55
Crusaders,2893,2,16,6,4,61,31,30,54
Glenavon,2893,3,9,9,8,54,46,8,36
Linfield,2893,4,10,5,11,39,41,-2,35
Cliftonville,2893,5,10,4,12,37,33,4,34
Ballymena,2893,6,8,4,14,26,47,-21,28
Glentoran,2893,7,6,6,10,24,32,-8,24
Dungannon,2893,8,2,4,16,14,47,-33,10
Crusaders,2894,1,16,7,3,62,31,31,55
Coleraine,2894,2,15,10,1,46,24,22,55
Glenavon,2894,3,9,9,8,54,46,8,36
Linfield,2894,4,10,5,11,38,40,-2,35
Cliftonville,2894,5,10,4,12,36,32,4,34
Ballymena,2894,6,7,5,14,26,48,-22,26
Glentoran,2894,7,6,6,10,24,32,-8,24
Dungannon,2894,8,2,4,16,14,47,-33,10
Crusaders,2895,1,17,6,3,63,30,33,57
Coleraine,2895,2,15,10,1,46,23,23,55
Glenavon,2895,3,9,9,8,53,46,7,36
Linfield,2895,4,10,6,10,39,38,1,36
Cliftonville,2895,5,9,5,12,34,33,1,32
Ballymena,2895,6,7,4,15,25,49,-24,25
Glentoran,2895,7,6,6,10,24,32,-8,24
Dungannon,2895,8,2,4,16,14,47,-33,10
Crusaders,2896,1,17,6,3,65,31,34,57
Coleraine,2896,2,14,10,2,44,25,19,52
Glenavon,2896,3,10,9,7,55,44,11,39
Linfield,2896,4,11,5,10,39,37,2,38
Cliftonville,2896,5,9,4,13,33,33,0,31
Ballymena,2896,6,7,4,15,26,51,-25,25
Glentoran,2896,7,6,6,10,24,32,-8,24
Dungannon,2896,8,2,4,16,14,47,-33,10
Crusaders,2897,1,17,6,3,63,30,33,57
Coleraine,2897,2,14,10,2,44,24,20,52
Glenavon,2897,3,10,9,7,54,44,10,39
Linfield,2897,4,11,5,10,41,38,3,38
Cliftonville,2897,5,9,4,13,34,35,-1,31
Ballymena,2897,6,7,4,15,25,49,-24,25
Glentoran,2897,7,6,6,10,24,32,-8,24
Dungannon,2897,8,2,4,16,14,47,-33,10
Crusaders,2898,1,17,6,3,63,30,33,57
Coleraine,2898,2,14,11,1,44,23,21,53
Linfield,2898,3,11,5,10,40,36,4,38
Glenavon,2898,4,9,10,7,53,44,9,37
Cliftonville,2898,5,9,4,13,32,34,-2,31
Ballymena,2898,6,7,4,15,25,49,-24,25
Glentoran,2898,7,6,6,10,24,32,-8,24
Dungannon,2898,8,2,4,16,14,47,-33,10
Crusaders,2899,1,17,6,3,64,30,34,57
Coleraine,2899,2,15,10,1,46,22,24,55
Linfield,2899,3,11,5,10,40,37,3,38
Glenavon,2899,4,9,9,8,52,46,6,36
Cliftonville,2899,5,9,4,13,33,34,-1,31
Ballymena,2899,6,7,4,15,25,50,-25,25
Glentoran,2899,7,6,6,10,24,32,-8,24
Dungannon,2899,8,2,4,16,14,47,-33,10
Crusaders,2900,1,16,6,4,61,32,29,54
Coleraine,2900,2,14,10,2,44,26,18,52
Glenavon,2900,3,10,9,7,56,44,12,39
Linfield,2900,4,10,6,10,38,37,1,36
Cliftonville,2900,5,9,5,12,33,32,1,32
Ballymena,2900,6,8,4,14,27,47,-20,28
Glentoran,2900,7,6,6,10,24,32,-8,24
Dungannon,2900,8,2,4,16,14,47,-33,10
Crusaders,2901,1,17,6,3,62,30,32,57
Coleraine,2901,2,14,10,2,44,24,20,52
Glenavon,2901,3,10,9,7,54,44,10,39
Linfield,2901,4,10,5,11,38,38,0,35
Cliftonville,2901,5,10,4,12,34,32,2,34
Ballymena,2901,6,7,4,15,25,48,-23,25
Glentoran,2901,7,6,6,10,24,32,-8,24
Dungannon,2901,8,2,4,16,14,47,-33,10
Crusaders,2902,1,17,6,3,63,31,32,57
Coleraine,2902,2,14,10,2,43,23,20,52
Glenavon,2902,3,10,9,7,53,43,10,39
Linfield,2902,4,11,5,10,39,37,2,38
Cliftonville,2902,5,9,4,13,33,33,0,31
Ballymena,2902,6,7,4,15,26,49,-23,25
Glentoran,2902,7,6,6,10,24,32,-8,24
Dungannon,2902,8,2,4,16,14,47,-33,10
Crusaders,2903,1,17,6,3,66,34,32,57
Coleraine,2903,2,14,11,1,43,22,21,53
Linfield,2903,3,11,5,10,39,36,3,38
Glenavon,2903,4,9,10,7,52,43,9,37
Cliftonville,2903,5,9,4,13,32,33,-1,31
Ballymena,2903,6,7,4,15,29,52,-23,25
Glentoran,2903,7,6,6,10,24,32,-8,24
Dungannon,2903,8,2,4,16,14,47,-33,10
Crusaders,2904,1,16,6,4,62,32,30,54
Coleraine,2904,2,14,10,2,46,27,19,52
Glenavon,2904,3,10,9,7,57,46,11,39
Linfield,2904,4,10,6,10,37,36,1,36
Cliftonville,2904,5,9,5,12,32,31,1,32
Ballymena,2904,6,8,4,14,27,48,-21,28
Glentoran,2904,7,6,6,10,24,32,-8,24
Dungannon,2904,8,2,4,16,14,47,-33,10
Coleraine,2905,1,15,10,1,44,22,22,55
Crusaders,2905,2,16,6,4,62,36,26,54
Glenavon,2905,3,9,9,8,52,44,8,36
Linfield,2905,4,10,5,11,37,37,0,35
Cliftonville,2905,5,10,4,12,33,31,2,34
Ballymena,2905,6,8,4,14,31,48,-17,28
Glentoran,2905,7,6,6,10,24,32,-8,24
Dungannon,2905,8,2,4,16,14,47,-33,10
Crusaders,2906,1,16,6,4,62,34,28,54
Coleraine,2906,2,14,11,1,44,23,21,53
Linfield,2906,3,11,5,10,38,36,2,38
Glenavon,2906,4,9,10,7,53,44,9,37
Cliftonville,2906,5,9,4,13,32,32,0,31
Ballymena,2906,6,8,4,14,29,48,-19,28
Glentoran,2906,7,6,6,10,24,32,-8,24
Dungannon,2906,8,2,4,16,14,47,-33,10
Crusaders,2907,1,16,6,4,63,34,29,54
Coleraine,2907,2,14,10,2,43,24,19,52
Glenavon,2907,3,10,9,7,54,43,11,39
Linfield,2907,4,11,5,10,38,36,2,38
Cliftonville,2907,5,9,4,13,32,32,0,31
Ballymena,2907,6,8,4,14,29,49,-20,28
Glentoran,2907,7,6,6,10,24,32,-8,24
Dungannon,2907,8,2,4,16,14,47,-33,10
Crusaders,2908,1,17,6,3,67,31,36,57
Coleraine,2908,2,14,11,1,43,22,21,53
Linfield,2908,3,11,5,10,40,36,4,38
Glenavon,2908,4,9,10,7,52,43,9,37
Cliftonville,2908,5,9,4,13,32,34,-2,31
Ballymena,2908,6,7,4,15,26,53,-27,25
Glentoran,2908,7,6,6,10,24,32,-8,24
Dungannon,2908,8,2,4,16,14,47,-33,10
Crusaders,2909,1,17,6,3,65,31,34,57
Coleraine,2909,2,14,10,2,44,25,19,52
Glenavon,2909,3,10,9,7,55,44,11,39
Linfield,2909,4,10,5,11,38,38,0,35
Cliftonville,2909,5,10,4,12,34,32,2,34
Ballymena,2909,6,7,4,15,26,51,-25,25
Glentoran,2909,7,6,6,10,24,32,-8,24
Dungannon,2909,8,2,4,16,14,47,-33,10
Crusaders,2910,1,17,6,3,64,30,34,57
Coleraine,2910,2,14,10,2,43,25,18,52
Glenavon,2910,3,10,9,7,55,43,12,39
Linfield,2910,4,10,5,11,37,37,0,35
Cliftonville,2910,5,10,4,12,33,31,2,34
Ballymena,2910,6,7,4,15,25,50,-25,25
Glentoran,2910,7,6,6,10,24,32,-8,24
Dungannon,2910,8,2,4,16,14,47,-33,10
Crusaders,2911,1,17,6,3,64,31,33,57
Coleraine,2911,2,15,10,1,45,23,22,55
Glenavon,2911,3,9,9,8,53,45,8,36
Linfield,2911,4,10,6,10,38,37,1,36
Cliftonville,2911,5,9,5,12,33,32,1,32
Ballymena,2911,6,7,4,15,26,50,-24,25
Glentoran,2911,7,6,6,10,24,32,-8,24
Dungannon,2911,8,2,4,16,14,47,-33,10
Crusaders,2912,1,16,7,3,61,30,31,55
Coleraine,2912,2,14,10,2,44,24,20,52
Glenavon,2912,3,10,9,7,54,44,10,39
Linfield,2912,4,11,5,10,41,37,4,38
Cliftonville,2912,5,9,4,13,33,35,-2,31
Ballymena,2912,6,7,5,14,25,47,-22,26
Glentoran,2912,7,6,6,10,24,32,-8,24
Dungannon,2912,8,2,4,16,14,47,-33,10
Crusaders,2913,1,17,6,3,64,31,33,57
Coleraine,2913,2,14,10,2,44,25,19,52
Glenavon,2913,3,10,9,7,55,44,11,39
Linfield,2913,4,10,5,11,38,39,-1,35
Cliftonville,2913,5,10,4,12,35,32,3,34
Ballymena,2913,6,7,4,15,26,50,-24,25
Glentoran,2913,7,6,6,10,24,32,-8,24
Dungannon,2913,8,2,4,16,14,47,-33,10
Crusaders,2914,1,16,7,3,62,31,31,55
Coleraine,2914,2,14,10,2,44,25,19,52
Glenavon,2914,3,10,9,7,55,44,11,39
Linfield,2914,4,10,5,11,38,38,0,35
Cliftonville,2914,5,10,4,12,34,32,2,34
Ballymena,2914,6,7,5,14,26,48,-22,26
Glentoran,2914,7,6,6,10,24,32,-8,24
Dungannon,2914,8,2,4,16,14,47,-33,10
Crusaders,2915,1,16,7,3,62,31,31,55
Coleraine,2915,2,14,11,1,44,23,21,53
Glenavon,2915,3,9,10,7,53,44,9,37
Linfield,2915,4,10,5,11,38,38,0,35
Cliftonville,2915,5,10,4,12,34,32,2,34
Ballymena,2915,6,7,5,14,26,48,-22,26
Glentoran,2915,7,6,6,10,24,32,-8,24
Dungannon,2915,8,2,4,16,14,47,-33,10
Crusaders,2916,1,16,7,3,62,31,31,55
Coleraine,2916,2,14,10,2,45,26,19,52
Glenavon,2916,3,10,9,7,56,45,11,39
Linfield,2916,4,11,5,10,39,37,2,38
Cliftonville,2916,5,9,4,13,33,33,0,31
Ballymena,2916,6,7,5,14,26,48,-22,26
Glentoran,2916,7,6,6,10,24,32,-8,24
Dungannon,2916,8,2,4,16,14,47,-33,10
Crusaders,2917,1,16,6,4,62,34,28,54
Coleraine,2917,2,14,10,2,44,24,20,52
Glenavon,2917,3,10,9,7,54,44,10,39
Linfield,2917,4,11,5,10,41,37,4,38
Cliftonville,2917,5,9,4,13,33,35,-2,31
Ballymena,2917,6,8,4,14,29,48,-19,28
Glentoran,2917,7,6,6,10,24,32,-8,24
Dungannon,2917,8,2,4,16,14,47,-33,10
Crusaders,2918,1,17,6,3,66,30,36,57
Coleraine,2918,2,14,11,1,44,23,21,53
Glenavon,2918,3,9,10,7,53,44,9,37
Linfield,2918,4,10,5,11,38,39,-1,35
Cliftonville,2918,5,10,4,12,35,32,3,34
Ballymena,2918,6,7,4,15,25,52,-27,25
Glentoran,2918,7,6,6,10,24,32,-8,24
Dungannon,2918,8,2,4,16,14,47,-33,10
Crusaders,2919,1,17,6,3,65,33,32,57
Coleraine,2919,2,14,11,1,44,23,21,53
Glenavon,2919,3,9,10,7,53,44,9,37
Linfield,2919,4,10,6,10,39,38,1,36
Cliftonville,2919,5,9,5,12,34,33,1,32
Ballymena,2919,6,7,4,15,28,51,-23,25
Glentoran,2919,7,6,6,10,24,32,-8,24
Dungannon,2919,8,2,4,16,14,47,-33,10
Crusaders,2920,1,16,7,3,63,32,31,55
Coleraine,2920,2,14,11,1,44,23,21,53
Linfield,2920,3,11,5,10,39,36,3,38
Glenavon,2920,4,9,10,7,53,44,9,37
Cliftonville,2920,5,9,4,13,32,33,-1,31
Ballymena,2920,6,7,5,14,27,49,-22,26
Glentoran,2920,7,6,6,10,24,32,-8,24
Dungannon,2920,8,2,4,16,14,47,-33,10
Crusaders,2921,1,17,6,3,62,30,32,57
Coleraine,2921,2,14,10,2,44,26,18,52
Glenavon,2921,3,10,9,7,56,44,12,39
Linfield,2921,4,10,6,10,37,36,1,36
Cliftonville,2921,5,9,5,12,32,31,1,32
Ballymena,2921,6,7,4,15,25,48,-23,25
Glentoran,2921,7,6,6,10,24,32,-8,24
Dungannon,2921,8,2,4,16,14,47,-33,10
Crusaders,2922,1,16,7,3,62,31,31,55
Coleraine,2922,2,15,10,1,45,23,22,55
Linfield,2922,3,11,5,10,40,37,3,38
Glenavon,2922,4,9,9,8,53,45,8,36
Cliftonville,2922,5,9,4,13,33,34,-1,31
Ballymena,2922,6,7,5,14,26,48,-22,26
Glentoran,2922,7,6,6,10,24,32,-8,24
Dungannon,2922,8,2,4,16,14,47,-33,10
Crusaders,2923,1,16,7,3,62,31,31,55
Coleraine,2923,2,14,10,2,44,24,20,52
Glenavon,2923,3,10,9,7,54,44,10,39
Linfield,2923,4,11,5,10,38,36,2,38
Cliftonville,2923,5,9,4,13,32,32,0,31
Ballymena,2923,6,7,5,14,26,48,-22,26
Glentoran,2923,7,6,6,10,24,32,-8,24
Dungannon,2923,8,2,4,16,14,47,-33,10
Crusaders,2924,1,17,6,3,64,31,33,57
Coleraine,2924,2,14,11,1,46,25,21,53
Glenavon,2924,3,9,10,7,55,46,9,37
Linfield,2924,4,10,5,11,37,40,-3,35
Cliftonville,2924,5,10,4,12,36,31,5,34
Ballymena,2924,6,7,4,15,26,50,-24,25
Glentoran,2924,7,6,6,10,24,32,-8,24
Dungannon,2924,8,2,4,16,14,47,-33,10
Crusaders,2925,1,17,6,3,63,30,33,57
Coleraine,2925,2,14,11,1,43,22,21,53
Linfield,2925,3,11,5,10,39,36,3,38
Glenavon,2925,4,9,10,7,52,43,9,37
Cliftonville,2925,5,9,4,13,32,33,-1,31
Ballymena,2925,6,7,4,15,25,49,-24,25
Glentoran,2925,7,6,6,10,24,32,-8,24
Dungannon,2925,8,2,4,16,14,47,-33,10
Crusaders,2926,1,16,7,3,62,31,31,55
Coleraine,2926,2,14,11,1,46,25,21,53
Linfield,2926,3,11,5,10,39,36,3,38
Glenavon,2926,4,9,10,7,55,46,9,37
Cliftonville,2926,5,9,4,13,32,33,-1,31
Ballymena,2926,6,7,5,14,26,48,-22,26
Glentoran,2926,7,6,6,10,24,32,-8,24
Dungannon,2926,8,2,4,16,14,47,-33,10
Crusaders,2927,1,17,6,3,65,33,32,57
Coleraine,2927,2,14,11,1,46,25,21,53
Linfield,2927,3,11,5,10,38,36,2,38
Glenavon,2927,4,9,10,7,55,46,9,37
Cliftonville,2927,5,9,4,13,32,32,0,31
Ballymena,2927,6,7,4,15,28,51,-23,25
Glentoran,2927,7,6,6,10,24,32,-8,24
Dungannon,2927,8,2,4,16,14,47,-33,10
Crusaders,2928,1,17,6,3,65,32,33,57
Coleraine,2928,2,14,10,2,43,26,17,52
Glenavon,2928,3,10,9,7,56,43,13,39
Linfield,2928,4,11,5,10,39,37,2,38
Cliftonville,2928,5,9,4,13,33,33,0,31
Ballymena,2928,6,7,4,15,27,51,-24,25
Glentoran,2928,7,6,6,10,24,32,-8,24
Dungannon,2928,8,2,4,16,14,47,-33,10
Coleraine,2929,1,15,10,1,48,23,25,55
Crusaders,2929,2,16,6,4,63,33,30,54
Linfield,2929,3,11,5,10,38,36,2,38
Glenavon,2929,4,9,9,8,53,48,5,36
Cliftonville,2929,5,9,4,13,32,32,0,31
Ballymena,2929,6,8,4,14,28,49,-21,28
Glentoran,2929,7,6,6,10,24,32,-8,24
Dungannon,2929,8,2,4,16,14,47,-33,10
Crusaders,2930,1,17,6,3,65,30,35,57
Coleraine,2930,2,15,10,1,46,24,22,55
Glenavon,2930,3,9,9,8,54,46,8,36
Linfield,2930,4,10,6,10,37,36,1,36
Cliftonville,2930,5,9,5,12,32,31,1,32
Ballymena,2930,6,7,4,15,25,51,-26,25
Glentoran,2930,7,6,6,10,24,32,-8,24
Dungannon,2930,8,2,4,16,14,47,-33,10
Crusaders,2931,1,17,6,3,62,30,32,57
Coleraine,2931,2,14,11,1,44,23,21,53
Linfield,2931,3,11,5,10,39,37,2,38
Glenavon,2931,4,9,10,7,53,44,9,37
Cliftonville,2931,5,9,4,13,33,33,0,31
Ballymena,2931,6,7,4,15,25,48,-23,25
Glentoran,2931,7,6,6,10,24,32,-8,24
Dungannon,2931,8,2,4,16,14,47,-33,10
Crusaders,2932,1,17,6,3,63,30,33,57
Coleraine,2932,2,15,10,1,45,23,22,55
Glenavon,2932,3,9,9,8,53,45,8,36
Linfield,2932,4,10,5,11,38,38,0,35
Cliftonville,2932,5,10,4,12,34,32,2,34
Ballymena,2932,6,7,4,15,25,49,-24,25
Glentoran,2932,7,6,6,10,24,32,-8,24
Dungannon,2932,8,2,4,16,14,47,-33,10
Crusaders,2933,1,17,6,3,64,31,33,57
Coleraine,2933,2,15,10,1,45,23,22,55
Glenavon,2933,3,9,9,8,53,45,8,36
Linfield,2933,4,10,6,10,38,37,1,36
Cliftonville,2933,5,9,5,12,33,32,1,32
Ballymena,2933,6,7,4,15,26,50,-24,25
Glentoran,2933,7,6,6,10,24,32,-8,24
Dungannon,2933,8,2,4,16,14,47,-33,10
Crusaders,2934,1,17,6,3,65,32,33,57
Coleraine,2934,2,14,10,2,44,24,20,52
Glenavon,2934,3,10,9,7,54,44,10,39
Linfield,2934,4,10,6,10,37,36,1,36
Cliftonville,2934,5,9,5,12,32,31,1,32
Ballymena,2934,6,7,4,15,27,51,-24,25
Glentoran,2934,7,6,6,10,24,32,-8,24
Dungannon,2934,8,2,4,16,14,47,-33,10
Crusaders,2935,1,17,6,3,63,31,32,57
Coleraine,2935,2,14,10,2,43,23,20,52
Glenavon,2935,3,10,9,7,53,43,10,39
Linfield,2935,4,11,5,10,39,36,3,38
Cliftonville,2935,5,9,4,13,32,33,-1,31
Ballymena,2935,6,7,4,15,26,49,-23,25
Glentoran,2935,7,6,6,10,24,32,-8,24
Dungannon,2935,8,2,4,16,14,47,-33,10
Crusaders,2936,1,16,7,3,63,32,31,55
Coleraine,2936,2,14,10,2,44,24,20,52
Glenavon,2936,3,10,9,7,54,44,10,39
Linfield,2936,4,11,5,10,40,36,4,38
Cliftonville,2936,5,9,4,13,32,34,-2,31
Ballymena,2936,6,7,5,14,27,49,-22,26
Glentoran,2936,7,6,6,10,24,32,-8,24
Dungannon,2936,8,2,4,16,14,47,-33,10
Crusaders,2937,1,16,6,4,61,31,30,54
Coleraine,2937,2,14,10,2,44,25,19,52
Glenavon,2937,3,10,9,7,55,44,11,39
Linfield,2937,4,11,5,10,40,36,4,38
Cliftonville,2937,5,9,4,13,32,34,-2,31
Ballymena,2937,6,8,4,14,26,47,-21,28
Glentoran,2937,7,6,6,10,24,32,-8,24
Dungannon,2937,8,2,4,16,14,47,-33,10
Crusaders,2938,1,17,6,3,63,30,33,57
Coleraine,2938,2,14,10,2,44,24,20,52
Glenavon,2938,3,10,9,7,54,44,10,39
Linfield,2938,4,11,5,10,40,37,3,38
Cliftonville,2938,5,9,4,13,33,34,-1,31
Ballymena,2938,6,7,4,15,25,49,-24,25
Glentoran,2938,7,6,6,10,24,32,-8,24
Dungannon,2938,8,2,4,16,14,47,-33,10
Crusaders,2939,1,16,6,4,61,31,30,54
Coleraine,2939,2,14,10,2,44,24,20,52
Glenavon,2939,3,10,9,7,54,44,10,39
Linfield,2939,4,11,5,10,41,37,4,38
Cliftonville,2939,5,9,4,13,33,35,-2,31
Ballymena,2939,6,8,4,14,26,47,-21,28
Glentoran,2939,7,6,6,10,24,32,-8,24
Dungannon,2939,8,2,4,16,14,47,-33,10
Crusaders,2940,1,17,6,3,65,31,34,57
Coleraine,2940,2,14,10,2,44,24,20,52
Glenavon,2940,3,10,9,7,54,44,10,39
Linfield,2940,4,11,5,10,40,38,2,38
Cliftonville,2940,5,9,4,13,34,34,0,31
Ballymena,2940,6,7,4,15,26,51,-25,25
Glentoran,2940,7,6,6,10,24,32,-8,24
Dungannon,2940,8,2,4,16,14,47,-33,10
Crusaders,2941,1,16,7,3,63,32,31,55
Coleraine,2941,2,14,11,1,43,22,21,53
Glenavon,2941,3,9,10,7,52,43,9,37
Linfield,2941,4,10,5,11,38,38,0,35
Cliftonville,2941,5,10,4,12,34,32,2,34
Ballymena,2941,6,7,5,14,27,49,-22,26
Glentoran,2941,7,6,6,10,24,32,-8,24
Dungannon,2941,8,2,4,16,14,47,-33,10
Coleraine,2942,1,15,10,1,47,22,25,55
Crusaders,2942,2,16,6,4,62,34,28,54
Linfield,2942,3,11,5,10,39,37,2,38
Glenavon,2942,4,9,9,8,52,47,5,36
Cliftonville,2942,5,9,4,13,33,33,0,31
Ballymena,2942,6,8,4,14,29,48,-19,28
Glentoran,2942,7,6,6,10,24,32,-8,24
Dungannon,2942,8,2,4,16,14,47,-33,10
Crusaders,2943,1,17,6,3,64,31,33,57
Coleraine,2943,2,14,10,2,43,24,19,52
Glenavon,2943,3,10,9,7,54,43,11,39
Linfield,2943,4,10,6,10,38,37,1,36
Cliftonville,2943,5,9,5,12,33,32,1,32
Ballymena,2943,6,7,4,15,26,50,-24,25
Glentoran,2943,7,6,6,10,24,32,-8,24
Dungannon,2943,8,2,4,16,14,47,-33,10
Crusaders,2944,1,17,6,3,65,30,35,57
Coleraine,2944,2,15,10,1,46,24,22,55
Linfield,2944,3,11,5,10,39,37,2,38
Glenavon,2944,4,9,9,8,54,46,8,36
Cliftonville,2944,5,9,4,13,33,33,0,31
Ballymena,2944,6,7,4,15,25,51,-26,25
Glentoran,2944,7,6,6,10,24,32,-8,24
Dungannon,2944,8,2,4,16,14,47,-33,10
Coleraine,2945,1,15,10,1,46,24,22,55
Crusaders,2945,2,16,6,4,62,32,30,54
Glenavon,2945,3,9,9,8,54,46,8,36
Linfield,2945,4,10,5,11,37,37,0,35
Cliftonville,2945,5,10,4,12,33,31,2,34
Ballymena,2945,6,8,4,14,27,48,-21,28
Glentoran,2945,7,6,6,10,24,32,-8,24
Dungannon,2945,8,2,4,16,14,47,-33,10
Crusaders,2946,1,17,6,3,65,32,33,57
Coleraine,2946,2,14,10,2,44,24,20,52
Glenavon,2946,3,10,9,7,54,44,10,39
Linfield,2946,4,10,5,11,39,39,0,35
Cliftonville,2946,5,10,4,12,35,33,2,34
Ballymena,2946,6,7,4,15,27,51,-24,25
Glentoran,2946,7,6,6,10,24,32,-8,24
Dungannon,2946,8,2,4,16,14,47,-33,10
Crusaders,2947,1,16,7,3,62,31,31,55
Coleraine,2947,2,14,10,2,44,26,18,52
Glenavon,2947,3,10,9,7,56,44,12,39
Linfield,2947,4,10,5,11,38,38,0,35
Cliftonville,2947,5,10,4,12,34,32,2,34
Ballymena,2947,6,7,5,14,26,48,-22,26
Glentoran,2947,7,6,6,10,24,32,-8,24
Dungannon,2947,8,2,4,16,14,47,-33,10
Crusaders,2948,1,17,6,3,63,31,32,57
Coleraine,2948,2,14,10,2,43,24,19,52
Glenavon,2948,3,10,9,7,54,43,11,39
Linfield,2948,4,10,6,10,38,37,1,36
Cliftonville,2948,5,9,5,12,33,32,1,32
Ballymena,2948,6,7,4,15,26,49,-23,25
Glentoran,2948,7,6,6,10,24,32,-8,24
Dungannon,2948,8,2,4,16,14,47,-33,10
Crusaders,2949,1,16,7,3,62,31,31,55
Coleraine,2949,2,15,10,1,44,22,22,55
Linfield,2949,3,11,5,10,38,36,2,38
Glenavon,2949,4,9,9,8,52,44,8,36
Cliftonville,2949,5,9,4,13,32,32,0,31
Ballymena,2949,6,7,5,14,26,48,-22,26
Glentoran,2949,7,6,6,10,24,32,-8,24
Dungannon,2949,8,2,4,16,14,47,-33,10
Crusaders,2950,1,17,6,3,62,30,32,57
Coleraine,2950,2,14,11,1,45,24,21,53
Glenavon,2950,3,9,10,7,54,45,9,37
Linfield,2950,4,10,5,11,37,38,-1,35
Cliftonville,2950,5,10,4,12,34,31,3,34
Ballymena,2950,6,7,4,15,25,48,-23,25
Glentoran,2950,7,6,6,10,24,32,-8,24
Dungannon,2950,8,2,4,16,14,47,-33,10
Coleraine,2951,1,15,10,1,45,22,23,55
Crusaders,2951,2,16,6,4,62,32,30,54
Glenavon,2951,3,9,9,8,52,45,7,36
Linfield,2951,4,10,6,10,37,36,1,36
Cliftonville,2951,5,9,5,12,32,31,1,32
Ballymena,2951,6,8,4,14,27,48,-21,28
Glentoran,2951,7,6,6,10,24,32,-8,24
Dungannon,2951,8,2,4,16,14,47,-33,10
Crusaders,2952,1,17,6,3,65,32,33,57
Coleraine,2952,2,15,10,1,45,23,22,55
Glenavon,2952,3,9,9,8,53,45,8,36
Linfield,2952,4,10,6,10,39,38,1,36
Cliftonville,2952,5,9,5,12,34,33,1,32
Ballymena,2952,6,7,4,15,27,51,-24,25
Glentoran,2952,7,6,6,10,24,32,-8,24
Dungannon,2952,8,2,4,16,14,47,-33,10
Crusaders,2953,1,17,6,3,62,30,32,57
Coleraine,2953,2,14,10,2,43,24,19,52
Glenavon,2953,3,10,9,7,54,43,11,39
Linfield,2953,4,11,5,10,41,37,4,38
Cliftonville,2953,5,9,4,13,33,35,-2,31
Ballymena,2953,6,7,4,15,25,48,-23,25
Glentoran,2953,7,6,6,10,24,32,-8,24
Dungannon,2953,8,2,4,16,14,47,-33,10
Crusaders,2954,1,16,7,3,62,31,31,55
Coleraine,2954,2,15,10,1,45,23,22,55
Linfield,2954,3,11,5,10,38,36,2,38
Glenavon,2954,4,9,9,8,53,45,8,36
Cliftonville,2954,5,9,4,13,32,32,0,31
Ballymena,2954,6,7,5,14,26,48,-22,26
Glentoran,2954,7,6,6,10,24,32,-8,24
Dungannon,2954,8,2,4,16,14,47,-33,10
Crusaders,2955,1,16,7,3,63,32,31,55
Coleraine,2955,2,15,10,1,47,24,23,55
Glenavon,2955,3,9,9,8,54,47,7,36
Linfield,2955,4,10,5,11,38,38,0,35
Cliftonville,2955,5,10,4,12,34,32,2,34
Ballymena,2955,6,7,5,14,27,49,-22,26
Glentoran,2955,7,6,6,10,24,32,-8,24
Dungannon,2955,8,2,4,16,14,47,-33,10
Crusaders,2956,1,16,7,3,63,32,31,55
Coleraine,2956,2,14,10,2,44,24,20,52
Glenavon,2956,3,10,9,7,54,44,10,39
Linfield,2956,4,10,6,10,38,37,1,36
Cliftonville,2956,5,9,5,12,33,32,1,32
Ballymena,2956,6,7,5,14,27,49,-22,26
Glentoran,2956,7,6,6,10,24,32,-8,24
Dungannon,2956,8,2,4,16,14,47,-33,10
Crusaders,2957,1,16,6,4,63,34,29,54
Coleraine,2957,2,14,11,1,43,22,21,53
Glenavon,2957,3,9,10,7,52,43,9,37
Linfield,2957,4,10,6,10,40,39,1,36
Cliftonville,2957,5,9,5,12,35,34,1,32
Ballymena,2957,6,8,4,14,29,49,-20,28
Glentoran,2957,7,6,6,10,24,32,-8,24
Dungannon,2957,8,2,4,16,14,47,-33,10
Crusaders,2958,1,16,6,4,62,33,29,54
Coleraine,2958,2,14,10,2,45,26,19,52
Glenavon,2958,3,10,9,7,56,45,11,39
Linfield,2958,4,10,5,11,39,40,-1,35
Cliftonville,2958,5,10,4,12,36,33,3,34
Ballymena,2958,6,8,4,14,28,48,-20,28
Glentoran,2958,7,6,6,10,24,32,-8,24
Dungannon,2958,8,2,4,16,14,47,-33,10
Crusaders,2959,1,17,6,3,63,31,32,57
Coleraine,2959,2,14,10,2,43,25,18,52
Glenavon,2959,3,10,9,7,55,43,12,39
Linfield,2959,4,10,6,10,38,37,1,36
Cliftonville,2959,5,9,5,12,33,32,1,32
Ballymena,2959,6,7,4,15,26,49,-23,25
Glentoran,2959,7,6,6,10,24,32,-8,24
Dungannon,2959,8,2,4,16,14,47,-33,10
Crusaders,2960,1,17,6,3,66,31,35,57
Coleraine,2960,2,15,10,1,45,23,22,55
Linfield,2960,3,11,5,10,40,37,3,38
Glenavon,2960,4,9,9,8,53,45,8,36
Cliftonville,2960,5,9,4,13,33,34,-1,31
Ballymena,2960,6,7,4,15,26,52,-26,25
Glentoran,2960,7,6,6,10,24,32,-8,24
Dungannon,2960,8,2,4,16,14,47,-33,10
Crusaders,2961,1,17,6,3,62,30,32,57
Coleraine,2961,2,15,10,1,44,22,22,55
Linfield,2961,3,11,5,10,41,38,3,38
Glenavon,2961,4,9,9,8,52,44,8,36
Cliftonville,2961,5,9,4,13,34,35,-1,31
Ballymena,2961,6,7,4,15,25,48,-23,25
Glentoran,2961,7,6,6,10,24,32,-8,24
Dungannon,2961,8,2,4,16,14,47,-33,10
Crusaders,2962,1,16,7,3,64,33,31,55
Coleraine,2962,2,14,11,1,45,24,21,53
Glenavon,2962,3,9,10,7,54,45,9,37
Linfield,2962,4,10,5,11,37,38,-1,35
Cliftonville,2962,5,10,4,12,34,31,3,34
Ballymena,2962,6,7,5,14,28,50,-22,26
Glentoran,2962,7,6,6,10,24,32,-8,24
Dungannon,2962,8,2,4,16,14,47,-33,10
Crusaders,2963,1,16,6,4,61,31,30,54
Coleraine,2963,2,14,10,2,45,25,20,52
Glenavon,2963,3,10,9,7,55,45,10,39
Linfield,2963,4,11,5,10,40,36,4,38
Cliftonville,2963,5,9,4,13,32,34,-2,31
Ballymena,2963,6,8,4,14,26,47,-21,28
Glentoran,2963,7,6,6,10,24,32,-8,24
Dungannon,2963,8,2,4,16,14,47,-33,10
Crusaders,2964,1,17,6,3,64,30,34,57
Coleraine,2964,2,14,10,2,43,23,20,52
Glenavon,2964,3,10,9,7,53,43,10,39
Linfield,2964,4,10,6,10,39,38,1,36
Cliftonville,2964,5,9,5,12,34,33,1,32
Ballymena,2964,6,7,4,15,25,50,-25,25
Glentoran,2964,7,6,6,10,24,32,-8,24
Dungannon,2964,8,2,4,16,14,47,-33,10
Crusaders,2965,1,16,7,3,62,31,31,55
Coleraine,2965,2,14,10,2,44,25,19,52
Glenavon,2965,3,10,9,7,55,44,11,39
Linfield,2965,4,10,6,10,38,37,1,36
Cliftonville,2965,5,9,5,12,33,32,1,32
Ballymena,2965,6,7,5,14,26,48,-22,26
Glentoran,2965,7,6,6,10,24,32,-8,24
Dungannon,2965,8,2,4,16,14,47,-33,10
Crusaders,2966,1,16,7,3,64,33,31,55
Coleraine,2966,2,15,10,1,47,22,25,55
Glenavon,2966,3,9,9,8,52,47,5,36
Linfield,2966,4,10,6,10,38,37,1,36
Cliftonville,2966,5,9,5,12,33,32,1,32
Ballymena,2966,6,7,5,14,28,50,-22,26
Glentoran,2966,7,6,6,10,24,32,-8,24
Dungannon,2966,8,2,4,16,14,47,-33,10
Crusaders,2967,1,16,6,4,63,33,30,54
Coleraine,2967,2,14,11,1,44,23,21,53
Linfield,2967,3,11,5,10,39,37,2,38
Glenavon,2967,4,9,10,7,53,44,9,37
Cliftonville,2967,5,9,4,13,33,33,0,31
Ballymena,2967,6,8,4,14,28,49,-21,28
Glentoran,2967,7,6,6,10,24,32,-8,24
Dungannon,2967,8,2,4,16,14,47,-33,10
Crusaders,2968,1,16,6,4,62,32,30,54
Coleraine,2968,2,14,11,1,46,25,21,53
Glenavon,2968,3,9,10,7,55,46,9,37
Linfield,2968,4,10,5,11,38,38,0,35
Cliftonville,2968,5,10,4,12,34,32,2,34
Ballymena,2968,6,8,4,14,27,48,-21,28
Glentoran,2968,7,6,6,10,24,32,-8,24
Dungannon,2968,8,2,4,16,14,47,-33,10
Crusaders,2969,1,16,6,4,62,33,29,54
Coleraine,2969,2,14,11,1,45,24,21,53
Linfield,2969,3,11,5,10,39,36,3,38
Glenavon,2969,4,9,10,7,54,45,9,37
Cliftonville,2969,5,9,4,13,32,33,-1,31
Ballymena,2969,6,8,4,14,28,48,-20,28
Glentoran,2969,7,6,6,10,24,32,-8,24
Dungannon,2969,8,2,4,16,14,47,-33,10
Crusaders,2970,1,16,6,4,63,33,30,54
Coleraine,2970,2,14,10,2,43,23,20,52
Glenavon,2970,3,10,9,7,53,43,10,39
Linfield,2970,4,10,6,10,38,37,1,36
Cliftonville,2970,5,9,5,12,33,32,1,32
Ballymena,2970,6,8,4,14,28,49,-21,28
Glentoran,2970,7,6,6,10,24,32,-8,24
Dungannon,2970,8,2,4,16,14,47,-33,10
Coleraine,2971,1,15,10,1,45,22,23,55
Crusaders,2971,2,16,6,4,63,35,28,54
Glenavon,2971,3,9,9,8,52,45,7,36
Linfield,2971,4,10,5,11,37,37,0,35
Cliftonville,2971,5,10,4,12,33,31,2,34
Ballymena,2971,6,8,4,14,30,49,-19,28
Glentoran,2971,7,6,6,10,24,32,-8,24
Dungannon,2971,8,2,4,16,14,47,-33,10
Crusaders,2972,1,17,6,3,63,31,32,57
Coleraine,2972,2,15,10,1,45,23,22,55
Linfield,2972,3,11,5,10,38,36,2,38
Glenavon,2972,4,9,9,8,53,45,8,36
Cliftonville,2972,5,9,4,13,32,32,0,31
Ballymena,2972,6,7,4,15,26,49,-23,25
Glentoran,2972,7,6,6,10,24,32,-8,24
Dungannon,2972,8,2,4,16,14,47,-33,10
Crusaders,2973,1,16,7,3,61,30,31,55
Coleraine,2973,2,14,10,2,43,24,19,52
Glenavon,2973,3,10,9,7,54,43,11,39
Linfield,2973,4,11,5,10,40,36,4,38
Cliftonville,2973,5,9,4,13,32,34,-2,31
Ballymena,2973,6,7,5,14,25,47,-22,26
Glentoran,2973,7,6,6,10,24,32,-8,24
Dungannon,2973,8,2,4,16,14,47,-33,10
Crusaders,2974,1,17,6,3,62,30,32,57
Coleraine,2974,2,14,10,2,43,26,17,52
Glenavon,2974,3,10,9,7,56,43,13,39
Linfield,2974,4,10,5,11,40,40,0,35
Cliftonville,2974,5,10,4,12,36,34,2,34
Ballymena,2974,6,7,4,15,25,48,-23,25
Glentoran,2974,7,6,6,10,24,32,-8,24
Dungannon,2974,8,2,4,16,14,47,-33,10
Crusaders,2975,1,16,6,4,62,32,30,54
Coleraine,2975,2,14,10,2,44,24,20,52
Glenavon,2975,3,10,9,7,54,44,10,39
Linfield,2975,4,10,5,11,39,40,-1,35
Cliftonville,2975,5,10,4,12,36,33,3,34
Ballymena,2975,6,8,4,14,27,48,-21,28
Glentoran,2975,7,6,6,10,24,32,-8,24
Dungannon,2975,8,2,4,16,14,47,-33,10
Crusaders,2976,1,17,6,3,62,30,32,57
Coleraine,2976,2,15,10,1,45,22,23,55
Linfield,2976,3,11,5,10,39,37,2,38
Glenavon,2976,4,9,9,8,52,45,7,36
Cliftonville,2976,5,9,4,13,33,33,0,31
Ballymena,2976,6,7,4,15,25,48,-23,25
Glentoran,2976,7,6,6,10,24,32,-8,24
Dungannon,2976,8,2,4,16,14,47,-33,10
Crusaders,2977,1,17,6,3,64,31,33,57
Coleraine,2977,2,14,10,2,44,24,20,52
Glenavon,2977,3,10,9,7,54,44,10,39
Linfield,2977,4,11,5,10,39,37,2,38
Cliftonville,2977,5,9,4,13,33,33,0,31
Ballymena,2977,6,7,4,15,26,50,-24,25
Glentoran,2977,7,6,6,10,24,32,-8,24
Dungannon,2977,8,2,4,16,14,47,-33,10
Crusaders,2978,1,17,6,3,62,30,32,57
Coleraine,2978,2,15,10,1,46,23,23,55
Linfield,2978,3,11,5,10,39,36,3,38
Glenavon,2978,4,9,9,8,53,46,7,36
Cliftonville,2978,5,9,4,13,32,33,-1,31
Ballymena,2978,6,7,4,15,25,48,-23,25
Glentoran,2978,7,6,6,10,24,32,-8,24
Dungannon,2978,8,2,4,16,14,47,-33,10
Crusaders,2979,1,17,6,3,63,31,32,57
Coleraine,2979,2,14,10,2,44,26,18,52
Glenavon,2979,3,10,9,7,56,44,12,39
Linfield,2979,4,11,5,10,40,38,2,38
Cliftonville,2979,5,9,4,13,34,34,0,31
Ballymena,2979,6,7,4,15,26,49,-23,25
Glentoran,2979,7,6,6,10,24,32,-8,24
Dungannon,2979,8,2,4,16,14,47,-33,10
Crusaders,2980,1,16,6,4,61,33,28,54
Coleraine,2980,2,14,10,2,43,23,20,52
Glenavon,2980,3,10,9,7,53,43,10,39
Linfield,2980,4,11,5,10,38,36,2,38
Cliftonville,2980,5,9,4,13,32,32,0,31
Ballymena,2980,6,8,4,14,28,47,-19,28
Glentoran,2980,7,6,6,10,24,32,-8,24
Dungannon,2980,8,2,4,16,14,47,-33,10
Crusaders,2981,1,17,6,3,67,31,36,57
Coleraine,2981,2,15,10,1,47,24,23,55
Linfield,2981,3,11,5,10,38,36,2,38
Glenavon,2981,4,9,9,8,54,47,7,36
Cliftonville,2981,5,9,4,13,32,32,0,31
Ballymena,2981,6,7,4,15,26,53,-27,25
Glentoran,2981,7,6,6,10,24,32,-8,24
Dungannon,2981,8,2,4,16,14,47,-33,10
Crusaders,2982,1,16,7,3,62,31,31,55
Coleraine,2982,2,15,10,1,45,23,22,55
Linfield,2982,3,11,5,10,39,37,2,38
Glenavon,2982,4,9,9,8,53,45,8,36
Cliftonville,2982,5,9,4,13,33,33,0,31
Ballymena,2982,6,7,5,14,26,48,-22,26
Glentoran,2982,7,6,6,10,24,32,-8,24
Dungannon,2982,8,2,4,16,14,47,-33,10
Crusaders,2983,1,17,6,3,64,32,32,57
Coleraine,2983,2,14,10,2,43,23,20,52
Glenavon,2983,3,10,9,7,53,43,10,39
Linfield,2983,4,10,6,10,38,37,1,36
Cliftonville,2983,5,9,5,12,33,32,1,32
Ballymena,2983,6,7,4,15,27,50,-23,25
Glentoran,2983,7,6,6,10,24,32,-8,24
Dungannon,2983,8,2,4,16,14,47,-33,10
Crusaders,2984,1,16,7,3,62,31,31,55
Coleraine,2984,2,14,10,2,44,24,20,52
Glenavon,2984,3,10,9,7,54,44,10,39
Linfield,2984,4,10,5,11,37,37,0,35
Cliftonville,2984,5,10,4,12,33,31,2,34
Ballymena,2984,6,7,5,14,26,48,-22,26
Glentoran,2984,7,6,6,10,24,32,-8,24
Dungannon,2984,8,2,4,16,14,47,-33,10
Crusaders,2985,1,16,6,4,62,34,28,54
Coleraine,2985,2,14,10,2,43,25,18,52
Glenavon,2985,3,10,9,7,55,43,12,39
Linfield,2985,4,10,5,11,37,38,-1,35
Cliftonville,2985,5,10,4,12,34,31,3,34
Ballymena,2985,6,8,4,14,29,48,-19,28
Glentoran,2985,7,6,6,10,24,32,-8,24
Dungannon,2985,8,2,4,16,14,47,-33,10
Crusaders,2986,1,16,6,4,61,31,30,54
Coleraine,2986,2,14,10,2,44,25,19,52
Glenavon,2986,3,10,9,7,55,44,11,39
Linfield,2986,4,11,5,10,39,37,2,38
Cliftonville,2986,5,9,4,13,33,33,0,31
Ballymena,2986,6,8,4,14,26,47,-21,28
Glentoran,2986,7,6,6,10,24,32,-8,24
Dungannon,2986,8,2,4,16,14,47,-33,10
Crusaders,2987,1,16,7,3,62,31,31,55
Coleraine,2987,2,14,10,2,45,26,19,52
Glenavon,2987,3,10,9,7,56,45,11,39
Linfield,2987,4,10,5,11,37,38,-1,35
Cliftonville,2987,5,10,4,12,34,31,3,34
Ballymena,2987,6,7,5,14,26,48,-22,26
Glentoran,2987,7,6,6,10,24,32,-8,24
Dungannon,2987,8,2,4,16,14,47,-33,10
Crusaders,2988,1,16,7,3,61,30,31,55
Coleraine,2988,2,14,10,2,43,24,19,52
Glenavon,2988,3,10,9,7,54,43,11,39
Linfield,2988,4,10,5,11,37,37,0,35
Cliftonville,2988,5,10,4,12,33,31,2,34
Ballymena,2988,6,7,5,14,25,47,-22,26
Glentoran,2988,7,6,6,10,24,32,-8,24
Dungannon,2988,8,2,4,16,14,47,-33,10
Crusaders,2989,1,17,6,3,65,30,35,57
Coleraine,2989,2,15,10,1,46,24,22,55
Glenavon,2989,3,9,9,8,54,46,8,36
Linfield,2989,4,10,5,11,37,37,0,35
Cliftonville,2989,5,10,4,12,33,31,2,34
Ballymena,2989,6,7,4,15,25,51,-26,25
Glentoran,2989,7,6,6,10,24,32,-8,24
Dungannon,2989,8,2,4,16,14,47,-33,10
Coleraine,2990,1,15,10,1,46,23,23,55
Crusaders,2990,2,16,6,4,61,31,30,54
Linfield,2990,3,11,5,10,38,36,2,38
Glenavon,2990,4,9,9,8,53,46,7,36
Cliftonville,2990,5,9,4,13,32,32,0,31
Ballymena,2990,6,8,4,14,26,47,-21,28
Glentoran,2990,7,6,6,10,24,32,-8,24
Dungannon,2990,8,2,4,16,14,47,-33,10
Crusaders,2991,1,17,6,3,66,31,35,57
Coleraine,2991,2,15,10,1,45,23,22,55
Linfield,2991,3,11,5,10,39,36,3,38
Glenavon,2991,4,9,9,8,53,45,8,36
Cliftonville,2991,5,9,4,13,32,33,-1,31
Ballymena,2991,6,7,4,15,26,52,-26,25
Glentoran,2991,7,6,6,10,24,32,-8,24
Dungannon,2991,8,2,4,16,14,47,-33,10
Crusaders,2992,1,17,6,3,64,31,33,57
Coleraine,2992,2,14,11,1,43,22,21,53
Linfield,2992,3,11,5,10,40,37,3,38
Glenavon,2992,4,9,10,7,52,43,9,37
Cliftonville,2992,5,9,4,13,33,34,-1,31
Ballymena,2992,6,7,4,15,26,50,-24,25
Glentoran,2992,7,6,6,10,24,32,-8,24
Dungannon,2992,8,2,4,16,14,47,-33,10
Coleraine,2993,1,15,10,1,45,23,22,55
Crusaders,2993,2,16,6,4,62,33,29,54
Linfield,2993,3,11,5,10,38,36,2,38
Glenavon,2993,4,9,9,8,53,45,8,36
Cliftonville,2993,5,9,4,13,32,32,0,31
Ballymena,2993,6,8,4,14,28,48,-20,28
Glentoran,2993,7,6,6,10,24,32,-8,24
Dungannon,2993,8,2,4,16,14,47,-33,10
Crusaders,2994,1,16,6,4,62,32,30,54
Coleraine,2994,2,14,10,2,43,27,16,52
Glenavon,2994,3,10,9,7,57,43,14,39
Linfield,2994,4,10,5,11,39,39,0,35
Cliftonville,2994,5,10,4,12,35,33,2,34
Ballymena,2994,6,8,4,14,27,48,-21,28
Glentoran,2994,7,6,6,10,24,32,-8,24
Dungannon,2994,8,2,4,16,14,47,-33,10
Crusaders,2995,1,17,6,3,63,31,32,57
Coleraine,2995,2,14,10,2,43,23,20,52
Glenavon,2995,3,10,9,7,53,43,10,39
Linfield,2995,4,11,5,10,41,36,5,38
Cliftonville,2995,5,9,4,13,32,35,-3,31
Ballymena,2995,6,7,4,15,26,49,-23,25
Glentoran,2995,7,6,6,10,24,32,-8,24
Dungannon,2995,8,2,4,16,14,47,-33,10
Crusaders,2996,1,16,6,4,62,33,29,54
Coleraine,2996,2,14,10,2,44,24,20,52
Glenavon,2996,3,10,9,7,54,44,10,39
Linfield,2996,4,11,5,10,39,37,2,38
Cliftonville,2996,5,9,4,13,33,33,0,31
Ballymena,2996,6,8,4,14,28,48,-20,28
Glentoran,2996,7,6,6,10,24,32,-8,24
Dungannon,2996,8,2,4,16,14,47,-33,10
Crusaders,2997,1,17,6,3,62,30,32,57
Coleraine,2997,2,14,10,2,44,24,20,52
Glenavon,2997,3,10,9,7,54,44,10,39
Linfield,2997,4,11,5,10,38,36,2,38
Cliftonville,2997,5,9,4,13,32,32,0,31
Ballymena,2997,6,7,4,15,25,48,-23,25
Glentoran,2997,7,6,6,10,24,32,-8,24
Dungannon,2997,8,2,4,16,14,47,-33,10
Crusaders,2998,1,17,6,3,65,30,35,57
Coleraine,2998,2,15,10,1,45,22,23,55
Linfield,2998,3,11,5,10,39,36,3,38
Glenavon,2998,4,9,9,8,52,45,7,36
Cliftonville,2998,5,9,4,13,32,33,-1,31
Ballymena,2998,6,7,4,15,25,51,-26,25
Glentoran,2998,7,6,6,10,24,32,-8,24
Dungannon,2998,8,2,4,16,14,47,-33,10
Crusaders,2999,1,17,6,3,65,32,33,57
Coleraine,2999,2,14,10,2,43,23,20,52
Glenavon,2999,3,10,9,7,53,43,10,39
Linfield,2999,4,10,5,11,39,40,-1,35
Cliftonville,2999,5,10,4,12,36,33,3,34
Ballymena,2999,6,7,4,15,27,51,-24,25
Glentoran,2999,7,6,6,10,24,32,-8,24
Dungannon,2999,8,2,4,16,14,47,-33,10
Crusaders,3000,1,16,6,4,61,31,30,54
Coleraine,3000,2,14,11,1,44,23,21,53
Linfield,3000,3,11,5,10,40,36,4,38
Glenavon,3000,4,9,10,7,53,44,9,37
Cliftonville,3000,5,9,4,13,32,34,-2,31
Ballymena,3000,6,8,4,14,26,47,-21,28
Glentoran,3000,7,6,6,10,24,32,-8,24
Dungannon,3000,8,2,4,16,14,47,-33,10
Crusaders,3001,1,16,6,4,64,34,30,54
Coleraine,3001,2,14,11,1,45,24,21,53
Glenavon,3001,3,9,10,7,54,45,9,37
Linfield,3001,4,10,5,11,38,38,0,35
Cliftonville,3001,5,10,4,12,34,32,2,34
Ballymena,3001,6,8,4,14,29,50,-21,28
Glentoran,3001,7,6,6,10,24,32,-8,24
Dungannon,3001,8,2,4,16,14,47,-33,10
Crusaders,3002,1,17,6,3,63,31,32,57
Coleraine,3002,2,14,10,2,43,26,17,52
Glenavon,3002,3,10,9,7,56,43,13,39
Linfield,3002,4,10,5,11,37,37,0,35
Cliftonville,3002,5,10,4,12,33,31,2,34
Ballymena,3002,6,7,4,15,26,49,-23,25
Glentoran,3002,7,6,6,10,24,32,-8,24
Dungannon,3002,8,2,4,16,14,47,-33,10
Crusaders,3003,1,16,6,4,62,32,30,54
Coleraine,3003,2,14,10,2,43,25,18,52
Glenavon,3003,3,10,9,7,55,43,12,39
Linfield,3003,4,11,5,10,42,37,5,38
Cliftonville,3003,5,9,4,13,33,36,-3,31
Ballymena,3003,6,8,4,14,27,48,-21,28
Glentoran,3003,7,6,6,10,24,32,-8,24
Dungannon,3003,8,2,4,16,14,47,-33,10
Crusaders,3004,1,17,6,3,63,31,32,57
Coleraine,3004,2,14,10,2,44,24,20,52
Glenavon,3004,3,10,9,7,54,44,10,39
Linfield,3004,4,10,5,11,38,38,0,35
Cliftonville,3004,5,10,4,12,34,32,2,34
Ballymena,3004,6,7,4,15,26,49,-23,25
Glentoran,3004,7,6,6,10,24,32,-8,24
Dungannon,3004,8,2,4,16,14,47,-33,10
Crusaders,3005,1,17,6,3,64,32,32,57
Coleraine,3005,2,15,10,1,44,22,22,55
Glenavon,3005,3,9,9,8,52,44,8,36
Linfield,3005,4,10,6,10,39,38,1,36
Cliftonville,3005,5,9,5,12,34,33,1,32
Ballymena,3005,6,7,4,15,27,50,-23,25
Glentoran,3005,7,6,6,10,24,32,-8,24
Dungannon,3005,8,2,4,16,14,47,-33,10
Crusaders,3006,1,17,6,3,66,30,36,57
Coleraine,3006,2,14,10,2,44,24,20,52
Glenavon,3006,3,10,9,7,54,44,10,39
Linfield,3006,4,11,5,10,39,37,2,38
Cliftonville,3006,5,9,4,13,33,33,0,31
Ballymena,3006,6,7,4,15,25,52,-27,25
Glentoran,3006,7,6,6,10,24,32,-8,24
Dungannon,3006,8,2,4,16,14,47,-33,10
Crusaders,3007,1,17,6,3,65,30,35,57
Coleraine,3007,2,14,10,2,44,26,18,52
Glenavon,3007,3,10,9,7,56,44,12,39
Linfield,3007,4,10,6,10,38,37,1,36
Cliftonville,3007,5,9,5,12,33,32,1,32
Ballymena,3007,6,7,4,15,25,51,-26,25
Glentoran,3007,7,6,6,10,24,32,-8,24
Dungannon,3007,8,2,4,16,14,47,-33,10
Crusaders,3008,1,17,6,3,64,32,32,57
Coleraine,3008,2,14,10,2,45,27,18,52
Glenavon,3008,3,10,9,7,57,45,12,39
Linfield,3008,4,11,5,10,41,36,5,38
Cliftonville,3008,5,9,4,13,32,35,-3,31
Ballymena,3008,6,7,4,15,27,50,-23,25
Glentoran,3008,7,6,6,10,24,32,-8,24
Dungannon,3008,8,2,4,16,14,47,-33,10
Crusaders,3009,1,16,6,4,61,32,29,54
Coleraine,3009,2,14,11,1,43,22,21,53
Glenavon,3009,3,9,10,7,52,43,9,37
Linfield,3009,4,10,5,11,38,38,0,35
Cliftonville,3009,5,10,4,12,34,32,2,34
Ballymena,3009,6,8,4,14,27,47,-20,28
Glentoran,3009,7,6,6,10,24,32,-8,24
Dungannon,3009,8,2,4,16,14,47,-33,10
Crusaders,3010,1,17,6,3,67,31,36,57
Coleraine,3010,2,14,11,1,45,24,21,53
Glenavon,3010,3,9,10,7,54,45,9,37
Linfield,3010,4,10,5,11,37,38,-1,35
Cliftonville,3010,5,10,4,12,34,31,3,34
Ballymena,3010,6,7,4,15,26,53,-27,25
Glentoran,3010,7,6,6,10,24,32,-8,24
Dungannon,3010,8,2,4,16,14,47,-33,10
Crusaders,3011,1,17,6,3,65,31,34,57
Coleraine,3011,2,14,10,2,44,24,20,52
Glenavon,3011,3,10,9,7,54,44,10,39
Linfield,3011,4,11,5,10,38,36,2,38
Cliftonville,3011,5,9,4,13,32,32,0,31
Ballymena,3011,6,7,4,15,26,51,-25,25
Glentoran,3011,7,6,6,10,24,32,-8,24
Dungannon,3011,8,2,4,16,14,47,-33,10
Crusaders,3012,1,17,6,3,65,30,35,57
Coleraine,3012,2,14,10,2,43,23,20,52
Glenavon,3012,3,10,9,7,53,43,10,39
Linfield,3012,4,11,5,10,41,36,5,38
Cliftonville,3012,5,9,4,13,32,35,-3,31
Ballymena,3012,6,7,4,15,25,51,-26,25
Glentoran,3012,7,6,6,10,24,32,-8,24
Dungannon,3012,8,2,4,16,14,47,-33,10
Crusaders,3013,1,16,7,3,62,31,31,55
Coleraine,3013,2,14,11,1,44,23,21,53
Glenavon,3013,3,9,10,7,53,44,9,37
Linfield,3013,4,10,6,10,39,38,1,36
Cliftonville,3013,5,9,5,12,34,33,1,32
Ballymena,3013,6,7,5,14,26,48,-22,26
Glentoran,3013,7,6,6,10,24,32,-8,24
Dungannon,3013,8,2,4,16,14,47,-33,10
Crusaders,3014,1,17,6,3,64,32,32,57
Coleraine,3014,2,15,10,1,46,23,23,55
Glenavon,3014,3,9,9,8,53,46,7,36
Linfield,3014,4,10,6,10,38,37,1,36
Cliftonville,3014,5,9,5,12,33,32,1,32
Ballymena,3014,6,7,4,15,27,50,-23,25
Glentoran,3014,7,6,6,10,24,32,-8,24
Dungannon,3014,8,2,4,16,14,47,-33,10
Crusaders,3015,1,17,6,3,65,32,33,57
Coleraine,3015,2,15,10,1,46,24,22,55
Linfield,3015,3,11,5,10,40,36,4,38
Glenavon,3015,4,9,9,8,54,46,8,36
Cliftonville,3015,5,9,4,13,32,34,-2,31
Ballymena,3015,6,7,4,15,27,51,-24,25
Glentoran,3015,7,6,6,10,24,32,-8,24
Dungannon,3015,8,2,4,16,14,47,-33,10
Crusaders,3016,1,17,6,3,63,31,32,57
Coleraine,3016,2,15,10,1,46,23,23,55
Glenavon,3016,3,9,9,8,53,46,7,36
Linfield,3016,4,10,5,11,38,38,0,35
Cliftonville,3016,5,10,4,12,34,32,2,34
Ballymena,3016,6,7,4,15,26,49,-23,25
Glentoran,3016,7,6,6,10,24,32,-8,24
Dungannon,3016,8,2,4,16,14,47,-33,10
Crusaders,3017,1,17,6,3,63,31,32,57
Coleraine,3017,2,15,10,1,44,22,22,55
Linfield,3017,3,11,5,10,40,37,3,38
Glenavon,3017,4,9,9,8,52,44,8,36
Cliftonville,3017,5,9,4,13,33,34,-1,31
Ballymena,3017,6,7,4,15,26,49,-23,25
Glentoran,3017,7,6,6,10,24,32,-8,24
Dungannon,3017,8,2,4,16,14,47,-33,10
Crusaders,3018,1,17,6,3,63,31,32,57
Coleraine,3018,2,14,11,1,46,25,21,53
Linfield,3018,3,11,5,10,38,36,2,38
Glenavon,3018,4,9,10,7,55,46,9,37
Cliftonville,3018,5,9,4,13,32,32,0,31
Ballymena,3018,6,7,4,15,26,49,-23,25
Glentoran,3018,7,6,6,10,24,32,-8,24
Dungannon,3018,8,2,4,16,14,47,-33,10
Crusaders,3019,1,17,6,3,62,30,32,57
Coleraine,3019,2,14,10,2,43,23,20,52
Glenavon,3019,3,10,9,7,53,43,10,39
Linfield,3019,4,11,5,10,39,36,3,38
Cliftonville,3019,5,9,4,13,32,33,-1,31
Ballymena,3019,6,7,4,15,25,48,-23,25
Glentoran,3019,7,6,6,10,24,32,-8,24
Dungannon,3019,8,2,4,16,14,47,-33,10
Crusaders,3020,1,17,6,3,64,32,32,57
Coleraine,3020,2,14,10,2,45,25,20,52
Glenavon,3020,3,10,9,7,55,45,10,39
Linfield,3020,4,10,5,11,37,37,0,35
Cliftonville,3020,5,10,4,12,33,31,2,34
Ballymena,3020,6,7,4,15,27,50,-23,25
Glentoran,3020,7,6,6,10,24,32,-8,24
Dungannon,3020,8,2,4,16,14,47,-33,10
Coleraine,3021,1,15,10,1,45,23,22,55
Crusaders,3021,2,16,6,4,63,33,30,54
Glenavon,3021,3,9,9,8,53,45,8,36
Linfield,3021,4,10,6,10,37,36,1,36
Cliftonville,3021,5,9,5,12,32,31,1,32
Ballymena,3021,6,8,4,14,28,49,-21,28
Glentoran,3021,7,6,6,10,24,32,-8,24
Dungannon,3021,8,2,4,16,14,47,-33,10
Crusaders,3022,1,17,6,3,62,30,32,57
Coleraine,3022,2,14,10,2,44,25,19,52
Glenavon,3022,3,10,9,7,55,44,11,39
Linfield,3022,4,11,5,10,40,37,3,38
Cliftonville,3022,5,9,4,13,33,34,-1,31
Ballymena,3022,6,7,4,15,25,48,-23,25
Glentoran,3022,7,6,6,10,24,32,-8,24
Dungannon,3022,8,2,4,16,14,47,-33,10
Crusaders,3023,1,16,6,4,61,32,29,54
Coleraine,3023,2,14,10,2,44,24,20,52
Glenavon,3023,3,10,9,7,54,44,10,39
Linfield,3023,4,10,6,10,38,37,1,36
Cliftonville,3023,5,9,5,12,33,32,1,32
Ballymena,3023,6,8,4,14,27,47,-20,28
Glentoran,3023,7,6,6,10,24,32,-8,24
Dungannon,3023,8,2,4,16,14,47,-33,10
Crusaders,3024,1,16,7,3,63,32,31,55
Coleraine,3024,2,14,10,2,44,26,18,52
Glenavon,3024,3,10,9,7,56,44,12,39
Linfield,3024,4,11,5,10,40,36,4,38
Cliftonville,3024,5,9,4,13,32,34,-2,31
Ballymena,3024,6,7,5,14,27,49,-22,26
Glentoran,3024,7,6,6,10,24,32,-8,24
Dungannon,3024,8,2,4,16,14,47,-33,10
Crusaders,3025,1,16,7,3,61,30,31,55
Coleraine,3025,2,14,10,2,44,26,18,52
Glenavon,3025,3,10,9,7,56,44,12,39
Linfield,3025,4,11,5,10,39,36,3,38
Cliftonville,3025,5,9,4,13,32,33,-1,31
Ballymena,3025,6,7,5,14,25,47,-22,26
Glentoran,3025,7,6,6,10,24,32,-8,24
Dungannon,3025,8,2,4,16,14,47,-33,10
Crusaders,3026,1,16,6,4,63,33,30,54
Coleraine,3026,2,14,10,2,45,28,17,52
Glenavon,3026,3,10,9,7,58,45,13,39
Linfield,3026,4,10,6,10,37,36,1,36
Cliftonville,3026,5,9,5,12,32,31,1,32
Ballymena,3026,6,8,4,14,28,49,-21,28
Glentoran,3026,7,6,6,10,24,32,-8,24
Dungannon,3026,8,2,4,16,14,47,-33,10
Crusaders,3027,1,17,6,3,66,31,35,57
Coleraine,3027,2,14,11,1,46,25,21,53
Glenavon,3027,3,9,10,7,55,46,9,37
Linfield,3027,4,10,6,10,37,36,1,36
Cliftonville,3027,5,9,5,12,32,31,1,32
Ballymena,3027,6,7,4,15,26,52,-26,25
Glentoran,3027,7,6,6,10,24,32,-8,24
Dungannon,3027,8,2,4,16,14,47,-33,10
Crusaders,3028,1,17,6,3,64,32,32,57
Coleraine,3028,2,15,10,1,46,22,24,55
Linfield,3028,3,11,5,10,38,36,2,38
Glenavon,3028,4,9,9,8,52,46,6,36
Cliftonville,3028,5,9,4,13,32,32,0,31
Ballymena,3028,6,7,4,15,27,50,-23,25
Glentoran,3028,7,6,6,10,24,32,-8,24
Dungannon,3028,8,2,4,16,14,47,-33,10
Coleraine,3029,1,15,10,1,44,22,22,55
Crusaders,3029,2,16,6,4,61,32,29,54
Glenavon,3029,3,9,9,8,52,44,8,36
Linfield,3029,4,10,6,10,40,39,1,36
Cliftonville,3029,5,9,5,12,35,34,1,32
Ballymena,3029,6,8,4,14,27,47,-20,28
Glentoran,3029,7,6,6,10,24,32,-8,24
Dungannon,3029,8,2,4,16,14,47,-33,10
Crusaders,3030,1,16,7,3,62,31,31,55
Coleraine,3030,2,14,10,2,43,25,18,52
Glenavon,3030,3,10,9,7,55,43,12,39
Linfield,3030,4,10,5,11,37,37,0,35
Cliftonville,3030,5,10,4,12,33,31,2,34
Ballymena,3030,6,7,5,14,26,48,-22,26
Glentoran,3030,7,6,6,10,24,32,-8,24
Dungannon,3030,8,2,4,16,14,47,-33,10
Crusaders,3031,1,17,6,3,63,30,33,57
Coleraine,3031,2,14,10,2,43,25,18,52
Glenavon,3031,3,10,9,7,55,43,12,39
Linfield,3031,4,11,5,10,40,36,4,38
Cliftonville,3031,5,9,4,13,32,34,-2,31
Ballymena,3031,6,7,4,15,25,49,-24,25
Glentoran,3031,7,6,6,10,24,32,-8,24
Dungannon,3031,8,2,4,16,14,47,-33,10
Crusaders,3032,1,17,6,3,63,30,33,57
Coleraine,3032,2,14,11,1,45,24,21,53
Linfield,3032,3,11,5,10,40,37,3,38
Glenavon,3032,4,9,10,7,54,45,9,37
Cliftonville,3032,5,9,4,13,33,34,-1,31
Ballymena,3032,6,7,4,15,25,49,-24,25
Glentoran,3032,7,6,6,10,24,32,-8,24
Dungannon,3032,8,2,4,16,14,47,-33,10
Crusaders,3033,1,17,6,3,64,31,33,57
Coleraine,3033,2,14,10,2,45,26,19,52
Glenavon,3033,3,10,9,7,56,45,11,39
Linfield,3033,4,11,5,10,38,36,2,38
Cliftonville,3033,5,9,4,13,32,32,0,31
Ballymena,3033,6,7,4,15,26,50,-24,25
Glentoran,3033,7,6,6,10,24,32,-8,24
Dungannon,3033,8,2,4,16,14,47,-33,10
Coleraine,3034,1,15,10,1,45,23,22,55
Crusaders,3034,2,16,6,4,62,33,29,54
Linfield,3034,3,11,5,10,38,36,2,38
Glenavon,3034,4,9,9,8,53,45,8,36
Cliftonville,3034,5,9,4,13,32,32,0,31
Ballymena,3034,6,8,4,14,28,48,-20,28
Glentoran,3034,7,6,6,10,24,32,-8,24
Dungannon,3034,8,2,4,16,14,47,-33,10
Coleraine,3035,1,15,10,1,45,23,22,55
Crusaders,3035,2,16,6,4,63,34,29,54
Glenavon,3035,3,9,9,8,53,45,8,36
Linfield,3035,4,10,5,11,38,38,0,35
Cliftonville,3035,5,10,4,12,34,32,2,34
Ballymena,3035,6,8,4,14,29,49,-20,28
Glentoran,3035,7,6,6,10,24,32,-8,24
Dungannon,3035,8,2,4,16,14,47,-33,10
Crusaders,3036,1,16,6,4,61,31,30,54
Coleraine,3036,2,14,10,2,43,24,19,52
Glenavon,3036,3,10,9,7,54,43,11,39
Linfield,3036,4,11,5,10,39,36,3,38
Cliftonville,3036,5,9,4,13,32,33,-1,31
Ballymena,3036,6,8,4,14,26,47,-21,28
Glentoran,3036,7,6,6,10,24,32,-8,24
Dungannon,3036,8,2,4,16,14,47,-33,10
Crusaders,3037,1,16,6,4,63,33,30,54
Coleraine,3037,2,14,10,2,45,25,20,52
Glenavon,3037,3,10,9,7,55,45,10,39
Linfield,3037,4,10,5,11,37,38,-1,35
Cliftonville,3037,5,10,4,12,34,31,3,34
Ballymena,3037,6,8,4,14,28,49,-21,28
Glentoran,3037,7,6,6,10,24,32,-8,24
Dungannon,3037,8,2,4,16,14,47,-33,10
Crusaders,3038,1,17,6,3,62,30,32,57
Coleraine,3038,2,15,10,1,44,22,22,55
Linfield,3038,3,11,5,10,40,36,4,38
Glenavon,3038,4,9,9,8,52,44,8,36
Cliftonville,3038,5,9,4,13,32,34,-2,31
Ballymena,3038,6,7,4,15,25,48,-23,25
Glentoran,3038,7,6,6,10,24,32,-8,24
Dungannon,3038,8,2,4,16,14,47,-33,10
Crusaders,3039,1,17,6,3,63,30,33,57
Coleraine,3039,2,15,10,1,46,23,23,55
Glenavon,3039,3,9,9,8,53,46,7,36
Linfield,3039,4,10,5,11,38,38,0,35
Cliftonville,3039,5,10,4,12,34,32,2,34
Ballymena,3039,6,7,4,15,25,49,-24,25
Glentoran,3039,7,6,6,10,24,32,-8,24
Dungannon,3039,8,2,4,16,14,47,-33,10
Crusaders,3040,1,17,6,3,64,31,33,57
Coleraine,3040,2,15,10,1,47,23,24,55
Linfield,3040,3,11,5,10,38,36,2,38
Glenavon,3040,4,9,9,8,53,47,6,36
Cliftonville,3040,5,9,4,13,32,32,0,31
Ballymena,3040,6,7,4,15,26,50,-24,25
Glentoran,3040,7,6,6,10,24,32,-8,24
Dungannon,3040,8,2,4,16,14,47,-33,10
Crusaders,3041,1,17,6,3,63,31,32,57
Coleraine,3041,2,14,10,2,45,25,20,52
Glenavon,3041,3,10,9,7,55,45,10,39
Linfield,3041,4,11,5,10,40,36,4,38
Cliftonville,3041,5,9,4,13,32,34,-2,31
Ballymena,3041,6,7,4,15,26,49,-23,25
Glentoran,3041,7,6,6,10,24,32,-8,24
Dungannon,3041,8,2,4,16,14,47,-33,10
Crusaders,3042,1,16,6,4,62,32,30,54
Coleraine,3042,2,14,11,1,44,23,21,53
Glenavon,3042,3,9,10,7,53,44,9,37
Linfield,3042,4,10,6,10,37,36,1,36
Cliftonville,3042,5,9,5,12,32,31,1,32
Ballymena,3042,6,8,4,14,27,48,-21,28
Glentoran,3042,7,6,6,10,24,32,-8,24
Dungannon,3042,8,2,4,16,14,47,-33,10
Crusaders,3043,1,17,6,3,63,31,32,57
Coleraine,3043,2,14,10,2,43,23,20,52
Glenavon,3043,3,10,9,7,53,43,10,39
Linfield,3043,4,10,6,10,39,38,1,36
Cliftonville,3043,5,9,5,12,34,33,1,32
Ballymena,3043,6,7,4,15,26,49,-23,25
Glentoran,3043,7,6,6,10,24,32,-8,24
Dungannon,3043,8,2,4,16,14,47,-33,10
Crusaders,3044,1,17,6,3,64,30,34,57
Coleraine,3044,2,14,11,1,43,22,21,53
Linfield,3044,3,11,5,10,38,36,2,38
Glenavon,3044,4,9,10,7,52,43,9,37
Cliftonville,3044,5,9,4,13,32,32,0,31
Ballymena,3044,6,7,4,15,25,50,-25,25
Glentoran,3044,7,6,6,10,24,32,-8,24
Dungannon,3044,8,2,4,16,14,47,-33,10
Crusaders,3045,1,16,6,4,62,33,29,54
Coleraine,3045,2,14,11,1,44,23,21,53
Linfield,3045,3,11,5,10,41,36,5,38
Glenavon,3045,4,9,10,7,53,44,9,37
Cliftonville,3045,5,9,4,13,32,35,-3,31
Ballymena,3045,6,8,4,14,28,48,-20,28
Glentoran,3045,7,6,6,10,24,32,-8,24
Dungannon,3045,8,2,4,16,14,47,-33,10
Crusaders,3046,1,16,7,3,62,31,31,55
Coleraine,3046,2,15,10,1,45,22,23,55
Glenavon,3046,3,9,9,8,52,45,7,36
Linfield,3046,4,10,5,11,39,39,0,35
Cliftonville,3046,5,10,4,12,35,33,2,34
Ballymena,3046,6,7,5,14,26,48,-22,26
Glentoran,3046,7,6,6,10,24,32,-8,24
Dungannon,3046,8,2,4,16,14,47,-33,10
Coleraine,3047,1,15,10,1,45,22,23,55
Crusaders,3047,2,16,6,4,61,32,29,54
Linfield,3047,3,11,5,10,38,36,2,38
Glenavon,3047,4,9,9,8,52,45,7,36
Cliftonville,3047,5,9,4,13,32,32,0,31
Ballymena,3047,6,8,4,14,27,47,-20,28
Glentoran,3047,7,6,6,10,24,32,-8,24
Dungannon,3047,8,2,4,16,14,47,-33,10
Coleraine,3048,1,15,10,1,45,23,22,55
Crusaders,3048,2,16,6,4,62,33,29,54
Linfield,3048,3,11,5,10,38,36,2,38
Glenavon,3048,4,9,9,8,53,45,8,36
Cliftonville,3048,5,9,4,13,32,32,0,31
Ballymena,3048,6,8,4,14,28,48,-20,28
Glentoran,3048,7,6,6,10,24,32,-8,24
Dungannon,3048,8,2,4,16,14,47,-33,10
Crusaders,3049,1,16,6,4,62,32,30,54
Coleraine,3049,2,14,11,1,44,23,21,53
Glenavon,3049,3,9,10,7,53,44,9,37
Linfield,3049,4,10,5,11,38,38,0,35
Cliftonville,3049,5,10,4,12,34,32,2,34
Ballymena,3049,6,8,4,14,27,48,-21,28
Glentoran,3049,7,6,6,10,24,32,-8,24
Dungannon,3049,8,2,4,16,14,47,-33,10
Crusaders,3050,1,17,6,3,64,32,32,57
Coleraine,3050,2,14,11,1,44,23,21,53
Linfield,3050,3,11,5,10,40,37,3,38
Glenavon,3050,4,9,10,7,53,44,9,37
Cliftonville,3050,5,9,4,13,33,34,-1,31
Ballymena,3050,6,7,4,15,27,50,-23,25
Glentoran,3050,7,6,6,10,24,32,-8,24
Dungannon,3050,8,2,4,16,14,47,-33,10
Crusaders,3051,1,17,6,3,65,30,35,57
Coleraine,3051,2,14,10,2,43,26,17,52
Glenavon,3051,3,10,9,7,56,43,13,39
Linfield,3051,4,11,5,10,40,38,2,38
Cliftonville,3051,5,9,4,13,34,34,0,31
Ballymena,3051,6,7,4,15,25,51,-26,25
Glentoran,3051,7,6,6,10,24,32,-8,24
Dungannon,3051,8,2,4,16,14,47,-33,10
Crusaders,3052,1,17,6,3,64,32,32,57
Coleraine,3052,2,14,10,2,44,24,20,52
Glenavon,3052,3,10,9,7,54,44,10,39
Linfield,3052,4,10,6,10,38,37,1,36
Cliftonville,3052,5,9,5,12,33,32,1,32
Ballymena,3052,6,7,4,15,27,50,-23,25
Glentoran,3052,7,6,6,10,24,32,-8,24
Dungannon,3052,8,2,4,16,14,47,-33,10
Crusaders,3053,1,17,6,3,62,30,32,57
Coleraine,3053,2,14,10,2,43,23,20,52
Glenavon,3053,3,10,9,7,53,43,10,39
Linfield,3053,4,10,6,10,38,37,1,36
Cliftonville,3053,5,9,5,12,33,32,1,32
Ballymena,3053,6,7,4,15,25,48,-23,25
Glentoran,3053,7,6,6,10,24,32,-8,24
Dungannon,3053,8,2,4,16,14,47,-33,10
Crusaders,3054,1,17,6,3,62,30,32,57
Coleraine,3054,2,14,10,2,43,24,19,52
Glenavon,3054,3,10,9,7,54,43,11,39
Linfield,3054,4,10,5,11,37,37,0,35
Cliftonville,3054,5,10,4,12,33,31,2,34
Ballymena,3054,6,7,4,15,25,48,-23,25
Glentoran,3054,7,6,6,10,24,32,-8,24
Dungannon,3054,8,2,4,16,14,47,-33,10
Crusaders,3055,1,16,6,4,62,33,29,54
Coleraine,3055,2,14,10,2,44,24,20,52
Glenavon,3055,3,10,9,7,54,44,10,39
Linfield,3055,4,10,5,11,37,38,-1,35
Cliftonville,3055,5,10,4,12,34,31,3,34
Ballymena,3055,6,8,4,14,28,48,-20,28
Glentoran,3055,7,6,6,10,24,32,-8,24
Dungannon,3055,8,2,4,16,14,47,-33,10
Crusaders,3056,1,17,6,3,68,31,37,57
Coleraine,3056,2,14,10,2,44,27,17,52
Glenavon,3056,3,10,9,7,57,44,13,39
Linfield,3056,4,10,5,11,38,38,0,35
Cliftonville,3056,5,10,4,12,34,32,2,34
Ballymena,3056,6,7,4,15,26,54,-28,25
Glentoran,3056,7,6,6,10,24,32,-8,24
Dungannon,3056,8,2,4,16,14,47,-33,10
Crusaders,3057,1,16,6,4,61,32,29,54
Coleraine,3057,2,14,10,2,44,24,20,52
Glenavon,3057,3,10,9,7,54,44,10,39
Linfield,3057,4,10,5,11,38,38,0,35
Cliftonville,3057,5,10,4,12,34,32,2,34
Ballymena,3057,6,8,4,14,27,47,-20,28
Glentoran,3057,7,6,6,10,24,32,-8,24
Dungannon,3057,8,2,4,16,14,47,-33,10
Crusaders,3058,1,16,7,3,65,34,31,55
Coleraine,3058,2,14,11,1,46,25,21,53
Linfield,3058,3,11,5,10,39,37,2,38
Glenavon,3058,4,9,10,7,55,46,9,37
Cliftonville,3058,5,9,4,13,33,33,0,31
Ballymena,3058,6,7,5,14,29,51,-22,26
Glentoran,3058,7,6,6,10,24,32,-8,24
Dungannon,3058,8,2,4,16,14,47,-33,10
Crusaders,3059,1,17,6,3,66,32,34,57
Coleraine,3059,2,15,10,1,45,23,22,55
Linfield,3059,3,11,5,10,39,37,2,38
Glenavon,3059,4,9,9,8,53,45,8,36
Cliftonville,3059,5,9,4,13,33,33,0,31
Ballymena,3059,6,7,4,15,27,52,-25,25
Glentoran,3059,7,6,6,10,24,32,-8,24
Dungannon,3059,8,2,4,16,14,47,-33,10
Crusaders,3060,1,17,6,3,64,32,32,57
Coleraine,3060,2,14,10,2,43,26,17,52
Glenavon,3060,3,10,9,7,56,43,13,39
Linfield,3060,4,11,5,10,38,36,2,38
Cliftonville,3060,5,9,4,13,32,32,0,31
Ballymena,3060,6,7,4,15,27,50,-23,25
Glentoran,3060,7,6,6,10,24,32,-8,24
Dungannon,3060,8,2,4,16,14,47,-33,10
Crusaders,3061,1,16,7,3,63,32,31,55
Coleraine,3061,2,14,10,2,44,25,19,52
Glenavon,3061,3,10,9,7,55,44,11,39
Linfield,3061,4,10,5,11,38,40,-2,35
Cliftonville,3061,5,10,4,12,36,32,4,34
Ballymena,3061,6,7,5,14,27,49,-22,26
Glentoran,3061,7,6,6,10,24,32,-8,24
Dungannon,3061,8,2,4,16,14,47,-33,10
Crusaders,3062,1,16,7,3,62,31,31,55
Coleraine,3062,2,14,10,2,43,25,18,52
Glenavon,3062,3,10,9,7,55,43,12,39
Linfield,3062,4,11,5,10,42,37,5,38
Cliftonville,3062,5,9,4,13,33,36,-3,31
Ballymena,3062,6,7,5,14,26,48,-22,26
Glentoran,3062,7,6,6,10,24,32,-8,24
Dungannon,3062,8,2,4,16,14,47,-33,10
Crusaders,3063,1,17,6,3,66,30,36,57
Coleraine,3063,2,14,10,2,44,25,19,52
Glenavon,3063,3,10,9,7,55,44,11,39
Linfield,3063,4,11,5,10,40,38,2,38
Cliftonville,3063,5,9,4,13,34,34,0,31
Ballymena,3063,6,7,4,15,25,52,-27,25
Glentoran,3063,7,6,6,10,24,32,-8,24
Dungannon,3063,8,2,4,16,14,47,-33,10
Crusaders,3064,1,17,6,3,64,32,32,57
Coleraine,3064,2,14,10,2,43,23,20,52
Glenavon,3064,3,10,9,7,53,43,10,39
Linfield,3064,4,10,6,10,39,38,1,36
Cliftonville,3064,5,9,5,12,34,33,1,32
Ballymena,3064,6,7,4,15,27,50,-23,25
Glentoran,3064,7,6,6,10,24,32,-8,24
Dungannon,3064,8,2,4,16,14,47,-33,10
Crusaders,3065,1,16,7,3,62,31,31,55
Coleraine,3065,2,15,10,1,46,23,23,55
Glenavon,3065,3,9,9,8,53,46,7,36
Linfield,3065,4,10,5,11,37,37,0,35
Cliftonville,3065,5,10,4,12,33,31,2,34
Ballymena,3065,6,7,5,14,26,48,-22,26
Glentoran,3065,7,6,6,10,24,32,-8,24
Dungannon,3065,8,2,4,16,14,47,-33,10
Crusaders,3066,1,16,7,3,63,32,31,55
Coleraine,3066,2,15,10,1,46,24,22,55
Linfield,3066,3,11,5,10,39,37,2,38
Glenavon,3066,4,9,9,8,54,46,8,36
Cliftonville,3066,5,9,4,13,33,33,0,31
Ballymena,3066,6,7,5,14,27,49,-22,26
Glentoran,3066,7,6,6,10,24,32,-8,24
Dungannon,3066,8,2,4,16,14,47,-33,10
Crusaders,3067,1,17,6,3,63,31,32,57
Coleraine,3067,2,14,10,2,44,25,19,52
Glenavon,3067,3,10,9,7,55,44,11,39
Linfield,3067,4,10,6,10,38,37,1,36
Cliftonville,3067,5,9,5,12,33,32,1,32
Ballymena,3067,6,7,4,15,26,49,-23,25
Glentoran,3067,7,6,6,10,24,32,-8,24
Dungannon,3067,8,2,4,16,14,47,-33,10
Crusaders,3068,1,16,6,4,62,33,29,54
Coleraine,3068,2,14,11,1,45,24,21,53
Linfield,3068,3,11,5,10,38,36,2,38
Glenavon,3068,4,9,10,7,54,45,9,37
Cliftonville,3068,5,9,4,13,32,32,0,31
Ballymena,3068,6,8,4,14,28,48,-20,28
Glentoran,3068,7,6,6,10,24,32,-8,24
Dungannon,3068,8,2,4,16,14,47,-33,10
Crusaders,3069,1,16,6,4,63,35,28,54
Coleraine,3069,2,14,10,2,43,26,17,52
Glenavon,3069,3,10,9,7,56,43,13,39
Linfield,3069,4,10,5,11,38,38,0,35
Cliftonville,3069,5,10,4,12,34,32,2,34
Ballymena,3069,6,8,4,14,30,49,-19,28
Glentoran,3069,7,6,6,10,24,32,-8,24
Dungannon,3069,8,2,4,16,14,47,-33,10
Crusaders,3070,1,17,6,3,63,30,33,57
Coleraine,3070,2,15,10,1,45,23,22,55
Linfield,3070,3,11,5,10,38,36,2,38
Glenavon,3070,4,9,9,8,53,45,8,36
Cliftonville,3070,5,9,4,13,32,32,0,31
Ballymena,3070,6,7,4,15,25,49,-24,25
Glentoran,3070,7,6,6,10,24,32,-8,24
Dungannon,3070,8,2,4,16,14,47,-33,10
Crusaders,3071,1,17,6,3,63,31,32,57
Coleraine,3071,2,15,10,1,48,25,23,55
Linfield,3071,3,11,5,10,39,36,3,38
Glenavon,3071,4,9,9,8,55,48,7,36
Cliftonville,3071,5,9,4,13,32,33,-1,31
Ballymena,3071,6,7,4,15,26,49,-23,25
Glentoran,3071,7,6,6,10,24,32,-8,24
Dungannon,3071,8,2,4,16,14,47,-33,10
Crusaders,3072,1,17,6,3,63,31,32,57
Coleraine,3072,2,14,10,2,43,25,18,52
Glenavon,3072,3,10,9,7,55,43,12,39
Linfield,3072,4,10,5,11,37,38,-1,35
Cliftonville,3072,5,10,4,12,34,31,3,34
Ballymena,3072,6,7,4,15,26,49,-23,25
Glentoran,3072,7,6,6,10,24,32,-8,24
Dungannon,3072,8,2,4,16,14,47,-33,10
Coleraine,3073,1,15,10,1,44,22,22,55
Crusaders,3073,2,16,6,4,62,33,29,54
Linfield,3073,3,11,5,10,40,36,4,38
Glenavon,3073,4,9,9,8,52,44,8,36
Cliftonville,3073,5,9,4,13,32,34,-2,31
Ballymena,3073,6,8,4,14,28,48,-20,28
Glentoran,3073,7,6,6,10,24,32,-8,24
Dungannon,3073,8,2,4,16,14,47,-33,10
Crusaders,3074,1,16,6,4,62,32,30,54
Coleraine,3074,2,14,10,2,44,27,17,52
Glenavon,3074,3,10,9,7,57,44,13,39
Linfield,3074,4,11,5,10,39,36,3,38
Cliftonville,3074,5,9,4,13,32,33,-1,31
Ballymena,3074,6,8,4,14,27,48,-21,28
Glentoran,3074,7,6,6,10,24,32,-8,24
Dungannon,3074,8,2,4,16,14,47,-33,10
Crusaders,3075,1,17,6,3,66,31,35,57
Coleraine,3075,2,14,11,1,46,25,21,53
Glenavon,3075,3,9,10,7,55,46,9,37
Linfield,3075,4,10,5,11,37,37,0,35
Cliftonville,3075,5,10,4,12,33,31,2,34
Ballymena,3075,6,7,4,15,26,52,-26,25
Glentoran,3075,7,6,6,10,24,32,-8,24
Dungannon,3075,8,2,4,16,14,47,-33,10
Crusaders,3076,1,17,6,3,64,32,32,57
Coleraine,3076,2,14,10,2,44,26,18,52
Glenavon,3076,3,10,9,7,56,44,12,39
Linfield,3076,4,11,5,10,38,36,2,38
Cliftonville,3076,5,9,4,13,32,32,0,31
Ballymena,3076,6,7,4,15,27,50,-23,25
Glentoran,3076,7,6,6,10,24,32,-8,24
Dungannon,3076,8,2,4,16,14,47,-33,10
Coleraine,3077,1,15,10,1,48,23,25,55
Crusaders,3077,2,16,6,4,61,31,30,54
Glenavon,3077,3,9,9,8,53,48,5,36
Linfield,3077,4,10,6,10,37,36,1,36
Cliftonville,3077,5,9,5,12,32,31,1,32
Ballymena,3077,6,8,4,14,26,47,-21,28
Glentoran,3077,7,6,6,10,24,32,-8,24
Dungannon,3077,8,2,4,16,14,47,-33,10
Crusaders,3078,1,17,6,3,64,31,33,57
Coleraine,3078,2,15,10,1,44,22,22,55
Linfield,3078,3,11,5,10,40,37,3,38
Glenavon,3078,4,9,9,8,52,44,8,36
Cliftonville,3078,5,9,4,13,33,34,-1,31
Ballymena,3078,6,7,4,15,26,50,-24,25
Glentoran,3078,7,6,6,10,24,32,-8,24
Dungannon,3078,8,2,4,16,14,47,-33,10
Crusaders,3079,1,17,6,3,64,31,33,57
Coleraine,3079,2,15,10,1,45,23,22,55
Glenavon,3079,3,9,9,8,53,45,8,36
Linfield,3079,4,10,5,11,37,37,0,35
Cliftonville,3079,5,10,4,12,33,31,2,34
Ballymena,3079,6,7,4,15,26,50,-24,25
Glentoran,3079,7,6,6,10,24,32,-8,24
Dungannon,3079,8,2,4,16,14,47,-33,10
Crusaders,3080,1,16,7,3,62,31,31,55
Coleraine,3080,2,14,11,1,44,23,21,53
Linfield,3080,3,11,5,10,38,36,2,38
Glenavon,3080,4,9,10,7,53,44,9,37
Cliftonville,3080,5,9,4,13,32,32,0,31
Ballymena,3080,6,7,5,14,26,48,-22,26
Glentoran,3080,7,6,6,10,24,32,-8,24
Dungannon,3080,8,2,4,16,14,47,-33,10
Crusaders,3081,1,16,7,3,62,31,31,55
Coleraine,3081,2,14,11,1,44,23,21,53
Linfield,3081,3,11,5,10,41,36,5,38
Glenavon,3081,4,9,10,7,53,44,9,37
Cliftonville,3081,5,9,4,13,32,35,-3,31
Ballymena,3081,6,7,5,14,26,48,-22,26
Glentoran,3081,7,6,6,10,24,32,-8,24
Dungannon,3081,8,2,4,16,14,47,-33,10
Crusaders,3082,1,16,6,4,61,33,28,54
Coleraine,3082,2,14,10,2,43,25,18,52
Glenavon,3082,3,10,9,7,55,43,12,39
Linfield,3082,4,11,5,10,40,36,4,38
Cliftonville,3082,5,9,4,13,32,34,-2,31
Ballymena,3082,6,8,4,14,28,47,-19,28
Glentoran,3082,7,6,6,10,24,32,-8,24
Dungannon,3082,8,2,4,16,14,47,-33,10
Crusaders,3083,1,16,6,4,62,32,30,54
Coleraine,3083,2,14,11,1,44,23,21,53
Glenavon,3083,3,9,10,7,53,44,9,37
Linfield,3083,4,10,6,10,38,37,1,36
Cliftonville,3083,5,9,5,12,33,32,1,32
Ballymena,3083,6,8,4,14,27,48,-21,28
Glentoran,3083,7,6,6,10,24,32,-8,24
Dungannon,3083,8,2,4,16,14,47,-33,10
Crusaders,3084,1,17,6,3,65,30,35,57
Coleraine,3084,2,14,10,2,44,25,19,52
Glenavon,3084,3,10,9,7,55,44,11,39
Linfield,3084,4,11,5,10,39,37,2,38
Cliftonville,3084,5,9,4,13,33,33,0,31
Ballymena,3084,6,7,4,15,25,51,-26,25
Glentoran,3084,7,6,6,10,24,32,-8,24
Dungannon,3084,8,2,4,16,14,47,-33,10
Crusaders,3085,1,17,6,3,64,30,34,57
Coleraine,3085,2,14,11,1,44,23,21,53
Linfield,3085,3,11,5,10,41,37,4,38
Glenavon,3085,4,9,10,7,53,44,9,37
Cliftonville,3085,5,9,4,13,33,35,-2,31
Ballymena,3085,6,7,4,15,25,50,-25,25
Glentoran,3085,7,6,6,10,24,32,-8,24
Dungannon,3085,8,2,4,16,14,47,-33,10
Crusaders,3086,1,17,6,3,65,30,35,57
Coleraine,3086,2,14,11,1,46,25,21,53
Linfield,3086,3,11,5,10,38,36,2,38
Glenavon,3086,4,9,10,7,55,46,9,37
Cliftonville,3086,5,9,4,13,32,32,0,31
Ballymena,3086,6,7,4,15,25,51,-26,25
Glentoran,3086,7,6,6,10,24,32,-8,24
Dungannon,3086,8,2,4,16,14,47,-33,10
Coleraine,3087,1,15,10,1,46,23,23,55
Crusaders,3087,2,16,6,4,62,33,29,54
Glenavon,3087,3,9,9,8,53,46,7,36
Linfield,3087,4,10,5,11,37,37,0,35
Cliftonville,3087,5,10,4,12,33,31,2,34
Ballymena,3087,6,8,4,14,28,48,-20,28
Glentoran,3087,7,6,6,10,24,32,-8,24
Dungannon,3087,8,2,4,16,14,47,-33,10
Crusaders,3088,1,16,6,4,61,32,29,54
Coleraine,3088,2,14,10,2,44,27,17,52
Glenavon,3088,3,10,9,7,57,44,13,39
Linfield,3088,4,10,6,10,38,37,1,36
Cliftonville,3088,5,9,5,12,33,32,1,32
Ballymena,3088,6,8,4,14,27,47,-20,28
Glentoran,3088,7,6,6,10,24,32,-8,24
Dungannon,3088,8,2,4,16,14,47,-33,10
Crusaders,3089,1,16,6,4,61,31,30,54
Coleraine,3089,2,14,10,2,45,25,20,52
Glenavon,3089,3,10,9,7,55,45,10,39
Linfield,3089,4,10,6,10,38,37,1,36
Cliftonville,3089,5,9,5,12,33,32,1,32
Ballymena,3089,6,8,4,14,26,47,-21,28
Glentoran,3089,7,6,6,10,24,32,-8,24
Dungannon,3089,8,2,4,16,14,47,-33,10
Crusaders,3090,1,17,6,3,63,30,33,57
Coleraine,3090,2,15,10,1,45,22,23,55
Linfield,3090,3,11,5,10,39,37,2,38
Glenavon,3090,4,9,9,8,52,45,7,36
Cliftonville,3090,5,9,4,13,33,33,0,31
Ballymena,3090,6,7,4,15,25,49,-24,25
Glentoran,3090,7,6,6,10,24,32,-8,24
Dungannon,3090,8,2,4,16,14,47,-33,10
Coleraine,3091,1,15,10,1,45,22,23,55
Crusaders,3091,2,16,6,4,61,32,29,54
Glenavon,3091,3,9,9,8,52,45,7,36
Linfield,3091,4,10,5,11,38,39,-1,35
Cliftonville,3091,5,10,4,12,35,32,3,34
Ballymena,3091,6,8,4,14,27,47,-20,28
Glentoran,3091,7,6,6,10,24,32,-8,24
Dungannon,3091,8,2,4,16,14,47,-33,10
Crusaders,3092,1,16,7,3,62,31,31,55
Coleraine,3092,2,14,11,1,44,23,21,53
Linfield,3092,3,11,5,10,40,38,2,38
Glenavon,3092,4,9,10,7,53,44,9,37
Cliftonville,3092,5,9,4,13,34,34,0,31
Ballymena,3092,6,7,5,14,26,48,-22,26
Glentoran,3092,7,6,6,10,24,32,-8,24
Dungannon,3092,8,2,4,16,14,47,-33,10
Crusaders,3093,1,17,6,3,65,31,34,57
Coleraine,3093,2,14,10,2,44,25,19,52
Glenavon,3093,3,10,9,7,55,44,11,39
Linfield,3093,4,10,6,10,38,37,1,36
Cliftonville,3093,5,9,5,12,33,32,1,32
Ballymena,3093,6,7,4,15,26,51,-25,25
Glentoran,3093,7,6,6,10,24,32,-8,24
Dungannon,3093,8,2,4,16,14,47,-33,10
Crusaders,3094,1,17,6,3,63,30,33,57
Coleraine,3094,2,14,11,1,45,24,21,53
Glenavon,3094,3,9,10,7,54,45,9,37
Linfield,3094,4,10,6,10,38,37,1,36
Cliftonville,3094,5,9,5,12,33,32,1,32
Ballymena,3094,6,7,4,15,25,49,-24,25
Glentoran,3094,7,6,6,10,24,32,-8,24
Dungannon,3094,8,2,4,16,14,47,-33,10
Crusaders,3095,1,16,7,3,63,32,31,55
Coleraine,3095,2,14,10,2,43,26,17,52
Glenavon,3095,3,10,9,7,56,43,13,39
Linfield,3095,4,10,6,10,38,37,1,36
Cliftonville,3095,5,9,5,12,33,32,1,32
Ballymena,3095,6,7,5,14,27,49,-22,26
Glentoran,3095,7,6,6,10,24,32,-8,24
Dungannon,3095,8,2,4,16,14,47,-33,10
Crusaders,3096,1,16,7,3,62,31,31,55
Coleraine,3096,2,14,11,1,43,22,21,53
Linfield,3096,3,11,5,10,38,36,2,38
Glenavon,3096,4,9,10,7,52,43,9,37
Cliftonville,3096,5,9,4,13,32,32,0,31
Ballymena,3096,6,7,5,14,26,48,-22,26
Glentoran,3096,7,6,6,10,24,32,-8,24
Dungannon,3096,8,2,4,16,14,47,-33,10
Coleraine,3097,1,15,10,1,47,23,24,55
Crusaders,3097,2,16,6,4,62,33,29,54
Glenavon,3097,3,9,9,8,53,47,6,36
Linfield,3097,4,10,6,10,37,36,1,36
Cliftonville,3097,5,9,5,12,32,31,1,32
Ballymena,3097,6,8,4,14,28,48,-20,28
Glentoran,3097,7,6,6,10,24,32,-8,24
Dungannon,3097,8,2,4,16,14,47,-33,10
Coleraine,3098,1,15,10,1,44,22,22,55
Crusaders,3098,2,16,6,4,62,32,30,54
Glenavon,3098,3,9,9,8,52,44,8,36
Linfield,3098,4,10,6,10,40,39,1,36
Cliftonville,3098,5,9,5,12,35,34,1,32
Ballymena,3098,6,8,4,14,27,48,-21,28
Glentoran,3098,7,6,6,10,24,32,-8,24
Dungannon,3098,8,2,4,16,14,47,-33,10
Crusaders,3099,1,17,6,3,65,30,35,57
Coleraine,3099,2,14,10,2,43,24,19,52
Glenavon,3099,3,10,9,7,54,43,11,39
Linfield,3099,4,10,6,10,37,36,1,36
Cliftonville,3099,5,9,5,12,32,31,1,32
Ballymena,3099,6,7,4,15,25,51,-26,25
Glentoran,3099,7,6,6,10,24,32,-8,24
Dungannon,3099,8,2,4,16,14,47,-33,10
Crusaders,3100,1,16,7,3,63,32,31,55
Coleraine,3100,2,14,10,2,43,25,18,52
Glenavon,3100,3,10,9,7,55,43,12,39
Linfield,3100,4,11,5,10,39,37,2,38
Cliftonville,3100,5,9,4,13,33,33,0,31
Ballymena,3100,6,7,5,14,27,49,-22,26
Glentoran,3100,7,6,6,10,24,32,-8,24
Dungannon,3100,8,2,4,16,14,47,-33,10
Crusaders,3101,1,17,6,3,64,32,32,57
Coleraine,3101,2,14,10,2,43,24,19,52
Glenavon,3101,3,10,9,7,54,43,11,39
Linfield,3101,4,11,5,10,41,36,5,38
Cliftonville,3101,5,9,4,13,32,35,-3,31
Ballymena,3101,6,7,4,15,27,50,-23,25
Glentoran,3101,7,6,6,10,24,32,-8,24
Dungannon,3101,8,2,4,16,14,47,-33,10
Crusaders,3102,1,17,6,3,64,31,33,57
Coleraine,3102,2,14,11,1,44,23,21,53
Linfield,3102,3,11,5,10,40,36,4,38
Glenavon,3102,4,9,10,7,53,44,9,37
Cliftonville,3102,5,9,4,13,32,34,-2,31
Ballymena,3102,6,7,4,15,26,50,-24,25
Glentoran,3102,7,6,6,10,24,32,-8,24
Dungannon,3102,8,2,4,16,14,47,-33,10
Crusaders,3103,1,17,6,3,63,30,33,57
Coleraine,3103,2,14,11,1,45,24,21,53
Linfield,3103,3,11,5,10,39,37,2,38
Glenavon,3103,4,9,10,7,54,45,9,37
Cliftonville,3103,5,9,4,13,33,33,0,31
Ballymena,3103,6,7,4,15,25,49,-24,25
Glentoran,3103,7,6,6,10,24,32,-8,24
Dungannon,3103,8,2,4,16,14,47,-33,10
Crusaders,3104,1,16,7,3,61,30,31,55
Coleraine,3104,2,14,10,2,45,25,20,52
Glenavon,3104,3,10,9,7,55,45,10,39
Linfield,3104,4,10,5,11,37,39,-2,35
Cliftonville,3104,5,10,4,12,35,31,4,34
Ballymena,3104,6,7,5,14,25,47,-22,26
Glentoran,3104,7,6,6,10,24,32,-8,24
Dungannon,3104,8,2,4,16,14,47,-33,10
Crusaders,3105,1,17,6,3,63,31,32,57
Coleraine,3105,2,14,10,2,43,24,19,52
Glenavon,3105,3,10,9,7,54,43,11,39
Linfield,3105,4,11,5,10,39,36,3,38
Cliftonville,3105,5,9,4,13,32,33,-1,31
Ballymena,3105,6,7,4,15,26,49,-23,25
Glentoran,3105,7,6,6,10,24,32,-8,24
Dungannon,3105,8,2,4,16,14,47,-33,10
Crusaders,3106,1,17,6,3,64,30,34,57
Coleraine,3106,2,14,10,2,44,25,19,52
Glenavon,3106,3,10,9,7,55,44,11,39
Linfield,3106,4,11,5,10,39,37,2,38
Cliftonville,3106,5,9,4,13,33,33,0,31
Ballymena,3106,6,7,4,15,25,50,-25,25
Glentoran,3106,7,6,6,10,24,32,-8,24
Dungannon,3106,8,2,4,16,14,47,-33,10
Crusaders,3107,1,16,7,3,62,31,31,55
Coleraine,3107,2,14,11,1,46,25,21,53
Linfield,3107,3,11,5,10,41,38,3,38
Glenavon,3107,4,9,10,7,55,46,9,37
Cliftonville,3107,5,9,4,13,34,35,-1,31
Ballymena,3107,6,7,5,14,26,48,-22,26
Glentoran,3107,7,6,6,10,24,32,-8,24
Dungannon,3107,8,2,4,16,14,47,-33,10
Crusaders,3108,1,16,6,4,62,32,30,54
Coleraine,3108,2,14,10,2,43,25,18,52
Glenavon,3108,3,10,9,7,55,43,12,39
Linfield,3108,4,11,5,10,41,37,4,38
Cliftonville,3108,5,9,4,13,33,35,-2,31
Ballymena,3108,6,8,4,14,27,48,-21,28
Glentoran,3108,7,6,6,10,24,32,-8,24
Dungannon,3108,8,2,4,16,14,47,-33,10
Crusaders,3109,1,17,6,3,62,30,32,57
Coleraine,3109,2,14,10,2,43,23,20,52
Glenavon,3109,3,10,9,7,53,43,10,39
Linfield,3109,4,10,6,10,38,37,1,36
Cliftonville,3109,5,9,5,12,33,32,1,32
Ballymena,3109,6,7,4,15,25,48,-23,25
Glentoran,3109,7,6,6,10,24,32,-8,24
Dungannon,3109,8,2,4,16,14,47,-33,10
Crusaders,3110,1,17,6,3,62,30,32,57
Coleraine,3110,2,14,11,1,46,25,21,53
Linfield,3110,3,11,5,10,39,37,2,38
Glenavon,3110,4,9,10,7,55,46,9,37
Cliftonville,3110,5,9,4,13,33,33,0,31
Ballymena,3110,6,7,4,15,25,48,-23,25
Glentoran,3110,7,6,6,10,24,32,-8,24
Dungannon,3110,8,2,4,16,14,47,-33,10
Coleraine,3111,1,15,10,1,48,23,25,55
Crusaders,3111,2,16,6,4,62,32,30,54
Glenavon,3111,3,9,9,8,53,48,5,36
Linfield,3111,4,10,6,10,38,37,1,36
Cliftonville,3111,5,9,5,12,33,32,1,32
Ballymena,3111,6,8,4,14,27,48,-21,28
Glentoran,3111,7,6,6,10,24,32,-8,24
Dungannon,3111,8,2,4,16,14,47,-33,10
Crusaders,3112,1,17,6,3,64,31,33,57
Coleraine,3112,2,15,10,1,45,23,22,55
Linfield,3112,3,11,5,10,39,36,3,38
Glenavon,3112,4,9,9,8,53,45,8,36
Cliftonville,3112,5,9,4,13,32,33,-1,31
Ballymena,3112,6,7,4,15,26,50,-24,25
Glentoran,3112,7,6,6,10,24,32,-8,24
Dungannon,3112,8,2,4,16,14,47,-33,10
Crusaders,3113,1,17,6,3,62,30,32,57
Coleraine,3113,2,15,10,1,45,23,22,55
Linfield,3113,3,11,5,10,39,36,3,38
Glenavon,3113,4,9,9,8,53,45,8,36
Cliftonville,3113,5,9,4,13,32,33,-1,31
Ballymena,3113,6,7,4,15,25,48,-23,25
Glentoran,3113,7,6,6,10,24,32,-8,24
Dungannon,3113,8,2,4,16,14,47,-33,10
Crusaders,3114,1,17,6,3,62,30,32,57
Coleraine,3114,2,15,10,1,45,22,23,55
Glenavon,3114,3,9,9,8,52,45,7,36
Linfield,3114,4,10,5,11,38,39,-1,35
Cliftonville,3114,5,10,4,12,35,32,3,34
Ballymena,3114,6,7,4,15,25,48,-23,25
Glentoran,3114,7,6,6,10,24,32,-8,24
Dungannon,3114,8,2,4,16,14,47,-33,10
Crusaders,3115,1,16,7,3,62,31,31,55
Coleraine,3115,2,15,10,1,44,22,22,55
Glenavon,3115,3,9,9,8,52,44,8,36
Linfield,3115,4,10,6,10,37,36,1,36
Cliftonville,3115,5,9,5,12,32,31,1,32
Ballymena,3115,6,7,5,14,26,48,-22,26
Glentoran,3115,7,6,6,10,24,32,-8,24
Dungannon,3115,8,2,4,16,14,47,-33,10
Crusaders,3116,1,17,6,3,67,32,35,57
Coleraine,3116,2,15,10,1,47,25,22,55
Linfield,3116,3,11,5,10,38,36,2,38
Glenavon,3116,4,9,9,8,55,47,8,36
Cliftonville,3116,5,9,4,13,32,32,0,31
Ballymena,3116,6,7,4,15,27,53,-26,25
Glentoran,3116,7,6,6,10,24,32,-8,24
Dungannon,3116,8,2,4,16,14,47,-33,10
Crusaders,3117,1,17,6,3,63,31,32,57
Coleraine,3117,2,15,10,1,46,23,23,55
Linfield,3117,3,11,5,10,39,37,2,38
Glenavon,3117,4,9,9,8,53,46,7,36
Cliftonville,3117,5,9,4,13,33,33,0,31
Ballymena,3117,6,7,4,15,26,49,-23,25
Glentoran,3117,7,6,6,10,24,32,-8,24
Dungannon,3117,8,2,4,16,14,47,-33,10
Crusaders,3118,1,16,7,3,62,31,31,55
Coleraine,3118,2,15,10,1,45,23,22,55
Glenavon,3118,3,9,9,8,53,45,8,36
Linfield,3118,4,10,5,11,37,37,0,35
Cliftonville,3118,5,10,4,12,33,31,2,34
Ballymena,3118,6,7,5,14,26,48,-22,26
Glentoran,3118,7,6,6,10,24,32,-8,24
Dungannon,3118,8,2,4,16,14,47,-33,10
Crusaders,3119,1,16,7,3,62,31,31,55
Coleraine,3119,2,14,11,1,44,23,21,53
Linfield,3119,3,11,5,10,42,36,6,38
Glenavon,3119,4,9,10,7,53,44,9,37
Cliftonville,3119,5,9,4,13,32,36,-4,31
Ballymena,3119,6,7,5,14,26,48,-22,26
Glentoran,3119,7,6,6,10,24,32,-8,24
Dungannon,3119,8,2,4,16,14,47,-33,10
Crusaders,3120,1,17,6,3,65,32,33,57
Coleraine,3120,2,14,10,2,43,23,20,52
Glenavon,3120,3,10,9,7,53,43,10,39
Linfield,3120,4,11,5,10,40,37,3,38
Cliftonville,3120,5,9,4,13,33,34,-1,31
Ballymena,3120,6,7,4,15,27,51,-24,25
Glentoran,3120,7,6,6,10,24,32,-8,24
Dungannon,3120,8,2,4,16,14,47,-33,10
Crusaders,3121,1,17,6,3,64,30,34,57
Coleraine,3121,2,14,11,1,44,23,21,53
Glenavon,3121,3,9,10,7,53,44,9,37
Linfield,3121,4,10,6,10,37,36,1,36
Cliftonville,3121,5,9,5,12,32,31,1,32
Ballymena,3121,6,7,4,15,25,50,-25,25
Glentoran,3121,7,6,6,10,24,32,-8,24
Dungannon,3121,8,2,4,16,14,47,-33,10
Crusaders,3122,1,17,6,3,65,31,34,57
Coleraine,3122,2,14,11,1,45,24,21,53
Linfield,3122,3,11,5,10,39,36,3,38
Glenavon,3122,4,9,10,7,54,45,9,37
Cliftonville,3122,5,9,4,13,32,33,-1,31
Ballymena,3122,6,7,4,15,26,51,-25,25
Glentoran,3122,7,6,6,10,24,32,-8,24
Dungannon,3122,8,2,4,16,14,47,-33,10
Crusaders,3123,1,16,6,4,63,33,30,54
Coleraine,3123,2,14,10,2,45,28,17,52
Glenavon,3123,3,10,9,7,58,45,13,39
Linfield,3123,4,11,5,10,39,37,2,38
Cliftonville,3123,5,9,4,13,33,33,0,31
Ballymena,3123,6,8,4,14,28,49,-21,28
Glentoran,3123,7,6,6,10,24,32,-8,24
Dungannon,3123,8,2,4,16,14,47,-33,10
Crusaders,3124,1,16,6,4,61,31,30,54
Coleraine,3124,2,14,11,1,45,24,21,53
Linfield,3124,3,11,5,10,39,37,2,38
Glenavon,3124,4,9,10,7,54,45,9,37
Cliftonville,3124,5,9,4,13,33,33,0,31
Ballymena,3124,6,8,4,14,26,47,-21,28
Glentoran,3124,7,6,6,10,24,32,-8,24
Dungannon,3124,8,2,4,16,14,47,-33,10
Crusaders,3125,1,16,6,4,62,32,30,54
Coleraine,3125,2,14,11,1,45,24,21,53
Glenavon,3125,3,9,10,7,54,45,9,37
Linfield,3125,4,10,5,11,37,37,0,35
Cliftonville,3125,5,10,4,12,33,31,2,34
Ballymena,3125,6,8,4,14,27,48,-21,28
Glentoran,3125,7,6,6,10,24,32,-8,24
Dungannon,3125,8,2,4,16,14,47,-33,10
Crusaders,3126,1,16,6,4,63,33,30,54
Coleraine,3126,2,14,11,1,43,22,21,53
Linfield,3126,3,11,5,10,40,38,2,38
Glenavon,3126,4,9,10,7,52,43,9,37
Cliftonville,3126,5,9,4,13,34,34,0,31
Ballymena,3126,6,8,4,14,28,49,-21,28
Glentoran,3126,7,6,6,10,24,32,-8,24
Dungannon,3126,8,2,4,16,14,47,-33,10
Crusaders,3127,1,17,6,3,65,31,34,57
Coleraine,3127,2,14,10,2,44,24,20,52
Glenavon,3127,3,10,9,7,54,44,10,39
Linfield,3127,4,11,5,10,38,36,2,38
Cliftonville,3127,5,9,4,13,32,32,0,31
Ballymena,3127,6,7,4,15,26,51,-25,25
Glentoran,3127,7,6,6,10,24,32,-8,24
Dungannon,3127,8,2,4,16,14,47,-33,10
Crusaders,3128,1,17,6,3,64,31,33,57
Coleraine,3128,2,14,10,2,44,24,20,52
Glenavon,3128,3,10,9,7,54,44,10,39
Linfield,3128,4,10,5,11,39,39,0,35
Cliftonville,3128,5,10,4,12,35,33,2,34
Ballymena,3128,6,7,4,15,26,50,-24,25
Glentoran,3128,7,6,6,10,24,32,-8,24
Dungannon,3128,8,2,4,16,14,47,-33,10
Crusaders,3129,1,16,7,3,63,32,31,55
Coleraine,3129,2,15,10,1,44,22,22,55
Glenavon,3129,3,9,9,8,52,44,8,36
Linfield,3129,4,10,6,10,39,38,1,36
Cliftonville,3129,5,9,5,12,34,33,1,32
Ballymena,3129,6,7,5,14,27,49,-22,26
Glentoran,3129,7,6,6,10,24,32,-8,24
Dungannon,3129,8,2,4,16,14,47,-33,10
Crusaders,3130,1,17,6,3,67,33,34,57
Coleraine,3130,2,14,10,2,43,25,18,52
Glenavon,3130,3,10,9,7,55,43,12,39
Linfield,3130,4,10,6,10,37,36,1,36
Cliftonville,3130,5,9,5,12,32,31,1,32
Ballymena,3130,6,7,4,15,28,53,-25,25
Glentoran,3130,7,6,6,10,24,32,-8,24
Dungannon,3130,8,2,4,16,14,47,-33,10
Crusaders,3131,1,16,7,3,63,32,31,55
Coleraine,3131,2,15,10,1,45,22,23,55
Glenavon,3131,3,9,9,8,52,45,7,36
Linfield,3131,4,10,6,10,37,36,1,36
Cliftonville,3131,5,9,5,12,32,31,1,32
Ballymena,3131,6,7,5,14,27,49,-22,26
Glentoran,3131,7,6,6,10,24,32,-8,24
Dungannon,3131,8,2,4,16,14,47,-33,10
Crusaders,3132,1,16,6,4,62,33,29,54
Coleraine,3132,2,14,10,2,44,24,20,52
Glenavon,3132,3,10,9,7,54,44,10,39
Linfield,3132,4,11,5,10,39,37,2,38
Cliftonville,3132,5,9,4,13,33,33,0,31
Ballymena,3132,6,8,4,14,28,48,-20,28
Glentoran,3132,7,6,6,10,24,32,-8,24
Dungannon,3132,8,2,4,16,14,47,-33,10
Crusaders,3133,1,16,6,4,61,32,29,54
Coleraine,3133,2,14,11,1,44,23,21,53
Glenavon,3133,3,9,10,7,53,44,9,37
Linfield,3133,4,10,5,11,37,37,0,35
Cliftonville,3133,5,10,4,12,33,31,2,34
Ballymena,3133,6,8,4,14,27,47,-20,28
Glentoran,3133,7,6,6,10,24,32,-8,24
Dungannon,3133,8,2,4,16,14,47,-33,10
Crusaders,3134,1,17,6,3,64,31,33,57
Coleraine,3134,2,14,10,2,44,25,19,52
Glenavon,3134,3,10,9,7,55,44,11,39
Linfield,3134,4,11,5,10,40,38,2,38
Cliftonville,3134,5,9,4,13,34,34,0,31
Ballymena,3134,6,7,4,15,26,50,-24,25
Glentoran,3134,7,6,6,10,24,32,-8,24
Dungannon,3134,8,2,4,16,14,47,-33,10
Crusaders,3135,1,16,7,3,62,31,31,55
Coleraine,3135,2,14,10,2,44,27,17,52
Glenavon,3135,3,10,9,7,57,44,13,39
Linfield,3135,4,10,6,10,38,37,1,36
Cliftonville,3135,5,9,5,12,33,32,1,32
Ballymena,3135,6,7,5,14,26,48,-22,26
Glentoran,3135,7,6,6,10,24,32,-8,24
Dungannon,3135,8,2,4,16,14,47,-33,10
Crusaders,3136,1,17,6,3,63,31,32,57
Coleraine,3136,2,14,10,2,43,23,20,52
Glenavon,3136,3,10,9,7,53,43,10,39
Linfield,3136,4,10,6,10,39,38,1,36
Cliftonville,3136,5,9,5,12,34,33,1,32
Ballymena,3136,6,7,4,15,26,49,-23,25
Glentoran,3136,7,6,6,10,24,32,-8,24
Dungannon,3136,8,2,4,16,14,47,-33,10
Crusaders,3137,1,16,7,3,62,31,31,55
Coleraine,3137,2,14,10,2,44,25,19,52
Glenavon,3137,3,10,9,7,55,44,11,39
Linfield,3137,4,11,5,10,39,36,3,38
Cliftonville,3137,5,9,4,13,32,33,-1,31
Ballymena,3137,6,7,5,14,26,48,-22,26
Glentoran,3137,7,6,6,10,24,32,-8,24
Dungannon,3137,8,2,4,16,14,47,-33,10
Coleraine,3138,1,15,10,1,46,24,22,55
Crusaders,3138,2,16,6,4,63,34,29,54
Glenavon,3138,3,9,9,8,54,46,8,36
Linfield,3138,4,10,5,11,38,38,0,35
Cliftonville,3138,5,10,4,12,34,32,2,34
Ballymena,3138,6,8,4,14,29,49,-20,28
Glentoran,3138,7,6,6,10,24,32,-8,24
Dungannon,3138,8,2,4,16,14,47,-33,10
Crusaders,3139,1,16,7,3,62,31,31,55
Coleraine,3139,2,15,10,1,46,24,22,55
Linfield,3139,3,11,5,10,40,36,4,38
Glenavon,3139,4,9,9,8,54,46,8,36
Cliftonville,3139,5,9,4,13,32,34,-2,31
Ballymena,3139,6,7,5,14,26,48,-22,26
Glentoran,3139,7,6,6,10,24,32,-8,24
Dungannon,3139,8,2,4,16,14,47,-33,10
Crusaders,3140,1,16,6,4,63,33,30,54
Coleraine,3140,2,14,10,2,44,24,20,52
Glenavon,3140,3,10,9,7,54,44,10,39
Linfield,3140,4,11,5,10,38,36,2,38
Cliftonville,3140,5,9,4,13,32,32,0,31
Ballymena,3140,6,8,4,14,28,49,-21,28
Glentoran,3140,7,6,6,10,24,32,-8,24
Dungannon,3140,8,2,4,16,14,47,-33,10
Crusaders,3141,1,17,6,3,65,32,33,57
Coleraine,3141,2,14,11,1,44,23,21,53
Linfield,3141,3,11,5,10,40,38,2,38
Glenavon,3141,4,9,10,7,53,44,9,37
Cliftonville,3141,5,9,4,13,34,34,0,31
Ballymena,3141,6,7,4,15,27,51,-24,25
Glentoran,3141,7,6,6,10,24,32,-8,24
Dungannon,3141,8,2,4,16,14,47,-33,10
Crusaders,3142,1,17,6,3,63,31,32,57
Coleraine,3142,2,14,11,1,44,23,21,53
Linfield,3142,3,11,5,10,38,36,2,38
Glenavon,3142,4,9,10,7,53,44,9,37
Cliftonville,3142,5,9,4,13,32,32,0,31
Ballymena,3142,6,7,4,15,26,49,-23,25
Glentoran,3142,7,6,6,10,24,32,-8,24
Dungannon,3142,8,2,4,16,14,47,-33,10
Crusaders,3143,1,17,6,3,65,31,34,57
Coleraine,3143,2,14,10,2,45,27,18,52
Glenavon,3143,3,10,9,7,57,45,12,39
Linfield,3143,4,10,5,11,37,38,-1,35
Cliftonville,3143,5,10,4,12,34,31,3,34
Ballymena,3143,6,7,4,15,26,51,-25,25
Glentoran,3143,7,6,6,10,24,32,-8,24
Dungannon,3143,8,2,4,16,14,47,-33,10
Crusaders,3144,1,16,6,4,61,33,28,54
Coleraine,3144,2,14,10,2,43,26,17,52
Glenavon,3144,3,10,9,7,56,43,13,39
Linfield,3144,4,11,5,10,38,36,2,38
Cliftonville,3144,5,9,4,13,32,32,0,31
Ballymena,3144,6,8,4,14,28,47,-19,28
Glentoran,3144,7,6,6,10,24,32,-8,24
Dungannon,3144,8,2,4,16,14,47,-33,10
Crusaders,3145,1,17,6,3,64,30,34,57
Coleraine,3145,2,14,10,2,44,25,19,52
Glenavon,3145,3,10,9,7,55,44,11,39
Linfield,3145,4,11,5,10,39,37,2,38
Cliftonville,3145,5,9,4,13,33,33,0,31
Ballymena,3145,6,7,4,15,25,50,-25,25
Glentoran,3145,7,6,6,10,24,32,-8,24
Dungannon,3145,8,2,4,16,14,47,-33,10
Crusaders,3146,1,17,6,3,67,30,37,57
Coleraine,3146,2,14,11,1,45,24,21,53
Glenavon,3146,3,9,10,7,54,45,9,37
Linfield,3146,4,10,5,11,37,38,-1,35
Cliftonville,3146,5,10,4,12,34,31,3,34
Ballymena,3146,6,7,4,15,25,53,-28,25
Glentoran,3146,7,6,6,10,24,32,-8,24
Dungannon,3146,8,2,4,16,14,47,-33,10
Crusaders,3147,1,17,6,3,64,32,32,57
Coleraine,3147,2,14,10,2,43,26,17,52
Glenavon,3147,3,10,9,7,56,43,13,39
Linfield,3147,4,11,5,10,38,36,2,38
Cliftonville,3147,5,9,4,13,32,32,0,31
Ballymena,3147,6,7,4,15,27,50,-23,25
Glentoran,3147,7,6,6,10,24,32,-8,24
Dungannon,3147,8,2,4,16,14,47,-33,10
Crusaders,3148,1,17,6,3,64,30,34,57
Coleraine,3148,2,14,10,2,43,23,20,52
Glenavon,3148,3,10,9,7,53,43,10,39
Linfield,3148,4,10,5,11,37,37,0,35
Cliftonville,3148,5,10,4,12,33,31,2,34
Ballymena,3148,6,7,4,15,25,50,-25,25
Glentoran,3148,7,6,6,10,24,32,-8,24
Dungannon,3148,8,2,4,16,14,47,-33,10
Crusaders,3149,1,17,6,3,66,34,32,57
Coleraine,3149,2,15,10,1,47,25,22,55
Glenavon,3149,3,9,9,8,55,47,8,36
Linfield,3149,4,10,5,11,38,38,0,35
Cliftonville,3149,5,10,4,12,34,32,2,34
Ballymena,3149,6,7,4,15,29,52,-23,25
Glentoran,3149,7,6,6,10,24,32,-8,24
Dungannon,3149,8,2,4,16,14,47,-33,10
Crusaders,3150,1,16,7,3,63,32,31,55
Coleraine,3150,2,15,10,1,47,23,24,55
Glenavon,3150,3,9,9,8,53,47,6,36
Linfield,3150,4,10,6,10,38,37,1,36
Cliftonville,3150,5,9,5,12,33,32,1,32
Ballymena,3150,6,7,5,14,27,49,-22,26
Glentoran,3150,7,6,6,10,24,32,-8,24
Dungannon,3150,8,2,4,16,14,47,-33,10
Crusaders,3151,1,16,7,3,62,31,31,55
Coleraine,3151,2,14,10,2,44,25,19,52
Glenavon,3151,3,10,9,7,55,44,11,39
Linfield,3151,4,10,5,11,37,37,0,35
Cliftonville,3151,5,10,4,12,33,31,2,34
Ballymena,3151,6,7,5,14,26,48,-22,26
Glentoran,3151,7,6,6,10,24,32,-8,24
Dungannon,3151,8,2,4,16,14,47,-33,10
Crusaders,3152,1,16,7,3,63,32,31,55
Coleraine,3152,2,14,11,1,44,23,21,53
Glenavon,3152,3,9,10,7,53,44,9,37
Linfield,3152,4,10,5,11,37,37,0,35
Cliftonville,3152,5,10,4,12,33,31,2,34
Ballymena,3152,6,7,5,14,27,49,-22,26
Glentoran,3152,7,6,6,10,24,32,-8,24
Dungannon,3152,8,2,4,16,14,47,-33,10
Crusaders,3153,1,16,7,3,62,31,31,55
Coleraine,3153,2,15,10,1,46,22,24,55
Glenavon,3153,3,9,9,8,52,46,6,36
Linfield,3153,4,10,6,10,38,37,1,36
Cliftonville,3153,5,9,5,12,33,32,1,32
Ballymena,3153,6,7,5,14,26,48,-22,26
Glentoran,3153,7,6,6,10,24,32,-8,24
Dungannon,3153,8,2,4,16,14,47,-33,10
Crusaders,3154,1,16,7,3,61,30,31,55
Coleraine,3154,2,15,10,1,45,23,22,55
Linfield,3154,3,11,5,10,39,37,2,38
Glenavon,3154,4,9,9,8,53,45,8,36
Cliftonville,3154,5,9,4,13,33,33,0,31
Ballymena,3154,6,7,5,14,25,47,-22,26
Glentoran,3154,7,6,6,10,24,32,-8,24
Dungannon,3154,8,2,4,16,14,47,-33,10
Crusaders,3155,1,17,6,3,66,34,32,57
Coleraine,3155,2,14,10,2,44,24,20,52
Glenavon,3155,3,10,9,7,54,44,10,39
Linfield,3155,4,10,5,11,37,37,0,35
Cliftonville,3155,5,10,4,12,33,31,2,34
Ballymena,3155,6,7,4,15,29,52,-23,25
Glentoran,3155,7,6,6,10,24,32,-8,24
Dungannon,3155,8,2,4,16,14,47,-33,10
Coleraine,3156,1,15,10,1,44,22,22,55
Crusaders,3156,2,16,6,4,63,34,29,54
Glenavon,3156,3,9,9,8,52,44,8,36
Linfield,3156,4,10,6,10,38,37,1,36
Cliftonville,3156,5,9,5,12,33,32,1,32
Ballymena,3156,6,8,4,14,29,49,-20,28
Glentoran,3156,7,6,6,10,24,32,-8,24
Dungannon,3156,8,2,4,16,14,47,-33,10
Crusaders,3157,1,16,7,3,63,32,31,55
Coleraine,3157,2,15,10,1,47,23,24,55
Linfield,3157,3,11,5,10,40,36,4,38
Glenavon,3157,4,9,9,8,53,47,6,36
Cliftonville,3157,5,9,4,13,32,34,-2,31
Ballymena,3157,6,7,5,14,27,49,-22,26
Glentoran,3157,7,6,6,10,24,32,-8,24
Dungannon,3157,8,2,4,16,14,47,-33,10
Crusaders,3158,1,17,6,3,64,31,33,57
Coleraine,3158,2,15,10,1,47,22,25,55
Glenavon,3158,3,9,9,8,52,47,5,36
Linfield,3158,4,10,5,11,37,37,0,35
Cliftonville,3158,5,10,4,12,33,31,2,34
Ballymena,3158,6,7,4,15,26,50,-24,25
Glentoran,3158,7,6,6,10,24,32,-8,24
Dungannon,3158,8,2,4,16,14,47,-33,10
Crusaders,3159,1,16,7,3,62,31,31,55
Coleraine,3159,2,15,10,1,47,23,24,55
Linfield,3159,3,11,5,10,38,36,2,38
Glenavon,3159,4,9,9,8,53,47,6,36
Cliftonville,3159,5,9,4,13,32,32,0,31
Ballymena,3159,6,7,5,14,26,48,-22,26
Glentoran,3159,7,6,6,10,24,32,-8,24
Dungannon,3159,8,2,4,16,14,47,-33,10
Crusaders,3160,1,16,6,4,61,32,29,54
Coleraine,3160,2,14,10,2,44,26,18,52
Glenavon,3160,3,10,9,7,56,44,12,39
Linfield,3160,4,10,5,11,38,39,-1,35
Cliftonville,3160,5,10,4,12,35,32,3,34
Ballymena,3160,6,8,4,14,27,47,-20,28
Glentoran,3160,7,6,6,10,24,32,-8,24
Dungannon,3160,8,2,4,16,14,47,-33,10
Crusaders,3161,1,16,7,3,62,31,31,55
Coleraine,3161,2,14,10,2,45,27,18,52
Glenavon,3161,3,10,9,7,57,45,12,39
Linfield,3161,4,10,5,11,37,38,-1,35
Cliftonville,3161,5,10,4,12,34,31,3,34
Ballymena,3161,6,7,5,14,26,48,-22,26
Glentoran,3161,7,6,6,10,24,32,-8,24
Dungannon,3161,8,2,4,16,14,47,-33,10
Crusaders,3162,1,17,6,3,62,30,32,57
Coleraine,3162,2,14,10,2,43,23,20,52
Glenavon,3162,3,10,9,7,53,43,10,39
Linfield,3162,4,10,5,11,38,38,0,35
Cliftonville,3162,5,10,4,12,34,32,2,34
Ballymena,3162,6,7,4,15,25,48,-23,25
Glentoran,3162,7,6,6,10,24,32,-8,24
Dungannon,3162,8,2,4,16,14,47,-33,10
Crusaders,3163,1,16,7,3,64,33,31,55
Coleraine,3163,2,14,10,2,43,24,19,52
Glenavon,3163,3,10,9,7,54,43,11,39
Linfield,3163,4,10,5,11,37,38,-1,35
Cliftonville,3163,5,10,4,12,34,31,3,34
Ballymena,3163,6,7,5,14,28,50,-22,26
Glentoran,3163,7,6,6,10,24,32,-8,24
Dungannon,3163,8,2,4,16,14,47,-33,10
Coleraine,3164,1,15,10,1,45,23,22,55
Crusaders,3164,2,16,6,4,64,34,30,54
Linfield,3164,3,11,5,10,39,36,3,38
Glenavon,3164,4,9,9,8,53,45,8,36
Cliftonville,3164,5,9,4,13,32,33,-1,31
Ballymena,3164,6,8,4,14,29,50,-21,28
Glentoran,3164,7,6,6,10,24,32,-8,24
Dungannon,3164,8,2,4,16,14,47,-33,10
Crusaders,3165,1,16,6,4,62,33,29,54
Coleraine,3165,2,14,10,2,44,25,19,52
Glenavon,3165,3,10,9,7,55,44,11,39
Linfield,3165,4,11,5,10,39,37,2,38
Cliftonville,3165,5,9,4,13,33,33,0,31
Ballymena,3165,6,8,4,14,28,48,-20,28
Glentoran,3165,7,6,6,10,24,32,-8,24
Dungannon,3165,8,2,4,16,14,47,-33,10
Coleraine,3166,1,15,10,1,46,23,23,55
Crusaders,3166,2,16,6,4,61,31,30,54
Linfield,3166,3,11,5,10,39,36,3,38
Glenavon,3166,4,9,9,8,53,46,7,36
Cliftonville,3166,5,9,4,13,32,33,-1,31
Ballymena,3166,6,8,4,14,26,47,-21,28
Glentoran,3166,7,6,6,10,24,32,-8,24
Dungannon,3166,8,2,4,16,14,47,-33,10
Crusaders,3167,1,17,6,3,65,30,35,57
Coleraine,3167,2,15,10,1,45,23,22,55
Glenavon,3167,3,9,9,8,53,45,8,36
Linfield,3167,4,10,6,10,38,37,1,36
Cliftonville,3167,5,9,5,12,33,32,1,32
Ballymena,3167,6,7,4,15,25,51,-26,25
Glentoran,3167,7,6,6,10,24,32,-8,24
Dungannon,3167,8,2,4,16,14,47,-33,10
Crusaders,3168,1,17,6,3,65,31,34,57
Coleraine,3168,2,14,10,2,44,26,18,52
Glenavon,3168,3,10,9,7,56,44,12,39
Linfield,3168,4,11,5,10,40,38,2,38
Cliftonville,3168,5,9,4,13,34,34,0,31
Ballymena,3168,6,7,4,15,26,51,-25,25
Glentoran,3168,7,6,6,10,24,32,-8,24
Dungannon,3168,8,2,4,16,14,47,-33,10
Crusaders,3169,1,17,6,3,65,31,34,57
Coleraine,3169,2,15,10,1,45,22,23,55
Glenavon,3169,3,9,9,8,52,45,7,36
Linfield,3169,4,10,6,10,37,36,1,36
Cliftonville,3169,5,9,5,12,32,31,1,32
Ballymena,3169,6,7,4,15,26,51,-25,25
Glentoran,3169,7,6,6,10,24,32,-8,24
Dungannon,3169,8,2,4,16,14,47,-33,10
Crusaders,3170,1,17,6,3,63,30,33,57
Coleraine,3170,2,14,11,1,44,23,21,53
Glenavon,3170,3,9,10,7,53,44,9,37
Linfield,3170,4,10,5,11,37,37,0,35
Cliftonville,3170,5,10,4,12,33,31,2,34
Ballymena,3170,6,7,4,15,25,49,-24,25
Glentoran,3170,7,6,6,10,24,32,-8,24
Dungannon,3170,8,2,4,16,14,47,-33,10
Crusaders,3171,1,17,6,3,64,31,33,57
Coleraine,3171,2,14,11,1,44,23,21,53
Linfield,3171,3,11,5,10,42,37,5,38
Glenavon,3171,4,9,10,7,53,44,9,37
Cliftonville,3171,5,9,4,13,33,36,-3,31
Ballymena,3171,6,7,4,15,26,50,-24,25
Glentoran,3171,7,6,6,10,24,32,-8,24
Dungannon,3171,8,2,4,16,14,47,-33,10
Crusaders,3172,1,16,7,3,64,33,31,55
Coleraine,3172,2,15,10,1,46,23,23,55
Linfield,3172,3,11,5,10,38,36,2,38
Glenavon,3172,4,9,9,8,53,46,7,36
Cliftonville,3172,5,9,4,13,32,32,0,31
Ballymena,3172,6,7,5,14,28,50,-22,26
Glentoran,3172,7,6,6,10,24,32,-8,24
Dungannon,3172,8,2,4,16,14,47,-33,10
Crusaders,3173,1,17,6,3,64,30,34,57
Coleraine,3173,2,15,10,1,45,22,23,55
Glenavon,3173,3,9,9,8,52,45,7,36
Linfield,3173,4,10,5,11,38,39,-1,35
Cliftonville,3173,5,10,4,12,35,32,3,34
Ballymena,3173,6,7,4,15,25,50,-25,25
Glentoran,3173,7,6,6,10,24,32,-8,24
Dungannon,3173,8,2,4,16,14,47,-33,10
Crusaders,3174,1,16,6,4,61,31,30,54
Coleraine,3174,2,14,11,1,43,22,21,53
Linfield,3174,3,11,5,10,38,36,2,38
Glenavon,3174,4,9,10,7,52,43,9,37
Cliftonville,3174,5,9,4,13,32,32,0,31
Ballymena,3174,6,8,4,14,26,47,-21,28
Glentoran,3174,7,6,6,10,24,32,-8,24
Dungannon,3174,8,2,4,16,14,47,-33,10
Crusaders,3175,1,17,6,3,65,31,34,57
Coleraine,3175,2,15,10,1,45,22,23,55
Glenavon,3175,3,9,9,8,52,45,7,36
Linfield,3175,4,10,5,11,37,38,-1,35
Cliftonville,3175,5,10,4,12,34,31,3,34
Ballymena,3175,6,7,4,15,26,51,-25,25
Glentoran,3175,7,6,6,10,24,32,-8,24
Dungannon,3175,8,2,4,16,14,47,-33,10
Crusaders,3176,1,16,6,4,61,31,30,54
Coleraine,3176,2,14,10,2,45,25,20,52
Glenavon,3176,3,10,9,7,55,45,10,39
Linfield,3176,4,10,6,10,37,36,1,36
Cliftonville,3176,5,9,5,12,32,31,1,32
Ballymena,3176,6,8,4,14,26,47,-21,28
Glentoran,3176,7,6,6,10,24,32,-8,24
Dungannon,3176,8,2,4,16,14,47,-33,10
Crusaders,3177,1,16,7,3,61,30,31,55
Coleraine,3177,2,14,10,2,45,27,18,52
Glenavon,3177,3,10,9,7,57,45,12,39
Linfield,3177,4,11,5,10,39,37,2,38
Cliftonville,3177,5,9,4,13,33,33,0,31
Ballymena,3177,6,7,5,14,25,47,-22,26
Glentoran,3177,7,6,6,10,24,32,-8,24
Dungannon,3177,8,2,4,16,14,47,-33,10
Crusaders,3178,1,16,7,3,63,32,31,55
Coleraine,3178,2,14,10,2,43,23,20,52
Glenavon,3178,3,10,9,7,53,43,10,39
Linfield,3178,4,10,6,10,37,36,1,36
Cliftonville,3178,5,9,5,12,32,31,1,32
Ballymena,3178,6,7,5,14,27,49,-22,26
Glentoran,3178,7,6,6,10,24,32,-8,24
Dungannon,3178,8,2,4,16,14,47,-33,10
Crusaders,3179,1,17,6,3,64,31,33,57
Coleraine,3179,2,14,11,1,44,23,21,53
Linfield,3179,3,11,5,10,41,36,5,38
Glenavon,3179,4,9,10,7,53,44,9,37
Cliftonville,3179,5,9,4,13,32,35,-3,31
Ballymena,3179,6,7,4,15,26,50,-24,25
Glentoran,3179,7,6,6,10,24,32,-8,24
Dungannon,3179,8,2,4,16,14,47,-33,10
Crusaders,3180,1,17,6,3,64,31,33,57
Coleraine,3180,2,14,11,1,44,23,21,53
Linfield,3180,3,11,5,10,40,37,3,38
Glenavon,3180,4,9,10,7,53,44,9,37
Cliftonville,3180,5,9,4,13,33,34,-1,31
Ballymena,3180,6,7,4,15,26,50,-24,25
Glentoran,3180,7,6,6,10,24,32,-8,24
Dungannon,3180,8,2,4,16,14,47,-33,10
Crusaders,3181,1,17,6,3,62,30,32,57
Coleraine,3181,2,14,10,2,43,23,20,52
Glenavon,3181,3,10,9,7,53,43,10,39
Linfield,3181,4,10,6,10,38,37,1,36
Cliftonville,3181,5,9,5,12,33,32,1,32
Ballymena,3181,6,7,4,15,25,48,-23,25
Glentoran,3181,7,6,6,10,24,32,-8,24
Dungannon,3181,8,2,4,16,14,47,-33,10
Crusaders,3182,1,16,6,4,61,32,29,54
Coleraine,3182,2,14,10,2,44,26,18,52
Glenavon,3182,3,10,9,7,56,44,12,39
Linfield,3182,4,11,5,10,38,36,2,38
Cliftonville,3182,5,9,4,13,32,32,0,31
Ballymena,3182,6,8,4,14,27,47,-20,28
Glentoran,3182,7,6,6,10,24,32,-8,24
Dungannon,3182,8,2,4,16,14,47,-33,10
Crusaders,3183,1,17,6,3,66,31,35,57
Coleraine,3183,2,14,11,1,43,22,21,53
Glenavon,3183,3,9,10,7,52,43,9,37
Linfield,3183,4,10,6,10,38,37,1,36
Cliftonville,3183,5,9,5,12,33,32,1,32
Ballymena,3183,6,7,4,15,26,52,-26,25
Glentoran,3183,7,6,6,10,24,32,-8,24
Dungannon,3183,8,2,4,16,14,47,-33,10
Crusaders,3184,1,17,6,3,65,31,34,57
Coleraine,3184,2,14,11,1,45,24,21,53
Glenavon,3184,3,9,10,7,54,45,9,37
Linfield,3184,4,10,6,10,38,37,1,36
Cliftonville,3184,5,9,5,12,33,32,1,32
Ballymena,3184,6,7,4,15,26,51,-25,25
Glentoran,3184,7,6,6,10,24,32,-8,24
Dungannon,3184,8,2,4,16,14,47,-33,10
Crusaders,3185,1,17,6,3,63,31,32,57
Coleraine,3185,2,15,10,1,46,23,23,55
Glenavon,3185,3,9,9,8,53,46,7,36
Linfield,3185,4,10,5,11,37,39,-2,35
Cliftonville,3185,5,10,4,12,35,31,4,34
Ballymena,3185,6,7,4,15,26,49,-23,25
Glentoran,3185,7,6,6,10,24,32,-8,24
Dungannon,3185,8,2,4,16,14,47,-33,10
Crusaders,3186,1,17,6,3,64,31,33,57
Coleraine,3186,2,15,10,1,47,24,23,55
Linfield,3186,3,11,5,10,38,36,2,38
Glenavon,3186,4,9,9,8,54,47,7,36
Cliftonville,3186,5,9,4,13,32,32,0,31
Ballymena,3186,6,7,4,15,26,50,-24,25
Glentoran,3186,7,6,6,10,24,32,-8,24
Dungannon,3186,8,2,4,16,14,47,-33,10
Crusaders,3187,1,16,7,3,61,30,31,55
Coleraine,3187,2,15,10,1,46,24,22,55
Linfield,3187,3,11,5,10,41,36,5,38
Glenavon,3187,4,9,9,8,54,46,8,36
Cliftonville,3187,5,9,4,13,32,35,-3,31
Ballymena,3187,6,7,5,14,25,47,-22,26
Glentoran,3187,7,6,6,10,24,32,-8,24
Dungannon,3187,8,2,4,16,14,47,-33,10
Crusaders,3188,1,17,6,3,64,30,34,57
Coleraine,3188,2,15,10,1,47,23,24,55
Linfield,3188,3,11,5,10,38,36,2,38
Glenavon,3188,4,9,9,8,53,47,6,36
Cliftonville,3188,5,9,4,13,32,32,0,31
Ballymena,3188,6,7,4,15,25,50,-25,25
Glentoran,3188,7,6,6,10,24,32,-8,24
Dungannon,3188,8,2,4,16,14,47,-33,10
Crusaders,3189,1,16,6,4,63,33,30,54
Coleraine,3189,2,14,11,1,44,23,21,53
Linfield,3189,3,11,5,10,39,37,2,38
Glenavon,3189,4,9,10,7,53,44,9,37
Cliftonville,3189,5,9,4,13,33,33,0,31
Ballymena,3189,6,8,4,14,28,49,-21,28
Glentoran,3189,7,6,6,10,24,32,-8,24
Dungannon,3189,8,2,4,16,14,47,-33,10
Crusaders,3190,1,16,7,3,62,31,31,55
Coleraine,3190,2,15,10,1,44,22,22,55
Glenavon,3190,3,9,9,8,52,44,8,36
Linfield,3190,4,10,6,10,37,36,1,36
Cliftonville,3190,5,9,5,12,32,31,1,32
Ballymena,3190,6,7,5,14,26,48,-22,26
Glentoran,3190,7,6,6,10,24,32,-8,24
Dungannon,3190,8,2,4,16,14,47,-33,10
Crusaders,3191,1,16,7,3,62,31,31,55
Coleraine,3191,2,14,10,2,43,23,20,52
Glenavon,3191,3,10,9,7,53,43,10,39
Linfield,3191,4,10,6,10,37,36,1,36
Cliftonville,3191,5,9,5,12,32,31,1,32
Ballymena,3191,6,7,5,14,26,48,-22,26
Glentoran,3191,7,6,6,10,24,32,-8,24
Dungannon,3191,8,2,4,16,14,47,-33,10
Crusaders,3192,1,16,6,4,63,33,30,54
Coleraine,3192,2,14,10,2,43,25,18,52
Glenavon,3192,3,10,9,7,55,43,12,39
Linfield,3192,4,11,5,10,39,37,2,38
Cliftonville,3192,5,9,4,13,33,33,0,31
Ballymena,3192,6,8,4,14,28,49,-21,28
Glentoran,3192,7,6,6,10,24,32,-8,24
Dungannon,3192,8,2,4,16,14,47,-33,10
Crusaders,3193,1,17,6,3,64,30,34,57
Coleraine,3193,2,14,10,2,43,24,19,52
Glenavon,3193,3,10,9,7,54,43,11,39
Linfield,3193,4,11,5,10,42,37,5,38
Cliftonville,3193,5,9,4,13,33,36,-3,31
Ballymena,3193,6,7,4,15,25,50,-25,25
Glentoran,3193,7,6,6,10,24,32,-8,24
Dungannon,3193,8,2,4,16,14,47,-33,10
Crusaders,3194,1,17,6,3,64,31,33,57
Coleraine,3194,2,15,10,1,46,22,24,55
Linfield,3194,3,11,5,10,39,36,3,38
Glenavon,3194,4,9,9,8,52,46,6,36
Cliftonville,3194,5,9,4,13,32,33,-1,31
Ballymena,3194,6,7,4,15,26,50,-24,25
Glentoran,3194,7,6,6,10,24,32,-8,24
Dungannon,3194,8,2,4,16,14,47,-33,10
Crusaders,3195,1,17,6,3,64,30,34,57
Coleraine,3195,2,14,10,2,44,24,20,52
Glenavon,3195,3,10,9,7,54,44,10,39
Linfield,3195,4,10,5,11,37,37,0,35
Cliftonville,3195,5,10,4,12,33,31,2,34
Ballymena,3195,6,7,4,15,25,50,-25,25
Glentoran,3195,7,6,6,10,24,32,-8,24
Dungannon,3195,8,2,4,16,14,47,-33,10
Crusaders,3196,1,17,6,3,64,31,33,57
Coleraine,3196,2,15,10,1,46,24,22,55
Linfield,3196,3,11,5,10,39,37,2,38
Glenavon,3196,4,9,9,8,54,46,8,36
Cliftonville,3196,5,9,4,13,33,33,0,31
Ballymena,3196,6,7,4,15,26,50,-24,25
Glentoran,3196,7,6,6,10,24,32,-8,24
Dungannon,3196,8,2,4,16,14,47,-33,10
Crusaders,3197,1,16,6,4,62,32,30,54
Coleraine,3197,2,14,10,2,44,24,20,52
Glenavon,3197,3,10,9,7,54,44,10,39
Linfield,3197,4,11,5,10,39,37,2,38
Cliftonville,3197,5,9,4,13,33,33,0,31
Ballymena,3197,6,8,4,14,27,48,-21,28
Glentoran,3197,7,6,6,10,24,32,-8,24
Dungannon,3197,8,2,4,16,14,47,-33,10
Crusaders,3198,1,17,6,3,64,32,32,57
Coleraine,3198,2,15,10,1,44,22,22,55
Linfield,3198,3,11,5,10,39,37,2,38
Glenavon,3198,4,9,9,8,52,44,8,36
Cliftonville,3198,5,9,4,13,33,33,0,31
Ballymena,3198,6,7,4,15,27,50,-23,25
Glentoran,3198,7,6,6,10,24,32,-8,24
Dungannon,3198,8,2,4,16,14,47,-33,10
Crusaders,3199,1,16,7,3,62,31,31,55
Coleraine,3199,2,14,10,2,45,27,18,52
Glenavon,3199,3,10,9,7,57,45,12,39
Linfield,3199,4,11,5,10,39,37,2,38
Cliftonville,3199,5,9,4,13,33,33,0,31
Ballymena,3199,6,7,5,14,26,48,-22,26
Glentoran,3199,7,6,6,10,24,32,-8,24
Dungannon,3199,8,2,4,16,14,47,-33,10
Crusaders,3200,1,17,6,3,64,31,33,57
Coleraine,3200,2,14,10,2,45,26,19,52
Glenavon,3200,3,10,9,7,56,45,11,39
Linfield,3200,4,10,5,11,38,38,0,35
Cliftonville,3200,5,10,4,12,34,32,2,34
Ballymena,3200,6,7,4,15,26,50,-24,25
Glentoran,3200,7,6,6,10,24,32,-8,24
Dungannon,3200,8,2,4,16,14,47,-33,10
Crusaders,3201,1,16,7,3,63,32,31,55
Coleraine,3201,2,14,10,2,43,25,18,52
Glenavon,3201,3,10,9,7,55,43,12,39
Linfield,3201,4,10,5,11,38,39,-1,35
Cliftonville,3201,5,10,4,12,35,32,3,34
Ballymena,3201,6,7,5,14,27,49,-22,26
Glentoran,3201,7,6,6,10,24,32,-8,24
Dungannon,3201,8,2,4,16,14,47,-33,10
Crusaders,3202,1,16,7,3,62,31,31,55
Coleraine,3202,2,15,10,1,45,22,23,55
Linfield,3202,3,11,5,10,41,37,4,38
Glenavon,3202,4,9,9,8,52,45,7,36
Cliftonville,3202,5,9,4,13,33,35,-2,31
Ballymena,3202,6,7,5,14,26,48,-22,26
Glentoran,3202,7,6,6,10,24,32,-8,24
Dungannon,3202,8,2,4,16,14,47,-33,10
Coleraine,3203,1,15,10,1,46,23,23,55
Crusaders,3203,2,16,6,4,62,32,30,54
Glenavon,3203,3,9,9,8,53,46,7,36
Linfield,3203,4,10,6,10,38,37,1,36
Cliftonville,3203,5,9,5,12,33,32,1,32
Ballymena,3203,6,8,4,14,27,48,-21,28
Glentoran,3203,7,6,6,10,24,32,-8,24
Dungannon,3203,8,2,4,16,14,47,-33,10
Crusaders,3204,1,16,7,3,61,30,31,55
Coleraine,3204,2,14,10,2,43,23,20,52
Glenavon,3204,3,10,9,7,53,43,10,39
Linfield,3204,4,10,5,11,39,40,-1,35
Cliftonville,3204,5,10,4,12,36,33,3,34
Ballymena,3204,6,7,5,14,25,47,-22,26
Glentoran,3204,7,6,6,10,24,32,-8,24
Dungannon,3204,8,2,4,16,14,47,-33,10
Crusaders,3205,1,16,6,4,61,32,29,54
Coleraine,3205,2,14,10,2,44,24,20,52
Glenavon,3205,3,10,9,7,54,44,10,39
Linfield,3205,4,11,5,10,39,37,2,38
Cliftonville,3205,5,9,4,13,33,33,0,31
Ballymena,3205,6,8,4,14,27,47,-20,28
Glentoran,3205,7,6,6,10,24,32,-8,24
Dungannon,3205,8,2,4,16,14,47,-33,10
Crusaders,3206,1,16,7,3,61,30,31,55
Coleraine,3206,2,14,11,1,46,25,21,53
Glenavon,3206,3,9,10,7,55,46,9,37
Linfield,3206,4,10,5,11,37,37,0,35
Cliftonville,3206,5,10,4,12,33,31,2,34
Ballymena,3206,6,7,5,14,25,47,-22,26
Glentoran,3206,7,6,6,10,24,32,-8,24
Dungannon,3206,8,2,4,16,14,47,-33,10
Crusaders,3207,1,16,6,4,62,32,30,54
Coleraine,3207,2,14,10,2,43,23,20,52
Glenavon,3207,3,10,9,7,53,43,10,39
Linfield,3207,4,11,5,10,38,36,2,38
Cliftonville,3207,5,9,4,13,32,32,0,31
Ballymena,3207,6,8,4,14,27,48,-21,28
Glentoran,3207,7,6,6,10,24,32,-8,24
Dungannon,3207,8,2,4,16,14,47,-33,10
Crusaders,3208,1,17,6,3,64,30,34,57
Coleraine,3208,2,15,10,1,46,24,22,55
Linfield,3208,3,11,5,10,39,36,3,38
Glenavon,3208,4,9,9,8,54,46,8,36
Cliftonville,3208,5,9,4,13,32,33,-1,31
Ballymena,3208,6,7,4,15,25,50,-25,25
Glentoran,3208,7,6,6,10,24,32,-8,24
Dungannon,3208,8,2,4,16,14,47,-33,10
Crusaders,3209,1,17,6,3,64,31,33,57
Coleraine,3209,2,15,10,1,47,24,23,55
Linfield,3209,3,11,5,10,39,37,2,38
Glenavon,3209,4,9,9,8,54,47,7,36
Cliftonville,3209,5,9,4,13,33,33,0,31
Ballymena,3209,6,7,4,15,26,50,-24,25
Glentoran,3209,7,6,6,10,24,32,-8,24
Dungannon,3209,8,2,4,16,14,47,-33,10
Crusaders,3210,1,17,6,3,63,31,32,57
Coleraine,3210,2,15,10,1,46,22,24,55
Linfield,3210,3,11,5,10,40,37,3,38
Glenavon,3210,4,9,9,8,52,46,6,36
Cliftonville,3210,5,9,4,13,33,34,-1,31
Ballymena,3210,6,7,4,15,26,49,-23,25
Glentoran,3210,7,6,6,10,24,32,-8,24
Dungannon,3210,8,2,4,16,14,47,-33,10
Crusaders,3211,1,17,6,3,62,30,32,57
Coleraine,3211,2,14,10,2,43,25,18,52
Glenavon,3211,3,10,9,7,55,43,12,39
Linfield,3211,4,10,6,10,37,36,1,36
Cliftonville,3211,5,9,5,12,32,31,1,32
Ballymena,3211,6,7,4,15,25,48,-23,25
Glentoran,3211,7,6,6,10,24,32,-8,24
Dungannon,3211,8,2,4,16,14,47,-33,10
Crusaders,3212,1,17,6,3,64,31,33,57
Coleraine,3212,2,14,10,2,45,26,19,52
Glenavon,3212,3,10,9,7,56,45,11,39
Linfield,3212,4,10,6,10,40,39,1,36
Cliftonville,3212,5,9,5,12,35,34,1,32
Ballymena,3212,6,7,4,15,26,50,-24,25
Glentoran,3212,7,6,6,10,24,32,-8,24
Dungannon,3212,8,2,4,16,14,47,-33,10
Crusaders,3213,1,17,6,3,63,30,33,57
Coleraine,3213,2,15,10,1,44,22,22,55
Glenavon,3213,3,9,9,8,52,44,8,36
Linfield,3213,4,10,6,10,37,36,1,36
Cliftonville,3213,5,9,5,12,32,31,1,32
Ballymena,3213,6,7,4,15,25,49,-24,25
Glentoran,3213,7,6,6,10,24,32,-8,24
Dungannon,3213,8,2,4,16,14,47,-33,10
Crusaders,3214,1,16,7,3,62,31,31,55
Coleraine,3214,2,14,10,2,44,25,19,52
Glenavon,3214,3,10,9,7,55,44,11,39
Linfield,3214,4,10,5,11,37,38,-1,35
Cliftonville,3214,5,10,4,12,34,31,3,34
Ballymena,3214,6,7,5,14,26,48,-22,26
Glentoran,3214,7,6,6,10,24,32,-8,24
Dungannon,3214,8,2,4,16,14,47,-33,10
Crusaders,3215,1,17,6,3,62,30,32,57
Coleraine,3215,2,14,10,2,43,23,20,52
Glenavon,3215,3,10,9,7,53,43,10,39
Linfield,3215,4,11,5,10,39,37,2,38
Cliftonville,3215,5,9,4,13,33,33,0,31
Ballymena,3215,6,7,4,15,25,48,-23,25
Glentoran,3215,7,6,6,10,24,32,-8,24
Dungannon,3215,8,2,4,16,14,47,-33,10
Crusaders,3216,1,16,6,4,61,33,28,54
Coleraine,3216,2,14,11,1,43,22,21,53
Glenavon,3216,3,9,10,7,52,43,9,37
Linfield,3216,4,10,5,11,37,37,0,35
Cliftonville,3216,5,10,4,12,33,31,2,34
Ballymena,3216,6,8,4,14,28,47,-19,28
Glentoran,3216,7,6,6,10,24,32,-8,24
Dungannon,3216,8,2,4,16,14,47,-33,10
Crusaders,3217,1,16,6,4,61,31,30,54
Coleraine,3217,2,14,10,2,43,23,20,52
Glenavon,3217,3,10,9,7,53,43,10,39
Linfield,3217,4,10,5,11,38,39,-1,35
Cliftonville,3217,5,10,4,12,35,32,3,34
Ballymena,3217,6,8,4,14,26,47,-21,28
Glentoran,3217,7,6,6,10,24,32,-8,24
Dungannon,3217,8,2,4,16,14,47,-33,10
Crusaders,3218,1,17,6,3,63,31,32,57
Coleraine,3218,2,14,10,2,45,25,20,52
Glenavon,3218,3,10,9,7,55,45,10,39
Linfield,3218,4,10,5,11,37,38,-1,35
Cliftonville,3218,5,10,4,12,34,31,3,34
Ballymena,3218,6,7,4,15,26,49,-23,25
Glentoran,3218,7,6,6,10,24,32,-8,24
Dungannon,3218,8,2,4,16,14,47,-33,10
Crusaders,3219,1,17,6,3,62,30,32,57
Coleraine,3219,2,15,10,1,45,23,22,55
Linfield,3219,3,11,5,10,39,37,2,38
Glenavon,3219,4,9,9,8,53,45,8,36
Cliftonville,3219,5,9,4,13,33,33,0,31
Ballymena,3219,6,7,4,15,25,48,-23,25
Glentoran,3219,7,6,6,10,24,32,-8,24
Dungannon,3219,8,2,4,16,14,47,-33,10
Crusaders,3220,1,16,7,3,63,32,31,55
Coleraine,3220,2,15,10,1,45,23,22,55
Glenavon,3220,3,9,9,8,53,45,8,36
Linfield,3220,4,10,5,11,38,39,-1,35
Cliftonville,3220,5,10,4,12,35,32,3,34
Ballymena,3220,6,7,5,14,27,49,-22,26
Glentoran,3220,7,6,6,10,24,32,-8,24
Dungannon,3220,8,2,4,16,14,47,-33,10
Coleraine,3221,1,15,10,1,44,22,22,55
Crusaders,3221,2,16,6,4,61,33,28,54
Linfield,3221,3,11,5,10,39,36,3,38
Glenavon,3221,4,9,9,8,52,44,8,36
Cliftonville,3221,5,9,4,13,32,33,-1,31
Ballymena,3221,6,8,4,14,28,47,-19,28
Glentoran,3221,7,6,6,10,24,32,-8,24
Dungannon,3221,8,2,4,16,14,47,-33,10
Crusaders,3222,1,17,6,3,64,30,34,57
Coleraine,3222,2,14,11,1,44,23,21,53
Glenavon,3222,3,9,10,7,53,44,9,37
Linfield,3222,4,10,6,10,38,37,1,36
Cliftonville,3222,5,9,5,12,33,32,1,32
Ballymena,3222,6,7,4,15,25,50,-25,25
Glentoran,3222,7,6,6,10,24,32,-8,24
Dungannon,3222,8,2,4,16,14,47,-33,10
Crusaders,3223,1,17,6,3,64,30,34,57
Coleraine,3223,2,14,11,1,45,24,21,53
Glenavon,3223,3,9,10,7,54,45,9,37
Linfield,3223,4,10,5,11,38,38,0,35
Cliftonville,3223,5,10,4,12,34,32,2,34
Ballymena,3223,6,7,4,15,25,50,-25,25
Glentoran,3223,7,6,6,10,24,32,-8,24
Dungannon,3223,8,2,4,16,14,47,-33,10
Crusaders,3224,1,17,6,3,64,30,34,57
Coleraine,3224,2,15,10,1,45,22,23,55
Linfield,3224,3,11,5,10,40,37,3,38
Glenavon,3224,4,9,9,8,52,45,7,36
Cliftonville,3224,5,9,4,13,33,34,-1,31
Ballymena,3224,6,7,4,15,25,50,-25,25
Glentoran,3224,7,6,6,10,24,32,-8,24
Dungannon,3224,8,2,4,16,14,47,-33,10
Crusaders,3225,1,16,7,3,63,32,31,55
Coleraine,3225,2,15,10,1,44,22,22,55
Glenavon,3225,3,9,9,8,52,44,8,36
Linfield,3225,4,10,5,11,38,38,0,35
Cliftonville,3225,5,10,4,12,34,32,2,34
Ballymena,3225,6,7,5,14,27,49,-22,26
Glentoran,3225,7,6,6,10,24,32,-8,24
Dungannon,3225,8,2,4,16,14,47,-33,10
Crusaders,3226,1,17,6,3,64,32,32,57
Coleraine,3226,2,14,11,1,44,23,21,53
Glenavon,3226,3,9,10,7,53,44,9,37
Linfield,3226,4,10,5,11,38,38,0,35
Cliftonville,3226,5,10,4,12,34,32,2,34
Ballymena,3226,6,7,4,15,27,50,-23,25
Glentoran,3226,7,6,6,10,24,32,-8,24
Dungannon,3226,8,2,4,16,14,47,-33,10
Crusaders,3227,1,16,6,4,63,33,30,54
Coleraine,3227,2,14,10,2,43,24,19,52
Glenavon,3227,3,10,9,7,54,43,11,39
Linfield,3227,4,10,6,10,38,37,1,36
Cliftonville,3227,5,9,5,12,33,32,1,32
Ballymena,3227,6,8,4,14,28,49,-21,28
Glentoran,3227,7,6,6,10,24,32,-8,24
Dungannon,3227,8,2,4,16,14,47,-33,10
Crusaders,3228,1,16,6,4,64,34,30,54
Coleraine,3228,2,14,10,2,44,25,19,52
Glenavon,3228,3,10,9,7,55,44,11,39
Linfield,3228,4,10,5,11,39,39,0,35
Cliftonville,3228,5,10,4,12,35,33,2,34
Ballymena,3228,6,8,4,14,29,50,-21,28
Glentoran,3228,7,6,6,10,24,32,-8,24
Dungannon,3228,8,2,4,16,14,47,-33,10
Crusaders,3229,1,16,7,3,64,33,31,55
Coleraine,3229,2,15,10,1,45,22,23,55
Linfield,3229,3,11,5,10,38,36,2,38
Glenavon,3229,4,9,9,8,52,45,7,36
Cliftonville,3229,5,9,4,13,32,32,0,31
Ballymena,3229,6,7,5,14,28,50,-22,26
Glentoran,3229,7,6,6,10,24,32,-8,24
Dungannon,3229,8,2,4,16,14,47,-33,10
Crusaders,3230,1,17,6,3,65,30,35,57
Coleraine,3230,2,14,10,2,43,23,20,52
Glenavon,3230,3,10,9,7,53,43,10,39
Linfield,3230,4,10,6,10,38,37,1,36
Cliftonville,3230,5,9,5,12,33,32,1,32
Ballymena,3230,6,7,4,15,25,51,-26,25
Glentoran,3230,7,6,6,10,24,32,-8,24
Dungannon,3230,8,2,4,16,14,47,-33,10
Crusaders,3231,1,17,6,3,63,30,33,57
Coleraine,3231,2,14,11,1,44,23,21,53
Linfield,3231,3,11,5,10,41,38,3,38
Glenavon,3231,4,9,10,7,53,44,9,37
Cliftonville,3231,5,9,4,13,34,35,-1,31
Ballymena,3231,6,7,4,15,25,49,-24,25
Glentoran,3231,7,6,6,10,24,32,-8,24
Dungannon,3231,8,2,4,16,14,47,-33,10
Crusaders,3232,1,17,6,3,64,30,34,57
Coleraine,3232,2,15,10,1,45,22,23,55
Glenavon,3232,3,9,9,8,52,45,7,36
Linfield,3232,4,10,6,10,37,36,1,36
Cliftonville,3232,5,9,5,12,32,31,1,32
Ballymena,3232,6,7,4,15,25,50,-25,25
Glentoran,3232,7,6,6,10,24,32,-8,24
Dungannon,3232,8,2,4,16,14,47,-33,10
Crusaders,3233,1,16,6,4,62,32,30,54
Coleraine,3233,2,14,10,2,44,24,20,52
Glenavon,3233,3,10,9,7,54,44,10,39
Linfield,3233,4,10,5,11,37,37,0,35
Cliftonville,3233,5,10,4,12,33,31,2,34
Ballymena,3233,6,8,4,14,27,48,-21,28
Glentoran,3233,7,6,6,10,24,32,-8,24
Dungannon,3233,8,2,4,16,14,47,-33,10
Crusaders,3234,1,17,6,3,66,30,36,57
Coleraine,3234,2,15,10,1,44,22,22,55
Linfield,3234,3,11,5,10,40,37,3,38
Glenavon,3234,4,9,9,8,52,44,8,36
Cliftonville,3234,5,9,4,13,33,34,-1,31
Ballymena,3234,6,7,4,15,25,52,-27,25
Glentoran,3234,7,6,6,10,24,32,-8,24
Dungannon,3234,8,2,4,16,14,47,-33,10
Crusaders,3235,1,16,6,4,61,32,29,54
Coleraine,3235,2,14,10,2,43,23,20,52
Glenavon,3235,3,10,9,7,53,43,10,39
Linfield,3235,4,11,5,10,39,37,2,38
Cliftonville,3235,5,9,4,13,33,33,0,31
Ballymena,3235,6,8,4,14,27,47,-20,28
Glentoran,3235,7,6,6,10,24,32,-8,24
Dungannon,3235,8,2,4,16,14,47,-33,10
Crusaders,3236,1,17,6,3,62,30,32,57
Coleraine,3236,2,15,10,1,45,22,23,55
Glenavon,3236,3,9,9,8,52,45,7,36
Linfield,3236,4,10,5,11,38,38,0,35
Cliftonville,3236,5,10,4,12,34,32,2,34
Ballymena,3236,6,7,4,15,25,48,-23,25
Glentoran,3236,7,6,6,10,24,32,-8,24
Dungannon,3236,8,2,4,16,14,47,-33,10
Crusaders,3237,1,17,6,3,64,30,34,57
Coleraine,3237,2,14,10,2,44,24,20,52
Glenavon,3237,3,10,9,7,54,44,10,39
Linfield,3237,4,10,5,11,37,37,0,35
Cliftonville,3237,5,10,4,12,33,31,2,34
Ballymena,3237,6,7,4,15,25,50,-25,25
Glentoran,3237,7,6,6,10,24,32,-8,24
Dungannon,3237,8,2,4,16,14,47,-33,10
Crusaders,3238,1,16,7,3,62,31,31,55
Coleraine,3238,2,14,11,1,44,23,21,53
Glenavon,3238,3,9,10,7,53,44,9,37
Linfield,3238,4,10,6,10,38,37,1,36
Cliftonville,3238,5,9,5,12,33,32,1,32
Ballymena,3238,6,7,5,14,26,48,-22,26
Glentoran,3238,7,6,6,10,24,32,-8,24
Dungannon,3238,8,2,4,16,14,47,-33,10
Crusaders,3239,1,16,6,4,62,33,29,54
Coleraine,3239,2,14,11,1,45,24,21,53
Linfield,3239,3,11,5,10,38,36,2,38
Glenavon,3239,4,9,10,7,54,45,9,37
Cliftonville,3239,5,9,4,13,32,32,0,31
Ballymena,3239,6,8,4,14,28,48,-20,28
Glentoran,3239,7,6,6,10,24,32,-8,24
Dungannon,3239,8,2,4,16,14,47,-33,10
Crusaders,3240,1,17,6,3,63,31,32,57
Coleraine,3240,2,14,11,1,44,23,21,53
Glenavon,3240,3,9,10,7,53,44,9,37
Linfield,3240,4,10,6,10,37,36,1,36
Cliftonville,3240,5,9,5,12,32,31,1,32
Ballymena,3240,6,7,4,15,26,49,-23,25
Glentoran,3240,7,6,6,10,24,32,-8,24
Dungannon,3240,8,2,4,16,14,47,-33,10
Crusaders,3241,1,17,6,3,65,30,35,57
Coleraine,3241,2,14,11,1,44,23,21,53
Linfield,3241,3,11,5,10,40,37,3,38
Glenavon,3241,4,9,10,7,53,44,9,37
Cliftonville,3241,5,9,4,13,33,34,-1,31
Ballymena,3241,6,7,4,15,25,51,-26,25
Glentoran,3241,7,6,6,10,24,32,-8,24
Dungannon,3241,8,2,4,16,14,47,-33,10
Crusaders,3242,1,17,6,3,66,30,36,57
Coleraine,3242,2,14,10,2,44,25,19,52
Glenavon,3242,3,10,9,7,55,44,11,39
Linfield,3242,4,10,5,11,37,37,0,35
Cliftonville,3242,5,10,4,12,33,31,2,34
Ballymena,3242,6,7,4,15,25,52,-27,25
Glentoran,3242,7,6,6,10,24,32,-8,24
Dungannon,3242,8,2,4,16,14,47,-33,10
Crusaders,3243,1,17,6,3,64,31,33,57
Coleraine,3243,2,15,10,1,47,22,25,55
Linfield,3243,3,11,5,10,38,36,2,38
Glenavon,3243,4,9,9,8,52,47,5,36
Cliftonville,3243,5,9,4,13,32,32,0,31
Ballymena,3243,6,7,4,15,26,50,-24,25
Glentoran,3243,7,6,6,10,24,32,-8,24
Dungannon,3243,8,2,4,16,14,47,-33,10
Crusaders,3244,1,17,6,3,64,30,34,57
Coleraine,3244,2,14,10,2,44,24,20,52
Glenavon,3244,3,10,9,7,54,44,10,39
Linfield,3244,4,11,5,10,41,36,5,38
Cliftonville,3244,5,9,4,13,32,35,-3,31
Ballymena,3244,6,7,4,15,25,50,-25,25
Glentoran,3244,7,6,6,10,24,32,-8,24
Dungannon,3244,8,2,4,16,14,47,-33,10
Crusaders,3245,1,16,7,3,62,31,31,55
Coleraine,3245,2,15,10,1,45,23,22,55
Linfield,3245,3,11,5,10,38,36,2,38
Glenavon,3245,4,9,9,8,53,45,8,36
Cliftonville,3245,5,9,4,13,32,32,0,31
Ballymena,3245,6,7,5,14,26,48,-22,26
Glentoran,3245,7,6,6,10,24,32,-8,24
Dungannon,3245,8,2,4,16,14,47,-33,10
Crusaders,3246,1,17,6,3,62,30,32,57
Coleraine,3246,2,14,10,2,45,27,18,52
Glenavon,3246,3,10,9,7,57,45,12,39
Linfield,3246,4,11,5,10,40,37,3,38
Cliftonville,3246,5,9,4,13,33,34,-1,31
Ballymena,3246,6,7,4,15,25,48,-23,25
Glentoran,3246,7,6,6,10,24,32,-8,24
Dungannon,3246,8,2,4,16,14,47,-33,10
Crusaders,3247,1,17,6,3,63,30,33,57
Coleraine,3247,2,14,11,1,44,23,21,53
Linfield,3247,3,11,5,10,40,37,3,38
Glenavon,3247,4,9,10,7,53,44,9,37
Cliftonville,3247,5,9,4,13,33,34,-1,31
Ballymena,3247,6,7,4,15,25,49,-24,25
Glentoran,3247,7,6,6,10,24,32,-8,24
Dungannon,3247,8,2,4,16,14,47,-33,10
Crusaders,3248,1,17,6,3,62,30,32,57
Coleraine,3248,2,14,11,1,44,23,21,53
Glenavon,3248,3,9,10,7,53,44,9,37
Linfield,3248,4,10,6,10,38,37,1,36
Cliftonville,3248,5,9,5,12,33,32,1,32
Ballymena,3248,6,7,4,15,25,48,-23,25
Glentoran,3248,7,6,6,10,24,32,-8,24
Dungannon,3248,8,2,4,16,14,47,-33,10
Crusaders,3249,1,17,6,3,63,30,33,57
Coleraine,3249,2,14,10,2,43,25,18,52
Glenavon,3249,3,10,9,7,55,43,12,39
Linfield,3249,4,10,5,11,38,39,-1,35
Cliftonville,3249,5,10,4,12,35,32,3,34
Ballymena,3249,6,7,4,15,25,49,-24,25
Glentoran,3249,7,6,6,10,24,32,-8,24
Dungannon,3249,8,2,4,16,14,47,-33,10
Coleraine,3250,1,15,10,1,46,23,23,55
Crusaders,3250,2,16,6,4,63,34,29,54
Linfield,3250,3,11,5,10,38,36,2,38
Glenavon,3250,4,9,9,8,53,46,7,36
Cliftonville,3250,5,9,4,13,32,32,0,31
Ballymena,3250,6,8,4,14,29,49,-20,28
Glentoran,3250,7,6,6,10,24,32,-8,24
Dungannon,3250,8,2,4,16,14,47,-33,10
Crusaders,3251,1,16,6,4,62,34,28,54
Coleraine,3251,2,14,10,2,44,25,19,52
Glenavon,3251,3,10,9,7,55,44,11,39
Linfield,3251,4,10,6,10,39,38,1,36
Cliftonville,3251,5,9,5,12,34,33,1,32
Ballymena,3251,6,8,4,14,29,48,-19,28
Glentoran,3251,7,6,6,10,24,32,-8,24
Dungannon,3251,8,2,4,16,14,47,-33,10
Crusaders,3252,1,17,6,3,63,31,32,57
Coleraine,3252,2,15,10,1,47,23,24,55
Glenavon,3252,3,9,9,8,53,47,6,36
Linfield,3252,4,10,5,11,38,38,0,35
Cliftonville,3252,5,10,4,12,34,32,2,34
Ballymena,3252,6,7,4,15,26,49,-23,25
Glentoran,3252,7,6,6,10,24,32,-8,24
Dungannon,3252,8,2,4,16,14,47,-33,10
Coleraine,3253,1,15,10,1,44,22,22,55
Crusaders,3253,2,16,6,4,62,32,30,54
Glenavon,3253,3,9,9,8,52,44,8,36
Linfield,3253,4,10,5,11,37,38,-1,35
Cliftonville,3253,5,10,4,12,34,31,3,34
Ballymena,3253,6,8,4,14,27,48,-21,28
Glentoran,3253,7,6,6,10,24,32,-8,24
Dungannon,3253,8,2,4,16,14,47,-33,10
Crusaders,3254,1,17,6,3,65,33,32,57
Coleraine,3254,2,14,11,1,45,24,21,53
Linfield,3254,3,11,5,10,39,37,2,38
Glenavon,3254,4,9,10,7,54,45,9,37
Cliftonville,3254,5,9,4,13,33,33,0,31
Ballymena,3254,6,7,4,15,28,51,-23,25
Glentoran,3254,7,6,6,10,24,32,-8,24
Dungannon,3254,8,2,4,16,14,47,-33,10
Crusaders,3255,1,17,6,3,63,31,32,57
Coleraine,3255,2,14,11,1,44,23,21,53
Linfield,3255,3,11,5,10,39,36,3,38
Glenavon,3255,4,9,10,7,53,44,9,37
Cliftonville,3255,5,9,4,13,32,33,-1,31
Ballymena,3255,6,7,4,15,26,49,-23,25
Glentoran,3255,7,6,6,10,24,32,-8,24
Dungannon,3255,8,2,4,16,14,47,-33,10
Crusaders,3256,1,17,6,3,65,31,34,57
Coleraine,3256,2,14,10,2,44,25,19,52
Glenavon,3256,3,10,9,7,55,44,11,39
Linfield,3256,4,11,5,10,39,36,3,38
Cliftonville,3256,5,9,4,13,32,33,-1,31
Ballymena,3256,6,7,4,15,26,51,-25,25
Glentoran,3256,7,6,6,10,24,32,-8,24
Dungannon,3256,8,2,4,16,14,47,-33,10
Crusaders,3257,1,17,6,3,63,30,33,57
Coleraine,3257,2,15,10,1,45,22,23,55
Linfield,3257,3,11,5,10,41,36,5,38
Glenavon,3257,4,9,9,8,52,45,7,36
Cliftonville,3257,5,9,4,13,32,35,-3,31
Ballymena,3257,6,7,4,15,25,49,-24,25
Glentoran,3257,7,6,6,10,24,32,-8,24
Dungannon,3257,8,2,4,16,14,47,-33,10
Crusaders,3258,1,16,7,3,62,31,31,55
Coleraine,3258,2,14,10,2,44,24,20,52
Glenavon,3258,3,10,9,7,54,44,10,39
Linfield,3258,4,10,6,10,37,36,1,36
Cliftonville,3258,5,9,5,12,32,31,1,32
Ballymena,3258,6,7,5,14,26,48,-22,26
Glentoran,3258,7,6,6,10,24,32,-8,24
Dungannon,3258,8,2,4,16,14,47,-33,10
Crusaders,3259,1,16,6,4,62,33,29,54
Coleraine,3259,2,14,10,2,44,24,20,52
Glenavon,3259,3,10,9,7,54,44,10,39
Linfield,3259,4,10,6,10,38,37,1,36
Cliftonville,3259,5,9,5,12,33,32,1,32
Ballymena,3259,6,8,4,14,28,48,-20,28
Glentoran,3259,7,6,6,10,24,32,-8,24
Dungannon,3259,8,2,4,16,14,47,-33,10
Crusaders,3260,1,16,6,4,61,33,28,54
Coleraine,3260,2,14,11,1,45,24,21,53
Linfield,3260,3,11,5,10,40,36,4,38
Glenavon,3260,4,9,10,7,54,45,9,37
Cliftonville,3260,5,9,4,13,32,34,-2,31
Ballymena,3260,6,8,4,14,28,47,-19,28
Glentoran,3260,7,6,6,10,24,32,-8,24
Dungannon,3260,8,2,4,16,14,47,-33,10
Crusaders,3261,1,17,6,3,62,30,32,57
Coleraine,3261,2,14,10,2,44,24,20,52
Glenavon,3261,3,10,9,7,54,44,10,39
Linfield,3261,4,10,5,11,37,38,-1,35
Cliftonville,3261,5,10,4,12,34,31,3,34
Ballymena,3261,6,7,4,15,25,48,-23,25
Glentoran,3261,7,6,6,10,24,32,-8,24
Dungannon,3261,8,2,4,16,14,47,-33,10
Crusaders,3262,1,17,6,3,64,31,33,57
Coleraine,3262,2,14,10,2,45,25,20,52
Glenavon,3262,3,10,9,7,55,45,10,39
Linfield,3262,4,10,6,10,37,36,1,36
Cliftonville,3262,5,9,5,12,32,31,1,32
Ballymena,3262,6,7,4,15,26,50,-24,25
Glentoran,3262,7,6,6,10,24,32,-8,24
Dungannon,3262,8,2,4,16,14,47,-33,10
Crusaders,3263,1,17,6,3,63,31,32,57
Coleraine,3263,2,14,10,2,43,23,20,52
Glenavon,3263,3,10,9,7,53,43,10,39
Linfield,3263,4,11,5,10,41,38,3,38
Cliftonville,3263,5,9,4,13,34,35,-1,31
Ballymena,3263,6,7,4,15,26,49,-23,25
Glentoran,3263,7,6,6,10,24,32,-8,24
Dungannon,3263,8,2,4,16,14,47,-33,10
Crusaders,3264,1,17,6,3,65,32,33,57
Coleraine,3264,2,14,11,1,44,23,21,53
Glenavon,3264,3,9,10,7,53,44,9,37
Linfield,3264,4,10,6,10,37,36,1,36
Cliftonville,3264,5,9,5,12,32,31,1,32
Ballymena,3264,6,7,4,15,27,51,-24,25
Glentoran,3264,7,6,6,10,24,32,-8,24
Dungannon,3264,8,2,4,16,14,47,-33,10
Crusaders,3265,1,16,6,4,61,31,30,54
Coleraine,3265,2,14,10,2,44,25,19,52
Glenavon,3265,3,10,9,7,55,44,11,39
Linfield,3265,4,10,5,11,37,38,-1,35
Cliftonville,3265,5,10,4,12,34,31,3,34
Ballymena,3265,6,8,4,14,26,47,-21,28
Glentoran,3265,7,6,6,10,24,32,-8,24
Dungannon,3265,8,2,4,16,14,47,-33,10
Crusaders,3266,1,16,6,4,62,33,29,54
Coleraine,3266,2,14,11,1,45,24,21,53
Glenavon,3266,3,9,10,7,54,45,9,37
Linfield,3266,4,10,5,11,38,38,0,35
Cliftonville,3266,5,10,4,12,34,32,2,34
Ballymena,3266,6,8,4,14,28,48,-20,28
Glentoran,3266,7,6,6,10,24,32,-8,24
Dungannon,3266,8,2,4,16,14,47,-33,10
Crusaders,3267,1,16,6,4,62,32,30,54
Coleraine,3267,2,14,10,2,43,23,20,52
Glenavon,3267,3,10,9,7,53,43,10,39
Linfield,3267,4,10,5,11,38,39,-1,35
Cliftonville,3267,5,10,4,12,35,32,3,34
Ballymena,3267,6,8,4,14,27,48,-21,28
Glentoran,3267,7,6,6,10,24,32,-8,24
Dungannon,3267,8,2,4,16,14,47,-33,10
Crusaders,3268,1,17,6,3,62,30,32,57
Coleraine,3268,2,14,10,2,44,24,20,52
Glenavon,3268,3,10,9,7,54,44,10,39
Linfield,3268,4,11,5,10,40,36,4,38
Cliftonville,3268,5,9,4,13,32,34,-2,31
Ballymena,3268,6,7,4,15,25,48,-23,25
Glentoran,3268,7,6,6,10,24,32,-8,24
Dungannon,3268,8,2,4,16,14,47,-33,10
Crusaders,3269,1,17,6,3,66,31,35,57
Coleraine,3269,2,15,10,1,45,23,22,55
Glenavon,3269,3,9,9,8,53,45,8,36
Linfield,3269,4,10,6,10,38,37,1,36
Cliftonville,3269,5,9,5,12,33,32,1,32
Ballymena,3269,6,7,4,15,26,52,-26,25
Glentoran,3269,7,6,6,10,24,32,-8,24
Dungannon,3269,8,2,4,16,14,47,-33,10
Crusaders,3270,1,17,6,3,65,32,33,57
Coleraine,3270,2,14,10,2,44,24,20,52
Glenavon,3270,3,10,9,7,54,44,10,39
Linfield,3270,4,11,5,10,40,36,4,38
Cliftonville,3270,5,9,4,13,32,34,-2,31
Ballymena,3270,6,7,4,15,27,51,-24,25
Glentoran,3270,7,6,6,10,24,32,-8,24
Dungannon,3270,8,2,4,16,14,47,-33,10
Crusaders,3271,1,16,6,4,63,33,30,54
Coleraine,3271,2,14,10,2,43,25,18,52
Glenavon,3271,3,10,9,7,55,43,12,39
Linfield,3271,4,11,5,10,38,36,2,38
Cliftonville,3271,5,9,4,13,32,32,0,31
Ballymena,3271,6,8,4,14,28,49,-21,28
Glentoran,3271,7,6,6,10,24,32,-8,24
Dungannon,3271,8,2,4,16,14,47,-33,10
Crusaders,3272,1,17,6,3,64,31,33,57
Coleraine,3272,2,14,10,2,43,23,20,52
Glenavon,3272,3,10,9,7,53,43,10,39
Linfield,3272,4,10,6,10,38,37,1,36
Cliftonville,3272,5,9,5,12,33,32,1,32
Ballymena,3272,6,7,4,15,26,50,-24,25
Glentoran,3272,7,6,6,10,24,32,-8,24
Dungannon,3272,8,2,4,16,14,47,-33,10
Crusaders,3273,1,17,6,3,62,30,32,57
Coleraine,3273,2,14,11,1,45,24,21,53
Linfield,3273,3,11,5,10,41,37,4,38
Glenavon,3273,4,9,10,7,54,45,9,37
Cliftonville,3273,5,9,4,13,33,35,-2,31
Ballymena,3273,6,7,4,15,25,48,-23,25
Glentoran,3273,7,6,6,10,24,32,-8,24
Dungannon,3273,8,2,4,16,14,47,-33,10
Crusaders,3274,1,16,6,4,62,33,29,54
Coleraine,3274,2,14,11,1,44,23,21,53
Glenavon,3274,3,9,10,7,53,44,9,37
Linfield,3274,4,10,6,10,37,36,1,36
Cliftonville,3274,5,9,5,12,32,31,1,32
Ballymena,3274,6,8,4,14,28,48,-20,28
Glentoran,3274,7,6,6,10,24,32,-8,24
Dungannon,3274,8,2,4,16,14,47,-33,10
Crusaders,3275,1,17,6,3,63,31,32,57
Coleraine,3275,2,14,11,1,44,23,21,53
Glenavon,3275,3,9,10,7,53,44,9,37
Linfield,3275,4,10,6,10,37,36,1,36
Cliftonville,3275,5,9,5,12,32,31,1,32
Ballymena,3275,6,7,4,15,26,49,-23,25
Glentoran,3275,7,6,6,10,24,32,-8,24
Dungannon,3275,8,2,4,16,14,47,-33,10
Coleraine,3276,1,15,10,1,46,23,23,55
Crusaders,3276,2,16,6,4,62,33,29,54
Glenavon,3276,3,9,9,8,53,46,7,36
Linfield,3276,4,10,5,11,37,39,-2,35
Cliftonville,3276,5,10,4,12,35,31,4,34
Ballymena,3276,6,8,4,14,28,48,-20,28
Glentoran,3276,7,6,6,10,24,32,-8,24
Dungannon,3276,8,2,4,16,14,47,-33,10
Crusaders,3277,1,17,6,3,66,30,36,57
Coleraine,3277,2,15,10,1,45,22,23,55
Linfield,3277,3,11,5,10,39,37,2,38
Glenavon,3277,4,9,9,8,52,45,7,36
Cliftonville,3277,5,9,4,13,33,33,0,31
Ballymena,3277,6,7,4,15,25,52,-27,25
Glentoran,3277,7,6,6,10,24,32,-8,24
Dungannon,3277,8,2,4,16,14,47,-33,10
Crusaders,3278,1,17,6,3,64,30,34,57
Coleraine,3278,2,15,10,1,44,22,22,55
Linfield,3278,3,11,5,10,39,36,3,38
Glenavon,3278,4,9,9,8,52,44,8,36
Cliftonville,3278,5,9,4,13,32,33,-1,31
Ballymena,3278,6,7,4,15,25,50,-25,25
Glentoran,3278,7,6,6,10,24,32,-8,24
Dungannon,3278,8,2,4,16,14,47,-33,10
Crusaders,3279,1,17,6,3,63,30,33,57
Coleraine,3279,2,14,11,1,45,24,21,53
Glenavon,3279,3,9,10,7,54,45,9,37
Linfield,3279,4,10,6,10,38,37,1,36
Cliftonville,3279,5,9,5,12,33,32,1,32
Ballymena,3279,6,7,4,15,25,49,-24,25
Glentoran,3279,7,6,6,10,24,32,-8,24
Dungannon,3279,8,2,4,16,14,47,-33,10
Crusaders,3280,1,17,6,3,62,30,32,57
Coleraine,3280,2,14,10,2,43,25,18,52
Glenavon,3280,3,10,9,7,55,43,12,39
Linfield,3280,4,11,5,10,39,37,2,38
Cliftonville,3280,5,9,4,13,33,33,0,31
Ballymena,3280,6,7,4,15,25,48,-23,25
Glentoran,3280,7,6,6,10,24,32,-8,24
Dungannon,3280,8,2,4,16,14,47,-33,10
Coleraine,3281,1,15,10,1,45,22,23,55
Crusaders,3281,2,16,6,4,63,33,30,54
Linfield,3281,3,11,5,10,40,38,2,38
Glenavon,3281,4,9,9,8,52,45,7,36
Cliftonville,3281,5,9,4,13,34,34,0,31
Ballymena,3281,6,8,4,14,28,49,-21,28
Glentoran,3281,7,6,6,10,24,32,-8,24
Dungannon,3281,8,2,4,16,14,47,-33,10
Crusaders,3282,1,16,6,4,61,33,28,54
Coleraine,3282,2,14,10,2,43,26,17,52
Glenavon,3282,3,10,9,7,56,43,13,39
Linfield,3282,4,10,6,10,38,37,1,36
Cliftonville,3282,5,9,5,12,33,32,1,32
Ballymena,3282,6,8,4,14,28,47,-19,28
Glentoran,3282,7,6,6,10,24,32,-8,24
Dungannon,3282,8,2,4,16,14,47,-33,10
Crusaders,3283,1,16,6,4,61,31,30,54
Coleraine,3283,2,14,10,2,44,24,20,52
Glenavon,3283,3,10,9,7,54,44,10,39
Linfield,3283,4,11,5,10,38,36,2,38
Cliftonville,3283,5,9,4,13,32,32,0,31
Ballymena,3283,6,8,4,14,26,47,-21,28
Glentoran,3283,7,6,6,10,24,32,-8,24
Dungannon,3283,8,2,4,16,14,47,-33,10
Crusaders,3284,1,16,7,3,61,30,31,55
Coleraine,3284,2,14,11,1,45,24,21,53
Glenavon,3284,3,9,10,7,54,45,9,37
Linfield,3284,4,10,5,11,38,38,0,35
Cliftonville,3284,5,10,4,12,34,32,2,34
Ballymena,3284,6,7,5,14,25,47,-22,26
Glentoran,3284,7,6,6,10,24,32,-8,24
Dungannon,3284,8,2,4,16,14,47,-33,10
Crusaders,3285,1,16,6,4,61,31,30,54
Coleraine,3285,2,14,10,2,44,24,20,52
Glenavon,3285,3,10,9,7,54,44,10,39
Linfield,3285,4,11,5,10,39,36,3,38
Cliftonville,3285,5,9,4,13,32,33,-1,31
Ballymena,3285,6,8,4,14,26,47,-21,28
Glentoran,3285,7,6,6,10,24,32,-8,24
Dungannon,3285,8,2,4,16,14,47,-33,10
Coleraine,3286,1,15,10,1,47,24,23,55
Crusaders,3286,2,16,6,4,61,34,27,54
Glenavon,3286,3,9,9,8,54,47,7,36
Linfield,3286,4,10,5,11,39,39,0,35
Cliftonville,3286,5,10,4,12,35,33,2,34
Ballymena,3286,6,8,4,14,29,47,-18,28
Glentoran,3286,7,6,6,10,24,32,-8,24
Dungannon,3286,8,2,4,16,14,47,-33,10
Crusaders,3287,1,17,6,3,63,30,33,57
Coleraine,3287,2,14,10,2,43,23,20,52
Glenavon,3287,3,10,9,7,53,43,10,39
Linfield,3287,4,10,6,10,38,37,1,36
Cliftonville,3287,5,9,5,12,33,32,1,32
Ballymena,3287,6,7,4,15,25,49,-24,25
Glentoran,3287,7,6,6,10,24,32,-8,24
Dungannon,3287,8,2,4,16,14,47,-33,10
Crusaders,3288,1,17,6,3,63,31,32,57
Coleraine,3288,2,14,10,2,44,24,20,52
Glenavon,3288,3,10,9,7,54,44,10,39
Linfield,3288,4,10,5,11,37,37,0,35
Cliftonville,3288,5,10,4,12,33,31,2,34
Ballymena,3288,6,7,4,15,26,49,-23,25
Glentoran,3288,7,6,6,10,24,32,-8,24
Dungannon,3288,8,2,4,16,14,47,-33,10
Crusaders,3289,1,17,6,3,65,31,34,57
Coleraine,3289,2,14,11,1,44,23,21,53
Linfield,3289,3,11,5,10,39,36,3,38
Glenavon,3289,4,9,10,7,53,44,9,37
Cliftonville,3289,5,9,4,13,32,33,-1,31
Ballymena,3289,6,7,4,15,26,51,-25,25
Glentoran,3289,7,6,6,10,24,32,-8,24
Dungannon,3289,8,2,4,16,14,47,-33,10
Crusaders,3290,1,17,6,3,62,30,32,57
Coleraine,3290,2,15,10,1,46,23,23,55
Linfield,3290,3,11,5,10,41,37,4,38
Glenavon,3290,4,9,9,8,53,46,7,36
Cliftonville,3290,5,9,4,13,33,35,-2,31
Ballymena,3290,6,7,4,15,25,48,-23,25
Glentoran,3290,7,6,6,10,24,32,-8,24
Dungannon,3290,8,2,4,16,14,47,-33,10
Crusaders,3291,1,17,6,3,63,30,33,57
Coleraine,3291,2,15,10,1,46,24,22,55
Linfield,3291,3,11,5,10,40,37,3,38
Glenavon,3291,4,9,9,8,54,46,8,36
Cliftonville,3291,5,9,4,13,33,34,-1,31
Ballymena,3291,6,7,4,15,25,49,-24,25
Glentoran,3291,7,6,6,10,24,32,-8,24
Dungannon,3291,8,2,4,16,14,47,-33,10
Crusaders,3292,1,17,6,3,67,34,33,57
Coleraine,3292,2,15,10,1,44,22,22,55
Glenavon,3292,3,9,9,8,52,44,8,36
Linfield,3292,4,10,6,10,38,37,1,36
Cliftonville,3292,5,9,5,12,33,32,1,32
Ballymena,3292,6,7,4,15,29,53,-24,25
Glentoran,3292,7,6,6,10,24,32,-8,24
Dungannon,3292,8,2,4,16,14,47,-33,10
Crusaders,3293,1,17,6,3,63,31,32,57
Coleraine,3293,2,15,10,1,45,22,23,55
Glenavon,3293,3,9,9,8,52,45,7,36
Linfield,3293,4,10,6,10,38,37,1,36
Cliftonville,3293,5,9,5,12,33,32,1,32
Ballymena,3293,6,7,4,15,26,49,-23,25
Glentoran,3293,7,6,6,10,24,32,-8,24
Dungannon,3293,8,2,4,16,14,47,-33,10
Crusaders,3294,1,16,6,4,61,31,30,54
Coleraine,3294,2,14,10,2,44,25,19,52
Glenavon,3294,3,10,9,7,55,44,11,39
Linfield,3294,4,11,5,10,40,37,3,38
Cliftonville,3294,5,9,4,13,33,34,-1,31
Ballymena,3294,6,8,4,14,26,47,-21,28
Glentoran,3294,7,6,6,10,24,32,-8,24
Dungannon,3294,8,2,4,16,14,47,-33,10
Crusaders,3295,1,16,6,4,62,33,29,54
Coleraine,3295,2,14,10,2,44,26,18,52
Glenavon,3295,3,10,9,7,56,44,12,39
Linfield,3295,4,11,5,10,41,37,4,38
Cliftonville,3295,5,9,4,13,33,35,-2,31
Ballymena,3295,6,8,4,14,28,48,-20,28
Glentoran,3295,7,6,6,10,24,32,-8,24
Dungannon,3295,8,2,4,16,14,47,-33,10
Coleraine,3296,1,15,10,1,45,23,22,55
Crusaders,3296,2,16,6,4,61,31,30,54
Glenavon,3296,3,9,9,8,53,45,8,36
Linfield,3296,4,10,6,10,39,38,1,36
Cliftonville,3296,5,9,5,12,34,33,1,32
Ballymena,3296,6,8,4,14,26,47,-21,28
Glentoran,3296,7,6,6,10,24,32,-8,24
Dungannon,3296,8,2,4,16,14,47,-33,10
Crusaders,3297,1,16,7,3,61,30,31,55
Coleraine,3297,2,14,10,2,44,24,20,52
Glenavon,3297,3,10,9,7,54,44,10,39
Linfield,3297,4,11,5,10,38,36,2,38
Cliftonville,3297,5,9,4,13,32,32,0,31
Ballymena,3297,6,7,5,14,25,47,-22,26
Glentoran,3297,7,6,6,10,24,32,-8,24
Dungannon,3297,8,2,4,16,14,47,-33,10
Coleraine,3298,1,15,10,1,46,24,22,55
Crusaders,3298,2,16,6,4,62,32,30,54
Glenavon,3298,3,9,9,8,54,46,8,36
Linfield,3298,4,10,6,10,38,37,1,36
Cliftonville,3298,5,9,5,12,33,32,1,32
Ballymena,3298,6,8,4,14,27,48,-21,28
Glentoran,3298,7,6,6,10,24,32,-8,24
Dungannon,3298,8,2,4,16,14,47,-33,10
Crusaders,3299,1,16,7,3,63,32,31,55
Coleraine,3299,2,15,10,1,44,22,22,55
Glenavon,3299,3,9,9,8,52,44,8,36
Linfield,3299,4,10,6,10,38,37,1,36
Cliftonville,3299,5,9,5,12,33,32,1,32
Ballymena,3299,6,7,5,14,27,49,-22,26
Glentoran,3299,7,6,6,10,24,32,-8,24
Dungannon,3299,8,2,4,16,14,47,-33,10
Crusaders,3300,1,16,7,3,63,32,31,55
Coleraine,3300,2,15,10,1,48,26,22,55
Linfield,3300,3,11,5,10,39,37,2,38
Glenavon,3300,4,9,9,8,56,48,8,36
Cliftonville,3300,5,9,4,13,33,33,0,31
Ballymena,3300,6,7,5,14,27,49,-22,26
Glentoran,3300,7,6,6,10,24,32,-8,24
Dungannon,3300,8,2,4,16,14,47,-33,10
Crusaders,3301,1,16,7,3,63,32,31,55
Coleraine,3301,2,15,10,1,46,23,23,55
Linfield,3301,3,11,5,10,38,36,2,38
Glenavon,3301,4,9,9,8,53,46,7,36
Cliftonville,3301,5,9,4,13,32,32,0,31
Ballymena,3301,6,7,5,14,27,49,-22,26
Glentoran,3301,7,6,6,10,24,32,-8,24
Dungannon,3301,8,2,4,16,14,47,-33,10
Coleraine,3302,1,15,10,1,45,22,23,55
Crusaders,3302,2,16,6,4,62,32,30,54
Glenavon,3302,3,9,9,8,52,45,7,36
Linfield,3302,4,10,6,10,38,37,1,36
Cliftonville,3302,5,9,5,12,33,32,1,32
Ballymena,3302,6,8,4,14,27,48,-21,28
Glentoran,3302,7,6,6,10,24,32,-8,24
Dungannon,3302,8,2,4,16,14,47,-33,10
Crusaders,3303,1,16,7,3,62,31,31,55
Coleraine,3303,2,14,10,2,43,23,20,52
Glenavon,3303,3,10,9,7,53,43,10,39
Linfield,3303,4,11,5,10,38,36,2,38
Cliftonville,3303,5,9,4,13,32,32,0,31
Ballymena,3303,6,7,5,14,26,48,-22,26
Glentoran,3303,7,6,6,10,24,32,-8,24
Dungannon,3303,8,2,4,16,14,47,-33,10
Crusaders,3304,1,16,6,4,63,33,30,54
Coleraine,3304,2,14,10,2,43,23,20,52
Glenavon,3304,3,10,9,7,53,43,10,39
Linfield,3304,4,11,5,10,38,36,2,38
Cliftonville,3304,5,9,4,13,32,32,0,31
Ballymena,3304,6,8,4,14,28,49,-21,28
Glentoran,3304,7,6,6,10,24,32,-8,24
Dungannon,3304,8,2,4,16,14,47,-33,10
Crusaders,3305,1,17,6,3,62,30,32,57
Coleraine,3305,2,14,11,1,45,24,21,53
Linfield,3305,3,11,5,10,39,36,3,38
Glenavon,3305,4,9,10,7,54,45,9,37
Cliftonville,3305,5,9,4,13,32,33,-1,31
Ballymena,3305,6,7,4,15,25,48,-23,25
Glentoran,3305,7,6,6,10,24,32,-8,24
Dungannon,3305,8,2,4,16,14,47,-33,10
Crusaders,3306,1,17,6,3,63,31,32,57
Coleraine,3306,2,14,10,2,46,27,19,52
Glenavon,3306,3,10,9,7,57,46,11,39
Linfield,3306,4,11,5,10,39,36,3,38
Cliftonville,3306,5,9,4,13,32,33,-1,31
Ballymena,3306,6,7,4,15,26,49,-23,25
Glentoran,3306,7,6,6,10,24,32,-8,24
Dungannon,3306,8,2,4,16,14,47,-33,10
Crusaders,3307,1,17,6,3,63,31,32,57
Coleraine,3307,2,15,10,1,45,22,23,55
Glenavon,3307,3,9,9,8,52,45,7,36
Linfield,3307,4,10,6,10,39,38,1,36
Cliftonville,3307,5,9,5,12,34,33,1,32
Ballymena,3307,6,7,4,15,26,49,-23,25
Glentoran,3307,7,6,6,10,24,32,-8,24
Dungannon,3307,8,2,4,16,14,47,-33,10
Crusaders,3308,1,17,6,3,63,31,32,57
Coleraine,3308,2,14,10,2,43,25,18,52
Glenavon,3308,3,10,9,7,55,43,12,39
Linfield,3308,4,11,5,10,38,36,2,38
Cliftonville,3308,5,9,4,13,32,32,0,31
Ballymena,3308,6,7,4,15,26,49,-23,25
Glentoran,3308,7,6,6,10,24,32,-8,24
Dungannon,3308,8,2,4,16,14,47,-33,10
Crusaders,3309,1,16,7,3,62,31,31,55
Coleraine,3309,2,14,11,1,44,23,21,53
Glenavon,3309,3,9,10,7,53,44,9,37
Linfield,3309,4,10,5,11,37,38,-1,35
Cliftonville,3309,5,10,4,12,34,31,3,34
Ballymena,3309,6,7,5,14,26,48,-22,26
Glentoran,3309,7,6,6,10,24,32,-8,24
Dungannon,3309,8,2,4,16,14,47,-33,10
Crusaders,3310,1,17,6,3,63,31,32,57
Coleraine,3310,2,14,10,2,43,25,18,52
Glenavon,3310,3,10,9,7,55,43,12,39
Linfield,3310,4,10,6,10,37,36,1,36
Cliftonville,3310,5,9,5,12,32,31,1,32
Ballymena,3310,6,7,4,15,26,49,-23,25
Glentoran,3310,7,6,6,10,24,32,-8,24
Dungannon,3310,8,2,4,16,14,47,-33,10
Crusaders,3311,1,16,6,4,61,32,29,54
Coleraine,3311,2,14,11,1,45,24,21,53
Linfield,3311,3,11,5,10,39,36,3,38
Glenavon,3311,4,9,10,7,54,45,9,37
Cliftonville,3311,5,9,4,13,32,33,-1,31
Ballymena,3311,6,8,4,14,27,47,-20,28
Glentoran,3311,7,6,6,10,24,32,-8,24
Dungannon,3311,8,2,4,16,14,47,-33,10
Crusaders,3312,1,17,6,3,64,32,32,57
Coleraine,3312,2,14,10,2,43,24,19,52
Glenavon,3312,3,10,9,7,54,43,11,39
Linfield,3312,4,11,5,10,38,36,2,38
Cliftonville,3312,5,9,4,13,32,32,0,31
Ballymena,3312,6,7,4,15,27,50,-23,25
Glentoran,3312,7,6,6,10,24,32,-8,24
Dungannon,3312,8,2,4,16,14,47,-33,10
Crusaders,3313,1,16,7,3,63,32,31,55
Coleraine,3313,2,14,10,2,43,24,19,52
Glenavon,3313,3,10,9,7,54,43,11,39
Linfield,3313,4,11,5,10,40,36,4,38
Cliftonville,3313,5,9,4,13,32,34,-2,31
Ballymena,3313,6,7,5,14,27,49,-22,26
Glentoran,3313,7,6,6,10,24,32,-8,24
Dungannon,3313,8,2,4,16,14,47,-33,10
Crusaders,3314,1,17,6,3,64,31,33,57
Coleraine,3314,2,14,10,2,44,24,20,52
Glenavon,3314,3,10,9,7,54,44,10,39
Linfield,3314,4,10,6,10,37,36,1,36
Cliftonville,3314,5,9,5,12,32,31,1,32
Ballymena,3314,6,7,4,15,26,50,-24,25
Glentoran,3314,7,6,6,10,24,32,-8,24
Dungannon,3314,8,2,4,16,14,47,-33,10
Crusaders,3315,1,17,6,3,63,30,33,57
Coleraine,3315,2,14,10,2,43,24,19,52
Glenavon,3315,3,10,9,7,54,43,11,39
Linfield,3315,4,11,5,10,39,37,2,38
Cliftonville,3315,5,9,4,13,33,33,0,31
Ballymena,3315,6,7,4,15,25,49,-24,25
Glentoran,3315,7,6,6,10,24,32,-8,24
Dungannon,3315,8,2,4,16,14,47,-33,10
Crusaders,3316,1,16,7,3,61,30,31,55
Coleraine,3316,2,14,10,2,43,24,19,52
Glenavon,3316,3,10,9,7,54,43,11,39
Linfield,3316,4,11,5,10,41,37,4,38
Cliftonville,3316,5,9,4,13,33,35,-2,31
Ballymena,3316,6,7,5,14,25,47,-22,26
Glentoran,3316,7,6,6,10,24,32,-8,24
Dungannon,3316,8,2,4,16,14,47,-33,10
Crusaders,3317,1,16,7,3,62,31,31,55
Coleraine,3317,2,14,11,1,44,23,21,53
Glenavon,3317,3,9,10,7,53,44,9,37
Linfield,3317,4,10,6,10,38,37,1,36
Cliftonville,3317,5,9,5,12,33,32,1,32
Ballymena,3317,6,7,5,14,26,48,-22,26
Glentoran,3317,7,6,6,10,24,32,-8,24
Dungannon,3317,8,2,4,16,14,47,-33,10
Crusaders,3318,1,17,6,3,62,30,32,57
Coleraine,3318,2,14,10,2,44,26,18,52
Glenavon,3318,3,10,9,7,56,44,12,39
Linfield,3318,4,10,5,11,37,38,-1,35
Cliftonville,3318,5,10,4,12,34,31,3,34
Ballymena,3318,6,7,4,15,25,48,-23,25
Glentoran,3318,7,6,6,10,24,32,-8,24
Dungannon,3318,8,2,4,16,14,47,-33,10
Crusaders,3319,1,16,7,3,62,31,31,55
Coleraine,3319,2,14,10,2,46,27,19,52
Glenavon,3319,3,10,9,7,57,46,11,39
Linfield,3319,4,11,5,10,38,36,2,38
Cliftonville,3319,5,9,4,13,32,32,0,31
Ballymena,3319,6,7,5,14,26,48,-22,26
Glentoran,3319,7,6,6,10,24,32,-8,24
Dungannon,3319,8,2,4,16,14,47,-33,10
Crusaders,3320,1,17,6,3,64,30,34,57
Coleraine,3320,2,15,10,1,47,23,24,55
Linfield,3320,3,11,5,10,39,37,2,38
Glenavon,3320,4,9,9,8,53,47,6,36
Cliftonville,3320,5,9,4,13,33,33,0,31
Ballymena,3320,6,7,4,15,25,50,-25,25
Glentoran,3320,7,6,6,10,24,32,-8,24
Dungannon,3320,8,2,4,16,14,47,-33,10
Crusaders,3321,1,16,7,3,62,31,31,55
Coleraine,3321,2,14,11,1,44,23,21,53
Glenavon,3321,3,9,10,7,53,44,9,37
Linfield,3321,4,10,6,10,37,36,1,36
Cliftonville,3321,5,9,5,12,32,31,1,32
Ballymena,3321,6,7,5,14,26,48,-22,26
Glentoran,3321,7,6,6,10,24,32,-8,24
Dungannon,3321,8,2,4,16,14,47,-33,10
Crusaders,3322,1,17,6,3,63,31,32,57
Coleraine,3322,2,14,10,2,44,24,20,52
Glenavon,3322,3,10,9,7,54,44,10,39
Linfield,3322,4,11,5,10,39,36,3,38
Cliftonville,3322,5,9,4,13,32,33,-1,31
Ballymena,3322,6,7,4,15,26,49,-23,25
Glentoran,3322,7,6,6,10,24,32,-8,24
Dungannon,3322,8,2,4,16,14,47,-33,10
Crusaders,3323,1,16,6,4,62,32,30,54
Coleraine,3323,2,14,10,2,43,26,17,52
Glenavon,3323,3,10,9,7,56,43,13,39
Linfield,3323,4,10,5,11,38,39,-1,35
Cliftonville,3323,5,10,4,12,35,32,3,34
Ballymena,3323,6,8,4,14,27,48,-21,28
Glentoran,3323,7,6,6,10,24,32,-8,24
Dungannon,3323,8,2,4,16,14,47,-33,10
Crusaders,3324,1,16,7,3,64,33,31,55
Coleraine,3324,2,15,10,1,44,22,22,55
Glenavon,3324,3,9,9,8,52,44,8,36
Linfield,3324,4,10,5,11,38,38,0,35
Cliftonville,3324,5,10,4,12,34,32,2,34
Ballymena,3324,6,7,5,14,28,50,-22,26
Glentoran,3324,7,6,6,10,24,32,-8,24
Dungannon,3324,8,2,4,16,14,47,-33,10
Crusaders,3325,1,16,6,4,62,35,27,54
Coleraine,3325,2,14,10,2,44,24,20,52
Glenavon,3325,3,10,9,7,54,44,10,39
Linfield,3325,4,10,5,11,37,37,0,35
Cliftonville,3325,5,10,4,12,33,31,2,34
Ballymena,3325,6,8,4,14,30,48,-18,28
Glentoran,3325,7,6,6,10,24,32,-8,24
Dungannon,3325,8,2,4,16,14,47,-33,10
Crusaders,3326,1,17,6,3,62,30,32,57
Coleraine,3326,2,14,11,1,44,23,21,53
Glenavon,3326,3,9,10,7,53,44,9,37
Linfield,3326,4,10,5,11,38,38,0,35
Cliftonville,3326,5,10,4,12,34,32,2,34
Ballymena,3326,6,7,4,15,25,48,-23,25
Glentoran,3326,7,6,6,10,24,32,-8,24
Dungannon,3326,8,2,4,16,14,47,-33,10
Coleraine,3327,1,15,10,1,46,23,23,55
Crusaders,3327,2,16,6,4,61,31,30,54
Linfield,3327,3,11,5,10,39,36,3,38
Glenavon,3327,4,9,9,8,53,46,7,36
Cliftonville,3327,5,9,4,13,32,33,-1,31
Ballymena,3327,6,8,4,14,26,47,-21,28
Glentoran,3327,7,6,6,10,24,32,-8,24
Dungannon,3327,8,2,4,16,14,47,-33,10
Crusaders,3328,1,17,6,3,64,30,34,57
Coleraine,3328,2,14,11,1,44,23,21,53
Linfield,3328,3,11,5,10,41,37,4,38
Glenavon,3328,4,9,10,7,53,44,9,37
Cliftonville,3328,5,9,4,13,33,35,-2,31
Ballymena,3328,6,7,4,15,25,50,-25,25
Glentoran,3328,7,6,6,10,24,32,-8,24
Dungannon,3328,8,2,4,16,14,47,-33,10
Crusaders,3329,1,17,6,3,65,31,34,57
Coleraine,3329,2,14,11,1,45,24,21,53
Linfield,3329,3,11,5,10,39,36,3,38
Glenavon,3329,4,9,10,7,54,45,9,37
Cliftonville,3329,5,9,4,13,32,33,-1,31
Ballymena,3329,6,7,4,15,26,51,-25,25
Glentoran,3329,7,6,6,10,24,32,-8,24
Dungannon,3329,8,2,4,16,14,47,-33,10
Crusaders,3330,1,17,6,3,62,30,32,57
Coleraine,3330,2,14,10,2,43,24,19,52
Glenavon,3330,3,10,9,7,54,43,11,39
Linfield,3330,4,11,5,10,41,37,4,38
Cliftonville,3330,5,9,4,13,33,35,-2,31
Ballymena,3330,6,7,4,15,25,48,-23,25
Glentoran,3330,7,6,6,10,24,32,-8,24
Dungannon,3330,8,2,4,16,14,47,-33,10
Crusaders,3331,1,16,6,4,61,32,29,54
Coleraine,3331,2,14,10,2,43,26,17,52
Glenavon,3331,3,10,9,7,56,43,13,39
Linfield,3331,4,11,5,10,39,37,2,38
Cliftonville,3331,5,9,4,13,33,33,0,31
Ballymena,3331,6,8,4,14,27,47,-20,28
Glentoran,3331,7,6,6,10,24,32,-8,24
Dungannon,3331,8,2,4,16,14,47,-33,10
Crusaders,3332,1,17,6,3,65,30,35,57
Coleraine,3332,2,14,10,2,43,23,20,52
Glenavon,3332,3,10,9,7,53,43,10,39
Linfield,3332,4,10,5,11,38,38,0,35
Cliftonville,3332,5,10,4,12,34,32,2,34
Ballymena,3332,6,7,4,15,25,51,-26,25
Glentoran,3332,7,6,6,10,24,32,-8,24
Dungannon,3332,8,2,4,16,14,47,-33,10
Crusaders,3333,1,17,6,3,65,30,35,57
Coleraine,3333,2,14,10,2,44,25,19,52
Glenavon,3333,3,10,9,7,55,44,11,39
Linfield,3333,4,11,5,10,38,36,2,38
Cliftonville,3333,5,9,4,13,32,32,0,31
Ballymena,3333,6,7,4,15,25,51,-26,25
Glentoran,3333,7,6,6,10,24,32,-8,24
Dungannon,3333,8,2,4,16,14,47,-33,10
Crusaders,3334,1,17,6,3,65,31,34,57
Coleraine,3334,2,14,10,2,45,25,20,52
Glenavon,3334,3,10,9,7,55,45,10,39
Linfield,3334,4,11,5,10,38,36,2,38
Cliftonville,3334,5,9,4,13,32,32,0,31
Ballymena,3334,6,7,4,15,26,51,-25,25
Glentoran,3334,7,6,6,10,24,32,-8,24
Dungannon,3334,8,2,4,16,14,47,-33,10
Coleraine,3335,1,15,10,1,46,22,24,55
Crusaders,3335,2,16,6,4,62,32,30,54
Linfield,3335,3,11,5,10,40,38,2,38
Glenavon,3335,4,9,9,8,52,46,6,36
Cliftonville,3335,5,9,4,13,34,34,0,31
Ballymena,3335,6,8,4,14,27,48,-21,28
Glentoran,3335,7,6,6,10,24,32,-8,24
Dungannon,3335,8,2,4,16,14,47,-33,10
Crusaders,3336,1,16,7,3,62,31,31,55
Coleraine,3336,2,14,10,2,43,24,19,52
Glenavon,3336,3,10,9,7,54,43,11,39
Linfield,3336,4,10,6,10,40,39,1,36
Cliftonville,3336,5,9,5,12,35,34,1,32
Ballymena,3336,6,7,5,14,26,48,-22,26
Glentoran,3336,7,6,6,10,24,32,-8,24
Dungannon,3336,8,2,4,16,14,47,-33,10
Crusaders,3337,1,17,6,3,63,30,33,57
Coleraine,3337,2,15,10,1,46,24,22,55
Glenavon,3337,3,9,9,8,54,46,8,36
Linfield,3337,4,10,6,10,38,37,1,36
Cliftonville,3337,5,9,5,12,33,32,1,32
Ballymena,3337,6,7,4,15,25,49,-24,25
Glentoran,3337,7,6,6,10,24,32,-8,24
Dungannon,3337,8,2,4,16,14,47,-33,10
Crusaders,3338,1,17,6,3,63,31,32,57
Coleraine,3338,2,15,10,1,45,23,22,55
Glenavon,3338,3,9,9,8,53,45,8,36
Linfield,3338,4,10,6,10,38,37,1,36
Cliftonville,3338,5,9,5,12,33,32,1,32
Ballymena,3338,6,7,4,15,26,49,-23,25
Glentoran,3338,7,6,6,10,24,32,-8,24
Dungannon,3338,8,2,4,16,14,47,-33,10
Crusaders,3339,1,16,6,4,63,33,30,54
Coleraine,3339,2,14,10,2,45,28,17,52
Glenavon,3339,3,10,9,7,58,45,13,39
Linfield,3339,4,11,5,10,39,37,2,38
Cliftonville,3339,5,9,4,13,33,33,0,31
Ballymena,3339,6,8,4,14,28,49,-21,28
Glentoran,3339,7,6,6,10,24,32,-8,24
Dungannon,3339,8,2,4,16,14,47,-33,10
Crusaders,3340,1,16,7,3,64,33,31,55
Coleraine,3340,2,15,10,1,47,23,24,55
Glenavon,3340,3,9,9,8,53,47,6,36
Linfield,3340,4,10,6,10,38,37,1,36
Cliftonville,3340,5,9,5,12,33,32,1,32
Ballymena,3340,6,7,5,14,28,50,-22,26
Glentoran,3340,7,6,6,10,24,32,-8,24
Dungannon,3340,8,2,4,16,14,47,-33,10
Crusaders,3341,1,17,6,3,65,30,35,57
Coleraine,3341,2,14,11,1,46,25,21,53
Linfield,3341,3,11,5,10,39,36,3,38
Glenavon,3341,4,9,10,7,55,46,9,37
Cliftonville,3341,5,9,4,13,32,33,-1,31
Ballymena,3341,6,7,4,15,25,51,-26,25
Glentoran,3341,7,6,6,10,24,32,-8,24
Dungannon,3341,8,2,4,16,14,47,-33,10
Crusaders,3342,1,16,7,3,62,31,31,55
Coleraine,3342,2,14,10,2,43,24,19,52
Glenavon,3342,3,10,9,7,54,43,11,39
Linfield,3342,4,11,5,10,38,36,2,38
Cliftonville,3342,5,9,4,13,32,32,0,31
Ballymena,3342,6,7,5,14,26,48,-22,26
Glentoran,3342,7,6,6,10,24,32,-8,24
Dungannon,3342,8,2,4,16,14,47,-33,10
Crusaders,3343,1,17,6,3,63,31,32,57
Coleraine,3343,2,14,10,2,44,24,20,52
Glenavon,3343,3,10,9,7,54,44,10,39
Linfield,3343,4,11,5,10,38,36,2,38
Cliftonville,3343,5,9,4,13,32,32,0,31
Ballymena,3343,6,7,4,15,26,49,-23,25
Glentoran,3343,7,6,6,10,24,32,-8,24
Dungannon,3343,8,2,4,16,14,47,-33,10
Crusaders,3344,1,17,6,3,64,32,32,57
Coleraine,3344,2,14,11,1,43,22,21,53
Linfield,3344,3,11,5,10,38,36,2,38
Glenavon,3344,4,9,10,7,52,43,9,37
Cliftonville,3344,5,9,4,13,32,32,0,31
Ballymena,3344,6,7,4,15,27,50,-23,25
Glentoran,3344,7,6,6,10,24,32,-8,24
Dungannon,3344,8,2,4,16,14,47,-33,10
Crusaders,3345,1,16,7,3,62,31,31,55
Coleraine,3345,2,15,10,1,46,24,22,55
Glenavon,3345,3,9,9,8,54,46,8,36
Linfield,3345,4,10,6,10,38,37,1,36
Cliftonville,3345,5,9,5,12,33,32,1,32
Ballymena,3345,6,7,5,14,26,48,-22,26
Glentoran,3345,7,6,6,10,24,32,-8,24
Dungannon,3345,8,2,4,16,14,47,-33,10
Coleraine,3346,1,15,10,1,46,24,22,55
Crusaders,3346,2,16,6,4,62,33,29,54
Linfield,3346,3,11,5,10,39,36,3,38
Glenavon,3346,4,9,9,8,54,46,8,36
Cliftonville,3346,5,9,4,13,32,33,-1,31
Ballymena,3346,6,8,4,14,28,48,-20,28
Glentoran,3346,7,6,6,10,24,32,-8,24
Dungannon,3346,8,2,4,16,14,47,-33,10
Crusaders,3347,1,16,7,3,61,30,31,55
Coleraine,3347,2,15,10,1,46,23,23,55
Linfield,3347,3,11,5,10,40,36,4,38
Glenavon,3347,4,9,9,8,53,46,7,36
Cliftonville,3347,5,9,4,13,32,34,-2,31
Ballymena,3347,6,7,5,14,25,47,-22,26
Glentoran,3347,7,6,6,10,24,32,-8,24
Dungannon,3347,8,2,4,16,14,47,-33,10
Crusaders,3348,1,17,6,3,64,31,33,57
Coleraine,3348,2,14,10,2,44,25,19,52
Glenavon,3348,3,10,9,7,55,44,11,39
Linfield,3348,4,10,5,11,37,38,-1,35
Cliftonville,3348,5,10,4,12,34,31,3,34
Ballymena,3348,6,7,4,15,26,50,-24,25
Glentoran,3348,7,6,6,10,24,32,-8,24
Dungannon,3348,8,2,4,16,14,47,-33,10
Crusaders,3349,1,16,7,3,62,31,31,55
Coleraine,3349,2,15,10,1,45,22,23,55
Linfield,3349,3,11,5,10,40,37,3,38
Glenavon,3349,4,9,9,8,52,45,7,36
Cliftonville,3349,5,9,4,13,33,34,-1,31
Ballymena,3349,6,7,5,14,26,48,-22,26
Glentoran,3349,7,6,6,10,24,32,-8,24
Dungannon,3349,8,2,4,16,14,47,-33,10
Crusaders,3350,1,16,7,3,61,30,31,55
Coleraine,3350,2,14,11,1,44,23,21,53
Glenavon,3350,3,9,10,7,53,44,9,37
Linfield,3350,4,10,6,10,38,37,1,36
Cliftonville,3350,5,9,5,12,33,32,1,32
Ballymena,3350,6,7,5,14,25,47,-22,26
Glentoran,3350,7,6,6,10,24,32,-8,24
Dungannon,3350,8,2,4,16,14,47,-33,10
Crusaders,3351,1,17,6,3,64,30,34,57
Coleraine,3351,2,14,11,1,44,23,21,53
Linfield,3351,3,11,5,10,39,37,2,38
Glenavon,3351,4,9,10,7,53,44,9,37
Cliftonville,3351,5,9,4,13,33,33,0,31
Ballymena,3351,6,7,4,15,25,50,-25,25
Glentoran,3351,7,6,6,10,24,32,-8,24
Dungannon,3351,8,2,4,16,14,47,-33,10
Coleraine,3352,1,15,10,1,47,23,24,55
Crusaders,3352,2,16,6,4,62,32,30,54
Linfield,3352,3,11,5,10,40,36,4,38
Glenavon,3352,4,9,9,8,53,47,6,36
Cliftonville,3352,5,9,4,13,32,34,-2,31
Ballymena,3352,6,8,4,14,27,48,-21,28
Glentoran,3352,7,6,6,10,24,32,-8,24
Dungannon,3352,8,2,4,16,14,47,-33,10
Crusaders,3353,1,16,6,4,62,33,29,54
Coleraine,3353,2,14,10,2,43,23,20,52
Glenavon,3353,3,10,9,7,53,43,10,39
Linfield,3353,4,10,5,11,39,40,-1,35
Cliftonville,3353,5,10,4,12,36,33,3,34
Ballymena,3353,6,8,4,14,28,48,-20,28
Glentoran,3353,7,6,6,10,24,32,-8,24
Dungannon,3353,8,2,4,16,14,47,-33,10
Crusaders,3354,1,17,6,3,62,30,32,57
Coleraine,3354,2,15,10,1,45,22,23,55
Glenavon,3354,3,9,9,8,52,45,7,36
Linfield,3354,4,10,5,11,39,39,0,35
Cliftonville,3354,5,10,4,12,35,33,2,34
Ballymena,3354,6,7,4,15,25,48,-23,25
Glentoran,3354,7,6,6,10,24,32,-8,24
Dungannon,3354,8,2,4,16,14,47,-33,10
Crusaders,3355,1,16,7,3,61,30,31,55
Coleraine,3355,2,14,10,2,45,25,20,52
Glenavon,3355,3,10,9,7,55,45,10,39
Linfield,3355,4,11,5,10,40,36,4,38
Cliftonville,3355,5,9,4,13,32,34,-2,31
Ballymena,3355,6,7,5,14,25,47,-22,26
Glentoran,3355,7,6,6,10,24,32,-8,24
Dungannon,3355,8,2,4,16,14,47,-33,10
Crusaders,3356,1,17,6,3,64,30,34,57
Coleraine,3356,2,14,11,1,43,22,21,53
Glenavon,3356,3,9,10,7,52,43,9,37
Linfield,3356,4,10,6,10,38,37,1,36
Cliftonville,3356,5,9,5,12,33,32,1,32
Ballymena,3356,6,7,4,15,25,50,-25,25
Glentoran,3356,7,6,6,10,24,32,-8,24
Dungannon,3356,8,2,4,16,14,47,-33,10
Crusaders,3357,1,17,6,3,63,31,32,57
Coleraine,3357,2,15,10,1,44,22,22,55
Glenavon,3357,3,9,9,8,52,44,8,36
Linfield,3357,4,10,6,10,39,38,1,36
Cliftonville,3357,5,9,5,12,34,33,1,32
Ballymena,3357,6,7,4,15,26,49,-23,25
Glentoran,3357,7,6,6,10,24,32,-8,24
Dungannon,3357,8,2,4,16,14,47,-33,10
Crusaders,3358,1,16,6,4,61,31,30,54
Coleraine,3358,2,14,10,2,43,23,20,52
Glenavon,3358,3,10,9,7,53,43,10,39
Linfield,3358,4,11,5,10,41,36,5,38
Cliftonville,3358,5,9,4,13,32,35,-3,31
Ballymena,3358,6,8,4,14,26,47,-21,28
Glentoran,3358,7,6,6,10,24,32,-8,24
Dungannon,3358,8,2,4,16,14,47,-33,10
Crusaders,3359,1,17,6,3,64,30,34,57
Coleraine,3359,2,15,10,1,46,24,22,55
Glenavon,3359,3,9,9,8,54,46,8,36
Linfield,3359,4,10,6,10,37,36,1,36
Cliftonville,3359,5,9,5,12,32,31,1,32
Ballymena,3359,6,7,4,15,25,50,-25,25
Glentoran,3359,7,6,6,10,24,32,-8,24
Dungannon,3359,8,2,4,16,14,47,-33,10
Crusaders,3360,1,17,6,3,64,30,34,57
Coleraine,3360,2,14,11,1,44,23,21,53
Linfield,3360,3,11,5,10,38,36,2,38
Glenavon,3360,4,9,10,7,53,44,9,37
Cliftonville,3360,5,9,4,13,32,32,0,31
Ballymena,3360,6,7,4,15,25,50,-25,25
Glentoran,3360,7,6,6,10,24,32,-8,24
Dungannon,3360,8,2,4,16,14,47,-33,10
Coleraine,3361,1,15,10,1,45,22,23,55
Crusaders,3361,2,16,6,4,63,33,30,54
Linfield,3361,3,11,5,10,39,37,2,38
Glenavon,3361,4,9,9,8,52,45,7,36
Cliftonville,3361,5,9,4,13,33,33,0,31
Ballymena,3361,6,8,4,14,28,49,-21,28
Glentoran,3361,7,6,6,10,24,32,-8,24
Dungannon,3361,8,2,4,16,14,47,-33,10
Crusaders,3362,1,17,6,3,63,30,33,57
Coleraine,3362,2,14,10,2,44,24,20,52
Glenavon,3362,3,10,9,7,54,44,10,39
Linfield,3362,4,11,5,10,39,36,3,38
Cliftonville,3362,5,9,4,13,32,33,-1,31
Ballymena,3362,6,7,4,15,25,49,-24,25
Glentoran,3362,7,6,6,10,24,32,-8,24
Dungannon,3362,8,2,4,16,14,47,-33,10
Crusaders,3363,1,17,6,3,65,31,34,57
Coleraine,3363,2,14,10,2,43,23,20,52
Glenavon,3363,3,10,9,7,53,43,10,39
Linfield,3363,4,10,6,10,38,37,1,36
Cliftonville,3363,5,9,5,12,33,32,1,32
Ballymena,3363,6,7,4,15,26,51,-25,25
Glentoran,3363,7,6,6,10,24,32,-8,24
Dungannon,3363,8,2,4,16,14,47,-33,10
Crusaders,3364,1,16,6,4,62,32,30,54
Coleraine,3364,2,14,11,1,43,22,21,53
Linfield,3364,3,11,5,10,39,37,2,38
Glenavon,3364,4,9,10,7,52,43,9,37
Cliftonville,3364,5,9,4,13,33,33,0,31
Ballymena,3364,6,8,4,14,27,48,-21,28
Glentoran,3364,7,6,6,10,24,32,-8,24
Dungannon,3364,8,2,4,16,14,47,-33,10
Coleraine,3365,1,15,10,1,46,24,22,55
Crusaders,3365,2,16,6,4,63,33,30,54
Glenavon,3365,3,9,9,8,54,46,8,36
Linfield,3365,4,10,5,11,37,37,0,35
Cliftonville,3365,5,10,4,12,33,31,2,34
Ballymena,3365,6,8,4,14,28,49,-21,28
Glentoran,3365,7,6,6,10,24,32,-8,24
Dungannon,3365,8,2,4,16,14,47,-33,10
Crusaders,3366,1,17,6,3,64,32,32,57
Coleraine,3366,2,14,10,2,43,23,20,52
Glenavon,3366,3,10,9,7,53,43,10,39
Linfield,3366,4,10,5,11,37,38,-1,35
Cliftonville,3366,5,10,4,12,34,31,3,34
Ballymena,3366,6,7,4,15,27,50,-23,25
Glentoran,3366,7,6,6,10,24,32,-8,24
Dungannon,3366,8,2,4,16,14,47,-33,10
Crusaders,3367,1,17,6,3,66,31,35,57
Coleraine,3367,2,14,10,2,45,25,20,52
Glenavon,3367,3,10,9,7,55,45,10,39
Linfield,3367,4,10,6,10,38,37,1,36
Cliftonville,3367,5,9,5,12,33,32,1,32
Ballymena,3367,6,7,4,15,26,52,-26,25
Glentoran,3367,7,6,6,10,24,32,-8,24
Dungannon,3367,8,2,4,16,14,47,-33,10
Coleraine,3368,1,15,10,1,46,24,22,55
Crusaders,3368,2,16,6,4,61,33,28,54
Glenavon,3368,3,9,9,8,54,46,8,36
Linfield,3368,4,10,6,10,39,38,1,36
Cliftonville,3368,5,9,5,12,34,33,1,32
Ballymena,3368,6,8,4,14,28,47,-19,28
Glentoran,3368,7,6,6,10,24,32,-8,24
Dungannon,3368,8,2,4,16,14,47,-33,10
Crusaders,3369,1,17,6,3,62,30,32,57
Coleraine,3369,2,14,10,2,45,26,19,52
Glenavon,3369,3,10,9,7,56,45,11,39
Linfield,3369,4,11,5,10,41,36,5,38
Cliftonville,3369,5,9,4,13,32,35,-3,31
Ballymena,3369,6,7,4,15,25,48,-23,25
Glentoran,3369,7,6,6,10,24,32,-8,24
Dungannon,3369,8,2,4,16,14,47,-33,10
Crusaders,3370,1,17,6,3,66,31,35,57
Coleraine,3370,2,14,10,2,43,23,20,52
Glenavon,3370,3,10,9,7,53,43,10,39
Linfield,3370,4,10,6,10,39,38,1,36
Cliftonville,3370,5,9,5,12,34,33,1,32
Ballymena,3370,6,7,4,15,26,52,-26,25
Glentoran,3370,7,6,6,10,24,32,-8,24
Dungannon,3370,8,2,4,16,14,47,-33,10
Crusaders,3371,1,17,6,3,64,30,34,57
Coleraine,3371,2,14,10,2,43,24,19,52
Glenavon,3371,3,10,9,7,54,43,11,39
Linfield,3371,4,10,5,11,38,39,-1,35
Cliftonville,3371,5,10,4,12,35,32,3,34
Ballymena,3371,6,7,4,15,25,50,-25,25
Glentoran,3371,7,6,6,10,24,32,-8,24
Dungannon,3371,8,2,4,16,14,47,-33,10
Crusaders,3372,1,17,6,3,63,31,32,57
Coleraine,3372,2,15,10,1,45,23,22,55
Glenavon,3372,3,9,9,8,53,45,8,36
Linfield,3372,4,10,5,11,38,38,0,35
Cliftonville,3372,5,10,4,12,34,32,2,34
Ballymena,3372,6,7,4,15,26,49,-23,25
Glentoran,3372,7,6,6,10,24,32,-8,24
Dungannon,3372,8,2,4,16,14,47,-33,10
Crusaders,3373,1,17,6,3,66,34,32,57
Coleraine,3373,2,15,10,1,47,25,22,55
Glenavon,3373,3,9,9,8,55,47,8,36
Linfield,3373,4,10,6,10,38,37,1,36
Cliftonville,3373,5,9,5,12,33,32,1,32
Ballymena,3373,6,7,4,15,29,52,-23,25
Glentoran,3373,7,6,6,10,24,32,-8,24
Dungannon,3373,8,2,4,16,14,47,-33,10
Crusaders,3374,1,16,6,4,63,34,29,54
Coleraine,3374,2,14,10,2,43,24,19,52
Glenavon,3374,3,10,9,7,54,43,11,39
Linfield,3374,4,11,5,10,38,36,2,38
Cliftonville,3374,5,9,4,13,32,32,0,31
Ballymena,3374,6,8,4,14,29,49,-20,28
Glentoran,3374,7,6,6,10,24,32,-8,24
Dungannon,3374,8,2,4,16,14,47,-33,10
Coleraine,3375,1,15,10,1,44,22,22,55
Crusaders,3375,2,16,6,4,61,31,30,54
Glenavon,3375,3,9,9,8,52,44,8,36
Linfield,3375,4,10,5,11,38,39,-1,35
Cliftonville,3375,5,10,4,12,35,32,3,34
Ballymena,3375,6,8,4,14,26,47,-21,28
Glentoran,3375,7,6,6,10,24,32,-8,24
Dungannon,3375,8,2,4,16,14,47,-33,10
Crusaders,3376,1,16,7,3,63,32,31,55
Coleraine,3376,2,15,10,1,46,23,23,55
Glenavon,3376,3,9,9,8,53,46,7,36
Linfield,3376,4,10,5,11,38,40,-2,35
Cliftonville,3376,5,10,4,12,36,32,4,34
Ballymena,3376,6,7,5,14,27,49,-22,26
Glentoran,3376,7,6,6,10,24,32,-8,24
Dungannon,3376,8,2,4,16,14,47,-33,10
Crusaders,3377,1,17,6,3,62,30,32,57
Coleraine,3377,2,15,10,1,45,23,22,55
Linfield,3377,3,11,5,10,38,36,2,38
Glenavon,3377,4,9,9,8,53,45,8,36
Cliftonville,3377,5,9,4,13,32,32,0,31
Ballymena,3377,6,7,4,15,25,48,-23,25
Glentoran,3377,7,6,6,10,24,32,-8,24
Dungannon,3377,8,2,4,16,14,47,-33,10
Crusaders,3378,1,17,6,3,64,30,34,57
Coleraine,3378,2,15,10,1,45,22,23,55
Glenavon,3378,3,9,9,8,52,45,7,36
Linfield,3378,4,10,6,10,37,36,1,36
Cliftonville,3378,5,9,5,12,32,31,1,32
Ballymena,3378,6,7,4,15,25,50,-25,25
Glentoran,3378,7,6,6,10,24,32,-8,24
Dungannon,3378,8,2,4,16,14,47,-33,10
Coleraine,3379,1,15,10,1,45,22,23,55
Crusaders,3379,2,16,6,4,61,31,30,54
Glenavon,3379,3,9,9,8,52,45,7,36
Linfield,3379,4,10,6,10,38,37,1,36
Cliftonville,3379,5,9,5,12,33,32,1,32
Ballymena,3379,6,8,4,14,26,47,-21,28
Glentoran,3379,7,6,6,10,24,32,-8,24
Dungannon,3379,8,2,4,16,14,47,-33,10
Crusaders,3380,1,17,6,3,63,31,32,57
Coleraine,3380,2,14,10,2,43,24,19,52
Glenavon,3380,3,10,9,7,54,43,11,39
Linfield,3380,4,10,5,11,37,39,-2,35
Cliftonville,3380,5,10,4,12,35,31,4,34
Ballymena,3380,6,7,4,15,26,49,-23,25
Glentoran,3380,7,6,6,10,24,32,-8,24
Dungannon,3380,8,2,4,16,14,47,-33,10
Coleraine,3381,1,15,10,1,46,24,22,55
Crusaders,3381,2,16,6,4,63,33,30,54
Linfield,3381,3,11,5,10,38,36,2,38
Glenavon,3381,4,9,9,8,54,46,8,36
Cliftonville,3381,5,9,4,13,32,32,0,31
Ballymena,3381,6,8,4,14,28,49,-21,28
Glentoran,3381,7,6,6,10,24,32,-8,24
Dungannon,3381,8,2,4,16,14,47,-33,10
Coleraine,3382,1,15,10,1,44,22,22,55
Crusaders,3382,2,16,6,4,62,32,30,54
Glenavon,3382,3,9,9,8,52,44,8,36
Linfield,3382,4,10,5,11,37,37,0,35
Cliftonville,3382,5,10,4,12,33,31,2,34
Ballymena,3382,6,8,4,14,27,48,-21,28
Glentoran,3382,7,6,6,10,24,32,-8,24
Dungannon,3382,8,2,4,16,14,47,-33,10
Crusaders,3383,1,17,6,3,63,31,32,57
Coleraine,3383,2,14,10,2,45,25,20,52
Glenavon,3383,3,10,9,7,55,45,10,39
Linfield,3383,4,10,6,10,38,37,1,36
Cliftonville,3383,5,9,5,12,33,32,1,32
Ballymena,3383,6,7,4,15,26,49,-23,25
Glentoran,3383,7,6,6,10,24,32,-8,24
Dungannon,3383,8,2,4,16,14,47,-33,10
Crusaders,3384,1,17,6,3,63,31,32,57
Coleraine,3384,2,14,11,1,44,23,21,53
Glenavon,3384,3,9,10,7,53,44,9,37
Linfield,3384,4,10,6,10,38,37,1,36
Cliftonville,3384,5,9,5,12,33,32,1,32
Ballymena,3384,6,7,4,15,26,49,-23,25
Glentoran,3384,7,6,6,10,24,32,-8,24
Dungannon,3384,8,2,4,16,14,47,-33,10
Crusaders,3385,1,17,6,3,63,31,32,57
Coleraine,3385,2,14,10,2,46,26,20,52
Glenavon,3385,3,10,9,7,56,46,10,39
Linfield,3385,4,10,5,11,39,39,0,35
Cliftonville,3385,5,10,4,12,35,33,2,34
Ballymena,3385,6,7,4,15,26,49,-23,25
Glentoran,3385,7,6,6,10,24,32,-8,24
Dungannon,3385,8,2,4,16,14,47,-33,10
Coleraine,3386,1,15,10,1,45,23,22,55
Crusaders,3386,2,16,6,4,61,32,29,54
Linfield,3386,3,11,5,10,38,36,2,38
Glenavon,3386,4,9,9,8,53,45,8,36
Cliftonville,3386,5,9,4,13,32,32,0,31
Ballymena,3386,6,8,4,14,27,47,-20,28
Glentoran,3386,7,6,6,10,24,32,-8,24
Dungannon,3386,8,2,4,16,14,47,-33,10
Coleraine,3387,1,15,10,1,46,24,22,55
Crusaders,3387,2,16,6,4,61,31,30,54
Linfield,3387,3,11,5,10,39,36,3,38
Glenavon,3387,4,9,9,8,54,46,8,36
Cliftonville,3387,5,9,4,13,32,33,-1,31
Ballymena,3387,6,8,4,14,26,47,-21,28
Glentoran,3387,7,6,6,10,24,32,-8,24
Dungannon,3387,8,2,4,16,14,47,-33,10
Crusaders,3388,1,16,7,3,63,32,31,55
Coleraine,3388,2,14,10,2,43,25,18,52
Glenavon,3388,3,10,9,7,55,43,12,39
Linfield,3388,4,11,5,10,38,36,2,38
Cliftonville,3388,5,9,4,13,32,32,0,31
Ballymena,3388,6,7,5,14,27,49,-22,26
Glentoran,3388,7,6,6,10,24,32,-8,24
Dungannon,3388,8,2,4,16,14,47,-33,10
Crusaders,3389,1,17,6,3,65,31,34,57
Coleraine,3389,2,14,10,2,43,23,20,52
Glenavon,3389,3,10,9,7,53,43,10,39
Linfield,3389,4,11,5,10,38,36,2,38
Cliftonville,3389,5,9,4,13,32,32,0,31
Ballymena,3389,6,7,4,15,26,51,-25,25
Glentoran,3389,7,6,6,10,24,32,-8,24
Dungannon,3389,8,2,4,16,14,47,-33,10
Crusaders,3390,1,17,6,3,62,30,32,57
Coleraine,3390,2,14,11,1,43,22,21,53
Linfield,3390,3,11,5,10,40,36,4,38
Glenavon,3390,4,9,10,7,52,43,9,37
Cliftonville,3390,5,9,4,13,32,34,-2,31
Ballymena,3390,6,7,4,15,25,48,-23,25
Glentoran,3390,7,6,6,10,24,32,-8,24
Dungannon,3390,8,2,4,16,14,47,-33,10
Coleraine,3391,1,15,10,1,46,23,23,55
Crusaders,3391,2,16,6,4,62,32,30,54
Glenavon,3391,3,9,9,8,53,46,7,36
Linfield,3391,4,10,5,11,38,40,-2,35
Cliftonville,3391,5,10,4,12,36,32,4,34
Ballymena,3391,6,8,4,14,27,48,-21,28
Glentoran,3391,7,6,6,10,24,32,-8,24
Dungannon,3391,8,2,4,16,14,47,-33,10
Crusaders,3392,1,17,6,3,63,30,33,57
Coleraine,3392,2,14,10,2,44,24,20,52
Glenavon,3392,3,10,9,7,54,44,10,39
Linfield,3392,4,11,5,10,39,36,3,38
Cliftonville,3392,5,9,4,13,32,33,-1,31
Ballymena,3392,6,7,4,15,25,49,-24,25
Glentoran,3392,7,6,6,10,24,32,-8,24
Dungannon,3392,8,2,4,16,14,47,-33,10
Crusaders,3393,1,16,6,4,61,31,30,54
Coleraine,3393,2,14,10,2,46,26,20,52
Glenavon,3393,3,10,9,7,56,46,10,39
Linfield,3393,4,10,6,10,38,37,1,36
Cliftonville,3393,5,9,5,12,33,32,1,32
Ballymena,3393,6,8,4,14,26,47,-21,28
Glentoran,3393,7,6,6,10,24,32,-8,24
Dungannon,3393,8,2,4,16,14,47,-33,10
Crusaders,3394,1,17,6,3,62,30,32,57
Coleraine,3394,2,15,10,1,44,22,22,55
Linfield,3394,3,11,5,10,41,36,5,38
Glenavon,3394,4,9,9,8,52,44,8,36
Cliftonville,3394,5,9,4,13,32,35,-3,31
Ballymena,3394,6,7,4,15,25,48,-23,25
Glentoran,3394,7,6,6,10,24,32,-8,24
Dungannon,3394,8,2,4,16,14,47,-33,10
Crusaders,3395,1,17,6,3,63,31,32,57
Coleraine,3395,2,14,11,1,44,23,21,53
Linfield,3395,3,11,5,10,40,38,2,38
Glenavon,3395,4,9,10,7,53,44,9,37
Cliftonville,3395,5,9,4,13,34,34,0,31
Ballymena,3395,6,7,4,15,26,49,-23,25
Glentoran,3395,7,6,6,10,24,32,-8,24
Dungannon,3395,8,2,4,16,14,47,-33,10
Crusaders,3396,1,16,7,3,62,31,31,55
Coleraine,3396,2,14,11,1,44,23,21,53
Glenavon,3396,3,9,10,7,53,44,9,37
Linfield,3396,4,10,5,11,39,39,0,35
Cliftonville,3396,5,10,4,12,35,33,2,34
Ballymena,3396,6,7,5,14,26,48,-22,26
Glentoran,3396,7,6,6,10,24,32,-8,24
Dungannon,3396,8,2,4,16,14,47,-33,10
Crusaders,3397,1,17,6,3,63,30,33,57
Coleraine,3397,2,15,10,1,45,23,22,55
Glenavon,3397,3,9,9,8,53,45,8,36
Linfield,3397,4,10,5,11,37,37,0,35
Cliftonville,3397,5,10,4,12,33,31,2,34
Ballymena,3397,6,7,4,15,25,49,-24,25
Glentoran,3397,7,6,6,10,24,32,-8,24
Dungannon,3397,8,2,4,16,14,47,-33,10
Crusaders,3398,1,17,6,3,63,30,33,57
Coleraine,3398,2,14,10,2,44,25,19,52
Glenavon,3398,3,10,9,7,55,44,11,39
Linfield,3398,4,10,5,11,37,38,-1,35
Cliftonville,3398,5,10,4,12,34,31,3,34
Ballymena,3398,6,7,4,15,25,49,-24,25
Glentoran,3398,7,6,6,10,24,32,-8,24
Dungannon,3398,8,2,4,16,14,47,-33,10
Crusaders,3399,1,17,6,3,63,31,32,57
Coleraine,3399,2,14,10,2,43,24,19,52
Glenavon,3399,3,10,9,7,54,43,11,39
Linfield,3399,4,10,5,11,38,38,0,35
Cliftonville,3399,5,10,4,12,34,32,2,34
Ballymena,3399,6,7,4,15,26,49,-23,25
Glentoran,3399,7,6,6,10,24,32,-8,24
Dungannon,3399,8,2,4,16,14,47,-33,10
Crusaders,3400,1,16,7,3,61,30,31,55
Coleraine,3400,2,14,10,2,44,25,19,52
Glenavon,3400,3,10,9,7,55,44,11,39
Linfield,3400,4,10,6,10,37,36,1,36
Cliftonville,3400,5,9,5,12,32,31,1,32
Ballymena,3400,6,7,5,14,25,47,-22,26
Glentoran,3400,7,6,6,10,24,32,-8,24
Dungannon,3400,8,2,4,16,14,47,-33,10
Crusaders,3401,1,16,6,4,61,31,30,54
Coleraine,3401,2,14,11,1,43,22,21,53
Glenavon,3401,3,9,10,7,52,43,9,37
Linfield,3401,4,10,5,11,38,38,0,35
Cliftonville,3401,5,10,4,12,34,32,2,34
Ballymena,3401,6,8,4,14,26,47,-21,28
Glentoran,3401,7,6,6,10,24,32,-8,24
Dungannon,3401,8,2,4,16,14,47,-33,10
Crusaders,3402,1,16,7,3,62,31,31,55
Coleraine,3402,2,15,10,1,44,22,22,55
Glenavon,3402,3,9,9,8,52,44,8,36
Linfield,3402,4,10,5,11,38,39,-1,35
Cliftonville,3402,5,10,4,12,35,32,3,34
Ballymena,3402,6,7,5,14,26,48,-22,26
Glentoran,3402,7,6,6,10,24,32,-8,24
Dungannon,3402,8,2,4,16,14,47,-33,10
Crusaders,3403,1,16,6,4,62,32,30,54
Coleraine,3403,2,14,10,2,43,23,20,52
Glenavon,3403,3,10,9,7,53,43,10,39
Linfield,3403,4,10,5,11,37,37,0,35
Cliftonville,3403,5,10,4,12,33,31,2,34
Ballymena,3403,6,8,4,14,27,48,-21,28
Glentoran,3403,7,6,6,10,24,32,-8,24
Dungannon,3403,8,2,4,16,14,47,-33,10
Crusaders,3404,1,17,6,3,63,31,32,57
Coleraine,3404,2,14,10,2,45,25,20,52
Glenavon,3404,3,10,9,7,55,45,10,39
Linfield,3404,4,11,5,10,41,37,4,38
Cliftonville,3404,5,9,4,13,33,35,-2,31
Ballymena,3404,6,7,4,15,26,49,-23,25
Glentoran,3404,7,6,6,10,24,32,-8,24
Dungannon,3404,8,2,4,16,14,47,-33,10
Crusaders,3405,1,16,7,3,62,31,31,55
Coleraine,3405,2,14,10,2,44,25,19,52
Glenavon,3405,3,10,9,7,55,44,11,39
Linfield,3405,4,10,5,11,37,37,0,35
Cliftonville,3405,5,10,4,12,33,31,2,34
Ballymena,3405,6,7,5,14,26,48,-22,26
Glentoran,3405,7,6,6,10,24,32,-8,24
Dungannon,3405,8,2,4,16,14,47,-33,10
Crusaders,3406,1,17,6,3,62,30,32,57
Coleraine,3406,2,14,10,2,47,27,20,52
Glenavon,3406,3,10,9,7,57,47,10,39
Linfield,3406,4,11,5,10,39,36,3,38
Cliftonville,3406,5,9,4,13,32,33,-1,31
Ballymena,3406,6,7,4,15,25,48,-23,25
Glentoran,3406,7,6,6,10,24,32,-8,24
Dungannon,3406,8,2,4,16,14,47,-33,10
Crusaders,3407,1,17,6,3,65,32,33,57
Coleraine,3407,2,14,10,2,45,26,19,52
Glenavon,3407,3,10,9,7,56,45,11,39
Linfield,3407,4,11,5,10,39,36,3,38
Cliftonville,3407,5,9,4,13,32,33,-1,31
Ballymena,3407,6,7,4,15,27,51,-24,25
Glentoran,3407,7,6,6,10,24,32,-8,24
Dungannon,3407,8,2,4,16,14,47,-33,10
Crusaders,3408,1,17,6,3,63,30,33,57
Coleraine,3408,2,14,10,2,44,28,16,52
Glenavon,3408,3,10,9,7,58,44,14,39
Linfield,3408,4,10,6,10,38,37,1,36
Cliftonville,3408,5,9,5,12,33,32,1,32
Ballymena,3408,6,7,4,15,25,49,-24,25
Glentoran,3408,7,6,6,10,24,32,-8,24
Dungannon,3408,8,2,4,16,14,47,-33,10
Crusaders,3409,1,17,6,3,62,30,32,57
Coleraine,3409,2,15,10,1,45,22,23,55
Glenavon,3409,3,9,9,8,52,45,7,36
Linfield,3409,4,10,5,11,37,37,0,35
Cliftonville,3409,5,10,4,12,33,31,2,34
Ballymena,3409,6,7,4,15,25,48,-23,25
Glentoran,3409,7,6,6,10,24,32,-8,24
Dungannon,3409,8,2,4,16,14,47,-33,10
Crusaders,3410,1,17,6,3,66,31,35,57
Coleraine,3410,2,15,10,1,46,22,24,55
Glenavon,3410,3,9,9,8,52,46,6,36
Linfield,3410,4,10,6,10,38,37,1,36
Cliftonville,3410,5,9,5,12,33,32,1,32
Ballymena,3410,6,7,4,15,26,52,-26,25
Glentoran,3410,7,6,6,10,24,32,-8,24
Dungannon,3410,8,2,4,16,14,47,-33,10
Crusaders,3411,1,17,6,3,62,30,32,57
Coleraine,3411,2,14,10,2,45,29,16,52
Glenavon,3411,3,10,9,7,59,45,14,39
Linfield,3411,4,11,5,10,39,37,2,38
Cliftonville,3411,5,9,4,13,33,33,0,31
Ballymena,3411,6,7,4,15,25,48,-23,25
Glentoran,3411,7,6,6,10,24,32,-8,24
Dungannon,3411,8,2,4,16,14,47,-33,10
Crusaders,3412,1,16,7,3,62,31,31,55
Coleraine,3412,2,14,11,1,43,22,21,53
Glenavon,3412,3,9,10,7,52,43,9,37
Linfield,3412,4,10,5,11,38,38,0,35
Cliftonville,3412,5,10,4,12,34,32,2,34
Ballymena,3412,6,7,5,14,26,48,-22,26
Glentoran,3412,7,6,6,10,24,32,-8,24
Dungannon,3412,8,2,4,16,14,47,-33,10
Crusaders,3413,1,17,6,3,64,32,32,57
Coleraine,3413,2,14,11,1,45,24,21,53
Glenavon,3413,3,9,10,7,54,45,9,37
Linfield,3413,4,10,6,10,39,38,1,36
Cliftonville,3413,5,9,5,12,34,33,1,32
Ballymena,3413,6,7,4,15,27,50,-23,25
Glentoran,3413,7,6,6,10,24,32,-8,24
Dungannon,3413,8,2,4,16,14,47,-33,10
Crusaders,3414,1,17,6,3,63,31,32,57
Coleraine,3414,2,14,11,1,43,22,21,53
Glenavon,3414,3,9,10,7,52,43,9,37
Linfield,3414,4,10,6,10,39,38,1,36
Cliftonville,3414,5,9,5,12,34,33,1,32
Ballymena,3414,6,7,4,15,26,49,-23,25
Glentoran,3414,7,6,6,10,24,32,-8,24
Dungannon,3414,8,2,4,16,14,47,-33,10
Crusaders,3415,1,17,6,3,65,32,33,57
Coleraine,3415,2,15,10,1,48,24,24,55
Glenavon,3415,3,9,9,8,54,48,6,36
Linfield,3415,4,10,6,10,38,37,1,36
Cliftonville,3415,5,9,5,12,33,32,1,32
Ballymena,3415,6,7,4,15,27,51,-24,25
Glentoran,3415,7,6,6,10,24,32,-8,24
Dungannon,3415,8,2,4,16,14,47,-33,10
Crusaders,3416,1,17,6,3,64,31,33,57
Coleraine,3416,2,14,10,2,43,23,20,52
Glenavon,3416,3,10,9,7,53,43,10,39
Linfield,3416,4,10,5,11,38,39,-1,35
Cliftonville,3416,5,10,4,12,35,32,3,34
Ballymena,3416,6,7,4,15,26,50,-24,25
Glentoran,3416,7,6,6,10,24,32,-8,24
Dungannon,3416,8,2,4,16,14,47,-33,10
Crusaders,3417,1,17,6,3,67,32,35,57
Coleraine,3417,2,14,11,1,44,23,21,53
Glenavon,3417,3,9,10,7,53,44,9,37
Linfield,3417,4,10,6,10,39,38,1,36
Cliftonville,3417,5,9,5,12,34,33,1,32
Ballymena,3417,6,7,4,15,27,53,-26,25
Glentoran,3417,7,6,6,10,24,32,-8,24
Dungannon,3417,8,2,4,16,14,47,-33,10
Crusaders,3418,1,17,6,3,62,30,32,57
Coleraine,3418,2,15,10,1,45,22,23,55
Glenavon,3418,3,9,9,8,52,45,7,36
Linfield,3418,4,10,5,11,37,38,-1,35
Cliftonville,3418,5,10,4,12,34,31,3,34
Ballymena,3418,6,7,4,15,25,48,-23,25
Glentoran,3418,7,6,6,10,24,32,-8,24
Dungannon,3418,8,2,4,16,14,47,-33,10
Crusaders,3419,1,16,7,3,64,33,31,55
Coleraine,3419,2,14,10,2,45,25,20,52
Glenavon,3419,3,10,9,7,55,45,10,39
Linfield,3419,4,10,6,10,37,36,1,36
Cliftonville,3419,5,9,5,12,32,31,1,32
Ballymena,3419,6,7,5,14,28,50,-22,26
Glentoran,3419,7,6,6,10,24,32,-8,24
Dungannon,3419,8,2,4,16,14,47,-33,10
Crusaders,3420,1,16,7,3,61,30,31,55
Coleraine,3420,2,14,10,2,46,27,19,52
Glenavon,3420,3,10,9,7,57,46,11,39
Linfield,3420,4,11,5,10,40,36,4,38
Cliftonville,3420,5,9,4,13,32,34,-2,31
Ballymena,3420,6,7,5,14,25,47,-22,26
Glentoran,3420,7,6,6,10,24,32,-8,24
Dungannon,3420,8,2,4,16,14,47,-33,10
Crusaders,3421,1,17,6,3,62,30,32,57
Coleraine,3421,2,14,10,2,44,26,18,52
Glenavon,3421,3,10,9,7,56,44,12,39
Linfield,3421,4,10,5,11,37,37,0,35
Cliftonville,3421,5,10,4,12,33,31,2,34
Ballymena,3421,6,7,4,15,25,48,-23,25
Glentoran,3421,7,6,6,10,24,32,-8,24
Dungannon,3421,8,2,4,16,14,47,-33,10
Crusaders,3422,1,17,6,3,63,30,33,57
Coleraine,3422,2,14,11,1,44,23,21,53
Linfield,3422,3,11,5,10,38,36,2,38
Glenavon,3422,4,9,10,7,53,44,9,37
Cliftonville,3422,5,9,4,13,32,32,0,31
Ballymena,3422,6,7,4,15,25,49,-24,25
Glentoran,3422,7,6,6,10,24,32,-8,24
Dungannon,3422,8,2,4,16,14,47,-33,10
Crusaders,3423,1,17,6,3,63,31,32,57
Coleraine,3423,2,14,10,2,44,29,15,52
Glenavon,3423,3,10,9,7,59,44,15,39
Linfield,3423,4,11,5,10,41,38,3,38
Cliftonville,3423,5,9,4,13,34,35,-1,31
Ballymena,3423,6,7,4,15,26,49,-23,25
Glentoran,3423,7,6,6,10,24,32,-8,24
Dungannon,3423,8,2,4,16,14,47,-33,10
Crusaders,3424,1,16,7,3,61,30,31,55
Coleraine,3424,2,14,11,1,46,25,21,53
Linfield,3424,3,11,5,10,39,36,3,38
Glenavon,3424,4,9,10,7,55,46,9,37
Cliftonville,3424,5,9,4,13,32,33,-1,31
Ballymena,3424,6,7,5,14,25,47,-22,26
Glentoran,3424,7,6,6,10,24,32,-8,24
Dungannon,3424,8,2,4,16,14,47,-33,10
Crusaders,3425,1,17,6,3,63,30,33,57
Coleraine,3425,2,14,10,2,43,23,20,52
Glenavon,3425,3,10,9,7,53,43,10,39
Linfield,3425,4,11,5,10,38,36,2,38
Cliftonville,3425,5,9,4,13,32,32,0,31
Ballymena,3425,6,7,4,15,25,49,-24,25
Glentoran,3425,7,6,6,10,24,32,-8,24
Dungannon,3425,8,2,4,16,14,47,-33,10
Crusaders,3426,1,16,7,3,64,33,31,55
Coleraine,3426,2,14,10,2,44,26,18,52
Glenavon,3426,3,10,9,7,56,44,12,39
Linfield,3426,4,11,5,10,38,36,2,38
Cliftonville,3426,5,9,4,13,32,32,0,31
Ballymena,3426,6,7,5,14,28,50,-22,26
Glentoran,3426,7,6,6,10,24,32,-8,24
Dungannon,3426,8,2,4,16,14,47,-33,10
Crusaders,3427,1,16,7,3,62,31,31,55
Coleraine,3427,2,14,10,2,43,23,20,52
Glenavon,3427,3,10,9,7,53,43,10,39
Linfield,3427,4,11,5,10,39,36,3,38
Cliftonville,3427,5,9,4,13,32,33,-1,31
Ballymena,3427,6,7,5,14,26,48,-22,26
Glentoran,3427,7,6,6,10,24,32,-8,24
Dungannon,3427,8,2,4,16,14,47,-33,10
Crusaders,3428,1,16,7,3,63,32,31,55
Coleraine,3428,2,14,11,1,44,23,21,53
Linfield,3428,3,11,5,10,38,36,2,38
Glenavon,3428,4,9,10,7,53,44,9,37
Cliftonville,3428,5,9,4,13,32,32,0,31
Ballymena,3428,6,7,5,14,27,49,-22,26
Glentoran,3428,7,6,6,10,24,32,-8,24
Dungannon,3428,8,2,4,16,14,47,-33,10
Crusaders,3429,1,17,6,3,64,31,33,57
Coleraine,3429,2,14,10,2,43,24,19,52
Glenavon,3429,3,10,9,7,54,43,11,39
Linfield,3429,4,10,5,11,37,37,0,35
Cliftonville,3429,5,10,4,12,33,31,2,34
Ballymena,3429,6,7,4,15,26,50,-24,25
Glentoran,3429,7,6,6,10,24,32,-8,24
Dungannon,3429,8,2,4,16,14,47,-33,10
Crusaders,3430,1,17,6,3,64,30,34,57
Coleraine,3430,2,15,10,1,46,24,22,55
Glenavon,3430,3,9,9,8,54,46,8,36
Linfield,3430,4,10,5,11,37,39,-2,35
Cliftonville,3430,5,10,4,12,35,31,4,34
Ballymena,3430,6,7,4,15,25,50,-25,25
Glentoran,3430,7,6,6,10,24,32,-8,24
Dungannon,3430,8,2,4,16,14,47,-33,10
Crusaders,3431,1,16,7,3,62,31,31,55
Coleraine,3431,2,14,11,1,45,24,21,53
Linfield,3431,3,11,5,10,39,36,3,38
Glenavon,3431,4,9,10,7,54,45,9,37
Cliftonville,3431,5,9,4,13,32,33,-1,31
Ballymena,3431,6,7,5,14,26,48,-22,26
Glentoran,3431,7,6,6,10,24,32,-8,24
Dungannon,3431,8,2,4,16,14,47,-33,10
Crusaders,3432,1,17,6,3,64,30,34,57
Coleraine,3432,2,14,10,2,43,26,17,52
Glenavon,3432,3,10,9,7,56,43,13,39
Linfield,3432,4,10,5,11,39,39,0,35
Cliftonville,3432,5,10,4,12,35,33,2,34
Ballymena,3432,6,7,4,15,25,50,-25,25
Glentoran,3432,7,6,6,10,24,32,-8,24
Dungannon,3432,8,2,4,16,14,47,-33,10
Coleraine,3433,1,15,10,1,45,23,22,55
Crusaders,3433,2,16,6,4,65,36,29,54
Glenavon,3433,3,9,9,8,53,45,8,36
Linfield,3433,4,10,6,10,39,38,1,36
Cliftonville,3433,5,9,5,12,34,33,1,32
Ballymena,3433,6,8,4,14,31,51,-20,28
Glentoran,3433,7,6,6,10,24,32,-8,24
Dungannon,3433,8,2,4,16,14,47,-33,10
Crusaders,3434,1,16,6,4,62,32,30,54
Coleraine,3434,2,14,10,2,43,25,18,52
Glenavon,3434,3,10,9,7,55,43,12,39
Linfield,3434,4,11,5,10,40,37,3,38
Cliftonville,3434,5,9,4,13,33,34,-1,31
Ballymena,3434,6,8,4,14,27,48,-21,28
Glentoran,3434,7,6,6,10,24,32,-8,24
Dungannon,3434,8,2,4,16,14,47,-33,10
Crusaders,3435,1,16,6,4,61,32,29,54
Coleraine,3435,2,14,11,1,44,23,21,53
Glenavon,3435,3,9,10,7,53,44,9,37
Linfield,3435,4,10,6,10,39,38,1,36
Cliftonville,3435,5,9,5,12,34,33,1,32
Ballymena,3435,6,8,4,14,27,47,-20,28
Glentoran,3435,7,6,6,10,24,32,-8,24
Dungannon,3435,8,2,4,16,14,47,-33,10
Crusaders,3436,1,17,6,3,64,31,33,57
Coleraine,3436,2,14,10,2,44,28,16,52
Glenavon,3436,3,10,9,7,58,44,14,39
Linfield,3436,4,10,5,11,37,37,0,35
Cliftonville,3436,5,10,4,12,33,31,2,34
Ballymena,3436,6,7,4,15,26,50,-24,25
Glentoran,3436,7,6,6,10,24,32,-8,24
Dungannon,3436,8,2,4,16,14,47,-33,10
Crusaders,3437,1,16,7,3,62,31,31,55
Coleraine,3437,2,14,10,2,44,25,19,52
Glenavon,3437,3,10,9,7,55,44,11,39
Linfield,3437,4,11,5,10,39,37,2,38
Cliftonville,3437,5,9,4,13,33,33,0,31
Ballymena,3437,6,7,5,14,26,48,-22,26
Glentoran,3437,7,6,6,10,24,32,-8,24
Dungannon,3437,8,2,4,16,14,47,-33,10
Crusaders,3438,1,17,6,3,63,30,33,57
Coleraine,3438,2,14,10,2,44,25,19,52
Glenavon,3438,3,10,9,7,55,44,11,39
Linfield,3438,4,10,5,11,37,37,0,35
Cliftonville,3438,5,10,4,12,33,31,2,34
Ballymena,3438,6,7,4,15,25,49,-24,25
Glentoran,3438,7,6,6,10,24,32,-8,24
Dungannon,3438,8,2,4,16,14,47,-33,10
Crusaders,3439,1,16,6,4,62,32,30,54
Coleraine,3439,2,14,10,2,43,24,19,52
Glenavon,3439,3,10,9,7,54,43,11,39
Linfield,3439,4,11,5,10,38,36,2,38
Cliftonville,3439,5,9,4,13,32,32,0,31
Ballymena,3439,6,8,4,14,27,48,-21,28
Glentoran,3439,7,6,6,10,24,32,-8,24
Dungannon,3439,8,2,4,16,14,47,-33,10
Crusaders,3440,1,16,7,3,63,32,31,55
Coleraine,3440,2,14,10,2,45,25,20,52
Glenavon,3440,3,10,9,7,55,45,10,39
Linfield,3440,4,11,5,10,40,36,4,38
Cliftonville,3440,5,9,4,13,32,34,-2,31
Ballymena,3440,6,7,5,14,27,49,-22,26
Glentoran,3440,7,6,6,10,24,32,-8,24
Dungannon,3440,8,2,4,16,14,47,-33,10
Crusaders,3441,1,17,6,3,63,31,32,57
Coleraine,3441,2,14,11,1,44,23,21,53
Glenavon,3441,3,9,10,7,53,44,9,37
Linfield,3441,4,10,5,11,37,38,-1,35
Cliftonville,3441,5,10,4,12,34,31,3,34
Ballymena,3441,6,7,4,15,26,49,-23,25
Glentoran,3441,7,6,6,10,24,32,-8,24
Dungannon,3441,8,2,4,16,14,47,-33,10
Crusaders,3442,1,17,6,3,62,30,32,57
Coleraine,3442,2,14,10,2,43,24,19,52
Glenavon,3442,3,10,9,7,54,43,11,39
Linfield,3442,4,10,5,11,38,39,-1,35
Cliftonville,3442,5,10,4,12,35,32,3,34
Ballymena,3442,6,7,4,15,25,48,-23,25
Glentoran,3442,7,6,6,10,24,32,-8,24
Dungannon,3442,8,2,4,16,14,47,-33,10
Crusaders,3443,1,17,6,3,66,32,34,57
Coleraine,3443,2,14,10,2,45,27,18,52
Glenavon,3443,3,10,9,7,57,45,12,39
Linfield,3443,4,10,6,10,37,36,1,36
Cliftonville,3443,5,9,5,12,32,31,1,32
Ballymena,3443,6,7,4,15,27,52,-25,25
Glentoran,3443,7,6,6,10,24,32,-8,24
Dungannon,3443,8,2,4,16,14,47,-33,10
Crusaders,3444,1,16,7,3,61,30,31,55
Coleraine,3444,2,14,11,1,44,23,21,53
Glenavon,3444,3,9,10,7,53,44,9,37
Linfield,3444,4,10,5,11,37,38,-1,35
Cliftonville,3444,5,10,4,12,34,31,3,34
Ballymena,3444,6,7,5,14,25,47,-22,26
Glentoran,3444,7,6,6,10,24,32,-8,24
Dungannon,3444,8,2,4,16,14,47,-33,10
Crusaders,3445,1,16,7,3,62,31,31,55
Coleraine,3445,2,14,10,2,44,24,20,52
Glenavon,3445,3,10,9,7,54,44,10,39
Linfield,3445,4,10,5,11,38,38,0,35
Cliftonville,3445,5,10,4,12,34,32,2,34
Ballymena,3445,6,7,5,14,26,48,-22,26
Glentoran,3445,7,6,6,10,24,32,-8,24
Dungannon,3445,8,2,4,16,14,47,-33,10
Coleraine,3446,1,15,10,1,45,23,22,55
Crusaders,3446,2,16,6,4,63,34,29,54
Glenavon,3446,3,9,9,8,53,45,8,36
Linfield,3446,4,10,6,10,38,37,1,36
Cliftonville,3446,5,9,5,12,33,32,1,32
Ballymena,3446,6,8,4,14,29,49,-20,28
Glentoran,3446,7,6,6,10,24,32,-8,24
Dungannon,3446,8,2,4,16,14,47,-33,10
Crusaders,3447,1,16,7,3,62,31,31,55
Coleraine,3447,2,15,10,1,45,22,23,55
Glenavon,3447,3,9,9,8,52,45,7,36
Linfield,3447,4,10,5,11,38,38,0,35
Cliftonville,3447,5,10,4,12,34,32,2,34
Ballymena,3447,6,7,5,14,26,48,-22,26
Glentoran,3447,7,6,6,10,24,32,-8,24
Dungannon,3447,8,2,4,16,14,47,-33,10
Crusaders,3448,1,17,6,3,63,31,32,57
Coleraine,3448,2,14,10,2,43,24,19,52
Glenavon,3448,3,10,9,7,54,43,11,39
Linfield,3448,4,11,5,10,40,36,4,38
Cliftonville,3448,5,9,4,13,32,34,-2,31
Ballymena,3448,6,7,4,15,26,49,-23,25
Glentoran,3448,7,6,6,10,24,32,-8,24
Dungannon,3448,8,2,4,16,14,47,-33,10
Crusaders,3449,1,16,7,3,62,31,31,55
Coleraine,3449,2,14,10,2,44,24,20,52
Glenavon,3449,3,10,9,7,54,44,10,39
Linfield,3449,4,10,5,11,37,37,0,35
Cliftonville,3449,5,10,4,12,33,31,2,34
Ballymena,3449,6,7,5,14,26,48,-22,26
Glentoran,3449,7,6,6,10,24,32,-8,24
Dungannon,3449,8,2,4,16,14,47,-33,10
Crusaders,3450,1,16,7,3,62,31,31,55
Coleraine,3450,2,15,10,1,45,23,22,55
Linfield,3450,3,11,5,10,38,36,2,38
Glenavon,3450,4,9,9,8,53,45,8,36
Cliftonville,3450,5,9,4,13,32,32,0,31
Ballymena,3450,6,7,5,14,26,48,-22,26
Glentoran,3450,7,6,6,10,24,32,-8,24
Dungannon,3450,8,2,4,16,14,47,-33,10
Crusaders,3451,1,17,6,3,67,30,37,57
Coleraine,3451,2,14,10,2,44,24,20,52
Glenavon,3451,3,10,9,7,54,44,10,39
Linfield,3451,4,10,5,11,37,37,0,35
Cliftonville,3451,5,10,4,12,33,31,2,34
Ballymena,3451,6,7,4,15,25,53,-28,25
Glentoran,3451,7,6,6,10,24,32,-8,24
Dungannon,3451,8,2,4,16,14,47,-33,10
Crusaders,3452,1,17,6,3,65,33,32,57
Coleraine,3452,2,15,10,1,44,22,22,55
Glenavon,3452,3,9,9,8,52,44,8,36
Linfield,3452,4,10,5,11,38,38,0,35
Cliftonville,3452,5,10,4,12,34,32,2,34
Ballymena,3452,6,7,4,15,28,51,-23,25
Glentoran,3452,7,6,6,10,24,32,-8,24
Dungannon,3452,8,2,4,16,14,47,-33,10
Crusaders,3453,1,17,6,3,64,32,32,57
Coleraine,3453,2,14,10,2,44,24,20,52
Glenavon,3453,3,10,9,7,54,44,10,39
Linfield,3453,4,11,5,10,39,36,3,38
Cliftonville,3453,5,9,4,13,32,33,-1,31
Ballymena,3453,6,7,4,15,27,50,-23,25
Glentoran,3453,7,6,6,10,24,32,-8,24
Dungannon,3453,8,2,4,16,14,47,-33,10
Crusaders,3454,1,17,6,3,64,31,33,57
Coleraine,3454,2,14,10,2,43,25,18,52
Glenavon,3454,3,10,9,7,55,43,12,39
Linfield,3454,4,10,6,10,37,36,1,36
Cliftonville,3454,5,9,5,12,32,31,1,32
Ballymena,3454,6,7,4,15,26,50,-24,25
Glentoran,3454,7,6,6,10,24,32,-8,24
Dungannon,3454,8,2,4,16,14,47,-33,10
Crusaders,3455,1,16,7,3,62,31,31,55
Coleraine,3455,2,14,10,2,43,23,20,52
Glenavon,3455,3,10,9,7,53,43,10,39
Linfield,3455,4,11,5,10,38,36,2,38
Cliftonville,3455,5,9,4,13,32,32,0,31
Ballymena,3455,6,7,5,14,26,48,-22,26
Glentoran,3455,7,6,6,10,24,32,-8,24
Dungannon,3455,8,2,4,16,14,47,-33,10
Crusaders,3456,1,16,7,3,61,30,31,55
Coleraine,3456,2,14,11,1,46,25,21,53
Glenavon,3456,3,9,10,7,55,46,9,37
Linfield,3456,4,10,6,10,38,37,1,36
Cliftonville,3456,5,9,5,12,33,32,1,32
Ballymena,3456,6,7,5,14,25,47,-22,26
Glentoran,3456,7,6,6,10,24,32,-8,24
Dungannon,3456,8,2,4,16,14,47,-33,10
Crusaders,3457,1,16,6,4,62,32,30,54
Coleraine,3457,2,14,10,2,45,27,18,52
Glenavon,3457,3,10,9,7,57,45,12,39
Linfield,3457,4,11,5,10,38,36,2,38
Cliftonville,3457,5,9,4,13,32,32,0,31
Ballymena,3457,6,8,4,14,27,48,-21,28
Glentoran,3457,7,6,6,10,24,32,-8,24
Dungannon,3457,8,2,4,16,14,47,-33,10
Crusaders,3458,1,16,7,3,63,32,31,55
Coleraine,3458,2,14,10,2,44,25,19,52
Glenavon,3458,3,10,9,7,55,44,11,39
Linfield,3458,4,10,5,11,37,40,-3,35
Cliftonville,3458,5,10,4,12,36,31,5,34
Ballymena,3458,6,7,5,14,27,49,-22,26
Glentoran,3458,7,6,6,10,24,32,-8,24
Dungannon,3458,8,2,4,16,14,47,-33,10
Crusaders,3459,1,16,7,3,62,31,31,55
Coleraine,3459,2,14,10,2,43,25,18,52
Glenavon,3459,3,10,9,7,55,43,12,39
Linfield,3459,4,11,5,10,41,38,3,38
Cliftonville,3459,5,9,4,13,34,35,-1,31
Ballymena,3459,6,7,5,14,26,48,-22,26
Glentoran,3459,7,6,6,10,24,32,-8,24
Dungannon,3459,8,2,4,16,14,47,-33,10
Crusaders,3460,1,17,6,3,62,30,32,57
Coleraine,3460,2,14,10,2,43,24,19,52
Glenavon,3460,3,10,9,7,54,43,11,39
Linfield,3460,4,11,5,10,40,36,4,38
Cliftonville,3460,5,9,4,13,32,34,-2,31
Ballymena,3460,6,7,4,15,25,48,-23,25
Glentoran,3460,7,6,6,10,24,32,-8,24
Dungannon,3460,8,2,4,16,14,47,-33,10
Crusaders,3461,1,17,6,3,63,31,32,57
Coleraine,3461,2,14,11,1,43,22,21,53
Linfield,3461,3,11,5,10,40,37,3,38
Glenavon,3461,4,9,10,7,52,43,9,37
Cliftonville,3461,5,9,4,13,33,34,-1,31
Ballymena,3461,6,7,4,15,26,49,-23,25
Glentoran,3461,7,6,6,10,24,32,-8,24
Dungannon,3461,8,2,4,16,14,47,-33,10
Crusaders,3462,1,16,7,3,62,31,31,55
Coleraine,3462,2,14,11,1,43,22,21,53
Linfield,3462,3,11,5,10,39,36,3,38
Glenavon,3462,4,9,10,7,52,43,9,37
Cliftonville,3462,5,9,4,13,32,33,-1,31
Ballymena,3462,6,7,5,14,26,48,-22,26
Glentoran,3462,7,6,6,10,24,32,-8,24
Dungannon,3462,8,2,4,16,14,47,-33,10
Crusaders,3463,1,16,7,3,63,32,31,55
Coleraine,3463,2,15,10,1,45,23,22,55
Glenavon,3463,3,9,9,8,53,45,8,36
Linfield,3463,4,10,6,10,38,37,1,36
Cliftonville,3463,5,9,5,12,33,32,1,32
Ballymena,3463,6,7,5,14,27,49,-22,26
Glentoran,3463,7,6,6,10,24,32,-8,24
Dungannon,3463,8,2,4,16,14,47,-33,10
Crusaders,3464,1,17,6,3,64,31,33,57
Coleraine,3464,2,15,10,1,46,23,23,55
Glenavon,3464,3,9,9,8,53,46,7,36
Linfield,3464,4,10,5,11,39,39,0,35
Cliftonville,3464,5,10,4,12,35,33,2,34
Ballymena,3464,6,7,4,15,26,50,-24,25
Glentoran,3464,7,6,6,10,24,32,-8,24
Dungannon,3464,8,2,4,16,14,47,-33,10
Crusaders,3465,1,16,6,4,61,31,30,54
Coleraine,3465,2,14,11,1,44,23,21,53
Glenavon,3465,3,9,10,7,53,44,9,37
Linfield,3465,4,10,5,11,38,39,-1,35
Cliftonville,3465,5,10,4,12,35,32,3,34
Ballymena,3465,6,8,4,14,26,47,-21,28
Glentoran,3465,7,6,6,10,24,32,-8,24
Dungannon,3465,8,2,4,16,14,47,-33,10
Coleraine,3466,1,15,10,1,47,22,25,55
Crusaders,3466,2,16,6,4,61,32,29,54
Glenavon,3466,3,9,9,8,52,47,5,36
Linfield,3466,4,10,5,11,37,38,-1,35
Cliftonville,3466,5,10,4,12,34,31,3,34
Ballymena,3466,6,8,4,14,27,47,-20,28
Glentoran,3466,7,6,6,10,24,32,-8,24
Dungannon,3466,8,2,4,16,14,47,-33,10
Crusaders,3467,1,17,6,3,65,31,34,57
Coleraine,3467,2,15,10,1,45,23,22,55
Linfield,3467,3,11,5,10,39,36,3,38
Glenavon,3467,4,9,9,8,53,45,8,36
Cliftonville,3467,5,9,4,13,32,33,-1,31
Ballymena,3467,6,7,4,15,26,51,-25,25
Glentoran,3467,7,6,6,10,24,32,-8,24
Dungannon,3467,8,2,4,16,14,47,-33,10
Crusaders,3468,1,17,6,3,65,32,33,57
Coleraine,3468,2,15,10,1,44,22,22,55
Glenavon,3468,3,9,9,8,52,44,8,36
Linfield,3468,4,10,5,11,37,37,0,35
Cliftonville,3468,5,10,4,12,33,31,2,34
Ballymena,3468,6,7,4,15,27,51,-24,25
Glentoran,3468,7,6,6,10,24,32,-8,24
Dungannon,3468,8,2,4,16,14,47,-33,10
Crusaders,3469,1,17,6,3,63,30,33,57
Coleraine,3469,2,14,11,1,44,23,21,53
Glenavon,3469,3,9,10,7,53,44,9,37
Linfield,3469,4,10,5,11,38,39,-1,35
Cliftonville,3469,5,10,4,12,35,32,3,34
Ballymena,3469,6,7,4,15,25,49,-24,25
Glentoran,3469,7,6,6,10,24,32,-8,24
Dungannon,3469,8,2,4,16,14,47,-33,10
Crusaders,3470,1,16,7,3,63,32,31,55
Coleraine,3470,2,14,10,2,44,24,20,52
Glenavon,3470,3,10,9,7,54,44,10,39
Linfield,3470,4,10,5,11,37,37,0,35
Cliftonville,3470,5,10,4,12,33,31,2,34
Ballymena,3470,6,7,5,14,27,49,-22,26
Glentoran,3470,7,6,6,10,24,32,-8,24
Dungannon,3470,8,2,4,16,14,47,-33,10
Crusaders,3471,1,16,6,4,61,31,30,54
Coleraine,3471,2,14,11,1,46,25,21,53
Glenavon,3471,3,9,10,7,55,46,9,37
Linfield,3471,4,10,5,11,38,38,0,35
Cliftonville,3471,5,10,4,12,34,32,2,34
Ballymena,3471,6,8,4,14,26,47,-21,28
Glentoran,3471,7,6,6,10,24,32,-8,24
Dungannon,3471,8,2,4,16,14,47,-33,10
Crusaders,3472,1,16,6,4,64,36,28,54
Coleraine,3472,2,14,10,2,43,23,20,52
Glenavon,3472,3,10,9,7,53,43,10,39
Linfield,3472,4,11,5,10,39,37,2,38
Cliftonville,3472,5,9,4,13,33,33,0,31
Ballymena,3472,6,8,4,14,31,50,-19,28
Glentoran,3472,7,6,6,10,24,32,-8,24
Dungannon,3472,8,2,4,16,14,47,-33,10
Coleraine,3473,1,15,10,1,46,23,23,55
Crusaders,3473,2,16,6,4,62,32,30,54
Glenavon,3473,3,9,9,8,53,46,7,36
Linfield,3473,4,10,6,10,38,37,1,36
Cliftonville,3473,5,9,5,12,33,32,1,32
Ballymena,3473,6,8,4,14,27,48,-21,28
Glentoran,3473,7,6,6,10,24,32,-8,24
Dungannon,3473,8,2,4,16,14,47,-33,10
Crusaders,3474,1,17,6,3,63,31,32,57
Coleraine,3474,2,14,10,2,45,26,19,52
Glenavon,3474,3,10,9,7,56,45,11,39
Linfield,3474,4,10,5,11,37,38,-1,35
Cliftonville,3474,5,10,4,12,34,31,3,34
Ballymena,3474,6,7,4,15,26,49,-23,25
Glentoran,3474,7,6,6,10,24,32,-8,24
Dungannon,3474,8,2,4,16,14,47,-33,10
Crusaders,3475,1,17,6,3,63,30,33,57
Coleraine,3475,2,14,10,2,44,24,20,52
Glenavon,3475,3,10,9,7,54,44,10,39
Linfield,3475,4,11,5,10,40,36,4,38
Cliftonville,3475,5,9,4,13,32,34,-2,31
Ballymena,3475,6,7,4,15,25,49,-24,25
Glentoran,3475,7,6,6,10,24,32,-8,24
Dungannon,3475,8,2,4,16,14,47,-33,10
Crusaders,3476,1,17,6,3,63,31,32,57
Coleraine,3476,2,14,10,2,44,24,20,52
Glenavon,3476,3,10,9,7,54,44,10,39
Linfield,3476,4,11,5,10,39,37,2,38
Cliftonville,3476,5,9,4,13,33,33,0,31
Ballymena,3476,6,7,4,15,26,49,-23,25
Glentoran,3476,7,6,6,10,24,32,-8,24
Dungannon,3476,8,2,4,16,14,47,-33,10
Coleraine,3477,1,15,10,1,46,23,23,55
Crusaders,3477,2,16,6,4,62,32,30,54
Linfield,3477,3,11,5,10,40,36,4,38
Glenavon,3477,4,9,9,8,53,46,7,36
Cliftonville,3477,5,9,4,13,32,34,-2,31
Ballymena,3477,6,8,4,14,27,48,-21,28
Glentoran,3477,7,6,6,10,24,32,-8,24
Dungannon,3477,8,2,4,16,14,47,-33,10
Crusaders,3478,1,16,7,3,63,32,31,55
Coleraine,3478,2,14,10,2,43,24,19,52
Glenavon,3478,3,10,9,7,54,43,11,39
Linfield,3478,4,11,5,10,39,36,3,38
Cliftonville,3478,5,9,4,13,32,33,-1,31
Ballymena,3478,6,7,5,14,27,49,-22,26
Glentoran,3478,7,6,6,10,24,32,-8,24
Dungannon,3478,8,2,4,16,14,47,-33,10
Crusaders,3479,1,16,7,3,63,32,31,55
Coleraine,3479,2,15,10,1,44,22,22,55
Glenavon,3479,3,9,9,8,52,44,8,36
Linfield,3479,4,10,5,11,37,39,-2,35
Cliftonville,3479,5,10,4,12,35,31,4,34
Ballymena,3479,6,7,5,14,27,49,-22,26
Glentoran,3479,7,6,6,10,24,32,-8,24
Dungannon,3479,8,2,4,16,14,47,-33,10
Crusaders,3480,1,17,6,3,63,30,33,57
Coleraine,3480,2,14,11,1,44,23,21,53
Glenavon,3480,3,9,10,7,53,44,9,37
Linfield,3480,4,10,6,10,37,36,1,36
Cliftonville,3480,5,9,5,12,32,31,1,32
Ballymena,3480,6,7,4,15,25,49,-24,25
Glentoran,3480,7,6,6,10,24,32,-8,24
Dungannon,3480,8,2,4,16,14,47,-33,10
Crusaders,3481,1,17,6,3,62,30,32,57
Coleraine,3481,2,14,11,1,45,24,21,53
Glenavon,3481,3,9,10,7,54,45,9,37
Linfield,3481,4,10,5,11,38,39,-1,35
Cliftonville,3481,5,10,4,12,35,32,3,34
Ballymena,3481,6,7,4,15,25,48,-23,25
Glentoran,3481,7,6,6,10,24,32,-8,24
Dungannon,3481,8,2,4,16,14,47,-33,10
Crusaders,3482,1,16,6,4,61,32,29,54
Coleraine,3482,2,14,11,1,44,23,21,53
Glenavon,3482,3,9,10,7,53,44,9,37
Linfield,3482,4,10,5,11,38,38,0,35
Cliftonville,3482,5,10,4,12,34,32,2,34
Ballymena,3482,6,8,4,14,27,47,-20,28
Glentoran,3482,7,6,6,10,24,32,-8,24
Dungannon,3482,8,2,4,16,14,47,-33,10
Crusaders,3483,1,17,6,3,63,31,32,57
Coleraine,3483,2,14,10,2,44,27,17,52
Glenavon,3483,3,10,9,7,57,44,13,39
Linfield,3483,4,11,5,10,39,37,2,38
Cliftonville,3483,5,9,4,13,33,33,0,31
Ballymena,3483,6,7,4,15,26,49,-23,25
Glentoran,3483,7,6,6,10,24,32,-8,24
Dungannon,3483,8,2,4,16,14,47,-33,10
Crusaders,3484,1,17,6,3,65,31,34,57
Coleraine,3484,2,14,11,1,44,23,21,53
Linfield,3484,3,11,5,10,40,36,4,38
Glenavon,3484,4,9,10,7,53,44,9,37
Cliftonville,3484,5,9,4,13,32,34,-2,31
Ballymena,3484,6,7,4,15,26,51,-25,25
Glentoran,3484,7,6,6,10,24,32,-8,24
Dungannon,3484,8,2,4,16,14,47,-33,10
Crusaders,3485,1,16,7,3,62,31,31,55
Coleraine,3485,2,14,10,2,45,25,20,52
Glenavon,3485,3,10,9,7,55,45,10,39
Linfield,3485,4,10,5,11,39,40,-1,35
Cliftonville,3485,5,10,4,12,36,33,3,34
Ballymena,3485,6,7,5,14,26,48,-22,26
Glentoran,3485,7,6,6,10,24,32,-8,24
Dungannon,3485,8,2,4,16,14,47,-33,10
Crusaders,3486,1,16,7,3,63,32,31,55
Coleraine,3486,2,14,10,2,45,27,18,52
Glenavon,3486,3,10,9,7,57,45,12,39
Linfield,3486,4,11,5,10,40,37,3,38
Cliftonville,3486,5,9,4,13,33,34,-1,31
Ballymena,3486,6,7,5,14,27,49,-22,26
Glentoran,3486,7,6,6,10,24,32,-8,24
Dungannon,3486,8,2,4,16,14,47,-33,10
Crusaders,3487,1,17,6,3,63,31,32,57
Coleraine,3487,2,14,10,2,44,25,19,52
Glenavon,3487,3,10,9,7,55,44,11,39
Linfield,3487,4,10,6,10,39,38,1,36
Cliftonville,3487,5,9,5,12,34,33,1,32
Ballymena,3487,6,7,4,15,26,49,-23,25
Glentoran,3487,7,6,6,10,24,32,-8,24
Dungannon,3487,8,2,4,16,14,47,-33,10
Crusaders,3488,1,17,6,3,64,31,33,57
Coleraine,3488,2,15,10,1,45,23,22,55
Linfield,3488,3,11,5,10,38,36,2,38
Glenavon,3488,4,9,9,8,53,45,8,36
Cliftonville,3488,5,9,4,13,32,32,0,31
Ballymena,3488,6,7,4,15,26,50,-24,25
Glentoran,3488,7,6,6,10,24,32,-8,24
Dungannon,3488,8,2,4,16,14,47,-33,10
Crusaders,3489,1,17,6,3,62,30,32,57
Coleraine,3489,2,15,10,1,45,23,22,55
Linfield,3489,3,11,5,10,38,36,2,38
Glenavon,3489,4,9,9,8,53,45,8,36
Cliftonville,3489,5,9,4,13,32,32,0,31
Ballymena,3489,6,7,4,15,25,48,-23,25
Glentoran,3489,7,6,6,10,24,32,-8,24
Dungannon,3489,8,2,4,16,14,47,-33,10
Crusaders,3490,1,16,6,4,61,32,29,54
Coleraine,3490,2,14,11,1,46,25,21,53
Glenavon,3490,3,9,10,7,55,46,9,37
Linfield,3490,4,10,5,11,37,37,0,35
Cliftonville,3490,5,10,4,12,33,31,2,34
Ballymena,3490,6,8,4,14,27,47,-20,28
Glentoran,3490,7,6,6,10,24,32,-8,24
Dungannon,3490,8,2,4,16,14,47,-33,10
Crusaders,3491,1,16,6,4,61,32,29,54
Coleraine,3491,2,14,10,2,45,25,20,52
Glenavon,3491,3,10,9,7,55,45,10,39
Linfield,3491,4,10,5,11,37,42,-5,35
Cliftonville,3491,5,10,4,12,38,31,7,34
Ballymena,3491,6,8,4,14,27,47,-20,28
Glentoran,3491,7,6,6,10,24,32,-8,24
Dungannon,3491,8,2,4,16,14,47,-33,10
Coleraine,3492,1,15,10,1,46,23,23,55
Crusaders,3492,2,16,6,4,62,32,30,54
Linfield,3492,3,11,5,10,40,37,3,38
Glenavon,3492,4,9,9,8,53,46,7,36
Cliftonville,3492,5,9,4,13,33,34,-1,31
Ballymena,3492,6,8,4,14,27,48,-21,28
Glentoran,3492,7,6,6,10,24,32,-8,24
Dungannon,3492,8,2,4,16,14,47,-33,10
Crusaders,3493,1,17,6,3,64,31,33,57
Coleraine,3493,2,14,11,1,44,23,21,53
Glenavon,3493,3,9,10,7,53,44,9,37
Linfield,3493,4,10,6,10,38,37,1,36
Cliftonville,3493,5,9,5,12,33,32,1,32
Ballymena,3493,6,7,4,15,26,50,-24,25
Glentoran,3493,7,6,6,10,24,32,-8,24
Dungannon,3493,8,2,4,16,14,47,-33,10
Crusaders,3494,1,17,6,3,63,31,32,57
Coleraine,3494,2,14,10,2,44,25,19,52
Glenavon,3494,3,10,9,7,55,44,11,39
Linfield,3494,4,10,5,11,37,38,-1,35
Cliftonville,3494,5,10,4,12,34,31,3,34
Ballymena,3494,6,7,4,15,26,49,-23,25
Glentoran,3494,7,6,6,10,24,32,-8,24
Dungannon,3494,8,2,4,16,14,47,-33,10
Crusaders,3495,1,16,6,4,61,32,29,54
Coleraine,3495,2,14,10,2,44,24,20,52
Glenavon,3495,3,10,9,7,54,44,10,39
Linfield,3495,4,10,6,10,40,39,1,36
Cliftonville,3495,5,9,5,12,35,34,1,32
Ballymena,3495,6,8,4,14,27,47,-20,28
Glentoran,3495,7,6,6,10,24,32,-8,24
Dungannon,3495,8,2,4,16,14,47,-33,10
Crusaders,3496,1,17,6,3,64,32,32,57
Coleraine,3496,2,14,10,2,44,24,20,52
Glenavon,3496,3,10,9,7,54,44,10,39
Linfield,3496,4,11,5,10,40,37,3,38
Cliftonville,3496,5,9,4,13,33,34,-1,31
Ballymena,3496,6,7,4,15,27,50,-23,25
Glentoran,3496,7,6,6,10,24,32,-8,24
Dungannon,3496,8,2,4,16,14,47,-33,10
Crusaders,3497,1,17,6,3,66,31,35,57
Coleraine,3497,2,14,10,2,43,23,20,52
Glenavon,3497,3,10,9,7,53,43,10,39
Linfield,3497,4,10,6,10,37,36,1,36
Cliftonville,3497,5,9,5,12,32,31,1,32
Ballymena,3497,6,7,4,15,26,52,-26,25
Glentoran,3497,7,6,6,10,24,32,-8,24
Dungannon,3497,8,2,4,16,14,47,-33,10
Crusaders,3498,1,17,6,3,64,31,33,57
Coleraine,3498,2,14,10,2,45,25,20,52
Glenavon,3498,3,10,9,7,55,45,10,39
Linfield,3498,4,10,5,11,37,37,0,35
Cliftonville,3498,5,10,4,12,33,31,2,34
Ballymena,3498,6,7,4,15,26,50,-24,25
Glentoran,3498,7,6,6,10,24,32,-8,24
Dungannon,3498,8,2,4,16,14,47,-33,10
Crusaders,3499,1,17,6,3,65,31,34,57
Coleraine,3499,2,14,10,2,43,23,20,52
Glenavon,3499,3,10,9,7,53,43,10,39
Linfield,3499,4,10,5,11,37,39,-2,35
Cliftonville,3499,5,10,4,12,35,31,4,34
Ballymena,3499,6,7,4,15,26,51,-25,25
Glentoran,3499,7,6,6,10,24,32,-8,24
Dungannon,3499,8,2,4,16,14,47,-33,10
Coleraine,3500,1,15,10,1,47,23,24,55
Crusaders,3500,2,16,6,4,61,32,29,54
Linfield,3500,3,11,5,10,38,36,2,38
Glenavon,3500,4,9,9,8,53,47,6,36
Cliftonville,3500,5,9,4,13,32,32,0,31
Ballymena,3500,6,8,4,14,27,47,-20,28
Glentoran,3500,7,6,6,10,24,32,-8,24
Dungannon,3500,8,2,4,16,14,47,-33,10
Crusaders,3501,1,17,6,3,62,30,32,57
Coleraine,3501,2,14,10,2,44,25,19,52
Glenavon,3501,3,10,9,7,55,44,11,39
Linfield,3501,4,10,6,10,38,37,1,36
Cliftonville,3501,5,9,5,12,33,32,1,32
Ballymena,3501,6,7,4,15,25,48,-23,25
Glentoran,3501,7,6,6,10,24,32,-8,24
Dungannon,3501,8,2,4,16,14,47,-33,10
Crusaders,3502,1,16,6,4,62,32,30,54
Coleraine,3502,2,14,10,2,45,25,20,52
Glenavon,3502,3,10,9,7,55,45,10,39
Linfield,3502,4,11,5,10,38,36,2,38
Cliftonville,3502,5,9,4,13,32,32,0,31
Ballymena,3502,6,8,4,14,27,48,-21,28
Glentoran,3502,7,6,6,10,24,32,-8,24
Dungannon,3502,8,2,4,16,14,47,-33,10
Crusaders,3503,1,17,6,3,65,32,33,57
Coleraine,3503,2,14,11,1,43,22,21,53
Linfield,3503,3,11,5,10,40,37,3,38
Glenavon,3503,4,9,10,7,52,43,9,37
Cliftonville,3503,5,9,4,13,33,34,-1,31
Ballymena,3503,6,7,4,15,27,51,-24,25
Glentoran,3503,7,6,6,10,24,32,-8,24
Dungannon,3503,8,2,4,16,14,47,-33,10
Crusaders,3504,1,17,6,3,64,30,34,57
Coleraine,3504,2,14,10,2,45,25,20,52
Glenavon,3504,3,10,9,7,55,45,10,39
Linfield,3504,4,10,5,11,37,38,-1,35
Cliftonville,3504,5,10,4,12,34,31,3,34
Ballymena,3504,6,7,4,15,25,50,-25,25
Glentoran,3504,7,6,6,10,24,32,-8,24
Dungannon,3504,8,2,4,16,14,47,-33,10
Crusaders,3505,1,16,6,4,61,31,30,54
Coleraine,3505,2,14,10,2,44,26,18,52
Glenavon,3505,3,10,9,7,56,44,12,39
Linfield,3505,4,10,5,11,37,37,0,35
Cliftonville,3505,5,10,4,12,33,31,2,34
Ballymena,3505,6,8,4,14,26,47,-21,28
Glentoran,3505,7,6,6,10,24,32,-8,24
Dungannon,3505,8,2,4,16,14,47,-33,10
Crusaders,3506,1,17,6,3,64,30,34,57
Coleraine,3506,2,14,10,2,44,28,16,52
Glenavon,3506,3,10,9,7,58,44,14,39
Linfield,3506,4,11,5,10,38,36,2,38
Cliftonville,3506,5,9,4,13,32,32,0,31
Ballymena,3506,6,7,4,15,25,50,-25,25
Glentoran,3506,7,6,6,10,24,32,-8,24
Dungannon,3506,8,2,4,16,14,47,-33,10
Crusaders,3507,1,16,7,3,63,32,31,55
Coleraine,3507,2,14,10,2,44,26,18,52
Glenavon,3507,3,10,9,7,56,44,12,39
Linfield,3507,4,11,5,10,40,37,3,38
Cliftonville,3507,5,9,4,13,33,34,-1,31
Ballymena,3507,6,7,5,14,27,49,-22,26
Glentoran,3507,7,6,6,10,24,32,-8,24
Dungannon,3507,8,2,4,16,14,47,-33,10
Crusaders,3508,1,16,7,3,63,32,31,55
Coleraine,3508,2,15,10,1,45,22,23,55
Linfield,3508,3,11,5,10,40,36,4,38
Glenavon,3508,4,9,9,8,52,45,7,36
Cliftonville,3508,5,9,4,13,32,34,-2,31
Ballymena,3508,6,7,5,14,27,49,-22,26
Glentoran,3508,7,6,6,10,24,32,-8,24
Dungannon,3508,8,2,4,16,14,47,-33,10
Crusaders,3509,1,16,7,3,62,31,31,55
Coleraine,3509,2,15,10,1,44,22,22,55
Linfield,3509,3,11,5,10,39,37,2,38
Glenavon,3509,4,9,9,8,52,44,8,36
Cliftonville,3509,5,9,4,13,33,33,0,31
Ballymena,3509,6,7,5,14,26,48,-22,26
Glentoran,3509,7,6,6,10,24,32,-8,24
Dungannon,3509,8,2,4,16,14,47,-33,10
Crusaders,3510,1,17,6,3,64,32,32,57
Coleraine,3510,2,15,10,1,48,24,24,55
Glenavon,3510,3,9,9,8,54,48,6,36
Linfield,3510,4,10,5,11,38,38,0,35
Cliftonville,3510,5,10,4,12,34,32,2,34
Ballymena,3510,6,7,4,15,27,50,-23,25
Glentoran,3510,7,6,6,10,24,32,-8,24
Dungannon,3510,8,2,4,16,14,47,-33,10
Crusaders,3511,1,17,6,3,64,31,33,57
Coleraine,3511,2,14,10,2,43,24,19,52
Glenavon,3511,3,10,9,7,54,43,11,39
Linfield,3511,4,10,5,11,37,39,-2,35
Cliftonville,3511,5,10,4,12,35,31,4,34
Ballymena,3511,6,7,4,15,26,50,-24,25
Glentoran,3511,7,6,6,10,24,32,-8,24
Dungannon,3511,8,2,4,16,14,47,-33,10
Crusaders,3512,1,16,7,3,62,31,31,55
Coleraine,3512,2,14,10,2,43,24,19,52
Glenavon,3512,3,10,9,7,54,43,11,39
Linfield,3512,4,10,5,11,38,38,0,35
Cliftonville,3512,5,10,4,12,34,32,2,34
Ballymena,3512,6,7,5,14,26,48,-22,26
Glentoran,3512,7,6,6,10,24,32,-8,24
Dungannon,3512,8,2,4,16,14,47,-33,10
Crusaders,3513,1,16,7,3,63,32,31,55
Coleraine,3513,2,14,10,2,44,24,20,52
Glenavon,3513,3,10,9,7,54,44,10,39
Linfield,3513,4,10,6,10,37,36,1,36
Cliftonville,3513,5,9,5,12,32,31,1,32
Ballymena,3513,6,7,5,14,27,49,-22,26
Glentoran,3513,7,6,6,10,24,32,-8,24
Dungannon,3513,8,2,4,16,14,47,-33,10
Coleraine,3514,1,15,10,1,46,24,22,55
Crusaders,3514,2,16,6,4,61,31,30,54
Glenavon,3514,3,9,9,8,54,46,8,36
Linfield,3514,4,10,6,10,38,37,1,36
Cliftonville,3514,5,9,5,12,33,32,1,32
Ballymena,3514,6,8,4,14,26,47,-21,28
Glentoran,3514,7,6,6,10,24,32,-8,24
Dungannon,3514,8,2,4,16,14,47,-33,10
Crusaders,3515,1,17,6,3,64,31,33,57
Coleraine,3515,2,14,11,1,45,24,21,53
Glenavon,3515,3,9,10,7,54,45,9,37
Linfield,3515,4,10,5,11,37,38,-1,35
Cliftonville,3515,5,10,4,12,34,31,3,34
Ballymena,3515,6,7,4,15,26,50,-24,25
Glentoran,3515,7,6,6,10,24,32,-8,24
Dungannon,3515,8,2,4,16,14,47,-33,10
Crusaders,3516,1,16,6,4,62,34,28,54
Coleraine,3516,2,14,10,2,44,27,17,52
Glenavon,3516,3,10,9,7,57,44,13,39
Linfield,3516,4,11,5,10,39,37,2,38
Cliftonville,3516,5,9,4,13,33,33,0,31
Ballymena,3516,6,8,4,14,29,48,-19,28
Glentoran,3516,7,6,6,10,24,32,-8,24
Dungannon,3516,8,2,4,16,14,47,-33,10
Crusaders,3517,1,16,6,4,62,33,29,54
Coleraine,3517,2,14,10,2,46,26,20,52
Glenavon,3517,3,10,9,7,56,46,10,39
Linfield,3517,4,11,5,10,40,37,3,38
Cliftonville,3517,5,9,4,13,33,34,-1,31
Ballymena,3517,6,8,4,14,28,48,-20,28
Glentoran,3517,7,6,6,10,24,32,-8,24
Dungannon,3517,8,2,4,16,14,47,-33,10
Crusaders,3518,1,17,6,3,63,30,33,57
Coleraine,3518,2,15,10,1,45,23,22,55
Linfield,3518,3,11,5,10,40,37,3,38
Glenavon,3518,4,9,9,8,53,45,8,36
Cliftonville,3518,5,9,4,13,33,34,-1,31
Ballymena,3518,6,7,4,15,25,49,-24,25
Glentoran,3518,7,6,6,10,24,32,-8,24
Dungannon,3518,8,2,4,16,14,47,-33,10
Crusaders,3519,1,17,6,3,62,30,32,57
Coleraine,3519,2,14,10,2,43,25,18,52
Glenavon,3519,3,10,9,7,55,43,12,39
Linfield,3519,4,11,5,10,39,36,3,38
Cliftonville,3519,5,9,4,13,32,33,-1,31
Ballymena,3519,6,7,4,15,25,48,-23,25
Glentoran,3519,7,6,6,10,24,32,-8,24
Dungannon,3519,8,2,4,16,14,47,-33,10
Crusaders,3520,1,16,6,4,61,32,29,54
Coleraine,3520,2,14,10,2,45,25,20,52
Glenavon,3520,3,10,9,7,55,45,10,39
Linfield,3520,4,10,5,11,38,38,0,35
Cliftonville,3520,5,10,4,12,34,32,2,34
Ballymena,3520,6,8,4,14,27,47,-20,28
Glentoran,3520,7,6,6,10,24,32,-8,24
Dungannon,3520,8,2,4,16,14,47,-33,10
Crusaders,3521,1,17,6,3,63,31,32,57
Coleraine,3521,2,14,11,1,45,24,21,53
Glenavon,3521,3,9,10,7,54,45,9,37
Linfield,3521,4,10,6,10,38,37,1,36
Cliftonville,3521,5,9,5,12,33,32,1,32
Ballymena,3521,6,7,4,15,26,49,-23,25
Glentoran,3521,7,6,6,10,24,32,-8,24
Dungannon,3521,8,2,4,16,14,47,-33,10
Crusaders,3522,1,17,6,3,62,30,32,57
Coleraine,3522,2,14,10,2,43,23,20,52
Glenavon,3522,3,10,9,7,53,43,10,39
Linfield,3522,4,10,5,11,38,39,-1,35
Cliftonville,3522,5,10,4,12,35,32,3,34
Ballymena,3522,6,7,4,15,25,48,-23,25
Glentoran,3522,7,6,6,10,24,32,-8,24
Dungannon,3522,8,2,4,16,14,47,-33,10
Crusaders,3523,1,17,6,3,64,31,33,57
Coleraine,3523,2,14,10,2,45,25,20,52
Glenavon,3523,3,10,9,7,55,45,10,39
Linfield,3523,4,11,5,10,38,36,2,38
Cliftonville,3523,5,9,4,13,32,32,0,31
Ballymena,3523,6,7,4,15,26,50,-24,25
Glentoran,3523,7,6,6,10,24,32,-8,24
Dungannon,3523,8,2,4,16,14,47,-33,10
Coleraine,3524,1,15,10,1,45,22,23,55
Crusaders,3524,2,16,6,4,62,32,30,54
Linfield,3524,3,11,5,10,41,36,5,38
Glenavon,3524,4,9,9,8,52,45,7,36
Cliftonville,3524,5,9,4,13,32,35,-3,31
Ballymena,3524,6,8,4,14,27,48,-21,28
Glentoran,3524,7,6,6,10,24,32,-8,24
Dungannon,3524,8,2,4,16,14,47,-33,10
Crusaders,3525,1,16,7,3,62,31,31,55
Coleraine,3525,2,14,11,1,47,26,21,53
Linfield,3525,3,11,5,10,39,36,3,38
Glenavon,3525,4,9,10,7,56,47,9,37
Cliftonville,3525,5,9,4,13,32,33,-1,31
Ballymena,3525,6,7,5,14,26,48,-22,26
Glentoran,3525,7,6,6,10,24,32,-8,24
Dungannon,3525,8,2,4,16,14,47,-33,10
Crusaders,3526,1,17,6,3,63,31,32,57
Coleraine,3526,2,14,10,2,44,25,19,52
Glenavon,3526,3,10,9,7,55,44,11,39
Linfield,3526,4,10,5,11,38,39,-1,35
Cliftonville,3526,5,10,4,12,35,32,3,34
Ballymena,3526,6,7,4,15,26,49,-23,25
Glentoran,3526,7,6,6,10,24,32,-8,24
Dungannon,3526,8,2,4,16,14,47,-33,10
Crusaders,3527,1,17,6,3,62,30,32,57
Coleraine,3527,2,14,10,2,43,25,18,52
Glenavon,3527,3,10,9,7,55,43,12,39
Linfield,3527,4,10,5,11,37,37,0,35
Cliftonville,3527,5,10,4,12,33,31,2,34
Ballymena,3527,6,7,4,15,25,48,-23,25
Glentoran,3527,7,6,6,10,24,32,-8,24
Dungannon,3527,8,2,4,16,14,47,-33,10
Crusaders,3528,1,17,6,3,66,31,35,57
Coleraine,3528,2,14,10,2,45,26,19,52
Glenavon,3528,3,10,9,7,56,45,11,39
Linfield,3528,4,11,5,10,38,36,2,38
Cliftonville,3528,5,9,4,13,32,32,0,31
Ballymena,3528,6,7,4,15,26,52,-26,25
Glentoran,3528,7,6,6,10,24,32,-8,24
Dungannon,3528,8,2,4,16,14,47,-33,10
Crusaders,3529,1,17,6,3,66,31,35,57
Coleraine,3529,2,14,10,2,45,25,20,52
Glenavon,3529,3,10,9,7,55,45,10,39
Linfield,3529,4,10,5,11,38,40,-2,35
Cliftonville,3529,5,10,4,12,36,32,4,34
Ballymena,3529,6,7,4,15,26,52,-26,25
Glentoran,3529,7,6,6,10,24,32,-8,24
Dungannon,3529,8,2,4,16,14,47,-33,10
Crusaders,3530,1,16,7,3,63,32,31,55
Coleraine,3530,2,14,11,1,44,23,21,53
Linfield,3530,3,11,5,10,40,37,3,38
Glenavon,3530,4,9,10,7,53,44,9,37
Cliftonville,3530,5,9,4,13,33,34,-1,31
Ballymena,3530,6,7,5,14,27,49,-22,26
Glentoran,3530,7,6,6,10,24,32,-8,24
Dungannon,3530,8,2,4,16,14,47,-33,10
Crusaders,3531,1,17,6,3,63,31,32,57
Coleraine,3531,2,14,11,1,45,24,21,53
Linfield,3531,3,11,5,10,39,36,3,38
Glenavon,3531,4,9,10,7,54,45,9,37
Cliftonville,3531,5,9,4,13,32,33,-1,31
Ballymena,3531,6,7,4,15,26,49,-23,25
Glentoran,3531,7,6,6,10,24,32,-8,24
Dungannon,3531,8,2,4,16,14,47,-33,10
Crusaders,3532,1,16,6,4,62,33,29,54
Coleraine,3532,2,14,11,1,43,22,21,53
Linfield,3532,3,11,5,10,41,37,4,38
Glenavon,3532,4,9,10,7,52,43,9,37
Cliftonville,3532,5,9,4,13,33,35,-2,31
Ballymena,3532,6,8,4,14,28,48,-20,28
Glentoran,3532,7,6,6,10,24,32,-8,24
Dungannon,3532,8,2,4,16,14,47,-33,10
Crusaders,3533,1,16,7,3,62,31,31,55
Coleraine,3533,2,15,10,1,46,24,22,55
Glenavon,3533,3,9,9,8,54,46,8,36
Linfield,3533,4,10,6,10,40,39,1,36
Cliftonville,3533,5,9,5,12,35,34,1,32
Ballymena,3533,6,7,5,14,26,48,-22,26
Glentoran,3533,7,6,6,10,24,32,-8,24
Dungannon,3533,8,2,4,16,14,47,-33,10
Crusaders,3534,1,16,7,3,62,31,31,55
Coleraine,3534,2,14,10,2,43,23,20,52
Glenavon,3534,3,10,9,7,53,43,10,39
Linfield,3534,4,10,6,10,37,36,1,36
Cliftonville,3534,5,9,5,12,32,31,1,32
Ballymena,3534,6,7,5,14,26,48,-22,26
Glentoran,3534,7,6,6,10,24,32,-8,24
Dungannon,3534,8,2,4,16,14,47,-33,10
Crusaders,3535,1,17,6,3,63,31,32,57
Coleraine,3535,2,14,10,2,46,28,18,52
Glenavon,3535,3,10,9,7,58,46,12,39
Linfield,3535,4,11,5,10,40,36,4,38
Cliftonville,3535,5,9,4,13,32,34,-2,31
Ballymena,3535,6,7,4,15,26,49,-23,25
Glentoran,3535,7,6,6,10,24,32,-8,24
Dungannon,3535,8,2,4,16,14,47,-33,10
Crusaders,3536,1,16,7,3,64,33,31,55
Coleraine,3536,2,15,10,1,46,24,22,55
Glenavon,3536,3,9,9,8,54,46,8,36
Linfield,3536,4,10,5,11,38,39,-1,35
Cliftonville,3536,5,10,4,12,35,32,3,34
Ballymena,3536,6,7,5,14,28,50,-22,26
Glentoran,3536,7,6,6,10,24,32,-8,24
Dungannon,3536,8,2,4,16,14,47,-33,10
Crusaders,3537,1,16,7,3,62,31,31,55
Coleraine,3537,2,14,10,2,44,24,20,52
Glenavon,3537,3,10,9,7,54,44,10,39
Linfield,3537,4,11,5,10,40,36,4,38
Cliftonville,3537,5,9,4,13,32,34,-2,31
Ballymena,3537,6,7,5,14,26,48,-22,26
Glentoran,3537,7,6,6,10,24,32,-8,24
Dungannon,3537,8,2,4,16,14,47,-33,10
Crusaders,3538,1,17,6,3,65,32,33,57
Coleraine,3538,2,15,10,1,45,23,22,55
Linfield,3538,3,11,5,10,39,37,2,38
Glenavon,3538,4,9,9,8,53,45,8,36
Cliftonville,3538,5,9,4,13,33,33,0,31
Ballymena,3538,6,7,4,15,27,51,-24,25
Glentoran,3538,7,6,6,10,24,32,-8,24
Dungannon,3538,8,2,4,16,14,47,-33,10
Crusaders,3539,1,17,6,3,66,31,35,57
Coleraine,3539,2,15,10,1,47,24,23,55
Linfield,3539,3,11,5,10,38,36,2,38
Glenavon,3539,4,9,9,8,54,47,7,36
Cliftonville,3539,5,9,4,13,32,32,0,31
Ballymena,3539,6,7,4,15,26,52,-26,25
Glentoran,3539,7,6,6,10,24,32,-8,24
Dungannon,3539,8,2,4,16,14,47,-33,10
Crusaders,3540,1,17,6,3,63,30,33,57
Coleraine,3540,2,14,10,2,45,27,18,52
Glenavon,3540,3,10,9,7,57,45,12,39
Linfield,3540,4,11,5,10,38,36,2,38
Cliftonville,3540,5,9,4,13,32,32,0,31
Ballymena,3540,6,7,4,15,25,49,-24,25
Glentoran,3540,7,6,6,10,24,32,-8,24
Dungannon,3540,8,2,4,16,14,47,-33,10
Crusaders,3541,1,17,6,3,65,30,35,57
Coleraine,3541,2,14,10,2,44,26,18,52
Glenavon,3541,3,10,9,7,56,44,12,39
Linfield,3541,4,10,6,10,37,36,1,36
Cliftonville,3541,5,9,5,12,32,31,1,32
Ballymena,3541,6,7,4,15,25,51,-26,25
Glentoran,3541,7,6,6,10,24,32,-8,24
Dungannon,3541,8,2,4,16,14,47,-33,10
Crusaders,3542,1,16,7,3,63,32,31,55
Coleraine,3542,2,15,10,1,47,25,22,55
Linfield,3542,3,11,5,10,39,37,2,38
Glenavon,3542,4,9,9,8,55,47,8,36
Cliftonville,3542,5,9,4,13,33,33,0,31
Ballymena,3542,6,7,5,14,27,49,-22,26
Glentoran,3542,7,6,6,10,24,32,-8,24
Dungannon,3542,8,2,4,16,14,47,-33,10
Crusaders,3543,1,17,6,3,63,31,32,57
Coleraine,3543,2,14,10,2,44,24,20,52
Glenavon,3543,3,10,9,7,54,44,10,39
Linfield,3543,4,10,6,10,38,37,1,36
Cliftonville,3543,5,9,5,12,33,32,1,32
Ballymena,3543,6,7,4,15,26,49,-23,25
Glentoran,3543,7,6,6,10,24,32,-8,24
Dungannon,3543,8,2,4,16,14,47,-33,10
Coleraine,3544,1,15,10,1,45,23,22,55
Crusaders,3544,2,16,6,4,62,33,29,54
Glenavon,3544,3,9,9,8,53,45,8,36
Linfield,3544,4,10,5,11,37,37,0,35
Cliftonville,3544,5,10,4,12,33,31,2,34
Ballymena,3544,6,8,4,14,28,48,-20,28
Glentoran,3544,7,6,6,10,24,32,-8,24
Dungannon,3544,8,2,4,16,14,47,-33,10
Crusaders,3545,1,16,7,3,62,31,31,55
Coleraine,3545,2,14,11,1,46,25,21,53
Glenavon,3545,3,9,10,7,55,46,9,37
Linfield,3545,4,10,5,11,37,37,0,35
Cliftonville,3545,5,10,4,12,33,31,2,34
Ballymena,3545,6,7,5,14,26,48,-22,26
Glentoran,3545,7,6,6,10,24,32,-8,24
Dungannon,3545,8,2,4,16,14,47,-33,10
Crusaders,3546,1,16,7,3,63,32,31,55
Coleraine,3546,2,14,10,2,43,26,17,52
Glenavon,3546,3,10,9,7,56,43,13,39
Linfield,3546,4,10,5,11,38,38,0,35
Cliftonville,3546,5,10,4,12,34,32,2,34
Ballymena,3546,6,7,5,14,27,49,-22,26
Glentoran,3546,7,6,6,10,24,32,-8,24
Dungannon,3546,8,2,4,16,14,47,-33,10
Crusaders,3547,1,16,7,3,61,30,31,55
Coleraine,3547,2,14,10,2,43,24,19,52
Glenavon,3547,3,10,9,7,54,43,11,39
Linfield,3547,4,11,5,10,38,36,2,38
Cliftonville,3547,5,9,4,13,32,32,0,31
Ballymena,3547,6,7,5,14,25,47,-22,26
Glentoran,3547,7,6,6,10,24,32,-8,24
Dungannon,3547,8,2,4,16,14,47,-33,10
Crusaders,3548,1,17,6,3,64,31,33,57
Coleraine,3548,2,15,10,1,47,25,22,55
Glenavon,3548,3,9,9,8,55,47,8,36
Linfield,3548,4,10,6,10,38,37,1,36
Cliftonville,3548,5,9,5,12,33,32,1,32
Ballymena,3548,6,7,4,15,26,50,-24,25
Glentoran,3548,7,6,6,10,24,32,-8,24
Dungannon,3548,8,2,4,16,14,47,-33,10
Crusaders,3549,1,16,6,4,62,32,30,54
Coleraine,3549,2,14,10,2,43,23,20,52
Glenavon,3549,3,10,9,7,53,43,10,39
Linfield,3549,4,10,5,11,37,39,-2,35
Cliftonville,3549,5,10,4,12,35,31,4,34
Ballymena,3549,6,8,4,14,27,48,-21,28
Glentoran,3549,7,6,6,10,24,32,-8,24
Dungannon,3549,8,2,4,16,14,47,-33,10
Crusaders,3550,1,16,6,4,62,33,29,54
Coleraine,3550,2,14,10,2,43,24,19,52
Glenavon,3550,3,10,9,7,54,43,11,39
Linfield,3550,4,11,5,10,38,36,2,38
Cliftonville,3550,5,9,4,13,32,32,0,31
Ballymena,3550,6,8,4,14,28,48,-20,28
Glentoran,3550,7,6,6,10,24,32,-8,24
Dungannon,3550,8,2,4,16,14,47,-33,10
Crusaders,3551,1,16,7,3,61,30,31,55
Coleraine,3551,2,14,11,1,43,22,21,53
Glenavon,3551,3,9,10,7,52,43,9,37
Linfield,3551,4,10,5,11,38,38,0,35
Cliftonville,3551,5,10,4,12,34,32,2,34
Ballymena,3551,6,7,5,14,25,47,-22,26
Glentoran,3551,7,6,6,10,24,32,-8,24
Dungannon,3551,8,2,4,16,14,47,-33,10
Crusaders,3552,1,17,6,3,68,31,37,57
Coleraine,3552,2,15,10,1,45,22,23,55
Glenavon,3552,3,9,9,8,52,45,7,36
Linfield,3552,4,10,6,10,38,37,1,36
Cliftonville,3552,5,9,5,12,33,32,1,32
Ballymena,3552,6,7,4,15,26,54,-28,25
Glentoran,3552,7,6,6,10,24,32,-8,24
Dungannon,3552,8,2,4,16,14,47,-33,10
Coleraine,3553,1,15,10,1,44,22,22,55
Crusaders,3553,2,16,6,4,62,33,29,54
Linfield,3553,3,11,5,10,39,37,2,38
Glenavon,3553,4,9,9,8,52,44,8,36
Cliftonville,3553,5,9,4,13,33,33,0,31
Ballymena,3553,6,8,4,14,28,48,-20,28
Glentoran,3553,7,6,6,10,24,32,-8,24
Dungannon,3553,8,2,4,16,14,47,-33,10
Crusaders,3554,1,16,7,3,62,31,31,55
Coleraine,3554,2,15,10,1,45,23,22,55
Linfield,3554,3,11,5,10,38,36,2,38
Glenavon,3554,4,9,9,8,53,45,8,36
Cliftonville,3554,5,9,4,13,32,32,0,31
Ballymena,3554,6,7,5,14,26,48,-22,26
Glentoran,3554,7,6,6,10,24,32,-8,24
Dungannon,3554,8,2,4,16,14,47,-33,10
Coleraine,3555,1,15,10,1,45,22,23,55
Crusaders,3555,2,16,6,4,61,31,30,54
Linfield,3555,3,11,5,10,40,36,4,38
Glenavon,3555,4,9,9,8,52,45,7,36
Cliftonville,3555,5,9,4,13,32,34,-2,31
Ballymena,3555,6,8,4,14,26,47,-21,28
Glentoran,3555,7,6,6,10,24,32,-8,24
Dungannon,3555,8,2,4,16,14,47,-33,10
Crusaders,3556,1,16,7,3,62,31,31,55
Coleraine,3556,2,14,10,2,44,25,19,52
Glenavon,3556,3,10,9,7,55,44,11,39
Linfield,3556,4,11,5,10,38,36,2,38
Cliftonville,3556,5,9,4,13,32,32,0,31
Ballymena,3556,6,7,5,14,26,48,-22,26
Glentoran,3556,7,6,6,10,24,32,-8,24
Dungannon,3556,8,2,4,16,14,47,-33,10
Crusaders,3557,1,17,6,3,66,34,32,57
Coleraine,3557,2,15,10,1,46,22,24,55
Glenavon,3557,3,9,9,8,52,46,6,36
Linfield,3557,4,10,5,11,37,37,0,35
Cliftonville,3557,5,10,4,12,33,31,2,34
Ballymena,3557,6,7,4,15,29,52,-23,25
Glentoran,3557,7,6,6,10,24,32,-8,24
Dungannon,3557,8,2,4,16,14,47,-33,10
Crusaders,3558,1,16,6,4,61,33,28,54
Coleraine,3558,2,14,10,2,43,24,19,52
Glenavon,3558,3,10,9,7,54,43,11,39
Linfield,3558,4,10,5,11,38,38,0,35
Cliftonville,3558,5,10,4,12,34,32,2,34
Ballymena,3558,6,8,4,14,28,47,-19,28
Glentoran,3558,7,6,6,10,24,32,-8,24
Dungannon,3558,8,2,4,16,14,47,-33,10
Crusaders,3559,1,17,6,3,63,30,33,57
Coleraine,3559,2,14,10,2,44,25,19,52
Glenavon,3559,3,10,9,7,55,44,11,39
Linfield,3559,4,10,5,11,38,38,0,35
Cliftonville,3559,5,10,4,12,34,32,2,34
Ballymena,3559,6,7,4,15,25,49,-24,25
Glentoran,3559,7,6,6,10,24,32,-8,24
Dungannon,3559,8,2,4,16,14,47,-33,10
Crusaders,3560,1,17,6,3,62,30,32,57
Coleraine,3560,2,15,10,1,47,25,22,55
Glenavon,3560,3,9,9,8,55,47,8,36
Linfield,3560,4,10,6,10,38,37,1,36
Cliftonville,3560,5,9,5,12,33,32,1,32
Ballymena,3560,6,7,4,15,25,48,-23,25
Glentoran,3560,7,6,6,10,24,32,-8,24
Dungannon,3560,8,2,4,16,14,47,-33,10
Crusaders,3561,1,16,6,4,62,33,29,54
Coleraine,3561,2,14,11,1,43,22,21,53
Glenavon,3561,3,9,10,7,52,43,9,37
Linfield,3561,4,10,5,11,37,38,-1,35
Cliftonville,3561,5,10,4,12,34,31,3,34
Ballymena,3561,6,8,4,14,28,48,-20,28
Glentoran,3561,7,6,6,10,24,32,-8,24
Dungannon,3561,8,2,4,16,14,47,-33,10
Crusaders,3562,1,17,6,3,64,32,32,57
Coleraine,3562,2,14,10,2,45,26,19,52
Glenavon,3562,3,10,9,7,56,45,11,39
Linfield,3562,4,11,5,10,39,36,3,38
Cliftonville,3562,5,9,4,13,32,33,-1,31
Ballymena,3562,6,7,4,15,27,50,-23,25
Glentoran,3562,7,6,6,10,24,32,-8,24
Dungannon,3562,8,2,4,16,14,47,-33,10
Crusaders,3563,1,17,6,3,64,30,34,57
Coleraine,3563,2,14,11,1,44,23,21,53
Glenavon,3563,3,9,10,7,53,44,9,37
Linfield,3563,4,10,5,11,37,37,0,35
Cliftonville,3563,5,10,4,12,33,31,2,34
Ballymena,3563,6,7,4,15,25,50,-25,25
Glentoran,3563,7,6,6,10,24,32,-8,24
Dungannon,3563,8,2,4,16,14,47,-33,10
Crusaders,3564,1,16,7,3,63,32,31,55
Coleraine,3564,2,14,10,2,44,25,19,52
Glenavon,3564,3,10,9,7,55,44,11,39
Linfield,3564,4,10,6,10,38,37,1,36
Cliftonville,3564,5,9,5,12,33,32,1,32
Ballymena,3564,6,7,5,14,27,49,-22,26
Glentoran,3564,7,6,6,10,24,32,-8,24
Dungannon,3564,8,2,4,16,14,47,-33,10
Crusaders,3565,1,16,7,3,61,30,31,55
Coleraine,3565,2,15,10,1,46,24,22,55
Linfield,3565,3,11,5,10,39,37,2,38
Glenavon,3565,4,9,9,8,54,46,8,36
Cliftonville,3565,5,9,4,13,33,33,0,31
Ballymena,3565,6,7,5,14,25,47,-22,26
Glentoran,3565,7,6,6,10,24,32,-8,24
Dungannon,3565,8,2,4,16,14,47,-33,10
Crusaders,3566,1,16,6,4,64,34,30,54
Coleraine,3566,2,14,11,1,43,22,21,53
Linfield,3566,3,11,5,10,40,36,4,38
Glenavon,3566,4,9,10,7,52,43,9,37
Cliftonville,3566,5,9,4,13,32,34,-2,31
Ballymena,3566,6,8,4,14,29,50,-21,28
Glentoran,3566,7,6,6,10,24,32,-8,24
Dungannon,3566,8,2,4,16,14,47,-33,10
Crusaders,3567,1,17,6,3,64,31,33,57
Coleraine,3567,2,15,10,1,46,24,22,55
Linfield,3567,3,11,5,10,39,36,3,38
Glenavon,3567,4,9,9,8,54,46,8,36
Cliftonville,3567,5,9,4,13,32,33,-1,31
Ballymena,3567,6,7,4,15,26,50,-24,25
Glentoran,3567,7,6,6,10,24,32,-8,24
Dungannon,3567,8,2,4,16,14,47,-33,10
Crusaders,3568,1,17,6,3,64,30,34,57
Coleraine,3568,2,14,10,2,43,25,18,52
Glenavon,3568,3,10,9,7,55,43,12,39
Linfield,3568,4,11,5,10,39,37,2,38
Cliftonville,3568,5,9,4,13,33,33,0,31
Ballymena,3568,6,7,4,15,25,50,-25,25
Glentoran,3568,7,6,6,10,24,32,-8,24
Dungannon,3568,8,2,4,16,14,47,-33,10
Crusaders,3569,1,16,7,3,62,31,31,55
Coleraine,3569,2,14,11,1,45,24,21,53
Glenavon,3569,3,9,10,7,54,45,9,37
Linfield,3569,4,10,6,10,37,36,1,36
Cliftonville,3569,5,9,5,12,32,31,1,32
Ballymena,3569,6,7,5,14,26,48,-22,26
Glentoran,3569,7,6,6,10,24,32,-8,24
Dungannon,3569,8,2,4,16,14,47,-33,10
Crusaders,3570,1,16,6,4,61,32,29,54
Coleraine,3570,2,14,10,2,45,25,20,52
Glenavon,3570,3,10,9,7,55,45,10,39
Linfield,3570,4,11,5,10,39,37,2,38
Cliftonville,3570,5,9,4,13,33,33,0,31
Ballymena,3570,6,8,4,14,27,47,-20,28
Glentoran,3570,7,6,6,10,24,32,-8,24
Dungannon,3570,8,2,4,16,14,47,-33,10
Crusaders,3571,1,16,7,3,61,30,31,55
Coleraine,3571,2,14,11,1,46,25,21,53
Glenavon,3571,3,9,10,7,55,46,9,37
Linfield,3571,4,10,5,11,38,39,-1,35
Cliftonville,3571,5,10,4,12,35,32,3,34
Ballymena,3571,6,7,5,14,25,47,-22,26
Glentoran,3571,7,6,6,10,24,32,-8,24
Dungannon,3571,8,2,4,16,14,47,-33,10
Crusaders,3572,1,16,7,3,62,31,31,55
Coleraine,3572,2,15,10,1,46,23,23,55
Glenavon,3572,3,9,9,8,53,46,7,36
Linfield,3572,4,10,6,10,38,37,1,36
Cliftonville,3572,5,9,5,12,33,32,1,32
Ballymena,3572,6,7,5,14,26,48,-22,26
Glentoran,3572,7,6,6,10,24,32,-8,24
Dungannon,3572,8,2,4,16,14,47,-33,10
Crusaders,3573,1,17,6,3,63,31,32,57
Coleraine,3573,2,14,10,2,43,25,18,52
Glenavon,3573,3,10,9,7,55,43,12,39
Linfield,3573,4,11,5,10,39,37,2,38
Cliftonville,3573,5,9,4,13,33,33,0,31
Ballymena,3573,6,7,4,15,26,49,-23,25
Glentoran,3573,7,6,6,10,24,32,-8,24
Dungannon,3573,8,2,4,16,14,47,-33,10
Crusaders,3574,1,16,7,3,63,32,31,55
Coleraine,3574,2,15,10,1,46,22,24,55
Linfield,3574,3,11,5,10,41,38,3,38
Glenavon,3574,4,9,9,8,52,46,6,36
Cliftonville,3574,5,9,4,13,34,35,-1,31
Ballymena,3574,6,7,5,14,27,49,-22,26
Glentoran,3574,7,6,6,10,24,32,-8,24
Dungannon,3574,8,2,4,16,14,47,-33,10
Crusaders,3575,1,17,6,3,65,32,33,57
Coleraine,3575,2,14,11,1,45,24,21,53
Glenavon,3575,3,9,10,7,54,45,9,37
Linfield,3575,4,10,5,11,37,39,-2,35
Cliftonville,3575,5,10,4,12,35,31,4,34
Ballymena,3575,6,7,4,15,27,51,-24,25
Glentoran,3575,7,6,6,10,24,32,-8,24
Dungannon,3575,8,2,4,16,14,47,-33,10
Crusaders,3576,1,17,6,3,63,31,32,57
Coleraine,3576,2,14,10,2,44,25,19,52
Glenavon,3576,3,10,9,7,55,44,11,39
Linfield,3576,4,10,5,11,37,38,-1,35
Cliftonville,3576,5,10,4,12,34,31,3,34
Ballymena,3576,6,7,4,15,26,49,-23,25
Glentoran,3576,7,6,6,10,24,32,-8,24
Dungannon,3576,8,2,4,16,14,47,-33,10
Crusaders,3577,1,17,6,3,63,30,33,57
Coleraine,3577,2,14,10,2,43,23,20,52
Glenavon,3577,3,10,9,7,53,43,10,39
Linfield,3577,4,10,6,10,39,38,1,36
Cliftonville,3577,5,9,5,12,34,33,1,32
Ballymena,3577,6,7,4,15,25,49,-24,25
Glentoran,3577,7,6,6,10,24,32,-8,24
Dungannon,3577,8,2,4,16,14,47,-33,10
Crusaders,3578,1,17,6,3,64,31,33,57
Coleraine,3578,2,15,10,1,44,22,22,55
Glenavon,3578,3,9,9,8,52,44,8,36
Linfield,3578,4,10,5,11,37,37,0,35
Cliftonville,3578,5,10,4,12,33,31,2,34
Ballymena,3578,6,7,4,15,26,50,-24,25
Glentoran,3578,7,6,6,10,24,32,-8,24
Dungannon,3578,8,2,4,16,14,47,-33,10
Crusaders,3579,1,16,7,3,62,31,31,55
Coleraine,3579,2,14,10,2,43,25,18,52
Glenavon,3579,3,10,9,7,55,43,12,39
Linfield,3579,4,10,5,11,37,37,0,35
Cliftonville,3579,5,10,4,12,33,31,2,34
Ballymena,3579,6,7,5,14,26,48,-22,26
Glentoran,3579,7,6,6,10,24,32,-8,24
Dungannon,3579,8,2,4,16,14,47,-33,10
Crusaders,3580,1,16,7,3,63,32,31,55
Coleraine,3580,2,15,10,1,45,23,22,55
Glenavon,3580,3,9,9,8,53,45,8,36
Linfield,3580,4,10,5,11,38,39,-1,35
Cliftonville,3580,5,10,4,12,35,32,3,34
Ballymena,3580,6,7,5,14,27,49,-22,26
Glentoran,3580,7,6,6,10,24,32,-8,24
Dungannon,3580,8,2,4,16,14,47,-33,10
Crusaders,3581,1,16,6,4,62,32,30,54
Coleraine,3581,2,14,10,2,44,24,20,52
Glenavon,3581,3,10,9,7,54,44,10,39
Linfield,3581,4,10,6,10,38,37,1,36
Cliftonville,3581,5,9,5,12,33,32,1,32
Ballymena,3581,6,8,4,14,27,48,-21,28
Glentoran,3581,7,6,6,10,24,32,-8,24
Dungannon,3581,8,2,4,16,14,47,-33,10
Crusaders,3582,1,16,7,3,62,31,31,55
Coleraine,3582,2,14,11,1,44,23,21,53
Glenavon,3582,3,9,10,7,53,44,9,37
Linfield,3582,4,10,6,10,38,37,1,36
Cliftonville,3582,5,9,5,12,33,32,1,32
Ballymena,3582,6,7,5,14,26,48,-22,26
Glentoran,3582,7,6,6,10,24,32,-8,24
Dungannon,3582,8,2,4,16,14,47,-33,10
Crusaders,3583,1,16,7,3,61,30,31,55
Coleraine,3583,2,14,10,2,44,25,19,52
Glenavon,3583,3,10,9,7,55,44,11,39
Linfield,3583,4,11,5,10,38,36,2,38
Cliftonville,3583,5,9,4,13,32,32,0,31
Ballymena,3583,6,7,5,14,25,47,-22,26
Glentoran,3583,7,6,6,10,24,32,-8,24
Dungannon,3583,8,2,4,16,14,47,-33,10
Coleraine,3584,1,15,10,1,46,24,22,55
Crusaders,3584,2,16,6,4,61,31,30,54
Linfield,3584,3,11,5,10,39,36,3,38
Glenavon,3584,4,9,9,8,54,46,8,36
Cliftonville,3584,5,9,4,13,32,33,-1,31
Ballymena,3584,6,8,4,14,26,47,-21,28
Glentoran,3584,7,6,6,10,24,32,-8,24
Dungannon,3584,8,2,4,16,14,47,-33,10
Crusaders,3585,1,17,6,3,65,31,34,57
Coleraine,3585,2,15,10,1,44,22,22,55
Linfield,3585,3,11,5,10,40,37,3,38
Glenavon,3585,4,9,9,8,52,44,8,36
Cliftonville,3585,5,9,4,13,33,34,-1,31
Ballymena,3585,6,7,4,15,26,51,-25,25
Glentoran,3585,7,6,6,10,24,32,-8,24
Dungannon,3585,8,2,4,16,14,47,-33,10
Crusaders,3586,1,17,6,3,63,30,33,57
Coleraine,3586,2,15,10,1,45,23,22,55
Glenavon,3586,3,9,9,8,53,45,8,36
Linfield,3586,4,10,6,10,38,37,1,36
Cliftonville,3586,5,9,5,12,33,32,1,32
Ballymena,3586,6,7,4,15,25,49,-24,25
Glentoran,3586,7,6,6,10,24,32,-8,24
Dungannon,3586,8,2,4,16,14,47,-33,10
Crusaders,3587,1,17,6,3,64,30,34,57
Coleraine,3587,2,15,10,1,45,23,22,55
Linfield,3587,3,11,5,10,41,36,5,38
Glenavon,3587,4,9,9,8,53,45,8,36
Cliftonville,3587,5,9,4,13,32,35,-3,31
Ballymena,3587,6,7,4,15,25,50,-25,25
Glentoran,3587,7,6,6,10,24,32,-8,24
Dungannon,3587,8,2,4,16,14,47,-33,10
Crusaders,3588,1,17,6,3,63,30,33,57
Coleraine,3588,2,15,10,1,45,23,22,55
Glenavon,3588,3,9,9,8,53,45,8,36
Linfield,3588,4,10,5,11,37,37,0,35
Cliftonville,3588,5,10,4,12,33,31,2,34
Ballymena,3588,6,7,4,15,25,49,-24,25
Glentoran,3588,7,6,6,10,24,32,-8,24
Dungannon,3588,8,2,4,16,14,47,-33,10
Crusaders,3589,1,17,6,3,64,31,33,57
Coleraine,3589,2,14,10,2,46,27,19,52
Glenavon,3589,3,10,9,7,57,46,11,39
Linfield,3589,4,11,5,10,41,36,5,38
Cliftonville,3589,5,9,4,13,32,35,-3,31
Ballymena,3589,6,7,4,15,26,50,-24,25
Glentoran,3589,7,6,6,10,24,32,-8,24
Dungannon,3589,8,2,4,16,14,47,-33,10
Crusaders,3590,1,16,7,3,62,31,31,55
Coleraine,3590,2,14,10,2,44,25,19,52
Glenavon,3590,3,10,9,7,55,44,11,39
Linfield,3590,4,11,5,10,39,37,2,38
Cliftonville,3590,5,9,4,13,33,33,0,31
Ballymena,3590,6,7,5,14,26,48,-22,26
Glentoran,3590,7,6,6,10,24,32,-8,24
Dungannon,3590,8,2,4,16,14,47,-33,10
Crusaders,3591,1,17,6,3,64,31,33,57
Coleraine,3591,2,14,10,2,44,26,18,52
Glenavon,3591,3,10,9,7,56,44,12,39
Linfield,3591,4,10,5,11,37,37,0,35
Cliftonville,3591,5,10,4,12,33,31,2,34
Ballymena,3591,6,7,4,15,26,50,-24,25
Glentoran,3591,7,6,6,10,24,32,-8,24
Dungannon,3591,8,2,4,16,14,47,-33,10
Crusaders,3592,1,16,7,3,62,31,31,55
Coleraine,3592,2,14,10,2,44,26,18,52
Glenavon,3592,3,10,9,7,56,44,12,39
Linfield,3592,4,10,5,11,37,37,0,35
Cliftonville,3592,5,10,4,12,33,31,2,34
Ballymena,3592,6,7,5,14,26,48,-22,26
Glentoran,3592,7,6,6,10,24,32,-8,24
Dungannon,3592,8,2,4,16,14,47,-33,10
Crusaders,3593,1,17,6,3,64,31,33,57
Coleraine,3593,2,14,11,1,44,23,21,53
Linfield,3593,3,11,5,10,40,38,2,38
Glenavon,3593,4,9,10,7,53,44,9,37
Cliftonville,3593,5,9,4,13,34,34,0,31
Ballymena,3593,6,7,4,15,26,50,-24,25
Glentoran,3593,7,6,6,10,24,32,-8,24
Dungannon,3593,8,2,4,16,14,47,-33,10
Crusaders,3594,1,16,6,4,62,32,30,54
Coleraine,3594,2,14,10,2,44,24,20,52
Glenavon,3594,3,10,9,7,54,44,10,39
Linfield,3594,4,10,5,11,38,39,-1,35
Cliftonville,3594,5,10,4,12,35,32,3,34
Ballymena,3594,6,8,4,14,27,48,-21,28
Glentoran,3594,7,6,6,10,24,32,-8,24
Dungannon,3594,8,2,4,16,14,47,-33,10
Crusaders,3595,1,16,7,3,61,30,31,55
Coleraine,3595,2,15,10,1,45,22,23,55
Glenavon,3595,3,9,9,8,52,45,7,36
Linfield,3595,4,10,5,11,38,39,-1,35
Cliftonville,3595,5,10,4,12,35,32,3,34
Ballymena,3595,6,7,5,14,25,47,-22,26
Glentoran,3595,7,6,6,10,24,32,-8,24
Dungannon,3595,8,2,4,16,14,47,-33,10
Crusaders,3596,1,17,6,3,63,31,32,57
Coleraine,3596,2,14,11,1,46,25,21,53
Linfield,3596,3,11,5,10,40,38,2,38
Glenavon,3596,4,9,10,7,55,46,9,37
Cliftonville,3596,5,9,4,13,34,34,0,31
Ballymena,3596,6,7,4,15,26,49,-23,25
Glentoran,3596,7,6,6,10,24,32,-8,24
Dungannon,3596,8,2,4,16,14,47,-33,10
Crusaders,3597,1,17,6,3,64,31,33,57
Coleraine,3597,2,14,10,2,43,23,20,52
Glenavon,3597,3,10,9,7,53,43,10,39
Linfield,3597,4,11,5,10,40,36,4,38
Cliftonville,3597,5,9,4,13,32,34,-2,31
Ballymena,3597,6,7,4,15,26,50,-24,25
Glentoran,3597,7,6,6,10,24,32,-8,24
Dungannon,3597,8,2,4,16,14,47,-33,10
Crusaders,3598,1,16,7,3,62,31,31,55
Coleraine,3598,2,15,10,1,46,24,22,55
Glenavon,3598,3,9,9,8,54,46,8,36
Linfield,3598,4,10,6,10,37,36,1,36
Cliftonville,3598,5,9,5,12,32,31,1,32
Ballymena,3598,6,7,5,14,26,48,-22,26
Glentoran,3598,7,6,6,10,24,32,-8,24
Dungannon,3598,8,2,4,16,14,47,-33,10
Crusaders,3599,1,17,6,3,66,30,36,57
Coleraine,3599,2,15,10,1,45,23,22,55
Linfield,3599,3,11,5,10,39,36,3,38
Glenavon,3599,4,9,9,8,53,45,8,36
Cliftonville,3599,5,9,4,13,32,33,-1,31
Ballymena,3599,6,7,4,15,25,52,-27,25
Glentoran,3599,7,6,6,10,24,32,-8,24
Dungannon,3599,8,2,4,16,14,47,-33,10
Crusaders,3600,1,17,6,3,66,31,35,57
Coleraine,3600,2,15,10,1,44,22,22,55
Linfield,3600,3,11,5,10,40,36,4,38
Glenavon,3600,4,9,9,8,52,44,8,36
Cliftonville,3600,5,9,4,13,32,34,-2,31
Ballymena,3600,6,7,4,15,26,52,-26,25
Glentoran,3600,7,6,6,10,24,32,-8,24
Dungannon,3600,8,2,4,16,14,47,-33,10
Crusaders,3601,1,17,6,3,62,30,32,57
Coleraine,3601,2,15,10,1,46,24,22,55
Linfield,3601,3,11,5,10,39,37,2,38
Glenavon,3601,4,9,9,8,54,46,8,36
Cliftonville,3601,5,9,4,13,33,33,0,31
Ballymena,3601,6,7,4,15,25,48,-23,25
Glentoran,3601,7,6,6,10,24,32,-8,24
Dungannon,3601,8,2,4,16,14,47,-33,10
Crusaders,3602,1,17,6,3,63,30,33,57
Coleraine,3602,2,15,10,1,47,22,25,55
Glenavon,3602,3,9,9,8,52,47,5,36
Linfield,3602,4,10,5,11,37,37,0,35
Cliftonville,3602,5,10,4,12,33,31,2,34
Ballymena,3602,6,7,4,15,25,49,-24,25
Glentoran,3602,7,6,6,10,24,32,-8,24
Dungannon,3602,8,2,4,16,14,47,-33,10
Crusaders,3603,1,16,7,3,63,32,31,55
Coleraine,3603,2,14,11,1,43,22,21,53
Glenavon,3603,3,9,10,7,52,43,9,37
Linfield,3603,4,10,6,10,39,38,1,36
Cliftonville,3603,5,9,5,12,34,33,1,32
Ballymena,3603,6,7,5,14,27,49,-22,26
Glentoran,3603,7,6,6,10,24,32,-8,24
Dungannon,3603,8,2,4,16,14,47,-33,10
Crusaders,3604,1,17,6,3,63,31,32,57
Coleraine,3604,2,14,10,2,44,24,20,52
Glenavon,3604,3,10,9,7,54,44,10,39
Linfield,3604,4,11,5,10,38,36,2,38
Cliftonville,3604,5,9,4,13,32,32,0,31
Ballymena,3604,6,7,4,15,26,49,-23,25
Glentoran,3604,7,6,6,10,24,32,-8,24
Dungannon,3604,8,2,4,16,14,47,-33,10
Crusaders,3605,1,17,6,3,64,31,33,57
Coleraine,3605,2,15,10,1,45,23,22,55
Glenavon,3605,3,9,9,8,53,45,8,36
Linfield,3605,4,10,6,10,40,39,1,36
Cliftonville,3605,5,9,5,12,35,34,1,32
Ballymena,3605,6,7,4,15,26,50,-24,25
Glentoran,3605,7,6,6,10,24,32,-8,24
Dungannon,3605,8,2,4,16,14,47,-33,10
Crusaders,3606,1,16,7,3,63,32,31,55
Coleraine,3606,2,15,10,1,45,22,23,55
Linfield,3606,3,11,5,10,38,36,2,38
Glenavon,3606,4,9,9,8,52,45,7,36
Cliftonville,3606,5,9,4,13,32,32,0,31
Ballymena,3606,6,7,5,14,27,49,-22,26
Glentoran,3606,7,6,6,10,24,32,-8,24
Dungannon,3606,8,2,4,16,14,47,-33,10
Crusaders,3607,1,17,6,3,64,31,33,57
Coleraine,3607,2,14,10,2,44,24,20,52
Glenavon,3607,3,10,9,7,54,44,10,39
Linfield,3607,4,11,5,10,40,36,4,38
Cliftonville,3607,5,9,4,13,32,34,-2,31
Ballymena,3607,6,7,4,15,26,50,-24,25
Glentoran,3607,7,6,6,10,24,32,-8,24
Dungannon,3607,8,2,4,16,14,47,-33,10
Crusaders,3608,1,17,6,3,64,31,33,57
Coleraine,3608,2,15,10,1,44,22,22,55
Glenavon,3608,3,9,9,8,52,44,8,36
Linfield,3608,4,10,5,11,38,38,0,35
Cliftonville,3608,5,10,4,12,34,32,2,34
Ballymena,3608,6,7,4,15,26,50,-24,25
Glentoran,3608,7,6,6,10,24,32,-8,24
Dungannon,3608,8,2,4,16,14,47,-33,10
Coleraine,3609,1,15,10,1,46,22,24,55
Crusaders,3609,2,16,6,4,63,34,29,54
Glenavon,3609,3,9,9,8,52,46,6,36
Linfield,3609,4,10,6,10,37,36,1,36
Cliftonville,3609,5,9,5,12,32,31,1,32
Ballymena,3609,6,8,4,14,29,49,-20,28
Glentoran,3609,7,6,6,10,24,32,-8,24
Dungannon,3609,8,2,4,16,14,47,-33,10
Crusaders,3610,1,17,6,3,67,31,36,57
Coleraine,3610,2,15,10,1,45,23,22,55
Glenavon,3610,3,9,9,8,53,45,8,36
Linfield,3610,4,10,6,10,37,36,1,36
Cliftonville,3610,5,9,5,12,32,31,1,32
Ballymena,3610,6,7,4,15,26,53,-27,25
Glentoran,3610,7,6,6,10,24,32,-8,24
Dungannon,3610,8,2,4,16,14,47,-33,10
Crusaders,3611,1,16,7,3,64,33,31,55
Coleraine,3611,2,14,10,2,43,25,18,52
Glenavon,3611,3,10,9,7,55,43,12,39
Linfield,3611,4,11,5,10,39,36,3,38
Cliftonville,3611,5,9,4,13,32,33,-1,31
Ballymena,3611,6,7,5,14,28,50,-22,26
Glentoran,3611,7,6,6,10,24,32,-8,24
Dungannon,3611,8,2,4,16,14,47,-33,10
Crusaders,3612,1,16,7,3,62,31,31,55
Coleraine,3612,2,14,11,1,45,24,21,53
Glenavon,3612,3,9,10,7,54,45,9,37
Linfield,3612,4,10,5,11,39,39,0,35
Cliftonville,3612,5,10,4,12,35,33,2,34
Ballymena,3612,6,7,5,14,26,48,-22,26
Glentoran,3612,7,6,6,10,24,32,-8,24
Dungannon,3612,8,2,4,16,14,47,-33,10
Crusaders,3613,1,16,7,3,61,30,31,55
Coleraine,3613,2,14,10,2,43,26,17,52
Glenavon,3613,3,10,9,7,56,43,13,39
Linfield,3613,4,11,5,10,41,37,4,38
Cliftonville,3613,5,9,4,13,33,35,-2,31
Ballymena,3613,6,7,5,14,25,47,-22,26
Glentoran,3613,7,6,6,10,24,32,-8,24
Dungannon,3613,8,2,4,16,14,47,-33,10
Crusaders,3614,1,17,6,3,64,32,32,57
Coleraine,3614,2,14,10,2,44,25,19,52
Glenavon,3614,3,10,9,7,55,44,11,39
Linfield,3614,4,10,5,11,37,37,0,35
Cliftonville,3614,5,10,4,12,33,31,2,34
Ballymena,3614,6,7,4,15,27,50,-23,25
Glentoran,3614,7,6,6,10,24,32,-8,24
Dungannon,3614,8,2,4,16,14,47,-33,10
Crusaders,3615,1,16,6,4,62,32,30,54
Coleraine,3615,2,14,10,2,43,24,19,52
Glenavon,3615,3,10,9,7,54,43,11,39
Linfield,3615,4,11,5,10,39,36,3,38
Cliftonville,3615,5,9,4,13,32,33,-1,31
Ballymena,3615,6,8,4,14,27,48,-21,28
Glentoran,3615,7,6,6,10,24,32,-8,24
Dungannon,3615,8,2,4,16,14,47,-33,10
Crusaders,3616,1,16,7,3,61,30,31,55
Coleraine,3616,2,14,10,2,44,26,18,52
Glenavon,3616,3,10,9,7,56,44,12,39
Linfield,3616,4,10,6,10,39,38,1,36
Cliftonville,3616,5,9,5,12,34,33,1,32
Ballymena,3616,6,7,5,14,25,47,-22,26
Glentoran,3616,7,6,6,10,24,32,-8,24
Dungannon,3616,8,2,4,16,14,47,-33,10
Coleraine,3617,1,15,10,1,46,23,23,55
Crusaders,3617,2,16,6,4,62,32,30,54
Linfield,3617,3,11,5,10,39,36,3,38
Glenavon,3617,4,9,9,8,53,46,7,36
Cliftonville,3617,5,9,4,13,32,33,-1,31
Ballymena,3617,6,8,4,14,27,48,-21,28
Glentoran,3617,7,6,6,10,24,32,-8,24
Dungannon,3617,8,2,4,16,14,47,-33,10
Crusaders,3618,1,16,7,3,62,31,31,55
Coleraine,3618,2,14,10,2,43,23,20,52
Glenavon,3618,3,10,9,7,53,43,10,39
Linfield,3618,4,10,5,11,38,39,-1,35
Cliftonville,3618,5,10,4,12,35,32,3,34
Ballymena,3618,6,7,5,14,26,48,-22,26
Glentoran,3618,7,6,6,10,24,32,-8,24
Dungannon,3618,8,2,4,16,14,47,-33,10
Crusaders,3619,1,17,6,3,65,33,32,57
Coleraine,3619,2,14,10,2,44,26,18,52
Glenavon,3619,3,10,9,7,56,44,12,39
Linfield,3619,4,10,6,10,38,37,1,36
Cliftonville,3619,5,9,5,12,33,32,1,32
Ballymena,3619,6,7,4,15,28,51,-23,25
Glentoran,3619,7,6,6,10,24,32,-8,24
Dungannon,3619,8,2,4,16,14,47,-33,10
Crusaders,3620,1,17,6,3,64,32,32,57
Coleraine,3620,2,14,11,1,45,24,21,53
Glenavon,3620,3,9,10,7,54,45,9,37
Linfield,3620,4,10,5,11,39,39,0,35
Cliftonville,3620,5,10,4,12,35,33,2,34
Ballymena,3620,6,7,4,15,27,50,-23,25
Glentoran,3620,7,6,6,10,24,32,-8,24
Dungannon,3620,8,2,4,16,14,47,-33,10
Coleraine,3621,1,15,10,1,45,23,22,55
Crusaders,3621,2,16,6,4,62,33,29,54
Linfield,3621,3,11,5,10,38,36,2,38
Glenavon,3621,4,9,9,8,53,45,8,36
Cliftonville,3621,5,9,4,13,32,32,0,31
Ballymena,3621,6,8,4,14,28,48,-20,28
Glentoran,3621,7,6,6,10,24,32,-8,24
Dungannon,3621,8,2,4,16,14,47,-33,10
Crusaders,3622,1,17,6,3,63,31,32,57
Coleraine,3622,2,14,11,1,44,23,21,53
Linfield,3622,3,11,5,10,39,36,3,38
Glenavon,3622,4,9,10,7,53,44,9,37
Cliftonville,3622,5,9,4,13,32,33,-1,31
Ballymena,3622,6,7,4,15,26,49,-23,25
Glentoran,3622,7,6,6,10,24,32,-8,24
Dungannon,3622,8,2,4,16,14,47,-33,10
Crusaders,3623,1,17,6,3,63,30,33,57
Coleraine,3623,2,14,10,2,44,25,19,52
Glenavon,3623,3,10,9,7,55,44,11,39
Linfield,3623,4,10,5,11,38,38,0,35
Cliftonville,3623,5,10,4,12,34,32,2,34
Ballymena,3623,6,7,4,15,25,49,-24,25
Glentoran,3623,7,6,6,10,24,32,-8,24
Dungannon,3623,8,2,4,16,14,47,-33,10
Crusaders,3624,1,16,6,4,64,34,30,54
Coleraine,3624,2,14,10,2,44,25,19,52
Glenavon,3624,3,10,9,7,55,44,11,39
Linfield,3624,4,10,6,10,37,36,1,36
Cliftonville,3624,5,9,5,12,32,31,1,32
Ballymena,3624,6,8,4,14,29,50,-21,28
Glentoran,3624,7,6,6,10,24,32,-8,24
Dungannon,3624,8,2,4,16,14,47,-33,10
Crusaders,3625,1,17,6,3,63,30,33,57
Coleraine,3625,2,15,10,1,44,22,22,55
Glenavon,3625,3,9,9,8,52,44,8,36
Linfield,3625,4,10,5,11,39,39,0,35
Cliftonville,3625,5,10,4,12,35,33,2,34
Ballymena,3625,6,7,4,15,25,49,-24,25
Glentoran,3625,7,6,6,10,24,32,-8,24
Dungannon,3625,8,2,4,16,14,47,-33,10
Crusaders,3626,1,17,6,3,64,31,33,57
Coleraine,3626,2,15,10,1,45,23,22,55
Linfield,3626,3,11,5,10,38,36,2,38
Glenavon,3626,4,9,9,8,53,45,8,36
Cliftonville,3626,5,9,4,13,32,32,0,31
Ballymena,3626,6,7,4,15,26,50,-24,25
Glentoran,3626,7,6,6,10,24,32,-8,24
Dungannon,3626,8,2,4,16,14,47,-33,10
Crusaders,3627,1,17,6,3,64,31,33,57
Coleraine,3627,2,14,11,1,45,24,21,53
Glenavon,3627,3,9,10,7,54,45,9,37
Linfield,3627,4,10,6,10,38,37,1,36
Cliftonville,3627,5,9,5,12,33,32,1,32
Ballymena,3627,6,7,4,15,26,50,-24,25
Glentoran,3627,7,6,6,10,24,32,-8,24
Dungannon,3627,8,2,4,16,14,47,-33,10
Crusaders,3628,1,16,7,3,62,31,31,55
Coleraine,3628,2,14,10,2,43,23,20,52
Glenavon,3628,3,10,9,7,53,43,10,39
Linfield,3628,4,11,5,10,40,38,2,38
Cliftonville,3628,5,9,4,13,34,34,0,31
Ballymena,3628,6,7,5,14,26,48,-22,26
Glentoran,3628,7,6,6,10,24,32,-8,24
Dungannon,3628,8,2,4,16,14,47,-33,10
Crusaders,3629,1,17,6,3,65,31,34,57
Coleraine,3629,2,14,10,2,45,25,20,52
Glenavon,3629,3,10,9,7,55,45,10,39
Linfield,3629,4,10,6,10,37,36,1,36
Cliftonville,3629,5,9,5,12,32,31,1,32
Ballymena,3629,6,7,4,15,26,51,-25,25
Glentoran,3629,7,6,6,10,24,32,-8,24
Dungannon,3629,8,2,4,16,14,47,-33,10
Crusaders,3630,1,16,7,3,62,31,31,55
Coleraine,3630,2,15,10,1,45,23,22,55
Linfield,3630,3,11,5,10,38,36,2,38
Glenavon,3630,4,9,9,8,53,45,8,36
Cliftonville,3630,5,9,4,13,32,32,0,31
Ballymena,3630,6,7,5,14,26,48,-22,26
Glentoran,3630,7,6,6,10,24,32,-8,24
Dungannon,3630,8,2,4,16,14,47,-33,10
Crusaders,3631,1,17,6,3,65,33,32,57
Coleraine,3631,2,14,10,2,44,25,19,52
Glenavon,3631,3,10,9,7,55,44,11,39
Linfield,3631,4,11,5,10,40,36,4,38
Cliftonville,3631,5,9,4,13,32,34,-2,31
Ballymena,3631,6,7,4,15,28,51,-23,25
Glentoran,3631,7,6,6,10,24,32,-8,24
Dungannon,3631,8,2,4,16,14,47,-33,10
Crusaders,3632,1,17,6,3,64,32,32,57
Coleraine,3632,2,14,10,2,44,27,17,52
Glenavon,3632,3,10,9,7,57,44,13,39
Linfield,3632,4,10,5,11,38,38,0,35
Cliftonville,3632,5,10,4,12,34,32,2,34
Ballymena,3632,6,7,4,15,27,50,-23,25
Glentoran,3632,7,6,6,10,24,32,-8,24
Dungannon,3632,8,2,4,16,14,47,-33,10
Crusaders,3633,1,17,6,3,63,31,32,57
Coleraine,3633,2,15,10,1,45,23,22,55
Linfield,3633,3,11,5,10,38,36,2,38
Glenavon,3633,4,9,9,8,53,45,8,36
Cliftonville,3633,5,9,4,13,32,32,0,31
Ballymena,3633,6,7,4,15,26,49,-23,25
Glentoran,3633,7,6,6,10,24,32,-8,24
Dungannon,3633,8,2,4,16,14,47,-33,10
Coleraine,3634,1,15,10,1,45,23,22,55
Crusaders,3634,2,16,6,4,61,32,29,54
Linfield,3634,3,11,5,10,40,38,2,38
Glenavon,3634,4,9,9,8,53,45,8,36
Cliftonville,3634,5,9,4,13,34,34,0,31
Ballymena,3634,6,8,4,14,27,47,-20,28
Glentoran,3634,7,6,6,10,24,32,-8,24
Dungannon,3634,8,2,4,16,14,47,-33,10
Crusaders,3635,1,16,6,4,62,33,29,54
Coleraine,3635,2,14,10,2,43,25,18,52
Glenavon,3635,3,10,9,7,55,43,12,39
Linfield,3635,4,10,5,11,39,40,-1,35
Cliftonville,3635,5,10,4,12,36,33,3,34
Ballymena,3635,6,8,4,14,28,48,-20,28
Glentoran,3635,7,6,6,10,24,32,-8,24
Dungannon,3635,8,2,4,16,14,47,-33,10
Crusaders,3636,1,17,6,3,65,30,35,57
Coleraine,3636,2,14,10,2,43,24,19,52
Glenavon,3636,3,10,9,7,54,43,11,39
Linfield,3636,4,11,5,10,38,36,2,38
Cliftonville,3636,5,9,4,13,32,32,0,31
Ballymena,3636,6,7,4,15,25,51,-26,25
Glentoran,3636,7,6,6,10,24,32,-8,24
Dungannon,3636,8,2,4,16,14,47,-33,10
Crusaders,3637,1,17,6,3,66,30,36,57
Coleraine,3637,2,14,11,1,45,24,21,53
Linfield,3637,3,11,5,10,41,36,5,38
Glenavon,3637,4,9,10,7,54,45,9,37
Cliftonville,3637,5,9,4,13,32,35,-3,31
Ballymena,3637,6,7,4,15,25,52,-27,25
Glentoran,3637,7,6,6,10,24,32,-8,24
Dungannon,3637,8,2,4,16,14,47,-33,10
Crusaders,3638,1,16,6,4,63,33,30,54
Coleraine,3638,2,14,11,1,43,22,21,53
Glenavon,3638,3,9,10,7,52,43,9,37
Linfield,3638,4,10,6,10,39,38,1,36
Cliftonville,3638,5,9,5,12,34,33,1,32
Ballymena,3638,6,8,4,14,28,49,-21,28
Glentoran,3638,7,6,6,10,24,32,-8,24
Dungannon,3638,8,2,4,16,14,47,-33,10
Crusaders,3639,1,17,6,3,65,31,34,57
Coleraine,3639,2,14,10,2,44,24,20,52
Glenavon,3639,3,10,9,7,54,44,10,39
Linfield,3639,4,10,5,11,37,37,0,35
Cliftonville,3639,5,10,4,12,33,31,2,34
Ballymena,3639,6,7,4,15,26,51,-25,25
Glentoran,3639,7,6,6,10,24,32,-8,24
Dungannon,3639,8,2,4,16,14,47,-33,10
Crusaders,3640,1,17,6,3,63,30,33,57
Coleraine,3640,2,14,10,2,44,24,20,52
Glenavon,3640,3,10,9,7,54,44,10,39
Linfield,3640,4,11,5,10,40,37,3,38
Cliftonville,3640,5,9,4,13,33,34,-1,31
Ballymena,3640,6,7,4,15,25,49,-24,25
Glentoran,3640,7,6,6,10,24,32,-8,24
Dungannon,3640,8,2,4,16,14,47,-33,10
Coleraine,3641,1,15,10,1,45,23,22,55
Crusaders,3641,2,16,6,4,61,31,30,54
Glenavon,3641,3,9,9,8,53,45,8,36
Linfield,3641,4,10,5,11,38,38,0,35
Cliftonville,3641,5,10,4,12,34,32,2,34
Ballymena,3641,6,8,4,14,26,47,-21,28
Glentoran,3641,7,6,6,10,24,32,-8,24
Dungannon,3641,8,2,4,16,14,47,-33,10
Crusaders,3642,1,17,6,3,64,32,32,57
Coleraine,3642,2,15,10,1,45,23,22,55
Linfield,3642,3,11,5,10,39,37,2,38
Glenavon,3642,4,9,9,8,53,45,8,36
Cliftonville,3642,5,9,4,13,33,33,0,31
Ballymena,3642,6,7,4,15,27,50,-23,25
Glentoran,3642,7,6,6,10,24,32,-8,24
Dungannon,3642,8,2,4,16,14,47,-33,10
Crusaders,3643,1,16,7,3,61,30,31,55
Coleraine,3643,2,14,10,2,44,24,20,52
Glenavon,3643,3,10,9,7,54,44,10,39
Linfield,3643,4,10,5,11,39,39,0,35
Cliftonville,3643,5,10,4,12,35,33,2,34
Ballymena,3643,6,7,5,14,25,47,-22,26
Glentoran,3643,7,6,6,10,24,32,-8,24
Dungannon,3643,8,2,4,16,14,47,-33,10
Crusaders,3644,1,17,6,3,64,32,32,57
Coleraine,3644,2,15,10,1,47,24,23,55
Glenavon,3644,3,9,9,8,54,47,7,36
Linfield,3644,4,10,6,10,38,37,1,36
Cliftonville,3644,5,9,5,12,33,32,1,32
Ballymena,3644,6,7,4,15,27,50,-23,25
Glentoran,3644,7,6,6,10,24,32,-8,24
Dungannon,3644,8,2,4,16,14,47,-33,10
Crusaders,3645,1,17,6,3,63,31,32,57
Coleraine,3645,2,14,10,2,44,26,18,52
Glenavon,3645,3,10,9,7,56,44,12,39
Linfield,3645,4,11,5,10,39,36,3,38
Cliftonville,3645,5,9,4,13,32,33,-1,31
Ballymena,3645,6,7,4,15,26,49,-23,25
Glentoran,3645,7,6,6,10,24,32,-8,24
Dungannon,3645,8,2,4,16,14,47,-33,10
Crusaders,3646,1,16,6,4,61,31,30,54
Coleraine,3646,2,14,10,2,45,25,20,52
Glenavon,3646,3,10,9,7,55,45,10,39
Linfield,3646,4,10,5,11,39,39,0,35
Cliftonville,3646,5,10,4,12,35,33,2,34
Ballymena,3646,6,8,4,14,26,47,-21,28
Glentoran,3646,7,6,6,10,24,32,-8,24
Dungannon,3646,8,2,4,16,14,47,-33,10
Crusaders,3647,1,17,6,3,62,30,32,57
Coleraine,3647,2,15,10,1,46,22,24,55
Linfield,3647,3,11,5,10,39,37,2,38
Glenavon,3647,4,9,9,8,52,46,6,36
Cliftonville,3647,5,9,4,13,33,33,0,31
Ballymena,3647,6,7,4,15,25,48,-23,25
Glentoran,3647,7,6,6,10,24,32,-8,24
Dungannon,3647,8,2,4,16,14,47,-33,10
Crusaders,3648,1,17,6,3,63,31,32,57
Coleraine,3648,2,15,10,1,44,22,22,55
Linfield,3648,3,11,5,10,39,36,3,38
Glenavon,3648,4,9,9,8,52,44,8,36
Cliftonville,3648,5,9,4,13,32,33,-1,31
Ballymena,3648,6,7,4,15,26,49,-23,25
Glentoran,3648,7,6,6,10,24,32,-8,24
Dungannon,3648,8,2,4,16,14,47,-33,10
Crusaders,3649,1,17,6,3,64,31,33,57
Coleraine,3649,2,14,10,2,43,24,19,52
Glenavon,3649,3,10,9,7,54,43,11,39
Linfield,3649,4,10,5,11,37,39,-2,35
Cliftonville,3649,5,10,4,12,35,31,4,34
Ballymena,3649,6,7,4,15,26,50,-24,25
Glentoran,3649,7,6,6,10,24,32,-8,24
Dungannon,3649,8,2,4,16,14,47,-33,10
Crusaders,3650,1,16,6,4,63,34,29,54
Coleraine,3650,2,14,11,1,44,23,21,53
Linfield,3650,3,11,5,10,38,36,2,38
Glenavon,3650,4,9,10,7,53,44,9,37
Cliftonville,3650,5,9,4,13,32,32,0,31
Ballymena,3650,6,8,4,14,29,49,-20,28
Glentoran,3650,7,6,6,10,24,32,-8,24
Dungannon,3650,8,2,4,16,14,47,-33,10
Coleraine,3651,1,15,10,1,46,23,23,55
Crusaders,3651,2,16,6,4,61,31,30,54
Linfield,3651,3,11,5,10,39,37,2,38
Glenavon,3651,4,9,9,8,53,46,7,36
Cliftonville,3651,5,9,4,13,33,33,0,31
Ballymena,3651,6,8,4,14,26,47,-21,28
Glentoran,3651,7,6,6,10,24,32,-8,24
Dungannon,3651,8,2,4,16,14,47,-33,10
Crusaders,3652,1,16,7,3,62,31,31,55
Coleraine,3652,2,14,10,2,44,24,20,52
Glenavon,3652,3,10,9,7,54,44,10,39
Linfield,3652,4,11,5,10,39,36,3,38
Cliftonville,3652,5,9,4,13,32,33,-1,31
Ballymena,3652,6,7,5,14,26,48,-22,26
Glentoran,3652,7,6,6,10,24,32,-8,24
Dungannon,3652,8,2,4,16,14,47,-33,10
Crusaders,3653,1,16,7,3,62,31,31,55
Coleraine,3653,2,14,10,2,44,25,19,52
Glenavon,3653,3,10,9,7,55,44,11,39
Linfield,3653,4,10,5,11,37,37,0,35
Cliftonville,3653,5,10,4,12,33,31,2,34
Ballymena,3653,6,7,5,14,26,48,-22,26
Glentoran,3653,7,6,6,10,24,32,-8,24
Dungannon,3653,8,2,4,16,14,47,-33,10
Crusaders,3654,1,17,6,3,64,31,33,57
Coleraine,3654,2,14,11,1,45,24,21,53
Glenavon,3654,3,9,10,7,54,45,9,37
Linfield,3654,4,10,5,11,37,38,-1,35
Cliftonville,3654,5,10,4,12,34,31,3,34
Ballymena,3654,6,7,4,15,26,50,-24,25
Glentoran,3654,7,6,6,10,24,32,-8,24
Dungannon,3654,8,2,4,16,14,47,-33,10
Coleraine,3655,1,15,10,1,47,24,23,55
Crusaders,3655,2,16,6,4,61,33,28,54
Glenavon,3655,3,9,9,8,54,47,7,36
Linfield,3655,4,10,6,10,37,36,1,36
Cliftonville,3655,5,9,5,12,32,31,1,32
Ballymena,3655,6,8,4,14,28,47,-19,28
Glentoran,3655,7,6,6,10,24,32,-8,24
Dungannon,3655,8,2,4,16,14,47,-33,10
Crusaders,3656,1,17,6,3,64,30,34,57
Coleraine,3656,2,14,11,1,44,23,21,53
Linfield,3656,3,11,5,10,38,36,2,38
Glenavon,3656,4,9,10,7,53,44,9,37
Cliftonville,3656,5,9,4,13,32,32,0,31
Ballymena,3656,6,7,4,15,25,50,-25,25
Glentoran,3656,7,6,6,10,24,32,-8,24
Dungannon,3656,8,2,4,16,14,47,-33,10
Crusaders,3657,1,17,6,3,63,31,32,57
Coleraine,3657,2,15,10,1,46,24,22,55
Linfield,3657,3,11,5,10,38,36,2,38
Glenavon,3657,4,9,9,8,54,46,8,36
Cliftonville,3657,5,9,4,13,32,32,0,31
Ballymena,3657,6,7,4,15,26,49,-23,25
Glentoran,3657,7,6,6,10,24,32,-8,24
Dungannon,3657,8,2,4,16,14,47,-33,10
Crusaders,3658,1,16,6,4,62,33,29,54
Coleraine,3658,2,14,11,1,44,23,21,53
Glenavon,3658,3,9,10,7,53,44,9,37
Linfield,3658,4,10,5,11,39,39,0,35
Cliftonville,3658,5,10,4,12,35,33,2,34
Ballymena,3658,6,8,4,14,28,48,-20,28
Glentoran,3658,7,6,6,10,24,32,-8,24
Dungannon,3658,8,2,4,16,14,47,-33,10
Crusaders,3659,1,17,6,3,64,30,34,57
Coleraine,3659,2,15,10,1,44,22,22,55
Linfield,3659,3,11,5,10,39,36,3,38
Glenavon,3659,4,9,9,8,52,44,8,36
Cliftonville,3659,5,9,4,13,32,33,-1,31
Ballymena,3659,6,7,4,15,25,50,-25,25
Glentoran,3659,7,6,6,10,24,32,-8,24
Dungannon,3659,8,2,4,16,14,47,-33,10
Crusaders,3660,1,16,7,3,62,31,31,55
Coleraine,3660,2,14,11,1,43,22,21,53
Glenavon,3660,3,9,10,7,52,43,9,37
Linfield,3660,4,10,6,10,39,38,1,36
Cliftonville,3660,5,9,5,12,34,33,1,32
Ballymena,3660,6,7,5,14,26,48,-22,26
Glentoran,3660,7,6,6,10,24,32,-8,24
Dungannon,3660,8,2,4,16,14,47,-33,10
Crusaders,3661,1,16,7,3,62,31,31,55
Coleraine,3661,2,14,11,1,46,25,21,53
Glenavon,3661,3,9,10,7,55,46,9,37
Linfield,3661,4,10,6,10,37,36,1,36
Cliftonville,3661,5,9,5,12,32,31,1,32
Ballymena,3661,6,7,5,14,26,48,-22,26
Glentoran,3661,7,6,6,10,24,32,-8,24
Dungannon,3661,8,2,4,16,14,47,-33,10
Crusaders,3662,1,16,6,4,64,34,30,54
Coleraine,3662,2,14,10,2,44,26,18,52
Glenavon,3662,3,10,9,7,56,44,12,39
Linfield,3662,4,10,5,11,38,38,0,35
Cliftonville,3662,5,10,4,12,34,32,2,34
Ballymena,3662,6,8,4,14,29,50,-21,28
Glentoran,3662,7,6,6,10,24,32,-8,24
Dungannon,3662,8,2,4,16,14,47,-33,10
Crusaders,3663,1,17,6,3,66,31,35,57
Coleraine,3663,2,14,11,1,44,23,21,53
Glenavon,3663,3,9,10,7,53,44,9,37
Linfield,3663,4,10,5,11,38,38,0,35
Cliftonville,3663,5,10,4,12,34,32,2,34
Ballymena,3663,6,7,4,15,26,52,-26,25
Glentoran,3663,7,6,6,10,24,32,-8,24
Dungannon,3663,8,2,4,16,14,47,-33,10
Coleraine,3664,1,15,10,1,45,23,22,55
Crusaders,3664,2,16,6,4,62,33,29,54
Linfield,3664,3,11,5,10,42,37,5,38
Glenavon,3664,4,9,9,8,53,45,8,36
Cliftonville,3664,5,9,4,13,33,36,-3,31
Ballymena,3664,6,8,4,14,28,48,-20,28
Glentoran,3664,7,6,6,10,24,32,-8,24
Dungannon,3664,8,2,4,16,14,47,-33,10
Crusaders,3665,1,16,6,4,62,33,29,54
Coleraine,3665,2,14,10,2,43,23,20,52
Glenavon,3665,3,10,9,7,53,43,10,39
Linfield,3665,4,10,6,10,38,37,1,36
Cliftonville,3665,5,9,5,12,33,32,1,32
Ballymena,3665,6,8,4,14,28,48,-20,28
Glentoran,3665,7,6,6,10,24,32,-8,24
Dungannon,3665,8,2,4,16,14,47,-33,10
Crusaders,3666,1,17,6,3,67,30,37,57
Coleraine,3666,2,14,10,2,43,25,18,52
Glenavon,3666,3,10,9,7,55,43,12,39
Linfield,3666,4,10,5,11,37,37,0,35
Cliftonville,3666,5,10,4,12,33,31,2,34
Ballymena,3666,6,7,4,15,25,53,-28,25
Glentoran,3666,7,6,6,10,24,32,-8,24
Dungannon,3666,8,2,4,16,14,47,-33,10
Crusaders,3667,1,17,6,3,64,32,32,57
Coleraine,3667,2,15,10,1,44,22,22,55
Glenavon,3667,3,9,9,8,52,44,8,36
Linfield,3667,4,10,6,10,37,36,1,36
Cliftonville,3667,5,9,5,12,32,31,1,32
Ballymena,3667,6,7,4,15,27,50,-23,25
Glentoran,3667,7,6,6,10,24,32,-8,24
Dungannon,3667,8,2,4,16,14,47,-33,10
Crusaders,3668,1,17,6,3,65,30,35,57
Coleraine,3668,2,14,10,2,43,24,19,52
Glenavon,3668,3,10,9,7,54,43,11,39
Linfield,3668,4,11,5,10,40,38,2,38
Cliftonville,3668,5,9,4,13,34,34,0,31
Ballymena,3668,6,7,4,15,25,51,-26,25
Glentoran,3668,7,6,6,10,24,32,-8,24
Dungannon,3668,8,2,4,16,14,47,-33,10
Crusaders,3669,1,16,7,3,62,31,31,55
Coleraine,3669,2,14,10,2,43,24,19,52
Glenavon,3669,3,10,9,7,54,43,11,39
Linfield,3669,4,11,5,10,38,36,2,38
Cliftonville,3669,5,9,4,13,32,32,0,31
Ballymena,3669,6,7,5,14,26,48,-22,26
Glentoran,3669,7,6,6,10,24,32,-8,24
Dungannon,3669,8,2,4,16,14,47,-33,10
Crusaders,3670,1,16,6,4,62,32,30,54
Coleraine,3670,2,14,10,2,44,24,20,52
Glenavon,3670,3,10,9,7,54,44,10,39
Linfield,3670,4,10,6,10,39,38,1,36
Cliftonville,3670,5,9,5,12,34,33,1,32
Ballymena,3670,6,8,4,14,27,48,-21,28
Glentoran,3670,7,6,6,10,24,32,-8,24
Dungannon,3670,8,2,4,16,14,47,-33,10
Crusaders,3671,1,16,7,3,62,31,31,55
Coleraine,3671,2,14,10,2,43,27,16,52
Glenavon,3671,3,10,9,7,57,43,14,39
Linfield,3671,4,11,5,10,39,36,3,38
Cliftonville,3671,5,9,4,13,32,33,-1,31
Ballymena,3671,6,7,5,14,26,48,-22,26
Glentoran,3671,7,6,6,10,24,32,-8,24
Dungannon,3671,8,2,4,16,14,47,-33,10
Crusaders,3672,1,17,6,3,65,32,33,57
Coleraine,3672,2,14,10,2,44,24,20,52
Glenavon,3672,3,10,9,7,54,44,10,39
Linfield,3672,4,10,6,10,38,37,1,36
Cliftonville,3672,5,9,5,12,33,32,1,32
Ballymena,3672,6,7,4,15,27,51,-24,25
Glentoran,3672,7,6,6,10,24,32,-8,24
Dungannon,3672,8,2,4,16,14,47,-33,10
Crusaders,3673,1,17,6,3,65,30,35,57
Coleraine,3673,2,14,11,1,46,25,21,53
Glenavon,3673,3,9,10,7,55,46,9,37
Linfield,3673,4,10,6,10,39,38,1,36
Cliftonville,3673,5,9,5,12,34,33,1,32
Ballymena,3673,6,7,4,15,25,51,-26,25
Glentoran,3673,7,6,6,10,24,32,-8,24
Dungannon,3673,8,2,4,16,14,47,-33,10
Crusaders,3674,1,16,7,3,62,31,31,55
Coleraine,3674,2,14,10,2,43,23,20,52
Glenavon,3674,3,10,9,7,53,43,10,39
Linfield,3674,4,11,5,10,39,36,3,38
Cliftonville,3674,5,9,4,13,32,33,-1,31
Ballymena,3674,6,7,5,14,26,48,-22,26
Glentoran,3674,7,6,6,10,24,32,-8,24
Dungannon,3674,8,2,4,16,14,47,-33,10
Crusaders,3675,1,17,6,3,64,32,32,57
Coleraine,3675,2,15,10,1,46,22,24,55
Linfield,3675,3,11,5,10,38,36,2,38
Glenavon,3675,4,9,9,8,52,46,6,36
Cliftonville,3675,5,9,4,13,32,32,0,31
Ballymena,3675,6,7,4,15,27,50,-23,25
Glentoran,3675,7,6,6,10,24,32,-8,24
Dungannon,3675,8,2,4,16,14,47,-33,10
Crusaders,3676,1,17,6,3,63,31,32,57
Coleraine,3676,2,14,11,1,44,23,21,53
Glenavon,3676,3,9,10,7,53,44,9,37
Linfield,3676,4,10,5,11,37,37,0,35
Cliftonville,3676,5,10,4,12,33,31,2,34
Ballymena,3676,6,7,4,15,26,49,-23,25
Glentoran,3676,7,6,6,10,24,32,-8,24
Dungannon,3676,8,2,4,16,14,47,-33,10
Crusaders,3677,1,17,6,3,66,30,36,57
Coleraine,3677,2,14,11,1,44,23,21,53
Linfield,3677,3,11,5,10,39,37,2,38
Glenavon,3677,4,9,10,7,53,44,9,37
Cliftonville,3677,5,9,4,13,33,33,0,31
Ballymena,3677,6,7,4,15,25,52,-27,25
Glentoran,3677,7,6,6,10,24,32,-8,24
Dungannon,3677,8,2,4,16,14,47,-33,10
Crusaders,3678,1,17,6,3,62,30,32,57
Coleraine,3678,2,14,10,2,44,24,20,52
Glenavon,3678,3,10,9,7,54,44,10,39
Linfield,3678,4,11,5,10,40,37,3,38
Cliftonville,3678,5,9,4,13,33,34,-1,31
Ballymena,3678,6,7,4,15,25,48,-23,25
Glentoran,3678,7,6,6,10,24,32,-8,24
Dungannon,3678,8,2,4,16,14,47,-33,10
Crusaders,3679,1,17,6,3,63,31,32,57
Coleraine,3679,2,14,10,2,43,23,20,52
Glenavon,3679,3,10,9,7,53,43,10,39
Linfield,3679,4,11,5,10,39,36,3,38
Cliftonville,3679,5,9,4,13,32,33,-1,31
Ballymena,3679,6,7,4,15,26,49,-23,25
Glentoran,3679,7,6,6,10,24,32,-8,24
Dungannon,3679,8,2,4,16,14,47,-33,10
Crusaders,3680,1,16,6,4,61,32,29,54
Coleraine,3680,2,14,10,2,43,24,19,52
Glenavon,3680,3,10,9,7,54,43,11,39
Linfield,3680,4,11,5,10,39,36,3,38
Cliftonville,3680,5,9,4,13,32,33,-1,31
Ballymena,3680,6,8,4,14,27,47,-20,28
Glentoran,3680,7,6,6,10,24,32,-8,24
Dungannon,3680,8,2,4,16,14,47,-33,10
Crusaders,3681,1,17,6,3,62,30,32,57
Coleraine,3681,2,14,11,1,45,24,21,53
Glenavon,3681,3,9,10,7,54,45,9,37
Linfield,3681,4,10,5,11,38,38,0,35
Cliftonville,3681,5,10,4,12,34,32,2,34
Ballymena,3681,6,7,4,15,25,48,-23,25
Glentoran,3681,7,6,6,10,24,32,-8,24
Dungannon,3681,8,2,4,16,14,47,-33,10
Crusaders,3682,1,17,6,3,64,31,33,57
Coleraine,3682,2,15,10,1,45,23,22,55
Glenavon,3682,3,9,9,8,53,45,8,36
Linfield,3682,4,10,5,11,37,38,-1,35
Cliftonville,3682,5,10,4,12,34,31,3,34
Ballymena,3682,6,7,4,15,26,50,-24,25
Glentoran,3682,7,6,6,10,24,32,-8,24
Dungannon,3682,8,2,4,16,14,47,-33,10
Crusaders,3683,1,16,6,4,61,31,30,54
Coleraine,3683,2,14,10,2,44,25,19,52
Glenavon,3683,3,10,9,7,55,44,11,39
Linfield,3683,4,11,5,10,41,37,4,38
Cliftonville,3683,5,9,4,13,33,35,-2,31
Ballymena,3683,6,8,4,14,26,47,-21,28
Glentoran,3683,7,6,6,10,24,32,-8,24
Dungannon,3683,8,2,4,16,14,47,-33,10
Crusaders,3684,1,16,6,4,63,33,30,54
Coleraine,3684,2,14,10,2,44,24,20,52
Glenavon,3684,3,10,9,7,54,44,10,39
Linfield,3684,4,11,5,10,40,36,4,38
Cliftonville,3684,5,9,4,13,32,34,-2,31
Ballymena,3684,6,8,4,14,28,49,-21,28
Glentoran,3684,7,6,6,10,24,32,-8,24
Dungannon,3684,8,2,4,16,14,47,-33,10
Coleraine,3685,1,15,10,1,45,23,22,55
Crusaders,3685,2,16,6,4,62,32,30,54
Linfield,3685,3,11,5,10,39,37,2,38
Glenavon,3685,4,9,9,8,53,45,8,36
Cliftonville,3685,5,9,4,13,33,33,0,31
Ballymena,3685,6,8,4,14,27,48,-21,28
Glentoran,3685,7,6,6,10,24,32,-8,24
Dungannon,3685,8,2,4,16,14,47,-33,10
Crusaders,3686,1,17,6,3,64,31,33,57
Coleraine,3686,2,15,10,1,45,23,22,55
Glenavon,3686,3,9,9,8,53,45,8,36
Linfield,3686,4,10,5,11,37,37,0,35
Cliftonville,3686,5,10,4,12,33,31,2,34
Ballymena,3686,6,7,4,15,26,50,-24,25
Glentoran,3686,7,6,6,10,24,32,-8,24
Dungannon,3686,8,2,4,16,14,47,-33,10
Crusaders,3687,1,16,6,4,62,32,30,54
Coleraine,3687,2,14,11,1,43,22,21,53
Glenavon,3687,3,9,10,7,52,43,9,37
Linfield,3687,4,10,5,11,39,40,-1,35
Cliftonville,3687,5,10,4,12,36,33,3,34
Ballymena,3687,6,8,4,14,27,48,-21,28
Glentoran,3687,7,6,6,10,24,32,-8,24
Dungannon,3687,8,2,4,16,14,47,-33,10
Crusaders,3688,1,17,6,3,62,30,32,57
Coleraine,3688,2,14,11,1,44,23,21,53
Glenavon,3688,3,9,10,7,53,44,9,37
Linfield,3688,4,10,5,11,37,37,0,35
Cliftonville,3688,5,10,4,12,33,31,2,34
Ballymena,3688,6,7,4,15,25,48,-23,25
Glentoran,3688,7,6,6,10,24,32,-8,24
Dungannon,3688,8,2,4,16,14,47,-33,10
Crusaders,3689,1,17,6,3,63,30,33,57
Coleraine,3689,2,14,10,2,43,23,20,52
Glenavon,3689,3,10,9,7,53,43,10,39
Linfield,3689,4,11,5,10,40,38,2,38
Cliftonville,3689,5,9,4,13,34,34,0,31
Ballymena,3689,6,7,4,15,25,49,-24,25
Glentoran,3689,7,6,6,10,24,32,-8,24
Dungannon,3689,8,2,4,16,14,47,-33,10
Crusaders,3690,1,16,6,4,61,31,30,54
Coleraine,3690,2,14,10,2,44,25,19,52
Glenavon,3690,3,10,9,7,55,44,11,39
Linfield,3690,4,10,5,11,37,38,-1,35
Cliftonville,3690,5,10,4,12,34,31,3,34
Ballymena,3690,6,8,4,14,26,47,-21,28
Glentoran,3690,7,6,6,10,24,32,-8,24
Dungannon,3690,8,2,4,16,14,47,-33,10
Crusaders,3691,1,16,7,3,64,33,31,55
Coleraine,3691,2,15,10,1,44,22,22,55
Glenavon,3691,3,9,9,8,52,44,8,36
Linfield,3691,4,10,6,10,38,37,1,36
Cliftonville,3691,5,9,5,12,33,32,1,32
Ballymena,3691,6,7,5,14,28,50,-22,26
Glentoran,3691,7,6,6,10,24,32,-8,24
Dungannon,3691,8,2,4,16,14,47,-33,10
Crusaders,3692,1,17,6,3,62,30,32,57
Coleraine,3692,2,15,10,1,44,22,22,55
Linfield,3692,3,11,5,10,39,37,2,38
Glenavon,3692,4,9,9,8,52,44,8,36
Cliftonville,3692,5,9,4,13,33,33,0,31
Ballymena,3692,6,7,4,15,25,48,-23,25
Glentoran,3692,7,6,6,10,24,32,-8,24
Dungannon,3692,8,2,4,16,14,47,-33,10
Crusaders,3693,1,17,6,3,64,32,32,57
Coleraine,3693,2,15,10,1,44,22,22,55
Glenavon,3693,3,9,9,8,52,44,8,36
Linfield,3693,4,10,5,11,39,39,0,35
Cliftonville,3693,5,10,4,12,35,33,2,34
Ballymena,3693,6,7,4,15,27,50,-23,25
Glentoran,3693,7,6,6,10,24,32,-8,24
Dungannon,3693,8,2,4,16,14,47,-33,10
Crusaders,3694,1,16,6,4,62,33,29,54
Coleraine,3694,2,14,11,1,45,24,21,53
Linfield,3694,3,11,5,10,39,37,2,38
Glenavon,3694,4,9,10,7,54,45,9,37
Cliftonville,3694,5,9,4,13,33,33,0,31
Ballymena,3694,6,8,4,14,28,48,-20,28
Glentoran,3694,7,6,6,10,24,32,-8,24
Dungannon,3694,8,2,4,16,14,47,-33,10
Crusaders,3695,1,17,6,3,65,31,34,57
Coleraine,3695,2,15,10,1,47,24,23,55
Linfield,3695,3,11,5,10,38,36,2,38
Glenavon,3695,4,9,9,8,54,47,7,36
Cliftonville,3695,5,9,4,13,32,32,0,31
Ballymena,3695,6,7,4,15,26,51,-25,25
Glentoran,3695,7,6,6,10,24,32,-8,24
Dungannon,3695,8,2,4,16,14,47,-33,10
Crusaders,3696,1,16,7,3,63,32,31,55
Coleraine,3696,2,14,11,1,44,23,21,53
Linfield,3696,3,11,5,10,38,36,2,38
Glenavon,3696,4,9,10,7,53,44,9,37
Cliftonville,3696,5,9,4,13,32,32,0,31
Ballymena,3696,6,7,5,14,27,49,-22,26
Glentoran,3696,7,6,6,10,24,32,-8,24
Dungannon,3696,8,2,4,16,14,47,-33,10
Crusaders,3697,1,17,6,3,64,31,33,57
Coleraine,3697,2,14,10,2,43,23,20,52
Glenavon,3697,3,10,9,7,53,43,10,39
Linfield,3697,4,10,5,11,39,39,0,35
Cliftonville,3697,5,10,4,12,35,33,2,34
Ballymena,3697,6,7,4,15,26,50,-24,25
Glentoran,3697,7,6,6,10,24,32,-8,24
Dungannon,3697,8,2,4,16,14,47,-33,10
Crusaders,3698,1,17,6,3,66,30,36,57
Coleraine,3698,2,14,10,2,43,24,19,52
Glenavon,3698,3,10,9,7,54,43,11,39
Linfield,3698,4,11,5,10,40,37,3,38
Cliftonville,3698,5,9,4,13,33,34,-1,31
Ballymena,3698,6,7,4,15,25,52,-27,25
Glentoran,3698,7,6,6,10,24,32,-8,24
Dungannon,3698,8,2,4,16,14,47,-33,10
Crusaders,3699,1,16,6,4,63,34,29,54
Coleraine,3699,2,14,11,1,44,23,21,53
Glenavon,3699,3,9,10,7,53,44,9,37
Linfield,3699,4,10,6,10,38,37,1,36
Cliftonville,3699,5,9,5,12,33,32,1,32
Ballymena,3699,6,8,4,14,29,49,-20,28
Glentoran,3699,7,6,6,10,24,32,-8,24
Dungannon,3699,8,2,4,16,14,47,-33,10
Crusaders,3700,1,16,7,3,62,31,31,55
Coleraine,3700,2,15,10,1,46,22,24,55
Linfield,3700,3,11,5,10,40,36,4,38
Glenavon,3700,4,9,9,8,52,46,6,36
Cliftonville,3700,5,9,4,13,32,34,-2,31
Ballymena,3700,6,7,5,14,26,48,-22,26
Glentoran,3700,7,6,6,10,24,32,-8,24
Dungannon,3700,8,2,4,16,14,47,-33,10
Crusaders,3701,1,17,6,3,64,30,34,57
Coleraine,3701,2,14,10,2,46,27,19,52
Glenavon,3701,3,10,9,7,57,46,11,39
Linfield,3701,4,10,6,10,39,38,1,36
Cliftonville,3701,5,9,5,12,34,33,1,32
Ballymena,3701,6,7,4,15,25,50,-25,25
Glentoran,3701,7,6,6,10,24,32,-8,24
Dungannon,3701,8,2,4,16,14,47,-33,10
Crusaders,3702,1,17,6,3,63,31,32,57
Coleraine,3702,2,14,10,2,44,25,19,52
Glenavon,3702,3,10,9,7,55,44,11,39
Linfield,3702,4,10,6,10,38,37,1,36
Cliftonville,3702,5,9,5,12,33,32,1,32
Ballymena,3702,6,7,4,15,26,49,-23,25
Glentoran,3702,7,6,6,10,24,32,-8,24
Dungannon,3702,8,2,4,16,14,47,-33,10
Crusaders,3703,1,17,6,3,63,31,32,57
Coleraine,3703,2,14,11,1,45,24,21,53
Linfield,3703,3,11,5,10,41,38,3,38
Glenavon,3703,4,9,10,7,54,45,9,37
Cliftonville,3703,5,9,4,13,34,35,-1,31
Ballymena,3703,6,7,4,15,26,49,-23,25
Glentoran,3703,7,6,6,10,24,32,-8,24
Dungannon,3703,8,2,4,16,14,47,-33,10
Crusaders,3704,1,16,6,4,61,32,29,54
Coleraine,3704,2,14,11,1,45,24,21,53
Linfield,3704,3,11,5,10,39,36,3,38
Glenavon,3704,4,9,10,7,54,45,9,37
Cliftonville,3704,5,9,4,13,32,33,-1,31
Ballymena,3704,6,8,4,14,27,47,-20,28
Glentoran,3704,7,6,6,10,24,32,-8,24
Dungannon,3704,8,2,4,16,14,47,-33,10
Crusaders,3705,1,17,6,3,65,31,34,57
Coleraine,3705,2,14,10,2,43,23,20,52
Glenavon,3705,3,10,9,7,53,43,10,39
Linfield,3705,4,11,5,10,38,36,2,38
Cliftonville,3705,5,9,4,13,32,32,0,31
Ballymena,3705,6,7,4,15,26,51,-25,25
Glentoran,3705,7,6,6,10,24,32,-8,24
Dungannon,3705,8,2,4,16,14,47,-33,10
Crusaders,3706,1,17,6,3,63,30,33,57
Coleraine,3706,2,14,10,2,46,26,20,52
Glenavon,3706,3,10,9,7,56,46,10,39
Linfield,3706,4,11,5,10,40,38,2,38
Cliftonville,3706,5,9,4,13,34,34,0,31
Ballymena,3706,6,7,4,15,25,49,-24,25
Glentoran,3706,7,6,6,10,24,32,-8,24
Dungannon,3706,8,2,4,16,14,47,-33,10
Coleraine,3707,1,15,10,1,44,22,22,55
Crusaders,3707,2,16,6,4,62,32,30,54
Linfield,3707,3,11,5,10,40,37,3,38
Glenavon,3707,4,9,9,8,52,44,8,36
Cliftonville,3707,5,9,4,13,33,34,-1,31
Ballymena,3707,6,8,4,14,27,48,-21,28
Glentoran,3707,7,6,6,10,24,32,-8,24
Dungannon,3707,8,2,4,16,14,47,-33,10
Coleraine,3708,1,15,10,1,45,23,22,55
Crusaders,3708,2,16,6,4,62,33,29,54
Glenavon,3708,3,9,9,8,53,45,8,36
Linfield,3708,4,10,6,10,38,37,1,36
Cliftonville,3708,5,9,5,12,33,32,1,32
Ballymena,3708,6,8,4,14,28,48,-20,28
Glentoran,3708,7,6,6,10,24,32,-8,24
Dungannon,3708,8,2,4,16,14,47,-33,10
Crusaders,3709,1,16,6,4,61,31,30,54
Coleraine,3709,2,14,10,2,44,24,20,52
Glenavon,3709,3,10,9,7,54,44,10,39
Linfield,3709,4,10,6,10,38,37,1,36
Cliftonville,3709,5,9,5,12,33,32,1,32
Ballymena,3709,6,8,4,14,26,47,-21,28
Glentoran,3709,7,6,6,10,24,32,-8,24
Dungannon,3709,8,2,4,16,14,47,-33,10
Crusaders,3710,1,16,7,3,63,32,31,55
Coleraine,3710,2,15,10,1,47,24,23,55
Glenavon,3710,3,9,9,8,54,47,7,36
Linfield,3710,4,10,5,11,39,39,0,35
Cliftonville,3710,5,10,4,12,35,33,2,34
Ballymena,3710,6,7,5,14,27,49,-22,26
Glentoran,3710,7,6,6,10,24,32,-8,24
Dungannon,3710,8,2,4,16,14,47,-33,10
Crusaders,3711,1,17,6,3,63,31,32,57
Coleraine,3711,2,15,10,1,46,24,22,55
Glenavon,3711,3,9,9,8,54,46,8,36
Linfield,3711,4,10,6,10,39,38,1,36
Cliftonville,3711,5,9,5,12,34,33,1,32
Ballymena,3711,6,7,4,15,26,49,-23,25
Glentoran,3711,7,6,6,10,24,32,-8,24
Dungannon,3711,8,2,4,16,14,47,-33,10
Crusaders,3712,1,17,6,3,64,30,34,57
Coleraine,3712,2,14,10,2,43,23,20,52
Glenavon,3712,3,10,9,7,53,43,10,39
Linfield,3712,4,11,5,10,38,36,2,38
Cliftonville,3712,5,9,4,13,32,32,0,31
Ballymena,3712,6,7,4,15,25,50,-25,25
Glentoran,3712,7,6,6,10,24,32,-8,24
Dungannon,3712,8,2,4,16,14,47,-33,10
Coleraine,3713,1,15,10,1,44,22,22,55
Crusaders,3713,2,16,6,4,62,32,30,54
Glenavon,3713,3,9,9,8,52,44,8,36
Linfield,3713,4,10,5,11,37,39,-2,35
Cliftonville,3713,5,10,4,12,35,31,4,34
Ballymena,3713,6,8,4,14,27,48,-21,28
Glentoran,3713,7,6,6,10,24,32,-8,24
Dungannon,3713,8,2,4,16,14,47,-33,10
Crusaders,3714,1,16,7,3,61,30,31,55
Coleraine,3714,2,14,11,1,46,25,21,53
Linfield,3714,3,11,5,10,39,36,3,38
Glenavon,3714,4,9,10,7,55,46,9,37
Cliftonville,3714,5,9,4,13,32,33,-1,31
Ballymena,3714,6,7,5,14,25,47,-22,26
Glentoran,3714,7,6,6,10,24,32,-8,24
Dungannon,3714,8,2,4,16,14,47,-33,10
Crusaders,3715,1,16,7,3,63,32,31,55
Coleraine,3715,2,15,10,1,47,24,23,55
Glenavon,3715,3,9,9,8,54,47,7,36
Linfield,3715,4,10,5,11,37,37,0,35
Cliftonville,3715,5,10,4,12,33,31,2,34
Ballymena,3715,6,7,5,14,27,49,-22,26
Glentoran,3715,7,6,6,10,24,32,-8,24
Dungannon,3715,8,2,4,16,14,47,-33,10
Crusaders,3716,1,17,6,3,64,32,32,57
Coleraine,3716,2,15,10,1,44,22,22,55
Linfield,3716,3,11,5,10,41,36,5,38
Glenavon,3716,4,9,9,8,52,44,8,36
Cliftonville,3716,5,9,4,13,32,35,-3,31
Ballymena,3716,6,7,4,15,27,50,-23,25
Glentoran,3716,7,6,6,10,24,32,-8,24
Dungannon,3716,8,2,4,16,14,47,-33,10
Coleraine,3717,1,15,10,1,44,22,22,55
Crusaders,3717,2,16,6,4,62,32,30,54
Linfield,3717,3,11,5,10,40,36,4,38
Glenavon,3717,4,9,9,8,52,44,8,36
Cliftonville,3717,5,9,4,13,32,34,-2,31
Ballymena,3717,6,8,4,14,27,48,-21,28
Glentoran,3717,7,6,6,10,24,32,-8,24
Dungannon,3717,8,2,4,16,14,47,-33,10
Coleraine,3718,1,15,10,1,45,23,22,55
Crusaders,3718,2,16,6,4,63,33,30,54
Linfield,3718,3,11,5,10,38,36,2,38
Glenavon,3718,4,9,9,8,53,45,8,36
Cliftonville,3718,5,9,4,13,32,32,0,31
Ballymena,3718,6,8,4,14,28,49,-21,28
Glentoran,3718,7,6,6,10,24,32,-8,24
Dungannon,3718,8,2,4,16,14,47,-33,10
Crusaders,3719,1,16,6,4,63,33,30,54
Coleraine,3719,2,14,11,1,44,23,21,53
Linfield,3719,3,11,5,10,38,36,2,38
Glenavon,3719,4,9,10,7,53,44,9,37
Cliftonville,3719,5,9,4,13,32,32,0,31
Ballymena,3719,6,8,4,14,28,49,-21,28
Glentoran,3719,7,6,6,10,24,32,-8,24
Dungannon,3719,8,2,4,16,14,47,-33,10
Crusaders,3720,1,16,6,4,61,32,29,54
Coleraine,3720,2,14,11,1,45,24,21,53
Linfield,3720,3,11,5,10,39,36,3,38
Glenavon,3720,4,9,10,7,54,45,9,37
Cliftonville,3720,5,9,4,13,32,33,-1,31
Ballymena,3720,6,8,4,14,27,47,-20,28
Glentoran,3720,7,6,6,10,24,32,-8,24
Dungannon,3720,8,2,4,16,14,47,-33,10
Crusaders,3721,1,17,6,3,62,30,32,57
Coleraine,3721,2,14,10,2,44,25,19,52
Glenavon,3721,3,10,9,7,55,44,11,39
Linfield,3721,4,10,5,11,37,38,-1,35
Cliftonville,3721,5,10,4,12,34,31,3,34
Ballymena,3721,6,7,4,15,25,48,-23,25
Glentoran,3721,7,6,6,10,24,32,-8,24
Dungannon,3721,8,2,4,16,14,47,-33,10
Crusaders,3722,1,17,6,3,63,30,33,57
Coleraine,3722,2,14,10,2,44,24,20,52
Glenavon,3722,3,10,9,7,54,44,10,39
Linfield,3722,4,11,5,10,39,37,2,38
Cliftonville,3722,5,9,4,13,33,33,0,31
Ballymena,3722,6,7,4,15,25,49,-24,25
Glentoran,3722,7,6,6,10,24,32,-8,24
Dungannon,3722,8,2,4,16,14,47,-33,10
Crusaders,3723,1,17,6,3,62,30,32,57
Coleraine,3723,2,15,10,1,46,23,23,55
Linfield,3723,3,11,5,10,39,37,2,38
Glenavon,3723,4,9,9,8,53,46,7,36
Cliftonville,3723,5,9,4,13,33,33,0,31
Ballymena,3723,6,7,4,15,25,48,-23,25
Glentoran,3723,7,6,6,10,24,32,-8,24
Dungannon,3723,8,2,4,16,14,47,-33,10
Crusaders,3724,1,16,7,3,62,31,31,55
Coleraine,3724,2,14,10,2,44,24,20,52
Glenavon,3724,3,10,9,7,54,44,10,39
Linfield,3724,4,11,5,10,39,36,3,38
Cliftonville,3724,5,9,4,13,32,33,-1,31
Ballymena,3724,6,7,5,14,26,48,-22,26
Glentoran,3724,7,6,6,10,24,32,-8,24
Dungannon,3724,8,2,4,16,14,47,-33,10
Crusaders,3725,1,17,6,3,66,33,33,57
Coleraine,3725,2,15,10,1,45,23,22,55
Linfield,3725,3,11,5,10,41,38,3,38
Glenavon,3725,4,9,9,8,53,45,8,36
Cliftonville,3725,5,9,4,13,34,35,-1,31
Ballymena,3725,6,7,4,15,28,52,-24,25
Glentoran,3725,7,6,6,10,24,32,-8,24
Dungannon,3725,8,2,4,16,14,47,-33,10
Crusaders,3726,1,16,7,3,62,31,31,55
Coleraine,3726,2,14,11,1,43,22,21,53
Glenavon,3726,3,9,10,7,52,43,9,37
Linfield,3726,4,10,5,11,37,37,0,35
Cliftonville,3726,5,10,4,12,33,31,2,34
Ballymena,3726,6,7,5,14,26,48,-22,26
Glentoran,3726,7,6,6,10,24,32,-8,24
Dungannon,3726,8,2,4,16,14,47,-33,10
Crusaders,3727,1,16,7,3,63,32,31,55
Coleraine,3727,2,14,10,2,44,27,17,52
Glenavon,3727,3,10,9,7,57,44,13,39
Linfield,3727,4,10,6,10,38,37,1,36
Cliftonville,3727,5,9,5,12,33,32,1,32
Ballymena,3727,6,7,5,14,27,49,-22,26
Glentoran,3727,7,6,6,10,24,32,-8,24
Dungannon,3727,8,2,4,16,14,47,-33,10
Crusaders,3728,1,16,7,3,63,32,31,55
Coleraine,3728,2,15,10,1,46,22,24,55
Linfield,3728,3,11,5,10,39,37,2,38
Glenavon,3728,4,9,9,8,52,46,6,36
Cliftonville,3728,5,9,4,13,33,33,0,31
Ballymena,3728,6,7,5,14,27,49,-22,26
Glentoran,3728,7,6,6,10,24,32,-8,24
Dungannon,3728,8,2,4,16,14,47,-33,10
Crusaders,3729,1,17,6,3,62,30,32,57
Coleraine,3729,2,14,11,1,43,22,21,53
Glenavon,3729,3,9,10,7,52,43,9,37
Linfield,3729,4,10,6,10,39,38,1,36
Cliftonville,3729,5,9,5,12,34,33,1,32
Ballymena,3729,6,7,4,15,25,48,-23,25
Glentoran,3729,7,6,6,10,24,32,-8,24
Dungannon,3729,8,2,4,16,14,47,-33,10
Crusaders,3730,1,17,6,3,62,30,32,57
Coleraine,3730,2,14,11,1,45,24,21,53
Glenavon,3730,3,9,10,7,54,45,9,37
Linfield,3730,4,10,5,11,37,39,-2,35
Cliftonville,3730,5,10,4,12,35,31,4,34
Ballymena,3730,6,7,4,15,25,48,-23,25
Glentoran,3730,7,6,6,10,24,32,-8,24
Dungannon,3730,8,2,4,16,14,47,-33,10
Crusaders,3731,1,16,7,3,62,31,31,55
Coleraine,3731,2,15,10,1,46,22,24,55
Glenavon,3731,3,9,9,8,52,46,6,36
Linfield,3731,4,10,5,11,38,38,0,35
Cliftonville,3731,5,10,4,12,34,32,2,34
Ballymena,3731,6,7,5,14,26,48,-22,26
Glentoran,3731,7,6,6,10,24,32,-8,24
Dungannon,3731,8,2,4,16,14,47,-33,10
Crusaders,3732,1,16,6,4,63,33,30,54
Coleraine,3732,2,14,10,2,44,24,20,52
Glenavon,3732,3,10,9,7,54,44,10,39
Linfield,3732,4,11,5,10,39,36,3,38
Cliftonville,3732,5,9,4,13,32,33,-1,31
Ballymena,3732,6,8,4,14,28,49,-21,28
Glentoran,3732,7,6,6,10,24,32,-8,24
Dungannon,3732,8,2,4,16,14,47,-33,10
Crusaders,3733,1,17,6,3,68,32,36,57
Coleraine,3733,2,14,11,1,47,26,21,53
Glenavon,3733,3,9,10,7,56,47,9,37
Linfield,3733,4,10,5,11,37,39,-2,35
Cliftonville,3733,5,10,4,12,35,31,4,34
Ballymena,3733,6,7,4,15,27,54,-27,25
Glentoran,3733,7,6,6,10,24,32,-8,24
Dungannon,3733,8,2,4,16,14,47,-33,10
Coleraine,3734,1,15,10,1,46,22,24,55
Crusaders,3734,2,16,6,4,61,31,30,54
Glenavon,3734,3,9,9,8,52,46,6,36
Linfield,3734,4,10,5,11,37,39,-2,35
Cliftonville,3734,5,10,4,12,35,31,4,34
Ballymena,3734,6,8,4,14,26,47,-21,28
Glentoran,3734,7,6,6,10,24,32,-8,24
Dungannon,3734,8,2,4,16,14,47,-33,10
Crusaders,3735,1,16,6,4,61,31,30,54
Coleraine,3735,2,14,10,2,43,24,19,52
Glenavon,3735,3,10,9,7,54,43,11,39
Linfield,3735,4,11,5,10,42,40,2,38
Cliftonville,3735,5,9,4,13,36,36,0,31
Ballymena,3735,6,8,4,14,26,47,-21,28
Glentoran,3735,7,6,6,10,24,32,-8,24
Dungannon,3735,8,2,4,16,14,47,-33,10
Crusaders,3736,1,17,6,3,68,30,38,57
Coleraine,3736,2,15,10,1,46,24,22,55
Glenavon,3736,3,9,9,8,54,46,8,36
Linfield,3736,4,10,5,11,38,39,-1,35
Cliftonville,3736,5,10,4,12,35,32,3,34
Ballymena,3736,6,7,4,15,25,54,-29,25
Glentoran,3736,7,6,6,10,24,32,-8,24
Dungannon,3736,8,2,4,16,14,47,-33,10
Crusaders,3737,1,17,6,3,64,31,33,57
Coleraine,3737,2,14,10,2,43,24,19,52
Glenavon,3737,3,10,9,7,54,43,11,39
Linfield,3737,4,10,6,10,37,36,1,36
Cliftonville,3737,5,9,5,12,32,31,1,32
Ballymena,3737,6,7,4,15,26,50,-24,25
Glentoran,3737,7,6,6,10,24,32,-8,24
Dungannon,3737,8,2,4,16,14,47,-33,10
Crusaders,3738,1,16,6,4,63,33,30,54
Coleraine,3738,2,14,11,1,44,23,21,53
Linfield,3738,3,11,5,10,38,36,2,38
Glenavon,3738,4,9,10,7,53,44,9,37
Cliftonville,3738,5,9,4,13,32,32,0,31
Ballymena,3738,6,8,4,14,28,49,-21,28
Glentoran,3738,7,6,6,10,24,32,-8,24
Dungannon,3738,8,2,4,16,14,47,-33,10
Crusaders,3739,1,17,6,3,66,31,35,57
Coleraine,3739,2,14,10,2,43,26,17,52
Glenavon,3739,3,10,9,7,56,43,13,39
Linfield,3739,4,11,5,10,41,37,4,38
Cliftonville,3739,5,9,4,13,33,35,-2,31
Ballymena,3739,6,7,4,15,26,52,-26,25
Glentoran,3739,7,6,6,10,24,32,-8,24
Dungannon,3739,8,2,4,16,14,47,-33,10
Crusaders,3740,1,17,6,3,64,31,33,57
Coleraine,3740,2,14,10,2,43,26,17,52
Glenavon,3740,3,10,9,7,56,43,13,39
Linfield,3740,4,11,5,10,39,36,3,38
Cliftonville,3740,5,9,4,13,32,33,-1,31
Ballymena,3740,6,7,4,15,26,50,-24,25
Glentoran,3740,7,6,6,10,24,32,-8,24
Dungannon,3740,8,2,4,16,14,47,-33,10
Crusaders,3741,1,17,6,3,63,31,32,57
Coleraine,3741,2,14,10,2,43,24,19,52
Glenavon,3741,3,10,9,7,54,43,11,39
Linfield,3741,4,10,6,10,38,37,1,36
Cliftonville,3741,5,9,5,12,33,32,1,32
Ballymena,3741,6,7,4,15,26,49,-23,25
Glentoran,3741,7,6,6,10,24,32,-8,24
Dungannon,3741,8,2,4,16,14,47,-33,10
Crusaders,3742,1,17,6,3,62,30,32,57
Coleraine,3742,2,14,11,1,44,23,21,53
Glenavon,3742,3,9,10,7,53,44,9,37
Linfield,3742,4,10,5,11,38,38,0,35
Cliftonville,3742,5,10,4,12,34,32,2,34
Ballymena,3742,6,7,4,15,25,48,-23,25
Glentoran,3742,7,6,6,10,24,32,-8,24
Dungannon,3742,8,2,4,16,14,47,-33,10
Crusaders,3743,1,16,7,3,62,31,31,55
Coleraine,3743,2,15,10,1,45,23,22,55
Linfield,3743,3,11,5,10,38,36,2,38
Glenavon,3743,4,9,9,8,53,45,8,36
Cliftonville,3743,5,9,4,13,32,32,0,31
Ballymena,3743,6,7,5,14,26,48,-22,26
Glentoran,3743,7,6,6,10,24,32,-8,24
Dungannon,3743,8,2,4,16,14,47,-33,10
Crusaders,3744,1,17,6,3,62,30,32,57
Coleraine,3744,2,15,10,1,47,23,24,55
Glenavon,3744,3,9,9,8,53,47,6,36
Linfield,3744,4,10,6,10,39,38,1,36
Cliftonville,3744,5,9,5,12,34,33,1,32
Ballymena,3744,6,7,4,15,25,48,-23,25
Glentoran,3744,7,6,6,10,24,32,-8,24
Dungannon,3744,8,2,4,16,14,47,-33,10
Crusaders,3745,1,16,6,4,62,33,29,54
Coleraine,3745,2,14,11,1,46,25,21,53
Linfield,3745,3,11,5,10,40,38,2,38
Glenavon,3745,4,9,10,7,55,46,9,37
Cliftonville,3745,5,9,4,13,34,34,0,31
Ballymena,3745,6,8,4,14,28,48,-20,28
Glentoran,3745,7,6,6,10,24,32,-8,24
Dungannon,3745,8,2,4,16,14,47,-33,10
Crusaders,3746,1,16,6,4,63,34,29,54
Coleraine,3746,2,14,11,1,44,23,21,53
Glenavon,3746,3,9,10,7,53,44,9,37
Linfield,3746,4,10,6,10,38,37,1,36
Cliftonville,3746,5,9,5,12,33,32,1,32
Ballymena,3746,6,8,4,14,29,49,-20,28
Glentoran,3746,7,6,6,10,24,32,-8,24
Dungannon,3746,8,2,4,16,14,47,-33,10
Crusaders,3747,1,17,6,3,64,31,33,57
Coleraine,3747,2,14,10,2,44,25,19,52
Glenavon,3747,3,10,9,7,55,44,11,39
Linfield,3747,4,10,5,11,38,40,-2,35
Cliftonville,3747,5,10,4,12,36,32,4,34
Ballymena,3747,6,7,4,15,26,50,-24,25
Glentoran,3747,7,6,6,10,24,32,-8,24
Dungannon,3747,8,2,4,16,14,47,-33,10
Crusaders,3748,1,16,6,4,62,32,30,54
Coleraine,3748,2,14,11,1,45,24,21,53
Glenavon,3748,3,9,10,7,54,45,9,37
Linfield,3748,4,10,5,11,37,39,-2,35
Cliftonville,3748,5,10,4,12,35,31,4,34
Ballymena,3748,6,8,4,14,27,48,-21,28
Glentoran,3748,7,6,6,10,24,32,-8,24
Dungannon,3748,8,2,4,16,14,47,-33,10
Crusaders,3749,1,17,6,3,62,30,32,57
Coleraine,3749,2,14,10,2,44,24,20,52
Glenavon,3749,3,10,9,7,54,44,10,39
Linfield,3749,4,10,5,11,37,39,-2,35
Cliftonville,3749,5,10,4,12,35,31,4,34
Ballymena,3749,6,7,4,15,25,48,-23,25
Glentoran,3749,7,6,6,10,24,32,-8,24
Dungannon,3749,8,2,4,16,14,47,-33,10
Crusaders,3750,1,16,6,4,63,33,30,54
Coleraine,3750,2,14,10,2,44,25,19,52
Glenavon,3750,3,10,9,7,55,44,11,39
Linfield,3750,4,11,5,10,39,36,3,38
Cliftonville,3750,5,9,4,13,32,33,-1,31
Ballymena,3750,6,8,4,14,28,49,-21,28
Glentoran,3750,7,6,6,10,24,32,-8,24
Dungannon,3750,8,2,4,16,14,47,-33,10
Crusaders,3751,1,17,6,3,66,30,36,57
Coleraine,3751,2,15,10,1,45,23,22,55
Glenavon,3751,3,9,9,8,53,45,8,36
Linfield,3751,4,10,6,10,38,37,1,36
Cliftonville,3751,5,9,5,12,33,32,1,32
Ballymena,3751,6,7,4,15,25,52,-27,25
Glentoran,3751,7,6,6,10,24,32,-8,24
Dungannon,3751,8,2,4,16,14,47,-33,10
Crusaders,3752,1,16,6,4,61,31,30,54
Coleraine,3752,2,14,10,2,43,23,20,52
Glenavon,3752,3,10,9,7,53,43,10,39
Linfield,3752,4,11,5,10,39,36,3,38
Cliftonville,3752,5,9,4,13,32,33,-1,31
Ballymena,3752,6,8,4,14,26,47,-21,28
Glentoran,3752,7,6,6,10,24,32,-8,24
Dungannon,3752,8,2,4,16,14,47,-33,10
Coleraine,3753,1,15,10,1,44,22,22,55
Crusaders,3753,2,16,6,4,62,33,29,54
Glenavon,3753,3,9,9,8,52,44,8,36
Linfield,3753,4,10,5,11,38,39,-1,35
Cliftonville,3753,5,10,4,12,35,32,3,34
Ballymena,3753,6,8,4,14,28,48,-20,28
Glentoran,3753,7,6,6,10,24,32,-8,24
Dungannon,3753,8,2,4,16,14,47,-33,10
Crusaders,3754,1,16,6,4,62,32,30,54
Coleraine,3754,2,14,10,2,45,25,20,52
Glenavon,3754,3,10,9,7,55,45,10,39
Linfield,3754,4,11,5,10,38,36,2,38
Cliftonville,3754,5,9,4,13,32,32,0,31
Ballymena,3754,6,8,4,14,27,48,-21,28
Glentoran,3754,7,6,6,10,24,32,-8,24
Dungannon,3754,8,2,4,16,14,47,-33,10
Crusaders,3755,1,17,6,3,62,30,32,57
Coleraine,3755,2,14,10,2,43,23,20,52
Glenavon,3755,3,10,9,7,53,43,10,39
Linfield,3755,4,10,6,10,38,37,1,36
Cliftonville,3755,5,9,5,12,33,32,1,32
Ballymena,3755,6,7,4,15,25,48,-23,25
Glentoran,3755,7,6,6,10,24,32,-8,24
Dungannon,3755,8,2,4,16,14,47,-33,10
Crusaders,3756,1,16,7,3,62,31,31,55
Coleraine,3756,2,15,10,1,47,25,22,55
Linfield,3756,3,11,5,10,38,36,2,38
Glenavon,3756,4,9,9,8,55,47,8,36
Cliftonville,3756,5,9,4,13,32,32,0,31
Ballymena,3756,6,7,5,14,26,48,-22,26
Glentoran,3756,7,6,6,10,24,32,-8,24
Dungannon,3756,8,2,4,16,14,47,-33,10
Crusaders,3757,1,16,7,3,63,32,31,55
Coleraine,3757,2,15,10,1,46,24,22,55
Glenavon,3757,3,9,9,8,54,46,8,36
Linfield,3757,4,10,5,11,38,40,-2,35
Cliftonville,3757,5,10,4,12,36,32,4,34
Ballymena,3757,6,7,5,14,27,49,-22,26
Glentoran,3757,7,6,6,10,24,32,-8,24
Dungannon,3757,8,2,4,16,14,47,-33,10
Crusaders,3758,1,17,6,3,63,30,33,57
Coleraine,3758,2,14,10,2,43,24,19,52
Glenavon,3758,3,10,9,7,54,43,11,39
Linfield,3758,4,10,5,11,39,39,0,35
Cliftonville,3758,5,10,4,12,35,33,2,34
Ballymena,3758,6,7,4,15,25,49,-24,25
Glentoran,3758,7,6,6,10,24,32,-8,24
Dungannon,3758,8,2,4,16,14,47,-33,10
Crusaders,3759,1,16,6,4,62,32,30,54
Coleraine,3759,2,14,10,2,43,24,19,52
Glenavon,3759,3,10,9,7,54,43,11,39
Linfield,3759,4,10,5,11,38,38,0,35
Cliftonville,3759,5,10,4,12,34,32,2,34
Ballymena,3759,6,8,4,14,27,48,-21,28
Glentoran,3759,7,6,6,10,24,32,-8,24
Dungannon,3759,8,2,4,16,14,47,-33,10
Crusaders,3760,1,16,7,3,64,33,31,55
Coleraine,3760,2,14,10,2,43,23,20,52
Glenavon,3760,3,10,9,7,53,43,10,39
Linfield,3760,4,10,6,10,38,37,1,36
Cliftonville,3760,5,9,5,12,33,32,1,32
Ballymena,3760,6,7,5,14,28,50,-22,26
Glentoran,3760,7,6,6,10,24,32,-8,24
Dungannon,3760,8,2,4,16,14,47,-33,10
Crusaders,3761,1,17,6,3,66,33,33,57
Coleraine,3761,2,14,10,2,43,23,20,52
Glenavon,3761,3,10,9,7,53,43,10,39
Linfield,3761,4,11,5,10,39,37,2,38
Cliftonville,3761,5,9,4,13,33,33,0,31
Ballymena,3761,6,7,4,15,28,52,-24,25
Glentoran,3761,7,6,6,10,24,32,-8,24
Dungannon,3761,8,2,4,16,14,47,-33,10
Crusaders,3762,1,17,6,3,62,30,32,57
Coleraine,3762,2,14,10,2,44,26,18,52
Glenavon,3762,3,10,9,7,56,44,12,39
Linfield,3762,4,11,5,10,39,36,3,38
Cliftonville,3762,5,9,4,13,32,33,-1,31
Ballymena,3762,6,7,4,15,25,48,-23,25
Glentoran,3762,7,6,6,10,24,32,-8,24
Dungannon,3762,8,2,4,16,14,47,-33,10
Crusaders,3763,1,16,6,4,61,31,30,54
Coleraine,3763,2,14,11,1,44,23,21,53
Glenavon,3763,3,9,10,7,53,44,9,37
Linfield,3763,4,10,5,11,39,39,0,35
Cliftonville,3763,5,10,4,12,35,33,2,34
Ballymena,3763,6,8,4,14,26,47,-21,28
Glentoran,3763,7,6,6,10,24,32,-8,24
Dungannon,3763,8,2,4,16,14,47,-33,10
Crusaders,3764,1,16,7,3,63,32,31,55
Coleraine,3764,2,14,10,2,43,25,18,52
Glenavon,3764,3,10,9,7,55,43,12,39
Linfield,3764,4,11,5,10,39,36,3,38
Cliftonville,3764,5,9,4,13,32,33,-1,31
Ballymena,3764,6,7,5,14,27,49,-22,26
Glentoran,3764,7,6,6,10,24,32,-8,24
Dungannon,3764,8,2,4,16,14,47,-33,10
Crusaders,3765,1,17,6,3,64,30,34,57
Coleraine,3765,2,14,11,1,45,24,21,53
Linfield,3765,3,11,5,10,39,36,3,38
Glenavon,3765,4,9,10,7,54,45,9,37
Cliftonville,3765,5,9,4,13,32,33,-1,31
Ballymena,3765,6,7,4,15,25,50,-25,25
Glentoran,3765,7,6,6,10,24,32,-8,24
Dungannon,3765,8,2,4,16,14,47,-33,10
Coleraine,3766,1,15,10,1,46,24,22,55
Crusaders,3766,2,16,6,4,62,33,29,54
Linfield,3766,3,11,5,10,38,36,2,38
Glenavon,3766,4,9,9,8,54,46,8,36
Cliftonville,3766,5,9,4,13,32,32,0,31
Ballymena,3766,6,8,4,14,28,48,-20,28
Glentoran,3766,7,6,6,10,24,32,-8,24
Dungannon,3766,8,2,4,16,14,47,-33,10
Crusaders,3767,1,16,6,4,62,32,30,54
Coleraine,3767,2,14,10,2,43,25,18,52
Glenavon,3767,3,10,9,7,55,43,12,39
Linfield,3767,4,11,5,10,39,37,2,38
Cliftonville,3767,5,9,4,13,33,33,0,31
Ballymena,3767,6,8,4,14,27,48,-21,28
Glentoran,3767,7,6,6,10,24,32,-8,24
Dungannon,3767,8,2,4,16,14,47,-33,10
Crusaders,3768,1,17,6,3,62,30,32,57
Coleraine,3768,2,14,11,1,44,23,21,53
Linfield,3768,3,11,5,10,39,36,3,38
Glenavon,3768,4,9,10,7,53,44,9,37
Cliftonville,3768,5,9,4,13,32,33,-1,31
Ballymena,3768,6,7,4,15,25,48,-23,25
Glentoran,3768,7,6,6,10,24,32,-8,24
Dungannon,3768,8,2,4,16,14,47,-33,10
Crusaders,3769,1,17,6,3,63,30,33,57
Coleraine,3769,2,14,10,2,43,23,20,52
Glenavon,3769,3,10,9,7,53,43,10,39
Linfield,3769,4,10,6,10,37,36,1,36
Cliftonville,3769,5,9,5,12,32,31,1,32
Ballymena,3769,6,7,4,15,25,49,-24,25
Glentoran,3769,7,6,6,10,24,32,-8,24
Dungannon,3769,8,2,4,16,14,47,-33,10
Coleraine,3770,1,15,10,1,45,23,22,55
Crusaders,3770,2,16,6,4,63,34,29,54
Glenavon,3770,3,9,9,8,53,45,8,36
Linfield,3770,4,10,5,11,37,37,0,35
Cliftonville,3770,5,10,4,12,33,31,2,34
Ballymena,3770,6,8,4,14,29,49,-20,28
Glentoran,3770,7,6,6,10,24,32,-8,24
Dungannon,3770,8,2,4,16,14,47,-33,10
Crusaders,3771,1,17,6,3,65,31,34,57
Coleraine,3771,2,15,10,1,46,23,23,55
Linfield,3771,3,11,5,10,38,36,2,38
Glenavon,3771,4,9,9,8,53,46,7,36
Cliftonville,3771,5,9,4,13,32,32,0,31
Ballymena,3771,6,7,4,15,26,51,-25,25
Glentoran,3771,7,6,6,10,24,32,-8,24
Dungannon,3771,8,2,4,16,14,47,-33,10
Crusaders,3772,1,16,6,4,62,33,29,54
Coleraine,3772,2,14,10,2,43,24,19,52
Glenavon,3772,3,10,9,7,54,43,11,39
Linfield,3772,4,10,6,10,39,38,1,36
Cliftonville,3772,5,9,5,12,34,33,1,32
Ballymena,3772,6,8,4,14,28,48,-20,28
Glentoran,3772,7,6,6,10,24,32,-8,24
Dungannon,3772,8,2,4,16,14,47,-33,10
Crusaders,3773,1,16,7,3,64,33,31,55
Coleraine,3773,2,15,10,1,45,23,22,55
Glenavon,3773,3,9,9,8,53,45,8,36
Linfield,3773,4,10,5,11,37,37,0,35
Cliftonville,3773,5,10,4,12,33,31,2,34
Ballymena,3773,6,7,5,14,28,50,-22,26
Glentoran,3773,7,6,6,10,24,32,-8,24
Dungannon,3773,8,2,4,16,14,47,-33,10
Crusaders,3774,1,17,6,3,65,30,35,57
Coleraine,3774,2,14,10,2,43,25,18,52
Glenavon,3774,3,10,9,7,55,43,12,39
Linfield,3774,4,11,5,10,38,36,2,38
Cliftonville,3774,5,9,4,13,32,32,0,31
Ballymena,3774,6,7,4,15,25,51,-26,25
Glentoran,3774,7,6,6,10,24,32,-8,24
Dungannon,3774,8,2,4,16,14,47,-33,10
Crusaders,3775,1,17,6,3,64,31,33,57
Coleraine,3775,2,15,10,1,45,23,22,55
Glenavon,3775,3,9,9,8,53,45,8,36
Linfield,3775,4,10,5,11,37,38,-1,35
Cliftonville,3775,5,10,4,12,34,31,3,34
Ballymena,3775,6,7,4,15,26,50,-24,25
Glentoran,3775,7,6,6,10,24,32,-8,24
Dungannon,3775,8,2,4,16,14,47,-33,10
Crusaders,3776,1,17,6,3,65,33,32,57
Coleraine,3776,2,14,11,1,44,23,21,53
Linfield,3776,3,11,5,10,41,38,3,38
Glenavon,3776,4,9,10,7,53,44,9,37
Cliftonville,3776,5,9,4,13,34,35,-1,31
Ballymena,3776,6,7,4,15,28,51,-23,25
Glentoran,3776,7,6,6,10,24,32,-8,24
Dungannon,3776,8,2,4,16,14,47,-33,10
Crusaders,3777,1,17,6,3,64,32,32,57
Coleraine,3777,2,15,10,1,48,24,24,55
Linfield,3777,3,11,5,10,39,36,3,38
Glenavon,3777,4,9,9,8,54,48,6,36
Cliftonville,3777,5,9,4,13,32,33,-1,31
Ballymena,3777,6,7,4,15,27,50,-23,25
Glentoran,3777,7,6,6,10,24,32,-8,24
Dungannon,3777,8,2,4,16,14,47,-33,10
Crusaders,3778,1,17,6,3,62,30,32,57
Coleraine,3778,2,14,11,1,45,24,21,53
Linfield,3778,3,11,5,10,39,36,3,38
Glenavon,3778,4,9,10,7,54,45,9,37
Cliftonville,3778,5,9,4,13,32,33,-1,31
Ballymena,3778,6,7,4,15,25,48,-23,25
Glentoran,3778,7,6,6,10,24,32,-8,24
Dungannon,3778,8,2,4,16,14,47,-33,10
Crusaders,3779,1,16,7,3,63,32,31,55
Coleraine,3779,2,14,11,1,45,24,21,53
Glenavon,3779,3,9,10,7,54,45,9,37
Linfield,3779,4,10,5,11,37,37,0,35
Cliftonville,3779,5,10,4,12,33,31,2,34
Ballymena,3779,6,7,5,14,27,49,-22,26
Glentoran,3779,7,6,6,10,24,32,-8,24
Dungannon,3779,8,2,4,16,14,47,-33,10
Crusaders,3780,1,17,6,3,63,31,32,57
Coleraine,3780,2,14,11,1,43,22,21,53
Linfield,3780,3,11,5,10,38,36,2,38
Glenavon,3780,4,9,10,7,52,43,9,37
Cliftonville,3780,5,9,4,13,32,32,0,31
Ballymena,3780,6,7,4,15,26,49,-23,25
Glentoran,3780,7,6,6,10,24,32,-8,24
Dungannon,3780,8,2,4,16,14,47,-33,10
Crusaders,3781,1,17,6,3,63,31,32,57
Coleraine,3781,2,15,10,1,45,23,22,55
Glenavon,3781,3,9,9,8,53,45,8,36
Linfield,3781,4,10,6,10,37,36,1,36
Cliftonville,3781,5,9,5,12,32,31,1,32
Ballymena,3781,6,7,4,15,26,49,-23,25
Glentoran,3781,7,6,6,10,24,32,-8,24
Dungannon,3781,8,2,4,16,14,47,-33,10
Crusaders,3782,1,17,6,3,65,31,34,57
Coleraine,3782,2,14,10,2,43,24,19,52
Glenavon,3782,3,10,9,7,54,43,11,39
Linfield,3782,4,10,6,10,38,37,1,36
Cliftonville,3782,5,9,5,12,33,32,1,32
Ballymena,3782,6,7,4,15,26,51,-25,25
Glentoran,3782,7,6,6,10,24,32,-8,24
Dungannon,3782,8,2,4,16,14,47,-33,10
Crusaders,3783,1,17,6,3,63,30,33,57
Coleraine,3783,2,14,10,2,45,25,20,52
Glenavon,3783,3,10,9,7,55,45,10,39
Linfield,3783,4,10,5,11,37,38,-1,35
Cliftonville,3783,5,10,4,12,34,31,3,34
Ballymena,3783,6,7,4,15,25,49,-24,25
Glentoran,3783,7,6,6,10,24,32,-8,24
Dungannon,3783,8,2,4,16,14,47,-33,10
Crusaders,3784,1,16,7,3,64,33,31,55
Coleraine,3784,2,15,10,1,49,22,27,55
Linfield,3784,3,11,5,10,38,36,2,38
Glenavon,3784,4,9,9,8,52,49,3,36
Cliftonville,3784,5,9,4,13,32,32,0,31
Ballymena,3784,6,7,5,14,28,50,-22,26
Glentoran,3784,7,6,6,10,24,32,-8,24
Dungannon,3784,8,2,4,16,14,47,-33,10
Crusaders,3785,1,17,6,3,63,30,33,57
Coleraine,3785,2,15,10,1,44,22,22,55
Linfield,3785,3,11,5,10,39,36,3,38
Glenavon,3785,4,9,9,8,52,44,8,36
Cliftonville,3785,5,9,4,13,32,33,-1,31
Ballymena,3785,6,7,4,15,25,49,-24,25
Glentoran,3785,7,6,6,10,24,32,-8,24
Dungannon,3785,8,2,4,16,14,47,-33,10
Crusaders,3786,1,17,6,3,64,31,33,57
Coleraine,3786,2,14,10,2,45,25,20,52
Glenavon,3786,3,10,9,7,55,45,10,39
Linfield,3786,4,10,5,11,37,39,-2,35
Cliftonville,3786,5,10,4,12,35,31,4,34
Ballymena,3786,6,7,4,15,26,50,-24,25
Glentoran,3786,7,6,6,10,24,32,-8,24
Dungannon,3786,8,2,4,16,14,47,-33,10
Crusaders,3787,1,16,7,3,63,32,31,55
Coleraine,3787,2,14,11,1,45,24,21,53
Glenavon,3787,3,9,10,7,54,45,9,37
Linfield,3787,4,10,6,10,38,37,1,36
Cliftonville,3787,5,9,5,12,33,32,1,32
Ballymena,3787,6,7,5,14,27,49,-22,26
Glentoran,3787,7,6,6,10,24,32,-8,24
Dungannon,3787,8,2,4,16,14,47,-33,10
Crusaders,3788,1,16,6,4,61,32,29,54
Coleraine,3788,2,14,11,1,45,24,21,53
Linfield,3788,3,11,5,10,39,37,2,38
Glenavon,3788,4,9,10,7,54,45,9,37
Cliftonville,3788,5,9,4,13,33,33,0,31
Ballymena,3788,6,8,4,14,27,47,-20,28
Glentoran,3788,7,6,6,10,24,32,-8,24
Dungannon,3788,8,2,4,16,14,47,-33,10
Crusaders,3789,1,17,6,3,63,30,33,57
Coleraine,3789,2,14,10,2,43,23,20,52
Glenavon,3789,3,10,9,7,53,43,10,39
Linfield,3789,4,11,5,10,40,37,3,38
Cliftonville,3789,5,9,4,13,33,34,-1,31
Ballymena,3789,6,7,4,15,25,49,-24,25
Glentoran,3789,7,6,6,10,24,32,-8,24
Dungannon,3789,8,2,4,16,14,47,-33,10
Crusaders,3790,1,17,6,3,64,30,34,57
Coleraine,3790,2,14,11,1,45,24,21,53
Glenavon,3790,3,9,10,7,54,45,9,37
Linfield,3790,4,10,6,10,39,38,1,36
Cliftonville,3790,5,9,5,12,34,33,1,32
Ballymena,3790,6,7,4,15,25,50,-25,25
Glentoran,3790,7,6,6,10,24,32,-8,24
Dungannon,3790,8,2,4,16,14,47,-33,10
Crusaders,3791,1,16,7,3,63,32,31,55
Coleraine,3791,2,14,11,1,43,22,21,53
Glenavon,3791,3,9,10,7,52,43,9,37
Linfield,3791,4,10,5,11,38,39,-1,35
Cliftonville,3791,5,10,4,12,35,32,3,34
Ballymena,3791,6,7,5,14,27,49,-22,26
Glentoran,3791,7,6,6,10,24,32,-8,24
Dungannon,3791,8,2,4,16,14,47,-33,10
Crusaders,3792,1,17,6,3,62,30,32,57
Coleraine,3792,2,15,10,1,46,22,24,55
Linfield,3792,3,11,5,10,40,38,2,38
Glenavon,3792,4,9,9,8,52,46,6,36
Cliftonville,3792,5,9,4,13,34,34,0,31
Ballymena,3792,6,7,4,15,25,48,-23,25
Glentoran,3792,7,6,6,10,24,32,-8,24
Dungannon,3792,8,2,4,16,14,47,-33,10
Crusaders,3793,1,16,6,4,61,32,29,54
Coleraine,3793,2,14,11,1,44,23,21,53
Linfield,3793,3,11,5,10,40,36,4,38
Glenavon,3793,4,9,10,7,53,44,9,37
Cliftonville,3793,5,9,4,13,32,34,-2,31
Ballymena,3793,6,8,4,14,27,47,-20,28
Glentoran,3793,7,6,6,10,24,32,-8,24
Dungannon,3793,8,2,4,16,14,47,-33,10
Crusaders,3794,1,16,7,3,63,32,31,55
Coleraine,3794,2,14,11,1,43,22,21,53
Glenavon,3794,3,9,10,7,52,43,9,37
Linfield,3794,4,10,5,11,38,39,-1,35
Cliftonville,3794,5,10,4,12,35,32,3,34
Ballymena,3794,6,7,5,14,27,49,-22,26
Glentoran,3794,7,6,6,10,24,32,-8,24
Dungannon,3794,8,2,4,16,14,47,-33,10
Crusaders,3795,1,17,6,3,63,31,32,57
Coleraine,3795,2,15,10,1,44,22,22,55
Glenavon,3795,3,9,9,8,52,44,8,36
Linfield,3795,4,10,5,11,38,39,-1,35
Cliftonville,3795,5,10,4,12,35,32,3,34
Ballymena,3795,6,7,4,15,26,49,-23,25
Glentoran,3795,7,6,6,10,24,32,-8,24
Dungannon,3795,8,2,4,16,14,47,-33,10
Crusaders,3796,1,16,7,3,62,31,31,55
Coleraine,3796,2,14,11,1,43,22,21,53
Linfield,3796,3,11,5,10,40,37,3,38
Glenavon,3796,4,9,10,7,52,43,9,37
Cliftonville,3796,5,9,4,13,33,34,-1,31
Ballymena,3796,6,7,5,14,26,48,-22,26
Glentoran,3796,7,6,6,10,24,32,-8,24
Dungannon,3796,8,2,4,16,14,47,-33,10
Crusaders,3797,1,16,6,4,62,32,30,54
Coleraine,3797,2,14,10,2,44,26,18,52
Glenavon,3797,3,10,9,7,56,44,12,39
Linfield,3797,4,10,5,11,38,38,0,35
Cliftonville,3797,5,10,4,12,34,32,2,34
Ballymena,3797,6,8,4,14,27,48,-21,28
Glentoran,3797,7,6,6,10,24,32,-8,24
Dungannon,3797,8,2,4,16,14,47,-33,10
Crusaders,3798,1,17,6,3,62,30,32,57
Coleraine,3798,2,15,10,1,45,23,22,55
Linfield,3798,3,11,5,10,39,37,2,38
Glenavon,3798,4,9,9,8,53,45,8,36
Cliftonville,3798,5,9,4,13,33,33,0,31
Ballymena,3798,6,7,4,15,25,48,-23,25
Glentoran,3798,7,6,6,10,24,32,-8,24
Dungannon,3798,8,2,4,16,14,47,-33,10
Crusaders,3799,1,16,7,3,62,31,31,55
Coleraine,3799,2,15,10,1,46,24,22,55
Glenavon,3799,3,9,9,8,54,46,8,36
Linfield,3799,4,10,6,10,37,36,1,36
Cliftonville,3799,5,9,5,12,32,31,1,32
Ballymena,3799,6,7,5,14,26,48,-22,26
Glentoran,3799,7,6,6,10,24,32,-8,24
Dungannon,3799,8,2,4,16,14,47,-33,10
Crusaders,3800,1,16,7,3,62,31,31,55
Coleraine,3800,2,14,10,2,43,23,20,52
Glenavon,3800,3,10,9,7,53,43,10,39
Linfield,3800,4,11,5,10,38,36,2,38
Cliftonville,3800,5,9,4,13,32,32,0,31
Ballymena,3800,6,7,5,14,26,48,-22,26
Glentoran,3800,7,6,6,10,24,32,-8,24
Dungannon,3800,8,2,4,16,14,47,-33,10
Crusaders,3801,1,16,6,4,61,32,29,54
Coleraine,3801,2,14,10,2,43,23,20,52
Glenavon,3801,3,10,9,7,53,43,10,39
Linfield,3801,4,11,5,10,39,37,2,38
Cliftonville,3801,5,9,4,13,33,33,0,31
Ballymena,3801,6,8,4,14,27,47,-20,28
Glentoran,3801,7,6,6,10,24,32,-8,24
Dungannon,3801,8,2,4,16,14,47,-33,10
Crusaders,3802,1,17,6,3,65,30,35,57
Coleraine,3802,2,15,10,1,44,22,22,55
Linfield,3802,3,11,5,10,39,37,2,38
Glenavon,3802,4,9,9,8,52,44,8,36
Cliftonville,3802,5,9,4,13,33,33,0,31
Ballymena,3802,6,7,4,15,25,51,-26,25
Glentoran,3802,7,6,6,10,24,32,-8,24
Dungannon,3802,8,2,4,16,14,47,-33,10
Crusaders,3803,1,16,7,3,62,31,31,55
Coleraine,3803,2,14,10,2,45,28,17,52
Glenavon,3803,3,10,9,7,58,45,13,39
Linfield,3803,4,11,5,10,38,36,2,38
Cliftonville,3803,5,9,4,13,32,32,0,31
Ballymena,3803,6,7,5,14,26,48,-22,26
Glentoran,3803,7,6,6,10,24,32,-8,24
Dungannon,3803,8,2,4,16,14,47,-33,10
Crusaders,3804,1,16,7,3,62,31,31,55
Coleraine,3804,2,14,10,2,43,24,19,52
Glenavon,3804,3,10,9,7,54,43,11,39
Linfield,3804,4,10,6,10,39,38,1,36
Cliftonville,3804,5,9,5,12,34,33,1,32
Ballymena,3804,6,7,5,14,26,48,-22,26
Glentoran,3804,7,6,6,10,24,32,-8,24
Dungannon,3804,8,2,4,16,14,47,-33,10
Crusaders,3805,1,17,6,3,65,31,34,57
Coleraine,3805,2,14,11,1,44,23,21,53
Glenavon,3805,3,9,10,7,53,44,9,37
Linfield,3805,4,10,5,11,38,41,-3,35
Cliftonville,3805,5,10,4,12,37,32,5,34
Ballymena,3805,6,7,4,15,26,51,-25,25
Glentoran,3805,7,6,6,10,24,32,-8,24
Dungannon,3805,8,2,4,16,14,47,-33,10
Crusaders,3806,1,17,6,3,63,30,33,57
Coleraine,3806,2,14,11,1,45,24,21,53
Glenavon,3806,3,9,10,7,54,45,9,37
Linfield,3806,4,10,6,10,37,36,1,36
Cliftonville,3806,5,9,5,12,32,31,1,32
Ballymena,3806,6,7,4,15,25,49,-24,25
Glentoran,3806,7,6,6,10,24,32,-8,24
Dungannon,3806,8,2,4,16,14,47,-33,10
Crusaders,3807,1,17,6,3,66,33,33,57
Coleraine,3807,2,14,10,2,44,26,18,52
Glenavon,3807,3,10,9,7,56,44,12,39
Linfield,3807,4,10,6,10,40,39,1,36
Cliftonville,3807,5,9,5,12,35,34,1,32
Ballymena,3807,6,7,4,15,28,52,-24,25
Glentoran,3807,7,6,6,10,24,32,-8,24
Dungannon,3807,8,2,4,16,14,47,-33,10
Crusaders,3808,1,17,6,3,64,32,32,57
Coleraine,3808,2,14,10,2,43,24,19,52
Glenavon,3808,3,10,9,7,54,43,11,39
Linfield,3808,4,11,5,10,39,36,3,38
Cliftonville,3808,5,9,4,13,32,33,-1,31
Ballymena,3808,6,7,4,15,27,50,-23,25
Glentoran,3808,7,6,6,10,24,32,-8,24
Dungannon,3808,8,2,4,16,14,47,-33,10
Crusaders,3809,1,16,6,4,62,33,29,54
Coleraine,3809,2,14,10,2,43,24,19,52
Glenavon,3809,3,10,9,7,54,43,11,39
Linfield,3809,4,10,6,10,38,37,1,36
Cliftonville,3809,5,9,5,12,33,32,1,32
Ballymena,3809,6,8,4,14,28,48,-20,28
Glentoran,3809,7,6,6,10,24,32,-8,24
Dungannon,3809,8,2,4,16,14,47,-33,10
Crusaders,3810,1,17,6,3,67,32,35,57
Coleraine,3810,2,15,10,1,46,22,24,55
Glenavon,3810,3,9,9,8,52,46,6,36
Linfield,3810,4,10,5,11,38,38,0,35
Cliftonville,3810,5,10,4,12,34,32,2,34
Ballymena,3810,6,7,4,15,27,53,-26,25
Glentoran,3810,7,6,6,10,24,32,-8,24
Dungannon,3810,8,2,4,16,14,47,-33,10
Crusaders,3811,1,17,6,3,63,30,33,57
Coleraine,3811,2,14,10,2,45,25,20,52
Glenavon,3811,3,10,9,7,55,45,10,39
Linfield,3811,4,10,6,10,39,38,1,36
Cliftonville,3811,5,9,5,12,34,33,1,32
Ballymena,3811,6,7,4,15,25,49,-24,25
Glentoran,3811,7,6,6,10,24,32,-8,24
Dungannon,3811,8,2,4,16,14,47,-33,10
Crusaders,3812,1,17,6,3,63,31,32,57
Coleraine,3812,2,15,10,1,46,24,22,55
Linfield,3812,3,11,5,10,40,38,2,38
Glenavon,3812,4,9,9,8,54,46,8,36
Cliftonville,3812,5,9,4,13,34,34,0,31
Ballymena,3812,6,7,4,15,26,49,-23,25
Glentoran,3812,7,6,6,10,24,32,-8,24
Dungannon,3812,8,2,4,16,14,47,-33,10
Crusaders,3813,1,17,6,3,66,34,32,57
Coleraine,3813,2,15,10,1,46,22,24,55
Glenavon,3813,3,9,9,8,52,46,6,36
Linfield,3813,4,10,5,11,37,37,0,35
Cliftonville,3813,5,10,4,12,33,31,2,34
Ballymena,3813,6,7,4,15,29,52,-23,25
Glentoran,3813,7,6,6,10,24,32,-8,24
Dungannon,3813,8,2,4,16,14,47,-33,10
Crusaders,3814,1,16,6,4,63,33,30,54
Coleraine,3814,2,14,10,2,43,23,20,52
Glenavon,3814,3,10,9,7,53,43,10,39
Linfield,3814,4,11,5,10,40,37,3,38
Cliftonville,3814,5,9,4,13,33,34,-1,31
Ballymena,3814,6,8,4,14,28,49,-21,28
Glentoran,3814,7,6,6,10,24,32,-8,24
Dungannon,3814,8,2,4,16,14,47,-33,10
Crusaders,3815,1,17,6,3,64,32,32,57
Coleraine,3815,2,14,10,2,43,27,16,52
Glenavon,3815,3,10,9,7,57,43,14,39
Linfield,3815,4,11,5,10,39,37,2,38
Cliftonville,3815,5,9,4,13,33,33,0,31
Ballymena,3815,6,7,4,15,27,50,-23,25
Glentoran,3815,7,6,6,10,24,32,-8,24
Dungannon,3815,8,2,4,16,14,47,-33,10
Crusaders,3816,1,17,6,3,63,31,32,57
Coleraine,3816,2,14,10,2,43,24,19,52
Glenavon,3816,3,10,9,7,54,43,11,39
Linfield,3816,4,11,5,10,39,37,2,38
Cliftonville,3816,5,9,4,13,33,33,0,31
Ballymena,3816,6,7,4,15,26,49,-23,25
Glentoran,3816,7,6,6,10,24,32,-8,24
Dungannon,3816,8,2,4,16,14,47,-33,10
Crusaders,3817,1,16,6,4,63,34,29,54
Coleraine,3817,2,14,11,1,45,24,21,53
Linfield,3817,3,11,5,10,39,36,3,38
Glenavon,3817,4,9,10,7,54,45,9,37
Cliftonville,3817,5,9,4,13,32,33,-1,31
Ballymena,3817,6,8,4,14,29,49,-20,28
Glentoran,3817,7,6,6,10,24,32,-8,24
Dungannon,3817,8,2,4,16,14,47,-33,10
Crusaders,3818,1,16,7,3,63,32,31,55
Coleraine,3818,2,14,10,2,43,25,18,52
Glenavon,3818,3,10,9,7,55,43,12,39
Linfield,3818,4,11,5,10,42,37,5,38
Cliftonville,3818,5,9,4,13,33,36,-3,31
Ballymena,3818,6,7,5,14,27,49,-22,26
Glentoran,3818,7,6,6,10,24,32,-8,24
Dungannon,3818,8,2,4,16,14,47,-33,10
Crusaders,3819,1,17,6,3,64,31,33,57
Coleraine,3819,2,15,10,1,45,23,22,55
Linfield,3819,3,11,5,10,40,37,3,38
Glenavon,3819,4,9,9,8,53,45,8,36
Cliftonville,3819,5,9,4,13,33,34,-1,31
Ballymena,3819,6,7,4,15,26,50,-24,25
Glentoran,3819,7,6,6,10,24,32,-8,24
Dungannon,3819,8,2,4,16,14,47,-33,10
Crusaders,3820,1,17,6,3,65,30,35,57
Coleraine,3820,2,14,10,2,45,27,18,52
Glenavon,3820,3,10,9,7,57,45,12,39
Linfield,3820,4,11,5,10,42,36,6,38
Cliftonville,3820,5,9,4,13,32,36,-4,31
Ballymena,3820,6,7,4,15,25,51,-26,25
Glentoran,3820,7,6,6,10,24,32,-8,24
Dungannon,3820,8,2,4,16,14,47,-33,10
Crusaders,3821,1,17,6,3,68,30,38,57
Coleraine,3821,2,15,10,1,44,22,22,55
Glenavon,3821,3,9,9,8,52,44,8,36
Linfield,3821,4,10,5,11,38,39,-1,35
Cliftonville,3821,5,10,4,12,35,32,3,34
Ballymena,3821,6,7,4,15,25,54,-29,25
Glentoran,3821,7,6,6,10,24,32,-8,24
Dungannon,3821,8,2,4,16,14,47,-33,10
Crusaders,3822,1,17,6,3,65,31,34,57
Coleraine,3822,2,15,10,1,47,22,25,55
Glenavon,3822,3,9,9,8,52,47,5,36
Linfield,3822,4,10,5,11,37,37,0,35
Cliftonville,3822,5,10,4,12,33,31,2,34
Ballymena,3822,6,7,4,15,26,51,-25,25
Glentoran,3822,7,6,6,10,24,32,-8,24
Dungannon,3822,8,2,4,16,14,47,-33,10
Crusaders,3823,1,17,6,3,62,30,32,57
Coleraine,3823,2,14,10,2,43,24,19,52
Glenavon,3823,3,10,9,7,54,43,11,39
Linfield,3823,4,11,5,10,40,36,4,38
Cliftonville,3823,5,9,4,13,32,34,-2,31
Ballymena,3823,6,7,4,15,25,48,-23,25
Glentoran,3823,7,6,6,10,24,32,-8,24
Dungannon,3823,8,2,4,16,14,47,-33,10
Crusaders,3824,1,16,7,3,61,30,31,55
Coleraine,3824,2,14,10,2,43,24,19,52
Glenavon,3824,3,10,9,7,54,43,11,39
Linfield,3824,4,10,5,11,39,41,-2,35
Cliftonville,3824,5,10,4,12,37,33,4,34
Ballymena,3824,6,7,5,14,25,47,-22,26
Glentoran,3824,7,6,6,10,24,32,-8,24
Dungannon,3824,8,2,4,16,14,47,-33,10
Crusaders,3825,1,17,6,3,66,32,34,57
Coleraine,3825,2,14,11,1,44,23,21,53
Glenavon,3825,3,9,10,7,53,44,9,37
Linfield,3825,4,10,6,10,37,36,1,36
Cliftonville,3825,5,9,5,12,32,31,1,32
Ballymena,3825,6,7,4,15,27,52,-25,25
Glentoran,3825,7,6,6,10,24,32,-8,24
Dungannon,3825,8,2,4,16,14,47,-33,10
Crusaders,3826,1,16,7,3,62,31,31,55
Coleraine,3826,2,14,11,1,43,22,21,53
Linfield,3826,3,11,5,10,40,36,4,38
Glenavon,3826,4,9,10,7,52,43,9,37
Cliftonville,3826,5,9,4,13,32,34,-2,31
Ballymena,3826,6,7,5,14,26,48,-22,26
Glentoran,3826,7,6,6,10,24,32,-8,24
Dungannon,3826,8,2,4,16,14,47,-33,10
Crusaders,3827,1,17,6,3,63,31,32,57
Coleraine,3827,2,14,10,2,44,24,20,52
Glenavon,3827,3,10,9,7,54,44,10,39
Linfield,3827,4,10,6,10,39,38,1,36
Cliftonville,3827,5,9,5,12,34,33,1,32
Ballymena,3827,6,7,4,15,26,49,-23,25
Glentoran,3827,7,6,6,10,24,32,-8,24
Dungannon,3827,8,2,4,16,14,47,-33,10
Crusaders,3828,1,17,6,3,63,30,33,57
Coleraine,3828,2,14,11,1,45,24,21,53
Glenavon,3828,3,9,10,7,54,45,9,37
Linfield,3828,4,10,5,11,37,38,-1,35
Cliftonville,3828,5,10,4,12,34,31,3,34
Ballymena,3828,6,7,4,15,25,49,-24,25
Glentoran,3828,7,6,6,10,24,32,-8,24
Dungannon,3828,8,2,4,16,14,47,-33,10
Crusaders,3829,1,17,6,3,62,30,32,57
Coleraine,3829,2,14,10,2,44,27,17,52
Glenavon,3829,3,10,9,7,57,44,13,39
Linfield,3829,4,11,5,10,38,36,2,38
Cliftonville,3829,5,9,4,13,32,32,0,31
Ballymena,3829,6,7,4,15,25,48,-23,25
Glentoran,3829,7,6,6,10,24,32,-8,24
Dungannon,3829,8,2,4,16,14,47,-33,10
Crusaders,3830,1,16,7,3,62,31,31,55
Coleraine,3830,2,14,10,2,43,24,19,52
Glenavon,3830,3,10,9,7,54,43,11,39
Linfield,3830,4,11,5,10,40,36,4,38
Cliftonville,3830,5,9,4,13,32,34,-2,31
Ballymena,3830,6,7,5,14,26,48,-22,26
Glentoran,3830,7,6,6,10,24,32,-8,24
Dungannon,3830,8,2,4,16,14,47,-33,10
Coleraine,3831,1,15,10,1,45,23,22,55
Crusaders,3831,2,16,6,4,63,33,30,54
Linfield,3831,3,11,5,10,39,36,3,38
Glenavon,3831,4,9,9,8,53,45,8,36
Cliftonville,3831,5,9,4,13,32,33,-1,31
Ballymena,3831,6,8,4,14,28,49,-21,28
Glentoran,3831,7,6,6,10,24,32,-8,24
Dungannon,3831,8,2,4,16,14,47,-33,10
Crusaders,3832,1,17,6,3,64,30,34,57
Coleraine,3832,2,14,10,2,45,29,16,52
Glenavon,3832,3,10,9,7,59,45,14,39
Linfield,3832,4,10,6,10,39,38,1,36
Cliftonville,3832,5,9,5,12,34,33,1,32
Ballymena,3832,6,7,4,15,25,50,-25,25
Glentoran,3832,7,6,6,10,24,32,-8,24
Dungannon,3832,8,2,4,16,14,47,-33,10
Crusaders,3833,1,17,6,3,64,31,33,57
Coleraine,3833,2,14,11,1,44,23,21,53
Linfield,3833,3,11,5,10,41,37,4,38
Glenavon,3833,4,9,10,7,53,44,9,37
Cliftonville,3833,5,9,4,13,33,35,-2,31
Ballymena,3833,6,7,4,15,26,50,-24,25
Glentoran,3833,7,6,6,10,24,32,-8,24
Dungannon,3833,8,2,4,16,14,47,-33,10
Crusaders,3834,1,16,7,3,63,32,31,55
Coleraine,3834,2,14,10,2,44,24,20,52
Glenavon,3834,3,10,9,7,54,44,10,39
Linfield,3834,4,11,5,10,39,37,2,38
Cliftonville,3834,5,9,4,13,33,33,0,31
Ballymena,3834,6,7,5,14,27,49,-22,26
Glentoran,3834,7,6,6,10,24,32,-8,24
Dungannon,3834,8,2,4,16,14,47,-33,10
Crusaders,3835,1,17,6,3,64,32,32,57
Coleraine,3835,2,15,10,1,46,23,23,55
Glenavon,3835,3,9,9,8,53,46,7,36
Linfield,3835,4,10,6,10,38,37,1,36
Cliftonville,3835,5,9,5,12,33,32,1,32
Ballymena,3835,6,7,4,15,27,50,-23,25
Glentoran,3835,7,6,6,10,24,32,-8,24
Dungannon,3835,8,2,4,16,14,47,-33,10
Crusaders,3836,1,16,7,3,63,32,31,55
Coleraine,3836,2,14,10,2,44,24,20,52
Glenavon,3836,3,10,9,7,54,44,10,39
Linfield,3836,4,10,5,11,38,38,0,35
Cliftonville,3836,5,10,4,12,34,32,2,34
Ballymena,3836,6,7,5,14,27,49,-22,26
Glentoran,3836,7,6,6,10,24,32,-8,24
Dungannon,3836,8,2,4,16,14,47,-33,10
Coleraine,3837,1,15,10,1,45,23,22,55
Crusaders,3837,2,16,6,4,63,33,30,54
Linfield,3837,3,11,5,10,40,37,3,38
Glenavon,3837,4,9,9,8,53,45,8,36
Cliftonville,3837,5,9,4,13,33,34,-1,31
Ballymena,3837,6,8,4,14,28,49,-21,28
Glentoran,3837,7,6,6,10,24,32,-8,24
Dungannon,3837,8,2,4,16,14,47,-33,10
Crusaders,3838,1,16,7,3,63,32,31,55
Coleraine,3838,2,14,11,1,44,23,21,53
Glenavon,3838,3,9,10,7,53,44,9,37
Linfield,3838,4,10,6,10,37,36,1,36
Cliftonville,3838,5,9,5,12,32,31,1,32
Ballymena,3838,6,7,5,14,27,49,-22,26
Glentoran,3838,7,6,6,10,24,32,-8,24
Dungannon,3838,8,2,4,16,14,47,-33,10
Crusaders,3839,1,16,6,4,62,32,30,54
Coleraine,3839,2,14,10,2,43,23,20,52
Glenavon,3839,3,10,9,7,53,43,10,39
Linfield,3839,4,11,5,10,40,36,4,38
Cliftonville,3839,5,9,4,13,32,34,-2,31
Ballymena,3839,6,8,4,14,27,48,-21,28
Glentoran,3839,7,6,6,10,24,32,-8,24
Dungannon,3839,8,2,4,16,14,47,-33,10
Crusaders,3840,1,17,6,3,62,30,32,57
Coleraine,3840,2,14,10,2,44,24,20,52
Glenavon,3840,3,10,9,7,54,44,10,39
Linfield,3840,4,11,5,10,38,36,2,38
Cliftonville,3840,5,9,4,13,32,32,0,31
Ballymena,3840,6,7,4,15,25,48,-23,25
Glentoran,3840,7,6,6,10,24,32,-8,24
Dungannon,3840,8,2,4,16,14,47,-33,10
Crusaders,3841,1,17,6,3,66,31,35,57
Coleraine,3841,2,14,10,2,44,24,20,52
Glenavon,3841,3,10,9,7,54,44,10,39
Linfield,3841,4,10,5,11,37,39,-2,35
Cliftonville,3841,5,10,4,12,35,31,4,34
Ballymena,3841,6,7,4,15,26,52,-26,25
Glentoran,3841,7,6,6,10,24,32,-8,24
Dungannon,3841,8,2,4,16,14,47,-33,10
Crusaders,3842,1,16,6,4,62,34,28,54
Coleraine,3842,2,14,10,2,43,25,18,52
Glenavon,3842,3,10,9,7,55,43,12,39
Linfield,3842,4,11,5,10,40,37,3,38
Cliftonville,3842,5,9,4,13,33,34,-1,31
Ballymena,3842,6,8,4,14,29,48,-19,28
Glentoran,3842,7,6,6,10,24,32,-8,24
Dungannon,3842,8,2,4,16,14,47,-33,10
Crusaders,3843,1,16,6,4,62,32,30,54
Coleraine,3843,2,14,10,2,43,24,19,52
Glenavon,3843,3,10,9,7,54,43,11,39
Linfield,3843,4,11,5,10,41,36,5,38
Cliftonville,3843,5,9,4,13,32,35,-3,31
Ballymena,3843,6,8,4,14,27,48,-21,28
Glentoran,3843,7,6,6,10,24,32,-8,24
Dungannon,3843,8,2,4,16,14,47,-33,10
Crusaders,3844,1,16,6,4,62,32,30,54
Coleraine,3844,2,14,10,2,43,23,20,52
Glenavon,3844,3,10,9,7,53,43,10,39
Linfield,3844,4,10,6,10,40,39,1,36
Cliftonville,3844,5,9,5,12,35,34,1,32
Ballymena,3844,6,8,4,14,27,48,-21,28
Glentoran,3844,7,6,6,10,24,32,-8,24
Dungannon,3844,8,2,4,16,14,47,-33,10
Crusaders,3845,1,17,6,3,64,30,34,57
Coleraine,3845,2,15,10,1,46,24,22,55
Linfield,3845,3,11,5,10,40,36,4,38
Glenavon,3845,4,9,9,8,54,46,8,36
Cliftonville,3845,5,9,4,13,32,34,-2,31
Ballymena,3845,6,7,4,15,25,50,-25,25
Glentoran,3845,7,6,6,10,24,32,-8,24
Dungannon,3845,8,2,4,16,14,47,-33,10
Crusaders,3846,1,17,6,3,64,30,34,57
Coleraine,3846,2,14,11,1,45,24,21,53
Glenavon,3846,3,9,10,7,54,45,9,37
Linfield,3846,4,10,5,11,37,38,-1,35
Cliftonville,3846,5,10,4,12,34,31,3,34
Ballymena,3846,6,7,4,15,25,50,-25,25
Glentoran,3846,7,6,6,10,24,32,-8,24
Dungannon,3846,8,2,4,16,14,47,-33,10
Crusaders,3847,1,16,6,4,62,32,30,54
Coleraine,3847,2,14,10,2,44,24,20,52
Glenavon,3847,3,10,9,7,54,44,10,39
Linfield,3847,4,10,6,10,37,36,1,36
Cliftonville,3847,5,9,5,12,32,31,1,32
Ballymena,3847,6,8,4,14,27,48,-21,28
Glentoran,3847,7,6,6,10,24,32,-8,24
Dungannon,3847,8,2,4,16,14,47,-33,10
Crusaders,3848,1,17,6,3,63,31,32,57
Coleraine,3848,2,14,10,2,43,24,19,52
Glenavon,3848,3,10,9,7,54,43,11,39
Linfield,3848,4,10,5,11,37,38,-1,35
Cliftonville,3848,5,10,4,12,34,31,3,34
Ballymena,3848,6,7,4,15,26,49,-23,25
Glentoran,3848,7,6,6,10,24,32,-8,24
Dungannon,3848,8,2,4,16,14,47,-33,10
Coleraine,3849,1,15,10,1,45,23,22,55
Crusaders,3849,2,16,6,4,63,33,30,54
Glenavon,3849,3,9,9,8,53,45,8,36
Linfield,3849,4,10,6,10,37,36,1,36
Cliftonville,3849,5,9,5,12,32,31,1,32
Ballymena,3849,6,8,4,14,28,49,-21,28
Glentoran,3849,7,6,6,10,24,32,-8,24
Dungannon,3849,8,2,4,16,14,47,-33,10
Coleraine,3850,1,15,10,1,44,22,22,55
Crusaders,3850,2,16,6,4,63,33,30,54
Glenavon,3850,3,9,9,8,52,44,8,36
Linfield,3850,4,10,6,10,38,37,1,36
Cliftonville,3850,5,9,5,12,33,32,1,32
Ballymena,3850,6,8,4,14,28,49,-21,28
Glentoran,3850,7,6,6,10,24,32,-8,24
Dungannon,3850,8,2,4,16,14,47,-33,10
Coleraine,3851,1,15,10,1,44,22,22,55
Crusaders,3851,2,16,6,4,61,31,30,54
Glenavon,3851,3,9,9,8,52,44,8,36
Linfield,3851,4,10,5,11,37,37,0,35
Cliftonville,3851,5,10,4,12,33,31,2,34
Ballymena,3851,6,8,4,14,26,47,-21,28
Glentoran,3851,7,6,6,10,24,32,-8,24
Dungannon,3851,8,2,4,16,14,47,-33,10
Crusaders,3852,1,16,7,3,64,33,31,55
Coleraine,3852,2,14,11,1,43,22,21,53
Linfield,3852,3,11,5,10,38,36,2,38
Glenavon,3852,4,9,10,7,52,43,9,37
Cliftonville,3852,5,9,4,13,32,32,0,31
Ballymena,3852,6,7,5,14,28,50,-22,26
Glentoran,3852,7,6,6,10,24,32,-8,24
Dungannon,3852,8,2,4,16,14,47,-33,10
Crusaders,3853,1,16,6,4,62,34,28,54
Coleraine,3853,2,14,10,2,45,28,17,52
Glenavon,3853,3,10,9,7,58,45,13,39
Linfield,3853,4,10,6,10,38,37,1,36
Cliftonville,3853,5,9,5,12,33,32,1,32
Ballymena,3853,6,8,4,14,29,48,-19,28
Glentoran,3853,7,6,6,10,24,32,-8,24
Dungannon,3853,8,2,4,16,14,47,-33,10
Crusaders,3854,1,16,6,4,61,31,30,54
Coleraine,3854,2,14,11,1,45,24,21,53
Glenavon,3854,3,9,10,7,54,45,9,37
Linfield,3854,4,10,6,10,38,37,1,36
Cliftonville,3854,5,9,5,12,33,32,1,32
Ballymena,3854,6,8,4,14,26,47,-21,28
Glentoran,3854,7,6,6,10,24,32,-8,24
Dungannon,3854,8,2,4,16,14,47,-33,10
Crusaders,3855,1,16,7,3,62,31,31,55
Coleraine,3855,2,14,10,2,43,24,19,52
Glenavon,3855,3,10,9,7,54,43,11,39
Linfield,3855,4,11,5,10,39,37,2,38
Cliftonville,3855,5,9,4,13,33,33,0,31
Ballymena,3855,6,7,5,14,26,48,-22,26
Glentoran,3855,7,6,6,10,24,32,-8,24
Dungannon,3855,8,2,4,16,14,47,-33,10
Crusaders,3856,1,16,6,4,62,32,30,54
Coleraine,3856,2,14,10,2,44,24,20,52
Glenavon,3856,3,10,9,7,54,44,10,39
Linfield,3856,4,10,6,10,37,36,1,36
Cliftonville,3856,5,9,5,12,32,31,1,32
Ballymena,3856,6,8,4,14,27,48,-21,28
Glentoran,3856,7,6,6,10,24,32,-8,24
Dungannon,3856,8,2,4,16,14,47,-33,10
Crusaders,3857,1,17,6,3,62,30,32,57
Coleraine,3857,2,15,10,1,44,22,22,55
Linfield,3857,3,11,5,10,40,36,4,38
Glenavon,3857,4,9,9,8,52,44,8,36
Cliftonville,3857,5,9,4,13,32,34,-2,31
Ballymena,3857,6,7,4,15,25,48,-23,25
Glentoran,3857,7,6,6,10,24,32,-8,24
Dungannon,3857,8,2,4,16,14,47,-33,10
Crusaders,3858,1,17,6,3,64,31,33,57
Coleraine,3858,2,15,10,1,47,24,23,55
Linfield,3858,3,11,5,10,39,36,3,38
Glenavon,3858,4,9,9,8,54,47,7,36
Cliftonville,3858,5,9,4,13,32,33,-1,31
Ballymena,3858,6,7,4,15,26,50,-24,25
Glentoran,3858,7,6,6,10,24,32,-8,24
Dungannon,3858,8,2,4,16,14,47,-33,10
Crusaders,3859,1,17,6,3,68,30,38,57
Coleraine,3859,2,14,10,2,43,26,17,52
Glenavon,3859,3,10,9,7,56,43,13,39
Linfield,3859,4,10,5,11,41,41,0,35
Cliftonville,3859,5,10,4,12,37,35,2,34
Ballymena,3859,6,7,4,15,25,54,-29,25
Glentoran,3859,7,6,6,10,24,32,-8,24
Dungannon,3859,8,2,4,16,14,47,-33,10
Crusaders,3860,1,17,6,3,63,31,32,57
Coleraine,3860,2,14,10,2,43,23,20,52
Glenavon,3860,3,10,9,7,53,43,10,39
Linfield,3860,4,10,5,11,38,38,0,35
Cliftonville,3860,5,10,4,12,34,32,2,34
Ballymena,3860,6,7,4,15,26,49,-23,25
Glentoran,3860,7,6,6,10,24,32,-8,24
Dungannon,3860,8,2,4,16,14,47,-33,10
Crusaders,3861,1,17,6,3,64,30,34,57
Coleraine,3861,2,15,10,1,46,23,23,55
Glenavon,3861,3,9,9,8,53,46,7,36
Linfield,3861,4,10,6,10,38,37,1,36
Cliftonville,3861,5,9,5,12,33,32,1,32
Ballymena,3861,6,7,4,15,25,50,-25,25
Glentoran,3861,7,6,6,10,24,32,-8,24
Dungannon,3861,8,2,4,16,14,47,-33,10
Crusaders,3862,1,17,6,3,64,31,33,57
Coleraine,3862,2,15,10,1,47,23,24,55
Linfield,3862,3,11,5,10,39,37,2,38
Glenavon,3862,4,9,9,8,53,47,6,36
Cliftonville,3862,5,9,4,13,33,33,0,31
Ballymena,3862,6,7,4,15,26,50,-24,25
Glentoran,3862,7,6,6,10,24,32,-8,24
Dungannon,3862,8,2,4,16,14,47,-33,10
Crusaders,3863,1,17,6,3,64,30,34,57
Coleraine,3863,2,14,10,2,44,24,20,52
Glenavon,3863,3,10,9,7,54,44,10,39
Linfield,3863,4,11,5,10,40,36,4,38
Cliftonville,3863,5,9,4,13,32,34,-2,31
Ballymena,3863,6,7,4,15,25,50,-25,25
Glentoran,3863,7,6,6,10,24,32,-8,24
Dungannon,3863,8,2,4,16,14,47,-33,10
Crusaders,3864,1,17,6,3,63,31,32,57
Coleraine,3864,2,14,10,2,43,24,19,52
Glenavon,3864,3,10,9,7,54,43,11,39
Linfield,3864,4,10,5,11,37,38,-1,35
Cliftonville,3864,5,10,4,12,34,31,3,34
Ballymena,3864,6,7,4,15,26,49,-23,25
Glentoran,3864,7,6,6,10,24,32,-8,24
Dungannon,3864,8,2,4,16,14,47,-33,10
Crusaders,3865,1,16,6,4,62,32,30,54
Coleraine,3865,2,14,10,2,43,24,19,52
Glenavon,3865,3,10,9,7,54,43,11,39
Linfield,3865,4,11,5,10,39,37,2,38
Cliftonville,3865,5,9,4,13,33,33,0,31
Ballymena,3865,6,8,4,14,27,48,-21,28
Glentoran,3865,7,6,6,10,24,32,-8,24
Dungannon,3865,8,2,4,16,14,47,-33,10
Crusaders,3866,1,16,6,4,62,32,30,54
Coleraine,3866,2,14,10,2,44,27,17,52
Glenavon,3866,3,10,9,7,57,44,13,39
Linfield,3866,4,10,5,11,38,39,-1,35
Cliftonville,3866,5,10,4,12,35,32,3,34
Ballymena,3866,6,8,4,14,27,48,-21,28
Glentoran,3866,7,6,6,10,24,32,-8,24
Dungannon,3866,8,2,4,16,14,47,-33,10
Crusaders,3867,1,17,6,3,64,32,32,57
Coleraine,3867,2,14,10,2,43,27,16,52
Glenavon,3867,3,10,9,7,57,43,14,39
Linfield,3867,4,10,6,10,37,36,1,36
Cliftonville,3867,5,9,5,12,32,31,1,32
Ballymena,3867,6,7,4,15,27,50,-23,25
Glentoran,3867,7,6,6,10,24,32,-8,24
Dungannon,3867,8,2,4,16,14,47,-33,10
Crusaders,3868,1,16,7,3,63,32,31,55
Coleraine,3868,2,14,11,1,46,25,21,53
Glenavon,3868,3,9,10,7,55,46,9,37
Linfield,3868,4,10,5,11,37,37,0,35
Cliftonville,3868,5,10,4,12,33,31,2,34
Ballymena,3868,6,7,5,14,27,49,-22,26
Glentoran,3868,7,6,6,10,24,32,-8,24
Dungannon,3868,8,2,4,16,14,47,-33,10
Crusaders,3869,1,17,6,3,64,31,33,57
Coleraine,3869,2,14,10,2,45,26,19,52
Glenavon,3869,3,10,9,7,56,45,11,39
Linfield,3869,4,10,6,10,37,36,1,36
Cliftonville,3869,5,9,5,12,32,31,1,32
Ballymena,3869,6,7,4,15,26,50,-24,25
Glentoran,3869,7,6,6,10,24,32,-8,24
Dungannon,3869,8,2,4,16,14,47,-33,10
Crusaders,3870,1,17,6,3,63,30,33,57
Coleraine,3870,2,15,10,1,45,23,22,55
Linfield,3870,3,11,5,10,40,37,3,38
Glenavon,3870,4,9,9,8,53,45,8,36
Cliftonville,3870,5,9,4,13,33,34,-1,31
Ballymena,3870,6,7,4,15,25,49,-24,25
Glentoran,3870,7,6,6,10,24,32,-8,24
Dungannon,3870,8,2,4,16,14,47,-33,10
Crusaders,3871,1,16,7,3,61,30,31,55
Coleraine,3871,2,14,10,2,45,27,18,52
Glenavon,3871,3,10,9,7,57,45,12,39
Linfield,3871,4,11,5,10,39,37,2,38
Cliftonville,3871,5,9,4,13,33,33,0,31
Ballymena,3871,6,7,5,14,25,47,-22,26
Glentoran,3871,7,6,6,10,24,32,-8,24
Dungannon,3871,8,2,4,16,14,47,-33,10
Crusaders,3872,1,17,6,3,64,31,33,57
Coleraine,3872,2,14,10,2,43,23,20,52
Glenavon,3872,3,10,9,7,53,43,10,39
Linfield,3872,4,11,5,10,39,37,2,38
Cliftonville,3872,5,9,4,13,33,33,0,31
Ballymena,3872,6,7,4,15,26,50,-24,25
Glentoran,3872,7,6,6,10,24,32,-8,24
Dungannon,3872,8,2,4,16,14,47,-33,10
Crusaders,3873,1,17,6,3,64,31,33,57
Coleraine,3873,2,14,11,1,45,24,21,53
Glenavon,3873,3,9,10,7,54,45,9,37
Linfield,3873,4,10,6,10,38,37,1,36
Cliftonville,3873,5,9,5,12,33,32,1,32
Ballymena,3873,6,7,4,15,26,50,-24,25
Glentoran,3873,7,6,6,10,24,32,-8,24
Dungannon,3873,8,2,4,16,14,47,-33,10
Crusaders,3874,1,16,7,3,61,30,31,55
Coleraine,3874,2,14,10,2,45,27,18,52
Glenavon,3874,3,10,9,7,57,45,12,39
Linfield,3874,4,11,5,10,38,36,2,38
Cliftonville,3874,5,9,4,13,32,32,0,31
Ballymena,3874,6,7,5,14,25,47,-22,26
Glentoran,3874,7,6,6,10,24,32,-8,24
Dungannon,3874,8,2,4,16,14,47,-33,10
Crusaders,3875,1,16,7,3,63,32,31,55
Coleraine,3875,2,14,10,2,44,24,20,52
Glenavon,3875,3,10,9,7,54,44,10,39
Linfield,3875,4,10,6,10,37,36,1,36
Cliftonville,3875,5,9,5,12,32,31,1,32
Ballymena,3875,6,7,5,14,27,49,-22,26
Glentoran,3875,7,6,6,10,24,32,-8,24
Dungannon,3875,8,2,4,16,14,47,-33,10
Crusaders,3876,1,16,6,4,62,33,29,54
Coleraine,3876,2,14,11,1,44,23,21,53
Glenavon,3876,3,9,10,7,53,44,9,37
Linfield,3876,4,10,6,10,39,38,1,36
Cliftonville,3876,5,9,5,12,34,33,1,32
Ballymena,3876,6,8,4,14,28,48,-20,28
Glentoran,3876,7,6,6,10,24,32,-8,24
Dungannon,3876,8,2,4,16,14,47,-33,10
Crusaders,3877,1,16,7,3,64,33,31,55
Coleraine,3877,2,14,10,2,44,24,20,52
Glenavon,3877,3,10,9,7,54,44,10,39
Linfield,3877,4,11,5,10,38,36,2,38
Cliftonville,3877,5,9,4,13,32,32,0,31
Ballymena,3877,6,7,5,14,28,50,-22,26
Glentoran,3877,7,6,6,10,24,32,-8,24
Dungannon,3877,8,2,4,16,14,47,-33,10
Crusaders,3878,1,17,6,3,66,31,35,57
Coleraine,3878,2,14,10,2,43,26,17,52
Glenavon,3878,3,10,9,7,56,43,13,39
Linfield,3878,4,11,5,10,40,37,3,38
Cliftonville,3878,5,9,4,13,33,34,-1,31
Ballymena,3878,6,7,4,15,26,52,-26,25
Glentoran,3878,7,6,6,10,24,32,-8,24
Dungannon,3878,8,2,4,16,14,47,-33,10
Coleraine,3879,1,15,10,1,45,22,23,55
Crusaders,3879,2,16,6,4,63,33,30,54
Linfield,3879,3,11,5,10,39,37,2,38
Glenavon,3879,4,9,9,8,52,45,7,36
Cliftonville,3879,5,9,4,13,33,33,0,31
Ballymena,3879,6,8,4,14,28,49,-21,28
Glentoran,3879,7,6,6,10,24,32,-8,24
Dungannon,3879,8,2,4,16,14,47,-33,10
Crusaders,3880,1,17,6,3,66,31,35,57
Coleraine,3880,2,14,10,2,43,26,17,52
Glenavon,3880,3,10,9,7,56,43,13,39
Linfield,3880,4,11,5,10,38,36,2,38
Cliftonville,3880,5,9,4,13,32,32,0,31
Ballymena,3880,6,7,4,15,26,52,-26,25
Glentoran,3880,7,6,6,10,24,32,-8,24
Dungannon,3880,8,2,4,16,14,47,-33,10
Crusaders,3881,1,16,7,3,62,31,31,55
Coleraine,3881,2,15,10,1,46,23,23,55
Glenavon,3881,3,9,9,8,53,46,7,36
Linfield,3881,4,10,6,10,37,36,1,36
Cliftonville,3881,5,9,5,12,32,31,1,32
Ballymena,3881,6,7,5,14,26,48,-22,26
Glentoran,3881,7,6,6,10,24,32,-8,24
Dungannon,3881,8,2,4,16,14,47,-33,10
Crusaders,3882,1,17,6,3,63,31,32,57
Coleraine,3882,2,14,10,2,44,24,20,52
Glenavon,3882,3,10,9,7,54,44,10,39
Linfield,3882,4,11,5,10,41,37,4,38
Cliftonville,3882,5,9,4,13,33,35,-2,31
Ballymena,3882,6,7,4,15,26,49,-23,25
Glentoran,3882,7,6,6,10,24,32,-8,24
Dungannon,3882,8,2,4,16,14,47,-33,10
Crusaders,3883,1,17,6,3,62,30,32,57
Coleraine,3883,2,14,10,2,43,23,20,52
Glenavon,3883,3,10,9,7,53,43,10,39
Linfield,3883,4,10,5,11,37,39,-2,35
Cliftonville,3883,5,10,4,12,35,31,4,34
Ballymena,3883,6,7,4,15,25,48,-23,25
Glentoran,3883,7,6,6,10,24,32,-8,24
Dungannon,3883,8,2,4,16,14,47,-33,10
Crusaders,3884,1,17,6,3,65,33,32,57
Coleraine,3884,2,15,10,1,46,23,23,55
Glenavon,3884,3,9,9,8,53,46,7,36
Linfield,3884,4,10,5,11,38,38,0,35
Cliftonville,3884,5,10,4,12,34,32,2,34
Ballymena,3884,6,7,4,15,28,51,-23,25
Glentoran,3884,7,6,6,10,24,32,-8,24
Dungannon,3884,8,2,4,16,14,47,-33,10
Crusaders,3885,1,17,6,3,62,30,32,57
Coleraine,3885,2,14,10,2,43,24,19,52
Glenavon,3885,3,10,9,7,54,43,11,39
Linfield,3885,4,11,5,10,40,37,3,38
Cliftonville,3885,5,9,4,13,33,34,-1,31
Ballymena,3885,6,7,4,15,25,48,-23,25
Glentoran,3885,7,6,6,10,24,32,-8,24
Dungannon,3885,8,2,4,16,14,47,-33,10
Crusaders,3886,1,16,7,3,62,31,31,55
Coleraine,3886,2,14,11,1,45,24,21,53
Glenavon,3886,3,9,10,7,54,45,9,37
Linfield,3886,4,10,5,11,38,39,-1,35
Cliftonville,3886,5,10,4,12,35,32,3,34
Ballymena,3886,6,7,5,14,26,48,-22,26
Glentoran,3886,7,6,6,10,24,32,-8,24
Dungannon,3886,8,2,4,16,14,47,-33,10
Coleraine,3887,1,15,10,1,47,23,24,55
Crusaders,3887,2,16,6,4,61,31,30,54
Linfield,3887,3,11,5,10,40,37,3,38
Glenavon,3887,4,9,9,8,53,47,6,36
Cliftonville,3887,5,9,4,13,33,34,-1,31
Ballymena,3887,6,8,4,14,26,47,-21,28
Glentoran,3887,7,6,6,10,24,32,-8,24
Dungannon,3887,8,2,4,16,14,47,-33,10
Crusaders,3888,1,16,6,4,62,33,29,54
Coleraine,3888,2,14,11,1,44,23,21,53
Glenavon,3888,3,9,10,7,53,44,9,37
Linfield,3888,4,10,6,10,38,37,1,36
Cliftonville,3888,5,9,5,12,33,32,1,32
Ballymena,3888,6,8,4,14,28,48,-20,28
Glentoran,3888,7,6,6,10,24,32,-8,24
Dungannon,3888,8,2,4,16,14,47,-33,10
Crusaders,3889,1,17,6,3,64,30,34,57
Coleraine,3889,2,14,11,1,45,24,21,53
Glenavon,3889,3,9,10,7,54,45,9,37
Linfield,3889,4,10,5,11,39,39,0,35
Cliftonville,3889,5,10,4,12,35,33,2,34
Ballymena,3889,6,7,4,15,25,50,-25,25
Glentoran,3889,7,6,6,10,24,32,-8,24
Dungannon,3889,8,2,4,16,14,47,-33,10
Crusaders,3890,1,17,6,3,64,31,33,57
Coleraine,3890,2,14,10,2,45,25,20,52
Glenavon,3890,3,10,9,7,55,45,10,39
Linfield,3890,4,11,5,10,39,37,2,38
Cliftonville,3890,5,9,4,13,33,33,0,31
Ballymena,3890,6,7,4,15,26,50,-24,25
Glentoran,3890,7,6,6,10,24,32,-8,24
Dungannon,3890,8,2,4,16,14,47,-33,10
Crusaders,3891,1,16,7,3,64,33,31,55
Coleraine,3891,2,14,11,1,43,22,21,53
Glenavon,3891,3,9,10,7,52,43,9,37
Linfield,3891,4,10,6,10,38,37,1,36
Cliftonville,3891,5,9,5,12,33,32,1,32
Ballymena,3891,6,7,5,14,28,50,-22,26
Glentoran,3891,7,6,6,10,24,32,-8,24
Dungannon,3891,8,2,4,16,14,47,-33,10
Crusaders,3892,1,16,7,3,63,32,31,55
Coleraine,3892,2,15,10,1,44,22,22,55
Glenavon,3892,3,9,9,8,52,44,8,36
Linfield,3892,4,10,6,10,37,36,1,36
Cliftonville,3892,5,9,5,12,32,31,1,32
Ballymena,3892,6,7,5,14,27,49,-22,26
Glentoran,3892,7,6,6,10,24,32,-8,24
Dungannon,3892,8,2,4,16,14,47,-33,10
Coleraine,3893,1,15,10,1,47,22,25,55
Crusaders,3893,2,16,6,4,62,32,30,54
Glenavon,3893,3,9,9,8,52,47,5,36
Linfield,3893,4,10,5,11,37,37,0,35
Cliftonville,3893,5,10,4,12,33,31,2,34
Ballymena,3893,6,8,4,14,27,48,-21,28
Glentoran,3893,7,6,6,10,24,32,-8,24
Dungannon,3893,8,2,4,16,14,47,-33,10
Crusaders,3894,1,17,6,3,62,30,32,57
Coleraine,3894,2,15,10,1,45,23,22,55
Glenavon,3894,3,9,9,8,53,45,8,36
Linfield,3894,4,10,5,11,38,38,0,35
Cliftonville,3894,5,10,4,12,34,32,2,34
Ballymena,3894,6,7,4,15,25,48,-23,25
Glentoran,3894,7,6,6,10,24,32,-8,24
Dungannon,3894,8,2,4,16,14,47,-33,10
Crusaders,3895,1,16,6,4,61,31,30,54
Coleraine,3895,2,14,10,2,44,25,19,52
Glenavon,3895,3,10,9,7,55,44,11,39
Linfield,3895,4,11,5,10,39,36,3,38
Cliftonville,3895,5,9,4,13,32,33,-1,31
Ballymena,3895,6,8,4,14,26,47,-21,28
Glentoran,3895,7,6,6,10,24,32,-8,24
Dungannon,3895,8,2,4,16,14,47,-33,10
Crusaders,3896,1,17,6,3,63,31,32,57
Coleraine,3896,2,14,10,2,43,24,19,52
Glenavon,3896,3,10,9,7,54,43,11,39
Linfield,3896,4,11,5,10,39,37,2,38
Cliftonville,3896,5,9,4,13,33,33,0,31
Ballymena,3896,6,7,4,15,26,49,-23,25
Glentoran,3896,7,6,6,10,24,32,-8,24
Dungannon,3896,8,2,4,16,14,47,-33,10
Crusaders,3897,1,17,6,3,64,31,33,57
Coleraine,3897,2,14,11,1,44,23,21,53
Glenavon,3897,3,9,10,7,53,44,9,37
Linfield,3897,4,10,5,11,39,40,-1,35
Cliftonville,3897,5,10,4,12,36,33,3,34
Ballymena,3897,6,7,4,15,26,50,-24,25
Glentoran,3897,7,6,6,10,24,32,-8,24
Dungannon,3897,8,2,4,16,14,47,-33,10
Crusaders,3898,1,17,6,3,64,32,32,57
Coleraine,3898,2,15,10,1,45,23,22,55
Glenavon,3898,3,9,9,8,53,45,8,36
Linfield,3898,4,10,5,11,38,38,0,35
Cliftonville,3898,5,10,4,12,34,32,2,34
Ballymena,3898,6,7,4,15,27,50,-23,25
Glentoran,3898,7,6,6,10,24,32,-8,24
Dungannon,3898,8,2,4,16,14,47,-33,10
Crusaders,3899,1,17,6,3,65,30,35,57
Coleraine,3899,2,15,10,1,44,22,22,55
Glenavon,3899,3,9,9,8,52,44,8,36
Linfield,3899,4,10,5,11,37,41,-4,35
Cliftonville,3899,5,10,4,12,37,31,6,34
Ballymena,3899,6,7,4,15,25,51,-26,25
Glentoran,3899,7,6,6,10,24,32,-8,24
Dungannon,3899,8,2,4,16,14,47,-33,10
Crusaders,3900,1,16,6,4,61,35,26,54
Coleraine,3900,2,14,11,1,43,22,21,53
Linfield,3900,3,11,5,10,40,36,4,38
Glenavon,3900,4,9,10,7,52,43,9,37
Cliftonville,3900,5,9,4,13,32,34,-2,31
Ballymena,3900,6,8,4,14,30,47,-17,28
Glentoran,3900,7,6,6,10,24,32,-8,24
Dungannon,3900,8,2,4,16,14,47,-33,10
Crusaders,3901,1,16,7,3,63,32,31,55
Coleraine,3901,2,14,11,1,44,23,21,53
Linfield,3901,3,11,5,10,38,36,2,38
Glenavon,3901,4,9,10,7,53,44,9,37
Cliftonville,3901,5,9,4,13,32,32,0,31
Ballymena,3901,6,7,5,14,27,49,-22,26
Glentoran,3901,7,6,6,10,24,32,-8,24
Dungannon,3901,8,2,4,16,14,47,-33,10
Crusaders,3902,1,16,6,4,62,32,30,54
Coleraine,3902,2,14,10,2,43,26,17,52
Glenavon,3902,3,10,9,7,56,43,13,39
Linfield,3902,4,11,5,10,40,36,4,38
Cliftonville,3902,5,9,4,13,32,34,-2,31
Ballymena,3902,6,8,4,14,27,48,-21,28
Glentoran,3902,7,6,6,10,24,32,-8,24
Dungannon,3902,8,2,4,16,14,47,-33,10
Crusaders,3903,1,16,6,4,61,32,29,54
Coleraine,3903,2,14,11,1,43,22,21,53
Linfield,3903,3,11,5,10,38,36,2,38
Glenavon,3903,4,9,10,7,52,43,9,37
Cliftonville,3903,5,9,4,13,32,32,0,31
Ballymena,3903,6,8,4,14,27,47,-20,28
Glentoran,3903,7,6,6,10,24,32,-8,24
Dungannon,3903,8,2,4,16,14,47,-33,10
Crusaders,3904,1,16,7,3,63,32,31,55
Coleraine,3904,2,14,10,2,44,25,19,52
Glenavon,3904,3,10,9,7,55,44,11,39
Linfield,3904,4,11,5,10,40,37,3,38
Cliftonville,3904,5,9,4,13,33,34,-1,31
Ballymena,3904,6,7,5,14,27,49,-22,26
Glentoran,3904,7,6,6,10,24,32,-8,24
Dungannon,3904,8,2,4,16,14,47,-33,10
Crusaders,3905,1,17,6,3,64,30,34,57
Coleraine,3905,2,14,11,1,44,23,21,53
Linfield,3905,3,11,5,10,40,37,3,38
Glenavon,3905,4,9,10,7,53,44,9,37
Cliftonville,3905,5,9,4,13,33,34,-1,31
Ballymena,3905,6,7,4,15,25,50,-25,25
Glentoran,3905,7,6,6,10,24,32,-8,24
Dungannon,3905,8,2,4,16,14,47,-33,10
Crusaders,3906,1,16,7,3,63,32,31,55
Coleraine,3906,2,14,10,2,43,23,20,52
Glenavon,3906,3,10,9,7,53,43,10,39
Linfield,3906,4,10,6,10,40,39,1,36
Cliftonville,3906,5,9,5,12,35,34,1,32
Ballymena,3906,6,7,5,14,27,49,-22,26
Glentoran,3906,7,6,6,10,24,32,-8,24
Dungannon,3906,8,2,4,16,14,47,-33,10
Crusaders,3907,1,16,7,3,62,31,31,55
Coleraine,3907,2,14,10,2,43,23,20,52
Glenavon,3907,3,10,9,7,53,43,10,39
Linfield,3907,4,10,5,11,37,39,-2,35
Cliftonville,3907,5,10,4,12,35,31,4,34
Ballymena,3907,6,7,5,14,26,48,-22,26
Glentoran,3907,7,6,6,10,24,32,-8,24
Dungannon,3907,8,2,4,16,14,47,-33,10
Crusaders,3908,1,17,6,3,65,30,35,57
Coleraine,3908,2,15,10,1,46,24,22,55
Glenavon,3908,3,9,9,8,54,46,8,36
Linfield,3908,4,10,5,11,37,38,-1,35
Cliftonville,3908,5,10,4,12,34,31,3,34
Ballymena,3908,6,7,4,15,25,51,-26,25
Glentoran,3908,7,6,6,10,24,32,-8,24
Dungannon,3908,8,2,4,16,14,47,-33,10
Crusaders,3909,1,17,6,3,63,31,32,57
Coleraine,3909,2,14,10,2,43,24,19,52
Glenavon,3909,3,10,9,7,54,43,11,39
Linfield,3909,4,10,6,10,38,37,1,36
Cliftonville,3909,5,9,5,12,33,32,1,32
Ballymena,3909,6,7,4,15,26,49,-23,25
Glentoran,3909,7,6,6,10,24,32,-8,24
Dungannon,3909,8,2,4,16,14,47,-33,10
Crusaders,3910,1,17,6,3,65,31,34,57
Coleraine,3910,2,14,10,2,46,28,18,52
Glenavon,3910,3,10,9,7,58,46,12,39
Linfield,3910,4,11,5,10,40,38,2,38
Cliftonville,3910,5,9,4,13,34,34,0,31
Ballymena,3910,6,7,4,15,26,51,-25,25
Glentoran,3910,7,6,6,10,24,32,-8,24
Dungannon,3910,8,2,4,16,14,47,-33,10
Crusaders,3911,1,17,6,3,65,32,33,57
Coleraine,3911,2,14,10,2,45,25,20,52
Glenavon,3911,3,10,9,7,55,45,10,39
Linfield,3911,4,10,5,11,37,37,0,35
Cliftonville,3911,5,10,4,12,33,31,2,34
Ballymena,3911,6,7,4,15,27,51,-24,25
Glentoran,3911,7,6,6,10,24,32,-8,24
Dungannon,3911,8,2,4,16,14,47,-33,10
Crusaders,3912,1,16,7,3,62,31,31,55
Coleraine,3912,2,15,10,1,46,23,23,55
Glenavon,3912,3,9,9,8,53,46,7,36
Linfield,3912,4,10,5,11,37,37,0,35
Cliftonville,3912,5,10,4,12,33,31,2,34
Ballymena,3912,6,7,5,14,26,48,-22,26
Glentoran,3912,7,6,6,10,24,32,-8,24
Dungannon,3912,8,2,4,16,14,47,-33,10
Crusaders,3913,1,17,6,3,65,30,35,57
Coleraine,3913,2,14,11,1,44,23,21,53
Linfield,3913,3,11,5,10,40,38,2,38
Glenavon,3913,4,9,10,7,53,44,9,37
Cliftonville,3913,5,9,4,13,34,34,0,31
Ballymena,3913,6,7,4,15,25,51,-26,25
Glentoran,3913,7,6,6,10,24,32,-8,24
Dungannon,3913,8,2,4,16,14,47,-33,10
Coleraine,3914,1,15,10,1,46,22,24,55
Crusaders,3914,2,16,6,4,61,33,28,54
Glenavon,3914,3,9,9,8,52,46,6,36
Linfield,3914,4,10,6,10,38,37,1,36
Cliftonville,3914,5,9,5,12,33,32,1,32
Ballymena,3914,6,8,4,14,28,47,-19,28
Glentoran,3914,7,6,6,10,24,32,-8,24
Dungannon,3914,8,2,4,16,14,47,-33,10
Crusaders,3915,1,17,6,3,67,32,35,57
Coleraine,3915,2,14,10,2,44,25,19,52
Glenavon,3915,3,10,9,7,55,44,11,39
Linfield,3915,4,10,5,11,37,37,0,35
Cliftonville,3915,5,10,4,12,33,31,2,34
Ballymena,3915,6,7,4,15,27,53,-26,25
Glentoran,3915,7,6,6,10,24,32,-8,24
Dungannon,3915,8,2,4,16,14,47,-33,10
Crusaders,3916,1,17,6,3,64,32,32,57
Coleraine,3916,2,14,10,2,45,25,20,52
Glenavon,3916,3,10,9,7,55,45,10,39
Linfield,3916,4,10,6,10,38,37,1,36
Cliftonville,3916,5,9,5,12,33,32,1,32
Ballymena,3916,6,7,4,15,27,50,-23,25
Glentoran,3916,7,6,6,10,24,32,-8,24
Dungannon,3916,8,2,4,16,14,47,-33,10
Crusaders,3917,1,16,6,4,62,33,29,54
Coleraine,3917,2,14,10,2,44,24,20,52
Glenavon,3917,3,10,9,7,54,44,10,39
Linfield,3917,4,10,5,11,38,39,-1,35
Cliftonville,3917,5,10,4,12,35,32,3,34
Ballymena,3917,6,8,4,14,28,48,-20,28
Glentoran,3917,7,6,6,10,24,32,-8,24
Dungannon,3917,8,2,4,16,14,47,-33,10
Crusaders,3918,1,17,6,3,62,30,32,57
Coleraine,3918,2,14,11,1,45,24,21,53
Glenavon,3918,3,9,10,7,54,45,9,37
Linfield,3918,4,10,6,10,37,36,1,36
Cliftonville,3918,5,9,5,12,32,31,1,32
Ballymena,3918,6,7,4,15,25,48,-23,25
Glentoran,3918,7,6,6,10,24,32,-8,24
Dungannon,3918,8,2,4,16,14,47,-33,10
Crusaders,3919,1,17,6,3,65,30,35,57
Coleraine,3919,2,14,11,1,44,23,21,53
Linfield,3919,3,11,5,10,39,36,3,38
Glenavon,3919,4,9,10,7,53,44,9,37
Cliftonville,3919,5,9,4,13,32,33,-1,31
Ballymena,3919,6,7,4,15,25,51,-26,25
Glentoran,3919,7,6,6,10,24,32,-8,24
Dungannon,3919,8,2,4,16,14,47,-33,10
Crusaders,3920,1,17,6,3,63,31,32,57
Coleraine,3920,2,15,10,1,44,22,22,55
Linfield,3920,3,11,5,10,39,36,3,38
Glenavon,3920,4,9,9,8,52,44,8,36
Cliftonville,3920,5,9,4,13,32,33,-1,31
Ballymena,3920,6,7,4,15,26,49,-23,25
Glentoran,3920,7,6,6,10,24,32,-8,24
Dungannon,3920,8,2,4,16,14,47,-33,10
Crusaders,3921,1,17,6,3,63,31,32,57
Coleraine,3921,2,14,10,2,43,24,19,52
Glenavon,3921,3,10,9,7,54,43,11,39
Linfield,3921,4,10,5,11,37,37,0,35
Cliftonville,3921,5,10,4,12,33,31,2,34
Ballymena,3921,6,7,4,15,26,49,-23,25
Glentoran,3921,7,6,6,10,24,32,-8,24
Dungannon,3921,8,2,4,16,14,47,-33,10
Crusaders,3922,1,17,6,3,65,30,35,57
Coleraine,3922,2,15,10,1,45,23,22,55
Glenavon,3922,3,9,9,8,53,45,8,36
Linfield,3922,4,10,6,10,39,38,1,36
Cliftonville,3922,5,9,5,12,34,33,1,32
Ballymena,3922,6,7,4,15,25,51,-26,25
Glentoran,3922,7,6,6,10,24,32,-8,24
Dungannon,3922,8,2,4,16,14,47,-33,10
Crusaders,3923,1,17,6,3,64,31,33,57
Coleraine,3923,2,15,10,1,45,22,23,55
Linfield,3923,3,11,5,10,40,36,4,38
Glenavon,3923,4,9,9,8,52,45,7,36
Cliftonville,3923,5,9,4,13,32,34,-2,31
Ballymena,3923,6,7,4,15,26,50,-24,25
Glentoran,3923,7,6,6,10,24,32,-8,24
Dungannon,3923,8,2,4,16,14,47,-33,10
Crusaders,3924,1,17,6,3,63,31,32,57
Coleraine,3924,2,15,10,1,46,23,23,55
Glenavon,3924,3,9,9,8,53,46,7,36
Linfield,3924,4,10,6,10,38,37,1,36
Cliftonville,3924,5,9,5,12,33,32,1,32
Ballymena,3924,6,7,4,15,26,49,-23,25
Glentoran,3924,7,6,6,10,24,32,-8,24
Dungannon,3924,8,2,4,16,14,47,-33,10
Crusaders,3925,1,16,7,3,61,30,31,55
Coleraine,3925,2,14,10,2,45,25,20,52
Glenavon,3925,3,10,9,7,55,45,10,39
Linfield,3925,4,11,5,10,39,37,2,38
Cliftonville,3925,5,9,4,13,33,33,0,31
Ballymena,3925,6,7,5,14,25,47,-22,26
Glentoran,3925,7,6,6,10,24,32,-8,24
Dungannon,3925,8,2,4,16,14,47,-33,10
Crusaders,3926,1,17,6,3,64,30,34,57
Coleraine,3926,2,15,10,1,46,23,23,55
Glenavon,3926,3,9,9,8,53,46,7,36
Linfield,3926,4,10,6,10,39,38,1,36
Cliftonville,3926,5,9,5,12,34,33,1,32
Ballymena,3926,6,7,4,15,25,50,-25,25
Glentoran,3926,7,6,6,10,24,32,-8,24
Dungannon,3926,8,2,4,16,14,47,-33,10
Crusaders,3927,1,17,6,3,64,30,34,57
Coleraine,3927,2,15,10,1,44,22,22,55
Glenavon,3927,3,9,9,8,52,44,8,36
Linfield,3927,4,10,5,11,38,42,-4,35
Cliftonville,3927,5,10,4,12,38,32,6,34
Ballymena,3927,6,7,4,15,25,50,-25,25
Glentoran,3927,7,6,6,10,24,32,-8,24
Dungannon,3927,8,2,4,16,14,47,-33,10
Crusaders,3928,1,16,7,3,62,31,31,55
Coleraine,3928,2,14,11,1,45,24,21,53
Linfield,3928,3,11,5,10,39,36,3,38
Glenavon,3928,4,9,10,7,54,45,9,37
Cliftonville,3928,5,9,4,13,32,33,-1,31
Ballymena,3928,6,7,5,14,26,48,-22,26
Glentoran,3928,7,6,6,10,24,32,-8,24
Dungannon,3928,8,2,4,16,14,47,-33,10
Crusaders,3929,1,17,6,3,62,30,32,57
Coleraine,3929,2,14,11,1,44,23,21,53
Glenavon,3929,3,9,10,7,53,44,9,37
Linfield,3929,4,10,5,11,38,38,0,35
Cliftonville,3929,5,10,4,12,34,32,2,34
Ballymena,3929,6,7,4,15,25,48,-23,25
Glentoran,3929,7,6,6,10,24,32,-8,24
Dungannon,3929,8,2,4,16,14,47,-33,10
Crusaders,3930,1,17,6,3,62,30,32,57
Coleraine,3930,2,15,10,1,44,22,22,55
Glenavon,3930,3,9,9,8,52,44,8,36
Linfield,3930,4,10,6,10,38,37,1,36
Cliftonville,3930,5,9,5,12,33,32,1,32
Ballymena,3930,6,7,4,15,25,48,-23,25
Glentoran,3930,7,6,6,10,24,32,-8,24
Dungannon,3930,8,2,4,16,14,47,-33,10
Crusaders,3931,1,17,6,3,65,31,34,57
Coleraine,3931,2,15,10,1,46,22,24,55
Glenavon,3931,3,9,9,8,52,46,6,36
Linfield,3931,4,10,5,11,38,39,-1,35
Cliftonville,3931,5,10,4,12,35,32,3,34
Ballymena,3931,6,7,4,15,26,51,-25,25
Glentoran,3931,7,6,6,10,24,32,-8,24
Dungannon,3931,8,2,4,16,14,47,-33,10
Crusaders,3932,1,17,6,3,63,31,32,57
Coleraine,3932,2,14,10,2,44,24,20,52
Glenavon,3932,3,10,9,7,54,44,10,39
Linfield,3932,4,10,6,10,37,36,1,36
Cliftonville,3932,5,9,5,12,32,31,1,32
Ballymena,3932,6,7,4,15,26,49,-23,25
Glentoran,3932,7,6,6,10,24,32,-8,24
Dungannon,3932,8,2,4,16,14,47,-33,10
Crusaders,3933,1,16,7,3,62,31,31,55
Coleraine,3933,2,14,11,1,44,23,21,53
Glenavon,3933,3,9,10,7,53,44,9,37
Linfield,3933,4,10,6,10,37,36,1,36
Cliftonville,3933,5,9,5,12,32,31,1,32
Ballymena,3933,6,7,5,14,26,48,-22,26
Glentoran,3933,7,6,6,10,24,32,-8,24
Dungannon,3933,8,2,4,16,14,47,-33,10
Coleraine,3934,1,15,10,1,45,22,23,55
Crusaders,3934,2,16,6,4,62,32,30,54
Glenavon,3934,3,9,9,8,52,45,7,36
Linfield,3934,4,10,6,10,38,37,1,36
Cliftonville,3934,5,9,5,12,33,32,1,32
Ballymena,3934,6,8,4,14,27,48,-21,28
Glentoran,3934,7,6,6,10,24,32,-8,24
Dungannon,3934,8,2,4,16,14,47,-33,10
Crusaders,3935,1,17,6,3,63,31,32,57
Coleraine,3935,2,14,10,2,44,25,19,52
Glenavon,3935,3,10,9,7,55,44,11,39
Linfield,3935,4,11,5,10,38,36,2,38
Cliftonville,3935,5,9,4,13,32,32,0,31
Ballymena,3935,6,7,4,15,26,49,-23,25
Glentoran,3935,7,6,6,10,24,32,-8,24
Dungannon,3935,8,2,4,16,14,47,-33,10
Crusaders,3936,1,16,7,3,63,32,31,55
Coleraine,3936,2,14,10,2,43,23,20,52
Glenavon,3936,3,10,9,7,53,43,10,39
Linfield,3936,4,10,6,10,39,38,1,36
Cliftonville,3936,5,9,5,12,34,33,1,32
Ballymena,3936,6,7,5,14,27,49,-22,26
Glentoran,3936,7,6,6,10,24,32,-8,24
Dungannon,3936,8,2,4,16,14,47,-33,10
Crusaders,3937,1,16,6,4,62,33,29,54
Coleraine,3937,2,14,10,2,44,25,19,52
Glenavon,3937,3,10,9,7,55,44,11,39
Linfield,3937,4,10,5,11,38,38,0,35
Cliftonville,3937,5,10,4,12,34,32,2,34
Ballymena,3937,6,8,4,14,28,48,-20,28
Glentoran,3937,7,6,6,10,24,32,-8,24
Dungannon,3937,8,2,4,16,14,47,-33,10
Crusaders,3938,1,16,7,3,61,30,31,55
Coleraine,3938,2,14,10,2,44,24,20,52
Glenavon,3938,3,10,9,7,54,44,10,39
Linfield,3938,4,11,5,10,39,36,3,38
Cliftonville,3938,5,9,4,13,32,33,-1,31
Ballymena,3938,6,7,5,14,25,47,-22,26
Glentoran,3938,7,6,6,10,24,32,-8,24
Dungannon,3938,8,2,4,16,14,47,-33,10
Crusaders,3939,1,16,6,4,61,31,30,54
Coleraine,3939,2,14,10,2,43,24,19,52
Glenavon,3939,3,10,9,7,54,43,11,39
Linfield,3939,4,11,5,10,40,38,2,38
Cliftonville,3939,5,9,4,13,34,34,0,31
Ballymena,3939,6,8,4,14,26,47,-21,28
Glentoran,3939,7,6,6,10,24,32,-8,24
Dungannon,3939,8,2,4,16,14,47,-33,10
Crusaders,3940,1,17,6,3,62,30,32,57
Coleraine,3940,2,15,10,1,45,22,23,55
Linfield,3940,3,11,5,10,38,36,2,38
Glenavon,3940,4,9,9,8,52,45,7,36
Cliftonville,3940,5,9,4,13,32,32,0,31
Ballymena,3940,6,7,4,15,25,48,-23,25
Glentoran,3940,7,6,6,10,24,32,-8,24
Dungannon,3940,8,2,4,16,14,47,-33,10
Crusaders,3941,1,16,7,3,62,31,31,55
Coleraine,3941,2,14,11,1,45,24,21,53
Linfield,3941,3,11,5,10,41,37,4,38
Glenavon,3941,4,9,10,7,54,45,9,37
Cliftonville,3941,5,9,4,13,33,35,-2,31
Ballymena,3941,6,7,5,14,26,48,-22,26
Glentoran,3941,7,6,6,10,24,32,-8,24
Dungannon,3941,8,2,4,16,14,47,-33,10
Crusaders,3942,1,16,7,3,63,32,31,55
Coleraine,3942,2,15,10,1,45,23,22,55
Glenavon,3942,3,9,9,8,53,45,8,36
Linfield,3942,4,10,6,10,37,36,1,36
Cliftonville,3942,5,9,5,12,32,31,1,32
Ballymena,3942,6,7,5,14,27,49,-22,26
Glentoran,3942,7,6,6,10,24,32,-8,24
Dungannon,3942,8,2,4,16,14,47,-33,10
Crusaders,3943,1,16,7,3,62,31,31,55
Coleraine,3943,2,15,10,1,46,23,23,55
Glenavon,3943,3,9,9,8,53,46,7,36
Linfield,3943,4,10,5,11,37,39,-2,35
Cliftonville,3943,5,10,4,12,35,31,4,34
Ballymena,3943,6,7,5,14,26,48,-22,26
Glentoran,3943,7,6,6,10,24,32,-8,24
Dungannon,3943,8,2,4,16,14,47,-33,10
Crusaders,3944,1,17,6,3,64,30,34,57
Coleraine,3944,2,14,11,1,44,23,21,53
Linfield,3944,3,11,5,10,40,36,4,38
Glenavon,3944,4,9,10,7,53,44,9,37
Cliftonville,3944,5,9,4,13,32,34,-2,31
Ballymena,3944,6,7,4,15,25,50,-25,25
Glentoran,3944,7,6,6,10,24,32,-8,24
Dungannon,3944,8,2,4,16,14,47,-33,10
Crusaders,3945,1,16,6,4,62,32,30,54
Coleraine,3945,2,14,10,2,43,23,20,52
Glenavon,3945,3,10,9,7,53,43,10,39
Linfield,3945,4,11,5,10,39,37,2,38
Cliftonville,3945,5,9,4,13,33,33,0,31
Ballymena,3945,6,8,4,14,27,48,-21,28
Glentoran,3945,7,6,6,10,24,32,-8,24
Dungannon,3945,8,2,4,16,14,47,-33,10
Crusaders,3946,1,16,7,3,63,32,31,55
Coleraine,3946,2,14,10,2,44,26,18,52
Glenavon,3946,3,10,9,7,56,44,12,39
Linfield,3946,4,11,5,10,39,36,3,38
Cliftonville,3946,5,9,4,13,32,33,-1,31
Ballymena,3946,6,7,5,14,27,49,-22,26
Glentoran,3946,7,6,6,10,24,32,-8,24
Dungannon,3946,8,2,4,16,14,47,-33,10
Crusaders,3947,1,16,7,3,61,30,31,55
Coleraine,3947,2,15,10,1,45,23,22,55
Linfield,3947,3,11,5,10,39,37,2,38
Glenavon,3947,4,9,9,8,53,45,8,36
Cliftonville,3947,5,9,4,13,33,33,0,31
Ballymena,3947,6,7,5,14,25,47,-22,26
Glentoran,3947,7,6,6,10,24,32,-8,24
Dungannon,3947,8,2,4,16,14,47,-33,10
Crusaders,3948,1,17,6,3,68,30,38,57
Coleraine,3948,2,14,10,2,45,27,18,52
Glenavon,3948,3,10,9,7,57,45,12,39
Linfield,3948,4,11,5,10,38,36,2,38
Cliftonville,3948,5,9,4,13,32,32,0,31
Ballymena,3948,6,7,4,15,25,54,-29,25
Glentoran,3948,7,6,6,10,24,32,-8,24
Dungannon,3948,8,2,4,16,14,47,-33,10
Crusaders,3949,1,17,6,3,64,30,34,57
Coleraine,3949,2,14,10,2,45,26,19,52
Glenavon,3949,3,10,9,7,56,45,11,39
Linfield,3949,4,10,6,10,39,38,1,36
Cliftonville,3949,5,9,5,12,34,33,1,32
Ballymena,3949,6,7,4,15,25,50,-25,25
Glentoran,3949,7,6,6,10,24,32,-8,24
Dungannon,3949,8,2,4,16,14,47,-33,10
Crusaders,3950,1,17,6,3,62,30,32,57
Coleraine,3950,2,14,10,2,44,24,20,52
Glenavon,3950,3,10,9,7,54,44,10,39
Linfield,3950,4,11,5,10,42,39,3,38
Cliftonville,3950,5,9,4,13,35,36,-1,31
Ballymena,3950,6,7,4,15,25,48,-23,25
Glentoran,3950,7,6,6,10,24,32,-8,24
Dungannon,3950,8,2,4,16,14,47,-33,10
Crusaders,3951,1,17,6,3,64,30,34,57
Coleraine,3951,2,14,10,2,43,23,20,52
Glenavon,3951,3,10,9,7,53,43,10,39
Linfield,3951,4,11,5,10,41,36,5,38
Cliftonville,3951,5,9,4,13,32,35,-3,31
Ballymena,3951,6,7,4,15,25,50,-25,25
Glentoran,3951,7,6,6,10,24,32,-8,24
Dungannon,3951,8,2,4,16,14,47,-33,10
Crusaders,3952,1,17,6,3,62,30,32,57
Coleraine,3952,2,15,10,1,46,23,23,55
Linfield,3952,3,11,5,10,39,37,2,38
Glenavon,3952,4,9,9,8,53,46,7,36
Cliftonville,3952,5,9,4,13,33,33,0,31
Ballymena,3952,6,7,4,15,25,48,-23,25
Glentoran,3952,7,6,6,10,24,32,-8,24
Dungannon,3952,8,2,4,16,14,47,-33,10
Crusaders,3953,1,17,6,3,63,30,33,57
Coleraine,3953,2,14,10,2,43,24,19,52
Glenavon,3953,3,10,9,7,54,43,11,39
Linfield,3953,4,10,5,11,37,38,-1,35
Cliftonville,3953,5,10,4,12,34,31,3,34
Ballymena,3953,6,7,4,15,25,49,-24,25
Glentoran,3953,7,6,6,10,24,32,-8,24
Dungannon,3953,8,2,4,16,14,47,-33,10
Crusaders,3954,1,17,6,3,65,32,33,57
Coleraine,3954,2,14,10,2,43,23,20,52
Glenavon,3954,3,10,9,7,53,43,10,39
Linfield,3954,4,11,5,10,38,36,2,38
Cliftonville,3954,5,9,4,13,32,32,0,31
Ballymena,3954,6,7,4,15,27,51,-24,25
Glentoran,3954,7,6,6,10,24,32,-8,24
Dungannon,3954,8,2,4,16,14,47,-33,10
Crusaders,3955,1,17,6,3,66,30,36,57
Coleraine,3955,2,15,10,1,45,23,22,55
Linfield,3955,3,11,5,10,39,37,2,38
Glenavon,3955,4,9,9,8,53,45,8,36
Cliftonville,3955,5,9,4,13,33,33,0,31
Ballymena,3955,6,7,4,15,25,52,-27,25
Glentoran,3955,7,6,6,10,24,32,-8,24
Dungannon,3955,8,2,4,16,14,47,-33,10
Crusaders,3956,1,16,7,3,63,32,31,55
Coleraine,3956,2,14,11,1,44,23,21,53
Linfield,3956,3,11,5,10,41,38,3,38
Glenavon,3956,4,9,10,7,53,44,9,37
Cliftonville,3956,5,9,4,13,34,35,-1,31
Ballymena,3956,6,7,5,14,27,49,-22,26
Glentoran,3956,7,6,6,10,24,32,-8,24
Dungannon,3956,8,2,4,16,14,47,-33,10
Crusaders,3957,1,16,7,3,62,31,31,55
Coleraine,3957,2,15,10,1,45,22,23,55
Glenavon,3957,3,9,9,8,52,45,7,36
Linfield,3957,4,10,5,11,38,39,-1,35
Cliftonville,3957,5,10,4,12,35,32,3,34
Ballymena,3957,6,7,5,14,26,48,-22,26
Glentoran,3957,7,6,6,10,24,32,-8,24
Dungannon,3957,8,2,4,16,14,47,-33,10
Coleraine,3958,1,15,10,1,45,23,22,55
Crusaders,3958,2,16,6,4,62,33,29,54
Glenavon,3958,3,9,9,8,53,45,8,36
Linfield,3958,4,10,5,11,38,38,0,35
Cliftonville,3958,5,10,4,12,34,32,2,34
Ballymena,3958,6,8,4,14,28,48,-20,28
Glentoran,3958,7,6,6,10,24,32,-8,24
Dungannon,3958,8,2,4,16,14,47,-33,10
Crusaders,3959,1,17,6,3,63,30,33,57
Coleraine,3959,2,14,10,2,43,25,18,52
Glenavon,3959,3,10,9,7,55,43,12,39
Linfield,3959,4,10,6,10,37,36,1,36
Cliftonville,3959,5,9,5,12,32,31,1,32
Ballymena,3959,6,7,4,15,25,49,-24,25
Glentoran,3959,7,6,6,10,24,32,-8,24
Dungannon,3959,8,2,4,16,14,47,-33,10
Crusaders,3960,1,17,6,3,63,30,33,57
Coleraine,3960,2,15,10,1,45,23,22,55
Linfield,3960,3,11,5,10,40,37,3,38
Glenavon,3960,4,9,9,8,53,45,8,36
Cliftonville,3960,5,9,4,13,33,34,-1,31
Ballymena,3960,6,7,4,15,25,49,-24,25
Glentoran,3960,7,6,6,10,24,32,-8,24
Dungannon,3960,8,2,4,16,14,47,-33,10
Crusaders,3961,1,16,6,4,62,32,30,54
Coleraine,3961,2,14,11,1,46,25,21,53
Linfield,3961,3,11,5,10,40,38,2,38
Glenavon,3961,4,9,10,7,55,46,9,37
Cliftonville,3961,5,9,4,13,34,34,0,31
Ballymena,3961,6,8,4,14,27,48,-21,28
Glentoran,3961,7,6,6,10,24,32,-8,24
Dungannon,3961,8,2,4,16,14,47,-33,10
Crusaders,3962,1,17,6,3,63,30,33,57
Coleraine,3962,2,14,11,1,44,23,21,53
Linfield,3962,3,11,5,10,41,36,5,38
Glenavon,3962,4,9,10,7,53,44,9,37
Cliftonville,3962,5,9,4,13,32,35,-3,31
Ballymena,3962,6,7,4,15,25,49,-24,25
Glentoran,3962,7,6,6,10,24,32,-8,24
Dungannon,3962,8,2,4,16,14,47,-33,10
Crusaders,3963,1,16,7,3,62,31,31,55
Coleraine,3963,2,14,10,2,44,25,19,52
Glenavon,3963,3,10,9,7,55,44,11,39
Linfield,3963,4,10,5,11,38,38,0,35
Cliftonville,3963,5,10,4,12,34,32,2,34
Ballymena,3963,6,7,5,14,26,48,-22,26
Glentoran,3963,7,6,6,10,24,32,-8,24
Dungannon,3963,8,2,4,16,14,47,-33,10
Crusaders,3964,1,17,6,3,64,31,33,57
Coleraine,3964,2,14,10,2,43,23,20,52
Glenavon,3964,3,10,9,7,53,43,10,39
Linfield,3964,4,10,6,10,38,37,1,36
Cliftonville,3964,5,9,5,12,33,32,1,32
Ballymena,3964,6,7,4,15,26,50,-24,25
Glentoran,3964,7,6,6,10,24,32,-8,24
Dungannon,3964,8,2,4,16,14,47,-33,10
Crusaders,3965,1,16,6,4,61,31,30,54
Coleraine,3965,2,14,10,2,43,24,19,52
Glenavon,3965,3,10,9,7,54,43,11,39
Linfield,3965,4,10,6,10,37,36,1,36
Cliftonville,3965,5,9,5,12,32,31,1,32
Ballymena,3965,6,8,4,14,26,47,-21,28
Glentoran,3965,7,6,6,10,24,32,-8,24
Dungannon,3965,8,2,4,16,14,47,-33,10
Crusaders,3966,1,16,7,3,61,30,31,55
Coleraine,3966,2,15,10,1,45,22,23,55
Glenavon,3966,3,9,9,8,52,45,7,36
Linfield,3966,4,10,5,11,37,38,-1,35
Cliftonville,3966,5,10,4,12,34,31,3,34
Ballymena,3966,6,7,5,14,25,47,-22,26
Glentoran,3966,7,6,6,10,24,32,-8,24
Dungannon,3966,8,2,4,16,14,47,-33,10
Crusaders,3967,1,17,6,3,63,31,32,57
Coleraine,3967,2,15,10,1,45,22,23,55
Linfield,3967,3,11,5,10,39,37,2,38
Glenavon,3967,4,9,9,8,52,45,7,36
Cliftonville,3967,5,9,4,13,33,33,0,31
Ballymena,3967,6,7,4,15,26,49,-23,25
Glentoran,3967,7,6,6,10,24,32,-8,24
Dungannon,3967,8,2,4,16,14,47,-33,10
Crusaders,3968,1,17,6,3,64,30,34,57
Coleraine,3968,2,15,10,1,46,23,23,55
Glenavon,3968,3,9,9,8,53,46,7,36
Linfield,3968,4,10,6,10,38,37,1,36
Cliftonville,3968,5,9,5,12,33,32,1,32
Ballymena,3968,6,7,4,15,25,50,-25,25
Glentoran,3968,7,6,6,10,24,32,-8,24
Dungannon,3968,8,2,4,16,14,47,-33,10
Coleraine,3969,1,15,10,1,46,23,23,55
Crusaders,3969,2,16,6,4,61,34,27,54
Glenavon,3969,3,9,9,8,53,46,7,36
Linfield,3969,4,10,5,11,37,39,-2,35
Cliftonville,3969,5,10,4,12,35,31,4,34
Ballymena,3969,6,8,4,14,29,47,-18,28
Glentoran,3969,7,6,6,10,24,32,-8,24
Dungannon,3969,8,2,4,16,14,47,-33,10
Crusaders,3970,1,17,6,3,64,30,34,57
Coleraine,3970,2,14,11,1,46,25,21,53
Glenavon,3970,3,9,10,7,55,46,9,37
Linfield,3970,4,10,6,10,40,39,1,36
Cliftonville,3970,5,9,5,12,35,34,1,32
Ballymena,3970,6,7,4,15,25,50,-25,25
Glentoran,3970,7,6,6,10,24,32,-8,24
Dungannon,3970,8,2,4,16,14,47,-33,10
Crusaders,3971,1,16,7,3,62,31,31,55
Coleraine,3971,2,14,10,2,43,26,17,52
Glenavon,3971,3,10,9,7,56,43,13,39
Linfield,3971,4,11,5,10,38,36,2,38
Cliftonville,3971,5,9,4,13,32,32,0,31
Ballymena,3971,6,7,5,14,26,48,-22,26
Glentoran,3971,7,6,6,10,24,32,-8,24
Dungannon,3971,8,2,4,16,14,47,-33,10
Crusaders,3972,1,16,7,3,63,32,31,55
Coleraine,3972,2,14,11,1,44,23,21,53
Linfield,3972,3,11,5,10,38,36,2,38
Glenavon,3972,4,9,10,7,53,44,9,37
Cliftonville,3972,5,9,4,13,32,32,0,31
Ballymena,3972,6,7,5,14,27,49,-22,26
Glentoran,3972,7,6,6,10,24,32,-8,24
Dungannon,3972,8,2,4,16,14,47,-33,10
Crusaders,3973,1,17,6,3,63,30,33,57
Coleraine,3973,2,15,10,1,46,24,22,55
Linfield,3973,3,11,5,10,38,36,2,38
Glenavon,3973,4,9,9,8,54,46,8,36
Cliftonville,3973,5,9,4,13,32,32,0,31
Ballymena,3973,6,7,4,15,25,49,-24,25
Glentoran,3973,7,6,6,10,24,32,-8,24
Dungannon,3973,8,2,4,16,14,47,-33,10
Crusaders,3974,1,17,6,3,63,30,33,57
Coleraine,3974,2,14,11,1,45,24,21,53
Linfield,3974,3,11,5,10,38,36,2,38
Glenavon,3974,4,9,10,7,54,45,9,37
Cliftonville,3974,5,9,4,13,32,32,0,31
Ballymena,3974,6,7,4,15,25,49,-24,25
Glentoran,3974,7,6,6,10,24,32,-8,24
Dungannon,3974,8,2,4,16,14,47,-33,10
Crusaders,3975,1,16,7,3,62,31,31,55
Coleraine,3975,2,15,10,1,46,22,24,55
Linfield,3975,3,11,5,10,38,36,2,38
Glenavon,3975,4,9,9,8,52,46,6,36
Cliftonville,3975,5,9,4,13,32,32,0,31
Ballymena,3975,6,7,5,14,26,48,-22,26
Glentoran,3975,7,6,6,10,24,32,-8,24
Dungannon,3975,8,2,4,16,14,47,-33,10
Coleraine,3976,1,15,10,1,44,22,22,55
Crusaders,3976,2,16,6,4,61,31,30,54
Linfield,3976,3,11,5,10,39,36,3,38
Glenavon,3976,4,9,9,8,52,44,8,36
Cliftonville,3976,5,9,4,13,32,33,-1,31
Ballymena,3976,6,8,4,14,26,47,-21,28
Glentoran,3976,7,6,6,10,24,32,-8,24
Dungannon,3976,8,2,4,16,14,47,-33,10
Crusaders,3977,1,17,6,3,63,30,33,57
Coleraine,3977,2,14,10,2,43,23,20,52
Glenavon,3977,3,10,9,7,53,43,10,39
Linfield,3977,4,10,5,11,37,37,0,35
Cliftonville,3977,5,10,4,12,33,31,2,34
Ballymena,3977,6,7,4,15,25,49,-24,25
Glentoran,3977,7,6,6,10,24,32,-8,24
Dungannon,3977,8,2,4,16,14,47,-33,10
Crusaders,3978,1,17,6,3,62,30,32,57
Coleraine,3978,2,15,10,1,45,23,22,55
Glenavon,3978,3,9,9,8,53,45,8,36
Linfield,3978,4,10,6,10,38,37,1,36
Cliftonville,3978,5,9,5,12,33,32,1,32
Ballymena,3978,6,7,4,15,25,48,-23,25
Glentoran,3978,7,6,6,10,24,32,-8,24
Dungannon,3978,8,2,4,16,14,47,-33,10
Crusaders,3979,1,16,6,4,63,33,30,54
Coleraine,3979,2,14,10,2,43,23,20,52
Glenavon,3979,3,10,9,7,53,43,10,39
Linfield,3979,4,11,5,10,40,37,3,38
Cliftonville,3979,5,9,4,13,33,34,-1,31
Ballymena,3979,6,8,4,14,28,49,-21,28
Glentoran,3979,7,6,6,10,24,32,-8,24
Dungannon,3979,8,2,4,16,14,47,-33,10
Crusaders,3980,1,17,6,3,67,30,37,57
Coleraine,3980,2,14,11,1,45,24,21,53
Linfield,3980,3,11,5,10,38,36,2,38
Glenavon,3980,4,9,10,7,54,45,9,37
Cliftonville,3980,5,9,4,13,32,32,0,31
Ballymena,3980,6,7,4,15,25,53,-28,25
Glentoran,3980,7,6,6,10,24,32,-8,24
Dungannon,3980,8,2,4,16,14,47,-33,10
Crusaders,3981,1,16,6,4,62,32,30,54
Coleraine,3981,2,14,10,2,45,27,18,52
Glenavon,3981,3,10,9,7,57,45,12,39
Linfield,3981,4,10,6,10,38,37,1,36
Cliftonville,3981,5,9,5,12,33,32,1,32
Ballymena,3981,6,8,4,14,27,48,-21,28
Glentoran,3981,7,6,6,10,24,32,-8,24
Dungannon,3981,8,2,4,16,14,47,-33,10
Crusaders,3982,1,16,7,3,62,31,31,55
Coleraine,3982,2,15,10,1,46,22,24,55
Glenavon,3982,3,9,9,8,52,46,6,36
Linfield,3982,4,10,5,11,37,38,-1,35
Cliftonville,3982,5,10,4,12,34,31,3,34
Ballymena,3982,6,7,5,14,26,48,-22,26
Glentoran,3982,7,6,6,10,24,32,-8,24
Dungannon,3982,8,2,4,16,14,47,-33,10
Crusaders,3983,1,17,6,3,65,31,34,57
Coleraine,3983,2,15,10,1,46,24,22,55
Glenavon,3983,3,9,9,8,54,46,8,36
Linfield,3983,4,10,5,11,37,37,0,35
Cliftonville,3983,5,10,4,12,33,31,2,34
Ballymena,3983,6,7,4,15,26,51,-25,25
Glentoran,3983,7,6,6,10,24,32,-8,24
Dungannon,3983,8,2,4,16,14,47,-33,10
Crusaders,3984,1,17,6,3,67,31,36,57
Coleraine,3984,2,14,10,2,44,24,20,52
Glenavon,3984,3,10,9,7,54,44,10,39
Linfield,3984,4,10,6,10,37,36,1,36
Cliftonville,3984,5,9,5,12,32,31,1,32
Ballymena,3984,6,7,4,15,26,53,-27,25
Glentoran,3984,7,6,6,10,24,32,-8,24
Dungannon,3984,8,2,4,16,14,47,-33,10
Crusaders,3985,1,17,6,3,65,31,34,57
Coleraine,3985,2,14,10,2,43,24,19,52
Glenavon,3985,3,10,9,7,54,43,11,39
Linfield,3985,4,11,5,10,38,36,2,38
Cliftonville,3985,5,9,4,13,32,32,0,31
Ballymena,3985,6,7,4,15,26,51,-25,25
Glentoran,3985,7,6,6,10,24,32,-8,24
Dungannon,3985,8,2,4,16,14,47,-33,10
Crusaders,3986,1,17,6,3,63,30,33,57
Coleraine,3986,2,14,11,1,44,23,21,53
Linfield,3986,3,11,5,10,40,36,4,38
Glenavon,3986,4,9,10,7,53,44,9,37
Cliftonville,3986,5,9,4,13,32,34,-2,31
Ballymena,3986,6,7,4,15,25,49,-24,25
Glentoran,3986,7,6,6,10,24,32,-8,24
Dungannon,3986,8,2,4,16,14,47,-33,10
Crusaders,3987,1,17,6,3,64,31,33,57
Coleraine,3987,2,14,10,2,44,24,20,52
Glenavon,3987,3,10,9,7,54,44,10,39
Linfield,3987,4,11,5,10,39,36,3,38
Cliftonville,3987,5,9,4,13,32,33,-1,31
Ballymena,3987,6,7,4,15,26,50,-24,25
Glentoran,3987,7,6,6,10,24,32,-8,24
Dungannon,3987,8,2,4,16,14,47,-33,10
Crusaders,3988,1,16,7,3,63,32,31,55
Coleraine,3988,2,15,10,1,46,24,22,55
Glenavon,3988,3,9,9,8,54,46,8,36
Linfield,3988,4,10,6,10,37,36,1,36
Cliftonville,3988,5,9,5,12,32,31,1,32
Ballymena,3988,6,7,5,14,27,49,-22,26
Glentoran,3988,7,6,6,10,24,32,-8,24
Dungannon,3988,8,2,4,16,14,47,-33,10
Crusaders,3989,1,17,6,3,63,31,32,57
Coleraine,3989,2,15,10,1,46,24,22,55
Glenavon,3989,3,9,9,8,54,46,8,36
Linfield,3989,4,10,5,11,38,39,-1,35
Cliftonville,3989,5,10,4,12,35,32,3,34
Ballymena,3989,6,7,4,15,26,49,-23,25
Glentoran,3989,7,6,6,10,24,32,-8,24
Dungannon,3989,8,2,4,16,14,47,-33,10
Crusaders,3990,1,16,6,4,61,31,30,54
Coleraine,3990,2,14,10,2,44,24,20,52
Glenavon,3990,3,10,9,7,54,44,10,39
Linfield,3990,4,11,5,10,39,37,2,38
Cliftonville,3990,5,9,4,13,33,33,0,31
Ballymena,3990,6,8,4,14,26,47,-21,28
Glentoran,3990,7,6,6,10,24,32,-8,24
Dungannon,3990,8,2,4,16,14,47,-33,10
Coleraine,3991,1,15,10,1,44,22,22,55
Crusaders,3991,2,16,6,4,63,33,30,54
Linfield,3991,3,11,5,10,38,36,2,38
Glenavon,3991,4,9,9,8,52,44,8,36
Cliftonville,3991,5,9,4,13,32,32,0,31
Ballymena,3991,6,8,4,14,28,49,-21,28
Glentoran,3991,7,6,6,10,24,32,-8,24
Dungannon,3991,8,2,4,16,14,47,-33,10
Crusaders,3992,1,17,6,3,65,33,32,57
Coleraine,3992,2,14,10,2,44,24,20,52
Glenavon,3992,3,10,9,7,54,44,10,39
Linfield,3992,4,10,6,10,37,36,1,36
Cliftonville,3992,5,9,5,12,32,31,1,32
Ballymena,3992,6,7,4,15,28,51,-23,25
Glentoran,3992,7,6,6,10,24,32,-8,24
Dungannon,3992,8,2,4,16,14,47,-33,10
Crusaders,3993,1,17,6,3,63,30,33,57
Coleraine,3993,2,14,10,2,43,24,19,52
Glenavon,3993,3,10,9,7,54,43,11,39
Linfield,3993,4,11,5,10,42,37,5,38
Cliftonville,3993,5,9,4,13,33,36,-3,31
Ballymena,3993,6,7,4,15,25,49,-24,25
Glentoran,3993,7,6,6,10,24,32,-8,24
Dungannon,3993,8,2,4,16,14,47,-33,10
Crusaders,3994,1,17,6,3,66,32,34,57
Coleraine,3994,2,14,11,1,43,22,21,53
Linfield,3994,3,11,5,10,38,36,2,38
Glenavon,3994,4,9,10,7,52,43,9,37
Cliftonville,3994,5,9,4,13,32,32,0,31
Ballymena,3994,6,7,4,15,27,52,-25,25
Glentoran,3994,7,6,6,10,24,32,-8,24
Dungannon,3994,8,2,4,16,14,47,-33,10
Crusaders,3995,1,16,6,4,62,33,29,54
Coleraine,3995,2,14,10,2,43,27,16,52
Glenavon,3995,3,10,9,7,57,43,14,39
Linfield,3995,4,10,6,10,37,36,1,36
Cliftonville,3995,5,9,5,12,32,31,1,32
Ballymena,3995,6,8,4,14,28,48,-20,28
Glentoran,3995,7,6,6,10,24,32,-8,24
Dungannon,3995,8,2,4,16,14,47,-33,10
Crusaders,3996,1,17,6,3,62,30,32,57
Coleraine,3996,2,14,11,1,44,23,21,53
Glenavon,3996,3,9,10,7,53,44,9,37
Linfield,3996,4,10,5,11,37,38,-1,35
Cliftonville,3996,5,10,4,12,34,31,3,34
Ballymena,3996,6,7,4,15,25,48,-23,25
Glentoran,3996,7,6,6,10,24,32,-8,24
Dungannon,3996,8,2,4,16,14,47,-33,10
Crusaders,3997,1,16,7,3,62,31,31,55
Coleraine,3997,2,14,10,2,43,23,20,52
Glenavon,3997,3,10,9,7,53,43,10,39
Linfield,3997,4,10,5,11,37,37,0,35
Cliftonville,3997,5,10,4,12,33,31,2,34
Ballymena,3997,6,7,5,14,26,48,-22,26
Glentoran,3997,7,6,6,10,24,32,-8,24
Dungannon,3997,8,2,4,16,14,47,-33,10
Crusaders,3998,1,16,7,3,62,31,31,55
Coleraine,3998,2,15,10,1,47,23,24,55
Glenavon,3998,3,9,9,8,53,47,6,36
Linfield,3998,4,10,6,10,37,36,1,36
Cliftonville,3998,5,9,5,12,32,31,1,32
Ballymena,3998,6,7,5,14,26,48,-22,26
Glentoran,3998,7,6,6,10,24,32,-8,24
Dungannon,3998,8,2,4,16,14,47,-33,10
Crusaders,3999,1,17,6,3,65,31,34,57
Coleraine,3999,2,15,10,1,44,22,22,55
Glenavon,3999,3,9,9,8,52,44,8,36
Linfield,3999,4,10,5,11,37,37,0,35
Cliftonville,3999,5,10,4,12,33,31,2,34
Ballymena,3999,6,7,4,15,26,51,-25,25
Glentoran,3999,7,6,6,10,24,32,-8,24
Dungannon,3999,8,2,4,16,14,47,-33,10
Crusaders,4000,1,16,7,3,62,31,31,55
Coleraine,4000,2,15,10,1,46,23,23,55
Glenavon,4000,3,9,9,8,53,46,7,36
Linfield,4000,4,10,6,10,37,36,1,36
Cliftonville,4000,5,9,5,12,32,31,1,32
Ballymena,4000,6,7,5,14,26,48,-22,26
Glentoran,4000,7,6,6,10,24,32,-8,24
Dungannon,4000,8,2,4,16,14,47,-33,10
Crusaders,4001,1,17,6,3,63,31,32,57
Coleraine,4001,2,15,10,1,47,24,23,55
Glenavon,4001,3,9,9,8,54,47,7,36
Linfield,4001,4,10,6,10,38,37,1,36
Cliftonville,4001,5,9,5,12,33,32,1,32
Ballymena,4001,6,7,4,15,26,49,-23,25
Glentoran,4001,7,6,6,10,24,32,-8,24
Dungannon,4001,8,2,4,16,14,47,-33,10
Crusaders,4002,1,17,6,3,63,30,33,57
Coleraine,4002,2,15,10,1,45,23,22,55
Glenavon,4002,3,9,9,8,53,45,8,36
Linfield,4002,4,10,6,10,38,37,1,36
Cliftonville,4002,5,9,5,12,33,32,1,32
Ballymena,4002,6,7,4,15,25,49,-24,25
Glentoran,4002,7,6,6,10,24,32,-8,24
Dungannon,4002,8,2,4,16,14,47,-33,10
Crusaders,4003,1,16,6,4,62,32,30,54
Coleraine,4003,2,14,10,2,46,26,20,52
Glenavon,4003,3,10,9,7,56,46,10,39
Linfield,4003,4,10,5,11,38,39,-1,35
Cliftonville,4003,5,10,4,12,35,32,3,34
Ballymena,4003,6,8,4,14,27,48,-21,28
Glentoran,4003,7,6,6,10,24,32,-8,24
Dungannon,4003,8,2,4,16,14,47,-33,10
Crusaders,4004,1,16,7,3,62,31,31,55
Coleraine,4004,2,14,10,2,44,27,17,52
Glenavon,4004,3,10,9,7,57,44,13,39
Linfield,4004,4,10,5,11,39,40,-1,35
Cliftonville,4004,5,10,4,12,36,33,3,34
Ballymena,4004,6,7,5,14,26,48,-22,26
Glentoran,4004,7,6,6,10,24,32,-8,24
Dungannon,4004,8,2,4,16,14,47,-33,10
Crusaders,4005,1,16,7,3,62,31,31,55
Coleraine,4005,2,14,11,1,44,23,21,53
Glenavon,4005,3,9,10,7,53,44,9,37
Linfield,4005,4,10,5,11,37,37,0,35
Cliftonville,4005,5,10,4,12,33,31,2,34
Ballymena,4005,6,7,5,14,26,48,-22,26
Glentoran,4005,7,6,6,10,24,32,-8,24
Dungannon,4005,8,2,4,16,14,47,-33,10
Coleraine,4006,1,15,10,1,47,23,24,55
Crusaders,4006,2,16,6,4,61,31,30,54
Glenavon,4006,3,9,9,8,53,47,6,36
Linfield,4006,4,10,6,10,37,36,1,36
Cliftonville,4006,5,9,5,12,32,31,1,32
Ballymena,4006,6,8,4,14,26,47,-21,28
Glentoran,4006,7,6,6,10,24,32,-8,24
Dungannon,4006,8,2,4,16,14,47,-33,10
Crusaders,4007,1,17,6,3,63,30,33,57
Coleraine,4007,2,15,10,1,44,22,22,55
Glenavon,4007,3,9,9,8,52,44,8,36
Linfield,4007,4,10,6,10,37,36,1,36
Cliftonville,4007,5,9,5,12,32,31,1,32
Ballymena,4007,6,7,4,15,25,49,-24,25
Glentoran,4007,7,6,6,10,24,32,-8,24
Dungannon,4007,8,2,4,16,14,47,-33,10
Crusaders,4008,1,16,7,3,62,31,31,55
Coleraine,4008,2,14,10,2,44,24,20,52
Glenavon,4008,3,10,9,7,54,44,10,39
Linfield,4008,4,11,5,10,38,36,2,38
Cliftonville,4008,5,9,4,13,32,32,0,31
Ballymena,4008,6,7,5,14,26,48,-22,26
Glentoran,4008,7,6,6,10,24,32,-8,24
Dungannon,4008,8,2,4,16,14,47,-33,10
Crusaders,4009,1,16,6,4,63,33,30,54
Coleraine,4009,2,14,10,2,43,26,17,52
Glenavon,4009,3,10,9,7,56,43,13,39
Linfield,4009,4,10,6,10,37,36,1,36
Cliftonville,4009,5,9,5,12,32,31,1,32
Ballymena,4009,6,8,4,14,28,49,-21,28
Glentoran,4009,7,6,6,10,24,32,-8,24
Dungannon,4009,8,2,4,16,14,47,-33,10
Crusaders,4010,1,16,6,4,61,31,30,54
Coleraine,4010,2,14,10,2,43,25,18,52
Glenavon,4010,3,10,9,7,55,43,12,39
Linfield,4010,4,10,5,11,37,39,-2,35
Cliftonville,4010,5,10,4,12,35,31,4,34
Ballymena,4010,6,8,4,14,26,47,-21,28
Glentoran,4010,7,6,6,10,24,32,-8,24
Dungannon,4010,8,2,4,16,14,47,-33,10
Crusaders,4011,1,17,6,3,64,32,32,57
Coleraine,4011,2,14,11,1,45,24,21,53
Glenavon,4011,3,9,10,7,54,45,9,37
Linfield,4011,4,10,5,11,37,38,-1,35
Cliftonville,4011,5,10,4,12,34,31,3,34
Ballymena,4011,6,7,4,15,27,50,-23,25
Glentoran,4011,7,6,6,10,24,32,-8,24
Dungannon,4011,8,2,4,16,14,47,-33,10
Crusaders,4012,1,17,6,3,64,30,34,57
Coleraine,4012,2,15,10,1,45,23,22,55
Linfield,4012,3,11,5,10,40,37,3,38
Glenavon,4012,4,9,9,8,53,45,8,36
Cliftonville,4012,5,9,4,13,33,34,-1,31
Ballymena,4012,6,7,4,15,25,50,-25,25
Glentoran,4012,7,6,6,10,24,32,-8,24
Dungannon,4012,8,2,4,16,14,47,-33,10
Crusaders,4013,1,16,7,3,63,32,31,55
Coleraine,4013,2,15,10,1,46,24,22,55
Glenavon,4013,3,9,9,8,54,46,8,36
Linfield,4013,4,10,6,10,37,36,1,36
Cliftonville,4013,5,9,5,12,32,31,1,32
Ballymena,4013,6,7,5,14,27,49,-22,26
Glentoran,4013,7,6,6,10,24,32,-8,24
Dungannon,4013,8,2,4,16,14,47,-33,10
Crusaders,4014,1,16,7,3,62,31,31,55
Coleraine,4014,2,14,10,2,43,25,18,52
Glenavon,4014,3,10,9,7,55,43,12,39
Linfield,4014,4,10,6,10,39,38,1,36
Cliftonville,4014,5,9,5,12,34,33,1,32
Ballymena,4014,6,7,5,14,26,48,-22,26
Glentoran,4014,7,6,6,10,24,32,-8,24
Dungannon,4014,8,2,4,16,14,47,-33,10
Crusaders,4015,1,17,6,3,63,31,32,57
Coleraine,4015,2,15,10,1,44,22,22,55
Glenavon,4015,3,9,9,8,52,44,8,36
Linfield,4015,4,10,5,11,37,37,0,35
Cliftonville,4015,5,10,4,12,33,31,2,34
Ballymena,4015,6,7,4,15,26,49,-23,25
Glentoran,4015,7,6,6,10,24,32,-8,24
Dungannon,4015,8,2,4,16,14,47,-33,10
Crusaders,4016,1,17,6,3,62,30,32,57
Coleraine,4016,2,14,10,2,45,25,20,52
Glenavon,4016,3,10,9,7,55,45,10,39
Linfield,4016,4,10,6,10,38,37,1,36
Cliftonville,4016,5,9,5,12,33,32,1,32
Ballymena,4016,6,7,4,15,25,48,-23,25
Glentoran,4016,7,6,6,10,24,32,-8,24
Dungannon,4016,8,2,4,16,14,47,-33,10
Crusaders,4017,1,16,6,4,64,34,30,54
Coleraine,4017,2,14,11,1,44,23,21,53
Linfield,4017,3,11,5,10,40,37,3,38
Glenavon,4017,4,9,10,7,53,44,9,37
Cliftonville,4017,5,9,4,13,33,34,-1,31
Ballymena,4017,6,8,4,14,29,50,-21,28
Glentoran,4017,7,6,6,10,24,32,-8,24
Dungannon,4017,8,2,4,16,14,47,-33,10
Crusaders,4018,1,16,6,4,61,31,30,54
Coleraine,4018,2,14,11,1,44,23,21,53
Glenavon,4018,3,9,10,7,53,44,9,37
Linfield,4018,4,10,5,11,37,38,-1,35
Cliftonville,4018,5,10,4,12,34,31,3,34
Ballymena,4018,6,8,4,14,26,47,-21,28
Glentoran,4018,7,6,6,10,24,32,-8,24
Dungannon,4018,8,2,4,16,14,47,-33,10
Crusaders,4019,1,17,6,3,64,30,34,57
Coleraine,4019,2,14,11,1,43,22,21,53
Linfield,4019,3,11,5,10,39,37,2,38
Glenavon,4019,4,9,10,7,52,43,9,37
Cliftonville,4019,5,9,4,13,33,33,0,31
Ballymena,4019,6,7,4,15,25,50,-25,25
Glentoran,4019,7,6,6,10,24,32,-8,24
Dungannon,4019,8,2,4,16,14,47,-33,10
Crusaders,4020,1,17,6,3,64,30,34,57
Coleraine,4020,2,15,10,1,47,25,22,55
Linfield,4020,3,11,5,10,38,36,2,38
Glenavon,4020,4,9,9,8,55,47,8,36
Cliftonville,4020,5,9,4,13,32,32,0,31
Ballymena,4020,6,7,4,15,25,50,-25,25
Glentoran,4020,7,6,6,10,24,32,-8,24
Dungannon,4020,8,2,4,16,14,47,-33,10
Crusaders,4021,1,17,6,3,64,32,32,57
Coleraine,4021,2,15,10,1,45,22,23,55
Linfield,4021,3,11,5,10,39,37,2,38
Glenavon,4021,4,9,9,8,52,45,7,36
Cliftonville,4021,5,9,4,13,33,33,0,31
Ballymena,4021,6,7,4,15,27,50,-23,25
Glentoran,4021,7,6,6,10,24,32,-8,24
Dungannon,4021,8,2,4,16,14,47,-33,10
Coleraine,4022,1,15,10,1,45,22,23,55
Crusaders,4022,2,16,6,4,64,34,30,54
Linfield,4022,3,11,5,10,41,38,3,38
Glenavon,4022,4,9,9,8,52,45,7,36
Cliftonville,4022,5,9,4,13,34,35,-1,31
Ballymena,4022,6,8,4,14,29,50,-21,28
Glentoran,4022,7,6,6,10,24,32,-8,24
Dungannon,4022,8,2,4,16,14,47,-33,10
Crusaders,4023,1,17,6,3,65,30,35,57
Coleraine,4023,2,14,11,1,44,23,21,53
Linfield,4023,3,11,5,10,38,36,2,38
Glenavon,4023,4,9,10,7,53,44,9,37
Cliftonville,4023,5,9,4,13,32,32,0,31
Ballymena,4023,6,7,4,15,25,51,-26,25
Glentoran,4023,7,6,6,10,24,32,-8,24
Dungannon,4023,8,2,4,16,14,47,-33,10
Crusaders,4024,1,17,6,3,64,31,33,57
Coleraine,4024,2,14,10,2,43,25,18,52
Glenavon,4024,3,10,9,7,55,43,12,39
Linfield,4024,4,11,5,10,39,37,2,38
Cliftonville,4024,5,9,4,13,33,33,0,31
Ballymena,4024,6,7,4,15,26,50,-24,25
Glentoran,4024,7,6,6,10,24,32,-8,24
Dungannon,4024,8,2,4,16,14,47,-33,10
Crusaders,4025,1,17,6,3,64,32,32,57
Coleraine,4025,2,14,11,1,47,26,21,53
Linfield,4025,3,11,5,10,41,38,3,38
Glenavon,4025,4,9,10,7,56,47,9,37
Cliftonville,4025,5,9,4,13,34,35,-1,31
Ballymena,4025,6,7,4,15,27,50,-23,25
Glentoran,4025,7,6,6,10,24,32,-8,24
Dungannon,4025,8,2,4,16,14,47,-33,10
Crusaders,4026,1,17,6,3,63,31,32,57
Coleraine,4026,2,15,10,1,45,22,23,55
Glenavon,4026,3,9,9,8,52,45,7,36
Linfield,4026,4,10,6,10,38,37,1,36
Cliftonville,4026,5,9,5,12,33,32,1,32
Ballymena,4026,6,7,4,15,26,49,-23,25
Glentoran,4026,7,6,6,10,24,32,-8,24
Dungannon,4026,8,2,4,16,14,47,-33,10
Crusaders,4027,1,16,7,3,64,33,31,55
Coleraine,4027,2,14,11,1,44,23,21,53
Linfield,4027,3,11,5,10,38,36,2,38
Glenavon,4027,4,9,10,7,53,44,9,37
Cliftonville,4027,5,9,4,13,32,32,0,31
Ballymena,4027,6,7,5,14,28,50,-22,26
Glentoran,4027,7,6,6,10,24,32,-8,24
Dungannon,4027,8,2,4,16,14,47,-33,10
Crusaders,4028,1,16,6,4,61,31,30,54
Coleraine,4028,2,14,10,2,43,24,19,52
Glenavon,4028,3,10,9,7,54,43,11,39
Linfield,4028,4,10,5,11,37,38,-1,35
Cliftonville,4028,5,10,4,12,34,31,3,34
Ballymena,4028,6,8,4,14,26,47,-21,28
Glentoran,4028,7,6,6,10,24,32,-8,24
Dungannon,4028,8,2,4,16,14,47,-33,10
Crusaders,4029,1,16,7,3,62,31,31,55
Coleraine,4029,2,14,10,2,44,24,20,52
Glenavon,4029,3,10,9,7,54,44,10,39
Linfield,4029,4,10,6,10,39,38,1,36
Cliftonville,4029,5,9,5,12,34,33,1,32
Ballymena,4029,6,7,5,14,26,48,-22,26
Glentoran,4029,7,6,6,10,24,32,-8,24
Dungannon,4029,8,2,4,16,14,47,-33,10
Crusaders,4030,1,17,6,3,62,30,32,57
Coleraine,4030,2,14,11,1,43,22,21,53
Linfield,4030,3,11,5,10,38,36,2,38
Glenavon,4030,4,9,10,7,52,43,9,37
Cliftonville,4030,5,9,4,13,32,32,0,31
Ballymena,4030,6,7,4,15,25,48,-23,25
Glentoran,4030,7,6,6,10,24,32,-8,24
Dungannon,4030,8,2,4,16,14,47,-33,10
Crusaders,4031,1,16,7,3,62,31,31,55
Coleraine,4031,2,15,10,1,45,23,22,55
Glenavon,4031,3,9,9,8,53,45,8,36
Linfield,4031,4,10,5,11,37,39,-2,35
Cliftonville,4031,5,10,4,12,35,31,4,34
Ballymena,4031,6,7,5,14,26,48,-22,26
Glentoran,4031,7,6,6,10,24,32,-8,24
Dungannon,4031,8,2,4,16,14,47,-33,10
Crusaders,4032,1,17,6,3,64,32,32,57
Coleraine,4032,2,15,10,1,47,23,24,55
Glenavon,4032,3,9,9,8,53,47,6,36
Linfield,4032,4,10,5,11,37,37,0,35
Cliftonville,4032,5,10,4,12,33,31,2,34
Ballymena,4032,6,7,4,15,27,50,-23,25
Glentoran,4032,7,6,6,10,24,32,-8,24
Dungannon,4032,8,2,4,16,14,47,-33,10
Crusaders,4033,1,17,6,3,63,31,32,57
Coleraine,4033,2,15,10,1,44,22,22,55
Linfield,4033,3,11,5,10,39,37,2,38
Glenavon,4033,4,9,9,8,52,44,8,36
Cliftonville,4033,5,9,4,13,33,33,0,31
Ballymena,4033,6,7,4,15,26,49,-23,25
Glentoran,4033,7,6,6,10,24,32,-8,24
Dungannon,4033,8,2,4,16,14,47,-33,10
Crusaders,4034,1,17,6,3,64,31,33,57
Coleraine,4034,2,14,10,2,43,24,19,52
Glenavon,4034,3,10,9,7,54,43,11,39
Linfield,4034,4,10,5,11,37,37,0,35
Cliftonville,4034,5,10,4,12,33,31,2,34
Ballymena,4034,6,7,4,15,26,50,-24,25
Glentoran,4034,7,6,6,10,24,32,-8,24
Dungannon,4034,8,2,4,16,14,47,-33,10
Crusaders,4035,1,17,6,3,67,32,35,57
Coleraine,4035,2,14,10,2,44,24,20,52
Glenavon,4035,3,10,9,7,54,44,10,39
Linfield,4035,4,11,5,10,40,36,4,38
Cliftonville,4035,5,9,4,13,32,34,-2,31
Ballymena,4035,6,7,4,15,27,53,-26,25
Glentoran,4035,7,6,6,10,24,32,-8,24
Dungannon,4035,8,2,4,16,14,47,-33,10
Crusaders,4036,1,16,6,4,61,31,30,54
Coleraine,4036,2,14,10,2,43,23,20,52
Glenavon,4036,3,10,9,7,53,43,10,39
Linfield,4036,4,11,5,10,39,36,3,38
Cliftonville,4036,5,9,4,13,32,33,-1,31
Ballymena,4036,6,8,4,14,26,47,-21,28
Glentoran,4036,7,6,6,10,24,32,-8,24
Dungannon,4036,8,2,4,16,14,47,-33,10
Crusaders,4037,1,16,7,3,63,32,31,55
Coleraine,4037,2,15,10,1,45,22,23,55
Linfield,4037,3,11,5,10,39,36,3,38
Glenavon,4037,4,9,9,8,52,45,7,36
Cliftonville,4037,5,9,4,13,32,33,-1,31
Ballymena,4037,6,7,5,14,27,49,-22,26
Glentoran,4037,7,6,6,10,24,32,-8,24
Dungannon,4037,8,2,4,16,14,47,-33,10
Crusaders,4038,1,17,6,3,63,31,32,57
Coleraine,4038,2,14,10,2,45,25,20,52
Glenavon,4038,3,10,9,7,55,45,10,39
Linfield,4038,4,10,6,10,37,36,1,36
Cliftonville,4038,5,9,5,12,32,31,1,32
Ballymena,4038,6,7,4,15,26,49,-23,25
Glentoran,4038,7,6,6,10,24,32,-8,24
Dungannon,4038,8,2,4,16,14,47,-33,10
Crusaders,4039,1,17,6,3,63,30,33,57
Coleraine,4039,2,14,10,2,43,24,19,52
Glenavon,4039,3,10,9,7,54,43,11,39
Linfield,4039,4,10,5,11,38,38,0,35
Cliftonville,4039,5,10,4,12,34,32,2,34
Ballymena,4039,6,7,4,15,25,49,-24,25
Glentoran,4039,7,6,6,10,24,32,-8,24
Dungannon,4039,8,2,4,16,14,47,-33,10
Crusaders,4040,1,16,7,3,61,30,31,55
Coleraine,4040,2,15,10,1,46,23,23,55
Linfield,4040,3,11,5,10,42,36,6,38
Glenavon,4040,4,9,9,8,53,46,7,36
Cliftonville,4040,5,9,4,13,32,36,-4,31
Ballymena,4040,6,7,5,14,25,47,-22,26
Glentoran,4040,7,6,6,10,24,32,-8,24
Dungannon,4040,8,2,4,16,14,47,-33,10
Crusaders,4041,1,17,6,3,64,31,33,57
Coleraine,4041,2,14,11,1,44,23,21,53
Glenavon,4041,3,9,10,7,53,44,9,37
Linfield,4041,4,10,6,10,39,38,1,36
Cliftonville,4041,5,9,5,12,34,33,1,32
Ballymena,4041,6,7,4,15,26,50,-24,25
Glentoran,4041,7,6,6,10,24,32,-8,24
Dungannon,4041,8,2,4,16,14,47,-33,10
Crusaders,4042,1,16,7,3,62,31,31,55
Coleraine,4042,2,14,11,1,44,23,21,53
Glenavon,4042,3,9,10,7,53,44,9,37
Linfield,4042,4,10,5,11,38,40,-2,35
Cliftonville,4042,5,10,4,12,36,32,4,34
Ballymena,4042,6,7,5,14,26,48,-22,26
Glentoran,4042,7,6,6,10,24,32,-8,24
Dungannon,4042,8,2,4,16,14,47,-33,10
Crusaders,4043,1,17,6,3,63,30,33,57
Coleraine,4043,2,14,10,2,44,24,20,52
Glenavon,4043,3,10,9,7,54,44,10,39
Linfield,4043,4,11,5,10,38,36,2,38
Cliftonville,4043,5,9,4,13,32,32,0,31
Ballymena,4043,6,7,4,15,25,49,-24,25
Glentoran,4043,7,6,6,10,24,32,-8,24
Dungannon,4043,8,2,4,16,14,47,-33,10
Crusaders,4044,1,16,6,4,63,33,30,54
Coleraine,4044,2,14,10,2,43,23,20,52
Glenavon,4044,3,10,9,7,53,43,10,39
Linfield,4044,4,10,5,11,40,40,0,35
Cliftonville,4044,5,10,4,12,36,34,2,34
Ballymena,4044,6,8,4,14,28,49,-21,28
Glentoran,4044,7,6,6,10,24,32,-8,24
Dungannon,4044,8,2,4,16,14,47,-33,10
Crusaders,4045,1,16,7,3,62,31,31,55
Coleraine,4045,2,15,10,1,47,23,24,55
Glenavon,4045,3,9,9,8,53,47,6,36
Linfield,4045,4,10,5,11,37,37,0,35
Cliftonville,4045,5,10,4,12,33,31,2,34
Ballymena,4045,6,7,5,14,26,48,-22,26
Glentoran,4045,7,6,6,10,24,32,-8,24
Dungannon,4045,8,2,4,16,14,47,-33,10
Crusaders,4046,1,17,6,3,63,31,32,57
Coleraine,4046,2,15,10,1,45,23,22,55
Linfield,4046,3,11,5,10,39,36,3,38
Glenavon,4046,4,9,9,8,53,45,8,36
Cliftonville,4046,5,9,4,13,32,33,-1,31
Ballymena,4046,6,7,4,15,26,49,-23,25
Glentoran,4046,7,6,6,10,24,32,-8,24
Dungannon,4046,8,2,4,16,14,47,-33,10
Crusaders,4047,1,17,6,3,67,31,36,57
Coleraine,4047,2,14,10,2,46,28,18,52
Glenavon,4047,3,10,9,7,58,46,12,39
Linfield,4047,4,10,5,11,37,38,-1,35
Cliftonville,4047,5,10,4,12,34,31,3,34
Ballymena,4047,6,7,4,15,26,53,-27,25
Glentoran,4047,7,6,6,10,24,32,-8,24
Dungannon,4047,8,2,4,16,14,47,-33,10
Crusaders,4048,1,17,6,3,62,30,32,57
Coleraine,4048,2,14,10,2,43,23,20,52
Glenavon,4048,3,10,9,7,53,43,10,39
Linfield,4048,4,11,5,10,41,36,5,38
Cliftonville,4048,5,9,4,13,32,35,-3,31
Ballymena,4048,6,7,4,15,25,48,-23,25
Glentoran,4048,7,6,6,10,24,32,-8,24
Dungannon,4048,8,2,4,16,14,47,-33,10
Crusaders,4049,1,17,6,3,65,31,34,57
Coleraine,4049,2,15,10,1,45,23,22,55
Linfield,4049,3,11,5,10,39,36,3,38
Glenavon,4049,4,9,9,8,53,45,8,36
Cliftonville,4049,5,9,4,13,32,33,-1,31
Ballymena,4049,6,7,4,15,26,51,-25,25
Glentoran,4049,7,6,6,10,24,32,-8,24
Dungannon,4049,8,2,4,16,14,47,-33,10
Crusaders,4050,1,16,7,3,61,30,31,55
Coleraine,4050,2,14,10,2,44,24,20,52
Glenavon,4050,3,10,9,7,54,44,10,39
Linfield,4050,4,11,5,10,40,38,2,38
Cliftonville,4050,5,9,4,13,34,34,0,31
Ballymena,4050,6,7,5,14,25,47,-22,26
Glentoran,4050,7,6,6,10,24,32,-8,24
Dungannon,4050,8,2,4,16,14,47,-33,10
Crusaders,4051,1,17,6,3,66,31,35,57
Coleraine,4051,2,14,10,2,44,24,20,52
Glenavon,4051,3,10,9,7,54,44,10,39
Linfield,4051,4,10,6,10,37,36,1,36
Cliftonville,4051,5,9,5,12,32,31,1,32
Ballymena,4051,6,7,4,15,26,52,-26,25
Glentoran,4051,7,6,6,10,24,32,-8,24
Dungannon,4051,8,2,4,16,14,47,-33,10
Crusaders,4052,1,16,6,4,62,32,30,54
Coleraine,4052,2,14,11,1,43,22,21,53
Glenavon,4052,3,9,10,7,52,43,9,37
Linfield,4052,4,10,5,11,37,37,0,35
Cliftonville,4052,5,10,4,12,33,31,2,34
Ballymena,4052,6,8,4,14,27,48,-21,28
Glentoran,4052,7,6,6,10,24,32,-8,24
Dungannon,4052,8,2,4,16,14,47,-33,10
Crusaders,4053,1,16,7,3,62,31,31,55
Coleraine,4053,2,14,10,2,43,23,20,52
Glenavon,4053,3,10,9,7,53,43,10,39
Linfield,4053,4,10,5,11,37,37,0,35
Cliftonville,4053,5,10,4,12,33,31,2,34
Ballymena,4053,6,7,5,14,26,48,-22,26
Glentoran,4053,7,6,6,10,24,32,-8,24
Dungannon,4053,8,2,4,16,14,47,-33,10
Crusaders,4054,1,17,6,3,63,31,32,57
Coleraine,4054,2,14,10,2,44,24,20,52
Glenavon,4054,3,10,9,7,54,44,10,39
Linfield,4054,4,10,5,11,37,37,0,35
Cliftonville,4054,5,10,4,12,33,31,2,34
Ballymena,4054,6,7,4,15,26,49,-23,25
Glentoran,4054,7,6,6,10,24,32,-8,24
Dungannon,4054,8,2,4,16,14,47,-33,10
Crusaders,4055,1,17,6,3,63,30,33,57
Coleraine,4055,2,14,10,2,43,25,18,52
Glenavon,4055,3,10,9,7,55,43,12,39
Linfield,4055,4,11,5,10,40,36,4,38
Cliftonville,4055,5,9,4,13,32,34,-2,31
Ballymena,4055,6,7,4,15,25,49,-24,25
Glentoran,4055,7,6,6,10,24,32,-8,24
Dungannon,4055,8,2,4,16,14,47,-33,10
Crusaders,4056,1,17,6,3,64,30,34,57
Coleraine,4056,2,14,10,2,44,27,17,52
Glenavon,4056,3,10,9,7,57,44,13,39
Linfield,4056,4,11,5,10,40,38,2,38
Cliftonville,4056,5,9,4,13,34,34,0,31
Ballymena,4056,6,7,4,15,25,50,-25,25
Glentoran,4056,7,6,6,10,24,32,-8,24
Dungannon,4056,8,2,4,16,14,47,-33,10
Crusaders,4057,1,16,7,3,62,31,31,55
Coleraine,4057,2,15,10,1,45,23,22,55
Linfield,4057,3,11,5,10,40,38,2,38
Glenavon,4057,4,9,9,8,53,45,8,36
Cliftonville,4057,5,9,4,13,34,34,0,31
Ballymena,4057,6,7,5,14,26,48,-22,26
Glentoran,4057,7,6,6,10,24,32,-8,24
Dungannon,4057,8,2,4,16,14,47,-33,10
Crusaders,4058,1,17,6,3,63,30,33,57
Coleraine,4058,2,15,10,1,45,22,23,55
Linfield,4058,3,11,5,10,39,37,2,38
Glenavon,4058,4,9,9,8,52,45,7,36
Cliftonville,4058,5,9,4,13,33,33,0,31
Ballymena,4058,6,7,4,15,25,49,-24,25
Glentoran,4058,7,6,6,10,24,32,-8,24
Dungannon,4058,8,2,4,16,14,47,-33,10
Crusaders,4059,1,17,6,3,64,30,34,57
Coleraine,4059,2,14,10,2,46,26,20,52
Glenavon,4059,3,10,9,7,56,46,10,39
Linfield,4059,4,11,5,10,41,36,5,38
Cliftonville,4059,5,9,4,13,32,35,-3,31
Ballymena,4059,6,7,4,15,25,50,-25,25
Glentoran,4059,7,6,6,10,24,32,-8,24
Dungannon,4059,8,2,4,16,14,47,-33,10
Coleraine,4060,1,15,10,1,45,23,22,55
Crusaders,4060,2,16,6,4,61,31,30,54
Linfield,4060,3,11,5,10,39,37,2,38
Glenavon,4060,4,9,9,8,53,45,8,36
Cliftonville,4060,5,9,4,13,33,33,0,31
Ballymena,4060,6,8,4,14,26,47,-21,28
Glentoran,4060,7,6,6,10,24,32,-8,24
Dungannon,4060,8,2,4,16,14,47,-33,10
Crusaders,4061,1,16,6,4,62,33,29,54
Coleraine,4061,2,14,10,2,45,25,20,52
Glenavon,4061,3,10,9,7,55,45,10,39
Linfield,4061,4,10,5,11,37,38,-1,35
Cliftonville,4061,5,10,4,12,34,31,3,34
Ballymena,4061,6,8,4,14,28,48,-20,28
Glentoran,4061,7,6,6,10,24,32,-8,24
Dungannon,4061,8,2,4,16,14,47,-33,10
Coleraine,4062,1,15,10,1,47,23,24,55
Crusaders,4062,2,16,6,4,66,36,30,54
Linfield,4062,3,11,5,10,40,36,4,38
Glenavon,4062,4,9,9,8,53,47,6,36
Cliftonville,4062,5,9,4,13,32,34,-2,31
Ballymena,4062,6,8,4,14,31,52,-21,28
Glentoran,4062,7,6,6,10,24,32,-8,24
Dungannon,4062,8,2,4,16,14,47,-33,10
Crusaders,4063,1,17,6,3,63,30,33,57
Coleraine,4063,2,15,10,1,47,22,25,55
Glenavon,4063,3,9,9,8,52,47,5,36
Linfield,4063,4,10,5,11,38,38,0,35
Cliftonville,4063,5,10,4,12,34,32,2,34
Ballymena,4063,6,7,4,15,25,49,-24,25
Glentoran,4063,7,6,6,10,24,32,-8,24
Dungannon,4063,8,2,4,16,14,47,-33,10
Crusaders,4064,1,17,6,3,62,30,32,57
Coleraine,4064,2,15,10,1,44,22,22,55
Glenavon,4064,3,9,9,8,52,44,8,36
Linfield,4064,4,10,5,11,37,38,-1,35
Cliftonville,4064,5,10,4,12,34,31,3,34
Ballymena,4064,6,7,4,15,25,48,-23,25
Glentoran,4064,7,6,6,10,24,32,-8,24
Dungannon,4064,8,2,4,16,14,47,-33,10
Crusaders,4065,1,17,6,3,67,33,34,57
Coleraine,4065,2,14,10,2,43,24,19,52
Glenavon,4065,3,10,9,7,54,43,11,39
Linfield,4065,4,11,5,10,38,36,2,38
Cliftonville,4065,5,9,4,13,32,32,0,31
Ballymena,4065,6,7,4,15,28,53,-25,25
Glentoran,4065,7,6,6,10,24,32,-8,24
Dungannon,4065,8,2,4,16,14,47,-33,10
Crusaders,4066,1,17,6,3,64,31,33,57
Coleraine,4066,2,14,11,1,44,23,21,53
Glenavon,4066,3,9,10,7,53,44,9,37
Linfield,4066,4,10,6,10,38,37,1,36
Cliftonville,4066,5,9,5,12,33,32,1,32
Ballymena,4066,6,7,4,15,26,50,-24,25
Glentoran,4066,7,6,6,10,24,32,-8,24
Dungannon,4066,8,2,4,16,14,47,-33,10
Crusaders,4067,1,16,7,3,62,31,31,55
Coleraine,4067,2,14,10,2,44,24,20,52
Glenavon,4067,3,10,9,7,54,44,10,39
Linfield,4067,4,11,5,10,39,36,3,38
Cliftonville,4067,5,9,4,13,32,33,-1,31
Ballymena,4067,6,7,5,14,26,48,-22,26
Glentoran,4067,7,6,6,10,24,32,-8,24
Dungannon,4067,8,2,4,16,14,47,-33,10
Crusaders,4068,1,17,6,3,66,32,34,57
Coleraine,4068,2,15,10,1,44,22,22,55
Linfield,4068,3,11,5,10,38,36,2,38
Glenavon,4068,4,9,9,8,52,44,8,36
Cliftonville,4068,5,9,4,13,32,32,0,31
Ballymena,4068,6,7,4,15,27,52,-25,25
Glentoran,4068,7,6,6,10,24,32,-8,24
Dungannon,4068,8,2,4,16,14,47,-33,10
Crusaders,4069,1,17,6,3,65,32,33,57
Coleraine,4069,2,14,11,1,45,24,21,53
Glenavon,4069,3,9,10,7,54,45,9,37
Linfield,4069,4,10,6,10,39,38,1,36
Cliftonville,4069,5,9,5,12,34,33,1,32
Ballymena,4069,6,7,4,15,27,51,-24,25
Glentoran,4069,7,6,6,10,24,32,-8,24
Dungannon,4069,8,2,4,16,14,47,-33,10
Crusaders,4070,1,16,7,3,62,31,31,55
Coleraine,4070,2,14,10,2,43,25,18,52
Glenavon,4070,3,10,9,7,55,43,12,39
Linfield,4070,4,11,5,10,39,37,2,38
Cliftonville,4070,5,9,4,13,33,33,0,31
Ballymena,4070,6,7,5,14,26,48,-22,26
Glentoran,4070,7,6,6,10,24,32,-8,24
Dungannon,4070,8,2,4,16,14,47,-33,10
Crusaders,4071,1,17,6,3,64,31,33,57
Coleraine,4071,2,14,10,2,43,25,18,52
Glenavon,4071,3,10,9,7,55,43,12,39
Linfield,4071,4,10,6,10,37,36,1,36
Cliftonville,4071,5,9,5,12,32,31,1,32
Ballymena,4071,6,7,4,15,26,50,-24,25
Glentoran,4071,7,6,6,10,24,32,-8,24
Dungannon,4071,8,2,4,16,14,47,-33,10
Crusaders,4072,1,17,6,3,63,31,32,57
Coleraine,4072,2,14,11,1,44,23,21,53
Linfield,4072,3,11,5,10,39,37,2,38
Glenavon,4072,4,9,10,7,53,44,9,37
Cliftonville,4072,5,9,4,13,33,33,0,31
Ballymena,4072,6,7,4,15,26,49,-23,25
Glentoran,4072,7,6,6,10,24,32,-8,24
Dungannon,4072,8,2,4,16,14,47,-33,10
Crusaders,4073,1,16,7,3,62,31,31,55
Coleraine,4073,2,14,10,2,43,24,19,52
Glenavon,4073,3,10,9,7,54,43,11,39
Linfield,4073,4,10,6,10,39,38,1,36
Cliftonville,4073,5,9,5,12,34,33,1,32
Ballymena,4073,6,7,5,14,26,48,-22,26
Glentoran,4073,7,6,6,10,24,32,-8,24
Dungannon,4073,8,2,4,16,14,47,-33,10
Crusaders,4074,1,16,7,3,62,31,31,55
Coleraine,4074,2,15,10,1,44,22,22,55
Glenavon,4074,3,9,9,8,52,44,8,36
Linfield,4074,4,10,5,11,37,39,-2,35
Cliftonville,4074,5,10,4,12,35,31,4,34
Ballymena,4074,6,7,5,14,26,48,-22,26
Glentoran,4074,7,6,6,10,24,32,-8,24
Dungannon,4074,8,2,4,16,14,47,-33,10
Crusaders,4075,1,16,7,3,62,31,31,55
Coleraine,4075,2,14,11,1,45,24,21,53
Linfield,4075,3,11,5,10,42,36,6,38
Glenavon,4075,4,9,10,7,54,45,9,37
Cliftonville,4075,5,9,4,13,32,36,-4,31
Ballymena,4075,6,7,5,14,26,48,-22,26
Glentoran,4075,7,6,6,10,24,32,-8,24
Dungannon,4075,8,2,4,16,14,47,-33,10
Crusaders,4076,1,17,6,3,63,31,32,57
Coleraine,4076,2,14,11,1,45,24,21,53
Linfield,4076,3,11,5,10,39,36,3,38
Glenavon,4076,4,9,10,7,54,45,9,37
Cliftonville,4076,5,9,4,13,32,33,-1,31
Ballymena,4076,6,7,4,15,26,49,-23,25
Glentoran,4076,7,6,6,10,24,32,-8,24
Dungannon,4076,8,2,4,16,14,47,-33,10
Crusaders,4077,1,17,6,3,64,30,34,57
Coleraine,4077,2,14,10,2,43,24,19,52
Glenavon,4077,3,10,9,7,54,43,11,39
Linfield,4077,4,10,5,11,37,37,0,35
Cliftonville,4077,5,10,4,12,33,31,2,34
Ballymena,4077,6,7,4,15,25,50,-25,25
Glentoran,4077,7,6,6,10,24,32,-8,24
Dungannon,4077,8,2,4,16,14,47,-33,10
Crusaders,4078,1,17,6,3,63,31,32,57
Coleraine,4078,2,14,10,2,44,25,19,52
Glenavon,4078,3,10,9,7,55,44,11,39
Linfield,4078,4,10,6,10,37,36,1,36
Cliftonville,4078,5,9,5,12,32,31,1,32
Ballymena,4078,6,7,4,15,26,49,-23,25
Glentoran,4078,7,6,6,10,24,32,-8,24
Dungannon,4078,8,2,4,16,14,47,-33,10
Crusaders,4079,1,16,6,4,61,32,29,54
Coleraine,4079,2,14,10,2,44,25,19,52
Glenavon,4079,3,10,9,7,55,44,11,39
Linfield,4079,4,10,6,10,37,36,1,36
Cliftonville,4079,5,9,5,12,32,31,1,32
Ballymena,4079,6,8,4,14,27,47,-20,28
Glentoran,4079,7,6,6,10,24,32,-8,24
Dungannon,4079,8,2,4,16,14,47,-33,10
Crusaders,4080,1,17,6,3,62,30,32,57
Coleraine,4080,2,14,10,2,44,24,20,52
Glenavon,4080,3,10,9,7,54,44,10,39
Linfield,4080,4,10,5,11,39,39,0,35
Cliftonville,4080,5,10,4,12,35,33,2,34
Ballymena,4080,6,7,4,15,25,48,-23,25
Glentoran,4080,7,6,6,10,24,32,-8,24
Dungannon,4080,8,2,4,16,14,47,-33,10
Crusaders,4081,1,16,7,3,61,30,31,55
Coleraine,4081,2,14,11,1,45,24,21,53
Linfield,4081,3,11,5,10,39,37,2,38
Glenavon,4081,4,9,10,7,54,45,9,37
Cliftonville,4081,5,9,4,13,33,33,0,31
Ballymena,4081,6,7,5,14,25,47,-22,26
Glentoran,4081,7,6,6,10,24,32,-8,24
Dungannon,4081,8,2,4,16,14,47,-33,10
Crusaders,4082,1,17,6,3,63,31,32,57
Coleraine,4082,2,15,10,1,45,22,23,55
Glenavon,4082,3,9,9,8,52,45,7,36
Linfield,4082,4,10,5,11,37,37,0,35
Cliftonville,4082,5,10,4,12,33,31,2,34
Ballymena,4082,6,7,4,15,26,49,-23,25
Glentoran,4082,7,6,6,10,24,32,-8,24
Dungannon,4082,8,2,4,16,14,47,-33,10
Crusaders,4083,1,17,6,3,63,30,33,57
Coleraine,4083,2,14,11,1,44,23,21,53
Linfield,4083,3,11,5,10,39,36,3,38
Glenavon,4083,4,9,10,7,53,44,9,37
Cliftonville,4083,5,9,4,13,32,33,-1,31
Ballymena,4083,6,7,4,15,25,49,-24,25
Glentoran,4083,7,6,6,10,24,32,-8,24
Dungannon,4083,8,2,4,16,14,47,-33,10
Crusaders,4084,1,17,6,3,64,30,34,57
Coleraine,4084,2,14,11,1,45,24,21,53
Linfield,4084,3,11,5,10,38,36,2,38
Glenavon,4084,4,9,10,7,54,45,9,37
Cliftonville,4084,5,9,4,13,32,32,0,31
Ballymena,4084,6,7,4,15,25,50,-25,25
Glentoran,4084,7,6,6,10,24,32,-8,24
Dungannon,4084,8,2,4,16,14,47,-33,10
Crusaders,4085,1,17,6,3,65,32,33,57
Coleraine,4085,2,14,10,2,45,25,20,52
Glenavon,4085,3,10,9,7,55,45,10,39
Linfield,4085,4,10,5,11,39,39,0,35
Cliftonville,4085,5,10,4,12,35,33,2,34
Ballymena,4085,6,7,4,15,27,51,-24,25
Glentoran,4085,7,6,6,10,24,32,-8,24
Dungannon,4085,8,2,4,16,14,47,-33,10
Crusaders,4086,1,17,6,3,65,32,33,57
Coleraine,4086,2,14,10,2,44,24,20,52
Glenavon,4086,3,10,9,7,54,44,10,39
Linfield,4086,4,10,5,11,37,38,-1,35
Cliftonville,4086,5,10,4,12,34,31,3,34
Ballymena,4086,6,7,4,15,27,51,-24,25
Glentoran,4086,7,6,6,10,24,32,-8,24
Dungannon,4086,8,2,4,16,14,47,-33,10
Coleraine,4087,1,15,10,1,47,22,25,55
Crusaders,4087,2,16,6,4,61,32,29,54
Glenavon,4087,3,9,9,8,52,47,5,36
Linfield,4087,4,10,6,10,37,36,1,36
Cliftonville,4087,5,9,5,12,32,31,1,32
Ballymena,4087,6,8,4,14,27,47,-20,28
Glentoran,4087,7,6,6,10,24,32,-8,24
Dungannon,4087,8,2,4,16,14,47,-33,10
Crusaders,4088,1,17,6,3,63,31,32,57
Coleraine,4088,2,14,10,2,45,26,19,52
Glenavon,4088,3,10,9,7,56,45,11,39
Linfield,4088,4,11,5,10,39,37,2,38
Cliftonville,4088,5,9,4,13,33,33,0,31
Ballymena,4088,6,7,4,15,26,49,-23,25
Glentoran,4088,7,6,6,10,24,32,-8,24
Dungannon,4088,8,2,4,16,14,47,-33,10
Crusaders,4089,1,17,6,3,65,31,34,57
Coleraine,4089,2,14,11,1,44,23,21,53
Glenavon,4089,3,9,10,7,53,44,9,37
Linfield,4089,4,10,5,11,37,37,0,35
Cliftonville,4089,5,10,4,12,33,31,2,34
Ballymena,4089,6,7,4,15,26,51,-25,25
Glentoran,4089,7,6,6,10,24,32,-8,24
Dungannon,4089,8,2,4,16,14,47,-33,10
Crusaders,4090,1,17,6,3,63,30,33,57
Coleraine,4090,2,14,10,2,44,26,18,52
Glenavon,4090,3,10,9,7,56,44,12,39
Linfield,4090,4,11,5,10,40,38,2,38
Cliftonville,4090,5,9,4,13,34,34,0,31
Ballymena,4090,6,7,4,15,25,49,-24,25
Glentoran,4090,7,6,6,10,24,32,-8,24
Dungannon,4090,8,2,4,16,14,47,-33,10
Crusaders,4091,1,16,6,4,61,31,30,54
Coleraine,4091,2,14,10,2,45,25,20,52
Glenavon,4091,3,10,9,7,55,45,10,39
Linfield,4091,4,11,5,10,41,39,2,38
Cliftonville,4091,5,9,4,13,35,35,0,31
Ballymena,4091,6,8,4,14,26,47,-21,28
Glentoran,4091,7,6,6,10,24,32,-8,24
Dungannon,4091,8,2,4,16,14,47,-33,10
Crusaders,4092,1,16,6,4,62,32,30,54
Coleraine,4092,2,14,11,1,45,24,21,53
Glenavon,4092,3,9,10,7,54,45,9,37
Linfield,4092,4,10,6,10,38,37,1,36
Cliftonville,4092,5,9,5,12,33,32,1,32
Ballymena,4092,6,8,4,14,27,48,-21,28
Glentoran,4092,7,6,6,10,24,32,-8,24
Dungannon,4092,8,2,4,16,14,47,-33,10
Crusaders,4093,1,17,6,3,63,31,32,57
Coleraine,4093,2,14,11,1,45,24,21,53
Glenavon,4093,3,9,10,7,54,45,9,37
Linfield,4093,4,10,6,10,39,38,1,36
Cliftonville,4093,5,9,5,12,34,33,1,32
Ballymena,4093,6,7,4,15,26,49,-23,25
Glentoran,4093,7,6,6,10,24,32,-8,24
Dungannon,4093,8,2,4,16,14,47,-33,10
Crusaders,4094,1,17,6,3,62,30,32,57
Coleraine,4094,2,15,10,1,45,23,22,55
Glenavon,4094,3,9,9,8,53,45,8,36
Linfield,4094,4,10,6,10,38,37,1,36
Cliftonville,4094,5,9,5,12,33,32,1,32
Ballymena,4094,6,7,4,15,25,48,-23,25
Glentoran,4094,7,6,6,10,24,32,-8,24
Dungannon,4094,8,2,4,16,14,47,-33,10
Crusaders,4095,1,17,6,3,64,31,33,57
Coleraine,4095,2,14,10,2,44,25,19,52
Glenavon,4095,3,10,9,7,55,44,11,39
Linfield,4095,4,10,5,11,37,37,0,35
Cliftonville,4095,5,10,4,12,33,31,2,34
Ballymena,4095,6,7,4,15,26,50,-24,25
Glentoran,4095,7,6,6,10,24,32,-8,24
Dungannon,4095,8,2,4,16,14,47,-33,10
Crusaders,4096,1,17,6,3,63,31,32,57
Coleraine,4096,2,15,10,1,44,22,22,55
Linfield,4096,3,11,5,10,39,36,3,38
Glenavon,4096,4,9,9,8,52,44,8,36
Cliftonville,4096,5,9,4,13,32,33,-1,31
Ballymena,4096,6,7,4,15,26,49,-23,25
Glentoran,4096,7,6,6,10,24,32,-8,24
Dungannon,4096,8,2,4,16,14,47,-33,10
Crusaders,4097,1,17,6,3,63,31,32,57
Coleraine,4097,2,14,10,2,44,25,19,52
Glenavon,4097,3,10,9,7,55,44,11,39
Linfield,4097,4,11,5,10,39,36,3,38
Cliftonville,4097,5,9,4,13,32,33,-1,31
Ballymena,4097,6,7,4,15,26,49,-23,25
Glentoran,4097,7,6,6,10,24,32,-8,24
Dungannon,4097,8,2,4,16,14,47,-33,10
Crusaders,4098,1,16,7,3,61,30,31,55
Coleraine,4098,2,14,10,2,43,23,20,52
Glenavon,4098,3,10,9,7,53,43,10,39
Linfield,4098,4,11,5,10,40,37,3,38
Cliftonville,4098,5,9,4,13,33,34,-1,31
Ballymena,4098,6,7,5,14,25,47,-22,26
Glentoran,4098,7,6,6,10,24,32,-8,24
Dungannon,4098,8,2,4,16,14,47,-33,10
Crusaders,4099,1,16,7,3,63,32,31,55
Coleraine,4099,2,15,10,1,46,23,23,55
Glenavon,4099,3,9,9,8,53,46,7,36
Linfield,4099,4,10,5,11,37,37,0,35
Cliftonville,4099,5,10,4,12,33,31,2,34
Ballymena,4099,6,7,5,14,27,49,-22,26
Glentoran,4099,7,6,6,10,24,32,-8,24
Dungannon,4099,8,2,4,16,14,47,-33,10
Crusaders,4100,1,17,6,3,63,30,33,57
Coleraine,4100,2,14,10,2,45,25,20,52
Glenavon,4100,3,10,9,7,55,45,10,39
Linfield,4100,4,10,6,10,39,38,1,36
Cliftonville,4100,5,9,5,12,34,33,1,32
Ballymena,4100,6,7,4,15,25,49,-24,25
Glentoran,4100,7,6,6,10,24,32,-8,24
Dungannon,4100,8,2,4,16,14,47,-33,10
Crusaders,4101,1,16,7,3,61,30,31,55
Coleraine,4101,2,15,10,1,46,24,22,55
Glenavon,4101,3,9,9,8,54,46,8,36
Linfield,4101,4,10,6,10,37,36,1,36
Cliftonville,4101,5,9,5,12,32,31,1,32
Ballymena,4101,6,7,5,14,25,47,-22,26
Glentoran,4101,7,6,6,10,24,32,-8,24
Dungannon,4101,8,2,4,16,14,47,-33,10
Crusaders,4102,1,16,6,4,63,35,28,54
Coleraine,4102,2,14,11,1,45,24,21,53
Linfield,4102,3,11,5,10,41,37,4,38
Glenavon,4102,4,9,10,7,54,45,9,37
Cliftonville,4102,5,9,4,13,33,35,-2,31
Ballymena,4102,6,8,4,14,30,49,-19,28
Glentoran,4102,7,6,6,10,24,32,-8,24
Dungannon,4102,8,2,4,16,14,47,-33,10
Crusaders,4103,1,16,7,3,63,32,31,55
Coleraine,4103,2,14,11,1,43,22,21,53
Linfield,4103,3,11,5,10,39,36,3,38
Glenavon,4103,4,9,10,7,52,43,9,37
Cliftonville,4103,5,9,4,13,32,33,-1,31
Ballymena,4103,6,7,5,14,27,49,-22,26
Glentoran,4103,7,6,6,10,24,32,-8,24
Dungannon,4103,8,2,4,16,14,47,-33,10
Crusaders,4104,1,16,7,3,62,31,31,55
Coleraine,4104,2,15,10,1,46,24,22,55
Linfield,4104,3,11,5,10,39,37,2,38
Glenavon,4104,4,9,9,8,54,46,8,36
Cliftonville,4104,5,9,4,13,33,33,0,31
Ballymena,4104,6,7,5,14,26,48,-22,26
Glentoran,4104,7,6,6,10,24,32,-8,24
Dungannon,4104,8,2,4,16,14,47,-33,10
Crusaders,4105,1,16,6,4,61,31,30,54
Coleraine,4105,2,14,10,2,44,24,20,52
Glenavon,4105,3,10,9,7,54,44,10,39
Linfield,4105,4,10,5,11,38,38,0,35
Cliftonville,4105,5,10,4,12,34,32,2,34
Ballymena,4105,6,8,4,14,26,47,-21,28
Glentoran,4105,7,6,6,10,24,32,-8,24
Dungannon,4105,8,2,4,16,14,47,-33,10
Crusaders,4106,1,17,6,3,63,31,32,57
Coleraine,4106,2,15,10,1,47,22,25,55
Glenavon,4106,3,9,9,8,52,47,5,36
Linfield,4106,4,10,6,10,37,36,1,36
Cliftonville,4106,5,9,5,12,32,31,1,32
Ballymena,4106,6,7,4,15,26,49,-23,25
Glentoran,4106,7,6,6,10,24,32,-8,24
Dungannon,4106,8,2,4,16,14,47,-33,10
Crusaders,4107,1,16,6,4,62,32,30,54
Coleraine,4107,2,14,11,1,43,22,21,53
Linfield,4107,3,11,5,10,38,36,2,38
Glenavon,4107,4,9,10,7,52,43,9,37
Cliftonville,4107,5,9,4,13,32,32,0,31
Ballymena,4107,6,8,4,14,27,48,-21,28
Glentoran,4107,7,6,6,10,24,32,-8,24
Dungannon,4107,8,2,4,16,14,47,-33,10
Crusaders,4108,1,17,6,3,64,31,33,57
Coleraine,4108,2,14,10,2,44,24,20,52
Glenavon,4108,3,10,9,7,54,44,10,39
Linfield,4108,4,11,5,10,40,36,4,38
Cliftonville,4108,5,9,4,13,32,34,-2,31
Ballymena,4108,6,7,4,15,26,50,-24,25
Glentoran,4108,7,6,6,10,24,32,-8,24
Dungannon,4108,8,2,4,16,14,47,-33,10
Crusaders,4109,1,17,6,3,64,32,32,57
Coleraine,4109,2,14,11,1,44,23,21,53
Linfield,4109,3,11,5,10,40,36,4,38
Glenavon,4109,4,9,10,7,53,44,9,37
Cliftonville,4109,5,9,4,13,32,34,-2,31
Ballymena,4109,6,7,4,15,27,50,-23,25
Glentoran,4109,7,6,6,10,24,32,-8,24
Dungannon,4109,8,2,4,16,14,47,-33,10
Crusaders,4110,1,17,6,3,62,30,32,57
Coleraine,4110,2,14,10,2,43,23,20,52
Glenavon,4110,3,10,9,7,53,43,10,39
Linfield,4110,4,11,5,10,38,36,2,38
Cliftonville,4110,5,9,4,13,32,32,0,31
Ballymena,4110,6,7,4,15,25,48,-23,25
Glentoran,4110,7,6,6,10,24,32,-8,24
Dungannon,4110,8,2,4,16,14,47,-33,10
Crusaders,4111,1,17,6,3,62,30,32,57
Coleraine,4111,2,15,10,1,46,24,22,55
Glenavon,4111,3,9,9,8,54,46,8,36
Linfield,4111,4,10,6,10,39,38,1,36
Cliftonville,4111,5,9,5,12,34,33,1,32
Ballymena,4111,6,7,4,15,25,48,-23,25
Glentoran,4111,7,6,6,10,24,32,-8,24
Dungannon,4111,8,2,4,16,14,47,-33,10
Crusaders,4112,1,16,7,3,62,31,31,55
Coleraine,4112,2,14,11,1,43,22,21,53
Glenavon,4112,3,9,10,7,52,43,9,37
Linfield,4112,4,10,6,10,38,37,1,36
Cliftonville,4112,5,9,5,12,33,32,1,32
Ballymena,4112,6,7,5,14,26,48,-22,26
Glentoran,4112,7,6,6,10,24,32,-8,24
Dungannon,4112,8,2,4,16,14,47,-33,10
Crusaders,4113,1,17,6,3,63,31,32,57
Coleraine,4113,2,14,10,2,43,25,18,52
Glenavon,4113,3,10,9,7,55,43,12,39
Linfield,4113,4,10,5,11,37,37,0,35
Cliftonville,4113,5,10,4,12,33,31,2,34
Ballymena,4113,6,7,4,15,26,49,-23,25
Glentoran,4113,7,6,6,10,24,32,-8,24
Dungannon,4113,8,2,4,16,14,47,-33,10
Crusaders,4114,1,17,6,3,62,30,32,57
Coleraine,4114,2,15,10,1,46,24,22,55
Glenavon,4114,3,9,9,8,54,46,8,36
Linfield,4114,4,10,6,10,39,38,1,36
Cliftonville,4114,5,9,5,12,34,33,1,32
Ballymena,4114,6,7,4,15,25,48,-23,25
Glentoran,4114,7,6,6,10,24,32,-8,24
Dungannon,4114,8,2,4,16,14,47,-33,10
Crusaders,4115,1,16,7,3,62,31,31,55
Coleraine,4115,2,14,11,1,44,23,21,53
Glenavon,4115,3,9,10,7,53,44,9,37
Linfield,4115,4,10,5,11,37,40,-3,35
Cliftonville,4115,5,10,4,12,36,31,5,34
Ballymena,4115,6,7,5,14,26,48,-22,26
Glentoran,4115,7,6,6,10,24,32,-8,24
Dungannon,4115,8,2,4,16,14,47,-33,10
Crusaders,4116,1,16,6,4,61,31,30,54
Coleraine,4116,2,14,10,2,44,24,20,52
Glenavon,4116,3,10,9,7,54,44,10,39
Linfield,4116,4,10,6,10,40,39,1,36
Cliftonville,4116,5,9,5,12,35,34,1,32
Ballymena,4116,6,8,4,14,26,47,-21,28
Glentoran,4116,7,6,6,10,24,32,-8,24
Dungannon,4116,8,2,4,16,14,47,-33,10
Crusaders,4117,1,17,6,3,65,30,35,57
Coleraine,4117,2,15,10,1,46,23,23,55
Glenavon,4117,3,9,9,8,53,46,7,36
Linfield,4117,4,10,5,11,37,39,-2,35
Cliftonville,4117,5,10,4,12,35,31,4,34
Ballymena,4117,6,7,4,15,25,51,-26,25
Glentoran,4117,7,6,6,10,24,32,-8,24
Dungannon,4117,8,2,4,16,14,47,-33,10
Crusaders,4118,1,17,6,3,62,30,32,57
Coleraine,4118,2,14,11,1,45,24,21,53
Linfield,4118,3,11,5,10,38,36,2,38
Glenavon,4118,4,9,10,7,54,45,9,37
Cliftonville,4118,5,9,4,13,32,32,0,31
Ballymena,4118,6,7,4,15,25,48,-23,25
Glentoran,4118,7,6,6,10,24,32,-8,24
Dungannon,4118,8,2,4,16,14,47,-33,10
Crusaders,4119,1,17,6,3,66,30,36,57
Coleraine,4119,2,15,10,1,45,23,22,55
Linfield,4119,3,11,5,10,39,37,2,38
Glenavon,4119,4,9,9,8,53,45,8,36
Cliftonville,4119,5,9,4,13,33,33,0,31
Ballymena,4119,6,7,4,15,25,52,-27,25
Glentoran,4119,7,6,6,10,24,32,-8,24
Dungannon,4119,8,2,4,16,14,47,-33,10
Crusaders,4120,1,16,7,3,61,30,31,55
Coleraine,4120,2,15,10,1,45,22,23,55
Linfield,4120,3,11,5,10,39,37,2,38
Glenavon,4120,4,9,9,8,52,45,7,36
Cliftonville,4120,5,9,4,13,33,33,0,31
Ballymena,4120,6,7,5,14,25,47,-22,26
Glentoran,4120,7,6,6,10,24,32,-8,24
Dungannon,4120,8,2,4,16,14,47,-33,10
Crusaders,4121,1,17,6,3,66,30,36,57
Coleraine,4121,2,14,11,1,44,23,21,53
Glenavon,4121,3,9,10,7,53,44,9,37
Linfield,4121,4,10,6,10,39,38,1,36
Cliftonville,4121,5,9,5,12,34,33,1,32
Ballymena,4121,6,7,4,15,25,52,-27,25
Glentoran,4121,7,6,6,10,24,32,-8,24
Dungannon,4121,8,2,4,16,14,47,-33,10
Crusaders,4122,1,16,7,3,63,32,31,55
Coleraine,4122,2,14,11,1,44,23,21,53
Glenavon,4122,3,9,10,7,53,44,9,37
Linfield,4122,4,10,6,10,37,36,1,36
Cliftonville,4122,5,9,5,12,32,31,1,32
Ballymena,4122,6,7,5,14,27,49,-22,26
Glentoran,4122,7,6,6,10,24,32,-8,24
Dungannon,4122,8,2,4,16,14,47,-33,10
Crusaders,4123,1,17,6,3,63,30,33,57
Coleraine,4123,2,14,10,2,44,24,20,52
Glenavon,4123,3,10,9,7,54,44,10,39
Linfield,4123,4,11,5,10,40,38,2,38
Cliftonville,4123,5,9,4,13,34,34,0,31
Ballymena,4123,6,7,4,15,25,49,-24,25
Glentoran,4123,7,6,6,10,24,32,-8,24
Dungannon,4123,8,2,4,16,14,47,-33,10
Crusaders,4124,1,17,6,3,64,30,34,57
Coleraine,4124,2,14,11,1,45,24,21,53
Glenavon,4124,3,9,10,7,54,45,9,37
Linfield,4124,4,10,6,10,39,38,1,36
Cliftonville,4124,5,9,5,12,34,33,1,32
Ballymena,4124,6,7,4,15,25,50,-25,25
Glentoran,4124,7,6,6,10,24,32,-8,24
Dungannon,4124,8,2,4,16,14,47,-33,10
Crusaders,4125,1,17,6,3,69,33,36,57
Coleraine,4125,2,14,10,2,46,26,20,52
Glenavon,4125,3,10,9,7,56,46,10,39
Linfield,4125,4,11,5,10,38,36,2,38
Cliftonville,4125,5,9,4,13,32,32,0,31
Ballymena,4125,6,7,4,15,28,55,-27,25
Glentoran,4125,7,6,6,10,24,32,-8,24
Dungannon,4125,8,2,4,16,14,47,-33,10
Crusaders,4126,1,17,6,3,65,31,34,57
Coleraine,4126,2,15,10,1,45,23,22,55
Linfield,4126,3,11,5,10,39,36,3,38
Glenavon,4126,4,9,9,8,53,45,8,36
Cliftonville,4126,5,9,4,13,32,33,-1,31
Ballymena,4126,6,7,4,15,26,51,-25,25
Glentoran,4126,7,6,6,10,24,32,-8,24
Dungannon,4126,8,2,4,16,14,47,-33,10
Crusaders,4127,1,16,7,3,63,32,31,55
Coleraine,4127,2,14,11,1,44,23,21,53
Glenavon,4127,3,9,10,7,53,44,9,37
Linfield,4127,4,10,6,10,39,38,1,36
Cliftonville,4127,5,9,5,12,34,33,1,32
Ballymena,4127,6,7,5,14,27,49,-22,26
Glentoran,4127,7,6,6,10,24,32,-8,24
Dungannon,4127,8,2,4,16,14,47,-33,10
Crusaders,4128,1,17,6,3,63,30,33,57
Coleraine,4128,2,14,10,2,44,24,20,52
Glenavon,4128,3,10,9,7,54,44,10,39
Linfield,4128,4,10,5,11,37,38,-1,35
Cliftonville,4128,5,10,4,12,34,31,3,34
Ballymena,4128,6,7,4,15,25,49,-24,25
Glentoran,4128,7,6,6,10,24,32,-8,24
Dungannon,4128,8,2,4,16,14,47,-33,10
Crusaders,4129,1,17,6,3,65,31,34,57
Coleraine,4129,2,14,10,2,44,25,19,52
Glenavon,4129,3,10,9,7,55,44,11,39
Linfield,4129,4,10,6,10,37,36,1,36
Cliftonville,4129,5,9,5,12,32,31,1,32
Ballymena,4129,6,7,4,15,26,51,-25,25
Glentoran,4129,7,6,6,10,24,32,-8,24
Dungannon,4129,8,2,4,16,14,47,-33,10
Crusaders,4130,1,17,6,3,64,31,33,57
Coleraine,4130,2,14,10,2,43,23,20,52
Glenavon,4130,3,10,9,7,53,43,10,39
Linfield,4130,4,10,6,10,37,36,1,36
Cliftonville,4130,5,9,5,12,32,31,1,32
Ballymena,4130,6,7,4,15,26,50,-24,25
Glentoran,4130,7,6,6,10,24,32,-8,24
Dungannon,4130,8,2,4,16,14,47,-33,10
Crusaders,4131,1,16,6,4,63,33,30,54
Coleraine,4131,2,14,10,2,43,23,20,52
Glenavon,4131,3,10,9,7,53,43,10,39
Linfield,4131,4,11,5,10,39,37,2,38
Cliftonville,4131,5,9,4,13,33,33,0,31
Ballymena,4131,6,8,4,14,28,49,-21,28
Glentoran,4131,7,6,6,10,24,32,-8,24
Dungannon,4131,8,2,4,16,14,47,-33,10
Crusaders,4132,1,16,7,3,62,31,31,55
Coleraine,4132,2,14,10,2,44,24,20,52
Glenavon,4132,3,10,9,7,54,44,10,39
Linfield,4132,4,11,5,10,44,36,8,38
Cliftonville,4132,5,9,4,13,32,38,-6,31
Ballymena,4132,6,7,5,14,26,48,-22,26
Glentoran,4132,7,6,6,10,24,32,-8,24
Dungannon,4132,8,2,4,16,14,47,-33,10
Crusaders,4133,1,17,6,3,65,31,34,57
Coleraine,4133,2,14,10,2,43,24,19,52
Glenavon,4133,3,10,9,7,54,43,11,39
Linfield,4133,4,10,6,10,38,37,1,36
Cliftonville,4133,5,9,5,12,33,32,1,32
Ballymena,4133,6,7,4,15,26,51,-25,25
Glentoran,4133,7,6,6,10,24,32,-8,24
Dungannon,4133,8,2,4,16,14,47,-33,10
Coleraine,4134,1,15,10,1,49,26,23,55
Crusaders,4134,2,16,6,4,62,32,30,54
Glenavon,4134,3,9,9,8,56,49,7,36
Linfield,4134,4,10,5,11,38,39,-1,35
Cliftonville,4134,5,10,4,12,35,32,3,34
Ballymena,4134,6,8,4,14,27,48,-21,28
Glentoran,4134,7,6,6,10,24,32,-8,24
Dungannon,4134,8,2,4,16,14,47,-33,10
Crusaders,4135,1,16,6,4,61,31,30,54
Coleraine,4135,2,14,10,2,44,24,20,52
Glenavon,4135,3,10,9,7,54,44,10,39
Linfield,4135,4,11,5,10,40,37,3,38
Cliftonville,4135,5,9,4,13,33,34,-1,31
Ballymena,4135,6,8,4,14,26,47,-21,28
Glentoran,4135,7,6,6,10,24,32,-8,24
Dungannon,4135,8,2,4,16,14,47,-33,10
Crusaders,4136,1,17,6,3,64,30,34,57
Coleraine,4136,2,14,10,2,43,24,19,52
Glenavon,4136,3,10,9,7,54,43,11,39
Linfield,4136,4,11,5,10,39,36,3,38
Cliftonville,4136,5,9,4,13,32,33,-1,31
Ballymena,4136,6,7,4,15,25,50,-25,25
Glentoran,4136,7,6,6,10,24,32,-8,24
Dungannon,4136,8,2,4,16,14,47,-33,10
Crusaders,4137,1,17,6,3,64,30,34,57
Coleraine,4137,2,14,10,2,43,23,20,52
Glenavon,4137,3,10,9,7,53,43,10,39
Linfield,4137,4,10,5,11,37,40,-3,35
Cliftonville,4137,5,10,4,12,36,31,5,34
Ballymena,4137,6,7,4,15,25,50,-25,25
Glentoran,4137,7,6,6,10,24,32,-8,24
Dungannon,4137,8,2,4,16,14,47,-33,10
Crusaders,4138,1,16,7,3,61,30,31,55
Coleraine,4138,2,14,10,2,44,25,19,52
Glenavon,4138,3,10,9,7,55,44,11,39
Linfield,4138,4,11,5,10,41,37,4,38
Cliftonville,4138,5,9,4,13,33,35,-2,31
Ballymena,4138,6,7,5,14,25,47,-22,26
Glentoran,4138,7,6,6,10,24,32,-8,24
Dungannon,4138,8,2,4,16,14,47,-33,10
Crusaders,4139,1,17,6,3,64,32,32,57
Coleraine,4139,2,14,10,2,44,25,19,52
Glenavon,4139,3,10,9,7,55,44,11,39
Linfield,4139,4,11,5,10,39,36,3,38
Cliftonville,4139,5,9,4,13,32,33,-1,31
Ballymena,4139,6,7,4,15,27,50,-23,25
Glentoran,4139,7,6,6,10,24,32,-8,24
Dungannon,4139,8,2,4,16,14,47,-33,10
Crusaders,4140,1,17,6,3,63,30,33,57
Coleraine,4140,2,15,10,1,47,23,24,55
Linfield,4140,3,11,5,10,39,37,2,38
Glenavon,4140,4,9,9,8,53,47,6,36
Cliftonville,4140,5,9,4,13,33,33,0,31
Ballymena,4140,6,7,4,15,25,49,-24,25
Glentoran,4140,7,6,6,10,24,32,-8,24
Dungannon,4140,8,2,4,16,14,47,-33,10
Crusaders,4141,1,17,6,3,65,32,33,57
Coleraine,4141,2,14,10,2,43,24,19,52
Glenavon,4141,3,10,9,7,54,43,11,39
Linfield,4141,4,11,5,10,39,36,3,38
Cliftonville,4141,5,9,4,13,32,33,-1,31
Ballymena,4141,6,7,4,15,27,51,-24,25
Glentoran,4141,7,6,6,10,24,32,-8,24
Dungannon,4141,8,2,4,16,14,47,-33,10
Crusaders,4142,1,16,6,4,61,33,28,54
Coleraine,4142,2,14,10,2,45,25,20,52
Glenavon,4142,3,10,9,7,55,45,10,39
Linfield,4142,4,11,5,10,38,36,2,38
Cliftonville,4142,5,9,4,13,32,32,0,31
Ballymena,4142,6,8,4,14,28,47,-19,28
Glentoran,4142,7,6,6,10,24,32,-8,24
Dungannon,4142,8,2,4,16,14,47,-33,10
Crusaders,4143,1,16,6,4,62,33,29,54
Coleraine,4143,2,14,10,2,44,24,20,52
Glenavon,4143,3,10,9,7,54,44,10,39
Linfield,4143,4,11,5,10,39,36,3,38
Cliftonville,4143,5,9,4,13,32,33,-1,31
Ballymena,4143,6,8,4,14,28,48,-20,28
Glentoran,4143,7,6,6,10,24,32,-8,24
Dungannon,4143,8,2,4,16,14,47,-33,10
Crusaders,4144,1,17,6,3,63,30,33,57
Coleraine,4144,2,14,10,2,46,27,19,52
Glenavon,4144,3,10,9,7,57,46,11,39
Linfield,4144,4,10,6,10,37,36,1,36
Cliftonville,4144,5,9,5,12,32,31,1,32
Ballymena,4144,6,7,4,15,25,49,-24,25
Glentoran,4144,7,6,6,10,24,32,-8,24
Dungannon,4144,8,2,4,16,14,47,-33,10
Crusaders,4145,1,17,6,3,63,30,33,57
Coleraine,4145,2,14,10,2,44,24,20,52
Glenavon,4145,3,10,9,7,54,44,10,39
Linfield,4145,4,10,6,10,39,38,1,36
Cliftonville,4145,5,9,5,12,34,33,1,32
Ballymena,4145,6,7,4,15,25,49,-24,25
Glentoran,4145,7,6,6,10,24,32,-8,24
Dungannon,4145,8,2,4,16,14,47,-33,10
Crusaders,4146,1,17,6,3,62,30,32,57
Coleraine,4146,2,15,10,1,45,22,23,55
Linfield,4146,3,11,5,10,39,37,2,38
Glenavon,4146,4,9,9,8,52,45,7,36
Cliftonville,4146,5,9,4,13,33,33,0,31
Ballymena,4146,6,7,4,15,25,48,-23,25
Glentoran,4146,7,6,6,10,24,32,-8,24
Dungannon,4146,8,2,4,16,14,47,-33,10
Crusaders,4147,1,16,7,3,63,32,31,55
Coleraine,4147,2,14,10,2,43,24,19,52
Glenavon,4147,3,10,9,7,54,43,11,39
Linfield,4147,4,11,5,10,41,37,4,38
Cliftonville,4147,5,9,4,13,33,35,-2,31
Ballymena,4147,6,7,5,14,27,49,-22,26
Glentoran,4147,7,6,6,10,24,32,-8,24
Dungannon,4147,8,2,4,16,14,47,-33,10
Crusaders,4148,1,17,6,3,64,31,33,57
Coleraine,4148,2,14,11,1,45,24,21,53
Linfield,4148,3,11,5,10,38,36,2,38
Glenavon,4148,4,9,10,7,54,45,9,37
Cliftonville,4148,5,9,4,13,32,32,0,31
Ballymena,4148,6,7,4,15,26,50,-24,25
Glentoran,4148,7,6,6,10,24,32,-8,24
Dungannon,4148,8,2,4,16,14,47,-33,10
Crusaders,4149,1,17,6,3,65,30,35,57
Coleraine,4149,2,14,10,2,43,24,19,52
Glenavon,4149,3,10,9,7,54,43,11,39
Linfield,4149,4,11,5,10,39,36,3,38
Cliftonville,4149,5,9,4,13,32,33,-1,31
Ballymena,4149,6,7,4,15,25,51,-26,25
Glentoran,4149,7,6,6,10,24,32,-8,24
Dungannon,4149,8,2,4,16,14,47,-33,10
Crusaders,4150,1,16,7,3,65,34,31,55
Coleraine,4150,2,14,11,1,43,22,21,53
Glenavon,4150,3,9,10,7,52,43,9,37
Linfield,4150,4,10,6,10,37,36,1,36
Cliftonville,4150,5,9,5,12,32,31,1,32
Ballymena,4150,6,7,5,14,29,51,-22,26
Glentoran,4150,7,6,6,10,24,32,-8,24
Dungannon,4150,8,2,4,16,14,47,-33,10
Coleraine,4151,1,15,10,1,44,22,22,55
Crusaders,4151,2,16,6,4,64,34,30,54
Glenavon,4151,3,9,9,8,52,44,8,36
Linfield,4151,4,10,6,10,37,36,1,36
Cliftonville,4151,5,9,5,12,32,31,1,32
Ballymena,4151,6,8,4,14,29,50,-21,28
Glentoran,4151,7,6,6,10,24,32,-8,24
Dungannon,4151,8,2,4,16,14,47,-33,10
Crusaders,4152,1,16,7,3,62,31,31,55
Coleraine,4152,2,14,11,1,44,23,21,53
Linfield,4152,3,11,5,10,39,37,2,38
Glenavon,4152,4,9,10,7,53,44,9,37
Cliftonville,4152,5,9,4,13,33,33,0,31
Ballymena,4152,6,7,5,14,26,48,-22,26
Glentoran,4152,7,6,6,10,24,32,-8,24
Dungannon,4152,8,2,4,16,14,47,-33,10
Crusaders,4153,1,17,6,3,62,30,32,57
Coleraine,4153,2,14,10,2,43,24,19,52
Glenavon,4153,3,10,9,7,54,43,11,39
Linfield,4153,4,10,5,11,38,39,-1,35
Cliftonville,4153,5,10,4,12,35,32,3,34
Ballymena,4153,6,7,4,15,25,48,-23,25
Glentoran,4153,7,6,6,10,24,32,-8,24
Dungannon,4153,8,2,4,16,14,47,-33,10
Crusaders,4154,1,17,6,3,67,30,37,57
Coleraine,4154,2,14,11,1,44,23,21,53
Linfield,4154,3,11,5,10,38,36,2,38
Glenavon,4154,4,9,10,7,53,44,9,37
Cliftonville,4154,5,9,4,13,32,32,0,31
Ballymena,4154,6,7,4,15,25,53,-28,25
Glentoran,4154,7,6,6,10,24,32,-8,24
Dungannon,4154,8,2,4,16,14,47,-33,10
Crusaders,4155,1,16,7,3,62,31,31,55
Coleraine,4155,2,14,10,2,43,24,19,52
Glenavon,4155,3,10,9,7,54,43,11,39
Linfield,4155,4,11,5,10,39,36,3,38
Cliftonville,4155,5,9,4,13,32,33,-1,31
Ballymena,4155,6,7,5,14,26,48,-22,26
Glentoran,4155,7,6,6,10,24,32,-8,24
Dungannon,4155,8,2,4,16,14,47,-33,10
Crusaders,4156,1,17,6,3,64,32,32,57
Coleraine,4156,2,14,11,1,45,24,21,53
Linfield,4156,3,11,5,10,39,37,2,38
Glenavon,4156,4,9,10,7,54,45,9,37
Cliftonville,4156,5,9,4,13,33,33,0,31
Ballymena,4156,6,7,4,15,27,50,-23,25
Glentoran,4156,7,6,6,10,24,32,-8,24
Dungannon,4156,8,2,4,16,14,47,-33,10
Crusaders,4157,1,16,6,4,62,33,29,54
Coleraine,4157,2,14,11,1,44,23,21,53
Linfield,4157,3,11,5,10,41,36,5,38
Glenavon,4157,4,9,10,7,53,44,9,37
Cliftonville,4157,5,9,4,13,32,35,-3,31
Ballymena,4157,6,8,4,14,28,48,-20,28
Glentoran,4157,7,6,6,10,24,32,-8,24
Dungannon,4157,8,2,4,16,14,47,-33,10
Crusaders,4158,1,17,6,3,63,31,32,57
Coleraine,4158,2,15,10,1,45,23,22,55
Glenavon,4158,3,9,9,8,53,45,8,36
Linfield,4158,4,10,5,11,37,38,-1,35
Cliftonville,4158,5,10,4,12,34,31,3,34
Ballymena,4158,6,7,4,15,26,49,-23,25
Glentoran,4158,7,6,6,10,24,32,-8,24
Dungannon,4158,8,2,4,16,14,47,-33,10
Crusaders,4159,1,17,6,3,64,31,33,57
Coleraine,4159,2,15,10,1,45,22,23,55
Linfield,4159,3,11,5,10,41,39,2,38
Glenavon,4159,4,9,9,8,52,45,7,36
Cliftonville,4159,5,9,4,13,35,35,0,31
Ballymena,4159,6,7,4,15,26,50,-24,25
Glentoran,4159,7,6,6,10,24,32,-8,24
Dungannon,4159,8,2,4,16,14,47,-33,10
Crusaders,4160,1,16,7,3,62,31,31,55
Coleraine,4160,2,14,11,1,43,22,21,53
Linfield,4160,3,11,5,10,39,37,2,38
Glenavon,4160,4,9,10,7,52,43,9,37
Cliftonville,4160,5,9,4,13,33,33,0,31
Ballymena,4160,6,7,5,14,26,48,-22,26
Glentoran,4160,7,6,6,10,24,32,-8,24
Dungannon,4160,8,2,4,16,14,47,-33,10
Crusaders,4161,1,16,7,3,63,32,31,55
Coleraine,4161,2,15,10,1,45,23,22,55
Linfield,4161,3,11,5,10,38,36,2,38
Glenavon,4161,4,9,9,8,53,45,8,36
Cliftonville,4161,5,9,4,13,32,32,0,31
Ballymena,4161,6,7,5,14,27,49,-22,26
Glentoran,4161,7,6,6,10,24,32,-8,24
Dungannon,4161,8,2,4,16,14,47,-33,10
Crusaders,4162,1,17,6,3,63,31,32,57
Coleraine,4162,2,14,10,2,43,23,20,52
Glenavon,4162,3,10,9,7,53,43,10,39
Linfield,4162,4,10,5,11,37,37,0,35
Cliftonville,4162,5,10,4,12,33,31,2,34
Ballymena,4162,6,7,4,15,26,49,-23,25
Glentoran,4162,7,6,6,10,24,32,-8,24
Dungannon,4162,8,2,4,16,14,47,-33,10
Coleraine,4163,1,15,10,1,45,23,22,55
Crusaders,4163,2,16,6,4,64,35,29,54
Linfield,4163,3,11,5,10,40,36,4,38
Glenavon,4163,4,9,9,8,53,45,8,36
Cliftonville,4163,5,9,4,13,32,34,-2,31
Ballymena,4163,6,8,4,14,30,50,-20,28
Glentoran,4163,7,6,6,10,24,32,-8,24
Dungannon,4163,8,2,4,16,14,47,-33,10
Crusaders,4164,1,17,6,3,62,30,32,57
Coleraine,4164,2,14,11,1,46,25,21,53
Linfield,4164,3,11,5,10,39,36,3,38
Glenavon,4164,4,9,10,7,55,46,9,37
Cliftonville,4164,5,9,4,13,32,33,-1,31
Ballymena,4164,6,7,4,15,25,48,-23,25
Glentoran,4164,7,6,6,10,24,32,-8,24
Dungannon,4164,8,2,4,16,14,47,-33,10
Crusaders,4165,1,17,6,3,66,31,35,57
Coleraine,4165,2,14,10,2,44,25,19,52
Glenavon,4165,3,10,9,7,55,44,11,39
Linfield,4165,4,10,6,10,37,36,1,36
Cliftonville,4165,5,9,5,12,32,31,1,32
Ballymena,4165,6,7,4,15,26,52,-26,25
Glentoran,4165,7,6,6,10,24,32,-8,24
Dungannon,4165,8,2,4,16,14,47,-33,10
Crusaders,4166,1,16,6,4,62,35,27,54
Coleraine,4166,2,14,11,1,44,23,21,53
Glenavon,4166,3,9,10,7,53,44,9,37
Linfield,4166,4,10,6,10,37,36,1,36
Cliftonville,4166,5,9,5,12,32,31,1,32
Ballymena,4166,6,8,4,14,30,48,-18,28
Glentoran,4166,7,6,6,10,24,32,-8,24
Dungannon,4166,8,2,4,16,14,47,-33,10
Crusaders,4167,1,16,6,4,62,32,30,54
Coleraine,4167,2,14,10,2,45,26,19,52
Glenavon,4167,3,10,9,7,56,45,11,39
Linfield,4167,4,11,5,10,38,36,2,38
Cliftonville,4167,5,9,4,13,32,32,0,31
Ballymena,4167,6,8,4,14,27,48,-21,28
Glentoran,4167,7,6,6,10,24,32,-8,24
Dungannon,4167,8,2,4,16,14,47,-33,10
Crusaders,4168,1,17,6,3,64,32,32,57
Coleraine,4168,2,15,10,1,46,22,24,55
Glenavon,4168,3,9,9,8,52,46,6,36
Linfield,4168,4,10,6,10,37,36,1,36
Cliftonville,4168,5,9,5,12,32,31,1,32
Ballymena,4168,6,7,4,15,27,50,-23,25
Glentoran,4168,7,6,6,10,24,32,-8,24
Dungannon,4168,8,2,4,16,14,47,-33,10
Crusaders,4169,1,16,7,3,63,32,31,55
Coleraine,4169,2,14,10,2,45,25,20,52
Glenavon,4169,3,10,9,7,55,45,10,39
Linfield,4169,4,10,5,11,38,38,0,35
Cliftonville,4169,5,10,4,12,34,32,2,34
Ballymena,4169,6,7,5,14,27,49,-22,26
Glentoran,4169,7,6,6,10,24,32,-8,24
Dungannon,4169,8,2,4,16,14,47,-33,10
Crusaders,4170,1,16,7,3,61,30,31,55
Coleraine,4170,2,15,10,1,45,23,22,55
Glenavon,4170,3,9,9,8,53,45,8,36
Linfield,4170,4,10,5,11,38,39,-1,35
Cliftonville,4170,5,10,4,12,35,32,3,34
Ballymena,4170,6,7,5,14,25,47,-22,26
Glentoran,4170,7,6,6,10,24,32,-8,24
Dungannon,4170,8,2,4,16,14,47,-33,10
Crusaders,4171,1,17,6,3,64,31,33,57
Coleraine,4171,2,15,10,1,45,22,23,55
Glenavon,4171,3,9,9,8,52,45,7,36
Linfield,4171,4,10,5,11,39,39,0,35
Cliftonville,4171,5,10,4,12,35,33,2,34
Ballymena,4171,6,7,4,15,26,50,-24,25
Glentoran,4171,7,6,6,10,24,32,-8,24
Dungannon,4171,8,2,4,16,14,47,-33,10
Crusaders,4172,1,17,6,3,63,30,33,57
Coleraine,4172,2,15,10,1,44,22,22,55
Linfield,4172,3,11,5,10,39,36,3,38
Glenavon,4172,4,9,9,8,52,44,8,36
Cliftonville,4172,5,9,4,13,32,33,-1,31
Ballymena,4172,6,7,4,15,25,49,-24,25
Glentoran,4172,7,6,6,10,24,32,-8,24
Dungannon,4172,8,2,4,16,14,47,-33,10
Crusaders,4173,1,16,6,4,63,34,29,54
Coleraine,4173,2,14,10,2,43,24,19,52
Glenavon,4173,3,10,9,7,54,43,11,39
Linfield,4173,4,10,6,10,38,37,1,36
Cliftonville,4173,5,9,5,12,33,32,1,32
Ballymena,4173,6,8,4,14,29,49,-20,28
Glentoran,4173,7,6,6,10,24,32,-8,24
Dungannon,4173,8,2,4,16,14,47,-33,10
Coleraine,4174,1,15,10,1,45,23,22,55
Crusaders,4174,2,16,6,4,62,33,29,54
Linfield,4174,3,11,5,10,39,37,2,38
Glenavon,4174,4,9,9,8,53,45,8,36
Cliftonville,4174,5,9,4,13,33,33,0,31
Ballymena,4174,6,8,4,14,28,48,-20,28
Glentoran,4174,7,6,6,10,24,32,-8,24
Dungannon,4174,8,2,4,16,14,47,-33,10
Crusaders,4175,1,17,6,3,65,31,34,57
Coleraine,4175,2,14,10,2,43,23,20,52
Glenavon,4175,3,10,9,7,53,43,10,39
Linfield,4175,4,10,6,10,37,36,1,36
Cliftonville,4175,5,9,5,12,32,31,1,32
Ballymena,4175,6,7,4,15,26,51,-25,25
Glentoran,4175,7,6,6,10,24,32,-8,24
Dungannon,4175,8,2,4,16,14,47,-33,10
Crusaders,4176,1,17,6,3,63,31,32,57
Coleraine,4176,2,14,10,2,45,25,20,52
Glenavon,4176,3,10,9,7,55,45,10,39
Linfield,4176,4,11,5,10,39,37,2,38
Cliftonville,4176,5,9,4,13,33,33,0,31
Ballymena,4176,6,7,4,15,26,49,-23,25
Glentoran,4176,7,6,6,10,24,32,-8,24
Dungannon,4176,8,2,4,16,14,47,-33,10
Crusaders,4177,1,17,6,3,63,30,33,57
Coleraine,4177,2,14,10,2,43,23,20,52
Glenavon,4177,3,10,9,7,53,43,10,39
Linfield,4177,4,10,5,11,37,38,-1,35
Cliftonville,4177,5,10,4,12,34,31,3,34
Ballymena,4177,6,7,4,15,25,49,-24,25
Glentoran,4177,7,6,6,10,24,32,-8,24
Dungannon,4177,8,2,4,16,14,47,-33,10
Coleraine,4178,1,15,10,1,44,22,22,55
Crusaders,4178,2,16,6,4,62,32,30,54
Linfield,4178,3,11,5,10,40,36,4,38
Glenavon,4178,4,9,9,8,52,44,8,36
Cliftonville,4178,5,9,4,13,32,34,-2,31
Ballymena,4178,6,8,4,14,27,48,-21,28
Glentoran,4178,7,6,6,10,24,32,-8,24
Dungannon,4178,8,2,4,16,14,47,-33,10
Crusaders,4179,1,16,6,4,62,33,29,54
Coleraine,4179,2,14,10,2,45,26,19,52
Glenavon,4179,3,10,9,7,56,45,11,39
Linfield,4179,4,11,5,10,39,36,3,38
Cliftonville,4179,5,9,4,13,32,33,-1,31
Ballymena,4179,6,8,4,14,28,48,-20,28
Glentoran,4179,7,6,6,10,24,32,-8,24
Dungannon,4179,8,2,4,16,14,47,-33,10
Crusaders,4180,1,17,6,3,62,30,32,57
Coleraine,4180,2,15,10,1,46,23,23,55
Linfield,4180,3,11,5,10,39,36,3,38
Glenavon,4180,4,9,9,8,53,46,7,36
Cliftonville,4180,5,9,4,13,32,33,-1,31
Ballymena,4180,6,7,4,15,25,48,-23,25
Glentoran,4180,7,6,6,10,24,32,-8,24
Dungannon,4180,8,2,4,16,14,47,-33,10
Crusaders,4181,1,17,6,3,65,33,32,57
Coleraine,4181,2,14,10,2,44,24,20,52
Glenavon,4181,3,10,9,7,54,44,10,39
Linfield,4181,4,11,5,10,39,37,2,38
Cliftonville,4181,5,9,4,13,33,33,0,31
Ballymena,4181,6,7,4,15,28,51,-23,25
Glentoran,4181,7,6,6,10,24,32,-8,24
Dungannon,4181,8,2,4,16,14,47,-33,10
Crusaders,4182,1,17,6,3,63,31,32,57
Coleraine,4182,2,14,11,1,43,22,21,53
Linfield,4182,3,11,5,10,42,36,6,38
Glenavon,4182,4,9,10,7,52,43,9,37
Cliftonville,4182,5,9,4,13,32,36,-4,31
Ballymena,4182,6,7,4,15,26,49,-23,25
Glentoran,4182,7,6,6,10,24,32,-8,24
Dungannon,4182,8,2,4,16,14,47,-33,10
Crusaders,4183,1,17,6,3,68,32,36,57
Coleraine,4183,2,14,11,1,44,23,21,53
Glenavon,4183,3,9,10,7,53,44,9,37
Linfield,4183,4,10,5,11,37,38,-1,35
Cliftonville,4183,5,10,4,12,34,31,3,34
Ballymena,4183,6,7,4,15,27,54,-27,25
Glentoran,4183,7,6,6,10,24,32,-8,24
Dungannon,4183,8,2,4,16,14,47,-33,10
Crusaders,4184,1,17,6,3,63,30,33,57
Coleraine,4184,2,14,10,2,44,24,20,52
Glenavon,4184,3,10,9,7,54,44,10,39
Linfield,4184,4,11,5,10,39,37,2,38
Cliftonville,4184,5,9,4,13,33,33,0,31
Ballymena,4184,6,7,4,15,25,49,-24,25
Glentoran,4184,7,6,6,10,24,32,-8,24
Dungannon,4184,8,2,4,16,14,47,-33,10
Crusaders,4185,1,17,6,3,63,30,33,57
Coleraine,4185,2,15,10,1,44,22,22,55
Linfield,4185,3,11,5,10,38,36,2,38
Glenavon,4185,4,9,9,8,52,44,8,36
Cliftonville,4185,5,9,4,13,32,32,0,31
Ballymena,4185,6,7,4,15,25,49,-24,25
Glentoran,4185,7,6,6,10,24,32,-8,24
Dungannon,4185,8,2,4,16,14,47,-33,10
Crusaders,4186,1,16,6,4,61,31,30,54
Coleraine,4186,2,14,10,2,43,23,20,52
Glenavon,4186,3,10,9,7,53,43,10,39
Linfield,4186,4,10,6,10,40,39,1,36
Cliftonville,4186,5,9,5,12,35,34,1,32
Ballymena,4186,6,8,4,14,26,47,-21,28
Glentoran,4186,7,6,6,10,24,32,-8,24
Dungannon,4186,8,2,4,16,14,47,-33,10
Crusaders,4187,1,17,6,3,62,30,32,57
Coleraine,4187,2,14,11,1,44,23,21,53
Glenavon,4187,3,9,10,7,53,44,9,37
Linfield,4187,4,10,5,11,38,38,0,35
Cliftonville,4187,5,10,4,12,34,32,2,34
Ballymena,4187,6,7,4,15,25,48,-23,25
Glentoran,4187,7,6,6,10,24,32,-8,24
Dungannon,4187,8,2,4,16,14,47,-33,10
Crusaders,4188,1,16,6,4,64,34,30,54
Coleraine,4188,2,14,10,2,43,24,19,52
Glenavon,4188,3,10,9,7,54,43,11,39
Linfield,4188,4,11,5,10,40,37,3,38
Cliftonville,4188,5,9,4,13,33,34,-1,31
Ballymena,4188,6,8,4,14,29,50,-21,28
Glentoran,4188,7,6,6,10,24,32,-8,24
Dungannon,4188,8,2,4,16,14,47,-33,10
Crusaders,4189,1,17,6,3,67,31,36,57
Coleraine,4189,2,15,10,1,46,24,22,55
Glenavon,4189,3,9,9,8,54,46,8,36
Linfield,4189,4,10,6,10,39,38,1,36
Cliftonville,4189,5,9,5,12,34,33,1,32
Ballymena,4189,6,7,4,15,26,53,-27,25
Glentoran,4189,7,6,6,10,24,32,-8,24
Dungannon,4189,8,2,4,16,14,47,-33,10
Crusaders,4190,1,16,7,3,62,31,31,55
Coleraine,4190,2,14,10,2,43,24,19,52
Glenavon,4190,3,10,9,7,54,43,11,39
Linfield,4190,4,10,6,10,37,36,1,36
Cliftonville,4190,5,9,5,12,32,31,1,32
Ballymena,4190,6,7,5,14,26,48,-22,26
Glentoran,4190,7,6,6,10,24,32,-8,24
Dungannon,4190,8,2,4,16,14,47,-33,10
Crusaders,4191,1,16,7,3,62,31,31,55
Coleraine,4191,2,14,10,2,44,27,17,52
Glenavon,4191,3,10,9,7,57,44,13,39
Linfield,4191,4,11,5,10,40,37,3,38
Cliftonville,4191,5,9,4,13,33,34,-1,31
Ballymena,4191,6,7,5,14,26,48,-22,26
Glentoran,4191,7,6,6,10,24,32,-8,24
Dungannon,4191,8,2,4,16,14,47,-33,10
Crusaders,4192,1,16,7,3,62,31,31,55
Coleraine,4192,2,15,10,1,45,22,23,55
Linfield,4192,3,11,5,10,38,36,2,38
Glenavon,4192,4,9,9,8,52,45,7,36
Cliftonville,4192,5,9,4,13,32,32,0,31
Ballymena,4192,6,7,5,14,26,48,-22,26
Glentoran,4192,7,6,6,10,24,32,-8,24
Dungannon,4192,8,2,4,16,14,47,-33,10
Crusaders,4193,1,17,6,3,63,31,32,57
Coleraine,4193,2,14,10,2,43,24,19,52
Glenavon,4193,3,10,9,7,54,43,11,39
Linfield,4193,4,10,5,11,37,37,0,35
Cliftonville,4193,5,10,4,12,33,31,2,34
Ballymena,4193,6,7,4,15,26,49,-23,25
Glentoran,4193,7,6,6,10,24,32,-8,24
Dungannon,4193,8,2,4,16,14,47,-33,10
Crusaders,4194,1,17,6,3,64,30,34,57
Coleraine,4194,2,14,10,2,44,24,20,52
Glenavon,4194,3,10,9,7,54,44,10,39
Linfield,4194,4,10,5,11,37,38,-1,35
Cliftonville,4194,5,10,4,12,34,31,3,34
Ballymena,4194,6,7,4,15,25,50,-25,25
Glentoran,4194,7,6,6,10,24,32,-8,24
Dungannon,4194,8,2,4,16,14,47,-33,10
Crusaders,4195,1,17,6,3,62,30,32,57
Coleraine,4195,2,15,10,1,46,24,22,55
Glenavon,4195,3,9,9,8,54,46,8,36
Linfield,4195,4,10,5,11,38,38,0,35
Cliftonville,4195,5,10,4,12,34,32,2,34
Ballymena,4195,6,7,4,15,25,48,-23,25
Glentoran,4195,7,6,6,10,24,32,-8,24
Dungannon,4195,8,2,4,16,14,47,-33,10
Crusaders,4196,1,16,7,3,62,31,31,55
Coleraine,4196,2,14,10,2,43,23,20,52
Glenavon,4196,3,10,9,7,53,43,10,39
Linfield,4196,4,11,5,10,38,36,2,38
Cliftonville,4196,5,9,4,13,32,32,0,31
Ballymena,4196,6,7,5,14,26,48,-22,26
Glentoran,4196,7,6,6,10,24,32,-8,24
Dungannon,4196,8,2,4,16,14,47,-33,10
Crusaders,4197,1,16,6,4,62,33,29,54
Coleraine,4197,2,14,10,2,43,24,19,52
Glenavon,4197,3,10,9,7,54,43,11,39
Linfield,4197,4,11,5,10,41,36,5,38
Cliftonville,4197,5,9,4,13,32,35,-3,31
Ballymena,4197,6,8,4,14,28,48,-20,28
Glentoran,4197,7,6,6,10,24,32,-8,24
Dungannon,4197,8,2,4,16,14,47,-33,10
Crusaders,4198,1,16,7,3,64,33,31,55
Coleraine,4198,2,15,10,1,46,24,22,55
Glenavon,4198,3,9,9,8,54,46,8,36
Linfield,4198,4,10,5,11,38,38,0,35
Cliftonville,4198,5,10,4,12,34,32,2,34
Ballymena,4198,6,7,5,14,28,50,-22,26
Glentoran,4198,7,6,6,10,24,32,-8,24
Dungannon,4198,8,2,4,16,14,47,-33,10
Crusaders,4199,1,17,6,3,64,31,33,57
Coleraine,4199,2,14,11,1,46,25,21,53
Glenavon,4199,3,9,10,7,55,46,9,37
Linfield,4199,4,10,5,11,38,38,0,35
Cliftonville,4199,5,10,4,12,34,32,2,34
Ballymena,4199,6,7,4,15,26,50,-24,25
Glentoran,4199,7,6,6,10,24,32,-8,24
Dungannon,4199,8,2,4,16,14,47,-33,10
Crusaders,4200,1,17,6,3,63,31,32,57
Coleraine,4200,2,14,10,2,44,25,19,52
Glenavon,4200,3,10,9,7,55,44,11,39
Linfield,4200,4,10,5,11,38,38,0,35
Cliftonville,4200,5,10,4,12,34,32,2,34
Ballymena,4200,6,7,4,15,26,49,-23,25
Glentoran,4200,7,6,6,10,24,32,-8,24
Dungannon,4200,8,2,4,16,14,47,-33,10
Crusaders,4201,1,16,6,4,61,31,30,54
Coleraine,4201,2,14,10,2,43,26,17,52
Glenavon,4201,3,10,9,7,56,43,13,39
Linfield,4201,4,10,6,10,39,38,1,36
Cliftonville,4201,5,9,5,12,34,33,1,32
Ballymena,4201,6,8,4,14,26,47,-21,28
Glentoran,4201,7,6,6,10,24,32,-8,24
Dungannon,4201,8,2,4,16,14,47,-33,10
Crusaders,4202,1,16,6,4,62,33,29,54
Coleraine,4202,2,14,10,2,44,26,18,52
Glenavon,4202,3,10,9,7,56,44,12,39
Linfield,4202,4,10,5,11,38,38,0,35
Cliftonville,4202,5,10,4,12,34,32,2,34
Ballymena,4202,6,8,4,14,28,48,-20,28
Glentoran,4202,7,6,6,10,24,32,-8,24
Dungannon,4202,8,2,4,16,14,47,-33,10
Crusaders,4203,1,16,6,4,63,33,30,54
Coleraine,4203,2,14,10,2,44,25,19,52
Glenavon,4203,3,10,9,7,55,44,11,39
Linfield,4203,4,10,5,11,39,39,0,35
Cliftonville,4203,5,10,4,12,35,33,2,34
Ballymena,4203,6,8,4,14,28,49,-21,28
Glentoran,4203,7,6,6,10,24,32,-8,24
Dungannon,4203,8,2,4,16,14,47,-33,10
Crusaders,4204,1,16,6,4,62,34,28,54
Coleraine,4204,2,14,10,2,44,25,19,52
Glenavon,4204,3,10,9,7,55,44,11,39
Linfield,4204,4,10,5,11,37,37,0,35
Cliftonville,4204,5,10,4,12,33,31,2,34
Ballymena,4204,6,8,4,14,29,48,-19,28
Glentoran,4204,7,6,6,10,24,32,-8,24
Dungannon,4204,8,2,4,16,14,47,-33,10
Crusaders,4205,1,17,6,3,63,30,33,57
Coleraine,4205,2,15,10,1,45,22,23,55
Linfield,4205,3,11,5,10,39,36,3,38
Glenavon,4205,4,9,9,8,52,45,7,36
Cliftonville,4205,5,9,4,13,32,33,-1,31
Ballymena,4205,6,7,4,15,25,49,-24,25
Glentoran,4205,7,6,6,10,24,32,-8,24
Dungannon,4205,8,2,4,16,14,47,-33,10
Crusaders,4206,1,16,6,4,61,32,29,54
Coleraine,4206,2,14,10,2,45,25,20,52
Glenavon,4206,3,10,9,7,55,45,10,39
Linfield,4206,4,11,5,10,38,36,2,38
Cliftonville,4206,5,9,4,13,32,32,0,31
Ballymena,4206,6,8,4,14,27,47,-20,28
Glentoran,4206,7,6,6,10,24,32,-8,24
Dungannon,4206,8,2,4,16,14,47,-33,10
Crusaders,4207,1,16,6,4,62,32,30,54
Coleraine,4207,2,14,11,1,45,24,21,53
Glenavon,4207,3,9,10,7,54,45,9,37
Linfield,4207,4,10,5,11,37,37,0,35
Cliftonville,4207,5,10,4,12,33,31,2,34
Ballymena,4207,6,8,4,14,27,48,-21,28
Glentoran,4207,7,6,6,10,24,32,-8,24
Dungannon,4207,8,2,4,16,14,47,-33,10
Crusaders,4208,1,16,6,4,63,33,30,54
Coleraine,4208,2,14,10,2,43,24,19,52
Glenavon,4208,3,10,9,7,54,43,11,39
Linfield,4208,4,11,5,10,38,36,2,38
Cliftonville,4208,5,9,4,13,32,32,0,31
Ballymena,4208,6,8,4,14,28,49,-21,28
Glentoran,4208,7,6,6,10,24,32,-8,24
Dungannon,4208,8,2,4,16,14,47,-33,10
Crusaders,4209,1,17,6,3,62,30,32,57
Coleraine,4209,2,15,10,1,45,23,22,55
Glenavon,4209,3,9,9,8,53,45,8,36
Linfield,4209,4,10,5,11,37,38,-1,35
Cliftonville,4209,5,10,4,12,34,31,3,34
Ballymena,4209,6,7,4,15,25,48,-23,25
Glentoran,4209,7,6,6,10,24,32,-8,24
Dungannon,4209,8,2,4,16,14,47,-33,10
Crusaders,4210,1,16,7,3,65,34,31,55
Coleraine,4210,2,14,11,1,46,25,21,53
Linfield,4210,3,11,5,10,39,36,3,38
Glenavon,4210,4,9,10,7,55,46,9,37
Cliftonville,4210,5,9,4,13,32,33,-1,31
Ballymena,4210,6,7,5,14,29,51,-22,26
Glentoran,4210,7,6,6,10,24,32,-8,24
Dungannon,4210,8,2,4,16,14,47,-33,10
Crusaders,4211,1,17,6,3,67,31,36,57
Coleraine,4211,2,14,11,1,43,22,21,53
Glenavon,4211,3,9,10,7,52,43,9,37
Linfield,4211,4,10,6,10,39,38,1,36
Cliftonville,4211,5,9,5,12,34,33,1,32
Ballymena,4211,6,7,4,15,26,53,-27,25
Glentoran,4211,7,6,6,10,24,32,-8,24
Dungannon,4211,8,2,4,16,14,47,-33,10
Crusaders,4212,1,16,6,4,63,33,30,54
Coleraine,4212,2,14,10,2,44,25,19,52
Glenavon,4212,3,10,9,7,55,44,11,39
Linfield,4212,4,10,5,11,37,38,-1,35
Cliftonville,4212,5,10,4,12,34,31,3,34
Ballymena,4212,6,8,4,14,28,49,-21,28
Glentoran,4212,7,6,6,10,24,32,-8,24
Dungannon,4212,8,2,4,16,14,47,-33,10
Crusaders,4213,1,17,6,3,63,30,33,57
Coleraine,4213,2,15,10,1,45,23,22,55
Linfield,4213,3,11,5,10,39,36,3,38
Glenavon,4213,4,9,9,8,53,45,8,36
Cliftonville,4213,5,9,4,13,32,33,-1,31
Ballymena,4213,6,7,4,15,25,49,-24,25
Glentoran,4213,7,6,6,10,24,32,-8,24
Dungannon,4213,8,2,4,16,14,47,-33,10
Crusaders,4214,1,17,6,3,63,30,33,57
Coleraine,4214,2,14,11,1,44,23,21,53
Linfield,4214,3,11,5,10,38,36,2,38
Glenavon,4214,4,9,10,7,53,44,9,37
Cliftonville,4214,5,9,4,13,32,32,0,31
Ballymena,4214,6,7,4,15,25,49,-24,25
Glentoran,4214,7,6,6,10,24,32,-8,24
Dungannon,4214,8,2,4,16,14,47,-33,10
Crusaders,4215,1,17,6,3,64,30,34,57
Coleraine,4215,2,15,10,1,47,22,25,55
Linfield,4215,3,11,5,10,38,36,2,38
Glenavon,4215,4,9,9,8,52,47,5,36
Cliftonville,4215,5,9,4,13,32,32,0,31
Ballymena,4215,6,7,4,15,25,50,-25,25
Glentoran,4215,7,6,6,10,24,32,-8,24
Dungannon,4215,8,2,4,16,14,47,-33,10
Crusaders,4216,1,16,6,4,62,33,29,54
Coleraine,4216,2,14,11,1,46,25,21,53
Linfield,4216,3,11,5,10,39,37,2,38
Glenavon,4216,4,9,10,7,55,46,9,37
Cliftonville,4216,5,9,4,13,33,33,0,31
Ballymena,4216,6,8,4,14,28,48,-20,28
Glentoran,4216,7,6,6,10,24,32,-8,24
Dungannon,4216,8,2,4,16,14,47,-33,10
Crusaders,4217,1,16,7,3,62,31,31,55
Coleraine,4217,2,14,11,1,44,23,21,53
Linfield,4217,3,11,5,10,39,37,2,38
Glenavon,4217,4,9,10,7,53,44,9,37
Cliftonville,4217,5,9,4,13,33,33,0,31
Ballymena,4217,6,7,5,14,26,48,-22,26
Glentoran,4217,7,6,6,10,24,32,-8,24
Dungannon,4217,8,2,4,16,14,47,-33,10
Crusaders,4218,1,16,7,3,62,31,31,55
Coleraine,4218,2,14,11,1,45,24,21,53
Linfield,4218,3,11,5,10,40,37,3,38
Glenavon,4218,4,9,10,7,54,45,9,37
Cliftonville,4218,5,9,4,13,33,34,-1,31
Ballymena,4218,6,7,5,14,26,48,-22,26
Glentoran,4218,7,6,6,10,24,32,-8,24
Dungannon,4218,8,2,4,16,14,47,-33,10
Crusaders,4219,1,17,6,3,63,31,32,57
Coleraine,4219,2,14,10,2,44,25,19,52
Glenavon,4219,3,10,9,7,55,44,11,39
Linfield,4219,4,11,5,10,40,37,3,38
Cliftonville,4219,5,9,4,13,33,34,-1,31
Ballymena,4219,6,7,4,15,26,49,-23,25
Glentoran,4219,7,6,6,10,24,32,-8,24
Dungannon,4219,8,2,4,16,14,47,-33,10
Crusaders,4220,1,17,6,3,64,30,34,57
Coleraine,4220,2,15,10,1,47,24,23,55
Linfield,4220,3,11,5,10,38,36,2,38
Glenavon,4220,4,9,9,8,54,47,7,36
Cliftonville,4220,5,9,4,13,32,32,0,31
Ballymena,4220,6,7,4,15,25,50,-25,25
Glentoran,4220,7,6,6,10,24,32,-8,24
Dungannon,4220,8,2,4,16,14,47,-33,10
Crusaders,4221,1,17,6,3,66,30,36,57
Coleraine,4221,2,14,10,2,44,24,20,52
Glenavon,4221,3,10,9,7,54,44,10,39
Linfield,4221,4,11,5,10,38,36,2,38
Cliftonville,4221,5,9,4,13,32,32,0,31
Ballymena,4221,6,7,4,15,25,52,-27,25
Glentoran,4221,7,6,6,10,24,32,-8,24
Dungannon,4221,8,2,4,16,14,47,-33,10
Crusaders,4222,1,17,6,3,65,32,33,57
Coleraine,4222,2,14,10,2,44,24,20,52
Glenavon,4222,3,10,9,7,54,44,10,39
Linfield,4222,4,10,6,10,38,37,1,36
Cliftonville,4222,5,9,5,12,33,32,1,32
Ballymena,4222,6,7,4,15,27,51,-24,25
Glentoran,4222,7,6,6,10,24,32,-8,24
Dungannon,4222,8,2,4,16,14,47,-33,10
Crusaders,4223,1,16,6,4,62,33,29,54
Coleraine,4223,2,14,11,1,43,22,21,53
Linfield,4223,3,11,5,10,40,37,3,38
Glenavon,4223,4,9,10,7,52,43,9,37
Cliftonville,4223,5,9,4,13,33,34,-1,31
Ballymena,4223,6,8,4,14,28,48,-20,28
Glentoran,4223,7,6,6,10,24,32,-8,24
Dungannon,4223,8,2,4,16,14,47,-33,10
Crusaders,4224,1,17,6,3,66,30,36,57
Coleraine,4224,2,15,10,1,46,24,22,55
Glenavon,4224,3,9,9,8,54,46,8,36
Linfield,4224,4,10,5,11,37,37,0,35
Cliftonville,4224,5,10,4,12,33,31,2,34
Ballymena,4224,6,7,4,15,25,52,-27,25
Glentoran,4224,7,6,6,10,24,32,-8,24
Dungannon,4224,8,2,4,16,14,47,-33,10
Crusaders,4225,1,17,6,3,64,31,33,57
Coleraine,4225,2,14,10,2,43,25,18,52
Glenavon,4225,3,10,9,7,55,43,12,39
Linfield,4225,4,10,5,11,38,38,0,35
Cliftonville,4225,5,10,4,12,34,32,2,34
Ballymena,4225,6,7,4,15,26,50,-24,25
Glentoran,4225,7,6,6,10,24,32,-8,24
Dungannon,4225,8,2,4,16,14,47,-33,10
Crusaders,4226,1,16,7,3,62,31,31,55
Coleraine,4226,2,15,10,1,46,22,24,55
Linfield,4226,3,11,5,10,39,36,3,38
Glenavon,4226,4,9,9,8,52,46,6,36
Cliftonville,4226,5,9,4,13,32,33,-1,31
Ballymena,4226,6,7,5,14,26,48,-22,26
Glentoran,4226,7,6,6,10,24,32,-8,24
Dungannon,4226,8,2,4,16,14,47,-33,10
Crusaders,4227,1,16,6,4,63,33,30,54
Coleraine,4227,2,14,10,2,43,24,19,52
Glenavon,4227,3,10,9,7,54,43,11,39
Linfield,4227,4,10,5,11,37,38,-1,35
Cliftonville,4227,5,10,4,12,34,31,3,34
Ballymena,4227,6,8,4,14,28,49,-21,28
Glentoran,4227,7,6,6,10,24,32,-8,24
Dungannon,4227,8,2,4,16,14,47,-33,10
Crusaders,4228,1,16,7,3,62,31,31,55
Coleraine,4228,2,15,10,1,45,23,22,55
Glenavon,4228,3,9,9,8,53,45,8,36
Linfield,4228,4,10,5,11,37,37,0,35
Cliftonville,4228,5,10,4,12,33,31,2,34
Ballymena,4228,6,7,5,14,26,48,-22,26
Glentoran,4228,7,6,6,10,24,32,-8,24
Dungannon,4228,8,2,4,16,14,47,-33,10
Crusaders,4229,1,17,6,3,65,31,34,57
Coleraine,4229,2,14,11,1,44,23,21,53
Glenavon,4229,3,9,10,7,53,44,9,37
Linfield,4229,4,10,5,11,38,38,0,35
Cliftonville,4229,5,10,4,12,34,32,2,34
Ballymena,4229,6,7,4,15,26,51,-25,25
Glentoran,4229,7,6,6,10,24,32,-8,24
Dungannon,4229,8,2,4,16,14,47,-33,10
Crusaders,4230,1,17,6,3,64,30,34,57
Coleraine,4230,2,15,10,1,45,23,22,55
Glenavon,4230,3,9,9,8,53,45,8,36
Linfield,4230,4,10,6,10,37,36,1,36
Cliftonville,4230,5,9,5,12,32,31,1,32
Ballymena,4230,6,7,4,15,25,50,-25,25
Glentoran,4230,7,6,6,10,24,32,-8,24
Dungannon,4230,8,2,4,16,14,47,-33,10
Crusaders,4231,1,17,6,3,64,30,34,57
Coleraine,4231,2,14,10,2,46,26,20,52
Glenavon,4231,3,10,9,7,56,46,10,39
Linfield,4231,4,10,6,10,38,37,1,36
Cliftonville,4231,5,9,5,12,33,32,1,32
Ballymena,4231,6,7,4,15,25,50,-25,25
Glentoran,4231,7,6,6,10,24,32,-8,24
Dungannon,4231,8,2,4,16,14,47,-33,10
Crusaders,4232,1,16,6,4,63,33,30,54
Coleraine,4232,2,14,10,2,43,24,19,52
Glenavon,4232,3,10,9,7,54,43,11,39
Linfield,4232,4,11,5,10,38,36,2,38
Cliftonville,4232,5,9,4,13,32,32,0,31
Ballymena,4232,6,8,4,14,28,49,-21,28
Glentoran,4232,7,6,6,10,24,32,-8,24
Dungannon,4232,8,2,4,16,14,47,-33,10
Coleraine,4233,1,15,10,1,45,22,23,55
Crusaders,4233,2,16,6,4,62,32,30,54
Linfield,4233,3,11,5,10,41,37,4,38
Glenavon,4233,4,9,9,8,52,45,7,36
Cliftonville,4233,5,9,4,13,33,35,-2,31
Ballymena,4233,6,8,4,14,27,48,-21,28
Glentoran,4233,7,6,6,10,24,32,-8,24
Dungannon,4233,8,2,4,16,14,47,-33,10
Crusaders,4234,1,16,6,4,63,33,30,54
Coleraine,4234,2,14,10,2,44,25,19,52
Glenavon,4234,3,10,9,7,55,44,11,39
Linfield,4234,4,10,5,11,38,38,0,35
Cliftonville,4234,5,10,4,12,34,32,2,34
Ballymena,4234,6,8,4,14,28,49,-21,28
Glentoran,4234,7,6,6,10,24,32,-8,24
Dungannon,4234,8,2,4,16,14,47,-33,10
Crusaders,4235,1,17,6,3,63,30,33,57
Coleraine,4235,2,14,10,2,45,27,18,52
Glenavon,4235,3,10,9,7,57,45,12,39
Linfield,4235,4,10,6,10,38,37,1,36
Cliftonville,4235,5,9,5,12,33,32,1,32
Ballymena,4235,6,7,4,15,25,49,-24,25
Glentoran,4235,7,6,6,10,24,32,-8,24
Dungannon,4235,8,2,4,16,14,47,-33,10
Crusaders,4236,1,16,7,3,64,33,31,55
Coleraine,4236,2,14,11,1,44,23,21,53
Glenavon,4236,3,9,10,7,53,44,9,37
Linfield,4236,4,10,6,10,37,36,1,36
Cliftonville,4236,5,9,5,12,32,31,1,32
Ballymena,4236,6,7,5,14,28,50,-22,26
Glentoran,4236,7,6,6,10,24,32,-8,24
Dungannon,4236,8,2,4,16,14,47,-33,10
Crusaders,4237,1,17,6,3,64,30,34,57
Coleraine,4237,2,14,11,1,44,23,21,53
Glenavon,4237,3,9,10,7,53,44,9,37
Linfield,4237,4,10,6,10,38,37,1,36
Cliftonville,4237,5,9,5,12,33,32,1,32
Ballymena,4237,6,7,4,15,25,50,-25,25
Glentoran,4237,7,6,6,10,24,32,-8,24
Dungannon,4237,8,2,4,16,14,47,-33,10
Coleraine,4238,1,15,10,1,44,22,22,55
Crusaders,4238,2,16,6,4,61,32,29,54
Linfield,4238,3,11,5,10,40,36,4,38
Glenavon,4238,4,9,9,8,52,44,8,36
Cliftonville,4238,5,9,4,13,32,34,-2,31
Ballymena,4238,6,8,4,14,27,47,-20,28
Glentoran,4238,7,6,6,10,24,32,-8,24
Dungannon,4238,8,2,4,16,14,47,-33,10
Crusaders,4239,1,16,7,3,62,31,31,55
Coleraine,4239,2,14,10,2,45,25,20,52
Glenavon,4239,3,10,9,7,55,45,10,39
Linfield,4239,4,11,5,10,39,37,2,38
Cliftonville,4239,5,9,4,13,33,33,0,31
Ballymena,4239,6,7,5,14,26,48,-22,26
Glentoran,4239,7,6,6,10,24,32,-8,24
Dungannon,4239,8,2,4,16,14,47,-33,10
Crusaders,4240,1,17,6,3,63,31,32,57
Coleraine,4240,2,14,10,2,44,27,17,52
Glenavon,4240,3,10,9,7,57,44,13,39
Linfield,4240,4,11,5,10,40,38,2,38
Cliftonville,4240,5,9,4,13,34,34,0,31
Ballymena,4240,6,7,4,15,26,49,-23,25
Glentoran,4240,7,6,6,10,24,32,-8,24
Dungannon,4240,8,2,4,16,14,47,-33,10
Crusaders,4241,1,16,7,3,61,30,31,55
Coleraine,4241,2,14,10,2,43,24,19,52
Glenavon,4241,3,10,9,7,54,43,11,39
Linfield,4241,4,10,6,10,38,37,1,36
Cliftonville,4241,5,9,5,12,33,32,1,32
Ballymena,4241,6,7,5,14,25,47,-22,26
Glentoran,4241,7,6,6,10,24,32,-8,24
Dungannon,4241,8,2,4,16,14,47,-33,10
Crusaders,4242,1,17,6,3,63,30,33,57
Coleraine,4242,2,14,10,2,43,23,20,52
Glenavon,4242,3,10,9,7,53,43,10,39
Linfield,4242,4,11,5,10,40,37,3,38
Cliftonville,4242,5,9,4,13,33,34,-1,31
Ballymena,4242,6,7,4,15,25,49,-24,25
Glentoran,4242,7,6,6,10,24,32,-8,24
Dungannon,4242,8,2,4,16,14,47,-33,10
Crusaders,4243,1,16,7,3,63,32,31,55
Coleraine,4243,2,14,10,2,43,24,19,52
Glenavon,4243,3,10,9,7,54,43,11,39
Linfield,4243,4,11,5,10,39,36,3,38
Cliftonville,4243,5,9,4,13,32,33,-1,31
Ballymena,4243,6,7,5,14,27,49,-22,26
Glentoran,4243,7,6,6,10,24,32,-8,24
Dungannon,4243,8,2,4,16,14,47,-33,10
Crusaders,4244,1,17,6,3,63,30,33,57
Coleraine,4244,2,15,10,1,47,24,23,55
Glenavon,4244,3,9,9,8,54,47,7,36
Linfield,4244,4,10,5,11,38,39,-1,35
Cliftonville,4244,5,10,4,12,35,32,3,34
Ballymena,4244,6,7,4,15,25,49,-24,25
Glentoran,4244,7,6,6,10,24,32,-8,24
Dungannon,4244,8,2,4,16,14,47,-33,10
Crusaders,4245,1,17,6,3,63,30,33,57
Coleraine,4245,2,15,10,1,46,22,24,55
Glenavon,4245,3,9,9,8,52,46,6,36
Linfield,4245,4,10,5,11,37,38,-1,35
Cliftonville,4245,5,10,4,12,34,31,3,34
Ballymena,4245,6,7,4,15,25,49,-24,25
Glentoran,4245,7,6,6,10,24,32,-8,24
Dungannon,4245,8,2,4,16,14,47,-33,10
Crusaders,4246,1,17,6,3,62,30,32,57
Coleraine,4246,2,14,10,2,43,25,18,52
Glenavon,4246,3,10,9,7,55,43,12,39
Linfield,4246,4,10,6,10,37,36,1,36
Cliftonville,4246,5,9,5,12,32,31,1,32
Ballymena,4246,6,7,4,15,25,48,-23,25
Glentoran,4246,7,6,6,10,24,32,-8,24
Dungannon,4246,8,2,4,16,14,47,-33,10
Crusaders,4247,1,16,6,4,62,32,30,54
Coleraine,4247,2,14,11,1,45,24,21,53
Linfield,4247,3,11,5,10,39,36,3,38
Glenavon,4247,4,9,10,7,54,45,9,37
Cliftonville,4247,5,9,4,13,32,33,-1,31
Ballymena,4247,6,8,4,14,27,48,-21,28
Glentoran,4247,7,6,6,10,24,32,-8,24
Dungannon,4247,8,2,4,16,14,47,-33,10
Crusaders,4248,1,17,6,3,65,30,35,57
Coleraine,4248,2,14,10,2,43,24,19,52
Glenavon,4248,3,10,9,7,54,43,11,39
Linfield,4248,4,10,5,11,37,40,-3,35
Cliftonville,4248,5,10,4,12,36,31,5,34
Ballymena,4248,6,7,4,15,25,51,-26,25
Glentoran,4248,7,6,6,10,24,32,-8,24
Dungannon,4248,8,2,4,16,14,47,-33,10
Crusaders,4249,1,17,6,3,66,31,35,57
Coleraine,4249,2,14,10,2,43,26,17,52
Glenavon,4249,3,10,9,7,56,43,13,39
Linfield,4249,4,11,5,10,38,36,2,38
Cliftonville,4249,5,9,4,13,32,32,0,31
Ballymena,4249,6,7,4,15,26,52,-26,25
Glentoran,4249,7,6,6,10,24,32,-8,24
Dungannon,4249,8,2,4,16,14,47,-33,10
Crusaders,4250,1,16,7,3,62,31,31,55
Coleraine,4250,2,15,10,1,45,22,23,55
Glenavon,4250,3,9,9,8,52,45,7,36
Linfield,4250,4,10,6,10,38,37,1,36
Cliftonville,4250,5,9,5,12,33,32,1,32
Ballymena,4250,6,7,5,14,26,48,-22,26
Glentoran,4250,7,6,6,10,24,32,-8,24
Dungannon,4250,8,2,4,16,14,47,-33,10
Crusaders,4251,1,17,6,3,66,31,35,57
Coleraine,4251,2,15,10,1,44,22,22,55
Linfield,4251,3,11,5,10,39,36,3,38
Glenavon,4251,4,9,9,8,52,44,8,36
Cliftonville,4251,5,9,4,13,32,33,-1,31
Ballymena,4251,6,7,4,15,26,52,-26,25
Glentoran,4251,7,6,6,10,24,32,-8,24
Dungannon,4251,8,2,4,16,14,47,-33,10
Crusaders,4252,1,16,6,4,62,33,29,54
Coleraine,4252,2,14,11,1,45,24,21,53
Glenavon,4252,3,9,10,7,54,45,9,37
Linfield,4252,4,10,5,11,38,38,0,35
Cliftonville,4252,5,10,4,12,34,32,2,34
Ballymena,4252,6,8,4,14,28,48,-20,28
Glentoran,4252,7,6,6,10,24,32,-8,24
Dungannon,4252,8,2,4,16,14,47,-33,10
Crusaders,4253,1,17,6,3,63,31,32,57
Coleraine,4253,2,14,10,2,43,24,19,52
Glenavon,4253,3,10,9,7,54,43,11,39
Linfield,4253,4,10,6,10,39,38,1,36
Cliftonville,4253,5,9,5,12,34,33,1,32
Ballymena,4253,6,7,4,15,26,49,-23,25
Glentoran,4253,7,6,6,10,24,32,-8,24
Dungannon,4253,8,2,4,16,14,47,-33,10
Crusaders,4254,1,16,7,3,61,30,31,55
Coleraine,4254,2,14,10,2,43,23,20,52
Glenavon,4254,3,10,9,7,53,43,10,39
Linfield,4254,4,10,5,11,38,38,0,35
Cliftonville,4254,5,10,4,12,34,32,2,34
Ballymena,4254,6,7,5,14,25,47,-22,26
Glentoran,4254,7,6,6,10,24,32,-8,24
Dungannon,4254,8,2,4,16,14,47,-33,10
Crusaders,4255,1,17,6,3,63,30,33,57
Coleraine,4255,2,14,11,1,45,24,21,53
Glenavon,4255,3,9,10,7,54,45,9,37
Linfield,4255,4,10,6,10,39,38,1,36
Cliftonville,4255,5,9,5,12,34,33,1,32
Ballymena,4255,6,7,4,15,25,49,-24,25
Glentoran,4255,7,6,6,10,24,32,-8,24
Dungannon,4255,8,2,4,16,14,47,-33,10
Crusaders,4256,1,16,7,3,63,32,31,55
Coleraine,4256,2,14,10,2,44,24,20,52
Glenavon,4256,3,10,9,7,54,44,10,39
Linfield,4256,4,10,5,11,38,38,0,35
Cliftonville,4256,5,10,4,12,34,32,2,34
Ballymena,4256,6,7,5,14,27,49,-22,26
Glentoran,4256,7,6,6,10,24,32,-8,24
Dungannon,4256,8,2,4,16,14,47,-33,10
Crusaders,4257,1,17,6,3,63,31,32,57
Coleraine,4257,2,14,11,1,45,24,21,53
Glenavon,4257,3,9,10,7,54,45,9,37
Linfield,4257,4,10,5,11,38,38,0,35
Cliftonville,4257,5,10,4,12,34,32,2,34
Ballymena,4257,6,7,4,15,26,49,-23,25
Glentoran,4257,7,6,6,10,24,32,-8,24
Dungannon,4257,8,2,4,16,14,47,-33,10
Crusaders,4258,1,17,6,3,62,30,32,57
Coleraine,4258,2,14,10,2,44,24,20,52
Glenavon,4258,3,10,9,7,54,44,10,39
Linfield,4258,4,10,5,11,37,37,0,35
Cliftonville,4258,5,10,4,12,33,31,2,34
Ballymena,4258,6,7,4,15,25,48,-23,25
Glentoran,4258,7,6,6,10,24,32,-8,24
Dungannon,4258,8,2,4,16,14,47,-33,10
Crusaders,4259,1,17,6,3,63,30,33,57
Coleraine,4259,2,14,11,1,44,23,21,53
Glenavon,4259,3,9,10,7,53,44,9,37
Linfield,4259,4,10,6,10,38,37,1,36
Cliftonville,4259,5,9,5,12,33,32,1,32
Ballymena,4259,6,7,4,15,25,49,-24,25
Glentoran,4259,7,6,6,10,24,32,-8,24
Dungannon,4259,8,2,4,16,14,47,-33,10
Crusaders,4260,1,17,6,3,63,30,33,57
Coleraine,4260,2,15,10,1,45,23,22,55
Linfield,4260,3,11,5,10,38,36,2,38
Glenavon,4260,4,9,9,8,53,45,8,36
Cliftonville,4260,5,9,4,13,32,32,0,31
Ballymena,4260,6,7,4,15,25,49,-24,25
Glentoran,4260,7,6,6,10,24,32,-8,24
Dungannon,4260,8,2,4,16,14,47,-33,10
Crusaders,4261,1,16,6,4,61,32,29,54
Coleraine,4261,2,14,10,2,43,24,19,52
Glenavon,4261,3,10,9,7,54,43,11,39
Linfield,4261,4,10,5,11,39,39,0,35
Cliftonville,4261,5,10,4,12,35,33,2,34
Ballymena,4261,6,8,4,14,27,47,-20,28
Glentoran,4261,7,6,6,10,24,32,-8,24
Dungannon,4261,8,2,4,16,14,47,-33,10
Crusaders,4262,1,16,6,4,62,32,30,54
Coleraine,4262,2,14,11,1,45,24,21,53
Linfield,4262,3,11,5,10,39,36,3,38
Glenavon,4262,4,9,10,7,54,45,9,37
Cliftonville,4262,5,9,4,13,32,33,-1,31
Ballymena,4262,6,8,4,14,27,48,-21,28
Glentoran,4262,7,6,6,10,24,32,-8,24
Dungannon,4262,8,2,4,16,14,47,-33,10
Crusaders,4263,1,17,6,3,65,30,35,57
Coleraine,4263,2,14,10,2,43,25,18,52
Glenavon,4263,3,10,9,7,55,43,12,39
Linfield,4263,4,11,5,10,40,37,3,38
Cliftonville,4263,5,9,4,13,33,34,-1,31
Ballymena,4263,6,7,4,15,25,51,-26,25
Glentoran,4263,7,6,6,10,24,32,-8,24
Dungannon,4263,8,2,4,16,14,47,-33,10
Crusaders,4264,1,16,7,3,62,31,31,55
Coleraine,4264,2,15,10,1,45,22,23,55
Glenavon,4264,3,9,9,8,52,45,7,36
Linfield,4264,4,10,6,10,39,38,1,36
Cliftonville,4264,5,9,5,12,34,33,1,32
Ballymena,4264,6,7,5,14,26,48,-22,26
Glentoran,4264,7,6,6,10,24,32,-8,24
Dungannon,4264,8,2,4,16,14,47,-33,10
Crusaders,4265,1,17,6,3,63,30,33,57
Coleraine,4265,2,14,10,2,43,26,17,52
Glenavon,4265,3,10,9,7,56,43,13,39
Linfield,4265,4,10,6,10,37,36,1,36
Cliftonville,4265,5,9,5,12,32,31,1,32
Ballymena,4265,6,7,4,15,25,49,-24,25
Glentoran,4265,7,6,6,10,24,32,-8,24
Dungannon,4265,8,2,4,16,14,47,-33,10
Crusaders,4266,1,16,7,3,64,33,31,55
Coleraine,4266,2,14,11,1,44,23,21,53
Glenavon,4266,3,9,10,7,53,44,9,37
Linfield,4266,4,10,5,11,38,38,0,35
Cliftonville,4266,5,10,4,12,34,32,2,34
Ballymena,4266,6,7,5,14,28,50,-22,26
Glentoran,4266,7,6,6,10,24,32,-8,24
Dungannon,4266,8,2,4,16,14,47,-33,10
Crusaders,4267,1,17,6,3,64,30,34,57
Coleraine,4267,2,15,10,1,46,22,24,55
Linfield,4267,3,11,5,10,40,36,4,38
Glenavon,4267,4,9,9,8,52,46,6,36
Cliftonville,4267,5,9,4,13,32,34,-2,31
Ballymena,4267,6,7,4,15,25,50,-25,25
Glentoran,4267,7,6,6,10,24,32,-8,24
Dungannon,4267,8,2,4,16,14,47,-33,10
Crusaders,4268,1,17,6,3,64,30,34,57
Coleraine,4268,2,15,10,1,44,22,22,55
Linfield,4268,3,11,5,10,38,36,2,38
Glenavon,4268,4,9,9,8,52,44,8,36
Cliftonville,4268,5,9,4,13,32,32,0,31
Ballymena,4268,6,7,4,15,25,50,-25,25
Glentoran,4268,7,6,6,10,24,32,-8,24
Dungannon,4268,8,2,4,16,14,47,-33,10
Crusaders,4269,1,17,6,3,66,30,36,57
Coleraine,4269,2,15,10,1,45,23,22,55
Linfield,4269,3,11,5,10,40,37,3,38
Glenavon,4269,4,9,9,8,53,45,8,36
Cliftonville,4269,5,9,4,13,33,34,-1,31
Ballymena,4269,6,7,4,15,25,52,-27,25
Glentoran,4269,7,6,6,10,24,32,-8,24
Dungannon,4269,8,2,4,16,14,47,-33,10
Crusaders,4270,1,17,6,3,64,30,34,57
Coleraine,4270,2,14,10,2,44,24,20,52
Glenavon,4270,3,10,9,7,54,44,10,39
Linfield,4270,4,10,6,10,38,37,1,36
Cliftonville,4270,5,9,5,12,33,32,1,32
Ballymena,4270,6,7,4,15,25,50,-25,25
Glentoran,4270,7,6,6,10,24,32,-8,24
Dungannon,4270,8,2,4,16,14,47,-33,10
Crusaders,4271,1,17,6,3,64,31,33,57
Coleraine,4271,2,15,10,1,45,23,22,55
Glenavon,4271,3,9,9,8,53,45,8,36
Linfield,4271,4,10,5,11,38,38,0,35
Cliftonville,4271,5,10,4,12,34,32,2,34
Ballymena,4271,6,7,4,15,26,50,-24,25
Glentoran,4271,7,6,6,10,24,32,-8,24
Dungannon,4271,8,2,4,16,14,47,-33,10
Crusaders,4272,1,17,6,3,62,30,32,57
Coleraine,4272,2,15,10,1,47,22,25,55
Glenavon,4272,3,9,9,8,52,47,5,36
Linfield,4272,4,10,5,11,37,40,-3,35
Cliftonville,4272,5,10,4,12,36,31,5,34
Ballymena,4272,6,7,4,15,25,48,-23,25
Glentoran,4272,7,6,6,10,24,32,-8,24
Dungannon,4272,8,2,4,16,14,47,-33,10
Crusaders,4273,1,17,6,3,65,33,32,57
Coleraine,4273,2,15,10,1,45,23,22,55
Glenavon,4273,3,9,9,8,53,45,8,36
Linfield,4273,4,10,5,11,37,40,-3,35
Cliftonville,4273,5,10,4,12,36,31,5,34
Ballymena,4273,6,7,4,15,28,51,-23,25
Glentoran,4273,7,6,6,10,24,32,-8,24
Dungannon,4273,8,2,4,16,14,47,-33,10
Crusaders,4274,1,17,6,3,67,32,35,57
Coleraine,4274,2,14,11,1,45,24,21,53
Linfield,4274,3,11,5,10,40,36,4,38
Glenavon,4274,4,9,10,7,54,45,9,37
Cliftonville,4274,5,9,4,13,32,34,-2,31
Ballymena,4274,6,7,4,15,27,53,-26,25
Glentoran,4274,7,6,6,10,24,32,-8,24
Dungannon,4274,8,2,4,16,14,47,-33,10
Crusaders,4275,1,16,7,3,62,31,31,55
Coleraine,4275,2,15,10,1,45,23,22,55
Linfield,4275,3,11,5,10,39,37,2,38
Glenavon,4275,4,9,9,8,53,45,8,36
Cliftonville,4275,5,9,4,13,33,33,0,31
Ballymena,4275,6,7,5,14,26,48,-22,26
Glentoran,4275,7,6,6,10,24,32,-8,24
Dungannon,4275,8,2,4,16,14,47,-33,10
Crusaders,4276,1,16,6,4,63,33,30,54
Coleraine,4276,2,14,10,2,44,25,19,52
Glenavon,4276,3,10,9,7,55,44,11,39
Linfield,4276,4,10,5,11,37,38,-1,35
Cliftonville,4276,5,10,4,12,34,31,3,34
Ballymena,4276,6,8,4,14,28,49,-21,28
Glentoran,4276,7,6,6,10,24,32,-8,24
Dungannon,4276,8,2,4,16,14,47,-33,10
Coleraine,4277,1,15,10,1,46,24,22,55
Crusaders,4277,2,16,6,4,61,33,28,54
Linfield,4277,3,11,5,10,38,36,2,38
Glenavon,4277,4,9,9,8,54,46,8,36
Cliftonville,4277,5,9,4,13,32,32,0,31
Ballymena,4277,6,8,4,14,28,47,-19,28
Glentoran,4277,7,6,6,10,24,32,-8,24
Dungannon,4277,8,2,4,16,14,47,-33,10
Crusaders,4278,1,17,6,3,64,30,34,57
Coleraine,4278,2,14,10,2,44,24,20,52
Glenavon,4278,3,10,9,7,54,44,10,39
Linfield,4278,4,11,5,10,38,36,2,38
Cliftonville,4278,5,9,4,13,32,32,0,31
Ballymena,4278,6,7,4,15,25,50,-25,25
Glentoran,4278,7,6,6,10,24,32,-8,24
Dungannon,4278,8,2,4,16,14,47,-33,10
Crusaders,4279,1,17,6,3,65,31,34,57
Coleraine,4279,2,14,11,1,44,23,21,53
Glenavon,4279,3,9,10,7,53,44,9,37
Linfield,4279,4,10,6,10,38,37,1,36
Cliftonville,4279,5,9,5,12,33,32,1,32
Ballymena,4279,6,7,4,15,26,51,-25,25
Glentoran,4279,7,6,6,10,24,32,-8,24
Dungannon,4279,8,2,4,16,14,47,-33,10
Crusaders,4280,1,16,6,4,64,35,29,54
Coleraine,4280,2,14,11,1,44,23,21,53
Glenavon,4280,3,9,10,7,53,44,9,37
Linfield,4280,4,10,6,10,38,37,1,36
Cliftonville,4280,5,9,5,12,33,32,1,32
Ballymena,4280,6,8,4,14,30,50,-20,28
Glentoran,4280,7,6,6,10,24,32,-8,24
Dungannon,4280,8,2,4,16,14,47,-33,10
Crusaders,4281,1,17,6,3,65,31,34,57
Coleraine,4281,2,15,10,1,46,22,24,55
Linfield,4281,3,11,5,10,39,37,2,38
Glenavon,4281,4,9,9,8,52,46,6,36
Cliftonville,4281,5,9,4,13,33,33,0,31
Ballymena,4281,6,7,4,15,26,51,-25,25
Glentoran,4281,7,6,6,10,24,32,-8,24
Dungannon,4281,8,2,4,16,14,47,-33,10
Crusaders,4282,1,16,6,4,62,32,30,54
Coleraine,4282,2,14,10,2,44,24,20,52
Glenavon,4282,3,10,9,7,54,44,10,39
Linfield,4282,4,11,5,10,38,36,2,38
Cliftonville,4282,5,9,4,13,32,32,0,31
Ballymena,4282,6,8,4,14,27,48,-21,28
Glentoran,4282,7,6,6,10,24,32,-8,24
Dungannon,4282,8,2,4,16,14,47,-33,10
Crusaders,4283,1,16,6,4,61,31,30,54
Coleraine,4283,2,14,10,2,43,25,18,52
Glenavon,4283,3,10,9,7,55,43,12,39
Linfield,4283,4,11,5,10,38,36,2,38
Cliftonville,4283,5,9,4,13,32,32,0,31
Ballymena,4283,6,8,4,14,26,47,-21,28
Glentoran,4283,7,6,6,10,24,32,-8,24
Dungannon,4283,8,2,4,16,14,47,-33,10
Crusaders,4284,1,17,6,3,64,31,33,57
Coleraine,4284,2,15,10,1,46,23,23,55
Linfield,4284,3,11,5,10,38,36,2,38
Glenavon,4284,4,9,9,8,53,46,7,36
Cliftonville,4284,5,9,4,13,32,32,0,31
Ballymena,4284,6,7,4,15,26,50,-24,25
Glentoran,4284,7,6,6,10,24,32,-8,24
Dungannon,4284,8,2,4,16,14,47,-33,10
Crusaders,4285,1,17,6,3,64,32,32,57
Coleraine,4285,2,14,10,2,44,24,20,52
Glenavon,4285,3,10,9,7,54,44,10,39
Linfield,4285,4,10,5,11,37,37,0,35
Cliftonville,4285,5,10,4,12,33,31,2,34
Ballymena,4285,6,7,4,15,27,50,-23,25
Glentoran,4285,7,6,6,10,24,32,-8,24
Dungannon,4285,8,2,4,16,14,47,-33,10
Crusaders,4286,1,17,6,3,64,30,34,57
Coleraine,4286,2,14,10,2,43,24,19,52
Glenavon,4286,3,10,9,7,54,43,11,39
Linfield,4286,4,10,5,11,37,39,-2,35
Cliftonville,4286,5,10,4,12,35,31,4,34
Ballymena,4286,6,7,4,15,25,50,-25,25
Glentoran,4286,7,6,6,10,24,32,-8,24
Dungannon,4286,8,2,4,16,14,47,-33,10
Crusaders,4287,1,17,6,3,64,30,34,57
Coleraine,4287,2,15,10,1,44,22,22,55
Linfield,4287,3,11,5,10,38,36,2,38
Glenavon,4287,4,9,9,8,52,44,8,36
Cliftonville,4287,5,9,4,13,32,32,0,31
Ballymena,4287,6,7,4,15,25,50,-25,25
Glentoran,4287,7,6,6,10,24,32,-8,24
Dungannon,4287,8,2,4,16,14,47,-33,10
Crusaders,4288,1,17,6,3,63,30,33,57
Coleraine,4288,2,14,10,2,44,26,18,52
Glenavon,4288,3,10,9,7,56,44,12,39
Linfield,4288,4,11,5,10,40,37,3,38
Cliftonville,4288,5,9,4,13,33,34,-1,31
Ballymena,4288,6,7,4,15,25,49,-24,25
Glentoran,4288,7,6,6,10,24,32,-8,24
Dungannon,4288,8,2,4,16,14,47,-33,10
Crusaders,4289,1,17,6,3,65,33,32,57
Coleraine,4289,2,14,10,2,43,25,18,52
Glenavon,4289,3,10,9,7,55,43,12,39
Linfield,4289,4,10,5,11,37,37,0,35
Cliftonville,4289,5,10,4,12,33,31,2,34
Ballymena,4289,6,7,4,15,28,51,-23,25
Glentoran,4289,7,6,6,10,24,32,-8,24
Dungannon,4289,8,2,4,16,14,47,-33,10
Crusaders,4290,1,17,6,3,63,31,32,57
Coleraine,4290,2,14,11,1,44,23,21,53
Linfield,4290,3,11,5,10,39,36,3,38
Glenavon,4290,4,9,10,7,53,44,9,37
Cliftonville,4290,5,9,4,13,32,33,-1,31
Ballymena,4290,6,7,4,15,26,49,-23,25
Glentoran,4290,7,6,6,10,24,32,-8,24
Dungannon,4290,8,2,4,16,14,47,-33,10
Coleraine,4291,1,15,10,1,48,24,24,55
Crusaders,4291,2,16,6,4,62,33,29,54
Linfield,4291,3,11,5,10,41,36,5,38
Glenavon,4291,4,9,9,8,54,48,6,36
Cliftonville,4291,5,9,4,13,32,35,-3,31
Ballymena,4291,6,8,4,14,28,48,-20,28
Glentoran,4291,7,6,6,10,24,32,-8,24
Dungannon,4291,8,2,4,16,14,47,-33,10
Crusaders,4292,1,17,6,3,64,32,32,57
Coleraine,4292,2,15,10,1,45,23,22,55
Glenavon,4292,3,9,9,8,53,45,8,36
Linfield,4292,4,10,5,11,38,38,0,35
Cliftonville,4292,5,10,4,12,34,32,2,34
Ballymena,4292,6,7,4,15,27,50,-23,25
Glentoran,4292,7,6,6,10,24,32,-8,24
Dungannon,4292,8,2,4,16,14,47,-33,10
Crusaders,4293,1,17,6,3,63,30,33,57
Coleraine,4293,2,15,10,1,46,24,22,55
Linfield,4293,3,11,5,10,38,36,2,38
Glenavon,4293,4,9,9,8,54,46,8,36
Cliftonville,4293,5,9,4,13,32,32,0,31
Ballymena,4293,6,7,4,15,25,49,-24,25
Glentoran,4293,7,6,6,10,24,32,-8,24
Dungannon,4293,8,2,4,16,14,47,-33,10
Crusaders,4294,1,16,7,3,61,30,31,55
Coleraine,4294,2,14,10,2,43,24,19,52
Glenavon,4294,3,10,9,7,54,43,11,39
Linfield,4294,4,11,5,10,40,38,2,38
Cliftonville,4294,5,9,4,13,34,34,0,31
Ballymena,4294,6,7,5,14,25,47,-22,26
Glentoran,4294,7,6,6,10,24,32,-8,24
Dungannon,4294,8,2,4,16,14,47,-33,10
Crusaders,4295,1,17,6,3,64,31,33,57
Coleraine,4295,2,14,11,1,44,23,21,53
Glenavon,4295,3,9,10,7,53,44,9,37
Linfield,4295,4,10,5,11,39,39,0,35
Cliftonville,4295,5,10,4,12,35,33,2,34
Ballymena,4295,6,7,4,15,26,50,-24,25
Glentoran,4295,7,6,6,10,24,32,-8,24
Dungannon,4295,8,2,4,16,14,47,-33,10
Crusaders,4296,1,17,6,3,63,31,32,57
Coleraine,4296,2,14,10,2,43,25,18,52
Glenavon,4296,3,10,9,7,55,43,12,39
Linfield,4296,4,10,6,10,38,37,1,36
Cliftonville,4296,5,9,5,12,33,32,1,32
Ballymena,4296,6,7,4,15,26,49,-23,25
Glentoran,4296,7,6,6,10,24,32,-8,24
Dungannon,4296,8,2,4,16,14,47,-33,10
Crusaders,4297,1,16,6,4,62,34,28,54
Coleraine,4297,2,14,10,2,45,26,19,52
Glenavon,4297,3,10,9,7,56,45,11,39
Linfield,4297,4,10,6,10,40,39,1,36
Cliftonville,4297,5,9,5,12,35,34,1,32
Ballymena,4297,6,8,4,14,29,48,-19,28
Glentoran,4297,7,6,6,10,24,32,-8,24
Dungannon,4297,8,2,4,16,14,47,-33,10
Crusaders,4298,1,17,6,3,63,31,32,57
Coleraine,4298,2,15,10,1,48,24,24,55
Linfield,4298,3,11,5,10,40,37,3,38
Glenavon,4298,4,9,9,8,54,48,6,36
Cliftonville,4298,5,9,4,13,33,34,-1,31
Ballymena,4298,6,7,4,15,26,49,-23,25
Glentoran,4298,7,6,6,10,24,32,-8,24
Dungannon,4298,8,2,4,16,14,47,-33,10
Crusaders,4299,1,16,7,3,62,31,31,55
Coleraine,4299,2,14,11,1,44,23,21,53
Glenavon,4299,3,9,10,7,53,44,9,37
Linfield,4299,4,10,5,11,37,38,-1,35
Cliftonville,4299,5,10,4,12,34,31,3,34
Ballymena,4299,6,7,5,14,26,48,-22,26
Glentoran,4299,7,6,6,10,24,32,-8,24
Dungannon,4299,8,2,4,16,14,47,-33,10
Crusaders,4300,1,17,6,3,63,31,32,57
Coleraine,4300,2,14,10,2,45,26,19,52
Glenavon,4300,3,10,9,7,56,45,11,39
Linfield,4300,4,11,5,10,38,36,2,38
Cliftonville,4300,5,9,4,13,32,32,0,31
Ballymena,4300,6,7,4,15,26,49,-23,25
Glentoran,4300,7,6,6,10,24,32,-8,24
Dungannon,4300,8,2,4,16,14,47,-33,10
Crusaders,4301,1,17,6,3,63,30,33,57
Coleraine,4301,2,14,10,2,43,24,19,52
Glenavon,4301,3,10,9,7,54,43,11,39
Linfield,4301,4,10,5,11,37,37,0,35
Cliftonville,4301,5,10,4,12,33,31,2,34
Ballymena,4301,6,7,4,15,25,49,-24,25
Glentoran,4301,7,6,6,10,24,32,-8,24
Dungannon,4301,8,2,4,16,14,47,-33,10
Coleraine,4302,1,15,10,1,45,22,23,55
Crusaders,4302,2,16,6,4,62,32,30,54
Linfield,4302,3,11,5,10,39,37,2,38
Glenavon,4302,4,9,9,8,52,45,7,36
Cliftonville,4302,5,9,4,13,33,33,0,31
Ballymena,4302,6,8,4,14,27,48,-21,28
Glentoran,4302,7,6,6,10,24,32,-8,24
Dungannon,4302,8,2,4,16,14,47,-33,10
Coleraine,4303,1,15,10,1,45,22,23,55
Crusaders,4303,2,16,6,4,62,32,30,54
Glenavon,4303,3,9,9,8,52,45,7,36
Linfield,4303,4,10,5,11,37,38,-1,35
Cliftonville,4303,5,10,4,12,34,31,3,34
Ballymena,4303,6,8,4,14,27,48,-21,28
Glentoran,4303,7,6,6,10,24,32,-8,24
Dungannon,4303,8,2,4,16,14,47,-33,10
Crusaders,4304,1,17,6,3,64,30,34,57
Coleraine,4304,2,15,10,1,46,23,23,55
Linfield,4304,3,11,5,10,39,37,2,38
Glenavon,4304,4,9,9,8,53,46,7,36
Cliftonville,4304,5,9,4,13,33,33,0,31
Ballymena,4304,6,7,4,15,25,50,-25,25
Glentoran,4304,7,6,6,10,24,32,-8,24
Dungannon,4304,8,2,4,16,14,47,-33,10
Crusaders,4305,1,16,7,3,63,32,31,55
Coleraine,4305,2,14,10,2,44,24,20,52
Glenavon,4305,3,10,9,7,54,44,10,39
Linfield,4305,4,11,5,10,40,36,4,38
Cliftonville,4305,5,9,4,13,32,34,-2,31
Ballymena,4305,6,7,5,14,27,49,-22,26
Glentoran,4305,7,6,6,10,24,32,-8,24
Dungannon,4305,8,2,4,16,14,47,-33,10
Coleraine,4306,1,15,10,1,45,22,23,55
Crusaders,4306,2,16,6,4,63,33,30,54
Linfield,4306,3,11,5,10,38,36,2,38
Glenavon,4306,4,9,9,8,52,45,7,36
Cliftonville,4306,5,9,4,13,32,32,0,31
Ballymena,4306,6,8,4,14,28,49,-21,28
Glentoran,4306,7,6,6,10,24,32,-8,24
Dungannon,4306,8,2,4,16,14,47,-33,10
Crusaders,4307,1,17,6,3,64,32,32,57
Coleraine,4307,2,14,10,2,43,24,19,52
Glenavon,4307,3,10,9,7,54,43,11,39
Linfield,4307,4,10,6,10,37,36,1,36
Cliftonville,4307,5,9,5,12,32,31,1,32
Ballymena,4307,6,7,4,15,27,50,-23,25
Glentoran,4307,7,6,6,10,24,32,-8,24
Dungannon,4307,8,2,4,16,14,47,-33,10
Coleraine,4308,1,15,10,1,47,23,24,55
Crusaders,4308,2,16,6,4,62,32,30,54
Glenavon,4308,3,9,9,8,53,47,6,36
Linfield,4308,4,10,6,10,39,38,1,36
Cliftonville,4308,5,9,5,12,34,33,1,32
Ballymena,4308,6,8,4,14,27,48,-21,28
Glentoran,4308,7,6,6,10,24,32,-8,24
Dungannon,4308,8,2,4,16,14,47,-33,10
Coleraine,4309,1,15,10,1,46,24,22,55
Crusaders,4309,2,16,6,4,61,34,27,54
Linfield,4309,3,11,5,10,39,36,3,38
Glenavon,4309,4,9,9,8,54,46,8,36
Cliftonville,4309,5,9,4,13,32,33,-1,31
Ballymena,4309,6,8,4,14,29,47,-18,28
Glentoran,4309,7,6,6,10,24,32,-8,24
Dungannon,4309,8,2,4,16,14,47,-33,10
Crusaders,4310,1,17,6,3,63,31,32,57
Coleraine,4310,2,14,11,1,44,23,21,53
Glenavon,4310,3,9,10,7,53,44,9,37
Linfield,4310,4,10,6,10,39,38,1,36
Cliftonville,4310,5,9,5,12,34,33,1,32
Ballymena,4310,6,7,4,15,26,49,-23,25
Glentoran,4310,7,6,6,10,24,32,-8,24
Dungannon,4310,8,2,4,16,14,47,-33,10
Crusaders,4311,1,16,6,4,62,32,30,54
Coleraine,4311,2,14,11,1,46,25,21,53
Linfield,4311,3,11,5,10,40,37,3,38
Glenavon,4311,4,9,10,7,55,46,9,37
Cliftonville,4311,5,9,4,13,33,34,-1,31
Ballymena,4311,6,8,4,14,27,48,-21,28
Glentoran,4311,7,6,6,10,24,32,-8,24
Dungannon,4311,8,2,4,16,14,47,-33,10
Crusaders,4312,1,17,6,3,63,30,33,57
Coleraine,4312,2,14,11,1,45,24,21,53
Linfield,4312,3,11,5,10,40,37,3,38
Glenavon,4312,4,9,10,7,54,45,9,37
Cliftonville,4312,5,9,4,13,33,34,-1,31
Ballymena,4312,6,7,4,15,25,49,-24,25
Glentoran,4312,7,6,6,10,24,32,-8,24
Dungannon,4312,8,2,4,16,14,47,-33,10
Crusaders,4313,1,16,6,4,61,31,30,54
Coleraine,4313,2,14,10,2,43,25,18,52
Glenavon,4313,3,10,9,7,55,43,12,39
Linfield,4313,4,10,5,11,37,37,0,35
Cliftonville,4313,5,10,4,12,33,31,2,34
Ballymena,4313,6,8,4,14,26,47,-21,28
Glentoran,4313,7,6,6,10,24,32,-8,24
Dungannon,4313,8,2,4,16,14,47,-33,10
Crusaders,4314,1,17,6,3,65,32,33,57
Coleraine,4314,2,14,10,2,43,24,19,52
Glenavon,4314,3,10,9,7,54,43,11,39
Linfield,4314,4,10,6,10,37,36,1,36
Cliftonville,4314,5,9,5,12,32,31,1,32
Ballymena,4314,6,7,4,15,27,51,-24,25
Glentoran,4314,7,6,6,10,24,32,-8,24
Dungannon,4314,8,2,4,16,14,47,-33,10
Crusaders,4315,1,16,7,3,62,31,31,55
Coleraine,4315,2,15,10,1,45,22,23,55
Glenavon,4315,3,9,9,8,52,45,7,36
Linfield,4315,4,10,5,11,37,38,-1,35
Cliftonville,4315,5,10,4,12,34,31,3,34
Ballymena,4315,6,7,5,14,26,48,-22,26
Glentoran,4315,7,6,6,10,24,32,-8,24
Dungannon,4315,8,2,4,16,14,47,-33,10
Crusaders,4316,1,17,6,3,63,31,32,57
Coleraine,4316,2,14,10,2,43,25,18,52
Glenavon,4316,3,10,9,7,55,43,12,39
Linfield,4316,4,10,6,10,40,39,1,36
Cliftonville,4316,5,9,5,12,35,34,1,32
Ballymena,4316,6,7,4,15,26,49,-23,25
Glentoran,4316,7,6,6,10,24,32,-8,24
Dungannon,4316,8,2,4,16,14,47,-33,10
Crusaders,4317,1,16,6,4,63,33,30,54
Coleraine,4317,2,14,10,2,43,24,19,52
Glenavon,4317,3,10,9,7,54,43,11,39
Linfield,4317,4,11,5,10,39,36,3,38
Cliftonville,4317,5,9,4,13,32,33,-1,31
Ballymena,4317,6,8,4,14,28,49,-21,28
Glentoran,4317,7,6,6,10,24,32,-8,24
Dungannon,4317,8,2,4,16,14,47,-33,10
Crusaders,4318,1,16,7,3,63,32,31,55
Coleraine,4318,2,14,11,1,45,24,21,53
Glenavon,4318,3,9,10,7,54,45,9,37
Linfield,4318,4,10,6,10,40,39,1,36
Cliftonville,4318,5,9,5,12,35,34,1,32
Ballymena,4318,6,7,5,14,27,49,-22,26
Glentoran,4318,7,6,6,10,24,32,-8,24
Dungannon,4318,8,2,4,16,14,47,-33,10
Crusaders,4319,1,17,6,3,64,32,32,57
Coleraine,4319,2,14,11,1,45,24,21,53
Glenavon,4319,3,9,10,7,54,45,9,37
Linfield,4319,4,10,5,11,38,38,0,35
Cliftonville,4319,5,10,4,12,34,32,2,34
Ballymena,4319,6,7,4,15,27,50,-23,25
Glentoran,4319,7,6,6,10,24,32,-8,24
Dungannon,4319,8,2,4,16,14,47,-33,10
Crusaders,4320,1,17,6,3,65,30,35,57
Coleraine,4320,2,15,10,1,46,24,22,55
Linfield,4320,3,11,5,10,39,36,3,38
Glenavon,4320,4,9,9,8,54,46,8,36
Cliftonville,4320,5,9,4,13,32,33,-1,31
Ballymena,4320,6,7,4,15,25,51,-26,25
Glentoran,4320,7,6,6,10,24,32,-8,24
Dungannon,4320,8,2,4,16,14,47,-33,10
Crusaders,4321,1,17,6,3,63,30,33,57
Coleraine,4321,2,15,10,1,48,26,22,55
Glenavon,4321,3,9,9,8,56,48,8,36
Linfield,4321,4,10,6,10,37,36,1,36
Cliftonville,4321,5,9,5,12,32,31,1,32
Ballymena,4321,6,7,4,15,25,49,-24,25
Glentoran,4321,7,6,6,10,24,32,-8,24
Dungannon,4321,8,2,4,16,14,47,-33,10
Coleraine,4322,1,15,10,1,45,22,23,55
Crusaders,4322,2,16,6,4,61,32,29,54
Glenavon,4322,3,9,9,8,52,45,7,36
Linfield,4322,4,10,5,11,37,38,-1,35
Cliftonville,4322,5,10,4,12,34,31,3,34
Ballymena,4322,6,8,4,14,27,47,-20,28
Glentoran,4322,7,6,6,10,24,32,-8,24
Dungannon,4322,8,2,4,16,14,47,-33,10
Crusaders,4323,1,17,6,3,63,31,32,57
Coleraine,4323,2,14,11,1,43,22,21,53
Glenavon,4323,3,9,10,7,52,43,9,37
Linfield,4323,4,10,6,10,40,39,1,36
Cliftonville,4323,5,9,5,12,35,34,1,32
Ballymena,4323,6,7,4,15,26,49,-23,25
Glentoran,4323,7,6,6,10,24,32,-8,24
Dungannon,4323,8,2,4,16,14,47,-33,10
Crusaders,4324,1,17,6,3,62,30,32,57
Coleraine,4324,2,14,10,2,44,27,17,52
Glenavon,4324,3,10,9,7,57,44,13,39
Linfield,4324,4,10,5,11,37,37,0,35
Cliftonville,4324,5,10,4,12,33,31,2,34
Ballymena,4324,6,7,4,15,25,48,-23,25
Glentoran,4324,7,6,6,10,24,32,-8,24
Dungannon,4324,8,2,4,16,14,47,-33,10
Crusaders,4325,1,17,6,3,62,30,32,57
Coleraine,4325,2,15,10,1,45,23,22,55
Glenavon,4325,3,9,9,8,53,45,8,36
Linfield,4325,4,10,6,10,37,36,1,36
Cliftonville,4325,5,9,5,12,32,31,1,32
Ballymena,4325,6,7,4,15,25,48,-23,25
Glentoran,4325,7,6,6,10,24,32,-8,24
Dungannon,4325,8,2,4,16,14,47,-33,10
Crusaders,4326,1,17,6,3,67,31,36,57
Coleraine,4326,2,14,11,1,44,23,21,53
Linfield,4326,3,11,5,10,38,36,2,38
Glenavon,4326,4,9,10,7,53,44,9,37
Cliftonville,4326,5,9,4,13,32,32,0,31
Ballymena,4326,6,7,4,15,26,53,-27,25
Glentoran,4326,7,6,6,10,24,32,-8,24
Dungannon,4326,8,2,4,16,14,47,-33,10
Crusaders,4327,1,16,7,3,65,34,31,55
Coleraine,4327,2,14,10,2,43,23,20,52
Glenavon,4327,3,10,9,7,53,43,10,39
Linfield,4327,4,11,5,10,41,37,4,38
Cliftonville,4327,5,9,4,13,33,35,-2,31
Ballymena,4327,6,7,5,14,29,51,-22,26
Glentoran,4327,7,6,6,10,24,32,-8,24
Dungannon,4327,8,2,4,16,14,47,-33,10
Crusaders,4328,1,16,6,4,62,34,28,54
Coleraine,4328,2,14,10,2,43,23,20,52
Glenavon,4328,3,10,9,7,53,43,10,39
Linfield,4328,4,11,5,10,39,37,2,38
Cliftonville,4328,5,9,4,13,33,33,0,31
Ballymena,4328,6,8,4,14,29,48,-19,28
Glentoran,4328,7,6,6,10,24,32,-8,24
Dungannon,4328,8,2,4,16,14,47,-33,10
Crusaders,4329,1,17,6,3,65,31,34,57
Coleraine,4329,2,14,10,2,44,25,19,52
Glenavon,4329,3,10,9,7,55,44,11,39
Linfield,4329,4,10,6,10,39,38,1,36
Cliftonville,4329,5,9,5,12,34,33,1,32
Ballymena,4329,6,7,4,15,26,51,-25,25
Glentoran,4329,7,6,6,10,24,32,-8,24
Dungannon,4329,8,2,4,16,14,47,-33,10
Crusaders,4330,1,16,7,3,64,33,31,55
Coleraine,4330,2,14,11,1,45,24,21,53
Glenavon,4330,3,9,10,7,54,45,9,37
Linfield,4330,4,10,6,10,39,38,1,36
Cliftonville,4330,5,9,5,12,34,33,1,32
Ballymena,4330,6,7,5,14,28,50,-22,26
Glentoran,4330,7,6,6,10,24,32,-8,24
Dungannon,4330,8,2,4,16,14,47,-33,10
Crusaders,4331,1,16,7,3,62,31,31,55
Coleraine,4331,2,14,10,2,44,25,19,52
Glenavon,4331,3,10,9,7,55,44,11,39
Linfield,4331,4,11,5,10,40,36,4,38
Cliftonville,4331,5,9,4,13,32,34,-2,31
Ballymena,4331,6,7,5,14,26,48,-22,26
Glentoran,4331,7,6,6,10,24,32,-8,24
Dungannon,4331,8,2,4,16,14,47,-33,10
Crusaders,4332,1,16,7,3,62,31,31,55
Coleraine,4332,2,14,10,2,45,25,20,52
Glenavon,4332,3,10,9,7,55,45,10,39
Linfield,4332,4,11,5,10,41,39,2,38
Cliftonville,4332,5,9,4,13,35,35,0,31
Ballymena,4332,6,7,5,14,26,48,-22,26
Glentoran,4332,7,6,6,10,24,32,-8,24
Dungannon,4332,8,2,4,16,14,47,-33,10
Crusaders,4333,1,17,6,3,63,30,33,57
Coleraine,4333,2,14,11,1,45,24,21,53
Glenavon,4333,3,9,10,7,54,45,9,37
Linfield,4333,4,10,5,11,38,38,0,35
Cliftonville,4333,5,10,4,12,34,32,2,34
Ballymena,4333,6,7,4,15,25,49,-24,25
Glentoran,4333,7,6,6,10,24,32,-8,24
Dungannon,4333,8,2,4,16,14,47,-33,10
Crusaders,4334,1,17,6,3,64,30,34,57
Coleraine,4334,2,15,10,1,45,23,22,55
Glenavon,4334,3,9,9,8,53,45,8,36
Linfield,4334,4,10,5,11,37,37,0,35
Cliftonville,4334,5,10,4,12,33,31,2,34
Ballymena,4334,6,7,4,15,25,50,-25,25
Glentoran,4334,7,6,6,10,24,32,-8,24
Dungannon,4334,8,2,4,16,14,47,-33,10
Crusaders,4335,1,17,6,3,64,30,34,57
Coleraine,4335,2,14,11,1,43,22,21,53
Glenavon,4335,3,9,10,7,52,43,9,37
Linfield,4335,4,10,5,11,37,38,-1,35
Cliftonville,4335,5,10,4,12,34,31,3,34
Ballymena,4335,6,7,4,15,25,50,-25,25
Glentoran,4335,7,6,6,10,24,32,-8,24
Dungannon,4335,8,2,4,16,14,47,-33,10
Crusaders,4336,1,16,7,3,61,30,31,55
Coleraine,4336,2,14,10,2,43,23,20,52
Glenavon,4336,3,10,9,7,53,43,10,39
Linfield,4336,4,10,6,10,38,37,1,36
Cliftonville,4336,5,9,5,12,33,32,1,32
Ballymena,4336,6,7,5,14,25,47,-22,26
Glentoran,4336,7,6,6,10,24,32,-8,24
Dungannon,4336,8,2,4,16,14,47,-33,10
Crusaders,4337,1,17,6,3,63,31,32,57
Coleraine,4337,2,14,11,1,47,26,21,53
Glenavon,4337,3,9,10,7,56,47,9,37
Linfield,4337,4,10,5,11,37,37,0,35
Cliftonville,4337,5,10,4,12,33,31,2,34
Ballymena,4337,6,7,4,15,26,49,-23,25
Glentoran,4337,7,6,6,10,24,32,-8,24
Dungannon,4337,8,2,4,16,14,47,-33,10
Coleraine,4338,1,15,10,1,47,24,23,55
Crusaders,4338,2,16,6,4,62,32,30,54
Linfield,4338,3,11,5,10,42,36,6,38
Glenavon,4338,4,9,9,8,54,47,7,36
Cliftonville,4338,5,9,4,13,32,36,-4,31
Ballymena,4338,6,8,4,14,27,48,-21,28
Glentoran,4338,7,6,6,10,24,32,-8,24
Dungannon,4338,8,2,4,16,14,47,-33,10
Crusaders,4339,1,17,6,3,65,31,34,57
Coleraine,4339,2,14,10,2,44,25,19,52
Glenavon,4339,3,10,9,7,55,44,11,39
Linfield,4339,4,11,5,10,40,36,4,38
Cliftonville,4339,5,9,4,13,32,34,-2,31
Ballymena,4339,6,7,4,15,26,51,-25,25
Glentoran,4339,7,6,6,10,24,32,-8,24
Dungannon,4339,8,2,4,16,14,47,-33,10
Crusaders,4340,1,17,6,3,67,30,37,57
Coleraine,4340,2,15,10,1,45,23,22,55
Linfield,4340,3,11,5,10,39,36,3,38
Glenavon,4340,4,9,9,8,53,45,8,36
Cliftonville,4340,5,9,4,13,32,33,-1,31
Ballymena,4340,6,7,4,15,25,53,-28,25
Glentoran,4340,7,6,6,10,24,32,-8,24
Dungannon,4340,8,2,4,16,14,47,-33,10
Crusaders,4341,1,16,7,3,62,31,31,55
Coleraine,4341,2,15,10,1,45,23,22,55
Linfield,4341,3,11,5,10,39,37,2,38
Glenavon,4341,4,9,9,8,53,45,8,36
Cliftonville,4341,5,9,4,13,33,33,0,31
Ballymena,4341,6,7,5,14,26,48,-22,26
Glentoran,4341,7,6,6,10,24,32,-8,24
Dungannon,4341,8,2,4,16,14,47,-33,10
Crusaders,4342,1,16,7,3,61,30,31,55
Coleraine,4342,2,14,10,2,45,26,19,52
Glenavon,4342,3,10,9,7,56,45,11,39
Linfield,4342,4,11,5,10,39,36,3,38
Cliftonville,4342,5,9,4,13,32,33,-1,31
Ballymena,4342,6,7,5,14,25,47,-22,26
Glentoran,4342,7,6,6,10,24,32,-8,24
Dungannon,4342,8,2,4,16,14,47,-33,10
Crusaders,4343,1,17,6,3,62,30,32,57
Coleraine,4343,2,14,10,2,43,23,20,52
Glenavon,4343,3,10,9,7,53,43,10,39
Linfield,4343,4,10,6,10,38,37,1,36
Cliftonville,4343,5,9,5,12,33,32,1,32
Ballymena,4343,6,7,4,15,25,48,-23,25
Glentoran,4343,7,6,6,10,24,32,-8,24
Dungannon,4343,8,2,4,16,14,47,-33,10
Crusaders,4344,1,16,7,3,61,30,31,55
Coleraine,4344,2,14,10,2,43,26,17,52
Glenavon,4344,3,10,9,7,56,43,13,39
Linfield,4344,4,11,5,10,39,36,3,38
Cliftonville,4344,5,9,4,13,32,33,-1,31
Ballymena,4344,6,7,5,14,25,47,-22,26
Glentoran,4344,7,6,6,10,24,32,-8,24
Dungannon,4344,8,2,4,16,14,47,-33,10
Crusaders,4345,1,17,6,3,65,32,33,57
Coleraine,4345,2,15,10,1,46,22,24,55
Linfield,4345,3,11,5,10,39,36,3,38
Glenavon,4345,4,9,9,8,52,46,6,36
Cliftonville,4345,5,9,4,13,32,33,-1,31
Ballymena,4345,6,7,4,15,27,51,-24,25
Glentoran,4345,7,6,6,10,24,32,-8,24
Dungannon,4345,8,2,4,16,14,47,-33,10
Crusaders,4346,1,17,6,3,64,30,34,57
Coleraine,4346,2,15,10,1,46,24,22,55
Glenavon,4346,3,9,9,8,54,46,8,36
Linfield,4346,4,10,6,10,39,38,1,36
Cliftonville,4346,5,9,5,12,34,33,1,32
Ballymena,4346,6,7,4,15,25,50,-25,25
Glentoran,4346,7,6,6,10,24,32,-8,24
Dungannon,4346,8,2,4,16,14,47,-33,10
Crusaders,4347,1,17,6,3,62,30,32,57
Coleraine,4347,2,15,10,1,45,23,22,55
Linfield,4347,3,11,5,10,39,37,2,38
Glenavon,4347,4,9,9,8,53,45,8,36
Cliftonville,4347,5,9,4,13,33,33,0,31
Ballymena,4347,6,7,4,15,25,48,-23,25
Glentoran,4347,7,6,6,10,24,32,-8,24
Dungannon,4347,8,2,4,16,14,47,-33,10
Crusaders,4348,1,17,6,3,63,31,32,57
Coleraine,4348,2,14,10,2,44,25,19,52
Glenavon,4348,3,10,9,7,55,44,11,39
Linfield,4348,4,10,6,10,37,36,1,36
Cliftonville,4348,5,9,5,12,32,31,1,32
Ballymena,4348,6,7,4,15,26,49,-23,25
Glentoran,4348,7,6,6,10,24,32,-8,24
Dungannon,4348,8,2,4,16,14,47,-33,10
Crusaders,4349,1,17,6,3,63,30,33,57
Coleraine,4349,2,15,10,1,44,22,22,55
Glenavon,4349,3,9,9,8,52,44,8,36
Linfield,4349,4,10,6,10,38,37,1,36
Cliftonville,4349,5,9,5,12,33,32,1,32
Ballymena,4349,6,7,4,15,25,49,-24,25
Glentoran,4349,7,6,6,10,24,32,-8,24
Dungannon,4349,8,2,4,16,14,47,-33,10
Crusaders,4350,1,17,6,3,63,31,32,57
Coleraine,4350,2,14,10,2,43,23,20,52
Glenavon,4350,3,10,9,7,53,43,10,39
Linfield,4350,4,10,6,10,39,38,1,36
Cliftonville,4350,5,9,5,12,34,33,1,32
Ballymena,4350,6,7,4,15,26,49,-23,25
Glentoran,4350,7,6,6,10,24,32,-8,24
Dungannon,4350,8,2,4,16,14,47,-33,10
Crusaders,4351,1,16,6,4,61,34,27,54
Coleraine,4351,2,14,11,1,45,24,21,53
Linfield,4351,3,11,5,10,40,37,3,38
Glenavon,4351,4,9,10,7,54,45,9,37
Cliftonville,4351,5,9,4,13,33,34,-1,31
Ballymena,4351,6,8,4,14,29,47,-18,28
Glentoran,4351,7,6,6,10,24,32,-8,24
Dungannon,4351,8,2,4,16,14,47,-33,10
Crusaders,4352,1,16,7,3,62,31,31,55
Coleraine,4352,2,15,10,1,46,22,24,55
Glenavon,4352,3,9,9,8,52,46,6,36
Linfield,4352,4,10,6,10,38,37,1,36
Cliftonville,4352,5,9,5,12,33,32,1,32
Ballymena,4352,6,7,5,14,26,48,-22,26
Glentoran,4352,7,6,6,10,24,32,-8,24
Dungannon,4352,8,2,4,16,14,47,-33,10
Crusaders,4353,1,16,6,4,61,32,29,54
Coleraine,4353,2,14,10,2,45,25,20,52
Glenavon,4353,3,10,9,7,55,45,10,39
Linfield,4353,4,10,5,11,37,37,0,35
Cliftonville,4353,5,10,4,12,33,31,2,34
Ballymena,4353,6,8,4,14,27,47,-20,28
Glentoran,4353,7,6,6,10,24,32,-8,24
Dungannon,4353,8,2,4,16,14,47,-33,10
Crusaders,4354,1,16,7,3,63,32,31,55
Coleraine,4354,2,15,10,1,45,22,23,55
Linfield,4354,3,11,5,10,39,37,2,38
Glenavon,4354,4,9,9,8,52,45,7,36
Cliftonville,4354,5,9,4,13,33,33,0,31
Ballymena,4354,6,7,5,14,27,49,-22,26
Glentoran,4354,7,6,6,10,24,32,-8,24
Dungannon,4354,8,2,4,16,14,47,-33,10
Coleraine,4355,1,15,10,1,47,23,24,55
Crusaders,4355,2,16,6,4,63,34,29,54
Glenavon,4355,3,9,9,8,53,47,6,36
Linfield,4355,4,10,6,10,37,36,1,36
Cliftonville,4355,5,9,5,12,32,31,1,32
Ballymena,4355,6,8,4,14,29,49,-20,28
Glentoran,4355,7,6,6,10,24,32,-8,24
Dungannon,4355,8,2,4,16,14,47,-33,10
Crusaders,4356,1,17,6,3,63,30,33,57
Coleraine,4356,2,14,11,1,44,23,21,53
Linfield,4356,3,11,5,10,39,37,2,38
Glenavon,4356,4,9,10,7,53,44,9,37
Cliftonville,4356,5,9,4,13,33,33,0,31
Ballymena,4356,6,7,4,15,25,49,-24,25
Glentoran,4356,7,6,6,10,24,32,-8,24
Dungannon,4356,8,2,4,16,14,47,-33,10
Coleraine,4357,1,15,10,1,45,22,23,55
Crusaders,4357,2,16,6,4,61,32,29,54
Glenavon,4357,3,9,9,8,52,45,7,36
Linfield,4357,4,10,5,11,38,38,0,35
Cliftonville,4357,5,10,4,12,34,32,2,34
Ballymena,4357,6,8,4,14,27,47,-20,28
Glentoran,4357,7,6,6,10,24,32,-8,24
Dungannon,4357,8,2,4,16,14,47,-33,10
Crusaders,4358,1,17,6,3,62,30,32,57
Coleraine,4358,2,15,10,1,45,23,22,55
Glenavon,4358,3,9,9,8,53,45,8,36
Linfield,4358,4,10,5,11,38,39,-1,35
Cliftonville,4358,5,10,4,12,35,32,3,34
Ballymena,4358,6,7,4,15,25,48,-23,25
Glentoran,4358,7,6,6,10,24,32,-8,24
Dungannon,4358,8,2,4,16,14,47,-33,10
Crusaders,4359,1,17,6,3,63,30,33,57
Coleraine,4359,2,15,10,1,45,22,23,55
Glenavon,4359,3,9,9,8,52,45,7,36
Linfield,4359,4,10,5,11,39,39,0,35
Cliftonville,4359,5,10,4,12,35,33,2,34
Ballymena,4359,6,7,4,15,25,49,-24,25
Glentoran,4359,7,6,6,10,24,32,-8,24
Dungannon,4359,8,2,4,16,14,47,-33,10
Crusaders,4360,1,17,6,3,63,31,32,57
Coleraine,4360,2,14,10,2,43,24,19,52
Glenavon,4360,3,10,9,7,54,43,11,39
Linfield,4360,4,11,5,10,38,36,2,38
Cliftonville,4360,5,9,4,13,32,32,0,31
Ballymena,4360,6,7,4,15,26,49,-23,25
Glentoran,4360,7,6,6,10,24,32,-8,24
Dungannon,4360,8,2,4,16,14,47,-33,10
Crusaders,4361,1,17,6,3,66,33,33,57
Coleraine,4361,2,15,10,1,47,23,24,55
Linfield,4361,3,11,5,10,39,36,3,38
Glenavon,4361,4,9,9,8,53,47,6,36
Cliftonville,4361,5,9,4,13,32,33,-1,31
Ballymena,4361,6,7,4,15,28,52,-24,25
Glentoran,4361,7,6,6,10,24,32,-8,24
Dungannon,4361,8,2,4,16,14,47,-33,10
Crusaders,4362,1,17,6,3,64,30,34,57
Coleraine,4362,2,14,10,2,45,25,20,52
Glenavon,4362,3,10,9,7,55,45,10,39
Linfield,4362,4,11,5,10,38,36,2,38
Cliftonville,4362,5,9,4,13,32,32,0,31
Ballymena,4362,6,7,4,15,25,50,-25,25
Glentoran,4362,7,6,6,10,24,32,-8,24
Dungannon,4362,8,2,4,16,14,47,-33,10
Crusaders,4363,1,16,7,3,63,32,31,55
Coleraine,4363,2,14,10,2,44,25,19,52
Glenavon,4363,3,10,9,7,55,44,11,39
Linfield,4363,4,11,5,10,39,37,2,38
Cliftonville,4363,5,9,4,13,33,33,0,31
Ballymena,4363,6,7,5,14,27,49,-22,26
Glentoran,4363,7,6,6,10,24,32,-8,24
Dungannon,4363,8,2,4,16,14,47,-33,10
Crusaders,4364,1,16,6,4,61,31,30,54
Coleraine,4364,2,14,10,2,43,23,20,52
Glenavon,4364,3,10,9,7,53,43,10,39
Linfield,4364,4,11,5,10,40,37,3,38
Cliftonville,4364,5,9,4,13,33,34,-1,31
Ballymena,4364,6,8,4,14,26,47,-21,28
Glentoran,4364,7,6,6,10,24,32,-8,24
Dungannon,4364,8,2,4,16,14,47,-33,10
Crusaders,4365,1,16,7,3,62,31,31,55
Coleraine,4365,2,14,10,2,44,24,20,52
Glenavon,4365,3,10,9,7,54,44,10,39
Linfield,4365,4,10,6,10,37,36,1,36
Cliftonville,4365,5,9,5,12,32,31,1,32
Ballymena,4365,6,7,5,14,26,48,-22,26
Glentoran,4365,7,6,6,10,24,32,-8,24
Dungannon,4365,8,2,4,16,14,47,-33,10
Crusaders,4366,1,16,6,4,61,35,26,54
Coleraine,4366,2,14,10,2,43,23,20,52
Glenavon,4366,3,10,9,7,53,43,10,39
Linfield,4366,4,11,5,10,40,36,4,38
Cliftonville,4366,5,9,4,13,32,34,-2,31
Ballymena,4366,6,8,4,14,30,47,-17,28
Glentoran,4366,7,6,6,10,24,32,-8,24
Dungannon,4366,8,2,4,16,14,47,-33,10
Crusaders,4367,1,17,6,3,66,30,36,57
Coleraine,4367,2,14,10,2,44,26,18,52
Glenavon,4367,3,10,9,7,56,44,12,39
Linfield,4367,4,11,5,10,42,36,6,38
Cliftonville,4367,5,9,4,13,32,36,-4,31
Ballymena,4367,6,7,4,15,25,52,-27,25
Glentoran,4367,7,6,6,10,24,32,-8,24
Dungannon,4367,8,2,4,16,14,47,-33,10
Crusaders,4368,1,16,7,3,62,31,31,55
Coleraine,4368,2,14,11,1,43,22,21,53
Glenavon,4368,3,9,10,7,52,43,9,37
Linfield,4368,4,10,5,11,37,38,-1,35
Cliftonville,4368,5,10,4,12,34,31,3,34
Ballymena,4368,6,7,5,14,26,48,-22,26
Glentoran,4368,7,6,6,10,24,32,-8,24
Dungannon,4368,8,2,4,16,14,47,-33,10
Crusaders,4369,1,17,6,3,62,30,32,57
Coleraine,4369,2,15,10,1,44,22,22,55
Linfield,4369,3,11,5,10,40,36,4,38
Glenavon,4369,4,9,9,8,52,44,8,36
Cliftonville,4369,5,9,4,13,32,34,-2,31
Ballymena,4369,6,7,4,15,25,48,-23,25
Glentoran,4369,7,6,6,10,24,32,-8,24
Dungannon,4369,8,2,4,16,14,47,-33,10
Crusaders,4370,1,16,6,4,62,33,29,54
Coleraine,4370,2,14,10,2,47,27,20,52
Glenavon,4370,3,10,9,7,57,47,10,39
Linfield,4370,4,10,5,11,39,40,-1,35
Cliftonville,4370,5,10,4,12,36,33,3,34
Ballymena,4370,6,8,4,14,28,48,-20,28
Glentoran,4370,7,6,6,10,24,32,-8,24
Dungannon,4370,8,2,4,16,14,47,-33,10
Crusaders,4371,1,16,6,4,62,33,29,54
Coleraine,4371,2,14,10,2,43,25,18,52
Glenavon,4371,3,10,9,7,55,43,12,39
Linfield,4371,4,11,5,10,42,38,4,38
Cliftonville,4371,5,9,4,13,34,36,-2,31
Ballymena,4371,6,8,4,14,28,48,-20,28
Glentoran,4371,7,6,6,10,24,32,-8,24
Dungannon,4371,8,2,4,16,14,47,-33,10
Crusaders,4372,1,17,6,3,63,31,32,57
Coleraine,4372,2,15,10,1,45,23,22,55
Glenavon,4372,3,9,9,8,53,45,8,36
Linfield,4372,4,10,6,10,37,36,1,36
Cliftonville,4372,5,9,5,12,32,31,1,32
Ballymena,4372,6,7,4,15,26,49,-23,25
Glentoran,4372,7,6,6,10,24,32,-8,24
Dungannon,4372,8,2,4,16,14,47,-33,10
Crusaders,4373,1,16,6,4,62,32,30,54
Coleraine,4373,2,14,11,1,45,24,21,53
Glenavon,4373,3,9,10,7,54,45,9,37
Linfield,4373,4,10,5,11,37,37,0,35
Cliftonville,4373,5,10,4,12,33,31,2,34
Ballymena,4373,6,8,4,14,27,48,-21,28
Glentoran,4373,7,6,6,10,24,32,-8,24
Dungannon,4373,8,2,4,16,14,47,-33,10
Crusaders,4374,1,16,6,4,61,35,26,54
Coleraine,4374,2,14,10,2,43,23,20,52
Glenavon,4374,3,10,9,7,53,43,10,39
Linfield,4374,4,10,6,10,37,36,1,36
Cliftonville,4374,5,9,5,12,32,31,1,32
Ballymena,4374,6,8,4,14,30,47,-17,28
Glentoran,4374,7,6,6,10,24,32,-8,24
Dungannon,4374,8,2,4,16,14,47,-33,10
Coleraine,4375,1,15,10,1,45,23,22,55
Crusaders,4375,2,16,6,4,62,32,30,54
Linfield,4375,3,11,5,10,38,36,2,38
Glenavon,4375,4,9,9,8,53,45,8,36
Cliftonville,4375,5,9,4,13,32,32,0,31
Ballymena,4375,6,8,4,14,27,48,-21,28
Glentoran,4375,7,6,6,10,24,32,-8,24
Dungannon,4375,8,2,4,16,14,47,-33,10
Crusaders,4376,1,17,6,3,64,32,32,57
Coleraine,4376,2,15,10,1,44,22,22,55
Linfield,4376,3,11,5,10,38,36,2,38
Glenavon,4376,4,9,9,8,52,44,8,36
Cliftonville,4376,5,9,4,13,32,32,0,31
Ballymena,4376,6,7,4,15,27,50,-23,25
Glentoran,4376,7,6,6,10,24,32,-8,24
Dungannon,4376,8,2,4,16,14,47,-33,10
Crusaders,4377,1,16,6,4,61,31,30,54
Coleraine,4377,2,14,11,1,44,23,21,53
Glenavon,4377,3,9,10,7,53,44,9,37
Linfield,4377,4,10,6,10,37,36,1,36
Cliftonville,4377,5,9,5,12,32,31,1,32
Ballymena,4377,6,8,4,14,26,47,-21,28
Glentoran,4377,7,6,6,10,24,32,-8,24
Dungannon,4377,8,2,4,16,14,47,-33,10
Crusaders,4378,1,17,6,3,63,31,32,57
Coleraine,4378,2,14,11,1,43,22,21,53
Linfield,4378,3,11,5,10,38,36,2,38
Glenavon,4378,4,9,10,7,52,43,9,37
Cliftonville,4378,5,9,4,13,32,32,0,31
Ballymena,4378,6,7,4,15,26,49,-23,25
Glentoran,4378,7,6,6,10,24,32,-8,24
Dungannon,4378,8,2,4,16,14,47,-33,10
Crusaders,4379,1,17,6,3,66,31,35,57
Coleraine,4379,2,14,10,2,44,24,20,52
Glenavon,4379,3,10,9,7,54,44,10,39
Linfield,4379,4,11,5,10,38,36,2,38
Cliftonville,4379,5,9,4,13,32,32,0,31
Ballymena,4379,6,7,4,15,26,52,-26,25
Glentoran,4379,7,6,6,10,24,32,-8,24
Dungannon,4379,8,2,4,16,14,47,-33,10
Crusaders,4380,1,17,6,3,63,30,33,57
Coleraine,4380,2,14,11,1,43,22,21,53
Linfield,4380,3,11,5,10,38,36,2,38
Glenavon,4380,4,9,10,7,52,43,9,37
Cliftonville,4380,5,9,4,13,32,32,0,31
Ballymena,4380,6,7,4,15,25,49,-24,25
Glentoran,4380,7,6,6,10,24,32,-8,24
Dungannon,4380,8,2,4,16,14,47,-33,10
Crusaders,4381,1,17,6,3,62,30,32,57
Coleraine,4381,2,14,11,1,46,25,21,53
Glenavon,4381,3,9,10,7,55,46,9,37
Linfield,4381,4,10,5,11,38,38,0,35
Cliftonville,4381,5,10,4,12,34,32,2,34
Ballymena,4381,6,7,4,15,25,48,-23,25
Glentoran,4381,7,6,6,10,24,32,-8,24
Dungannon,4381,8,2,4,16,14,47,-33,10
Coleraine,4382,1,15,10,1,46,24,22,55
Crusaders,4382,2,16,6,4,62,33,29,54
Glenavon,4382,3,9,9,8,54,46,8,36
Linfield,4382,4,10,6,10,38,37,1,36
Cliftonville,4382,5,9,5,12,33,32,1,32
Ballymena,4382,6,8,4,14,28,48,-20,28
Glentoran,4382,7,6,6,10,24,32,-8,24
Dungannon,4382,8,2,4,16,14,47,-33,10
Crusaders,4383,1,17,6,3,66,30,36,57
Coleraine,4383,2,15,10,1,44,22,22,55
Linfield,4383,3,11,5,10,38,36,2,38
Glenavon,4383,4,9,9,8,52,44,8,36
Cliftonville,4383,5,9,4,13,32,32,0,31
Ballymena,4383,6,7,4,15,25,52,-27,25
Glentoran,4383,7,6,6,10,24,32,-8,24
Dungannon,4383,8,2,4,16,14,47,-33,10
Crusaders,4384,1,17,6,3,65,30,35,57
Coleraine,4384,2,14,10,2,45,25,20,52
Glenavon,4384,3,10,9,7,55,45,10,39
Linfield,4384,4,11,5,10,39,36,3,38
Cliftonville,4384,5,9,4,13,32,33,-1,31
Ballymena,4384,6,7,4,15,25,51,-26,25
Glentoran,4384,7,6,6,10,24,32,-8,24
Dungannon,4384,8,2,4,16,14,47,-33,10
Crusaders,4385,1,17,6,3,63,30,33,57
Coleraine,4385,2,14,10,2,44,25,19,52
Glenavon,4385,3,10,9,7,55,44,11,39
Linfield,4385,4,10,6,10,40,39,1,36
Cliftonville,4385,5,9,5,12,35,34,1,32
Ballymena,4385,6,7,4,15,25,49,-24,25
Glentoran,4385,7,6,6,10,24,32,-8,24
Dungannon,4385,8,2,4,16,14,47,-33,10
Crusaders,4386,1,17,6,3,64,30,34,57
Coleraine,4386,2,14,10,2,45,27,18,52
Glenavon,4386,3,10,9,7,57,45,12,39
Linfield,4386,4,11,5,10,40,37,3,38
Cliftonville,4386,5,9,4,13,33,34,-1,31
Ballymena,4386,6,7,4,15,25,50,-25,25
Glentoran,4386,7,6,6,10,24,32,-8,24
Dungannon,4386,8,2,4,16,14,47,-33,10
Crusaders,4387,1,17,6,3,64,30,34,57
Coleraine,4387,2,14,10,2,45,26,19,52
Glenavon,4387,3,10,9,7,56,45,11,39
Linfield,4387,4,11,5,10,39,37,2,38
Cliftonville,4387,5,9,4,13,33,33,0,31
Ballymena,4387,6,7,4,15,25,50,-25,25
Glentoran,4387,7,6,6,10,24,32,-8,24
Dungannon,4387,8,2,4,16,14,47,-33,10
Crusaders,4388,1,16,6,4,62,32,30,54
Coleraine,4388,2,14,10,2,44,25,19,52
Glenavon,4388,3,10,9,7,55,44,11,39
Linfield,4388,4,11,5,10,39,36,3,38
Cliftonville,4388,5,9,4,13,32,33,-1,31
Ballymena,4388,6,8,4,14,27,48,-21,28
Glentoran,4388,7,6,6,10,24,32,-8,24
Dungannon,4388,8,2,4,16,14,47,-33,10
Crusaders,4389,1,16,7,3,61,30,31,55
Coleraine,4389,2,15,10,1,46,24,22,55
Linfield,4389,3,11,5,10,40,36,4,38
Glenavon,4389,4,9,9,8,54,46,8,36
Cliftonville,4389,5,9,4,13,32,34,-2,31
Ballymena,4389,6,7,5,14,25,47,-22,26
Glentoran,4389,7,6,6,10,24,32,-8,24
Dungannon,4389,8,2,4,16,14,47,-33,10
Crusaders,4390,1,16,7,3,62,31,31,55
Coleraine,4390,2,14,10,2,44,24,20,52
Glenavon,4390,3,10,9,7,54,44,10,39
Linfield,4390,4,11,5,10,41,39,2,38
Cliftonville,4390,5,9,4,13,35,35,0,31
Ballymena,4390,6,7,5,14,26,48,-22,26
Glentoran,4390,7,6,6,10,24,32,-8,24
Dungannon,4390,8,2,4,16,14,47,-33,10
Crusaders,4391,1,17,6,3,63,31,32,57
Coleraine,4391,2,14,10,2,45,25,20,52
Glenavon,4391,3,10,9,7,55,45,10,39
Linfield,4391,4,11,5,10,38,36,2,38
Cliftonville,4391,5,9,4,13,32,32,0,31
Ballymena,4391,6,7,4,15,26,49,-23,25
Glentoran,4391,7,6,6,10,24,32,-8,24
Dungannon,4391,8,2,4,16,14,47,-33,10
Crusaders,4392,1,17,6,3,63,31,32,57
Coleraine,4392,2,14,10,2,43,25,18,52
Glenavon,4392,3,10,9,7,55,43,12,39
Linfield,4392,4,11,5,10,38,36,2,38
Cliftonville,4392,5,9,4,13,32,32,0,31
Ballymena,4392,6,7,4,15,26,49,-23,25
Glentoran,4392,7,6,6,10,24,32,-8,24
Dungannon,4392,8,2,4,16,14,47,-33,10
Crusaders,4393,1,17,6,3,67,32,35,57
Coleraine,4393,2,15,10,1,46,22,24,55
Glenavon,4393,3,9,9,8,52,46,6,36
Linfield,4393,4,10,6,10,40,39,1,36
Cliftonville,4393,5,9,5,12,35,34,1,32
Ballymena,4393,6,7,4,15,27,53,-26,25
Glentoran,4393,7,6,6,10,24,32,-8,24
Dungannon,4393,8,2,4,16,14,47,-33,10
Crusaders,4394,1,16,6,4,61,31,30,54
Coleraine,4394,2,14,11,1,45,24,21,53
Glenavon,4394,3,9,10,7,54,45,9,37
Linfield,4394,4,10,5,11,38,39,-1,35
Cliftonville,4394,5,10,4,12,35,32,3,34
Ballymena,4394,6,8,4,14,26,47,-21,28
Glentoran,4394,7,6,6,10,24,32,-8,24
Dungannon,4394,8,2,4,16,14,47,-33,10
Crusaders,4395,1,16,7,3,62,31,31,55
Coleraine,4395,2,15,10,1,44,22,22,55
Linfield,4395,3,11,5,10,39,37,2,38
Glenavon,4395,4,9,9,8,52,44,8,36
Cliftonville,4395,5,9,4,13,33,33,0,31
Ballymena,4395,6,7,5,14,26,48,-22,26
Glentoran,4395,7,6,6,10,24,32,-8,24
Dungannon,4395,8,2,4,16,14,47,-33,10
Crusaders,4396,1,16,6,4,61,33,28,54
Coleraine,4396,2,14,10,2,43,23,20,52
Glenavon,4396,3,10,9,7,53,43,10,39
Linfield,4396,4,10,5,11,38,40,-2,35
Cliftonville,4396,5,10,4,12,36,32,4,34
Ballymena,4396,6,8,4,14,28,47,-19,28
Glentoran,4396,7,6,6,10,24,32,-8,24
Dungannon,4396,8,2,4,16,14,47,-33,10
Coleraine,4397,1,15,10,1,46,22,24,55
Crusaders,4397,2,16,6,4,61,31,30,54
Linfield,4397,3,11,5,10,39,37,2,38
Glenavon,4397,4,9,9,8,52,46,6,36
Cliftonville,4397,5,9,4,13,33,33,0,31
Ballymena,4397,6,8,4,14,26,47,-21,28
Glentoran,4397,7,6,6,10,24,32,-8,24
Dungannon,4397,8,2,4,16,14,47,-33,10
Crusaders,4398,1,17,6,3,64,32,32,57
Coleraine,4398,2,14,10,2,44,24,20,52
Glenavon,4398,3,10,9,7,54,44,10,39
Linfield,4398,4,10,6,10,37,36,1,36
Cliftonville,4398,5,9,5,12,32,31,1,32
Ballymena,4398,6,7,4,15,27,50,-23,25
Glentoran,4398,7,6,6,10,24,32,-8,24
Dungannon,4398,8,2,4,16,14,47,-33,10
Crusaders,4399,1,17,6,3,63,31,32,57
Coleraine,4399,2,14,10,2,45,25,20,52
Glenavon,4399,3,10,9,7,55,45,10,39
Linfield,4399,4,10,6,10,37,36,1,36
Cliftonville,4399,5,9,5,12,32,31,1,32
Ballymena,4399,6,7,4,15,26,49,-23,25
Glentoran,4399,7,6,6,10,24,32,-8,24
Dungannon,4399,8,2,4,16,14,47,-33,10
Crusaders,4400,1,16,7,3,62,31,31,55
Coleraine,4400,2,14,11,1,43,22,21,53
Linfield,4400,3,11,5,10,41,37,4,38
Glenavon,4400,4,9,10,7,52,43,9,37
Cliftonville,4400,5,9,4,13,33,35,-2,31
Ballymena,4400,6,7,5,14,26,48,-22,26
Glentoran,4400,7,6,6,10,24,32,-8,24
Dungannon,4400,8,2,4,16,14,47,-33,10
Crusaders,4401,1,17,6,3,63,31,32,57
Coleraine,4401,2,15,10,1,45,23,22,55
Glenavon,4401,3,9,9,8,53,45,8,36
Linfield,4401,4,10,5,11,38,38,0,35
Cliftonville,4401,5,10,4,12,34,32,2,34
Ballymena,4401,6,7,4,15,26,49,-23,25
Glentoran,4401,7,6,6,10,24,32,-8,24
Dungannon,4401,8,2,4,16,14,47,-33,10
Crusaders,4402,1,17,6,3,64,30,34,57
Coleraine,4402,2,15,10,1,44,22,22,55
Glenavon,4402,3,9,9,8,52,44,8,36
Linfield,4402,4,10,6,10,37,36,1,36
Cliftonville,4402,5,9,5,12,32,31,1,32
Ballymena,4402,6,7,4,15,25,50,-25,25
Glentoran,4402,7,6,6,10,24,32,-8,24
Dungannon,4402,8,2,4,16,14,47,-33,10
Crusaders,4403,1,16,6,4,61,32,29,54
Coleraine,4403,2,14,11,1,44,23,21,53
Linfield,4403,3,11,5,10,38,36,2,38
Glenavon,4403,4,9,10,7,53,44,9,37
Cliftonville,4403,5,9,4,13,32,32,0,31
Ballymena,4403,6,8,4,14,27,47,-20,28
Glentoran,4403,7,6,6,10,24,32,-8,24
Dungannon,4403,8,2,4,16,14,47,-33,10
Coleraine,4404,1,15,10,1,47,25,22,55
Crusaders,4404,2,16,6,4,61,31,30,54
Glenavon,4404,3,9,9,8,55,47,8,36
Linfield,4404,4,10,5,11,37,38,-1,35
Cliftonville,4404,5,10,4,12,34,31,3,34
Ballymena,4404,6,8,4,14,26,47,-21,28
Glentoran,4404,7,6,6,10,24,32,-8,24
Dungannon,4404,8,2,4,16,14,47,-33,10
Crusaders,4405,1,16,7,3,63,32,31,55
Coleraine,4405,2,15,10,1,47,24,23,55
Glenavon,4405,3,9,9,8,54,47,7,36
Linfield,4405,4,10,6,10,37,36,1,36
Cliftonville,4405,5,9,5,12,32,31,1,32
Ballymena,4405,6,7,5,14,27,49,-22,26
Glentoran,4405,7,6,6,10,24,32,-8,24
Dungannon,4405,8,2,4,16,14,47,-33,10
Crusaders,4406,1,17,6,3,65,30,35,57
Coleraine,4406,2,14,10,2,43,25,18,52
Glenavon,4406,3,10,9,7,55,43,12,39
Linfield,4406,4,11,5,10,40,36,4,38
Cliftonville,4406,5,9,4,13,32,34,-2,31
Ballymena,4406,6,7,4,15,25,51,-26,25
Glentoran,4406,7,6,6,10,24,32,-8,24
Dungannon,4406,8,2,4,16,14,47,-33,10
Crusaders,4407,1,17,6,3,63,30,33,57
Coleraine,4407,2,14,10,2,44,26,18,52
Glenavon,4407,3,10,9,7,56,44,12,39
Linfield,4407,4,11,5,10,40,37,3,38
Cliftonville,4407,5,9,4,13,33,34,-1,31
Ballymena,4407,6,7,4,15,25,49,-24,25
Glentoran,4407,7,6,6,10,24,32,-8,24
Dungannon,4407,8,2,4,16,14,47,-33,10
Crusaders,4408,1,17,6,3,62,30,32,57
Coleraine,4408,2,15,10,1,45,23,22,55
Glenavon,4408,3,9,9,8,53,45,8,36
Linfield,4408,4,10,6,10,38,37,1,36
Cliftonville,4408,5,9,5,12,33,32,1,32
Ballymena,4408,6,7,4,15,25,48,-23,25
Glentoran,4408,7,6,6,10,24,32,-8,24
Dungannon,4408,8,2,4,16,14,47,-33,10
Crusaders,4409,1,17,6,3,63,30,33,57
Coleraine,4409,2,14,11,1,45,24,21,53
Glenavon,4409,3,9,10,7,54,45,9,37
Linfield,4409,4,10,6,10,39,38,1,36
Cliftonville,4409,5,9,5,12,34,33,1,32
Ballymena,4409,6,7,4,15,25,49,-24,25
Glentoran,4409,7,6,6,10,24,32,-8,24
Dungannon,4409,8,2,4,16,14,47,-33,10
Crusaders,4410,1,17,6,3,65,31,34,57
Coleraine,4410,2,15,10,1,45,23,22,55
Glenavon,4410,3,9,9,8,53,45,8,36
Linfield,4410,4,10,5,11,37,37,0,35
Cliftonville,4410,5,10,4,12,33,31,2,34
Ballymena,4410,6,7,4,15,26,51,-25,25
Glentoran,4410,7,6,6,10,24,32,-8,24
Dungannon,4410,8,2,4,16,14,47,-33,10
Crusaders,4411,1,16,6,4,62,32,30,54
Coleraine,4411,2,14,11,1,44,23,21,53
Glenavon,4411,3,9,10,7,53,44,9,37
Linfield,4411,4,10,5,11,39,40,-1,35
Cliftonville,4411,5,10,4,12,36,33,3,34
Ballymena,4411,6,8,4,14,27,48,-21,28
Glentoran,4411,7,6,6,10,24,32,-8,24
Dungannon,4411,8,2,4,16,14,47,-33,10
Crusaders,4412,1,16,6,4,63,33,30,54
Coleraine,4412,2,14,11,1,43,22,21,53
Glenavon,4412,3,9,10,7,52,43,9,37
Linfield,4412,4,10,5,11,38,38,0,35
Cliftonville,4412,5,10,4,12,34,32,2,34
Ballymena,4412,6,8,4,14,28,49,-21,28
Glentoran,4412,7,6,6,10,24,32,-8,24
Dungannon,4412,8,2,4,16,14,47,-33,10
Crusaders,4413,1,17,6,3,63,31,32,57
Coleraine,4413,2,14,10,2,43,23,20,52
Glenavon,4413,3,10,9,7,53,43,10,39
Linfield,4413,4,10,5,11,37,37,0,35
Cliftonville,4413,5,10,4,12,33,31,2,34
Ballymena,4413,6,7,4,15,26,49,-23,25
Glentoran,4413,7,6,6,10,24,32,-8,24
Dungannon,4413,8,2,4,16,14,47,-33,10
Crusaders,4414,1,16,7,3,63,32,31,55
Coleraine,4414,2,14,11,1,44,23,21,53
Glenavon,4414,3,9,10,7,53,44,9,37
Linfield,4414,4,10,5,11,38,38,0,35
Cliftonville,4414,5,10,4,12,34,32,2,34
Ballymena,4414,6,7,5,14,27,49,-22,26
Glentoran,4414,7,6,6,10,24,32,-8,24
Dungannon,4414,8,2,4,16,14,47,-33,10
Crusaders,4415,1,17,6,3,63,31,32,57
Coleraine,4415,2,15,10,1,46,24,22,55
Glenavon,4415,3,9,9,8,54,46,8,36
Linfield,4415,4,10,6,10,37,36,1,36
Cliftonville,4415,5,9,5,12,32,31,1,32
Ballymena,4415,6,7,4,15,26,49,-23,25
Glentoran,4415,7,6,6,10,24,32,-8,24
Dungannon,4415,8,2,4,16,14,47,-33,10
Crusaders,4416,1,16,7,3,62,31,31,55
Coleraine,4416,2,14,10,2,43,24,19,52
Glenavon,4416,3,10,9,7,54,43,11,39
Linfield,4416,4,10,5,11,37,39,-2,35
Cliftonville,4416,5,10,4,12,35,31,4,34
Ballymena,4416,6,7,5,14,26,48,-22,26
Glentoran,4416,7,6,6,10,24,32,-8,24
Dungannon,4416,8,2,4,16,14,47,-33,10
Crusaders,4417,1,17,6,3,66,30,36,57
Coleraine,4417,2,14,11,1,45,24,21,53
Glenavon,4417,3,9,10,7,54,45,9,37
Linfield,4417,4,10,6,10,38,37,1,36
Cliftonville,4417,5,9,5,12,33,32,1,32
Ballymena,4417,6,7,4,15,25,52,-27,25
Glentoran,4417,7,6,6,10,24,32,-8,24
Dungannon,4417,8,2,4,16,14,47,-33,10
Crusaders,4418,1,17,6,3,65,30,35,57
Coleraine,4418,2,15,10,1,46,22,24,55
Linfield,4418,3,11,5,10,39,36,3,38
Glenavon,4418,4,9,9,8,52,46,6,36
Cliftonville,4418,5,9,4,13,32,33,-1,31
Ballymena,4418,6,7,4,15,25,51,-26,25
Glentoran,4418,7,6,6,10,24,32,-8,24
Dungannon,4418,8,2,4,16,14,47,-33,10
Crusaders,4419,1,16,6,4,61,32,29,54
Coleraine,4419,2,14,10,2,43,23,20,52
Glenavon,4419,3,10,9,7,53,43,10,39
Linfield,4419,4,11,5,10,40,38,2,38
Cliftonville,4419,5,9,4,13,34,34,0,31
Ballymena,4419,6,8,4,14,27,47,-20,28
Glentoran,4419,7,6,6,10,24,32,-8,24
Dungannon,4419,8,2,4,16,14,47,-33,10
Crusaders,4420,1,17,6,3,64,31,33,57
Coleraine,4420,2,15,10,1,47,24,23,55
Linfield,4420,3,11,5,10,40,37,3,38
Glenavon,4420,4,9,9,8,54,47,7,36
Cliftonville,4420,5,9,4,13,33,34,-1,31
Ballymena,4420,6,7,4,15,26,50,-24,25
Glentoran,4420,7,6,6,10,24,32,-8,24
Dungannon,4420,8,2,4,16,14,47,-33,10
Crusaders,4421,1,16,7,3,62,31,31,55
Coleraine,4421,2,14,10,2,43,23,20,52
Glenavon,4421,3,10,9,7,53,43,10,39
Linfield,4421,4,11,5,10,41,37,4,38
Cliftonville,4421,5,9,4,13,33,35,-2,31
Ballymena,4421,6,7,5,14,26,48,-22,26
Glentoran,4421,7,6,6,10,24,32,-8,24
Dungannon,4421,8,2,4,16,14,47,-33,10
Crusaders,4422,1,16,6,4,62,33,29,54
Coleraine,4422,2,14,10,2,44,25,19,52
Glenavon,4422,3,10,9,7,55,44,11,39
Linfield,4422,4,11,5,10,40,36,4,38
Cliftonville,4422,5,9,4,13,32,34,-2,31
Ballymena,4422,6,8,4,14,28,48,-20,28
Glentoran,4422,7,6,6,10,24,32,-8,24
Dungannon,4422,8,2,4,16,14,47,-33,10
Crusaders,4423,1,16,7,3,62,31,31,55
Coleraine,4423,2,15,10,1,44,22,22,55
Glenavon,4423,3,9,9,8,52,44,8,36
Linfield,4423,4,10,5,11,37,37,0,35
Cliftonville,4423,5,10,4,12,33,31,2,34
Ballymena,4423,6,7,5,14,26,48,-22,26
Glentoran,4423,7,6,6,10,24,32,-8,24
Dungannon,4423,8,2,4,16,14,47,-33,10
Crusaders,4424,1,16,7,3,63,32,31,55
Coleraine,4424,2,15,10,1,44,22,22,55
Linfield,4424,3,11,5,10,39,36,3,38
Glenavon,4424,4,9,9,8,52,44,8,36
Cliftonville,4424,5,9,4,13,32,33,-1,31
Ballymena,4424,6,7,5,14,27,49,-22,26
Glentoran,4424,7,6,6,10,24,32,-8,24
Dungannon,4424,8,2,4,16,14,47,-33,10
Crusaders,4425,1,16,6,4,63,33,30,54
Coleraine,4425,2,14,10,2,45,26,19,52
Glenavon,4425,3,10,9,7,56,45,11,39
Linfield,4425,4,11,5,10,39,37,2,38
Cliftonville,4425,5,9,4,13,33,33,0,31
Ballymena,4425,6,8,4,14,28,49,-21,28
Glentoran,4425,7,6,6,10,24,32,-8,24
Dungannon,4425,8,2,4,16,14,47,-33,10
Crusaders,4426,1,17,6,3,63,31,32,57
Coleraine,4426,2,14,10,2,45,25,20,52
Glenavon,4426,3,10,9,7,55,45,10,39
Linfield,4426,4,10,5,11,38,39,-1,35
Cliftonville,4426,5,10,4,12,35,32,3,34
Ballymena,4426,6,7,4,15,26,49,-23,25
Glentoran,4426,7,6,6,10,24,32,-8,24
Dungannon,4426,8,2,4,16,14,47,-33,10
Coleraine,4427,1,15,10,1,46,24,22,55
Crusaders,4427,2,16,6,4,61,34,27,54
Glenavon,4427,3,9,9,8,54,46,8,36
Linfield,4427,4,10,5,11,38,38,0,35
Cliftonville,4427,5,10,4,12,34,32,2,34
Ballymena,4427,6,8,4,14,29,47,-18,28
Glentoran,4427,7,6,6,10,24,32,-8,24
Dungannon,4427,8,2,4,16,14,47,-33,10
Coleraine,4428,1,15,10,1,45,23,22,55
Crusaders,4428,2,16,6,4,61,31,30,54
Glenavon,4428,3,9,9,8,53,45,8,36
Linfield,4428,4,10,5,11,37,37,0,35
Cliftonville,4428,5,10,4,12,33,31,2,34
Ballymena,4428,6,8,4,14,26,47,-21,28
Glentoran,4428,7,6,6,10,24,32,-8,24
Dungannon,4428,8,2,4,16,14,47,-33,10
Crusaders,4429,1,16,7,3,63,32,31,55
Coleraine,4429,2,15,10,1,46,23,23,55
Glenavon,4429,3,9,9,8,53,46,7,36
Linfield,4429,4,10,6,10,38,37,1,36
Cliftonville,4429,5,9,5,12,33,32,1,32
Ballymena,4429,6,7,5,14,27,49,-22,26
Glentoran,4429,7,6,6,10,24,32,-8,24
Dungannon,4429,8,2,4,16,14,47,-33,10
Crusaders,4430,1,16,7,3,62,31,31,55
Coleraine,4430,2,15,10,1,45,22,23,55
Linfield,4430,3,11,5,10,39,37,2,38
Glenavon,4430,4,9,9,8,52,45,7,36
Cliftonville,4430,5,9,4,13,33,33,0,31
Ballymena,4430,6,7,5,14,26,48,-22,26
Glentoran,4430,7,6,6,10,24,32,-8,24
Dungannon,4430,8,2,4,16,14,47,-33,10
Crusaders,4431,1,16,7,3,63,32,31,55
Coleraine,4431,2,14,11,1,44,23,21,53
Glenavon,4431,3,9,10,7,53,44,9,37
Linfield,4431,4,10,6,10,38,37,1,36
Cliftonville,4431,5,9,5,12,33,32,1,32
Ballymena,4431,6,7,5,14,27,49,-22,26
Glentoran,4431,7,6,6,10,24,32,-8,24
Dungannon,4431,8,2,4,16,14,47,-33,10
Crusaders,4432,1,16,7,3,61,30,31,55
Coleraine,4432,2,14,11,1,45,24,21,53
Linfield,4432,3,11,5,10,38,36,2,38
Glenavon,4432,4,9,10,7,54,45,9,37
Cliftonville,4432,5,9,4,13,32,32,0,31
Ballymena,4432,6,7,5,14,25,47,-22,26
Glentoran,4432,7,6,6,10,24,32,-8,24
Dungannon,4432,8,2,4,16,14,47,-33,10
Crusaders,4433,1,17,6,3,62,30,32,57
Coleraine,4433,2,15,10,1,46,24,22,55
Glenavon,4433,3,9,9,8,54,46,8,36
Linfield,4433,4,10,6,10,38,37,1,36
Cliftonville,4433,5,9,5,12,33,32,1,32
Ballymena,4433,6,7,4,15,25,48,-23,25
Glentoran,4433,7,6,6,10,24,32,-8,24
Dungannon,4433,8,2,4,16,14,47,-33,10
Crusaders,4434,1,16,6,4,63,34,29,54
Coleraine,4434,2,14,10,2,43,23,20,52
Glenavon,4434,3,10,9,7,53,43,10,39
Linfield,4434,4,10,5,11,37,37,0,35
Cliftonville,4434,5,10,4,12,33,31,2,34
Ballymena,4434,6,8,4,14,29,49,-20,28
Glentoran,4434,7,6,6,10,24,32,-8,24
Dungannon,4434,8,2,4,16,14,47,-33,10
Crusaders,4435,1,16,7,3,61,30,31,55
Coleraine,4435,2,14,10,2,44,24,20,52
Glenavon,4435,3,10,9,7,54,44,10,39
Linfield,4435,4,11,5,10,38,36,2,38
Cliftonville,4435,5,9,4,13,32,32,0,31
Ballymena,4435,6,7,5,14,25,47,-22,26
Glentoran,4435,7,6,6,10,24,32,-8,24
Dungannon,4435,8,2,4,16,14,47,-33,10
Crusaders,4436,1,17,6,3,63,30,33,57
Coleraine,4436,2,15,10,1,47,25,22,55
Glenavon,4436,3,9,9,8,55,47,8,36
Linfield,4436,4,10,5,11,38,38,0,35
Cliftonville,4436,5,10,4,12,34,32,2,34
Ballymena,4436,6,7,4,15,25,49,-24,25
Glentoran,4436,7,6,6,10,24,32,-8,24
Dungannon,4436,8,2,4,16,14,47,-33,10
Crusaders,4437,1,16,7,3,61,30,31,55
Coleraine,4437,2,14,10,2,44,25,19,52
Glenavon,4437,3,10,9,7,55,44,11,39
Linfield,4437,4,11,5,10,38,36,2,38
Cliftonville,4437,5,9,4,13,32,32,0,31
Ballymena,4437,6,7,5,14,25,47,-22,26
Glentoran,4437,7,6,6,10,24,32,-8,24
Dungannon,4437,8,2,4,16,14,47,-33,10
Crusaders,4438,1,17,6,3,64,32,32,57
Coleraine,4438,2,14,10,2,43,23,20,52
Glenavon,4438,3,10,9,7,53,43,10,39
Linfield,4438,4,11,5,10,39,37,2,38
Cliftonville,4438,5,9,4,13,33,33,0,31
Ballymena,4438,6,7,4,15,27,50,-23,25
Glentoran,4438,7,6,6,10,24,32,-8,24
Dungannon,4438,8,2,4,16,14,47,-33,10
Crusaders,4439,1,16,7,3,62,31,31,55
Coleraine,4439,2,14,10,2,43,23,20,52
Glenavon,4439,3,10,9,7,53,43,10,39
Linfield,4439,4,11,5,10,42,37,5,38
Cliftonville,4439,5,9,4,13,33,36,-3,31
Ballymena,4439,6,7,5,14,26,48,-22,26
Glentoran,4439,7,6,6,10,24,32,-8,24
Dungannon,4439,8,2,4,16,14,47,-33,10
Crusaders,4440,1,17,6,3,65,32,33,57
Coleraine,4440,2,15,10,1,45,23,22,55
Glenavon,4440,3,9,9,8,53,45,8,36
Linfield,4440,4,10,6,10,38,37,1,36
Cliftonville,4440,5,9,5,12,33,32,1,32
Ballymena,4440,6,7,4,15,27,51,-24,25
Glentoran,4440,7,6,6,10,24,32,-8,24
Dungannon,4440,8,2,4,16,14,47,-33,10
Crusaders,4441,1,17,6,3,64,31,33,57
Coleraine,4441,2,14,10,2,43,24,19,52
Glenavon,4441,3,10,9,7,54,43,11,39
Linfield,4441,4,11,5,10,40,36,4,38
Cliftonville,4441,5,9,4,13,32,34,-2,31
Ballymena,4441,6,7,4,15,26,50,-24,25
Glentoran,4441,7,6,6,10,24,32,-8,24
Dungannon,4441,8,2,4,16,14,47,-33,10
Crusaders,4442,1,16,7,3,63,32,31,55
Coleraine,4442,2,14,10,2,44,24,20,52
Glenavon,4442,3,10,9,7,54,44,10,39
Linfield,4442,4,11,5,10,38,36,2,38
Cliftonville,4442,5,9,4,13,32,32,0,31
Ballymena,4442,6,7,5,14,27,49,-22,26
Glentoran,4442,7,6,6,10,24,32,-8,24
Dungannon,4442,8,2,4,16,14,47,-33,10
Crusaders,4443,1,17,6,3,64,31,33,57
Coleraine,4443,2,15,10,1,45,22,23,55
Linfield,4443,3,11,5,10,40,37,3,38
Glenavon,4443,4,9,9,8,52,45,7,36
Cliftonville,4443,5,9,4,13,33,34,-1,31
Ballymena,4443,6,7,4,15,26,50,-24,25
Glentoran,4443,7,6,6,10,24,32,-8,24
Dungannon,4443,8,2,4,16,14,47,-33,10
Crusaders,4444,1,16,7,3,62,31,31,55
Coleraine,4444,2,15,10,1,46,24,22,55
Linfield,4444,3,11,5,10,38,36,2,38
Glenavon,4444,4,9,9,8,54,46,8,36
Cliftonville,4444,5,9,4,13,32,32,0,31
Ballymena,4444,6,7,5,14,26,48,-22,26
Glentoran,4444,7,6,6,10,24,32,-8,24
Dungannon,4444,8,2,4,16,14,47,-33,10
Crusaders,4445,1,17,6,3,64,30,34,57
Coleraine,4445,2,14,11,1,43,22,21,53
Glenavon,4445,3,9,10,7,52,43,9,37
Linfield,4445,4,10,5,11,38,38,0,35
Cliftonville,4445,5,10,4,12,34,32,2,34
Ballymena,4445,6,7,4,15,25,50,-25,25
Glentoran,4445,7,6,6,10,24,32,-8,24
Dungannon,4445,8,2,4,16,14,47,-33,10
Crusaders,4446,1,16,6,4,62,32,30,54
Coleraine,4446,2,14,10,2,44,27,17,52
Glenavon,4446,3,10,9,7,57,44,13,39
Linfield,4446,4,10,5,11,38,38,0,35
Cliftonville,4446,5,10,4,12,34,32,2,34
Ballymena,4446,6,8,4,14,27,48,-21,28
Glentoran,4446,7,6,6,10,24,32,-8,24
Dungannon,4446,8,2,4,16,14,47,-33,10
Coleraine,4447,1,15,10,1,44,22,22,55
Crusaders,4447,2,16,6,4,62,32,30,54
Glenavon,4447,3,9,9,8,52,44,8,36
Linfield,4447,4,10,6,10,38,37,1,36
Cliftonville,4447,5,9,5,12,33,32,1,32
Ballymena,4447,6,8,4,14,27,48,-21,28
Glentoran,4447,7,6,6,10,24,32,-8,24
Dungannon,4447,8,2,4,16,14,47,-33,10
Crusaders,4448,1,17,6,3,63,31,32,57
Coleraine,4448,2,14,10,2,44,26,18,52
Glenavon,4448,3,10,9,7,56,44,12,39
Linfield,4448,4,10,6,10,37,36,1,36
Cliftonville,4448,5,9,5,12,32,31,1,32
Ballymena,4448,6,7,4,15,26,49,-23,25
Glentoran,4448,7,6,6,10,24,32,-8,24
Dungannon,4448,8,2,4,16,14,47,-33,10
Crusaders,4449,1,17,6,3,65,30,35,57
Coleraine,4449,2,14,11,1,45,24,21,53
Linfield,4449,3,11,5,10,40,38,2,38
Glenavon,4449,4,9,10,7,54,45,9,37
Cliftonville,4449,5,9,4,13,34,34,0,31
Ballymena,4449,6,7,4,15,25,51,-26,25
Glentoran,4449,7,6,6,10,24,32,-8,24
Dungannon,4449,8,2,4,16,14,47,-33,10
Crusaders,4450,1,17,6,3,65,32,33,57
Coleraine,4450,2,15,10,1,46,22,24,55
Linfield,4450,3,11,5,10,42,37,5,38
Glenavon,4450,4,9,9,8,52,46,6,36
Cliftonville,4450,5,9,4,13,33,36,-3,31
Ballymena,4450,6,7,4,15,27,51,-24,25
Glentoran,4450,7,6,6,10,24,32,-8,24
Dungannon,4450,8,2,4,16,14,47,-33,10
Crusaders,4451,1,17,6,3,64,32,32,57
Coleraine,4451,2,14,11,1,45,24,21,53
Linfield,4451,3,11,5,10,39,36,3,38
Glenavon,4451,4,9,10,7,54,45,9,37
Cliftonville,4451,5,9,4,13,32,33,-1,31
Ballymena,4451,6,7,4,15,27,50,-23,25
Glentoran,4451,7,6,6,10,24,32,-8,24
Dungannon,4451,8,2,4,16,14,47,-33,10
Coleraine,4452,1,15,10,1,46,24,22,55
Crusaders,4452,2,16,6,4,61,32,29,54
Linfield,4452,3,11,5,10,39,36,3,38
Glenavon,4452,4,9,9,8,54,46,8,36
Cliftonville,4452,5,9,4,13,32,33,-1,31
Ballymena,4452,6,8,4,14,27,47,-20,28
Glentoran,4452,7,6,6,10,24,32,-8,24
Dungannon,4452,8,2,4,16,14,47,-33,10
Crusaders,4453,1,16,7,3,62,31,31,55
Coleraine,4453,2,14,10,2,43,24,19,52
Glenavon,4453,3,10,9,7,54,43,11,39
Linfield,4453,4,11,5,10,40,37,3,38
Cliftonville,4453,5,9,4,13,33,34,-1,31
Ballymena,4453,6,7,5,14,26,48,-22,26
Glentoran,4453,7,6,6,10,24,32,-8,24
Dungannon,4453,8,2,4,16,14,47,-33,10
Crusaders,4454,1,17,6,3,63,30,33,57
Coleraine,4454,2,15,10,1,45,23,22,55
Linfield,4454,3,11,5,10,39,36,3,38
Glenavon,4454,4,9,9,8,53,45,8,36
Cliftonville,4454,5,9,4,13,32,33,-1,31
Ballymena,4454,6,7,4,15,25,49,-24,25
Glentoran,4454,7,6,6,10,24,32,-8,24
Dungannon,4454,8,2,4,16,14,47,-33,10
Coleraine,4455,1,15,10,1,44,22,22,55
Crusaders,4455,2,16,6,4,62,32,30,54
Glenavon,4455,3,9,9,8,52,44,8,36
Linfield,4455,4,10,5,11,39,39,0,35
Cliftonville,4455,5,10,4,12,35,33,2,34
Ballymena,4455,6,8,4,14,27,48,-21,28
Glentoran,4455,7,6,6,10,24,32,-8,24
Dungannon,4455,8,2,4,16,14,47,-33,10
Coleraine,4456,1,15,10,1,44,22,22,55
Crusaders,4456,2,16,6,4,62,33,29,54
Linfield,4456,3,11,5,10,39,36,3,38
Glenavon,4456,4,9,9,8,52,44,8,36
Cliftonville,4456,5,9,4,13,32,33,-1,31
Ballymena,4456,6,8,4,14,28,48,-20,28
Glentoran,4456,7,6,6,10,24,32,-8,24
Dungannon,4456,8,2,4,16,14,47,-33,10
Crusaders,4457,1,17,6,3,65,32,33,57
Coleraine,4457,2,14,10,2,44,25,19,52
Glenavon,4457,3,10,9,7,55,44,11,39
Linfield,4457,4,10,5,11,37,38,-1,35
Cliftonville,4457,5,10,4,12,34,31,3,34
Ballymena,4457,6,7,4,15,27,51,-24,25
Glentoran,4457,7,6,6,10,24,32,-8,24
Dungannon,4457,8,2,4,16,14,47,-33,10
Crusaders,4458,1,16,7,3,62,31,31,55
Coleraine,4458,2,14,10,2,45,26,19,52
Glenavon,4458,3,10,9,7,56,45,11,39
Linfield,4458,4,11,5,10,39,37,2,38
Cliftonville,4458,5,9,4,13,33,33,0,31
Ballymena,4458,6,7,5,14,26,48,-22,26
Glentoran,4458,7,6,6,10,24,32,-8,24
Dungannon,4458,8,2,4,16,14,47,-33,10
Crusaders,4459,1,17,6,3,62,30,32,57
Coleraine,4459,2,14,10,2,43,24,19,52
Glenavon,4459,3,10,9,7,54,43,11,39
Linfield,4459,4,11,5,10,38,36,2,38
Cliftonville,4459,5,9,4,13,32,32,0,31
Ballymena,4459,6,7,4,15,25,48,-23,25
Glentoran,4459,7,6,6,10,24,32,-8,24
Dungannon,4459,8,2,4,16,14,47,-33,10
Coleraine,4460,1,15,10,1,46,22,24,55
Crusaders,4460,2,16,6,4,62,33,29,54
Linfield,4460,3,11,5,10,39,37,2,38
Glenavon,4460,4,9,9,8,52,46,6,36
Cliftonville,4460,5,9,4,13,33,33,0,31
Ballymena,4460,6,8,4,14,28,48,-20,28
Glentoran,4460,7,6,6,10,24,32,-8,24
Dungannon,4460,8,2,4,16,14,47,-33,10
Crusaders,4461,1,17,6,3,64,32,32,57
Coleraine,4461,2,15,10,1,45,22,23,55
Linfield,4461,3,11,5,10,40,36,4,38
Glenavon,4461,4,9,9,8,52,45,7,36
Cliftonville,4461,5,9,4,13,32,34,-2,31
Ballymena,4461,6,7,4,15,27,50,-23,25
Glentoran,4461,7,6,6,10,24,32,-8,24
Dungannon,4461,8,2,4,16,14,47,-33,10
Crusaders,4462,1,17,6,3,64,30,34,57
Coleraine,4462,2,14,11,1,46,25,21,53
Linfield,4462,3,11,5,10,40,38,2,38
Glenavon,4462,4,9,10,7,55,46,9,37
Cliftonville,4462,5,9,4,13,34,34,0,31
Ballymena,4462,6,7,4,15,25,50,-25,25
Glentoran,4462,7,6,6,10,24,32,-8,24
Dungannon,4462,8,2,4,16,14,47,-33,10
Crusaders,4463,1,16,7,3,62,31,31,55
Coleraine,4463,2,14,11,1,43,22,21,53
Glenavon,4463,3,9,10,7,52,43,9,37
Linfield,4463,4,10,5,11,39,40,-1,35
Cliftonville,4463,5,10,4,12,36,33,3,34
Ballymena,4463,6,7,5,14,26,48,-22,26
Glentoran,4463,7,6,6,10,24,32,-8,24
Dungannon,4463,8,2,4,16,14,47,-33,10
Crusaders,4464,1,16,7,3,61,30,31,55
Coleraine,4464,2,14,10,2,43,23,20,52
Glenavon,4464,3,10,9,7,53,43,10,39
Linfield,4464,4,11,5,10,41,38,3,38
Cliftonville,4464,5,9,4,13,34,35,-1,31
Ballymena,4464,6,7,5,14,25,47,-22,26
Glentoran,4464,7,6,6,10,24,32,-8,24
Dungannon,4464,8,2,4,16,14,47,-33,10
Crusaders,4465,1,16,7,3,61,30,31,55
Coleraine,4465,2,14,10,2,45,26,19,52
Glenavon,4465,3,10,9,7,56,45,11,39
Linfield,4465,4,10,6,10,37,36,1,36
Cliftonville,4465,5,9,5,12,32,31,1,32
Ballymena,4465,6,7,5,14,25,47,-22,26
Glentoran,4465,7,6,6,10,24,32,-8,24
Dungannon,4465,8,2,4,16,14,47,-33,10
Coleraine,4466,1,15,10,1,45,23,22,55
Crusaders,4466,2,16,6,4,62,32,30,54
Linfield,4466,3,11,5,10,40,36,4,38
Glenavon,4466,4,9,9,8,53,45,8,36
Cliftonville,4466,5,9,4,13,32,34,-2,31
Ballymena,4466,6,8,4,14,27,48,-21,28
Glentoran,4466,7,6,6,10,24,32,-8,24
Dungannon,4466,8,2,4,16,14,47,-33,10
Crusaders,4467,1,17,6,3,63,30,33,57
Coleraine,4467,2,14,10,2,44,24,20,52
Glenavon,4467,3,10,9,7,54,44,10,39
Linfield,4467,4,10,5,11,37,38,-1,35
Cliftonville,4467,5,10,4,12,34,31,3,34
Ballymena,4467,6,7,4,15,25,49,-24,25
Glentoran,4467,7,6,6,10,24,32,-8,24
Dungannon,4467,8,2,4,16,14,47,-33,10
Crusaders,4468,1,17,6,3,63,30,33,57
Coleraine,4468,2,15,10,1,46,22,24,55
Glenavon,4468,3,9,9,8,52,46,6,36
Linfield,4468,4,10,5,11,37,37,0,35
Cliftonville,4468,5,10,4,12,33,31,2,34
Ballymena,4468,6,7,4,15,25,49,-24,25
Glentoran,4468,7,6,6,10,24,32,-8,24
Dungannon,4468,8,2,4,16,14,47,-33,10
Crusaders,4469,1,16,7,3,61,30,31,55
Coleraine,4469,2,14,10,2,45,25,20,52
Glenavon,4469,3,10,9,7,55,45,10,39
Linfield,4469,4,10,6,10,38,37,1,36
Cliftonville,4469,5,9,5,12,33,32,1,32
Ballymena,4469,6,7,5,14,25,47,-22,26
Glentoran,4469,7,6,6,10,24,32,-8,24
Dungannon,4469,8,2,4,16,14,47,-33,10
Crusaders,4470,1,17,6,3,66,30,36,57
Coleraine,4470,2,15,10,1,47,23,24,55
Linfield,4470,3,11,5,10,38,36,2,38
Glenavon,4470,4,9,9,8,53,47,6,36
Cliftonville,4470,5,9,4,13,32,32,0,31
Ballymena,4470,6,7,4,15,25,52,-27,25
Glentoran,4470,7,6,6,10,24,32,-8,24
Dungannon,4470,8,2,4,16,14,47,-33,10
Crusaders,4471,1,17,6,3,64,30,34,57
Coleraine,4471,2,14,10,2,43,25,18,52
Glenavon,4471,3,10,9,7,55,43,12,39
Linfield,4471,4,10,6,10,37,36,1,36
Cliftonville,4471,5,9,5,12,32,31,1,32
Ballymena,4471,6,7,4,15,25,50,-25,25
Glentoran,4471,7,6,6,10,24,32,-8,24
Dungannon,4471,8,2,4,16,14,47,-33,10
Crusaders,4472,1,17,6,3,64,30,34,57
Coleraine,4472,2,14,10,2,45,28,17,52
Glenavon,4472,3,10,9,7,58,45,13,39
Linfield,4472,4,11,5,10,38,36,2,38
Cliftonville,4472,5,9,4,13,32,32,0,31
Ballymena,4472,6,7,4,15,25,50,-25,25
Glentoran,4472,7,6,6,10,24,32,-8,24
Dungannon,4472,8,2,4,16,14,47,-33,10
Crusaders,4473,1,17,6,3,63,31,32,57
Coleraine,4473,2,15,10,1,45,23,22,55
Linfield,4473,3,11,5,10,41,38,3,38
Glenavon,4473,4,9,9,8,53,45,8,36
Cliftonville,4473,5,9,4,13,34,35,-1,31
Ballymena,4473,6,7,4,15,26,49,-23,25
Glentoran,4473,7,6,6,10,24,32,-8,24
Dungannon,4473,8,2,4,16,14,47,-33,10
Crusaders,4474,1,17,6,3,62,30,32,57
Coleraine,4474,2,15,10,1,45,23,22,55
Linfield,4474,3,11,5,10,38,36,2,38
Glenavon,4474,4,9,9,8,53,45,8,36
Cliftonville,4474,5,9,4,13,32,32,0,31
Ballymena,4474,6,7,4,15,25,48,-23,25
Glentoran,4474,7,6,6,10,24,32,-8,24
Dungannon,4474,8,2,4,16,14,47,-33,10
Crusaders,4475,1,17,6,3,63,30,33,57
Coleraine,4475,2,15,10,1,45,23,22,55
Linfield,4475,3,11,5,10,39,36,3,38
Glenavon,4475,4,9,9,8,53,45,8,36
Cliftonville,4475,5,9,4,13,32,33,-1,31
Ballymena,4475,6,7,4,15,25,49,-24,25
Glentoran,4475,7,6,6,10,24,32,-8,24
Dungannon,4475,8,2,4,16,14,47,-33,10
Crusaders,4476,1,17,6,3,64,30,34,57
Coleraine,4476,2,15,10,1,46,24,22,55
Glenavon,4476,3,9,9,8,54,46,8,36
Linfield,4476,4,10,5,11,38,38,0,35
Cliftonville,4476,5,10,4,12,34,32,2,34
Ballymena,4476,6,7,4,15,25,50,-25,25
Glentoran,4476,7,6,6,10,24,32,-8,24
Dungannon,4476,8,2,4,16,14,47,-33,10
Coleraine,4477,1,15,10,1,45,22,23,55
Crusaders,4477,2,16,6,4,62,34,28,54
Linfield,4477,3,11,5,10,38,36,2,38
Glenavon,4477,4,9,9,8,52,45,7,36
Cliftonville,4477,5,9,4,13,32,32,0,31
Ballymena,4477,6,8,4,14,29,48,-19,28
Glentoran,4477,7,6,6,10,24,32,-8,24
Dungannon,4477,8,2,4,16,14,47,-33,10
Crusaders,4478,1,17,6,3,63,31,32,57
Coleraine,4478,2,14,10,2,43,26,17,52
Glenavon,4478,3,10,9,7,56,43,13,39
Linfield,4478,4,11,5,10,39,37,2,38
Cliftonville,4478,5,9,4,13,33,33,0,31
Ballymena,4478,6,7,4,15,26,49,-23,25
Glentoran,4478,7,6,6,10,24,32,-8,24
Dungannon,4478,8,2,4,16,14,47,-33,10
Crusaders,4479,1,16,7,3,61,30,31,55
Coleraine,4479,2,15,10,1,44,22,22,55
Glenavon,4479,3,9,9,8,52,44,8,36
Linfield,4479,4,10,5,11,37,37,0,35
Cliftonville,4479,5,10,4,12,33,31,2,34
Ballymena,4479,6,7,5,14,25,47,-22,26
Glentoran,4479,7,6,6,10,24,32,-8,24
Dungannon,4479,8,2,4,16,14,47,-33,10
Crusaders,4480,1,16,7,3,62,31,31,55
Coleraine,4480,2,14,11,1,43,22,21,53
Glenavon,4480,3,9,10,7,52,43,9,37
Linfield,4480,4,10,6,10,37,36,1,36
Cliftonville,4480,5,9,5,12,32,31,1,32
Ballymena,4480,6,7,5,14,26,48,-22,26
Glentoran,4480,7,6,6,10,24,32,-8,24
Dungannon,4480,8,2,4,16,14,47,-33,10
Coleraine,4481,1,15,10,1,47,24,23,55
Crusaders,4481,2,16,6,4,61,31,30,54
Linfield,4481,3,11,5,10,39,36,3,38
Glenavon,4481,4,9,9,8,54,47,7,36
Cliftonville,4481,5,9,4,13,32,33,-1,31
Ballymena,4481,6,8,4,14,26,47,-21,28
Glentoran,4481,7,6,6,10,24,32,-8,24
Dungannon,4481,8,2,4,16,14,47,-33,10
Crusaders,4482,1,17,6,3,63,31,32,57
Coleraine,4482,2,15,10,1,45,23,22,55
Linfield,4482,3,11,5,10,40,37,3,38
Glenavon,4482,4,9,9,8,53,45,8,36
Cliftonville,4482,5,9,4,13,33,34,-1,31
Ballymena,4482,6,7,4,15,26,49,-23,25
Glentoran,4482,7,6,6,10,24,32,-8,24
Dungannon,4482,8,2,4,16,14,47,-33,10
Crusaders,4483,1,17,6,3,66,31,35,57
Coleraine,4483,2,15,10,1,46,24,22,55
Linfield,4483,3,11,5,10,40,37,3,38
Glenavon,4483,4,9,9,8,54,46,8,36
Cliftonville,4483,5,9,4,13,33,34,-1,31
Ballymena,4483,6,7,4,15,26,52,-26,25
Glentoran,4483,7,6,6,10,24,32,-8,24
Dungannon,4483,8,2,4,16,14,47,-33,10
Crusaders,4484,1,16,7,3,61,30,31,55
Coleraine,4484,2,15,10,1,47,25,22,55
Glenavon,4484,3,9,9,8,55,47,8,36
Linfield,4484,4,10,5,11,38,38,0,35
Cliftonville,4484,5,10,4,12,34,32,2,34
Ballymena,4484,6,7,5,14,25,47,-22,26
Glentoran,4484,7,6,6,10,24,32,-8,24
Dungannon,4484,8,2,4,16,14,47,-33,10
Crusaders,4485,1,17,6,3,65,31,34,57
Coleraine,4485,2,15,10,1,48,25,23,55
Glenavon,4485,3,9,9,8,55,48,7,36
Linfield,4485,4,10,6,10,38,37,1,36
Cliftonville,4485,5,9,5,12,33,32,1,32
Ballymena,4485,6,7,4,15,26,51,-25,25
Glentoran,4485,7,6,6,10,24,32,-8,24
Dungannon,4485,8,2,4,16,14,47,-33,10
Crusaders,4486,1,17,6,3,64,30,34,57
Coleraine,4486,2,15,10,1,45,23,22,55
Glenavon,4486,3,9,9,8,53,45,8,36
Linfield,4486,4,10,5,11,38,38,0,35
Cliftonville,4486,5,10,4,12,34,32,2,34
Ballymena,4486,6,7,4,15,25,50,-25,25
Glentoran,4486,7,6,6,10,24,32,-8,24
Dungannon,4486,8,2,4,16,14,47,-33,10
Crusaders,4487,1,16,7,3,62,31,31,55
Coleraine,4487,2,14,10,2,45,25,20,52
Glenavon,4487,3,10,9,7,55,45,10,39
Linfield,4487,4,10,6,10,38,37,1,36
Cliftonville,4487,5,9,5,12,33,32,1,32
Ballymena,4487,6,7,5,14,26,48,-22,26
Glentoran,4487,7,6,6,10,24,32,-8,24
Dungannon,4487,8,2,4,16,14,47,-33,10
Crusaders,4488,1,17,6,3,62,30,32,57
Coleraine,4488,2,14,11,1,44,23,21,53
Glenavon,4488,3,9,10,7,53,44,9,37
Linfield,4488,4,10,5,11,37,37,0,35
Cliftonville,4488,5,10,4,12,33,31,2,34
Ballymena,4488,6,7,4,15,25,48,-23,25
Glentoran,4488,7,6,6,10,24,32,-8,24
Dungannon,4488,8,2,4,16,14,47,-33,10
Crusaders,4489,1,17,6,3,62,30,32,57
Coleraine,4489,2,15,10,1,46,24,22,55
Glenavon,4489,3,9,9,8,54,46,8,36
Linfield,4489,4,10,5,11,37,37,0,35
Cliftonville,4489,5,10,4,12,33,31,2,34
Ballymena,4489,6,7,4,15,25,48,-23,25
Glentoran,4489,7,6,6,10,24,32,-8,24
Dungannon,4489,8,2,4,16,14,47,-33,10
Crusaders,4490,1,16,6,4,62,32,30,54
Coleraine,4490,2,14,11,1,45,24,21,53
Linfield,4490,3,11,5,10,39,37,2,38
Glenavon,4490,4,9,10,7,54,45,9,37
Cliftonville,4490,5,9,4,13,33,33,0,31
Ballymena,4490,6,8,4,14,27,48,-21,28
Glentoran,4490,7,6,6,10,24,32,-8,24
Dungannon,4490,8,2,4,16,14,47,-33,10
Crusaders,4491,1,17,6,3,63,31,32,57
Coleraine,4491,2,15,10,1,47,24,23,55
Linfield,4491,3,11,5,10,40,37,3,38
Glenavon,4491,4,9,9,8,54,47,7,36
Cliftonville,4491,5,9,4,13,33,34,-1,31
Ballymena,4491,6,7,4,15,26,49,-23,25
Glentoran,4491,7,6,6,10,24,32,-8,24
Dungannon,4491,8,2,4,16,14,47,-33,10
Crusaders,4492,1,17,6,3,63,30,33,57
Coleraine,4492,2,14,10,2,43,24,19,52
Glenavon,4492,3,10,9,7,54,43,11,39
Linfield,4492,4,10,6,10,37,36,1,36
Cliftonville,4492,5,9,5,12,32,31,1,32
Ballymena,4492,6,7,4,15,25,49,-24,25
Glentoran,4492,7,6,6,10,24,32,-8,24
Dungannon,4492,8,2,4,16,14,47,-33,10
Coleraine,4493,1,15,10,1,45,22,23,55
Crusaders,4493,2,16,6,4,62,32,30,54
Glenavon,4493,3,9,9,8,52,45,7,36
Linfield,4493,4,10,5,11,37,37,0,35
Cliftonville,4493,5,10,4,12,33,31,2,34
Ballymena,4493,6,8,4,14,27,48,-21,28
Glentoran,4493,7,6,6,10,24,32,-8,24
Dungannon,4493,8,2,4,16,14,47,-33,10
Crusaders,4494,1,17,6,3,63,31,32,57
Coleraine,4494,2,15,10,1,45,22,23,55
Glenavon,4494,3,9,9,8,52,45,7,36
Linfield,4494,4,10,6,10,39,38,1,36
Cliftonville,4494,5,9,5,12,34,33,1,32
Ballymena,4494,6,7,4,15,26,49,-23,25
Glentoran,4494,7,6,6,10,24,32,-8,24
Dungannon,4494,8,2,4,16,14,47,-33,10
Crusaders,4495,1,17,6,3,63,30,33,57
Coleraine,4495,2,14,10,2,44,26,18,52
Glenavon,4495,3,10,9,7,56,44,12,39
Linfield,4495,4,11,5,10,39,36,3,38
Cliftonville,4495,5,9,4,13,32,33,-1,31
Ballymena,4495,6,7,4,15,25,49,-24,25
Glentoran,4495,7,6,6,10,24,32,-8,24
Dungannon,4495,8,2,4,16,14,47,-33,10
Crusaders,4496,1,17,6,3,64,30,34,57
Coleraine,4496,2,14,10,2,44,26,18,52
Glenavon,4496,3,10,9,7,56,44,12,39
Linfield,4496,4,10,5,11,37,37,0,35
Cliftonville,4496,5,10,4,12,33,31,2,34
Ballymena,4496,6,7,4,15,25,50,-25,25
Glentoran,4496,7,6,6,10,24,32,-8,24
Dungannon,4496,8,2,4,16,14,47,-33,10
Crusaders,4497,1,17,6,3,65,32,33,57
Coleraine,4497,2,14,10,2,46,26,20,52
Glenavon,4497,3,10,9,7,56,46,10,39
Linfield,4497,4,10,5,11,37,39,-2,35
Cliftonville,4497,5,10,4,12,35,31,4,34
Ballymena,4497,6,7,4,15,27,51,-24,25
Glentoran,4497,7,6,6,10,24,32,-8,24
Dungannon,4497,8,2,4,16,14,47,-33,10
Crusaders,4498,1,17,6,3,65,31,34,57
Coleraine,4498,2,14,11,1,45,24,21,53
Glenavon,4498,3,9,10,7,54,45,9,37
Linfield,4498,4,10,5,11,38,38,0,35
Cliftonville,4498,5,10,4,12,34,32,2,34
Ballymena,4498,6,7,4,15,26,51,-25,25
Glentoran,4498,7,6,6,10,24,32,-8,24
Dungannon,4498,8,2,4,16,14,47,-33,10
Crusaders,4499,1,16,6,4,61,32,29,54
Coleraine,4499,2,14,10,2,43,23,20,52
Glenavon,4499,3,10,9,7,53,43,10,39
Linfield,4499,4,11,5,10,41,37,4,38
Cliftonville,4499,5,9,4,13,33,35,-2,31
Ballymena,4499,6,8,4,14,27,47,-20,28
Glentoran,4499,7,6,6,10,24,32,-8,24
Dungannon,4499,8,2,4,16,14,47,-33,10
Crusaders,4500,1,17,6,3,63,30,33,57
Coleraine,4500,2,14,10,2,43,24,19,52
Glenavon,4500,3,10,9,7,54,43,11,39
Linfield,4500,4,10,6,10,39,38,1,36
Cliftonville,4500,5,9,5,12,34,33,1,32
Ballymena,4500,6,7,4,15,25,49,-24,25
Glentoran,4500,7,6,6,10,24,32,-8,24
Dungannon,4500,8,2,4,16,14,47,-33,10
Crusaders,4501,1,17,6,3,64,32,32,57
Coleraine,4501,2,14,11,1,45,24,21,53
Glenavon,4501,3,9,10,7,54,45,9,37
Linfield,4501,4,10,5,11,37,37,0,35
Cliftonville,4501,5,10,4,12,33,31,2,34
Ballymena,4501,6,7,4,15,27,50,-23,25
Glentoran,4501,7,6,6,10,24,32,-8,24
Dungannon,4501,8,2,4,16,14,47,-33,10
Crusaders,4502,1,16,6,4,63,33,30,54
Coleraine,4502,2,14,11,1,43,22,21,53
Glenavon,4502,3,9,10,7,52,43,9,37
Linfield,4502,4,10,6,10,39,38,1,36
Cliftonville,4502,5,9,5,12,34,33,1,32
Ballymena,4502,6,8,4,14,28,49,-21,28
Glentoran,4502,7,6,6,10,24,32,-8,24
Dungannon,4502,8,2,4,16,14,47,-33,10
Crusaders,4503,1,17,6,3,63,30,33,57
Coleraine,4503,2,15,10,1,46,24,22,55
Glenavon,4503,3,9,9,8,54,46,8,36
Linfield,4503,4,10,6,10,39,38,1,36
Cliftonville,4503,5,9,5,12,34,33,1,32
Ballymena,4503,6,7,4,15,25,49,-24,25
Glentoran,4503,7,6,6,10,24,32,-8,24
Dungannon,4503,8,2,4,16,14,47,-33,10
Crusaders,4504,1,16,6,4,63,33,30,54
Coleraine,4504,2,14,10,2,43,24,19,52
Glenavon,4504,3,10,9,7,54,43,11,39
Linfield,4504,4,11,5,10,38,36,2,38
Cliftonville,4504,5,9,4,13,32,32,0,31
Ballymena,4504,6,8,4,14,28,49,-21,28
Glentoran,4504,7,6,6,10,24,32,-8,24
Dungannon,4504,8,2,4,16,14,47,-33,10
Crusaders,4505,1,16,6,4,63,33,30,54
Coleraine,4505,2,14,10,2,43,23,20,52
Glenavon,4505,3,10,9,7,53,43,10,39
Linfield,4505,4,11,5,10,39,36,3,38
Cliftonville,4505,5,9,4,13,32,33,-1,31
Ballymena,4505,6,8,4,14,28,49,-21,28
Glentoran,4505,7,6,6,10,24,32,-8,24
Dungannon,4505,8,2,4,16,14,47,-33,10
Crusaders,4506,1,17,6,3,63,30,33,57
Coleraine,4506,2,15,10,1,48,25,23,55
Glenavon,4506,3,9,9,8,55,48,7,36
Linfield,4506,4,10,5,11,39,39,0,35
Cliftonville,4506,5,10,4,12,35,33,2,34
Ballymena,4506,6,7,4,15,25,49,-24,25
Glentoran,4506,7,6,6,10,24,32,-8,24
Dungannon,4506,8,2,4,16,14,47,-33,10
Crusaders,4507,1,17,6,3,64,30,34,57
Coleraine,4507,2,15,10,1,45,23,22,55
Linfield,4507,3,11,5,10,38,36,2,38
Glenavon,4507,4,9,9,8,53,45,8,36
Cliftonville,4507,5,9,4,13,32,32,0,31
Ballymena,4507,6,7,4,15,25,50,-25,25
Glentoran,4507,7,6,6,10,24,32,-8,24
Dungannon,4507,8,2,4,16,14,47,-33,10
Crusaders,4508,1,16,6,4,62,32,30,54
Coleraine,4508,2,14,10,2,45,27,18,52
Glenavon,4508,3,10,9,7,57,45,12,39
Linfield,4508,4,11,5,10,38,36,2,38
Cliftonville,4508,5,9,4,13,32,32,0,31
Ballymena,4508,6,8,4,14,27,48,-21,28
Glentoran,4508,7,6,6,10,24,32,-8,24
Dungannon,4508,8,2,4,16,14,47,-33,10
Crusaders,4509,1,17,6,3,62,30,32,57
Coleraine,4509,2,14,10,2,43,23,20,52
Glenavon,4509,3,10,9,7,53,43,10,39
Linfield,4509,4,11,5,10,39,37,2,38
Cliftonville,4509,5,9,4,13,33,33,0,31
Ballymena,4509,6,7,4,15,25,48,-23,25
Glentoran,4509,7,6,6,10,24,32,-8,24
Dungannon,4509,8,2,4,16,14,47,-33,10
Crusaders,4510,1,16,6,4,61,34,27,54
Coleraine,4510,2,14,10,2,43,25,18,52
Glenavon,4510,3,10,9,7,55,43,12,39
Linfield,4510,4,10,5,11,38,38,0,35
Cliftonville,4510,5,10,4,12,34,32,2,34
Ballymena,4510,6,8,4,14,29,47,-18,28
Glentoran,4510,7,6,6,10,24,32,-8,24
Dungannon,4510,8,2,4,16,14,47,-33,10
Coleraine,4511,1,15,10,1,45,22,23,55
Crusaders,4511,2,16,6,4,62,32,30,54
Glenavon,4511,3,9,9,8,52,45,7,36
Linfield,4511,4,10,5,11,38,38,0,35
Cliftonville,4511,5,10,4,12,34,32,2,34
Ballymena,4511,6,8,4,14,27,48,-21,28
Glentoran,4511,7,6,6,10,24,32,-8,24
Dungannon,4511,8,2,4,16,14,47,-33,10
Crusaders,4512,1,16,7,3,62,31,31,55
Coleraine,4512,2,14,10,2,43,25,18,52
Glenavon,4512,3,10,9,7,55,43,12,39
Linfield,4512,4,11,5,10,41,38,3,38
Cliftonville,4512,5,9,4,13,34,35,-1,31
Ballymena,4512,6,7,5,14,26,48,-22,26
Glentoran,4512,7,6,6,10,24,32,-8,24
Dungannon,4512,8,2,4,16,14,47,-33,10
Crusaders,4513,1,17,6,3,66,33,33,57
Coleraine,4513,2,14,11,1,45,24,21,53
Glenavon,4513,3,9,10,7,54,45,9,37
Linfield,4513,4,10,5,11,38,38,0,35
Cliftonville,4513,5,10,4,12,34,32,2,34
Ballymena,4513,6,7,4,15,28,52,-24,25
Glentoran,4513,7,6,6,10,24,32,-8,24
Dungannon,4513,8,2,4,16,14,47,-33,10
Crusaders,4514,1,16,6,4,62,33,29,54
Coleraine,4514,2,14,11,1,45,24,21,53
Glenavon,4514,3,9,10,7,54,45,9,37
Linfield,4514,4,10,5,11,38,39,-1,35
Cliftonville,4514,5,10,4,12,35,32,3,34
Ballymena,4514,6,8,4,14,28,48,-20,28
Glentoran,4514,7,6,6,10,24,32,-8,24
Dungannon,4514,8,2,4,16,14,47,-33,10
Crusaders,4515,1,16,7,3,62,31,31,55
Coleraine,4515,2,14,10,2,43,25,18,52
Glenavon,4515,3,10,9,7,55,43,12,39
Linfield,4515,4,10,6,10,39,38,1,36
Cliftonville,4515,5,9,5,12,34,33,1,32
Ballymena,4515,6,7,5,14,26,48,-22,26
Glentoran,4515,7,6,6,10,24,32,-8,24
Dungannon,4515,8,2,4,16,14,47,-33,10
Crusaders,4516,1,16,7,3,62,31,31,55
Coleraine,4516,2,14,11,1,45,24,21,53
Linfield,4516,3,11,5,10,38,36,2,38
Glenavon,4516,4,9,10,7,54,45,9,37
Cliftonville,4516,5,9,4,13,32,32,0,31
Ballymena,4516,6,7,5,14,26,48,-22,26
Glentoran,4516,7,6,6,10,24,32,-8,24
Dungannon,4516,8,2,4,16,14,47,-33,10
Crusaders,4517,1,17,6,3,62,30,32,57
Coleraine,4517,2,14,10,2,44,25,19,52
Glenavon,4517,3,10,9,7,55,44,11,39
Linfield,4517,4,10,6,10,37,36,1,36
Cliftonville,4517,5,9,5,12,32,31,1,32
Ballymena,4517,6,7,4,15,25,48,-23,25
Glentoran,4517,7,6,6,10,24,32,-8,24
Dungannon,4517,8,2,4,16,14,47,-33,10
Crusaders,4518,1,16,6,4,62,33,29,54
Coleraine,4518,2,14,11,1,43,22,21,53
Linfield,4518,3,11,5,10,41,37,4,38
Glenavon,4518,4,9,10,7,52,43,9,37
Cliftonville,4518,5,9,4,13,33,35,-2,31
Ballymena,4518,6,8,4,14,28,48,-20,28
Glentoran,4518,7,6,6,10,24,32,-8,24
Dungannon,4518,8,2,4,16,14,47,-33,10
Crusaders,4519,1,17,6,3,62,30,32,57
Coleraine,4519,2,14,11,1,43,22,21,53
Linfield,4519,3,11,5,10,38,36,2,38
Glenavon,4519,4,9,10,7,52,43,9,37
Cliftonville,4519,5,9,4,13,32,32,0,31
Ballymena,4519,6,7,4,15,25,48,-23,25
Glentoran,4519,7,6,6,10,24,32,-8,24
Dungannon,4519,8,2,4,16,14,47,-33,10
Crusaders,4520,1,17,6,3,65,31,34,57
Coleraine,4520,2,14,11,1,44,23,21,53
Glenavon,4520,3,9,10,7,53,44,9,37
Linfield,4520,4,10,6,10,38,37,1,36
Cliftonville,4520,5,9,5,12,33,32,1,32
Ballymena,4520,6,7,4,15,26,51,-25,25
Glentoran,4520,7,6,6,10,24,32,-8,24
Dungannon,4520,8,2,4,16,14,47,-33,10
Crusaders,4521,1,17,6,3,64,30,34,57
Coleraine,4521,2,14,11,1,44,23,21,53
Linfield,4521,3,11,5,10,39,37,2,38
Glenavon,4521,4,9,10,7,53,44,9,37
Cliftonville,4521,5,9,4,13,33,33,0,31
Ballymena,4521,6,7,4,15,25,50,-25,25
Glentoran,4521,7,6,6,10,24,32,-8,24
Dungannon,4521,8,2,4,16,14,47,-33,10
Crusaders,4522,1,17,6,3,63,31,32,57
Coleraine,4522,2,14,10,2,43,25,18,52
Glenavon,4522,3,10,9,7,55,43,12,39
Linfield,4522,4,11,5,10,38,36,2,38
Cliftonville,4522,5,9,4,13,32,32,0,31
Ballymena,4522,6,7,4,15,26,49,-23,25
Glentoran,4522,7,6,6,10,24,32,-8,24
Dungannon,4522,8,2,4,16,14,47,-33,10
Crusaders,4523,1,17,6,3,64,30,34,57
Coleraine,4523,2,14,10,2,43,23,20,52
Glenavon,4523,3,10,9,7,53,43,10,39
Linfield,4523,4,11,5,10,40,37,3,38
Cliftonville,4523,5,9,4,13,33,34,-1,31
Ballymena,4523,6,7,4,15,25,50,-25,25
Glentoran,4523,7,6,6,10,24,32,-8,24
Dungannon,4523,8,2,4,16,14,47,-33,10
Crusaders,4524,1,17,6,3,63,31,32,57
Coleraine,4524,2,15,10,1,44,22,22,55
Glenavon,4524,3,9,9,8,52,44,8,36
Linfield,4524,4,10,5,11,38,39,-1,35
Cliftonville,4524,5,10,4,12,35,32,3,34
Ballymena,4524,6,7,4,15,26,49,-23,25
Glentoran,4524,7,6,6,10,24,32,-8,24
Dungannon,4524,8,2,4,16,14,47,-33,10
Crusaders,4525,1,16,7,3,62,31,31,55
Coleraine,4525,2,14,11,1,47,26,21,53
Glenavon,4525,3,9,10,7,56,47,9,37
Linfield,4525,4,10,5,11,37,37,0,35
Cliftonville,4525,5,10,4,12,33,31,2,34
Ballymena,4525,6,7,5,14,26,48,-22,26
Glentoran,4525,7,6,6,10,24,32,-8,24
Dungannon,4525,8,2,4,16,14,47,-33,10
Crusaders,4526,1,17,6,3,62,30,32,57
Coleraine,4526,2,15,10,1,45,23,22,55
Linfield,4526,3,11,5,10,38,36,2,38
Glenavon,4526,4,9,9,8,53,45,8,36
Cliftonville,4526,5,9,4,13,32,32,0,31
Ballymena,4526,6,7,4,15,25,48,-23,25
Glentoran,4526,7,6,6,10,24,32,-8,24
Dungannon,4526,8,2,4,16,14,47,-33,10
Crusaders,4527,1,16,7,3,62,31,31,55
Coleraine,4527,2,14,11,1,44,23,21,53
Glenavon,4527,3,9,10,7,53,44,9,37
Linfield,4527,4,10,6,10,38,37,1,36
Cliftonville,4527,5,9,5,12,33,32,1,32
Ballymena,4527,6,7,5,14,26,48,-22,26
Glentoran,4527,7,6,6,10,24,32,-8,24
Dungannon,4527,8,2,4,16,14,47,-33,10
Crusaders,4528,1,16,7,3,62,31,31,55
Coleraine,4528,2,14,11,1,45,24,21,53
Linfield,4528,3,11,5,10,39,37,2,38
Glenavon,4528,4,9,10,7,54,45,9,37
Cliftonville,4528,5,9,4,13,33,33,0,31
Ballymena,4528,6,7,5,14,26,48,-22,26
Glentoran,4528,7,6,6,10,24,32,-8,24
Dungannon,4528,8,2,4,16,14,47,-33,10
Crusaders,4529,1,16,7,3,63,32,31,55
Coleraine,4529,2,14,11,1,45,24,21,53
Linfield,4529,3,11,5,10,39,36,3,38
Glenavon,4529,4,9,10,7,54,45,9,37
Cliftonville,4529,5,9,4,13,32,33,-1,31
Ballymena,4529,6,7,5,14,27,49,-22,26
Glentoran,4529,7,6,6,10,24,32,-8,24
Dungannon,4529,8,2,4,16,14,47,-33,10
Crusaders,4530,1,17,6,3,63,30,33,57
Coleraine,4530,2,14,11,1,44,23,21,53
Glenavon,4530,3,9,10,7,53,44,9,37
Linfield,4530,4,10,6,10,38,37,1,36
Cliftonville,4530,5,9,5,12,33,32,1,32
Ballymena,4530,6,7,4,15,25,49,-24,25
Glentoran,4530,7,6,6,10,24,32,-8,24
Dungannon,4530,8,2,4,16,14,47,-33,10
Crusaders,4531,1,16,7,3,62,31,31,55
Coleraine,4531,2,14,11,1,43,22,21,53
Glenavon,4531,3,9,10,7,52,43,9,37
Linfield,4531,4,10,6,10,37,36,1,36
Cliftonville,4531,5,9,5,12,32,31,1,32
Ballymena,4531,6,7,5,14,26,48,-22,26
Glentoran,4531,7,6,6,10,24,32,-8,24
Dungannon,4531,8,2,4,16,14,47,-33,10
Crusaders,4532,1,17,6,3,64,31,33,57
Coleraine,4532,2,14,10,2,44,25,19,52
Glenavon,4532,3,10,9,7,55,44,11,39
Linfield,4532,4,11,5,10,40,38,2,38
Cliftonville,4532,5,9,4,13,34,34,0,31
Ballymena,4532,6,7,4,15,26,50,-24,25
Glentoran,4532,7,6,6,10,24,32,-8,24
Dungannon,4532,8,2,4,16,14,47,-33,10
Crusaders,4533,1,16,6,4,62,32,30,54
Coleraine,4533,2,14,11,1,45,24,21,53
Linfield,4533,3,11,5,10,38,36,2,38
Glenavon,4533,4,9,10,7,54,45,9,37
Cliftonville,4533,5,9,4,13,32,32,0,31
Ballymena,4533,6,8,4,14,27,48,-21,28
Glentoran,4533,7,6,6,10,24,32,-8,24
Dungannon,4533,8,2,4,16,14,47,-33,10
Crusaders,4534,1,17,6,3,66,30,36,57
Coleraine,4534,2,15,10,1,45,23,22,55
Linfield,4534,3,11,5,10,40,37,3,38
Glenavon,4534,4,9,9,8,53,45,8,36
Cliftonville,4534,5,9,4,13,33,34,-1,31
Ballymena,4534,6,7,4,15,25,52,-27,25
Glentoran,4534,7,6,6,10,24,32,-8,24
Dungannon,4534,8,2,4,16,14,47,-33,10
Crusaders,4535,1,16,7,3,62,31,31,55
Coleraine,4535,2,14,11,1,43,22,21,53
Glenavon,4535,3,9,10,7,52,43,9,37
Linfield,4535,4,10,6,10,37,36,1,36
Cliftonville,4535,5,9,5,12,32,31,1,32
Ballymena,4535,6,7,5,14,26,48,-22,26
Glentoran,4535,7,6,6,10,24,32,-8,24
Dungannon,4535,8,2,4,16,14,47,-33,10
Crusaders,4536,1,17,6,3,64,32,32,57
Coleraine,4536,2,14,10,2,45,25,20,52
Glenavon,4536,3,10,9,7,55,45,10,39
Linfield,4536,4,10,6,10,38,37,1,36
Cliftonville,4536,5,9,5,12,33,32,1,32
Ballymena,4536,6,7,4,15,27,50,-23,25
Glentoran,4536,7,6,6,10,24,32,-8,24
Dungannon,4536,8,2,4,16,14,47,-33,10
Crusaders,4537,1,17,6,3,64,31,33,57
Coleraine,4537,2,14,10,2,43,23,20,52
Glenavon,4537,3,10,9,7,53,43,10,39
Linfield,4537,4,11,5,10,38,36,2,38
Cliftonville,4537,5,9,4,13,32,32,0,31
Ballymena,4537,6,7,4,15,26,50,-24,25
Glentoran,4537,7,6,6,10,24,32,-8,24
Dungannon,4537,8,2,4,16,14,47,-33,10
Coleraine,4538,1,15,10,1,45,23,22,55
Crusaders,4538,2,16,6,4,62,32,30,54
Linfield,4538,3,11,5,10,38,36,2,38
Glenavon,4538,4,9,9,8,53,45,8,36
Cliftonville,4538,5,9,4,13,32,32,0,31
Ballymena,4538,6,8,4,14,27,48,-21,28
Glentoran,4538,7,6,6,10,24,32,-8,24
Dungannon,4538,8,2,4,16,14,47,-33,10
Crusaders,4539,1,16,7,3,62,31,31,55
Coleraine,4539,2,14,10,2,45,26,19,52
Glenavon,4539,3,10,9,7,56,45,11,39
Linfield,4539,4,11,5,10,41,39,2,38
Cliftonville,4539,5,9,4,13,35,35,0,31
Ballymena,4539,6,7,5,14,26,48,-22,26
Glentoran,4539,7,6,6,10,24,32,-8,24
Dungannon,4539,8,2,4,16,14,47,-33,10
Crusaders,4540,1,17,6,3,63,31,32,57
Coleraine,4540,2,15,10,1,46,24,22,55
Linfield,4540,3,11,5,10,40,36,4,38
Glenavon,4540,4,9,9,8,54,46,8,36
Cliftonville,4540,5,9,4,13,32,34,-2,31
Ballymena,4540,6,7,4,15,26,49,-23,25
Glentoran,4540,7,6,6,10,24,32,-8,24
Dungannon,4540,8,2,4,16,14,47,-33,10
Crusaders,4541,1,16,7,3,62,31,31,55
Coleraine,4541,2,14,11,1,44,23,21,53
Linfield,4541,3,11,5,10,39,37,2,38
Glenavon,4541,4,9,10,7,53,44,9,37
Cliftonville,4541,5,9,4,13,33,33,0,31
Ballymena,4541,6,7,5,14,26,48,-22,26
Glentoran,4541,7,6,6,10,24,32,-8,24
Dungannon,4541,8,2,4,16,14,47,-33,10
Crusaders,4542,1,16,6,4,63,33,30,54
Coleraine,4542,2,14,11,1,44,23,21,53
Glenavon,4542,3,9,10,7,53,44,9,37
Linfield,4542,4,10,5,11,37,37,0,35
Cliftonville,4542,5,10,4,12,33,31,2,34
Ballymena,4542,6,8,4,14,28,49,-21,28
Glentoran,4542,7,6,6,10,24,32,-8,24
Dungannon,4542,8,2,4,16,14,47,-33,10
Crusaders,4543,1,17,6,3,63,30,33,57
Coleraine,4543,2,14,10,2,43,24,19,52
Glenavon,4543,3,10,9,7,54,43,11,39
Linfield,4543,4,10,5,11,38,38,0,35
Cliftonville,4543,5,10,4,12,34,32,2,34
Ballymena,4543,6,7,4,15,25,49,-24,25
Glentoran,4543,7,6,6,10,24,32,-8,24
Dungannon,4543,8,2,4,16,14,47,-33,10
Crusaders,4544,1,16,7,3,62,31,31,55
Coleraine,4544,2,14,11,1,44,23,21,53
Glenavon,4544,3,9,10,7,53,44,9,37
Linfield,4544,4,10,5,11,38,39,-1,35
Cliftonville,4544,5,10,4,12,35,32,3,34
Ballymena,4544,6,7,5,14,26,48,-22,26
Glentoran,4544,7,6,6,10,24,32,-8,24
Dungannon,4544,8,2,4,16,14,47,-33,10
Crusaders,4545,1,16,7,3,61,30,31,55
Coleraine,4545,2,14,11,1,44,23,21,53
Linfield,4545,3,11,5,10,38,36,2,38
Glenavon,4545,4,9,10,7,53,44,9,37
Cliftonville,4545,5,9,4,13,32,32,0,31
Ballymena,4545,6,7,5,14,25,47,-22,26
Glentoran,4545,7,6,6,10,24,32,-8,24
Dungannon,4545,8,2,4,16,14,47,-33,10
Crusaders,4546,1,16,6,4,61,31,30,54
Coleraine,4546,2,14,10,2,43,24,19,52
Glenavon,4546,3,10,9,7,54,43,11,39
Linfield,4546,4,10,6,10,38,37,1,36
Cliftonville,4546,5,9,5,12,33,32,1,32
Ballymena,4546,6,8,4,14,26,47,-21,28
Glentoran,4546,7,6,6,10,24,32,-8,24
Dungannon,4546,8,2,4,16,14,47,-33,10
Crusaders,4547,1,16,6,4,63,33,30,54
Coleraine,4547,2,14,11,1,44,23,21,53
Linfield,4547,3,11,5,10,38,36,2,38
Glenavon,4547,4,9,10,7,53,44,9,37
Cliftonville,4547,5,9,4,13,32,32,0,31
Ballymena,4547,6,8,4,14,28,49,-21,28
Glentoran,4547,7,6,6,10,24,32,-8,24
Dungannon,4547,8,2,4,16,14,47,-33,10
Crusaders,4548,1,16,7,3,62,31,31,55
Coleraine,4548,2,14,10,2,43,24,19,52
Glenavon,4548,3,10,9,7,54,43,11,39
Linfield,4548,4,10,6,10,38,37,1,36
Cliftonville,4548,5,9,5,12,33,32,1,32
Ballymena,4548,6,7,5,14,26,48,-22,26
Glentoran,4548,7,6,6,10,24,32,-8,24
Dungannon,4548,8,2,4,16,14,47,-33,10
Crusaders,4549,1,16,6,4,62,33,29,54
Coleraine,4549,2,14,10,2,43,26,17,52
Glenavon,4549,3,10,9,7,56,43,13,39
Linfield,4549,4,11,5,10,38,36,2,38
Cliftonville,4549,5,9,4,13,32,32,0,31
Ballymena,4549,6,8,4,14,28,48,-20,28
Glentoran,4549,7,6,6,10,24,32,-8,24
Dungannon,4549,8,2,4,16,14,47,-33,10
Crusaders,4550,1,17,6,3,66,31,35,57
Coleraine,4550,2,15,10,1,46,24,22,55
Linfield,4550,3,11,5,10,39,36,3,38
Glenavon,4550,4,9,9,8,54,46,8,36
Cliftonville,4550,5,9,4,13,32,33,-1,31
Ballymena,4550,6,7,4,15,26,52,-26,25
Glentoran,4550,7,6,6,10,24,32,-8,24
Dungannon,4550,8,2,4,16,14,47,-33,10
Crusaders,4551,1,16,7,3,63,32,31,55
Coleraine,4551,2,14,10,2,43,24,19,52
Glenavon,4551,3,10,9,7,54,43,11,39
Linfield,4551,4,10,5,11,38,38,0,35
Cliftonville,4551,5,10,4,12,34,32,2,34
Ballymena,4551,6,7,5,14,27,49,-22,26
Glentoran,4551,7,6,6,10,24,32,-8,24
Dungannon,4551,8,2,4,16,14,47,-33,10
Crusaders,4552,1,16,6,4,62,32,30,54
Coleraine,4552,2,14,10,2,43,23,20,52
Glenavon,4552,3,10,9,7,53,43,10,39
Linfield,4552,4,10,5,11,37,39,-2,35
Cliftonville,4552,5,10,4,12,35,31,4,34
Ballymena,4552,6,8,4,14,27,48,-21,28
Glentoran,4552,7,6,6,10,24,32,-8,24
Dungannon,4552,8,2,4,16,14,47,-33,10
Crusaders,4553,1,16,7,3,63,32,31,55
Coleraine,4553,2,14,10,2,46,27,19,52
Glenavon,4553,3,10,9,7,57,46,11,39
Linfield,4553,4,11,5,10,38,36,2,38
Cliftonville,4553,5,9,4,13,32,32,0,31
Ballymena,4553,6,7,5,14,27,49,-22,26
Glentoran,4553,7,6,6,10,24,32,-8,24
Dungannon,4553,8,2,4,16,14,47,-33,10
Crusaders,4554,1,17,6,3,64,30,34,57
Coleraine,4554,2,14,11,1,45,24,21,53
Linfield,4554,3,11,5,10,39,37,2,38
Glenavon,4554,4,9,10,7,54,45,9,37
Cliftonville,4554,5,9,4,13,33,33,0,31
Ballymena,4554,6,7,4,15,25,50,-25,25
Glentoran,4554,7,6,6,10,24,32,-8,24
Dungannon,4554,8,2,4,16,14,47,-33,10
Crusaders,4555,1,17,6,3,65,33,32,57
Coleraine,4555,2,14,10,2,44,24,20,52
Glenavon,4555,3,10,9,7,54,44,10,39
Linfield,4555,4,11,5,10,39,37,2,38
Cliftonville,4555,5,9,4,13,33,33,0,31
Ballymena,4555,6,7,4,15,28,51,-23,25
Glentoran,4555,7,6,6,10,24,32,-8,24
Dungannon,4555,8,2,4,16,14,47,-33,10
Crusaders,4556,1,16,7,3,62,31,31,55
Coleraine,4556,2,14,11,1,44,23,21,53
Glenavon,4556,3,9,10,7,53,44,9,37
Linfield,4556,4,10,5,11,37,37,0,35
Cliftonville,4556,5,10,4,12,33,31,2,34
Ballymena,4556,6,7,5,14,26,48,-22,26
Glentoran,4556,7,6,6,10,24,32,-8,24
Dungannon,4556,8,2,4,16,14,47,-33,10
Coleraine,4557,1,15,10,1,45,23,22,55
Crusaders,4557,2,16,6,4,61,31,30,54
Glenavon,4557,3,9,9,8,53,45,8,36
Linfield,4557,4,10,6,10,37,36,1,36
Cliftonville,4557,5,9,5,12,32,31,1,32
Ballymena,4557,6,8,4,14,26,47,-21,28
Glentoran,4557,7,6,6,10,24,32,-8,24
Dungannon,4557,8,2,4,16,14,47,-33,10
Crusaders,4558,1,17,6,3,63,30,33,57
Coleraine,4558,2,15,10,1,47,23,24,55
Glenavon,4558,3,9,9,8,53,47,6,36
Linfield,4558,4,10,5,11,37,39,-2,35
Cliftonville,4558,5,10,4,12,35,31,4,34
Ballymena,4558,6,7,4,15,25,49,-24,25
Glentoran,4558,7,6,6,10,24,32,-8,24
Dungannon,4558,8,2,4,16,14,47,-33,10
Coleraine,4559,1,15,10,1,45,22,23,55
Crusaders,4559,2,16,6,4,62,34,28,54
Glenavon,4559,3,9,9,8,52,45,7,36
Linfield,4559,4,10,5,11,37,37,0,35
Cliftonville,4559,5,10,4,12,33,31,2,34
Ballymena,4559,6,8,4,14,29,48,-19,28
Glentoran,4559,7,6,6,10,24,32,-8,24
Dungannon,4559,8,2,4,16,14,47,-33,10
Crusaders,4560,1,16,7,3,62,31,31,55
Coleraine,4560,2,14,10,2,44,24,20,52
Glenavon,4560,3,10,9,7,54,44,10,39
Linfield,4560,4,10,5,11,38,38,0,35
Cliftonville,4560,5,10,4,12,34,32,2,34
Ballymena,4560,6,7,5,14,26,48,-22,26
Glentoran,4560,7,6,6,10,24,32,-8,24
Dungannon,4560,8,2,4,16,14,47,-33,10
Crusaders,4561,1,16,6,4,61,31,30,54
Coleraine,4561,2,14,11,1,44,23,21,53
Linfield,4561,3,11,5,10,41,37,4,38
Glenavon,4561,4,9,10,7,53,44,9,37
Cliftonville,4561,5,9,4,13,33,35,-2,31
Ballymena,4561,6,8,4,14,26,47,-21,28
Glentoran,4561,7,6,6,10,24,32,-8,24
Dungannon,4561,8,2,4,16,14,47,-33,10
Crusaders,4562,1,17,6,3,62,30,32,57
Coleraine,4562,2,14,10,2,44,24,20,52
Glenavon,4562,3,10,9,7,54,44,10,39
Linfield,4562,4,10,5,11,38,38,0,35
Cliftonville,4562,5,10,4,12,34,32,2,34
Ballymena,4562,6,7,4,15,25,48,-23,25
Glentoran,4562,7,6,6,10,24,32,-8,24
Dungannon,4562,8,2,4,16,14,47,-33,10
Crusaders,4563,1,17,6,3,63,30,33,57
Coleraine,4563,2,14,10,2,43,23,20,52
Glenavon,4563,3,10,9,7,53,43,10,39
Linfield,4563,4,11,5,10,41,36,5,38
Cliftonville,4563,5,9,4,13,32,35,-3,31
Ballymena,4563,6,7,4,15,25,49,-24,25
Glentoran,4563,7,6,6,10,24,32,-8,24
Dungannon,4563,8,2,4,16,14,47,-33,10
Crusaders,4564,1,16,6,4,62,32,30,54
Coleraine,4564,2,14,10,2,44,26,18,52
Glenavon,4564,3,10,9,7,56,44,12,39
Linfield,4564,4,11,5,10,38,36,2,38
Cliftonville,4564,5,9,4,13,32,32,0,31
Ballymena,4564,6,8,4,14,27,48,-21,28
Glentoran,4564,7,6,6,10,24,32,-8,24
Dungannon,4564,8,2,4,16,14,47,-33,10
Crusaders,4565,1,17,6,3,63,31,32,57
Coleraine,4565,2,15,10,1,48,23,25,55
Linfield,4565,3,11,5,10,38,36,2,38
Glenavon,4565,4,9,9,8,53,48,5,36
Cliftonville,4565,5,9,4,13,32,32,0,31
Ballymena,4565,6,7,4,15,26,49,-23,25
Glentoran,4565,7,6,6,10,24,32,-8,24
Dungannon,4565,8,2,4,16,14,47,-33,10
Crusaders,4566,1,17,6,3,64,30,34,57
Coleraine,4566,2,15,10,1,45,23,22,55
Glenavon,4566,3,9,9,8,53,45,8,36
Linfield,4566,4,10,5,11,37,40,-3,35
Cliftonville,4566,5,10,4,12,36,31,5,34
Ballymena,4566,6,7,4,15,25,50,-25,25
Glentoran,4566,7,6,6,10,24,32,-8,24
Dungannon,4566,8,2,4,16,14,47,-33,10
Crusaders,4567,1,16,6,4,62,32,30,54
Coleraine,4567,2,14,10,2,43,24,19,52
Glenavon,4567,3,10,9,7,54,43,11,39
Linfield,4567,4,10,5,11,38,38,0,35
Cliftonville,4567,5,10,4,12,34,32,2,34
Ballymena,4567,6,8,4,14,27,48,-21,28
Glentoran,4567,7,6,6,10,24,32,-8,24
Dungannon,4567,8,2,4,16,14,47,-33,10
Crusaders,4568,1,16,7,3,63,32,31,55
Coleraine,4568,2,14,11,1,45,24,21,53
Linfield,4568,3,11,5,10,38,36,2,38
Glenavon,4568,4,9,10,7,54,45,9,37
Cliftonville,4568,5,9,4,13,32,32,0,31
Ballymena,4568,6,7,5,14,27,49,-22,26
Glentoran,4568,7,6,6,10,24,32,-8,24
Dungannon,4568,8,2,4,16,14,47,-33,10
Crusaders,4569,1,16,7,3,63,32,31,55
Coleraine,4569,2,14,10,2,43,25,18,52
Glenavon,4569,3,10,9,7,55,43,12,39
Linfield,4569,4,10,5,11,39,39,0,35
Cliftonville,4569,5,10,4,12,35,33,2,34
Ballymena,4569,6,7,5,14,27,49,-22,26
Glentoran,4569,7,6,6,10,24,32,-8,24
Dungannon,4569,8,2,4,16,14,47,-33,10
Crusaders,4570,1,17,6,3,65,30,35,57
Coleraine,4570,2,15,10,1,47,23,24,55
Glenavon,4570,3,9,9,8,53,47,6,36
Linfield,4570,4,10,5,11,38,38,0,35
Cliftonville,4570,5,10,4,12,34,32,2,34
Ballymena,4570,6,7,4,15,25,51,-26,25
Glentoran,4570,7,6,6,10,24,32,-8,24
Dungannon,4570,8,2,4,16,14,47,-33,10
Crusaders,4571,1,17,6,3,64,30,34,57
Coleraine,4571,2,14,10,2,44,26,18,52
Glenavon,4571,3,10,9,7,56,44,12,39
Linfield,4571,4,10,5,11,37,38,-1,35
Cliftonville,4571,5,10,4,12,34,31,3,34
Ballymena,4571,6,7,4,15,25,50,-25,25
Glentoran,4571,7,6,6,10,24,32,-8,24
Dungannon,4571,8,2,4,16,14,47,-33,10
Crusaders,4572,1,16,7,3,62,31,31,55
Coleraine,4572,2,15,10,1,45,22,23,55
Linfield,4572,3,11,5,10,39,37,2,38
Glenavon,4572,4,9,9,8,52,45,7,36
Cliftonville,4572,5,9,4,13,33,33,0,31
Ballymena,4572,6,7,5,14,26,48,-22,26
Glentoran,4572,7,6,6,10,24,32,-8,24
Dungannon,4572,8,2,4,16,14,47,-33,10
Crusaders,4573,1,17,6,3,62,30,32,57
Coleraine,4573,2,14,10,2,43,23,20,52
Glenavon,4573,3,10,9,7,53,43,10,39
Linfield,4573,4,11,5,10,41,36,5,38
Cliftonville,4573,5,9,4,13,32,35,-3,31
Ballymena,4573,6,7,4,15,25,48,-23,25
Glentoran,4573,7,6,6,10,24,32,-8,24
Dungannon,4573,8,2,4,16,14,47,-33,10
Crusaders,4574,1,17,6,3,65,30,35,57
Coleraine,4574,2,14,10,2,44,24,20,52
Glenavon,4574,3,10,9,7,54,44,10,39
Linfield,4574,4,11,5,10,39,36,3,38
Cliftonville,4574,5,9,4,13,32,33,-1,31
Ballymena,4574,6,7,4,15,25,51,-26,25
Glentoran,4574,7,6,6,10,24,32,-8,24
Dungannon,4574,8,2,4,16,14,47,-33,10
Coleraine,4575,1,15,10,1,44,22,22,55
Crusaders,4575,2,16,6,4,62,34,28,54
Linfield,4575,3,11,5,10,38,36,2,38
Glenavon,4575,4,9,9,8,52,44,8,36
Cliftonville,4575,5,9,4,13,32,32,0,31
Ballymena,4575,6,8,4,14,29,48,-19,28
Glentoran,4575,7,6,6,10,24,32,-8,24
Dungannon,4575,8,2,4,16,14,47,-33,10
Crusaders,4576,1,16,6,4,62,32,30,54
Coleraine,4576,2,14,10,2,44,24,20,52
Glenavon,4576,3,10,9,7,54,44,10,39
Linfield,4576,4,11,5,10,39,37,2,38
Cliftonville,4576,5,9,4,13,33,33,0,31
Ballymena,4576,6,8,4,14,27,48,-21,28
Glentoran,4576,7,6,6,10,24,32,-8,24
Dungannon,4576,8,2,4,16,14,47,-33,10
Crusaders,4577,1,17,6,3,63,30,33,57
Coleraine,4577,2,14,10,2,44,25,19,52
Glenavon,4577,3,10,9,7,55,44,11,39
Linfield,4577,4,11,5,10,39,36,3,38
Cliftonville,4577,5,9,4,13,32,33,-1,31
Ballymena,4577,6,7,4,15,25,49,-24,25
Glentoran,4577,7,6,6,10,24,32,-8,24
Dungannon,4577,8,2,4,16,14,47,-33,10
Crusaders,4578,1,17,6,3,63,31,32,57
Coleraine,4578,2,14,11,1,44,23,21,53
Glenavon,4578,3,9,10,7,53,44,9,37
Linfield,4578,4,10,6,10,37,36,1,36
Cliftonville,4578,5,9,5,12,32,31,1,32
Ballymena,4578,6,7,4,15,26,49,-23,25
Glentoran,4578,7,6,6,10,24,32,-8,24
Dungannon,4578,8,2,4,16,14,47,-33,10
Crusaders,4579,1,17,6,3,63,30,33,57
Coleraine,4579,2,14,10,2,44,24,20,52
Glenavon,4579,3,10,9,7,54,44,10,39
Linfield,4579,4,10,5,11,37,37,0,35
Cliftonville,4579,5,10,4,12,33,31,2,34
Ballymena,4579,6,7,4,15,25,49,-24,25
Glentoran,4579,7,6,6,10,24,32,-8,24
Dungannon,4579,8,2,4,16,14,47,-33,10
Crusaders,4580,1,17,6,3,64,31,33,57
Coleraine,4580,2,14,10,2,43,24,19,52
Glenavon,4580,3,10,9,7,54,43,11,39
Linfield,4580,4,11,5,10,38,36,2,38
Cliftonville,4580,5,9,4,13,32,32,0,31
Ballymena,4580,6,7,4,15,26,50,-24,25
Glentoran,4580,7,6,6,10,24,32,-8,24
Dungannon,4580,8,2,4,16,14,47,-33,10
Crusaders,4581,1,17,6,3,63,30,33,57
Coleraine,4581,2,14,10,2,44,25,19,52
Glenavon,4581,3,10,9,7,55,44,11,39
Linfield,4581,4,11,5,10,39,36,3,38
Cliftonville,4581,5,9,4,13,32,33,-1,31
Ballymena,4581,6,7,4,15,25,49,-24,25
Glentoran,4581,7,6,6,10,24,32,-8,24
Dungannon,4581,8,2,4,16,14,47,-33,10
Crusaders,4582,1,17,6,3,63,31,32,57
Coleraine,4582,2,14,10,2,43,24,19,52
Glenavon,4582,3,10,9,7,54,43,11,39
Linfield,4582,4,10,5,11,39,39,0,35
Cliftonville,4582,5,10,4,12,35,33,2,34
Ballymena,4582,6,7,4,15,26,49,-23,25
Glentoran,4582,7,6,6,10,24,32,-8,24
Dungannon,4582,8,2,4,16,14,47,-33,10
Crusaders,4583,1,17,6,3,63,31,32,57
Coleraine,4583,2,15,10,1,44,22,22,55
Glenavon,4583,3,9,9,8,52,44,8,36
Linfield,4583,4,10,6,10,39,38,1,36
Cliftonville,4583,5,9,5,12,34,33,1,32
Ballymena,4583,6,7,4,15,26,49,-23,25
Glentoran,4583,7,6,6,10,24,32,-8,24
Dungannon,4583,8,2,4,16,14,47,-33,10
Crusaders,4584,1,17,6,3,63,31,32,57
Coleraine,4584,2,14,10,2,45,25,20,52
Glenavon,4584,3,10,9,7,55,45,10,39
Linfield,4584,4,11,5,10,38,36,2,38
Cliftonville,4584,5,9,4,13,32,32,0,31
Ballymena,4584,6,7,4,15,26,49,-23,25
Glentoran,4584,7,6,6,10,24,32,-8,24
Dungannon,4584,8,2,4,16,14,47,-33,10
Crusaders,4585,1,17,6,3,62,30,32,57
Coleraine,4585,2,14,10,2,44,24,20,52
Glenavon,4585,3,10,9,7,54,44,10,39
Linfield,4585,4,11,5,10,40,38,2,38
Cliftonville,4585,5,9,4,13,34,34,0,31
Ballymena,4585,6,7,4,15,25,48,-23,25
Glentoran,4585,7,6,6,10,24,32,-8,24
Dungannon,4585,8,2,4,16,14,47,-33,10
Crusaders,4586,1,17,6,3,64,31,33,57
Coleraine,4586,2,15,10,1,44,22,22,55
Linfield,4586,3,11,5,10,38,36,2,38
Glenavon,4586,4,9,9,8,52,44,8,36
Cliftonville,4586,5,9,4,13,32,32,0,31
Ballymena,4586,6,7,4,15,26,50,-24,25
Glentoran,4586,7,6,6,10,24,32,-8,24
Dungannon,4586,8,2,4,16,14,47,-33,10
Crusaders,4587,1,17,6,3,64,30,34,57
Coleraine,4587,2,14,10,2,44,24,20,52
Glenavon,4587,3,10,9,7,54,44,10,39
Linfield,4587,4,11,5,10,40,37,3,38
Cliftonville,4587,5,9,4,13,33,34,-1,31
Ballymena,4587,6,7,4,15,25,50,-25,25
Glentoran,4587,7,6,6,10,24,32,-8,24
Dungannon,4587,8,2,4,16,14,47,-33,10
Crusaders,4588,1,16,7,3,62,31,31,55
Coleraine,4588,2,14,11,1,43,22,21,53
Glenavon,4588,3,9,10,7,52,43,9,37
Linfield,4588,4,10,6,10,38,37,1,36
Cliftonville,4588,5,9,5,12,33,32,1,32
Ballymena,4588,6,7,5,14,26,48,-22,26
Glentoran,4588,7,6,6,10,24,32,-8,24
Dungannon,4588,8,2,4,16,14,47,-33,10
Crusaders,4589,1,16,6,4,64,37,27,54
Coleraine,4589,2,14,10,2,43,24,19,52
Glenavon,4589,3,10,9,7,54,43,11,39
Linfield,4589,4,11,5,10,40,36,4,38
Cliftonville,4589,5,9,4,13,32,34,-2,31
Ballymena,4589,6,8,4,14,32,50,-18,28
Glentoran,4589,7,6,6,10,24,32,-8,24
Dungannon,4589,8,2,4,16,14,47,-33,10
Crusaders,4590,1,16,6,4,62,32,30,54
Coleraine,4590,2,14,11,1,44,23,21,53
Glenavon,4590,3,9,10,7,53,44,9,37
Linfield,4590,4,10,5,11,38,38,0,35
Cliftonville,4590,5,10,4,12,34,32,2,34
Ballymena,4590,6,8,4,14,27,48,-21,28
Glentoran,4590,7,6,6,10,24,32,-8,24
Dungannon,4590,8,2,4,16,14,47,-33,10
Crusaders,4591,1,17,6,3,62,30,32,57
Coleraine,4591,2,15,10,1,45,23,22,55
Glenavon,4591,3,9,9,8,53,45,8,36
Linfield,4591,4,10,6,10,38,37,1,36
Cliftonville,4591,5,9,5,12,33,32,1,32
Ballymena,4591,6,7,4,15,25,48,-23,25
Glentoran,4591,7,6,6,10,24,32,-8,24
Dungannon,4591,8,2,4,16,14,47,-33,10
Crusaders,4592,1,17,6,3,63,30,33,57
Coleraine,4592,2,14,10,2,44,25,19,52
Glenavon,4592,3,10,9,7,55,44,11,39
Linfield,4592,4,11,5,10,39,37,2,38
Cliftonville,4592,5,9,4,13,33,33,0,31
Ballymena,4592,6,7,4,15,25,49,-24,25
Glentoran,4592,7,6,6,10,24,32,-8,24
Dungannon,4592,8,2,4,16,14,47,-33,10
Crusaders,4593,1,16,7,3,62,31,31,55
Coleraine,4593,2,14,10,2,43,24,19,52
Glenavon,4593,3,10,9,7,54,43,11,39
Linfield,4593,4,11,5,10,41,36,5,38
Cliftonville,4593,5,9,4,13,32,35,-3,31
Ballymena,4593,6,7,5,14,26,48,-22,26
Glentoran,4593,7,6,6,10,24,32,-8,24
Dungannon,4593,8,2,4,16,14,47,-33,10
Crusaders,4594,1,17,6,3,63,30,33,57
Coleraine,4594,2,14,11,1,44,23,21,53
Glenavon,4594,3,9,10,7,53,44,9,37
Linfield,4594,4,10,5,11,37,38,-1,35
Cliftonville,4594,5,10,4,12,34,31,3,34
Ballymena,4594,6,7,4,15,25,49,-24,25
Glentoran,4594,7,6,6,10,24,32,-8,24
Dungannon,4594,8,2,4,16,14,47,-33,10
Crusaders,4595,1,17,6,3,62,30,32,57
Coleraine,4595,2,14,11,1,43,22,21,53
Linfield,4595,3,11,5,10,39,36,3,38
Glenavon,4595,4,9,10,7,52,43,9,37
Cliftonville,4595,5,9,4,13,32,33,-1,31
Ballymena,4595,6,7,4,15,25,48,-23,25
Glentoran,4595,7,6,6,10,24,32,-8,24
Dungannon,4595,8,2,4,16,14,47,-33,10
Crusaders,4596,1,17,6,3,62,30,32,57
Coleraine,4596,2,15,10,1,45,22,23,55
Linfield,4596,3,11,5,10,40,38,2,38
Glenavon,4596,4,9,9,8,52,45,7,36
Cliftonville,4596,5,9,4,13,34,34,0,31
Ballymena,4596,6,7,4,15,25,48,-23,25
Glentoran,4596,7,6,6,10,24,32,-8,24
Dungannon,4596,8,2,4,16,14,47,-33,10
Crusaders,4597,1,16,7,3,62,31,31,55
Coleraine,4597,2,14,11,1,44,23,21,53
Linfield,4597,3,11,5,10,39,37,2,38
Glenavon,4597,4,9,10,7,53,44,9,37
Cliftonville,4597,5,9,4,13,33,33,0,31
Ballymena,4597,6,7,5,14,26,48,-22,26
Glentoran,4597,7,6,6,10,24,32,-8,24
Dungannon,4597,8,2,4,16,14,47,-33,10
Coleraine,4598,1,15,10,1,45,23,22,55
Crusaders,4598,2,16,6,4,62,32,30,54
Glenavon,4598,3,9,9,8,53,45,8,36
Linfield,4598,4,10,6,10,38,37,1,36
Cliftonville,4598,5,9,5,12,33,32,1,32
Ballymena,4598,6,8,4,14,27,48,-21,28
Glentoran,4598,7,6,6,10,24,32,-8,24
Dungannon,4598,8,2,4,16,14,47,-33,10
Crusaders,4599,1,16,7,3,65,34,31,55
Coleraine,4599,2,14,10,2,44,24,20,52
Glenavon,4599,3,10,9,7,54,44,10,39
Linfield,4599,4,10,5,11,38,38,0,35
Cliftonville,4599,5,10,4,12,34,32,2,34
Ballymena,4599,6,7,5,14,29,51,-22,26
Glentoran,4599,7,6,6,10,24,32,-8,24
Dungannon,4599,8,2,4,16,14,47,-33,10
Crusaders,4600,1,17,6,3,62,30,32,57
Coleraine,4600,2,14,10,2,43,25,18,52
Glenavon,4600,3,10,9,7,55,43,12,39
Linfield,4600,4,10,5,11,39,40,-1,35
Cliftonville,4600,5,10,4,12,36,33,3,34
Ballymena,4600,6,7,4,15,25,48,-23,25
Glentoran,4600,7,6,6,10,24,32,-8,24
Dungannon,4600,8,2,4,16,14,47,-33,10
Coleraine,4601,1,15,10,1,45,23,22,55
Crusaders,4601,2,16,6,4,62,34,28,54
Glenavon,4601,3,9,9,8,53,45,8,36
Linfield,4601,4,10,5,11,37,37,0,35
Cliftonville,4601,5,10,4,12,33,31,2,34
Ballymena,4601,6,8,4,14,29,48,-19,28
Glentoran,4601,7,6,6,10,24,32,-8,24
Dungannon,4601,8,2,4,16,14,47,-33,10
Coleraine,4602,1,15,10,1,44,22,22,55
Crusaders,4602,2,16,6,4,62,32,30,54
Glenavon,4602,3,9,9,8,52,44,8,36
Linfield,4602,4,10,5,11,38,38,0,35
Cliftonville,4602,5,10,4,12,34,32,2,34
Ballymena,4602,6,8,4,14,27,48,-21,28
Glentoran,4602,7,6,6,10,24,32,-8,24
Dungannon,4602,8,2,4,16,14,47,-33,10
Crusaders,4603,1,17,6,3,62,30,32,57
Coleraine,4603,2,14,11,1,43,22,21,53
Glenavon,4603,3,9,10,7,52,43,9,37
Linfield,4603,4,10,6,10,38,37,1,36
Cliftonville,4603,5,9,5,12,33,32,1,32
Ballymena,4603,6,7,4,15,25,48,-23,25
Glentoran,4603,7,6,6,10,24,32,-8,24
Dungannon,4603,8,2,4,16,14,47,-33,10
Crusaders,4604,1,16,7,3,62,31,31,55
Coleraine,4604,2,14,10,2,44,24,20,52
Glenavon,4604,3,10,9,7,54,44,10,39
Linfield,4604,4,10,5,11,38,38,0,35
Cliftonville,4604,5,10,4,12,34,32,2,34
Ballymena,4604,6,7,5,14,26,48,-22,26
Glentoran,4604,7,6,6,10,24,32,-8,24
Dungannon,4604,8,2,4,16,14,47,-33,10
Crusaders,4605,1,17,6,3,63,31,32,57
Coleraine,4605,2,15,10,1,47,24,23,55
Linfield,4605,3,11,5,10,39,36,3,38
Glenavon,4605,4,9,9,8,54,47,7,36
Cliftonville,4605,5,9,4,13,32,33,-1,31
Ballymena,4605,6,7,4,15,26,49,-23,25
Glentoran,4605,7,6,6,10,24,32,-8,24
Dungannon,4605,8,2,4,16,14,47,-33,10
Crusaders,4606,1,17,6,3,63,31,32,57
Coleraine,4606,2,15,10,1,45,23,22,55
Linfield,4606,3,11,5,10,39,37,2,38
Glenavon,4606,4,9,9,8,53,45,8,36
Cliftonville,4606,5,9,4,13,33,33,0,31
Ballymena,4606,6,7,4,15,26,49,-23,25
Glentoran,4606,7,6,6,10,24,32,-8,24
Dungannon,4606,8,2,4,16,14,47,-33,10
Crusaders,4607,1,17,6,3,67,31,36,57
Coleraine,4607,2,14,11,1,44,23,21,53
Linfield,4607,3,11,5,10,39,36,3,38
Glenavon,4607,4,9,10,7,53,44,9,37
Cliftonville,4607,5,9,4,13,32,33,-1,31
Ballymena,4607,6,7,4,15,26,53,-27,25
Glentoran,4607,7,6,6,10,24,32,-8,24
Dungannon,4607,8,2,4,16,14,47,-33,10
Crusaders,4608,1,17,6,3,64,30,34,57
Coleraine,4608,2,14,11,1,44,23,21,53
Glenavon,4608,3,9,10,7,53,44,9,37
Linfield,4608,4,10,6,10,39,38,1,36
Cliftonville,4608,5,9,5,12,34,33,1,32
Ballymena,4608,6,7,4,15,25,50,-25,25
Glentoran,4608,7,6,6,10,24,32,-8,24
Dungannon,4608,8,2,4,16,14,47,-33,10
Crusaders,4609,1,17,6,3,64,32,32,57
Coleraine,4609,2,14,11,1,43,22,21,53
Linfield,4609,3,11,5,10,39,37,2,38
Glenavon,4609,4,9,10,7,52,43,9,37
Cliftonville,4609,5,9,4,13,33,33,0,31
Ballymena,4609,6,7,4,15,27,50,-23,25
Glentoran,4609,7,6,6,10,24,32,-8,24
Dungannon,4609,8,2,4,16,14,47,-33,10
Crusaders,4610,1,16,7,3,64,33,31,55
Coleraine,4610,2,14,10,2,45,25,20,52
Glenavon,4610,3,10,9,7,55,45,10,39
Linfield,4610,4,10,6,10,37,36,1,36
Cliftonville,4610,5,9,5,12,32,31,1,32
Ballymena,4610,6,7,5,14,28,50,-22,26
Glentoran,4610,7,6,6,10,24,32,-8,24
Dungannon,4610,8,2,4,16,14,47,-33,10
Crusaders,4611,1,16,7,3,63,32,31,55
Coleraine,4611,2,14,11,1,44,23,21,53
Glenavon,4611,3,9,10,7,53,44,9,37
Linfield,4611,4,10,6,10,38,37,1,36
Cliftonville,4611,5,9,5,12,33,32,1,32
Ballymena,4611,6,7,5,14,27,49,-22,26
Glentoran,4611,7,6,6,10,24,32,-8,24
Dungannon,4611,8,2,4,16,14,47,-33,10
Crusaders,4612,1,16,7,3,62,31,31,55
Coleraine,4612,2,15,10,1,45,23,22,55
Linfield,4612,3,11,5,10,39,36,3,38
Glenavon,4612,4,9,9,8,53,45,8,36
Cliftonville,4612,5,9,4,13,32,33,-1,31
Ballymena,4612,6,7,5,14,26,48,-22,26
Glentoran,4612,7,6,6,10,24,32,-8,24
Dungannon,4612,8,2,4,16,14,47,-33,10
Crusaders,4613,1,17,6,3,63,30,33,57
Coleraine,4613,2,14,11,1,45,24,21,53
Linfield,4613,3,11,5,10,38,36,2,38
Glenavon,4613,4,9,10,7,54,45,9,37
Cliftonville,4613,5,9,4,13,32,32,0,31
Ballymena,4613,6,7,4,15,25,49,-24,25
Glentoran,4613,7,6,6,10,24,32,-8,24
Dungannon,4613,8,2,4,16,14,47,-33,10
Crusaders,4614,1,17,6,3,63,30,33,57
Coleraine,4614,2,15,10,1,46,22,24,55
Glenavon,4614,3,9,9,8,52,46,6,36
Linfield,4614,4,10,6,10,38,37,1,36
Cliftonville,4614,5,9,5,12,33,32,1,32
Ballymena,4614,6,7,4,15,25,49,-24,25
Glentoran,4614,7,6,6,10,24,32,-8,24
Dungannon,4614,8,2,4,16,14,47,-33,10
Crusaders,4615,1,16,6,4,62,32,30,54
Coleraine,4615,2,14,10,2,43,24,19,52
Glenavon,4615,3,10,9,7,54,43,11,39
Linfield,4615,4,11,5,10,40,36,4,38
Cliftonville,4615,5,9,4,13,32,34,-2,31
Ballymena,4615,6,8,4,14,27,48,-21,28
Glentoran,4615,7,6,6,10,24,32,-8,24
Dungannon,4615,8,2,4,16,14,47,-33,10
Crusaders,4616,1,16,7,3,62,31,31,55
Coleraine,4616,2,14,10,2,43,25,18,52
Glenavon,4616,3,10,9,7,55,43,12,39
Linfield,4616,4,11,5,10,39,36,3,38
Cliftonville,4616,5,9,4,13,32,33,-1,31
Ballymena,4616,6,7,5,14,26,48,-22,26
Glentoran,4616,7,6,6,10,24,32,-8,24
Dungannon,4616,8,2,4,16,14,47,-33,10
Crusaders,4617,1,17,6,3,63,30,33,57
Coleraine,4617,2,15,10,1,45,22,23,55
Glenavon,4617,3,9,9,8,52,45,7,36
Linfield,4617,4,10,5,11,37,37,0,35
Cliftonville,4617,5,10,4,12,33,31,2,34
Ballymena,4617,6,7,4,15,25,49,-24,25
Glentoran,4617,7,6,6,10,24,32,-8,24
Dungannon,4617,8,2,4,16,14,47,-33,10
Crusaders,4618,1,16,6,4,62,32,30,54
Coleraine,4618,2,14,10,2,45,25,20,52
Glenavon,4618,3,10,9,7,55,45,10,39
Linfield,4618,4,11,5,10,38,36,2,38
Cliftonville,4618,5,9,4,13,32,32,0,31
Ballymena,4618,6,8,4,14,27,48,-21,28
Glentoran,4618,7,6,6,10,24,32,-8,24
Dungannon,4618,8,2,4,16,14,47,-33,10
Crusaders,4619,1,17,6,3,63,31,32,57
Coleraine,4619,2,14,10,2,43,23,20,52
Glenavon,4619,3,10,9,7,53,43,10,39
Linfield,4619,4,10,5,11,39,39,0,35
Cliftonville,4619,5,10,4,12,35,33,2,34
Ballymena,4619,6,7,4,15,26,49,-23,25
Glentoran,4619,7,6,6,10,24,32,-8,24
Dungannon,4619,8,2,4,16,14,47,-33,10
Crusaders,4620,1,16,7,3,62,31,31,55
Coleraine,4620,2,14,10,2,43,24,19,52
Glenavon,4620,3,10,9,7,54,43,11,39
Linfield,4620,4,10,6,10,39,38,1,36
Cliftonville,4620,5,9,5,12,34,33,1,32
Ballymena,4620,6,7,5,14,26,48,-22,26
Glentoran,4620,7,6,6,10,24,32,-8,24
Dungannon,4620,8,2,4,16,14,47,-33,10
Coleraine,4621,1,15,10,1,48,23,25,55
Crusaders,4621,2,16,6,4,61,31,30,54
Glenavon,4621,3,9,9,8,53,48,5,36
Linfield,4621,4,10,5,11,38,39,-1,35
Cliftonville,4621,5,10,4,12,35,32,3,34
Ballymena,4621,6,8,4,14,26,47,-21,28
Glentoran,4621,7,6,6,10,24,32,-8,24
Dungannon,4621,8,2,4,16,14,47,-33,10
Crusaders,4622,1,16,7,3,64,33,31,55
Coleraine,4622,2,15,10,1,46,24,22,55
Linfield,4622,3,11,5,10,40,36,4,38
Glenavon,4622,4,9,9,8,54,46,8,36
Cliftonville,4622,5,9,4,13,32,34,-2,31
Ballymena,4622,6,7,5,14,28,50,-22,26
Glentoran,4622,7,6,6,10,24,32,-8,24
Dungannon,4622,8,2,4,16,14,47,-33,10
Crusaders,4623,1,17,6,3,65,31,34,57
Coleraine,4623,2,14,11,1,43,22,21,53
Glenavon,4623,3,9,10,7,52,43,9,37
Linfield,4623,4,10,6,10,37,36,1,36
Cliftonville,4623,5,9,5,12,32,31,1,32
Ballymena,4623,6,7,4,15,26,51,-25,25
Glentoran,4623,7,6,6,10,24,32,-8,24
Dungannon,4623,8,2,4,16,14,47,-33,10
Crusaders,4624,1,17,6,3,62,30,32,57
Coleraine,4624,2,14,11,1,43,22,21,53
Glenavon,4624,3,9,10,7,52,43,9,37
Linfield,4624,4,10,5,11,39,39,0,35
Cliftonville,4624,5,10,4,12,35,33,2,34
Ballymena,4624,6,7,4,15,25,48,-23,25
Glentoran,4624,7,6,6,10,24,32,-8,24
Dungannon,4624,8,2,4,16,14,47,-33,10
Crusaders,4625,1,16,6,4,67,37,30,54
Coleraine,4625,2,14,11,1,44,23,21,53
Linfield,4625,3,11,5,10,38,36,2,38
Glenavon,4625,4,9,10,7,53,44,9,37
Cliftonville,4625,5,9,4,13,32,32,0,31
Ballymena,4625,6,8,4,14,32,53,-21,28
Glentoran,4625,7,6,6,10,24,32,-8,24
Dungannon,4625,8,2,4,16,14,47,-33,10
Crusaders,4626,1,17,6,3,63,31,32,57
Coleraine,4626,2,14,10,2,44,25,19,52
Glenavon,4626,3,10,9,7,55,44,11,39
Linfield,4626,4,11,5,10,39,36,3,38
Cliftonville,4626,5,9,4,13,32,33,-1,31
Ballymena,4626,6,7,4,15,26,49,-23,25
Glentoran,4626,7,6,6,10,24,32,-8,24
Dungannon,4626,8,2,4,16,14,47,-33,10
Crusaders,4627,1,16,6,4,61,32,29,54
Coleraine,4627,2,14,11,1,45,24,21,53
Glenavon,4627,3,9,10,7,54,45,9,37
Linfield,4627,4,10,6,10,37,36,1,36
Cliftonville,4627,5,9,5,12,32,31,1,32
Ballymena,4627,6,8,4,14,27,47,-20,28
Glentoran,4627,7,6,6,10,24,32,-8,24
Dungannon,4627,8,2,4,16,14,47,-33,10
Crusaders,4628,1,17,6,3,63,31,32,57
Coleraine,4628,2,14,11,1,45,24,21,53
Glenavon,4628,3,9,10,7,54,45,9,37
Linfield,4628,4,10,6,10,38,37,1,36
Cliftonville,4628,5,9,5,12,33,32,1,32
Ballymena,4628,6,7,4,15,26,49,-23,25
Glentoran,4628,7,6,6,10,24,32,-8,24
Dungannon,4628,8,2,4,16,14,47,-33,10
Crusaders,4629,1,16,7,3,62,31,31,55
Coleraine,4629,2,14,10,2,43,23,20,52
Glenavon,4629,3,10,9,7,53,43,10,39
Linfield,4629,4,11,5,10,39,37,2,38
Cliftonville,4629,5,9,4,13,33,33,0,31
Ballymena,4629,6,7,5,14,26,48,-22,26
Glentoran,4629,7,6,6,10,24,32,-8,24
Dungannon,4629,8,2,4,16,14,47,-33,10
Crusaders,4630,1,16,6,4,62,33,29,54
Coleraine,4630,2,14,10,2,44,28,16,52
Glenavon,4630,3,10,9,7,58,44,14,39
Linfield,4630,4,10,6,10,38,37,1,36
Cliftonville,4630,5,9,5,12,33,32,1,32
Ballymena,4630,6,8,4,14,28,48,-20,28
Glentoran,4630,7,6,6,10,24,32,-8,24
Dungannon,4630,8,2,4,16,14,47,-33,10
Crusaders,4631,1,16,6,4,61,33,28,54
Coleraine,4631,2,14,10,2,44,26,18,52
Glenavon,4631,3,10,9,7,56,44,12,39
Linfield,4631,4,11,5,10,39,37,2,38
Cliftonville,4631,5,9,4,13,33,33,0,31
Ballymena,4631,6,8,4,14,28,47,-19,28
Glentoran,4631,7,6,6,10,24,32,-8,24
Dungannon,4631,8,2,4,16,14,47,-33,10
Crusaders,4632,1,16,6,4,61,31,30,54
Coleraine,4632,2,14,10,2,43,24,19,52
Glenavon,4632,3,10,9,7,54,43,11,39
Linfield,4632,4,10,5,11,38,39,-1,35
Cliftonville,4632,5,10,4,12,35,32,3,34
Ballymena,4632,6,8,4,14,26,47,-21,28
Glentoran,4632,7,6,6,10,24,32,-8,24
Dungannon,4632,8,2,4,16,14,47,-33,10
Crusaders,4633,1,16,7,3,62,31,31,55
Coleraine,4633,2,14,10,2,45,27,18,52
Glenavon,4633,3,10,9,7,57,45,12,39
Linfield,4633,4,10,5,11,38,38,0,35
Cliftonville,4633,5,10,4,12,34,32,2,34
Ballymena,4633,6,7,5,14,26,48,-22,26
Glentoran,4633,7,6,6,10,24,32,-8,24
Dungannon,4633,8,2,4,16,14,47,-33,10
Coleraine,4634,1,15,10,1,46,24,22,55
Crusaders,4634,2,16,6,4,61,32,29,54
Linfield,4634,3,11,5,10,39,37,2,38
Glenavon,4634,4,9,9,8,54,46,8,36
Cliftonville,4634,5,9,4,13,33,33,0,31
Ballymena,4634,6,8,4,14,27,47,-20,28
Glentoran,4634,7,6,6,10,24,32,-8,24
Dungannon,4634,8,2,4,16,14,47,-33,10
Crusaders,4635,1,16,7,3,64,33,31,55
Coleraine,4635,2,15,10,1,46,22,24,55
Glenavon,4635,3,9,9,8,52,46,6,36
Linfield,4635,4,10,5,11,37,37,0,35
Cliftonville,4635,5,10,4,12,33,31,2,34
Ballymena,4635,6,7,5,14,28,50,-22,26
Glentoran,4635,7,6,6,10,24,32,-8,24
Dungannon,4635,8,2,4,16,14,47,-33,10
Crusaders,4636,1,17,6,3,65,33,32,57
Coleraine,4636,2,14,10,2,44,26,18,52
Glenavon,4636,3,10,9,7,56,44,12,39
Linfield,4636,4,10,6,10,38,37,1,36
Cliftonville,4636,5,9,5,12,33,32,1,32
Ballymena,4636,6,7,4,15,28,51,-23,25
Glentoran,4636,7,6,6,10,24,32,-8,24
Dungannon,4636,8,2,4,16,14,47,-33,10
Crusaders,4637,1,16,6,4,61,31,30,54
Coleraine,4637,2,14,11,1,45,24,21,53
Linfield,4637,3,11,5,10,39,37,2,38
Glenavon,4637,4,9,10,7,54,45,9,37
Cliftonville,4637,5,9,4,13,33,33,0,31
Ballymena,4637,6,8,4,14,26,47,-21,28
Glentoran,4637,7,6,6,10,24,32,-8,24
Dungannon,4637,8,2,4,16,14,47,-33,10
Crusaders,4638,1,16,6,4,63,33,30,54
Coleraine,4638,2,14,10,2,43,23,20,52
Glenavon,4638,3,10,9,7,53,43,10,39
Linfield,4638,4,10,5,11,39,39,0,35
Cliftonville,4638,5,10,4,12,35,33,2,34
Ballymena,4638,6,8,4,14,28,49,-21,28
Glentoran,4638,7,6,6,10,24,32,-8,24
Dungannon,4638,8,2,4,16,14,47,-33,10
Crusaders,4639,1,17,6,3,65,30,35,57
Coleraine,4639,2,14,10,2,44,25,19,52
Glenavon,4639,3,10,9,7,55,44,11,39
Linfield,4639,4,10,5,11,37,39,-2,35
Cliftonville,4639,5,10,4,12,35,31,4,34
Ballymena,4639,6,7,4,15,25,51,-26,25
Glentoran,4639,7,6,6,10,24,32,-8,24
Dungannon,4639,8,2,4,16,14,47,-33,10
Crusaders,4640,1,16,6,4,61,31,30,54
Coleraine,4640,2,14,11,1,45,24,21,53
Linfield,4640,3,11,5,10,39,37,2,38
Glenavon,4640,4,9,10,7,54,45,9,37
Cliftonville,4640,5,9,4,13,33,33,0,31
Ballymena,4640,6,8,4,14,26,47,-21,28
Glentoran,4640,7,6,6,10,24,32,-8,24
Dungannon,4640,8,2,4,16,14,47,-33,10
Crusaders,4641,1,17,6,3,65,30,35,57
Coleraine,4641,2,14,11,1,45,24,21,53
Linfield,4641,3,11,5,10,39,37,2,38
Glenavon,4641,4,9,10,7,54,45,9,37
Cliftonville,4641,5,9,4,13,33,33,0,31
Ballymena,4641,6,7,4,15,25,51,-26,25
Glentoran,4641,7,6,6,10,24,32,-8,24
Dungannon,4641,8,2,4,16,14,47,-33,10
Crusaders,4642,1,17,6,3,64,30,34,57
Coleraine,4642,2,14,11,1,44,23,21,53
Linfield,4642,3,11,5,10,40,38,2,38
Glenavon,4642,4,9,10,7,53,44,9,37
Cliftonville,4642,5,9,4,13,34,34,0,31
Ballymena,4642,6,7,4,15,25,50,-25,25
Glentoran,4642,7,6,6,10,24,32,-8,24
Dungannon,4642,8,2,4,16,14,47,-33,10
Crusaders,4643,1,17,6,3,63,30,33,57
Coleraine,4643,2,14,10,2,44,25,19,52
Glenavon,4643,3,10,9,7,55,44,11,39
Linfield,4643,4,11,5,10,40,38,2,38
Cliftonville,4643,5,9,4,13,34,34,0,31
Ballymena,4643,6,7,4,15,25,49,-24,25
Glentoran,4643,7,6,6,10,24,32,-8,24
Dungannon,4643,8,2,4,16,14,47,-33,10
Crusaders,4644,1,17,6,3,63,31,32,57
Coleraine,4644,2,15,10,1,46,22,24,55
Glenavon,4644,3,9,9,8,52,46,6,36
Linfield,4644,4,10,5,11,37,37,0,35
Cliftonville,4644,5,10,4,12,33,31,2,34
Ballymena,4644,6,7,4,15,26,49,-23,25
Glentoran,4644,7,6,6,10,24,32,-8,24
Dungannon,4644,8,2,4,16,14,47,-33,10
Crusaders,4645,1,17,6,3,63,30,33,57
Coleraine,4645,2,15,10,1,46,23,23,55
Linfield,4645,3,11,5,10,38,36,2,38
Glenavon,4645,4,9,9,8,53,46,7,36
Cliftonville,4645,5,9,4,13,32,32,0,31
Ballymena,4645,6,7,4,15,25,49,-24,25
Glentoran,4645,7,6,6,10,24,32,-8,24
Dungannon,4645,8,2,4,16,14,47,-33,10
Crusaders,4646,1,17,6,3,64,30,34,57
Coleraine,4646,2,15,10,1,45,23,22,55
Glenavon,4646,3,9,9,8,53,45,8,36
Linfield,4646,4,10,6,10,37,36,1,36
Cliftonville,4646,5,9,5,12,32,31,1,32
Ballymena,4646,6,7,4,15,25,50,-25,25
Glentoran,4646,7,6,6,10,24,32,-8,24
Dungannon,4646,8,2,4,16,14,47,-33,10
Crusaders,4647,1,16,6,4,61,31,30,54
Coleraine,4647,2,14,11,1,45,24,21,53
Linfield,4647,3,11,5,10,40,36,4,38
Glenavon,4647,4,9,10,7,54,45,9,37
Cliftonville,4647,5,9,4,13,32,34,-2,31
Ballymena,4647,6,8,4,14,26,47,-21,28
Glentoran,4647,7,6,6,10,24,32,-8,24
Dungannon,4647,8,2,4,16,14,47,-33,10
Crusaders,4648,1,17,6,3,66,32,34,57
Coleraine,4648,2,14,10,2,45,25,20,52
Glenavon,4648,3,10,9,7,55,45,10,39
Linfield,4648,4,11,5,10,39,36,3,38
Cliftonville,4648,5,9,4,13,32,33,-1,31
Ballymena,4648,6,7,4,15,27,52,-25,25
Glentoran,4648,7,6,6,10,24,32,-8,24
Dungannon,4648,8,2,4,16,14,47,-33,10
Crusaders,4649,1,17,6,3,63,30,33,57
Coleraine,4649,2,15,10,1,44,22,22,55
Glenavon,4649,3,9,9,8,52,44,8,36
Linfield,4649,4,10,6,10,39,38,1,36
Cliftonville,4649,5,9,5,12,34,33,1,32
Ballymena,4649,6,7,4,15,25,49,-24,25
Glentoran,4649,7,6,6,10,24,32,-8,24
Dungannon,4649,8,2,4,16,14,47,-33,10
Crusaders,4650,1,16,6,4,63,34,29,54
Coleraine,4650,2,14,10,2,43,26,17,52
Glenavon,4650,3,10,9,7,56,43,13,39
Linfield,4650,4,11,5,10,40,38,2,38
Cliftonville,4650,5,9,4,13,34,34,0,31
Ballymena,4650,6,8,4,14,29,49,-20,28
Glentoran,4650,7,6,6,10,24,32,-8,24
Dungannon,4650,8,2,4,16,14,47,-33,10
Crusaders,4651,1,17,6,3,64,31,33,57
Coleraine,4651,2,15,10,1,44,22,22,55
Glenavon,4651,3,9,9,8,52,44,8,36
Linfield,4651,4,10,5,11,38,38,0,35
Cliftonville,4651,5,10,4,12,34,32,2,34
Ballymena,4651,6,7,4,15,26,50,-24,25
Glentoran,4651,7,6,6,10,24,32,-8,24
Dungannon,4651,8,2,4,16,14,47,-33,10
Crusaders,4652,1,17,6,3,65,31,34,57
Coleraine,4652,2,14,10,2,45,26,19,52
Glenavon,4652,3,10,9,7,56,45,11,39
Linfield,4652,4,10,5,11,38,38,0,35
Cliftonville,4652,5,10,4,12,34,32,2,34
Ballymena,4652,6,7,4,15,26,51,-25,25
Glentoran,4652,7,6,6,10,24,32,-8,24
Dungannon,4652,8,2,4,16,14,47,-33,10
Crusaders,4653,1,17,6,3,69,30,39,57
Coleraine,4653,2,15,10,1,44,22,22,55
Glenavon,4653,3,9,9,8,52,44,8,36
Linfield,4653,4,10,5,11,38,38,0,35
Cliftonville,4653,5,10,4,12,34,32,2,34
Ballymena,4653,6,7,4,15,25,55,-30,25
Glentoran,4653,7,6,6,10,24,32,-8,24
Dungannon,4653,8,2,4,16,14,47,-33,10
Crusaders,4654,1,17,6,3,64,30,34,57
Coleraine,4654,2,14,10,2,44,24,20,52
Glenavon,4654,3,10,9,7,54,44,10,39
Linfield,4654,4,10,5,11,38,38,0,35
Cliftonville,4654,5,10,4,12,34,32,2,34
Ballymena,4654,6,7,4,15,25,50,-25,25
Glentoran,4654,7,6,6,10,24,32,-8,24
Dungannon,4654,8,2,4,16,14,47,-33,10
Crusaders,4655,1,17,6,3,63,30,33,57
Coleraine,4655,2,14,11,1,43,22,21,53
Linfield,4655,3,11,5,10,39,37,2,38
Glenavon,4655,4,9,10,7,52,43,9,37
Cliftonville,4655,5,9,4,13,33,33,0,31
Ballymena,4655,6,7,4,15,25,49,-24,25
Glentoran,4655,7,6,6,10,24,32,-8,24
Dungannon,4655,8,2,4,16,14,47,-33,10
Crusaders,4656,1,17,6,3,64,32,32,57
Coleraine,4656,2,15,10,1,45,22,23,55
Linfield,4656,3,11,5,10,40,36,4,38
Glenavon,4656,4,9,9,8,52,45,7,36
Cliftonville,4656,5,9,4,13,32,34,-2,31
Ballymena,4656,6,7,4,15,27,50,-23,25
Glentoran,4656,7,6,6,10,24,32,-8,24
Dungannon,4656,8,2,4,16,14,47,-33,10
Crusaders,4657,1,16,6,4,62,32,30,54
Coleraine,4657,2,14,11,1,46,25,21,53
Glenavon,4657,3,9,10,7,55,46,9,37
Linfield,4657,4,10,6,10,38,37,1,36
Cliftonville,4657,5,9,5,12,33,32,1,32
Ballymena,4657,6,8,4,14,27,48,-21,28
Glentoran,4657,7,6,6,10,24,32,-8,24
Dungannon,4657,8,2,4,16,14,47,-33,10
Crusaders,4658,1,17,6,3,64,30,34,57
Coleraine,4658,2,15,10,1,46,22,24,55
Linfield,4658,3,11,5,10,38,36,2,38
Glenavon,4658,4,9,9,8,52,46,6,36
Cliftonville,4658,5,9,4,13,32,32,0,31
Ballymena,4658,6,7,4,15,25,50,-25,25
Glentoran,4658,7,6,6,10,24,32,-8,24
Dungannon,4658,8,2,4,16,14,47,-33,10
Crusaders,4659,1,16,7,3,63,32,31,55
Coleraine,4659,2,14,11,1,45,24,21,53
Linfield,4659,3,11,5,10,39,37,2,38
Glenavon,4659,4,9,10,7,54,45,9,37
Cliftonville,4659,5,9,4,13,33,33,0,31
Ballymena,4659,6,7,5,14,27,49,-22,26
Glentoran,4659,7,6,6,10,24,32,-8,24
Dungannon,4659,8,2,4,16,14,47,-33,10
Crusaders,4660,1,17,6,3,63,30,33,57
Coleraine,4660,2,15,10,1,45,23,22,55
Glenavon,4660,3,9,9,8,53,45,8,36
Linfield,4660,4,10,5,11,37,37,0,35
Cliftonville,4660,5,10,4,12,33,31,2,34
Ballymena,4660,6,7,4,15,25,49,-24,25
Glentoran,4660,7,6,6,10,24,32,-8,24
Dungannon,4660,8,2,4,16,14,47,-33,10
Crusaders,4661,1,17,6,3,64,30,34,57
Coleraine,4661,2,14,10,2,43,25,18,52
Glenavon,4661,3,10,9,7,55,43,12,39
Linfield,4661,4,10,5,11,37,39,-2,35
Cliftonville,4661,5,10,4,12,35,31,4,34
Ballymena,4661,6,7,4,15,25,50,-25,25
Glentoran,4661,7,6,6,10,24,32,-8,24
Dungannon,4661,8,2,4,16,14,47,-33,10
Crusaders,4662,1,16,7,3,62,31,31,55
Coleraine,4662,2,15,10,1,45,23,22,55
Linfield,4662,3,11,5,10,39,37,2,38
Glenavon,4662,4,9,9,8,53,45,8,36
Cliftonville,4662,5,9,4,13,33,33,0,31
Ballymena,4662,6,7,5,14,26,48,-22,26
Glentoran,4662,7,6,6,10,24,32,-8,24
Dungannon,4662,8,2,4,16,14,47,-33,10
Crusaders,4663,1,17,6,3,63,30,33,57
Coleraine,4663,2,14,10,2,43,24,19,52
Glenavon,4663,3,10,9,7,54,43,11,39
Linfield,4663,4,10,5,11,37,37,0,35
Cliftonville,4663,5,10,4,12,33,31,2,34
Ballymena,4663,6,7,4,15,25,49,-24,25
Glentoran,4663,7,6,6,10,24,32,-8,24
Dungannon,4663,8,2,4,16,14,47,-33,10
Crusaders,4664,1,16,7,3,63,32,31,55
Coleraine,4664,2,14,10,2,44,24,20,52
Glenavon,4664,3,10,9,7,54,44,10,39
Linfield,4664,4,11,5,10,38,36,2,38
Cliftonville,4664,5,9,4,13,32,32,0,31
Ballymena,4664,6,7,5,14,27,49,-22,26
Glentoran,4664,7,6,6,10,24,32,-8,24
Dungannon,4664,8,2,4,16,14,47,-33,10
Crusaders,4665,1,17,6,3,63,31,32,57
Coleraine,4665,2,14,11,1,45,24,21,53
Linfield,4665,3,11,5,10,40,36,4,38
Glenavon,4665,4,9,10,7,54,45,9,37
Cliftonville,4665,5,9,4,13,32,34,-2,31
Ballymena,4665,6,7,4,15,26,49,-23,25
Glentoran,4665,7,6,6,10,24,32,-8,24
Dungannon,4665,8,2,4,16,14,47,-33,10
Crusaders,4666,1,16,6,4,62,33,29,54
Coleraine,4666,2,14,10,2,43,27,16,52
Glenavon,4666,3,10,9,7,57,43,14,39
Linfield,4666,4,10,5,11,38,38,0,35
Cliftonville,4666,5,10,4,12,34,32,2,34
Ballymena,4666,6,8,4,14,28,48,-20,28
Glentoran,4666,7,6,6,10,24,32,-8,24
Dungannon,4666,8,2,4,16,14,47,-33,10
Crusaders,4667,1,17,6,3,66,30,36,57
Coleraine,4667,2,15,10,1,45,23,22,55
Glenavon,4667,3,9,9,8,53,45,8,36
Linfield,4667,4,10,6,10,37,36,1,36
Cliftonville,4667,5,9,5,12,32,31,1,32
Ballymena,4667,6,7,4,15,25,52,-27,25
Glentoran,4667,7,6,6,10,24,32,-8,24
Dungannon,4667,8,2,4,16,14,47,-33,10
Crusaders,4668,1,16,6,4,61,32,29,54
Coleraine,4668,2,14,10,2,43,23,20,52
Glenavon,4668,3,10,9,7,53,43,10,39
Linfield,4668,4,10,5,11,38,39,-1,35
Cliftonville,4668,5,10,4,12,35,32,3,34
Ballymena,4668,6,8,4,14,27,47,-20,28
Glentoran,4668,7,6,6,10,24,32,-8,24
Dungannon,4668,8,2,4,16,14,47,-33,10
Coleraine,4669,1,15,10,1,46,23,23,55
Crusaders,4669,2,16,6,4,63,33,30,54
Glenavon,4669,3,9,9,8,53,46,7,36
Linfield,4669,4,10,5,11,38,38,0,35
Cliftonville,4669,5,10,4,12,34,32,2,34
Ballymena,4669,6,8,4,14,28,49,-21,28
Glentoran,4669,7,6,6,10,24,32,-8,24
Dungannon,4669,8,2,4,16,14,47,-33,10
Crusaders,4670,1,16,7,3,61,30,31,55
Coleraine,4670,2,15,10,1,45,23,22,55
Glenavon,4670,3,9,9,8,53,45,8,36
Linfield,4670,4,10,6,10,38,37,1,36
Cliftonville,4670,5,9,5,12,33,32,1,32
Ballymena,4670,6,7,5,14,25,47,-22,26
Glentoran,4670,7,6,6,10,24,32,-8,24
Dungannon,4670,8,2,4,16,14,47,-33,10
Crusaders,4671,1,16,7,3,61,30,31,55
Coleraine,4671,2,14,10,2,45,25,20,52
Glenavon,4671,3,10,9,7,55,45,10,39
Linfield,4671,4,11,5,10,43,36,7,38
Cliftonville,4671,5,9,4,13,32,37,-5,31
Ballymena,4671,6,7,5,14,25,47,-22,26
Glentoran,4671,7,6,6,10,24,32,-8,24
Dungannon,4671,8,2,4,16,14,47,-33,10
Crusaders,4672,1,17,6,3,65,30,35,57
Coleraine,4672,2,14,10,2,43,24,19,52
Glenavon,4672,3,10,9,7,54,43,11,39
Linfield,4672,4,10,6,10,38,37,1,36
Cliftonville,4672,5,9,5,12,33,32,1,32
Ballymena,4672,6,7,4,15,25,51,-26,25
Glentoran,4672,7,6,6,10,24,32,-8,24
Dungannon,4672,8,2,4,16,14,47,-33,10
Crusaders,4673,1,16,7,3,63,32,31,55
Coleraine,4673,2,15,10,1,45,23,22,55
Glenavon,4673,3,9,9,8,53,45,8,36
Linfield,4673,4,10,5,11,37,38,-1,35
Cliftonville,4673,5,10,4,12,34,31,3,34
Ballymena,4673,6,7,5,14,27,49,-22,26
Glentoran,4673,7,6,6,10,24,32,-8,24
Dungannon,4673,8,2,4,16,14,47,-33,10
Crusaders,4674,1,16,6,4,61,31,30,54
Coleraine,4674,2,14,11,1,43,22,21,53
Glenavon,4674,3,9,10,7,52,43,9,37
Linfield,4674,4,10,5,11,38,38,0,35
Cliftonville,4674,5,10,4,12,34,32,2,34
Ballymena,4674,6,8,4,14,26,47,-21,28
Glentoran,4674,7,6,6,10,24,32,-8,24
Dungannon,4674,8,2,4,16,14,47,-33,10
Crusaders,4675,1,17,6,3,64,32,32,57
Coleraine,4675,2,14,11,1,44,23,21,53
Linfield,4675,3,11,5,10,38,36,2,38
Glenavon,4675,4,9,10,7,53,44,9,37
Cliftonville,4675,5,9,4,13,32,32,0,31
Ballymena,4675,6,7,4,15,27,50,-23,25
Glentoran,4675,7,6,6,10,24,32,-8,24
Dungannon,4675,8,2,4,16,14,47,-33,10
Crusaders,4676,1,17,6,3,63,30,33,57
Coleraine,4676,2,14,10,2,43,23,20,52
Glenavon,4676,3,10,9,7,53,43,10,39
Linfield,4676,4,11,5,10,39,37,2,38
Cliftonville,4676,5,9,4,13,33,33,0,31
Ballymena,4676,6,7,4,15,25,49,-24,25
Glentoran,4676,7,6,6,10,24,32,-8,24
Dungannon,4676,8,2,4,16,14,47,-33,10
Crusaders,4677,1,17,6,3,65,32,33,57
Coleraine,4677,2,15,10,1,45,22,23,55
Glenavon,4677,3,9,9,8,52,45,7,36
Linfield,4677,4,10,5,11,38,38,0,35
Cliftonville,4677,5,10,4,12,34,32,2,34
Ballymena,4677,6,7,4,15,27,51,-24,25
Glentoran,4677,7,6,6,10,24,32,-8,24
Dungannon,4677,8,2,4,16,14,47,-33,10
Crusaders,4678,1,16,7,3,63,32,31,55
Coleraine,4678,2,14,11,1,46,25,21,53
Glenavon,4678,3,9,10,7,55,46,9,37
Linfield,4678,4,10,5,11,38,38,0,35
Cliftonville,4678,5,10,4,12,34,32,2,34
Ballymena,4678,6,7,5,14,27,49,-22,26
Glentoran,4678,7,6,6,10,24,32,-8,24
Dungannon,4678,8,2,4,16,14,47,-33,10
Crusaders,4679,1,17,6,3,64,31,33,57
Coleraine,4679,2,15,10,1,47,22,25,55
Linfield,4679,3,11,5,10,38,36,2,38
Glenavon,4679,4,9,9,8,52,47,5,36
Cliftonville,4679,5,9,4,13,32,32,0,31
Ballymena,4679,6,7,4,15,26,50,-24,25
Glentoran,4679,7,6,6,10,24,32,-8,24
Dungannon,4679,8,2,4,16,14,47,-33,10
Crusaders,4680,1,16,6,4,62,32,30,54
Coleraine,4680,2,14,10,2,44,25,19,52
Glenavon,4680,3,10,9,7,55,44,11,39
Linfield,4680,4,11,5,10,40,37,3,38
Cliftonville,4680,5,9,4,13,33,34,-1,31
Ballymena,4680,6,8,4,14,27,48,-21,28
Glentoran,4680,7,6,6,10,24,32,-8,24
Dungannon,4680,8,2,4,16,14,47,-33,10
Crusaders,4681,1,17,6,3,65,30,35,57
Coleraine,4681,2,14,10,2,43,24,19,52
Glenavon,4681,3,10,9,7,54,43,11,39
Linfield,4681,4,11,5,10,39,36,3,38
Cliftonville,4681,5,9,4,13,32,33,-1,31
Ballymena,4681,6,7,4,15,25,51,-26,25
Glentoran,4681,7,6,6,10,24,32,-8,24
Dungannon,4681,8,2,4,16,14,47,-33,10
Crusaders,4682,1,16,6,4,62,32,30,54
Coleraine,4682,2,14,10,2,45,25,20,52
Glenavon,4682,3,10,9,7,55,45,10,39
Linfield,4682,4,11,5,10,42,36,6,38
Cliftonville,4682,5,9,4,13,32,36,-4,31
Ballymena,4682,6,8,4,14,27,48,-21,28
Glentoran,4682,7,6,6,10,24,32,-8,24
Dungannon,4682,8,2,4,16,14,47,-33,10
Crusaders,4683,1,16,6,4,62,32,30,54
Coleraine,4683,2,14,10,2,44,24,20,52
Glenavon,4683,3,10,9,7,54,44,10,39
Linfield,4683,4,10,5,11,37,38,-1,35
Cliftonville,4683,5,10,4,12,34,31,3,34
Ballymena,4683,6,8,4,14,27,48,-21,28
Glentoran,4683,7,6,6,10,24,32,-8,24
Dungannon,4683,8,2,4,16,14,47,-33,10
Crusaders,4684,1,17,6,3,63,30,33,57
Coleraine,4684,2,15,10,1,45,23,22,55
Glenavon,4684,3,9,9,8,53,45,8,36
Linfield,4684,4,10,6,10,38,37,1,36
Cliftonville,4684,5,9,5,12,33,32,1,32
Ballymena,4684,6,7,4,15,25,49,-24,25
Glentoran,4684,7,6,6,10,24,32,-8,24
Dungannon,4684,8,2,4,16,14,47,-33,10
Coleraine,4685,1,15,10,1,46,23,23,55
Crusaders,4685,2,16,6,4,63,33,30,54
Linfield,4685,3,11,5,10,40,38,2,38
Glenavon,4685,4,9,9,8,53,46,7,36
Cliftonville,4685,5,9,4,13,34,34,0,31
Ballymena,4685,6,8,4,14,28,49,-21,28
Glentoran,4685,7,6,6,10,24,32,-8,24
Dungannon,4685,8,2,4,16,14,47,-33,10
Crusaders,4686,1,16,6,4,62,35,27,54
Coleraine,4686,2,14,11,1,43,22,21,53
Glenavon,4686,3,9,10,7,52,43,9,37
Linfield,4686,4,10,6,10,39,38,1,36
Cliftonville,4686,5,9,5,12,34,33,1,32
Ballymena,4686,6,8,4,14,30,48,-18,28
Glentoran,4686,7,6,6,10,24,32,-8,24
Dungannon,4686,8,2,4,16,14,47,-33,10
Crusaders,4687,1,17,6,3,63,31,32,57
Coleraine,4687,2,14,10,2,44,27,17,52
Glenavon,4687,3,10,9,7,57,44,13,39
Linfield,4687,4,10,5,11,38,38,0,35
Cliftonville,4687,5,10,4,12,34,32,2,34
Ballymena,4687,6,7,4,15,26,49,-23,25
Glentoran,4687,7,6,6,10,24,32,-8,24
Dungannon,4687,8,2,4,16,14,47,-33,10
Crusaders,4688,1,16,6,4,61,31,30,54
Coleraine,4688,2,14,10,2,44,25,19,52
Glenavon,4688,3,10,9,7,55,44,11,39
Linfield,4688,4,10,5,11,38,38,0,35
Cliftonville,4688,5,10,4,12,34,32,2,34
Ballymena,4688,6,8,4,14,26,47,-21,28
Glentoran,4688,7,6,6,10,24,32,-8,24
Dungannon,4688,8,2,4,16,14,47,-33,10
Crusaders,4689,1,16,7,3,62,31,31,55
Coleraine,4689,2,14,11,1,44,23,21,53
Linfield,4689,3,11,5,10,41,37,4,38
Glenavon,4689,4,9,10,7,53,44,9,37
Cliftonville,4689,5,9,4,13,33,35,-2,31
Ballymena,4689,6,7,5,14,26,48,-22,26
Glentoran,4689,7,6,6,10,24,32,-8,24
Dungannon,4689,8,2,4,16,14,47,-33,10
Crusaders,4690,1,16,6,4,63,33,30,54
Coleraine,4690,2,14,10,2,44,24,20,52
Glenavon,4690,3,10,9,7,54,44,10,39
Linfield,4690,4,11,5,10,40,36,4,38
Cliftonville,4690,5,9,4,13,32,34,-2,31
Ballymena,4690,6,8,4,14,28,49,-21,28
Glentoran,4690,7,6,6,10,24,32,-8,24
Dungannon,4690,8,2,4,16,14,47,-33,10
Crusaders,4691,1,16,6,4,63,33,30,54
Coleraine,4691,2,14,10,2,45,26,19,52
Glenavon,4691,3,10,9,7,56,45,11,39
Linfield,4691,4,10,6,10,39,38,1,36
Cliftonville,4691,5,9,5,12,34,33,1,32
Ballymena,4691,6,8,4,14,28,49,-21,28
Glentoran,4691,7,6,6,10,24,32,-8,24
Dungannon,4691,8,2,4,16,14,47,-33,10
Crusaders,4692,1,16,6,4,61,32,29,54
Coleraine,4692,2,14,11,1,43,22,21,53
Linfield,4692,3,11,5,10,38,36,2,38
Glenavon,4692,4,9,10,7,52,43,9,37
Cliftonville,4692,5,9,4,13,32,32,0,31
Ballymena,4692,6,8,4,14,27,47,-20,28
Glentoran,4692,7,6,6,10,24,32,-8,24
Dungannon,4692,8,2,4,16,14,47,-33,10
Coleraine,4693,1,15,10,1,46,23,23,55
Crusaders,4693,2,16,6,4,61,31,30,54
Linfield,4693,3,11,5,10,38,36,2,38
Glenavon,4693,4,9,9,8,53,46,7,36
Cliftonville,4693,5,9,4,13,32,32,0,31
Ballymena,4693,6,8,4,14,26,47,-21,28
Glentoran,4693,7,6,6,10,24,32,-8,24
Dungannon,4693,8,2,4,16,14,47,-33,10
Crusaders,4694,1,17,6,3,64,31,33,57
Coleraine,4694,2,14,11,1,44,23,21,53
Linfield,4694,3,11,5,10,38,36,2,38
Glenavon,4694,4,9,10,7,53,44,9,37
Cliftonville,4694,5,9,4,13,32,32,0,31
Ballymena,4694,6,7,4,15,26,50,-24,25
Glentoran,4694,7,6,6,10,24,32,-8,24
Dungannon,4694,8,2,4,16,14,47,-33,10
Coleraine,4695,1,15,10,1,47,23,24,55
Crusaders,4695,2,16,6,4,62,32,30,54
Glenavon,4695,3,9,9,8,53,47,6,36
Linfield,4695,4,10,5,11,37,38,-1,35
Cliftonville,4695,5,10,4,12,34,31,3,34
Ballymena,4695,6,8,4,14,27,48,-21,28
Glentoran,4695,7,6,6,10,24,32,-8,24
Dungannon,4695,8,2,4,16,14,47,-33,10
Crusaders,4696,1,17,6,3,65,31,34,57
Coleraine,4696,2,14,10,2,43,27,16,52
Glenavon,4696,3,10,9,7,57,43,14,39
Linfield,4696,4,11,5,10,40,36,4,38
Cliftonville,4696,5,9,4,13,32,34,-2,31
Ballymena,4696,6,7,4,15,26,51,-25,25
Glentoran,4696,7,6,6,10,24,32,-8,24
Dungannon,4696,8,2,4,16,14,47,-33,10
Crusaders,4697,1,16,7,3,62,31,31,55
Coleraine,4697,2,14,11,1,44,23,21,53
Linfield,4697,3,11,5,10,38,36,2,38
Glenavon,4697,4,9,10,7,53,44,9,37
Cliftonville,4697,5,9,4,13,32,32,0,31
Ballymena,4697,6,7,5,14,26,48,-22,26
Glentoran,4697,7,6,6,10,24,32,-8,24
Dungannon,4697,8,2,4,16,14,47,-33,10
Coleraine,4698,1,15,10,1,44,22,22,55
Crusaders,4698,2,16,6,4,62,32,30,54
Glenavon,4698,3,9,9,8,52,44,8,36
Linfield,4698,4,10,6,10,38,37,1,36
Cliftonville,4698,5,9,5,12,33,32,1,32
Ballymena,4698,6,8,4,14,27,48,-21,28
Glentoran,4698,7,6,6,10,24,32,-8,24
Dungannon,4698,8,2,4,16,14,47,-33,10
Crusaders,4699,1,17,6,3,64,31,33,57
Coleraine,4699,2,14,10,2,43,24,19,52
Glenavon,4699,3,10,9,7,54,43,11,39
Linfield,4699,4,10,6,10,37,36,1,36
Cliftonville,4699,5,9,5,12,32,31,1,32
Ballymena,4699,6,7,4,15,26,50,-24,25
Glentoran,4699,7,6,6,10,24,32,-8,24
Dungannon,4699,8,2,4,16,14,47,-33,10
Coleraine,4700,1,15,10,1,45,23,22,55
Crusaders,4700,2,16,6,4,62,32,30,54
Glenavon,4700,3,9,9,8,53,45,8,36
Linfield,4700,4,10,6,10,38,37,1,36
Cliftonville,4700,5,9,5,12,33,32,1,32
Ballymena,4700,6,8,4,14,27,48,-21,28
Glentoran,4700,7,6,6,10,24,32,-8,24
Dungannon,4700,8,2,4,16,14,47,-33,10
Crusaders,4701,1,17,6,3,64,30,34,57
Coleraine,4701,2,14,10,2,43,23,20,52
Glenavon,4701,3,10,9,7,53,43,10,39
Linfield,4701,4,11,5,10,39,37,2,38
Cliftonville,4701,5,9,4,13,33,33,0,31
Ballymena,4701,6,7,4,15,25,50,-25,25
Glentoran,4701,7,6,6,10,24,32,-8,24
Dungannon,4701,8,2,4,16,14,47,-33,10
Crusaders,4702,1,16,6,4,62,34,28,54
Coleraine,4702,2,14,10,2,43,24,19,52
Glenavon,4702,3,10,9,7,54,43,11,39
Linfield,4702,4,10,6,10,38,37,1,36
Cliftonville,4702,5,9,5,12,33,32,1,32
Ballymena,4702,6,8,4,14,29,48,-19,28
Glentoran,4702,7,6,6,10,24,32,-8,24
Dungannon,4702,8,2,4,16,14,47,-33,10
Crusaders,4703,1,17,6,3,63,31,32,57
Coleraine,4703,2,14,10,2,43,23,20,52
Glenavon,4703,3,10,9,7,53,43,10,39
Linfield,4703,4,10,6,10,38,37,1,36
Cliftonville,4703,5,9,5,12,33,32,1,32
Ballymena,4703,6,7,4,15,26,49,-23,25
Glentoran,4703,7,6,6,10,24,32,-8,24
Dungannon,4703,8,2,4,16,14,47,-33,10
Crusaders,4704,1,17,6,3,64,32,32,57
Coleraine,4704,2,14,10,2,45,25,20,52
Glenavon,4704,3,10,9,7,55,45,10,39
Linfield,4704,4,11,5,10,39,37,2,38
Cliftonville,4704,5,9,4,13,33,33,0,31
Ballymena,4704,6,7,4,15,27,50,-23,25
Glentoran,4704,7,6,6,10,24,32,-8,24
Dungannon,4704,8,2,4,16,14,47,-33,10
Crusaders,4705,1,16,6,4,62,32,30,54
Coleraine,4705,2,14,10,2,43,25,18,52
Glenavon,4705,3,10,9,7,55,43,12,39
Linfield,4705,4,11,5,10,38,36,2,38
Cliftonville,4705,5,9,4,13,32,32,0,31
Ballymena,4705,6,8,4,14,27,48,-21,28
Glentoran,4705,7,6,6,10,24,32,-8,24
Dungannon,4705,8,2,4,16,14,47,-33,10
Crusaders,4706,1,16,7,3,63,32,31,55
Coleraine,4706,2,14,11,1,44,23,21,53
Glenavon,4706,3,9,10,7,53,44,9,37
Linfield,4706,4,10,5,11,37,38,-1,35
Cliftonville,4706,5,10,4,12,34,31,3,34
Ballymena,4706,6,7,5,14,27,49,-22,26
Glentoran,4706,7,6,6,10,24,32,-8,24
Dungannon,4706,8,2,4,16,14,47,-33,10
Crusaders,4707,1,17,6,3,63,31,32,57
Coleraine,4707,2,14,11,1,44,23,21,53
Glenavon,4707,3,9,10,7,53,44,9,37
Linfield,4707,4,10,6,10,38,37,1,36
Cliftonville,4707,5,9,5,12,33,32,1,32
Ballymena,4707,6,7,4,15,26,49,-23,25
Glentoran,4707,7,6,6,10,24,32,-8,24
Dungannon,4707,8,2,4,16,14,47,-33,10
Crusaders,4708,1,16,6,4,62,33,29,54
Coleraine,4708,2,14,10,2,43,24,19,52
Glenavon,4708,3,10,9,7,54,43,11,39
Linfield,4708,4,11,5,10,38,36,2,38
Cliftonville,4708,5,9,4,13,32,32,0,31
Ballymena,4708,6,8,4,14,28,48,-20,28
Glentoran,4708,7,6,6,10,24,32,-8,24
Dungannon,4708,8,2,4,16,14,47,-33,10
Coleraine,4709,1,15,10,1,45,23,22,55
Crusaders,4709,2,16,6,4,61,32,29,54
Glenavon,4709,3,9,9,8,53,45,8,36
Linfield,4709,4,10,5,11,37,37,0,35
Cliftonville,4709,5,10,4,12,33,31,2,34
Ballymena,4709,6,8,4,14,27,47,-20,28
Glentoran,4709,7,6,6,10,24,32,-8,24
Dungannon,4709,8,2,4,16,14,47,-33,10
Crusaders,4710,1,17,6,3,64,30,34,57
Coleraine,4710,2,15,10,1,44,22,22,55
Glenavon,4710,3,9,9,8,52,44,8,36
Linfield,4710,4,10,5,11,38,38,0,35
Cliftonville,4710,5,10,4,12,34,32,2,34
Ballymena,4710,6,7,4,15,25,50,-25,25
Glentoran,4710,7,6,6,10,24,32,-8,24
Dungannon,4710,8,2,4,16,14,47,-33,10
Crusaders,4711,1,17,6,3,63,31,32,57
Coleraine,4711,2,14,10,2,44,29,15,52
Glenavon,4711,3,10,9,7,59,44,15,39
Linfield,4711,4,10,5,11,38,39,-1,35
Cliftonville,4711,5,10,4,12,35,32,3,34
Ballymena,4711,6,7,4,15,26,49,-23,25
Glentoran,4711,7,6,6,10,24,32,-8,24
Dungannon,4711,8,2,4,16,14,47,-33,10
Crusaders,4712,1,16,7,3,61,30,31,55
Coleraine,4712,2,14,10,2,44,24,20,52
Glenavon,4712,3,10,9,7,54,44,10,39
Linfield,4712,4,11,5,10,40,36,4,38
Cliftonville,4712,5,9,4,13,32,34,-2,31
Ballymena,4712,6,7,5,14,25,47,-22,26
Glentoran,4712,7,6,6,10,24,32,-8,24
Dungannon,4712,8,2,4,16,14,47,-33,10
Crusaders,4713,1,17,6,3,63,31,32,57
Coleraine,4713,2,15,10,1,45,23,22,55
Linfield,4713,3,11,5,10,39,36,3,38
Glenavon,4713,4,9,9,8,53,45,8,36
Cliftonville,4713,5,9,4,13,32,33,-1,31
Ballymena,4713,6,7,4,15,26,49,-23,25
Glentoran,4713,7,6,6,10,24,32,-8,24
Dungannon,4713,8,2,4,16,14,47,-33,10
Coleraine,4714,1,15,10,1,46,22,24,55
Crusaders,4714,2,16,6,4,63,33,30,54
Glenavon,4714,3,9,9,8,52,46,6,36
Linfield,4714,4,10,5,11,37,37,0,35
Cliftonville,4714,5,10,4,12,33,31,2,34
Ballymena,4714,6,8,4,14,28,49,-21,28
Glentoran,4714,7,6,6,10,24,32,-8,24
Dungannon,4714,8,2,4,16,14,47,-33,10
Crusaders,4715,1,16,7,3,63,32,31,55
Coleraine,4715,2,15,10,1,46,24,22,55
Linfield,4715,3,11,5,10,38,36,2,38
Glenavon,4715,4,9,9,8,54,46,8,36
Cliftonville,4715,5,9,4,13,32,32,0,31
Ballymena,4715,6,7,5,14,27,49,-22,26
Glentoran,4715,7,6,6,10,24,32,-8,24
Dungannon,4715,8,2,4,16,14,47,-33,10
Crusaders,4716,1,17,6,3,64,31,33,57
Coleraine,4716,2,14,11,1,45,24,21,53
Glenavon,4716,3,9,10,7,54,45,9,37
Linfield,4716,4,10,6,10,38,37,1,36
Cliftonville,4716,5,9,5,12,33,32,1,32
Ballymena,4716,6,7,4,15,26,50,-24,25
Glentoran,4716,7,6,6,10,24,32,-8,24
Dungannon,4716,8,2,4,16,14,47,-33,10
Crusaders,4717,1,17,6,3,62,30,32,57
Coleraine,4717,2,14,10,2,45,25,20,52
Glenavon,4717,3,10,9,7,55,45,10,39
Linfield,4717,4,10,5,11,38,38,0,35
Cliftonville,4717,5,10,4,12,34,32,2,34
Ballymena,4717,6,7,4,15,25,48,-23,25
Glentoran,4717,7,6,6,10,24,32,-8,24
Dungannon,4717,8,2,4,16,14,47,-33,10
Crusaders,4718,1,17,6,3,63,30,33,57
Coleraine,4718,2,14,11,1,44,23,21,53
Linfield,4718,3,11,5,10,40,36,4,38
Glenavon,4718,4,9,10,7,53,44,9,37
Cliftonville,4718,5,9,4,13,32,34,-2,31
Ballymena,4718,6,7,4,15,25,49,-24,25
Glentoran,4718,7,6,6,10,24,32,-8,24
Dungannon,4718,8,2,4,16,14,47,-33,10
Crusaders,4719,1,17,6,3,64,30,34,57
Coleraine,4719,2,14,10,2,44,25,19,52
Glenavon,4719,3,10,9,7,55,44,11,39
Linfield,4719,4,10,5,11,38,38,0,35
Cliftonville,4719,5,10,4,12,34,32,2,34
Ballymena,4719,6,7,4,15,25,50,-25,25
Glentoran,4719,7,6,6,10,24,32,-8,24
Dungannon,4719,8,2,4,16,14,47,-33,10
Crusaders,4720,1,17,6,3,64,30,34,57
Coleraine,4720,2,15,10,1,46,23,23,55
Glenavon,4720,3,9,9,8,53,46,7,36
Linfield,4720,4,10,5,11,37,39,-2,35
Cliftonville,4720,5,10,4,12,35,31,4,34
Ballymena,4720,6,7,4,15,25,50,-25,25
Glentoran,4720,7,6,6,10,24,32,-8,24
Dungannon,4720,8,2,4,16,14,47,-33,10
Crusaders,4721,1,17,6,3,65,33,32,57
Coleraine,4721,2,14,11,1,44,23,21,53
Linfield,4721,3,11,5,10,39,37,2,38
Glenavon,4721,4,9,10,7,53,44,9,37
Cliftonville,4721,5,9,4,13,33,33,0,31
Ballymena,4721,6,7,4,15,28,51,-23,25
Glentoran,4721,7,6,6,10,24,32,-8,24
Dungannon,4721,8,2,4,16,14,47,-33,10
Crusaders,4722,1,16,7,3,63,32,31,55
Coleraine,4722,2,14,10,2,44,24,20,52
Glenavon,4722,3,10,9,7,54,44,10,39
Linfield,4722,4,11,5,10,39,36,3,38
Cliftonville,4722,5,9,4,13,32,33,-1,31
Ballymena,4722,6,7,5,14,27,49,-22,26
Glentoran,4722,7,6,6,10,24,32,-8,24
Dungannon,4722,8,2,4,16,14,47,-33,10
Crusaders,4723,1,16,6,4,63,33,30,54
Coleraine,4723,2,14,10,2,43,27,16,52
Glenavon,4723,3,10,9,7,57,43,14,39
Linfield,4723,4,11,5,10,39,37,2,38
Cliftonville,4723,5,9,4,13,33,33,0,31
Ballymena,4723,6,8,4,14,28,49,-21,28
Glentoran,4723,7,6,6,10,24,32,-8,24
Dungannon,4723,8,2,4,16,14,47,-33,10
Crusaders,4724,1,17,6,3,62,30,32,57
Coleraine,4724,2,15,10,1,46,23,23,55
Linfield,4724,3,11,5,10,39,37,2,38
Glenavon,4724,4,9,9,8,53,46,7,36
Cliftonville,4724,5,9,4,13,33,33,0,31
Ballymena,4724,6,7,4,15,25,48,-23,25
Glentoran,4724,7,6,6,10,24,32,-8,24
Dungannon,4724,8,2,4,16,14,47,-33,10
Crusaders,4725,1,17,6,3,63,31,32,57
Coleraine,4725,2,14,10,2,44,24,20,52
Glenavon,4725,3,10,9,7,54,44,10,39
Linfield,4725,4,11,5,10,38,36,2,38
Cliftonville,4725,5,9,4,13,32,32,0,31
Ballymena,4725,6,7,4,15,26,49,-23,25
Glentoran,4725,7,6,6,10,24,32,-8,24
Dungannon,4725,8,2,4,16,14,47,-33,10
Crusaders,4726,1,17,6,3,63,31,32,57
Coleraine,4726,2,15,10,1,48,23,25,55
Glenavon,4726,3,9,9,8,53,48,5,36
Linfield,4726,4,10,6,10,38,37,1,36
Cliftonville,4726,5,9,5,12,33,32,1,32
Ballymena,4726,6,7,4,15,26,49,-23,25
Glentoran,4726,7,6,6,10,24,32,-8,24
Dungannon,4726,8,2,4,16,14,47,-33,10
Crusaders,4727,1,17,6,3,64,32,32,57
Coleraine,4727,2,15,10,1,46,22,24,55
Glenavon,4727,3,9,9,8,52,46,6,36
Linfield,4727,4,10,6,10,39,38,1,36
Cliftonville,4727,5,9,5,12,34,33,1,32
Ballymena,4727,6,7,4,15,27,50,-23,25
Glentoran,4727,7,6,6,10,24,32,-8,24
Dungannon,4727,8,2,4,16,14,47,-33,10
Crusaders,4728,1,16,6,4,62,33,29,54
Coleraine,4728,2,14,11,1,44,23,21,53
Glenavon,4728,3,9,10,7,53,44,9,37
Linfield,4728,4,10,6,10,39,38,1,36
Cliftonville,4728,5,9,5,12,34,33,1,32
Ballymena,4728,6,8,4,14,28,48,-20,28
Glentoran,4728,7,6,6,10,24,32,-8,24
Dungannon,4728,8,2,4,16,14,47,-33,10
Crusaders,4729,1,17,6,3,62,30,32,57
Coleraine,4729,2,14,10,2,43,27,16,52
Glenavon,4729,3,10,9,7,57,43,14,39
Linfield,4729,4,10,6,10,37,36,1,36
Cliftonville,4729,5,9,5,12,32,31,1,32
Ballymena,4729,6,7,4,15,25,48,-23,25
Glentoran,4729,7,6,6,10,24,32,-8,24
Dungannon,4729,8,2,4,16,14,47,-33,10
Crusaders,4730,1,16,6,4,63,33,30,54
Coleraine,4730,2,14,10,2,43,23,20,52
Glenavon,4730,3,10,9,7,53,43,10,39
Linfield,4730,4,10,5,11,37,38,-1,35
Cliftonville,4730,5,10,4,12,34,31,3,34
Ballymena,4730,6,8,4,14,28,49,-21,28
Glentoran,4730,7,6,6,10,24,32,-8,24
Dungannon,4730,8,2,4,16,14,47,-33,10
Coleraine,4731,1,15,10,1,46,23,23,55
Crusaders,4731,2,16,6,4,61,31,30,54
Glenavon,4731,3,9,9,8,53,46,7,36
Linfield,4731,4,10,6,10,38,37,1,36
Cliftonville,4731,5,9,5,12,33,32,1,32
Ballymena,4731,6,8,4,14,26,47,-21,28
Glentoran,4731,7,6,6,10,24,32,-8,24
Dungannon,4731,8,2,4,16,14,47,-33,10
Crusaders,4732,1,16,7,3,63,32,31,55
Coleraine,4732,2,15,10,1,46,23,23,55
Glenavon,4732,3,9,9,8,53,46,7,36
Linfield,4732,4,10,5,11,37,38,-1,35
Cliftonville,4732,5,10,4,12,34,31,3,34
Ballymena,4732,6,7,5,14,27,49,-22,26
Glentoran,4732,7,6,6,10,24,32,-8,24
Dungannon,4732,8,2,4,16,14,47,-33,10
Crusaders,4733,1,17,6,3,63,30,33,57
Coleraine,4733,2,15,10,1,45,22,23,55
Glenavon,4733,3,9,9,8,52,45,7,36
Linfield,4733,4,10,5,11,39,39,0,35
Cliftonville,4733,5,10,4,12,35,33,2,34
Ballymena,4733,6,7,4,15,25,49,-24,25
Glentoran,4733,7,6,6,10,24,32,-8,24
Dungannon,4733,8,2,4,16,14,47,-33,10
Crusaders,4734,1,16,6,4,63,34,29,54
Coleraine,4734,2,14,11,1,43,22,21,53
Glenavon,4734,3,9,10,7,52,43,9,37
Linfield,4734,4,10,5,11,37,38,-1,35
Cliftonville,4734,5,10,4,12,34,31,3,34
Ballymena,4734,6,8,4,14,29,49,-20,28
Glentoran,4734,7,6,6,10,24,32,-8,24
Dungannon,4734,8,2,4,16,14,47,-33,10
Crusaders,4735,1,16,6,4,62,32,30,54
Coleraine,4735,2,14,10,2,43,25,18,52
Glenavon,4735,3,10,9,7,55,43,12,39
Linfield,4735,4,11,5,10,38,36,2,38
Cliftonville,4735,5,9,4,13,32,32,0,31
Ballymena,4735,6,8,4,14,27,48,-21,28
Glentoran,4735,7,6,6,10,24,32,-8,24
Dungannon,4735,8,2,4,16,14,47,-33,10
Crusaders,4736,1,16,7,3,63,32,31,55
Coleraine,4736,2,15,10,1,46,22,24,55
Linfield,4736,3,11,5,10,39,37,2,38
Glenavon,4736,4,9,9,8,52,46,6,36
Cliftonville,4736,5,9,4,13,33,33,0,31
Ballymena,4736,6,7,5,14,27,49,-22,26
Glentoran,4736,7,6,6,10,24,32,-8,24
Dungannon,4736,8,2,4,16,14,47,-33,10
Crusaders,4737,1,17,6,3,65,32,33,57
Coleraine,4737,2,14,10,2,44,26,18,52
Glenavon,4737,3,10,9,7,56,44,12,39
Linfield,4737,4,11,5,10,39,36,3,38
Cliftonville,4737,5,9,4,13,32,33,-1,31
Ballymena,4737,6,7,4,15,27,51,-24,25
Glentoran,4737,7,6,6,10,24,32,-8,24
Dungannon,4737,8,2,4,16,14,47,-33,10
Crusaders,4738,1,17,6,3,63,30,33,57
Coleraine,4738,2,14,10,2,44,24,20,52
Glenavon,4738,3,10,9,7,54,44,10,39
Linfield,4738,4,11,5,10,38,36,2,38
Cliftonville,4738,5,9,4,13,32,32,0,31
Ballymena,4738,6,7,4,15,25,49,-24,25
Glentoran,4738,7,6,6,10,24,32,-8,24
Dungannon,4738,8,2,4,16,14,47,-33,10
Crusaders,4739,1,17,6,3,63,30,33,57
Coleraine,4739,2,14,10,2,43,25,18,52
Glenavon,4739,3,10,9,7,55,43,12,39
Linfield,4739,4,11,5,10,40,37,3,38
Cliftonville,4739,5,9,4,13,33,34,-1,31
Ballymena,4739,6,7,4,15,25,49,-24,25
Glentoran,4739,7,6,6,10,24,32,-8,24
Dungannon,4739,8,2,4,16,14,47,-33,10
Crusaders,4740,1,16,6,4,61,31,30,54
Coleraine,4740,2,14,11,1,44,23,21,53
Glenavon,4740,3,9,10,7,53,44,9,37
Linfield,4740,4,10,5,11,37,38,-1,35
Cliftonville,4740,5,10,4,12,34,31,3,34
Ballymena,4740,6,8,4,14,26,47,-21,28
Glentoran,4740,7,6,6,10,24,32,-8,24
Dungannon,4740,8,2,4,16,14,47,-33,10
Coleraine,4741,1,15,10,1,47,24,23,55
Crusaders,4741,2,16,6,4,62,34,28,54
Linfield,4741,3,11,5,10,41,37,4,38
Glenavon,4741,4,9,9,8,54,47,7,36
Cliftonville,4741,5,9,4,13,33,35,-2,31
Ballymena,4741,6,8,4,14,29,48,-19,28
Glentoran,4741,7,6,6,10,24,32,-8,24
Dungannon,4741,8,2,4,16,14,47,-33,10
Crusaders,4742,1,17,6,3,63,30,33,57
Coleraine,4742,2,15,10,1,48,24,24,55
Linfield,4742,3,11,5,10,40,36,4,38
Glenavon,4742,4,9,9,8,54,48,6,36
Cliftonville,4742,5,9,4,13,32,34,-2,31
Ballymena,4742,6,7,4,15,25,49,-24,25
Glentoran,4742,7,6,6,10,24,32,-8,24
Dungannon,4742,8,2,4,16,14,47,-33,10
Crusaders,4743,1,17,6,3,63,30,33,57
Coleraine,4743,2,14,10,2,43,23,20,52
Glenavon,4743,3,10,9,7,53,43,10,39
Linfield,4743,4,10,5,11,37,38,-1,35
Cliftonville,4743,5,10,4,12,34,31,3,34
Ballymena,4743,6,7,4,15,25,49,-24,25
Glentoran,4743,7,6,6,10,24,32,-8,24
Dungannon,4743,8,2,4,16,14,47,-33,10
Crusaders,4744,1,16,6,4,61,31,30,54
Coleraine,4744,2,14,11,1,45,24,21,53
Linfield,4744,3,11,5,10,40,37,3,38
Glenavon,4744,4,9,10,7,54,45,9,37
Cliftonville,4744,5,9,4,13,33,34,-1,31
Ballymena,4744,6,8,4,14,26,47,-21,28
Glentoran,4744,7,6,6,10,24,32,-8,24
Dungannon,4744,8,2,4,16,14,47,-33,10
Crusaders,4745,1,16,7,3,63,32,31,55
Coleraine,4745,2,14,10,2,46,28,18,52
Glenavon,4745,3,10,9,7,58,46,12,39
Linfield,4745,4,10,6,10,37,36,1,36
Cliftonville,4745,5,9,5,12,32,31,1,32
Ballymena,4745,6,7,5,14,27,49,-22,26
Glentoran,4745,7,6,6,10,24,32,-8,24
Dungannon,4745,8,2,4,16,14,47,-33,10
Crusaders,4746,1,17,6,3,66,34,32,57
Coleraine,4746,2,14,10,2,44,26,18,52
Glenavon,4746,3,10,9,7,56,44,12,39
Linfield,4746,4,10,5,11,38,38,0,35
Cliftonville,4746,5,10,4,12,34,32,2,34
Ballymena,4746,6,7,4,15,29,52,-23,25
Glentoran,4746,7,6,6,10,24,32,-8,24
Dungannon,4746,8,2,4,16,14,47,-33,10
Crusaders,4747,1,16,6,4,63,33,30,54
Coleraine,4747,2,14,11,1,43,22,21,53
Glenavon,4747,3,9,10,7,52,43,9,37
Linfield,4747,4,10,6,10,37,36,1,36
Cliftonville,4747,5,9,5,12,32,31,1,32
Ballymena,4747,6,8,4,14,28,49,-21,28
Glentoran,4747,7,6,6,10,24,32,-8,24
Dungannon,4747,8,2,4,16,14,47,-33,10
Crusaders,4748,1,16,7,3,62,31,31,55
Coleraine,4748,2,15,10,1,46,23,23,55
Glenavon,4748,3,9,9,8,53,46,7,36
Linfield,4748,4,10,6,10,37,36,1,36
Cliftonville,4748,5,9,5,12,32,31,1,32
Ballymena,4748,6,7,5,14,26,48,-22,26
Glentoran,4748,7,6,6,10,24,32,-8,24
Dungannon,4748,8,2,4,16,14,47,-33,10
Crusaders,4749,1,17,6,3,65,31,34,57
Coleraine,4749,2,14,11,1,45,24,21,53
Glenavon,4749,3,9,10,7,54,45,9,37
Linfield,4749,4,10,6,10,40,39,1,36
Cliftonville,4749,5,9,5,12,35,34,1,32
Ballymena,4749,6,7,4,15,26,51,-25,25
Glentoran,4749,7,6,6,10,24,32,-8,24
Dungannon,4749,8,2,4,16,14,47,-33,10
Crusaders,4750,1,17,6,3,63,31,32,57
Coleraine,4750,2,15,10,1,44,22,22,55
Glenavon,4750,3,9,9,8,52,44,8,36
Linfield,4750,4,10,5,11,37,37,0,35
Cliftonville,4750,5,10,4,12,33,31,2,34
Ballymena,4750,6,7,4,15,26,49,-23,25
Glentoran,4750,7,6,6,10,24,32,-8,24
Dungannon,4750,8,2,4,16,14,47,-33,10
Crusaders,4751,1,17,6,3,63,31,32,57
Coleraine,4751,2,15,10,1,45,23,22,55
Linfield,4751,3,11,5,10,39,37,2,38
Glenavon,4751,4,9,9,8,53,45,8,36
Cliftonville,4751,5,9,4,13,33,33,0,31
Ballymena,4751,6,7,4,15,26,49,-23,25
Glentoran,4751,7,6,6,10,24,32,-8,24
Dungannon,4751,8,2,4,16,14,47,-33,10
Coleraine,4752,1,15,10,1,44,22,22,55
Crusaders,4752,2,16,6,4,61,31,30,54
Linfield,4752,3,11,5,10,42,36,6,38
Glenavon,4752,4,9,9,8,52,44,8,36
Cliftonville,4752,5,9,4,13,32,36,-4,31
Ballymena,4752,6,8,4,14,26,47,-21,28
Glentoran,4752,7,6,6,10,24,32,-8,24
Dungannon,4752,8,2,4,16,14,47,-33,10
Crusaders,4753,1,16,7,3,62,31,31,55
Coleraine,4753,2,15,10,1,45,23,22,55
Linfield,4753,3,11,5,10,40,37,3,38
Glenavon,4753,4,9,9,8,53,45,8,36
Cliftonville,4753,5,9,4,13,33,34,-1,31
Ballymena,4753,6,7,5,14,26,48,-22,26
Glentoran,4753,7,6,6,10,24,32,-8,24
Dungannon,4753,8,2,4,16,14,47,-33,10
Crusaders,4754,1,17,6,3,62,30,32,57
Coleraine,4754,2,14,10,2,43,23,20,52
Glenavon,4754,3,10,9,7,53,43,10,39
Linfield,4754,4,10,5,11,38,38,0,35
Cliftonville,4754,5,10,4,12,34,32,2,34
Ballymena,4754,6,7,4,15,25,48,-23,25
Glentoran,4754,7,6,6,10,24,32,-8,24
Dungannon,4754,8,2,4,16,14,47,-33,10
Crusaders,4755,1,16,6,4,61,32,29,54
Coleraine,4755,2,14,10,2,44,25,19,52
Glenavon,4755,3,10,9,7,55,44,11,39
Linfield,4755,4,10,5,11,37,38,-1,35
Cliftonville,4755,5,10,4,12,34,31,3,34
Ballymena,4755,6,8,4,14,27,47,-20,28
Glentoran,4755,7,6,6,10,24,32,-8,24
Dungannon,4755,8,2,4,16,14,47,-33,10
Crusaders,4756,1,16,6,4,63,34,29,54
Coleraine,4756,2,14,11,1,45,24,21,53
Glenavon,4756,3,9,10,7,54,45,9,37
Linfield,4756,4,10,5,11,37,38,-1,35
Cliftonville,4756,5,10,4,12,34,31,3,34
Ballymena,4756,6,8,4,14,29,49,-20,28
Glentoran,4756,7,6,6,10,24,32,-8,24
Dungannon,4756,8,2,4,16,14,47,-33,10
Crusaders,4757,1,17,6,3,63,30,33,57
Coleraine,4757,2,14,11,1,44,23,21,53
Glenavon,4757,3,9,10,7,53,44,9,37
Linfield,4757,4,10,6,10,38,37,1,36
Cliftonville,4757,5,9,5,12,33,32,1,32
Ballymena,4757,6,7,4,15,25,49,-24,25
Glentoran,4757,7,6,6,10,24,32,-8,24
Dungannon,4757,8,2,4,16,14,47,-33,10
Crusaders,4758,1,17,6,3,64,31,33,57
Coleraine,4758,2,15,10,1,45,23,22,55
Linfield,4758,3,11,5,10,40,36,4,38
Glenavon,4758,4,9,9,8,53,45,8,36
Cliftonville,4758,5,9,4,13,32,34,-2,31
Ballymena,4758,6,7,4,15,26,50,-24,25
Glentoran,4758,7,6,6,10,24,32,-8,24
Dungannon,4758,8,2,4,16,14,47,-33,10
Crusaders,4759,1,16,7,3,62,31,31,55
Coleraine,4759,2,15,10,1,46,22,24,55
Glenavon,4759,3,9,9,8,52,46,6,36
Linfield,4759,4,10,6,10,38,37,1,36
Cliftonville,4759,5,9,5,12,33,32,1,32
Ballymena,4759,6,7,5,14,26,48,-22,26
Glentoran,4759,7,6,6,10,24,32,-8,24
Dungannon,4759,8,2,4,16,14,47,-33,10
Crusaders,4760,1,17,6,3,63,31,32,57
Coleraine,4760,2,14,10,2,43,23,20,52
Glenavon,4760,3,10,9,7,53,43,10,39
Linfield,4760,4,10,6,10,37,36,1,36
Cliftonville,4760,5,9,5,12,32,31,1,32
Ballymena,4760,6,7,4,15,26,49,-23,25
Glentoran,4760,7,6,6,10,24,32,-8,24
Dungannon,4760,8,2,4,16,14,47,-33,10
Crusaders,4761,1,17,6,3,63,31,32,57
Coleraine,4761,2,14,11,1,45,24,21,53
Glenavon,4761,3,9,10,7,54,45,9,37
Linfield,4761,4,10,6,10,37,36,1,36
Cliftonville,4761,5,9,5,12,32,31,1,32
Ballymena,4761,6,7,4,15,26,49,-23,25
Glentoran,4761,7,6,6,10,24,32,-8,24
Dungannon,4761,8,2,4,16,14,47,-33,10
Crusaders,4762,1,17,6,3,64,32,32,57
Coleraine,4762,2,14,10,2,43,23,20,52
Glenavon,4762,3,10,9,7,53,43,10,39
Linfield,4762,4,10,5,11,37,37,0,35
Cliftonville,4762,5,10,4,12,33,31,2,34
Ballymena,4762,6,7,4,15,27,50,-23,25
Glentoran,4762,7,6,6,10,24,32,-8,24
Dungannon,4762,8,2,4,16,14,47,-33,10
Coleraine,4763,1,15,10,1,47,25,22,55
Crusaders,4763,2,16,6,4,63,33,30,54
Glenavon,4763,3,9,9,8,55,47,8,36
Linfield,4763,4,10,5,11,37,38,-1,35
Cliftonville,4763,5,10,4,12,34,31,3,34
Ballymena,4763,6,8,4,14,28,49,-21,28
Glentoran,4763,7,6,6,10,24,32,-8,24
Dungannon,4763,8,2,4,16,14,47,-33,10
Crusaders,4764,1,17,6,3,64,32,32,57
Coleraine,4764,2,14,11,1,44,23,21,53
Linfield,4764,3,11,5,10,38,36,2,38
Glenavon,4764,4,9,10,7,53,44,9,37
Cliftonville,4764,5,9,4,13,32,32,0,31
Ballymena,4764,6,7,4,15,27,50,-23,25
Glentoran,4764,7,6,6,10,24,32,-8,24
Dungannon,4764,8,2,4,16,14,47,-33,10
Crusaders,4765,1,16,7,3,64,33,31,55
Coleraine,4765,2,14,10,2,43,24,19,52
Glenavon,4765,3,10,9,7,54,43,11,39
Linfield,4765,4,10,6,10,38,37,1,36
Cliftonville,4765,5,9,5,12,33,32,1,32
Ballymena,4765,6,7,5,14,28,50,-22,26
Glentoran,4765,7,6,6,10,24,32,-8,24
Dungannon,4765,8,2,4,16,14,47,-33,10
Crusaders,4766,1,17,6,3,66,32,34,57
Coleraine,4766,2,14,10,2,43,23,20,52
Glenavon,4766,3,10,9,7,53,43,10,39
Linfield,4766,4,11,5,10,42,37,5,38
Cliftonville,4766,5,9,4,13,33,36,-3,31
Ballymena,4766,6,7,4,15,27,52,-25,25
Glentoran,4766,7,6,6,10,24,32,-8,24
Dungannon,4766,8,2,4,16,14,47,-33,10
Crusaders,4767,1,16,7,3,63,32,31,55
Coleraine,4767,2,14,10,2,44,26,18,52
Glenavon,4767,3,10,9,7,56,44,12,39
Linfield,4767,4,10,5,11,38,38,0,35
Cliftonville,4767,5,10,4,12,34,32,2,34
Ballymena,4767,6,7,5,14,27,49,-22,26
Glentoran,4767,7,6,6,10,24,32,-8,24
Dungannon,4767,8,2,4,16,14,47,-33,10
Crusaders,4768,1,16,7,3,61,30,31,55
Coleraine,4768,2,15,10,1,48,23,25,55
Glenavon,4768,3,9,9,8,53,48,5,36
Linfield,4768,4,10,5,11,37,38,-1,35
Cliftonville,4768,5,10,4,12,34,31,3,34
Ballymena,4768,6,7,5,14,25,47,-22,26
Glentoran,4768,7,6,6,10,24,32,-8,24
Dungannon,4768,8,2,4,16,14,47,-33,10
Crusaders,4769,1,16,6,4,62,34,28,54
Coleraine,4769,2,14,10,2,44,25,19,52
Glenavon,4769,3,10,9,7,55,44,11,39
Linfield,4769,4,11,5,10,39,37,2,38
Cliftonville,4769,5,9,4,13,33,33,0,31
Ballymena,4769,6,8,4,14,29,48,-19,28
Glentoran,4769,7,6,6,10,24,32,-8,24
Dungannon,4769,8,2,4,16,14,47,-33,10
Crusaders,4770,1,17,6,3,64,30,34,57
Coleraine,4770,2,15,10,1,46,24,22,55
Linfield,4770,3,11,5,10,40,37,3,38
Glenavon,4770,4,9,9,8,54,46,8,36
Cliftonville,4770,5,9,4,13,33,34,-1,31
Ballymena,4770,6,7,4,15,25,50,-25,25
Glentoran,4770,7,6,6,10,24,32,-8,24
Dungannon,4770,8,2,4,16,14,47,-33,10
Crusaders,4771,1,17,6,3,67,32,35,57
Coleraine,4771,2,14,10,2,43,26,17,52
Glenavon,4771,3,10,9,7,56,43,13,39
Linfield,4771,4,10,5,11,38,38,0,35
Cliftonville,4771,5,10,4,12,34,32,2,34
Ballymena,4771,6,7,4,15,27,53,-26,25
Glentoran,4771,7,6,6,10,24,32,-8,24
Dungannon,4771,8,2,4,16,14,47,-33,10
Crusaders,4772,1,17,6,3,62,30,32,57
Coleraine,4772,2,14,10,2,46,26,20,52
Glenavon,4772,3,10,9,7,56,46,10,39
Linfield,4772,4,11,5,10,40,37,3,38
Cliftonville,4772,5,9,4,13,33,34,-1,31
Ballymena,4772,6,7,4,15,25,48,-23,25
Glentoran,4772,7,6,6,10,24,32,-8,24
Dungannon,4772,8,2,4,16,14,47,-33,10
Crusaders,4773,1,17,6,3,65,31,34,57
Coleraine,4773,2,15,10,1,45,23,22,55
Linfield,4773,3,11,5,10,38,36,2,38
Glenavon,4773,4,9,9,8,53,45,8,36
Cliftonville,4773,5,9,4,13,32,32,0,31
Ballymena,4773,6,7,4,15,26,51,-25,25
Glentoran,4773,7,6,6,10,24,32,-8,24
Dungannon,4773,8,2,4,16,14,47,-33,10
Crusaders,4774,1,17,6,3,64,32,32,57
Coleraine,4774,2,14,11,1,43,22,21,53
Glenavon,4774,3,9,10,7,52,43,9,37
Linfield,4774,4,10,5,11,37,38,-1,35
Cliftonville,4774,5,10,4,12,34,31,3,34
Ballymena,4774,6,7,4,15,27,50,-23,25
Glentoran,4774,7,6,6,10,24,32,-8,24
Dungannon,4774,8,2,4,16,14,47,-33,10
Crusaders,4775,1,16,6,4,63,33,30,54
Coleraine,4775,2,14,11,1,45,24,21,53
Linfield,4775,3,11,5,10,41,39,2,38
Glenavon,4775,4,9,10,7,54,45,9,37
Cliftonville,4775,5,9,4,13,35,35,0,31
Ballymena,4775,6,8,4,14,28,49,-21,28
Glentoran,4775,7,6,6,10,24,32,-8,24
Dungannon,4775,8,2,4,16,14,47,-33,10
Crusaders,4776,1,16,6,4,61,33,28,54
Coleraine,4776,2,14,10,2,44,24,20,52
Glenavon,4776,3,10,9,7,54,44,10,39
Linfield,4776,4,11,5,10,38,36,2,38
Cliftonville,4776,5,9,4,13,32,32,0,31
Ballymena,4776,6,8,4,14,28,47,-19,28
Glentoran,4776,7,6,6,10,24,32,-8,24
Dungannon,4776,8,2,4,16,14,47,-33,10
Coleraine,4777,1,15,10,1,46,23,23,55
Crusaders,4777,2,16,6,4,62,32,30,54
Linfield,4777,3,11,5,10,40,36,4,38
Glenavon,4777,4,9,9,8,53,46,7,36
Cliftonville,4777,5,9,4,13,32,34,-2,31
Ballymena,4777,6,8,4,14,27,48,-21,28
Glentoran,4777,7,6,6,10,24,32,-8,24
Dungannon,4777,8,2,4,16,14,47,-33,10
Crusaders,4778,1,16,6,4,62,32,30,54
Coleraine,4778,2,14,11,1,45,24,21,53
Glenavon,4778,3,9,10,7,54,45,9,37
Linfield,4778,4,10,6,10,38,37,1,36
Cliftonville,4778,5,9,5,12,33,32,1,32
Ballymena,4778,6,8,4,14,27,48,-21,28
Glentoran,4778,7,6,6,10,24,32,-8,24
Dungannon,4778,8,2,4,16,14,47,-33,10
Crusaders,4779,1,17,6,3,65,31,34,57
Coleraine,4779,2,15,10,1,46,24,22,55
Linfield,4779,3,11,5,10,39,36,3,38
Glenavon,4779,4,9,9,8,54,46,8,36
Cliftonville,4779,5,9,4,13,32,33,-1,31
Ballymena,4779,6,7,4,15,26,51,-25,25
Glentoran,4779,7,6,6,10,24,32,-8,24
Dungannon,4779,8,2,4,16,14,47,-33,10
Crusaders,4780,1,16,6,4,62,32,30,54
Coleraine,4780,2,14,10,2,43,23,20,52
Glenavon,4780,3,10,9,7,53,43,10,39
Linfield,4780,4,11,5,10,40,36,4,38
Cliftonville,4780,5,9,4,13,32,34,-2,31
Ballymena,4780,6,8,4,14,27,48,-21,28
Glentoran,4780,7,6,6,10,24,32,-8,24
Dungannon,4780,8,2,4,16,14,47,-33,10
Crusaders,4781,1,16,6,4,62,33,29,54
Coleraine,4781,2,14,10,2,43,23,20,52
Glenavon,4781,3,10,9,7,53,43,10,39
Linfield,4781,4,10,6,10,38,37,1,36
Cliftonville,4781,5,9,5,12,33,32,1,32
Ballymena,4781,6,8,4,14,28,48,-20,28
Glentoran,4781,7,6,6,10,24,32,-8,24
Dungannon,4781,8,2,4,16,14,47,-33,10
Crusaders,4782,1,17,6,3,63,30,33,57
Coleraine,4782,2,15,10,1,44,22,22,55
Glenavon,4782,3,9,9,8,52,44,8,36
Linfield,4782,4,10,5,11,38,39,-1,35
Cliftonville,4782,5,10,4,12,35,32,3,34
Ballymena,4782,6,7,4,15,25,49,-24,25
Glentoran,4782,7,6,6,10,24,32,-8,24
Dungannon,4782,8,2,4,16,14,47,-33,10
Crusaders,4783,1,17,6,3,64,32,32,57
Coleraine,4783,2,14,10,2,43,23,20,52
Glenavon,4783,3,10,9,7,53,43,10,39
Linfield,4783,4,10,5,11,38,38,0,35
Cliftonville,4783,5,10,4,12,34,32,2,34
Ballymena,4783,6,7,4,15,27,50,-23,25
Glentoran,4783,7,6,6,10,24,32,-8,24
Dungannon,4783,8,2,4,16,14,47,-33,10
Crusaders,4784,1,17,6,3,65,32,33,57
Coleraine,4784,2,14,11,1,44,23,21,53
Linfield,4784,3,11,5,10,39,37,2,38
Glenavon,4784,4,9,10,7,53,44,9,37
Cliftonville,4784,5,9,4,13,33,33,0,31
Ballymena,4784,6,7,4,15,27,51,-24,25
Glentoran,4784,7,6,6,10,24,32,-8,24
Dungannon,4784,8,2,4,16,14,47,-33,10
Crusaders,4785,1,17,6,3,69,31,38,57
Coleraine,4785,2,14,11,1,43,22,21,53
Linfield,4785,3,11,5,10,46,36,10,38
Glenavon,4785,4,9,10,7,52,43,9,37
Cliftonville,4785,5,9,4,13,32,40,-8,31
Ballymena,4785,6,7,4,15,26,55,-29,25
Glentoran,4785,7,6,6,10,24,32,-8,24
Dungannon,4785,8,2,4,16,14,47,-33,10
Crusaders,4786,1,17,6,3,65,31,34,57
Coleraine,4786,2,14,10,2,44,24,20,52
Glenavon,4786,3,10,9,7,54,44,10,39
Linfield,4786,4,10,6,10,38,37,1,36
Cliftonville,4786,5,9,5,12,33,32,1,32
Ballymena,4786,6,7,4,15,26,51,-25,25
Glentoran,4786,7,6,6,10,24,32,-8,24
Dungannon,4786,8,2,4,16,14,47,-33,10
Crusaders,4787,1,17,6,3,63,31,32,57
Coleraine,4787,2,14,10,2,44,26,18,52
Glenavon,4787,3,10,9,7,56,44,12,39
Linfield,4787,4,11,5,10,39,36,3,38
Cliftonville,4787,5,9,4,13,32,33,-1,31
Ballymena,4787,6,7,4,15,26,49,-23,25
Glentoran,4787,7,6,6,10,24,32,-8,24
Dungannon,4787,8,2,4,16,14,47,-33,10
Crusaders,4788,1,17,6,3,66,30,36,57
Coleraine,4788,2,14,11,1,46,25,21,53
Linfield,4788,3,11,5,10,40,38,2,38
Glenavon,4788,4,9,10,7,55,46,9,37
Cliftonville,4788,5,9,4,13,34,34,0,31
Ballymena,4788,6,7,4,15,25,52,-27,25
Glentoran,4788,7,6,6,10,24,32,-8,24
Dungannon,4788,8,2,4,16,14,47,-33,10
Crusaders,4789,1,17,6,3,62,30,32,57
Coleraine,4789,2,14,11,1,44,23,21,53
Glenavon,4789,3,9,10,7,53,44,9,37
Linfield,4789,4,10,5,11,38,38,0,35
Cliftonville,4789,5,10,4,12,34,32,2,34
Ballymena,4789,6,7,4,15,25,48,-23,25
Glentoran,4789,7,6,6,10,24,32,-8,24
Dungannon,4789,8,2,4,16,14,47,-33,10
Crusaders,4790,1,16,6,4,62,33,29,54
Coleraine,4790,2,14,10,2,44,24,20,52
Glenavon,4790,3,10,9,7,54,44,10,39
Linfield,4790,4,10,6,10,39,38,1,36
Cliftonville,4790,5,9,5,12,34,33,1,32
Ballymena,4790,6,8,4,14,28,48,-20,28
Glentoran,4790,7,6,6,10,24,32,-8,24
Dungannon,4790,8,2,4,16,14,47,-33,10
Crusaders,4791,1,17,6,3,63,30,33,57
Coleraine,4791,2,15,10,1,45,23,22,55
Linfield,4791,3,11,5,10,43,37,6,38
Glenavon,4791,4,9,9,8,53,45,8,36
Cliftonville,4791,5,9,4,13,33,37,-4,31
Ballymena,4791,6,7,4,15,25,49,-24,25
Glentoran,4791,7,6,6,10,24,32,-8,24
Dungannon,4791,8,2,4,16,14,47,-33,10
Crusaders,4792,1,16,6,4,64,34,30,54
Coleraine,4792,2,14,10,2,43,25,18,52
Glenavon,4792,3,10,9,7,55,43,12,39
Linfield,4792,4,11,5,10,40,36,4,38
Cliftonville,4792,5,9,4,13,32,34,-2,31
Ballymena,4792,6,8,4,14,29,50,-21,28
Glentoran,4792,7,6,6,10,24,32,-8,24
Dungannon,4792,8,2,4,16,14,47,-33,10
Crusaders,4793,1,17,6,3,65,31,34,57
Coleraine,4793,2,15,10,1,45,22,23,55
Linfield,4793,3,11,5,10,39,36,3,38
Glenavon,4793,4,9,9,8,52,45,7,36
Cliftonville,4793,5,9,4,13,32,33,-1,31
Ballymena,4793,6,7,4,15,26,51,-25,25
Glentoran,4793,7,6,6,10,24,32,-8,24
Dungannon,4793,8,2,4,16,14,47,-33,10
Crusaders,4794,1,17,6,3,64,31,33,57
Coleraine,4794,2,14,11,1,43,22,21,53
Glenavon,4794,3,9,10,7,52,43,9,37
Linfield,4794,4,10,5,11,37,37,0,35
Cliftonville,4794,5,10,4,12,33,31,2,34
Ballymena,4794,6,7,4,15,26,50,-24,25
Glentoran,4794,7,6,6,10,24,32,-8,24
Dungannon,4794,8,2,4,16,14,47,-33,10
Crusaders,4795,1,17,6,3,64,30,34,57
Coleraine,4795,2,14,11,1,44,23,21,53
Glenavon,4795,3,9,10,7,53,44,9,37
Linfield,4795,4,10,6,10,37,36,1,36
Cliftonville,4795,5,9,5,12,32,31,1,32
Ballymena,4795,6,7,4,15,25,50,-25,25
Glentoran,4795,7,6,6,10,24,32,-8,24
Dungannon,4795,8,2,4,16,14,47,-33,10
Coleraine,4796,1,15,10,1,50,25,25,55
Crusaders,4796,2,16,6,4,61,31,30,54
Glenavon,4796,3,9,9,8,55,50,5,36
Linfield,4796,4,10,5,11,39,39,0,35
Cliftonville,4796,5,10,4,12,35,33,2,34
Ballymena,4796,6,8,4,14,26,47,-21,28
Glentoran,4796,7,6,6,10,24,32,-8,24
Dungannon,4796,8,2,4,16,14,47,-33,10
Crusaders,4797,1,16,6,4,62,32,30,54
Coleraine,4797,2,14,10,2,45,25,20,52
Glenavon,4797,3,10,9,7,55,45,10,39
Linfield,4797,4,10,6,10,38,37,1,36
Cliftonville,4797,5,9,5,12,33,32,1,32
Ballymena,4797,6,8,4,14,27,48,-21,28
Glentoran,4797,7,6,6,10,24,32,-8,24
Dungannon,4797,8,2,4,16,14,47,-33,10
Crusaders,4798,1,16,6,4,62,32,30,54
Coleraine,4798,2,14,11,1,44,23,21,53
Glenavon,4798,3,9,10,7,53,44,9,37
Linfield,4798,4,10,6,10,37,36,1,36
Cliftonville,4798,5,9,5,12,32,31,1,32
Ballymena,4798,6,8,4,14,27,48,-21,28
Glentoran,4798,7,6,6,10,24,32,-8,24
Dungannon,4798,8,2,4,16,14,47,-33,10
Crusaders,4799,1,17,6,3,64,31,33,57
Coleraine,4799,2,14,10,2,45,25,20,52
Glenavon,4799,3,10,9,7,55,45,10,39
Linfield,4799,4,11,5,10,40,37,3,38
Cliftonville,4799,5,9,4,13,33,34,-1,31
Ballymena,4799,6,7,4,15,26,50,-24,25
Glentoran,4799,7,6,6,10,24,32,-8,24
Dungannon,4799,8,2,4,16,14,47,-33,10
Crusaders,4800,1,17,6,3,66,32,34,57
Coleraine,4800,2,14,11,1,43,22,21,53
Glenavon,4800,3,9,10,7,52,43,9,37
Linfield,4800,4,10,6,10,38,37,1,36
Cliftonville,4800,5,9,5,12,33,32,1,32
Ballymena,4800,6,7,4,15,27,52,-25,25
Glentoran,4800,7,6,6,10,24,32,-8,24
Dungannon,4800,8,2,4,16,14,47,-33,10
Crusaders,4801,1,16,6,4,61,31,30,54
Coleraine,4801,2,14,11,1,46,25,21,53
Linfield,4801,3,11,5,10,39,36,3,38
Glenavon,4801,4,9,10,7,55,46,9,37
Cliftonville,4801,5,9,4,13,32,33,-1,31
Ballymena,4801,6,8,4,14,26,47,-21,28
Glentoran,4801,7,6,6,10,24,32,-8,24
Dungannon,4801,8,2,4,16,14,47,-33,10
Crusaders,4802,1,16,6,4,61,32,29,54
Coleraine,4802,2,14,10,2,44,24,20,52
Glenavon,4802,3,10,9,7,54,44,10,39
Linfield,4802,4,11,5,10,40,36,4,38
Cliftonville,4802,5,9,4,13,32,34,-2,31
Ballymena,4802,6,8,4,14,27,47,-20,28
Glentoran,4802,7,6,6,10,24,32,-8,24
Dungannon,4802,8,2,4,16,14,47,-33,10
Coleraine,4803,1,15,10,1,44,22,22,55
Crusaders,4803,2,16,6,4,62,32,30,54
Glenavon,4803,3,9,9,8,52,44,8,36
Linfield,4803,4,10,6,10,39,38,1,36
Cliftonville,4803,5,9,5,12,34,33,1,32
Ballymena,4803,6,8,4,14,27,48,-21,28
Glentoran,4803,7,6,6,10,24,32,-8,24
Dungannon,4803,8,2,4,16,14,47,-33,10
Crusaders,4804,1,17,6,3,63,30,33,57
Coleraine,4804,2,15,10,1,44,22,22,55
Linfield,4804,3,11,5,10,40,36,4,38
Glenavon,4804,4,9,9,8,52,44,8,36
Cliftonville,4804,5,9,4,13,32,34,-2,31
Ballymena,4804,6,7,4,15,25,49,-24,25
Glentoran,4804,7,6,6,10,24,32,-8,24
Dungannon,4804,8,2,4,16,14,47,-33,10
Crusaders,4805,1,17,6,3,62,30,32,57
Coleraine,4805,2,15,10,1,47,23,24,55
Linfield,4805,3,11,5,10,39,36,3,38
Glenavon,4805,4,9,9,8,53,47,6,36
Cliftonville,4805,5,9,4,13,32,33,-1,31
Ballymena,4805,6,7,4,15,25,48,-23,25
Glentoran,4805,7,6,6,10,24,32,-8,24
Dungannon,4805,8,2,4,16,14,47,-33,10
Coleraine,4806,1,15,10,1,45,23,22,55
Crusaders,4806,2,16,6,4,62,33,29,54
Glenavon,4806,3,9,9,8,53,45,8,36
Linfield,4806,4,10,5,11,37,37,0,35
Cliftonville,4806,5,10,4,12,33,31,2,34
Ballymena,4806,6,8,4,14,28,48,-20,28
Glentoran,4806,7,6,6,10,24,32,-8,24
Dungannon,4806,8,2,4,16,14,47,-33,10
Crusaders,4807,1,17,6,3,64,31,33,57
Coleraine,4807,2,14,10,2,45,25,20,52
Glenavon,4807,3,10,9,7,55,45,10,39
Linfield,4807,4,11,5,10,39,36,3,38
Cliftonville,4807,5,9,4,13,32,33,-1,31
Ballymena,4807,6,7,4,15,26,50,-24,25
Glentoran,4807,7,6,6,10,24,32,-8,24
Dungannon,4807,8,2,4,16,14,47,-33,10
Crusaders,4808,1,17,6,3,64,31,33,57
Coleraine,4808,2,14,11,1,44,23,21,53
Glenavon,4808,3,9,10,7,53,44,9,37
Linfield,4808,4,10,5,11,38,38,0,35
Cliftonville,4808,5,10,4,12,34,32,2,34
Ballymena,4808,6,7,4,15,26,50,-24,25
Glentoran,4808,7,6,6,10,24,32,-8,24
Dungannon,4808,8,2,4,16,14,47,-33,10
Crusaders,4809,1,16,7,3,63,32,31,55
Coleraine,4809,2,15,10,1,45,23,22,55
Glenavon,4809,3,9,9,8,53,45,8,36
Linfield,4809,4,10,5,11,37,38,-1,35
Cliftonville,4809,5,10,4,12,34,31,3,34
Ballymena,4809,6,7,5,14,27,49,-22,26
Glentoran,4809,7,6,6,10,24,32,-8,24
Dungannon,4809,8,2,4,16,14,47,-33,10
Coleraine,4810,1,15,10,1,46,22,24,55
Crusaders,4810,2,16,6,4,61,31,30,54
Linfield,4810,3,11,5,10,40,38,2,38
Glenavon,4810,4,9,9,8,52,46,6,36
Cliftonville,4810,5,9,4,13,34,34,0,31
Ballymena,4810,6,8,4,14,26,47,-21,28
Glentoran,4810,7,6,6,10,24,32,-8,24
Dungannon,4810,8,2,4,16,14,47,-33,10
Crusaders,4811,1,16,7,3,62,31,31,55
Coleraine,4811,2,15,10,1,46,24,22,55
Linfield,4811,3,11,5,10,40,36,4,38
Glenavon,4811,4,9,9,8,54,46,8,36
Cliftonville,4811,5,9,4,13,32,34,-2,31
Ballymena,4811,6,7,5,14,26,48,-22,26
Glentoran,4811,7,6,6,10,24,32,-8,24
Dungannon,4811,8,2,4,16,14,47,-33,10
Crusaders,4812,1,17,6,3,66,30,36,57
Coleraine,4812,2,14,10,2,44,24,20,52
Glenavon,4812,3,10,9,7,54,44,10,39
Linfield,4812,4,10,5,11,37,37,0,35
Cliftonville,4812,5,10,4,12,33,31,2,34
Ballymena,4812,6,7,4,15,25,52,-27,25
Glentoran,4812,7,6,6,10,24,32,-8,24
Dungannon,4812,8,2,4,16,14,47,-33,10
Crusaders,4813,1,17,6,3,64,30,34,57
Coleraine,4813,2,14,10,2,44,24,20,52
Glenavon,4813,3,10,9,7,54,44,10,39
Linfield,4813,4,10,5,11,37,38,-1,35
Cliftonville,4813,5,10,4,12,34,31,3,34
Ballymena,4813,6,7,4,15,25,50,-25,25
Glentoran,4813,7,6,6,10,24,32,-8,24
Dungannon,4813,8,2,4,16,14,47,-33,10
Crusaders,4814,1,16,7,3,61,30,31,55
Coleraine,4814,2,14,10,2,44,25,19,52
Glenavon,4814,3,10,9,7,55,44,11,39
Linfield,4814,4,11,5,10,38,36,2,38
Cliftonville,4814,5,9,4,13,32,32,0,31
Ballymena,4814,6,7,5,14,25,47,-22,26
Glentoran,4814,7,6,6,10,24,32,-8,24
Dungannon,4814,8,2,4,16,14,47,-33,10
Crusaders,4815,1,17,6,3,66,31,35,57
Coleraine,4815,2,14,10,2,43,24,19,52
Glenavon,4815,3,10,9,7,54,43,11,39
Linfield,4815,4,11,5,10,40,37,3,38
Cliftonville,4815,5,9,4,13,33,34,-1,31
Ballymena,4815,6,7,4,15,26,52,-26,25
Glentoran,4815,7,6,6,10,24,32,-8,24
Dungannon,4815,8,2,4,16,14,47,-33,10
Crusaders,4816,1,17,6,3,62,30,32,57
Coleraine,4816,2,14,11,1,44,23,21,53
Glenavon,4816,3,9,10,7,53,44,9,37
Linfield,4816,4,10,5,11,38,38,0,35
Cliftonville,4816,5,10,4,12,34,32,2,34
Ballymena,4816,6,7,4,15,25,48,-23,25
Glentoran,4816,7,6,6,10,24,32,-8,24
Dungannon,4816,8,2,4,16,14,47,-33,10
Crusaders,4817,1,17,6,3,63,31,32,57
Coleraine,4817,2,14,11,1,43,22,21,53
Linfield,4817,3,11,5,10,41,36,5,38
Glenavon,4817,4,9,10,7,52,43,9,37
Cliftonville,4817,5,9,4,13,32,35,-3,31
Ballymena,4817,6,7,4,15,26,49,-23,25
Glentoran,4817,7,6,6,10,24,32,-8,24
Dungannon,4817,8,2,4,16,14,47,-33,10
Crusaders,4818,1,17,6,3,64,30,34,57
Coleraine,4818,2,14,10,2,45,25,20,52
Glenavon,4818,3,10,9,7,55,45,10,39
Linfield,4818,4,10,5,11,40,40,0,35
Cliftonville,4818,5,10,4,12,36,34,2,34
Ballymena,4818,6,7,4,15,25,50,-25,25
Glentoran,4818,7,6,6,10,24,32,-8,24
Dungannon,4818,8,2,4,16,14,47,-33,10
Crusaders,4819,1,17,6,3,63,31,32,57
Coleraine,4819,2,15,10,1,46,22,24,55
Linfield,4819,3,11,5,10,39,37,2,38
Glenavon,4819,4,9,9,8,52,46,6,36
Cliftonville,4819,5,9,4,13,33,33,0,31
Ballymena,4819,6,7,4,15,26,49,-23,25
Glentoran,4819,7,6,6,10,24,32,-8,24
Dungannon,4819,8,2,4,16,14,47,-33,10
Crusaders,4820,1,17,6,3,65,32,33,57
Coleraine,4820,2,14,10,2,44,25,19,52
Glenavon,4820,3,10,9,7,55,44,11,39
Linfield,4820,4,10,5,11,37,37,0,35
Cliftonville,4820,5,10,4,12,33,31,2,34
Ballymena,4820,6,7,4,15,27,51,-24,25
Glentoran,4820,7,6,6,10,24,32,-8,24
Dungannon,4820,8,2,4,16,14,47,-33,10
Crusaders,4821,1,16,6,4,62,32,30,54
Coleraine,4821,2,14,10,2,44,24,20,52
Glenavon,4821,3,10,9,7,54,44,10,39
Linfield,4821,4,11,5,10,41,37,4,38
Cliftonville,4821,5,9,4,13,33,35,-2,31
Ballymena,4821,6,8,4,14,27,48,-21,28
Glentoran,4821,7,6,6,10,24,32,-8,24
Dungannon,4821,8,2,4,16,14,47,-33,10
Crusaders,4822,1,17,6,3,66,32,34,57
Coleraine,4822,2,14,11,1,45,24,21,53
Linfield,4822,3,11,5,10,39,36,3,38
Glenavon,4822,4,9,10,7,54,45,9,37
Cliftonville,4822,5,9,4,13,32,33,-1,31
Ballymena,4822,6,7,4,15,27,52,-25,25
Glentoran,4822,7,6,6,10,24,32,-8,24
Dungannon,4822,8,2,4,16,14,47,-33,10
Crusaders,4823,1,16,6,4,62,33,29,54
Coleraine,4823,2,14,10,2,44,25,19,52
Glenavon,4823,3,10,9,7,55,44,11,39
Linfield,4823,4,10,6,10,37,36,1,36
Cliftonville,4823,5,9,5,12,32,31,1,32
Ballymena,4823,6,8,4,14,28,48,-20,28
Glentoran,4823,7,6,6,10,24,32,-8,24
Dungannon,4823,8,2,4,16,14,47,-33,10
Crusaders,4824,1,17,6,3,62,30,32,57
Coleraine,4824,2,14,10,2,43,25,18,52
Glenavon,4824,3,10,9,7,55,43,12,39
Linfield,4824,4,10,6,10,39,38,1,36
Cliftonville,4824,5,9,5,12,34,33,1,32
Ballymena,4824,6,7,4,15,25,48,-23,25
Glentoran,4824,7,6,6,10,24,32,-8,24
Dungannon,4824,8,2,4,16,14,47,-33,10
Crusaders,4825,1,17,6,3,65,30,35,57
Coleraine,4825,2,14,10,2,44,24,20,52
Glenavon,4825,3,10,9,7,54,44,10,39
Linfield,4825,4,11,5,10,41,36,5,38
Cliftonville,4825,5,9,4,13,32,35,-3,31
Ballymena,4825,6,7,4,15,25,51,-26,25
Glentoran,4825,7,6,6,10,24,32,-8,24
Dungannon,4825,8,2,4,16,14,47,-33,10
Crusaders,4826,1,17,6,3,64,31,33,57
Coleraine,4826,2,14,11,1,44,23,21,53
Linfield,4826,3,11,5,10,39,36,3,38
Glenavon,4826,4,9,10,7,53,44,9,37
Cliftonville,4826,5,9,4,13,32,33,-1,31
Ballymena,4826,6,7,4,15,26,50,-24,25
Glentoran,4826,7,6,6,10,24,32,-8,24
Dungannon,4826,8,2,4,16,14,47,-33,10
Crusaders,4827,1,17,6,3,62,30,32,57
Coleraine,4827,2,14,10,2,45,26,19,52
Glenavon,4827,3,10,9,7,56,45,11,39
Linfield,4827,4,10,5,11,38,38,0,35
Cliftonville,4827,5,10,4,12,34,32,2,34
Ballymena,4827,6,7,4,15,25,48,-23,25
Glentoran,4827,7,6,6,10,24,32,-8,24
Dungannon,4827,8,2,4,16,14,47,-33,10
Crusaders,4828,1,16,6,4,62,32,30,54
Coleraine,4828,2,14,11,1,44,23,21,53
Glenavon,4828,3,9,10,7,53,44,9,37
Linfield,4828,4,10,5,11,39,40,-1,35
Cliftonville,4828,5,10,4,12,36,33,3,34
Ballymena,4828,6,8,4,14,27,48,-21,28
Glentoran,4828,7,6,6,10,24,32,-8,24
Dungannon,4828,8,2,4,16,14,47,-33,10
Coleraine,4829,1,15,10,1,48,25,23,55
Crusaders,4829,2,16,6,4,61,31,30,54
Glenavon,4829,3,9,9,8,55,48,7,36
Linfield,4829,4,10,6,10,39,38,1,36
Cliftonville,4829,5,9,5,12,34,33,1,32
Ballymena,4829,6,8,4,14,26,47,-21,28
Glentoran,4829,7,6,6,10,24,32,-8,24
Dungannon,4829,8,2,4,16,14,47,-33,10
Crusaders,4830,1,17,6,3,63,31,32,57
Coleraine,4830,2,15,10,1,48,25,23,55
Linfield,4830,3,11,5,10,41,36,5,38
Glenavon,4830,4,9,9,8,55,48,7,36
Cliftonville,4830,5,9,4,13,32,35,-3,31
Ballymena,4830,6,7,4,15,26,49,-23,25
Glentoran,4830,7,6,6,10,24,32,-8,24
Dungannon,4830,8,2,4,16,14,47,-33,10
Crusaders,4831,1,17,6,3,64,32,32,57
Coleraine,4831,2,14,10,2,43,24,19,52
Glenavon,4831,3,10,9,7,54,43,11,39
Linfield,4831,4,10,6,10,38,37,1,36
Cliftonville,4831,5,9,5,12,33,32,1,32
Ballymena,4831,6,7,4,15,27,50,-23,25
Glentoran,4831,7,6,6,10,24,32,-8,24
Dungannon,4831,8,2,4,16,14,47,-33,10
Crusaders,4832,1,17,6,3,65,30,35,57
Coleraine,4832,2,15,10,1,46,23,23,55
Glenavon,4832,3,9,9,8,53,46,7,36
Linfield,4832,4,10,5,11,38,38,0,35
Cliftonville,4832,5,10,4,12,34,32,2,34
Ballymena,4832,6,7,4,15,25,51,-26,25
Glentoran,4832,7,6,6,10,24,32,-8,24
Dungannon,4832,8,2,4,16,14,47,-33,10
Crusaders,4833,1,17,6,3,65,31,34,57
Coleraine,4833,2,14,10,2,44,24,20,52
Glenavon,4833,3,10,9,7,54,44,10,39
Linfield,4833,4,11,5,10,39,36,3,38
Cliftonville,4833,5,9,4,13,32,33,-1,31
Ballymena,4833,6,7,4,15,26,51,-25,25
Glentoran,4833,7,6,6,10,24,32,-8,24
Dungannon,4833,8,2,4,16,14,47,-33,10
Crusaders,4834,1,17,6,3,64,31,33,57
Coleraine,4834,2,15,10,1,46,23,23,55
Linfield,4834,3,11,5,10,38,36,2,38
Glenavon,4834,4,9,9,8,53,46,7,36
Cliftonville,4834,5,9,4,13,32,32,0,31
Ballymena,4834,6,7,4,15,26,50,-24,25
Glentoran,4834,7,6,6,10,24,32,-8,24
Dungannon,4834,8,2,4,16,14,47,-33,10
Crusaders,4835,1,16,7,3,62,31,31,55
Coleraine,4835,2,15,10,1,49,23,26,55
Glenavon,4835,3,9,9,8,53,49,4,36
Linfield,4835,4,10,6,10,38,37,1,36
Cliftonville,4835,5,9,5,12,33,32,1,32
Ballymena,4835,6,7,5,14,26,48,-22,26
Glentoran,4835,7,6,6,10,24,32,-8,24
Dungannon,4835,8,2,4,16,14,47,-33,10
Crusaders,4836,1,17,6,3,62,30,32,57
Coleraine,4836,2,15,10,1,47,25,22,55
Linfield,4836,3,11,5,10,39,37,2,38
Glenavon,4836,4,9,9,8,55,47,8,36
Cliftonville,4836,5,9,4,13,33,33,0,31
Ballymena,4836,6,7,4,15,25,48,-23,25
Glentoran,4836,7,6,6,10,24,32,-8,24
Dungannon,4836,8,2,4,16,14,47,-33,10
Crusaders,4837,1,16,7,3,62,31,31,55
Coleraine,4837,2,15,10,1,48,24,24,55
Glenavon,4837,3,9,9,8,54,48,6,36
Linfield,4837,4,10,5,11,37,37,0,35
Cliftonville,4837,5,10,4,12,33,31,2,34
Ballymena,4837,6,7,5,14,26,48,-22,26
Glentoran,4837,7,6,6,10,24,32,-8,24
Dungannon,4837,8,2,4,16,14,47,-33,10
Crusaders,4838,1,17,6,3,64,31,33,57
Coleraine,4838,2,14,11,1,44,23,21,53
Glenavon,4838,3,9,10,7,53,44,9,37
Linfield,4838,4,10,6,10,37,36,1,36
Cliftonville,4838,5,9,5,12,32,31,1,32
Ballymena,4838,6,7,4,15,26,50,-24,25
Glentoran,4838,7,6,6,10,24,32,-8,24
Dungannon,4838,8,2,4,16,14,47,-33,10
Crusaders,4839,1,17,6,3,63,31,32,57
Coleraine,4839,2,14,11,1,44,23,21,53
Glenavon,4839,3,9,10,7,53,44,9,37
Linfield,4839,4,10,5,11,37,37,0,35
Cliftonville,4839,5,10,4,12,33,31,2,34
Ballymena,4839,6,7,4,15,26,49,-23,25
Glentoran,4839,7,6,6,10,24,32,-8,24
Dungannon,4839,8,2,4,16,14,47,-33,10
Crusaders,4840,1,17,6,3,66,32,34,57
Coleraine,4840,2,15,10,1,44,22,22,55
Glenavon,4840,3,9,9,8,52,44,8,36
Linfield,4840,4,10,6,10,37,36,1,36
Cliftonville,4840,5,9,5,12,32,31,1,32
Ballymena,4840,6,7,4,15,27,52,-25,25
Glentoran,4840,7,6,6,10,24,32,-8,24
Dungannon,4840,8,2,4,16,14,47,-33,10
Crusaders,4841,1,17,6,3,63,31,32,57
Coleraine,4841,2,15,10,1,45,23,22,55
Glenavon,4841,3,9,9,8,53,45,8,36
Linfield,4841,4,10,5,11,37,37,0,35
Cliftonville,4841,5,10,4,12,33,31,2,34
Ballymena,4841,6,7,4,15,26,49,-23,25
Glentoran,4841,7,6,6,10,24,32,-8,24
Dungannon,4841,8,2,4,16,14,47,-33,10
Crusaders,4842,1,17,6,3,65,33,32,57
Coleraine,4842,2,14,10,2,43,26,17,52
Glenavon,4842,3,10,9,7,56,43,13,39
Linfield,4842,4,10,5,11,39,39,0,35
Cliftonville,4842,5,10,4,12,35,33,2,34
Ballymena,4842,6,7,4,15,28,51,-23,25
Glentoran,4842,7,6,6,10,24,32,-8,24
Dungannon,4842,8,2,4,16,14,47,-33,10
Crusaders,4843,1,17,6,3,65,31,34,57
Coleraine,4843,2,14,10,2,44,25,19,52
Glenavon,4843,3,10,9,7,55,44,11,39
Linfield,4843,4,11,5,10,40,37,3,38
Cliftonville,4843,5,9,4,13,33,34,-1,31
Ballymena,4843,6,7,4,15,26,51,-25,25
Glentoran,4843,7,6,6,10,24,32,-8,24
Dungannon,4843,8,2,4,16,14,47,-33,10
Crusaders,4844,1,17,6,3,65,32,33,57
Coleraine,4844,2,14,10,2,43,23,20,52
Glenavon,4844,3,10,9,7,53,43,10,39
Linfield,4844,4,10,5,11,39,39,0,35
Cliftonville,4844,5,10,4,12,35,33,2,34
Ballymena,4844,6,7,4,15,27,51,-24,25
Glentoran,4844,7,6,6,10,24,32,-8,24
Dungannon,4844,8,2,4,16,14,47,-33,10
Crusaders,4845,1,17,6,3,64,32,32,57
Coleraine,4845,2,14,10,2,44,24,20,52
Glenavon,4845,3,10,9,7,54,44,10,39
Linfield,4845,4,11,5,10,38,36,2,38
Cliftonville,4845,5,9,4,13,32,32,0,31
Ballymena,4845,6,7,4,15,27,50,-23,25
Glentoran,4845,7,6,6,10,24,32,-8,24
Dungannon,4845,8,2,4,16,14,47,-33,10
Crusaders,4846,1,16,7,3,62,31,31,55
Coleraine,4846,2,14,10,2,45,26,19,52
Glenavon,4846,3,10,9,7,56,45,11,39
Linfield,4846,4,10,5,11,37,37,0,35
Cliftonville,4846,5,10,4,12,33,31,2,34
Ballymena,4846,6,7,5,14,26,48,-22,26
Glentoran,4846,7,6,6,10,24,32,-8,24
Dungannon,4846,8,2,4,16,14,47,-33,10
Crusaders,4847,1,17,6,3,62,30,32,57
Coleraine,4847,2,14,11,1,43,22,21,53
Glenavon,4847,3,9,10,7,52,43,9,37
Linfield,4847,4,10,5,11,37,39,-2,35
Cliftonville,4847,5,10,4,12,35,31,4,34
Ballymena,4847,6,7,4,15,25,48,-23,25
Glentoran,4847,7,6,6,10,24,32,-8,24
Dungannon,4847,8,2,4,16,14,47,-33,10
Coleraine,4848,1,15,10,1,46,22,24,55
Crusaders,4848,2,16,6,4,61,32,29,54
Glenavon,4848,3,9,9,8,52,46,6,36
Linfield,4848,4,10,5,11,37,37,0,35
Cliftonville,4848,5,10,4,12,33,31,2,34
Ballymena,4848,6,8,4,14,27,47,-20,28
Glentoran,4848,7,6,6,10,24,32,-8,24
Dungannon,4848,8,2,4,16,14,47,-33,10
Crusaders,4849,1,16,7,3,63,32,31,55
Coleraine,4849,2,15,10,1,45,22,23,55
Glenavon,4849,3,9,9,8,52,45,7,36
Linfield,4849,4,10,6,10,37,36,1,36
Cliftonville,4849,5,9,5,12,32,31,1,32
Ballymena,4849,6,7,5,14,27,49,-22,26
Glentoran,4849,7,6,6,10,24,32,-8,24
Dungannon,4849,8,2,4,16,14,47,-33,10
Crusaders,4850,1,16,7,3,61,30,31,55
Coleraine,4850,2,15,10,1,46,23,23,55
Linfield,4850,3,11,5,10,40,36,4,38
Glenavon,4850,4,9,9,8,53,46,7,36
Cliftonville,4850,5,9,4,13,32,34,-2,31
Ballymena,4850,6,7,5,14,25,47,-22,26
Glentoran,4850,7,6,6,10,24,32,-8,24
Dungannon,4850,8,2,4,16,14,47,-33,10
Crusaders,4851,1,16,7,3,63,32,31,55
Coleraine,4851,2,15,10,1,45,23,22,55
Linfield,4851,3,11,5,10,40,37,3,38
Glenavon,4851,4,9,9,8,53,45,8,36
Cliftonville,4851,5,9,4,13,33,34,-1,31
Ballymena,4851,6,7,5,14,27,49,-22,26
Glentoran,4851,7,6,6,10,24,32,-8,24
Dungannon,4851,8,2,4,16,14,47,-33,10
Crusaders,4852,1,16,7,3,62,31,31,55
Coleraine,4852,2,14,10,2,45,27,18,52
Glenavon,4852,3,10,9,7,57,45,12,39
Linfield,4852,4,11,5,10,39,37,2,38
Cliftonville,4852,5,9,4,13,33,33,0,31
Ballymena,4852,6,7,5,14,26,48,-22,26
Glentoran,4852,7,6,6,10,24,32,-8,24
Dungannon,4852,8,2,4,16,14,47,-33,10
Crusaders,4853,1,16,7,3,62,31,31,55
Coleraine,4853,2,15,10,1,46,22,24,55
Glenavon,4853,3,9,9,8,52,46,6,36
Linfield,4853,4,10,6,10,38,37,1,36
Cliftonville,4853,5,9,5,12,33,32,1,32
Ballymena,4853,6,7,5,14,26,48,-22,26
Glentoran,4853,7,6,6,10,24,32,-8,24
Dungannon,4853,8,2,4,16,14,47,-33,10
Crusaders,4854,1,17,6,3,65,31,34,57
Coleraine,4854,2,14,11,1,46,25,21,53
Linfield,4854,3,11,5,10,39,36,3,38
Glenavon,4854,4,9,10,7,55,46,9,37
Cliftonville,4854,5,9,4,13,32,33,-1,31
Ballymena,4854,6,7,4,15,26,51,-25,25
Glentoran,4854,7,6,6,10,24,32,-8,24
Dungannon,4854,8,2,4,16,14,47,-33,10
Crusaders,4855,1,17,6,3,62,30,32,57
Coleraine,4855,2,14,10,2,44,25,19,52
Glenavon,4855,3,10,9,7,55,44,11,39
Linfield,4855,4,11,5,10,39,37,2,38
Cliftonville,4855,5,9,4,13,33,33,0,31
Ballymena,4855,6,7,4,15,25,48,-23,25
Glentoran,4855,7,6,6,10,24,32,-8,24
Dungannon,4855,8,2,4,16,14,47,-33,10
Crusaders,4856,1,16,7,3,62,31,31,55
Coleraine,4856,2,14,10,2,44,26,18,52
Glenavon,4856,3,10,9,7,56,44,12,39
Linfield,4856,4,11,5,10,39,37,2,38
Cliftonville,4856,5,9,4,13,33,33,0,31
Ballymena,4856,6,7,5,14,26,48,-22,26
Glentoran,4856,7,6,6,10,24,32,-8,24
Dungannon,4856,8,2,4,16,14,47,-33,10
Crusaders,4857,1,17,6,3,62,30,32,57
Coleraine,4857,2,14,10,2,44,26,18,52
Glenavon,4857,3,10,9,7,56,44,12,39
Linfield,4857,4,11,5,10,38,36,2,38
Cliftonville,4857,5,9,4,13,32,32,0,31
Ballymena,4857,6,7,4,15,25,48,-23,25
Glentoran,4857,7,6,6,10,24,32,-8,24
Dungannon,4857,8,2,4,16,14,47,-33,10
Crusaders,4858,1,17,6,3,63,30,33,57
Coleraine,4858,2,14,10,2,44,24,20,52
Glenavon,4858,3,10,9,7,54,44,10,39
Linfield,4858,4,10,6,10,37,36,1,36
Cliftonville,4858,5,9,5,12,32,31,1,32
Ballymena,4858,6,7,4,15,25,49,-24,25
Glentoran,4858,7,6,6,10,24,32,-8,24
Dungannon,4858,8,2,4,16,14,47,-33,10
Coleraine,4859,1,15,10,1,46,23,23,55
Crusaders,4859,2,16,6,4,61,31,30,54
Linfield,4859,3,11,5,10,39,36,3,38
Glenavon,4859,4,9,9,8,53,46,7,36
Cliftonville,4859,5,9,4,13,32,33,-1,31
Ballymena,4859,6,8,4,14,26,47,-21,28
Glentoran,4859,7,6,6,10,24,32,-8,24
Dungannon,4859,8,2,4,16,14,47,-33,10
Crusaders,4860,1,16,6,4,62,35,27,54
Coleraine,4860,2,14,10,2,43,23,20,52
Glenavon,4860,3,10,9,7,53,43,10,39
Linfield,4860,4,10,6,10,37,36,1,36
Cliftonville,4860,5,9,5,12,32,31,1,32
Ballymena,4860,6,8,4,14,30,48,-18,28
Glentoran,4860,7,6,6,10,24,32,-8,24
Dungannon,4860,8,2,4,16,14,47,-33,10
Crusaders,4861,1,17,6,3,63,31,32,57
Coleraine,4861,2,14,11,1,45,24,21,53
Glenavon,4861,3,9,10,7,54,45,9,37
Linfield,4861,4,10,5,11,38,38,0,35
Cliftonville,4861,5,10,4,12,34,32,2,34
Ballymena,4861,6,7,4,15,26,49,-23,25
Glentoran,4861,7,6,6,10,24,32,-8,24
Dungannon,4861,8,2,4,16,14,47,-33,10
Crusaders,4862,1,17,6,3,65,32,33,57
Coleraine,4862,2,14,11,1,43,22,21,53
Glenavon,4862,3,9,10,7,52,43,9,37
Linfield,4862,4,10,6,10,37,36,1,36
Cliftonville,4862,5,9,5,12,32,31,1,32
Ballymena,4862,6,7,4,15,27,51,-24,25
Glentoran,4862,7,6,6,10,24,32,-8,24
Dungannon,4862,8,2,4,16,14,47,-33,10
Crusaders,4863,1,16,7,3,61,30,31,55
Coleraine,4863,2,14,10,2,43,24,19,52
Glenavon,4863,3,10,9,7,54,43,11,39
Linfield,4863,4,10,5,11,38,38,0,35
Cliftonville,4863,5,10,4,12,34,32,2,34
Ballymena,4863,6,7,5,14,25,47,-22,26
Glentoran,4863,7,6,6,10,24,32,-8,24
Dungannon,4863,8,2,4,16,14,47,-33,10
Crusaders,4864,1,16,7,3,62,31,31,55
Coleraine,4864,2,15,10,1,45,23,22,55
Linfield,4864,3,11,5,10,38,36,2,38
Glenavon,4864,4,9,9,8,53,45,8,36
Cliftonville,4864,5,9,4,13,32,32,0,31
Ballymena,4864,6,7,5,14,26,48,-22,26
Glentoran,4864,7,6,6,10,24,32,-8,24
Dungannon,4864,8,2,4,16,14,47,-33,10
Coleraine,4865,1,15,10,1,44,22,22,55
Crusaders,4865,2,16,6,4,61,33,28,54
Linfield,4865,3,11,5,10,39,36,3,38
Glenavon,4865,4,9,9,8,52,44,8,36
Cliftonville,4865,5,9,4,13,32,33,-1,31
Ballymena,4865,6,8,4,14,28,47,-19,28
Glentoran,4865,7,6,6,10,24,32,-8,24
Dungannon,4865,8,2,4,16,14,47,-33,10
Crusaders,4866,1,17,6,3,65,32,33,57
Coleraine,4866,2,14,10,2,43,23,20,52
Glenavon,4866,3,10,9,7,53,43,10,39
Linfield,4866,4,10,5,11,37,38,-1,35
Cliftonville,4866,5,10,4,12,34,31,3,34
Ballymena,4866,6,7,4,15,27,51,-24,25
Glentoran,4866,7,6,6,10,24,32,-8,24
Dungannon,4866,8,2,4,16,14,47,-33,10
Crusaders,4867,1,16,6,4,61,32,29,54
Coleraine,4867,2,14,10,2,44,24,20,52
Glenavon,4867,3,10,9,7,54,44,10,39
Linfield,4867,4,10,5,11,37,39,-2,35
Cliftonville,4867,5,10,4,12,35,31,4,34
Ballymena,4867,6,8,4,14,27,47,-20,28
Glentoran,4867,7,6,6,10,24,32,-8,24
Dungannon,4867,8,2,4,16,14,47,-33,10
Crusaders,4868,1,17,6,3,65,32,33,57
Coleraine,4868,2,14,11,1,44,23,21,53
Glenavon,4868,3,9,10,7,53,44,9,37
Linfield,4868,4,10,5,11,38,39,-1,35
Cliftonville,4868,5,10,4,12,35,32,3,34
Ballymena,4868,6,7,4,15,27,51,-24,25
Glentoran,4868,7,6,6,10,24,32,-8,24
Dungannon,4868,8,2,4,16,14,47,-33,10
Crusaders,4869,1,16,6,4,61,31,30,54
Coleraine,4869,2,14,11,1,44,23,21,53
Glenavon,4869,3,9,10,7,53,44,9,37
Linfield,4869,4,10,5,11,39,39,0,35
Cliftonville,4869,5,10,4,12,35,33,2,34
Ballymena,4869,6,8,4,14,26,47,-21,28
Glentoran,4869,7,6,6,10,24,32,-8,24
Dungannon,4869,8,2,4,16,14,47,-33,10
Crusaders,4870,1,16,7,3,62,31,31,55
Coleraine,4870,2,14,10,2,43,24,19,52
Glenavon,4870,3,10,9,7,54,43,11,39
Linfield,4870,4,11,5,10,40,37,3,38
Cliftonville,4870,5,9,4,13,33,34,-1,31
Ballymena,4870,6,7,5,14,26,48,-22,26
Glentoran,4870,7,6,6,10,24,32,-8,24
Dungannon,4870,8,2,4,16,14,47,-33,10
Crusaders,4871,1,17,6,3,63,30,33,57
Coleraine,4871,2,15,10,1,45,22,23,55
Glenavon,4871,3,9,9,8,52,45,7,36
Linfield,4871,4,10,6,10,38,37,1,36
Cliftonville,4871,5,9,5,12,33,32,1,32
Ballymena,4871,6,7,4,15,25,49,-24,25
Glentoran,4871,7,6,6,10,24,32,-8,24
Dungannon,4871,8,2,4,16,14,47,-33,10
Crusaders,4872,1,17,6,3,65,33,32,57
Coleraine,4872,2,15,10,1,44,22,22,55
Glenavon,4872,3,9,9,8,52,44,8,36
Linfield,4872,4,10,6,10,37,36,1,36
Cliftonville,4872,5,9,5,12,32,31,1,32
Ballymena,4872,6,7,4,15,28,51,-23,25
Glentoran,4872,7,6,6,10,24,32,-8,24
Dungannon,4872,8,2,4,16,14,47,-33,10
Crusaders,4873,1,17,6,3,62,30,32,57
Coleraine,4873,2,15,10,1,46,24,22,55
Glenavon,4873,3,9,9,8,54,46,8,36
Linfield,4873,4,10,5,11,38,38,0,35
Cliftonville,4873,5,10,4,12,34,32,2,34
Ballymena,4873,6,7,4,15,25,48,-23,25
Glentoran,4873,7,6,6,10,24,32,-8,24
Dungannon,4873,8,2,4,16,14,47,-33,10
Coleraine,4874,1,15,10,1,46,22,24,55
Crusaders,4874,2,16,6,4,62,34,28,54
Glenavon,4874,3,9,9,8,52,46,6,36
Linfield,4874,4,10,5,11,37,37,0,35
Cliftonville,4874,5,10,4,12,33,31,2,34
Ballymena,4874,6,8,4,14,29,48,-19,28
Glentoran,4874,7,6,6,10,24,32,-8,24
Dungannon,4874,8,2,4,16,14,47,-33,10
Crusaders,4875,1,17,6,3,64,31,33,57
Coleraine,4875,2,14,10,2,44,24,20,52
Glenavon,4875,3,10,9,7,54,44,10,39
Linfield,4875,4,10,6,10,38,37,1,36
Cliftonville,4875,5,9,5,12,33,32,1,32
Ballymena,4875,6,7,4,15,26,50,-24,25
Glentoran,4875,7,6,6,10,24,32,-8,24
Dungannon,4875,8,2,4,16,14,47,-33,10
Crusaders,4876,1,17,6,3,65,30,35,57
Coleraine,4876,2,14,10,2,44,24,20,52
Glenavon,4876,3,10,9,7,54,44,10,39
Linfield,4876,4,10,5,11,38,39,-1,35
Cliftonville,4876,5,10,4,12,35,32,3,34
Ballymena,4876,6,7,4,15,25,51,-26,25
Glentoran,4876,7,6,6,10,24,32,-8,24
Dungannon,4876,8,2,4,16,14,47,-33,10
Crusaders,4877,1,17,6,3,67,32,35,57
Coleraine,4877,2,14,10,2,44,24,20,52
Glenavon,4877,3,10,9,7,54,44,10,39
Linfield,4877,4,11,5,10,39,36,3,38
Cliftonville,4877,5,9,4,13,32,33,-1,31
Ballymena,4877,6,7,4,15,27,53,-26,25
Glentoran,4877,7,6,6,10,24,32,-8,24
Dungannon,4877,8,2,4,16,14,47,-33,10
Crusaders,4878,1,16,6,4,62,32,30,54
Coleraine,4878,2,14,10,2,45,26,19,52
Glenavon,4878,3,10,9,7,56,45,11,39
Linfield,4878,4,11,5,10,40,38,2,38
Cliftonville,4878,5,9,4,13,34,34,0,31
Ballymena,4878,6,8,4,14,27,48,-21,28
Glentoran,4878,7,6,6,10,24,32,-8,24
Dungannon,4878,8,2,4,16,14,47,-33,10
Crusaders,4879,1,17,6,3,67,32,35,57
Coleraine,4879,2,14,11,1,45,24,21,53
Linfield,4879,3,11,5,10,39,36,3,38
Glenavon,4879,4,9,10,7,54,45,9,37
Cliftonville,4879,5,9,4,13,32,33,-1,31
Ballymena,4879,6,7,4,15,27,53,-26,25
Glentoran,4879,7,6,6,10,24,32,-8,24
Dungannon,4879,8,2,4,16,14,47,-33,10
Crusaders,4880,1,17,6,3,63,30,33,57
Coleraine,4880,2,14,11,1,45,24,21,53
Glenavon,4880,3,9,10,7,54,45,9,37
Linfield,4880,4,10,5,11,38,39,-1,35
Cliftonville,4880,5,10,4,12,35,32,3,34
Ballymena,4880,6,7,4,15,25,49,-24,25
Glentoran,4880,7,6,6,10,24,32,-8,24
Dungannon,4880,8,2,4,16,14,47,-33,10
Crusaders,4881,1,16,7,3,64,33,31,55
Coleraine,4881,2,15,10,1,47,23,24,55
Linfield,4881,3,11,5,10,41,37,4,38
Glenavon,4881,4,9,9,8,53,47,6,36
Cliftonville,4881,5,9,4,13,33,35,-2,31
Ballymena,4881,6,7,5,14,28,50,-22,26
Glentoran,4881,7,6,6,10,24,32,-8,24
Dungannon,4881,8,2,4,16,14,47,-33,10
Crusaders,4882,1,16,6,4,61,31,30,54
Coleraine,4882,2,14,10,2,45,25,20,52
Glenavon,4882,3,10,9,7,55,45,10,39
Linfield,4882,4,10,6,10,38,37,1,36
Cliftonville,4882,5,9,5,12,33,32,1,32
Ballymena,4882,6,8,4,14,26,47,-21,28
Glentoran,4882,7,6,6,10,24,32,-8,24
Dungannon,4882,8,2,4,16,14,47,-33,10
Crusaders,4883,1,17,6,3,63,31,32,57
Coleraine,4883,2,14,10,2,44,24,20,52
Glenavon,4883,3,10,9,7,54,44,10,39
Linfield,4883,4,11,5,10,39,36,3,38
Cliftonville,4883,5,9,4,13,32,33,-1,31
Ballymena,4883,6,7,4,15,26,49,-23,25
Glentoran,4883,7,6,6,10,24,32,-8,24
Dungannon,4883,8,2,4,16,14,47,-33,10
Crusaders,4884,1,17,6,3,62,30,32,57
Coleraine,4884,2,14,10,2,43,23,20,52
Glenavon,4884,3,10,9,7,53,43,10,39
Linfield,4884,4,10,5,11,38,38,0,35
Cliftonville,4884,5,10,4,12,34,32,2,34
Ballymena,4884,6,7,4,15,25,48,-23,25
Glentoran,4884,7,6,6,10,24,32,-8,24
Dungannon,4884,8,2,4,16,14,47,-33,10
Crusaders,4885,1,17,6,3,63,31,32,57
Coleraine,4885,2,14,10,2,44,24,20,52
Glenavon,4885,3,10,9,7,54,44,10,39
Linfield,4885,4,10,6,10,38,37,1,36
Cliftonville,4885,5,9,5,12,33,32,1,32
Ballymena,4885,6,7,4,15,26,49,-23,25
Glentoran,4885,7,6,6,10,24,32,-8,24
Dungannon,4885,8,2,4,16,14,47,-33,10
Crusaders,4886,1,17,6,3,64,30,34,57
Coleraine,4886,2,14,10,2,44,24,20,52
Glenavon,4886,3,10,9,7,54,44,10,39
Linfield,4886,4,10,6,10,37,36,1,36
Cliftonville,4886,5,9,5,12,32,31,1,32
Ballymena,4886,6,7,4,15,25,50,-25,25
Glentoran,4886,7,6,6,10,24,32,-8,24
Dungannon,4886,8,2,4,16,14,47,-33,10
Coleraine,4887,1,15,10,1,47,22,25,55
Crusaders,4887,2,16,6,4,62,32,30,54
Glenavon,4887,3,9,9,8,52,47,5,36
Linfield,4887,4,10,6,10,39,38,1,36
Cliftonville,4887,5,9,5,12,34,33,1,32
Ballymena,4887,6,8,4,14,27,48,-21,28
Glentoran,4887,7,6,6,10,24,32,-8,24
Dungannon,4887,8,2,4,16,14,47,-33,10
Crusaders,4888,1,16,6,4,62,32,30,54
Coleraine,4888,2,14,10,2,43,24,19,52
Glenavon,4888,3,10,9,7,54,43,11,39
Linfield,4888,4,11,5,10,38,36,2,38
Cliftonville,4888,5,9,4,13,32,32,0,31
Ballymena,4888,6,8,4,14,27,48,-21,28
Glentoran,4888,7,6,6,10,24,32,-8,24
Dungannon,4888,8,2,4,16,14,47,-33,10
Crusaders,4889,1,16,6,4,61,31,30,54
Coleraine,4889,2,14,10,2,44,24,20,52
Glenavon,4889,3,10,9,7,54,44,10,39
Linfield,4889,4,11,5,10,39,37,2,38
Cliftonville,4889,5,9,4,13,33,33,0,31
Ballymena,4889,6,8,4,14,26,47,-21,28
Glentoran,4889,7,6,6,10,24,32,-8,24
Dungannon,4889,8,2,4,16,14,47,-33,10
Crusaders,4890,1,17,6,3,62,30,32,57
Coleraine,4890,2,14,10,2,45,25,20,52
Glenavon,4890,3,10,9,7,55,45,10,39
Linfield,4890,4,10,6,10,39,38,1,36
Cliftonville,4890,5,9,5,12,34,33,1,32
Ballymena,4890,6,7,4,15,25,48,-23,25
Glentoran,4890,7,6,6,10,24,32,-8,24
Dungannon,4890,8,2,4,16,14,47,-33,10
Crusaders,4891,1,16,6,4,61,32,29,54
Coleraine,4891,2,14,11,1,44,23,21,53
Glenavon,4891,3,9,10,7,53,44,9,37
Linfield,4891,4,10,6,10,39,38,1,36
Cliftonville,4891,5,9,5,12,34,33,1,32
Ballymena,4891,6,8,4,14,27,47,-20,28
Glentoran,4891,7,6,6,10,24,32,-8,24
Dungannon,4891,8,2,4,16,14,47,-33,10
Crusaders,4892,1,16,7,3,61,30,31,55
Coleraine,4892,2,14,11,1,45,24,21,53
Glenavon,4892,3,9,10,7,54,45,9,37
Linfield,4892,4,10,5,11,38,38,0,35
Cliftonville,4892,5,10,4,12,34,32,2,34
Ballymena,4892,6,7,5,14,25,47,-22,26
Glentoran,4892,7,6,6,10,24,32,-8,24
Dungannon,4892,8,2,4,16,14,47,-33,10
Crusaders,4893,1,17,6,3,64,31,33,57
Coleraine,4893,2,14,10,2,43,24,19,52
Glenavon,4893,3,10,9,7,54,43,11,39
Linfield,4893,4,10,5,11,39,39,0,35
Cliftonville,4893,5,10,4,12,35,33,2,34
Ballymena,4893,6,7,4,15,26,50,-24,25
Glentoran,4893,7,6,6,10,24,32,-8,24
Dungannon,4893,8,2,4,16,14,47,-33,10
Crusaders,4894,1,17,6,3,64,30,34,57
Coleraine,4894,2,15,10,1,44,22,22,55
Glenavon,4894,3,9,9,8,52,44,8,36
Linfield,4894,4,10,5,11,37,38,-1,35
Cliftonville,4894,5,10,4,12,34,31,3,34
Ballymena,4894,6,7,4,15,25,50,-25,25
Glentoran,4894,7,6,6,10,24,32,-8,24
Dungannon,4894,8,2,4,16,14,47,-33,10
Crusaders,4895,1,16,7,3,62,31,31,55
Coleraine,4895,2,14,10,2,44,25,19,52
Glenavon,4895,3,10,9,7,55,44,11,39
Linfield,4895,4,11,5,10,39,37,2,38
Cliftonville,4895,5,9,4,13,33,33,0,31
Ballymena,4895,6,7,5,14,26,48,-22,26
Glentoran,4895,7,6,6,10,24,32,-8,24
Dungannon,4895,8,2,4,16,14,47,-33,10
Crusaders,4896,1,16,7,3,63,32,31,55
Coleraine,4896,2,15,10,1,47,22,25,55
Linfield,4896,3,11,5,10,40,38,2,38
Glenavon,4896,4,9,9,8,52,47,5,36
Cliftonville,4896,5,9,4,13,34,34,0,31
Ballymena,4896,6,7,5,14,27,49,-22,26
Glentoran,4896,7,6,6,10,24,32,-8,24
Dungannon,4896,8,2,4,16,14,47,-33,10
Crusaders,4897,1,17,6,3,63,31,32,57
Coleraine,4897,2,14,10,2,43,23,20,52
Glenavon,4897,3,10,9,7,53,43,10,39
Linfield,4897,4,11,5,10,38,36,2,38
Cliftonville,4897,5,9,4,13,32,32,0,31
Ballymena,4897,6,7,4,15,26,49,-23,25
Glentoran,4897,7,6,6,10,24,32,-8,24
Dungannon,4897,8,2,4,16,14,47,-33,10
Crusaders,4898,1,17,6,3,63,31,32,57
Coleraine,4898,2,14,10,2,44,24,20,52
Glenavon,4898,3,10,9,7,54,44,10,39
Linfield,4898,4,11,5,10,40,36,4,38
Cliftonville,4898,5,9,4,13,32,34,-2,31
Ballymena,4898,6,7,4,15,26,49,-23,25
Glentoran,4898,7,6,6,10,24,32,-8,24
Dungannon,4898,8,2,4,16,14,47,-33,10
Crusaders,4899,1,17,6,3,62,30,32,57
Coleraine,4899,2,15,10,1,44,22,22,55
Linfield,4899,3,11,5,10,39,36,3,38
Glenavon,4899,4,9,9,8,52,44,8,36
Cliftonville,4899,5,9,4,13,32,33,-1,31
Ballymena,4899,6,7,4,15,25,48,-23,25
Glentoran,4899,7,6,6,10,24,32,-8,24
Dungannon,4899,8,2,4,16,14,47,-33,10
Crusaders,4900,1,16,7,3,63,32,31,55
Coleraine,4900,2,14,10,2,44,24,20,52
Glenavon,4900,3,10,9,7,54,44,10,39
Linfield,4900,4,10,5,11,37,37,0,35
Cliftonville,4900,5,10,4,12,33,31,2,34
Ballymena,4900,6,7,5,14,27,49,-22,26
Glentoran,4900,7,6,6,10,24,32,-8,24
Dungannon,4900,8,2,4,16,14,47,-33,10
Crusaders,4901,1,16,7,3,62,31,31,55
Coleraine,4901,2,15,10,1,44,22,22,55
Glenavon,4901,3,9,9,8,52,44,8,36
Linfield,4901,4,10,6,10,38,37,1,36
Cliftonville,4901,5,9,5,12,33,32,1,32
Ballymena,4901,6,7,5,14,26,48,-22,26
Glentoran,4901,7,6,6,10,24,32,-8,24
Dungannon,4901,8,2,4,16,14,47,-33,10
Coleraine,4902,1,15,10,1,46,23,23,55
Crusaders,4902,2,16,6,4,62,32,30,54
Glenavon,4902,3,9,9,8,53,46,7,36
Linfield,4902,4,10,5,11,37,37,0,35
Cliftonville,4902,5,10,4,12,33,31,2,34
Ballymena,4902,6,8,4,14,27,48,-21,28
Glentoran,4902,7,6,6,10,24,32,-8,24
Dungannon,4902,8,2,4,16,14,47,-33,10
Coleraine,4903,1,15,10,1,45,23,22,55
Crusaders,4903,2,16,6,4,61,32,29,54
Linfield,4903,3,11,5,10,38,36,2,38
Glenavon,4903,4,9,9,8,53,45,8,36
Cliftonville,4903,5,9,4,13,32,32,0,31
Ballymena,4903,6,8,4,14,27,47,-20,28
Glentoran,4903,7,6,6,10,24,32,-8,24
Dungannon,4903,8,2,4,16,14,47,-33,10
Crusaders,4904,1,17,6,3,63,31,32,57
Coleraine,4904,2,14,10,2,46,26,20,52
Glenavon,4904,3,10,9,7,56,46,10,39
Linfield,4904,4,11,5,10,39,36,3,38
Cliftonville,4904,5,9,4,13,32,33,-1,31
Ballymena,4904,6,7,4,15,26,49,-23,25
Glentoran,4904,7,6,6,10,24,32,-8,24
Dungannon,4904,8,2,4,16,14,47,-33,10
Crusaders,4905,1,17,6,3,66,32,34,57
Coleraine,4905,2,14,10,2,44,25,19,52
Glenavon,4905,3,10,9,7,55,44,11,39
Linfield,4905,4,10,5,11,38,39,-1,35
Cliftonville,4905,5,10,4,12,35,32,3,34
Ballymena,4905,6,7,4,15,27,52,-25,25
Glentoran,4905,7,6,6,10,24,32,-8,24
Dungannon,4905,8,2,4,16,14,47,-33,10
Crusaders,4906,1,17,6,3,63,30,33,57
Coleraine,4906,2,15,10,1,45,23,22,55
Glenavon,4906,3,9,9,8,53,45,8,36
Linfield,4906,4,10,6,10,38,37,1,36
Cliftonville,4906,5,9,5,12,33,32,1,32
Ballymena,4906,6,7,4,15,25,49,-24,25
Glentoran,4906,7,6,6,10,24,32,-8,24
Dungannon,4906,8,2,4,16,14,47,-33,10
Crusaders,4907,1,17,6,3,63,30,33,57
Coleraine,4907,2,14,10,2,45,25,20,52
Glenavon,4907,3,10,9,7,55,45,10,39
Linfield,4907,4,11,5,10,38,36,2,38
Cliftonville,4907,5,9,4,13,32,32,0,31
Ballymena,4907,6,7,4,15,25,49,-24,25
Glentoran,4907,7,6,6,10,24,32,-8,24
Dungannon,4907,8,2,4,16,14,47,-33,10
Crusaders,4908,1,17,6,3,64,30,34,57
Coleraine,4908,2,15,10,1,44,22,22,55
Glenavon,4908,3,9,9,8,52,44,8,36
Linfield,4908,4,10,6,10,39,38,1,36
Cliftonville,4908,5,9,5,12,34,33,1,32
Ballymena,4908,6,7,4,15,25,50,-25,25
Glentoran,4908,7,6,6,10,24,32,-8,24
Dungannon,4908,8,2,4,16,14,47,-33,10
Crusaders,4909,1,17,6,3,64,31,33,57
Coleraine,4909,2,14,10,2,44,25,19,52
Glenavon,4909,3,10,9,7,55,44,11,39
Linfield,4909,4,10,5,11,37,37,0,35
Cliftonville,4909,5,10,4,12,33,31,2,34
Ballymena,4909,6,7,4,15,26,50,-24,25
Glentoran,4909,7,6,6,10,24,32,-8,24
Dungannon,4909,8,2,4,16,14,47,-33,10
Crusaders,4910,1,17,6,3,63,31,32,57
Coleraine,4910,2,14,10,2,43,25,18,52
Glenavon,4910,3,10,9,7,55,43,12,39
Linfield,4910,4,10,6,10,37,36,1,36
Cliftonville,4910,5,9,5,12,32,31,1,32
Ballymena,4910,6,7,4,15,26,49,-23,25
Glentoran,4910,7,6,6,10,24,32,-8,24
Dungannon,4910,8,2,4,16,14,47,-33,10
Crusaders,4911,1,17,6,3,66,30,36,57
Coleraine,4911,2,15,10,1,46,23,23,55
Glenavon,4911,3,9,9,8,53,46,7,36
Linfield,4911,4,10,6,10,38,37,1,36
Cliftonville,4911,5,9,5,12,33,32,1,32
Ballymena,4911,6,7,4,15,25,52,-27,25
Glentoran,4911,7,6,6,10,24,32,-8,24
Dungannon,4911,8,2,4,16,14,47,-33,10
Crusaders,4912,1,16,7,3,62,31,31,55
Coleraine,4912,2,14,11,1,45,24,21,53
Glenavon,4912,3,9,10,7,54,45,9,37
Linfield,4912,4,10,5,11,37,37,0,35
Cliftonville,4912,5,10,4,12,33,31,2,34
Ballymena,4912,6,7,5,14,26,48,-22,26
Glentoran,4912,7,6,6,10,24,32,-8,24
Dungannon,4912,8,2,4,16,14,47,-33,10
Crusaders,4913,1,17,6,3,62,30,32,57
Coleraine,4913,2,14,10,2,44,25,19,52
Glenavon,4913,3,10,9,7,55,44,11,39
Linfield,4913,4,10,5,11,38,38,0,35
Cliftonville,4913,5,10,4,12,34,32,2,34
Ballymena,4913,6,7,4,15,25,48,-23,25
Glentoran,4913,7,6,6,10,24,32,-8,24
Dungannon,4913,8,2,4,16,14,47,-33,10
Crusaders,4914,1,16,7,3,63,32,31,55
Coleraine,4914,2,15,10,1,47,23,24,55
Linfield,4914,3,11,5,10,39,36,3,38
Glenavon,4914,4,9,9,8,53,47,6,36
Cliftonville,4914,5,9,4,13,32,33,-1,31
Ballymena,4914,6,7,5,14,27,49,-22,26
Glentoran,4914,7,6,6,10,24,32,-8,24
Dungannon,4914,8,2,4,16,14,47,-33,10
Crusaders,4915,1,17,6,3,63,31,32,57
Coleraine,4915,2,14,10,2,45,26,19,52
Glenavon,4915,3,10,9,7,56,45,11,39
Linfield,4915,4,10,6,10,37,36,1,36
Cliftonville,4915,5,9,5,12,32,31,1,32
Ballymena,4915,6,7,4,15,26,49,-23,25
Glentoran,4915,7,6,6,10,24,32,-8,24
Dungannon,4915,8,2,4,16,14,47,-33,10
Crusaders,4916,1,17,6,3,64,31,33,57
Coleraine,4916,2,14,10,2,45,27,18,52
Glenavon,4916,3,10,9,7,57,45,12,39
Linfield,4916,4,10,5,11,38,39,-1,35
Cliftonville,4916,5,10,4,12,35,32,3,34
Ballymena,4916,6,7,4,15,26,50,-24,25
Glentoran,4916,7,6,6,10,24,32,-8,24
Dungannon,4916,8,2,4,16,14,47,-33,10
Crusaders,4917,1,16,6,4,61,32,29,54
Coleraine,4917,2,14,11,1,45,24,21,53
Glenavon,4917,3,9,10,7,54,45,9,37
Linfield,4917,4,10,6,10,37,36,1,36
Cliftonville,4917,5,9,5,12,32,31,1,32
Ballymena,4917,6,8,4,14,27,47,-20,28
Glentoran,4917,7,6,6,10,24,32,-8,24
Dungannon,4917,8,2,4,16,14,47,-33,10
Crusaders,4918,1,17,6,3,64,31,33,57
Coleraine,4918,2,15,10,1,46,23,23,55
Glenavon,4918,3,9,9,8,53,46,7,36
Linfield,4918,4,10,6,10,38,37,1,36
Cliftonville,4918,5,9,5,12,33,32,1,32
Ballymena,4918,6,7,4,15,26,50,-24,25
Glentoran,4918,7,6,6,10,24,32,-8,24
Dungannon,4918,8,2,4,16,14,47,-33,10
Crusaders,4919,1,17,6,3,63,31,32,57
Coleraine,4919,2,14,10,2,43,23,20,52
Glenavon,4919,3,10,9,7,53,43,10,39
Linfield,4919,4,11,5,10,39,36,3,38
Cliftonville,4919,5,9,4,13,32,33,-1,31
Ballymena,4919,6,7,4,15,26,49,-23,25
Glentoran,4919,7,6,6,10,24,32,-8,24
Dungannon,4919,8,2,4,16,14,47,-33,10
Crusaders,4920,1,17,6,3,63,30,33,57
Coleraine,4920,2,14,10,2,43,25,18,52
Glenavon,4920,3,10,9,7,55,43,12,39
Linfield,4920,4,11,5,10,40,37,3,38
Cliftonville,4920,5,9,4,13,33,34,-1,31
Ballymena,4920,6,7,4,15,25,49,-24,25
Glentoran,4920,7,6,6,10,24,32,-8,24
Dungannon,4920,8,2,4,16,14,47,-33,10
Crusaders,4921,1,17,6,3,64,30,34,57
Coleraine,4921,2,15,10,1,46,23,23,55
Linfield,4921,3,11,5,10,41,36,5,38
Glenavon,4921,4,9,9,8,53,46,7,36
Cliftonville,4921,5,9,4,13,32,35,-3,31
Ballymena,4921,6,7,4,15,25,50,-25,25
Glentoran,4921,7,6,6,10,24,32,-8,24
Dungannon,4921,8,2,4,16,14,47,-33,10
Crusaders,4922,1,17,6,3,64,30,34,57
Coleraine,4922,2,15,10,1,46,23,23,55
Linfield,4922,3,11,5,10,39,36,3,38
Glenavon,4922,4,9,9,8,53,46,7,36
Cliftonville,4922,5,9,4,13,32,33,-1,31
Ballymena,4922,6,7,4,15,25,50,-25,25
Glentoran,4922,7,6,6,10,24,32,-8,24
Dungannon,4922,8,2,4,16,14,47,-33,10
Crusaders,4923,1,17,6,3,66,30,36,57
Coleraine,4923,2,14,11,1,44,23,21,53
Glenavon,4923,3,9,10,7,53,44,9,37
Linfield,4923,4,10,5,11,38,38,0,35
Cliftonville,4923,5,10,4,12,34,32,2,34
Ballymena,4923,6,7,4,15,25,52,-27,25
Glentoran,4923,7,6,6,10,24,32,-8,24
Dungannon,4923,8,2,4,16,14,47,-33,10
Crusaders,4924,1,17,6,3,66,33,33,57
Coleraine,4924,2,15,10,1,47,24,23,55
Linfield,4924,3,11,5,10,40,36,4,38
Glenavon,4924,4,9,9,8,54,47,7,36
Cliftonville,4924,5,9,4,13,32,34,-2,31
Ballymena,4924,6,7,4,15,28,52,-24,25
Glentoran,4924,7,6,6,10,24,32,-8,24
Dungannon,4924,8,2,4,16,14,47,-33,10
Coleraine,4925,1,15,10,1,46,24,22,55
Crusaders,4925,2,16,6,4,62,32,30,54
Glenavon,4925,3,9,9,8,54,46,8,36
Linfield,4925,4,10,5,11,38,38,0,35
Cliftonville,4925,5,10,4,12,34,32,2,34
Ballymena,4925,6,8,4,14,27,48,-21,28
Glentoran,4925,7,6,6,10,24,32,-8,24
Dungannon,4925,8,2,4,16,14,47,-33,10
Crusaders,4926,1,17,6,3,64,32,32,57
Coleraine,4926,2,14,10,2,43,24,19,52
Glenavon,4926,3,10,9,7,54,43,11,39
Linfield,4926,4,10,5,11,37,37,0,35
Cliftonville,4926,5,10,4,12,33,31,2,34
Ballymena,4926,6,7,4,15,27,50,-23,25
Glentoran,4926,7,6,6,10,24,32,-8,24
Dungannon,4926,8,2,4,16,14,47,-33,10
Crusaders,4927,1,17,6,3,66,31,35,57
Coleraine,4927,2,14,11,1,44,23,21,53
Linfield,4927,3,11,5,10,39,37,2,38
Glenavon,4927,4,9,10,7,53,44,9,37
Cliftonville,4927,5,9,4,13,33,33,0,31
Ballymena,4927,6,7,4,15,26,52,-26,25
Glentoran,4927,7,6,6,10,24,32,-8,24
Dungannon,4927,8,2,4,16,14,47,-33,10
Crusaders,4928,1,16,7,3,62,31,31,55
Coleraine,4928,2,14,10,2,44,24,20,52
Glenavon,4928,3,10,9,7,54,44,10,39
Linfield,4928,4,10,6,10,38,37,1,36
Cliftonville,4928,5,9,5,12,33,32,1,32
Ballymena,4928,6,7,5,14,26,48,-22,26
Glentoran,4928,7,6,6,10,24,32,-8,24
Dungannon,4928,8,2,4,16,14,47,-33,10
Crusaders,4929,1,17,6,3,63,31,32,57
Coleraine,4929,2,15,10,1,46,24,22,55
Glenavon,4929,3,9,9,8,54,46,8,36
Linfield,4929,4,10,6,10,38,37,1,36
Cliftonville,4929,5,9,5,12,33,32,1,32
Ballymena,4929,6,7,4,15,26,49,-23,25
Glentoran,4929,7,6,6,10,24,32,-8,24
Dungannon,4929,8,2,4,16,14,47,-33,10
Crusaders,4930,1,16,7,3,61,30,31,55
Coleraine,4930,2,14,10,2,43,24,19,52
Glenavon,4930,3,10,9,7,54,43,11,39
Linfield,4930,4,10,6,10,38,37,1,36
Cliftonville,4930,5,9,5,12,33,32,1,32
Ballymena,4930,6,7,5,14,25,47,-22,26
Glentoran,4930,7,6,6,10,24,32,-8,24
Dungannon,4930,8,2,4,16,14,47,-33,10
Crusaders,4931,1,16,6,4,61,34,27,54
Coleraine,4931,2,14,10,2,44,24,20,52
Glenavon,4931,3,10,9,7,54,44,10,39
Linfield,4931,4,11,5,10,38,36,2,38
Cliftonville,4931,5,9,4,13,32,32,0,31
Ballymena,4931,6,8,4,14,29,47,-18,28
Glentoran,4931,7,6,6,10,24,32,-8,24
Dungannon,4931,8,2,4,16,14,47,-33,10
Crusaders,4932,1,17,6,3,64,30,34,57
Coleraine,4932,2,14,10,2,44,24,20,52
Glenavon,4932,3,10,9,7,54,44,10,39
Linfield,4932,4,11,5,10,40,38,2,38
Cliftonville,4932,5,9,4,13,34,34,0,31
Ballymena,4932,6,7,4,15,25,50,-25,25
Glentoran,4932,7,6,6,10,24,32,-8,24
Dungannon,4932,8,2,4,16,14,47,-33,10
Crusaders,4933,1,17,6,3,64,31,33,57
Coleraine,4933,2,15,10,1,45,22,23,55
Glenavon,4933,3,9,9,8,52,45,7,36
Linfield,4933,4,10,5,11,37,38,-1,35
Cliftonville,4933,5,10,4,12,34,31,3,34
Ballymena,4933,6,7,4,15,26,50,-24,25
Glentoran,4933,7,6,6,10,24,32,-8,24
Dungannon,4933,8,2,4,16,14,47,-33,10
Crusaders,4934,1,17,6,3,63,30,33,57
Coleraine,4934,2,15,10,1,47,25,22,55
Glenavon,4934,3,9,9,8,55,47,8,36
Linfield,4934,4,10,6,10,38,37,1,36
Cliftonville,4934,5,9,5,12,33,32,1,32
Ballymena,4934,6,7,4,15,25,49,-24,25
Glentoran,4934,7,6,6,10,24,32,-8,24
Dungannon,4934,8,2,4,16,14,47,-33,10
Crusaders,4935,1,16,7,3,63,32,31,55
Coleraine,4935,2,14,11,1,44,23,21,53
Linfield,4935,3,11,5,10,38,36,2,38
Glenavon,4935,4,9,10,7,53,44,9,37
Cliftonville,4935,5,9,4,13,32,32,0,31
Ballymena,4935,6,7,5,14,27,49,-22,26
Glentoran,4935,7,6,6,10,24,32,-8,24
Dungannon,4935,8,2,4,16,14,47,-33,10
Crusaders,4936,1,16,6,4,62,32,30,54
Coleraine,4936,2,14,10,2,44,25,19,52
Glenavon,4936,3,10,9,7,55,44,11,39
Linfield,4936,4,11,5,10,41,38,3,38
Cliftonville,4936,5,9,4,13,34,35,-1,31
Ballymena,4936,6,8,4,14,27,48,-21,28
Glentoran,4936,7,6,6,10,24,32,-8,24
Dungannon,4936,8,2,4,16,14,47,-33,10
Crusaders,4937,1,16,7,3,62,31,31,55
Coleraine,4937,2,14,10,2,45,25,20,52
Glenavon,4937,3,10,9,7,55,45,10,39
Linfield,4937,4,10,6,10,38,37,1,36
Cliftonville,4937,5,9,5,12,33,32,1,32
Ballymena,4937,6,7,5,14,26,48,-22,26
Glentoran,4937,7,6,6,10,24,32,-8,24
Dungannon,4937,8,2,4,16,14,47,-33,10
Crusaders,4938,1,16,7,3,64,33,31,55
Coleraine,4938,2,14,11,1,44,23,21,53
Linfield,4938,3,11,5,10,40,38,2,38
Glenavon,4938,4,9,10,7,53,44,9,37
Cliftonville,4938,5,9,4,13,34,34,0,31
Ballymena,4938,6,7,5,14,28,50,-22,26
Glentoran,4938,7,6,6,10,24,32,-8,24
Dungannon,4938,8,2,4,16,14,47,-33,10
Crusaders,4939,1,16,6,4,62,33,29,54
Coleraine,4939,2,14,10,2,43,25,18,52
Glenavon,4939,3,10,9,7,55,43,12,39
Linfield,4939,4,11,5,10,41,36,5,38
Cliftonville,4939,5,9,4,13,32,35,-3,31
Ballymena,4939,6,8,4,14,28,48,-20,28
Glentoran,4939,7,6,6,10,24,32,-8,24
Dungannon,4939,8,2,4,16,14,47,-33,10
Crusaders,4940,1,17,6,3,65,31,34,57
Coleraine,4940,2,15,10,1,45,23,22,55
Glenavon,4940,3,9,9,8,53,45,8,36
Linfield,4940,4,10,6,10,37,36,1,36
Cliftonville,4940,5,9,5,12,32,31,1,32
Ballymena,4940,6,7,4,15,26,51,-25,25
Glentoran,4940,7,6,6,10,24,32,-8,24
Dungannon,4940,8,2,4,16,14,47,-33,10
Crusaders,4941,1,17,6,3,63,30,33,57
Coleraine,4941,2,14,10,2,43,24,19,52
Glenavon,4941,3,10,9,7,54,43,11,39
Linfield,4941,4,10,5,11,37,37,0,35
Cliftonville,4941,5,10,4,12,33,31,2,34
Ballymena,4941,6,7,4,15,25,49,-24,25
Glentoran,4941,7,6,6,10,24,32,-8,24
Dungannon,4941,8,2,4,16,14,47,-33,10
Crusaders,4942,1,17,6,3,62,30,32,57
Coleraine,4942,2,14,11,1,47,26,21,53
Glenavon,4942,3,9,10,7,56,47,9,37
Linfield,4942,4,10,5,11,39,40,-1,35
Cliftonville,4942,5,10,4,12,36,33,3,34
Ballymena,4942,6,7,4,15,25,48,-23,25
Glentoran,4942,7,6,6,10,24,32,-8,24
Dungannon,4942,8,2,4,16,14,47,-33,10
Crusaders,4943,1,16,7,3,61,30,31,55
Coleraine,4943,2,15,10,1,44,22,22,55
Glenavon,4943,3,9,9,8,52,44,8,36
Linfield,4943,4,10,5,11,38,39,-1,35
Cliftonville,4943,5,10,4,12,35,32,3,34
Ballymena,4943,6,7,5,14,25,47,-22,26
Glentoran,4943,7,6,6,10,24,32,-8,24
Dungannon,4943,8,2,4,16,14,47,-33,10
Crusaders,4944,1,16,6,4,62,33,29,54
Coleraine,4944,2,14,10,2,45,26,19,52
Glenavon,4944,3,10,9,7,56,45,11,39
Linfield,4944,4,11,5,10,40,37,3,38
Cliftonville,4944,5,9,4,13,33,34,-1,31
Ballymena,4944,6,8,4,14,28,48,-20,28
Glentoran,4944,7,6,6,10,24,32,-8,24
Dungannon,4944,8,2,4,16,14,47,-33,10
Crusaders,4945,1,16,6,4,61,31,30,54
Coleraine,4945,2,14,10,2,43,23,20,52
Glenavon,4945,3,10,9,7,53,43,10,39
Linfield,4945,4,10,6,10,38,37,1,36
Cliftonville,4945,5,9,5,12,33,32,1,32
Ballymena,4945,6,8,4,14,26,47,-21,28
Glentoran,4945,7,6,6,10,24,32,-8,24
Dungannon,4945,8,2,4,16,14,47,-33,10
Crusaders,4946,1,17,6,3,64,31,33,57
Coleraine,4946,2,14,10,2,43,24,19,52
Glenavon,4946,3,10,9,7,54,43,11,39
Linfield,4946,4,10,6,10,38,37,1,36
Cliftonville,4946,5,9,5,12,33,32,1,32
Ballymena,4946,6,7,4,15,26,50,-24,25
Glentoran,4946,7,6,6,10,24,32,-8,24
Dungannon,4946,8,2,4,16,14,47,-33,10
Crusaders,4947,1,16,7,3,62,31,31,55
Coleraine,4947,2,14,10,2,43,25,18,52
Glenavon,4947,3,10,9,7,55,43,12,39
Linfield,4947,4,11,5,10,39,36,3,38
Cliftonville,4947,5,9,4,13,32,33,-1,31
Ballymena,4947,6,7,5,14,26,48,-22,26
Glentoran,4947,7,6,6,10,24,32,-8,24
Dungannon,4947,8,2,4,16,14,47,-33,10
Crusaders,4948,1,17,6,3,63,31,32,57
Coleraine,4948,2,14,10,2,43,26,17,52
Glenavon,4948,3,10,9,7,56,43,13,39
Linfield,4948,4,10,5,11,37,40,-3,35
Cliftonville,4948,5,10,4,12,36,31,5,34
Ballymena,4948,6,7,4,15,26,49,-23,25
Glentoran,4948,7,6,6,10,24,32,-8,24
Dungannon,4948,8,2,4,16,14,47,-33,10
Crusaders,4949,1,16,7,3,62,31,31,55
Coleraine,4949,2,15,10,1,45,22,23,55
Linfield,4949,3,11,5,10,39,36,3,38
Glenavon,4949,4,9,9,8,52,45,7,36
Cliftonville,4949,5,9,4,13,32,33,-1,31
Ballymena,4949,6,7,5,14,26,48,-22,26
Glentoran,4949,7,6,6,10,24,32,-8,24
Dungannon,4949,8,2,4,16,14,47,-33,10
Crusaders,4950,1,16,7,3,62,31,31,55
Coleraine,4950,2,14,10,2,45,25,20,52
Glenavon,4950,3,10,9,7,55,45,10,39
Linfield,4950,4,10,6,10,38,37,1,36
Cliftonville,4950,5,9,5,12,33,32,1,32
Ballymena,4950,6,7,5,14,26,48,-22,26
Glentoran,4950,7,6,6,10,24,32,-8,24
Dungannon,4950,8,2,4,16,14,47,-33,10
Crusaders,4951,1,16,7,3,63,32,31,55
Coleraine,4951,2,14,11,1,43,22,21,53
Glenavon,4951,3,9,10,7,52,43,9,37
Linfield,4951,4,10,5,11,38,38,0,35
Cliftonville,4951,5,10,4,12,34,32,2,34
Ballymena,4951,6,7,5,14,27,49,-22,26
Glentoran,4951,7,6,6,10,24,32,-8,24
Dungannon,4951,8,2,4,16,14,47,-33,10
Crusaders,4952,1,16,7,3,62,31,31,55
Coleraine,4952,2,14,11,1,43,22,21,53
Linfield,4952,3,11,5,10,39,36,3,38
Glenavon,4952,4,9,10,7,52,43,9,37
Cliftonville,4952,5,9,4,13,32,33,-1,31
Ballymena,4952,6,7,5,14,26,48,-22,26
Glentoran,4952,7,6,6,10,24,32,-8,24
Dungannon,4952,8,2,4,16,14,47,-33,10
Crusaders,4953,1,16,6,4,61,32,29,54
Coleraine,4953,2,14,11,1,46,25,21,53
Glenavon,4953,3,9,10,7,55,46,9,37
Linfield,4953,4,10,5,11,38,39,-1,35
Cliftonville,4953,5,10,4,12,35,32,3,34
Ballymena,4953,6,8,4,14,27,47,-20,28
Glentoran,4953,7,6,6,10,24,32,-8,24
Dungannon,4953,8,2,4,16,14,47,-33,10
Crusaders,4954,1,16,7,3,62,31,31,55
Coleraine,4954,2,14,10,2,43,24,19,52
Glenavon,4954,3,10,9,7,54,43,11,39
Linfield,4954,4,10,5,11,37,37,0,35
Cliftonville,4954,5,10,4,12,33,31,2,34
Ballymena,4954,6,7,5,14,26,48,-22,26
Glentoran,4954,7,6,6,10,24,32,-8,24
Dungannon,4954,8,2,4,16,14,47,-33,10
Crusaders,4955,1,17,6,3,64,30,34,57
Coleraine,4955,2,14,10,2,43,23,20,52
Glenavon,4955,3,10,9,7,53,43,10,39
Linfield,4955,4,10,6,10,40,39,1,36
Cliftonville,4955,5,9,5,12,35,34,1,32
Ballymena,4955,6,7,4,15,25,50,-25,25
Glentoran,4955,7,6,6,10,24,32,-8,24
Dungannon,4955,8,2,4,16,14,47,-33,10
Crusaders,4956,1,17,6,3,65,32,33,57
Coleraine,4956,2,14,10,2,43,23,20,52
Glenavon,4956,3,10,9,7,53,43,10,39
Linfield,4956,4,11,5,10,41,38,3,38
Cliftonville,4956,5,9,4,13,34,35,-1,31
Ballymena,4956,6,7,4,15,27,51,-24,25
Glentoran,4956,7,6,6,10,24,32,-8,24
Dungannon,4956,8,2,4,16,14,47,-33,10
Crusaders,4957,1,16,7,3,62,31,31,55
Coleraine,4957,2,15,10,1,45,22,23,55
Glenavon,4957,3,9,9,8,52,45,7,36
Linfield,4957,4,10,5,11,37,37,0,35
Cliftonville,4957,5,10,4,12,33,31,2,34
Ballymena,4957,6,7,5,14,26,48,-22,26
Glentoran,4957,7,6,6,10,24,32,-8,24
Dungannon,4957,8,2,4,16,14,47,-33,10
Crusaders,4958,1,17,6,3,63,31,32,57
Coleraine,4958,2,14,10,2,44,24,20,52
Glenavon,4958,3,10,9,7,54,44,10,39
Linfield,4958,4,11,5,10,39,37,2,38
Cliftonville,4958,5,9,4,13,33,33,0,31
Ballymena,4958,6,7,4,15,26,49,-23,25
Glentoran,4958,7,6,6,10,24,32,-8,24
Dungannon,4958,8,2,4,16,14,47,-33,10
Crusaders,4959,1,16,6,4,61,31,30,54
Coleraine,4959,2,14,10,2,44,24,20,52
Glenavon,4959,3,10,9,7,54,44,10,39
Linfield,4959,4,11,5,10,39,36,3,38
Cliftonville,4959,5,9,4,13,32,33,-1,31
Ballymena,4959,6,8,4,14,26,47,-21,28
Glentoran,4959,7,6,6,10,24,32,-8,24
Dungannon,4959,8,2,4,16,14,47,-33,10
Crusaders,4960,1,16,6,4,63,33,30,54
Coleraine,4960,2,14,11,1,44,23,21,53
Linfield,4960,3,11,5,10,39,37,2,38
Glenavon,4960,4,9,10,7,53,44,9,37
Cliftonville,4960,5,9,4,13,33,33,0,31
Ballymena,4960,6,8,4,14,28,49,-21,28
Glentoran,4960,7,6,6,10,24,32,-8,24
Dungannon,4960,8,2,4,16,14,47,-33,10
Crusaders,4961,1,17,6,3,66,31,35,57
Coleraine,4961,2,14,11,1,45,24,21,53
Glenavon,4961,3,9,10,7,54,45,9,37
Linfield,4961,4,10,6,10,40,39,1,36
Cliftonville,4961,5,9,5,12,35,34,1,32
Ballymena,4961,6,7,4,15,26,52,-26,25
Glentoran,4961,7,6,6,10,24,32,-8,24
Dungannon,4961,8,2,4,16,14,47,-33,10
Coleraine,4962,1,15,10,1,45,23,22,55
Crusaders,4962,2,16,6,4,62,32,30,54
Glenavon,4962,3,9,9,8,53,45,8,36
Linfield,4962,4,10,5,11,37,37,0,35
Cliftonville,4962,5,10,4,12,33,31,2,34
Ballymena,4962,6,8,4,14,27,48,-21,28
Glentoran,4962,7,6,6,10,24,32,-8,24
Dungannon,4962,8,2,4,16,14,47,-33,10
Crusaders,4963,1,17,6,3,66,32,34,57
Coleraine,4963,2,15,10,1,46,24,22,55
Linfield,4963,3,11,5,10,38,36,2,38
Glenavon,4963,4,9,9,8,54,46,8,36
Cliftonville,4963,5,9,4,13,32,32,0,31
Ballymena,4963,6,7,4,15,27,52,-25,25
Glentoran,4963,7,6,6,10,24,32,-8,24
Dungannon,4963,8,2,4,16,14,47,-33,10
Crusaders,4964,1,16,7,3,62,31,31,55
Coleraine,4964,2,14,11,1,46,25,21,53
Glenavon,4964,3,9,10,7,55,46,9,37
Linfield,4964,4,10,5,11,38,38,0,35
Cliftonville,4964,5,10,4,12,34,32,2,34
Ballymena,4964,6,7,5,14,26,48,-22,26
Glentoran,4964,7,6,6,10,24,32,-8,24
Dungannon,4964,8,2,4,16,14,47,-33,10
Crusaders,4965,1,17,6,3,62,30,32,57
Coleraine,4965,2,14,11,1,44,23,21,53
Linfield,4965,3,11,5,10,39,37,2,38
Glenavon,4965,4,9,10,7,53,44,9,37
Cliftonville,4965,5,9,4,13,33,33,0,31
Ballymena,4965,6,7,4,15,25,48,-23,25
Glentoran,4965,7,6,6,10,24,32,-8,24
Dungannon,4965,8,2,4,16,14,47,-33,10
Crusaders,4966,1,17,6,3,64,30,34,57
Coleraine,4966,2,14,10,2,43,23,20,52
Glenavon,4966,3,10,9,7,53,43,10,39
Linfield,4966,4,11,5,10,38,36,2,38
Cliftonville,4966,5,9,4,13,32,32,0,31
Ballymena,4966,6,7,4,15,25,50,-25,25
Glentoran,4966,7,6,6,10,24,32,-8,24
Dungannon,4966,8,2,4,16,14,47,-33,10
Crusaders,4967,1,17,6,3,62,30,32,57
Coleraine,4967,2,14,10,2,44,25,19,52
Glenavon,4967,3,10,9,7,55,44,11,39
Linfield,4967,4,10,6,10,38,37,1,36
Cliftonville,4967,5,9,5,12,33,32,1,32
Ballymena,4967,6,7,4,15,25,48,-23,25
Glentoran,4967,7,6,6,10,24,32,-8,24
Dungannon,4967,8,2,4,16,14,47,-33,10
Crusaders,4968,1,17,6,3,63,30,33,57
Coleraine,4968,2,14,11,1,43,22,21,53
Glenavon,4968,3,9,10,7,52,43,9,37
Linfield,4968,4,10,6,10,38,37,1,36
Cliftonville,4968,5,9,5,12,33,32,1,32
Ballymena,4968,6,7,4,15,25,49,-24,25
Glentoran,4968,7,6,6,10,24,32,-8,24
Dungannon,4968,8,2,4,16,14,47,-33,10
Crusaders,4969,1,17,6,3,66,32,34,57
Coleraine,4969,2,15,10,1,44,22,22,55
Linfield,4969,3,11,5,10,39,37,2,38
Glenavon,4969,4,9,9,8,52,44,8,36
Cliftonville,4969,5,9,4,13,33,33,0,31
Ballymena,4969,6,7,4,15,27,52,-25,25
Glentoran,4969,7,6,6,10,24,32,-8,24
Dungannon,4969,8,2,4,16,14,47,-33,10
Coleraine,4970,1,15,10,1,46,23,23,55
Crusaders,4970,2,16,6,4,63,33,30,54
Linfield,4970,3,11,5,10,40,37,3,38
Glenavon,4970,4,9,9,8,53,46,7,36
Cliftonville,4970,5,9,4,13,33,34,-1,31
Ballymena,4970,6,8,4,14,28,49,-21,28
Glentoran,4970,7,6,6,10,24,32,-8,24
Dungannon,4970,8,2,4,16,14,47,-33,10
Crusaders,4971,1,17,6,3,63,31,32,57
Coleraine,4971,2,14,11,1,44,23,21,53
Linfield,4971,3,11,5,10,39,36,3,38
Glenavon,4971,4,9,10,7,53,44,9,37
Cliftonville,4971,5,9,4,13,32,33,-1,31
Ballymena,4971,6,7,4,15,26,49,-23,25
Glentoran,4971,7,6,6,10,24,32,-8,24
Dungannon,4971,8,2,4,16,14,47,-33,10
Crusaders,4972,1,17,6,3,63,30,33,57
Coleraine,4972,2,15,10,1,48,26,22,55
Glenavon,4972,3,9,9,8,56,48,8,36
Linfield,4972,4,10,6,10,37,36,1,36
Cliftonville,4972,5,9,5,12,32,31,1,32
Ballymena,4972,6,7,4,15,25,49,-24,25
Glentoran,4972,7,6,6,10,24,32,-8,24
Dungannon,4972,8,2,4,16,14,47,-33,10
Crusaders,4973,1,16,7,3,62,31,31,55
Coleraine,4973,2,14,10,2,43,24,19,52
Glenavon,4973,3,10,9,7,54,43,11,39
Linfield,4973,4,11,5,10,39,36,3,38
Cliftonville,4973,5,9,4,13,32,33,-1,31
Ballymena,4973,6,7,5,14,26,48,-22,26
Glentoran,4973,7,6,6,10,24,32,-8,24
Dungannon,4973,8,2,4,16,14,47,-33,10
Crusaders,4974,1,16,7,3,63,32,31,55
Coleraine,4974,2,14,10,2,45,27,18,52
Glenavon,4974,3,10,9,7,57,45,12,39
Linfield,4974,4,11,5,10,39,37,2,38
Cliftonville,4974,5,9,4,13,33,33,0,31
Ballymena,4974,6,7,5,14,27,49,-22,26
Glentoran,4974,7,6,6,10,24,32,-8,24
Dungannon,4974,8,2,4,16,14,47,-33,10
Crusaders,4975,1,16,7,3,61,30,31,55
Coleraine,4975,2,14,10,2,43,23,20,52
Glenavon,4975,3,10,9,7,53,43,10,39
Linfield,4975,4,10,5,11,38,39,-1,35
Cliftonville,4975,5,10,4,12,35,32,3,34
Ballymena,4975,6,7,5,14,25,47,-22,26
Glentoran,4975,7,6,6,10,24,32,-8,24
Dungannon,4975,8,2,4,16,14,47,-33,10
Crusaders,4976,1,17,6,3,63,30,33,57
Coleraine,4976,2,14,10,2,43,24,19,52
Glenavon,4976,3,10,9,7,54,43,11,39
Linfield,4976,4,10,5,11,37,39,-2,35
Cliftonville,4976,5,10,4,12,35,31,4,34
Ballymena,4976,6,7,4,15,25,49,-24,25
Glentoran,4976,7,6,6,10,24,32,-8,24
Dungannon,4976,8,2,4,16,14,47,-33,10
Crusaders,4977,1,16,6,4,62,33,29,54
Coleraine,4977,2,14,10,2,46,26,20,52
Glenavon,4977,3,10,9,7,56,46,10,39
Linfield,4977,4,10,6,10,38,37,1,36
Cliftonville,4977,5,9,5,12,33,32,1,32
Ballymena,4977,6,8,4,14,28,48,-20,28
Glentoran,4977,7,6,6,10,24,32,-8,24
Dungannon,4977,8,2,4,16,14,47,-33,10
Crusaders,4978,1,17,6,3,67,32,35,57
Coleraine,4978,2,14,10,2,44,24,20,52
Glenavon,4978,3,10,9,7,54,44,10,39
Linfield,4978,4,11,5,10,39,36,3,38
Cliftonville,4978,5,9,4,13,32,33,-1,31
Ballymena,4978,6,7,4,15,27,53,-26,25
Glentoran,4978,7,6,6,10,24,32,-8,24
Dungannon,4978,8,2,4,16,14,47,-33,10
Crusaders,4979,1,16,7,3,63,32,31,55
Coleraine,4979,2,15,10,1,46,23,23,55
Glenavon,4979,3,9,9,8,53,46,7,36
Linfield,4979,4,10,6,10,37,36,1,36
Cliftonville,4979,5,9,5,12,32,31,1,32
Ballymena,4979,6,7,5,14,27,49,-22,26
Glentoran,4979,7,6,6,10,24,32,-8,24
Dungannon,4979,8,2,4,16,14,47,-33,10
Crusaders,4980,1,17,6,3,64,32,32,57
Coleraine,4980,2,14,11,1,44,23,21,53
Linfield,4980,3,11,5,10,39,37,2,38
Glenavon,4980,4,9,10,7,53,44,9,37
Cliftonville,4980,5,9,4,13,33,33,0,31
Ballymena,4980,6,7,4,15,27,50,-23,25
Glentoran,4980,7,6,6,10,24,32,-8,24
Dungannon,4980,8,2,4,16,14,47,-33,10
Crusaders,4981,1,17,6,3,63,30,33,57
Coleraine,4981,2,14,11,1,46,25,21,53
Glenavon,4981,3,9,10,7,55,46,9,37
Linfield,4981,4,10,6,10,39,38,1,36
Cliftonville,4981,5,9,5,12,34,33,1,32
Ballymena,4981,6,7,4,15,25,49,-24,25
Glentoran,4981,7,6,6,10,24,32,-8,24
Dungannon,4981,8,2,4,16,14,47,-33,10
Crusaders,4982,1,16,7,3,62,31,31,55
Coleraine,4982,2,15,10,1,44,22,22,55
Linfield,4982,3,11,5,10,39,36,3,38
Glenavon,4982,4,9,9,8,52,44,8,36
Cliftonville,4982,5,9,4,13,32,33,-1,31
Ballymena,4982,6,7,5,14,26,48,-22,26
Glentoran,4982,7,6,6,10,24,32,-8,24
Dungannon,4982,8,2,4,16,14,47,-33,10
Crusaders,4983,1,16,7,3,61,30,31,55
Coleraine,4983,2,14,10,2,43,25,18,52
Glenavon,4983,3,10,9,7,55,43,12,39
Linfield,4983,4,10,6,10,39,38,1,36
Cliftonville,4983,5,9,5,12,34,33,1,32
Ballymena,4983,6,7,5,14,25,47,-22,26
Glentoran,4983,7,6,6,10,24,32,-8,24
Dungannon,4983,8,2,4,16,14,47,-33,10
Crusaders,4984,1,17,6,3,63,31,32,57
Coleraine,4984,2,15,10,1,45,23,22,55
Linfield,4984,3,11,5,10,39,37,2,38
Glenavon,4984,4,9,9,8,53,45,8,36
Cliftonville,4984,5,9,4,13,33,33,0,31
Ballymena,4984,6,7,4,15,26,49,-23,25
Glentoran,4984,7,6,6,10,24,32,-8,24
Dungannon,4984,8,2,4,16,14,47,-33,10
Crusaders,4985,1,16,6,4,61,33,28,54
Coleraine,4985,2,14,11,1,44,23,21,53
Glenavon,4985,3,9,10,7,53,44,9,37
Linfield,4985,4,10,6,10,38,37,1,36
Cliftonville,4985,5,9,5,12,33,32,1,32
Ballymena,4985,6,8,4,14,28,47,-19,28
Glentoran,4985,7,6,6,10,24,32,-8,24
Dungannon,4985,8,2,4,16,14,47,-33,10
Crusaders,4986,1,17,6,3,64,31,33,57
Coleraine,4986,2,14,10,2,43,26,17,52
Glenavon,4986,3,10,9,7,56,43,13,39
Linfield,4986,4,10,6,10,37,36,1,36
Cliftonville,4986,5,9,5,12,32,31,1,32
Ballymena,4986,6,7,4,15,26,50,-24,25
Glentoran,4986,7,6,6,10,24,32,-8,24
Dungannon,4986,8,2,4,16,14,47,-33,10
Crusaders,4987,1,16,7,3,62,31,31,55
Coleraine,4987,2,14,10,2,43,23,20,52
Glenavon,4987,3,10,9,7,53,43,10,39
Linfield,4987,4,11,5,10,40,37,3,38
Cliftonville,4987,5,9,4,13,33,34,-1,31
Ballymena,4987,6,7,5,14,26,48,-22,26
Glentoran,4987,7,6,6,10,24,32,-8,24
Dungannon,4987,8,2,4,16,14,47,-33,10
Coleraine,4988,1,15,10,1,45,22,23,55
Crusaders,4988,2,16,6,4,61,33,28,54
Linfield,4988,3,11,5,10,39,37,2,38
Glenavon,4988,4,9,9,8,52,45,7,36
Cliftonville,4988,5,9,4,13,33,33,0,31
Ballymena,4988,6,8,4,14,28,47,-19,28
Glentoran,4988,7,6,6,10,24,32,-8,24
Dungannon,4988,8,2,4,16,14,47,-33,10
Crusaders,4989,1,17,6,3,63,31,32,57
Coleraine,4989,2,15,10,1,48,23,25,55
Glenavon,4989,3,9,9,8,53,48,5,36
Linfield,4989,4,10,5,11,38,38,0,35
Cliftonville,4989,5,10,4,12,34,32,2,34
Ballymena,4989,6,7,4,15,26,49,-23,25
Glentoran,4989,7,6,6,10,24,32,-8,24
Dungannon,4989,8,2,4,16,14,47,-33,10
Crusaders,4990,1,17,6,3,65,31,34,57
Coleraine,4990,2,14,10,2,44,26,18,52
Glenavon,4990,3,10,9,7,56,44,12,39
Linfield,4990,4,11,5,10,39,37,2,38
Cliftonville,4990,5,9,4,13,33,33,0,31
Ballymena,4990,6,7,4,15,26,51,-25,25
Glentoran,4990,7,6,6,10,24,32,-8,24
Dungannon,4990,8,2,4,16,14,47,-33,10
Crusaders,4991,1,16,7,3,63,32,31,55
Coleraine,4991,2,15,10,1,45,22,23,55
Linfield,4991,3,11,5,10,40,37,3,38
Glenavon,4991,4,9,9,8,52,45,7,36
Cliftonville,4991,5,9,4,13,33,34,-1,31
Ballymena,4991,6,7,5,14,27,49,-22,26
Glentoran,4991,7,6,6,10,24,32,-8,24
Dungannon,4991,8,2,4,16,14,47,-33,10
Crusaders,4992,1,16,7,3,64,33,31,55
Coleraine,4992,2,15,10,1,44,22,22,55
Linfield,4992,3,11,5,10,38,36,2,38
Glenavon,4992,4,9,9,8,52,44,8,36
Cliftonville,4992,5,9,4,13,32,32,0,31
Ballymena,4992,6,7,5,14,28,50,-22,26
Glentoran,4992,7,6,6,10,24,32,-8,24
Dungannon,4992,8,2,4,16,14,47,-33,10
Crusaders,4993,1,16,6,4,62,33,29,54
Coleraine,4993,2,14,10,2,45,25,20,52
Glenavon,4993,3,10,9,7,55,45,10,39
Linfield,4993,4,10,6,10,37,36,1,36
Cliftonville,4993,5,9,5,12,32,31,1,32
Ballymena,4993,6,8,4,14,28,48,-20,28
Glentoran,4993,7,6,6,10,24,32,-8,24
Dungannon,4993,8,2,4,16,14,47,-33,10
Crusaders,4994,1,17,6,3,63,31,32,57
Coleraine,4994,2,14,10,2,43,25,18,52
Glenavon,4994,3,10,9,7,55,43,12,39
Linfield,4994,4,11,5,10,39,36,3,38
Cliftonville,4994,5,9,4,13,32,33,-1,31
Ballymena,4994,6,7,4,15,26,49,-23,25
Glentoran,4994,7,6,6,10,24,32,-8,24
Dungannon,4994,8,2,4,16,14,47,-33,10
Crusaders,4995,1,17,6,3,64,30,34,57
Coleraine,4995,2,14,10,2,43,25,18,52
Glenavon,4995,3,10,9,7,55,43,12,39
Linfield,4995,4,11,5,10,41,37,4,38
Cliftonville,4995,5,9,4,13,33,35,-2,31
Ballymena,4995,6,7,4,15,25,50,-25,25
Glentoran,4995,7,6,6,10,24,32,-8,24
Dungannon,4995,8,2,4,16,14,47,-33,10
Crusaders,4996,1,17,6,3,62,30,32,57
Coleraine,4996,2,14,10,2,43,23,20,52
Glenavon,4996,3,10,9,7,53,43,10,39
Linfield,4996,4,10,6,10,39,38,1,36
Cliftonville,4996,5,9,5,12,34,33,1,32
Ballymena,4996,6,7,4,15,25,48,-23,25
Glentoran,4996,7,6,6,10,24,32,-8,24
Dungannon,4996,8,2,4,16,14,47,-33,10
Crusaders,4997,1,16,7,3,61,30,31,55
Coleraine,4997,2,14,11,1,44,23,21,53
Linfield,4997,3,11,5,10,41,37,4,38
Glenavon,4997,4,9,10,7,53,44,9,37
Cliftonville,4997,5,9,4,13,33,35,-2,31
Ballymena,4997,6,7,5,14,25,47,-22,26
Glentoran,4997,7,6,6,10,24,32,-8,24
Dungannon,4997,8,2,4,16,14,47,-33,10
Coleraine,4998,1,15,10,1,46,22,24,55
Crusaders,4998,2,16,6,4,61,31,30,54
Linfield,4998,3,11,5,10,38,36,2,38
Glenavon,4998,4,9,9,8,52,46,6,36
Cliftonville,4998,5,9,4,13,32,32,0,31
Ballymena,4998,6,8,4,14,26,47,-21,28
Glentoran,4998,7,6,6,10,24,32,-8,24
Dungannon,4998,8,2,4,16,14,47,-33,10
Crusaders,4999,1,17,6,3,64,32,32,57
Coleraine,4999,2,14,10,2,44,25,19,52
Glenavon,4999,3,10,9,7,55,44,11,39
Linfield,4999,4,11,5,10,40,37,3,38
Cliftonville,4999,5,9,4,13,33,34,-1,31
Ballymena,4999,6,7,4,15,27,50,-23,25
Glentoran,4999,7,6,6,10,24,32,-8,24
Dungannon,4999,8,2,4,16,14,47,-33,10
Crusaders,5000,1,16,7,3,62,31,31,55
Coleraine,5000,2,14,11,1,44,23,21,53
Glenavon,5000,3,9,10,7,53,44,9,37
Linfield,5000,4,10,6,10,38,37,1,36
Cliftonville,5000,5,9,5,12,33,32,1,32
Ballymena,5000,6,7,5,14,26,48,-22,26
Glentoran,5000,7,6,6,10,24,32,-8,24
Dungannon,5000,8,2,4,16,14,47,-33,10
Crusaders,5001,1,17,6,3,63,31,32,57
Coleraine,5001,2,15,10,1,47,22,25,55
Linfield,5001,3,11,5,10,39,36,3,38
Glenavon,5001,4,9,9,8,52,47,5,36
Cliftonville,5001,5,9,4,13,32,33,-1,31
Ballymena,5001,6,7,4,15,26,49,-23,25
Glentoran,5001,7,6,6,10,24,32,-8,24
Dungannon,5001,8,2,4,16,14,47,-33,10
Crusaders,5002,1,16,7,3,64,33,31,55
Coleraine,5002,2,14,10,2,45,26,19,52
Glenavon,5002,3,10,9,7,56,45,11,39
Linfield,5002,4,11,5,10,40,36,4,38
Cliftonville,5002,5,9,4,13,32,34,-2,31
Ballymena,5002,6,7,5,14,28,50,-22,26
Glentoran,5002,7,6,6,10,24,32,-8,24
Dungannon,5002,8,2,4,16,14,47,-33,10
Crusaders,5003,1,16,7,3,62,31,31,55
Coleraine,5003,2,14,10,2,44,25,19,52
Glenavon,5003,3,10,9,7,55,44,11,39
Linfield,5003,4,11,5,10,39,36,3,38
Cliftonville,5003,5,9,4,13,32,33,-1,31
Ballymena,5003,6,7,5,14,26,48,-22,26
Glentoran,5003,7,6,6,10,24,32,-8,24
Dungannon,5003,8,2,4,16,14,47,-33,10
Crusaders,5004,1,17,6,3,64,31,33,57
Coleraine,5004,2,14,10,2,43,23,20,52
Glenavon,5004,3,10,9,7,53,43,10,39
Linfield,5004,4,11,5,10,39,36,3,38
Cliftonville,5004,5,9,4,13,32,33,-1,31
Ballymena,5004,6,7,4,15,26,50,-24,25
Glentoran,5004,7,6,6,10,24,32,-8,24
Dungannon,5004,8,2,4,16,14,47,-33,10
Crusaders,5005,1,16,7,3,62,31,31,55
Coleraine,5005,2,15,10,1,45,23,22,55
Linfield,5005,3,11,5,10,39,37,2,38
Glenavon,5005,4,9,9,8,53,45,8,36
Cliftonville,5005,5,9,4,13,33,33,0,31
Ballymena,5005,6,7,5,14,26,48,-22,26
Glentoran,5005,7,6,6,10,24,32,-8,24
Dungannon,5005,8,2,4,16,14,47,-33,10
Crusaders,5006,1,17,6,3,64,31,33,57
Coleraine,5006,2,15,10,1,46,24,22,55
Glenavon,5006,3,9,9,8,54,46,8,36
Linfield,5006,4,10,5,11,39,39,0,35
Cliftonville,5006,5,10,4,12,35,33,2,34
Ballymena,5006,6,7,4,15,26,50,-24,25
Glentoran,5006,7,6,6,10,24,32,-8,24
Dungannon,5006,8,2,4,16,14,47,-33,10
Crusaders,5007,1,17,6,3,65,30,35,57
Coleraine,5007,2,14,11,1,44,23,21,53
Linfield,5007,3,11,5,10,39,37,2,38
Glenavon,5007,4,9,10,7,53,44,9,37
Cliftonville,5007,5,9,4,13,33,33,0,31
Ballymena,5007,6,7,4,15,25,51,-26,25
Glentoran,5007,7,6,6,10,24,32,-8,24
Dungannon,5007,8,2,4,16,14,47,-33,10
Crusaders,5008,1,16,6,4,62,32,30,54
Coleraine,5008,2,14,10,2,44,24,20,52
Glenavon,5008,3,10,9,7,54,44,10,39
Linfield,5008,4,10,6,10,37,36,1,36
Cliftonville,5008,5,9,5,12,32,31,1,32
Ballymena,5008,6,8,4,14,27,48,-21,28
Glentoran,5008,7,6,6,10,24,32,-8,24
Dungannon,5008,8,2,4,16,14,47,-33,10
Crusaders,5009,1,16,6,4,61,32,29,54
Coleraine,5009,2,14,10,2,44,24,20,52
Glenavon,5009,3,10,9,7,54,44,10,39
Linfield,5009,4,11,5,10,40,36,4,38
Cliftonville,5009,5,9,4,13,32,34,-2,31
Ballymena,5009,6,8,4,14,27,47,-20,28
Glentoran,5009,7,6,6,10,24,32,-8,24
Dungannon,5009,8,2,4,16,14,47,-33,10
Crusaders,5010,1,17,6,3,63,30,33,57
Coleraine,5010,2,14,10,2,43,25,18,52
Glenavon,5010,3,10,9,7,55,43,12,39
Linfield,5010,4,11,5,10,39,36,3,38
Cliftonville,5010,5,9,4,13,32,33,-1,31
Ballymena,5010,6,7,4,15,25,49,-24,25
Glentoran,5010,7,6,6,10,24,32,-8,24
Dungannon,5010,8,2,4,16,14,47,-33,10
Crusaders,5011,1,17,6,3,64,32,32,57
Coleraine,5011,2,15,10,1,47,24,23,55
Glenavon,5011,3,9,9,8,54,47,7,36
Linfield,5011,4,10,6,10,39,38,1,36
Cliftonville,5011,5,9,5,12,34,33,1,32
Ballymena,5011,6,7,4,15,27,50,-23,25
Glentoran,5011,7,6,6,10,24,32,-8,24
Dungannon,5011,8,2,4,16,14,47,-33,10
Crusaders,5012,1,17,6,3,65,33,32,57
Coleraine,5012,2,14,10,2,43,23,20,52
Glenavon,5012,3,10,9,7,53,43,10,39
Linfield,5012,4,10,6,10,39,38,1,36
Cliftonville,5012,5,9,5,12,34,33,1,32
Ballymena,5012,6,7,4,15,28,51,-23,25
Glentoran,5012,7,6,6,10,24,32,-8,24
Dungannon,5012,8,2,4,16,14,47,-33,10
Crusaders,5013,1,17,6,3,65,30,35,57
Coleraine,5013,2,15,10,1,45,23,22,55
Linfield,5013,3,11,5,10,39,36,3,38
Glenavon,5013,4,9,9,8,53,45,8,36
Cliftonville,5013,5,9,4,13,32,33,-1,31
Ballymena,5013,6,7,4,15,25,51,-26,25
Glentoran,5013,7,6,6,10,24,32,-8,24
Dungannon,5013,8,2,4,16,14,47,-33,10
Coleraine,5014,1,15,10,1,45,22,23,55
Crusaders,5014,2,16,6,4,62,33,29,54
Linfield,5014,3,11,5,10,39,37,2,38
Glenavon,5014,4,9,9,8,52,45,7,36
Cliftonville,5014,5,9,4,13,33,33,0,31
Ballymena,5014,6,8,4,14,28,48,-20,28
Glentoran,5014,7,6,6,10,24,32,-8,24
Dungannon,5014,8,2,4,16,14,47,-33,10
Crusaders,5015,1,17,6,3,64,31,33,57
Coleraine,5015,2,14,10,2,44,24,20,52
Glenavon,5015,3,10,9,7,54,44,10,39
Linfield,5015,4,11,5,10,39,37,2,38
Cliftonville,5015,5,9,4,13,33,33,0,31
Ballymena,5015,6,7,4,15,26,50,-24,25
Glentoran,5015,7,6,6,10,24,32,-8,24
Dungannon,5015,8,2,4,16,14,47,-33,10
Crusaders,5016,1,16,6,4,62,32,30,54
Coleraine,5016,2,14,11,1,45,24,21,53
Linfield,5016,3,11,5,10,40,36,4,38
Glenavon,5016,4,9,10,7,54,45,9,37
Cliftonville,5016,5,9,4,13,32,34,-2,31
Ballymena,5016,6,8,4,14,27,48,-21,28
Glentoran,5016,7,6,6,10,24,32,-8,24
Dungannon,5016,8,2,4,16,14,47,-33,10
Crusaders,5017,1,17,6,3,65,31,34,57
Coleraine,5017,2,14,10,2,44,24,20,52
Glenavon,5017,3,10,9,7,54,44,10,39
Linfield,5017,4,11,5,10,38,36,2,38
Cliftonville,5017,5,9,4,13,32,32,0,31
Ballymena,5017,6,7,4,15,26,51,-25,25
Glentoran,5017,7,6,6,10,24,32,-8,24
Dungannon,5017,8,2,4,16,14,47,-33,10
Crusaders,5018,1,17,6,3,65,31,34,57
Coleraine,5018,2,15,10,1,46,22,24,55
Glenavon,5018,3,9,9,8,52,46,6,36
Linfield,5018,4,10,6,10,37,36,1,36
Cliftonville,5018,5,9,5,12,32,31,1,32
Ballymena,5018,6,7,4,15,26,51,-25,25
Glentoran,5018,7,6,6,10,24,32,-8,24
Dungannon,5018,8,2,4,16,14,47,-33,10
Crusaders,5019,1,17,6,3,66,31,35,57
Coleraine,5019,2,15,10,1,45,23,22,55
Linfield,5019,3,11,5,10,41,38,3,38
Glenavon,5019,4,9,9,8,53,45,8,36
Cliftonville,5019,5,9,4,13,34,35,-1,31
Ballymena,5019,6,7,4,15,26,52,-26,25
Glentoran,5019,7,6,6,10,24,32,-8,24
Dungannon,5019,8,2,4,16,14,47,-33,10
Crusaders,5020,1,17,6,3,64,30,34,57
Coleraine,5020,2,14,11,1,45,24,21,53
Linfield,5020,3,11,5,10,41,37,4,38
Glenavon,5020,4,9,10,7,54,45,9,37
Cliftonville,5020,5,9,4,13,33,35,-2,31
Ballymena,5020,6,7,4,15,25,50,-25,25
Glentoran,5020,7,6,6,10,24,32,-8,24
Dungannon,5020,8,2,4,16,14,47,-33,10
Crusaders,5021,1,16,7,3,62,31,31,55
Coleraine,5021,2,14,10,2,45,26,19,52
Glenavon,5021,3,10,9,7,56,45,11,39
Linfield,5021,4,11,5,10,38,36,2,38
Cliftonville,5021,5,9,4,13,32,32,0,31
Ballymena,5021,6,7,5,14,26,48,-22,26
Glentoran,5021,7,6,6,10,24,32,-8,24
Dungannon,5021,8,2,4,16,14,47,-33,10
Crusaders,5022,1,16,7,3,61,30,31,55
Coleraine,5022,2,15,10,1,46,22,24,55
Linfield,5022,3,11,5,10,40,38,2,38
Glenavon,5022,4,9,9,8,52,46,6,36
Cliftonville,5022,5,9,4,13,34,34,0,31
Ballymena,5022,6,7,5,14,25,47,-22,26
Glentoran,5022,7,6,6,10,24,32,-8,24
Dungannon,5022,8,2,4,16,14,47,-33,10
Crusaders,5023,1,17,6,3,64,32,32,57
Coleraine,5023,2,14,10,2,44,25,19,52
Glenavon,5023,3,10,9,7,55,44,11,39
Linfield,5023,4,11,5,10,38,36,2,38
Cliftonville,5023,5,9,4,13,32,32,0,31
Ballymena,5023,6,7,4,15,27,50,-23,25
Glentoran,5023,7,6,6,10,24,32,-8,24
Dungannon,5023,8,2,4,16,14,47,-33,10
Crusaders,5024,1,16,6,4,62,33,29,54
Coleraine,5024,2,14,11,1,47,26,21,53
Glenavon,5024,3,9,10,7,56,47,9,37
Linfield,5024,4,10,5,11,37,37,0,35
Cliftonville,5024,5,10,4,12,33,31,2,34
Ballymena,5024,6,8,4,14,28,48,-20,28
Glentoran,5024,7,6,6,10,24,32,-8,24
Dungannon,5024,8,2,4,16,14,47,-33,10
Crusaders,5025,1,17,6,3,66,30,36,57
Coleraine,5025,2,15,10,1,45,22,23,55
Linfield,5025,3,11,5,10,41,37,4,38
Glenavon,5025,4,9,9,8,52,45,7,36
Cliftonville,5025,5,9,4,13,33,35,-2,31
Ballymena,5025,6,7,4,15,25,52,-27,25
Glentoran,5025,7,6,6,10,24,32,-8,24
Dungannon,5025,8,2,4,16,14,47,-33,10
Crusaders,5026,1,16,7,3,63,32,31,55
Coleraine,5026,2,15,10,1,45,23,22,55
Glenavon,5026,3,9,9,8,53,45,8,36
Linfield,5026,4,10,5,11,38,38,0,35
Cliftonville,5026,5,10,4,12,34,32,2,34
Ballymena,5026,6,7,5,14,27,49,-22,26
Glentoran,5026,7,6,6,10,24,32,-8,24
Dungannon,5026,8,2,4,16,14,47,-33,10
Crusaders,5027,1,16,6,4,62,32,30,54
Coleraine,5027,2,14,10,2,45,27,18,52
Glenavon,5027,3,10,9,7,57,45,12,39
Linfield,5027,4,10,6,10,38,37,1,36
Cliftonville,5027,5,9,5,12,33,32,1,32
Ballymena,5027,6,8,4,14,27,48,-21,28
Glentoran,5027,7,6,6,10,24,32,-8,24
Dungannon,5027,8,2,4,16,14,47,-33,10
Crusaders,5028,1,17,6,3,62,30,32,57
Coleraine,5028,2,14,11,1,46,25,21,53
Glenavon,5028,3,9,10,7,55,46,9,37
Linfield,5028,4,10,5,11,38,38,0,35
Cliftonville,5028,5,10,4,12,34,32,2,34
Ballymena,5028,6,7,4,15,25,48,-23,25
Glentoran,5028,7,6,6,10,24,32,-8,24
Dungannon,5028,8,2,4,16,14,47,-33,10
Crusaders,5029,1,16,6,4,62,32,30,54
Coleraine,5029,2,14,10,2,43,23,20,52
Glenavon,5029,3,10,9,7,53,43,10,39
Linfield,5029,4,11,5,10,39,37,2,38
Cliftonville,5029,5,9,4,13,33,33,0,31
Ballymena,5029,6,8,4,14,27,48,-21,28
Glentoran,5029,7,6,6,10,24,32,-8,24
Dungannon,5029,8,2,4,16,14,47,-33,10
Coleraine,5030,1,15,10,1,47,24,23,55
Crusaders,5030,2,16,6,4,63,36,27,54
Glenavon,5030,3,9,9,8,54,47,7,36
Linfield,5030,4,10,5,11,37,37,0,35
Cliftonville,5030,5,10,4,12,33,31,2,34
Ballymena,5030,6,8,4,14,31,49,-18,28
Glentoran,5030,7,6,6,10,24,32,-8,24
Dungannon,5030,8,2,4,16,14,47,-33,10
Coleraine,5031,1,15,10,1,46,23,23,55
Crusaders,5031,2,16,6,4,61,32,29,54
Linfield,5031,3,11,5,10,40,37,3,38
Glenavon,5031,4,9,9,8,53,46,7,36
Cliftonville,5031,5,9,4,13,33,34,-1,31
Ballymena,5031,6,8,4,14,27,47,-20,28
Glentoran,5031,7,6,6,10,24,32,-8,24
Dungannon,5031,8,2,4,16,14,47,-33,10
Crusaders,5032,1,17,6,3,68,33,35,57
Coleraine,5032,2,15,10,1,45,22,23,55
Linfield,5032,3,11,5,10,38,36,2,38
Glenavon,5032,4,9,9,8,52,45,7,36
Cliftonville,5032,5,9,4,13,32,32,0,31
Ballymena,5032,6,7,4,15,28,54,-26,25
Glentoran,5032,7,6,6,10,24,32,-8,24
Dungannon,5032,8,2,4,16,14,47,-33,10
Crusaders,5033,1,17,6,3,64,31,33,57
Coleraine,5033,2,14,11,1,44,23,21,53
Linfield,5033,3,11,5,10,38,36,2,38
Glenavon,5033,4,9,10,7,53,44,9,37
Cliftonville,5033,5,9,4,13,32,32,0,31
Ballymena,5033,6,7,4,15,26,50,-24,25
Glentoran,5033,7,6,6,10,24,32,-8,24
Dungannon,5033,8,2,4,16,14,47,-33,10
Crusaders,5034,1,17,6,3,63,31,32,57
Coleraine,5034,2,14,11,1,44,23,21,53
Glenavon,5034,3,9,10,7,53,44,9,37
Linfield,5034,4,10,5,11,37,39,-2,35
Cliftonville,5034,5,10,4,12,35,31,4,34
Ballymena,5034,6,7,4,15,26,49,-23,25
Glentoran,5034,7,6,6,10,24,32,-8,24
Dungannon,5034,8,2,4,16,14,47,-33,10
Crusaders,5035,1,17,6,3,65,30,35,57
Coleraine,5035,2,14,10,2,44,24,20,52
Glenavon,5035,3,10,9,7,54,44,10,39
Linfield,5035,4,11,5,10,41,37,4,38
Cliftonville,5035,5,9,4,13,33,35,-2,31
Ballymena,5035,6,7,4,15,25,51,-26,25
Glentoran,5035,7,6,6,10,24,32,-8,24
Dungannon,5035,8,2,4,16,14,47,-33,10
Crusaders,5036,1,17,6,3,62,30,32,57
Coleraine,5036,2,14,10,2,43,25,18,52
Glenavon,5036,3,10,9,7,55,43,12,39
Linfield,5036,4,11,5,10,40,37,3,38
Cliftonville,5036,5,9,4,13,33,34,-1,31
Ballymena,5036,6,7,4,15,25,48,-23,25
Glentoran,5036,7,6,6,10,24,32,-8,24
Dungannon,5036,8,2,4,16,14,47,-33,10
Crusaders,5037,1,16,7,3,61,30,31,55
Coleraine,5037,2,15,10,1,47,24,23,55
Linfield,5037,3,11,5,10,40,36,4,38
Glenavon,5037,4,9,9,8,54,47,7,36
Cliftonville,5037,5,9,4,13,32,34,-2,31
Ballymena,5037,6,7,5,14,25,47,-22,26
Glentoran,5037,7,6,6,10,24,32,-8,24
Dungannon,5037,8,2,4,16,14,47,-33,10
Crusaders,5038,1,16,7,3,62,31,31,55
Coleraine,5038,2,15,10,1,46,23,23,55
Linfield,5038,3,11,5,10,39,36,3,38
Glenavon,5038,4,9,9,8,53,46,7,36
Cliftonville,5038,5,9,4,13,32,33,-1,31
Ballymena,5038,6,7,5,14,26,48,-22,26
Glentoran,5038,7,6,6,10,24,32,-8,24
Dungannon,5038,8,2,4,16,14,47,-33,10
Crusaders,5039,1,17,6,3,63,31,32,57
Coleraine,5039,2,15,10,1,44,22,22,55
Linfield,5039,3,11,5,10,39,37,2,38
Glenavon,5039,4,9,9,8,52,44,8,36
Cliftonville,5039,5,9,4,13,33,33,0,31
Ballymena,5039,6,7,4,15,26,49,-23,25
Glentoran,5039,7,6,6,10,24,32,-8,24
Dungannon,5039,8,2,4,16,14,47,-33,10
Crusaders,5040,1,16,7,3,61,30,31,55
Coleraine,5040,2,14,11,1,45,24,21,53
Glenavon,5040,3,9,10,7,54,45,9,37
Linfield,5040,4,10,5,11,37,37,0,35
Cliftonville,5040,5,10,4,12,33,31,2,34
Ballymena,5040,6,7,5,14,25,47,-22,26
Glentoran,5040,7,6,6,10,24,32,-8,24
Dungannon,5040,8,2,4,16,14,47,-33,10
Coleraine,5041,1,15,10,1,45,23,22,55
Crusaders,5041,2,16,6,4,63,33,30,54
Glenavon,5041,3,9,9,8,53,45,8,36
Linfield,5041,4,10,5,11,37,38,-1,35
Cliftonville,5041,5,10,4,12,34,31,3,34
Ballymena,5041,6,8,4,14,28,49,-21,28
Glentoran,5041,7,6,6,10,24,32,-8,24
Dungannon,5041,8,2,4,16,14,47,-33,10
Crusaders,5042,1,17,6,3,63,31,32,57
Coleraine,5042,2,14,11,1,44,23,21,53
Glenavon,5042,3,9,10,7,53,44,9,37
Linfield,5042,4,10,5,11,38,39,-1,35
Cliftonville,5042,5,10,4,12,35,32,3,34
Ballymena,5042,6,7,4,15,26,49,-23,25
Glentoran,5042,7,6,6,10,24,32,-8,24
Dungannon,5042,8,2,4,16,14,47,-33,10
Crusaders,5043,1,16,7,3,63,32,31,55
Coleraine,5043,2,15,10,1,46,23,23,55
Glenavon,5043,3,9,9,8,53,46,7,36
Linfield,5043,4,10,6,10,38,37,1,36
Cliftonville,5043,5,9,5,12,33,32,1,32
Ballymena,5043,6,7,5,14,27,49,-22,26
Glentoran,5043,7,6,6,10,24,32,-8,24
Dungannon,5043,8,2,4,16,14,47,-33,10
Coleraine,5044,1,15,10,1,45,22,23,55
Crusaders,5044,2,16,6,4,61,31,30,54
Linfield,5044,3,11,5,10,42,37,5,38
Glenavon,5044,4,9,9,8,52,45,7,36
Cliftonville,5044,5,9,4,13,33,36,-3,31
Ballymena,5044,6,8,4,14,26,47,-21,28
Glentoran,5044,7,6,6,10,24,32,-8,24
Dungannon,5044,8,2,4,16,14,47,-33,10
Crusaders,5045,1,16,6,4,61,32,29,54
Coleraine,5045,2,14,11,1,44,23,21,53
Glenavon,5045,3,9,10,7,53,44,9,37
Linfield,5045,4,10,5,11,38,38,0,35
Cliftonville,5045,5,10,4,12,34,32,2,34
Ballymena,5045,6,8,4,14,27,47,-20,28
Glentoran,5045,7,6,6,10,24,32,-8,24
Dungannon,5045,8,2,4,16,14,47,-33,10
Crusaders,5046,1,17,6,3,65,30,35,57
Coleraine,5046,2,15,10,1,44,22,22,55
Linfield,5046,3,11,5,10,38,36,2,38
Glenavon,5046,4,9,9,8,52,44,8,36
Cliftonville,5046,5,9,4,13,32,32,0,31
Ballymena,5046,6,7,4,15,25,51,-26,25
Glentoran,5046,7,6,6,10,24,32,-8,24
Dungannon,5046,8,2,4,16,14,47,-33,10
Crusaders,5047,1,17,6,3,64,32,32,57
Coleraine,5047,2,15,10,1,44,22,22,55
Glenavon,5047,3,9,9,8,52,44,8,36
Linfield,5047,4,10,5,11,38,40,-2,35
Cliftonville,5047,5,10,4,12,36,32,4,34
Ballymena,5047,6,7,4,15,27,50,-23,25
Glentoran,5047,7,6,6,10,24,32,-8,24
Dungannon,5047,8,2,4,16,14,47,-33,10
Crusaders,5048,1,16,6,4,62,33,29,54
Coleraine,5048,2,14,10,2,43,23,20,52
Glenavon,5048,3,10,9,7,53,43,10,39
Linfield,5048,4,10,5,11,38,38,0,35
Cliftonville,5048,5,10,4,12,34,32,2,34
Ballymena,5048,6,8,4,14,28,48,-20,28
Glentoran,5048,7,6,6,10,24,32,-8,24
Dungannon,5048,8,2,4,16,14,47,-33,10
Crusaders,5049,1,16,7,3,64,33,31,55
Coleraine,5049,2,14,10,2,43,23,20,52
Glenavon,5049,3,10,9,7,53,43,10,39
Linfield,5049,4,10,5,11,37,38,-1,35
Cliftonville,5049,5,10,4,12,34,31,3,34
Ballymena,5049,6,7,5,14,28,50,-22,26
Glentoran,5049,7,6,6,10,24,32,-8,24
Dungannon,5049,8,2,4,16,14,47,-33,10
Crusaders,5050,1,16,7,3,63,32,31,55
Coleraine,5050,2,15,10,1,44,22,22,55
Glenavon,5050,3,9,9,8,52,44,8,36
Linfield,5050,4,10,5,11,37,38,-1,35
Cliftonville,5050,5,10,4,12,34,31,3,34
Ballymena,5050,6,7,5,14,27,49,-22,26
Glentoran,5050,7,6,6,10,24,32,-8,24
Dungannon,5050,8,2,4,16,14,47,-33,10
Crusaders,5051,1,17,6,3,65,31,34,57
Coleraine,5051,2,14,10,2,45,26,19,52
Glenavon,5051,3,10,9,7,56,45,11,39
Linfield,5051,4,11,5,10,38,36,2,38
Cliftonville,5051,5,9,4,13,32,32,0,31
Ballymena,5051,6,7,4,15,26,51,-25,25
Glentoran,5051,7,6,6,10,24,32,-8,24
Dungannon,5051,8,2,4,16,14,47,-33,10
Crusaders,5052,1,16,7,3,63,32,31,55
Coleraine,5052,2,14,11,1,45,24,21,53
Linfield,5052,3,11,5,10,40,37,3,38
Glenavon,5052,4,9,10,7,54,45,9,37
Cliftonville,5052,5,9,4,13,33,34,-1,31
Ballymena,5052,6,7,5,14,27,49,-22,26
Glentoran,5052,7,6,6,10,24,32,-8,24
Dungannon,5052,8,2,4,16,14,47,-33,10
Coleraine,5053,1,15,10,1,44,22,22,55
Crusaders,5053,2,16,6,4,61,33,28,54
Linfield,5053,3,11,5,10,41,36,5,38
Glenavon,5053,4,9,9,8,52,44,8,36
Cliftonville,5053,5,9,4,13,32,35,-3,31
Ballymena,5053,6,8,4,14,28,47,-19,28
Glentoran,5053,7,6,6,10,24,32,-8,24
Dungannon,5053,8,2,4,16,14,47,-33,10
Crusaders,5054,1,17,6,3,64,31,33,57
Coleraine,5054,2,14,10,2,44,25,19,52
Glenavon,5054,3,10,9,7,55,44,11,39
Linfield,5054,4,10,5,11,37,37,0,35
Cliftonville,5054,5,10,4,12,33,31,2,34
Ballymena,5054,6,7,4,15,26,50,-24,25
Glentoran,5054,7,6,6,10,24,32,-8,24
Dungannon,5054,8,2,4,16,14,47,-33,10
Crusaders,5055,1,17,6,3,65,31,34,57
Coleraine,5055,2,14,10,2,43,24,19,52
Glenavon,5055,3,10,9,7,54,43,11,39
Linfield,5055,4,11,5,10,38,36,2,38
Cliftonville,5055,5,9,4,13,32,32,0,31
Ballymena,5055,6,7,4,15,26,51,-25,25
Glentoran,5055,7,6,6,10,24,32,-8,24
Dungannon,5055,8,2,4,16,14,47,-33,10
Crusaders,5056,1,17,6,3,65,33,32,57
Coleraine,5056,2,15,10,1,46,24,22,55
Glenavon,5056,3,9,9,8,54,46,8,36
Linfield,5056,4,10,6,10,38,37,1,36
Cliftonville,5056,5,9,5,12,33,32,1,32
Ballymena,5056,6,7,4,15,28,51,-23,25
Glentoran,5056,7,6,6,10,24,32,-8,24
Dungannon,5056,8,2,4,16,14,47,-33,10
Crusaders,5057,1,16,6,4,63,34,29,54
Coleraine,5057,2,14,10,2,44,26,18,52
Glenavon,5057,3,10,9,7,56,44,12,39
Linfield,5057,4,11,5,10,38,36,2,38
Cliftonville,5057,5,9,4,13,32,32,0,31
Ballymena,5057,6,8,4,14,29,49,-20,28
Glentoran,5057,7,6,6,10,24,32,-8,24
Dungannon,5057,8,2,4,16,14,47,-33,10
Crusaders,5058,1,16,7,3,61,30,31,55
Coleraine,5058,2,14,11,1,43,22,21,53
Linfield,5058,3,11,5,10,42,37,5,38
Glenavon,5058,4,9,10,7,52,43,9,37
Cliftonville,5058,5,9,4,13,33,36,-3,31
Ballymena,5058,6,7,5,14,25,47,-22,26
Glentoran,5058,7,6,6,10,24,32,-8,24
Dungannon,5058,8,2,4,16,14,47,-33,10
Crusaders,5059,1,16,7,3,62,31,31,55
Coleraine,5059,2,14,10,2,43,26,17,52
Glenavon,5059,3,10,9,7,56,43,13,39
Linfield,5059,4,10,5,11,38,38,0,35
Cliftonville,5059,5,10,4,12,34,32,2,34
Ballymena,5059,6,7,5,14,26,48,-22,26
Glentoran,5059,7,6,6,10,24,32,-8,24
Dungannon,5059,8,2,4,16,14,47,-33,10
Crusaders,5060,1,16,7,3,64,33,31,55
Coleraine,5060,2,15,10,1,45,23,22,55
Glenavon,5060,3,9,9,8,53,45,8,36
Linfield,5060,4,10,6,10,37,36,1,36
Cliftonville,5060,5,9,5,12,32,31,1,32
Ballymena,5060,6,7,5,14,28,50,-22,26
Glentoran,5060,7,6,6,10,24,32,-8,24
Dungannon,5060,8,2,4,16,14,47,-33,10
Crusaders,5061,1,17,6,3,64,31,33,57
Coleraine,5061,2,14,10,2,44,24,20,52
Glenavon,5061,3,10,9,7,54,44,10,39
Linfield,5061,4,10,5,11,38,38,0,35
Cliftonville,5061,5,10,4,12,34,32,2,34
Ballymena,5061,6,7,4,15,26,50,-24,25
Glentoran,5061,7,6,6,10,24,32,-8,24
Dungannon,5061,8,2,4,16,14,47,-33,10
Crusaders,5062,1,16,6,4,62,32,30,54
Coleraine,5062,2,14,10,2,44,24,20,52
Glenavon,5062,3,10,9,7,54,44,10,39
Linfield,5062,4,10,5,11,37,39,-2,35
Cliftonville,5062,5,10,4,12,35,31,4,34
Ballymena,5062,6,8,4,14,27,48,-21,28
Glentoran,5062,7,6,6,10,24,32,-8,24
Dungannon,5062,8,2,4,16,14,47,-33,10
Crusaders,5063,1,17,6,3,65,33,32,57
Coleraine,5063,2,14,10,2,45,26,19,52
Glenavon,5063,3,10,9,7,56,45,11,39
Linfield,5063,4,10,6,10,38,37,1,36
Cliftonville,5063,5,9,5,12,33,32,1,32
Ballymena,5063,6,7,4,15,28,51,-23,25
Glentoran,5063,7,6,6,10,24,32,-8,24
Dungannon,5063,8,2,4,16,14,47,-33,10
Crusaders,5064,1,17,6,3,65,32,33,57
Coleraine,5064,2,14,11,1,45,24,21,53
Glenavon,5064,3,9,10,7,54,45,9,37
Linfield,5064,4,10,6,10,37,36,1,36
Cliftonville,5064,5,9,5,12,32,31,1,32
Ballymena,5064,6,7,4,15,27,51,-24,25
Glentoran,5064,7,6,6,10,24,32,-8,24
Dungannon,5064,8,2,4,16,14,47,-33,10
Crusaders,5065,1,17,6,3,62,30,32,57
Coleraine,5065,2,15,10,1,45,23,22,55
Glenavon,5065,3,9,9,8,53,45,8,36
Linfield,5065,4,10,6,10,37,36,1,36
Cliftonville,5065,5,9,5,12,32,31,1,32
Ballymena,5065,6,7,4,15,25,48,-23,25
Glentoran,5065,7,6,6,10,24,32,-8,24
Dungannon,5065,8,2,4,16,14,47,-33,10
Crusaders,5066,1,17,6,3,67,30,37,57
Coleraine,5066,2,14,11,1,44,23,21,53
Glenavon,5066,3,9,10,7,53,44,9,37
Linfield,5066,4,10,5,11,37,37,0,35
Cliftonville,5066,5,10,4,12,33,31,2,34
Ballymena,5066,6,7,4,15,25,53,-28,25
Glentoran,5066,7,6,6,10,24,32,-8,24
Dungannon,5066,8,2,4,16,14,47,-33,10
Crusaders,5067,1,17,6,3,63,31,32,57
Coleraine,5067,2,14,11,1,44,23,21,53
Glenavon,5067,3,9,10,7,53,44,9,37
Linfield,5067,4,10,5,11,38,38,0,35
Cliftonville,5067,5,10,4,12,34,32,2,34
Ballymena,5067,6,7,4,15,26,49,-23,25
Glentoran,5067,7,6,6,10,24,32,-8,24
Dungannon,5067,8,2,4,16,14,47,-33,10
Crusaders,5068,1,17,6,3,64,30,34,57
Coleraine,5068,2,14,11,1,44,23,21,53
Linfield,5068,3,11,5,10,39,37,2,38
Glenavon,5068,4,9,10,7,53,44,9,37
Cliftonville,5068,5,9,4,13,33,33,0,31
Ballymena,5068,6,7,4,15,25,50,-25,25
Glentoran,5068,7,6,6,10,24,32,-8,24
Dungannon,5068,8,2,4,16,14,47,-33,10
Crusaders,5069,1,17,6,3,64,31,33,57
Coleraine,5069,2,14,10,2,44,27,17,52
Glenavon,5069,3,10,9,7,57,44,13,39
Linfield,5069,4,10,6,10,39,38,1,36
Cliftonville,5069,5,9,5,12,34,33,1,32
Ballymena,5069,6,7,4,15,26,50,-24,25
Glentoran,5069,7,6,6,10,24,32,-8,24
Dungannon,5069,8,2,4,16,14,47,-33,10
Crusaders,5070,1,16,7,3,61,30,31,55
Coleraine,5070,2,14,10,2,43,24,19,52
Glenavon,5070,3,10,9,7,54,43,11,39
Linfield,5070,4,10,5,11,38,41,-3,35
Cliftonville,5070,5,10,4,12,37,32,5,34
Ballymena,5070,6,7,5,14,25,47,-22,26
Glentoran,5070,7,6,6,10,24,32,-8,24
Dungannon,5070,8,2,4,16,14,47,-33,10
Crusaders,5071,1,16,7,3,62,31,31,55
Coleraine,5071,2,14,10,2,44,24,20,52
Glenavon,5071,3,10,9,7,54,44,10,39
Linfield,5071,4,11,5,10,39,36,3,38
Cliftonville,5071,5,9,4,13,32,33,-1,31
Ballymena,5071,6,7,5,14,26,48,-22,26
Glentoran,5071,7,6,6,10,24,32,-8,24
Dungannon,5071,8,2,4,16,14,47,-33,10
Crusaders,5072,1,17,6,3,63,30,33,57
Coleraine,5072,2,14,11,1,44,23,21,53
Glenavon,5072,3,9,10,7,53,44,9,37
Linfield,5072,4,10,6,10,38,37,1,36
Cliftonville,5072,5,9,5,12,33,32,1,32
Ballymena,5072,6,7,4,15,25,49,-24,25
Glentoran,5072,7,6,6,10,24,32,-8,24
Dungannon,5072,8,2,4,16,14,47,-33,10
Crusaders,5073,1,17,6,3,65,32,33,57
Coleraine,5073,2,14,10,2,44,25,19,52
Glenavon,5073,3,10,9,7,55,44,11,39
Linfield,5073,4,10,5,11,37,38,-1,35
Cliftonville,5073,5,10,4,12,34,31,3,34
Ballymena,5073,6,7,4,15,27,51,-24,25
Glentoran,5073,7,6,6,10,24,32,-8,24
Dungannon,5073,8,2,4,16,14,47,-33,10
Crusaders,5074,1,17,6,3,62,30,32,57
Coleraine,5074,2,15,10,1,47,24,23,55
Glenavon,5074,3,9,9,8,54,47,7,36
Linfield,5074,4,10,6,10,37,36,1,36
Cliftonville,5074,5,9,5,12,32,31,1,32
Ballymena,5074,6,7,4,15,25,48,-23,25
Glentoran,5074,7,6,6,10,24,32,-8,24
Dungannon,5074,8,2,4,16,14,47,-33,10
Coleraine,5075,1,15,10,1,44,22,22,55
Crusaders,5075,2,16,6,4,64,35,29,54
Glenavon,5075,3,9,9,8,52,44,8,36
Linfield,5075,4,10,5,11,37,37,0,35
Cliftonville,5075,5,10,4,12,33,31,2,34
Ballymena,5075,6,8,4,14,30,50,-20,28
Glentoran,5075,7,6,6,10,24,32,-8,24
Dungannon,5075,8,2,4,16,14,47,-33,10
Crusaders,5076,1,17,6,3,65,30,35,57
Coleraine,5076,2,14,10,2,44,25,19,52
Glenavon,5076,3,10,9,7,55,44,11,39
Linfield,5076,4,10,5,11,37,39,-2,35
Cliftonville,5076,5,10,4,12,35,31,4,34
Ballymena,5076,6,7,4,15,25,51,-26,25
Glentoran,5076,7,6,6,10,24,32,-8,24
Dungannon,5076,8,2,4,16,14,47,-33,10
Crusaders,5077,1,17,6,3,64,30,34,57
Coleraine,5077,2,15,10,1,45,23,22,55
Linfield,5077,3,11,5,10,38,36,2,38
Glenavon,5077,4,9,9,8,53,45,8,36
Cliftonville,5077,5,9,4,13,32,32,0,31
Ballymena,5077,6,7,4,15,25,50,-25,25
Glentoran,5077,7,6,6,10,24,32,-8,24
Dungannon,5077,8,2,4,16,14,47,-33,10
Crusaders,5078,1,16,7,3,62,31,31,55
Coleraine,5078,2,14,11,1,44,23,21,53
Linfield,5078,3,11,5,10,39,37,2,38
Glenavon,5078,4,9,10,7,53,44,9,37
Cliftonville,5078,5,9,4,13,33,33,0,31
Ballymena,5078,6,7,5,14,26,48,-22,26
Glentoran,5078,7,6,6,10,24,32,-8,24
Dungannon,5078,8,2,4,16,14,47,-33,10
Crusaders,5079,1,17,6,3,62,30,32,57
Coleraine,5079,2,14,11,1,44,23,21,53
Glenavon,5079,3,9,10,7,53,44,9,37
Linfield,5079,4,10,6,10,40,39,1,36
Cliftonville,5079,5,9,5,12,35,34,1,32
Ballymena,5079,6,7,4,15,25,48,-23,25
Glentoran,5079,7,6,6,10,24,32,-8,24
Dungannon,5079,8,2,4,16,14,47,-33,10
Crusaders,5080,1,16,7,3,61,30,31,55
Coleraine,5080,2,14,11,1,44,23,21,53
Linfield,5080,3,11,5,10,40,38,2,38
Glenavon,5080,4,9,10,7,53,44,9,37
Cliftonville,5080,5,9,4,13,34,34,0,31
Ballymena,5080,6,7,5,14,25,47,-22,26
Glentoran,5080,7,6,6,10,24,32,-8,24
Dungannon,5080,8,2,4,16,14,47,-33,10
Crusaders,5081,1,16,7,3,62,31,31,55
Coleraine,5081,2,15,10,1,44,22,22,55
Linfield,5081,3,11,5,10,40,37,3,38
Glenavon,5081,4,9,9,8,52,44,8,36
Cliftonville,5081,5,9,4,13,33,34,-1,31
Ballymena,5081,6,7,5,14,26,48,-22,26
Glentoran,5081,7,6,6,10,24,32,-8,24
Dungannon,5081,8,2,4,16,14,47,-33,10
Crusaders,5082,1,17,6,3,64,30,34,57
Coleraine,5082,2,14,10,2,43,24,19,52
Glenavon,5082,3,10,9,7,54,43,11,39
Linfield,5082,4,10,6,10,37,36,1,36
Cliftonville,5082,5,9,5,12,32,31,1,32
Ballymena,5082,6,7,4,15,25,50,-25,25
Glentoran,5082,7,6,6,10,24,32,-8,24
Dungannon,5082,8,2,4,16,14,47,-33,10
Crusaders,5083,1,16,6,4,61,31,30,54
Coleraine,5083,2,14,11,1,43,22,21,53
Glenavon,5083,3,9,10,7,52,43,9,37
Linfield,5083,4,10,6,10,38,37,1,36
Cliftonville,5083,5,9,5,12,33,32,1,32
Ballymena,5083,6,8,4,14,26,47,-21,28
Glentoran,5083,7,6,6,10,24,32,-8,24
Dungannon,5083,8,2,4,16,14,47,-33,10
Crusaders,5084,1,17,6,3,63,31,32,57
Coleraine,5084,2,14,11,1,44,23,21,53
Linfield,5084,3,11,5,10,41,36,5,38
Glenavon,5084,4,9,10,7,53,44,9,37
Cliftonville,5084,5,9,4,13,32,35,-3,31
Ballymena,5084,6,7,4,15,26,49,-23,25
Glentoran,5084,7,6,6,10,24,32,-8,24
Dungannon,5084,8,2,4,16,14,47,-33,10
Crusaders,5085,1,17,6,3,63,31,32,57
Coleraine,5085,2,14,10,2,44,24,20,52
Glenavon,5085,3,10,9,7,54,44,10,39
Linfield,5085,4,10,6,10,37,36,1,36
Cliftonville,5085,5,9,5,12,32,31,1,32
Ballymena,5085,6,7,4,15,26,49,-23,25
Glentoran,5085,7,6,6,10,24,32,-8,24
Dungannon,5085,8,2,4,16,14,47,-33,10
Crusaders,5086,1,17,6,3,63,31,32,57
Coleraine,5086,2,14,11,1,44,23,21,53
Glenavon,5086,3,9,10,7,53,44,9,37
Linfield,5086,4,10,6,10,37,36,1,36
Cliftonville,5086,5,9,5,12,32,31,1,32
Ballymena,5086,6,7,4,15,26,49,-23,25
Glentoran,5086,7,6,6,10,24,32,-8,24
Dungannon,5086,8,2,4,16,14,47,-33,10
Crusaders,5087,1,17,6,3,63,30,33,57
Coleraine,5087,2,14,10,2,44,24,20,52
Glenavon,5087,3,10,9,7,54,44,10,39
Linfield,5087,4,11,5,10,39,36,3,38
Cliftonville,5087,5,9,4,13,32,33,-1,31
Ballymena,5087,6,7,4,15,25,49,-24,25
Glentoran,5087,7,6,6,10,24,32,-8,24
Dungannon,5087,8,2,4,16,14,47,-33,10
Crusaders,5088,1,17,6,3,67,32,35,57
Coleraine,5088,2,15,10,1,45,22,23,55
Glenavon,5088,3,9,9,8,52,45,7,36
Linfield,5088,4,10,6,10,38,37,1,36
Cliftonville,5088,5,9,5,12,33,32,1,32
Ballymena,5088,6,7,4,15,27,53,-26,25
Glentoran,5088,7,6,6,10,24,32,-8,24
Dungannon,5088,8,2,4,16,14,47,-33,10
Crusaders,5089,1,17,6,3,63,30,33,57
Coleraine,5089,2,15,10,1,45,22,23,55
Glenavon,5089,3,9,9,8,52,45,7,36
Linfield,5089,4,10,5,11,38,39,-1,35
Cliftonville,5089,5,10,4,12,35,32,3,34
Ballymena,5089,6,7,4,15,25,49,-24,25
Glentoran,5089,7,6,6,10,24,32,-8,24
Dungannon,5089,8,2,4,16,14,47,-33,10
Crusaders,5090,1,16,6,4,61,31,30,54
Coleraine,5090,2,14,11,1,44,23,21,53
Linfield,5090,3,11,5,10,38,36,2,38
Glenavon,5090,4,9,10,7,53,44,9,37
Cliftonville,5090,5,9,4,13,32,32,0,31
Ballymena,5090,6,8,4,14,26,47,-21,28
Glentoran,5090,7,6,6,10,24,32,-8,24
Dungannon,5090,8,2,4,16,14,47,-33,10
Crusaders,5091,1,17,6,3,62,30,32,57
Coleraine,5091,2,14,10,2,44,24,20,52
Glenavon,5091,3,10,9,7,54,44,10,39
Linfield,5091,4,10,5,11,39,39,0,35
Cliftonville,5091,5,10,4,12,35,33,2,34
Ballymena,5091,6,7,4,15,25,48,-23,25
Glentoran,5091,7,6,6,10,24,32,-8,24
Dungannon,5091,8,2,4,16,14,47,-33,10
Coleraine,5092,1,15,10,1,44,22,22,55
Crusaders,5092,2,16,6,4,61,31,30,54
Linfield,5092,3,11,5,10,40,36,4,38
Glenavon,5092,4,9,9,8,52,44,8,36
Cliftonville,5092,5,9,4,13,32,34,-2,31
Ballymena,5092,6,8,4,14,26,47,-21,28
Glentoran,5092,7,6,6,10,24,32,-8,24
Dungannon,5092,8,2,4,16,14,47,-33,10
Crusaders,5093,1,17,6,3,63,30,33,57
Coleraine,5093,2,14,10,2,44,25,19,52
Glenavon,5093,3,10,9,7,55,44,11,39
Linfield,5093,4,10,6,10,38,37,1,36
Cliftonville,5093,5,9,5,12,33,32,1,32
Ballymena,5093,6,7,4,15,25,49,-24,25
Glentoran,5093,7,6,6,10,24,32,-8,24
Dungannon,5093,8,2,4,16,14,47,-33,10
Crusaders,5094,1,17,6,3,64,31,33,57
Coleraine,5094,2,14,10,2,44,24,20,52
Glenavon,5094,3,10,9,7,54,44,10,39
Linfield,5094,4,11,5,10,39,37,2,38
Cliftonville,5094,5,9,4,13,33,33,0,31
Ballymena,5094,6,7,4,15,26,50,-24,25
Glentoran,5094,7,6,6,10,24,32,-8,24
Dungannon,5094,8,2,4,16,14,47,-33,10
Coleraine,5095,1,15,10,1,45,23,22,55
Crusaders,5095,2,16,6,4,62,34,28,54
Glenavon,5095,3,9,9,8,53,45,8,36
Linfield,5095,4,10,5,11,38,38,0,35
Cliftonville,5095,5,10,4,12,34,32,2,34
Ballymena,5095,6,8,4,14,29,48,-19,28
Glentoran,5095,7,6,6,10,24,32,-8,24
Dungannon,5095,8,2,4,16,14,47,-33,10
Crusaders,5096,1,16,6,4,61,31,30,54
Coleraine,5096,2,14,10,2,44,24,20,52
Glenavon,5096,3,10,9,7,54,44,10,39
Linfield,5096,4,11,5,10,38,36,2,38
Cliftonville,5096,5,9,4,13,32,32,0,31
Ballymena,5096,6,8,4,14,26,47,-21,28
Glentoran,5096,7,6,6,10,24,32,-8,24
Dungannon,5096,8,2,4,16,14,47,-33,10
Crusaders,5097,1,17,6,3,63,31,32,57
Coleraine,5097,2,14,10,2,43,24,19,52
Glenavon,5097,3,10,9,7,54,43,11,39
Linfield,5097,4,10,6,10,38,37,1,36
Cliftonville,5097,5,9,5,12,33,32,1,32
Ballymena,5097,6,7,4,15,26,49,-23,25
Glentoran,5097,7,6,6,10,24,32,-8,24
Dungannon,5097,8,2,4,16,14,47,-33,10
Crusaders,5098,1,16,7,3,63,32,31,55
Coleraine,5098,2,14,10,2,44,24,20,52
Glenavon,5098,3,10,9,7,54,44,10,39
Linfield,5098,4,11,5,10,40,38,2,38
Cliftonville,5098,5,9,4,13,34,34,0,31
Ballymena,5098,6,7,5,14,27,49,-22,26
Glentoran,5098,7,6,6,10,24,32,-8,24
Dungannon,5098,8,2,4,16,14,47,-33,10
Crusaders,5099,1,17,6,3,65,31,34,57
Coleraine,5099,2,15,10,1,45,23,22,55
Linfield,5099,3,11,5,10,39,37,2,38
Glenavon,5099,4,9,9,8,53,45,8,36
Cliftonville,5099,5,9,4,13,33,33,0,31
Ballymena,5099,6,7,4,15,26,51,-25,25
Glentoran,5099,7,6,6,10,24,32,-8,24
Dungannon,5099,8,2,4,16,14,47,-33,10
Crusaders,5100,1,16,6,4,61,31,30,54
Coleraine,5100,2,14,10,2,46,27,19,52
Glenavon,5100,3,10,9,7,57,46,11,39
Linfield,5100,4,11,5,10,40,37,3,38
Cliftonville,5100,5,9,4,13,33,34,-1,31
Ballymena,5100,6,8,4,14,26,47,-21,28
Glentoran,5100,7,6,6,10,24,32,-8,24
Dungannon,5100,8,2,4,16,14,47,-33,10
Crusaders,5101,1,16,6,4,61,32,29,54
Coleraine,5101,2,14,10,2,43,23,20,52
Glenavon,5101,3,10,9,7,53,43,10,39
Linfield,5101,4,10,5,11,37,39,-2,35
Cliftonville,5101,5,10,4,12,35,31,4,34
Ballymena,5101,6,8,4,14,27,47,-20,28
Glentoran,5101,7,6,6,10,24,32,-8,24
Dungannon,5101,8,2,4,16,14,47,-33,10
Crusaders,5102,1,16,6,4,61,37,24,54
Coleraine,5102,2,14,10,2,45,25,20,52
Glenavon,5102,3,10,9,7,55,45,10,39
Linfield,5102,4,10,6,10,37,36,1,36
Cliftonville,5102,5,9,5,12,32,31,1,32
Ballymena,5102,6,8,4,14,32,47,-15,28
Glentoran,5102,7,6,6,10,24,32,-8,24
Dungannon,5102,8,2,4,16,14,47,-33,10
Crusaders,5103,1,16,7,3,61,30,31,55
Coleraine,5103,2,15,10,1,45,22,23,55
Glenavon,5103,3,9,9,8,52,45,7,36
Linfield,5103,4,10,6,10,38,37,1,36
Cliftonville,5103,5,9,5,12,33,32,1,32
Ballymena,5103,6,7,5,14,25,47,-22,26
Glentoran,5103,7,6,6,10,24,32,-8,24
Dungannon,5103,8,2,4,16,14,47,-33,10
Crusaders,5104,1,16,6,4,63,35,28,54
Coleraine,5104,2,14,10,2,43,24,19,52
Glenavon,5104,3,10,9,7,54,43,11,39
Linfield,5104,4,10,6,10,40,39,1,36
Cliftonville,5104,5,9,5,12,35,34,1,32
Ballymena,5104,6,8,4,14,30,49,-19,28
Glentoran,5104,7,6,6,10,24,32,-8,24
Dungannon,5104,8,2,4,16,14,47,-33,10
Crusaders,5105,1,16,6,4,61,32,29,54
Coleraine,5105,2,14,10,2,44,25,19,52
Glenavon,5105,3,10,9,7,55,44,11,39
Linfield,5105,4,11,5,10,39,36,3,38
Cliftonville,5105,5,9,4,13,32,33,-1,31
Ballymena,5105,6,8,4,14,27,47,-20,28
Glentoran,5105,7,6,6,10,24,32,-8,24
Dungannon,5105,8,2,4,16,14,47,-33,10
Crusaders,5106,1,17,6,3,62,30,32,57
Coleraine,5106,2,14,10,2,45,25,20,52
Glenavon,5106,3,10,9,7,55,45,10,39
Linfield,5106,4,11,5,10,38,36,2,38
Cliftonville,5106,5,9,4,13,32,32,0,31
Ballymena,5106,6,7,4,15,25,48,-23,25
Glentoran,5106,7,6,6,10,24,32,-8,24
Dungannon,5106,8,2,4,16,14,47,-33,10
Crusaders,5107,1,17,6,3,63,31,32,57
Coleraine,5107,2,14,10,2,44,26,18,52
Glenavon,5107,3,10,9,7,56,44,12,39
Linfield,5107,4,10,5,11,37,39,-2,35
Cliftonville,5107,5,10,4,12,35,31,4,34
Ballymena,5107,6,7,4,15,26,49,-23,25
Glentoran,5107,7,6,6,10,24,32,-8,24
Dungannon,5107,8,2,4,16,14,47,-33,10
Crusaders,5108,1,17,6,3,65,30,35,57
Coleraine,5108,2,14,10,2,44,24,20,52
Glenavon,5108,3,10,9,7,54,44,10,39
Linfield,5108,4,10,5,11,37,37,0,35
Cliftonville,5108,5,10,4,12,33,31,2,34
Ballymena,5108,6,7,4,15,25,51,-26,25
Glentoran,5108,7,6,6,10,24,32,-8,24
Dungannon,5108,8,2,4,16,14,47,-33,10
Crusaders,5109,1,16,7,3,62,31,31,55
Coleraine,5109,2,15,10,1,45,22,23,55
Linfield,5109,3,11,5,10,38,36,2,38
Glenavon,5109,4,9,9,8,52,45,7,36
Cliftonville,5109,5,9,4,13,32,32,0,31
Ballymena,5109,6,7,5,14,26,48,-22,26
Glentoran,5109,7,6,6,10,24,32,-8,24
Dungannon,5109,8,2,4,16,14,47,-33,10
Crusaders,5110,1,16,7,3,62,31,31,55
Coleraine,5110,2,15,10,1,46,23,23,55
Linfield,5110,3,11,5,10,39,37,2,38
Glenavon,5110,4,9,9,8,53,46,7,36
Cliftonville,5110,5,9,4,13,33,33,0,31
Ballymena,5110,6,7,5,14,26,48,-22,26
Glentoran,5110,7,6,6,10,24,32,-8,24
Dungannon,5110,8,2,4,16,14,47,-33,10
Crusaders,5111,1,17,6,3,64,31,33,57
Coleraine,5111,2,14,11,1,44,23,21,53
Glenavon,5111,3,9,10,7,53,44,9,37
Linfield,5111,4,10,5,11,37,38,-1,35
Cliftonville,5111,5,10,4,12,34,31,3,34
Ballymena,5111,6,7,4,15,26,50,-24,25
Glentoran,5111,7,6,6,10,24,32,-8,24
Dungannon,5111,8,2,4,16,14,47,-33,10
Crusaders,5112,1,17,6,3,64,31,33,57
Coleraine,5112,2,14,10,2,44,24,20,52
Glenavon,5112,3,10,9,7,54,44,10,39
Linfield,5112,4,11,5,10,41,37,4,38
Cliftonville,5112,5,9,4,13,33,35,-2,31
Ballymena,5112,6,7,4,15,26,50,-24,25
Glentoran,5112,7,6,6,10,24,32,-8,24
Dungannon,5112,8,2,4,16,14,47,-33,10
Crusaders,5113,1,17,6,3,63,31,32,57
Coleraine,5113,2,15,10,1,47,25,22,55
Linfield,5113,3,11,5,10,40,38,2,38
Glenavon,5113,4,9,9,8,55,47,8,36
Cliftonville,5113,5,9,4,13,34,34,0,31
Ballymena,5113,6,7,4,15,26,49,-23,25
Glentoran,5113,7,6,6,10,24,32,-8,24
Dungannon,5113,8,2,4,16,14,47,-33,10
Crusaders,5114,1,17,6,3,62,30,32,57
Coleraine,5114,2,14,10,2,44,24,20,52
Glenavon,5114,3,10,9,7,54,44,10,39
Linfield,5114,4,10,5,11,37,37,0,35
Cliftonville,5114,5,10,4,12,33,31,2,34
Ballymena,5114,6,7,4,15,25,48,-23,25
Glentoran,5114,7,6,6,10,24,32,-8,24
Dungannon,5114,8,2,4,16,14,47,-33,10
Crusaders,5115,1,16,7,3,61,30,31,55
Coleraine,5115,2,14,10,2,43,24,19,52
Glenavon,5115,3,10,9,7,54,43,11,39
Linfield,5115,4,10,6,10,39,38,1,36
Cliftonville,5115,5,9,5,12,34,33,1,32
Ballymena,5115,6,7,5,14,25,47,-22,26
Glentoran,5115,7,6,6,10,24,32,-8,24
Dungannon,5115,8,2,4,16,14,47,-33,10
Crusaders,5116,1,16,7,3,63,32,31,55
Coleraine,5116,2,14,11,1,46,25,21,53
Linfield,5116,3,11,5,10,39,37,2,38
Glenavon,5116,4,9,10,7,55,46,9,37
Cliftonville,5116,5,9,4,13,33,33,0,31
Ballymena,5116,6,7,5,14,27,49,-22,26
Glentoran,5116,7,6,6,10,24,32,-8,24
Dungannon,5116,8,2,4,16,14,47,-33,10
Crusaders,5117,1,17,6,3,64,32,32,57
Coleraine,5117,2,14,10,2,43,23,20,52
Glenavon,5117,3,10,9,7,53,43,10,39
Linfield,5117,4,10,5,11,37,38,-1,35
Cliftonville,5117,5,10,4,12,34,31,3,34
Ballymena,5117,6,7,4,15,27,50,-23,25
Glentoran,5117,7,6,6,10,24,32,-8,24
Dungannon,5117,8,2,4,16,14,47,-33,10
Crusaders,5118,1,16,7,3,62,31,31,55
Coleraine,5118,2,15,10,1,46,23,23,55
Glenavon,5118,3,9,9,8,53,46,7,36
Linfield,5118,4,10,5,11,37,38,-1,35
Cliftonville,5118,5,10,4,12,34,31,3,34
Ballymena,5118,6,7,5,14,26,48,-22,26
Glentoran,5118,7,6,6,10,24,32,-8,24
Dungannon,5118,8,2,4,16,14,47,-33,10
Crusaders,5119,1,17,6,3,64,31,33,57
Coleraine,5119,2,14,10,2,43,23,20,52
Glenavon,5119,3,10,9,7,53,43,10,39
Linfield,5119,4,10,6,10,39,38,1,36
Cliftonville,5119,5,9,5,12,34,33,1,32
Ballymena,5119,6,7,4,15,26,50,-24,25
Glentoran,5119,7,6,6,10,24,32,-8,24
Dungannon,5119,8,2,4,16,14,47,-33,10
Coleraine,5120,1,15,10,1,47,25,22,55
Crusaders,5120,2,16,6,4,62,33,29,54
Linfield,5120,3,11,5,10,39,36,3,38
Glenavon,5120,4,9,9,8,55,47,8,36
Cliftonville,5120,5,9,4,13,32,33,-1,31
Ballymena,5120,6,8,4,14,28,48,-20,28
Glentoran,5120,7,6,6,10,24,32,-8,24
Dungannon,5120,8,2,4,16,14,47,-33,10
Crusaders,5121,1,16,6,4,62,32,30,54
Coleraine,5121,2,14,11,1,44,23,21,53
Glenavon,5121,3,9,10,7,53,44,9,37
Linfield,5121,4,10,5,11,37,37,0,35
Cliftonville,5121,5,10,4,12,33,31,2,34
Ballymena,5121,6,8,4,14,27,48,-21,28
Glentoran,5121,7,6,6,10,24,32,-8,24
Dungannon,5121,8,2,4,16,14,47,-33,10
Crusaders,5122,1,17,6,3,65,30,35,57
Coleraine,5122,2,15,10,1,47,24,23,55
Glenavon,5122,3,9,9,8,54,47,7,36
Linfield,5122,4,10,6,10,39,38,1,36
Cliftonville,5122,5,9,5,12,34,33,1,32
Ballymena,5122,6,7,4,15,25,51,-26,25
Glentoran,5122,7,6,6,10,24,32,-8,24
Dungannon,5122,8,2,4,16,14,47,-33,10
Crusaders,5123,1,17,6,3,64,32,32,57
Coleraine,5123,2,15,10,1,45,23,22,55
Glenavon,5123,3,9,9,8,53,45,8,36
Linfield,5123,4,10,6,10,38,37,1,36
Cliftonville,5123,5,9,5,12,33,32,1,32
Ballymena,5123,6,7,4,15,27,50,-23,25
Glentoran,5123,7,6,6,10,24,32,-8,24
Dungannon,5123,8,2,4,16,14,47,-33,10
Crusaders,5124,1,16,7,3,62,31,31,55
Coleraine,5124,2,14,11,1,46,25,21,53
Glenavon,5124,3,9,10,7,55,46,9,37
Linfield,5124,4,10,5,11,38,38,0,35
Cliftonville,5124,5,10,4,12,34,32,2,34
Ballymena,5124,6,7,5,14,26,48,-22,26
Glentoran,5124,7,6,6,10,24,32,-8,24
Dungannon,5124,8,2,4,16,14,47,-33,10
Crusaders,5125,1,17,6,3,62,30,32,57
Coleraine,5125,2,14,11,1,44,23,21,53
Glenavon,5125,3,9,10,7,53,44,9,37
Linfield,5125,4,10,5,11,38,40,-2,35
Cliftonville,5125,5,10,4,12,36,32,4,34
Ballymena,5125,6,7,4,15,25,48,-23,25
Glentoran,5125,7,6,6,10,24,32,-8,24
Dungannon,5125,8,2,4,16,14,47,-33,10
Crusaders,5126,1,16,7,3,65,34,31,55
Coleraine,5126,2,14,10,2,45,26,19,52
Glenavon,5126,3,10,9,7,56,45,11,39
Linfield,5126,4,10,6,10,37,36,1,36
Cliftonville,5126,5,9,5,12,32,31,1,32
Ballymena,5126,6,7,5,14,29,51,-22,26
Glentoran,5126,7,6,6,10,24,32,-8,24
Dungannon,5126,8,2,4,16,14,47,-33,10
Crusaders,5127,1,17,6,3,63,30,33,57
Coleraine,5127,2,15,10,1,44,22,22,55
Glenavon,5127,3,9,9,8,52,44,8,36
Linfield,5127,4,10,6,10,38,37,1,36
Cliftonville,5127,5,9,5,12,33,32,1,32
Ballymena,5127,6,7,4,15,25,49,-24,25
Glentoran,5127,7,6,6,10,24,32,-8,24
Dungannon,5127,8,2,4,16,14,47,-33,10
Crusaders,5128,1,16,6,4,61,33,28,54
Coleraine,5128,2,14,10,2,43,26,17,52
Glenavon,5128,3,10,9,7,56,43,13,39
Linfield,5128,4,11,5,10,38,36,2,38
Cliftonville,5128,5,9,4,13,32,32,0,31
Ballymena,5128,6,8,4,14,28,47,-19,28
Glentoran,5128,7,6,6,10,24,32,-8,24
Dungannon,5128,8,2,4,16,14,47,-33,10
Crusaders,5129,1,17,6,3,65,30,35,57
Coleraine,5129,2,14,10,2,43,24,19,52
Glenavon,5129,3,10,9,7,54,43,11,39
Linfield,5129,4,10,6,10,37,36,1,36
Cliftonville,5129,5,9,5,12,32,31,1,32
Ballymena,5129,6,7,4,15,25,51,-26,25
Glentoran,5129,7,6,6,10,24,32,-8,24
Dungannon,5129,8,2,4,16,14,47,-33,10
Crusaders,5130,1,16,7,3,62,31,31,55
Coleraine,5130,2,14,11,1,44,23,21,53
Linfield,5130,3,11,5,10,38,36,2,38
Glenavon,5130,4,9,10,7,53,44,9,37
Cliftonville,5130,5,9,4,13,32,32,0,31
Ballymena,5130,6,7,5,14,26,48,-22,26
Glentoran,5130,7,6,6,10,24,32,-8,24
Dungannon,5130,8,2,4,16,14,47,-33,10
Crusaders,5131,1,16,7,3,63,32,31,55
Coleraine,5131,2,14,11,1,44,23,21,53
Glenavon,5131,3,9,10,7,53,44,9,37
Linfield,5131,4,10,6,10,39,38,1,36
Cliftonville,5131,5,9,5,12,34,33,1,32
Ballymena,5131,6,7,5,14,27,49,-22,26
Glentoran,5131,7,6,6,10,24,32,-8,24
Dungannon,5131,8,2,4,16,14,47,-33,10
Crusaders,5132,1,16,6,4,62,32,30,54
Coleraine,5132,2,14,10,2,46,27,19,52
Glenavon,5132,3,10,9,7,57,46,11,39
Linfield,5132,4,10,5,11,37,38,-1,35
Cliftonville,5132,5,10,4,12,34,31,3,34
Ballymena,5132,6,8,4,14,27,48,-21,28
Glentoran,5132,7,6,6,10,24,32,-8,24
Dungannon,5132,8,2,4,16,14,47,-33,10
Crusaders,5133,1,17,6,3,63,31,32,57
Coleraine,5133,2,14,10,2,44,27,17,52
Glenavon,5133,3,10,9,7,57,44,13,39
Linfield,5133,4,10,6,10,38,37,1,36
Cliftonville,5133,5,9,5,12,33,32,1,32
Ballymena,5133,6,7,4,15,26,49,-23,25
Glentoran,5133,7,6,6,10,24,32,-8,24
Dungannon,5133,8,2,4,16,14,47,-33,10
Crusaders,5134,1,16,7,3,62,31,31,55
Coleraine,5134,2,14,10,2,44,25,19,52
Glenavon,5134,3,10,9,7,55,44,11,39
Linfield,5134,4,11,5,10,39,36,3,38
Cliftonville,5134,5,9,4,13,32,33,-1,31
Ballymena,5134,6,7,5,14,26,48,-22,26
Glentoran,5134,7,6,6,10,24,32,-8,24
Dungannon,5134,8,2,4,16,14,47,-33,10
Crusaders,5135,1,17,6,3,63,31,32,57
Coleraine,5135,2,14,10,2,44,24,20,52
Glenavon,5135,3,10,9,7,54,44,10,39
Linfield,5135,4,10,5,11,37,37,0,35
Cliftonville,5135,5,10,4,12,33,31,2,34
Ballymena,5135,6,7,4,15,26,49,-23,25
Glentoran,5135,7,6,6,10,24,32,-8,24
Dungannon,5135,8,2,4,16,14,47,-33,10
Crusaders,5136,1,17,6,3,63,30,33,57
Coleraine,5136,2,14,10,2,44,26,18,52
Glenavon,5136,3,10,9,7,56,44,12,39
Linfield,5136,4,10,5,11,37,38,-1,35
Cliftonville,5136,5,10,4,12,34,31,3,34
Ballymena,5136,6,7,4,15,25,49,-24,25
Glentoran,5136,7,6,6,10,24,32,-8,24
Dungannon,5136,8,2,4,16,14,47,-33,10
Crusaders,5137,1,17,6,3,62,30,32,57
Coleraine,5137,2,14,10,2,43,25,18,52
Glenavon,5137,3,10,9,7,55,43,12,39
Linfield,5137,4,10,6,10,39,38,1,36
Cliftonville,5137,5,9,5,12,34,33,1,32
Ballymena,5137,6,7,4,15,25,48,-23,25
Glentoran,5137,7,6,6,10,24,32,-8,24
Dungannon,5137,8,2,4,16,14,47,-33,10
Crusaders,5138,1,16,7,3,64,33,31,55
Coleraine,5138,2,14,10,2,44,24,20,52
Glenavon,5138,3,10,9,7,54,44,10,39
Linfield,5138,4,10,6,10,38,37,1,36
Cliftonville,5138,5,9,5,12,33,32,1,32
Ballymena,5138,6,7,5,14,28,50,-22,26
Glentoran,5138,7,6,6,10,24,32,-8,24
Dungannon,5138,8,2,4,16,14,47,-33,10
Crusaders,5139,1,17,6,3,63,30,33,57
Coleraine,5139,2,14,10,2,44,24,20,52
Glenavon,5139,3,10,9,7,54,44,10,39
Linfield,5139,4,11,5,10,38,36,2,38
Cliftonville,5139,5,9,4,13,32,32,0,31
Ballymena,5139,6,7,4,15,25,49,-24,25
Glentoran,5139,7,6,6,10,24,32,-8,24
Dungannon,5139,8,2,4,16,14,47,-33,10
Crusaders,5140,1,16,6,4,62,33,29,54
Coleraine,5140,2,14,10,2,44,25,19,52
Glenavon,5140,3,10,9,7,55,44,11,39
Linfield,5140,4,11,5,10,39,37,2,38
Cliftonville,5140,5,9,4,13,33,33,0,31
Ballymena,5140,6,8,4,14,28,48,-20,28
Glentoran,5140,7,6,6,10,24,32,-8,24
Dungannon,5140,8,2,4,16,14,47,-33,10
Coleraine,5141,1,15,10,1,46,22,24,55
Crusaders,5141,2,16,6,4,62,33,29,54
Linfield,5141,3,11,5,10,38,36,2,38
Glenavon,5141,4,9,9,8,52,46,6,36
Cliftonville,5141,5,9,4,13,32,32,0,31
Ballymena,5141,6,8,4,14,28,48,-20,28
Glentoran,5141,7,6,6,10,24,32,-8,24
Dungannon,5141,8,2,4,16,14,47,-33,10
Crusaders,5142,1,16,7,3,62,31,31,55
Coleraine,5142,2,14,11,1,45,24,21,53
Linfield,5142,3,11,5,10,38,36,2,38
Glenavon,5142,4,9,10,7,54,45,9,37
Cliftonville,5142,5,9,4,13,32,32,0,31
Ballymena,5142,6,7,5,14,26,48,-22,26
Glentoran,5142,7,6,6,10,24,32,-8,24
Dungannon,5142,8,2,4,16,14,47,-33,10
Crusaders,5143,1,16,6,4,63,33,30,54
Coleraine,5143,2,14,11,1,43,22,21,53
Linfield,5143,3,11,5,10,40,36,4,38
Glenavon,5143,4,9,10,7,52,43,9,37
Cliftonville,5143,5,9,4,13,32,34,-2,31
Ballymena,5143,6,8,4,14,28,49,-21,28
Glentoran,5143,7,6,6,10,24,32,-8,24
Dungannon,5143,8,2,4,16,14,47,-33,10
Crusaders,5144,1,17,6,3,64,32,32,57
Coleraine,5144,2,15,10,1,47,23,24,55
Linfield,5144,3,11,5,10,38,36,2,38
Glenavon,5144,4,9,9,8,53,47,6,36
Cliftonville,5144,5,9,4,13,32,32,0,31
Ballymena,5144,6,7,4,15,27,50,-23,25
Glentoran,5144,7,6,6,10,24,32,-8,24
Dungannon,5144,8,2,4,16,14,47,-33,10
Crusaders,5145,1,17,6,3,64,30,34,57
Coleraine,5145,2,15,10,1,47,22,25,55
Glenavon,5145,3,9,9,8,52,47,5,36
Linfield,5145,4,10,5,11,37,38,-1,35
Cliftonville,5145,5,10,4,12,34,31,3,34
Ballymena,5145,6,7,4,15,25,50,-25,25
Glentoran,5145,7,6,6,10,24,32,-8,24
Dungannon,5145,8,2,4,16,14,47,-33,10
Crusaders,5146,1,17,6,3,62,30,32,57
Coleraine,5146,2,14,11,1,44,23,21,53
Glenavon,5146,3,9,10,7,53,44,9,37
Linfield,5146,4,10,5,11,38,39,-1,35
Cliftonville,5146,5,10,4,12,35,32,3,34
Ballymena,5146,6,7,4,15,25,48,-23,25
Glentoran,5146,7,6,6,10,24,32,-8,24
Dungannon,5146,8,2,4,16,14,47,-33,10
Crusaders,5147,1,16,7,3,63,32,31,55
Coleraine,5147,2,15,10,1,44,22,22,55
Linfield,5147,3,11,5,10,40,36,4,38
Glenavon,5147,4,9,9,8,52,44,8,36
Cliftonville,5147,5,9,4,13,32,34,-2,31
Ballymena,5147,6,7,5,14,27,49,-22,26
Glentoran,5147,7,6,6,10,24,32,-8,24
Dungannon,5147,8,2,4,16,14,47,-33,10
Crusaders,5148,1,17,6,3,63,31,32,57
Coleraine,5148,2,14,11,1,44,23,21,53
Linfield,5148,3,11,5,10,38,36,2,38
Glenavon,5148,4,9,10,7,53,44,9,37
Cliftonville,5148,5,9,4,13,32,32,0,31
Ballymena,5148,6,7,4,15,26,49,-23,25
Glentoran,5148,7,6,6,10,24,32,-8,24
Dungannon,5148,8,2,4,16,14,47,-33,10
Crusaders,5149,1,17,6,3,62,30,32,57
Coleraine,5149,2,14,11,1,44,23,21,53
Linfield,5149,3,11,5,10,41,36,5,38
Glenavon,5149,4,9,10,7,53,44,9,37
Cliftonville,5149,5,9,4,13,32,35,-3,31
Ballymena,5149,6,7,4,15,25,48,-23,25
Glentoran,5149,7,6,6,10,24,32,-8,24
Dungannon,5149,8,2,4,16,14,47,-33,10
Crusaders,5150,1,17,6,3,63,31,32,57
Coleraine,5150,2,14,10,2,45,25,20,52
Glenavon,5150,3,10,9,7,55,45,10,39
Linfield,5150,4,10,6,10,39,38,1,36
Cliftonville,5150,5,9,5,12,34,33,1,32
Ballymena,5150,6,7,4,15,26,49,-23,25
Glentoran,5150,7,6,6,10,24,32,-8,24
Dungannon,5150,8,2,4,16,14,47,-33,10
Crusaders,5151,1,16,7,3,61,30,31,55
Coleraine,5151,2,15,10,1,45,23,22,55
Linfield,5151,3,11,5,10,39,36,3,38
Glenavon,5151,4,9,9,8,53,45,8,36
Cliftonville,5151,5,9,4,13,32,33,-1,31
Ballymena,5151,6,7,5,14,25,47,-22,26
Glentoran,5151,7,6,6,10,24,32,-8,24
Dungannon,5151,8,2,4,16,14,47,-33,10
Crusaders,5152,1,17,6,3,64,32,32,57
Coleraine,5152,2,14,11,1,44,23,21,53
Glenavon,5152,3,9,10,7,53,44,9,37
Linfield,5152,4,10,5,11,37,37,0,35
Cliftonville,5152,5,10,4,12,33,31,2,34
Ballymena,5152,6,7,4,15,27,50,-23,25
Glentoran,5152,7,6,6,10,24,32,-8,24
Dungannon,5152,8,2,4,16,14,47,-33,10
Crusaders,5153,1,17,6,3,63,31,32,57
Coleraine,5153,2,14,11,1,44,23,21,53
Linfield,5153,3,11,5,10,41,37,4,38
Glenavon,5153,4,9,10,7,53,44,9,37
Cliftonville,5153,5,9,4,13,33,35,-2,31
Ballymena,5153,6,7,4,15,26,49,-23,25
Glentoran,5153,7,6,6,10,24,32,-8,24
Dungannon,5153,8,2,4,16,14,47,-33,10
Crusaders,5154,1,17,6,3,63,31,32,57
Coleraine,5154,2,14,11,1,45,24,21,53
Linfield,5154,3,11,5,10,40,37,3,38
Glenavon,5154,4,9,10,7,54,45,9,37
Cliftonville,5154,5,9,4,13,33,34,-1,31
Ballymena,5154,6,7,4,15,26,49,-23,25
Glentoran,5154,7,6,6,10,24,32,-8,24
Dungannon,5154,8,2,4,16,14,47,-33,10
Crusaders,5155,1,16,7,3,64,33,31,55
Coleraine,5155,2,14,10,2,44,24,20,52
Glenavon,5155,3,10,9,7,54,44,10,39
Linfield,5155,4,11,5,10,39,36,3,38
Cliftonville,5155,5,9,4,13,32,33,-1,31
Ballymena,5155,6,7,5,14,28,50,-22,26
Glentoran,5155,7,6,6,10,24,32,-8,24
Dungannon,5155,8,2,4,16,14,47,-33,10
Crusaders,5156,1,16,6,4,62,33,29,54
Coleraine,5156,2,14,10,2,43,25,18,52
Glenavon,5156,3,10,9,7,55,43,12,39
Linfield,5156,4,10,6,10,38,37,1,36
Cliftonville,5156,5,9,5,12,33,32,1,32
Ballymena,5156,6,8,4,14,28,48,-20,28
Glentoran,5156,7,6,6,10,24,32,-8,24
Dungannon,5156,8,2,4,16,14,47,-33,10
Crusaders,5157,1,16,6,4,62,32,30,54
Coleraine,5157,2,14,11,1,44,23,21,53
Glenavon,5157,3,9,10,7,53,44,9,37
Linfield,5157,4,10,6,10,38,37,1,36
Cliftonville,5157,5,9,5,12,33,32,1,32
Ballymena,5157,6,8,4,14,27,48,-21,28
Glentoran,5157,7,6,6,10,24,32,-8,24
Dungannon,5157,8,2,4,16,14,47,-33,10
Crusaders,5158,1,17,6,3,64,31,33,57
Coleraine,5158,2,15,10,1,44,22,22,55
Linfield,5158,3,11,5,10,41,38,3,38
Glenavon,5158,4,9,9,8,52,44,8,36
Cliftonville,5158,5,9,4,13,34,35,-1,31
Ballymena,5158,6,7,4,15,26,50,-24,25
Glentoran,5158,7,6,6,10,24,32,-8,24
Dungannon,5158,8,2,4,16,14,47,-33,10
Crusaders,5159,1,17,6,3,63,30,33,57
Coleraine,5159,2,14,10,2,46,26,20,52
Glenavon,5159,3,10,9,7,56,46,10,39
Linfield,5159,4,11,5,10,38,36,2,38
Cliftonville,5159,5,9,4,13,32,32,0,31
Ballymena,5159,6,7,4,15,25,49,-24,25
Glentoran,5159,7,6,6,10,24,32,-8,24
Dungannon,5159,8,2,4,16,14,47,-33,10
Crusaders,5160,1,16,7,3,62,31,31,55
Coleraine,5160,2,14,10,2,44,25,19,52
Glenavon,5160,3,10,9,7,55,44,11,39
Linfield,5160,4,10,5,11,39,39,0,35
Cliftonville,5160,5,10,4,12,35,33,2,34
Ballymena,5160,6,7,5,14,26,48,-22,26
Glentoran,5160,7,6,6,10,24,32,-8,24
Dungannon,5160,8,2,4,16,14,47,-33,10
Crusaders,5161,1,17,6,3,63,31,32,57
Coleraine,5161,2,14,10,2,44,24,20,52
Glenavon,5161,3,10,9,7,54,44,10,39
Linfield,5161,4,11,5,10,41,38,3,38
Cliftonville,5161,5,9,4,13,34,35,-1,31
Ballymena,5161,6,7,4,15,26,49,-23,25
Glentoran,5161,7,6,6,10,24,32,-8,24
Dungannon,5161,8,2,4,16,14,47,-33,10
Crusaders,5162,1,17,6,3,64,32,32,57
Coleraine,5162,2,15,10,1,45,22,23,55
Glenavon,5162,3,9,9,8,52,45,7,36
Linfield,5162,4,10,5,11,37,38,-1,35
Cliftonville,5162,5,10,4,12,34,31,3,34
Ballymena,5162,6,7,4,15,27,50,-23,25
Glentoran,5162,7,6,6,10,24,32,-8,24
Dungannon,5162,8,2,4,16,14,47,-33,10
Crusaders,5163,1,17,6,3,63,30,33,57
Coleraine,5163,2,14,10,2,43,24,19,52
Glenavon,5163,3,10,9,7,54,43,11,39
Linfield,5163,4,10,6,10,39,38,1,36
Cliftonville,5163,5,9,5,12,34,33,1,32
Ballymena,5163,6,7,4,15,25,49,-24,25
Glentoran,5163,7,6,6,10,24,32,-8,24
Dungannon,5163,8,2,4,16,14,47,-33,10
Crusaders,5164,1,16,6,4,62,32,30,54
Coleraine,5164,2,14,11,1,44,23,21,53
Glenavon,5164,3,9,10,7,53,44,9,37
Linfield,5164,4,10,5,11,38,38,0,35
Cliftonville,5164,5,10,4,12,34,32,2,34
Ballymena,5164,6,8,4,14,27,48,-21,28
Glentoran,5164,7,6,6,10,24,32,-8,24
Dungannon,5164,8,2,4,16,14,47,-33,10
Crusaders,5165,1,17,6,3,62,30,32,57
Coleraine,5165,2,14,10,2,45,25,20,52
Glenavon,5165,3,10,9,7,55,45,10,39
Linfield,5165,4,10,6,10,37,36,1,36
Cliftonville,5165,5,9,5,12,32,31,1,32
Ballymena,5165,6,7,4,15,25,48,-23,25
Glentoran,5165,7,6,6,10,24,32,-8,24
Dungannon,5165,8,2,4,16,14,47,-33,10
Crusaders,5166,1,17,6,3,63,30,33,57
Coleraine,5166,2,14,11,1,44,23,21,53
Glenavon,5166,3,9,10,7,53,44,9,37
Linfield,5166,4,10,5,11,37,39,-2,35
Cliftonville,5166,5,10,4,12,35,31,4,34
Ballymena,5166,6,7,4,15,25,49,-24,25
Glentoran,5166,7,6,6,10,24,32,-8,24
Dungannon,5166,8,2,4,16,14,47,-33,10
Crusaders,5167,1,17,6,3,63,31,32,57
Coleraine,5167,2,15,10,1,46,23,23,55
Glenavon,5167,3,9,9,8,53,46,7,36
Linfield,5167,4,10,5,11,39,39,0,35
Cliftonville,5167,5,10,4,12,35,33,2,34
Ballymena,5167,6,7,4,15,26,49,-23,25
Glentoran,5167,7,6,6,10,24,32,-8,24
Dungannon,5167,8,2,4,16,14,47,-33,10
Crusaders,5168,1,16,7,3,65,34,31,55
Coleraine,5168,2,15,10,1,44,22,22,55
Glenavon,5168,3,9,9,8,52,44,8,36
Linfield,5168,4,10,6,10,37,36,1,36
Cliftonville,5168,5,9,5,12,32,31,1,32
Ballymena,5168,6,7,5,14,29,51,-22,26
Glentoran,5168,7,6,6,10,24,32,-8,24
Dungannon,5168,8,2,4,16,14,47,-33,10
Crusaders,5169,1,17,6,3,64,31,33,57
Coleraine,5169,2,15,10,1,45,22,23,55
Glenavon,5169,3,9,9,8,52,45,7,36
Linfield,5169,4,10,6,10,38,37,1,36
Cliftonville,5169,5,9,5,12,33,32,1,32
Ballymena,5169,6,7,4,15,26,50,-24,25
Glentoran,5169,7,6,6,10,24,32,-8,24
Dungannon,5169,8,2,4,16,14,47,-33,10
Crusaders,5170,1,17,6,3,66,30,36,57
Coleraine,5170,2,15,10,1,44,22,22,55
Linfield,5170,3,11,5,10,39,37,2,38
Glenavon,5170,4,9,9,8,52,44,8,36
Cliftonville,5170,5,9,4,13,33,33,0,31
Ballymena,5170,6,7,4,15,25,52,-27,25
Glentoran,5170,7,6,6,10,24,32,-8,24
Dungannon,5170,8,2,4,16,14,47,-33,10
Crusaders,5171,1,16,7,3,62,31,31,55
Coleraine,5171,2,15,10,1,47,25,22,55
Glenavon,5171,3,9,9,8,55,47,8,36
Linfield,5171,4,10,6,10,38,37,1,36
Cliftonville,5171,5,9,5,12,33,32,1,32
Ballymena,5171,6,7,5,14,26,48,-22,26
Glentoran,5171,7,6,6,10,24,32,-8,24
Dungannon,5171,8,2,4,16,14,47,-33,10
Crusaders,5172,1,16,7,3,62,31,31,55
Coleraine,5172,2,15,10,1,45,23,22,55
Glenavon,5172,3,9,9,8,53,45,8,36
Linfield,5172,4,10,6,10,37,36,1,36
Cliftonville,5172,5,9,5,12,32,31,1,32
Ballymena,5172,6,7,5,14,26,48,-22,26
Glentoran,5172,7,6,6,10,24,32,-8,24
Dungannon,5172,8,2,4,16,14,47,-33,10
Crusaders,5173,1,16,6,4,63,34,29,54
Coleraine,5173,2,14,10,2,44,24,20,52
Glenavon,5173,3,10,9,7,54,44,10,39
Linfield,5173,4,10,5,11,37,37,0,35
Cliftonville,5173,5,10,4,12,33,31,2,34
Ballymena,5173,6,8,4,14,29,49,-20,28
Glentoran,5173,7,6,6,10,24,32,-8,24
Dungannon,5173,8,2,4,16,14,47,-33,10
Crusaders,5174,1,17,6,3,64,31,33,57
Coleraine,5174,2,15,10,1,47,24,23,55
Linfield,5174,3,11,5,10,39,37,2,38
Glenavon,5174,4,9,9,8,54,47,7,36
Cliftonville,5174,5,9,4,13,33,33,0,31
Ballymena,5174,6,7,4,15,26,50,-24,25
Glentoran,5174,7,6,6,10,24,32,-8,24
Dungannon,5174,8,2,4,16,14,47,-33,10
Crusaders,5175,1,17,6,3,62,30,32,57
Coleraine,5175,2,15,10,1,46,23,23,55
Glenavon,5175,3,9,9,8,53,46,7,36
Linfield,5175,4,10,6,10,38,37,1,36
Cliftonville,5175,5,9,5,12,33,32,1,32
Ballymena,5175,6,7,4,15,25,48,-23,25
Glentoran,5175,7,6,6,10,24,32,-8,24
Dungannon,5175,8,2,4,16,14,47,-33,10
Crusaders,5176,1,16,6,4,61,31,30,54
Coleraine,5176,2,14,10,2,43,23,20,52
Glenavon,5176,3,10,9,7,53,43,10,39
Linfield,5176,4,10,5,11,37,38,-1,35
Cliftonville,5176,5,10,4,12,34,31,3,34
Ballymena,5176,6,8,4,14,26,47,-21,28
Glentoran,5176,7,6,6,10,24,32,-8,24
Dungannon,5176,8,2,4,16,14,47,-33,10
Crusaders,5177,1,16,7,3,62,31,31,55
Coleraine,5177,2,14,10,2,43,25,18,52
Glenavon,5177,3,10,9,7,55,43,12,39
Linfield,5177,4,10,5,11,37,39,-2,35
Cliftonville,5177,5,10,4,12,35,31,4,34
Ballymena,5177,6,7,5,14,26,48,-22,26
Glentoran,5177,7,6,6,10,24,32,-8,24
Dungannon,5177,8,2,4,16,14,47,-33,10
Coleraine,5178,1,15,10,1,45,23,22,55
Crusaders,5178,2,16,6,4,61,33,28,54
Linfield,5178,3,11,5,10,41,39,2,38
Glenavon,5178,4,9,9,8,53,45,8,36
Cliftonville,5178,5,9,4,13,35,35,0,31
Ballymena,5178,6,8,4,14,28,47,-19,28
Glentoran,5178,7,6,6,10,24,32,-8,24
Dungannon,5178,8,2,4,16,14,47,-33,10
Crusaders,5179,1,17,6,3,63,31,32,57
Coleraine,5179,2,15,10,1,45,23,22,55
Glenavon,5179,3,9,9,8,53,45,8,36
Linfield,5179,4,10,5,11,37,37,0,35
Cliftonville,5179,5,10,4,12,33,31,2,34
Ballymena,5179,6,7,4,15,26,49,-23,25
Glentoran,5179,7,6,6,10,24,32,-8,24
Dungannon,5179,8,2,4,16,14,47,-33,10
Coleraine,5180,1,15,10,1,45,23,22,55
Crusaders,5180,2,16,6,4,62,32,30,54
Linfield,5180,3,11,5,10,39,36,3,38
Glenavon,5180,4,9,9,8,53,45,8,36
Cliftonville,5180,5,9,4,13,32,33,-1,31
Ballymena,5180,6,8,4,14,27,48,-21,28
Glentoran,5180,7,6,6,10,24,32,-8,24
Dungannon,5180,8,2,4,16,14,47,-33,10
Crusaders,5181,1,16,6,4,63,35,28,54
Coleraine,5181,2,14,10,2,43,24,19,52
Glenavon,5181,3,10,9,7,54,43,11,39
Linfield,5181,4,10,6,10,38,37,1,36
Cliftonville,5181,5,9,5,12,33,32,1,32
Ballymena,5181,6,8,4,14,30,49,-19,28
Glentoran,5181,7,6,6,10,24,32,-8,24
Dungannon,5181,8,2,4,16,14,47,-33,10
Crusaders,5182,1,16,6,4,61,31,30,54
Coleraine,5182,2,14,11,1,45,24,21,53
Glenavon,5182,3,9,10,7,54,45,9,37
Linfield,5182,4,10,5,11,38,38,0,35
Cliftonville,5182,5,10,4,12,34,32,2,34
Ballymena,5182,6,8,4,14,26,47,-21,28
Glentoran,5182,7,6,6,10,24,32,-8,24
Dungannon,5182,8,2,4,16,14,47,-33,10
Crusaders,5183,1,16,7,3,63,32,31,55
Coleraine,5183,2,14,11,1,46,25,21,53
Linfield,5183,3,11,5,10,39,36,3,38
Glenavon,5183,4,9,10,7,55,46,9,37
Cliftonville,5183,5,9,4,13,32,33,-1,31
Ballymena,5183,6,7,5,14,27,49,-22,26
Glentoran,5183,7,6,6,10,24,32,-8,24
Dungannon,5183,8,2,4,16,14,47,-33,10
Coleraine,5184,1,15,10,1,46,23,23,55
Crusaders,5184,2,16,6,4,63,33,30,54
Linfield,5184,3,11,5,10,39,37,2,38
Glenavon,5184,4,9,9,8,53,46,7,36
Cliftonville,5184,5,9,4,13,33,33,0,31
Ballymena,5184,6,8,4,14,28,49,-21,28
Glentoran,5184,7,6,6,10,24,32,-8,24
Dungannon,5184,8,2,4,16,14,47,-33,10
Crusaders,5185,1,17,6,3,65,31,34,57
Coleraine,5185,2,14,10,2,46,26,20,52
Glenavon,5185,3,10,9,7,56,46,10,39
Linfield,5185,4,11,5,10,39,36,3,38
Cliftonville,5185,5,9,4,13,32,33,-1,31
Ballymena,5185,6,7,4,15,26,51,-25,25
Glentoran,5185,7,6,6,10,24,32,-8,24
Dungannon,5185,8,2,4,16,14,47,-33,10
Crusaders,5186,1,17,6,3,63,30,33,57
Coleraine,5186,2,14,11,1,44,23,21,53
Glenavon,5186,3,9,10,7,53,44,9,37
Linfield,5186,4,10,5,11,37,37,0,35
Cliftonville,5186,5,10,4,12,33,31,2,34
Ballymena,5186,6,7,4,15,25,49,-24,25
Glentoran,5186,7,6,6,10,24,32,-8,24
Dungannon,5186,8,2,4,16,14,47,-33,10
Crusaders,5187,1,17,6,3,66,32,34,57
Coleraine,5187,2,14,11,1,45,24,21,53
Linfield,5187,3,11,5,10,42,37,5,38
Glenavon,5187,4,9,10,7,54,45,9,37
Cliftonville,5187,5,9,4,13,33,36,-3,31
Ballymena,5187,6,7,4,15,27,52,-25,25
Glentoran,5187,7,6,6,10,24,32,-8,24
Dungannon,5187,8,2,4,16,14,47,-33,10
Coleraine,5188,1,15,10,1,45,23,22,55
Crusaders,5188,2,16,6,4,62,32,30,54
Glenavon,5188,3,9,9,8,53,45,8,36
Linfield,5188,4,10,6,10,38,37,1,36
Cliftonville,5188,5,9,5,12,33,32,1,32
Ballymena,5188,6,8,4,14,27,48,-21,28
Glentoran,5188,7,6,6,10,24,32,-8,24
Dungannon,5188,8,2,4,16,14,47,-33,10
Coleraine,5189,1,15,10,1,45,23,22,55
Crusaders,5189,2,16,6,4,62,32,30,54
Linfield,5189,3,11,5,10,40,37,3,38
Glenavon,5189,4,9,9,8,53,45,8,36
Cliftonville,5189,5,9,4,13,33,34,-1,31
Ballymena,5189,6,8,4,14,27,48,-21,28
Glentoran,5189,7,6,6,10,24,32,-8,24
Dungannon,5189,8,2,4,16,14,47,-33,10
Crusaders,5190,1,17,6,3,63,30,33,57
Coleraine,5190,2,15,10,1,44,22,22,55
Glenavon,5190,3,9,9,8,52,44,8,36
Linfield,5190,4,10,6,10,38,37,1,36
Cliftonville,5190,5,9,5,12,33,32,1,32
Ballymena,5190,6,7,4,15,25,49,-24,25
Glentoran,5190,7,6,6,10,24,32,-8,24
Dungannon,5190,8,2,4,16,14,47,-33,10
Crusaders,5191,1,16,7,3,61,30,31,55
Coleraine,5191,2,14,10,2,43,23,20,52
Glenavon,5191,3,10,9,7,53,43,10,39
Linfield,5191,4,10,6,10,37,36,1,36
Cliftonville,5191,5,9,5,12,32,31,1,32
Ballymena,5191,6,7,5,14,25,47,-22,26
Glentoran,5191,7,6,6,10,24,32,-8,24
Dungannon,5191,8,2,4,16,14,47,-33,10
Crusaders,5192,1,16,7,3,64,33,31,55
Coleraine,5192,2,15,10,1,44,22,22,55
Glenavon,5192,3,9,9,8,52,44,8,36
Linfield,5192,4,10,6,10,37,36,1,36
Cliftonville,5192,5,9,5,12,32,31,1,32
Ballymena,5192,6,7,5,14,28,50,-22,26
Glentoran,5192,7,6,6,10,24,32,-8,24
Dungannon,5192,8,2,4,16,14,47,-33,10
Crusaders,5193,1,17,6,3,66,32,34,57
Coleraine,5193,2,15,10,1,45,23,22,55
Linfield,5193,3,11,5,10,38,36,2,38
Glenavon,5193,4,9,9,8,53,45,8,36
Cliftonville,5193,5,9,4,13,32,32,0,31
Ballymena,5193,6,7,4,15,27,52,-25,25
Glentoran,5193,7,6,6,10,24,32,-8,24
Dungannon,5193,8,2,4,16,14,47,-33,10
Crusaders,5194,1,16,6,4,61,31,30,54
Coleraine,5194,2,14,10,2,45,26,19,52
Glenavon,5194,3,10,9,7,56,45,11,39
Linfield,5194,4,11,5,10,40,37,3,38
Cliftonville,5194,5,9,4,13,33,34,-1,31
Ballymena,5194,6,8,4,14,26,47,-21,28
Glentoran,5194,7,6,6,10,24,32,-8,24
Dungannon,5194,8,2,4,16,14,47,-33,10
Crusaders,5195,1,17,6,3,63,31,32,57
Coleraine,5195,2,14,10,2,43,24,19,52
Glenavon,5195,3,10,9,7,54,43,11,39
Linfield,5195,4,10,6,10,39,38,1,36
Cliftonville,5195,5,9,5,12,34,33,1,32
Ballymena,5195,6,7,4,15,26,49,-23,25
Glentoran,5195,7,6,6,10,24,32,-8,24
Dungannon,5195,8,2,4,16,14,47,-33,10
Crusaders,5196,1,17,6,3,64,31,33,57
Coleraine,5196,2,14,10,2,44,26,18,52
Glenavon,5196,3,10,9,7,56,44,12,39
Linfield,5196,4,11,5,10,39,36,3,38
Cliftonville,5196,5,9,4,13,32,33,-1,31
Ballymena,5196,6,7,4,15,26,50,-24,25
Glentoran,5196,7,6,6,10,24,32,-8,24
Dungannon,5196,8,2,4,16,14,47,-33,10
Crusaders,5197,1,16,6,4,61,31,30,54
Coleraine,5197,2,14,11,1,45,24,21,53
Glenavon,5197,3,9,10,7,54,45,9,37
Linfield,5197,4,10,5,11,39,39,0,35
Cliftonville,5197,5,10,4,12,35,33,2,34
Ballymena,5197,6,8,4,14,26,47,-21,28
Glentoran,5197,7,6,6,10,24,32,-8,24
Dungannon,5197,8,2,4,16,14,47,-33,10
Crusaders,5198,1,17,6,3,63,30,33,57
Coleraine,5198,2,14,10,2,43,24,19,52
Glenavon,5198,3,10,9,7,54,43,11,39
Linfield,5198,4,11,5,10,39,36,3,38
Cliftonville,5198,5,9,4,13,32,33,-1,31
Ballymena,5198,6,7,4,15,25,49,-24,25
Glentoran,5198,7,6,6,10,24,32,-8,24
Dungannon,5198,8,2,4,16,14,47,-33,10
Crusaders,5199,1,17,6,3,63,31,32,57
Coleraine,5199,2,14,10,2,44,26,18,52
Glenavon,5199,3,10,9,7,56,44,12,39
Linfield,5199,4,10,5,11,37,38,-1,35
Cliftonville,5199,5,10,4,12,34,31,3,34
Ballymena,5199,6,7,4,15,26,49,-23,25
Glentoran,5199,7,6,6,10,24,32,-8,24
Dungannon,5199,8,2,4,16,14,47,-33,10
Crusaders,5200,1,17,6,3,63,31,32,57
Coleraine,5200,2,14,10,2,43,25,18,52
Glenavon,5200,3,10,9,7,55,43,12,39
Linfield,5200,4,10,6,10,38,37,1,36
Cliftonville,5200,5,9,5,12,33,32,1,32
Ballymena,5200,6,7,4,15,26,49,-23,25
Glentoran,5200,7,6,6,10,24,32,-8,24
Dungannon,5200,8,2,4,16,14,47,-33,10
Crusaders,5201,1,17,6,3,66,32,34,57
Coleraine,5201,2,14,11,1,44,23,21,53
Linfield,5201,3,11,5,10,39,37,2,38
Glenavon,5201,4,9,10,7,53,44,9,37
Cliftonville,5201,5,9,4,13,33,33,0,31
Ballymena,5201,6,7,4,15,27,52,-25,25
Glentoran,5201,7,6,6,10,24,32,-8,24
Dungannon,5201,8,2,4,16,14,47,-33,10
Crusaders,5202,1,17,6,3,64,31,33,57
Coleraine,5202,2,14,10,2,45,27,18,52
Glenavon,5202,3,10,9,7,57,45,12,39
Linfield,5202,4,10,6,10,39,38,1,36
Cliftonville,5202,5,9,5,12,34,33,1,32
Ballymena,5202,6,7,4,15,26,50,-24,25
Glentoran,5202,7,6,6,10,24,32,-8,24
Dungannon,5202,8,2,4,16,14,47,-33,10
Crusaders,5203,1,17,6,3,63,31,32,57
Coleraine,5203,2,14,11,1,44,23,21,53
Linfield,5203,3,11,5,10,40,38,2,38
Glenavon,5203,4,9,10,7,53,44,9,37
Cliftonville,5203,5,9,4,13,34,34,0,31
Ballymena,5203,6,7,4,15,26,49,-23,25
Glentoran,5203,7,6,6,10,24,32,-8,24
Dungannon,5203,8,2,4,16,14,47,-33,10
Crusaders,5204,1,17,6,3,63,30,33,57
Coleraine,5204,2,14,11,1,43,22,21,53
Glenavon,5204,3,9,10,7,52,43,9,37
Linfield,5204,4,10,6,10,39,38,1,36
Cliftonville,5204,5,9,5,12,34,33,1,32
Ballymena,5204,6,7,4,15,25,49,-24,25
Glentoran,5204,7,6,6,10,24,32,-8,24
Dungannon,5204,8,2,4,16,14,47,-33,10
Crusaders,5205,1,16,6,4,63,34,29,54
Coleraine,5205,2,14,10,2,44,25,19,52
Glenavon,5205,3,10,9,7,55,44,11,39
Linfield,5205,4,11,5,10,40,36,4,38
Cliftonville,5205,5,9,4,13,32,34,-2,31
Ballymena,5205,6,8,4,14,29,49,-20,28
Glentoran,5205,7,6,6,10,24,32,-8,24
Dungannon,5205,8,2,4,16,14,47,-33,10
Crusaders,5206,1,16,7,3,64,33,31,55
Coleraine,5206,2,14,10,2,45,25,20,52
Glenavon,5206,3,10,9,7,55,45,10,39
Linfield,5206,4,11,5,10,38,36,2,38
Cliftonville,5206,5,9,4,13,32,32,0,31
Ballymena,5206,6,7,5,14,28,50,-22,26
Glentoran,5206,7,6,6,10,24,32,-8,24
Dungannon,5206,8,2,4,16,14,47,-33,10
Coleraine,5207,1,15,10,1,46,24,22,55
Crusaders,5207,2,16,6,4,63,33,30,54
Glenavon,5207,3,9,9,8,54,46,8,36
Linfield,5207,4,10,5,11,37,38,-1,35
Cliftonville,5207,5,10,4,12,34,31,3,34
Ballymena,5207,6,8,4,14,28,49,-21,28
Glentoran,5207,7,6,6,10,24,32,-8,24
Dungannon,5207,8,2,4,16,14,47,-33,10
Crusaders,5208,1,17,6,3,65,32,33,57
Coleraine,5208,2,14,10,2,44,24,20,52
Glenavon,5208,3,10,9,7,54,44,10,39
Linfield,5208,4,11,5,10,41,36,5,38
Cliftonville,5208,5,9,4,13,32,35,-3,31
Ballymena,5208,6,7,4,15,27,51,-24,25
Glentoran,5208,7,6,6,10,24,32,-8,24
Dungannon,5208,8,2,4,16,14,47,-33,10
Crusaders,5209,1,17,6,3,62,30,32,57
Coleraine,5209,2,14,10,2,44,24,20,52
Glenavon,5209,3,10,9,7,54,44,10,39
Linfield,5209,4,11,5,10,40,37,3,38
Cliftonville,5209,5,9,4,13,33,34,-1,31
Ballymena,5209,6,7,4,15,25,48,-23,25
Glentoran,5209,7,6,6,10,24,32,-8,24
Dungannon,5209,8,2,4,16,14,47,-33,10
Crusaders,5210,1,16,6,4,63,33,30,54
Coleraine,5210,2,14,10,2,44,24,20,52
Glenavon,5210,3,10,9,7,54,44,10,39
Linfield,5210,4,11,5,10,38,36,2,38
Cliftonville,5210,5,9,4,13,32,32,0,31
Ballymena,5210,6,8,4,14,28,49,-21,28
Glentoran,5210,7,6,6,10,24,32,-8,24
Dungannon,5210,8,2,4,16,14,47,-33,10
Crusaders,5211,1,16,7,3,61,30,31,55
Coleraine,5211,2,14,10,2,43,25,18,52
Glenavon,5211,3,10,9,7,55,43,12,39
Linfield,5211,4,10,5,11,38,38,0,35
Cliftonville,5211,5,10,4,12,34,32,2,34
Ballymena,5211,6,7,5,14,25,47,-22,26
Glentoran,5211,7,6,6,10,24,32,-8,24
Dungannon,5211,8,2,4,16,14,47,-33,10
Crusaders,5212,1,17,6,3,62,30,32,57
Coleraine,5212,2,15,10,1,46,24,22,55
Glenavon,5212,3,9,9,8,54,46,8,36
Linfield,5212,4,10,5,11,37,37,0,35
Cliftonville,5212,5,10,4,12,33,31,2,34
Ballymena,5212,6,7,4,15,25,48,-23,25
Glentoran,5212,7,6,6,10,24,32,-8,24
Dungannon,5212,8,2,4,16,14,47,-33,10
Crusaders,5213,1,17,6,3,64,31,33,57
Coleraine,5213,2,14,10,2,43,26,17,52
Glenavon,5213,3,10,9,7,56,43,13,39
Linfield,5213,4,10,5,11,37,37,0,35
Cliftonville,5213,5,10,4,12,33,31,2,34
Ballymena,5213,6,7,4,15,26,50,-24,25
Glentoran,5213,7,6,6,10,24,32,-8,24
Dungannon,5213,8,2,4,16,14,47,-33,10
Crusaders,5214,1,17,6,3,66,31,35,57
Coleraine,5214,2,14,11,1,44,23,21,53
Glenavon,5214,3,9,10,7,53,44,9,37
Linfield,5214,4,10,6,10,37,36,1,36
Cliftonville,5214,5,9,5,12,32,31,1,32
Ballymena,5214,6,7,4,15,26,52,-26,25
Glentoran,5214,7,6,6,10,24,32,-8,24
Dungannon,5214,8,2,4,16,14,47,-33,10
Crusaders,5215,1,16,6,4,62,32,30,54
Coleraine,5215,2,14,10,2,45,25,20,52
Glenavon,5215,3,10,9,7,55,45,10,39
Linfield,5215,4,10,6,10,39,38,1,36
Cliftonville,5215,5,9,5,12,34,33,1,32
Ballymena,5215,6,8,4,14,27,48,-21,28
Glentoran,5215,7,6,6,10,24,32,-8,24
Dungannon,5215,8,2,4,16,14,47,-33,10
Crusaders,5216,1,17,6,3,62,30,32,57
Coleraine,5216,2,15,10,1,46,23,23,55
Linfield,5216,3,11,5,10,39,37,2,38
Glenavon,5216,4,9,9,8,53,46,7,36
Cliftonville,5216,5,9,4,13,33,33,0,31
Ballymena,5216,6,7,4,15,25,48,-23,25
Glentoran,5216,7,6,6,10,24,32,-8,24
Dungannon,5216,8,2,4,16,14,47,-33,10
Crusaders,5217,1,17,6,3,63,31,32,57
Coleraine,5217,2,14,11,1,45,24,21,53
Glenavon,5217,3,9,10,7,54,45,9,37
Linfield,5217,4,10,6,10,38,37,1,36
Cliftonville,5217,5,9,5,12,33,32,1,32
Ballymena,5217,6,7,4,15,26,49,-23,25
Glentoran,5217,7,6,6,10,24,32,-8,24
Dungannon,5217,8,2,4,16,14,47,-33,10
Crusaders,5218,1,17,6,3,63,30,33,57
Coleraine,5218,2,15,10,1,45,23,22,55
Linfield,5218,3,11,5,10,39,37,2,38
Glenavon,5218,4,9,9,8,53,45,8,36
Cliftonville,5218,5,9,4,13,33,33,0,31
Ballymena,5218,6,7,4,15,25,49,-24,25
Glentoran,5218,7,6,6,10,24,32,-8,24
Dungannon,5218,8,2,4,16,14,47,-33,10
Crusaders,5219,1,16,7,3,62,31,31,55
Coleraine,5219,2,15,10,1,45,22,23,55
Glenavon,5219,3,9,9,8,52,45,7,36
Linfield,5219,4,10,5,11,37,38,-1,35
Cliftonville,5219,5,10,4,12,34,31,3,34
Ballymena,5219,6,7,5,14,26,48,-22,26
Glentoran,5219,7,6,6,10,24,32,-8,24
Dungannon,5219,8,2,4,16,14,47,-33,10
Crusaders,5220,1,16,7,3,62,31,31,55
Coleraine,5220,2,14,11,1,45,24,21,53
Glenavon,5220,3,9,10,7,54,45,9,37
Linfield,5220,4,10,5,11,37,37,0,35
Cliftonville,5220,5,10,4,12,33,31,2,34
Ballymena,5220,6,7,5,14,26,48,-22,26
Glentoran,5220,7,6,6,10,24,32,-8,24
Dungannon,5220,8,2,4,16,14,47,-33,10
Crusaders,5221,1,17,6,3,64,30,34,57
Coleraine,5221,2,15,10,1,49,23,26,55
Linfield,5221,3,11,5,10,38,36,2,38
Glenavon,5221,4,9,9,8,53,49,4,36
Cliftonville,5221,5,9,4,13,32,32,0,31
Ballymena,5221,6,7,4,15,25,50,-25,25
Glentoran,5221,7,6,6,10,24,32,-8,24
Dungannon,5221,8,2,4,16,14,47,-33,10
Crusaders,5222,1,17,6,3,63,30,33,57
Coleraine,5222,2,15,10,1,46,22,24,55
Linfield,5222,3,11,5,10,39,37,2,38
Glenavon,5222,4,9,9,8,52,46,6,36
Cliftonville,5222,5,9,4,13,33,33,0,31
Ballymena,5222,6,7,4,15,25,49,-24,25
Glentoran,5222,7,6,6,10,24,32,-8,24
Dungannon,5222,8,2,4,16,14,47,-33,10
Crusaders,5223,1,16,6,4,63,33,30,54
Coleraine,5223,2,14,10,2,43,24,19,52
Glenavon,5223,3,10,9,7,54,43,11,39
Linfield,5223,4,10,5,11,37,37,0,35
Cliftonville,5223,5,10,4,12,33,31,2,34
Ballymena,5223,6,8,4,14,28,49,-21,28
Glentoran,5223,7,6,6,10,24,32,-8,24
Dungannon,5223,8,2,4,16,14,47,-33,10
Crusaders,5224,1,17,6,3,65,31,34,57
Coleraine,5224,2,15,10,1,44,22,22,55
Linfield,5224,3,11,5,10,40,36,4,38
Glenavon,5224,4,9,9,8,52,44,8,36
Cliftonville,5224,5,9,4,13,32,34,-2,31
Ballymena,5224,6,7,4,15,26,51,-25,25
Glentoran,5224,7,6,6,10,24,32,-8,24
Dungannon,5224,8,2,4,16,14,47,-33,10
Crusaders,5225,1,16,7,3,61,30,31,55
Coleraine,5225,2,14,11,1,43,22,21,53
Linfield,5225,3,11,5,10,38,36,2,38
Glenavon,5225,4,9,10,7,52,43,9,37
Cliftonville,5225,5,9,4,13,32,32,0,31
Ballymena,5225,6,7,5,14,25,47,-22,26
Glentoran,5225,7,6,6,10,24,32,-8,24
Dungannon,5225,8,2,4,16,14,47,-33,10
Coleraine,5226,1,15,10,1,47,23,24,55
Crusaders,5226,2,16,6,4,62,33,29,54
Glenavon,5226,3,9,9,8,53,47,6,36
Linfield,5226,4,10,5,11,38,38,0,35
Cliftonville,5226,5,10,4,12,34,32,2,34
Ballymena,5226,6,8,4,14,28,48,-20,28
Glentoran,5226,7,6,6,10,24,32,-8,24
Dungannon,5226,8,2,4,16,14,47,-33,10
Crusaders,5227,1,16,7,3,62,31,31,55
Coleraine,5227,2,14,10,2,43,25,18,52
Glenavon,5227,3,10,9,7,55,43,12,39
Linfield,5227,4,11,5,10,42,36,6,38
Cliftonville,5227,5,9,4,13,32,36,-4,31
Ballymena,5227,6,7,5,14,26,48,-22,26
Glentoran,5227,7,6,6,10,24,32,-8,24
Dungannon,5227,8,2,4,16,14,47,-33,10
Crusaders,5228,1,16,6,4,62,32,30,54
Coleraine,5228,2,14,10,2,45,25,20,52
Glenavon,5228,3,10,9,7,55,45,10,39
Linfield,5228,4,10,6,10,38,37,1,36
Cliftonville,5228,5,9,5,12,33,32,1,32
Ballymena,5228,6,8,4,14,27,48,-21,28
Glentoran,5228,7,6,6,10,24,32,-8,24
Dungannon,5228,8,2,4,16,14,47,-33,10
Crusaders,5229,1,16,6,4,62,33,29,54
Coleraine,5229,2,14,10,2,45,27,18,52
Glenavon,5229,3,10,9,7,57,45,12,39
Linfield,5229,4,11,5,10,39,36,3,38
Cliftonville,5229,5,9,4,13,32,33,-1,31
Ballymena,5229,6,8,4,14,28,48,-20,28
Glentoran,5229,7,6,6,10,24,32,-8,24
Dungannon,5229,8,2,4,16,14,47,-33,10
Crusaders,5230,1,16,7,3,62,31,31,55
Coleraine,5230,2,14,10,2,44,24,20,52
Glenavon,5230,3,10,9,7,54,44,10,39
Linfield,5230,4,10,6,10,38,37,1,36
Cliftonville,5230,5,9,5,12,33,32,1,32
Ballymena,5230,6,7,5,14,26,48,-22,26
Glentoran,5230,7,6,6,10,24,32,-8,24
Dungannon,5230,8,2,4,16,14,47,-33,10
Crusaders,5231,1,16,7,3,63,32,31,55
Coleraine,5231,2,14,10,2,43,26,17,52
Glenavon,5231,3,10,9,7,56,43,13,39
Linfield,5231,4,10,5,11,38,38,0,35
Cliftonville,5231,5,10,4,12,34,32,2,34
Ballymena,5231,6,7,5,14,27,49,-22,26
Glentoran,5231,7,6,6,10,24,32,-8,24
Dungannon,5231,8,2,4,16,14,47,-33,10
Crusaders,5232,1,17,6,3,63,31,32,57
Coleraine,5232,2,15,10,1,44,22,22,55
Linfield,5232,3,11,5,10,39,37,2,38
Glenavon,5232,4,9,9,8,52,44,8,36
Cliftonville,5232,5,9,4,13,33,33,0,31
Ballymena,5232,6,7,4,15,26,49,-23,25
Glentoran,5232,7,6,6,10,24,32,-8,24
Dungannon,5232,8,2,4,16,14,47,-33,10
Crusaders,5233,1,16,7,3,61,30,31,55
Coleraine,5233,2,14,11,1,45,24,21,53
Glenavon,5233,3,9,10,7,54,45,9,37
Linfield,5233,4,10,5,11,38,38,0,35
Cliftonville,5233,5,10,4,12,34,32,2,34
Ballymena,5233,6,7,5,14,25,47,-22,26
Glentoran,5233,7,6,6,10,24,32,-8,24
Dungannon,5233,8,2,4,16,14,47,-33,10
Crusaders,5234,1,16,7,3,62,31,31,55
Coleraine,5234,2,15,10,1,44,22,22,55
Linfield,5234,3,11,5,10,38,36,2,38
Glenavon,5234,4,9,9,8,52,44,8,36
Cliftonville,5234,5,9,4,13,32,32,0,31
Ballymena,5234,6,7,5,14,26,48,-22,26
Glentoran,5234,7,6,6,10,24,32,-8,24
Dungannon,5234,8,2,4,16,14,47,-33,10
Crusaders,5235,1,17,6,3,64,30,34,57
Coleraine,5235,2,14,10,2,43,23,20,52
Glenavon,5235,3,10,9,7,53,43,10,39
Linfield,5235,4,11,5,10,39,37,2,38
Cliftonville,5235,5,9,4,13,33,33,0,31
Ballymena,5235,6,7,4,15,25,50,-25,25
Glentoran,5235,7,6,6,10,24,32,-8,24
Dungannon,5235,8,2,4,16,14,47,-33,10
Crusaders,5236,1,17,6,3,66,32,34,57
Coleraine,5236,2,14,10,2,44,24,20,52
Glenavon,5236,3,10,9,7,54,44,10,39
Linfield,5236,4,11,5,10,39,36,3,38
Cliftonville,5236,5,9,4,13,32,33,-1,31
Ballymena,5236,6,7,4,15,27,52,-25,25
Glentoran,5236,7,6,6,10,24,32,-8,24
Dungannon,5236,8,2,4,16,14,47,-33,10
Crusaders,5237,1,17,6,3,64,31,33,57
Coleraine,5237,2,14,10,2,44,24,20,52
Glenavon,5237,3,10,9,7,54,44,10,39
Linfield,5237,4,10,6,10,37,36,1,36
Cliftonville,5237,5,9,5,12,32,31,1,32
Ballymena,5237,6,7,4,15,26,50,-24,25
Glentoran,5237,7,6,6,10,24,32,-8,24
Dungannon,5237,8,2,4,16,14,47,-33,10
Crusaders,5238,1,17,6,3,65,33,32,57
Coleraine,5238,2,15,10,1,46,23,23,55
Glenavon,5238,3,9,9,8,53,46,7,36
Linfield,5238,4,10,6,10,40,39,1,36
Cliftonville,5238,5,9,5,12,35,34,1,32
Ballymena,5238,6,7,4,15,28,51,-23,25
Glentoran,5238,7,6,6,10,24,32,-8,24
Dungannon,5238,8,2,4,16,14,47,-33,10
Crusaders,5239,1,17,6,3,65,30,35,57
Coleraine,5239,2,14,10,2,44,24,20,52
Glenavon,5239,3,10,9,7,54,44,10,39
Linfield,5239,4,10,6,10,38,37,1,36
Cliftonville,5239,5,9,5,12,33,32,1,32
Ballymena,5239,6,7,4,15,25,51,-26,25
Glentoran,5239,7,6,6,10,24,32,-8,24
Dungannon,5239,8,2,4,16,14,47,-33,10
Crusaders,5240,1,16,6,4,61,33,28,54
Coleraine,5240,2,14,10,2,44,26,18,52
Glenavon,5240,3,10,9,7,56,44,12,39
Linfield,5240,4,10,5,11,38,38,0,35
Cliftonville,5240,5,10,4,12,34,32,2,34
Ballymena,5240,6,8,4,14,28,47,-19,28
Glentoran,5240,7,6,6,10,24,32,-8,24
Dungannon,5240,8,2,4,16,14,47,-33,10
Crusaders,5241,1,17,6,3,64,32,32,57
Coleraine,5241,2,15,10,1,46,23,23,55
Glenavon,5241,3,9,9,8,53,46,7,36
Linfield,5241,4,10,5,11,38,38,0,35
Cliftonville,5241,5,10,4,12,34,32,2,34
Ballymena,5241,6,7,4,15,27,50,-23,25
Glentoran,5241,7,6,6,10,24,32,-8,24
Dungannon,5241,8,2,4,16,14,47,-33,10
Coleraine,5242,1,15,10,1,46,22,24,55
Crusaders,5242,2,16,6,4,62,33,29,54
Glenavon,5242,3,9,9,8,52,46,6,36
Linfield,5242,4,10,6,10,38,37,1,36
Cliftonville,5242,5,9,5,12,33,32,1,32
Ballymena,5242,6,8,4,14,28,48,-20,28
Glentoran,5242,7,6,6,10,24,32,-8,24
Dungannon,5242,8,2,4,16,14,47,-33,10
Coleraine,5243,1,15,10,1,46,24,22,55
Crusaders,5243,2,16,6,4,65,35,30,54
Linfield,5243,3,11,5,10,40,38,2,38
Glenavon,5243,4,9,9,8,54,46,8,36
Cliftonville,5243,5,9,4,13,34,34,0,31
Ballymena,5243,6,8,4,14,30,51,-21,28
Glentoran,5243,7,6,6,10,24,32,-8,24
Dungannon,5243,8,2,4,16,14,47,-33,10
Crusaders,5244,1,16,6,4,62,38,24,54
Coleraine,5244,2,14,10,2,43,23,20,52
Glenavon,5244,3,10,9,7,53,43,10,39
Linfield,5244,4,11,5,10,39,36,3,38
Cliftonville,5244,5,9,4,13,32,33,-1,31
Ballymena,5244,6,8,4,14,33,48,-15,28
Glentoran,5244,7,6,6,10,24,32,-8,24
Dungannon,5244,8,2,4,16,14,47,-33,10
Crusaders,5245,1,16,7,3,62,31,31,55
Coleraine,5245,2,14,10,2,44,25,19,52
Glenavon,5245,3,10,9,7,55,44,11,39
Linfield,5245,4,10,6,10,38,37,1,36
Cliftonville,5245,5,9,5,12,33,32,1,32
Ballymena,5245,6,7,5,14,26,48,-22,26
Glentoran,5245,7,6,6,10,24,32,-8,24
Dungannon,5245,8,2,4,16,14,47,-33,10
Crusaders,5246,1,17,6,3,63,31,32,57
Coleraine,5246,2,14,10,2,43,23,20,52
Glenavon,5246,3,10,9,7,53,43,10,39
Linfield,5246,4,10,6,10,38,37,1,36
Cliftonville,5246,5,9,5,12,33,32,1,32
Ballymena,5246,6,7,4,15,26,49,-23,25
Glentoran,5246,7,6,6,10,24,32,-8,24
Dungannon,5246,8,2,4,16,14,47,-33,10
Coleraine,5247,1,15,10,1,45,23,22,55
Crusaders,5247,2,16,6,4,61,32,29,54
Linfield,5247,3,11,5,10,42,38,4,38
Glenavon,5247,4,9,9,8,53,45,8,36
Cliftonville,5247,5,9,4,13,34,36,-2,31
Ballymena,5247,6,8,4,14,27,47,-20,28
Glentoran,5247,7,6,6,10,24,32,-8,24
Dungannon,5247,8,2,4,16,14,47,-33,10
Crusaders,5248,1,17,6,3,63,31,32,57
Coleraine,5248,2,15,10,1,46,22,24,55
Linfield,5248,3,11,5,10,40,36,4,38
Glenavon,5248,4,9,9,8,52,46,6,36
Cliftonville,5248,5,9,4,13,32,34,-2,31
Ballymena,5248,6,7,4,15,26,49,-23,25
Glentoran,5248,7,6,6,10,24,32,-8,24
Dungannon,5248,8,2,4,16,14,47,-33,10
Crusaders,5249,1,17,6,3,64,31,33,57
Coleraine,5249,2,14,11,1,45,24,21,53
Glenavon,5249,3,9,10,7,54,45,9,37
Linfield,5249,4,10,5,11,37,37,0,35
Cliftonville,5249,5,10,4,12,33,31,2,34
Ballymena,5249,6,7,4,15,26,50,-24,25
Glentoran,5249,7,6,6,10,24,32,-8,24
Dungannon,5249,8,2,4,16,14,47,-33,10
Crusaders,5250,1,17,6,3,65,32,33,57
Coleraine,5250,2,14,11,1,45,24,21,53
Linfield,5250,3,11,5,10,40,37,3,38
Glenavon,5250,4,9,10,7,54,45,9,37
Cliftonville,5250,5,9,4,13,33,34,-1,31
Ballymena,5250,6,7,4,15,27,51,-24,25
Glentoran,5250,7,6,6,10,24,32,-8,24
Dungannon,5250,8,2,4,16,14,47,-33,10
Crusaders,5251,1,17,6,3,62,30,32,57
Coleraine,5251,2,15,10,1,44,22,22,55
Linfield,5251,3,11,5,10,42,38,4,38
Glenavon,5251,4,9,9,8,52,44,8,36
Cliftonville,5251,5,9,4,13,34,36,-2,31
Ballymena,5251,6,7,4,15,25,48,-23,25
Glentoran,5251,7,6,6,10,24,32,-8,24
Dungannon,5251,8,2,4,16,14,47,-33,10
Crusaders,5252,1,16,7,3,62,31,31,55
Coleraine,5252,2,14,10,2,44,24,20,52
Glenavon,5252,3,10,9,7,54,44,10,39
Linfield,5252,4,10,6,10,39,38,1,36
Cliftonville,5252,5,9,5,12,34,33,1,32
Ballymena,5252,6,7,5,14,26,48,-22,26
Glentoran,5252,7,6,6,10,24,32,-8,24
Dungannon,5252,8,2,4,16,14,47,-33,10
Crusaders,5253,1,17,6,3,65,31,34,57
Coleraine,5253,2,15,10,1,47,24,23,55
Linfield,5253,3,11,5,10,41,37,4,38
Glenavon,5253,4,9,9,8,54,47,7,36
Cliftonville,5253,5,9,4,13,33,35,-2,31
Ballymena,5253,6,7,4,15,26,51,-25,25
Glentoran,5253,7,6,6,10,24,32,-8,24
Dungannon,5253,8,2,4,16,14,47,-33,10
Crusaders,5254,1,17,6,3,64,30,34,57
Coleraine,5254,2,15,10,1,46,23,23,55
Linfield,5254,3,11,5,10,38,36,2,38
Glenavon,5254,4,9,9,8,53,46,7,36
Cliftonville,5254,5,9,4,13,32,32,0,31
Ballymena,5254,6,7,4,15,25,50,-25,25
Glentoran,5254,7,6,6,10,24,32,-8,24
Dungannon,5254,8,2,4,16,14,47,-33,10
Crusaders,5255,1,17,6,3,64,32,32,57
Coleraine,5255,2,15,10,1,45,23,22,55
Glenavon,5255,3,9,9,8,53,45,8,36
Linfield,5255,4,10,6,10,38,37,1,36
Cliftonville,5255,5,9,5,12,33,32,1,32
Ballymena,5255,6,7,4,15,27,50,-23,25
Glentoran,5255,7,6,6,10,24,32,-8,24
Dungannon,5255,8,2,4,16,14,47,-33,10
Crusaders,5256,1,17,6,3,64,30,34,57
Coleraine,5256,2,14,10,2,43,26,17,52
Glenavon,5256,3,10,9,7,56,43,13,39
Linfield,5256,4,10,6,10,38,37,1,36
Cliftonville,5256,5,9,5,12,33,32,1,32
Ballymena,5256,6,7,4,15,25,50,-25,25
Glentoran,5256,7,6,6,10,24,32,-8,24
Dungannon,5256,8,2,4,16,14,47,-33,10
Crusaders,5257,1,16,7,3,62,31,31,55
Coleraine,5257,2,14,11,1,45,24,21,53
Linfield,5257,3,11,5,10,39,36,3,38
Glenavon,5257,4,9,10,7,54,45,9,37
Cliftonville,5257,5,9,4,13,32,33,-1,31
Ballymena,5257,6,7,5,14,26,48,-22,26
Glentoran,5257,7,6,6,10,24,32,-8,24
Dungannon,5257,8,2,4,16,14,47,-33,10
Crusaders,5258,1,17,6,3,62,30,32,57
Coleraine,5258,2,15,10,1,45,22,23,55
Linfield,5258,3,11,5,10,40,37,3,38
Glenavon,5258,4,9,9,8,52,45,7,36
Cliftonville,5258,5,9,4,13,33,34,-1,31
Ballymena,5258,6,7,4,15,25,48,-23,25
Glentoran,5258,7,6,6,10,24,32,-8,24
Dungannon,5258,8,2,4,16,14,47,-33,10
Crusaders,5259,1,17,6,3,63,31,32,57
Coleraine,5259,2,14,11,1,45,24,21,53
Glenavon,5259,3,9,10,7,54,45,9,37
Linfield,5259,4,10,5,11,37,37,0,35
Cliftonville,5259,5,10,4,12,33,31,2,34
Ballymena,5259,6,7,4,15,26,49,-23,25
Glentoran,5259,7,6,6,10,24,32,-8,24
Dungannon,5259,8,2,4,16,14,47,-33,10
Crusaders,5260,1,17,6,3,64,32,32,57
Coleraine,5260,2,14,11,1,45,24,21,53
Glenavon,5260,3,9,10,7,54,45,9,37
Linfield,5260,4,10,5,11,37,37,0,35
Cliftonville,5260,5,10,4,12,33,31,2,34
Ballymena,5260,6,7,4,15,27,50,-23,25
Glentoran,5260,7,6,6,10,24,32,-8,24
Dungannon,5260,8,2,4,16,14,47,-33,10
Crusaders,5261,1,17,6,3,63,31,32,57
Coleraine,5261,2,14,11,1,44,23,21,53
Linfield,5261,3,11,5,10,40,36,4,38
Glenavon,5261,4,9,10,7,53,44,9,37
Cliftonville,5261,5,9,4,13,32,34,-2,31
Ballymena,5261,6,7,4,15,26,49,-23,25
Glentoran,5261,7,6,6,10,24,32,-8,24
Dungannon,5261,8,2,4,16,14,47,-33,10
Crusaders,5262,1,17,6,3,62,30,32,57
Coleraine,5262,2,14,10,2,45,25,20,52
Glenavon,5262,3,10,9,7,55,45,10,39
Linfield,5262,4,11,5,10,39,36,3,38
Cliftonville,5262,5,9,4,13,32,33,-1,31
Ballymena,5262,6,7,4,15,25,48,-23,25
Glentoran,5262,7,6,6,10,24,32,-8,24
Dungannon,5262,8,2,4,16,14,47,-33,10
Crusaders,5263,1,17,6,3,64,32,32,57
Coleraine,5263,2,14,10,2,43,24,19,52
Glenavon,5263,3,10,9,7,54,43,11,39
Linfield,5263,4,11,5,10,40,38,2,38
Cliftonville,5263,5,9,4,13,34,34,0,31
Ballymena,5263,6,7,4,15,27,50,-23,25
Glentoran,5263,7,6,6,10,24,32,-8,24
Dungannon,5263,8,2,4,16,14,47,-33,10
Crusaders,5264,1,17,6,3,63,31,32,57
Coleraine,5264,2,14,10,2,43,23,20,52
Glenavon,5264,3,10,9,7,53,43,10,39
Linfield,5264,4,10,5,11,37,37,0,35
Cliftonville,5264,5,10,4,12,33,31,2,34
Ballymena,5264,6,7,4,15,26,49,-23,25
Glentoran,5264,7,6,6,10,24,32,-8,24
Dungannon,5264,8,2,4,16,14,47,-33,10
Crusaders,5265,1,16,7,3,62,31,31,55
Coleraine,5265,2,15,10,1,45,23,22,55
Glenavon,5265,3,9,9,8,53,45,8,36
Linfield,5265,4,10,6,10,38,37,1,36
Cliftonville,5265,5,9,5,12,33,32,1,32
Ballymena,5265,6,7,5,14,26,48,-22,26
Glentoran,5265,7,6,6,10,24,32,-8,24
Dungannon,5265,8,2,4,16,14,47,-33,10
Crusaders,5266,1,17,6,3,64,31,33,57
Coleraine,5266,2,14,10,2,44,24,20,52
Glenavon,5266,3,10,9,7,54,44,10,39
Linfield,5266,4,11,5,10,38,36,2,38
Cliftonville,5266,5,9,4,13,32,32,0,31
Ballymena,5266,6,7,4,15,26,50,-24,25
Glentoran,5266,7,6,6,10,24,32,-8,24
Dungannon,5266,8,2,4,16,14,47,-33,10
Crusaders,5267,1,16,6,4,62,34,28,54
Coleraine,5267,2,14,10,2,44,25,19,52
Glenavon,5267,3,10,9,7,55,44,11,39
Linfield,5267,4,10,6,10,37,36,1,36
Cliftonville,5267,5,9,5,12,32,31,1,32
Ballymena,5267,6,8,4,14,29,48,-19,28
Glentoran,5267,7,6,6,10,24,32,-8,24
Dungannon,5267,8,2,4,16,14,47,-33,10
Crusaders,5268,1,16,6,4,63,33,30,54
Coleraine,5268,2,14,11,1,44,23,21,53
Linfield,5268,3,11,5,10,39,36,3,38
Glenavon,5268,4,9,10,7,53,44,9,37
Cliftonville,5268,5,9,4,13,32,33,-1,31
Ballymena,5268,6,8,4,14,28,49,-21,28
Glentoran,5268,7,6,6,10,24,32,-8,24
Dungannon,5268,8,2,4,16,14,47,-33,10
Crusaders,5269,1,17,6,3,64,31,33,57
Coleraine,5269,2,14,10,2,44,25,19,52
Glenavon,5269,3,10,9,7,55,44,11,39
Linfield,5269,4,11,5,10,39,36,3,38
Cliftonville,5269,5,9,4,13,32,33,-1,31
Ballymena,5269,6,7,4,15,26,50,-24,25
Glentoran,5269,7,6,6,10,24,32,-8,24
Dungannon,5269,8,2,4,16,14,47,-33,10
Coleraine,5270,1,15,10,1,45,22,23,55
Crusaders,5270,2,16,6,4,62,32,30,54
Glenavon,5270,3,9,9,8,52,45,7,36
Linfield,5270,4,10,5,11,37,38,-1,35
Cliftonville,5270,5,10,4,12,34,31,3,34
Ballymena,5270,6,8,4,14,27,48,-21,28
Glentoran,5270,7,6,6,10,24,32,-8,24
Dungannon,5270,8,2,4,16,14,47,-33,10
Crusaders,5271,1,17,6,3,63,30,33,57
Coleraine,5271,2,15,10,1,45,22,23,55
Glenavon,5271,3,9,9,8,52,45,7,36
Linfield,5271,4,10,6,10,38,37,1,36
Cliftonville,5271,5,9,5,12,33,32,1,32
Ballymena,5271,6,7,4,15,25,49,-24,25
Glentoran,5271,7,6,6,10,24,32,-8,24
Dungannon,5271,8,2,4,16,14,47,-33,10
Crusaders,5272,1,16,7,3,62,31,31,55
Coleraine,5272,2,14,10,2,44,24,20,52
Glenavon,5272,3,10,9,7,54,44,10,39
Linfield,5272,4,11,5,10,39,36,3,38
Cliftonville,5272,5,9,4,13,32,33,-1,31
Ballymena,5272,6,7,5,14,26,48,-22,26
Glentoran,5272,7,6,6,10,24,32,-8,24
Dungannon,5272,8,2,4,16,14,47,-33,10
Crusaders,5273,1,17,6,3,62,30,32,57
Coleraine,5273,2,15,10,1,49,22,27,55
Linfield,5273,3,11,5,10,40,36,4,38
Glenavon,5273,4,9,9,8,52,49,3,36
Cliftonville,5273,5,9,4,13,32,34,-2,31
Ballymena,5273,6,7,4,15,25,48,-23,25
Glentoran,5273,7,6,6,10,24,32,-8,24
Dungannon,5273,8,2,4,16,14,47,-33,10
Crusaders,5274,1,17,6,3,62,30,32,57
Coleraine,5274,2,14,10,2,45,28,17,52
Glenavon,5274,3,10,9,7,58,45,13,39
Linfield,5274,4,11,5,10,39,37,2,38
Cliftonville,5274,5,9,4,13,33,33,0,31
Ballymena,5274,6,7,4,15,25,48,-23,25
Glentoran,5274,7,6,6,10,24,32,-8,24
Dungannon,5274,8,2,4,16,14,47,-33,10
Crusaders,5275,1,17,6,3,65,32,33,57
Coleraine,5275,2,14,11,1,45,24,21,53
Glenavon,5275,3,9,10,7,54,45,9,37
Linfield,5275,4,10,5,11,38,38,0,35
Cliftonville,5275,5,10,4,12,34,32,2,34
Ballymena,5275,6,7,4,15,27,51,-24,25
Glentoran,5275,7,6,6,10,24,32,-8,24
Dungannon,5275,8,2,4,16,14,47,-33,10
Coleraine,5276,1,15,10,1,46,24,22,55
Crusaders,5276,2,16,6,4,61,33,28,54
Glenavon,5276,3,9,9,8,54,46,8,36
Linfield,5276,4,10,6,10,38,37,1,36
Cliftonville,5276,5,9,5,12,33,32,1,32
Ballymena,5276,6,8,4,14,28,47,-19,28
Glentoran,5276,7,6,6,10,24,32,-8,24
Dungannon,5276,8,2,4,16,14,47,-33,10
Crusaders,5277,1,16,6,4,62,32,30,54
Coleraine,5277,2,14,11,1,44,23,21,53
Glenavon,5277,3,9,10,7,53,44,9,37
Linfield,5277,4,10,6,10,38,37,1,36
Cliftonville,5277,5,9,5,12,33,32,1,32
Ballymena,5277,6,8,4,14,27,48,-21,28
Glentoran,5277,7,6,6,10,24,32,-8,24
Dungannon,5277,8,2,4,16,14,47,-33,10
Crusaders,5278,1,17,6,3,62,30,32,57
Coleraine,5278,2,15,10,1,45,22,23,55
Linfield,5278,3,11,5,10,38,36,2,38
Glenavon,5278,4,9,9,8,52,45,7,36
Cliftonville,5278,5,9,4,13,32,32,0,31
Ballymena,5278,6,7,4,15,25,48,-23,25
Glentoran,5278,7,6,6,10,24,32,-8,24
Dungannon,5278,8,2,4,16,14,47,-33,10
Crusaders,5279,1,16,6,4,61,32,29,54
Coleraine,5279,2,14,11,1,44,23,21,53
Glenavon,5279,3,9,10,7,53,44,9,37
Linfield,5279,4,10,5,11,37,39,-2,35
Cliftonville,5279,5,10,4,12,35,31,4,34
Ballymena,5279,6,8,4,14,27,47,-20,28
Glentoran,5279,7,6,6,10,24,32,-8,24
Dungannon,5279,8,2,4,16,14,47,-33,10
Crusaders,5280,1,17,6,3,64,32,32,57
Coleraine,5280,2,14,10,2,44,25,19,52
Glenavon,5280,3,10,9,7,55,44,11,39
Linfield,5280,4,11,5,10,38,36,2,38
Cliftonville,5280,5,9,4,13,32,32,0,31
Ballymena,5280,6,7,4,15,27,50,-23,25
Glentoran,5280,7,6,6,10,24,32,-8,24
Dungannon,5280,8,2,4,16,14,47,-33,10
Crusaders,5281,1,17,6,3,63,31,32,57
Coleraine,5281,2,14,11,1,45,24,21,53
Linfield,5281,3,11,5,10,38,36,2,38
Glenavon,5281,4,9,10,7,54,45,9,37
Cliftonville,5281,5,9,4,13,32,32,0,31
Ballymena,5281,6,7,4,15,26,49,-23,25
Glentoran,5281,7,6,6,10,24,32,-8,24
Dungannon,5281,8,2,4,16,14,47,-33,10
Crusaders,5282,1,17,6,3,64,30,34,57
Coleraine,5282,2,14,11,1,45,24,21,53
Glenavon,5282,3,9,10,7,54,45,9,37
Linfield,5282,4,10,5,11,38,38,0,35
Cliftonville,5282,5,10,4,12,34,32,2,34
Ballymena,5282,6,7,4,15,25,50,-25,25
Glentoran,5282,7,6,6,10,24,32,-8,24
Dungannon,5282,8,2,4,16,14,47,-33,10
Coleraine,5283,1,15,10,1,47,24,23,55
Crusaders,5283,2,16,6,4,62,34,28,54
Glenavon,5283,3,9,9,8,54,47,7,36
Linfield,5283,4,10,6,10,38,37,1,36
Cliftonville,5283,5,9,5,12,33,32,1,32
Ballymena,5283,6,8,4,14,29,48,-19,28
Glentoran,5283,7,6,6,10,24,32,-8,24
Dungannon,5283,8,2,4,16,14,47,-33,10
Crusaders,5284,1,17,6,3,63,31,32,57
Coleraine,5284,2,15,10,1,48,24,24,55
Linfield,5284,3,11,5,10,39,36,3,38
Glenavon,5284,4,9,9,8,54,48,6,36
Cliftonville,5284,5,9,4,13,32,33,-1,31
Ballymena,5284,6,7,4,15,26,49,-23,25
Glentoran,5284,7,6,6,10,24,32,-8,24
Dungannon,5284,8,2,4,16,14,47,-33,10
Crusaders,5285,1,17,6,3,62,30,32,57
Coleraine,5285,2,14,10,2,44,24,20,52
Glenavon,5285,3,10,9,7,54,44,10,39
Linfield,5285,4,11,5,10,42,37,5,38
Cliftonville,5285,5,9,4,13,33,36,-3,31
Ballymena,5285,6,7,4,15,25,48,-23,25
Glentoran,5285,7,6,6,10,24,32,-8,24
Dungannon,5285,8,2,4,16,14,47,-33,10
Crusaders,5286,1,17,6,3,62,30,32,57
Coleraine,5286,2,14,10,2,45,26,19,52
Glenavon,5286,3,10,9,7,56,45,11,39
Linfield,5286,4,11,5,10,38,36,2,38
Cliftonville,5286,5,9,4,13,32,32,0,31
Ballymena,5286,6,7,4,15,25,48,-23,25
Glentoran,5286,7,6,6,10,24,32,-8,24
Dungannon,5286,8,2,4,16,14,47,-33,10
Crusaders,5287,1,17,6,3,67,31,36,57
Coleraine,5287,2,15,10,1,47,22,25,55
Linfield,5287,3,11,5,10,40,38,2,38
Glenavon,5287,4,9,9,8,52,47,5,36
Cliftonville,5287,5,9,4,13,34,34,0,31
Ballymena,5287,6,7,4,15,26,53,-27,25
Glentoran,5287,7,6,6,10,24,32,-8,24
Dungannon,5287,8,2,4,16,14,47,-33,10
Crusaders,5288,1,17,6,3,65,30,35,57
Coleraine,5288,2,15,10,1,45,23,22,55
Glenavon,5288,3,9,9,8,53,45,8,36
Linfield,5288,4,10,5,11,37,37,0,35
Cliftonville,5288,5,10,4,12,33,31,2,34
Ballymena,5288,6,7,4,15,25,51,-26,25
Glentoran,5288,7,6,6,10,24,32,-8,24
Dungannon,5288,8,2,4,16,14,47,-33,10
Crusaders,5289,1,16,7,3,61,30,31,55
Coleraine,5289,2,15,10,1,48,23,25,55
Linfield,5289,3,11,5,10,40,37,3,38
Glenavon,5289,4,9,9,8,53,48,5,36
Cliftonville,5289,5,9,4,13,33,34,-1,31
Ballymena,5289,6,7,5,14,25,47,-22,26
Glentoran,5289,7,6,6,10,24,32,-8,24
Dungannon,5289,8,2,4,16,14,47,-33,10
Crusaders,5290,1,16,7,3,62,31,31,55
Coleraine,5290,2,14,11,1,43,22,21,53
Linfield,5290,3,11,5,10,38,36,2,38
Glenavon,5290,4,9,10,7,52,43,9,37
Cliftonville,5290,5,9,4,13,32,32,0,31
Ballymena,5290,6,7,5,14,26,48,-22,26
Glentoran,5290,7,6,6,10,24,32,-8,24
Dungannon,5290,8,2,4,16,14,47,-33,10
Crusaders,5291,1,16,7,3,63,32,31,55
Coleraine,5291,2,14,11,1,44,23,21,53
Glenavon,5291,3,9,10,7,53,44,9,37
Linfield,5291,4,10,6,10,37,36,1,36
Cliftonville,5291,5,9,5,12,32,31,1,32
Ballymena,5291,6,7,5,14,27,49,-22,26
Glentoran,5291,7,6,6,10,24,32,-8,24
Dungannon,5291,8,2,4,16,14,47,-33,10
Crusaders,5292,1,17,6,3,63,31,32,57
Coleraine,5292,2,14,11,1,43,22,21,53
Linfield,5292,3,11,5,10,40,37,3,38
Glenavon,5292,4,9,10,7,52,43,9,37
Cliftonville,5292,5,9,4,13,33,34,-1,31
Ballymena,5292,6,7,4,15,26,49,-23,25
Glentoran,5292,7,6,6,10,24,32,-8,24
Dungannon,5292,8,2,4,16,14,47,-33,10
Crusaders,5293,1,16,7,3,63,32,31,55
Coleraine,5293,2,14,10,2,43,23,20,52
Glenavon,5293,3,10,9,7,53,43,10,39
Linfield,5293,4,10,5,11,38,38,0,35
Cliftonville,5293,5,10,4,12,34,32,2,34
Ballymena,5293,6,7,5,14,27,49,-22,26
Glentoran,5293,7,6,6,10,24,32,-8,24
Dungannon,5293,8,2,4,16,14,47,-33,10
Crusaders,5294,1,17,6,3,63,31,32,57
Coleraine,5294,2,14,11,1,44,23,21,53
Glenavon,5294,3,9,10,7,53,44,9,37
Linfield,5294,4,10,5,11,38,39,-1,35
Cliftonville,5294,5,10,4,12,35,32,3,34
Ballymena,5294,6,7,4,15,26,49,-23,25
Glentoran,5294,7,6,6,10,24,32,-8,24
Dungannon,5294,8,2,4,16,14,47,-33,10
Crusaders,5295,1,16,7,3,63,32,31,55
Coleraine,5295,2,14,11,1,45,24,21,53
Glenavon,5295,3,9,10,7,54,45,9,37
Linfield,5295,4,10,6,10,37,36,1,36
Cliftonville,5295,5,9,5,12,32,31,1,32
Ballymena,5295,6,7,5,14,27,49,-22,26
Glentoran,5295,7,6,6,10,24,32,-8,24
Dungannon,5295,8,2,4,16,14,47,-33,10
Crusaders,5296,1,17,6,3,62,30,32,57
Coleraine,5296,2,15,10,1,47,23,24,55
Linfield,5296,3,11,5,10,39,36,3,38
Glenavon,5296,4,9,9,8,53,47,6,36
Cliftonville,5296,5,9,4,13,32,33,-1,31
Ballymena,5296,6,7,4,15,25,48,-23,25
Glentoran,5296,7,6,6,10,24,32,-8,24
Dungannon,5296,8,2,4,16,14,47,-33,10
Crusaders,5297,1,17,6,3,63,30,33,57
Coleraine,5297,2,14,10,2,45,26,19,52
Glenavon,5297,3,10,9,7,56,45,11,39
Linfield,5297,4,11,5,10,41,37,4,38
Cliftonville,5297,5,9,4,13,33,35,-2,31
Ballymena,5297,6,7,4,15,25,49,-24,25
Glentoran,5297,7,6,6,10,24,32,-8,24
Dungannon,5297,8,2,4,16,14,47,-33,10
Crusaders,5298,1,16,7,3,62,31,31,55
Coleraine,5298,2,15,10,1,47,24,23,55
Linfield,5298,3,11,5,10,40,38,2,38
Glenavon,5298,4,9,9,8,54,47,7,36
Cliftonville,5298,5,9,4,13,34,34,0,31
Ballymena,5298,6,7,5,14,26,48,-22,26
Glentoran,5298,7,6,6,10,24,32,-8,24
Dungannon,5298,8,2,4,16,14,47,-33,10
Crusaders,5299,1,17,6,3,65,32,33,57
Coleraine,5299,2,14,10,2,43,24,19,52
Glenavon,5299,3,10,9,7,54,43,11,39
Linfield,5299,4,10,5,11,37,39,-2,35
Cliftonville,5299,5,10,4,12,35,31,4,34
Ballymena,5299,6,7,4,15,27,51,-24,25
Glentoran,5299,7,6,6,10,24,32,-8,24
Dungannon,5299,8,2,4,16,14,47,-33,10
Crusaders,5300,1,16,6,4,61,32,29,54
Coleraine,5300,2,14,10,2,46,27,19,52
Glenavon,5300,3,10,9,7,57,46,11,39
Linfield,5300,4,11,5,10,40,36,4,38
Cliftonville,5300,5,9,4,13,32,34,-2,31
Ballymena,5300,6,8,4,14,27,47,-20,28
Glentoran,5300,7,6,6,10,24,32,-8,24
Dungannon,5300,8,2,4,16,14,47,-33,10
Crusaders,5301,1,17,6,3,64,30,34,57
Coleraine,5301,2,14,11,1,43,22,21,53
Linfield,5301,3,11,5,10,40,36,4,38
Glenavon,5301,4,9,10,7,52,43,9,37
Cliftonville,5301,5,9,4,13,32,34,-2,31
Ballymena,5301,6,7,4,15,25,50,-25,25
Glentoran,5301,7,6,6,10,24,32,-8,24
Dungannon,5301,8,2,4,16,14,47,-33,10
Crusaders,5302,1,17,6,3,63,30,33,57
Coleraine,5302,2,14,10,2,43,23,20,52
Glenavon,5302,3,10,9,7,53,43,10,39
Linfield,5302,4,10,5,11,38,38,0,35
Cliftonville,5302,5,10,4,12,34,32,2,34
Ballymena,5302,6,7,4,15,25,49,-24,25
Glentoran,5302,7,6,6,10,24,32,-8,24
Dungannon,5302,8,2,4,16,14,47,-33,10
Crusaders,5303,1,16,7,3,63,32,31,55
Coleraine,5303,2,14,10,2,45,25,20,52
Glenavon,5303,3,10,9,7,55,45,10,39
Linfield,5303,4,10,5,11,37,37,0,35
Cliftonville,5303,5,10,4,12,33,31,2,34
Ballymena,5303,6,7,5,14,27,49,-22,26
Glentoran,5303,7,6,6,10,24,32,-8,24
Dungannon,5303,8,2,4,16,14,47,-33,10
Crusaders,5304,1,16,7,3,62,31,31,55
Coleraine,5304,2,15,10,1,46,24,22,55
Glenavon,5304,3,9,9,8,54,46,8,36
Linfield,5304,4,10,6,10,37,36,1,36
Cliftonville,5304,5,9,5,12,32,31,1,32
Ballymena,5304,6,7,5,14,26,48,-22,26
Glentoran,5304,7,6,6,10,24,32,-8,24
Dungannon,5304,8,2,4,16,14,47,-33,10
Crusaders,5305,1,16,7,3,63,32,31,55
Coleraine,5305,2,14,10,2,44,25,19,52
Glenavon,5305,3,10,9,7,55,44,11,39
Linfield,5305,4,11,5,10,38,36,2,38
Cliftonville,5305,5,9,4,13,32,32,0,31
Ballymena,5305,6,7,5,14,27,49,-22,26
Glentoran,5305,7,6,6,10,24,32,-8,24
Dungannon,5305,8,2,4,16,14,47,-33,10
Crusaders,5306,1,16,6,4,62,32,30,54
Coleraine,5306,2,14,11,1,44,23,21,53
Linfield,5306,3,11,5,10,39,36,3,38
Glenavon,5306,4,9,10,7,53,44,9,37
Cliftonville,5306,5,9,4,13,32,33,-1,31
Ballymena,5306,6,8,4,14,27,48,-21,28
Glentoran,5306,7,6,6,10,24,32,-8,24
Dungannon,5306,8,2,4,16,14,47,-33,10
Crusaders,5307,1,17,6,3,66,31,35,57
Coleraine,5307,2,14,10,2,43,23,20,52
Glenavon,5307,3,10,9,7,53,43,10,39
Linfield,5307,4,11,5,10,38,36,2,38
Cliftonville,5307,5,9,4,13,32,32,0,31
Ballymena,5307,6,7,4,15,26,52,-26,25
Glentoran,5307,7,6,6,10,24,32,-8,24
Dungannon,5307,8,2,4,16,14,47,-33,10
Crusaders,5308,1,17,6,3,64,30,34,57
Coleraine,5308,2,14,10,2,43,24,19,52
Glenavon,5308,3,10,9,7,54,43,11,39
Linfield,5308,4,10,5,11,39,40,-1,35
Cliftonville,5308,5,10,4,12,36,33,3,34
Ballymena,5308,6,7,4,15,25,50,-25,25
Glentoran,5308,7,6,6,10,24,32,-8,24
Dungannon,5308,8,2,4,16,14,47,-33,10
Crusaders,5309,1,17,6,3,65,33,32,57
Coleraine,5309,2,15,10,1,44,22,22,55
Linfield,5309,3,11,5,10,38,36,2,38
Glenavon,5309,4,9,9,8,52,44,8,36
Cliftonville,5309,5,9,4,13,32,32,0,31
Ballymena,5309,6,7,4,15,28,51,-23,25
Glentoran,5309,7,6,6,10,24,32,-8,24
Dungannon,5309,8,2,4,16,14,47,-33,10
Crusaders,5310,1,17,6,3,64,31,33,57
Coleraine,5310,2,14,11,1,44,23,21,53
Linfield,5310,3,11,5,10,41,37,4,38
Glenavon,5310,4,9,10,7,53,44,9,37
Cliftonville,5310,5,9,4,13,33,35,-2,31
Ballymena,5310,6,7,4,15,26,50,-24,25
Glentoran,5310,7,6,6,10,24,32,-8,24
Dungannon,5310,8,2,4,16,14,47,-33,10
Crusaders,5311,1,17,6,3,63,30,33,57
Coleraine,5311,2,14,11,1,43,22,21,53
Glenavon,5311,3,9,10,7,52,43,9,37
Linfield,5311,4,10,5,11,37,38,-1,35
Cliftonville,5311,5,10,4,12,34,31,3,34
Ballymena,5311,6,7,4,15,25,49,-24,25
Glentoran,5311,7,6,6,10,24,32,-8,24
Dungannon,5311,8,2,4,16,14,47,-33,10
Crusaders,5312,1,16,7,3,62,31,31,55
Coleraine,5312,2,14,10,2,44,24,20,52
Glenavon,5312,3,10,9,7,54,44,10,39
Linfield,5312,4,10,5,11,38,38,0,35
Cliftonville,5312,5,10,4,12,34,32,2,34
Ballymena,5312,6,7,5,14,26,48,-22,26
Glentoran,5312,7,6,6,10,24,32,-8,24
Dungannon,5312,8,2,4,16,14,47,-33,10
Coleraine,5313,1,15,10,1,45,22,23,55
Crusaders,5313,2,16,6,4,62,32,30,54
Glenavon,5313,3,9,9,8,52,45,7,36
Linfield,5313,4,10,6,10,37,36,1,36
Cliftonville,5313,5,9,5,12,32,31,1,32
Ballymena,5313,6,8,4,14,27,48,-21,28
Glentoran,5313,7,6,6,10,24,32,-8,24
Dungannon,5313,8,2,4,16,14,47,-33,10
Crusaders,5314,1,16,6,4,63,34,29,54
Coleraine,5314,2,14,10,2,43,24,19,52
Glenavon,5314,3,10,9,7,54,43,11,39
Linfield,5314,4,10,5,11,38,38,0,35
Cliftonville,5314,5,10,4,12,34,32,2,34
Ballymena,5314,6,8,4,14,29,49,-20,28
Glentoran,5314,7,6,6,10,24,32,-8,24
Dungannon,5314,8,2,4,16,14,47,-33,10
Crusaders,5315,1,16,7,3,62,31,31,55
Coleraine,5315,2,15,10,1,45,22,23,55
Glenavon,5315,3,9,9,8,52,45,7,36
Linfield,5315,4,10,5,11,38,38,0,35
Cliftonville,5315,5,10,4,12,34,32,2,34
Ballymena,5315,6,7,5,14,26,48,-22,26
Glentoran,5315,7,6,6,10,24,32,-8,24
Dungannon,5315,8,2,4,16,14,47,-33,10
Crusaders,5316,1,16,6,4,61,33,28,54
Coleraine,5316,2,14,10,2,44,24,20,52
Glenavon,5316,3,10,9,7,54,44,10,39
Linfield,5316,4,10,5,11,37,37,0,35
Cliftonville,5316,5,10,4,12,33,31,2,34
Ballymena,5316,6,8,4,14,28,47,-19,28
Glentoran,5316,7,6,6,10,24,32,-8,24
Dungannon,5316,8,2,4,16,14,47,-33,10
Crusaders,5317,1,17,6,3,66,32,34,57
Coleraine,5317,2,14,10,2,43,26,17,52
Glenavon,5317,3,10,9,7,56,43,13,39
Linfield,5317,4,11,5,10,38,36,2,38
Cliftonville,5317,5,9,4,13,32,32,0,31
Ballymena,5317,6,7,4,15,27,52,-25,25
Glentoran,5317,7,6,6,10,24,32,-8,24
Dungannon,5317,8,2,4,16,14,47,-33,10
Crusaders,5318,1,16,7,3,63,32,31,55
Coleraine,5318,2,15,10,1,47,23,24,55
Linfield,5318,3,11,5,10,38,36,2,38
Glenavon,5318,4,9,9,8,53,47,6,36
Cliftonville,5318,5,9,4,13,32,32,0,31
Ballymena,5318,6,7,5,14,27,49,-22,26
Glentoran,5318,7,6,6,10,24,32,-8,24
Dungannon,5318,8,2,4,16,14,47,-33,10
Crusaders,5319,1,16,7,3,63,32,31,55
Coleraine,5319,2,14,11,1,46,25,21,53
Glenavon,5319,3,9,10,7,55,46,9,37
Linfield,5319,4,10,6,10,39,38,1,36
Cliftonville,5319,5,9,5,12,34,33,1,32
Ballymena,5319,6,7,5,14,27,49,-22,26
Glentoran,5319,7,6,6,10,24,32,-8,24
Dungannon,5319,8,2,4,16,14,47,-33,10
Crusaders,5320,1,17,6,3,64,31,33,57
Coleraine,5320,2,14,11,1,44,23,21,53
Glenavon,5320,3,9,10,7,53,44,9,37
Linfield,5320,4,10,6,10,38,37,1,36
Cliftonville,5320,5,9,5,12,33,32,1,32
Ballymena,5320,6,7,4,15,26,50,-24,25
Glentoran,5320,7,6,6,10,24,32,-8,24
Dungannon,5320,8,2,4,16,14,47,-33,10
Crusaders,5321,1,17,6,3,65,30,35,57
Coleraine,5321,2,14,11,1,44,23,21,53
Linfield,5321,3,11,5,10,38,36,2,38
Glenavon,5321,4,9,10,7,53,44,9,37
Cliftonville,5321,5,9,4,13,32,32,0,31
Ballymena,5321,6,7,4,15,25,51,-26,25
Glentoran,5321,7,6,6,10,24,32,-8,24
Dungannon,5321,8,2,4,16,14,47,-33,10
Crusaders,5322,1,16,6,4,61,32,29,54
Coleraine,5322,2,14,10,2,44,24,20,52
Glenavon,5322,3,10,9,7,54,44,10,39
Linfield,5322,4,11,5,10,41,38,3,38
Cliftonville,5322,5,9,4,13,34,35,-1,31
Ballymena,5322,6,8,4,14,27,47,-20,28
Glentoran,5322,7,6,6,10,24,32,-8,24
Dungannon,5322,8,2,4,16,14,47,-33,10
Crusaders,5323,1,17,6,3,64,32,32,57
Coleraine,5323,2,14,10,2,44,24,20,52
Glenavon,5323,3,10,9,7,54,44,10,39
Linfield,5323,4,11,5,10,39,36,3,38
Cliftonville,5323,5,9,4,13,32,33,-1,31
Ballymena,5323,6,7,4,15,27,50,-23,25
Glentoran,5323,7,6,6,10,24,32,-8,24
Dungannon,5323,8,2,4,16,14,47,-33,10
Crusaders,5324,1,16,7,3,61,30,31,55
Coleraine,5324,2,14,10,2,43,24,19,52
Glenavon,5324,3,10,9,7,54,43,11,39
Linfield,5324,4,11,5,10,40,37,3,38
Cliftonville,5324,5,9,4,13,33,34,-1,31
Ballymena,5324,6,7,5,14,25,47,-22,26
Glentoran,5324,7,6,6,10,24,32,-8,24
Dungannon,5324,8,2,4,16,14,47,-33,10
Crusaders,5325,1,16,6,4,61,31,30,54
Coleraine,5325,2,14,10,2,43,23,20,52
Glenavon,5325,3,10,9,7,53,43,10,39
Linfield,5325,4,10,5,11,37,37,0,35
Cliftonville,5325,5,10,4,12,33,31,2,34
Ballymena,5325,6,8,4,14,26,47,-21,28
Glentoran,5325,7,6,6,10,24,32,-8,24
Dungannon,5325,8,2,4,16,14,47,-33,10
Crusaders,5326,1,16,6,4,61,33,28,54
Coleraine,5326,2,14,10,2,43,23,20,52
Glenavon,5326,3,10,9,7,53,43,10,39
Linfield,5326,4,11,5,10,38,36,2,38
Cliftonville,5326,5,9,4,13,32,32,0,31
Ballymena,5326,6,8,4,14,28,47,-19,28
Glentoran,5326,7,6,6,10,24,32,-8,24
Dungannon,5326,8,2,4,16,14,47,-33,10
Crusaders,5327,1,17,6,3,62,30,32,57
Coleraine,5327,2,15,10,1,45,22,23,55
Glenavon,5327,3,9,9,8,52,45,7,36
Linfield,5327,4,10,6,10,38,37,1,36
Cliftonville,5327,5,9,5,12,33,32,1,32
Ballymena,5327,6,7,4,15,25,48,-23,25
Glentoran,5327,7,6,6,10,24,32,-8,24
Dungannon,5327,8,2,4,16,14,47,-33,10
Crusaders,5328,1,16,6,4,63,33,30,54
Coleraine,5328,2,14,10,2,45,28,17,52
Glenavon,5328,3,10,9,7,58,45,13,39
Linfield,5328,4,10,5,11,37,37,0,35
Cliftonville,5328,5,10,4,12,33,31,2,34
Ballymena,5328,6,8,4,14,28,49,-21,28
Glentoran,5328,7,6,6,10,24,32,-8,24
Dungannon,5328,8,2,4,16,14,47,-33,10
Crusaders,5329,1,16,7,3,62,31,31,55
Coleraine,5329,2,14,11,1,44,23,21,53
Linfield,5329,3,11,5,10,38,36,2,38
Glenavon,5329,4,9,10,7,53,44,9,37
Cliftonville,5329,5,9,4,13,32,32,0,31
Ballymena,5329,6,7,5,14,26,48,-22,26
Glentoran,5329,7,6,6,10,24,32,-8,24
Dungannon,5329,8,2,4,16,14,47,-33,10
Crusaders,5330,1,16,7,3,62,31,31,55
Coleraine,5330,2,14,11,1,43,22,21,53
Glenavon,5330,3,9,10,7,52,43,9,37
Linfield,5330,4,10,6,10,38,37,1,36
Cliftonville,5330,5,9,5,12,33,32,1,32
Ballymena,5330,6,7,5,14,26,48,-22,26
Glentoran,5330,7,6,6,10,24,32,-8,24
Dungannon,5330,8,2,4,16,14,47,-33,10
Crusaders,5331,1,17,6,3,63,31,32,57
Coleraine,5331,2,14,11,1,44,23,21,53
Linfield,5331,3,11,5,10,39,36,3,38
Glenavon,5331,4,9,10,7,53,44,9,37
Cliftonville,5331,5,9,4,13,32,33,-1,31
Ballymena,5331,6,7,4,15,26,49,-23,25
Glentoran,5331,7,6,6,10,24,32,-8,24
Dungannon,5331,8,2,4,16,14,47,-33,10
Crusaders,5332,1,17,6,3,64,30,34,57
Coleraine,5332,2,14,11,1,44,23,21,53
Glenavon,5332,3,9,10,7,53,44,9,37
Linfield,5332,4,10,5,11,37,37,0,35
Cliftonville,5332,5,10,4,12,33,31,2,34
Ballymena,5332,6,7,4,15,25,50,-25,25
Glentoran,5332,7,6,6,10,24,32,-8,24
Dungannon,5332,8,2,4,16,14,47,-33,10
Crusaders,5333,1,17,6,3,66,31,35,57
Coleraine,5333,2,15,10,1,46,22,24,55
Glenavon,5333,3,9,9,8,52,46,6,36
Linfield,5333,4,10,6,10,38,37,1,36
Cliftonville,5333,5,9,5,12,33,32,1,32
Ballymena,5333,6,7,4,15,26,52,-26,25
Glentoran,5333,7,6,6,10,24,32,-8,24
Dungannon,5333,8,2,4,16,14,47,-33,10
Crusaders,5334,1,17,6,3,64,30,34,57
Coleraine,5334,2,15,10,1,45,22,23,55
Glenavon,5334,3,9,9,8,52,45,7,36
Linfield,5334,4,10,5,11,38,39,-1,35
Cliftonville,5334,5,10,4,12,35,32,3,34
Ballymena,5334,6,7,4,15,25,50,-25,25
Glentoran,5334,7,6,6,10,24,32,-8,24
Dungannon,5334,8,2,4,16,14,47,-33,10
Crusaders,5335,1,16,6,4,63,33,30,54
Coleraine,5335,2,14,10,2,44,25,19,52
Glenavon,5335,3,10,9,7,55,44,11,39
Linfield,5335,4,11,5,10,41,36,5,38
Cliftonville,5335,5,9,4,13,32,35,-3,31
Ballymena,5335,6,8,4,14,28,49,-21,28
Glentoran,5335,7,6,6,10,24,32,-8,24
Dungannon,5335,8,2,4,16,14,47,-33,10
Crusaders,5336,1,16,6,4,61,31,30,54
Coleraine,5336,2,14,10,2,43,27,16,52
Glenavon,5336,3,10,9,7,57,43,14,39
Linfield,5336,4,11,5,10,40,37,3,38
Cliftonville,5336,5,9,4,13,33,34,-1,31
Ballymena,5336,6,8,4,14,26,47,-21,28
Glentoran,5336,7,6,6,10,24,32,-8,24
Dungannon,5336,8,2,4,16,14,47,-33,10
Crusaders,5337,1,17,6,3,64,32,32,57
Coleraine,5337,2,14,10,2,43,23,20,52
Glenavon,5337,3,10,9,7,53,43,10,39
Linfield,5337,4,10,6,10,38,37,1,36
Cliftonville,5337,5,9,5,12,33,32,1,32
Ballymena,5337,6,7,4,15,27,50,-23,25
Glentoran,5337,7,6,6,10,24,32,-8,24
Dungannon,5337,8,2,4,16,14,47,-33,10
Crusaders,5338,1,17,6,3,63,31,32,57
Coleraine,5338,2,15,10,1,45,22,23,55
Linfield,5338,3,11,5,10,39,37,2,38
Glenavon,5338,4,9,9,8,52,45,7,36
Cliftonville,5338,5,9,4,13,33,33,0,31
Ballymena,5338,6,7,4,15,26,49,-23,25
Glentoran,5338,7,6,6,10,24,32,-8,24
Dungannon,5338,8,2,4,16,14,47,-33,10
Crusaders,5339,1,16,7,3,63,32,31,55
Coleraine,5339,2,15,10,1,45,22,23,55
Linfield,5339,3,11,5,10,41,37,4,38
Glenavon,5339,4,9,9,8,52,45,7,36
Cliftonville,5339,5,9,4,13,33,35,-2,31
Ballymena,5339,6,7,5,14,27,49,-22,26
Glentoran,5339,7,6,6,10,24,32,-8,24
Dungannon,5339,8,2,4,16,14,47,-33,10
Crusaders,5340,1,16,6,4,61,31,30,54
Coleraine,5340,2,14,11,1,44,23,21,53
Glenavon,5340,3,9,10,7,53,44,9,37
Linfield,5340,4,10,5,11,38,38,0,35
Cliftonville,5340,5,10,4,12,34,32,2,34
Ballymena,5340,6,8,4,14,26,47,-21,28
Glentoran,5340,7,6,6,10,24,32,-8,24
Dungannon,5340,8,2,4,16,14,47,-33,10
Crusaders,5341,1,17,6,3,64,31,33,57
Coleraine,5341,2,14,10,2,44,24,20,52
Glenavon,5341,3,10,9,7,54,44,10,39
Linfield,5341,4,10,6,10,37,36,1,36
Cliftonville,5341,5,9,5,12,32,31,1,32
Ballymena,5341,6,7,4,15,26,50,-24,25
Glentoran,5341,7,6,6,10,24,32,-8,24
Dungannon,5341,8,2,4,16,14,47,-33,10
Crusaders,5342,1,17,6,3,63,31,32,57
Coleraine,5342,2,14,10,2,43,24,19,52
Glenavon,5342,3,10,9,7,54,43,11,39
Linfield,5342,4,10,5,11,38,38,0,35
Cliftonville,5342,5,10,4,12,34,32,2,34
Ballymena,5342,6,7,4,15,26,49,-23,25
Glentoran,5342,7,6,6,10,24,32,-8,24
Dungannon,5342,8,2,4,16,14,47,-33,10
Coleraine,5343,1,15,10,1,45,23,22,55
Crusaders,5343,2,16,6,4,62,32,30,54
Linfield,5343,3,11,5,10,38,36,2,38
Glenavon,5343,4,9,9,8,53,45,8,36
Cliftonville,5343,5,9,4,13,32,32,0,31
Ballymena,5343,6,8,4,14,27,48,-21,28
Glentoran,5343,7,6,6,10,24,32,-8,24
Dungannon,5343,8,2,4,16,14,47,-33,10
Crusaders,5344,1,16,7,3,62,31,31,55
Coleraine,5344,2,14,10,2,45,25,20,52
Glenavon,5344,3,10,9,7,55,45,10,39
Linfield,5344,4,10,5,11,37,37,0,35
Cliftonville,5344,5,10,4,12,33,31,2,34
Ballymena,5344,6,7,5,14,26,48,-22,26
Glentoran,5344,7,6,6,10,24,32,-8,24
Dungannon,5344,8,2,4,16,14,47,-33,10
Crusaders,5345,1,17,6,3,62,30,32,57
Coleraine,5345,2,15,10,1,47,24,23,55
Glenavon,5345,3,9,9,8,54,47,7,36
Linfield,5345,4,10,5,11,38,38,0,35
Cliftonville,5345,5,10,4,12,34,32,2,34
Ballymena,5345,6,7,4,15,25,48,-23,25
Glentoran,5345,7,6,6,10,24,32,-8,24
Dungannon,5345,8,2,4,16,14,47,-33,10
Crusaders,5346,1,17,6,3,64,30,34,57
Coleraine,5346,2,15,10,1,47,24,23,55
Linfield,5346,3,11,5,10,39,36,3,38
Glenavon,5346,4,9,9,8,54,47,7,36
Cliftonville,5346,5,9,4,13,32,33,-1,31
Ballymena,5346,6,7,4,15,25,50,-25,25
Glentoran,5346,7,6,6,10,24,32,-8,24
Dungannon,5346,8,2,4,16,14,47,-33,10
Crusaders,5347,1,16,7,3,62,31,31,55
Coleraine,5347,2,15,10,1,47,24,23,55
Linfield,5347,3,11,5,10,38,36,2,38
Glenavon,5347,4,9,9,8,54,47,7,36
Cliftonville,5347,5,9,4,13,32,32,0,31
Ballymena,5347,6,7,5,14,26,48,-22,26
Glentoran,5347,7,6,6,10,24,32,-8,24
Dungannon,5347,8,2,4,16,14,47,-33,10
Crusaders,5348,1,17,6,3,63,31,32,57
Coleraine,5348,2,14,11,1,44,23,21,53
Linfield,5348,3,11,5,10,43,37,6,38
Glenavon,5348,4,9,10,7,53,44,9,37
Cliftonville,5348,5,9,4,13,33,37,-4,31
Ballymena,5348,6,7,4,15,26,49,-23,25
Glentoran,5348,7,6,6,10,24,32,-8,24
Dungannon,5348,8,2,4,16,14,47,-33,10
Coleraine,5349,1,15,10,1,47,23,24,55
Crusaders,5349,2,16,6,4,62,33,29,54
Linfield,5349,3,11,5,10,38,36,2,38
Glenavon,5349,4,9,9,8,53,47,6,36
Cliftonville,5349,5,9,4,13,32,32,0,31
Ballymena,5349,6,8,4,14,28,48,-20,28
Glentoran,5349,7,6,6,10,24,32,-8,24
Dungannon,5349,8,2,4,16,14,47,-33,10
Crusaders,5350,1,17,6,3,65,31,34,57
Coleraine,5350,2,15,10,1,45,22,23,55
Glenavon,5350,3,9,9,8,52,45,7,36
Linfield,5350,4,10,5,11,38,38,0,35
Cliftonville,5350,5,10,4,12,34,32,2,34
Ballymena,5350,6,7,4,15,26,51,-25,25
Glentoran,5350,7,6,6,10,24,32,-8,24
Dungannon,5350,8,2,4,16,14,47,-33,10
Crusaders,5351,1,16,7,3,62,31,31,55
Coleraine,5351,2,14,10,2,43,24,19,52
Glenavon,5351,3,10,9,7,54,43,11,39
Linfield,5351,4,11,5,10,38,36,2,38
Cliftonville,5351,5,9,4,13,32,32,0,31
Ballymena,5351,6,7,5,14,26,48,-22,26
Glentoran,5351,7,6,6,10,24,32,-8,24
Dungannon,5351,8,2,4,16,14,47,-33,10
Crusaders,5352,1,16,7,3,64,33,31,55
Coleraine,5352,2,14,10,2,44,24,20,52
Glenavon,5352,3,10,9,7,54,44,10,39
Linfield,5352,4,11,5,10,38,36,2,38
Cliftonville,5352,5,9,4,13,32,32,0,31
Ballymena,5352,6,7,5,14,28,50,-22,26
Glentoran,5352,7,6,6,10,24,32,-8,24
Dungannon,5352,8,2,4,16,14,47,-33,10
Crusaders,5353,1,16,6,4,61,31,30,54
Coleraine,5353,2,14,10,2,44,24,20,52
Glenavon,5353,3,10,9,7,54,44,10,39
Linfield,5353,4,10,6,10,37,36,1,36
Cliftonville,5353,5,9,5,12,32,31,1,32
Ballymena,5353,6,8,4,14,26,47,-21,28
Glentoran,5353,7,6,6,10,24,32,-8,24
Dungannon,5353,8,2,4,16,14,47,-33,10
Crusaders,5354,1,17,6,3,65,30,35,57
Coleraine,5354,2,15,10,1,44,22,22,55
Linfield,5354,3,11,5,10,39,36,3,38
Glenavon,5354,4,9,9,8,52,44,8,36
Cliftonville,5354,5,9,4,13,32,33,-1,31
Ballymena,5354,6,7,4,15,25,51,-26,25
Glentoran,5354,7,6,6,10,24,32,-8,24
Dungannon,5354,8,2,4,16,14,47,-33,10
Crusaders,5355,1,17,6,3,62,30,32,57
Coleraine,5355,2,14,10,2,46,28,18,52
Glenavon,5355,3,10,9,7,58,46,12,39
Linfield,5355,4,10,5,11,38,38,0,35
Cliftonville,5355,5,10,4,12,34,32,2,34
Ballymena,5355,6,7,4,15,25,48,-23,25
Glentoran,5355,7,6,6,10,24,32,-8,24
Dungannon,5355,8,2,4,16,14,47,-33,10
Coleraine,5356,1,15,10,1,49,22,27,55
Crusaders,5356,2,16,6,4,61,31,30,54
Glenavon,5356,3,9,9,8,52,49,3,36
Linfield,5356,4,10,6,10,38,37,1,36
Cliftonville,5356,5,9,5,12,33,32,1,32
Ballymena,5356,6,8,4,14,26,47,-21,28
Glentoran,5356,7,6,6,10,24,32,-8,24
Dungannon,5356,8,2,4,16,14,47,-33,10
Crusaders,5357,1,17,6,3,65,31,34,57
Coleraine,5357,2,14,11,1,44,23,21,53
Glenavon,5357,3,9,10,7,53,44,9,37
Linfield,5357,4,10,5,11,37,38,-1,35
Cliftonville,5357,5,10,4,12,34,31,3,34
Ballymena,5357,6,7,4,15,26,51,-25,25
Glentoran,5357,7,6,6,10,24,32,-8,24
Dungannon,5357,8,2,4,16,14,47,-33,10
Crusaders,5358,1,17,6,3,63,31,32,57
Coleraine,5358,2,15,10,1,44,22,22,55
Glenavon,5358,3,9,9,8,52,44,8,36
Linfield,5358,4,10,6,10,37,36,1,36
Cliftonville,5358,5,9,5,12,32,31,1,32
Ballymena,5358,6,7,4,15,26,49,-23,25
Glentoran,5358,7,6,6,10,24,32,-8,24
Dungannon,5358,8,2,4,16,14,47,-33,10
Crusaders,5359,1,17,6,3,63,31,32,57
Coleraine,5359,2,15,10,1,45,23,22,55
Glenavon,5359,3,9,9,8,53,45,8,36
Linfield,5359,4,10,5,11,40,40,0,35
Cliftonville,5359,5,10,4,12,36,34,2,34
Ballymena,5359,6,7,4,15,26,49,-23,25
Glentoran,5359,7,6,6,10,24,32,-8,24
Dungannon,5359,8,2,4,16,14,47,-33,10
Crusaders,5360,1,17,6,3,64,30,34,57
Coleraine,5360,2,15,10,1,44,22,22,55
Linfield,5360,3,11,5,10,39,36,3,38
Glenavon,5360,4,9,9,8,52,44,8,36
Cliftonville,5360,5,9,4,13,32,33,-1,31
Ballymena,5360,6,7,4,15,25,50,-25,25
Glentoran,5360,7,6,6,10,24,32,-8,24
Dungannon,5360,8,2,4,16,14,47,-33,10
Crusaders,5361,1,16,7,3,61,30,31,55
Coleraine,5361,2,15,10,1,47,23,24,55
Linfield,5361,3,11,5,10,39,37,2,38
Glenavon,5361,4,9,9,8,53,47,6,36
Cliftonville,5361,5,9,4,13,33,33,0,31
Ballymena,5361,6,7,5,14,25,47,-22,26
Glentoran,5361,7,6,6,10,24,32,-8,24
Dungannon,5361,8,2,4,16,14,47,-33,10
Crusaders,5362,1,16,6,4,62,32,30,54
Coleraine,5362,2,14,10,2,44,26,18,52
Glenavon,5362,3,10,9,7,56,44,12,39
Linfield,5362,4,11,5,10,38,36,2,38
Cliftonville,5362,5,9,4,13,32,32,0,31
Ballymena,5362,6,8,4,14,27,48,-21,28
Glentoran,5362,7,6,6,10,24,32,-8,24
Dungannon,5362,8,2,4,16,14,47,-33,10
Crusaders,5363,1,16,7,3,63,32,31,55
Coleraine,5363,2,15,10,1,45,23,22,55
Linfield,5363,3,11,5,10,40,36,4,38
Glenavon,5363,4,9,9,8,53,45,8,36
Cliftonville,5363,5,9,4,13,32,34,-2,31
Ballymena,5363,6,7,5,14,27,49,-22,26
Glentoran,5363,7,6,6,10,24,32,-8,24
Dungannon,5363,8,2,4,16,14,47,-33,10
Crusaders,5364,1,17,6,3,62,30,32,57
Coleraine,5364,2,14,10,2,44,25,19,52
Glenavon,5364,3,10,9,7,55,44,11,39
Linfield,5364,4,10,6,10,38,37,1,36
Cliftonville,5364,5,9,5,12,33,32,1,32
Ballymena,5364,6,7,4,15,25,48,-23,25
Glentoran,5364,7,6,6,10,24,32,-8,24
Dungannon,5364,8,2,4,16,14,47,-33,10
Crusaders,5365,1,16,6,4,62,32,30,54
Coleraine,5365,2,14,10,2,44,24,20,52
Glenavon,5365,3,10,9,7,54,44,10,39
Linfield,5365,4,10,6,10,38,37,1,36
Cliftonville,5365,5,9,5,12,33,32,1,32
Ballymena,5365,6,8,4,14,27,48,-21,28
Glentoran,5365,7,6,6,10,24,32,-8,24
Dungannon,5365,8,2,4,16,14,47,-33,10
Crusaders,5366,1,16,6,4,62,33,29,54
Coleraine,5366,2,14,10,2,43,24,19,52
Glenavon,5366,3,10,9,7,54,43,11,39
Linfield,5366,4,10,5,11,37,37,0,35
Cliftonville,5366,5,10,4,12,33,31,2,34
Ballymena,5366,6,8,4,14,28,48,-20,28
Glentoran,5366,7,6,6,10,24,32,-8,24
Dungannon,5366,8,2,4,16,14,47,-33,10
Crusaders,5367,1,17,6,3,64,32,32,57
Coleraine,5367,2,14,11,1,47,26,21,53
Glenavon,5367,3,9,10,7,56,47,9,37
Linfield,5367,4,10,6,10,40,39,1,36
Cliftonville,5367,5,9,5,12,35,34,1,32
Ballymena,5367,6,7,4,15,27,50,-23,25
Glentoran,5367,7,6,6,10,24,32,-8,24
Dungannon,5367,8,2,4,16,14,47,-33,10
Coleraine,5368,1,15,10,1,45,23,22,55
Crusaders,5368,2,16,6,4,62,32,30,54
Linfield,5368,3,11,5,10,39,36,3,38
Glenavon,5368,4,9,9,8,53,45,8,36
Cliftonville,5368,5,9,4,13,32,33,-1,31
Ballymena,5368,6,8,4,14,27,48,-21,28
Glentoran,5368,7,6,6,10,24,32,-8,24
Dungannon,5368,8,2,4,16,14,47,-33,10
Crusaders,5369,1,16,6,4,61,31,30,54
Coleraine,5369,2,14,11,1,43,22,21,53
Linfield,5369,3,11,5,10,39,37,2,38
Glenavon,5369,4,9,10,7,52,43,9,37
Cliftonville,5369,5,9,4,13,33,33,0,31
Ballymena,5369,6,8,4,14,26,47,-21,28
Glentoran,5369,7,6,6,10,24,32,-8,24
Dungannon,5369,8,2,4,16,14,47,-33,10
Crusaders,5370,1,16,7,3,62,31,31,55
Coleraine,5370,2,14,10,2,45,25,20,52
Glenavon,5370,3,10,9,7,55,45,10,39
Linfield,5370,4,10,6,10,38,37,1,36
Cliftonville,5370,5,9,5,12,33,32,1,32
Ballymena,5370,6,7,5,14,26,48,-22,26
Glentoran,5370,7,6,6,10,24,32,-8,24
Dungannon,5370,8,2,4,16,14,47,-33,10
Crusaders,5371,1,17,6,3,64,31,33,57
Coleraine,5371,2,15,10,1,47,23,24,55
Glenavon,5371,3,9,9,8,53,47,6,36
Linfield,5371,4,10,5,11,37,39,-2,35
Cliftonville,5371,5,10,4,12,35,31,4,34
Ballymena,5371,6,7,4,15,26,50,-24,25
Glentoran,5371,7,6,6,10,24,32,-8,24
Dungannon,5371,8,2,4,16,14,47,-33,10
Crusaders,5372,1,16,7,3,63,32,31,55
Coleraine,5372,2,14,11,1,45,24,21,53
Glenavon,5372,3,9,10,7,54,45,9,37
Linfield,5372,4,10,6,10,39,38,1,36
Cliftonville,5372,5,9,5,12,34,33,1,32
Ballymena,5372,6,7,5,14,27,49,-22,26
Glentoran,5372,7,6,6,10,24,32,-8,24
Dungannon,5372,8,2,4,16,14,47,-33,10
Crusaders,5373,1,17,6,3,63,31,32,57
Coleraine,5373,2,14,10,2,43,26,17,52
Glenavon,5373,3,10,9,7,56,43,13,39
Linfield,5373,4,11,5,10,39,36,3,38
Cliftonville,5373,5,9,4,13,32,33,-1,31
Ballymena,5373,6,7,4,15,26,49,-23,25
Glentoran,5373,7,6,6,10,24,32,-8,24
Dungannon,5373,8,2,4,16,14,47,-33,10
Crusaders,5374,1,17,6,3,65,32,33,57
Coleraine,5374,2,14,11,1,45,24,21,53
Linfield,5374,3,11,5,10,39,36,3,38
Glenavon,5374,4,9,10,7,54,45,9,37
Cliftonville,5374,5,9,4,13,32,33,-1,31
Ballymena,5374,6,7,4,15,27,51,-24,25
Glentoran,5374,7,6,6,10,24,32,-8,24
Dungannon,5374,8,2,4,16,14,47,-33,10
Crusaders,5375,1,17,6,3,64,30,34,57
Coleraine,5375,2,14,10,2,43,23,20,52
Glenavon,5375,3,10,9,7,53,43,10,39
Linfield,5375,4,11,5,10,42,37,5,38
Cliftonville,5375,5,9,4,13,33,36,-3,31
Ballymena,5375,6,7,4,15,25,50,-25,25
Glentoran,5375,7,6,6,10,24,32,-8,24
Dungannon,5375,8,2,4,16,14,47,-33,10
Crusaders,5376,1,17,6,3,65,31,34,57
Coleraine,5376,2,15,10,1,45,23,22,55
Linfield,5376,3,11,5,10,40,37,3,38
Glenavon,5376,4,9,9,8,53,45,8,36
Cliftonville,5376,5,9,4,13,33,34,-1,31
Ballymena,5376,6,7,4,15,26,51,-25,25
Glentoran,5376,7,6,6,10,24,32,-8,24
Dungannon,5376,8,2,4,16,14,47,-33,10
Crusaders,5377,1,16,7,3,63,32,31,55
Coleraine,5377,2,15,10,1,44,22,22,55
Glenavon,5377,3,9,9,8,52,44,8,36
Linfield,5377,4,10,5,11,38,39,-1,35
Cliftonville,5377,5,10,4,12,35,32,3,34
Ballymena,5377,6,7,5,14,27,49,-22,26
Glentoran,5377,7,6,6,10,24,32,-8,24
Dungannon,5377,8,2,4,16,14,47,-33,10
Crusaders,5378,1,17,6,3,64,30,34,57
Coleraine,5378,2,14,10,2,43,25,18,52
Glenavon,5378,3,10,9,7,55,43,12,39
Linfield,5378,4,11,5,10,38,36,2,38
Cliftonville,5378,5,9,4,13,32,32,0,31
Ballymena,5378,6,7,4,15,25,50,-25,25
Glentoran,5378,7,6,6,10,24,32,-8,24
Dungannon,5378,8,2,4,16,14,47,-33,10
Crusaders,5379,1,16,6,4,61,31,30,54
Coleraine,5379,2,14,10,2,43,25,18,52
Glenavon,5379,3,10,9,7,55,43,12,39
Linfield,5379,4,11,5,10,40,36,4,38
Cliftonville,5379,5,9,4,13,32,34,-2,31
Ballymena,5379,6,8,4,14,26,47,-21,28
Glentoran,5379,7,6,6,10,24,32,-8,24
Dungannon,5379,8,2,4,16,14,47,-33,10
Crusaders,5380,1,16,6,4,61,34,27,54
Coleraine,5380,2,14,10,2,43,23,20,52
Glenavon,5380,3,10,9,7,53,43,10,39
Linfield,5380,4,10,6,10,39,38,1,36
Cliftonville,5380,5,9,5,12,34,33,1,32
Ballymena,5380,6,8,4,14,29,47,-18,28
Glentoran,5380,7,6,6,10,24,32,-8,24
Dungannon,5380,8,2,4,16,14,47,-33,10
Crusaders,5381,1,17,6,3,64,31,33,57
Coleraine,5381,2,14,11,1,44,23,21,53
Glenavon,5381,3,9,10,7,53,44,9,37
Linfield,5381,4,10,5,11,38,40,-2,35
Cliftonville,5381,5,10,4,12,36,32,4,34
Ballymena,5381,6,7,4,15,26,50,-24,25
Glentoran,5381,7,6,6,10,24,32,-8,24
Dungannon,5381,8,2,4,16,14,47,-33,10
Crusaders,5382,1,16,7,3,61,30,31,55
Coleraine,5382,2,14,11,1,44,23,21,53
Glenavon,5382,3,9,10,7,53,44,9,37
Linfield,5382,4,10,6,10,38,37,1,36
Cliftonville,5382,5,9,5,12,33,32,1,32
Ballymena,5382,6,7,5,14,25,47,-22,26
Glentoran,5382,7,6,6,10,24,32,-8,24
Dungannon,5382,8,2,4,16,14,47,-33,10
Crusaders,5383,1,17,6,3,63,31,32,57
Coleraine,5383,2,15,10,1,45,22,23,55
Glenavon,5383,3,9,9,8,52,45,7,36
Linfield,5383,4,10,5,11,38,38,0,35
Cliftonville,5383,5,10,4,12,34,32,2,34
Ballymena,5383,6,7,4,15,26,49,-23,25
Glentoran,5383,7,6,6,10,24,32,-8,24
Dungannon,5383,8,2,4,16,14,47,-33,10
Crusaders,5384,1,17,6,3,63,31,32,57
Coleraine,5384,2,14,10,2,43,24,19,52
Glenavon,5384,3,10,9,7,54,43,11,39
Linfield,5384,4,10,6,10,38,37,1,36
Cliftonville,5384,5,9,5,12,33,32,1,32
Ballymena,5384,6,7,4,15,26,49,-23,25
Glentoran,5384,7,6,6,10,24,32,-8,24
Dungannon,5384,8,2,4,16,14,47,-33,10
Crusaders,5385,1,17,6,3,64,31,33,57
Coleraine,5385,2,14,10,2,45,25,20,52
Glenavon,5385,3,10,9,7,55,45,10,39
Linfield,5385,4,10,6,10,38,37,1,36
Cliftonville,5385,5,9,5,12,33,32,1,32
Ballymena,5385,6,7,4,15,26,50,-24,25
Glentoran,5385,7,6,6,10,24,32,-8,24
Dungannon,5385,8,2,4,16,14,47,-33,10
Crusaders,5386,1,17,6,3,64,31,33,57
Coleraine,5386,2,15,10,1,45,23,22,55
Glenavon,5386,3,9,9,8,53,45,8,36
Linfield,5386,4,10,6,10,38,37,1,36
Cliftonville,5386,5,9,5,12,33,32,1,32
Ballymena,5386,6,7,4,15,26,50,-24,25
Glentoran,5386,7,6,6,10,24,32,-8,24
Dungannon,5386,8,2,4,16,14,47,-33,10
Crusaders,5387,1,17,6,3,62,30,32,57
Coleraine,5387,2,14,10,2,43,24,19,52
Glenavon,5387,3,10,9,7,54,43,11,39
Linfield,5387,4,10,6,10,38,37,1,36
Cliftonville,5387,5,9,5,12,33,32,1,32
Ballymena,5387,6,7,4,15,25,48,-23,25
Glentoran,5387,7,6,6,10,24,32,-8,24
Dungannon,5387,8,2,4,16,14,47,-33,10
Crusaders,5388,1,17,6,3,64,32,32,57
Coleraine,5388,2,14,10,2,44,25,19,52
Glenavon,5388,3,10,9,7,55,44,11,39
Linfield,5388,4,10,5,11,38,38,0,35
Cliftonville,5388,5,10,4,12,34,32,2,34
Ballymena,5388,6,7,4,15,27,50,-23,25
Glentoran,5388,7,6,6,10,24,32,-8,24
Dungannon,5388,8,2,4,16,14,47,-33,10
Crusaders,5389,1,16,7,3,63,32,31,55
Coleraine,5389,2,14,10,2,44,24,20,52
Glenavon,5389,3,10,9,7,54,44,10,39
Linfield,5389,4,10,5,11,38,38,0,35
Cliftonville,5389,5,10,4,12,34,32,2,34
Ballymena,5389,6,7,5,14,27,49,-22,26
Glentoran,5389,7,6,6,10,24,32,-8,24
Dungannon,5389,8,2,4,16,14,47,-33,10
Crusaders,5390,1,17,6,3,64,31,33,57
Coleraine,5390,2,14,11,1,45,24,21,53
Glenavon,5390,3,9,10,7,54,45,9,37
Linfield,5390,4,10,6,10,38,37,1,36
Cliftonville,5390,5,9,5,12,33,32,1,32
Ballymena,5390,6,7,4,15,26,50,-24,25
Glentoran,5390,7,6,6,10,24,32,-8,24
Dungannon,5390,8,2,4,16,14,47,-33,10
Coleraine,5391,1,15,10,1,47,24,23,55
Crusaders,5391,2,16,6,4,61,31,30,54
Glenavon,5391,3,9,9,8,54,47,7,36
Linfield,5391,4,10,6,10,38,37,1,36
Cliftonville,5391,5,9,5,12,33,32,1,32
Ballymena,5391,6,8,4,14,26,47,-21,28
Glentoran,5391,7,6,6,10,24,32,-8,24
Dungannon,5391,8,2,4,16,14,47,-33,10
Coleraine,5392,1,15,10,1,47,25,22,55
Crusaders,5392,2,16,6,4,62,32,30,54
Glenavon,5392,3,9,9,8,55,47,8,36
Linfield,5392,4,10,5,11,37,38,-1,35
Cliftonville,5392,5,10,4,12,34,31,3,34
Ballymena,5392,6,8,4,14,27,48,-21,28
Glentoran,5392,7,6,6,10,24,32,-8,24
Dungannon,5392,8,2,4,16,14,47,-33,10
Crusaders,5393,1,16,6,4,63,33,30,54
Coleraine,5393,2,14,10,2,43,24,19,52
Glenavon,5393,3,10,9,7,54,43,11,39
Linfield,5393,4,10,6,10,39,38,1,36
Cliftonville,5393,5,9,5,12,34,33,1,32
Ballymena,5393,6,8,4,14,28,49,-21,28
Glentoran,5393,7,6,6,10,24,32,-8,24
Dungannon,5393,8,2,4,16,14,47,-33,10
Crusaders,5394,1,17,6,3,64,30,34,57
Coleraine,5394,2,14,11,1,45,24,21,53
Linfield,5394,3,11,5,10,39,36,3,38
Glenavon,5394,4,9,10,7,54,45,9,37
Cliftonville,5394,5,9,4,13,32,33,-1,31
Ballymena,5394,6,7,4,15,25,50,-25,25
Glentoran,5394,7,6,6,10,24,32,-8,24
Dungannon,5394,8,2,4,16,14,47,-33,10
Crusaders,5395,1,16,6,4,62,32,30,54
Coleraine,5395,2,14,10,2,45,26,19,52
Glenavon,5395,3,10,9,7,56,45,11,39
Linfield,5395,4,11,5,10,39,36,3,38
Cliftonville,5395,5,9,4,13,32,33,-1,31
Ballymena,5395,6,8,4,14,27,48,-21,28
Glentoran,5395,7,6,6,10,24,32,-8,24
Dungannon,5395,8,2,4,16,14,47,-33,10
Crusaders,5396,1,16,6,4,61,34,27,54
Coleraine,5396,2,14,10,2,44,24,20,52
Glenavon,5396,3,10,9,7,54,44,10,39
Linfield,5396,4,10,6,10,38,37,1,36
Cliftonville,5396,5,9,5,12,33,32,1,32
Ballymena,5396,6,8,4,14,29,47,-18,28
Glentoran,5396,7,6,6,10,24,32,-8,24
Dungannon,5396,8,2,4,16,14,47,-33,10
Crusaders,5397,1,16,6,4,61,31,30,54
Coleraine,5397,2,14,10,2,43,23,20,52
Glenavon,5397,3,10,9,7,53,43,10,39
Linfield,5397,4,11,5,10,40,36,4,38
Cliftonville,5397,5,9,4,13,32,34,-2,31
Ballymena,5397,6,8,4,14,26,47,-21,28
Glentoran,5397,7,6,6,10,24,32,-8,24
Dungannon,5397,8,2,4,16,14,47,-33,10
Crusaders,5398,1,16,6,4,63,33,30,54
Coleraine,5398,2,14,10,2,43,23,20,52
Glenavon,5398,3,10,9,7,53,43,10,39
Linfield,5398,4,10,5,11,37,37,0,35
Cliftonville,5398,5,10,4,12,33,31,2,34
Ballymena,5398,6,8,4,14,28,49,-21,28
Glentoran,5398,7,6,6,10,24,32,-8,24
Dungannon,5398,8,2,4,16,14,47,-33,10
Crusaders,5399,1,17,6,3,65,32,33,57
Coleraine,5399,2,14,10,2,44,24,20,52
Glenavon,5399,3,10,9,7,54,44,10,39
Linfield,5399,4,10,5,11,38,38,0,35
Cliftonville,5399,5,10,4,12,34,32,2,34
Ballymena,5399,6,7,4,15,27,51,-24,25
Glentoran,5399,7,6,6,10,24,32,-8,24
Dungannon,5399,8,2,4,16,14,47,-33,10
Crusaders,5400,1,17,6,3,64,31,33,57
Coleraine,5400,2,14,11,1,44,23,21,53
Linfield,5400,3,11,5,10,40,36,4,38
Glenavon,5400,4,9,10,7,53,44,9,37
Cliftonville,5400,5,9,4,13,32,34,-2,31
Ballymena,5400,6,7,4,15,26,50,-24,25
Glentoran,5400,7,6,6,10,24,32,-8,24
Dungannon,5400,8,2,4,16,14,47,-33,10
Crusaders,5401,1,16,7,3,62,31,31,55
Coleraine,5401,2,14,10,2,43,25,18,52
Glenavon,5401,3,10,9,7,55,43,12,39
Linfield,5401,4,11,5,10,39,36,3,38
Cliftonville,5401,5,9,4,13,32,33,-1,31
Ballymena,5401,6,7,5,14,26,48,-22,26
Glentoran,5401,7,6,6,10,24,32,-8,24
Dungannon,5401,8,2,4,16,14,47,-33,10
Crusaders,5402,1,17,6,3,65,32,33,57
Coleraine,5402,2,15,10,1,46,24,22,55
Linfield,5402,3,11,5,10,40,37,3,38
Glenavon,5402,4,9,9,8,54,46,8,36
Cliftonville,5402,5,9,4,13,33,34,-1,31
Ballymena,5402,6,7,4,15,27,51,-24,25
Glentoran,5402,7,6,6,10,24,32,-8,24
Dungannon,5402,8,2,4,16,14,47,-33,10
Crusaders,5403,1,16,7,3,63,32,31,55
Coleraine,5403,2,15,10,1,47,24,23,55
Linfield,5403,3,11,5,10,39,37,2,38
Glenavon,5403,4,9,9,8,54,47,7,36
Cliftonville,5403,5,9,4,13,33,33,0,31
Ballymena,5403,6,7,5,14,27,49,-22,26
Glentoran,5403,7,6,6,10,24,32,-8,24
Dungannon,5403,8,2,4,16,14,47,-33,10
Crusaders,5404,1,16,7,3,62,31,31,55
Coleraine,5404,2,15,10,1,45,23,22,55
Linfield,5404,3,11,5,10,39,36,3,38
Glenavon,5404,4,9,9,8,53,45,8,36
Cliftonville,5404,5,9,4,13,32,33,-1,31
Ballymena,5404,6,7,5,14,26,48,-22,26
Glentoran,5404,7,6,6,10,24,32,-8,24
Dungannon,5404,8,2,4,16,14,47,-33,10
Crusaders,5405,1,16,7,3,61,30,31,55
Coleraine,5405,2,14,11,1,44,23,21,53
Linfield,5405,3,11,5,10,41,37,4,38
Glenavon,5405,4,9,10,7,53,44,9,37
Cliftonville,5405,5,9,4,13,33,35,-2,31
Ballymena,5405,6,7,5,14,25,47,-22,26
Glentoran,5405,7,6,6,10,24,32,-8,24
Dungannon,5405,8,2,4,16,14,47,-33,10
Crusaders,5406,1,16,6,4,61,31,30,54
Coleraine,5406,2,14,10,2,43,24,19,52
Glenavon,5406,3,10,9,7,54,43,11,39
Linfield,5406,4,11,5,10,38,36,2,38
Cliftonville,5406,5,9,4,13,32,32,0,31
Ballymena,5406,6,8,4,14,26,47,-21,28
Glentoran,5406,7,6,6,10,24,32,-8,24
Dungannon,5406,8,2,4,16,14,47,-33,10
Crusaders,5407,1,17,6,3,64,30,34,57
Coleraine,5407,2,15,10,1,46,24,22,55
Glenavon,5407,3,9,9,8,54,46,8,36
Linfield,5407,4,10,5,11,38,38,0,35
Cliftonville,5407,5,10,4,12,34,32,2,34
Ballymena,5407,6,7,4,15,25,50,-25,25
Glentoran,5407,7,6,6,10,24,32,-8,24
Dungannon,5407,8,2,4,16,14,47,-33,10
Crusaders,5408,1,17,6,3,62,30,32,57
Coleraine,5408,2,14,11,1,44,23,21,53
Glenavon,5408,3,9,10,7,53,44,9,37
Linfield,5408,4,10,6,10,37,36,1,36
Cliftonville,5408,5,9,5,12,32,31,1,32
Ballymena,5408,6,7,4,15,25,48,-23,25
Glentoran,5408,7,6,6,10,24,32,-8,24
Dungannon,5408,8,2,4,16,14,47,-33,10
Coleraine,5409,1,15,10,1,44,22,22,55
Crusaders,5409,2,16,6,4,61,31,30,54
Glenavon,5409,3,9,9,8,52,44,8,36
Linfield,5409,4,10,6,10,38,37,1,36
Cliftonville,5409,5,9,5,12,33,32,1,32
Ballymena,5409,6,8,4,14,26,47,-21,28
Glentoran,5409,7,6,6,10,24,32,-8,24
Dungannon,5409,8,2,4,16,14,47,-33,10
Crusaders,5410,1,17,6,3,63,31,32,57
Coleraine,5410,2,14,11,1,44,23,21,53
Linfield,5410,3,11,5,10,38,36,2,38
Glenavon,5410,4,9,10,7,53,44,9,37
Cliftonville,5410,5,9,4,13,32,32,0,31
Ballymena,5410,6,7,4,15,26,49,-23,25
Glentoran,5410,7,6,6,10,24,32,-8,24
Dungannon,5410,8,2,4,16,14,47,-33,10
Crusaders,5411,1,17,6,3,64,32,32,57
Coleraine,5411,2,14,10,2,44,24,20,52
Glenavon,5411,3,10,9,7,54,44,10,39
Linfield,5411,4,11,5,10,41,37,4,38
Cliftonville,5411,5,9,4,13,33,35,-2,31
Ballymena,5411,6,7,4,15,27,50,-23,25
Glentoran,5411,7,6,6,10,24,32,-8,24
Dungannon,5411,8,2,4,16,14,47,-33,10
Crusaders,5412,1,17,6,3,62,30,32,57
Coleraine,5412,2,15,10,1,44,22,22,55
Linfield,5412,3,11,5,10,40,38,2,38
Glenavon,5412,4,9,9,8,52,44,8,36
Cliftonville,5412,5,9,4,13,34,34,0,31
Ballymena,5412,6,7,4,15,25,48,-23,25
Glentoran,5412,7,6,6,10,24,32,-8,24
Dungannon,5412,8,2,4,16,14,47,-33,10
Coleraine,5413,1,15,10,1,47,23,24,55
Crusaders,5413,2,16,6,4,61,33,28,54
Glenavon,5413,3,9,9,8,53,47,6,36
Linfield,5413,4,10,5,11,39,39,0,35
Cliftonville,5413,5,10,4,12,35,33,2,34
Ballymena,5413,6,8,4,14,28,47,-19,28
Glentoran,5413,7,6,6,10,24,32,-8,24
Dungannon,5413,8,2,4,16,14,47,-33,10
Crusaders,5414,1,17,6,3,63,31,32,57
Coleraine,5414,2,14,10,2,44,24,20,52
Glenavon,5414,3,10,9,7,54,44,10,39
Linfield,5414,4,10,5,11,38,38,0,35
Cliftonville,5414,5,10,4,12,34,32,2,34
Ballymena,5414,6,7,4,15,26,49,-23,25
Glentoran,5414,7,6,6,10,24,32,-8,24
Dungannon,5414,8,2,4,16,14,47,-33,10
Coleraine,5415,1,15,10,1,46,22,24,55
Crusaders,5415,2,16,6,4,61,32,29,54
Glenavon,5415,3,9,9,8,52,46,6,36
Linfield,5415,4,10,5,11,38,39,-1,35
Cliftonville,5415,5,10,4,12,35,32,3,34
Ballymena,5415,6,8,4,14,27,47,-20,28
Glentoran,5415,7,6,6,10,24,32,-8,24
Dungannon,5415,8,2,4,16,14,47,-33,10
Coleraine,5416,1,15,10,1,45,22,23,55
Crusaders,5416,2,16,6,4,62,32,30,54
Glenavon,5416,3,9,9,8,52,45,7,36
Linfield,5416,4,10,6,10,39,38,1,36
Cliftonville,5416,5,9,5,12,34,33,1,32
Ballymena,5416,6,8,4,14,27,48,-21,28
Glentoran,5416,7,6,6,10,24,32,-8,24
Dungannon,5416,8,2,4,16,14,47,-33,10
Crusaders,5417,1,17,6,3,65,32,33,57
Coleraine,5417,2,15,10,1,46,24,22,55
Linfield,5417,3,11,5,10,39,37,2,38
Glenavon,5417,4,9,9,8,54,46,8,36
Cliftonville,5417,5,9,4,13,33,33,0,31
Ballymena,5417,6,7,4,15,27,51,-24,25
Glentoran,5417,7,6,6,10,24,32,-8,24
Dungannon,5417,8,2,4,16,14,47,-33,10
Crusaders,5418,1,16,7,3,61,30,31,55
Coleraine,5418,2,14,10,2,43,24,19,52
Glenavon,5418,3,10,9,7,54,43,11,39
Linfield,5418,4,10,6,10,38,37,1,36
Cliftonville,5418,5,9,5,12,33,32,1,32
Ballymena,5418,6,7,5,14,25,47,-22,26
Glentoran,5418,7,6,6,10,24,32,-8,24
Dungannon,5418,8,2,4,16,14,47,-33,10
Crusaders,5419,1,16,6,4,61,32,29,54
Coleraine,5419,2,14,10,2,45,26,19,52
Glenavon,5419,3,10,9,7,56,45,11,39
Linfield,5419,4,11,5,10,39,36,3,38
Cliftonville,5419,5,9,4,13,32,33,-1,31
Ballymena,5419,6,8,4,14,27,47,-20,28
Glentoran,5419,7,6,6,10,24,32,-8,24
Dungannon,5419,8,2,4,16,14,47,-33,10
Crusaders,5420,1,16,7,3,64,33,31,55
Coleraine,5420,2,14,10,2,44,25,19,52
Glenavon,5420,3,10,9,7,55,44,11,39
Linfield,5420,4,10,6,10,38,37,1,36
Cliftonville,5420,5,9,5,12,33,32,1,32
Ballymena,5420,6,7,5,14,28,50,-22,26
Glentoran,5420,7,6,6,10,24,32,-8,24
Dungannon,5420,8,2,4,16,14,47,-33,10
Crusaders,5421,1,16,7,3,62,31,31,55
Coleraine,5421,2,14,10,2,44,26,18,52
Glenavon,5421,3,10,9,7,56,44,12,39
Linfield,5421,4,10,5,11,39,39,0,35
Cliftonville,5421,5,10,4,12,35,33,2,34
Ballymena,5421,6,7,5,14,26,48,-22,26
Glentoran,5421,7,6,6,10,24,32,-8,24
Dungannon,5421,8,2,4,16,14,47,-33,10
Crusaders,5422,1,16,7,3,62,31,31,55
Coleraine,5422,2,15,10,1,46,22,24,55
Linfield,5422,3,11,5,10,38,36,2,38
Glenavon,5422,4,9,9,8,52,46,6,36
Cliftonville,5422,5,9,4,13,32,32,0,31
Ballymena,5422,6,7,5,14,26,48,-22,26
Glentoran,5422,7,6,6,10,24,32,-8,24
Dungannon,5422,8,2,4,16,14,47,-33,10
Crusaders,5423,1,17,6,3,63,31,32,57
Coleraine,5423,2,14,10,2,43,23,20,52
Glenavon,5423,3,10,9,7,53,43,10,39
Linfield,5423,4,11,5,10,39,36,3,38
Cliftonville,5423,5,9,4,13,32,33,-1,31
Ballymena,5423,6,7,4,15,26,49,-23,25
Glentoran,5423,7,6,6,10,24,32,-8,24
Dungannon,5423,8,2,4,16,14,47,-33,10
Crusaders,5424,1,16,7,3,64,33,31,55
Coleraine,5424,2,14,10,2,45,25,20,52
Glenavon,5424,3,10,9,7,55,45,10,39
Linfield,5424,4,10,5,11,37,39,-2,35
Cliftonville,5424,5,10,4,12,35,31,4,34
Ballymena,5424,6,7,5,14,28,50,-22,26
Glentoran,5424,7,6,6,10,24,32,-8,24
Dungannon,5424,8,2,4,16,14,47,-33,10
Coleraine,5425,1,15,10,1,44,22,22,55
Crusaders,5425,2,16,6,4,61,31,30,54
Glenavon,5425,3,9,9,8,52,44,8,36
Linfield,5425,4,10,5,11,38,38,0,35
Cliftonville,5425,5,10,4,12,34,32,2,34
Ballymena,5425,6,8,4,14,26,47,-21,28
Glentoran,5425,7,6,6,10,24,32,-8,24
Dungannon,5425,8,2,4,16,14,47,-33,10
Crusaders,5426,1,17,6,3,65,32,33,57
Coleraine,5426,2,15,10,1,47,24,23,55
Linfield,5426,3,11,5,10,38,36,2,38
Glenavon,5426,4,9,9,8,54,47,7,36
Cliftonville,5426,5,9,4,13,32,32,0,31
Ballymena,5426,6,7,4,15,27,51,-24,25
Glentoran,5426,7,6,6,10,24,32,-8,24
Dungannon,5426,8,2,4,16,14,47,-33,10
Crusaders,5427,1,16,7,3,62,31,31,55
Coleraine,5427,2,14,10,2,43,25,18,52
Glenavon,5427,3,10,9,7,55,43,12,39
Linfield,5427,4,10,6,10,38,37,1,36
Cliftonville,5427,5,9,5,12,33,32,1,32
Ballymena,5427,6,7,5,14,26,48,-22,26
Glentoran,5427,7,6,6,10,24,32,-8,24
Dungannon,5427,8,2,4,16,14,47,-33,10
Crusaders,5428,1,16,7,3,61,30,31,55
Coleraine,5428,2,15,10,1,47,25,22,55
Linfield,5428,3,11,5,10,38,36,2,38
Glenavon,5428,4,9,9,8,55,47,8,36
Cliftonville,5428,5,9,4,13,32,32,0,31
Ballymena,5428,6,7,5,14,25,47,-22,26
Glentoran,5428,7,6,6,10,24,32,-8,24
Dungannon,5428,8,2,4,16,14,47,-33,10
Crusaders,5429,1,17,6,3,65,31,34,57
Coleraine,5429,2,15,10,1,45,22,23,55
Glenavon,5429,3,9,9,8,52,45,7,36
Linfield,5429,4,10,6,10,39,38,1,36
Cliftonville,5429,5,9,5,12,34,33,1,32
Ballymena,5429,6,7,4,15,26,51,-25,25
Glentoran,5429,7,6,6,10,24,32,-8,24
Dungannon,5429,8,2,4,16,14,47,-33,10
Crusaders,5430,1,17,6,3,63,31,32,57
Coleraine,5430,2,14,10,2,44,25,19,52
Glenavon,5430,3,10,9,7,55,44,11,39
Linfield,5430,4,11,5,10,39,37,2,38
Cliftonville,5430,5,9,4,13,33,33,0,31
Ballymena,5430,6,7,4,15,26,49,-23,25
Glentoran,5430,7,6,6,10,24,32,-8,24
Dungannon,5430,8,2,4,16,14,47,-33,10
Crusaders,5431,1,16,7,3,62,31,31,55
Coleraine,5431,2,15,10,1,45,22,23,55
Linfield,5431,3,11,5,10,39,36,3,38
Glenavon,5431,4,9,9,8,52,45,7,36
Cliftonville,5431,5,9,4,13,32,33,-1,31
Ballymena,5431,6,7,5,14,26,48,-22,26
Glentoran,5431,7,6,6,10,24,32,-8,24
Dungannon,5431,8,2,4,16,14,47,-33,10
Crusaders,5432,1,16,6,4,62,32,30,54
Coleraine,5432,2,14,11,1,44,23,21,53
Glenavon,5432,3,9,10,7,53,44,9,37
Linfield,5432,4,10,6,10,39,38,1,36
Cliftonville,5432,5,9,5,12,34,33,1,32
Ballymena,5432,6,8,4,14,27,48,-21,28
Glentoran,5432,7,6,6,10,24,32,-8,24
Dungannon,5432,8,2,4,16,14,47,-33,10
Crusaders,5433,1,17,6,3,64,32,32,57
Coleraine,5433,2,14,11,1,44,23,21,53
Glenavon,5433,3,9,10,7,53,44,9,37
Linfield,5433,4,10,6,10,38,37,1,36
Cliftonville,5433,5,9,5,12,33,32,1,32
Ballymena,5433,6,7,4,15,27,50,-23,25
Glentoran,5433,7,6,6,10,24,32,-8,24
Dungannon,5433,8,2,4,16,14,47,-33,10
Crusaders,5434,1,17,6,3,65,33,32,57
Coleraine,5434,2,15,10,1,44,22,22,55
Glenavon,5434,3,9,9,8,52,44,8,36
Linfield,5434,4,10,5,11,38,39,-1,35
Cliftonville,5434,5,10,4,12,35,32,3,34
Ballymena,5434,6,7,4,15,28,51,-23,25
Glentoran,5434,7,6,6,10,24,32,-8,24
Dungannon,5434,8,2,4,16,14,47,-33,10
Crusaders,5435,1,16,7,3,64,33,31,55
Coleraine,5435,2,14,10,2,44,24,20,52
Glenavon,5435,3,10,9,7,54,44,10,39
Linfield,5435,4,10,5,11,37,37,0,35
Cliftonville,5435,5,10,4,12,33,31,2,34
Ballymena,5435,6,7,5,14,28,50,-22,26
Glentoran,5435,7,6,6,10,24,32,-8,24
Dungannon,5435,8,2,4,16,14,47,-33,10
Crusaders,5436,1,17,6,3,63,31,32,57
Coleraine,5436,2,14,11,1,45,24,21,53
Glenavon,5436,3,9,10,7,54,45,9,37
Linfield,5436,4,10,6,10,39,38,1,36
Cliftonville,5436,5,9,5,12,34,33,1,32
Ballymena,5436,6,7,4,15,26,49,-23,25
Glentoran,5436,7,6,6,10,24,32,-8,24
Dungannon,5436,8,2,4,16,14,47,-33,10
Crusaders,5437,1,17,6,3,64,32,32,57
Coleraine,5437,2,15,10,1,46,23,23,55
Glenavon,5437,3,9,9,8,53,46,7,36
Linfield,5437,4,10,6,10,39,38,1,36
Cliftonville,5437,5,9,5,12,34,33,1,32
Ballymena,5437,6,7,4,15,27,50,-23,25
Glentoran,5437,7,6,6,10,24,32,-8,24
Dungannon,5437,8,2,4,16,14,47,-33,10
Crusaders,5438,1,17,6,3,63,31,32,57
Coleraine,5438,2,14,10,2,43,24,19,52
Glenavon,5438,3,10,9,7,54,43,11,39
Linfield,5438,4,11,5,10,39,36,3,38
Cliftonville,5438,5,9,4,13,32,33,-1,31
Ballymena,5438,6,7,4,15,26,49,-23,25
Glentoran,5438,7,6,6,10,24,32,-8,24
Dungannon,5438,8,2,4,16,14,47,-33,10
Crusaders,5439,1,16,7,3,62,31,31,55
Coleraine,5439,2,15,10,1,47,23,24,55
Glenavon,5439,3,9,9,8,53,47,6,36
Linfield,5439,4,10,6,10,39,38,1,36
Cliftonville,5439,5,9,5,12,34,33,1,32
Ballymena,5439,6,7,5,14,26,48,-22,26
Glentoran,5439,7,6,6,10,24,32,-8,24
Dungannon,5439,8,2,4,16,14,47,-33,10
Crusaders,5440,1,17,6,3,66,32,34,57
Coleraine,5440,2,14,10,2,43,24,19,52
Glenavon,5440,3,10,9,7,54,43,11,39
Linfield,5440,4,11,5,10,39,36,3,38
Cliftonville,5440,5,9,4,13,32,33,-1,31
Ballymena,5440,6,7,4,15,27,52,-25,25
Glentoran,5440,7,6,6,10,24,32,-8,24
Dungannon,5440,8,2,4,16,14,47,-33,10
Crusaders,5441,1,17,6,3,63,31,32,57
Coleraine,5441,2,15,10,1,45,22,23,55
Linfield,5441,3,11,5,10,38,36,2,38
Glenavon,5441,4,9,9,8,52,45,7,36
Cliftonville,5441,5,9,4,13,32,32,0,31
Ballymena,5441,6,7,4,15,26,49,-23,25
Glentoran,5441,7,6,6,10,24,32,-8,24
Dungannon,5441,8,2,4,16,14,47,-33,10
Crusaders,5442,1,17,6,3,62,30,32,57
Coleraine,5442,2,14,11,1,45,24,21,53
Glenavon,5442,3,9,10,7,54,45,9,37
Linfield,5442,4,10,5,11,38,38,0,35
Cliftonville,5442,5,10,4,12,34,32,2,34
Ballymena,5442,6,7,4,15,25,48,-23,25
Glentoran,5442,7,6,6,10,24,32,-8,24
Dungannon,5442,8,2,4,16,14,47,-33,10
Crusaders,5443,1,16,7,3,64,33,31,55
Coleraine,5443,2,15,10,1,47,25,22,55
Linfield,5443,3,11,5,10,39,37,2,38
Glenavon,5443,4,9,9,8,55,47,8,36
Cliftonville,5443,5,9,4,13,33,33,0,31
Ballymena,5443,6,7,5,14,28,50,-22,26
Glentoran,5443,7,6,6,10,24,32,-8,24
Dungannon,5443,8,2,4,16,14,47,-33,10
Crusaders,5444,1,16,7,3,62,31,31,55
Coleraine,5444,2,15,10,1,46,23,23,55
Linfield,5444,3,11,5,10,38,36,2,38
Glenavon,5444,4,9,9,8,53,46,7,36
Cliftonville,5444,5,9,4,13,32,32,0,31
Ballymena,5444,6,7,5,14,26,48,-22,26
Glentoran,5444,7,6,6,10,24,32,-8,24
Dungannon,5444,8,2,4,16,14,47,-33,10
Crusaders,5445,1,17,6,3,65,30,35,57
Coleraine,5445,2,15,10,1,46,24,22,55
Glenavon,5445,3,9,9,8,54,46,8,36
Linfield,5445,4,10,5,11,37,37,0,35
Cliftonville,5445,5,10,4,12,33,31,2,34
Ballymena,5445,6,7,4,15,25,51,-26,25
Glentoran,5445,7,6,6,10,24,32,-8,24
Dungannon,5445,8,2,4,16,14,47,-33,10
Crusaders,5446,1,16,7,3,63,32,31,55
Coleraine,5446,2,14,10,2,44,25,19,52
Glenavon,5446,3,10,9,7,55,44,11,39
Linfield,5446,4,10,6,10,40,39,1,36
Cliftonville,5446,5,9,5,12,35,34,1,32
Ballymena,5446,6,7,5,14,27,49,-22,26
Glentoran,5446,7,6,6,10,24,32,-8,24
Dungannon,5446,8,2,4,16,14,47,-33,10
Crusaders,5447,1,17,6,3,64,31,33,57
Coleraine,5447,2,14,11,1,43,22,21,53
Linfield,5447,3,11,5,10,39,37,2,38
Glenavon,5447,4,9,10,7,52,43,9,37
Cliftonville,5447,5,9,4,13,33,33,0,31
Ballymena,5447,6,7,4,15,26,50,-24,25
Glentoran,5447,7,6,6,10,24,32,-8,24
Dungannon,5447,8,2,4,16,14,47,-33,10
Coleraine,5448,1,15,10,1,46,22,24,55
Crusaders,5448,2,16,6,4,63,33,30,54
Linfield,5448,3,11,5,10,39,37,2,38
Glenavon,5448,4,9,9,8,52,46,6,36
Cliftonville,5448,5,9,4,13,33,33,0,31
Ballymena,5448,6,8,4,14,28,49,-21,28
Glentoran,5448,7,6,6,10,24,32,-8,24
Dungannon,5448,8,2,4,16,14,47,-33,10
Crusaders,5449,1,17,6,3,64,32,32,57
Coleraine,5449,2,14,11,1,44,23,21,53
Glenavon,5449,3,9,10,7,53,44,9,37
Linfield,5449,4,10,6,10,39,38,1,36
Cliftonville,5449,5,9,5,12,34,33,1,32
Ballymena,5449,6,7,4,15,27,50,-23,25
Glentoran,5449,7,6,6,10,24,32,-8,24
Dungannon,5449,8,2,4,16,14,47,-33,10
Crusaders,5450,1,17,6,3,66,33,33,57
Coleraine,5450,2,15,10,1,44,22,22,55
Glenavon,5450,3,9,9,8,52,44,8,36
Linfield,5450,4,10,5,11,39,39,0,35
Cliftonville,5450,5,10,4,12,35,33,2,34
Ballymena,5450,6,7,4,15,28,52,-24,25
Glentoran,5450,7,6,6,10,24,32,-8,24
Dungannon,5450,8,2,4,16,14,47,-33,10
Crusaders,5451,1,17,6,3,64,30,34,57
Coleraine,5451,2,15,10,1,45,23,22,55
Linfield,5451,3,11,5,10,41,37,4,38
Glenavon,5451,4,9,9,8,53,45,8,36
Cliftonville,5451,5,9,4,13,33,35,-2,31
Ballymena,5451,6,7,4,15,25,50,-25,25
Glentoran,5451,7,6,6,10,24,32,-8,24
Dungannon,5451,8,2,4,16,14,47,-33,10
Crusaders,5452,1,17,6,3,63,31,32,57
Coleraine,5452,2,15,10,1,44,22,22,55
Linfield,5452,3,11,5,10,39,37,2,38
Glenavon,5452,4,9,9,8,52,44,8,36
Cliftonville,5452,5,9,4,13,33,33,0,31
Ballymena,5452,6,7,4,15,26,49,-23,25
Glentoran,5452,7,6,6,10,24,32,-8,24
Dungannon,5452,8,2,4,16,14,47,-33,10
Crusaders,5453,1,17,6,3,62,30,32,57
Coleraine,5453,2,14,11,1,44,23,21,53
Linfield,5453,3,11,5,10,39,36,3,38
Glenavon,5453,4,9,10,7,53,44,9,37
Cliftonville,5453,5,9,4,13,32,33,-1,31
Ballymena,5453,6,7,4,15,25,48,-23,25
Glentoran,5453,7,6,6,10,24,32,-8,24
Dungannon,5453,8,2,4,16,14,47,-33,10
Crusaders,5454,1,17,6,3,64,32,32,57
Coleraine,5454,2,15,10,1,45,22,23,55
Glenavon,5454,3,9,9,8,52,45,7,36
Linfield,5454,4,10,5,11,37,37,0,35
Cliftonville,5454,5,10,4,12,33,31,2,34
Ballymena,5454,6,7,4,15,27,50,-23,25
Glentoran,5454,7,6,6,10,24,32,-8,24
Dungannon,5454,8,2,4,16,14,47,-33,10
Crusaders,5455,1,16,6,4,62,33,29,54
Coleraine,5455,2,14,10,2,43,23,20,52
Glenavon,5455,3,10,9,7,53,43,10,39
Linfield,5455,4,11,5,10,39,36,3,38
Cliftonville,5455,5,9,4,13,32,33,-1,31
Ballymena,5455,6,8,4,14,28,48,-20,28
Glentoran,5455,7,6,6,10,24,32,-8,24
Dungannon,5455,8,2,4,16,14,47,-33,10
Crusaders,5456,1,16,6,4,62,32,30,54
Coleraine,5456,2,14,10,2,43,25,18,52
Glenavon,5456,3,10,9,7,55,43,12,39
Linfield,5456,4,10,6,10,38,37,1,36
Cliftonville,5456,5,9,5,12,33,32,1,32
Ballymena,5456,6,8,4,14,27,48,-21,28
Glentoran,5456,7,6,6,10,24,32,-8,24
Dungannon,5456,8,2,4,16,14,47,-33,10
Crusaders,5457,1,17,6,3,63,31,32,57
Coleraine,5457,2,15,10,1,45,23,22,55
Glenavon,5457,3,9,9,8,53,45,8,36
Linfield,5457,4,10,6,10,37,36,1,36
Cliftonville,5457,5,9,5,12,32,31,1,32
Ballymena,5457,6,7,4,15,26,49,-23,25
Glentoran,5457,7,6,6,10,24,32,-8,24
Dungannon,5457,8,2,4,16,14,47,-33,10
Crusaders,5458,1,16,6,4,61,32,29,54
Coleraine,5458,2,14,10,2,45,27,18,52
Glenavon,5458,3,10,9,7,57,45,12,39
Linfield,5458,4,10,6,10,39,38,1,36
Cliftonville,5458,5,9,5,12,34,33,1,32
Ballymena,5458,6,8,4,14,27,47,-20,28
Glentoran,5458,7,6,6,10,24,32,-8,24
Dungannon,5458,8,2,4,16,14,47,-33,10
Crusaders,5459,1,16,7,3,62,31,31,55
Coleraine,5459,2,14,10,2,43,26,17,52
Glenavon,5459,3,10,9,7,56,43,13,39
Linfield,5459,4,11,5,10,40,38,2,38
Cliftonville,5459,5,9,4,13,34,34,0,31
Ballymena,5459,6,7,5,14,26,48,-22,26
Glentoran,5459,7,6,6,10,24,32,-8,24
Dungannon,5459,8,2,4,16,14,47,-33,10
Crusaders,5460,1,16,7,3,63,32,31,55
Coleraine,5460,2,14,11,1,44,23,21,53
Linfield,5460,3,11,5,10,39,36,3,38
Glenavon,5460,4,9,10,7,53,44,9,37
Cliftonville,5460,5,9,4,13,32,33,-1,31
Ballymena,5460,6,7,5,14,27,49,-22,26
Glentoran,5460,7,6,6,10,24,32,-8,24
Dungannon,5460,8,2,4,16,14,47,-33,10
Crusaders,5461,1,17,6,3,64,31,33,57
Coleraine,5461,2,14,11,1,44,23,21,53
Linfield,5461,3,11,5,10,39,37,2,38
Glenavon,5461,4,9,10,7,53,44,9,37
Cliftonville,5461,5,9,4,13,33,33,0,31
Ballymena,5461,6,7,4,15,26,50,-24,25
Glentoran,5461,7,6,6,10,24,32,-8,24
Dungannon,5461,8,2,4,16,14,47,-33,10
Crusaders,5462,1,16,6,4,61,31,30,54
Coleraine,5462,2,14,10,2,44,24,20,52
Glenavon,5462,3,10,9,7,54,44,10,39
Linfield,5462,4,11,5,10,40,37,3,38
Cliftonville,5462,5,9,4,13,33,34,-1,31
Ballymena,5462,6,8,4,14,26,47,-21,28
Glentoran,5462,7,6,6,10,24,32,-8,24
Dungannon,5462,8,2,4,16,14,47,-33,10
Crusaders,5463,1,17,6,3,63,30,33,57
Coleraine,5463,2,14,11,1,44,23,21,53
Glenavon,5463,3,9,10,7,53,44,9,37
Linfield,5463,4,10,5,11,38,38,0,35
Cliftonville,5463,5,10,4,12,34,32,2,34
Ballymena,5463,6,7,4,15,25,49,-24,25
Glentoran,5463,7,6,6,10,24,32,-8,24
Dungannon,5463,8,2,4,16,14,47,-33,10
Crusaders,5464,1,17,6,3,64,30,34,57
Coleraine,5464,2,14,11,1,44,23,21,53
Linfield,5464,3,11,5,10,39,37,2,38
Glenavon,5464,4,9,10,7,53,44,9,37
Cliftonville,5464,5,9,4,13,33,33,0,31
Ballymena,5464,6,7,4,15,25,50,-25,25
Glentoran,5464,7,6,6,10,24,32,-8,24
Dungannon,5464,8,2,4,16,14,47,-33,10
Crusaders,5465,1,17,6,3,64,31,33,57
Coleraine,5465,2,14,10,2,43,25,18,52
Glenavon,5465,3,10,9,7,55,43,12,39
Linfield,5465,4,11,5,10,38,36,2,38
Cliftonville,5465,5,9,4,13,32,32,0,31
Ballymena,5465,6,7,4,15,26,50,-24,25
Glentoran,5465,7,6,6,10,24,32,-8,24
Dungannon,5465,8,2,4,16,14,47,-33,10
Crusaders,5466,1,17,6,3,65,33,32,57
Coleraine,5466,2,15,10,1,45,22,23,55
Linfield,5466,3,11,5,10,39,37,2,38
Glenavon,5466,4,9,9,8,52,45,7,36
Cliftonville,5466,5,9,4,13,33,33,0,31
Ballymena,5466,6,7,4,15,28,51,-23,25
Glentoran,5466,7,6,6,10,24,32,-8,24
Dungannon,5466,8,2,4,16,14,47,-33,10
Crusaders,5467,1,16,7,3,61,30,31,55
Coleraine,5467,2,14,11,1,44,23,21,53
Linfield,5467,3,11,5,10,41,38,3,38
Glenavon,5467,4,9,10,7,53,44,9,37
Cliftonville,5467,5,9,4,13,34,35,-1,31
Ballymena,5467,6,7,5,14,25,47,-22,26
Glentoran,5467,7,6,6,10,24,32,-8,24
Dungannon,5467,8,2,4,16,14,47,-33,10
Crusaders,5468,1,17,6,3,62,30,32,57
Coleraine,5468,2,14,11,1,44,23,21,53
Glenavon,5468,3,9,10,7,53,44,9,37
Linfield,5468,4,10,6,10,38,37,1,36
Cliftonville,5468,5,9,5,12,33,32,1,32
Ballymena,5468,6,7,4,15,25,48,-23,25
Glentoran,5468,7,6,6,10,24,32,-8,24
Dungannon,5468,8,2,4,16,14,47,-33,10
Crusaders,5469,1,17,6,3,65,31,34,57
Coleraine,5469,2,14,11,1,45,24,21,53
Glenavon,5469,3,9,10,7,54,45,9,37
Linfield,5469,4,10,5,11,37,38,-1,35
Cliftonville,5469,5,10,4,12,34,31,3,34
Ballymena,5469,6,7,4,15,26,51,-25,25
Glentoran,5469,7,6,6,10,24,32,-8,24
Dungannon,5469,8,2,4,16,14,47,-33,10
Crusaders,5470,1,17,6,3,64,31,33,57
Coleraine,5470,2,14,10,2,46,26,20,52
Glenavon,5470,3,10,9,7,56,46,10,39
Linfield,5470,4,11,5,10,38,36,2,38
Cliftonville,5470,5,9,4,13,32,32,0,31
Ballymena,5470,6,7,4,15,26,50,-24,25
Glentoran,5470,7,6,6,10,24,32,-8,24
Dungannon,5470,8,2,4,16,14,47,-33,10
Coleraine,5471,1,15,10,1,44,22,22,55
Crusaders,5471,2,16,6,4,62,32,30,54
Linfield,5471,3,11,5,10,39,37,2,38
Glenavon,5471,4,9,9,8,52,44,8,36
Cliftonville,5471,5,9,4,13,33,33,0,31
Ballymena,5471,6,8,4,14,27,48,-21,28
Glentoran,5471,7,6,6,10,24,32,-8,24
Dungannon,5471,8,2,4,16,14,47,-33,10
Crusaders,5472,1,16,7,3,62,31,31,55
Coleraine,5472,2,14,11,1,45,24,21,53
Glenavon,5472,3,9,10,7,54,45,9,37
Linfield,5472,4,10,6,10,40,39,1,36
Cliftonville,5472,5,9,5,12,35,34,1,32
Ballymena,5472,6,7,5,14,26,48,-22,26
Glentoran,5472,7,6,6,10,24,32,-8,24
Dungannon,5472,8,2,4,16,14,47,-33,10
Coleraine,5473,1,15,10,1,47,23,24,55
Crusaders,5473,2,16,6,4,63,33,30,54
Glenavon,5473,3,9,9,8,53,47,6,36
Linfield,5473,4,10,5,11,38,38,0,35
Cliftonville,5473,5,10,4,12,34,32,2,34
Ballymena,5473,6,8,4,14,28,49,-21,28
Glentoran,5473,7,6,6,10,24,32,-8,24
Dungannon,5473,8,2,4,16,14,47,-33,10
Crusaders,5474,1,16,6,4,61,31,30,54
Coleraine,5474,2,14,11,1,46,25,21,53
Glenavon,5474,3,9,10,7,55,46,9,37
Linfield,5474,4,10,6,10,39,38,1,36
Cliftonville,5474,5,9,5,12,34,33,1,32
Ballymena,5474,6,8,4,14,26,47,-21,28
Glentoran,5474,7,6,6,10,24,32,-8,24
Dungannon,5474,8,2,4,16,14,47,-33,10
Crusaders,5475,1,17,6,3,64,32,32,57
Coleraine,5475,2,14,10,2,44,24,20,52
Glenavon,5475,3,10,9,7,54,44,10,39
Linfield,5475,4,11,5,10,39,37,2,38
Cliftonville,5475,5,9,4,13,33,33,0,31
Ballymena,5475,6,7,4,15,27,50,-23,25
Glentoran,5475,7,6,6,10,24,32,-8,24
Dungannon,5475,8,2,4,16,14,47,-33,10
Crusaders,5476,1,16,6,4,61,31,30,54
Coleraine,5476,2,14,10,2,45,25,20,52
Glenavon,5476,3,10,9,7,55,45,10,39
Linfield,5476,4,11,5,10,39,36,3,38
Cliftonville,5476,5,9,4,13,32,33,-1,31
Ballymena,5476,6,8,4,14,26,47,-21,28
Glentoran,5476,7,6,6,10,24,32,-8,24
Dungannon,5476,8,2,4,16,14,47,-33,10
Crusaders,5477,1,17,6,3,65,31,34,57
Coleraine,5477,2,15,10,1,44,22,22,55
Linfield,5477,3,11,5,10,40,38,2,38
Glenavon,5477,4,9,9,8,52,44,8,36
Cliftonville,5477,5,9,4,13,34,34,0,31
Ballymena,5477,6,7,4,15,26,51,-25,25
Glentoran,5477,7,6,6,10,24,32,-8,24
Dungannon,5477,8,2,4,16,14,47,-33,10
Crusaders,5478,1,17,6,3,65,30,35,57
Coleraine,5478,2,15,10,1,45,23,22,55
Glenavon,5478,3,9,9,8,53,45,8,36
Linfield,5478,4,10,6,10,38,37,1,36
Cliftonville,5478,5,9,5,12,33,32,1,32
Ballymena,5478,6,7,4,15,25,51,-26,25
Glentoran,5478,7,6,6,10,24,32,-8,24
Dungannon,5478,8,2,4,16,14,47,-33,10
Crusaders,5479,1,17,6,3,63,30,33,57
Coleraine,5479,2,14,10,2,44,24,20,52
Glenavon,5479,3,10,9,7,54,44,10,39
Linfield,5479,4,10,6,10,38,37,1,36
Cliftonville,5479,5,9,5,12,33,32,1,32
Ballymena,5479,6,7,4,15,25,49,-24,25
Glentoran,5479,7,6,6,10,24,32,-8,24
Dungannon,5479,8,2,4,16,14,47,-33,10
Crusaders,5480,1,16,6,4,62,34,28,54
Coleraine,5480,2,14,10,2,44,26,18,52
Glenavon,5480,3,10,9,7,56,44,12,39
Linfield,5480,4,11,5,10,39,36,3,38
Cliftonville,5480,5,9,4,13,32,33,-1,31
Ballymena,5480,6,8,4,14,29,48,-19,28
Glentoran,5480,7,6,6,10,24,32,-8,24
Dungannon,5480,8,2,4,16,14,47,-33,10
Crusaders,5481,1,16,6,4,63,34,29,54
Coleraine,5481,2,14,11,1,44,23,21,53
Glenavon,5481,3,9,10,7,53,44,9,37
Linfield,5481,4,10,5,11,38,38,0,35
Cliftonville,5481,5,10,4,12,34,32,2,34
Ballymena,5481,6,8,4,14,29,49,-20,28
Glentoran,5481,7,6,6,10,24,32,-8,24
Dungannon,5481,8,2,4,16,14,47,-33,10
Crusaders,5482,1,16,6,4,62,32,30,54
Coleraine,5482,2,14,11,1,46,25,21,53
Linfield,5482,3,11,5,10,38,36,2,38
Glenavon,5482,4,9,10,7,55,46,9,37
Cliftonville,5482,5,9,4,13,32,32,0,31
Ballymena,5482,6,8,4,14,27,48,-21,28
Glentoran,5482,7,6,6,10,24,32,-8,24
Dungannon,5482,8,2,4,16,14,47,-33,10
Crusaders,5483,1,17,6,3,65,31,34,57
Coleraine,5483,2,15,10,1,44,22,22,55
Linfield,5483,3,11,5,10,38,36,2,38
Glenavon,5483,4,9,9,8,52,44,8,36
Cliftonville,5483,5,9,4,13,32,32,0,31
Ballymena,5483,6,7,4,15,26,51,-25,25
Glentoran,5483,7,6,6,10,24,32,-8,24
Dungannon,5483,8,2,4,16,14,47,-33,10
Crusaders,5484,1,17,6,3,62,30,32,57
Coleraine,5484,2,15,10,1,45,22,23,55
Linfield,5484,3,11,5,10,40,36,4,38
Glenavon,5484,4,9,9,8,52,45,7,36
Cliftonville,5484,5,9,4,13,32,34,-2,31
Ballymena,5484,6,7,4,15,25,48,-23,25
Glentoran,5484,7,6,6,10,24,32,-8,24
Dungannon,5484,8,2,4,16,14,47,-33,10
Coleraine,5485,1,15,10,1,45,23,22,55
Crusaders,5485,2,16,6,4,63,34,29,54
Linfield,5485,3,11,5,10,39,36,3,38
Glenavon,5485,4,9,9,8,53,45,8,36
Cliftonville,5485,5,9,4,13,32,33,-1,31
Ballymena,5485,6,8,4,14,29,49,-20,28
Glentoran,5485,7,6,6,10,24,32,-8,24
Dungannon,5485,8,2,4,16,14,47,-33,10
Crusaders,5486,1,17,6,3,63,31,32,57
Coleraine,5486,2,14,10,2,43,25,18,52
Glenavon,5486,3,10,9,7,55,43,12,39
Linfield,5486,4,11,5,10,39,37,2,38
Cliftonville,5486,5,9,4,13,33,33,0,31
Ballymena,5486,6,7,4,15,26,49,-23,25
Glentoran,5486,7,6,6,10,24,32,-8,24
Dungannon,5486,8,2,4,16,14,47,-33,10
Crusaders,5487,1,16,7,3,61,30,31,55
Coleraine,5487,2,14,11,1,43,22,21,53
Glenavon,5487,3,9,10,7,52,43,9,37
Linfield,5487,4,10,6,10,37,36,1,36
Cliftonville,5487,5,9,5,12,32,31,1,32
Ballymena,5487,6,7,5,14,25,47,-22,26
Glentoran,5487,7,6,6,10,24,32,-8,24
Dungannon,5487,8,2,4,16,14,47,-33,10
Crusaders,5488,1,16,7,3,63,32,31,55
Coleraine,5488,2,14,10,2,44,28,16,52
Glenavon,5488,3,10,9,7,58,44,14,39
Linfield,5488,4,10,5,11,38,38,0,35
Cliftonville,5488,5,10,4,12,34,32,2,34
Ballymena,5488,6,7,5,14,27,49,-22,26
Glentoran,5488,7,6,6,10,24,32,-8,24
Dungannon,5488,8,2,4,16,14,47,-33,10
Crusaders,5489,1,17,6,3,63,31,32,57
Coleraine,5489,2,14,10,2,45,28,17,52
Glenavon,5489,3,10,9,7,58,45,13,39
Linfield,5489,4,10,6,10,37,36,1,36
Cliftonville,5489,5,9,5,12,32,31,1,32
Ballymena,5489,6,7,4,15,26,49,-23,25
Glentoran,5489,7,6,6,10,24,32,-8,24
Dungannon,5489,8,2,4,16,14,47,-33,10
Crusaders,5490,1,17,6,3,62,30,32,57
Coleraine,5490,2,14,10,2,44,24,20,52
Glenavon,5490,3,10,9,7,54,44,10,39
Linfield,5490,4,10,6,10,38,37,1,36
Cliftonville,5490,5,9,5,12,33,32,1,32
Ballymena,5490,6,7,4,15,25,48,-23,25
Glentoran,5490,7,6,6,10,24,32,-8,24
Dungannon,5490,8,2,4,16,14,47,-33,10
Crusaders,5491,1,17,6,3,63,30,33,57
Coleraine,5491,2,14,10,2,43,25,18,52
Glenavon,5491,3,10,9,7,55,43,12,39
Linfield,5491,4,10,5,11,37,37,0,35
Cliftonville,5491,5,10,4,12,33,31,2,34
Ballymena,5491,6,7,4,15,25,49,-24,25
Glentoran,5491,7,6,6,10,24,32,-8,24
Dungannon,5491,8,2,4,16,14,47,-33,10
Crusaders,5492,1,17,6,3,62,30,32,57
Coleraine,5492,2,14,10,2,43,25,18,52
Glenavon,5492,3,10,9,7,55,43,12,39
Linfield,5492,4,10,6,10,38,37,1,36
Cliftonville,5492,5,9,5,12,33,32,1,32
Ballymena,5492,6,7,4,15,25,48,-23,25
Glentoran,5492,7,6,6,10,24,32,-8,24
Dungannon,5492,8,2,4,16,14,47,-33,10
Crusaders,5493,1,16,6,4,62,32,30,54
Coleraine,5493,2,14,11,1,45,24,21,53
Glenavon,5493,3,9,10,7,54,45,9,37
Linfield,5493,4,10,5,11,37,37,0,35
Cliftonville,5493,5,10,4,12,33,31,2,34
Ballymena,5493,6,8,4,14,27,48,-21,28
Glentoran,5493,7,6,6,10,24,32,-8,24
Dungannon,5493,8,2,4,16,14,47,-33,10
Crusaders,5494,1,16,6,4,61,31,30,54
Coleraine,5494,2,14,11,1,43,22,21,53
Linfield,5494,3,11,5,10,40,36,4,38
Glenavon,5494,4,9,10,7,52,43,9,37
Cliftonville,5494,5,9,4,13,32,34,-2,31
Ballymena,5494,6,8,4,14,26,47,-21,28
Glentoran,5494,7,6,6,10,24,32,-8,24
Dungannon,5494,8,2,4,16,14,47,-33,10
Crusaders,5495,1,17,6,3,66,32,34,57
Coleraine,5495,2,15,10,1,46,24,22,55
Glenavon,5495,3,9,9,8,54,46,8,36
Linfield,5495,4,10,5,11,37,38,-1,35
Cliftonville,5495,5,10,4,12,34,31,3,34
Ballymena,5495,6,7,4,15,27,52,-25,25
Glentoran,5495,7,6,6,10,24,32,-8,24
Dungannon,5495,8,2,4,16,14,47,-33,10
Crusaders,5496,1,17,6,3,64,30,34,57
Coleraine,5496,2,15,10,1,46,22,24,55
Glenavon,5496,3,9,9,8,52,46,6,36
Linfield,5496,4,10,6,10,40,39,1,36
Cliftonville,5496,5,9,5,12,35,34,1,32
Ballymena,5496,6,7,4,15,25,50,-25,25
Glentoran,5496,7,6,6,10,24,32,-8,24
Dungannon,5496,8,2,4,16,14,47,-33,10
Crusaders,5497,1,17,6,3,67,33,34,57
Coleraine,5497,2,14,10,2,43,24,19,52
Glenavon,5497,3,10,9,7,54,43,11,39
Linfield,5497,4,10,5,11,37,37,0,35
Cliftonville,5497,5,10,4,12,33,31,2,34
Ballymena,5497,6,7,4,15,28,53,-25,25
Glentoran,5497,7,6,6,10,24,32,-8,24
Dungannon,5497,8,2,4,16,14,47,-33,10
Crusaders,5498,1,17,6,3,64,31,33,57
Coleraine,5498,2,14,10,2,43,23,20,52
Glenavon,5498,3,10,9,7,53,43,10,39
Linfield,5498,4,11,5,10,39,37,2,38
Cliftonville,5498,5,9,4,13,33,33,0,31
Ballymena,5498,6,7,4,15,26,50,-24,25
Glentoran,5498,7,6,6,10,24,32,-8,24
Dungannon,5498,8,2,4,16,14,47,-33,10
Crusaders,5499,1,17,6,3,66,31,35,57
Coleraine,5499,2,14,10,2,43,26,17,52
Glenavon,5499,3,10,9,7,56,43,13,39
Linfield,5499,4,11,5,10,38,36,2,38
Cliftonville,5499,5,9,4,13,32,32,0,31
Ballymena,5499,6,7,4,15,26,52,-26,25
Glentoran,5499,7,6,6,10,24,32,-8,24
Dungannon,5499,8,2,4,16,14,47,-33,10
Crusaders,5500,1,16,6,4,63,33,30,54
Coleraine,5500,2,14,10,2,43,23,20,52
Glenavon,5500,3,10,9,7,53,43,10,39
Linfield,5500,4,10,5,11,38,38,0,35
Cliftonville,5500,5,10,4,12,34,32,2,34
Ballymena,5500,6,8,4,14,28,49,-21,28
Glentoran,5500,7,6,6,10,24,32,-8,24
Dungannon,5500,8,2,4,16,14,47,-33,10
Crusaders,5501,1,17,6,3,62,30,32,57
Coleraine,5501,2,15,10,1,45,23,22,55
Linfield,5501,3,11,5,10,40,37,3,38
Glenavon,5501,4,9,9,8,53,45,8,36
Cliftonville,5501,5,9,4,13,33,34,-1,31
Ballymena,5501,6,7,4,15,25,48,-23,25
Glentoran,5501,7,6,6,10,24,32,-8,24
Dungannon,5501,8,2,4,16,14,47,-33,10
Crusaders,5502,1,16,6,4,63,35,28,54
Coleraine,5502,2,14,10,2,43,23,20,52
Glenavon,5502,3,10,9,7,53,43,10,39
Linfield,5502,4,10,6,10,38,37,1,36
Cliftonville,5502,5,9,5,12,33,32,1,32
Ballymena,5502,6,8,4,14,30,49,-19,28
Glentoran,5502,7,6,6,10,24,32,-8,24
Dungannon,5502,8,2,4,16,14,47,-33,10
Crusaders,5503,1,17,6,3,66,31,35,57
Coleraine,5503,2,14,10,2,44,24,20,52
Glenavon,5503,3,10,9,7,54,44,10,39
Linfield,5503,4,11,5,10,40,37,3,38
Cliftonville,5503,5,9,4,13,33,34,-1,31
Ballymena,5503,6,7,4,15,26,52,-26,25
Glentoran,5503,7,6,6,10,24,32,-8,24
Dungannon,5503,8,2,4,16,14,47,-33,10
Crusaders,5504,1,16,7,3,61,30,31,55
Coleraine,5504,2,14,11,1,45,24,21,53
Glenavon,5504,3,9,10,7,54,45,9,37
Linfield,5504,4,10,5,11,37,38,-1,35
Cliftonville,5504,5,10,4,12,34,31,3,34
Ballymena,5504,6,7,5,14,25,47,-22,26
Glentoran,5504,7,6,6,10,24,32,-8,24
Dungannon,5504,8,2,4,16,14,47,-33,10
Crusaders,5505,1,17,6,3,63,31,32,57
Coleraine,5505,2,14,10,2,44,24,20,52
Glenavon,5505,3,10,9,7,54,44,10,39
Linfield,5505,4,11,5,10,38,36,2,38
Cliftonville,5505,5,9,4,13,32,32,0,31
Ballymena,5505,6,7,4,15,26,49,-23,25
Glentoran,5505,7,6,6,10,24,32,-8,24
Dungannon,5505,8,2,4,16,14,47,-33,10
Crusaders,5506,1,17,6,3,65,31,34,57
Coleraine,5506,2,14,10,2,44,29,15,52
Glenavon,5506,3,10,9,7,59,44,15,39
Linfield,5506,4,11,5,10,39,36,3,38
Cliftonville,5506,5,9,4,13,32,33,-1,31
Ballymena,5506,6,7,4,15,26,51,-25,25
Glentoran,5506,7,6,6,10,24,32,-8,24
Dungannon,5506,8,2,4,16,14,47,-33,10
Crusaders,5507,1,17,6,3,63,30,33,57
Coleraine,5507,2,14,10,2,43,24,19,52
Glenavon,5507,3,10,9,7,54,43,11,39
Linfield,5507,4,10,6,10,37,36,1,36
Cliftonville,5507,5,9,5,12,32,31,1,32
Ballymena,5507,6,7,4,15,25,49,-24,25
Glentoran,5507,7,6,6,10,24,32,-8,24
Dungannon,5507,8,2,4,16,14,47,-33,10
Coleraine,5508,1,15,10,1,48,24,24,55
Crusaders,5508,2,16,6,4,61,31,30,54
Linfield,5508,3,11,5,10,39,36,3,38
Glenavon,5508,4,9,9,8,54,48,6,36
Cliftonville,5508,5,9,4,13,32,33,-1,31
Ballymena,5508,6,8,4,14,26,47,-21,28
Glentoran,5508,7,6,6,10,24,32,-8,24
Dungannon,5508,8,2,4,16,14,47,-33,10
Crusaders,5509,1,17,6,3,65,30,35,57
Coleraine,5509,2,14,10,2,44,25,19,52
Glenavon,5509,3,10,9,7,55,44,11,39
Linfield,5509,4,10,6,10,38,37,1,36
Cliftonville,5509,5,9,5,12,33,32,1,32
Ballymena,5509,6,7,4,15,25,51,-26,25
Glentoran,5509,7,6,6,10,24,32,-8,24
Dungannon,5509,8,2,4,16,14,47,-33,10
Crusaders,5510,1,16,6,4,61,32,29,54
Coleraine,5510,2,14,10,2,43,24,19,52
Glenavon,5510,3,10,9,7,54,43,11,39
Linfield,5510,4,10,5,11,37,37,0,35
Cliftonville,5510,5,10,4,12,33,31,2,34
Ballymena,5510,6,8,4,14,27,47,-20,28
Glentoran,5510,7,6,6,10,24,32,-8,24
Dungannon,5510,8,2,4,16,14,47,-33,10
Crusaders,5511,1,16,7,3,64,33,31,55
Coleraine,5511,2,15,10,1,45,22,23,55
Linfield,5511,3,11,5,10,40,37,3,38
Glenavon,5511,4,9,9,8,52,45,7,36
Cliftonville,5511,5,9,4,13,33,34,-1,31
Ballymena,5511,6,7,5,14,28,50,-22,26
Glentoran,5511,7,6,6,10,24,32,-8,24
Dungannon,5511,8,2,4,16,14,47,-33,10
Crusaders,5512,1,17,6,3,65,31,34,57
Coleraine,5512,2,15,10,1,44,22,22,55
Linfield,5512,3,11,5,10,40,36,4,38
Glenavon,5512,4,9,9,8,52,44,8,36
Cliftonville,5512,5,9,4,13,32,34,-2,31
Ballymena,5512,6,7,4,15,26,51,-25,25
Glentoran,5512,7,6,6,10,24,32,-8,24
Dungannon,5512,8,2,4,16,14,47,-33,10
Crusaders,5513,1,16,7,3,61,30,31,55
Coleraine,5513,2,15,10,1,45,22,23,55
Glenavon,5513,3,9,9,8,52,45,7,36
Linfield,5513,4,10,6,10,39,38,1,36
Cliftonville,5513,5,9,5,12,34,33,1,32
Ballymena,5513,6,7,5,14,25,47,-22,26
Glentoran,5513,7,6,6,10,24,32,-8,24
Dungannon,5513,8,2,4,16,14,47,-33,10
Crusaders,5514,1,16,7,3,62,31,31,55
Coleraine,5514,2,15,10,1,47,25,22,55
Glenavon,5514,3,9,9,8,55,47,8,36
Linfield,5514,4,10,6,10,39,38,1,36
Cliftonville,5514,5,9,5,12,34,33,1,32
Ballymena,5514,6,7,5,14,26,48,-22,26
Glentoran,5514,7,6,6,10,24,32,-8,24
Dungannon,5514,8,2,4,16,14,47,-33,10
Coleraine,5515,1,15,10,1,48,25,23,55
Crusaders,5515,2,16,6,4,62,32,30,54
Linfield,5515,3,11,5,10,39,36,3,38
Glenavon,5515,4,9,9,8,55,48,7,36
Cliftonville,5515,5,9,4,13,32,33,-1,31
Ballymena,5515,6,8,4,14,27,48,-21,28
Glentoran,5515,7,6,6,10,24,32,-8,24
Dungannon,5515,8,2,4,16,14,47,-33,10
Crusaders,5516,1,16,6,4,63,33,30,54
Coleraine,5516,2,14,10,2,46,26,20,52
Glenavon,5516,3,10,9,7,56,46,10,39
Linfield,5516,4,11,5,10,40,37,3,38
Cliftonville,5516,5,9,4,13,33,34,-1,31
Ballymena,5516,6,8,4,14,28,49,-21,28
Glentoran,5516,7,6,6,10,24,32,-8,24
Dungannon,5516,8,2,4,16,14,47,-33,10
Crusaders,5517,1,16,7,3,64,33,31,55
Coleraine,5517,2,14,11,1,45,24,21,53
Linfield,5517,3,11,5,10,40,36,4,38
Glenavon,5517,4,9,10,7,54,45,9,37
Cliftonville,5517,5,9,4,13,32,34,-2,31
Ballymena,5517,6,7,5,14,28,50,-22,26
Glentoran,5517,7,6,6,10,24,32,-8,24
Dungannon,5517,8,2,4,16,14,47,-33,10
Crusaders,5518,1,17,6,3,63,31,32,57
Coleraine,5518,2,14,10,2,43,24,19,52
Glenavon,5518,3,10,9,7,54,43,11,39
Linfield,5518,4,10,6,10,38,37,1,36
Cliftonville,5518,5,9,5,12,33,32,1,32
Ballymena,5518,6,7,4,15,26,49,-23,25
Glentoran,5518,7,6,6,10,24,32,-8,24
Dungannon,5518,8,2,4,16,14,47,-33,10
Crusaders,5519,1,17,6,3,63,31,32,57
Coleraine,5519,2,14,10,2,44,26,18,52
Glenavon,5519,3,10,9,7,56,44,12,39
Linfield,5519,4,10,6,10,37,36,1,36
Cliftonville,5519,5,9,5,12,32,31,1,32
Ballymena,5519,6,7,4,15,26,49,-23,25
Glentoran,5519,7,6,6,10,24,32,-8,24
Dungannon,5519,8,2,4,16,14,47,-33,10
Crusaders,5520,1,17,6,3,62,30,32,57
Coleraine,5520,2,15,10,1,45,23,22,55
Linfield,5520,3,11,5,10,38,36,2,38
Glenavon,5520,4,9,9,8,53,45,8,36
Cliftonville,5520,5,9,4,13,32,32,0,31
Ballymena,5520,6,7,4,15,25,48,-23,25
Glentoran,5520,7,6,6,10,24,32,-8,24
Dungannon,5520,8,2,4,16,14,47,-33,10
Crusaders,5521,1,16,7,3,61,30,31,55
Coleraine,5521,2,14,10,2,43,23,20,52
Glenavon,5521,3,10,9,7,53,43,10,39
Linfield,5521,4,11,5,10,39,37,2,38
Cliftonville,5521,5,9,4,13,33,33,0,31
Ballymena,5521,6,7,5,14,25,47,-22,26
Glentoran,5521,7,6,6,10,24,32,-8,24
Dungannon,5521,8,2,4,16,14,47,-33,10
Crusaders,5522,1,16,7,3,62,31,31,55
Coleraine,5522,2,15,10,1,46,23,23,55
Linfield,5522,3,11,5,10,39,37,2,38
Glenavon,5522,4,9,9,8,53,46,7,36
Cliftonville,5522,5,9,4,13,33,33,0,31
Ballymena,5522,6,7,5,14,26,48,-22,26
Glentoran,5522,7,6,6,10,24,32,-8,24
Dungannon,5522,8,2,4,16,14,47,-33,10
Crusaders,5523,1,16,7,3,61,30,31,55
Coleraine,5523,2,14,10,2,44,24,20,52
Glenavon,5523,3,10,9,7,54,44,10,39
Linfield,5523,4,10,6,10,38,37,1,36
Cliftonville,5523,5,9,5,12,33,32,1,32
Ballymena,5523,6,7,5,14,25,47,-22,26
Glentoran,5523,7,6,6,10,24,32,-8,24
Dungannon,5523,8,2,4,16,14,47,-33,10
Crusaders,5524,1,16,6,4,61,31,30,54
Coleraine,5524,2,14,10,2,45,25,20,52
Glenavon,5524,3,10,9,7,55,45,10,39
Linfield,5524,4,10,6,10,38,37,1,36
Cliftonville,5524,5,9,5,12,33,32,1,32
Ballymena,5524,6,8,4,14,26,47,-21,28
Glentoran,5524,7,6,6,10,24,32,-8,24
Dungannon,5524,8,2,4,16,14,47,-33,10
Crusaders,5525,1,16,7,3,63,32,31,55
Coleraine,5525,2,15,10,1,47,25,22,55
Linfield,5525,3,11,5,10,39,36,3,38
Glenavon,5525,4,9,9,8,55,47,8,36
Cliftonville,5525,5,9,4,13,32,33,-1,31
Ballymena,5525,6,7,5,14,27,49,-22,26
Glentoran,5525,7,6,6,10,24,32,-8,24
Dungannon,5525,8,2,4,16,14,47,-33,10
Crusaders,5526,1,16,7,3,63,32,31,55
Coleraine,5526,2,15,10,1,46,23,23,55
Glenavon,5526,3,9,9,8,53,46,7,36
Linfield,5526,4,10,5,11,37,37,0,35
Cliftonville,5526,5,10,4,12,33,31,2,34
Ballymena,5526,6,7,5,14,27,49,-22,26
Glentoran,5526,7,6,6,10,24,32,-8,24
Dungannon,5526,8,2,4,16,14,47,-33,10
Coleraine,5527,1,15,10,1,45,22,23,55
Crusaders,5527,2,16,6,4,61,31,30,54
Glenavon,5527,3,9,9,8,52,45,7,36
Linfield,5527,4,10,5,11,38,38,0,35
Cliftonville,5527,5,10,4,12,34,32,2,34
Ballymena,5527,6,8,4,14,26,47,-21,28
Glentoran,5527,7,6,6,10,24,32,-8,24
Dungannon,5527,8,2,4,16,14,47,-33,10
Crusaders,5528,1,16,7,3,62,31,31,55
Coleraine,5528,2,14,10,2,44,25,19,52
Glenavon,5528,3,10,9,7,55,44,11,39
Linfield,5528,4,10,5,11,37,37,0,35
Cliftonville,5528,5,10,4,12,33,31,2,34
Ballymena,5528,6,7,5,14,26,48,-22,26
Glentoran,5528,7,6,6,10,24,32,-8,24
Dungannon,5528,8,2,4,16,14,47,-33,10
Crusaders,5529,1,16,6,4,62,32,30,54
Coleraine,5529,2,14,10,2,44,26,18,52
Glenavon,5529,3,10,9,7,56,44,12,39
Linfield,5529,4,11,5,10,40,37,3,38
Cliftonville,5529,5,9,4,13,33,34,-1,31
Ballymena,5529,6,8,4,14,27,48,-21,28
Glentoran,5529,7,6,6,10,24,32,-8,24
Dungannon,5529,8,2,4,16,14,47,-33,10
Crusaders,5530,1,17,6,3,62,30,32,57
Coleraine,5530,2,15,10,1,46,23,23,55
Glenavon,5530,3,9,9,8,53,46,7,36
Linfield,5530,4,10,6,10,38,37,1,36
Cliftonville,5530,5,9,5,12,33,32,1,32
Ballymena,5530,6,7,4,15,25,48,-23,25
Glentoran,5530,7,6,6,10,24,32,-8,24
Dungannon,5530,8,2,4,16,14,47,-33,10
Crusaders,5531,1,17,6,3,62,30,32,57
Coleraine,5531,2,15,10,1,46,23,23,55
Glenavon,5531,3,9,9,8,53,46,7,36
Linfield,5531,4,10,6,10,38,37,1,36
Cliftonville,5531,5,9,5,12,33,32,1,32
Ballymena,5531,6,7,4,15,25,48,-23,25
Glentoran,5531,7,6,6,10,24,32,-8,24
Dungannon,5531,8,2,4,16,14,47,-33,10
Crusaders,5532,1,17,6,3,67,32,35,57
Coleraine,5532,2,15,10,1,46,23,23,55
Linfield,5532,3,11,5,10,38,36,2,38
Glenavon,5532,4,9,9,8,53,46,7,36
Cliftonville,5532,5,9,4,13,32,32,0,31
Ballymena,5532,6,7,4,15,27,53,-26,25
Glentoran,5532,7,6,6,10,24,32,-8,24
Dungannon,5532,8,2,4,16,14,47,-33,10
Crusaders,5533,1,17,6,3,66,31,35,57
Coleraine,5533,2,14,10,2,44,24,20,52
Glenavon,5533,3,10,9,7,54,44,10,39
Linfield,5533,4,11,5,10,40,37,3,38
Cliftonville,5533,5,9,4,13,33,34,-1,31
Ballymena,5533,6,7,4,15,26,52,-26,25
Glentoran,5533,7,6,6,10,24,32,-8,24
Dungannon,5533,8,2,4,16,14,47,-33,10
Crusaders,5534,1,16,7,3,63,32,31,55
Coleraine,5534,2,14,11,1,44,23,21,53
Linfield,5534,3,11,5,10,38,36,2,38
Glenavon,5534,4,9,10,7,53,44,9,37
Cliftonville,5534,5,9,4,13,32,32,0,31
Ballymena,5534,6,7,5,14,27,49,-22,26
Glentoran,5534,7,6,6,10,24,32,-8,24
Dungannon,5534,8,2,4,16,14,47,-33,10
Crusaders,5535,1,17,6,3,63,30,33,57
Coleraine,5535,2,15,10,1,47,24,23,55
Glenavon,5535,3,9,9,8,54,47,7,36
Linfield,5535,4,10,5,11,38,38,0,35
Cliftonville,5535,5,10,4,12,34,32,2,34
Ballymena,5535,6,7,4,15,25,49,-24,25
Glentoran,5535,7,6,6,10,24,32,-8,24
Dungannon,5535,8,2,4,16,14,47,-33,10
Crusaders,5536,1,16,6,4,62,32,30,54
Coleraine,5536,2,14,10,2,45,27,18,52
Glenavon,5536,3,10,9,7,57,45,12,39
Linfield,5536,4,11,5,10,38,36,2,38
Cliftonville,5536,5,9,4,13,32,32,0,31
Ballymena,5536,6,8,4,14,27,48,-21,28
Glentoran,5536,7,6,6,10,24,32,-8,24
Dungannon,5536,8,2,4,16,14,47,-33,10
Crusaders,5537,1,17,6,3,64,31,33,57
Coleraine,5537,2,14,10,2,44,24,20,52
Glenavon,5537,3,10,9,7,54,44,10,39
Linfield,5537,4,10,6,10,38,37,1,36
Cliftonville,5537,5,9,5,12,33,32,1,32
Ballymena,5537,6,7,4,15,26,50,-24,25
Glentoran,5537,7,6,6,10,24,32,-8,24
Dungannon,5537,8,2,4,16,14,47,-33,10
Crusaders,5538,1,17,6,3,65,30,35,57
Coleraine,5538,2,14,11,1,44,23,21,53
Glenavon,5538,3,9,10,7,53,44,9,37
Linfield,5538,4,10,5,11,38,38,0,35
Cliftonville,5538,5,10,4,12,34,32,2,34
Ballymena,5538,6,7,4,15,25,51,-26,25
Glentoran,5538,7,6,6,10,24,32,-8,24
Dungannon,5538,8,2,4,16,14,47,-33,10
Coleraine,5539,1,15,10,1,44,22,22,55
Crusaders,5539,2,16,6,4,63,33,30,54
Linfield,5539,3,11,5,10,40,36,4,38
Glenavon,5539,4,9,9,8,52,44,8,36
Cliftonville,5539,5,9,4,13,32,34,-2,31
Ballymena,5539,6,8,4,14,28,49,-21,28
Glentoran,5539,7,6,6,10,24,32,-8,24
Dungannon,5539,8,2,4,16,14,47,-33,10
Coleraine,5540,1,15,10,1,46,24,22,55
Crusaders,5540,2,16,6,4,61,32,29,54
Linfield,5540,3,11,5,10,41,37,4,38
Glenavon,5540,4,9,9,8,54,46,8,36
Cliftonville,5540,5,9,4,13,33,35,-2,31
Ballymena,5540,6,8,4,14,27,47,-20,28
Glentoran,5540,7,6,6,10,24,32,-8,24
Dungannon,5540,8,2,4,16,14,47,-33,10
Crusaders,5541,1,16,7,3,62,31,31,55
Coleraine,5541,2,14,11,1,44,23,21,53
Glenavon,5541,3,9,10,7,53,44,9,37
Linfield,5541,4,10,5,11,38,38,0,35
Cliftonville,5541,5,10,4,12,34,32,2,34
Ballymena,5541,6,7,5,14,26,48,-22,26
Glentoran,5541,7,6,6,10,24,32,-8,24
Dungannon,5541,8,2,4,16,14,47,-33,10
Crusaders,5542,1,17,6,3,66,34,32,57
Coleraine,5542,2,14,10,2,43,23,20,52
Glenavon,5542,3,10,9,7,53,43,10,39
Linfield,5542,4,10,5,11,38,38,0,35
Cliftonville,5542,5,10,4,12,34,32,2,34
Ballymena,5542,6,7,4,15,29,52,-23,25
Glentoran,5542,7,6,6,10,24,32,-8,24
Dungannon,5542,8,2,4,16,14,47,-33,10
Crusaders,5543,1,17,6,3,62,30,32,57
Coleraine,5543,2,14,11,1,45,24,21,53
Glenavon,5543,3,9,10,7,54,45,9,37
Linfield,5543,4,10,5,11,37,38,-1,35
Cliftonville,5543,5,10,4,12,34,31,3,34
Ballymena,5543,6,7,4,15,25,48,-23,25
Glentoran,5543,7,6,6,10,24,32,-8,24
Dungannon,5543,8,2,4,16,14,47,-33,10
Crusaders,5544,1,17,6,3,64,32,32,57
Coleraine,5544,2,15,10,1,47,24,23,55
Linfield,5544,3,11,5,10,40,37,3,38
Glenavon,5544,4,9,9,8,54,47,7,36
Cliftonville,5544,5,9,4,13,33,34,-1,31
Ballymena,5544,6,7,4,15,27,50,-23,25
Glentoran,5544,7,6,6,10,24,32,-8,24
Dungannon,5544,8,2,4,16,14,47,-33,10
Crusaders,5545,1,17,6,3,63,31,32,57
Coleraine,5545,2,14,10,2,43,24,19,52
Glenavon,5545,3,10,9,7,54,43,11,39
Linfield,5545,4,11,5,10,39,37,2,38
Cliftonville,5545,5,9,4,13,33,33,0,31
Ballymena,5545,6,7,4,15,26,49,-23,25
Glentoran,5545,7,6,6,10,24,32,-8,24
Dungannon,5545,8,2,4,16,14,47,-33,10
Crusaders,5546,1,17,6,3,62,30,32,57
Coleraine,5546,2,14,10,2,44,25,19,52
Glenavon,5546,3,10,9,7,55,44,11,39
Linfield,5546,4,11,5,10,40,36,4,38
Cliftonville,5546,5,9,4,13,32,34,-2,31
Ballymena,5546,6,7,4,15,25,48,-23,25
Glentoran,5546,7,6,6,10,24,32,-8,24
Dungannon,5546,8,2,4,16,14,47,-33,10
Crusaders,5547,1,17,6,3,66,31,35,57
Coleraine,5547,2,15,10,1,46,23,23,55
Linfield,5547,3,11,5,10,38,36,2,38
Glenavon,5547,4,9,9,8,53,46,7,36
Cliftonville,5547,5,9,4,13,32,32,0,31
Ballymena,5547,6,7,4,15,26,52,-26,25
Glentoran,5547,7,6,6,10,24,32,-8,24
Dungannon,5547,8,2,4,16,14,47,-33,10
Crusaders,5548,1,17,6,3,65,32,33,57
Coleraine,5548,2,15,10,1,44,22,22,55
Glenavon,5548,3,9,9,8,52,44,8,36
Linfield,5548,4,10,6,10,38,37,1,36
Cliftonville,5548,5,9,5,12,33,32,1,32
Ballymena,5548,6,7,4,15,27,51,-24,25
Glentoran,5548,7,6,6,10,24,32,-8,24
Dungannon,5548,8,2,4,16,14,47,-33,10
Crusaders,5549,1,16,7,3,63,32,31,55
Coleraine,5549,2,14,10,2,43,25,18,52
Glenavon,5549,3,10,9,7,55,43,12,39
Linfield,5549,4,11,5,10,40,38,2,38
Cliftonville,5549,5,9,4,13,34,34,0,31
Ballymena,5549,6,7,5,14,27,49,-22,26
Glentoran,5549,7,6,6,10,24,32,-8,24
Dungannon,5549,8,2,4,16,14,47,-33,10
Crusaders,5550,1,16,6,4,63,33,30,54
Coleraine,5550,2,14,10,2,44,26,18,52
Glenavon,5550,3,10,9,7,56,44,12,39
Linfield,5550,4,10,6,10,38,37,1,36
Cliftonville,5550,5,9,5,12,33,32,1,32
Ballymena,5550,6,8,4,14,28,49,-21,28
Glentoran,5550,7,6,6,10,24,32,-8,24
Dungannon,5550,8,2,4,16,14,47,-33,10
Crusaders,5551,1,17,6,3,62,30,32,57
Coleraine,5551,2,15,10,1,46,23,23,55
Glenavon,5551,3,9,9,8,53,46,7,36
Linfield,5551,4,10,6,10,38,37,1,36
Cliftonville,5551,5,9,5,12,33,32,1,32
Ballymena,5551,6,7,4,15,25,48,-23,25
Glentoran,5551,7,6,6,10,24,32,-8,24
Dungannon,5551,8,2,4,16,14,47,-33,10
Crusaders,5552,1,17,6,3,64,31,33,57
Coleraine,5552,2,14,10,2,44,24,20,52
Glenavon,5552,3,10,9,7,54,44,10,39
Linfield,5552,4,11,5,10,39,37,2,38
Cliftonville,5552,5,9,4,13,33,33,0,31
Ballymena,5552,6,7,4,15,26,50,-24,25
Glentoran,5552,7,6,6,10,24,32,-8,24
Dungannon,5552,8,2,4,16,14,47,-33,10
Crusaders,5553,1,17,6,3,62,30,32,57
Coleraine,5553,2,15,10,1,45,23,22,55
Glenavon,5553,3,9,9,8,53,45,8,36
Linfield,5553,4,10,6,10,38,37,1,36
Cliftonville,5553,5,9,5,12,33,32,1,32
Ballymena,5553,6,7,4,15,25,48,-23,25
Glentoran,5553,7,6,6,10,24,32,-8,24
Dungannon,5553,8,2,4,16,14,47,-33,10
Crusaders,5554,1,17,6,3,67,31,36,57
Coleraine,5554,2,14,11,1,43,22,21,53
Glenavon,5554,3,9,10,7,52,43,9,37
Linfield,5554,4,10,5,11,37,38,-1,35
Cliftonville,5554,5,10,4,12,34,31,3,34
Ballymena,5554,6,7,4,15,26,53,-27,25
Glentoran,5554,7,6,6,10,24,32,-8,24
Dungannon,5554,8,2,4,16,14,47,-33,10
Crusaders,5555,1,17,6,3,65,31,34,57
Coleraine,5555,2,15,10,1,46,23,23,55
Linfield,5555,3,11,5,10,39,37,2,38
Glenavon,5555,4,9,9,8,53,46,7,36
Cliftonville,5555,5,9,4,13,33,33,0,31
Ballymena,5555,6,7,4,15,26,51,-25,25
Glentoran,5555,7,6,6,10,24,32,-8,24
Dungannon,5555,8,2,4,16,14,47,-33,10
Crusaders,5556,1,16,6,4,62,33,29,54
Coleraine,5556,2,14,10,2,43,26,17,52
Glenavon,5556,3,10,9,7,56,43,13,39
Linfield,5556,4,10,6,10,38,37,1,36
Cliftonville,5556,5,9,5,12,33,32,1,32
Ballymena,5556,6,8,4,14,28,48,-20,28
Glentoran,5556,7,6,6,10,24,32,-8,24
Dungannon,5556,8,2,4,16,14,47,-33,10
Crusaders,5557,1,17,6,3,63,31,32,57
Coleraine,5557,2,14,10,2,45,26,19,52
Glenavon,5557,3,10,9,7,56,45,11,39
Linfield,5557,4,10,6,10,38,37,1,36
Cliftonville,5557,5,9,5,12,33,32,1,32
Ballymena,5557,6,7,4,15,26,49,-23,25
Glentoran,5557,7,6,6,10,24,32,-8,24
Dungannon,5557,8,2,4,16,14,47,-33,10
Crusaders,5558,1,16,6,4,62,36,26,54
Coleraine,5558,2,14,10,2,44,24,20,52
Glenavon,5558,3,10,9,7,54,44,10,39
Linfield,5558,4,11,5,10,39,37,2,38
Cliftonville,5558,5,9,4,13,33,33,0,31
Ballymena,5558,6,8,4,14,31,48,-17,28
Glentoran,5558,7,6,6,10,24,32,-8,24
Dungannon,5558,8,2,4,16,14,47,-33,10
Crusaders,5559,1,16,6,4,62,33,29,54
Coleraine,5559,2,14,11,1,43,22,21,53
Glenavon,5559,3,9,10,7,52,43,9,37
Linfield,5559,4,10,6,10,38,37,1,36
Cliftonville,5559,5,9,5,12,33,32,1,32
Ballymena,5559,6,8,4,14,28,48,-20,28
Glentoran,5559,7,6,6,10,24,32,-8,24
Dungannon,5559,8,2,4,16,14,47,-33,10
Coleraine,5560,1,15,10,1,46,23,23,55
Crusaders,5560,2,16,6,4,61,35,26,54
Linfield,5560,3,11,5,10,40,38,2,38
Glenavon,5560,4,9,9,8,53,46,7,36
Cliftonville,5560,5,9,4,13,34,34,0,31
Ballymena,5560,6,8,4,14,30,47,-17,28
Glentoran,5560,7,6,6,10,24,32,-8,24
Dungannon,5560,8,2,4,16,14,47,-33,10
Crusaders,5561,1,17,6,3,64,31,33,57
Coleraine,5561,2,14,11,1,43,22,21,53
Glenavon,5561,3,9,10,7,52,43,9,37
Linfield,5561,4,10,6,10,38,37,1,36
Cliftonville,5561,5,9,5,12,33,32,1,32
Ballymena,5561,6,7,4,15,26,50,-24,25
Glentoran,5561,7,6,6,10,24,32,-8,24
Dungannon,5561,8,2,4,16,14,47,-33,10
Crusaders,5562,1,16,7,3,62,31,31,55
Coleraine,5562,2,14,11,1,45,24,21,53
Glenavon,5562,3,9,10,7,54,45,9,37
Linfield,5562,4,10,6,10,39,38,1,36
Cliftonville,5562,5,9,5,12,34,33,1,32
Ballymena,5562,6,7,5,14,26,48,-22,26
Glentoran,5562,7,6,6,10,24,32,-8,24
Dungannon,5562,8,2,4,16,14,47,-33,10
Crusaders,5563,1,16,7,3,63,32,31,55
Coleraine,5563,2,15,10,1,47,25,22,55
Linfield,5563,3,11,5,10,39,37,2,38
Glenavon,5563,4,9,9,8,55,47,8,36
Cliftonville,5563,5,9,4,13,33,33,0,31
Ballymena,5563,6,7,5,14,27,49,-22,26
Glentoran,5563,7,6,6,10,24,32,-8,24
Dungannon,5563,8,2,4,16,14,47,-33,10
Crusaders,5564,1,17,6,3,64,31,33,57
Coleraine,5564,2,15,10,1,46,22,24,55
Linfield,5564,3,11,5,10,39,36,3,38
Glenavon,5564,4,9,9,8,52,46,6,36
Cliftonville,5564,5,9,4,13,32,33,-1,31
Ballymena,5564,6,7,4,15,26,50,-24,25
Glentoran,5564,7,6,6,10,24,32,-8,24
Dungannon,5564,8,2,4,16,14,47,-33,10
Crusaders,5565,1,16,7,3,62,31,31,55
Coleraine,5565,2,14,10,2,43,24,19,52
Glenavon,5565,3,10,9,7,54,43,11,39
Linfield,5565,4,11,5,10,41,36,5,38
Cliftonville,5565,5,9,4,13,32,35,-3,31
Ballymena,5565,6,7,5,14,26,48,-22,26
Glentoran,5565,7,6,6,10,24,32,-8,24
Dungannon,5565,8,2,4,16,14,47,-33,10
Crusaders,5566,1,17,6,3,66,32,34,57
Coleraine,5566,2,14,10,2,44,24,20,52
Glenavon,5566,3,10,9,7,54,44,10,39
Linfield,5566,4,10,6,10,38,37,1,36
Cliftonville,5566,5,9,5,12,33,32,1,32
Ballymena,5566,6,7,4,15,27,52,-25,25
Glentoran,5566,7,6,6,10,24,32,-8,24
Dungannon,5566,8,2,4,16,14,47,-33,10
Crusaders,5567,1,16,7,3,63,32,31,55
Coleraine,5567,2,15,10,1,45,22,23,55
Glenavon,5567,3,9,9,8,52,45,7,36
Linfield,5567,4,10,5,11,37,37,0,35
Cliftonville,5567,5,10,4,12,33,31,2,34
Ballymena,5567,6,7,5,14,27,49,-22,26
Glentoran,5567,7,6,6,10,24,32,-8,24
Dungannon,5567,8,2,4,16,14,47,-33,10
Crusaders,5568,1,17,6,3,65,33,32,57
Coleraine,5568,2,15,10,1,45,23,22,55
Glenavon,5568,3,9,9,8,53,45,8,36
Linfield,5568,4,10,5,11,38,38,0,35
Cliftonville,5568,5,10,4,12,34,32,2,34
Ballymena,5568,6,7,4,15,28,51,-23,25
Glentoran,5568,7,6,6,10,24,32,-8,24
Dungannon,5568,8,2,4,16,14,47,-33,10
Crusaders,5569,1,17,6,3,64,30,34,57
Coleraine,5569,2,14,10,2,43,24,19,52
Glenavon,5569,3,10,9,7,54,43,11,39
Linfield,5569,4,10,5,11,37,38,-1,35
Cliftonville,5569,5,10,4,12,34,31,3,34
Ballymena,5569,6,7,4,15,25,50,-25,25
Glentoran,5569,7,6,6,10,24,32,-8,24
Dungannon,5569,8,2,4,16,14,47,-33,10
Crusaders,5570,1,16,7,3,61,30,31,55
Coleraine,5570,2,14,11,1,46,25,21,53
Glenavon,5570,3,9,10,7,55,46,9,37
Linfield,5570,4,10,6,10,38,37,1,36
Cliftonville,5570,5,9,5,12,33,32,1,32
Ballymena,5570,6,7,5,14,25,47,-22,26
Glentoran,5570,7,6,6,10,24,32,-8,24
Dungannon,5570,8,2,4,16,14,47,-33,10
Crusaders,5571,1,16,6,4,63,34,29,54
Coleraine,5571,2,14,10,2,44,24,20,52
Glenavon,5571,3,10,9,7,54,44,10,39
Linfield,5571,4,10,5,11,37,38,-1,35
Cliftonville,5571,5,10,4,12,34,31,3,34
Ballymena,5571,6,8,4,14,29,49,-20,28
Glentoran,5571,7,6,6,10,24,32,-8,24
Dungannon,5571,8,2,4,16,14,47,-33,10
Crusaders,5572,1,17,6,3,65,31,34,57
Coleraine,5572,2,15,10,1,44,22,22,55
Linfield,5572,3,11,5,10,39,36,3,38
Glenavon,5572,4,9,9,8,52,44,8,36
Cliftonville,5572,5,9,4,13,32,33,-1,31
Ballymena,5572,6,7,4,15,26,51,-25,25
Glentoran,5572,7,6,6,10,24,32,-8,24
Dungannon,5572,8,2,4,16,14,47,-33,10
Crusaders,5573,1,17,6,3,64,31,33,57
Coleraine,5573,2,14,11,1,44,23,21,53
Linfield,5573,3,11,5,10,39,37,2,38
Glenavon,5573,4,9,10,7,53,44,9,37
Cliftonville,5573,5,9,4,13,33,33,0,31
Ballymena,5573,6,7,4,15,26,50,-24,25
Glentoran,5573,7,6,6,10,24,32,-8,24
Dungannon,5573,8,2,4,16,14,47,-33,10
Coleraine,5574,1,15,10,1,45,23,22,55
Crusaders,5574,2,16,6,4,62,32,30,54
Glenavon,5574,3,9,9,8,53,45,8,36
Linfield,5574,4,10,5,11,38,38,0,35
Cliftonville,5574,5,10,4,12,34,32,2,34
Ballymena,5574,6,8,4,14,27,48,-21,28
Glentoran,5574,7,6,6,10,24,32,-8,24
Dungannon,5574,8,2,4,16,14,47,-33,10
Crusaders,5575,1,16,7,3,63,32,31,55
Coleraine,5575,2,14,11,1,43,22,21,53
Linfield,5575,3,11,5,10,38,36,2,38
Glenavon,5575,4,9,10,7,52,43,9,37
Cliftonville,5575,5,9,4,13,32,32,0,31
Ballymena,5575,6,7,5,14,27,49,-22,26
Glentoran,5575,7,6,6,10,24,32,-8,24
Dungannon,5575,8,2,4,16,14,47,-33,10
Crusaders,5576,1,17,6,3,63,30,33,57
Coleraine,5576,2,15,10,1,47,23,24,55
Linfield,5576,3,11,5,10,40,36,4,38
Glenavon,5576,4,9,9,8,53,47,6,36
Cliftonville,5576,5,9,4,13,32,34,-2,31
Ballymena,5576,6,7,4,15,25,49,-24,25
Glentoran,5576,7,6,6,10,24,32,-8,24
Dungannon,5576,8,2,4,16,14,47,-33,10
Crusaders,5577,1,16,7,3,62,31,31,55
Coleraine,5577,2,14,10,2,44,24,20,52
Glenavon,5577,3,10,9,7,54,44,10,39
Linfield,5577,4,10,5,11,38,38,0,35
Cliftonville,5577,5,10,4,12,34,32,2,34
Ballymena,5577,6,7,5,14,26,48,-22,26
Glentoran,5577,7,6,6,10,24,32,-8,24
Dungannon,5577,8,2,4,16,14,47,-33,10
Crusaders,5578,1,17,6,3,64,32,32,57
Coleraine,5578,2,14,10,2,45,26,19,52
Glenavon,5578,3,10,9,7,56,45,11,39
Linfield,5578,4,10,6,10,38,37,1,36
Cliftonville,5578,5,9,5,12,33,32,1,32
Ballymena,5578,6,7,4,15,27,50,-23,25
Glentoran,5578,7,6,6,10,24,32,-8,24
Dungannon,5578,8,2,4,16,14,47,-33,10
Crusaders,5579,1,16,7,3,61,30,31,55
Coleraine,5579,2,14,11,1,45,24,21,53
Glenavon,5579,3,9,10,7,54,45,9,37
Linfield,5579,4,10,6,10,37,36,1,36
Cliftonville,5579,5,9,5,12,32,31,1,32
Ballymena,5579,6,7,5,14,25,47,-22,26
Glentoran,5579,7,6,6,10,24,32,-8,24
Dungannon,5579,8,2,4,16,14,47,-33,10
Coleraine,5580,1,15,10,1,46,24,22,55
Crusaders,5580,2,16,6,4,62,32,30,54
Linfield,5580,3,11,5,10,39,36,3,38
Glenavon,5580,4,9,9,8,54,46,8,36
Cliftonville,5580,5,9,4,13,32,33,-1,31
Ballymena,5580,6,8,4,14,27,48,-21,28
Glentoran,5580,7,6,6,10,24,32,-8,24
Dungannon,5580,8,2,4,16,14,47,-33,10
Crusaders,5581,1,17,6,3,64,30,34,57
Coleraine,5581,2,14,10,2,44,25,19,52
Glenavon,5581,3,10,9,7,55,44,11,39
Linfield,5581,4,11,5,10,39,37,2,38
Cliftonville,5581,5,9,4,13,33,33,0,31
Ballymena,5581,6,7,4,15,25,50,-25,25
Glentoran,5581,7,6,6,10,24,32,-8,24
Dungannon,5581,8,2,4,16,14,47,-33,10
Crusaders,5582,1,16,7,3,64,33,31,55
Coleraine,5582,2,14,11,1,44,23,21,53
Glenavon,5582,3,9,10,7,53,44,9,37
Linfield,5582,4,10,5,11,37,37,0,35
Cliftonville,5582,5,10,4,12,33,31,2,34
Ballymena,5582,6,7,5,14,28,50,-22,26
Glentoran,5582,7,6,6,10,24,32,-8,24
Dungannon,5582,8,2,4,16,14,47,-33,10
Crusaders,5583,1,16,6,4,62,33,29,54
Coleraine,5583,2,14,10,2,44,25,19,52
Glenavon,5583,3,10,9,7,55,44,11,39
Linfield,5583,4,11,5,10,38,36,2,38
Cliftonville,5583,5,9,4,13,32,32,0,31
Ballymena,5583,6,8,4,14,28,48,-20,28
Glentoran,5583,7,6,6,10,24,32,-8,24
Dungannon,5583,8,2,4,16,14,47,-33,10
Crusaders,5584,1,16,7,3,62,31,31,55
Coleraine,5584,2,14,11,1,43,22,21,53
Linfield,5584,3,11,5,10,41,36,5,38
Glenavon,5584,4,9,10,7,52,43,9,37
Cliftonville,5584,5,9,4,13,32,35,-3,31
Ballymena,5584,6,7,5,14,26,48,-22,26
Glentoran,5584,7,6,6,10,24,32,-8,24
Dungannon,5584,8,2,4,16,14,47,-33,10
Crusaders,5585,1,16,6,4,61,32,29,54
Coleraine,5585,2,14,10,2,44,26,18,52
Glenavon,5585,3,10,9,7,56,44,12,39
Linfield,5585,4,10,6,10,37,36,1,36
Cliftonville,5585,5,9,5,12,32,31,1,32
Ballymena,5585,6,8,4,14,27,47,-20,28
Glentoran,5585,7,6,6,10,24,32,-8,24
Dungannon,5585,8,2,4,16,14,47,-33,10
Crusaders,5586,1,16,6,4,61,31,30,54
Coleraine,5586,2,14,11,1,45,24,21,53
Linfield,5586,3,11,5,10,38,36,2,38
Glenavon,5586,4,9,10,7,54,45,9,37
Cliftonville,5586,5,9,4,13,32,32,0,31
Ballymena,5586,6,8,4,14,26,47,-21,28
Glentoran,5586,7,6,6,10,24,32,-8,24
Dungannon,5586,8,2,4,16,14,47,-33,10
Crusaders,5587,1,17,6,3,62,30,32,57
Coleraine,5587,2,14,10,2,43,23,20,52
Glenavon,5587,3,10,9,7,53,43,10,39
Linfield,5587,4,10,6,10,37,36,1,36
Cliftonville,5587,5,9,5,12,32,31,1,32
Ballymena,5587,6,7,4,15,25,48,-23,25
Glentoran,5587,7,6,6,10,24,32,-8,24
Dungannon,5587,8,2,4,16,14,47,-33,10
Crusaders,5588,1,17,6,3,63,30,33,57
Coleraine,5588,2,15,10,1,46,24,22,55
Linfield,5588,3,11,5,10,40,36,4,38
Glenavon,5588,4,9,9,8,54,46,8,36
Cliftonville,5588,5,9,4,13,32,34,-2,31
Ballymena,5588,6,7,4,15,25,49,-24,25
Glentoran,5588,7,6,6,10,24,32,-8,24
Dungannon,5588,8,2,4,16,14,47,-33,10
Crusaders,5589,1,17,6,3,62,30,32,57
Coleraine,5589,2,15,10,1,47,24,23,55
Glenavon,5589,3,9,9,8,54,47,7,36
Linfield,5589,4,10,6,10,38,37,1,36
Cliftonville,5589,5,9,5,12,33,32,1,32
Ballymena,5589,6,7,4,15,25,48,-23,25
Glentoran,5589,7,6,6,10,24,32,-8,24
Dungannon,5589,8,2,4,16,14,47,-33,10
Crusaders,5590,1,17,6,3,63,30,33,57
Coleraine,5590,2,15,10,1,46,22,24,55
Glenavon,5590,3,9,9,8,52,46,6,36
Linfield,5590,4,10,5,11,37,37,0,35
Cliftonville,5590,5,10,4,12,33,31,2,34
Ballymena,5590,6,7,4,15,25,49,-24,25
Glentoran,5590,7,6,6,10,24,32,-8,24
Dungannon,5590,8,2,4,16,14,47,-33,10
Crusaders,5591,1,16,7,3,63,32,31,55
Coleraine,5591,2,15,10,1,47,22,25,55
Glenavon,5591,3,9,9,8,52,47,5,36
Linfield,5591,4,10,5,11,39,39,0,35
Cliftonville,5591,5,10,4,12,35,33,2,34
Ballymena,5591,6,7,5,14,27,49,-22,26
Glentoran,5591,7,6,6,10,24,32,-8,24
Dungannon,5591,8,2,4,16,14,47,-33,10
Crusaders,5592,1,17,6,3,63,31,32,57
Coleraine,5592,2,14,11,1,46,25,21,53
Glenavon,5592,3,9,10,7,55,46,9,37
Linfield,5592,4,10,6,10,39,38,1,36
Cliftonville,5592,5,9,5,12,34,33,1,32
Ballymena,5592,6,7,4,15,26,49,-23,25
Glentoran,5592,7,6,6,10,24,32,-8,24
Dungannon,5592,8,2,4,16,14,47,-33,10
Crusaders,5593,1,16,6,4,64,34,30,54
Coleraine,5593,2,14,11,1,44,23,21,53
Glenavon,5593,3,9,10,7,53,44,9,37
Linfield,5593,4,10,6,10,38,37,1,36
Cliftonville,5593,5,9,5,12,33,32,1,32
Ballymena,5593,6,8,4,14,29,50,-21,28
Glentoran,5593,7,6,6,10,24,32,-8,24
Dungannon,5593,8,2,4,16,14,47,-33,10
Crusaders,5594,1,16,6,4,62,32,30,54
Coleraine,5594,2,14,11,1,46,25,21,53
Glenavon,5594,3,9,10,7,55,46,9,37
Linfield,5594,4,10,5,11,37,38,-1,35
Cliftonville,5594,5,10,4,12,34,31,3,34
Ballymena,5594,6,8,4,14,27,48,-21,28
Glentoran,5594,7,6,6,10,24,32,-8,24
Dungannon,5594,8,2,4,16,14,47,-33,10
Crusaders,5595,1,17,6,3,62,30,32,57
Coleraine,5595,2,14,10,2,44,24,20,52
Glenavon,5595,3,10,9,7,54,44,10,39
Linfield,5595,4,11,5,10,39,36,3,38
Cliftonville,5595,5,9,4,13,32,33,-1,31
Ballymena,5595,6,7,4,15,25,48,-23,25
Glentoran,5595,7,6,6,10,24,32,-8,24
Dungannon,5595,8,2,4,16,14,47,-33,10
Crusaders,5596,1,17,6,3,66,30,36,57
Coleraine,5596,2,15,10,1,45,22,23,55
Glenavon,5596,3,9,9,8,52,45,7,36
Linfield,5596,4,10,6,10,37,36,1,36
Cliftonville,5596,5,9,5,12,32,31,1,32
Ballymena,5596,6,7,4,15,25,52,-27,25
Glentoran,5596,7,6,6,10,24,32,-8,24
Dungannon,5596,8,2,4,16,14,47,-33,10
Crusaders,5597,1,17,6,3,64,31,33,57
Coleraine,5597,2,14,10,2,45,25,20,52
Glenavon,5597,3,10,9,7,55,45,10,39
Linfield,5597,4,11,5,10,38,36,2,38
Cliftonville,5597,5,9,4,13,32,32,0,31
Ballymena,5597,6,7,4,15,26,50,-24,25
Glentoran,5597,7,6,6,10,24,32,-8,24
Dungannon,5597,8,2,4,16,14,47,-33,10
Coleraine,5598,1,15,10,1,45,23,22,55
Crusaders,5598,2,16,6,4,61,31,30,54
Linfield,5598,3,11,5,10,38,36,2,38
Glenavon,5598,4,9,9,8,53,45,8,36
Cliftonville,5598,5,9,4,13,32,32,0,31
Ballymena,5598,6,8,4,14,26,47,-21,28
Glentoran,5598,7,6,6,10,24,32,-8,24
Dungannon,5598,8,2,4,16,14,47,-33,10
Crusaders,5599,1,17,6,3,66,32,34,57
Coleraine,5599,2,14,11,1,46,25,21,53
Glenavon,5599,3,9,10,7,55,46,9,37
Linfield,5599,4,10,5,11,38,39,-1,35
Cliftonville,5599,5,10,4,12,35,32,3,34
Ballymena,5599,6,7,4,15,27,52,-25,25
Glentoran,5599,7,6,6,10,24,32,-8,24
Dungannon,5599,8,2,4,16,14,47,-33,10
Crusaders,5600,1,17,6,3,63,30,33,57
Coleraine,5600,2,14,10,2,43,24,19,52
Glenavon,5600,3,10,9,7,54,43,11,39
Linfield,5600,4,10,5,11,37,37,0,35
Cliftonville,5600,5,10,4,12,33,31,2,34
Ballymena,5600,6,7,4,15,25,49,-24,25
Glentoran,5600,7,6,6,10,24,32,-8,24
Dungannon,5600,8,2,4,16,14,47,-33,10
Crusaders,5601,1,17,6,3,62,30,32,57
Coleraine,5601,2,14,10,2,43,24,19,52
Glenavon,5601,3,10,9,7,54,43,11,39
Linfield,5601,4,11,5,10,39,36,3,38
Cliftonville,5601,5,9,4,13,32,33,-1,31
Ballymena,5601,6,7,4,15,25,48,-23,25
Glentoran,5601,7,6,6,10,24,32,-8,24
Dungannon,5601,8,2,4,16,14,47,-33,10
Crusaders,5602,1,17,6,3,62,30,32,57
Coleraine,5602,2,15,10,1,46,23,23,55
Linfield,5602,3,11,5,10,39,36,3,38
Glenavon,5602,4,9,9,8,53,46,7,36
Cliftonville,5602,5,9,4,13,32,33,-1,31
Ballymena,5602,6,7,4,15,25,48,-23,25
Glentoran,5602,7,6,6,10,24,32,-8,24
Dungannon,5602,8,2,4,16,14,47,-33,10
Crusaders,5603,1,17,6,3,63,30,33,57
Coleraine,5603,2,15,10,1,45,23,22,55
Glenavon,5603,3,9,9,8,53,45,8,36
Linfield,5603,4,10,5,11,38,38,0,35
Cliftonville,5603,5,10,4,12,34,32,2,34
Ballymena,5603,6,7,4,15,25,49,-24,25
Glentoran,5603,7,6,6,10,24,32,-8,24
Dungannon,5603,8,2,4,16,14,47,-33,10
Crusaders,5604,1,17,6,3,65,32,33,57
Coleraine,5604,2,15,10,1,46,24,22,55
Linfield,5604,3,11,5,10,40,36,4,38
Glenavon,5604,4,9,9,8,54,46,8,36
Cliftonville,5604,5,9,4,13,32,34,-2,31
Ballymena,5604,6,7,4,15,27,51,-24,25
Glentoran,5604,7,6,6,10,24,32,-8,24
Dungannon,5604,8,2,4,16,14,47,-33,10
Crusaders,5605,1,16,7,3,62,31,31,55
Coleraine,5605,2,14,11,1,45,24,21,53
Glenavon,5605,3,9,10,7,54,45,9,37
Linfield,5605,4,10,5,11,37,38,-1,35
Cliftonville,5605,5,10,4,12,34,31,3,34
Ballymena,5605,6,7,5,14,26,48,-22,26
Glentoran,5605,7,6,6,10,24,32,-8,24
Dungannon,5605,8,2,4,16,14,47,-33,10
Coleraine,5606,1,15,10,1,45,23,22,55
Crusaders,5606,2,16,6,4,61,32,29,54
Glenavon,5606,3,9,9,8,53,45,8,36
Linfield,5606,4,10,5,11,37,38,-1,35
Cliftonville,5606,5,10,4,12,34,31,3,34
Ballymena,5606,6,8,4,14,27,47,-20,28
Glentoran,5606,7,6,6,10,24,32,-8,24
Dungannon,5606,8,2,4,16,14,47,-33,10
Crusaders,5607,1,17,6,3,62,30,32,57
Coleraine,5607,2,15,10,1,47,25,22,55
Glenavon,5607,3,9,9,8,55,47,8,36
Linfield,5607,4,10,5,11,37,39,-2,35
Cliftonville,5607,5,10,4,12,35,31,4,34
Ballymena,5607,6,7,4,15,25,48,-23,25
Glentoran,5607,7,6,6,10,24,32,-8,24
Dungannon,5607,8,2,4,16,14,47,-33,10
Crusaders,5608,1,16,6,4,62,32,30,54
Coleraine,5608,2,14,10,2,43,24,19,52
Glenavon,5608,3,10,9,7,54,43,11,39
Linfield,5608,4,11,5,10,39,37,2,38
Cliftonville,5608,5,9,4,13,33,33,0,31
Ballymena,5608,6,8,4,14,27,48,-21,28
Glentoran,5608,7,6,6,10,24,32,-8,24
Dungannon,5608,8,2,4,16,14,47,-33,10
Crusaders,5609,1,16,7,3,63,32,31,55
Coleraine,5609,2,14,10,2,45,25,20,52
Glenavon,5609,3,10,9,7,55,45,10,39
Linfield,5609,4,10,6,10,38,37,1,36
Cliftonville,5609,5,9,5,12,33,32,1,32
Ballymena,5609,6,7,5,14,27,49,-22,26
Glentoran,5609,7,6,6,10,24,32,-8,24
Dungannon,5609,8,2,4,16,14,47,-33,10
Crusaders,5610,1,16,7,3,63,32,31,55
Coleraine,5610,2,14,11,1,45,24,21,53
Linfield,5610,3,11,5,10,38,36,2,38
Glenavon,5610,4,9,10,7,54,45,9,37
Cliftonville,5610,5,9,4,13,32,32,0,31
Ballymena,5610,6,7,5,14,27,49,-22,26
Glentoran,5610,7,6,6,10,24,32,-8,24
Dungannon,5610,8,2,4,16,14,47,-33,10
Crusaders,5611,1,16,7,3,63,32,31,55
Coleraine,5611,2,14,10,2,43,27,16,52
Glenavon,5611,3,10,9,7,57,43,14,39
Linfield,5611,4,10,5,11,37,37,0,35
Cliftonville,5611,5,10,4,12,33,31,2,34
Ballymena,5611,6,7,5,14,27,49,-22,26
Glentoran,5611,7,6,6,10,24,32,-8,24
Dungannon,5611,8,2,4,16,14,47,-33,10
Crusaders,5612,1,17,6,3,63,30,33,57
Coleraine,5612,2,14,10,2,44,25,19,52
Glenavon,5612,3,10,9,7,55,44,11,39
Linfield,5612,4,11,5,10,39,36,3,38
Cliftonville,5612,5,9,4,13,32,33,-1,31
Ballymena,5612,6,7,4,15,25,49,-24,25
Glentoran,5612,7,6,6,10,24,32,-8,24
Dungannon,5612,8,2,4,16,14,47,-33,10
Crusaders,5613,1,16,7,3,61,30,31,55
Coleraine,5613,2,15,10,1,44,22,22,55
Linfield,5613,3,11,5,10,39,36,3,38
Glenavon,5613,4,9,9,8,52,44,8,36
Cliftonville,5613,5,9,4,13,32,33,-1,31
Ballymena,5613,6,7,5,14,25,47,-22,26
Glentoran,5613,7,6,6,10,24,32,-8,24
Dungannon,5613,8,2,4,16,14,47,-33,10
Crusaders,5614,1,16,6,4,62,32,30,54
Coleraine,5614,2,14,10,2,43,24,19,52
Glenavon,5614,3,10,9,7,54,43,11,39
Linfield,5614,4,11,5,10,41,38,3,38
Cliftonville,5614,5,9,4,13,34,35,-1,31
Ballymena,5614,6,8,4,14,27,48,-21,28
Glentoran,5614,7,6,6,10,24,32,-8,24
Dungannon,5614,8,2,4,16,14,47,-33,10
Coleraine,5615,1,15,10,1,45,22,23,55
Crusaders,5615,2,16,6,4,61,32,29,54
Glenavon,5615,3,9,9,8,52,45,7,36
Linfield,5615,4,10,6,10,38,37,1,36
Cliftonville,5615,5,9,5,12,33,32,1,32
Ballymena,5615,6,8,4,14,27,47,-20,28
Glentoran,5615,7,6,6,10,24,32,-8,24
Dungannon,5615,8,2,4,16,14,47,-33,10
Crusaders,5616,1,16,6,4,61,33,28,54
Coleraine,5616,2,14,10,2,44,26,18,52
Glenavon,5616,3,10,9,7,56,44,12,39
Linfield,5616,4,10,6,10,38,37,1,36
Cliftonville,5616,5,9,5,12,33,32,1,32
Ballymena,5616,6,8,4,14,28,47,-19,28
Glentoran,5616,7,6,6,10,24,32,-8,24
Dungannon,5616,8,2,4,16,14,47,-33,10
Crusaders,5617,1,16,7,3,63,32,31,55
Coleraine,5617,2,14,10,2,44,24,20,52
Glenavon,5617,3,10,9,7,54,44,10,39
Linfield,5617,4,11,5,10,40,36,4,38
Cliftonville,5617,5,9,4,13,32,34,-2,31
Ballymena,5617,6,7,5,14,27,49,-22,26
Glentoran,5617,7,6,6,10,24,32,-8,24
Dungannon,5617,8,2,4,16,14,47,-33,10
Crusaders,5618,1,16,7,3,62,31,31,55
Coleraine,5618,2,14,11,1,43,22,21,53
Linfield,5618,3,11,5,10,39,36,3,38
Glenavon,5618,4,9,10,7,52,43,9,37
Cliftonville,5618,5,9,4,13,32,33,-1,31
Ballymena,5618,6,7,5,14,26,48,-22,26
Glentoran,5618,7,6,6,10,24,32,-8,24
Dungannon,5618,8,2,4,16,14,47,-33,10
Crusaders,5619,1,17,6,3,65,30,35,57
Coleraine,5619,2,15,10,1,46,22,24,55
Glenavon,5619,3,9,9,8,52,46,6,36
Linfield,5619,4,10,5,11,37,40,-3,35
Cliftonville,5619,5,10,4,12,36,31,5,34
Ballymena,5619,6,7,4,15,25,51,-26,25
Glentoran,5619,7,6,6,10,24,32,-8,24
Dungannon,5619,8,2,4,16,14,47,-33,10
Crusaders,5620,1,16,7,3,64,33,31,55
Coleraine,5620,2,15,10,1,45,23,22,55
Glenavon,5620,3,9,9,8,53,45,8,36
Linfield,5620,4,10,5,11,38,39,-1,35
Cliftonville,5620,5,10,4,12,35,32,3,34
Ballymena,5620,6,7,5,14,28,50,-22,26
Glentoran,5620,7,6,6,10,24,32,-8,24
Dungannon,5620,8,2,4,16,14,47,-33,10
Crusaders,5621,1,16,6,4,63,33,30,54
Coleraine,5621,2,14,10,2,43,23,20,52
Glenavon,5621,3,10,9,7,53,43,10,39
Linfield,5621,4,11,5,10,40,36,4,38
Cliftonville,5621,5,9,4,13,32,34,-2,31
Ballymena,5621,6,8,4,14,28,49,-21,28
Glentoran,5621,7,6,6,10,24,32,-8,24
Dungannon,5621,8,2,4,16,14,47,-33,10
Coleraine,5622,1,15,10,1,45,23,22,55
Crusaders,5622,2,16,6,4,61,33,28,54
Glenavon,5622,3,9,9,8,53,45,8,36
Linfield,5622,4,10,6,10,38,37,1,36
Cliftonville,5622,5,9,5,12,33,32,1,32
Ballymena,5622,6,8,4,14,28,47,-19,28
Glentoran,5622,7,6,6,10,24,32,-8,24
Dungannon,5622,8,2,4,16,14,47,-33,10
Crusaders,5623,1,17,6,3,63,30,33,57
Coleraine,5623,2,14,10,2,44,25,19,52
Glenavon,5623,3,10,9,7,55,44,11,39
Linfield,5623,4,11,5,10,38,36,2,38
Cliftonville,5623,5,9,4,13,32,32,0,31
Ballymena,5623,6,7,4,15,25,49,-24,25
Glentoran,5623,7,6,6,10,24,32,-8,24
Dungannon,5623,8,2,4,16,14,47,-33,10
Crusaders,5624,1,16,6,4,61,31,30,54
Coleraine,5624,2,14,11,1,44,23,21,53
Glenavon,5624,3,9,10,7,53,44,9,37
Linfield,5624,4,10,6,10,39,38,1,36
Cliftonville,5624,5,9,5,12,34,33,1,32
Ballymena,5624,6,8,4,14,26,47,-21,28
Glentoran,5624,7,6,6,10,24,32,-8,24
Dungannon,5624,8,2,4,16,14,47,-33,10
Crusaders,5625,1,17,6,3,64,31,33,57
Coleraine,5625,2,15,10,1,45,23,22,55
Linfield,5625,3,11,5,10,39,36,3,38
Glenavon,5625,4,9,9,8,53,45,8,36
Cliftonville,5625,5,9,4,13,32,33,-1,31
Ballymena,5625,6,7,4,15,26,50,-24,25
Glentoran,5625,7,6,6,10,24,32,-8,24
Dungannon,5625,8,2,4,16,14,47,-33,10
Crusaders,5626,1,16,6,4,62,32,30,54
Coleraine,5626,2,14,10,2,45,26,19,52
Glenavon,5626,3,10,9,7,56,45,11,39
Linfield,5626,4,10,5,11,39,40,-1,35
Cliftonville,5626,5,10,4,12,36,33,3,34
Ballymena,5626,6,8,4,14,27,48,-21,28
Glentoran,5626,7,6,6,10,24,32,-8,24
Dungannon,5626,8,2,4,16,14,47,-33,10
Crusaders,5627,1,17,6,3,63,30,33,57
Coleraine,5627,2,15,10,1,45,23,22,55
Glenavon,5627,3,9,9,8,53,45,8,36
Linfield,5627,4,10,5,11,37,37,0,35
Cliftonville,5627,5,10,4,12,33,31,2,34
Ballymena,5627,6,7,4,15,25,49,-24,25
Glentoran,5627,7,6,6,10,24,32,-8,24
Dungannon,5627,8,2,4,16,14,47,-33,10
Crusaders,5628,1,17,6,3,62,30,32,57
Coleraine,5628,2,14,11,1,45,24,21,53
Linfield,5628,3,11,5,10,38,36,2,38
Glenavon,5628,4,9,10,7,54,45,9,37
Cliftonville,5628,5,9,4,13,32,32,0,31
Ballymena,5628,6,7,4,15,25,48,-23,25
Glentoran,5628,7,6,6,10,24,32,-8,24
Dungannon,5628,8,2,4,16,14,47,-33,10
Crusaders,5629,1,17,6,3,63,31,32,57
Coleraine,5629,2,14,11,1,43,22,21,53
Glenavon,5629,3,9,10,7,52,43,9,37
Linfield,5629,4,10,5,11,38,38,0,35
Cliftonville,5629,5,10,4,12,34,32,2,34
Ballymena,5629,6,7,4,15,26,49,-23,25
Glentoran,5629,7,6,6,10,24,32,-8,24
Dungannon,5629,8,2,4,16,14,47,-33,10
Crusaders,5630,1,16,7,3,62,31,31,55
Coleraine,5630,2,15,10,1,46,23,23,55
Glenavon,5630,3,9,9,8,53,46,7,36
Linfield,5630,4,10,6,10,37,36,1,36
Cliftonville,5630,5,9,5,12,32,31,1,32
Ballymena,5630,6,7,5,14,26,48,-22,26
Glentoran,5630,7,6,6,10,24,32,-8,24
Dungannon,5630,8,2,4,16,14,47,-33,10
Crusaders,5631,1,17,6,3,65,30,35,57
Coleraine,5631,2,14,10,2,45,26,19,52
Glenavon,5631,3,10,9,7,56,45,11,39
Linfield,5631,4,11,5,10,40,36,4,38
Cliftonville,5631,5,9,4,13,32,34,-2,31
Ballymena,5631,6,7,4,15,25,51,-26,25
Glentoran,5631,7,6,6,10,24,32,-8,24
Dungannon,5631,8,2,4,16,14,47,-33,10
Crusaders,5632,1,16,6,4,63,33,30,54
Coleraine,5632,2,14,11,1,44,23,21,53
Linfield,5632,3,11,5,10,38,36,2,38
Glenavon,5632,4,9,10,7,53,44,9,37
Cliftonville,5632,5,9,4,13,32,32,0,31
Ballymena,5632,6,8,4,14,28,49,-21,28
Glentoran,5632,7,6,6,10,24,32,-8,24
Dungannon,5632,8,2,4,16,14,47,-33,10
Coleraine,5633,1,15,10,1,45,23,22,55
Crusaders,5633,2,16,6,4,61,32,29,54
Glenavon,5633,3,9,9,8,53,45,8,36
Linfield,5633,4,10,6,10,38,37,1,36
Cliftonville,5633,5,9,5,12,33,32,1,32
Ballymena,5633,6,8,4,14,27,47,-20,28
Glentoran,5633,7,6,6,10,24,32,-8,24
Dungannon,5633,8,2,4,16,14,47,-33,10
Crusaders,5634,1,17,6,3,64,31,33,57
Coleraine,5634,2,14,10,2,45,25,20,52
Glenavon,5634,3,10,9,7,55,45,10,39
Linfield,5634,4,10,5,11,38,38,0,35
Cliftonville,5634,5,10,4,12,34,32,2,34
Ballymena,5634,6,7,4,15,26,50,-24,25
Glentoran,5634,7,6,6,10,24,32,-8,24
Dungannon,5634,8,2,4,16,14,47,-33,10
Crusaders,5635,1,17,6,3,64,30,34,57
Coleraine,5635,2,15,10,1,45,22,23,55
Glenavon,5635,3,9,9,8,52,45,7,36
Linfield,5635,4,10,5,11,37,38,-1,35
Cliftonville,5635,5,10,4,12,34,31,3,34
Ballymena,5635,6,7,4,15,25,50,-25,25
Glentoran,5635,7,6,6,10,24,32,-8,24
Dungannon,5635,8,2,4,16,14,47,-33,10
Crusaders,5636,1,16,6,4,61,33,28,54
Coleraine,5636,2,14,11,1,45,24,21,53
Glenavon,5636,3,9,10,7,54,45,9,37
Linfield,5636,4,10,5,11,37,40,-3,35
Cliftonville,5636,5,10,4,12,36,31,5,34
Ballymena,5636,6,8,4,14,28,47,-19,28
Glentoran,5636,7,6,6,10,24,32,-8,24
Dungannon,5636,8,2,4,16,14,47,-33,10
Crusaders,5637,1,16,7,3,62,31,31,55
Coleraine,5637,2,14,11,1,47,26,21,53
Glenavon,5637,3,9,10,7,56,47,9,37
Linfield,5637,4,10,5,11,38,38,0,35
Cliftonville,5637,5,10,4,12,34,32,2,34
Ballymena,5637,6,7,5,14,26,48,-22,26
Glentoran,5637,7,6,6,10,24,32,-8,24
Dungannon,5637,8,2,4,16,14,47,-33,10
Coleraine,5638,1,15,10,1,48,23,25,55
Crusaders,5638,2,16,6,4,61,31,30,54
Linfield,5638,3,11,5,10,40,38,2,38
Glenavon,5638,4,9,9,8,53,48,5,36
Cliftonville,5638,5,9,4,13,34,34,0,31
Ballymena,5638,6,8,4,14,26,47,-21,28
Glentoran,5638,7,6,6,10,24,32,-8,24
Dungannon,5638,8,2,4,16,14,47,-33,10
Crusaders,5639,1,17,6,3,66,31,35,57
Coleraine,5639,2,14,10,2,44,24,20,52
Glenavon,5639,3,10,9,7,54,44,10,39
Linfield,5639,4,11,5,10,39,36,3,38
Cliftonville,5639,5,9,4,13,32,33,-1,31
Ballymena,5639,6,7,4,15,26,52,-26,25
Glentoran,5639,7,6,6,10,24,32,-8,24
Dungannon,5639,8,2,4,16,14,47,-33,10
Crusaders,5640,1,17,6,3,63,31,32,57
Coleraine,5640,2,14,11,1,43,22,21,53
Glenavon,5640,3,9,10,7,52,43,9,37
Linfield,5640,4,10,5,11,37,39,-2,35
Cliftonville,5640,5,10,4,12,35,31,4,34
Ballymena,5640,6,7,4,15,26,49,-23,25
Glentoran,5640,7,6,6,10,24,32,-8,24
Dungannon,5640,8,2,4,16,14,47,-33,10
Crusaders,5641,1,16,7,3,63,32,31,55
Coleraine,5641,2,15,10,1,46,23,23,55
Glenavon,5641,3,9,9,8,53,46,7,36
Linfield,5641,4,10,5,11,39,40,-1,35
Cliftonville,5641,5,10,4,12,36,33,3,34
Ballymena,5641,6,7,5,14,27,49,-22,26
Glentoran,5641,7,6,6,10,24,32,-8,24
Dungannon,5641,8,2,4,16,14,47,-33,10
Crusaders,5642,1,16,6,4,61,33,28,54
Coleraine,5642,2,14,11,1,44,23,21,53
Glenavon,5642,3,9,10,7,53,44,9,37
Linfield,5642,4,10,5,11,37,37,0,35
Cliftonville,5642,5,10,4,12,33,31,2,34
Ballymena,5642,6,8,4,14,28,47,-19,28
Glentoran,5642,7,6,6,10,24,32,-8,24
Dungannon,5642,8,2,4,16,14,47,-33,10
Coleraine,5643,1,15,10,1,45,23,22,55
Crusaders,5643,2,16,6,4,61,32,29,54
Glenavon,5643,3,9,9,8,53,45,8,36
Linfield,5643,4,10,6,10,38,37,1,36
Cliftonville,5643,5,9,5,12,33,32,1,32
Ballymena,5643,6,8,4,14,27,47,-20,28
Glentoran,5643,7,6,6,10,24,32,-8,24
Dungannon,5643,8,2,4,16,14,47,-33,10
Crusaders,5644,1,16,6,4,61,34,27,54
Coleraine,5644,2,14,10,2,44,24,20,52
Glenavon,5644,3,10,9,7,54,44,10,39
Linfield,5644,4,10,5,11,37,37,0,35
Cliftonville,5644,5,10,4,12,33,31,2,34
Ballymena,5644,6,8,4,14,29,47,-18,28
Glentoran,5644,7,6,6,10,24,32,-8,24
Dungannon,5644,8,2,4,16,14,47,-33,10
Crusaders,5645,1,16,7,3,63,32,31,55
Coleraine,5645,2,14,10,2,43,24,19,52
Glenavon,5645,3,10,9,7,54,43,11,39
Linfield,5645,4,11,5,10,39,36,3,38
Cliftonville,5645,5,9,4,13,32,33,-1,31
Ballymena,5645,6,7,5,14,27,49,-22,26
Glentoran,5645,7,6,6,10,24,32,-8,24
Dungannon,5645,8,2,4,16,14,47,-33,10
Crusaders,5646,1,16,7,3,63,32,31,55
Coleraine,5646,2,15,10,1,45,22,23,55
Linfield,5646,3,11,5,10,40,37,3,38
Glenavon,5646,4,9,9,8,52,45,7,36
Cliftonville,5646,5,9,4,13,33,34,-1,31
Ballymena,5646,6,7,5,14,27,49,-22,26
Glentoran,5646,7,6,6,10,24,32,-8,24
Dungannon,5646,8,2,4,16,14,47,-33,10
Crusaders,5647,1,16,6,4,62,32,30,54
Coleraine,5647,2,14,10,2,44,24,20,52
Glenavon,5647,3,10,9,7,54,44,10,39
Linfield,5647,4,11,5,10,38,36,2,38
Cliftonville,5647,5,9,4,13,32,32,0,31
Ballymena,5647,6,8,4,14,27,48,-21,28
Glentoran,5647,7,6,6,10,24,32,-8,24
Dungannon,5647,8,2,4,16,14,47,-33,10
Crusaders,5648,1,16,6,4,61,31,30,54
Coleraine,5648,2,14,10,2,43,23,20,52
Glenavon,5648,3,10,9,7,53,43,10,39
Linfield,5648,4,10,5,11,37,38,-1,35
Cliftonville,5648,5,10,4,12,34,31,3,34
Ballymena,5648,6,8,4,14,26,47,-21,28
Glentoran,5648,7,6,6,10,24,32,-8,24
Dungannon,5648,8,2,4,16,14,47,-33,10
Coleraine,5649,1,15,10,1,47,23,24,55
Crusaders,5649,2,16,6,4,63,33,30,54
Glenavon,5649,3,9,9,8,53,47,6,36
Linfield,5649,4,10,5,11,39,39,0,35
Cliftonville,5649,5,10,4,12,35,33,2,34
Ballymena,5649,6,8,4,14,28,49,-21,28
Glentoran,5649,7,6,6,10,24,32,-8,24
Dungannon,5649,8,2,4,16,14,47,-33,10
Crusaders,5650,1,17,6,3,65,31,34,57
Coleraine,5650,2,14,10,2,44,25,19,52
Glenavon,5650,3,10,9,7,55,44,11,39
Linfield,5650,4,10,5,11,37,38,-1,35
Cliftonville,5650,5,10,4,12,34,31,3,34
Ballymena,5650,6,7,4,15,26,51,-25,25
Glentoran,5650,7,6,6,10,24,32,-8,24
Dungannon,5650,8,2,4,16,14,47,-33,10
Crusaders,5651,1,17,6,3,64,31,33,57
Coleraine,5651,2,14,10,2,44,24,20,52
Glenavon,5651,3,10,9,7,54,44,10,39
Linfield,5651,4,11,5,10,39,37,2,38
Cliftonville,5651,5,9,4,13,33,33,0,31
Ballymena,5651,6,7,4,15,26,50,-24,25
Glentoran,5651,7,6,6,10,24,32,-8,24
Dungannon,5651,8,2,4,16,14,47,-33,10
Crusaders,5652,1,17,6,3,64,32,32,57
Coleraine,5652,2,14,10,2,43,26,17,52
Glenavon,5652,3,10,9,7,56,43,13,39
Linfield,5652,4,11,5,10,39,36,3,38
Cliftonville,5652,5,9,4,13,32,33,-1,31
Ballymena,5652,6,7,4,15,27,50,-23,25
Glentoran,5652,7,6,6,10,24,32,-8,24
Dungannon,5652,8,2,4,16,14,47,-33,10
Crusaders,5653,1,17,6,3,64,31,33,57
Coleraine,5653,2,15,10,1,44,22,22,55
Linfield,5653,3,11,5,10,40,37,3,38
Glenavon,5653,4,9,9,8,52,44,8,36
Cliftonville,5653,5,9,4,13,33,34,-1,31
Ballymena,5653,6,7,4,15,26,50,-24,25
Glentoran,5653,7,6,6,10,24,32,-8,24
Dungannon,5653,8,2,4,16,14,47,-33,10
Crusaders,5654,1,16,7,3,62,31,31,55
Coleraine,5654,2,14,10,2,44,24,20,52
Glenavon,5654,3,10,9,7,54,44,10,39
Linfield,5654,4,11,5,10,41,36,5,38
Cliftonville,5654,5,9,4,13,32,35,-3,31
Ballymena,5654,6,7,5,14,26,48,-22,26
Glentoran,5654,7,6,6,10,24,32,-8,24
Dungannon,5654,8,2,4,16,14,47,-33,10
Crusaders,5655,1,16,7,3,63,32,31,55
Coleraine,5655,2,15,10,1,45,23,22,55
Linfield,5655,3,11,5,10,39,37,2,38
Glenavon,5655,4,9,9,8,53,45,8,36
Cliftonville,5655,5,9,4,13,33,33,0,31
Ballymena,5655,6,7,5,14,27,49,-22,26
Glentoran,5655,7,6,6,10,24,32,-8,24
Dungannon,5655,8,2,4,16,14,47,-33,10
Crusaders,5656,1,17,6,3,66,30,36,57
Coleraine,5656,2,14,10,2,43,23,20,52
Glenavon,5656,3,10,9,7,53,43,10,39
Linfield,5656,4,11,5,10,40,36,4,38
Cliftonville,5656,5,9,4,13,32,34,-2,31
Ballymena,5656,6,7,4,15,25,52,-27,25
Glentoran,5656,7,6,6,10,24,32,-8,24
Dungannon,5656,8,2,4,16,14,47,-33,10
Crusaders,5657,1,16,6,4,61,31,30,54
Coleraine,5657,2,14,10,2,44,24,20,52
Glenavon,5657,3,10,9,7,54,44,10,39
Linfield,5657,4,11,5,10,40,36,4,38
Cliftonville,5657,5,9,4,13,32,34,-2,31
Ballymena,5657,6,8,4,14,26,47,-21,28
Glentoran,5657,7,6,6,10,24,32,-8,24
Dungannon,5657,8,2,4,16,14,47,-33,10
Crusaders,5658,1,17,6,3,63,31,32,57
Coleraine,5658,2,14,10,2,43,23,20,52
Glenavon,5658,3,10,9,7,53,43,10,39
Linfield,5658,4,11,5,10,40,37,3,38
Cliftonville,5658,5,9,4,13,33,34,-1,31
Ballymena,5658,6,7,4,15,26,49,-23,25
Glentoran,5658,7,6,6,10,24,32,-8,24
Dungannon,5658,8,2,4,16,14,47,-33,10
Crusaders,5659,1,17,6,3,63,31,32,57
Coleraine,5659,2,14,10,2,44,25,19,52
Glenavon,5659,3,10,9,7,55,44,11,39
Linfield,5659,4,10,6,10,37,36,1,36
Cliftonville,5659,5,9,5,12,32,31,1,32
Ballymena,5659,6,7,4,15,26,49,-23,25
Glentoran,5659,7,6,6,10,24,32,-8,24
Dungannon,5659,8,2,4,16,14,47,-33,10
Crusaders,5660,1,17,6,3,63,31,32,57
Coleraine,5660,2,15,10,1,47,23,24,55
Glenavon,5660,3,9,9,8,53,47,6,36
Linfield,5660,4,10,5,11,37,37,0,35
Cliftonville,5660,5,10,4,12,33,31,2,34
Ballymena,5660,6,7,4,15,26,49,-23,25
Glentoran,5660,7,6,6,10,24,32,-8,24
Dungannon,5660,8,2,4,16,14,47,-33,10
Crusaders,5661,1,17,6,3,63,30,33,57
Coleraine,5661,2,14,10,2,44,24,20,52
Glenavon,5661,3,10,9,7,54,44,10,39
Linfield,5661,4,10,5,11,38,38,0,35
Cliftonville,5661,5,10,4,12,34,32,2,34
Ballymena,5661,6,7,4,15,25,49,-24,25
Glentoran,5661,7,6,6,10,24,32,-8,24
Dungannon,5661,8,2,4,16,14,47,-33,10
Crusaders,5662,1,17,6,3,64,31,33,57
Coleraine,5662,2,14,10,2,43,27,16,52
Glenavon,5662,3,10,9,7,57,43,14,39
Linfield,5662,4,10,6,10,37,36,1,36
Cliftonville,5662,5,9,5,12,32,31,1,32
Ballymena,5662,6,7,4,15,26,50,-24,25
Glentoran,5662,7,6,6,10,24,32,-8,24
Dungannon,5662,8,2,4,16,14,47,-33,10
Crusaders,5663,1,17,6,3,66,33,33,57
Coleraine,5663,2,14,10,2,45,25,20,52
Glenavon,5663,3,10,9,7,55,45,10,39
Linfield,5663,4,10,6,10,38,37,1,36
Cliftonville,5663,5,9,5,12,33,32,1,32
Ballymena,5663,6,7,4,15,28,52,-24,25
Glentoran,5663,7,6,6,10,24,32,-8,24
Dungannon,5663,8,2,4,16,14,47,-33,10
Crusaders,5664,1,16,6,4,61,31,30,54
Coleraine,5664,2,14,10,2,44,24,20,52
Glenavon,5664,3,10,9,7,54,44,10,39
Linfield,5664,4,10,5,11,37,38,-1,35
Cliftonville,5664,5,10,4,12,34,31,3,34
Ballymena,5664,6,8,4,14,26,47,-21,28
Glentoran,5664,7,6,6,10,24,32,-8,24
Dungannon,5664,8,2,4,16,14,47,-33,10
Crusaders,5665,1,16,7,3,62,31,31,55
Coleraine,5665,2,14,10,2,43,25,18,52
Glenavon,5665,3,10,9,7,55,43,12,39
Linfield,5665,4,11,5,10,40,38,2,38
Cliftonville,5665,5,9,4,13,34,34,0,31
Ballymena,5665,6,7,5,14,26,48,-22,26
Glentoran,5665,7,6,6,10,24,32,-8,24
Dungannon,5665,8,2,4,16,14,47,-33,10
Crusaders,5666,1,16,7,3,61,30,31,55
Coleraine,5666,2,14,10,2,44,26,18,52
Glenavon,5666,3,10,9,7,56,44,12,39
Linfield,5666,4,11,5,10,40,37,3,38
Cliftonville,5666,5,9,4,13,33,34,-1,31
Ballymena,5666,6,7,5,14,25,47,-22,26
Glentoran,5666,7,6,6,10,24,32,-8,24
Dungannon,5666,8,2,4,16,14,47,-33,10
Crusaders,5667,1,17,6,3,62,30,32,57
Coleraine,5667,2,14,11,1,43,22,21,53
Linfield,5667,3,11,5,10,41,38,3,38
Glenavon,5667,4,9,10,7,52,43,9,37
Cliftonville,5667,5,9,4,13,34,35,-1,31
Ballymena,5667,6,7,4,15,25,48,-23,25
Glentoran,5667,7,6,6,10,24,32,-8,24
Dungannon,5667,8,2,4,16,14,47,-33,10
Crusaders,5668,1,17,6,3,66,32,34,57
Coleraine,5668,2,14,10,2,43,23,20,52
Glenavon,5668,3,10,9,7,53,43,10,39
Linfield,5668,4,11,5,10,42,38,4,38
Cliftonville,5668,5,9,4,13,34,36,-2,31
Ballymena,5668,6,7,4,15,27,52,-25,25
Glentoran,5668,7,6,6,10,24,32,-8,24
Dungannon,5668,8,2,4,16,14,47,-33,10
Crusaders,5669,1,16,7,3,63,32,31,55
Coleraine,5669,2,14,10,2,44,24,20,52
Glenavon,5669,3,10,9,7,54,44,10,39
Linfield,5669,4,10,5,11,38,38,0,35
Cliftonville,5669,5,10,4,12,34,32,2,34
Ballymena,5669,6,7,5,14,27,49,-22,26
Glentoran,5669,7,6,6,10,24,32,-8,24
Dungannon,5669,8,2,4,16,14,47,-33,10
Crusaders,5670,1,16,7,3,62,31,31,55
Coleraine,5670,2,14,10,2,44,25,19,52
Glenavon,5670,3,10,9,7,55,44,11,39
Linfield,5670,4,10,6,10,38,37,1,36
Cliftonville,5670,5,9,5,12,33,32,1,32
Ballymena,5670,6,7,5,14,26,48,-22,26
Glentoran,5670,7,6,6,10,24,32,-8,24
Dungannon,5670,8,2,4,16,14,47,-33,10
Crusaders,5671,1,17,6,3,64,30,34,57
Coleraine,5671,2,14,10,2,43,23,20,52
Glenavon,5671,3,10,9,7,53,43,10,39
Linfield,5671,4,10,5,11,37,37,0,35
Cliftonville,5671,5,10,4,12,33,31,2,34
Ballymena,5671,6,7,4,15,25,50,-25,25
Glentoran,5671,7,6,6,10,24,32,-8,24
Dungannon,5671,8,2,4,16,14,47,-33,10
Crusaders,5672,1,17,6,3,62,30,32,57
Coleraine,5672,2,14,11,1,44,23,21,53
Linfield,5672,3,11,5,10,40,37,3,38
Glenavon,5672,4,9,10,7,53,44,9,37
Cliftonville,5672,5,9,4,13,33,34,-1,31
Ballymena,5672,6,7,4,15,25,48,-23,25
Glentoran,5672,7,6,6,10,24,32,-8,24
Dungannon,5672,8,2,4,16,14,47,-33,10
Crusaders,5673,1,17,6,3,62,30,32,57
Coleraine,5673,2,14,10,2,43,24,19,52
Glenavon,5673,3,10,9,7,54,43,11,39
Linfield,5673,4,10,6,10,38,37,1,36
Cliftonville,5673,5,9,5,12,33,32,1,32
Ballymena,5673,6,7,4,15,25,48,-23,25
Glentoran,5673,7,6,6,10,24,32,-8,24
Dungannon,5673,8,2,4,16,14,47,-33,10
Crusaders,5674,1,16,7,3,62,31,31,55
Coleraine,5674,2,14,11,1,45,24,21,53
Linfield,5674,3,11,5,10,39,36,3,38
Glenavon,5674,4,9,10,7,54,45,9,37
Cliftonville,5674,5,9,4,13,32,33,-1,31
Ballymena,5674,6,7,5,14,26,48,-22,26
Glentoran,5674,7,6,6,10,24,32,-8,24
Dungannon,5674,8,2,4,16,14,47,-33,10
Crusaders,5675,1,17,6,3,63,30,33,57
Coleraine,5675,2,14,11,1,44,23,21,53
Linfield,5675,3,11,5,10,38,36,2,38
Glenavon,5675,4,9,10,7,53,44,9,37
Cliftonville,5675,5,9,4,13,32,32,0,31
Ballymena,5675,6,7,4,15,25,49,-24,25
Glentoran,5675,7,6,6,10,24,32,-8,24
Dungannon,5675,8,2,4,16,14,47,-33,10
Crusaders,5676,1,17,6,3,63,31,32,57
Coleraine,5676,2,14,10,2,43,25,18,52
Glenavon,5676,3,10,9,7,55,43,12,39
Linfield,5676,4,10,6,10,38,37,1,36
Cliftonville,5676,5,9,5,12,33,32,1,32
Ballymena,5676,6,7,4,15,26,49,-23,25
Glentoran,5676,7,6,6,10,24,32,-8,24
Dungannon,5676,8,2,4,16,14,47,-33,10
Crusaders,5677,1,17,6,3,63,31,32,57
Coleraine,5677,2,14,11,1,45,24,21,53
Linfield,5677,3,11,5,10,38,36,2,38
Glenavon,5677,4,9,10,7,54,45,9,37
Cliftonville,5677,5,9,4,13,32,32,0,31
Ballymena,5677,6,7,4,15,26,49,-23,25
Glentoran,5677,7,6,6,10,24,32,-8,24
Dungannon,5677,8,2,4,16,14,47,-33,10
Crusaders,5678,1,17,6,3,62,30,32,57
Coleraine,5678,2,15,10,1,45,23,22,55
Linfield,5678,3,11,5,10,39,36,3,38
Glenavon,5678,4,9,9,8,53,45,8,36
Cliftonville,5678,5,9,4,13,32,33,-1,31
Ballymena,5678,6,7,4,15,25,48,-23,25
Glentoran,5678,7,6,6,10,24,32,-8,24
Dungannon,5678,8,2,4,16,14,47,-33,10
Crusaders,5679,1,17,6,3,63,31,32,57
Coleraine,5679,2,14,10,2,43,26,17,52
Glenavon,5679,3,10,9,7,56,43,13,39
Linfield,5679,4,10,5,11,38,39,-1,35
Cliftonville,5679,5,10,4,12,35,32,3,34
Ballymena,5679,6,7,4,15,26,49,-23,25
Glentoran,5679,7,6,6,10,24,32,-8,24
Dungannon,5679,8,2,4,16,14,47,-33,10
Crusaders,5680,1,17,6,3,65,31,34,57
Coleraine,5680,2,15,10,1,44,22,22,55
Glenavon,5680,3,9,9,8,52,44,8,36
Linfield,5680,4,10,5,11,37,37,0,35
Cliftonville,5680,5,10,4,12,33,31,2,34
Ballymena,5680,6,7,4,15,26,51,-25,25
Glentoran,5680,7,6,6,10,24,32,-8,24
Dungannon,5680,8,2,4,16,14,47,-33,10
Crusaders,5681,1,17,6,3,63,30,33,57
Coleraine,5681,2,14,11,1,43,22,21,53
Glenavon,5681,3,9,10,7,52,43,9,37
Linfield,5681,4,10,5,11,39,40,-1,35
Cliftonville,5681,5,10,4,12,36,33,3,34
Ballymena,5681,6,7,4,15,25,49,-24,25
Glentoran,5681,7,6,6,10,24,32,-8,24
Dungannon,5681,8,2,4,16,14,47,-33,10
Crusaders,5682,1,17,6,3,64,31,33,57
Coleraine,5682,2,14,10,2,44,25,19,52
Glenavon,5682,3,10,9,7,55,44,11,39
Linfield,5682,4,10,6,10,38,37,1,36
Cliftonville,5682,5,9,5,12,33,32,1,32
Ballymena,5682,6,7,4,15,26,50,-24,25
Glentoran,5682,7,6,6,10,24,32,-8,24
Dungannon,5682,8,2,4,16,14,47,-33,10
Crusaders,5683,1,17,6,3,63,30,33,57
Coleraine,5683,2,14,10,2,43,23,20,52
Glenavon,5683,3,10,9,7,53,43,10,39
Linfield,5683,4,11,5,10,38,36,2,38
Cliftonville,5683,5,9,4,13,32,32,0,31
Ballymena,5683,6,7,4,15,25,49,-24,25
Glentoran,5683,7,6,6,10,24,32,-8,24
Dungannon,5683,8,2,4,16,14,47,-33,10
Crusaders,5684,1,17,6,3,63,31,32,57
Coleraine,5684,2,14,11,1,44,23,21,53
Glenavon,5684,3,9,10,7,53,44,9,37
Linfield,5684,4,10,6,10,37,36,1,36
Cliftonville,5684,5,9,5,12,32,31,1,32
Ballymena,5684,6,7,4,15,26,49,-23,25
Glentoran,5684,7,6,6,10,24,32,-8,24
Dungannon,5684,8,2,4,16,14,47,-33,10
Crusaders,5685,1,17,6,3,64,32,32,57
Coleraine,5685,2,15,10,1,47,22,25,55
Glenavon,5685,3,9,9,8,52,47,5,36
Linfield,5685,4,10,6,10,37,36,1,36
Cliftonville,5685,5,9,5,12,32,31,1,32
Ballymena,5685,6,7,4,15,27,50,-23,25
Glentoran,5685,7,6,6,10,24,32,-8,24
Dungannon,5685,8,2,4,16,14,47,-33,10
Crusaders,5686,1,17,6,3,66,30,36,57
Coleraine,5686,2,14,10,2,44,26,18,52
Glenavon,5686,3,10,9,7,56,44,12,39
Linfield,5686,4,10,5,11,38,38,0,35
Cliftonville,5686,5,10,4,12,34,32,2,34
Ballymena,5686,6,7,4,15,25,52,-27,25
Glentoran,5686,7,6,6,10,24,32,-8,24
Dungannon,5686,8,2,4,16,14,47,-33,10
Crusaders,5687,1,17,6,3,63,30,33,57
Coleraine,5687,2,15,10,1,45,23,22,55
Linfield,5687,3,11,5,10,40,36,4,38
Glenavon,5687,4,9,9,8,53,45,8,36
Cliftonville,5687,5,9,4,13,32,34,-2,31
Ballymena,5687,6,7,4,15,25,49,-24,25
Glentoran,5687,7,6,6,10,24,32,-8,24
Dungannon,5687,8,2,4,16,14,47,-33,10
Crusaders,5688,1,16,6,4,63,33,30,54
Coleraine,5688,2,14,11,1,44,23,21,53
Glenavon,5688,3,9,10,7,53,44,9,37
Linfield,5688,4,10,5,11,39,39,0,35
Cliftonville,5688,5,10,4,12,35,33,2,34
Ballymena,5688,6,8,4,14,28,49,-21,28
Glentoran,5688,7,6,6,10,24,32,-8,24
Dungannon,5688,8,2,4,16,14,47,-33,10
Crusaders,5689,1,17,6,3,63,31,32,57
Coleraine,5689,2,15,10,1,44,22,22,55
Linfield,5689,3,11,5,10,39,36,3,38
Glenavon,5689,4,9,9,8,52,44,8,36
Cliftonville,5689,5,9,4,13,32,33,-1,31
Ballymena,5689,6,7,4,15,26,49,-23,25
Glentoran,5689,7,6,6,10,24,32,-8,24
Dungannon,5689,8,2,4,16,14,47,-33,10
Crusaders,5690,1,17,6,3,64,32,32,57
Coleraine,5690,2,15,10,1,44,22,22,55
Linfield,5690,3,11,5,10,38,36,2,38
Glenavon,5690,4,9,9,8,52,44,8,36
Cliftonville,5690,5,9,4,13,32,32,0,31
Ballymena,5690,6,7,4,15,27,50,-23,25
Glentoran,5690,7,6,6,10,24,32,-8,24
Dungannon,5690,8,2,4,16,14,47,-33,10
Crusaders,5691,1,16,6,4,62,32,30,54
Coleraine,5691,2,14,10,2,45,26,19,52
Glenavon,5691,3,10,9,7,56,45,11,39
Linfield,5691,4,11,5,10,39,36,3,38
Cliftonville,5691,5,9,4,13,32,33,-1,31
Ballymena,5691,6,8,4,14,27,48,-21,28
Glentoran,5691,7,6,6,10,24,32,-8,24
Dungannon,5691,8,2,4,16,14,47,-33,10
Crusaders,5692,1,16,6,4,61,33,28,54
Coleraine,5692,2,14,10,2,43,23,20,52
Glenavon,5692,3,10,9,7,53,43,10,39
Linfield,5692,4,10,5,11,37,38,-1,35
Cliftonville,5692,5,10,4,12,34,31,3,34
Ballymena,5692,6,8,4,14,28,47,-19,28
Glentoran,5692,7,6,6,10,24,32,-8,24
Dungannon,5692,8,2,4,16,14,47,-33,10
Coleraine,5693,1,15,10,1,46,23,23,55
Crusaders,5693,2,16,6,4,62,32,30,54
Linfield,5693,3,11,5,10,38,36,2,38
Glenavon,5693,4,9,9,8,53,46,7,36
Cliftonville,5693,5,9,4,13,32,32,0,31
Ballymena,5693,6,8,4,14,27,48,-21,28
Glentoran,5693,7,6,6,10,24,32,-8,24
Dungannon,5693,8,2,4,16,14,47,-33,10
Crusaders,5694,1,17,6,3,66,31,35,57
Coleraine,5694,2,14,10,2,43,24,19,52
Glenavon,5694,3,10,9,7,54,43,11,39
Linfield,5694,4,10,6,10,38,37,1,36
Cliftonville,5694,5,9,5,12,33,32,1,32
Ballymena,5694,6,7,4,15,26,52,-26,25
Glentoran,5694,7,6,6,10,24,32,-8,24
Dungannon,5694,8,2,4,16,14,47,-33,10
Crusaders,5695,1,17,6,3,63,31,32,57
Coleraine,5695,2,14,11,1,45,24,21,53
Glenavon,5695,3,9,10,7,54,45,9,37
Linfield,5695,4,10,6,10,38,37,1,36
Cliftonville,5695,5,9,5,12,33,32,1,32
Ballymena,5695,6,7,4,15,26,49,-23,25
Glentoran,5695,7,6,6,10,24,32,-8,24
Dungannon,5695,8,2,4,16,14,47,-33,10
Crusaders,5696,1,17,6,3,63,30,33,57
Coleraine,5696,2,14,10,2,43,23,20,52
Glenavon,5696,3,10,9,7,53,43,10,39
Linfield,5696,4,10,6,10,39,38,1,36
Cliftonville,5696,5,9,5,12,34,33,1,32
Ballymena,5696,6,7,4,15,25,49,-24,25
Glentoran,5696,7,6,6,10,24,32,-8,24
Dungannon,5696,8,2,4,16,14,47,-33,10
Crusaders,5697,1,16,7,3,62,31,31,55
Coleraine,5697,2,15,10,1,47,23,24,55
Linfield,5697,3,11,5,10,41,37,4,38
Glenavon,5697,4,9,9,8,53,47,6,36
Cliftonville,5697,5,9,4,13,33,35,-2,31
Ballymena,5697,6,7,5,14,26,48,-22,26
Glentoran,5697,7,6,6,10,24,32,-8,24
Dungannon,5697,8,2,4,16,14,47,-33,10
Crusaders,5698,1,16,6,4,62,32,30,54
Coleraine,5698,2,14,10,2,44,25,19,52
Glenavon,5698,3,10,9,7,55,44,11,39
Linfield,5698,4,11,5,10,41,37,4,38
Cliftonville,5698,5,9,4,13,33,35,-2,31
Ballymena,5698,6,8,4,14,27,48,-21,28
Glentoran,5698,7,6,6,10,24,32,-8,24
Dungannon,5698,8,2,4,16,14,47,-33,10
Crusaders,5699,1,16,7,3,63,32,31,55
Coleraine,5699,2,14,10,2,44,26,18,52
Glenavon,5699,3,10,9,7,56,44,12,39
Linfield,5699,4,10,5,11,37,37,0,35
Cliftonville,5699,5,10,4,12,33,31,2,34
Ballymena,5699,6,7,5,14,27,49,-22,26
Glentoran,5699,7,6,6,10,24,32,-8,24
Dungannon,5699,8,2,4,16,14,47,-33,10
Crusaders,5700,1,16,6,4,61,31,30,54
Coleraine,5700,2,14,10,2,44,25,19,52
Glenavon,5700,3,10,9,7,55,44,11,39
Linfield,5700,4,11,5,10,41,38,3,38
Cliftonville,5700,5,9,4,13,34,35,-1,31
Ballymena,5700,6,8,4,14,26,47,-21,28
Glentoran,5700,7,6,6,10,24,32,-8,24
Dungannon,5700,8,2,4,16,14,47,-33,10
Crusaders,5701,1,16,7,3,63,32,31,55
Coleraine,5701,2,14,10,2,43,24,19,52
Glenavon,5701,3,10,9,7,54,43,11,39
Linfield,5701,4,11,5,10,39,37,2,38
Cliftonville,5701,5,9,4,13,33,33,0,31
Ballymena,5701,6,7,5,14,27,49,-22,26
Glentoran,5701,7,6,6,10,24,32,-8,24
Dungannon,5701,8,2,4,16,14,47,-33,10
Crusaders,5702,1,16,7,3,62,31,31,55
Coleraine,5702,2,14,11,1,45,24,21,53
Linfield,5702,3,11,5,10,40,36,4,38
Glenavon,5702,4,9,10,7,54,45,9,37
Cliftonville,5702,5,9,4,13,32,34,-2,31
Ballymena,5702,6,7,5,14,26,48,-22,26
Glentoran,5702,7,6,6,10,24,32,-8,24
Dungannon,5702,8,2,4,16,14,47,-33,10
Crusaders,5703,1,16,7,3,63,32,31,55
Coleraine,5703,2,14,10,2,44,24,20,52
Glenavon,5703,3,10,9,7,54,44,10,39
Linfield,5703,4,11,5,10,38,36,2,38
Cliftonville,5703,5,9,4,13,32,32,0,31
Ballymena,5703,6,7,5,14,27,49,-22,26
Glentoran,5703,7,6,6,10,24,32,-8,24
Dungannon,5703,8,2,4,16,14,47,-33,10
Crusaders,5704,1,17,6,3,63,31,32,57
Coleraine,5704,2,14,11,1,45,24,21,53
Linfield,5704,3,11,5,10,39,36,3,38
Glenavon,5704,4,9,10,7,54,45,9,37
Cliftonville,5704,5,9,4,13,32,33,-1,31
Ballymena,5704,6,7,4,15,26,49,-23,25
Glentoran,5704,7,6,6,10,24,32,-8,24
Dungannon,5704,8,2,4,16,14,47,-33,10
Crusaders,5705,1,17,6,3,62,30,32,57
Coleraine,5705,2,15,10,1,45,23,22,55
Glenavon,5705,3,9,9,8,53,45,8,36
Linfield,5705,4,10,6,10,37,36,1,36
Cliftonville,5705,5,9,5,12,32,31,1,32
Ballymena,5705,6,7,4,15,25,48,-23,25
Glentoran,5705,7,6,6,10,24,32,-8,24
Dungannon,5705,8,2,4,16,14,47,-33,10
Crusaders,5706,1,16,7,3,63,32,31,55
Coleraine,5706,2,14,11,1,44,23,21,53
Glenavon,5706,3,9,10,7,53,44,9,37
Linfield,5706,4,10,6,10,38,37,1,36
Cliftonville,5706,5,9,5,12,33,32,1,32
Ballymena,5706,6,7,5,14,27,49,-22,26
Glentoran,5706,7,6,6,10,24,32,-8,24
Dungannon,5706,8,2,4,16,14,47,-33,10
Crusaders,5707,1,16,7,3,62,31,31,55
Coleraine,5707,2,14,11,1,43,22,21,53
Linfield,5707,3,11,5,10,38,36,2,38
Glenavon,5707,4,9,10,7,52,43,9,37
Cliftonville,5707,5,9,4,13,32,32,0,31
Ballymena,5707,6,7,5,14,26,48,-22,26
Glentoran,5707,7,6,6,10,24,32,-8,24
Dungannon,5707,8,2,4,16,14,47,-33,10
Crusaders,5708,1,17,6,3,63,30,33,57
Coleraine,5708,2,15,10,1,46,23,23,55
Glenavon,5708,3,9,9,8,53,46,7,36
Linfield,5708,4,10,5,11,38,38,0,35
Cliftonville,5708,5,10,4,12,34,32,2,34
Ballymena,5708,6,7,4,15,25,49,-24,25
Glentoran,5708,7,6,6,10,24,32,-8,24
Dungannon,5708,8,2,4,16,14,47,-33,10
Crusaders,5709,1,17,6,3,67,31,36,57
Coleraine,5709,2,15,10,1,46,22,24,55
Linfield,5709,3,11,5,10,40,37,3,38
Glenavon,5709,4,9,9,8,52,46,6,36
Cliftonville,5709,5,9,4,13,33,34,-1,31
Ballymena,5709,6,7,4,15,26,53,-27,25
Glentoran,5709,7,6,6,10,24,32,-8,24
Dungannon,5709,8,2,4,16,14,47,-33,10
Crusaders,5710,1,17,6,3,63,31,32,57
Coleraine,5710,2,15,10,1,46,24,22,55
Glenavon,5710,3,9,9,8,54,46,8,36
Linfield,5710,4,10,5,11,38,39,-1,35
Cliftonville,5710,5,10,4,12,35,32,3,34
Ballymena,5710,6,7,4,15,26,49,-23,25
Glentoran,5710,7,6,6,10,24,32,-8,24
Dungannon,5710,8,2,4,16,14,47,-33,10
Crusaders,5711,1,17,6,3,64,32,32,57
Coleraine,5711,2,14,10,2,43,27,16,52
Glenavon,5711,3,10,9,7,57,43,14,39
Linfield,5711,4,11,5,10,38,36,2,38
Cliftonville,5711,5,9,4,13,32,32,0,31
Ballymena,5711,6,7,4,15,27,50,-23,25
Glentoran,5711,7,6,6,10,24,32,-8,24
Dungannon,5711,8,2,4,16,14,47,-33,10
Crusaders,5712,1,17,6,3,63,30,33,57
Coleraine,5712,2,14,11,1,44,23,21,53
Linfield,5712,3,11,5,10,39,37,2,38
Glenavon,5712,4,9,10,7,53,44,9,37
Cliftonville,5712,5,9,4,13,33,33,0,31
Ballymena,5712,6,7,4,15,25,49,-24,25
Glentoran,5712,7,6,6,10,24,32,-8,24
Dungannon,5712,8,2,4,16,14,47,-33,10
Crusaders,5713,1,16,6,4,61,31,30,54
Coleraine,5713,2,14,11,1,44,23,21,53
Linfield,5713,3,11,5,10,40,38,2,38
Glenavon,5713,4,9,10,7,53,44,9,37
Cliftonville,5713,5,9,4,13,34,34,0,31
Ballymena,5713,6,8,4,14,26,47,-21,28
Glentoran,5713,7,6,6,10,24,32,-8,24
Dungannon,5713,8,2,4,16,14,47,-33,10
Crusaders,5714,1,17,6,3,64,31,33,57
Coleraine,5714,2,14,10,2,46,26,20,52
Glenavon,5714,3,10,9,7,56,46,10,39
Linfield,5714,4,10,5,11,38,38,0,35
Cliftonville,5714,5,10,4,12,34,32,2,34
Ballymena,5714,6,7,4,15,26,50,-24,25
Glentoran,5714,7,6,6,10,24,32,-8,24
Dungannon,5714,8,2,4,16,14,47,-33,10
Crusaders,5715,1,17,6,3,62,30,32,57
Coleraine,5715,2,15,10,1,47,25,22,55
Linfield,5715,3,11,5,10,39,36,3,38
Glenavon,5715,4,9,9,8,55,47,8,36
Cliftonville,5715,5,9,4,13,32,33,-1,31
Ballymena,5715,6,7,4,15,25,48,-23,25
Glentoran,5715,7,6,6,10,24,32,-8,24
Dungannon,5715,8,2,4,16,14,47,-33,10
Crusaders,5716,1,17,6,3,66,33,33,57
Coleraine,5716,2,14,11,1,45,24,21,53
Glenavon,5716,3,9,10,7,54,45,9,37
Linfield,5716,4,10,5,11,37,38,-1,35
Cliftonville,5716,5,10,4,12,34,31,3,34
Ballymena,5716,6,7,4,15,28,52,-24,25
Glentoran,5716,7,6,6,10,24,32,-8,24
Dungannon,5716,8,2,4,16,14,47,-33,10
Crusaders,5717,1,16,6,4,61,31,30,54
Coleraine,5717,2,14,10,2,44,24,20,52
Glenavon,5717,3,10,9,7,54,44,10,39
Linfield,5717,4,11,5,10,38,36,2,38
Cliftonville,5717,5,9,4,13,32,32,0,31
Ballymena,5717,6,8,4,14,26,47,-21,28
Glentoran,5717,7,6,6,10,24,32,-8,24
Dungannon,5717,8,2,4,16,14,47,-33,10
Crusaders,5718,1,16,6,4,62,32,30,54
Coleraine,5718,2,14,11,1,43,22,21,53
Glenavon,5718,3,9,10,7,52,43,9,37
Linfield,5718,4,10,5,11,38,38,0,35
Cliftonville,5718,5,10,4,12,34,32,2,34
Ballymena,5718,6,8,4,14,27,48,-21,28
Glentoran,5718,7,6,6,10,24,32,-8,24
Dungannon,5718,8,2,4,16,14,47,-33,10
Crusaders,5719,1,17,6,3,64,31,33,57
Coleraine,5719,2,14,11,1,44,23,21,53
Glenavon,5719,3,9,10,7,53,44,9,37
Linfield,5719,4,10,5,11,38,38,0,35
Cliftonville,5719,5,10,4,12,34,32,2,34
Ballymena,5719,6,7,4,15,26,50,-24,25
Glentoran,5719,7,6,6,10,24,32,-8,24
Dungannon,5719,8,2,4,16,14,47,-33,10
Crusaders,5720,1,17,6,3,64,30,34,57
Coleraine,5720,2,14,10,2,45,25,20,52
Glenavon,5720,3,10,9,7,55,45,10,39
Linfield,5720,4,10,6,10,38,37,1,36
Cliftonville,5720,5,9,5,12,33,32,1,32
Ballymena,5720,6,7,4,15,25,50,-25,25
Glentoran,5720,7,6,6,10,24,32,-8,24
Dungannon,5720,8,2,4,16,14,47,-33,10
Crusaders,5721,1,17,6,3,63,31,32,57
Coleraine,5721,2,14,11,1,44,23,21,53
Glenavon,5721,3,9,10,7,53,44,9,37
Linfield,5721,4,10,6,10,39,38,1,36
Cliftonville,5721,5,9,5,12,34,33,1,32
Ballymena,5721,6,7,4,15,26,49,-23,25
Glentoran,5721,7,6,6,10,24,32,-8,24
Dungannon,5721,8,2,4,16,14,47,-33,10
Crusaders,5722,1,17,6,3,64,32,32,57
Coleraine,5722,2,15,10,1,46,24,22,55
Glenavon,5722,3,9,9,8,54,46,8,36
Linfield,5722,4,10,5,11,37,37,0,35
Cliftonville,5722,5,10,4,12,33,31,2,34
Ballymena,5722,6,7,4,15,27,50,-23,25
Glentoran,5722,7,6,6,10,24,32,-8,24
Dungannon,5722,8,2,4,16,14,47,-33,10
Crusaders,5723,1,16,7,3,62,31,31,55
Coleraine,5723,2,14,10,2,44,25,19,52
Glenavon,5723,3,10,9,7,55,44,11,39
Linfield,5723,4,11,5,10,40,36,4,38
Cliftonville,5723,5,9,4,13,32,34,-2,31
Ballymena,5723,6,7,5,14,26,48,-22,26
Glentoran,5723,7,6,6,10,24,32,-8,24
Dungannon,5723,8,2,4,16,14,47,-33,10
Crusaders,5724,1,17,6,3,63,30,33,57
Coleraine,5724,2,14,10,2,43,23,20,52
Glenavon,5724,3,10,9,7,53,43,10,39
Linfield,5724,4,10,6,10,37,36,1,36
Cliftonville,5724,5,9,5,12,32,31,1,32
Ballymena,5724,6,7,4,15,25,49,-24,25
Glentoran,5724,7,6,6,10,24,32,-8,24
Dungannon,5724,8,2,4,16,14,47,-33,10
Crusaders,5725,1,17,6,3,64,30,34,57
Coleraine,5725,2,15,10,1,46,24,22,55
Linfield,5725,3,11,5,10,38,36,2,38
Glenavon,5725,4,9,9,8,54,46,8,36
Cliftonville,5725,5,9,4,13,32,32,0,31
Ballymena,5725,6,7,4,15,25,50,-25,25
Glentoran,5725,7,6,6,10,24,32,-8,24
Dungannon,5725,8,2,4,16,14,47,-33,10
Crusaders,5726,1,16,7,3,64,33,31,55
Coleraine,5726,2,14,10,2,43,23,20,52
Glenavon,5726,3,10,9,7,53,43,10,39
Linfield,5726,4,10,6,10,39,38,1,36
Cliftonville,5726,5,9,5,12,34,33,1,32
Ballymena,5726,6,7,5,14,28,50,-22,26
Glentoran,5726,7,6,6,10,24,32,-8,24
Dungannon,5726,8,2,4,16,14,47,-33,10
Crusaders,5727,1,17,6,3,62,30,32,57
Coleraine,5727,2,14,10,2,43,24,19,52
Glenavon,5727,3,10,9,7,54,43,11,39
Linfield,5727,4,10,5,11,37,37,0,35
Cliftonville,5727,5,10,4,12,33,31,2,34
Ballymena,5727,6,7,4,15,25,48,-23,25
Glentoran,5727,7,6,6,10,24,32,-8,24
Dungannon,5727,8,2,4,16,14,47,-33,10
Crusaders,5728,1,17,6,3,63,30,33,57
Coleraine,5728,2,14,11,1,46,25,21,53
Glenavon,5728,3,9,10,7,55,46,9,37
Linfield,5728,4,10,5,11,37,39,-2,35
Cliftonville,5728,5,10,4,12,35,31,4,34
Ballymena,5728,6,7,4,15,25,49,-24,25
Glentoran,5728,7,6,6,10,24,32,-8,24
Dungannon,5728,8,2,4,16,14,47,-33,10
Crusaders,5729,1,17,6,3,62,30,32,57
Coleraine,5729,2,15,10,1,47,23,24,55
Glenavon,5729,3,9,9,8,53,47,6,36
Linfield,5729,4,10,5,11,37,37,0,35
Cliftonville,5729,5,10,4,12,33,31,2,34
Ballymena,5729,6,7,4,15,25,48,-23,25
Glentoran,5729,7,6,6,10,24,32,-8,24
Dungannon,5729,8,2,4,16,14,47,-33,10
Crusaders,5730,1,17,6,3,63,30,33,57
Coleraine,5730,2,14,10,2,45,25,20,52
Glenavon,5730,3,10,9,7,55,45,10,39
Linfield,5730,4,10,6,10,39,38,1,36
Cliftonville,5730,5,9,5,12,34,33,1,32
Ballymena,5730,6,7,4,15,25,49,-24,25
Glentoran,5730,7,6,6,10,24,32,-8,24
Dungannon,5730,8,2,4,16,14,47,-33,10
Crusaders,5731,1,16,7,3,64,33,31,55
Coleraine,5731,2,15,10,1,45,23,22,55
Glenavon,5731,3,9,9,8,53,45,8,36
Linfield,5731,4,10,5,11,37,38,-1,35
Cliftonville,5731,5,10,4,12,34,31,3,34
Ballymena,5731,6,7,5,14,28,50,-22,26
Glentoran,5731,7,6,6,10,24,32,-8,24
Dungannon,5731,8,2,4,16,14,47,-33,10
Crusaders,5732,1,16,7,3,62,31,31,55
Coleraine,5732,2,15,10,1,44,22,22,55
Glenavon,5732,3,9,9,8,52,44,8,36
Linfield,5732,4,10,5,11,37,38,-1,35
Cliftonville,5732,5,10,4,12,34,31,3,34
Ballymena,5732,6,7,5,14,26,48,-22,26
Glentoran,5732,7,6,6,10,24,32,-8,24
Dungannon,5732,8,2,4,16,14,47,-33,10
Crusaders,5733,1,17,6,3,62,30,32,57
Coleraine,5733,2,14,11,1,44,23,21,53
Linfield,5733,3,11,5,10,39,36,3,38
Glenavon,5733,4,9,10,7,53,44,9,37
Cliftonville,5733,5,9,4,13,32,33,-1,31
Ballymena,5733,6,7,4,15,25,48,-23,25
Glentoran,5733,7,6,6,10,24,32,-8,24
Dungannon,5733,8,2,4,16,14,47,-33,10
Crusaders,5734,1,17,6,3,65,31,34,57
Coleraine,5734,2,14,11,1,46,25,21,53
Glenavon,5734,3,9,10,7,55,46,9,37
Linfield,5734,4,10,5,11,37,38,-1,35
Cliftonville,5734,5,10,4,12,34,31,3,34
Ballymena,5734,6,7,4,15,26,51,-25,25
Glentoran,5734,7,6,6,10,24,32,-8,24
Dungannon,5734,8,2,4,16,14,47,-33,10
Crusaders,5735,1,17,6,3,64,32,32,57
Coleraine,5735,2,14,10,2,43,27,16,52
Glenavon,5735,3,10,9,7,57,43,14,39
Linfield,5735,4,11,5,10,39,36,3,38
Cliftonville,5735,5,9,4,13,32,33,-1,31
Ballymena,5735,6,7,4,15,27,50,-23,25
Glentoran,5735,7,6,6,10,24,32,-8,24
Dungannon,5735,8,2,4,16,14,47,-33,10
Crusaders,5736,1,17,6,3,63,31,32,57
Coleraine,5736,2,14,10,2,44,25,19,52
Glenavon,5736,3,10,9,7,55,44,11,39
Linfield,5736,4,10,5,11,37,38,-1,35
Cliftonville,5736,5,10,4,12,34,31,3,34
Ballymena,5736,6,7,4,15,26,49,-23,25
Glentoran,5736,7,6,6,10,24,32,-8,24
Dungannon,5736,8,2,4,16,14,47,-33,10
Crusaders,5737,1,17,6,3,63,30,33,57
Coleraine,5737,2,15,10,1,44,22,22,55
Linfield,5737,3,11,5,10,40,38,2,38
Glenavon,5737,4,9,9,8,52,44,8,36
Cliftonville,5737,5,9,4,13,34,34,0,31
Ballymena,5737,6,7,4,15,25,49,-24,25
Glentoran,5737,7,6,6,10,24,32,-8,24
Dungannon,5737,8,2,4,16,14,47,-33,10
Crusaders,5738,1,17,6,3,63,31,32,57
Coleraine,5738,2,15,10,1,46,24,22,55
Linfield,5738,3,11,5,10,38,36,2,38
Glenavon,5738,4,9,9,8,54,46,8,36
Cliftonville,5738,5,9,4,13,32,32,0,31
Ballymena,5738,6,7,4,15,26,49,-23,25
Glentoran,5738,7,6,6,10,24,32,-8,24
Dungannon,5738,8,2,4,16,14,47,-33,10
Crusaders,5739,1,17,6,3,64,30,34,57
Coleraine,5739,2,14,11,1,45,24,21,53
Linfield,5739,3,11,5,10,41,37,4,38
Glenavon,5739,4,9,10,7,54,45,9,37
Cliftonville,5739,5,9,4,13,33,35,-2,31
Ballymena,5739,6,7,4,15,25,50,-25,25
Glentoran,5739,7,6,6,10,24,32,-8,24
Dungannon,5739,8,2,4,16,14,47,-33,10
Crusaders,5740,1,17,6,3,64,31,33,57
Coleraine,5740,2,15,10,1,45,23,22,55
Linfield,5740,3,11,5,10,39,36,3,38
Glenavon,5740,4,9,9,8,53,45,8,36
Cliftonville,5740,5,9,4,13,32,33,-1,31
Ballymena,5740,6,7,4,15,26,50,-24,25
Glentoran,5740,7,6,6,10,24,32,-8,24
Dungannon,5740,8,2,4,16,14,47,-33,10
Crusaders,5741,1,17,6,3,64,30,34,57
Coleraine,5741,2,15,10,1,46,24,22,55
Linfield,5741,3,11,5,10,39,36,3,38
Glenavon,5741,4,9,9,8,54,46,8,36
Cliftonville,5741,5,9,4,13,32,33,-1,31
Ballymena,5741,6,7,4,15,25,50,-25,25
Glentoran,5741,7,6,6,10,24,32,-8,24
Dungannon,5741,8,2,4,16,14,47,-33,10
Crusaders,5742,1,16,6,4,62,32,30,54
Coleraine,5742,2,14,10,2,43,27,16,52
Glenavon,5742,3,10,9,7,57,43,14,39
Linfield,5742,4,10,5,11,38,38,0,35
Cliftonville,5742,5,10,4,12,34,32,2,34
Ballymena,5742,6,8,4,14,27,48,-21,28
Glentoran,5742,7,6,6,10,24,32,-8,24
Dungannon,5742,8,2,4,16,14,47,-33,10
Crusaders,5743,1,16,6,4,61,31,30,54
Coleraine,5743,2,14,11,1,44,23,21,53
Linfield,5743,3,11,5,10,38,36,2,38
Glenavon,5743,4,9,10,7,53,44,9,37
Cliftonville,5743,5,9,4,13,32,32,0,31
Ballymena,5743,6,8,4,14,26,47,-21,28
Glentoran,5743,7,6,6,10,24,32,-8,24
Dungannon,5743,8,2,4,16,14,47,-33,10
Crusaders,5744,1,16,7,3,62,31,31,55
Coleraine,5744,2,14,10,2,45,25,20,52
Glenavon,5744,3,10,9,7,55,45,10,39
Linfield,5744,4,10,6,10,37,36,1,36
Cliftonville,5744,5,9,5,12,32,31,1,32
Ballymena,5744,6,7,5,14,26,48,-22,26
Glentoran,5744,7,6,6,10,24,32,-8,24
Dungannon,5744,8,2,4,16,14,47,-33,10
Crusaders,5745,1,17,6,3,65,31,34,57
Coleraine,5745,2,15,10,1,46,22,24,55
Glenavon,5745,3,9,9,8,52,46,6,36
Linfield,5745,4,10,5,11,38,39,-1,35
Cliftonville,5745,5,10,4,12,35,32,3,34
Ballymena,5745,6,7,4,15,26,51,-25,25
Glentoran,5745,7,6,6,10,24,32,-8,24
Dungannon,5745,8,2,4,16,14,47,-33,10
Crusaders,5746,1,16,6,4,63,33,30,54
Coleraine,5746,2,14,10,2,43,25,18,52
Glenavon,5746,3,10,9,7,55,43,12,39
Linfield,5746,4,10,6,10,37,36,1,36
Cliftonville,5746,5,9,5,12,32,31,1,32
Ballymena,5746,6,8,4,14,28,49,-21,28
Glentoran,5746,7,6,6,10,24,32,-8,24
Dungannon,5746,8,2,4,16,14,47,-33,10
Crusaders,5747,1,16,7,3,62,31,31,55
Coleraine,5747,2,14,10,2,44,24,20,52
Glenavon,5747,3,10,9,7,54,44,10,39
Linfield,5747,4,10,5,11,39,40,-1,35
Cliftonville,5747,5,10,4,12,36,33,3,34
Ballymena,5747,6,7,5,14,26,48,-22,26
Glentoran,5747,7,6,6,10,24,32,-8,24
Dungannon,5747,8,2,4,16,14,47,-33,10
Crusaders,5748,1,17,6,3,63,31,32,57
Coleraine,5748,2,14,11,1,47,26,21,53
Glenavon,5748,3,9,10,7,56,47,9,37
Linfield,5748,4,10,5,11,39,39,0,35
Cliftonville,5748,5,10,4,12,35,33,2,34
Ballymena,5748,6,7,4,15,26,49,-23,25
Glentoran,5748,7,6,6,10,24,32,-8,24
Dungannon,5748,8,2,4,16,14,47,-33,10
Crusaders,5749,1,16,7,3,61,30,31,55
Coleraine,5749,2,14,11,1,44,23,21,53
Glenavon,5749,3,9,10,7,53,44,9,37
Linfield,5749,4,10,5,11,37,37,0,35
Cliftonville,5749,5,10,4,12,33,31,2,34
Ballymena,5749,6,7,5,14,25,47,-22,26
Glentoran,5749,7,6,6,10,24,32,-8,24
Dungannon,5749,8,2,4,16,14,47,-33,10
Crusaders,5750,1,16,7,3,63,32,31,55
Coleraine,5750,2,15,10,1,46,24,22,55
Linfield,5750,3,11,5,10,40,37,3,38
Glenavon,5750,4,9,9,8,54,46,8,36
Cliftonville,5750,5,9,4,13,33,34,-1,31
Ballymena,5750,6,7,5,14,27,49,-22,26
Glentoran,5750,7,6,6,10,24,32,-8,24
Dungannon,5750,8,2,4,16,14,47,-33,10
Crusaders,5751,1,16,6,4,63,33,30,54
Coleraine,5751,2,14,11,1,45,24,21,53
Linfield,5751,3,11,5,10,40,37,3,38
Glenavon,5751,4,9,10,7,54,45,9,37
Cliftonville,5751,5,9,4,13,33,34,-1,31
Ballymena,5751,6,8,4,14,28,49,-21,28
Glentoran,5751,7,6,6,10,24,32,-8,24
Dungannon,5751,8,2,4,16,14,47,-33,10
Crusaders,5752,1,17,6,3,66,31,35,57
Coleraine,5752,2,14,11,1,45,24,21,53
Glenavon,5752,3,9,10,7,54,45,9,37
Linfield,5752,4,10,6,10,37,36,1,36
Cliftonville,5752,5,9,5,12,32,31,1,32
Ballymena,5752,6,7,4,15,26,52,-26,25
Glentoran,5752,7,6,6,10,24,32,-8,24
Dungannon,5752,8,2,4,16,14,47,-33,10
Crusaders,5753,1,16,7,3,63,32,31,55
Coleraine,5753,2,15,10,1,44,22,22,55
Linfield,5753,3,11,5,10,41,37,4,38
Glenavon,5753,4,9,9,8,52,44,8,36
Cliftonville,5753,5,9,4,13,33,35,-2,31
Ballymena,5753,6,7,5,14,27,49,-22,26
Glentoran,5753,7,6,6,10,24,32,-8,24
Dungannon,5753,8,2,4,16,14,47,-33,10
Crusaders,5754,1,16,7,3,62,31,31,55
Coleraine,5754,2,15,10,1,44,22,22,55
Glenavon,5754,3,9,9,8,52,44,8,36
Linfield,5754,4,10,6,10,37,36,1,36
Cliftonville,5754,5,9,5,12,32,31,1,32
Ballymena,5754,6,7,5,14,26,48,-22,26
Glentoran,5754,7,6,6,10,24,32,-8,24
Dungannon,5754,8,2,4,16,14,47,-33,10
Crusaders,5755,1,16,7,3,63,32,31,55
Coleraine,5755,2,14,10,2,44,24,20,52
Glenavon,5755,3,10,9,7,54,44,10,39
Linfield,5755,4,10,5,11,37,37,0,35
Cliftonville,5755,5,10,4,12,33,31,2,34
Ballymena,5755,6,7,5,14,27,49,-22,26
Glentoran,5755,7,6,6,10,24,32,-8,24
Dungannon,5755,8,2,4,16,14,47,-33,10
Crusaders,5756,1,16,7,3,62,31,31,55
Coleraine,5756,2,15,10,1,46,23,23,55
Linfield,5756,3,11,5,10,39,36,3,38
Glenavon,5756,4,9,9,8,53,46,7,36
Cliftonville,5756,5,9,4,13,32,33,-1,31
Ballymena,5756,6,7,5,14,26,48,-22,26
Glentoran,5756,7,6,6,10,24,32,-8,24
Dungannon,5756,8,2,4,16,14,47,-33,10
Crusaders,5757,1,17,6,3,64,31,33,57
Coleraine,5757,2,14,10,2,45,25,20,52
Glenavon,5757,3,10,9,7,55,45,10,39
Linfield,5757,4,11,5,10,39,36,3,38
Cliftonville,5757,5,9,4,13,32,33,-1,31
Ballymena,5757,6,7,4,15,26,50,-24,25
Glentoran,5757,7,6,6,10,24,32,-8,24
Dungannon,5757,8,2,4,16,14,47,-33,10
Crusaders,5758,1,17,6,3,63,30,33,57
Coleraine,5758,2,14,10,2,43,24,19,52
Glenavon,5758,3,10,9,7,54,43,11,39
Linfield,5758,4,11,5,10,39,37,2,38
Cliftonville,5758,5,9,4,13,33,33,0,31
Ballymena,5758,6,7,4,15,25,49,-24,25
Glentoran,5758,7,6,6,10,24,32,-8,24
Dungannon,5758,8,2,4,16,14,47,-33,10
Crusaders,5759,1,17,6,3,65,30,35,57
Coleraine,5759,2,14,11,1,46,25,21,53
Glenavon,5759,3,9,10,7,55,46,9,37
Linfield,5759,4,10,6,10,37,36,1,36
Cliftonville,5759,5,9,5,12,32,31,1,32
Ballymena,5759,6,7,4,15,25,51,-26,25
Glentoran,5759,7,6,6,10,24,32,-8,24
Dungannon,5759,8,2,4,16,14,47,-33,10
Crusaders,5760,1,16,6,4,61,31,30,54
Coleraine,5760,2,14,10,2,43,25,18,52
Glenavon,5760,3,10,9,7,55,43,12,39
Linfield,5760,4,10,6,10,38,37,1,36
Cliftonville,5760,5,9,5,12,33,32,1,32
Ballymena,5760,6,8,4,14,26,47,-21,28
Glentoran,5760,7,6,6,10,24,32,-8,24
Dungannon,5760,8,2,4,16,14,47,-33,10
Crusaders,5761,1,16,7,3,61,30,31,55
Coleraine,5761,2,14,10,2,43,24,19,52
Glenavon,5761,3,10,9,7,54,43,11,39
Linfield,5761,4,10,5,11,38,38,0,35
Cliftonville,5761,5,10,4,12,34,32,2,34
Ballymena,5761,6,7,5,14,25,47,-22,26
Glentoran,5761,7,6,6,10,24,32,-8,24
Dungannon,5761,8,2,4,16,14,47,-33,10
Crusaders,5762,1,16,6,4,61,32,29,54
Coleraine,5762,2,14,11,1,45,24,21,53
Glenavon,5762,3,9,10,7,54,45,9,37
Linfield,5762,4,10,6,10,38,37,1,36
Cliftonville,5762,5,9,5,12,33,32,1,32
Ballymena,5762,6,8,4,14,27,47,-20,28
Glentoran,5762,7,6,6,10,24,32,-8,24
Dungannon,5762,8,2,4,16,14,47,-33,10
Crusaders,5763,1,16,6,4,61,31,30,54
Coleraine,5763,2,14,10,2,44,26,18,52
Glenavon,5763,3,10,9,7,56,44,12,39
Linfield,5763,4,10,5,11,38,38,0,35
Cliftonville,5763,5,10,4,12,34,32,2,34
Ballymena,5763,6,8,4,14,26,47,-21,28
Glentoran,5763,7,6,6,10,24,32,-8,24
Dungannon,5763,8,2,4,16,14,47,-33,10
Crusaders,5764,1,17,6,3,62,30,32,57
Coleraine,5764,2,15,10,1,47,25,22,55
Glenavon,5764,3,9,9,8,55,47,8,36
Linfield,5764,4,10,5,11,38,39,-1,35
Cliftonville,5764,5,10,4,12,35,32,3,34
Ballymena,5764,6,7,4,15,25,48,-23,25
Glentoran,5764,7,6,6,10,24,32,-8,24
Dungannon,5764,8,2,4,16,14,47,-33,10
Crusaders,5765,1,16,6,4,62,32,30,54
Coleraine,5765,2,14,11,1,44,23,21,53
Glenavon,5765,3,9,10,7,53,44,9,37
Linfield,5765,4,10,5,11,38,38,0,35
Cliftonville,5765,5,10,4,12,34,32,2,34
Ballymena,5765,6,8,4,14,27,48,-21,28
Glentoran,5765,7,6,6,10,24,32,-8,24
Dungannon,5765,8,2,4,16,14,47,-33,10
Crusaders,5766,1,17,6,3,65,30,35,57
Coleraine,5766,2,14,10,2,44,26,18,52
Glenavon,5766,3,10,9,7,56,44,12,39
Linfield,5766,4,10,5,11,37,37,0,35
Cliftonville,5766,5,10,4,12,33,31,2,34
Ballymena,5766,6,7,4,15,25,51,-26,25
Glentoran,5766,7,6,6,10,24,32,-8,24
Dungannon,5766,8,2,4,16,14,47,-33,10
Crusaders,5767,1,17,6,3,63,30,33,57
Coleraine,5767,2,14,10,2,46,26,20,52
Glenavon,5767,3,10,9,7,56,46,10,39
Linfield,5767,4,10,5,11,37,39,-2,35
Cliftonville,5767,5,10,4,12,35,31,4,34
Ballymena,5767,6,7,4,15,25,49,-24,25
Glentoran,5767,7,6,6,10,24,32,-8,24
Dungannon,5767,8,2,4,16,14,47,-33,10
Crusaders,5768,1,16,6,4,61,32,29,54
Coleraine,5768,2,14,11,1,46,25,21,53
Glenavon,5768,3,9,10,7,55,46,9,37
Linfield,5768,4,10,5,11,37,37,0,35
Cliftonville,5768,5,10,4,12,33,31,2,34
Ballymena,5768,6,8,4,14,27,47,-20,28
Glentoran,5768,7,6,6,10,24,32,-8,24
Dungannon,5768,8,2,4,16,14,47,-33,10
Crusaders,5769,1,17,6,3,63,30,33,57
Coleraine,5769,2,14,10,2,44,25,19,52
Glenavon,5769,3,10,9,7,55,44,11,39
Linfield,5769,4,11,5,10,38,36,2,38
Cliftonville,5769,5,9,4,13,32,32,0,31
Ballymena,5769,6,7,4,15,25,49,-24,25
Glentoran,5769,7,6,6,10,24,32,-8,24
Dungannon,5769,8,2,4,16,14,47,-33,10
Coleraine,5770,1,15,10,1,46,24,22,55
Crusaders,5770,2,16,6,4,62,33,29,54
Glenavon,5770,3,9,9,8,54,46,8,36
Linfield,5770,4,10,5,11,38,38,0,35
Cliftonville,5770,5,10,4,12,34,32,2,34
Ballymena,5770,6,8,4,14,28,48,-20,28
Glentoran,5770,7,6,6,10,24,32,-8,24
Dungannon,5770,8,2,4,16,14,47,-33,10
Crusaders,5771,1,16,6,4,61,33,28,54
Coleraine,5771,2,14,10,2,43,23,20,52
Glenavon,5771,3,10,9,7,53,43,10,39
Linfield,5771,4,11,5,10,39,36,3,38
Cliftonville,5771,5,9,4,13,32,33,-1,31
Ballymena,5771,6,8,4,14,28,47,-19,28
Glentoran,5771,7,6,6,10,24,32,-8,24
Dungannon,5771,8,2,4,16,14,47,-33,10
Crusaders,5772,1,16,7,3,61,30,31,55
Coleraine,5772,2,15,10,1,46,23,23,55
Glenavon,5772,3,9,9,8,53,46,7,36
Linfield,5772,4,10,6,10,38,37,1,36
Cliftonville,5772,5,9,5,12,33,32,1,32
Ballymena,5772,6,7,5,14,25,47,-22,26
Glentoran,5772,7,6,6,10,24,32,-8,24
Dungannon,5772,8,2,4,16,14,47,-33,10
Crusaders,5773,1,17,6,3,62,30,32,57
Coleraine,5773,2,14,11,1,44,23,21,53
Linfield,5773,3,11,5,10,38,36,2,38
Glenavon,5773,4,9,10,7,53,44,9,37
Cliftonville,5773,5,9,4,13,32,32,0,31
Ballymena,5773,6,7,4,15,25,48,-23,25
Glentoran,5773,7,6,6,10,24,32,-8,24
Dungannon,5773,8,2,4,16,14,47,-33,10
Crusaders,5774,1,17,6,3,64,31,33,57
Coleraine,5774,2,14,10,2,46,26,20,52
Glenavon,5774,3,10,9,7,56,46,10,39
Linfield,5774,4,11,5,10,41,36,5,38
Cliftonville,5774,5,9,4,13,32,35,-3,31
Ballymena,5774,6,7,4,15,26,50,-24,25
Glentoran,5774,7,6,6,10,24,32,-8,24
Dungannon,5774,8,2,4,16,14,47,-33,10
Crusaders,5775,1,17,6,3,63,30,33,57
Coleraine,5775,2,14,10,2,43,23,20,52
Glenavon,5775,3,10,9,7,53,43,10,39
Linfield,5775,4,10,5,11,37,37,0,35
Cliftonville,5775,5,10,4,12,33,31,2,34
Ballymena,5775,6,7,4,15,25,49,-24,25
Glentoran,5775,7,6,6,10,24,32,-8,24
Dungannon,5775,8,2,4,16,14,47,-33,10
Crusaders,5776,1,16,6,4,62,32,30,54
Coleraine,5776,2,14,10,2,44,24,20,52
Glenavon,5776,3,10,9,7,54,44,10,39
Linfield,5776,4,10,6,10,38,37,1,36
Cliftonville,5776,5,9,5,12,33,32,1,32
Ballymena,5776,6,8,4,14,27,48,-21,28
Glentoran,5776,7,6,6,10,24,32,-8,24
Dungannon,5776,8,2,4,16,14,47,-33,10
Crusaders,5777,1,17,6,3,63,31,32,57
Coleraine,5777,2,15,10,1,46,24,22,55
Linfield,5777,3,11,5,10,40,38,2,38
Glenavon,5777,4,9,9,8,54,46,8,36
Cliftonville,5777,5,9,4,13,34,34,0,31
Ballymena,5777,6,7,4,15,26,49,-23,25
Glentoran,5777,7,6,6,10,24,32,-8,24
Dungannon,5777,8,2,4,16,14,47,-33,10
Crusaders,5778,1,17,6,3,62,30,32,57
Coleraine,5778,2,14,10,2,44,24,20,52
Glenavon,5778,3,10,9,7,54,44,10,39
Linfield,5778,4,10,5,11,38,38,0,35
Cliftonville,5778,5,10,4,12,34,32,2,34
Ballymena,5778,6,7,4,15,25,48,-23,25
Glentoran,5778,7,6,6,10,24,32,-8,24
Dungannon,5778,8,2,4,16,14,47,-33,10
Crusaders,5779,1,17,6,3,64,31,33,57
Coleraine,5779,2,14,10,2,44,26,18,52
Glenavon,5779,3,10,9,7,56,44,12,39
Linfield,5779,4,10,5,11,39,39,0,35
Cliftonville,5779,5,10,4,12,35,33,2,34
Ballymena,5779,6,7,4,15,26,50,-24,25
Glentoran,5779,7,6,6,10,24,32,-8,24
Dungannon,5779,8,2,4,16,14,47,-33,10
Crusaders,5780,1,16,7,3,64,33,31,55
Coleraine,5780,2,14,10,2,44,25,19,52
Glenavon,5780,3,10,9,7,55,44,11,39
Linfield,5780,4,11,5,10,38,36,2,38
Cliftonville,5780,5,9,4,13,32,32,0,31
Ballymena,5780,6,7,5,14,28,50,-22,26
Glentoran,5780,7,6,6,10,24,32,-8,24
Dungannon,5780,8,2,4,16,14,47,-33,10
Crusaders,5781,1,17,6,3,64,31,33,57
Coleraine,5781,2,15,10,1,46,23,23,55
Linfield,5781,3,11,5,10,39,36,3,38
Glenavon,5781,4,9,9,8,53,46,7,36
Cliftonville,5781,5,9,4,13,32,33,-1,31
Ballymena,5781,6,7,4,15,26,50,-24,25
Glentoran,5781,7,6,6,10,24,32,-8,24
Dungannon,5781,8,2,4,16,14,47,-33,10
Crusaders,5782,1,17,6,3,64,30,34,57
Coleraine,5782,2,14,10,2,44,27,17,52
Glenavon,5782,3,10,9,7,57,44,13,39
Linfield,5782,4,10,6,10,38,37,1,36
Cliftonville,5782,5,9,5,12,33,32,1,32
Ballymena,5782,6,7,4,15,25,50,-25,25
Glentoran,5782,7,6,6,10,24,32,-8,24
Dungannon,5782,8,2,4,16,14,47,-33,10
Crusaders,5783,1,17,6,3,64,30,34,57
Coleraine,5783,2,14,10,2,43,23,20,52
Glenavon,5783,3,10,9,7,53,43,10,39
Linfield,5783,4,10,6,10,38,37,1,36
Cliftonville,5783,5,9,5,12,33,32,1,32
Ballymena,5783,6,7,4,15,25,50,-25,25
Glentoran,5783,7,6,6,10,24,32,-8,24
Dungannon,5783,8,2,4,16,14,47,-33,10
Crusaders,5784,1,17,6,3,64,30,34,57
Coleraine,5784,2,14,10,2,44,25,19,52
Glenavon,5784,3,10,9,7,55,44,11,39
Linfield,5784,4,10,6,10,39,38,1,36
Cliftonville,5784,5,9,5,12,34,33,1,32
Ballymena,5784,6,7,4,15,25,50,-25,25
Glentoran,5784,7,6,6,10,24,32,-8,24
Dungannon,5784,8,2,4,16,14,47,-33,10
Crusaders,5785,1,17,6,3,62,30,32,57
Coleraine,5785,2,14,10,2,43,23,20,52
Glenavon,5785,3,10,9,7,53,43,10,39
Linfield,5785,4,10,5,11,37,38,-1,35
Cliftonville,5785,5,10,4,12,34,31,3,34
Ballymena,5785,6,7,4,15,25,48,-23,25
Glentoran,5785,7,6,6,10,24,32,-8,24
Dungannon,5785,8,2,4,16,14,47,-33,10
Crusaders,5786,1,16,6,4,62,32,30,54
Coleraine,5786,2,14,10,2,46,26,20,52
Glenavon,5786,3,10,9,7,56,46,10,39
Linfield,5786,4,10,6,10,38,37,1,36
Cliftonville,5786,5,9,5,12,33,32,1,32
Ballymena,5786,6,8,4,14,27,48,-21,28
Glentoran,5786,7,6,6,10,24,32,-8,24
Dungannon,5786,8,2,4,16,14,47,-33,10
Crusaders,5787,1,16,7,3,63,32,31,55
Coleraine,5787,2,14,11,1,44,23,21,53
Glenavon,5787,3,9,10,7,53,44,9,37
Linfield,5787,4,10,5,11,38,41,-3,35
Cliftonville,5787,5,10,4,12,37,32,5,34
Ballymena,5787,6,7,5,14,27,49,-22,26
Glentoran,5787,7,6,6,10,24,32,-8,24
Dungannon,5787,8,2,4,16,14,47,-33,10
Crusaders,5788,1,17,6,3,63,31,32,57
Coleraine,5788,2,14,11,1,46,25,21,53
Linfield,5788,3,11,5,10,39,36,3,38
Glenavon,5788,4,9,10,7,55,46,9,37
Cliftonville,5788,5,9,4,13,32,33,-1,31
Ballymena,5788,6,7,4,15,26,49,-23,25
Glentoran,5788,7,6,6,10,24,32,-8,24
Dungannon,5788,8,2,4,16,14,47,-33,10
Crusaders,5789,1,16,6,4,61,31,30,54
Coleraine,5789,2,14,10,2,43,25,18,52
Glenavon,5789,3,10,9,7,55,43,12,39
Linfield,5789,4,11,5,10,39,37,2,38
Cliftonville,5789,5,9,4,13,33,33,0,31
Ballymena,5789,6,8,4,14,26,47,-21,28
Glentoran,5789,7,6,6,10,24,32,-8,24
Dungannon,5789,8,2,4,16,14,47,-33,10
Crusaders,5790,1,17,6,3,65,32,33,57
Coleraine,5790,2,15,10,1,45,23,22,55
Glenavon,5790,3,9,9,8,53,45,8,36
Linfield,5790,4,10,6,10,38,37,1,36
Cliftonville,5790,5,9,5,12,33,32,1,32
Ballymena,5790,6,7,4,15,27,51,-24,25
Glentoran,5790,7,6,6,10,24,32,-8,24
Dungannon,5790,8,2,4,16,14,47,-33,10
Crusaders,5791,1,17,6,3,64,31,33,57
Coleraine,5791,2,14,10,2,43,27,16,52
Glenavon,5791,3,10,9,7,57,43,14,39
Linfield,5791,4,10,5,11,37,38,-1,35
Cliftonville,5791,5,10,4,12,34,31,3,34
Ballymena,5791,6,7,4,15,26,50,-24,25
Glentoran,5791,7,6,6,10,24,32,-8,24
Dungannon,5791,8,2,4,16,14,47,-33,10
Crusaders,5792,1,16,7,3,64,33,31,55
Coleraine,5792,2,14,10,2,43,27,16,52
Glenavon,5792,3,10,9,7,57,43,14,39
Linfield,5792,4,11,5,10,40,36,4,38
Cliftonville,5792,5,9,4,13,32,34,-2,31
Ballymena,5792,6,7,5,14,28,50,-22,26
Glentoran,5792,7,6,6,10,24,32,-8,24
Dungannon,5792,8,2,4,16,14,47,-33,10
Crusaders,5793,1,17,6,3,63,31,32,57
Coleraine,5793,2,14,10,2,45,25,20,52
Glenavon,5793,3,10,9,7,55,45,10,39
Linfield,5793,4,11,5,10,42,36,6,38
Cliftonville,5793,5,9,4,13,32,36,-4,31
Ballymena,5793,6,7,4,15,26,49,-23,25
Glentoran,5793,7,6,6,10,24,32,-8,24
Dungannon,5793,8,2,4,16,14,47,-33,10
Crusaders,5794,1,17,6,3,65,30,35,57
Coleraine,5794,2,14,10,2,43,26,17,52
Glenavon,5794,3,10,9,7,56,43,13,39
Linfield,5794,4,11,5,10,40,37,3,38
Cliftonville,5794,5,9,4,13,33,34,-1,31
Ballymena,5794,6,7,4,15,25,51,-26,25
Glentoran,5794,7,6,6,10,24,32,-8,24
Dungannon,5794,8,2,4,16,14,47,-33,10
Crusaders,5795,1,17,6,3,63,30,33,57
Coleraine,5795,2,14,11,1,45,24,21,53
Linfield,5795,3,11,5,10,40,37,3,38
Glenavon,5795,4,9,10,7,54,45,9,37
Cliftonville,5795,5,9,4,13,33,34,-1,31
Ballymena,5795,6,7,4,15,25,49,-24,25
Glentoran,5795,7,6,6,10,24,32,-8,24
Dungannon,5795,8,2,4,16,14,47,-33,10
Crusaders,5796,1,17,6,3,63,30,33,57
Coleraine,5796,2,15,10,1,46,24,22,55
Glenavon,5796,3,9,9,8,54,46,8,36
Linfield,5796,4,10,5,11,38,39,-1,35
Cliftonville,5796,5,10,4,12,35,32,3,34
Ballymena,5796,6,7,4,15,25,49,-24,25
Glentoran,5796,7,6,6,10,24,32,-8,24
Dungannon,5796,8,2,4,16,14,47,-33,10
Coleraine,5797,1,15,10,1,44,22,22,55
Crusaders,5797,2,16,6,4,61,31,30,54
Glenavon,5797,3,9,9,8,52,44,8,36
Linfield,5797,4,10,5,11,37,38,-1,35
Cliftonville,5797,5,10,4,12,34,31,3,34
Ballymena,5797,6,8,4,14,26,47,-21,28
Glentoran,5797,7,6,6,10,24,32,-8,24
Dungannon,5797,8,2,4,16,14,47,-33,10
Crusaders,5798,1,17,6,3,65,33,32,57
Coleraine,5798,2,14,10,2,45,27,18,52
Glenavon,5798,3,10,9,7,57,45,12,39
Linfield,5798,4,11,5,10,38,36,2,38
Cliftonville,5798,5,9,4,13,32,32,0,31
Ballymena,5798,6,7,4,15,28,51,-23,25
Glentoran,5798,7,6,6,10,24,32,-8,24
Dungannon,5798,8,2,4,16,14,47,-33,10
Crusaders,5799,1,16,6,4,64,34,30,54
Coleraine,5799,2,14,11,1,45,24,21,53
Linfield,5799,3,11,5,10,40,36,4,38
Glenavon,5799,4,9,10,7,54,45,9,37
Cliftonville,5799,5,9,4,13,32,34,-2,31
Ballymena,5799,6,8,4,14,29,50,-21,28
Glentoran,5799,7,6,6,10,24,32,-8,24
Dungannon,5799,8,2,4,16,14,47,-33,10
Crusaders,5800,1,16,7,3,62,31,31,55
Coleraine,5800,2,14,10,2,44,26,18,52
Glenavon,5800,3,10,9,7,56,44,12,39
Linfield,5800,4,10,6,10,38,37,1,36
Cliftonville,5800,5,9,5,12,33,32,1,32
Ballymena,5800,6,7,5,14,26,48,-22,26
Glentoran,5800,7,6,6,10,24,32,-8,24
Dungannon,5800,8,2,4,16,14,47,-33,10
Crusaders,5801,1,17,6,3,65,31,34,57
Coleraine,5801,2,15,10,1,46,22,24,55
Linfield,5801,3,11,5,10,39,37,2,38
Glenavon,5801,4,9,9,8,52,46,6,36
Cliftonville,5801,5,9,4,13,33,33,0,31
Ballymena,5801,6,7,4,15,26,51,-25,25
Glentoran,5801,7,6,6,10,24,32,-8,24
Dungannon,5801,8,2,4,16,14,47,-33,10
Crusaders,5802,1,17,6,3,63,30,33,57
Coleraine,5802,2,15,10,1,44,22,22,55
Linfield,5802,3,11,5,10,43,36,7,38
Glenavon,5802,4,9,9,8,52,44,8,36
Cliftonville,5802,5,9,4,13,32,37,-5,31
Ballymena,5802,6,7,4,15,25,49,-24,25
Glentoran,5802,7,6,6,10,24,32,-8,24
Dungannon,5802,8,2,4,16,14,47,-33,10
Crusaders,5803,1,16,6,4,62,33,29,54
Coleraine,5803,2,14,11,1,44,23,21,53
Linfield,5803,3,11,5,10,40,37,3,38
Glenavon,5803,4,9,10,7,53,44,9,37
Cliftonville,5803,5,9,4,13,33,34,-1,31
Ballymena,5803,6,8,4,14,28,48,-20,28
Glentoran,5803,7,6,6,10,24,32,-8,24
Dungannon,5803,8,2,4,16,14,47,-33,10
Crusaders,5804,1,17,6,3,66,31,35,57
Coleraine,5804,2,14,11,1,43,22,21,53
Glenavon,5804,3,9,10,7,52,43,9,37
Linfield,5804,4,10,6,10,37,36,1,36
Cliftonville,5804,5,9,5,12,32,31,1,32
Ballymena,5804,6,7,4,15,26,52,-26,25
Glentoran,5804,7,6,6,10,24,32,-8,24
Dungannon,5804,8,2,4,16,14,47,-33,10
Crusaders,5805,1,16,7,3,63,32,31,55
Coleraine,5805,2,14,10,2,43,24,19,52
Glenavon,5805,3,10,9,7,54,43,11,39
Linfield,5805,4,11,5,10,40,37,3,38
Cliftonville,5805,5,9,4,13,33,34,-1,31
Ballymena,5805,6,7,5,14,27,49,-22,26
Glentoran,5805,7,6,6,10,24,32,-8,24
Dungannon,5805,8,2,4,16,14,47,-33,10
Crusaders,5806,1,16,7,3,62,31,31,55
Coleraine,5806,2,14,11,1,44,23,21,53
Glenavon,5806,3,9,10,7,53,44,9,37
Linfield,5806,4,10,5,11,37,38,-1,35
Cliftonville,5806,5,10,4,12,34,31,3,34
Ballymena,5806,6,7,5,14,26,48,-22,26
Glentoran,5806,7,6,6,10,24,32,-8,24
Dungannon,5806,8,2,4,16,14,47,-33,10
Crusaders,5807,1,16,6,4,62,34,28,54
Coleraine,5807,2,14,10,2,43,24,19,52
Glenavon,5807,3,10,9,7,54,43,11,39
Linfield,5807,4,11,5,10,39,36,3,38
Cliftonville,5807,5,9,4,13,32,33,-1,31
Ballymena,5807,6,8,4,14,29,48,-19,28
Glentoran,5807,7,6,6,10,24,32,-8,24
Dungannon,5807,8,2,4,16,14,47,-33,10
Crusaders,5808,1,17,6,3,66,31,35,57
Coleraine,5808,2,14,10,2,44,24,20,52
Glenavon,5808,3,10,9,7,54,44,10,39
Linfield,5808,4,11,5,10,38,36,2,38
Cliftonville,5808,5,9,4,13,32,32,0,31
Ballymena,5808,6,7,4,15,26,52,-26,25
Glentoran,5808,7,6,6,10,24,32,-8,24
Dungannon,5808,8,2,4,16,14,47,-33,10
Crusaders,5809,1,17,6,3,62,30,32,57
Coleraine,5809,2,14,11,1,44,23,21,53
Linfield,5809,3,11,5,10,39,37,2,38
Glenavon,5809,4,9,10,7,53,44,9,37
Cliftonville,5809,5,9,4,13,33,33,0,31
Ballymena,5809,6,7,4,15,25,48,-23,25
Glentoran,5809,7,6,6,10,24,32,-8,24
Dungannon,5809,8,2,4,16,14,47,-33,10
Crusaders,5810,1,17,6,3,65,30,35,57
Coleraine,5810,2,14,10,2,43,25,18,52
Glenavon,5810,3,10,9,7,55,43,12,39
Linfield,5810,4,11,5,10,40,38,2,38
Cliftonville,5810,5,9,4,13,34,34,0,31
Ballymena,5810,6,7,4,15,25,51,-26,25
Glentoran,5810,7,6,6,10,24,32,-8,24
Dungannon,5810,8,2,4,16,14,47,-33,10
Crusaders,5811,1,17,6,3,64,30,34,57
Coleraine,5811,2,15,10,1,45,23,22,55
Glenavon,5811,3,9,9,8,53,45,8,36
Linfield,5811,4,10,6,10,38,37,1,36
Cliftonville,5811,5,9,5,12,33,32,1,32
Ballymena,5811,6,7,4,15,25,50,-25,25
Glentoran,5811,7,6,6,10,24,32,-8,24
Dungannon,5811,8,2,4,16,14,47,-33,10
Crusaders,5812,1,17,6,3,62,30,32,57
Coleraine,5812,2,14,10,2,44,24,20,52
Glenavon,5812,3,10,9,7,54,44,10,39
Linfield,5812,4,10,5,11,38,39,-1,35
Cliftonville,5812,5,10,4,12,35,32,3,34
Ballymena,5812,6,7,4,15,25,48,-23,25
Glentoran,5812,7,6,6,10,24,32,-8,24
Dungannon,5812,8,2,4,16,14,47,-33,10
Crusaders,5813,1,17,6,3,64,31,33,57
Coleraine,5813,2,14,11,1,45,24,21,53
Linfield,5813,3,11,5,10,39,36,3,38
Glenavon,5813,4,9,10,7,54,45,9,37
Cliftonville,5813,5,9,4,13,32,33,-1,31
Ballymena,5813,6,7,4,15,26,50,-24,25
Glentoran,5813,7,6,6,10,24,32,-8,24
Dungannon,5813,8,2,4,16,14,47,-33,10
Crusaders,5814,1,17,6,3,65,32,33,57
Coleraine,5814,2,15,10,1,46,22,24,55
Glenavon,5814,3,9,9,8,52,46,6,36
Linfield,5814,4,10,5,11,37,37,0,35
Cliftonville,5814,5,10,4,12,33,31,2,34
Ballymena,5814,6,7,4,15,27,51,-24,25
Glentoran,5814,7,6,6,10,24,32,-8,24
Dungannon,5814,8,2,4,16,14,47,-33,10
Crusaders,5815,1,17,6,3,64,31,33,57
Coleraine,5815,2,14,10,2,43,24,19,52
Glenavon,5815,3,10,9,7,54,43,11,39
Linfield,5815,4,10,6,10,38,37,1,36
Cliftonville,5815,5,9,5,12,33,32,1,32
Ballymena,5815,6,7,4,15,26,50,-24,25
Glentoran,5815,7,6,6,10,24,32,-8,24
Dungannon,5815,8,2,4,16,14,47,-33,10
Crusaders,5816,1,17,6,3,65,32,33,57
Coleraine,5816,2,14,10,2,44,27,17,52
Glenavon,5816,3,10,9,7,57,44,13,39
Linfield,5816,4,11,5,10,39,36,3,38
Cliftonville,5816,5,9,4,13,32,33,-1,31
Ballymena,5816,6,7,4,15,27,51,-24,25
Glentoran,5816,7,6,6,10,24,32,-8,24
Dungannon,5816,8,2,4,16,14,47,-33,10
Crusaders,5817,1,16,6,4,61,32,29,54
Coleraine,5817,2,14,10,2,43,25,18,52
Glenavon,5817,3,10,9,7,55,43,12,39
Linfield,5817,4,11,5,10,38,36,2,38
Cliftonville,5817,5,9,4,13,32,32,0,31
Ballymena,5817,6,8,4,14,27,47,-20,28
Glentoran,5817,7,6,6,10,24,32,-8,24
Dungannon,5817,8,2,4,16,14,47,-33,10
Crusaders,5818,1,17,6,3,64,31,33,57
Coleraine,5818,2,14,11,1,45,24,21,53
Linfield,5818,3,11,5,10,39,36,3,38
Glenavon,5818,4,9,10,7,54,45,9,37
Cliftonville,5818,5,9,4,13,32,33,-1,31
Ballymena,5818,6,7,4,15,26,50,-24,25
Glentoran,5818,7,6,6,10,24,32,-8,24
Dungannon,5818,8,2,4,16,14,47,-33,10
Crusaders,5819,1,16,7,3,64,33,31,55
Coleraine,5819,2,14,10,2,44,24,20,52
Glenavon,5819,3,10,9,7,54,44,10,39
Linfield,5819,4,10,6,10,38,37,1,36
Cliftonville,5819,5,9,5,12,33,32,1,32
Ballymena,5819,6,7,5,14,28,50,-22,26
Glentoran,5819,7,6,6,10,24,32,-8,24
Dungannon,5819,8,2,4,16,14,47,-33,10
Coleraine,5820,1,15,10,1,47,23,24,55
Crusaders,5820,2,16,6,4,62,34,28,54
Glenavon,5820,3,9,9,8,53,47,6,36
Linfield,5820,4,10,6,10,38,37,1,36
Cliftonville,5820,5,9,5,12,33,32,1,32
Ballymena,5820,6,8,4,14,29,48,-19,28
Glentoran,5820,7,6,6,10,24,32,-8,24
Dungannon,5820,8,2,4,16,14,47,-33,10
Crusaders,5821,1,17,6,3,63,31,32,57
Coleraine,5821,2,14,11,1,45,24,21,53
Glenavon,5821,3,9,10,7,54,45,9,37
Linfield,5821,4,10,6,10,38,37,1,36
Cliftonville,5821,5,9,5,12,33,32,1,32
Ballymena,5821,6,7,4,15,26,49,-23,25
Glentoran,5821,7,6,6,10,24,32,-8,24
Dungannon,5821,8,2,4,16,14,47,-33,10
Crusaders,5822,1,17,6,3,63,30,33,57
Coleraine,5822,2,15,10,1,47,24,23,55
Linfield,5822,3,11,5,10,38,36,2,38
Glenavon,5822,4,9,9,8,54,47,7,36
Cliftonville,5822,5,9,4,13,32,32,0,31
Ballymena,5822,6,7,4,15,25,49,-24,25
Glentoran,5822,7,6,6,10,24,32,-8,24
Dungannon,5822,8,2,4,16,14,47,-33,10
Crusaders,5823,1,17,6,3,62,30,32,57
Coleraine,5823,2,14,11,1,44,23,21,53
Linfield,5823,3,11,5,10,38,36,2,38
Glenavon,5823,4,9,10,7,53,44,9,37
Cliftonville,5823,5,9,4,13,32,32,0,31
Ballymena,5823,6,7,4,15,25,48,-23,25
Glentoran,5823,7,6,6,10,24,32,-8,24
Dungannon,5823,8,2,4,16,14,47,-33,10
Crusaders,5824,1,16,6,4,61,32,29,54
Coleraine,5824,2,14,11,1,44,23,21,53
Linfield,5824,3,11,5,10,38,36,2,38
Glenavon,5824,4,9,10,7,53,44,9,37
Cliftonville,5824,5,9,4,13,32,32,0,31
Ballymena,5824,6,8,4,14,27,47,-20,28
Glentoran,5824,7,6,6,10,24,32,-8,24
Dungannon,5824,8,2,4,16,14,47,-33,10
Crusaders,5825,1,16,7,3,63,32,31,55
Coleraine,5825,2,15,10,1,44,22,22,55
Glenavon,5825,3,9,9,8,52,44,8,36
Linfield,5825,4,10,5,11,37,39,-2,35
Cliftonville,5825,5,10,4,12,35,31,4,34
Ballymena,5825,6,7,5,14,27,49,-22,26
Glentoran,5825,7,6,6,10,24,32,-8,24
Dungannon,5825,8,2,4,16,14,47,-33,10
Coleraine,5826,1,15,10,1,47,25,22,55
Crusaders,5826,2,16,6,4,62,32,30,54
Glenavon,5826,3,9,9,8,55,47,8,36
Linfield,5826,4,10,6,10,39,38,1,36
Cliftonville,5826,5,9,5,12,34,33,1,32
Ballymena,5826,6,8,4,14,27,48,-21,28
Glentoran,5826,7,6,6,10,24,32,-8,24
Dungannon,5826,8,2,4,16,14,47,-33,10
Crusaders,5827,1,16,6,4,63,33,30,54
Coleraine,5827,2,14,10,2,44,24,20,52
Glenavon,5827,3,10,9,7,54,44,10,39
Linfield,5827,4,10,5,11,37,37,0,35
Cliftonville,5827,5,10,4,12,33,31,2,34
Ballymena,5827,6,8,4,14,28,49,-21,28
Glentoran,5827,7,6,6,10,24,32,-8,24
Dungannon,5827,8,2,4,16,14,47,-33,10
Crusaders,5828,1,16,7,3,61,30,31,55
Coleraine,5828,2,14,11,1,47,26,21,53
Linfield,5828,3,11,5,10,40,36,4,38
Glenavon,5828,4,9,10,7,56,47,9,37
Cliftonville,5828,5,9,4,13,32,34,-2,31
Ballymena,5828,6,7,5,14,25,47,-22,26
Glentoran,5828,7,6,6,10,24,32,-8,24
Dungannon,5828,8,2,4,16,14,47,-33,10
Crusaders,5829,1,16,6,4,62,33,29,54
Coleraine,5829,2,14,10,2,44,25,19,52
Glenavon,5829,3,10,9,7,55,44,11,39
Linfield,5829,4,11,5,10,42,37,5,38
Cliftonville,5829,5,9,4,13,33,36,-3,31
Ballymena,5829,6,8,4,14,28,48,-20,28
Glentoran,5829,7,6,6,10,24,32,-8,24
Dungannon,5829,8,2,4,16,14,47,-33,10
Crusaders,5830,1,17,6,3,64,30,34,57
Coleraine,5830,2,15,10,1,45,23,22,55
Glenavon,5830,3,9,9,8,53,45,8,36
Linfield,5830,4,10,5,11,38,38,0,35
Cliftonville,5830,5,10,4,12,34,32,2,34
Ballymena,5830,6,7,4,15,25,50,-25,25
Glentoran,5830,7,6,6,10,24,32,-8,24
Dungannon,5830,8,2,4,16,14,47,-33,10
Coleraine,5831,1,15,10,1,47,23,24,55
Crusaders,5831,2,16,6,4,62,32,30,54
Linfield,5831,3,11,5,10,41,37,4,38
Glenavon,5831,4,9,9,8,53,47,6,36
Cliftonville,5831,5,9,4,13,33,35,-2,31
Ballymena,5831,6,8,4,14,27,48,-21,28
Glentoran,5831,7,6,6,10,24,32,-8,24
Dungannon,5831,8,2,4,16,14,47,-33,10
Crusaders,5832,1,17,6,3,64,31,33,57
Coleraine,5832,2,15,10,1,47,24,23,55
Linfield,5832,3,11,5,10,39,36,3,38
Glenavon,5832,4,9,9,8,54,47,7,36
Cliftonville,5832,5,9,4,13,32,33,-1,31
Ballymena,5832,6,7,4,15,26,50,-24,25
Glentoran,5832,7,6,6,10,24,32,-8,24
Dungannon,5832,8,2,4,16,14,47,-33,10
Crusaders,5833,1,17,6,3,62,30,32,57
Coleraine,5833,2,14,10,2,43,23,20,52
Glenavon,5833,3,10,9,7,53,43,10,39
Linfield,5833,4,11,5,10,42,36,6,38
Cliftonville,5833,5,9,4,13,32,36,-4,31
Ballymena,5833,6,7,4,15,25,48,-23,25
Glentoran,5833,7,6,6,10,24,32,-8,24
Dungannon,5833,8,2,4,16,14,47,-33,10
Crusaders,5834,1,17,6,3,63,31,32,57
Coleraine,5834,2,14,11,1,46,25,21,53
Linfield,5834,3,11,5,10,38,36,2,38
Glenavon,5834,4,9,10,7,55,46,9,37
Cliftonville,5834,5,9,4,13,32,32,0,31
Ballymena,5834,6,7,4,15,26,49,-23,25
Glentoran,5834,7,6,6,10,24,32,-8,24
Dungannon,5834,8,2,4,16,14,47,-33,10
Crusaders,5835,1,17,6,3,64,32,32,57
Coleraine,5835,2,14,10,2,43,24,19,52
Glenavon,5835,3,10,9,7,54,43,11,39
Linfield,5835,4,11,5,10,39,37,2,38
Cliftonville,5835,5,9,4,13,33,33,0,31
Ballymena,5835,6,7,4,15,27,50,-23,25
Glentoran,5835,7,6,6,10,24,32,-8,24
Dungannon,5835,8,2,4,16,14,47,-33,10
Crusaders,5836,1,16,6,4,62,33,29,54
Coleraine,5836,2,14,11,1,43,22,21,53
Glenavon,5836,3,9,10,7,52,43,9,37
Linfield,5836,4,10,5,11,37,37,0,35
Cliftonville,5836,5,10,4,12,33,31,2,34
Ballymena,5836,6,8,4,14,28,48,-20,28
Glentoran,5836,7,6,6,10,24,32,-8,24
Dungannon,5836,8,2,4,16,14,47,-33,10
Crusaders,5837,1,17,6,3,63,31,32,57
Coleraine,5837,2,14,10,2,43,26,17,52
Glenavon,5837,3,10,9,7,56,43,13,39
Linfield,5837,4,11,5,10,38,36,2,38
Cliftonville,5837,5,9,4,13,32,32,0,31
Ballymena,5837,6,7,4,15,26,49,-23,25
Glentoran,5837,7,6,6,10,24,32,-8,24
Dungannon,5837,8,2,4,16,14,47,-33,10
Crusaders,5838,1,17,6,3,65,32,33,57
Coleraine,5838,2,14,10,2,44,24,20,52
Glenavon,5838,3,10,9,7,54,44,10,39
Linfield,5838,4,11,5,10,38,36,2,38
Cliftonville,5838,5,9,4,13,32,32,0,31
Ballymena,5838,6,7,4,15,27,51,-24,25
Glentoran,5838,7,6,6,10,24,32,-8,24
Dungannon,5838,8,2,4,16,14,47,-33,10
Crusaders,5839,1,17,6,3,65,32,33,57
Coleraine,5839,2,14,10,2,43,23,20,52
Glenavon,5839,3,10,9,7,53,43,10,39
Linfield,5839,4,10,5,11,38,40,-2,35
Cliftonville,5839,5,10,4,12,36,32,4,34
Ballymena,5839,6,7,4,15,27,51,-24,25
Glentoran,5839,7,6,6,10,24,32,-8,24
Dungannon,5839,8,2,4,16,14,47,-33,10
Crusaders,5840,1,17,6,3,64,30,34,57
Coleraine,5840,2,15,10,1,45,23,22,55
Linfield,5840,3,11,5,10,38,36,2,38
Glenavon,5840,4,9,9,8,53,45,8,36
Cliftonville,5840,5,9,4,13,32,32,0,31
Ballymena,5840,6,7,4,15,25,50,-25,25
Glentoran,5840,7,6,6,10,24,32,-8,24
Dungannon,5840,8,2,4,16,14,47,-33,10
Crusaders,5841,1,17,6,3,62,30,32,57
Coleraine,5841,2,15,10,1,45,23,22,55
Linfield,5841,3,11,5,10,39,37,2,38
Glenavon,5841,4,9,9,8,53,45,8,36
Cliftonville,5841,5,9,4,13,33,33,0,31
Ballymena,5841,6,7,4,15,25,48,-23,25
Glentoran,5841,7,6,6,10,24,32,-8,24
Dungannon,5841,8,2,4,16,14,47,-33,10
Crusaders,5842,1,17,6,3,64,30,34,57
Coleraine,5842,2,14,10,2,45,26,19,52
Glenavon,5842,3,10,9,7,56,45,11,39
Linfield,5842,4,10,6,10,38,37,1,36
Cliftonville,5842,5,9,5,12,33,32,1,32
Ballymena,5842,6,7,4,15,25,50,-25,25
Glentoran,5842,7,6,6,10,24,32,-8,24
Dungannon,5842,8,2,4,16,14,47,-33,10
Crusaders,5843,1,16,6,4,62,32,30,54
Coleraine,5843,2,14,10,2,44,25,19,52
Glenavon,5843,3,10,9,7,55,44,11,39
Linfield,5843,4,10,5,11,38,39,-1,35
Cliftonville,5843,5,10,4,12,35,32,3,34
Ballymena,5843,6,8,4,14,27,48,-21,28
Glentoran,5843,7,6,6,10,24,32,-8,24
Dungannon,5843,8,2,4,16,14,47,-33,10
Crusaders,5844,1,16,7,3,63,32,31,55
Coleraine,5844,2,15,10,1,46,23,23,55
Glenavon,5844,3,9,9,8,53,46,7,36
Linfield,5844,4,10,5,11,38,39,-1,35
Cliftonville,5844,5,10,4,12,35,32,3,34
Ballymena,5844,6,7,5,14,27,49,-22,26
Glentoran,5844,7,6,6,10,24,32,-8,24
Dungannon,5844,8,2,4,16,14,47,-33,10
Crusaders,5845,1,17,6,3,65,32,33,57
Coleraine,5845,2,15,10,1,45,22,23,55
Glenavon,5845,3,9,9,8,52,45,7,36
Linfield,5845,4,10,6,10,38,37,1,36
Cliftonville,5845,5,9,5,12,33,32,1,32
Ballymena,5845,6,7,4,15,27,51,-24,25
Glentoran,5845,7,6,6,10,24,32,-8,24
Dungannon,5845,8,2,4,16,14,47,-33,10
Crusaders,5846,1,17,6,3,65,31,34,57
Coleraine,5846,2,15,10,1,44,22,22,55
Glenavon,5846,3,9,9,8,52,44,8,36
Linfield,5846,4,10,5,11,37,37,0,35
Cliftonville,5846,5,10,4,12,33,31,2,34
Ballymena,5846,6,7,4,15,26,51,-25,25
Glentoran,5846,7,6,6,10,24,32,-8,24
Dungannon,5846,8,2,4,16,14,47,-33,10
Crusaders,5847,1,17,6,3,65,31,34,57
Coleraine,5847,2,14,10,2,43,25,18,52
Glenavon,5847,3,10,9,7,55,43,12,39
Linfield,5847,4,10,6,10,37,36,1,36
Cliftonville,5847,5,9,5,12,32,31,1,32
Ballymena,5847,6,7,4,15,26,51,-25,25
Glentoran,5847,7,6,6,10,24,32,-8,24
Dungannon,5847,8,2,4,16,14,47,-33,10
Coleraine,5848,1,15,10,1,46,24,22,55
Crusaders,5848,2,16,6,4,61,31,30,54
Glenavon,5848,3,9,9,8,54,46,8,36
Linfield,5848,4,10,6,10,38,37,1,36
Cliftonville,5848,5,9,5,12,33,32,1,32
Ballymena,5848,6,8,4,14,26,47,-21,28
Glentoran,5848,7,6,6,10,24,32,-8,24
Dungannon,5848,8,2,4,16,14,47,-33,10
Crusaders,5849,1,16,7,3,63,32,31,55
Coleraine,5849,2,14,11,1,44,23,21,53
Linfield,5849,3,11,5,10,39,36,3,38
Glenavon,5849,4,9,10,7,53,44,9,37
Cliftonville,5849,5,9,4,13,32,33,-1,31
Ballymena,5849,6,7,5,14,27,49,-22,26
Glentoran,5849,7,6,6,10,24,32,-8,24
Dungannon,5849,8,2,4,16,14,47,-33,10
Crusaders,5850,1,16,6,4,62,32,30,54
Coleraine,5850,2,14,10,2,43,27,16,52
Glenavon,5850,3,10,9,7,57,43,14,39
Linfield,5850,4,11,5,10,39,36,3,38
Cliftonville,5850,5,9,4,13,32,33,-1,31
Ballymena,5850,6,8,4,14,27,48,-21,28
Glentoran,5850,7,6,6,10,24,32,-8,24
Dungannon,5850,8,2,4,16,14,47,-33,10
Crusaders,5851,1,17,6,3,63,30,33,57
Coleraine,5851,2,14,10,2,43,26,17,52
Glenavon,5851,3,10,9,7,56,43,13,39
Linfield,5851,4,10,6,10,37,36,1,36
Cliftonville,5851,5,9,5,12,32,31,1,32
Ballymena,5851,6,7,4,15,25,49,-24,25
Glentoran,5851,7,6,6,10,24,32,-8,24
Dungannon,5851,8,2,4,16,14,47,-33,10
Crusaders,5852,1,16,6,4,62,33,29,54
Coleraine,5852,2,14,11,1,45,24,21,53
Linfield,5852,3,11,5,10,39,36,3,38
Glenavon,5852,4,9,10,7,54,45,9,37
Cliftonville,5852,5,9,4,13,32,33,-1,31
Ballymena,5852,6,8,4,14,28,48,-20,28
Glentoran,5852,7,6,6,10,24,32,-8,24
Dungannon,5852,8,2,4,16,14,47,-33,10
Crusaders,5853,1,17,6,3,63,31,32,57
Coleraine,5853,2,15,10,1,44,22,22,55
Glenavon,5853,3,9,9,8,52,44,8,36
Linfield,5853,4,10,6,10,38,37,1,36
Cliftonville,5853,5,9,5,12,33,32,1,32
Ballymena,5853,6,7,4,15,26,49,-23,25
Glentoran,5853,7,6,6,10,24,32,-8,24
Dungannon,5853,8,2,4,16,14,47,-33,10
Coleraine,5854,1,15,10,1,44,22,22,55
Crusaders,5854,2,16,6,4,64,34,30,54
Glenavon,5854,3,9,9,8,52,44,8,36
Linfield,5854,4,10,5,11,38,39,-1,35
Cliftonville,5854,5,10,4,12,35,32,3,34
Ballymena,5854,6,8,4,14,29,50,-21,28
Glentoran,5854,7,6,6,10,24,32,-8,24
Dungannon,5854,8,2,4,16,14,47,-33,10
Crusaders,5855,1,16,6,4,62,32,30,54
Coleraine,5855,2,14,11,1,43,22,21,53
Linfield,5855,3,11,5,10,39,37,2,38
Glenavon,5855,4,9,10,7,52,43,9,37
Cliftonville,5855,5,9,4,13,33,33,0,31
Ballymena,5855,6,8,4,14,27,48,-21,28
Glentoran,5855,7,6,6,10,24,32,-8,24
Dungannon,5855,8,2,4,16,14,47,-33,10
Coleraine,5856,1,15,10,1,47,24,23,55
Crusaders,5856,2,16,6,4,63,33,30,54
Linfield,5856,3,11,5,10,39,36,3,38
Glenavon,5856,4,9,9,8,54,47,7,36
Cliftonville,5856,5,9,4,13,32,33,-1,31
Ballymena,5856,6,8,4,14,28,49,-21,28
Glentoran,5856,7,6,6,10,24,32,-8,24
Dungannon,5856,8,2,4,16,14,47,-33,10
Crusaders,5857,1,17,6,3,63,30,33,57
Coleraine,5857,2,14,11,1,44,23,21,53
Glenavon,5857,3,9,10,7,53,44,9,37
Linfield,5857,4,10,6,10,39,38,1,36
Cliftonville,5857,5,9,5,12,34,33,1,32
Ballymena,5857,6,7,4,15,25,49,-24,25
Glentoran,5857,7,6,6,10,24,32,-8,24
Dungannon,5857,8,2,4,16,14,47,-33,10
Coleraine,5858,1,15,10,1,45,23,22,55
Crusaders,5858,2,16,6,4,62,32,30,54
Linfield,5858,3,11,5,10,38,36,2,38
Glenavon,5858,4,9,9,8,53,45,8,36
Cliftonville,5858,5,9,4,13,32,32,0,31
Ballymena,5858,6,8,4,14,27,48,-21,28
Glentoran,5858,7,6,6,10,24,32,-8,24
Dungannon,5858,8,2,4,16,14,47,-33,10
Coleraine,5859,1,15,10,1,45,23,22,55
Crusaders,5859,2,16,6,4,62,32,30,54
Linfield,5859,3,11,5,10,42,36,6,38
Glenavon,5859,4,9,9,8,53,45,8,36
Cliftonville,5859,5,9,4,13,32,36,-4,31
Ballymena,5859,6,8,4,14,27,48,-21,28
Glentoran,5859,7,6,6,10,24,32,-8,24
Dungannon,5859,8,2,4,16,14,47,-33,10
Crusaders,5860,1,17,6,3,64,30,34,57
Coleraine,5860,2,15,10,1,45,22,23,55
Glenavon,5860,3,9,9,8,52,45,7,36
Linfield,5860,4,10,6,10,40,39,1,36
Cliftonville,5860,5,9,5,12,35,34,1,32
Ballymena,5860,6,7,4,15,25,50,-25,25
Glentoran,5860,7,6,6,10,24,32,-8,24
Dungannon,5860,8,2,4,16,14,47,-33,10
Crusaders,5861,1,16,7,3,62,31,31,55
Coleraine,5861,2,14,11,1,43,22,21,53
Glenavon,5861,3,9,10,7,52,43,9,37
Linfield,5861,4,10,6,10,37,36,1,36
Cliftonville,5861,5,9,5,12,32,31,1,32
Ballymena,5861,6,7,5,14,26,48,-22,26
Glentoran,5861,7,6,6,10,24,32,-8,24
Dungannon,5861,8,2,4,16,14,47,-33,10
Crusaders,5862,1,16,6,4,61,31,30,54
Coleraine,5862,2,14,10,2,43,25,18,52
Glenavon,5862,3,10,9,7,55,43,12,39
Linfield,5862,4,10,6,10,38,37,1,36
Cliftonville,5862,5,9,5,12,33,32,1,32
Ballymena,5862,6,8,4,14,26,47,-21,28
Glentoran,5862,7,6,6,10,24,32,-8,24
Dungannon,5862,8,2,4,16,14,47,-33,10
Crusaders,5863,1,17,6,3,64,32,32,57
Coleraine,5863,2,15,10,1,47,23,24,55
Glenavon,5863,3,9,9,8,53,47,6,36
Linfield,5863,4,10,6,10,38,37,1,36
Cliftonville,5863,5,9,5,12,33,32,1,32
Ballymena,5863,6,7,4,15,27,50,-23,25
Glentoran,5863,7,6,6,10,24,32,-8,24
Dungannon,5863,8,2,4,16,14,47,-33,10
Crusaders,5864,1,16,6,4,63,33,30,54
Coleraine,5864,2,14,10,2,46,26,20,52
Glenavon,5864,3,10,9,7,56,46,10,39
Linfield,5864,4,10,5,11,37,38,-1,35
Cliftonville,5864,5,10,4,12,34,31,3,34
Ballymena,5864,6,8,4,14,28,49,-21,28
Glentoran,5864,7,6,6,10,24,32,-8,24
Dungannon,5864,8,2,4,16,14,47,-33,10
Crusaders,5865,1,16,6,4,63,34,29,54
Coleraine,5865,2,14,10,2,44,24,20,52
Glenavon,5865,3,10,9,7,54,44,10,39
Linfield,5865,4,10,5,11,37,37,0,35
Cliftonville,5865,5,10,4,12,33,31,2,34
Ballymena,5865,6,8,4,14,29,49,-20,28
Glentoran,5865,7,6,6,10,24,32,-8,24
Dungannon,5865,8,2,4,16,14,47,-33,10
Crusaders,5866,1,17,6,3,65,32,33,57
Coleraine,5866,2,14,10,2,44,25,19,52
Glenavon,5866,3,10,9,7,55,44,11,39
Linfield,5866,4,11,5,10,39,37,2,38
Cliftonville,5866,5,9,4,13,33,33,0,31
Ballymena,5866,6,7,4,15,27,51,-24,25
Glentoran,5866,7,6,6,10,24,32,-8,24
Dungannon,5866,8,2,4,16,14,47,-33,10
Crusaders,5867,1,16,6,4,62,32,30,54
Coleraine,5867,2,14,10,2,44,24,20,52
Glenavon,5867,3,10,9,7,54,44,10,39
Linfield,5867,4,10,5,11,37,37,0,35
Cliftonville,5867,5,10,4,12,33,31,2,34
Ballymena,5867,6,8,4,14,27,48,-21,28
Glentoran,5867,7,6,6,10,24,32,-8,24
Dungannon,5867,8,2,4,16,14,47,-33,10
Crusaders,5868,1,16,6,4,61,31,30,54
Coleraine,5868,2,14,11,1,44,23,21,53
Linfield,5868,3,11,5,10,38,36,2,38
Glenavon,5868,4,9,10,7,53,44,9,37
Cliftonville,5868,5,9,4,13,32,32,0,31
Ballymena,5868,6,8,4,14,26,47,-21,28
Glentoran,5868,7,6,6,10,24,32,-8,24
Dungannon,5868,8,2,4,16,14,47,-33,10
Crusaders,5869,1,17,6,3,63,31,32,57
Coleraine,5869,2,14,11,1,44,23,21,53
Glenavon,5869,3,9,10,7,53,44,9,37
Linfield,5869,4,10,6,10,37,36,1,36
Cliftonville,5869,5,9,5,12,32,31,1,32
Ballymena,5869,6,7,4,15,26,49,-23,25
Glentoran,5869,7,6,6,10,24,32,-8,24
Dungannon,5869,8,2,4,16,14,47,-33,10
Crusaders,5870,1,17,6,3,65,31,34,57
Coleraine,5870,2,14,10,2,43,27,16,52
Glenavon,5870,3,10,9,7,57,43,14,39
Linfield,5870,4,11,5,10,38,36,2,38
Cliftonville,5870,5,9,4,13,32,32,0,31
Ballymena,5870,6,7,4,15,26,51,-25,25
Glentoran,5870,7,6,6,10,24,32,-8,24
Dungannon,5870,8,2,4,16,14,47,-33,10
Crusaders,5871,1,17,6,3,62,30,32,57
Coleraine,5871,2,15,10,1,45,22,23,55
Linfield,5871,3,11,5,10,40,37,3,38
Glenavon,5871,4,9,9,8,52,45,7,36
Cliftonville,5871,5,9,4,13,33,34,-1,31
Ballymena,5871,6,7,4,15,25,48,-23,25
Glentoran,5871,7,6,6,10,24,32,-8,24
Dungannon,5871,8,2,4,16,14,47,-33,10
Crusaders,5872,1,17,6,3,63,30,33,57
Coleraine,5872,2,15,10,1,47,23,24,55
Glenavon,5872,3,9,9,8,53,47,6,36
Linfield,5872,4,10,6,10,38,37,1,36
Cliftonville,5872,5,9,5,12,33,32,1,32
Ballymena,5872,6,7,4,15,25,49,-24,25
Glentoran,5872,7,6,6,10,24,32,-8,24
Dungannon,5872,8,2,4,16,14,47,-33,10
Crusaders,5873,1,17,6,3,64,30,34,57
Coleraine,5873,2,14,10,2,44,24,20,52
Glenavon,5873,3,10,9,7,54,44,10,39
Linfield,5873,4,10,6,10,38,37,1,36
Cliftonville,5873,5,9,5,12,33,32,1,32
Ballymena,5873,6,7,4,15,25,50,-25,25
Glentoran,5873,7,6,6,10,24,32,-8,24
Dungannon,5873,8,2,4,16,14,47,-33,10
Crusaders,5874,1,17,6,3,63,30,33,57
Coleraine,5874,2,14,10,2,45,25,20,52
Glenavon,5874,3,10,9,7,55,45,10,39
Linfield,5874,4,11,5,10,40,36,4,38
Cliftonville,5874,5,9,4,13,32,34,-2,31
Ballymena,5874,6,7,4,15,25,49,-24,25
Glentoran,5874,7,6,6,10,24,32,-8,24
Dungannon,5874,8,2,4,16,14,47,-33,10
Crusaders,5875,1,16,7,3,63,32,31,55
Coleraine,5875,2,14,10,2,43,24,19,52
Glenavon,5875,3,10,9,7,54,43,11,39
Linfield,5875,4,11,5,10,40,36,4,38
Cliftonville,5875,5,9,4,13,32,34,-2,31
Ballymena,5875,6,7,5,14,27,49,-22,26
Glentoran,5875,7,6,6,10,24,32,-8,24
Dungannon,5875,8,2,4,16,14,47,-33,10
Crusaders,5876,1,16,7,3,62,31,31,55
Coleraine,5876,2,14,11,1,44,23,21,53
Linfield,5876,3,11,5,10,41,37,4,38
Glenavon,5876,4,9,10,7,53,44,9,37
Cliftonville,5876,5,9,4,13,33,35,-2,31
Ballymena,5876,6,7,5,14,26,48,-22,26
Glentoran,5876,7,6,6,10,24,32,-8,24
Dungannon,5876,8,2,4,16,14,47,-33,10
Crusaders,5877,1,17,6,3,64,32,32,57
Coleraine,5877,2,14,10,2,44,26,18,52
Glenavon,5877,3,10,9,7,56,44,12,39
Linfield,5877,4,11,5,10,39,37,2,38
Cliftonville,5877,5,9,4,13,33,33,0,31
Ballymena,5877,6,7,4,15,27,50,-23,25
Glentoran,5877,7,6,6,10,24,32,-8,24
Dungannon,5877,8,2,4,16,14,47,-33,10
Crusaders,5878,1,17,6,3,63,31,32,57
Coleraine,5878,2,15,10,1,45,23,22,55
Linfield,5878,3,11,5,10,40,37,3,38
Glenavon,5878,4,9,9,8,53,45,8,36
Cliftonville,5878,5,9,4,13,33,34,-1,31
Ballymena,5878,6,7,4,15,26,49,-23,25
Glentoran,5878,7,6,6,10,24,32,-8,24
Dungannon,5878,8,2,4,16,14,47,-33,10
Crusaders,5879,1,16,7,3,62,31,31,55
Coleraine,5879,2,14,10,2,44,26,18,52
Glenavon,5879,3,10,9,7,56,44,12,39
Linfield,5879,4,10,6,10,38,37,1,36
Cliftonville,5879,5,9,5,12,33,32,1,32
Ballymena,5879,6,7,5,14,26,48,-22,26
Glentoran,5879,7,6,6,10,24,32,-8,24
Dungannon,5879,8,2,4,16,14,47,-33,10
Crusaders,5880,1,17,6,3,62,30,32,57
Coleraine,5880,2,14,10,2,44,25,19,52
Glenavon,5880,3,10,9,7,55,44,11,39
Linfield,5880,4,10,6,10,38,37,1,36
Cliftonville,5880,5,9,5,12,33,32,1,32
Ballymena,5880,6,7,4,15,25,48,-23,25
Glentoran,5880,7,6,6,10,24,32,-8,24
Dungannon,5880,8,2,4,16,14,47,-33,10
Crusaders,5881,1,17,6,3,66,31,35,57
Coleraine,5881,2,15,10,1,44,22,22,55
Linfield,5881,3,11,5,10,39,36,3,38
Glenavon,5881,4,9,9,8,52,44,8,36
Cliftonville,5881,5,9,4,13,32,33,-1,31
Ballymena,5881,6,7,4,15,26,52,-26,25
Glentoran,5881,7,6,6,10,24,32,-8,24
Dungannon,5881,8,2,4,16,14,47,-33,10
Crusaders,5882,1,17,6,3,63,30,33,57
Coleraine,5882,2,14,10,2,43,24,19,52
Glenavon,5882,3,10,9,7,54,43,11,39
Linfield,5882,4,11,5,10,39,37,2,38
Cliftonville,5882,5,9,4,13,33,33,0,31
Ballymena,5882,6,7,4,15,25,49,-24,25
Glentoran,5882,7,6,6,10,24,32,-8,24
Dungannon,5882,8,2,4,16,14,47,-33,10
Crusaders,5883,1,16,7,3,63,32,31,55
Coleraine,5883,2,14,10,2,43,23,20,52
Glenavon,5883,3,10,9,7,53,43,10,39
Linfield,5883,4,10,5,11,37,38,-1,35
Cliftonville,5883,5,10,4,12,34,31,3,34
Ballymena,5883,6,7,5,14,27,49,-22,26
Glentoran,5883,7,6,6,10,24,32,-8,24
Dungannon,5883,8,2,4,16,14,47,-33,10
Crusaders,5884,1,17,6,3,63,31,32,57
Coleraine,5884,2,14,10,2,43,23,20,52
Glenavon,5884,3,10,9,7,53,43,10,39
Linfield,5884,4,10,5,11,37,38,-1,35
Cliftonville,5884,5,10,4,12,34,31,3,34
Ballymena,5884,6,7,4,15,26,49,-23,25
Glentoran,5884,7,6,6,10,24,32,-8,24
Dungannon,5884,8,2,4,16,14,47,-33,10
Crusaders,5885,1,16,6,4,64,34,30,54
Coleraine,5885,2,14,10,2,45,25,20,52
Glenavon,5885,3,10,9,7,55,45,10,39
Linfield,5885,4,11,5,10,40,37,3,38
Cliftonville,5885,5,9,4,13,33,34,-1,31
Ballymena,5885,6,8,4,14,29,50,-21,28
Glentoran,5885,7,6,6,10,24,32,-8,24
Dungannon,5885,8,2,4,16,14,47,-33,10
Crusaders,5886,1,16,7,3,62,31,31,55
Coleraine,5886,2,14,10,2,44,24,20,52
Glenavon,5886,3,10,9,7,54,44,10,39
Linfield,5886,4,10,5,11,38,38,0,35
Cliftonville,5886,5,10,4,12,34,32,2,34
Ballymena,5886,6,7,5,14,26,48,-22,26
Glentoran,5886,7,6,6,10,24,32,-8,24
Dungannon,5886,8,2,4,16,14,47,-33,10
Crusaders,5887,1,16,7,3,63,32,31,55
Coleraine,5887,2,14,10,2,44,24,20,52
Glenavon,5887,3,10,9,7,54,44,10,39
Linfield,5887,4,11,5,10,39,36,3,38
Cliftonville,5887,5,9,4,13,32,33,-1,31
Ballymena,5887,6,7,5,14,27,49,-22,26
Glentoran,5887,7,6,6,10,24,32,-8,24
Dungannon,5887,8,2,4,16,14,47,-33,10
Crusaders,5888,1,17,6,3,62,30,32,57
Coleraine,5888,2,15,10,1,46,23,23,55
Glenavon,5888,3,9,9,8,53,46,7,36
Linfield,5888,4,10,6,10,38,37,1,36
Cliftonville,5888,5,9,5,12,33,32,1,32
Ballymena,5888,6,7,4,15,25,48,-23,25
Glentoran,5888,7,6,6,10,24,32,-8,24
Dungannon,5888,8,2,4,16,14,47,-33,10
Crusaders,5889,1,16,6,4,63,35,28,54
Coleraine,5889,2,14,11,1,45,24,21,53
Linfield,5889,3,11,5,10,39,37,2,38
Glenavon,5889,4,9,10,7,54,45,9,37
Cliftonville,5889,5,9,4,13,33,33,0,31
Ballymena,5889,6,8,4,14,30,49,-19,28
Glentoran,5889,7,6,6,10,24,32,-8,24
Dungannon,5889,8,2,4,16,14,47,-33,10
Crusaders,5890,1,16,6,4,62,32,30,54
Coleraine,5890,2,14,10,2,46,26,20,52
Glenavon,5890,3,10,9,7,56,46,10,39
Linfield,5890,4,10,5,11,37,37,0,35
Cliftonville,5890,5,10,4,12,33,31,2,34
Ballymena,5890,6,8,4,14,27,48,-21,28
Glentoran,5890,7,6,6,10,24,32,-8,24
Dungannon,5890,8,2,4,16,14,47,-33,10
Crusaders,5891,1,16,6,4,61,32,29,54
Coleraine,5891,2,14,10,2,44,27,17,52
Glenavon,5891,3,10,9,7,57,44,13,39
Linfield,5891,4,11,5,10,38,36,2,38
Cliftonville,5891,5,9,4,13,32,32,0,31
Ballymena,5891,6,8,4,14,27,47,-20,28
Glentoran,5891,7,6,6,10,24,32,-8,24
Dungannon,5891,8,2,4,16,14,47,-33,10
Crusaders,5892,1,17,6,3,63,30,33,57
Coleraine,5892,2,14,11,1,44,23,21,53
Linfield,5892,3,11,5,10,39,36,3,38
Glenavon,5892,4,9,10,7,53,44,9,37
Cliftonville,5892,5,9,4,13,32,33,-1,31
Ballymena,5892,6,7,4,15,25,49,-24,25
Glentoran,5892,7,6,6,10,24,32,-8,24
Dungannon,5892,8,2,4,16,14,47,-33,10
Crusaders,5893,1,17,6,3,66,30,36,57
Coleraine,5893,2,14,10,2,44,24,20,52
Glenavon,5893,3,10,9,7,54,44,10,39
Linfield,5893,4,10,5,11,37,37,0,35
Cliftonville,5893,5,10,4,12,33,31,2,34
Ballymena,5893,6,7,4,15,25,52,-27,25
Glentoran,5893,7,6,6,10,24,32,-8,24
Dungannon,5893,8,2,4,16,14,47,-33,10
Crusaders,5894,1,17,6,3,65,31,34,57
Coleraine,5894,2,14,10,2,43,25,18,52
Glenavon,5894,3,10,9,7,55,43,12,39
Linfield,5894,4,10,5,11,38,38,0,35
Cliftonville,5894,5,10,4,12,34,32,2,34
Ballymena,5894,6,7,4,15,26,51,-25,25
Glentoran,5894,7,6,6,10,24,32,-8,24
Dungannon,5894,8,2,4,16,14,47,-33,10
Crusaders,5895,1,16,6,4,63,33,30,54
Coleraine,5895,2,14,10,2,43,25,18,52
Glenavon,5895,3,10,9,7,55,43,12,39
Linfield,5895,4,11,5,10,40,36,4,38
Cliftonville,5895,5,9,4,13,32,34,-2,31
Ballymena,5895,6,8,4,14,28,49,-21,28
Glentoran,5895,7,6,6,10,24,32,-8,24
Dungannon,5895,8,2,4,16,14,47,-33,10
Crusaders,5896,1,17,6,3,65,32,33,57
Coleraine,5896,2,14,10,2,43,26,17,52
Glenavon,5896,3,10,9,7,56,43,13,39
Linfield,5896,4,11,5,10,40,37,3,38
Cliftonville,5896,5,9,4,13,33,34,-1,31
Ballymena,5896,6,7,4,15,27,51,-24,25
Glentoran,5896,7,6,6,10,24,32,-8,24
Dungannon,5896,8,2,4,16,14,47,-33,10
Crusaders,5897,1,16,7,3,63,32,31,55
Coleraine,5897,2,14,11,1,43,22,21,53
Glenavon,5897,3,9,10,7,52,43,9,37
Linfield,5897,4,10,5,11,37,37,0,35
Cliftonville,5897,5,10,4,12,33,31,2,34
Ballymena,5897,6,7,5,14,27,49,-22,26
Glentoran,5897,7,6,6,10,24,32,-8,24
Dungannon,5897,8,2,4,16,14,47,-33,10
Crusaders,5898,1,16,7,3,62,31,31,55
Coleraine,5898,2,14,10,2,44,28,16,52
Glenavon,5898,3,10,9,7,58,44,14,39
Linfield,5898,4,10,5,11,38,39,-1,35
Cliftonville,5898,5,10,4,12,35,32,3,34
Ballymena,5898,6,7,5,14,26,48,-22,26
Glentoran,5898,7,6,6,10,24,32,-8,24
Dungannon,5898,8,2,4,16,14,47,-33,10
Crusaders,5899,1,16,7,3,62,31,31,55
Coleraine,5899,2,14,10,2,43,25,18,52
Glenavon,5899,3,10,9,7,55,43,12,39
Linfield,5899,4,11,5,10,40,36,4,38
Cliftonville,5899,5,9,4,13,32,34,-2,31
Ballymena,5899,6,7,5,14,26,48,-22,26
Glentoran,5899,7,6,6,10,24,32,-8,24
Dungannon,5899,8,2,4,16,14,47,-33,10
Crusaders,5900,1,17,6,3,62,30,32,57
Coleraine,5900,2,14,10,2,44,24,20,52
Glenavon,5900,3,10,9,7,54,44,10,39
Linfield,5900,4,11,5,10,38,36,2,38
Cliftonville,5900,5,9,4,13,32,32,0,31
Ballymena,5900,6,7,4,15,25,48,-23,25
Glentoran,5900,7,6,6,10,24,32,-8,24
Dungannon,5900,8,2,4,16,14,47,-33,10
Crusaders,5901,1,17,6,3,62,30,32,57
Coleraine,5901,2,14,10,2,44,25,19,52
Glenavon,5901,3,10,9,7,55,44,11,39
Linfield,5901,4,10,6,10,39,38,1,36
Cliftonville,5901,5,9,5,12,34,33,1,32
Ballymena,5901,6,7,4,15,25,48,-23,25
Glentoran,5901,7,6,6,10,24,32,-8,24
Dungannon,5901,8,2,4,16,14,47,-33,10
Crusaders,5902,1,16,7,3,64,33,31,55
Coleraine,5902,2,15,10,1,45,22,23,55
Glenavon,5902,3,9,9,8,52,45,7,36
Linfield,5902,4,10,5,11,39,40,-1,35
Cliftonville,5902,5,10,4,12,36,33,3,34
Ballymena,5902,6,7,5,14,28,50,-22,26
Glentoran,5902,7,6,6,10,24,32,-8,24
Dungannon,5902,8,2,4,16,14,47,-33,10
Crusaders,5903,1,17,6,3,64,31,33,57
Coleraine,5903,2,14,10,2,43,24,19,52
Glenavon,5903,3,10,9,7,54,43,11,39
Linfield,5903,4,11,5,10,38,36,2,38
Cliftonville,5903,5,9,4,13,32,32,0,31
Ballymena,5903,6,7,4,15,26,50,-24,25
Glentoran,5903,7,6,6,10,24,32,-8,24
Dungannon,5903,8,2,4,16,14,47,-33,10
Crusaders,5904,1,17,6,3,65,33,32,57
Coleraine,5904,2,15,10,1,45,23,22,55
Glenavon,5904,3,9,9,8,53,45,8,36
Linfield,5904,4,10,5,11,38,39,-1,35
Cliftonville,5904,5,10,4,12,35,32,3,34
Ballymena,5904,6,7,4,15,28,51,-23,25
Glentoran,5904,7,6,6,10,24,32,-8,24
Dungannon,5904,8,2,4,16,14,47,-33,10
Crusaders,5905,1,16,7,3,62,31,31,55
Coleraine,5905,2,15,10,1,44,22,22,55
Linfield,5905,3,11,5,10,38,36,2,38
Glenavon,5905,4,9,9,8,52,44,8,36
Cliftonville,5905,5,9,4,13,32,32,0,31
Ballymena,5905,6,7,5,14,26,48,-22,26
Glentoran,5905,7,6,6,10,24,32,-8,24
Dungannon,5905,8,2,4,16,14,47,-33,10
Crusaders,5906,1,17,6,3,62,30,32,57
Coleraine,5906,2,14,10,2,45,25,20,52
Glenavon,5906,3,10,9,7,55,45,10,39
Linfield,5906,4,11,5,10,40,37,3,38
Cliftonville,5906,5,9,4,13,33,34,-1,31
Ballymena,5906,6,7,4,15,25,48,-23,25
Glentoran,5906,7,6,6,10,24,32,-8,24
Dungannon,5906,8,2,4,16,14,47,-33,10
Crusaders,5907,1,16,7,3,62,31,31,55
Coleraine,5907,2,14,10,2,43,23,20,52
Glenavon,5907,3,10,9,7,53,43,10,39
Linfield,5907,4,11,5,10,41,39,2,38
Cliftonville,5907,5,9,4,13,35,35,0,31
Ballymena,5907,6,7,5,14,26,48,-22,26
Glentoran,5907,7,6,6,10,24,32,-8,24
Dungannon,5907,8,2,4,16,14,47,-33,10
Crusaders,5908,1,16,6,4,62,34,28,54
Coleraine,5908,2,14,10,2,43,23,20,52
Glenavon,5908,3,10,9,7,53,43,10,39
Linfield,5908,4,10,5,11,39,39,0,35
Cliftonville,5908,5,10,4,12,35,33,2,34
Ballymena,5908,6,8,4,14,29,48,-19,28
Glentoran,5908,7,6,6,10,24,32,-8,24
Dungannon,5908,8,2,4,16,14,47,-33,10
Crusaders,5909,1,17,6,3,66,30,36,57
Coleraine,5909,2,14,10,2,43,23,20,52
Glenavon,5909,3,10,9,7,53,43,10,39
Linfield,5909,4,11,5,10,40,37,3,38
Cliftonville,5909,5,9,4,13,33,34,-1,31
Ballymena,5909,6,7,4,15,25,52,-27,25
Glentoran,5909,7,6,6,10,24,32,-8,24
Dungannon,5909,8,2,4,16,14,47,-33,10
Crusaders,5910,1,16,7,3,62,31,31,55
Coleraine,5910,2,14,10,2,44,24,20,52
Glenavon,5910,3,10,9,7,54,44,10,39
Linfield,5910,4,10,6,10,38,37,1,36
Cliftonville,5910,5,9,5,12,33,32,1,32
Ballymena,5910,6,7,5,14,26,48,-22,26
Glentoran,5910,7,6,6,10,24,32,-8,24
Dungannon,5910,8,2,4,16,14,47,-33,10
Crusaders,5911,1,17,6,3,64,31,33,57
Coleraine,5911,2,15,10,1,46,23,23,55
Linfield,5911,3,11,5,10,40,36,4,38
Glenavon,5911,4,9,9,8,53,46,7,36
Cliftonville,5911,5,9,4,13,32,34,-2,31
Ballymena,5911,6,7,4,15,26,50,-24,25
Glentoran,5911,7,6,6,10,24,32,-8,24
Dungannon,5911,8,2,4,16,14,47,-33,10
Crusaders,5912,1,17,6,3,63,31,32,57
Coleraine,5912,2,14,10,2,44,25,19,52
Glenavon,5912,3,10,9,7,55,44,11,39
Linfield,5912,4,10,5,11,38,39,-1,35
Cliftonville,5912,5,10,4,12,35,32,3,34
Ballymena,5912,6,7,4,15,26,49,-23,25
Glentoran,5912,7,6,6,10,24,32,-8,24
Dungannon,5912,8,2,4,16,14,47,-33,10
Crusaders,5913,1,16,7,3,63,32,31,55
Coleraine,5913,2,14,10,2,47,28,19,52
Glenavon,5913,3,10,9,7,58,47,11,39
Linfield,5913,4,11,5,10,39,36,3,38
Cliftonville,5913,5,9,4,13,32,33,-1,31
Ballymena,5913,6,7,5,14,27,49,-22,26
Glentoran,5913,7,6,6,10,24,32,-8,24
Dungannon,5913,8,2,4,16,14,47,-33,10
Crusaders,5914,1,16,7,3,63,32,31,55
Coleraine,5914,2,14,10,2,45,26,19,52
Glenavon,5914,3,10,9,7,56,45,11,39
Linfield,5914,4,11,5,10,39,37,2,38
Cliftonville,5914,5,9,4,13,33,33,0,31
Ballymena,5914,6,7,5,14,27,49,-22,26
Glentoran,5914,7,6,6,10,24,32,-8,24
Dungannon,5914,8,2,4,16,14,47,-33,10
Crusaders,5915,1,17,6,3,63,30,33,57
Coleraine,5915,2,14,10,2,43,23,20,52
Glenavon,5915,3,10,9,7,53,43,10,39
Linfield,5915,4,10,5,11,37,39,-2,35
Cliftonville,5915,5,10,4,12,35,31,4,34
Ballymena,5915,6,7,4,15,25,49,-24,25
Glentoran,5915,7,6,6,10,24,32,-8,24
Dungannon,5915,8,2,4,16,14,47,-33,10
Crusaders,5916,1,17,6,3,63,30,33,57
Coleraine,5916,2,15,10,1,45,23,22,55
Linfield,5916,3,11,5,10,40,36,4,38
Glenavon,5916,4,9,9,8,53,45,8,36
Cliftonville,5916,5,9,4,13,32,34,-2,31
Ballymena,5916,6,7,4,15,25,49,-24,25
Glentoran,5916,7,6,6,10,24,32,-8,24
Dungannon,5916,8,2,4,16,14,47,-33,10
Crusaders,5917,1,16,6,4,61,31,30,54
Coleraine,5917,2,14,10,2,45,25,20,52
Glenavon,5917,3,10,9,7,55,45,10,39
Linfield,5917,4,10,6,10,37,36,1,36
Cliftonville,5917,5,9,5,12,32,31,1,32
Ballymena,5917,6,8,4,14,26,47,-21,28
Glentoran,5917,7,6,6,10,24,32,-8,24
Dungannon,5917,8,2,4,16,14,47,-33,10
Crusaders,5918,1,16,7,3,63,32,31,55
Coleraine,5918,2,14,11,1,43,22,21,53
Linfield,5918,3,11,5,10,40,38,2,38
Glenavon,5918,4,9,10,7,52,43,9,37
Cliftonville,5918,5,9,4,13,34,34,0,31
Ballymena,5918,6,7,5,14,27,49,-22,26
Glentoran,5918,7,6,6,10,24,32,-8,24
Dungannon,5918,8,2,4,16,14,47,-33,10
Crusaders,5919,1,16,7,3,63,32,31,55
Coleraine,5919,2,15,10,1,45,23,22,55
Linfield,5919,3,11,5,10,40,36,4,38
Glenavon,5919,4,9,9,8,53,45,8,36
Cliftonville,5919,5,9,4,13,32,34,-2,31
Ballymena,5919,6,7,5,14,27,49,-22,26
Glentoran,5919,7,6,6,10,24,32,-8,24
Dungannon,5919,8,2,4,16,14,47,-33,10
Crusaders,5920,1,17,6,3,63,30,33,57
Coleraine,5920,2,15,10,1,45,23,22,55
Linfield,5920,3,11,5,10,39,36,3,38
Glenavon,5920,4,9,9,8,53,45,8,36
Cliftonville,5920,5,9,4,13,32,33,-1,31
Ballymena,5920,6,7,4,15,25,49,-24,25
Glentoran,5920,7,6,6,10,24,32,-8,24
Dungannon,5920,8,2,4,16,14,47,-33,10
Crusaders,5921,1,17,6,3,65,31,34,57
Coleraine,5921,2,15,10,1,45,23,22,55
Glenavon,5921,3,9,9,8,53,45,8,36
Linfield,5921,4,10,6,10,39,38,1,36
Cliftonville,5921,5,9,5,12,34,33,1,32
Ballymena,5921,6,7,4,15,26,51,-25,25
Glentoran,5921,7,6,6,10,24,32,-8,24
Dungannon,5921,8,2,4,16,14,47,-33,10
Crusaders,5922,1,17,6,3,65,31,34,57
Coleraine,5922,2,14,11,1,44,23,21,53
Glenavon,5922,3,9,10,7,53,44,9,37
Linfield,5922,4,10,6,10,38,37,1,36
Cliftonville,5922,5,9,5,12,33,32,1,32
Ballymena,5922,6,7,4,15,26,51,-25,25
Glentoran,5922,7,6,6,10,24,32,-8,24
Dungannon,5922,8,2,4,16,14,47,-33,10
Crusaders,5923,1,17,6,3,63,30,33,57
Coleraine,5923,2,14,11,1,44,23,21,53
Linfield,5923,3,11,5,10,39,36,3,38
Glenavon,5923,4,9,10,7,53,44,9,37
Cliftonville,5923,5,9,4,13,32,33,-1,31
Ballymena,5923,6,7,4,15,25,49,-24,25
Glentoran,5923,7,6,6,10,24,32,-8,24
Dungannon,5923,8,2,4,16,14,47,-33,10
Crusaders,5924,1,17,6,3,65,32,33,57
Coleraine,5924,2,15,10,1,45,23,22,55
Linfield,5924,3,11,5,10,38,36,2,38
Glenavon,5924,4,9,9,8,53,45,8,36
Cliftonville,5924,5,9,4,13,32,32,0,31
Ballymena,5924,6,7,4,15,27,51,-24,25
Glentoran,5924,7,6,6,10,24,32,-8,24
Dungannon,5924,8,2,4,16,14,47,-33,10
Crusaders,5925,1,17,6,3,64,31,33,57
Coleraine,5925,2,15,10,1,44,22,22,55
Glenavon,5925,3,9,9,8,52,44,8,36
Linfield,5925,4,10,6,10,39,38,1,36
Cliftonville,5925,5,9,5,12,34,33,1,32
Ballymena,5925,6,7,4,15,26,50,-24,25
Glentoran,5925,7,6,6,10,24,32,-8,24
Dungannon,5925,8,2,4,16,14,47,-33,10
Crusaders,5926,1,16,6,4,62,32,30,54
Coleraine,5926,2,14,10,2,44,25,19,52
Glenavon,5926,3,10,9,7,55,44,11,39
Linfield,5926,4,10,6,10,37,36,1,36
Cliftonville,5926,5,9,5,12,32,31,1,32
Ballymena,5926,6,8,4,14,27,48,-21,28
Glentoran,5926,7,6,6,10,24,32,-8,24
Dungannon,5926,8,2,4,16,14,47,-33,10
Crusaders,5927,1,16,6,4,61,33,28,54
Coleraine,5927,2,14,10,2,45,25,20,52
Glenavon,5927,3,10,9,7,55,45,10,39
Linfield,5927,4,11,5,10,38,36,2,38
Cliftonville,5927,5,9,4,13,32,32,0,31
Ballymena,5927,6,8,4,14,28,47,-19,28
Glentoran,5927,7,6,6,10,24,32,-8,24
Dungannon,5927,8,2,4,16,14,47,-33,10
Crusaders,5928,1,16,7,3,62,31,31,55
Coleraine,5928,2,14,11,1,44,23,21,53
Glenavon,5928,3,9,10,7,53,44,9,37
Linfield,5928,4,10,5,11,37,37,0,35
Cliftonville,5928,5,10,4,12,33,31,2,34
Ballymena,5928,6,7,5,14,26,48,-22,26
Glentoran,5928,7,6,6,10,24,32,-8,24
Dungannon,5928,8,2,4,16,14,47,-33,10
Crusaders,5929,1,17,6,3,63,30,33,57
Coleraine,5929,2,14,10,2,45,25,20,52
Glenavon,5929,3,10,9,7,55,45,10,39
Linfield,5929,4,10,6,10,38,37,1,36
Cliftonville,5929,5,9,5,12,33,32,1,32
Ballymena,5929,6,7,4,15,25,49,-24,25
Glentoran,5929,7,6,6,10,24,32,-8,24
Dungannon,5929,8,2,4,16,14,47,-33,10
Crusaders,5930,1,16,7,3,62,31,31,55
Coleraine,5930,2,15,10,1,45,23,22,55
Glenavon,5930,3,9,9,8,53,45,8,36
Linfield,5930,4,10,6,10,37,36,1,36
Cliftonville,5930,5,9,5,12,32,31,1,32
Ballymena,5930,6,7,5,14,26,48,-22,26
Glentoran,5930,7,6,6,10,24,32,-8,24
Dungannon,5930,8,2,4,16,14,47,-33,10
Crusaders,5931,1,17,6,3,63,30,33,57
Coleraine,5931,2,15,10,1,47,24,23,55
Linfield,5931,3,11,5,10,38,36,2,38
Glenavon,5931,4,9,9,8,54,47,7,36
Cliftonville,5931,5,9,4,13,32,32,0,31
Ballymena,5931,6,7,4,15,25,49,-24,25
Glentoran,5931,7,6,6,10,24,32,-8,24
Dungannon,5931,8,2,4,16,14,47,-33,10
Crusaders,5932,1,16,7,3,62,31,31,55
Coleraine,5932,2,14,10,2,45,27,18,52
Glenavon,5932,3,10,9,7,57,45,12,39
Linfield,5932,4,11,5,10,39,36,3,38
Cliftonville,5932,5,9,4,13,32,33,-1,31
Ballymena,5932,6,7,5,14,26,48,-22,26
Glentoran,5932,7,6,6,10,24,32,-8,24
Dungannon,5932,8,2,4,16,14,47,-33,10
Crusaders,5933,1,16,7,3,63,32,31,55
Coleraine,5933,2,14,11,1,44,23,21,53
Glenavon,5933,3,9,10,7,53,44,9,37
Linfield,5933,4,10,5,11,37,38,-1,35
Cliftonville,5933,5,10,4,12,34,31,3,34
Ballymena,5933,6,7,5,14,27,49,-22,26
Glentoran,5933,7,6,6,10,24,32,-8,24
Dungannon,5933,8,2,4,16,14,47,-33,10
Crusaders,5934,1,17,6,3,63,31,32,57
Coleraine,5934,2,14,11,1,45,24,21,53
Glenavon,5934,3,9,10,7,54,45,9,37
Linfield,5934,4,10,5,11,38,38,0,35
Cliftonville,5934,5,10,4,12,34,32,2,34
Ballymena,5934,6,7,4,15,26,49,-23,25
Glentoran,5934,7,6,6,10,24,32,-8,24
Dungannon,5934,8,2,4,16,14,47,-33,10
Crusaders,5935,1,17,6,3,64,31,33,57
Coleraine,5935,2,15,10,1,44,22,22,55
Glenavon,5935,3,9,9,8,52,44,8,36
Linfield,5935,4,10,5,11,38,38,0,35
Cliftonville,5935,5,10,4,12,34,32,2,34
Ballymena,5935,6,7,4,15,26,50,-24,25
Glentoran,5935,7,6,6,10,24,32,-8,24
Dungannon,5935,8,2,4,16,14,47,-33,10
Crusaders,5936,1,16,6,4,65,35,30,54
Coleraine,5936,2,14,10,2,44,28,16,52
Glenavon,5936,3,10,9,7,58,44,14,39
Linfield,5936,4,11,5,10,39,36,3,38
Cliftonville,5936,5,9,4,13,32,33,-1,31
Ballymena,5936,6,8,4,14,30,51,-21,28
Glentoran,5936,7,6,6,10,24,32,-8,24
Dungannon,5936,8,2,4,16,14,47,-33,10
Crusaders,5937,1,16,7,3,63,32,31,55
Coleraine,5937,2,14,10,2,43,23,20,52
Glenavon,5937,3,10,9,7,53,43,10,39
Linfield,5937,4,11,5,10,40,36,4,38
Cliftonville,5937,5,9,4,13,32,34,-2,31
Ballymena,5937,6,7,5,14,27,49,-22,26
Glentoran,5937,7,6,6,10,24,32,-8,24
Dungannon,5937,8,2,4,16,14,47,-33,10
Crusaders,5938,1,17,6,3,63,31,32,57
Coleraine,5938,2,15,10,1,46,23,23,55
Linfield,5938,3,11,5,10,40,37,3,38
Glenavon,5938,4,9,9,8,53,46,7,36
Cliftonville,5938,5,9,4,13,33,34,-1,31
Ballymena,5938,6,7,4,15,26,49,-23,25
Glentoran,5938,7,6,6,10,24,32,-8,24
Dungannon,5938,8,2,4,16,14,47,-33,10
Crusaders,5939,1,16,7,3,61,30,31,55
Coleraine,5939,2,14,10,2,44,25,19,52
Glenavon,5939,3,10,9,7,55,44,11,39
Linfield,5939,4,11,5,10,39,36,3,38
Cliftonville,5939,5,9,4,13,32,33,-1,31
Ballymena,5939,6,7,5,14,25,47,-22,26
Glentoran,5939,7,6,6,10,24,32,-8,24
Dungannon,5939,8,2,4,16,14,47,-33,10
Crusaders,5940,1,17,6,3,65,31,34,57
Coleraine,5940,2,15,10,1,45,22,23,55
Linfield,5940,3,11,5,10,40,37,3,38
Glenavon,5940,4,9,9,8,52,45,7,36
Cliftonville,5940,5,9,4,13,33,34,-1,31
Ballymena,5940,6,7,4,15,26,51,-25,25
Glentoran,5940,7,6,6,10,24,32,-8,24
Dungannon,5940,8,2,4,16,14,47,-33,10
Crusaders,5941,1,17,6,3,65,30,35,57
Coleraine,5941,2,15,10,1,46,23,23,55
Linfield,5941,3,11,5,10,41,38,3,38
Glenavon,5941,4,9,9,8,53,46,7,36
Cliftonville,5941,5,9,4,13,34,35,-1,31
Ballymena,5941,6,7,4,15,25,51,-26,25
Glentoran,5941,7,6,6,10,24,32,-8,24
Dungannon,5941,8,2,4,16,14,47,-33,10
Coleraine,5942,1,15,10,1,45,23,22,55
Crusaders,5942,2,16,6,4,61,31,30,54
Glenavon,5942,3,9,9,8,53,45,8,36
Linfield,5942,4,10,6,10,38,37,1,36
Cliftonville,5942,5,9,5,12,33,32,1,32
Ballymena,5942,6,8,4,14,26,47,-21,28
Glentoran,5942,7,6,6,10,24,32,-8,24
Dungannon,5942,8,2,4,16,14,47,-33,10
Crusaders,5943,1,16,7,3,61,30,31,55
Coleraine,5943,2,14,11,1,44,23,21,53
Linfield,5943,3,11,5,10,39,37,2,38
Glenavon,5943,4,9,10,7,53,44,9,37
Cliftonville,5943,5,9,4,13,33,33,0,31
Ballymena,5943,6,7,5,14,25,47,-22,26
Glentoran,5943,7,6,6,10,24,32,-8,24
Dungannon,5943,8,2,4,16,14,47,-33,10
Crusaders,5944,1,17,6,3,65,32,33,57
Coleraine,5944,2,14,11,1,47,26,21,53
Linfield,5944,3,11,5,10,40,37,3,38
Glenavon,5944,4,9,10,7,56,47,9,37
Cliftonville,5944,5,9,4,13,33,34,-1,31
Ballymena,5944,6,7,4,15,27,51,-24,25
Glentoran,5944,7,6,6,10,24,32,-8,24
Dungannon,5944,8,2,4,16,14,47,-33,10
Crusaders,5945,1,17,6,3,63,31,32,57
Coleraine,5945,2,14,10,2,43,27,16,52
Glenavon,5945,3,10,9,7,57,43,14,39
Linfield,5945,4,10,5,11,40,40,0,35
Cliftonville,5945,5,10,4,12,36,34,2,34
Ballymena,5945,6,7,4,15,26,49,-23,25
Glentoran,5945,7,6,6,10,24,32,-8,24
Dungannon,5945,8,2,4,16,14,47,-33,10
Coleraine,5946,1,15,10,1,45,23,22,55
Crusaders,5946,2,16,6,4,62,32,30,54
Linfield,5946,3,11,5,10,38,36,2,38
Glenavon,5946,4,9,9,8,53,45,8,36
Cliftonville,5946,5,9,4,13,32,32,0,31
Ballymena,5946,6,8,4,14,27,48,-21,28
Glentoran,5946,7,6,6,10,24,32,-8,24
Dungannon,5946,8,2,4,16,14,47,-33,10
Crusaders,5947,1,16,6,4,61,31,30,54
Coleraine,5947,2,14,10,2,44,24,20,52
Glenavon,5947,3,10,9,7,54,44,10,39
Linfield,5947,4,11,5,10,39,36,3,38
Cliftonville,5947,5,9,4,13,32,33,-1,31
Ballymena,5947,6,8,4,14,26,47,-21,28
Glentoran,5947,7,6,6,10,24,32,-8,24
Dungannon,5947,8,2,4,16,14,47,-33,10
Crusaders,5948,1,17,6,3,67,32,35,57
Coleraine,5948,2,15,10,1,47,23,24,55
Linfield,5948,3,11,5,10,39,36,3,38
Glenavon,5948,4,9,9,8,53,47,6,36
Cliftonville,5948,5,9,4,13,32,33,-1,31
Ballymena,5948,6,7,4,15,27,53,-26,25
Glentoran,5948,7,6,6,10,24,32,-8,24
Dungannon,5948,8,2,4,16,14,47,-33,10
Crusaders,5949,1,16,6,4,61,31,30,54
Coleraine,5949,2,14,11,1,43,22,21,53
Linfield,5949,3,11,5,10,39,37,2,38
Glenavon,5949,4,9,10,7,52,43,9,37
Cliftonville,5949,5,9,4,13,33,33,0,31
Ballymena,5949,6,8,4,14,26,47,-21,28
Glentoran,5949,7,6,6,10,24,32,-8,24
Dungannon,5949,8,2,4,16,14,47,-33,10
Crusaders,5950,1,16,6,4,64,34,30,54
Coleraine,5950,2,14,10,2,44,24,20,52
Glenavon,5950,3,10,9,7,54,44,10,39
Linfield,5950,4,10,5,11,37,37,0,35
Cliftonville,5950,5,10,4,12,33,31,2,34
Ballymena,5950,6,8,4,14,29,50,-21,28
Glentoran,5950,7,6,6,10,24,32,-8,24
Dungannon,5950,8,2,4,16,14,47,-33,10
Crusaders,5951,1,17,6,3,66,30,36,57
Coleraine,5951,2,15,10,1,45,23,22,55
Glenavon,5951,3,9,9,8,53,45,8,36
Linfield,5951,4,10,5,11,37,37,0,35
Cliftonville,5951,5,10,4,12,33,31,2,34
Ballymena,5951,6,7,4,15,25,52,-27,25
Glentoran,5951,7,6,6,10,24,32,-8,24
Dungannon,5951,8,2,4,16,14,47,-33,10
Crusaders,5952,1,17,6,3,63,31,32,57
Coleraine,5952,2,14,10,2,43,23,20,52
Glenavon,5952,3,10,9,7,53,43,10,39
Linfield,5952,4,10,5,11,38,38,0,35
Cliftonville,5952,5,10,4,12,34,32,2,34
Ballymena,5952,6,7,4,15,26,49,-23,25
Glentoran,5952,7,6,6,10,24,32,-8,24
Dungannon,5952,8,2,4,16,14,47,-33,10
Crusaders,5953,1,17,6,3,63,31,32,57
Coleraine,5953,2,14,11,1,45,24,21,53
Linfield,5953,3,11,5,10,39,36,3,38
Glenavon,5953,4,9,10,7,54,45,9,37
Cliftonville,5953,5,9,4,13,32,33,-1,31
Ballymena,5953,6,7,4,15,26,49,-23,25
Glentoran,5953,7,6,6,10,24,32,-8,24
Dungannon,5953,8,2,4,16,14,47,-33,10
Crusaders,5954,1,16,7,3,61,30,31,55
Coleraine,5954,2,14,10,2,43,24,19,52
Glenavon,5954,3,10,9,7,54,43,11,39
Linfield,5954,4,11,5,10,39,36,3,38
Cliftonville,5954,5,9,4,13,32,33,-1,31
Ballymena,5954,6,7,5,14,25,47,-22,26
Glentoran,5954,7,6,6,10,24,32,-8,24
Dungannon,5954,8,2,4,16,14,47,-33,10
Crusaders,5955,1,16,6,4,62,32,30,54
Coleraine,5955,2,14,11,1,45,24,21,53
Glenavon,5955,3,9,10,7,54,45,9,37
Linfield,5955,4,10,6,10,39,38,1,36
Cliftonville,5955,5,9,5,12,34,33,1,32
Ballymena,5955,6,8,4,14,27,48,-21,28
Glentoran,5955,7,6,6,10,24,32,-8,24
Dungannon,5955,8,2,4,16,14,47,-33,10
Crusaders,5956,1,17,6,3,64,31,33,57
Coleraine,5956,2,14,10,2,43,24,19,52
Glenavon,5956,3,10,9,7,54,43,11,39
Linfield,5956,4,10,6,10,38,37,1,36
Cliftonville,5956,5,9,5,12,33,32,1,32
Ballymena,5956,6,7,4,15,26,50,-24,25
Glentoran,5956,7,6,6,10,24,32,-8,24
Dungannon,5956,8,2,4,16,14,47,-33,10
Crusaders,5957,1,17,6,3,66,31,35,57
Coleraine,5957,2,14,10,2,44,25,19,52
Glenavon,5957,3,10,9,7,55,44,11,39
Linfield,5957,4,11,5,10,40,36,4,38
Cliftonville,5957,5,9,4,13,32,34,-2,31
Ballymena,5957,6,7,4,15,26,52,-26,25
Glentoran,5957,7,6,6,10,24,32,-8,24
Dungannon,5957,8,2,4,16,14,47,-33,10
Coleraine,5958,1,15,10,1,45,23,22,55
Crusaders,5958,2,16,6,4,61,31,30,54
Glenavon,5958,3,9,9,8,53,45,8,36
Linfield,5958,4,10,5,11,38,39,-1,35
Cliftonville,5958,5,10,4,12,35,32,3,34
Ballymena,5958,6,8,4,14,26,47,-21,28
Glentoran,5958,7,6,6,10,24,32,-8,24
Dungannon,5958,8,2,4,16,14,47,-33,10
Crusaders,5959,1,16,6,4,61,31,30,54
Coleraine,5959,2,14,11,1,44,23,21,53
Linfield,5959,3,11,5,10,39,36,3,38
Glenavon,5959,4,9,10,7,53,44,9,37
Cliftonville,5959,5,9,4,13,32,33,-1,31
Ballymena,5959,6,8,4,14,26,47,-21,28
Glentoran,5959,7,6,6,10,24,32,-8,24
Dungannon,5959,8,2,4,16,14,47,-33,10
Crusaders,5960,1,17,6,3,63,31,32,57
Coleraine,5960,2,14,10,2,45,26,19,52
Glenavon,5960,3,10,9,7,56,45,11,39
Linfield,5960,4,10,6,10,38,37,1,36
Cliftonville,5960,5,9,5,12,33,32,1,32
Ballymena,5960,6,7,4,15,26,49,-23,25
Glentoran,5960,7,6,6,10,24,32,-8,24
Dungannon,5960,8,2,4,16,14,47,-33,10
Crusaders,5961,1,17,6,3,64,30,34,57
Coleraine,5961,2,14,10,2,43,24,19,52
Glenavon,5961,3,10,9,7,54,43,11,39
Linfield,5961,4,10,6,10,38,37,1,36
Cliftonville,5961,5,9,5,12,33,32,1,32
Ballymena,5961,6,7,4,15,25,50,-25,25
Glentoran,5961,7,6,6,10,24,32,-8,24
Dungannon,5961,8,2,4,16,14,47,-33,10
Crusaders,5962,1,16,7,3,61,30,31,55
Coleraine,5962,2,15,10,1,45,22,23,55
Glenavon,5962,3,9,9,8,52,45,7,36
Linfield,5962,4,10,5,11,37,38,-1,35
Cliftonville,5962,5,10,4,12,34,31,3,34
Ballymena,5962,6,7,5,14,25,47,-22,26
Glentoran,5962,7,6,6,10,24,32,-8,24
Dungannon,5962,8,2,4,16,14,47,-33,10
Crusaders,5963,1,16,6,4,62,32,30,54
Coleraine,5963,2,14,10,2,44,24,20,52
Glenavon,5963,3,10,9,7,54,44,10,39
Linfield,5963,4,10,6,10,38,37,1,36
Cliftonville,5963,5,9,5,12,33,32,1,32
Ballymena,5963,6,8,4,14,27,48,-21,28
Glentoran,5963,7,6,6,10,24,32,-8,24
Dungannon,5963,8,2,4,16,14,47,-33,10
Crusaders,5964,1,17,6,3,63,30,33,57
Coleraine,5964,2,14,10,2,44,25,19,52
Glenavon,5964,3,10,9,7,55,44,11,39
Linfield,5964,4,10,6,10,38,37,1,36
Cliftonville,5964,5,9,5,12,33,32,1,32
Ballymena,5964,6,7,4,15,25,49,-24,25
Glentoran,5964,7,6,6,10,24,32,-8,24
Dungannon,5964,8,2,4,16,14,47,-33,10
Crusaders,5965,1,16,6,4,62,32,30,54
Coleraine,5965,2,14,10,2,45,26,19,52
Glenavon,5965,3,10,9,7,56,45,11,39
Linfield,5965,4,11,5,10,40,36,4,38
Cliftonville,5965,5,9,4,13,32,34,-2,31
Ballymena,5965,6,8,4,14,27,48,-21,28
Glentoran,5965,7,6,6,10,24,32,-8,24
Dungannon,5965,8,2,4,16,14,47,-33,10
Crusaders,5966,1,17,6,3,64,32,32,57
Coleraine,5966,2,14,10,2,43,23,20,52
Glenavon,5966,3,10,9,7,53,43,10,39
Linfield,5966,4,10,5,11,38,39,-1,35
Cliftonville,5966,5,10,4,12,35,32,3,34
Ballymena,5966,6,7,4,15,27,50,-23,25
Glentoran,5966,7,6,6,10,24,32,-8,24
Dungannon,5966,8,2,4,16,14,47,-33,10
Crusaders,5967,1,17,6,3,63,30,33,57
Coleraine,5967,2,15,10,1,48,22,26,55
Glenavon,5967,3,9,9,8,52,48,4,36
Linfield,5967,4,10,6,10,41,40,1,36
Cliftonville,5967,5,9,5,12,36,35,1,32
Ballymena,5967,6,7,4,15,25,49,-24,25
Glentoran,5967,7,6,6,10,24,32,-8,24
Dungannon,5967,8,2,4,16,14,47,-33,10
Crusaders,5968,1,16,6,4,61,32,29,54
Coleraine,5968,2,14,11,1,43,22,21,53
Linfield,5968,3,11,5,10,40,36,4,38
Glenavon,5968,4,9,10,7,52,43,9,37
Cliftonville,5968,5,9,4,13,32,34,-2,31
Ballymena,5968,6,8,4,14,27,47,-20,28
Glentoran,5968,7,6,6,10,24,32,-8,24
Dungannon,5968,8,2,4,16,14,47,-33,10
Crusaders,5969,1,17,6,3,63,30,33,57
Coleraine,5969,2,14,10,2,43,23,20,52
Glenavon,5969,3,10,9,7,53,43,10,39
Linfield,5969,4,10,6,10,38,37,1,36
Cliftonville,5969,5,9,5,12,33,32,1,32
Ballymena,5969,6,7,4,15,25,49,-24,25
Glentoran,5969,7,6,6,10,24,32,-8,24
Dungannon,5969,8,2,4,16,14,47,-33,10
Crusaders,5970,1,17,6,3,65,31,34,57
Coleraine,5970,2,14,10,2,43,25,18,52
Glenavon,5970,3,10,9,7,55,43,12,39
Linfield,5970,4,10,6,10,37,36,1,36
Cliftonville,5970,5,9,5,12,32,31,1,32
Ballymena,5970,6,7,4,15,26,51,-25,25
Glentoran,5970,7,6,6,10,24,32,-8,24
Dungannon,5970,8,2,4,16,14,47,-33,10
Coleraine,5971,1,15,10,1,46,23,23,55
Crusaders,5971,2,16,6,4,63,33,30,54
Glenavon,5971,3,9,9,8,53,46,7,36
Linfield,5971,4,10,6,10,37,36,1,36
Cliftonville,5971,5,9,5,12,32,31,1,32
Ballymena,5971,6,8,4,14,28,49,-21,28
Glentoran,5971,7,6,6,10,24,32,-8,24
Dungannon,5971,8,2,4,16,14,47,-33,10
Crusaders,5972,1,17,6,3,62,30,32,57
Coleraine,5972,2,14,10,2,43,25,18,52
Glenavon,5972,3,10,9,7,55,43,12,39
Linfield,5972,4,11,5,10,40,38,2,38
Cliftonville,5972,5,9,4,13,34,34,0,31
Ballymena,5972,6,7,4,15,25,48,-23,25
Glentoran,5972,7,6,6,10,24,32,-8,24
Dungannon,5972,8,2,4,16,14,47,-33,10
Crusaders,5973,1,16,7,3,62,31,31,55
Coleraine,5973,2,14,11,1,45,24,21,53
Linfield,5973,3,11,5,10,39,37,2,38
Glenavon,5973,4,9,10,7,54,45,9,37
Cliftonville,5973,5,9,4,13,33,33,0,31
Ballymena,5973,6,7,5,14,26,48,-22,26
Glentoran,5973,7,6,6,10,24,32,-8,24
Dungannon,5973,8,2,4,16,14,47,-33,10
Crusaders,5974,1,17,6,3,64,31,33,57
Coleraine,5974,2,14,10,2,43,23,20,52
Glenavon,5974,3,10,9,7,53,43,10,39
Linfield,5974,4,11,5,10,38,36,2,38
Cliftonville,5974,5,9,4,13,32,32,0,31
Ballymena,5974,6,7,4,15,26,50,-24,25
Glentoran,5974,7,6,6,10,24,32,-8,24
Dungannon,5974,8,2,4,16,14,47,-33,10
Crusaders,5975,1,17,6,3,63,31,32,57
Coleraine,5975,2,14,11,1,44,23,21,53
Glenavon,5975,3,9,10,7,53,44,9,37
Linfield,5975,4,10,5,11,39,39,0,35
Cliftonville,5975,5,10,4,12,35,33,2,34
Ballymena,5975,6,7,4,15,26,49,-23,25
Glentoran,5975,7,6,6,10,24,32,-8,24
Dungannon,5975,8,2,4,16,14,47,-33,10
Crusaders,5976,1,17,6,3,65,32,33,57
Coleraine,5976,2,14,10,2,43,24,19,52
Glenavon,5976,3,10,9,7,54,43,11,39
Linfield,5976,4,10,6,10,39,38,1,36
Cliftonville,5976,5,9,5,12,34,33,1,32
Ballymena,5976,6,7,4,15,27,51,-24,25
Glentoran,5976,7,6,6,10,24,32,-8,24
Dungannon,5976,8,2,4,16,14,47,-33,10
Crusaders,5977,1,17,6,3,62,30,32,57
Coleraine,5977,2,15,10,1,45,23,22,55
Linfield,5977,3,11,5,10,39,36,3,38
Glenavon,5977,4,9,9,8,53,45,8,36
Cliftonville,5977,5,9,4,13,32,33,-1,31
Ballymena,5977,6,7,4,15,25,48,-23,25
Glentoran,5977,7,6,6,10,24,32,-8,24
Dungannon,5977,8,2,4,16,14,47,-33,10
Crusaders,5978,1,16,6,4,61,31,30,54
Coleraine,5978,2,14,10,2,44,26,18,52
Glenavon,5978,3,10,9,7,56,44,12,39
Linfield,5978,4,10,6,10,39,38,1,36
Cliftonville,5978,5,9,5,12,34,33,1,32
Ballymena,5978,6,8,4,14,26,47,-21,28
Glentoran,5978,7,6,6,10,24,32,-8,24
Dungannon,5978,8,2,4,16,14,47,-33,10
Crusaders,5979,1,17,6,3,64,31,33,57
Coleraine,5979,2,15,10,1,47,22,25,55
Glenavon,5979,3,9,9,8,52,47,5,36
Linfield,5979,4,10,6,10,37,36,1,36
Cliftonville,5979,5,9,5,12,32,31,1,32
Ballymena,5979,6,7,4,15,26,50,-24,25
Glentoran,5979,7,6,6,10,24,32,-8,24
Dungannon,5979,8,2,4,16,14,47,-33,10
Crusaders,5980,1,17,6,3,65,30,35,57
Coleraine,5980,2,14,11,1,43,22,21,53
Linfield,5980,3,11,5,10,41,36,5,38
Glenavon,5980,4,9,10,7,52,43,9,37
Cliftonville,5980,5,9,4,13,32,35,-3,31
Ballymena,5980,6,7,4,15,25,51,-26,25
Glentoran,5980,7,6,6,10,24,32,-8,24
Dungannon,5980,8,2,4,16,14,47,-33,10
Crusaders,5981,1,17,6,3,63,30,33,57
Coleraine,5981,2,14,11,1,45,24,21,53
Linfield,5981,3,11,5,10,38,36,2,38
Glenavon,5981,4,9,10,7,54,45,9,37
Cliftonville,5981,5,9,4,13,32,32,0,31
Ballymena,5981,6,7,4,15,25,49,-24,25
Glentoran,5981,7,6,6,10,24,32,-8,24
Dungannon,5981,8,2,4,16,14,47,-33,10
Crusaders,5982,1,16,7,3,63,32,31,55
Coleraine,5982,2,14,11,1,44,23,21,53
Glenavon,5982,3,9,10,7,53,44,9,37
Linfield,5982,4,10,5,11,37,37,0,35
Cliftonville,5982,5,10,4,12,33,31,2,34
Ballymena,5982,6,7,5,14,27,49,-22,26
Glentoran,5982,7,6,6,10,24,32,-8,24
Dungannon,5982,8,2,4,16,14,47,-33,10
Crusaders,5983,1,17,6,3,64,32,32,57
Coleraine,5983,2,14,10,2,45,25,20,52
Glenavon,5983,3,10,9,7,55,45,10,39
Linfield,5983,4,11,5,10,40,36,4,38
Cliftonville,5983,5,9,4,13,32,34,-2,31
Ballymena,5983,6,7,4,15,27,50,-23,25
Glentoran,5983,7,6,6,10,24,32,-8,24
Dungannon,5983,8,2,4,16,14,47,-33,10
Crusaders,5984,1,16,7,3,63,32,31,55
Coleraine,5984,2,14,10,2,44,24,20,52
Glenavon,5984,3,10,9,7,54,44,10,39
Linfield,5984,4,11,5,10,42,37,5,38
Cliftonville,5984,5,9,4,13,33,36,-3,31
Ballymena,5984,6,7,5,14,27,49,-22,26
Glentoran,5984,7,6,6,10,24,32,-8,24
Dungannon,5984,8,2,4,16,14,47,-33,10
Crusaders,5985,1,16,6,4,62,32,30,54
Coleraine,5985,2,14,10,2,44,24,20,52
Glenavon,5985,3,10,9,7,54,44,10,39
Linfield,5985,4,10,6,10,38,37,1,36
Cliftonville,5985,5,9,5,12,33,32,1,32
Ballymena,5985,6,8,4,14,27,48,-21,28
Glentoran,5985,7,6,6,10,24,32,-8,24
Dungannon,5985,8,2,4,16,14,47,-33,10
Crusaders,5986,1,17,6,3,64,32,32,57
Coleraine,5986,2,15,10,1,47,25,22,55
Glenavon,5986,3,9,9,8,55,47,8,36
Linfield,5986,4,10,6,10,40,39,1,36
Cliftonville,5986,5,9,5,12,35,34,1,32
Ballymena,5986,6,7,4,15,27,50,-23,25
Glentoran,5986,7,6,6,10,24,32,-8,24
Dungannon,5986,8,2,4,16,14,47,-33,10
Crusaders,5987,1,17,6,3,63,30,33,57
Coleraine,5987,2,14,11,1,45,24,21,53
Glenavon,5987,3,9,10,7,54,45,9,37
Linfield,5987,4,10,6,10,38,37,1,36
Cliftonville,5987,5,9,5,12,33,32,1,32
Ballymena,5987,6,7,4,15,25,49,-24,25
Glentoran,5987,7,6,6,10,24,32,-8,24
Dungannon,5987,8,2,4,16,14,47,-33,10
Crusaders,5988,1,16,7,3,62,31,31,55
Coleraine,5988,2,15,10,1,46,23,23,55
Glenavon,5988,3,9,9,8,53,46,7,36
Linfield,5988,4,10,5,11,37,37,0,35
Cliftonville,5988,5,10,4,12,33,31,2,34
Ballymena,5988,6,7,5,14,26,48,-22,26
Glentoran,5988,7,6,6,10,24,32,-8,24
Dungannon,5988,8,2,4,16,14,47,-33,10
Crusaders,5989,1,17,6,3,63,30,33,57
Coleraine,5989,2,14,10,2,43,26,17,52
Glenavon,5989,3,10,9,7,56,43,13,39
Linfield,5989,4,10,6,10,38,37,1,36
Cliftonville,5989,5,9,5,12,33,32,1,32
Ballymena,5989,6,7,4,15,25,49,-24,25
Glentoran,5989,7,6,6,10,24,32,-8,24
Dungannon,5989,8,2,4,16,14,47,-33,10
Crusaders,5990,1,16,6,4,63,34,29,54
Coleraine,5990,2,14,11,1,44,23,21,53
Glenavon,5990,3,9,10,7,53,44,9,37
Linfield,5990,4,10,5,11,37,40,-3,35
Cliftonville,5990,5,10,4,12,36,31,5,34
Ballymena,5990,6,8,4,14,29,49,-20,28
Glentoran,5990,7,6,6,10,24,32,-8,24
Dungannon,5990,8,2,4,16,14,47,-33,10
Crusaders,5991,1,16,7,3,63,32,31,55
Coleraine,5991,2,14,11,1,44,23,21,53
Linfield,5991,3,11,5,10,38,36,2,38
Glenavon,5991,4,9,10,7,53,44,9,37
Cliftonville,5991,5,9,4,13,32,32,0,31
Ballymena,5991,6,7,5,14,27,49,-22,26
Glentoran,5991,7,6,6,10,24,32,-8,24
Dungannon,5991,8,2,4,16,14,47,-33,10
Crusaders,5992,1,16,6,4,62,33,29,54
Coleraine,5992,2,14,10,2,43,23,20,52
Glenavon,5992,3,10,9,7,53,43,10,39
Linfield,5992,4,10,6,10,39,38,1,36
Cliftonville,5992,5,9,5,12,34,33,1,32
Ballymena,5992,6,8,4,14,28,48,-20,28
Glentoran,5992,7,6,6,10,24,32,-8,24
Dungannon,5992,8,2,4,16,14,47,-33,10
Crusaders,5993,1,16,6,4,62,32,30,54
Coleraine,5993,2,14,10,2,44,25,19,52
Glenavon,5993,3,10,9,7,55,44,11,39
Linfield,5993,4,10,5,11,37,39,-2,35
Cliftonville,5993,5,10,4,12,35,31,4,34
Ballymena,5993,6,8,4,14,27,48,-21,28
Glentoran,5993,7,6,6,10,24,32,-8,24
Dungannon,5993,8,2,4,16,14,47,-33,10
Crusaders,5994,1,17,6,3,64,31,33,57
Coleraine,5994,2,14,10,2,43,23,20,52
Glenavon,5994,3,10,9,7,53,43,10,39
Linfield,5994,4,11,5,10,41,37,4,38
Cliftonville,5994,5,9,4,13,33,35,-2,31
Ballymena,5994,6,7,4,15,26,50,-24,25
Glentoran,5994,7,6,6,10,24,32,-8,24
Dungannon,5994,8,2,4,16,14,47,-33,10
Crusaders,5995,1,17,6,3,63,30,33,57
Coleraine,5995,2,14,10,2,44,27,17,52
Glenavon,5995,3,10,9,7,57,44,13,39
Linfield,5995,4,11,5,10,39,37,2,38
Cliftonville,5995,5,9,4,13,33,33,0,31
Ballymena,5995,6,7,4,15,25,49,-24,25
Glentoran,5995,7,6,6,10,24,32,-8,24
Dungannon,5995,8,2,4,16,14,47,-33,10
Crusaders,5996,1,17,6,3,64,32,32,57
Coleraine,5996,2,14,10,2,44,27,17,52
Glenavon,5996,3,10,9,7,57,44,13,39
Linfield,5996,4,11,5,10,38,36,2,38
Cliftonville,5996,5,9,4,13,32,32,0,31
Ballymena,5996,6,7,4,15,27,50,-23,25
Glentoran,5996,7,6,6,10,24,32,-8,24
Dungannon,5996,8,2,4,16,14,47,-33,10
Crusaders,5997,1,16,7,3,62,31,31,55
Coleraine,5997,2,14,10,2,45,25,20,52
Glenavon,5997,3,10,9,7,55,45,10,39
Linfield,5997,4,11,5,10,39,36,3,38
Cliftonville,5997,5,9,4,13,32,33,-1,31
Ballymena,5997,6,7,5,14,26,48,-22,26
Glentoran,5997,7,6,6,10,24,32,-8,24
Dungannon,5997,8,2,4,16,14,47,-33,10
Crusaders,5998,1,16,7,3,61,30,31,55
Coleraine,5998,2,15,10,1,44,22,22,55
Linfield,5998,3,11,5,10,40,36,4,38
Glenavon,5998,4,9,9,8,52,44,8,36
Cliftonville,5998,5,9,4,13,32,34,-2,31
Ballymena,5998,6,7,5,14,25,47,-22,26
Glentoran,5998,7,6,6,10,24,32,-8,24
Dungannon,5998,8,2,4,16,14,47,-33,10
Crusaders,5999,1,17,6,3,64,31,33,57
Coleraine,5999,2,14,10,2,43,23,20,52
Glenavon,5999,3,10,9,7,53,43,10,39
Linfield,5999,4,10,5,11,38,39,-1,35
Cliftonville,5999,5,10,4,12,35,32,3,34
Ballymena,5999,6,7,4,15,26,50,-24,25
Glentoran,5999,7,6,6,10,24,32,-8,24
Dungannon,5999,8,2,4,16,14,47,-33,10
Crusaders,6000,1,16,6,4,63,33,30,54
Coleraine,6000,2,14,10,2,43,24,19,52
Glenavon,6000,3,10,9,7,54,43,11,39
Linfield,6000,4,10,6,10,38,37,1,36
Cliftonville,6000,5,9,5,12,33,32,1,32
Ballymena,6000,6,8,4,14,28,49,-21,28
Glentoran,6000,7,6,6,10,24,32,-8,24
Dungannon,6000,8,2,4,16,14,47,-33,10
Crusaders,6001,1,16,6,4,61,31,30,54
Coleraine,6001,2,14,10,2,46,27,19,52
Glenavon,6001,3,10,9,7,57,46,11,39
Linfield,6001,4,11,5,10,41,38,3,38
Cliftonville,6001,5,9,4,13,34,35,-1,31
Ballymena,6001,6,8,4,14,26,47,-21,28
Glentoran,6001,7,6,6,10,24,32,-8,24
Dungannon,6001,8,2,4,16,14,47,-33,10
Crusaders,6002,1,17,6,3,64,31,33,57
Coleraine,6002,2,14,10,2,43,24,19,52
Glenavon,6002,3,10,9,7,54,43,11,39
Linfield,6002,4,11,5,10,38,36,2,38
Cliftonville,6002,5,9,4,13,32,32,0,31
Ballymena,6002,6,7,4,15,26,50,-24,25
Glentoran,6002,7,6,6,10,24,32,-8,24
Dungannon,6002,8,2,4,16,14,47,-33,10
Crusaders,6003,1,16,6,4,62,32,30,54
Coleraine,6003,2,14,10,2,44,26,18,52
Glenavon,6003,3,10,9,7,56,44,12,39
Linfield,6003,4,10,6,10,38,37,1,36
Cliftonville,6003,5,9,5,12,33,32,1,32
Ballymena,6003,6,8,4,14,27,48,-21,28
Glentoran,6003,7,6,6,10,24,32,-8,24
Dungannon,6003,8,2,4,16,14,47,-33,10
Crusaders,6004,1,17,6,3,63,30,33,57
Coleraine,6004,2,14,10,2,44,24,20,52
Glenavon,6004,3,10,9,7,54,44,10,39
Linfield,6004,4,11,5,10,39,36,3,38
Cliftonville,6004,5,9,4,13,32,33,-1,31
Ballymena,6004,6,7,4,15,25,49,-24,25
Glentoran,6004,7,6,6,10,24,32,-8,24
Dungannon,6004,8,2,4,16,14,47,-33,10
Crusaders,6005,1,17,6,3,64,31,33,57
Coleraine,6005,2,14,10,2,44,26,18,52
Glenavon,6005,3,10,9,7,56,44,12,39
Linfield,6005,4,11,5,10,39,36,3,38
Cliftonville,6005,5,9,4,13,32,33,-1,31
Ballymena,6005,6,7,4,15,26,50,-24,25
Glentoran,6005,7,6,6,10,24,32,-8,24
Dungannon,6005,8,2,4,16,14,47,-33,10
Crusaders,6006,1,17,6,3,63,30,33,57
Coleraine,6006,2,14,10,2,43,23,20,52
Glenavon,6006,3,10,9,7,53,43,10,39
Linfield,6006,4,10,5,11,37,38,-1,35
Cliftonville,6006,5,10,4,12,34,31,3,34
Ballymena,6006,6,7,4,15,25,49,-24,25
Glentoran,6006,7,6,6,10,24,32,-8,24
Dungannon,6006,8,2,4,16,14,47,-33,10
Crusaders,6007,1,16,7,3,62,31,31,55
Coleraine,6007,2,14,10,2,44,24,20,52
Glenavon,6007,3,10,9,7,54,44,10,39
Linfield,6007,4,10,5,11,38,38,0,35
Cliftonville,6007,5,10,4,12,34,32,2,34
Ballymena,6007,6,7,5,14,26,48,-22,26
Glentoran,6007,7,6,6,10,24,32,-8,24
Dungannon,6007,8,2,4,16,14,47,-33,10
Crusaders,6008,1,16,6,4,61,31,30,54
Coleraine,6008,2,14,10,2,43,28,15,52
Glenavon,6008,3,10,9,7,58,43,15,39
Linfield,6008,4,11,5,10,39,37,2,38
Cliftonville,6008,5,9,4,13,33,33,0,31
Ballymena,6008,6,8,4,14,26,47,-21,28
Glentoran,6008,7,6,6,10,24,32,-8,24
Dungannon,6008,8,2,4,16,14,47,-33,10
Coleraine,6009,1,15,10,1,45,23,22,55
Crusaders,6009,2,16,6,4,62,32,30,54
Glenavon,6009,3,9,9,8,53,45,8,36
Linfield,6009,4,10,5,11,37,39,-2,35
Cliftonville,6009,5,10,4,12,35,31,4,34
Ballymena,6009,6,8,4,14,27,48,-21,28
Glentoran,6009,7,6,6,10,24,32,-8,24
Dungannon,6009,8,2,4,16,14,47,-33,10
Coleraine,6010,1,15,10,1,44,22,22,55
Crusaders,6010,2,16,6,4,62,33,29,54
Glenavon,6010,3,9,9,8,52,44,8,36
Linfield,6010,4,10,6,10,37,36,1,36
Cliftonville,6010,5,9,5,12,32,31,1,32
Ballymena,6010,6,8,4,14,28,48,-20,28
Glentoran,6010,7,6,6,10,24,32,-8,24
Dungannon,6010,8,2,4,16,14,47,-33,10
Crusaders,6011,1,17,6,3,65,32,33,57
Coleraine,6011,2,15,10,1,45,22,23,55
Glenavon,6011,3,9,9,8,52,45,7,36
Linfield,6011,4,10,5,11,38,38,0,35
Cliftonville,6011,5,10,4,12,34,32,2,34
Ballymena,6011,6,7,4,15,27,51,-24,25
Glentoran,6011,7,6,6,10,24,32,-8,24
Dungannon,6011,8,2,4,16,14,47,-33,10
Crusaders,6012,1,17,6,3,62,30,32,57
Coleraine,6012,2,14,10,2,43,24,19,52
Glenavon,6012,3,10,9,7,54,43,11,39
Linfield,6012,4,10,6,10,38,37,1,36
Cliftonville,6012,5,9,5,12,33,32,1,32
Ballymena,6012,6,7,4,15,25,48,-23,25
Glentoran,6012,7,6,6,10,24,32,-8,24
Dungannon,6012,8,2,4,16,14,47,-33,10
Crusaders,6013,1,17,6,3,63,31,32,57
Coleraine,6013,2,14,10,2,44,24,20,52
Glenavon,6013,3,10,9,7,54,44,10,39
Linfield,6013,4,11,5,10,38,36,2,38
Cliftonville,6013,5,9,4,13,32,32,0,31
Ballymena,6013,6,7,4,15,26,49,-23,25
Glentoran,6013,7,6,6,10,24,32,-8,24
Dungannon,6013,8,2,4,16,14,47,-33,10
Crusaders,6014,1,17,6,3,63,30,33,57
Coleraine,6014,2,14,10,2,43,23,20,52
Glenavon,6014,3,10,9,7,53,43,10,39
Linfield,6014,4,10,5,11,38,39,-1,35
Cliftonville,6014,5,10,4,12,35,32,3,34
Ballymena,6014,6,7,4,15,25,49,-24,25
Glentoran,6014,7,6,6,10,24,32,-8,24
Dungannon,6014,8,2,4,16,14,47,-33,10
Crusaders,6015,1,16,7,3,61,30,31,55
Coleraine,6015,2,15,10,1,45,22,23,55
Glenavon,6015,3,9,9,8,52,45,7,36
Linfield,6015,4,10,5,11,37,37,0,35
Cliftonville,6015,5,10,4,12,33,31,2,34
Ballymena,6015,6,7,5,14,25,47,-22,26
Glentoran,6015,7,6,6,10,24,32,-8,24
Dungannon,6015,8,2,4,16,14,47,-33,10
Crusaders,6016,1,17,6,3,63,30,33,57
Coleraine,6016,2,14,10,2,44,25,19,52
Glenavon,6016,3,10,9,7,55,44,11,39
Linfield,6016,4,11,5,10,40,36,4,38
Cliftonville,6016,5,9,4,13,32,34,-2,31
Ballymena,6016,6,7,4,15,25,49,-24,25
Glentoran,6016,7,6,6,10,24,32,-8,24
Dungannon,6016,8,2,4,16,14,47,-33,10
Crusaders,6017,1,17,6,3,64,31,33,57
Coleraine,6017,2,15,10,1,44,22,22,55
Glenavon,6017,3,9,9,8,52,44,8,36
Linfield,6017,4,10,6,10,38,37,1,36
Cliftonville,6017,5,9,5,12,33,32,1,32
Ballymena,6017,6,7,4,15,26,50,-24,25
Glentoran,6017,7,6,6,10,24,32,-8,24
Dungannon,6017,8,2,4,16,14,47,-33,10
Crusaders,6018,1,17,6,3,62,30,32,57
Coleraine,6018,2,14,11,1,43,22,21,53
Glenavon,6018,3,9,10,7,52,43,9,37
Linfield,6018,4,10,5,11,37,37,0,35
Cliftonville,6018,5,10,4,12,33,31,2,34
Ballymena,6018,6,7,4,15,25,48,-23,25
Glentoran,6018,7,6,6,10,24,32,-8,24
Dungannon,6018,8,2,4,16,14,47,-33,10
Crusaders,6019,1,17,6,3,62,30,32,57
Coleraine,6019,2,14,11,1,44,23,21,53
Glenavon,6019,3,9,10,7,53,44,9,37
Linfield,6019,4,10,5,11,37,38,-1,35
Cliftonville,6019,5,10,4,12,34,31,3,34
Ballymena,6019,6,7,4,15,25,48,-23,25
Glentoran,6019,7,6,6,10,24,32,-8,24
Dungannon,6019,8,2,4,16,14,47,-33,10
Crusaders,6020,1,17,6,3,63,30,33,57
Coleraine,6020,2,14,10,2,43,23,20,52
Glenavon,6020,3,10,9,7,53,43,10,39
Linfield,6020,4,10,6,10,37,36,1,36
Cliftonville,6020,5,9,5,12,32,31,1,32
Ballymena,6020,6,7,4,15,25,49,-24,25
Glentoran,6020,7,6,6,10,24,32,-8,24
Dungannon,6020,8,2,4,16,14,47,-33,10
Crusaders,6021,1,17,6,3,64,32,32,57
Coleraine,6021,2,14,10,2,43,24,19,52
Glenavon,6021,3,10,9,7,54,43,11,39
Linfield,6021,4,11,5,10,38,36,2,38
Cliftonville,6021,5,9,4,13,32,32,0,31
Ballymena,6021,6,7,4,15,27,50,-23,25
Glentoran,6021,7,6,6,10,24,32,-8,24
Dungannon,6021,8,2,4,16,14,47,-33,10
Crusaders,6022,1,16,7,3,63,32,31,55
Coleraine,6022,2,15,10,1,46,23,23,55
Glenavon,6022,3,9,9,8,53,46,7,36
Linfield,6022,4,10,6,10,38,37,1,36
Cliftonville,6022,5,9,5,12,33,32,1,32
Ballymena,6022,6,7,5,14,27,49,-22,26
Glentoran,6022,7,6,6,10,24,32,-8,24
Dungannon,6022,8,2,4,16,14,47,-33,10
Crusaders,6023,1,17,6,3,63,31,32,57
Coleraine,6023,2,15,10,1,45,23,22,55
Linfield,6023,3,11,5,10,39,36,3,38
Glenavon,6023,4,9,9,8,53,45,8,36
Cliftonville,6023,5,9,4,13,32,33,-1,31
Ballymena,6023,6,7,4,15,26,49,-23,25
Glentoran,6023,7,6,6,10,24,32,-8,24
Dungannon,6023,8,2,4,16,14,47,-33,10
Crusaders,6024,1,16,6,4,61,31,30,54
Coleraine,6024,2,14,11,1,45,24,21,53
Linfield,6024,3,11,5,10,39,36,3,38
Glenavon,6024,4,9,10,7,54,45,9,37
Cliftonville,6024,5,9,4,13,32,33,-1,31
Ballymena,6024,6,8,4,14,26,47,-21,28
Glentoran,6024,7,6,6,10,24,32,-8,24
Dungannon,6024,8,2,4,16,14,47,-33,10
Crusaders,6025,1,16,6,4,61,34,27,54
Coleraine,6025,2,14,10,2,45,25,20,52
Glenavon,6025,3,10,9,7,55,45,10,39
Linfield,6025,4,10,6,10,37,36,1,36
Cliftonville,6025,5,9,5,12,32,31,1,32
Ballymena,6025,6,8,4,14,29,47,-18,28
Glentoran,6025,7,6,6,10,24,32,-8,24
Dungannon,6025,8,2,4,16,14,47,-33,10
Crusaders,6026,1,17,6,3,63,30,33,57
Coleraine,6026,2,14,11,1,44,23,21,53
Glenavon,6026,3,9,10,7,53,44,9,37
Linfield,6026,4,10,6,10,37,36,1,36
Cliftonville,6026,5,9,5,12,32,31,1,32
Ballymena,6026,6,7,4,15,25,49,-24,25
Glentoran,6026,7,6,6,10,24,32,-8,24
Dungannon,6026,8,2,4,16,14,47,-33,10
Crusaders,6027,1,16,7,3,62,31,31,55
Coleraine,6027,2,14,10,2,45,25,20,52
Glenavon,6027,3,10,9,7,55,45,10,39
Linfield,6027,4,10,5,11,37,37,0,35
Cliftonville,6027,5,10,4,12,33,31,2,34
Ballymena,6027,6,7,5,14,26,48,-22,26
Glentoran,6027,7,6,6,10,24,32,-8,24
Dungannon,6027,8,2,4,16,14,47,-33,10
Crusaders,6028,1,17,6,3,65,31,34,57
Coleraine,6028,2,15,10,1,46,24,22,55
Glenavon,6028,3,9,9,8,54,46,8,36
Linfield,6028,4,10,5,11,37,37,0,35
Cliftonville,6028,5,10,4,12,33,31,2,34
Ballymena,6028,6,7,4,15,26,51,-25,25
Glentoran,6028,7,6,6,10,24,32,-8,24
Dungannon,6028,8,2,4,16,14,47,-33,10
Crusaders,6029,1,16,7,3,64,33,31,55
Coleraine,6029,2,15,10,1,44,22,22,55
Glenavon,6029,3,9,9,8,52,44,8,36
Linfield,6029,4,10,6,10,38,37,1,36
Cliftonville,6029,5,9,5,12,33,32,1,32
Ballymena,6029,6,7,5,14,28,50,-22,26
Glentoran,6029,7,6,6,10,24,32,-8,24
Dungannon,6029,8,2,4,16,14,47,-33,10
Crusaders,6030,1,16,6,4,61,32,29,54
Coleraine,6030,2,14,10,2,45,27,18,52
Glenavon,6030,3,10,9,7,57,45,12,39
Linfield,6030,4,11,5,10,38,36,2,38
Cliftonville,6030,5,9,4,13,32,32,0,31
Ballymena,6030,6,8,4,14,27,47,-20,28
Glentoran,6030,7,6,6,10,24,32,-8,24
Dungannon,6030,8,2,4,16,14,47,-33,10
Crusaders,6031,1,17,6,3,66,31,35,57
Coleraine,6031,2,14,11,1,45,24,21,53
Glenavon,6031,3,9,10,7,54,45,9,37
Linfield,6031,4,10,5,11,38,38,0,35
Cliftonville,6031,5,10,4,12,34,32,2,34
Ballymena,6031,6,7,4,15,26,52,-26,25
Glentoran,6031,7,6,6,10,24,32,-8,24
Dungannon,6031,8,2,4,16,14,47,-33,10
Crusaders,6032,1,16,6,4,62,32,30,54
Coleraine,6032,2,14,10,2,43,23,20,52
Glenavon,6032,3,10,9,7,53,43,10,39
Linfield,6032,4,10,6,10,38,37,1,36
Cliftonville,6032,5,9,5,12,33,32,1,32
Ballymena,6032,6,8,4,14,27,48,-21,28
Glentoran,6032,7,6,6,10,24,32,-8,24
Dungannon,6032,8,2,4,16,14,47,-33,10
Crusaders,6033,1,17,6,3,62,30,32,57
Coleraine,6033,2,14,10,2,44,25,19,52
Glenavon,6033,3,10,9,7,55,44,11,39
Linfield,6033,4,10,6,10,37,36,1,36
Cliftonville,6033,5,9,5,12,32,31,1,32
Ballymena,6033,6,7,4,15,25,48,-23,25
Glentoran,6033,7,6,6,10,24,32,-8,24
Dungannon,6033,8,2,4,16,14,47,-33,10
Crusaders,6034,1,16,7,3,62,31,31,55
Coleraine,6034,2,14,11,1,43,22,21,53
Linfield,6034,3,11,5,10,41,36,5,38
Glenavon,6034,4,9,10,7,52,43,9,37
Cliftonville,6034,5,9,4,13,32,35,-3,31
Ballymena,6034,6,7,5,14,26,48,-22,26
Glentoran,6034,7,6,6,10,24,32,-8,24
Dungannon,6034,8,2,4,16,14,47,-33,10
Coleraine,6035,1,15,10,1,45,22,23,55
Crusaders,6035,2,16,6,4,61,32,29,54
Glenavon,6035,3,9,9,8,52,45,7,36
Linfield,6035,4,10,5,11,38,38,0,35
Cliftonville,6035,5,10,4,12,34,32,2,34
Ballymena,6035,6,8,4,14,27,47,-20,28
Glentoran,6035,7,6,6,10,24,32,-8,24
Dungannon,6035,8,2,4,16,14,47,-33,10
Crusaders,6036,1,17,6,3,63,31,32,57
Coleraine,6036,2,14,10,2,43,24,19,52
Glenavon,6036,3,10,9,7,54,43,11,39
Linfield,6036,4,10,5,11,38,40,-2,35
Cliftonville,6036,5,10,4,12,36,32,4,34
Ballymena,6036,6,7,4,15,26,49,-23,25
Glentoran,6036,7,6,6,10,24,32,-8,24
Dungannon,6036,8,2,4,16,14,47,-33,10
Coleraine,6037,1,15,10,1,48,23,25,55
Crusaders,6037,2,16,6,4,63,34,29,54
Linfield,6037,3,11,5,10,39,37,2,38
Glenavon,6037,4,9,9,8,53,48,5,36
Cliftonville,6037,5,9,4,13,33,33,0,31
Ballymena,6037,6,8,4,14,29,49,-20,28
Glentoran,6037,7,6,6,10,24,32,-8,24
Dungannon,6037,8,2,4,16,14,47,-33,10
Crusaders,6038,1,17,6,3,65,31,34,57
Coleraine,6038,2,14,10,2,44,25,19,52
Glenavon,6038,3,10,9,7,55,44,11,39
Linfield,6038,4,10,6,10,38,37,1,36
Cliftonville,6038,5,9,5,12,33,32,1,32
Ballymena,6038,6,7,4,15,26,51,-25,25
Glentoran,6038,7,6,6,10,24,32,-8,24
Dungannon,6038,8,2,4,16,14,47,-33,10
Crusaders,6039,1,17,6,3,65,31,34,57
Coleraine,6039,2,14,10,2,43,25,18,52
Glenavon,6039,3,10,9,7,55,43,12,39
Linfield,6039,4,10,5,11,37,37,0,35
Cliftonville,6039,5,10,4,12,33,31,2,34
Ballymena,6039,6,7,4,15,26,51,-25,25
Glentoran,6039,7,6,6,10,24,32,-8,24
Dungannon,6039,8,2,4,16,14,47,-33,10
Coleraine,6040,1,15,10,1,44,22,22,55
Crusaders,6040,2,16,6,4,63,35,28,54
Linfield,6040,3,11,5,10,39,37,2,38
Glenavon,6040,4,9,9,8,52,44,8,36
Cliftonville,6040,5,9,4,13,33,33,0,31
Ballymena,6040,6,8,4,14,30,49,-19,28
Glentoran,6040,7,6,6,10,24,32,-8,24
Dungannon,6040,8,2,4,16,14,47,-33,10
Crusaders,6041,1,16,7,3,61,30,31,55
Coleraine,6041,2,14,11,1,44,23,21,53
Linfield,6041,3,11,5,10,39,37,2,38
Glenavon,6041,4,9,10,7,53,44,9,37
Cliftonville,6041,5,9,4,13,33,33,0,31
Ballymena,6041,6,7,5,14,25,47,-22,26
Glentoran,6041,7,6,6,10,24,32,-8,24
Dungannon,6041,8,2,4,16,14,47,-33,10
Crusaders,6042,1,17,6,3,65,32,33,57
Coleraine,6042,2,14,10,2,43,24,19,52
Glenavon,6042,3,10,9,7,54,43,11,39
Linfield,6042,4,10,5,11,37,37,0,35
Cliftonville,6042,5,10,4,12,33,31,2,34
Ballymena,6042,6,7,4,15,27,51,-24,25
Glentoran,6042,7,6,6,10,24,32,-8,24
Dungannon,6042,8,2,4,16,14,47,-33,10
Crusaders,6043,1,17,6,3,66,31,35,57
Coleraine,6043,2,14,10,2,43,23,20,52
Glenavon,6043,3,10,9,7,53,43,10,39
Linfield,6043,4,11,5,10,40,37,3,38
Cliftonville,6043,5,9,4,13,33,34,-1,31
Ballymena,6043,6,7,4,15,26,52,-26,25
Glentoran,6043,7,6,6,10,24,32,-8,24
Dungannon,6043,8,2,4,16,14,47,-33,10
Crusaders,6044,1,17,6,3,63,30,33,57
Coleraine,6044,2,15,10,1,45,22,23,55
Linfield,6044,3,11,5,10,40,36,4,38
Glenavon,6044,4,9,9,8,52,45,7,36
Cliftonville,6044,5,9,4,13,32,34,-2,31
Ballymena,6044,6,7,4,15,25,49,-24,25
Glentoran,6044,7,6,6,10,24,32,-8,24
Dungannon,6044,8,2,4,16,14,47,-33,10
Crusaders,6045,1,17,6,3,66,30,36,57
Coleraine,6045,2,14,10,2,44,25,19,52
Glenavon,6045,3,10,9,7,55,44,11,39
Linfield,6045,4,11,5,10,39,36,3,38
Cliftonville,6045,5,9,4,13,32,33,-1,31
Ballymena,6045,6,7,4,15,25,52,-27,25
Glentoran,6045,7,6,6,10,24,32,-8,24
Dungannon,6045,8,2,4,16,14,47,-33,10
Crusaders,6046,1,17,6,3,66,30,36,57
Coleraine,6046,2,14,10,2,43,25,18,52
Glenavon,6046,3,10,9,7,55,43,12,39
Linfield,6046,4,10,5,11,38,38,0,35
Cliftonville,6046,5,10,4,12,34,32,2,34
Ballymena,6046,6,7,4,15,25,52,-27,25
Glentoran,6046,7,6,6,10,24,32,-8,24
Dungannon,6046,8,2,4,16,14,47,-33,10
Crusaders,6047,1,16,6,4,63,34,29,54
Coleraine,6047,2,14,10,2,43,24,19,52
Glenavon,6047,3,10,9,7,54,43,11,39
Linfield,6047,4,11,5,10,39,36,3,38
Cliftonville,6047,5,9,4,13,32,33,-1,31
Ballymena,6047,6,8,4,14,29,49,-20,28
Glentoran,6047,7,6,6,10,24,32,-8,24
Dungannon,6047,8,2,4,16,14,47,-33,10
Crusaders,6048,1,16,6,4,62,34,28,54
Coleraine,6048,2,14,10,2,43,24,19,52
Glenavon,6048,3,10,9,7,54,43,11,39
Linfield,6048,4,11,5,10,41,38,3,38
Cliftonville,6048,5,9,4,13,34,35,-1,31
Ballymena,6048,6,8,4,14,29,48,-19,28
Glentoran,6048,7,6,6,10,24,32,-8,24
Dungannon,6048,8,2,4,16,14,47,-33,10
Crusaders,6049,1,17,6,3,65,31,34,57
Coleraine,6049,2,14,11,1,47,26,21,53
Glenavon,6049,3,9,10,7,56,47,9,37
Linfield,6049,4,10,6,10,39,38,1,36
Cliftonville,6049,5,9,5,12,34,33,1,32
Ballymena,6049,6,7,4,15,26,51,-25,25
Glentoran,6049,7,6,6,10,24,32,-8,24
Dungannon,6049,8,2,4,16,14,47,-33,10
Crusaders,6050,1,16,6,4,62,34,28,54
Coleraine,6050,2,14,10,2,44,27,17,52
Glenavon,6050,3,10,9,7,57,44,13,39
Linfield,6050,4,11,5,10,39,37,2,38
Cliftonville,6050,5,9,4,13,33,33,0,31
Ballymena,6050,6,8,4,14,29,48,-19,28
Glentoran,6050,7,6,6,10,24,32,-8,24
Dungannon,6050,8,2,4,16,14,47,-33,10
Coleraine,6051,1,15,10,1,45,23,22,55
Crusaders,6051,2,16,6,4,61,32,29,54
Linfield,6051,3,11,5,10,39,37,2,38
Glenavon,6051,4,9,9,8,53,45,8,36
Cliftonville,6051,5,9,4,13,33,33,0,31
Ballymena,6051,6,8,4,14,27,47,-20,28
Glentoran,6051,7,6,6,10,24,32,-8,24
Dungannon,6051,8,2,4,16,14,47,-33,10
Crusaders,6052,1,17,6,3,62,30,32,57
Coleraine,6052,2,14,10,2,45,25,20,52
Glenavon,6052,3,10,9,7,55,45,10,39
Linfield,6052,4,11,5,10,38,36,2,38
Cliftonville,6052,5,9,4,13,32,32,0,31
Ballymena,6052,6,7,4,15,25,48,-23,25
Glentoran,6052,7,6,6,10,24,32,-8,24
Dungannon,6052,8,2,4,16,14,47,-33,10
Crusaders,6053,1,16,6,4,62,35,27,54
Coleraine,6053,2,14,10,2,45,25,20,52
Glenavon,6053,3,10,9,7,55,45,10,39
Linfield,6053,4,10,6,10,37,36,1,36
Cliftonville,6053,5,9,5,12,32,31,1,32
Ballymena,6053,6,8,4,14,30,48,-18,28
Glentoran,6053,7,6,6,10,24,32,-8,24
Dungannon,6053,8,2,4,16,14,47,-33,10
Crusaders,6054,1,16,6,4,61,32,29,54
Coleraine,6054,2,14,10,2,44,24,20,52
Glenavon,6054,3,10,9,7,54,44,10,39
Linfield,6054,4,10,5,11,39,39,0,35
Cliftonville,6054,5,10,4,12,35,33,2,34
Ballymena,6054,6,8,4,14,27,47,-20,28
Glentoran,6054,7,6,6,10,24,32,-8,24
Dungannon,6054,8,2,4,16,14,47,-33,10
Crusaders,6055,1,17,6,3,66,31,35,57
Coleraine,6055,2,14,10,2,44,25,19,52
Glenavon,6055,3,10,9,7,55,44,11,39
Linfield,6055,4,10,6,10,38,37,1,36
Cliftonville,6055,5,9,5,12,33,32,1,32
Ballymena,6055,6,7,4,15,26,52,-26,25
Glentoran,6055,7,6,6,10,24,32,-8,24
Dungannon,6055,8,2,4,16,14,47,-33,10
Crusaders,6056,1,17,6,3,65,31,34,57
Coleraine,6056,2,15,10,1,44,22,22,55
Glenavon,6056,3,9,9,8,52,44,8,36
Linfield,6056,4,10,5,11,38,42,-4,35
Cliftonville,6056,5,10,4,12,38,32,6,34
Ballymena,6056,6,7,4,15,26,51,-25,25
Glentoran,6056,7,6,6,10,24,32,-8,24
Dungannon,6056,8,2,4,16,14,47,-33,10
Crusaders,6057,1,16,7,3,61,30,31,55
Coleraine,6057,2,14,10,2,44,26,18,52
Glenavon,6057,3,10,9,7,56,44,12,39
Linfield,6057,4,11,5,10,38,36,2,38
Cliftonville,6057,5,9,4,13,32,32,0,31
Ballymena,6057,6,7,5,14,25,47,-22,26
Glentoran,6057,7,6,6,10,24,32,-8,24
Dungannon,6057,8,2,4,16,14,47,-33,10
Coleraine,6058,1,15,10,1,45,23,22,55
Crusaders,6058,2,16,6,4,61,31,30,54
Linfield,6058,3,11,5,10,39,36,3,38
Glenavon,6058,4,9,9,8,53,45,8,36
Cliftonville,6058,5,9,4,13,32,33,-1,31
Ballymena,6058,6,8,4,14,26,47,-21,28
Glentoran,6058,7,6,6,10,24,32,-8,24
Dungannon,6058,8,2,4,16,14,47,-33,10
Crusaders,6059,1,17,6,3,63,31,32,57
Coleraine,6059,2,15,10,1,44,22,22,55
Linfield,6059,3,11,5,10,42,37,5,38
Glenavon,6059,4,9,9,8,52,44,8,36
Cliftonville,6059,5,9,4,13,33,36,-3,31
Ballymena,6059,6,7,4,15,26,49,-23,25
Glentoran,6059,7,6,6,10,24,32,-8,24
Dungannon,6059,8,2,4,16,14,47,-33,10
Crusaders,6060,1,17,6,3,64,32,32,57
Coleraine,6060,2,14,10,2,44,26,18,52
Glenavon,6060,3,10,9,7,56,44,12,39
Linfield,6060,4,11,5,10,39,36,3,38
Cliftonville,6060,5,9,4,13,32,33,-1,31
Ballymena,6060,6,7,4,15,27,50,-23,25
Glentoran,6060,7,6,6,10,24,32,-8,24
Dungannon,6060,8,2,4,16,14,47,-33,10
Crusaders,6061,1,17,6,3,64,31,33,57
Coleraine,6061,2,14,10,2,44,25,19,52
Glenavon,6061,3,10,9,7,55,44,11,39
Linfield,6061,4,10,6,10,39,38,1,36
Cliftonville,6061,5,9,5,12,34,33,1,32
Ballymena,6061,6,7,4,15,26,50,-24,25
Glentoran,6061,7,6,6,10,24,32,-8,24
Dungannon,6061,8,2,4,16,14,47,-33,10
Crusaders,6062,1,17,6,3,63,31,32,57
Coleraine,6062,2,15,10,1,45,23,22,55
Glenavon,6062,3,9,9,8,53,45,8,36
Linfield,6062,4,10,5,11,37,37,0,35
Cliftonville,6062,5,10,4,12,33,31,2,34
Ballymena,6062,6,7,4,15,26,49,-23,25
Glentoran,6062,7,6,6,10,24,32,-8,24
Dungannon,6062,8,2,4,16,14,47,-33,10
Crusaders,6063,1,17,6,3,63,30,33,57
Coleraine,6063,2,14,10,2,44,26,18,52
Glenavon,6063,3,10,9,7,56,44,12,39
Linfield,6063,4,10,6,10,38,37,1,36
Cliftonville,6063,5,9,5,12,33,32,1,32
Ballymena,6063,6,7,4,15,25,49,-24,25
Glentoran,6063,7,6,6,10,24,32,-8,24
Dungannon,6063,8,2,4,16,14,47,-33,10
Crusaders,6064,1,17,6,3,64,30,34,57
Coleraine,6064,2,15,10,1,46,24,22,55
Linfield,6064,3,11,5,10,40,38,2,38
Glenavon,6064,4,9,9,8,54,46,8,36
Cliftonville,6064,5,9,4,13,34,34,0,31
Ballymena,6064,6,7,4,15,25,50,-25,25
Glentoran,6064,7,6,6,10,24,32,-8,24
Dungannon,6064,8,2,4,16,14,47,-33,10
Crusaders,6065,1,17,6,3,66,32,34,57
Coleraine,6065,2,14,10,2,45,25,20,52
Glenavon,6065,3,10,9,7,55,45,10,39
Linfield,6065,4,11,5,10,39,36,3,38
Cliftonville,6065,5,9,4,13,32,33,-1,31
Ballymena,6065,6,7,4,15,27,52,-25,25
Glentoran,6065,7,6,6,10,24,32,-8,24
Dungannon,6065,8,2,4,16,14,47,-33,10
Crusaders,6066,1,17,6,3,65,30,35,57
Coleraine,6066,2,15,10,1,48,24,24,55
Linfield,6066,3,11,5,10,39,37,2,38
Glenavon,6066,4,9,9,8,54,48,6,36
Cliftonville,6066,5,9,4,13,33,33,0,31
Ballymena,6066,6,7,4,15,25,51,-26,25
Glentoran,6066,7,6,6,10,24,32,-8,24
Dungannon,6066,8,2,4,16,14,47,-33,10
Crusaders,6067,1,17,6,3,62,30,32,57
Coleraine,6067,2,14,10,2,43,23,20,52
Glenavon,6067,3,10,9,7,53,43,10,39
Linfield,6067,4,11,5,10,39,37,2,38
Cliftonville,6067,5,9,4,13,33,33,0,31
Ballymena,6067,6,7,4,15,25,48,-23,25
Glentoran,6067,7,6,6,10,24,32,-8,24
Dungannon,6067,8,2,4,16,14,47,-33,10
Crusaders,6068,1,17,6,3,63,31,32,57
Coleraine,6068,2,15,10,1,46,24,22,55
Glenavon,6068,3,9,9,8,54,46,8,36
Linfield,6068,4,10,6,10,39,38,1,36
Cliftonville,6068,5,9,5,12,34,33,1,32
Ballymena,6068,6,7,4,15,26,49,-23,25
Glentoran,6068,7,6,6,10,24,32,-8,24
Dungannon,6068,8,2,4,16,14,47,-33,10
Crusaders,6069,1,17,6,3,63,30,33,57
Coleraine,6069,2,15,10,1,45,23,22,55
Glenavon,6069,3,9,9,8,53,45,8,36
Linfield,6069,4,10,5,11,37,38,-1,35
Cliftonville,6069,5,10,4,12,34,31,3,34
Ballymena,6069,6,7,4,15,25,49,-24,25
Glentoran,6069,7,6,6,10,24,32,-8,24
Dungannon,6069,8,2,4,16,14,47,-33,10
Crusaders,6070,1,17,6,3,66,32,34,57
Coleraine,6070,2,14,10,2,43,24,19,52
Glenavon,6070,3,10,9,7,54,43,11,39
Linfield,6070,4,10,6,10,40,39,1,36
Cliftonville,6070,5,9,5,12,35,34,1,32
Ballymena,6070,6,7,4,15,27,52,-25,25
Glentoran,6070,7,6,6,10,24,32,-8,24
Dungannon,6070,8,2,4,16,14,47,-33,10
Crusaders,6071,1,17,6,3,63,31,32,57
Coleraine,6071,2,14,10,2,44,25,19,52
Glenavon,6071,3,10,9,7,55,44,11,39
Linfield,6071,4,10,5,11,37,37,0,35
Cliftonville,6071,5,10,4,12,33,31,2,34
Ballymena,6071,6,7,4,15,26,49,-23,25
Glentoran,6071,7,6,6,10,24,32,-8,24
Dungannon,6071,8,2,4,16,14,47,-33,10
Crusaders,6072,1,17,6,3,65,33,32,57
Coleraine,6072,2,14,10,2,45,25,20,52
Glenavon,6072,3,10,9,7,55,45,10,39
Linfield,6072,4,11,5,10,41,37,4,38
Cliftonville,6072,5,9,4,13,33,35,-2,31
Ballymena,6072,6,7,4,15,28,51,-23,25
Glentoran,6072,7,6,6,10,24,32,-8,24
Dungannon,6072,8,2,4,16,14,47,-33,10
Crusaders,6073,1,17,6,3,63,31,32,57
Coleraine,6073,2,14,10,2,44,26,18,52
Glenavon,6073,3,10,9,7,56,44,12,39
Linfield,6073,4,10,6,10,38,37,1,36
Cliftonville,6073,5,9,5,12,33,32,1,32
Ballymena,6073,6,7,4,15,26,49,-23,25
Glentoran,6073,7,6,6,10,24,32,-8,24
Dungannon,6073,8,2,4,16,14,47,-33,10
Crusaders,6074,1,17,6,3,66,30,36,57
Coleraine,6074,2,14,10,2,44,26,18,52
Glenavon,6074,3,10,9,7,56,44,12,39
Linfield,6074,4,10,5,11,37,38,-1,35
Cliftonville,6074,5,10,4,12,34,31,3,34
Ballymena,6074,6,7,4,15,25,52,-27,25
Glentoran,6074,7,6,6,10,24,32,-8,24
Dungannon,6074,8,2,4,16,14,47,-33,10
Crusaders,6075,1,17,6,3,66,32,34,57
Coleraine,6075,2,15,10,1,45,23,22,55
Glenavon,6075,3,9,9,8,53,45,8,36
Linfield,6075,4,10,6,10,37,36,1,36
Cliftonville,6075,5,9,5,12,32,31,1,32
Ballymena,6075,6,7,4,15,27,52,-25,25
Glentoran,6075,7,6,6,10,24,32,-8,24
Dungannon,6075,8,2,4,16,14,47,-33,10
Crusaders,6076,1,16,6,4,62,32,30,54
Coleraine,6076,2,14,11,1,44,23,21,53
Glenavon,6076,3,9,10,7,53,44,9,37
Linfield,6076,4,10,6,10,38,37,1,36
Cliftonville,6076,5,9,5,12,33,32,1,32
Ballymena,6076,6,8,4,14,27,48,-21,28
Glentoran,6076,7,6,6,10,24,32,-8,24
Dungannon,6076,8,2,4,16,14,47,-33,10
Crusaders,6077,1,17,6,3,65,30,35,57
Coleraine,6077,2,14,10,2,45,25,20,52
Glenavon,6077,3,10,9,7,55,45,10,39
Linfield,6077,4,11,5,10,38,36,2,38
Cliftonville,6077,5,9,4,13,32,32,0,31
Ballymena,6077,6,7,4,15,25,51,-26,25
Glentoran,6077,7,6,6,10,24,32,-8,24
Dungannon,6077,8,2,4,16,14,47,-33,10
Crusaders,6078,1,16,6,4,61,31,30,54
Coleraine,6078,2,14,11,1,43,22,21,53
Glenavon,6078,3,9,10,7,52,43,9,37
Linfield,6078,4,10,6,10,37,36,1,36
Cliftonville,6078,5,9,5,12,32,31,1,32
Ballymena,6078,6,8,4,14,26,47,-21,28
Glentoran,6078,7,6,6,10,24,32,-8,24
Dungannon,6078,8,2,4,16,14,47,-33,10
Coleraine,6079,1,15,10,1,45,22,23,55
Crusaders,6079,2,16,6,4,61,31,30,54
Glenavon,6079,3,9,9,8,52,45,7,36
Linfield,6079,4,10,6,10,38,37,1,36
Cliftonville,6079,5,9,5,12,33,32,1,32
Ballymena,6079,6,8,4,14,26,47,-21,28
Glentoran,6079,7,6,6,10,24,32,-8,24
Dungannon,6079,8,2,4,16,14,47,-33,10
Crusaders,6080,1,17,6,3,65,31,34,57
Coleraine,6080,2,14,10,2,44,24,20,52
Glenavon,6080,3,10,9,7,54,44,10,39
Linfield,6080,4,10,5,11,37,40,-3,35
Cliftonville,6080,5,10,4,12,36,31,5,34
Ballymena,6080,6,7,4,15,26,51,-25,25
Glentoran,6080,7,6,6,10,24,32,-8,24
Dungannon,6080,8,2,4,16,14,47,-33,10
Crusaders,6081,1,16,7,3,63,32,31,55
Coleraine,6081,2,14,10,2,43,23,20,52
Glenavon,6081,3,10,9,7,53,43,10,39
Linfield,6081,4,11,5,10,41,36,5,38
Cliftonville,6081,5,9,4,13,32,35,-3,31
Ballymena,6081,6,7,5,14,27,49,-22,26
Glentoran,6081,7,6,6,10,24,32,-8,24
Dungannon,6081,8,2,4,16,14,47,-33,10
Crusaders,6082,1,16,7,3,64,33,31,55
Coleraine,6082,2,15,10,1,45,23,22,55
Linfield,6082,3,11,5,10,40,37,3,38
Glenavon,6082,4,9,9,8,53,45,8,36
Cliftonville,6082,5,9,4,13,33,34,-1,31
Ballymena,6082,6,7,5,14,28,50,-22,26
Glentoran,6082,7,6,6,10,24,32,-8,24
Dungannon,6082,8,2,4,16,14,47,-33,10
Crusaders,6083,1,17,6,3,64,32,32,57
Coleraine,6083,2,15,10,1,46,23,23,55
Glenavon,6083,3,9,9,8,53,46,7,36
Linfield,6083,4,10,5,11,38,38,0,35
Cliftonville,6083,5,10,4,12,34,32,2,34
Ballymena,6083,6,7,4,15,27,50,-23,25
Glentoran,6083,7,6,6,10,24,32,-8,24
Dungannon,6083,8,2,4,16,14,47,-33,10
Crusaders,6084,1,16,6,4,63,34,29,54
Coleraine,6084,2,14,10,2,44,25,19,52
Glenavon,6084,3,10,9,7,55,44,11,39
Linfield,6084,4,11,5,10,39,37,2,38
Cliftonville,6084,5,9,4,13,33,33,0,31
Ballymena,6084,6,8,4,14,29,49,-20,28
Glentoran,6084,7,6,6,10,24,32,-8,24
Dungannon,6084,8,2,4,16,14,47,-33,10
Crusaders,6085,1,16,6,4,62,33,29,54
Coleraine,6085,2,14,10,2,43,26,17,52
Glenavon,6085,3,10,9,7,56,43,13,39
Linfield,6085,4,10,5,11,39,40,-1,35
Cliftonville,6085,5,10,4,12,36,33,3,34
Ballymena,6085,6,8,4,14,28,48,-20,28
Glentoran,6085,7,6,6,10,24,32,-8,24
Dungannon,6085,8,2,4,16,14,47,-33,10
Coleraine,6086,1,15,10,1,47,22,25,55
Crusaders,6086,2,16,6,4,62,32,30,54
Linfield,6086,3,11,5,10,40,38,2,38
Glenavon,6086,4,9,9,8,52,47,5,36
Cliftonville,6086,5,9,4,13,34,34,0,31
Ballymena,6086,6,8,4,14,27,48,-21,28
Glentoran,6086,7,6,6,10,24,32,-8,24
Dungannon,6086,8,2,4,16,14,47,-33,10
Coleraine,6087,1,15,10,1,45,23,22,55
Crusaders,6087,2,16,6,4,61,31,30,54
Glenavon,6087,3,9,9,8,53,45,8,36
Linfield,6087,4,10,5,11,37,37,0,35
Cliftonville,6087,5,10,4,12,33,31,2,34
Ballymena,6087,6,8,4,14,26,47,-21,28
Glentoran,6087,7,6,6,10,24,32,-8,24
Dungannon,6087,8,2,4,16,14,47,-33,10
Crusaders,6088,1,17,6,3,64,32,32,57
Coleraine,6088,2,14,10,2,43,24,19,52
Glenavon,6088,3,10,9,7,54,43,11,39
Linfield,6088,4,10,6,10,37,36,1,36
Cliftonville,6088,5,9,5,12,32,31,1,32
Ballymena,6088,6,7,4,15,27,50,-23,25
Glentoran,6088,7,6,6,10,24,32,-8,24
Dungannon,6088,8,2,4,16,14,47,-33,10
Crusaders,6089,1,16,6,4,62,34,28,54
Coleraine,6089,2,14,10,2,44,24,20,52
Glenavon,6089,3,10,9,7,54,44,10,39
Linfield,6089,4,11,5,10,44,37,7,38
Cliftonville,6089,5,9,4,13,33,38,-5,31
Ballymena,6089,6,8,4,14,29,48,-19,28
Glentoran,6089,7,6,6,10,24,32,-8,24
Dungannon,6089,8,2,4,16,14,47,-33,10
Crusaders,6090,1,16,7,3,63,32,31,55
Coleraine,6090,2,14,10,2,44,25,19,52
Glenavon,6090,3,10,9,7,55,44,11,39
Linfield,6090,4,10,5,11,37,38,-1,35
Cliftonville,6090,5,10,4,12,34,31,3,34
Ballymena,6090,6,7,5,14,27,49,-22,26
Glentoran,6090,7,6,6,10,24,32,-8,24
Dungannon,6090,8,2,4,16,14,47,-33,10
Coleraine,6091,1,15,10,1,45,23,22,55
Crusaders,6091,2,16,6,4,61,31,30,54
Linfield,6091,3,11,5,10,38,36,2,38
Glenavon,6091,4,9,9,8,53,45,8,36
Cliftonville,6091,5,9,4,13,32,32,0,31
Ballymena,6091,6,8,4,14,26,47,-21,28
Glentoran,6091,7,6,6,10,24,32,-8,24
Dungannon,6091,8,2,4,16,14,47,-33,10
Crusaders,6092,1,16,7,3,61,30,31,55
Coleraine,6092,2,14,11,1,44,23,21,53
Glenavon,6092,3,9,10,7,53,44,9,37
Linfield,6092,4,10,5,11,38,38,0,35
Cliftonville,6092,5,10,4,12,34,32,2,34
Ballymena,6092,6,7,5,14,25,47,-22,26
Glentoran,6092,7,6,6,10,24,32,-8,24
Dungannon,6092,8,2,4,16,14,47,-33,10
Crusaders,6093,1,17,6,3,62,30,32,57
Coleraine,6093,2,14,11,1,45,24,21,53
Linfield,6093,3,11,5,10,39,37,2,38
Glenavon,6093,4,9,10,7,54,45,9,37
Cliftonville,6093,5,9,4,13,33,33,0,31
Ballymena,6093,6,7,4,15,25,48,-23,25
Glentoran,6093,7,6,6,10,24,32,-8,24
Dungannon,6093,8,2,4,16,14,47,-33,10
Crusaders,6094,1,16,6,4,62,32,30,54
Coleraine,6094,2,14,10,2,43,25,18,52
Glenavon,6094,3,10,9,7,55,43,12,39
Linfield,6094,4,10,5,11,38,39,-1,35
Cliftonville,6094,5,10,4,12,35,32,3,34
Ballymena,6094,6,8,4,14,27,48,-21,28
Glentoran,6094,7,6,6,10,24,32,-8,24
Dungannon,6094,8,2,4,16,14,47,-33,10
Crusaders,6095,1,17,6,3,62,30,32,57
Coleraine,6095,2,14,11,1,43,22,21,53
Glenavon,6095,3,9,10,7,52,43,9,37
Linfield,6095,4,10,5,11,37,37,0,35
Cliftonville,6095,5,10,4,12,33,31,2,34
Ballymena,6095,6,7,4,15,25,48,-23,25
Glentoran,6095,7,6,6,10,24,32,-8,24
Dungannon,6095,8,2,4,16,14,47,-33,10
Crusaders,6096,1,17,6,3,64,31,33,57
Coleraine,6096,2,15,10,1,49,24,25,55
Glenavon,6096,3,9,9,8,54,49,5,36
Linfield,6096,4,10,6,10,38,37,1,36
Cliftonville,6096,5,9,5,12,33,32,1,32
Ballymena,6096,6,7,4,15,26,50,-24,25
Glentoran,6096,7,6,6,10,24,32,-8,24
Dungannon,6096,8,2,4,16,14,47,-33,10
Coleraine,6097,1,15,10,1,44,22,22,55
Crusaders,6097,2,16,6,4,62,32,30,54
Linfield,6097,3,11,5,10,39,37,2,38
Glenavon,6097,4,9,9,8,52,44,8,36
Cliftonville,6097,5,9,4,13,33,33,0,31
Ballymena,6097,6,8,4,14,27,48,-21,28
Glentoran,6097,7,6,6,10,24,32,-8,24
Dungannon,6097,8,2,4,16,14,47,-33,10
Crusaders,6098,1,17,6,3,63,30,33,57
Coleraine,6098,2,14,11,1,44,23,21,53
Linfield,6098,3,11,5,10,39,36,3,38
Glenavon,6098,4,9,10,7,53,44,9,37
Cliftonville,6098,5,9,4,13,32,33,-1,31
Ballymena,6098,6,7,4,15,25,49,-24,25
Glentoran,6098,7,6,6,10,24,32,-8,24
Dungannon,6098,8,2,4,16,14,47,-33,10
Crusaders,6099,1,17,6,3,63,31,32,57
Coleraine,6099,2,14,10,2,43,23,20,52
Glenavon,6099,3,10,9,7,53,43,10,39
Linfield,6099,4,11,5,10,38,36,2,38
Cliftonville,6099,5,9,4,13,32,32,0,31
Ballymena,6099,6,7,4,15,26,49,-23,25
Glentoran,6099,7,6,6,10,24,32,-8,24
Dungannon,6099,8,2,4,16,14,47,-33,10
Crusaders,6100,1,16,6,4,61,31,30,54
Coleraine,6100,2,14,10,2,46,27,19,52
Glenavon,6100,3,10,9,7,57,46,11,39
Linfield,6100,4,10,6,10,38,37,1,36
Cliftonville,6100,5,9,5,12,33,32,1,32
Ballymena,6100,6,8,4,14,26,47,-21,28
Glentoran,6100,7,6,6,10,24,32,-8,24
Dungannon,6100,8,2,4,16,14,47,-33,10
Crusaders,6101,1,16,7,3,64,33,31,55
Coleraine,6101,2,14,10,2,43,24,19,52
Glenavon,6101,3,10,9,7,54,43,11,39
Linfield,6101,4,11,5,10,39,36,3,38
Cliftonville,6101,5,9,4,13,32,33,-1,31
Ballymena,6101,6,7,5,14,28,50,-22,26
Glentoran,6101,7,6,6,10,24,32,-8,24
Dungannon,6101,8,2,4,16,14,47,-33,10
Crusaders,6102,1,17,6,3,62,30,32,57
Coleraine,6102,2,14,10,2,43,23,20,52
Glenavon,6102,3,10,9,7,53,43,10,39
Linfield,6102,4,10,5,11,38,38,0,35
Cliftonville,6102,5,10,4,12,34,32,2,34
Ballymena,6102,6,7,4,15,25,48,-23,25
Glentoran,6102,7,6,6,10,24,32,-8,24
Dungannon,6102,8,2,4,16,14,47,-33,10
Crusaders,6103,1,17,6,3,64,32,32,57
Coleraine,6103,2,14,10,2,44,24,20,52
Glenavon,6103,3,10,9,7,54,44,10,39
Linfield,6103,4,10,5,11,37,37,0,35
Cliftonville,6103,5,10,4,12,33,31,2,34
Ballymena,6103,6,7,4,15,27,50,-23,25
Glentoran,6103,7,6,6,10,24,32,-8,24
Dungannon,6103,8,2,4,16,14,47,-33,10
Crusaders,6104,1,17,6,3,63,31,32,57
Coleraine,6104,2,14,10,2,43,25,18,52
Glenavon,6104,3,10,9,7,55,43,12,39
Linfield,6104,4,10,6,10,38,37,1,36
Cliftonville,6104,5,9,5,12,33,32,1,32
Ballymena,6104,6,7,4,15,26,49,-23,25
Glentoran,6104,7,6,6,10,24,32,-8,24
Dungannon,6104,8,2,4,16,14,47,-33,10
Crusaders,6105,1,17,6,3,63,30,33,57
Coleraine,6105,2,14,10,2,46,27,19,52
Glenavon,6105,3,10,9,7,57,46,11,39
Linfield,6105,4,10,5,11,38,38,0,35
Cliftonville,6105,5,10,4,12,34,32,2,34
Ballymena,6105,6,7,4,15,25,49,-24,25
Glentoran,6105,7,6,6,10,24,32,-8,24
Dungannon,6105,8,2,4,16,14,47,-33,10
Crusaders,6106,1,16,7,3,62,31,31,55
Coleraine,6106,2,15,10,1,44,22,22,55
Linfield,6106,3,11,5,10,40,37,3,38
Glenavon,6106,4,9,9,8,52,44,8,36
Cliftonville,6106,5,9,4,13,33,34,-1,31
Ballymena,6106,6,7,5,14,26,48,-22,26
Glentoran,6106,7,6,6,10,24,32,-8,24
Dungannon,6106,8,2,4,16,14,47,-33,10
Crusaders,6107,1,16,7,3,63,32,31,55
Coleraine,6107,2,14,10,2,44,25,19,52
Glenavon,6107,3,10,9,7,55,44,11,39
Linfield,6107,4,10,5,11,37,40,-3,35
Cliftonville,6107,5,10,4,12,36,31,5,34
Ballymena,6107,6,7,5,14,27,49,-22,26
Glentoran,6107,7,6,6,10,24,32,-8,24
Dungannon,6107,8,2,4,16,14,47,-33,10
Crusaders,6108,1,17,6,3,63,30,33,57
Coleraine,6108,2,14,10,2,43,23,20,52
Glenavon,6108,3,10,9,7,53,43,10,39
Linfield,6108,4,10,6,10,39,38,1,36
Cliftonville,6108,5,9,5,12,34,33,1,32
Ballymena,6108,6,7,4,15,25,49,-24,25
Glentoran,6108,7,6,6,10,24,32,-8,24
Dungannon,6108,8,2,4,16,14,47,-33,10
Crusaders,6109,1,16,7,3,62,31,31,55
Coleraine,6109,2,15,10,1,45,23,22,55
Glenavon,6109,3,9,9,8,53,45,8,36
Linfield,6109,4,10,6,10,38,37,1,36
Cliftonville,6109,5,9,5,12,33,32,1,32
Ballymena,6109,6,7,5,14,26,48,-22,26
Glentoran,6109,7,6,6,10,24,32,-8,24
Dungannon,6109,8,2,4,16,14,47,-33,10
Crusaders,6110,1,17,6,3,68,31,37,57
Coleraine,6110,2,15,10,1,46,22,24,55
Glenavon,6110,3,9,9,8,52,46,6,36
Linfield,6110,4,10,6,10,38,37,1,36
Cliftonville,6110,5,9,5,12,33,32,1,32
Ballymena,6110,6,7,4,15,26,54,-28,25
Glentoran,6110,7,6,6,10,24,32,-8,24
Dungannon,6110,8,2,4,16,14,47,-33,10
Crusaders,6111,1,16,6,4,61,33,28,54
Coleraine,6111,2,14,11,1,43,22,21,53
Glenavon,6111,3,9,10,7,52,43,9,37
Linfield,6111,4,10,5,11,38,39,-1,35
Cliftonville,6111,5,10,4,12,35,32,3,34
Ballymena,6111,6,8,4,14,28,47,-19,28
Glentoran,6111,7,6,6,10,24,32,-8,24
Dungannon,6111,8,2,4,16,14,47,-33,10
Crusaders,6112,1,17,6,3,64,30,34,57
Coleraine,6112,2,14,10,2,43,24,19,52
Glenavon,6112,3,10,9,7,54,43,11,39
Linfield,6112,4,11,5,10,39,36,3,38
Cliftonville,6112,5,9,4,13,32,33,-1,31
Ballymena,6112,6,7,4,15,25,50,-25,25
Glentoran,6112,7,6,6,10,24,32,-8,24
Dungannon,6112,8,2,4,16,14,47,-33,10
Crusaders,6113,1,16,6,4,61,33,28,54
Coleraine,6113,2,14,10,2,43,23,20,52
Glenavon,6113,3,10,9,7,53,43,10,39
Linfield,6113,4,10,6,10,38,37,1,36
Cliftonville,6113,5,9,5,12,33,32,1,32
Ballymena,6113,6,8,4,14,28,47,-19,28
Glentoran,6113,7,6,6,10,24,32,-8,24
Dungannon,6113,8,2,4,16,14,47,-33,10
Coleraine,6114,1,15,10,1,46,22,24,55
Crusaders,6114,2,16,6,4,62,32,30,54
Glenavon,6114,3,9,9,8,52,46,6,36
Linfield,6114,4,10,6,10,38,37,1,36
Cliftonville,6114,5,9,5,12,33,32,1,32
Ballymena,6114,6,8,4,14,27,48,-21,28
Glentoran,6114,7,6,6,10,24,32,-8,24
Dungannon,6114,8,2,4,16,14,47,-33,10
Crusaders,6115,1,16,6,4,62,32,30,54
Coleraine,6115,2,14,10,2,43,24,19,52
Glenavon,6115,3,10,9,7,54,43,11,39
Linfield,6115,4,10,5,11,37,38,-1,35
Cliftonville,6115,5,10,4,12,34,31,3,34
Ballymena,6115,6,8,4,14,27,48,-21,28
Glentoran,6115,7,6,6,10,24,32,-8,24
Dungannon,6115,8,2,4,16,14,47,-33,10
Coleraine,6116,1,15,10,1,46,24,22,55
Crusaders,6116,2,16,6,4,62,34,28,54
Glenavon,6116,3,9,9,8,54,46,8,36
Linfield,6116,4,10,6,10,38,37,1,36
Cliftonville,6116,5,9,5,12,33,32,1,32
Ballymena,6116,6,8,4,14,29,48,-19,28
Glentoran,6116,7,6,6,10,24,32,-8,24
Dungannon,6116,8,2,4,16,14,47,-33,10
Crusaders,6117,1,17,6,3,63,31,32,57
Coleraine,6117,2,15,10,1,46,22,24,55
Linfield,6117,3,11,5,10,39,37,2,38
Glenavon,6117,4,9,9,8,52,46,6,36
Cliftonville,6117,5,9,4,13,33,33,0,31
Ballymena,6117,6,7,4,15,26,49,-23,25
Glentoran,6117,7,6,6,10,24,32,-8,24
Dungannon,6117,8,2,4,16,14,47,-33,10
Crusaders,6118,1,17,6,3,63,31,32,57
Coleraine,6118,2,14,10,2,43,23,20,52
Glenavon,6118,3,10,9,7,53,43,10,39
Linfield,6118,4,11,5,10,40,37,3,38
Cliftonville,6118,5,9,4,13,33,34,-1,31
Ballymena,6118,6,7,4,15,26,49,-23,25
Glentoran,6118,7,6,6,10,24,32,-8,24
Dungannon,6118,8,2,4,16,14,47,-33,10
Crusaders,6119,1,17,6,3,65,32,33,57
Coleraine,6119,2,14,11,1,44,23,21,53
Glenavon,6119,3,9,10,7,53,44,9,37
Linfield,6119,4,10,5,11,37,39,-2,35
Cliftonville,6119,5,10,4,12,35,31,4,34
Ballymena,6119,6,7,4,15,27,51,-24,25
Glentoran,6119,7,6,6,10,24,32,-8,24
Dungannon,6119,8,2,4,16,14,47,-33,10
Crusaders,6120,1,17,6,3,62,30,32,57
Coleraine,6120,2,14,11,1,44,23,21,53
Linfield,6120,3,11,5,10,38,36,2,38
Glenavon,6120,4,9,10,7,53,44,9,37
Cliftonville,6120,5,9,4,13,32,32,0,31
Ballymena,6120,6,7,4,15,25,48,-23,25
Glentoran,6120,7,6,6,10,24,32,-8,24
Dungannon,6120,8,2,4,16,14,47,-33,10
Crusaders,6121,1,17,6,3,65,33,32,57
Coleraine,6121,2,14,11,1,46,25,21,53
Linfield,6121,3,11,5,10,38,36,2,38
Glenavon,6121,4,9,10,7,55,46,9,37
Cliftonville,6121,5,9,4,13,32,32,0,31
Ballymena,6121,6,7,4,15,28,51,-23,25
Glentoran,6121,7,6,6,10,24,32,-8,24
Dungannon,6121,8,2,4,16,14,47,-33,10
Crusaders,6122,1,16,7,3,64,33,31,55
Coleraine,6122,2,15,10,1,45,22,23,55
Linfield,6122,3,11,5,10,40,36,4,38
Glenavon,6122,4,9,9,8,52,45,7,36
Cliftonville,6122,5,9,4,13,32,34,-2,31
Ballymena,6122,6,7,5,14,28,50,-22,26
Glentoran,6122,7,6,6,10,24,32,-8,24
Dungannon,6122,8,2,4,16,14,47,-33,10
Crusaders,6123,1,17,6,3,63,30,33,57
Coleraine,6123,2,14,11,1,44,23,21,53
Linfield,6123,3,11,5,10,39,37,2,38
Glenavon,6123,4,9,10,7,53,44,9,37
Cliftonville,6123,5,9,4,13,33,33,0,31
Ballymena,6123,6,7,4,15,25,49,-24,25
Glentoran,6123,7,6,6,10,24,32,-8,24
Dungannon,6123,8,2,4,16,14,47,-33,10
Crusaders,6124,1,17,6,3,66,30,36,57
Coleraine,6124,2,14,10,2,44,27,17,52
Glenavon,6124,3,10,9,7,57,44,13,39
Linfield,6124,4,11,5,10,39,37,2,38
Cliftonville,6124,5,9,4,13,33,33,0,31
Ballymena,6124,6,7,4,15,25,52,-27,25
Glentoran,6124,7,6,6,10,24,32,-8,24
Dungannon,6124,8,2,4,16,14,47,-33,10
Crusaders,6125,1,17,6,3,62,30,32,57
Coleraine,6125,2,14,10,2,43,24,19,52
Glenavon,6125,3,10,9,7,54,43,11,39
Linfield,6125,4,11,5,10,39,37,2,38
Cliftonville,6125,5,9,4,13,33,33,0,31
Ballymena,6125,6,7,4,15,25,48,-23,25
Glentoran,6125,7,6,6,10,24,32,-8,24
Dungannon,6125,8,2,4,16,14,47,-33,10
Crusaders,6126,1,17,6,3,64,32,32,57
Coleraine,6126,2,15,10,1,45,23,22,55
Linfield,6126,3,11,5,10,38,36,2,38
Glenavon,6126,4,9,9,8,53,45,8,36
Cliftonville,6126,5,9,4,13,32,32,0,31
Ballymena,6126,6,7,4,15,27,50,-23,25
Glentoran,6126,7,6,6,10,24,32,-8,24
Dungannon,6126,8,2,4,16,14,47,-33,10
Crusaders,6127,1,16,7,3,63,32,31,55
Coleraine,6127,2,14,10,2,44,25,19,52
Glenavon,6127,3,10,9,7,55,44,11,39
Linfield,6127,4,11,5,10,40,37,3,38
Cliftonville,6127,5,9,4,13,33,34,-1,31
Ballymena,6127,6,7,5,14,27,49,-22,26
Glentoran,6127,7,6,6,10,24,32,-8,24
Dungannon,6127,8,2,4,16,14,47,-33,10
Crusaders,6128,1,17,6,3,63,30,33,57
Coleraine,6128,2,15,10,1,47,24,23,55
Glenavon,6128,3,9,9,8,54,47,7,36
Linfield,6128,4,10,6,10,38,37,1,36
Cliftonville,6128,5,9,5,12,33,32,1,32
Ballymena,6128,6,7,4,15,25,49,-24,25
Glentoran,6128,7,6,6,10,24,32,-8,24
Dungannon,6128,8,2,4,16,14,47,-33,10
Crusaders,6129,1,16,6,4,61,35,26,54
Coleraine,6129,2,14,10,2,44,26,18,52
Glenavon,6129,3,10,9,7,56,44,12,39
Linfield,6129,4,10,5,11,37,37,0,35
Cliftonville,6129,5,10,4,12,33,31,2,34
Ballymena,6129,6,8,4,14,30,47,-17,28
Glentoran,6129,7,6,6,10,24,32,-8,24
Dungannon,6129,8,2,4,16,14,47,-33,10
Crusaders,6130,1,17,6,3,64,31,33,57
Coleraine,6130,2,14,10,2,44,24,20,52
Glenavon,6130,3,10,9,7,54,44,10,39
Linfield,6130,4,10,6,10,37,36,1,36
Cliftonville,6130,5,9,5,12,32,31,1,32
Ballymena,6130,6,7,4,15,26,50,-24,25
Glentoran,6130,7,6,6,10,24,32,-8,24
Dungannon,6130,8,2,4,16,14,47,-33,10
Crusaders,6131,1,17,6,3,66,31,35,57
Coleraine,6131,2,15,10,1,45,22,23,55
Linfield,6131,3,11,5,10,39,36,3,38
Glenavon,6131,4,9,9,8,52,45,7,36
Cliftonville,6131,5,9,4,13,32,33,-1,31
Ballymena,6131,6,7,4,15,26,52,-26,25
Glentoran,6131,7,6,6,10,24,32,-8,24
Dungannon,6131,8,2,4,16,14,47,-33,10
Crusaders,6132,1,17,6,3,66,33,33,57
Coleraine,6132,2,14,10,2,43,25,18,52
Glenavon,6132,3,10,9,7,55,43,12,39
Linfield,6132,4,10,6,10,38,37,1,36
Cliftonville,6132,5,9,5,12,33,32,1,32
Ballymena,6132,6,7,4,15,28,52,-24,25
Glentoran,6132,7,6,6,10,24,32,-8,24
Dungannon,6132,8,2,4,16,14,47,-33,10
Crusaders,6133,1,17,6,3,63,30,33,57
Coleraine,6133,2,14,10,2,43,23,20,52
Glenavon,6133,3,10,9,7,53,43,10,39
Linfield,6133,4,10,6,10,38,37,1,36
Cliftonville,6133,5,9,5,12,33,32,1,32
Ballymena,6133,6,7,4,15,25,49,-24,25
Glentoran,6133,7,6,6,10,24,32,-8,24
Dungannon,6133,8,2,4,16,14,47,-33,10
Crusaders,6134,1,17,6,3,64,32,32,57
Coleraine,6134,2,14,10,2,43,25,18,52
Glenavon,6134,3,10,9,7,55,43,12,39
Linfield,6134,4,10,5,11,37,38,-1,35
Cliftonville,6134,5,10,4,12,34,31,3,34
Ballymena,6134,6,7,4,15,27,50,-23,25
Glentoran,6134,7,6,6,10,24,32,-8,24
Dungannon,6134,8,2,4,16,14,47,-33,10
Crusaders,6135,1,16,7,3,63,32,31,55
Coleraine,6135,2,15,10,1,46,24,22,55
Linfield,6135,3,11,5,10,39,37,2,38
Glenavon,6135,4,9,9,8,54,46,8,36
Cliftonville,6135,5,9,4,13,33,33,0,31
Ballymena,6135,6,7,5,14,27,49,-22,26
Glentoran,6135,7,6,6,10,24,32,-8,24
Dungannon,6135,8,2,4,16,14,47,-33,10
Crusaders,6136,1,16,7,3,62,31,31,55
Coleraine,6136,2,14,10,2,44,25,19,52
Glenavon,6136,3,10,9,7,55,44,11,39
Linfield,6136,4,10,6,10,38,37,1,36
Cliftonville,6136,5,9,5,12,33,32,1,32
Ballymena,6136,6,7,5,14,26,48,-22,26
Glentoran,6136,7,6,6,10,24,32,-8,24
Dungannon,6136,8,2,4,16,14,47,-33,10
Crusaders,6137,1,17,6,3,63,31,32,57
Coleraine,6137,2,15,10,1,45,23,22,55
Glenavon,6137,3,9,9,8,53,45,8,36
Linfield,6137,4,10,5,11,38,38,0,35
Cliftonville,6137,5,10,4,12,34,32,2,34
Ballymena,6137,6,7,4,15,26,49,-23,25
Glentoran,6137,7,6,6,10,24,32,-8,24
Dungannon,6137,8,2,4,16,14,47,-33,10
Crusaders,6138,1,17,6,3,66,32,34,57
Coleraine,6138,2,14,10,2,44,25,19,52
Glenavon,6138,3,10,9,7,55,44,11,39
Linfield,6138,4,10,6,10,38,37,1,36
Cliftonville,6138,5,9,5,12,33,32,1,32
Ballymena,6138,6,7,4,15,27,52,-25,25
Glentoran,6138,7,6,6,10,24,32,-8,24
Dungannon,6138,8,2,4,16,14,47,-33,10
Crusaders,6139,1,17,6,3,64,32,32,57
Coleraine,6139,2,14,10,2,45,27,18,52
Glenavon,6139,3,10,9,7,57,45,12,39
Linfield,6139,4,11,5,10,38,36,2,38
Cliftonville,6139,5,9,4,13,32,32,0,31
Ballymena,6139,6,7,4,15,27,50,-23,25
Glentoran,6139,7,6,6,10,24,32,-8,24
Dungannon,6139,8,2,4,16,14,47,-33,10
Crusaders,6140,1,16,6,4,61,31,30,54
Coleraine,6140,2,14,10,2,43,23,20,52
Glenavon,6140,3,10,9,7,53,43,10,39
Linfield,6140,4,10,5,11,37,38,-1,35
Cliftonville,6140,5,10,4,12,34,31,3,34
Ballymena,6140,6,8,4,14,26,47,-21,28
Glentoran,6140,7,6,6,10,24,32,-8,24
Dungannon,6140,8,2,4,16,14,47,-33,10
Crusaders,6141,1,16,7,3,62,31,31,55
Coleraine,6141,2,14,10,2,44,25,19,52
Glenavon,6141,3,10,9,7,55,44,11,39
Linfield,6141,4,11,5,10,39,36,3,38
Cliftonville,6141,5,9,4,13,32,33,-1,31
Ballymena,6141,6,7,5,14,26,48,-22,26
Glentoran,6141,7,6,6,10,24,32,-8,24
Dungannon,6141,8,2,4,16,14,47,-33,10
Crusaders,6142,1,16,7,3,62,31,31,55
Coleraine,6142,2,14,10,2,43,23,20,52
Glenavon,6142,3,10,9,7,53,43,10,39
Linfield,6142,4,11,5,10,40,37,3,38
Cliftonville,6142,5,9,4,13,33,34,-1,31
Ballymena,6142,6,7,5,14,26,48,-22,26
Glentoran,6142,7,6,6,10,24,32,-8,24
Dungannon,6142,8,2,4,16,14,47,-33,10
Crusaders,6143,1,17,6,3,64,30,34,57
Coleraine,6143,2,14,11,1,44,23,21,53
Glenavon,6143,3,9,10,7,53,44,9,37
Linfield,6143,4,10,5,11,37,37,0,35
Cliftonville,6143,5,10,4,12,33,31,2,34
Ballymena,6143,6,7,4,15,25,50,-25,25
Glentoran,6143,7,6,6,10,24,32,-8,24
Dungannon,6143,8,2,4,16,14,47,-33,10
Crusaders,6144,1,16,7,3,63,32,31,55
Coleraine,6144,2,14,11,1,44,23,21,53
Linfield,6144,3,11,5,10,39,37,2,38
Glenavon,6144,4,9,10,7,53,44,9,37
Cliftonville,6144,5,9,4,13,33,33,0,31
Ballymena,6144,6,7,5,14,27,49,-22,26
Glentoran,6144,7,6,6,10,24,32,-8,24
Dungannon,6144,8,2,4,16,14,47,-33,10
Crusaders,6145,1,16,6,4,61,31,30,54
Coleraine,6145,2,14,11,1,44,23,21,53
Linfield,6145,3,11,5,10,38,36,2,38
Glenavon,6145,4,9,10,7,53,44,9,37
Cliftonville,6145,5,9,4,13,32,32,0,31
Ballymena,6145,6,8,4,14,26,47,-21,28
Glentoran,6145,7,6,6,10,24,32,-8,24
Dungannon,6145,8,2,4,16,14,47,-33,10
Crusaders,6146,1,17,6,3,64,31,33,57
Coleraine,6146,2,14,11,1,45,24,21,53
Glenavon,6146,3,9,10,7,54,45,9,37
Linfield,6146,4,10,6,10,37,36,1,36
Cliftonville,6146,5,9,5,12,32,31,1,32
Ballymena,6146,6,7,4,15,26,50,-24,25
Glentoran,6146,7,6,6,10,24,32,-8,24
Dungannon,6146,8,2,4,16,14,47,-33,10
Crusaders,6147,1,17,6,3,63,31,32,57
Coleraine,6147,2,15,10,1,46,22,24,55
Glenavon,6147,3,9,9,8,52,46,6,36
Linfield,6147,4,10,5,11,39,39,0,35
Cliftonville,6147,5,10,4,12,35,33,2,34
Ballymena,6147,6,7,4,15,26,49,-23,25
Glentoran,6147,7,6,6,10,24,32,-8,24
Dungannon,6147,8,2,4,16,14,47,-33,10
Crusaders,6148,1,16,6,4,61,32,29,54
Coleraine,6148,2,14,10,2,43,24,19,52
Glenavon,6148,3,10,9,7,54,43,11,39
Linfield,6148,4,11,5,10,40,36,4,38
Cliftonville,6148,5,9,4,13,32,34,-2,31
Ballymena,6148,6,8,4,14,27,47,-20,28
Glentoran,6148,7,6,6,10,24,32,-8,24
Dungannon,6148,8,2,4,16,14,47,-33,10
Crusaders,6149,1,17,6,3,63,31,32,57
Coleraine,6149,2,14,10,2,43,24,19,52
Glenavon,6149,3,10,9,7,54,43,11,39
Linfield,6149,4,11,5,10,38,36,2,38
Cliftonville,6149,5,9,4,13,32,32,0,31
Ballymena,6149,6,7,4,15,26,49,-23,25
Glentoran,6149,7,6,6,10,24,32,-8,24
Dungannon,6149,8,2,4,16,14,47,-33,10
Coleraine,6150,1,15,10,1,44,22,22,55
Crusaders,6150,2,16,6,4,61,31,30,54
Linfield,6150,3,11,5,10,40,38,2,38
Glenavon,6150,4,9,9,8,52,44,8,36
Cliftonville,6150,5,9,4,13,34,34,0,31
Ballymena,6150,6,8,4,14,26,47,-21,28
Glentoran,6150,7,6,6,10,24,32,-8,24
Dungannon,6150,8,2,4,16,14,47,-33,10
Crusaders,6151,1,17,6,3,64,30,34,57
Coleraine,6151,2,14,10,2,45,25,20,52
Glenavon,6151,3,10,9,7,55,45,10,39
Linfield,6151,4,10,6,10,37,36,1,36
Cliftonville,6151,5,9,5,12,32,31,1,32
Ballymena,6151,6,7,4,15,25,50,-25,25
Glentoran,6151,7,6,6,10,24,32,-8,24
Dungannon,6151,8,2,4,16,14,47,-33,10
Crusaders,6152,1,17,6,3,62,30,32,57
Coleraine,6152,2,14,11,1,45,24,21,53
Glenavon,6152,3,9,10,7,54,45,9,37
Linfield,6152,4,10,5,11,38,38,0,35
Cliftonville,6152,5,10,4,12,34,32,2,34
Ballymena,6152,6,7,4,15,25,48,-23,25
Glentoran,6152,7,6,6,10,24,32,-8,24
Dungannon,6152,8,2,4,16,14,47,-33,10
Crusaders,6153,1,17,6,3,64,30,34,57
Coleraine,6153,2,14,10,2,44,24,20,52
Glenavon,6153,3,10,9,7,54,44,10,39
Linfield,6153,4,10,5,11,38,38,0,35
Cliftonville,6153,5,10,4,12,34,32,2,34
Ballymena,6153,6,7,4,15,25,50,-25,25
Glentoran,6153,7,6,6,10,24,32,-8,24
Dungannon,6153,8,2,4,16,14,47,-33,10
Crusaders,6154,1,17,6,3,66,30,36,57
Coleraine,6154,2,14,10,2,43,24,19,52
Glenavon,6154,3,10,9,7,54,43,11,39
Linfield,6154,4,10,6,10,37,36,1,36
Cliftonville,6154,5,9,5,12,32,31,1,32
Ballymena,6154,6,7,4,15,25,52,-27,25
Glentoran,6154,7,6,6,10,24,32,-8,24
Dungannon,6154,8,2,4,16,14,47,-33,10
Coleraine,6155,1,15,10,1,44,22,22,55
Crusaders,6155,2,16,6,4,62,33,29,54
Glenavon,6155,3,9,9,8,52,44,8,36
Linfield,6155,4,10,5,11,38,38,0,35
Cliftonville,6155,5,10,4,12,34,32,2,34
Ballymena,6155,6,8,4,14,28,48,-20,28
Glentoran,6155,7,6,6,10,24,32,-8,24
Dungannon,6155,8,2,4,16,14,47,-33,10
Coleraine,6156,1,15,10,1,45,22,23,55
Crusaders,6156,2,16,6,4,61,31,30,54
Glenavon,6156,3,9,9,8,52,45,7,36
Linfield,6156,4,10,6,10,38,37,1,36
Cliftonville,6156,5,9,5,12,33,32,1,32
Ballymena,6156,6,8,4,14,26,47,-21,28
Glentoran,6156,7,6,6,10,24,32,-8,24
Dungannon,6156,8,2,4,16,14,47,-33,10
Crusaders,6157,1,16,7,3,63,32,31,55
Coleraine,6157,2,14,11,1,45,24,21,53
Linfield,6157,3,11,5,10,39,36,3,38
Glenavon,6157,4,9,10,7,54,45,9,37
Cliftonville,6157,5,9,4,13,32,33,-1,31
Ballymena,6157,6,7,5,14,27,49,-22,26
Glentoran,6157,7,6,6,10,24,32,-8,24
Dungannon,6157,8,2,4,16,14,47,-33,10
Crusaders,6158,1,16,7,3,62,31,31,55
Coleraine,6158,2,14,11,1,44,23,21,53
Linfield,6158,3,11,5,10,39,37,2,38
Glenavon,6158,4,9,10,7,53,44,9,37
Cliftonville,6158,5,9,4,13,33,33,0,31
Ballymena,6158,6,7,5,14,26,48,-22,26
Glentoran,6158,7,6,6,10,24,32,-8,24
Dungannon,6158,8,2,4,16,14,47,-33,10
Crusaders,6159,1,16,6,4,62,32,30,54
Coleraine,6159,2,14,10,2,43,23,20,52
Glenavon,6159,3,10,9,7,53,43,10,39
Linfield,6159,4,10,5,11,37,37,0,35
Cliftonville,6159,5,10,4,12,33,31,2,34
Ballymena,6159,6,8,4,14,27,48,-21,28
Glentoran,6159,7,6,6,10,24,32,-8,24
Dungannon,6159,8,2,4,16,14,47,-33,10
Crusaders,6160,1,17,6,3,63,31,32,57
Coleraine,6160,2,14,10,2,45,27,18,52
Glenavon,6160,3,10,9,7,57,45,12,39
Linfield,6160,4,11,5,10,40,37,3,38
Cliftonville,6160,5,9,4,13,33,34,-1,31
Ballymena,6160,6,7,4,15,26,49,-23,25
Glentoran,6160,7,6,6,10,24,32,-8,24
Dungannon,6160,8,2,4,16,14,47,-33,10
Crusaders,6161,1,16,6,4,62,33,29,54
Coleraine,6161,2,14,10,2,45,26,19,52
Glenavon,6161,3,10,9,7,56,45,11,39
Linfield,6161,4,11,5,10,40,38,2,38
Cliftonville,6161,5,9,4,13,34,34,0,31
Ballymena,6161,6,8,4,14,28,48,-20,28
Glentoran,6161,7,6,6,10,24,32,-8,24
Dungannon,6161,8,2,4,16,14,47,-33,10
Crusaders,6162,1,16,6,4,62,32,30,54
Coleraine,6162,2,14,10,2,43,24,19,52
Glenavon,6162,3,10,9,7,54,43,11,39
Linfield,6162,4,11,5,10,38,36,2,38
Cliftonville,6162,5,9,4,13,32,32,0,31
Ballymena,6162,6,8,4,14,27,48,-21,28
Glentoran,6162,7,6,6,10,24,32,-8,24
Dungannon,6162,8,2,4,16,14,47,-33,10
Crusaders,6163,1,16,7,3,63,32,31,55
Coleraine,6163,2,15,10,1,46,22,24,55
Glenavon,6163,3,9,9,8,52,46,6,36
Linfield,6163,4,10,6,10,38,37,1,36
Cliftonville,6163,5,9,5,12,33,32,1,32
Ballymena,6163,6,7,5,14,27,49,-22,26
Glentoran,6163,7,6,6,10,24,32,-8,24
Dungannon,6163,8,2,4,16,14,47,-33,10
Crusaders,6164,1,17,6,3,65,33,32,57
Coleraine,6164,2,14,10,2,43,27,16,52
Glenavon,6164,3,10,9,7,57,43,14,39
Linfield,6164,4,10,6,10,38,37,1,36
Cliftonville,6164,5,9,5,12,33,32,1,32
Ballymena,6164,6,7,4,15,28,51,-23,25
Glentoran,6164,7,6,6,10,24,32,-8,24
Dungannon,6164,8,2,4,16,14,47,-33,10
Crusaders,6165,1,17,6,3,63,30,33,57
Coleraine,6165,2,14,10,2,43,26,17,52
Glenavon,6165,3,10,9,7,56,43,13,39
Linfield,6165,4,11,5,10,39,37,2,38
Cliftonville,6165,5,9,4,13,33,33,0,31
Ballymena,6165,6,7,4,15,25,49,-24,25
Glentoran,6165,7,6,6,10,24,32,-8,24
Dungannon,6165,8,2,4,16,14,47,-33,10
Crusaders,6166,1,16,6,4,61,32,29,54
Coleraine,6166,2,14,10,2,44,24,20,52
Glenavon,6166,3,10,9,7,54,44,10,39
Linfield,6166,4,10,5,11,37,37,0,35
Cliftonville,6166,5,10,4,12,33,31,2,34
Ballymena,6166,6,8,4,14,27,47,-20,28
Glentoran,6166,7,6,6,10,24,32,-8,24
Dungannon,6166,8,2,4,16,14,47,-33,10
Crusaders,6167,1,17,6,3,64,31,33,57
Coleraine,6167,2,14,10,2,46,26,20,52
Glenavon,6167,3,10,9,7,56,46,10,39
Linfield,6167,4,10,6,10,37,36,1,36
Cliftonville,6167,5,9,5,12,32,31,1,32
Ballymena,6167,6,7,4,15,26,50,-24,25
Glentoran,6167,7,6,6,10,24,32,-8,24
Dungannon,6167,8,2,4,16,14,47,-33,10
Crusaders,6168,1,17,6,3,66,31,35,57
Coleraine,6168,2,15,10,1,45,22,23,55
Glenavon,6168,3,9,9,8,52,45,7,36
Linfield,6168,4,10,5,11,38,38,0,35
Cliftonville,6168,5,10,4,12,34,32,2,34
Ballymena,6168,6,7,4,15,26,52,-26,25
Glentoran,6168,7,6,6,10,24,32,-8,24
Dungannon,6168,8,2,4,16,14,47,-33,10
Crusaders,6169,1,16,6,4,63,34,29,54
Coleraine,6169,2,14,11,1,44,23,21,53
Glenavon,6169,3,9,10,7,53,44,9,37
Linfield,6169,4,10,6,10,38,37,1,36
Cliftonville,6169,5,9,5,12,33,32,1,32
Ballymena,6169,6,8,4,14,29,49,-20,28
Glentoran,6169,7,6,6,10,24,32,-8,24
Dungannon,6169,8,2,4,16,14,47,-33,10
Coleraine,6170,1,15,10,1,45,23,22,55
Crusaders,6170,2,16,6,4,61,32,29,54
Glenavon,6170,3,9,9,8,53,45,8,36
Linfield,6170,4,10,6,10,37,36,1,36
Cliftonville,6170,5,9,5,12,32,31,1,32
Ballymena,6170,6,8,4,14,27,47,-20,28
Glentoran,6170,7,6,6,10,24,32,-8,24
Dungannon,6170,8,2,4,16,14,47,-33,10
Crusaders,6171,1,17,6,3,64,31,33,57
Coleraine,6171,2,15,10,1,45,23,22,55
Glenavon,6171,3,9,9,8,53,45,8,36
Linfield,6171,4,10,6,10,38,37,1,36
Cliftonville,6171,5,9,5,12,33,32,1,32
Ballymena,6171,6,7,4,15,26,50,-24,25
Glentoran,6171,7,6,6,10,24,32,-8,24
Dungannon,6171,8,2,4,16,14,47,-33,10
Crusaders,6172,1,17,6,3,65,30,35,57
Coleraine,6172,2,15,10,1,45,23,22,55
Glenavon,6172,3,9,9,8,53,45,8,36
Linfield,6172,4,10,5,11,37,38,-1,35
Cliftonville,6172,5,10,4,12,34,31,3,34
Ballymena,6172,6,7,4,15,25,51,-26,25
Glentoran,6172,7,6,6,10,24,32,-8,24
Dungannon,6172,8,2,4,16,14,47,-33,10
Crusaders,6173,1,17,6,3,63,30,33,57
Coleraine,6173,2,15,10,1,44,22,22,55
Linfield,6173,3,11,5,10,40,36,4,38
Glenavon,6173,4,9,9,8,52,44,8,36
Cliftonville,6173,5,9,4,13,32,34,-2,31
Ballymena,6173,6,7,4,15,25,49,-24,25
Glentoran,6173,7,6,6,10,24,32,-8,24
Dungannon,6173,8,2,4,16,14,47,-33,10
Coleraine,6174,1,15,10,1,46,22,24,55
Crusaders,6174,2,16,6,4,61,31,30,54
Linfield,6174,3,11,5,10,39,37,2,38
Glenavon,6174,4,9,9,8,52,46,6,36
Cliftonville,6174,5,9,4,13,33,33,0,31
Ballymena,6174,6,8,4,14,26,47,-21,28
Glentoran,6174,7,6,6,10,24,32,-8,24
Dungannon,6174,8,2,4,16,14,47,-33,10
Crusaders,6175,1,17,6,3,64,31,33,57
Coleraine,6175,2,15,10,1,48,23,25,55
Linfield,6175,3,11,5,10,39,36,3,38
Glenavon,6175,4,9,9,8,53,48,5,36
Cliftonville,6175,5,9,4,13,32,33,-1,31
Ballymena,6175,6,7,4,15,26,50,-24,25
Glentoran,6175,7,6,6,10,24,32,-8,24
Dungannon,6175,8,2,4,16,14,47,-33,10
Crusaders,6176,1,17,6,3,63,31,32,57
Coleraine,6176,2,15,10,1,44,22,22,55
Glenavon,6176,3,9,9,8,52,44,8,36
Linfield,6176,4,10,5,11,37,37,0,35
Cliftonville,6176,5,10,4,12,33,31,2,34
Ballymena,6176,6,7,4,15,26,49,-23,25
Glentoran,6176,7,6,6,10,24,32,-8,24
Dungannon,6176,8,2,4,16,14,47,-33,10
Crusaders,6177,1,17,6,3,64,30,34,57
Coleraine,6177,2,14,10,2,45,26,19,52
Glenavon,6177,3,10,9,7,56,45,11,39
Linfield,6177,4,10,6,10,38,37,1,36
Cliftonville,6177,5,9,5,12,33,32,1,32
Ballymena,6177,6,7,4,15,25,50,-25,25
Glentoran,6177,7,6,6,10,24,32,-8,24
Dungannon,6177,8,2,4,16,14,47,-33,10
Crusaders,6178,1,17,6,3,63,31,32,57
Coleraine,6178,2,15,10,1,44,22,22,55
Glenavon,6178,3,9,9,8,52,44,8,36
Linfield,6178,4,10,5,11,37,38,-1,35
Cliftonville,6178,5,10,4,12,34,31,3,34
Ballymena,6178,6,7,4,15,26,49,-23,25
Glentoran,6178,7,6,6,10,24,32,-8,24
Dungannon,6178,8,2,4,16,14,47,-33,10
Crusaders,6179,1,16,7,3,61,30,31,55
Coleraine,6179,2,14,10,2,43,24,19,52
Glenavon,6179,3,10,9,7,54,43,11,39
Linfield,6179,4,11,5,10,38,36,2,38
Cliftonville,6179,5,9,4,13,32,32,0,31
Ballymena,6179,6,7,5,14,25,47,-22,26
Glentoran,6179,7,6,6,10,24,32,-8,24
Dungannon,6179,8,2,4,16,14,47,-33,10
Crusaders,6180,1,17,6,3,64,31,33,57
Coleraine,6180,2,14,11,1,46,25,21,53
Linfield,6180,3,11,5,10,39,36,3,38
Glenavon,6180,4,9,10,7,55,46,9,37
Cliftonville,6180,5,9,4,13,32,33,-1,31
Ballymena,6180,6,7,4,15,26,50,-24,25
Glentoran,6180,7,6,6,10,24,32,-8,24
Dungannon,6180,8,2,4,16,14,47,-33,10
Crusaders,6181,1,16,7,3,63,32,31,55
Coleraine,6181,2,14,11,1,45,24,21,53
Linfield,6181,3,11,5,10,40,36,4,38
Glenavon,6181,4,9,10,7,54,45,9,37
Cliftonville,6181,5,9,4,13,32,34,-2,31
Ballymena,6181,6,7,5,14,27,49,-22,26
Glentoran,6181,7,6,6,10,24,32,-8,24
Dungannon,6181,8,2,4,16,14,47,-33,10
Crusaders,6182,1,16,7,3,62,31,31,55
Coleraine,6182,2,14,11,1,44,23,21,53
Glenavon,6182,3,9,10,7,53,44,9,37
Linfield,6182,4,10,5,11,37,37,0,35
Cliftonville,6182,5,10,4,12,33,31,2,34
Ballymena,6182,6,7,5,14,26,48,-22,26
Glentoran,6182,7,6,6,10,24,32,-8,24
Dungannon,6182,8,2,4,16,14,47,-33,10
Crusaders,6183,1,16,6,4,62,32,30,54
Coleraine,6183,2,14,11,1,45,24,21,53
Glenavon,6183,3,9,10,7,54,45,9,37
Linfield,6183,4,10,5,11,37,37,0,35
Cliftonville,6183,5,10,4,12,33,31,2,34
Ballymena,6183,6,8,4,14,27,48,-21,28
Glentoran,6183,7,6,6,10,24,32,-8,24
Dungannon,6183,8,2,4,16,14,47,-33,10
Crusaders,6184,1,17,6,3,64,30,34,57
Coleraine,6184,2,15,10,1,46,22,24,55
Glenavon,6184,3,9,9,8,52,46,6,36
Linfield,6184,4,10,5,11,37,38,-1,35
Cliftonville,6184,5,10,4,12,34,31,3,34
Ballymena,6184,6,7,4,15,25,50,-25,25
Glentoran,6184,7,6,6,10,24,32,-8,24
Dungannon,6184,8,2,4,16,14,47,-33,10
Crusaders,6185,1,17,6,3,62,30,32,57
Coleraine,6185,2,14,10,2,43,23,20,52
Glenavon,6185,3,10,9,7,53,43,10,39
Linfield,6185,4,10,5,11,38,39,-1,35
Cliftonville,6185,5,10,4,12,35,32,3,34
Ballymena,6185,6,7,4,15,25,48,-23,25
Glentoran,6185,7,6,6,10,24,32,-8,24
Dungannon,6185,8,2,4,16,14,47,-33,10
Crusaders,6186,1,17,6,3,63,30,33,57
Coleraine,6186,2,15,10,1,46,22,24,55
Glenavon,6186,3,9,9,8,52,46,6,36
Linfield,6186,4,10,5,11,39,41,-2,35
Cliftonville,6186,5,10,4,12,37,33,4,34
Ballymena,6186,6,7,4,15,25,49,-24,25
Glentoran,6186,7,6,6,10,24,32,-8,24
Dungannon,6186,8,2,4,16,14,47,-33,10
Crusaders,6187,1,17,6,3,65,30,35,57
Coleraine,6187,2,15,10,1,44,22,22,55
Glenavon,6187,3,9,9,8,52,44,8,36
Linfield,6187,4,10,6,10,38,37,1,36
Cliftonville,6187,5,9,5,12,33,32,1,32
Ballymena,6187,6,7,4,15,25,51,-26,25
Glentoran,6187,7,6,6,10,24,32,-8,24
Dungannon,6187,8,2,4,16,14,47,-33,10
Crusaders,6188,1,17,6,3,64,32,32,57
Coleraine,6188,2,14,11,1,43,22,21,53
Linfield,6188,3,11,5,10,38,36,2,38
Glenavon,6188,4,9,10,7,52,43,9,37
Cliftonville,6188,5,9,4,13,32,32,0,31
Ballymena,6188,6,7,4,15,27,50,-23,25
Glentoran,6188,7,6,6,10,24,32,-8,24
Dungannon,6188,8,2,4,16,14,47,-33,10
Crusaders,6189,1,17,6,3,64,30,34,57
Coleraine,6189,2,15,10,1,46,24,22,55
Linfield,6189,3,11,5,10,40,36,4,38
Glenavon,6189,4,9,9,8,54,46,8,36
Cliftonville,6189,5,9,4,13,32,34,-2,31
Ballymena,6189,6,7,4,15,25,50,-25,25
Glentoran,6189,7,6,6,10,24,32,-8,24
Dungannon,6189,8,2,4,16,14,47,-33,10
Crusaders,6190,1,17,6,3,64,30,34,57
Coleraine,6190,2,14,11,1,45,24,21,53
Linfield,6190,3,11,5,10,40,36,4,38
Glenavon,6190,4,9,10,7,54,45,9,37
Cliftonville,6190,5,9,4,13,32,34,-2,31
Ballymena,6190,6,7,4,15,25,50,-25,25
Glentoran,6190,7,6,6,10,24,32,-8,24
Dungannon,6190,8,2,4,16,14,47,-33,10
Crusaders,6191,1,16,7,3,61,30,31,55
Coleraine,6191,2,14,11,1,44,23,21,53
Glenavon,6191,3,9,10,7,53,44,9,37
Linfield,6191,4,10,5,11,38,38,0,35
Cliftonville,6191,5,10,4,12,34,32,2,34
Ballymena,6191,6,7,5,14,25,47,-22,26
Glentoran,6191,7,6,6,10,24,32,-8,24
Dungannon,6191,8,2,4,16,14,47,-33,10
Crusaders,6192,1,16,7,3,61,30,31,55
Coleraine,6192,2,14,11,1,45,24,21,53
Glenavon,6192,3,9,10,7,54,45,9,37
Linfield,6192,4,10,6,10,39,38,1,36
Cliftonville,6192,5,9,5,12,34,33,1,32
Ballymena,6192,6,7,5,14,25,47,-22,26
Glentoran,6192,7,6,6,10,24,32,-8,24
Dungannon,6192,8,2,4,16,14,47,-33,10
Crusaders,6193,1,16,7,3,64,33,31,55
Coleraine,6193,2,14,10,2,46,26,20,52
Glenavon,6193,3,10,9,7,56,46,10,39
Linfield,6193,4,11,5,10,38,36,2,38
Cliftonville,6193,5,9,4,13,32,32,0,31
Ballymena,6193,6,7,5,14,28,50,-22,26
Glentoran,6193,7,6,6,10,24,32,-8,24
Dungannon,6193,8,2,4,16,14,47,-33,10
Crusaders,6194,1,16,6,4,63,33,30,54
Coleraine,6194,2,14,11,1,44,23,21,53
Glenavon,6194,3,9,10,7,53,44,9,37
Linfield,6194,4,10,5,11,39,39,0,35
Cliftonville,6194,5,10,4,12,35,33,2,34
Ballymena,6194,6,8,4,14,28,49,-21,28
Glentoran,6194,7,6,6,10,24,32,-8,24
Dungannon,6194,8,2,4,16,14,47,-33,10
Crusaders,6195,1,17,6,3,64,30,34,57
Coleraine,6195,2,14,11,1,43,22,21,53
Glenavon,6195,3,9,10,7,52,43,9,37
Linfield,6195,4,10,5,11,39,39,0,35
Cliftonville,6195,5,10,4,12,35,33,2,34
Ballymena,6195,6,7,4,15,25,50,-25,25
Glentoran,6195,7,6,6,10,24,32,-8,24
Dungannon,6195,8,2,4,16,14,47,-33,10
Crusaders,6196,1,17,6,3,65,31,34,57
Coleraine,6196,2,14,10,2,44,25,19,52
Glenavon,6196,3,10,9,7,55,44,11,39
Linfield,6196,4,11,5,10,38,36,2,38
Cliftonville,6196,5,9,4,13,32,32,0,31
Ballymena,6196,6,7,4,15,26,51,-25,25
Glentoran,6196,7,6,6,10,24,32,-8,24
Dungannon,6196,8,2,4,16,14,47,-33,10
Crusaders,6197,1,16,6,4,63,33,30,54
Coleraine,6197,2,14,11,1,45,24,21,53
Linfield,6197,3,11,5,10,38,36,2,38
Glenavon,6197,4,9,10,7,54,45,9,37
Cliftonville,6197,5,9,4,13,32,32,0,31
Ballymena,6197,6,8,4,14,28,49,-21,28
Glentoran,6197,7,6,6,10,24,32,-8,24
Dungannon,6197,8,2,4,16,14,47,-33,10
Crusaders,6198,1,16,6,4,61,31,30,54
Coleraine,6198,2,14,11,1,44,23,21,53
Linfield,6198,3,11,5,10,38,36,2,38
Glenavon,6198,4,9,10,7,53,44,9,37
Cliftonville,6198,5,9,4,13,32,32,0,31
Ballymena,6198,6,8,4,14,26,47,-21,28
Glentoran,6198,7,6,6,10,24,32,-8,24
Dungannon,6198,8,2,4,16,14,47,-33,10
Crusaders,6199,1,16,7,3,64,33,31,55
Coleraine,6199,2,14,10,2,46,26,20,52
Glenavon,6199,3,10,9,7,56,46,10,39
Linfield,6199,4,10,6,10,38,37,1,36
Cliftonville,6199,5,9,5,12,33,32,1,32
Ballymena,6199,6,7,5,14,28,50,-22,26
Glentoran,6199,7,6,6,10,24,32,-8,24
Dungannon,6199,8,2,4,16,14,47,-33,10
Crusaders,6200,1,16,7,3,63,32,31,55
Coleraine,6200,2,14,10,2,43,26,17,52
Glenavon,6200,3,10,9,7,56,43,13,39
Linfield,6200,4,11,5,10,40,37,3,38
Cliftonville,6200,5,9,4,13,33,34,-1,31
Ballymena,6200,6,7,5,14,27,49,-22,26
Glentoran,6200,7,6,6,10,24,32,-8,24
Dungannon,6200,8,2,4,16,14,47,-33,10
Crusaders,6201,1,17,6,3,63,31,32,57
Coleraine,6201,2,15,10,1,45,23,22,55
Linfield,6201,3,11,5,10,40,38,2,38
Glenavon,6201,4,9,9,8,53,45,8,36
Cliftonville,6201,5,9,4,13,34,34,0,31
Ballymena,6201,6,7,4,15,26,49,-23,25
Glentoran,6201,7,6,6,10,24,32,-8,24
Dungannon,6201,8,2,4,16,14,47,-33,10
Crusaders,6202,1,16,7,3,62,31,31,55
Coleraine,6202,2,15,10,1,44,22,22,55
Linfield,6202,3,11,5,10,40,36,4,38
Glenavon,6202,4,9,9,8,52,44,8,36
Cliftonville,6202,5,9,4,13,32,34,-2,31
Ballymena,6202,6,7,5,14,26,48,-22,26
Glentoran,6202,7,6,6,10,24,32,-8,24
Dungannon,6202,8,2,4,16,14,47,-33,10
Crusaders,6203,1,17,6,3,64,30,34,57
Coleraine,6203,2,14,10,2,44,26,18,52
Glenavon,6203,3,10,9,7,56,44,12,39
Linfield,6203,4,10,6,10,38,37,1,36
Cliftonville,6203,5,9,5,12,33,32,1,32
Ballymena,6203,6,7,4,15,25,50,-25,25
Glentoran,6203,7,6,6,10,24,32,-8,24
Dungannon,6203,8,2,4,16,14,47,-33,10
Coleraine,6204,1,15,10,1,45,23,22,55
Crusaders,6204,2,16,6,4,61,31,30,54
Linfield,6204,3,11,5,10,38,36,2,38
Glenavon,6204,4,9,9,8,53,45,8,36
Cliftonville,6204,5,9,4,13,32,32,0,31
Ballymena,6204,6,8,4,14,26,47,-21,28
Glentoran,6204,7,6,6,10,24,32,-8,24
Dungannon,6204,8,2,4,16,14,47,-33,10
Coleraine,6205,1,15,10,1,45,23,22,55
Crusaders,6205,2,16,6,4,62,33,29,54
Glenavon,6205,3,9,9,8,53,45,8,36
Linfield,6205,4,10,5,11,38,38,0,35
Cliftonville,6205,5,10,4,12,34,32,2,34
Ballymena,6205,6,8,4,14,28,48,-20,28
Glentoran,6205,7,6,6,10,24,32,-8,24
Dungannon,6205,8,2,4,16,14,47,-33,10
Crusaders,6206,1,17,6,3,64,31,33,57
Coleraine,6206,2,14,10,2,43,24,19,52
Glenavon,6206,3,10,9,7,54,43,11,39
Linfield,6206,4,10,6,10,38,37,1,36
Cliftonville,6206,5,9,5,12,33,32,1,32
Ballymena,6206,6,7,4,15,26,50,-24,25
Glentoran,6206,7,6,6,10,24,32,-8,24
Dungannon,6206,8,2,4,16,14,47,-33,10
Crusaders,6207,1,17,6,3,62,30,32,57
Coleraine,6207,2,14,10,2,43,25,18,52
Glenavon,6207,3,10,9,7,55,43,12,39
Linfield,6207,4,10,6,10,38,37,1,36
Cliftonville,6207,5,9,5,12,33,32,1,32
Ballymena,6207,6,7,4,15,25,48,-23,25
Glentoran,6207,7,6,6,10,24,32,-8,24
Dungannon,6207,8,2,4,16,14,47,-33,10
Crusaders,6208,1,17,6,3,63,30,33,57
Coleraine,6208,2,15,10,1,44,22,22,55
Glenavon,6208,3,9,9,8,52,44,8,36
Linfield,6208,4,10,6,10,37,36,1,36
Cliftonville,6208,5,9,5,12,32,31,1,32
Ballymena,6208,6,7,4,15,25,49,-24,25
Glentoran,6208,7,6,6,10,24,32,-8,24
Dungannon,6208,8,2,4,16,14,47,-33,10
Crusaders,6209,1,16,7,3,62,31,31,55
Coleraine,6209,2,14,10,2,44,24,20,52
Glenavon,6209,3,10,9,7,54,44,10,39
Linfield,6209,4,11,5,10,39,37,2,38
Cliftonville,6209,5,9,4,13,33,33,0,31
Ballymena,6209,6,7,5,14,26,48,-22,26
Glentoran,6209,7,6,6,10,24,32,-8,24
Dungannon,6209,8,2,4,16,14,47,-33,10
Crusaders,6210,1,17,6,3,64,32,32,57
Coleraine,6210,2,14,10,2,44,25,19,52
Glenavon,6210,3,10,9,7,55,44,11,39
Linfield,6210,4,10,6,10,37,36,1,36
Cliftonville,6210,5,9,5,12,32,31,1,32
Ballymena,6210,6,7,4,15,27,50,-23,25
Glentoran,6210,7,6,6,10,24,32,-8,24
Dungannon,6210,8,2,4,16,14,47,-33,10
Crusaders,6211,1,16,6,4,61,31,30,54
Coleraine,6211,2,14,11,1,45,24,21,53
Linfield,6211,3,11,5,10,40,36,4,38
Glenavon,6211,4,9,10,7,54,45,9,37
Cliftonville,6211,5,9,4,13,32,34,-2,31
Ballymena,6211,6,8,4,14,26,47,-21,28
Glentoran,6211,7,6,6,10,24,32,-8,24
Dungannon,6211,8,2,4,16,14,47,-33,10
Crusaders,6212,1,16,6,4,61,31,30,54
Coleraine,6212,2,14,10,2,44,25,19,52
Glenavon,6212,3,10,9,7,55,44,11,39
Linfield,6212,4,10,6,10,38,37,1,36
Cliftonville,6212,5,9,5,12,33,32,1,32
Ballymena,6212,6,8,4,14,26,47,-21,28
Glentoran,6212,7,6,6,10,24,32,-8,24
Dungannon,6212,8,2,4,16,14,47,-33,10
Crusaders,6213,1,16,7,3,62,31,31,55
Coleraine,6213,2,14,11,1,45,24,21,53
Glenavon,6213,3,9,10,7,54,45,9,37
Linfield,6213,4,10,6,10,39,38,1,36
Cliftonville,6213,5,9,5,12,34,33,1,32
Ballymena,6213,6,7,5,14,26,48,-22,26
Glentoran,6213,7,6,6,10,24,32,-8,24
Dungannon,6213,8,2,4,16,14,47,-33,10
Crusaders,6214,1,16,7,3,62,31,31,55
Coleraine,6214,2,14,10,2,43,23,20,52
Glenavon,6214,3,10,9,7,53,43,10,39
Linfield,6214,4,10,5,11,38,38,0,35
Cliftonville,6214,5,10,4,12,34,32,2,34
Ballymena,6214,6,7,5,14,26,48,-22,26
Glentoran,6214,7,6,6,10,24,32,-8,24
Dungannon,6214,8,2,4,16,14,47,-33,10
Crusaders,6215,1,17,6,3,64,32,32,57
Coleraine,6215,2,14,10,2,45,27,18,52
Glenavon,6215,3,10,9,7,57,45,12,39
Linfield,6215,4,10,5,11,38,40,-2,35
Cliftonville,6215,5,10,4,12,36,32,4,34
Ballymena,6215,6,7,4,15,27,50,-23,25
Glentoran,6215,7,6,6,10,24,32,-8,24
Dungannon,6215,8,2,4,16,14,47,-33,10
Crusaders,6216,1,17,6,3,62,30,32,57
Coleraine,6216,2,15,10,1,46,23,23,55
Linfield,6216,3,11,5,10,40,37,3,38
Glenavon,6216,4,9,9,8,53,46,7,36
Cliftonville,6216,5,9,4,13,33,34,-1,31
Ballymena,6216,6,7,4,15,25,48,-23,25
Glentoran,6216,7,6,6,10,24,32,-8,24
Dungannon,6216,8,2,4,16,14,47,-33,10
Crusaders,6217,1,16,6,4,62,32,30,54
Coleraine,6217,2,14,10,2,44,25,19,52
Glenavon,6217,3,10,9,7,55,44,11,39
Linfield,6217,4,11,5,10,39,36,3,38
Cliftonville,6217,5,9,4,13,32,33,-1,31
Ballymena,6217,6,8,4,14,27,48,-21,28
Glentoran,6217,7,6,6,10,24,32,-8,24
Dungannon,6217,8,2,4,16,14,47,-33,10
Crusaders,6218,1,16,6,4,62,32,30,54
Coleraine,6218,2,14,10,2,44,25,19,52
Glenavon,6218,3,10,9,7,55,44,11,39
Linfield,6218,4,11,5,10,38,36,2,38
Cliftonville,6218,5,9,4,13,32,32,0,31
Ballymena,6218,6,8,4,14,27,48,-21,28
Glentoran,6218,7,6,6,10,24,32,-8,24
Dungannon,6218,8,2,4,16,14,47,-33,10
Crusaders,6219,1,17,6,3,64,30,34,57
Coleraine,6219,2,14,10,2,43,25,18,52
Glenavon,6219,3,10,9,7,55,43,12,39
Linfield,6219,4,11,5,10,39,37,2,38
Cliftonville,6219,5,9,4,13,33,33,0,31
Ballymena,6219,6,7,4,15,25,50,-25,25
Glentoran,6219,7,6,6,10,24,32,-8,24
Dungannon,6219,8,2,4,16,14,47,-33,10
Crusaders,6220,1,16,6,4,64,34,30,54
Coleraine,6220,2,14,11,1,46,25,21,53
Glenavon,6220,3,9,10,7,55,46,9,37
Linfield,6220,4,10,6,10,38,37,1,36
Cliftonville,6220,5,9,5,12,33,32,1,32
Ballymena,6220,6,8,4,14,29,50,-21,28
Glentoran,6220,7,6,6,10,24,32,-8,24
Dungannon,6220,8,2,4,16,14,47,-33,10
Crusaders,6221,1,16,6,4,61,32,29,54
Coleraine,6221,2,14,10,2,43,25,18,52
Glenavon,6221,3,10,9,7,55,43,12,39
Linfield,6221,4,10,5,11,37,37,0,35
Cliftonville,6221,5,10,4,12,33,31,2,34
Ballymena,6221,6,8,4,14,27,47,-20,28
Glentoran,6221,7,6,6,10,24,32,-8,24
Dungannon,6221,8,2,4,16,14,47,-33,10
Coleraine,6222,1,15,10,1,45,23,22,55
Crusaders,6222,2,16,6,4,64,34,30,54
Linfield,6222,3,11,5,10,38,36,2,38
Glenavon,6222,4,9,9,8,53,45,8,36
Cliftonville,6222,5,9,4,13,32,32,0,31
Ballymena,6222,6,8,4,14,29,50,-21,28
Glentoran,6222,7,6,6,10,24,32,-8,24
Dungannon,6222,8,2,4,16,14,47,-33,10
Crusaders,6223,1,17,6,3,63,30,33,57
Coleraine,6223,2,15,10,1,45,23,22,55
Glenavon,6223,3,9,9,8,53,45,8,36
Linfield,6223,4,10,6,10,38,37,1,36
Cliftonville,6223,5,9,5,12,33,32,1,32
Ballymena,6223,6,7,4,15,25,49,-24,25
Glentoran,6223,7,6,6,10,24,32,-8,24
Dungannon,6223,8,2,4,16,14,47,-33,10
Crusaders,6224,1,16,6,4,61,31,30,54
Coleraine,6224,2,14,10,2,44,24,20,52
Glenavon,6224,3,10,9,7,54,44,10,39
Linfield,6224,4,10,6,10,38,37,1,36
Cliftonville,6224,5,9,5,12,33,32,1,32
Ballymena,6224,6,8,4,14,26,47,-21,28
Glentoran,6224,7,6,6,10,24,32,-8,24
Dungannon,6224,8,2,4,16,14,47,-33,10
Crusaders,6225,1,17,6,3,66,32,34,57
Coleraine,6225,2,15,10,1,46,23,23,55
Linfield,6225,3,11,5,10,39,36,3,38
Glenavon,6225,4,9,9,8,53,46,7,36
Cliftonville,6225,5,9,4,13,32,33,-1,31
Ballymena,6225,6,7,4,15,27,52,-25,25
Glentoran,6225,7,6,6,10,24,32,-8,24
Dungannon,6225,8,2,4,16,14,47,-33,10
Crusaders,6226,1,16,7,3,61,30,31,55
Coleraine,6226,2,15,10,1,45,23,22,55
Linfield,6226,3,11,5,10,40,37,3,38
Glenavon,6226,4,9,9,8,53,45,8,36
Cliftonville,6226,5,9,4,13,33,34,-1,31
Ballymena,6226,6,7,5,14,25,47,-22,26
Glentoran,6226,7,6,6,10,24,32,-8,24
Dungannon,6226,8,2,4,16,14,47,-33,10
Crusaders,6227,1,16,7,3,62,31,31,55
Coleraine,6227,2,14,11,1,44,23,21,53
Glenavon,6227,3,9,10,7,53,44,9,37
Linfield,6227,4,10,5,11,38,38,0,35
Cliftonville,6227,5,10,4,12,34,32,2,34
Ballymena,6227,6,7,5,14,26,48,-22,26
Glentoran,6227,7,6,6,10,24,32,-8,24
Dungannon,6227,8,2,4,16,14,47,-33,10
Crusaders,6228,1,16,6,4,63,34,29,54
Coleraine,6228,2,14,10,2,44,24,20,52
Glenavon,6228,3,10,9,7,54,44,10,39
Linfield,6228,4,10,6,10,37,36,1,36
Cliftonville,6228,5,9,5,12,32,31,1,32
Ballymena,6228,6,8,4,14,29,49,-20,28
Glentoran,6228,7,6,6,10,24,32,-8,24
Dungannon,6228,8,2,4,16,14,47,-33,10
Crusaders,6229,1,16,7,3,62,31,31,55
Coleraine,6229,2,14,11,1,44,23,21,53
Linfield,6229,3,11,5,10,39,36,3,38
Glenavon,6229,4,9,10,7,53,44,9,37
Cliftonville,6229,5,9,4,13,32,33,-1,31
Ballymena,6229,6,7,5,14,26,48,-22,26
Glentoran,6229,7,6,6,10,24,32,-8,24
Dungannon,6229,8,2,4,16,14,47,-33,10
Crusaders,6230,1,16,7,3,61,30,31,55
Coleraine,6230,2,15,10,1,45,23,22,55
Glenavon,6230,3,9,9,8,53,45,8,36
Linfield,6230,4,10,6,10,37,36,1,36
Cliftonville,6230,5,9,5,12,32,31,1,32
Ballymena,6230,6,7,5,14,25,47,-22,26
Glentoran,6230,7,6,6,10,24,32,-8,24
Dungannon,6230,8,2,4,16,14,47,-33,10
Coleraine,6231,1,15,10,1,45,23,22,55
Crusaders,6231,2,16,6,4,62,32,30,54
Glenavon,6231,3,9,9,8,53,45,8,36
Linfield,6231,4,10,5,11,37,37,0,35
Cliftonville,6231,5,10,4,12,33,31,2,34
Ballymena,6231,6,8,4,14,27,48,-21,28
Glentoran,6231,7,6,6,10,24,32,-8,24
Dungannon,6231,8,2,4,16,14,47,-33,10
Crusaders,6232,1,17,6,3,65,31,34,57
Coleraine,6232,2,14,10,2,43,25,18,52
Glenavon,6232,3,10,9,7,55,43,12,39
Linfield,6232,4,10,5,11,37,37,0,35
Cliftonville,6232,5,10,4,12,33,31,2,34
Ballymena,6232,6,7,4,15,26,51,-25,25
Glentoran,6232,7,6,6,10,24,32,-8,24
Dungannon,6232,8,2,4,16,14,47,-33,10
Crusaders,6233,1,17,6,3,64,30,34,57
Coleraine,6233,2,15,10,1,46,23,23,55
Linfield,6233,3,11,5,10,40,36,4,38
Glenavon,6233,4,9,9,8,53,46,7,36
Cliftonville,6233,5,9,4,13,32,34,-2,31
Ballymena,6233,6,7,4,15,25,50,-25,25
Glentoran,6233,7,6,6,10,24,32,-8,24
Dungannon,6233,8,2,4,16,14,47,-33,10
Crusaders,6234,1,17,6,3,62,30,32,57
Coleraine,6234,2,14,10,2,43,24,19,52
Glenavon,6234,3,10,9,7,54,43,11,39
Linfield,6234,4,11,5,10,39,36,3,38
Cliftonville,6234,5,9,4,13,32,33,-1,31
Ballymena,6234,6,7,4,15,25,48,-23,25
Glentoran,6234,7,6,6,10,24,32,-8,24
Dungannon,6234,8,2,4,16,14,47,-33,10
Crusaders,6235,1,17,6,3,64,31,33,57
Coleraine,6235,2,14,10,2,43,25,18,52
Glenavon,6235,3,10,9,7,55,43,12,39
Linfield,6235,4,11,5,10,41,36,5,38
Cliftonville,6235,5,9,4,13,32,35,-3,31
Ballymena,6235,6,7,4,15,26,50,-24,25
Glentoran,6235,7,6,6,10,24,32,-8,24
Dungannon,6235,8,2,4,16,14,47,-33,10
Crusaders,6236,1,16,7,3,64,33,31,55
Coleraine,6236,2,14,11,1,44,23,21,53
Linfield,6236,3,11,5,10,42,37,5,38
Glenavon,6236,4,9,10,7,53,44,9,37
Cliftonville,6236,5,9,4,13,33,36,-3,31
Ballymena,6236,6,7,5,14,28,50,-22,26
Glentoran,6236,7,6,6,10,24,32,-8,24
Dungannon,6236,8,2,4,16,14,47,-33,10
Crusaders,6237,1,17,6,3,63,31,32,57
Coleraine,6237,2,14,10,2,44,26,18,52
Glenavon,6237,3,10,9,7,56,44,12,39
Linfield,6237,4,10,6,10,39,38,1,36
Cliftonville,6237,5,9,5,12,34,33,1,32
Ballymena,6237,6,7,4,15,26,49,-23,25
Glentoran,6237,7,6,6,10,24,32,-8,24
Dungannon,6237,8,2,4,16,14,47,-33,10
Crusaders,6238,1,17,6,3,63,31,32,57
Coleraine,6238,2,14,10,2,44,25,19,52
Glenavon,6238,3,10,9,7,55,44,11,39
Linfield,6238,4,10,6,10,37,36,1,36
Cliftonville,6238,5,9,5,12,32,31,1,32
Ballymena,6238,6,7,4,15,26,49,-23,25
Glentoran,6238,7,6,6,10,24,32,-8,24
Dungannon,6238,8,2,4,16,14,47,-33,10
Crusaders,6239,1,16,7,3,62,31,31,55
Coleraine,6239,2,15,10,1,45,23,22,55
Glenavon,6239,3,9,9,8,53,45,8,36
Linfield,6239,4,10,6,10,37,36,1,36
Cliftonville,6239,5,9,5,12,32,31,1,32
Ballymena,6239,6,7,5,14,26,48,-22,26
Glentoran,6239,7,6,6,10,24,32,-8,24
Dungannon,6239,8,2,4,16,14,47,-33,10
Crusaders,6240,1,17,6,3,63,31,32,57
Coleraine,6240,2,14,11,1,44,23,21,53
Glenavon,6240,3,9,10,7,53,44,9,37
Linfield,6240,4,10,6,10,38,37,1,36
Cliftonville,6240,5,9,5,12,33,32,1,32
Ballymena,6240,6,7,4,15,26,49,-23,25
Glentoran,6240,7,6,6,10,24,32,-8,24
Dungannon,6240,8,2,4,16,14,47,-33,10
Crusaders,6241,1,16,6,4,62,32,30,54
Coleraine,6241,2,14,11,1,43,22,21,53
Glenavon,6241,3,9,10,7,52,43,9,37
Linfield,6241,4,10,5,11,37,37,0,35
Cliftonville,6241,5,10,4,12,33,31,2,34
Ballymena,6241,6,8,4,14,27,48,-21,28
Glentoran,6241,7,6,6,10,24,32,-8,24
Dungannon,6241,8,2,4,16,14,47,-33,10
Crusaders,6242,1,17,6,3,62,30,32,57
Coleraine,6242,2,14,10,2,45,25,20,52
Glenavon,6242,3,10,9,7,55,45,10,39
Linfield,6242,4,10,6,10,38,37,1,36
Cliftonville,6242,5,9,5,12,33,32,1,32
Ballymena,6242,6,7,4,15,25,48,-23,25
Glentoran,6242,7,6,6,10,24,32,-8,24
Dungannon,6242,8,2,4,16,14,47,-33,10
Crusaders,6243,1,17,6,3,64,32,32,57
Coleraine,6243,2,15,10,1,46,24,22,55
Linfield,6243,3,11,5,10,39,36,3,38
Glenavon,6243,4,9,9,8,54,46,8,36
Cliftonville,6243,5,9,4,13,32,33,-1,31
Ballymena,6243,6,7,4,15,27,50,-23,25
Glentoran,6243,7,6,6,10,24,32,-8,24
Dungannon,6243,8,2,4,16,14,47,-33,10
Crusaders,6244,1,17,6,3,64,30,34,57
Coleraine,6244,2,14,10,2,43,25,18,52
Glenavon,6244,3,10,9,7,55,43,12,39
Linfield,6244,4,10,6,10,37,36,1,36
Cliftonville,6244,5,9,5,12,32,31,1,32
Ballymena,6244,6,7,4,15,25,50,-25,25
Glentoran,6244,7,6,6,10,24,32,-8,24
Dungannon,6244,8,2,4,16,14,47,-33,10
Crusaders,6245,1,17,6,3,65,33,32,57
Coleraine,6245,2,14,10,2,43,24,19,52
Glenavon,6245,3,10,9,7,54,43,11,39
Linfield,6245,4,10,6,10,37,36,1,36
Cliftonville,6245,5,9,5,12,32,31,1,32
Ballymena,6245,6,7,4,15,28,51,-23,25
Glentoran,6245,7,6,6,10,24,32,-8,24
Dungannon,6245,8,2,4,16,14,47,-33,10
Crusaders,6246,1,17,6,3,63,30,33,57
Coleraine,6246,2,14,10,2,43,24,19,52
Glenavon,6246,3,10,9,7,54,43,11,39
Linfield,6246,4,10,6,10,39,38,1,36
Cliftonville,6246,5,9,5,12,34,33,1,32
Ballymena,6246,6,7,4,15,25,49,-24,25
Glentoran,6246,7,6,6,10,24,32,-8,24
Dungannon,6246,8,2,4,16,14,47,-33,10
Crusaders,6247,1,16,6,4,64,34,30,54
Coleraine,6247,2,14,10,2,43,24,19,52
Glenavon,6247,3,10,9,7,54,43,11,39
Linfield,6247,4,10,6,10,38,37,1,36
Cliftonville,6247,5,9,5,12,33,32,1,32
Ballymena,6247,6,8,4,14,29,50,-21,28
Glentoran,6247,7,6,6,10,24,32,-8,24
Dungannon,6247,8,2,4,16,14,47,-33,10
Crusaders,6248,1,16,6,4,62,32,30,54
Coleraine,6248,2,14,10,2,44,24,20,52
Glenavon,6248,3,10,9,7,54,44,10,39
Linfield,6248,4,11,5,10,39,37,2,38
Cliftonville,6248,5,9,4,13,33,33,0,31
Ballymena,6248,6,8,4,14,27,48,-21,28
Glentoran,6248,7,6,6,10,24,32,-8,24
Dungannon,6248,8,2,4,16,14,47,-33,10
Crusaders,6249,1,16,7,3,62,31,31,55
Coleraine,6249,2,14,10,2,45,26,19,52
Glenavon,6249,3,10,9,7,56,45,11,39
Linfield,6249,4,11,5,10,39,36,3,38
Cliftonville,6249,5,9,4,13,32,33,-1,31
Ballymena,6249,6,7,5,14,26,48,-22,26
Glentoran,6249,7,6,6,10,24,32,-8,24
Dungannon,6249,8,2,4,16,14,47,-33,10
Crusaders,6250,1,16,7,3,63,32,31,55
Coleraine,6250,2,14,10,2,43,24,19,52
Glenavon,6250,3,10,9,7,54,43,11,39
Linfield,6250,4,11,5,10,38,36,2,38
Cliftonville,6250,5,9,4,13,32,32,0,31
Ballymena,6250,6,7,5,14,27,49,-22,26
Glentoran,6250,7,6,6,10,24,32,-8,24
Dungannon,6250,8,2,4,16,14,47,-33,10
Crusaders,6251,1,16,7,3,62,31,31,55
Coleraine,6251,2,15,10,1,46,23,23,55
Glenavon,6251,3,9,9,8,53,46,7,36
Linfield,6251,4,10,5,11,37,38,-1,35
Cliftonville,6251,5,10,4,12,34,31,3,34
Ballymena,6251,6,7,5,14,26,48,-22,26
Glentoran,6251,7,6,6,10,24,32,-8,24
Dungannon,6251,8,2,4,16,14,47,-33,10
Crusaders,6252,1,17,6,3,62,30,32,57
Coleraine,6252,2,14,11,1,46,25,21,53
Linfield,6252,3,11,5,10,39,36,3,38
Glenavon,6252,4,9,10,7,55,46,9,37
Cliftonville,6252,5,9,4,13,32,33,-1,31
Ballymena,6252,6,7,4,15,25,48,-23,25
Glentoran,6252,7,6,6,10,24,32,-8,24
Dungannon,6252,8,2,4,16,14,47,-33,10
Crusaders,6253,1,16,6,4,62,32,30,54
Coleraine,6253,2,14,10,2,43,23,20,52
Glenavon,6253,3,10,9,7,53,43,10,39
Linfield,6253,4,10,5,11,39,39,0,35
Cliftonville,6253,5,10,4,12,35,33,2,34
Ballymena,6253,6,8,4,14,27,48,-21,28
Glentoran,6253,7,6,6,10,24,32,-8,24
Dungannon,6253,8,2,4,16,14,47,-33,10
Crusaders,6254,1,17,6,3,64,31,33,57
Coleraine,6254,2,15,10,1,44,22,22,55
Linfield,6254,3,11,5,10,38,36,2,38
Glenavon,6254,4,9,9,8,52,44,8,36
Cliftonville,6254,5,9,4,13,32,32,0,31
Ballymena,6254,6,7,4,15,26,50,-24,25
Glentoran,6254,7,6,6,10,24,32,-8,24
Dungannon,6254,8,2,4,16,14,47,-33,10
Crusaders,6255,1,16,7,3,61,30,31,55
Coleraine,6255,2,15,10,1,47,23,24,55
Glenavon,6255,3,9,9,8,53,47,6,36
Linfield,6255,4,10,6,10,38,37,1,36
Cliftonville,6255,5,9,5,12,33,32,1,32
Ballymena,6255,6,7,5,14,25,47,-22,26
Glentoran,6255,7,6,6,10,24,32,-8,24
Dungannon,6255,8,2,4,16,14,47,-33,10
Crusaders,6256,1,16,7,3,63,32,31,55
Coleraine,6256,2,14,10,2,44,25,19,52
Glenavon,6256,3,10,9,7,55,44,11,39
Linfield,6256,4,10,6,10,39,38,1,36
Cliftonville,6256,5,9,5,12,34,33,1,32
Ballymena,6256,6,7,5,14,27,49,-22,26
Glentoran,6256,7,6,6,10,24,32,-8,24
Dungannon,6256,8,2,4,16,14,47,-33,10
Crusaders,6257,1,16,6,4,63,33,30,54
Coleraine,6257,2,14,10,2,43,23,20,52
Glenavon,6257,3,10,9,7,53,43,10,39
Linfield,6257,4,10,5,11,37,37,0,35
Cliftonville,6257,5,10,4,12,33,31,2,34
Ballymena,6257,6,8,4,14,28,49,-21,28
Glentoran,6257,7,6,6,10,24,32,-8,24
Dungannon,6257,8,2,4,16,14,47,-33,10
Crusaders,6258,1,17,6,3,63,31,32,57
Coleraine,6258,2,14,11,1,45,24,21,53
Linfield,6258,3,11,5,10,38,36,2,38
Glenavon,6258,4,9,10,7,54,45,9,37
Cliftonville,6258,5,9,4,13,32,32,0,31
Ballymena,6258,6,7,4,15,26,49,-23,25
Glentoran,6258,7,6,6,10,24,32,-8,24
Dungannon,6258,8,2,4,16,14,47,-33,10
Crusaders,6259,1,17,6,3,63,30,33,57
Coleraine,6259,2,15,10,1,44,22,22,55
Glenavon,6259,3,9,9,8,52,44,8,36
Linfield,6259,4,10,5,11,38,38,0,35
Cliftonville,6259,5,10,4,12,34,32,2,34
Ballymena,6259,6,7,4,15,25,49,-24,25
Glentoran,6259,7,6,6,10,24,32,-8,24
Dungannon,6259,8,2,4,16,14,47,-33,10
Crusaders,6260,1,17,6,3,63,30,33,57
Coleraine,6260,2,14,10,2,44,24,20,52
Glenavon,6260,3,10,9,7,54,44,10,39
Linfield,6260,4,11,5,10,41,36,5,38
Cliftonville,6260,5,9,4,13,32,35,-3,31
Ballymena,6260,6,7,4,15,25,49,-24,25
Glentoran,6260,7,6,6,10,24,32,-8,24
Dungannon,6260,8,2,4,16,14,47,-33,10
Crusaders,6261,1,16,7,3,63,32,31,55
Coleraine,6261,2,14,11,1,44,23,21,53
Glenavon,6261,3,9,10,7,53,44,9,37
Linfield,6261,4,10,5,11,37,38,-1,35
Cliftonville,6261,5,10,4,12,34,31,3,34
Ballymena,6261,6,7,5,14,27,49,-22,26
Glentoran,6261,7,6,6,10,24,32,-8,24
Dungannon,6261,8,2,4,16,14,47,-33,10
Coleraine,6262,1,15,10,1,46,22,24,55
Crusaders,6262,2,16,6,4,62,32,30,54
Glenavon,6262,3,9,9,8,52,46,6,36
Linfield,6262,4,10,5,11,37,37,0,35
Cliftonville,6262,5,10,4,12,33,31,2,34
Ballymena,6262,6,8,4,14,27,48,-21,28
Glentoran,6262,7,6,6,10,24,32,-8,24
Dungannon,6262,8,2,4,16,14,47,-33,10
Crusaders,6263,1,17,6,3,62,30,32,57
Coleraine,6263,2,15,10,1,46,24,22,55
Glenavon,6263,3,9,9,8,54,46,8,36
Linfield,6263,4,10,6,10,38,37,1,36
Cliftonville,6263,5,9,5,12,33,32,1,32
Ballymena,6263,6,7,4,15,25,48,-23,25
Glentoran,6263,7,6,6,10,24,32,-8,24
Dungannon,6263,8,2,4,16,14,47,-33,10
Crusaders,6264,1,17,6,3,67,33,34,57
Coleraine,6264,2,14,10,2,44,27,17,52
Glenavon,6264,3,10,9,7,57,44,13,39
Linfield,6264,4,10,6,10,37,36,1,36
Cliftonville,6264,5,9,5,12,32,31,1,32
Ballymena,6264,6,7,4,15,28,53,-25,25
Glentoran,6264,7,6,6,10,24,32,-8,24
Dungannon,6264,8,2,4,16,14,47,-33,10
Crusaders,6265,1,17,6,3,65,30,35,57
Coleraine,6265,2,15,10,1,45,23,22,55
Linfield,6265,3,11,5,10,38,36,2,38
Glenavon,6265,4,9,9,8,53,45,8,36
Cliftonville,6265,5,9,4,13,32,32,0,31
Ballymena,6265,6,7,4,15,25,51,-26,25
Glentoran,6265,7,6,6,10,24,32,-8,24
Dungannon,6265,8,2,4,16,14,47,-33,10
Crusaders,6266,1,17,6,3,62,30,32,57
Coleraine,6266,2,15,10,1,48,23,25,55
Glenavon,6266,3,9,9,8,53,48,5,36
Linfield,6266,4,10,6,10,37,36,1,36
Cliftonville,6266,5,9,5,12,32,31,1,32
Ballymena,6266,6,7,4,15,25,48,-23,25
Glentoran,6266,7,6,6,10,24,32,-8,24
Dungannon,6266,8,2,4,16,14,47,-33,10
Crusaders,6267,1,16,7,3,63,32,31,55
Coleraine,6267,2,14,10,2,43,25,18,52
Glenavon,6267,3,10,9,7,55,43,12,39
Linfield,6267,4,10,5,11,38,38,0,35
Cliftonville,6267,5,10,4,12,34,32,2,34
Ballymena,6267,6,7,5,14,27,49,-22,26
Glentoran,6267,7,6,6,10,24,32,-8,24
Dungannon,6267,8,2,4,16,14,47,-33,10
Crusaders,6268,1,16,6,4,61,31,30,54
Coleraine,6268,2,14,10,2,44,26,18,52
Glenavon,6268,3,10,9,7,56,44,12,39
Linfield,6268,4,11,5,10,40,38,2,38
Cliftonville,6268,5,9,4,13,34,34,0,31
Ballymena,6268,6,8,4,14,26,47,-21,28
Glentoran,6268,7,6,6,10,24,32,-8,24
Dungannon,6268,8,2,4,16,14,47,-33,10
Crusaders,6269,1,17,6,3,64,30,34,57
Coleraine,6269,2,15,10,1,48,23,25,55
Glenavon,6269,3,9,9,8,53,48,5,36
Linfield,6269,4,10,5,11,37,39,-2,35
Cliftonville,6269,5,10,4,12,35,31,4,34
Ballymena,6269,6,7,4,15,25,50,-25,25
Glentoran,6269,7,6,6,10,24,32,-8,24
Dungannon,6269,8,2,4,16,14,47,-33,10
Crusaders,6270,1,17,6,3,62,30,32,57
Coleraine,6270,2,15,10,1,45,22,23,55
Glenavon,6270,3,9,9,8,52,45,7,36
Linfield,6270,4,10,5,11,37,37,0,35
Cliftonville,6270,5,10,4,12,33,31,2,34
Ballymena,6270,6,7,4,15,25,48,-23,25
Glentoran,6270,7,6,6,10,24,32,-8,24
Dungannon,6270,8,2,4,16,14,47,-33,10
Crusaders,6271,1,16,6,4,61,31,30,54
Coleraine,6271,2,14,10,2,43,23,20,52
Glenavon,6271,3,10,9,7,53,43,10,39
Linfield,6271,4,11,5,10,38,36,2,38
Cliftonville,6271,5,9,4,13,32,32,0,31
Ballymena,6271,6,8,4,14,26,47,-21,28
Glentoran,6271,7,6,6,10,24,32,-8,24
Dungannon,6271,8,2,4,16,14,47,-33,10
Crusaders,6272,1,17,6,3,63,31,32,57
Coleraine,6272,2,14,11,1,44,23,21,53
Glenavon,6272,3,9,10,7,53,44,9,37
Linfield,6272,4,10,6,10,38,37,1,36
Cliftonville,6272,5,9,5,12,33,32,1,32
Ballymena,6272,6,7,4,15,26,49,-23,25
Glentoran,6272,7,6,6,10,24,32,-8,24
Dungannon,6272,8,2,4,16,14,47,-33,10
Crusaders,6273,1,16,7,3,63,32,31,55
Coleraine,6273,2,14,10,2,45,25,20,52
Glenavon,6273,3,10,9,7,55,45,10,39
Linfield,6273,4,11,5,10,39,36,3,38
Cliftonville,6273,5,9,4,13,32,33,-1,31
Ballymena,6273,6,7,5,14,27,49,-22,26
Glentoran,6273,7,6,6,10,24,32,-8,24
Dungannon,6273,8,2,4,16,14,47,-33,10
Coleraine,6274,1,15,10,1,47,24,23,55
Crusaders,6274,2,16,6,4,62,32,30,54
Linfield,6274,3,11,5,10,41,36,5,38
Glenavon,6274,4,9,9,8,54,47,7,36
Cliftonville,6274,5,9,4,13,32,35,-3,31
Ballymena,6274,6,8,4,14,27,48,-21,28
Glentoran,6274,7,6,6,10,24,32,-8,24
Dungannon,6274,8,2,4,16,14,47,-33,10
Crusaders,6275,1,17,6,3,64,30,34,57
Coleraine,6275,2,14,10,2,44,24,20,52
Glenavon,6275,3,10,9,7,54,44,10,39
Linfield,6275,4,11,5,10,40,36,4,38
Cliftonville,6275,5,9,4,13,32,34,-2,31
Ballymena,6275,6,7,4,15,25,50,-25,25
Glentoran,6275,7,6,6,10,24,32,-8,24
Dungannon,6275,8,2,4,16,14,47,-33,10
Crusaders,6276,1,16,6,4,61,31,30,54
Coleraine,6276,2,14,10,2,43,25,18,52
Glenavon,6276,3,10,9,7,55,43,12,39
Linfield,6276,4,10,6,10,40,39,1,36
Cliftonville,6276,5,9,5,12,35,34,1,32
Ballymena,6276,6,8,4,14,26,47,-21,28
Glentoran,6276,7,6,6,10,24,32,-8,24
Dungannon,6276,8,2,4,16,14,47,-33,10
Crusaders,6277,1,16,7,3,62,31,31,55
Coleraine,6277,2,15,10,1,45,23,22,55
Glenavon,6277,3,9,9,8,53,45,8,36
Linfield,6277,4,10,5,11,37,37,0,35
Cliftonville,6277,5,10,4,12,33,31,2,34
Ballymena,6277,6,7,5,14,26,48,-22,26
Glentoran,6277,7,6,6,10,24,32,-8,24
Dungannon,6277,8,2,4,16,14,47,-33,10
Crusaders,6278,1,17,6,3,63,31,32,57
Coleraine,6278,2,14,10,2,44,24,20,52
Glenavon,6278,3,10,9,7,54,44,10,39
Linfield,6278,4,10,5,11,37,38,-1,35
Cliftonville,6278,5,10,4,12,34,31,3,34
Ballymena,6278,6,7,4,15,26,49,-23,25
Glentoran,6278,7,6,6,10,24,32,-8,24
Dungannon,6278,8,2,4,16,14,47,-33,10
Crusaders,6279,1,16,7,3,63,32,31,55
Coleraine,6279,2,14,11,1,45,24,21,53
Linfield,6279,3,11,5,10,38,36,2,38
Glenavon,6279,4,9,10,7,54,45,9,37
Cliftonville,6279,5,9,4,13,32,32,0,31
Ballymena,6279,6,7,5,14,27,49,-22,26
Glentoran,6279,7,6,6,10,24,32,-8,24
Dungannon,6279,8,2,4,16,14,47,-33,10
Crusaders,6280,1,16,7,3,62,31,31,55
Coleraine,6280,2,14,10,2,44,26,18,52
Glenavon,6280,3,10,9,7,56,44,12,39
Linfield,6280,4,11,5,10,39,36,3,38
Cliftonville,6280,5,9,4,13,32,33,-1,31
Ballymena,6280,6,7,5,14,26,48,-22,26
Glentoran,6280,7,6,6,10,24,32,-8,24
Dungannon,6280,8,2,4,16,14,47,-33,10
Crusaders,6281,1,16,6,4,62,34,28,54
Coleraine,6281,2,14,10,2,43,26,17,52
Glenavon,6281,3,10,9,7,56,43,13,39
Linfield,6281,4,11,5,10,38,36,2,38
Cliftonville,6281,5,9,4,13,32,32,0,31
Ballymena,6281,6,8,4,14,29,48,-19,28
Glentoran,6281,7,6,6,10,24,32,-8,24
Dungannon,6281,8,2,4,16,14,47,-33,10
Crusaders,6282,1,16,7,3,62,31,31,55
Coleraine,6282,2,15,10,1,46,23,23,55
Linfield,6282,3,11,5,10,38,36,2,38
Glenavon,6282,4,9,9,8,53,46,7,36
Cliftonville,6282,5,9,4,13,32,32,0,31
Ballymena,6282,6,7,5,14,26,48,-22,26
Glentoran,6282,7,6,6,10,24,32,-8,24
Dungannon,6282,8,2,4,16,14,47,-33,10
Crusaders,6283,1,17,6,3,63,31,32,57
Coleraine,6283,2,15,10,1,47,23,24,55
Glenavon,6283,3,9,9,8,53,47,6,36
Linfield,6283,4,10,5,11,37,38,-1,35
Cliftonville,6283,5,10,4,12,34,31,3,34
Ballymena,6283,6,7,4,15,26,49,-23,25
Glentoran,6283,7,6,6,10,24,32,-8,24
Dungannon,6283,8,2,4,16,14,47,-33,10
Crusaders,6284,1,17,6,3,65,31,34,57
Coleraine,6284,2,14,10,2,45,26,19,52
Glenavon,6284,3,10,9,7,56,45,11,39
Linfield,6284,4,11,5,10,40,37,3,38
Cliftonville,6284,5,9,4,13,33,34,-1,31
Ballymena,6284,6,7,4,15,26,51,-25,25
Glentoran,6284,7,6,6,10,24,32,-8,24
Dungannon,6284,8,2,4,16,14,47,-33,10
Crusaders,6285,1,17,6,3,62,30,32,57
Coleraine,6285,2,14,10,2,43,26,17,52
Glenavon,6285,3,10,9,7,56,43,13,39
Linfield,6285,4,11,5,10,40,37,3,38
Cliftonville,6285,5,9,4,13,33,34,-1,31
Ballymena,6285,6,7,4,15,25,48,-23,25
Glentoran,6285,7,6,6,10,24,32,-8,24
Dungannon,6285,8,2,4,16,14,47,-33,10
Crusaders,6286,1,17,6,3,67,32,35,57
Coleraine,6286,2,14,10,2,44,24,20,52
Glenavon,6286,3,10,9,7,54,44,10,39
Linfield,6286,4,11,5,10,40,37,3,38
Cliftonville,6286,5,9,4,13,33,34,-1,31
Ballymena,6286,6,7,4,15,27,53,-26,25
Glentoran,6286,7,6,6,10,24,32,-8,24
Dungannon,6286,8,2,4,16,14,47,-33,10
Crusaders,6287,1,17,6,3,64,31,33,57
Coleraine,6287,2,14,10,2,44,24,20,52
Glenavon,6287,3,10,9,7,54,44,10,39
Linfield,6287,4,10,6,10,37,36,1,36
Cliftonville,6287,5,9,5,12,32,31,1,32
Ballymena,6287,6,7,4,15,26,50,-24,25
Glentoran,6287,7,6,6,10,24,32,-8,24
Dungannon,6287,8,2,4,16,14,47,-33,10
Crusaders,6288,1,17,6,3,62,30,32,57
Coleraine,6288,2,14,10,2,44,26,18,52
Glenavon,6288,3,10,9,7,56,44,12,39
Linfield,6288,4,10,6,10,38,37,1,36
Cliftonville,6288,5,9,5,12,33,32,1,32
Ballymena,6288,6,7,4,15,25,48,-23,25
Glentoran,6288,7,6,6,10,24,32,-8,24
Dungannon,6288,8,2,4,16,14,47,-33,10
Coleraine,6289,1,15,10,1,47,24,23,55
Crusaders,6289,2,16,6,4,61,32,29,54
Glenavon,6289,3,9,9,8,54,47,7,36
Linfield,6289,4,10,5,11,38,38,0,35
Cliftonville,6289,5,10,4,12,34,32,2,34
Ballymena,6289,6,8,4,14,27,47,-20,28
Glentoran,6289,7,6,6,10,24,32,-8,24
Dungannon,6289,8,2,4,16,14,47,-33,10
Crusaders,6290,1,17,6,3,62,30,32,57
Coleraine,6290,2,15,10,1,47,25,22,55
Glenavon,6290,3,9,9,8,55,47,8,36
Linfield,6290,4,10,6,10,38,37,1,36
Cliftonville,6290,5,9,5,12,33,32,1,32
Ballymena,6290,6,7,4,15,25,48,-23,25
Glentoran,6290,7,6,6,10,24,32,-8,24
Dungannon,6290,8,2,4,16,14,47,-33,10
Crusaders,6291,1,16,6,4,61,32,29,54
Coleraine,6291,2,14,10,2,43,26,17,52
Glenavon,6291,3,10,9,7,56,43,13,39
Linfield,6291,4,11,5,10,39,36,3,38
Cliftonville,6291,5,9,4,13,32,33,-1,31
Ballymena,6291,6,8,4,14,27,47,-20,28
Glentoran,6291,7,6,6,10,24,32,-8,24
Dungannon,6291,8,2,4,16,14,47,-33,10
Crusaders,6292,1,17,6,3,63,31,32,57
Coleraine,6292,2,14,10,2,46,26,20,52
Glenavon,6292,3,10,9,7,56,46,10,39
Linfield,6292,4,11,5,10,41,36,5,38
Cliftonville,6292,5,9,4,13,32,35,-3,31
Ballymena,6292,6,7,4,15,26,49,-23,25
Glentoran,6292,7,6,6,10,24,32,-8,24
Dungannon,6292,8,2,4,16,14,47,-33,10
Crusaders,6293,1,17,6,3,65,32,33,57
Coleraine,6293,2,14,11,1,45,24,21,53
Linfield,6293,3,11,5,10,40,37,3,38
Glenavon,6293,4,9,10,7,54,45,9,37
Cliftonville,6293,5,9,4,13,33,34,-1,31
Ballymena,6293,6,7,4,15,27,51,-24,25
Glentoran,6293,7,6,6,10,24,32,-8,24
Dungannon,6293,8,2,4,16,14,47,-33,10
Crusaders,6294,1,17,6,3,67,30,37,57
Coleraine,6294,2,15,10,1,45,23,22,55
Linfield,6294,3,11,5,10,38,36,2,38
Glenavon,6294,4,9,9,8,53,45,8,36
Cliftonville,6294,5,9,4,13,32,32,0,31
Ballymena,6294,6,7,4,15,25,53,-28,25
Glentoran,6294,7,6,6,10,24,32,-8,24
Dungannon,6294,8,2,4,16,14,47,-33,10
Crusaders,6295,1,16,7,3,62,31,31,55
Coleraine,6295,2,14,10,2,44,26,18,52
Glenavon,6295,3,10,9,7,56,44,12,39
Linfield,6295,4,11,5,10,40,38,2,38
Cliftonville,6295,5,9,4,13,34,34,0,31
Ballymena,6295,6,7,5,14,26,48,-22,26
Glentoran,6295,7,6,6,10,24,32,-8,24
Dungannon,6295,8,2,4,16,14,47,-33,10
Crusaders,6296,1,17,6,3,63,31,32,57
Coleraine,6296,2,14,11,1,44,23,21,53
Linfield,6296,3,11,5,10,39,36,3,38
Glenavon,6296,4,9,10,7,53,44,9,37
Cliftonville,6296,5,9,4,13,32,33,-1,31
Ballymena,6296,6,7,4,15,26,49,-23,25
Glentoran,6296,7,6,6,10,24,32,-8,24
Dungannon,6296,8,2,4,16,14,47,-33,10
Coleraine,6297,1,15,10,1,44,22,22,55
Crusaders,6297,2,16,6,4,61,32,29,54
Linfield,6297,3,11,5,10,40,36,4,38
Glenavon,6297,4,9,9,8,52,44,8,36
Cliftonville,6297,5,9,4,13,32,34,-2,31
Ballymena,6297,6,8,4,14,27,47,-20,28
Glentoran,6297,7,6,6,10,24,32,-8,24
Dungannon,6297,8,2,4,16,14,47,-33,10
Crusaders,6298,1,16,7,3,62,31,31,55
Coleraine,6298,2,14,10,2,44,27,17,52
Glenavon,6298,3,10,9,7,57,44,13,39
Linfield,6298,4,10,5,11,37,39,-2,35
Cliftonville,6298,5,10,4,12,35,31,4,34
Ballymena,6298,6,7,5,14,26,48,-22,26
Glentoran,6298,7,6,6,10,24,32,-8,24
Dungannon,6298,8,2,4,16,14,47,-33,10
Coleraine,6299,1,15,10,1,45,23,22,55
Crusaders,6299,2,16,6,4,62,32,30,54
Linfield,6299,3,11,5,10,40,36,4,38
Glenavon,6299,4,9,9,8,53,45,8,36
Cliftonville,6299,5,9,4,13,32,34,-2,31
Ballymena,6299,6,8,4,14,27,48,-21,28
Glentoran,6299,7,6,6,10,24,32,-8,24
Dungannon,6299,8,2,4,16,14,47,-33,10
Crusaders,6300,1,17,6,3,64,30,34,57
Coleraine,6300,2,14,11,1,45,24,21,53
Linfield,6300,3,11,5,10,39,37,2,38
Glenavon,6300,4,9,10,7,54,45,9,37
Cliftonville,6300,5,9,4,13,33,33,0,31
Ballymena,6300,6,7,4,15,25,50,-25,25
Glentoran,6300,7,6,6,10,24,32,-8,24
Dungannon,6300,8,2,4,16,14,47,-33,10
Coleraine,6301,1,15,10,1,45,23,22,55
Crusaders,6301,2,16,6,4,61,31,30,54
Linfield,6301,3,11,5,10,39,36,3,38
Glenavon,6301,4,9,9,8,53,45,8,36
Cliftonville,6301,5,9,4,13,32,33,-1,31
Ballymena,6301,6,8,4,14,26,47,-21,28
Glentoran,6301,7,6,6,10,24,32,-8,24
Dungannon,6301,8,2,4,16,14,47,-33,10
Crusaders,6302,1,17,6,3,62,30,32,57
Coleraine,6302,2,14,11,1,45,24,21,53
Linfield,6302,3,11,5,10,39,36,3,38
Glenavon,6302,4,9,10,7,54,45,9,37
Cliftonville,6302,5,9,4,13,32,33,-1,31
Ballymena,6302,6,7,4,15,25,48,-23,25
Glentoran,6302,7,6,6,10,24,32,-8,24
Dungannon,6302,8,2,4,16,14,47,-33,10
Crusaders,6303,1,17,6,3,63,31,32,57
Coleraine,6303,2,15,10,1,45,23,22,55
Linfield,6303,3,11,5,10,38,36,2,38
Glenavon,6303,4,9,9,8,53,45,8,36
Cliftonville,6303,5,9,4,13,32,32,0,31
Ballymena,6303,6,7,4,15,26,49,-23,25
Glentoran,6303,7,6,6,10,24,32,-8,24
Dungannon,6303,8,2,4,16,14,47,-33,10
Crusaders,6304,1,17,6,3,63,31,32,57
Coleraine,6304,2,14,11,1,45,24,21,53
Linfield,6304,3,11,5,10,39,36,3,38
Glenavon,6304,4,9,10,7,54,45,9,37
Cliftonville,6304,5,9,4,13,32,33,-1,31
Ballymena,6304,6,7,4,15,26,49,-23,25
Glentoran,6304,7,6,6,10,24,32,-8,24
Dungannon,6304,8,2,4,16,14,47,-33,10
Crusaders,6305,1,16,6,4,62,32,30,54
Coleraine,6305,2,14,10,2,44,24,20,52
Glenavon,6305,3,10,9,7,54,44,10,39
Linfield,6305,4,10,5,11,38,40,-2,35
Cliftonville,6305,5,10,4,12,36,32,4,34
Ballymena,6305,6,8,4,14,27,48,-21,28
Glentoran,6305,7,6,6,10,24,32,-8,24
Dungannon,6305,8,2,4,16,14,47,-33,10
Crusaders,6306,1,17,6,3,63,31,32,57
Coleraine,6306,2,14,11,1,44,23,21,53
Glenavon,6306,3,9,10,7,53,44,9,37
Linfield,6306,4,10,5,11,38,38,0,35
Cliftonville,6306,5,10,4,12,34,32,2,34
Ballymena,6306,6,7,4,15,26,49,-23,25
Glentoran,6306,7,6,6,10,24,32,-8,24
Dungannon,6306,8,2,4,16,14,47,-33,10
Crusaders,6307,1,16,7,3,63,32,31,55
Coleraine,6307,2,15,10,1,45,23,22,55
Glenavon,6307,3,9,9,8,53,45,8,36
Linfield,6307,4,10,6,10,38,37,1,36
Cliftonville,6307,5,9,5,12,33,32,1,32
Ballymena,6307,6,7,5,14,27,49,-22,26
Glentoran,6307,7,6,6,10,24,32,-8,24
Dungannon,6307,8,2,4,16,14,47,-33,10
Crusaders,6308,1,16,7,3,62,31,31,55
Coleraine,6308,2,14,10,2,45,26,19,52
Glenavon,6308,3,10,9,7,56,45,11,39
Linfield,6308,4,10,5,11,38,38,0,35
Cliftonville,6308,5,10,4,12,34,32,2,34
Ballymena,6308,6,7,5,14,26,48,-22,26
Glentoran,6308,7,6,6,10,24,32,-8,24
Dungannon,6308,8,2,4,16,14,47,-33,10
Crusaders,6309,1,17,6,3,64,32,32,57
Coleraine,6309,2,15,10,1,46,24,22,55
Linfield,6309,3,11,5,10,39,37,2,38
Glenavon,6309,4,9,9,8,54,46,8,36
Cliftonville,6309,5,9,4,13,33,33,0,31
Ballymena,6309,6,7,4,15,27,50,-23,25
Glentoran,6309,7,6,6,10,24,32,-8,24
Dungannon,6309,8,2,4,16,14,47,-33,10
Crusaders,6310,1,16,6,4,61,31,30,54
Coleraine,6310,2,14,10,2,43,26,17,52
Glenavon,6310,3,10,9,7,56,43,13,39
Linfield,6310,4,11,5,10,39,36,3,38
Cliftonville,6310,5,9,4,13,32,33,-1,31
Ballymena,6310,6,8,4,14,26,47,-21,28
Glentoran,6310,7,6,6,10,24,32,-8,24
Dungannon,6310,8,2,4,16,14,47,-33,10
Crusaders,6311,1,17,6,3,63,30,33,57
Coleraine,6311,2,14,11,1,44,23,21,53
Glenavon,6311,3,9,10,7,53,44,9,37
Linfield,6311,4,10,6,10,38,37,1,36
Cliftonville,6311,5,9,5,12,33,32,1,32
Ballymena,6311,6,7,4,15,25,49,-24,25
Glentoran,6311,7,6,6,10,24,32,-8,24
Dungannon,6311,8,2,4,16,14,47,-33,10
Crusaders,6312,1,16,6,4,62,32,30,54
Coleraine,6312,2,14,10,2,43,23,20,52
Glenavon,6312,3,10,9,7,53,43,10,39
Linfield,6312,4,11,5,10,39,37,2,38
Cliftonville,6312,5,9,4,13,33,33,0,31
Ballymena,6312,6,8,4,14,27,48,-21,28
Glentoran,6312,7,6,6,10,24,32,-8,24
Dungannon,6312,8,2,4,16,14,47,-33,10
Crusaders,6313,1,17,6,3,64,31,33,57
Coleraine,6313,2,14,11,1,43,22,21,53
Glenavon,6313,3,9,10,7,52,43,9,37
Linfield,6313,4,10,6,10,38,37,1,36
Cliftonville,6313,5,9,5,12,33,32,1,32
Ballymena,6313,6,7,4,15,26,50,-24,25
Glentoran,6313,7,6,6,10,24,32,-8,24
Dungannon,6313,8,2,4,16,14,47,-33,10
Crusaders,6314,1,17,6,3,66,33,33,57
Coleraine,6314,2,14,11,1,44,23,21,53
Glenavon,6314,3,9,10,7,53,44,9,37
Linfield,6314,4,10,6,10,37,36,1,36
Cliftonville,6314,5,9,5,12,32,31,1,32
Ballymena,6314,6,7,4,15,28,52,-24,25
Glentoran,6314,7,6,6,10,24,32,-8,24
Dungannon,6314,8,2,4,16,14,47,-33,10
Crusaders,6315,1,16,7,3,62,31,31,55
Coleraine,6315,2,14,10,2,45,25,20,52
Glenavon,6315,3,10,9,7,55,45,10,39
Linfield,6315,4,10,6,10,38,37,1,36
Cliftonville,6315,5,9,5,12,33,32,1,32
Ballymena,6315,6,7,5,14,26,48,-22,26
Glentoran,6315,7,6,6,10,24,32,-8,24
Dungannon,6315,8,2,4,16,14,47,-33,10
Crusaders,6316,1,16,7,3,62,31,31,55
Coleraine,6316,2,15,10,1,45,23,22,55
Glenavon,6316,3,9,9,8,53,45,8,36
Linfield,6316,4,10,5,11,38,38,0,35
Cliftonville,6316,5,10,4,12,34,32,2,34
Ballymena,6316,6,7,5,14,26,48,-22,26
Glentoran,6316,7,6,6,10,24,32,-8,24
Dungannon,6316,8,2,4,16,14,47,-33,10
Crusaders,6317,1,17,6,3,64,30,34,57
Coleraine,6317,2,15,10,1,47,22,25,55
Glenavon,6317,3,9,9,8,52,47,5,36
Linfield,6317,4,10,5,11,38,38,0,35
Cliftonville,6317,5,10,4,12,34,32,2,34
Ballymena,6317,6,7,4,15,25,50,-25,25
Glentoran,6317,7,6,6,10,24,32,-8,24
Dungannon,6317,8,2,4,16,14,47,-33,10
Crusaders,6318,1,17,6,3,64,30,34,57
Coleraine,6318,2,14,10,2,46,26,20,52
Glenavon,6318,3,10,9,7,56,46,10,39
Linfield,6318,4,11,5,10,38,36,2,38
Cliftonville,6318,5,9,4,13,32,32,0,31
Ballymena,6318,6,7,4,15,25,50,-25,25
Glentoran,6318,7,6,6,10,24,32,-8,24
Dungannon,6318,8,2,4,16,14,47,-33,10
Coleraine,6319,1,15,10,1,45,23,22,55
Crusaders,6319,2,16,6,4,62,36,26,54
Glenavon,6319,3,9,9,8,53,45,8,36
Linfield,6319,4,10,6,10,37,36,1,36
Cliftonville,6319,5,9,5,12,32,31,1,32
Ballymena,6319,6,8,4,14,31,48,-17,28
Glentoran,6319,7,6,6,10,24,32,-8,24
Dungannon,6319,8,2,4,16,14,47,-33,10
Crusaders,6320,1,16,7,3,63,32,31,55
Coleraine,6320,2,15,10,1,47,22,25,55
Glenavon,6320,3,9,9,8,52,47,5,36
Linfield,6320,4,10,5,11,37,37,0,35
Cliftonville,6320,5,10,4,12,33,31,2,34
Ballymena,6320,6,7,5,14,27,49,-22,26
Glentoran,6320,7,6,6,10,24,32,-8,24
Dungannon,6320,8,2,4,16,14,47,-33,10
Crusaders,6321,1,16,6,4,62,32,30,54
Coleraine,6321,2,14,10,2,44,25,19,52
Glenavon,6321,3,10,9,7,55,44,11,39
Linfield,6321,4,11,5,10,39,36,3,38
Cliftonville,6321,5,9,4,13,32,33,-1,31
Ballymena,6321,6,8,4,14,27,48,-21,28
Glentoran,6321,7,6,6,10,24,32,-8,24
Dungannon,6321,8,2,4,16,14,47,-33,10
Crusaders,6322,1,17,6,3,65,33,32,57
Coleraine,6322,2,15,10,1,45,22,23,55
Glenavon,6322,3,9,9,8,52,45,7,36
Linfield,6322,4,10,6,10,38,37,1,36
Cliftonville,6322,5,9,5,12,33,32,1,32
Ballymena,6322,6,7,4,15,28,51,-23,25
Glentoran,6322,7,6,6,10,24,32,-8,24
Dungannon,6322,8,2,4,16,14,47,-33,10
Crusaders,6323,1,17,6,3,65,31,34,57
Coleraine,6323,2,14,10,2,44,25,19,52
Glenavon,6323,3,10,9,7,55,44,11,39
Linfield,6323,4,11,5,10,39,36,3,38
Cliftonville,6323,5,9,4,13,32,33,-1,31
Ballymena,6323,6,7,4,15,26,51,-25,25
Glentoran,6323,7,6,6,10,24,32,-8,24
Dungannon,6323,8,2,4,16,14,47,-33,10
Crusaders,6324,1,16,6,4,61,31,30,54
Coleraine,6324,2,14,11,1,43,22,21,53
Glenavon,6324,3,9,10,7,52,43,9,37
Linfield,6324,4,10,5,11,37,38,-1,35
Cliftonville,6324,5,10,4,12,34,31,3,34
Ballymena,6324,6,8,4,14,26,47,-21,28
Glentoran,6324,7,6,6,10,24,32,-8,24
Dungannon,6324,8,2,4,16,14,47,-33,10
Crusaders,6325,1,16,7,3,62,31,31,55
Coleraine,6325,2,15,10,1,45,23,22,55
Glenavon,6325,3,9,9,8,53,45,8,36
Linfield,6325,4,10,5,11,37,38,-1,35
Cliftonville,6325,5,10,4,12,34,31,3,34
Ballymena,6325,6,7,5,14,26,48,-22,26
Glentoran,6325,7,6,6,10,24,32,-8,24
Dungannon,6325,8,2,4,16,14,47,-33,10
Crusaders,6326,1,16,7,3,62,31,31,55
Coleraine,6326,2,14,11,1,43,22,21,53
Glenavon,6326,3,9,10,7,52,43,9,37
Linfield,6326,4,10,5,11,38,39,-1,35
Cliftonville,6326,5,10,4,12,35,32,3,34
Ballymena,6326,6,7,5,14,26,48,-22,26
Glentoran,6326,7,6,6,10,24,32,-8,24
Dungannon,6326,8,2,4,16,14,47,-33,10
Crusaders,6327,1,16,7,3,62,31,31,55
Coleraine,6327,2,15,10,1,46,23,23,55
Glenavon,6327,3,9,9,8,53,46,7,36
Linfield,6327,4,10,6,10,38,37,1,36
Cliftonville,6327,5,9,5,12,33,32,1,32
Ballymena,6327,6,7,5,14,26,48,-22,26
Glentoran,6327,7,6,6,10,24,32,-8,24
Dungannon,6327,8,2,4,16,14,47,-33,10
Crusaders,6328,1,16,6,4,61,35,26,54
Coleraine,6328,2,14,10,2,44,25,19,52
Glenavon,6328,3,10,9,7,55,44,11,39
Linfield,6328,4,11,5,10,39,36,3,38
Cliftonville,6328,5,9,4,13,32,33,-1,31
Ballymena,6328,6,8,4,14,30,47,-17,28
Glentoran,6328,7,6,6,10,24,32,-8,24
Dungannon,6328,8,2,4,16,14,47,-33,10
Crusaders,6329,1,17,6,3,62,30,32,57
Coleraine,6329,2,15,10,1,45,23,22,55
Glenavon,6329,3,9,9,8,53,45,8,36
Linfield,6329,4,10,6,10,38,37,1,36
Cliftonville,6329,5,9,5,12,33,32,1,32
Ballymena,6329,6,7,4,15,25,48,-23,25
Glentoran,6329,7,6,6,10,24,32,-8,24
Dungannon,6329,8,2,4,16,14,47,-33,10
Crusaders,6330,1,16,7,3,62,31,31,55
Coleraine,6330,2,14,10,2,44,25,19,52
Glenavon,6330,3,10,9,7,55,44,11,39
Linfield,6330,4,11,5,10,38,36,2,38
Cliftonville,6330,5,9,4,13,32,32,0,31
Ballymena,6330,6,7,5,14,26,48,-22,26
Glentoran,6330,7,6,6,10,24,32,-8,24
Dungannon,6330,8,2,4,16,14,47,-33,10
Crusaders,6331,1,17,6,3,63,30,33,57
Coleraine,6331,2,15,10,1,47,24,23,55
Linfield,6331,3,11,5,10,40,36,4,38
Glenavon,6331,4,9,9,8,54,47,7,36
Cliftonville,6331,5,9,4,13,32,34,-2,31
Ballymena,6331,6,7,4,15,25,49,-24,25
Glentoran,6331,7,6,6,10,24,32,-8,24
Dungannon,6331,8,2,4,16,14,47,-33,10
Crusaders,6332,1,16,7,3,63,32,31,55
Coleraine,6332,2,15,10,1,44,22,22,55
Glenavon,6332,3,9,9,8,52,44,8,36
Linfield,6332,4,10,6,10,38,37,1,36
Cliftonville,6332,5,9,5,12,33,32,1,32
Ballymena,6332,6,7,5,14,27,49,-22,26
Glentoran,6332,7,6,6,10,24,32,-8,24
Dungannon,6332,8,2,4,16,14,47,-33,10
Crusaders,6333,1,17,6,3,64,32,32,57
Coleraine,6333,2,14,11,1,43,22,21,53
Glenavon,6333,3,9,10,7,52,43,9,37
Linfield,6333,4,10,5,11,38,38,0,35
Cliftonville,6333,5,10,4,12,34,32,2,34
Ballymena,6333,6,7,4,15,27,50,-23,25
Glentoran,6333,7,6,6,10,24,32,-8,24
Dungannon,6333,8,2,4,16,14,47,-33,10
Crusaders,6334,1,16,6,4,62,32,30,54
Coleraine,6334,2,14,11,1,44,23,21,53
Glenavon,6334,3,9,10,7,53,44,9,37
Linfield,6334,4,10,6,10,37,36,1,36
Cliftonville,6334,5,9,5,12,32,31,1,32
Ballymena,6334,6,8,4,14,27,48,-21,28
Glentoran,6334,7,6,6,10,24,32,-8,24
Dungannon,6334,8,2,4,16,14,47,-33,10
Crusaders,6335,1,17,6,3,67,32,35,57
Coleraine,6335,2,14,11,1,43,22,21,53
Glenavon,6335,3,9,10,7,52,43,9,37
Linfield,6335,4,10,6,10,38,37,1,36
Cliftonville,6335,5,9,5,12,33,32,1,32
Ballymena,6335,6,7,4,15,27,53,-26,25
Glentoran,6335,7,6,6,10,24,32,-8,24
Dungannon,6335,8,2,4,16,14,47,-33,10
Crusaders,6336,1,16,6,4,61,32,29,54
Coleraine,6336,2,14,11,1,44,23,21,53
Glenavon,6336,3,9,10,7,53,44,9,37
Linfield,6336,4,10,5,11,37,38,-1,35
Cliftonville,6336,5,10,4,12,34,31,3,34
Ballymena,6336,6,8,4,14,27,47,-20,28
Glentoran,6336,7,6,6,10,24,32,-8,24
Dungannon,6336,8,2,4,16,14,47,-33,10
Crusaders,6337,1,16,7,3,62,31,31,55
Coleraine,6337,2,15,10,1,45,23,22,55
Glenavon,6337,3,9,9,8,53,45,8,36
Linfield,6337,4,10,5,11,37,40,-3,35
Cliftonville,6337,5,10,4,12,36,31,5,34
Ballymena,6337,6,7,5,14,26,48,-22,26
Glentoran,6337,7,6,6,10,24,32,-8,24
Dungannon,6337,8,2,4,16,14,47,-33,10
Crusaders,6338,1,16,7,3,62,31,31,55
Coleraine,6338,2,15,10,1,47,23,24,55
Linfield,6338,3,11,5,10,38,36,2,38
Glenavon,6338,4,9,9,8,53,47,6,36
Cliftonville,6338,5,9,4,13,32,32,0,31
Ballymena,6338,6,7,5,14,26,48,-22,26
Glentoran,6338,7,6,6,10,24,32,-8,24
Dungannon,6338,8,2,4,16,14,47,-33,10
Crusaders,6339,1,16,7,3,62,31,31,55
Coleraine,6339,2,15,10,1,46,23,23,55
Glenavon,6339,3,9,9,8,53,46,7,36
Linfield,6339,4,10,6,10,41,40,1,36
Cliftonville,6339,5,9,5,12,36,35,1,32
Ballymena,6339,6,7,5,14,26,48,-22,26
Glentoran,6339,7,6,6,10,24,32,-8,24
Dungannon,6339,8,2,4,16,14,47,-33,10
Crusaders,6340,1,17,6,3,64,31,33,57
Coleraine,6340,2,15,10,1,46,24,22,55
Glenavon,6340,3,9,9,8,54,46,8,36
Linfield,6340,4,10,6,10,37,36,1,36
Cliftonville,6340,5,9,5,12,32,31,1,32
Ballymena,6340,6,7,4,15,26,50,-24,25
Glentoran,6340,7,6,6,10,24,32,-8,24
Dungannon,6340,8,2,4,16,14,47,-33,10
Crusaders,6341,1,17,6,3,62,30,32,57
Coleraine,6341,2,14,11,1,44,23,21,53
Linfield,6341,3,11,5,10,41,36,5,38
Glenavon,6341,4,9,10,7,53,44,9,37
Cliftonville,6341,5,9,4,13,32,35,-3,31
Ballymena,6341,6,7,4,15,25,48,-23,25
Glentoran,6341,7,6,6,10,24,32,-8,24
Dungannon,6341,8,2,4,16,14,47,-33,10
Crusaders,6342,1,17,6,3,66,31,35,57
Coleraine,6342,2,15,10,1,45,23,22,55
Linfield,6342,3,11,5,10,41,39,2,38
Glenavon,6342,4,9,9,8,53,45,8,36
Cliftonville,6342,5,9,4,13,35,35,0,31
Ballymena,6342,6,7,4,15,26,52,-26,25
Glentoran,6342,7,6,6,10,24,32,-8,24
Dungannon,6342,8,2,4,16,14,47,-33,10
Crusaders,6343,1,16,7,3,63,32,31,55
Coleraine,6343,2,14,11,1,45,24,21,53
Linfield,6343,3,11,5,10,39,36,3,38
Glenavon,6343,4,9,10,7,54,45,9,37
Cliftonville,6343,5,9,4,13,32,33,-1,31
Ballymena,6343,6,7,5,14,27,49,-22,26
Glentoran,6343,7,6,6,10,24,32,-8,24
Dungannon,6343,8,2,4,16,14,47,-33,10
Crusaders,6344,1,17,6,3,64,30,34,57
Coleraine,6344,2,14,10,2,43,23,20,52
Glenavon,6344,3,10,9,7,53,43,10,39
Linfield,6344,4,10,6,10,38,37,1,36
Cliftonville,6344,5,9,5,12,33,32,1,32
Ballymena,6344,6,7,4,15,25,50,-25,25
Glentoran,6344,7,6,6,10,24,32,-8,24
Dungannon,6344,8,2,4,16,14,47,-33,10
Crusaders,6345,1,17,6,3,65,30,35,57
Coleraine,6345,2,14,11,1,45,24,21,53
Linfield,6345,3,11,5,10,39,37,2,38
Glenavon,6345,4,9,10,7,54,45,9,37
Cliftonville,6345,5,9,4,13,33,33,0,31
Ballymena,6345,6,7,4,15,25,51,-26,25
Glentoran,6345,7,6,6,10,24,32,-8,24
Dungannon,6345,8,2,4,16,14,47,-33,10
Crusaders,6346,1,16,6,4,61,31,30,54
Coleraine,6346,2,14,10,2,43,27,16,52
Glenavon,6346,3,10,9,7,57,43,14,39
Linfield,6346,4,10,5,11,38,38,0,35
Cliftonville,6346,5,10,4,12,34,32,2,34
Ballymena,6346,6,8,4,14,26,47,-21,28
Glentoran,6346,7,6,6,10,24,32,-8,24
Dungannon,6346,8,2,4,16,14,47,-33,10
Coleraine,6347,1,15,10,1,46,23,23,55
Crusaders,6347,2,16,6,4,61,33,28,54
Glenavon,6347,3,9,9,8,53,46,7,36
Linfield,6347,4,10,6,10,38,37,1,36
Cliftonville,6347,5,9,5,12,33,32,1,32
Ballymena,6347,6,8,4,14,28,47,-19,28
Glentoran,6347,7,6,6,10,24,32,-8,24
Dungannon,6347,8,2,4,16,14,47,-33,10
Crusaders,6348,1,17,6,3,64,31,33,57
Coleraine,6348,2,14,10,2,45,26,19,52
Glenavon,6348,3,10,9,7,56,45,11,39
Linfield,6348,4,10,6,10,38,37,1,36
Cliftonville,6348,5,9,5,12,33,32,1,32
Ballymena,6348,6,7,4,15,26,50,-24,25
Glentoran,6348,7,6,6,10,24,32,-8,24
Dungannon,6348,8,2,4,16,14,47,-33,10
Crusaders,6349,1,17,6,3,65,32,33,57
Coleraine,6349,2,14,10,2,43,23,20,52
Glenavon,6349,3,10,9,7,53,43,10,39
Linfield,6349,4,11,5,10,38,36,2,38
Cliftonville,6349,5,9,4,13,32,32,0,31
Ballymena,6349,6,7,4,15,27,51,-24,25
Glentoran,6349,7,6,6,10,24,32,-8,24
Dungannon,6349,8,2,4,16,14,47,-33,10
Crusaders,6350,1,17,6,3,63,30,33,57
Coleraine,6350,2,15,10,1,44,22,22,55
Linfield,6350,3,11,5,10,39,37,2,38
Glenavon,6350,4,9,9,8,52,44,8,36
Cliftonville,6350,5,9,4,13,33,33,0,31
Ballymena,6350,6,7,4,15,25,49,-24,25
Glentoran,6350,7,6,6,10,24,32,-8,24
Dungannon,6350,8,2,4,16,14,47,-33,10
Coleraine,6351,1,15,10,1,46,22,24,55
Crusaders,6351,2,16,6,4,61,33,28,54
Glenavon,6351,3,9,9,8,52,46,6,36
Linfield,6351,4,10,5,11,37,39,-2,35
Cliftonville,6351,5,10,4,12,35,31,4,34
Ballymena,6351,6,8,4,14,28,47,-19,28
Glentoran,6351,7,6,6,10,24,32,-8,24
Dungannon,6351,8,2,4,16,14,47,-33,10
Crusaders,6352,1,17,6,3,63,31,32,57
Coleraine,6352,2,15,10,1,45,23,22,55
Linfield,6352,3,11,5,10,38,36,2,38
Glenavon,6352,4,9,9,8,53,45,8,36
Cliftonville,6352,5,9,4,13,32,32,0,31
Ballymena,6352,6,7,4,15,26,49,-23,25
Glentoran,6352,7,6,6,10,24,32,-8,24
Dungannon,6352,8,2,4,16,14,47,-33,10
Crusaders,6353,1,16,7,3,62,31,31,55
Coleraine,6353,2,14,10,2,43,23,20,52
Glenavon,6353,3,10,9,7,53,43,10,39
Linfield,6353,4,10,6,10,38,37,1,36
Cliftonville,6353,5,9,5,12,33,32,1,32
Ballymena,6353,6,7,5,14,26,48,-22,26
Glentoran,6353,7,6,6,10,24,32,-8,24
Dungannon,6353,8,2,4,16,14,47,-33,10
Crusaders,6354,1,17,6,3,68,32,36,57
Coleraine,6354,2,15,10,1,45,23,22,55
Glenavon,6354,3,9,9,8,53,45,8,36
Linfield,6354,4,10,5,11,37,37,0,35
Cliftonville,6354,5,10,4,12,33,31,2,34
Ballymena,6354,6,7,4,15,27,54,-27,25
Glentoran,6354,7,6,6,10,24,32,-8,24
Dungannon,6354,8,2,4,16,14,47,-33,10
Crusaders,6355,1,17,6,3,63,31,32,57
Coleraine,6355,2,14,11,1,44,23,21,53
Linfield,6355,3,11,5,10,38,36,2,38
Glenavon,6355,4,9,10,7,53,44,9,37
Cliftonville,6355,5,9,4,13,32,32,0,31
Ballymena,6355,6,7,4,15,26,49,-23,25
Glentoran,6355,7,6,6,10,24,32,-8,24
Dungannon,6355,8,2,4,16,14,47,-33,10
Crusaders,6356,1,17,6,3,64,31,33,57
Coleraine,6356,2,14,11,1,45,24,21,53
Glenavon,6356,3,9,10,7,54,45,9,37
Linfield,6356,4,10,5,11,38,38,0,35
Cliftonville,6356,5,10,4,12,34,32,2,34
Ballymena,6356,6,7,4,15,26,50,-24,25
Glentoran,6356,7,6,6,10,24,32,-8,24
Dungannon,6356,8,2,4,16,14,47,-33,10
Crusaders,6357,1,16,6,4,61,31,30,54
Coleraine,6357,2,14,10,2,43,23,20,52
Glenavon,6357,3,10,9,7,53,43,10,39
Linfield,6357,4,10,6,10,38,37,1,36
Cliftonville,6357,5,9,5,12,33,32,1,32
Ballymena,6357,6,8,4,14,26,47,-21,28
Glentoran,6357,7,6,6,10,24,32,-8,24
Dungannon,6357,8,2,4,16,14,47,-33,10
Coleraine,6358,1,15,10,1,45,23,22,55
Crusaders,6358,2,16,6,4,61,32,29,54
Linfield,6358,3,11,5,10,39,36,3,38
Glenavon,6358,4,9,9,8,53,45,8,36
Cliftonville,6358,5,9,4,13,32,33,-1,31
Ballymena,6358,6,8,4,14,27,47,-20,28
Glentoran,6358,7,6,6,10,24,32,-8,24
Dungannon,6358,8,2,4,16,14,47,-33,10
Crusaders,6359,1,16,7,3,63,32,31,55
Coleraine,6359,2,15,10,1,46,24,22,55
Glenavon,6359,3,9,9,8,54,46,8,36
Linfield,6359,4,10,5,11,38,40,-2,35
Cliftonville,6359,5,10,4,12,36,32,4,34
Ballymena,6359,6,7,5,14,27,49,-22,26
Glentoran,6359,7,6,6,10,24,32,-8,24
Dungannon,6359,8,2,4,16,14,47,-33,10
Crusaders,6360,1,17,6,3,64,32,32,57
Coleraine,6360,2,14,10,2,44,26,18,52
Glenavon,6360,3,10,9,7,56,44,12,39
Linfield,6360,4,10,6,10,38,37,1,36
Cliftonville,6360,5,9,5,12,33,32,1,32
Ballymena,6360,6,7,4,15,27,50,-23,25
Glentoran,6360,7,6,6,10,24,32,-8,24
Dungannon,6360,8,2,4,16,14,47,-33,10
Crusaders,6361,1,17,6,3,65,32,33,57
Coleraine,6361,2,14,10,2,43,23,20,52
Glenavon,6361,3,10,9,7,53,43,10,39
Linfield,6361,4,10,6,10,38,37,1,36
Cliftonville,6361,5,9,5,12,33,32,1,32
Ballymena,6361,6,7,4,15,27,51,-24,25
Glentoran,6361,7,6,6,10,24,32,-8,24
Dungannon,6361,8,2,4,16,14,47,-33,10
Crusaders,6362,1,16,7,3,62,31,31,55
Coleraine,6362,2,14,10,2,45,25,20,52
Glenavon,6362,3,10,9,7,55,45,10,39
Linfield,6362,4,11,5,10,39,37,2,38
Cliftonville,6362,5,9,4,13,33,33,0,31
Ballymena,6362,6,7,5,14,26,48,-22,26
Glentoran,6362,7,6,6,10,24,32,-8,24
Dungannon,6362,8,2,4,16,14,47,-33,10
Crusaders,6363,1,17,6,3,62,30,32,57
Coleraine,6363,2,14,10,2,44,25,19,52
Glenavon,6363,3,10,9,7,55,44,11,39
Linfield,6363,4,10,6,10,39,38,1,36
Cliftonville,6363,5,9,5,12,34,33,1,32
Ballymena,6363,6,7,4,15,25,48,-23,25
Glentoran,6363,7,6,6,10,24,32,-8,24
Dungannon,6363,8,2,4,16,14,47,-33,10
Crusaders,6364,1,16,7,3,61,30,31,55
Coleraine,6364,2,14,11,1,44,23,21,53
Glenavon,6364,3,9,10,7,53,44,9,37
Linfield,6364,4,10,5,11,38,38,0,35
Cliftonville,6364,5,10,4,12,34,32,2,34
Ballymena,6364,6,7,5,14,25,47,-22,26
Glentoran,6364,7,6,6,10,24,32,-8,24
Dungannon,6364,8,2,4,16,14,47,-33,10
Coleraine,6365,1,15,10,1,44,22,22,55
Crusaders,6365,2,16,6,4,62,32,30,54
Glenavon,6365,3,9,9,8,52,44,8,36
Linfield,6365,4,10,6,10,37,36,1,36
Cliftonville,6365,5,9,5,12,32,31,1,32
Ballymena,6365,6,8,4,14,27,48,-21,28
Glentoran,6365,7,6,6,10,24,32,-8,24
Dungannon,6365,8,2,4,16,14,47,-33,10
Crusaders,6366,1,17,6,3,63,31,32,57
Coleraine,6366,2,14,11,1,44,23,21,53
Linfield,6366,3,11,5,10,39,37,2,38
Glenavon,6366,4,9,10,7,53,44,9,37
Cliftonville,6366,5,9,4,13,33,33,0,31
Ballymena,6366,6,7,4,15,26,49,-23,25
Glentoran,6366,7,6,6,10,24,32,-8,24
Dungannon,6366,8,2,4,16,14,47,-33,10
Crusaders,6367,1,16,6,4,61,31,30,54
Coleraine,6367,2,14,10,2,45,25,20,52
Glenavon,6367,3,10,9,7,55,45,10,39
Linfield,6367,4,11,5,10,38,36,2,38
Cliftonville,6367,5,9,4,13,32,32,0,31
Ballymena,6367,6,8,4,14,26,47,-21,28
Glentoran,6367,7,6,6,10,24,32,-8,24
Dungannon,6367,8,2,4,16,14,47,-33,10
Crusaders,6368,1,17,6,3,67,31,36,57
Coleraine,6368,2,14,10,2,45,28,17,52
Glenavon,6368,3,10,9,7,58,45,13,39
Linfield,6368,4,10,6,10,37,36,1,36
Cliftonville,6368,5,9,5,12,32,31,1,32
Ballymena,6368,6,7,4,15,26,53,-27,25
Glentoran,6368,7,6,6,10,24,32,-8,24
Dungannon,6368,8,2,4,16,14,47,-33,10
Crusaders,6369,1,16,6,4,62,33,29,54
Coleraine,6369,2,14,10,2,44,25,19,52
Glenavon,6369,3,10,9,7,55,44,11,39
Linfield,6369,4,11,5,10,38,36,2,38
Cliftonville,6369,5,9,4,13,32,32,0,31
Ballymena,6369,6,8,4,14,28,48,-20,28
Glentoran,6369,7,6,6,10,24,32,-8,24
Dungannon,6369,8,2,4,16,14,47,-33,10
Crusaders,6370,1,17,6,3,65,31,34,57
Coleraine,6370,2,15,10,1,49,24,25,55
Linfield,6370,3,11,5,10,38,36,2,38
Glenavon,6370,4,9,9,8,54,49,5,36
Cliftonville,6370,5,9,4,13,32,32,0,31
Ballymena,6370,6,7,4,15,26,51,-25,25
Glentoran,6370,7,6,6,10,24,32,-8,24
Dungannon,6370,8,2,4,16,14,47,-33,10
Crusaders,6371,1,16,6,4,61,31,30,54
Coleraine,6371,2,14,10,2,43,24,19,52
Glenavon,6371,3,10,9,7,54,43,11,39
Linfield,6371,4,10,5,11,37,38,-1,35
Cliftonville,6371,5,10,4,12,34,31,3,34
Ballymena,6371,6,8,4,14,26,47,-21,28
Glentoran,6371,7,6,6,10,24,32,-8,24
Dungannon,6371,8,2,4,16,14,47,-33,10
Crusaders,6372,1,17,6,3,64,32,32,57
Coleraine,6372,2,14,10,2,44,24,20,52
Glenavon,6372,3,10,9,7,54,44,10,39
Linfield,6372,4,10,6,10,37,36,1,36
Cliftonville,6372,5,9,5,12,32,31,1,32
Ballymena,6372,6,7,4,15,27,50,-23,25
Glentoran,6372,7,6,6,10,24,32,-8,24
Dungannon,6372,8,2,4,16,14,47,-33,10
Crusaders,6373,1,16,6,4,62,34,28,54
Coleraine,6373,2,14,10,2,44,24,20,52
Glenavon,6373,3,10,9,7,54,44,10,39
Linfield,6373,4,11,5,10,40,38,2,38
Cliftonville,6373,5,9,4,13,34,34,0,31
Ballymena,6373,6,8,4,14,29,48,-19,28
Glentoran,6373,7,6,6,10,24,32,-8,24
Dungannon,6373,8,2,4,16,14,47,-33,10
Coleraine,6374,1,15,10,1,46,24,22,55
Crusaders,6374,2,16,6,4,62,32,30,54
Linfield,6374,3,11,5,10,39,37,2,38
Glenavon,6374,4,9,9,8,54,46,8,36
Cliftonville,6374,5,9,4,13,33,33,0,31
Ballymena,6374,6,8,4,14,27,48,-21,28
Glentoran,6374,7,6,6,10,24,32,-8,24
Dungannon,6374,8,2,4,16,14,47,-33,10
Crusaders,6375,1,17,6,3,64,30,34,57
Coleraine,6375,2,14,11,1,44,23,21,53
Linfield,6375,3,11,5,10,38,36,2,38
Glenavon,6375,4,9,10,7,53,44,9,37
Cliftonville,6375,5,9,4,13,32,32,0,31
Ballymena,6375,6,7,4,15,25,50,-25,25
Glentoran,6375,7,6,6,10,24,32,-8,24
Dungannon,6375,8,2,4,16,14,47,-33,10
Crusaders,6376,1,17,6,3,65,32,33,57
Coleraine,6376,2,14,10,2,44,25,19,52
Glenavon,6376,3,10,9,7,55,44,11,39
Linfield,6376,4,11,5,10,40,36,4,38
Cliftonville,6376,5,9,4,13,32,34,-2,31
Ballymena,6376,6,7,4,15,27,51,-24,25
Glentoran,6376,7,6,6,10,24,32,-8,24
Dungannon,6376,8,2,4,16,14,47,-33,10
Crusaders,6377,1,17,6,3,62,30,32,57
Coleraine,6377,2,15,10,1,45,22,23,55
Linfield,6377,3,11,5,10,38,36,2,38
Glenavon,6377,4,9,9,8,52,45,7,36
Cliftonville,6377,5,9,4,13,32,32,0,31
Ballymena,6377,6,7,4,15,25,48,-23,25
Glentoran,6377,7,6,6,10,24,32,-8,24
Dungannon,6377,8,2,4,16,14,47,-33,10
Crusaders,6378,1,17,6,3,63,31,32,57
Coleraine,6378,2,14,10,2,43,24,19,52
Glenavon,6378,3,10,9,7,54,43,11,39
Linfield,6378,4,10,5,11,38,38,0,35
Cliftonville,6378,5,10,4,12,34,32,2,34
Ballymena,6378,6,7,4,15,26,49,-23,25
Glentoran,6378,7,6,6,10,24,32,-8,24
Dungannon,6378,8,2,4,16,14,47,-33,10
Crusaders,6379,1,17,6,3,63,31,32,57
Coleraine,6379,2,14,11,1,44,23,21,53
Linfield,6379,3,11,5,10,40,37,3,38
Glenavon,6379,4,9,10,7,53,44,9,37
Cliftonville,6379,5,9,4,13,33,34,-1,31
Ballymena,6379,6,7,4,15,26,49,-23,25
Glentoran,6379,7,6,6,10,24,32,-8,24
Dungannon,6379,8,2,4,16,14,47,-33,10
Crusaders,6380,1,16,7,3,61,30,31,55
Coleraine,6380,2,14,10,2,44,26,18,52
Glenavon,6380,3,10,9,7,56,44,12,39
Linfield,6380,4,11,5,10,38,36,2,38
Cliftonville,6380,5,9,4,13,32,32,0,31
Ballymena,6380,6,7,5,14,25,47,-22,26
Glentoran,6380,7,6,6,10,24,32,-8,24
Dungannon,6380,8,2,4,16,14,47,-33,10
Crusaders,6381,1,16,6,4,63,33,30,54
Coleraine,6381,2,14,10,2,45,25,20,52
Glenavon,6381,3,10,9,7,55,45,10,39
Linfield,6381,4,10,5,11,39,39,0,35
Cliftonville,6381,5,10,4,12,35,33,2,34
Ballymena,6381,6,8,4,14,28,49,-21,28
Glentoran,6381,7,6,6,10,24,32,-8,24
Dungannon,6381,8,2,4,16,14,47,-33,10
Crusaders,6382,1,16,7,3,62,31,31,55
Coleraine,6382,2,15,10,1,47,22,25,55
Linfield,6382,3,11,5,10,39,37,2,38
Glenavon,6382,4,9,9,8,52,47,5,36
Cliftonville,6382,5,9,4,13,33,33,0,31
Ballymena,6382,6,7,5,14,26,48,-22,26
Glentoran,6382,7,6,6,10,24,32,-8,24
Dungannon,6382,8,2,4,16,14,47,-33,10
Crusaders,6383,1,17,6,3,62,30,32,57
Coleraine,6383,2,15,10,1,45,22,23,55
Linfield,6383,3,11,5,10,39,37,2,38
Glenavon,6383,4,9,9,8,52,45,7,36
Cliftonville,6383,5,9,4,13,33,33,0,31
Ballymena,6383,6,7,4,15,25,48,-23,25
Glentoran,6383,7,6,6,10,24,32,-8,24
Dungannon,6383,8,2,4,16,14,47,-33,10
Crusaders,6384,1,17,6,3,64,32,32,57
Coleraine,6384,2,14,11,1,46,25,21,53
Linfield,6384,3,11,5,10,40,36,4,38
Glenavon,6384,4,9,10,7,55,46,9,37
Cliftonville,6384,5,9,4,13,32,34,-2,31
Ballymena,6384,6,7,4,15,27,50,-23,25
Glentoran,6384,7,6,6,10,24,32,-8,24
Dungannon,6384,8,2,4,16,14,47,-33,10
Crusaders,6385,1,17,6,3,63,31,32,57
Coleraine,6385,2,14,11,1,44,23,21,53
Glenavon,6385,3,9,10,7,53,44,9,37
Linfield,6385,4,10,5,11,38,38,0,35
Cliftonville,6385,5,10,4,12,34,32,2,34
Ballymena,6385,6,7,4,15,26,49,-23,25
Glentoran,6385,7,6,6,10,24,32,-8,24
Dungannon,6385,8,2,4,16,14,47,-33,10
Crusaders,6386,1,16,6,4,62,32,30,54
Coleraine,6386,2,14,10,2,43,25,18,52
Glenavon,6386,3,10,9,7,55,43,12,39
Linfield,6386,4,10,5,11,38,38,0,35
Cliftonville,6386,5,10,4,12,34,32,2,34
Ballymena,6386,6,8,4,14,27,48,-21,28
Glentoran,6386,7,6,6,10,24,32,-8,24
Dungannon,6386,8,2,4,16,14,47,-33,10
Crusaders,6387,1,16,7,3,62,31,31,55
Coleraine,6387,2,14,11,1,46,25,21,53
Linfield,6387,3,11,5,10,38,36,2,38
Glenavon,6387,4,9,10,7,55,46,9,37
Cliftonville,6387,5,9,4,13,32,32,0,31
Ballymena,6387,6,7,5,14,26,48,-22,26
Glentoran,6387,7,6,6,10,24,32,-8,24
Dungannon,6387,8,2,4,16,14,47,-33,10
Crusaders,6388,1,16,7,3,63,32,31,55
Coleraine,6388,2,14,10,2,44,27,17,52
Glenavon,6388,3,10,9,7,57,44,13,39
Linfield,6388,4,11,5,10,39,37,2,38
Cliftonville,6388,5,9,4,13,33,33,0,31
Ballymena,6388,6,7,5,14,27,49,-22,26
Glentoran,6388,7,6,6,10,24,32,-8,24
Dungannon,6388,8,2,4,16,14,47,-33,10
Crusaders,6389,1,17,6,3,64,30,34,57
Coleraine,6389,2,14,11,1,44,23,21,53
Glenavon,6389,3,9,10,7,53,44,9,37
Linfield,6389,4,10,6,10,38,37,1,36
Cliftonville,6389,5,9,5,12,33,32,1,32
Ballymena,6389,6,7,4,15,25,50,-25,25
Glentoran,6389,7,6,6,10,24,32,-8,24
Dungannon,6389,8,2,4,16,14,47,-33,10
Crusaders,6390,1,16,7,3,61,30,31,55
Coleraine,6390,2,14,10,2,44,26,18,52
Glenavon,6390,3,10,9,7,56,44,12,39
Linfield,6390,4,11,5,10,39,37,2,38
Cliftonville,6390,5,9,4,13,33,33,0,31
Ballymena,6390,6,7,5,14,25,47,-22,26
Glentoran,6390,7,6,6,10,24,32,-8,24
Dungannon,6390,8,2,4,16,14,47,-33,10
Crusaders,6391,1,17,6,3,63,31,32,57
Coleraine,6391,2,14,10,2,43,23,20,52
Glenavon,6391,3,10,9,7,53,43,10,39
Linfield,6391,4,11,5,10,41,36,5,38
Cliftonville,6391,5,9,4,13,32,35,-3,31
Ballymena,6391,6,7,4,15,26,49,-23,25
Glentoran,6391,7,6,6,10,24,32,-8,24
Dungannon,6391,8,2,4,16,14,47,-33,10
Crusaders,6392,1,17,6,3,63,30,33,57
Coleraine,6392,2,14,11,1,44,23,21,53
Linfield,6392,3,11,5,10,40,38,2,38
Glenavon,6392,4,9,10,7,53,44,9,37
Cliftonville,6392,5,9,4,13,34,34,0,31
Ballymena,6392,6,7,4,15,25,49,-24,25
Glentoran,6392,7,6,6,10,24,32,-8,24
Dungannon,6392,8,2,4,16,14,47,-33,10
Crusaders,6393,1,17,6,3,64,31,33,57
Coleraine,6393,2,14,11,1,45,24,21,53
Linfield,6393,3,11,5,10,39,37,2,38
Glenavon,6393,4,9,10,7,54,45,9,37
Cliftonville,6393,5,9,4,13,33,33,0,31
Ballymena,6393,6,7,4,15,26,50,-24,25
Glentoran,6393,7,6,6,10,24,32,-8,24
Dungannon,6393,8,2,4,16,14,47,-33,10
Crusaders,6394,1,16,7,3,63,32,31,55
Coleraine,6394,2,14,10,2,44,25,19,52
Glenavon,6394,3,10,9,7,55,44,11,39
Linfield,6394,4,11,5,10,39,36,3,38
Cliftonville,6394,5,9,4,13,32,33,-1,31
Ballymena,6394,6,7,5,14,27,49,-22,26
Glentoran,6394,7,6,6,10,24,32,-8,24
Dungannon,6394,8,2,4,16,14,47,-33,10
Crusaders,6395,1,17,6,3,62,30,32,57
Coleraine,6395,2,14,10,2,43,24,19,52
Glenavon,6395,3,10,9,7,54,43,11,39
Linfield,6395,4,11,5,10,39,37,2,38
Cliftonville,6395,5,9,4,13,33,33,0,31
Ballymena,6395,6,7,4,15,25,48,-23,25
Glentoran,6395,7,6,6,10,24,32,-8,24
Dungannon,6395,8,2,4,16,14,47,-33,10
Crusaders,6396,1,17,6,3,65,30,35,57
Coleraine,6396,2,15,10,1,46,22,24,55
Glenavon,6396,3,9,9,8,52,46,6,36
Linfield,6396,4,10,5,11,39,39,0,35
Cliftonville,6396,5,10,4,12,35,33,2,34
Ballymena,6396,6,7,4,15,25,51,-26,25
Glentoran,6396,7,6,6,10,24,32,-8,24
Dungannon,6396,8,2,4,16,14,47,-33,10
Crusaders,6397,1,16,6,4,61,34,27,54
Coleraine,6397,2,14,10,2,43,25,18,52
Glenavon,6397,3,10,9,7,55,43,12,39
Linfield,6397,4,10,5,11,38,39,-1,35
Cliftonville,6397,5,10,4,12,35,32,3,34
Ballymena,6397,6,8,4,14,29,47,-18,28
Glentoran,6397,7,6,6,10,24,32,-8,24
Dungannon,6397,8,2,4,16,14,47,-33,10
Coleraine,6398,1,15,10,1,46,22,24,55
Crusaders,6398,2,16,6,4,61,34,27,54
Linfield,6398,3,11,5,10,40,37,3,38
Glenavon,6398,4,9,9,8,52,46,6,36
Cliftonville,6398,5,9,4,13,33,34,-1,31
Ballymena,6398,6,8,4,14,29,47,-18,28
Glentoran,6398,7,6,6,10,24,32,-8,24
Dungannon,6398,8,2,4,16,14,47,-33,10
Crusaders,6399,1,16,7,3,63,32,31,55
Coleraine,6399,2,15,10,1,45,22,23,55
Glenavon,6399,3,9,9,8,52,45,7,36
Linfield,6399,4,10,6,10,38,37,1,36
Cliftonville,6399,5,9,5,12,33,32,1,32
Ballymena,6399,6,7,5,14,27,49,-22,26
Glentoran,6399,7,6,6,10,24,32,-8,24
Dungannon,6399,8,2,4,16,14,47,-33,10
Crusaders,6400,1,17,6,3,62,30,32,57
Coleraine,6400,2,14,10,2,44,24,20,52
Glenavon,6400,3,10,9,7,54,44,10,39
Linfield,6400,4,10,6,10,38,37,1,36
Cliftonville,6400,5,9,5,12,33,32,1,32
Ballymena,6400,6,7,4,15,25,48,-23,25
Glentoran,6400,7,6,6,10,24,32,-8,24
Dungannon,6400,8,2,4,16,14,47,-33,10
Crusaders,6401,1,17,6,3,63,30,33,57
Coleraine,6401,2,14,11,1,44,23,21,53
Linfield,6401,3,11,5,10,39,37,2,38
Glenavon,6401,4,9,10,7,53,44,9,37
Cliftonville,6401,5,9,4,13,33,33,0,31
Ballymena,6401,6,7,4,15,25,49,-24,25
Glentoran,6401,7,6,6,10,24,32,-8,24
Dungannon,6401,8,2,4,16,14,47,-33,10
Crusaders,6402,1,17,6,3,63,31,32,57
Coleraine,6402,2,15,10,1,48,26,22,55
Linfield,6402,3,11,5,10,40,38,2,38
Glenavon,6402,4,9,9,8,56,48,8,36
Cliftonville,6402,5,9,4,13,34,34,0,31
Ballymena,6402,6,7,4,15,26,49,-23,25
Glentoran,6402,7,6,6,10,24,32,-8,24
Dungannon,6402,8,2,4,16,14,47,-33,10
Crusaders,6403,1,17,6,3,65,30,35,57
Coleraine,6403,2,15,10,1,48,22,26,55
Glenavon,6403,3,9,9,8,52,48,4,36
Linfield,6403,4,10,6,10,38,37,1,36
Cliftonville,6403,5,9,5,12,33,32,1,32
Ballymena,6403,6,7,4,15,25,51,-26,25
Glentoran,6403,7,6,6,10,24,32,-8,24
Dungannon,6403,8,2,4,16,14,47,-33,10
Crusaders,6404,1,17,6,3,65,31,34,57
Coleraine,6404,2,14,10,2,43,23,20,52
Glenavon,6404,3,10,9,7,53,43,10,39
Linfield,6404,4,10,5,11,38,39,-1,35
Cliftonville,6404,5,10,4,12,35,32,3,34
Ballymena,6404,6,7,4,15,26,51,-25,25
Glentoran,6404,7,6,6,10,24,32,-8,24
Dungannon,6404,8,2,4,16,14,47,-33,10
Crusaders,6405,1,17,6,3,62,30,32,57
Coleraine,6405,2,14,11,1,45,24,21,53
Glenavon,6405,3,9,10,7,54,45,9,37
Linfield,6405,4,10,5,11,37,38,-1,35
Cliftonville,6405,5,10,4,12,34,31,3,34
Ballymena,6405,6,7,4,15,25,48,-23,25
Glentoran,6405,7,6,6,10,24,32,-8,24
Dungannon,6405,8,2,4,16,14,47,-33,10
Coleraine,6406,1,15,10,1,44,22,22,55
Crusaders,6406,2,16,6,4,61,31,30,54
Linfield,6406,3,11,5,10,38,36,2,38
Glenavon,6406,4,9,9,8,52,44,8,36
Cliftonville,6406,5,9,4,13,32,32,0,31
Ballymena,6406,6,8,4,14,26,47,-21,28
Glentoran,6406,7,6,6,10,24,32,-8,24
Dungannon,6406,8,2,4,16,14,47,-33,10
Coleraine,6407,1,15,10,1,46,22,24,55
Crusaders,6407,2,16,6,4,64,34,30,54
Glenavon,6407,3,9,9,8,52,46,6,36
Linfield,6407,4,10,5,11,38,38,0,35
Cliftonville,6407,5,10,4,12,34,32,2,34
Ballymena,6407,6,8,4,14,29,50,-21,28
Glentoran,6407,7,6,6,10,24,32,-8,24
Dungannon,6407,8,2,4,16,14,47,-33,10
Crusaders,6408,1,17,6,3,63,30,33,57
Coleraine,6408,2,14,10,2,44,24,20,52
Glenavon,6408,3,10,9,7,54,44,10,39
Linfield,6408,4,11,5,10,38,36,2,38
Cliftonville,6408,5,9,4,13,32,32,0,31
Ballymena,6408,6,7,4,15,25,49,-24,25
Glentoran,6408,7,6,6,10,24,32,-8,24
Dungannon,6408,8,2,4,16,14,47,-33,10
Crusaders,6409,1,16,6,4,61,32,29,54
Coleraine,6409,2,14,11,1,44,23,21,53
Glenavon,6409,3,9,10,7,53,44,9,37
Linfield,6409,4,10,5,11,38,38,0,35
Cliftonville,6409,5,10,4,12,34,32,2,34
Ballymena,6409,6,8,4,14,27,47,-20,28
Glentoran,6409,7,6,6,10,24,32,-8,24
Dungannon,6409,8,2,4,16,14,47,-33,10
Crusaders,6410,1,16,6,4,62,33,29,54
Coleraine,6410,2,14,10,2,43,23,20,52
Glenavon,6410,3,10,9,7,53,43,10,39
Linfield,6410,4,10,5,11,38,40,-2,35
Cliftonville,6410,5,10,4,12,36,32,4,34
Ballymena,6410,6,8,4,14,28,48,-20,28
Glentoran,6410,7,6,6,10,24,32,-8,24
Dungannon,6410,8,2,4,16,14,47,-33,10
Crusaders,6411,1,16,7,3,63,32,31,55
Coleraine,6411,2,15,10,1,45,22,23,55
Linfield,6411,3,11,5,10,38,36,2,38
Glenavon,6411,4,9,9,8,52,45,7,36
Cliftonville,6411,5,9,4,13,32,32,0,31
Ballymena,6411,6,7,5,14,27,49,-22,26
Glentoran,6411,7,6,6,10,24,32,-8,24
Dungannon,6411,8,2,4,16,14,47,-33,10
Crusaders,6412,1,17,6,3,64,31,33,57
Coleraine,6412,2,14,10,2,43,27,16,52
Glenavon,6412,3,10,9,7,57,43,14,39
Linfield,6412,4,10,6,10,39,38,1,36
Cliftonville,6412,5,9,5,12,34,33,1,32
Ballymena,6412,6,7,4,15,26,50,-24,25
Glentoran,6412,7,6,6,10,24,32,-8,24
Dungannon,6412,8,2,4,16,14,47,-33,10
Crusaders,6413,1,17,6,3,63,30,33,57
Coleraine,6413,2,14,10,2,44,25,19,52
Glenavon,6413,3,10,9,7,55,44,11,39
Linfield,6413,4,10,5,11,38,38,0,35
Cliftonville,6413,5,10,4,12,34,32,2,34
Ballymena,6413,6,7,4,15,25,49,-24,25
Glentoran,6413,7,6,6,10,24,32,-8,24
Dungannon,6413,8,2,4,16,14,47,-33,10
Crusaders,6414,1,16,7,3,62,31,31,55
Coleraine,6414,2,14,10,2,44,24,20,52
Glenavon,6414,3,10,9,7,54,44,10,39
Linfield,6414,4,11,5,10,39,36,3,38
Cliftonville,6414,5,9,4,13,32,33,-1,31
Ballymena,6414,6,7,5,14,26,48,-22,26
Glentoran,6414,7,6,6,10,24,32,-8,24
Dungannon,6414,8,2,4,16,14,47,-33,10
Crusaders,6415,1,16,6,4,62,32,30,54
Coleraine,6415,2,14,10,2,43,24,19,52
Glenavon,6415,3,10,9,7,54,43,11,39
Linfield,6415,4,11,5,10,38,36,2,38
Cliftonville,6415,5,9,4,13,32,32,0,31
Ballymena,6415,6,8,4,14,27,48,-21,28
Glentoran,6415,7,6,6,10,24,32,-8,24
Dungannon,6415,8,2,4,16,14,47,-33,10
Crusaders,6416,1,16,6,4,61,31,30,54
Coleraine,6416,2,14,11,1,44,23,21,53
Linfield,6416,3,11,5,10,39,36,3,38
Glenavon,6416,4,9,10,7,53,44,9,37
Cliftonville,6416,5,9,4,13,32,33,-1,31
Ballymena,6416,6,8,4,14,26,47,-21,28
Glentoran,6416,7,6,6,10,24,32,-8,24
Dungannon,6416,8,2,4,16,14,47,-33,10
Crusaders,6417,1,16,7,3,63,32,31,55
Coleraine,6417,2,14,11,1,44,23,21,53
Glenavon,6417,3,9,10,7,53,44,9,37
Linfield,6417,4,10,5,11,37,39,-2,35
Cliftonville,6417,5,10,4,12,35,31,4,34
Ballymena,6417,6,7,5,14,27,49,-22,26
Glentoran,6417,7,6,6,10,24,32,-8,24
Dungannon,6417,8,2,4,16,14,47,-33,10
Crusaders,6418,1,17,6,3,63,31,32,57
Coleraine,6418,2,14,10,2,44,25,19,52
Glenavon,6418,3,10,9,7,55,44,11,39
Linfield,6418,4,11,5,10,38,36,2,38
Cliftonville,6418,5,9,4,13,32,32,0,31
Ballymena,6418,6,7,4,15,26,49,-23,25
Glentoran,6418,7,6,6,10,24,32,-8,24
Dungannon,6418,8,2,4,16,14,47,-33,10
Crusaders,6419,1,16,6,4,61,31,30,54
Coleraine,6419,2,14,10,2,44,25,19,52
Glenavon,6419,3,10,9,7,55,44,11,39
Linfield,6419,4,10,6,10,39,38,1,36
Cliftonville,6419,5,9,5,12,34,33,1,32
Ballymena,6419,6,8,4,14,26,47,-21,28
Glentoran,6419,7,6,6,10,24,32,-8,24
Dungannon,6419,8,2,4,16,14,47,-33,10
Crusaders,6420,1,17,6,3,64,31,33,57
Coleraine,6420,2,15,10,1,46,23,23,55
Linfield,6420,3,11,5,10,40,36,4,38
Glenavon,6420,4,9,9,8,53,46,7,36
Cliftonville,6420,5,9,4,13,32,34,-2,31
Ballymena,6420,6,7,4,15,26,50,-24,25
Glentoran,6420,7,6,6,10,24,32,-8,24
Dungannon,6420,8,2,4,16,14,47,-33,10
Crusaders,6421,1,17,6,3,63,31,32,57
Coleraine,6421,2,14,11,1,47,26,21,53
Glenavon,6421,3,9,10,7,56,47,9,37
Linfield,6421,4,10,6,10,39,38,1,36
Cliftonville,6421,5,9,5,12,34,33,1,32
Ballymena,6421,6,7,4,15,26,49,-23,25
Glentoran,6421,7,6,6,10,24,32,-8,24
Dungannon,6421,8,2,4,16,14,47,-33,10
Crusaders,6422,1,16,6,4,61,31,30,54
Coleraine,6422,2,14,11,1,44,23,21,53
Linfield,6422,3,11,5,10,38,36,2,38
Glenavon,6422,4,9,10,7,53,44,9,37
Cliftonville,6422,5,9,4,13,32,32,0,31
Ballymena,6422,6,8,4,14,26,47,-21,28
Glentoran,6422,7,6,6,10,24,32,-8,24
Dungannon,6422,8,2,4,16,14,47,-33,10
Crusaders,6423,1,16,7,3,62,31,31,55
Coleraine,6423,2,15,10,1,45,22,23,55
Linfield,6423,3,11,5,10,38,36,2,38
Glenavon,6423,4,9,9,8,52,45,7,36
Cliftonville,6423,5,9,4,13,32,32,0,31
Ballymena,6423,6,7,5,14,26,48,-22,26
Glentoran,6423,7,6,6,10,24,32,-8,24
Dungannon,6423,8,2,4,16,14,47,-33,10
Crusaders,6424,1,16,6,4,62,35,27,54
Coleraine,6424,2,14,11,1,44,23,21,53
Linfield,6424,3,11,5,10,39,36,3,38
Glenavon,6424,4,9,10,7,53,44,9,37
Cliftonville,6424,5,9,4,13,32,33,-1,31
Ballymena,6424,6,8,4,14,30,48,-18,28
Glentoran,6424,7,6,6,10,24,32,-8,24
Dungannon,6424,8,2,4,16,14,47,-33,10
Crusaders,6425,1,17,6,3,64,31,33,57
Coleraine,6425,2,15,10,1,44,22,22,55
Glenavon,6425,3,9,9,8,52,44,8,36
Linfield,6425,4,10,6,10,38,37,1,36
Cliftonville,6425,5,9,5,12,33,32,1,32
Ballymena,6425,6,7,4,15,26,50,-24,25
Glentoran,6425,7,6,6,10,24,32,-8,24
Dungannon,6425,8,2,4,16,14,47,-33,10
Crusaders,6426,1,17,6,3,63,31,32,57
Coleraine,6426,2,14,11,1,44,23,21,53
Linfield,6426,3,11,5,10,41,37,4,38
Glenavon,6426,4,9,10,7,53,44,9,37
Cliftonville,6426,5,9,4,13,33,35,-2,31
Ballymena,6426,6,7,4,15,26,49,-23,25
Glentoran,6426,7,6,6,10,24,32,-8,24
Dungannon,6426,8,2,4,16,14,47,-33,10
Crusaders,6427,1,16,6,4,62,32,30,54
Coleraine,6427,2,14,10,2,43,23,20,52
Glenavon,6427,3,10,9,7,53,43,10,39
Linfield,6427,4,11,5,10,38,36,2,38
Cliftonville,6427,5,9,4,13,32,32,0,31
Ballymena,6427,6,8,4,14,27,48,-21,28
Glentoran,6427,7,6,6,10,24,32,-8,24
Dungannon,6427,8,2,4,16,14,47,-33,10
Coleraine,6428,1,15,10,1,46,24,22,55
Crusaders,6428,2,16,6,4,62,32,30,54
Linfield,6428,3,11,5,10,39,36,3,38
Glenavon,6428,4,9,9,8,54,46,8,36
Cliftonville,6428,5,9,4,13,32,33,-1,31
Ballymena,6428,6,8,4,14,27,48,-21,28
Glentoran,6428,7,6,6,10,24,32,-8,24
Dungannon,6428,8,2,4,16,14,47,-33,10
Crusaders,6429,1,17,6,3,65,31,34,57
Coleraine,6429,2,14,10,2,43,23,20,52
Glenavon,6429,3,10,9,7,53,43,10,39
Linfield,6429,4,11,5,10,40,36,4,38
Cliftonville,6429,5,9,4,13,32,34,-2,31
Ballymena,6429,6,7,4,15,26,51,-25,25
Glentoran,6429,7,6,6,10,24,32,-8,24
Dungannon,6429,8,2,4,16,14,47,-33,10
Crusaders,6430,1,17,6,3,63,30,33,57
Coleraine,6430,2,15,10,1,45,22,23,55
Linfield,6430,3,11,5,10,42,36,6,38
Glenavon,6430,4,9,9,8,52,45,7,36
Cliftonville,6430,5,9,4,13,32,36,-4,31
Ballymena,6430,6,7,4,15,25,49,-24,25
Glentoran,6430,7,6,6,10,24,32,-8,24
Dungannon,6430,8,2,4,16,14,47,-33,10
Crusaders,6431,1,17,6,3,64,31,33,57
Coleraine,6431,2,14,10,2,47,28,19,52
Glenavon,6431,3,10,9,7,58,47,11,39
Linfield,6431,4,10,5,11,37,37,0,35
Cliftonville,6431,5,10,4,12,33,31,2,34
Ballymena,6431,6,7,4,15,26,50,-24,25
Glentoran,6431,7,6,6,10,24,32,-8,24
Dungannon,6431,8,2,4,16,14,47,-33,10
Crusaders,6432,1,17,6,3,64,30,34,57
Coleraine,6432,2,15,10,1,44,22,22,55
Glenavon,6432,3,9,9,8,52,44,8,36
Linfield,6432,4,10,5,11,37,37,0,35
Cliftonville,6432,5,10,4,12,33,31,2,34
Ballymena,6432,6,7,4,15,25,50,-25,25
Glentoran,6432,7,6,6,10,24,32,-8,24
Dungannon,6432,8,2,4,16,14,47,-33,10
Crusaders,6433,1,17,6,3,66,32,34,57
Coleraine,6433,2,14,10,2,44,25,19,52
Glenavon,6433,3,10,9,7,55,44,11,39
Linfield,6433,4,10,5,11,38,38,0,35
Cliftonville,6433,5,10,4,12,34,32,2,34
Ballymena,6433,6,7,4,15,27,52,-25,25
Glentoran,6433,7,6,6,10,24,32,-8,24
Dungannon,6433,8,2,4,16,14,47,-33,10
Crusaders,6434,1,17,6,3,63,30,33,57
Coleraine,6434,2,14,10,2,45,26,19,52
Glenavon,6434,3,10,9,7,56,45,11,39
Linfield,6434,4,10,6,10,37,36,1,36
Cliftonville,6434,5,9,5,12,32,31,1,32
Ballymena,6434,6,7,4,15,25,49,-24,25
Glentoran,6434,7,6,6,10,24,32,-8,24
Dungannon,6434,8,2,4,16,14,47,-33,10
Crusaders,6435,1,16,7,3,63,32,31,55
Coleraine,6435,2,14,10,2,43,24,19,52
Glenavon,6435,3,10,9,7,54,43,11,39
Linfield,6435,4,11,5,10,38,36,2,38
Cliftonville,6435,5,9,4,13,32,32,0,31
Ballymena,6435,6,7,5,14,27,49,-22,26
Glentoran,6435,7,6,6,10,24,32,-8,24
Dungannon,6435,8,2,4,16,14,47,-33,10
Crusaders,6436,1,17,6,3,64,32,32,57
Coleraine,6436,2,14,10,2,44,25,19,52
Glenavon,6436,3,10,9,7,55,44,11,39
Linfield,6436,4,11,5,10,39,36,3,38
Cliftonville,6436,5,9,4,13,32,33,-1,31
Ballymena,6436,6,7,4,15,27,50,-23,25
Glentoran,6436,7,6,6,10,24,32,-8,24
Dungannon,6436,8,2,4,16,14,47,-33,10
Crusaders,6437,1,16,7,3,64,33,31,55
Coleraine,6437,2,15,10,1,46,23,23,55
Linfield,6437,3,11,5,10,40,36,4,38
Glenavon,6437,4,9,9,8,53,46,7,36
Cliftonville,6437,5,9,4,13,32,34,-2,31
Ballymena,6437,6,7,5,14,28,50,-22,26
Glentoran,6437,7,6,6,10,24,32,-8,24
Dungannon,6437,8,2,4,16,14,47,-33,10
Crusaders,6438,1,17,6,3,63,30,33,57
Coleraine,6438,2,14,10,2,44,26,18,52
Glenavon,6438,3,10,9,7,56,44,12,39
Linfield,6438,4,11,5,10,39,36,3,38
Cliftonville,6438,5,9,4,13,32,33,-1,31
Ballymena,6438,6,7,4,15,25,49,-24,25
Glentoran,6438,7,6,6,10,24,32,-8,24
Dungannon,6438,8,2,4,16,14,47,-33,10
Coleraine,6439,1,15,10,1,47,22,25,55
Crusaders,6439,2,16,6,4,62,32,30,54
Linfield,6439,3,11,5,10,41,37,4,38
Glenavon,6439,4,9,9,8,52,47,5,36
Cliftonville,6439,5,9,4,13,33,35,-2,31
Ballymena,6439,6,8,4,14,27,48,-21,28
Glentoran,6439,7,6,6,10,24,32,-8,24
Dungannon,6439,8,2,4,16,14,47,-33,10
Crusaders,6440,1,17,6,3,63,31,32,57
Coleraine,6440,2,15,10,1,45,23,22,55
Linfield,6440,3,11,5,10,40,37,3,38
Glenavon,6440,4,9,9,8,53,45,8,36
Cliftonville,6440,5,9,4,13,33,34,-1,31
Ballymena,6440,6,7,4,15,26,49,-23,25
Glentoran,6440,7,6,6,10,24,32,-8,24
Dungannon,6440,8,2,4,16,14,47,-33,10
Crusaders,6441,1,17,6,3,63,31,32,57
Coleraine,6441,2,14,11,1,43,22,21,53
Glenavon,6441,3,9,10,7,52,43,9,37
Linfield,6441,4,10,6,10,37,36,1,36
Cliftonville,6441,5,9,5,12,32,31,1,32
Ballymena,6441,6,7,4,15,26,49,-23,25
Glentoran,6441,7,6,6,10,24,32,-8,24
Dungannon,6441,8,2,4,16,14,47,-33,10
Crusaders,6442,1,16,7,3,64,33,31,55
Coleraine,6442,2,14,10,2,45,25,20,52
Glenavon,6442,3,10,9,7,55,45,10,39
Linfield,6442,4,11,5,10,39,36,3,38
Cliftonville,6442,5,9,4,13,32,33,-1,31
Ballymena,6442,6,7,5,14,28,50,-22,26
Glentoran,6442,7,6,6,10,24,32,-8,24
Dungannon,6442,8,2,4,16,14,47,-33,10
Crusaders,6443,1,17,6,3,64,31,33,57
Coleraine,6443,2,15,10,1,47,24,23,55
Glenavon,6443,3,9,9,8,54,47,7,36
Linfield,6443,4,10,6,10,38,37,1,36
Cliftonville,6443,5,9,5,12,33,32,1,32
Ballymena,6443,6,7,4,15,26,50,-24,25
Glentoran,6443,7,6,6,10,24,32,-8,24
Dungannon,6443,8,2,4,16,14,47,-33,10
Crusaders,6444,1,17,6,3,65,32,33,57
Coleraine,6444,2,15,10,1,46,22,24,55
Linfield,6444,3,11,5,10,39,37,2,38
Glenavon,6444,4,9,9,8,52,46,6,36
Cliftonville,6444,5,9,4,13,33,33,0,31
Ballymena,6444,6,7,4,15,27,51,-24,25
Glentoran,6444,7,6,6,10,24,32,-8,24
Dungannon,6444,8,2,4,16,14,47,-33,10
Coleraine,6445,1,15,10,1,46,22,24,55
Crusaders,6445,2,16,6,4,63,33,30,54
Glenavon,6445,3,9,9,8,52,46,6,36
Linfield,6445,4,10,5,11,37,38,-1,35
Cliftonville,6445,5,10,4,12,34,31,3,34
Ballymena,6445,6,8,4,14,28,49,-21,28
Glentoran,6445,7,6,6,10,24,32,-8,24
Dungannon,6445,8,2,4,16,14,47,-33,10
Crusaders,6446,1,17,6,3,66,32,34,57
Coleraine,6446,2,14,10,2,44,25,19,52
Glenavon,6446,3,10,9,7,55,44,11,39
Linfield,6446,4,10,5,11,39,39,0,35
Cliftonville,6446,5,10,4,12,35,33,2,34
Ballymena,6446,6,7,4,15,27,52,-25,25
Glentoran,6446,7,6,6,10,24,32,-8,24
Dungannon,6446,8,2,4,16,14,47,-33,10
Coleraine,6447,1,15,10,1,45,23,22,55
Crusaders,6447,2,16,6,4,62,32,30,54
Glenavon,6447,3,9,9,8,53,45,8,36
Linfield,6447,4,10,6,10,37,36,1,36
Cliftonville,6447,5,9,5,12,32,31,1,32
Ballymena,6447,6,8,4,14,27,48,-21,28
Glentoran,6447,7,6,6,10,24,32,-8,24
Dungannon,6447,8,2,4,16,14,47,-33,10
Crusaders,6448,1,17,6,3,62,30,32,57
Coleraine,6448,2,14,10,2,43,23,20,52
Glenavon,6448,3,10,9,7,53,43,10,39
Linfield,6448,4,11,5,10,40,37,3,38
Cliftonville,6448,5,9,4,13,33,34,-1,31
Ballymena,6448,6,7,4,15,25,48,-23,25
Glentoran,6448,7,6,6,10,24,32,-8,24
Dungannon,6448,8,2,4,16,14,47,-33,10
Crusaders,6449,1,16,7,3,62,31,31,55
Coleraine,6449,2,14,11,1,46,25,21,53
Glenavon,6449,3,9,10,7,55,46,9,37
Linfield,6449,4,10,5,11,38,38,0,35
Cliftonville,6449,5,10,4,12,34,32,2,34
Ballymena,6449,6,7,5,14,26,48,-22,26
Glentoran,6449,7,6,6,10,24,32,-8,24
Dungannon,6449,8,2,4,16,14,47,-33,10
Crusaders,6450,1,17,6,3,66,30,36,57
Coleraine,6450,2,14,11,1,46,25,21,53
Linfield,6450,3,11,5,10,38,36,2,38
Glenavon,6450,4,9,10,7,55,46,9,37
Cliftonville,6450,5,9,4,13,32,32,0,31
Ballymena,6450,6,7,4,15,25,52,-27,25
Glentoran,6450,7,6,6,10,24,32,-8,24
Dungannon,6450,8,2,4,16,14,47,-33,10
Crusaders,6451,1,17,6,3,62,30,32,57
Coleraine,6451,2,14,11,1,46,25,21,53
Linfield,6451,3,11,5,10,40,38,2,38
Glenavon,6451,4,9,10,7,55,46,9,37
Cliftonville,6451,5,9,4,13,34,34,0,31
Ballymena,6451,6,7,4,15,25,48,-23,25
Glentoran,6451,7,6,6,10,24,32,-8,24
Dungannon,6451,8,2,4,16,14,47,-33,10
Crusaders,6452,1,16,7,3,62,31,31,55
Coleraine,6452,2,15,10,1,44,22,22,55
Glenavon,6452,3,9,9,8,52,44,8,36
Linfield,6452,4,10,5,11,38,38,0,35
Cliftonville,6452,5,10,4,12,34,32,2,34
Ballymena,6452,6,7,5,14,26,48,-22,26
Glentoran,6452,7,6,6,10,24,32,-8,24
Dungannon,6452,8,2,4,16,14,47,-33,10
Crusaders,6453,1,17,6,3,64,31,33,57
Coleraine,6453,2,14,10,2,44,25,19,52
Glenavon,6453,3,10,9,7,55,44,11,39
Linfield,6453,4,10,6,10,38,37,1,36
Cliftonville,6453,5,9,5,12,33,32,1,32
Ballymena,6453,6,7,4,15,26,50,-24,25
Glentoran,6453,7,6,6,10,24,32,-8,24
Dungannon,6453,8,2,4,16,14,47,-33,10
Crusaders,6454,1,17,6,3,66,32,34,57
Coleraine,6454,2,14,11,1,45,24,21,53
Linfield,6454,3,11,5,10,39,36,3,38
Glenavon,6454,4,9,10,7,54,45,9,37
Cliftonville,6454,5,9,4,13,32,33,-1,31
Ballymena,6454,6,7,4,15,27,52,-25,25
Glentoran,6454,7,6,6,10,24,32,-8,24
Dungannon,6454,8,2,4,16,14,47,-33,10
Crusaders,6455,1,17,6,3,64,31,33,57
Coleraine,6455,2,15,10,1,44,22,22,55
Linfield,6455,3,11,5,10,38,36,2,38
Glenavon,6455,4,9,9,8,52,44,8,36
Cliftonville,6455,5,9,4,13,32,32,0,31
Ballymena,6455,6,7,4,15,26,50,-24,25
Glentoran,6455,7,6,6,10,24,32,-8,24
Dungannon,6455,8,2,4,16,14,47,-33,10
Crusaders,6456,1,16,6,4,62,32,30,54
Coleraine,6456,2,14,10,2,44,25,19,52
Glenavon,6456,3,10,9,7,55,44,11,39
Linfield,6456,4,11,5,10,40,36,4,38
Cliftonville,6456,5,9,4,13,32,34,-2,31
Ballymena,6456,6,8,4,14,27,48,-21,28
Glentoran,6456,7,6,6,10,24,32,-8,24
Dungannon,6456,8,2,4,16,14,47,-33,10
Crusaders,6457,1,17,6,3,64,31,33,57
Coleraine,6457,2,14,10,2,45,25,20,52
Glenavon,6457,3,10,9,7,55,45,10,39
Linfield,6457,4,10,6,10,38,37,1,36
Cliftonville,6457,5,9,5,12,33,32,1,32
Ballymena,6457,6,7,4,15,26,50,-24,25
Glentoran,6457,7,6,6,10,24,32,-8,24
Dungannon,6457,8,2,4,16,14,47,-33,10
Crusaders,6458,1,17,6,3,63,30,33,57
Coleraine,6458,2,14,10,2,43,24,19,52
Glenavon,6458,3,10,9,7,54,43,11,39
Linfield,6458,4,10,5,11,37,37,0,35
Cliftonville,6458,5,10,4,12,33,31,2,34
Ballymena,6458,6,7,4,15,25,49,-24,25
Glentoran,6458,7,6,6,10,24,32,-8,24
Dungannon,6458,8,2,4,16,14,47,-33,10
Crusaders,6459,1,17,6,3,64,32,32,57
Coleraine,6459,2,15,10,1,45,22,23,55
Linfield,6459,3,11,5,10,40,36,4,38
Glenavon,6459,4,9,9,8,52,45,7,36
Cliftonville,6459,5,9,4,13,32,34,-2,31
Ballymena,6459,6,7,4,15,27,50,-23,25
Glentoran,6459,7,6,6,10,24,32,-8,24
Dungannon,6459,8,2,4,16,14,47,-33,10
Crusaders,6460,1,17,6,3,63,31,32,57
Coleraine,6460,2,14,10,2,44,24,20,52
Glenavon,6460,3,10,9,7,54,44,10,39
Linfield,6460,4,11,5,10,38,36,2,38
Cliftonville,6460,5,9,4,13,32,32,0,31
Ballymena,6460,6,7,4,15,26,49,-23,25
Glentoran,6460,7,6,6,10,24,32,-8,24
Dungannon,6460,8,2,4,16,14,47,-33,10
Crusaders,6461,1,17,6,3,65,30,35,57
Coleraine,6461,2,14,10,2,44,25,19,52
Glenavon,6461,3,10,9,7,55,44,11,39
Linfield,6461,4,11,5,10,39,36,3,38
Cliftonville,6461,5,9,4,13,32,33,-1,31
Ballymena,6461,6,7,4,15,25,51,-26,25
Glentoran,6461,7,6,6,10,24,32,-8,24
Dungannon,6461,8,2,4,16,14,47,-33,10
Crusaders,6462,1,16,6,4,62,34,28,54
Coleraine,6462,2,14,11,1,43,22,21,53
Linfield,6462,3,11,5,10,39,37,2,38
Glenavon,6462,4,9,10,7,52,43,9,37
Cliftonville,6462,5,9,4,13,33,33,0,31
Ballymena,6462,6,8,4,14,29,48,-19,28
Glentoran,6462,7,6,6,10,24,32,-8,24
Dungannon,6462,8,2,4,16,14,47,-33,10
Crusaders,6463,1,17,6,3,65,32,33,57
Coleraine,6463,2,14,10,2,43,24,19,52
Glenavon,6463,3,10,9,7,54,43,11,39
Linfield,6463,4,11,5,10,40,36,4,38
Cliftonville,6463,5,9,4,13,32,34,-2,31
Ballymena,6463,6,7,4,15,27,51,-24,25
Glentoran,6463,7,6,6,10,24,32,-8,24
Dungannon,6463,8,2,4,16,14,47,-33,10
Crusaders,6464,1,16,6,4,61,31,30,54
Coleraine,6464,2,14,10,2,45,25,20,52
Glenavon,6464,3,10,9,7,55,45,10,39
Linfield,6464,4,10,5,11,39,39,0,35
Cliftonville,6464,5,10,4,12,35,33,2,34
Ballymena,6464,6,8,4,14,26,47,-21,28
Glentoran,6464,7,6,6,10,24,32,-8,24
Dungannon,6464,8,2,4,16,14,47,-33,10
Crusaders,6465,1,17,6,3,65,30,35,57
Coleraine,6465,2,14,10,2,43,23,20,52
Glenavon,6465,3,10,9,7,53,43,10,39
Linfield,6465,4,11,5,10,39,37,2,38
Cliftonville,6465,5,9,4,13,33,33,0,31
Ballymena,6465,6,7,4,15,25,51,-26,25
Glentoran,6465,7,6,6,10,24,32,-8,24
Dungannon,6465,8,2,4,16,14,47,-33,10
Coleraine,6466,1,15,10,1,45,23,22,55
Crusaders,6466,2,16,6,4,61,31,30,54
Glenavon,6466,3,9,9,8,53,45,8,36
Linfield,6466,4,10,5,11,39,39,0,35
Cliftonville,6466,5,10,4,12,35,33,2,34
Ballymena,6466,6,8,4,14,26,47,-21,28
Glentoran,6466,7,6,6,10,24,32,-8,24
Dungannon,6466,8,2,4,16,14,47,-33,10
Crusaders,6467,1,16,7,3,62,31,31,55
Coleraine,6467,2,14,10,2,44,24,20,52
Glenavon,6467,3,10,9,7,54,44,10,39
Linfield,6467,4,11,5,10,38,36,2,38
Cliftonville,6467,5,9,4,13,32,32,0,31
Ballymena,6467,6,7,5,14,26,48,-22,26
Glentoran,6467,7,6,6,10,24,32,-8,24
Dungannon,6467,8,2,4,16,14,47,-33,10
Crusaders,6468,1,16,6,4,61,34,27,54
Coleraine,6468,2,14,11,1,44,23,21,53
Glenavon,6468,3,9,10,7,53,44,9,37
Linfield,6468,4,10,5,11,37,37,0,35
Cliftonville,6468,5,10,4,12,33,31,2,34
Ballymena,6468,6,8,4,14,29,47,-18,28
Glentoran,6468,7,6,6,10,24,32,-8,24
Dungannon,6468,8,2,4,16,14,47,-33,10
Crusaders,6469,1,16,7,3,62,31,31,55
Coleraine,6469,2,14,10,2,43,23,20,52
Glenavon,6469,3,10,9,7,53,43,10,39
Linfield,6469,4,10,5,11,38,38,0,35
Cliftonville,6469,5,10,4,12,34,32,2,34
Ballymena,6469,6,7,5,14,26,48,-22,26
Glentoran,6469,7,6,6,10,24,32,-8,24
Dungannon,6469,8,2,4,16,14,47,-33,10
Crusaders,6470,1,16,7,3,62,31,31,55
Coleraine,6470,2,15,10,1,45,22,23,55
Linfield,6470,3,11,5,10,39,36,3,38
Glenavon,6470,4,9,9,8,52,45,7,36
Cliftonville,6470,5,9,4,13,32,33,-1,31
Ballymena,6470,6,7,5,14,26,48,-22,26
Glentoran,6470,7,6,6,10,24,32,-8,24
Dungannon,6470,8,2,4,16,14,47,-33,10
Crusaders,6471,1,17,6,3,63,31,32,57
Coleraine,6471,2,14,11,1,43,22,21,53
Linfield,6471,3,11,5,10,38,36,2,38
Glenavon,6471,4,9,10,7,52,43,9,37
Cliftonville,6471,5,9,4,13,32,32,0,31
Ballymena,6471,6,7,4,15,26,49,-23,25
Glentoran,6471,7,6,6,10,24,32,-8,24
Dungannon,6471,8,2,4,16,14,47,-33,10
Crusaders,6472,1,17,6,3,65,30,35,57
Coleraine,6472,2,14,10,2,44,24,20,52
Glenavon,6472,3,10,9,7,54,44,10,39
Linfield,6472,4,10,5,11,38,38,0,35
Cliftonville,6472,5,10,4,12,34,32,2,34
Ballymena,6472,6,7,4,15,25,51,-26,25
Glentoran,6472,7,6,6,10,24,32,-8,24
Dungannon,6472,8,2,4,16,14,47,-33,10
Crusaders,6473,1,17,6,3,63,31,32,57
Coleraine,6473,2,14,10,2,44,25,19,52
Glenavon,6473,3,10,9,7,55,44,11,39
Linfield,6473,4,11,5,10,39,36,3,38
Cliftonville,6473,5,9,4,13,32,33,-1,31
Ballymena,6473,6,7,4,15,26,49,-23,25
Glentoran,6473,7,6,6,10,24,32,-8,24
Dungannon,6473,8,2,4,16,14,47,-33,10
Coleraine,6474,1,15,10,1,46,24,22,55
Crusaders,6474,2,16,6,4,61,33,28,54
Linfield,6474,3,11,5,10,38,36,2,38
Glenavon,6474,4,9,9,8,54,46,8,36
Cliftonville,6474,5,9,4,13,32,32,0,31
Ballymena,6474,6,8,4,14,28,47,-19,28
Glentoran,6474,7,6,6,10,24,32,-8,24
Dungannon,6474,8,2,4,16,14,47,-33,10
Crusaders,6475,1,16,6,4,61,33,28,54
Coleraine,6475,2,14,11,1,45,24,21,53
Glenavon,6475,3,9,10,7,54,45,9,37
Linfield,6475,4,10,6,10,38,37,1,36
Cliftonville,6475,5,9,5,12,33,32,1,32
Ballymena,6475,6,8,4,14,28,47,-19,28
Glentoran,6475,7,6,6,10,24,32,-8,24
Dungannon,6475,8,2,4,16,14,47,-33,10
Crusaders,6476,1,17,6,3,66,30,36,57
Coleraine,6476,2,14,10,2,43,25,18,52
Glenavon,6476,3,10,9,7,55,43,12,39
Linfield,6476,4,11,5,10,40,38,2,38
Cliftonville,6476,5,9,4,13,34,34,0,31
Ballymena,6476,6,7,4,15,25,52,-27,25
Glentoran,6476,7,6,6,10,24,32,-8,24
Dungannon,6476,8,2,4,16,14,47,-33,10
Crusaders,6477,1,17,6,3,63,31,32,57
Coleraine,6477,2,14,10,2,43,23,20,52
Glenavon,6477,3,10,9,7,53,43,10,39
Linfield,6477,4,10,6,10,38,37,1,36
Cliftonville,6477,5,9,5,12,33,32,1,32
Ballymena,6477,6,7,4,15,26,49,-23,25
Glentoran,6477,7,6,6,10,24,32,-8,24
Dungannon,6477,8,2,4,16,14,47,-33,10
Crusaders,6478,1,17,6,3,62,30,32,57
Coleraine,6478,2,14,10,2,44,24,20,52
Glenavon,6478,3,10,9,7,54,44,10,39
Linfield,6478,4,10,5,11,38,38,0,35
Cliftonville,6478,5,10,4,12,34,32,2,34
Ballymena,6478,6,7,4,15,25,48,-23,25
Glentoran,6478,7,6,6,10,24,32,-8,24
Dungannon,6478,8,2,4,16,14,47,-33,10
Crusaders,6479,1,17,6,3,64,31,33,57
Coleraine,6479,2,14,11,1,45,24,21,53
Linfield,6479,3,11,5,10,40,37,3,38
Glenavon,6479,4,9,10,7,54,45,9,37
Cliftonville,6479,5,9,4,13,33,34,-1,31
Ballymena,6479,6,7,4,15,26,50,-24,25
Glentoran,6479,7,6,6,10,24,32,-8,24
Dungannon,6479,8,2,4,16,14,47,-33,10
Crusaders,6480,1,17,6,3,63,31,32,57
Coleraine,6480,2,15,10,1,45,22,23,55
Linfield,6480,3,11,5,10,39,36,3,38
Glenavon,6480,4,9,9,8,52,45,7,36
Cliftonville,6480,5,9,4,13,32,33,-1,31
Ballymena,6480,6,7,4,15,26,49,-23,25
Glentoran,6480,7,6,6,10,24,32,-8,24
Dungannon,6480,8,2,4,16,14,47,-33,10
Crusaders,6481,1,17,6,3,63,31,32,57
Coleraine,6481,2,15,10,1,48,25,23,55
Linfield,6481,3,11,5,10,38,36,2,38
Glenavon,6481,4,9,9,8,55,48,7,36
Cliftonville,6481,5,9,4,13,32,32,0,31
Ballymena,6481,6,7,4,15,26,49,-23,25
Glentoran,6481,7,6,6,10,24,32,-8,24
Dungannon,6481,8,2,4,16,14,47,-33,10
Crusaders,6482,1,17,6,3,63,31,32,57
Coleraine,6482,2,14,11,1,46,25,21,53
Linfield,6482,3,11,5,10,42,36,6,38
Glenavon,6482,4,9,10,7,55,46,9,37
Cliftonville,6482,5,9,4,13,32,36,-4,31
Ballymena,6482,6,7,4,15,26,49,-23,25
Glentoran,6482,7,6,6,10,24,32,-8,24
Dungannon,6482,8,2,4,16,14,47,-33,10
Crusaders,6483,1,17,6,3,63,31,32,57
Coleraine,6483,2,14,10,2,44,24,20,52
Glenavon,6483,3,10,9,7,54,44,10,39
Linfield,6483,4,11,5,10,39,37,2,38
Cliftonville,6483,5,9,4,13,33,33,0,31
Ballymena,6483,6,7,4,15,26,49,-23,25
Glentoran,6483,7,6,6,10,24,32,-8,24
Dungannon,6483,8,2,4,16,14,47,-33,10
Crusaders,6484,1,17,6,3,62,30,32,57
Coleraine,6484,2,14,11,1,46,25,21,53
Glenavon,6484,3,9,10,7,55,46,9,37
Linfield,6484,4,10,5,11,38,38,0,35
Cliftonville,6484,5,10,4,12,34,32,2,34
Ballymena,6484,6,7,4,15,25,48,-23,25
Glentoran,6484,7,6,6,10,24,32,-8,24
Dungannon,6484,8,2,4,16,14,47,-33,10
Crusaders,6485,1,17,6,3,65,32,33,57
Coleraine,6485,2,15,10,1,45,23,22,55
Glenavon,6485,3,9,9,8,53,45,8,36
Linfield,6485,4,10,5,11,38,38,0,35
Cliftonville,6485,5,10,4,12,34,32,2,34
Ballymena,6485,6,7,4,15,27,51,-24,25
Glentoran,6485,7,6,6,10,24,32,-8,24
Dungannon,6485,8,2,4,16,14,47,-33,10
Crusaders,6486,1,16,6,4,62,33,29,54
Coleraine,6486,2,14,10,2,43,25,18,52
Glenavon,6486,3,10,9,7,55,43,12,39
Linfield,6486,4,10,6,10,39,38,1,36
Cliftonville,6486,5,9,5,12,34,33,1,32
Ballymena,6486,6,8,4,14,28,48,-20,28
Glentoran,6486,7,6,6,10,24,32,-8,24
Dungannon,6486,8,2,4,16,14,47,-33,10
Crusaders,6487,1,17,6,3,64,32,32,57
Coleraine,6487,2,14,10,2,45,25,20,52
Glenavon,6487,3,10,9,7,55,45,10,39
Linfield,6487,4,10,5,11,39,39,0,35
Cliftonville,6487,5,10,4,12,35,33,2,34
Ballymena,6487,6,7,4,15,27,50,-23,25
Glentoran,6487,7,6,6,10,24,32,-8,24
Dungannon,6487,8,2,4,16,14,47,-33,10
Crusaders,6488,1,17,6,3,67,32,35,57
Coleraine,6488,2,14,11,1,44,23,21,53
Linfield,6488,3,11,5,10,40,37,3,38
Glenavon,6488,4,9,10,7,53,44,9,37
Cliftonville,6488,5,9,4,13,33,34,-1,31
Ballymena,6488,6,7,4,15,27,53,-26,25
Glentoran,6488,7,6,6,10,24,32,-8,24
Dungannon,6488,8,2,4,16,14,47,-33,10
Crusaders,6489,1,17,6,3,63,31,32,57
Coleraine,6489,2,14,10,2,43,23,20,52
Glenavon,6489,3,10,9,7,53,43,10,39
Linfield,6489,4,10,5,11,37,37,0,35
Cliftonville,6489,5,10,4,12,33,31,2,34
Ballymena,6489,6,7,4,15,26,49,-23,25
Glentoran,6489,7,6,6,10,24,32,-8,24
Dungannon,6489,8,2,4,16,14,47,-33,10
Crusaders,6490,1,17,6,3,65,30,35,57
Coleraine,6490,2,15,10,1,46,24,22,55
Linfield,6490,3,11,5,10,38,36,2,38
Glenavon,6490,4,9,9,8,54,46,8,36
Cliftonville,6490,5,9,4,13,32,32,0,31
Ballymena,6490,6,7,4,15,25,51,-26,25
Glentoran,6490,7,6,6,10,24,32,-8,24
Dungannon,6490,8,2,4,16,14,47,-33,10
Coleraine,6491,1,15,10,1,45,22,23,55
Crusaders,6491,2,16,6,4,61,32,29,54
Linfield,6491,3,11,5,10,40,36,4,38
Glenavon,6491,4,9,9,8,52,45,7,36
Cliftonville,6491,5,9,4,13,32,34,-2,31
Ballymena,6491,6,8,4,14,27,47,-20,28
Glentoran,6491,7,6,6,10,24,32,-8,24
Dungannon,6491,8,2,4,16,14,47,-33,10
Crusaders,6492,1,17,6,3,65,30,35,57
Coleraine,6492,2,14,10,2,44,24,20,52
Glenavon,6492,3,10,9,7,54,44,10,39
Linfield,6492,4,11,5,10,38,36,2,38
Cliftonville,6492,5,9,4,13,32,32,0,31
Ballymena,6492,6,7,4,15,25,51,-26,25
Glentoran,6492,7,6,6,10,24,32,-8,24
Dungannon,6492,8,2,4,16,14,47,-33,10
Crusaders,6493,1,17,6,3,64,30,34,57
Coleraine,6493,2,15,10,1,46,24,22,55
Glenavon,6493,3,9,9,8,54,46,8,36
Linfield,6493,4,10,5,11,38,40,-2,35
Cliftonville,6493,5,10,4,12,36,32,4,34
Ballymena,6493,6,7,4,15,25,50,-25,25
Glentoran,6493,7,6,6,10,24,32,-8,24
Dungannon,6493,8,2,4,16,14,47,-33,10
Crusaders,6494,1,16,7,3,61,30,31,55
Coleraine,6494,2,14,10,2,44,25,19,52
Glenavon,6494,3,10,9,7,55,44,11,39
Linfield,6494,4,10,6,10,37,36,1,36
Cliftonville,6494,5,9,5,12,32,31,1,32
Ballymena,6494,6,7,5,14,25,47,-22,26
Glentoran,6494,7,6,6,10,24,32,-8,24
Dungannon,6494,8,2,4,16,14,47,-33,10
Crusaders,6495,1,16,6,4,62,32,30,54
Coleraine,6495,2,14,10,2,43,23,20,52
Glenavon,6495,3,10,9,7,53,43,10,39
Linfield,6495,4,11,5,10,38,36,2,38
Cliftonville,6495,5,9,4,13,32,32,0,31
Ballymena,6495,6,8,4,14,27,48,-21,28
Glentoran,6495,7,6,6,10,24,32,-8,24
Dungannon,6495,8,2,4,16,14,47,-33,10
Coleraine,6496,1,15,10,1,47,24,23,55
Crusaders,6496,2,16,6,4,61,33,28,54
Glenavon,6496,3,9,9,8,54,47,7,36
Linfield,6496,4,10,6,10,37,36,1,36
Cliftonville,6496,5,9,5,12,32,31,1,32
Ballymena,6496,6,8,4,14,28,47,-19,28
Glentoran,6496,7,6,6,10,24,32,-8,24
Dungannon,6496,8,2,4,16,14,47,-33,10
Crusaders,6497,1,16,7,3,61,30,31,55
Coleraine,6497,2,15,10,1,45,22,23,55
Linfield,6497,3,11,5,10,40,36,4,38
Glenavon,6497,4,9,9,8,52,45,7,36
Cliftonville,6497,5,9,4,13,32,34,-2,31
Ballymena,6497,6,7,5,14,25,47,-22,26
Glentoran,6497,7,6,6,10,24,32,-8,24
Dungannon,6497,8,2,4,16,14,47,-33,10
Crusaders,6498,1,17,6,3,64,30,34,57
Coleraine,6498,2,14,10,2,43,24,19,52
Glenavon,6498,3,10,9,7,54,43,11,39
Linfield,6498,4,11,5,10,38,36,2,38
Cliftonville,6498,5,9,4,13,32,32,0,31
Ballymena,6498,6,7,4,15,25,50,-25,25
Glentoran,6498,7,6,6,10,24,32,-8,24
Dungannon,6498,8,2,4,16,14,47,-33,10
Crusaders,6499,1,16,6,4,63,33,30,54
Coleraine,6499,2,14,10,2,44,24,20,52
Glenavon,6499,3,10,9,7,54,44,10,39
Linfield,6499,4,10,5,11,38,38,0,35
Cliftonville,6499,5,10,4,12,34,32,2,34
Ballymena,6499,6,8,4,14,28,49,-21,28
Glentoran,6499,7,6,6,10,24,32,-8,24
Dungannon,6499,8,2,4,16,14,47,-33,10
Crusaders,6500,1,17,6,3,63,31,32,57
Coleraine,6500,2,15,10,1,46,24,22,55
Linfield,6500,3,11,5,10,40,36,4,38
Glenavon,6500,4,9,9,8,54,46,8,36
Cliftonville,6500,5,9,4,13,32,34,-2,31
Ballymena,6500,6,7,4,15,26,49,-23,25
Glentoran,6500,7,6,6,10,24,32,-8,24
Dungannon,6500,8,2,4,16,14,47,-33,10
Crusaders,6501,1,16,7,3,62,31,31,55
Coleraine,6501,2,15,10,1,44,22,22,55
Glenavon,6501,3,9,9,8,52,44,8,36
Linfield,6501,4,10,5,11,38,38,0,35
Cliftonville,6501,5,10,4,12,34,32,2,34
Ballymena,6501,6,7,5,14,26,48,-22,26
Glentoran,6501,7,6,6,10,24,32,-8,24
Dungannon,6501,8,2,4,16,14,47,-33,10
Coleraine,6502,1,15,10,1,45,23,22,55
Crusaders,6502,2,16,6,4,62,32,30,54
Glenavon,6502,3,9,9,8,53,45,8,36
Linfield,6502,4,10,6,10,38,37,1,36
Cliftonville,6502,5,9,5,12,33,32,1,32
Ballymena,6502,6,8,4,14,27,48,-21,28
Glentoran,6502,7,6,6,10,24,32,-8,24
Dungannon,6502,8,2,4,16,14,47,-33,10
Crusaders,6503,1,17,6,3,65,33,32,57
Coleraine,6503,2,14,10,2,43,23,20,52
Glenavon,6503,3,10,9,7,53,43,10,39
Linfield,6503,4,11,5,10,39,36,3,38
Cliftonville,6503,5,9,4,13,32,33,-1,31
Ballymena,6503,6,7,4,15,28,51,-23,25
Glentoran,6503,7,6,6,10,24,32,-8,24
Dungannon,6503,8,2,4,16,14,47,-33,10
Crusaders,6504,1,17,6,3,63,30,33,57
Coleraine,6504,2,14,10,2,45,25,20,52
Glenavon,6504,3,10,9,7,55,45,10,39
Linfield,6504,4,10,6,10,38,37,1,36
Cliftonville,6504,5,9,5,12,33,32,1,32
Ballymena,6504,6,7,4,15,25,49,-24,25
Glentoran,6504,7,6,6,10,24,32,-8,24
Dungannon,6504,8,2,4,16,14,47,-33,10
Crusaders,6505,1,16,6,4,63,34,29,54
Coleraine,6505,2,14,10,2,44,26,18,52
Glenavon,6505,3,10,9,7,56,44,12,39
Linfield,6505,4,10,5,11,38,38,0,35
Cliftonville,6505,5,10,4,12,34,32,2,34
Ballymena,6505,6,8,4,14,29,49,-20,28
Glentoran,6505,7,6,6,10,24,32,-8,24
Dungannon,6505,8,2,4,16,14,47,-33,10
Crusaders,6506,1,17,6,3,64,32,32,57
Coleraine,6506,2,15,10,1,46,23,23,55
Linfield,6506,3,11,5,10,40,36,4,38
Glenavon,6506,4,9,9,8,53,46,7,36
Cliftonville,6506,5,9,4,13,32,34,-2,31
Ballymena,6506,6,7,4,15,27,50,-23,25
Glentoran,6506,7,6,6,10,24,32,-8,24
Dungannon,6506,8,2,4,16,14,47,-33,10
Crusaders,6507,1,16,7,3,63,32,31,55
Coleraine,6507,2,14,10,2,44,24,20,52
Glenavon,6507,3,10,9,7,54,44,10,39
Linfield,6507,4,11,5,10,38,36,2,38
Cliftonville,6507,5,9,4,13,32,32,0,31
Ballymena,6507,6,7,5,14,27,49,-22,26
Glentoran,6507,7,6,6,10,24,32,-8,24
Dungannon,6507,8,2,4,16,14,47,-33,10
Crusaders,6508,1,17,6,3,66,32,34,57
Coleraine,6508,2,14,11,1,45,24,21,53
Linfield,6508,3,11,5,10,40,36,4,38
Glenavon,6508,4,9,10,7,54,45,9,37
Cliftonville,6508,5,9,4,13,32,34,-2,31
Ballymena,6508,6,7,4,15,27,52,-25,25
Glentoran,6508,7,6,6,10,24,32,-8,24
Dungannon,6508,8,2,4,16,14,47,-33,10
Crusaders,6509,1,17,6,3,63,30,33,57
Coleraine,6509,2,14,10,2,43,24,19,52
Glenavon,6509,3,10,9,7,54,43,11,39
Linfield,6509,4,10,5,11,37,39,-2,35
Cliftonville,6509,5,10,4,12,35,31,4,34
Ballymena,6509,6,7,4,15,25,49,-24,25
Glentoran,6509,7,6,6,10,24,32,-8,24
Dungannon,6509,8,2,4,16,14,47,-33,10
Crusaders,6510,1,17,6,3,62,30,32,57
Coleraine,6510,2,14,10,2,43,25,18,52
Glenavon,6510,3,10,9,7,55,43,12,39
Linfield,6510,4,10,6,10,37,36,1,36
Cliftonville,6510,5,9,5,12,32,31,1,32
Ballymena,6510,6,7,4,15,25,48,-23,25
Glentoran,6510,7,6,6,10,24,32,-8,24
Dungannon,6510,8,2,4,16,14,47,-33,10
Crusaders,6511,1,16,7,3,63,32,31,55
Coleraine,6511,2,14,11,1,43,22,21,53
Glenavon,6511,3,9,10,7,52,43,9,37
Linfield,6511,4,10,5,11,37,39,-2,35
Cliftonville,6511,5,10,4,12,35,31,4,34
Ballymena,6511,6,7,5,14,27,49,-22,26
Glentoran,6511,7,6,6,10,24,32,-8,24
Dungannon,6511,8,2,4,16,14,47,-33,10
Crusaders,6512,1,17,6,3,67,31,36,57
Coleraine,6512,2,14,11,1,45,24,21,53
Linfield,6512,3,11,5,10,38,36,2,38
Glenavon,6512,4,9,10,7,54,45,9,37
Cliftonville,6512,5,9,4,13,32,32,0,31
Ballymena,6512,6,7,4,15,26,53,-27,25
Glentoran,6512,7,6,6,10,24,32,-8,24
Dungannon,6512,8,2,4,16,14,47,-33,10
Crusaders,6513,1,17,6,3,63,31,32,57
Coleraine,6513,2,14,11,1,43,22,21,53
Glenavon,6513,3,9,10,7,52,43,9,37
Linfield,6513,4,10,5,11,38,38,0,35
Cliftonville,6513,5,10,4,12,34,32,2,34
Ballymena,6513,6,7,4,15,26,49,-23,25
Glentoran,6513,7,6,6,10,24,32,-8,24
Dungannon,6513,8,2,4,16,14,47,-33,10
Crusaders,6514,1,16,7,3,63,32,31,55
Coleraine,6514,2,15,10,1,45,22,23,55
Linfield,6514,3,11,5,10,38,36,2,38
Glenavon,6514,4,9,9,8,52,45,7,36
Cliftonville,6514,5,9,4,13,32,32,0,31
Ballymena,6514,6,7,5,14,27,49,-22,26
Glentoran,6514,7,6,6,10,24,32,-8,24
Dungannon,6514,8,2,4,16,14,47,-33,10
Crusaders,6515,1,17,6,3,67,30,37,57
Coleraine,6515,2,14,10,2,44,25,19,52
Glenavon,6515,3,10,9,7,55,44,11,39
Linfield,6515,4,10,6,10,37,36,1,36
Cliftonville,6515,5,9,5,12,32,31,1,32
Ballymena,6515,6,7,4,15,25,53,-28,25
Glentoran,6515,7,6,6,10,24,32,-8,24
Dungannon,6515,8,2,4,16,14,47,-33,10
Crusaders,6516,1,17,6,3,63,30,33,57
Coleraine,6516,2,14,10,2,44,25,19,52
Glenavon,6516,3,10,9,7,55,44,11,39
Linfield,6516,4,11,5,10,38,36,2,38
Cliftonville,6516,5,9,4,13,32,32,0,31
Ballymena,6516,6,7,4,15,25,49,-24,25
Glentoran,6516,7,6,6,10,24,32,-8,24
Dungannon,6516,8,2,4,16,14,47,-33,10
Crusaders,6517,1,17,6,3,63,30,33,57
Coleraine,6517,2,15,10,1,44,22,22,55
Glenavon,6517,3,9,9,8,52,44,8,36
Linfield,6517,4,10,6,10,38,37,1,36
Cliftonville,6517,5,9,5,12,33,32,1,32
Ballymena,6517,6,7,4,15,25,49,-24,25
Glentoran,6517,7,6,6,10,24,32,-8,24
Dungannon,6517,8,2,4,16,14,47,-33,10
Crusaders,6518,1,17,6,3,64,30,34,57
Coleraine,6518,2,14,10,2,43,24,19,52
Glenavon,6518,3,10,9,7,54,43,11,39
Linfield,6518,4,11,5,10,38,36,2,38
Cliftonville,6518,5,9,4,13,32,32,0,31
Ballymena,6518,6,7,4,15,25,50,-25,25
Glentoran,6518,7,6,6,10,24,32,-8,24
Dungannon,6518,8,2,4,16,14,47,-33,10
Crusaders,6519,1,16,7,3,63,32,31,55
Coleraine,6519,2,14,10,2,44,25,19,52
Glenavon,6519,3,10,9,7,55,44,11,39
Linfield,6519,4,10,5,11,37,38,-1,35
Cliftonville,6519,5,10,4,12,34,31,3,34
Ballymena,6519,6,7,5,14,27,49,-22,26
Glentoran,6519,7,6,6,10,24,32,-8,24
Dungannon,6519,8,2,4,16,14,47,-33,10
Crusaders,6520,1,17,6,3,63,30,33,57
Coleraine,6520,2,15,10,1,45,23,22,55
Glenavon,6520,3,9,9,8,53,45,8,36
Linfield,6520,4,10,6,10,38,37,1,36
Cliftonville,6520,5,9,5,12,33,32,1,32
Ballymena,6520,6,7,4,15,25,49,-24,25
Glentoran,6520,7,6,6,10,24,32,-8,24
Dungannon,6520,8,2,4,16,14,47,-33,10
Crusaders,6521,1,17,6,3,63,30,33,57
Coleraine,6521,2,15,10,1,45,23,22,55
Linfield,6521,3,11,5,10,39,37,2,38
Glenavon,6521,4,9,9,8,53,45,8,36
Cliftonville,6521,5,9,4,13,33,33,0,31
Ballymena,6521,6,7,4,15,25,49,-24,25
Glentoran,6521,7,6,6,10,24,32,-8,24
Dungannon,6521,8,2,4,16,14,47,-33,10
Crusaders,6522,1,16,7,3,61,30,31,55
Coleraine,6522,2,14,10,2,44,25,19,52
Glenavon,6522,3,10,9,7,55,44,11,39
Linfield,6522,4,10,6,10,37,36,1,36
Cliftonville,6522,5,9,5,12,32,31,1,32
Ballymena,6522,6,7,5,14,25,47,-22,26
Glentoran,6522,7,6,6,10,24,32,-8,24
Dungannon,6522,8,2,4,16,14,47,-33,10
Crusaders,6523,1,16,7,3,63,32,31,55
Coleraine,6523,2,14,11,1,44,23,21,53
Glenavon,6523,3,9,10,7,53,44,9,37
Linfield,6523,4,10,5,11,38,38,0,35
Cliftonville,6523,5,10,4,12,34,32,2,34
Ballymena,6523,6,7,5,14,27,49,-22,26
Glentoran,6523,7,6,6,10,24,32,-8,24
Dungannon,6523,8,2,4,16,14,47,-33,10
Crusaders,6524,1,17,6,3,63,31,32,57
Coleraine,6524,2,14,10,2,43,23,20,52
Glenavon,6524,3,10,9,7,53,43,10,39
Linfield,6524,4,11,5,10,38,36,2,38
Cliftonville,6524,5,9,4,13,32,32,0,31
Ballymena,6524,6,7,4,15,26,49,-23,25
Glentoran,6524,7,6,6,10,24,32,-8,24
Dungannon,6524,8,2,4,16,14,47,-33,10
Crusaders,6525,1,16,6,4,61,31,30,54
Coleraine,6525,2,14,10,2,43,24,19,52
Glenavon,6525,3,10,9,7,54,43,11,39
Linfield,6525,4,10,5,11,37,37,0,35
Cliftonville,6525,5,10,4,12,33,31,2,34
Ballymena,6525,6,8,4,14,26,47,-21,28
Glentoran,6525,7,6,6,10,24,32,-8,24
Dungannon,6525,8,2,4,16,14,47,-33,10
Crusaders,6526,1,17,6,3,63,31,32,57
Coleraine,6526,2,14,10,2,44,24,20,52
Glenavon,6526,3,10,9,7,54,44,10,39
Linfield,6526,4,10,6,10,38,37,1,36
Cliftonville,6526,5,9,5,12,33,32,1,32
Ballymena,6526,6,7,4,15,26,49,-23,25
Glentoran,6526,7,6,6,10,24,32,-8,24
Dungannon,6526,8,2,4,16,14,47,-33,10
Crusaders,6527,1,17,6,3,63,31,32,57
Coleraine,6527,2,14,10,2,43,23,20,52
Glenavon,6527,3,10,9,7,53,43,10,39
Linfield,6527,4,10,6,10,38,37,1,36
Cliftonville,6527,5,9,5,12,33,32,1,32
Ballymena,6527,6,7,4,15,26,49,-23,25
Glentoran,6527,7,6,6,10,24,32,-8,24
Dungannon,6527,8,2,4,16,14,47,-33,10
Crusaders,6528,1,16,6,4,61,31,30,54
Coleraine,6528,2,14,10,2,43,27,16,52
Glenavon,6528,3,10,9,7,57,43,14,39
Linfield,6528,4,10,6,10,38,37,1,36
Cliftonville,6528,5,9,5,12,33,32,1,32
Ballymena,6528,6,8,4,14,26,47,-21,28
Glentoran,6528,7,6,6,10,24,32,-8,24
Dungannon,6528,8,2,4,16,14,47,-33,10
Crusaders,6529,1,16,7,3,62,31,31,55
Coleraine,6529,2,15,10,1,45,23,22,55
Glenavon,6529,3,9,9,8,53,45,8,36
Linfield,6529,4,10,6,10,39,38,1,36
Cliftonville,6529,5,9,5,12,34,33,1,32
Ballymena,6529,6,7,5,14,26,48,-22,26
Glentoran,6529,7,6,6,10,24,32,-8,24
Dungannon,6529,8,2,4,16,14,47,-33,10
Crusaders,6530,1,17,6,3,63,30,33,57
Coleraine,6530,2,14,10,2,44,25,19,52
Glenavon,6530,3,10,9,7,55,44,11,39
Linfield,6530,4,11,5,10,40,37,3,38
Cliftonville,6530,5,9,4,13,33,34,-1,31
Ballymena,6530,6,7,4,15,25,49,-24,25
Glentoran,6530,7,6,6,10,24,32,-8,24
Dungannon,6530,8,2,4,16,14,47,-33,10
Crusaders,6531,1,16,6,4,62,34,28,54
Coleraine,6531,2,14,11,1,43,22,21,53
Glenavon,6531,3,9,10,7,52,43,9,37
Linfield,6531,4,10,5,11,38,38,0,35
Cliftonville,6531,5,10,4,12,34,32,2,34
Ballymena,6531,6,8,4,14,29,48,-19,28
Glentoran,6531,7,6,6,10,24,32,-8,24
Dungannon,6531,8,2,4,16,14,47,-33,10
Crusaders,6532,1,16,6,4,63,34,29,54
Coleraine,6532,2,14,11,1,45,24,21,53
Linfield,6532,3,11,5,10,38,36,2,38
Glenavon,6532,4,9,10,7,54,45,9,37
Cliftonville,6532,5,9,4,13,32,32,0,31
Ballymena,6532,6,8,4,14,29,49,-20,28
Glentoran,6532,7,6,6,10,24,32,-8,24
Dungannon,6532,8,2,4,16,14,47,-33,10
Crusaders,6533,1,17,6,3,63,31,32,57
Coleraine,6533,2,14,10,2,43,24,19,52
Glenavon,6533,3,10,9,7,54,43,11,39
Linfield,6533,4,11,5,10,39,36,3,38
Cliftonville,6533,5,9,4,13,32,33,-1,31
Ballymena,6533,6,7,4,15,26,49,-23,25
Glentoran,6533,7,6,6,10,24,32,-8,24
Dungannon,6533,8,2,4,16,14,47,-33,10
Crusaders,6534,1,17,6,3,64,30,34,57
Coleraine,6534,2,14,10,2,43,23,20,52
Glenavon,6534,3,10,9,7,53,43,10,39
Linfield,6534,4,11,5,10,38,36,2,38
Cliftonville,6534,5,9,4,13,32,32,0,31
Ballymena,6534,6,7,4,15,25,50,-25,25
Glentoran,6534,7,6,6,10,24,32,-8,24
Dungannon,6534,8,2,4,16,14,47,-33,10
Crusaders,6535,1,17,6,3,62,30,32,57
Coleraine,6535,2,14,11,1,46,25,21,53
Glenavon,6535,3,9,10,7,55,46,9,37
Linfield,6535,4,10,5,11,37,37,0,35
Cliftonville,6535,5,10,4,12,33,31,2,34
Ballymena,6535,6,7,4,15,25,48,-23,25
Glentoran,6535,7,6,6,10,24,32,-8,24
Dungannon,6535,8,2,4,16,14,47,-33,10
Crusaders,6536,1,17,6,3,65,32,33,57
Coleraine,6536,2,15,10,1,45,23,22,55
Glenavon,6536,3,9,9,8,53,45,8,36
Linfield,6536,4,10,6,10,37,36,1,36
Cliftonville,6536,5,9,5,12,32,31,1,32
Ballymena,6536,6,7,4,15,27,51,-24,25
Glentoran,6536,7,6,6,10,24,32,-8,24
Dungannon,6536,8,2,4,16,14,47,-33,10
Crusaders,6537,1,16,7,3,62,31,31,55
Coleraine,6537,2,14,10,2,43,25,18,52
Glenavon,6537,3,10,9,7,55,43,12,39
Linfield,6537,4,10,5,11,38,38,0,35
Cliftonville,6537,5,10,4,12,34,32,2,34
Ballymena,6537,6,7,5,14,26,48,-22,26
Glentoran,6537,7,6,6,10,24,32,-8,24
Dungannon,6537,8,2,4,16,14,47,-33,10
Crusaders,6538,1,17,6,3,65,33,32,57
Coleraine,6538,2,14,10,2,45,27,18,52
Glenavon,6538,3,10,9,7,57,45,12,39
Linfield,6538,4,11,5,10,40,36,4,38
Cliftonville,6538,5,9,4,13,32,34,-2,31
Ballymena,6538,6,7,4,15,28,51,-23,25
Glentoran,6538,7,6,6,10,24,32,-8,24
Dungannon,6538,8,2,4,16,14,47,-33,10
Crusaders,6539,1,17,6,3,64,32,32,57
Coleraine,6539,2,14,10,2,43,26,17,52
Glenavon,6539,3,10,9,7,56,43,13,39
Linfield,6539,4,10,6,10,38,37,1,36
Cliftonville,6539,5,9,5,12,33,32,1,32
Ballymena,6539,6,7,4,15,27,50,-23,25
Glentoran,6539,7,6,6,10,24,32,-8,24
Dungannon,6539,8,2,4,16,14,47,-33,10
Crusaders,6540,1,16,6,4,61,32,29,54
Coleraine,6540,2,14,11,1,45,24,21,53
Linfield,6540,3,11,5,10,38,36,2,38
Glenavon,6540,4,9,10,7,54,45,9,37
Cliftonville,6540,5,9,4,13,32,32,0,31
Ballymena,6540,6,8,4,14,27,47,-20,28
Glentoran,6540,7,6,6,10,24,32,-8,24
Dungannon,6540,8,2,4,16,14,47,-33,10
Coleraine,6541,1,15,10,1,45,23,22,55
Crusaders,6541,2,16,6,4,61,31,30,54
Glenavon,6541,3,9,9,8,53,45,8,36
Linfield,6541,4,10,6,10,38,37,1,36
Cliftonville,6541,5,9,5,12,33,32,1,32
Ballymena,6541,6,8,4,14,26,47,-21,28
Glentoran,6541,7,6,6,10,24,32,-8,24
Dungannon,6541,8,2,4,16,14,47,-33,10
Crusaders,6542,1,17,6,3,62,30,32,57
Coleraine,6542,2,14,10,2,44,24,20,52
Glenavon,6542,3,10,9,7,54,44,10,39
Linfield,6542,4,11,5,10,41,38,3,38
Cliftonville,6542,5,9,4,13,34,35,-1,31
Ballymena,6542,6,7,4,15,25,48,-23,25
Glentoran,6542,7,6,6,10,24,32,-8,24
Dungannon,6542,8,2,4,16,14,47,-33,10
Crusaders,6543,1,17,6,3,64,31,33,57
Coleraine,6543,2,14,11,1,44,23,21,53
Glenavon,6543,3,9,10,7,53,44,9,37
Linfield,6543,4,10,6,10,38,37,1,36
Cliftonville,6543,5,9,5,12,33,32,1,32
Ballymena,6543,6,7,4,15,26,50,-24,25
Glentoran,6543,7,6,6,10,24,32,-8,24
Dungannon,6543,8,2,4,16,14,47,-33,10
Crusaders,6544,1,17,6,3,62,30,32,57
Coleraine,6544,2,14,10,2,44,24,20,52
Glenavon,6544,3,10,9,7,54,44,10,39
Linfield,6544,4,11,5,10,40,36,4,38
Cliftonville,6544,5,9,4,13,32,34,-2,31
Ballymena,6544,6,7,4,15,25,48,-23,25
Glentoran,6544,7,6,6,10,24,32,-8,24
Dungannon,6544,8,2,4,16,14,47,-33,10
Crusaders,6545,1,17,6,3,63,31,32,57
Coleraine,6545,2,14,10,2,45,25,20,52
Glenavon,6545,3,10,9,7,55,45,10,39
Linfield,6545,4,11,5,10,41,37,4,38
Cliftonville,6545,5,9,4,13,33,35,-2,31
Ballymena,6545,6,7,4,15,26,49,-23,25
Glentoran,6545,7,6,6,10,24,32,-8,24
Dungannon,6545,8,2,4,16,14,47,-33,10
Crusaders,6546,1,17,6,3,62,30,32,57
Coleraine,6546,2,14,10,2,44,24,20,52
Glenavon,6546,3,10,9,7,54,44,10,39
Linfield,6546,4,11,5,10,38,36,2,38
Cliftonville,6546,5,9,4,13,32,32,0,31
Ballymena,6546,6,7,4,15,25,48,-23,25
Glentoran,6546,7,6,6,10,24,32,-8,24
Dungannon,6546,8,2,4,16,14,47,-33,10
Coleraine,6547,1,15,10,1,46,22,24,55
Crusaders,6547,2,16,6,4,61,31,30,54
Linfield,6547,3,11,5,10,39,37,2,38
Glenavon,6547,4,9,9,8,52,46,6,36
Cliftonville,6547,5,9,4,13,33,33,0,31
Ballymena,6547,6,8,4,14,26,47,-21,28
Glentoran,6547,7,6,6,10,24,32,-8,24
Dungannon,6547,8,2,4,16,14,47,-33,10
Crusaders,6548,1,16,7,3,63,32,31,55
Coleraine,6548,2,14,10,2,43,26,17,52
Glenavon,6548,3,10,9,7,56,43,13,39
Linfield,6548,4,11,5,10,39,37,2,38
Cliftonville,6548,5,9,4,13,33,33,0,31
Ballymena,6548,6,7,5,14,27,49,-22,26
Glentoran,6548,7,6,6,10,24,32,-8,24
Dungannon,6548,8,2,4,16,14,47,-33,10
Crusaders,6549,1,17,6,3,66,32,34,57
Coleraine,6549,2,15,10,1,46,23,23,55
Glenavon,6549,3,9,9,8,53,46,7,36
Linfield,6549,4,10,5,11,38,38,0,35
Cliftonville,6549,5,10,4,12,34,32,2,34
Ballymena,6549,6,7,4,15,27,52,-25,25
Glentoran,6549,7,6,6,10,24,32,-8,24
Dungannon,6549,8,2,4,16,14,47,-33,10
Crusaders,6550,1,17,6,3,64,30,34,57
Coleraine,6550,2,14,10,2,44,25,19,52
Glenavon,6550,3,10,9,7,55,44,11,39
Linfield,6550,4,11,5,10,39,37,2,38
Cliftonville,6550,5,9,4,13,33,33,0,31
Ballymena,6550,6,7,4,15,25,50,-25,25
Glentoran,6550,7,6,6,10,24,32,-8,24
Dungannon,6550,8,2,4,16,14,47,-33,10
Crusaders,6551,1,17,6,3,63,30,33,57
Coleraine,6551,2,15,10,1,44,22,22,55
Linfield,6551,3,11,5,10,39,37,2,38
Glenavon,6551,4,9,9,8,52,44,8,36
Cliftonville,6551,5,9,4,13,33,33,0,31
Ballymena,6551,6,7,4,15,25,49,-24,25
Glentoran,6551,7,6,6,10,24,32,-8,24
Dungannon,6551,8,2,4,16,14,47,-33,10
Coleraine,6552,1,15,10,1,44,22,22,55
Crusaders,6552,2,16,6,4,63,33,30,54
Linfield,6552,3,11,5,10,40,37,3,38
Glenavon,6552,4,9,9,8,52,44,8,36
Cliftonville,6552,5,9,4,13,33,34,-1,31
Ballymena,6552,6,8,4,14,28,49,-21,28
Glentoran,6552,7,6,6,10,24,32,-8,24
Dungannon,6552,8,2,4,16,14,47,-33,10
Crusaders,6553,1,16,7,3,61,30,31,55
Coleraine,6553,2,15,10,1,44,22,22,55
Glenavon,6553,3,9,9,8,52,44,8,36
Linfield,6553,4,10,5,11,38,38,0,35
Cliftonville,6553,5,10,4,12,34,32,2,34
Ballymena,6553,6,7,5,14,25,47,-22,26
Glentoran,6553,7,6,6,10,24,32,-8,24
Dungannon,6553,8,2,4,16,14,47,-33,10
Crusaders,6554,1,17,6,3,64,32,32,57
Coleraine,6554,2,14,10,2,44,25,19,52
Glenavon,6554,3,10,9,7,55,44,11,39
Linfield,6554,4,11,5,10,39,37,2,38
Cliftonville,6554,5,9,4,13,33,33,0,31
Ballymena,6554,6,7,4,15,27,50,-23,25
Glentoran,6554,7,6,6,10,24,32,-8,24
Dungannon,6554,8,2,4,16,14,47,-33,10
Crusaders,6555,1,17,6,3,63,30,33,57
Coleraine,6555,2,15,10,1,46,22,24,55
Glenavon,6555,3,9,9,8,52,46,6,36
Linfield,6555,4,10,5,11,37,37,0,35
Cliftonville,6555,5,10,4,12,33,31,2,34
Ballymena,6555,6,7,4,15,25,49,-24,25
Glentoran,6555,7,6,6,10,24,32,-8,24
Dungannon,6555,8,2,4,16,14,47,-33,10
Crusaders,6556,1,16,7,3,62,31,31,55
Coleraine,6556,2,15,10,1,45,23,22,55
Linfield,6556,3,11,5,10,38,36,2,38
Glenavon,6556,4,9,9,8,53,45,8,36
Cliftonville,6556,5,9,4,13,32,32,0,31
Ballymena,6556,6,7,5,14,26,48,-22,26
Glentoran,6556,7,6,6,10,24,32,-8,24
Dungannon,6556,8,2,4,16,14,47,-33,10
Crusaders,6557,1,16,7,3,61,30,31,55
Coleraine,6557,2,14,11,1,45,24,21,53
Linfield,6557,3,11,5,10,40,38,2,38
Glenavon,6557,4,9,10,7,54,45,9,37
Cliftonville,6557,5,9,4,13,34,34,0,31
Ballymena,6557,6,7,5,14,25,47,-22,26
Glentoran,6557,7,6,6,10,24,32,-8,24
Dungannon,6557,8,2,4,16,14,47,-33,10
Crusaders,6558,1,16,6,4,62,34,28,54
Coleraine,6558,2,14,11,1,44,23,21,53
Linfield,6558,3,11,5,10,42,37,5,38
Glenavon,6558,4,9,10,7,53,44,9,37
Cliftonville,6558,5,9,4,13,33,36,-3,31
Ballymena,6558,6,8,4,14,29,48,-19,28
Glentoran,6558,7,6,6,10,24,32,-8,24
Dungannon,6558,8,2,4,16,14,47,-33,10
Crusaders,6559,1,17,6,3,63,30,33,57
Coleraine,6559,2,14,10,2,44,29,15,52
Glenavon,6559,3,10,9,7,59,44,15,39
Linfield,6559,4,11,5,10,38,36,2,38
Cliftonville,6559,5,9,4,13,32,32,0,31
Ballymena,6559,6,7,4,15,25,49,-24,25
Glentoran,6559,7,6,6,10,24,32,-8,24
Dungannon,6559,8,2,4,16,14,47,-33,10
Crusaders,6560,1,17,6,3,62,30,32,57
Coleraine,6560,2,14,10,2,44,24,20,52
Glenavon,6560,3,10,9,7,54,44,10,39
Linfield,6560,4,11,5,10,40,37,3,38
Cliftonville,6560,5,9,4,13,33,34,-1,31
Ballymena,6560,6,7,4,15,25,48,-23,25
Glentoran,6560,7,6,6,10,24,32,-8,24
Dungannon,6560,8,2,4,16,14,47,-33,10
Crusaders,6561,1,17,6,3,63,30,33,57
Coleraine,6561,2,14,10,2,45,25,20,52
Glenavon,6561,3,10,9,7,55,45,10,39
Linfield,6561,4,10,6,10,37,36,1,36
Cliftonville,6561,5,9,5,12,32,31,1,32
Ballymena,6561,6,7,4,15,25,49,-24,25
Glentoran,6561,7,6,6,10,24,32,-8,24
Dungannon,6561,8,2,4,16,14,47,-33,10
Coleraine,6562,1,15,10,1,46,24,22,55
Crusaders,6562,2,16,6,4,64,34,30,54
Glenavon,6562,3,9,9,8,54,46,8,36
Linfield,6562,4,10,5,11,37,37,0,35
Cliftonville,6562,5,10,4,12,33,31,2,34
Ballymena,6562,6,8,4,14,29,50,-21,28
Glentoran,6562,7,6,6,10,24,32,-8,24
Dungannon,6562,8,2,4,16,14,47,-33,10
Crusaders,6563,1,17,6,3,64,31,33,57
Coleraine,6563,2,15,10,1,46,22,24,55
Glenavon,6563,3,9,9,8,52,46,6,36
Linfield,6563,4,10,6,10,38,37,1,36
Cliftonville,6563,5,9,5,12,33,32,1,32
Ballymena,6563,6,7,4,15,26,50,-24,25
Glentoran,6563,7,6,6,10,24,32,-8,24
Dungannon,6563,8,2,4,16,14,47,-33,10
Crusaders,6564,1,16,7,3,64,33,31,55
Coleraine,6564,2,14,10,2,43,25,18,52
Glenavon,6564,3,10,9,7,55,43,12,39
Linfield,6564,4,10,6,10,38,37,1,36
Cliftonville,6564,5,9,5,12,33,32,1,32
Ballymena,6564,6,7,5,14,28,50,-22,26
Glentoran,6564,7,6,6,10,24,32,-8,24
Dungannon,6564,8,2,4,16,14,47,-33,10
Crusaders,6565,1,17,6,3,64,31,33,57
Coleraine,6565,2,14,10,2,43,25,18,52
Glenavon,6565,3,10,9,7,55,43,12,39
Linfield,6565,4,10,6,10,37,36,1,36
Cliftonville,6565,5,9,5,12,32,31,1,32
Ballymena,6565,6,7,4,15,26,50,-24,25
Glentoran,6565,7,6,6,10,24,32,-8,24
Dungannon,6565,8,2,4,16,14,47,-33,10
Crusaders,6566,1,17,6,3,63,30,33,57
Coleraine,6566,2,14,10,2,45,25,20,52
Glenavon,6566,3,10,9,7,55,45,10,39
Linfield,6566,4,10,5,11,38,38,0,35
Cliftonville,6566,5,10,4,12,34,32,2,34
Ballymena,6566,6,7,4,15,25,49,-24,25
Glentoran,6566,7,6,6,10,24,32,-8,24
Dungannon,6566,8,2,4,16,14,47,-33,10
Crusaders,6567,1,16,7,3,63,32,31,55
Coleraine,6567,2,14,11,1,43,22,21,53
Linfield,6567,3,11,5,10,40,36,4,38
Glenavon,6567,4,9,10,7,52,43,9,37
Cliftonville,6567,5,9,4,13,32,34,-2,31
Ballymena,6567,6,7,5,14,27,49,-22,26
Glentoran,6567,7,6,6,10,24,32,-8,24
Dungannon,6567,8,2,4,16,14,47,-33,10
Coleraine,6568,1,15,10,1,46,22,24,55
Crusaders,6568,2,16,6,4,61,31,30,54
Linfield,6568,3,11,5,10,39,36,3,38
Glenavon,6568,4,9,9,8,52,46,6,36
Cliftonville,6568,5,9,4,13,32,33,-1,31
Ballymena,6568,6,8,4,14,26,47,-21,28
Glentoran,6568,7,6,6,10,24,32,-8,24
Dungannon,6568,8,2,4,16,14,47,-33,10
Crusaders,6569,1,16,7,3,61,30,31,55
Coleraine,6569,2,14,10,2,44,25,19,52
Glenavon,6569,3,10,9,7,55,44,11,39
Linfield,6569,4,10,6,10,37,36,1,36
Cliftonville,6569,5,9,5,12,32,31,1,32
Ballymena,6569,6,7,5,14,25,47,-22,26
Glentoran,6569,7,6,6,10,24,32,-8,24
Dungannon,6569,8,2,4,16,14,47,-33,10
Crusaders,6570,1,17,6,3,65,31,34,57
Coleraine,6570,2,14,10,2,43,24,19,52
Glenavon,6570,3,10,9,7,54,43,11,39
Linfield,6570,4,10,5,11,37,39,-2,35
Cliftonville,6570,5,10,4,12,35,31,4,34
Ballymena,6570,6,7,4,15,26,51,-25,25
Glentoran,6570,7,6,6,10,24,32,-8,24
Dungannon,6570,8,2,4,16,14,47,-33,10
Crusaders,6571,1,17,6,3,64,30,34,57
Coleraine,6571,2,14,10,2,43,24,19,52
Glenavon,6571,3,10,9,7,54,43,11,39
Linfield,6571,4,11,5,10,38,36,2,38
Cliftonville,6571,5,9,4,13,32,32,0,31
Ballymena,6571,6,7,4,15,25,50,-25,25
Glentoran,6571,7,6,6,10,24,32,-8,24
Dungannon,6571,8,2,4,16,14,47,-33,10
Coleraine,6572,1,15,10,1,47,25,22,55
Crusaders,6572,2,16,6,4,62,32,30,54
Glenavon,6572,3,9,9,8,55,47,8,36
Linfield,6572,4,10,5,11,37,37,0,35
Cliftonville,6572,5,10,4,12,33,31,2,34
Ballymena,6572,6,8,4,14,27,48,-21,28
Glentoran,6572,7,6,6,10,24,32,-8,24
Dungannon,6572,8,2,4,16,14,47,-33,10
Crusaders,6573,1,17,6,3,64,31,33,57
Coleraine,6573,2,15,10,1,45,23,22,55
Glenavon,6573,3,9,9,8,53,45,8,36
Linfield,6573,4,10,6,10,38,37,1,36
Cliftonville,6573,5,9,5,12,33,32,1,32
Ballymena,6573,6,7,4,15,26,50,-24,25
Glentoran,6573,7,6,6,10,24,32,-8,24
Dungannon,6573,8,2,4,16,14,47,-33,10
Crusaders,6574,1,17,6,3,63,31,32,57
Coleraine,6574,2,14,10,2,43,23,20,52
Glenavon,6574,3,10,9,7,53,43,10,39
Linfield,6574,4,11,5,10,40,38,2,38
Cliftonville,6574,5,9,4,13,34,34,0,31
Ballymena,6574,6,7,4,15,26,49,-23,25
Glentoran,6574,7,6,6,10,24,32,-8,24
Dungannon,6574,8,2,4,16,14,47,-33,10
Crusaders,6575,1,17,6,3,63,30,33,57
Coleraine,6575,2,14,11,1,44,23,21,53
Glenavon,6575,3,9,10,7,53,44,9,37
Linfield,6575,4,10,6,10,38,37,1,36
Cliftonville,6575,5,9,5,12,33,32,1,32
Ballymena,6575,6,7,4,15,25,49,-24,25
Glentoran,6575,7,6,6,10,24,32,-8,24
Dungannon,6575,8,2,4,16,14,47,-33,10
Crusaders,6576,1,17,6,3,63,31,32,57
Coleraine,6576,2,14,10,2,44,25,19,52
Glenavon,6576,3,10,9,7,55,44,11,39
Linfield,6576,4,11,5,10,38,36,2,38
Cliftonville,6576,5,9,4,13,32,32,0,31
Ballymena,6576,6,7,4,15,26,49,-23,25
Glentoran,6576,7,6,6,10,24,32,-8,24
Dungannon,6576,8,2,4,16,14,47,-33,10
Crusaders,6577,1,16,7,3,61,30,31,55
Coleraine,6577,2,14,10,2,44,27,17,52
Glenavon,6577,3,10,9,7,57,44,13,39
Linfield,6577,4,10,6,10,39,38,1,36
Cliftonville,6577,5,9,5,12,34,33,1,32
Ballymena,6577,6,7,5,14,25,47,-22,26
Glentoran,6577,7,6,6,10,24,32,-8,24
Dungannon,6577,8,2,4,16,14,47,-33,10
Crusaders,6578,1,17,6,3,65,32,33,57
Coleraine,6578,2,15,10,1,45,23,22,55
Glenavon,6578,3,9,9,8,53,45,8,36
Linfield,6578,4,10,6,10,37,36,1,36
Cliftonville,6578,5,9,5,12,32,31,1,32
Ballymena,6578,6,7,4,15,27,51,-24,25
Glentoran,6578,7,6,6,10,24,32,-8,24
Dungannon,6578,8,2,4,16,14,47,-33,10
Crusaders,6579,1,16,7,3,61,30,31,55
Coleraine,6579,2,14,11,1,43,22,21,53
Linfield,6579,3,11,5,10,38,36,2,38
Glenavon,6579,4,9,10,7,52,43,9,37
Cliftonville,6579,5,9,4,13,32,32,0,31
Ballymena,6579,6,7,5,14,25,47,-22,26
Glentoran,6579,7,6,6,10,24,32,-8,24
Dungannon,6579,8,2,4,16,14,47,-33,10
Crusaders,6580,1,17,6,3,62,30,32,57
Coleraine,6580,2,14,10,2,44,24,20,52
Glenavon,6580,3,10,9,7,54,44,10,39
Linfield,6580,4,11,5,10,39,36,3,38
Cliftonville,6580,5,9,4,13,32,33,-1,31
Ballymena,6580,6,7,4,15,25,48,-23,25
Glentoran,6580,7,6,6,10,24,32,-8,24
Dungannon,6580,8,2,4,16,14,47,-33,10
Crusaders,6581,1,17,6,3,63,30,33,57
Coleraine,6581,2,14,10,2,43,23,20,52
Glenavon,6581,3,10,9,7,53,43,10,39
Linfield,6581,4,10,5,11,37,38,-1,35
Cliftonville,6581,5,10,4,12,34,31,3,34
Ballymena,6581,6,7,4,15,25,49,-24,25
Glentoran,6581,7,6,6,10,24,32,-8,24
Dungannon,6581,8,2,4,16,14,47,-33,10
Coleraine,6582,1,15,10,1,45,23,22,55
Crusaders,6582,2,16,6,4,61,32,29,54
Glenavon,6582,3,9,9,8,53,45,8,36
Linfield,6582,4,10,6,10,39,38,1,36
Cliftonville,6582,5,9,5,12,34,33,1,32
Ballymena,6582,6,8,4,14,27,47,-20,28
Glentoran,6582,7,6,6,10,24,32,-8,24
Dungannon,6582,8,2,4,16,14,47,-33,10
Coleraine,6583,1,15,10,1,44,22,22,55
Crusaders,6583,2,16,6,4,64,36,28,54
Glenavon,6583,3,9,9,8,52,44,8,36
Linfield,6583,4,10,6,10,37,36,1,36
Cliftonville,6583,5,9,5,12,32,31,1,32
Ballymena,6583,6,8,4,14,31,50,-19,28
Glentoran,6583,7,6,6,10,24,32,-8,24
Dungannon,6583,8,2,4,16,14,47,-33,10
Crusaders,6584,1,16,7,3,63,32,31,55
Coleraine,6584,2,14,10,2,44,24,20,52
Glenavon,6584,3,10,9,7,54,44,10,39
Linfield,6584,4,11,5,10,41,38,3,38
Cliftonville,6584,5,9,4,13,34,35,-1,31
Ballymena,6584,6,7,5,14,27,49,-22,26
Glentoran,6584,7,6,6,10,24,32,-8,24
Dungannon,6584,8,2,4,16,14,47,-33,10
Crusaders,6585,1,17,6,3,62,30,32,57
Coleraine,6585,2,14,10,2,44,26,18,52
Glenavon,6585,3,10,9,7,56,44,12,39
Linfield,6585,4,11,5,10,39,36,3,38
Cliftonville,6585,5,9,4,13,32,33,-1,31
Ballymena,6585,6,7,4,15,25,48,-23,25
Glentoran,6585,7,6,6,10,24,32,-8,24
Dungannon,6585,8,2,4,16,14,47,-33,10
Crusaders,6586,1,17,6,3,64,31,33,57
Coleraine,6586,2,15,10,1,46,23,23,55
Glenavon,6586,3,9,9,8,53,46,7,36
Linfield,6586,4,10,5,11,38,38,0,35
Cliftonville,6586,5,10,4,12,34,32,2,34
Ballymena,6586,6,7,4,15,26,50,-24,25
Glentoran,6586,7,6,6,10,24,32,-8,24
Dungannon,6586,8,2,4,16,14,47,-33,10
Crusaders,6587,1,16,6,4,64,34,30,54
Coleraine,6587,2,14,10,2,43,23,20,52
Glenavon,6587,3,10,9,7,53,43,10,39
Linfield,6587,4,10,5,11,37,37,0,35
Cliftonville,6587,5,10,4,12,33,31,2,34
Ballymena,6587,6,8,4,14,29,50,-21,28
Glentoran,6587,7,6,6,10,24,32,-8,24
Dungannon,6587,8,2,4,16,14,47,-33,10
Coleraine,6588,1,15,10,1,44,22,22,55
Crusaders,6588,2,16,6,4,61,31,30,54
Glenavon,6588,3,9,9,8,52,44,8,36
Linfield,6588,4,10,6,10,41,40,1,36
Cliftonville,6588,5,9,5,12,36,35,1,32
Ballymena,6588,6,8,4,14,26,47,-21,28
Glentoran,6588,7,6,6,10,24,32,-8,24
Dungannon,6588,8,2,4,16,14,47,-33,10
Crusaders,6589,1,16,6,4,63,34,29,54
Coleraine,6589,2,14,11,1,45,24,21,53
Linfield,6589,3,11,5,10,39,37,2,38
Glenavon,6589,4,9,10,7,54,45,9,37
Cliftonville,6589,5,9,4,13,33,33,0,31
Ballymena,6589,6,8,4,14,29,49,-20,28
Glentoran,6589,7,6,6,10,24,32,-8,24
Dungannon,6589,8,2,4,16,14,47,-33,10
Coleraine,6590,1,15,10,1,44,22,22,55
Crusaders,6590,2,16,6,4,62,32,30,54
Linfield,6590,3,11,5,10,41,37,4,38
Glenavon,6590,4,9,9,8,52,44,8,36
Cliftonville,6590,5,9,4,13,33,35,-2,31
Ballymena,6590,6,8,4,14,27,48,-21,28
Glentoran,6590,7,6,6,10,24,32,-8,24
Dungannon,6590,8,2,4,16,14,47,-33,10
Crusaders,6591,1,17,6,3,63,31,32,57
Coleraine,6591,2,14,10,2,44,25,19,52
Glenavon,6591,3,10,9,7,55,44,11,39
Linfield,6591,4,11,5,10,39,37,2,38
Cliftonville,6591,5,9,4,13,33,33,0,31
Ballymena,6591,6,7,4,15,26,49,-23,25
Glentoran,6591,7,6,6,10,24,32,-8,24
Dungannon,6591,8,2,4,16,14,47,-33,10
Crusaders,6592,1,16,7,3,63,32,31,55
Coleraine,6592,2,15,10,1,45,23,22,55
Linfield,6592,3,11,5,10,39,36,3,38
Glenavon,6592,4,9,9,8,53,45,8,36
Cliftonville,6592,5,9,4,13,32,33,-1,31
Ballymena,6592,6,7,5,14,27,49,-22,26
Glentoran,6592,7,6,6,10,24,32,-8,24
Dungannon,6592,8,2,4,16,14,47,-33,10
Crusaders,6593,1,17,6,3,64,31,33,57
Coleraine,6593,2,14,11,1,45,24,21,53
Linfield,6593,3,11,5,10,41,37,4,38
Glenavon,6593,4,9,10,7,54,45,9,37
Cliftonville,6593,5,9,4,13,33,35,-2,31
Ballymena,6593,6,7,4,15,26,50,-24,25
Glentoran,6593,7,6,6,10,24,32,-8,24
Dungannon,6593,8,2,4,16,14,47,-33,10
Crusaders,6594,1,17,6,3,62,30,32,57
Coleraine,6594,2,14,10,2,44,26,18,52
Glenavon,6594,3,10,9,7,56,44,12,39
Linfield,6594,4,10,5,11,37,37,0,35
Cliftonville,6594,5,10,4,12,33,31,2,34
Ballymena,6594,6,7,4,15,25,48,-23,25
Glentoran,6594,7,6,6,10,24,32,-8,24
Dungannon,6594,8,2,4,16,14,47,-33,10
Crusaders,6595,1,17,6,3,62,30,32,57
Coleraine,6595,2,14,11,1,46,25,21,53
Glenavon,6595,3,9,10,7,55,46,9,37
Linfield,6595,4,10,5,11,39,41,-2,35
Cliftonville,6595,5,10,4,12,37,33,4,34
Ballymena,6595,6,7,4,15,25,48,-23,25
Glentoran,6595,7,6,6,10,24,32,-8,24
Dungannon,6595,8,2,4,16,14,47,-33,10
Crusaders,6596,1,16,6,4,62,32,30,54
Coleraine,6596,2,14,10,2,44,26,18,52
Glenavon,6596,3,10,9,7,56,44,12,39
Linfield,6596,4,11,5,10,38,36,2,38
Cliftonville,6596,5,9,4,13,32,32,0,31
Ballymena,6596,6,8,4,14,27,48,-21,28
Glentoran,6596,7,6,6,10,24,32,-8,24
Dungannon,6596,8,2,4,16,14,47,-33,10
Crusaders,6597,1,17,6,3,64,31,33,57
Coleraine,6597,2,14,11,1,43,22,21,53
Glenavon,6597,3,9,10,7,52,43,9,37
Linfield,6597,4,10,6,10,38,37,1,36
Cliftonville,6597,5,9,5,12,33,32,1,32
Ballymena,6597,6,7,4,15,26,50,-24,25
Glentoran,6597,7,6,6,10,24,32,-8,24
Dungannon,6597,8,2,4,16,14,47,-33,10
Crusaders,6598,1,16,6,4,61,33,28,54
Coleraine,6598,2,14,10,2,43,23,20,52
Glenavon,6598,3,10,9,7,53,43,10,39
Linfield,6598,4,10,5,11,39,40,-1,35
Cliftonville,6598,5,10,4,12,36,33,3,34
Ballymena,6598,6,8,4,14,28,47,-19,28
Glentoran,6598,7,6,6,10,24,32,-8,24
Dungannon,6598,8,2,4,16,14,47,-33,10
Crusaders,6599,1,17,6,3,64,31,33,57
Coleraine,6599,2,14,10,2,43,23,20,52
Glenavon,6599,3,10,9,7,53,43,10,39
Linfield,6599,4,10,5,11,37,38,-1,35
Cliftonville,6599,5,10,4,12,34,31,3,34
Ballymena,6599,6,7,4,15,26,50,-24,25
Glentoran,6599,7,6,6,10,24,32,-8,24
Dungannon,6599,8,2,4,16,14,47,-33,10
Crusaders,6600,1,17,6,3,65,31,34,57
Coleraine,6600,2,14,11,1,43,22,21,53
Glenavon,6600,3,9,10,7,52,43,9,37
Linfield,6600,4,10,5,11,37,38,-1,35
Cliftonville,6600,5,10,4,12,34,31,3,34
Ballymena,6600,6,7,4,15,26,51,-25,25
Glentoran,6600,7,6,6,10,24,32,-8,24
Dungannon,6600,8,2,4,16,14,47,-33,10
Crusaders,6601,1,17,6,3,64,31,33,57
Coleraine,6601,2,15,10,1,46,24,22,55
Linfield,6601,3,11,5,10,38,36,2,38
Glenavon,6601,4,9,9,8,54,46,8,36
Cliftonville,6601,5,9,4,13,32,32,0,31
Ballymena,6601,6,7,4,15,26,50,-24,25
Glentoran,6601,7,6,6,10,24,32,-8,24
Dungannon,6601,8,2,4,16,14,47,-33,10
Coleraine,6602,1,15,10,1,45,22,23,55
Crusaders,6602,2,16,6,4,62,33,29,54
Glenavon,6602,3,9,9,8,52,45,7,36
Linfield,6602,4,10,6,10,38,37,1,36
Cliftonville,6602,5,9,5,12,33,32,1,32
Ballymena,6602,6,8,4,14,28,48,-20,28
Glentoran,6602,7,6,6,10,24,32,-8,24
Dungannon,6602,8,2,4,16,14,47,-33,10
Coleraine,6603,1,15,10,1,45,23,22,55
Crusaders,6603,2,16,6,4,61,33,28,54
Glenavon,6603,3,9,9,8,53,45,8,36
Linfield,6603,4,10,5,11,37,38,-1,35
Cliftonville,6603,5,10,4,12,34,31,3,34
Ballymena,6603,6,8,4,14,28,47,-19,28
Glentoran,6603,7,6,6,10,24,32,-8,24
Dungannon,6603,8,2,4,16,14,47,-33,10
Crusaders,6604,1,16,6,4,63,35,28,54
Coleraine,6604,2,14,10,2,44,25,19,52
Glenavon,6604,3,10,9,7,55,44,11,39
Linfield,6604,4,10,6,10,39,38,1,36
Cliftonville,6604,5,9,5,12,34,33,1,32
Ballymena,6604,6,8,4,14,30,49,-19,28
Glentoran,6604,7,6,6,10,24,32,-8,24
Dungannon,6604,8,2,4,16,14,47,-33,10
Crusaders,6605,1,17,6,3,63,30,33,57
Coleraine,6605,2,14,10,2,45,25,20,52
Glenavon,6605,3,10,9,7,55,45,10,39
Linfield,6605,4,10,5,11,37,37,0,35
Cliftonville,6605,5,10,4,12,33,31,2,34
Ballymena,6605,6,7,4,15,25,49,-24,25
Glentoran,6605,7,6,6,10,24,32,-8,24
Dungannon,6605,8,2,4,16,14,47,-33,10
Coleraine,6606,1,15,10,1,45,23,22,55
Crusaders,6606,2,16,6,4,61,31,30,54
Glenavon,6606,3,9,9,8,53,45,8,36
Linfield,6606,4,10,5,11,37,37,0,35
Cliftonville,6606,5,10,4,12,33,31,2,34
Ballymena,6606,6,8,4,14,26,47,-21,28
Glentoran,6606,7,6,6,10,24,32,-8,24
Dungannon,6606,8,2,4,16,14,47,-33,10
Crusaders,6607,1,17,6,3,65,31,34,57
Coleraine,6607,2,14,10,2,44,25,19,52
Glenavon,6607,3,10,9,7,55,44,11,39
Linfield,6607,4,10,5,11,38,39,-1,35
Cliftonville,6607,5,10,4,12,35,32,3,34
Ballymena,6607,6,7,4,15,26,51,-25,25
Glentoran,6607,7,6,6,10,24,32,-8,24
Dungannon,6607,8,2,4,16,14,47,-33,10
Crusaders,6608,1,17,6,3,62,30,32,57
Coleraine,6608,2,15,10,1,47,23,24,55
Glenavon,6608,3,9,9,8,53,47,6,36
Linfield,6608,4,10,5,11,38,38,0,35
Cliftonville,6608,5,10,4,12,34,32,2,34
Ballymena,6608,6,7,4,15,25,48,-23,25
Glentoran,6608,7,6,6,10,24,32,-8,24
Dungannon,6608,8,2,4,16,14,47,-33,10
Crusaders,6609,1,16,6,4,62,32,30,54
Coleraine,6609,2,14,10,2,44,24,20,52
Glenavon,6609,3,10,9,7,54,44,10,39
Linfield,6609,4,10,6,10,37,36,1,36
Cliftonville,6609,5,9,5,12,32,31,1,32
Ballymena,6609,6,8,4,14,27,48,-21,28
Glentoran,6609,7,6,6,10,24,32,-8,24
Dungannon,6609,8,2,4,16,14,47,-33,10
Crusaders,6610,1,17,6,3,65,31,34,57
Coleraine,6610,2,15,10,1,46,24,22,55
Glenavon,6610,3,9,9,8,54,46,8,36
Linfield,6610,4,10,5,11,38,38,0,35
Cliftonville,6610,5,10,4,12,34,32,2,34
Ballymena,6610,6,7,4,15,26,51,-25,25
Glentoran,6610,7,6,6,10,24,32,-8,24
Dungannon,6610,8,2,4,16,14,47,-33,10
Crusaders,6611,1,16,7,3,62,31,31,55
Coleraine,6611,2,15,10,1,45,23,22,55
Glenavon,6611,3,9,9,8,53,45,8,36
Linfield,6611,4,10,5,11,37,37,0,35
Cliftonville,6611,5,10,4,12,33,31,2,34
Ballymena,6611,6,7,5,14,26,48,-22,26
Glentoran,6611,7,6,6,10,24,32,-8,24
Dungannon,6611,8,2,4,16,14,47,-33,10
Crusaders,6612,1,17,6,3,65,31,34,57
Coleraine,6612,2,14,11,1,45,24,21,53
Glenavon,6612,3,9,10,7,54,45,9,37
Linfield,6612,4,10,6,10,38,37,1,36
Cliftonville,6612,5,9,5,12,33,32,1,32
Ballymena,6612,6,7,4,15,26,51,-25,25
Glentoran,6612,7,6,6,10,24,32,-8,24
Dungannon,6612,8,2,4,16,14,47,-33,10
Crusaders,6613,1,17,6,3,63,31,32,57
Coleraine,6613,2,14,11,1,43,22,21,53
Linfield,6613,3,11,5,10,40,37,3,38
Glenavon,6613,4,9,10,7,52,43,9,37
Cliftonville,6613,5,9,4,13,33,34,-1,31
Ballymena,6613,6,7,4,15,26,49,-23,25
Glentoran,6613,7,6,6,10,24,32,-8,24
Dungannon,6613,8,2,4,16,14,47,-33,10
Crusaders,6614,1,16,7,3,64,33,31,55
Coleraine,6614,2,14,11,1,43,22,21,53
Linfield,6614,3,11,5,10,39,36,3,38
Glenavon,6614,4,9,10,7,52,43,9,37
Cliftonville,6614,5,9,4,13,32,33,-1,31
Ballymena,6614,6,7,5,14,28,50,-22,26
Glentoran,6614,7,6,6,10,24,32,-8,24
Dungannon,6614,8,2,4,16,14,47,-33,10
Crusaders,6615,1,17,6,3,64,30,34,57
Coleraine,6615,2,15,10,1,47,23,24,55
Glenavon,6615,3,9,9,8,53,47,6,36
Linfield,6615,4,10,6,10,38,37,1,36
Cliftonville,6615,5,9,5,12,33,32,1,32
Ballymena,6615,6,7,4,15,25,50,-25,25
Glentoran,6615,7,6,6,10,24,32,-8,24
Dungannon,6615,8,2,4,16,14,47,-33,10
Crusaders,6616,1,16,7,3,62,31,31,55
Coleraine,6616,2,14,11,1,44,23,21,53
Glenavon,6616,3,9,10,7,53,44,9,37
Linfield,6616,4,10,5,11,38,38,0,35
Cliftonville,6616,5,10,4,12,34,32,2,34
Ballymena,6616,6,7,5,14,26,48,-22,26
Glentoran,6616,7,6,6,10,24,32,-8,24
Dungannon,6616,8,2,4,16,14,47,-33,10
Crusaders,6617,1,16,6,4,63,34,29,54
Coleraine,6617,2,14,10,2,44,25,19,52
Glenavon,6617,3,10,9,7,55,44,11,39
Linfield,6617,4,11,5,10,40,36,4,38
Cliftonville,6617,5,9,4,13,32,34,-2,31
Ballymena,6617,6,8,4,14,29,49,-20,28
Glentoran,6617,7,6,6,10,24,32,-8,24
Dungannon,6617,8,2,4,16,14,47,-33,10
Crusaders,6618,1,16,7,3,63,32,31,55
Coleraine,6618,2,14,11,1,45,24,21,53
Linfield,6618,3,11,5,10,40,36,4,38
Glenavon,6618,4,9,10,7,54,45,9,37
Cliftonville,6618,5,9,4,13,32,34,-2,31
Ballymena,6618,6,7,5,14,27,49,-22,26
Glentoran,6618,7,6,6,10,24,32,-8,24
Dungannon,6618,8,2,4,16,14,47,-33,10
Crusaders,6619,1,17,6,3,63,30,33,57
Coleraine,6619,2,14,10,2,44,24,20,52
Glenavon,6619,3,10,9,7,54,44,10,39
Linfield,6619,4,11,5,10,38,36,2,38
Cliftonville,6619,5,9,4,13,32,32,0,31
Ballymena,6619,6,7,4,15,25,49,-24,25
Glentoran,6619,7,6,6,10,24,32,-8,24
Dungannon,6619,8,2,4,16,14,47,-33,10
Crusaders,6620,1,16,7,3,62,31,31,55
Coleraine,6620,2,14,10,2,43,26,17,52
Glenavon,6620,3,10,9,7,56,43,13,39
Linfield,6620,4,11,5,10,39,37,2,38
Cliftonville,6620,5,9,4,13,33,33,0,31
Ballymena,6620,6,7,5,14,26,48,-22,26
Glentoran,6620,7,6,6,10,24,32,-8,24
Dungannon,6620,8,2,4,16,14,47,-33,10
Coleraine,6621,1,15,10,1,44,22,22,55
Crusaders,6621,2,16,6,4,62,32,30,54
Linfield,6621,3,11,5,10,38,36,2,38
Glenavon,6621,4,9,9,8,52,44,8,36
Cliftonville,6621,5,9,4,13,32,32,0,31
Ballymena,6621,6,8,4,14,27,48,-21,28
Glentoran,6621,7,6,6,10,24,32,-8,24
Dungannon,6621,8,2,4,16,14,47,-33,10
Crusaders,6622,1,17,6,3,65,31,34,57
Coleraine,6622,2,14,10,2,43,23,20,52
Glenavon,6622,3,10,9,7,53,43,10,39
Linfield,6622,4,10,5,11,37,39,-2,35
Cliftonville,6622,5,10,4,12,35,31,4,34
Ballymena,6622,6,7,4,15,26,51,-25,25
Glentoran,6622,7,6,6,10,24,32,-8,24
Dungannon,6622,8,2,4,16,14,47,-33,10
Crusaders,6623,1,16,7,3,62,31,31,55
Coleraine,6623,2,14,11,1,44,23,21,53
Linfield,6623,3,11,5,10,39,36,3,38
Glenavon,6623,4,9,10,7,53,44,9,37
Cliftonville,6623,5,9,4,13,32,33,-1,31
Ballymena,6623,6,7,5,14,26,48,-22,26
Glentoran,6623,7,6,6,10,24,32,-8,24
Dungannon,6623,8,2,4,16,14,47,-33,10
Crusaders,6624,1,17,6,3,62,30,32,57
Coleraine,6624,2,15,10,1,45,22,23,55
Linfield,6624,3,11,5,10,40,36,4,38
Glenavon,6624,4,9,9,8,52,45,7,36
Cliftonville,6624,5,9,4,13,32,34,-2,31
Ballymena,6624,6,7,4,15,25,48,-23,25
Glentoran,6624,7,6,6,10,24,32,-8,24
Dungannon,6624,8,2,4,16,14,47,-33,10
Crusaders,6625,1,16,7,3,63,32,31,55
Coleraine,6625,2,15,10,1,46,23,23,55
Glenavon,6625,3,9,9,8,53,46,7,36
Linfield,6625,4,10,6,10,38,37,1,36
Cliftonville,6625,5,9,5,12,33,32,1,32
Ballymena,6625,6,7,5,14,27,49,-22,26
Glentoran,6625,7,6,6,10,24,32,-8,24
Dungannon,6625,8,2,4,16,14,47,-33,10
Crusaders,6626,1,16,6,4,63,33,30,54
Coleraine,6626,2,14,11,1,45,24,21,53
Glenavon,6626,3,9,10,7,54,45,9,37
Linfield,6626,4,10,6,10,37,36,1,36
Cliftonville,6626,5,9,5,12,32,31,1,32
Ballymena,6626,6,8,4,14,28,49,-21,28
Glentoran,6626,7,6,6,10,24,32,-8,24
Dungannon,6626,8,2,4,16,14,47,-33,10
Crusaders,6627,1,17,6,3,62,30,32,57
Coleraine,6627,2,14,11,1,45,24,21,53
Glenavon,6627,3,9,10,7,54,45,9,37
Linfield,6627,4,10,6,10,39,38,1,36
Cliftonville,6627,5,9,5,12,34,33,1,32
Ballymena,6627,6,7,4,15,25,48,-23,25
Glentoran,6627,7,6,6,10,24,32,-8,24
Dungannon,6627,8,2,4,16,14,47,-33,10
Crusaders,6628,1,17,6,3,63,30,33,57
Coleraine,6628,2,15,10,1,46,24,22,55
Linfield,6628,3,11,5,10,38,36,2,38
Glenavon,6628,4,9,9,8,54,46,8,36
Cliftonville,6628,5,9,4,13,32,32,0,31
Ballymena,6628,6,7,4,15,25,49,-24,25
Glentoran,6628,7,6,6,10,24,32,-8,24
Dungannon,6628,8,2,4,16,14,47,-33,10
Crusaders,6629,1,17,6,3,63,31,32,57
Coleraine,6629,2,15,10,1,45,23,22,55
Linfield,6629,3,11,5,10,39,36,3,38
Glenavon,6629,4,9,9,8,53,45,8,36
Cliftonville,6629,5,9,4,13,32,33,-1,31
Ballymena,6629,6,7,4,15,26,49,-23,25
Glentoran,6629,7,6,6,10,24,32,-8,24
Dungannon,6629,8,2,4,16,14,47,-33,10
Crusaders,6630,1,17,6,3,62,30,32,57
Coleraine,6630,2,14,10,2,44,25,19,52
Glenavon,6630,3,10,9,7,55,44,11,39
Linfield,6630,4,10,6,10,37,36,1,36
Cliftonville,6630,5,9,5,12,32,31,1,32
Ballymena,6630,6,7,4,15,25,48,-23,25
Glentoran,6630,7,6,6,10,24,32,-8,24
Dungannon,6630,8,2,4,16,14,47,-33,10
Crusaders,6631,1,16,7,3,62,31,31,55
Coleraine,6631,2,15,10,1,47,22,25,55
Linfield,6631,3,11,5,10,38,36,2,38
Glenavon,6631,4,9,9,8,52,47,5,36
Cliftonville,6631,5,9,4,13,32,32,0,31
Ballymena,6631,6,7,5,14,26,48,-22,26
Glentoran,6631,7,6,6,10,24,32,-8,24
Dungannon,6631,8,2,4,16,14,47,-33,10
Crusaders,6632,1,17,6,3,62,30,32,57
Coleraine,6632,2,14,10,2,43,23,20,52
Glenavon,6632,3,10,9,7,53,43,10,39
Linfield,6632,4,11,5,10,42,36,6,38
Cliftonville,6632,5,9,4,13,32,36,-4,31
Ballymena,6632,6,7,4,15,25,48,-23,25
Glentoran,6632,7,6,6,10,24,32,-8,24
Dungannon,6632,8,2,4,16,14,47,-33,10
Crusaders,6633,1,17,6,3,63,31,32,57
Coleraine,6633,2,15,10,1,47,23,24,55
Linfield,6633,3,11,5,10,39,37,2,38
Glenavon,6633,4,9,9,8,53,47,6,36
Cliftonville,6633,5,9,4,13,33,33,0,31
Ballymena,6633,6,7,4,15,26,49,-23,25
Glentoran,6633,7,6,6,10,24,32,-8,24
Dungannon,6633,8,2,4,16,14,47,-33,10
Crusaders,6634,1,17,6,3,64,30,34,57
Coleraine,6634,2,14,10,2,44,24,20,52
Glenavon,6634,3,10,9,7,54,44,10,39
Linfield,6634,4,10,6,10,37,36,1,36
Cliftonville,6634,5,9,5,12,32,31,1,32
Ballymena,6634,6,7,4,15,25,50,-25,25
Glentoran,6634,7,6,6,10,24,32,-8,24
Dungannon,6634,8,2,4,16,14,47,-33,10
Crusaders,6635,1,16,7,3,62,31,31,55
Coleraine,6635,2,15,10,1,45,23,22,55
Glenavon,6635,3,9,9,8,53,45,8,36
Linfield,6635,4,10,6,10,39,38,1,36
Cliftonville,6635,5,9,5,12,34,33,1,32
Ballymena,6635,6,7,5,14,26,48,-22,26
Glentoran,6635,7,6,6,10,24,32,-8,24
Dungannon,6635,8,2,4,16,14,47,-33,10
Crusaders,6636,1,17,6,3,63,30,33,57
Coleraine,6636,2,14,10,2,43,24,19,52
Glenavon,6636,3,10,9,7,54,43,11,39
Linfield,6636,4,10,5,11,37,37,0,35
Cliftonville,6636,5,10,4,12,33,31,2,34
Ballymena,6636,6,7,4,15,25,49,-24,25
Glentoran,6636,7,6,6,10,24,32,-8,24
Dungannon,6636,8,2,4,16,14,47,-33,10
Crusaders,6637,1,17,6,3,64,32,32,57
Coleraine,6637,2,14,11,1,44,23,21,53
Linfield,6637,3,11,5,10,38,36,2,38
Glenavon,6637,4,9,10,7,53,44,9,37
Cliftonville,6637,5,9,4,13,32,32,0,31
Ballymena,6637,6,7,4,15,27,50,-23,25
Glentoran,6637,7,6,6,10,24,32,-8,24
Dungannon,6637,8,2,4,16,14,47,-33,10
Crusaders,6638,1,17,6,3,62,30,32,57
Coleraine,6638,2,15,10,1,44,22,22,55
Linfield,6638,3,11,5,10,39,36,3,38
Glenavon,6638,4,9,9,8,52,44,8,36
Cliftonville,6638,5,9,4,13,32,33,-1,31
Ballymena,6638,6,7,4,15,25,48,-23,25
Glentoran,6638,7,6,6,10,24,32,-8,24
Dungannon,6638,8,2,4,16,14,47,-33,10
Crusaders,6639,1,16,7,3,61,30,31,55
Coleraine,6639,2,15,10,1,45,23,22,55
Glenavon,6639,3,9,9,8,53,45,8,36
Linfield,6639,4,10,6,10,38,37,1,36
Cliftonville,6639,5,9,5,12,33,32,1,32
Ballymena,6639,6,7,5,14,25,47,-22,26
Glentoran,6639,7,6,6,10,24,32,-8,24
Dungannon,6639,8,2,4,16,14,47,-33,10
Crusaders,6640,1,16,7,3,62,31,31,55
Coleraine,6640,2,14,10,2,45,25,20,52
Glenavon,6640,3,10,9,7,55,45,10,39
Linfield,6640,4,10,5,11,38,38,0,35
Cliftonville,6640,5,10,4,12,34,32,2,34
Ballymena,6640,6,7,5,14,26,48,-22,26
Glentoran,6640,7,6,6,10,24,32,-8,24
Dungannon,6640,8,2,4,16,14,47,-33,10
Crusaders,6641,1,16,6,4,61,32,29,54
Coleraine,6641,2,14,11,1,44,23,21,53
Glenavon,6641,3,9,10,7,53,44,9,37
Linfield,6641,4,10,5,11,37,38,-1,35
Cliftonville,6641,5,10,4,12,34,31,3,34
Ballymena,6641,6,8,4,14,27,47,-20,28
Glentoran,6641,7,6,6,10,24,32,-8,24
Dungannon,6641,8,2,4,16,14,47,-33,10
Crusaders,6642,1,17,6,3,62,30,32,57
Coleraine,6642,2,14,10,2,43,23,20,52
Glenavon,6642,3,10,9,7,53,43,10,39
Linfield,6642,4,11,5,10,39,37,2,38
Cliftonville,6642,5,9,4,13,33,33,0,31
Ballymena,6642,6,7,4,15,25,48,-23,25
Glentoran,6642,7,6,6,10,24,32,-8,24
Dungannon,6642,8,2,4,16,14,47,-33,10
Crusaders,6643,1,17,6,3,63,31,32,57
Coleraine,6643,2,14,10,2,43,26,17,52
Glenavon,6643,3,10,9,7,56,43,13,39
Linfield,6643,4,10,5,11,37,37,0,35
Cliftonville,6643,5,10,4,12,33,31,2,34
Ballymena,6643,6,7,4,15,26,49,-23,25
Glentoran,6643,7,6,6,10,24,32,-8,24
Dungannon,6643,8,2,4,16,14,47,-33,10
Crusaders,6644,1,17,6,3,62,30,32,57
Coleraine,6644,2,14,11,1,45,24,21,53
Linfield,6644,3,11,5,10,40,37,3,38
Glenavon,6644,4,9,10,7,54,45,9,37
Cliftonville,6644,5,9,4,13,33,34,-1,31
Ballymena,6644,6,7,4,15,25,48,-23,25
Glentoran,6644,7,6,6,10,24,32,-8,24
Dungannon,6644,8,2,4,16,14,47,-33,10
Coleraine,6645,1,15,10,1,49,23,26,55
Crusaders,6645,2,16,6,4,62,32,30,54
Glenavon,6645,3,9,9,8,53,49,4,36
Linfield,6645,4,10,6,10,37,36,1,36
Cliftonville,6645,5,9,5,12,32,31,1,32
Ballymena,6645,6,8,4,14,27,48,-21,28
Glentoran,6645,7,6,6,10,24,32,-8,24
Dungannon,6645,8,2,4,16,14,47,-33,10
Crusaders,6646,1,17,6,3,65,31,34,57
Coleraine,6646,2,15,10,1,45,23,22,55
Glenavon,6646,3,9,9,8,53,45,8,36
Linfield,6646,4,10,5,11,38,38,0,35
Cliftonville,6646,5,10,4,12,34,32,2,34
Ballymena,6646,6,7,4,15,26,51,-25,25
Glentoran,6646,7,6,6,10,24,32,-8,24
Dungannon,6646,8,2,4,16,14,47,-33,10
Crusaders,6647,1,16,7,3,63,32,31,55
Coleraine,6647,2,14,10,2,43,24,19,52
Glenavon,6647,3,10,9,7,54,43,11,39
Linfield,6647,4,11,5,10,39,37,2,38
Cliftonville,6647,5,9,4,13,33,33,0,31
Ballymena,6647,6,7,5,14,27,49,-22,26
Glentoran,6647,7,6,6,10,24,32,-8,24
Dungannon,6647,8,2,4,16,14,47,-33,10
Crusaders,6648,1,17,6,3,63,30,33,57
Coleraine,6648,2,15,10,1,44,22,22,55
Glenavon,6648,3,9,9,8,52,44,8,36
Linfield,6648,4,10,6,10,37,36,1,36
Cliftonville,6648,5,9,5,12,32,31,1,32
Ballymena,6648,6,7,4,15,25,49,-24,25
Glentoran,6648,7,6,6,10,24,32,-8,24
Dungannon,6648,8,2,4,16,14,47,-33,10
Crusaders,6649,1,17,6,3,64,31,33,57
Coleraine,6649,2,14,10,2,44,25,19,52
Glenavon,6649,3,10,9,7,55,44,11,39
Linfield,6649,4,10,6,10,37,36,1,36
Cliftonville,6649,5,9,5,12,32,31,1,32
Ballymena,6649,6,7,4,15,26,50,-24,25
Glentoran,6649,7,6,6,10,24,32,-8,24
Dungannon,6649,8,2,4,16,14,47,-33,10
Crusaders,6650,1,17,6,3,66,31,35,57
Coleraine,6650,2,14,10,2,43,23,20,52
Glenavon,6650,3,10,9,7,53,43,10,39
Linfield,6650,4,10,6,10,38,37,1,36
Cliftonville,6650,5,9,5,12,33,32,1,32
Ballymena,6650,6,7,4,15,26,52,-26,25
Glentoran,6650,7,6,6,10,24,32,-8,24
Dungannon,6650,8,2,4,16,14,47,-33,10
Crusaders,6651,1,17,6,3,64,30,34,57
Coleraine,6651,2,14,11,1,44,23,21,53
Glenavon,6651,3,9,10,7,53,44,9,37
Linfield,6651,4,10,6,10,37,36,1,36
Cliftonville,6651,5,9,5,12,32,31,1,32
Ballymena,6651,6,7,4,15,25,50,-25,25
Glentoran,6651,7,6,6,10,24,32,-8,24
Dungannon,6651,8,2,4,16,14,47,-33,10
Crusaders,6652,1,17,6,3,65,30,35,57
Coleraine,6652,2,14,10,2,43,23,20,52
Glenavon,6652,3,10,9,7,53,43,10,39
Linfield,6652,4,10,6,10,37,36,1,36
Cliftonville,6652,5,9,5,12,32,31,1,32
Ballymena,6652,6,7,4,15,25,51,-26,25
Glentoran,6652,7,6,6,10,24,32,-8,24
Dungannon,6652,8,2,4,16,14,47,-33,10
Crusaders,6653,1,16,6,4,61,31,30,54
Coleraine,6653,2,14,11,1,44,23,21,53
Linfield,6653,3,11,5,10,39,37,2,38
Glenavon,6653,4,9,10,7,53,44,9,37
Cliftonville,6653,5,9,4,13,33,33,0,31
Ballymena,6653,6,8,4,14,26,47,-21,28
Glentoran,6653,7,6,6,10,24,32,-8,24
Dungannon,6653,8,2,4,16,14,47,-33,10
Crusaders,6654,1,17,6,3,64,30,34,57
Coleraine,6654,2,15,10,1,48,22,26,55
Glenavon,6654,3,9,9,8,52,48,4,36
Linfield,6654,4,10,5,11,37,38,-1,35
Cliftonville,6654,5,10,4,12,34,31,3,34
Ballymena,6654,6,7,4,15,25,50,-25,25
Glentoran,6654,7,6,6,10,24,32,-8,24
Dungannon,6654,8,2,4,16,14,47,-33,10
Crusaders,6655,1,17,6,3,65,33,32,57
Coleraine,6655,2,15,10,1,46,24,22,55
Linfield,6655,3,11,5,10,41,36,5,38
Glenavon,6655,4,9,9,8,54,46,8,36
Cliftonville,6655,5,9,4,13,32,35,-3,31
Ballymena,6655,6,7,4,15,28,51,-23,25
Glentoran,6655,7,6,6,10,24,32,-8,24
Dungannon,6655,8,2,4,16,14,47,-33,10
Crusaders,6656,1,17,6,3,66,32,34,57
Coleraine,6656,2,15,10,1,45,23,22,55
Glenavon,6656,3,9,9,8,53,45,8,36
Linfield,6656,4,10,6,10,38,37,1,36
Cliftonville,6656,5,9,5,12,33,32,1,32
Ballymena,6656,6,7,4,15,27,52,-25,25
Glentoran,6656,7,6,6,10,24,32,-8,24
Dungannon,6656,8,2,4,16,14,47,-33,10
Crusaders,6657,1,17,6,3,64,30,34,57
Coleraine,6657,2,14,11,1,44,23,21,53
Glenavon,6657,3,9,10,7,53,44,9,37
Linfield,6657,4,10,5,11,38,38,0,35
Cliftonville,6657,5,10,4,12,34,32,2,34
Ballymena,6657,6,7,4,15,25,50,-25,25
Glentoran,6657,7,6,6,10,24,32,-8,24
Dungannon,6657,8,2,4,16,14,47,-33,10
Crusaders,6658,1,17,6,3,65,30,35,57
Coleraine,6658,2,14,10,2,43,27,16,52
Glenavon,6658,3,10,9,7,57,43,14,39
Linfield,6658,4,11,5,10,40,38,2,38
Cliftonville,6658,5,9,4,13,34,34,0,31
Ballymena,6658,6,7,4,15,25,51,-26,25
Glentoran,6658,7,6,6,10,24,32,-8,24
Dungannon,6658,8,2,4,16,14,47,-33,10
Crusaders,6659,1,17,6,3,64,32,32,57
Coleraine,6659,2,14,10,2,44,26,18,52
Glenavon,6659,3,10,9,7,56,44,12,39
Linfield,6659,4,11,5,10,39,36,3,38
Cliftonville,6659,5,9,4,13,32,33,-1,31
Ballymena,6659,6,7,4,15,27,50,-23,25
Glentoran,6659,7,6,6,10,24,32,-8,24
Dungannon,6659,8,2,4,16,14,47,-33,10
Crusaders,6660,1,16,6,4,62,34,28,54
Coleraine,6660,2,14,10,2,43,23,20,52
Glenavon,6660,3,10,9,7,53,43,10,39
Linfield,6660,4,11,5,10,40,36,4,38
Cliftonville,6660,5,9,4,13,32,34,-2,31
Ballymena,6660,6,8,4,14,29,48,-19,28
Glentoran,6660,7,6,6,10,24,32,-8,24
Dungannon,6660,8,2,4,16,14,47,-33,10
Crusaders,6661,1,17,6,3,64,30,34,57
Coleraine,6661,2,15,10,1,45,22,23,55
Linfield,6661,3,11,5,10,40,38,2,38
Glenavon,6661,4,9,9,8,52,45,7,36
Cliftonville,6661,5,9,4,13,34,34,0,31
Ballymena,6661,6,7,4,15,25,50,-25,25
Glentoran,6661,7,6,6,10,24,32,-8,24
Dungannon,6661,8,2,4,16,14,47,-33,10
Crusaders,6662,1,16,6,4,61,33,28,54
Coleraine,6662,2,14,11,1,45,24,21,53
Glenavon,6662,3,9,10,7,54,45,9,37
Linfield,6662,4,10,5,11,37,37,0,35
Cliftonville,6662,5,10,4,12,33,31,2,34
Ballymena,6662,6,8,4,14,28,47,-19,28
Glentoran,6662,7,6,6,10,24,32,-8,24
Dungannon,6662,8,2,4,16,14,47,-33,10
Crusaders,6663,1,17,6,3,63,30,33,57
Coleraine,6663,2,15,10,1,46,24,22,55
Glenavon,6663,3,9,9,8,54,46,8,36
Linfield,6663,4,10,5,11,40,41,-1,35
Cliftonville,6663,5,10,4,12,37,34,3,34
Ballymena,6663,6,7,4,15,25,49,-24,25
Glentoran,6663,7,6,6,10,24,32,-8,24
Dungannon,6663,8,2,4,16,14,47,-33,10
Crusaders,6664,1,16,6,4,61,33,28,54
Coleraine,6664,2,14,10,2,43,27,16,52
Glenavon,6664,3,10,9,7,57,43,14,39
Linfield,6664,4,11,5,10,39,36,3,38
Cliftonville,6664,5,9,4,13,32,33,-1,31
Ballymena,6664,6,8,4,14,28,47,-19,28
Glentoran,6664,7,6,6,10,24,32,-8,24
Dungannon,6664,8,2,4,16,14,47,-33,10
Crusaders,6665,1,17,6,3,64,30,34,57
Coleraine,6665,2,15,10,1,45,23,22,55
Glenavon,6665,3,9,9,8,53,45,8,36
Linfield,6665,4,10,6,10,38,37,1,36
Cliftonville,6665,5,9,5,12,33,32,1,32
Ballymena,6665,6,7,4,15,25,50,-25,25
Glentoran,6665,7,6,6,10,24,32,-8,24
Dungannon,6665,8,2,4,16,14,47,-33,10
Coleraine,6666,1,15,10,1,47,24,23,55
Crusaders,6666,2,16,6,4,63,33,30,54
Glenavon,6666,3,9,9,8,54,47,7,36
Linfield,6666,4,10,5,11,37,37,0,35
Cliftonville,6666,5,10,4,12,33,31,2,34
Ballymena,6666,6,8,4,14,28,49,-21,28
Glentoran,6666,7,6,6,10,24,32,-8,24
Dungannon,6666,8,2,4,16,14,47,-33,10
Crusaders,6667,1,16,6,4,63,34,29,54
Coleraine,6667,2,14,10,2,43,24,19,52
Glenavon,6667,3,10,9,7,54,43,11,39
Linfield,6667,4,11,5,10,39,36,3,38
Cliftonville,6667,5,9,4,13,32,33,-1,31
Ballymena,6667,6,8,4,14,29,49,-20,28
Glentoran,6667,7,6,6,10,24,32,-8,24
Dungannon,6667,8,2,4,16,14,47,-33,10
Crusaders,6668,1,17,6,3,64,32,32,57
Coleraine,6668,2,15,10,1,44,22,22,55
Linfield,6668,3,11,5,10,38,36,2,38
Glenavon,6668,4,9,9,8,52,44,8,36
Cliftonville,6668,5,9,4,13,32,32,0,31
Ballymena,6668,6,7,4,15,27,50,-23,25
Glentoran,6668,7,6,6,10,24,32,-8,24
Dungannon,6668,8,2,4,16,14,47,-33,10
Crusaders,6669,1,17,6,3,62,30,32,57
Coleraine,6669,2,14,10,2,43,26,17,52
Glenavon,6669,3,10,9,7,56,43,13,39
Linfield,6669,4,10,5,11,38,38,0,35
Cliftonville,6669,5,10,4,12,34,32,2,34
Ballymena,6669,6,7,4,15,25,48,-23,25
Glentoran,6669,7,6,6,10,24,32,-8,24
Dungannon,6669,8,2,4,16,14,47,-33,10
Crusaders,6670,1,17,6,3,63,31,32,57
Coleraine,6670,2,14,10,2,44,24,20,52
Glenavon,6670,3,10,9,7,54,44,10,39
Linfield,6670,4,10,6,10,38,37,1,36
Cliftonville,6670,5,9,5,12,33,32,1,32
Ballymena,6670,6,7,4,15,26,49,-23,25
Glentoran,6670,7,6,6,10,24,32,-8,24
Dungannon,6670,8,2,4,16,14,47,-33,10
Crusaders,6671,1,17,6,3,63,30,33,57
Coleraine,6671,2,14,11,1,45,24,21,53
Glenavon,6671,3,9,10,7,54,45,9,37
Linfield,6671,4,10,6,10,39,38,1,36
Cliftonville,6671,5,9,5,12,34,33,1,32
Ballymena,6671,6,7,4,15,25,49,-24,25
Glentoran,6671,7,6,6,10,24,32,-8,24
Dungannon,6671,8,2,4,16,14,47,-33,10
Crusaders,6672,1,17,6,3,65,30,35,57
Coleraine,6672,2,14,10,2,44,25,19,52
Glenavon,6672,3,10,9,7,55,44,11,39
Linfield,6672,4,10,5,11,37,37,0,35
Cliftonville,6672,5,10,4,12,33,31,2,34
Ballymena,6672,6,7,4,15,25,51,-26,25
Glentoran,6672,7,6,6,10,24,32,-8,24
Dungannon,6672,8,2,4,16,14,47,-33,10
Crusaders,6673,1,16,6,4,62,32,30,54
Coleraine,6673,2,14,11,1,43,22,21,53
Glenavon,6673,3,9,10,7,52,43,9,37
Linfield,6673,4,10,6,10,38,37,1,36
Cliftonville,6673,5,9,5,12,33,32,1,32
Ballymena,6673,6,8,4,14,27,48,-21,28
Glentoran,6673,7,6,6,10,24,32,-8,24
Dungannon,6673,8,2,4,16,14,47,-33,10
Crusaders,6674,1,17,6,3,63,31,32,57
Coleraine,6674,2,15,10,1,46,24,22,55
Linfield,6674,3,11,5,10,39,37,2,38
Glenavon,6674,4,9,9,8,54,46,8,36
Cliftonville,6674,5,9,4,13,33,33,0,31
Ballymena,6674,6,7,4,15,26,49,-23,25
Glentoran,6674,7,6,6,10,24,32,-8,24
Dungannon,6674,8,2,4,16,14,47,-33,10
Crusaders,6675,1,17,6,3,65,31,34,57
Coleraine,6675,2,15,10,1,47,24,23,55
Glenavon,6675,3,9,9,8,54,47,7,36
Linfield,6675,4,10,5,11,37,39,-2,35
Cliftonville,6675,5,10,4,12,35,31,4,34
Ballymena,6675,6,7,4,15,26,51,-25,25
Glentoran,6675,7,6,6,10,24,32,-8,24
Dungannon,6675,8,2,4,16,14,47,-33,10
Crusaders,6676,1,16,7,3,62,31,31,55
Coleraine,6676,2,15,10,1,45,22,23,55
Glenavon,6676,3,9,9,8,52,45,7,36
Linfield,6676,4,10,6,10,38,37,1,36
Cliftonville,6676,5,9,5,12,33,32,1,32
Ballymena,6676,6,7,5,14,26,48,-22,26
Glentoran,6676,7,6,6,10,24,32,-8,24
Dungannon,6676,8,2,4,16,14,47,-33,10
Crusaders,6677,1,17,6,3,65,30,35,57
Coleraine,6677,2,14,11,1,45,24,21,53
Linfield,6677,3,11,5,10,39,37,2,38
Glenavon,6677,4,9,10,7,54,45,9,37
Cliftonville,6677,5,9,4,13,33,33,0,31
Ballymena,6677,6,7,4,15,25,51,-26,25
Glentoran,6677,7,6,6,10,24,32,-8,24
Dungannon,6677,8,2,4,16,14,47,-33,10
Crusaders,6678,1,17,6,3,64,30,34,57
Coleraine,6678,2,15,10,1,45,23,22,55
Glenavon,6678,3,9,9,8,53,45,8,36
Linfield,6678,4,10,5,11,37,37,0,35
Cliftonville,6678,5,10,4,12,33,31,2,34
Ballymena,6678,6,7,4,15,25,50,-25,25
Glentoran,6678,7,6,6,10,24,32,-8,24
Dungannon,6678,8,2,4,16,14,47,-33,10
Crusaders,6679,1,17,6,3,65,30,35,57
Coleraine,6679,2,15,10,1,46,24,22,55
Linfield,6679,3,11,5,10,40,36,4,38
Glenavon,6679,4,9,9,8,54,46,8,36
Cliftonville,6679,5,9,4,13,32,34,-2,31
Ballymena,6679,6,7,4,15,25,51,-26,25
Glentoran,6679,7,6,6,10,24,32,-8,24
Dungannon,6679,8,2,4,16,14,47,-33,10
Crusaders,6680,1,17,6,3,65,31,34,57
Coleraine,6680,2,14,10,2,44,25,19,52
Glenavon,6680,3,10,9,7,55,44,11,39
Linfield,6680,4,11,5,10,40,38,2,38
Cliftonville,6680,5,9,4,13,34,34,0,31
Ballymena,6680,6,7,4,15,26,51,-25,25
Glentoran,6680,7,6,6,10,24,32,-8,24
Dungannon,6680,8,2,4,16,14,47,-33,10
Crusaders,6681,1,17,6,3,63,30,33,57
Coleraine,6681,2,15,10,1,45,23,22,55
Glenavon,6681,3,9,9,8,53,45,8,36
Linfield,6681,4,10,6,10,37,36,1,36
Cliftonville,6681,5,9,5,12,32,31,1,32
Ballymena,6681,6,7,4,15,25,49,-24,25
Glentoran,6681,7,6,6,10,24,32,-8,24
Dungannon,6681,8,2,4,16,14,47,-33,10
Crusaders,6682,1,17,6,3,64,30,34,57
Coleraine,6682,2,14,10,2,43,24,19,52
Glenavon,6682,3,10,9,7,54,43,11,39
Linfield,6682,4,10,6,10,39,38,1,36
Cliftonville,6682,5,9,5,12,34,33,1,32
Ballymena,6682,6,7,4,15,25,50,-25,25
Glentoran,6682,7,6,6,10,24,32,-8,24
Dungannon,6682,8,2,4,16,14,47,-33,10
Crusaders,6683,1,17,6,3,64,31,33,57
Coleraine,6683,2,14,10,2,44,24,20,52
Glenavon,6683,3,10,9,7,54,44,10,39
Linfield,6683,4,10,6,10,37,36,1,36
Cliftonville,6683,5,9,5,12,32,31,1,32
Ballymena,6683,6,7,4,15,26,50,-24,25
Glentoran,6683,7,6,6,10,24,32,-8,24
Dungannon,6683,8,2,4,16,14,47,-33,10
Crusaders,6684,1,17,6,3,65,31,34,57
Coleraine,6684,2,14,10,2,44,27,17,52
Glenavon,6684,3,10,9,7,57,44,13,39
Linfield,6684,4,10,6,10,37,36,1,36
Cliftonville,6684,5,9,5,12,32,31,1,32
Ballymena,6684,6,7,4,15,26,51,-25,25
Glentoran,6684,7,6,6,10,24,32,-8,24
Dungannon,6684,8,2,4,16,14,47,-33,10
Coleraine,6685,1,15,10,1,46,22,24,55
Crusaders,6685,2,16,6,4,61,31,30,54
Glenavon,6685,3,9,9,8,52,46,6,36
Linfield,6685,4,10,5,11,38,39,-1,35
Cliftonville,6685,5,10,4,12,35,32,3,34
Ballymena,6685,6,8,4,14,26,47,-21,28
Glentoran,6685,7,6,6,10,24,32,-8,24
Dungannon,6685,8,2,4,16,14,47,-33,10
Crusaders,6686,1,17,6,3,63,31,32,57
Coleraine,6686,2,15,10,1,45,22,23,55
Glenavon,6686,3,9,9,8,52,45,7,36
Linfield,6686,4,10,5,11,37,39,-2,35
Cliftonville,6686,5,10,4,12,35,31,4,34
Ballymena,6686,6,7,4,15,26,49,-23,25
Glentoran,6686,7,6,6,10,24,32,-8,24
Dungannon,6686,8,2,4,16,14,47,-33,10
Crusaders,6687,1,17,6,3,65,30,35,57
Coleraine,6687,2,14,10,2,44,24,20,52
Glenavon,6687,3,10,9,7,54,44,10,39
Linfield,6687,4,10,5,11,38,38,0,35
Cliftonville,6687,5,10,4,12,34,32,2,34
Ballymena,6687,6,7,4,15,25,51,-26,25
Glentoran,6687,7,6,6,10,24,32,-8,24
Dungannon,6687,8,2,4,16,14,47,-33,10
Crusaders,6688,1,16,6,4,62,33,29,54
Coleraine,6688,2,14,11,1,44,23,21,53
Linfield,6688,3,11,5,10,39,36,3,38
Glenavon,6688,4,9,10,7,53,44,9,37
Cliftonville,6688,5,9,4,13,32,33,-1,31
Ballymena,6688,6,8,4,14,28,48,-20,28
Glentoran,6688,7,6,6,10,24,32,-8,24
Dungannon,6688,8,2,4,16,14,47,-33,10
Crusaders,6689,1,16,7,3,62,31,31,55
Coleraine,6689,2,14,10,2,43,24,19,52
Glenavon,6689,3,10,9,7,54,43,11,39
Linfield,6689,4,11,5,10,39,36,3,38
Cliftonville,6689,5,9,4,13,32,33,-1,31
Ballymena,6689,6,7,5,14,26,48,-22,26
Glentoran,6689,7,6,6,10,24,32,-8,24
Dungannon,6689,8,2,4,16,14,47,-33,10
Crusaders,6690,1,17,6,3,62,30,32,57
Coleraine,6690,2,15,10,1,45,22,23,55
Linfield,6690,3,11,5,10,39,36,3,38
Glenavon,6690,4,9,9,8,52,45,7,36
Cliftonville,6690,5,9,4,13,32,33,-1,31
Ballymena,6690,6,7,4,15,25,48,-23,25
Glentoran,6690,7,6,6,10,24,32,-8,24
Dungannon,6690,8,2,4,16,14,47,-33,10
Crusaders,6691,1,16,7,3,61,30,31,55
Coleraine,6691,2,14,10,2,44,24,20,52
Glenavon,6691,3,10,9,7,54,44,10,39
Linfield,6691,4,11,5,10,38,36,2,38
Cliftonville,6691,5,9,4,13,32,32,0,31
Ballymena,6691,6,7,5,14,25,47,-22,26
Glentoran,6691,7,6,6,10,24,32,-8,24
Dungannon,6691,8,2,4,16,14,47,-33,10
Crusaders,6692,1,16,6,4,61,31,30,54
Coleraine,6692,2,14,10,2,44,24,20,52
Glenavon,6692,3,10,9,7,54,44,10,39
Linfield,6692,4,10,6,10,37,36,1,36
Cliftonville,6692,5,9,5,12,32,31,1,32
Ballymena,6692,6,8,4,14,26,47,-21,28
Glentoran,6692,7,6,6,10,24,32,-8,24
Dungannon,6692,8,2,4,16,14,47,-33,10
Crusaders,6693,1,16,6,4,61,33,28,54
Coleraine,6693,2,14,10,2,43,23,20,52
Glenavon,6693,3,10,9,7,53,43,10,39
Linfield,6693,4,11,5,10,41,37,4,38
Cliftonville,6693,5,9,4,13,33,35,-2,31
Ballymena,6693,6,8,4,14,28,47,-19,28
Glentoran,6693,7,6,6,10,24,32,-8,24
Dungannon,6693,8,2,4,16,14,47,-33,10
Crusaders,6694,1,17,6,3,65,30,35,57
Coleraine,6694,2,14,11,1,45,24,21,53
Linfield,6694,3,11,5,10,38,36,2,38
Glenavon,6694,4,9,10,7,54,45,9,37
Cliftonville,6694,5,9,4,13,32,32,0,31
Ballymena,6694,6,7,4,15,25,51,-26,25
Glentoran,6694,7,6,6,10,24,32,-8,24
Dungannon,6694,8,2,4,16,14,47,-33,10
Crusaders,6695,1,16,6,4,61,33,28,54
Coleraine,6695,2,14,10,2,44,25,19,52
Glenavon,6695,3,10,9,7,55,44,11,39
Linfield,6695,4,11,5,10,38,36,2,38
Cliftonville,6695,5,9,4,13,32,32,0,31
Ballymena,6695,6,8,4,14,28,47,-19,28
Glentoran,6695,7,6,6,10,24,32,-8,24
Dungannon,6695,8,2,4,16,14,47,-33,10
Crusaders,6696,1,17,6,3,67,31,36,57
Coleraine,6696,2,15,10,1,44,22,22,55
Linfield,6696,3,11,5,10,39,36,3,38
Glenavon,6696,4,9,9,8,52,44,8,36
Cliftonville,6696,5,9,4,13,32,33,-1,31
Ballymena,6696,6,7,4,15,26,53,-27,25
Glentoran,6696,7,6,6,10,24,32,-8,24
Dungannon,6696,8,2,4,16,14,47,-33,10
Crusaders,6697,1,17,6,3,64,31,33,57
Coleraine,6697,2,14,11,1,46,25,21,53
Linfield,6697,3,11,5,10,40,37,3,38
Glenavon,6697,4,9,10,7,55,46,9,37
Cliftonville,6697,5,9,4,13,33,34,-1,31
Ballymena,6697,6,7,4,15,26,50,-24,25
Glentoran,6697,7,6,6,10,24,32,-8,24
Dungannon,6697,8,2,4,16,14,47,-33,10
Coleraine,6698,1,15,10,1,45,23,22,55
Crusaders,6698,2,16,6,4,61,34,27,54
Linfield,6698,3,11,5,10,40,38,2,38
Glenavon,6698,4,9,9,8,53,45,8,36
Cliftonville,6698,5,9,4,13,34,34,0,31
Ballymena,6698,6,8,4,14,29,47,-18,28
Glentoran,6698,7,6,6,10,24,32,-8,24
Dungannon,6698,8,2,4,16,14,47,-33,10
Coleraine,6699,1,15,10,1,46,22,24,55
Crusaders,6699,2,16,6,4,61,32,29,54
Glenavon,6699,3,9,9,8,52,46,6,36
Linfield,6699,4,10,5,11,37,39,-2,35
Cliftonville,6699,5,10,4,12,35,31,4,34
Ballymena,6699,6,8,4,14,27,47,-20,28
Glentoran,6699,7,6,6,10,24,32,-8,24
Dungannon,6699,8,2,4,16,14,47,-33,10
Crusaders,6700,1,17,6,3,67,31,36,57
Coleraine,6700,2,15,10,1,44,22,22,55
Linfield,6700,3,11,5,10,40,36,4,38
Glenavon,6700,4,9,9,8,52,44,8,36
Cliftonville,6700,5,9,4,13,32,34,-2,31
Ballymena,6700,6,7,4,15,26,53,-27,25
Glentoran,6700,7,6,6,10,24,32,-8,24
Dungannon,6700,8,2,4,16,14,47,-33,10
Crusaders,6701,1,17,6,3,64,30,34,57
Coleraine,6701,2,14,10,2,43,24,19,52
Glenavon,6701,3,10,9,7,54,43,11,39
Linfield,6701,4,10,6,10,39,38,1,36
Cliftonville,6701,5,9,5,12,34,33,1,32
Ballymena,6701,6,7,4,15,25,50,-25,25
Glentoran,6701,7,6,6,10,24,32,-8,24
Dungannon,6701,8,2,4,16,14,47,-33,10
Crusaders,6702,1,17,6,3,68,30,38,57
Coleraine,6702,2,14,11,1,44,23,21,53
Linfield,6702,3,11,5,10,39,36,3,38
Glenavon,6702,4,9,10,7,53,44,9,37
Cliftonville,6702,5,9,4,13,32,33,-1,31
Ballymena,6702,6,7,4,15,25,54,-29,25
Glentoran,6702,7,6,6,10,24,32,-8,24
Dungannon,6702,8,2,4,16,14,47,-33,10
Crusaders,6703,1,17,6,3,63,31,32,57
Coleraine,6703,2,14,10,2,43,23,20,52
Glenavon,6703,3,10,9,7,53,43,10,39
Linfield,6703,4,11,5,10,42,38,4,38
Cliftonville,6703,5,9,4,13,34,36,-2,31
Ballymena,6703,6,7,4,15,26,49,-23,25
Glentoran,6703,7,6,6,10,24,32,-8,24
Dungannon,6703,8,2,4,16,14,47,-33,10
Crusaders,6704,1,17,6,3,63,30,33,57
Coleraine,6704,2,15,10,1,46,23,23,55
Linfield,6704,3,11,5,10,38,36,2,38
Glenavon,6704,4,9,9,8,53,46,7,36
Cliftonville,6704,5,9,4,13,32,32,0,31
Ballymena,6704,6,7,4,15,25,49,-24,25
Glentoran,6704,7,6,6,10,24,32,-8,24
Dungannon,6704,8,2,4,16,14,47,-33,10
Coleraine,6705,1,15,10,1,47,22,25,55
Crusaders,6705,2,16,6,4,62,32,30,54
Linfield,6705,3,11,5,10,38,36,2,38
Glenavon,6705,4,9,9,8,52,47,5,36
Cliftonville,6705,5,9,4,13,32,32,0,31
Ballymena,6705,6,8,4,14,27,48,-21,28
Glentoran,6705,7,6,6,10,24,32,-8,24
Dungannon,6705,8,2,4,16,14,47,-33,10
Crusaders,6706,1,17,6,3,65,30,35,57
Coleraine,6706,2,14,11,1,44,23,21,53
Glenavon,6706,3,9,10,7,53,44,9,37
Linfield,6706,4,10,6,10,38,37,1,36
Cliftonville,6706,5,9,5,12,33,32,1,32
Ballymena,6706,6,7,4,15,25,51,-26,25
Glentoran,6706,7,6,6,10,24,32,-8,24
Dungannon,6706,8,2,4,16,14,47,-33,10
Crusaders,6707,1,16,6,4,63,33,30,54
Coleraine,6707,2,14,10,2,43,25,18,52
Glenavon,6707,3,10,9,7,55,43,12,39
Linfield,6707,4,11,5,10,38,36,2,38
Cliftonville,6707,5,9,4,13,32,32,0,31
Ballymena,6707,6,8,4,14,28,49,-21,28
Glentoran,6707,7,6,6,10,24,32,-8,24
Dungannon,6707,8,2,4,16,14,47,-33,10
Coleraine,6708,1,15,10,1,44,22,22,55
Crusaders,6708,2,16,6,4,62,32,30,54
Linfield,6708,3,11,5,10,39,36,3,38
Glenavon,6708,4,9,9,8,52,44,8,36
Cliftonville,6708,5,9,4,13,32,33,-1,31
Ballymena,6708,6,8,4,14,27,48,-21,28
Glentoran,6708,7,6,6,10,24,32,-8,24
Dungannon,6708,8,2,4,16,14,47,-33,10
Crusaders,6709,1,17,6,3,64,30,34,57
Coleraine,6709,2,15,10,1,45,23,22,55
Linfield,6709,3,11,5,10,39,37,2,38
Glenavon,6709,4,9,9,8,53,45,8,36
Cliftonville,6709,5,9,4,13,33,33,0,31
Ballymena,6709,6,7,4,15,25,50,-25,25
Glentoran,6709,7,6,6,10,24,32,-8,24
Dungannon,6709,8,2,4,16,14,47,-33,10
Crusaders,6710,1,17,6,3,63,31,32,57
Coleraine,6710,2,14,11,1,44,23,21,53
Glenavon,6710,3,9,10,7,53,44,9,37
Linfield,6710,4,10,5,11,39,39,0,35
Cliftonville,6710,5,10,4,12,35,33,2,34
Ballymena,6710,6,7,4,15,26,49,-23,25
Glentoran,6710,7,6,6,10,24,32,-8,24
Dungannon,6710,8,2,4,16,14,47,-33,10
Crusaders,6711,1,17,6,3,65,30,35,57
Coleraine,6711,2,14,10,2,43,23,20,52
Glenavon,6711,3,10,9,7,53,43,10,39
Linfield,6711,4,11,5,10,38,36,2,38
Cliftonville,6711,5,9,4,13,32,32,0,31
Ballymena,6711,6,7,4,15,25,51,-26,25
Glentoran,6711,7,6,6,10,24,32,-8,24
Dungannon,6711,8,2,4,16,14,47,-33,10
Crusaders,6712,1,16,6,4,62,32,30,54
Coleraine,6712,2,14,10,2,44,24,20,52
Glenavon,6712,3,10,9,7,54,44,10,39
Linfield,6712,4,11,5,10,41,36,5,38
Cliftonville,6712,5,9,4,13,32,35,-3,31
Ballymena,6712,6,8,4,14,27,48,-21,28
Glentoran,6712,7,6,6,10,24,32,-8,24
Dungannon,6712,8,2,4,16,14,47,-33,10
Crusaders,6713,1,17,6,3,63,30,33,57
Coleraine,6713,2,14,11,1,44,23,21,53
Linfield,6713,3,11,5,10,40,37,3,38
Glenavon,6713,4,9,10,7,53,44,9,37
Cliftonville,6713,5,9,4,13,33,34,-1,31
Ballymena,6713,6,7,4,15,25,49,-24,25
Glentoran,6713,7,6,6,10,24,32,-8,24
Dungannon,6713,8,2,4,16,14,47,-33,10
Coleraine,6714,1,15,10,1,45,23,22,55
Crusaders,6714,2,16,6,4,61,32,29,54
Linfield,6714,3,11,5,10,39,36,3,38
Glenavon,6714,4,9,9,8,53,45,8,36
Cliftonville,6714,5,9,4,13,32,33,-1,31
Ballymena,6714,6,8,4,14,27,47,-20,28
Glentoran,6714,7,6,6,10,24,32,-8,24
Dungannon,6714,8,2,4,16,14,47,-33,10
Crusaders,6715,1,17,6,3,63,31,32,57
Coleraine,6715,2,14,10,2,43,23,20,52
Glenavon,6715,3,10,9,7,53,43,10,39
Linfield,6715,4,11,5,10,39,36,3,38
Cliftonville,6715,5,9,4,13,32,33,-1,31
Ballymena,6715,6,7,4,15,26,49,-23,25
Glentoran,6715,7,6,6,10,24,32,-8,24
Dungannon,6715,8,2,4,16,14,47,-33,10
Crusaders,6716,1,17,6,3,63,31,32,57
Coleraine,6716,2,14,10,2,45,25,20,52
Glenavon,6716,3,10,9,7,55,45,10,39
Linfield,6716,4,10,5,11,38,38,0,35
Cliftonville,6716,5,10,4,12,34,32,2,34
Ballymena,6716,6,7,4,15,26,49,-23,25
Glentoran,6716,7,6,6,10,24,32,-8,24
Dungannon,6716,8,2,4,16,14,47,-33,10
Crusaders,6717,1,17,6,3,63,31,32,57
Coleraine,6717,2,15,10,1,48,23,25,55
Glenavon,6717,3,9,9,8,53,48,5,36
Linfield,6717,4,10,5,11,37,37,0,35
Cliftonville,6717,5,10,4,12,33,31,2,34
Ballymena,6717,6,7,4,15,26,49,-23,25
Glentoran,6717,7,6,6,10,24,32,-8,24
Dungannon,6717,8,2,4,16,14,47,-33,10
Crusaders,6718,1,16,6,4,62,33,29,54
Coleraine,6718,2,14,10,2,44,24,20,52
Glenavon,6718,3,10,9,7,54,44,10,39
Linfield,6718,4,11,5,10,40,38,2,38
Cliftonville,6718,5,9,4,13,34,34,0,31
Ballymena,6718,6,8,4,14,28,48,-20,28
Glentoran,6718,7,6,6,10,24,32,-8,24
Dungannon,6718,8,2,4,16,14,47,-33,10
Crusaders,6719,1,16,7,3,64,33,31,55
Coleraine,6719,2,14,10,2,45,25,20,52
Glenavon,6719,3,10,9,7,55,45,10,39
Linfield,6719,4,10,6,10,38,37,1,36
Cliftonville,6719,5,9,5,12,33,32,1,32
Ballymena,6719,6,7,5,14,28,50,-22,26
Glentoran,6719,7,6,6,10,24,32,-8,24
Dungannon,6719,8,2,4,16,14,47,-33,10
Crusaders,6720,1,17,6,3,63,31,32,57
Coleraine,6720,2,15,10,1,46,24,22,55
Linfield,6720,3,11,5,10,40,37,3,38
Glenavon,6720,4,9,9,8,54,46,8,36
Cliftonville,6720,5,9,4,13,33,34,-1,31
Ballymena,6720,6,7,4,15,26,49,-23,25
Glentoran,6720,7,6,6,10,24,32,-8,24
Dungannon,6720,8,2,4,16,14,47,-33,10
Crusaders,6721,1,16,6,4,62,32,30,54
Coleraine,6721,2,14,11,1,44,23,21,53
Glenavon,6721,3,9,10,7,53,44,9,37
Linfield,6721,4,10,5,11,37,38,-1,35
Cliftonville,6721,5,10,4,12,34,31,3,34
Ballymena,6721,6,8,4,14,27,48,-21,28
Glentoran,6721,7,6,6,10,24,32,-8,24
Dungannon,6721,8,2,4,16,14,47,-33,10
Crusaders,6722,1,17,6,3,64,30,34,57
Coleraine,6722,2,14,11,1,43,22,21,53
Linfield,6722,3,11,5,10,39,36,3,38
Glenavon,6722,4,9,10,7,52,43,9,37
Cliftonville,6722,5,9,4,13,32,33,-1,31
Ballymena,6722,6,7,4,15,25,50,-25,25
Glentoran,6722,7,6,6,10,24,32,-8,24
Dungannon,6722,8,2,4,16,14,47,-33,10
Crusaders,6723,1,17,6,3,63,31,32,57
Coleraine,6723,2,14,10,2,44,24,20,52
Glenavon,6723,3,10,9,7,54,44,10,39
Linfield,6723,4,10,6,10,38,37,1,36
Cliftonville,6723,5,9,5,12,33,32,1,32
Ballymena,6723,6,7,4,15,26,49,-23,25
Glentoran,6723,7,6,6,10,24,32,-8,24
Dungannon,6723,8,2,4,16,14,47,-33,10
Crusaders,6724,1,16,7,3,62,31,31,55
Coleraine,6724,2,15,10,1,45,23,22,55
Linfield,6724,3,11,5,10,38,36,2,38
Glenavon,6724,4,9,9,8,53,45,8,36
Cliftonville,6724,5,9,4,13,32,32,0,31
Ballymena,6724,6,7,5,14,26,48,-22,26
Glentoran,6724,7,6,6,10,24,32,-8,24
Dungannon,6724,8,2,4,16,14,47,-33,10
Crusaders,6725,1,17,6,3,64,32,32,57
Coleraine,6725,2,15,10,1,47,23,24,55
Linfield,6725,3,11,5,10,40,37,3,38
Glenavon,6725,4,9,9,8,53,47,6,36
Cliftonville,6725,5,9,4,13,33,34,-1,31
Ballymena,6725,6,7,4,15,27,50,-23,25
Glentoran,6725,7,6,6,10,24,32,-8,24
Dungannon,6725,8,2,4,16,14,47,-33,10
Crusaders,6726,1,16,7,3,61,30,31,55
Coleraine,6726,2,15,10,1,45,23,22,55
Glenavon,6726,3,9,9,8,53,45,8,36
Linfield,6726,4,10,5,11,37,37,0,35
Cliftonville,6726,5,10,4,12,33,31,2,34
Ballymena,6726,6,7,5,14,25,47,-22,26
Glentoran,6726,7,6,6,10,24,32,-8,24
Dungannon,6726,8,2,4,16,14,47,-33,10
Crusaders,6727,1,17,6,3,63,31,32,57
Coleraine,6727,2,14,11,1,44,23,21,53
Glenavon,6727,3,9,10,7,53,44,9,37
Linfield,6727,4,10,6,10,37,36,1,36
Cliftonville,6727,5,9,5,12,32,31,1,32
Ballymena,6727,6,7,4,15,26,49,-23,25
Glentoran,6727,7,6,6,10,24,32,-8,24
Dungannon,6727,8,2,4,16,14,47,-33,10
Crusaders,6728,1,17,6,3,63,31,32,57
Coleraine,6728,2,14,10,2,45,25,20,52
Glenavon,6728,3,10,9,7,55,45,10,39
Linfield,6728,4,11,5,10,39,36,3,38
Cliftonville,6728,5,9,4,13,32,33,-1,31
Ballymena,6728,6,7,4,15,26,49,-23,25
Glentoran,6728,7,6,6,10,24,32,-8,24
Dungannon,6728,8,2,4,16,14,47,-33,10
Coleraine,6729,1,15,10,1,46,23,23,55
Crusaders,6729,2,16,6,4,62,33,29,54
Linfield,6729,3,11,5,10,38,36,2,38
Glenavon,6729,4,9,9,8,53,46,7,36
Cliftonville,6729,5,9,4,13,32,32,0,31
Ballymena,6729,6,8,4,14,28,48,-20,28
Glentoran,6729,7,6,6,10,24,32,-8,24
Dungannon,6729,8,2,4,16,14,47,-33,10
Crusaders,6730,1,17,6,3,63,31,32,57
Coleraine,6730,2,14,10,2,44,25,19,52
Glenavon,6730,3,10,9,7,55,44,11,39
Linfield,6730,4,10,5,11,37,38,-1,35
Cliftonville,6730,5,10,4,12,34,31,3,34
Ballymena,6730,6,7,4,15,26,49,-23,25
Glentoran,6730,7,6,6,10,24,32,-8,24
Dungannon,6730,8,2,4,16,14,47,-33,10
Crusaders,6731,1,17,6,3,63,31,32,57
Coleraine,6731,2,14,10,2,43,24,19,52
Glenavon,6731,3,10,9,7,54,43,11,39
Linfield,6731,4,10,5,11,38,39,-1,35
Cliftonville,6731,5,10,4,12,35,32,3,34
Ballymena,6731,6,7,4,15,26,49,-23,25
Glentoran,6731,7,6,6,10,24,32,-8,24
Dungannon,6731,8,2,4,16,14,47,-33,10
Crusaders,6732,1,17,6,3,65,31,34,57
Coleraine,6732,2,14,10,2,43,27,16,52
Glenavon,6732,3,10,9,7,57,43,14,39
Linfield,6732,4,10,5,11,37,37,0,35
Cliftonville,6732,5,10,4,12,33,31,2,34
Ballymena,6732,6,7,4,15,26,51,-25,25
Glentoran,6732,7,6,6,10,24,32,-8,24
Dungannon,6732,8,2,4,16,14,47,-33,10
Crusaders,6733,1,16,7,3,63,32,31,55
Coleraine,6733,2,14,11,1,45,24,21,53
Glenavon,6733,3,9,10,7,54,45,9,37
Linfield,6733,4,10,6,10,38,37,1,36
Cliftonville,6733,5,9,5,12,33,32,1,32
Ballymena,6733,6,7,5,14,27,49,-22,26
Glentoran,6733,7,6,6,10,24,32,-8,24
Dungannon,6733,8,2,4,16,14,47,-33,10
Crusaders,6734,1,17,6,3,64,30,34,57
Coleraine,6734,2,14,11,1,43,22,21,53
Glenavon,6734,3,9,10,7,52,43,9,37
Linfield,6734,4,10,6,10,37,36,1,36
Cliftonville,6734,5,9,5,12,32,31,1,32
Ballymena,6734,6,7,4,15,25,50,-25,25
Glentoran,6734,7,6,6,10,24,32,-8,24
Dungannon,6734,8,2,4,16,14,47,-33,10
Crusaders,6735,1,17,6,3,63,30,33,57
Coleraine,6735,2,14,10,2,45,28,17,52
Glenavon,6735,3,10,9,7,58,45,13,39
Linfield,6735,4,10,6,10,37,36,1,36
Cliftonville,6735,5,9,5,12,32,31,1,32
Ballymena,6735,6,7,4,15,25,49,-24,25
Glentoran,6735,7,6,6,10,24,32,-8,24
Dungannon,6735,8,2,4,16,14,47,-33,10
Crusaders,6736,1,16,6,4,61,31,30,54
Coleraine,6736,2,14,10,2,43,26,17,52
Glenavon,6736,3,10,9,7,56,43,13,39
Linfield,6736,4,10,5,11,37,37,0,35
Cliftonville,6736,5,10,4,12,33,31,2,34
Ballymena,6736,6,8,4,14,26,47,-21,28
Glentoran,6736,7,6,6,10,24,32,-8,24
Dungannon,6736,8,2,4,16,14,47,-33,10
Coleraine,6737,1,15,10,1,45,22,23,55
Crusaders,6737,2,16,6,4,61,31,30,54
Glenavon,6737,3,9,9,8,52,45,7,36
Linfield,6737,4,10,6,10,38,37,1,36
Cliftonville,6737,5,9,5,12,33,32,1,32
Ballymena,6737,6,8,4,14,26,47,-21,28
Glentoran,6737,7,6,6,10,24,32,-8,24
Dungannon,6737,8,2,4,16,14,47,-33,10
Crusaders,6738,1,16,7,3,62,31,31,55
Coleraine,6738,2,14,10,2,43,23,20,52
Glenavon,6738,3,10,9,7,53,43,10,39
Linfield,6738,4,10,6,10,37,36,1,36
Cliftonville,6738,5,9,5,12,32,31,1,32
Ballymena,6738,6,7,5,14,26,48,-22,26
Glentoran,6738,7,6,6,10,24,32,-8,24
Dungannon,6738,8,2,4,16,14,47,-33,10
Crusaders,6739,1,17,6,3,64,31,33,57
Coleraine,6739,2,15,10,1,44,22,22,55
Linfield,6739,3,11,5,10,39,36,3,38
Glenavon,6739,4,9,9,8,52,44,8,36
Cliftonville,6739,5,9,4,13,32,33,-1,31
Ballymena,6739,6,7,4,15,26,50,-24,25
Glentoran,6739,7,6,6,10,24,32,-8,24
Dungannon,6739,8,2,4,16,14,47,-33,10
Crusaders,6740,1,16,7,3,63,32,31,55
Coleraine,6740,2,14,11,1,46,25,21,53
Glenavon,6740,3,9,10,7,55,46,9,37
Linfield,6740,4,10,6,10,38,37,1,36
Cliftonville,6740,5,9,5,12,33,32,1,32
Ballymena,6740,6,7,5,14,27,49,-22,26
Glentoran,6740,7,6,6,10,24,32,-8,24
Dungannon,6740,8,2,4,16,14,47,-33,10
Crusaders,6741,1,16,6,4,62,33,29,54
Coleraine,6741,2,14,10,2,44,26,18,52
Glenavon,6741,3,10,9,7,56,44,12,39
Linfield,6741,4,11,5,10,40,37,3,38
Cliftonville,6741,5,9,4,13,33,34,-1,31
Ballymena,6741,6,8,4,14,28,48,-20,28
Glentoran,6741,7,6,6,10,24,32,-8,24
Dungannon,6741,8,2,4,16,14,47,-33,10
Crusaders,6742,1,16,7,3,62,31,31,55
Coleraine,6742,2,14,10,2,44,25,19,52
Glenavon,6742,3,10,9,7,55,44,11,39
Linfield,6742,4,10,6,10,38,37,1,36
Cliftonville,6742,5,9,5,12,33,32,1,32
Ballymena,6742,6,7,5,14,26,48,-22,26
Glentoran,6742,7,6,6,10,24,32,-8,24
Dungannon,6742,8,2,4,16,14,47,-33,10
Crusaders,6743,1,17,6,3,64,32,32,57
Coleraine,6743,2,14,11,1,46,25,21,53
Linfield,6743,3,11,5,10,40,37,3,38
Glenavon,6743,4,9,10,7,55,46,9,37
Cliftonville,6743,5,9,4,13,33,34,-1,31
Ballymena,6743,6,7,4,15,27,50,-23,25
Glentoran,6743,7,6,6,10,24,32,-8,24
Dungannon,6743,8,2,4,16,14,47,-33,10
Crusaders,6744,1,17,6,3,62,30,32,57
Coleraine,6744,2,14,11,1,46,25,21,53
Glenavon,6744,3,9,10,7,55,46,9,37
Linfield,6744,4,10,6,10,38,37,1,36
Cliftonville,6744,5,9,5,12,33,32,1,32
Ballymena,6744,6,7,4,15,25,48,-23,25
Glentoran,6744,7,6,6,10,24,32,-8,24
Dungannon,6744,8,2,4,16,14,47,-33,10
Crusaders,6745,1,16,7,3,62,31,31,55
Coleraine,6745,2,15,10,1,45,22,23,55
Glenavon,6745,3,9,9,8,52,45,7,36
Linfield,6745,4,10,6,10,38,37,1,36
Cliftonville,6745,5,9,5,12,33,32,1,32
Ballymena,6745,6,7,5,14,26,48,-22,26
Glentoran,6745,7,6,6,10,24,32,-8,24
Dungannon,6745,8,2,4,16,14,47,-33,10
Crusaders,6746,1,16,6,4,62,33,29,54
Coleraine,6746,2,14,11,1,46,25,21,53
Glenavon,6746,3,9,10,7,55,46,9,37
Linfield,6746,4,10,5,11,37,37,0,35
Cliftonville,6746,5,10,4,12,33,31,2,34
Ballymena,6746,6,8,4,14,28,48,-20,28
Glentoran,6746,7,6,6,10,24,32,-8,24
Dungannon,6746,8,2,4,16,14,47,-33,10
Crusaders,6747,1,17,6,3,64,31,33,57
Coleraine,6747,2,14,10,2,43,24,19,52
Glenavon,6747,3,10,9,7,54,43,11,39
Linfield,6747,4,11,5,10,40,37,3,38
Cliftonville,6747,5,9,4,13,33,34,-1,31
Ballymena,6747,6,7,4,15,26,50,-24,25
Glentoran,6747,7,6,6,10,24,32,-8,24
Dungannon,6747,8,2,4,16,14,47,-33,10
Crusaders,6748,1,17,6,3,63,31,32,57
Coleraine,6748,2,15,10,1,44,22,22,55
Linfield,6748,3,11,5,10,39,36,3,38
Glenavon,6748,4,9,9,8,52,44,8,36
Cliftonville,6748,5,9,4,13,32,33,-1,31
Ballymena,6748,6,7,4,15,26,49,-23,25
Glentoran,6748,7,6,6,10,24,32,-8,24
Dungannon,6748,8,2,4,16,14,47,-33,10
Crusaders,6749,1,17,6,3,64,31,33,57
Coleraine,6749,2,14,10,2,43,26,17,52
Glenavon,6749,3,10,9,7,56,43,13,39
Linfield,6749,4,10,6,10,38,37,1,36
Cliftonville,6749,5,9,5,12,33,32,1,32
Ballymena,6749,6,7,4,15,26,50,-24,25
Glentoran,6749,7,6,6,10,24,32,-8,24
Dungannon,6749,8,2,4,16,14,47,-33,10
Crusaders,6750,1,17,6,3,63,31,32,57
Coleraine,6750,2,14,11,1,44,23,21,53
Linfield,6750,3,11,5,10,40,37,3,38
Glenavon,6750,4,9,10,7,53,44,9,37
Cliftonville,6750,5,9,4,13,33,34,-1,31
Ballymena,6750,6,7,4,15,26,49,-23,25
Glentoran,6750,7,6,6,10,24,32,-8,24
Dungannon,6750,8,2,4,16,14,47,-33,10
Crusaders,6751,1,16,6,4,62,34,28,54
Coleraine,6751,2,14,11,1,43,22,21,53
Linfield,6751,3,11,5,10,40,37,3,38
Glenavon,6751,4,9,10,7,52,43,9,37
Cliftonville,6751,5,9,4,13,33,34,-1,31
Ballymena,6751,6,8,4,14,29,48,-19,28
Glentoran,6751,7,6,6,10,24,32,-8,24
Dungannon,6751,8,2,4,16,14,47,-33,10
Coleraine,6752,1,15,10,1,46,24,22,55
Crusaders,6752,2,16,6,4,61,31,30,54
Glenavon,6752,3,9,9,8,54,46,8,36
Linfield,6752,4,10,5,11,40,40,0,35
Cliftonville,6752,5,10,4,12,36,34,2,34
Ballymena,6752,6,8,4,14,26,47,-21,28
Glentoran,6752,7,6,6,10,24,32,-8,24
Dungannon,6752,8,2,4,16,14,47,-33,10
Crusaders,6753,1,17,6,3,65,30,35,57
Coleraine,6753,2,14,10,2,44,24,20,52
Glenavon,6753,3,10,9,7,54,44,10,39
Linfield,6753,4,11,5,10,39,36,3,38
Cliftonville,6753,5,9,4,13,32,33,-1,31
Ballymena,6753,6,7,4,15,25,51,-26,25
Glentoran,6753,7,6,6,10,24,32,-8,24
Dungannon,6753,8,2,4,16,14,47,-33,10
Crusaders,6754,1,17,6,3,63,30,33,57
Coleraine,6754,2,15,10,1,45,23,22,55
Glenavon,6754,3,9,9,8,53,45,8,36
Linfield,6754,4,10,5,11,37,37,0,35
Cliftonville,6754,5,10,4,12,33,31,2,34
Ballymena,6754,6,7,4,15,25,49,-24,25
Glentoran,6754,7,6,6,10,24,32,-8,24
Dungannon,6754,8,2,4,16,14,47,-33,10
Crusaders,6755,1,16,6,4,61,33,28,54
Coleraine,6755,2,14,10,2,43,23,20,52
Glenavon,6755,3,10,9,7,53,43,10,39
Linfield,6755,4,11,5,10,41,36,5,38
Cliftonville,6755,5,9,4,13,32,35,-3,31
Ballymena,6755,6,8,4,14,28,47,-19,28
Glentoran,6755,7,6,6,10,24,32,-8,24
Dungannon,6755,8,2,4,16,14,47,-33,10
Crusaders,6756,1,16,7,3,63,32,31,55
Coleraine,6756,2,14,11,1,44,23,21,53
Linfield,6756,3,11,5,10,38,36,2,38
Glenavon,6756,4,9,10,7,53,44,9,37
Cliftonville,6756,5,9,4,13,32,32,0,31
Ballymena,6756,6,7,5,14,27,49,-22,26
Glentoran,6756,7,6,6,10,24,32,-8,24
Dungannon,6756,8,2,4,16,14,47,-33,10
Crusaders,6757,1,17,6,3,64,31,33,57
Coleraine,6757,2,15,10,1,45,22,23,55
Glenavon,6757,3,9,9,8,52,45,7,36
Linfield,6757,4,10,5,11,40,40,0,35
Cliftonville,6757,5,10,4,12,36,34,2,34
Ballymena,6757,6,7,4,15,26,50,-24,25
Glentoran,6757,7,6,6,10,24,32,-8,24
Dungannon,6757,8,2,4,16,14,47,-33,10
Crusaders,6758,1,17,6,3,62,30,32,57
Coleraine,6758,2,14,10,2,45,25,20,52
Glenavon,6758,3,10,9,7,55,45,10,39
Linfield,6758,4,11,5,10,39,37,2,38
Cliftonville,6758,5,9,4,13,33,33,0,31
Ballymena,6758,6,7,4,15,25,48,-23,25
Glentoran,6758,7,6,6,10,24,32,-8,24
Dungannon,6758,8,2,4,16,14,47,-33,10
Crusaders,6759,1,16,7,3,63,32,31,55
Coleraine,6759,2,14,10,2,44,25,19,52
Glenavon,6759,3,10,9,7,55,44,11,39
Linfield,6759,4,10,6,10,38,37,1,36
Cliftonville,6759,5,9,5,12,33,32,1,32
Ballymena,6759,6,7,5,14,27,49,-22,26
Glentoran,6759,7,6,6,10,24,32,-8,24
Dungannon,6759,8,2,4,16,14,47,-33,10
Crusaders,6760,1,16,7,3,61,30,31,55
Coleraine,6760,2,14,10,2,44,25,19,52
Glenavon,6760,3,10,9,7,55,44,11,39
Linfield,6760,4,11,5,10,40,37,3,38
Cliftonville,6760,5,9,4,13,33,34,-1,31
Ballymena,6760,6,7,5,14,25,47,-22,26
Glentoran,6760,7,6,6,10,24,32,-8,24
Dungannon,6760,8,2,4,16,14,47,-33,10
Crusaders,6761,1,16,6,4,63,34,29,54
Coleraine,6761,2,14,10,2,44,24,20,52
Glenavon,6761,3,10,9,7,54,44,10,39
Linfield,6761,4,10,6,10,39,38,1,36
Cliftonville,6761,5,9,5,12,34,33,1,32
Ballymena,6761,6,8,4,14,29,49,-20,28
Glentoran,6761,7,6,6,10,24,32,-8,24
Dungannon,6761,8,2,4,16,14,47,-33,10
Crusaders,6762,1,17,6,3,64,31,33,57
Coleraine,6762,2,14,10,2,43,25,18,52
Glenavon,6762,3,10,9,7,55,43,12,39
Linfield,6762,4,11,5,10,39,36,3,38
Cliftonville,6762,5,9,4,13,32,33,-1,31
Ballymena,6762,6,7,4,15,26,50,-24,25
Glentoran,6762,7,6,6,10,24,32,-8,24
Dungannon,6762,8,2,4,16,14,47,-33,10
Crusaders,6763,1,17,6,3,63,31,32,57
Coleraine,6763,2,15,10,1,45,22,23,55
Glenavon,6763,3,9,9,8,52,45,7,36
Linfield,6763,4,10,5,11,38,38,0,35
Cliftonville,6763,5,10,4,12,34,32,2,34
Ballymena,6763,6,7,4,15,26,49,-23,25
Glentoran,6763,7,6,6,10,24,32,-8,24
Dungannon,6763,8,2,4,16,14,47,-33,10
Crusaders,6764,1,16,7,3,63,32,31,55
Coleraine,6764,2,14,10,2,44,30,14,52
Glenavon,6764,3,10,9,7,60,44,16,39
Linfield,6764,4,10,6,10,39,38,1,36
Cliftonville,6764,5,9,5,12,34,33,1,32
Ballymena,6764,6,7,5,14,27,49,-22,26
Glentoran,6764,7,6,6,10,24,32,-8,24
Dungannon,6764,8,2,4,16,14,47,-33,10
Crusaders,6765,1,17,6,3,62,30,32,57
Coleraine,6765,2,14,11,1,44,23,21,53
Glenavon,6765,3,9,10,7,53,44,9,37
Linfield,6765,4,10,6,10,38,37,1,36
Cliftonville,6765,5,9,5,12,33,32,1,32
Ballymena,6765,6,7,4,15,25,48,-23,25
Glentoran,6765,7,6,6,10,24,32,-8,24
Dungannon,6765,8,2,4,16,14,47,-33,10
Crusaders,6766,1,17,6,3,63,30,33,57
Coleraine,6766,2,15,10,1,46,22,24,55
Glenavon,6766,3,9,9,8,52,46,6,36
Linfield,6766,4,10,5,11,37,37,0,35
Cliftonville,6766,5,10,4,12,33,31,2,34
Ballymena,6766,6,7,4,15,25,49,-24,25
Glentoran,6766,7,6,6,10,24,32,-8,24
Dungannon,6766,8,2,4,16,14,47,-33,10
Crusaders,6767,1,17,6,3,65,30,35,57
Coleraine,6767,2,14,10,2,44,26,18,52
Glenavon,6767,3,10,9,7,56,44,12,39
Linfield,6767,4,11,5,10,40,37,3,38
Cliftonville,6767,5,9,4,13,33,34,-1,31
Ballymena,6767,6,7,4,15,25,51,-26,25
Glentoran,6767,7,6,6,10,24,32,-8,24
Dungannon,6767,8,2,4,16,14,47,-33,10
Crusaders,6768,1,17,6,3,64,32,32,57
Coleraine,6768,2,14,10,2,44,26,18,52
Glenavon,6768,3,10,9,7,56,44,12,39
Linfield,6768,4,11,5,10,38,36,2,38
Cliftonville,6768,5,9,4,13,32,32,0,31
Ballymena,6768,6,7,4,15,27,50,-23,25
Glentoran,6768,7,6,6,10,24,32,-8,24
Dungannon,6768,8,2,4,16,14,47,-33,10
Crusaders,6769,1,16,6,4,62,32,30,54
Coleraine,6769,2,14,11,1,46,25,21,53
Glenavon,6769,3,9,10,7,55,46,9,37
Linfield,6769,4,10,6,10,37,36,1,36
Cliftonville,6769,5,9,5,12,32,31,1,32
Ballymena,6769,6,8,4,14,27,48,-21,28
Glentoran,6769,7,6,6,10,24,32,-8,24
Dungannon,6769,8,2,4,16,14,47,-33,10
Crusaders,6770,1,17,6,3,64,32,32,57
Coleraine,6770,2,14,11,1,45,24,21,53
Glenavon,6770,3,9,10,7,54,45,9,37
Linfield,6770,4,10,6,10,38,37,1,36
Cliftonville,6770,5,9,5,12,33,32,1,32
Ballymena,6770,6,7,4,15,27,50,-23,25
Glentoran,6770,7,6,6,10,24,32,-8,24
Dungannon,6770,8,2,4,16,14,47,-33,10
Coleraine,6771,1,15,10,1,47,24,23,55
Crusaders,6771,2,16,6,4,63,33,30,54
Linfield,6771,3,11,5,10,38,36,2,38
Glenavon,6771,4,9,9,8,54,47,7,36
Cliftonville,6771,5,9,4,13,32,32,0,31
Ballymena,6771,6,8,4,14,28,49,-21,28
Glentoran,6771,7,6,6,10,24,32,-8,24
Dungannon,6771,8,2,4,16,14,47,-33,10
Crusaders,6772,1,17,6,3,65,30,35,57
Coleraine,6772,2,14,11,1,44,23,21,53
Glenavon,6772,3,9,10,7,53,44,9,37
Linfield,6772,4,10,6,10,38,37,1,36
Cliftonville,6772,5,9,5,12,33,32,1,32
Ballymena,6772,6,7,4,15,25,51,-26,25
Glentoran,6772,7,6,6,10,24,32,-8,24
Dungannon,6772,8,2,4,16,14,47,-33,10
Crusaders,6773,1,17,6,3,64,31,33,57
Coleraine,6773,2,15,10,1,48,22,26,55
Glenavon,6773,3,9,9,8,52,48,4,36
Linfield,6773,4,10,5,11,37,37,0,35
Cliftonville,6773,5,10,4,12,33,31,2,34
Ballymena,6773,6,7,4,15,26,50,-24,25
Glentoran,6773,7,6,6,10,24,32,-8,24
Dungannon,6773,8,2,4,16,14,47,-33,10
Crusaders,6774,1,16,7,3,62,31,31,55
Coleraine,6774,2,15,10,1,46,23,23,55
Linfield,6774,3,11,5,10,39,36,3,38
Glenavon,6774,4,9,9,8,53,46,7,36
Cliftonville,6774,5,9,4,13,32,33,-1,31
Ballymena,6774,6,7,5,14,26,48,-22,26
Glentoran,6774,7,6,6,10,24,32,-8,24
Dungannon,6774,8,2,4,16,14,47,-33,10
Crusaders,6775,1,17,6,3,64,32,32,57
Coleraine,6775,2,14,10,2,44,24,20,52
Glenavon,6775,3,10,9,7,54,44,10,39
Linfield,6775,4,10,6,10,37,36,1,36
Cliftonville,6775,5,9,5,12,32,31,1,32
Ballymena,6775,6,7,4,15,27,50,-23,25
Glentoran,6775,7,6,6,10,24,32,-8,24
Dungannon,6775,8,2,4,16,14,47,-33,10
Crusaders,6776,1,17,6,3,62,30,32,57
Coleraine,6776,2,15,10,1,46,24,22,55
Glenavon,6776,3,9,9,8,54,46,8,36
Linfield,6776,4,10,6,10,38,37,1,36
Cliftonville,6776,5,9,5,12,33,32,1,32
Ballymena,6776,6,7,4,15,25,48,-23,25
Glentoran,6776,7,6,6,10,24,32,-8,24
Dungannon,6776,8,2,4,16,14,47,-33,10
Crusaders,6777,1,17,6,3,64,31,33,57
Coleraine,6777,2,14,11,1,44,23,21,53
Glenavon,6777,3,9,10,7,53,44,9,37
Linfield,6777,4,10,5,11,38,38,0,35
Cliftonville,6777,5,10,4,12,34,32,2,34
Ballymena,6777,6,7,4,15,26,50,-24,25
Glentoran,6777,7,6,6,10,24,32,-8,24
Dungannon,6777,8,2,4,16,14,47,-33,10
Crusaders,6778,1,17,6,3,63,31,32,57
Coleraine,6778,2,14,11,1,45,24,21,53
Linfield,6778,3,11,5,10,39,36,3,38
Glenavon,6778,4,9,10,7,54,45,9,37
Cliftonville,6778,5,9,4,13,32,33,-1,31
Ballymena,6778,6,7,4,15,26,49,-23,25
Glentoran,6778,7,6,6,10,24,32,-8,24
Dungannon,6778,8,2,4,16,14,47,-33,10
Crusaders,6779,1,17,6,3,65,32,33,57
Coleraine,6779,2,15,10,1,45,23,22,55
Linfield,6779,3,11,5,10,38,36,2,38
Glenavon,6779,4,9,9,8,53,45,8,36
Cliftonville,6779,5,9,4,13,32,32,0,31
Ballymena,6779,6,7,4,15,27,51,-24,25
Glentoran,6779,7,6,6,10,24,32,-8,24
Dungannon,6779,8,2,4,16,14,47,-33,10
Crusaders,6780,1,17,6,3,63,31,32,57
Coleraine,6780,2,14,11,1,43,22,21,53
Linfield,6780,3,11,5,10,38,36,2,38
Glenavon,6780,4,9,10,7,52,43,9,37
Cliftonville,6780,5,9,4,13,32,32,0,31
Ballymena,6780,6,7,4,15,26,49,-23,25
Glentoran,6780,7,6,6,10,24,32,-8,24
Dungannon,6780,8,2,4,16,14,47,-33,10
Crusaders,6781,1,16,7,3,63,32,31,55
Coleraine,6781,2,15,10,1,46,22,24,55
Glenavon,6781,3,9,9,8,52,46,6,36
Linfield,6781,4,10,5,11,37,37,0,35
Cliftonville,6781,5,10,4,12,33,31,2,34
Ballymena,6781,6,7,5,14,27,49,-22,26
Glentoran,6781,7,6,6,10,24,32,-8,24
Dungannon,6781,8,2,4,16,14,47,-33,10
Crusaders,6782,1,17,6,3,63,31,32,57
Coleraine,6782,2,15,10,1,46,22,24,55
Glenavon,6782,3,9,9,8,52,46,6,36
Linfield,6782,4,10,6,10,37,36,1,36
Cliftonville,6782,5,9,5,12,32,31,1,32
Ballymena,6782,6,7,4,15,26,49,-23,25
Glentoran,6782,7,6,6,10,24,32,-8,24
Dungannon,6782,8,2,4,16,14,47,-33,10
Crusaders,6783,1,17,6,3,63,30,33,57
Coleraine,6783,2,15,10,1,46,24,22,55
Linfield,6783,3,11,5,10,38,36,2,38
Glenavon,6783,4,9,9,8,54,46,8,36
Cliftonville,6783,5,9,4,13,32,32,0,31
Ballymena,6783,6,7,4,15,25,49,-24,25
Glentoran,6783,7,6,6,10,24,32,-8,24
Dungannon,6783,8,2,4,16,14,47,-33,10
Crusaders,6784,1,17,6,3,63,31,32,57
Coleraine,6784,2,14,11,1,44,23,21,53
Linfield,6784,3,11,5,10,39,37,2,38
Glenavon,6784,4,9,10,7,53,44,9,37
Cliftonville,6784,5,9,4,13,33,33,0,31
Ballymena,6784,6,7,4,15,26,49,-23,25
Glentoran,6784,7,6,6,10,24,32,-8,24
Dungannon,6784,8,2,4,16,14,47,-33,10
Crusaders,6785,1,16,6,4,63,33,30,54
Coleraine,6785,2,14,11,1,45,24,21,53
Glenavon,6785,3,9,10,7,54,45,9,37
Linfield,6785,4,10,5,11,37,37,0,35
Cliftonville,6785,5,10,4,12,33,31,2,34
Ballymena,6785,6,8,4,14,28,49,-21,28
Glentoran,6785,7,6,6,10,24,32,-8,24
Dungannon,6785,8,2,4,16,14,47,-33,10
Coleraine,6786,1,15,10,1,47,22,25,55
Crusaders,6786,2,16,6,4,61,31,30,54
Glenavon,6786,3,9,9,8,52,47,5,36
Linfield,6786,4,10,6,10,38,37,1,36
Cliftonville,6786,5,9,5,12,33,32,1,32
Ballymena,6786,6,8,4,14,26,47,-21,28
Glentoran,6786,7,6,6,10,24,32,-8,24
Dungannon,6786,8,2,4,16,14,47,-33,10
Crusaders,6787,1,16,6,4,61,31,30,54
Coleraine,6787,2,14,11,1,45,24,21,53
Linfield,6787,3,11,5,10,39,36,3,38
Glenavon,6787,4,9,10,7,54,45,9,37
Cliftonville,6787,5,9,4,13,32,33,-1,31
Ballymena,6787,6,8,4,14,26,47,-21,28
Glentoran,6787,7,6,6,10,24,32,-8,24
Dungannon,6787,8,2,4,16,14,47,-33,10
Crusaders,6788,1,17,6,3,66,33,33,57
Coleraine,6788,2,15,10,1,46,24,22,55
Glenavon,6788,3,9,9,8,54,46,8,36
Linfield,6788,4,10,5,11,38,39,-1,35
Cliftonville,6788,5,10,4,12,35,32,3,34
Ballymena,6788,6,7,4,15,28,52,-24,25
Glentoran,6788,7,6,6,10,24,32,-8,24
Dungannon,6788,8,2,4,16,14,47,-33,10
Crusaders,6789,1,16,7,3,63,32,31,55
Coleraine,6789,2,14,10,2,43,25,18,52
Glenavon,6789,3,10,9,7,55,43,12,39
Linfield,6789,4,10,5,11,38,38,0,35
Cliftonville,6789,5,10,4,12,34,32,2,34
Ballymena,6789,6,7,5,14,27,49,-22,26
Glentoran,6789,7,6,6,10,24,32,-8,24
Dungannon,6789,8,2,4,16,14,47,-33,10
Crusaders,6790,1,17,6,3,63,30,33,57
Coleraine,6790,2,15,10,1,46,24,22,55
Linfield,6790,3,11,5,10,40,36,4,38
Glenavon,6790,4,9,9,8,54,46,8,36
Cliftonville,6790,5,9,4,13,32,34,-2,31
Ballymena,6790,6,7,4,15,25,49,-24,25
Glentoran,6790,7,6,6,10,24,32,-8,24
Dungannon,6790,8,2,4,16,14,47,-33,10
Crusaders,6791,1,17,6,3,63,30,33,57
Coleraine,6791,2,14,10,2,43,24,19,52
Glenavon,6791,3,10,9,7,54,43,11,39
Linfield,6791,4,11,5,10,40,36,4,38
Cliftonville,6791,5,9,4,13,32,34,-2,31
Ballymena,6791,6,7,4,15,25,49,-24,25
Glentoran,6791,7,6,6,10,24,32,-8,24
Dungannon,6791,8,2,4,16,14,47,-33,10
Crusaders,6792,1,16,6,4,61,33,28,54
Coleraine,6792,2,14,10,2,44,25,19,52
Glenavon,6792,3,10,9,7,55,44,11,39
Linfield,6792,4,11,5,10,40,36,4,38
Cliftonville,6792,5,9,4,13,32,34,-2,31
Ballymena,6792,6,8,4,14,28,47,-19,28
Glentoran,6792,7,6,6,10,24,32,-8,24
Dungannon,6792,8,2,4,16,14,47,-33,10
Crusaders,6793,1,17,6,3,63,30,33,57
Coleraine,6793,2,14,11,1,44,23,21,53
Linfield,6793,3,11,5,10,40,38,2,38
Glenavon,6793,4,9,10,7,53,44,9,37
Cliftonville,6793,5,9,4,13,34,34,0,31
Ballymena,6793,6,7,4,15,25,49,-24,25
Glentoran,6793,7,6,6,10,24,32,-8,24
Dungannon,6793,8,2,4,16,14,47,-33,10
Crusaders,6794,1,17,6,3,64,32,32,57
Coleraine,6794,2,14,10,2,43,23,20,52
Glenavon,6794,3,10,9,7,53,43,10,39
Linfield,6794,4,10,5,11,38,38,0,35
Cliftonville,6794,5,10,4,12,34,32,2,34
Ballymena,6794,6,7,4,15,27,50,-23,25
Glentoran,6794,7,6,6,10,24,32,-8,24
Dungannon,6794,8,2,4,16,14,47,-33,10
Crusaders,6795,1,16,6,4,61,31,30,54
Coleraine,6795,2,14,10,2,45,25,20,52
Glenavon,6795,3,10,9,7,55,45,10,39
Linfield,6795,4,11,5,10,38,36,2,38
Cliftonville,6795,5,9,4,13,32,32,0,31
Ballymena,6795,6,8,4,14,26,47,-21,28
Glentoran,6795,7,6,6,10,24,32,-8,24
Dungannon,6795,8,2,4,16,14,47,-33,10
Crusaders,6796,1,16,7,3,63,32,31,55
Coleraine,6796,2,14,11,1,45,24,21,53
Glenavon,6796,3,9,10,7,54,45,9,37
Linfield,6796,4,10,5,11,38,39,-1,35
Cliftonville,6796,5,10,4,12,35,32,3,34
Ballymena,6796,6,7,5,14,27,49,-22,26
Glentoran,6796,7,6,6,10,24,32,-8,24
Dungannon,6796,8,2,4,16,14,47,-33,10
Crusaders,6797,1,17,6,3,63,30,33,57
Coleraine,6797,2,14,10,2,46,27,19,52
Glenavon,6797,3,10,9,7,57,46,11,39
Linfield,6797,4,10,6,10,37,36,1,36
Cliftonville,6797,5,9,5,12,32,31,1,32
Ballymena,6797,6,7,4,15,25,49,-24,25
Glentoran,6797,7,6,6,10,24,32,-8,24
Dungannon,6797,8,2,4,16,14,47,-33,10
Coleraine,6798,1,15,10,1,46,24,22,55
Crusaders,6798,2,16,6,4,63,34,29,54
Linfield,6798,3,11,5,10,40,37,3,38
Glenavon,6798,4,9,9,8,54,46,8,36
Cliftonville,6798,5,9,4,13,33,34,-1,31
Ballymena,6798,6,8,4,14,29,49,-20,28
Glentoran,6798,7,6,6,10,24,32,-8,24
Dungannon,6798,8,2,4,16,14,47,-33,10
Crusaders,6799,1,17,6,3,66,31,35,57
Coleraine,6799,2,14,10,2,44,24,20,52
Glenavon,6799,3,10,9,7,54,44,10,39
Linfield,6799,4,11,5,10,39,36,3,38
Cliftonville,6799,5,9,4,13,32,33,-1,31
Ballymena,6799,6,7,4,15,26,52,-26,25
Glentoran,6799,7,6,6,10,24,32,-8,24
Dungannon,6799,8,2,4,16,14,47,-33,10
Coleraine,6800,1,15,10,1,45,23,22,55
Crusaders,6800,2,16,6,4,62,32,30,54
Glenavon,6800,3,9,9,8,53,45,8,36
Linfield,6800,4,10,6,10,39,38,1,36
Cliftonville,6800,5,9,5,12,34,33,1,32
Ballymena,6800,6,8,4,14,27,48,-21,28
Glentoran,6800,7,6,6,10,24,32,-8,24
Dungannon,6800,8,2,4,16,14,47,-33,10
Crusaders,6801,1,16,6,4,61,31,30,54
Coleraine,6801,2,14,10,2,43,24,19,52
Glenavon,6801,3,10,9,7,54,43,11,39
Linfield,6801,4,10,5,11,38,39,-1,35
Cliftonville,6801,5,10,4,12,35,32,3,34
Ballymena,6801,6,8,4,14,26,47,-21,28
Glentoran,6801,7,6,6,10,24,32,-8,24
Dungannon,6801,8,2,4,16,14,47,-33,10
Crusaders,6802,1,16,6,4,61,32,29,54
Coleraine,6802,2,14,10,2,44,24,20,52
Glenavon,6802,3,10,9,7,54,44,10,39
Linfield,6802,4,10,6,10,37,36,1,36
Cliftonville,6802,5,9,5,12,32,31,1,32
Ballymena,6802,6,8,4,14,27,47,-20,28
Glentoran,6802,7,6,6,10,24,32,-8,24
Dungannon,6802,8,2,4,16,14,47,-33,10
Crusaders,6803,1,17,6,3,63,30,33,57
Coleraine,6803,2,14,10,2,43,29,14,52
Glenavon,6803,3,10,9,7,59,43,16,39
Linfield,6803,4,10,6,10,37,36,1,36
Cliftonville,6803,5,9,5,12,32,31,1,32
Ballymena,6803,6,7,4,15,25,49,-24,25
Glentoran,6803,7,6,6,10,24,32,-8,24
Dungannon,6803,8,2,4,16,14,47,-33,10
Crusaders,6804,1,16,7,3,63,32,31,55
Coleraine,6804,2,14,11,1,45,24,21,53
Glenavon,6804,3,9,10,7,54,45,9,37
Linfield,6804,4,10,6,10,39,38,1,36
Cliftonville,6804,5,9,5,12,34,33,1,32
Ballymena,6804,6,7,5,14,27,49,-22,26
Glentoran,6804,7,6,6,10,24,32,-8,24
Dungannon,6804,8,2,4,16,14,47,-33,10
Crusaders,6805,1,17,6,3,64,32,32,57
Coleraine,6805,2,14,11,1,44,23,21,53
Glenavon,6805,3,9,10,7,53,44,9,37
Linfield,6805,4,10,5,11,38,38,0,35
Cliftonville,6805,5,10,4,12,34,32,2,34
Ballymena,6805,6,7,4,15,27,50,-23,25
Glentoran,6805,7,6,6,10,24,32,-8,24
Dungannon,6805,8,2,4,16,14,47,-33,10
Crusaders,6806,1,16,7,3,61,30,31,55
Coleraine,6806,2,14,10,2,44,25,19,52
Glenavon,6806,3,10,9,7,55,44,11,39
Linfield,6806,4,10,5,11,37,37,0,35
Cliftonville,6806,5,10,4,12,33,31,2,34
Ballymena,6806,6,7,5,14,25,47,-22,26
Glentoran,6806,7,6,6,10,24,32,-8,24
Dungannon,6806,8,2,4,16,14,47,-33,10
Crusaders,6807,1,17,6,3,64,31,33,57
Coleraine,6807,2,14,10,2,44,25,19,52
Glenavon,6807,3,10,9,7,55,44,11,39
Linfield,6807,4,11,5,10,41,36,5,38
Cliftonville,6807,5,9,4,13,32,35,-3,31
Ballymena,6807,6,7,4,15,26,50,-24,25
Glentoran,6807,7,6,6,10,24,32,-8,24
Dungannon,6807,8,2,4,16,14,47,-33,10
Crusaders,6808,1,17,6,3,62,30,32,57
Coleraine,6808,2,14,10,2,43,23,20,52
Glenavon,6808,3,10,9,7,53,43,10,39
Linfield,6808,4,10,6,10,39,38,1,36
Cliftonville,6808,5,9,5,12,34,33,1,32
Ballymena,6808,6,7,4,15,25,48,-23,25
Glentoran,6808,7,6,6,10,24,32,-8,24
Dungannon,6808,8,2,4,16,14,47,-33,10
Crusaders,6809,1,16,7,3,61,30,31,55
Coleraine,6809,2,15,10,1,44,22,22,55
Linfield,6809,3,11,5,10,39,37,2,38
Glenavon,6809,4,9,9,8,52,44,8,36
Cliftonville,6809,5,9,4,13,33,33,0,31
Ballymena,6809,6,7,5,14,25,47,-22,26
Glentoran,6809,7,6,6,10,24,32,-8,24
Dungannon,6809,8,2,4,16,14,47,-33,10
Coleraine,6810,1,15,10,1,44,22,22,55
Crusaders,6810,2,16,6,4,61,33,28,54
Glenavon,6810,3,9,9,8,52,44,8,36
Linfield,6810,4,10,5,11,37,37,0,35
Cliftonville,6810,5,10,4,12,33,31,2,34
Ballymena,6810,6,8,4,14,28,47,-19,28
Glentoran,6810,7,6,6,10,24,32,-8,24
Dungannon,6810,8,2,4,16,14,47,-33,10
Crusaders,6811,1,17,6,3,63,30,33,57
Coleraine,6811,2,14,10,2,44,24,20,52
Glenavon,6811,3,10,9,7,54,44,10,39
Linfield,6811,4,10,6,10,37,36,1,36
Cliftonville,6811,5,9,5,12,32,31,1,32
Ballymena,6811,6,7,4,15,25,49,-24,25
Glentoran,6811,7,6,6,10,24,32,-8,24
Dungannon,6811,8,2,4,16,14,47,-33,10
Crusaders,6812,1,16,6,4,61,32,29,54
Coleraine,6812,2,14,10,2,44,25,19,52
Glenavon,6812,3,10,9,7,55,44,11,39
Linfield,6812,4,10,5,11,38,38,0,35
Cliftonville,6812,5,10,4,12,34,32,2,34
Ballymena,6812,6,8,4,14,27,47,-20,28
Glentoran,6812,7,6,6,10,24,32,-8,24
Dungannon,6812,8,2,4,16,14,47,-33,10
Crusaders,6813,1,17,6,3,62,30,32,57
Coleraine,6813,2,14,11,1,44,23,21,53
Glenavon,6813,3,9,10,7,53,44,9,37
Linfield,6813,4,10,6,10,39,38,1,36
Cliftonville,6813,5,9,5,12,34,33,1,32
Ballymena,6813,6,7,4,15,25,48,-23,25
Glentoran,6813,7,6,6,10,24,32,-8,24
Dungannon,6813,8,2,4,16,14,47,-33,10
Crusaders,6814,1,16,7,3,62,31,31,55
Coleraine,6814,2,15,10,1,45,23,22,55
Linfield,6814,3,11,5,10,40,37,3,38
Glenavon,6814,4,9,9,8,53,45,8,36
Cliftonville,6814,5,9,4,13,33,34,-1,31
Ballymena,6814,6,7,5,14,26,48,-22,26
Glentoran,6814,7,6,6,10,24,32,-8,24
Dungannon,6814,8,2,4,16,14,47,-33,10
Crusaders,6815,1,16,7,3,62,31,31,55
Coleraine,6815,2,14,11,1,45,24,21,53
Glenavon,6815,3,9,10,7,54,45,9,37
Linfield,6815,4,10,5,11,38,38,0,35
Cliftonville,6815,5,10,4,12,34,32,2,34
Ballymena,6815,6,7,5,14,26,48,-22,26
Glentoran,6815,7,6,6,10,24,32,-8,24
Dungannon,6815,8,2,4,16,14,47,-33,10
Crusaders,6816,1,16,7,3,63,32,31,55
Coleraine,6816,2,15,10,1,46,23,23,55
Linfield,6816,3,11,5,10,40,38,2,38
Glenavon,6816,4,9,9,8,53,46,7,36
Cliftonville,6816,5,9,4,13,34,34,0,31
Ballymena,6816,6,7,5,14,27,49,-22,26
Glentoran,6816,7,6,6,10,24,32,-8,24
Dungannon,6816,8,2,4,16,14,47,-33,10
Crusaders,6817,1,17,6,3,63,31,32,57
Coleraine,6817,2,14,11,1,44,23,21,53
Glenavon,6817,3,9,10,7,53,44,9,37
Linfield,6817,4,10,6,10,38,37,1,36
Cliftonville,6817,5,9,5,12,33,32,1,32
Ballymena,6817,6,7,4,15,26,49,-23,25
Glentoran,6817,7,6,6,10,24,32,-8,24
Dungannon,6817,8,2,4,16,14,47,-33,10
Crusaders,6818,1,16,6,4,62,33,29,54
Coleraine,6818,2,14,11,1,43,22,21,53
Glenavon,6818,3,9,10,7,52,43,9,37
Linfield,6818,4,10,6,10,38,37,1,36
Cliftonville,6818,5,9,5,12,33,32,1,32
Ballymena,6818,6,8,4,14,28,48,-20,28
Glentoran,6818,7,6,6,10,24,32,-8,24
Dungannon,6818,8,2,4,16,14,47,-33,10
Crusaders,6819,1,16,7,3,62,31,31,55
Coleraine,6819,2,14,11,1,44,23,21,53
Glenavon,6819,3,9,10,7,53,44,9,37
Linfield,6819,4,10,5,11,38,38,0,35
Cliftonville,6819,5,10,4,12,34,32,2,34
Ballymena,6819,6,7,5,14,26,48,-22,26
Glentoran,6819,7,6,6,10,24,32,-8,24
Dungannon,6819,8,2,4,16,14,47,-33,10
Crusaders,6820,1,16,7,3,64,33,31,55
Coleraine,6820,2,14,11,1,46,25,21,53
Linfield,6820,3,11,5,10,40,38,2,38
Glenavon,6820,4,9,10,7,55,46,9,37
Cliftonville,6820,5,9,4,13,34,34,0,31
Ballymena,6820,6,7,5,14,28,50,-22,26
Glentoran,6820,7,6,6,10,24,32,-8,24
Dungannon,6820,8,2,4,16,14,47,-33,10
Crusaders,6821,1,16,7,3,62,31,31,55
Coleraine,6821,2,14,10,2,44,24,20,52
Glenavon,6821,3,10,9,7,54,44,10,39
Linfield,6821,4,10,6,10,39,38,1,36
Cliftonville,6821,5,9,5,12,34,33,1,32
Ballymena,6821,6,7,5,14,26,48,-22,26
Glentoran,6821,7,6,6,10,24,32,-8,24
Dungannon,6821,8,2,4,16,14,47,-33,10
Crusaders,6822,1,17,6,3,63,31,32,57
Coleraine,6822,2,14,10,2,43,23,20,52
Glenavon,6822,3,10,9,7,53,43,10,39
Linfield,6822,4,10,6,10,37,36,1,36
Cliftonville,6822,5,9,5,12,32,31,1,32
Ballymena,6822,6,7,4,15,26,49,-23,25
Glentoran,6822,7,6,6,10,24,32,-8,24
Dungannon,6822,8,2,4,16,14,47,-33,10
Crusaders,6823,1,17,6,3,62,30,32,57
Coleraine,6823,2,14,10,2,43,24,19,52
Glenavon,6823,3,10,9,7,54,43,11,39
Linfield,6823,4,10,6,10,38,37,1,36
Cliftonville,6823,5,9,5,12,33,32,1,32
Ballymena,6823,6,7,4,15,25,48,-23,25
Glentoran,6823,7,6,6,10,24,32,-8,24
Dungannon,6823,8,2,4,16,14,47,-33,10
Crusaders,6824,1,17,6,3,62,30,32,57
Coleraine,6824,2,14,10,2,46,29,17,52
Glenavon,6824,3,10,9,7,59,46,13,39
Linfield,6824,4,11,5,10,39,37,2,38
Cliftonville,6824,5,9,4,13,33,33,0,31
Ballymena,6824,6,7,4,15,25,48,-23,25
Glentoran,6824,7,6,6,10,24,32,-8,24
Dungannon,6824,8,2,4,16,14,47,-33,10
Crusaders,6825,1,17,6,3,63,31,32,57
Coleraine,6825,2,15,10,1,45,23,22,55
Linfield,6825,3,11,5,10,40,36,4,38
Glenavon,6825,4,9,9,8,53,45,8,36
Cliftonville,6825,5,9,4,13,32,34,-2,31
Ballymena,6825,6,7,4,15,26,49,-23,25
Glentoran,6825,7,6,6,10,24,32,-8,24
Dungannon,6825,8,2,4,16,14,47,-33,10
Crusaders,6826,1,17,6,3,63,31,32,57
Coleraine,6826,2,14,10,2,44,27,17,52
Glenavon,6826,3,10,9,7,57,44,13,39
Linfield,6826,4,11,5,10,40,36,4,38
Cliftonville,6826,5,9,4,13,32,34,-2,31
Ballymena,6826,6,7,4,15,26,49,-23,25
Glentoran,6826,7,6,6,10,24,32,-8,24
Dungannon,6826,8,2,4,16,14,47,-33,10
Crusaders,6827,1,17,6,3,64,31,33,57
Coleraine,6827,2,15,10,1,45,23,22,55
Glenavon,6827,3,9,9,8,53,45,8,36
Linfield,6827,4,10,6,10,40,39,1,36
Cliftonville,6827,5,9,5,12,35,34,1,32
Ballymena,6827,6,7,4,15,26,50,-24,25
Glentoran,6827,7,6,6,10,24,32,-8,24
Dungannon,6827,8,2,4,16,14,47,-33,10
Crusaders,6828,1,17,6,3,63,30,33,57
Coleraine,6828,2,14,10,2,43,23,20,52
Glenavon,6828,3,10,9,7,53,43,10,39
Linfield,6828,4,11,5,10,39,36,3,38
Cliftonville,6828,5,9,4,13,32,33,-1,31
Ballymena,6828,6,7,4,15,25,49,-24,25
Glentoran,6828,7,6,6,10,24,32,-8,24
Dungannon,6828,8,2,4,16,14,47,-33,10
Crusaders,6829,1,17,6,3,64,32,32,57
Coleraine,6829,2,14,11,1,45,24,21,53
Glenavon,6829,3,9,10,7,54,45,9,37
Linfield,6829,4,10,5,11,37,38,-1,35
Cliftonville,6829,5,10,4,12,34,31,3,34
Ballymena,6829,6,7,4,15,27,50,-23,25
Glentoran,6829,7,6,6,10,24,32,-8,24
Dungannon,6829,8,2,4,16,14,47,-33,10
Crusaders,6830,1,17,6,3,63,31,32,57
Coleraine,6830,2,14,11,1,44,23,21,53
Linfield,6830,3,11,5,10,39,37,2,38
Glenavon,6830,4,9,10,7,53,44,9,37
Cliftonville,6830,5,9,4,13,33,33,0,31
Ballymena,6830,6,7,4,15,26,49,-23,25
Glentoran,6830,7,6,6,10,24,32,-8,24
Dungannon,6830,8,2,4,16,14,47,-33,10
Coleraine,6831,1,15,10,1,47,25,22,55
Crusaders,6831,2,16,6,4,61,32,29,54
Linfield,6831,3,11,5,10,39,37,2,38
Glenavon,6831,4,9,9,8,55,47,8,36
Cliftonville,6831,5,9,4,13,33,33,0,31
Ballymena,6831,6,8,4,14,27,47,-20,28
Glentoran,6831,7,6,6,10,24,32,-8,24
Dungannon,6831,8,2,4,16,14,47,-33,10
Crusaders,6832,1,17,6,3,63,31,32,57
Coleraine,6832,2,14,10,2,45,26,19,52
Glenavon,6832,3,10,9,7,56,45,11,39
Linfield,6832,4,11,5,10,39,36,3,38
Cliftonville,6832,5,9,4,13,32,33,-1,31
Ballymena,6832,6,7,4,15,26,49,-23,25
Glentoran,6832,7,6,6,10,24,32,-8,24
Dungannon,6832,8,2,4,16,14,47,-33,10
Crusaders,6833,1,16,7,3,62,31,31,55
Coleraine,6833,2,14,11,1,44,23,21,53
Linfield,6833,3,11,5,10,39,37,2,38
Glenavon,6833,4,9,10,7,53,44,9,37
Cliftonville,6833,5,9,4,13,33,33,0,31
Ballymena,6833,6,7,5,14,26,48,-22,26
Glentoran,6833,7,6,6,10,24,32,-8,24
Dungannon,6833,8,2,4,16,14,47,-33,10
Crusaders,6834,1,16,7,3,62,31,31,55
Coleraine,6834,2,14,10,2,44,24,20,52
Glenavon,6834,3,10,9,7,54,44,10,39
Linfield,6834,4,11,5,10,40,36,4,38
Cliftonville,6834,5,9,4,13,32,34,-2,31
Ballymena,6834,6,7,5,14,26,48,-22,26
Glentoran,6834,7,6,6,10,24,32,-8,24
Dungannon,6834,8,2,4,16,14,47,-33,10
Crusaders,6835,1,17,6,3,64,30,34,57
Coleraine,6835,2,15,10,1,46,23,23,55
Glenavon,6835,3,9,9,8,53,46,7,36
Linfield,6835,4,10,5,11,37,38,-1,35
Cliftonville,6835,5,10,4,12,34,31,3,34
Ballymena,6835,6,7,4,15,25,50,-25,25
Glentoran,6835,7,6,6,10,24,32,-8,24
Dungannon,6835,8,2,4,16,14,47,-33,10
Crusaders,6836,1,16,7,3,63,32,31,55
Coleraine,6836,2,14,10,2,43,23,20,52
Glenavon,6836,3,10,9,7,53,43,10,39
Linfield,6836,4,11,5,10,38,36,2,38
Cliftonville,6836,5,9,4,13,32,32,0,31
Ballymena,6836,6,7,5,14,27,49,-22,26
Glentoran,6836,7,6,6,10,24,32,-8,24
Dungannon,6836,8,2,4,16,14,47,-33,10
Crusaders,6837,1,16,6,4,61,32,29,54
Coleraine,6837,2,14,11,1,45,24,21,53
Linfield,6837,3,11,5,10,39,36,3,38
Glenavon,6837,4,9,10,7,54,45,9,37
Cliftonville,6837,5,9,4,13,32,33,-1,31
Ballymena,6837,6,8,4,14,27,47,-20,28
Glentoran,6837,7,6,6,10,24,32,-8,24
Dungannon,6837,8,2,4,16,14,47,-33,10
Crusaders,6838,1,17,6,3,62,30,32,57
Coleraine,6838,2,14,11,1,43,22,21,53
Linfield,6838,3,11,5,10,38,36,2,38
Glenavon,6838,4,9,10,7,52,43,9,37
Cliftonville,6838,5,9,4,13,32,32,0,31
Ballymena,6838,6,7,4,15,25,48,-23,25
Glentoran,6838,7,6,6,10,24,32,-8,24
Dungannon,6838,8,2,4,16,14,47,-33,10
Crusaders,6839,1,17,6,3,64,31,33,57
Coleraine,6839,2,14,10,2,43,24,19,52
Glenavon,6839,3,10,9,7,54,43,11,39
Linfield,6839,4,10,6,10,38,37,1,36
Cliftonville,6839,5,9,5,12,33,32,1,32
Ballymena,6839,6,7,4,15,26,50,-24,25
Glentoran,6839,7,6,6,10,24,32,-8,24
Dungannon,6839,8,2,4,16,14,47,-33,10
Coleraine,6840,1,15,10,1,48,23,25,55
Crusaders,6840,2,16,6,4,62,33,29,54
Glenavon,6840,3,9,9,8,53,48,5,36
Linfield,6840,4,10,5,11,38,38,0,35
Cliftonville,6840,5,10,4,12,34,32,2,34
Ballymena,6840,6,8,4,14,28,48,-20,28
Glentoran,6840,7,6,6,10,24,32,-8,24
Dungannon,6840,8,2,4,16,14,47,-33,10
Crusaders,6841,1,16,7,3,62,31,31,55
Coleraine,6841,2,15,10,1,45,23,22,55
Linfield,6841,3,11,5,10,41,37,4,38
Glenavon,6841,4,9,9,8,53,45,8,36
Cliftonville,6841,5,9,4,13,33,35,-2,31
Ballymena,6841,6,7,5,14,26,48,-22,26
Glentoran,6841,7,6,6,10,24,32,-8,24
Dungannon,6841,8,2,4,16,14,47,-33,10
Crusaders,6842,1,17,6,3,65,32,33,57
Coleraine,6842,2,14,10,2,44,26,18,52
Glenavon,6842,3,10,9,7,56,44,12,39
Linfield,6842,4,11,5,10,40,37,3,38
Cliftonville,6842,5,9,4,13,33,34,-1,31
Ballymena,6842,6,7,4,15,27,51,-24,25
Glentoran,6842,7,6,6,10,24,32,-8,24
Dungannon,6842,8,2,4,16,14,47,-33,10
Crusaders,6843,1,17,6,3,65,31,34,57
Coleraine,6843,2,14,10,2,45,27,18,52
Glenavon,6843,3,10,9,7,57,45,12,39
Linfield,6843,4,10,6,10,39,38,1,36
Cliftonville,6843,5,9,5,12,34,33,1,32
Ballymena,6843,6,7,4,15,26,51,-25,25
Glentoran,6843,7,6,6,10,24,32,-8,24
Dungannon,6843,8,2,4,16,14,47,-33,10
Crusaders,6844,1,17,6,3,64,31,33,57
Coleraine,6844,2,15,10,1,47,22,25,55
Glenavon,6844,3,9,9,8,52,47,5,36
Linfield,6844,4,10,5,11,38,38,0,35
Cliftonville,6844,5,10,4,12,34,32,2,34
Ballymena,6844,6,7,4,15,26,50,-24,25
Glentoran,6844,7,6,6,10,24,32,-8,24
Dungannon,6844,8,2,4,16,14,47,-33,10
Crusaders,6845,1,16,6,4,62,32,30,54
Coleraine,6845,2,14,11,1,43,22,21,53
Glenavon,6845,3,9,10,7,52,43,9,37
Linfield,6845,4,10,5,11,37,38,-1,35
Cliftonville,6845,5,10,4,12,34,31,3,34
Ballymena,6845,6,8,4,14,27,48,-21,28
Glentoran,6845,7,6,6,10,24,32,-8,24
Dungannon,6845,8,2,4,16,14,47,-33,10
Coleraine,6846,1,15,10,1,45,23,22,55
Crusaders,6846,2,16,6,4,61,31,30,54
Glenavon,6846,3,9,9,8,53,45,8,36
Linfield,6846,4,10,5,11,37,38,-1,35
Cliftonville,6846,5,10,4,12,34,31,3,34
Ballymena,6846,6,8,4,14,26,47,-21,28
Glentoran,6846,7,6,6,10,24,32,-8,24
Dungannon,6846,8,2,4,16,14,47,-33,10
Crusaders,6847,1,17,6,3,63,30,33,57
Coleraine,6847,2,14,10,2,43,25,18,52
Glenavon,6847,3,10,9,7,55,43,12,39
Linfield,6847,4,11,5,10,40,36,4,38
Cliftonville,6847,5,9,4,13,32,34,-2,31
Ballymena,6847,6,7,4,15,25,49,-24,25
Glentoran,6847,7,6,6,10,24,32,-8,24
Dungannon,6847,8,2,4,16,14,47,-33,10
Crusaders,6848,1,17,6,3,64,32,32,57
Coleraine,6848,2,15,10,1,47,22,25,55
Glenavon,6848,3,9,9,8,52,47,5,36
Linfield,6848,4,10,6,10,38,37,1,36
Cliftonville,6848,5,9,5,12,33,32,1,32
Ballymena,6848,6,7,4,15,27,50,-23,25
Glentoran,6848,7,6,6,10,24,32,-8,24
Dungannon,6848,8,2,4,16,14,47,-33,10
Crusaders,6849,1,17,6,3,63,31,32,57
Coleraine,6849,2,14,10,2,43,24,19,52
Glenavon,6849,3,10,9,7,54,43,11,39
Linfield,6849,4,11,5,10,38,36,2,38
Cliftonville,6849,5,9,4,13,32,32,0,31
Ballymena,6849,6,7,4,15,26,49,-23,25
Glentoran,6849,7,6,6,10,24,32,-8,24
Dungannon,6849,8,2,4,16,14,47,-33,10
Crusaders,6850,1,17,6,3,62,30,32,57
Coleraine,6850,2,14,10,2,43,25,18,52
Glenavon,6850,3,10,9,7,55,43,12,39
Linfield,6850,4,11,5,10,39,37,2,38
Cliftonville,6850,5,9,4,13,33,33,0,31
Ballymena,6850,6,7,4,15,25,48,-23,25
Glentoran,6850,7,6,6,10,24,32,-8,24
Dungannon,6850,8,2,4,16,14,47,-33,10
Crusaders,6851,1,17,6,3,62,30,32,57
Coleraine,6851,2,14,11,1,45,24,21,53
Glenavon,6851,3,9,10,7,54,45,9,37
Linfield,6851,4,10,6,10,37,36,1,36
Cliftonville,6851,5,9,5,12,32,31,1,32
Ballymena,6851,6,7,4,15,25,48,-23,25
Glentoran,6851,7,6,6,10,24,32,-8,24
Dungannon,6851,8,2,4,16,14,47,-33,10
Crusaders,6852,1,16,6,4,62,33,29,54
Coleraine,6852,2,14,11,1,44,23,21,53
Glenavon,6852,3,9,10,7,53,44,9,37
Linfield,6852,4,10,6,10,37,36,1,36
Cliftonville,6852,5,9,5,12,32,31,1,32
Ballymena,6852,6,8,4,14,28,48,-20,28
Glentoran,6852,7,6,6,10,24,32,-8,24
Dungannon,6852,8,2,4,16,14,47,-33,10
Crusaders,6853,1,17,6,3,64,32,32,57
Coleraine,6853,2,15,10,1,46,24,22,55
Linfield,6853,3,11,5,10,39,36,3,38
Glenavon,6853,4,9,9,8,54,46,8,36
Cliftonville,6853,5,9,4,13,32,33,-1,31
Ballymena,6853,6,7,4,15,27,50,-23,25
Glentoran,6853,7,6,6,10,24,32,-8,24
Dungannon,6853,8,2,4,16,14,47,-33,10
Crusaders,6854,1,16,6,4,62,32,30,54
Coleraine,6854,2,14,10,2,43,26,17,52
Glenavon,6854,3,10,9,7,56,43,13,39
Linfield,6854,4,11,5,10,39,37,2,38
Cliftonville,6854,5,9,4,13,33,33,0,31
Ballymena,6854,6,8,4,14,27,48,-21,28
Glentoran,6854,7,6,6,10,24,32,-8,24
Dungannon,6854,8,2,4,16,14,47,-33,10
Crusaders,6855,1,17,6,3,63,30,33,57
Coleraine,6855,2,14,10,2,43,24,19,52
Glenavon,6855,3,10,9,7,54,43,11,39
Linfield,6855,4,11,5,10,39,37,2,38
Cliftonville,6855,5,9,4,13,33,33,0,31
Ballymena,6855,6,7,4,15,25,49,-24,25
Glentoran,6855,7,6,6,10,24,32,-8,24
Dungannon,6855,8,2,4,16,14,47,-33,10
Crusaders,6856,1,17,6,3,65,32,33,57
Coleraine,6856,2,14,10,2,43,24,19,52
Glenavon,6856,3,10,9,7,54,43,11,39
Linfield,6856,4,11,5,10,41,37,4,38
Cliftonville,6856,5,9,4,13,33,35,-2,31
Ballymena,6856,6,7,4,15,27,51,-24,25
Glentoran,6856,7,6,6,10,24,32,-8,24
Dungannon,6856,8,2,4,16,14,47,-33,10
Crusaders,6857,1,16,7,3,62,31,31,55
Coleraine,6857,2,14,11,1,45,24,21,53
Linfield,6857,3,11,5,10,38,36,2,38
Glenavon,6857,4,9,10,7,54,45,9,37
Cliftonville,6857,5,9,4,13,32,32,0,31
Ballymena,6857,6,7,5,14,26,48,-22,26
Glentoran,6857,7,6,6,10,24,32,-8,24
Dungannon,6857,8,2,4,16,14,47,-33,10
Crusaders,6858,1,17,6,3,63,30,33,57
Coleraine,6858,2,15,10,1,45,22,23,55
Linfield,6858,3,11,5,10,40,38,2,38
Glenavon,6858,4,9,9,8,52,45,7,36
Cliftonville,6858,5,9,4,13,34,34,0,31
Ballymena,6858,6,7,4,15,25,49,-24,25
Glentoran,6858,7,6,6,10,24,32,-8,24
Dungannon,6858,8,2,4,16,14,47,-33,10
Crusaders,6859,1,17,6,3,64,31,33,57
Coleraine,6859,2,14,10,2,43,23,20,52
Glenavon,6859,3,10,9,7,53,43,10,39
Linfield,6859,4,11,5,10,40,36,4,38
Cliftonville,6859,5,9,4,13,32,34,-2,31
Ballymena,6859,6,7,4,15,26,50,-24,25
Glentoran,6859,7,6,6,10,24,32,-8,24
Dungannon,6859,8,2,4,16,14,47,-33,10
Crusaders,6860,1,17,6,3,62,30,32,57
Coleraine,6860,2,14,10,2,44,24,20,52
Glenavon,6860,3,10,9,7,54,44,10,39
Linfield,6860,4,10,5,11,37,39,-2,35
Cliftonville,6860,5,10,4,12,35,31,4,34
Ballymena,6860,6,7,4,15,25,48,-23,25
Glentoran,6860,7,6,6,10,24,32,-8,24
Dungannon,6860,8,2,4,16,14,47,-33,10
Crusaders,6861,1,17,6,3,63,31,32,57
Coleraine,6861,2,15,10,1,46,24,22,55
Glenavon,6861,3,9,9,8,54,46,8,36
Linfield,6861,4,10,5,11,38,38,0,35
Cliftonville,6861,5,10,4,12,34,32,2,34
Ballymena,6861,6,7,4,15,26,49,-23,25
Glentoran,6861,7,6,6,10,24,32,-8,24
Dungannon,6861,8,2,4,16,14,47,-33,10
Crusaders,6862,1,16,7,3,63,32,31,55
Coleraine,6862,2,14,10,2,43,24,19,52
Glenavon,6862,3,10,9,7,54,43,11,39
Linfield,6862,4,11,5,10,39,37,2,38
Cliftonville,6862,5,9,4,13,33,33,0,31
Ballymena,6862,6,7,5,14,27,49,-22,26
Glentoran,6862,7,6,6,10,24,32,-8,24
Dungannon,6862,8,2,4,16,14,47,-33,10
Crusaders,6863,1,16,7,3,63,32,31,55
Coleraine,6863,2,14,10,2,43,24,19,52
Glenavon,6863,3,10,9,7,54,43,11,39
Linfield,6863,4,10,5,11,37,37,0,35
Cliftonville,6863,5,10,4,12,33,31,2,34
Ballymena,6863,6,7,5,14,27,49,-22,26
Glentoran,6863,7,6,6,10,24,32,-8,24
Dungannon,6863,8,2,4,16,14,47,-33,10
Crusaders,6864,1,17,6,3,63,31,32,57
Coleraine,6864,2,14,11,1,44,23,21,53
Glenavon,6864,3,9,10,7,53,44,9,37
Linfield,6864,4,10,5,11,38,38,0,35
Cliftonville,6864,5,10,4,12,34,32,2,34
Ballymena,6864,6,7,4,15,26,49,-23,25
Glentoran,6864,7,6,6,10,24,32,-8,24
Dungannon,6864,8,2,4,16,14,47,-33,10
Crusaders,6865,1,16,7,3,62,31,31,55
Coleraine,6865,2,14,10,2,43,25,18,52
Glenavon,6865,3,10,9,7,55,43,12,39
Linfield,6865,4,11,5,10,39,36,3,38
Cliftonville,6865,5,9,4,13,32,33,-1,31
Ballymena,6865,6,7,5,14,26,48,-22,26
Glentoran,6865,7,6,6,10,24,32,-8,24
Dungannon,6865,8,2,4,16,14,47,-33,10
Crusaders,6866,1,17,6,3,64,32,32,57
Coleraine,6866,2,15,10,1,46,24,22,55
Linfield,6866,3,11,5,10,38,36,2,38
Glenavon,6866,4,9,9,8,54,46,8,36
Cliftonville,6866,5,9,4,13,32,32,0,31
Ballymena,6866,6,7,4,15,27,50,-23,25
Glentoran,6866,7,6,6,10,24,32,-8,24
Dungannon,6866,8,2,4,16,14,47,-33,10
Crusaders,6867,1,17,6,3,63,31,32,57
Coleraine,6867,2,15,10,1,45,23,22,55
Linfield,6867,3,11,5,10,39,36,3,38
Glenavon,6867,4,9,9,8,53,45,8,36
Cliftonville,6867,5,9,4,13,32,33,-1,31
Ballymena,6867,6,7,4,15,26,49,-23,25
Glentoran,6867,7,6,6,10,24,32,-8,24
Dungannon,6867,8,2,4,16,14,47,-33,10
Crusaders,6868,1,17,6,3,64,31,33,57
Coleraine,6868,2,14,10,2,44,24,20,52
Glenavon,6868,3,10,9,7,54,44,10,39
Linfield,6868,4,10,5,11,37,38,-1,35
Cliftonville,6868,5,10,4,12,34,31,3,34
Ballymena,6868,6,7,4,15,26,50,-24,25
Glentoran,6868,7,6,6,10,24,32,-8,24
Dungannon,6868,8,2,4,16,14,47,-33,10
Crusaders,6869,1,16,6,4,62,33,29,54
Coleraine,6869,2,14,10,2,44,26,18,52
Glenavon,6869,3,10,9,7,56,44,12,39
Linfield,6869,4,10,6,10,38,37,1,36
Cliftonville,6869,5,9,5,12,33,32,1,32
Ballymena,6869,6,8,4,14,28,48,-20,28
Glentoran,6869,7,6,6,10,24,32,-8,24
Dungannon,6869,8,2,4,16,14,47,-33,10
Crusaders,6870,1,16,7,3,62,31,31,55
Coleraine,6870,2,15,10,1,44,22,22,55
Linfield,6870,3,11,5,10,41,37,4,38
Glenavon,6870,4,9,9,8,52,44,8,36
Cliftonville,6870,5,9,4,13,33,35,-2,31
Ballymena,6870,6,7,5,14,26,48,-22,26
Glentoran,6870,7,6,6,10,24,32,-8,24
Dungannon,6870,8,2,4,16,14,47,-33,10
Crusaders,6871,1,16,6,4,63,34,29,54
Coleraine,6871,2,14,11,1,44,23,21,53
Linfield,6871,3,11,5,10,39,37,2,38
Glenavon,6871,4,9,10,7,53,44,9,37
Cliftonville,6871,5,9,4,13,33,33,0,31
Ballymena,6871,6,8,4,14,29,49,-20,28
Glentoran,6871,7,6,6,10,24,32,-8,24
Dungannon,6871,8,2,4,16,14,47,-33,10
Crusaders,6872,1,16,6,4,62,32,30,54
Coleraine,6872,2,14,10,2,45,25,20,52
Glenavon,6872,3,10,9,7,55,45,10,39
Linfield,6872,4,11,5,10,38,36,2,38
Cliftonville,6872,5,9,4,13,32,32,0,31
Ballymena,6872,6,8,4,14,27,48,-21,28
Glentoran,6872,7,6,6,10,24,32,-8,24
Dungannon,6872,8,2,4,16,14,47,-33,10
Crusaders,6873,1,16,6,4,63,33,30,54
Coleraine,6873,2,14,11,1,44,23,21,53
Glenavon,6873,3,9,10,7,53,44,9,37
Linfield,6873,4,10,6,10,37,36,1,36
Cliftonville,6873,5,9,5,12,32,31,1,32
Ballymena,6873,6,8,4,14,28,49,-21,28
Glentoran,6873,7,6,6,10,24,32,-8,24
Dungannon,6873,8,2,4,16,14,47,-33,10
Crusaders,6874,1,17,6,3,66,32,34,57
Coleraine,6874,2,14,10,2,44,25,19,52
Glenavon,6874,3,10,9,7,55,44,11,39
Linfield,6874,4,10,5,11,38,38,0,35
Cliftonville,6874,5,10,4,12,34,32,2,34
Ballymena,6874,6,7,4,15,27,52,-25,25
Glentoran,6874,7,6,6,10,24,32,-8,24
Dungannon,6874,8,2,4,16,14,47,-33,10
Crusaders,6875,1,17,6,3,64,32,32,57
Coleraine,6875,2,14,10,2,44,25,19,52
Glenavon,6875,3,10,9,7,55,44,11,39
Linfield,6875,4,11,5,10,39,36,3,38
Cliftonville,6875,5,9,4,13,32,33,-1,31
Ballymena,6875,6,7,4,15,27,50,-23,25
Glentoran,6875,7,6,6,10,24,32,-8,24
Dungannon,6875,8,2,4,16,14,47,-33,10
Coleraine,6876,1,15,10,1,45,23,22,55
Crusaders,6876,2,16,6,4,61,31,30,54
Linfield,6876,3,11,5,10,40,37,3,38
Glenavon,6876,4,9,9,8,53,45,8,36
Cliftonville,6876,5,9,4,13,33,34,-1,31
Ballymena,6876,6,8,4,14,26,47,-21,28
Glentoran,6876,7,6,6,10,24,32,-8,24
Dungannon,6876,8,2,4,16,14,47,-33,10
Crusaders,6877,1,17,6,3,64,31,33,57
Coleraine,6877,2,15,10,1,45,22,23,55
Glenavon,6877,3,9,9,8,52,45,7,36
Linfield,6877,4,10,6,10,38,37,1,36
Cliftonville,6877,5,9,5,12,33,32,1,32
Ballymena,6877,6,7,4,15,26,50,-24,25
Glentoran,6877,7,6,6,10,24,32,-8,24
Dungannon,6877,8,2,4,16,14,47,-33,10
Crusaders,6878,1,17,6,3,65,33,32,57
Coleraine,6878,2,15,10,1,44,22,22,55
Glenavon,6878,3,9,9,8,52,44,8,36
Linfield,6878,4,10,6,10,38,37,1,36
Cliftonville,6878,5,9,5,12,33,32,1,32
Ballymena,6878,6,7,4,15,28,51,-23,25
Glentoran,6878,7,6,6,10,24,32,-8,24
Dungannon,6878,8,2,4,16,14,47,-33,10
Crusaders,6879,1,16,7,3,62,31,31,55
Coleraine,6879,2,15,10,1,49,23,26,55
Glenavon,6879,3,9,9,8,53,49,4,36
Linfield,6879,4,10,6,10,39,38,1,36
Cliftonville,6879,5,9,5,12,34,33,1,32
Ballymena,6879,6,7,5,14,26,48,-22,26
Glentoran,6879,7,6,6,10,24,32,-8,24
Dungannon,6879,8,2,4,16,14,47,-33,10
Crusaders,6880,1,17,6,3,62,30,32,57
Coleraine,6880,2,14,11,1,44,23,21,53
Linfield,6880,3,11,5,10,40,37,3,38
Glenavon,6880,4,9,10,7,53,44,9,37
Cliftonville,6880,5,9,4,13,33,34,-1,31
Ballymena,6880,6,7,4,15,25,48,-23,25
Glentoran,6880,7,6,6,10,24,32,-8,24
Dungannon,6880,8,2,4,16,14,47,-33,10
Crusaders,6881,1,16,7,3,62,31,31,55
Coleraine,6881,2,14,11,1,44,23,21,53
Linfield,6881,3,11,5,10,38,36,2,38
Glenavon,6881,4,9,10,7,53,44,9,37
Cliftonville,6881,5,9,4,13,32,32,0,31
Ballymena,6881,6,7,5,14,26,48,-22,26
Glentoran,6881,7,6,6,10,24,32,-8,24
Dungannon,6881,8,2,4,16,14,47,-33,10
Crusaders,6882,1,17,6,3,63,31,32,57
Coleraine,6882,2,14,10,2,43,24,19,52
Glenavon,6882,3,10,9,7,54,43,11,39
Linfield,6882,4,10,5,11,37,38,-1,35
Cliftonville,6882,5,10,4,12,34,31,3,34
Ballymena,6882,6,7,4,15,26,49,-23,25
Glentoran,6882,7,6,6,10,24,32,-8,24
Dungannon,6882,8,2,4,16,14,47,-33,10
Crusaders,6883,1,17,6,3,65,30,35,57
Coleraine,6883,2,14,10,2,44,25,19,52
Glenavon,6883,3,10,9,7,55,44,11,39
Linfield,6883,4,11,5,10,39,36,3,38
Cliftonville,6883,5,9,4,13,32,33,-1,31
Ballymena,6883,6,7,4,15,25,51,-26,25
Glentoran,6883,7,6,6,10,24,32,-8,24
Dungannon,6883,8,2,4,16,14,47,-33,10
Crusaders,6884,1,16,6,4,61,31,30,54
Coleraine,6884,2,14,11,1,43,22,21,53
Glenavon,6884,3,9,10,7,52,43,9,37
Linfield,6884,4,10,5,11,38,39,-1,35
Cliftonville,6884,5,10,4,12,35,32,3,34
Ballymena,6884,6,8,4,14,26,47,-21,28
Glentoran,6884,7,6,6,10,24,32,-8,24
Dungannon,6884,8,2,4,16,14,47,-33,10
Crusaders,6885,1,17,6,3,63,30,33,57
Coleraine,6885,2,15,10,1,44,22,22,55
Glenavon,6885,3,9,9,8,52,44,8,36
Linfield,6885,4,10,5,11,37,37,0,35
Cliftonville,6885,5,10,4,12,33,31,2,34
Ballymena,6885,6,7,4,15,25,49,-24,25
Glentoran,6885,7,6,6,10,24,32,-8,24
Dungannon,6885,8,2,4,16,14,47,-33,10
Crusaders,6886,1,16,7,3,62,31,31,55
Coleraine,6886,2,15,10,1,45,22,23,55
Linfield,6886,3,11,5,10,39,36,3,38
Glenavon,6886,4,9,9,8,52,45,7,36
Cliftonville,6886,5,9,4,13,32,33,-1,31
Ballymena,6886,6,7,5,14,26,48,-22,26
Glentoran,6886,7,6,6,10,24,32,-8,24
Dungannon,6886,8,2,4,16,14,47,-33,10
Crusaders,6887,1,17,6,3,65,31,34,57
Coleraine,6887,2,14,10,2,44,27,17,52
Glenavon,6887,3,10,9,7,57,44,13,39
Linfield,6887,4,10,6,10,37,36,1,36
Cliftonville,6887,5,9,5,12,32,31,1,32
Ballymena,6887,6,7,4,15,26,51,-25,25
Glentoran,6887,7,6,6,10,24,32,-8,24
Dungannon,6887,8,2,4,16,14,47,-33,10
Crusaders,6888,1,16,7,3,62,31,31,55
Coleraine,6888,2,14,10,2,43,25,18,52
Glenavon,6888,3,10,9,7,55,43,12,39
Linfield,6888,4,11,5,10,38,36,2,38
Cliftonville,6888,5,9,4,13,32,32,0,31
Ballymena,6888,6,7,5,14,26,48,-22,26
Glentoran,6888,7,6,6,10,24,32,-8,24
Dungannon,6888,8,2,4,16,14,47,-33,10
Crusaders,6889,1,17,6,3,64,32,32,57
Coleraine,6889,2,14,10,2,43,23,20,52
Glenavon,6889,3,10,9,7,53,43,10,39
Linfield,6889,4,10,6,10,39,38,1,36
Cliftonville,6889,5,9,5,12,34,33,1,32
Ballymena,6889,6,7,4,15,27,50,-23,25
Glentoran,6889,7,6,6,10,24,32,-8,24
Dungannon,6889,8,2,4,16,14,47,-33,10
Crusaders,6890,1,16,6,4,63,33,30,54
Coleraine,6890,2,14,10,2,43,23,20,52
Glenavon,6890,3,10,9,7,53,43,10,39
Linfield,6890,4,11,5,10,41,36,5,38
Cliftonville,6890,5,9,4,13,32,35,-3,31
Ballymena,6890,6,8,4,14,28,49,-21,28
Glentoran,6890,7,6,6,10,24,32,-8,24
Dungannon,6890,8,2,4,16,14,47,-33,10
Crusaders,6891,1,16,6,4,61,32,29,54
Coleraine,6891,2,14,10,2,44,24,20,52
Glenavon,6891,3,10,9,7,54,44,10,39
Linfield,6891,4,10,6,10,38,37,1,36
Cliftonville,6891,5,9,5,12,33,32,1,32
Ballymena,6891,6,8,4,14,27,47,-20,28
Glentoran,6891,7,6,6,10,24,32,-8,24
Dungannon,6891,8,2,4,16,14,47,-33,10
Crusaders,6892,1,16,7,3,63,32,31,55
Coleraine,6892,2,14,10,2,43,24,19,52
Glenavon,6892,3,10,9,7,54,43,11,39
Linfield,6892,4,11,5,10,40,36,4,38
Cliftonville,6892,5,9,4,13,32,34,-2,31
Ballymena,6892,6,7,5,14,27,49,-22,26
Glentoran,6892,7,6,6,10,24,32,-8,24
Dungannon,6892,8,2,4,16,14,47,-33,10
Crusaders,6893,1,17,6,3,66,30,36,57
Coleraine,6893,2,15,10,1,45,23,22,55
Glenavon,6893,3,9,9,8,53,45,8,36
Linfield,6893,4,10,6,10,38,37,1,36
Cliftonville,6893,5,9,5,12,33,32,1,32
Ballymena,6893,6,7,4,15,25,52,-27,25
Glentoran,6893,7,6,6,10,24,32,-8,24
Dungannon,6893,8,2,4,16,14,47,-33,10
Crusaders,6894,1,16,6,4,61,31,30,54
Coleraine,6894,2,14,10,2,44,24,20,52
Glenavon,6894,3,10,9,7,54,44,10,39
Linfield,6894,4,10,5,11,37,37,0,35
Cliftonville,6894,5,10,4,12,33,31,2,34
Ballymena,6894,6,8,4,14,26,47,-21,28
Glentoran,6894,7,6,6,10,24,32,-8,24
Dungannon,6894,8,2,4,16,14,47,-33,10
Crusaders,6895,1,17,6,3,67,30,37,57
Coleraine,6895,2,14,10,2,44,24,20,52
Glenavon,6895,3,10,9,7,54,44,10,39
Linfield,6895,4,11,5,10,39,36,3,38
Cliftonville,6895,5,9,4,13,32,33,-1,31
Ballymena,6895,6,7,4,15,25,53,-28,25
Glentoran,6895,7,6,6,10,24,32,-8,24
Dungannon,6895,8,2,4,16,14,47,-33,10
Crusaders,6896,1,17,6,3,65,30,35,57
Coleraine,6896,2,15,10,1,47,23,24,55
Linfield,6896,3,11,5,10,42,36,6,38
Glenavon,6896,4,9,9,8,53,47,6,36
Cliftonville,6896,5,9,4,13,32,36,-4,31
Ballymena,6896,6,7,4,15,25,51,-26,25
Glentoran,6896,7,6,6,10,24,32,-8,24
Dungannon,6896,8,2,4,16,14,47,-33,10
Crusaders,6897,1,17,6,3,64,31,33,57
Coleraine,6897,2,14,11,1,43,22,21,53
Linfield,6897,3,11,5,10,40,37,3,38
Glenavon,6897,4,9,10,7,52,43,9,37
Cliftonville,6897,5,9,4,13,33,34,-1,31
Ballymena,6897,6,7,4,15,26,50,-24,25
Glentoran,6897,7,6,6,10,24,32,-8,24
Dungannon,6897,8,2,4,16,14,47,-33,10
Crusaders,6898,1,16,7,3,62,31,31,55
Coleraine,6898,2,14,10,2,44,25,19,52
Glenavon,6898,3,10,9,7,55,44,11,39
Linfield,6898,4,11,5,10,39,37,2,38
Cliftonville,6898,5,9,4,13,33,33,0,31
Ballymena,6898,6,7,5,14,26,48,-22,26
Glentoran,6898,7,6,6,10,24,32,-8,24
Dungannon,6898,8,2,4,16,14,47,-33,10
Crusaders,6899,1,17,6,3,66,32,34,57
Coleraine,6899,2,14,10,2,43,25,18,52
Glenavon,6899,3,10,9,7,55,43,12,39
Linfield,6899,4,10,6,10,38,37,1,36
Cliftonville,6899,5,9,5,12,33,32,1,32
Ballymena,6899,6,7,4,15,27,52,-25,25
Glentoran,6899,7,6,6,10,24,32,-8,24
Dungannon,6899,8,2,4,16,14,47,-33,10
Crusaders,6900,1,16,7,3,61,30,31,55
Coleraine,6900,2,15,10,1,45,23,22,55
Glenavon,6900,3,9,9,8,53,45,8,36
Linfield,6900,4,10,6,10,38,37,1,36
Cliftonville,6900,5,9,5,12,33,32,1,32
Ballymena,6900,6,7,5,14,25,47,-22,26
Glentoran,6900,7,6,6,10,24,32,-8,24
Dungannon,6900,8,2,4,16,14,47,-33,10
Crusaders,6901,1,17,6,3,69,33,36,57
Coleraine,6901,2,15,10,1,45,22,23,55
Glenavon,6901,3,9,9,8,52,45,7,36
Linfield,6901,4,10,6,10,39,38,1,36
Cliftonville,6901,5,9,5,12,34,33,1,32
Ballymena,6901,6,7,4,15,28,55,-27,25
Glentoran,6901,7,6,6,10,24,32,-8,24
Dungannon,6901,8,2,4,16,14,47,-33,10
Crusaders,6902,1,17,6,3,63,30,33,57
Coleraine,6902,2,14,10,2,44,25,19,52
Glenavon,6902,3,10,9,7,55,44,11,39
Linfield,6902,4,10,5,11,38,38,0,35
Cliftonville,6902,5,10,4,12,34,32,2,34
Ballymena,6902,6,7,4,15,25,49,-24,25
Glentoran,6902,7,6,6,10,24,32,-8,24
Dungannon,6902,8,2,4,16,14,47,-33,10
Crusaders,6903,1,17,6,3,67,30,37,57
Coleraine,6903,2,15,10,1,46,23,23,55
Glenavon,6903,3,9,9,8,53,46,7,36
Linfield,6903,4,10,5,11,38,38,0,35
Cliftonville,6903,5,10,4,12,34,32,2,34
Ballymena,6903,6,7,4,15,25,53,-28,25
Glentoran,6903,7,6,6,10,24,32,-8,24
Dungannon,6903,8,2,4,16,14,47,-33,10
Crusaders,6904,1,16,7,3,63,32,31,55
Coleraine,6904,2,15,10,1,46,23,23,55
Linfield,6904,3,11,5,10,41,38,3,38
Glenavon,6904,4,9,9,8,53,46,7,36
Cliftonville,6904,5,9,4,13,34,35,-1,31
Ballymena,6904,6,7,5,14,27,49,-22,26
Glentoran,6904,7,6,6,10,24,32,-8,24
Dungannon,6904,8,2,4,16,14,47,-33,10
Crusaders,6905,1,17,6,3,65,31,34,57
Coleraine,6905,2,14,10,2,45,28,17,52
Glenavon,6905,3,10,9,7,58,45,13,39
Linfield,6905,4,10,5,11,37,37,0,35
Cliftonville,6905,5,10,4,12,33,31,2,34
Ballymena,6905,6,7,4,15,26,51,-25,25
Glentoran,6905,7,6,6,10,24,32,-8,24
Dungannon,6905,8,2,4,16,14,47,-33,10
Crusaders,6906,1,16,7,3,62,31,31,55
Coleraine,6906,2,15,10,1,46,24,22,55
Glenavon,6906,3,9,9,8,54,46,8,36
Linfield,6906,4,10,5,11,37,38,-1,35
Cliftonville,6906,5,10,4,12,34,31,3,34
Ballymena,6906,6,7,5,14,26,48,-22,26
Glentoran,6906,7,6,6,10,24,32,-8,24
Dungannon,6906,8,2,4,16,14,47,-33,10
Crusaders,6907,1,17,6,3,64,30,34,57
Coleraine,6907,2,14,10,2,43,26,17,52
Glenavon,6907,3,10,9,7,56,43,13,39
Linfield,6907,4,11,5,10,38,36,2,38
Cliftonville,6907,5,9,4,13,32,32,0,31
Ballymena,6907,6,7,4,15,25,50,-25,25
Glentoran,6907,7,6,6,10,24,32,-8,24
Dungannon,6907,8,2,4,16,14,47,-33,10
Crusaders,6908,1,17,6,3,67,33,34,57
Coleraine,6908,2,14,10,2,44,25,19,52
Glenavon,6908,3,10,9,7,55,44,11,39
Linfield,6908,4,11,5,10,39,37,2,38
Cliftonville,6908,5,9,4,13,33,33,0,31
Ballymena,6908,6,7,4,15,28,53,-25,25
Glentoran,6908,7,6,6,10,24,32,-8,24
Dungannon,6908,8,2,4,16,14,47,-33,10
Crusaders,6909,1,16,7,3,62,31,31,55
Coleraine,6909,2,14,10,2,44,24,20,52
Glenavon,6909,3,10,9,7,54,44,10,39
Linfield,6909,4,11,5,10,38,36,2,38
Cliftonville,6909,5,9,4,13,32,32,0,31
Ballymena,6909,6,7,5,14,26,48,-22,26
Glentoran,6909,7,6,6,10,24,32,-8,24
Dungannon,6909,8,2,4,16,14,47,-33,10
Crusaders,6910,1,17,6,3,63,31,32,57
Coleraine,6910,2,14,11,1,44,23,21,53
Glenavon,6910,3,9,10,7,53,44,9,37
Linfield,6910,4,10,6,10,37,36,1,36
Cliftonville,6910,5,9,5,12,32,31,1,32
Ballymena,6910,6,7,4,15,26,49,-23,25
Glentoran,6910,7,6,6,10,24,32,-8,24
Dungannon,6910,8,2,4,16,14,47,-33,10
Crusaders,6911,1,16,6,4,61,31,30,54
Coleraine,6911,2,14,10,2,43,23,20,52
Glenavon,6911,3,10,9,7,53,43,10,39
Linfield,6911,4,11,5,10,39,36,3,38
Cliftonville,6911,5,9,4,13,32,33,-1,31
Ballymena,6911,6,8,4,14,26,47,-21,28
Glentoran,6911,7,6,6,10,24,32,-8,24
Dungannon,6911,8,2,4,16,14,47,-33,10
Crusaders,6912,1,16,6,4,61,32,29,54
Coleraine,6912,2,14,10,2,43,27,16,52
Glenavon,6912,3,10,9,7,57,43,14,39
Linfield,6912,4,10,6,10,38,37,1,36
Cliftonville,6912,5,9,5,12,33,32,1,32
Ballymena,6912,6,8,4,14,27,47,-20,28
Glentoran,6912,7,6,6,10,24,32,-8,24
Dungannon,6912,8,2,4,16,14,47,-33,10
Crusaders,6913,1,17,6,3,65,31,34,57
Coleraine,6913,2,15,10,1,44,22,22,55
Linfield,6913,3,11,5,10,38,36,2,38
Glenavon,6913,4,9,9,8,52,44,8,36
Cliftonville,6913,5,9,4,13,32,32,0,31
Ballymena,6913,6,7,4,15,26,51,-25,25
Glentoran,6913,7,6,6,10,24,32,-8,24
Dungannon,6913,8,2,4,16,14,47,-33,10
Crusaders,6914,1,17,6,3,63,31,32,57
Coleraine,6914,2,15,10,1,46,22,24,55
Linfield,6914,3,11,5,10,39,36,3,38
Glenavon,6914,4,9,9,8,52,46,6,36
Cliftonville,6914,5,9,4,13,32,33,-1,31
Ballymena,6914,6,7,4,15,26,49,-23,25
Glentoran,6914,7,6,6,10,24,32,-8,24
Dungannon,6914,8,2,4,16,14,47,-33,10
Crusaders,6915,1,16,6,4,61,31,30,54
Coleraine,6915,2,14,11,1,43,22,21,53
Glenavon,6915,3,9,10,7,52,43,9,37
Linfield,6915,4,10,6,10,38,37,1,36
Cliftonville,6915,5,9,5,12,33,32,1,32
Ballymena,6915,6,8,4,14,26,47,-21,28
Glentoran,6915,7,6,6,10,24,32,-8,24
Dungannon,6915,8,2,4,16,14,47,-33,10
Crusaders,6916,1,17,6,3,64,31,33,57
Coleraine,6916,2,14,11,1,44,23,21,53
Linfield,6916,3,11,5,10,39,37,2,38
Glenavon,6916,4,9,10,7,53,44,9,37
Cliftonville,6916,5,9,4,13,33,33,0,31
Ballymena,6916,6,7,4,15,26,50,-24,25
Glentoran,6916,7,6,6,10,24,32,-8,24
Dungannon,6916,8,2,4,16,14,47,-33,10
Crusaders,6917,1,17,6,3,63,31,32,57
Coleraine,6917,2,15,10,1,49,26,23,55
Linfield,6917,3,11,5,10,38,36,2,38
Glenavon,6917,4,9,9,8,56,49,7,36
Cliftonville,6917,5,9,4,13,32,32,0,31
Ballymena,6917,6,7,4,15,26,49,-23,25
Glentoran,6917,7,6,6,10,24,32,-8,24
Dungannon,6917,8,2,4,16,14,47,-33,10
Crusaders,6918,1,17,6,3,65,32,33,57
Coleraine,6918,2,15,10,1,45,23,22,55
Glenavon,6918,3,9,9,8,53,45,8,36
Linfield,6918,4,10,6,10,39,38,1,36
Cliftonville,6918,5,9,5,12,34,33,1,32
Ballymena,6918,6,7,4,15,27,51,-24,25
Glentoran,6918,7,6,6,10,24,32,-8,24
Dungannon,6918,8,2,4,16,14,47,-33,10
Crusaders,6919,1,17,6,3,64,30,34,57
Coleraine,6919,2,15,10,1,45,23,22,55
Glenavon,6919,3,9,9,8,53,45,8,36
Linfield,6919,4,10,5,11,37,40,-3,35
Cliftonville,6919,5,10,4,12,36,31,5,34
Ballymena,6919,6,7,4,15,25,50,-25,25
Glentoran,6919,7,6,6,10,24,32,-8,24
Dungannon,6919,8,2,4,16,14,47,-33,10
Crusaders,6920,1,16,7,3,62,31,31,55
Coleraine,6920,2,15,10,1,46,24,22,55
Glenavon,6920,3,9,9,8,54,46,8,36
Linfield,6920,4,10,5,11,37,37,0,35
Cliftonville,6920,5,10,4,12,33,31,2,34
Ballymena,6920,6,7,5,14,26,48,-22,26
Glentoran,6920,7,6,6,10,24,32,-8,24
Dungannon,6920,8,2,4,16,14,47,-33,10
Crusaders,6921,1,16,7,3,62,31,31,55
Coleraine,6921,2,15,10,1,47,22,25,55
Glenavon,6921,3,9,9,8,52,47,5,36
Linfield,6921,4,10,6,10,37,36,1,36
Cliftonville,6921,5,9,5,12,32,31,1,32
Ballymena,6921,6,7,5,14,26,48,-22,26
Glentoran,6921,7,6,6,10,24,32,-8,24
Dungannon,6921,8,2,4,16,14,47,-33,10
Crusaders,6922,1,17,6,3,66,31,35,57
Coleraine,6922,2,14,11,1,44,23,21,53
Glenavon,6922,3,9,10,7,53,44,9,37
Linfield,6922,4,10,6,10,38,37,1,36
Cliftonville,6922,5,9,5,12,33,32,1,32
Ballymena,6922,6,7,4,15,26,52,-26,25
Glentoran,6922,7,6,6,10,24,32,-8,24
Dungannon,6922,8,2,4,16,14,47,-33,10
Crusaders,6923,1,17,6,3,64,31,33,57
Coleraine,6923,2,14,10,2,43,24,19,52
Glenavon,6923,3,10,9,7,54,43,11,39
Linfield,6923,4,11,5,10,38,36,2,38
Cliftonville,6923,5,9,4,13,32,32,0,31
Ballymena,6923,6,7,4,15,26,50,-24,25
Glentoran,6923,7,6,6,10,24,32,-8,24
Dungannon,6923,8,2,4,16,14,47,-33,10
Crusaders,6924,1,16,7,3,64,33,31,55
Coleraine,6924,2,14,10,2,46,27,19,52
Glenavon,6924,3,10,9,7,57,46,11,39
Linfield,6924,4,11,5,10,40,37,3,38
Cliftonville,6924,5,9,4,13,33,34,-1,31
Ballymena,6924,6,7,5,14,28,50,-22,26
Glentoran,6924,7,6,6,10,24,32,-8,24
Dungannon,6924,8,2,4,16,14,47,-33,10
Crusaders,6925,1,16,7,3,63,32,31,55
Coleraine,6925,2,14,10,2,43,24,19,52
Glenavon,6925,3,10,9,7,54,43,11,39
Linfield,6925,4,10,5,11,37,39,-2,35
Cliftonville,6925,5,10,4,12,35,31,4,34
Ballymena,6925,6,7,5,14,27,49,-22,26
Glentoran,6925,7,6,6,10,24,32,-8,24
Dungannon,6925,8,2,4,16,14,47,-33,10
Crusaders,6926,1,17,6,3,63,31,32,57
Coleraine,6926,2,14,10,2,44,27,17,52
Glenavon,6926,3,10,9,7,57,44,13,39
Linfield,6926,4,11,5,10,38,36,2,38
Cliftonville,6926,5,9,4,13,32,32,0,31
Ballymena,6926,6,7,4,15,26,49,-23,25
Glentoran,6926,7,6,6,10,24,32,-8,24
Dungannon,6926,8,2,4,16,14,47,-33,10
Crusaders,6927,1,17,6,3,68,31,37,57
Coleraine,6927,2,14,10,2,44,24,20,52
Glenavon,6927,3,10,9,7,54,44,10,39
Linfield,6927,4,10,6,10,37,36,1,36
Cliftonville,6927,5,9,5,12,32,31,1,32
Ballymena,6927,6,7,4,15,26,54,-28,25
Glentoran,6927,7,6,6,10,24,32,-8,24
Dungannon,6927,8,2,4,16,14,47,-33,10
Crusaders,6928,1,16,7,3,62,31,31,55
Coleraine,6928,2,14,10,2,44,24,20,52
Glenavon,6928,3,10,9,7,54,44,10,39
Linfield,6928,4,10,5,11,38,38,0,35
Cliftonville,6928,5,10,4,12,34,32,2,34
Ballymena,6928,6,7,5,14,26,48,-22,26
Glentoran,6928,7,6,6,10,24,32,-8,24
Dungannon,6928,8,2,4,16,14,47,-33,10
Crusaders,6929,1,17,6,3,63,31,32,57
Coleraine,6929,2,14,10,2,44,24,20,52
Glenavon,6929,3,10,9,7,54,44,10,39
Linfield,6929,4,10,5,11,39,39,0,35
Cliftonville,6929,5,10,4,12,35,33,2,34
Ballymena,6929,6,7,4,15,26,49,-23,25
Glentoran,6929,7,6,6,10,24,32,-8,24
Dungannon,6929,8,2,4,16,14,47,-33,10
Crusaders,6930,1,17,6,3,64,30,34,57
Coleraine,6930,2,14,10,2,44,25,19,52
Glenavon,6930,3,10,9,7,55,44,11,39
Linfield,6930,4,11,5,10,39,36,3,38
Cliftonville,6930,5,9,4,13,32,33,-1,31
Ballymena,6930,6,7,4,15,25,50,-25,25
Glentoran,6930,7,6,6,10,24,32,-8,24
Dungannon,6930,8,2,4,16,14,47,-33,10
Coleraine,6931,1,15,10,1,46,22,24,55
Crusaders,6931,2,16,6,4,61,31,30,54
Glenavon,6931,3,9,9,8,52,46,6,36
Linfield,6931,4,10,5,11,37,39,-2,35
Cliftonville,6931,5,10,4,12,35,31,4,34
Ballymena,6931,6,8,4,14,26,47,-21,28
Glentoran,6931,7,6,6,10,24,32,-8,24
Dungannon,6931,8,2,4,16,14,47,-33,10
Crusaders,6932,1,17,6,3,63,31,32,57
Coleraine,6932,2,14,11,1,44,23,21,53
Linfield,6932,3,11,5,10,38,36,2,38
Glenavon,6932,4,9,10,7,53,44,9,37
Cliftonville,6932,5,9,4,13,32,32,0,31
Ballymena,6932,6,7,4,15,26,49,-23,25
Glentoran,6932,7,6,6,10,24,32,-8,24
Dungannon,6932,8,2,4,16,14,47,-33,10
Crusaders,6933,1,16,7,3,62,31,31,55
Coleraine,6933,2,15,10,1,46,23,23,55
Linfield,6933,3,11,5,10,41,37,4,38
Glenavon,6933,4,9,9,8,53,46,7,36
Cliftonville,6933,5,9,4,13,33,35,-2,31
Ballymena,6933,6,7,5,14,26,48,-22,26
Glentoran,6933,7,6,6,10,24,32,-8,24
Dungannon,6933,8,2,4,16,14,47,-33,10
Crusaders,6934,1,16,6,4,63,33,30,54
Coleraine,6934,2,14,10,2,44,25,19,52
Glenavon,6934,3,10,9,7,55,44,11,39
Linfield,6934,4,10,6,10,37,36,1,36
Cliftonville,6934,5,9,5,12,32,31,1,32
Ballymena,6934,6,8,4,14,28,49,-21,28
Glentoran,6934,7,6,6,10,24,32,-8,24
Dungannon,6934,8,2,4,16,14,47,-33,10
Crusaders,6935,1,16,6,4,62,33,29,54
Coleraine,6935,2,14,10,2,43,24,19,52
Glenavon,6935,3,10,9,7,54,43,11,39
Linfield,6935,4,11,5,10,39,36,3,38
Cliftonville,6935,5,9,4,13,32,33,-1,31
Ballymena,6935,6,8,4,14,28,48,-20,28
Glentoran,6935,7,6,6,10,24,32,-8,24
Dungannon,6935,8,2,4,16,14,47,-33,10
Crusaders,6936,1,17,6,3,65,32,33,57
Coleraine,6936,2,14,11,1,43,22,21,53
Linfield,6936,3,11,5,10,39,37,2,38
Glenavon,6936,4,9,10,7,52,43,9,37
Cliftonville,6936,5,9,4,13,33,33,0,31
Ballymena,6936,6,7,4,15,27,51,-24,25
Glentoran,6936,7,6,6,10,24,32,-8,24
Dungannon,6936,8,2,4,16,14,47,-33,10
Crusaders,6937,1,16,7,3,62,31,31,55
Coleraine,6937,2,15,10,1,45,22,23,55
Linfield,6937,3,11,5,10,38,36,2,38
Glenavon,6937,4,9,9,8,52,45,7,36
Cliftonville,6937,5,9,4,13,32,32,0,31
Ballymena,6937,6,7,5,14,26,48,-22,26
Glentoran,6937,7,6,6,10,24,32,-8,24
Dungannon,6937,8,2,4,16,14,47,-33,10
Crusaders,6938,1,17,6,3,64,30,34,57
Coleraine,6938,2,15,10,1,47,23,24,55
Glenavon,6938,3,9,9,8,53,47,6,36
Linfield,6938,4,10,5,11,38,38,0,35
Cliftonville,6938,5,10,4,12,34,32,2,34
Ballymena,6938,6,7,4,15,25,50,-25,25
Glentoran,6938,7,6,6,10,24,32,-8,24
Dungannon,6938,8,2,4,16,14,47,-33,10
Crusaders,6939,1,17,6,3,63,31,32,57
Coleraine,6939,2,14,10,2,44,25,19,52
Glenavon,6939,3,10,9,7,55,44,11,39
Linfield,6939,4,11,5,10,38,36,2,38
Cliftonville,6939,5,9,4,13,32,32,0,31
Ballymena,6939,6,7,4,15,26,49,-23,25
Glentoran,6939,7,6,6,10,24,32,-8,24
Dungannon,6939,8,2,4,16,14,47,-33,10
Crusaders,6940,1,16,6,4,62,32,30,54
Coleraine,6940,2,14,11,1,44,23,21,53
Linfield,6940,3,11,5,10,39,36,3,38
Glenavon,6940,4,9,10,7,53,44,9,37
Cliftonville,6940,5,9,4,13,32,33,-1,31
Ballymena,6940,6,8,4,14,27,48,-21,28
Glentoran,6940,7,6,6,10,24,32,-8,24
Dungannon,6940,8,2,4,16,14,47,-33,10
Crusaders,6941,1,17,6,3,65,30,35,57
Coleraine,6941,2,15,10,1,46,22,24,55
Glenavon,6941,3,9,9,8,52,46,6,36
Linfield,6941,4,10,5,11,37,38,-1,35
Cliftonville,6941,5,10,4,12,34,31,3,34
Ballymena,6941,6,7,4,15,25,51,-26,25
Glentoran,6941,7,6,6,10,24,32,-8,24
Dungannon,6941,8,2,4,16,14,47,-33,10
Crusaders,6942,1,17,6,3,64,30,34,57
Coleraine,6942,2,14,10,2,45,26,19,52
Glenavon,6942,3,10,9,7,56,45,11,39
Linfield,6942,4,11,5,10,39,36,3,38
Cliftonville,6942,5,9,4,13,32,33,-1,31
Ballymena,6942,6,7,4,15,25,50,-25,25
Glentoran,6942,7,6,6,10,24,32,-8,24
Dungannon,6942,8,2,4,16,14,47,-33,10
Crusaders,6943,1,16,6,4,61,32,29,54
Coleraine,6943,2,14,11,1,44,23,21,53
Linfield,6943,3,11,5,10,39,37,2,38
Glenavon,6943,4,9,10,7,53,44,9,37
Cliftonville,6943,5,9,4,13,33,33,0,31
Ballymena,6943,6,8,4,14,27,47,-20,28
Glentoran,6943,7,6,6,10,24,32,-8,24
Dungannon,6943,8,2,4,16,14,47,-33,10
Crusaders,6944,1,16,7,3,63,32,31,55
Coleraine,6944,2,15,10,1,45,23,22,55
Linfield,6944,3,11,5,10,38,36,2,38
Glenavon,6944,4,9,9,8,53,45,8,36
Cliftonville,6944,5,9,4,13,32,32,0,31
Ballymena,6944,6,7,5,14,27,49,-22,26
Glentoran,6944,7,6,6,10,24,32,-8,24
Dungannon,6944,8,2,4,16,14,47,-33,10
Coleraine,6945,1,15,10,1,47,24,23,55
Crusaders,6945,2,16,6,4,62,32,30,54
Linfield,6945,3,11,5,10,38,36,2,38
Glenavon,6945,4,9,9,8,54,47,7,36
Cliftonville,6945,5,9,4,13,32,32,0,31
Ballymena,6945,6,8,4,14,27,48,-21,28
Glentoran,6945,7,6,6,10,24,32,-8,24
Dungannon,6945,8,2,4,16,14,47,-33,10
Crusaders,6946,1,16,6,4,61,32,29,54
Coleraine,6946,2,14,11,1,44,23,21,53
Linfield,6946,3,11,5,10,40,36,4,38
Glenavon,6946,4,9,10,7,53,44,9,37
Cliftonville,6946,5,9,4,13,32,34,-2,31
Ballymena,6946,6,8,4,14,27,47,-20,28
Glentoran,6946,7,6,6,10,24,32,-8,24
Dungannon,6946,8,2,4,16,14,47,-33,10
Crusaders,6947,1,16,7,3,62,31,31,55
Coleraine,6947,2,14,11,1,43,22,21,53
Linfield,6947,3,11,5,10,40,38,2,38
Glenavon,6947,4,9,10,7,52,43,9,37
Cliftonville,6947,5,9,4,13,34,34,0,31
Ballymena,6947,6,7,5,14,26,48,-22,26
Glentoran,6947,7,6,6,10,24,32,-8,24
Dungannon,6947,8,2,4,16,14,47,-33,10
Crusaders,6948,1,17,6,3,65,33,32,57
Coleraine,6948,2,14,10,2,45,27,18,52
Glenavon,6948,3,10,9,7,57,45,12,39
Linfield,6948,4,11,5,10,40,37,3,38
Cliftonville,6948,5,9,4,13,33,34,-1,31
Ballymena,6948,6,7,4,15,28,51,-23,25
Glentoran,6948,7,6,6,10,24,32,-8,24
Dungannon,6948,8,2,4,16,14,47,-33,10
Crusaders,6949,1,16,7,3,63,32,31,55
Coleraine,6949,2,14,10,2,44,24,20,52
Glenavon,6949,3,10,9,7,54,44,10,39
Linfield,6949,4,11,5,10,38,36,2,38
Cliftonville,6949,5,9,4,13,32,32,0,31
Ballymena,6949,6,7,5,14,27,49,-22,26
Glentoran,6949,7,6,6,10,24,32,-8,24
Dungannon,6949,8,2,4,16,14,47,-33,10
Crusaders,6950,1,16,7,3,61,30,31,55
Coleraine,6950,2,15,10,1,44,22,22,55
Glenavon,6950,3,9,9,8,52,44,8,36
Linfield,6950,4,10,5,11,38,39,-1,35
Cliftonville,6950,5,10,4,12,35,32,3,34
Ballymena,6950,6,7,5,14,25,47,-22,26
Glentoran,6950,7,6,6,10,24,32,-8,24
Dungannon,6950,8,2,4,16,14,47,-33,10
Crusaders,6951,1,17,6,3,65,31,34,57
Coleraine,6951,2,14,10,2,43,24,19,52
Glenavon,6951,3,10,9,7,54,43,11,39
Linfield,6951,4,10,5,11,37,37,0,35
Cliftonville,6951,5,10,4,12,33,31,2,34
Ballymena,6951,6,7,4,15,26,51,-25,25
Glentoran,6951,7,6,6,10,24,32,-8,24
Dungannon,6951,8,2,4,16,14,47,-33,10
Coleraine,6952,1,15,10,1,46,22,24,55
Crusaders,6952,2,16,6,4,63,35,28,54
Linfield,6952,3,11,5,10,42,36,6,38
Glenavon,6952,4,9,9,8,52,46,6,36
Cliftonville,6952,5,9,4,13,32,36,-4,31
Ballymena,6952,6,8,4,14,30,49,-19,28
Glentoran,6952,7,6,6,10,24,32,-8,24
Dungannon,6952,8,2,4,16,14,47,-33,10
Crusaders,6953,1,16,7,3,62,31,31,55
Coleraine,6953,2,14,10,2,44,27,17,52
Glenavon,6953,3,10,9,7,57,44,13,39
Linfield,6953,4,11,5,10,39,36,3,38
Cliftonville,6953,5,9,4,13,32,33,-1,31
Ballymena,6953,6,7,5,14,26,48,-22,26
Glentoran,6953,7,6,6,10,24,32,-8,24
Dungannon,6953,8,2,4,16,14,47,-33,10
Crusaders,6954,1,17,6,3,62,30,32,57
Coleraine,6954,2,14,11,1,44,23,21,53
Linfield,6954,3,11,5,10,40,36,4,38
Glenavon,6954,4,9,10,7,53,44,9,37
Cliftonville,6954,5,9,4,13,32,34,-2,31
Ballymena,6954,6,7,4,15,25,48,-23,25
Glentoran,6954,7,6,6,10,24,32,-8,24
Dungannon,6954,8,2,4,16,14,47,-33,10
Crusaders,6955,1,17,6,3,62,30,32,57
Coleraine,6955,2,15,10,1,46,23,23,55
Linfield,6955,3,11,5,10,39,36,3,38
Glenavon,6955,4,9,9,8,53,46,7,36
Cliftonville,6955,5,9,4,13,32,33,-1,31
Ballymena,6955,6,7,4,15,25,48,-23,25
Glentoran,6955,7,6,6,10,24,32,-8,24
Dungannon,6955,8,2,4,16,14,47,-33,10
Coleraine,6956,1,15,10,1,45,23,22,55
Crusaders,6956,2,16,6,4,61,34,27,54
Linfield,6956,3,11,5,10,39,37,2,38
Glenavon,6956,4,9,9,8,53,45,8,36
Cliftonville,6956,5,9,4,13,33,33,0,31
Ballymena,6956,6,8,4,14,29,47,-18,28
Glentoran,6956,7,6,6,10,24,32,-8,24
Dungannon,6956,8,2,4,16,14,47,-33,10
Crusaders,6957,1,17,6,3,66,32,34,57
Coleraine,6957,2,14,10,2,44,26,18,52
Glenavon,6957,3,10,9,7,56,44,12,39
Linfield,6957,4,10,5,11,37,40,-3,35
Cliftonville,6957,5,10,4,12,36,31,5,34
Ballymena,6957,6,7,4,15,27,52,-25,25
Glentoran,6957,7,6,6,10,24,32,-8,24
Dungannon,6957,8,2,4,16,14,47,-33,10
Crusaders,6958,1,17,6,3,65,32,33,57
Coleraine,6958,2,14,10,2,44,24,20,52
Glenavon,6958,3,10,9,7,54,44,10,39
Linfield,6958,4,10,6,10,40,39,1,36
Cliftonville,6958,5,9,5,12,35,34,1,32
Ballymena,6958,6,7,4,15,27,51,-24,25
Glentoran,6958,7,6,6,10,24,32,-8,24
Dungannon,6958,8,2,4,16,14,47,-33,10
Crusaders,6959,1,17,6,3,63,30,33,57
Coleraine,6959,2,15,10,1,45,22,23,55
Glenavon,6959,3,9,9,8,52,45,7,36
Linfield,6959,4,10,6,10,37,36,1,36
Cliftonville,6959,5,9,5,12,32,31,1,32
Ballymena,6959,6,7,4,15,25,49,-24,25
Glentoran,6959,7,6,6,10,24,32,-8,24
Dungannon,6959,8,2,4,16,14,47,-33,10
Crusaders,6960,1,17,6,3,64,32,32,57
Coleraine,6960,2,14,10,2,43,24,19,52
Glenavon,6960,3,10,9,7,54,43,11,39
Linfield,6960,4,10,6,10,38,37,1,36
Cliftonville,6960,5,9,5,12,33,32,1,32
Ballymena,6960,6,7,4,15,27,50,-23,25
Glentoran,6960,7,6,6,10,24,32,-8,24
Dungannon,6960,8,2,4,16,14,47,-33,10
Crusaders,6961,1,17,6,3,64,30,34,57
Coleraine,6961,2,14,10,2,43,24,19,52
Glenavon,6961,3,10,9,7,54,43,11,39
Linfield,6961,4,10,5,11,38,38,0,35
Cliftonville,6961,5,10,4,12,34,32,2,34
Ballymena,6961,6,7,4,15,25,50,-25,25
Glentoran,6961,7,6,6,10,24,32,-8,24
Dungannon,6961,8,2,4,16,14,47,-33,10
Coleraine,6962,1,15,10,1,44,22,22,55
Crusaders,6962,2,16,6,4,61,33,28,54
Glenavon,6962,3,9,9,8,52,44,8,36
Linfield,6962,4,10,5,11,38,38,0,35
Cliftonville,6962,5,10,4,12,34,32,2,34
Ballymena,6962,6,8,4,14,28,47,-19,28
Glentoran,6962,7,6,6,10,24,32,-8,24
Dungannon,6962,8,2,4,16,14,47,-33,10
Crusaders,6963,1,16,7,3,61,30,31,55
Coleraine,6963,2,15,10,1,47,23,24,55
Linfield,6963,3,11,5,10,41,37,4,38
Glenavon,6963,4,9,9,8,53,47,6,36
Cliftonville,6963,5,9,4,13,33,35,-2,31
Ballymena,6963,6,7,5,14,25,47,-22,26
Glentoran,6963,7,6,6,10,24,32,-8,24
Dungannon,6963,8,2,4,16,14,47,-33,10
Crusaders,6964,1,17,6,3,62,30,32,57
Coleraine,6964,2,14,11,1,44,23,21,53
Glenavon,6964,3,9,10,7,53,44,9,37
Linfield,6964,4,10,6,10,38,37,1,36
Cliftonville,6964,5,9,5,12,33,32,1,32
Ballymena,6964,6,7,4,15,25,48,-23,25
Glentoran,6964,7,6,6,10,24,32,-8,24
Dungannon,6964,8,2,4,16,14,47,-33,10
Crusaders,6965,1,17,6,3,63,30,33,57
Coleraine,6965,2,15,10,1,46,23,23,55
Glenavon,6965,3,9,9,8,53,46,7,36
Linfield,6965,4,10,5,11,38,38,0,35
Cliftonville,6965,5,10,4,12,34,32,2,34
Ballymena,6965,6,7,4,15,25,49,-24,25
Glentoran,6965,7,6,6,10,24,32,-8,24
Dungannon,6965,8,2,4,16,14,47,-33,10
Crusaders,6966,1,17,6,3,64,32,32,57
Coleraine,6966,2,14,10,2,43,26,17,52
Glenavon,6966,3,10,9,7,56,43,13,39
Linfield,6966,4,11,5,10,39,37,2,38
Cliftonville,6966,5,9,4,13,33,33,0,31
Ballymena,6966,6,7,4,15,27,50,-23,25
Glentoran,6966,7,6,6,10,24,32,-8,24
Dungannon,6966,8,2,4,16,14,47,-33,10
Crusaders,6967,1,16,7,3,61,30,31,55
Coleraine,6967,2,14,10,2,43,24,19,52
Glenavon,6967,3,10,9,7,54,43,11,39
Linfield,6967,4,11,5,10,43,37,6,38
Cliftonville,6967,5,9,4,13,33,37,-4,31
Ballymena,6967,6,7,5,14,25,47,-22,26
Glentoran,6967,7,6,6,10,24,32,-8,24
Dungannon,6967,8,2,4,16,14,47,-33,10
Crusaders,6968,1,17,6,3,63,30,33,57
Coleraine,6968,2,14,10,2,44,24,20,52
Glenavon,6968,3,10,9,7,54,44,10,39
Linfield,6968,4,10,5,11,38,38,0,35
Cliftonville,6968,5,10,4,12,34,32,2,34
Ballymena,6968,6,7,4,15,25,49,-24,25
Glentoran,6968,7,6,6,10,24,32,-8,24
Dungannon,6968,8,2,4,16,14,47,-33,10
Crusaders,6969,1,16,6,4,62,32,30,54
Coleraine,6969,2,14,11,1,44,23,21,53
Linfield,6969,3,11,5,10,42,36,6,38
Glenavon,6969,4,9,10,7,53,44,9,37
Cliftonville,6969,5,9,4,13,32,36,-4,31
Ballymena,6969,6,8,4,14,27,48,-21,28
Glentoran,6969,7,6,6,10,24,32,-8,24
Dungannon,6969,8,2,4,16,14,47,-33,10
Crusaders,6970,1,16,7,3,62,31,31,55
Coleraine,6970,2,14,10,2,44,25,19,52
Glenavon,6970,3,10,9,7,55,44,11,39
Linfield,6970,4,10,6,10,38,37,1,36
Cliftonville,6970,5,9,5,12,33,32,1,32
Ballymena,6970,6,7,5,14,26,48,-22,26
Glentoran,6970,7,6,6,10,24,32,-8,24
Dungannon,6970,8,2,4,16,14,47,-33,10
Crusaders,6971,1,17,6,3,64,30,34,57
Coleraine,6971,2,15,10,1,47,24,23,55
Linfield,6971,3,11,5,10,38,36,2,38
Glenavon,6971,4,9,9,8,54,47,7,36
Cliftonville,6971,5,9,4,13,32,32,0,31
Ballymena,6971,6,7,4,15,25,50,-25,25
Glentoran,6971,7,6,6,10,24,32,-8,24
Dungannon,6971,8,2,4,16,14,47,-33,10
Crusaders,6972,1,16,7,3,64,33,31,55
Coleraine,6972,2,14,11,1,43,22,21,53
Linfield,6972,3,11,5,10,40,36,4,38
Glenavon,6972,4,9,10,7,52,43,9,37
Cliftonville,6972,5,9,4,13,32,34,-2,31
Ballymena,6972,6,7,5,14,28,50,-22,26
Glentoran,6972,7,6,6,10,24,32,-8,24
Dungannon,6972,8,2,4,16,14,47,-33,10
Crusaders,6973,1,17,6,3,64,31,33,57
Coleraine,6973,2,14,10,2,43,23,20,52
Glenavon,6973,3,10,9,7,53,43,10,39
Linfield,6973,4,10,5,11,37,38,-1,35
Cliftonville,6973,5,10,4,12,34,31,3,34
Ballymena,6973,6,7,4,15,26,50,-24,25
Glentoran,6973,7,6,6,10,24,32,-8,24
Dungannon,6973,8,2,4,16,14,47,-33,10
Crusaders,6974,1,16,6,4,61,34,27,54
Coleraine,6974,2,14,10,2,44,25,19,52
Glenavon,6974,3,10,9,7,55,44,11,39
Linfield,6974,4,11,5,10,39,37,2,38
Cliftonville,6974,5,9,4,13,33,33,0,31
Ballymena,6974,6,8,4,14,29,47,-18,28
Glentoran,6974,7,6,6,10,24,32,-8,24
Dungannon,6974,8,2,4,16,14,47,-33,10
Crusaders,6975,1,16,7,3,61,30,31,55
Coleraine,6975,2,14,11,1,44,23,21,53
Glenavon,6975,3,9,10,7,53,44,9,37
Linfield,6975,4,10,6,10,39,38,1,36
Cliftonville,6975,5,9,5,12,34,33,1,32
Ballymena,6975,6,7,5,14,25,47,-22,26
Glentoran,6975,7,6,6,10,24,32,-8,24
Dungannon,6975,8,2,4,16,14,47,-33,10
Coleraine,6976,1,15,10,1,45,23,22,55
Crusaders,6976,2,16,6,4,61,31,30,54
Linfield,6976,3,11,5,10,38,36,2,38
Glenavon,6976,4,9,9,8,53,45,8,36
Cliftonville,6976,5,9,4,13,32,32,0,31
Ballymena,6976,6,8,4,14,26,47,-21,28
Glentoran,6976,7,6,6,10,24,32,-8,24
Dungannon,6976,8,2,4,16,14,47,-33,10
Crusaders,6977,1,17,6,3,64,31,33,57
Coleraine,6977,2,14,10,2,46,27,19,52
Glenavon,6977,3,10,9,7,57,46,11,39
Linfield,6977,4,11,5,10,40,36,4,38
Cliftonville,6977,5,9,4,13,32,34,-2,31
Ballymena,6977,6,7,4,15,26,50,-24,25
Glentoran,6977,7,6,6,10,24,32,-8,24
Dungannon,6977,8,2,4,16,14,47,-33,10
Crusaders,6978,1,17,6,3,66,30,36,57
Coleraine,6978,2,14,10,2,46,26,20,52
Glenavon,6978,3,10,9,7,56,46,10,39
Linfield,6978,4,10,6,10,38,37,1,36
Cliftonville,6978,5,9,5,12,33,32,1,32
Ballymena,6978,6,7,4,15,25,52,-27,25
Glentoran,6978,7,6,6,10,24,32,-8,24
Dungannon,6978,8,2,4,16,14,47,-33,10
Crusaders,6979,1,16,6,4,62,32,30,54
Coleraine,6979,2,14,10,2,44,24,20,52
Glenavon,6979,3,10,9,7,54,44,10,39
Linfield,6979,4,11,5,10,39,36,3,38
Cliftonville,6979,5,9,4,13,32,33,-1,31
Ballymena,6979,6,8,4,14,27,48,-21,28
Glentoran,6979,7,6,6,10,24,32,-8,24
Dungannon,6979,8,2,4,16,14,47,-33,10
Crusaders,6980,1,17,6,3,62,30,32,57
Coleraine,6980,2,14,11,1,44,23,21,53
Linfield,6980,3,11,5,10,39,37,2,38
Glenavon,6980,4,9,10,7,53,44,9,37
Cliftonville,6980,5,9,4,13,33,33,0,31
Ballymena,6980,6,7,4,15,25,48,-23,25
Glentoran,6980,7,6,6,10,24,32,-8,24
Dungannon,6980,8,2,4,16,14,47,-33,10
Crusaders,6981,1,16,6,4,62,32,30,54
Coleraine,6981,2,14,10,2,43,23,20,52
Glenavon,6981,3,10,9,7,53,43,10,39
Linfield,6981,4,11,5,10,39,37,2,38
Cliftonville,6981,5,9,4,13,33,33,0,31
Ballymena,6981,6,8,4,14,27,48,-21,28
Glentoran,6981,7,6,6,10,24,32,-8,24
Dungannon,6981,8,2,4,16,14,47,-33,10
Crusaders,6982,1,17,6,3,63,31,32,57
Coleraine,6982,2,14,11,1,44,23,21,53
Glenavon,6982,3,9,10,7,53,44,9,37
Linfield,6982,4,10,6,10,38,37,1,36
Cliftonville,6982,5,9,5,12,33,32,1,32
Ballymena,6982,6,7,4,15,26,49,-23,25
Glentoran,6982,7,6,6,10,24,32,-8,24
Dungannon,6982,8,2,4,16,14,47,-33,10
Crusaders,6983,1,16,7,3,62,31,31,55
Coleraine,6983,2,14,11,1,44,23,21,53
Linfield,6983,3,11,5,10,39,37,2,38
Glenavon,6983,4,9,10,7,53,44,9,37
Cliftonville,6983,5,9,4,13,33,33,0,31
Ballymena,6983,6,7,5,14,26,48,-22,26
Glentoran,6983,7,6,6,10,24,32,-8,24
Dungannon,6983,8,2,4,16,14,47,-33,10
Crusaders,6984,1,16,7,3,63,32,31,55
Coleraine,6984,2,14,10,2,44,24,20,52
Glenavon,6984,3,10,9,7,54,44,10,39
Linfield,6984,4,11,5,10,40,37,3,38
Cliftonville,6984,5,9,4,13,33,34,-1,31
Ballymena,6984,6,7,5,14,27,49,-22,26
Glentoran,6984,7,6,6,10,24,32,-8,24
Dungannon,6984,8,2,4,16,14,47,-33,10
Coleraine,6985,1,15,10,1,46,23,23,55
Crusaders,6985,2,16,6,4,63,33,30,54
Linfield,6985,3,11,5,10,39,36,3,38
Glenavon,6985,4,9,9,8,53,46,7,36
Cliftonville,6985,5,9,4,13,32,33,-1,31
Ballymena,6985,6,8,4,14,28,49,-21,28
Glentoran,6985,7,6,6,10,24,32,-8,24
Dungannon,6985,8,2,4,16,14,47,-33,10
Crusaders,6986,1,16,7,3,61,30,31,55
Coleraine,6986,2,14,10,2,43,23,20,52
Glenavon,6986,3,10,9,7,53,43,10,39
Linfield,6986,4,11,5,10,39,36,3,38
Cliftonville,6986,5,9,4,13,32,33,-1,31
Ballymena,6986,6,7,5,14,25,47,-22,26
Glentoran,6986,7,6,6,10,24,32,-8,24
Dungannon,6986,8,2,4,16,14,47,-33,10
Crusaders,6987,1,17,6,3,62,30,32,57
Coleraine,6987,2,14,10,2,45,25,20,52
Glenavon,6987,3,10,9,7,55,45,10,39
Linfield,6987,4,11,5,10,39,37,2,38
Cliftonville,6987,5,9,4,13,33,33,0,31
Ballymena,6987,6,7,4,15,25,48,-23,25
Glentoran,6987,7,6,6,10,24,32,-8,24
Dungannon,6987,8,2,4,16,14,47,-33,10
Crusaders,6988,1,17,6,3,64,31,33,57
Coleraine,6988,2,14,10,2,44,25,19,52
Glenavon,6988,3,10,9,7,55,44,11,39
Linfield,6988,4,11,5,10,39,36,3,38
Cliftonville,6988,5,9,4,13,32,33,-1,31
Ballymena,6988,6,7,4,15,26,50,-24,25
Glentoran,6988,7,6,6,10,24,32,-8,24
Dungannon,6988,8,2,4,16,14,47,-33,10
Crusaders,6989,1,17,6,3,63,31,32,57
Coleraine,6989,2,15,10,1,46,24,22,55
Glenavon,6989,3,9,9,8,54,46,8,36
Linfield,6989,4,10,6,10,38,37,1,36
Cliftonville,6989,5,9,5,12,33,32,1,32
Ballymena,6989,6,7,4,15,26,49,-23,25
Glentoran,6989,7,6,6,10,24,32,-8,24
Dungannon,6989,8,2,4,16,14,47,-33,10
Crusaders,6990,1,16,7,3,62,31,31,55
Coleraine,6990,2,15,10,1,50,24,26,55
Linfield,6990,3,11,5,10,39,37,2,38
Glenavon,6990,4,9,9,8,54,50,4,36
Cliftonville,6990,5,9,4,13,33,33,0,31
Ballymena,6990,6,7,5,14,26,48,-22,26
Glentoran,6990,7,6,6,10,24,32,-8,24
Dungannon,6990,8,2,4,16,14,47,-33,10
Crusaders,6991,1,17,6,3,63,31,32,57
Coleraine,6991,2,14,10,2,43,25,18,52
Glenavon,6991,3,10,9,7,55,43,12,39
Linfield,6991,4,10,5,11,37,37,0,35
Cliftonville,6991,5,10,4,12,33,31,2,34
Ballymena,6991,6,7,4,15,26,49,-23,25
Glentoran,6991,7,6,6,10,24,32,-8,24
Dungannon,6991,8,2,4,16,14,47,-33,10
Coleraine,6992,1,15,10,1,47,24,23,55
Crusaders,6992,2,16,6,4,61,33,28,54
Linfield,6992,3,11,5,10,40,36,4,38
Glenavon,6992,4,9,9,8,54,47,7,36
Cliftonville,6992,5,9,4,13,32,34,-2,31
Ballymena,6992,6,8,4,14,28,47,-19,28
Glentoran,6992,7,6,6,10,24,32,-8,24
Dungannon,6992,8,2,4,16,14,47,-33,10
Coleraine,6993,1,15,10,1,45,23,22,55
Crusaders,6993,2,16,6,4,62,32,30,54
Glenavon,6993,3,9,9,8,53,45,8,36
Linfield,6993,4,10,6,10,37,36,1,36
Cliftonville,6993,5,9,5,12,32,31,1,32
Ballymena,6993,6,8,4,14,27,48,-21,28
Glentoran,6993,7,6,6,10,24,32,-8,24
Dungannon,6993,8,2,4,16,14,47,-33,10
Crusaders,6994,1,17,6,3,65,31,34,57
Coleraine,6994,2,14,11,1,45,24,21,53
Glenavon,6994,3,9,10,7,54,45,9,37
Linfield,6994,4,10,6,10,38,37,1,36
Cliftonville,6994,5,9,5,12,33,32,1,32
Ballymena,6994,6,7,4,15,26,51,-25,25
Glentoran,6994,7,6,6,10,24,32,-8,24
Dungannon,6994,8,2,4,16,14,47,-33,10
Crusaders,6995,1,17,6,3,63,31,32,57
Coleraine,6995,2,15,10,1,46,23,23,55
Glenavon,6995,3,9,9,8,53,46,7,36
Linfield,6995,4,10,6,10,38,37,1,36
Cliftonville,6995,5,9,5,12,33,32,1,32
Ballymena,6995,6,7,4,15,26,49,-23,25
Glentoran,6995,7,6,6,10,24,32,-8,24
Dungannon,6995,8,2,4,16,14,47,-33,10
Coleraine,6996,1,15,10,1,46,24,22,55
Crusaders,6996,2,16,6,4,61,31,30,54
Linfield,6996,3,11,5,10,39,36,3,38
Glenavon,6996,4,9,9,8,54,46,8,36
Cliftonville,6996,5,9,4,13,32,33,-1,31
Ballymena,6996,6,8,4,14,26,47,-21,28
Glentoran,6996,7,6,6,10,24,32,-8,24
Dungannon,6996,8,2,4,16,14,47,-33,10
Crusaders,6997,1,17,6,3,64,31,33,57
Coleraine,6997,2,14,10,2,43,25,18,52
Glenavon,6997,3,10,9,7,55,43,12,39
Linfield,6997,4,11,5,10,38,36,2,38
Cliftonville,6997,5,9,4,13,32,32,0,31
Ballymena,6997,6,7,4,15,26,50,-24,25
Glentoran,6997,7,6,6,10,24,32,-8,24
Dungannon,6997,8,2,4,16,14,47,-33,10
Crusaders,6998,1,16,6,4,61,32,29,54
Coleraine,6998,2,14,10,2,44,24,20,52
Glenavon,6998,3,10,9,7,54,44,10,39
Linfield,6998,4,11,5,10,43,37,6,38
Cliftonville,6998,5,9,4,13,33,37,-4,31
Ballymena,6998,6,8,4,14,27,47,-20,28
Glentoran,6998,7,6,6,10,24,32,-8,24
Dungannon,6998,8,2,4,16,14,47,-33,10
Crusaders,6999,1,16,6,4,62,33,29,54
Coleraine,6999,2,14,10,2,43,23,20,52
Glenavon,6999,3,10,9,7,53,43,10,39
Linfield,6999,4,10,6,10,37,36,1,36
Cliftonville,6999,5,9,5,12,32,31,1,32
Ballymena,6999,6,8,4,14,28,48,-20,28
Glentoran,6999,7,6,6,10,24,32,-8,24
Dungannon,6999,8,2,4,16,14,47,-33,10
Crusaders,7000,1,16,6,4,62,33,29,54
Coleraine,7000,2,14,10,2,44,27,17,52
Glenavon,7000,3,10,9,7,57,44,13,39
Linfield,7000,4,11,5,10,39,36,3,38
Cliftonville,7000,5,9,4,13,32,33,-1,31
Ballymena,7000,6,8,4,14,28,48,-20,28
Glentoran,7000,7,6,6,10,24,32,-8,24
Dungannon,7000,8,2,4,16,14,47,-33,10
Crusaders,7001,1,17,6,3,64,31,33,57
Coleraine,7001,2,14,10,2,44,27,17,52
Glenavon,7001,3,10,9,7,57,44,13,39
Linfield,7001,4,10,6,10,38,37,1,36
Cliftonville,7001,5,9,5,12,33,32,1,32
Ballymena,7001,6,7,4,15,26,50,-24,25
Glentoran,7001,7,6,6,10,24,32,-8,24
Dungannon,7001,8,2,4,16,14,47,-33,10
Crusaders,7002,1,17,6,3,66,31,35,57
Coleraine,7002,2,14,11,1,45,24,21,53
Glenavon,7002,3,9,10,7,54,45,9,37
Linfield,7002,4,10,6,10,39,38,1,36
Cliftonville,7002,5,9,5,12,34,33,1,32
Ballymena,7002,6,7,4,15,26,52,-26,25
Glentoran,7002,7,6,6,10,24,32,-8,24
Dungannon,7002,8,2,4,16,14,47,-33,10
Crusaders,7003,1,16,6,4,62,32,30,54
Coleraine,7003,2,14,10,2,43,25,18,52
Glenavon,7003,3,10,9,7,55,43,12,39
Linfield,7003,4,10,5,11,37,38,-1,35
Cliftonville,7003,5,10,4,12,34,31,3,34
Ballymena,7003,6,8,4,14,27,48,-21,28
Glentoran,7003,7,6,6,10,24,32,-8,24
Dungannon,7003,8,2,4,16,14,47,-33,10
Crusaders,7004,1,16,7,3,62,31,31,55
Coleraine,7004,2,14,10,2,44,25,19,52
Glenavon,7004,3,10,9,7,55,44,11,39
Linfield,7004,4,10,5,11,38,38,0,35
Cliftonville,7004,5,10,4,12,34,32,2,34
Ballymena,7004,6,7,5,14,26,48,-22,26
Glentoran,7004,7,6,6,10,24,32,-8,24
Dungannon,7004,8,2,4,16,14,47,-33,10
Crusaders,7005,1,17,6,3,65,31,34,57
Coleraine,7005,2,14,11,1,43,22,21,53
Glenavon,7005,3,9,10,7,52,43,9,37
Linfield,7005,4,10,5,11,37,39,-2,35
Cliftonville,7005,5,10,4,12,35,31,4,34
Ballymena,7005,6,7,4,15,26,51,-25,25
Glentoran,7005,7,6,6,10,24,32,-8,24
Dungannon,7005,8,2,4,16,14,47,-33,10
Coleraine,7006,1,15,10,1,45,23,22,55
Crusaders,7006,2,16,6,4,63,33,30,54
Linfield,7006,3,11,5,10,39,37,2,38
Glenavon,7006,4,9,9,8,53,45,8,36
Cliftonville,7006,5,9,4,13,33,33,0,31
Ballymena,7006,6,8,4,14,28,49,-21,28
Glentoran,7006,7,6,6,10,24,32,-8,24
Dungannon,7006,8,2,4,16,14,47,-33,10
Crusaders,7007,1,16,6,4,62,32,30,54
Coleraine,7007,2,14,11,1,46,25,21,53
Glenavon,7007,3,9,10,7,55,46,9,37
Linfield,7007,4,10,5,11,37,38,-1,35
Cliftonville,7007,5,10,4,12,34,31,3,34
Ballymena,7007,6,8,4,14,27,48,-21,28
Glentoran,7007,7,6,6,10,24,32,-8,24
Dungannon,7007,8,2,4,16,14,47,-33,10
Crusaders,7008,1,16,6,4,62,32,30,54
Coleraine,7008,2,14,10,2,43,23,20,52
Glenavon,7008,3,10,9,7,53,43,10,39
Linfield,7008,4,11,5,10,40,36,4,38
Cliftonville,7008,5,9,4,13,32,34,-2,31
Ballymena,7008,6,8,4,14,27,48,-21,28
Glentoran,7008,7,6,6,10,24,32,-8,24
Dungannon,7008,8,2,4,16,14,47,-33,10
Crusaders,7009,1,16,7,3,62,31,31,55
Coleraine,7009,2,14,10,2,45,27,18,52
Glenavon,7009,3,10,9,7,57,45,12,39
Linfield,7009,4,10,5,11,37,38,-1,35
Cliftonville,7009,5,10,4,12,34,31,3,34
Ballymena,7009,6,7,5,14,26,48,-22,26
Glentoran,7009,7,6,6,10,24,32,-8,24
Dungannon,7009,8,2,4,16,14,47,-33,10
Crusaders,7010,1,17,6,3,64,30,34,57
Coleraine,7010,2,15,10,1,46,23,23,55
Linfield,7010,3,11,5,10,41,37,4,38
Glenavon,7010,4,9,9,8,53,46,7,36
Cliftonville,7010,5,9,4,13,33,35,-2,31
Ballymena,7010,6,7,4,15,25,50,-25,25
Glentoran,7010,7,6,6,10,24,32,-8,24
Dungannon,7010,8,2,4,16,14,47,-33,10
Crusaders,7011,1,16,7,3,62,31,31,55
Coleraine,7011,2,14,10,2,43,23,20,52
Glenavon,7011,3,10,9,7,53,43,10,39
Linfield,7011,4,10,6,10,39,38,1,36
Cliftonville,7011,5,9,5,12,34,33,1,32
Ballymena,7011,6,7,5,14,26,48,-22,26
Glentoran,7011,7,6,6,10,24,32,-8,24
Dungannon,7011,8,2,4,16,14,47,-33,10
Crusaders,7012,1,17,6,3,64,31,33,57
Coleraine,7012,2,14,11,1,45,24,21,53
Glenavon,7012,3,9,10,7,54,45,9,37
Linfield,7012,4,10,5,11,39,39,0,35
Cliftonville,7012,5,10,4,12,35,33,2,34
Ballymena,7012,6,7,4,15,26,50,-24,25
Glentoran,7012,7,6,6,10,24,32,-8,24
Dungannon,7012,8,2,4,16,14,47,-33,10
Crusaders,7013,1,16,6,4,62,32,30,54
Coleraine,7013,2,14,10,2,44,24,20,52
Glenavon,7013,3,10,9,7,54,44,10,39
Linfield,7013,4,10,6,10,37,36,1,36
Cliftonville,7013,5,9,5,12,32,31,1,32
Ballymena,7013,6,8,4,14,27,48,-21,28
Glentoran,7013,7,6,6,10,24,32,-8,24
Dungannon,7013,8,2,4,16,14,47,-33,10
Crusaders,7014,1,16,7,3,63,32,31,55
Coleraine,7014,2,15,10,1,45,23,22,55
Linfield,7014,3,11,5,10,38,36,2,38
Glenavon,7014,4,9,9,8,53,45,8,36
Cliftonville,7014,5,9,4,13,32,32,0,31
Ballymena,7014,6,7,5,14,27,49,-22,26
Glentoran,7014,7,6,6,10,24,32,-8,24
Dungannon,7014,8,2,4,16,14,47,-33,10
Crusaders,7015,1,16,6,4,61,32,29,54
Coleraine,7015,2,14,10,2,45,25,20,52
Glenavon,7015,3,10,9,7,55,45,10,39
Linfield,7015,4,10,6,10,38,37,1,36
Cliftonville,7015,5,9,5,12,33,32,1,32
Ballymena,7015,6,8,4,14,27,47,-20,28
Glentoran,7015,7,6,6,10,24,32,-8,24
Dungannon,7015,8,2,4,16,14,47,-33,10
Crusaders,7016,1,17,6,3,65,30,35,57
Coleraine,7016,2,14,11,1,44,23,21,53
Glenavon,7016,3,9,10,7,53,44,9,37
Linfield,7016,4,10,5,11,38,39,-1,35
Cliftonville,7016,5,10,4,12,35,32,3,34
Ballymena,7016,6,7,4,15,25,51,-26,25
Glentoran,7016,7,6,6,10,24,32,-8,24
Dungannon,7016,8,2,4,16,14,47,-33,10
Crusaders,7017,1,17,6,3,64,31,33,57
Coleraine,7017,2,14,11,1,44,23,21,53
Glenavon,7017,3,9,10,7,53,44,9,37
Linfield,7017,4,10,5,11,38,39,-1,35
Cliftonville,7017,5,10,4,12,35,32,3,34
Ballymena,7017,6,7,4,15,26,50,-24,25
Glentoran,7017,7,6,6,10,24,32,-8,24
Dungannon,7017,8,2,4,16,14,47,-33,10
Crusaders,7018,1,17,6,3,65,32,33,57
Coleraine,7018,2,15,10,1,48,22,26,55
Glenavon,7018,3,9,9,8,52,48,4,36
Linfield,7018,4,10,6,10,39,38,1,36
Cliftonville,7018,5,9,5,12,34,33,1,32
Ballymena,7018,6,7,4,15,27,51,-24,25
Glentoran,7018,7,6,6,10,24,32,-8,24
Dungannon,7018,8,2,4,16,14,47,-33,10
Crusaders,7019,1,16,6,4,61,32,29,54
Coleraine,7019,2,14,11,1,44,23,21,53
Glenavon,7019,3,9,10,7,53,44,9,37
Linfield,7019,4,10,6,10,40,39,1,36
Cliftonville,7019,5,9,5,12,35,34,1,32
Ballymena,7019,6,8,4,14,27,47,-20,28
Glentoran,7019,7,6,6,10,24,32,-8,24
Dungannon,7019,8,2,4,16,14,47,-33,10
Crusaders,7020,1,16,6,4,62,33,29,54
Coleraine,7020,2,14,10,2,44,24,20,52
Glenavon,7020,3,10,9,7,54,44,10,39
Linfield,7020,4,11,5,10,39,37,2,38
Cliftonville,7020,5,9,4,13,33,33,0,31
Ballymena,7020,6,8,4,14,28,48,-20,28
Glentoran,7020,7,6,6,10,24,32,-8,24
Dungannon,7020,8,2,4,16,14,47,-33,10
Crusaders,7021,1,17,6,3,62,30,32,57
Coleraine,7021,2,15,10,1,46,23,23,55
Glenavon,7021,3,9,9,8,53,46,7,36
Linfield,7021,4,10,5,11,37,38,-1,35
Cliftonville,7021,5,10,4,12,34,31,3,34
Ballymena,7021,6,7,4,15,25,48,-23,25
Glentoran,7021,7,6,6,10,24,32,-8,24
Dungannon,7021,8,2,4,16,14,47,-33,10
Crusaders,7022,1,17,6,3,64,30,34,57
Coleraine,7022,2,14,10,2,45,25,20,52
Glenavon,7022,3,10,9,7,55,45,10,39
Linfield,7022,4,10,5,11,37,39,-2,35
Cliftonville,7022,5,10,4,12,35,31,4,34
Ballymena,7022,6,7,4,15,25,50,-25,25
Glentoran,7022,7,6,6,10,24,32,-8,24
Dungannon,7022,8,2,4,16,14,47,-33,10
Crusaders,7023,1,16,7,3,63,32,31,55
Coleraine,7023,2,15,10,1,46,23,23,55
Linfield,7023,3,11,5,10,38,36,2,38
Glenavon,7023,4,9,9,8,53,46,7,36
Cliftonville,7023,5,9,4,13,32,32,0,31
Ballymena,7023,6,7,5,14,27,49,-22,26
Glentoran,7023,7,6,6,10,24,32,-8,24
Dungannon,7023,8,2,4,16,14,47,-33,10
Crusaders,7024,1,17,6,3,63,30,33,57
Coleraine,7024,2,14,10,2,43,26,17,52
Glenavon,7024,3,10,9,7,56,43,13,39
Linfield,7024,4,11,5,10,39,37,2,38
Cliftonville,7024,5,9,4,13,33,33,0,31
Ballymena,7024,6,7,4,15,25,49,-24,25
Glentoran,7024,7,6,6,10,24,32,-8,24
Dungannon,7024,8,2,4,16,14,47,-33,10
Crusaders,7025,1,16,7,3,63,32,31,55
Coleraine,7025,2,14,10,2,44,24,20,52
Glenavon,7025,3,10,9,7,54,44,10,39
Linfield,7025,4,10,6,10,39,38,1,36
Cliftonville,7025,5,9,5,12,34,33,1,32
Ballymena,7025,6,7,5,14,27,49,-22,26
Glentoran,7025,7,6,6,10,24,32,-8,24
Dungannon,7025,8,2,4,16,14,47,-33,10
Crusaders,7026,1,17,6,3,62,30,32,57
Coleraine,7026,2,15,10,1,45,23,22,55
Glenavon,7026,3,9,9,8,53,45,8,36
Linfield,7026,4,10,6,10,39,38,1,36
Cliftonville,7026,5,9,5,12,34,33,1,32
Ballymena,7026,6,7,4,15,25,48,-23,25
Glentoran,7026,7,6,6,10,24,32,-8,24
Dungannon,7026,8,2,4,16,14,47,-33,10
Crusaders,7027,1,17,6,3,63,31,32,57
Coleraine,7027,2,14,10,2,43,23,20,52
Glenavon,7027,3,10,9,7,53,43,10,39
Linfield,7027,4,10,5,11,37,37,0,35
Cliftonville,7027,5,10,4,12,33,31,2,34
Ballymena,7027,6,7,4,15,26,49,-23,25
Glentoran,7027,7,6,6,10,24,32,-8,24
Dungannon,7027,8,2,4,16,14,47,-33,10
Crusaders,7028,1,17,6,3,63,31,32,57
Coleraine,7028,2,15,10,1,45,23,22,55
Linfield,7028,3,11,5,10,39,37,2,38
Glenavon,7028,4,9,9,8,53,45,8,36
Cliftonville,7028,5,9,4,13,33,33,0,31
Ballymena,7028,6,7,4,15,26,49,-23,25
Glentoran,7028,7,6,6,10,24,32,-8,24
Dungannon,7028,8,2,4,16,14,47,-33,10
Crusaders,7029,1,16,7,3,63,32,31,55
Coleraine,7029,2,14,10,2,43,23,20,52
Glenavon,7029,3,10,9,7,53,43,10,39
Linfield,7029,4,11,5,10,39,36,3,38
Cliftonville,7029,5,9,4,13,32,33,-1,31
Ballymena,7029,6,7,5,14,27,49,-22,26
Glentoran,7029,7,6,6,10,24,32,-8,24
Dungannon,7029,8,2,4,16,14,47,-33,10
Crusaders,7030,1,17,6,3,64,31,33,57
Coleraine,7030,2,14,10,2,43,27,16,52
Glenavon,7030,3,10,9,7,57,43,14,39
Linfield,7030,4,11,5,10,39,37,2,38
Cliftonville,7030,5,9,4,13,33,33,0,31
Ballymena,7030,6,7,4,15,26,50,-24,25
Glentoran,7030,7,6,6,10,24,32,-8,24
Dungannon,7030,8,2,4,16,14,47,-33,10
Crusaders,7031,1,17,6,3,65,31,34,57
Coleraine,7031,2,14,11,1,45,24,21,53
Linfield,7031,3,11,5,10,40,37,3,38
Glenavon,7031,4,9,10,7,54,45,9,37
Cliftonville,7031,5,9,4,13,33,34,-1,31
Ballymena,7031,6,7,4,15,26,51,-25,25
Glentoran,7031,7,6,6,10,24,32,-8,24
Dungannon,7031,8,2,4,16,14,47,-33,10
Crusaders,7032,1,16,6,4,61,33,28,54
Coleraine,7032,2,14,10,2,43,24,19,52
Glenavon,7032,3,10,9,7,54,43,11,39
Linfield,7032,4,11,5,10,38,36,2,38
Cliftonville,7032,5,9,4,13,32,32,0,31
Ballymena,7032,6,8,4,14,28,47,-19,28
Glentoran,7032,7,6,6,10,24,32,-8,24
Dungannon,7032,8,2,4,16,14,47,-33,10
Crusaders,7033,1,17,6,3,66,30,36,57
Coleraine,7033,2,14,10,2,43,23,20,52
Glenavon,7033,3,10,9,7,53,43,10,39
Linfield,7033,4,10,6,10,38,37,1,36
Cliftonville,7033,5,9,5,12,33,32,1,32
Ballymena,7033,6,7,4,15,25,52,-27,25
Glentoran,7033,7,6,6,10,24,32,-8,24
Dungannon,7033,8,2,4,16,14,47,-33,10
Crusaders,7034,1,16,7,3,64,33,31,55
Coleraine,7034,2,15,10,1,46,23,23,55
Glenavon,7034,3,9,9,8,53,46,7,36
Linfield,7034,4,10,6,10,37,36,1,36
Cliftonville,7034,5,9,5,12,32,31,1,32
Ballymena,7034,6,7,5,14,28,50,-22,26
Glentoran,7034,7,6,6,10,24,32,-8,24
Dungannon,7034,8,2,4,16,14,47,-33,10
Crusaders,7035,1,16,6,4,65,36,29,54
Coleraine,7035,2,14,10,2,44,24,20,52
Glenavon,7035,3,10,9,7,54,44,10,39
Linfield,7035,4,11,5,10,38,36,2,38
Cliftonville,7035,5,9,4,13,32,32,0,31
Ballymena,7035,6,8,4,14,31,51,-20,28
Glentoran,7035,7,6,6,10,24,32,-8,24
Dungannon,7035,8,2,4,16,14,47,-33,10
Crusaders,7036,1,16,6,4,61,32,29,54
Coleraine,7036,2,14,10,2,44,26,18,52
Glenavon,7036,3,10,9,7,56,44,12,39
Linfield,7036,4,10,5,11,38,38,0,35
Cliftonville,7036,5,10,4,12,34,32,2,34
Ballymena,7036,6,8,4,14,27,47,-20,28
Glentoran,7036,7,6,6,10,24,32,-8,24
Dungannon,7036,8,2,4,16,14,47,-33,10
Crusaders,7037,1,17,6,3,65,32,33,57
Coleraine,7037,2,15,10,1,45,23,22,55
Linfield,7037,3,11,5,10,38,36,2,38
Glenavon,7037,4,9,9,8,53,45,8,36
Cliftonville,7037,5,9,4,13,32,32,0,31
Ballymena,7037,6,7,4,15,27,51,-24,25
Glentoran,7037,7,6,6,10,24,32,-8,24
Dungannon,7037,8,2,4,16,14,47,-33,10
Crusaders,7038,1,17,6,3,63,31,32,57
Coleraine,7038,2,15,10,1,44,22,22,55
Glenavon,7038,3,9,9,8,52,44,8,36
Linfield,7038,4,10,6,10,37,36,1,36
Cliftonville,7038,5,9,5,12,32,31,1,32
Ballymena,7038,6,7,4,15,26,49,-23,25
Glentoran,7038,7,6,6,10,24,32,-8,24
Dungannon,7038,8,2,4,16,14,47,-33,10
Crusaders,7039,1,17,6,3,65,32,33,57
Coleraine,7039,2,14,11,1,44,23,21,53
Glenavon,7039,3,9,10,7,53,44,9,37
Linfield,7039,4,10,5,11,37,38,-1,35
Cliftonville,7039,5,10,4,12,34,31,3,34
Ballymena,7039,6,7,4,15,27,51,-24,25
Glentoran,7039,7,6,6,10,24,32,-8,24
Dungannon,7039,8,2,4,16,14,47,-33,10
Crusaders,7040,1,17,6,3,64,31,33,57
Coleraine,7040,2,14,10,2,44,25,19,52
Glenavon,7040,3,10,9,7,55,44,11,39
Linfield,7040,4,11,5,10,40,36,4,38
Cliftonville,7040,5,9,4,13,32,34,-2,31
Ballymena,7040,6,7,4,15,26,50,-24,25
Glentoran,7040,7,6,6,10,24,32,-8,24
Dungannon,7040,8,2,4,16,14,47,-33,10
Crusaders,7041,1,17,6,3,66,33,33,57
Coleraine,7041,2,14,11,1,43,22,21,53
Linfield,7041,3,11,5,10,41,36,5,38
Glenavon,7041,4,9,10,7,52,43,9,37
Cliftonville,7041,5,9,4,13,32,35,-3,31
Ballymena,7041,6,7,4,15,28,52,-24,25
Glentoran,7041,7,6,6,10,24,32,-8,24
Dungannon,7041,8,2,4,16,14,47,-33,10
Crusaders,7042,1,16,7,3,63,32,31,55
Coleraine,7042,2,14,10,2,43,25,18,52
Glenavon,7042,3,10,9,7,55,43,12,39
Linfield,7042,4,11,5,10,38,36,2,38
Cliftonville,7042,5,9,4,13,32,32,0,31
Ballymena,7042,6,7,5,14,27,49,-22,26
Glentoran,7042,7,6,6,10,24,32,-8,24
Dungannon,7042,8,2,4,16,14,47,-33,10
Crusaders,7043,1,17,6,3,63,30,33,57
Coleraine,7043,2,14,11,1,44,23,21,53
Glenavon,7043,3,9,10,7,53,44,9,37
Linfield,7043,4,10,5,11,39,39,0,35
Cliftonville,7043,5,10,4,12,35,33,2,34
Ballymena,7043,6,7,4,15,25,49,-24,25
Glentoran,7043,7,6,6,10,24,32,-8,24
Dungannon,7043,8,2,4,16,14,47,-33,10
Crusaders,7044,1,17,6,3,69,30,39,57
Coleraine,7044,2,15,10,1,46,23,23,55
Linfield,7044,3,11,5,10,40,36,4,38
Glenavon,7044,4,9,9,8,53,46,7,36
Cliftonville,7044,5,9,4,13,32,34,-2,31
Ballymena,7044,6,7,4,15,25,55,-30,25
Glentoran,7044,7,6,6,10,24,32,-8,24
Dungannon,7044,8,2,4,16,14,47,-33,10
Crusaders,7045,1,16,6,4,62,32,30,54
Coleraine,7045,2,14,11,1,44,23,21,53
Glenavon,7045,3,9,10,7,53,44,9,37
Linfield,7045,4,10,6,10,38,37,1,36
Cliftonville,7045,5,9,5,12,33,32,1,32
Ballymena,7045,6,8,4,14,27,48,-21,28
Glentoran,7045,7,6,6,10,24,32,-8,24
Dungannon,7045,8,2,4,16,14,47,-33,10
Coleraine,7046,1,15,10,1,44,22,22,55
Crusaders,7046,2,16,6,4,63,34,29,54
Glenavon,7046,3,9,9,8,52,44,8,36
Linfield,7046,4,10,6,10,38,37,1,36
Cliftonville,7046,5,9,5,12,33,32,1,32
Ballymena,7046,6,8,4,14,29,49,-20,28
Glentoran,7046,7,6,6,10,24,32,-8,24
Dungannon,7046,8,2,4,16,14,47,-33,10
Coleraine,7047,1,15,10,1,45,23,22,55
Crusaders,7047,2,16,6,4,63,33,30,54
Linfield,7047,3,11,5,10,39,37,2,38
Glenavon,7047,4,9,9,8,53,45,8,36
Cliftonville,7047,5,9,4,13,33,33,0,31
Ballymena,7047,6,8,4,14,28,49,-21,28
Glentoran,7047,7,6,6,10,24,32,-8,24
Dungannon,7047,8,2,4,16,14,47,-33,10
Crusaders,7048,1,17,6,3,63,30,33,57
Coleraine,7048,2,14,10,2,43,23,20,52
Glenavon,7048,3,10,9,7,53,43,10,39
Linfield,7048,4,11,5,10,38,36,2,38
Cliftonville,7048,5,9,4,13,32,32,0,31
Ballymena,7048,6,7,4,15,25,49,-24,25
Glentoran,7048,7,6,6,10,24,32,-8,24
Dungannon,7048,8,2,4,16,14,47,-33,10
Crusaders,7049,1,17,6,3,62,30,32,57
Coleraine,7049,2,14,11,1,44,23,21,53
Linfield,7049,3,11,5,10,40,37,3,38
Glenavon,7049,4,9,10,7,53,44,9,37
Cliftonville,7049,5,9,4,13,33,34,-1,31
Ballymena,7049,6,7,4,15,25,48,-23,25
Glentoran,7049,7,6,6,10,24,32,-8,24
Dungannon,7049,8,2,4,16,14,47,-33,10
Crusaders,7050,1,17,6,3,62,30,32,57
Coleraine,7050,2,15,10,1,44,22,22,55
Glenavon,7050,3,9,9,8,52,44,8,36
Linfield,7050,4,10,5,11,40,40,0,35
Cliftonville,7050,5,10,4,12,36,34,2,34
Ballymena,7050,6,7,4,15,25,48,-23,25
Glentoran,7050,7,6,6,10,24,32,-8,24
Dungannon,7050,8,2,4,16,14,47,-33,10
Crusaders,7051,1,16,6,4,62,32,30,54
Coleraine,7051,2,14,11,1,43,22,21,53
Glenavon,7051,3,9,10,7,52,43,9,37
Linfield,7051,4,10,5,11,38,38,0,35
Cliftonville,7051,5,10,4,12,34,32,2,34
Ballymena,7051,6,8,4,14,27,48,-21,28
Glentoran,7051,7,6,6,10,24,32,-8,24
Dungannon,7051,8,2,4,16,14,47,-33,10
Crusaders,7052,1,16,7,3,63,32,31,55
Coleraine,7052,2,15,10,1,44,22,22,55
Glenavon,7052,3,9,9,8,52,44,8,36
Linfield,7052,4,10,5,11,38,38,0,35
Cliftonville,7052,5,10,4,12,34,32,2,34
Ballymena,7052,6,7,5,14,27,49,-22,26
Glentoran,7052,7,6,6,10,24,32,-8,24
Dungannon,7052,8,2,4,16,14,47,-33,10
Crusaders,7053,1,16,6,4,62,33,29,54
Coleraine,7053,2,14,10,2,44,25,19,52
Glenavon,7053,3,10,9,7,55,44,11,39
Linfield,7053,4,10,5,11,37,37,0,35
Cliftonville,7053,5,10,4,12,33,31,2,34
Ballymena,7053,6,8,4,14,28,48,-20,28
Glentoran,7053,7,6,6,10,24,32,-8,24
Dungannon,7053,8,2,4,16,14,47,-33,10
Crusaders,7054,1,17,6,3,64,31,33,57
Coleraine,7054,2,14,10,2,44,25,19,52
Glenavon,7054,3,10,9,7,55,44,11,39
Linfield,7054,4,11,5,10,39,37,2,38
Cliftonville,7054,5,9,4,13,33,33,0,31
Ballymena,7054,6,7,4,15,26,50,-24,25
Glentoran,7054,7,6,6,10,24,32,-8,24
Dungannon,7054,8,2,4,16,14,47,-33,10
Crusaders,7055,1,16,7,3,63,32,31,55
Coleraine,7055,2,14,10,2,44,25,19,52
Glenavon,7055,3,10,9,7,55,44,11,39
Linfield,7055,4,11,5,10,38,36,2,38
Cliftonville,7055,5,9,4,13,32,32,0,31
Ballymena,7055,6,7,5,14,27,49,-22,26
Glentoran,7055,7,6,6,10,24,32,-8,24
Dungannon,7055,8,2,4,16,14,47,-33,10
Crusaders,7056,1,17,6,3,63,31,32,57
Coleraine,7056,2,14,10,2,44,26,18,52
Glenavon,7056,3,10,9,7,56,44,12,39
Linfield,7056,4,10,5,11,38,40,-2,35
Cliftonville,7056,5,10,4,12,36,32,4,34
Ballymena,7056,6,7,4,15,26,49,-23,25
Glentoran,7056,7,6,6,10,24,32,-8,24
Dungannon,7056,8,2,4,16,14,47,-33,10
Crusaders,7057,1,17,6,3,62,30,32,57
Coleraine,7057,2,15,10,1,46,22,24,55
Glenavon,7057,3,9,9,8,52,46,6,36
Linfield,7057,4,10,6,10,37,36,1,36
Cliftonville,7057,5,9,5,12,32,31,1,32
Ballymena,7057,6,7,4,15,25,48,-23,25
Glentoran,7057,7,6,6,10,24,32,-8,24
Dungannon,7057,8,2,4,16,14,47,-33,10
Coleraine,7058,1,15,10,1,47,23,24,55
Crusaders,7058,2,16,6,4,63,35,28,54
Glenavon,7058,3,9,9,8,53,47,6,36
Linfield,7058,4,10,5,11,37,37,0,35
Cliftonville,7058,5,10,4,12,33,31,2,34
Ballymena,7058,6,8,4,14,30,49,-19,28
Glentoran,7058,7,6,6,10,24,32,-8,24
Dungannon,7058,8,2,4,16,14,47,-33,10
Crusaders,7059,1,16,7,3,61,30,31,55
Coleraine,7059,2,15,10,1,44,22,22,55
Glenavon,7059,3,9,9,8,52,44,8,36
Linfield,7059,4,10,5,11,37,37,0,35
Cliftonville,7059,5,10,4,12,33,31,2,34
Ballymena,7059,6,7,5,14,25,47,-22,26
Glentoran,7059,7,6,6,10,24,32,-8,24
Dungannon,7059,8,2,4,16,14,47,-33,10
Crusaders,7060,1,17,6,3,64,32,32,57
Coleraine,7060,2,14,11,1,45,24,21,53
Linfield,7060,3,11,5,10,39,37,2,38
Glenavon,7060,4,9,10,7,54,45,9,37
Cliftonville,7060,5,9,4,13,33,33,0,31
Ballymena,7060,6,7,4,15,27,50,-23,25
Glentoran,7060,7,6,6,10,24,32,-8,24
Dungannon,7060,8,2,4,16,14,47,-33,10
Crusaders,7061,1,17,6,3,65,32,33,57
Coleraine,7061,2,14,11,1,45,24,21,53
Glenavon,7061,3,9,10,7,54,45,9,37
Linfield,7061,4,10,6,10,38,37,1,36
Cliftonville,7061,5,9,5,12,33,32,1,32
Ballymena,7061,6,7,4,15,27,51,-24,25
Glentoran,7061,7,6,6,10,24,32,-8,24
Dungannon,7061,8,2,4,16,14,47,-33,10
Crusaders,7062,1,17,6,3,65,31,34,57
Coleraine,7062,2,14,10,2,43,24,19,52
Glenavon,7062,3,10,9,7,54,43,11,39
Linfield,7062,4,10,6,10,37,36,1,36
Cliftonville,7062,5,9,5,12,32,31,1,32
Ballymena,7062,6,7,4,15,26,51,-25,25
Glentoran,7062,7,6,6,10,24,32,-8,24
Dungannon,7062,8,2,4,16,14,47,-33,10
Crusaders,7063,1,16,7,3,62,31,31,55
Coleraine,7063,2,14,10,2,43,23,20,52
Glenavon,7063,3,10,9,7,53,43,10,39
Linfield,7063,4,10,5,11,39,39,0,35
Cliftonville,7063,5,10,4,12,35,33,2,34
Ballymena,7063,6,7,5,14,26,48,-22,26
Glentoran,7063,7,6,6,10,24,32,-8,24
Dungannon,7063,8,2,4,16,14,47,-33,10
Crusaders,7064,1,17,6,3,63,31,32,57
Coleraine,7064,2,14,10,2,43,24,19,52
Glenavon,7064,3,10,9,7,54,43,11,39
Linfield,7064,4,10,6,10,39,38,1,36
Cliftonville,7064,5,9,5,12,34,33,1,32
Ballymena,7064,6,7,4,15,26,49,-23,25
Glentoran,7064,7,6,6,10,24,32,-8,24
Dungannon,7064,8,2,4,16,14,47,-33,10
Crusaders,7065,1,17,6,3,66,31,35,57
Coleraine,7065,2,14,10,2,43,26,17,52
Glenavon,7065,3,10,9,7,56,43,13,39
Linfield,7065,4,10,5,11,37,38,-1,35
Cliftonville,7065,5,10,4,12,34,31,3,34
Ballymena,7065,6,7,4,15,26,52,-26,25
Glentoran,7065,7,6,6,10,24,32,-8,24
Dungannon,7065,8,2,4,16,14,47,-33,10
Crusaders,7066,1,16,7,3,62,31,31,55
Coleraine,7066,2,14,11,1,46,25,21,53
Linfield,7066,3,11,5,10,43,38,5,38
Glenavon,7066,4,9,10,7,55,46,9,37
Cliftonville,7066,5,9,4,13,34,37,-3,31
Ballymena,7066,6,7,5,14,26,48,-22,26
Glentoran,7066,7,6,6,10,24,32,-8,24
Dungannon,7066,8,2,4,16,14,47,-33,10
Crusaders,7067,1,17,6,3,64,30,34,57
Coleraine,7067,2,15,10,1,44,22,22,55
Glenavon,7067,3,9,9,8,52,44,8,36
Linfield,7067,4,10,5,11,37,38,-1,35
Cliftonville,7067,5,10,4,12,34,31,3,34
Ballymena,7067,6,7,4,15,25,50,-25,25
Glentoran,7067,7,6,6,10,24,32,-8,24
Dungannon,7067,8,2,4,16,14,47,-33,10
Crusaders,7068,1,16,7,3,62,31,31,55
Coleraine,7068,2,15,10,1,46,22,24,55
Glenavon,7068,3,9,9,8,52,46,6,36
Linfield,7068,4,10,5,11,38,39,-1,35
Cliftonville,7068,5,10,4,12,35,32,3,34
Ballymena,7068,6,7,5,14,26,48,-22,26
Glentoran,7068,7,6,6,10,24,32,-8,24
Dungannon,7068,8,2,4,16,14,47,-33,10
Crusaders,7069,1,16,6,4,62,32,30,54
Coleraine,7069,2,14,10,2,43,24,19,52
Glenavon,7069,3,10,9,7,54,43,11,39
Linfield,7069,4,11,5,10,40,37,3,38
Cliftonville,7069,5,9,4,13,33,34,-1,31
Ballymena,7069,6,8,4,14,27,48,-21,28
Glentoran,7069,7,6,6,10,24,32,-8,24
Dungannon,7069,8,2,4,16,14,47,-33,10
Crusaders,7070,1,17,6,3,63,30,33,57
Coleraine,7070,2,15,10,1,47,24,23,55
Glenavon,7070,3,9,9,8,54,47,7,36
Linfield,7070,4,10,6,10,38,37,1,36
Cliftonville,7070,5,9,5,12,33,32,1,32
Ballymena,7070,6,7,4,15,25,49,-24,25
Glentoran,7070,7,6,6,10,24,32,-8,24
Dungannon,7070,8,2,4,16,14,47,-33,10
Crusaders,7071,1,17,6,3,63,30,33,57
Coleraine,7071,2,15,10,1,45,23,22,55
Linfield,7071,3,11,5,10,40,36,4,38
Glenavon,7071,4,9,9,8,53,45,8,36
Cliftonville,7071,5,9,4,13,32,34,-2,31
Ballymena,7071,6,7,4,15,25,49,-24,25
Glentoran,7071,7,6,6,10,24,32,-8,24
Dungannon,7071,8,2,4,16,14,47,-33,10
Crusaders,7072,1,16,7,3,61,30,31,55
Coleraine,7072,2,15,10,1,45,23,22,55
Linfield,7072,3,11,5,10,38,36,2,38
Glenavon,7072,4,9,9,8,53,45,8,36
Cliftonville,7072,5,9,4,13,32,32,0,31
Ballymena,7072,6,7,5,14,25,47,-22,26
Glentoran,7072,7,6,6,10,24,32,-8,24
Dungannon,7072,8,2,4,16,14,47,-33,10
Crusaders,7073,1,16,7,3,63,32,31,55
Coleraine,7073,2,14,10,2,43,23,20,52
Glenavon,7073,3,10,9,7,53,43,10,39
Linfield,7073,4,10,6,10,39,38,1,36
Cliftonville,7073,5,9,5,12,34,33,1,32
Ballymena,7073,6,7,5,14,27,49,-22,26
Glentoran,7073,7,6,6,10,24,32,-8,24
Dungannon,7073,8,2,4,16,14,47,-33,10
Coleraine,7074,1,15,10,1,46,22,24,55
Crusaders,7074,2,16,6,4,61,33,28,54
Linfield,7074,3,11,5,10,40,38,2,38
Glenavon,7074,4,9,9,8,52,46,6,36
Cliftonville,7074,5,9,4,13,34,34,0,31
Ballymena,7074,6,8,4,14,28,47,-19,28
Glentoran,7074,7,6,6,10,24,32,-8,24
Dungannon,7074,8,2,4,16,14,47,-33,10
Crusaders,7075,1,17,6,3,64,32,32,57
Coleraine,7075,2,15,10,1,47,24,23,55
Glenavon,7075,3,9,9,8,54,47,7,36
Linfield,7075,4,10,6,10,37,36,1,36
Cliftonville,7075,5,9,5,12,32,31,1,32
Ballymena,7075,6,7,4,15,27,50,-23,25
Glentoran,7075,7,6,6,10,24,32,-8,24
Dungannon,7075,8,2,4,16,14,47,-33,10
Crusaders,7076,1,16,6,4,61,35,26,54
Coleraine,7076,2,14,10,2,44,24,20,52
Glenavon,7076,3,10,9,7,54,44,10,39
Linfield,7076,4,10,6,10,37,36,1,36
Cliftonville,7076,5,9,5,12,32,31,1,32
Ballymena,7076,6,8,4,14,30,47,-17,28
Glentoran,7076,7,6,6,10,24,32,-8,24
Dungannon,7076,8,2,4,16,14,47,-33,10
Crusaders,7077,1,17,6,3,64,32,32,57
Coleraine,7077,2,14,11,1,46,25,21,53
Linfield,7077,3,11,5,10,39,37,2,38
Glenavon,7077,4,9,10,7,55,46,9,37
Cliftonville,7077,5,9,4,13,33,33,0,31
Ballymena,7077,6,7,4,15,27,50,-23,25
Glentoran,7077,7,6,6,10,24,32,-8,24
Dungannon,7077,8,2,4,16,14,47,-33,10
Coleraine,7078,1,15,10,1,47,22,25,55
Crusaders,7078,2,16,6,4,61,31,30,54
Glenavon,7078,3,9,9,8,52,47,5,36
Linfield,7078,4,10,5,11,38,40,-2,35
Cliftonville,7078,5,10,4,12,36,32,4,34
Ballymena,7078,6,8,4,14,26,47,-21,28
Glentoran,7078,7,6,6,10,24,32,-8,24
Dungannon,7078,8,2,4,16,14,47,-33,10
Crusaders,7079,1,16,7,3,63,32,31,55
Coleraine,7079,2,14,10,2,44,24,20,52
Glenavon,7079,3,10,9,7,54,44,10,39
Linfield,7079,4,11,5,10,39,37,2,38
Cliftonville,7079,5,9,4,13,33,33,0,31
Ballymena,7079,6,7,5,14,27,49,-22,26
Glentoran,7079,7,6,6,10,24,32,-8,24
Dungannon,7079,8,2,4,16,14,47,-33,10
Crusaders,7080,1,16,6,4,63,33,30,54
Coleraine,7080,2,14,10,2,44,24,20,52
Glenavon,7080,3,10,9,7,54,44,10,39
Linfield,7080,4,10,5,11,38,38,0,35
Cliftonville,7080,5,10,4,12,34,32,2,34
Ballymena,7080,6,8,4,14,28,49,-21,28
Glentoran,7080,7,6,6,10,24,32,-8,24
Dungannon,7080,8,2,4,16,14,47,-33,10
Crusaders,7081,1,16,6,4,63,33,30,54
Coleraine,7081,2,14,11,1,44,23,21,53
Linfield,7081,3,11,5,10,41,37,4,38
Glenavon,7081,4,9,10,7,53,44,9,37
Cliftonville,7081,5,9,4,13,33,35,-2,31
Ballymena,7081,6,8,4,14,28,49,-21,28
Glentoran,7081,7,6,6,10,24,32,-8,24
Dungannon,7081,8,2,4,16,14,47,-33,10
Crusaders,7082,1,17,6,3,63,30,33,57
Coleraine,7082,2,14,11,1,45,24,21,53
Glenavon,7082,3,9,10,7,54,45,9,37
Linfield,7082,4,10,5,11,37,37,0,35
Cliftonville,7082,5,10,4,12,33,31,2,34
Ballymena,7082,6,7,4,15,25,49,-24,25
Glentoran,7082,7,6,6,10,24,32,-8,24
Dungannon,7082,8,2,4,16,14,47,-33,10
Crusaders,7083,1,17,6,3,63,30,33,57
Coleraine,7083,2,14,10,2,44,24,20,52
Glenavon,7083,3,10,9,7,54,44,10,39
Linfield,7083,4,10,5,11,38,38,0,35
Cliftonville,7083,5,10,4,12,34,32,2,34
Ballymena,7083,6,7,4,15,25,49,-24,25
Glentoran,7083,7,6,6,10,24,32,-8,24
Dungannon,7083,8,2,4,16,14,47,-33,10
Crusaders,7084,1,17,6,3,62,30,32,57
Coleraine,7084,2,14,10,2,44,24,20,52
Glenavon,7084,3,10,9,7,54,44,10,39
Linfield,7084,4,10,6,10,38,37,1,36
Cliftonville,7084,5,9,5,12,33,32,1,32
Ballymena,7084,6,7,4,15,25,48,-23,25
Glentoran,7084,7,6,6,10,24,32,-8,24
Dungannon,7084,8,2,4,16,14,47,-33,10
Crusaders,7085,1,17,6,3,62,30,32,57
Coleraine,7085,2,15,10,1,49,26,23,55
Glenavon,7085,3,9,9,8,56,49,7,36
Linfield,7085,4,10,6,10,40,39,1,36
Cliftonville,7085,5,9,5,12,35,34,1,32
Ballymena,7085,6,7,4,15,25,48,-23,25
Glentoran,7085,7,6,6,10,24,32,-8,24
Dungannon,7085,8,2,4,16,14,47,-33,10
Crusaders,7086,1,17,6,3,64,31,33,57
Coleraine,7086,2,14,11,1,43,22,21,53
Glenavon,7086,3,9,10,7,52,43,9,37
Linfield,7086,4,10,5,11,38,38,0,35
Cliftonville,7086,5,10,4,12,34,32,2,34
Ballymena,7086,6,7,4,15,26,50,-24,25
Glentoran,7086,7,6,6,10,24,32,-8,24
Dungannon,7086,8,2,4,16,14,47,-33,10
Crusaders,7087,1,17,6,3,64,30,34,57
Coleraine,7087,2,14,11,1,45,24,21,53
Linfield,7087,3,11,5,10,39,37,2,38
Glenavon,7087,4,9,10,7,54,45,9,37
Cliftonville,7087,5,9,4,13,33,33,0,31
Ballymena,7087,6,7,4,15,25,50,-25,25
Glentoran,7087,7,6,6,10,24,32,-8,24
Dungannon,7087,8,2,4,16,14,47,-33,10
Crusaders,7088,1,17,6,3,64,31,33,57
Coleraine,7088,2,15,10,1,45,23,22,55
Linfield,7088,3,11,5,10,40,36,4,38
Glenavon,7088,4,9,9,8,53,45,8,36
Cliftonville,7088,5,9,4,13,32,34,-2,31
Ballymena,7088,6,7,4,15,26,50,-24,25
Glentoran,7088,7,6,6,10,24,32,-8,24
Dungannon,7088,8,2,4,16,14,47,-33,10
Coleraine,7089,1,15,10,1,44,22,22,55
Crusaders,7089,2,16,6,4,62,32,30,54
Linfield,7089,3,11,5,10,39,36,3,38
Glenavon,7089,4,9,9,8,52,44,8,36
Cliftonville,7089,5,9,4,13,32,33,-1,31
Ballymena,7089,6,8,4,14,27,48,-21,28
Glentoran,7089,7,6,6,10,24,32,-8,24
Dungannon,7089,8,2,4,16,14,47,-33,10
Crusaders,7090,1,16,7,3,61,30,31,55
Coleraine,7090,2,15,10,1,46,24,22,55
Glenavon,7090,3,9,9,8,54,46,8,36
Linfield,7090,4,10,6,10,37,36,1,36
Cliftonville,7090,5,9,5,12,32,31,1,32
Ballymena,7090,6,7,5,14,25,47,-22,26
Glentoran,7090,7,6,6,10,24,32,-8,24
Dungannon,7090,8,2,4,16,14,47,-33,10
Crusaders,7091,1,17,6,3,63,31,32,57
Coleraine,7091,2,15,10,1,45,22,23,55
Linfield,7091,3,11,5,10,39,37,2,38
Glenavon,7091,4,9,9,8,52,45,7,36
Cliftonville,7091,5,9,4,13,33,33,0,31
Ballymena,7091,6,7,4,15,26,49,-23,25
Glentoran,7091,7,6,6,10,24,32,-8,24
Dungannon,7091,8,2,4,16,14,47,-33,10
Crusaders,7092,1,17,6,3,64,31,33,57
Coleraine,7092,2,14,11,1,45,24,21,53
Linfield,7092,3,11,5,10,39,36,3,38
Glenavon,7092,4,9,10,7,54,45,9,37
Cliftonville,7092,5,9,4,13,32,33,-1,31
Ballymena,7092,6,7,4,15,26,50,-24,25
Glentoran,7092,7,6,6,10,24,32,-8,24
Dungannon,7092,8,2,4,16,14,47,-33,10
Crusaders,7093,1,16,6,4,62,32,30,54
Coleraine,7093,2,14,10,2,45,26,19,52
Glenavon,7093,3,10,9,7,56,45,11,39
Linfield,7093,4,10,5,11,37,38,-1,35
Cliftonville,7093,5,10,4,12,34,31,3,34
Ballymena,7093,6,8,4,14,27,48,-21,28
Glentoran,7093,7,6,6,10,24,32,-8,24
Dungannon,7093,8,2,4,16,14,47,-33,10
Crusaders,7094,1,17,6,3,64,31,33,57
Coleraine,7094,2,14,11,1,44,23,21,53
Glenavon,7094,3,9,10,7,53,44,9,37
Linfield,7094,4,10,5,11,37,37,0,35
Cliftonville,7094,5,10,4,12,33,31,2,34
Ballymena,7094,6,7,4,15,26,50,-24,25
Glentoran,7094,7,6,6,10,24,32,-8,24
Dungannon,7094,8,2,4,16,14,47,-33,10
Crusaders,7095,1,17,6,3,63,31,32,57
Coleraine,7095,2,14,10,2,44,25,19,52
Glenavon,7095,3,10,9,7,55,44,11,39
Linfield,7095,4,10,6,10,38,37,1,36
Cliftonville,7095,5,9,5,12,33,32,1,32
Ballymena,7095,6,7,4,15,26,49,-23,25
Glentoran,7095,7,6,6,10,24,32,-8,24
Dungannon,7095,8,2,4,16,14,47,-33,10
Crusaders,7096,1,16,7,3,61,30,31,55
Coleraine,7096,2,15,10,1,45,23,22,55
Linfield,7096,3,11,5,10,39,37,2,38
Glenavon,7096,4,9,9,8,53,45,8,36
Cliftonville,7096,5,9,4,13,33,33,0,31
Ballymena,7096,6,7,5,14,25,47,-22,26
Glentoran,7096,7,6,6,10,24,32,-8,24
Dungannon,7096,8,2,4,16,14,47,-33,10
Crusaders,7097,1,17,6,3,63,31,32,57
Coleraine,7097,2,15,10,1,45,23,22,55
Glenavon,7097,3,9,9,8,53,45,8,36
Linfield,7097,4,10,6,10,38,37,1,36
Cliftonville,7097,5,9,5,12,33,32,1,32
Ballymena,7097,6,7,4,15,26,49,-23,25
Glentoran,7097,7,6,6,10,24,32,-8,24
Dungannon,7097,8,2,4,16,14,47,-33,10
Coleraine,7098,1,15,10,1,45,23,22,55
Crusaders,7098,2,16,6,4,61,31,30,54
Glenavon,7098,3,9,9,8,53,45,8,36
Linfield,7098,4,10,6,10,38,37,1,36
Cliftonville,7098,5,9,5,12,33,32,1,32
Ballymena,7098,6,8,4,14,26,47,-21,28
Glentoran,7098,7,6,6,10,24,32,-8,24
Dungannon,7098,8,2,4,16,14,47,-33,10
Crusaders,7099,1,17,6,3,63,31,32,57
Coleraine,7099,2,14,10,2,43,23,20,52
Glenavon,7099,3,10,9,7,53,43,10,39
Linfield,7099,4,11,5,10,39,36,3,38
Cliftonville,7099,5,9,4,13,32,33,-1,31
Ballymena,7099,6,7,4,15,26,49,-23,25
Glentoran,7099,7,6,6,10,24,32,-8,24
Dungannon,7099,8,2,4,16,14,47,-33,10
Crusaders,7100,1,16,7,3,62,31,31,55
Coleraine,7100,2,15,10,1,44,22,22,55
Linfield,7100,3,11,5,10,38,36,2,38
Glenavon,7100,4,9,9,8,52,44,8,36
Cliftonville,7100,5,9,4,13,32,32,0,31
Ballymena,7100,6,7,5,14,26,48,-22,26
Glentoran,7100,7,6,6,10,24,32,-8,24
Dungannon,7100,8,2,4,16,14,47,-33,10
Crusaders,7101,1,17,6,3,63,31,32,57
Coleraine,7101,2,15,10,1,45,22,23,55
Glenavon,7101,3,9,9,8,52,45,7,36
Linfield,7101,4,10,6,10,38,37,1,36
Cliftonville,7101,5,9,5,12,33,32,1,32
Ballymena,7101,6,7,4,15,26,49,-23,25
Glentoran,7101,7,6,6,10,24,32,-8,24
Dungannon,7101,8,2,4,16,14,47,-33,10
Crusaders,7102,1,16,6,4,62,32,30,54
Coleraine,7102,2,14,11,1,44,23,21,53
Linfield,7102,3,11,5,10,40,37,3,38
Glenavon,7102,4,9,10,7,53,44,9,37
Cliftonville,7102,5,9,4,13,33,34,-1,31
Ballymena,7102,6,8,4,14,27,48,-21,28
Glentoran,7102,7,6,6,10,24,32,-8,24
Dungannon,7102,8,2,4,16,14,47,-33,10
Coleraine,7103,1,15,10,1,45,23,22,55
Crusaders,7103,2,16,6,4,61,32,29,54
Linfield,7103,3,11,5,10,39,36,3,38
Glenavon,7103,4,9,9,8,53,45,8,36
Cliftonville,7103,5,9,4,13,32,33,-1,31
Ballymena,7103,6,8,4,14,27,47,-20,28
Glentoran,7103,7,6,6,10,24,32,-8,24
Dungannon,7103,8,2,4,16,14,47,-33,10
Crusaders,7104,1,16,6,4,63,34,29,54
Coleraine,7104,2,14,10,2,44,26,18,52
Glenavon,7104,3,10,9,7,56,44,12,39
Linfield,7104,4,11,5,10,38,36,2,38
Cliftonville,7104,5,9,4,13,32,32,0,31
Ballymena,7104,6,8,4,14,29,49,-20,28
Glentoran,7104,7,6,6,10,24,32,-8,24
Dungannon,7104,8,2,4,16,14,47,-33,10
Coleraine,7105,1,15,10,1,46,22,24,55
Crusaders,7105,2,16,6,4,61,31,30,54
Glenavon,7105,3,9,9,8,52,46,6,36
Linfield,7105,4,10,6,10,38,37,1,36
Cliftonville,7105,5,9,5,12,33,32,1,32
Ballymena,7105,6,8,4,14,26,47,-21,28
Glentoran,7105,7,6,6,10,24,32,-8,24
Dungannon,7105,8,2,4,16,14,47,-33,10
Crusaders,7106,1,16,6,4,61,31,30,54
Coleraine,7106,2,14,11,1,44,23,21,53
Glenavon,7106,3,9,10,7,53,44,9,37
Linfield,7106,4,10,5,11,38,38,0,35
Cliftonville,7106,5,10,4,12,34,32,2,34
Ballymena,7106,6,8,4,14,26,47,-21,28
Glentoran,7106,7,6,6,10,24,32,-8,24
Dungannon,7106,8,2,4,16,14,47,-33,10
Crusaders,7107,1,17,6,3,63,31,32,57
Coleraine,7107,2,15,10,1,44,22,22,55
Glenavon,7107,3,9,9,8,52,44,8,36
Linfield,7107,4,10,5,11,39,41,-2,35
Cliftonville,7107,5,10,4,12,37,33,4,34
Ballymena,7107,6,7,4,15,26,49,-23,25
Glentoran,7107,7,6,6,10,24,32,-8,24
Dungannon,7107,8,2,4,16,14,47,-33,10
Crusaders,7108,1,17,6,3,64,31,33,57
Coleraine,7108,2,14,10,2,44,25,19,52
Glenavon,7108,3,10,9,7,55,44,11,39
Linfield,7108,4,10,5,11,37,37,0,35
Cliftonville,7108,5,10,4,12,33,31,2,34
Ballymena,7108,6,7,4,15,26,50,-24,25
Glentoran,7108,7,6,6,10,24,32,-8,24
Dungannon,7108,8,2,4,16,14,47,-33,10
Crusaders,7109,1,16,7,3,63,32,31,55
Coleraine,7109,2,15,10,1,45,23,22,55
Linfield,7109,3,11,5,10,39,37,2,38
Glenavon,7109,4,9,9,8,53,45,8,36
Cliftonville,7109,5,9,4,13,33,33,0,31
Ballymena,7109,6,7,5,14,27,49,-22,26
Glentoran,7109,7,6,6,10,24,32,-8,24
Dungannon,7109,8,2,4,16,14,47,-33,10
Crusaders,7110,1,17,6,3,63,30,33,57
Coleraine,7110,2,15,10,1,46,24,22,55
Glenavon,7110,3,9,9,8,54,46,8,36
Linfield,7110,4,10,5,11,38,38,0,35
Cliftonville,7110,5,10,4,12,34,32,2,34
Ballymena,7110,6,7,4,15,25,49,-24,25
Glentoran,7110,7,6,6,10,24,32,-8,24
Dungannon,7110,8,2,4,16,14,47,-33,10
Coleraine,7111,1,15,10,1,46,24,22,55
Crusaders,7111,2,16,6,4,63,33,30,54
Linfield,7111,3,11,5,10,39,37,2,38
Glenavon,7111,4,9,9,8,54,46,8,36
Cliftonville,7111,5,9,4,13,33,33,0,31
Ballymena,7111,6,8,4,14,28,49,-21,28
Glentoran,7111,7,6,6,10,24,32,-8,24
Dungannon,7111,8,2,4,16,14,47,-33,10
Crusaders,7112,1,17,6,3,64,32,32,57
Coleraine,7112,2,14,10,2,45,25,20,52
Glenavon,7112,3,10,9,7,55,45,10,39
Linfield,7112,4,10,6,10,38,37,1,36
Cliftonville,7112,5,9,5,12,33,32,1,32
Ballymena,7112,6,7,4,15,27,50,-23,25
Glentoran,7112,7,6,6,10,24,32,-8,24
Dungannon,7112,8,2,4,16,14,47,-33,10
Crusaders,7113,1,16,7,3,63,32,31,55
Coleraine,7113,2,15,10,1,47,22,25,55
Glenavon,7113,3,9,9,8,52,47,5,36
Linfield,7113,4,10,6,10,39,38,1,36
Cliftonville,7113,5,9,5,12,34,33,1,32
Ballymena,7113,6,7,5,14,27,49,-22,26
Glentoran,7113,7,6,6,10,24,32,-8,24
Dungannon,7113,8,2,4,16,14,47,-33,10
Crusaders,7114,1,17,6,3,64,30,34,57
Coleraine,7114,2,14,10,2,44,25,19,52
Glenavon,7114,3,10,9,7,55,44,11,39
Linfield,7114,4,11,5,10,39,36,3,38
Cliftonville,7114,5,9,4,13,32,33,-1,31
Ballymena,7114,6,7,4,15,25,50,-25,25
Glentoran,7114,7,6,6,10,24,32,-8,24
Dungannon,7114,8,2,4,16,14,47,-33,10
Crusaders,7115,1,17,6,3,63,31,32,57
Coleraine,7115,2,15,10,1,44,22,22,55
Glenavon,7115,3,9,9,8,52,44,8,36
Linfield,7115,4,10,5,11,37,38,-1,35
Cliftonville,7115,5,10,4,12,34,31,3,34
Ballymena,7115,6,7,4,15,26,49,-23,25
Glentoran,7115,7,6,6,10,24,32,-8,24
Dungannon,7115,8,2,4,16,14,47,-33,10
Crusaders,7116,1,16,7,3,62,31,31,55
Coleraine,7116,2,15,10,1,45,23,22,55
Linfield,7116,3,11,5,10,40,36,4,38
Glenavon,7116,4,9,9,8,53,45,8,36
Cliftonville,7116,5,9,4,13,32,34,-2,31
Ballymena,7116,6,7,5,14,26,48,-22,26
Glentoran,7116,7,6,6,10,24,32,-8,24
Dungannon,7116,8,2,4,16,14,47,-33,10
Crusaders,7117,1,17,6,3,62,30,32,57
Coleraine,7117,2,15,10,1,45,22,23,55
Linfield,7117,3,11,5,10,40,37,3,38
Glenavon,7117,4,9,9,8,52,45,7,36
Cliftonville,7117,5,9,4,13,33,34,-1,31
Ballymena,7117,6,7,4,15,25,48,-23,25
Glentoran,7117,7,6,6,10,24,32,-8,24
Dungannon,7117,8,2,4,16,14,47,-33,10
Crusaders,7118,1,16,7,3,63,32,31,55
Coleraine,7118,2,14,10,2,44,27,17,52
Glenavon,7118,3,10,9,7,57,44,13,39
Linfield,7118,4,10,6,10,39,38,1,36
Cliftonville,7118,5,9,5,12,34,33,1,32
Ballymena,7118,6,7,5,14,27,49,-22,26
Glentoran,7118,7,6,6,10,24,32,-8,24
Dungannon,7118,8,2,4,16,14,47,-33,10
Crusaders,7119,1,16,6,4,61,32,29,54
Coleraine,7119,2,14,10,2,44,26,18,52
Glenavon,7119,3,10,9,7,56,44,12,39
Linfield,7119,4,11,5,10,40,36,4,38
Cliftonville,7119,5,9,4,13,32,34,-2,31
Ballymena,7119,6,8,4,14,27,47,-20,28
Glentoran,7119,7,6,6,10,24,32,-8,24
Dungannon,7119,8,2,4,16,14,47,-33,10
Crusaders,7120,1,17,6,3,64,32,32,57
Coleraine,7120,2,14,11,1,43,22,21,53
Linfield,7120,3,11,5,10,38,36,2,38
Glenavon,7120,4,9,10,7,52,43,9,37
Cliftonville,7120,5,9,4,13,32,32,0,31
Ballymena,7120,6,7,4,15,27,50,-23,25
Glentoran,7120,7,6,6,10,24,32,-8,24
Dungannon,7120,8,2,4,16,14,47,-33,10
Crusaders,7121,1,16,6,4,64,34,30,54
Coleraine,7121,2,14,10,2,44,24,20,52
Glenavon,7121,3,10,9,7,54,44,10,39
Linfield,7121,4,11,5,10,38,36,2,38
Cliftonville,7121,5,9,4,13,32,32,0,31
Ballymena,7121,6,8,4,14,29,50,-21,28
Glentoran,7121,7,6,6,10,24,32,-8,24
Dungannon,7121,8,2,4,16,14,47,-33,10
Crusaders,7122,1,17,6,3,62,30,32,57
Coleraine,7122,2,14,10,2,44,24,20,52
Glenavon,7122,3,10,9,7,54,44,10,39
Linfield,7122,4,11,5,10,39,37,2,38
Cliftonville,7122,5,9,4,13,33,33,0,31
Ballymena,7122,6,7,4,15,25,48,-23,25
Glentoran,7122,7,6,6,10,24,32,-8,24
Dungannon,7122,8,2,4,16,14,47,-33,10
Crusaders,7123,1,16,7,3,62,31,31,55
Coleraine,7123,2,14,11,1,45,24,21,53
Linfield,7123,3,11,5,10,39,37,2,38
Glenavon,7123,4,9,10,7,54,45,9,37
Cliftonville,7123,5,9,4,13,33,33,0,31
Ballymena,7123,6,7,5,14,26,48,-22,26
Glentoran,7123,7,6,6,10,24,32,-8,24
Dungannon,7123,8,2,4,16,14,47,-33,10
Crusaders,7124,1,17,6,3,63,30,33,57
Coleraine,7124,2,14,10,2,43,26,17,52
Glenavon,7124,3,10,9,7,56,43,13,39
Linfield,7124,4,10,5,11,37,39,-2,35
Cliftonville,7124,5,10,4,12,35,31,4,34
Ballymena,7124,6,7,4,15,25,49,-24,25
Glentoran,7124,7,6,6,10,24,32,-8,24
Dungannon,7124,8,2,4,16,14,47,-33,10
Crusaders,7125,1,17,6,3,62,30,32,57
Coleraine,7125,2,14,10,2,43,24,19,52
Glenavon,7125,3,10,9,7,54,43,11,39
Linfield,7125,4,10,5,11,38,38,0,35
Cliftonville,7125,5,10,4,12,34,32,2,34
Ballymena,7125,6,7,4,15,25,48,-23,25
Glentoran,7125,7,6,6,10,24,32,-8,24
Dungannon,7125,8,2,4,16,14,47,-33,10
Crusaders,7126,1,17,6,3,64,32,32,57
Coleraine,7126,2,14,10,2,45,25,20,52
Glenavon,7126,3,10,9,7,55,45,10,39
Linfield,7126,4,10,6,10,38,37,1,36
Cliftonville,7126,5,9,5,12,33,32,1,32
Ballymena,7126,6,7,4,15,27,50,-23,25
Glentoran,7126,7,6,6,10,24,32,-8,24
Dungannon,7126,8,2,4,16,14,47,-33,10
Crusaders,7127,1,16,6,4,61,31,30,54
Coleraine,7127,2,14,11,1,43,22,21,53
Linfield,7127,3,11,5,10,39,36,3,38
Glenavon,7127,4,9,10,7,52,43,9,37
Cliftonville,7127,5,9,4,13,32,33,-1,31
Ballymena,7127,6,8,4,14,26,47,-21,28
Glentoran,7127,7,6,6,10,24,32,-8,24
Dungannon,7127,8,2,4,16,14,47,-33,10
Crusaders,7128,1,17,6,3,68,30,38,57
Coleraine,7128,2,14,11,1,45,24,21,53
Linfield,7128,3,11,5,10,39,37,2,38
Glenavon,7128,4,9,10,7,54,45,9,37
Cliftonville,7128,5,9,4,13,33,33,0,31
Ballymena,7128,6,7,4,15,25,54,-29,25
Glentoran,7128,7,6,6,10,24,32,-8,24
Dungannon,7128,8,2,4,16,14,47,-33,10
Crusaders,7129,1,16,7,3,62,31,31,55
Coleraine,7129,2,14,10,2,43,26,17,52
Glenavon,7129,3,10,9,7,56,43,13,39
Linfield,7129,4,11,5,10,41,37,4,38
Cliftonville,7129,5,9,4,13,33,35,-2,31
Ballymena,7129,6,7,5,14,26,48,-22,26
Glentoran,7129,7,6,6,10,24,32,-8,24
Dungannon,7129,8,2,4,16,14,47,-33,10
Crusaders,7130,1,16,7,3,62,31,31,55
Coleraine,7130,2,15,10,1,47,23,24,55
Linfield,7130,3,11,5,10,39,37,2,38
Glenavon,7130,4,9,9,8,53,47,6,36
Cliftonville,7130,5,9,4,13,33,33,0,31
Ballymena,7130,6,7,5,14,26,48,-22,26
Glentoran,7130,7,6,6,10,24,32,-8,24
Dungannon,7130,8,2,4,16,14,47,-33,10
Crusaders,7131,1,16,6,4,63,33,30,54
Coleraine,7131,2,14,10,2,44,24,20,52
Glenavon,7131,3,10,9,7,54,44,10,39
Linfield,7131,4,10,5,11,37,37,0,35
Cliftonville,7131,5,10,4,12,33,31,2,34
Ballymena,7131,6,8,4,14,28,49,-21,28
Glentoran,7131,7,6,6,10,24,32,-8,24
Dungannon,7131,8,2,4,16,14,47,-33,10
Crusaders,7132,1,16,7,3,62,31,31,55
Coleraine,7132,2,14,10,2,43,23,20,52
Glenavon,7132,3,10,9,7,53,43,10,39
Linfield,7132,4,10,5,11,37,38,-1,35
Cliftonville,7132,5,10,4,12,34,31,3,34
Ballymena,7132,6,7,5,14,26,48,-22,26
Glentoran,7132,7,6,6,10,24,32,-8,24
Dungannon,7132,8,2,4,16,14,47,-33,10
Crusaders,7133,1,17,6,3,65,31,34,57
Coleraine,7133,2,15,10,1,48,25,23,55
Glenavon,7133,3,9,9,8,55,48,7,36
Linfield,7133,4,10,6,10,39,38,1,36
Cliftonville,7133,5,9,5,12,34,33,1,32
Ballymena,7133,6,7,4,15,26,51,-25,25
Glentoran,7133,7,6,6,10,24,32,-8,24
Dungannon,7133,8,2,4,16,14,47,-33,10
Crusaders,7134,1,17,6,3,64,31,33,57
Coleraine,7134,2,14,10,2,43,23,20,52
Glenavon,7134,3,10,9,7,53,43,10,39
Linfield,7134,4,11,5,10,38,36,2,38
Cliftonville,7134,5,9,4,13,32,32,0,31
Ballymena,7134,6,7,4,15,26,50,-24,25
Glentoran,7134,7,6,6,10,24,32,-8,24
Dungannon,7134,8,2,4,16,14,47,-33,10
Crusaders,7135,1,16,6,4,61,33,28,54
Coleraine,7135,2,14,11,1,46,25,21,53
Linfield,7135,3,11,5,10,41,39,2,38
Glenavon,7135,4,9,10,7,55,46,9,37
Cliftonville,7135,5,9,4,13,35,35,0,31
Ballymena,7135,6,8,4,14,28,47,-19,28
Glentoran,7135,7,6,6,10,24,32,-8,24
Dungannon,7135,8,2,4,16,14,47,-33,10
Crusaders,7136,1,17,6,3,66,31,35,57
Coleraine,7136,2,14,11,1,44,23,21,53
Glenavon,7136,3,9,10,7,53,44,9,37
Linfield,7136,4,10,5,11,39,39,0,35
Cliftonville,7136,5,10,4,12,35,33,2,34
Ballymena,7136,6,7,4,15,26,52,-26,25
Glentoran,7136,7,6,6,10,24,32,-8,24
Dungannon,7136,8,2,4,16,14,47,-33,10
Crusaders,7137,1,16,7,3,62,31,31,55
Coleraine,7137,2,15,10,1,44,22,22,55
Linfield,7137,3,11,5,10,38,36,2,38
Glenavon,7137,4,9,9,8,52,44,8,36
Cliftonville,7137,5,9,4,13,32,32,0,31
Ballymena,7137,6,7,5,14,26,48,-22,26
Glentoran,7137,7,6,6,10,24,32,-8,24
Dungannon,7137,8,2,4,16,14,47,-33,10
Crusaders,7138,1,16,6,4,61,32,29,54
Coleraine,7138,2,14,11,1,44,23,21,53
Linfield,7138,3,11,5,10,38,36,2,38
Glenavon,7138,4,9,10,7,53,44,9,37
Cliftonville,7138,5,9,4,13,32,32,0,31
Ballymena,7138,6,8,4,14,27,47,-20,28
Glentoran,7138,7,6,6,10,24,32,-8,24
Dungannon,7138,8,2,4,16,14,47,-33,10
Crusaders,7139,1,16,7,3,63,32,31,55
Coleraine,7139,2,15,10,1,44,22,22,55
Glenavon,7139,3,9,9,8,52,44,8,36
Linfield,7139,4,10,5,11,38,38,0,35
Cliftonville,7139,5,10,4,12,34,32,2,34
Ballymena,7139,6,7,5,14,27,49,-22,26
Glentoran,7139,7,6,6,10,24,32,-8,24
Dungannon,7139,8,2,4,16,14,47,-33,10
Crusaders,7140,1,16,7,3,62,31,31,55
Coleraine,7140,2,14,10,2,44,24,20,52
Glenavon,7140,3,10,9,7,54,44,10,39
Linfield,7140,4,11,5,10,43,36,7,38
Cliftonville,7140,5,9,4,13,32,37,-5,31
Ballymena,7140,6,7,5,14,26,48,-22,26
Glentoran,7140,7,6,6,10,24,32,-8,24
Dungannon,7140,8,2,4,16,14,47,-33,10
Crusaders,7141,1,16,7,3,62,31,31,55
Coleraine,7141,2,15,10,1,45,23,22,55
Glenavon,7141,3,9,9,8,53,45,8,36
Linfield,7141,4,10,6,10,37,36,1,36
Cliftonville,7141,5,9,5,12,32,31,1,32
Ballymena,7141,6,7,5,14,26,48,-22,26
Glentoran,7141,7,6,6,10,24,32,-8,24
Dungannon,7141,8,2,4,16,14,47,-33,10
Crusaders,7142,1,16,7,3,62,31,31,55
Coleraine,7142,2,15,10,1,44,22,22,55
Linfield,7142,3,11,5,10,41,36,5,38
Glenavon,7142,4,9,9,8,52,44,8,36
Cliftonville,7142,5,9,4,13,32,35,-3,31
Ballymena,7142,6,7,5,14,26,48,-22,26
Glentoran,7142,7,6,6,10,24,32,-8,24
Dungannon,7142,8,2,4,16,14,47,-33,10
Coleraine,7143,1,15,10,1,45,22,23,55
Crusaders,7143,2,16,6,4,61,31,30,54
Linfield,7143,3,11,5,10,39,36,3,38
Glenavon,7143,4,9,9,8,52,45,7,36
Cliftonville,7143,5,9,4,13,32,33,-1,31
Ballymena,7143,6,8,4,14,26,47,-21,28
Glentoran,7143,7,6,6,10,24,32,-8,24
Dungannon,7143,8,2,4,16,14,47,-33,10
Crusaders,7144,1,16,6,4,63,33,30,54
Coleraine,7144,2,14,10,2,45,25,20,52
Glenavon,7144,3,10,9,7,55,45,10,39
Linfield,7144,4,10,5,11,37,37,0,35
Cliftonville,7144,5,10,4,12,33,31,2,34
Ballymena,7144,6,8,4,14,28,49,-21,28
Glentoran,7144,7,6,6,10,24,32,-8,24
Dungannon,7144,8,2,4,16,14,47,-33,10
Crusaders,7145,1,17,6,3,63,30,33,57
Coleraine,7145,2,14,10,2,43,26,17,52
Glenavon,7145,3,10,9,7,56,43,13,39
Linfield,7145,4,11,5,10,41,36,5,38
Cliftonville,7145,5,9,4,13,32,35,-3,31
Ballymena,7145,6,7,4,15,25,49,-24,25
Glentoran,7145,7,6,6,10,24,32,-8,24
Dungannon,7145,8,2,4,16,14,47,-33,10
Crusaders,7146,1,17,6,3,64,31,33,57
Coleraine,7146,2,14,11,1,45,24,21,53
Linfield,7146,3,11,5,10,40,36,4,38
Glenavon,7146,4,9,10,7,54,45,9,37
Cliftonville,7146,5,9,4,13,32,34,-2,31
Ballymena,7146,6,7,4,15,26,50,-24,25
Glentoran,7146,7,6,6,10,24,32,-8,24
Dungannon,7146,8,2,4,16,14,47,-33,10
Crusaders,7147,1,17,6,3,62,30,32,57
Coleraine,7147,2,15,10,1,47,22,25,55
Glenavon,7147,3,9,9,8,52,47,5,36
Linfield,7147,4,10,5,11,37,38,-1,35
Cliftonville,7147,5,10,4,12,34,31,3,34
Ballymena,7147,6,7,4,15,25,48,-23,25
Glentoran,7147,7,6,6,10,24,32,-8,24
Dungannon,7147,8,2,4,16,14,47,-33,10
Crusaders,7148,1,17,6,3,65,30,35,57
Coleraine,7148,2,15,10,1,47,22,25,55
Linfield,7148,3,11,5,10,39,36,3,38
Glenavon,7148,4,9,9,8,52,47,5,36
Cliftonville,7148,5,9,4,13,32,33,-1,31
Ballymena,7148,6,7,4,15,25,51,-26,25
Glentoran,7148,7,6,6,10,24,32,-8,24
Dungannon,7148,8,2,4,16,14,47,-33,10
Coleraine,7149,1,15,10,1,47,24,23,55
Crusaders,7149,2,16,6,4,61,34,27,54
Glenavon,7149,3,9,9,8,54,47,7,36
Linfield,7149,4,10,6,10,38,37,1,36
Cliftonville,7149,5,9,5,12,33,32,1,32
Ballymena,7149,6,8,4,14,29,47,-18,28
Glentoran,7149,7,6,6,10,24,32,-8,24
Dungannon,7149,8,2,4,16,14,47,-33,10
Coleraine,7150,1,15,10,1,45,22,23,55
Crusaders,7150,2,16,6,4,62,32,30,54
Linfield,7150,3,11,5,10,38,36,2,38
Glenavon,7150,4,9,9,8,52,45,7,36
Cliftonville,7150,5,9,4,13,32,32,0,31
Ballymena,7150,6,8,4,14,27,48,-21,28
Glentoran,7150,7,6,6,10,24,32,-8,24
Dungannon,7150,8,2,4,16,14,47,-33,10
Crusaders,7151,1,16,7,3,62,31,31,55
Coleraine,7151,2,14,10,2,45,25,20,52
Glenavon,7151,3,10,9,7,55,45,10,39
Linfield,7151,4,11,5,10,40,36,4,38
Cliftonville,7151,5,9,4,13,32,34,-2,31
Ballymena,7151,6,7,5,14,26,48,-22,26
Glentoran,7151,7,6,6,10,24,32,-8,24
Dungannon,7151,8,2,4,16,14,47,-33,10
Crusaders,7152,1,17,6,3,64,30,34,57
Coleraine,7152,2,15,10,1,45,22,23,55
Linfield,7152,3,11,5,10,39,36,3,38
Glenavon,7152,4,9,9,8,52,45,7,36
Cliftonville,7152,5,9,4,13,32,33,-1,31
Ballymena,7152,6,7,4,15,25,50,-25,25
Glentoran,7152,7,6,6,10,24,32,-8,24
Dungannon,7152,8,2,4,16,14,47,-33,10
Crusaders,7153,1,17,6,3,63,31,32,57
Coleraine,7153,2,14,11,1,44,23,21,53
Glenavon,7153,3,9,10,7,53,44,9,37
Linfield,7153,4,10,6,10,39,38,1,36
Cliftonville,7153,5,9,5,12,34,33,1,32
Ballymena,7153,6,7,4,15,26,49,-23,25
Glentoran,7153,7,6,6,10,24,32,-8,24
Dungannon,7153,8,2,4,16,14,47,-33,10
Crusaders,7154,1,17,6,3,64,32,32,57
Coleraine,7154,2,14,10,2,44,24,20,52
Glenavon,7154,3,10,9,7,54,44,10,39
Linfield,7154,4,10,5,11,37,38,-1,35
Cliftonville,7154,5,10,4,12,34,31,3,34
Ballymena,7154,6,7,4,15,27,50,-23,25
Glentoran,7154,7,6,6,10,24,32,-8,24
Dungannon,7154,8,2,4,16,14,47,-33,10
Crusaders,7155,1,17,6,3,66,31,35,57
Coleraine,7155,2,15,10,1,47,23,24,55
Linfield,7155,3,11,5,10,39,36,3,38
Glenavon,7155,4,9,9,8,53,47,6,36
Cliftonville,7155,5,9,4,13,32,33,-1,31
Ballymena,7155,6,7,4,15,26,52,-26,25
Glentoran,7155,7,6,6,10,24,32,-8,24
Dungannon,7155,8,2,4,16,14,47,-33,10
Crusaders,7156,1,16,7,3,63,32,31,55
Coleraine,7156,2,14,10,2,43,24,19,52
Glenavon,7156,3,10,9,7,54,43,11,39
Linfield,7156,4,11,5,10,41,36,5,38
Cliftonville,7156,5,9,4,13,32,35,-3,31
Ballymena,7156,6,7,5,14,27,49,-22,26
Glentoran,7156,7,6,6,10,24,32,-8,24
Dungannon,7156,8,2,4,16,14,47,-33,10
Crusaders,7157,1,16,7,3,62,31,31,55
Coleraine,7157,2,15,10,1,47,24,23,55
Linfield,7157,3,11,5,10,41,38,3,38
Glenavon,7157,4,9,9,8,54,47,7,36
Cliftonville,7157,5,9,4,13,34,35,-1,31
Ballymena,7157,6,7,5,14,26,48,-22,26
Glentoran,7157,7,6,6,10,24,32,-8,24
Dungannon,7157,8,2,4,16,14,47,-33,10
Crusaders,7158,1,17,6,3,63,30,33,57
Coleraine,7158,2,15,10,1,46,22,24,55
Glenavon,7158,3,9,9,8,52,46,6,36
Linfield,7158,4,10,6,10,38,37,1,36
Cliftonville,7158,5,9,5,12,33,32,1,32
Ballymena,7158,6,7,4,15,25,49,-24,25
Glentoran,7158,7,6,6,10,24,32,-8,24
Dungannon,7158,8,2,4,16,14,47,-33,10
Crusaders,7159,1,16,7,3,64,33,31,55
Coleraine,7159,2,14,10,2,44,24,20,52
Glenavon,7159,3,10,9,7,54,44,10,39
Linfield,7159,4,11,5,10,41,36,5,38
Cliftonville,7159,5,9,4,13,32,35,-3,31
Ballymena,7159,6,7,5,14,28,50,-22,26
Glentoran,7159,7,6,6,10,24,32,-8,24
Dungannon,7159,8,2,4,16,14,47,-33,10
Crusaders,7160,1,17,6,3,64,31,33,57
Coleraine,7160,2,15,10,1,46,24,22,55
Linfield,7160,3,11,5,10,40,36,4,38
Glenavon,7160,4,9,9,8,54,46,8,36
Cliftonville,7160,5,9,4,13,32,34,-2,31
Ballymena,7160,6,7,4,15,26,50,-24,25
Glentoran,7160,7,6,6,10,24,32,-8,24
Dungannon,7160,8,2,4,16,14,47,-33,10
Crusaders,7161,1,17,6,3,64,30,34,57
Coleraine,7161,2,14,11,1,45,24,21,53
Glenavon,7161,3,9,10,7,54,45,9,37
Linfield,7161,4,10,5,11,38,39,-1,35
Cliftonville,7161,5,10,4,12,35,32,3,34
Ballymena,7161,6,7,4,15,25,50,-25,25
Glentoran,7161,7,6,6,10,24,32,-8,24
Dungannon,7161,8,2,4,16,14,47,-33,10
Coleraine,7162,1,15,10,1,44,22,22,55
Crusaders,7162,2,16,6,4,62,33,29,54
Glenavon,7162,3,9,9,8,52,44,8,36
Linfield,7162,4,10,5,11,38,38,0,35
Cliftonville,7162,5,10,4,12,34,32,2,34
Ballymena,7162,6,8,4,14,28,48,-20,28
Glentoran,7162,7,6,6,10,24,32,-8,24
Dungannon,7162,8,2,4,16,14,47,-33,10
Crusaders,7163,1,16,7,3,64,33,31,55
Coleraine,7163,2,15,10,1,45,23,22,55
Linfield,7163,3,11,5,10,39,36,3,38
Glenavon,7163,4,9,9,8,53,45,8,36
Cliftonville,7163,5,9,4,13,32,33,-1,31
Ballymena,7163,6,7,5,14,28,50,-22,26
Glentoran,7163,7,6,6,10,24,32,-8,24
Dungannon,7163,8,2,4,16,14,47,-33,10
Crusaders,7164,1,17,6,3,65,30,35,57
Coleraine,7164,2,14,10,2,43,25,18,52
Glenavon,7164,3,10,9,7,55,43,12,39
Linfield,7164,4,10,5,11,37,37,0,35
Cliftonville,7164,5,10,4,12,33,31,2,34
Ballymena,7164,6,7,4,15,25,51,-26,25
Glentoran,7164,7,6,6,10,24,32,-8,24
Dungannon,7164,8,2,4,16,14,47,-33,10
Crusaders,7165,1,16,6,4,62,33,29,54
Coleraine,7165,2,14,10,2,44,26,18,52
Glenavon,7165,3,10,9,7,56,44,12,39
Linfield,7165,4,11,5,10,38,36,2,38
Cliftonville,7165,5,9,4,13,32,32,0,31
Ballymena,7165,6,8,4,14,28,48,-20,28
Glentoran,7165,7,6,6,10,24,32,-8,24
Dungannon,7165,8,2,4,16,14,47,-33,10
Crusaders,7166,1,17,6,3,63,31,32,57
Coleraine,7166,2,14,10,2,45,26,19,52
Glenavon,7166,3,10,9,7,56,45,11,39
Linfield,7166,4,11,5,10,39,36,3,38
Cliftonville,7166,5,9,4,13,32,33,-1,31
Ballymena,7166,6,7,4,15,26,49,-23,25
Glentoran,7166,7,6,6,10,24,32,-8,24
Dungannon,7166,8,2,4,16,14,47,-33,10
Crusaders,7167,1,17,6,3,62,30,32,57
Coleraine,7167,2,15,10,1,46,23,23,55
Glenavon,7167,3,9,9,8,53,46,7,36
Linfield,7167,4,10,6,10,37,36,1,36
Cliftonville,7167,5,9,5,12,32,31,1,32
Ballymena,7167,6,7,4,15,25,48,-23,25
Glentoran,7167,7,6,6,10,24,32,-8,24
Dungannon,7167,8,2,4,16,14,47,-33,10
Crusaders,7168,1,17,6,3,63,30,33,57
Coleraine,7168,2,14,10,2,45,26,19,52
Glenavon,7168,3,10,9,7,56,45,11,39
Linfield,7168,4,10,6,10,39,38,1,36
Cliftonville,7168,5,9,5,12,34,33,1,32
Ballymena,7168,6,7,4,15,25,49,-24,25
Glentoran,7168,7,6,6,10,24,32,-8,24
Dungannon,7168,8,2,4,16,14,47,-33,10
Coleraine,7169,1,15,10,1,45,23,22,55
Crusaders,7169,2,16,6,4,62,33,29,54
Linfield,7169,3,11,5,10,39,36,3,38
Glenavon,7169,4,9,9,8,53,45,8,36
Cliftonville,7169,5,9,4,13,32,33,-1,31
Ballymena,7169,6,8,4,14,28,48,-20,28
Glentoran,7169,7,6,6,10,24,32,-8,24
Dungannon,7169,8,2,4,16,14,47,-33,10
Crusaders,7170,1,17,6,3,64,30,34,57
Coleraine,7170,2,15,10,1,46,24,22,55
Glenavon,7170,3,9,9,8,54,46,8,36
Linfield,7170,4,10,5,11,38,38,0,35
Cliftonville,7170,5,10,4,12,34,32,2,34
Ballymena,7170,6,7,4,15,25,50,-25,25
Glentoran,7170,7,6,6,10,24,32,-8,24
Dungannon,7170,8,2,4,16,14,47,-33,10
Crusaders,7171,1,17,6,3,64,31,33,57
Coleraine,7171,2,14,10,2,43,25,18,52
Glenavon,7171,3,10,9,7,55,43,12,39
Linfield,7171,4,10,5,11,37,37,0,35
Cliftonville,7171,5,10,4,12,33,31,2,34
Ballymena,7171,6,7,4,15,26,50,-24,25
Glentoran,7171,7,6,6,10,24,32,-8,24
Dungannon,7171,8,2,4,16,14,47,-33,10
Crusaders,7172,1,17,6,3,64,31,33,57
Coleraine,7172,2,14,11,1,44,23,21,53
Glenavon,7172,3,9,10,7,53,44,9,37
Linfield,7172,4,10,6,10,38,37,1,36
Cliftonville,7172,5,9,5,12,33,32,1,32
Ballymena,7172,6,7,4,15,26,50,-24,25
Glentoran,7172,7,6,6,10,24,32,-8,24
Dungannon,7172,8,2,4,16,14,47,-33,10
Crusaders,7173,1,16,7,3,61,30,31,55
Coleraine,7173,2,14,10,2,45,25,20,52
Glenavon,7173,3,10,9,7,55,45,10,39
Linfield,7173,4,11,5,10,38,36,2,38
Cliftonville,7173,5,9,4,13,32,32,0,31
Ballymena,7173,6,7,5,14,25,47,-22,26
Glentoran,7173,7,6,6,10,24,32,-8,24
Dungannon,7173,8,2,4,16,14,47,-33,10
Crusaders,7174,1,17,6,3,65,33,32,57
Coleraine,7174,2,15,10,1,47,24,23,55
Linfield,7174,3,11,5,10,38,36,2,38
Glenavon,7174,4,9,9,8,54,47,7,36
Cliftonville,7174,5,9,4,13,32,32,0,31
Ballymena,7174,6,7,4,15,28,51,-23,25
Glentoran,7174,7,6,6,10,24,32,-8,24
Dungannon,7174,8,2,4,16,14,47,-33,10
Crusaders,7175,1,17,6,3,64,32,32,57
Coleraine,7175,2,15,10,1,44,22,22,55
Linfield,7175,3,11,5,10,39,36,3,38
Glenavon,7175,4,9,9,8,52,44,8,36
Cliftonville,7175,5,9,4,13,32,33,-1,31
Ballymena,7175,6,7,4,15,27,50,-23,25
Glentoran,7175,7,6,6,10,24,32,-8,24
Dungannon,7175,8,2,4,16,14,47,-33,10
Crusaders,7176,1,17,6,3,63,31,32,57
Coleraine,7176,2,14,11,1,45,24,21,53
Linfield,7176,3,11,5,10,39,36,3,38
Glenavon,7176,4,9,10,7,54,45,9,37
Cliftonville,7176,5,9,4,13,32,33,-1,31
Ballymena,7176,6,7,4,15,26,49,-23,25
Glentoran,7176,7,6,6,10,24,32,-8,24
Dungannon,7176,8,2,4,16,14,47,-33,10
Crusaders,7177,1,17,6,3,64,30,34,57
Coleraine,7177,2,15,10,1,45,22,23,55
Linfield,7177,3,11,5,10,39,36,3,38
Glenavon,7177,4,9,9,8,52,45,7,36
Cliftonville,7177,5,9,4,13,32,33,-1,31
Ballymena,7177,6,7,4,15,25,50,-25,25
Glentoran,7177,7,6,6,10,24,32,-8,24
Dungannon,7177,8,2,4,16,14,47,-33,10
Crusaders,7178,1,16,7,3,62,31,31,55
Coleraine,7178,2,14,11,1,45,24,21,53
Glenavon,7178,3,9,10,7,54,45,9,37
Linfield,7178,4,10,6,10,37,36,1,36
Cliftonville,7178,5,9,5,12,32,31,1,32
Ballymena,7178,6,7,5,14,26,48,-22,26
Glentoran,7178,7,6,6,10,24,32,-8,24
Dungannon,7178,8,2,4,16,14,47,-33,10
Crusaders,7179,1,17,6,3,64,30,34,57
Coleraine,7179,2,14,11,1,45,24,21,53
Linfield,7179,3,11,5,10,38,36,2,38
Glenavon,7179,4,9,10,7,54,45,9,37
Cliftonville,7179,5,9,4,13,32,32,0,31
Ballymena,7179,6,7,4,15,25,50,-25,25
Glentoran,7179,7,6,6,10,24,32,-8,24
Dungannon,7179,8,2,4,16,14,47,-33,10
Coleraine,7180,1,15,10,1,46,24,22,55
Crusaders,7180,2,16,6,4,63,33,30,54
Linfield,7180,3,11,5,10,38,36,2,38
Glenavon,7180,4,9,9,8,54,46,8,36
Cliftonville,7180,5,9,4,13,32,32,0,31
Ballymena,7180,6,8,4,14,28,49,-21,28
Glentoran,7180,7,6,6,10,24,32,-8,24
Dungannon,7180,8,2,4,16,14,47,-33,10
Crusaders,7181,1,17,6,3,65,31,34,57
Coleraine,7181,2,14,11,1,46,25,21,53
Linfield,7181,3,11,5,10,38,36,2,38
Glenavon,7181,4,9,10,7,55,46,9,37
Cliftonville,7181,5,9,4,13,32,32,0,31
Ballymena,7181,6,7,4,15,26,51,-25,25
Glentoran,7181,7,6,6,10,24,32,-8,24
Dungannon,7181,8,2,4,16,14,47,-33,10
Crusaders,7182,1,17,6,3,63,31,32,57
Coleraine,7182,2,14,10,2,43,26,17,52
Glenavon,7182,3,10,9,7,56,43,13,39
Linfield,7182,4,10,6,10,39,38,1,36
Cliftonville,7182,5,9,5,12,34,33,1,32
Ballymena,7182,6,7,4,15,26,49,-23,25
Glentoran,7182,7,6,6,10,24,32,-8,24
Dungannon,7182,8,2,4,16,14,47,-33,10
Crusaders,7183,1,17,6,3,63,31,32,57
Coleraine,7183,2,14,10,2,43,23,20,52
Glenavon,7183,3,10,9,7,53,43,10,39
Linfield,7183,4,11,5,10,40,37,3,38
Cliftonville,7183,5,9,4,13,33,34,-1,31
Ballymena,7183,6,7,4,15,26,49,-23,25
Glentoran,7183,7,6,6,10,24,32,-8,24
Dungannon,7183,8,2,4,16,14,47,-33,10
Crusaders,7184,1,16,6,4,62,34,28,54
Coleraine,7184,2,14,10,2,43,27,16,52
Glenavon,7184,3,10,9,7,57,43,14,39
Linfield,7184,4,10,6,10,38,37,1,36
Cliftonville,7184,5,9,5,12,33,32,1,32
Ballymena,7184,6,8,4,14,29,48,-19,28
Glentoran,7184,7,6,6,10,24,32,-8,24
Dungannon,7184,8,2,4,16,14,47,-33,10
Crusaders,7185,1,17,6,3,64,31,33,57
Coleraine,7185,2,15,10,1,47,22,25,55
Linfield,7185,3,11,5,10,38,36,2,38
Glenavon,7185,4,9,9,8,52,47,5,36
Cliftonville,7185,5,9,4,13,32,32,0,31
Ballymena,7185,6,7,4,15,26,50,-24,25
Glentoran,7185,7,6,6,10,24,32,-8,24
Dungannon,7185,8,2,4,16,14,47,-33,10
Crusaders,7186,1,16,7,3,61,30,31,55
Coleraine,7186,2,14,11,1,45,24,21,53
Glenavon,7186,3,9,10,7,54,45,9,37
Linfield,7186,4,10,6,10,37,36,1,36
Cliftonville,7186,5,9,5,12,32,31,1,32
Ballymena,7186,6,7,5,14,25,47,-22,26
Glentoran,7186,7,6,6,10,24,32,-8,24
Dungannon,7186,8,2,4,16,14,47,-33,10
Crusaders,7187,1,17,6,3,64,31,33,57
Coleraine,7187,2,14,10,2,45,25,20,52
Glenavon,7187,3,10,9,7,55,45,10,39
Linfield,7187,4,11,5,10,39,37,2,38
Cliftonville,7187,5,9,4,13,33,33,0,31
Ballymena,7187,6,7,4,15,26,50,-24,25
Glentoran,7187,7,6,6,10,24,32,-8,24
Dungannon,7187,8,2,4,16,14,47,-33,10
Crusaders,7188,1,16,7,3,63,32,31,55
Coleraine,7188,2,15,10,1,47,25,22,55
Glenavon,7188,3,9,9,8,55,47,8,36
Linfield,7188,4,10,6,10,37,36,1,36
Cliftonville,7188,5,9,5,12,32,31,1,32
Ballymena,7188,6,7,5,14,27,49,-22,26
Glentoran,7188,7,6,6,10,24,32,-8,24
Dungannon,7188,8,2,4,16,14,47,-33,10
Crusaders,7189,1,17,6,3,63,31,32,57
Coleraine,7189,2,14,11,1,45,24,21,53
Glenavon,7189,3,9,10,7,54,45,9,37
Linfield,7189,4,10,5,11,38,38,0,35
Cliftonville,7189,5,10,4,12,34,32,2,34
Ballymena,7189,6,7,4,15,26,49,-23,25
Glentoran,7189,7,6,6,10,24,32,-8,24
Dungannon,7189,8,2,4,16,14,47,-33,10
Crusaders,7190,1,17,6,3,62,30,32,57
Coleraine,7190,2,15,10,1,45,23,22,55
Glenavon,7190,3,9,9,8,53,45,8,36
Linfield,7190,4,10,6,10,39,38,1,36
Cliftonville,7190,5,9,5,12,34,33,1,32
Ballymena,7190,6,7,4,15,25,48,-23,25
Glentoran,7190,7,6,6,10,24,32,-8,24
Dungannon,7190,8,2,4,16,14,47,-33,10
Crusaders,7191,1,16,6,4,61,32,29,54
Coleraine,7191,2,14,10,2,43,23,20,52
Glenavon,7191,3,10,9,7,53,43,10,39
Linfield,7191,4,11,5,10,39,37,2,38
Cliftonville,7191,5,9,4,13,33,33,0,31
Ballymena,7191,6,8,4,14,27,47,-20,28
Glentoran,7191,7,6,6,10,24,32,-8,24
Dungannon,7191,8,2,4,16,14,47,-33,10
Crusaders,7192,1,17,6,3,64,31,33,57
Coleraine,7192,2,14,10,2,43,23,20,52
Glenavon,7192,3,10,9,7,53,43,10,39
Linfield,7192,4,11,5,10,39,37,2,38
Cliftonville,7192,5,9,4,13,33,33,0,31
Ballymena,7192,6,7,4,15,26,50,-24,25
Glentoran,7192,7,6,6,10,24,32,-8,24
Dungannon,7192,8,2,4,16,14,47,-33,10
Crusaders,7193,1,16,7,3,62,31,31,55
Coleraine,7193,2,14,11,1,45,24,21,53
Linfield,7193,3,11,5,10,38,36,2,38
Glenavon,7193,4,9,10,7,54,45,9,37
Cliftonville,7193,5,9,4,13,32,32,0,31
Ballymena,7193,6,7,5,14,26,48,-22,26
Glentoran,7193,7,6,6,10,24,32,-8,24
Dungannon,7193,8,2,4,16,14,47,-33,10
Crusaders,7194,1,16,6,4,61,31,30,54
Coleraine,7194,2,14,10,2,44,27,17,52
Glenavon,7194,3,10,9,7,57,44,13,39
Linfield,7194,4,11,5,10,39,37,2,38
Cliftonville,7194,5,9,4,13,33,33,0,31
Ballymena,7194,6,8,4,14,26,47,-21,28
Glentoran,7194,7,6,6,10,24,32,-8,24
Dungannon,7194,8,2,4,16,14,47,-33,10
Crusaders,7195,1,17,6,3,65,30,35,57
Coleraine,7195,2,14,10,2,45,25,20,52
Glenavon,7195,3,10,9,7,55,45,10,39
Linfield,7195,4,11,5,10,38,36,2,38
Cliftonville,7195,5,9,4,13,32,32,0,31
Ballymena,7195,6,7,4,15,25,51,-26,25
Glentoran,7195,7,6,6,10,24,32,-8,24
Dungannon,7195,8,2,4,16,14,47,-33,10
Crusaders,7196,1,16,7,3,64,33,31,55
Coleraine,7196,2,14,10,2,43,23,20,52
Glenavon,7196,3,10,9,7,53,43,10,39
Linfield,7196,4,10,5,11,38,38,0,35
Cliftonville,7196,5,10,4,12,34,32,2,34
Ballymena,7196,6,7,5,14,28,50,-22,26
Glentoran,7196,7,6,6,10,24,32,-8,24
Dungannon,7196,8,2,4,16,14,47,-33,10
Crusaders,7197,1,17,6,3,63,30,33,57
Coleraine,7197,2,15,10,1,45,22,23,55
Linfield,7197,3,11,5,10,40,36,4,38
Glenavon,7197,4,9,9,8,52,45,7,36
Cliftonville,7197,5,9,4,13,32,34,-2,31
Ballymena,7197,6,7,4,15,25,49,-24,25
Glentoran,7197,7,6,6,10,24,32,-8,24
Dungannon,7197,8,2,4,16,14,47,-33,10
Crusaders,7198,1,17,6,3,64,30,34,57
Coleraine,7198,2,14,11,1,44,23,21,53
Linfield,7198,3,11,5,10,39,36,3,38
Glenavon,7198,4,9,10,7,53,44,9,37
Cliftonville,7198,5,9,4,13,32,33,-1,31
Ballymena,7198,6,7,4,15,25,50,-25,25
Glentoran,7198,7,6,6,10,24,32,-8,24
Dungannon,7198,8,2,4,16,14,47,-33,10
Crusaders,7199,1,16,6,4,62,35,27,54
Coleraine,7199,2,14,11,1,44,23,21,53
Linfield,7199,3,11,5,10,38,36,2,38
Glenavon,7199,4,9,10,7,53,44,9,37
Cliftonville,7199,5,9,4,13,32,32,0,31
Ballymena,7199,6,8,4,14,30,48,-18,28
Glentoran,7199,7,6,6,10,24,32,-8,24
Dungannon,7199,8,2,4,16,14,47,-33,10
Crusaders,7200,1,16,6,4,61,34,27,54
Coleraine,7200,2,14,11,1,44,23,21,53
Glenavon,7200,3,9,10,7,53,44,9,37
Linfield,7200,4,10,6,10,38,37,1,36
Cliftonville,7200,5,9,5,12,33,32,1,32
Ballymena,7200,6,8,4,14,29,47,-18,28
Glentoran,7200,7,6,6,10,24,32,-8,24
Dungannon,7200,8,2,4,16,14,47,-33,10
Crusaders,7201,1,17,6,3,62,30,32,57
Coleraine,7201,2,15,10,1,46,24,22,55
Glenavon,7201,3,9,9,8,54,46,8,36
Linfield,7201,4,10,6,10,39,38,1,36
Cliftonville,7201,5,9,5,12,34,33,1,32
Ballymena,7201,6,7,4,15,25,48,-23,25
Glentoran,7201,7,6,6,10,24,32,-8,24
Dungannon,7201,8,2,4,16,14,47,-33,10
Crusaders,7202,1,17,6,3,66,34,32,57
Coleraine,7202,2,14,11,1,45,24,21,53
Glenavon,7202,3,9,10,7,54,45,9,37
Linfield,7202,4,10,5,11,38,38,0,35
Cliftonville,7202,5,10,4,12,34,32,2,34
Ballymena,7202,6,7,4,15,29,52,-23,25
Glentoran,7202,7,6,6,10,24,32,-8,24
Dungannon,7202,8,2,4,16,14,47,-33,10
Crusaders,7203,1,17,6,3,65,31,34,57
Coleraine,7203,2,14,10,2,44,24,20,52
Glenavon,7203,3,10,9,7,54,44,10,39
Linfield,7203,4,11,5,10,39,37,2,38
Cliftonville,7203,5,9,4,13,33,33,0,31
Ballymena,7203,6,7,4,15,26,51,-25,25
Glentoran,7203,7,6,6,10,24,32,-8,24
Dungannon,7203,8,2,4,16,14,47,-33,10
Coleraine,7204,1,15,10,1,46,24,22,55
Crusaders,7204,2,16,6,4,62,33,29,54
Glenavon,7204,3,9,9,8,54,46,8,36
Linfield,7204,4,10,6,10,38,37,1,36
Cliftonville,7204,5,9,5,12,33,32,1,32
Ballymena,7204,6,8,4,14,28,48,-20,28
Glentoran,7204,7,6,6,10,24,32,-8,24
Dungannon,7204,8,2,4,16,14,47,-33,10
Crusaders,7205,1,17,6,3,62,30,32,57
Coleraine,7205,2,15,10,1,44,22,22,55
Linfield,7205,3,11,5,10,38,36,2,38
Glenavon,7205,4,9,9,8,52,44,8,36
Cliftonville,7205,5,9,4,13,32,32,0,31
Ballymena,7205,6,7,4,15,25,48,-23,25
Glentoran,7205,7,6,6,10,24,32,-8,24
Dungannon,7205,8,2,4,16,14,47,-33,10
Crusaders,7206,1,17,6,3,62,30,32,57
Coleraine,7206,2,14,10,2,43,23,20,52
Glenavon,7206,3,10,9,7,53,43,10,39
Linfield,7206,4,10,6,10,37,36,1,36
Cliftonville,7206,5,9,5,12,32,31,1,32
Ballymena,7206,6,7,4,15,25,48,-23,25
Glentoran,7206,7,6,6,10,24,32,-8,24
Dungannon,7206,8,2,4,16,14,47,-33,10
Crusaders,7207,1,16,6,4,62,33,29,54
Coleraine,7207,2,14,10,2,43,23,20,52
Glenavon,7207,3,10,9,7,53,43,10,39
Linfield,7207,4,10,6,10,37,36,1,36
Cliftonville,7207,5,9,5,12,32,31,1,32
Ballymena,7207,6,8,4,14,28,48,-20,28
Glentoran,7207,7,6,6,10,24,32,-8,24
Dungannon,7207,8,2,4,16,14,47,-33,10
Crusaders,7208,1,17,6,3,63,30,33,57
Coleraine,7208,2,14,10,2,44,24,20,52
Glenavon,7208,3,10,9,7,54,44,10,39
Linfield,7208,4,10,5,11,39,39,0,35
Cliftonville,7208,5,10,4,12,35,33,2,34
Ballymena,7208,6,7,4,15,25,49,-24,25
Glentoran,7208,7,6,6,10,24,32,-8,24
Dungannon,7208,8,2,4,16,14,47,-33,10
Crusaders,7209,1,16,7,3,63,32,31,55
Coleraine,7209,2,14,10,2,43,25,18,52
Glenavon,7209,3,10,9,7,55,43,12,39
Linfield,7209,4,11,5,10,39,37,2,38
Cliftonville,7209,5,9,4,13,33,33,0,31
Ballymena,7209,6,7,5,14,27,49,-22,26
Glentoran,7209,7,6,6,10,24,32,-8,24
Dungannon,7209,8,2,4,16,14,47,-33,10
Crusaders,7210,1,16,6,4,61,31,30,54
Coleraine,7210,2,14,10,2,43,28,15,52
Glenavon,7210,3,10,9,7,58,43,15,39
Linfield,7210,4,11,5,10,39,36,3,38
Cliftonville,7210,5,9,4,13,32,33,-1,31
Ballymena,7210,6,8,4,14,26,47,-21,28
Glentoran,7210,7,6,6,10,24,32,-8,24
Dungannon,7210,8,2,4,16,14,47,-33,10
Crusaders,7211,1,16,6,4,61,31,30,54
Coleraine,7211,2,14,11,1,44,23,21,53
Linfield,7211,3,11,5,10,40,36,4,38
Glenavon,7211,4,9,10,7,53,44,9,37
Cliftonville,7211,5,9,4,13,32,34,-2,31
Ballymena,7211,6,8,4,14,26,47,-21,28
Glentoran,7211,7,6,6,10,24,32,-8,24
Dungannon,7211,8,2,4,16,14,47,-33,10
Crusaders,7212,1,16,7,3,63,32,31,55
Coleraine,7212,2,15,10,1,46,22,24,55
Linfield,7212,3,11,5,10,40,37,3,38
Glenavon,7212,4,9,9,8,52,46,6,36
Cliftonville,7212,5,9,4,13,33,34,-1,31
Ballymena,7212,6,7,5,14,27,49,-22,26
Glentoran,7212,7,6,6,10,24,32,-8,24
Dungannon,7212,8,2,4,16,14,47,-33,10
Crusaders,7213,1,17,6,3,63,31,32,57
Coleraine,7213,2,14,10,2,45,25,20,52
Glenavon,7213,3,10,9,7,55,45,10,39
Linfield,7213,4,11,5,10,39,37,2,38
Cliftonville,7213,5,9,4,13,33,33,0,31
Ballymena,7213,6,7,4,15,26,49,-23,25
Glentoran,7213,7,6,6,10,24,32,-8,24
Dungannon,7213,8,2,4,16,14,47,-33,10
Crusaders,7214,1,16,6,4,61,31,30,54
Coleraine,7214,2,14,10,2,45,26,19,52
Glenavon,7214,3,10,9,7,56,45,11,39
Linfield,7214,4,10,6,10,37,36,1,36
Cliftonville,7214,5,9,5,12,32,31,1,32
Ballymena,7214,6,8,4,14,26,47,-21,28
Glentoran,7214,7,6,6,10,24,32,-8,24
Dungannon,7214,8,2,4,16,14,47,-33,10
Crusaders,7215,1,17,6,3,64,31,33,57
Coleraine,7215,2,14,10,2,44,26,18,52
Glenavon,7215,3,10,9,7,56,44,12,39
Linfield,7215,4,11,5,10,39,37,2,38
Cliftonville,7215,5,9,4,13,33,33,0,31
Ballymena,7215,6,7,4,15,26,50,-24,25
Glentoran,7215,7,6,6,10,24,32,-8,24
Dungannon,7215,8,2,4,16,14,47,-33,10
Crusaders,7216,1,16,7,3,63,32,31,55
Coleraine,7216,2,14,10,2,44,25,19,52
Glenavon,7216,3,10,9,7,55,44,11,39
Linfield,7216,4,11,5,10,39,37,2,38
Cliftonville,7216,5,9,4,13,33,33,0,31
Ballymena,7216,6,7,5,14,27,49,-22,26
Glentoran,7216,7,6,6,10,24,32,-8,24
Dungannon,7216,8,2,4,16,14,47,-33,10
Crusaders,7217,1,17,6,3,63,31,32,57
Coleraine,7217,2,14,10,2,45,27,18,52
Glenavon,7217,3,10,9,7,57,45,12,39
Linfield,7217,4,10,6,10,38,37,1,36
Cliftonville,7217,5,9,5,12,33,32,1,32
Ballymena,7217,6,7,4,15,26,49,-23,25
Glentoran,7217,7,6,6,10,24,32,-8,24
Dungannon,7217,8,2,4,16,14,47,-33,10
Crusaders,7218,1,16,6,4,61,33,28,54
Coleraine,7218,2,14,10,2,45,27,18,52
Glenavon,7218,3,10,9,7,57,45,12,39
Linfield,7218,4,10,6,10,40,39,1,36
Cliftonville,7218,5,9,5,12,35,34,1,32
Ballymena,7218,6,8,4,14,28,47,-19,28
Glentoran,7218,7,6,6,10,24,32,-8,24
Dungannon,7218,8,2,4,16,14,47,-33,10
Crusaders,7219,1,17,6,3,65,32,33,57
Coleraine,7219,2,14,10,2,43,24,19,52
Glenavon,7219,3,10,9,7,54,43,11,39
Linfield,7219,4,11,5,10,38,36,2,38
Cliftonville,7219,5,9,4,13,32,32,0,31
Ballymena,7219,6,7,4,15,27,51,-24,25
Glentoran,7219,7,6,6,10,24,32,-8,24
Dungannon,7219,8,2,4,16,14,47,-33,10
Crusaders,7220,1,17,6,3,65,31,34,57
Coleraine,7220,2,15,10,1,45,23,22,55
Glenavon,7220,3,9,9,8,53,45,8,36
Linfield,7220,4,10,5,11,38,39,-1,35
Cliftonville,7220,5,10,4,12,35,32,3,34
Ballymena,7220,6,7,4,15,26,51,-25,25
Glentoran,7220,7,6,6,10,24,32,-8,24
Dungannon,7220,8,2,4,16,14,47,-33,10
Crusaders,7221,1,17,6,3,63,31,32,57
Coleraine,7221,2,15,10,1,45,23,22,55
Linfield,7221,3,11,5,10,38,36,2,38
Glenavon,7221,4,9,9,8,53,45,8,36
Cliftonville,7221,5,9,4,13,32,32,0,31
Ballymena,7221,6,7,4,15,26,49,-23,25
Glentoran,7221,7,6,6,10,24,32,-8,24
Dungannon,7221,8,2,4,16,14,47,-33,10
Crusaders,7222,1,16,6,4,63,33,30,54
Coleraine,7222,2,14,11,1,44,23,21,53
Glenavon,7222,3,9,10,7,53,44,9,37
Linfield,7222,4,10,6,10,38,37,1,36
Cliftonville,7222,5,9,5,12,33,32,1,32
Ballymena,7222,6,8,4,14,28,49,-21,28
Glentoran,7222,7,6,6,10,24,32,-8,24
Dungannon,7222,8,2,4,16,14,47,-33,10
Crusaders,7223,1,16,7,3,62,31,31,55
Coleraine,7223,2,15,10,1,48,23,25,55
Glenavon,7223,3,9,9,8,53,48,5,36
Linfield,7223,4,10,5,11,38,38,0,35
Cliftonville,7223,5,10,4,12,34,32,2,34
Ballymena,7223,6,7,5,14,26,48,-22,26
Glentoran,7223,7,6,6,10,24,32,-8,24
Dungannon,7223,8,2,4,16,14,47,-33,10
Crusaders,7224,1,16,6,4,61,31,30,54
Coleraine,7224,2,14,11,1,44,23,21,53
Glenavon,7224,3,9,10,7,53,44,9,37
Linfield,7224,4,10,5,11,37,37,0,35
Cliftonville,7224,5,10,4,12,33,31,2,34
Ballymena,7224,6,8,4,14,26,47,-21,28
Glentoran,7224,7,6,6,10,24,32,-8,24
Dungannon,7224,8,2,4,16,14,47,-33,10
Crusaders,7225,1,17,6,3,66,30,36,57
Coleraine,7225,2,15,10,1,48,25,23,55
Linfield,7225,3,11,5,10,40,37,3,38
Glenavon,7225,4,9,9,8,55,48,7,36
Cliftonville,7225,5,9,4,13,33,34,-1,31
Ballymena,7225,6,7,4,15,25,52,-27,25
Glentoran,7225,7,6,6,10,24,32,-8,24
Dungannon,7225,8,2,4,16,14,47,-33,10
Crusaders,7226,1,17,6,3,64,32,32,57
Coleraine,7226,2,14,10,2,43,23,20,52
Glenavon,7226,3,10,9,7,53,43,10,39
Linfield,7226,4,10,5,11,38,39,-1,35
Cliftonville,7226,5,10,4,12,35,32,3,34
Ballymena,7226,6,7,4,15,27,50,-23,25
Glentoran,7226,7,6,6,10,24,32,-8,24
Dungannon,7226,8,2,4,16,14,47,-33,10
Crusaders,7227,1,17,6,3,63,31,32,57
Coleraine,7227,2,14,10,2,45,25,20,52
Glenavon,7227,3,10,9,7,55,45,10,39
Linfield,7227,4,10,6,10,38,37,1,36
Cliftonville,7227,5,9,5,12,33,32,1,32
Ballymena,7227,6,7,4,15,26,49,-23,25
Glentoran,7227,7,6,6,10,24,32,-8,24
Dungannon,7227,8,2,4,16,14,47,-33,10
Coleraine,7228,1,15,10,1,46,23,23,55
Crusaders,7228,2,16,6,4,62,32,30,54
Linfield,7228,3,11,5,10,41,37,4,38
Glenavon,7228,4,9,9,8,53,46,7,36
Cliftonville,7228,5,9,4,13,33,35,-2,31
Ballymena,7228,6,8,4,14,27,48,-21,28
Glentoran,7228,7,6,6,10,24,32,-8,24
Dungannon,7228,8,2,4,16,14,47,-33,10
Crusaders,7229,1,16,7,3,61,30,31,55
Coleraine,7229,2,14,11,1,44,23,21,53
Linfield,7229,3,11,5,10,38,36,2,38
Glenavon,7229,4,9,10,7,53,44,9,37
Cliftonville,7229,5,9,4,13,32,32,0,31
Ballymena,7229,6,7,5,14,25,47,-22,26
Glentoran,7229,7,6,6,10,24,32,-8,24
Dungannon,7229,8,2,4,16,14,47,-33,10
Crusaders,7230,1,16,6,4,61,31,30,54
Coleraine,7230,2,14,11,1,45,24,21,53
Linfield,7230,3,11,5,10,40,37,3,38
Glenavon,7230,4,9,10,7,54,45,9,37
Cliftonville,7230,5,9,4,13,33,34,-1,31
Ballymena,7230,6,8,4,14,26,47,-21,28
Glentoran,7230,7,6,6,10,24,32,-8,24
Dungannon,7230,8,2,4,16,14,47,-33,10
Crusaders,7231,1,17,6,3,63,30,33,57
Coleraine,7231,2,15,10,1,46,22,24,55
Linfield,7231,3,11,5,10,41,37,4,38
Glenavon,7231,4,9,9,8,52,46,6,36
Cliftonville,7231,5,9,4,13,33,35,-2,31
Ballymena,7231,6,7,4,15,25,49,-24,25
Glentoran,7231,7,6,6,10,24,32,-8,24
Dungannon,7231,8,2,4,16,14,47,-33,10
Crusaders,7232,1,16,6,4,63,33,30,54
Coleraine,7232,2,14,11,1,43,22,21,53
Glenavon,7232,3,9,10,7,52,43,9,37
Linfield,7232,4,10,5,11,38,38,0,35
Cliftonville,7232,5,10,4,12,34,32,2,34
Ballymena,7232,6,8,4,14,28,49,-21,28
Glentoran,7232,7,6,6,10,24,32,-8,24
Dungannon,7232,8,2,4,16,14,47,-33,10
Coleraine,7233,1,15,10,1,44,22,22,55
Crusaders,7233,2,16,6,4,61,31,30,54
Linfield,7233,3,11,5,10,40,37,3,38
Glenavon,7233,4,9,9,8,52,44,8,36
Cliftonville,7233,5,9,4,13,33,34,-1,31
Ballymena,7233,6,8,4,14,26,47,-21,28
Glentoran,7233,7,6,6,10,24,32,-8,24
Dungannon,7233,8,2,4,16,14,47,-33,10
Crusaders,7234,1,17,6,3,63,30,33,57
Coleraine,7234,2,15,10,1,45,23,22,55
Linfield,7234,3,11,5,10,40,36,4,38
Glenavon,7234,4,9,9,8,53,45,8,36
Cliftonville,7234,5,9,4,13,32,34,-2,31
Ballymena,7234,6,7,4,15,25,49,-24,25
Glentoran,7234,7,6,6,10,24,32,-8,24
Dungannon,7234,8,2,4,16,14,47,-33,10
Crusaders,7235,1,16,6,4,63,33,30,54
Coleraine,7235,2,14,11,1,43,22,21,53
Glenavon,7235,3,9,10,7,52,43,9,37
Linfield,7235,4,10,5,11,37,38,-1,35
Cliftonville,7235,5,10,4,12,34,31,3,34
Ballymena,7235,6,8,4,14,28,49,-21,28
Glentoran,7235,7,6,6,10,24,32,-8,24
Dungannon,7235,8,2,4,16,14,47,-33,10
Crusaders,7236,1,17,6,3,63,31,32,57
Coleraine,7236,2,14,10,2,44,24,20,52
Glenavon,7236,3,10,9,7,54,44,10,39
Linfield,7236,4,11,5,10,40,38,2,38
Cliftonville,7236,5,9,4,13,34,34,0,31
Ballymena,7236,6,7,4,15,26,49,-23,25
Glentoran,7236,7,6,6,10,24,32,-8,24
Dungannon,7236,8,2,4,16,14,47,-33,10
Crusaders,7237,1,17,6,3,65,31,34,57
Coleraine,7237,2,15,10,1,46,24,22,55
Linfield,7237,3,11,5,10,39,36,3,38
Glenavon,7237,4,9,9,8,54,46,8,36
Cliftonville,7237,5,9,4,13,32,33,-1,31
Ballymena,7237,6,7,4,15,26,51,-25,25
Glentoran,7237,7,6,6,10,24,32,-8,24
Dungannon,7237,8,2,4,16,14,47,-33,10
Crusaders,7238,1,17,6,3,65,33,32,57
Coleraine,7238,2,15,10,1,46,24,22,55
Linfield,7238,3,11,5,10,40,36,4,38
Glenavon,7238,4,9,9,8,54,46,8,36
Cliftonville,7238,5,9,4,13,32,34,-2,31
Ballymena,7238,6,7,4,15,28,51,-23,25
Glentoran,7238,7,6,6,10,24,32,-8,24
Dungannon,7238,8,2,4,16,14,47,-33,10
Crusaders,7239,1,16,7,3,62,31,31,55
Coleraine,7239,2,14,10,2,47,27,20,52
Glenavon,7239,3,10,9,7,57,47,10,39
Linfield,7239,4,11,5,10,38,36,2,38
Cliftonville,7239,5,9,4,13,32,32,0,31
Ballymena,7239,6,7,5,14,26,48,-22,26
Glentoran,7239,7,6,6,10,24,32,-8,24
Dungannon,7239,8,2,4,16,14,47,-33,10
Crusaders,7240,1,16,7,3,64,33,31,55
Coleraine,7240,2,14,10,2,43,24,19,52
Glenavon,7240,3,10,9,7,54,43,11,39
Linfield,7240,4,11,5,10,40,37,3,38
Cliftonville,7240,5,9,4,13,33,34,-1,31
Ballymena,7240,6,7,5,14,28,50,-22,26
Glentoran,7240,7,6,6,10,24,32,-8,24
Dungannon,7240,8,2,4,16,14,47,-33,10
Coleraine,7241,1,15,10,1,45,23,22,55
Crusaders,7241,2,16,6,4,62,33,29,54
Glenavon,7241,3,9,9,8,53,45,8,36
Linfield,7241,4,10,6,10,37,36,1,36
Cliftonville,7241,5,9,5,12,32,31,1,32
Ballymena,7241,6,8,4,14,28,48,-20,28
Glentoran,7241,7,6,6,10,24,32,-8,24
Dungannon,7241,8,2,4,16,14,47,-33,10
Crusaders,7242,1,17,6,3,62,30,32,57
Coleraine,7242,2,15,10,1,47,24,23,55
Linfield,7242,3,11,5,10,38,36,2,38
Glenavon,7242,4,9,9,8,54,47,7,36
Cliftonville,7242,5,9,4,13,32,32,0,31
Ballymena,7242,6,7,4,15,25,48,-23,25
Glentoran,7242,7,6,6,10,24,32,-8,24
Dungannon,7242,8,2,4,16,14,47,-33,10
Crusaders,7243,1,17,6,3,62,30,32,57
Coleraine,7243,2,14,11,1,45,24,21,53
Linfield,7243,3,11,5,10,38,36,2,38
Glenavon,7243,4,9,10,7,54,45,9,37
Cliftonville,7243,5,9,4,13,32,32,0,31
Ballymena,7243,6,7,4,15,25,48,-23,25
Glentoran,7243,7,6,6,10,24,32,-8,24
Dungannon,7243,8,2,4,16,14,47,-33,10
Crusaders,7244,1,17,6,3,65,32,33,57
Coleraine,7244,2,14,11,1,44,23,21,53
Linfield,7244,3,11,5,10,39,36,3,38
Glenavon,7244,4,9,10,7,53,44,9,37
Cliftonville,7244,5,9,4,13,32,33,-1,31
Ballymena,7244,6,7,4,15,27,51,-24,25
Glentoran,7244,7,6,6,10,24,32,-8,24
Dungannon,7244,8,2,4,16,14,47,-33,10
Crusaders,7245,1,17,6,3,63,31,32,57
Coleraine,7245,2,14,10,2,43,24,19,52
Glenavon,7245,3,10,9,7,54,43,11,39
Linfield,7245,4,11,5,10,39,36,3,38
Cliftonville,7245,5,9,4,13,32,33,-1,31
Ballymena,7245,6,7,4,15,26,49,-23,25
Glentoran,7245,7,6,6,10,24,32,-8,24
Dungannon,7245,8,2,4,16,14,47,-33,10
Crusaders,7246,1,17,6,3,66,31,35,57
Coleraine,7246,2,14,10,2,45,27,18,52
Glenavon,7246,3,10,9,7,57,45,12,39
Linfield,7246,4,10,5,11,37,38,-1,35
Cliftonville,7246,5,10,4,12,34,31,3,34
Ballymena,7246,6,7,4,15,26,52,-26,25
Glentoran,7246,7,6,6,10,24,32,-8,24
Dungannon,7246,8,2,4,16,14,47,-33,10
Crusaders,7247,1,17,6,3,64,31,33,57
Coleraine,7247,2,14,10,2,45,27,18,52
Glenavon,7247,3,10,9,7,57,45,12,39
Linfield,7247,4,11,5,10,40,36,4,38
Cliftonville,7247,5,9,4,13,32,34,-2,31
Ballymena,7247,6,7,4,15,26,50,-24,25
Glentoran,7247,7,6,6,10,24,32,-8,24
Dungannon,7247,8,2,4,16,14,47,-33,10
Crusaders,7248,1,16,7,3,63,32,31,55
Coleraine,7248,2,14,11,1,44,23,21,53
Linfield,7248,3,11,5,10,38,36,2,38
Glenavon,7248,4,9,10,7,53,44,9,37
Cliftonville,7248,5,9,4,13,32,32,0,31
Ballymena,7248,6,7,5,14,27,49,-22,26
Glentoran,7248,7,6,6,10,24,32,-8,24
Dungannon,7248,8,2,4,16,14,47,-33,10
Crusaders,7249,1,16,7,3,63,32,31,55
Coleraine,7249,2,14,11,1,44,23,21,53
Linfield,7249,3,11,5,10,38,36,2,38
Glenavon,7249,4,9,10,7,53,44,9,37
Cliftonville,7249,5,9,4,13,32,32,0,31
Ballymena,7249,6,7,5,14,27,49,-22,26
Glentoran,7249,7,6,6,10,24,32,-8,24
Dungannon,7249,8,2,4,16,14,47,-33,10
Crusaders,7250,1,16,7,3,62,31,31,55
Coleraine,7250,2,14,10,2,43,23,20,52
Glenavon,7250,3,10,9,7,53,43,10,39
Linfield,7250,4,11,5,10,38,36,2,38
Cliftonville,7250,5,9,4,13,32,32,0,31
Ballymena,7250,6,7,5,14,26,48,-22,26
Glentoran,7250,7,6,6,10,24,32,-8,24
Dungannon,7250,8,2,4,16,14,47,-33,10
Coleraine,7251,1,15,10,1,45,22,23,55
Crusaders,7251,2,16,6,4,62,32,30,54
Glenavon,7251,3,9,9,8,52,45,7,36
Linfield,7251,4,10,6,10,38,37,1,36
Cliftonville,7251,5,9,5,12,33,32,1,32
Ballymena,7251,6,8,4,14,27,48,-21,28
Glentoran,7251,7,6,6,10,24,32,-8,24
Dungannon,7251,8,2,4,16,14,47,-33,10
Crusaders,7252,1,16,6,4,63,34,29,54
Coleraine,7252,2,14,10,2,45,27,18,52
Glenavon,7252,3,10,9,7,57,45,12,39
Linfield,7252,4,11,5,10,39,37,2,38
Cliftonville,7252,5,9,4,13,33,33,0,31
Ballymena,7252,6,8,4,14,29,49,-20,28
Glentoran,7252,7,6,6,10,24,32,-8,24
Dungannon,7252,8,2,4,16,14,47,-33,10
Crusaders,7253,1,16,6,4,61,31,30,54
Coleraine,7253,2,14,10,2,43,26,17,52
Glenavon,7253,3,10,9,7,56,43,13,39
Linfield,7253,4,10,5,11,37,37,0,35
Cliftonville,7253,5,10,4,12,33,31,2,34
Ballymena,7253,6,8,4,14,26,47,-21,28
Glentoran,7253,7,6,6,10,24,32,-8,24
Dungannon,7253,8,2,4,16,14,47,-33,10
Crusaders,7254,1,17,6,3,64,30,34,57
Coleraine,7254,2,14,10,2,45,27,18,52
Glenavon,7254,3,10,9,7,57,45,12,39
Linfield,7254,4,11,5,10,38,36,2,38
Cliftonville,7254,5,9,4,13,32,32,0,31
Ballymena,7254,6,7,4,15,25,50,-25,25
Glentoran,7254,7,6,6,10,24,32,-8,24
Dungannon,7254,8,2,4,16,14,47,-33,10
Crusaders,7255,1,17,6,3,65,31,34,57
Coleraine,7255,2,14,10,2,43,23,20,52
Glenavon,7255,3,10,9,7,53,43,10,39
Linfield,7255,4,10,5,11,37,38,-1,35
Cliftonville,7255,5,10,4,12,34,31,3,34
Ballymena,7255,6,7,4,15,26,51,-25,25
Glentoran,7255,7,6,6,10,24,32,-8,24
Dungannon,7255,8,2,4,16,14,47,-33,10
Crusaders,7256,1,17,6,3,63,31,32,57
Coleraine,7256,2,14,10,2,43,24,19,52
Glenavon,7256,3,10,9,7,54,43,11,39
Linfield,7256,4,10,5,11,38,39,-1,35
Cliftonville,7256,5,10,4,12,35,32,3,34
Ballymena,7256,6,7,4,15,26,49,-23,25
Glentoran,7256,7,6,6,10,24,32,-8,24
Dungannon,7256,8,2,4,16,14,47,-33,10
Crusaders,7257,1,16,6,4,62,32,30,54
Coleraine,7257,2,14,10,2,45,25,20,52
Glenavon,7257,3,10,9,7,55,45,10,39
Linfield,7257,4,10,5,11,39,40,-1,35
Cliftonville,7257,5,10,4,12,36,33,3,34
Ballymena,7257,6,8,4,14,27,48,-21,28
Glentoran,7257,7,6,6,10,24,32,-8,24
Dungannon,7257,8,2,4,16,14,47,-33,10
Crusaders,7258,1,17,6,3,63,30,33,57
Coleraine,7258,2,14,10,2,44,28,16,52
Glenavon,7258,3,10,9,7,58,44,14,39
Linfield,7258,4,10,5,11,38,38,0,35
Cliftonville,7258,5,10,4,12,34,32,2,34
Ballymena,7258,6,7,4,15,25,49,-24,25
Glentoran,7258,7,6,6,10,24,32,-8,24
Dungannon,7258,8,2,4,16,14,47,-33,10
Crusaders,7259,1,16,7,3,61,30,31,55
Coleraine,7259,2,15,10,1,45,23,22,55
Glenavon,7259,3,9,9,8,53,45,8,36
Linfield,7259,4,10,6,10,40,39,1,36
Cliftonville,7259,5,9,5,12,35,34,1,32
Ballymena,7259,6,7,5,14,25,47,-22,26
Glentoran,7259,7,6,6,10,24,32,-8,24
Dungannon,7259,8,2,4,16,14,47,-33,10
Crusaders,7260,1,16,6,4,62,32,30,54
Coleraine,7260,2,14,10,2,43,24,19,52
Glenavon,7260,3,10,9,7,54,43,11,39
Linfield,7260,4,11,5,10,39,36,3,38
Cliftonville,7260,5,9,4,13,32,33,-1,31
Ballymena,7260,6,8,4,14,27,48,-21,28
Glentoran,7260,7,6,6,10,24,32,-8,24
Dungannon,7260,8,2,4,16,14,47,-33,10
Crusaders,7261,1,16,7,3,65,34,31,55
Coleraine,7261,2,14,10,2,44,24,20,52
Glenavon,7261,3,10,9,7,54,44,10,39
Linfield,7261,4,11,5,10,39,37,2,38
Cliftonville,7261,5,9,4,13,33,33,0,31
Ballymena,7261,6,7,5,14,29,51,-22,26
Glentoran,7261,7,6,6,10,24,32,-8,24
Dungannon,7261,8,2,4,16,14,47,-33,10
Crusaders,7262,1,17,6,3,65,31,34,57
Coleraine,7262,2,14,10,2,44,24,20,52
Glenavon,7262,3,10,9,7,54,44,10,39
Linfield,7262,4,10,6,10,40,39,1,36
Cliftonville,7262,5,9,5,12,35,34,1,32
Ballymena,7262,6,7,4,15,26,51,-25,25
Glentoran,7262,7,6,6,10,24,32,-8,24
Dungannon,7262,8,2,4,16,14,47,-33,10
Crusaders,7263,1,16,6,4,62,32,30,54
Coleraine,7263,2,14,11,1,46,25,21,53
Glenavon,7263,3,9,10,7,55,46,9,37
Linfield,7263,4,10,5,11,37,37,0,35
Cliftonville,7263,5,10,4,12,33,31,2,34
Ballymena,7263,6,8,4,14,27,48,-21,28
Glentoran,7263,7,6,6,10,24,32,-8,24
Dungannon,7263,8,2,4,16,14,47,-33,10
Crusaders,7264,1,16,7,3,62,31,31,55
Coleraine,7264,2,14,10,2,43,23,20,52
Glenavon,7264,3,10,9,7,53,43,10,39
Linfield,7264,4,11,5,10,41,37,4,38
Cliftonville,7264,5,9,4,13,33,35,-2,31
Ballymena,7264,6,7,5,14,26,48,-22,26
Glentoran,7264,7,6,6,10,24,32,-8,24
Dungannon,7264,8,2,4,16,14,47,-33,10
Crusaders,7265,1,16,7,3,64,33,31,55
Coleraine,7265,2,14,10,2,44,24,20,52
Glenavon,7265,3,10,9,7,54,44,10,39
Linfield,7265,4,10,5,11,37,37,0,35
Cliftonville,7265,5,10,4,12,33,31,2,34
Ballymena,7265,6,7,5,14,28,50,-22,26
Glentoran,7265,7,6,6,10,24,32,-8,24
Dungannon,7265,8,2,4,16,14,47,-33,10
Crusaders,7266,1,17,6,3,62,30,32,57
Coleraine,7266,2,14,11,1,45,24,21,53
Linfield,7266,3,11,5,10,39,36,3,38
Glenavon,7266,4,9,10,7,54,45,9,37
Cliftonville,7266,5,9,4,13,32,33,-1,31
Ballymena,7266,6,7,4,15,25,48,-23,25
Glentoran,7266,7,6,6,10,24,32,-8,24
Dungannon,7266,8,2,4,16,14,47,-33,10
Crusaders,7267,1,17,6,3,63,30,33,57
Coleraine,7267,2,15,10,1,45,22,23,55
Linfield,7267,3,11,5,10,40,36,4,38
Glenavon,7267,4,9,9,8,52,45,7,36
Cliftonville,7267,5,9,4,13,32,34,-2,31
Ballymena,7267,6,7,4,15,25,49,-24,25
Glentoran,7267,7,6,6,10,24,32,-8,24
Dungannon,7267,8,2,4,16,14,47,-33,10
Crusaders,7268,1,17,6,3,63,30,33,57
Coleraine,7268,2,15,10,1,44,22,22,55
Glenavon,7268,3,9,9,8,52,44,8,36
Linfield,7268,4,10,6,10,38,37,1,36
Cliftonville,7268,5,9,5,12,33,32,1,32
Ballymena,7268,6,7,4,15,25,49,-24,25
Glentoran,7268,7,6,6,10,24,32,-8,24
Dungannon,7268,8,2,4,16,14,47,-33,10
Crusaders,7269,1,16,7,3,61,30,31,55
Coleraine,7269,2,14,11,1,45,24,21,53
Glenavon,7269,3,9,10,7,54,45,9,37
Linfield,7269,4,10,6,10,38,37,1,36
Cliftonville,7269,5,9,5,12,33,32,1,32
Ballymena,7269,6,7,5,14,25,47,-22,26
Glentoran,7269,7,6,6,10,24,32,-8,24
Dungannon,7269,8,2,4,16,14,47,-33,10
Crusaders,7270,1,16,7,3,62,31,31,55
Coleraine,7270,2,14,11,1,44,23,21,53
Linfield,7270,3,11,5,10,42,37,5,38
Glenavon,7270,4,9,10,7,53,44,9,37
Cliftonville,7270,5,9,4,13,33,36,-3,31
Ballymena,7270,6,7,5,14,26,48,-22,26
Glentoran,7270,7,6,6,10,24,32,-8,24
Dungannon,7270,8,2,4,16,14,47,-33,10
Crusaders,7271,1,17,6,3,62,30,32,57
Coleraine,7271,2,15,10,1,46,24,22,55
Glenavon,7271,3,9,9,8,54,46,8,36
Linfield,7271,4,10,5,11,39,40,-1,35
Cliftonville,7271,5,10,4,12,36,33,3,34
Ballymena,7271,6,7,4,15,25,48,-23,25
Glentoran,7271,7,6,6,10,24,32,-8,24
Dungannon,7271,8,2,4,16,14,47,-33,10
Crusaders,7272,1,17,6,3,64,30,34,57
Coleraine,7272,2,14,10,2,44,24,20,52
Glenavon,7272,3,10,9,7,54,44,10,39
Linfield,7272,4,10,6,10,38,37,1,36
Cliftonville,7272,5,9,5,12,33,32,1,32
Ballymena,7272,6,7,4,15,25,50,-25,25
Glentoran,7272,7,6,6,10,24,32,-8,24
Dungannon,7272,8,2,4,16,14,47,-33,10
Coleraine,7273,1,15,10,1,45,22,23,55
Crusaders,7273,2,16,6,4,62,32,30,54
Glenavon,7273,3,9,9,8,52,45,7,36
Linfield,7273,4,10,5,11,37,38,-1,35
Cliftonville,7273,5,10,4,12,34,31,3,34
Ballymena,7273,6,8,4,14,27,48,-21,28
Glentoran,7273,7,6,6,10,24,32,-8,24
Dungannon,7273,8,2,4,16,14,47,-33,10
Crusaders,7274,1,17,6,3,64,32,32,57
Coleraine,7274,2,15,10,1,44,22,22,55
Linfield,7274,3,11,5,10,39,36,3,38
Glenavon,7274,4,9,9,8,52,44,8,36
Cliftonville,7274,5,9,4,13,32,33,-1,31
Ballymena,7274,6,7,4,15,27,50,-23,25
Glentoran,7274,7,6,6,10,24,32,-8,24
Dungannon,7274,8,2,4,16,14,47,-33,10
Crusaders,7275,1,17,6,3,65,30,35,57
Coleraine,7275,2,14,10,2,44,24,20,52
Glenavon,7275,3,10,9,7,54,44,10,39
Linfield,7275,4,10,5,11,37,37,0,35
Cliftonville,7275,5,10,4,12,33,31,2,34
Ballymena,7275,6,7,4,15,25,51,-26,25
Glentoran,7275,7,6,6,10,24,32,-8,24
Dungannon,7275,8,2,4,16,14,47,-33,10
Crusaders,7276,1,17,6,3,66,33,33,57
Coleraine,7276,2,15,10,1,45,23,22,55
Glenavon,7276,3,9,9,8,53,45,8,36
Linfield,7276,4,10,6,10,37,36,1,36
Cliftonville,7276,5,9,5,12,32,31,1,32
Ballymena,7276,6,7,4,15,28,52,-24,25
Glentoran,7276,7,6,6,10,24,32,-8,24
Dungannon,7276,8,2,4,16,14,47,-33,10
Crusaders,7277,1,16,6,4,62,32,30,54
Coleraine,7277,2,14,11,1,45,24,21,53
Linfield,7277,3,11,5,10,40,36,4,38
Glenavon,7277,4,9,10,7,54,45,9,37
Cliftonville,7277,5,9,4,13,32,34,-2,31
Ballymena,7277,6,8,4,14,27,48,-21,28
Glentoran,7277,7,6,6,10,24,32,-8,24
Dungannon,7277,8,2,4,16,14,47,-33,10
Crusaders,7278,1,17,6,3,65,30,35,57
Coleraine,7278,2,15,10,1,45,22,23,55
Linfield,7278,3,11,5,10,39,37,2,38
Glenavon,7278,4,9,9,8,52,45,7,36
Cliftonville,7278,5,9,4,13,33,33,0,31
Ballymena,7278,6,7,4,15,25,51,-26,25
Glentoran,7278,7,6,6,10,24,32,-8,24
Dungannon,7278,8,2,4,16,14,47,-33,10
Crusaders,7279,1,17,6,3,63,31,32,57
Coleraine,7279,2,15,10,1,44,22,22,55
Glenavon,7279,3,9,9,8,52,44,8,36
Linfield,7279,4,10,5,11,37,37,0,35
Cliftonville,7279,5,10,4,12,33,31,2,34
Ballymena,7279,6,7,4,15,26,49,-23,25
Glentoran,7279,7,6,6,10,24,32,-8,24
Dungannon,7279,8,2,4,16,14,47,-33,10
Crusaders,7280,1,16,7,3,63,32,31,55
Coleraine,7280,2,14,10,2,43,25,18,52
Glenavon,7280,3,10,9,7,55,43,12,39
Linfield,7280,4,11,5,10,39,36,3,38
Cliftonville,7280,5,9,4,13,32,33,-1,31
Ballymena,7280,6,7,5,14,27,49,-22,26
Glentoran,7280,7,6,6,10,24,32,-8,24
Dungannon,7280,8,2,4,16,14,47,-33,10
Crusaders,7281,1,17,6,3,62,30,32,57
Coleraine,7281,2,15,10,1,45,23,22,55
Linfield,7281,3,11,5,10,38,36,2,38
Glenavon,7281,4,9,9,8,53,45,8,36
Cliftonville,7281,5,9,4,13,32,32,0,31
Ballymena,7281,6,7,4,15,25,48,-23,25
Glentoran,7281,7,6,6,10,24,32,-8,24
Dungannon,7281,8,2,4,16,14,47,-33,10
Crusaders,7282,1,16,7,3,64,33,31,55
Coleraine,7282,2,15,10,1,44,22,22,55
Linfield,7282,3,11,5,10,41,38,3,38
Glenavon,7282,4,9,9,8,52,44,8,36
Cliftonville,7282,5,9,4,13,34,35,-1,31
Ballymena,7282,6,7,5,14,28,50,-22,26
Glentoran,7282,7,6,6,10,24,32,-8,24
Dungannon,7282,8,2,4,16,14,47,-33,10
Crusaders,7283,1,17,6,3,63,31,32,57
Coleraine,7283,2,14,10,2,43,23,20,52
Glenavon,7283,3,10,9,7,53,43,10,39
Linfield,7283,4,10,5,11,37,39,-2,35
Cliftonville,7283,5,10,4,12,35,31,4,34
Ballymena,7283,6,7,4,15,26,49,-23,25
Glentoran,7283,7,6,6,10,24,32,-8,24
Dungannon,7283,8,2,4,16,14,47,-33,10
Crusaders,7284,1,17,6,3,64,32,32,57
Coleraine,7284,2,15,10,1,45,23,22,55
Linfield,7284,3,11,5,10,40,37,3,38
Glenavon,7284,4,9,9,8,53,45,8,36
Cliftonville,7284,5,9,4,13,33,34,-1,31
Ballymena,7284,6,7,4,15,27,50,-23,25
Glentoran,7284,7,6,6,10,24,32,-8,24
Dungannon,7284,8,2,4,16,14,47,-33,10
Crusaders,7285,1,16,7,3,62,31,31,55
Coleraine,7285,2,14,10,2,43,23,20,52
Glenavon,7285,3,10,9,7,53,43,10,39
Linfield,7285,4,10,5,11,37,37,0,35
Cliftonville,7285,5,10,4,12,33,31,2,34
Ballymena,7285,6,7,5,14,26,48,-22,26
Glentoran,7285,7,6,6,10,24,32,-8,24
Dungannon,7285,8,2,4,16,14,47,-33,10
Crusaders,7286,1,16,7,3,63,32,31,55
Coleraine,7286,2,14,11,1,45,24,21,53
Glenavon,7286,3,9,10,7,54,45,9,37
Linfield,7286,4,10,5,11,39,39,0,35
Cliftonville,7286,5,10,4,12,35,33,2,34
Ballymena,7286,6,7,5,14,27,49,-22,26
Glentoran,7286,7,6,6,10,24,32,-8,24
Dungannon,7286,8,2,4,16,14,47,-33,10
Crusaders,7287,1,17,6,3,64,32,32,57
Coleraine,7287,2,14,11,1,43,22,21,53
Linfield,7287,3,11,5,10,39,36,3,38
Glenavon,7287,4,9,10,7,52,43,9,37
Cliftonville,7287,5,9,4,13,32,33,-1,31
Ballymena,7287,6,7,4,15,27,50,-23,25
Glentoran,7287,7,6,6,10,24,32,-8,24
Dungannon,7287,8,2,4,16,14,47,-33,10
Coleraine,7288,1,15,10,1,46,23,23,55
Crusaders,7288,2,16,6,4,61,32,29,54
Linfield,7288,3,11,5,10,41,38,3,38
Glenavon,7288,4,9,9,8,53,46,7,36
Cliftonville,7288,5,9,4,13,34,35,-1,31
Ballymena,7288,6,8,4,14,27,47,-20,28
Glentoran,7288,7,6,6,10,24,32,-8,24
Dungannon,7288,8,2,4,16,14,47,-33,10
Crusaders,7289,1,17,6,3,63,31,32,57
Coleraine,7289,2,15,10,1,46,23,23,55
Linfield,7289,3,11,5,10,38,36,2,38
Glenavon,7289,4,9,9,8,53,46,7,36
Cliftonville,7289,5,9,4,13,32,32,0,31
Ballymena,7289,6,7,4,15,26,49,-23,25
Glentoran,7289,7,6,6,10,24,32,-8,24
Dungannon,7289,8,2,4,16,14,47,-33,10
Crusaders,7290,1,17,6,3,63,30,33,57
Coleraine,7290,2,14,11,1,44,23,21,53
Glenavon,7290,3,9,10,7,53,44,9,37
Linfield,7290,4,10,6,10,40,39,1,36
Cliftonville,7290,5,9,5,12,35,34,1,32
Ballymena,7290,6,7,4,15,25,49,-24,25
Glentoran,7290,7,6,6,10,24,32,-8,24
Dungannon,7290,8,2,4,16,14,47,-33,10
Crusaders,7291,1,16,7,3,62,31,31,55
Coleraine,7291,2,14,11,1,43,22,21,53
Linfield,7291,3,11,5,10,40,37,3,38
Glenavon,7291,4,9,10,7,52,43,9,37
Cliftonville,7291,5,9,4,13,33,34,-1,31
Ballymena,7291,6,7,5,14,26,48,-22,26
Glentoran,7291,7,6,6,10,24,32,-8,24
Dungannon,7291,8,2,4,16,14,47,-33,10
Crusaders,7292,1,16,7,3,62,31,31,55
Coleraine,7292,2,14,10,2,44,24,20,52
Glenavon,7292,3,10,9,7,54,44,10,39
Linfield,7292,4,11,5,10,39,37,2,38
Cliftonville,7292,5,9,4,13,33,33,0,31
Ballymena,7292,6,7,5,14,26,48,-22,26
Glentoran,7292,7,6,6,10,24,32,-8,24
Dungannon,7292,8,2,4,16,14,47,-33,10
Crusaders,7293,1,17,6,3,65,31,34,57
Coleraine,7293,2,14,11,1,44,23,21,53
Glenavon,7293,3,9,10,7,53,44,9,37
Linfield,7293,4,10,6,10,37,36,1,36
Cliftonville,7293,5,9,5,12,32,31,1,32
Ballymena,7293,6,7,4,15,26,51,-25,25
Glentoran,7293,7,6,6,10,24,32,-8,24
Dungannon,7293,8,2,4,16,14,47,-33,10
Crusaders,7294,1,17,6,3,65,30,35,57
Coleraine,7294,2,14,10,2,43,26,17,52
Glenavon,7294,3,10,9,7,56,43,13,39
Linfield,7294,4,10,5,11,37,37,0,35
Cliftonville,7294,5,10,4,12,33,31,2,34
Ballymena,7294,6,7,4,15,25,51,-26,25
Glentoran,7294,7,6,6,10,24,32,-8,24
Dungannon,7294,8,2,4,16,14,47,-33,10
Coleraine,7295,1,15,10,1,46,24,22,55
Crusaders,7295,2,16,6,4,61,31,30,54
Linfield,7295,3,11,5,10,39,36,3,38
Glenavon,7295,4,9,9,8,54,46,8,36
Cliftonville,7295,5,9,4,13,32,33,-1,31
Ballymena,7295,6,8,4,14,26,47,-21,28
Glentoran,7295,7,6,6,10,24,32,-8,24
Dungannon,7295,8,2,4,16,14,47,-33,10
Crusaders,7296,1,17,6,3,64,31,33,57
Coleraine,7296,2,15,10,1,46,23,23,55
Glenavon,7296,3,9,9,8,53,46,7,36
Linfield,7296,4,10,5,11,37,38,-1,35
Cliftonville,7296,5,10,4,12,34,31,3,34
Ballymena,7296,6,7,4,15,26,50,-24,25
Glentoran,7296,7,6,6,10,24,32,-8,24
Dungannon,7296,8,2,4,16,14,47,-33,10
Crusaders,7297,1,17,6,3,66,30,36,57
Coleraine,7297,2,14,10,2,43,26,17,52
Glenavon,7297,3,10,9,7,56,43,13,39
Linfield,7297,4,10,6,10,38,37,1,36
Cliftonville,7297,5,9,5,12,33,32,1,32
Ballymena,7297,6,7,4,15,25,52,-27,25
Glentoran,7297,7,6,6,10,24,32,-8,24
Dungannon,7297,8,2,4,16,14,47,-33,10
Crusaders,7298,1,17,6,3,67,30,37,57
Coleraine,7298,2,14,10,2,44,24,20,52
Glenavon,7298,3,10,9,7,54,44,10,39
Linfield,7298,4,11,5,10,39,36,3,38
Cliftonville,7298,5,9,4,13,32,33,-1,31
Ballymena,7298,6,7,4,15,25,53,-28,25
Glentoran,7298,7,6,6,10,24,32,-8,24
Dungannon,7298,8,2,4,16,14,47,-33,10
Crusaders,7299,1,17,6,3,63,30,33,57
Coleraine,7299,2,15,10,1,46,24,22,55
Glenavon,7299,3,9,9,8,54,46,8,36
Linfield,7299,4,10,6,10,38,37,1,36
Cliftonville,7299,5,9,5,12,33,32,1,32
Ballymena,7299,6,7,4,15,25,49,-24,25
Glentoran,7299,7,6,6,10,24,32,-8,24
Dungannon,7299,8,2,4,16,14,47,-33,10
Crusaders,7300,1,17,6,3,65,32,33,57
Coleraine,7300,2,15,10,1,46,23,23,55
Linfield,7300,3,11,5,10,38,36,2,38
Glenavon,7300,4,9,9,8,53,46,7,36
Cliftonville,7300,5,9,4,13,32,32,0,31
Ballymena,7300,6,7,4,15,27,51,-24,25
Glentoran,7300,7,6,6,10,24,32,-8,24
Dungannon,7300,8,2,4,16,14,47,-33,10
Crusaders,7301,1,17,6,3,64,31,33,57
Coleraine,7301,2,14,10,2,44,24,20,52
Glenavon,7301,3,10,9,7,54,44,10,39
Linfield,7301,4,11,5,10,38,36,2,38
Cliftonville,7301,5,9,4,13,32,32,0,31
Ballymena,7301,6,7,4,15,26,50,-24,25
Glentoran,7301,7,6,6,10,24,32,-8,24
Dungannon,7301,8,2,4,16,14,47,-33,10
Crusaders,7302,1,16,7,3,63,32,31,55
Coleraine,7302,2,14,11,1,44,23,21,53
Glenavon,7302,3,9,10,7,53,44,9,37
Linfield,7302,4,10,6,10,38,37,1,36
Cliftonville,7302,5,9,5,12,33,32,1,32
Ballymena,7302,6,7,5,14,27,49,-22,26
Glentoran,7302,7,6,6,10,24,32,-8,24
Dungannon,7302,8,2,4,16,14,47,-33,10
Crusaders,7303,1,17,6,3,64,31,33,57
Coleraine,7303,2,14,10,2,43,23,20,52
Glenavon,7303,3,10,9,7,53,43,10,39
Linfield,7303,4,11,5,10,40,38,2,38
Cliftonville,7303,5,9,4,13,34,34,0,31
Ballymena,7303,6,7,4,15,26,50,-24,25
Glentoran,7303,7,6,6,10,24,32,-8,24
Dungannon,7303,8,2,4,16,14,47,-33,10
Crusaders,7304,1,16,6,4,63,33,30,54
Coleraine,7304,2,14,10,2,45,25,20,52
Glenavon,7304,3,10,9,7,55,45,10,39
Linfield,7304,4,10,6,10,38,37,1,36
Cliftonville,7304,5,9,5,12,33,32,1,32
Ballymena,7304,6,8,4,14,28,49,-21,28
Glentoran,7304,7,6,6,10,24,32,-8,24
Dungannon,7304,8,2,4,16,14,47,-33,10
Crusaders,7305,1,16,6,4,62,32,30,54
Coleraine,7305,2,14,11,1,44,23,21,53
Glenavon,7305,3,9,10,7,53,44,9,37
Linfield,7305,4,10,6,10,37,36,1,36
Cliftonville,7305,5,9,5,12,32,31,1,32
Ballymena,7305,6,8,4,14,27,48,-21,28
Glentoran,7305,7,6,6,10,24,32,-8,24
Dungannon,7305,8,2,4,16,14,47,-33,10
Coleraine,7306,1,15,10,1,46,22,24,55
Crusaders,7306,2,16,6,4,62,33,29,54
Glenavon,7306,3,9,9,8,52,46,6,36
Linfield,7306,4,10,6,10,39,38,1,36
Cliftonville,7306,5,9,5,12,34,33,1,32
Ballymena,7306,6,8,4,14,28,48,-20,28
Glentoran,7306,7,6,6,10,24,32,-8,24
Dungannon,7306,8,2,4,16,14,47,-33,10
Crusaders,7307,1,17,6,3,65,32,33,57
Coleraine,7307,2,14,10,2,43,24,19,52
Glenavon,7307,3,10,9,7,54,43,11,39
Linfield,7307,4,10,5,11,37,39,-2,35
Cliftonville,7307,5,10,4,12,35,31,4,34
Ballymena,7307,6,7,4,15,27,51,-24,25
Glentoran,7307,7,6,6,10,24,32,-8,24
Dungannon,7307,8,2,4,16,14,47,-33,10
Crusaders,7308,1,17,6,3,64,30,34,57
Coleraine,7308,2,15,10,1,46,23,23,55
Linfield,7308,3,11,5,10,40,37,3,38
Glenavon,7308,4,9,9,8,53,46,7,36
Cliftonville,7308,5,9,4,13,33,34,-1,31
Ballymena,7308,6,7,4,15,25,50,-25,25
Glentoran,7308,7,6,6,10,24,32,-8,24
Dungannon,7308,8,2,4,16,14,47,-33,10
Crusaders,7309,1,16,7,3,64,33,31,55
Coleraine,7309,2,14,10,2,43,23,20,52
Glenavon,7309,3,10,9,7,53,43,10,39
Linfield,7309,4,11,5,10,38,36,2,38
Cliftonville,7309,5,9,4,13,32,32,0,31
Ballymena,7309,6,7,5,14,28,50,-22,26
Glentoran,7309,7,6,6,10,24,32,-8,24
Dungannon,7309,8,2,4,16,14,47,-33,10
Crusaders,7310,1,17,6,3,65,30,35,57
Coleraine,7310,2,14,11,1,44,23,21,53
Glenavon,7310,3,9,10,7,53,44,9,37
Linfield,7310,4,10,6,10,38,37,1,36
Cliftonville,7310,5,9,5,12,33,32,1,32
Ballymena,7310,6,7,4,15,25,51,-26,25
Glentoran,7310,7,6,6,10,24,32,-8,24
Dungannon,7310,8,2,4,16,14,47,-33,10
Crusaders,7311,1,17,6,3,64,32,32,57
Coleraine,7311,2,14,10,2,45,26,19,52
Glenavon,7311,3,10,9,7,56,45,11,39
Linfield,7311,4,10,5,11,38,38,0,35
Cliftonville,7311,5,10,4,12,34,32,2,34
Ballymena,7311,6,7,4,15,27,50,-23,25
Glentoran,7311,7,6,6,10,24,32,-8,24
Dungannon,7311,8,2,4,16,14,47,-33,10
Crusaders,7312,1,17,6,3,64,32,32,57
Coleraine,7312,2,14,11,1,44,23,21,53
Glenavon,7312,3,9,10,7,53,44,9,37
Linfield,7312,4,10,5,11,38,38,0,35
Cliftonville,7312,5,10,4,12,34,32,2,34
Ballymena,7312,6,7,4,15,27,50,-23,25
Glentoran,7312,7,6,6,10,24,32,-8,24
Dungannon,7312,8,2,4,16,14,47,-33,10
Crusaders,7313,1,16,7,3,62,31,31,55
Coleraine,7313,2,15,10,1,44,22,22,55
Linfield,7313,3,11,5,10,41,37,4,38
Glenavon,7313,4,9,9,8,52,44,8,36
Cliftonville,7313,5,9,4,13,33,35,-2,31
Ballymena,7313,6,7,5,14,26,48,-22,26
Glentoran,7313,7,6,6,10,24,32,-8,24
Dungannon,7313,8,2,4,16,14,47,-33,10
Crusaders,7314,1,16,7,3,62,31,31,55
Coleraine,7314,2,15,10,1,45,22,23,55
Linfield,7314,3,11,5,10,40,37,3,38
Glenavon,7314,4,9,9,8,52,45,7,36
Cliftonville,7314,5,9,4,13,33,34,-1,31
Ballymena,7314,6,7,5,14,26,48,-22,26
Glentoran,7314,7,6,6,10,24,32,-8,24
Dungannon,7314,8,2,4,16,14,47,-33,10
Crusaders,7315,1,17,6,3,62,30,32,57
Coleraine,7315,2,14,11,1,44,23,21,53
Glenavon,7315,3,9,10,7,53,44,9,37
Linfield,7315,4,10,5,11,38,38,0,35
Cliftonville,7315,5,10,4,12,34,32,2,34
Ballymena,7315,6,7,4,15,25,48,-23,25
Glentoran,7315,7,6,6,10,24,32,-8,24
Dungannon,7315,8,2,4,16,14,47,-33,10
Crusaders,7316,1,16,6,4,62,32,30,54
Coleraine,7316,2,14,10,2,43,23,20,52
Glenavon,7316,3,10,9,7,53,43,10,39
Linfield,7316,4,11,5,10,39,36,3,38
Cliftonville,7316,5,9,4,13,32,33,-1,31
Ballymena,7316,6,8,4,14,27,48,-21,28
Glentoran,7316,7,6,6,10,24,32,-8,24
Dungannon,7316,8,2,4,16,14,47,-33,10
Crusaders,7317,1,17,6,3,65,30,35,57
Coleraine,7317,2,14,11,1,43,22,21,53
Linfield,7317,3,11,5,10,38,36,2,38
Glenavon,7317,4,9,10,7,52,43,9,37
Cliftonville,7317,5,9,4,13,32,32,0,31
Ballymena,7317,6,7,4,15,25,51,-26,25
Glentoran,7317,7,6,6,10,24,32,-8,24
Dungannon,7317,8,2,4,16,14,47,-33,10
Crusaders,7318,1,16,6,4,61,33,28,54
Coleraine,7318,2,14,10,2,45,25,20,52
Glenavon,7318,3,10,9,7,55,45,10,39
Linfield,7318,4,10,6,10,38,37,1,36
Cliftonville,7318,5,9,5,12,33,32,1,32
Ballymena,7318,6,8,4,14,28,47,-19,28
Glentoran,7318,7,6,6,10,24,32,-8,24
Dungannon,7318,8,2,4,16,14,47,-33,10
Coleraine,7319,1,15,10,1,45,22,23,55
Crusaders,7319,2,16,6,4,62,32,30,54
Glenavon,7319,3,9,9,8,52,45,7,36
Linfield,7319,4,10,5,11,40,40,0,35
Cliftonville,7319,5,10,4,12,36,34,2,34
Ballymena,7319,6,8,4,14,27,48,-21,28
Glentoran,7319,7,6,6,10,24,32,-8,24
Dungannon,7319,8,2,4,16,14,47,-33,10
Crusaders,7320,1,16,7,3,61,30,31,55
Coleraine,7320,2,14,10,2,43,25,18,52
Glenavon,7320,3,10,9,7,55,43,12,39
Linfield,7320,4,10,5,11,37,39,-2,35
Cliftonville,7320,5,10,4,12,35,31,4,34
Ballymena,7320,6,7,5,14,25,47,-22,26
Glentoran,7320,7,6,6,10,24,32,-8,24
Dungannon,7320,8,2,4,16,14,47,-33,10
Crusaders,7321,1,16,6,4,62,36,26,54
Coleraine,7321,2,14,10,2,44,25,19,52
Glenavon,7321,3,10,9,7,55,44,11,39
Linfield,7321,4,11,5,10,39,37,2,38
Cliftonville,7321,5,9,4,13,33,33,0,31
Ballymena,7321,6,8,4,14,31,48,-17,28
Glentoran,7321,7,6,6,10,24,32,-8,24
Dungannon,7321,8,2,4,16,14,47,-33,10
Crusaders,7322,1,16,7,3,62,31,31,55
Coleraine,7322,2,15,10,1,46,24,22,55
Glenavon,7322,3,9,9,8,54,46,8,36
Linfield,7322,4,10,5,11,37,37,0,35
Cliftonville,7322,5,10,4,12,33,31,2,34
Ballymena,7322,6,7,5,14,26,48,-22,26
Glentoran,7322,7,6,6,10,24,32,-8,24
Dungannon,7322,8,2,4,16,14,47,-33,10
Crusaders,7323,1,17,6,3,63,30,33,57
Coleraine,7323,2,14,10,2,44,24,20,52
Glenavon,7323,3,10,9,7,54,44,10,39
Linfield,7323,4,11,5,10,43,38,5,38
Cliftonville,7323,5,9,4,13,34,37,-3,31
Ballymena,7323,6,7,4,15,25,49,-24,25
Glentoran,7323,7,6,6,10,24,32,-8,24
Dungannon,7323,8,2,4,16,14,47,-33,10
Crusaders,7324,1,16,6,4,63,34,29,54
Coleraine,7324,2,14,11,1,44,23,21,53
Glenavon,7324,3,9,10,7,53,44,9,37
Linfield,7324,4,10,6,10,37,36,1,36
Cliftonville,7324,5,9,5,12,32,31,1,32
Ballymena,7324,6,8,4,14,29,49,-20,28
Glentoran,7324,7,6,6,10,24,32,-8,24
Dungannon,7324,8,2,4,16,14,47,-33,10
Crusaders,7325,1,17,6,3,62,30,32,57
Coleraine,7325,2,14,10,2,44,24,20,52
Glenavon,7325,3,10,9,7,54,44,10,39
Linfield,7325,4,11,5,10,39,36,3,38
Cliftonville,7325,5,9,4,13,32,33,-1,31
Ballymena,7325,6,7,4,15,25,48,-23,25
Glentoran,7325,7,6,6,10,24,32,-8,24
Dungannon,7325,8,2,4,16,14,47,-33,10
Crusaders,7326,1,17,6,3,65,30,35,57
Coleraine,7326,2,14,10,2,43,23,20,52
Glenavon,7326,3,10,9,7,53,43,10,39
Linfield,7326,4,10,5,11,39,39,0,35
Cliftonville,7326,5,10,4,12,35,33,2,34
Ballymena,7326,6,7,4,15,25,51,-26,25
Glentoran,7326,7,6,6,10,24,32,-8,24
Dungannon,7326,8,2,4,16,14,47,-33,10
Crusaders,7327,1,17,6,3,63,31,32,57
Coleraine,7327,2,15,10,1,44,22,22,55
Glenavon,7327,3,9,9,8,52,44,8,36
Linfield,7327,4,10,6,10,37,36,1,36
Cliftonville,7327,5,9,5,12,32,31,1,32
Ballymena,7327,6,7,4,15,26,49,-23,25
Glentoran,7327,7,6,6,10,24,32,-8,24
Dungannon,7327,8,2,4,16,14,47,-33,10
Crusaders,7328,1,17,6,3,62,30,32,57
Coleraine,7328,2,14,10,2,47,27,20,52
Glenavon,7328,3,10,9,7,57,47,10,39
Linfield,7328,4,11,5,10,39,37,2,38
Cliftonville,7328,5,9,4,13,33,33,0,31
Ballymena,7328,6,7,4,15,25,48,-23,25
Glentoran,7328,7,6,6,10,24,32,-8,24
Dungannon,7328,8,2,4,16,14,47,-33,10
Crusaders,7329,1,17,6,3,62,30,32,57
Coleraine,7329,2,15,10,1,44,22,22,55
Linfield,7329,3,11,5,10,42,37,5,38
Glenavon,7329,4,9,9,8,52,44,8,36
Cliftonville,7329,5,9,4,13,33,36,-3,31
Ballymena,7329,6,7,4,15,25,48,-23,25
Glentoran,7329,7,6,6,10,24,32,-8,24
Dungannon,7329,8,2,4,16,14,47,-33,10
Crusaders,7330,1,16,7,3,63,32,31,55
Coleraine,7330,2,14,10,2,45,26,19,52
Glenavon,7330,3,10,9,7,56,45,11,39
Linfield,7330,4,11,5,10,38,36,2,38
Cliftonville,7330,5,9,4,13,32,32,0,31
Ballymena,7330,6,7,5,14,27,49,-22,26
Glentoran,7330,7,6,6,10,24,32,-8,24
Dungannon,7330,8,2,4,16,14,47,-33,10
Crusaders,7331,1,16,7,3,61,30,31,55
Coleraine,7331,2,14,10,2,44,24,20,52
Glenavon,7331,3,10,9,7,54,44,10,39
Linfield,7331,4,10,5,11,38,38,0,35
Cliftonville,7331,5,10,4,12,34,32,2,34
Ballymena,7331,6,7,5,14,25,47,-22,26
Glentoran,7331,7,6,6,10,24,32,-8,24
Dungannon,7331,8,2,4,16,14,47,-33,10
Crusaders,7332,1,16,7,3,62,31,31,55
Coleraine,7332,2,14,11,1,43,22,21,53
Linfield,7332,3,11,5,10,38,36,2,38
Glenavon,7332,4,9,10,7,52,43,9,37
Cliftonville,7332,5,9,4,13,32,32,0,31
Ballymena,7332,6,7,5,14,26,48,-22,26
Glentoran,7332,7,6,6,10,24,32,-8,24
Dungannon,7332,8,2,4,16,14,47,-33,10
Crusaders,7333,1,17,6,3,66,32,34,57
Coleraine,7333,2,15,10,1,47,22,25,55
Linfield,7333,3,11,5,10,39,36,3,38
Glenavon,7333,4,9,9,8,52,47,5,36
Cliftonville,7333,5,9,4,13,32,33,-1,31
Ballymena,7333,6,7,4,15,27,52,-25,25
Glentoran,7333,7,6,6,10,24,32,-8,24
Dungannon,7333,8,2,4,16,14,47,-33,10
Crusaders,7334,1,17,6,3,65,31,34,57
Coleraine,7334,2,14,10,2,43,25,18,52
Glenavon,7334,3,10,9,7,55,43,12,39
Linfield,7334,4,10,5,11,38,38,0,35
Cliftonville,7334,5,10,4,12,34,32,2,34
Ballymena,7334,6,7,4,15,26,51,-25,25
Glentoran,7334,7,6,6,10,24,32,-8,24
Dungannon,7334,8,2,4,16,14,47,-33,10
Crusaders,7335,1,17,6,3,65,32,33,57
Coleraine,7335,2,15,10,1,45,22,23,55
Glenavon,7335,3,9,9,8,52,45,7,36
Linfield,7335,4,10,5,11,39,39,0,35
Cliftonville,7335,5,10,4,12,35,33,2,34
Ballymena,7335,6,7,4,15,27,51,-24,25
Glentoran,7335,7,6,6,10,24,32,-8,24
Dungannon,7335,8,2,4,16,14,47,-33,10
Crusaders,7336,1,17,6,3,65,31,34,57
Coleraine,7336,2,14,10,2,44,24,20,52
Glenavon,7336,3,10,9,7,54,44,10,39
Linfield,7336,4,10,6,10,39,38,1,36
Cliftonville,7336,5,9,5,12,34,33,1,32
Ballymena,7336,6,7,4,15,26,51,-25,25
Glentoran,7336,7,6,6,10,24,32,-8,24
Dungannon,7336,8,2,4,16,14,47,-33,10
Crusaders,7337,1,17,6,3,64,30,34,57
Coleraine,7337,2,15,10,1,45,23,22,55
Glenavon,7337,3,9,9,8,53,45,8,36
Linfield,7337,4,10,6,10,37,36,1,36
Cliftonville,7337,5,9,5,12,32,31,1,32
Ballymena,7337,6,7,4,15,25,50,-25,25
Glentoran,7337,7,6,6,10,24,32,-8,24
Dungannon,7337,8,2,4,16,14,47,-33,10
Crusaders,7338,1,17,6,3,63,30,33,57
Coleraine,7338,2,14,10,2,43,25,18,52
Glenavon,7338,3,10,9,7,55,43,12,39
Linfield,7338,4,10,6,10,38,37,1,36
Cliftonville,7338,5,9,5,12,33,32,1,32
Ballymena,7338,6,7,4,15,25,49,-24,25
Glentoran,7338,7,6,6,10,24,32,-8,24
Dungannon,7338,8,2,4,16,14,47,-33,10
Crusaders,7339,1,16,7,3,63,32,31,55
Coleraine,7339,2,14,10,2,44,24,20,52
Glenavon,7339,3,10,9,7,54,44,10,39
Linfield,7339,4,10,6,10,37,36,1,36
Cliftonville,7339,5,9,5,12,32,31,1,32
Ballymena,7339,6,7,5,14,27,49,-22,26
Glentoran,7339,7,6,6,10,24,32,-8,24
Dungannon,7339,8,2,4,16,14,47,-33,10
Crusaders,7340,1,17,6,3,65,33,32,57
Coleraine,7340,2,14,10,2,43,23,20,52
Glenavon,7340,3,10,9,7,53,43,10,39
Linfield,7340,4,10,5,11,38,40,-2,35
Cliftonville,7340,5,10,4,12,36,32,4,34
Ballymena,7340,6,7,4,15,28,51,-23,25
Glentoran,7340,7,6,6,10,24,32,-8,24
Dungannon,7340,8,2,4,16,14,47,-33,10
Crusaders,7341,1,17,6,3,65,30,35,57
Coleraine,7341,2,14,11,1,44,23,21,53
Glenavon,7341,3,9,10,7,53,44,9,37
Linfield,7341,4,10,5,11,38,39,-1,35
Cliftonville,7341,5,10,4,12,35,32,3,34
Ballymena,7341,6,7,4,15,25,51,-26,25
Glentoran,7341,7,6,6,10,24,32,-8,24
Dungannon,7341,8,2,4,16,14,47,-33,10
Crusaders,7342,1,17,6,3,65,32,33,57
Coleraine,7342,2,14,11,1,45,24,21,53
Linfield,7342,3,11,5,10,39,37,2,38
Glenavon,7342,4,9,10,7,54,45,9,37
Cliftonville,7342,5,9,4,13,33,33,0,31
Ballymena,7342,6,7,4,15,27,51,-24,25
Glentoran,7342,7,6,6,10,24,32,-8,24
Dungannon,7342,8,2,4,16,14,47,-33,10
Crusaders,7343,1,16,6,4,62,32,30,54
Coleraine,7343,2,14,10,2,44,25,19,52
Glenavon,7343,3,10,9,7,55,44,11,39
Linfield,7343,4,10,5,11,38,38,0,35
Cliftonville,7343,5,10,4,12,34,32,2,34
Ballymena,7343,6,8,4,14,27,48,-21,28
Glentoran,7343,7,6,6,10,24,32,-8,24
Dungannon,7343,8,2,4,16,14,47,-33,10
Crusaders,7344,1,17,6,3,65,30,35,57
Coleraine,7344,2,15,10,1,44,22,22,55
Glenavon,7344,3,9,9,8,52,44,8,36
Linfield,7344,4,10,5,11,37,39,-2,35
Cliftonville,7344,5,10,4,12,35,31,4,34
Ballymena,7344,6,7,4,15,25,51,-26,25
Glentoran,7344,7,6,6,10,24,32,-8,24
Dungannon,7344,8,2,4,16,14,47,-33,10
Crusaders,7345,1,17,6,3,63,31,32,57
Coleraine,7345,2,14,10,2,44,24,20,52
Glenavon,7345,3,10,9,7,54,44,10,39
Linfield,7345,4,11,5,10,39,36,3,38
Cliftonville,7345,5,9,4,13,32,33,-1,31
Ballymena,7345,6,7,4,15,26,49,-23,25
Glentoran,7345,7,6,6,10,24,32,-8,24
Dungannon,7345,8,2,4,16,14,47,-33,10
Crusaders,7346,1,17,6,3,64,30,34,57
Coleraine,7346,2,14,11,1,44,23,21,53
Linfield,7346,3,11,5,10,39,37,2,38
Glenavon,7346,4,9,10,7,53,44,9,37
Cliftonville,7346,5,9,4,13,33,33,0,31
Ballymena,7346,6,7,4,15,25,50,-25,25
Glentoran,7346,7,6,6,10,24,32,-8,24
Dungannon,7346,8,2,4,16,14,47,-33,10
Crusaders,7347,1,17,6,3,63,30,33,57
Coleraine,7347,2,14,10,2,45,26,19,52
Glenavon,7347,3,10,9,7,56,45,11,39
Linfield,7347,4,10,6,10,39,38,1,36
Cliftonville,7347,5,9,5,12,34,33,1,32
Ballymena,7347,6,7,4,15,25,49,-24,25
Glentoran,7347,7,6,6,10,24,32,-8,24
Dungannon,7347,8,2,4,16,14,47,-33,10
Crusaders,7348,1,17,6,3,64,31,33,57
Coleraine,7348,2,14,10,2,45,25,20,52
Glenavon,7348,3,10,9,7,55,45,10,39
Linfield,7348,4,10,5,11,37,38,-1,35
Cliftonville,7348,5,10,4,12,34,31,3,34
Ballymena,7348,6,7,4,15,26,50,-24,25
Glentoran,7348,7,6,6,10,24,32,-8,24
Dungannon,7348,8,2,4,16,14,47,-33,10
Coleraine,7349,1,15,10,1,45,23,22,55
Crusaders,7349,2,16,6,4,61,32,29,54
Linfield,7349,3,11,5,10,40,38,2,38
Glenavon,7349,4,9,9,8,53,45,8,36
Cliftonville,7349,5,9,4,13,34,34,0,31
Ballymena,7349,6,8,4,14,27,47,-20,28
Glentoran,7349,7,6,6,10,24,32,-8,24
Dungannon,7349,8,2,4,16,14,47,-33,10
Crusaders,7350,1,17,6,3,63,30,33,57
Coleraine,7350,2,15,10,1,47,22,25,55
Linfield,7350,3,11,5,10,38,36,2,38
Glenavon,7350,4,9,9,8,52,47,5,36
Cliftonville,7350,5,9,4,13,32,32,0,31
Ballymena,7350,6,7,4,15,25,49,-24,25
Glentoran,7350,7,6,6,10,24,32,-8,24
Dungannon,7350,8,2,4,16,14,47,-33,10
Crusaders,7351,1,17,6,3,64,30,34,57
Coleraine,7351,2,15,10,1,45,22,23,55
Glenavon,7351,3,9,9,8,52,45,7,36
Linfield,7351,4,10,5,11,37,38,-1,35
Cliftonville,7351,5,10,4,12,34,31,3,34
Ballymena,7351,6,7,4,15,25,50,-25,25
Glentoran,7351,7,6,6,10,24,32,-8,24
Dungannon,7351,8,2,4,16,14,47,-33,10
Crusaders,7352,1,16,6,4,61,32,29,54
Coleraine,7352,2,14,11,1,44,23,21,53
Linfield,7352,3,11,5,10,41,37,4,38
Glenavon,7352,4,9,10,7,53,44,9,37
Cliftonville,7352,5,9,4,13,33,35,-2,31
Ballymena,7352,6,8,4,14,27,47,-20,28
Glentoran,7352,7,6,6,10,24,32,-8,24
Dungannon,7352,8,2,4,16,14,47,-33,10
Crusaders,7353,1,16,6,4,61,32,29,54
Coleraine,7353,2,14,10,2,43,23,20,52
Glenavon,7353,3,10,9,7,53,43,10,39
Linfield,7353,4,11,5,10,39,36,3,38
Cliftonville,7353,5,9,4,13,32,33,-1,31
Ballymena,7353,6,8,4,14,27,47,-20,28
Glentoran,7353,7,6,6,10,24,32,-8,24
Dungannon,7353,8,2,4,16,14,47,-33,10
Crusaders,7354,1,16,7,3,64,33,31,55
Coleraine,7354,2,14,10,2,43,23,20,52
Glenavon,7354,3,10,9,7,53,43,10,39
Linfield,7354,4,10,6,10,38,37,1,36
Cliftonville,7354,5,9,5,12,33,32,1,32
Ballymena,7354,6,7,5,14,28,50,-22,26
Glentoran,7354,7,6,6,10,24,32,-8,24
Dungannon,7354,8,2,4,16,14,47,-33,10
Crusaders,7355,1,17,6,3,62,30,32,57
Coleraine,7355,2,14,10,2,44,24,20,52
Glenavon,7355,3,10,9,7,54,44,10,39
Linfield,7355,4,10,5,11,37,38,-1,35
Cliftonville,7355,5,10,4,12,34,31,3,34
Ballymena,7355,6,7,4,15,25,48,-23,25
Glentoran,7355,7,6,6,10,24,32,-8,24
Dungannon,7355,8,2,4,16,14,47,-33,10
Crusaders,7356,1,17,6,3,63,30,33,57
Coleraine,7356,2,14,10,2,43,24,19,52
Glenavon,7356,3,10,9,7,54,43,11,39
Linfield,7356,4,10,5,11,37,37,0,35
Cliftonville,7356,5,10,4,12,33,31,2,34
Ballymena,7356,6,7,4,15,25,49,-24,25
Glentoran,7356,7,6,6,10,24,32,-8,24
Dungannon,7356,8,2,4,16,14,47,-33,10
Crusaders,7357,1,16,6,4,64,34,30,54
Coleraine,7357,2,14,11,1,45,24,21,53
Linfield,7357,3,11,5,10,41,37,4,38
Glenavon,7357,4,9,10,7,54,45,9,37
Cliftonville,7357,5,9,4,13,33,35,-2,31
Ballymena,7357,6,8,4,14,29,50,-21,28
Glentoran,7357,7,6,6,10,24,32,-8,24
Dungannon,7357,8,2,4,16,14,47,-33,10
Crusaders,7358,1,17,6,3,65,33,32,57
Coleraine,7358,2,14,10,2,43,23,20,52
Glenavon,7358,3,10,9,7,53,43,10,39
Linfield,7358,4,11,5,10,41,37,4,38
Cliftonville,7358,5,9,4,13,33,35,-2,31
Ballymena,7358,6,7,4,15,28,51,-23,25
Glentoran,7358,7,6,6,10,24,32,-8,24
Dungannon,7358,8,2,4,16,14,47,-33,10
Crusaders,7359,1,17,6,3,63,31,32,57
Coleraine,7359,2,15,10,1,45,23,22,55
Glenavon,7359,3,9,9,8,53,45,8,36
Linfield,7359,4,10,5,11,38,38,0,35
Cliftonville,7359,5,10,4,12,34,32,2,34
Ballymena,7359,6,7,4,15,26,49,-23,25
Glentoran,7359,7,6,6,10,24,32,-8,24
Dungannon,7359,8,2,4,16,14,47,-33,10
Crusaders,7360,1,17,6,3,67,30,37,57
Coleraine,7360,2,15,10,1,45,22,23,55
Linfield,7360,3,11,5,10,39,37,2,38
Glenavon,7360,4,9,9,8,52,45,7,36
Cliftonville,7360,5,9,4,13,33,33,0,31
Ballymena,7360,6,7,4,15,25,53,-28,25
Glentoran,7360,7,6,6,10,24,32,-8,24
Dungannon,7360,8,2,4,16,14,47,-33,10
Crusaders,7361,1,17,6,3,64,30,34,57
Coleraine,7361,2,14,10,2,43,24,19,52
Glenavon,7361,3,10,9,7,54,43,11,39
Linfield,7361,4,10,6,10,39,38,1,36
Cliftonville,7361,5,9,5,12,34,33,1,32
Ballymena,7361,6,7,4,15,25,50,-25,25
Glentoran,7361,7,6,6,10,24,32,-8,24
Dungannon,7361,8,2,4,16,14,47,-33,10
Crusaders,7362,1,16,7,3,64,33,31,55
Coleraine,7362,2,14,10,2,44,24,20,52
Glenavon,7362,3,10,9,7,54,44,10,39
Linfield,7362,4,10,6,10,37,36,1,36
Cliftonville,7362,5,9,5,12,32,31,1,32
Ballymena,7362,6,7,5,14,28,50,-22,26
Glentoran,7362,7,6,6,10,24,32,-8,24
Dungannon,7362,8,2,4,16,14,47,-33,10
Crusaders,7363,1,17,6,3,64,32,32,57
Coleraine,7363,2,14,11,1,43,22,21,53
Linfield,7363,3,11,5,10,38,36,2,38
Glenavon,7363,4,9,10,7,52,43,9,37
Cliftonville,7363,5,9,4,13,32,32,0,31
Ballymena,7363,6,7,4,15,27,50,-23,25
Glentoran,7363,7,6,6,10,24,32,-8,24
Dungannon,7363,8,2,4,16,14,47,-33,10
Crusaders,7364,1,16,6,4,63,33,30,54
Coleraine,7364,2,14,10,2,43,24,19,52
Glenavon,7364,3,10,9,7,54,43,11,39
Linfield,7364,4,11,5,10,39,36,3,38
Cliftonville,7364,5,9,4,13,32,33,-1,31
Ballymena,7364,6,8,4,14,28,49,-21,28
Glentoran,7364,7,6,6,10,24,32,-8,24
Dungannon,7364,8,2,4,16,14,47,-33,10
Crusaders,7365,1,17,6,3,63,31,32,57
Coleraine,7365,2,15,10,1,45,23,22,55
Glenavon,7365,3,9,9,8,53,45,8,36
Linfield,7365,4,10,6,10,38,37,1,36
Cliftonville,7365,5,9,5,12,33,32,1,32
Ballymena,7365,6,7,4,15,26,49,-23,25
Glentoran,7365,7,6,6,10,24,32,-8,24
Dungannon,7365,8,2,4,16,14,47,-33,10
Crusaders,7366,1,17,6,3,62,30,32,57
Coleraine,7366,2,15,10,1,46,24,22,55
Glenavon,7366,3,9,9,8,54,46,8,36
Linfield,7366,4,10,5,11,38,40,-2,35
Cliftonville,7366,5,10,4,12,36,32,4,34
Ballymena,7366,6,7,4,15,25,48,-23,25
Glentoran,7366,7,6,6,10,24,32,-8,24
Dungannon,7366,8,2,4,16,14,47,-33,10
Crusaders,7367,1,16,7,3,63,32,31,55
Coleraine,7367,2,14,11,1,46,25,21,53
Glenavon,7367,3,9,10,7,55,46,9,37
Linfield,7367,4,10,5,11,38,38,0,35
Cliftonville,7367,5,10,4,12,34,32,2,34
Ballymena,7367,6,7,5,14,27,49,-22,26
Glentoran,7367,7,6,6,10,24,32,-8,24
Dungannon,7367,8,2,4,16,14,47,-33,10
Crusaders,7368,1,16,7,3,63,32,31,55
Coleraine,7368,2,14,10,2,43,24,19,52
Glenavon,7368,3,10,9,7,54,43,11,39
Linfield,7368,4,10,5,11,37,39,-2,35
Cliftonville,7368,5,10,4,12,35,31,4,34
Ballymena,7368,6,7,5,14,27,49,-22,26
Glentoran,7368,7,6,6,10,24,32,-8,24
Dungannon,7368,8,2,4,16,14,47,-33,10
Crusaders,7369,1,16,7,3,62,31,31,55
Coleraine,7369,2,15,10,1,46,23,23,55
Linfield,7369,3,11,5,10,40,36,4,38
Glenavon,7369,4,9,9,8,53,46,7,36
Cliftonville,7369,5,9,4,13,32,34,-2,31
Ballymena,7369,6,7,5,14,26,48,-22,26
Glentoran,7369,7,6,6,10,24,32,-8,24
Dungannon,7369,8,2,4,16,14,47,-33,10
Crusaders,7370,1,17,6,3,64,30,34,57
Coleraine,7370,2,14,11,1,44,23,21,53
Glenavon,7370,3,9,10,7,53,44,9,37
Linfield,7370,4,10,6,10,38,37,1,36
Cliftonville,7370,5,9,5,12,33,32,1,32
Ballymena,7370,6,7,4,15,25,50,-25,25
Glentoran,7370,7,6,6,10,24,32,-8,24
Dungannon,7370,8,2,4,16,14,47,-33,10
Crusaders,7371,1,16,7,3,62,31,31,55
Coleraine,7371,2,15,10,1,47,24,23,55
Linfield,7371,3,11,5,10,38,36,2,38
Glenavon,7371,4,9,9,8,54,47,7,36
Cliftonville,7371,5,9,4,13,32,32,0,31
Ballymena,7371,6,7,5,14,26,48,-22,26
Glentoran,7371,7,6,6,10,24,32,-8,24
Dungannon,7371,8,2,4,16,14,47,-33,10
Crusaders,7372,1,17,6,3,63,31,32,57
Coleraine,7372,2,14,11,1,45,24,21,53
Linfield,7372,3,11,5,10,39,36,3,38
Glenavon,7372,4,9,10,7,54,45,9,37
Cliftonville,7372,5,9,4,13,32,33,-1,31
Ballymena,7372,6,7,4,15,26,49,-23,25
Glentoran,7372,7,6,6,10,24,32,-8,24
Dungannon,7372,8,2,4,16,14,47,-33,10
Crusaders,7373,1,17,6,3,65,30,35,57
Coleraine,7373,2,14,10,2,44,25,19,52
Glenavon,7373,3,10,9,7,55,44,11,39
Linfield,7373,4,10,5,11,38,38,0,35
Cliftonville,7373,5,10,4,12,34,32,2,34
Ballymena,7373,6,7,4,15,25,51,-26,25
Glentoran,7373,7,6,6,10,24,32,-8,24
Dungannon,7373,8,2,4,16,14,47,-33,10
Crusaders,7374,1,16,6,4,62,33,29,54
Coleraine,7374,2,14,11,1,45,24,21,53
Linfield,7374,3,11,5,10,39,37,2,38
Glenavon,7374,4,9,10,7,54,45,9,37
Cliftonville,7374,5,9,4,13,33,33,0,31
Ballymena,7374,6,8,4,14,28,48,-20,28
Glentoran,7374,7,6,6,10,24,32,-8,24
Dungannon,7374,8,2,4,16,14,47,-33,10
Crusaders,7375,1,17,6,3,64,32,32,57
Coleraine,7375,2,15,10,1,46,23,23,55
Glenavon,7375,3,9,9,8,53,46,7,36
Linfield,7375,4,10,5,11,37,37,0,35
Cliftonville,7375,5,10,4,12,33,31,2,34
Ballymena,7375,6,7,4,15,27,50,-23,25
Glentoran,7375,7,6,6,10,24,32,-8,24
Dungannon,7375,8,2,4,16,14,47,-33,10
Crusaders,7376,1,17,6,3,63,30,33,57
Coleraine,7376,2,14,10,2,43,26,17,52
Glenavon,7376,3,10,9,7,56,43,13,39
Linfield,7376,4,11,5,10,40,37,3,38
Cliftonville,7376,5,9,4,13,33,34,-1,31
Ballymena,7376,6,7,4,15,25,49,-24,25
Glentoran,7376,7,6,6,10,24,32,-8,24
Dungannon,7376,8,2,4,16,14,47,-33,10
Crusaders,7377,1,17,6,3,63,31,32,57
Coleraine,7377,2,14,10,2,43,24,19,52
Glenavon,7377,3,10,9,7,54,43,11,39
Linfield,7377,4,10,5,11,38,38,0,35
Cliftonville,7377,5,10,4,12,34,32,2,34
Ballymena,7377,6,7,4,15,26,49,-23,25
Glentoran,7377,7,6,6,10,24,32,-8,24
Dungannon,7377,8,2,4,16,14,47,-33,10
Crusaders,7378,1,17,6,3,65,32,33,57
Coleraine,7378,2,15,10,1,46,22,24,55
Linfield,7378,3,11,5,10,38,36,2,38
Glenavon,7378,4,9,9,8,52,46,6,36
Cliftonville,7378,5,9,4,13,32,32,0,31
Ballymena,7378,6,7,4,15,27,51,-24,25
Glentoran,7378,7,6,6,10,24,32,-8,24
Dungannon,7378,8,2,4,16,14,47,-33,10
Crusaders,7379,1,16,7,3,63,32,31,55
Coleraine,7379,2,15,10,1,45,22,23,55
Glenavon,7379,3,9,9,8,52,45,7,36
Linfield,7379,4,10,5,11,37,37,0,35
Cliftonville,7379,5,10,4,12,33,31,2,34
Ballymena,7379,6,7,5,14,27,49,-22,26
Glentoran,7379,7,6,6,10,24,32,-8,24
Dungannon,7379,8,2,4,16,14,47,-33,10
Crusaders,7380,1,17,6,3,64,31,33,57
Coleraine,7380,2,14,11,1,44,23,21,53
Glenavon,7380,3,9,10,7,53,44,9,37
Linfield,7380,4,10,5,11,37,37,0,35
Cliftonville,7380,5,10,4,12,33,31,2,34
Ballymena,7380,6,7,4,15,26,50,-24,25
Glentoran,7380,7,6,6,10,24,32,-8,24
Dungannon,7380,8,2,4,16,14,47,-33,10
Crusaders,7381,1,17,6,3,67,31,36,57
Coleraine,7381,2,14,11,1,44,23,21,53
Linfield,7381,3,11,5,10,40,38,2,38
Glenavon,7381,4,9,10,7,53,44,9,37
Cliftonville,7381,5,9,4,13,34,34,0,31
Ballymena,7381,6,7,4,15,26,53,-27,25
Glentoran,7381,7,6,6,10,24,32,-8,24
Dungannon,7381,8,2,4,16,14,47,-33,10
Coleraine,7382,1,15,10,1,45,23,22,55
Crusaders,7382,2,16,6,4,62,34,28,54
Glenavon,7382,3,9,9,8,53,45,8,36
Linfield,7382,4,10,6,10,38,37,1,36
Cliftonville,7382,5,9,5,12,33,32,1,32
Ballymena,7382,6,8,4,14,29,48,-19,28
Glentoran,7382,7,6,6,10,24,32,-8,24
Dungannon,7382,8,2,4,16,14,47,-33,10
Crusaders,7383,1,16,6,4,62,33,29,54
Coleraine,7383,2,14,10,2,43,23,20,52
Glenavon,7383,3,10,9,7,53,43,10,39
Linfield,7383,4,10,5,11,37,39,-2,35
Cliftonville,7383,5,10,4,12,35,31,4,34
Ballymena,7383,6,8,4,14,28,48,-20,28
Glentoran,7383,7,6,6,10,24,32,-8,24
Dungannon,7383,8,2,4,16,14,47,-33,10
Crusaders,7384,1,16,7,3,63,32,31,55
Coleraine,7384,2,14,11,1,44,23,21,53
Linfield,7384,3,11,5,10,39,36,3,38
Glenavon,7384,4,9,10,7,53,44,9,37
Cliftonville,7384,5,9,4,13,32,33,-1,31
Ballymena,7384,6,7,5,14,27,49,-22,26
Glentoran,7384,7,6,6,10,24,32,-8,24
Dungannon,7384,8,2,4,16,14,47,-33,10
Crusaders,7385,1,16,6,4,61,33,28,54
Coleraine,7385,2,14,10,2,43,24,19,52
Glenavon,7385,3,10,9,7,54,43,11,39
Linfield,7385,4,11,5,10,41,36,5,38
Cliftonville,7385,5,9,4,13,32,35,-3,31
Ballymena,7385,6,8,4,14,28,47,-19,28
Glentoran,7385,7,6,6,10,24,32,-8,24
Dungannon,7385,8,2,4,16,14,47,-33,10
Crusaders,7386,1,17,6,3,65,30,35,57
Coleraine,7386,2,15,10,1,45,23,22,55
Linfield,7386,3,11,5,10,40,37,3,38
Glenavon,7386,4,9,9,8,53,45,8,36
Cliftonville,7386,5,9,4,13,33,34,-1,31
Ballymena,7386,6,7,4,15,25,51,-26,25
Glentoran,7386,7,6,6,10,24,32,-8,24
Dungannon,7386,8,2,4,16,14,47,-33,10
Crusaders,7387,1,16,7,3,62,31,31,55
Coleraine,7387,2,14,10,2,43,23,20,52
Glenavon,7387,3,10,9,7,53,43,10,39
Linfield,7387,4,11,5,10,39,36,3,38
Cliftonville,7387,5,9,4,13,32,33,-1,31
Ballymena,7387,6,7,5,14,26,48,-22,26
Glentoran,7387,7,6,6,10,24,32,-8,24
Dungannon,7387,8,2,4,16,14,47,-33,10
Crusaders,7388,1,17,6,3,64,30,34,57
Coleraine,7388,2,14,10,2,44,24,20,52
Glenavon,7388,3,10,9,7,54,44,10,39
Linfield,7388,4,11,5,10,39,37,2,38
Cliftonville,7388,5,9,4,13,33,33,0,31
Ballymena,7388,6,7,4,15,25,50,-25,25
Glentoran,7388,7,6,6,10,24,32,-8,24
Dungannon,7388,8,2,4,16,14,47,-33,10
Crusaders,7389,1,16,6,4,63,35,28,54
Coleraine,7389,2,14,10,2,43,24,19,52
Glenavon,7389,3,10,9,7,54,43,11,39
Linfield,7389,4,11,5,10,38,36,2,38
Cliftonville,7389,5,9,4,13,32,32,0,31
Ballymena,7389,6,8,4,14,30,49,-19,28
Glentoran,7389,7,6,6,10,24,32,-8,24
Dungannon,7389,8,2,4,16,14,47,-33,10
Crusaders,7390,1,17,6,3,64,30,34,57
Coleraine,7390,2,14,10,2,43,25,18,52
Glenavon,7390,3,10,9,7,55,43,12,39
Linfield,7390,4,11,5,10,39,36,3,38
Cliftonville,7390,5,9,4,13,32,33,-1,31
Ballymena,7390,6,7,4,15,25,50,-25,25
Glentoran,7390,7,6,6,10,24,32,-8,24
Dungannon,7390,8,2,4,16,14,47,-33,10
Crusaders,7391,1,17,6,3,65,32,33,57
Coleraine,7391,2,14,11,1,44,23,21,53
Linfield,7391,3,11,5,10,40,38,2,38
Glenavon,7391,4,9,10,7,53,44,9,37
Cliftonville,7391,5,9,4,13,34,34,0,31
Ballymena,7391,6,7,4,15,27,51,-24,25
Glentoran,7391,7,6,6,10,24,32,-8,24
Dungannon,7391,8,2,4,16,14,47,-33,10
Crusaders,7392,1,16,6,4,62,33,29,54
Coleraine,7392,2,14,11,1,45,24,21,53
Glenavon,7392,3,9,10,7,54,45,9,37
Linfield,7392,4,10,6,10,38,37,1,36
Cliftonville,7392,5,9,5,12,33,32,1,32
Ballymena,7392,6,8,4,14,28,48,-20,28
Glentoran,7392,7,6,6,10,24,32,-8,24
Dungannon,7392,8,2,4,16,14,47,-33,10
Crusaders,7393,1,17,6,3,64,30,34,57
Coleraine,7393,2,14,11,1,44,23,21,53
Glenavon,7393,3,9,10,7,53,44,9,37
Linfield,7393,4,10,6,10,37,36,1,36
Cliftonville,7393,5,9,5,12,32,31,1,32
Ballymena,7393,6,7,4,15,25,50,-25,25
Glentoran,7393,7,6,6,10,24,32,-8,24
Dungannon,7393,8,2,4,16,14,47,-33,10
Crusaders,7394,1,16,7,3,61,30,31,55
Coleraine,7394,2,14,10,2,44,27,17,52
Glenavon,7394,3,10,9,7,57,44,13,39
Linfield,7394,4,11,5,10,39,36,3,38
Cliftonville,7394,5,9,4,13,32,33,-1,31
Ballymena,7394,6,7,5,14,25,47,-22,26
Glentoran,7394,7,6,6,10,24,32,-8,24
Dungannon,7394,8,2,4,16,14,47,-33,10
Crusaders,7395,1,17,6,3,64,32,32,57
Coleraine,7395,2,14,10,2,43,23,20,52
Glenavon,7395,3,10,9,7,53,43,10,39
Linfield,7395,4,10,5,11,37,37,0,35
Cliftonville,7395,5,10,4,12,33,31,2,34
Ballymena,7395,6,7,4,15,27,50,-23,25
Glentoran,7395,7,6,6,10,24,32,-8,24
Dungannon,7395,8,2,4,16,14,47,-33,10
Crusaders,7396,1,17,6,3,63,30,33,57
Coleraine,7396,2,14,10,2,44,24,20,52
Glenavon,7396,3,10,9,7,54,44,10,39
Linfield,7396,4,10,6,10,38,37,1,36
Cliftonville,7396,5,9,5,12,33,32,1,32
Ballymena,7396,6,7,4,15,25,49,-24,25
Glentoran,7396,7,6,6,10,24,32,-8,24
Dungannon,7396,8,2,4,16,14,47,-33,10
Crusaders,7397,1,16,7,3,61,30,31,55
Coleraine,7397,2,15,10,1,44,22,22,55
Glenavon,7397,3,9,9,8,52,44,8,36
Linfield,7397,4,10,5,11,37,38,-1,35
Cliftonville,7397,5,10,4,12,34,31,3,34
Ballymena,7397,6,7,5,14,25,47,-22,26
Glentoran,7397,7,6,6,10,24,32,-8,24
Dungannon,7397,8,2,4,16,14,47,-33,10
Crusaders,7398,1,17,6,3,65,31,34,57
Coleraine,7398,2,14,11,1,45,24,21,53
Glenavon,7398,3,9,10,7,54,45,9,37
Linfield,7398,4,10,5,11,37,37,0,35
Cliftonville,7398,5,10,4,12,33,31,2,34
Ballymena,7398,6,7,4,15,26,51,-25,25
Glentoran,7398,7,6,6,10,24,32,-8,24
Dungannon,7398,8,2,4,16,14,47,-33,10
Crusaders,7399,1,17,6,3,63,31,32,57
Coleraine,7399,2,14,10,2,43,24,19,52
Glenavon,7399,3,10,9,7,54,43,11,39
Linfield,7399,4,11,5,10,40,38,2,38
Cliftonville,7399,5,9,4,13,34,34,0,31
Ballymena,7399,6,7,4,15,26,49,-23,25
Glentoran,7399,7,6,6,10,24,32,-8,24
Dungannon,7399,8,2,4,16,14,47,-33,10
Crusaders,7400,1,17,6,3,65,30,35,57
Coleraine,7400,2,14,10,2,43,23,20,52
Glenavon,7400,3,10,9,7,53,43,10,39
Linfield,7400,4,10,5,11,38,39,-1,35
Cliftonville,7400,5,10,4,12,35,32,3,34
Ballymena,7400,6,7,4,15,25,51,-26,25
Glentoran,7400,7,6,6,10,24,32,-8,24
Dungannon,7400,8,2,4,16,14,47,-33,10
Crusaders,7401,1,16,6,4,62,32,30,54
Coleraine,7401,2,14,10,2,43,25,18,52
Glenavon,7401,3,10,9,7,55,43,12,39
Linfield,7401,4,11,5,10,43,38,5,38
Cliftonville,7401,5,9,4,13,34,37,-3,31
Ballymena,7401,6,8,4,14,27,48,-21,28
Glentoran,7401,7,6,6,10,24,32,-8,24
Dungannon,7401,8,2,4,16,14,47,-33,10
Crusaders,7402,1,16,6,4,61,31,30,54
Coleraine,7402,2,14,10,2,44,24,20,52
Glenavon,7402,3,10,9,7,54,44,10,39
Linfield,7402,4,11,5,10,39,37,2,38
Cliftonville,7402,5,9,4,13,33,33,0,31
Ballymena,7402,6,8,4,14,26,47,-21,28
Glentoran,7402,7,6,6,10,24,32,-8,24
Dungannon,7402,8,2,4,16,14,47,-33,10
Crusaders,7403,1,16,6,4,62,33,29,54
Coleraine,7403,2,14,11,1,44,23,21,53
Glenavon,7403,3,9,10,7,53,44,9,37
Linfield,7403,4,10,5,11,39,39,0,35
Cliftonville,7403,5,10,4,12,35,33,2,34
Ballymena,7403,6,8,4,14,28,48,-20,28
Glentoran,7403,7,6,6,10,24,32,-8,24
Dungannon,7403,8,2,4,16,14,47,-33,10
Crusaders,7404,1,16,7,3,61,30,31,55
Coleraine,7404,2,15,10,1,46,22,24,55
Glenavon,7404,3,9,9,8,52,46,6,36
Linfield,7404,4,10,5,11,37,38,-1,35
Cliftonville,7404,5,10,4,12,34,31,3,34
Ballymena,7404,6,7,5,14,25,47,-22,26
Glentoran,7404,7,6,6,10,24,32,-8,24
Dungannon,7404,8,2,4,16,14,47,-33,10
Crusaders,7405,1,17,6,3,65,30,35,57
Coleraine,7405,2,15,10,1,45,23,22,55
Linfield,7405,3,11,5,10,39,36,3,38
Glenavon,7405,4,9,9,8,53,45,8,36
Cliftonville,7405,5,9,4,13,32,33,-1,31
Ballymena,7405,6,7,4,15,25,51,-26,25
Glentoran,7405,7,6,6,10,24,32,-8,24
Dungannon,7405,8,2,4,16,14,47,-33,10
Crusaders,7406,1,17,6,3,62,30,32,57
Coleraine,7406,2,14,11,1,44,23,21,53
Glenavon,7406,3,9,10,7,53,44,9,37
Linfield,7406,4,10,5,11,37,37,0,35
Cliftonville,7406,5,10,4,12,33,31,2,34
Ballymena,7406,6,7,4,15,25,48,-23,25
Glentoran,7406,7,6,6,10,24,32,-8,24
Dungannon,7406,8,2,4,16,14,47,-33,10
Crusaders,7407,1,16,7,3,62,31,31,55
Coleraine,7407,2,14,10,2,44,25,19,52
Glenavon,7407,3,10,9,7,55,44,11,39
Linfield,7407,4,11,5,10,38,36,2,38
Cliftonville,7407,5,9,4,13,32,32,0,31
Ballymena,7407,6,7,5,14,26,48,-22,26
Glentoran,7407,7,6,6,10,24,32,-8,24
Dungannon,7407,8,2,4,16,14,47,-33,10
Crusaders,7408,1,16,7,3,62,31,31,55
Coleraine,7408,2,14,11,1,44,23,21,53
Linfield,7408,3,11,5,10,39,37,2,38
Glenavon,7408,4,9,10,7,53,44,9,37
Cliftonville,7408,5,9,4,13,33,33,0,31
Ballymena,7408,6,7,5,14,26,48,-22,26
Glentoran,7408,7,6,6,10,24,32,-8,24
Dungannon,7408,8,2,4,16,14,47,-33,10
Crusaders,7409,1,17,6,3,63,31,32,57
Coleraine,7409,2,15,10,1,45,23,22,55
Linfield,7409,3,11,5,10,40,38,2,38
Glenavon,7409,4,9,9,8,53,45,8,36
Cliftonville,7409,5,9,4,13,34,34,0,31
Ballymena,7409,6,7,4,15,26,49,-23,25
Glentoran,7409,7,6,6,10,24,32,-8,24
Dungannon,7409,8,2,4,16,14,47,-33,10
Crusaders,7410,1,17,6,3,62,30,32,57
Coleraine,7410,2,14,10,2,43,23,20,52
Glenavon,7410,3,10,9,7,53,43,10,39
Linfield,7410,4,11,5,10,40,38,2,38
Cliftonville,7410,5,9,4,13,34,34,0,31
Ballymena,7410,6,7,4,15,25,48,-23,25
Glentoran,7410,7,6,6,10,24,32,-8,24
Dungannon,7410,8,2,4,16,14,47,-33,10
Crusaders,7411,1,16,7,3,62,31,31,55
Coleraine,7411,2,15,10,1,48,23,25,55
Glenavon,7411,3,9,9,8,53,48,5,36
Linfield,7411,4,10,6,10,39,38,1,36
Cliftonville,7411,5,9,5,12,34,33,1,32
Ballymena,7411,6,7,5,14,26,48,-22,26
Glentoran,7411,7,6,6,10,24,32,-8,24
Dungannon,7411,8,2,4,16,14,47,-33,10
Crusaders,7412,1,17,6,3,63,31,32,57
Coleraine,7412,2,14,10,2,44,24,20,52
Glenavon,7412,3,10,9,7,54,44,10,39
Linfield,7412,4,10,5,11,37,38,-1,35
Cliftonville,7412,5,10,4,12,34,31,3,34
Ballymena,7412,6,7,4,15,26,49,-23,25
Glentoran,7412,7,6,6,10,24,32,-8,24
Dungannon,7412,8,2,4,16,14,47,-33,10
Crusaders,7413,1,17,6,3,64,31,33,57
Coleraine,7413,2,15,10,1,47,23,24,55
Linfield,7413,3,11,5,10,40,38,2,38
Glenavon,7413,4,9,9,8,53,47,6,36
Cliftonville,7413,5,9,4,13,34,34,0,31
Ballymena,7413,6,7,4,15,26,50,-24,25
Glentoran,7413,7,6,6,10,24,32,-8,24
Dungannon,7413,8,2,4,16,14,47,-33,10
Coleraine,7414,1,15,10,1,45,22,23,55
Crusaders,7414,2,16,6,4,62,32,30,54
Glenavon,7414,3,9,9,8,52,45,7,36
Linfield,7414,4,10,5,11,38,38,0,35
Cliftonville,7414,5,10,4,12,34,32,2,34
Ballymena,7414,6,8,4,14,27,48,-21,28
Glentoran,7414,7,6,6,10,24,32,-8,24
Dungannon,7414,8,2,4,16,14,47,-33,10
Crusaders,7415,1,17,6,3,63,31,32,57
Coleraine,7415,2,15,10,1,47,23,24,55
Glenavon,7415,3,9,9,8,53,47,6,36
Linfield,7415,4,10,5,11,39,39,0,35
Cliftonville,7415,5,10,4,12,35,33,2,34
Ballymena,7415,6,7,4,15,26,49,-23,25
Glentoran,7415,7,6,6,10,24,32,-8,24
Dungannon,7415,8,2,4,16,14,47,-33,10
Crusaders,7416,1,16,7,3,62,31,31,55
Coleraine,7416,2,15,10,1,45,22,23,55
Linfield,7416,3,11,5,10,39,36,3,38
Glenavon,7416,4,9,9,8,52,45,7,36
Cliftonville,7416,5,9,4,13,32,33,-1,31
Ballymena,7416,6,7,5,14,26,48,-22,26
Glentoran,7416,7,6,6,10,24,32,-8,24
Dungannon,7416,8,2,4,16,14,47,-33,10
Crusaders,7417,1,16,7,3,61,30,31,55
Coleraine,7417,2,15,10,1,45,23,22,55
Linfield,7417,3,11,5,10,39,36,3,38
Glenavon,7417,4,9,9,8,53,45,8,36
Cliftonville,7417,5,9,4,13,32,33,-1,31
Ballymena,7417,6,7,5,14,25,47,-22,26
Glentoran,7417,7,6,6,10,24,32,-8,24
Dungannon,7417,8,2,4,16,14,47,-33,10
Crusaders,7418,1,16,7,3,65,34,31,55
Coleraine,7418,2,14,10,2,44,24,20,52
Glenavon,7418,3,10,9,7,54,44,10,39
Linfield,7418,4,10,6,10,38,37,1,36
Cliftonville,7418,5,9,5,12,33,32,1,32
Ballymena,7418,6,7,5,14,29,51,-22,26
Glentoran,7418,7,6,6,10,24,32,-8,24
Dungannon,7418,8,2,4,16,14,47,-33,10
Crusaders,7419,1,17,6,3,67,34,33,57
Coleraine,7419,2,14,10,2,44,25,19,52
Glenavon,7419,3,10,9,7,55,44,11,39
Linfield,7419,4,10,6,10,39,38,1,36
Cliftonville,7419,5,9,5,12,34,33,1,32
Ballymena,7419,6,7,4,15,29,53,-24,25
Glentoran,7419,7,6,6,10,24,32,-8,24
Dungannon,7419,8,2,4,16,14,47,-33,10
Crusaders,7420,1,17,6,3,63,31,32,57
Coleraine,7420,2,14,11,1,46,25,21,53
Linfield,7420,3,11,5,10,38,36,2,38
Glenavon,7420,4,9,10,7,55,46,9,37
Cliftonville,7420,5,9,4,13,32,32,0,31
Ballymena,7420,6,7,4,15,26,49,-23,25
Glentoran,7420,7,6,6,10,24,32,-8,24
Dungannon,7420,8,2,4,16,14,47,-33,10
Crusaders,7421,1,17,6,3,65,31,34,57
Coleraine,7421,2,15,10,1,45,22,23,55
Glenavon,7421,3,9,9,8,52,45,7,36
Linfield,7421,4,10,5,11,37,37,0,35
Cliftonville,7421,5,10,4,12,33,31,2,34
Ballymena,7421,6,7,4,15,26,51,-25,25
Glentoran,7421,7,6,6,10,24,32,-8,24
Dungannon,7421,8,2,4,16,14,47,-33,10
Crusaders,7422,1,16,6,4,61,33,28,54
Coleraine,7422,2,14,10,2,43,24,19,52
Glenavon,7422,3,10,9,7,54,43,11,39
Linfield,7422,4,10,6,10,37,36,1,36
Cliftonville,7422,5,9,5,12,32,31,1,32
Ballymena,7422,6,8,4,14,28,47,-19,28
Glentoran,7422,7,6,6,10,24,32,-8,24
Dungannon,7422,8,2,4,16,14,47,-33,10
Crusaders,7423,1,17,6,3,63,30,33,57
Coleraine,7423,2,14,10,2,44,24,20,52
Glenavon,7423,3,10,9,7,54,44,10,39
Linfield,7423,4,10,6,10,38,37,1,36
Cliftonville,7423,5,9,5,12,33,32,1,32
Ballymena,7423,6,7,4,15,25,49,-24,25
Glentoran,7423,7,6,6,10,24,32,-8,24
Dungannon,7423,8,2,4,16,14,47,-33,10
Crusaders,7424,1,16,7,3,63,32,31,55
Coleraine,7424,2,15,10,1,45,23,22,55
Linfield,7424,3,11,5,10,38,36,2,38
Glenavon,7424,4,9,9,8,53,45,8,36
Cliftonville,7424,5,9,4,13,32,32,0,31
Ballymena,7424,6,7,5,14,27,49,-22,26
Glentoran,7424,7,6,6,10,24,32,-8,24
Dungannon,7424,8,2,4,16,14,47,-33,10
Crusaders,7425,1,17,6,3,63,31,32,57
Coleraine,7425,2,14,11,1,46,25,21,53
Linfield,7425,3,11,5,10,39,36,3,38
Glenavon,7425,4,9,10,7,55,46,9,37
Cliftonville,7425,5,9,4,13,32,33,-1,31
Ballymena,7425,6,7,4,15,26,49,-23,25
Glentoran,7425,7,6,6,10,24,32,-8,24
Dungannon,7425,8,2,4,16,14,47,-33,10
Crusaders,7426,1,17,6,3,62,30,32,57
Coleraine,7426,2,14,11,1,44,23,21,53
Glenavon,7426,3,9,10,7,53,44,9,37
Linfield,7426,4,10,6,10,37,36,1,36
Cliftonville,7426,5,9,5,12,32,31,1,32
Ballymena,7426,6,7,4,15,25,48,-23,25
Glentoran,7426,7,6,6,10,24,32,-8,24
Dungannon,7426,8,2,4,16,14,47,-33,10
Crusaders,7427,1,16,7,3,62,31,31,55
Coleraine,7427,2,14,10,2,44,24,20,52
Glenavon,7427,3,10,9,7,54,44,10,39
Linfield,7427,4,10,5,11,39,39,0,35
Cliftonville,7427,5,10,4,12,35,33,2,34
Ballymena,7427,6,7,5,14,26,48,-22,26
Glentoran,7427,7,6,6,10,24,32,-8,24
Dungannon,7427,8,2,4,16,14,47,-33,10
Crusaders,7428,1,16,6,4,61,31,30,54
Coleraine,7428,2,14,11,1,45,24,21,53
Glenavon,7428,3,9,10,7,54,45,9,37
Linfield,7428,4,10,5,11,37,37,0,35
Cliftonville,7428,5,10,4,12,33,31,2,34
Ballymena,7428,6,8,4,14,26,47,-21,28
Glentoran,7428,7,6,6,10,24,32,-8,24
Dungannon,7428,8,2,4,16,14,47,-33,10
Crusaders,7429,1,16,6,4,62,32,30,54
Coleraine,7429,2,14,10,2,43,25,18,52
Glenavon,7429,3,10,9,7,55,43,12,39
Linfield,7429,4,10,5,11,39,40,-1,35
Cliftonville,7429,5,10,4,12,36,33,3,34
Ballymena,7429,6,8,4,14,27,48,-21,28
Glentoran,7429,7,6,6,10,24,32,-8,24
Dungannon,7429,8,2,4,16,14,47,-33,10
Crusaders,7430,1,16,7,3,63,32,31,55
Coleraine,7430,2,15,10,1,44,22,22,55
Linfield,7430,3,11,5,10,41,39,2,38
Glenavon,7430,4,9,9,8,52,44,8,36
Cliftonville,7430,5,9,4,13,35,35,0,31
Ballymena,7430,6,7,5,14,27,49,-22,26
Glentoran,7430,7,6,6,10,24,32,-8,24
Dungannon,7430,8,2,4,16,14,47,-33,10
Crusaders,7431,1,17,6,3,63,31,32,57
Coleraine,7431,2,14,11,1,46,25,21,53
Glenavon,7431,3,9,10,7,55,46,9,37
Linfield,7431,4,10,6,10,38,37,1,36
Cliftonville,7431,5,9,5,12,33,32,1,32
Ballymena,7431,6,7,4,15,26,49,-23,25
Glentoran,7431,7,6,6,10,24,32,-8,24
Dungannon,7431,8,2,4,16,14,47,-33,10
Crusaders,7432,1,16,6,4,63,33,30,54
Coleraine,7432,2,14,11,1,43,22,21,53
Linfield,7432,3,11,5,10,39,36,3,38
Glenavon,7432,4,9,10,7,52,43,9,37
Cliftonville,7432,5,9,4,13,32,33,-1,31
Ballymena,7432,6,8,4,14,28,49,-21,28
Glentoran,7432,7,6,6,10,24,32,-8,24
Dungannon,7432,8,2,4,16,14,47,-33,10
Crusaders,7433,1,17,6,3,63,31,32,57
Coleraine,7433,2,15,10,1,48,24,24,55
Linfield,7433,3,11,5,10,39,36,3,38
Glenavon,7433,4,9,9,8,54,48,6,36
Cliftonville,7433,5,9,4,13,32,33,-1,31
Ballymena,7433,6,7,4,15,26,49,-23,25
Glentoran,7433,7,6,6,10,24,32,-8,24
Dungannon,7433,8,2,4,16,14,47,-33,10
Crusaders,7434,1,16,7,3,62,31,31,55
Coleraine,7434,2,14,10,2,43,23,20,52
Glenavon,7434,3,10,9,7,53,43,10,39
Linfield,7434,4,10,5,11,39,40,-1,35
Cliftonville,7434,5,10,4,12,36,33,3,34
Ballymena,7434,6,7,5,14,26,48,-22,26
Glentoran,7434,7,6,6,10,24,32,-8,24
Dungannon,7434,8,2,4,16,14,47,-33,10
Crusaders,7435,1,16,7,3,61,30,31,55
Coleraine,7435,2,14,10,2,45,26,19,52
Glenavon,7435,3,10,9,7,56,45,11,39
Linfield,7435,4,10,6,10,38,37,1,36
Cliftonville,7435,5,9,5,12,33,32,1,32
Ballymena,7435,6,7,5,14,25,47,-22,26
Glentoran,7435,7,6,6,10,24,32,-8,24
Dungannon,7435,8,2,4,16,14,47,-33,10
Crusaders,7436,1,16,7,3,63,32,31,55
Coleraine,7436,2,14,10,2,44,26,18,52
Glenavon,7436,3,10,9,7,56,44,12,39
Linfield,7436,4,10,5,11,40,41,-1,35
Cliftonville,7436,5,10,4,12,37,34,3,34
Ballymena,7436,6,7,5,14,27,49,-22,26
Glentoran,7436,7,6,6,10,24,32,-8,24
Dungannon,7436,8,2,4,16,14,47,-33,10
Crusaders,7437,1,17,6,3,62,30,32,57
Coleraine,7437,2,15,10,1,46,22,24,55
Linfield,7437,3,11,5,10,39,37,2,38
Glenavon,7437,4,9,9,8,52,46,6,36
Cliftonville,7437,5,9,4,13,33,33,0,31
Ballymena,7437,6,7,4,15,25,48,-23,25
Glentoran,7437,7,6,6,10,24,32,-8,24
Dungannon,7437,8,2,4,16,14,47,-33,10
Crusaders,7438,1,17,6,3,63,30,33,57
Coleraine,7438,2,15,10,1,44,22,22,55
Linfield,7438,3,11,5,10,41,36,5,38
Glenavon,7438,4,9,9,8,52,44,8,36
Cliftonville,7438,5,9,4,13,32,35,-3,31
Ballymena,7438,6,7,4,15,25,49,-24,25
Glentoran,7438,7,6,6,10,24,32,-8,24
Dungannon,7438,8,2,4,16,14,47,-33,10
Crusaders,7439,1,17,6,3,64,31,33,57
Coleraine,7439,2,14,10,2,45,25,20,52
Glenavon,7439,3,10,9,7,55,45,10,39
Linfield,7439,4,11,5,10,38,36,2,38
Cliftonville,7439,5,9,4,13,32,32,0,31
Ballymena,7439,6,7,4,15,26,50,-24,25
Glentoran,7439,7,6,6,10,24,32,-8,24
Dungannon,7439,8,2,4,16,14,47,-33,10
Crusaders,7440,1,16,7,3,62,31,31,55
Coleraine,7440,2,14,10,2,44,25,19,52
Glenavon,7440,3,10,9,7,55,44,11,39
Linfield,7440,4,10,5,11,37,37,0,35
Cliftonville,7440,5,10,4,12,33,31,2,34
Ballymena,7440,6,7,5,14,26,48,-22,26
Glentoran,7440,7,6,6,10,24,32,-8,24
Dungannon,7440,8,2,4,16,14,47,-33,10
Crusaders,7441,1,17,6,3,65,30,35,57
Coleraine,7441,2,14,11,1,43,22,21,53
Glenavon,7441,3,9,10,7,52,43,9,37
Linfield,7441,4,10,5,11,38,42,-4,35
Cliftonville,7441,5,10,4,12,38,32,6,34
Ballymena,7441,6,7,4,15,25,51,-26,25
Glentoran,7441,7,6,6,10,24,32,-8,24
Dungannon,7441,8,2,4,16,14,47,-33,10
Crusaders,7442,1,16,7,3,63,32,31,55
Coleraine,7442,2,14,10,2,45,26,19,52
Glenavon,7442,3,10,9,7,56,45,11,39
Linfield,7442,4,10,6,10,37,36,1,36
Cliftonville,7442,5,9,5,12,32,31,1,32
Ballymena,7442,6,7,5,14,27,49,-22,26
Glentoran,7442,7,6,6,10,24,32,-8,24
Dungannon,7442,8,2,4,16,14,47,-33,10
Crusaders,7443,1,17,6,3,63,31,32,57
Coleraine,7443,2,14,10,2,44,24,20,52
Glenavon,7443,3,10,9,7,54,44,10,39
Linfield,7443,4,11,5,10,40,37,3,38
Cliftonville,7443,5,9,4,13,33,34,-1,31
Ballymena,7443,6,7,4,15,26,49,-23,25
Glentoran,7443,7,6,6,10,24,32,-8,24
Dungannon,7443,8,2,4,16,14,47,-33,10
Crusaders,7444,1,16,6,4,61,31,30,54
Coleraine,7444,2,14,10,2,43,24,19,52
Glenavon,7444,3,10,9,7,54,43,11,39
Linfield,7444,4,10,6,10,38,37,1,36
Cliftonville,7444,5,9,5,12,33,32,1,32
Ballymena,7444,6,8,4,14,26,47,-21,28
Glentoran,7444,7,6,6,10,24,32,-8,24
Dungannon,7444,8,2,4,16,14,47,-33,10
Coleraine,7445,1,15,10,1,45,23,22,55
Crusaders,7445,2,16,6,4,62,33,29,54
Linfield,7445,3,11,5,10,38,36,2,38
Glenavon,7445,4,9,9,8,53,45,8,36
Cliftonville,7445,5,9,4,13,32,32,0,31
Ballymena,7445,6,8,4,14,28,48,-20,28
Glentoran,7445,7,6,6,10,24,32,-8,24
Dungannon,7445,8,2,4,16,14,47,-33,10
Coleraine,7446,1,15,10,1,47,24,23,55
Crusaders,7446,2,16,6,4,61,31,30,54
Glenavon,7446,3,9,9,8,54,47,7,36
Linfield,7446,4,10,6,10,38,37,1,36
Cliftonville,7446,5,9,5,12,33,32,1,32
Ballymena,7446,6,8,4,14,26,47,-21,28
Glentoran,7446,7,6,6,10,24,32,-8,24
Dungannon,7446,8,2,4,16,14,47,-33,10
Crusaders,7447,1,17,6,3,64,32,32,57
Coleraine,7447,2,14,10,2,43,23,20,52
Glenavon,7447,3,10,9,7,53,43,10,39
Linfield,7447,4,11,5,10,38,36,2,38
Cliftonville,7447,5,9,4,13,32,32,0,31
Ballymena,7447,6,7,4,15,27,50,-23,25
Glentoran,7447,7,6,6,10,24,32,-8,24
Dungannon,7447,8,2,4,16,14,47,-33,10
Crusaders,7448,1,17,6,3,62,30,32,57
Coleraine,7448,2,14,11,1,45,24,21,53
Linfield,7448,3,11,5,10,39,36,3,38
Glenavon,7448,4,9,10,7,54,45,9,37
Cliftonville,7448,5,9,4,13,32,33,-1,31
Ballymena,7448,6,7,4,15,25,48,-23,25
Glentoran,7448,7,6,6,10,24,32,-8,24
Dungannon,7448,8,2,4,16,14,47,-33,10
Crusaders,7449,1,17,6,3,65,30,35,57
Coleraine,7449,2,14,10,2,44,25,19,52
Glenavon,7449,3,10,9,7,55,44,11,39
Linfield,7449,4,11,5,10,39,36,3,38
Cliftonville,7449,5,9,4,13,32,33,-1,31
Ballymena,7449,6,7,4,15,25,51,-26,25
Glentoran,7449,7,6,6,10,24,32,-8,24
Dungannon,7449,8,2,4,16,14,47,-33,10
Crusaders,7450,1,17,6,3,64,31,33,57
Coleraine,7450,2,15,10,1,46,23,23,55
Linfield,7450,3,11,5,10,39,36,3,38
Glenavon,7450,4,9,9,8,53,46,7,36
Cliftonville,7450,5,9,4,13,32,33,-1,31
Ballymena,7450,6,7,4,15,26,50,-24,25
Glentoran,7450,7,6,6,10,24,32,-8,24
Dungannon,7450,8,2,4,16,14,47,-33,10
Coleraine,7451,1,15,10,1,45,23,22,55
Crusaders,7451,2,16,6,4,63,33,30,54
Linfield,7451,3,11,5,10,40,37,3,38
Glenavon,7451,4,9,9,8,53,45,8,36
Cliftonville,7451,5,9,4,13,33,34,-1,31
Ballymena,7451,6,8,4,14,28,49,-21,28
Glentoran,7451,7,6,6,10,24,32,-8,24
Dungannon,7451,8,2,4,16,14,47,-33,10
Crusaders,7452,1,17,6,3,64,32,32,57
Coleraine,7452,2,15,10,1,46,22,24,55
Glenavon,7452,3,9,9,8,52,46,6,36
Linfield,7452,4,10,5,11,37,37,0,35
Cliftonville,7452,5,10,4,12,33,31,2,34
Ballymena,7452,6,7,4,15,27,50,-23,25
Glentoran,7452,7,6,6,10,24,32,-8,24
Dungannon,7452,8,2,4,16,14,47,-33,10
Crusaders,7453,1,16,7,3,62,31,31,55
Coleraine,7453,2,14,11,1,43,22,21,53
Glenavon,7453,3,9,10,7,52,43,9,37
Linfield,7453,4,10,5,11,38,38,0,35
Cliftonville,7453,5,10,4,12,34,32,2,34
Ballymena,7453,6,7,5,14,26,48,-22,26
Glentoran,7453,7,6,6,10,24,32,-8,24
Dungannon,7453,8,2,4,16,14,47,-33,10
Crusaders,7454,1,16,7,3,65,34,31,55
Coleraine,7454,2,14,10,2,44,25,19,52
Glenavon,7454,3,10,9,7,55,44,11,39
Linfield,7454,4,11,5,10,41,38,3,38
Cliftonville,7454,5,9,4,13,34,35,-1,31
Ballymena,7454,6,7,5,14,29,51,-22,26
Glentoran,7454,7,6,6,10,24,32,-8,24
Dungannon,7454,8,2,4,16,14,47,-33,10
Crusaders,7455,1,17,6,3,65,30,35,57
Coleraine,7455,2,14,11,1,46,25,21,53
Glenavon,7455,3,9,10,7,55,46,9,37
Linfield,7455,4,10,5,11,37,38,-1,35
Cliftonville,7455,5,10,4,12,34,31,3,34
Ballymena,7455,6,7,4,15,25,51,-26,25
Glentoran,7455,7,6,6,10,24,32,-8,24
Dungannon,7455,8,2,4,16,14,47,-33,10
Crusaders,7456,1,17,6,3,63,31,32,57
Coleraine,7456,2,15,10,1,45,23,22,55
Glenavon,7456,3,9,9,8,53,45,8,36
Linfield,7456,4,10,6,10,37,36,1,36
Cliftonville,7456,5,9,5,12,32,31,1,32
Ballymena,7456,6,7,4,15,26,49,-23,25
Glentoran,7456,7,6,6,10,24,32,-8,24
Dungannon,7456,8,2,4,16,14,47,-33,10
Crusaders,7457,1,16,7,3,62,31,31,55
Coleraine,7457,2,14,10,2,44,25,19,52
Glenavon,7457,3,10,9,7,55,44,11,39
Linfield,7457,4,11,5,10,38,36,2,38
Cliftonville,7457,5,9,4,13,32,32,0,31
Ballymena,7457,6,7,5,14,26,48,-22,26
Glentoran,7457,7,6,6,10,24,32,-8,24
Dungannon,7457,8,2,4,16,14,47,-33,10
Crusaders,7458,1,17,6,3,64,30,34,57
Coleraine,7458,2,15,10,1,45,23,22,55
Glenavon,7458,3,9,9,8,53,45,8,36
Linfield,7458,4,10,6,10,38,37,1,36
Cliftonville,7458,5,9,5,12,33,32,1,32
Ballymena,7458,6,7,4,15,25,50,-25,25
Glentoran,7458,7,6,6,10,24,32,-8,24
Dungannon,7458,8,2,4,16,14,47,-33,10
Crusaders,7459,1,16,6,4,62,32,30,54
Coleraine,7459,2,14,10,2,44,26,18,52
Glenavon,7459,3,10,9,7,56,44,12,39
Linfield,7459,4,11,5,10,38,36,2,38
Cliftonville,7459,5,9,4,13,32,32,0,31
Ballymena,7459,6,8,4,14,27,48,-21,28
Glentoran,7459,7,6,6,10,24,32,-8,24
Dungannon,7459,8,2,4,16,14,47,-33,10
Crusaders,7460,1,16,7,3,62,31,31,55
Coleraine,7460,2,14,10,2,43,24,19,52
Glenavon,7460,3,10,9,7,54,43,11,39
Linfield,7460,4,10,6,10,38,37,1,36
Cliftonville,7460,5,9,5,12,33,32,1,32
Ballymena,7460,6,7,5,14,26,48,-22,26
Glentoran,7460,7,6,6,10,24,32,-8,24
Dungannon,7460,8,2,4,16,14,47,-33,10
Crusaders,7461,1,17,6,3,64,32,32,57
Coleraine,7461,2,15,10,1,45,22,23,55
Linfield,7461,3,11,5,10,39,36,3,38
Glenavon,7461,4,9,9,8,52,45,7,36
Cliftonville,7461,5,9,4,13,32,33,-1,31
Ballymena,7461,6,7,4,15,27,50,-23,25
Glentoran,7461,7,6,6,10,24,32,-8,24
Dungannon,7461,8,2,4,16,14,47,-33,10
Crusaders,7462,1,16,6,4,61,31,30,54
Coleraine,7462,2,14,10,2,44,28,16,52
Glenavon,7462,3,10,9,7,58,44,14,39
Linfield,7462,4,11,5,10,38,36,2,38
Cliftonville,7462,5,9,4,13,32,32,0,31
Ballymena,7462,6,8,4,14,26,47,-21,28
Glentoran,7462,7,6,6,10,24,32,-8,24
Dungannon,7462,8,2,4,16,14,47,-33,10
Crusaders,7463,1,16,6,4,61,34,27,54
Coleraine,7463,2,14,11,1,44,23,21,53
Linfield,7463,3,11,5,10,38,36,2,38
Glenavon,7463,4,9,10,7,53,44,9,37
Cliftonville,7463,5,9,4,13,32,32,0,31
Ballymena,7463,6,8,4,14,29,47,-18,28
Glentoran,7463,7,6,6,10,24,32,-8,24
Dungannon,7463,8,2,4,16,14,47,-33,10
Crusaders,7464,1,16,6,4,62,32,30,54
Coleraine,7464,2,14,10,2,47,28,19,52
Glenavon,7464,3,10,9,7,58,47,11,39
Linfield,7464,4,11,5,10,39,36,3,38
Cliftonville,7464,5,9,4,13,32,33,-1,31
Ballymena,7464,6,8,4,14,27,48,-21,28
Glentoran,7464,7,6,6,10,24,32,-8,24
Dungannon,7464,8,2,4,16,14,47,-33,10
Crusaders,7465,1,17,6,3,66,31,35,57
Coleraine,7465,2,14,11,1,44,23,21,53
Glenavon,7465,3,9,10,7,53,44,9,37
Linfield,7465,4,10,6,10,38,37,1,36
Cliftonville,7465,5,9,5,12,33,32,1,32
Ballymena,7465,6,7,4,15,26,52,-26,25
Glentoran,7465,7,6,6,10,24,32,-8,24
Dungannon,7465,8,2,4,16,14,47,-33,10
Crusaders,7466,1,16,7,3,61,30,31,55
Coleraine,7466,2,14,10,2,43,25,18,52
Glenavon,7466,3,10,9,7,55,43,12,39
Linfield,7466,4,10,5,11,37,38,-1,35
Cliftonville,7466,5,10,4,12,34,31,3,34
Ballymena,7466,6,7,5,14,25,47,-22,26
Glentoran,7466,7,6,6,10,24,32,-8,24
Dungannon,7466,8,2,4,16,14,47,-33,10
Crusaders,7467,1,17,6,3,63,31,32,57
Coleraine,7467,2,14,11,1,44,23,21,53
Linfield,7467,3,11,5,10,39,37,2,38
Glenavon,7467,4,9,10,7,53,44,9,37
Cliftonville,7467,5,9,4,13,33,33,0,31
Ballymena,7467,6,7,4,15,26,49,-23,25
Glentoran,7467,7,6,6,10,24,32,-8,24
Dungannon,7467,8,2,4,16,14,47,-33,10
Crusaders,7468,1,16,7,3,63,32,31,55
Coleraine,7468,2,14,11,1,46,25,21,53
Glenavon,7468,3,9,10,7,55,46,9,37
Linfield,7468,4,10,6,10,38,37,1,36
Cliftonville,7468,5,9,5,12,33,32,1,32
Ballymena,7468,6,7,5,14,27,49,-22,26
Glentoran,7468,7,6,6,10,24,32,-8,24
Dungannon,7468,8,2,4,16,14,47,-33,10
Crusaders,7469,1,17,6,3,62,30,32,57
Coleraine,7469,2,14,11,1,44,23,21,53
Linfield,7469,3,11,5,10,42,36,6,38
Glenavon,7469,4,9,10,7,53,44,9,37
Cliftonville,7469,5,9,4,13,32,36,-4,31
Ballymena,7469,6,7,4,15,25,48,-23,25
Glentoran,7469,7,6,6,10,24,32,-8,24
Dungannon,7469,8,2,4,16,14,47,-33,10
Crusaders,7470,1,16,6,4,62,33,29,54
Coleraine,7470,2,14,11,1,45,24,21,53
Linfield,7470,3,11,5,10,40,37,3,38
Glenavon,7470,4,9,10,7,54,45,9,37
Cliftonville,7470,5,9,4,13,33,34,-1,31
Ballymena,7470,6,8,4,14,28,48,-20,28
Glentoran,7470,7,6,6,10,24,32,-8,24
Dungannon,7470,8,2,4,16,14,47,-33,10
Crusaders,7471,1,17,6,3,63,30,33,57
Coleraine,7471,2,14,11,1,45,24,21,53
Glenavon,7471,3,9,10,7,54,45,9,37
Linfield,7471,4,10,5,11,38,38,0,35
Cliftonville,7471,5,10,4,12,34,32,2,34
Ballymena,7471,6,7,4,15,25,49,-24,25
Glentoran,7471,7,6,6,10,24,32,-8,24
Dungannon,7471,8,2,4,16,14,47,-33,10
Crusaders,7472,1,17,6,3,67,31,36,57
Coleraine,7472,2,15,10,1,47,25,22,55
Linfield,7472,3,11,5,10,39,37,2,38
Glenavon,7472,4,9,9,8,55,47,8,36
Cliftonville,7472,5,9,4,13,33,33,0,31
Ballymena,7472,6,7,4,15,26,53,-27,25
Glentoran,7472,7,6,6,10,24,32,-8,24
Dungannon,7472,8,2,4,16,14,47,-33,10
Crusaders,7473,1,16,7,3,62,31,31,55
Coleraine,7473,2,14,10,2,44,24,20,52
Glenavon,7473,3,10,9,7,54,44,10,39
Linfield,7473,4,11,5,10,40,38,2,38
Cliftonville,7473,5,9,4,13,34,34,0,31
Ballymena,7473,6,7,5,14,26,48,-22,26
Glentoran,7473,7,6,6,10,24,32,-8,24
Dungannon,7473,8,2,4,16,14,47,-33,10
Crusaders,7474,1,17,6,3,66,32,34,57
Coleraine,7474,2,15,10,1,47,23,24,55
Linfield,7474,3,11,5,10,38,36,2,38
Glenavon,7474,4,9,9,8,53,47,6,36
Cliftonville,7474,5,9,4,13,32,32,0,31
Ballymena,7474,6,7,4,15,27,52,-25,25
Glentoran,7474,7,6,6,10,24,32,-8,24
Dungannon,7474,8,2,4,16,14,47,-33,10
Crusaders,7475,1,17,6,3,63,30,33,57
Coleraine,7475,2,14,10,2,43,24,19,52
Glenavon,7475,3,10,9,7,54,43,11,39
Linfield,7475,4,10,5,11,38,38,0,35
Cliftonville,7475,5,10,4,12,34,32,2,34
Ballymena,7475,6,7,4,15,25,49,-24,25
Glentoran,7475,7,6,6,10,24,32,-8,24
Dungannon,7475,8,2,4,16,14,47,-33,10
Crusaders,7476,1,17,6,3,64,30,34,57
Coleraine,7476,2,14,10,2,44,24,20,52
Glenavon,7476,3,10,9,7,54,44,10,39
Linfield,7476,4,10,5,11,37,37,0,35
Cliftonville,7476,5,10,4,12,33,31,2,34
Ballymena,7476,6,7,4,15,25,50,-25,25
Glentoran,7476,7,6,6,10,24,32,-8,24
Dungannon,7476,8,2,4,16,14,47,-33,10
Crusaders,7477,1,16,6,4,62,34,28,54
Coleraine,7477,2,14,10,2,44,25,19,52
Glenavon,7477,3,10,9,7,55,44,11,39
Linfield,7477,4,11,5,10,39,36,3,38
Cliftonville,7477,5,9,4,13,32,33,-1,31
Ballymena,7477,6,8,4,14,29,48,-19,28
Glentoran,7477,7,6,6,10,24,32,-8,24
Dungannon,7477,8,2,4,16,14,47,-33,10
Crusaders,7478,1,16,6,4,62,32,30,54
Coleraine,7478,2,14,11,1,44,23,21,53
Glenavon,7478,3,9,10,7,53,44,9,37
Linfield,7478,4,10,5,11,37,37,0,35
Cliftonville,7478,5,10,4,12,33,31,2,34
Ballymena,7478,6,8,4,14,27,48,-21,28
Glentoran,7478,7,6,6,10,24,32,-8,24
Dungannon,7478,8,2,4,16,14,47,-33,10
Crusaders,7479,1,16,7,3,62,31,31,55
Coleraine,7479,2,15,10,1,45,23,22,55
Linfield,7479,3,11,5,10,38,36,2,38
Glenavon,7479,4,9,9,8,53,45,8,36
Cliftonville,7479,5,9,4,13,32,32,0,31
Ballymena,7479,6,7,5,14,26,48,-22,26
Glentoran,7479,7,6,6,10,24,32,-8,24
Dungannon,7479,8,2,4,16,14,47,-33,10
Crusaders,7480,1,17,6,3,64,32,32,57
Coleraine,7480,2,14,11,1,44,23,21,53
Glenavon,7480,3,9,10,7,53,44,9,37
Linfield,7480,4,10,6,10,37,36,1,36
Cliftonville,7480,5,9,5,12,32,31,1,32
Ballymena,7480,6,7,4,15,27,50,-23,25
Glentoran,7480,7,6,6,10,24,32,-8,24
Dungannon,7480,8,2,4,16,14,47,-33,10
Crusaders,7481,1,16,7,3,63,32,31,55
Coleraine,7481,2,14,10,2,43,23,20,52
Glenavon,7481,3,10,9,7,53,43,10,39
Linfield,7481,4,10,6,10,37,36,1,36
Cliftonville,7481,5,9,5,12,32,31,1,32
Ballymena,7481,6,7,5,14,27,49,-22,26
Glentoran,7481,7,6,6,10,24,32,-8,24
Dungannon,7481,8,2,4,16,14,47,-33,10
Crusaders,7482,1,16,6,4,62,33,29,54
Coleraine,7482,2,14,11,1,44,23,21,53
Linfield,7482,3,11,5,10,39,37,2,38
Glenavon,7482,4,9,10,7,53,44,9,37
Cliftonville,7482,5,9,4,13,33,33,0,31
Ballymena,7482,6,8,4,14,28,48,-20,28
Glentoran,7482,7,6,6,10,24,32,-8,24
Dungannon,7482,8,2,4,16,14,47,-33,10
Crusaders,7483,1,17,6,3,64,31,33,57
Coleraine,7483,2,14,11,1,45,24,21,53
Linfield,7483,3,11,5,10,39,37,2,38
Glenavon,7483,4,9,10,7,54,45,9,37
Cliftonville,7483,5,9,4,13,33,33,0,31
Ballymena,7483,6,7,4,15,26,50,-24,25
Glentoran,7483,7,6,6,10,24,32,-8,24
Dungannon,7483,8,2,4,16,14,47,-33,10
Crusaders,7484,1,16,7,3,62,31,31,55
Coleraine,7484,2,15,10,1,47,24,23,55
Linfield,7484,3,11,5,10,39,36,3,38
Glenavon,7484,4,9,9,8,54,47,7,36
Cliftonville,7484,5,9,4,13,32,33,-1,31
Ballymena,7484,6,7,5,14,26,48,-22,26
Glentoran,7484,7,6,6,10,24,32,-8,24
Dungannon,7484,8,2,4,16,14,47,-33,10
Crusaders,7485,1,16,7,3,62,31,31,55
Coleraine,7485,2,14,10,2,45,25,20,52
Glenavon,7485,3,10,9,7,55,45,10,39
Linfield,7485,4,11,5,10,38,36,2,38
Cliftonville,7485,5,9,4,13,32,32,0,31
Ballymena,7485,6,7,5,14,26,48,-22,26
Glentoran,7485,7,6,6,10,24,32,-8,24
Dungannon,7485,8,2,4,16,14,47,-33,10
Crusaders,7486,1,17,6,3,64,32,32,57
Coleraine,7486,2,14,10,2,44,24,20,52
Glenavon,7486,3,10,9,7,54,44,10,39
Linfield,7486,4,11,5,10,40,37,3,38
Cliftonville,7486,5,9,4,13,33,34,-1,31
Ballymena,7486,6,7,4,15,27,50,-23,25
Glentoran,7486,7,6,6,10,24,32,-8,24
Dungannon,7486,8,2,4,16,14,47,-33,10
Crusaders,7487,1,17,6,3,65,30,35,57
Coleraine,7487,2,15,10,1,45,23,22,55
Glenavon,7487,3,9,9,8,53,45,8,36
Linfield,7487,4,10,6,10,38,37,1,36
Cliftonville,7487,5,9,5,12,33,32,1,32
Ballymena,7487,6,7,4,15,25,51,-26,25
Glentoran,7487,7,6,6,10,24,32,-8,24
Dungannon,7487,8,2,4,16,14,47,-33,10
Crusaders,7488,1,16,7,3,62,31,31,55
Coleraine,7488,2,14,11,1,45,24,21,53
Linfield,7488,3,11,5,10,40,38,2,38
Glenavon,7488,4,9,10,7,54,45,9,37
Cliftonville,7488,5,9,4,13,34,34,0,31
Ballymena,7488,6,7,5,14,26,48,-22,26
Glentoran,7488,7,6,6,10,24,32,-8,24
Dungannon,7488,8,2,4,16,14,47,-33,10
Crusaders,7489,1,17,6,3,64,32,32,57
Coleraine,7489,2,15,10,1,47,24,23,55
Linfield,7489,3,11,5,10,41,36,5,38
Glenavon,7489,4,9,9,8,54,47,7,36
Cliftonville,7489,5,9,4,13,32,35,-3,31
Ballymena,7489,6,7,4,15,27,50,-23,25
Glentoran,7489,7,6,6,10,24,32,-8,24
Dungannon,7489,8,2,4,16,14,47,-33,10
Crusaders,7490,1,16,7,3,63,32,31,55
Coleraine,7490,2,14,10,2,44,24,20,52
Glenavon,7490,3,10,9,7,54,44,10,39
Linfield,7490,4,11,5,10,38,36,2,38
Cliftonville,7490,5,9,4,13,32,32,0,31
Ballymena,7490,6,7,5,14,27,49,-22,26
Glentoran,7490,7,6,6,10,24,32,-8,24
Dungannon,7490,8,2,4,16,14,47,-33,10
Crusaders,7491,1,16,6,4,61,31,30,54
Coleraine,7491,2,14,11,1,45,24,21,53
Linfield,7491,3,11,5,10,39,36,3,38
Glenavon,7491,4,9,10,7,54,45,9,37
Cliftonville,7491,5,9,4,13,32,33,-1,31
Ballymena,7491,6,8,4,14,26,47,-21,28
Glentoran,7491,7,6,6,10,24,32,-8,24
Dungannon,7491,8,2,4,16,14,47,-33,10
Crusaders,7492,1,16,7,3,63,32,31,55
Coleraine,7492,2,14,11,1,44,23,21,53
Glenavon,7492,3,9,10,7,53,44,9,37
Linfield,7492,4,10,5,11,37,37,0,35
Cliftonville,7492,5,10,4,12,33,31,2,34
Ballymena,7492,6,7,5,14,27,49,-22,26
Glentoran,7492,7,6,6,10,24,32,-8,24
Dungannon,7492,8,2,4,16,14,47,-33,10
Crusaders,7493,1,17,6,3,64,31,33,57
Coleraine,7493,2,14,10,2,44,24,20,52
Glenavon,7493,3,10,9,7,54,44,10,39
Linfield,7493,4,11,5,10,40,37,3,38
Cliftonville,7493,5,9,4,13,33,34,-1,31
Ballymena,7493,6,7,4,15,26,50,-24,25
Glentoran,7493,7,6,6,10,24,32,-8,24
Dungannon,7493,8,2,4,16,14,47,-33,10
Crusaders,7494,1,17,6,3,62,30,32,57
Coleraine,7494,2,15,10,1,45,23,22,55
Linfield,7494,3,11,5,10,38,36,2,38
Glenavon,7494,4,9,9,8,53,45,8,36
Cliftonville,7494,5,9,4,13,32,32,0,31
Ballymena,7494,6,7,4,15,25,48,-23,25
Glentoran,7494,7,6,6,10,24,32,-8,24
Dungannon,7494,8,2,4,16,14,47,-33,10
Crusaders,7495,1,17,6,3,66,31,35,57
Coleraine,7495,2,15,10,1,47,25,22,55
Linfield,7495,3,11,5,10,40,36,4,38
Glenavon,7495,4,9,9,8,55,47,8,36
Cliftonville,7495,5,9,4,13,32,34,-2,31
Ballymena,7495,6,7,4,15,26,52,-26,25
Glentoran,7495,7,6,6,10,24,32,-8,24
Dungannon,7495,8,2,4,16,14,47,-33,10
Crusaders,7496,1,16,7,3,61,30,31,55
Coleraine,7496,2,15,10,1,45,23,22,55
Linfield,7496,3,11,5,10,43,37,6,38
Glenavon,7496,4,9,9,8,53,45,8,36
Cliftonville,7496,5,9,4,13,33,37,-4,31
Ballymena,7496,6,7,5,14,25,47,-22,26
Glentoran,7496,7,6,6,10,24,32,-8,24
Dungannon,7496,8,2,4,16,14,47,-33,10
Crusaders,7497,1,16,6,4,64,34,30,54
Coleraine,7497,2,14,10,2,44,25,19,52
Glenavon,7497,3,10,9,7,55,44,11,39
Linfield,7497,4,10,6,10,38,37,1,36
Cliftonville,7497,5,9,5,12,33,32,1,32
Ballymena,7497,6,8,4,14,29,50,-21,28
Glentoran,7497,7,6,6,10,24,32,-8,24
Dungannon,7497,8,2,4,16,14,47,-33,10
Crusaders,7498,1,17,6,3,65,32,33,57
Coleraine,7498,2,14,10,2,44,25,19,52
Glenavon,7498,3,10,9,7,55,44,11,39
Linfield,7498,4,10,6,10,38,37,1,36
Cliftonville,7498,5,9,5,12,33,32,1,32
Ballymena,7498,6,7,4,15,27,51,-24,25
Glentoran,7498,7,6,6,10,24,32,-8,24
Dungannon,7498,8,2,4,16,14,47,-33,10
Coleraine,7499,1,15,10,1,44,22,22,55
Crusaders,7499,2,16,6,4,61,31,30,54
Glenavon,7499,3,9,9,8,52,44,8,36
Linfield,7499,4,10,6,10,37,36,1,36
Cliftonville,7499,5,9,5,12,32,31,1,32
Ballymena,7499,6,8,4,14,26,47,-21,28
Glentoran,7499,7,6,6,10,24,32,-8,24
Dungannon,7499,8,2,4,16,14,47,-33,10
Crusaders,7500,1,17,6,3,62,30,32,57
Coleraine,7500,2,14,11,1,45,24,21,53
Glenavon,7500,3,9,10,7,54,45,9,37
Linfield,7500,4,10,5,11,38,38,0,35
Cliftonville,7500,5,10,4,12,34,32,2,34
Ballymena,7500,6,7,4,15,25,48,-23,25
Glentoran,7500,7,6,6,10,24,32,-8,24
Dungannon,7500,8,2,4,16,14,47,-33,10
Crusaders,7501,1,16,6,4,61,31,30,54
Coleraine,7501,2,14,11,1,45,24,21,53
Linfield,7501,3,11,5,10,39,37,2,38
Glenavon,7501,4,9,10,7,54,45,9,37
Cliftonville,7501,5,9,4,13,33,33,0,31
Ballymena,7501,6,8,4,14,26,47,-21,28
Glentoran,7501,7,6,6,10,24,32,-8,24
Dungannon,7501,8,2,4,16,14,47,-33,10
Crusaders,7502,1,16,6,4,64,34,30,54
Coleraine,7502,2,14,11,1,43,22,21,53
Glenavon,7502,3,9,10,7,52,43,9,37
Linfield,7502,4,10,5,11,37,40,-3,35
Cliftonville,7502,5,10,4,12,36,31,5,34
Ballymena,7502,6,8,4,14,29,50,-21,28
Glentoran,7502,7,6,6,10,24,32,-8,24
Dungannon,7502,8,2,4,16,14,47,-33,10
Crusaders,7503,1,17,6,3,63,31,32,57
Coleraine,7503,2,14,10,2,43,26,17,52
Glenavon,7503,3,10,9,7,56,43,13,39
Linfield,7503,4,11,5,10,38,36,2,38
Cliftonville,7503,5,9,4,13,32,32,0,31
Ballymena,7503,6,7,4,15,26,49,-23,25
Glentoran,7503,7,6,6,10,24,32,-8,24
Dungannon,7503,8,2,4,16,14,47,-33,10
Crusaders,7504,1,16,6,4,62,32,30,54
Coleraine,7504,2,14,11,1,45,24,21,53
Glenavon,7504,3,9,10,7,54,45,9,37
Linfield,7504,4,10,6,10,39,38,1,36
Cliftonville,7504,5,9,5,12,34,33,1,32
Ballymena,7504,6,8,4,14,27,48,-21,28
Glentoran,7504,7,6,6,10,24,32,-8,24
Dungannon,7504,8,2,4,16,14,47,-33,10
Crusaders,7505,1,17,6,3,62,30,32,57
Coleraine,7505,2,14,10,2,45,25,20,52
Glenavon,7505,3,10,9,7,55,45,10,39
Linfield,7505,4,10,6,10,38,37,1,36
Cliftonville,7505,5,9,5,12,33,32,1,32
Ballymena,7505,6,7,4,15,25,48,-23,25
Glentoran,7505,7,6,6,10,24,32,-8,24
Dungannon,7505,8,2,4,16,14,47,-33,10
Crusaders,7506,1,17,6,3,63,31,32,57
Coleraine,7506,2,15,10,1,47,23,24,55
Linfield,7506,3,11,5,10,40,37,3,38
Glenavon,7506,4,9,9,8,53,47,6,36
Cliftonville,7506,5,9,4,13,33,34,-1,31
Ballymena,7506,6,7,4,15,26,49,-23,25
Glentoran,7506,7,6,6,10,24,32,-8,24
Dungannon,7506,8,2,4,16,14,47,-33,10
Crusaders,7507,1,16,7,3,62,31,31,55
Coleraine,7507,2,15,10,1,47,24,23,55
Linfield,7507,3,11,5,10,38,36,2,38
Glenavon,7507,4,9,9,8,54,47,7,36
Cliftonville,7507,5,9,4,13,32,32,0,31
Ballymena,7507,6,7,5,14,26,48,-22,26
Glentoran,7507,7,6,6,10,24,32,-8,24
Dungannon,7507,8,2,4,16,14,47,-33,10
Coleraine,7508,1,15,10,1,48,25,23,55
Crusaders,7508,2,16,6,4,61,31,30,54
Glenavon,7508,3,9,9,8,55,48,7,36
Linfield,7508,4,10,5,11,37,38,-1,35
Cliftonville,7508,5,10,4,12,34,31,3,34
Ballymena,7508,6,8,4,14,26,47,-21,28
Glentoran,7508,7,6,6,10,24,32,-8,24
Dungannon,7508,8,2,4,16,14,47,-33,10
Coleraine,7509,1,15,10,1,45,22,23,55
Crusaders,7509,2,16,6,4,61,31,30,54
Linfield,7509,3,11,5,10,39,36,3,38
Glenavon,7509,4,9,9,8,52,45,7,36
Cliftonville,7509,5,9,4,13,32,33,-1,31
Ballymena,7509,6,8,4,14,26,47,-21,28
Glentoran,7509,7,6,6,10,24,32,-8,24
Dungannon,7509,8,2,4,16,14,47,-33,10
Crusaders,7510,1,17,6,3,65,32,33,57
Coleraine,7510,2,14,10,2,44,25,19,52
Glenavon,7510,3,10,9,7,55,44,11,39
Linfield,7510,4,10,5,11,39,39,0,35
Cliftonville,7510,5,10,4,12,35,33,2,34
Ballymena,7510,6,7,4,15,27,51,-24,25
Glentoran,7510,7,6,6,10,24,32,-8,24
Dungannon,7510,8,2,4,16,14,47,-33,10
Crusaders,7511,1,16,7,3,63,32,31,55
Coleraine,7511,2,15,10,1,46,24,22,55
Glenavon,7511,3,9,9,8,54,46,8,36
Linfield,7511,4,10,5,11,38,39,-1,35
Cliftonville,7511,5,10,4,12,35,32,3,34
Ballymena,7511,6,7,5,14,27,49,-22,26
Glentoran,7511,7,6,6,10,24,32,-8,24
Dungannon,7511,8,2,4,16,14,47,-33,10
Crusaders,7512,1,17,6,3,63,31,32,57
Coleraine,7512,2,14,10,2,43,24,19,52
Glenavon,7512,3,10,9,7,54,43,11,39
Linfield,7512,4,10,5,11,38,38,0,35
Cliftonville,7512,5,10,4,12,34,32,2,34
Ballymena,7512,6,7,4,15,26,49,-23,25
Glentoran,7512,7,6,6,10,24,32,-8,24
Dungannon,7512,8,2,4,16,14,47,-33,10
Crusaders,7513,1,16,7,3,62,31,31,55
Coleraine,7513,2,14,10,2,44,24,20,52
Glenavon,7513,3,10,9,7,54,44,10,39
Linfield,7513,4,10,6,10,37,36,1,36
Cliftonville,7513,5,9,5,12,32,31,1,32
Ballymena,7513,6,7,5,14,26,48,-22,26
Glentoran,7513,7,6,6,10,24,32,-8,24
Dungannon,7513,8,2,4,16,14,47,-33,10
Coleraine,7514,1,15,10,1,45,23,22,55
Crusaders,7514,2,16,6,4,61,32,29,54
Glenavon,7514,3,9,9,8,53,45,8,36
Linfield,7514,4,10,6,10,39,38,1,36
Cliftonville,7514,5,9,5,12,34,33,1,32
Ballymena,7514,6,8,4,14,27,47,-20,28
Glentoran,7514,7,6,6,10,24,32,-8,24
Dungannon,7514,8,2,4,16,14,47,-33,10
Crusaders,7515,1,16,7,3,64,33,31,55
Coleraine,7515,2,15,10,1,44,22,22,55
Glenavon,7515,3,9,9,8,52,44,8,36
Linfield,7515,4,10,5,11,38,38,0,35
Cliftonville,7515,5,10,4,12,34,32,2,34
Ballymena,7515,6,7,5,14,28,50,-22,26
Glentoran,7515,7,6,6,10,24,32,-8,24
Dungannon,7515,8,2,4,16,14,47,-33,10
Crusaders,7516,1,17,6,3,64,30,34,57
Coleraine,7516,2,15,10,1,45,23,22,55
Linfield,7516,3,11,5,10,40,37,3,38
Glenavon,7516,4,9,9,8,53,45,8,36
Cliftonville,7516,5,9,4,13,33,34,-1,31
Ballymena,7516,6,7,4,15,25,50,-25,25
Glentoran,7516,7,6,6,10,24,32,-8,24
Dungannon,7516,8,2,4,16,14,47,-33,10
Crusaders,7517,1,16,7,3,62,31,31,55
Coleraine,7517,2,14,11,1,45,24,21,53
Linfield,7517,3,11,5,10,38,36,2,38
Glenavon,7517,4,9,10,7,54,45,9,37
Cliftonville,7517,5,9,4,13,32,32,0,31
Ballymena,7517,6,7,5,14,26,48,-22,26
Glentoran,7517,7,6,6,10,24,32,-8,24
Dungannon,7517,8,2,4,16,14,47,-33,10
Crusaders,7518,1,16,6,4,61,31,30,54
Coleraine,7518,2,14,11,1,43,22,21,53
Linfield,7518,3,11,5,10,39,36,3,38
Glenavon,7518,4,9,10,7,52,43,9,37
Cliftonville,7518,5,9,4,13,32,33,-1,31
Ballymena,7518,6,8,4,14,26,47,-21,28
Glentoran,7518,7,6,6,10,24,32,-8,24
Dungannon,7518,8,2,4,16,14,47,-33,10
Crusaders,7519,1,16,6,4,63,34,29,54
Coleraine,7519,2,14,10,2,44,25,19,52
Glenavon,7519,3,10,9,7,55,44,11,39
Linfield,7519,4,10,6,10,37,36,1,36
Cliftonville,7519,5,9,5,12,32,31,1,32
Ballymena,7519,6,8,4,14,29,49,-20,28
Glentoran,7519,7,6,6,10,24,32,-8,24
Dungannon,7519,8,2,4,16,14,47,-33,10
Crusaders,7520,1,17,6,3,65,31,34,57
Coleraine,7520,2,14,10,2,43,25,18,52
Glenavon,7520,3,10,9,7,55,43,12,39
Linfield,7520,4,10,5,11,37,38,-1,35
Cliftonville,7520,5,10,4,12,34,31,3,34
Ballymena,7520,6,7,4,15,26,51,-25,25
Glentoran,7520,7,6,6,10,24,32,-8,24
Dungannon,7520,8,2,4,16,14,47,-33,10
Crusaders,7521,1,16,6,4,62,32,30,54
Coleraine,7521,2,14,10,2,46,26,20,52
Glenavon,7521,3,10,9,7,56,46,10,39
Linfield,7521,4,11,5,10,42,37,5,38
Cliftonville,7521,5,9,4,13,33,36,-3,31
Ballymena,7521,6,8,4,14,27,48,-21,28
Glentoran,7521,7,6,6,10,24,32,-8,24
Dungannon,7521,8,2,4,16,14,47,-33,10
Crusaders,7522,1,16,6,4,62,33,29,54
Coleraine,7522,2,14,10,2,45,27,18,52
Glenavon,7522,3,10,9,7,57,45,12,39
Linfield,7522,4,11,5,10,38,36,2,38
Cliftonville,7522,5,9,4,13,32,32,0,31
Ballymena,7522,6,8,4,14,28,48,-20,28
Glentoran,7522,7,6,6,10,24,32,-8,24
Dungannon,7522,8,2,4,16,14,47,-33,10
Coleraine,7523,1,15,10,1,48,24,24,55
Crusaders,7523,2,16,6,4,62,32,30,54
Glenavon,7523,3,9,9,8,54,48,6,36
Linfield,7523,4,10,6,10,39,38,1,36
Cliftonville,7523,5,9,5,12,34,33,1,32
Ballymena,7523,6,8,4,14,27,48,-21,28
Glentoran,7523,7,6,6,10,24,32,-8,24
Dungannon,7523,8,2,4,16,14,47,-33,10
Crusaders,7524,1,17,6,3,66,33,33,57
Coleraine,7524,2,14,10,2,44,24,20,52
Glenavon,7524,3,10,9,7,54,44,10,39
Linfield,7524,4,10,5,11,38,39,-1,35
Cliftonville,7524,5,10,4,12,35,32,3,34
Ballymena,7524,6,7,4,15,28,52,-24,25
Glentoran,7524,7,6,6,10,24,32,-8,24
Dungannon,7524,8,2,4,16,14,47,-33,10
Crusaders,7525,1,16,7,3,64,33,31,55
Coleraine,7525,2,14,10,2,43,23,20,52
Glenavon,7525,3,10,9,7,53,43,10,39
Linfield,7525,4,10,6,10,38,37,1,36
Cliftonville,7525,5,9,5,12,33,32,1,32
Ballymena,7525,6,7,5,14,28,50,-22,26
Glentoran,7525,7,6,6,10,24,32,-8,24
Dungannon,7525,8,2,4,16,14,47,-33,10
Crusaders,7526,1,17,6,3,63,31,32,57
Coleraine,7526,2,15,10,1,44,22,22,55
Linfield,7526,3,11,5,10,38,36,2,38
Glenavon,7526,4,9,9,8,52,44,8,36
Cliftonville,7526,5,9,4,13,32,32,0,31
Ballymena,7526,6,7,4,15,26,49,-23,25
Glentoran,7526,7,6,6,10,24,32,-8,24
Dungannon,7526,8,2,4,16,14,47,-33,10
Crusaders,7527,1,16,7,3,63,32,31,55
Coleraine,7527,2,15,10,1,44,22,22,55
Glenavon,7527,3,9,9,8,52,44,8,36
Linfield,7527,4,10,5,11,38,38,0,35
Cliftonville,7527,5,10,4,12,34,32,2,34
Ballymena,7527,6,7,5,14,27,49,-22,26
Glentoran,7527,7,6,6,10,24,32,-8,24
Dungannon,7527,8,2,4,16,14,47,-33,10
Crusaders,7528,1,17,6,3,64,30,34,57
Coleraine,7528,2,14,11,1,44,23,21,53
Glenavon,7528,3,9,10,7,53,44,9,37
Linfield,7528,4,10,6,10,37,36,1,36
Cliftonville,7528,5,9,5,12,32,31,1,32
Ballymena,7528,6,7,4,15,25,50,-25,25
Glentoran,7528,7,6,6,10,24,32,-8,24
Dungannon,7528,8,2,4,16,14,47,-33,10
Crusaders,7529,1,17,6,3,67,31,36,57
Coleraine,7529,2,15,10,1,45,23,22,55
Glenavon,7529,3,9,9,8,53,45,8,36
Linfield,7529,4,10,5,11,38,38,0,35
Cliftonville,7529,5,10,4,12,34,32,2,34
Ballymena,7529,6,7,4,15,26,53,-27,25
Glentoran,7529,7,6,6,10,24,32,-8,24
Dungannon,7529,8,2,4,16,14,47,-33,10
Crusaders,7530,1,17,6,3,63,31,32,57
Coleraine,7530,2,14,10,2,44,25,19,52
Glenavon,7530,3,10,9,7,55,44,11,39
Linfield,7530,4,11,5,10,39,36,3,38
Cliftonville,7530,5,9,4,13,32,33,-1,31
Ballymena,7530,6,7,4,15,26,49,-23,25
Glentoran,7530,7,6,6,10,24,32,-8,24
Dungannon,7530,8,2,4,16,14,47,-33,10
Crusaders,7531,1,17,6,3,65,30,35,57
Coleraine,7531,2,14,10,2,44,25,19,52
Glenavon,7531,3,10,9,7,55,44,11,39
Linfield,7531,4,11,5,10,39,37,2,38
Cliftonville,7531,5,9,4,13,33,33,0,31
Ballymena,7531,6,7,4,15,25,51,-26,25
Glentoran,7531,7,6,6,10,24,32,-8,24
Dungannon,7531,8,2,4,16,14,47,-33,10
Crusaders,7532,1,17,6,3,63,30,33,57
Coleraine,7532,2,14,10,2,44,24,20,52
Glenavon,7532,3,10,9,7,54,44,10,39
Linfield,7532,4,10,6,10,37,36,1,36
Cliftonville,7532,5,9,5,12,32,31,1,32
Ballymena,7532,6,7,4,15,25,49,-24,25
Glentoran,7532,7,6,6,10,24,32,-8,24
Dungannon,7532,8,2,4,16,14,47,-33,10
Crusaders,7533,1,16,7,3,64,33,31,55
Coleraine,7533,2,15,10,1,47,23,24,55
Linfield,7533,3,11,5,10,39,36,3,38
Glenavon,7533,4,9,9,8,53,47,6,36
Cliftonville,7533,5,9,4,13,32,33,-1,31
Ballymena,7533,6,7,5,14,28,50,-22,26
Glentoran,7533,7,6,6,10,24,32,-8,24
Dungannon,7533,8,2,4,16,14,47,-33,10
Crusaders,7534,1,16,7,3,63,32,31,55
Coleraine,7534,2,14,11,1,44,23,21,53
Linfield,7534,3,11,5,10,40,37,3,38
Glenavon,7534,4,9,10,7,53,44,9,37
Cliftonville,7534,5,9,4,13,33,34,-1,31
Ballymena,7534,6,7,5,14,27,49,-22,26
Glentoran,7534,7,6,6,10,24,32,-8,24
Dungannon,7534,8,2,4,16,14,47,-33,10
Crusaders,7535,1,17,6,3,64,32,32,57
Coleraine,7535,2,14,11,1,43,22,21,53
Glenavon,7535,3,9,10,7,52,43,9,37
Linfield,7535,4,10,5,11,38,38,0,35
Cliftonville,7535,5,10,4,12,34,32,2,34
Ballymena,7535,6,7,4,15,27,50,-23,25
Glentoran,7535,7,6,6,10,24,32,-8,24
Dungannon,7535,8,2,4,16,14,47,-33,10
Crusaders,7536,1,16,6,4,62,32,30,54
Coleraine,7536,2,14,11,1,45,24,21,53
Glenavon,7536,3,9,10,7,54,45,9,37
Linfield,7536,4,10,6,10,39,38,1,36
Cliftonville,7536,5,9,5,12,34,33,1,32
Ballymena,7536,6,8,4,14,27,48,-21,28
Glentoran,7536,7,6,6,10,24,32,-8,24
Dungannon,7536,8,2,4,16,14,47,-33,10
Crusaders,7537,1,16,6,4,61,35,26,54
Coleraine,7537,2,14,10,2,45,26,19,52
Glenavon,7537,3,10,9,7,56,45,11,39
Linfield,7537,4,11,5,10,38,36,2,38
Cliftonville,7537,5,9,4,13,32,32,0,31
Ballymena,7537,6,8,4,14,30,47,-17,28
Glentoran,7537,7,6,6,10,24,32,-8,24
Dungannon,7537,8,2,4,16,14,47,-33,10
Crusaders,7538,1,17,6,3,63,31,32,57
Coleraine,7538,2,14,10,2,44,25,19,52
Glenavon,7538,3,10,9,7,55,44,11,39
Linfield,7538,4,11,5,10,40,36,4,38
Cliftonville,7538,5,9,4,13,32,34,-2,31
Ballymena,7538,6,7,4,15,26,49,-23,25
Glentoran,7538,7,6,6,10,24,32,-8,24
Dungannon,7538,8,2,4,16,14,47,-33,10
Crusaders,7539,1,16,6,4,63,33,30,54
Coleraine,7539,2,14,10,2,44,25,19,52
Glenavon,7539,3,10,9,7,55,44,11,39
Linfield,7539,4,11,5,10,40,36,4,38
Cliftonville,7539,5,9,4,13,32,34,-2,31
Ballymena,7539,6,8,4,14,28,49,-21,28
Glentoran,7539,7,6,6,10,24,32,-8,24
Dungannon,7539,8,2,4,16,14,47,-33,10
Crusaders,7540,1,17,6,3,64,31,33,57
Coleraine,7540,2,14,10,2,44,25,19,52
Glenavon,7540,3,10,9,7,55,44,11,39
Linfield,7540,4,10,6,10,38,37,1,36
Cliftonville,7540,5,9,5,12,33,32,1,32
Ballymena,7540,6,7,4,15,26,50,-24,25
Glentoran,7540,7,6,6,10,24,32,-8,24
Dungannon,7540,8,2,4,16,14,47,-33,10
Crusaders,7541,1,16,7,3,62,31,31,55
Coleraine,7541,2,14,11,1,45,24,21,53
Linfield,7541,3,11,5,10,38,36,2,38
Glenavon,7541,4,9,10,7,54,45,9,37
Cliftonville,7541,5,9,4,13,32,32,0,31
Ballymena,7541,6,7,5,14,26,48,-22,26
Glentoran,7541,7,6,6,10,24,32,-8,24
Dungannon,7541,8,2,4,16,14,47,-33,10
Crusaders,7542,1,17,6,3,65,30,35,57
Coleraine,7542,2,14,10,2,44,24,20,52
Glenavon,7542,3,10,9,7,54,44,10,39
Linfield,7542,4,10,5,11,38,38,0,35
Cliftonville,7542,5,10,4,12,34,32,2,34
Ballymena,7542,6,7,4,15,25,51,-26,25
Glentoran,7542,7,6,6,10,24,32,-8,24
Dungannon,7542,8,2,4,16,14,47,-33,10
Crusaders,7543,1,16,6,4,61,32,29,54
Coleraine,7543,2,14,11,1,44,23,21,53
Glenavon,7543,3,9,10,7,53,44,9,37
Linfield,7543,4,10,5,11,37,37,0,35
Cliftonville,7543,5,10,4,12,33,31,2,34
Ballymena,7543,6,8,4,14,27,47,-20,28
Glentoran,7543,7,6,6,10,24,32,-8,24
Dungannon,7543,8,2,4,16,14,47,-33,10
Crusaders,7544,1,16,7,3,62,31,31,55
Coleraine,7544,2,14,10,2,43,25,18,52
Glenavon,7544,3,10,9,7,55,43,12,39
Linfield,7544,4,10,5,11,37,38,-1,35
Cliftonville,7544,5,10,4,12,34,31,3,34
Ballymena,7544,6,7,5,14,26,48,-22,26
Glentoran,7544,7,6,6,10,24,32,-8,24
Dungannon,7544,8,2,4,16,14,47,-33,10
Crusaders,7545,1,17,6,3,64,32,32,57
Coleraine,7545,2,14,10,2,43,23,20,52
Glenavon,7545,3,10,9,7,53,43,10,39
Linfield,7545,4,10,6,10,39,38,1,36
Cliftonville,7545,5,9,5,12,34,33,1,32
Ballymena,7545,6,7,4,15,27,50,-23,25
Glentoran,7545,7,6,6,10,24,32,-8,24
Dungannon,7545,8,2,4,16,14,47,-33,10
Coleraine,7546,1,15,10,1,45,23,22,55
Crusaders,7546,2,16,6,4,63,33,30,54
Glenavon,7546,3,9,9,8,53,45,8,36
Linfield,7546,4,10,5,11,37,38,-1,35
Cliftonville,7546,5,10,4,12,34,31,3,34
Ballymena,7546,6,8,4,14,28,49,-21,28
Glentoran,7546,7,6,6,10,24,32,-8,24
Dungannon,7546,8,2,4,16,14,47,-33,10
Crusaders,7547,1,17,6,3,64,32,32,57
Coleraine,7547,2,15,10,1,46,22,24,55
Linfield,7547,3,11,5,10,39,36,3,38
Glenavon,7547,4,9,9,8,52,46,6,36
Cliftonville,7547,5,9,4,13,32,33,-1,31
Ballymena,7547,6,7,4,15,27,50,-23,25
Glentoran,7547,7,6,6,10,24,32,-8,24
Dungannon,7547,8,2,4,16,14,47,-33,10
Coleraine,7548,1,15,10,1,46,22,24,55
Crusaders,7548,2,16,6,4,61,32,29,54
Glenavon,7548,3,9,9,8,52,46,6,36
Linfield,7548,4,10,5,11,37,37,0,35
Cliftonville,7548,5,10,4,12,33,31,2,34
Ballymena,7548,6,8,4,14,27,47,-20,28
Glentoran,7548,7,6,6,10,24,32,-8,24
Dungannon,7548,8,2,4,16,14,47,-33,10
Crusaders,7549,1,17,6,3,63,31,32,57
Coleraine,7549,2,14,11,1,43,22,21,53
Linfield,7549,3,11,5,10,39,37,2,38
Glenavon,7549,4,9,10,7,52,43,9,37
Cliftonville,7549,5,9,4,13,33,33,0,31
Ballymena,7549,6,7,4,15,26,49,-23,25
Glentoran,7549,7,6,6,10,24,32,-8,24
Dungannon,7549,8,2,4,16,14,47,-33,10
Crusaders,7550,1,17,6,3,63,31,32,57
Coleraine,7550,2,14,10,2,44,24,20,52
Glenavon,7550,3,10,9,7,54,44,10,39
Linfield,7550,4,11,5,10,38,36,2,38
Cliftonville,7550,5,9,4,13,32,32,0,31
Ballymena,7550,6,7,4,15,26,49,-23,25
Glentoran,7550,7,6,6,10,24,32,-8,24
Dungannon,7550,8,2,4,16,14,47,-33,10
Coleraine,7551,1,15,10,1,46,22,24,55
Crusaders,7551,2,16,6,4,62,33,29,54
Linfield,7551,3,11,5,10,40,37,3,38
Glenavon,7551,4,9,9,8,52,46,6,36
Cliftonville,7551,5,9,4,13,33,34,-1,31
Ballymena,7551,6,8,4,14,28,48,-20,28
Glentoran,7551,7,6,6,10,24,32,-8,24
Dungannon,7551,8,2,4,16,14,47,-33,10
Crusaders,7552,1,16,6,4,62,32,30,54
Coleraine,7552,2,14,10,2,43,23,20,52
Glenavon,7552,3,10,9,7,53,43,10,39
Linfield,7552,4,11,5,10,42,37,5,38
Cliftonville,7552,5,9,4,13,33,36,-3,31
Ballymena,7552,6,8,4,14,27,48,-21,28
Glentoran,7552,7,6,6,10,24,32,-8,24
Dungannon,7552,8,2,4,16,14,47,-33,10
Crusaders,7553,1,17,6,3,64,30,34,57
Coleraine,7553,2,15,10,1,45,23,22,55
Linfield,7553,3,11,5,10,39,36,3,38
Glenavon,7553,4,9,9,8,53,45,8,36
Cliftonville,7553,5,9,4,13,32,33,-1,31
Ballymena,7553,6,7,4,15,25,50,-25,25
Glentoran,7553,7,6,6,10,24,32,-8,24
Dungannon,7553,8,2,4,16,14,47,-33,10
Coleraine,7554,1,15,10,1,45,22,23,55
Crusaders,7554,2,16,6,4,61,31,30,54
Glenavon,7554,3,9,9,8,52,45,7,36
Linfield,7554,4,10,6,10,38,37,1,36
Cliftonville,7554,5,9,5,12,33,32,1,32
Ballymena,7554,6,8,4,14,26,47,-21,28
Glentoran,7554,7,6,6,10,24,32,-8,24
Dungannon,7554,8,2,4,16,14,47,-33,10
Crusaders,7555,1,17,6,3,65,33,32,57
Coleraine,7555,2,14,10,2,43,23,20,52
Glenavon,7555,3,10,9,7,53,43,10,39
Linfield,7555,4,10,6,10,38,37,1,36
Cliftonville,7555,5,9,5,12,33,32,1,32
Ballymena,7555,6,7,4,15,28,51,-23,25
Glentoran,7555,7,6,6,10,24,32,-8,24
Dungannon,7555,8,2,4,16,14,47,-33,10
Crusaders,7556,1,16,6,4,62,33,29,54
Coleraine,7556,2,14,10,2,44,25,19,52
Glenavon,7556,3,10,9,7,55,44,11,39
Linfield,7556,4,11,5,10,40,38,2,38
Cliftonville,7556,5,9,4,13,34,34,0,31
Ballymena,7556,6,8,4,14,28,48,-20,28
Glentoran,7556,7,6,6,10,24,32,-8,24
Dungannon,7556,8,2,4,16,14,47,-33,10
Crusaders,7557,1,16,7,3,64,33,31,55
Coleraine,7557,2,14,11,1,44,23,21,53
Glenavon,7557,3,9,10,7,53,44,9,37
Linfield,7557,4,10,6,10,38,37,1,36
Cliftonville,7557,5,9,5,12,33,32,1,32
Ballymena,7557,6,7,5,14,28,50,-22,26
Glentoran,7557,7,6,6,10,24,32,-8,24
Dungannon,7557,8,2,4,16,14,47,-33,10
Crusaders,7558,1,17,6,3,63,31,32,57
Coleraine,7558,2,14,10,2,45,26,19,52
Glenavon,7558,3,10,9,7,56,45,11,39
Linfield,7558,4,11,5,10,39,37,2,38
Cliftonville,7558,5,9,4,13,33,33,0,31
Ballymena,7558,6,7,4,15,26,49,-23,25
Glentoran,7558,7,6,6,10,24,32,-8,24
Dungannon,7558,8,2,4,16,14,47,-33,10
Coleraine,7559,1,15,10,1,45,22,23,55
Crusaders,7559,2,16,6,4,61,31,30,54
Glenavon,7559,3,9,9,8,52,45,7,36
Linfield,7559,4,10,6,10,39,38,1,36
Cliftonville,7559,5,9,5,12,34,33,1,32
Ballymena,7559,6,8,4,14,26,47,-21,28
Glentoran,7559,7,6,6,10,24,32,-8,24
Dungannon,7559,8,2,4,16,14,47,-33,10
Crusaders,7560,1,16,7,3,63,32,31,55
Coleraine,7560,2,15,10,1,45,22,23,55
Linfield,7560,3,11,5,10,41,38,3,38
Glenavon,7560,4,9,9,8,52,45,7,36
Cliftonville,7560,5,9,4,13,34,35,-1,31
Ballymena,7560,6,7,5,14,27,49,-22,26
Glentoran,7560,7,6,6,10,24,32,-8,24
Dungannon,7560,8,2,4,16,14,47,-33,10
Crusaders,7561,1,16,7,3,62,31,31,55
Coleraine,7561,2,14,10,2,44,25,19,52
Glenavon,7561,3,10,9,7,55,44,11,39
Linfield,7561,4,11,5,10,42,37,5,38
Cliftonville,7561,5,9,4,13,33,36,-3,31
Ballymena,7561,6,7,5,14,26,48,-22,26
Glentoran,7561,7,6,6,10,24,32,-8,24
Dungannon,7561,8,2,4,16,14,47,-33,10
Crusaders,7562,1,16,6,4,61,31,30,54
Coleraine,7562,2,14,10,2,44,24,20,52
Glenavon,7562,3,10,9,7,54,44,10,39
Linfield,7562,4,10,5,11,37,37,0,35
Cliftonville,7562,5,10,4,12,33,31,2,34
Ballymena,7562,6,8,4,14,26,47,-21,28
Glentoran,7562,7,6,6,10,24,32,-8,24
Dungannon,7562,8,2,4,16,14,47,-33,10
Crusaders,7563,1,17,6,3,64,32,32,57
Coleraine,7563,2,14,10,2,45,26,19,52
Glenavon,7563,3,10,9,7,56,45,11,39
Linfield,7563,4,10,6,10,37,36,1,36
Cliftonville,7563,5,9,5,12,32,31,1,32
Ballymena,7563,6,7,4,15,27,50,-23,25
Glentoran,7563,7,6,6,10,24,32,-8,24
Dungannon,7563,8,2,4,16,14,47,-33,10
Crusaders,7564,1,17,6,3,62,30,32,57
Coleraine,7564,2,15,10,1,46,24,22,55
Glenavon,7564,3,9,9,8,54,46,8,36
Linfield,7564,4,10,6,10,38,37,1,36
Cliftonville,7564,5,9,5,12,33,32,1,32
Ballymena,7564,6,7,4,15,25,48,-23,25
Glentoran,7564,7,6,6,10,24,32,-8,24
Dungannon,7564,8,2,4,16,14,47,-33,10
Crusaders,7565,1,17,6,3,65,33,32,57
Coleraine,7565,2,14,11,1,46,25,21,53
Glenavon,7565,3,9,10,7,55,46,9,37
Linfield,7565,4,10,6,10,38,37,1,36
Cliftonville,7565,5,9,5,12,33,32,1,32
Ballymena,7565,6,7,4,15,28,51,-23,25
Glentoran,7565,7,6,6,10,24,32,-8,24
Dungannon,7565,8,2,4,16,14,47,-33,10
Crusaders,7566,1,17,6,3,64,32,32,57
Coleraine,7566,2,15,10,1,45,23,22,55
Glenavon,7566,3,9,9,8,53,45,8,36
Linfield,7566,4,10,6,10,37,36,1,36
Cliftonville,7566,5,9,5,12,32,31,1,32
Ballymena,7566,6,7,4,15,27,50,-23,25
Glentoran,7566,7,6,6,10,24,32,-8,24
Dungannon,7566,8,2,4,16,14,47,-33,10
Crusaders,7567,1,16,7,3,63,32,31,55
Coleraine,7567,2,14,10,2,44,24,20,52
Glenavon,7567,3,10,9,7,54,44,10,39
Linfield,7567,4,11,5,10,41,37,4,38
Cliftonville,7567,5,9,4,13,33,35,-2,31
Ballymena,7567,6,7,5,14,27,49,-22,26
Glentoran,7567,7,6,6,10,24,32,-8,24
Dungannon,7567,8,2,4,16,14,47,-33,10
Crusaders,7568,1,16,7,3,62,31,31,55
Coleraine,7568,2,15,10,1,48,22,26,55
Glenavon,7568,3,9,9,8,52,48,4,36
Linfield,7568,4,10,6,10,37,36,1,36
Cliftonville,7568,5,9,5,12,32,31,1,32
Ballymena,7568,6,7,5,14,26,48,-22,26
Glentoran,7568,7,6,6,10,24,32,-8,24
Dungannon,7568,8,2,4,16,14,47,-33,10
Crusaders,7569,1,16,6,4,63,33,30,54
Coleraine,7569,2,14,10,2,44,25,19,52
Glenavon,7569,3,10,9,7,55,44,11,39
Linfield,7569,4,10,5,11,38,39,-1,35
Cliftonville,7569,5,10,4,12,35,32,3,34
Ballymena,7569,6,8,4,14,28,49,-21,28
Glentoran,7569,7,6,6,10,24,32,-8,24
Dungannon,7569,8,2,4,16,14,47,-33,10
Crusaders,7570,1,16,7,3,63,32,31,55
Coleraine,7570,2,14,10,2,45,25,20,52
Glenavon,7570,3,10,9,7,55,45,10,39
Linfield,7570,4,10,5,11,37,37,0,35
Cliftonville,7570,5,10,4,12,33,31,2,34
Ballymena,7570,6,7,5,14,27,49,-22,26
Glentoran,7570,7,6,6,10,24,32,-8,24
Dungannon,7570,8,2,4,16,14,47,-33,10
Coleraine,7571,1,15,10,1,45,23,22,55
Crusaders,7571,2,16,6,4,62,33,29,54
Glenavon,7571,3,9,9,8,53,45,8,36
Linfield,7571,4,10,6,10,39,38,1,36
Cliftonville,7571,5,9,5,12,34,33,1,32
Ballymena,7571,6,8,4,14,28,48,-20,28
Glentoran,7571,7,6,6,10,24,32,-8,24
Dungannon,7571,8,2,4,16,14,47,-33,10
Crusaders,7572,1,17,6,3,63,30,33,57
Coleraine,7572,2,14,10,2,43,26,17,52
Glenavon,7572,3,10,9,7,56,43,13,39
Linfield,7572,4,10,5,11,39,40,-1,35
Cliftonville,7572,5,10,4,12,36,33,3,34
Ballymena,7572,6,7,4,15,25,49,-24,25
Glentoran,7572,7,6,6,10,24,32,-8,24
Dungannon,7572,8,2,4,16,14,47,-33,10
Coleraine,7573,1,15,10,1,46,23,23,55
Crusaders,7573,2,16,6,4,62,32,30,54
Linfield,7573,3,11,5,10,39,37,2,38
Glenavon,7573,4,9,9,8,53,46,7,36
Cliftonville,7573,5,9,4,13,33,33,0,31
Ballymena,7573,6,8,4,14,27,48,-21,28
Glentoran,7573,7,6,6,10,24,32,-8,24
Dungannon,7573,8,2,4,16,14,47,-33,10
Crusaders,7574,1,17,6,3,63,31,32,57
Coleraine,7574,2,15,10,1,45,22,23,55
Glenavon,7574,3,9,9,8,52,45,7,36
Linfield,7574,4,10,5,11,38,41,-3,35
Cliftonville,7574,5,10,4,12,37,32,5,34
Ballymena,7574,6,7,4,15,26,49,-23,25
Glentoran,7574,7,6,6,10,24,32,-8,24
Dungannon,7574,8,2,4,16,14,47,-33,10
Crusaders,7575,1,16,6,4,61,32,29,54
Coleraine,7575,2,14,11,1,46,25,21,53
Glenavon,7575,3,9,10,7,55,46,9,37
Linfield,7575,4,10,5,11,37,38,-1,35
Cliftonville,7575,5,10,4,12,34,31,3,34
Ballymena,7575,6,8,4,14,27,47,-20,28
Glentoran,7575,7,6,6,10,24,32,-8,24
Dungannon,7575,8,2,4,16,14,47,-33,10
Coleraine,7576,1,15,10,1,44,22,22,55
Crusaders,7576,2,16,6,4,62,34,28,54
Glenavon,7576,3,9,9,8,52,44,8,36
Linfield,7576,4,10,6,10,37,36,1,36
Cliftonville,7576,5,9,5,12,32,31,1,32
Ballymena,7576,6,8,4,14,29,48,-19,28
Glentoran,7576,7,6,6,10,24,32,-8,24
Dungannon,7576,8,2,4,16,14,47,-33,10
Crusaders,7577,1,17,6,3,66,32,34,57
Coleraine,7577,2,15,10,1,45,23,22,55
Glenavon,7577,3,9,9,8,53,45,8,36
Linfield,7577,4,10,6,10,38,37,1,36
Cliftonville,7577,5,9,5,12,33,32,1,32
Ballymena,7577,6,7,4,15,27,52,-25,25
Glentoran,7577,7,6,6,10,24,32,-8,24
Dungannon,7577,8,2,4,16,14,47,-33,10
Crusaders,7578,1,17,6,3,64,30,34,57
Coleraine,7578,2,14,11,1,43,22,21,53
Glenavon,7578,3,9,10,7,52,43,9,37
Linfield,7578,4,10,5,11,37,37,0,35
Cliftonville,7578,5,10,4,12,33,31,2,34
Ballymena,7578,6,7,4,15,25,50,-25,25
Glentoran,7578,7,6,6,10,24,32,-8,24
Dungannon,7578,8,2,4,16,14,47,-33,10
Crusaders,7579,1,17,6,3,63,30,33,57
Coleraine,7579,2,14,11,1,44,23,21,53
Glenavon,7579,3,9,10,7,53,44,9,37
Linfield,7579,4,10,5,11,38,39,-1,35
Cliftonville,7579,5,10,4,12,35,32,3,34
Ballymena,7579,6,7,4,15,25,49,-24,25
Glentoran,7579,7,6,6,10,24,32,-8,24
Dungannon,7579,8,2,4,16,14,47,-33,10
Crusaders,7580,1,17,6,3,66,31,35,57
Coleraine,7580,2,14,11,1,45,24,21,53
Linfield,7580,3,11,5,10,41,36,5,38
Glenavon,7580,4,9,10,7,54,45,9,37
Cliftonville,7580,5,9,4,13,32,35,-3,31
Ballymena,7580,6,7,4,15,26,52,-26,25
Glentoran,7580,7,6,6,10,24,32,-8,24
Dungannon,7580,8,2,4,16,14,47,-33,10
Crusaders,7581,1,17,6,3,63,30,33,57
Coleraine,7581,2,15,10,1,45,23,22,55
Glenavon,7581,3,9,9,8,53,45,8,36
Linfield,7581,4,10,6,10,39,38,1,36
Cliftonville,7581,5,9,5,12,34,33,1,32
Ballymena,7581,6,7,4,15,25,49,-24,25
Glentoran,7581,7,6,6,10,24,32,-8,24
Dungannon,7581,8,2,4,16,14,47,-33,10
Coleraine,7582,1,15,10,1,45,22,23,55
Crusaders,7582,2,16,6,4,61,31,30,54
Glenavon,7582,3,9,9,8,52,45,7,36
Linfield,7582,4,10,5,11,37,37,0,35
Cliftonville,7582,5,10,4,12,33,31,2,34
Ballymena,7582,6,8,4,14,26,47,-21,28
Glentoran,7582,7,6,6,10,24,32,-8,24
Dungannon,7582,8,2,4,16,14,47,-33,10
Crusaders,7583,1,16,7,3,62,31,31,55
Coleraine,7583,2,15,10,1,45,23,22,55
Glenavon,7583,3,9,9,8,53,45,8,36
Linfield,7583,4,10,5,11,37,37,0,35
Cliftonville,7583,5,10,4,12,33,31,2,34
Ballymena,7583,6,7,5,14,26,48,-22,26
Glentoran,7583,7,6,6,10,24,32,-8,24
Dungannon,7583,8,2,4,16,14,47,-33,10
Crusaders,7584,1,17,6,3,63,30,33,57
Coleraine,7584,2,15,10,1,45,23,22,55
Linfield,7584,3,11,5,10,40,36,4,38
Glenavon,7584,4,9,9,8,53,45,8,36
Cliftonville,7584,5,9,4,13,32,34,-2,31
Ballymena,7584,6,7,4,15,25,49,-24,25
Glentoran,7584,7,6,6,10,24,32,-8,24
Dungannon,7584,8,2,4,16,14,47,-33,10
Crusaders,7585,1,17,6,3,62,30,32,57
Coleraine,7585,2,14,11,1,45,24,21,53
Linfield,7585,3,11,5,10,40,37,3,38
Glenavon,7585,4,9,10,7,54,45,9,37
Cliftonville,7585,5,9,4,13,33,34,-1,31
Ballymena,7585,6,7,4,15,25,48,-23,25
Glentoran,7585,7,6,6,10,24,32,-8,24
Dungannon,7585,8,2,4,16,14,47,-33,10
Crusaders,7586,1,17,6,3,63,30,33,57
Coleraine,7586,2,14,10,2,43,23,20,52
Glenavon,7586,3,10,9,7,53,43,10,39
Linfield,7586,4,10,6,10,38,37,1,36
Cliftonville,7586,5,9,5,12,33,32,1,32
Ballymena,7586,6,7,4,15,25,49,-24,25
Glentoran,7586,7,6,6,10,24,32,-8,24
Dungannon,7586,8,2,4,16,14,47,-33,10
Crusaders,7587,1,17,6,3,66,34,32,57
Coleraine,7587,2,14,10,2,44,24,20,52
Glenavon,7587,3,10,9,7,54,44,10,39
Linfield,7587,4,11,5,10,40,37,3,38
Cliftonville,7587,5,9,4,13,33,34,-1,31
Ballymena,7587,6,7,4,15,29,52,-23,25
Glentoran,7587,7,6,6,10,24,32,-8,24
Dungannon,7587,8,2,4,16,14,47,-33,10
Crusaders,7588,1,17,6,3,62,30,32,57
Coleraine,7588,2,15,10,1,45,22,23,55
Linfield,7588,3,11,5,10,39,36,3,38
Glenavon,7588,4,9,9,8,52,45,7,36
Cliftonville,7588,5,9,4,13,32,33,-1,31
Ballymena,7588,6,7,4,15,25,48,-23,25
Glentoran,7588,7,6,6,10,24,32,-8,24
Dungannon,7588,8,2,4,16,14,47,-33,10
Crusaders,7589,1,17,6,3,63,31,32,57
Coleraine,7589,2,14,11,1,45,24,21,53
Linfield,7589,3,11,5,10,40,38,2,38
Glenavon,7589,4,9,10,7,54,45,9,37
Cliftonville,7589,5,9,4,13,34,34,0,31
Ballymena,7589,6,7,4,15,26,49,-23,25
Glentoran,7589,7,6,6,10,24,32,-8,24
Dungannon,7589,8,2,4,16,14,47,-33,10
Crusaders,7590,1,17,6,3,64,32,32,57
Coleraine,7590,2,14,10,2,45,29,16,52
Glenavon,7590,3,10,9,7,59,45,14,39
Linfield,7590,4,11,5,10,38,36,2,38
Cliftonville,7590,5,9,4,13,32,32,0,31
Ballymena,7590,6,7,4,15,27,50,-23,25
Glentoran,7590,7,6,6,10,24,32,-8,24
Dungannon,7590,8,2,4,16,14,47,-33,10
Crusaders,7591,1,16,7,3,61,30,31,55
Coleraine,7591,2,14,11,1,44,23,21,53
Linfield,7591,3,11,5,10,41,37,4,38
Glenavon,7591,4,9,10,7,53,44,9,37
Cliftonville,7591,5,9,4,13,33,35,-2,31
Ballymena,7591,6,7,5,14,25,47,-22,26
Glentoran,7591,7,6,6,10,24,32,-8,24
Dungannon,7591,8,2,4,16,14,47,-33,10
Crusaders,7592,1,17,6,3,64,30,34,57
Coleraine,7592,2,15,10,1,47,23,24,55
Linfield,7592,3,11,5,10,43,37,6,38
Glenavon,7592,4,9,9,8,53,47,6,36
Cliftonville,7592,5,9,4,13,33,37,-4,31
Ballymena,7592,6,7,4,15,25,50,-25,25
Glentoran,7592,7,6,6,10,24,32,-8,24
Dungannon,7592,8,2,4,16,14,47,-33,10
Crusaders,7593,1,16,6,4,62,33,29,54
Coleraine,7593,2,14,11,1,44,23,21,53
Glenavon,7593,3,9,10,7,53,44,9,37
Linfield,7593,4,10,5,11,38,38,0,35
Cliftonville,7593,5,10,4,12,34,32,2,34
Ballymena,7593,6,8,4,14,28,48,-20,28
Glentoran,7593,7,6,6,10,24,32,-8,24
Dungannon,7593,8,2,4,16,14,47,-33,10
Crusaders,7594,1,17,6,3,62,30,32,57
Coleraine,7594,2,15,10,1,45,22,23,55
Glenavon,7594,3,9,9,8,52,45,7,36
Linfield,7594,4,10,6,10,39,38,1,36
Cliftonville,7594,5,9,5,12,34,33,1,32
Ballymena,7594,6,7,4,15,25,48,-23,25
Glentoran,7594,7,6,6,10,24,32,-8,24
Dungannon,7594,8,2,4,16,14,47,-33,10
Crusaders,7595,1,16,7,3,61,30,31,55
Coleraine,7595,2,15,10,1,46,24,22,55
Linfield,7595,3,11,5,10,38,36,2,38
Glenavon,7595,4,9,9,8,54,46,8,36
Cliftonville,7595,5,9,4,13,32,32,0,31
Ballymena,7595,6,7,5,14,25,47,-22,26
Glentoran,7595,7,6,6,10,24,32,-8,24
Dungannon,7595,8,2,4,16,14,47,-33,10
Crusaders,7596,1,16,6,4,61,32,29,54
Coleraine,7596,2,14,11,1,45,24,21,53
Linfield,7596,3,11,5,10,39,37,2,38
Glenavon,7596,4,9,10,7,54,45,9,37
Cliftonville,7596,5,9,4,13,33,33,0,31
Ballymena,7596,6,8,4,14,27,47,-20,28
Glentoran,7596,7,6,6,10,24,32,-8,24
Dungannon,7596,8,2,4,16,14,47,-33,10
Crusaders,7597,1,16,7,3,63,32,31,55
Coleraine,7597,2,14,10,2,44,26,18,52
Glenavon,7597,3,10,9,7,56,44,12,39
Linfield,7597,4,10,6,10,38,37,1,36
Cliftonville,7597,5,9,5,12,33,32,1,32
Ballymena,7597,6,7,5,14,27,49,-22,26
Glentoran,7597,7,6,6,10,24,32,-8,24
Dungannon,7597,8,2,4,16,14,47,-33,10
Crusaders,7598,1,17,6,3,65,32,33,57
Coleraine,7598,2,14,10,2,43,24,19,52
Glenavon,7598,3,10,9,7,54,43,11,39
Linfield,7598,4,11,5,10,40,36,4,38
Cliftonville,7598,5,9,4,13,32,34,-2,31
Ballymena,7598,6,7,4,15,27,51,-24,25
Glentoran,7598,7,6,6,10,24,32,-8,24
Dungannon,7598,8,2,4,16,14,47,-33,10
Crusaders,7599,1,17,6,3,63,31,32,57
Coleraine,7599,2,14,10,2,44,24,20,52
Glenavon,7599,3,10,9,7,54,44,10,39
Linfield,7599,4,10,6,10,39,38,1,36
Cliftonville,7599,5,9,5,12,34,33,1,32
Ballymena,7599,6,7,4,15,26,49,-23,25
Glentoran,7599,7,6,6,10,24,32,-8,24
Dungannon,7599,8,2,4,16,14,47,-33,10
Crusaders,7600,1,17,6,3,67,33,34,57
Coleraine,7600,2,15,10,1,45,23,22,55
Glenavon,7600,3,9,9,8,53,45,8,36
Linfield,7600,4,10,5,11,38,38,0,35
Cliftonville,7600,5,10,4,12,34,32,2,34
Ballymena,7600,6,7,4,15,28,53,-25,25
Glentoran,7600,7,6,6,10,24,32,-8,24
Dungannon,7600,8,2,4,16,14,47,-33,10
Coleraine,7601,1,15,10,1,49,23,26,55
Crusaders,7601,2,16,6,4,62,33,29,54
Glenavon,7601,3,9,9,8,53,49,4,36
Linfield,7601,4,10,5,11,38,38,0,35
Cliftonville,7601,5,10,4,12,34,32,2,34
Ballymena,7601,6,8,4,14,28,48,-20,28
Glentoran,7601,7,6,6,10,24,32,-8,24
Dungannon,7601,8,2,4,16,14,47,-33,10
Crusaders,7602,1,17,6,3,63,31,32,57
Coleraine,7602,2,15,10,1,46,24,22,55
Glenavon,7602,3,9,9,8,54,46,8,36
Linfield,7602,4,10,6,10,38,37,1,36
Cliftonville,7602,5,9,5,12,33,32,1,32
Ballymena,7602,6,7,4,15,26,49,-23,25
Glentoran,7602,7,6,6,10,24,32,-8,24
Dungannon,7602,8,2,4,16,14,47,-33,10
Crusaders,7603,1,17,6,3,63,31,32,57
Coleraine,7603,2,14,10,2,44,24,20,52
Glenavon,7603,3,10,9,7,54,44,10,39
Linfield,7603,4,11,5,10,40,37,3,38
Cliftonville,7603,5,9,4,13,33,34,-1,31
Ballymena,7603,6,7,4,15,26,49,-23,25
Glentoran,7603,7,6,6,10,24,32,-8,24
Dungannon,7603,8,2,4,16,14,47,-33,10
Crusaders,7604,1,16,7,3,63,32,31,55
Coleraine,7604,2,14,11,1,45,24,21,53
Linfield,7604,3,11,5,10,40,37,3,38
Glenavon,7604,4,9,10,7,54,45,9,37
Cliftonville,7604,5,9,4,13,33,34,-1,31
Ballymena,7604,6,7,5,14,27,49,-22,26
Glentoran,7604,7,6,6,10,24,32,-8,24
Dungannon,7604,8,2,4,16,14,47,-33,10
Coleraine,7605,1,15,10,1,48,22,26,55
Crusaders,7605,2,16,6,4,61,32,29,54
Linfield,7605,3,11,5,10,39,37,2,38
Glenavon,7605,4,9,9,8,52,48,4,36
Cliftonville,7605,5,9,4,13,33,33,0,31
Ballymena,7605,6,8,4,14,27,47,-20,28
Glentoran,7605,7,6,6,10,24,32,-8,24
Dungannon,7605,8,2,4,16,14,47,-33,10
Crusaders,7606,1,17,6,3,64,31,33,57
Coleraine,7606,2,15,10,1,46,24,22,55
Glenavon,7606,3,9,9,8,54,46,8,36
Linfield,7606,4,10,5,11,37,40,-3,35
Cliftonville,7606,5,10,4,12,36,31,5,34
Ballymena,7606,6,7,4,15,26,50,-24,25
Glentoran,7606,7,6,6,10,24,32,-8,24
Dungannon,7606,8,2,4,16,14,47,-33,10
Crusaders,7607,1,17,6,3,62,30,32,57
Coleraine,7607,2,14,11,1,45,24,21,53
Glenavon,7607,3,9,10,7,54,45,9,37
Linfield,7607,4,10,5,11,37,37,0,35
Cliftonville,7607,5,10,4,12,33,31,2,34
Ballymena,7607,6,7,4,15,25,48,-23,25
Glentoran,7607,7,6,6,10,24,32,-8,24
Dungannon,7607,8,2,4,16,14,47,-33,10
Crusaders,7608,1,16,7,3,61,30,31,55
Coleraine,7608,2,15,10,1,50,25,25,55
Glenavon,7608,3,9,9,8,55,50,5,36
Linfield,7608,4,10,5,11,38,38,0,35
Cliftonville,7608,5,10,4,12,34,32,2,34
Ballymena,7608,6,7,5,14,25,47,-22,26
Glentoran,7608,7,6,6,10,24,32,-8,24
Dungannon,7608,8,2,4,16,14,47,-33,10
Crusaders,7609,1,17,6,3,62,30,32,57
Coleraine,7609,2,14,11,1,45,24,21,53
Linfield,7609,3,11,5,10,39,37,2,38
Glenavon,7609,4,9,10,7,54,45,9,37
Cliftonville,7609,5,9,4,13,33,33,0,31
Ballymena,7609,6,7,4,15,25,48,-23,25
Glentoran,7609,7,6,6,10,24,32,-8,24
Dungannon,7609,8,2,4,16,14,47,-33,10
Crusaders,7610,1,16,6,4,62,32,30,54
Coleraine,7610,2,14,10,2,43,23,20,52
Glenavon,7610,3,10,9,7,53,43,10,39
Linfield,7610,4,11,5,10,39,37,2,38
Cliftonville,7610,5,9,4,13,33,33,0,31
Ballymena,7610,6,8,4,14,27,48,-21,28
Glentoran,7610,7,6,6,10,24,32,-8,24
Dungannon,7610,8,2,4,16,14,47,-33,10
Crusaders,7611,1,17,6,3,64,30,34,57
Coleraine,7611,2,15,10,1,47,23,24,55
Linfield,7611,3,11,5,10,38,36,2,38
Glenavon,7611,4,9,9,8,53,47,6,36
Cliftonville,7611,5,9,4,13,32,32,0,31
Ballymena,7611,6,7,4,15,25,50,-25,25
Glentoran,7611,7,6,6,10,24,32,-8,24
Dungannon,7611,8,2,4,16,14,47,-33,10
Crusaders,7612,1,17,6,3,64,32,32,57
Coleraine,7612,2,14,11,1,45,24,21,53
Glenavon,7612,3,9,10,7,54,45,9,37
Linfield,7612,4,10,6,10,38,37,1,36
Cliftonville,7612,5,9,5,12,33,32,1,32
Ballymena,7612,6,7,4,15,27,50,-23,25
Glentoran,7612,7,6,6,10,24,32,-8,24
Dungannon,7612,8,2,4,16,14,47,-33,10
Coleraine,7613,1,15,10,1,48,22,26,55
Crusaders,7613,2,16,6,4,61,33,28,54
Glenavon,7613,3,9,9,8,52,48,4,36
Linfield,7613,4,10,5,11,38,39,-1,35
Cliftonville,7613,5,10,4,12,35,32,3,34
Ballymena,7613,6,8,4,14,28,47,-19,28
Glentoran,7613,7,6,6,10,24,32,-8,24
Dungannon,7613,8,2,4,16,14,47,-33,10
Crusaders,7614,1,16,7,3,63,32,31,55
Coleraine,7614,2,14,10,2,44,25,19,52
Glenavon,7614,3,10,9,7,55,44,11,39
Linfield,7614,4,10,6,10,39,38,1,36
Cliftonville,7614,5,9,5,12,34,33,1,32
Ballymena,7614,6,7,5,14,27,49,-22,26
Glentoran,7614,7,6,6,10,24,32,-8,24
Dungannon,7614,8,2,4,16,14,47,-33,10
Crusaders,7615,1,16,6,4,64,34,30,54
Coleraine,7615,2,14,10,2,44,24,20,52
Glenavon,7615,3,10,9,7,54,44,10,39
Linfield,7615,4,10,6,10,38,37,1,36
Cliftonville,7615,5,9,5,12,33,32,1,32
Ballymena,7615,6,8,4,14,29,50,-21,28
Glentoran,7615,7,6,6,10,24,32,-8,24
Dungannon,7615,8,2,4,16,14,47,-33,10
Crusaders,7616,1,17,6,3,66,31,35,57
Coleraine,7616,2,15,10,1,45,22,23,55
Linfield,7616,3,11,5,10,40,36,4,38
Glenavon,7616,4,9,9,8,52,45,7,36
Cliftonville,7616,5,9,4,13,32,34,-2,31
Ballymena,7616,6,7,4,15,26,52,-26,25
Glentoran,7616,7,6,6,10,24,32,-8,24
Dungannon,7616,8,2,4,16,14,47,-33,10
Crusaders,7617,1,17,6,3,63,31,32,57
Coleraine,7617,2,14,10,2,46,27,19,52
Glenavon,7617,3,10,9,7,57,46,11,39
Linfield,7617,4,10,5,11,38,39,-1,35
Cliftonville,7617,5,10,4,12,35,32,3,34
Ballymena,7617,6,7,4,15,26,49,-23,25
Glentoran,7617,7,6,6,10,24,32,-8,24
Dungannon,7617,8,2,4,16,14,47,-33,10
Crusaders,7618,1,16,6,4,62,34,28,54
Coleraine,7618,2,14,10,2,44,24,20,52
Glenavon,7618,3,10,9,7,54,44,10,39
Linfield,7618,4,10,6,10,38,37,1,36
Cliftonville,7618,5,9,5,12,33,32,1,32
Ballymena,7618,6,8,4,14,29,48,-19,28
Glentoran,7618,7,6,6,10,24,32,-8,24
Dungannon,7618,8,2,4,16,14,47,-33,10
Crusaders,7619,1,16,7,3,61,30,31,55
Coleraine,7619,2,14,11,1,45,24,21,53
Glenavon,7619,3,9,10,7,54,45,9,37
Linfield,7619,4,10,6,10,38,37,1,36
Cliftonville,7619,5,9,5,12,33,32,1,32
Ballymena,7619,6,7,5,14,25,47,-22,26
Glentoran,7619,7,6,6,10,24,32,-8,24
Dungannon,7619,8,2,4,16,14,47,-33,10
Crusaders,7620,1,17,6,3,64,30,34,57
Coleraine,7620,2,15,10,1,44,22,22,55
Linfield,7620,3,11,5,10,38,36,2,38
Glenavon,7620,4,9,9,8,52,44,8,36
Cliftonville,7620,5,9,4,13,32,32,0,31
Ballymena,7620,6,7,4,15,25,50,-25,25
Glentoran,7620,7,6,6,10,24,32,-8,24
Dungannon,7620,8,2,4,16,14,47,-33,10
Crusaders,7621,1,16,7,3,62,31,31,55
Coleraine,7621,2,14,11,1,45,24,21,53
Linfield,7621,3,11,5,10,39,36,3,38
Glenavon,7621,4,9,10,7,54,45,9,37
Cliftonville,7621,5,9,4,13,32,33,-1,31
Ballymena,7621,6,7,5,14,26,48,-22,26
Glentoran,7621,7,6,6,10,24,32,-8,24
Dungannon,7621,8,2,4,16,14,47,-33,10
Crusaders,7622,1,17,6,3,64,31,33,57
Coleraine,7622,2,14,11,1,44,23,21,53
Glenavon,7622,3,9,10,7,53,44,9,37
Linfield,7622,4,10,6,10,39,38,1,36
Cliftonville,7622,5,9,5,12,34,33,1,32
Ballymena,7622,6,7,4,15,26,50,-24,25
Glentoran,7622,7,6,6,10,24,32,-8,24
Dungannon,7622,8,2,4,16,14,47,-33,10
Crusaders,7623,1,17,6,3,63,31,32,57
Coleraine,7623,2,15,10,1,44,22,22,55
Glenavon,7623,3,9,9,8,52,44,8,36
Linfield,7623,4,10,5,11,38,39,-1,35
Cliftonville,7623,5,10,4,12,35,32,3,34
Ballymena,7623,6,7,4,15,26,49,-23,25
Glentoran,7623,7,6,6,10,24,32,-8,24
Dungannon,7623,8,2,4,16,14,47,-33,10
Crusaders,7624,1,17,6,3,64,32,32,57
Coleraine,7624,2,14,11,1,44,23,21,53
Linfield,7624,3,11,5,10,41,38,3,38
Glenavon,7624,4,9,10,7,53,44,9,37
Cliftonville,7624,5,9,4,13,34,35,-1,31
Ballymena,7624,6,7,4,15,27,50,-23,25
Glentoran,7624,7,6,6,10,24,32,-8,24
Dungannon,7624,8,2,4,16,14,47,-33,10
Crusaders,7625,1,16,6,4,61,32,29,54
Coleraine,7625,2,14,10,2,44,26,18,52
Glenavon,7625,3,10,9,7,56,44,12,39
Linfield,7625,4,11,5,10,40,38,2,38
Cliftonville,7625,5,9,4,13,34,34,0,31
Ballymena,7625,6,8,4,14,27,47,-20,28
Glentoran,7625,7,6,6,10,24,32,-8,24
Dungannon,7625,8,2,4,16,14,47,-33,10
Crusaders,7626,1,16,6,4,61,32,29,54
Coleraine,7626,2,14,10,2,43,24,19,52
Glenavon,7626,3,10,9,7,54,43,11,39
Linfield,7626,4,11,5,10,39,37,2,38
Cliftonville,7626,5,9,4,13,33,33,0,31
Ballymena,7626,6,8,4,14,27,47,-20,28
Glentoran,7626,7,6,6,10,24,32,-8,24
Dungannon,7626,8,2,4,16,14,47,-33,10
Crusaders,7627,1,17,6,3,64,31,33,57
Coleraine,7627,2,15,10,1,45,23,22,55
Glenavon,7627,3,9,9,8,53,45,8,36
Linfield,7627,4,10,5,11,37,38,-1,35
Cliftonville,7627,5,10,4,12,34,31,3,34
Ballymena,7627,6,7,4,15,26,50,-24,25
Glentoran,7627,7,6,6,10,24,32,-8,24
Dungannon,7627,8,2,4,16,14,47,-33,10
Crusaders,7628,1,17,6,3,63,31,32,57
Coleraine,7628,2,14,10,2,43,25,18,52
Glenavon,7628,3,10,9,7,55,43,12,39
Linfield,7628,4,10,5,11,38,38,0,35
Cliftonville,7628,5,10,4,12,34,32,2,34
Ballymena,7628,6,7,4,15,26,49,-23,25
Glentoran,7628,7,6,6,10,24,32,-8,24
Dungannon,7628,8,2,4,16,14,47,-33,10
Crusaders,7629,1,16,7,3,62,31,31,55
Coleraine,7629,2,15,10,1,45,23,22,55
Glenavon,7629,3,9,9,8,53,45,8,36
Linfield,7629,4,10,5,11,37,39,-2,35
Cliftonville,7629,5,10,4,12,35,31,4,34
Ballymena,7629,6,7,5,14,26,48,-22,26
Glentoran,7629,7,6,6,10,24,32,-8,24
Dungannon,7629,8,2,4,16,14,47,-33,10
Crusaders,7630,1,17,6,3,63,31,32,57
Coleraine,7630,2,14,10,2,44,24,20,52
Glenavon,7630,3,10,9,7,54,44,10,39
Linfield,7630,4,10,5,11,37,37,0,35
Cliftonville,7630,5,10,4,12,33,31,2,34
Ballymena,7630,6,7,4,15,26,49,-23,25
Glentoran,7630,7,6,6,10,24,32,-8,24
Dungannon,7630,8,2,4,16,14,47,-33,10
Coleraine,7631,1,15,10,1,47,22,25,55
Crusaders,7631,2,16,6,4,61,31,30,54
Glenavon,7631,3,9,9,8,52,47,5,36
Linfield,7631,4,10,6,10,38,37,1,36
Cliftonville,7631,5,9,5,12,33,32,1,32
Ballymena,7631,6,8,4,14,26,47,-21,28
Glentoran,7631,7,6,6,10,24,32,-8,24
Dungannon,7631,8,2,4,16,14,47,-33,10
Crusaders,7632,1,16,7,3,61,30,31,55
Coleraine,7632,2,15,10,1,45,22,23,55
Linfield,7632,3,11,5,10,39,36,3,38
Glenavon,7632,4,9,9,8,52,45,7,36
Cliftonville,7632,5,9,4,13,32,33,-1,31
Ballymena,7632,6,7,5,14,25,47,-22,26
Glentoran,7632,7,6,6,10,24,32,-8,24
Dungannon,7632,8,2,4,16,14,47,-33,10
Crusaders,7633,1,17,6,3,63,31,32,57
Coleraine,7633,2,14,10,2,43,23,20,52
Glenavon,7633,3,10,9,7,53,43,10,39
Linfield,7633,4,11,5,10,40,37,3,38
Cliftonville,7633,5,9,4,13,33,34,-1,31
Ballymena,7633,6,7,4,15,26,49,-23,25
Glentoran,7633,7,6,6,10,24,32,-8,24
Dungannon,7633,8,2,4,16,14,47,-33,10
Crusaders,7634,1,16,6,4,62,32,30,54
Coleraine,7634,2,14,10,2,43,23,20,52
Glenavon,7634,3,10,9,7,53,43,10,39
Linfield,7634,4,10,5,11,38,38,0,35
Cliftonville,7634,5,10,4,12,34,32,2,34
Ballymena,7634,6,8,4,14,27,48,-21,28
Glentoran,7634,7,6,6,10,24,32,-8,24
Dungannon,7634,8,2,4,16,14,47,-33,10
Crusaders,7635,1,17,6,3,65,30,35,57
Coleraine,7635,2,14,10,2,44,24,20,52
Glenavon,7635,3,10,9,7,54,44,10,39
Linfield,7635,4,11,5,10,40,36,4,38
Cliftonville,7635,5,9,4,13,32,34,-2,31
Ballymena,7635,6,7,4,15,25,51,-26,25
Glentoran,7635,7,6,6,10,24,32,-8,24
Dungannon,7635,8,2,4,16,14,47,-33,10
Crusaders,7636,1,17,6,3,64,32,32,57
Coleraine,7636,2,15,10,1,44,22,22,55
Glenavon,7636,3,9,9,8,52,44,8,36
Linfield,7636,4,10,5,11,37,38,-1,35
Cliftonville,7636,5,10,4,12,34,31,3,34
Ballymena,7636,6,7,4,15,27,50,-23,25
Glentoran,7636,7,6,6,10,24,32,-8,24
Dungannon,7636,8,2,4,16,14,47,-33,10
Coleraine,7637,1,15,10,1,46,22,24,55
Crusaders,7637,2,16,6,4,63,34,29,54
Glenavon,7637,3,9,9,8,52,46,6,36
Linfield,7637,4,10,5,11,38,38,0,35
Cliftonville,7637,5,10,4,12,34,32,2,34
Ballymena,7637,6,8,4,14,29,49,-20,28
Glentoran,7637,7,6,6,10,24,32,-8,24
Dungannon,7637,8,2,4,16,14,47,-33,10
Crusaders,7638,1,16,7,3,63,32,31,55
Coleraine,7638,2,15,10,1,45,22,23,55
Linfield,7638,3,11,5,10,38,36,2,38
Glenavon,7638,4,9,9,8,52,45,7,36
Cliftonville,7638,5,9,4,13,32,32,0,31
Ballymena,7638,6,7,5,14,27,49,-22,26
Glentoran,7638,7,6,6,10,24,32,-8,24
Dungannon,7638,8,2,4,16,14,47,-33,10
Crusaders,7639,1,17,6,3,62,30,32,57
Coleraine,7639,2,15,10,1,47,25,22,55
Glenavon,7639,3,9,9,8,55,47,8,36
Linfield,7639,4,10,6,10,39,38,1,36
Cliftonville,7639,5,9,5,12,34,33,1,32
Ballymena,7639,6,7,4,15,25,48,-23,25
Glentoran,7639,7,6,6,10,24,32,-8,24
Dungannon,7639,8,2,4,16,14,47,-33,10
Crusaders,7640,1,17,6,3,62,30,32,57
Coleraine,7640,2,15,10,1,45,22,23,55
Linfield,7640,3,11,5,10,40,38,2,38
Glenavon,7640,4,9,9,8,52,45,7,36
Cliftonville,7640,5,9,4,13,34,34,0,31
Ballymena,7640,6,7,4,15,25,48,-23,25
Glentoran,7640,7,6,6,10,24,32,-8,24
Dungannon,7640,8,2,4,16,14,47,-33,10
Crusaders,7641,1,17,6,3,64,31,33,57
Coleraine,7641,2,14,10,2,44,25,19,52
Glenavon,7641,3,10,9,7,55,44,11,39
Linfield,7641,4,10,5,11,38,38,0,35
Cliftonville,7641,5,10,4,12,34,32,2,34
Ballymena,7641,6,7,4,15,26,50,-24,25
Glentoran,7641,7,6,6,10,24,32,-8,24
Dungannon,7641,8,2,4,16,14,47,-33,10
Crusaders,7642,1,16,7,3,62,31,31,55
Coleraine,7642,2,15,10,1,47,24,23,55
Glenavon,7642,3,9,9,8,54,47,7,36
Linfield,7642,4,10,6,10,38,37,1,36
Cliftonville,7642,5,9,5,12,33,32,1,32
Ballymena,7642,6,7,5,14,26,48,-22,26
Glentoran,7642,7,6,6,10,24,32,-8,24
Dungannon,7642,8,2,4,16,14,47,-33,10
Crusaders,7643,1,17,6,3,63,31,32,57
Coleraine,7643,2,14,11,1,44,23,21,53
Linfield,7643,3,11,5,10,38,36,2,38
Glenavon,7643,4,9,10,7,53,44,9,37
Cliftonville,7643,5,9,4,13,32,32,0,31
Ballymena,7643,6,7,4,15,26,49,-23,25
Glentoran,7643,7,6,6,10,24,32,-8,24
Dungannon,7643,8,2,4,16,14,47,-33,10
Crusaders,7644,1,17,6,3,64,31,33,57
Coleraine,7644,2,15,10,1,47,22,25,55
Linfield,7644,3,11,5,10,39,36,3,38
Glenavon,7644,4,9,9,8,52,47,5,36
Cliftonville,7644,5,9,4,13,32,33,-1,31
Ballymena,7644,6,7,4,15,26,50,-24,25
Glentoran,7644,7,6,6,10,24,32,-8,24
Dungannon,7644,8,2,4,16,14,47,-33,10
Crusaders,7645,1,17,6,3,66,30,36,57
Coleraine,7645,2,14,10,2,43,25,18,52
Glenavon,7645,3,10,9,7,55,43,12,39
Linfield,7645,4,11,5,10,40,38,2,38
Cliftonville,7645,5,9,4,13,34,34,0,31
Ballymena,7645,6,7,4,15,25,52,-27,25
Glentoran,7645,7,6,6,10,24,32,-8,24
Dungannon,7645,8,2,4,16,14,47,-33,10
Crusaders,7646,1,17,6,3,63,30,33,57
Coleraine,7646,2,15,10,1,45,22,23,55
Linfield,7646,3,11,5,10,39,37,2,38
Glenavon,7646,4,9,9,8,52,45,7,36
Cliftonville,7646,5,9,4,13,33,33,0,31
Ballymena,7646,6,7,4,15,25,49,-24,25
Glentoran,7646,7,6,6,10,24,32,-8,24
Dungannon,7646,8,2,4,16,14,47,-33,10
Crusaders,7647,1,17,6,3,65,30,35,57
Coleraine,7647,2,14,11,1,45,24,21,53
Linfield,7647,3,11,5,10,39,36,3,38
Glenavon,7647,4,9,10,7,54,45,9,37
Cliftonville,7647,5,9,4,13,32,33,-1,31
Ballymena,7647,6,7,4,15,25,51,-26,25
Glentoran,7647,7,6,6,10,24,32,-8,24
Dungannon,7647,8,2,4,16,14,47,-33,10
Crusaders,7648,1,17,6,3,64,32,32,57
Coleraine,7648,2,14,11,1,44,23,21,53
Glenavon,7648,3,9,10,7,53,44,9,37
Linfield,7648,4,10,5,11,37,38,-1,35
Cliftonville,7648,5,10,4,12,34,31,3,34
Ballymena,7648,6,7,4,15,27,50,-23,25
Glentoran,7648,7,6,6,10,24,32,-8,24
Dungannon,7648,8,2,4,16,14,47,-33,10
Crusaders,7649,1,16,7,3,63,32,31,55
Coleraine,7649,2,14,11,1,43,22,21,53
Glenavon,7649,3,9,10,7,52,43,9,37
Linfield,7649,4,10,5,11,37,37,0,35
Cliftonville,7649,5,10,4,12,33,31,2,34
Ballymena,7649,6,7,5,14,27,49,-22,26
Glentoran,7649,7,6,6,10,24,32,-8,24
Dungannon,7649,8,2,4,16,14,47,-33,10
Crusaders,7650,1,17,6,3,63,31,32,57
Coleraine,7650,2,14,10,2,43,23,20,52
Glenavon,7650,3,10,9,7,53,43,10,39
Linfield,7650,4,10,6,10,38,37,1,36
Cliftonville,7650,5,9,5,12,33,32,1,32
Ballymena,7650,6,7,4,15,26,49,-23,25
Glentoran,7650,7,6,6,10,24,32,-8,24
Dungannon,7650,8,2,4,16,14,47,-33,10
Crusaders,7651,1,17,6,3,64,32,32,57
Coleraine,7651,2,14,10,2,43,24,19,52
Glenavon,7651,3,10,9,7,54,43,11,39
Linfield,7651,4,10,5,11,38,39,-1,35
Cliftonville,7651,5,10,4,12,35,32,3,34
Ballymena,7651,6,7,4,15,27,50,-23,25
Glentoran,7651,7,6,6,10,24,32,-8,24
Dungannon,7651,8,2,4,16,14,47,-33,10
Crusaders,7652,1,16,6,4,62,32,30,54
Coleraine,7652,2,14,11,1,45,24,21,53
Glenavon,7652,3,9,10,7,54,45,9,37
Linfield,7652,4,10,5,11,37,38,-1,35
Cliftonville,7652,5,10,4,12,34,31,3,34
Ballymena,7652,6,8,4,14,27,48,-21,28
Glentoran,7652,7,6,6,10,24,32,-8,24
Dungannon,7652,8,2,4,16,14,47,-33,10
Crusaders,7653,1,16,6,4,62,35,27,54
Coleraine,7653,2,14,10,2,44,26,18,52
Glenavon,7653,3,10,9,7,56,44,12,39
Linfield,7653,4,10,5,11,37,38,-1,35
Cliftonville,7653,5,10,4,12,34,31,3,34
Ballymena,7653,6,8,4,14,30,48,-18,28
Glentoran,7653,7,6,6,10,24,32,-8,24
Dungannon,7653,8,2,4,16,14,47,-33,10
Crusaders,7654,1,17,6,3,66,30,36,57
Coleraine,7654,2,14,10,2,44,24,20,52
Glenavon,7654,3,10,9,7,54,44,10,39
Linfield,7654,4,10,5,11,38,38,0,35
Cliftonville,7654,5,10,4,12,34,32,2,34
Ballymena,7654,6,7,4,15,25,52,-27,25
Glentoran,7654,7,6,6,10,24,32,-8,24
Dungannon,7654,8,2,4,16,14,47,-33,10
Crusaders,7655,1,17,6,3,63,30,33,57
Coleraine,7655,2,14,10,2,44,25,19,52
Glenavon,7655,3,10,9,7,55,44,11,39
Linfield,7655,4,11,5,10,39,36,3,38
Cliftonville,7655,5,9,4,13,32,33,-1,31
Ballymena,7655,6,7,4,15,25,49,-24,25
Glentoran,7655,7,6,6,10,24,32,-8,24
Dungannon,7655,8,2,4,16,14,47,-33,10
Crusaders,7656,1,17,6,3,64,31,33,57
Coleraine,7656,2,15,10,1,46,22,24,55
Glenavon,7656,3,9,9,8,52,46,6,36
Linfield,7656,4,10,5,11,38,38,0,35
Cliftonville,7656,5,10,4,12,34,32,2,34
Ballymena,7656,6,7,4,15,26,50,-24,25
Glentoran,7656,7,6,6,10,24,32,-8,24
Dungannon,7656,8,2,4,16,14,47,-33,10
Crusaders,7657,1,17,6,3,62,30,32,57
Coleraine,7657,2,14,10,2,44,24,20,52
Glenavon,7657,3,10,9,7,54,44,10,39
Linfield,7657,4,11,5,10,39,37,2,38
Cliftonville,7657,5,9,4,13,33,33,0,31
Ballymena,7657,6,7,4,15,25,48,-23,25
Glentoran,7657,7,6,6,10,24,32,-8,24
Dungannon,7657,8,2,4,16,14,47,-33,10
Crusaders,7658,1,17,6,3,63,31,32,57
Coleraine,7658,2,15,10,1,49,23,26,55
Linfield,7658,3,11,5,10,41,38,3,38
Glenavon,7658,4,9,9,8,53,49,4,36
Cliftonville,7658,5,9,4,13,34,35,-1,31
Ballymena,7658,6,7,4,15,26,49,-23,25
Glentoran,7658,7,6,6,10,24,32,-8,24
Dungannon,7658,8,2,4,16,14,47,-33,10
Crusaders,7659,1,17,6,3,66,31,35,57
Coleraine,7659,2,15,10,1,45,23,22,55
Linfield,7659,3,11,5,10,40,38,2,38
Glenavon,7659,4,9,9,8,53,45,8,36
Cliftonville,7659,5,9,4,13,34,34,0,31
Ballymena,7659,6,7,4,15,26,52,-26,25
Glentoran,7659,7,6,6,10,24,32,-8,24
Dungannon,7659,8,2,4,16,14,47,-33,10
Crusaders,7660,1,16,7,3,63,32,31,55
Coleraine,7660,2,14,11,1,45,24,21,53
Linfield,7660,3,11,5,10,38,36,2,38
Glenavon,7660,4,9,10,7,54,45,9,37
Cliftonville,7660,5,9,4,13,32,32,0,31
Ballymena,7660,6,7,5,14,27,49,-22,26
Glentoran,7660,7,6,6,10,24,32,-8,24
Dungannon,7660,8,2,4,16,14,47,-33,10
Crusaders,7661,1,17,6,3,63,30,33,57
Coleraine,7661,2,14,11,1,44,23,21,53
Glenavon,7661,3,9,10,7,53,44,9,37
Linfield,7661,4,10,6,10,37,36,1,36
Cliftonville,7661,5,9,5,12,32,31,1,32
Ballymena,7661,6,7,4,15,25,49,-24,25
Glentoran,7661,7,6,6,10,24,32,-8,24
Dungannon,7661,8,2,4,16,14,47,-33,10
Crusaders,7662,1,17,6,3,63,31,32,57
Coleraine,7662,2,14,11,1,44,23,21,53
Linfield,7662,3,11,5,10,38,36,2,38
Glenavon,7662,4,9,10,7,53,44,9,37
Cliftonville,7662,5,9,4,13,32,32,0,31
Ballymena,7662,6,7,4,15,26,49,-23,25
Glentoran,7662,7,6,6,10,24,32,-8,24
Dungannon,7662,8,2,4,16,14,47,-33,10
Crusaders,7663,1,17,6,3,64,31,33,57
Coleraine,7663,2,14,10,2,44,26,18,52
Glenavon,7663,3,10,9,7,56,44,12,39
Linfield,7663,4,11,5,10,39,37,2,38
Cliftonville,7663,5,9,4,13,33,33,0,31
Ballymena,7663,6,7,4,15,26,50,-24,25
Glentoran,7663,7,6,6,10,24,32,-8,24
Dungannon,7663,8,2,4,16,14,47,-33,10
Crusaders,7664,1,17,6,3,63,31,32,57
Coleraine,7664,2,14,10,2,44,24,20,52
Glenavon,7664,3,10,9,7,54,44,10,39
Linfield,7664,4,10,5,11,37,37,0,35
Cliftonville,7664,5,10,4,12,33,31,2,34
Ballymena,7664,6,7,4,15,26,49,-23,25
Glentoran,7664,7,6,6,10,24,32,-8,24
Dungannon,7664,8,2,4,16,14,47,-33,10
Coleraine,7665,1,15,10,1,44,22,22,55
Crusaders,7665,2,16,6,4,61,32,29,54
Linfield,7665,3,11,5,10,38,36,2,38
Glenavon,7665,4,9,9,8,52,44,8,36
Cliftonville,7665,5,9,4,13,32,32,0,31
Ballymena,7665,6,8,4,14,27,47,-20,28
Glentoran,7665,7,6,6,10,24,32,-8,24
Dungannon,7665,8,2,4,16,14,47,-33,10
Crusaders,7666,1,17,6,3,63,30,33,57
Coleraine,7666,2,14,10,2,44,28,16,52
Glenavon,7666,3,10,9,7,58,44,14,39
Linfield,7666,4,10,5,11,37,38,-1,35
Cliftonville,7666,5,10,4,12,34,31,3,34
Ballymena,7666,6,7,4,15,25,49,-24,25
Glentoran,7666,7,6,6,10,24,32,-8,24
Dungannon,7666,8,2,4,16,14,47,-33,10
Crusaders,7667,1,16,7,3,61,30,31,55
Coleraine,7667,2,15,10,1,45,22,23,55
Glenavon,7667,3,9,9,8,52,45,7,36
Linfield,7667,4,10,5,11,37,40,-3,35
Cliftonville,7667,5,10,4,12,36,31,5,34
Ballymena,7667,6,7,5,14,25,47,-22,26
Glentoran,7667,7,6,6,10,24,32,-8,24
Dungannon,7667,8,2,4,16,14,47,-33,10
Crusaders,7668,1,16,7,3,62,31,31,55
Coleraine,7668,2,14,11,1,44,23,21,53
Glenavon,7668,3,9,10,7,53,44,9,37
Linfield,7668,4,10,6,10,38,37,1,36
Cliftonville,7668,5,9,5,12,33,32,1,32
Ballymena,7668,6,7,5,14,26,48,-22,26
Glentoran,7668,7,6,6,10,24,32,-8,24
Dungannon,7668,8,2,4,16,14,47,-33,10
Crusaders,7669,1,16,6,4,62,32,30,54
Coleraine,7669,2,14,11,1,45,24,21,53
Glenavon,7669,3,9,10,7,54,45,9,37
Linfield,7669,4,10,5,11,37,37,0,35
Cliftonville,7669,5,10,4,12,33,31,2,34
Ballymena,7669,6,8,4,14,27,48,-21,28
Glentoran,7669,7,6,6,10,24,32,-8,24
Dungannon,7669,8,2,4,16,14,47,-33,10
Crusaders,7670,1,16,7,3,61,30,31,55
Coleraine,7670,2,14,10,2,44,24,20,52
Glenavon,7670,3,10,9,7,54,44,10,39
Linfield,7670,4,11,5,10,40,36,4,38
Cliftonville,7670,5,9,4,13,32,34,-2,31
Ballymena,7670,6,7,5,14,25,47,-22,26
Glentoran,7670,7,6,6,10,24,32,-8,24
Dungannon,7670,8,2,4,16,14,47,-33,10
Crusaders,7671,1,16,6,4,62,32,30,54
Coleraine,7671,2,14,10,2,44,24,20,52
Glenavon,7671,3,10,9,7,54,44,10,39
Linfield,7671,4,10,6,10,38,37,1,36
Cliftonville,7671,5,9,5,12,33,32,1,32
Ballymena,7671,6,8,4,14,27,48,-21,28
Glentoran,7671,7,6,6,10,24,32,-8,24
Dungannon,7671,8,2,4,16,14,47,-33,10
Crusaders,7672,1,17,6,3,62,30,32,57
Coleraine,7672,2,14,11,1,46,25,21,53
Glenavon,7672,3,9,10,7,55,46,9,37
Linfield,7672,4,10,6,10,38,37,1,36
Cliftonville,7672,5,9,5,12,33,32,1,32
Ballymena,7672,6,7,4,15,25,48,-23,25
Glentoran,7672,7,6,6,10,24,32,-8,24
Dungannon,7672,8,2,4,16,14,47,-33,10
Crusaders,7673,1,17,6,3,62,30,32,57
Coleraine,7673,2,14,10,2,45,25,20,52
Glenavon,7673,3,10,9,7,55,45,10,39
Linfield,7673,4,10,6,10,37,36,1,36
Cliftonville,7673,5,9,5,12,32,31,1,32
Ballymena,7673,6,7,4,15,25,48,-23,25
Glentoran,7673,7,6,6,10,24,32,-8,24
Dungannon,7673,8,2,4,16,14,47,-33,10
Crusaders,7674,1,17,6,3,64,30,34,57
Coleraine,7674,2,15,10,1,45,23,22,55
Glenavon,7674,3,9,9,8,53,45,8,36
Linfield,7674,4,10,5,11,37,38,-1,35
Cliftonville,7674,5,10,4,12,34,31,3,34
Ballymena,7674,6,7,4,15,25,50,-25,25
Glentoran,7674,7,6,6,10,24,32,-8,24
Dungannon,7674,8,2,4,16,14,47,-33,10
Crusaders,7675,1,16,6,4,62,36,26,54
Coleraine,7675,2,14,11,1,45,24,21,53
Linfield,7675,3,11,5,10,38,36,2,38
Glenavon,7675,4,9,10,7,54,45,9,37
Cliftonville,7675,5,9,4,13,32,32,0,31
Ballymena,7675,6,8,4,14,31,48,-17,28
Glentoran,7675,7,6,6,10,24,32,-8,24
Dungannon,7675,8,2,4,16,14,47,-33,10
Crusaders,7676,1,16,6,4,61,33,28,54
Coleraine,7676,2,14,10,2,44,26,18,52
Glenavon,7676,3,10,9,7,56,44,12,39
Linfield,7676,4,11,5,10,40,36,4,38
Cliftonville,7676,5,9,4,13,32,34,-2,31
Ballymena,7676,6,8,4,14,28,47,-19,28
Glentoran,7676,7,6,6,10,24,32,-8,24
Dungannon,7676,8,2,4,16,14,47,-33,10
Crusaders,7677,1,17,6,3,64,30,34,57
Coleraine,7677,2,14,10,2,43,23,20,52
Glenavon,7677,3,10,9,7,53,43,10,39
Linfield,7677,4,10,6,10,37,36,1,36
Cliftonville,7677,5,9,5,12,32,31,1,32
Ballymena,7677,6,7,4,15,25,50,-25,25
Glentoran,7677,7,6,6,10,24,32,-8,24
Dungannon,7677,8,2,4,16,14,47,-33,10
Crusaders,7678,1,17,6,3,65,30,35,57
Coleraine,7678,2,14,11,1,45,24,21,53
Glenavon,7678,3,9,10,7,54,45,9,37
Linfield,7678,4,10,6,10,38,37,1,36
Cliftonville,7678,5,9,5,12,33,32,1,32
Ballymena,7678,6,7,4,15,25,51,-26,25
Glentoran,7678,7,6,6,10,24,32,-8,24
Dungannon,7678,8,2,4,16,14,47,-33,10
Crusaders,7679,1,17,6,3,67,31,36,57
Coleraine,7679,2,15,10,1,47,23,24,55
Glenavon,7679,3,9,9,8,53,47,6,36
Linfield,7679,4,10,6,10,38,37,1,36
Cliftonville,7679,5,9,5,12,33,32,1,32
Ballymena,7679,6,7,4,15,26,53,-27,25
Glentoran,7679,7,6,6,10,24,32,-8,24
Dungannon,7679,8,2,4,16,14,47,-33,10
Crusaders,7680,1,17,6,3,66,31,35,57
Coleraine,7680,2,15,10,1,44,22,22,55
Glenavon,7680,3,9,9,8,52,44,8,36
Linfield,7680,4,10,5,11,37,37,0,35
Cliftonville,7680,5,10,4,12,33,31,2,34
Ballymena,7680,6,7,4,15,26,52,-26,25
Glentoran,7680,7,6,6,10,24,32,-8,24
Dungannon,7680,8,2,4,16,14,47,-33,10
Coleraine,7681,1,15,10,1,44,22,22,55
Crusaders,7681,2,16,6,4,63,34,29,54
Linfield,7681,3,11,5,10,43,37,6,38
Glenavon,7681,4,9,9,8,52,44,8,36
Cliftonville,7681,5,9,4,13,33,37,-4,31
Ballymena,7681,6,8,4,14,29,49,-20,28
Glentoran,7681,7,6,6,10,24,32,-8,24
Dungannon,7681,8,2,4,16,14,47,-33,10
Crusaders,7682,1,17,6,3,64,30,34,57
Coleraine,7682,2,15,10,1,46,24,22,55
Linfield,7682,3,11,5,10,40,37,3,38
Glenavon,7682,4,9,9,8,54,46,8,36
Cliftonville,7682,5,9,4,13,33,34,-1,31
Ballymena,7682,6,7,4,15,25,50,-25,25
Glentoran,7682,7,6,6,10,24,32,-8,24
Dungannon,7682,8,2,4,16,14,47,-33,10
Crusaders,7683,1,16,6,4,62,32,30,54
Coleraine,7683,2,14,10,2,43,26,17,52
Glenavon,7683,3,10,9,7,56,43,13,39
Linfield,7683,4,10,5,11,38,38,0,35
Cliftonville,7683,5,10,4,12,34,32,2,34
Ballymena,7683,6,8,4,14,27,48,-21,28
Glentoran,7683,7,6,6,10,24,32,-8,24
Dungannon,7683,8,2,4,16,14,47,-33,10
Crusaders,7684,1,17,6,3,66,30,36,57
Coleraine,7684,2,14,10,2,43,24,19,52
Glenavon,7684,3,10,9,7,54,43,11,39
Linfield,7684,4,10,6,10,37,36,1,36
Cliftonville,7684,5,9,5,12,32,31,1,32
Ballymena,7684,6,7,4,15,25,52,-27,25
Glentoran,7684,7,6,6,10,24,32,-8,24
Dungannon,7684,8,2,4,16,14,47,-33,10
Coleraine,7685,1,15,10,1,47,22,25,55
Crusaders,7685,2,16,6,4,61,31,30,54
Linfield,7685,3,11,5,10,40,37,3,38
Glenavon,7685,4,9,9,8,52,47,5,36
Cliftonville,7685,5,9,4,13,33,34,-1,31
Ballymena,7685,6,8,4,14,26,47,-21,28
Glentoran,7685,7,6,6,10,24,32,-8,24
Dungannon,7685,8,2,4,16,14,47,-33,10
Coleraine,7686,1,15,10,1,45,23,22,55
Crusaders,7686,2,16,6,4,63,33,30,54
Linfield,7686,3,11,5,10,38,36,2,38
Glenavon,7686,4,9,9,8,53,45,8,36
Cliftonville,7686,5,9,4,13,32,32,0,31
Ballymena,7686,6,8,4,14,28,49,-21,28
Glentoran,7686,7,6,6,10,24,32,-8,24
Dungannon,7686,8,2,4,16,14,47,-33,10
Crusaders,7687,1,17,6,3,65,31,34,57
Coleraine,7687,2,14,10,2,45,26,19,52
Glenavon,7687,3,10,9,7,56,45,11,39
Linfield,7687,4,10,5,11,37,39,-2,35
Cliftonville,7687,5,10,4,12,35,31,4,34
Ballymena,7687,6,7,4,15,26,51,-25,25
Glentoran,7687,7,6,6,10,24,32,-8,24
Dungannon,7687,8,2,4,16,14,47,-33,10
Crusaders,7688,1,16,7,3,62,31,31,55
Coleraine,7688,2,15,10,1,45,23,22,55
Linfield,7688,3,11,5,10,38,36,2,38
Glenavon,7688,4,9,9,8,53,45,8,36
Cliftonville,7688,5,9,4,13,32,32,0,31
Ballymena,7688,6,7,5,14,26,48,-22,26
Glentoran,7688,7,6,6,10,24,32,-8,24
Dungannon,7688,8,2,4,16,14,47,-33,10
Crusaders,7689,1,17,6,3,62,30,32,57
Coleraine,7689,2,15,10,1,45,23,22,55
Glenavon,7689,3,9,9,8,53,45,8,36
Linfield,7689,4,10,6,10,40,39,1,36
Cliftonville,7689,5,9,5,12,35,34,1,32
Ballymena,7689,6,7,4,15,25,48,-23,25
Glentoran,7689,7,6,6,10,24,32,-8,24
Dungannon,7689,8,2,4,16,14,47,-33,10
Crusaders,7690,1,16,6,4,61,32,29,54
Coleraine,7690,2,14,10,2,43,23,20,52
Glenavon,7690,3,10,9,7,53,43,10,39
Linfield,7690,4,11,5,10,39,36,3,38
Cliftonville,7690,5,9,4,13,32,33,-1,31
Ballymena,7690,6,8,4,14,27,47,-20,28
Glentoran,7690,7,6,6,10,24,32,-8,24
Dungannon,7690,8,2,4,16,14,47,-33,10
Crusaders,7691,1,17,6,3,64,32,32,57
Coleraine,7691,2,14,10,2,44,25,19,52
Glenavon,7691,3,10,9,7,55,44,11,39
Linfield,7691,4,10,5,11,37,37,0,35
Cliftonville,7691,5,10,4,12,33,31,2,34
Ballymena,7691,6,7,4,15,27,50,-23,25
Glentoran,7691,7,6,6,10,24,32,-8,24
Dungannon,7691,8,2,4,16,14,47,-33,10
Coleraine,7692,1,15,10,1,45,23,22,55
Crusaders,7692,2,16,6,4,62,32,30,54
Linfield,7692,3,11,5,10,39,37,2,38
Glenavon,7692,4,9,9,8,53,45,8,36
Cliftonville,7692,5,9,4,13,33,33,0,31
Ballymena,7692,6,8,4,14,27,48,-21,28
Glentoran,7692,7,6,6,10,24,32,-8,24
Dungannon,7692,8,2,4,16,14,47,-33,10
Crusaders,7693,1,17,6,3,65,33,32,57
Coleraine,7693,2,15,10,1,46,23,23,55
Glenavon,7693,3,9,9,8,53,46,7,36
Linfield,7693,4,10,6,10,37,36,1,36
Cliftonville,7693,5,9,5,12,32,31,1,32
Ballymena,7693,6,7,4,15,28,51,-23,25
Glentoran,7693,7,6,6,10,24,32,-8,24
Dungannon,7693,8,2,4,16,14,47,-33,10
Crusaders,7694,1,16,7,3,61,30,31,55
Coleraine,7694,2,15,10,1,45,23,22,55
Linfield,7694,3,11,5,10,41,36,5,38
Glenavon,7694,4,9,9,8,53,45,8,36
Cliftonville,7694,5,9,4,13,32,35,-3,31
Ballymena,7694,6,7,5,14,25,47,-22,26
Glentoran,7694,7,6,6,10,24,32,-8,24
Dungannon,7694,8,2,4,16,14,47,-33,10
Crusaders,7695,1,16,7,3,63,32,31,55
Coleraine,7695,2,15,10,1,45,23,22,55
Glenavon,7695,3,9,9,8,53,45,8,36
Linfield,7695,4,10,6,10,38,37,1,36
Cliftonville,7695,5,9,5,12,33,32,1,32
Ballymena,7695,6,7,5,14,27,49,-22,26
Glentoran,7695,7,6,6,10,24,32,-8,24
Dungannon,7695,8,2,4,16,14,47,-33,10
Crusaders,7696,1,16,7,3,63,32,31,55
Coleraine,7696,2,14,10,2,43,23,20,52
Glenavon,7696,3,10,9,7,53,43,10,39
Linfield,7696,4,11,5,10,38,36,2,38
Cliftonville,7696,5,9,4,13,32,32,0,31
Ballymena,7696,6,7,5,14,27,49,-22,26
Glentoran,7696,7,6,6,10,24,32,-8,24
Dungannon,7696,8,2,4,16,14,47,-33,10
Crusaders,7697,1,17,6,3,63,30,33,57
Coleraine,7697,2,14,11,1,44,23,21,53
Glenavon,7697,3,9,10,7,53,44,9,37
Linfield,7697,4,10,5,11,37,37,0,35
Cliftonville,7697,5,10,4,12,33,31,2,34
Ballymena,7697,6,7,4,15,25,49,-24,25
Glentoran,7697,7,6,6,10,24,32,-8,24
Dungannon,7697,8,2,4,16,14,47,-33,10
Crusaders,7698,1,17,6,3,67,30,37,57
Coleraine,7698,2,14,10,2,43,23,20,52
Glenavon,7698,3,10,9,7,53,43,10,39
Linfield,7698,4,11,5,10,38,36,2,38
Cliftonville,7698,5,9,4,13,32,32,0,31
Ballymena,7698,6,7,4,15,25,53,-28,25
Glentoran,7698,7,6,6,10,24,32,-8,24
Dungannon,7698,8,2,4,16,14,47,-33,10
Crusaders,7699,1,16,6,4,62,34,28,54
Coleraine,7699,2,14,10,2,43,26,17,52
Glenavon,7699,3,10,9,7,56,43,13,39
Linfield,7699,4,11,5,10,38,36,2,38
Cliftonville,7699,5,9,4,13,32,32,0,31
Ballymena,7699,6,8,4,14,29,48,-19,28
Glentoran,7699,7,6,6,10,24,32,-8,24
Dungannon,7699,8,2,4,16,14,47,-33,10
Crusaders,7700,1,17,6,3,62,30,32,57
Coleraine,7700,2,14,10,2,44,24,20,52
Glenavon,7700,3,10,9,7,54,44,10,39
Linfield,7700,4,10,5,11,37,37,0,35
Cliftonville,7700,5,10,4,12,33,31,2,34
Ballymena,7700,6,7,4,15,25,48,-23,25
Glentoran,7700,7,6,6,10,24,32,-8,24
Dungannon,7700,8,2,4,16,14,47,-33,10
Crusaders,7701,1,17,6,3,64,31,33,57
Coleraine,7701,2,14,10,2,45,29,16,52
Glenavon,7701,3,10,9,7,59,45,14,39
Linfield,7701,4,10,6,10,39,38,1,36
Cliftonville,7701,5,9,5,12,34,33,1,32
Ballymena,7701,6,7,4,15,26,50,-24,25
Glentoran,7701,7,6,6,10,24,32,-8,24
Dungannon,7701,8,2,4,16,14,47,-33,10
Crusaders,7702,1,16,7,3,62,31,31,55
Coleraine,7702,2,14,10,2,44,24,20,52
Glenavon,7702,3,10,9,7,54,44,10,39
Linfield,7702,4,10,5,11,40,40,0,35
Cliftonville,7702,5,10,4,12,36,34,2,34
Ballymena,7702,6,7,5,14,26,48,-22,26
Glentoran,7702,7,6,6,10,24,32,-8,24
Dungannon,7702,8,2,4,16,14,47,-33,10
Crusaders,7703,1,17,6,3,66,34,32,57
Coleraine,7703,2,15,10,1,45,22,23,55
Linfield,7703,3,11,5,10,40,37,3,38
Glenavon,7703,4,9,9,8,52,45,7,36
Cliftonville,7703,5,9,4,13,33,34,-1,31
Ballymena,7703,6,7,4,15,29,52,-23,25
Glentoran,7703,7,6,6,10,24,32,-8,24
Dungannon,7703,8,2,4,16,14,47,-33,10
Crusaders,7704,1,16,7,3,61,30,31,55
Coleraine,7704,2,14,11,1,45,24,21,53
Glenavon,7704,3,9,10,7,54,45,9,37
Linfield,7704,4,10,5,11,37,38,-1,35
Cliftonville,7704,5,10,4,12,34,31,3,34
Ballymena,7704,6,7,5,14,25,47,-22,26
Glentoran,7704,7,6,6,10,24,32,-8,24
Dungannon,7704,8,2,4,16,14,47,-33,10
Crusaders,7705,1,16,7,3,63,32,31,55
Coleraine,7705,2,14,11,1,45,24,21,53
Glenavon,7705,3,9,10,7,54,45,9,37
Linfield,7705,4,10,6,10,37,36,1,36
Cliftonville,7705,5,9,5,12,32,31,1,32
Ballymena,7705,6,7,5,14,27,49,-22,26
Glentoran,7705,7,6,6,10,24,32,-8,24
Dungannon,7705,8,2,4,16,14,47,-33,10
Crusaders,7706,1,16,7,3,63,32,31,55
Coleraine,7706,2,14,10,2,44,25,19,52
Glenavon,7706,3,10,9,7,55,44,11,39
Linfield,7706,4,11,5,10,40,36,4,38
Cliftonville,7706,5,9,4,13,32,34,-2,31
Ballymena,7706,6,7,5,14,27,49,-22,26
Glentoran,7706,7,6,6,10,24,32,-8,24
Dungannon,7706,8,2,4,16,14,47,-33,10
Crusaders,7707,1,17,6,3,63,31,32,57
Coleraine,7707,2,14,11,1,43,22,21,53
Glenavon,7707,3,9,10,7,52,43,9,37
Linfield,7707,4,10,6,10,38,37,1,36
Cliftonville,7707,5,9,5,12,33,32,1,32
Ballymena,7707,6,7,4,15,26,49,-23,25
Glentoran,7707,7,6,6,10,24,32,-8,24
Dungannon,7707,8,2,4,16,14,47,-33,10
Crusaders,7708,1,16,7,3,63,32,31,55
Coleraine,7708,2,14,10,2,43,24,19,52
Glenavon,7708,3,10,9,7,54,43,11,39
Linfield,7708,4,11,5,10,39,37,2,38
Cliftonville,7708,5,9,4,13,33,33,0,31
Ballymena,7708,6,7,5,14,27,49,-22,26
Glentoran,7708,7,6,6,10,24,32,-8,24
Dungannon,7708,8,2,4,16,14,47,-33,10
Crusaders,7709,1,16,6,4,61,32,29,54
Coleraine,7709,2,14,11,1,44,23,21,53
Glenavon,7709,3,9,10,7,53,44,9,37
Linfield,7709,4,10,5,11,38,38,0,35
Cliftonville,7709,5,10,4,12,34,32,2,34
Ballymena,7709,6,8,4,14,27,47,-20,28
Glentoran,7709,7,6,6,10,24,32,-8,24
Dungannon,7709,8,2,4,16,14,47,-33,10
Crusaders,7710,1,17,6,3,64,32,32,57
Coleraine,7710,2,15,10,1,45,23,22,55
Linfield,7710,3,11,5,10,39,37,2,38
Glenavon,7710,4,9,9,8,53,45,8,36
Cliftonville,7710,5,9,4,13,33,33,0,31
Ballymena,7710,6,7,4,15,27,50,-23,25
Glentoran,7710,7,6,6,10,24,32,-8,24
Dungannon,7710,8,2,4,16,14,47,-33,10
Crusaders,7711,1,17,6,3,62,30,32,57
Coleraine,7711,2,15,10,1,45,23,22,55
Glenavon,7711,3,9,9,8,53,45,8,36
Linfield,7711,4,10,6,10,38,37,1,36
Cliftonville,7711,5,9,5,12,33,32,1,32
Ballymena,7711,6,7,4,15,25,48,-23,25
Glentoran,7711,7,6,6,10,24,32,-8,24
Dungannon,7711,8,2,4,16,14,47,-33,10
Crusaders,7712,1,17,6,3,64,32,32,57
Coleraine,7712,2,14,10,2,43,23,20,52
Glenavon,7712,3,10,9,7,53,43,10,39
Linfield,7712,4,10,6,10,37,36,1,36
Cliftonville,7712,5,9,5,12,32,31,1,32
Ballymena,7712,6,7,4,15,27,50,-23,25
Glentoran,7712,7,6,6,10,24,32,-8,24
Dungannon,7712,8,2,4,16,14,47,-33,10
Crusaders,7713,1,16,7,3,62,31,31,55
Coleraine,7713,2,14,10,2,44,27,17,52
Glenavon,7713,3,10,9,7,57,44,13,39
Linfield,7713,4,10,6,10,38,37,1,36
Cliftonville,7713,5,9,5,12,33,32,1,32
Ballymena,7713,6,7,5,14,26,48,-22,26
Glentoran,7713,7,6,6,10,24,32,-8,24
Dungannon,7713,8,2,4,16,14,47,-33,10
Crusaders,7714,1,16,7,3,62,31,31,55
Coleraine,7714,2,14,11,1,44,23,21,53
Glenavon,7714,3,9,10,7,53,44,9,37
Linfield,7714,4,10,5,11,38,38,0,35
Cliftonville,7714,5,10,4,12,34,32,2,34
Ballymena,7714,6,7,5,14,26,48,-22,26
Glentoran,7714,7,6,6,10,24,32,-8,24
Dungannon,7714,8,2,4,16,14,47,-33,10
Crusaders,7715,1,17,6,3,64,32,32,57
Coleraine,7715,2,15,10,1,47,22,25,55
Linfield,7715,3,11,5,10,39,37,2,38
Glenavon,7715,4,9,9,8,52,47,5,36
Cliftonville,7715,5,9,4,13,33,33,0,31
Ballymena,7715,6,7,4,15,27,50,-23,25
Glentoran,7715,7,6,6,10,24,32,-8,24
Dungannon,7715,8,2,4,16,14,47,-33,10
Crusaders,7716,1,17,6,3,65,31,34,57
Coleraine,7716,2,14,10,2,43,25,18,52
Glenavon,7716,3,10,9,7,55,43,12,39
Linfield,7716,4,10,6,10,37,36,1,36
Cliftonville,7716,5,9,5,12,32,31,1,32
Ballymena,7716,6,7,4,15,26,51,-25,25
Glentoran,7716,7,6,6,10,24,32,-8,24
Dungannon,7716,8,2,4,16,14,47,-33,10
Crusaders,7717,1,16,7,3,63,32,31,55
Coleraine,7717,2,14,10,2,45,27,18,52
Glenavon,7717,3,10,9,7,57,45,12,39
Linfield,7717,4,10,5,11,37,37,0,35
Cliftonville,7717,5,10,4,12,33,31,2,34
Ballymena,7717,6,7,5,14,27,49,-22,26
Glentoran,7717,7,6,6,10,24,32,-8,24
Dungannon,7717,8,2,4,16,14,47,-33,10
Crusaders,7718,1,17,6,3,63,30,33,57
Coleraine,7718,2,14,10,2,43,23,20,52
Glenavon,7718,3,10,9,7,53,43,10,39
Linfield,7718,4,11,5,10,40,38,2,38
Cliftonville,7718,5,9,4,13,34,34,0,31
Ballymena,7718,6,7,4,15,25,49,-24,25
Glentoran,7718,7,6,6,10,24,32,-8,24
Dungannon,7718,8,2,4,16,14,47,-33,10
Coleraine,7719,1,15,10,1,44,22,22,55
Crusaders,7719,2,16,6,4,62,32,30,54
Linfield,7719,3,11,5,10,39,36,3,38
Glenavon,7719,4,9,9,8,52,44,8,36
Cliftonville,7719,5,9,4,13,32,33,-1,31
Ballymena,7719,6,8,4,14,27,48,-21,28
Glentoran,7719,7,6,6,10,24,32,-8,24
Dungannon,7719,8,2,4,16,14,47,-33,10
Crusaders,7720,1,17,6,3,64,31,33,57
Coleraine,7720,2,14,10,2,43,23,20,52
Glenavon,7720,3,10,9,7,53,43,10,39
Linfield,7720,4,11,5,10,39,37,2,38
Cliftonville,7720,5,9,4,13,33,33,0,31
Ballymena,7720,6,7,4,15,26,50,-24,25
Glentoran,7720,7,6,6,10,24,32,-8,24
Dungannon,7720,8,2,4,16,14,47,-33,10
Crusaders,7721,1,17,6,3,62,30,32,57
Coleraine,7721,2,14,10,2,44,24,20,52
Glenavon,7721,3,10,9,7,54,44,10,39
Linfield,7721,4,11,5,10,39,37,2,38
Cliftonville,7721,5,9,4,13,33,33,0,31
Ballymena,7721,6,7,4,15,25,48,-23,25
Glentoran,7721,7,6,6,10,24,32,-8,24
Dungannon,7721,8,2,4,16,14,47,-33,10
Crusaders,7722,1,17,6,3,66,30,36,57
Coleraine,7722,2,15,10,1,46,24,22,55
Linfield,7722,3,11,5,10,40,36,4,38
Glenavon,7722,4,9,9,8,54,46,8,36
Cliftonville,7722,5,9,4,13,32,34,-2,31
Ballymena,7722,6,7,4,15,25,52,-27,25
Glentoran,7722,7,6,6,10,24,32,-8,24
Dungannon,7722,8,2,4,16,14,47,-33,10
Crusaders,7723,1,17,6,3,64,31,33,57
Coleraine,7723,2,15,10,1,47,23,24,55
Glenavon,7723,3,9,9,8,53,47,6,36
Linfield,7723,4,10,5,11,38,38,0,35
Cliftonville,7723,5,10,4,12,34,32,2,34
Ballymena,7723,6,7,4,15,26,50,-24,25
Glentoran,7723,7,6,6,10,24,32,-8,24
Dungannon,7723,8,2,4,16,14,47,-33,10
Crusaders,7724,1,17,6,3,63,30,33,57
Coleraine,7724,2,15,10,1,47,25,22,55
Linfield,7724,3,11,5,10,38,36,2,38
Glenavon,7724,4,9,9,8,55,47,8,36
Cliftonville,7724,5,9,4,13,32,32,0,31
Ballymena,7724,6,7,4,15,25,49,-24,25
Glentoran,7724,7,6,6,10,24,32,-8,24
Dungannon,7724,8,2,4,16,14,47,-33,10
Crusaders,7725,1,16,6,4,61,31,30,54
Coleraine,7725,2,14,10,2,44,24,20,52
Glenavon,7725,3,10,9,7,54,44,10,39
Linfield,7725,4,11,5,10,40,37,3,38
Cliftonville,7725,5,9,4,13,33,34,-1,31
Ballymena,7725,6,8,4,14,26,47,-21,28
Glentoran,7725,7,6,6,10,24,32,-8,24
Dungannon,7725,8,2,4,16,14,47,-33,10
Crusaders,7726,1,16,6,4,61,31,30,54
Coleraine,7726,2,14,10,2,44,24,20,52
Glenavon,7726,3,10,9,7,54,44,10,39
Linfield,7726,4,11,5,10,38,36,2,38
Cliftonville,7726,5,9,4,13,32,32,0,31
Ballymena,7726,6,8,4,14,26,47,-21,28
Glentoran,7726,7,6,6,10,24,32,-8,24
Dungannon,7726,8,2,4,16,14,47,-33,10
Crusaders,7727,1,17,6,3,64,31,33,57
Coleraine,7727,2,14,11,1,44,23,21,53
Linfield,7727,3,11,5,10,40,38,2,38
Glenavon,7727,4,9,10,7,53,44,9,37
Cliftonville,7727,5,9,4,13,34,34,0,31
Ballymena,7727,6,7,4,15,26,50,-24,25
Glentoran,7727,7,6,6,10,24,32,-8,24
Dungannon,7727,8,2,4,16,14,47,-33,10
Crusaders,7728,1,16,7,3,61,30,31,55
Coleraine,7728,2,14,11,1,44,23,21,53
Glenavon,7728,3,9,10,7,53,44,9,37
Linfield,7728,4,10,5,11,38,39,-1,35
Cliftonville,7728,5,10,4,12,35,32,3,34
Ballymena,7728,6,7,5,14,25,47,-22,26
Glentoran,7728,7,6,6,10,24,32,-8,24
Dungannon,7728,8,2,4,16,14,47,-33,10
Coleraine,7729,1,15,10,1,46,22,24,55
Crusaders,7729,2,16,6,4,61,32,29,54
Glenavon,7729,3,9,9,8,52,46,6,36
Linfield,7729,4,10,5,11,38,39,-1,35
Cliftonville,7729,5,10,4,12,35,32,3,34
Ballymena,7729,6,8,4,14,27,47,-20,28
Glentoran,7729,7,6,6,10,24,32,-8,24
Dungannon,7729,8,2,4,16,14,47,-33,10
Crusaders,7730,1,16,7,3,62,31,31,55
Coleraine,7730,2,15,10,1,46,24,22,55
Glenavon,7730,3,9,9,8,54,46,8,36
Linfield,7730,4,10,5,11,38,40,-2,35
Cliftonville,7730,5,10,4,12,36,32,4,34
Ballymena,7730,6,7,5,14,26,48,-22,26
Glentoran,7730,7,6,6,10,24,32,-8,24
Dungannon,7730,8,2,4,16,14,47,-33,10
Crusaders,7731,1,17,6,3,65,30,35,57
Coleraine,7731,2,14,11,1,46,25,21,53
Linfield,7731,3,11,5,10,38,36,2,38
Glenavon,7731,4,9,10,7,55,46,9,37
Cliftonville,7731,5,9,4,13,32,32,0,31
Ballymena,7731,6,7,4,15,25,51,-26,25
Glentoran,7731,7,6,6,10,24,32,-8,24
Dungannon,7731,8,2,4,16,14,47,-33,10
Crusaders,7732,1,17,6,3,64,31,33,57
Coleraine,7732,2,14,11,1,45,24,21,53
Linfield,7732,3,11,5,10,38,36,2,38
Glenavon,7732,4,9,10,7,54,45,9,37
Cliftonville,7732,5,9,4,13,32,32,0,31
Ballymena,7732,6,7,4,15,26,50,-24,25
Glentoran,7732,7,6,6,10,24,32,-8,24
Dungannon,7732,8,2,4,16,14,47,-33,10
Crusaders,7733,1,16,7,3,62,31,31,55
Coleraine,7733,2,15,10,1,45,23,22,55
Linfield,7733,3,11,5,10,40,37,3,38
Glenavon,7733,4,9,9,8,53,45,8,36
Cliftonville,7733,5,9,4,13,33,34,-1,31
Ballymena,7733,6,7,5,14,26,48,-22,26
Glentoran,7733,7,6,6,10,24,32,-8,24
Dungannon,7733,8,2,4,16,14,47,-33,10
Crusaders,7734,1,16,7,3,61,30,31,55
Coleraine,7734,2,14,10,2,45,25,20,52
Glenavon,7734,3,10,9,7,55,45,10,39
Linfield,7734,4,11,5,10,38,36,2,38
Cliftonville,7734,5,9,4,13,32,32,0,31
Ballymena,7734,6,7,5,14,25,47,-22,26
Glentoran,7734,7,6,6,10,24,32,-8,24
Dungannon,7734,8,2,4,16,14,47,-33,10
Crusaders,7735,1,16,6,4,62,32,30,54
Coleraine,7735,2,14,11,1,46,25,21,53
Linfield,7735,3,11,5,10,39,37,2,38
Glenavon,7735,4,9,10,7,55,46,9,37
Cliftonville,7735,5,9,4,13,33,33,0,31
Ballymena,7735,6,8,4,14,27,48,-21,28
Glentoran,7735,7,6,6,10,24,32,-8,24
Dungannon,7735,8,2,4,16,14,47,-33,10
Crusaders,7736,1,16,6,4,62,33,29,54
Coleraine,7736,2,14,10,2,45,25,20,52
Glenavon,7736,3,10,9,7,55,45,10,39
Linfield,7736,4,10,6,10,38,37,1,36
Cliftonville,7736,5,9,5,12,33,32,1,32
Ballymena,7736,6,8,4,14,28,48,-20,28
Glentoran,7736,7,6,6,10,24,32,-8,24
Dungannon,7736,8,2,4,16,14,47,-33,10
Crusaders,7737,1,17,6,3,63,31,32,57
Coleraine,7737,2,14,11,1,45,24,21,53
Linfield,7737,3,11,5,10,39,37,2,38
Glenavon,7737,4,9,10,7,54,45,9,37
Cliftonville,7737,5,9,4,13,33,33,0,31
Ballymena,7737,6,7,4,15,26,49,-23,25
Glentoran,7737,7,6,6,10,24,32,-8,24
Dungannon,7737,8,2,4,16,14,47,-33,10
Crusaders,7738,1,16,7,3,64,33,31,55
Coleraine,7738,2,15,10,1,48,23,25,55
Glenavon,7738,3,9,9,8,53,48,5,36
Linfield,7738,4,10,5,11,37,38,-1,35
Cliftonville,7738,5,10,4,12,34,31,3,34
Ballymena,7738,6,7,5,14,28,50,-22,26
Glentoran,7738,7,6,6,10,24,32,-8,24
Dungannon,7738,8,2,4,16,14,47,-33,10
Crusaders,7739,1,16,7,3,63,32,31,55
Coleraine,7739,2,15,10,1,46,24,22,55
Glenavon,7739,3,9,9,8,54,46,8,36
Linfield,7739,4,10,5,11,37,38,-1,35
Cliftonville,7739,5,10,4,12,34,31,3,34
Ballymena,7739,6,7,5,14,27,49,-22,26
Glentoran,7739,7,6,6,10,24,32,-8,24
Dungannon,7739,8,2,4,16,14,47,-33,10
Crusaders,7740,1,17,6,3,63,30,33,57
Coleraine,7740,2,15,10,1,45,23,22,55
Glenavon,7740,3,9,9,8,53,45,8,36
Linfield,7740,4,10,5,11,37,37,0,35
Cliftonville,7740,5,10,4,12,33,31,2,34
Ballymena,7740,6,7,4,15,25,49,-24,25
Glentoran,7740,7,6,6,10,24,32,-8,24
Dungannon,7740,8,2,4,16,14,47,-33,10
Crusaders,7741,1,17,6,3,66,31,35,57
Coleraine,7741,2,15,10,1,47,24,23,55
Glenavon,7741,3,9,9,8,54,47,7,36
Linfield,7741,4,10,5,11,37,38,-1,35
Cliftonville,7741,5,10,4,12,34,31,3,34
Ballymena,7741,6,7,4,15,26,52,-26,25
Glentoran,7741,7,6,6,10,24,32,-8,24
Dungannon,7741,8,2,4,16,14,47,-33,10
Crusaders,7742,1,17,6,3,63,31,32,57
Coleraine,7742,2,14,11,1,44,23,21,53
Glenavon,7742,3,9,10,7,53,44,9,37
Linfield,7742,4,10,6,10,39,38,1,36
Cliftonville,7742,5,9,5,12,34,33,1,32
Ballymena,7742,6,7,4,15,26,49,-23,25
Glentoran,7742,7,6,6,10,24,32,-8,24
Dungannon,7742,8,2,4,16,14,47,-33,10
Coleraine,7743,1,15,10,1,46,24,22,55
Crusaders,7743,2,16,6,4,61,31,30,54
Linfield,7743,3,11,5,10,40,37,3,38
Glenavon,7743,4,9,9,8,54,46,8,36
Cliftonville,7743,5,9,4,13,33,34,-1,31
Ballymena,7743,6,8,4,14,26,47,-21,28
Glentoran,7743,7,6,6,10,24,32,-8,24
Dungannon,7743,8,2,4,16,14,47,-33,10
Crusaders,7744,1,17,6,3,63,30,33,57
Coleraine,7744,2,14,10,2,43,24,19,52
Glenavon,7744,3,10,9,7,54,43,11,39
Linfield,7744,4,11,5,10,40,36,4,38
Cliftonville,7744,5,9,4,13,32,34,-2,31
Ballymena,7744,6,7,4,15,25,49,-24,25
Glentoran,7744,7,6,6,10,24,32,-8,24
Dungannon,7744,8,2,4,16,14,47,-33,10
Crusaders,7745,1,16,7,3,62,31,31,55
Coleraine,7745,2,14,10,2,43,23,20,52
Glenavon,7745,3,10,9,7,53,43,10,39
Linfield,7745,4,11,5,10,40,37,3,38
Cliftonville,7745,5,9,4,13,33,34,-1,31
Ballymena,7745,6,7,5,14,26,48,-22,26
Glentoran,7745,7,6,6,10,24,32,-8,24
Dungannon,7745,8,2,4,16,14,47,-33,10
Crusaders,7746,1,17,6,3,64,32,32,57
Coleraine,7746,2,14,10,2,43,23,20,52
Glenavon,7746,3,10,9,7,53,43,10,39
Linfield,7746,4,11,5,10,41,37,4,38
Cliftonville,7746,5,9,4,13,33,35,-2,31
Ballymena,7746,6,7,4,15,27,50,-23,25
Glentoran,7746,7,6,6,10,24,32,-8,24
Dungannon,7746,8,2,4,16,14,47,-33,10
Crusaders,7747,1,16,6,4,63,33,30,54
Coleraine,7747,2,14,10,2,45,26,19,52
Glenavon,7747,3,10,9,7,56,45,11,39
Linfield,7747,4,10,6,10,37,36,1,36
Cliftonville,7747,5,9,5,12,32,31,1,32
Ballymena,7747,6,8,4,14,28,49,-21,28
Glentoran,7747,7,6,6,10,24,32,-8,24
Dungannon,7747,8,2,4,16,14,47,-33,10
Crusaders,7748,1,17,6,3,63,30,33,57
Coleraine,7748,2,15,10,1,46,22,24,55
Glenavon,7748,3,9,9,8,52,46,6,36
Linfield,7748,4,10,5,11,37,39,-2,35
Cliftonville,7748,5,10,4,12,35,31,4,34
Ballymena,7748,6,7,4,15,25,49,-24,25
Glentoran,7748,7,6,6,10,24,32,-8,24
Dungannon,7748,8,2,4,16,14,47,-33,10
Crusaders,7749,1,17,6,3,67,33,34,57
Coleraine,7749,2,15,10,1,47,23,24,55
Glenavon,7749,3,9,9,8,53,47,6,36
Linfield,7749,4,10,5,11,37,37,0,35
Cliftonville,7749,5,10,4,12,33,31,2,34
Ballymena,7749,6,7,4,15,28,53,-25,25
Glentoran,7749,7,6,6,10,24,32,-8,24
Dungannon,7749,8,2,4,16,14,47,-33,10
Crusaders,7750,1,16,7,3,63,32,31,55
Coleraine,7750,2,14,11,1,43,22,21,53
Glenavon,7750,3,9,10,7,52,43,9,37
Linfield,7750,4,10,5,11,37,38,-1,35
Cliftonville,7750,5,10,4,12,34,31,3,34
Ballymena,7750,6,7,5,14,27,49,-22,26
Glentoran,7750,7,6,6,10,24,32,-8,24
Dungannon,7750,8,2,4,16,14,47,-33,10
Coleraine,7751,1,15,10,1,45,23,22,55
Crusaders,7751,2,16,6,4,61,33,28,54
Linfield,7751,3,11,5,10,39,37,2,38
Glenavon,7751,4,9,9,8,53,45,8,36
Cliftonville,7751,5,9,4,13,33,33,0,31
Ballymena,7751,6,8,4,14,28,47,-19,28
Glentoran,7751,7,6,6,10,24,32,-8,24
Dungannon,7751,8,2,4,16,14,47,-33,10
Crusaders,7752,1,17,6,3,63,31,32,57
Coleraine,7752,2,15,10,1,45,23,22,55
Glenavon,7752,3,9,9,8,53,45,8,36
Linfield,7752,4,10,6,10,39,38,1,36
Cliftonville,7752,5,9,5,12,34,33,1,32
Ballymena,7752,6,7,4,15,26,49,-23,25
Glentoran,7752,7,6,6,10,24,32,-8,24
Dungannon,7752,8,2,4,16,14,47,-33,10
Crusaders,7753,1,17,6,3,66,31,35,57
Coleraine,7753,2,14,11,1,44,23,21,53
Linfield,7753,3,11,5,10,39,37,2,38
Glenavon,7753,4,9,10,7,53,44,9,37
Cliftonville,7753,5,9,4,13,33,33,0,31
Ballymena,7753,6,7,4,15,26,52,-26,25
Glentoran,7753,7,6,6,10,24,32,-8,24
Dungannon,7753,8,2,4,16,14,47,-33,10
Crusaders,7754,1,16,6,4,64,34,30,54
Coleraine,7754,2,14,11,1,44,23,21,53
Linfield,7754,3,11,5,10,42,37,5,38
Glenavon,7754,4,9,10,7,53,44,9,37
Cliftonville,7754,5,9,4,13,33,36,-3,31
Ballymena,7754,6,8,4,14,29,50,-21,28
Glentoran,7754,7,6,6,10,24,32,-8,24
Dungannon,7754,8,2,4,16,14,47,-33,10
Crusaders,7755,1,16,6,4,62,32,30,54
Coleraine,7755,2,14,10,2,45,26,19,52
Glenavon,7755,3,10,9,7,56,45,11,39
Linfield,7755,4,10,6,10,38,37,1,36
Cliftonville,7755,5,9,5,12,33,32,1,32
Ballymena,7755,6,8,4,14,27,48,-21,28
Glentoran,7755,7,6,6,10,24,32,-8,24
Dungannon,7755,8,2,4,16,14,47,-33,10
Crusaders,7756,1,16,6,4,61,35,26,54
Coleraine,7756,2,14,10,2,43,24,19,52
Glenavon,7756,3,10,9,7,54,43,11,39
Linfield,7756,4,10,6,10,39,38,1,36
Cliftonville,7756,5,9,5,12,34,33,1,32
Ballymena,7756,6,8,4,14,30,47,-17,28
Glentoran,7756,7,6,6,10,24,32,-8,24
Dungannon,7756,8,2,4,16,14,47,-33,10
Crusaders,7757,1,17,6,3,62,30,32,57
Coleraine,7757,2,14,11,1,46,25,21,53
Glenavon,7757,3,9,10,7,55,46,9,37
Linfield,7757,4,10,5,11,38,39,-1,35
Cliftonville,7757,5,10,4,12,35,32,3,34
Ballymena,7757,6,7,4,15,25,48,-23,25
Glentoran,7757,7,6,6,10,24,32,-8,24
Dungannon,7757,8,2,4,16,14,47,-33,10
Crusaders,7758,1,17,6,3,63,30,33,57
Coleraine,7758,2,14,10,2,45,26,19,52
Glenavon,7758,3,10,9,7,56,45,11,39
Linfield,7758,4,11,5,10,40,38,2,38
Cliftonville,7758,5,9,4,13,34,34,0,31
Ballymena,7758,6,7,4,15,25,49,-24,25
Glentoran,7758,7,6,6,10,24,32,-8,24
Dungannon,7758,8,2,4,16,14,47,-33,10
Crusaders,7759,1,16,6,4,63,33,30,54
Coleraine,7759,2,14,10,2,44,24,20,52
Glenavon,7759,3,10,9,7,54,44,10,39
Linfield,7759,4,11,5,10,38,36,2,38
Cliftonville,7759,5,9,4,13,32,32,0,31
Ballymena,7759,6,8,4,14,28,49,-21,28
Glentoran,7759,7,6,6,10,24,32,-8,24
Dungannon,7759,8,2,4,16,14,47,-33,10
Crusaders,7760,1,16,6,4,63,33,30,54
Coleraine,7760,2,14,11,1,43,22,21,53
Glenavon,7760,3,9,10,7,52,43,9,37
Linfield,7760,4,10,6,10,37,36,1,36
Cliftonville,7760,5,9,5,12,32,31,1,32
Ballymena,7760,6,8,4,14,28,49,-21,28
Glentoran,7760,7,6,6,10,24,32,-8,24
Dungannon,7760,8,2,4,16,14,47,-33,10
Crusaders,7761,1,16,6,4,63,33,30,54
Coleraine,7761,2,14,10,2,43,25,18,52
Glenavon,7761,3,10,9,7,55,43,12,39
Linfield,7761,4,10,5,11,38,38,0,35
Cliftonville,7761,5,10,4,12,34,32,2,34
Ballymena,7761,6,8,4,14,28,49,-21,28
Glentoran,7761,7,6,6,10,24,32,-8,24
Dungannon,7761,8,2,4,16,14,47,-33,10
Crusaders,7762,1,16,7,3,62,31,31,55
Coleraine,7762,2,14,10,2,43,27,16,52
Glenavon,7762,3,10,9,7,57,43,14,39
Linfield,7762,4,10,6,10,38,37,1,36
Cliftonville,7762,5,9,5,12,33,32,1,32
Ballymena,7762,6,7,5,14,26,48,-22,26
Glentoran,7762,7,6,6,10,24,32,-8,24
Dungannon,7762,8,2,4,16,14,47,-33,10
Crusaders,7763,1,17,6,3,62,30,32,57
Coleraine,7763,2,15,10,1,45,23,22,55
Glenavon,7763,3,9,9,8,53,45,8,36
Linfield,7763,4,10,5,11,38,38,0,35
Cliftonville,7763,5,10,4,12,34,32,2,34
Ballymena,7763,6,7,4,15,25,48,-23,25
Glentoran,7763,7,6,6,10,24,32,-8,24
Dungannon,7763,8,2,4,16,14,47,-33,10
Coleraine,7764,1,15,10,1,44,22,22,55
Crusaders,7764,2,16,6,4,63,33,30,54
Glenavon,7764,3,9,9,8,52,44,8,36
Linfield,7764,4,10,5,11,37,37,0,35
Cliftonville,7764,5,10,4,12,33,31,2,34
Ballymena,7764,6,8,4,14,28,49,-21,28
Glentoran,7764,7,6,6,10,24,32,-8,24
Dungannon,7764,8,2,4,16,14,47,-33,10
Crusaders,7765,1,17,6,3,65,33,32,57
Coleraine,7765,2,14,11,1,44,23,21,53
Glenavon,7765,3,9,10,7,53,44,9,37
Linfield,7765,4,10,6,10,38,37,1,36
Cliftonville,7765,5,9,5,12,33,32,1,32
Ballymena,7765,6,7,4,15,28,51,-23,25
Glentoran,7765,7,6,6,10,24,32,-8,24
Dungannon,7765,8,2,4,16,14,47,-33,10
Crusaders,7766,1,16,6,4,64,34,30,54
Coleraine,7766,2,14,10,2,44,25,19,52
Glenavon,7766,3,10,9,7,55,44,11,39
Linfield,7766,4,10,6,10,38,37,1,36
Cliftonville,7766,5,9,5,12,33,32,1,32
Ballymena,7766,6,8,4,14,29,50,-21,28
Glentoran,7766,7,6,6,10,24,32,-8,24
Dungannon,7766,8,2,4,16,14,47,-33,10
Crusaders,7767,1,16,6,4,61,33,28,54
Coleraine,7767,2,14,11,1,45,24,21,53
Linfield,7767,3,11,5,10,38,36,2,38
Glenavon,7767,4,9,10,7,54,45,9,37
Cliftonville,7767,5,9,4,13,32,32,0,31
Ballymena,7767,6,8,4,14,28,47,-19,28
Glentoran,7767,7,6,6,10,24,32,-8,24
Dungannon,7767,8,2,4,16,14,47,-33,10
Crusaders,7768,1,17,6,3,63,30,33,57
Coleraine,7768,2,14,11,1,43,22,21,53
Linfield,7768,3,11,5,10,40,36,4,38
Glenavon,7768,4,9,10,7,52,43,9,37
Cliftonville,7768,5,9,4,13,32,34,-2,31
Ballymena,7768,6,7,4,15,25,49,-24,25
Glentoran,7768,7,6,6,10,24,32,-8,24
Dungannon,7768,8,2,4,16,14,47,-33,10
Crusaders,7769,1,17,6,3,63,31,32,57
Coleraine,7769,2,15,10,1,45,22,23,55
Glenavon,7769,3,9,9,8,52,45,7,36
Linfield,7769,4,10,5,11,38,38,0,35
Cliftonville,7769,5,10,4,12,34,32,2,34
Ballymena,7769,6,7,4,15,26,49,-23,25
Glentoran,7769,7,6,6,10,24,32,-8,24
Dungannon,7769,8,2,4,16,14,47,-33,10
Crusaders,7770,1,16,6,4,61,31,30,54
Coleraine,7770,2,14,10,2,43,24,19,52
Glenavon,7770,3,10,9,7,54,43,11,39
Linfield,7770,4,10,6,10,38,37,1,36
Cliftonville,7770,5,9,5,12,33,32,1,32
Ballymena,7770,6,8,4,14,26,47,-21,28
Glentoran,7770,7,6,6,10,24,32,-8,24
Dungannon,7770,8,2,4,16,14,47,-33,10
Crusaders,7771,1,17,6,3,64,31,33,57
Coleraine,7771,2,15,10,1,45,22,23,55
Linfield,7771,3,11,5,10,39,36,3,38
Glenavon,7771,4,9,9,8,52,45,7,36
Cliftonville,7771,5,9,4,13,32,33,-1,31
Ballymena,7771,6,7,4,15,26,50,-24,25
Glentoran,7771,7,6,6,10,24,32,-8,24
Dungannon,7771,8,2,4,16,14,47,-33,10
Coleraine,7772,1,15,10,1,45,23,22,55
Crusaders,7772,2,16,6,4,61,32,29,54
Glenavon,7772,3,9,9,8,53,45,8,36
Linfield,7772,4,10,6,10,37,36,1,36
Cliftonville,7772,5,9,5,12,32,31,1,32
Ballymena,7772,6,8,4,14,27,47,-20,28
Glentoran,7772,7,6,6,10,24,32,-8,24
Dungannon,7772,8,2,4,16,14,47,-33,10
Crusaders,7773,1,16,7,3,63,32,31,55
Coleraine,7773,2,14,10,2,43,23,20,52
Glenavon,7773,3,10,9,7,53,43,10,39
Linfield,7773,4,10,6,10,38,37,1,36
Cliftonville,7773,5,9,5,12,33,32,1,32
Ballymena,7773,6,7,5,14,27,49,-22,26
Glentoran,7773,7,6,6,10,24,32,-8,24
Dungannon,7773,8,2,4,16,14,47,-33,10
Crusaders,7774,1,17,6,3,63,31,32,57
Coleraine,7774,2,14,10,2,44,25,19,52
Glenavon,7774,3,10,9,7,55,44,11,39
Linfield,7774,4,11,5,10,39,37,2,38
Cliftonville,7774,5,9,4,13,33,33,0,31
Ballymena,7774,6,7,4,15,26,49,-23,25
Glentoran,7774,7,6,6,10,24,32,-8,24
Dungannon,7774,8,2,4,16,14,47,-33,10
Crusaders,7775,1,16,6,4,61,31,30,54
Coleraine,7775,2,14,10,2,44,24,20,52
Glenavon,7775,3,10,9,7,54,44,10,39
Linfield,7775,4,10,5,11,37,37,0,35
Cliftonville,7775,5,10,4,12,33,31,2,34
Ballymena,7775,6,8,4,14,26,47,-21,28
Glentoran,7775,7,6,6,10,24,32,-8,24
Dungannon,7775,8,2,4,16,14,47,-33,10
Crusaders,7776,1,17,6,3,63,31,32,57
Coleraine,7776,2,14,11,1,44,23,21,53
Glenavon,7776,3,9,10,7,53,44,9,37
Linfield,7776,4,10,6,10,38,37,1,36
Cliftonville,7776,5,9,5,12,33,32,1,32
Ballymena,7776,6,7,4,15,26,49,-23,25
Glentoran,7776,7,6,6,10,24,32,-8,24
Dungannon,7776,8,2,4,16,14,47,-33,10
Crusaders,7777,1,17,6,3,64,30,34,57
Coleraine,7777,2,15,10,1,45,23,22,55
Glenavon,7777,3,9,9,8,53,45,8,36
Linfield,7777,4,10,6,10,38,37,1,36
Cliftonville,7777,5,9,5,12,33,32,1,32
Ballymena,7777,6,7,4,15,25,50,-25,25
Glentoran,7777,7,6,6,10,24,32,-8,24
Dungannon,7777,8,2,4,16,14,47,-33,10
Crusaders,7778,1,16,6,4,62,32,30,54
Coleraine,7778,2,14,10,2,45,25,20,52
Glenavon,7778,3,10,9,7,55,45,10,39
Linfield,7778,4,11,5,10,39,36,3,38
Cliftonville,7778,5,9,4,13,32,33,-1,31
Ballymena,7778,6,8,4,14,27,48,-21,28
Glentoran,7778,7,6,6,10,24,32,-8,24
Dungannon,7778,8,2,4,16,14,47,-33,10
Crusaders,7779,1,16,7,3,62,31,31,55
Coleraine,7779,2,15,10,1,45,23,22,55
Glenavon,7779,3,9,9,8,53,45,8,36
Linfield,7779,4,10,6,10,39,38,1,36
Cliftonville,7779,5,9,5,12,34,33,1,32
Ballymena,7779,6,7,5,14,26,48,-22,26
Glentoran,7779,7,6,6,10,24,32,-8,24
Dungannon,7779,8,2,4,16,14,47,-33,10
Crusaders,7780,1,16,6,4,61,31,30,54
Coleraine,7780,2,14,10,2,43,23,20,52
Glenavon,7780,3,10,9,7,53,43,10,39
Linfield,7780,4,10,6,10,37,36,1,36
Cliftonville,7780,5,9,5,12,32,31,1,32
Ballymena,7780,6,8,4,14,26,47,-21,28
Glentoran,7780,7,6,6,10,24,32,-8,24
Dungannon,7780,8,2,4,16,14,47,-33,10
Crusaders,7781,1,17,6,3,63,31,32,57
Coleraine,7781,2,15,10,1,46,23,23,55
Glenavon,7781,3,9,9,8,53,46,7,36
Linfield,7781,4,10,6,10,38,37,1,36
Cliftonville,7781,5,9,5,12,33,32,1,32
Ballymena,7781,6,7,4,15,26,49,-23,25
Glentoran,7781,7,6,6,10,24,32,-8,24
Dungannon,7781,8,2,4,16,14,47,-33,10
Crusaders,7782,1,17,6,3,64,31,33,57
Coleraine,7782,2,15,10,1,46,22,24,55
Linfield,7782,3,11,5,10,39,37,2,38
Glenavon,7782,4,9,9,8,52,46,6,36
Cliftonville,7782,5,9,4,13,33,33,0,31
Ballymena,7782,6,7,4,15,26,50,-24,25
Glentoran,7782,7,6,6,10,24,32,-8,24
Dungannon,7782,8,2,4,16,14,47,-33,10
Crusaders,7783,1,17,6,3,63,30,33,57
Coleraine,7783,2,14,10,2,44,25,19,52
Glenavon,7783,3,10,9,7,55,44,11,39
Linfield,7783,4,10,6,10,38,37,1,36
Cliftonville,7783,5,9,5,12,33,32,1,32
Ballymena,7783,6,7,4,15,25,49,-24,25
Glentoran,7783,7,6,6,10,24,32,-8,24
Dungannon,7783,8,2,4,16,14,47,-33,10
Crusaders,7784,1,17,6,3,64,30,34,57
Coleraine,7784,2,15,10,1,47,22,25,55
Linfield,7784,3,11,5,10,39,36,3,38
Glenavon,7784,4,9,9,8,52,47,5,36
Cliftonville,7784,5,9,4,13,32,33,-1,31
Ballymena,7784,6,7,4,15,25,50,-25,25
Glentoran,7784,7,6,6,10,24,32,-8,24
Dungannon,7784,8,2,4,16,14,47,-33,10
Crusaders,7785,1,17,6,3,64,32,32,57
Coleraine,7785,2,14,10,2,43,24,19,52
Glenavon,7785,3,10,9,7,54,43,11,39
Linfield,7785,4,10,6,10,37,36,1,36
Cliftonville,7785,5,9,5,12,32,31,1,32
Ballymena,7785,6,7,4,15,27,50,-23,25
Glentoran,7785,7,6,6,10,24,32,-8,24
Dungannon,7785,8,2,4,16,14,47,-33,10
Crusaders,7786,1,17,6,3,63,31,32,57
Coleraine,7786,2,14,11,1,43,22,21,53
Glenavon,7786,3,9,10,7,52,43,9,37
Linfield,7786,4,10,6,10,38,37,1,36
Cliftonville,7786,5,9,5,12,33,32,1,32
Ballymena,7786,6,7,4,15,26,49,-23,25
Glentoran,7786,7,6,6,10,24,32,-8,24
Dungannon,7786,8,2,4,16,14,47,-33,10
Crusaders,7787,1,17,6,3,62,30,32,57
Coleraine,7787,2,14,11,1,43,22,21,53
Linfield,7787,3,11,5,10,40,38,2,38
Glenavon,7787,4,9,10,7,52,43,9,37
Cliftonville,7787,5,9,4,13,34,34,0,31
Ballymena,7787,6,7,4,15,25,48,-23,25
Glentoran,7787,7,6,6,10,24,32,-8,24
Dungannon,7787,8,2,4,16,14,47,-33,10
Crusaders,7788,1,17,6,3,65,30,35,57
Coleraine,7788,2,15,10,1,45,22,23,55
Glenavon,7788,3,9,9,8,52,45,7,36
Linfield,7788,4,10,5,11,37,37,0,35
Cliftonville,7788,5,10,4,12,33,31,2,34
Ballymena,7788,6,7,4,15,25,51,-26,25
Glentoran,7788,7,6,6,10,24,32,-8,24
Dungannon,7788,8,2,4,16,14,47,-33,10
Crusaders,7789,1,17,6,3,63,31,32,57
Coleraine,7789,2,14,11,1,43,22,21,53
Glenavon,7789,3,9,10,7,52,43,9,37
Linfield,7789,4,10,6,10,38,37,1,36
Cliftonville,7789,5,9,5,12,33,32,1,32
Ballymena,7789,6,7,4,15,26,49,-23,25
Glentoran,7789,7,6,6,10,24,32,-8,24
Dungannon,7789,8,2,4,16,14,47,-33,10
Coleraine,7790,1,15,10,1,45,22,23,55
Crusaders,7790,2,16,6,4,61,32,29,54
Glenavon,7790,3,9,9,8,52,45,7,36
Linfield,7790,4,10,6,10,37,36,1,36
Cliftonville,7790,5,9,5,12,32,31,1,32
Ballymena,7790,6,8,4,14,27,47,-20,28
Glentoran,7790,7,6,6,10,24,32,-8,24
Dungannon,7790,8,2,4,16,14,47,-33,10
Crusaders,7791,1,17,6,3,64,30,34,57
Coleraine,7791,2,15,10,1,45,22,23,55
Glenavon,7791,3,9,9,8,52,45,7,36
Linfield,7791,4,10,5,11,38,38,0,35
Cliftonville,7791,5,10,4,12,34,32,2,34
Ballymena,7791,6,7,4,15,25,50,-25,25
Glentoran,7791,7,6,6,10,24,32,-8,24
Dungannon,7791,8,2,4,16,14,47,-33,10
Crusaders,7792,1,17,6,3,67,31,36,57
Coleraine,7792,2,15,10,1,45,22,23,55
Glenavon,7792,3,9,9,8,52,45,7,36
Linfield,7792,4,10,5,11,37,38,-1,35
Cliftonville,7792,5,10,4,12,34,31,3,34
Ballymena,7792,6,7,4,15,26,53,-27,25
Glentoran,7792,7,6,6,10,24,32,-8,24
Dungannon,7792,8,2,4,16,14,47,-33,10
Crusaders,7793,1,17,6,3,63,30,33,57
Coleraine,7793,2,15,10,1,44,22,22,55
Linfield,7793,3,11,5,10,39,37,2,38
Glenavon,7793,4,9,9,8,52,44,8,36
Cliftonville,7793,5,9,4,13,33,33,0,31
Ballymena,7793,6,7,4,15,25,49,-24,25
Glentoran,7793,7,6,6,10,24,32,-8,24
Dungannon,7793,8,2,4,16,14,47,-33,10
Crusaders,7794,1,16,7,3,62,31,31,55
Coleraine,7794,2,14,11,1,44,23,21,53
Glenavon,7794,3,9,10,7,53,44,9,37
Linfield,7794,4,10,6,10,39,38,1,36
Cliftonville,7794,5,9,5,12,34,33,1,32
Ballymena,7794,6,7,5,14,26,48,-22,26
Glentoran,7794,7,6,6,10,24,32,-8,24
Dungannon,7794,8,2,4,16,14,47,-33,10
Crusaders,7795,1,16,7,3,62,31,31,55
Coleraine,7795,2,14,11,1,45,24,21,53
Linfield,7795,3,11,5,10,38,36,2,38
Glenavon,7795,4,9,10,7,54,45,9,37
Cliftonville,7795,5,9,4,13,32,32,0,31
Ballymena,7795,6,7,5,14,26,48,-22,26
Glentoran,7795,7,6,6,10,24,32,-8,24
Dungannon,7795,8,2,4,16,14,47,-33,10
Crusaders,7796,1,16,6,4,61,31,30,54
Coleraine,7796,2,14,10,2,44,26,18,52
Glenavon,7796,3,10,9,7,56,44,12,39
Linfield,7796,4,11,5,10,39,36,3,38
Cliftonville,7796,5,9,4,13,32,33,-1,31
Ballymena,7796,6,8,4,14,26,47,-21,28
Glentoran,7796,7,6,6,10,24,32,-8,24
Dungannon,7796,8,2,4,16,14,47,-33,10
Crusaders,7797,1,17,6,3,62,30,32,57
Coleraine,7797,2,15,10,1,46,24,22,55
Linfield,7797,3,11,5,10,41,36,5,38
Glenavon,7797,4,9,9,8,54,46,8,36
Cliftonville,7797,5,9,4,13,32,35,-3,31
Ballymena,7797,6,7,4,15,25,48,-23,25
Glentoran,7797,7,6,6,10,24,32,-8,24
Dungannon,7797,8,2,4,16,14,47,-33,10
Crusaders,7798,1,16,6,4,62,32,30,54
Coleraine,7798,2,14,10,2,43,23,20,52
Glenavon,7798,3,10,9,7,53,43,10,39
Linfield,7798,4,11,5,10,40,37,3,38
Cliftonville,7798,5,9,4,13,33,34,-1,31
Ballymena,7798,6,8,4,14,27,48,-21,28
Glentoran,7798,7,6,6,10,24,32,-8,24
Dungannon,7798,8,2,4,16,14,47,-33,10
Crusaders,7799,1,16,6,4,61,33,28,54
Coleraine,7799,2,14,10,2,43,23,20,52
Glenavon,7799,3,10,9,7,53,43,10,39
Linfield,7799,4,11,5,10,38,36,2,38
Cliftonville,7799,5,9,4,13,32,32,0,31
Ballymena,7799,6,8,4,14,28,47,-19,28
Glentoran,7799,7,6,6,10,24,32,-8,24
Dungannon,7799,8,2,4,16,14,47,-33,10
Crusaders,7800,1,17,6,3,63,31,32,57
Coleraine,7800,2,15,10,1,44,22,22,55
Linfield,7800,3,11,5,10,38,36,2,38
Glenavon,7800,4,9,9,8,52,44,8,36
Cliftonville,7800,5,9,4,13,32,32,0,31
Ballymena,7800,6,7,4,15,26,49,-23,25
Glentoran,7800,7,6,6,10,24,32,-8,24
Dungannon,7800,8,2,4,16,14,47,-33,10
Crusaders,7801,1,16,7,3,63,32,31,55
Coleraine,7801,2,15,10,1,44,22,22,55
Linfield,7801,3,11,5,10,38,36,2,38
Glenavon,7801,4,9,9,8,52,44,8,36
Cliftonville,7801,5,9,4,13,32,32,0,31
Ballymena,7801,6,7,5,14,27,49,-22,26
Glentoran,7801,7,6,6,10,24,32,-8,24
Dungannon,7801,8,2,4,16,14,47,-33,10
Crusaders,7802,1,17,6,3,63,30,33,57
Coleraine,7802,2,15,10,1,45,22,23,55
Linfield,7802,3,11,5,10,40,36,4,38
Glenavon,7802,4,9,9,8,52,45,7,36
Cliftonville,7802,5,9,4,13,32,34,-2,31
Ballymena,7802,6,7,4,15,25,49,-24,25
Glentoran,7802,7,6,6,10,24,32,-8,24
Dungannon,7802,8,2,4,16,14,47,-33,10
Crusaders,7803,1,16,7,3,62,31,31,55
Coleraine,7803,2,14,11,1,46,25,21,53
Glenavon,7803,3,9,10,7,55,46,9,37
Linfield,7803,4,10,6,10,38,37,1,36
Cliftonville,7803,5,9,5,12,33,32,1,32
Ballymena,7803,6,7,5,14,26,48,-22,26
Glentoran,7803,7,6,6,10,24,32,-8,24
Dungannon,7803,8,2,4,16,14,47,-33,10
Crusaders,7804,1,17,6,3,65,30,35,57
Coleraine,7804,2,14,11,1,44,23,21,53
Glenavon,7804,3,9,10,7,53,44,9,37
Linfield,7804,4,10,5,11,37,37,0,35
Cliftonville,7804,5,10,4,12,33,31,2,34
Ballymena,7804,6,7,4,15,25,51,-26,25
Glentoran,7804,7,6,6,10,24,32,-8,24
Dungannon,7804,8,2,4,16,14,47,-33,10
Crusaders,7805,1,17,6,3,64,32,32,57
Coleraine,7805,2,14,10,2,43,24,19,52
Glenavon,7805,3,10,9,7,54,43,11,39
Linfield,7805,4,10,6,10,37,36,1,36
Cliftonville,7805,5,9,5,12,32,31,1,32
Ballymena,7805,6,7,4,15,27,50,-23,25
Glentoran,7805,7,6,6,10,24,32,-8,24
Dungannon,7805,8,2,4,16,14,47,-33,10
Crusaders,7806,1,17,6,3,62,30,32,57
Coleraine,7806,2,14,11,1,45,24,21,53
Glenavon,7806,3,9,10,7,54,45,9,37
Linfield,7806,4,10,6,10,39,38,1,36
Cliftonville,7806,5,9,5,12,34,33,1,32
Ballymena,7806,6,7,4,15,25,48,-23,25
Glentoran,7806,7,6,6,10,24,32,-8,24
Dungannon,7806,8,2,4,16,14,47,-33,10
Crusaders,7807,1,17,6,3,65,31,34,57
Coleraine,7807,2,14,11,1,43,22,21,53
Glenavon,7807,3,9,10,7,52,43,9,37
Linfield,7807,4,10,6,10,38,37,1,36
Cliftonville,7807,5,9,5,12,33,32,1,32
Ballymena,7807,6,7,4,15,26,51,-25,25
Glentoran,7807,7,6,6,10,24,32,-8,24
Dungannon,7807,8,2,4,16,14,47,-33,10
Crusaders,7808,1,17,6,3,63,31,32,57
Coleraine,7808,2,14,10,2,43,24,19,52
Glenavon,7808,3,10,9,7,54,43,11,39
Linfield,7808,4,10,5,11,38,38,0,35
Cliftonville,7808,5,10,4,12,34,32,2,34
Ballymena,7808,6,7,4,15,26,49,-23,25
Glentoran,7808,7,6,6,10,24,32,-8,24
Dungannon,7808,8,2,4,16,14,47,-33,10
Crusaders,7809,1,17,6,3,64,31,33,57
Coleraine,7809,2,14,10,2,43,26,17,52
Glenavon,7809,3,10,9,7,56,43,13,39
Linfield,7809,4,11,5,10,38,36,2,38
Cliftonville,7809,5,9,4,13,32,32,0,31
Ballymena,7809,6,7,4,15,26,50,-24,25
Glentoran,7809,7,6,6,10,24,32,-8,24
Dungannon,7809,8,2,4,16,14,47,-33,10
Crusaders,7810,1,17,6,3,64,31,33,57
Coleraine,7810,2,14,10,2,44,24,20,52
Glenavon,7810,3,10,9,7,54,44,10,39
Linfield,7810,4,10,5,11,37,37,0,35
Cliftonville,7810,5,10,4,12,33,31,2,34
Ballymena,7810,6,7,4,15,26,50,-24,25
Glentoran,7810,7,6,6,10,24,32,-8,24
Dungannon,7810,8,2,4,16,14,47,-33,10
Crusaders,7811,1,17,6,3,63,30,33,57
Coleraine,7811,2,14,11,1,44,23,21,53
Linfield,7811,3,11,5,10,39,36,3,38
Glenavon,7811,4,9,10,7,53,44,9,37
Cliftonville,7811,5,9,4,13,32,33,-1,31
Ballymena,7811,6,7,4,15,25,49,-24,25
Glentoran,7811,7,6,6,10,24,32,-8,24
Dungannon,7811,8,2,4,16,14,47,-33,10
Crusaders,7812,1,17,6,3,63,31,32,57
Coleraine,7812,2,15,10,1,45,22,23,55
Linfield,7812,3,11,5,10,39,37,2,38
Glenavon,7812,4,9,9,8,52,45,7,36
Cliftonville,7812,5,9,4,13,33,33,0,31
Ballymena,7812,6,7,4,15,26,49,-23,25
Glentoran,7812,7,6,6,10,24,32,-8,24
Dungannon,7812,8,2,4,16,14,47,-33,10
Crusaders,7813,1,17,6,3,63,30,33,57
Coleraine,7813,2,14,10,2,45,25,20,52
Glenavon,7813,3,10,9,7,55,45,10,39
Linfield,7813,4,11,5,10,38,36,2,38
Cliftonville,7813,5,9,4,13,32,32,0,31
Ballymena,7813,6,7,4,15,25,49,-24,25
Glentoran,7813,7,6,6,10,24,32,-8,24
Dungannon,7813,8,2,4,16,14,47,-33,10
Crusaders,7814,1,16,6,4,62,32,30,54
Coleraine,7814,2,14,10,2,43,23,20,52
Glenavon,7814,3,10,9,7,53,43,10,39
Linfield,7814,4,11,5,10,39,36,3,38
Cliftonville,7814,5,9,4,13,32,33,-1,31
Ballymena,7814,6,8,4,14,27,48,-21,28
Glentoran,7814,7,6,6,10,24,32,-8,24
Dungannon,7814,8,2,4,16,14,47,-33,10
Crusaders,7815,1,16,6,4,63,33,30,54
Coleraine,7815,2,14,10,2,44,27,17,52
Glenavon,7815,3,10,9,7,57,44,13,39
Linfield,7815,4,11,5,10,40,38,2,38
Cliftonville,7815,5,9,4,13,34,34,0,31
Ballymena,7815,6,8,4,14,28,49,-21,28
Glentoran,7815,7,6,6,10,24,32,-8,24
Dungannon,7815,8,2,4,16,14,47,-33,10
Crusaders,7816,1,17,6,3,63,30,33,57
Coleraine,7816,2,14,11,1,44,23,21,53
Linfield,7816,3,11,5,10,40,36,4,38
Glenavon,7816,4,9,10,7,53,44,9,37
Cliftonville,7816,5,9,4,13,32,34,-2,31
Ballymena,7816,6,7,4,15,25,49,-24,25
Glentoran,7816,7,6,6,10,24,32,-8,24
Dungannon,7816,8,2,4,16,14,47,-33,10
Crusaders,7817,1,17,6,3,63,30,33,57
Coleraine,7817,2,14,11,1,44,23,21,53
Linfield,7817,3,11,5,10,39,36,3,38
Glenavon,7817,4,9,10,7,53,44,9,37
Cliftonville,7817,5,9,4,13,32,33,-1,31
Ballymena,7817,6,7,4,15,25,49,-24,25
Glentoran,7817,7,6,6,10,24,32,-8,24
Dungannon,7817,8,2,4,16,14,47,-33,10
Crusaders,7818,1,17,6,3,62,30,32,57
Coleraine,7818,2,14,10,2,44,24,20,52
Glenavon,7818,3,10,9,7,54,44,10,39
Linfield,7818,4,10,5,11,37,38,-1,35
Cliftonville,7818,5,10,4,12,34,31,3,34
Ballymena,7818,6,7,4,15,25,48,-23,25
Glentoran,7818,7,6,6,10,24,32,-8,24
Dungannon,7818,8,2,4,16,14,47,-33,10
Crusaders,7819,1,17,6,3,63,31,32,57
Coleraine,7819,2,14,11,1,44,23,21,53
Linfield,7819,3,11,5,10,38,36,2,38
Glenavon,7819,4,9,10,7,53,44,9,37
Cliftonville,7819,5,9,4,13,32,32,0,31
Ballymena,7819,6,7,4,15,26,49,-23,25
Glentoran,7819,7,6,6,10,24,32,-8,24
Dungannon,7819,8,2,4,16,14,47,-33,10
Crusaders,7820,1,16,7,3,63,32,31,55
Coleraine,7820,2,14,10,2,45,25,20,52
Glenavon,7820,3,10,9,7,55,45,10,39
Linfield,7820,4,10,5,11,37,37,0,35
Cliftonville,7820,5,10,4,12,33,31,2,34
Ballymena,7820,6,7,5,14,27,49,-22,26
Glentoran,7820,7,6,6,10,24,32,-8,24
Dungannon,7820,8,2,4,16,14,47,-33,10
Crusaders,7821,1,16,6,4,63,33,30,54
Coleraine,7821,2,14,10,2,43,23,20,52
Glenavon,7821,3,10,9,7,53,43,10,39
Linfield,7821,4,11,5,10,40,36,4,38
Cliftonville,7821,5,9,4,13,32,34,-2,31
Ballymena,7821,6,8,4,14,28,49,-21,28
Glentoran,7821,7,6,6,10,24,32,-8,24
Dungannon,7821,8,2,4,16,14,47,-33,10
Crusaders,7822,1,17,6,3,66,31,35,57
Coleraine,7822,2,15,10,1,46,23,23,55
Linfield,7822,3,11,5,10,39,36,3,38
Glenavon,7822,4,9,9,8,53,46,7,36
Cliftonville,7822,5,9,4,13,32,33,-1,31
Ballymena,7822,6,7,4,15,26,52,-26,25
Glentoran,7822,7,6,6,10,24,32,-8,24
Dungannon,7822,8,2,4,16,14,47,-33,10
Crusaders,7823,1,16,7,3,62,31,31,55
Coleraine,7823,2,15,10,1,45,23,22,55
Linfield,7823,3,11,5,10,41,36,5,38
Glenavon,7823,4,9,9,8,53,45,8,36
Cliftonville,7823,5,9,4,13,32,35,-3,31
Ballymena,7823,6,7,5,14,26,48,-22,26
Glentoran,7823,7,6,6,10,24,32,-8,24
Dungannon,7823,8,2,4,16,14,47,-33,10
Crusaders,7824,1,16,7,3,63,32,31,55
Coleraine,7824,2,15,10,1,45,23,22,55
Glenavon,7824,3,9,9,8,53,45,8,36
Linfield,7824,4,10,6,10,38,37,1,36
Cliftonville,7824,5,9,5,12,33,32,1,32
Ballymena,7824,6,7,5,14,27,49,-22,26
Glentoran,7824,7,6,6,10,24,32,-8,24
Dungannon,7824,8,2,4,16,14,47,-33,10
Crusaders,7825,1,16,7,3,62,31,31,55
Coleraine,7825,2,14,10,2,43,27,16,52
Glenavon,7825,3,10,9,7,57,43,14,39
Linfield,7825,4,11,5,10,40,38,2,38
Cliftonville,7825,5,9,4,13,34,34,0,31
Ballymena,7825,6,7,5,14,26,48,-22,26
Glentoran,7825,7,6,6,10,24,32,-8,24
Dungannon,7825,8,2,4,16,14,47,-33,10
Coleraine,7826,1,15,10,1,47,25,22,55
Crusaders,7826,2,16,6,4,61,31,30,54
Linfield,7826,3,11,5,10,38,36,2,38
Glenavon,7826,4,9,9,8,55,47,8,36
Cliftonville,7826,5,9,4,13,32,32,0,31
Ballymena,7826,6,8,4,14,26,47,-21,28
Glentoran,7826,7,6,6,10,24,32,-8,24
Dungannon,7826,8,2,4,16,14,47,-33,10
Crusaders,7827,1,16,6,4,61,31,30,54
Coleraine,7827,2,14,10,2,44,24,20,52
Glenavon,7827,3,10,9,7,54,44,10,39
Linfield,7827,4,11,5,10,41,36,5,38
Cliftonville,7827,5,9,4,13,32,35,-3,31
Ballymena,7827,6,8,4,14,26,47,-21,28
Glentoran,7827,7,6,6,10,24,32,-8,24
Dungannon,7827,8,2,4,16,14,47,-33,10
Crusaders,7828,1,17,6,3,62,30,32,57
Coleraine,7828,2,14,10,2,44,26,18,52
Glenavon,7828,3,10,9,7,56,44,12,39
Linfield,7828,4,11,5,10,42,36,6,38
Cliftonville,7828,5,9,4,13,32,36,-4,31
Ballymena,7828,6,7,4,15,25,48,-23,25
Glentoran,7828,7,6,6,10,24,32,-8,24
Dungannon,7828,8,2,4,16,14,47,-33,10
Crusaders,7829,1,16,6,4,61,31,30,54
Coleraine,7829,2,14,10,2,44,24,20,52
Glenavon,7829,3,10,9,7,54,44,10,39
Linfield,7829,4,10,6,10,38,37,1,36
Cliftonville,7829,5,9,5,12,33,32,1,32
Ballymena,7829,6,8,4,14,26,47,-21,28
Glentoran,7829,7,6,6,10,24,32,-8,24
Dungannon,7829,8,2,4,16,14,47,-33,10
Crusaders,7830,1,17,6,3,62,30,32,57
Coleraine,7830,2,15,10,1,45,23,22,55
Linfield,7830,3,11,5,10,40,38,2,38
Glenavon,7830,4,9,9,8,53,45,8,36
Cliftonville,7830,5,9,4,13,34,34,0,31
Ballymena,7830,6,7,4,15,25,48,-23,25
Glentoran,7830,7,6,6,10,24,32,-8,24
Dungannon,7830,8,2,4,16,14,47,-33,10
Crusaders,7831,1,17,6,3,63,30,33,57
Coleraine,7831,2,14,10,2,43,24,19,52
Glenavon,7831,3,10,9,7,54,43,11,39
Linfield,7831,4,10,6,10,38,37,1,36
Cliftonville,7831,5,9,5,12,33,32,1,32
Ballymena,7831,6,7,4,15,25,49,-24,25
Glentoran,7831,7,6,6,10,24,32,-8,24
Dungannon,7831,8,2,4,16,14,47,-33,10
Crusaders,7832,1,16,7,3,62,31,31,55
Coleraine,7832,2,14,10,2,44,25,19,52
Glenavon,7832,3,10,9,7,55,44,11,39
Linfield,7832,4,11,5,10,39,36,3,38
Cliftonville,7832,5,9,4,13,32,33,-1,31
Ballymena,7832,6,7,5,14,26,48,-22,26
Glentoran,7832,7,6,6,10,24,32,-8,24
Dungannon,7832,8,2,4,16,14,47,-33,10
Coleraine,7833,1,15,10,1,44,22,22,55
Crusaders,7833,2,16,6,4,62,35,27,54
Linfield,7833,3,11,5,10,39,36,3,38
Glenavon,7833,4,9,9,8,52,44,8,36
Cliftonville,7833,5,9,4,13,32,33,-1,31
Ballymena,7833,6,8,4,14,30,48,-18,28
Glentoran,7833,7,6,6,10,24,32,-8,24
Dungannon,7833,8,2,4,16,14,47,-33,10
Crusaders,7834,1,17,6,3,63,30,33,57
Coleraine,7834,2,14,10,2,44,27,17,52
Glenavon,7834,3,10,9,7,57,44,13,39
Linfield,7834,4,10,6,10,38,37,1,36
Cliftonville,7834,5,9,5,12,33,32,1,32
Ballymena,7834,6,7,4,15,25,49,-24,25
Glentoran,7834,7,6,6,10,24,32,-8,24
Dungannon,7834,8,2,4,16,14,47,-33,10
Crusaders,7835,1,17,6,3,64,32,32,57
Coleraine,7835,2,15,10,1,46,23,23,55
Glenavon,7835,3,9,9,8,53,46,7,36
Linfield,7835,4,10,6,10,38,37,1,36
Cliftonville,7835,5,9,5,12,33,32,1,32
Ballymena,7835,6,7,4,15,27,50,-23,25
Glentoran,7835,7,6,6,10,24,32,-8,24
Dungannon,7835,8,2,4,16,14,47,-33,10
Crusaders,7836,1,17,6,3,64,31,33,57
Coleraine,7836,2,15,10,1,45,22,23,55
Glenavon,7836,3,9,9,8,52,45,7,36
Linfield,7836,4,10,5,11,39,40,-1,35
Cliftonville,7836,5,10,4,12,36,33,3,34
Ballymena,7836,6,7,4,15,26,50,-24,25
Glentoran,7836,7,6,6,10,24,32,-8,24
Dungannon,7836,8,2,4,16,14,47,-33,10
Crusaders,7837,1,17,6,3,65,31,34,57
Coleraine,7837,2,14,10,2,44,24,20,52
Glenavon,7837,3,10,9,7,54,44,10,39
Linfield,7837,4,11,5,10,38,36,2,38
Cliftonville,7837,5,9,4,13,32,32,0,31
Ballymena,7837,6,7,4,15,26,51,-25,25
Glentoran,7837,7,6,6,10,24,32,-8,24
Dungannon,7837,8,2,4,16,14,47,-33,10
Crusaders,7838,1,17,6,3,63,30,33,57
Coleraine,7838,2,14,10,2,43,23,20,52
Glenavon,7838,3,10,9,7,53,43,10,39
Linfield,7838,4,11,5,10,39,36,3,38
Cliftonville,7838,5,9,4,13,32,33,-1,31
Ballymena,7838,6,7,4,15,25,49,-24,25
Glentoran,7838,7,6,6,10,24,32,-8,24
Dungannon,7838,8,2,4,16,14,47,-33,10
Crusaders,7839,1,17,6,3,64,32,32,57
Coleraine,7839,2,15,10,1,47,24,23,55
Linfield,7839,3,11,5,10,40,37,3,38
Glenavon,7839,4,9,9,8,54,47,7,36
Cliftonville,7839,5,9,4,13,33,34,-1,31
Ballymena,7839,6,7,4,15,27,50,-23,25
Glentoran,7839,7,6,6,10,24,32,-8,24
Dungannon,7839,8,2,4,16,14,47,-33,10
Coleraine,7840,1,15,10,1,49,22,27,55
Crusaders,7840,2,16,6,4,62,32,30,54
Glenavon,7840,3,9,9,8,52,49,3,36
Linfield,7840,4,10,5,11,37,37,0,35
Cliftonville,7840,5,10,4,12,33,31,2,34
Ballymena,7840,6,8,4,14,27,48,-21,28
Glentoran,7840,7,6,6,10,24,32,-8,24
Dungannon,7840,8,2,4,16,14,47,-33,10
Crusaders,7841,1,17,6,3,65,30,35,57
Coleraine,7841,2,14,11,1,44,23,21,53
Glenavon,7841,3,9,10,7,53,44,9,37
Linfield,7841,4,10,6,10,38,37,1,36
Cliftonville,7841,5,9,5,12,33,32,1,32
Ballymena,7841,6,7,4,15,25,51,-26,25
Glentoran,7841,7,6,6,10,24,32,-8,24
Dungannon,7841,8,2,4,16,14,47,-33,10
Crusaders,7842,1,17,6,3,63,31,32,57
Coleraine,7842,2,14,11,1,47,26,21,53
Linfield,7842,3,11,5,10,38,36,2,38
Glenavon,7842,4,9,10,7,56,47,9,37
Cliftonville,7842,5,9,4,13,32,32,0,31
Ballymena,7842,6,7,4,15,26,49,-23,25
Glentoran,7842,7,6,6,10,24,32,-8,24
Dungannon,7842,8,2,4,16,14,47,-33,10
Crusaders,7843,1,17,6,3,63,31,32,57
Coleraine,7843,2,15,10,1,45,22,23,55
Glenavon,7843,3,9,9,8,52,45,7,36
Linfield,7843,4,10,6,10,38,37,1,36
Cliftonville,7843,5,9,5,12,33,32,1,32
Ballymena,7843,6,7,4,15,26,49,-23,25
Glentoran,7843,7,6,6,10,24,32,-8,24
Dungannon,7843,8,2,4,16,14,47,-33,10
Crusaders,7844,1,16,6,4,61,32,29,54
Coleraine,7844,2,14,11,1,45,24,21,53
Glenavon,7844,3,9,10,7,54,45,9,37
Linfield,7844,4,10,6,10,38,37,1,36
Cliftonville,7844,5,9,5,12,33,32,1,32
Ballymena,7844,6,8,4,14,27,47,-20,28
Glentoran,7844,7,6,6,10,24,32,-8,24
Dungannon,7844,8,2,4,16,14,47,-33,10
Crusaders,7845,1,16,7,3,63,32,31,55
Coleraine,7845,2,14,11,1,44,23,21,53
Linfield,7845,3,11,5,10,40,36,4,38
Glenavon,7845,4,9,10,7,53,44,9,37
Cliftonville,7845,5,9,4,13,32,34,-2,31
Ballymena,7845,6,7,5,14,27,49,-22,26
Glentoran,7845,7,6,6,10,24,32,-8,24
Dungannon,7845,8,2,4,16,14,47,-33,10
Crusaders,7846,1,16,7,3,62,31,31,55
Coleraine,7846,2,14,10,2,45,26,19,52
Glenavon,7846,3,10,9,7,56,45,11,39
Linfield,7846,4,10,5,11,38,39,-1,35
Cliftonville,7846,5,10,4,12,35,32,3,34
Ballymena,7846,6,7,5,14,26,48,-22,26
Glentoran,7846,7,6,6,10,24,32,-8,24
Dungannon,7846,8,2,4,16,14,47,-33,10
Crusaders,7847,1,17,6,3,63,30,33,57
Coleraine,7847,2,14,10,2,45,25,20,52
Glenavon,7847,3,10,9,7,55,45,10,39
Linfield,7847,4,11,5,10,39,36,3,38
Cliftonville,7847,5,9,4,13,32,33,-1,31
Ballymena,7847,6,7,4,15,25,49,-24,25
Glentoran,7847,7,6,6,10,24,32,-8,24
Dungannon,7847,8,2,4,16,14,47,-33,10
Crusaders,7848,1,17,6,3,63,31,32,57
Coleraine,7848,2,15,10,1,44,22,22,55
Glenavon,7848,3,9,9,8,52,44,8,36
Linfield,7848,4,10,5,11,39,40,-1,35
Cliftonville,7848,5,10,4,12,36,33,3,34
Ballymena,7848,6,7,4,15,26,49,-23,25
Glentoran,7848,7,6,6,10,24,32,-8,24
Dungannon,7848,8,2,4,16,14,47,-33,10
Crusaders,7849,1,16,6,4,63,33,30,54
Coleraine,7849,2,14,10,2,43,25,18,52
Glenavon,7849,3,10,9,7,55,43,12,39
Linfield,7849,4,10,5,11,38,38,0,35
Cliftonville,7849,5,10,4,12,34,32,2,34
Ballymena,7849,6,8,4,14,28,49,-21,28
Glentoran,7849,7,6,6,10,24,32,-8,24
Dungannon,7849,8,2,4,16,14,47,-33,10
Crusaders,7850,1,16,7,3,64,33,31,55
Coleraine,7850,2,15,10,1,44,22,22,55
Glenavon,7850,3,9,9,8,52,44,8,36
Linfield,7850,4,10,5,11,38,38,0,35
Cliftonville,7850,5,10,4,12,34,32,2,34
Ballymena,7850,6,7,5,14,28,50,-22,26
Glentoran,7850,7,6,6,10,24,32,-8,24
Dungannon,7850,8,2,4,16,14,47,-33,10
Crusaders,7851,1,17,6,3,64,31,33,57
Coleraine,7851,2,15,10,1,47,22,25,55
Glenavon,7851,3,9,9,8,52,47,5,36
Linfield,7851,4,10,6,10,37,36,1,36
Cliftonville,7851,5,9,5,12,32,31,1,32
Ballymena,7851,6,7,4,15,26,50,-24,25
Glentoran,7851,7,6,6,10,24,32,-8,24
Dungannon,7851,8,2,4,16,14,47,-33,10
Crusaders,7852,1,17,6,3,63,31,32,57
Coleraine,7852,2,15,10,1,45,23,22,55
Linfield,7852,3,11,5,10,38,36,2,38
Glenavon,7852,4,9,9,8,53,45,8,36
Cliftonville,7852,5,9,4,13,32,32,0,31
Ballymena,7852,6,7,4,15,26,49,-23,25
Glentoran,7852,7,6,6,10,24,32,-8,24
Dungannon,7852,8,2,4,16,14,47,-33,10
Coleraine,7853,1,15,10,1,45,23,22,55
Crusaders,7853,2,16,6,4,61,33,28,54
Glenavon,7853,3,9,9,8,53,45,8,36
Linfield,7853,4,10,5,11,37,37,0,35
Cliftonville,7853,5,10,4,12,33,31,2,34
Ballymena,7853,6,8,4,14,28,47,-19,28
Glentoran,7853,7,6,6,10,24,32,-8,24
Dungannon,7853,8,2,4,16,14,47,-33,10
Crusaders,7854,1,17,6,3,63,31,32,57
Coleraine,7854,2,14,10,2,43,26,17,52
Glenavon,7854,3,10,9,7,56,43,13,39
Linfield,7854,4,10,6,10,37,36,1,36
Cliftonville,7854,5,9,5,12,32,31,1,32
Ballymena,7854,6,7,4,15,26,49,-23,25
Glentoran,7854,7,6,6,10,24,32,-8,24
Dungannon,7854,8,2,4,16,14,47,-33,10
Crusaders,7855,1,17,6,3,63,31,32,57
Coleraine,7855,2,15,10,1,46,24,22,55
Linfield,7855,3,11,5,10,39,36,3,38
Glenavon,7855,4,9,9,8,54,46,8,36
Cliftonville,7855,5,9,4,13,32,33,-1,31
Ballymena,7855,6,7,4,15,26,49,-23,25
Glentoran,7855,7,6,6,10,24,32,-8,24
Dungannon,7855,8,2,4,16,14,47,-33,10
Crusaders,7856,1,17,6,3,65,33,32,57
Coleraine,7856,2,14,10,2,45,27,18,52
Glenavon,7856,3,10,9,7,57,45,12,39
Linfield,7856,4,10,6,10,38,37,1,36
Cliftonville,7856,5,9,5,12,33,32,1,32
Ballymena,7856,6,7,4,15,28,51,-23,25
Glentoran,7856,7,6,6,10,24,32,-8,24
Dungannon,7856,8,2,4,16,14,47,-33,10
Crusaders,7857,1,16,7,3,63,32,31,55
Coleraine,7857,2,15,10,1,48,24,24,55
Linfield,7857,3,11,5,10,42,36,6,38
Glenavon,7857,4,9,9,8,54,48,6,36
Cliftonville,7857,5,9,4,13,32,36,-4,31
Ballymena,7857,6,7,5,14,27,49,-22,26
Glentoran,7857,7,6,6,10,24,32,-8,24
Dungannon,7857,8,2,4,16,14,47,-33,10
Crusaders,7858,1,16,6,4,61,31,30,54
Coleraine,7858,2,14,10,2,43,23,20,52
Glenavon,7858,3,10,9,7,53,43,10,39
Linfield,7858,4,11,5,10,39,36,3,38
Cliftonville,7858,5,9,4,13,32,33,-1,31
Ballymena,7858,6,8,4,14,26,47,-21,28
Glentoran,7858,7,6,6,10,24,32,-8,24
Dungannon,7858,8,2,4,16,14,47,-33,10
Coleraine,7859,1,15,10,1,45,22,23,55
Crusaders,7859,2,16,6,4,61,31,30,54
Glenavon,7859,3,9,9,8,52,45,7,36
Linfield,7859,4,10,6,10,38,37,1,36
Cliftonville,7859,5,9,5,12,33,32,1,32
Ballymena,7859,6,8,4,14,26,47,-21,28
Glentoran,7859,7,6,6,10,24,32,-8,24
Dungannon,7859,8,2,4,16,14,47,-33,10
Crusaders,7860,1,16,6,4,62,32,30,54
Coleraine,7860,2,14,10,2,44,25,19,52
Glenavon,7860,3,10,9,7,55,44,11,39
Linfield,7860,4,11,5,10,41,38,3,38
Cliftonville,7860,5,9,4,13,34,35,-1,31
Ballymena,7860,6,8,4,14,27,48,-21,28
Glentoran,7860,7,6,6,10,24,32,-8,24
Dungannon,7860,8,2,4,16,14,47,-33,10
Crusaders,7861,1,17,6,3,65,31,34,57
Coleraine,7861,2,14,10,2,44,25,19,52
Glenavon,7861,3,10,9,7,55,44,11,39
Linfield,7861,4,10,6,10,38,37,1,36
Cliftonville,7861,5,9,5,12,33,32,1,32
Ballymena,7861,6,7,4,15,26,51,-25,25
Glentoran,7861,7,6,6,10,24,32,-8,24
Dungannon,7861,8,2,4,16,14,47,-33,10
Crusaders,7862,1,17,6,3,63,31,32,57
Coleraine,7862,2,14,11,1,43,22,21,53
Glenavon,7862,3,9,10,7,52,43,9,37
Linfield,7862,4,10,6,10,38,37,1,36
Cliftonville,7862,5,9,5,12,33,32,1,32
Ballymena,7862,6,7,4,15,26,49,-23,25
Glentoran,7862,7,6,6,10,24,32,-8,24
Dungannon,7862,8,2,4,16,14,47,-33,10
Crusaders,7863,1,17,6,3,63,31,32,57
Coleraine,7863,2,15,10,1,45,22,23,55
Glenavon,7863,3,9,9,8,52,45,7,36
Linfield,7863,4,10,6,10,37,36,1,36
Cliftonville,7863,5,9,5,12,32,31,1,32
Ballymena,7863,6,7,4,15,26,49,-23,25
Glentoran,7863,7,6,6,10,24,32,-8,24
Dungannon,7863,8,2,4,16,14,47,-33,10
Coleraine,7864,1,15,10,1,47,24,23,55
Crusaders,7864,2,16,6,4,63,33,30,54
Linfield,7864,3,11,5,10,39,36,3,38
Glenavon,7864,4,9,9,8,54,47,7,36
Cliftonville,7864,5,9,4,13,32,33,-1,31
Ballymena,7864,6,8,4,14,28,49,-21,28
Glentoran,7864,7,6,6,10,24,32,-8,24
Dungannon,7864,8,2,4,16,14,47,-33,10
Crusaders,7865,1,17,6,3,62,30,32,57
Coleraine,7865,2,14,10,2,44,24,20,52
Glenavon,7865,3,10,9,7,54,44,10,39
Linfield,7865,4,10,5,11,38,39,-1,35
Cliftonville,7865,5,10,4,12,35,32,3,34
Ballymena,7865,6,7,4,15,25,48,-23,25
Glentoran,7865,7,6,6,10,24,32,-8,24
Dungannon,7865,8,2,4,16,14,47,-33,10
Crusaders,7866,1,17,6,3,64,31,33,57
Coleraine,7866,2,14,11,1,44,23,21,53
Linfield,7866,3,11,5,10,38,36,2,38
Glenavon,7866,4,9,10,7,53,44,9,37
Cliftonville,7866,5,9,4,13,32,32,0,31
Ballymena,7866,6,7,4,15,26,50,-24,25
Glentoran,7866,7,6,6,10,24,32,-8,24
Dungannon,7866,8,2,4,16,14,47,-33,10
Crusaders,7867,1,17,6,3,65,31,34,57
Coleraine,7867,2,14,10,2,45,26,19,52
Glenavon,7867,3,10,9,7,56,45,11,39
Linfield,7867,4,11,5,10,39,36,3,38
Cliftonville,7867,5,9,4,13,32,33,-1,31
Ballymena,7867,6,7,4,15,26,51,-25,25
Glentoran,7867,7,6,6,10,24,32,-8,24
Dungannon,7867,8,2,4,16,14,47,-33,10
Crusaders,7868,1,17,6,3,64,32,32,57
Coleraine,7868,2,15,10,1,45,22,23,55
Glenavon,7868,3,9,9,8,52,45,7,36
Linfield,7868,4,10,6,10,38,37,1,36
Cliftonville,7868,5,9,5,12,33,32,1,32
Ballymena,7868,6,7,4,15,27,50,-23,25
Glentoran,7868,7,6,6,10,24,32,-8,24
Dungannon,7868,8,2,4,16,14,47,-33,10
Crusaders,7869,1,16,7,3,62,31,31,55
Coleraine,7869,2,14,11,1,44,23,21,53
Glenavon,7869,3,9,10,7,53,44,9,37
Linfield,7869,4,10,5,11,37,37,0,35
Cliftonville,7869,5,10,4,12,33,31,2,34
Ballymena,7869,6,7,5,14,26,48,-22,26
Glentoran,7869,7,6,6,10,24,32,-8,24
Dungannon,7869,8,2,4,16,14,47,-33,10
Crusaders,7870,1,17,6,3,65,30,35,57
Coleraine,7870,2,15,10,1,45,22,23,55
Linfield,7870,3,11,5,10,39,36,3,38
Glenavon,7870,4,9,9,8,52,45,7,36
Cliftonville,7870,5,9,4,13,32,33,-1,31
Ballymena,7870,6,7,4,15,25,51,-26,25
Glentoran,7870,7,6,6,10,24,32,-8,24
Dungannon,7870,8,2,4,16,14,47,-33,10
Crusaders,7871,1,17,6,3,64,30,34,57
Coleraine,7871,2,14,10,2,43,25,18,52
Glenavon,7871,3,10,9,7,55,43,12,39
Linfield,7871,4,11,5,10,38,36,2,38
Cliftonville,7871,5,9,4,13,32,32,0,31
Ballymena,7871,6,7,4,15,25,50,-25,25
Glentoran,7871,7,6,6,10,24,32,-8,24
Dungannon,7871,8,2,4,16,14,47,-33,10
Crusaders,7872,1,17,6,3,64,30,34,57
Coleraine,7872,2,14,10,2,44,24,20,52
Glenavon,7872,3,10,9,7,54,44,10,39
Linfield,7872,4,10,6,10,38,37,1,36
Cliftonville,7872,5,9,5,12,33,32,1,32
Ballymena,7872,6,7,4,15,25,50,-25,25
Glentoran,7872,7,6,6,10,24,32,-8,24
Dungannon,7872,8,2,4,16,14,47,-33,10
Crusaders,7873,1,17,6,3,64,31,33,57
Coleraine,7873,2,14,10,2,43,24,19,52
Glenavon,7873,3,10,9,7,54,43,11,39
Linfield,7873,4,11,5,10,38,36,2,38
Cliftonville,7873,5,9,4,13,32,32,0,31
Ballymena,7873,6,7,4,15,26,50,-24,25
Glentoran,7873,7,6,6,10,24,32,-8,24
Dungannon,7873,8,2,4,16,14,47,-33,10
Crusaders,7874,1,16,7,3,64,33,31,55
Coleraine,7874,2,15,10,1,44,22,22,55
Linfield,7874,3,11,5,10,41,36,5,38
Glenavon,7874,4,9,9,8,52,44,8,36
Cliftonville,7874,5,9,4,13,32,35,-3,31
Ballymena,7874,6,7,5,14,28,50,-22,26
Glentoran,7874,7,6,6,10,24,32,-8,24
Dungannon,7874,8,2,4,16,14,47,-33,10
Crusaders,7875,1,16,6,4,61,32,29,54
Coleraine,7875,2,14,11,1,46,25,21,53
Linfield,7875,3,11,5,10,39,36,3,38
Glenavon,7875,4,9,10,7,55,46,9,37
Cliftonville,7875,5,9,4,13,32,33,-1,31
Ballymena,7875,6,8,4,14,27,47,-20,28
Glentoran,7875,7,6,6,10,24,32,-8,24
Dungannon,7875,8,2,4,16,14,47,-33,10
Crusaders,7876,1,16,7,3,62,31,31,55
Coleraine,7876,2,15,10,1,47,24,23,55
Linfield,7876,3,11,5,10,39,37,2,38
Glenavon,7876,4,9,9,8,54,47,7,36
Cliftonville,7876,5,9,4,13,33,33,0,31
Ballymena,7876,6,7,5,14,26,48,-22,26
Glentoran,7876,7,6,6,10,24,32,-8,24
Dungannon,7876,8,2,4,16,14,47,-33,10
Crusaders,7877,1,16,7,3,62,31,31,55
Coleraine,7877,2,14,11,1,45,24,21,53
Glenavon,7877,3,9,10,7,54,45,9,37
Linfield,7877,4,10,6,10,37,36,1,36
Cliftonville,7877,5,9,5,12,32,31,1,32
Ballymena,7877,6,7,5,14,26,48,-22,26
Glentoran,7877,7,6,6,10,24,32,-8,24
Dungannon,7877,8,2,4,16,14,47,-33,10
Crusaders,7878,1,16,7,3,62,31,31,55
Coleraine,7878,2,14,10,2,43,26,17,52
Glenavon,7878,3,10,9,7,56,43,13,39
Linfield,7878,4,10,6,10,40,39,1,36
Cliftonville,7878,5,9,5,12,35,34,1,32
Ballymena,7878,6,7,5,14,26,48,-22,26
Glentoran,7878,7,6,6,10,24,32,-8,24
Dungannon,7878,8,2,4,16,14,47,-33,10
Crusaders,7879,1,17,6,3,62,30,32,57
Coleraine,7879,2,14,10,2,45,26,19,52
Glenavon,7879,3,10,9,7,56,45,11,39
Linfield,7879,4,11,5,10,40,36,4,38
Cliftonville,7879,5,9,4,13,32,34,-2,31
Ballymena,7879,6,7,4,15,25,48,-23,25
Glentoran,7879,7,6,6,10,24,32,-8,24
Dungannon,7879,8,2,4,16,14,47,-33,10
Crusaders,7880,1,17,6,3,63,31,32,57
Coleraine,7880,2,14,11,1,44,23,21,53
Glenavon,7880,3,9,10,7,53,44,9,37
Linfield,7880,4,10,5,11,37,37,0,35
Cliftonville,7880,5,10,4,12,33,31,2,34
Ballymena,7880,6,7,4,15,26,49,-23,25
Glentoran,7880,7,6,6,10,24,32,-8,24
Dungannon,7880,8,2,4,16,14,47,-33,10
Crusaders,7881,1,16,6,4,64,34,30,54
Coleraine,7881,2,14,10,2,43,24,19,52
Glenavon,7881,3,10,9,7,54,43,11,39
Linfield,7881,4,11,5,10,40,36,4,38
Cliftonville,7881,5,9,4,13,32,34,-2,31
Ballymena,7881,6,8,4,14,29,50,-21,28
Glentoran,7881,7,6,6,10,24,32,-8,24
Dungannon,7881,8,2,4,16,14,47,-33,10
Crusaders,7882,1,17,6,3,62,30,32,57
Coleraine,7882,2,15,10,1,44,22,22,55
Linfield,7882,3,11,5,10,39,36,3,38
Glenavon,7882,4,9,9,8,52,44,8,36
Cliftonville,7882,5,9,4,13,32,33,-1,31
Ballymena,7882,6,7,4,15,25,48,-23,25
Glentoran,7882,7,6,6,10,24,32,-8,24
Dungannon,7882,8,2,4,16,14,47,-33,10
Crusaders,7883,1,17,6,3,64,32,32,57
Coleraine,7883,2,14,11,1,44,23,21,53
Glenavon,7883,3,9,10,7,53,44,9,37
Linfield,7883,4,10,5,11,37,37,0,35
Cliftonville,7883,5,10,4,12,33,31,2,34
Ballymena,7883,6,7,4,15,27,50,-23,25
Glentoran,7883,7,6,6,10,24,32,-8,24
Dungannon,7883,8,2,4,16,14,47,-33,10
Crusaders,7884,1,17,6,3,63,31,32,57
Coleraine,7884,2,14,10,2,45,26,19,52
Glenavon,7884,3,10,9,7,56,45,11,39
Linfield,7884,4,11,5,10,38,36,2,38
Cliftonville,7884,5,9,4,13,32,32,0,31
Ballymena,7884,6,7,4,15,26,49,-23,25
Glentoran,7884,7,6,6,10,24,32,-8,24
Dungannon,7884,8,2,4,16,14,47,-33,10
Crusaders,7885,1,16,7,3,63,32,31,55
Coleraine,7885,2,15,10,1,46,24,22,55
Glenavon,7885,3,9,9,8,54,46,8,36
Linfield,7885,4,10,6,10,37,36,1,36
Cliftonville,7885,5,9,5,12,32,31,1,32
Ballymena,7885,6,7,5,14,27,49,-22,26
Glentoran,7885,7,6,6,10,24,32,-8,24
Dungannon,7885,8,2,4,16,14,47,-33,10
Crusaders,7886,1,17,6,3,63,30,33,57
Coleraine,7886,2,14,10,2,43,24,19,52
Glenavon,7886,3,10,9,7,54,43,11,39
Linfield,7886,4,10,5,11,39,41,-2,35
Cliftonville,7886,5,10,4,12,37,33,4,34
Ballymena,7886,6,7,4,15,25,49,-24,25
Glentoran,7886,7,6,6,10,24,32,-8,24
Dungannon,7886,8,2,4,16,14,47,-33,10
Crusaders,7887,1,17,6,3,64,31,33,57
Coleraine,7887,2,14,10,2,43,24,19,52
Glenavon,7887,3,10,9,7,54,43,11,39
Linfield,7887,4,10,6,10,39,38,1,36
Cliftonville,7887,5,9,5,12,34,33,1,32
Ballymena,7887,6,7,4,15,26,50,-24,25
Glentoran,7887,7,6,6,10,24,32,-8,24
Dungannon,7887,8,2,4,16,14,47,-33,10
Crusaders,7888,1,17,6,3,64,32,32,57
Coleraine,7888,2,14,11,1,44,23,21,53
Glenavon,7888,3,9,10,7,53,44,9,37
Linfield,7888,4,10,6,10,38,37,1,36
Cliftonville,7888,5,9,5,12,33,32,1,32
Ballymena,7888,6,7,4,15,27,50,-23,25
Glentoran,7888,7,6,6,10,24,32,-8,24
Dungannon,7888,8,2,4,16,14,47,-33,10
Crusaders,7889,1,16,7,3,63,32,31,55
Coleraine,7889,2,15,10,1,44,22,22,55
Linfield,7889,3,11,5,10,40,37,3,38
Glenavon,7889,4,9,9,8,52,44,8,36
Cliftonville,7889,5,9,4,13,33,34,-1,31
Ballymena,7889,6,7,5,14,27,49,-22,26
Glentoran,7889,7,6,6,10,24,32,-8,24
Dungannon,7889,8,2,4,16,14,47,-33,10
Crusaders,7890,1,17,6,3,63,31,32,57
Coleraine,7890,2,14,10,2,44,25,19,52
Glenavon,7890,3,10,9,7,55,44,11,39
Linfield,7890,4,11,5,10,40,38,2,38
Cliftonville,7890,5,9,4,13,34,34,0,31
Ballymena,7890,6,7,4,15,26,49,-23,25
Glentoran,7890,7,6,6,10,24,32,-8,24
Dungannon,7890,8,2,4,16,14,47,-33,10
Crusaders,7891,1,17,6,3,65,30,35,57
Coleraine,7891,2,14,10,2,45,27,18,52
Glenavon,7891,3,10,9,7,57,45,12,39
Linfield,7891,4,10,6,10,37,36,1,36
Cliftonville,7891,5,9,5,12,32,31,1,32
Ballymena,7891,6,7,4,15,25,51,-26,25
Glentoran,7891,7,6,6,10,24,32,-8,24
Dungannon,7891,8,2,4,16,14,47,-33,10
Crusaders,7892,1,16,7,3,62,31,31,55
Coleraine,7892,2,15,10,1,44,22,22,55
Linfield,7892,3,11,5,10,39,37,2,38
Glenavon,7892,4,9,9,8,52,44,8,36
Cliftonville,7892,5,9,4,13,33,33,0,31
Ballymena,7892,6,7,5,14,26,48,-22,26
Glentoran,7892,7,6,6,10,24,32,-8,24
Dungannon,7892,8,2,4,16,14,47,-33,10
Crusaders,7893,1,17,6,3,66,30,36,57
Coleraine,7893,2,14,10,2,45,27,18,52
Glenavon,7893,3,10,9,7,57,45,12,39
Linfield,7893,4,10,6,10,37,36,1,36
Cliftonville,7893,5,9,5,12,32,31,1,32
Ballymena,7893,6,7,4,15,25,52,-27,25
Glentoran,7893,7,6,6,10,24,32,-8,24
Dungannon,7893,8,2,4,16,14,47,-33,10
Crusaders,7894,1,17,6,3,63,31,32,57
Coleraine,7894,2,14,11,1,43,22,21,53
Glenavon,7894,3,9,10,7,52,43,9,37
Linfield,7894,4,10,5,11,37,40,-3,35
Cliftonville,7894,5,10,4,12,36,31,5,34
Ballymena,7894,6,7,4,15,26,49,-23,25
Glentoran,7894,7,6,6,10,24,32,-8,24
Dungannon,7894,8,2,4,16,14,47,-33,10
Crusaders,7895,1,16,7,3,64,33,31,55
Coleraine,7895,2,14,10,2,46,26,20,52
Glenavon,7895,3,10,9,7,56,46,10,39
Linfield,7895,4,10,6,10,38,37,1,36
Cliftonville,7895,5,9,5,12,33,32,1,32
Ballymena,7895,6,7,5,14,28,50,-22,26
Glentoran,7895,7,6,6,10,24,32,-8,24
Dungannon,7895,8,2,4,16,14,47,-33,10
Crusaders,7896,1,17,6,3,63,30,33,57
Coleraine,7896,2,14,10,2,43,23,20,52
Glenavon,7896,3,10,9,7,53,43,10,39
Linfield,7896,4,10,6,10,38,37,1,36
Cliftonville,7896,5,9,5,12,33,32,1,32
Ballymena,7896,6,7,4,15,25,49,-24,25
Glentoran,7896,7,6,6,10,24,32,-8,24
Dungannon,7896,8,2,4,16,14,47,-33,10
Crusaders,7897,1,17,6,3,62,30,32,57
Coleraine,7897,2,15,10,1,47,24,23,55
Linfield,7897,3,11,5,10,39,36,3,38
Glenavon,7897,4,9,9,8,54,47,7,36
Cliftonville,7897,5,9,4,13,32,33,-1,31
Ballymena,7897,6,7,4,15,25,48,-23,25
Glentoran,7897,7,6,6,10,24,32,-8,24
Dungannon,7897,8,2,4,16,14,47,-33,10
Crusaders,7898,1,16,7,3,63,32,31,55
Coleraine,7898,2,14,10,2,45,25,20,52
Glenavon,7898,3,10,9,7,55,45,10,39
Linfield,7898,4,11,5,10,39,36,3,38
Cliftonville,7898,5,9,4,13,32,33,-1,31
Ballymena,7898,6,7,5,14,27,49,-22,26
Glentoran,7898,7,6,6,10,24,32,-8,24
Dungannon,7898,8,2,4,16,14,47,-33,10
Coleraine,7899,1,15,10,1,45,22,23,55
Crusaders,7899,2,16,6,4,61,31,30,54
Glenavon,7899,3,9,9,8,52,45,7,36
Linfield,7899,4,10,5,11,37,38,-1,35
Cliftonville,7899,5,10,4,12,34,31,3,34
Ballymena,7899,6,8,4,14,26,47,-21,28
Glentoran,7899,7,6,6,10,24,32,-8,24
Dungannon,7899,8,2,4,16,14,47,-33,10
Crusaders,7900,1,16,6,4,61,32,29,54
Coleraine,7900,2,14,11,1,44,23,21,53
Linfield,7900,3,11,5,10,39,37,2,38
Glenavon,7900,4,9,10,7,53,44,9,37
Cliftonville,7900,5,9,4,13,33,33,0,31
Ballymena,7900,6,8,4,14,27,47,-20,28
Glentoran,7900,7,6,6,10,24,32,-8,24
Dungannon,7900,8,2,4,16,14,47,-33,10
Crusaders,7901,1,16,7,3,62,31,31,55
Coleraine,7901,2,14,10,2,45,26,19,52
Glenavon,7901,3,10,9,7,56,45,11,39
Linfield,7901,4,10,5,11,38,38,0,35
Cliftonville,7901,5,10,4,12,34,32,2,34
Ballymena,7901,6,7,5,14,26,48,-22,26
Glentoran,7901,7,6,6,10,24,32,-8,24
Dungannon,7901,8,2,4,16,14,47,-33,10
Crusaders,7902,1,17,6,3,63,30,33,57
Coleraine,7902,2,15,10,1,46,23,23,55
Glenavon,7902,3,9,9,8,53,46,7,36
Linfield,7902,4,10,5,11,37,37,0,35
Cliftonville,7902,5,10,4,12,33,31,2,34
Ballymena,7902,6,7,4,15,25,49,-24,25
Glentoran,7902,7,6,6,10,24,32,-8,24
Dungannon,7902,8,2,4,16,14,47,-33,10
Crusaders,7903,1,17,6,3,65,30,35,57
Coleraine,7903,2,14,11,1,44,23,21,53
Glenavon,7903,3,9,10,7,53,44,9,37
Linfield,7903,4,10,5,11,38,39,-1,35
Cliftonville,7903,5,10,4,12,35,32,3,34
Ballymena,7903,6,7,4,15,25,51,-26,25
Glentoran,7903,7,6,6,10,24,32,-8,24
Dungannon,7903,8,2,4,16,14,47,-33,10
Crusaders,7904,1,17,6,3,64,30,34,57
Coleraine,7904,2,14,10,2,44,24,20,52
Glenavon,7904,3,10,9,7,54,44,10,39
Linfield,7904,4,11,5,10,41,37,4,38
Cliftonville,7904,5,9,4,13,33,35,-2,31
Ballymena,7904,6,7,4,15,25,50,-25,25
Glentoran,7904,7,6,6,10,24,32,-8,24
Dungannon,7904,8,2,4,16,14,47,-33,10
Crusaders,7905,1,16,7,3,62,31,31,55
Coleraine,7905,2,15,10,1,47,23,24,55
Glenavon,7905,3,9,9,8,53,47,6,36
Linfield,7905,4,10,5,11,37,38,-1,35
Cliftonville,7905,5,10,4,12,34,31,3,34
Ballymena,7905,6,7,5,14,26,48,-22,26
Glentoran,7905,7,6,6,10,24,32,-8,24
Dungannon,7905,8,2,4,16,14,47,-33,10
Crusaders,7906,1,16,7,3,63,32,31,55
Coleraine,7906,2,15,10,1,44,22,22,55
Linfield,7906,3,11,5,10,38,36,2,38
Glenavon,7906,4,9,9,8,52,44,8,36
Cliftonville,7906,5,9,4,13,32,32,0,31
Ballymena,7906,6,7,5,14,27,49,-22,26
Glentoran,7906,7,6,6,10,24,32,-8,24
Dungannon,7906,8,2,4,16,14,47,-33,10
Crusaders,7907,1,17,6,3,65,31,34,57
Coleraine,7907,2,15,10,1,46,23,23,55
Glenavon,7907,3,9,9,8,53,46,7,36
Linfield,7907,4,10,5,11,37,37,0,35
Cliftonville,7907,5,10,4,12,33,31,2,34
Ballymena,7907,6,7,4,15,26,51,-25,25
Glentoran,7907,7,6,6,10,24,32,-8,24
Dungannon,7907,8,2,4,16,14,47,-33,10
Crusaders,7908,1,16,6,4,61,31,30,54
Coleraine,7908,2,14,11,1,44,23,21,53
Glenavon,7908,3,9,10,7,53,44,9,37
Linfield,7908,4,10,6,10,37,36,1,36
Cliftonville,7908,5,9,5,12,32,31,1,32
Ballymena,7908,6,8,4,14,26,47,-21,28
Glentoran,7908,7,6,6,10,24,32,-8,24
Dungannon,7908,8,2,4,16,14,47,-33,10
Crusaders,7909,1,16,7,3,64,33,31,55
Coleraine,7909,2,14,10,2,43,24,19,52
Glenavon,7909,3,10,9,7,54,43,11,39
Linfield,7909,4,10,6,10,38,37,1,36
Cliftonville,7909,5,9,5,12,33,32,1,32
Ballymena,7909,6,7,5,14,28,50,-22,26
Glentoran,7909,7,6,6,10,24,32,-8,24
Dungannon,7909,8,2,4,16,14,47,-33,10
Crusaders,7910,1,17,6,3,63,30,33,57
Coleraine,7910,2,14,10,2,43,23,20,52
Glenavon,7910,3,10,9,7,53,43,10,39
Linfield,7910,4,10,6,10,38,37,1,36
Cliftonville,7910,5,9,5,12,33,32,1,32
Ballymena,7910,6,7,4,15,25,49,-24,25
Glentoran,7910,7,6,6,10,24,32,-8,24
Dungannon,7910,8,2,4,16,14,47,-33,10
Crusaders,7911,1,16,7,3,62,31,31,55
Coleraine,7911,2,14,10,2,43,24,19,52
Glenavon,7911,3,10,9,7,54,43,11,39
Linfield,7911,4,10,5,11,39,39,0,35
Cliftonville,7911,5,10,4,12,35,33,2,34
Ballymena,7911,6,7,5,14,26,48,-22,26
Glentoran,7911,7,6,6,10,24,32,-8,24
Dungannon,7911,8,2,4,16,14,47,-33,10
Crusaders,7912,1,16,7,3,62,31,31,55
Coleraine,7912,2,15,10,1,44,22,22,55
Linfield,7912,3,11,5,10,40,37,3,38
Glenavon,7912,4,9,9,8,52,44,8,36
Cliftonville,7912,5,9,4,13,33,34,-1,31
Ballymena,7912,6,7,5,14,26,48,-22,26
Glentoran,7912,7,6,6,10,24,32,-8,24
Dungannon,7912,8,2,4,16,14,47,-33,10
Crusaders,7913,1,16,7,3,62,31,31,55
Coleraine,7913,2,14,10,2,44,25,19,52
Glenavon,7913,3,10,9,7,55,44,11,39
Linfield,7913,4,10,6,10,38,37,1,36
Cliftonville,7913,5,9,5,12,33,32,1,32
Ballymena,7913,6,7,5,14,26,48,-22,26
Glentoran,7913,7,6,6,10,24,32,-8,24
Dungannon,7913,8,2,4,16,14,47,-33,10
Crusaders,7914,1,16,7,3,63,32,31,55
Coleraine,7914,2,14,11,1,43,22,21,53
Glenavon,7914,3,9,10,7,52,43,9,37
Linfield,7914,4,10,5,11,37,38,-1,35
Cliftonville,7914,5,10,4,12,34,31,3,34
Ballymena,7914,6,7,5,14,27,49,-22,26
Glentoran,7914,7,6,6,10,24,32,-8,24
Dungannon,7914,8,2,4,16,14,47,-33,10
Crusaders,7915,1,17,6,3,62,30,32,57
Coleraine,7915,2,14,11,1,46,25,21,53
Linfield,7915,3,11,5,10,41,37,4,38
Glenavon,7915,4,9,10,7,55,46,9,37
Cliftonville,7915,5,9,4,13,33,35,-2,31
Ballymena,7915,6,7,4,15,25,48,-23,25
Glentoran,7915,7,6,6,10,24,32,-8,24
Dungannon,7915,8,2,4,16,14,47,-33,10
Crusaders,7916,1,17,6,3,64,31,33,57
Coleraine,7916,2,14,10,2,43,23,20,52
Glenavon,7916,3,10,9,7,53,43,10,39
Linfield,7916,4,10,6,10,38,37,1,36
Cliftonville,7916,5,9,5,12,33,32,1,32
Ballymena,7916,6,7,4,15,26,50,-24,25
Glentoran,7916,7,6,6,10,24,32,-8,24
Dungannon,7916,8,2,4,16,14,47,-33,10
Crusaders,7917,1,16,7,3,62,31,31,55
Coleraine,7917,2,15,10,1,45,23,22,55
Glenavon,7917,3,9,9,8,53,45,8,36
Linfield,7917,4,10,6,10,37,36,1,36
Cliftonville,7917,5,9,5,12,32,31,1,32
Ballymena,7917,6,7,5,14,26,48,-22,26
Glentoran,7917,7,6,6,10,24,32,-8,24
Dungannon,7917,8,2,4,16,14,47,-33,10
Crusaders,7918,1,17,6,3,63,31,32,57
Coleraine,7918,2,14,10,2,43,23,20,52
Glenavon,7918,3,10,9,7,53,43,10,39
Linfield,7918,4,11,5,10,38,36,2,38
Cliftonville,7918,5,9,4,13,32,32,0,31
Ballymena,7918,6,7,4,15,26,49,-23,25
Glentoran,7918,7,6,6,10,24,32,-8,24
Dungannon,7918,8,2,4,16,14,47,-33,10
Crusaders,7919,1,16,6,4,61,32,29,54
Coleraine,7919,2,14,10,2,44,26,18,52
Glenavon,7919,3,10,9,7,56,44,12,39
Linfield,7919,4,10,6,10,37,36,1,36
Cliftonville,7919,5,9,5,12,32,31,1,32
Ballymena,7919,6,8,4,14,27,47,-20,28
Glentoran,7919,7,6,6,10,24,32,-8,24
Dungannon,7919,8,2,4,16,14,47,-33,10
Crusaders,7920,1,17,6,3,65,31,34,57
Coleraine,7920,2,15,10,1,46,23,23,55
Linfield,7920,3,11,5,10,39,36,3,38
Glenavon,7920,4,9,9,8,53,46,7,36
Cliftonville,7920,5,9,4,13,32,33,-1,31
Ballymena,7920,6,7,4,15,26,51,-25,25
Glentoran,7920,7,6,6,10,24,32,-8,24
Dungannon,7920,8,2,4,16,14,47,-33,10
Crusaders,7921,1,17,6,3,65,31,34,57
Coleraine,7921,2,14,10,2,43,24,19,52
Glenavon,7921,3,10,9,7,54,43,11,39
Linfield,7921,4,11,5,10,38,36,2,38
Cliftonville,7921,5,9,4,13,32,32,0,31
Ballymena,7921,6,7,4,15,26,51,-25,25
Glentoran,7921,7,6,6,10,24,32,-8,24
Dungannon,7921,8,2,4,16,14,47,-33,10
Crusaders,7922,1,17,6,3,63,31,32,57
Coleraine,7922,2,15,10,1,45,23,22,55
Linfield,7922,3,11,5,10,39,37,2,38
Glenavon,7922,4,9,9,8,53,45,8,36
Cliftonville,7922,5,9,4,13,33,33,0,31
Ballymena,7922,6,7,4,15,26,49,-23,25
Glentoran,7922,7,6,6,10,24,32,-8,24
Dungannon,7922,8,2,4,16,14,47,-33,10
Coleraine,7923,1,15,10,1,45,23,22,55
Crusaders,7923,2,16,6,4,61,31,30,54
Linfield,7923,3,11,5,10,39,36,3,38
Glenavon,7923,4,9,9,8,53,45,8,36
Cliftonville,7923,5,9,4,13,32,33,-1,31
Ballymena,7923,6,8,4,14,26,47,-21,28
Glentoran,7923,7,6,6,10,24,32,-8,24
Dungannon,7923,8,2,4,16,14,47,-33,10
Crusaders,7924,1,16,7,3,62,31,31,55
Coleraine,7924,2,15,10,1,45,23,22,55
Glenavon,7924,3,9,9,8,53,45,8,36
Linfield,7924,4,10,6,10,37,36,1,36
Cliftonville,7924,5,9,5,12,32,31,1,32
Ballymena,7924,6,7,5,14,26,48,-22,26
Glentoran,7924,7,6,6,10,24,32,-8,24
Dungannon,7924,8,2,4,16,14,47,-33,10
Crusaders,7925,1,16,7,3,64,33,31,55
Coleraine,7925,2,14,11,1,43,22,21,53
Linfield,7925,3,11,5,10,38,36,2,38
Glenavon,7925,4,9,10,7,52,43,9,37
Cliftonville,7925,5,9,4,13,32,32,0,31
Ballymena,7925,6,7,5,14,28,50,-22,26
Glentoran,7925,7,6,6,10,24,32,-8,24
Dungannon,7925,8,2,4,16,14,47,-33,10
Coleraine,7926,1,15,10,1,45,23,22,55
Crusaders,7926,2,16,6,4,61,31,30,54
Linfield,7926,3,11,5,10,40,38,2,38
Glenavon,7926,4,9,9,8,53,45,8,36
Cliftonville,7926,5,9,4,13,34,34,0,31
Ballymena,7926,6,8,4,14,26,47,-21,28
Glentoran,7926,7,6,6,10,24,32,-8,24
Dungannon,7926,8,2,4,16,14,47,-33,10
Crusaders,7927,1,17,6,3,64,32,32,57
Coleraine,7927,2,15,10,1,45,23,22,55
Linfield,7927,3,11,5,10,41,39,2,38
Glenavon,7927,4,9,9,8,53,45,8,36
Cliftonville,7927,5,9,4,13,35,35,0,31
Ballymena,7927,6,7,4,15,27,50,-23,25
Glentoran,7927,7,6,6,10,24,32,-8,24
Dungannon,7927,8,2,4,16,14,47,-33,10
Crusaders,7928,1,16,7,3,62,31,31,55
Coleraine,7928,2,15,10,1,47,23,24,55
Glenavon,7928,3,9,9,8,53,47,6,36
Linfield,7928,4,10,5,11,37,37,0,35
Cliftonville,7928,5,10,4,12,33,31,2,34
Ballymena,7928,6,7,5,14,26,48,-22,26
Glentoran,7928,7,6,6,10,24,32,-8,24
Dungannon,7928,8,2,4,16,14,47,-33,10
Crusaders,7929,1,17,6,3,64,32,32,57
Coleraine,7929,2,14,11,1,45,24,21,53
Linfield,7929,3,11,5,10,38,36,2,38
Glenavon,7929,4,9,10,7,54,45,9,37
Cliftonville,7929,5,9,4,13,32,32,0,31
Ballymena,7929,6,7,4,15,27,50,-23,25
Glentoran,7929,7,6,6,10,24,32,-8,24
Dungannon,7929,8,2,4,16,14,47,-33,10
Crusaders,7930,1,16,6,4,62,32,30,54
Coleraine,7930,2,14,11,1,44,23,21,53
Glenavon,7930,3,9,10,7,53,44,9,37
Linfield,7930,4,10,5,11,37,37,0,35
Cliftonville,7930,5,10,4,12,33,31,2,34
Ballymena,7930,6,8,4,14,27,48,-21,28
Glentoran,7930,7,6,6,10,24,32,-8,24
Dungannon,7930,8,2,4,16,14,47,-33,10
Crusaders,7931,1,17,6,3,62,30,32,57
Coleraine,7931,2,14,10,2,45,25,20,52
Glenavon,7931,3,10,9,7,55,45,10,39
Linfield,7931,4,11,5,10,38,36,2,38
Cliftonville,7931,5,9,4,13,32,32,0,31
Ballymena,7931,6,7,4,15,25,48,-23,25
Glentoran,7931,7,6,6,10,24,32,-8,24
Dungannon,7931,8,2,4,16,14,47,-33,10
Crusaders,7932,1,17,6,3,62,30,32,57
Coleraine,7932,2,14,11,1,45,24,21,53
Linfield,7932,3,11,5,10,40,37,3,38
Glenavon,7932,4,9,10,7,54,45,9,37
Cliftonville,7932,5,9,4,13,33,34,-1,31
Ballymena,7932,6,7,4,15,25,48,-23,25
Glentoran,7932,7,6,6,10,24,32,-8,24
Dungannon,7932,8,2,4,16,14,47,-33,10
Crusaders,7933,1,17,6,3,64,32,32,57
Coleraine,7933,2,14,11,1,44,23,21,53
Glenavon,7933,3,9,10,7,53,44,9,37
Linfield,7933,4,10,6,10,37,36,1,36
Cliftonville,7933,5,9,5,12,32,31,1,32
Ballymena,7933,6,7,4,15,27,50,-23,25
Glentoran,7933,7,6,6,10,24,32,-8,24
Dungannon,7933,8,2,4,16,14,47,-33,10
Crusaders,7934,1,16,6,4,63,34,29,54
Coleraine,7934,2,14,11,1,44,23,21,53
Glenavon,7934,3,9,10,7,53,44,9,37
Linfield,7934,4,10,6,10,37,36,1,36
Cliftonville,7934,5,9,5,12,32,31,1,32
Ballymena,7934,6,8,4,14,29,49,-20,28
Glentoran,7934,7,6,6,10,24,32,-8,24
Dungannon,7934,8,2,4,16,14,47,-33,10
Crusaders,7935,1,16,7,3,62,31,31,55
Coleraine,7935,2,14,11,1,45,24,21,53
Glenavon,7935,3,9,10,7,54,45,9,37
Linfield,7935,4,10,6,10,38,37,1,36
Cliftonville,7935,5,9,5,12,33,32,1,32
Ballymena,7935,6,7,5,14,26,48,-22,26
Glentoran,7935,7,6,6,10,24,32,-8,24
Dungannon,7935,8,2,4,16,14,47,-33,10
Crusaders,7936,1,17,6,3,65,30,35,57
Coleraine,7936,2,14,10,2,43,23,20,52
Glenavon,7936,3,10,9,7,53,43,10,39
Linfield,7936,4,10,5,11,37,38,-1,35
Cliftonville,7936,5,10,4,12,34,31,3,34
Ballymena,7936,6,7,4,15,25,51,-26,25
Glentoran,7936,7,6,6,10,24,32,-8,24
Dungannon,7936,8,2,4,16,14,47,-33,10
Crusaders,7937,1,16,6,4,61,32,29,54
Coleraine,7937,2,14,10,2,43,23,20,52
Glenavon,7937,3,10,9,7,53,43,10,39
Linfield,7937,4,10,5,11,37,39,-2,35
Cliftonville,7937,5,10,4,12,35,31,4,34
Ballymena,7937,6,8,4,14,27,47,-20,28
Glentoran,7937,7,6,6,10,24,32,-8,24
Dungannon,7937,8,2,4,16,14,47,-33,10
Crusaders,7938,1,16,7,3,62,31,31,55
Coleraine,7938,2,14,10,2,44,25,19,52
Glenavon,7938,3,10,9,7,55,44,11,39
Linfield,7938,4,10,5,11,37,37,0,35
Cliftonville,7938,5,10,4,12,33,31,2,34
Ballymena,7938,6,7,5,14,26,48,-22,26
Glentoran,7938,7,6,6,10,24,32,-8,24
Dungannon,7938,8,2,4,16,14,47,-33,10
Crusaders,7939,1,17,6,3,64,30,34,57
Coleraine,7939,2,14,10,2,43,26,17,52
Glenavon,7939,3,10,9,7,56,43,13,39
Linfield,7939,4,10,6,10,37,36,1,36
Cliftonville,7939,5,9,5,12,32,31,1,32
Ballymena,7939,6,7,4,15,25,50,-25,25
Glentoran,7939,7,6,6,10,24,32,-8,24
Dungannon,7939,8,2,4,16,14,47,-33,10
Crusaders,7940,1,17,6,3,62,30,32,57
Coleraine,7940,2,14,11,1,43,22,21,53
Linfield,7940,3,11,5,10,39,36,3,38
Glenavon,7940,4,9,10,7,52,43,9,37
Cliftonville,7940,5,9,4,13,32,33,-1,31
Ballymena,7940,6,7,4,15,25,48,-23,25
Glentoran,7940,7,6,6,10,24,32,-8,24
Dungannon,7940,8,2,4,16,14,47,-33,10
Crusaders,7941,1,17,6,3,64,30,34,57
Coleraine,7941,2,15,10,1,46,24,22,55
Linfield,7941,3,11,5,10,38,36,2,38
Glenavon,7941,4,9,9,8,54,46,8,36
Cliftonville,7941,5,9,4,13,32,32,0,31
Ballymena,7941,6,7,4,15,25,50,-25,25
Glentoran,7941,7,6,6,10,24,32,-8,24
Dungannon,7941,8,2,4,16,14,47,-33,10
Crusaders,7942,1,17,6,3,63,30,33,57
Coleraine,7942,2,15,10,1,45,22,23,55
Glenavon,7942,3,9,9,8,52,45,7,36
Linfield,7942,4,10,6,10,37,36,1,36
Cliftonville,7942,5,9,5,12,32,31,1,32
Ballymena,7942,6,7,4,15,25,49,-24,25
Glentoran,7942,7,6,6,10,24,32,-8,24
Dungannon,7942,8,2,4,16,14,47,-33,10
Crusaders,7943,1,17,6,3,63,30,33,57
Coleraine,7943,2,14,11,1,44,23,21,53
Linfield,7943,3,11,5,10,38,36,2,38
Glenavon,7943,4,9,10,7,53,44,9,37
Cliftonville,7943,5,9,4,13,32,32,0,31
Ballymena,7943,6,7,4,15,25,49,-24,25
Glentoran,7943,7,6,6,10,24,32,-8,24
Dungannon,7943,8,2,4,16,14,47,-33,10
Crusaders,7944,1,17,6,3,63,31,32,57
Coleraine,7944,2,14,11,1,44,23,21,53
Glenavon,7944,3,9,10,7,53,44,9,37
Linfield,7944,4,10,5,11,38,38,0,35
Cliftonville,7944,5,10,4,12,34,32,2,34
Ballymena,7944,6,7,4,15,26,49,-23,25
Glentoran,7944,7,6,6,10,24,32,-8,24
Dungannon,7944,8,2,4,16,14,47,-33,10
Coleraine,7945,1,15,10,1,44,22,22,55
Crusaders,7945,2,16,6,4,63,34,29,54
Glenavon,7945,3,9,9,8,52,44,8,36
Linfield,7945,4,10,6,10,38,37,1,36
Cliftonville,7945,5,9,5,12,33,32,1,32
Ballymena,7945,6,8,4,14,29,49,-20,28
Glentoran,7945,7,6,6,10,24,32,-8,24
Dungannon,7945,8,2,4,16,14,47,-33,10
Crusaders,7946,1,17,6,3,63,30,33,57
Coleraine,7946,2,14,11,1,45,24,21,53
Linfield,7946,3,11,5,10,38,36,2,38
Glenavon,7946,4,9,10,7,54,45,9,37
Cliftonville,7946,5,9,4,13,32,32,0,31
Ballymena,7946,6,7,4,15,25,49,-24,25
Glentoran,7946,7,6,6,10,24,32,-8,24
Dungannon,7946,8,2,4,16,14,47,-33,10
Crusaders,7947,1,17,6,3,64,30,34,57
Coleraine,7947,2,15,10,1,45,22,23,55
Glenavon,7947,3,9,9,8,52,45,7,36
Linfield,7947,4,10,6,10,39,38,1,36
Cliftonville,7947,5,9,5,12,34,33,1,32
Ballymena,7947,6,7,4,15,25,50,-25,25
Glentoran,7947,7,6,6,10,24,32,-8,24
Dungannon,7947,8,2,4,16,14,47,-33,10
Crusaders,7948,1,17,6,3,63,30,33,57
Coleraine,7948,2,14,10,2,45,27,18,52
Glenavon,7948,3,10,9,7,57,45,12,39
Linfield,7948,4,11,5,10,40,38,2,38
Cliftonville,7948,5,9,4,13,34,34,0,31
Ballymena,7948,6,7,4,15,25,49,-24,25
Glentoran,7948,7,6,6,10,24,32,-8,24
Dungannon,7948,8,2,4,16,14,47,-33,10
Crusaders,7949,1,16,6,4,62,32,30,54
Coleraine,7949,2,14,11,1,43,22,21,53
Glenavon,7949,3,9,10,7,52,43,9,37
Linfield,7949,4,10,5,11,37,38,-1,35
Cliftonville,7949,5,10,4,12,34,31,3,34
Ballymena,7949,6,8,4,14,27,48,-21,28
Glentoran,7949,7,6,6,10,24,32,-8,24
Dungannon,7949,8,2,4,16,14,47,-33,10
Crusaders,7950,1,17,6,3,65,31,34,57
Coleraine,7950,2,14,10,2,46,27,19,52
Glenavon,7950,3,10,9,7,57,46,11,39
Linfield,7950,4,10,6,10,38,37,1,36
Cliftonville,7950,5,9,5,12,33,32,1,32
Ballymena,7950,6,7,4,15,26,51,-25,25
Glentoran,7950,7,6,6,10,24,32,-8,24
Dungannon,7950,8,2,4,16,14,47,-33,10
Crusaders,7951,1,16,7,3,63,32,31,55
Coleraine,7951,2,15,10,1,46,24,22,55
Glenavon,7951,3,9,9,8,54,46,8,36
Linfield,7951,4,10,6,10,38,37,1,36
Cliftonville,7951,5,9,5,12,33,32,1,32
Ballymena,7951,6,7,5,14,27,49,-22,26
Glentoran,7951,7,6,6,10,24,32,-8,24
Dungannon,7951,8,2,4,16,14,47,-33,10
Crusaders,7952,1,17,6,3,65,30,35,57
Coleraine,7952,2,14,11,1,44,23,21,53
Linfield,7952,3,11,5,10,39,37,2,38
Glenavon,7952,4,9,10,7,53,44,9,37
Cliftonville,7952,5,9,4,13,33,33,0,31
Ballymena,7952,6,7,4,15,25,51,-26,25
Glentoran,7952,7,6,6,10,24,32,-8,24
Dungannon,7952,8,2,4,16,14,47,-33,10
Coleraine,7953,1,15,10,1,47,25,22,55
Crusaders,7953,2,16,6,4,62,33,29,54
Glenavon,7953,3,9,9,8,55,47,8,36
Linfield,7953,4,10,5,11,37,37,0,35
Cliftonville,7953,5,10,4,12,33,31,2,34
Ballymena,7953,6,8,4,14,28,48,-20,28
Glentoran,7953,7,6,6,10,24,32,-8,24
Dungannon,7953,8,2,4,16,14,47,-33,10
Coleraine,7954,1,15,10,1,46,24,22,55
Crusaders,7954,2,16,6,4,61,34,27,54
Glenavon,7954,3,9,9,8,54,46,8,36
Linfield,7954,4,10,6,10,37,36,1,36
Cliftonville,7954,5,9,5,12,32,31,1,32
Ballymena,7954,6,8,4,14,29,47,-18,28
Glentoran,7954,7,6,6,10,24,32,-8,24
Dungannon,7954,8,2,4,16,14,47,-33,10
Crusaders,7955,1,16,6,4,61,32,29,54
Coleraine,7955,2,14,10,2,46,26,20,52
Glenavon,7955,3,10,9,7,56,46,10,39
Linfield,7955,4,10,6,10,37,36,1,36
Cliftonville,7955,5,9,5,12,32,31,1,32
Ballymena,7955,6,8,4,14,27,47,-20,28
Glentoran,7955,7,6,6,10,24,32,-8,24
Dungannon,7955,8,2,4,16,14,47,-33,10
Crusaders,7956,1,17,6,3,67,32,35,57
Coleraine,7956,2,14,11,1,44,23,21,53
Linfield,7956,3,11,5,10,39,37,2,38
Glenavon,7956,4,9,10,7,53,44,9,37
Cliftonville,7956,5,9,4,13,33,33,0,31
Ballymena,7956,6,7,4,15,27,53,-26,25
Glentoran,7956,7,6,6,10,24,32,-8,24
Dungannon,7956,8,2,4,16,14,47,-33,10
Crusaders,7957,1,17,6,3,64,31,33,57
Coleraine,7957,2,14,10,2,44,24,20,52
Glenavon,7957,3,10,9,7,54,44,10,39
Linfield,7957,4,10,5,11,38,38,0,35
Cliftonville,7957,5,10,4,12,34,32,2,34
Ballymena,7957,6,7,4,15,26,50,-24,25
Glentoran,7957,7,6,6,10,24,32,-8,24
Dungannon,7957,8,2,4,16,14,47,-33,10
Crusaders,7958,1,17,6,3,64,32,32,57
Coleraine,7958,2,14,11,1,44,23,21,53
Glenavon,7958,3,9,10,7,53,44,9,37
Linfield,7958,4,10,6,10,38,37,1,36
Cliftonville,7958,5,9,5,12,33,32,1,32
Ballymena,7958,6,7,4,15,27,50,-23,25
Glentoran,7958,7,6,6,10,24,32,-8,24
Dungannon,7958,8,2,4,16,14,47,-33,10
Crusaders,7959,1,17,6,3,66,32,34,57
Coleraine,7959,2,15,10,1,47,23,24,55
Linfield,7959,3,11,5,10,39,37,2,38
Glenavon,7959,4,9,9,8,53,47,6,36
Cliftonville,7959,5,9,4,13,33,33,0,31
Ballymena,7959,6,7,4,15,27,52,-25,25
Glentoran,7959,7,6,6,10,24,32,-8,24
Dungannon,7959,8,2,4,16,14,47,-33,10
Crusaders,7960,1,17,6,3,64,30,34,57
Coleraine,7960,2,15,10,1,47,24,23,55
Glenavon,7960,3,9,9,8,54,47,7,36
Linfield,7960,4,10,5,11,37,37,0,35
Cliftonville,7960,5,10,4,12,33,31,2,34
Ballymena,7960,6,7,4,15,25,50,-25,25
Glentoran,7960,7,6,6,10,24,32,-8,24
Dungannon,7960,8,2,4,16,14,47,-33,10
Crusaders,7961,1,17,6,3,62,30,32,57
Coleraine,7961,2,15,10,1,46,22,24,55
Linfield,7961,3,11,5,10,39,36,3,38
Glenavon,7961,4,9,9,8,52,46,6,36
Cliftonville,7961,5,9,4,13,32,33,-1,31
Ballymena,7961,6,7,4,15,25,48,-23,25
Glentoran,7961,7,6,6,10,24,32,-8,24
Dungannon,7961,8,2,4,16,14,47,-33,10
Crusaders,7962,1,17,6,3,63,31,32,57
Coleraine,7962,2,15,10,1,45,23,22,55
Linfield,7962,3,11,5,10,38,36,2,38
Glenavon,7962,4,9,9,8,53,45,8,36
Cliftonville,7962,5,9,4,13,32,32,0,31
Ballymena,7962,6,7,4,15,26,49,-23,25
Glentoran,7962,7,6,6,10,24,32,-8,24
Dungannon,7962,8,2,4,16,14,47,-33,10
Crusaders,7963,1,17,6,3,64,30,34,57
Coleraine,7963,2,14,11,1,44,23,21,53
Linfield,7963,3,11,5,10,41,38,3,38
Glenavon,7963,4,9,10,7,53,44,9,37
Cliftonville,7963,5,9,4,13,34,35,-1,31
Ballymena,7963,6,7,4,15,25,50,-25,25
Glentoran,7963,7,6,6,10,24,32,-8,24
Dungannon,7963,8,2,4,16,14,47,-33,10
Crusaders,7964,1,16,6,4,62,34,28,54
Coleraine,7964,2,14,11,1,44,23,21,53
Glenavon,7964,3,9,10,7,53,44,9,37
Linfield,7964,4,10,6,10,37,36,1,36
Cliftonville,7964,5,9,5,12,32,31,1,32
Ballymena,7964,6,8,4,14,29,48,-19,28
Glentoran,7964,7,6,6,10,24,32,-8,24
Dungannon,7964,8,2,4,16,14,47,-33,10
Crusaders,7965,1,16,6,4,61,31,30,54
Coleraine,7965,2,14,10,2,43,24,19,52
Glenavon,7965,3,10,9,7,54,43,11,39
Linfield,7965,4,10,5,11,37,37,0,35
Cliftonville,7965,5,10,4,12,33,31,2,34
Ballymena,7965,6,8,4,14,26,47,-21,28
Glentoran,7965,7,6,6,10,24,32,-8,24
Dungannon,7965,8,2,4,16,14,47,-33,10
Crusaders,7966,1,17,6,3,62,30,32,57
Coleraine,7966,2,15,10,1,44,22,22,55
Glenavon,7966,3,9,9,8,52,44,8,36
Linfield,7966,4,10,6,10,38,37,1,36
Cliftonville,7966,5,9,5,12,33,32,1,32
Ballymena,7966,6,7,4,15,25,48,-23,25
Glentoran,7966,7,6,6,10,24,32,-8,24
Dungannon,7966,8,2,4,16,14,47,-33,10
Crusaders,7967,1,16,6,4,61,31,30,54
Coleraine,7967,2,14,11,1,44,23,21,53
Linfield,7967,3,11,5,10,39,37,2,38
Glenavon,7967,4,9,10,7,53,44,9,37
Cliftonville,7967,5,9,4,13,33,33,0,31
Ballymena,7967,6,8,4,14,26,47,-21,28
Glentoran,7967,7,6,6,10,24,32,-8,24
Dungannon,7967,8,2,4,16,14,47,-33,10
Crusaders,7968,1,16,6,4,61,31,30,54
Coleraine,7968,2,14,10,2,45,25,20,52
Glenavon,7968,3,10,9,7,55,45,10,39
Linfield,7968,4,11,5,10,38,36,2,38
Cliftonville,7968,5,9,4,13,32,32,0,31
Ballymena,7968,6,8,4,14,26,47,-21,28
Glentoran,7968,7,6,6,10,24,32,-8,24
Dungannon,7968,8,2,4,16,14,47,-33,10
Crusaders,7969,1,16,6,4,62,32,30,54
Coleraine,7969,2,14,10,2,44,26,18,52
Glenavon,7969,3,10,9,7,56,44,12,39
Linfield,7969,4,10,5,11,38,38,0,35
Cliftonville,7969,5,10,4,12,34,32,2,34
Ballymena,7969,6,8,4,14,27,48,-21,28
Glentoran,7969,7,6,6,10,24,32,-8,24
Dungannon,7969,8,2,4,16,14,47,-33,10
Crusaders,7970,1,17,6,3,63,31,32,57
Coleraine,7970,2,14,10,2,43,25,18,52
Glenavon,7970,3,10,9,7,55,43,12,39
Linfield,7970,4,11,5,10,42,37,5,38
Cliftonville,7970,5,9,4,13,33,36,-3,31
Ballymena,7970,6,7,4,15,26,49,-23,25
Glentoran,7970,7,6,6,10,24,32,-8,24
Dungannon,7970,8,2,4,16,14,47,-33,10
Crusaders,7971,1,17,6,3,65,33,32,57
Coleraine,7971,2,14,10,2,45,25,20,52
Glenavon,7971,3,10,9,7,55,45,10,39
Linfield,7971,4,11,5,10,39,36,3,38
Cliftonville,7971,5,9,4,13,32,33,-1,31
Ballymena,7971,6,7,4,15,28,51,-23,25
Glentoran,7971,7,6,6,10,24,32,-8,24
Dungannon,7971,8,2,4,16,14,47,-33,10
Crusaders,7972,1,17,6,3,65,32,33,57
Coleraine,7972,2,14,10,2,43,23,20,52
Glenavon,7972,3,10,9,7,53,43,10,39
Linfield,7972,4,10,6,10,38,37,1,36
Cliftonville,7972,5,9,5,12,33,32,1,32
Ballymena,7972,6,7,4,15,27,51,-24,25
Glentoran,7972,7,6,6,10,24,32,-8,24
Dungannon,7972,8,2,4,16,14,47,-33,10
Crusaders,7973,1,17,6,3,65,32,33,57
Coleraine,7973,2,14,10,2,44,25,19,52
Glenavon,7973,3,10,9,7,55,44,11,39
Linfield,7973,4,10,5,11,37,38,-1,35
Cliftonville,7973,5,10,4,12,34,31,3,34
Ballymena,7973,6,7,4,15,27,51,-24,25
Glentoran,7973,7,6,6,10,24,32,-8,24
Dungannon,7973,8,2,4,16,14,47,-33,10
Crusaders,7974,1,17,6,3,64,31,33,57
Coleraine,7974,2,14,10,2,45,26,19,52
Glenavon,7974,3,10,9,7,56,45,11,39
Linfield,7974,4,11,5,10,38,36,2,38
Cliftonville,7974,5,9,4,13,32,32,0,31
Ballymena,7974,6,7,4,15,26,50,-24,25
Glentoran,7974,7,6,6,10,24,32,-8,24
Dungannon,7974,8,2,4,16,14,47,-33,10
Crusaders,7975,1,17,6,3,62,30,32,57
Coleraine,7975,2,14,10,2,43,24,19,52
Glenavon,7975,3,10,9,7,54,43,11,39
Linfield,7975,4,10,5,11,37,37,0,35
Cliftonville,7975,5,10,4,12,33,31,2,34
Ballymena,7975,6,7,4,15,25,48,-23,25
Glentoran,7975,7,6,6,10,24,32,-8,24
Dungannon,7975,8,2,4,16,14,47,-33,10
Crusaders,7976,1,16,6,4,61,31,30,54
Coleraine,7976,2,14,11,1,45,24,21,53
Linfield,7976,3,11,5,10,39,37,2,38
Glenavon,7976,4,9,10,7,54,45,9,37
Cliftonville,7976,5,9,4,13,33,33,0,31
Ballymena,7976,6,8,4,14,26,47,-21,28
Glentoran,7976,7,6,6,10,24,32,-8,24
Dungannon,7976,8,2,4,16,14,47,-33,10
Coleraine,7977,1,15,10,1,47,23,24,55
Crusaders,7977,2,16,6,4,62,32,30,54
Glenavon,7977,3,9,9,8,53,47,6,36
Linfield,7977,4,10,5,11,37,38,-1,35
Cliftonville,7977,5,10,4,12,34,31,3,34
Ballymena,7977,6,8,4,14,27,48,-21,28
Glentoran,7977,7,6,6,10,24,32,-8,24
Dungannon,7977,8,2,4,16,14,47,-33,10
Coleraine,7978,1,15,10,1,45,23,22,55
Crusaders,7978,2,16,6,4,62,32,30,54
Linfield,7978,3,11,5,10,38,36,2,38
Glenavon,7978,4,9,9,8,53,45,8,36
Cliftonville,7978,5,9,4,13,32,32,0,31
Ballymena,7978,6,8,4,14,27,48,-21,28
Glentoran,7978,7,6,6,10,24,32,-8,24
Dungannon,7978,8,2,4,16,14,47,-33,10
Crusaders,7979,1,17,6,3,63,30,33,57
Coleraine,7979,2,14,11,1,43,22,21,53
Glenavon,7979,3,9,10,7,52,43,9,37
Linfield,7979,4,10,6,10,37,36,1,36
Cliftonville,7979,5,9,5,12,32,31,1,32
Ballymena,7979,6,7,4,15,25,49,-24,25
Glentoran,7979,7,6,6,10,24,32,-8,24
Dungannon,7979,8,2,4,16,14,47,-33,10
Crusaders,7980,1,17,6,3,64,32,32,57
Coleraine,7980,2,14,11,1,44,23,21,53
Glenavon,7980,3,9,10,7,53,44,9,37
Linfield,7980,4,10,5,11,37,38,-1,35
Cliftonville,7980,5,10,4,12,34,31,3,34
Ballymena,7980,6,7,4,15,27,50,-23,25
Glentoran,7980,7,6,6,10,24,32,-8,24
Dungannon,7980,8,2,4,16,14,47,-33,10
Crusaders,7981,1,17,6,3,64,30,34,57
Coleraine,7981,2,15,10,1,45,22,23,55
Glenavon,7981,3,9,9,8,52,45,7,36
Linfield,7981,4,10,5,11,39,39,0,35
Cliftonville,7981,5,10,4,12,35,33,2,34
Ballymena,7981,6,7,4,15,25,50,-25,25
Glentoran,7981,7,6,6,10,24,32,-8,24
Dungannon,7981,8,2,4,16,14,47,-33,10
Crusaders,7982,1,16,7,3,63,32,31,55
Coleraine,7982,2,15,10,1,45,22,23,55
Linfield,7982,3,11,5,10,39,36,3,38
Glenavon,7982,4,9,9,8,52,45,7,36
Cliftonville,7982,5,9,4,13,32,33,-1,31
Ballymena,7982,6,7,5,14,27,49,-22,26
Glentoran,7982,7,6,6,10,24,32,-8,24
Dungannon,7982,8,2,4,16,14,47,-33,10
Crusaders,7983,1,16,7,3,63,32,31,55
Coleraine,7983,2,14,10,2,45,25,20,52
Glenavon,7983,3,10,9,7,55,45,10,39
Linfield,7983,4,10,5,11,38,38,0,35
Cliftonville,7983,5,10,4,12,34,32,2,34
Ballymena,7983,6,7,5,14,27,49,-22,26
Glentoran,7983,7,6,6,10,24,32,-8,24
Dungannon,7983,8,2,4,16,14,47,-33,10
Crusaders,7984,1,16,6,4,61,32,29,54
Coleraine,7984,2,14,11,1,44,23,21,53
Linfield,7984,3,11,5,10,39,36,3,38
Glenavon,7984,4,9,10,7,53,44,9,37
Cliftonville,7984,5,9,4,13,32,33,-1,31
Ballymena,7984,6,8,4,14,27,47,-20,28
Glentoran,7984,7,6,6,10,24,32,-8,24
Dungannon,7984,8,2,4,16,14,47,-33,10
Crusaders,7985,1,17,6,3,65,31,34,57
Coleraine,7985,2,14,10,2,45,26,19,52
Glenavon,7985,3,10,9,7,56,45,11,39
Linfield,7985,4,10,6,10,37,36,1,36
Cliftonville,7985,5,9,5,12,32,31,1,32
Ballymena,7985,6,7,4,15,26,51,-25,25
Glentoran,7985,7,6,6,10,24,32,-8,24
Dungannon,7985,8,2,4,16,14,47,-33,10
Crusaders,7986,1,17,6,3,64,32,32,57
Coleraine,7986,2,15,10,1,46,24,22,55
Glenavon,7986,3,9,9,8,54,46,8,36
Linfield,7986,4,10,5,11,37,38,-1,35
Cliftonville,7986,5,10,4,12,34,31,3,34
Ballymena,7986,6,7,4,15,27,50,-23,25
Glentoran,7986,7,6,6,10,24,32,-8,24
Dungannon,7986,8,2,4,16,14,47,-33,10
Crusaders,7987,1,17,6,3,63,31,32,57
Coleraine,7987,2,14,10,2,44,24,20,52
Glenavon,7987,3,10,9,7,54,44,10,39
Linfield,7987,4,10,5,11,37,37,0,35
Cliftonville,7987,5,10,4,12,33,31,2,34
Ballymena,7987,6,7,4,15,26,49,-23,25
Glentoran,7987,7,6,6,10,24,32,-8,24
Dungannon,7987,8,2,4,16,14,47,-33,10
Crusaders,7988,1,17,6,3,63,30,33,57
Coleraine,7988,2,14,10,2,45,26,19,52
Glenavon,7988,3,10,9,7,56,45,11,39
Linfield,7988,4,11,5,10,38,36,2,38
Cliftonville,7988,5,9,4,13,32,32,0,31
Ballymena,7988,6,7,4,15,25,49,-24,25
Glentoran,7988,7,6,6,10,24,32,-8,24
Dungannon,7988,8,2,4,16,14,47,-33,10
Crusaders,7989,1,17,6,3,64,32,32,57
Coleraine,7989,2,14,11,1,46,25,21,53
Linfield,7989,3,11,5,10,38,36,2,38
Glenavon,7989,4,9,10,7,55,46,9,37
Cliftonville,7989,5,9,4,13,32,32,0,31
Ballymena,7989,6,7,4,15,27,50,-23,25
Glentoran,7989,7,6,6,10,24,32,-8,24
Dungannon,7989,8,2,4,16,14,47,-33,10
Crusaders,7990,1,17,6,3,63,31,32,57
Coleraine,7990,2,14,10,2,43,23,20,52
Glenavon,7990,3,10,9,7,53,43,10,39
Linfield,7990,4,11,5,10,39,37,2,38
Cliftonville,7990,5,9,4,13,33,33,0,31
Ballymena,7990,6,7,4,15,26,49,-23,25
Glentoran,7990,7,6,6,10,24,32,-8,24
Dungannon,7990,8,2,4,16,14,47,-33,10
Crusaders,7991,1,17,6,3,66,30,36,57
Coleraine,7991,2,14,10,2,44,24,20,52
Glenavon,7991,3,10,9,7,54,44,10,39
Linfield,7991,4,11,5,10,38,36,2,38
Cliftonville,7991,5,9,4,13,32,32,0,31
Ballymena,7991,6,7,4,15,25,52,-27,25
Glentoran,7991,7,6,6,10,24,32,-8,24
Dungannon,7991,8,2,4,16,14,47,-33,10
Crusaders,7992,1,17,6,3,66,30,36,57
Coleraine,7992,2,14,10,2,45,25,20,52
Glenavon,7992,3,10,9,7,55,45,10,39
Linfield,7992,4,10,5,11,37,37,0,35
Cliftonville,7992,5,10,4,12,33,31,2,34
Ballymena,7992,6,7,4,15,25,52,-27,25
Glentoran,7992,7,6,6,10,24,32,-8,24
Dungannon,7992,8,2,4,16,14,47,-33,10
Crusaders,7993,1,17,6,3,64,30,34,57
Coleraine,7993,2,14,10,2,43,23,20,52
Glenavon,7993,3,10,9,7,53,43,10,39
Linfield,7993,4,11,5,10,42,36,6,38
Cliftonville,7993,5,9,4,13,32,36,-4,31
Ballymena,7993,6,7,4,15,25,50,-25,25
Glentoran,7993,7,6,6,10,24,32,-8,24
Dungannon,7993,8,2,4,16,14,47,-33,10
Crusaders,7994,1,17,6,3,64,30,34,57
Coleraine,7994,2,14,11,1,44,23,21,53
Linfield,7994,3,11,5,10,40,36,4,38
Glenavon,7994,4,9,10,7,53,44,9,37
Cliftonville,7994,5,9,4,13,32,34,-2,31
Ballymena,7994,6,7,4,15,25,50,-25,25
Glentoran,7994,7,6,6,10,24,32,-8,24
Dungannon,7994,8,2,4,16,14,47,-33,10
Crusaders,7995,1,16,7,3,64,33,31,55
Coleraine,7995,2,15,10,1,44,22,22,55
Glenavon,7995,3,9,9,8,52,44,8,36
Linfield,7995,4,10,6,10,38,37,1,36
Cliftonville,7995,5,9,5,12,33,32,1,32
Ballymena,7995,6,7,5,14,28,50,-22,26
Glentoran,7995,7,6,6,10,24,32,-8,24
Dungannon,7995,8,2,4,16,14,47,-33,10
Crusaders,7996,1,16,7,3,63,32,31,55
Coleraine,7996,2,15,10,1,46,23,23,55
Glenavon,7996,3,9,9,8,53,46,7,36
Linfield,7996,4,10,5,11,38,38,0,35
Cliftonville,7996,5,10,4,12,34,32,2,34
Ballymena,7996,6,7,5,14,27,49,-22,26
Glentoran,7996,7,6,6,10,24,32,-8,24
Dungannon,7996,8,2,4,16,14,47,-33,10
Crusaders,7997,1,17,6,3,63,31,32,57
Coleraine,7997,2,15,10,1,47,24,23,55
Linfield,7997,3,11,5,10,39,37,2,38
Glenavon,7997,4,9,9,8,54,47,7,36
Cliftonville,7997,5,9,4,13,33,33,0,31
Ballymena,7997,6,7,4,15,26,49,-23,25
Glentoran,7997,7,6,6,10,24,32,-8,24
Dungannon,7997,8,2,4,16,14,47,-33,10
Crusaders,7998,1,16,6,4,63,35,28,54
Coleraine,7998,2,14,10,2,44,24,20,52
Glenavon,7998,3,10,9,7,54,44,10,39
Linfield,7998,4,10,6,10,38,37,1,36
Cliftonville,7998,5,9,5,12,33,32,1,32
Ballymena,7998,6,8,4,14,30,49,-19,28
Glentoran,7998,7,6,6,10,24,32,-8,24
Dungannon,7998,8,2,4,16,14,47,-33,10
Coleraine,7999,1,15,10,1,46,24,22,55
Crusaders,7999,2,16,6,4,61,31,30,54
Linfield,7999,3,11,5,10,39,36,3,38
Glenavon,7999,4,9,9,8,54,46,8,36
Cliftonville,7999,5,9,4,13,32,33,-1,31
Ballymena,7999,6,8,4,14,26,47,-21,28
Glentoran,7999,7,6,6,10,24,32,-8,24
Dungannon,7999,8,2,4,16,14,47,-33,10
Crusaders,8000,1,17,6,3,64,31,33,57
Coleraine,8000,2,14,10,2,44,26,18,52
Glenavon,8000,3,10,9,7,56,44,12,39
Linfield,8000,4,10,6,10,38,37,1,36
Cliftonville,8000,5,9,5,12,33,32,1,32
Ballymena,8000,6,7,4,15,26,50,-24,25
Glentoran,8000,7,6,6,10,24,32,-8,24
Dungannon,8000,8,2,4,16,14,47,-33,10
Crusaders,8001,1,17,6,3,62,30,32,57
Coleraine,8001,2,14,10,2,44,24,20,52
Glenavon,8001,3,10,9,7,54,44,10,39
Linfield,8001,4,10,6,10,38,37,1,36
Cliftonville,8001,5,9,5,12,33,32,1,32
Ballymena,8001,6,7,4,15,25,48,-23,25
Glentoran,8001,7,6,6,10,24,32,-8,24
Dungannon,8001,8,2,4,16,14,47,-33,10
Crusaders,8002,1,17,6,3,63,30,33,57
Coleraine,8002,2,14,10,2,44,24,20,52
Glenavon,8002,3,10,9,7,54,44,10,39
Linfield,8002,4,10,6,10,37,36,1,36
Cliftonville,8002,5,9,5,12,32,31,1,32
Ballymena,8002,6,7,4,15,25,49,-24,25
Glentoran,8002,7,6,6,10,24,32,-8,24
Dungannon,8002,8,2,4,16,14,47,-33,10
Coleraine,8003,1,15,10,1,44,22,22,55
Crusaders,8003,2,16,6,4,62,33,29,54
Linfield,8003,3,11,5,10,38,36,2,38
Glenavon,8003,4,9,9,8,52,44,8,36
Cliftonville,8003,5,9,4,13,32,32,0,31
Ballymena,8003,6,8,4,14,28,48,-20,28
Glentoran,8003,7,6,6,10,24,32,-8,24
Dungannon,8003,8,2,4,16,14,47,-33,10
Crusaders,8004,1,17,6,3,63,30,33,57
Coleraine,8004,2,14,10,2,44,24,20,52
Glenavon,8004,3,10,9,7,54,44,10,39
Linfield,8004,4,11,5,10,38,36,2,38
Cliftonville,8004,5,9,4,13,32,32,0,31
Ballymena,8004,6,7,4,15,25,49,-24,25
Glentoran,8004,7,6,6,10,24,32,-8,24
Dungannon,8004,8,2,4,16,14,47,-33,10
Crusaders,8005,1,17,6,3,63,30,33,57
Coleraine,8005,2,14,10,2,44,24,20,52
Glenavon,8005,3,10,9,7,54,44,10,39
Linfield,8005,4,10,5,11,38,38,0,35
Cliftonville,8005,5,10,4,12,34,32,2,34
Ballymena,8005,6,7,4,15,25,49,-24,25
Glentoran,8005,7,6,6,10,24,32,-8,24
Dungannon,8005,8,2,4,16,14,47,-33,10
Crusaders,8006,1,16,7,3,61,30,31,55
Coleraine,8006,2,15,10,1,46,23,23,55
Glenavon,8006,3,9,9,8,53,46,7,36
Linfield,8006,4,10,5,11,38,38,0,35
Cliftonville,8006,5,10,4,12,34,32,2,34
Ballymena,8006,6,7,5,14,25,47,-22,26
Glentoran,8006,7,6,6,10,24,32,-8,24
Dungannon,8006,8,2,4,16,14,47,-33,10
Crusaders,8007,1,16,7,3,63,32,31,55
Coleraine,8007,2,15,10,1,47,23,24,55
Glenavon,8007,3,9,9,8,53,47,6,36
Linfield,8007,4,10,6,10,38,37,1,36
Cliftonville,8007,5,9,5,12,33,32,1,32
Ballymena,8007,6,7,5,14,27,49,-22,26
Glentoran,8007,7,6,6,10,24,32,-8,24
Dungannon,8007,8,2,4,16,14,47,-33,10
Crusaders,8008,1,17,6,3,62,30,32,57
Coleraine,8008,2,14,10,2,45,25,20,52
Glenavon,8008,3,10,9,7,55,45,10,39
Linfield,8008,4,10,6,10,37,36,1,36
Cliftonville,8008,5,9,5,12,32,31,1,32
Ballymena,8008,6,7,4,15,25,48,-23,25
Glentoran,8008,7,6,6,10,24,32,-8,24
Dungannon,8008,8,2,4,16,14,47,-33,10
Crusaders,8009,1,16,6,4,62,35,27,54
Coleraine,8009,2,14,10,2,44,25,19,52
Glenavon,8009,3,10,9,7,55,44,11,39
Linfield,8009,4,10,5,11,37,37,0,35
Cliftonville,8009,5,10,4,12,33,31,2,34
Ballymena,8009,6,8,4,14,30,48,-18,28
Glentoran,8009,7,6,6,10,24,32,-8,24
Dungannon,8009,8,2,4,16,14,47,-33,10
Coleraine,8010,1,15,10,1,46,24,22,55
Crusaders,8010,2,16,6,4,62,32,30,54
Glenavon,8010,3,9,9,8,54,46,8,36
Linfield,8010,4,10,5,11,37,37,0,35
Cliftonville,8010,5,10,4,12,33,31,2,34
Ballymena,8010,6,8,4,14,27,48,-21,28
Glentoran,8010,7,6,6,10,24,32,-8,24
Dungannon,8010,8,2,4,16,14,47,-33,10
Crusaders,8011,1,17,6,3,63,31,32,57
Coleraine,8011,2,14,10,2,45,25,20,52
Glenavon,8011,3,10,9,7,55,45,10,39
Linfield,8011,4,11,5,10,38,36,2,38
Cliftonville,8011,5,9,4,13,32,32,0,31
Ballymena,8011,6,7,4,15,26,49,-23,25
Glentoran,8011,7,6,6,10,24,32,-8,24
Dungannon,8011,8,2,4,16,14,47,-33,10
Crusaders,8012,1,17,6,3,64,31,33,57
Coleraine,8012,2,14,10,2,45,25,20,52
Glenavon,8012,3,10,9,7,55,45,10,39
Linfield,8012,4,11,5,10,40,37,3,38
Cliftonville,8012,5,9,4,13,33,34,-1,31
Ballymena,8012,6,7,4,15,26,50,-24,25
Glentoran,8012,7,6,6,10,24,32,-8,24
Dungannon,8012,8,2,4,16,14,47,-33,10
Crusaders,8013,1,17,6,3,63,30,33,57
Coleraine,8013,2,14,10,2,44,24,20,52
Glenavon,8013,3,10,9,7,54,44,10,39
Linfield,8013,4,10,6,10,39,38,1,36
Cliftonville,8013,5,9,5,12,34,33,1,32
Ballymena,8013,6,7,4,15,25,49,-24,25
Glentoran,8013,7,6,6,10,24,32,-8,24
Dungannon,8013,8,2,4,16,14,47,-33,10
Crusaders,8014,1,16,7,3,61,30,31,55
Coleraine,8014,2,14,10,2,46,27,19,52
Glenavon,8014,3,10,9,7,57,46,11,39
Linfield,8014,4,11,5,10,39,37,2,38
Cliftonville,8014,5,9,4,13,33,33,0,31
Ballymena,8014,6,7,5,14,25,47,-22,26
Glentoran,8014,7,6,6,10,24,32,-8,24
Dungannon,8014,8,2,4,16,14,47,-33,10
Crusaders,8015,1,17,6,3,64,31,33,57
Coleraine,8015,2,14,10,2,43,25,18,52
Glenavon,8015,3,10,9,7,55,43,12,39
Linfield,8015,4,11,5,10,38,36,2,38
Cliftonville,8015,5,9,4,13,32,32,0,31
Ballymena,8015,6,7,4,15,26,50,-24,25
Glentoran,8015,7,6,6,10,24,32,-8,24
Dungannon,8015,8,2,4,16,14,47,-33,10
Coleraine,8016,1,15,10,1,47,22,25,55
Crusaders,8016,2,16,6,4,61,32,29,54
Glenavon,8016,3,9,9,8,52,47,5,36
Linfield,8016,4,10,5,11,38,38,0,35
Cliftonville,8016,5,10,4,12,34,32,2,34
Ballymena,8016,6,8,4,14,27,47,-20,28
Glentoran,8016,7,6,6,10,24,32,-8,24
Dungannon,8016,8,2,4,16,14,47,-33,10
Crusaders,8017,1,17,6,3,63,30,33,57
Coleraine,8017,2,15,10,1,45,23,22,55
Linfield,8017,3,11,5,10,39,37,2,38
Glenavon,8017,4,9,9,8,53,45,8,36
Cliftonville,8017,5,9,4,13,33,33,0,31
Ballymena,8017,6,7,4,15,25,49,-24,25
Glentoran,8017,7,6,6,10,24,32,-8,24
Dungannon,8017,8,2,4,16,14,47,-33,10
Crusaders,8018,1,16,7,3,63,32,31,55
Coleraine,8018,2,14,11,1,44,23,21,53
Linfield,8018,3,11,5,10,38,36,2,38
Glenavon,8018,4,9,10,7,53,44,9,37
Cliftonville,8018,5,9,4,13,32,32,0,31
Ballymena,8018,6,7,5,14,27,49,-22,26
Glentoran,8018,7,6,6,10,24,32,-8,24
Dungannon,8018,8,2,4,16,14,47,-33,10
Crusaders,8019,1,17,6,3,62,30,32,57
Coleraine,8019,2,14,10,2,44,24,20,52
Glenavon,8019,3,10,9,7,54,44,10,39
Linfield,8019,4,10,6,10,39,38,1,36
Cliftonville,8019,5,9,5,12,34,33,1,32
Ballymena,8019,6,7,4,15,25,48,-23,25
Glentoran,8019,7,6,6,10,24,32,-8,24
Dungannon,8019,8,2,4,16,14,47,-33,10
Crusaders,8020,1,17,6,3,63,31,32,57
Coleraine,8020,2,15,10,1,47,23,24,55
Linfield,8020,3,11,5,10,38,36,2,38
Glenavon,8020,4,9,9,8,53,47,6,36
Cliftonville,8020,5,9,4,13,32,32,0,31
Ballymena,8020,6,7,4,15,26,49,-23,25
Glentoran,8020,7,6,6,10,24,32,-8,24
Dungannon,8020,8,2,4,16,14,47,-33,10
Crusaders,8021,1,16,6,4,61,32,29,54
Coleraine,8021,2,14,11,1,44,23,21,53
Glenavon,8021,3,9,10,7,53,44,9,37
Linfield,8021,4,10,5,11,38,39,-1,35
Cliftonville,8021,5,10,4,12,35,32,3,34
Ballymena,8021,6,8,4,14,27,47,-20,28
Glentoran,8021,7,6,6,10,24,32,-8,24
Dungannon,8021,8,2,4,16,14,47,-33,10
Crusaders,8022,1,16,7,3,63,32,31,55
Coleraine,8022,2,14,10,2,43,23,20,52
Glenavon,8022,3,10,9,7,53,43,10,39
Linfield,8022,4,10,6,10,38,37,1,36
Cliftonville,8022,5,9,5,12,33,32,1,32
Ballymena,8022,6,7,5,14,27,49,-22,26
Glentoran,8022,7,6,6,10,24,32,-8,24
Dungannon,8022,8,2,4,16,14,47,-33,10
Crusaders,8023,1,17,6,3,63,31,32,57
Coleraine,8023,2,14,10,2,43,23,20,52
Glenavon,8023,3,10,9,7,53,43,10,39
Linfield,8023,4,11,5,10,41,38,3,38
Cliftonville,8023,5,9,4,13,34,35,-1,31
Ballymena,8023,6,7,4,15,26,49,-23,25
Glentoran,8023,7,6,6,10,24,32,-8,24
Dungannon,8023,8,2,4,16,14,47,-33,10
Crusaders,8024,1,17,6,3,65,31,34,57
Coleraine,8024,2,14,11,1,43,22,21,53
Glenavon,8024,3,9,10,7,52,43,9,37
Linfield,8024,4,10,5,11,37,37,0,35
Cliftonville,8024,5,10,4,12,33,31,2,34
Ballymena,8024,6,7,4,15,26,51,-25,25
Glentoran,8024,7,6,6,10,24,32,-8,24
Dungannon,8024,8,2,4,16,14,47,-33,10
Crusaders,8025,1,17,6,3,63,30,33,57
Coleraine,8025,2,14,10,2,43,24,19,52
Glenavon,8025,3,10,9,7,54,43,11,39
Linfield,8025,4,10,6,10,37,36,1,36
Cliftonville,8025,5,9,5,12,32,31,1,32
Ballymena,8025,6,7,4,15,25,49,-24,25
Glentoran,8025,7,6,6,10,24,32,-8,24
Dungannon,8025,8,2,4,16,14,47,-33,10
Crusaders,8026,1,17,6,3,62,30,32,57
Coleraine,8026,2,15,10,1,45,23,22,55
Glenavon,8026,3,9,9,8,53,45,8,36
Linfield,8026,4,10,6,10,37,36,1,36
Cliftonville,8026,5,9,5,12,32,31,1,32
Ballymena,8026,6,7,4,15,25,48,-23,25
Glentoran,8026,7,6,6,10,24,32,-8,24
Dungannon,8026,8,2,4,16,14,47,-33,10
Crusaders,8027,1,17,6,3,64,31,33,57
Coleraine,8027,2,14,10,2,43,24,19,52
Glenavon,8027,3,10,9,7,54,43,11,39
Linfield,8027,4,11,5,10,38,36,2,38
Cliftonville,8027,5,9,4,13,32,32,0,31
Ballymena,8027,6,7,4,15,26,50,-24,25
Glentoran,8027,7,6,6,10,24,32,-8,24
Dungannon,8027,8,2,4,16,14,47,-33,10
Crusaders,8028,1,16,6,4,63,33,30,54
Coleraine,8028,2,14,11,1,44,23,21,53
Glenavon,8028,3,9,10,7,53,44,9,37
Linfield,8028,4,10,5,11,37,38,-1,35
Cliftonville,8028,5,10,4,12,34,31,3,34
Ballymena,8028,6,8,4,14,28,49,-21,28
Glentoran,8028,7,6,6,10,24,32,-8,24
Dungannon,8028,8,2,4,16,14,47,-33,10
Crusaders,8029,1,16,7,3,62,31,31,55
Coleraine,8029,2,14,11,1,44,23,21,53
Glenavon,8029,3,9,10,7,53,44,9,37
Linfield,8029,4,10,6,10,38,37,1,36
Cliftonville,8029,5,9,5,12,33,32,1,32
Ballymena,8029,6,7,5,14,26,48,-22,26
Glentoran,8029,7,6,6,10,24,32,-8,24
Dungannon,8029,8,2,4,16,14,47,-33,10
Crusaders,8030,1,16,7,3,62,31,31,55
Coleraine,8030,2,14,11,1,43,22,21,53
Linfield,8030,3,11,5,10,39,36,3,38
Glenavon,8030,4,9,10,7,52,43,9,37
Cliftonville,8030,5,9,4,13,32,33,-1,31
Ballymena,8030,6,7,5,14,26,48,-22,26
Glentoran,8030,7,6,6,10,24,32,-8,24
Dungannon,8030,8,2,4,16,14,47,-33,10
Crusaders,8031,1,16,7,3,61,30,31,55
Coleraine,8031,2,14,11,1,44,23,21,53
Glenavon,8031,3,9,10,7,53,44,9,37
Linfield,8031,4,10,5,11,39,39,0,35
Cliftonville,8031,5,10,4,12,35,33,2,34
Ballymena,8031,6,7,5,14,25,47,-22,26
Glentoran,8031,7,6,6,10,24,32,-8,24
Dungannon,8031,8,2,4,16,14,47,-33,10
Crusaders,8032,1,17,6,3,63,30,33,57
Coleraine,8032,2,14,10,2,44,24,20,52
Glenavon,8032,3,10,9,7,54,44,10,39
Linfield,8032,4,11,5,10,39,36,3,38
Cliftonville,8032,5,9,4,13,32,33,-1,31
Ballymena,8032,6,7,4,15,25,49,-24,25
Glentoran,8032,7,6,6,10,24,32,-8,24
Dungannon,8032,8,2,4,16,14,47,-33,10
Crusaders,8033,1,16,6,4,62,32,30,54
Coleraine,8033,2,14,10,2,46,27,19,52
Glenavon,8033,3,10,9,7,57,46,11,39
Linfield,8033,4,11,5,10,39,36,3,38
Cliftonville,8033,5,9,4,13,32,33,-1,31
Ballymena,8033,6,8,4,14,27,48,-21,28
Glentoran,8033,7,6,6,10,24,32,-8,24
Dungannon,8033,8,2,4,16,14,47,-33,10
Crusaders,8034,1,16,6,4,63,33,30,54
Coleraine,8034,2,14,10,2,43,23,20,52
Glenavon,8034,3,10,9,7,53,43,10,39
Linfield,8034,4,10,6,10,37,36,1,36
Cliftonville,8034,5,9,5,12,32,31,1,32
Ballymena,8034,6,8,4,14,28,49,-21,28
Glentoran,8034,7,6,6,10,24,32,-8,24
Dungannon,8034,8,2,4,16,14,47,-33,10
Crusaders,8035,1,16,7,3,62,31,31,55
Coleraine,8035,2,14,10,2,44,24,20,52
Glenavon,8035,3,10,9,7,54,44,10,39
Linfield,8035,4,10,6,10,38,37,1,36
Cliftonville,8035,5,9,5,12,33,32,1,32
Ballymena,8035,6,7,5,14,26,48,-22,26
Glentoran,8035,7,6,6,10,24,32,-8,24
Dungannon,8035,8,2,4,16,14,47,-33,10
Crusaders,8036,1,17,6,3,65,31,34,57
Coleraine,8036,2,14,10,2,44,25,19,52
Glenavon,8036,3,10,9,7,55,44,11,39
Linfield,8036,4,11,5,10,38,36,2,38
Cliftonville,8036,5,9,4,13,32,32,0,31
Ballymena,8036,6,7,4,15,26,51,-25,25
Glentoran,8036,7,6,6,10,24,32,-8,24
Dungannon,8036,8,2,4,16,14,47,-33,10
Crusaders,8037,1,17,6,3,64,32,32,57
Coleraine,8037,2,14,11,1,45,24,21,53
Glenavon,8037,3,9,10,7,54,45,9,37
Linfield,8037,4,10,5,11,37,37,0,35
Cliftonville,8037,5,10,4,12,33,31,2,34
Ballymena,8037,6,7,4,15,27,50,-23,25
Glentoran,8037,7,6,6,10,24,32,-8,24
Dungannon,8037,8,2,4,16,14,47,-33,10
Crusaders,8038,1,16,7,3,62,31,31,55
Coleraine,8038,2,14,10,2,44,25,19,52
Glenavon,8038,3,10,9,7,55,44,11,39
Linfield,8038,4,11,5,10,39,37,2,38
Cliftonville,8038,5,9,4,13,33,33,0,31
Ballymena,8038,6,7,5,14,26,48,-22,26
Glentoran,8038,7,6,6,10,24,32,-8,24
Dungannon,8038,8,2,4,16,14,47,-33,10
Crusaders,8039,1,16,7,3,61,30,31,55
Coleraine,8039,2,15,10,1,44,22,22,55
Glenavon,8039,3,9,9,8,52,44,8,36
Linfield,8039,4,10,6,10,37,36,1,36
Cliftonville,8039,5,9,5,12,32,31,1,32
Ballymena,8039,6,7,5,14,25,47,-22,26
Glentoran,8039,7,6,6,10,24,32,-8,24
Dungannon,8039,8,2,4,16,14,47,-33,10
Crusaders,8040,1,16,7,3,62,31,31,55
Coleraine,8040,2,15,10,1,46,24,22,55
Glenavon,8040,3,9,9,8,54,46,8,36
Linfield,8040,4,10,6,10,37,36,1,36
Cliftonville,8040,5,9,5,12,32,31,1,32
Ballymena,8040,6,7,5,14,26,48,-22,26
Glentoran,8040,7,6,6,10,24,32,-8,24
Dungannon,8040,8,2,4,16,14,47,-33,10
Crusaders,8041,1,16,7,3,62,31,31,55
Coleraine,8041,2,14,10,2,44,24,20,52
Glenavon,8041,3,10,9,7,54,44,10,39
Linfield,8041,4,10,6,10,39,38,1,36
Cliftonville,8041,5,9,5,12,34,33,1,32
Ballymena,8041,6,7,5,14,26,48,-22,26
Glentoran,8041,7,6,6,10,24,32,-8,24
Dungannon,8041,8,2,4,16,14,47,-33,10
Crusaders,8042,1,16,6,4,63,33,30,54
Coleraine,8042,2,14,10,2,43,23,20,52
Glenavon,8042,3,10,9,7,53,43,10,39
Linfield,8042,4,10,5,11,38,38,0,35
Cliftonville,8042,5,10,4,12,34,32,2,34
Ballymena,8042,6,8,4,14,28,49,-21,28
Glentoran,8042,7,6,6,10,24,32,-8,24
Dungannon,8042,8,2,4,16,14,47,-33,10
Crusaders,8043,1,17,6,3,62,30,32,57
Coleraine,8043,2,14,10,2,43,23,20,52
Glenavon,8043,3,10,9,7,53,43,10,39
Linfield,8043,4,11,5,10,41,39,2,38
Cliftonville,8043,5,9,4,13,35,35,0,31
Ballymena,8043,6,7,4,15,25,48,-23,25
Glentoran,8043,7,6,6,10,24,32,-8,24
Dungannon,8043,8,2,4,16,14,47,-33,10
Crusaders,8044,1,16,6,4,62,33,29,54
Coleraine,8044,2,14,10,2,44,25,19,52
Glenavon,8044,3,10,9,7,55,44,11,39
Linfield,8044,4,11,5,10,41,36,5,38
Cliftonville,8044,5,9,4,13,32,35,-3,31
Ballymena,8044,6,8,4,14,28,48,-20,28
Glentoran,8044,7,6,6,10,24,32,-8,24
Dungannon,8044,8,2,4,16,14,47,-33,10
Crusaders,8045,1,16,6,4,63,33,30,54
Coleraine,8045,2,14,10,2,45,25,20,52
Glenavon,8045,3,10,9,7,55,45,10,39
Linfield,8045,4,10,5,11,38,38,0,35
Cliftonville,8045,5,10,4,12,34,32,2,34
Ballymena,8045,6,8,4,14,28,49,-21,28
Glentoran,8045,7,6,6,10,24,32,-8,24
Dungannon,8045,8,2,4,16,14,47,-33,10
Coleraine,8046,1,15,10,1,45,22,23,55
Crusaders,8046,2,16,6,4,61,31,30,54
Glenavon,8046,3,9,9,8,52,45,7,36
Linfield,8046,4,10,6,10,37,36,1,36
Cliftonville,8046,5,9,5,12,32,31,1,32
Ballymena,8046,6,8,4,14,26,47,-21,28
Glentoran,8046,7,6,6,10,24,32,-8,24
Dungannon,8046,8,2,4,16,14,47,-33,10
Crusaders,8047,1,17,6,3,66,34,32,57
Coleraine,8047,2,14,11,1,44,23,21,53
Linfield,8047,3,11,5,10,38,36,2,38
Glenavon,8047,4,9,10,7,53,44,9,37
Cliftonville,8047,5,9,4,13,32,32,0,31
Ballymena,8047,6,7,4,15,29,52,-23,25
Glentoran,8047,7,6,6,10,24,32,-8,24
Dungannon,8047,8,2,4,16,14,47,-33,10
Crusaders,8048,1,16,6,4,62,33,29,54
Coleraine,8048,2,14,10,2,45,25,20,52
Glenavon,8048,3,10,9,7,55,45,10,39
Linfield,8048,4,10,5,11,37,38,-1,35
Cliftonville,8048,5,10,4,12,34,31,3,34
Ballymena,8048,6,8,4,14,28,48,-20,28
Glentoran,8048,7,6,6,10,24,32,-8,24
Dungannon,8048,8,2,4,16,14,47,-33,10
Crusaders,8049,1,17,6,3,65,33,32,57
Coleraine,8049,2,14,10,2,43,28,15,52
Glenavon,8049,3,10,9,7,58,43,15,39
Linfield,8049,4,10,5,11,37,39,-2,35
Cliftonville,8049,5,10,4,12,35,31,4,34
Ballymena,8049,6,7,4,15,28,51,-23,25
Glentoran,8049,7,6,6,10,24,32,-8,24
Dungannon,8049,8,2,4,16,14,47,-33,10
Crusaders,8050,1,16,6,4,61,31,30,54
Coleraine,8050,2,14,11,1,46,25,21,53
Glenavon,8050,3,9,10,7,55,46,9,37
Linfield,8050,4,10,6,10,38,37,1,36
Cliftonville,8050,5,9,5,12,33,32,1,32
Ballymena,8050,6,8,4,14,26,47,-21,28
Glentoran,8050,7,6,6,10,24,32,-8,24
Dungannon,8050,8,2,4,16,14,47,-33,10
Crusaders,8051,1,17,6,3,65,31,34,57
Coleraine,8051,2,14,10,2,43,23,20,52
Glenavon,8051,3,10,9,7,53,43,10,39
Linfield,8051,4,11,5,10,40,36,4,38
Cliftonville,8051,5,9,4,13,32,34,-2,31
Ballymena,8051,6,7,4,15,26,51,-25,25
Glentoran,8051,7,6,6,10,24,32,-8,24
Dungannon,8051,8,2,4,16,14,47,-33,10
Crusaders,8052,1,17,6,3,64,30,34,57
Coleraine,8052,2,15,10,1,45,23,22,55
Linfield,8052,3,11,5,10,38,36,2,38
Glenavon,8052,4,9,9,8,53,45,8,36
Cliftonville,8052,5,9,4,13,32,32,0,31
Ballymena,8052,6,7,4,15,25,50,-25,25
Glentoran,8052,7,6,6,10,24,32,-8,24
Dungannon,8052,8,2,4,16,14,47,-33,10
Crusaders,8053,1,17,6,3,63,31,32,57
Coleraine,8053,2,14,10,2,44,24,20,52
Glenavon,8053,3,10,9,7,54,44,10,39
Linfield,8053,4,11,5,10,40,37,3,38
Cliftonville,8053,5,9,4,13,33,34,-1,31
Ballymena,8053,6,7,4,15,26,49,-23,25
Glentoran,8053,7,6,6,10,24,32,-8,24
Dungannon,8053,8,2,4,16,14,47,-33,10
Crusaders,8054,1,17,6,3,64,32,32,57
Coleraine,8054,2,14,11,1,45,24,21,53
Linfield,8054,3,11,5,10,39,36,3,38
Glenavon,8054,4,9,10,7,54,45,9,37
Cliftonville,8054,5,9,4,13,32,33,-1,31
Ballymena,8054,6,7,4,15,27,50,-23,25
Glentoran,8054,7,6,6,10,24,32,-8,24
Dungannon,8054,8,2,4,16,14,47,-33,10
Crusaders,8055,1,16,6,4,62,32,30,54
Coleraine,8055,2,14,11,1,46,25,21,53
Glenavon,8055,3,9,10,7,55,46,9,37
Linfield,8055,4,10,6,10,39,38,1,36
Cliftonville,8055,5,9,5,12,34,33,1,32
Ballymena,8055,6,8,4,14,27,48,-21,28
Glentoran,8055,7,6,6,10,24,32,-8,24
Dungannon,8055,8,2,4,16,14,47,-33,10
Crusaders,8056,1,16,6,4,63,34,29,54
Coleraine,8056,2,14,10,2,43,26,17,52
Glenavon,8056,3,10,9,7,56,43,13,39
Linfield,8056,4,10,5,11,37,37,0,35
Cliftonville,8056,5,10,4,12,33,31,2,34
Ballymena,8056,6,8,4,14,29,49,-20,28
Glentoran,8056,7,6,6,10,24,32,-8,24
Dungannon,8056,8,2,4,16,14,47,-33,10
Crusaders,8057,1,16,6,4,64,34,30,54
Coleraine,8057,2,14,11,1,43,22,21,53
Linfield,8057,3,11,5,10,39,36,3,38
Glenavon,8057,4,9,10,7,52,43,9,37
Cliftonville,8057,5,9,4,13,32,33,-1,31
Ballymena,8057,6,8,4,14,29,50,-21,28
Glentoran,8057,7,6,6,10,24,32,-8,24
Dungannon,8057,8,2,4,16,14,47,-33,10
Crusaders,8058,1,16,6,4,61,32,29,54
Coleraine,8058,2,14,11,1,44,23,21,53
Glenavon,8058,3,9,10,7,53,44,9,37
Linfield,8058,4,10,6,10,39,38,1,36
Cliftonville,8058,5,9,5,12,34,33,1,32
Ballymena,8058,6,8,4,14,27,47,-20,28
Glentoran,8058,7,6,6,10,24,32,-8,24
Dungannon,8058,8,2,4,16,14,47,-33,10
Crusaders,8059,1,16,6,4,62,32,30,54
Coleraine,8059,2,14,10,2,44,25,19,52
Glenavon,8059,3,10,9,7,55,44,11,39
Linfield,8059,4,11,5,10,40,37,3,38
Cliftonville,8059,5,9,4,13,33,34,-1,31
Ballymena,8059,6,8,4,14,27,48,-21,28
Glentoran,8059,7,6,6,10,24,32,-8,24
Dungannon,8059,8,2,4,16,14,47,-33,10
Crusaders,8060,1,17,6,3,65,32,33,57
Coleraine,8060,2,14,11,1,44,23,21,53
Linfield,8060,3,11,5,10,39,37,2,38
Glenavon,8060,4,9,10,7,53,44,9,37
Cliftonville,8060,5,9,4,13,33,33,0,31
Ballymena,8060,6,7,4,15,27,51,-24,25
Glentoran,8060,7,6,6,10,24,32,-8,24
Dungannon,8060,8,2,4,16,14,47,-33,10
Coleraine,8061,1,15,10,1,46,24,22,55
Crusaders,8061,2,16,6,4,62,33,29,54
Glenavon,8061,3,9,9,8,54,46,8,36
Linfield,8061,4,10,6,10,38,37,1,36
Cliftonville,8061,5,9,5,12,33,32,1,32
Ballymena,8061,6,8,4,14,28,48,-20,28
Glentoran,8061,7,6,6,10,24,32,-8,24
Dungannon,8061,8,2,4,16,14,47,-33,10
Crusaders,8062,1,16,6,4,62,32,30,54
Coleraine,8062,2,14,11,1,43,22,21,53
Glenavon,8062,3,9,10,7,52,43,9,37
Linfield,8062,4,10,6,10,37,36,1,36
Cliftonville,8062,5,9,5,12,32,31,1,32
Ballymena,8062,6,8,4,14,27,48,-21,28
Glentoran,8062,7,6,6,10,24,32,-8,24
Dungannon,8062,8,2,4,16,14,47,-33,10
Crusaders,8063,1,16,6,4,61,32,29,54
Coleraine,8063,2,14,10,2,45,25,20,52
Glenavon,8063,3,10,9,7,55,45,10,39
Linfield,8063,4,11,5,10,38,36,2,38
Cliftonville,8063,5,9,4,13,32,32,0,31
Ballymena,8063,6,8,4,14,27,47,-20,28
Glentoran,8063,7,6,6,10,24,32,-8,24
Dungannon,8063,8,2,4,16,14,47,-33,10
Crusaders,8064,1,16,6,4,62,32,30,54
Coleraine,8064,2,14,10,2,45,25,20,52
Glenavon,8064,3,10,9,7,55,45,10,39
Linfield,8064,4,11,5,10,38,36,2,38
Cliftonville,8064,5,9,4,13,32,32,0,31
Ballymena,8064,6,8,4,14,27,48,-21,28
Glentoran,8064,7,6,6,10,24,32,-8,24
Dungannon,8064,8,2,4,16,14,47,-33,10
Crusaders,8065,1,16,6,4,61,32,29,54
Coleraine,8065,2,14,10,2,46,26,20,52
Glenavon,8065,3,10,9,7,56,46,10,39
Linfield,8065,4,11,5,10,41,39,2,38
Cliftonville,8065,5,9,4,13,35,35,0,31
Ballymena,8065,6,8,4,14,27,47,-20,28
Glentoran,8065,7,6,6,10,24,32,-8,24
Dungannon,8065,8,2,4,16,14,47,-33,10
Coleraine,8066,1,15,10,1,44,22,22,55
Crusaders,8066,2,16,6,4,63,33,30,54
Glenavon,8066,3,9,9,8,52,44,8,36
Linfield,8066,4,10,6,10,38,37,1,36
Cliftonville,8066,5,9,5,12,33,32,1,32
Ballymena,8066,6,8,4,14,28,49,-21,28
Glentoran,8066,7,6,6,10,24,32,-8,24
Dungannon,8066,8,2,4,16,14,47,-33,10
Crusaders,8067,1,17,6,3,63,30,33,57
Coleraine,8067,2,14,10,2,45,25,20,52
Glenavon,8067,3,10,9,7,55,45,10,39
Linfield,8067,4,11,5,10,41,37,4,38
Cliftonville,8067,5,9,4,13,33,35,-2,31
Ballymena,8067,6,7,4,15,25,49,-24,25
Glentoran,8067,7,6,6,10,24,32,-8,24
Dungannon,8067,8,2,4,16,14,47,-33,10
Crusaders,8068,1,17,6,3,65,32,33,57
Coleraine,8068,2,14,11,1,44,23,21,53
Linfield,8068,3,11,5,10,39,37,2,38
Glenavon,8068,4,9,10,7,53,44,9,37
Cliftonville,8068,5,9,4,13,33,33,0,31
Ballymena,8068,6,7,4,15,27,51,-24,25
Glentoran,8068,7,6,6,10,24,32,-8,24
Dungannon,8068,8,2,4,16,14,47,-33,10
Crusaders,8069,1,17,6,3,65,31,34,57
Coleraine,8069,2,15,10,1,46,22,24,55
Linfield,8069,3,11,5,10,39,36,3,38
Glenavon,8069,4,9,9,8,52,46,6,36
Cliftonville,8069,5,9,4,13,32,33,-1,31
Ballymena,8069,6,7,4,15,26,51,-25,25
Glentoran,8069,7,6,6,10,24,32,-8,24
Dungannon,8069,8,2,4,16,14,47,-33,10
Crusaders,8070,1,16,7,3,62,31,31,55
Coleraine,8070,2,14,10,2,43,26,17,52
Glenavon,8070,3,10,9,7,56,43,13,39
Linfield,8070,4,11,5,10,40,36,4,38
Cliftonville,8070,5,9,4,13,32,34,-2,31
Ballymena,8070,6,7,5,14,26,48,-22,26
Glentoran,8070,7,6,6,10,24,32,-8,24
Dungannon,8070,8,2,4,16,14,47,-33,10
Crusaders,8071,1,17,6,3,65,31,34,57
Coleraine,8071,2,14,10,2,44,24,20,52
Glenavon,8071,3,10,9,7,54,44,10,39
Linfield,8071,4,10,5,11,37,37,0,35
Cliftonville,8071,5,10,4,12,33,31,2,34
Ballymena,8071,6,7,4,15,26,51,-25,25
Glentoran,8071,7,6,6,10,24,32,-8,24
Dungannon,8071,8,2,4,16,14,47,-33,10
Coleraine,8072,1,15,10,1,46,23,23,55
Crusaders,8072,2,16,6,4,62,33,29,54
Linfield,8072,3,11,5,10,40,36,4,38
Glenavon,8072,4,9,9,8,53,46,7,36
Cliftonville,8072,5,9,4,13,32,34,-2,31
Ballymena,8072,6,8,4,14,28,48,-20,28
Glentoran,8072,7,6,6,10,24,32,-8,24
Dungannon,8072,8,2,4,16,14,47,-33,10
Crusaders,8073,1,16,7,3,62,31,31,55
Coleraine,8073,2,14,11,1,44,23,21,53
Glenavon,8073,3,9,10,7,53,44,9,37
Linfield,8073,4,10,5,11,37,37,0,35
Cliftonville,8073,5,10,4,12,33,31,2,34
Ballymena,8073,6,7,5,14,26,48,-22,26
Glentoran,8073,7,6,6,10,24,32,-8,24
Dungannon,8073,8,2,4,16,14,47,-33,10
Crusaders,8074,1,17,6,3,63,31,32,57
Coleraine,8074,2,14,10,2,43,23,20,52
Glenavon,8074,3,10,9,7,53,43,10,39
Linfield,8074,4,11,5,10,38,36,2,38
Cliftonville,8074,5,9,4,13,32,32,0,31
Ballymena,8074,6,7,4,15,26,49,-23,25
Glentoran,8074,7,6,6,10,24,32,-8,24
Dungannon,8074,8,2,4,16,14,47,-33,10
Crusaders,8075,1,16,7,3,63,32,31,55
Coleraine,8075,2,15,10,1,45,22,23,55
Glenavon,8075,3,9,9,8,52,45,7,36
Linfield,8075,4,10,6,10,38,37,1,36
Cliftonville,8075,5,9,5,12,33,32,1,32
Ballymena,8075,6,7,5,14,27,49,-22,26
Glentoran,8075,7,6,6,10,24,32,-8,24
Dungannon,8075,8,2,4,16,14,47,-33,10
Coleraine,8076,1,15,10,1,47,24,23,55
Crusaders,8076,2,16,6,4,61,33,28,54
Linfield,8076,3,11,5,10,39,37,2,38
Glenavon,8076,4,9,9,8,54,47,7,36
Cliftonville,8076,5,9,4,13,33,33,0,31
Ballymena,8076,6,8,4,14,28,47,-19,28
Glentoran,8076,7,6,6,10,24,32,-8,24
Dungannon,8076,8,2,4,16,14,47,-33,10
Crusaders,8077,1,17,6,3,63,30,33,57
Coleraine,8077,2,15,10,1,45,23,22,55
Linfield,8077,3,11,5,10,38,36,2,38
Glenavon,8077,4,9,9,8,53,45,8,36
Cliftonville,8077,5,9,4,13,32,32,0,31
Ballymena,8077,6,7,4,15,25,49,-24,25
Glentoran,8077,7,6,6,10,24,32,-8,24
Dungannon,8077,8,2,4,16,14,47,-33,10
Crusaders,8078,1,17,6,3,65,31,34,57
Coleraine,8078,2,15,10,1,48,22,26,55
Linfield,8078,3,11,5,10,38,36,2,38
Glenavon,8078,4,9,9,8,52,48,4,36
Cliftonville,8078,5,9,4,13,32,32,0,31
Ballymena,8078,6,7,4,15,26,51,-25,25
Glentoran,8078,7,6,6,10,24,32,-8,24
Dungannon,8078,8,2,4,16,14,47,-33,10
Crusaders,8079,1,17,6,3,64,30,34,57
Coleraine,8079,2,14,10,2,43,25,18,52
Glenavon,8079,3,10,9,7,55,43,12,39
Linfield,8079,4,11,5,10,39,36,3,38
Cliftonville,8079,5,9,4,13,32,33,-1,31
Ballymena,8079,6,7,4,15,25,50,-25,25
Glentoran,8079,7,6,6,10,24,32,-8,24
Dungannon,8079,8,2,4,16,14,47,-33,10
Crusaders,8080,1,17,6,3,64,32,32,57
Coleraine,8080,2,14,11,1,45,24,21,53
Glenavon,8080,3,9,10,7,54,45,9,37
Linfield,8080,4,10,5,11,37,37,0,35
Cliftonville,8080,5,10,4,12,33,31,2,34
Ballymena,8080,6,7,4,15,27,50,-23,25
Glentoran,8080,7,6,6,10,24,32,-8,24
Dungannon,8080,8,2,4,16,14,47,-33,10
Crusaders,8081,1,17,6,3,65,30,35,57
Coleraine,8081,2,15,10,1,46,22,24,55
Glenavon,8081,3,9,9,8,52,46,6,36
Linfield,8081,4,10,5,11,38,39,-1,35
Cliftonville,8081,5,10,4,12,35,32,3,34
Ballymena,8081,6,7,4,15,25,51,-26,25
Glentoran,8081,7,6,6,10,24,32,-8,24
Dungannon,8081,8,2,4,16,14,47,-33,10
Crusaders,8082,1,16,6,4,61,31,30,54
Coleraine,8082,2,14,10,2,43,24,19,52
Glenavon,8082,3,10,9,7,54,43,11,39
Linfield,8082,4,11,5,10,40,36,4,38
Cliftonville,8082,5,9,4,13,32,34,-2,31
Ballymena,8082,6,8,4,14,26,47,-21,28
Glentoran,8082,7,6,6,10,24,32,-8,24
Dungannon,8082,8,2,4,16,14,47,-33,10
Crusaders,8083,1,16,7,3,61,30,31,55
Coleraine,8083,2,14,11,1,45,24,21,53
Linfield,8083,3,11,5,10,39,36,3,38
Glenavon,8083,4,9,10,7,54,45,9,37
Cliftonville,8083,5,9,4,13,32,33,-1,31
Ballymena,8083,6,7,5,14,25,47,-22,26
Glentoran,8083,7,6,6,10,24,32,-8,24
Dungannon,8083,8,2,4,16,14,47,-33,10
Coleraine,8084,1,15,10,1,44,22,22,55
Crusaders,8084,2,16,6,4,62,32,30,54
Linfield,8084,3,11,5,10,38,36,2,38
Glenavon,8084,4,9,9,8,52,44,8,36
Cliftonville,8084,5,9,4,13,32,32,0,31
Ballymena,8084,6,8,4,14,27,48,-21,28
Glentoran,8084,7,6,6,10,24,32,-8,24
Dungannon,8084,8,2,4,16,14,47,-33,10
Crusaders,8085,1,17,6,3,64,32,32,57
Coleraine,8085,2,14,10,2,44,25,19,52
Glenavon,8085,3,10,9,7,55,44,11,39
Linfield,8085,4,10,6,10,37,36,1,36
Cliftonville,8085,5,9,5,12,32,31,1,32
Ballymena,8085,6,7,4,15,27,50,-23,25
Glentoran,8085,7,6,6,10,24,32,-8,24
Dungannon,8085,8,2,4,16,14,47,-33,10
Crusaders,8086,1,17,6,3,65,33,32,57
Coleraine,8086,2,14,10,2,44,24,20,52
Glenavon,8086,3,10,9,7,54,44,10,39
Linfield,8086,4,11,5,10,39,37,2,38
Cliftonville,8086,5,9,4,13,33,33,0,31
Ballymena,8086,6,7,4,15,28,51,-23,25
Glentoran,8086,7,6,6,10,24,32,-8,24
Dungannon,8086,8,2,4,16,14,47,-33,10
Crusaders,8087,1,16,7,3,64,33,31,55
Coleraine,8087,2,14,11,1,43,22,21,53
Glenavon,8087,3,9,10,7,52,43,9,37
Linfield,8087,4,10,6,10,39,38,1,36
Cliftonville,8087,5,9,5,12,34,33,1,32
Ballymena,8087,6,7,5,14,28,50,-22,26
Glentoran,8087,7,6,6,10,24,32,-8,24
Dungannon,8087,8,2,4,16,14,47,-33,10
Crusaders,8088,1,17,6,3,63,30,33,57
Coleraine,8088,2,14,11,1,44,23,21,53
Linfield,8088,3,11,5,10,39,37,2,38
Glenavon,8088,4,9,10,7,53,44,9,37
Cliftonville,8088,5,9,4,13,33,33,0,31
Ballymena,8088,6,7,4,15,25,49,-24,25
Glentoran,8088,7,6,6,10,24,32,-8,24
Dungannon,8088,8,2,4,16,14,47,-33,10
Crusaders,8089,1,17,6,3,66,32,34,57
Coleraine,8089,2,14,11,1,45,24,21,53
Linfield,8089,3,11,5,10,38,36,2,38
Glenavon,8089,4,9,10,7,54,45,9,37
Cliftonville,8089,5,9,4,13,32,32,0,31
Ballymena,8089,6,7,4,15,27,52,-25,25
Glentoran,8089,7,6,6,10,24,32,-8,24
Dungannon,8089,8,2,4,16,14,47,-33,10
Crusaders,8090,1,16,7,3,61,30,31,55
Coleraine,8090,2,15,10,1,46,22,24,55
Glenavon,8090,3,9,9,8,52,46,6,36
Linfield,8090,4,10,6,10,38,37,1,36
Cliftonville,8090,5,9,5,12,33,32,1,32
Ballymena,8090,6,7,5,14,25,47,-22,26
Glentoran,8090,7,6,6,10,24,32,-8,24
Dungannon,8090,8,2,4,16,14,47,-33,10
Crusaders,8091,1,17,6,3,65,31,34,57
Coleraine,8091,2,14,10,2,44,24,20,52
Glenavon,8091,3,10,9,7,54,44,10,39
Linfield,8091,4,10,5,11,37,37,0,35
Cliftonville,8091,5,10,4,12,33,31,2,34
Ballymena,8091,6,7,4,15,26,51,-25,25
Glentoran,8091,7,6,6,10,24,32,-8,24
Dungannon,8091,8,2,4,16,14,47,-33,10
Crusaders,8092,1,17,6,3,63,31,32,57
Coleraine,8092,2,14,10,2,44,24,20,52
Glenavon,8092,3,10,9,7,54,44,10,39
Linfield,8092,4,11,5,10,38,36,2,38
Cliftonville,8092,5,9,4,13,32,32,0,31
Ballymena,8092,6,7,4,15,26,49,-23,25
Glentoran,8092,7,6,6,10,24,32,-8,24
Dungannon,8092,8,2,4,16,14,47,-33,10
Crusaders,8093,1,16,6,4,61,32,29,54
Coleraine,8093,2,14,10,2,43,23,20,52
Glenavon,8093,3,10,9,7,53,43,10,39
Linfield,8093,4,10,6,10,38,37,1,36
Cliftonville,8093,5,9,5,12,33,32,1,32
Ballymena,8093,6,8,4,14,27,47,-20,28
Glentoran,8093,7,6,6,10,24,32,-8,24
Dungannon,8093,8,2,4,16,14,47,-33,10
Crusaders,8094,1,17,6,3,63,30,33,57
Coleraine,8094,2,14,10,2,44,24,20,52
Glenavon,8094,3,10,9,7,54,44,10,39
Linfield,8094,4,11,5,10,40,37,3,38
Cliftonville,8094,5,9,4,13,33,34,-1,31
Ballymena,8094,6,7,4,15,25,49,-24,25
Glentoran,8094,7,6,6,10,24,32,-8,24
Dungannon,8094,8,2,4,16,14,47,-33,10
Crusaders,8095,1,17,6,3,63,30,33,57
Coleraine,8095,2,15,10,1,45,22,23,55
Linfield,8095,3,11,5,10,38,36,2,38
Glenavon,8095,4,9,9,8,52,45,7,36
Cliftonville,8095,5,9,4,13,32,32,0,31
Ballymena,8095,6,7,4,15,25,49,-24,25
Glentoran,8095,7,6,6,10,24,32,-8,24
Dungannon,8095,8,2,4,16,14,47,-33,10
Crusaders,8096,1,16,7,3,63,32,31,55
Coleraine,8096,2,15,10,1,46,24,22,55
Glenavon,8096,3,9,9,8,54,46,8,36
Linfield,8096,4,10,5,11,37,37,0,35
Cliftonville,8096,5,10,4,12,33,31,2,34
Ballymena,8096,6,7,5,14,27,49,-22,26
Glentoran,8096,7,6,6,10,24,32,-8,24
Dungannon,8096,8,2,4,16,14,47,-33,10
Crusaders,8097,1,16,7,3,65,34,31,55
Coleraine,8097,2,14,10,2,43,25,18,52
Glenavon,8097,3,10,9,7,55,43,12,39
Linfield,8097,4,10,6,10,37,36,1,36
Cliftonville,8097,5,9,5,12,32,31,1,32
Ballymena,8097,6,7,5,14,29,51,-22,26
Glentoran,8097,7,6,6,10,24,32,-8,24
Dungannon,8097,8,2,4,16,14,47,-33,10
Crusaders,8098,1,17,6,3,64,32,32,57
Coleraine,8098,2,15,10,1,45,22,23,55
Glenavon,8098,3,9,9,8,52,45,7,36
Linfield,8098,4,10,5,11,39,39,0,35
Cliftonville,8098,5,10,4,12,35,33,2,34
Ballymena,8098,6,7,4,15,27,50,-23,25
Glentoran,8098,7,6,6,10,24,32,-8,24
Dungannon,8098,8,2,4,16,14,47,-33,10
Crusaders,8099,1,17,6,3,67,30,37,57
Coleraine,8099,2,14,10,2,44,24,20,52
Glenavon,8099,3,10,9,7,54,44,10,39
Linfield,8099,4,10,6,10,39,38,1,36
Cliftonville,8099,5,9,5,12,34,33,1,32
Ballymena,8099,6,7,4,15,25,53,-28,25
Glentoran,8099,7,6,6,10,24,32,-8,24
Dungannon,8099,8,2,4,16,14,47,-33,10
Crusaders,8100,1,17,6,3,63,30,33,57
Coleraine,8100,2,14,11,1,45,24,21,53
Glenavon,8100,3,9,10,7,54,45,9,37
Linfield,8100,4,10,5,11,37,38,-1,35
Cliftonville,8100,5,10,4,12,34,31,3,34
Ballymena,8100,6,7,4,15,25,49,-24,25
Glentoran,8100,7,6,6,10,24,32,-8,24
Dungannon,8100,8,2,4,16,14,47,-33,10
Crusaders,8101,1,16,6,4,63,33,30,54
Coleraine,8101,2,14,10,2,44,25,19,52
Glenavon,8101,3,10,9,7,55,44,11,39
Linfield,8101,4,10,5,11,38,38,0,35
Cliftonville,8101,5,10,4,12,34,32,2,34
Ballymena,8101,6,8,4,14,28,49,-21,28
Glentoran,8101,7,6,6,10,24,32,-8,24
Dungannon,8101,8,2,4,16,14,47,-33,10
Crusaders,8102,1,16,6,4,62,32,30,54
Coleraine,8102,2,14,10,2,44,25,19,52
Glenavon,8102,3,10,9,7,55,44,11,39
Linfield,8102,4,11,5,10,40,36,4,38
Cliftonville,8102,5,9,4,13,32,34,-2,31
Ballymena,8102,6,8,4,14,27,48,-21,28
Glentoran,8102,7,6,6,10,24,32,-8,24
Dungannon,8102,8,2,4,16,14,47,-33,10
Crusaders,8103,1,17,6,3,63,30,33,57
Coleraine,8103,2,14,11,1,44,23,21,53
Glenavon,8103,3,9,10,7,53,44,9,37
Linfield,8103,4,10,5,11,37,38,-1,35
Cliftonville,8103,5,10,4,12,34,31,3,34
Ballymena,8103,6,7,4,15,25,49,-24,25
Glentoran,8103,7,6,6,10,24,32,-8,24
Dungannon,8103,8,2,4,16,14,47,-33,10
Crusaders,8104,1,16,6,4,63,33,30,54
Coleraine,8104,2,14,10,2,43,23,20,52
Glenavon,8104,3,10,9,7,53,43,10,39
Linfield,8104,4,11,5,10,38,36,2,38
Cliftonville,8104,5,9,4,13,32,32,0,31
Ballymena,8104,6,8,4,14,28,49,-21,28
Glentoran,8104,7,6,6,10,24,32,-8,24
Dungannon,8104,8,2,4,16,14,47,-33,10
Crusaders,8105,1,17,6,3,63,30,33,57
Coleraine,8105,2,14,10,2,44,25,19,52
Glenavon,8105,3,10,9,7,55,44,11,39
Linfield,8105,4,11,5,10,40,36,4,38
Cliftonville,8105,5,9,4,13,32,34,-2,31
Ballymena,8105,6,7,4,15,25,49,-24,25
Glentoran,8105,7,6,6,10,24,32,-8,24
Dungannon,8105,8,2,4,16,14,47,-33,10
Crusaders,8106,1,17,6,3,63,30,33,57
Coleraine,8106,2,14,10,2,45,25,20,52
Glenavon,8106,3,10,9,7,55,45,10,39
Linfield,8106,4,11,5,10,39,37,2,38
Cliftonville,8106,5,9,4,13,33,33,0,31
Ballymena,8106,6,7,4,15,25,49,-24,25
Glentoran,8106,7,6,6,10,24,32,-8,24
Dungannon,8106,8,2,4,16,14,47,-33,10
Crusaders,8107,1,16,7,3,63,32,31,55
Coleraine,8107,2,14,10,2,45,25,20,52
Glenavon,8107,3,10,9,7,55,45,10,39
Linfield,8107,4,11,5,10,40,37,3,38
Cliftonville,8107,5,9,4,13,33,34,-1,31
Ballymena,8107,6,7,5,14,27,49,-22,26
Glentoran,8107,7,6,6,10,24,32,-8,24
Dungannon,8107,8,2,4,16,14,47,-33,10
Crusaders,8108,1,17,6,3,64,32,32,57
Coleraine,8108,2,14,11,1,43,22,21,53
Linfield,8108,3,11,5,10,41,38,3,38
Glenavon,8108,4,9,10,7,52,43,9,37
Cliftonville,8108,5,9,4,13,34,35,-1,31
Ballymena,8108,6,7,4,15,27,50,-23,25
Glentoran,8108,7,6,6,10,24,32,-8,24
Dungannon,8108,8,2,4,16,14,47,-33,10
Crusaders,8109,1,17,6,3,64,31,33,57
Coleraine,8109,2,15,10,1,45,23,22,55
Glenavon,8109,3,9,9,8,53,45,8,36
Linfield,8109,4,10,6,10,37,36,1,36
Cliftonville,8109,5,9,5,12,32,31,1,32
Ballymena,8109,6,7,4,15,26,50,-24,25
Glentoran,8109,7,6,6,10,24,32,-8,24
Dungannon,8109,8,2,4,16,14,47,-33,10
Coleraine,8110,1,15,10,1,44,22,22,55
Crusaders,8110,2,16,6,4,62,33,29,54
Glenavon,8110,3,9,9,8,52,44,8,36
Linfield,8110,4,10,5,11,40,40,0,35
Cliftonville,8110,5,10,4,12,36,34,2,34
Ballymena,8110,6,8,4,14,28,48,-20,28
Glentoran,8110,7,6,6,10,24,32,-8,24
Dungannon,8110,8,2,4,16,14,47,-33,10
Crusaders,8111,1,17,6,3,63,30,33,57
Coleraine,8111,2,15,10,1,44,22,22,55
Linfield,8111,3,11,5,10,39,36,3,38
Glenavon,8111,4,9,9,8,52,44,8,36
Cliftonville,8111,5,9,4,13,32,33,-1,31
Ballymena,8111,6,7,4,15,25,49,-24,25
Glentoran,8111,7,6,6,10,24,32,-8,24
Dungannon,8111,8,2,4,16,14,47,-33,10
Crusaders,8112,1,17,6,3,64,31,33,57
Coleraine,8112,2,14,10,2,44,24,20,52
Glenavon,8112,3,10,9,7,54,44,10,39
Linfield,8112,4,10,6,10,38,37,1,36
Cliftonville,8112,5,9,5,12,33,32,1,32
Ballymena,8112,6,7,4,15,26,50,-24,25
Glentoran,8112,7,6,6,10,24,32,-8,24
Dungannon,8112,8,2,4,16,14,47,-33,10
Crusaders,8113,1,16,7,3,61,30,31,55
Coleraine,8113,2,14,11,1,44,23,21,53
Glenavon,8113,3,9,10,7,53,44,9,37
Linfield,8113,4,10,5,11,38,38,0,35
Cliftonville,8113,5,10,4,12,34,32,2,34
Ballymena,8113,6,7,5,14,25,47,-22,26
Glentoran,8113,7,6,6,10,24,32,-8,24
Dungannon,8113,8,2,4,16,14,47,-33,10
Crusaders,8114,1,17,6,3,62,30,32,57
Coleraine,8114,2,15,10,1,44,22,22,55
Glenavon,8114,3,9,9,8,52,44,8,36
Linfield,8114,4,10,5,11,37,37,0,35
Cliftonville,8114,5,10,4,12,33,31,2,34
Ballymena,8114,6,7,4,15,25,48,-23,25
Glentoran,8114,7,6,6,10,24,32,-8,24
Dungannon,8114,8,2,4,16,14,47,-33,10
Crusaders,8115,1,17,6,3,63,30,33,57
Coleraine,8115,2,15,10,1,45,22,23,55
Glenavon,8115,3,9,9,8,52,45,7,36
Linfield,8115,4,10,5,11,37,37,0,35
Cliftonville,8115,5,10,4,12,33,31,2,34
Ballymena,8115,6,7,4,15,25,49,-24,25
Glentoran,8115,7,6,6,10,24,32,-8,24
Dungannon,8115,8,2,4,16,14,47,-33,10
Crusaders,8116,1,17,6,3,63,31,32,57
Coleraine,8116,2,14,10,2,44,25,19,52
Glenavon,8116,3,10,9,7,55,44,11,39
Linfield,8116,4,10,5,11,37,37,0,35
Cliftonville,8116,5,10,4,12,33,31,2,34
Ballymena,8116,6,7,4,15,26,49,-23,25
Glentoran,8116,7,6,6,10,24,32,-8,24
Dungannon,8116,8,2,4,16,14,47,-33,10
Crusaders,8117,1,17,6,3,63,31,32,57
Coleraine,8117,2,14,10,2,45,25,20,52
Glenavon,8117,3,10,9,7,55,45,10,39
Linfield,8117,4,11,5,10,39,36,3,38
Cliftonville,8117,5,9,4,13,32,33,-1,31
Ballymena,8117,6,7,4,15,26,49,-23,25
Glentoran,8117,7,6,6,10,24,32,-8,24
Dungannon,8117,8,2,4,16,14,47,-33,10
Coleraine,8118,1,15,10,1,44,22,22,55
Crusaders,8118,2,16,6,4,61,31,30,54
Glenavon,8118,3,9,9,8,52,44,8,36
Linfield,8118,4,10,6,10,37,36,1,36
Cliftonville,8118,5,9,5,12,32,31,1,32
Ballymena,8118,6,8,4,14,26,47,-21,28
Glentoran,8118,7,6,6,10,24,32,-8,24
Dungannon,8118,8,2,4,16,14,47,-33,10
Crusaders,8119,1,17,6,3,64,32,32,57
Coleraine,8119,2,14,10,2,43,23,20,52
Glenavon,8119,3,10,9,7,53,43,10,39
Linfield,8119,4,10,6,10,37,36,1,36
Cliftonville,8119,5,9,5,12,32,31,1,32
Ballymena,8119,6,7,4,15,27,50,-23,25
Glentoran,8119,7,6,6,10,24,32,-8,24
Dungannon,8119,8,2,4,16,14,47,-33,10
Crusaders,8120,1,16,6,4,61,31,30,54
Coleraine,8120,2,14,10,2,44,27,17,52
Glenavon,8120,3,10,9,7,57,44,13,39
Linfield,8120,4,11,5,10,38,36,2,38
Cliftonville,8120,5,9,4,13,32,32,0,31
Ballymena,8120,6,8,4,14,26,47,-21,28
Glentoran,8120,7,6,6,10,24,32,-8,24
Dungannon,8120,8,2,4,16,14,47,-33,10
Crusaders,8121,1,17,6,3,63,30,33,57
Coleraine,8121,2,14,10,2,44,25,19,52
Glenavon,8121,3,10,9,7,55,44,11,39
Linfield,8121,4,10,5,11,37,38,-1,35
Cliftonville,8121,5,10,4,12,34,31,3,34
Ballymena,8121,6,7,4,15,25,49,-24,25
Glentoran,8121,7,6,6,10,24,32,-8,24
Dungannon,8121,8,2,4,16,14,47,-33,10
Crusaders,8122,1,17,6,3,65,31,34,57
Coleraine,8122,2,15,10,1,45,23,22,55
Linfield,8122,3,11,5,10,39,36,3,38
Glenavon,8122,4,9,9,8,53,45,8,36
Cliftonville,8122,5,9,4,13,32,33,-1,31
Ballymena,8122,6,7,4,15,26,51,-25,25
Glentoran,8122,7,6,6,10,24,32,-8,24
Dungannon,8122,8,2,4,16,14,47,-33,10
Crusaders,8123,1,17,6,3,63,30,33,57
Coleraine,8123,2,14,10,2,43,24,19,52
Glenavon,8123,3,10,9,7,54,43,11,39
Linfield,8123,4,11,5,10,39,37,2,38
Cliftonville,8123,5,9,4,13,33,33,0,31
Ballymena,8123,6,7,4,15,25,49,-24,25
Glentoran,8123,7,6,6,10,24,32,-8,24
Dungannon,8123,8,2,4,16,14,47,-33,10
Coleraine,8124,1,15,10,1,46,24,22,55
Crusaders,8124,2,16,6,4,61,31,30,54
Linfield,8124,3,11,5,10,39,37,2,38
Glenavon,8124,4,9,9,8,54,46,8,36
Cliftonville,8124,5,9,4,13,33,33,0,31
Ballymena,8124,6,8,4,14,26,47,-21,28
Glentoran,8124,7,6,6,10,24,32,-8,24
Dungannon,8124,8,2,4,16,14,47,-33,10
Coleraine,8125,1,15,10,1,45,23,22,55
Crusaders,8125,2,16,6,4,61,32,29,54
Glenavon,8125,3,9,9,8,53,45,8,36
Linfield,8125,4,10,5,11,39,39,0,35
Cliftonville,8125,5,10,4,12,35,33,2,34
Ballymena,8125,6,8,4,14,27,47,-20,28
Glentoran,8125,7,6,6,10,24,32,-8,24
Dungannon,8125,8,2,4,16,14,47,-33,10
Crusaders,8126,1,17,6,3,63,31,32,57
Coleraine,8126,2,15,10,1,46,22,24,55
Glenavon,8126,3,9,9,8,52,46,6,36
Linfield,8126,4,10,5,11,38,38,0,35
Cliftonville,8126,5,10,4,12,34,32,2,34
Ballymena,8126,6,7,4,15,26,49,-23,25
Glentoran,8126,7,6,6,10,24,32,-8,24
Dungannon,8126,8,2,4,16,14,47,-33,10
Coleraine,8127,1,15,10,1,45,23,22,55
Crusaders,8127,2,16,6,4,61,32,29,54
Glenavon,8127,3,9,9,8,53,45,8,36
Linfield,8127,4,10,6,10,38,37,1,36
Cliftonville,8127,5,9,5,12,33,32,1,32
Ballymena,8127,6,8,4,14,27,47,-20,28
Glentoran,8127,7,6,6,10,24,32,-8,24
Dungannon,8127,8,2,4,16,14,47,-33,10
Coleraine,8128,1,15,10,1,46,24,22,55
Crusaders,8128,2,16,6,4,62,32,30,54
Linfield,8128,3,11,5,10,40,36,4,38
Glenavon,8128,4,9,9,8,54,46,8,36
Cliftonville,8128,5,9,4,13,32,34,-2,31
Ballymena,8128,6,8,4,14,27,48,-21,28
Glentoran,8128,7,6,6,10,24,32,-8,24
Dungannon,8128,8,2,4,16,14,47,-33,10
Crusaders,8129,1,17,6,3,64,31,33,57
Coleraine,8129,2,15,10,1,45,22,23,55
Glenavon,8129,3,9,9,8,52,45,7,36
Linfield,8129,4,10,5,11,38,38,0,35
Cliftonville,8129,5,10,4,12,34,32,2,34
Ballymena,8129,6,7,4,15,26,50,-24,25
Glentoran,8129,7,6,6,10,24,32,-8,24
Dungannon,8129,8,2,4,16,14,47,-33,10
Crusaders,8130,1,17,6,3,64,32,32,57
Coleraine,8130,2,14,10,2,44,25,19,52
Glenavon,8130,3,10,9,7,55,44,11,39
Linfield,8130,4,11,5,10,40,36,4,38
Cliftonville,8130,5,9,4,13,32,34,-2,31
Ballymena,8130,6,7,4,15,27,50,-23,25
Glentoran,8130,7,6,6,10,24,32,-8,24
Dungannon,8130,8,2,4,16,14,47,-33,10
Crusaders,8131,1,16,7,3,63,32,31,55
Coleraine,8131,2,14,11,1,46,25,21,53
Glenavon,8131,3,9,10,7,55,46,9,37
Linfield,8131,4,10,5,11,37,37,0,35
Cliftonville,8131,5,10,4,12,33,31,2,34
Ballymena,8131,6,7,5,14,27,49,-22,26
Glentoran,8131,7,6,6,10,24,32,-8,24
Dungannon,8131,8,2,4,16,14,47,-33,10
Crusaders,8132,1,16,6,4,62,32,30,54
Coleraine,8132,2,14,10,2,43,25,18,52
Glenavon,8132,3,10,9,7,55,43,12,39
Linfield,8132,4,10,6,10,37,36,1,36
Cliftonville,8132,5,9,5,12,32,31,1,32
Ballymena,8132,6,8,4,14,27,48,-21,28
Glentoran,8132,7,6,6,10,24,32,-8,24
Dungannon,8132,8,2,4,16,14,47,-33,10
Crusaders,8133,1,17,6,3,63,31,32,57
Coleraine,8133,2,14,10,2,45,26,19,52
Glenavon,8133,3,10,9,7,56,45,11,39
Linfield,8133,4,11,5,10,38,36,2,38
Cliftonville,8133,5,9,4,13,32,32,0,31
Ballymena,8133,6,7,4,15,26,49,-23,25
Glentoran,8133,7,6,6,10,24,32,-8,24
Dungannon,8133,8,2,4,16,14,47,-33,10
Crusaders,8134,1,17,6,3,64,30,34,57
Coleraine,8134,2,14,11,1,44,23,21,53
Glenavon,8134,3,9,10,7,53,44,9,37
Linfield,8134,4,10,6,10,37,36,1,36
Cliftonville,8134,5,9,5,12,32,31,1,32
Ballymena,8134,6,7,4,15,25,50,-25,25
Glentoran,8134,7,6,6,10,24,32,-8,24
Dungannon,8134,8,2,4,16,14,47,-33,10
Crusaders,8135,1,16,7,3,62,31,31,55
Coleraine,8135,2,14,10,2,43,23,20,52
Glenavon,8135,3,10,9,7,53,43,10,39
Linfield,8135,4,11,5,10,38,36,2,38
Cliftonville,8135,5,9,4,13,32,32,0,31
Ballymena,8135,6,7,5,14,26,48,-22,26
Glentoran,8135,7,6,6,10,24,32,-8,24
Dungannon,8135,8,2,4,16,14,47,-33,10
Crusaders,8136,1,16,6,4,61,31,30,54
Coleraine,8136,2,14,10,2,44,25,19,52
Glenavon,8136,3,10,9,7,55,44,11,39
Linfield,8136,4,11,5,10,39,37,2,38
Cliftonville,8136,5,9,4,13,33,33,0,31
Ballymena,8136,6,8,4,14,26,47,-21,28
Glentoran,8136,7,6,6,10,24,32,-8,24
Dungannon,8136,8,2,4,16,14,47,-33,10
Crusaders,8137,1,16,7,3,62,31,31,55
Coleraine,8137,2,15,10,1,44,22,22,55
Glenavon,8137,3,9,9,8,52,44,8,36
Linfield,8137,4,10,6,10,38,37,1,36
Cliftonville,8137,5,9,5,12,33,32,1,32
Ballymena,8137,6,7,5,14,26,48,-22,26
Glentoran,8137,7,6,6,10,24,32,-8,24
Dungannon,8137,8,2,4,16,14,47,-33,10
Crusaders,8138,1,16,7,3,61,30,31,55
Coleraine,8138,2,14,10,2,45,25,20,52
Glenavon,8138,3,10,9,7,55,45,10,39
Linfield,8138,4,10,5,11,37,38,-1,35
Cliftonville,8138,5,10,4,12,34,31,3,34
Ballymena,8138,6,7,5,14,25,47,-22,26
Glentoran,8138,7,6,6,10,24,32,-8,24
Dungannon,8138,8,2,4,16,14,47,-33,10
Crusaders,8139,1,16,7,3,62,31,31,55
Coleraine,8139,2,14,10,2,45,26,19,52
Glenavon,8139,3,10,9,7,56,45,11,39
Linfield,8139,4,10,5,11,37,37,0,35
Cliftonville,8139,5,10,4,12,33,31,2,34
Ballymena,8139,6,7,5,14,26,48,-22,26
Glentoran,8139,7,6,6,10,24,32,-8,24
Dungannon,8139,8,2,4,16,14,47,-33,10
Crusaders,8140,1,17,6,3,62,30,32,57
Coleraine,8140,2,15,10,1,46,23,23,55
Glenavon,8140,3,9,9,8,53,46,7,36
Linfield,8140,4,10,5,11,38,39,-1,35
Cliftonville,8140,5,10,4,12,35,32,3,34
Ballymena,8140,6,7,4,15,25,48,-23,25
Glentoran,8140,7,6,6,10,24,32,-8,24
Dungannon,8140,8,2,4,16,14,47,-33,10
Crusaders,8141,1,17,6,3,63,31,32,57
Coleraine,8141,2,14,11,1,44,23,21,53
Glenavon,8141,3,9,10,7,53,44,9,37
Linfield,8141,4,10,6,10,39,38,1,36
Cliftonville,8141,5,9,5,12,34,33,1,32
Ballymena,8141,6,7,4,15,26,49,-23,25
Glentoran,8141,7,6,6,10,24,32,-8,24
Dungannon,8141,8,2,4,16,14,47,-33,10
Crusaders,8142,1,16,7,3,62,31,31,55
Coleraine,8142,2,15,10,1,45,22,23,55
Glenavon,8142,3,9,9,8,52,45,7,36
Linfield,8142,4,10,6,10,39,38,1,36
Cliftonville,8142,5,9,5,12,34,33,1,32
Ballymena,8142,6,7,5,14,26,48,-22,26
Glentoran,8142,7,6,6,10,24,32,-8,24
Dungannon,8142,8,2,4,16,14,47,-33,10
Crusaders,8143,1,16,7,3,61,30,31,55
Coleraine,8143,2,15,10,1,47,22,25,55
Glenavon,8143,3,9,9,8,52,47,5,36
Linfield,8143,4,10,6,10,38,37,1,36
Cliftonville,8143,5,9,5,12,33,32,1,32
Ballymena,8143,6,7,5,14,25,47,-22,26
Glentoran,8143,7,6,6,10,24,32,-8,24
Dungannon,8143,8,2,4,16,14,47,-33,10
Crusaders,8144,1,17,6,3,63,30,33,57
Coleraine,8144,2,14,10,2,43,24,19,52
Glenavon,8144,3,10,9,7,54,43,11,39
Linfield,8144,4,10,5,11,39,40,-1,35
Cliftonville,8144,5,10,4,12,36,33,3,34
Ballymena,8144,6,7,4,15,25,49,-24,25
Glentoran,8144,7,6,6,10,24,32,-8,24
Dungannon,8144,8,2,4,16,14,47,-33,10
Crusaders,8145,1,17,6,3,63,31,32,57
Coleraine,8145,2,14,11,1,45,24,21,53
Glenavon,8145,3,9,10,7,54,45,9,37
Linfield,8145,4,10,5,11,37,37,0,35
Cliftonville,8145,5,10,4,12,33,31,2,34
Ballymena,8145,6,7,4,15,26,49,-23,25
Glentoran,8145,7,6,6,10,24,32,-8,24
Dungannon,8145,8,2,4,16,14,47,-33,10
Coleraine,8146,1,15,10,1,46,23,23,55
Crusaders,8146,2,16,6,4,62,32,30,54
Glenavon,8146,3,9,9,8,53,46,7,36
Linfield,8146,4,10,6,10,38,37,1,36
Cliftonville,8146,5,9,5,12,33,32,1,32
Ballymena,8146,6,8,4,14,27,48,-21,28
Glentoran,8146,7,6,6,10,24,32,-8,24
Dungannon,8146,8,2,4,16,14,47,-33,10
Crusaders,8147,1,16,7,3,62,31,31,55
Coleraine,8147,2,14,10,2,44,25,19,52
Glenavon,8147,3,10,9,7,55,44,11,39
Linfield,8147,4,10,6,10,37,36,1,36
Cliftonville,8147,5,9,5,12,32,31,1,32
Ballymena,8147,6,7,5,14,26,48,-22,26
Glentoran,8147,7,6,6,10,24,32,-8,24
Dungannon,8147,8,2,4,16,14,47,-33,10
Crusaders,8148,1,17,6,3,64,32,32,57
Coleraine,8148,2,15,10,1,45,23,22,55
Linfield,8148,3,11,5,10,38,36,2,38
Glenavon,8148,4,9,9,8,53,45,8,36
Cliftonville,8148,5,9,4,13,32,32,0,31
Ballymena,8148,6,7,4,15,27,50,-23,25
Glentoran,8148,7,6,6,10,24,32,-8,24
Dungannon,8148,8,2,4,16,14,47,-33,10
Crusaders,8149,1,16,6,4,63,34,29,54
Coleraine,8149,2,14,10,2,43,23,20,52
Glenavon,8149,3,10,9,7,53,43,10,39
Linfield,8149,4,10,5,11,38,38,0,35
Cliftonville,8149,5,10,4,12,34,32,2,34
Ballymena,8149,6,8,4,14,29,49,-20,28
Glentoran,8149,7,6,6,10,24,32,-8,24
Dungannon,8149,8,2,4,16,14,47,-33,10
Crusaders,8150,1,16,6,4,62,32,30,54
Coleraine,8150,2,14,10,2,45,27,18,52
Glenavon,8150,3,10,9,7,57,45,12,39
Linfield,8150,4,11,5,10,40,38,2,38
Cliftonville,8150,5,9,4,13,34,34,0,31
Ballymena,8150,6,8,4,14,27,48,-21,28
Glentoran,8150,7,6,6,10,24,32,-8,24
Dungannon,8150,8,2,4,16,14,47,-33,10
Crusaders,8151,1,16,7,3,62,31,31,55
Coleraine,8151,2,15,10,1,47,22,25,55
Linfield,8151,3,11,5,10,39,37,2,38
Glenavon,8151,4,9,9,8,52,47,5,36
Cliftonville,8151,5,9,4,13,33,33,0,31
Ballymena,8151,6,7,5,14,26,48,-22,26
Glentoran,8151,7,6,6,10,24,32,-8,24
Dungannon,8151,8,2,4,16,14,47,-33,10
Coleraine,8152,1,15,10,1,44,22,22,55
Crusaders,8152,2,16,6,4,61,31,30,54
Glenavon,8152,3,9,9,8,52,44,8,36
Linfield,8152,4,10,5,11,37,37,0,35
Cliftonville,8152,5,10,4,12,33,31,2,34
Ballymena,8152,6,8,4,14,26,47,-21,28
Glentoran,8152,7,6,6,10,24,32,-8,24
Dungannon,8152,8,2,4,16,14,47,-33,10
Crusaders,8153,1,16,6,4,63,34,29,54
Coleraine,8153,2,14,10,2,44,27,17,52
Glenavon,8153,3,10,9,7,57,44,13,39
Linfield,8153,4,10,6,10,38,37,1,36
Cliftonville,8153,5,9,5,12,33,32,1,32
Ballymena,8153,6,8,4,14,29,49,-20,28
Glentoran,8153,7,6,6,10,24,32,-8,24
Dungannon,8153,8,2,4,16,14,47,-33,10
Crusaders,8154,1,17,6,3,62,30,32,57
Coleraine,8154,2,15,10,1,46,23,23,55
Glenavon,8154,3,9,9,8,53,46,7,36
Linfield,8154,4,10,6,10,37,36,1,36
Cliftonville,8154,5,9,5,12,32,31,1,32
Ballymena,8154,6,7,4,15,25,48,-23,25
Glentoran,8154,7,6,6,10,24,32,-8,24
Dungannon,8154,8,2,4,16,14,47,-33,10
Crusaders,8155,1,17,6,3,65,31,34,57
Coleraine,8155,2,15,10,1,45,23,22,55
Linfield,8155,3,11,5,10,40,38,2,38
Glenavon,8155,4,9,9,8,53,45,8,36
Cliftonville,8155,5,9,4,13,34,34,0,31
Ballymena,8155,6,7,4,15,26,51,-25,25
Glentoran,8155,7,6,6,10,24,32,-8,24
Dungannon,8155,8,2,4,16,14,47,-33,10
Crusaders,8156,1,16,7,3,62,31,31,55
Coleraine,8156,2,14,11,1,44,23,21,53
Glenavon,8156,3,9,10,7,53,44,9,37
Linfield,8156,4,10,6,10,39,38,1,36
Cliftonville,8156,5,9,5,12,34,33,1,32
Ballymena,8156,6,7,5,14,26,48,-22,26
Glentoran,8156,7,6,6,10,24,32,-8,24
Dungannon,8156,8,2,4,16,14,47,-33,10
Crusaders,8157,1,16,6,4,62,34,28,54
Coleraine,8157,2,14,11,1,45,24,21,53
Glenavon,8157,3,9,10,7,54,45,9,37
Linfield,8157,4,10,5,11,37,39,-2,35
Cliftonville,8157,5,10,4,12,35,31,4,34
Ballymena,8157,6,8,4,14,29,48,-19,28
Glentoran,8157,7,6,6,10,24,32,-8,24
Dungannon,8157,8,2,4,16,14,47,-33,10
Crusaders,8158,1,17,6,3,64,31,33,57
Coleraine,8158,2,14,11,1,45,24,21,53
Glenavon,8158,3,9,10,7,54,45,9,37
Linfield,8158,4,10,5,11,37,38,-1,35
Cliftonville,8158,5,10,4,12,34,31,3,34
Ballymena,8158,6,7,4,15,26,50,-24,25
Glentoran,8158,7,6,6,10,24,32,-8,24
Dungannon,8158,8,2,4,16,14,47,-33,10
Coleraine,8159,1,15,10,1,47,24,23,55
Crusaders,8159,2,16,6,4,63,34,29,54
Linfield,8159,3,11,5,10,40,38,2,38
Glenavon,8159,4,9,9,8,54,47,7,36
Cliftonville,8159,5,9,4,13,34,34,0,31
Ballymena,8159,6,8,4,14,29,49,-20,28
Glentoran,8159,7,6,6,10,24,32,-8,24
Dungannon,8159,8,2,4,16,14,47,-33,10
Crusaders,8160,1,17,6,3,63,31,32,57
Coleraine,8160,2,15,10,1,45,23,22,55
Glenavon,8160,3,9,9,8,53,45,8,36
Linfield,8160,4,10,5,11,37,37,0,35
Cliftonville,8160,5,10,4,12,33,31,2,34
Ballymena,8160,6,7,4,15,26,49,-23,25
Glentoran,8160,7,6,6,10,24,32,-8,24
Dungannon,8160,8,2,4,16,14,47,-33,10
Crusaders,8161,1,17,6,3,63,30,33,57
Coleraine,8161,2,15,10,1,47,22,25,55
Linfield,8161,3,11,5,10,38,36,2,38
Glenavon,8161,4,9,9,8,52,47,5,36
Cliftonville,8161,5,9,4,13,32,32,0,31
Ballymena,8161,6,7,4,15,25,49,-24,25
Glentoran,8161,7,6,6,10,24,32,-8,24
Dungannon,8161,8,2,4,16,14,47,-33,10
Crusaders,8162,1,16,6,4,62,32,30,54
Coleraine,8162,2,14,10,2,44,25,19,52
Glenavon,8162,3,10,9,7,55,44,11,39
Linfield,8162,4,11,5,10,39,36,3,38
Cliftonville,8162,5,9,4,13,32,33,-1,31
Ballymena,8162,6,8,4,14,27,48,-21,28
Glentoran,8162,7,6,6,10,24,32,-8,24
Dungannon,8162,8,2,4,16,14,47,-33,10
Crusaders,8163,1,17,6,3,63,30,33,57
Coleraine,8163,2,14,10,2,43,27,16,52
Glenavon,8163,3,10,9,7,57,43,14,39
Linfield,8163,4,10,6,10,38,37,1,36
Cliftonville,8163,5,9,5,12,33,32,1,32
Ballymena,8163,6,7,4,15,25,49,-24,25
Glentoran,8163,7,6,6,10,24,32,-8,24
Dungannon,8163,8,2,4,16,14,47,-33,10
Crusaders,8164,1,17,6,3,65,33,32,57
Coleraine,8164,2,14,10,2,44,24,20,52
Glenavon,8164,3,10,9,7,54,44,10,39
Linfield,8164,4,11,5,10,38,36,2,38
Cliftonville,8164,5,9,4,13,32,32,0,31
Ballymena,8164,6,7,4,15,28,51,-23,25
Glentoran,8164,7,6,6,10,24,32,-8,24
Dungannon,8164,8,2,4,16,14,47,-33,10
Crusaders,8165,1,16,7,3,62,31,31,55
Coleraine,8165,2,14,10,2,44,25,19,52
Glenavon,8165,3,10,9,7,55,44,11,39
Linfield,8165,4,10,5,11,38,39,-1,35
Cliftonville,8165,5,10,4,12,35,32,3,34
Ballymena,8165,6,7,5,14,26,48,-22,26
Glentoran,8165,7,6,6,10,24,32,-8,24
Dungannon,8165,8,2,4,16,14,47,-33,10
Crusaders,8166,1,16,7,3,62,31,31,55
Coleraine,8166,2,14,11,1,45,24,21,53
Linfield,8166,3,11,5,10,39,36,3,38
Glenavon,8166,4,9,10,7,54,45,9,37
Cliftonville,8166,5,9,4,13,32,33,-1,31
Ballymena,8166,6,7,5,14,26,48,-22,26
Glentoran,8166,7,6,6,10,24,32,-8,24
Dungannon,8166,8,2,4,16,14,47,-33,10
Crusaders,8167,1,16,6,4,61,31,30,54
Coleraine,8167,2,14,10,2,44,28,16,52
Glenavon,8167,3,10,9,7,58,44,14,39
Linfield,8167,4,10,5,11,38,39,-1,35
Cliftonville,8167,5,10,4,12,35,32,3,34
Ballymena,8167,6,8,4,14,26,47,-21,28
Glentoran,8167,7,6,6,10,24,32,-8,24
Dungannon,8167,8,2,4,16,14,47,-33,10
Crusaders,8168,1,16,7,3,65,34,31,55
Coleraine,8168,2,14,10,2,44,28,16,52
Glenavon,8168,3,10,9,7,58,44,14,39
Linfield,8168,4,10,5,11,38,38,0,35
Cliftonville,8168,5,10,4,12,34,32,2,34
Ballymena,8168,6,7,5,14,29,51,-22,26
Glentoran,8168,7,6,6,10,24,32,-8,24
Dungannon,8168,8,2,4,16,14,47,-33,10
Crusaders,8169,1,16,7,3,63,32,31,55
Coleraine,8169,2,15,10,1,47,25,22,55
Linfield,8169,3,11,5,10,38,36,2,38
Glenavon,8169,4,9,9,8,55,47,8,36
Cliftonville,8169,5,9,4,13,32,32,0,31
Ballymena,8169,6,7,5,14,27,49,-22,26
Glentoran,8169,7,6,6,10,24,32,-8,24
Dungannon,8169,8,2,4,16,14,47,-33,10
Coleraine,8170,1,15,10,1,47,24,23,55
Crusaders,8170,2,16,6,4,62,33,29,54
Glenavon,8170,3,9,9,8,54,47,7,36
Linfield,8170,4,10,6,10,37,36,1,36
Cliftonville,8170,5,9,5,12,32,31,1,32
Ballymena,8170,6,8,4,14,28,48,-20,28
Glentoran,8170,7,6,6,10,24,32,-8,24
Dungannon,8170,8,2,4,16,14,47,-33,10
Crusaders,8171,1,16,7,3,62,31,31,55
Coleraine,8171,2,14,10,2,45,25,20,52
Glenavon,8171,3,10,9,7,55,45,10,39
Linfield,8171,4,10,5,11,37,37,0,35
Cliftonville,8171,5,10,4,12,33,31,2,34
Ballymena,8171,6,7,5,14,26,48,-22,26
Glentoran,8171,7,6,6,10,24,32,-8,24
Dungannon,8171,8,2,4,16,14,47,-33,10
Crusaders,8172,1,17,6,3,67,31,36,57
Coleraine,8172,2,14,11,1,44,23,21,53
Glenavon,8172,3,9,10,7,53,44,9,37
Linfield,8172,4,10,6,10,38,37,1,36
Cliftonville,8172,5,9,5,12,33,32,1,32
Ballymena,8172,6,7,4,15,26,53,-27,25
Glentoran,8172,7,6,6,10,24,32,-8,24
Dungannon,8172,8,2,4,16,14,47,-33,10
Crusaders,8173,1,16,7,3,64,33,31,55
Coleraine,8173,2,15,10,1,45,23,22,55
Linfield,8173,3,11,5,10,39,36,3,38
Glenavon,8173,4,9,9,8,53,45,8,36
Cliftonville,8173,5,9,4,13,32,33,-1,31
Ballymena,8173,6,7,5,14,28,50,-22,26
Glentoran,8173,7,6,6,10,24,32,-8,24
Dungannon,8173,8,2,4,16,14,47,-33,10
Crusaders,8174,1,17,6,3,63,30,33,57
Coleraine,8174,2,14,10,2,44,25,19,52
Glenavon,8174,3,10,9,7,55,44,11,39
Linfield,8174,4,11,5,10,40,36,4,38
Cliftonville,8174,5,9,4,13,32,34,-2,31
Ballymena,8174,6,7,4,15,25,49,-24,25
Glentoran,8174,7,6,6,10,24,32,-8,24
Dungannon,8174,8,2,4,16,14,47,-33,10
Crusaders,8175,1,17,6,3,66,30,36,57
Coleraine,8175,2,14,10,2,43,23,20,52
Glenavon,8175,3,10,9,7,53,43,10,39
Linfield,8175,4,11,5,10,38,36,2,38
Cliftonville,8175,5,9,4,13,32,32,0,31
Ballymena,8175,6,7,4,15,25,52,-27,25
Glentoran,8175,7,6,6,10,24,32,-8,24
Dungannon,8175,8,2,4,16,14,47,-33,10
Crusaders,8176,1,17,6,3,66,33,33,57
Coleraine,8176,2,14,10,2,45,26,19,52
Glenavon,8176,3,10,9,7,56,45,11,39
Linfield,8176,4,10,6,10,37,36,1,36
Cliftonville,8176,5,9,5,12,32,31,1,32
Ballymena,8176,6,7,4,15,28,52,-24,25
Glentoran,8176,7,6,6,10,24,32,-8,24
Dungannon,8176,8,2,4,16,14,47,-33,10
Crusaders,8177,1,17,6,3,63,31,32,57
Coleraine,8177,2,14,10,2,45,26,19,52
Glenavon,8177,3,10,9,7,56,45,11,39
Linfield,8177,4,10,6,10,38,37,1,36
Cliftonville,8177,5,9,5,12,33,32,1,32
Ballymena,8177,6,7,4,15,26,49,-23,25
Glentoran,8177,7,6,6,10,24,32,-8,24
Dungannon,8177,8,2,4,16,14,47,-33,10
Crusaders,8178,1,17,6,3,62,30,32,57
Coleraine,8178,2,14,10,2,46,27,19,52
Glenavon,8178,3,10,9,7,57,46,11,39
Linfield,8178,4,10,5,11,38,40,-2,35
Cliftonville,8178,5,10,4,12,36,32,4,34
Ballymena,8178,6,7,4,15,25,48,-23,25
Glentoran,8178,7,6,6,10,24,32,-8,24
Dungannon,8178,8,2,4,16,14,47,-33,10
Crusaders,8179,1,16,6,4,61,31,30,54
Coleraine,8179,2,14,11,1,45,24,21,53
Linfield,8179,3,11,5,10,40,36,4,38
Glenavon,8179,4,9,10,7,54,45,9,37
Cliftonville,8179,5,9,4,13,32,34,-2,31
Ballymena,8179,6,8,4,14,26,47,-21,28
Glentoran,8179,7,6,6,10,24,32,-8,24
Dungannon,8179,8,2,4,16,14,47,-33,10
Crusaders,8180,1,17,6,3,62,30,32,57
Coleraine,8180,2,14,11,1,46,25,21,53
Linfield,8180,3,11,5,10,38,36,2,38
Glenavon,8180,4,9,10,7,55,46,9,37
Cliftonville,8180,5,9,4,13,32,32,0,31
Ballymena,8180,6,7,4,15,25,48,-23,25
Glentoran,8180,7,6,6,10,24,32,-8,24
Dungannon,8180,8,2,4,16,14,47,-33,10
Crusaders,8181,1,16,7,3,61,30,31,55
Coleraine,8181,2,15,10,1,44,22,22,55
Glenavon,8181,3,9,9,8,52,44,8,36
Linfield,8181,4,10,6,10,37,36,1,36
Cliftonville,8181,5,9,5,12,32,31,1,32
Ballymena,8181,6,7,5,14,25,47,-22,26
Glentoran,8181,7,6,6,10,24,32,-8,24
Dungannon,8181,8,2,4,16,14,47,-33,10
Crusaders,8182,1,17,6,3,62,30,32,57
Coleraine,8182,2,14,10,2,44,24,20,52
Glenavon,8182,3,10,9,7,54,44,10,39
Linfield,8182,4,11,5,10,39,36,3,38
Cliftonville,8182,5,9,4,13,32,33,-1,31
Ballymena,8182,6,7,4,15,25,48,-23,25
Glentoran,8182,7,6,6,10,24,32,-8,24
Dungannon,8182,8,2,4,16,14,47,-33,10
Crusaders,8183,1,17,6,3,64,30,34,57
Coleraine,8183,2,14,11,1,44,23,21,53
Linfield,8183,3,11,5,10,38,36,2,38
Glenavon,8183,4,9,10,7,53,44,9,37
Cliftonville,8183,5,9,4,13,32,32,0,31
Ballymena,8183,6,7,4,15,25,50,-25,25
Glentoran,8183,7,6,6,10,24,32,-8,24
Dungannon,8183,8,2,4,16,14,47,-33,10
Crusaders,8184,1,16,6,4,61,31,30,54
Coleraine,8184,2,14,11,1,44,23,21,53
Linfield,8184,3,11,5,10,39,37,2,38
Glenavon,8184,4,9,10,7,53,44,9,37
Cliftonville,8184,5,9,4,13,33,33,0,31
Ballymena,8184,6,8,4,14,26,47,-21,28
Glentoran,8184,7,6,6,10,24,32,-8,24
Dungannon,8184,8,2,4,16,14,47,-33,10
Crusaders,8185,1,17,6,3,64,31,33,57
Coleraine,8185,2,14,10,2,43,26,17,52
Glenavon,8185,3,10,9,7,56,43,13,39
Linfield,8185,4,11,5,10,40,36,4,38
Cliftonville,8185,5,9,4,13,32,34,-2,31
Ballymena,8185,6,7,4,15,26,50,-24,25
Glentoran,8185,7,6,6,10,24,32,-8,24
Dungannon,8185,8,2,4,16,14,47,-33,10
Crusaders,8186,1,17,6,3,66,32,34,57
Coleraine,8186,2,14,11,1,46,25,21,53
Glenavon,8186,3,9,10,7,55,46,9,37
Linfield,8186,4,10,6,10,39,38,1,36
Cliftonville,8186,5,9,5,12,34,33,1,32
Ballymena,8186,6,7,4,15,27,52,-25,25
Glentoran,8186,7,6,6,10,24,32,-8,24
Dungannon,8186,8,2,4,16,14,47,-33,10
Crusaders,8187,1,16,6,4,61,32,29,54
Coleraine,8187,2,14,10,2,44,24,20,52
Glenavon,8187,3,10,9,7,54,44,10,39
Linfield,8187,4,11,5,10,39,37,2,38
Cliftonville,8187,5,9,4,13,33,33,0,31
Ballymena,8187,6,8,4,14,27,47,-20,28
Glentoran,8187,7,6,6,10,24,32,-8,24
Dungannon,8187,8,2,4,16,14,47,-33,10
Crusaders,8188,1,16,7,3,63,32,31,55
Coleraine,8188,2,14,10,2,44,24,20,52
Glenavon,8188,3,10,9,7,54,44,10,39
Linfield,8188,4,11,5,10,39,37,2,38
Cliftonville,8188,5,9,4,13,33,33,0,31
Ballymena,8188,6,7,5,14,27,49,-22,26
Glentoran,8188,7,6,6,10,24,32,-8,24
Dungannon,8188,8,2,4,16,14,47,-33,10
Crusaders,8189,1,17,6,3,63,31,32,57
Coleraine,8189,2,14,10,2,44,25,19,52
Glenavon,8189,3,10,9,7,55,44,11,39
Linfield,8189,4,10,6,10,38,37,1,36
Cliftonville,8189,5,9,5,12,33,32,1,32
Ballymena,8189,6,7,4,15,26,49,-23,25
Glentoran,8189,7,6,6,10,24,32,-8,24
Dungannon,8189,8,2,4,16,14,47,-33,10
Crusaders,8190,1,17,6,3,63,30,33,57
Coleraine,8190,2,14,10,2,44,25,19,52
Glenavon,8190,3,10,9,7,55,44,11,39
Linfield,8190,4,10,6,10,38,37,1,36
Cliftonville,8190,5,9,5,12,33,32,1,32
Ballymena,8190,6,7,4,15,25,49,-24,25
Glentoran,8190,7,6,6,10,24,32,-8,24
Dungannon,8190,8,2,4,16,14,47,-33,10
Coleraine,8191,1,15,10,1,47,23,24,55
Crusaders,8191,2,16,6,4,62,32,30,54
Glenavon,8191,3,9,9,8,53,47,6,36
Linfield,8191,4,10,5,11,37,38,-1,35
Cliftonville,8191,5,10,4,12,34,31,3,34
Ballymena,8191,6,8,4,14,27,48,-21,28
Glentoran,8191,7,6,6,10,24,32,-8,24
Dungannon,8191,8,2,4,16,14,47,-33,10
Crusaders,8192,1,17,6,3,64,31,33,57
Coleraine,8192,2,14,10,2,44,25,19,52
Glenavon,8192,3,10,9,7,55,44,11,39
Linfield,8192,4,11,5,10,42,36,6,38
Cliftonville,8192,5,9,4,13,32,36,-4,31
Ballymena,8192,6,7,4,15,26,50,-24,25
Glentoran,8192,7,6,6,10,24,32,-8,24
Dungannon,8192,8,2,4,16,14,47,-33,10
Crusaders,8193,1,17,6,3,64,32,32,57
Coleraine,8193,2,15,10,1,45,22,23,55
Linfield,8193,3,11,5,10,39,37,2,38
Glenavon,8193,4,9,9,8,52,45,7,36
Cliftonville,8193,5,9,4,13,33,33,0,31
Ballymena,8193,6,7,4,15,27,50,-23,25
Glentoran,8193,7,6,6,10,24,32,-8,24
Dungannon,8193,8,2,4,16,14,47,-33,10
Crusaders,8194,1,16,7,3,62,31,31,55
Coleraine,8194,2,15,10,1,45,23,22,55
Linfield,8194,3,11,5,10,38,36,2,38
Glenavon,8194,4,9,9,8,53,45,8,36
Cliftonville,8194,5,9,4,13,32,32,0,31
Ballymena,8194,6,7,5,14,26,48,-22,26
Glentoran,8194,7,6,6,10,24,32,-8,24
Dungannon,8194,8,2,4,16,14,47,-33,10
Crusaders,8195,1,16,7,3,62,31,31,55
Coleraine,8195,2,14,10,2,45,26,19,52
Glenavon,8195,3,10,9,7,56,45,11,39
Linfield,8195,4,11,5,10,39,37,2,38
Cliftonville,8195,5,9,4,13,33,33,0,31
Ballymena,8195,6,7,5,14,26,48,-22,26
Glentoran,8195,7,6,6,10,24,32,-8,24
Dungannon,8195,8,2,4,16,14,47,-33,10
Crusaders,8196,1,17,6,3,63,31,32,57
Coleraine,8196,2,14,11,1,46,25,21,53
Linfield,8196,3,11,5,10,42,37,5,38
Glenavon,8196,4,9,10,7,55,46,9,37
Cliftonville,8196,5,9,4,13,33,36,-3,31
Ballymena,8196,6,7,4,15,26,49,-23,25
Glentoran,8196,7,6,6,10,24,32,-8,24
Dungannon,8196,8,2,4,16,14,47,-33,10
Coleraine,8197,1,15,10,1,47,24,23,55
Crusaders,8197,2,16,6,4,62,34,28,54
Glenavon,8197,3,9,9,8,54,47,7,36
Linfield,8197,4,10,5,11,39,39,0,35
Cliftonville,8197,5,10,4,12,35,33,2,34
Ballymena,8197,6,8,4,14,29,48,-19,28
Glentoran,8197,7,6,6,10,24,32,-8,24
Dungannon,8197,8,2,4,16,14,47,-33,10
Crusaders,8198,1,16,7,3,63,32,31,55
Coleraine,8198,2,14,11,1,43,22,21,53
Glenavon,8198,3,9,10,7,52,43,9,37
Linfield,8198,4,10,6,10,38,37,1,36
Cliftonville,8198,5,9,5,12,33,32,1,32
Ballymena,8198,6,7,5,14,27,49,-22,26
Glentoran,8198,7,6,6,10,24,32,-8,24
Dungannon,8198,8,2,4,16,14,47,-33,10
Crusaders,8199,1,16,7,3,62,31,31,55
Coleraine,8199,2,14,10,2,43,24,19,52
Glenavon,8199,3,10,9,7,54,43,11,39
Linfield,8199,4,11,5,10,39,37,2,38
Cliftonville,8199,5,9,4,13,33,33,0,31
Ballymena,8199,6,7,5,14,26,48,-22,26
Glentoran,8199,7,6,6,10,24,32,-8,24
Dungannon,8199,8,2,4,16,14,47,-33,10
Crusaders,8200,1,17,6,3,62,30,32,57
Coleraine,8200,2,14,11,1,43,22,21,53
Linfield,8200,3,11,5,10,39,37,2,38
Glenavon,8200,4,9,10,7,52,43,9,37
Cliftonville,8200,5,9,4,13,33,33,0,31
Ballymena,8200,6,7,4,15,25,48,-23,25
Glentoran,8200,7,6,6,10,24,32,-8,24
Dungannon,8200,8,2,4,16,14,47,-33,10
Crusaders,8201,1,16,7,3,61,30,31,55
Coleraine,8201,2,14,10,2,44,24,20,52
Glenavon,8201,3,10,9,7,54,44,10,39
Linfield,8201,4,11,5,10,39,36,3,38
Cliftonville,8201,5,9,4,13,32,33,-1,31
Ballymena,8201,6,7,5,14,25,47,-22,26
Glentoran,8201,7,6,6,10,24,32,-8,24
Dungannon,8201,8,2,4,16,14,47,-33,10
Crusaders,8202,1,17,6,3,63,30,33,57
Coleraine,8202,2,15,10,1,46,23,23,55
Linfield,8202,3,11,5,10,38,36,2,38
Glenavon,8202,4,9,9,8,53,46,7,36
Cliftonville,8202,5,9,4,13,32,32,0,31
Ballymena,8202,6,7,4,15,25,49,-24,25
Glentoran,8202,7,6,6,10,24,32,-8,24
Dungannon,8202,8,2,4,16,14,47,-33,10
Crusaders,8203,1,16,7,3,63,32,31,55
Coleraine,8203,2,14,10,2,43,26,17,52
Glenavon,8203,3,10,9,7,56,43,13,39
Linfield,8203,4,11,5,10,39,36,3,38
Cliftonville,8203,5,9,4,13,32,33,-1,31
Ballymena,8203,6,7,5,14,27,49,-22,26
Glentoran,8203,7,6,6,10,24,32,-8,24
Dungannon,8203,8,2,4,16,14,47,-33,10
Crusaders,8204,1,17,6,3,63,30,33,57
Coleraine,8204,2,14,10,2,43,25,18,52
Glenavon,8204,3,10,9,7,55,43,12,39
Linfield,8204,4,10,6,10,37,36,1,36
Cliftonville,8204,5,9,5,12,32,31,1,32
Ballymena,8204,6,7,4,15,25,49,-24,25
Glentoran,8204,7,6,6,10,24,32,-8,24
Dungannon,8204,8,2,4,16,14,47,-33,10
Crusaders,8205,1,17,6,3,63,31,32,57
Coleraine,8205,2,15,10,1,46,24,22,55
Linfield,8205,3,11,5,10,42,36,6,38
Glenavon,8205,4,9,9,8,54,46,8,36
Cliftonville,8205,5,9,4,13,32,36,-4,31
Ballymena,8205,6,7,4,15,26,49,-23,25
Glentoran,8205,7,6,6,10,24,32,-8,24
Dungannon,8205,8,2,4,16,14,47,-33,10
Crusaders,8206,1,17,6,3,63,30,33,57
Coleraine,8206,2,14,11,1,44,23,21,53
Glenavon,8206,3,9,10,7,53,44,9,37
Linfield,8206,4,10,6,10,38,37,1,36
Cliftonville,8206,5,9,5,12,33,32,1,32
Ballymena,8206,6,7,4,15,25,49,-24,25
Glentoran,8206,7,6,6,10,24,32,-8,24
Dungannon,8206,8,2,4,16,14,47,-33,10
Crusaders,8207,1,16,6,4,62,32,30,54
Coleraine,8207,2,14,11,1,44,23,21,53
Linfield,8207,3,11,5,10,38,36,2,38
Glenavon,8207,4,9,10,7,53,44,9,37
Cliftonville,8207,5,9,4,13,32,32,0,31
Ballymena,8207,6,8,4,14,27,48,-21,28
Glentoran,8207,7,6,6,10,24,32,-8,24
Dungannon,8207,8,2,4,16,14,47,-33,10
Crusaders,8208,1,17,6,3,65,31,34,57
Coleraine,8208,2,14,11,1,45,24,21,53
Linfield,8208,3,11,5,10,42,37,5,38
Glenavon,8208,4,9,10,7,54,45,9,37
Cliftonville,8208,5,9,4,13,33,36,-3,31
Ballymena,8208,6,7,4,15,26,51,-25,25
Glentoran,8208,7,6,6,10,24,32,-8,24
Dungannon,8208,8,2,4,16,14,47,-33,10
Crusaders,8209,1,16,7,3,63,32,31,55
Coleraine,8209,2,14,10,2,44,25,19,52
Glenavon,8209,3,10,9,7,55,44,11,39
Linfield,8209,4,10,5,11,37,38,-1,35
Cliftonville,8209,5,10,4,12,34,31,3,34
Ballymena,8209,6,7,5,14,27,49,-22,26
Glentoran,8209,7,6,6,10,24,32,-8,24
Dungannon,8209,8,2,4,16,14,47,-33,10
Crusaders,8210,1,17,6,3,65,30,35,57
Coleraine,8210,2,14,11,1,45,24,21,53
Glenavon,8210,3,9,10,7,54,45,9,37
Linfield,8210,4,10,6,10,37,36,1,36
Cliftonville,8210,5,9,5,12,32,31,1,32
Ballymena,8210,6,7,4,15,25,51,-26,25
Glentoran,8210,7,6,6,10,24,32,-8,24
Dungannon,8210,8,2,4,16,14,47,-33,10
Crusaders,8211,1,16,7,3,62,31,31,55
Coleraine,8211,2,14,10,2,44,24,20,52
Glenavon,8211,3,10,9,7,54,44,10,39
Linfield,8211,4,10,5,11,39,39,0,35
Cliftonville,8211,5,10,4,12,35,33,2,34
Ballymena,8211,6,7,5,14,26,48,-22,26
Glentoran,8211,7,6,6,10,24,32,-8,24
Dungannon,8211,8,2,4,16,14,47,-33,10
Crusaders,8212,1,17,6,3,66,32,34,57
Coleraine,8212,2,14,10,2,44,25,19,52
Glenavon,8212,3,10,9,7,55,44,11,39
Linfield,8212,4,11,5,10,41,37,4,38
Cliftonville,8212,5,9,4,13,33,35,-2,31
Ballymena,8212,6,7,4,15,27,52,-25,25
Glentoran,8212,7,6,6,10,24,32,-8,24
Dungannon,8212,8,2,4,16,14,47,-33,10
Crusaders,8213,1,17,6,3,63,31,32,57
Coleraine,8213,2,14,10,2,44,24,20,52
Glenavon,8213,3,10,9,7,54,44,10,39
Linfield,8213,4,10,5,11,38,39,-1,35
Cliftonville,8213,5,10,4,12,35,32,3,34
Ballymena,8213,6,7,4,15,26,49,-23,25
Glentoran,8213,7,6,6,10,24,32,-8,24
Dungannon,8213,8,2,4,16,14,47,-33,10
Crusaders,8214,1,16,6,4,61,32,29,54
Coleraine,8214,2,14,10,2,43,23,20,52
Glenavon,8214,3,10,9,7,53,43,10,39
Linfield,8214,4,11,5,10,38,36,2,38
Cliftonville,8214,5,9,4,13,32,32,0,31
Ballymena,8214,6,8,4,14,27,47,-20,28
Glentoran,8214,7,6,6,10,24,32,-8,24
Dungannon,8214,8,2,4,16,14,47,-33,10
Crusaders,8215,1,16,7,3,63,32,31,55
Coleraine,8215,2,15,10,1,45,23,22,55
Glenavon,8215,3,9,9,8,53,45,8,36
Linfield,8215,4,10,5,11,39,39,0,35
Cliftonville,8215,5,10,4,12,35,33,2,34
Ballymena,8215,6,7,5,14,27,49,-22,26
Glentoran,8215,7,6,6,10,24,32,-8,24
Dungannon,8215,8,2,4,16,14,47,-33,10
Crusaders,8216,1,16,6,4,62,34,28,54
Coleraine,8216,2,14,10,2,45,25,20,52
Glenavon,8216,3,10,9,7,55,45,10,39
Linfield,8216,4,10,6,10,40,39,1,36
Cliftonville,8216,5,9,5,12,35,34,1,32
Ballymena,8216,6,8,4,14,29,48,-19,28
Glentoran,8216,7,6,6,10,24,32,-8,24
Dungannon,8216,8,2,4,16,14,47,-33,10
Crusaders,8217,1,17,6,3,67,32,35,57
Coleraine,8217,2,14,10,2,44,25,19,52
Glenavon,8217,3,10,9,7,55,44,11,39
Linfield,8217,4,10,5,11,38,38,0,35
Cliftonville,8217,5,10,4,12,34,32,2,34
Ballymena,8217,6,7,4,15,27,53,-26,25
Glentoran,8217,7,6,6,10,24,32,-8,24
Dungannon,8217,8,2,4,16,14,47,-33,10
Crusaders,8218,1,17,6,3,65,32,33,57
Coleraine,8218,2,14,10,2,43,24,19,52
Glenavon,8218,3,10,9,7,54,43,11,39
Linfield,8218,4,11,5,10,40,37,3,38
Cliftonville,8218,5,9,4,13,33,34,-1,31
Ballymena,8218,6,7,4,15,27,51,-24,25
Glentoran,8218,7,6,6,10,24,32,-8,24
Dungannon,8218,8,2,4,16,14,47,-33,10
Crusaders,8219,1,17,6,3,63,30,33,57
Coleraine,8219,2,15,10,1,47,24,23,55
Glenavon,8219,3,9,9,8,54,47,7,36
Linfield,8219,4,10,6,10,38,37,1,36
Cliftonville,8219,5,9,5,12,33,32,1,32
Ballymena,8219,6,7,4,15,25,49,-24,25
Glentoran,8219,7,6,6,10,24,32,-8,24
Dungannon,8219,8,2,4,16,14,47,-33,10
Crusaders,8220,1,17,6,3,63,31,32,57
Coleraine,8220,2,14,11,1,44,23,21,53
Glenavon,8220,3,9,10,7,53,44,9,37
Linfield,8220,4,10,6,10,38,37,1,36
Cliftonville,8220,5,9,5,12,33,32,1,32
Ballymena,8220,6,7,4,15,26,49,-23,25
Glentoran,8220,7,6,6,10,24,32,-8,24
Dungannon,8220,8,2,4,16,14,47,-33,10
Coleraine,8221,1,15,10,1,46,22,24,55
Crusaders,8221,2,16,6,4,62,32,30,54
Glenavon,8221,3,9,9,8,52,46,6,36
Linfield,8221,4,10,6,10,37,36,1,36
Cliftonville,8221,5,9,5,12,32,31,1,32
Ballymena,8221,6,8,4,14,27,48,-21,28
Glentoran,8221,7,6,6,10,24,32,-8,24
Dungannon,8221,8,2,4,16,14,47,-33,10
Crusaders,8222,1,16,7,3,61,30,31,55
Coleraine,8222,2,15,10,1,49,26,23,55
Glenavon,8222,3,9,9,8,56,49,7,36
Linfield,8222,4,10,5,11,37,37,0,35
Cliftonville,8222,5,10,4,12,33,31,2,34
Ballymena,8222,6,7,5,14,25,47,-22,26
Glentoran,8222,7,6,6,10,24,32,-8,24
Dungannon,8222,8,2,4,16,14,47,-33,10
Crusaders,8223,1,16,7,3,62,31,31,55
Coleraine,8223,2,14,11,1,45,24,21,53
Glenavon,8223,3,9,10,7,54,45,9,37
Linfield,8223,4,10,5,11,38,39,-1,35
Cliftonville,8223,5,10,4,12,35,32,3,34
Ballymena,8223,6,7,5,14,26,48,-22,26
Glentoran,8223,7,6,6,10,24,32,-8,24
Dungannon,8223,8,2,4,16,14,47,-33,10
Crusaders,8224,1,16,6,4,61,33,28,54
Coleraine,8224,2,14,10,2,43,24,19,52
Glenavon,8224,3,10,9,7,54,43,11,39
Linfield,8224,4,10,6,10,39,38,1,36
Cliftonville,8224,5,9,5,12,34,33,1,32
Ballymena,8224,6,8,4,14,28,47,-19,28
Glentoran,8224,7,6,6,10,24,32,-8,24
Dungannon,8224,8,2,4,16,14,47,-33,10
Crusaders,8225,1,17,6,3,65,30,35,57
Coleraine,8225,2,14,10,2,44,25,19,52
Glenavon,8225,3,10,9,7,55,44,11,39
Linfield,8225,4,11,5,10,39,37,2,38
Cliftonville,8225,5,9,4,13,33,33,0,31
Ballymena,8225,6,7,4,15,25,51,-26,25
Glentoran,8225,7,6,6,10,24,32,-8,24
Dungannon,8225,8,2,4,16,14,47,-33,10
Crusaders,8226,1,17,6,3,64,30,34,57
Coleraine,8226,2,14,10,2,43,25,18,52
Glenavon,8226,3,10,9,7,55,43,12,39
Linfield,8226,4,11,5,10,42,37,5,38
Cliftonville,8226,5,9,4,13,33,36,-3,31
Ballymena,8226,6,7,4,15,25,50,-25,25
Glentoran,8226,7,6,6,10,24,32,-8,24
Dungannon,8226,8,2,4,16,14,47,-33,10
Crusaders,8227,1,17,6,3,64,31,33,57
Coleraine,8227,2,15,10,1,46,24,22,55
Linfield,8227,3,11,5,10,39,36,3,38
Glenavon,8227,4,9,9,8,54,46,8,36
Cliftonville,8227,5,9,4,13,32,33,-1,31
Ballymena,8227,6,7,4,15,26,50,-24,25
Glentoran,8227,7,6,6,10,24,32,-8,24
Dungannon,8227,8,2,4,16,14,47,-33,10
Coleraine,8228,1,15,10,1,45,22,23,55
Crusaders,8228,2,16,6,4,62,32,30,54
Glenavon,8228,3,9,9,8,52,45,7,36
Linfield,8228,4,10,6,10,38,37,1,36
Cliftonville,8228,5,9,5,12,33,32,1,32
Ballymena,8228,6,8,4,14,27,48,-21,28
Glentoran,8228,7,6,6,10,24,32,-8,24
Dungannon,8228,8,2,4,16,14,47,-33,10
Crusaders,8229,1,17,6,3,65,32,33,57
Coleraine,8229,2,14,11,1,44,23,21,53
Glenavon,8229,3,9,10,7,53,44,9,37
Linfield,8229,4,10,6,10,37,36,1,36
Cliftonville,8229,5,9,5,12,32,31,1,32
Ballymena,8229,6,7,4,15,27,51,-24,25
Glentoran,8229,7,6,6,10,24,32,-8,24
Dungannon,8229,8,2,4,16,14,47,-33,10
Crusaders,8230,1,17,6,3,65,30,35,57
Coleraine,8230,2,14,11,1,43,22,21,53
Glenavon,8230,3,9,10,7,52,43,9,37
Linfield,8230,4,10,5,11,37,39,-2,35
Cliftonville,8230,5,10,4,12,35,31,4,34
Ballymena,8230,6,7,4,15,25,51,-26,25
Glentoran,8230,7,6,6,10,24,32,-8,24
Dungannon,8230,8,2,4,16,14,47,-33,10
Crusaders,8231,1,17,6,3,64,32,32,57
Coleraine,8231,2,15,10,1,44,22,22,55
Glenavon,8231,3,9,9,8,52,44,8,36
Linfield,8231,4,10,5,11,37,39,-2,35
Cliftonville,8231,5,10,4,12,35,31,4,34
Ballymena,8231,6,7,4,15,27,50,-23,25
Glentoran,8231,7,6,6,10,24,32,-8,24
Dungannon,8231,8,2,4,16,14,47,-33,10
Coleraine,8232,1,15,10,1,45,22,23,55
Crusaders,8232,2,16,6,4,63,33,30,54
Glenavon,8232,3,9,9,8,52,45,7,36
Linfield,8232,4,10,5,11,37,37,0,35
Cliftonville,8232,5,10,4,12,33,31,2,34
Ballymena,8232,6,8,4,14,28,49,-21,28
Glentoran,8232,7,6,6,10,24,32,-8,24
Dungannon,8232,8,2,4,16,14,47,-33,10
Crusaders,8233,1,16,7,3,64,33,31,55
Coleraine,8233,2,14,11,1,44,23,21,53
Linfield,8233,3,11,5,10,38,36,2,38
Glenavon,8233,4,9,10,7,53,44,9,37
Cliftonville,8233,5,9,4,13,32,32,0,31
Ballymena,8233,6,7,5,14,28,50,-22,26
Glentoran,8233,7,6,6,10,24,32,-8,24
Dungannon,8233,8,2,4,16,14,47,-33,10
Coleraine,8234,1,15,10,1,44,22,22,55
Crusaders,8234,2,16,6,4,61,33,28,54
Linfield,8234,3,11,5,10,38,36,2,38
Glenavon,8234,4,9,9,8,52,44,8,36
Cliftonville,8234,5,9,4,13,32,32,0,31
Ballymena,8234,6,8,4,14,28,47,-19,28
Glentoran,8234,7,6,6,10,24,32,-8,24
Dungannon,8234,8,2,4,16,14,47,-33,10
Crusaders,8235,1,16,6,4,61,31,30,54
Coleraine,8235,2,14,11,1,44,23,21,53
Glenavon,8235,3,9,10,7,53,44,9,37
Linfield,8235,4,10,6,10,38,37,1,36
Cliftonville,8235,5,9,5,12,33,32,1,32
Ballymena,8235,6,8,4,14,26,47,-21,28
Glentoran,8235,7,6,6,10,24,32,-8,24
Dungannon,8235,8,2,4,16,14,47,-33,10
Crusaders,8236,1,17,6,3,64,32,32,57
Coleraine,8236,2,15,10,1,45,22,23,55
Glenavon,8236,3,9,9,8,52,45,7,36
Linfield,8236,4,10,6,10,39,38,1,36
Cliftonville,8236,5,9,5,12,34,33,1,32
Ballymena,8236,6,7,4,15,27,50,-23,25
Glentoran,8236,7,6,6,10,24,32,-8,24
Dungannon,8236,8,2,4,16,14,47,-33,10
Crusaders,8237,1,17,6,3,65,30,35,57
Coleraine,8237,2,14,10,2,43,24,19,52
Glenavon,8237,3,10,9,7,54,43,11,39
Linfield,8237,4,10,6,10,40,39,1,36
Cliftonville,8237,5,9,5,12,35,34,1,32
Ballymena,8237,6,7,4,15,25,51,-26,25
Glentoran,8237,7,6,6,10,24,32,-8,24
Dungannon,8237,8,2,4,16,14,47,-33,10
Crusaders,8238,1,17,6,3,62,30,32,57
Coleraine,8238,2,14,11,1,44,23,21,53
Linfield,8238,3,11,5,10,38,36,2,38
Glenavon,8238,4,9,10,7,53,44,9,37
Cliftonville,8238,5,9,4,13,32,32,0,31
Ballymena,8238,6,7,4,15,25,48,-23,25
Glentoran,8238,7,6,6,10,24,32,-8,24
Dungannon,8238,8,2,4,16,14,47,-33,10
Crusaders,8239,1,16,7,3,62,31,31,55
Coleraine,8239,2,15,10,1,46,23,23,55
Linfield,8239,3,11,5,10,41,36,5,38
Glenavon,8239,4,9,9,8,53,46,7,36
Cliftonville,8239,5,9,4,13,32,35,-3,31
Ballymena,8239,6,7,5,14,26,48,-22,26
Glentoran,8239,7,6,6,10,24,32,-8,24
Dungannon,8239,8,2,4,16,14,47,-33,10
Coleraine,8240,1,15,10,1,47,24,23,55
Crusaders,8240,2,16,6,4,63,34,29,54
Linfield,8240,3,11,5,10,39,37,2,38
Glenavon,8240,4,9,9,8,54,47,7,36
Cliftonville,8240,5,9,4,13,33,33,0,31
Ballymena,8240,6,8,4,14,29,49,-20,28
Glentoran,8240,7,6,6,10,24,32,-8,24
Dungannon,8240,8,2,4,16,14,47,-33,10
Coleraine,8241,1,15,10,1,45,23,22,55
Crusaders,8241,2,16,6,4,62,32,30,54
Glenavon,8241,3,9,9,8,53,45,8,36
Linfield,8241,4,10,6,10,37,36,1,36
Cliftonville,8241,5,9,5,12,32,31,1,32
Ballymena,8241,6,8,4,14,27,48,-21,28
Glentoran,8241,7,6,6,10,24,32,-8,24
Dungannon,8241,8,2,4,16,14,47,-33,10
Crusaders,8242,1,17,6,3,64,30,34,57
Coleraine,8242,2,14,10,2,44,24,20,52
Glenavon,8242,3,10,9,7,54,44,10,39
Linfield,8242,4,11,5,10,38,36,2,38
Cliftonville,8242,5,9,4,13,32,32,0,31
Ballymena,8242,6,7,4,15,25,50,-25,25
Glentoran,8242,7,6,6,10,24,32,-8,24
Dungannon,8242,8,2,4,16,14,47,-33,10
Crusaders,8243,1,17,6,3,62,30,32,57
Coleraine,8243,2,15,10,1,46,23,23,55
Linfield,8243,3,11,5,10,43,37,6,38
Glenavon,8243,4,9,9,8,53,46,7,36
Cliftonville,8243,5,9,4,13,33,37,-4,31
Ballymena,8243,6,7,4,15,25,48,-23,25
Glentoran,8243,7,6,6,10,24,32,-8,24
Dungannon,8243,8,2,4,16,14,47,-33,10
Crusaders,8244,1,16,6,4,61,31,30,54
Coleraine,8244,2,14,10,2,44,26,18,52
Glenavon,8244,3,10,9,7,56,44,12,39
Linfield,8244,4,11,5,10,39,36,3,38
Cliftonville,8244,5,9,4,13,32,33,-1,31
Ballymena,8244,6,8,4,14,26,47,-21,28
Glentoran,8244,7,6,6,10,24,32,-8,24
Dungannon,8244,8,2,4,16,14,47,-33,10
Coleraine,8245,1,15,10,1,47,23,24,55
Crusaders,8245,2,16,6,4,62,34,28,54
Linfield,8245,3,11,5,10,38,36,2,38
Glenavon,8245,4,9,9,8,53,47,6,36
Cliftonville,8245,5,9,4,13,32,32,0,31
Ballymena,8245,6,8,4,14,29,48,-19,28
Glentoran,8245,7,6,6,10,24,32,-8,24
Dungannon,8245,8,2,4,16,14,47,-33,10
Crusaders,8246,1,17,6,3,63,30,33,57
Coleraine,8246,2,14,10,2,44,25,19,52
Glenavon,8246,3,10,9,7,55,44,11,39
Linfield,8246,4,11,5,10,38,36,2,38
Cliftonville,8246,5,9,4,13,32,32,0,31
Ballymena,8246,6,7,4,15,25,49,-24,25
Glentoran,8246,7,6,6,10,24,32,-8,24
Dungannon,8246,8,2,4,16,14,47,-33,10
Coleraine,8247,1,15,10,1,44,22,22,55
Crusaders,8247,2,16,6,4,62,34,28,54
Glenavon,8247,3,9,9,8,52,44,8,36
Linfield,8247,4,10,6,10,37,36,1,36
Cliftonville,8247,5,9,5,12,32,31,1,32
Ballymena,8247,6,8,4,14,29,48,-19,28
Glentoran,8247,7,6,6,10,24,32,-8,24
Dungannon,8247,8,2,4,16,14,47,-33,10
Crusaders,8248,1,17,6,3,62,30,32,57
Coleraine,8248,2,15,10,1,47,25,22,55
Glenavon,8248,3,9,9,8,55,47,8,36
Linfield,8248,4,10,5,11,37,38,-1,35
Cliftonville,8248,5,10,4,12,34,31,3,34
Ballymena,8248,6,7,4,15,25,48,-23,25
Glentoran,8248,7,6,6,10,24,32,-8,24
Dungannon,8248,8,2,4,16,14,47,-33,10
Crusaders,8249,1,16,7,3,63,32,31,55
Coleraine,8249,2,15,10,1,47,25,22,55
Glenavon,8249,3,9,9,8,55,47,8,36
Linfield,8249,4,10,5,11,39,41,-2,35
Cliftonville,8249,5,10,4,12,37,33,4,34
Ballymena,8249,6,7,5,14,27,49,-22,26
Glentoran,8249,7,6,6,10,24,32,-8,24
Dungannon,8249,8,2,4,16,14,47,-33,10
Crusaders,8250,1,17,6,3,62,30,32,57
Coleraine,8250,2,14,10,2,45,25,20,52
Glenavon,8250,3,10,9,7,55,45,10,39
Linfield,8250,4,10,6,10,38,37,1,36
Cliftonville,8250,5,9,5,12,33,32,1,32
Ballymena,8250,6,7,4,15,25,48,-23,25
Glentoran,8250,7,6,6,10,24,32,-8,24
Dungannon,8250,8,2,4,16,14,47,-33,10
Crusaders,8251,1,16,7,3,62,31,31,55
Coleraine,8251,2,14,10,2,45,25,20,52
Glenavon,8251,3,10,9,7,55,45,10,39
Linfield,8251,4,10,5,11,38,38,0,35
Cliftonville,8251,5,10,4,12,34,32,2,34
Ballymena,8251,6,7,5,14,26,48,-22,26
Glentoran,8251,7,6,6,10,24,32,-8,24
Dungannon,8251,8,2,4,16,14,47,-33,10
Crusaders,8252,1,17,6,3,62,30,32,57
Coleraine,8252,2,14,10,2,43,24,19,52
Glenavon,8252,3,10,9,7,54,43,11,39
Linfield,8252,4,10,5,11,39,40,-1,35
Cliftonville,8252,5,10,4,12,36,33,3,34
Ballymena,8252,6,7,4,15,25,48,-23,25
Glentoran,8252,7,6,6,10,24,32,-8,24
Dungannon,8252,8,2,4,16,14,47,-33,10
Crusaders,8253,1,17,6,3,62,30,32,57
Coleraine,8253,2,14,10,2,43,24,19,52
Glenavon,8253,3,10,9,7,54,43,11,39
Linfield,8253,4,10,5,11,38,38,0,35
Cliftonville,8253,5,10,4,12,34,32,2,34
Ballymena,8253,6,7,4,15,25,48,-23,25
Glentoran,8253,7,6,6,10,24,32,-8,24
Dungannon,8253,8,2,4,16,14,47,-33,10
Crusaders,8254,1,17,6,3,64,32,32,57
Coleraine,8254,2,14,10,2,45,25,20,52
Glenavon,8254,3,10,9,7,55,45,10,39
Linfield,8254,4,10,5,11,38,38,0,35
Cliftonville,8254,5,10,4,12,34,32,2,34
Ballymena,8254,6,7,4,15,27,50,-23,25
Glentoran,8254,7,6,6,10,24,32,-8,24
Dungannon,8254,8,2,4,16,14,47,-33,10
Crusaders,8255,1,17,6,3,63,30,33,57
Coleraine,8255,2,15,10,1,45,23,22,55
Glenavon,8255,3,9,9,8,53,45,8,36
Linfield,8255,4,10,5,11,37,38,-1,35
Cliftonville,8255,5,10,4,12,34,31,3,34
Ballymena,8255,6,7,4,15,25,49,-24,25
Glentoran,8255,7,6,6,10,24,32,-8,24
Dungannon,8255,8,2,4,16,14,47,-33,10
Crusaders,8256,1,16,7,3,62,31,31,55
Coleraine,8256,2,15,10,1,46,24,22,55
Linfield,8256,3,11,5,10,41,39,2,38
Glenavon,8256,4,9,9,8,54,46,8,36
Cliftonville,8256,5,9,4,13,35,35,0,31
Ballymena,8256,6,7,5,14,26,48,-22,26
Glentoran,8256,7,6,6,10,24,32,-8,24
Dungannon,8256,8,2,4,16,14,47,-33,10
Crusaders,8257,1,16,6,4,61,34,27,54
Coleraine,8257,2,14,11,1,44,23,21,53
Linfield,8257,3,11,5,10,39,37,2,38
Glenavon,8257,4,9,10,7,53,44,9,37
Cliftonville,8257,5,9,4,13,33,33,0,31
Ballymena,8257,6,8,4,14,29,47,-18,28
Glentoran,8257,7,6,6,10,24,32,-8,24
Dungannon,8257,8,2,4,16,14,47,-33,10
Crusaders,8258,1,16,7,3,64,33,31,55
Coleraine,8258,2,15,10,1,45,22,23,55
Glenavon,8258,3,9,9,8,52,45,7,36
Linfield,8258,4,10,6,10,37,36,1,36
Cliftonville,8258,5,9,5,12,32,31,1,32
Ballymena,8258,6,7,5,14,28,50,-22,26
Glentoran,8258,7,6,6,10,24,32,-8,24
Dungannon,8258,8,2,4,16,14,47,-33,10
Crusaders,8259,1,16,7,3,62,31,31,55
Coleraine,8259,2,14,11,1,43,22,21,53
Linfield,8259,3,11,5,10,39,37,2,38
Glenavon,8259,4,9,10,7,52,43,9,37
Cliftonville,8259,5,9,4,13,33,33,0,31
Ballymena,8259,6,7,5,14,26,48,-22,26
Glentoran,8259,7,6,6,10,24,32,-8,24
Dungannon,8259,8,2,4,16,14,47,-33,10
Crusaders,8260,1,16,7,3,63,32,31,55
Coleraine,8260,2,14,11,1,46,25,21,53
Glenavon,8260,3,9,10,7,55,46,9,37
Linfield,8260,4,10,6,10,37,36,1,36
Cliftonville,8260,5,9,5,12,32,31,1,32
Ballymena,8260,6,7,5,14,27,49,-22,26
Glentoran,8260,7,6,6,10,24,32,-8,24
Dungannon,8260,8,2,4,16,14,47,-33,10
Crusaders,8261,1,17,6,3,66,30,36,57
Coleraine,8261,2,14,10,2,45,25,20,52
Glenavon,8261,3,10,9,7,55,45,10,39
Linfield,8261,4,11,5,10,40,38,2,38
Cliftonville,8261,5,9,4,13,34,34,0,31
Ballymena,8261,6,7,4,15,25,52,-27,25
Glentoran,8261,7,6,6,10,24,32,-8,24
Dungannon,8261,8,2,4,16,14,47,-33,10
Coleraine,8262,1,15,10,1,46,23,23,55
Crusaders,8262,2,16,6,4,61,32,29,54
Linfield,8262,3,11,5,10,39,37,2,38
Glenavon,8262,4,9,9,8,53,46,7,36
Cliftonville,8262,5,9,4,13,33,33,0,31
Ballymena,8262,6,8,4,14,27,47,-20,28
Glentoran,8262,7,6,6,10,24,32,-8,24
Dungannon,8262,8,2,4,16,14,47,-33,10
Crusaders,8263,1,16,7,3,63,32,31,55
Coleraine,8263,2,14,11,1,44,23,21,53
Glenavon,8263,3,9,10,7,53,44,9,37
Linfield,8263,4,10,6,10,39,38,1,36
Cliftonville,8263,5,9,5,12,34,33,1,32
Ballymena,8263,6,7,5,14,27,49,-22,26
Glentoran,8263,7,6,6,10,24,32,-8,24
Dungannon,8263,8,2,4,16,14,47,-33,10
Crusaders,8264,1,17,6,3,66,33,33,57
Coleraine,8264,2,15,10,1,48,22,26,55
Glenavon,8264,3,9,9,8,52,48,4,36
Linfield,8264,4,10,6,10,38,37,1,36
Cliftonville,8264,5,9,5,12,33,32,1,32
Ballymena,8264,6,7,4,15,28,52,-24,25
Glentoran,8264,7,6,6,10,24,32,-8,24
Dungannon,8264,8,2,4,16,14,47,-33,10
Crusaders,8265,1,17,6,3,63,31,32,57
Coleraine,8265,2,14,10,2,45,25,20,52
Glenavon,8265,3,10,9,7,55,45,10,39
Linfield,8265,4,10,5,11,37,37,0,35
Cliftonville,8265,5,10,4,12,33,31,2,34
Ballymena,8265,6,7,4,15,26,49,-23,25
Glentoran,8265,7,6,6,10,24,32,-8,24
Dungannon,8265,8,2,4,16,14,47,-33,10
Crusaders,8266,1,16,6,4,62,33,29,54
Coleraine,8266,2,14,11,1,43,22,21,53
Glenavon,8266,3,9,10,7,52,43,9,37
Linfield,8266,4,10,6,10,39,38,1,36
Cliftonville,8266,5,9,5,12,34,33,1,32
Ballymena,8266,6,8,4,14,28,48,-20,28
Glentoran,8266,7,6,6,10,24,32,-8,24
Dungannon,8266,8,2,4,16,14,47,-33,10
Crusaders,8267,1,16,6,4,61,31,30,54
Coleraine,8267,2,14,10,2,45,25,20,52
Glenavon,8267,3,10,9,7,55,45,10,39
Linfield,8267,4,11,5,10,38,36,2,38
Cliftonville,8267,5,9,4,13,32,32,0,31
Ballymena,8267,6,8,4,14,26,47,-21,28
Glentoran,8267,7,6,6,10,24,32,-8,24
Dungannon,8267,8,2,4,16,14,47,-33,10
Crusaders,8268,1,17,6,3,63,31,32,57
Coleraine,8268,2,14,10,2,44,25,19,52
Glenavon,8268,3,10,9,7,55,44,11,39
Linfield,8268,4,10,5,11,38,38,0,35
Cliftonville,8268,5,10,4,12,34,32,2,34
Ballymena,8268,6,7,4,15,26,49,-23,25
Glentoran,8268,7,6,6,10,24,32,-8,24
Dungannon,8268,8,2,4,16,14,47,-33,10
Crusaders,8269,1,17,6,3,62,30,32,57
Coleraine,8269,2,14,10,2,44,24,20,52
Glenavon,8269,3,10,9,7,54,44,10,39
Linfield,8269,4,10,5,11,37,37,0,35
Cliftonville,8269,5,10,4,12,33,31,2,34
Ballymena,8269,6,7,4,15,25,48,-23,25
Glentoran,8269,7,6,6,10,24,32,-8,24
Dungannon,8269,8,2,4,16,14,47,-33,10
Crusaders,8270,1,17,6,3,63,30,33,57
Coleraine,8270,2,15,10,1,45,23,22,55
Glenavon,8270,3,9,9,8,53,45,8,36
Linfield,8270,4,10,5,11,37,39,-2,35
Cliftonville,8270,5,10,4,12,35,31,4,34
Ballymena,8270,6,7,4,15,25,49,-24,25
Glentoran,8270,7,6,6,10,24,32,-8,24
Dungannon,8270,8,2,4,16,14,47,-33,10
Crusaders,8271,1,16,6,4,61,31,30,54
Coleraine,8271,2,14,11,1,43,22,21,53
Glenavon,8271,3,9,10,7,52,43,9,37
Linfield,8271,4,10,5,11,37,37,0,35
Cliftonville,8271,5,10,4,12,33,31,2,34
Ballymena,8271,6,8,4,14,26,47,-21,28
Glentoran,8271,7,6,6,10,24,32,-8,24
Dungannon,8271,8,2,4,16,14,47,-33,10
Crusaders,8272,1,16,7,3,61,30,31,55
Coleraine,8272,2,14,11,1,46,25,21,53
Linfield,8272,3,11,5,10,39,36,3,38
Glenavon,8272,4,9,10,7,55,46,9,37
Cliftonville,8272,5,9,4,13,32,33,-1,31
Ballymena,8272,6,7,5,14,25,47,-22,26
Glentoran,8272,7,6,6,10,24,32,-8,24
Dungannon,8272,8,2,4,16,14,47,-33,10
Crusaders,8273,1,16,7,3,64,33,31,55
Coleraine,8273,2,15,10,1,45,23,22,55
Linfield,8273,3,11,5,10,40,38,2,38
Glenavon,8273,4,9,9,8,53,45,8,36
Cliftonville,8273,5,9,4,13,34,34,0,31
Ballymena,8273,6,7,5,14,28,50,-22,26
Glentoran,8273,7,6,6,10,24,32,-8,24
Dungannon,8273,8,2,4,16,14,47,-33,10
Crusaders,8274,1,17,6,3,63,30,33,57
Coleraine,8274,2,14,10,2,44,26,18,52
Glenavon,8274,3,10,9,7,56,44,12,39
Linfield,8274,4,10,6,10,38,37,1,36
Cliftonville,8274,5,9,5,12,33,32,1,32
Ballymena,8274,6,7,4,15,25,49,-24,25
Glentoran,8274,7,6,6,10,24,32,-8,24
Dungannon,8274,8,2,4,16,14,47,-33,10
Crusaders,8275,1,17,6,3,63,30,33,57
Coleraine,8275,2,14,10,2,44,25,19,52
Glenavon,8275,3,10,9,7,55,44,11,39
Linfield,8275,4,10,5,11,37,37,0,35
Cliftonville,8275,5,10,4,12,33,31,2,34
Ballymena,8275,6,7,4,15,25,49,-24,25
Glentoran,8275,7,6,6,10,24,32,-8,24
Dungannon,8275,8,2,4,16,14,47,-33,10
Crusaders,8276,1,17,6,3,62,30,32,57
Coleraine,8276,2,14,10,2,44,24,20,52
Glenavon,8276,3,10,9,7,54,44,10,39
Linfield,8276,4,11,5,10,40,36,4,38
Cliftonville,8276,5,9,4,13,32,34,-2,31
Ballymena,8276,6,7,4,15,25,48,-23,25
Glentoran,8276,7,6,6,10,24,32,-8,24
Dungannon,8276,8,2,4,16,14,47,-33,10
Crusaders,8277,1,16,7,3,62,31,31,55
Coleraine,8277,2,14,11,1,45,24,21,53
Linfield,8277,3,11,5,10,38,36,2,38
Glenavon,8277,4,9,10,7,54,45,9,37
Cliftonville,8277,5,9,4,13,32,32,0,31
Ballymena,8277,6,7,5,14,26,48,-22,26
Glentoran,8277,7,6,6,10,24,32,-8,24
Dungannon,8277,8,2,4,16,14,47,-33,10
Crusaders,8278,1,16,7,3,63,32,31,55
Coleraine,8278,2,14,10,2,45,26,19,52
Glenavon,8278,3,10,9,7,56,45,11,39
Linfield,8278,4,10,6,10,39,38,1,36
Cliftonville,8278,5,9,5,12,34,33,1,32
Ballymena,8278,6,7,5,14,27,49,-22,26
Glentoran,8278,7,6,6,10,24,32,-8,24
Dungannon,8278,8,2,4,16,14,47,-33,10
Crusaders,8279,1,17,6,3,63,31,32,57
Coleraine,8279,2,15,10,1,47,25,22,55
Linfield,8279,3,11,5,10,38,36,2,38
Glenavon,8279,4,9,9,8,55,47,8,36
Cliftonville,8279,5,9,4,13,32,32,0,31
Ballymena,8279,6,7,4,15,26,49,-23,25
Glentoran,8279,7,6,6,10,24,32,-8,24
Dungannon,8279,8,2,4,16,14,47,-33,10
Crusaders,8280,1,17,6,3,64,31,33,57
Coleraine,8280,2,14,11,1,44,23,21,53
Linfield,8280,3,11,5,10,38,36,2,38
Glenavon,8280,4,9,10,7,53,44,9,37
Cliftonville,8280,5,9,4,13,32,32,0,31
Ballymena,8280,6,7,4,15,26,50,-24,25
Glentoran,8280,7,6,6,10,24,32,-8,24
Dungannon,8280,8,2,4,16,14,47,-33,10
Crusaders,8281,1,17,6,3,64,32,32,57
Coleraine,8281,2,14,10,2,44,24,20,52
Glenavon,8281,3,10,9,7,54,44,10,39
Linfield,8281,4,11,5,10,40,37,3,38
Cliftonville,8281,5,9,4,13,33,34,-1,31
Ballymena,8281,6,7,4,15,27,50,-23,25
Glentoran,8281,7,6,6,10,24,32,-8,24
Dungannon,8281,8,2,4,16,14,47,-33,10
Crusaders,8282,1,17,6,3,63,30,33,57
Coleraine,8282,2,14,10,2,44,24,20,52
Glenavon,8282,3,10,9,7,54,44,10,39
Linfield,8282,4,11,5,10,40,36,4,38
Cliftonville,8282,5,9,4,13,32,34,-2,31
Ballymena,8282,6,7,4,15,25,49,-24,25
Glentoran,8282,7,6,6,10,24,32,-8,24
Dungannon,8282,8,2,4,16,14,47,-33,10
Coleraine,8283,1,15,10,1,47,24,23,55
Crusaders,8283,2,16,6,4,61,31,30,54
Glenavon,8283,3,9,9,8,54,47,7,36
Linfield,8283,4,10,5,11,37,38,-1,35
Cliftonville,8283,5,10,4,12,34,31,3,34
Ballymena,8283,6,8,4,14,26,47,-21,28
Glentoran,8283,7,6,6,10,24,32,-8,24
Dungannon,8283,8,2,4,16,14,47,-33,10
Crusaders,8284,1,16,7,3,63,32,31,55
Coleraine,8284,2,15,10,1,47,23,24,55
Linfield,8284,3,11,5,10,39,36,3,38
Glenavon,8284,4,9,9,8,53,47,6,36
Cliftonville,8284,5,9,4,13,32,33,-1,31
Ballymena,8284,6,7,5,14,27,49,-22,26
Glentoran,8284,7,6,6,10,24,32,-8,24
Dungannon,8284,8,2,4,16,14,47,-33,10
Crusaders,8285,1,16,6,4,62,35,27,54
Coleraine,8285,2,14,11,1,44,23,21,53
Glenavon,8285,3,9,10,7,53,44,9,37
Linfield,8285,4,10,5,11,37,39,-2,35
Cliftonville,8285,5,10,4,12,35,31,4,34
Ballymena,8285,6,8,4,14,30,48,-18,28
Glentoran,8285,7,6,6,10,24,32,-8,24
Dungannon,8285,8,2,4,16,14,47,-33,10
Crusaders,8286,1,16,7,3,61,30,31,55
Coleraine,8286,2,15,10,1,46,24,22,55
Glenavon,8286,3,9,9,8,54,46,8,36
Linfield,8286,4,10,5,11,38,39,-1,35
Cliftonville,8286,5,10,4,12,35,32,3,34
Ballymena,8286,6,7,5,14,25,47,-22,26
Glentoran,8286,7,6,6,10,24,32,-8,24
Dungannon,8286,8,2,4,16,14,47,-33,10
Crusaders,8287,1,17,6,3,65,31,34,57
Coleraine,8287,2,14,10,2,43,24,19,52
Glenavon,8287,3,10,9,7,54,43,11,39
Linfield,8287,4,10,6,10,38,37,1,36
Cliftonville,8287,5,9,5,12,33,32,1,32
Ballymena,8287,6,7,4,15,26,51,-25,25
Glentoran,8287,7,6,6,10,24,32,-8,24
Dungannon,8287,8,2,4,16,14,47,-33,10
Crusaders,8288,1,17,6,3,64,31,33,57
Coleraine,8288,2,15,10,1,46,23,23,55
Linfield,8288,3,11,5,10,40,36,4,38
Glenavon,8288,4,9,9,8,53,46,7,36
Cliftonville,8288,5,9,4,13,32,34,-2,31
Ballymena,8288,6,7,4,15,26,50,-24,25
Glentoran,8288,7,6,6,10,24,32,-8,24
Dungannon,8288,8,2,4,16,14,47,-33,10
Crusaders,8289,1,16,7,3,61,30,31,55
Coleraine,8289,2,14,11,1,43,22,21,53
Linfield,8289,3,11,5,10,39,37,2,38
Glenavon,8289,4,9,10,7,52,43,9,37
Cliftonville,8289,5,9,4,13,33,33,0,31
Ballymena,8289,6,7,5,14,25,47,-22,26
Glentoran,8289,7,6,6,10,24,32,-8,24
Dungannon,8289,8,2,4,16,14,47,-33,10
Crusaders,8290,1,17,6,3,65,32,33,57
Coleraine,8290,2,15,10,1,46,23,23,55
Linfield,8290,3,11,5,10,42,36,6,38
Glenavon,8290,4,9,9,8,53,46,7,36
Cliftonville,8290,5,9,4,13,32,36,-4,31
Ballymena,8290,6,7,4,15,27,51,-24,25
Glentoran,8290,7,6,6,10,24,32,-8,24
Dungannon,8290,8,2,4,16,14,47,-33,10
Coleraine,8291,1,15,10,1,45,23,22,55
Crusaders,8291,2,16,6,4,63,33,30,54
Glenavon,8291,3,9,9,8,53,45,8,36
Linfield,8291,4,10,5,11,37,37,0,35
Cliftonville,8291,5,10,4,12,33,31,2,34
Ballymena,8291,6,8,4,14,28,49,-21,28
Glentoran,8291,7,6,6,10,24,32,-8,24
Dungannon,8291,8,2,4,16,14,47,-33,10
Crusaders,8292,1,17,6,3,63,30,33,57
Coleraine,8292,2,14,11,1,45,24,21,53
Linfield,8292,3,11,5,10,39,36,3,38
Glenavon,8292,4,9,10,7,54,45,9,37
Cliftonville,8292,5,9,4,13,32,33,-1,31
Ballymena,8292,6,7,4,15,25,49,-24,25
Glentoran,8292,7,6,6,10,24,32,-8,24
Dungannon,8292,8,2,4,16,14,47,-33,10
Crusaders,8293,1,16,7,3,63,32,31,55
Coleraine,8293,2,14,11,1,43,22,21,53
Glenavon,8293,3,9,10,7,52,43,9,37
Linfield,8293,4,10,6,10,38,37,1,36
Cliftonville,8293,5,9,5,12,33,32,1,32
Ballymena,8293,6,7,5,14,27,49,-22,26
Glentoran,8293,7,6,6,10,24,32,-8,24
Dungannon,8293,8,2,4,16,14,47,-33,10
Crusaders,8294,1,16,7,3,64,33,31,55
Coleraine,8294,2,14,10,2,44,25,19,52
Glenavon,8294,3,10,9,7,55,44,11,39
Linfield,8294,4,11,5,10,38,36,2,38
Cliftonville,8294,5,9,4,13,32,32,0,31
Ballymena,8294,6,7,5,14,28,50,-22,26
Glentoran,8294,7,6,6,10,24,32,-8,24
Dungannon,8294,8,2,4,16,14,47,-33,10
Crusaders,8295,1,17,6,3,66,30,36,57
Coleraine,8295,2,14,10,2,43,23,20,52
Glenavon,8295,3,10,9,7,53,43,10,39
Linfield,8295,4,11,5,10,41,36,5,38
Cliftonville,8295,5,9,4,13,32,35,-3,31
Ballymena,8295,6,7,4,15,25,52,-27,25
Glentoran,8295,7,6,6,10,24,32,-8,24
Dungannon,8295,8,2,4,16,14,47,-33,10
Crusaders,8296,1,16,7,3,62,31,31,55
Coleraine,8296,2,15,10,1,45,23,22,55
Glenavon,8296,3,9,9,8,53,45,8,36
Linfield,8296,4,10,6,10,39,38,1,36
Cliftonville,8296,5,9,5,12,34,33,1,32
Ballymena,8296,6,7,5,14,26,48,-22,26
Glentoran,8296,7,6,6,10,24,32,-8,24
Dungannon,8296,8,2,4,16,14,47,-33,10
Crusaders,8297,1,16,7,3,62,31,31,55
Coleraine,8297,2,14,10,2,45,25,20,52
Glenavon,8297,3,10,9,7,55,45,10,39
Linfield,8297,4,11,5,10,38,36,2,38
Cliftonville,8297,5,9,4,13,32,32,0,31
Ballymena,8297,6,7,5,14,26,48,-22,26
Glentoran,8297,7,6,6,10,24,32,-8,24
Dungannon,8297,8,2,4,16,14,47,-33,10
Crusaders,8298,1,16,6,4,61,31,30,54
Coleraine,8298,2,14,11,1,44,23,21,53
Glenavon,8298,3,9,10,7,53,44,9,37
Linfield,8298,4,10,5,11,39,39,0,35
Cliftonville,8298,5,10,4,12,35,33,2,34
Ballymena,8298,6,8,4,14,26,47,-21,28
Glentoran,8298,7,6,6,10,24,32,-8,24
Dungannon,8298,8,2,4,16,14,47,-33,10
Crusaders,8299,1,17,6,3,62,30,32,57
Coleraine,8299,2,14,10,2,43,23,20,52
Glenavon,8299,3,10,9,7,53,43,10,39
Linfield,8299,4,11,5,10,40,36,4,38
Cliftonville,8299,5,9,4,13,32,34,-2,31
Ballymena,8299,6,7,4,15,25,48,-23,25
Glentoran,8299,7,6,6,10,24,32,-8,24
Dungannon,8299,8,2,4,16,14,47,-33,10
Crusaders,8300,1,16,6,4,62,33,29,54
Coleraine,8300,2,14,11,1,44,23,21,53
Glenavon,8300,3,9,10,7,53,44,9,37
Linfield,8300,4,10,5,11,37,37,0,35
Cliftonville,8300,5,10,4,12,33,31,2,34
Ballymena,8300,6,8,4,14,28,48,-20,28
Glentoran,8300,7,6,6,10,24,32,-8,24
Dungannon,8300,8,2,4,16,14,47,-33,10
Crusaders,8301,1,17,6,3,62,30,32,57
Coleraine,8301,2,15,10,1,44,22,22,55
Glenavon,8301,3,9,9,8,52,44,8,36
Linfield,8301,4,10,6,10,38,37,1,36
Cliftonville,8301,5,9,5,12,33,32,1,32
Ballymena,8301,6,7,4,15,25,48,-23,25
Glentoran,8301,7,6,6,10,24,32,-8,24
Dungannon,8301,8,2,4,16,14,47,-33,10
Coleraine,8302,1,15,10,1,45,22,23,55
Crusaders,8302,2,16,6,4,61,31,30,54
Linfield,8302,3,11,5,10,40,37,3,38
Glenavon,8302,4,9,9,8,52,45,7,36
Cliftonville,8302,5,9,4,13,33,34,-1,31
Ballymena,8302,6,8,4,14,26,47,-21,28
Glentoran,8302,7,6,6,10,24,32,-8,24
Dungannon,8302,8,2,4,16,14,47,-33,10
Crusaders,8303,1,17,6,3,64,32,32,57
Coleraine,8303,2,14,11,1,44,23,21,53
Glenavon,8303,3,9,10,7,53,44,9,37
Linfield,8303,4,10,6,10,38,37,1,36
Cliftonville,8303,5,9,5,12,33,32,1,32
Ballymena,8303,6,7,4,15,27,50,-23,25
Glentoran,8303,7,6,6,10,24,32,-8,24
Dungannon,8303,8,2,4,16,14,47,-33,10
Crusaders,8304,1,17,6,3,64,30,34,57
Coleraine,8304,2,14,11,1,45,24,21,53
Linfield,8304,3,11,5,10,40,36,4,38
Glenavon,8304,4,9,10,7,54,45,9,37
Cliftonville,8304,5,9,4,13,32,34,-2,31
Ballymena,8304,6,7,4,15,25,50,-25,25
Glentoran,8304,7,6,6,10,24,32,-8,24
Dungannon,8304,8,2,4,16,14,47,-33,10
Crusaders,8305,1,17,6,3,64,32,32,57
Coleraine,8305,2,14,11,1,44,23,21,53
Glenavon,8305,3,9,10,7,53,44,9,37
Linfield,8305,4,10,6,10,38,37,1,36
Cliftonville,8305,5,9,5,12,33,32,1,32
Ballymena,8305,6,7,4,15,27,50,-23,25
Glentoran,8305,7,6,6,10,24,32,-8,24
Dungannon,8305,8,2,4,16,14,47,-33,10
Crusaders,8306,1,17,6,3,62,30,32,57
Coleraine,8306,2,14,10,2,43,23,20,52
Glenavon,8306,3,10,9,7,53,43,10,39
Linfield,8306,4,11,5,10,38,36,2,38
Cliftonville,8306,5,9,4,13,32,32,0,31
Ballymena,8306,6,7,4,15,25,48,-23,25
Glentoran,8306,7,6,6,10,24,32,-8,24
Dungannon,8306,8,2,4,16,14,47,-33,10
Crusaders,8307,1,17,6,3,63,30,33,57
Coleraine,8307,2,14,10,2,45,25,20,52
Glenavon,8307,3,10,9,7,55,45,10,39
Linfield,8307,4,10,6,10,37,36,1,36
Cliftonville,8307,5,9,5,12,32,31,1,32
Ballymena,8307,6,7,4,15,25,49,-24,25
Glentoran,8307,7,6,6,10,24,32,-8,24
Dungannon,8307,8,2,4,16,14,47,-33,10
Crusaders,8308,1,17,6,3,63,31,32,57
Coleraine,8308,2,14,10,2,44,24,20,52
Glenavon,8308,3,10,9,7,54,44,10,39
Linfield,8308,4,11,5,10,41,36,5,38
Cliftonville,8308,5,9,4,13,32,35,-3,31
Ballymena,8308,6,7,4,15,26,49,-23,25
Glentoran,8308,7,6,6,10,24,32,-8,24
Dungannon,8308,8,2,4,16,14,47,-33,10
Crusaders,8309,1,17,6,3,62,30,32,57
Coleraine,8309,2,14,10,2,43,24,19,52
Glenavon,8309,3,10,9,7,54,43,11,39
Linfield,8309,4,10,5,11,37,37,0,35
Cliftonville,8309,5,10,4,12,33,31,2,34
Ballymena,8309,6,7,4,15,25,48,-23,25
Glentoran,8309,7,6,6,10,24,32,-8,24
Dungannon,8309,8,2,4,16,14,47,-33,10
Crusaders,8310,1,16,6,4,61,31,30,54
Coleraine,8310,2,14,10,2,44,25,19,52
Glenavon,8310,3,10,9,7,55,44,11,39
Linfield,8310,4,11,5,10,38,36,2,38
Cliftonville,8310,5,9,4,13,32,32,0,31
Ballymena,8310,6,8,4,14,26,47,-21,28
Glentoran,8310,7,6,6,10,24,32,-8,24
Dungannon,8310,8,2,4,16,14,47,-33,10
Crusaders,8311,1,17,6,3,66,31,35,57
Coleraine,8311,2,14,10,2,44,24,20,52
Glenavon,8311,3,10,9,7,54,44,10,39
Linfield,8311,4,11,5,10,40,37,3,38
Cliftonville,8311,5,9,4,13,33,34,-1,31
Ballymena,8311,6,7,4,15,26,52,-26,25
Glentoran,8311,7,6,6,10,24,32,-8,24
Dungannon,8311,8,2,4,16,14,47,-33,10
Crusaders,8312,1,16,7,3,62,31,31,55
Coleraine,8312,2,15,10,1,45,23,22,55
Linfield,8312,3,11,5,10,40,38,2,38
Glenavon,8312,4,9,9,8,53,45,8,36
Cliftonville,8312,5,9,4,13,34,34,0,31
Ballymena,8312,6,7,5,14,26,48,-22,26
Glentoran,8312,7,6,6,10,24,32,-8,24
Dungannon,8312,8,2,4,16,14,47,-33,10
Crusaders,8313,1,17,6,3,64,32,32,57
Coleraine,8313,2,14,10,2,43,23,20,52
Glenavon,8313,3,10,9,7,53,43,10,39
Linfield,8313,4,11,5,10,39,37,2,38
Cliftonville,8313,5,9,4,13,33,33,0,31
Ballymena,8313,6,7,4,15,27,50,-23,25
Glentoran,8313,7,6,6,10,24,32,-8,24
Dungannon,8313,8,2,4,16,14,47,-33,10
Coleraine,8314,1,15,10,1,44,22,22,55
Crusaders,8314,2,16,6,4,63,33,30,54
Linfield,8314,3,11,5,10,39,37,2,38
Glenavon,8314,4,9,9,8,52,44,8,36
Cliftonville,8314,5,9,4,13,33,33,0,31
Ballymena,8314,6,8,4,14,28,49,-21,28
Glentoran,8314,7,6,6,10,24,32,-8,24
Dungannon,8314,8,2,4,16,14,47,-33,10
Crusaders,8315,1,17,6,3,65,33,32,57
Coleraine,8315,2,14,10,2,44,24,20,52
Glenavon,8315,3,10,9,7,54,44,10,39
Linfield,8315,4,10,6,10,37,36,1,36
Cliftonville,8315,5,9,5,12,32,31,1,32
Ballymena,8315,6,7,4,15,28,51,-23,25
Glentoran,8315,7,6,6,10,24,32,-8,24
Dungannon,8315,8,2,4,16,14,47,-33,10
Crusaders,8316,1,17,6,3,63,31,32,57
Coleraine,8316,2,14,11,1,43,22,21,53
Linfield,8316,3,11,5,10,40,37,3,38
Glenavon,8316,4,9,10,7,52,43,9,37
Cliftonville,8316,5,9,4,13,33,34,-1,31
Ballymena,8316,6,7,4,15,26,49,-23,25
Glentoran,8316,7,6,6,10,24,32,-8,24
Dungannon,8316,8,2,4,16,14,47,-33,10
Crusaders,8317,1,16,7,3,62,31,31,55
Coleraine,8317,2,14,11,1,44,23,21,53
Glenavon,8317,3,9,10,7,53,44,9,37
Linfield,8317,4,10,6,10,38,37,1,36
Cliftonville,8317,5,9,5,12,33,32,1,32
Ballymena,8317,6,7,5,14,26,48,-22,26
Glentoran,8317,7,6,6,10,24,32,-8,24
Dungannon,8317,8,2,4,16,14,47,-33,10
Crusaders,8318,1,17,6,3,64,31,33,57
Coleraine,8318,2,14,11,1,44,23,21,53
Glenavon,8318,3,9,10,7,53,44,9,37
Linfield,8318,4,10,5,11,37,37,0,35
Cliftonville,8318,5,10,4,12,33,31,2,34
Ballymena,8318,6,7,4,15,26,50,-24,25
Glentoran,8318,7,6,6,10,24,32,-8,24
Dungannon,8318,8,2,4,16,14,47,-33,10
Crusaders,8319,1,17,6,3,63,30,33,57
Coleraine,8319,2,14,10,2,44,25,19,52
Glenavon,8319,3,10,9,7,55,44,11,39
Linfield,8319,4,11,5,10,39,37,2,38
Cliftonville,8319,5,9,4,13,33,33,0,31
Ballymena,8319,6,7,4,15,25,49,-24,25
Glentoran,8319,7,6,6,10,24,32,-8,24
Dungannon,8319,8,2,4,16,14,47,-33,10
Crusaders,8320,1,17,6,3,62,30,32,57
Coleraine,8320,2,15,10,1,46,24,22,55
Glenavon,8320,3,9,9,8,54,46,8,36
Linfield,8320,4,10,6,10,39,38,1,36
Cliftonville,8320,5,9,5,12,34,33,1,32
Ballymena,8320,6,7,4,15,25,48,-23,25
Glentoran,8320,7,6,6,10,24,32,-8,24
Dungannon,8320,8,2,4,16,14,47,-33,10
Crusaders,8321,1,16,7,3,62,31,31,55
Coleraine,8321,2,14,11,1,43,22,21,53
Glenavon,8321,3,9,10,7,52,43,9,37
Linfield,8321,4,10,6,10,38,37,1,36
Cliftonville,8321,5,9,5,12,33,32,1,32
Ballymena,8321,6,7,5,14,26,48,-22,26
Glentoran,8321,7,6,6,10,24,32,-8,24
Dungannon,8321,8,2,4,16,14,47,-33,10
Coleraine,8322,1,15,10,1,46,22,24,55
Crusaders,8322,2,16,6,4,61,32,29,54
Linfield,8322,3,11,5,10,38,36,2,38
Glenavon,8322,4,9,9,8,52,46,6,36
Cliftonville,8322,5,9,4,13,32,32,0,31
Ballymena,8322,6,8,4,14,27,47,-20,28
Glentoran,8322,7,6,6,10,24,32,-8,24
Dungannon,8322,8,2,4,16,14,47,-33,10
Crusaders,8323,1,17,6,3,63,31,32,57
Coleraine,8323,2,14,11,1,44,23,21,53
Glenavon,8323,3,9,10,7,53,44,9,37
Linfield,8323,4,10,6,10,38,37,1,36
Cliftonville,8323,5,9,5,12,33,32,1,32
Ballymena,8323,6,7,4,15,26,49,-23,25
Glentoran,8323,7,6,6,10,24,32,-8,24
Dungannon,8323,8,2,4,16,14,47,-33,10
Coleraine,8324,1,15,10,1,45,23,22,55
Crusaders,8324,2,16,6,4,62,33,29,54
Glenavon,8324,3,9,9,8,53,45,8,36
Linfield,8324,4,10,6,10,39,38,1,36
Cliftonville,8324,5,9,5,12,34,33,1,32
Ballymena,8324,6,8,4,14,28,48,-20,28
Glentoran,8324,7,6,6,10,24,32,-8,24
Dungannon,8324,8,2,4,16,14,47,-33,10
Crusaders,8325,1,16,7,3,61,30,31,55
Coleraine,8325,2,14,11,1,44,23,21,53
Linfield,8325,3,11,5,10,38,36,2,38
Glenavon,8325,4,9,10,7,53,44,9,37
Cliftonville,8325,5,9,4,13,32,32,0,31
Ballymena,8325,6,7,5,14,25,47,-22,26
Glentoran,8325,7,6,6,10,24,32,-8,24
Dungannon,8325,8,2,4,16,14,47,-33,10
Crusaders,8326,1,17,6,3,64,31,33,57
Coleraine,8326,2,15,10,1,44,22,22,55
Linfield,8326,3,11,5,10,40,37,3,38
Glenavon,8326,4,9,9,8,52,44,8,36
Cliftonville,8326,5,9,4,13,33,34,-1,31
Ballymena,8326,6,7,4,15,26,50,-24,25
Glentoran,8326,7,6,6,10,24,32,-8,24
Dungannon,8326,8,2,4,16,14,47,-33,10
Crusaders,8327,1,17,6,3,63,31,32,57
Coleraine,8327,2,15,10,1,44,22,22,55
Glenavon,8327,3,9,9,8,52,44,8,36
Linfield,8327,4,10,5,11,37,37,0,35
Cliftonville,8327,5,10,4,12,33,31,2,34
Ballymena,8327,6,7,4,15,26,49,-23,25
Glentoran,8327,7,6,6,10,24,32,-8,24
Dungannon,8327,8,2,4,16,14,47,-33,10
Crusaders,8328,1,17,6,3,65,32,33,57
Coleraine,8328,2,15,10,1,44,22,22,55
Linfield,8328,3,11,5,10,40,38,2,38
Glenavon,8328,4,9,9,8,52,44,8,36
Cliftonville,8328,5,9,4,13,34,34,0,31
Ballymena,8328,6,7,4,15,27,51,-24,25
Glentoran,8328,7,6,6,10,24,32,-8,24
Dungannon,8328,8,2,4,16,14,47,-33,10
Crusaders,8329,1,17,6,3,64,30,34,57
Coleraine,8329,2,14,10,2,44,24,20,52
Glenavon,8329,3,10,9,7,54,44,10,39
Linfield,8329,4,11,5,10,39,36,3,38
Cliftonville,8329,5,9,4,13,32,33,-1,31
Ballymena,8329,6,7,4,15,25,50,-25,25
Glentoran,8329,7,6,6,10,24,32,-8,24
Dungannon,8329,8,2,4,16,14,47,-33,10
Crusaders,8330,1,17,6,3,64,31,33,57
Coleraine,8330,2,14,10,2,45,25,20,52
Glenavon,8330,3,10,9,7,55,45,10,39
Linfield,8330,4,10,5,11,37,37,0,35
Cliftonville,8330,5,10,4,12,33,31,2,34
Ballymena,8330,6,7,4,15,26,50,-24,25
Glentoran,8330,7,6,6,10,24,32,-8,24
Dungannon,8330,8,2,4,16,14,47,-33,10
Crusaders,8331,1,16,7,3,63,32,31,55
Coleraine,8331,2,14,10,2,44,26,18,52
Glenavon,8331,3,10,9,7,56,44,12,39
Linfield,8331,4,10,6,10,38,37,1,36
Cliftonville,8331,5,9,5,12,33,32,1,32
Ballymena,8331,6,7,5,14,27,49,-22,26
Glentoran,8331,7,6,6,10,24,32,-8,24
Dungannon,8331,8,2,4,16,14,47,-33,10
Crusaders,8332,1,17,6,3,63,30,33,57
Coleraine,8332,2,15,10,1,46,22,24,55
Glenavon,8332,3,9,9,8,52,46,6,36
Linfield,8332,4,10,5,11,37,37,0,35
Cliftonville,8332,5,10,4,12,33,31,2,34
Ballymena,8332,6,7,4,15,25,49,-24,25
Glentoran,8332,7,6,6,10,24,32,-8,24
Dungannon,8332,8,2,4,16,14,47,-33,10
Crusaders,8333,1,16,7,3,62,31,31,55
Coleraine,8333,2,14,11,1,45,24,21,53
Glenavon,8333,3,9,10,7,54,45,9,37
Linfield,8333,4,10,5,11,38,38,0,35
Cliftonville,8333,5,10,4,12,34,32,2,34
Ballymena,8333,6,7,5,14,26,48,-22,26
Glentoran,8333,7,6,6,10,24,32,-8,24
Dungannon,8333,8,2,4,16,14,47,-33,10
Crusaders,8334,1,17,6,3,64,32,32,57
Coleraine,8334,2,14,10,2,45,26,19,52
Glenavon,8334,3,10,9,7,56,45,11,39
Linfield,8334,4,11,5,10,39,37,2,38
Cliftonville,8334,5,9,4,13,33,33,0,31
Ballymena,8334,6,7,4,15,27,50,-23,25
Glentoran,8334,7,6,6,10,24,32,-8,24
Dungannon,8334,8,2,4,16,14,47,-33,10
Crusaders,8335,1,17,6,3,62,30,32,57
Coleraine,8335,2,15,10,1,46,22,24,55
Glenavon,8335,3,9,9,8,52,46,6,36
Linfield,8335,4,10,5,11,37,39,-2,35
Cliftonville,8335,5,10,4,12,35,31,4,34
Ballymena,8335,6,7,4,15,25,48,-23,25
Glentoran,8335,7,6,6,10,24,32,-8,24
Dungannon,8335,8,2,4,16,14,47,-33,10
Crusaders,8336,1,17,6,3,65,31,34,57
Coleraine,8336,2,15,10,1,44,22,22,55
Linfield,8336,3,11,5,10,39,37,2,38
Glenavon,8336,4,9,9,8,52,44,8,36
Cliftonville,8336,5,9,4,13,33,33,0,31
Ballymena,8336,6,7,4,15,26,51,-25,25
Glentoran,8336,7,6,6,10,24,32,-8,24
Dungannon,8336,8,2,4,16,14,47,-33,10
Crusaders,8337,1,17,6,3,67,33,34,57
Coleraine,8337,2,14,10,2,44,24,20,52
Glenavon,8337,3,10,9,7,54,44,10,39
Linfield,8337,4,11,5,10,39,36,3,38
Cliftonville,8337,5,9,4,13,32,33,-1,31
Ballymena,8337,6,7,4,15,28,53,-25,25
Glentoran,8337,7,6,6,10,24,32,-8,24
Dungannon,8337,8,2,4,16,14,47,-33,10
Crusaders,8338,1,17,6,3,62,30,32,57
Coleraine,8338,2,14,10,2,44,25,19,52
Glenavon,8338,3,10,9,7,55,44,11,39
Linfield,8338,4,10,6,10,37,36,1,36
Cliftonville,8338,5,9,5,12,32,31,1,32
Ballymena,8338,6,7,4,15,25,48,-23,25
Glentoran,8338,7,6,6,10,24,32,-8,24
Dungannon,8338,8,2,4,16,14,47,-33,10
Crusaders,8339,1,17,6,3,63,30,33,57
Coleraine,8339,2,15,10,1,46,22,24,55
Linfield,8339,3,11,5,10,40,37,3,38
Glenavon,8339,4,9,9,8,52,46,6,36
Cliftonville,8339,5,9,4,13,33,34,-1,31
Ballymena,8339,6,7,4,15,25,49,-24,25
Glentoran,8339,7,6,6,10,24,32,-8,24
Dungannon,8339,8,2,4,16,14,47,-33,10
Crusaders,8340,1,17,6,3,63,31,32,57
Coleraine,8340,2,14,10,2,44,24,20,52
Glenavon,8340,3,10,9,7,54,44,10,39
Linfield,8340,4,11,5,10,38,36,2,38
Cliftonville,8340,5,9,4,13,32,32,0,31
Ballymena,8340,6,7,4,15,26,49,-23,25
Glentoran,8340,7,6,6,10,24,32,-8,24
Dungannon,8340,8,2,4,16,14,47,-33,10
Coleraine,8341,1,15,10,1,45,23,22,55
Crusaders,8341,2,16,6,4,62,32,30,54
Glenavon,8341,3,9,9,8,53,45,8,36
Linfield,8341,4,10,5,11,38,38,0,35
Cliftonville,8341,5,10,4,12,34,32,2,34
Ballymena,8341,6,8,4,14,27,48,-21,28
Glentoran,8341,7,6,6,10,24,32,-8,24
Dungannon,8341,8,2,4,16,14,47,-33,10
Crusaders,8342,1,17,6,3,66,31,35,57
Coleraine,8342,2,14,10,2,43,23,20,52
Glenavon,8342,3,10,9,7,53,43,10,39
Linfield,8342,4,10,6,10,39,38,1,36
Cliftonville,8342,5,9,5,12,34,33,1,32
Ballymena,8342,6,7,4,15,26,52,-26,25
Glentoran,8342,7,6,6,10,24,32,-8,24
Dungannon,8342,8,2,4,16,14,47,-33,10
Crusaders,8343,1,17,6,3,64,31,33,57
Coleraine,8343,2,14,11,1,44,23,21,53
Glenavon,8343,3,9,10,7,53,44,9,37
Linfield,8343,4,10,5,11,38,38,0,35
Cliftonville,8343,5,10,4,12,34,32,2,34
Ballymena,8343,6,7,4,15,26,50,-24,25
Glentoran,8343,7,6,6,10,24,32,-8,24
Dungannon,8343,8,2,4,16,14,47,-33,10
Crusaders,8344,1,16,6,4,62,33,29,54
Coleraine,8344,2,14,11,1,44,23,21,53
Glenavon,8344,3,9,10,7,53,44,9,37
Linfield,8344,4,10,5,11,37,39,-2,35
Cliftonville,8344,5,10,4,12,35,31,4,34
Ballymena,8344,6,8,4,14,28,48,-20,28
Glentoran,8344,7,6,6,10,24,32,-8,24
Dungannon,8344,8,2,4,16,14,47,-33,10
Crusaders,8345,1,16,6,4,62,33,29,54
Coleraine,8345,2,14,11,1,47,26,21,53
Glenavon,8345,3,9,10,7,56,47,9,37
Linfield,8345,4,10,5,11,37,38,-1,35
Cliftonville,8345,5,10,4,12,34,31,3,34
Ballymena,8345,6,8,4,14,28,48,-20,28
Glentoran,8345,7,6,6,10,24,32,-8,24
Dungannon,8345,8,2,4,16,14,47,-33,10
Crusaders,8346,1,16,7,3,64,33,31,55
Coleraine,8346,2,15,10,1,45,23,22,55
Glenavon,8346,3,9,9,8,53,45,8,36
Linfield,8346,4,10,5,11,38,38,0,35
Cliftonville,8346,5,10,4,12,34,32,2,34
Ballymena,8346,6,7,5,14,28,50,-22,26
Glentoran,8346,7,6,6,10,24,32,-8,24
Dungannon,8346,8,2,4,16,14,47,-33,10
Crusaders,8347,1,16,7,3,62,31,31,55
Coleraine,8347,2,14,10,2,44,26,18,52
Glenavon,8347,3,10,9,7,56,44,12,39
Linfield,8347,4,11,5,10,41,38,3,38
Cliftonville,8347,5,9,4,13,34,35,-1,31
Ballymena,8347,6,7,5,14,26,48,-22,26
Glentoran,8347,7,6,6,10,24,32,-8,24
Dungannon,8347,8,2,4,16,14,47,-33,10
Crusaders,8348,1,17,6,3,64,31,33,57
Coleraine,8348,2,14,10,2,46,26,20,52
Glenavon,8348,3,10,9,7,56,46,10,39
Linfield,8348,4,10,6,10,39,38,1,36
Cliftonville,8348,5,9,5,12,34,33,1,32
Ballymena,8348,6,7,4,15,26,50,-24,25
Glentoran,8348,7,6,6,10,24,32,-8,24
Dungannon,8348,8,2,4,16,14,47,-33,10
Crusaders,8349,1,17,6,3,64,32,32,57
Coleraine,8349,2,14,11,1,44,23,21,53
Glenavon,8349,3,9,10,7,53,44,9,37
Linfield,8349,4,10,5,11,37,38,-1,35
Cliftonville,8349,5,10,4,12,34,31,3,34
Ballymena,8349,6,7,4,15,27,50,-23,25
Glentoran,8349,7,6,6,10,24,32,-8,24
Dungannon,8349,8,2,4,16,14,47,-33,10
Crusaders,8350,1,16,7,3,62,31,31,55
Coleraine,8350,2,14,10,2,44,24,20,52
Glenavon,8350,3,10,9,7,54,44,10,39
Linfield,8350,4,11,5,10,39,37,2,38
Cliftonville,8350,5,9,4,13,33,33,0,31
Ballymena,8350,6,7,5,14,26,48,-22,26
Glentoran,8350,7,6,6,10,24,32,-8,24
Dungannon,8350,8,2,4,16,14,47,-33,10
Crusaders,8351,1,16,7,3,63,32,31,55
Coleraine,8351,2,14,10,2,44,25,19,52
Glenavon,8351,3,10,9,7,55,44,11,39
Linfield,8351,4,10,5,11,38,38,0,35
Cliftonville,8351,5,10,4,12,34,32,2,34
Ballymena,8351,6,7,5,14,27,49,-22,26
Glentoran,8351,7,6,6,10,24,32,-8,24
Dungannon,8351,8,2,4,16,14,47,-33,10
Crusaders,8352,1,16,7,3,64,33,31,55
Coleraine,8352,2,15,10,1,45,22,23,55
Linfield,8352,3,11,5,10,39,37,2,38
Glenavon,8352,4,9,9,8,52,45,7,36
Cliftonville,8352,5,9,4,13,33,33,0,31
Ballymena,8352,6,7,5,14,28,50,-22,26
Glentoran,8352,7,6,6,10,24,32,-8,24
Dungannon,8352,8,2,4,16,14,47,-33,10
Crusaders,8353,1,17,6,3,66,30,36,57
Coleraine,8353,2,14,11,1,44,23,21,53
Linfield,8353,3,11,5,10,40,37,3,38
Glenavon,8353,4,9,10,7,53,44,9,37
Cliftonville,8353,5,9,4,13,33,34,-1,31
Ballymena,8353,6,7,4,15,25,52,-27,25
Glentoran,8353,7,6,6,10,24,32,-8,24
Dungannon,8353,8,2,4,16,14,47,-33,10
Crusaders,8354,1,17,6,3,63,30,33,57
Coleraine,8354,2,14,11,1,44,23,21,53
Glenavon,8354,3,9,10,7,53,44,9,37
Linfield,8354,4,10,6,10,37,36,1,36
Cliftonville,8354,5,9,5,12,32,31,1,32
Ballymena,8354,6,7,4,15,25,49,-24,25
Glentoran,8354,7,6,6,10,24,32,-8,24
Dungannon,8354,8,2,4,16,14,47,-33,10
Crusaders,8355,1,16,7,3,62,31,31,55
Coleraine,8355,2,15,10,1,46,23,23,55
Glenavon,8355,3,9,9,8,53,46,7,36
Linfield,8355,4,10,5,11,37,38,-1,35
Cliftonville,8355,5,10,4,12,34,31,3,34
Ballymena,8355,6,7,5,14,26,48,-22,26
Glentoran,8355,7,6,6,10,24,32,-8,24
Dungannon,8355,8,2,4,16,14,47,-33,10
Crusaders,8356,1,17,6,3,66,31,35,57
Coleraine,8356,2,15,10,1,45,23,22,55
Glenavon,8356,3,9,9,8,53,45,8,36
Linfield,8356,4,10,5,11,37,37,0,35
Cliftonville,8356,5,10,4,12,33,31,2,34
Ballymena,8356,6,7,4,15,26,52,-26,25
Glentoran,8356,7,6,6,10,24,32,-8,24
Dungannon,8356,8,2,4,16,14,47,-33,10
Crusaders,8357,1,16,7,3,61,30,31,55
Coleraine,8357,2,15,10,1,44,22,22,55
Glenavon,8357,3,9,9,8,52,44,8,36
Linfield,8357,4,10,5,11,39,39,0,35
Cliftonville,8357,5,10,4,12,35,33,2,34
Ballymena,8357,6,7,5,14,25,47,-22,26
Glentoran,8357,7,6,6,10,24,32,-8,24
Dungannon,8357,8,2,4,16,14,47,-33,10
Crusaders,8358,1,17,6,3,64,31,33,57
Coleraine,8358,2,14,10,2,45,25,20,52
Glenavon,8358,3,10,9,7,55,45,10,39
Linfield,8358,4,11,5,10,41,37,4,38
Cliftonville,8358,5,9,4,13,33,35,-2,31
Ballymena,8358,6,7,4,15,26,50,-24,25
Glentoran,8358,7,6,6,10,24,32,-8,24
Dungannon,8358,8,2,4,16,14,47,-33,10
Crusaders,8359,1,16,7,3,61,30,31,55
Coleraine,8359,2,14,11,1,44,23,21,53
Linfield,8359,3,11,5,10,38,36,2,38
Glenavon,8359,4,9,10,7,53,44,9,37
Cliftonville,8359,5,9,4,13,32,32,0,31
Ballymena,8359,6,7,5,14,25,47,-22,26
Glentoran,8359,7,6,6,10,24,32,-8,24
Dungannon,8359,8,2,4,16,14,47,-33,10
Crusaders,8360,1,16,7,3,62,31,31,55
Coleraine,8360,2,14,11,1,44,23,21,53
Linfield,8360,3,11,5,10,40,37,3,38
Glenavon,8360,4,9,10,7,53,44,9,37
Cliftonville,8360,5,9,4,13,33,34,-1,31
Ballymena,8360,6,7,5,14,26,48,-22,26
Glentoran,8360,7,6,6,10,24,32,-8,24
Dungannon,8360,8,2,4,16,14,47,-33,10
Crusaders,8361,1,16,7,3,62,31,31,55
Coleraine,8361,2,14,10,2,44,24,20,52
Glenavon,8361,3,10,9,7,54,44,10,39
Linfield,8361,4,10,5,11,37,37,0,35
Cliftonville,8361,5,10,4,12,33,31,2,34
Ballymena,8361,6,7,5,14,26,48,-22,26
Glentoran,8361,7,6,6,10,24,32,-8,24
Dungannon,8361,8,2,4,16,14,47,-33,10
Crusaders,8362,1,17,6,3,65,32,33,57
Coleraine,8362,2,14,10,2,43,24,19,52
Glenavon,8362,3,10,9,7,54,43,11,39
Linfield,8362,4,11,5,10,38,36,2,38
Cliftonville,8362,5,9,4,13,32,32,0,31
Ballymena,8362,6,7,4,15,27,51,-24,25
Glentoran,8362,7,6,6,10,24,32,-8,24
Dungannon,8362,8,2,4,16,14,47,-33,10
Crusaders,8363,1,16,7,3,62,31,31,55
Coleraine,8363,2,15,10,1,45,23,22,55
Glenavon,8363,3,9,9,8,53,45,8,36
Linfield,8363,4,10,5,11,38,39,-1,35
Cliftonville,8363,5,10,4,12,35,32,3,34
Ballymena,8363,6,7,5,14,26,48,-22,26
Glentoran,8363,7,6,6,10,24,32,-8,24
Dungannon,8363,8,2,4,16,14,47,-33,10
Crusaders,8364,1,16,6,4,62,34,28,54
Coleraine,8364,2,14,10,2,43,24,19,52
Glenavon,8364,3,10,9,7,54,43,11,39
Linfield,8364,4,10,5,11,37,37,0,35
Cliftonville,8364,5,10,4,12,33,31,2,34
Ballymena,8364,6,8,4,14,29,48,-19,28
Glentoran,8364,7,6,6,10,24,32,-8,24
Dungannon,8364,8,2,4,16,14,47,-33,10
Crusaders,8365,1,17,6,3,63,31,32,57
Coleraine,8365,2,15,10,1,45,23,22,55
Linfield,8365,3,11,5,10,38,36,2,38
Glenavon,8365,4,9,9,8,53,45,8,36
Cliftonville,8365,5,9,4,13,32,32,0,31
Ballymena,8365,6,7,4,15,26,49,-23,25
Glentoran,8365,7,6,6,10,24,32,-8,24
Dungannon,8365,8,2,4,16,14,47,-33,10
Crusaders,8366,1,17,6,3,64,30,34,57
Coleraine,8366,2,14,10,2,43,23,20,52
Glenavon,8366,3,10,9,7,53,43,10,39
Linfield,8366,4,10,6,10,38,37,1,36
Cliftonville,8366,5,9,5,12,33,32,1,32
Ballymena,8366,6,7,4,15,25,50,-25,25
Glentoran,8366,7,6,6,10,24,32,-8,24
Dungannon,8366,8,2,4,16,14,47,-33,10
Crusaders,8367,1,17,6,3,64,31,33,57
Coleraine,8367,2,15,10,1,46,24,22,55
Glenavon,8367,3,9,9,8,54,46,8,36
Linfield,8367,4,10,6,10,37,36,1,36
Cliftonville,8367,5,9,5,12,32,31,1,32
Ballymena,8367,6,7,4,15,26,50,-24,25
Glentoran,8367,7,6,6,10,24,32,-8,24
Dungannon,8367,8,2,4,16,14,47,-33,10
Crusaders,8368,1,17,6,3,64,32,32,57
Coleraine,8368,2,14,10,2,43,23,20,52
Glenavon,8368,3,10,9,7,53,43,10,39
Linfield,8368,4,10,5,11,38,38,0,35
Cliftonville,8368,5,10,4,12,34,32,2,34
Ballymena,8368,6,7,4,15,27,50,-23,25
Glentoran,8368,7,6,6,10,24,32,-8,24
Dungannon,8368,8,2,4,16,14,47,-33,10
Crusaders,8369,1,17,6,3,65,30,35,57
Coleraine,8369,2,15,10,1,46,23,23,55
Glenavon,8369,3,9,9,8,53,46,7,36
Linfield,8369,4,10,5,11,38,38,0,35
Cliftonville,8369,5,10,4,12,34,32,2,34
Ballymena,8369,6,7,4,15,25,51,-26,25
Glentoran,8369,7,6,6,10,24,32,-8,24
Dungannon,8369,8,2,4,16,14,47,-33,10
Coleraine,8370,1,15,10,1,49,23,26,55
Crusaders,8370,2,16,6,4,62,33,29,54
Linfield,8370,3,11,5,10,39,37,2,38
Glenavon,8370,4,9,9,8,53,49,4,36
Cliftonville,8370,5,9,4,13,33,33,0,31
Ballymena,8370,6,8,4,14,28,48,-20,28
Glentoran,8370,7,6,6,10,24,32,-8,24
Dungannon,8370,8,2,4,16,14,47,-33,10
Crusaders,8371,1,17,6,3,67,31,36,57
Coleraine,8371,2,15,10,1,45,23,22,55
Linfield,8371,3,11,5,10,39,37,2,38
Glenavon,8371,4,9,9,8,53,45,8,36
Cliftonville,8371,5,9,4,13,33,33,0,31
Ballymena,8371,6,7,4,15,26,53,-27,25
Glentoran,8371,7,6,6,10,24,32,-8,24
Dungannon,8371,8,2,4,16,14,47,-33,10
Crusaders,8372,1,16,6,4,61,33,28,54
Coleraine,8372,2,14,10,2,43,25,18,52
Glenavon,8372,3,10,9,7,55,43,12,39
Linfield,8372,4,10,6,10,38,37,1,36
Cliftonville,8372,5,9,5,12,33,32,1,32
Ballymena,8372,6,8,4,14,28,47,-19,28
Glentoran,8372,7,6,6,10,24,32,-8,24
Dungannon,8372,8,2,4,16,14,47,-33,10
Crusaders,8373,1,17,6,3,64,32,32,57
Coleraine,8373,2,14,10,2,43,23,20,52
Glenavon,8373,3,10,9,7,53,43,10,39
Linfield,8373,4,10,6,10,38,37,1,36
Cliftonville,8373,5,9,5,12,33,32,1,32
Ballymena,8373,6,7,4,15,27,50,-23,25
Glentoran,8373,7,6,6,10,24,32,-8,24
Dungannon,8373,8,2,4,16,14,47,-33,10
Crusaders,8374,1,17,6,3,64,30,34,57
Coleraine,8374,2,14,10,2,45,25,20,52
Glenavon,8374,3,10,9,7,55,45,10,39
Linfield,8374,4,11,5,10,38,36,2,38
Cliftonville,8374,5,9,4,13,32,32,0,31
Ballymena,8374,6,7,4,15,25,50,-25,25
Glentoran,8374,7,6,6,10,24,32,-8,24
Dungannon,8374,8,2,4,16,14,47,-33,10
Crusaders,8375,1,16,6,4,62,33,29,54
Coleraine,8375,2,14,11,1,44,23,21,53
Glenavon,8375,3,9,10,7,53,44,9,37
Linfield,8375,4,10,5,11,37,37,0,35
Cliftonville,8375,5,10,4,12,33,31,2,34
Ballymena,8375,6,8,4,14,28,48,-20,28
Glentoran,8375,7,6,6,10,24,32,-8,24
Dungannon,8375,8,2,4,16,14,47,-33,10
Crusaders,8376,1,16,6,4,63,33,30,54
Coleraine,8376,2,14,10,2,44,25,19,52
Glenavon,8376,3,10,9,7,55,44,11,39
Linfield,8376,4,11,5,10,42,36,6,38
Cliftonville,8376,5,9,4,13,32,36,-4,31
Ballymena,8376,6,8,4,14,28,49,-21,28
Glentoran,8376,7,6,6,10,24,32,-8,24
Dungannon,8376,8,2,4,16,14,47,-33,10
Crusaders,8377,1,17,6,3,63,30,33,57
Coleraine,8377,2,15,10,1,46,24,22,55
Linfield,8377,3,11,5,10,40,36,4,38
Glenavon,8377,4,9,9,8,54,46,8,36
Cliftonville,8377,5,9,4,13,32,34,-2,31
Ballymena,8377,6,7,4,15,25,49,-24,25
Glentoran,8377,7,6,6,10,24,32,-8,24
Dungannon,8377,8,2,4,16,14,47,-33,10
Crusaders,8378,1,17,6,3,63,30,33,57
Coleraine,8378,2,14,11,1,43,22,21,53
Glenavon,8378,3,9,10,7,52,43,9,37
Linfield,8378,4,10,5,11,37,37,0,35
Cliftonville,8378,5,10,4,12,33,31,2,34
Ballymena,8378,6,7,4,15,25,49,-24,25
Glentoran,8378,7,6,6,10,24,32,-8,24
Dungannon,8378,8,2,4,16,14,47,-33,10
Crusaders,8379,1,17,6,3,64,31,33,57
Coleraine,8379,2,14,10,2,43,25,18,52
Glenavon,8379,3,10,9,7,55,43,12,39
Linfield,8379,4,11,5,10,42,39,3,38
Cliftonville,8379,5,9,4,13,35,36,-1,31
Ballymena,8379,6,7,4,15,26,50,-24,25
Glentoran,8379,7,6,6,10,24,32,-8,24
Dungannon,8379,8,2,4,16,14,47,-33,10
Crusaders,8380,1,17,6,3,65,32,33,57
Coleraine,8380,2,14,10,2,43,25,18,52
Glenavon,8380,3,10,9,7,55,43,12,39
Linfield,8380,4,11,5,10,41,37,4,38
Cliftonville,8380,5,9,4,13,33,35,-2,31
Ballymena,8380,6,7,4,15,27,51,-24,25
Glentoran,8380,7,6,6,10,24,32,-8,24
Dungannon,8380,8,2,4,16,14,47,-33,10
Crusaders,8381,1,16,7,3,61,30,31,55
Coleraine,8381,2,14,11,1,44,23,21,53
Linfield,8381,3,11,5,10,38,36,2,38
Glenavon,8381,4,9,10,7,53,44,9,37
Cliftonville,8381,5,9,4,13,32,32,0,31
Ballymena,8381,6,7,5,14,25,47,-22,26
Glentoran,8381,7,6,6,10,24,32,-8,24
Dungannon,8381,8,2,4,16,14,47,-33,10
Crusaders,8382,1,17,6,3,62,30,32,57
Coleraine,8382,2,14,11,1,44,23,21,53
Glenavon,8382,3,9,10,7,53,44,9,37
Linfield,8382,4,10,6,10,37,36,1,36
Cliftonville,8382,5,9,5,12,32,31,1,32
Ballymena,8382,6,7,4,15,25,48,-23,25
Glentoran,8382,7,6,6,10,24,32,-8,24
Dungannon,8382,8,2,4,16,14,47,-33,10
Crusaders,8383,1,17,6,3,62,30,32,57
Coleraine,8383,2,14,10,2,45,26,19,52
Glenavon,8383,3,10,9,7,56,45,11,39
Linfield,8383,4,11,5,10,40,37,3,38
Cliftonville,8383,5,9,4,13,33,34,-1,31
Ballymena,8383,6,7,4,15,25,48,-23,25
Glentoran,8383,7,6,6,10,24,32,-8,24
Dungannon,8383,8,2,4,16,14,47,-33,10
Crusaders,8384,1,17,6,3,64,30,34,57
Coleraine,8384,2,14,11,1,46,25,21,53
Glenavon,8384,3,9,10,7,55,46,9,37
Linfield,8384,4,10,5,11,39,39,0,35
Cliftonville,8384,5,10,4,12,35,33,2,34
Ballymena,8384,6,7,4,15,25,50,-25,25
Glentoran,8384,7,6,6,10,24,32,-8,24
Dungannon,8384,8,2,4,16,14,47,-33,10
Crusaders,8385,1,17,6,3,65,31,34,57
Coleraine,8385,2,14,10,2,44,25,19,52
Glenavon,8385,3,10,9,7,55,44,11,39
Linfield,8385,4,11,5,10,40,36,4,38
Cliftonville,8385,5,9,4,13,32,34,-2,31
Ballymena,8385,6,7,4,15,26,51,-25,25
Glentoran,8385,7,6,6,10,24,32,-8,24
Dungannon,8385,8,2,4,16,14,47,-33,10
Crusaders,8386,1,17,6,3,64,31,33,57
Coleraine,8386,2,15,10,1,44,22,22,55
Linfield,8386,3,11,5,10,38,36,2,38
Glenavon,8386,4,9,9,8,52,44,8,36
Cliftonville,8386,5,9,4,13,32,32,0,31
Ballymena,8386,6,7,4,15,26,50,-24,25
Glentoran,8386,7,6,6,10,24,32,-8,24
Dungannon,8386,8,2,4,16,14,47,-33,10
Crusaders,8387,1,16,6,4,62,32,30,54
Coleraine,8387,2,14,10,2,43,23,20,52
Glenavon,8387,3,10,9,7,53,43,10,39
Linfield,8387,4,10,5,11,39,39,0,35
Cliftonville,8387,5,10,4,12,35,33,2,34
Ballymena,8387,6,8,4,14,27,48,-21,28
Glentoran,8387,7,6,6,10,24,32,-8,24
Dungannon,8387,8,2,4,16,14,47,-33,10
Crusaders,8388,1,16,7,3,62,31,31,55
Coleraine,8388,2,14,10,2,44,24,20,52
Glenavon,8388,3,10,9,7,54,44,10,39
Linfield,8388,4,10,6,10,38,37,1,36
Cliftonville,8388,5,9,5,12,33,32,1,32
Ballymena,8388,6,7,5,14,26,48,-22,26
Glentoran,8388,7,6,6,10,24,32,-8,24
Dungannon,8388,8,2,4,16,14,47,-33,10
Crusaders,8389,1,17,6,3,65,30,35,57
Coleraine,8389,2,14,11,1,44,23,21,53
Glenavon,8389,3,9,10,7,53,44,9,37
Linfield,8389,4,10,6,10,38,37,1,36
Cliftonville,8389,5,9,5,12,33,32,1,32
Ballymena,8389,6,7,4,15,25,51,-26,25
Glentoran,8389,7,6,6,10,24,32,-8,24
Dungannon,8389,8,2,4,16,14,47,-33,10
Crusaders,8390,1,16,6,4,61,32,29,54
Coleraine,8390,2,14,10,2,43,24,19,52
Glenavon,8390,3,10,9,7,54,43,11,39
Linfield,8390,4,10,5,11,38,38,0,35
Cliftonville,8390,5,10,4,12,34,32,2,34
Ballymena,8390,6,8,4,14,27,47,-20,28
Glentoran,8390,7,6,6,10,24,32,-8,24
Dungannon,8390,8,2,4,16,14,47,-33,10
Crusaders,8391,1,16,6,4,62,32,30,54
Coleraine,8391,2,14,11,1,44,23,21,53
Glenavon,8391,3,9,10,7,53,44,9,37
Linfield,8391,4,10,6,10,38,37,1,36
Cliftonville,8391,5,9,5,12,33,32,1,32
Ballymena,8391,6,8,4,14,27,48,-21,28
Glentoran,8391,7,6,6,10,24,32,-8,24
Dungannon,8391,8,2,4,16,14,47,-33,10
Crusaders,8392,1,16,6,4,65,35,30,54
Coleraine,8392,2,14,10,2,44,24,20,52
Glenavon,8392,3,10,9,7,54,44,10,39
Linfield,8392,4,10,5,11,38,40,-2,35
Cliftonville,8392,5,10,4,12,36,32,4,34
Ballymena,8392,6,8,4,14,30,51,-21,28
Glentoran,8392,7,6,6,10,24,32,-8,24
Dungannon,8392,8,2,4,16,14,47,-33,10
Crusaders,8393,1,17,6,3,63,30,33,57
Coleraine,8393,2,14,10,2,45,25,20,52
Glenavon,8393,3,10,9,7,55,45,10,39
Linfield,8393,4,11,5,10,39,37,2,38
Cliftonville,8393,5,9,4,13,33,33,0,31
Ballymena,8393,6,7,4,15,25,49,-24,25
Glentoran,8393,7,6,6,10,24,32,-8,24
Dungannon,8393,8,2,4,16,14,47,-33,10
Crusaders,8394,1,17,6,3,64,30,34,57
Coleraine,8394,2,14,11,1,44,23,21,53
Glenavon,8394,3,9,10,7,53,44,9,37
Linfield,8394,4,10,6,10,39,38,1,36
Cliftonville,8394,5,9,5,12,34,33,1,32
Ballymena,8394,6,7,4,15,25,50,-25,25
Glentoran,8394,7,6,6,10,24,32,-8,24
Dungannon,8394,8,2,4,16,14,47,-33,10
Crusaders,8395,1,17,6,3,64,30,34,57
Coleraine,8395,2,14,10,2,43,24,19,52
Glenavon,8395,3,10,9,7,54,43,11,39
Linfield,8395,4,11,5,10,41,36,5,38
Cliftonville,8395,5,9,4,13,32,35,-3,31
Ballymena,8395,6,7,4,15,25,50,-25,25
Glentoran,8395,7,6,6,10,24,32,-8,24
Dungannon,8395,8,2,4,16,14,47,-33,10
Crusaders,8396,1,16,6,4,61,31,30,54
Coleraine,8396,2,14,10,2,43,25,18,52
Glenavon,8396,3,10,9,7,55,43,12,39
Linfield,8396,4,10,6,10,39,38,1,36
Cliftonville,8396,5,9,5,12,34,33,1,32
Ballymena,8396,6,8,4,14,26,47,-21,28
Glentoran,8396,7,6,6,10,24,32,-8,24
Dungannon,8396,8,2,4,16,14,47,-33,10
Crusaders,8397,1,17,6,3,62,30,32,57
Coleraine,8397,2,14,10,2,43,23,20,52
Glenavon,8397,3,10,9,7,53,43,10,39
Linfield,8397,4,10,6,10,37,36,1,36
Cliftonville,8397,5,9,5,12,32,31,1,32
Ballymena,8397,6,7,4,15,25,48,-23,25
Glentoran,8397,7,6,6,10,24,32,-8,24
Dungannon,8397,8,2,4,16,14,47,-33,10
Coleraine,8398,1,15,10,1,45,22,23,55
Crusaders,8398,2,16,6,4,61,33,28,54
Glenavon,8398,3,9,9,8,52,45,7,36
Linfield,8398,4,10,6,10,37,36,1,36
Cliftonville,8398,5,9,5,12,32,31,1,32
Ballymena,8398,6,8,4,14,28,47,-19,28
Glentoran,8398,7,6,6,10,24,32,-8,24
Dungannon,8398,8,2,4,16,14,47,-33,10
Crusaders,8399,1,16,7,3,62,31,31,55
Coleraine,8399,2,15,10,1,46,23,23,55
Linfield,8399,3,11,5,10,38,36,2,38
Glenavon,8399,4,9,9,8,53,46,7,36
Cliftonville,8399,5,9,4,13,32,32,0,31
Ballymena,8399,6,7,5,14,26,48,-22,26
Glentoran,8399,7,6,6,10,24,32,-8,24
Dungannon,8399,8,2,4,16,14,47,-33,10
Crusaders,8400,1,17,6,3,65,32,33,57
Coleraine,8400,2,14,10,2,44,24,20,52
Glenavon,8400,3,10,9,7,54,44,10,39
Linfield,8400,4,11,5,10,41,36,5,38
Cliftonville,8400,5,9,4,13,32,35,-3,31
Ballymena,8400,6,7,4,15,27,51,-24,25
Glentoran,8400,7,6,6,10,24,32,-8,24
Dungannon,8400,8,2,4,16,14,47,-33,10
Crusaders,8401,1,17,6,3,65,31,34,57
Coleraine,8401,2,15,10,1,45,23,22,55
Linfield,8401,3,11,5,10,38,36,2,38
Glenavon,8401,4,9,9,8,53,45,8,36
Cliftonville,8401,5,9,4,13,32,32,0,31
Ballymena,8401,6,7,4,15,26,51,-25,25
Glentoran,8401,7,6,6,10,24,32,-8,24
Dungannon,8401,8,2,4,16,14,47,-33,10
Crusaders,8402,1,17,6,3,65,32,33,57
Coleraine,8402,2,14,10,2,44,24,20,52
Glenavon,8402,3,10,9,7,54,44,10,39
Linfield,8402,4,11,5,10,38,36,2,38
Cliftonville,8402,5,9,4,13,32,32,0,31
Ballymena,8402,6,7,4,15,27,51,-24,25
Glentoran,8402,7,6,6,10,24,32,-8,24
Dungannon,8402,8,2,4,16,14,47,-33,10
Crusaders,8403,1,17,6,3,63,30,33,57
Coleraine,8403,2,14,10,2,44,24,20,52
Glenavon,8403,3,10,9,7,54,44,10,39
Linfield,8403,4,10,5,11,37,37,0,35
Cliftonville,8403,5,10,4,12,33,31,2,34
Ballymena,8403,6,7,4,15,25,49,-24,25
Glentoran,8403,7,6,6,10,24,32,-8,24
Dungannon,8403,8,2,4,16,14,47,-33,10
Crusaders,8404,1,17,6,3,62,30,32,57
Coleraine,8404,2,15,10,1,44,22,22,55
Linfield,8404,3,11,5,10,39,37,2,38
Glenavon,8404,4,9,9,8,52,44,8,36
Cliftonville,8404,5,9,4,13,33,33,0,31
Ballymena,8404,6,7,4,15,25,48,-23,25
Glentoran,8404,7,6,6,10,24,32,-8,24
Dungannon,8404,8,2,4,16,14,47,-33,10
Crusaders,8405,1,17,6,3,64,31,33,57
Coleraine,8405,2,15,10,1,46,23,23,55
Glenavon,8405,3,9,9,8,53,46,7,36
Linfield,8405,4,10,5,11,38,39,-1,35
Cliftonville,8405,5,10,4,12,35,32,3,34
Ballymena,8405,6,7,4,15,26,50,-24,25
Glentoran,8405,7,6,6,10,24,32,-8,24
Dungannon,8405,8,2,4,16,14,47,-33,10
Crusaders,8406,1,17,6,3,64,30,34,57
Coleraine,8406,2,14,11,1,44,23,21,53
Glenavon,8406,3,9,10,7,53,44,9,37
Linfield,8406,4,10,5,11,38,38,0,35
Cliftonville,8406,5,10,4,12,34,32,2,34
Ballymena,8406,6,7,4,15,25,50,-25,25
Glentoran,8406,7,6,6,10,24,32,-8,24
Dungannon,8406,8,2,4,16,14,47,-33,10
Crusaders,8407,1,17,6,3,66,30,36,57
Coleraine,8407,2,15,10,1,45,22,23,55
Linfield,8407,3,11,5,10,39,37,2,38
Glenavon,8407,4,9,9,8,52,45,7,36
Cliftonville,8407,5,9,4,13,33,33,0,31
Ballymena,8407,6,7,4,15,25,52,-27,25
Glentoran,8407,7,6,6,10,24,32,-8,24
Dungannon,8407,8,2,4,16,14,47,-33,10
Crusaders,8408,1,16,7,3,62,31,31,55
Coleraine,8408,2,14,10,2,45,26,19,52
Glenavon,8408,3,10,9,7,56,45,11,39
Linfield,8408,4,11,5,10,39,36,3,38
Cliftonville,8408,5,9,4,13,32,33,-1,31
Ballymena,8408,6,7,5,14,26,48,-22,26
Glentoran,8408,7,6,6,10,24,32,-8,24
Dungannon,8408,8,2,4,16,14,47,-33,10
Coleraine,8409,1,15,10,1,46,22,24,55
Crusaders,8409,2,16,6,4,61,32,29,54
Linfield,8409,3,11,5,10,39,37,2,38
Glenavon,8409,4,9,9,8,52,46,6,36
Cliftonville,8409,5,9,4,13,33,33,0,31
Ballymena,8409,6,8,4,14,27,47,-20,28
Glentoran,8409,7,6,6,10,24,32,-8,24
Dungannon,8409,8,2,4,16,14,47,-33,10
Crusaders,8410,1,17,6,3,65,31,34,57
Coleraine,8410,2,14,10,2,43,24,19,52
Glenavon,8410,3,10,9,7,54,43,11,39
Linfield,8410,4,11,5,10,38,36,2,38
Cliftonville,8410,5,9,4,13,32,32,0,31
Ballymena,8410,6,7,4,15,26,51,-25,25
Glentoran,8410,7,6,6,10,24,32,-8,24
Dungannon,8410,8,2,4,16,14,47,-33,10
Crusaders,8411,1,17,6,3,65,30,35,57
Coleraine,8411,2,14,11,1,46,25,21,53
Glenavon,8411,3,9,10,7,55,46,9,37
Linfield,8411,4,10,5,11,37,39,-2,35
Cliftonville,8411,5,10,4,12,35,31,4,34
Ballymena,8411,6,7,4,15,25,51,-26,25
Glentoran,8411,7,6,6,10,24,32,-8,24
Dungannon,8411,8,2,4,16,14,47,-33,10
Crusaders,8412,1,16,6,4,63,33,30,54
Coleraine,8412,2,14,11,1,44,23,21,53
Glenavon,8412,3,9,10,7,53,44,9,37
Linfield,8412,4,10,5,11,39,40,-1,35
Cliftonville,8412,5,10,4,12,36,33,3,34
Ballymena,8412,6,8,4,14,28,49,-21,28
Glentoran,8412,7,6,6,10,24,32,-8,24
Dungannon,8412,8,2,4,16,14,47,-33,10
Crusaders,8413,1,17,6,3,65,33,32,57
Coleraine,8413,2,15,10,1,46,24,22,55
Glenavon,8413,3,9,9,8,54,46,8,36
Linfield,8413,4,10,6,10,38,37,1,36
Cliftonville,8413,5,9,5,12,33,32,1,32
Ballymena,8413,6,7,4,15,28,51,-23,25
Glentoran,8413,7,6,6,10,24,32,-8,24
Dungannon,8413,8,2,4,16,14,47,-33,10
Crusaders,8414,1,17,6,3,62,30,32,57
Coleraine,8414,2,14,11,1,46,25,21,53
Glenavon,8414,3,9,10,7,55,46,9,37
Linfield,8414,4,10,6,10,39,38,1,36
Cliftonville,8414,5,9,5,12,34,33,1,32
Ballymena,8414,6,7,4,15,25,48,-23,25
Glentoran,8414,7,6,6,10,24,32,-8,24
Dungannon,8414,8,2,4,16,14,47,-33,10
Crusaders,8415,1,16,6,4,63,33,30,54
Coleraine,8415,2,14,11,1,45,24,21,53
Glenavon,8415,3,9,10,7,54,45,9,37
Linfield,8415,4,10,6,10,38,37,1,36
Cliftonville,8415,5,9,5,12,33,32,1,32
Ballymena,8415,6,8,4,14,28,49,-21,28
Glentoran,8415,7,6,6,10,24,32,-8,24
Dungannon,8415,8,2,4,16,14,47,-33,10
Crusaders,8416,1,16,7,3,63,32,31,55
Coleraine,8416,2,14,10,2,43,24,19,52
Glenavon,8416,3,10,9,7,54,43,11,39
Linfield,8416,4,10,5,11,38,39,-1,35
Cliftonville,8416,5,10,4,12,35,32,3,34
Ballymena,8416,6,7,5,14,27,49,-22,26
Glentoran,8416,7,6,6,10,24,32,-8,24
Dungannon,8416,8,2,4,16,14,47,-33,10
Crusaders,8417,1,17,6,3,64,31,33,57
Coleraine,8417,2,14,11,1,44,23,21,53
Linfield,8417,3,11,5,10,39,36,3,38
Glenavon,8417,4,9,10,7,53,44,9,37
Cliftonville,8417,5,9,4,13,32,33,-1,31
Ballymena,8417,6,7,4,15,26,50,-24,25
Glentoran,8417,7,6,6,10,24,32,-8,24
Dungannon,8417,8,2,4,16,14,47,-33,10
Crusaders,8418,1,17,6,3,62,30,32,57
Coleraine,8418,2,14,10,2,43,23,20,52
Glenavon,8418,3,10,9,7,53,43,10,39
Linfield,8418,4,10,6,10,39,38,1,36
Cliftonville,8418,5,9,5,12,34,33,1,32
Ballymena,8418,6,7,4,15,25,48,-23,25
Glentoran,8418,7,6,6,10,24,32,-8,24
Dungannon,8418,8,2,4,16,14,47,-33,10
Crusaders,8419,1,17,6,3,63,30,33,57
Coleraine,8419,2,15,10,1,46,24,22,55
Glenavon,8419,3,9,9,8,54,46,8,36
Linfield,8419,4,10,6,10,38,37,1,36
Cliftonville,8419,5,9,5,12,33,32,1,32
Ballymena,8419,6,7,4,15,25,49,-24,25
Glentoran,8419,7,6,6,10,24,32,-8,24
Dungannon,8419,8,2,4,16,14,47,-33,10
Crusaders,8420,1,17,6,3,64,31,33,57
Coleraine,8420,2,15,10,1,44,22,22,55
Linfield,8420,3,11,5,10,39,36,3,38
Glenavon,8420,4,9,9,8,52,44,8,36
Cliftonville,8420,5,9,4,13,32,33,-1,31
Ballymena,8420,6,7,4,15,26,50,-24,25
Glentoran,8420,7,6,6,10,24,32,-8,24
Dungannon,8420,8,2,4,16,14,47,-33,10
Crusaders,8421,1,17,6,3,68,30,38,57
Coleraine,8421,2,14,11,1,46,25,21,53
Glenavon,8421,3,9,10,7,55,46,9,37
Linfield,8421,4,10,6,10,38,37,1,36
Cliftonville,8421,5,9,5,12,33,32,1,32
Ballymena,8421,6,7,4,15,25,54,-29,25
Glentoran,8421,7,6,6,10,24,32,-8,24
Dungannon,8421,8,2,4,16,14,47,-33,10
Crusaders,8422,1,17,6,3,63,31,32,57
Coleraine,8422,2,14,10,2,44,25,19,52
Glenavon,8422,3,10,9,7,55,44,11,39
Linfield,8422,4,11,5,10,39,37,2,38
Cliftonville,8422,5,9,4,13,33,33,0,31
Ballymena,8422,6,7,4,15,26,49,-23,25
Glentoran,8422,7,6,6,10,24,32,-8,24
Dungannon,8422,8,2,4,16,14,47,-33,10
Crusaders,8423,1,16,6,4,63,34,29,54
Coleraine,8423,2,14,10,2,44,24,20,52
Glenavon,8423,3,10,9,7,54,44,10,39
Linfield,8423,4,10,5,11,38,38,0,35
Cliftonville,8423,5,10,4,12,34,32,2,34
Ballymena,8423,6,8,4,14,29,49,-20,28
Glentoran,8423,7,6,6,10,24,32,-8,24
Dungannon,8423,8,2,4,16,14,47,-33,10
Crusaders,8424,1,17,6,3,64,30,34,57
Coleraine,8424,2,14,10,2,44,24,20,52
Glenavon,8424,3,10,9,7,54,44,10,39
Linfield,8424,4,10,6,10,38,37,1,36
Cliftonville,8424,5,9,5,12,33,32,1,32
Ballymena,8424,6,7,4,15,25,50,-25,25
Glentoran,8424,7,6,6,10,24,32,-8,24
Dungannon,8424,8,2,4,16,14,47,-33,10
Crusaders,8425,1,16,6,4,61,36,25,54
Coleraine,8425,2,14,10,2,45,25,20,52
Glenavon,8425,3,10,9,7,55,45,10,39
Linfield,8425,4,11,5,10,39,37,2,38
Cliftonville,8425,5,9,4,13,33,33,0,31
Ballymena,8425,6,8,4,14,31,47,-16,28
Glentoran,8425,7,6,6,10,24,32,-8,24
Dungannon,8425,8,2,4,16,14,47,-33,10
Crusaders,8426,1,17,6,3,64,30,34,57
Coleraine,8426,2,15,10,1,45,23,22,55
Linfield,8426,3,11,5,10,39,36,3,38
Glenavon,8426,4,9,9,8,53,45,8,36
Cliftonville,8426,5,9,4,13,32,33,-1,31
Ballymena,8426,6,7,4,15,25,50,-25,25
Glentoran,8426,7,6,6,10,24,32,-8,24
Dungannon,8426,8,2,4,16,14,47,-33,10
Crusaders,8427,1,17,6,3,63,30,33,57
Coleraine,8427,2,14,10,2,44,25,19,52
Glenavon,8427,3,10,9,7,55,44,11,39
Linfield,8427,4,11,5,10,40,37,3,38
Cliftonville,8427,5,9,4,13,33,34,-1,31
Ballymena,8427,6,7,4,15,25,49,-24,25
Glentoran,8427,7,6,6,10,24,32,-8,24
Dungannon,8427,8,2,4,16,14,47,-33,10
Crusaders,8428,1,16,6,4,61,31,30,54
Coleraine,8428,2,14,11,1,43,22,21,53
Glenavon,8428,3,9,10,7,52,43,9,37
Linfield,8428,4,10,6,10,37,36,1,36
Cliftonville,8428,5,9,5,12,32,31,1,32
Ballymena,8428,6,8,4,14,26,47,-21,28
Glentoran,8428,7,6,6,10,24,32,-8,24
Dungannon,8428,8,2,4,16,14,47,-33,10
Crusaders,8429,1,17,6,3,64,32,32,57
Coleraine,8429,2,15,10,1,47,23,24,55
Linfield,8429,3,11,5,10,42,37,5,38
Glenavon,8429,4,9,9,8,53,47,6,36
Cliftonville,8429,5,9,4,13,33,36,-3,31
Ballymena,8429,6,7,4,15,27,50,-23,25
Glentoran,8429,7,6,6,10,24,32,-8,24
Dungannon,8429,8,2,4,16,14,47,-33,10
Crusaders,8430,1,17,6,3,64,32,32,57
Coleraine,8430,2,15,10,1,44,22,22,55
Linfield,8430,3,11,5,10,39,37,2,38
Glenavon,8430,4,9,9,8,52,44,8,36
Cliftonville,8430,5,9,4,13,33,33,0,31
Ballymena,8430,6,7,4,15,27,50,-23,25
Glentoran,8430,7,6,6,10,24,32,-8,24
Dungannon,8430,8,2,4,16,14,47,-33,10
Crusaders,8431,1,16,7,3,62,31,31,55
Coleraine,8431,2,14,11,1,44,23,21,53
Glenavon,8431,3,9,10,7,53,44,9,37
Linfield,8431,4,10,6,10,38,37,1,36
Cliftonville,8431,5,9,5,12,33,32,1,32
Ballymena,8431,6,7,5,14,26,48,-22,26
Glentoran,8431,7,6,6,10,24,32,-8,24
Dungannon,8431,8,2,4,16,14,47,-33,10
Crusaders,8432,1,17,6,3,64,32,32,57
Coleraine,8432,2,14,11,1,44,23,21,53
Linfield,8432,3,11,5,10,40,38,2,38
Glenavon,8432,4,9,10,7,53,44,9,37
Cliftonville,8432,5,9,4,13,34,34,0,31
Ballymena,8432,6,7,4,15,27,50,-23,25
Glentoran,8432,7,6,6,10,24,32,-8,24
Dungannon,8432,8,2,4,16,14,47,-33,10
Crusaders,8433,1,16,7,3,62,31,31,55
Coleraine,8433,2,15,10,1,45,23,22,55
Linfield,8433,3,11,5,10,40,37,3,38
Glenavon,8433,4,9,9,8,53,45,8,36
Cliftonville,8433,5,9,4,13,33,34,-1,31
Ballymena,8433,6,7,5,14,26,48,-22,26
Glentoran,8433,7,6,6,10,24,32,-8,24
Dungannon,8433,8,2,4,16,14,47,-33,10
Crusaders,8434,1,16,6,4,64,35,29,54
Coleraine,8434,2,14,10,2,43,23,20,52
Glenavon,8434,3,10,9,7,53,43,10,39
Linfield,8434,4,10,6,10,38,37,1,36
Cliftonville,8434,5,9,5,12,33,32,1,32
Ballymena,8434,6,8,4,14,30,50,-20,28
Glentoran,8434,7,6,6,10,24,32,-8,24
Dungannon,8434,8,2,4,16,14,47,-33,10
Crusaders,8435,1,17,6,3,62,30,32,57
Coleraine,8435,2,14,10,2,43,23,20,52
Glenavon,8435,3,10,9,7,53,43,10,39
Linfield,8435,4,11,5,10,38,36,2,38
Cliftonville,8435,5,9,4,13,32,32,0,31
Ballymena,8435,6,7,4,15,25,48,-23,25
Glentoran,8435,7,6,6,10,24,32,-8,24
Dungannon,8435,8,2,4,16,14,47,-33,10
Crusaders,8436,1,17,6,3,65,30,35,57
Coleraine,8436,2,14,10,2,43,25,18,52
Glenavon,8436,3,10,9,7,55,43,12,39
Linfield,8436,4,11,5,10,40,38,2,38
Cliftonville,8436,5,9,4,13,34,34,0,31
Ballymena,8436,6,7,4,15,25,51,-26,25
Glentoran,8436,7,6,6,10,24,32,-8,24
Dungannon,8436,8,2,4,16,14,47,-33,10
Crusaders,8437,1,16,7,3,63,32,31,55
Coleraine,8437,2,14,10,2,45,25,20,52
Glenavon,8437,3,10,9,7,55,45,10,39
Linfield,8437,4,10,5,11,37,38,-1,35
Cliftonville,8437,5,10,4,12,34,31,3,34
Ballymena,8437,6,7,5,14,27,49,-22,26
Glentoran,8437,7,6,6,10,24,32,-8,24
Dungannon,8437,8,2,4,16,14,47,-33,10
Coleraine,8438,1,15,10,1,45,22,23,55
Crusaders,8438,2,16,6,4,61,33,28,54
Glenavon,8438,3,9,9,8,52,45,7,36
Linfield,8438,4,10,6,10,38,37,1,36
Cliftonville,8438,5,9,5,12,33,32,1,32
Ballymena,8438,6,8,4,14,28,47,-19,28
Glentoran,8438,7,6,6,10,24,32,-8,24
Dungannon,8438,8,2,4,16,14,47,-33,10
Crusaders,8439,1,17,6,3,63,30,33,57
Coleraine,8439,2,14,10,2,46,26,20,52
Glenavon,8439,3,10,9,7,56,46,10,39
Linfield,8439,4,10,5,11,37,41,-4,35
Cliftonville,8439,5,10,4,12,37,31,6,34
Ballymena,8439,6,7,4,15,25,49,-24,25
Glentoran,8439,7,6,6,10,24,32,-8,24
Dungannon,8439,8,2,4,16,14,47,-33,10
Coleraine,8440,1,15,10,1,45,22,23,55
Crusaders,8440,2,16,6,4,61,33,28,54
Glenavon,8440,3,9,9,8,52,45,7,36
Linfield,8440,4,10,5,11,40,40,0,35
Cliftonville,8440,5,10,4,12,36,34,2,34
Ballymena,8440,6,8,4,14,28,47,-19,28
Glentoran,8440,7,6,6,10,24,32,-8,24
Dungannon,8440,8,2,4,16,14,47,-33,10
Crusaders,8441,1,17,6,3,64,30,34,57
Coleraine,8441,2,14,10,2,43,26,17,52
Glenavon,8441,3,10,9,7,56,43,13,39
Linfield,8441,4,10,5,11,38,38,0,35
Cliftonville,8441,5,10,4,12,34,32,2,34
Ballymena,8441,6,7,4,15,25,50,-25,25
Glentoran,8441,7,6,6,10,24,32,-8,24
Dungannon,8441,8,2,4,16,14,47,-33,10
Crusaders,8442,1,17,6,3,62,30,32,57
Coleraine,8442,2,14,11,1,45,24,21,53
Glenavon,8442,3,9,10,7,54,45,9,37
Linfield,8442,4,10,6,10,39,38,1,36
Cliftonville,8442,5,9,5,12,34,33,1,32
Ballymena,8442,6,7,4,15,25,48,-23,25
Glentoran,8442,7,6,6,10,24,32,-8,24
Dungannon,8442,8,2,4,16,14,47,-33,10
Crusaders,8443,1,16,7,3,62,31,31,55
Coleraine,8443,2,14,10,2,43,24,19,52
Glenavon,8443,3,10,9,7,54,43,11,39
Linfield,8443,4,11,5,10,39,37,2,38
Cliftonville,8443,5,9,4,13,33,33,0,31
Ballymena,8443,6,7,5,14,26,48,-22,26
Glentoran,8443,7,6,6,10,24,32,-8,24
Dungannon,8443,8,2,4,16,14,47,-33,10
Crusaders,8444,1,17,6,3,65,30,35,57
Coleraine,8444,2,15,10,1,46,23,23,55
Glenavon,8444,3,9,9,8,53,46,7,36
Linfield,8444,4,10,6,10,38,37,1,36
Cliftonville,8444,5,9,5,12,33,32,1,32
Ballymena,8444,6,7,4,15,25,51,-26,25
Glentoran,8444,7,6,6,10,24,32,-8,24
Dungannon,8444,8,2,4,16,14,47,-33,10
Crusaders,8445,1,17,6,3,65,30,35,57
Coleraine,8445,2,14,10,2,43,23,20,52
Glenavon,8445,3,10,9,7,53,43,10,39
Linfield,8445,4,11,5,10,40,37,3,38
Cliftonville,8445,5,9,4,13,33,34,-1,31
Ballymena,8445,6,7,4,15,25,51,-26,25
Glentoran,8445,7,6,6,10,24,32,-8,24
Dungannon,8445,8,2,4,16,14,47,-33,10
Crusaders,8446,1,17,6,3,64,31,33,57
Coleraine,8446,2,15,10,1,44,22,22,55
Linfield,8446,3,11,5,10,38,36,2,38
Glenavon,8446,4,9,9,8,52,44,8,36
Cliftonville,8446,5,9,4,13,32,32,0,31
Ballymena,8446,6,7,4,15,26,50,-24,25
Glentoran,8446,7,6,6,10,24,32,-8,24
Dungannon,8446,8,2,4,16,14,47,-33,10
Coleraine,8447,1,15,10,1,44,22,22,55
Crusaders,8447,2,16,6,4,61,32,29,54
Linfield,8447,3,11,5,10,38,36,2,38
Glenavon,8447,4,9,9,8,52,44,8,36
Cliftonville,8447,5,9,4,13,32,32,0,31
Ballymena,8447,6,8,4,14,27,47,-20,28
Glentoran,8447,7,6,6,10,24,32,-8,24
Dungannon,8447,8,2,4,16,14,47,-33,10
Crusaders,8448,1,17,6,3,64,30,34,57
Coleraine,8448,2,15,10,1,44,22,22,55
Linfield,8448,3,11,5,10,39,36,3,38
Glenavon,8448,4,9,9,8,52,44,8,36
Cliftonville,8448,5,9,4,13,32,33,-1,31
Ballymena,8448,6,7,4,15,25,50,-25,25
Glentoran,8448,7,6,6,10,24,32,-8,24
Dungannon,8448,8,2,4,16,14,47,-33,10
Crusaders,8449,1,17,6,3,63,30,33,57
Coleraine,8449,2,14,10,2,43,24,19,52
Glenavon,8449,3,10,9,7,54,43,11,39
Linfield,8449,4,10,6,10,38,37,1,36
Cliftonville,8449,5,9,5,12,33,32,1,32
Ballymena,8449,6,7,4,15,25,49,-24,25
Glentoran,8449,7,6,6,10,24,32,-8,24
Dungannon,8449,8,2,4,16,14,47,-33,10
Crusaders,8450,1,17,6,3,66,31,35,57
Coleraine,8450,2,15,10,1,45,23,22,55
Glenavon,8450,3,9,9,8,53,45,8,36
Linfield,8450,4,10,6,10,37,36,1,36
Cliftonville,8450,5,9,5,12,32,31,1,32
Ballymena,8450,6,7,4,15,26,52,-26,25
Glentoran,8450,7,6,6,10,24,32,-8,24
Dungannon,8450,8,2,4,16,14,47,-33,10
Crusaders,8451,1,17,6,3,63,30,33,57
Coleraine,8451,2,15,10,1,46,23,23,55
Linfield,8451,3,11,5,10,38,36,2,38
Glenavon,8451,4,9,9,8,53,46,7,36
Cliftonville,8451,5,9,4,13,32,32,0,31
Ballymena,8451,6,7,4,15,25,49,-24,25
Glentoran,8451,7,6,6,10,24,32,-8,24
Dungannon,8451,8,2,4,16,14,47,-33,10
Coleraine,8452,1,15,10,1,44,22,22,55
Crusaders,8452,2,16,6,4,62,33,29,54
Linfield,8452,3,11,5,10,39,36,3,38
Glenavon,8452,4,9,9,8,52,44,8,36
Cliftonville,8452,5,9,4,13,32,33,-1,31
Ballymena,8452,6,8,4,14,28,48,-20,28
Glentoran,8452,7,6,6,10,24,32,-8,24
Dungannon,8452,8,2,4,16,14,47,-33,10
Coleraine,8453,1,15,10,1,44,22,22,55
Crusaders,8453,2,16,6,4,61,32,29,54
Glenavon,8453,3,9,9,8,52,44,8,36
Linfield,8453,4,10,5,11,38,38,0,35
Cliftonville,8453,5,10,4,12,34,32,2,34
Ballymena,8453,6,8,4,14,27,47,-20,28
Glentoran,8453,7,6,6,10,24,32,-8,24
Dungannon,8453,8,2,4,16,14,47,-33,10
Crusaders,8454,1,17,6,3,63,31,32,57
Coleraine,8454,2,15,10,1,45,22,23,55
Glenavon,8454,3,9,9,8,52,45,7,36
Linfield,8454,4,10,6,10,38,37,1,36
Cliftonville,8454,5,9,5,12,33,32,1,32
Ballymena,8454,6,7,4,15,26,49,-23,25
Glentoran,8454,7,6,6,10,24,32,-8,24
Dungannon,8454,8,2,4,16,14,47,-33,10
Crusaders,8455,1,17,6,3,63,30,33,57
Coleraine,8455,2,14,11,1,44,23,21,53
Linfield,8455,3,11,5,10,40,37,3,38
Glenavon,8455,4,9,10,7,53,44,9,37
Cliftonville,8455,5,9,4,13,33,34,-1,31
Ballymena,8455,6,7,4,15,25,49,-24,25
Glentoran,8455,7,6,6,10,24,32,-8,24
Dungannon,8455,8,2,4,16,14,47,-33,10
Crusaders,8456,1,17,6,3,63,31,32,57
Coleraine,8456,2,15,10,1,45,23,22,55
Glenavon,8456,3,9,9,8,53,45,8,36
Linfield,8456,4,10,5,11,38,39,-1,35
Cliftonville,8456,5,10,4,12,35,32,3,34
Ballymena,8456,6,7,4,15,26,49,-23,25
Glentoran,8456,7,6,6,10,24,32,-8,24
Dungannon,8456,8,2,4,16,14,47,-33,10
Crusaders,8457,1,16,7,3,62,31,31,55
Coleraine,8457,2,14,10,2,45,26,19,52
Glenavon,8457,3,10,9,7,56,45,11,39
Linfield,8457,4,11,5,10,38,36,2,38
Cliftonville,8457,5,9,4,13,32,32,0,31
Ballymena,8457,6,7,5,14,26,48,-22,26
Glentoran,8457,7,6,6,10,24,32,-8,24
Dungannon,8457,8,2,4,16,14,47,-33,10
Crusaders,8458,1,17,6,3,64,32,32,57
Coleraine,8458,2,14,10,2,43,23,20,52
Glenavon,8458,3,10,9,7,53,43,10,39
Linfield,8458,4,11,5,10,38,36,2,38
Cliftonville,8458,5,9,4,13,32,32,0,31
Ballymena,8458,6,7,4,15,27,50,-23,25
Glentoran,8458,7,6,6,10,24,32,-8,24
Dungannon,8458,8,2,4,16,14,47,-33,10
Crusaders,8459,1,16,7,3,63,32,31,55
Coleraine,8459,2,14,10,2,44,24,20,52
Glenavon,8459,3,10,9,7,54,44,10,39
Linfield,8459,4,11,5,10,39,37,2,38
Cliftonville,8459,5,9,4,13,33,33,0,31
Ballymena,8459,6,7,5,14,27,49,-22,26
Glentoran,8459,7,6,6,10,24,32,-8,24
Dungannon,8459,8,2,4,16,14,47,-33,10
Crusaders,8460,1,16,7,3,62,31,31,55
Coleraine,8460,2,14,10,2,43,23,20,52
Glenavon,8460,3,10,9,7,53,43,10,39
Linfield,8460,4,11,5,10,40,37,3,38
Cliftonville,8460,5,9,4,13,33,34,-1,31
Ballymena,8460,6,7,5,14,26,48,-22,26
Glentoran,8460,7,6,6,10,24,32,-8,24
Dungannon,8460,8,2,4,16,14,47,-33,10
Crusaders,8461,1,17,6,3,62,30,32,57
Coleraine,8461,2,14,10,2,45,25,20,52
Glenavon,8461,3,10,9,7,55,45,10,39
Linfield,8461,4,10,5,11,37,37,0,35
Cliftonville,8461,5,10,4,12,33,31,2,34
Ballymena,8461,6,7,4,15,25,48,-23,25
Glentoran,8461,7,6,6,10,24,32,-8,24
Dungannon,8461,8,2,4,16,14,47,-33,10
Crusaders,8462,1,17,6,3,63,31,32,57
Coleraine,8462,2,15,10,1,45,23,22,55
Glenavon,8462,3,9,9,8,53,45,8,36
Linfield,8462,4,10,5,11,39,39,0,35
Cliftonville,8462,5,10,4,12,35,33,2,34
Ballymena,8462,6,7,4,15,26,49,-23,25
Glentoran,8462,7,6,6,10,24,32,-8,24
Dungannon,8462,8,2,4,16,14,47,-33,10
Crusaders,8463,1,16,6,4,62,32,30,54
Coleraine,8463,2,14,10,2,44,26,18,52
Glenavon,8463,3,10,9,7,56,44,12,39
Linfield,8463,4,11,5,10,39,37,2,38
Cliftonville,8463,5,9,4,13,33,33,0,31
Ballymena,8463,6,8,4,14,27,48,-21,28
Glentoran,8463,7,6,6,10,24,32,-8,24
Dungannon,8463,8,2,4,16,14,47,-33,10
Crusaders,8464,1,16,6,4,63,33,30,54
Coleraine,8464,2,14,10,2,45,25,20,52
Glenavon,8464,3,10,9,7,55,45,10,39
Linfield,8464,4,11,5,10,40,38,2,38
Cliftonville,8464,5,9,4,13,34,34,0,31
Ballymena,8464,6,8,4,14,28,49,-21,28
Glentoran,8464,7,6,6,10,24,32,-8,24
Dungannon,8464,8,2,4,16,14,47,-33,10
Coleraine,8465,1,15,10,1,45,22,23,55
Crusaders,8465,2,16,6,4,61,31,30,54
Linfield,8465,3,11,5,10,38,36,2,38
Glenavon,8465,4,9,9,8,52,45,7,36
Cliftonville,8465,5,9,4,13,32,32,0,31
Ballymena,8465,6,8,4,14,26,47,-21,28
Glentoran,8465,7,6,6,10,24,32,-8,24
Dungannon,8465,8,2,4,16,14,47,-33,10
Crusaders,8466,1,16,7,3,63,32,31,55
Coleraine,8466,2,15,10,1,45,23,22,55
Glenavon,8466,3,9,9,8,53,45,8,36
Linfield,8466,4,10,5,11,37,37,0,35
Cliftonville,8466,5,10,4,12,33,31,2,34
Ballymena,8466,6,7,5,14,27,49,-22,26
Glentoran,8466,7,6,6,10,24,32,-8,24
Dungannon,8466,8,2,4,16,14,47,-33,10
Crusaders,8467,1,17,6,3,63,30,33,57
Coleraine,8467,2,14,11,1,44,23,21,53
Linfield,8467,3,11,5,10,39,36,3,38
Glenavon,8467,4,9,10,7,53,44,9,37
Cliftonville,8467,5,9,4,13,32,33,-1,31
Ballymena,8467,6,7,4,15,25,49,-24,25
Glentoran,8467,7,6,6,10,24,32,-8,24
Dungannon,8467,8,2,4,16,14,47,-33,10
Crusaders,8468,1,16,6,4,61,32,29,54
Coleraine,8468,2,14,11,1,43,22,21,53
Glenavon,8468,3,9,10,7,52,43,9,37
Linfield,8468,4,10,6,10,38,37,1,36
Cliftonville,8468,5,9,5,12,33,32,1,32
Ballymena,8468,6,8,4,14,27,47,-20,28
Glentoran,8468,7,6,6,10,24,32,-8,24
Dungannon,8468,8,2,4,16,14,47,-33,10
Crusaders,8469,1,17,6,3,65,30,35,57
Coleraine,8469,2,15,10,1,46,24,22,55
Glenavon,8469,3,9,9,8,54,46,8,36
Linfield,8469,4,10,5,11,39,39,0,35
Cliftonville,8469,5,10,4,12,35,33,2,34
Ballymena,8469,6,7,4,15,25,51,-26,25
Glentoran,8469,7,6,6,10,24,32,-8,24
Dungannon,8469,8,2,4,16,14,47,-33,10
Crusaders,8470,1,17,6,3,65,32,33,57
Coleraine,8470,2,14,10,2,44,24,20,52
Glenavon,8470,3,10,9,7,54,44,10,39
Linfield,8470,4,10,5,11,37,38,-1,35
Cliftonville,8470,5,10,4,12,34,31,3,34
Ballymena,8470,6,7,4,15,27,51,-24,25
Glentoran,8470,7,6,6,10,24,32,-8,24
Dungannon,8470,8,2,4,16,14,47,-33,10
Crusaders,8471,1,17,6,3,63,31,32,57
Coleraine,8471,2,14,11,1,44,23,21,53
Glenavon,8471,3,9,10,7,53,44,9,37
Linfield,8471,4,10,6,10,38,37,1,36
Cliftonville,8471,5,9,5,12,33,32,1,32
Ballymena,8471,6,7,4,15,26,49,-23,25
Glentoran,8471,7,6,6,10,24,32,-8,24
Dungannon,8471,8,2,4,16,14,47,-33,10
Crusaders,8472,1,16,7,3,61,30,31,55
Coleraine,8472,2,15,10,1,45,23,22,55
Linfield,8472,3,11,5,10,39,36,3,38
Glenavon,8472,4,9,9,8,53,45,8,36
Cliftonville,8472,5,9,4,13,32,33,-1,31
Ballymena,8472,6,7,5,14,25,47,-22,26
Glentoran,8472,7,6,6,10,24,32,-8,24
Dungannon,8472,8,2,4,16,14,47,-33,10
Crusaders,8473,1,17,6,3,64,31,33,57
Coleraine,8473,2,14,10,2,43,25,18,52
Glenavon,8473,3,10,9,7,55,43,12,39
Linfield,8473,4,10,5,11,37,38,-1,35
Cliftonville,8473,5,10,4,12,34,31,3,34
Ballymena,8473,6,7,4,15,26,50,-24,25
Glentoran,8473,7,6,6,10,24,32,-8,24
Dungannon,8473,8,2,4,16,14,47,-33,10
Crusaders,8474,1,17,6,3,65,30,35,57
Coleraine,8474,2,15,10,1,46,23,23,55
Linfield,8474,3,11,5,10,40,38,2,38
Glenavon,8474,4,9,9,8,53,46,7,36
Cliftonville,8474,5,9,4,13,34,34,0,31
Ballymena,8474,6,7,4,15,25,51,-26,25
Glentoran,8474,7,6,6,10,24,32,-8,24
Dungannon,8474,8,2,4,16,14,47,-33,10
Crusaders,8475,1,16,7,3,62,31,31,55
Coleraine,8475,2,14,10,2,43,25,18,52
Glenavon,8475,3,10,9,7,55,43,12,39
Linfield,8475,4,10,5,11,37,37,0,35
Cliftonville,8475,5,10,4,12,33,31,2,34
Ballymena,8475,6,7,5,14,26,48,-22,26
Glentoran,8475,7,6,6,10,24,32,-8,24
Dungannon,8475,8,2,4,16,14,47,-33,10
Crusaders,8476,1,17,6,3,63,30,33,57
Coleraine,8476,2,14,10,2,44,24,20,52
Glenavon,8476,3,10,9,7,54,44,10,39
Linfield,8476,4,11,5,10,40,37,3,38
Cliftonville,8476,5,9,4,13,33,34,-1,31
Ballymena,8476,6,7,4,15,25,49,-24,25
Glentoran,8476,7,6,6,10,24,32,-8,24
Dungannon,8476,8,2,4,16,14,47,-33,10
Crusaders,8477,1,17,6,3,67,32,35,57
Coleraine,8477,2,15,10,1,45,23,22,55
Glenavon,8477,3,9,9,8,53,45,8,36
Linfield,8477,4,10,5,11,38,39,-1,35
Cliftonville,8477,5,10,4,12,35,32,3,34
Ballymena,8477,6,7,4,15,27,53,-26,25
Glentoran,8477,7,6,6,10,24,32,-8,24
Dungannon,8477,8,2,4,16,14,47,-33,10
Crusaders,8478,1,16,6,4,63,34,29,54
Coleraine,8478,2,14,11,1,45,24,21,53
Glenavon,8478,3,9,10,7,54,45,9,37
Linfield,8478,4,10,5,11,38,39,-1,35
Cliftonville,8478,5,10,4,12,35,32,3,34
Ballymena,8478,6,8,4,14,29,49,-20,28
Glentoran,8478,7,6,6,10,24,32,-8,24
Dungannon,8478,8,2,4,16,14,47,-33,10
Crusaders,8479,1,16,7,3,63,32,31,55
Coleraine,8479,2,14,10,2,43,24,19,52
Glenavon,8479,3,10,9,7,54,43,11,39
Linfield,8479,4,11,5,10,38,36,2,38
Cliftonville,8479,5,9,4,13,32,32,0,31
Ballymena,8479,6,7,5,14,27,49,-22,26
Glentoran,8479,7,6,6,10,24,32,-8,24
Dungannon,8479,8,2,4,16,14,47,-33,10
Crusaders,8480,1,17,6,3,67,31,36,57
Coleraine,8480,2,14,11,1,43,22,21,53
Linfield,8480,3,11,5,10,39,37,2,38
Glenavon,8480,4,9,10,7,52,43,9,37
Cliftonville,8480,5,9,4,13,33,33,0,31
Ballymena,8480,6,7,4,15,26,53,-27,25
Glentoran,8480,7,6,6,10,24,32,-8,24
Dungannon,8480,8,2,4,16,14,47,-33,10
Crusaders,8481,1,17,6,3,63,31,32,57
Coleraine,8481,2,15,10,1,47,22,25,55
Linfield,8481,3,11,5,10,39,37,2,38
Glenavon,8481,4,9,9,8,52,47,5,36
Cliftonville,8481,5,9,4,13,33,33,0,31
Ballymena,8481,6,7,4,15,26,49,-23,25
Glentoran,8481,7,6,6,10,24,32,-8,24
Dungannon,8481,8,2,4,16,14,47,-33,10
Crusaders,8482,1,16,7,3,62,31,31,55
Coleraine,8482,2,14,10,2,43,26,17,52
Glenavon,8482,3,10,9,7,56,43,13,39
Linfield,8482,4,10,5,11,37,37,0,35
Cliftonville,8482,5,10,4,12,33,31,2,34
Ballymena,8482,6,7,5,14,26,48,-22,26
Glentoran,8482,7,6,6,10,24,32,-8,24
Dungannon,8482,8,2,4,16,14,47,-33,10
Crusaders,8483,1,16,6,4,63,34,29,54
Coleraine,8483,2,14,11,1,47,26,21,53
Glenavon,8483,3,9,10,7,56,47,9,37
Linfield,8483,4,10,5,11,39,40,-1,35
Cliftonville,8483,5,10,4,12,36,33,3,34
Ballymena,8483,6,8,4,14,29,49,-20,28
Glentoran,8483,7,6,6,10,24,32,-8,24
Dungannon,8483,8,2,4,16,14,47,-33,10
Crusaders,8484,1,16,6,4,61,31,30,54
Coleraine,8484,2,14,10,2,43,23,20,52
Glenavon,8484,3,10,9,7,53,43,10,39
Linfield,8484,4,11,5,10,41,38,3,38
Cliftonville,8484,5,9,4,13,34,35,-1,31
Ballymena,8484,6,8,4,14,26,47,-21,28
Glentoran,8484,7,6,6,10,24,32,-8,24
Dungannon,8484,8,2,4,16,14,47,-33,10
Crusaders,8485,1,16,6,4,61,32,29,54
Coleraine,8485,2,14,10,2,44,25,19,52
Glenavon,8485,3,10,9,7,55,44,11,39
Linfield,8485,4,10,6,10,38,37,1,36
Cliftonville,8485,5,9,5,12,33,32,1,32
Ballymena,8485,6,8,4,14,27,47,-20,28
Glentoran,8485,7,6,6,10,24,32,-8,24
Dungannon,8485,8,2,4,16,14,47,-33,10
Crusaders,8486,1,17,6,3,64,31,33,57
Coleraine,8486,2,14,11,1,46,25,21,53
Glenavon,8486,3,9,10,7,55,46,9,37
Linfield,8486,4,10,6,10,38,37,1,36
Cliftonville,8486,5,9,5,12,33,32,1,32
Ballymena,8486,6,7,4,15,26,50,-24,25
Glentoran,8486,7,6,6,10,24,32,-8,24
Dungannon,8486,8,2,4,16,14,47,-33,10
Crusaders,8487,1,16,7,3,63,32,31,55
Coleraine,8487,2,14,10,2,45,26,19,52
Glenavon,8487,3,10,9,7,56,45,11,39
Linfield,8487,4,10,5,11,37,37,0,35
Cliftonville,8487,5,10,4,12,33,31,2,34
Ballymena,8487,6,7,5,14,27,49,-22,26
Glentoran,8487,7,6,6,10,24,32,-8,24
Dungannon,8487,8,2,4,16,14,47,-33,10
Crusaders,8488,1,17,6,3,64,32,32,57
Coleraine,8488,2,14,10,2,43,23,20,52
Glenavon,8488,3,10,9,7,53,43,10,39
Linfield,8488,4,10,5,11,37,37,0,35
Cliftonville,8488,5,10,4,12,33,31,2,34
Ballymena,8488,6,7,4,15,27,50,-23,25
Glentoran,8488,7,6,6,10,24,32,-8,24
Dungannon,8488,8,2,4,16,14,47,-33,10
Crusaders,8489,1,17,6,3,64,32,32,57
Coleraine,8489,2,14,10,2,43,23,20,52
Glenavon,8489,3,10,9,7,53,43,10,39
Linfield,8489,4,11,5,10,40,37,3,38
Cliftonville,8489,5,9,4,13,33,34,-1,31
Ballymena,8489,6,7,4,15,27,50,-23,25
Glentoran,8489,7,6,6,10,24,32,-8,24
Dungannon,8489,8,2,4,16,14,47,-33,10
Crusaders,8490,1,17,6,3,62,30,32,57
Coleraine,8490,2,14,11,1,44,23,21,53
Glenavon,8490,3,9,10,7,53,44,9,37
Linfield,8490,4,10,6,10,38,37,1,36
Cliftonville,8490,5,9,5,12,33,32,1,32
Ballymena,8490,6,7,4,15,25,48,-23,25
Glentoran,8490,7,6,6,10,24,32,-8,24
Dungannon,8490,8,2,4,16,14,47,-33,10
Crusaders,8491,1,17,6,3,65,30,35,57
Coleraine,8491,2,15,10,1,48,24,24,55
Linfield,8491,3,11,5,10,40,37,3,38
Glenavon,8491,4,9,9,8,54,48,6,36
Cliftonville,8491,5,9,4,13,33,34,-1,31
Ballymena,8491,6,7,4,15,25,51,-26,25
Glentoran,8491,7,6,6,10,24,32,-8,24
Dungannon,8491,8,2,4,16,14,47,-33,10
Crusaders,8492,1,17,6,3,63,30,33,57
Coleraine,8492,2,14,11,1,43,22,21,53
Glenavon,8492,3,9,10,7,52,43,9,37
Linfield,8492,4,10,6,10,37,36,1,36
Cliftonville,8492,5,9,5,12,32,31,1,32
Ballymena,8492,6,7,4,15,25,49,-24,25
Glentoran,8492,7,6,6,10,24,32,-8,24
Dungannon,8492,8,2,4,16,14,47,-33,10
Crusaders,8493,1,16,7,3,63,32,31,55
Coleraine,8493,2,14,10,2,44,24,20,52
Glenavon,8493,3,10,9,7,54,44,10,39
Linfield,8493,4,11,5,10,38,36,2,38
Cliftonville,8493,5,9,4,13,32,32,0,31
Ballymena,8493,6,7,5,14,27,49,-22,26
Glentoran,8493,7,6,6,10,24,32,-8,24
Dungannon,8493,8,2,4,16,14,47,-33,10
Crusaders,8494,1,16,7,3,61,30,31,55
Coleraine,8494,2,14,10,2,43,24,19,52
Glenavon,8494,3,10,9,7,54,43,11,39
Linfield,8494,4,10,5,11,37,39,-2,35
Cliftonville,8494,5,10,4,12,35,31,4,34
Ballymena,8494,6,7,5,14,25,47,-22,26
Glentoran,8494,7,6,6,10,24,32,-8,24
Dungannon,8494,8,2,4,16,14,47,-33,10
Crusaders,8495,1,17,6,3,64,31,33,57
Coleraine,8495,2,15,10,1,49,23,26,55
Glenavon,8495,3,9,9,8,53,49,4,36
Linfield,8495,4,10,6,10,39,38,1,36
Cliftonville,8495,5,9,5,12,34,33,1,32
Ballymena,8495,6,7,4,15,26,50,-24,25
Glentoran,8495,7,6,6,10,24,32,-8,24
Dungannon,8495,8,2,4,16,14,47,-33,10
Coleraine,8496,1,15,10,1,46,24,22,55
Crusaders,8496,2,16,6,4,62,32,30,54
Glenavon,8496,3,9,9,8,54,46,8,36
Linfield,8496,4,10,6,10,38,37,1,36
Cliftonville,8496,5,9,5,12,33,32,1,32
Ballymena,8496,6,8,4,14,27,48,-21,28
Glentoran,8496,7,6,6,10,24,32,-8,24
Dungannon,8496,8,2,4,16,14,47,-33,10
Coleraine,8497,1,15,10,1,47,23,24,55
Crusaders,8497,2,16,6,4,64,34,30,54
Linfield,8497,3,11,5,10,39,37,2,38
Glenavon,8497,4,9,9,8,53,47,6,36
Cliftonville,8497,5,9,4,13,33,33,0,31
Ballymena,8497,6,8,4,14,29,50,-21,28
Glentoran,8497,7,6,6,10,24,32,-8,24
Dungannon,8497,8,2,4,16,14,47,-33,10
Crusaders,8498,1,17,6,3,64,30,34,57
Coleraine,8498,2,15,10,1,47,23,24,55
Glenavon,8498,3,9,9,8,53,47,6,36
Linfield,8498,4,10,5,11,37,37,0,35
Cliftonville,8498,5,10,4,12,33,31,2,34
Ballymena,8498,6,7,4,15,25,50,-25,25
Glentoran,8498,7,6,6,10,24,32,-8,24
Dungannon,8498,8,2,4,16,14,47,-33,10
Crusaders,8499,1,16,6,4,61,32,29,54
Coleraine,8499,2,14,10,2,43,24,19,52
Glenavon,8499,3,10,9,7,54,43,11,39
Linfield,8499,4,11,5,10,39,37,2,38
Cliftonville,8499,5,9,4,13,33,33,0,31
Ballymena,8499,6,8,4,14,27,47,-20,28
Glentoran,8499,7,6,6,10,24,32,-8,24
Dungannon,8499,8,2,4,16,14,47,-33,10
Crusaders,8500,1,16,7,3,62,31,31,55
Coleraine,8500,2,15,10,1,46,24,22,55
Glenavon,8500,3,9,9,8,54,46,8,36
Linfield,8500,4,10,6,10,37,36,1,36
Cliftonville,8500,5,9,5,12,32,31,1,32
Ballymena,8500,6,7,5,14,26,48,-22,26
Glentoran,8500,7,6,6,10,24,32,-8,24
Dungannon,8500,8,2,4,16,14,47,-33,10
Crusaders,8501,1,17,6,3,63,31,32,57
Coleraine,8501,2,14,10,2,43,25,18,52
Glenavon,8501,3,10,9,7,55,43,12,39
Linfield,8501,4,11,5,10,41,38,3,38
Cliftonville,8501,5,9,4,13,34,35,-1,31
Ballymena,8501,6,7,4,15,26,49,-23,25
Glentoran,8501,7,6,6,10,24,32,-8,24
Dungannon,8501,8,2,4,16,14,47,-33,10
Crusaders,8502,1,17,6,3,62,30,32,57
Coleraine,8502,2,14,10,2,43,23,20,52
Glenavon,8502,3,10,9,7,53,43,10,39
Linfield,8502,4,10,5,11,37,37,0,35
Cliftonville,8502,5,10,4,12,33,31,2,34
Ballymena,8502,6,7,4,15,25,48,-23,25
Glentoran,8502,7,6,6,10,24,32,-8,24
Dungannon,8502,8,2,4,16,14,47,-33,10
Crusaders,8503,1,17,6,3,65,32,33,57
Coleraine,8503,2,15,10,1,47,22,25,55
Glenavon,8503,3,9,9,8,52,47,5,36
Linfield,8503,4,10,5,11,39,39,0,35
Cliftonville,8503,5,10,4,12,35,33,2,34
Ballymena,8503,6,7,4,15,27,51,-24,25
Glentoran,8503,7,6,6,10,24,32,-8,24
Dungannon,8503,8,2,4,16,14,47,-33,10
Coleraine,8504,1,15,10,1,46,22,24,55
Crusaders,8504,2,16,6,4,64,34,30,54
Glenavon,8504,3,9,9,8,52,46,6,36
Linfield,8504,4,10,5,11,37,38,-1,35
Cliftonville,8504,5,10,4,12,34,31,3,34
Ballymena,8504,6,8,4,14,29,50,-21,28
Glentoran,8504,7,6,6,10,24,32,-8,24
Dungannon,8504,8,2,4,16,14,47,-33,10
Crusaders,8505,1,17,6,3,62,30,32,57
Coleraine,8505,2,14,10,2,44,24,20,52
Glenavon,8505,3,10,9,7,54,44,10,39
Linfield,8505,4,10,6,10,38,37,1,36
Cliftonville,8505,5,9,5,12,33,32,1,32
Ballymena,8505,6,7,4,15,25,48,-23,25
Glentoran,8505,7,6,6,10,24,32,-8,24
Dungannon,8505,8,2,4,16,14,47,-33,10
Crusaders,8506,1,16,6,4,61,32,29,54
Coleraine,8506,2,14,10,2,44,24,20,52
Glenavon,8506,3,10,9,7,54,44,10,39
Linfield,8506,4,11,5,10,38,36,2,38
Cliftonville,8506,5,9,4,13,32,32,0,31
Ballymena,8506,6,8,4,14,27,47,-20,28
Glentoran,8506,7,6,6,10,24,32,-8,24
Dungannon,8506,8,2,4,16,14,47,-33,10
Coleraine,8507,1,15,10,1,46,23,23,55
Crusaders,8507,2,16,6,4,62,35,27,54
Glenavon,8507,3,9,9,8,53,46,7,36
Linfield,8507,4,10,5,11,37,38,-1,35
Cliftonville,8507,5,10,4,12,34,31,3,34
Ballymena,8507,6,8,4,14,30,48,-18,28
Glentoran,8507,7,6,6,10,24,32,-8,24
Dungannon,8507,8,2,4,16,14,47,-33,10
Crusaders,8508,1,17,6,3,62,30,32,57
Coleraine,8508,2,14,10,2,45,27,18,52
Glenavon,8508,3,10,9,7,57,45,12,39
Linfield,8508,4,11,5,10,40,36,4,38
Cliftonville,8508,5,9,4,13,32,34,-2,31
Ballymena,8508,6,7,4,15,25,48,-23,25
Glentoran,8508,7,6,6,10,24,32,-8,24
Dungannon,8508,8,2,4,16,14,47,-33,10
Crusaders,8509,1,17,6,3,64,31,33,57
Coleraine,8509,2,15,10,1,46,23,23,55
Linfield,8509,3,11,5,10,39,37,2,38
Glenavon,8509,4,9,9,8,53,46,7,36
Cliftonville,8509,5,9,4,13,33,33,0,31
Ballymena,8509,6,7,4,15,26,50,-24,25
Glentoran,8509,7,6,6,10,24,32,-8,24
Dungannon,8509,8,2,4,16,14,47,-33,10
Crusaders,8510,1,17,6,3,62,30,32,57
Coleraine,8510,2,14,10,2,43,23,20,52
Glenavon,8510,3,10,9,7,53,43,10,39
Linfield,8510,4,10,5,11,38,39,-1,35
Cliftonville,8510,5,10,4,12,35,32,3,34
Ballymena,8510,6,7,4,15,25,48,-23,25
Glentoran,8510,7,6,6,10,24,32,-8,24
Dungannon,8510,8,2,4,16,14,47,-33,10
Crusaders,8511,1,17,6,3,65,30,35,57
Coleraine,8511,2,14,10,2,44,24,20,52
Glenavon,8511,3,10,9,7,54,44,10,39
Linfield,8511,4,10,5,11,38,38,0,35
Cliftonville,8511,5,10,4,12,34,32,2,34
Ballymena,8511,6,7,4,15,25,51,-26,25
Glentoran,8511,7,6,6,10,24,32,-8,24
Dungannon,8511,8,2,4,16,14,47,-33,10
Crusaders,8512,1,17,6,3,64,30,34,57
Coleraine,8512,2,14,10,2,43,28,15,52
Glenavon,8512,3,10,9,7,58,43,15,39
Linfield,8512,4,11,5,10,38,36,2,38
Cliftonville,8512,5,9,4,13,32,32,0,31
Ballymena,8512,6,7,4,15,25,50,-25,25
Glentoran,8512,7,6,6,10,24,32,-8,24
Dungannon,8512,8,2,4,16,14,47,-33,10
Crusaders,8513,1,17,6,3,64,31,33,57
Coleraine,8513,2,14,10,2,44,25,19,52
Glenavon,8513,3,10,9,7,55,44,11,39
Linfield,8513,4,11,5,10,38,36,2,38
Cliftonville,8513,5,9,4,13,32,32,0,31
Ballymena,8513,6,7,4,15,26,50,-24,25
Glentoran,8513,7,6,6,10,24,32,-8,24
Dungannon,8513,8,2,4,16,14,47,-33,10
Crusaders,8514,1,17,6,3,65,32,33,57
Coleraine,8514,2,14,10,2,43,24,19,52
Glenavon,8514,3,10,9,7,54,43,11,39
Linfield,8514,4,11,5,10,40,36,4,38
Cliftonville,8514,5,9,4,13,32,34,-2,31
Ballymena,8514,6,7,4,15,27,51,-24,25
Glentoran,8514,7,6,6,10,24,32,-8,24
Dungannon,8514,8,2,4,16,14,47,-33,10
Crusaders,8515,1,16,7,3,63,32,31,55
Coleraine,8515,2,14,11,1,45,24,21,53
Glenavon,8515,3,9,10,7,54,45,9,37
Linfield,8515,4,10,5,11,37,38,-1,35
Cliftonville,8515,5,10,4,12,34,31,3,34
Ballymena,8515,6,7,5,14,27,49,-22,26
Glentoran,8515,7,6,6,10,24,32,-8,24
Dungannon,8515,8,2,4,16,14,47,-33,10
Crusaders,8516,1,16,6,4,61,32,29,54
Coleraine,8516,2,14,10,2,43,23,20,52
Glenavon,8516,3,10,9,7,53,43,10,39
Linfield,8516,4,10,6,10,39,38,1,36
Cliftonville,8516,5,9,5,12,34,33,1,32
Ballymena,8516,6,8,4,14,27,47,-20,28
Glentoran,8516,7,6,6,10,24,32,-8,24
Dungannon,8516,8,2,4,16,14,47,-33,10
Crusaders,8517,1,16,7,3,62,31,31,55
Coleraine,8517,2,14,10,2,43,24,19,52
Glenavon,8517,3,10,9,7,54,43,11,39
Linfield,8517,4,10,5,11,38,39,-1,35
Cliftonville,8517,5,10,4,12,35,32,3,34
Ballymena,8517,6,7,5,14,26,48,-22,26
Glentoran,8517,7,6,6,10,24,32,-8,24
Dungannon,8517,8,2,4,16,14,47,-33,10
Coleraine,8518,1,15,10,1,46,22,24,55
Crusaders,8518,2,16,6,4,61,32,29,54
Glenavon,8518,3,9,9,8,52,46,6,36
Linfield,8518,4,10,5,11,37,38,-1,35
Cliftonville,8518,5,10,4,12,34,31,3,34
Ballymena,8518,6,8,4,14,27,47,-20,28
Glentoran,8518,7,6,6,10,24,32,-8,24
Dungannon,8518,8,2,4,16,14,47,-33,10
Crusaders,8519,1,16,7,3,61,30,31,55
Coleraine,8519,2,14,11,1,44,23,21,53
Glenavon,8519,3,9,10,7,53,44,9,37
Linfield,8519,4,10,5,11,38,38,0,35
Cliftonville,8519,5,10,4,12,34,32,2,34
Ballymena,8519,6,7,5,14,25,47,-22,26
Glentoran,8519,7,6,6,10,24,32,-8,24
Dungannon,8519,8,2,4,16,14,47,-33,10
Coleraine,8520,1,15,10,1,46,23,23,55
Crusaders,8520,2,16,6,4,62,34,28,54
Linfield,8520,3,11,5,10,39,36,3,38
Glenavon,8520,4,9,9,8,53,46,7,36
Cliftonville,8520,5,9,4,13,32,33,-1,31
Ballymena,8520,6,8,4,14,29,48,-19,28
Glentoran,8520,7,6,6,10,24,32,-8,24
Dungannon,8520,8,2,4,16,14,47,-33,10
Crusaders,8521,1,16,6,4,61,32,29,54
Coleraine,8521,2,14,10,2,43,24,19,52
Glenavon,8521,3,10,9,7,54,43,11,39
Linfield,8521,4,10,5,11,37,37,0,35
Cliftonville,8521,5,10,4,12,33,31,2,34
Ballymena,8521,6,8,4,14,27,47,-20,28
Glentoran,8521,7,6,6,10,24,32,-8,24
Dungannon,8521,8,2,4,16,14,47,-33,10
Crusaders,8522,1,17,6,3,63,31,32,57
Coleraine,8522,2,14,11,1,43,22,21,53
Glenavon,8522,3,9,10,7,52,43,9,37
Linfield,8522,4,10,5,11,39,40,-1,35
Cliftonville,8522,5,10,4,12,36,33,3,34
Ballymena,8522,6,7,4,15,26,49,-23,25
Glentoran,8522,7,6,6,10,24,32,-8,24
Dungannon,8522,8,2,4,16,14,47,-33,10
Crusaders,8523,1,17,6,3,63,30,33,57
Coleraine,8523,2,14,10,2,43,25,18,52
Glenavon,8523,3,10,9,7,55,43,12,39
Linfield,8523,4,11,5,10,40,37,3,38
Cliftonville,8523,5,9,4,13,33,34,-1,31
Ballymena,8523,6,7,4,15,25,49,-24,25
Glentoran,8523,7,6,6,10,24,32,-8,24
Dungannon,8523,8,2,4,16,14,47,-33,10
Crusaders,8524,1,16,7,3,63,32,31,55
Coleraine,8524,2,14,10,2,44,25,19,52
Glenavon,8524,3,10,9,7,55,44,11,39
Linfield,8524,4,11,5,10,38,36,2,38
Cliftonville,8524,5,9,4,13,32,32,0,31
Ballymena,8524,6,7,5,14,27,49,-22,26
Glentoran,8524,7,6,6,10,24,32,-8,24
Dungannon,8524,8,2,4,16,14,47,-33,10
Crusaders,8525,1,17,6,3,64,32,32,57
Coleraine,8525,2,14,10,2,43,26,17,52
Glenavon,8525,3,10,9,7,56,43,13,39
Linfield,8525,4,11,5,10,40,38,2,38
Cliftonville,8525,5,9,4,13,34,34,0,31
Ballymena,8525,6,7,4,15,27,50,-23,25
Glentoran,8525,7,6,6,10,24,32,-8,24
Dungannon,8525,8,2,4,16,14,47,-33,10
Crusaders,8526,1,17,6,3,63,31,32,57
Coleraine,8526,2,14,11,1,43,22,21,53
Linfield,8526,3,11,5,10,39,37,2,38
Glenavon,8526,4,9,10,7,52,43,9,37
Cliftonville,8526,5,9,4,13,33,33,0,31
Ballymena,8526,6,7,4,15,26,49,-23,25
Glentoran,8526,7,6,6,10,24,32,-8,24
Dungannon,8526,8,2,4,16,14,47,-33,10
Crusaders,8527,1,16,6,4,62,32,30,54
Coleraine,8527,2,14,11,1,45,24,21,53
Glenavon,8527,3,9,10,7,54,45,9,37
Linfield,8527,4,10,6,10,38,37,1,36
Cliftonville,8527,5,9,5,12,33,32,1,32
Ballymena,8527,6,8,4,14,27,48,-21,28
Glentoran,8527,7,6,6,10,24,32,-8,24
Dungannon,8527,8,2,4,16,14,47,-33,10
Crusaders,8528,1,16,7,3,64,33,31,55
Coleraine,8528,2,14,10,2,43,25,18,52
Glenavon,8528,3,10,9,7,55,43,12,39
Linfield,8528,4,11,5,10,40,36,4,38
Cliftonville,8528,5,9,4,13,32,34,-2,31
Ballymena,8528,6,7,5,14,28,50,-22,26
Glentoran,8528,7,6,6,10,24,32,-8,24
Dungannon,8528,8,2,4,16,14,47,-33,10
Crusaders,8529,1,17,6,3,66,31,35,57
Coleraine,8529,2,14,11,1,44,23,21,53
Glenavon,8529,3,9,10,7,53,44,9,37
Linfield,8529,4,10,5,11,38,38,0,35
Cliftonville,8529,5,10,4,12,34,32,2,34
Ballymena,8529,6,7,4,15,26,52,-26,25
Glentoran,8529,7,6,6,10,24,32,-8,24
Dungannon,8529,8,2,4,16,14,47,-33,10
Crusaders,8530,1,16,7,3,63,32,31,55
Coleraine,8530,2,15,10,1,46,24,22,55
Linfield,8530,3,11,5,10,40,37,3,38
Glenavon,8530,4,9,9,8,54,46,8,36
Cliftonville,8530,5,9,4,13,33,34,-1,31
Ballymena,8530,6,7,5,14,27,49,-22,26
Glentoran,8530,7,6,6,10,24,32,-8,24
Dungannon,8530,8,2,4,16,14,47,-33,10
Crusaders,8531,1,16,6,4,62,32,30,54
Coleraine,8531,2,14,11,1,44,23,21,53
Glenavon,8531,3,9,10,7,53,44,9,37
Linfield,8531,4,10,5,11,37,37,0,35
Cliftonville,8531,5,10,4,12,33,31,2,34
Ballymena,8531,6,8,4,14,27,48,-21,28
Glentoran,8531,7,6,6,10,24,32,-8,24
Dungannon,8531,8,2,4,16,14,47,-33,10
Coleraine,8532,1,15,10,1,45,23,22,55
Crusaders,8532,2,16,6,4,61,33,28,54
Glenavon,8532,3,9,9,8,53,45,8,36
Linfield,8532,4,10,5,11,38,38,0,35
Cliftonville,8532,5,10,4,12,34,32,2,34
Ballymena,8532,6,8,4,14,28,47,-19,28
Glentoran,8532,7,6,6,10,24,32,-8,24
Dungannon,8532,8,2,4,16,14,47,-33,10
Crusaders,8533,1,16,7,3,63,32,31,55
Coleraine,8533,2,14,10,2,44,24,20,52
Glenavon,8533,3,10,9,7,54,44,10,39
Linfield,8533,4,11,5,10,40,36,4,38
Cliftonville,8533,5,9,4,13,32,34,-2,31
Ballymena,8533,6,7,5,14,27,49,-22,26
Glentoran,8533,7,6,6,10,24,32,-8,24
Dungannon,8533,8,2,4,16,14,47,-33,10
Crusaders,8534,1,17,6,3,64,31,33,57
Coleraine,8534,2,14,10,2,44,26,18,52
Glenavon,8534,3,10,9,7,56,44,12,39
Linfield,8534,4,10,6,10,37,36,1,36
Cliftonville,8534,5,9,5,12,32,31,1,32
Ballymena,8534,6,7,4,15,26,50,-24,25
Glentoran,8534,7,6,6,10,24,32,-8,24
Dungannon,8534,8,2,4,16,14,47,-33,10
Crusaders,8535,1,17,6,3,64,32,32,57
Coleraine,8535,2,14,11,1,44,23,21,53
Glenavon,8535,3,9,10,7,53,44,9,37
Linfield,8535,4,10,5,11,38,38,0,35
Cliftonville,8535,5,10,4,12,34,32,2,34
Ballymena,8535,6,7,4,15,27,50,-23,25
Glentoran,8535,7,6,6,10,24,32,-8,24
Dungannon,8535,8,2,4,16,14,47,-33,10
Crusaders,8536,1,17,6,3,63,31,32,57
Coleraine,8536,2,15,10,1,44,22,22,55
Glenavon,8536,3,9,9,8,52,44,8,36
Linfield,8536,4,10,5,11,39,39,0,35
Cliftonville,8536,5,10,4,12,35,33,2,34
Ballymena,8536,6,7,4,15,26,49,-23,25
Glentoran,8536,7,6,6,10,24,32,-8,24
Dungannon,8536,8,2,4,16,14,47,-33,10
Crusaders,8537,1,16,6,4,62,32,30,54
Coleraine,8537,2,14,11,1,44,23,21,53
Glenavon,8537,3,9,10,7,53,44,9,37
Linfield,8537,4,10,6,10,39,38,1,36
Cliftonville,8537,5,9,5,12,34,33,1,32
Ballymena,8537,6,8,4,14,27,48,-21,28
Glentoran,8537,7,6,6,10,24,32,-8,24
Dungannon,8537,8,2,4,16,14,47,-33,10
Crusaders,8538,1,17,6,3,64,31,33,57
Coleraine,8538,2,14,11,1,44,23,21,53
Linfield,8538,3,11,5,10,38,36,2,38
Glenavon,8538,4,9,10,7,53,44,9,37
Cliftonville,8538,5,9,4,13,32,32,0,31
Ballymena,8538,6,7,4,15,26,50,-24,25
Glentoran,8538,7,6,6,10,24,32,-8,24
Dungannon,8538,8,2,4,16,14,47,-33,10
Coleraine,8539,1,15,10,1,45,22,23,55
Crusaders,8539,2,16,6,4,63,33,30,54
Glenavon,8539,3,9,9,8,52,45,7,36
Linfield,8539,4,10,6,10,38,37,1,36
Cliftonville,8539,5,9,5,12,33,32,1,32
Ballymena,8539,6,8,4,14,28,49,-21,28
Glentoran,8539,7,6,6,10,24,32,-8,24
Dungannon,8539,8,2,4,16,14,47,-33,10
Crusaders,8540,1,16,7,3,62,31,31,55
Coleraine,8540,2,14,11,1,44,23,21,53
Glenavon,8540,3,9,10,7,53,44,9,37
Linfield,8540,4,10,6,10,40,39,1,36
Cliftonville,8540,5,9,5,12,35,34,1,32
Ballymena,8540,6,7,5,14,26,48,-22,26
Glentoran,8540,7,6,6,10,24,32,-8,24
Dungannon,8540,8,2,4,16,14,47,-33,10
Coleraine,8541,1,15,10,1,45,23,22,55
Crusaders,8541,2,16,6,4,61,31,30,54
Glenavon,8541,3,9,9,8,53,45,8,36
Linfield,8541,4,10,5,11,38,38,0,35
Cliftonville,8541,5,10,4,12,34,32,2,34
Ballymena,8541,6,8,4,14,26,47,-21,28
Glentoran,8541,7,6,6,10,24,32,-8,24
Dungannon,8541,8,2,4,16,14,47,-33,10
Crusaders,8542,1,17,6,3,64,32,32,57
Coleraine,8542,2,15,10,1,47,23,24,55
Linfield,8542,3,11,5,10,43,39,4,38
Glenavon,8542,4,9,9,8,53,47,6,36
Cliftonville,8542,5,9,4,13,35,37,-2,31
Ballymena,8542,6,7,4,15,27,50,-23,25
Glentoran,8542,7,6,6,10,24,32,-8,24
Dungannon,8542,8,2,4,16,14,47,-33,10
Crusaders,8543,1,16,6,4,62,33,29,54
Coleraine,8543,2,14,10,2,43,23,20,52
Glenavon,8543,3,10,9,7,53,43,10,39
Linfield,8543,4,11,5,10,39,36,3,38
Cliftonville,8543,5,9,4,13,32,33,-1,31
Ballymena,8543,6,8,4,14,28,48,-20,28
Glentoran,8543,7,6,6,10,24,32,-8,24
Dungannon,8543,8,2,4,16,14,47,-33,10
Crusaders,8544,1,16,7,3,62,31,31,55
Coleraine,8544,2,15,10,1,45,23,22,55
Glenavon,8544,3,9,9,8,53,45,8,36
Linfield,8544,4,10,5,11,38,38,0,35
Cliftonville,8544,5,10,4,12,34,32,2,34
Ballymena,8544,6,7,5,14,26,48,-22,26
Glentoran,8544,7,6,6,10,24,32,-8,24
Dungannon,8544,8,2,4,16,14,47,-33,10
Crusaders,8545,1,17,6,3,63,30,33,57
Coleraine,8545,2,14,10,2,44,24,20,52
Glenavon,8545,3,10,9,7,54,44,10,39
Linfield,8545,4,10,6,10,39,38,1,36
Cliftonville,8545,5,9,5,12,34,33,1,32
Ballymena,8545,6,7,4,15,25,49,-24,25
Glentoran,8545,7,6,6,10,24,32,-8,24
Dungannon,8545,8,2,4,16,14,47,-33,10
Crusaders,8546,1,17,6,3,63,31,32,57
Coleraine,8546,2,15,10,1,47,23,24,55
Glenavon,8546,3,9,9,8,53,47,6,36
Linfield,8546,4,10,5,11,37,37,0,35
Cliftonville,8546,5,10,4,12,33,31,2,34
Ballymena,8546,6,7,4,15,26,49,-23,25
Glentoran,8546,7,6,6,10,24,32,-8,24
Dungannon,8546,8,2,4,16,14,47,-33,10
Crusaders,8547,1,17,6,3,62,30,32,57
Coleraine,8547,2,15,10,1,44,22,22,55
Glenavon,8547,3,9,9,8,52,44,8,36
Linfield,8547,4,10,5,11,37,39,-2,35
Cliftonville,8547,5,10,4,12,35,31,4,34
Ballymena,8547,6,7,4,15,25,48,-23,25
Glentoran,8547,7,6,6,10,24,32,-8,24
Dungannon,8547,8,2,4,16,14,47,-33,10
Coleraine,8548,1,15,10,1,44,22,22,55
Crusaders,8548,2,16,6,4,62,32,30,54
Glenavon,8548,3,9,9,8,52,44,8,36
Linfield,8548,4,10,5,11,37,37,0,35
Cliftonville,8548,5,10,4,12,33,31,2,34
Ballymena,8548,6,8,4,14,27,48,-21,28
Glentoran,8548,7,6,6,10,24,32,-8,24
Dungannon,8548,8,2,4,16,14,47,-33,10
Crusaders,8549,1,17,6,3,63,31,32,57
Coleraine,8549,2,15,10,1,46,22,24,55
Linfield,8549,3,11,5,10,38,36,2,38
Glenavon,8549,4,9,9,8,52,46,6,36
Cliftonville,8549,5,9,4,13,32,32,0,31
Ballymena,8549,6,7,4,15,26,49,-23,25
Glentoran,8549,7,6,6,10,24,32,-8,24
Dungannon,8549,8,2,4,16,14,47,-33,10
Crusaders,8550,1,16,6,4,61,32,29,54
Coleraine,8550,2,14,10,2,43,24,19,52
Glenavon,8550,3,10,9,7,54,43,11,39
Linfield,8550,4,11,5,10,39,37,2,38
Cliftonville,8550,5,9,4,13,33,33,0,31
Ballymena,8550,6,8,4,14,27,47,-20,28
Glentoran,8550,7,6,6,10,24,32,-8,24
Dungannon,8550,8,2,4,16,14,47,-33,10
Crusaders,8551,1,16,6,4,62,33,29,54
Coleraine,8551,2,14,11,1,44,23,21,53
Linfield,8551,3,11,5,10,39,36,3,38
Glenavon,8551,4,9,10,7,53,44,9,37
Cliftonville,8551,5,9,4,13,32,33,-1,31
Ballymena,8551,6,8,4,14,28,48,-20,28
Glentoran,8551,7,6,6,10,24,32,-8,24
Dungannon,8551,8,2,4,16,14,47,-33,10
Crusaders,8552,1,16,7,3,62,31,31,55
Coleraine,8552,2,15,10,1,46,23,23,55
Glenavon,8552,3,9,9,8,53,46,7,36
Linfield,8552,4,10,5,11,37,37,0,35
Cliftonville,8552,5,10,4,12,33,31,2,34
Ballymena,8552,6,7,5,14,26,48,-22,26
Glentoran,8552,7,6,6,10,24,32,-8,24
Dungannon,8552,8,2,4,16,14,47,-33,10
Crusaders,8553,1,16,7,3,62,31,31,55
Coleraine,8553,2,14,10,2,44,24,20,52
Glenavon,8553,3,10,9,7,54,44,10,39
Linfield,8553,4,11,5,10,40,37,3,38
Cliftonville,8553,5,9,4,13,33,34,-1,31
Ballymena,8553,6,7,5,14,26,48,-22,26
Glentoran,8553,7,6,6,10,24,32,-8,24
Dungannon,8553,8,2,4,16,14,47,-33,10
Crusaders,8554,1,17,6,3,62,30,32,57
Coleraine,8554,2,14,11,1,43,22,21,53
Linfield,8554,3,11,5,10,39,36,3,38
Glenavon,8554,4,9,10,7,52,43,9,37
Cliftonville,8554,5,9,4,13,32,33,-1,31
Ballymena,8554,6,7,4,15,25,48,-23,25
Glentoran,8554,7,6,6,10,24,32,-8,24
Dungannon,8554,8,2,4,16,14,47,-33,10
Crusaders,8555,1,16,7,3,64,33,31,55
Coleraine,8555,2,14,10,2,44,24,20,52
Glenavon,8555,3,10,9,7,54,44,10,39
Linfield,8555,4,10,6,10,38,37,1,36
Cliftonville,8555,5,9,5,12,33,32,1,32
Ballymena,8555,6,7,5,14,28,50,-22,26
Glentoran,8555,7,6,6,10,24,32,-8,24
Dungannon,8555,8,2,4,16,14,47,-33,10
Crusaders,8556,1,17,6,3,64,30,34,57
Coleraine,8556,2,14,10,2,44,24,20,52
Glenavon,8556,3,10,9,7,54,44,10,39
Linfield,8556,4,10,5,11,37,37,0,35
Cliftonville,8556,5,10,4,12,33,31,2,34
Ballymena,8556,6,7,4,15,25,50,-25,25
Glentoran,8556,7,6,6,10,24,32,-8,24
Dungannon,8556,8,2,4,16,14,47,-33,10
Crusaders,8557,1,16,7,3,63,32,31,55
Coleraine,8557,2,14,11,1,45,24,21,53
Linfield,8557,3,11,5,10,38,36,2,38
Glenavon,8557,4,9,10,7,54,45,9,37
Cliftonville,8557,5,9,4,13,32,32,0,31
Ballymena,8557,6,7,5,14,27,49,-22,26
Glentoran,8557,7,6,6,10,24,32,-8,24
Dungannon,8557,8,2,4,16,14,47,-33,10
Crusaders,8558,1,17,6,3,64,31,33,57
Coleraine,8558,2,14,10,2,44,25,19,52
Glenavon,8558,3,10,9,7,55,44,11,39
Linfield,8558,4,10,5,11,37,37,0,35
Cliftonville,8558,5,10,4,12,33,31,2,34
Ballymena,8558,6,7,4,15,26,50,-24,25
Glentoran,8558,7,6,6,10,24,32,-8,24
Dungannon,8558,8,2,4,16,14,47,-33,10
Crusaders,8559,1,17,6,3,63,31,32,57
Coleraine,8559,2,15,10,1,45,23,22,55
Linfield,8559,3,11,5,10,40,37,3,38
Glenavon,8559,4,9,9,8,53,45,8,36
Cliftonville,8559,5,9,4,13,33,34,-1,31
Ballymena,8559,6,7,4,15,26,49,-23,25
Glentoran,8559,7,6,6,10,24,32,-8,24
Dungannon,8559,8,2,4,16,14,47,-33,10
Crusaders,8560,1,17,6,3,64,31,33,57
Coleraine,8560,2,15,10,1,47,25,22,55
Linfield,8560,3,11,5,10,40,38,2,38
Glenavon,8560,4,9,9,8,55,47,8,36
Cliftonville,8560,5,9,4,13,34,34,0,31
Ballymena,8560,6,7,4,15,26,50,-24,25
Glentoran,8560,7,6,6,10,24,32,-8,24
Dungannon,8560,8,2,4,16,14,47,-33,10
Crusaders,8561,1,17,6,3,62,30,32,57
Coleraine,8561,2,15,10,1,45,23,22,55
Linfield,8561,3,11,5,10,40,38,2,38
Glenavon,8561,4,9,9,8,53,45,8,36
Cliftonville,8561,5,9,4,13,34,34,0,31
Ballymena,8561,6,7,4,15,25,48,-23,25
Glentoran,8561,7,6,6,10,24,32,-8,24
Dungannon,8561,8,2,4,16,14,47,-33,10
Crusaders,8562,1,17,6,3,65,31,34,57
Coleraine,8562,2,15,10,1,46,22,24,55
Linfield,8562,3,11,5,10,38,36,2,38
Glenavon,8562,4,9,9,8,52,46,6,36
Cliftonville,8562,5,9,4,13,32,32,0,31
Ballymena,8562,6,7,4,15,26,51,-25,25
Glentoran,8562,7,6,6,10,24,32,-8,24
Dungannon,8562,8,2,4,16,14,47,-33,10
Crusaders,8563,1,16,7,3,62,31,31,55
Coleraine,8563,2,14,10,2,45,25,20,52
Glenavon,8563,3,10,9,7,55,45,10,39
Linfield,8563,4,10,5,11,39,39,0,35
Cliftonville,8563,5,10,4,12,35,33,2,34
Ballymena,8563,6,7,5,14,26,48,-22,26
Glentoran,8563,7,6,6,10,24,32,-8,24
Dungannon,8563,8,2,4,16,14,47,-33,10
Crusaders,8564,1,16,6,4,61,32,29,54
Coleraine,8564,2,14,11,1,44,23,21,53
Linfield,8564,3,11,5,10,38,36,2,38
Glenavon,8564,4,9,10,7,53,44,9,37
Cliftonville,8564,5,9,4,13,32,32,0,31
Ballymena,8564,6,8,4,14,27,47,-20,28
Glentoran,8564,7,6,6,10,24,32,-8,24
Dungannon,8564,8,2,4,16,14,47,-33,10
Crusaders,8565,1,17,6,3,64,31,33,57
Coleraine,8565,2,15,10,1,45,23,22,55
Glenavon,8565,3,9,9,8,53,45,8,36
Linfield,8565,4,10,6,10,37,36,1,36
Cliftonville,8565,5,9,5,12,32,31,1,32
Ballymena,8565,6,7,4,15,26,50,-24,25
Glentoran,8565,7,6,6,10,24,32,-8,24
Dungannon,8565,8,2,4,16,14,47,-33,10
Crusaders,8566,1,17,6,3,64,31,33,57
Coleraine,8566,2,14,10,2,44,24,20,52
Glenavon,8566,3,10,9,7,54,44,10,39
Linfield,8566,4,10,5,11,39,39,0,35
Cliftonville,8566,5,10,4,12,35,33,2,34
Ballymena,8566,6,7,4,15,26,50,-24,25
Glentoran,8566,7,6,6,10,24,32,-8,24
Dungannon,8566,8,2,4,16,14,47,-33,10
Crusaders,8567,1,17,6,3,62,30,32,57
Coleraine,8567,2,14,10,2,44,26,18,52
Glenavon,8567,3,10,9,7,56,44,12,39
Linfield,8567,4,11,5,10,40,36,4,38
Cliftonville,8567,5,9,4,13,32,34,-2,31
Ballymena,8567,6,7,4,15,25,48,-23,25
Glentoran,8567,7,6,6,10,24,32,-8,24
Dungannon,8567,8,2,4,16,14,47,-33,10
Crusaders,8568,1,17,6,3,66,30,36,57
Coleraine,8568,2,14,10,2,43,24,19,52
Glenavon,8568,3,10,9,7,54,43,11,39
Linfield,8568,4,10,6,10,39,38,1,36
Cliftonville,8568,5,9,5,12,34,33,1,32
Ballymena,8568,6,7,4,15,25,52,-27,25
Glentoran,8568,7,6,6,10,24,32,-8,24
Dungannon,8568,8,2,4,16,14,47,-33,10
Crusaders,8569,1,17,6,3,63,30,33,57
Coleraine,8569,2,14,10,2,43,23,20,52
Glenavon,8569,3,10,9,7,53,43,10,39
Linfield,8569,4,10,5,11,37,37,0,35
Cliftonville,8569,5,10,4,12,33,31,2,34
Ballymena,8569,6,7,4,15,25,49,-24,25
Glentoran,8569,7,6,6,10,24,32,-8,24
Dungannon,8569,8,2,4,16,14,47,-33,10
Crusaders,8570,1,17,6,3,63,30,33,57
Coleraine,8570,2,14,10,2,43,24,19,52
Glenavon,8570,3,10,9,7,54,43,11,39
Linfield,8570,4,10,6,10,39,38,1,36
Cliftonville,8570,5,9,5,12,34,33,1,32
Ballymena,8570,6,7,4,15,25,49,-24,25
Glentoran,8570,7,6,6,10,24,32,-8,24
Dungannon,8570,8,2,4,16,14,47,-33,10
Crusaders,8571,1,17,6,3,63,30,33,57
Coleraine,8571,2,15,10,1,47,24,23,55
Linfield,8571,3,11,5,10,42,37,5,38
Glenavon,8571,4,9,9,8,54,47,7,36
Cliftonville,8571,5,9,4,13,33,36,-3,31
Ballymena,8571,6,7,4,15,25,49,-24,25
Glentoran,8571,7,6,6,10,24,32,-8,24
Dungannon,8571,8,2,4,16,14,47,-33,10
Crusaders,8572,1,17,6,3,65,32,33,57
Coleraine,8572,2,14,11,1,45,24,21,53
Linfield,8572,3,11,5,10,40,37,3,38
Glenavon,8572,4,9,10,7,54,45,9,37
Cliftonville,8572,5,9,4,13,33,34,-1,31
Ballymena,8572,6,7,4,15,27,51,-24,25
Glentoran,8572,7,6,6,10,24,32,-8,24
Dungannon,8572,8,2,4,16,14,47,-33,10
Coleraine,8573,1,15,10,1,45,23,22,55
Crusaders,8573,2,16,6,4,61,32,29,54
Glenavon,8573,3,9,9,8,53,45,8,36
Linfield,8573,4,10,5,11,38,38,0,35
Cliftonville,8573,5,10,4,12,34,32,2,34
Ballymena,8573,6,8,4,14,27,47,-20,28
Glentoran,8573,7,6,6,10,24,32,-8,24
Dungannon,8573,8,2,4,16,14,47,-33,10
Crusaders,8574,1,16,6,4,62,32,30,54
Coleraine,8574,2,14,10,2,43,23,20,52
Glenavon,8574,3,10,9,7,53,43,10,39
Linfield,8574,4,11,5,10,39,36,3,38
Cliftonville,8574,5,9,4,13,32,33,-1,31
Ballymena,8574,6,8,4,14,27,48,-21,28
Glentoran,8574,7,6,6,10,24,32,-8,24
Dungannon,8574,8,2,4,16,14,47,-33,10
Crusaders,8575,1,17,6,3,63,31,32,57
Coleraine,8575,2,15,10,1,48,22,26,55
Glenavon,8575,3,9,9,8,52,48,4,36
Linfield,8575,4,10,5,11,38,40,-2,35
Cliftonville,8575,5,10,4,12,36,32,4,34
Ballymena,8575,6,7,4,15,26,49,-23,25
Glentoran,8575,7,6,6,10,24,32,-8,24
Dungannon,8575,8,2,4,16,14,47,-33,10
Crusaders,8576,1,16,7,3,62,31,31,55
Coleraine,8576,2,15,10,1,45,23,22,55
Glenavon,8576,3,9,9,8,53,45,8,36
Linfield,8576,4,10,6,10,39,38,1,36
Cliftonville,8576,5,9,5,12,34,33,1,32
Ballymena,8576,6,7,5,14,26,48,-22,26
Glentoran,8576,7,6,6,10,24,32,-8,24
Dungannon,8576,8,2,4,16,14,47,-33,10
Crusaders,8577,1,16,7,3,61,30,31,55
Coleraine,8577,2,15,10,1,44,22,22,55
Linfield,8577,3,11,5,10,40,36,4,38
Glenavon,8577,4,9,9,8,52,44,8,36
Cliftonville,8577,5,9,4,13,32,34,-2,31
Ballymena,8577,6,7,5,14,25,47,-22,26
Glentoran,8577,7,6,6,10,24,32,-8,24
Dungannon,8577,8,2,4,16,14,47,-33,10
Crusaders,8578,1,17,6,3,62,30,32,57
Coleraine,8578,2,14,10,2,46,26,20,52
Glenavon,8578,3,10,9,7,56,46,10,39
Linfield,8578,4,11,5,10,38,36,2,38
Cliftonville,8578,5,9,4,13,32,32,0,31
Ballymena,8578,6,7,4,15,25,48,-23,25
Glentoran,8578,7,6,6,10,24,32,-8,24
Dungannon,8578,8,2,4,16,14,47,-33,10
Crusaders,8579,1,17,6,3,66,32,34,57
Coleraine,8579,2,14,11,1,45,24,21,53
Linfield,8579,3,11,5,10,39,36,3,38
Glenavon,8579,4,9,10,7,54,45,9,37
Cliftonville,8579,5,9,4,13,32,33,-1,31
Ballymena,8579,6,7,4,15,27,52,-25,25
Glentoran,8579,7,6,6,10,24,32,-8,24
Dungannon,8579,8,2,4,16,14,47,-33,10
Crusaders,8580,1,17,6,3,65,31,34,57
Coleraine,8580,2,14,10,2,45,25,20,52
Glenavon,8580,3,10,9,7,55,45,10,39
Linfield,8580,4,11,5,10,40,38,2,38
Cliftonville,8580,5,9,4,13,34,34,0,31
Ballymena,8580,6,7,4,15,26,51,-25,25
Glentoran,8580,7,6,6,10,24,32,-8,24
Dungannon,8580,8,2,4,16,14,47,-33,10
Coleraine,8581,1,15,10,1,45,23,22,55
Crusaders,8581,2,16,6,4,62,32,30,54
Linfield,8581,3,11,5,10,40,37,3,38
Glenavon,8581,4,9,9,8,53,45,8,36
Cliftonville,8581,5,9,4,13,33,34,-1,31
Ballymena,8581,6,8,4,14,27,48,-21,28
Glentoran,8581,7,6,6,10,24,32,-8,24
Dungannon,8581,8,2,4,16,14,47,-33,10
Crusaders,8582,1,17,6,3,65,32,33,57
Coleraine,8582,2,15,10,1,46,22,24,55
Glenavon,8582,3,9,9,8,52,46,6,36
Linfield,8582,4,10,5,11,37,37,0,35
Cliftonville,8582,5,10,4,12,33,31,2,34
Ballymena,8582,6,7,4,15,27,51,-24,25
Glentoran,8582,7,6,6,10,24,32,-8,24
Dungannon,8582,8,2,4,16,14,47,-33,10
Crusaders,8583,1,17,6,3,64,30,34,57
Coleraine,8583,2,15,10,1,46,24,22,55
Linfield,8583,3,11,5,10,41,37,4,38
Glenavon,8583,4,9,9,8,54,46,8,36
Cliftonville,8583,5,9,4,13,33,35,-2,31
Ballymena,8583,6,7,4,15,25,50,-25,25
Glentoran,8583,7,6,6,10,24,32,-8,24
Dungannon,8583,8,2,4,16,14,47,-33,10
Crusaders,8584,1,16,6,4,62,32,30,54
Coleraine,8584,2,14,11,1,44,23,21,53
Linfield,8584,3,11,5,10,42,36,6,38
Glenavon,8584,4,9,10,7,53,44,9,37
Cliftonville,8584,5,9,4,13,32,36,-4,31
Ballymena,8584,6,8,4,14,27,48,-21,28
Glentoran,8584,7,6,6,10,24,32,-8,24
Dungannon,8584,8,2,4,16,14,47,-33,10
Crusaders,8585,1,16,6,4,62,32,30,54
Coleraine,8585,2,14,10,2,44,25,19,52
Glenavon,8585,3,10,9,7,55,44,11,39
Linfield,8585,4,11,5,10,41,37,4,38
Cliftonville,8585,5,9,4,13,33,35,-2,31
Ballymena,8585,6,8,4,14,27,48,-21,28
Glentoran,8585,7,6,6,10,24,32,-8,24
Dungannon,8585,8,2,4,16,14,47,-33,10
Crusaders,8586,1,16,6,4,63,34,29,54
Coleraine,8586,2,14,10,2,44,24,20,52
Glenavon,8586,3,10,9,7,54,44,10,39
Linfield,8586,4,10,6,10,38,37,1,36
Cliftonville,8586,5,9,5,12,33,32,1,32
Ballymena,8586,6,8,4,14,29,49,-20,28
Glentoran,8586,7,6,6,10,24,32,-8,24
Dungannon,8586,8,2,4,16,14,47,-33,10
Crusaders,8587,1,17,6,3,65,32,33,57
Coleraine,8587,2,14,11,1,45,24,21,53
Glenavon,8587,3,9,10,7,54,45,9,37
Linfield,8587,4,10,6,10,38,37,1,36
Cliftonville,8587,5,9,5,12,33,32,1,32
Ballymena,8587,6,7,4,15,27,51,-24,25
Glentoran,8587,7,6,6,10,24,32,-8,24
Dungannon,8587,8,2,4,16,14,47,-33,10
Crusaders,8588,1,17,6,3,65,30,35,57
Coleraine,8588,2,14,11,1,44,23,21,53
Glenavon,8588,3,9,10,7,53,44,9,37
Linfield,8588,4,10,5,11,37,39,-2,35
Cliftonville,8588,5,10,4,12,35,31,4,34
Ballymena,8588,6,7,4,15,25,51,-26,25
Glentoran,8588,7,6,6,10,24,32,-8,24
Dungannon,8588,8,2,4,16,14,47,-33,10
Crusaders,8589,1,16,7,3,63,32,31,55
Coleraine,8589,2,14,11,1,45,24,21,53
Linfield,8589,3,11,5,10,39,37,2,38
Glenavon,8589,4,9,10,7,54,45,9,37
Cliftonville,8589,5,9,4,13,33,33,0,31
Ballymena,8589,6,7,5,14,27,49,-22,26
Glentoran,8589,7,6,6,10,24,32,-8,24
Dungannon,8589,8,2,4,16,14,47,-33,10
Crusaders,8590,1,17,6,3,65,31,34,57
Coleraine,8590,2,14,11,1,45,24,21,53
Glenavon,8590,3,9,10,7,54,45,9,37
Linfield,8590,4,10,5,11,37,38,-1,35
Cliftonville,8590,5,10,4,12,34,31,3,34
Ballymena,8590,6,7,4,15,26,51,-25,25
Glentoran,8590,7,6,6,10,24,32,-8,24
Dungannon,8590,8,2,4,16,14,47,-33,10
Crusaders,8591,1,17,6,3,63,30,33,57
Coleraine,8591,2,14,11,1,45,24,21,53
Linfield,8591,3,11,5,10,39,37,2,38
Glenavon,8591,4,9,10,7,54,45,9,37
Cliftonville,8591,5,9,4,13,33,33,0,31
Ballymena,8591,6,7,4,15,25,49,-24,25
Glentoran,8591,7,6,6,10,24,32,-8,24
Dungannon,8591,8,2,4,16,14,47,-33,10
Crusaders,8592,1,17,6,3,66,30,36,57
Coleraine,8592,2,15,10,1,44,22,22,55
Linfield,8592,3,11,5,10,39,36,3,38
Glenavon,8592,4,9,9,8,52,44,8,36
Cliftonville,8592,5,9,4,13,32,33,-1,31
Ballymena,8592,6,7,4,15,25,52,-27,25
Glentoran,8592,7,6,6,10,24,32,-8,24
Dungannon,8592,8,2,4,16,14,47,-33,10
Crusaders,8593,1,16,6,4,62,32,30,54
Coleraine,8593,2,14,11,1,44,23,21,53
Linfield,8593,3,11,5,10,39,36,3,38
Glenavon,8593,4,9,10,7,53,44,9,37
Cliftonville,8593,5,9,4,13,32,33,-1,31
Ballymena,8593,6,8,4,14,27,48,-21,28
Glentoran,8593,7,6,6,10,24,32,-8,24
Dungannon,8593,8,2,4,16,14,47,-33,10
Crusaders,8594,1,17,6,3,65,32,33,57
Coleraine,8594,2,14,10,2,43,25,18,52
Glenavon,8594,3,10,9,7,55,43,12,39
Linfield,8594,4,11,5,10,39,37,2,38
Cliftonville,8594,5,9,4,13,33,33,0,31
Ballymena,8594,6,7,4,15,27,51,-24,25
Glentoran,8594,7,6,6,10,24,32,-8,24
Dungannon,8594,8,2,4,16,14,47,-33,10
Crusaders,8595,1,17,6,3,63,30,33,57
Coleraine,8595,2,14,11,1,45,24,21,53
Linfield,8595,3,11,5,10,40,37,3,38
Glenavon,8595,4,9,10,7,54,45,9,37
Cliftonville,8595,5,9,4,13,33,34,-1,31
Ballymena,8595,6,7,4,15,25,49,-24,25
Glentoran,8595,7,6,6,10,24,32,-8,24
Dungannon,8595,8,2,4,16,14,47,-33,10
Crusaders,8596,1,17,6,3,64,31,33,57
Coleraine,8596,2,14,11,1,44,23,21,53
Linfield,8596,3,11,5,10,39,36,3,38
Glenavon,8596,4,9,10,7,53,44,9,37
Cliftonville,8596,5,9,4,13,32,33,-1,31
Ballymena,8596,6,7,4,15,26,50,-24,25
Glentoran,8596,7,6,6,10,24,32,-8,24
Dungannon,8596,8,2,4,16,14,47,-33,10
Crusaders,8597,1,17,6,3,62,30,32,57
Coleraine,8597,2,14,10,2,43,24,19,52
Glenavon,8597,3,10,9,7,54,43,11,39
Linfield,8597,4,11,5,10,38,36,2,38
Cliftonville,8597,5,9,4,13,32,32,0,31
Ballymena,8597,6,7,4,15,25,48,-23,25
Glentoran,8597,7,6,6,10,24,32,-8,24
Dungannon,8597,8,2,4,16,14,47,-33,10
Crusaders,8598,1,17,6,3,62,30,32,57
Coleraine,8598,2,15,10,1,47,23,24,55
Linfield,8598,3,11,5,10,39,36,3,38
Glenavon,8598,4,9,9,8,53,47,6,36
Cliftonville,8598,5,9,4,13,32,33,-1,31
Ballymena,8598,6,7,4,15,25,48,-23,25
Glentoran,8598,7,6,6,10,24,32,-8,24
Dungannon,8598,8,2,4,16,14,47,-33,10
Crusaders,8599,1,17,6,3,62,30,32,57
Coleraine,8599,2,14,11,1,44,23,21,53
Glenavon,8599,3,9,10,7,53,44,9,37
Linfield,8599,4,10,5,11,37,38,-1,35
Cliftonville,8599,5,10,4,12,34,31,3,34
Ballymena,8599,6,7,4,15,25,48,-23,25
Glentoran,8599,7,6,6,10,24,32,-8,24
Dungannon,8599,8,2,4,16,14,47,-33,10
Coleraine,8600,1,15,10,1,46,24,22,55
Crusaders,8600,2,16,6,4,62,32,30,54
Glenavon,8600,3,9,9,8,54,46,8,36
Linfield,8600,4,10,6,10,37,36,1,36
Cliftonville,8600,5,9,5,12,32,31,1,32
Ballymena,8600,6,8,4,14,27,48,-21,28
Glentoran,8600,7,6,6,10,24,32,-8,24
Dungannon,8600,8,2,4,16,14,47,-33,10
Crusaders,8601,1,17,6,3,64,31,33,57
Coleraine,8601,2,14,10,2,44,25,19,52
Glenavon,8601,3,10,9,7,55,44,11,39
Linfield,8601,4,11,5,10,38,36,2,38
Cliftonville,8601,5,9,4,13,32,32,0,31
Ballymena,8601,6,7,4,15,26,50,-24,25
Glentoran,8601,7,6,6,10,24,32,-8,24
Dungannon,8601,8,2,4,16,14,47,-33,10
Crusaders,8602,1,17,6,3,62,30,32,57
Coleraine,8602,2,14,10,2,45,25,20,52
Glenavon,8602,3,10,9,7,55,45,10,39
Linfield,8602,4,10,5,11,37,37,0,35
Cliftonville,8602,5,10,4,12,33,31,2,34
Ballymena,8602,6,7,4,15,25,48,-23,25
Glentoran,8602,7,6,6,10,24,32,-8,24
Dungannon,8602,8,2,4,16,14,47,-33,10
Crusaders,8603,1,17,6,3,63,30,33,57
Coleraine,8603,2,14,10,2,44,24,20,52
Glenavon,8603,3,10,9,7,54,44,10,39
Linfield,8603,4,11,5,10,39,37,2,38
Cliftonville,8603,5,9,4,13,33,33,0,31
Ballymena,8603,6,7,4,15,25,49,-24,25
Glentoran,8603,7,6,6,10,24,32,-8,24
Dungannon,8603,8,2,4,16,14,47,-33,10
Crusaders,8604,1,17,6,3,62,30,32,57
Coleraine,8604,2,14,10,2,45,27,18,52
Glenavon,8604,3,10,9,7,57,45,12,39
Linfield,8604,4,11,5,10,39,36,3,38
Cliftonville,8604,5,9,4,13,32,33,-1,31
Ballymena,8604,6,7,4,15,25,48,-23,25
Glentoran,8604,7,6,6,10,24,32,-8,24
Dungannon,8604,8,2,4,16,14,47,-33,10
Crusaders,8605,1,16,7,3,63,32,31,55
Coleraine,8605,2,14,11,1,45,24,21,53
Linfield,8605,3,11,5,10,39,36,3,38
Glenavon,8605,4,9,10,7,54,45,9,37
Cliftonville,8605,5,9,4,13,32,33,-1,31
Ballymena,8605,6,7,5,14,27,49,-22,26
Glentoran,8605,7,6,6,10,24,32,-8,24
Dungannon,8605,8,2,4,16,14,47,-33,10
Crusaders,8606,1,16,7,3,62,31,31,55
Coleraine,8606,2,15,10,1,45,23,22,55
Linfield,8606,3,11,5,10,39,36,3,38
Glenavon,8606,4,9,9,8,53,45,8,36
Cliftonville,8606,5,9,4,13,32,33,-1,31
Ballymena,8606,6,7,5,14,26,48,-22,26
Glentoran,8606,7,6,6,10,24,32,-8,24
Dungannon,8606,8,2,4,16,14,47,-33,10
Crusaders,8607,1,17,6,3,63,31,32,57
Coleraine,8607,2,14,11,1,45,24,21,53
Glenavon,8607,3,9,10,7,54,45,9,37
Linfield,8607,4,10,5,11,37,39,-2,35
Cliftonville,8607,5,10,4,12,35,31,4,34
Ballymena,8607,6,7,4,15,26,49,-23,25
Glentoran,8607,7,6,6,10,24,32,-8,24
Dungannon,8607,8,2,4,16,14,47,-33,10
Crusaders,8608,1,17,6,3,65,31,34,57
Coleraine,8608,2,14,10,2,43,25,18,52
Glenavon,8608,3,10,9,7,55,43,12,39
Linfield,8608,4,10,5,11,38,39,-1,35
Cliftonville,8608,5,10,4,12,35,32,3,34
Ballymena,8608,6,7,4,15,26,51,-25,25
Glentoran,8608,7,6,6,10,24,32,-8,24
Dungannon,8608,8,2,4,16,14,47,-33,10
Crusaders,8609,1,17,6,3,64,32,32,57
Coleraine,8609,2,14,10,2,44,25,19,52
Glenavon,8609,3,10,9,7,55,44,11,39
Linfield,8609,4,11,5,10,39,37,2,38
Cliftonville,8609,5,9,4,13,33,33,0,31
Ballymena,8609,6,7,4,15,27,50,-23,25
Glentoran,8609,7,6,6,10,24,32,-8,24
Dungannon,8609,8,2,4,16,14,47,-33,10
Crusaders,8610,1,17,6,3,63,30,33,57
Coleraine,8610,2,14,10,2,44,25,19,52
Glenavon,8610,3,10,9,7,55,44,11,39
Linfield,8610,4,11,5,10,41,38,3,38
Cliftonville,8610,5,9,4,13,34,35,-1,31
Ballymena,8610,6,7,4,15,25,49,-24,25
Glentoran,8610,7,6,6,10,24,32,-8,24
Dungannon,8610,8,2,4,16,14,47,-33,10
Crusaders,8611,1,17,6,3,63,31,32,57
Coleraine,8611,2,14,10,2,44,24,20,52
Glenavon,8611,3,10,9,7,54,44,10,39
Linfield,8611,4,10,5,11,37,37,0,35
Cliftonville,8611,5,10,4,12,33,31,2,34
Ballymena,8611,6,7,4,15,26,49,-23,25
Glentoran,8611,7,6,6,10,24,32,-8,24
Dungannon,8611,8,2,4,16,14,47,-33,10
Crusaders,8612,1,16,7,3,61,30,31,55
Coleraine,8612,2,14,11,1,46,25,21,53
Glenavon,8612,3,9,10,7,55,46,9,37
Linfield,8612,4,10,6,10,37,36,1,36
Cliftonville,8612,5,9,5,12,32,31,1,32
Ballymena,8612,6,7,5,14,25,47,-22,26
Glentoran,8612,7,6,6,10,24,32,-8,24
Dungannon,8612,8,2,4,16,14,47,-33,10
Crusaders,8613,1,16,6,4,62,33,29,54
Coleraine,8613,2,14,11,1,44,23,21,53
Linfield,8613,3,11,5,10,40,37,3,38
Glenavon,8613,4,9,10,7,53,44,9,37
Cliftonville,8613,5,9,4,13,33,34,-1,31
Ballymena,8613,6,8,4,14,28,48,-20,28
Glentoran,8613,7,6,6,10,24,32,-8,24
Dungannon,8613,8,2,4,16,14,47,-33,10
Crusaders,8614,1,17,6,3,63,30,33,57
Coleraine,8614,2,14,11,1,45,24,21,53
Glenavon,8614,3,9,10,7,54,45,9,37
Linfield,8614,4,10,5,11,37,37,0,35
Cliftonville,8614,5,10,4,12,33,31,2,34
Ballymena,8614,6,7,4,15,25,49,-24,25
Glentoran,8614,7,6,6,10,24,32,-8,24
Dungannon,8614,8,2,4,16,14,47,-33,10
Crusaders,8615,1,17,6,3,64,32,32,57
Coleraine,8615,2,14,10,2,44,24,20,52
Glenavon,8615,3,10,9,7,54,44,10,39
Linfield,8615,4,11,5,10,39,36,3,38
Cliftonville,8615,5,9,4,13,32,33,-1,31
Ballymena,8615,6,7,4,15,27,50,-23,25
Glentoran,8615,7,6,6,10,24,32,-8,24
Dungannon,8615,8,2,4,16,14,47,-33,10
Crusaders,8616,1,17,6,3,63,30,33,57
Coleraine,8616,2,14,10,2,43,23,20,52
Glenavon,8616,3,10,9,7,53,43,10,39
Linfield,8616,4,10,6,10,37,36,1,36
Cliftonville,8616,5,9,5,12,32,31,1,32
Ballymena,8616,6,7,4,15,25,49,-24,25
Glentoran,8616,7,6,6,10,24,32,-8,24
Dungannon,8616,8,2,4,16,14,47,-33,10
Coleraine,8617,1,15,10,1,44,22,22,55
Crusaders,8617,2,16,6,4,62,32,30,54
Glenavon,8617,3,9,9,8,52,44,8,36
Linfield,8617,4,10,5,11,37,38,-1,35
Cliftonville,8617,5,10,4,12,34,31,3,34
Ballymena,8617,6,8,4,14,27,48,-21,28
Glentoran,8617,7,6,6,10,24,32,-8,24
Dungannon,8617,8,2,4,16,14,47,-33,10
Crusaders,8618,1,17,6,3,63,31,32,57
Coleraine,8618,2,15,10,1,45,23,22,55
Glenavon,8618,3,9,9,8,53,45,8,36
Linfield,8618,4,10,6,10,37,36,1,36
Cliftonville,8618,5,9,5,12,32,31,1,32
Ballymena,8618,6,7,4,15,26,49,-23,25
Glentoran,8618,7,6,6,10,24,32,-8,24
Dungannon,8618,8,2,4,16,14,47,-33,10
Coleraine,8619,1,15,10,1,44,22,22,55
Crusaders,8619,2,16,6,4,62,32,30,54
Glenavon,8619,3,9,9,8,52,44,8,36
Linfield,8619,4,10,5,11,38,38,0,35
Cliftonville,8619,5,10,4,12,34,32,2,34
Ballymena,8619,6,8,4,14,27,48,-21,28
Glentoran,8619,7,6,6,10,24,32,-8,24
Dungannon,8619,8,2,4,16,14,47,-33,10
Crusaders,8620,1,17,6,3,63,31,32,57
Coleraine,8620,2,14,11,1,44,23,21,53
Glenavon,8620,3,9,10,7,53,44,9,37
Linfield,8620,4,10,5,11,37,37,0,35
Cliftonville,8620,5,10,4,12,33,31,2,34
Ballymena,8620,6,7,4,15,26,49,-23,25
Glentoran,8620,7,6,6,10,24,32,-8,24
Dungannon,8620,8,2,4,16,14,47,-33,10
Crusaders,8621,1,17,6,3,64,31,33,57
Coleraine,8621,2,14,10,2,44,25,19,52
Glenavon,8621,3,10,9,7,55,44,11,39
Linfield,8621,4,11,5,10,39,37,2,38
Cliftonville,8621,5,9,4,13,33,33,0,31
Ballymena,8621,6,7,4,15,26,50,-24,25
Glentoran,8621,7,6,6,10,24,32,-8,24
Dungannon,8621,8,2,4,16,14,47,-33,10
Crusaders,8622,1,17,6,3,65,31,34,57
Coleraine,8622,2,14,10,2,45,25,20,52
Glenavon,8622,3,10,9,7,55,45,10,39
Linfield,8622,4,10,5,11,38,38,0,35
Cliftonville,8622,5,10,4,12,34,32,2,34
Ballymena,8622,6,7,4,15,26,51,-25,25
Glentoran,8622,7,6,6,10,24,32,-8,24
Dungannon,8622,8,2,4,16,14,47,-33,10
Crusaders,8623,1,16,7,3,63,32,31,55
Coleraine,8623,2,14,11,1,44,23,21,53
Glenavon,8623,3,9,10,7,53,44,9,37
Linfield,8623,4,10,5,11,37,39,-2,35
Cliftonville,8623,5,10,4,12,35,31,4,34
Ballymena,8623,6,7,5,14,27,49,-22,26
Glentoran,8623,7,6,6,10,24,32,-8,24
Dungannon,8623,8,2,4,16,14,47,-33,10
Crusaders,8624,1,17,6,3,63,31,32,57
Coleraine,8624,2,14,10,2,43,23,20,52
Glenavon,8624,3,10,9,7,53,43,10,39
Linfield,8624,4,11,5,10,39,36,3,38
Cliftonville,8624,5,9,4,13,32,33,-1,31
Ballymena,8624,6,7,4,15,26,49,-23,25
Glentoran,8624,7,6,6,10,24,32,-8,24
Dungannon,8624,8,2,4,16,14,47,-33,10
Crusaders,8625,1,16,6,4,61,34,27,54
Coleraine,8625,2,14,10,2,43,23,20,52
Glenavon,8625,3,10,9,7,53,43,10,39
Linfield,8625,4,11,5,10,39,36,3,38
Cliftonville,8625,5,9,4,13,32,33,-1,31
Ballymena,8625,6,8,4,14,29,47,-18,28
Glentoran,8625,7,6,6,10,24,32,-8,24
Dungannon,8625,8,2,4,16,14,47,-33,10
Crusaders,8626,1,17,6,3,64,30,34,57
Coleraine,8626,2,14,11,1,44,23,21,53
Linfield,8626,3,11,5,10,38,36,2,38
Glenavon,8626,4,9,10,7,53,44,9,37
Cliftonville,8626,5,9,4,13,32,32,0,31
Ballymena,8626,6,7,4,15,25,50,-25,25
Glentoran,8626,7,6,6,10,24,32,-8,24
Dungannon,8626,8,2,4,16,14,47,-33,10
Crusaders,8627,1,16,7,3,63,32,31,55
Coleraine,8627,2,14,10,2,43,26,17,52
Glenavon,8627,3,10,9,7,56,43,13,39
Linfield,8627,4,10,5,11,37,37,0,35
Cliftonville,8627,5,10,4,12,33,31,2,34
Ballymena,8627,6,7,5,14,27,49,-22,26
Glentoran,8627,7,6,6,10,24,32,-8,24
Dungannon,8627,8,2,4,16,14,47,-33,10
Crusaders,8628,1,16,6,4,62,33,29,54
Coleraine,8628,2,14,10,2,44,24,20,52
Glenavon,8628,3,10,9,7,54,44,10,39
Linfield,8628,4,10,6,10,38,37,1,36
Cliftonville,8628,5,9,5,12,33,32,1,32
Ballymena,8628,6,8,4,14,28,48,-20,28
Glentoran,8628,7,6,6,10,24,32,-8,24
Dungannon,8628,8,2,4,16,14,47,-33,10
Crusaders,8629,1,16,7,3,62,31,31,55
Coleraine,8629,2,14,10,2,45,26,19,52
Glenavon,8629,3,10,9,7,56,45,11,39
Linfield,8629,4,11,5,10,39,37,2,38
Cliftonville,8629,5,9,4,13,33,33,0,31
Ballymena,8629,6,7,5,14,26,48,-22,26
Glentoran,8629,7,6,6,10,24,32,-8,24
Dungannon,8629,8,2,4,16,14,47,-33,10
Crusaders,8630,1,16,6,4,62,33,29,54
Coleraine,8630,2,14,10,2,44,24,20,52
Glenavon,8630,3,10,9,7,54,44,10,39
Linfield,8630,4,11,5,10,41,36,5,38
Cliftonville,8630,5,9,4,13,32,35,-3,31
Ballymena,8630,6,8,4,14,28,48,-20,28
Glentoran,8630,7,6,6,10,24,32,-8,24
Dungannon,8630,8,2,4,16,14,47,-33,10
Crusaders,8631,1,17,6,3,63,31,32,57
Coleraine,8631,2,14,10,2,43,26,17,52
Glenavon,8631,3,10,9,7,56,43,13,39
Linfield,8631,4,11,5,10,41,36,5,38
Cliftonville,8631,5,9,4,13,32,35,-3,31
Ballymena,8631,6,7,4,15,26,49,-23,25
Glentoran,8631,7,6,6,10,24,32,-8,24
Dungannon,8631,8,2,4,16,14,47,-33,10
Crusaders,8632,1,17,6,3,64,30,34,57
Coleraine,8632,2,14,10,2,44,24,20,52
Glenavon,8632,3,10,9,7,54,44,10,39
Linfield,8632,4,11,5,10,40,37,3,38
Cliftonville,8632,5,9,4,13,33,34,-1,31
Ballymena,8632,6,7,4,15,25,50,-25,25
Glentoran,8632,7,6,6,10,24,32,-8,24
Dungannon,8632,8,2,4,16,14,47,-33,10
Crusaders,8633,1,17,6,3,62,30,32,57
Coleraine,8633,2,14,10,2,44,25,19,52
Glenavon,8633,3,10,9,7,55,44,11,39
Linfield,8633,4,10,5,11,37,40,-3,35
Cliftonville,8633,5,10,4,12,36,31,5,34
Ballymena,8633,6,7,4,15,25,48,-23,25
Glentoran,8633,7,6,6,10,24,32,-8,24
Dungannon,8633,8,2,4,16,14,47,-33,10
Crusaders,8634,1,16,7,3,61,30,31,55
Coleraine,8634,2,14,10,2,46,26,20,52
Glenavon,8634,3,10,9,7,56,46,10,39
Linfield,8634,4,11,5,10,39,37,2,38
Cliftonville,8634,5,9,4,13,33,33,0,31
Ballymena,8634,6,7,5,14,25,47,-22,26
Glentoran,8634,7,6,6,10,24,32,-8,24
Dungannon,8634,8,2,4,16,14,47,-33,10
Coleraine,8635,1,15,10,1,45,22,23,55
Crusaders,8635,2,16,6,4,62,33,29,54
Linfield,8635,3,11,5,10,40,36,4,38
Glenavon,8635,4,9,9,8,52,45,7,36
Cliftonville,8635,5,9,4,13,32,34,-2,31
Ballymena,8635,6,8,4,14,28,48,-20,28
Glentoran,8635,7,6,6,10,24,32,-8,24
Dungannon,8635,8,2,4,16,14,47,-33,10
Crusaders,8636,1,17,6,3,63,31,32,57
Coleraine,8636,2,14,10,2,43,23,20,52
Glenavon,8636,3,10,9,7,53,43,10,39
Linfield,8636,4,10,5,11,38,38,0,35
Cliftonville,8636,5,10,4,12,34,32,2,34
Ballymena,8636,6,7,4,15,26,49,-23,25
Glentoran,8636,7,6,6,10,24,32,-8,24
Dungannon,8636,8,2,4,16,14,47,-33,10
Crusaders,8637,1,17,6,3,66,33,33,57
Coleraine,8637,2,15,10,1,46,22,24,55
Linfield,8637,3,11,5,10,39,36,3,38
Glenavon,8637,4,9,9,8,52,46,6,36
Cliftonville,8637,5,9,4,13,32,33,-1,31
Ballymena,8637,6,7,4,15,28,52,-24,25
Glentoran,8637,7,6,6,10,24,32,-8,24
Dungannon,8637,8,2,4,16,14,47,-33,10
Crusaders,8638,1,17,6,3,65,31,34,57
Coleraine,8638,2,15,10,1,44,22,22,55
Glenavon,8638,3,9,9,8,52,44,8,36
Linfield,8638,4,10,6,10,37,36,1,36
Cliftonville,8638,5,9,5,12,32,31,1,32
Ballymena,8638,6,7,4,15,26,51,-25,25
Glentoran,8638,7,6,6,10,24,32,-8,24
Dungannon,8638,8,2,4,16,14,47,-33,10
Crusaders,8639,1,17,6,3,62,30,32,57
Coleraine,8639,2,14,10,2,45,25,20,52
Glenavon,8639,3,10,9,7,55,45,10,39
Linfield,8639,4,10,6,10,38,37,1,36
Cliftonville,8639,5,9,5,12,33,32,1,32
Ballymena,8639,6,7,4,15,25,48,-23,25
Glentoran,8639,7,6,6,10,24,32,-8,24
Dungannon,8639,8,2,4,16,14,47,-33,10
Crusaders,8640,1,16,7,3,63,32,31,55
Coleraine,8640,2,14,10,2,44,24,20,52
Glenavon,8640,3,10,9,7,54,44,10,39
Linfield,8640,4,10,5,11,38,38,0,35
Cliftonville,8640,5,10,4,12,34,32,2,34
Ballymena,8640,6,7,5,14,27,49,-22,26
Glentoran,8640,7,6,6,10,24,32,-8,24
Dungannon,8640,8,2,4,16,14,47,-33,10
Crusaders,8641,1,17,6,3,63,30,33,57
Coleraine,8641,2,14,10,2,43,23,20,52
Glenavon,8641,3,10,9,7,53,43,10,39
Linfield,8641,4,10,5,11,38,38,0,35
Cliftonville,8641,5,10,4,12,34,32,2,34
Ballymena,8641,6,7,4,15,25,49,-24,25
Glentoran,8641,7,6,6,10,24,32,-8,24
Dungannon,8641,8,2,4,16,14,47,-33,10
Crusaders,8642,1,17,6,3,63,31,32,57
Coleraine,8642,2,15,10,1,44,22,22,55
Glenavon,8642,3,9,9,8,52,44,8,36
Linfield,8642,4,10,5,11,37,38,-1,35
Cliftonville,8642,5,10,4,12,34,31,3,34
Ballymena,8642,6,7,4,15,26,49,-23,25
Glentoran,8642,7,6,6,10,24,32,-8,24
Dungannon,8642,8,2,4,16,14,47,-33,10
Crusaders,8643,1,17,6,3,63,30,33,57
Coleraine,8643,2,15,10,1,45,22,23,55
Linfield,8643,3,11,5,10,40,37,3,38
Glenavon,8643,4,9,9,8,52,45,7,36
Cliftonville,8643,5,9,4,13,33,34,-1,31
Ballymena,8643,6,7,4,15,25,49,-24,25
Glentoran,8643,7,6,6,10,24,32,-8,24
Dungannon,8643,8,2,4,16,14,47,-33,10
Coleraine,8644,1,15,10,1,44,22,22,55
Crusaders,8644,2,16,6,4,61,31,30,54
Linfield,8644,3,11,5,10,41,36,5,38
Glenavon,8644,4,9,9,8,52,44,8,36
Cliftonville,8644,5,9,4,13,32,35,-3,31
Ballymena,8644,6,8,4,14,26,47,-21,28
Glentoran,8644,7,6,6,10,24,32,-8,24
Dungannon,8644,8,2,4,16,14,47,-33,10
Crusaders,8645,1,17,6,3,64,32,32,57
Coleraine,8645,2,14,10,2,43,26,17,52
Glenavon,8645,3,10,9,7,56,43,13,39
Linfield,8645,4,11,5,10,39,36,3,38
Cliftonville,8645,5,9,4,13,32,33,-1,31
Ballymena,8645,6,7,4,15,27,50,-23,25
Glentoran,8645,7,6,6,10,24,32,-8,24
Dungannon,8645,8,2,4,16,14,47,-33,10
Crusaders,8646,1,16,7,3,62,31,31,55
Coleraine,8646,2,14,10,2,43,24,19,52
Glenavon,8646,3,10,9,7,54,43,11,39
Linfield,8646,4,11,5,10,40,38,2,38
Cliftonville,8646,5,9,4,13,34,34,0,31
Ballymena,8646,6,7,5,14,26,48,-22,26
Glentoran,8646,7,6,6,10,24,32,-8,24
Dungannon,8646,8,2,4,16,14,47,-33,10
Crusaders,8647,1,17,6,3,68,32,36,57
Coleraine,8647,2,14,10,2,44,24,20,52
Glenavon,8647,3,10,9,7,54,44,10,39
Linfield,8647,4,11,5,10,40,36,4,38
Cliftonville,8647,5,9,4,13,32,34,-2,31
Ballymena,8647,6,7,4,15,27,54,-27,25
Glentoran,8647,7,6,6,10,24,32,-8,24
Dungannon,8647,8,2,4,16,14,47,-33,10
Crusaders,8648,1,17,6,3,64,31,33,57
Coleraine,8648,2,14,10,2,45,25,20,52
Glenavon,8648,3,10,9,7,55,45,10,39
Linfield,8648,4,10,6,10,37,36,1,36
Cliftonville,8648,5,9,5,12,32,31,1,32
Ballymena,8648,6,7,4,15,26,50,-24,25
Glentoran,8648,7,6,6,10,24,32,-8,24
Dungannon,8648,8,2,4,16,14,47,-33,10
Crusaders,8649,1,16,6,4,61,32,29,54
Coleraine,8649,2,14,11,1,43,22,21,53
Glenavon,8649,3,9,10,7,52,43,9,37
Linfield,8649,4,10,5,11,37,39,-2,35
Cliftonville,8649,5,10,4,12,35,31,4,34
Ballymena,8649,6,8,4,14,27,47,-20,28
Glentoran,8649,7,6,6,10,24,32,-8,24
Dungannon,8649,8,2,4,16,14,47,-33,10
Crusaders,8650,1,17,6,3,64,32,32,57
Coleraine,8650,2,14,10,2,43,25,18,52
Glenavon,8650,3,10,9,7,55,43,12,39
Linfield,8650,4,10,5,11,38,39,-1,35
Cliftonville,8650,5,10,4,12,35,32,3,34
Ballymena,8650,6,7,4,15,27,50,-23,25
Glentoran,8650,7,6,6,10,24,32,-8,24
Dungannon,8650,8,2,4,16,14,47,-33,10
Crusaders,8651,1,16,7,3,63,32,31,55
Coleraine,8651,2,14,11,1,43,22,21,53
Linfield,8651,3,11,5,10,39,37,2,38
Glenavon,8651,4,9,10,7,52,43,9,37
Cliftonville,8651,5,9,4,13,33,33,0,31
Ballymena,8651,6,7,5,14,27,49,-22,26
Glentoran,8651,7,6,6,10,24,32,-8,24
Dungannon,8651,8,2,4,16,14,47,-33,10
Crusaders,8652,1,17,6,3,63,30,33,57
Coleraine,8652,2,15,10,1,47,22,25,55
Linfield,8652,3,11,5,10,40,36,4,38
Glenavon,8652,4,9,9,8,52,47,5,36
Cliftonville,8652,5,9,4,13,32,34,-2,31
Ballymena,8652,6,7,4,15,25,49,-24,25
Glentoran,8652,7,6,6,10,24,32,-8,24
Dungannon,8652,8,2,4,16,14,47,-33,10
Crusaders,8653,1,16,6,4,61,33,28,54
Coleraine,8653,2,14,10,2,45,28,17,52
Glenavon,8653,3,10,9,7,58,45,13,39
Linfield,8653,4,11,5,10,39,36,3,38
Cliftonville,8653,5,9,4,13,32,33,-1,31
Ballymena,8653,6,8,4,14,28,47,-19,28
Glentoran,8653,7,6,6,10,24,32,-8,24
Dungannon,8653,8,2,4,16,14,47,-33,10
Crusaders,8654,1,17,6,3,64,30,34,57
Coleraine,8654,2,14,11,1,44,23,21,53
Linfield,8654,3,11,5,10,39,37,2,38
Glenavon,8654,4,9,10,7,53,44,9,37
Cliftonville,8654,5,9,4,13,33,33,0,31
Ballymena,8654,6,7,4,15,25,50,-25,25
Glentoran,8654,7,6,6,10,24,32,-8,24
Dungannon,8654,8,2,4,16,14,47,-33,10
Crusaders,8655,1,16,7,3,62,31,31,55
Coleraine,8655,2,15,10,1,46,23,23,55
Linfield,8655,3,11,5,10,38,36,2,38
Glenavon,8655,4,9,9,8,53,46,7,36
Cliftonville,8655,5,9,4,13,32,32,0,31
Ballymena,8655,6,7,5,14,26,48,-22,26
Glentoran,8655,7,6,6,10,24,32,-8,24
Dungannon,8655,8,2,4,16,14,47,-33,10
Crusaders,8656,1,17,6,3,63,30,33,57
Coleraine,8656,2,14,10,2,43,23,20,52
Glenavon,8656,3,10,9,7,53,43,10,39
Linfield,8656,4,10,5,11,39,39,0,35
Cliftonville,8656,5,10,4,12,35,33,2,34
Ballymena,8656,6,7,4,15,25,49,-24,25
Glentoran,8656,7,6,6,10,24,32,-8,24
Dungannon,8656,8,2,4,16,14,47,-33,10
Coleraine,8657,1,15,10,1,46,24,22,55
Crusaders,8657,2,16,6,4,62,32,30,54
Glenavon,8657,3,9,9,8,54,46,8,36
Linfield,8657,4,10,6,10,37,36,1,36
Cliftonville,8657,5,9,5,12,32,31,1,32
Ballymena,8657,6,8,4,14,27,48,-21,28
Glentoran,8657,7,6,6,10,24,32,-8,24
Dungannon,8657,8,2,4,16,14,47,-33,10
Crusaders,8658,1,17,6,3,62,30,32,57
Coleraine,8658,2,15,10,1,45,23,22,55
Linfield,8658,3,11,5,10,38,36,2,38
Glenavon,8658,4,9,9,8,53,45,8,36
Cliftonville,8658,5,9,4,13,32,32,0,31
Ballymena,8658,6,7,4,15,25,48,-23,25
Glentoran,8658,7,6,6,10,24,32,-8,24
Dungannon,8658,8,2,4,16,14,47,-33,10
Crusaders,8659,1,17,6,3,64,31,33,57
Coleraine,8659,2,14,11,1,44,23,21,53
Glenavon,8659,3,9,10,7,53,44,9,37
Linfield,8659,4,10,5,11,37,37,0,35
Cliftonville,8659,5,10,4,12,33,31,2,34
Ballymena,8659,6,7,4,15,26,50,-24,25
Glentoran,8659,7,6,6,10,24,32,-8,24
Dungannon,8659,8,2,4,16,14,47,-33,10
Crusaders,8660,1,17,6,3,62,30,32,57
Coleraine,8660,2,15,10,1,46,24,22,55
Glenavon,8660,3,9,9,8,54,46,8,36
Linfield,8660,4,10,5,11,37,37,0,35
Cliftonville,8660,5,10,4,12,33,31,2,34
Ballymena,8660,6,7,4,15,25,48,-23,25
Glentoran,8660,7,6,6,10,24,32,-8,24
Dungannon,8660,8,2,4,16,14,47,-33,10
Crusaders,8661,1,17,6,3,64,30,34,57
Coleraine,8661,2,15,10,1,47,22,25,55
Linfield,8661,3,11,5,10,39,37,2,38
Glenavon,8661,4,9,9,8,52,47,5,36
Cliftonville,8661,5,9,4,13,33,33,0,31
Ballymena,8661,6,7,4,15,25,50,-25,25
Glentoran,8661,7,6,6,10,24,32,-8,24
Dungannon,8661,8,2,4,16,14,47,-33,10
Crusaders,8662,1,17,6,3,63,30,33,57
Coleraine,8662,2,14,11,1,44,23,21,53
Linfield,8662,3,11,5,10,40,36,4,38
Glenavon,8662,4,9,10,7,53,44,9,37
Cliftonville,8662,5,9,4,13,32,34,-2,31
Ballymena,8662,6,7,4,15,25,49,-24,25
Glentoran,8662,7,6,6,10,24,32,-8,24
Dungannon,8662,8,2,4,16,14,47,-33,10
Crusaders,8663,1,17,6,3,64,32,32,57
Coleraine,8663,2,15,10,1,46,23,23,55
Glenavon,8663,3,9,9,8,53,46,7,36
Linfield,8663,4,10,6,10,39,38,1,36
Cliftonville,8663,5,9,5,12,34,33,1,32
Ballymena,8663,6,7,4,15,27,50,-23,25
Glentoran,8663,7,6,6,10,24,32,-8,24
Dungannon,8663,8,2,4,16,14,47,-33,10
Crusaders,8664,1,17,6,3,63,31,32,57
Coleraine,8664,2,14,10,2,43,27,16,52
Glenavon,8664,3,10,9,7,57,43,14,39
Linfield,8664,4,10,6,10,37,36,1,36
Cliftonville,8664,5,9,5,12,32,31,1,32
Ballymena,8664,6,7,4,15,26,49,-23,25
Glentoran,8664,7,6,6,10,24,32,-8,24
Dungannon,8664,8,2,4,16,14,47,-33,10
Crusaders,8665,1,16,6,4,63,33,30,54
Coleraine,8665,2,14,11,1,44,23,21,53
Linfield,8665,3,11,5,10,39,36,3,38
Glenavon,8665,4,9,10,7,53,44,9,37
Cliftonville,8665,5,9,4,13,32,33,-1,31
Ballymena,8665,6,8,4,14,28,49,-21,28
Glentoran,8665,7,6,6,10,24,32,-8,24
Dungannon,8665,8,2,4,16,14,47,-33,10
Crusaders,8666,1,17,6,3,64,31,33,57
Coleraine,8666,2,15,10,1,46,22,24,55
Glenavon,8666,3,9,9,8,52,46,6,36
Linfield,8666,4,10,5,11,38,39,-1,35
Cliftonville,8666,5,10,4,12,35,32,3,34
Ballymena,8666,6,7,4,15,26,50,-24,25
Glentoran,8666,7,6,6,10,24,32,-8,24
Dungannon,8666,8,2,4,16,14,47,-33,10
Crusaders,8667,1,16,6,4,62,32,30,54
Coleraine,8667,2,14,10,2,45,26,19,52
Glenavon,8667,3,10,9,7,56,45,11,39
Linfield,8667,4,11,5,10,39,36,3,38
Cliftonville,8667,5,9,4,13,32,33,-1,31
Ballymena,8667,6,8,4,14,27,48,-21,28
Glentoran,8667,7,6,6,10,24,32,-8,24
Dungannon,8667,8,2,4,16,14,47,-33,10
Crusaders,8668,1,16,6,4,62,34,28,54
Coleraine,8668,2,14,11,1,46,25,21,53
Linfield,8668,3,11,5,10,39,36,3,38
Glenavon,8668,4,9,10,7,55,46,9,37
Cliftonville,8668,5,9,4,13,32,33,-1,31
Ballymena,8668,6,8,4,14,29,48,-19,28
Glentoran,8668,7,6,6,10,24,32,-8,24
Dungannon,8668,8,2,4,16,14,47,-33,10
Crusaders,8669,1,16,6,4,64,34,30,54
Coleraine,8669,2,14,11,1,44,23,21,53
Glenavon,8669,3,9,10,7,53,44,9,37
Linfield,8669,4,10,5,11,37,37,0,35
Cliftonville,8669,5,10,4,12,33,31,2,34
Ballymena,8669,6,8,4,14,29,50,-21,28
Glentoran,8669,7,6,6,10,24,32,-8,24
Dungannon,8669,8,2,4,16,14,47,-33,10
Crusaders,8670,1,16,7,3,62,31,31,55
Coleraine,8670,2,14,11,1,44,23,21,53
Linfield,8670,3,11,5,10,39,36,3,38
Glenavon,8670,4,9,10,7,53,44,9,37
Cliftonville,8670,5,9,4,13,32,33,-1,31
Ballymena,8670,6,7,5,14,26,48,-22,26
Glentoran,8670,7,6,6,10,24,32,-8,24
Dungannon,8670,8,2,4,16,14,47,-33,10
Crusaders,8671,1,17,6,3,62,30,32,57
Coleraine,8671,2,14,10,2,43,24,19,52
Glenavon,8671,3,10,9,7,54,43,11,39
Linfield,8671,4,10,6,10,39,38,1,36
Cliftonville,8671,5,9,5,12,34,33,1,32
Ballymena,8671,6,7,4,15,25,48,-23,25
Glentoran,8671,7,6,6,10,24,32,-8,24
Dungannon,8671,8,2,4,16,14,47,-33,10
Crusaders,8672,1,17,6,3,64,32,32,57
Coleraine,8672,2,14,11,1,43,22,21,53
Linfield,8672,3,11,5,10,39,36,3,38
Glenavon,8672,4,9,10,7,52,43,9,37
Cliftonville,8672,5,9,4,13,32,33,-1,31
Ballymena,8672,6,7,4,15,27,50,-23,25
Glentoran,8672,7,6,6,10,24,32,-8,24
Dungannon,8672,8,2,4,16,14,47,-33,10
Crusaders,8673,1,17,6,3,62,30,32,57
Coleraine,8673,2,14,10,2,45,25,20,52
Glenavon,8673,3,10,9,7,55,45,10,39
Linfield,8673,4,10,6,10,37,36,1,36
Cliftonville,8673,5,9,5,12,32,31,1,32
Ballymena,8673,6,7,4,15,25,48,-23,25
Glentoran,8673,7,6,6,10,24,32,-8,24
Dungannon,8673,8,2,4,16,14,47,-33,10
Crusaders,8674,1,16,7,3,63,32,31,55
Coleraine,8674,2,15,10,1,46,22,24,55
Linfield,8674,3,11,5,10,41,36,5,38
Glenavon,8674,4,9,9,8,52,46,6,36
Cliftonville,8674,5,9,4,13,32,35,-3,31
Ballymena,8674,6,7,5,14,27,49,-22,26
Glentoran,8674,7,6,6,10,24,32,-8,24
Dungannon,8674,8,2,4,16,14,47,-33,10
Crusaders,8675,1,17,6,3,66,31,35,57
Coleraine,8675,2,15,10,1,46,23,23,55
Glenavon,8675,3,9,9,8,53,46,7,36
Linfield,8675,4,10,6,10,38,37,1,36
Cliftonville,8675,5,9,5,12,33,32,1,32
Ballymena,8675,6,7,4,15,26,52,-26,25
Glentoran,8675,7,6,6,10,24,32,-8,24
Dungannon,8675,8,2,4,16,14,47,-33,10
Crusaders,8676,1,16,6,4,61,32,29,54
Coleraine,8676,2,14,10,2,43,27,16,52
Glenavon,8676,3,10,9,7,57,43,14,39
Linfield,8676,4,10,5,11,38,38,0,35
Cliftonville,8676,5,10,4,12,34,32,2,34
Ballymena,8676,6,8,4,14,27,47,-20,28
Glentoran,8676,7,6,6,10,24,32,-8,24
Dungannon,8676,8,2,4,16,14,47,-33,10
Crusaders,8677,1,17,6,3,63,30,33,57
Coleraine,8677,2,14,10,2,44,25,19,52
Glenavon,8677,3,10,9,7,55,44,11,39
Linfield,8677,4,11,5,10,40,36,4,38
Cliftonville,8677,5,9,4,13,32,34,-2,31
Ballymena,8677,6,7,4,15,25,49,-24,25
Glentoran,8677,7,6,6,10,24,32,-8,24
Dungannon,8677,8,2,4,16,14,47,-33,10
Crusaders,8678,1,16,7,3,62,31,31,55
Coleraine,8678,2,15,10,1,44,22,22,55
Glenavon,8678,3,9,9,8,52,44,8,36
Linfield,8678,4,10,5,11,37,40,-3,35
Cliftonville,8678,5,10,4,12,36,31,5,34
Ballymena,8678,6,7,5,14,26,48,-22,26
Glentoran,8678,7,6,6,10,24,32,-8,24
Dungannon,8678,8,2,4,16,14,47,-33,10
Crusaders,8679,1,16,7,3,62,31,31,55
Coleraine,8679,2,14,11,1,44,23,21,53
Linfield,8679,3,11,5,10,38,36,2,38
Glenavon,8679,4,9,10,7,53,44,9,37
Cliftonville,8679,5,9,4,13,32,32,0,31
Ballymena,8679,6,7,5,14,26,48,-22,26
Glentoran,8679,7,6,6,10,24,32,-8,24
Dungannon,8679,8,2,4,16,14,47,-33,10
Crusaders,8680,1,16,7,3,62,31,31,55
Coleraine,8680,2,14,10,2,43,23,20,52
Glenavon,8680,3,10,9,7,53,43,10,39
Linfield,8680,4,10,6,10,39,38,1,36
Cliftonville,8680,5,9,5,12,34,33,1,32
Ballymena,8680,6,7,5,14,26,48,-22,26
Glentoran,8680,7,6,6,10,24,32,-8,24
Dungannon,8680,8,2,4,16,14,47,-33,10
Coleraine,8681,1,15,10,1,45,23,22,55
Crusaders,8681,2,16,6,4,62,33,29,54
Glenavon,8681,3,9,9,8,53,45,8,36
Linfield,8681,4,10,5,11,38,40,-2,35
Cliftonville,8681,5,10,4,12,36,32,4,34
Ballymena,8681,6,8,4,14,28,48,-20,28
Glentoran,8681,7,6,6,10,24,32,-8,24
Dungannon,8681,8,2,4,16,14,47,-33,10
Coleraine,8682,1,15,10,1,45,23,22,55
Crusaders,8682,2,16,6,4,62,32,30,54
Linfield,8682,3,11,5,10,38,36,2,38
Glenavon,8682,4,9,9,8,53,45,8,36
Cliftonville,8682,5,9,4,13,32,32,0,31
Ballymena,8682,6,8,4,14,27,48,-21,28
Glentoran,8682,7,6,6,10,24,32,-8,24
Dungannon,8682,8,2,4,16,14,47,-33,10
Crusaders,8683,1,17,6,3,63,31,32,57
Coleraine,8683,2,14,11,1,44,23,21,53
Linfield,8683,3,11,5,10,41,38,3,38
Glenavon,8683,4,9,10,7,53,44,9,37
Cliftonville,8683,5,9,4,13,34,35,-1,31
Ballymena,8683,6,7,4,15,26,49,-23,25
Glentoran,8683,7,6,6,10,24,32,-8,24
Dungannon,8683,8,2,4,16,14,47,-33,10
Crusaders,8684,1,16,7,3,62,31,31,55
Coleraine,8684,2,14,10,2,44,24,20,52
Glenavon,8684,3,10,9,7,54,44,10,39
Linfield,8684,4,11,5,10,38,36,2,38
Cliftonville,8684,5,9,4,13,32,32,0,31
Ballymena,8684,6,7,5,14,26,48,-22,26
Glentoran,8684,7,6,6,10,24,32,-8,24
Dungannon,8684,8,2,4,16,14,47,-33,10
Crusaders,8685,1,17,6,3,64,30,34,57
Coleraine,8685,2,14,10,2,44,24,20,52
Glenavon,8685,3,10,9,7,54,44,10,39
Linfield,8685,4,11,5,10,38,36,2,38
Cliftonville,8685,5,9,4,13,32,32,0,31
Ballymena,8685,6,7,4,15,25,50,-25,25
Glentoran,8685,7,6,6,10,24,32,-8,24
Dungannon,8685,8,2,4,16,14,47,-33,10
Crusaders,8686,1,17,6,3,66,30,36,57
Coleraine,8686,2,15,10,1,45,23,22,55
Linfield,8686,3,11,5,10,39,37,2,38
Glenavon,8686,4,9,9,8,53,45,8,36
Cliftonville,8686,5,9,4,13,33,33,0,31
Ballymena,8686,6,7,4,15,25,52,-27,25
Glentoran,8686,7,6,6,10,24,32,-8,24
Dungannon,8686,8,2,4,16,14,47,-33,10
Crusaders,8687,1,16,6,4,62,32,30,54
Coleraine,8687,2,14,10,2,45,25,20,52
Glenavon,8687,3,10,9,7,55,45,10,39
Linfield,8687,4,10,6,10,38,37,1,36
Cliftonville,8687,5,9,5,12,33,32,1,32
Ballymena,8687,6,8,4,14,27,48,-21,28
Glentoran,8687,7,6,6,10,24,32,-8,24
Dungannon,8687,8,2,4,16,14,47,-33,10
Crusaders,8688,1,16,6,4,63,33,30,54
Coleraine,8688,2,14,10,2,44,24,20,52
Glenavon,8688,3,10,9,7,54,44,10,39
Linfield,8688,4,10,5,11,38,38,0,35
Cliftonville,8688,5,10,4,12,34,32,2,34
Ballymena,8688,6,8,4,14,28,49,-21,28
Glentoran,8688,7,6,6,10,24,32,-8,24
Dungannon,8688,8,2,4,16,14,47,-33,10
Crusaders,8689,1,16,7,3,62,31,31,55
Coleraine,8689,2,15,10,1,46,22,24,55
Linfield,8689,3,11,5,10,39,37,2,38
Glenavon,8689,4,9,9,8,52,46,6,36
Cliftonville,8689,5,9,4,13,33,33,0,31
Ballymena,8689,6,7,5,14,26,48,-22,26
Glentoran,8689,7,6,6,10,24,32,-8,24
Dungannon,8689,8,2,4,16,14,47,-33,10
Crusaders,8690,1,16,7,3,62,31,31,55
Coleraine,8690,2,14,10,2,44,24,20,52
Glenavon,8690,3,10,9,7,54,44,10,39
Linfield,8690,4,10,5,11,37,37,0,35
Cliftonville,8690,5,10,4,12,33,31,2,34
Ballymena,8690,6,7,5,14,26,48,-22,26
Glentoran,8690,7,6,6,10,24,32,-8,24
Dungannon,8690,8,2,4,16,14,47,-33,10
Crusaders,8691,1,16,6,4,62,33,29,54
Coleraine,8691,2,14,10,2,43,23,20,52
Glenavon,8691,3,10,9,7,53,43,10,39
Linfield,8691,4,10,5,11,37,38,-1,35
Cliftonville,8691,5,10,4,12,34,31,3,34
Ballymena,8691,6,8,4,14,28,48,-20,28
Glentoran,8691,7,6,6,10,24,32,-8,24
Dungannon,8691,8,2,4,16,14,47,-33,10
Crusaders,8692,1,16,7,3,63,32,31,55
Coleraine,8692,2,15,10,1,47,23,24,55
Linfield,8692,3,11,5,10,38,36,2,38
Glenavon,8692,4,9,9,8,53,47,6,36
Cliftonville,8692,5,9,4,13,32,32,0,31
Ballymena,8692,6,7,5,14,27,49,-22,26
Glentoran,8692,7,6,6,10,24,32,-8,24
Dungannon,8692,8,2,4,16,14,47,-33,10
Crusaders,8693,1,17,6,3,63,31,32,57
Coleraine,8693,2,15,10,1,45,22,23,55
Linfield,8693,3,11,5,10,40,38,2,38
Glenavon,8693,4,9,9,8,52,45,7,36
Cliftonville,8693,5,9,4,13,34,34,0,31
Ballymena,8693,6,7,4,15,26,49,-23,25
Glentoran,8693,7,6,6,10,24,32,-8,24
Dungannon,8693,8,2,4,16,14,47,-33,10
Crusaders,8694,1,17,6,3,64,31,33,57
Coleraine,8694,2,14,10,2,43,24,19,52
Glenavon,8694,3,10,9,7,54,43,11,39
Linfield,8694,4,11,5,10,40,37,3,38
Cliftonville,8694,5,9,4,13,33,34,-1,31
Ballymena,8694,6,7,4,15,26,50,-24,25
Glentoran,8694,7,6,6,10,24,32,-8,24
Dungannon,8694,8,2,4,16,14,47,-33,10
Crusaders,8695,1,17,6,3,63,31,32,57
Coleraine,8695,2,14,10,2,43,27,16,52
Glenavon,8695,3,10,9,7,57,43,14,39
Linfield,8695,4,11,5,10,43,37,6,38
Cliftonville,8695,5,9,4,13,33,37,-4,31
Ballymena,8695,6,7,4,15,26,49,-23,25
Glentoran,8695,7,6,6,10,24,32,-8,24
Dungannon,8695,8,2,4,16,14,47,-33,10
Crusaders,8696,1,17,6,3,64,30,34,57
Coleraine,8696,2,15,10,1,45,23,22,55
Glenavon,8696,3,9,9,8,53,45,8,36
Linfield,8696,4,10,5,11,38,38,0,35
Cliftonville,8696,5,10,4,12,34,32,2,34
Ballymena,8696,6,7,4,15,25,50,-25,25
Glentoran,8696,7,6,6,10,24,32,-8,24
Dungannon,8696,8,2,4,16,14,47,-33,10
Crusaders,8697,1,17,6,3,65,31,34,57
Coleraine,8697,2,14,11,1,44,23,21,53
Glenavon,8697,3,9,10,7,53,44,9,37
Linfield,8697,4,10,5,11,38,38,0,35
Cliftonville,8697,5,10,4,12,34,32,2,34
Ballymena,8697,6,7,4,15,26,51,-25,25
Glentoran,8697,7,6,6,10,24,32,-8,24
Dungannon,8697,8,2,4,16,14,47,-33,10
Crusaders,8698,1,17,6,3,62,30,32,57
Coleraine,8698,2,14,10,2,44,24,20,52
Glenavon,8698,3,10,9,7,54,44,10,39
Linfield,8698,4,11,5,10,38,36,2,38
Cliftonville,8698,5,9,4,13,32,32,0,31
Ballymena,8698,6,7,4,15,25,48,-23,25
Glentoran,8698,7,6,6,10,24,32,-8,24
Dungannon,8698,8,2,4,16,14,47,-33,10
Crusaders,8699,1,16,7,3,65,34,31,55
Coleraine,8699,2,14,11,1,44,23,21,53
Glenavon,8699,3,9,10,7,53,44,9,37
Linfield,8699,4,10,5,11,38,38,0,35
Cliftonville,8699,5,10,4,12,34,32,2,34
Ballymena,8699,6,7,5,14,29,51,-22,26
Glentoran,8699,7,6,6,10,24,32,-8,24
Dungannon,8699,8,2,4,16,14,47,-33,10
Crusaders,8700,1,16,7,3,62,31,31,55
Coleraine,8700,2,15,10,1,45,23,22,55
Linfield,8700,3,11,5,10,40,36,4,38
Glenavon,8700,4,9,9,8,53,45,8,36
Cliftonville,8700,5,9,4,13,32,34,-2,31
Ballymena,8700,6,7,5,14,26,48,-22,26
Glentoran,8700,7,6,6,10,24,32,-8,24
Dungannon,8700,8,2,4,16,14,47,-33,10
Coleraine,8701,1,15,10,1,46,23,23,55
Crusaders,8701,2,16,6,4,61,31,30,54
Glenavon,8701,3,9,9,8,53,46,7,36
Linfield,8701,4,10,6,10,38,37,1,36
Cliftonville,8701,5,9,5,12,33,32,1,32
Ballymena,8701,6,8,4,14,26,47,-21,28
Glentoran,8701,7,6,6,10,24,32,-8,24
Dungannon,8701,8,2,4,16,14,47,-33,10
Crusaders,8702,1,17,6,3,65,31,34,57
Coleraine,8702,2,14,11,1,44,23,21,53
Glenavon,8702,3,9,10,7,53,44,9,37
Linfield,8702,4,10,6,10,37,36,1,36
Cliftonville,8702,5,9,5,12,32,31,1,32
Ballymena,8702,6,7,4,15,26,51,-25,25
Glentoran,8702,7,6,6,10,24,32,-8,24
Dungannon,8702,8,2,4,16,14,47,-33,10
Crusaders,8703,1,16,7,3,62,31,31,55
Coleraine,8703,2,14,10,2,44,26,18,52
Glenavon,8703,3,10,9,7,56,44,12,39
Linfield,8703,4,10,6,10,38,37,1,36
Cliftonville,8703,5,9,5,12,33,32,1,32
Ballymena,8703,6,7,5,14,26,48,-22,26
Glentoran,8703,7,6,6,10,24,32,-8,24
Dungannon,8703,8,2,4,16,14,47,-33,10
Crusaders,8704,1,17,6,3,64,31,33,57
Coleraine,8704,2,14,11,1,44,23,21,53
Glenavon,8704,3,9,10,7,53,44,9,37
Linfield,8704,4,10,5,11,37,37,0,35
Cliftonville,8704,5,10,4,12,33,31,2,34
Ballymena,8704,6,7,4,15,26,50,-24,25
Glentoran,8704,7,6,6,10,24,32,-8,24
Dungannon,8704,8,2,4,16,14,47,-33,10
Crusaders,8705,1,16,6,4,62,32,30,54
Coleraine,8705,2,14,10,2,44,24,20,52
Glenavon,8705,3,10,9,7,54,44,10,39
Linfield,8705,4,10,6,10,38,37,1,36
Cliftonville,8705,5,9,5,12,33,32,1,32
Ballymena,8705,6,8,4,14,27,48,-21,28
Glentoran,8705,7,6,6,10,24,32,-8,24
Dungannon,8705,8,2,4,16,14,47,-33,10
Crusaders,8706,1,16,6,4,61,31,30,54
Coleraine,8706,2,14,10,2,43,24,19,52
Glenavon,8706,3,10,9,7,54,43,11,39
Linfield,8706,4,10,6,10,37,36,1,36
Cliftonville,8706,5,9,5,12,32,31,1,32
Ballymena,8706,6,8,4,14,26,47,-21,28
Glentoran,8706,7,6,6,10,24,32,-8,24
Dungannon,8706,8,2,4,16,14,47,-33,10
Crusaders,8707,1,16,6,4,62,32,30,54
Coleraine,8707,2,14,10,2,44,24,20,52
Glenavon,8707,3,10,9,7,54,44,10,39
Linfield,8707,4,10,6,10,37,36,1,36
Cliftonville,8707,5,9,5,12,32,31,1,32
Ballymena,8707,6,8,4,14,27,48,-21,28
Glentoran,8707,7,6,6,10,24,32,-8,24
Dungannon,8707,8,2,4,16,14,47,-33,10
Crusaders,8708,1,17,6,3,63,31,32,57
Coleraine,8708,2,14,10,2,43,24,19,52
Glenavon,8708,3,10,9,7,54,43,11,39
Linfield,8708,4,10,5,11,37,37,0,35
Cliftonville,8708,5,10,4,12,33,31,2,34
Ballymena,8708,6,7,4,15,26,49,-23,25
Glentoran,8708,7,6,6,10,24,32,-8,24
Dungannon,8708,8,2,4,16,14,47,-33,10
Crusaders,8709,1,17,6,3,63,30,33,57
Coleraine,8709,2,14,11,1,45,24,21,53
Linfield,8709,3,11,5,10,40,38,2,38
Glenavon,8709,4,9,10,7,54,45,9,37
Cliftonville,8709,5,9,4,13,34,34,0,31
Ballymena,8709,6,7,4,15,25,49,-24,25
Glentoran,8709,7,6,6,10,24,32,-8,24
Dungannon,8709,8,2,4,16,14,47,-33,10
Crusaders,8710,1,17,6,3,64,31,33,57
Coleraine,8710,2,14,11,1,44,23,21,53
Glenavon,8710,3,9,10,7,53,44,9,37
Linfield,8710,4,10,5,11,37,37,0,35
Cliftonville,8710,5,10,4,12,33,31,2,34
Ballymena,8710,6,7,4,15,26,50,-24,25
Glentoran,8710,7,6,6,10,24,32,-8,24
Dungannon,8710,8,2,4,16,14,47,-33,10
Crusaders,8711,1,17,6,3,62,30,32,57
Coleraine,8711,2,14,11,1,46,25,21,53
Glenavon,8711,3,9,10,7,55,46,9,37
Linfield,8711,4,10,6,10,38,37,1,36
Cliftonville,8711,5,9,5,12,33,32,1,32
Ballymena,8711,6,7,4,15,25,48,-23,25
Glentoran,8711,7,6,6,10,24,32,-8,24
Dungannon,8711,8,2,4,16,14,47,-33,10
Crusaders,8712,1,17,6,3,64,30,34,57
Coleraine,8712,2,14,10,2,45,25,20,52
Glenavon,8712,3,10,9,7,55,45,10,39
Linfield,8712,4,11,5,10,39,37,2,38
Cliftonville,8712,5,9,4,13,33,33,0,31
Ballymena,8712,6,7,4,15,25,50,-25,25
Glentoran,8712,7,6,6,10,24,32,-8,24
Dungannon,8712,8,2,4,16,14,47,-33,10
Crusaders,8713,1,16,7,3,61,30,31,55
Coleraine,8713,2,14,11,1,44,23,21,53
Glenavon,8713,3,9,10,7,53,44,9,37
Linfield,8713,4,10,5,11,39,39,0,35
Cliftonville,8713,5,10,4,12,35,33,2,34
Ballymena,8713,6,7,5,14,25,47,-22,26
Glentoran,8713,7,6,6,10,24,32,-8,24
Dungannon,8713,8,2,4,16,14,47,-33,10
Crusaders,8714,1,16,6,4,62,32,30,54
Coleraine,8714,2,14,10,2,44,26,18,52
Glenavon,8714,3,10,9,7,56,44,12,39
Linfield,8714,4,11,5,10,39,37,2,38
Cliftonville,8714,5,9,4,13,33,33,0,31
Ballymena,8714,6,8,4,14,27,48,-21,28
Glentoran,8714,7,6,6,10,24,32,-8,24
Dungannon,8714,8,2,4,16,14,47,-33,10
Coleraine,8715,1,15,10,1,44,22,22,55
Crusaders,8715,2,16,6,4,63,33,30,54
Linfield,8715,3,11,5,10,40,38,2,38
Glenavon,8715,4,9,9,8,52,44,8,36
Cliftonville,8715,5,9,4,13,34,34,0,31
Ballymena,8715,6,8,4,14,28,49,-21,28
Glentoran,8715,7,6,6,10,24,32,-8,24
Dungannon,8715,8,2,4,16,14,47,-33,10
Crusaders,8716,1,16,7,3,62,31,31,55
Coleraine,8716,2,15,10,1,44,22,22,55
Linfield,8716,3,11,5,10,39,36,3,38
Glenavon,8716,4,9,9,8,52,44,8,36
Cliftonville,8716,5,9,4,13,32,33,-1,31
Ballymena,8716,6,7,5,14,26,48,-22,26
Glentoran,8716,7,6,6,10,24,32,-8,24
Dungannon,8716,8,2,4,16,14,47,-33,10
Coleraine,8717,1,15,10,1,45,22,23,55
Crusaders,8717,2,16,6,4,62,32,30,54
Linfield,8717,3,11,5,10,39,37,2,38
Glenavon,8717,4,9,9,8,52,45,7,36
Cliftonville,8717,5,9,4,13,33,33,0,31
Ballymena,8717,6,8,4,14,27,48,-21,28
Glentoran,8717,7,6,6,10,24,32,-8,24
Dungannon,8717,8,2,4,16,14,47,-33,10
Crusaders,8718,1,17,6,3,63,30,33,57
Coleraine,8718,2,15,10,1,46,22,24,55
Linfield,8718,3,11,5,10,39,37,2,38
Glenavon,8718,4,9,9,8,52,46,6,36
Cliftonville,8718,5,9,4,13,33,33,0,31
Ballymena,8718,6,7,4,15,25,49,-24,25
Glentoran,8718,7,6,6,10,24,32,-8,24
Dungannon,8718,8,2,4,16,14,47,-33,10
Crusaders,8719,1,17,6,3,64,31,33,57
Coleraine,8719,2,14,11,1,45,24,21,53
Linfield,8719,3,11,5,10,41,38,3,38
Glenavon,8719,4,9,10,7,54,45,9,37
Cliftonville,8719,5,9,4,13,34,35,-1,31
Ballymena,8719,6,7,4,15,26,50,-24,25
Glentoran,8719,7,6,6,10,24,32,-8,24
Dungannon,8719,8,2,4,16,14,47,-33,10
Crusaders,8720,1,16,6,4,63,34,29,54
Coleraine,8720,2,14,10,2,44,24,20,52
Glenavon,8720,3,10,9,7,54,44,10,39
Linfield,8720,4,10,6,10,39,38,1,36
Cliftonville,8720,5,9,5,12,34,33,1,32
Ballymena,8720,6,8,4,14,29,49,-20,28
Glentoran,8720,7,6,6,10,24,32,-8,24
Dungannon,8720,8,2,4,16,14,47,-33,10
Crusaders,8721,1,17,6,3,64,30,34,57
Coleraine,8721,2,14,10,2,43,23,20,52
Glenavon,8721,3,10,9,7,53,43,10,39
Linfield,8721,4,11,5,10,38,36,2,38
Cliftonville,8721,5,9,4,13,32,32,0,31
Ballymena,8721,6,7,4,15,25,50,-25,25
Glentoran,8721,7,6,6,10,24,32,-8,24
Dungannon,8721,8,2,4,16,14,47,-33,10
Crusaders,8722,1,16,6,4,62,32,30,54
Coleraine,8722,2,14,10,2,43,23,20,52
Glenavon,8722,3,10,9,7,53,43,10,39
Linfield,8722,4,11,5,10,39,36,3,38
Cliftonville,8722,5,9,4,13,32,33,-1,31
Ballymena,8722,6,8,4,14,27,48,-21,28
Glentoran,8722,7,6,6,10,24,32,-8,24
Dungannon,8722,8,2,4,16,14,47,-33,10
Crusaders,8723,1,17,6,3,65,31,34,57
Coleraine,8723,2,14,10,2,44,27,17,52
Glenavon,8723,3,10,9,7,57,44,13,39
Linfield,8723,4,11,5,10,39,37,2,38
Cliftonville,8723,5,9,4,13,33,33,0,31
Ballymena,8723,6,7,4,15,26,51,-25,25
Glentoran,8723,7,6,6,10,24,32,-8,24
Dungannon,8723,8,2,4,16,14,47,-33,10
Crusaders,8724,1,16,6,4,61,31,30,54
Coleraine,8724,2,14,10,2,43,24,19,52
Glenavon,8724,3,10,9,7,54,43,11,39
Linfield,8724,4,11,5,10,39,36,3,38
Cliftonville,8724,5,9,4,13,32,33,-1,31
Ballymena,8724,6,8,4,14,26,47,-21,28
Glentoran,8724,7,6,6,10,24,32,-8,24
Dungannon,8724,8,2,4,16,14,47,-33,10
Crusaders,8725,1,17,6,3,63,31,32,57
Coleraine,8725,2,14,11,1,45,24,21,53
Glenavon,8725,3,9,10,7,54,45,9,37
Linfield,8725,4,10,6,10,38,37,1,36
Cliftonville,8725,5,9,5,12,33,32,1,32
Ballymena,8725,6,7,4,15,26,49,-23,25
Glentoran,8725,7,6,6,10,24,32,-8,24
Dungannon,8725,8,2,4,16,14,47,-33,10
Crusaders,8726,1,16,7,3,63,32,31,55
Coleraine,8726,2,14,10,2,43,24,19,52
Glenavon,8726,3,10,9,7,54,43,11,39
Linfield,8726,4,11,5,10,40,37,3,38
Cliftonville,8726,5,9,4,13,33,34,-1,31
Ballymena,8726,6,7,5,14,27,49,-22,26
Glentoran,8726,7,6,6,10,24,32,-8,24
Dungannon,8726,8,2,4,16,14,47,-33,10
Crusaders,8727,1,16,6,4,61,31,30,54
Coleraine,8727,2,14,10,2,46,26,20,52
Glenavon,8727,3,10,9,7,56,46,10,39
Linfield,8727,4,11,5,10,38,36,2,38
Cliftonville,8727,5,9,4,13,32,32,0,31
Ballymena,8727,6,8,4,14,26,47,-21,28
Glentoran,8727,7,6,6,10,24,32,-8,24
Dungannon,8727,8,2,4,16,14,47,-33,10
Crusaders,8728,1,17,6,3,62,30,32,57
Coleraine,8728,2,14,11,1,46,25,21,53
Glenavon,8728,3,9,10,7,55,46,9,37
Linfield,8728,4,10,5,11,37,37,0,35
Cliftonville,8728,5,10,4,12,33,31,2,34
Ballymena,8728,6,7,4,15,25,48,-23,25
Glentoran,8728,7,6,6,10,24,32,-8,24
Dungannon,8728,8,2,4,16,14,47,-33,10
Coleraine,8729,1,15,10,1,46,24,22,55
Crusaders,8729,2,16,6,4,61,32,29,54
Glenavon,8729,3,9,9,8,54,46,8,36
Linfield,8729,4,10,5,11,37,38,-1,35
Cliftonville,8729,5,10,4,12,34,31,3,34
Ballymena,8729,6,8,4,14,27,47,-20,28
Glentoran,8729,7,6,6,10,24,32,-8,24
Dungannon,8729,8,2,4,16,14,47,-33,10
Crusaders,8730,1,16,6,4,61,31,30,54
Coleraine,8730,2,14,10,2,45,26,19,52
Glenavon,8730,3,10,9,7,56,45,11,39
Linfield,8730,4,11,5,10,38,36,2,38
Cliftonville,8730,5,9,4,13,32,32,0,31
Ballymena,8730,6,8,4,14,26,47,-21,28
Glentoran,8730,7,6,6,10,24,32,-8,24
Dungannon,8730,8,2,4,16,14,47,-33,10
Crusaders,8731,1,17,6,3,62,30,32,57
Coleraine,8731,2,15,10,1,45,23,22,55
Linfield,8731,3,11,5,10,39,37,2,38
Glenavon,8731,4,9,9,8,53,45,8,36
Cliftonville,8731,5,9,4,13,33,33,0,31
Ballymena,8731,6,7,4,15,25,48,-23,25
Glentoran,8731,7,6,6,10,24,32,-8,24
Dungannon,8731,8,2,4,16,14,47,-33,10
Crusaders,8732,1,16,7,3,62,31,31,55
Coleraine,8732,2,14,10,2,43,23,20,52
Glenavon,8732,3,10,9,7,53,43,10,39
Linfield,8732,4,10,5,11,37,38,-1,35
Cliftonville,8732,5,10,4,12,34,31,3,34
Ballymena,8732,6,7,5,14,26,48,-22,26
Glentoran,8732,7,6,6,10,24,32,-8,24
Dungannon,8732,8,2,4,16,14,47,-33,10
Crusaders,8733,1,17,6,3,65,32,33,57
Coleraine,8733,2,14,11,1,44,23,21,53
Glenavon,8733,3,9,10,7,53,44,9,37
Linfield,8733,4,10,6,10,38,37,1,36
Cliftonville,8733,5,9,5,12,33,32,1,32
Ballymena,8733,6,7,4,15,27,51,-24,25
Glentoran,8733,7,6,6,10,24,32,-8,24
Dungannon,8733,8,2,4,16,14,47,-33,10
Coleraine,8734,1,15,10,1,46,24,22,55
Crusaders,8734,2,16,6,4,62,33,29,54
Glenavon,8734,3,9,9,8,54,46,8,36
Linfield,8734,4,10,6,10,39,38,1,36
Cliftonville,8734,5,9,5,12,34,33,1,32
Ballymena,8734,6,8,4,14,28,48,-20,28
Glentoran,8734,7,6,6,10,24,32,-8,24
Dungannon,8734,8,2,4,16,14,47,-33,10
Crusaders,8735,1,17,6,3,63,31,32,57
Coleraine,8735,2,15,10,1,46,24,22,55
Linfield,8735,3,11,5,10,39,37,2,38
Glenavon,8735,4,9,9,8,54,46,8,36
Cliftonville,8735,5,9,4,13,33,33,0,31
Ballymena,8735,6,7,4,15,26,49,-23,25
Glentoran,8735,7,6,6,10,24,32,-8,24
Dungannon,8735,8,2,4,16,14,47,-33,10
Crusaders,8736,1,17,6,3,66,32,34,57
Coleraine,8736,2,14,10,2,43,24,19,52
Glenavon,8736,3,10,9,7,54,43,11,39
Linfield,8736,4,11,5,10,40,37,3,38
Cliftonville,8736,5,9,4,13,33,34,-1,31
Ballymena,8736,6,7,4,15,27,52,-25,25
Glentoran,8736,7,6,6,10,24,32,-8,24
Dungannon,8736,8,2,4,16,14,47,-33,10
Crusaders,8737,1,17,6,3,64,30,34,57
Coleraine,8737,2,15,10,1,46,22,24,55
Glenavon,8737,3,9,9,8,52,46,6,36
Linfield,8737,4,10,6,10,38,37,1,36
Cliftonville,8737,5,9,5,12,33,32,1,32
Ballymena,8737,6,7,4,15,25,50,-25,25
Glentoran,8737,7,6,6,10,24,32,-8,24
Dungannon,8737,8,2,4,16,14,47,-33,10
Crusaders,8738,1,16,7,3,66,35,31,55
Coleraine,8738,2,15,10,1,45,23,22,55
Linfield,8738,3,11,5,10,38,36,2,38
Glenavon,8738,4,9,9,8,53,45,8,36
Cliftonville,8738,5,9,4,13,32,32,0,31
Ballymena,8738,6,7,5,14,30,52,-22,26
Glentoran,8738,7,6,6,10,24,32,-8,24
Dungannon,8738,8,2,4,16,14,47,-33,10
Crusaders,8739,1,17,6,3,64,32,32,57
Coleraine,8739,2,15,10,1,46,23,23,55
Glenavon,8739,3,9,9,8,53,46,7,36
Linfield,8739,4,10,6,10,39,38,1,36
Cliftonville,8739,5,9,5,12,34,33,1,32
Ballymena,8739,6,7,4,15,27,50,-23,25
Glentoran,8739,7,6,6,10,24,32,-8,24
Dungannon,8739,8,2,4,16,14,47,-33,10
Crusaders,8740,1,17,6,3,64,32,32,57
Coleraine,8740,2,15,10,1,48,23,25,55
Glenavon,8740,3,9,9,8,53,48,5,36
Linfield,8740,4,10,6,10,37,36,1,36
Cliftonville,8740,5,9,5,12,32,31,1,32
Ballymena,8740,6,7,4,15,27,50,-23,25
Glentoran,8740,7,6,6,10,24,32,-8,24
Dungannon,8740,8,2,4,16,14,47,-33,10
Crusaders,8741,1,17,6,3,64,32,32,57
Coleraine,8741,2,15,10,1,48,23,25,55
Glenavon,8741,3,9,9,8,53,48,5,36
Linfield,8741,4,10,5,11,37,38,-1,35
Cliftonville,8741,5,10,4,12,34,31,3,34
Ballymena,8741,6,7,4,15,27,50,-23,25
Glentoran,8741,7,6,6,10,24,32,-8,24
Dungannon,8741,8,2,4,16,14,47,-33,10
Crusaders,8742,1,17,6,3,64,30,34,57
Coleraine,8742,2,14,10,2,43,26,17,52
Glenavon,8742,3,10,9,7,56,43,13,39
Linfield,8742,4,11,5,10,39,36,3,38
Cliftonville,8742,5,9,4,13,32,33,-1,31
Ballymena,8742,6,7,4,15,25,50,-25,25
Glentoran,8742,7,6,6,10,24,32,-8,24
Dungannon,8742,8,2,4,16,14,47,-33,10
Crusaders,8743,1,16,6,4,62,32,30,54
Coleraine,8743,2,14,10,2,43,23,20,52
Glenavon,8743,3,10,9,7,53,43,10,39
Linfield,8743,4,11,5,10,40,36,4,38
Cliftonville,8743,5,9,4,13,32,34,-2,31
Ballymena,8743,6,8,4,14,27,48,-21,28
Glentoran,8743,7,6,6,10,24,32,-8,24
Dungannon,8743,8,2,4,16,14,47,-33,10
Crusaders,8744,1,17,6,3,64,30,34,57
Coleraine,8744,2,15,10,1,45,23,22,55
Glenavon,8744,3,9,9,8,53,45,8,36
Linfield,8744,4,10,6,10,37,36,1,36
Cliftonville,8744,5,9,5,12,32,31,1,32
Ballymena,8744,6,7,4,15,25,50,-25,25
Glentoran,8744,7,6,6,10,24,32,-8,24
Dungannon,8744,8,2,4,16,14,47,-33,10
Crusaders,8745,1,16,7,3,62,31,31,55
Coleraine,8745,2,15,10,1,44,22,22,55
Linfield,8745,3,11,5,10,38,36,2,38
Glenavon,8745,4,9,9,8,52,44,8,36
Cliftonville,8745,5,9,4,13,32,32,0,31
Ballymena,8745,6,7,5,14,26,48,-22,26
Glentoran,8745,7,6,6,10,24,32,-8,24
Dungannon,8745,8,2,4,16,14,47,-33,10
Crusaders,8746,1,16,6,4,61,31,30,54
Coleraine,8746,2,14,10,2,44,25,19,52
Glenavon,8746,3,10,9,7,55,44,11,39
Linfield,8746,4,11,5,10,40,36,4,38
Cliftonville,8746,5,9,4,13,32,34,-2,31
Ballymena,8746,6,8,4,14,26,47,-21,28
Glentoran,8746,7,6,6,10,24,32,-8,24
Dungannon,8746,8,2,4,16,14,47,-33,10
Crusaders,8747,1,17,6,3,63,31,32,57
Coleraine,8747,2,14,10,2,45,26,19,52
Glenavon,8747,3,10,9,7,56,45,11,39
Linfield,8747,4,10,5,11,38,39,-1,35
Cliftonville,8747,5,10,4,12,35,32,3,34
Ballymena,8747,6,7,4,15,26,49,-23,25
Glentoran,8747,7,6,6,10,24,32,-8,24
Dungannon,8747,8,2,4,16,14,47,-33,10
Crusaders,8748,1,17,6,3,66,32,34,57
Coleraine,8748,2,14,10,2,43,24,19,52
Glenavon,8748,3,10,9,7,54,43,11,39
Linfield,8748,4,10,5,11,37,38,-1,35
Cliftonville,8748,5,10,4,12,34,31,3,34
Ballymena,8748,6,7,4,15,27,52,-25,25
Glentoran,8748,7,6,6,10,24,32,-8,24
Dungannon,8748,8,2,4,16,14,47,-33,10
Crusaders,8749,1,16,7,3,64,33,31,55
Coleraine,8749,2,14,11,1,45,24,21,53
Glenavon,8749,3,9,10,7,54,45,9,37
Linfield,8749,4,10,6,10,38,37,1,36
Cliftonville,8749,5,9,5,12,33,32,1,32
Ballymena,8749,6,7,5,14,28,50,-22,26
Glentoran,8749,7,6,6,10,24,32,-8,24
Dungannon,8749,8,2,4,16,14,47,-33,10
Crusaders,8750,1,17,6,3,66,31,35,57
Coleraine,8750,2,14,11,1,46,25,21,53
Linfield,8750,3,11,5,10,39,36,3,38
Glenavon,8750,4,9,10,7,55,46,9,37
Cliftonville,8750,5,9,4,13,32,33,-1,31
Ballymena,8750,6,7,4,15,26,52,-26,25
Glentoran,8750,7,6,6,10,24,32,-8,24
Dungannon,8750,8,2,4,16,14,47,-33,10
Crusaders,8751,1,17,6,3,63,30,33,57
Coleraine,8751,2,14,10,2,43,23,20,52
Glenavon,8751,3,10,9,7,53,43,10,39
Linfield,8751,4,10,6,10,37,36,1,36
Cliftonville,8751,5,9,5,12,32,31,1,32
Ballymena,8751,6,7,4,15,25,49,-24,25
Glentoran,8751,7,6,6,10,24,32,-8,24
Dungannon,8751,8,2,4,16,14,47,-33,10
Crusaders,8752,1,17,6,3,67,31,36,57
Coleraine,8752,2,15,10,1,46,24,22,55
Linfield,8752,3,11,5,10,42,36,6,38
Glenavon,8752,4,9,9,8,54,46,8,36
Cliftonville,8752,5,9,4,13,32,36,-4,31
Ballymena,8752,6,7,4,15,26,53,-27,25
Glentoran,8752,7,6,6,10,24,32,-8,24
Dungannon,8752,8,2,4,16,14,47,-33,10
Crusaders,8753,1,16,7,3,61,30,31,55
Coleraine,8753,2,14,10,2,44,25,19,52
Glenavon,8753,3,10,9,7,55,44,11,39
Linfield,8753,4,10,5,11,39,40,-1,35
Cliftonville,8753,5,10,4,12,36,33,3,34
Ballymena,8753,6,7,5,14,25,47,-22,26
Glentoran,8753,7,6,6,10,24,32,-8,24
Dungannon,8753,8,2,4,16,14,47,-33,10
Crusaders,8754,1,17,6,3,65,31,34,57
Coleraine,8754,2,14,11,1,44,23,21,53
Glenavon,8754,3,9,10,7,53,44,9,37
Linfield,8754,4,10,5,11,38,39,-1,35
Cliftonville,8754,5,10,4,12,35,32,3,34
Ballymena,8754,6,7,4,15,26,51,-25,25
Glentoran,8754,7,6,6,10,24,32,-8,24
Dungannon,8754,8,2,4,16,14,47,-33,10
Crusaders,8755,1,17,6,3,65,32,33,57
Coleraine,8755,2,14,10,2,44,24,20,52
Glenavon,8755,3,10,9,7,54,44,10,39
Linfield,8755,4,11,5,10,39,36,3,38
Cliftonville,8755,5,9,4,13,32,33,-1,31
Ballymena,8755,6,7,4,15,27,51,-24,25
Glentoran,8755,7,6,6,10,24,32,-8,24
Dungannon,8755,8,2,4,16,14,47,-33,10
Crusaders,8756,1,16,7,3,61,30,31,55
Coleraine,8756,2,15,10,1,44,22,22,55
Linfield,8756,3,11,5,10,38,36,2,38
Glenavon,8756,4,9,9,8,52,44,8,36
Cliftonville,8756,5,9,4,13,32,32,0,31
Ballymena,8756,6,7,5,14,25,47,-22,26
Glentoran,8756,7,6,6,10,24,32,-8,24
Dungannon,8756,8,2,4,16,14,47,-33,10
Crusaders,8757,1,16,6,4,62,32,30,54
Coleraine,8757,2,14,10,2,43,23,20,52
Glenavon,8757,3,10,9,7,53,43,10,39
Linfield,8757,4,11,5,10,39,37,2,38
Cliftonville,8757,5,9,4,13,33,33,0,31
Ballymena,8757,6,8,4,14,27,48,-21,28
Glentoran,8757,7,6,6,10,24,32,-8,24
Dungannon,8757,8,2,4,16,14,47,-33,10
Crusaders,8758,1,17,6,3,66,32,34,57
Coleraine,8758,2,14,10,2,43,24,19,52
Glenavon,8758,3,10,9,7,54,43,11,39
Linfield,8758,4,10,6,10,38,37,1,36
Cliftonville,8758,5,9,5,12,33,32,1,32
Ballymena,8758,6,7,4,15,27,52,-25,25
Glentoran,8758,7,6,6,10,24,32,-8,24
Dungannon,8758,8,2,4,16,14,47,-33,10
Crusaders,8759,1,17,6,3,62,30,32,57
Coleraine,8759,2,14,11,1,43,22,21,53
Glenavon,8759,3,9,10,7,52,43,9,37
Linfield,8759,4,10,5,11,38,39,-1,35
Cliftonville,8759,5,10,4,12,35,32,3,34
Ballymena,8759,6,7,4,15,25,48,-23,25
Glentoran,8759,7,6,6,10,24,32,-8,24
Dungannon,8759,8,2,4,16,14,47,-33,10
Crusaders,8760,1,16,6,4,62,32,30,54
Coleraine,8760,2,14,11,1,44,23,21,53
Glenavon,8760,3,9,10,7,53,44,9,37
Linfield,8760,4,10,6,10,37,36,1,36
Cliftonville,8760,5,9,5,12,32,31,1,32
Ballymena,8760,6,8,4,14,27,48,-21,28
Glentoran,8760,7,6,6,10,24,32,-8,24
Dungannon,8760,8,2,4,16,14,47,-33,10
Crusaders,8761,1,17,6,3,65,30,35,57
Coleraine,8761,2,14,11,1,44,23,21,53
Linfield,8761,3,11,5,10,40,38,2,38
Glenavon,8761,4,9,10,7,53,44,9,37
Cliftonville,8761,5,9,4,13,34,34,0,31
Ballymena,8761,6,7,4,15,25,51,-26,25
Glentoran,8761,7,6,6,10,24,32,-8,24
Dungannon,8761,8,2,4,16,14,47,-33,10
Crusaders,8762,1,17,6,3,66,31,35,57
Coleraine,8762,2,15,10,1,47,24,23,55
Glenavon,8762,3,9,9,8,54,47,7,36
Linfield,8762,4,10,6,10,39,38,1,36
Cliftonville,8762,5,9,5,12,34,33,1,32
Ballymena,8762,6,7,4,15,26,52,-26,25
Glentoran,8762,7,6,6,10,24,32,-8,24
Dungannon,8762,8,2,4,16,14,47,-33,10
Crusaders,8763,1,17,6,3,64,32,32,57
Coleraine,8763,2,14,10,2,43,23,20,52
Glenavon,8763,3,10,9,7,53,43,10,39
Linfield,8763,4,10,5,11,38,39,-1,35
Cliftonville,8763,5,10,4,12,35,32,3,34
Ballymena,8763,6,7,4,15,27,50,-23,25
Glentoran,8763,7,6,6,10,24,32,-8,24
Dungannon,8763,8,2,4,16,14,47,-33,10
Crusaders,8764,1,17,6,3,63,30,33,57
Coleraine,8764,2,15,10,1,44,22,22,55
Glenavon,8764,3,9,9,8,52,44,8,36
Linfield,8764,4,10,5,11,38,38,0,35
Cliftonville,8764,5,10,4,12,34,32,2,34
Ballymena,8764,6,7,4,15,25,49,-24,25
Glentoran,8764,7,6,6,10,24,32,-8,24
Dungannon,8764,8,2,4,16,14,47,-33,10
Crusaders,8765,1,16,7,3,62,31,31,55
Coleraine,8765,2,14,11,1,44,23,21,53
Linfield,8765,3,11,5,10,40,37,3,38
Glenavon,8765,4,9,10,7,53,44,9,37
Cliftonville,8765,5,9,4,13,33,34,-1,31
Ballymena,8765,6,7,5,14,26,48,-22,26
Glentoran,8765,7,6,6,10,24,32,-8,24
Dungannon,8765,8,2,4,16,14,47,-33,10
Crusaders,8766,1,16,7,3,62,31,31,55
Coleraine,8766,2,14,11,1,46,25,21,53
Glenavon,8766,3,9,10,7,55,46,9,37
Linfield,8766,4,10,6,10,38,37,1,36
Cliftonville,8766,5,9,5,12,33,32,1,32
Ballymena,8766,6,7,5,14,26,48,-22,26
Glentoran,8766,7,6,6,10,24,32,-8,24
Dungannon,8766,8,2,4,16,14,47,-33,10
Crusaders,8767,1,16,7,3,62,31,31,55
Coleraine,8767,2,15,10,1,45,22,23,55
Glenavon,8767,3,9,9,8,52,45,7,36
Linfield,8767,4,10,5,11,37,37,0,35
Cliftonville,8767,5,10,4,12,33,31,2,34
Ballymena,8767,6,7,5,14,26,48,-22,26
Glentoran,8767,7,6,6,10,24,32,-8,24
Dungannon,8767,8,2,4,16,14,47,-33,10
Coleraine,8768,1,15,10,1,45,23,22,55
Crusaders,8768,2,16,6,4,63,35,28,54
Glenavon,8768,3,9,9,8,53,45,8,36
Linfield,8768,4,10,6,10,37,36,1,36
Cliftonville,8768,5,9,5,12,32,31,1,32
Ballymena,8768,6,8,4,14,30,49,-19,28
Glentoran,8768,7,6,6,10,24,32,-8,24
Dungannon,8768,8,2,4,16,14,47,-33,10
Crusaders,8769,1,17,6,3,63,31,32,57
Coleraine,8769,2,14,10,2,43,27,16,52
Glenavon,8769,3,10,9,7,57,43,14,39
Linfield,8769,4,10,5,11,38,38,0,35
Cliftonville,8769,5,10,4,12,34,32,2,34
Ballymena,8769,6,7,4,15,26,49,-23,25
Glentoran,8769,7,6,6,10,24,32,-8,24
Dungannon,8769,8,2,4,16,14,47,-33,10
Crusaders,8770,1,17,6,3,64,32,32,57
Coleraine,8770,2,14,10,2,44,24,20,52
Glenavon,8770,3,10,9,7,54,44,10,39
Linfield,8770,4,10,6,10,37,36,1,36
Cliftonville,8770,5,9,5,12,32,31,1,32
Ballymena,8770,6,7,4,15,27,50,-23,25
Glentoran,8770,7,6,6,10,24,32,-8,24
Dungannon,8770,8,2,4,16,14,47,-33,10
Crusaders,8771,1,17,6,3,66,30,36,57
Coleraine,8771,2,15,10,1,44,22,22,55
Glenavon,8771,3,9,9,8,52,44,8,36
Linfield,8771,4,10,5,11,37,39,-2,35
Cliftonville,8771,5,10,4,12,35,31,4,34
Ballymena,8771,6,7,4,15,25,52,-27,25
Glentoran,8771,7,6,6,10,24,32,-8,24
Dungannon,8771,8,2,4,16,14,47,-33,10
Crusaders,8772,1,17,6,3,64,30,34,57
Coleraine,8772,2,15,10,1,44,22,22,55
Linfield,8772,3,11,5,10,40,38,2,38
Glenavon,8772,4,9,9,8,52,44,8,36
Cliftonville,8772,5,9,4,13,34,34,0,31
Ballymena,8772,6,7,4,15,25,50,-25,25
Glentoran,8772,7,6,6,10,24,32,-8,24
Dungannon,8772,8,2,4,16,14,47,-33,10
Crusaders,8773,1,17,6,3,63,31,32,57
Coleraine,8773,2,14,10,2,44,25,19,52
Glenavon,8773,3,10,9,7,55,44,11,39
Linfield,8773,4,11,5,10,39,36,3,38
Cliftonville,8773,5,9,4,13,32,33,-1,31
Ballymena,8773,6,7,4,15,26,49,-23,25
Glentoran,8773,7,6,6,10,24,32,-8,24
Dungannon,8773,8,2,4,16,14,47,-33,10
Crusaders,8774,1,16,7,3,62,31,31,55
Coleraine,8774,2,15,10,1,46,24,22,55
Glenavon,8774,3,9,9,8,54,46,8,36
Linfield,8774,4,10,6,10,37,36,1,36
Cliftonville,8774,5,9,5,12,32,31,1,32
Ballymena,8774,6,7,5,14,26,48,-22,26
Glentoran,8774,7,6,6,10,24,32,-8,24
Dungannon,8774,8,2,4,16,14,47,-33,10
Coleraine,8775,1,15,10,1,45,23,22,55
Crusaders,8775,2,16,6,4,62,32,30,54
Glenavon,8775,3,9,9,8,53,45,8,36
Linfield,8775,4,10,5,11,40,40,0,35
Cliftonville,8775,5,10,4,12,36,34,2,34
Ballymena,8775,6,8,4,14,27,48,-21,28
Glentoran,8775,7,6,6,10,24,32,-8,24
Dungannon,8775,8,2,4,16,14,47,-33,10
Crusaders,8776,1,16,7,3,62,31,31,55
Coleraine,8776,2,15,10,1,44,22,22,55
Linfield,8776,3,11,5,10,39,37,2,38
Glenavon,8776,4,9,9,8,52,44,8,36
Cliftonville,8776,5,9,4,13,33,33,0,31
Ballymena,8776,6,7,5,14,26,48,-22,26
Glentoran,8776,7,6,6,10,24,32,-8,24
Dungannon,8776,8,2,4,16,14,47,-33,10
Crusaders,8777,1,16,7,3,64,33,31,55
Coleraine,8777,2,15,10,1,47,23,24,55
Linfield,8777,3,11,5,10,39,37,2,38
Glenavon,8777,4,9,9,8,53,47,6,36
Cliftonville,8777,5,9,4,13,33,33,0,31
Ballymena,8777,6,7,5,14,28,50,-22,26
Glentoran,8777,7,6,6,10,24,32,-8,24
Dungannon,8777,8,2,4,16,14,47,-33,10
Crusaders,8778,1,16,6,4,61,31,30,54
Coleraine,8778,2,14,10,2,45,25,20,52
Glenavon,8778,3,10,9,7,55,45,10,39
Linfield,8778,4,11,5,10,38,36,2,38
Cliftonville,8778,5,9,4,13,32,32,0,31
Ballymena,8778,6,8,4,14,26,47,-21,28
Glentoran,8778,7,6,6,10,24,32,-8,24
Dungannon,8778,8,2,4,16,14,47,-33,10
Crusaders,8779,1,17,6,3,64,31,33,57
Coleraine,8779,2,14,11,1,44,23,21,53
Linfield,8779,3,11,5,10,41,37,4,38
Glenavon,8779,4,9,10,7,53,44,9,37
Cliftonville,8779,5,9,4,13,33,35,-2,31
Ballymena,8779,6,7,4,15,26,50,-24,25
Glentoran,8779,7,6,6,10,24,32,-8,24
Dungannon,8779,8,2,4,16,14,47,-33,10
Crusaders,8780,1,17,6,3,64,32,32,57
Coleraine,8780,2,14,10,2,45,26,19,52
Glenavon,8780,3,10,9,7,56,45,11,39
Linfield,8780,4,10,6,10,38,37,1,36
Cliftonville,8780,5,9,5,12,33,32,1,32
Ballymena,8780,6,7,4,15,27,50,-23,25
Glentoran,8780,7,6,6,10,24,32,-8,24
Dungannon,8780,8,2,4,16,14,47,-33,10
Coleraine,8781,1,15,10,1,45,23,22,55
Crusaders,8781,2,16,6,4,62,32,30,54
Glenavon,8781,3,9,9,8,53,45,8,36
Linfield,8781,4,10,6,10,38,37,1,36
Cliftonville,8781,5,9,5,12,33,32,1,32
Ballymena,8781,6,8,4,14,27,48,-21,28
Glentoran,8781,7,6,6,10,24,32,-8,24
Dungannon,8781,8,2,4,16,14,47,-33,10
Crusaders,8782,1,17,6,3,62,30,32,57
Coleraine,8782,2,14,10,2,43,24,19,52
Glenavon,8782,3,10,9,7,54,43,11,39
Linfield,8782,4,11,5,10,40,37,3,38
Cliftonville,8782,5,9,4,13,33,34,-1,31
Ballymena,8782,6,7,4,15,25,48,-23,25
Glentoran,8782,7,6,6,10,24,32,-8,24
Dungannon,8782,8,2,4,16,14,47,-33,10
Coleraine,8783,1,15,10,1,45,23,22,55
Crusaders,8783,2,16,6,4,61,31,30,54
Linfield,8783,3,11,5,10,39,36,3,38
Glenavon,8783,4,9,9,8,53,45,8,36
Cliftonville,8783,5,9,4,13,32,33,-1,31
Ballymena,8783,6,8,4,14,26,47,-21,28
Glentoran,8783,7,6,6,10,24,32,-8,24
Dungannon,8783,8,2,4,16,14,47,-33,10
Coleraine,8784,1,15,10,1,45,23,22,55
Crusaders,8784,2,16,6,4,62,36,26,54
Linfield,8784,3,11,5,10,39,37,2,38
Glenavon,8784,4,9,9,8,53,45,8,36
Cliftonville,8784,5,9,4,13,33,33,0,31
Ballymena,8784,6,8,4,14,31,48,-17,28
Glentoran,8784,7,6,6,10,24,32,-8,24
Dungannon,8784,8,2,4,16,14,47,-33,10
Crusaders,8785,1,17,6,3,64,30,34,57
Coleraine,8785,2,14,11,1,44,23,21,53
Glenavon,8785,3,9,10,7,53,44,9,37
Linfield,8785,4,10,6,10,38,37,1,36
Cliftonville,8785,5,9,5,12,33,32,1,32
Ballymena,8785,6,7,4,15,25,50,-25,25
Glentoran,8785,7,6,6,10,24,32,-8,24
Dungannon,8785,8,2,4,16,14,47,-33,10
Crusaders,8786,1,16,7,3,62,31,31,55
Coleraine,8786,2,14,11,1,45,24,21,53
Linfield,8786,3,11,5,10,39,37,2,38
Glenavon,8786,4,9,10,7,54,45,9,37
Cliftonville,8786,5,9,4,13,33,33,0,31
Ballymena,8786,6,7,5,14,26,48,-22,26
Glentoran,8786,7,6,6,10,24,32,-8,24
Dungannon,8786,8,2,4,16,14,47,-33,10
Crusaders,8787,1,17,6,3,62,30,32,57
Coleraine,8787,2,14,11,1,44,23,21,53
Glenavon,8787,3,9,10,7,53,44,9,37
Linfield,8787,4,10,5,11,38,38,0,35
Cliftonville,8787,5,10,4,12,34,32,2,34
Ballymena,8787,6,7,4,15,25,48,-23,25
Glentoran,8787,7,6,6,10,24,32,-8,24
Dungannon,8787,8,2,4,16,14,47,-33,10
Crusaders,8788,1,17,6,3,66,31,35,57
Coleraine,8788,2,14,10,2,43,23,20,52
Glenavon,8788,3,10,9,7,53,43,10,39
Linfield,8788,4,10,6,10,38,37,1,36
Cliftonville,8788,5,9,5,12,33,32,1,32
Ballymena,8788,6,7,4,15,26,52,-26,25
Glentoran,8788,7,6,6,10,24,32,-8,24
Dungannon,8788,8,2,4,16,14,47,-33,10
Crusaders,8789,1,16,7,3,63,32,31,55
Coleraine,8789,2,14,10,2,43,24,19,52
Glenavon,8789,3,10,9,7,54,43,11,39
Linfield,8789,4,11,5,10,38,36,2,38
Cliftonville,8789,5,9,4,13,32,32,0,31
Ballymena,8789,6,7,5,14,27,49,-22,26
Glentoran,8789,7,6,6,10,24,32,-8,24
Dungannon,8789,8,2,4,16,14,47,-33,10
Crusaders,8790,1,16,6,4,62,32,30,54
Coleraine,8790,2,14,10,2,43,23,20,52
Glenavon,8790,3,10,9,7,53,43,10,39
Linfield,8790,4,10,6,10,38,37,1,36
Cliftonville,8790,5,9,5,12,33,32,1,32
Ballymena,8790,6,8,4,14,27,48,-21,28
Glentoran,8790,7,6,6,10,24,32,-8,24
Dungannon,8790,8,2,4,16,14,47,-33,10
Crusaders,8791,1,17,6,3,62,30,32,57
Coleraine,8791,2,15,10,1,46,23,23,55
Linfield,8791,3,11,5,10,39,37,2,38
Glenavon,8791,4,9,9,8,53,46,7,36
Cliftonville,8791,5,9,4,13,33,33,0,31
Ballymena,8791,6,7,4,15,25,48,-23,25
Glentoran,8791,7,6,6,10,24,32,-8,24
Dungannon,8791,8,2,4,16,14,47,-33,10
Coleraine,8792,1,15,10,1,45,22,23,55
Crusaders,8792,2,16,6,4,61,31,30,54
Linfield,8792,3,11,5,10,39,37,2,38
Glenavon,8792,4,9,9,8,52,45,7,36
Cliftonville,8792,5,9,4,13,33,33,0,31
Ballymena,8792,6,8,4,14,26,47,-21,28
Glentoran,8792,7,6,6,10,24,32,-8,24
Dungannon,8792,8,2,4,16,14,47,-33,10
Crusaders,8793,1,16,6,4,61,32,29,54
Coleraine,8793,2,14,11,1,43,22,21,53
Linfield,8793,3,11,5,10,40,36,4,38
Glenavon,8793,4,9,10,7,52,43,9,37
Cliftonville,8793,5,9,4,13,32,34,-2,31
Ballymena,8793,6,8,4,14,27,47,-20,28
Glentoran,8793,7,6,6,10,24,32,-8,24
Dungannon,8793,8,2,4,16,14,47,-33,10
Crusaders,8794,1,16,6,4,61,31,30,54
Coleraine,8794,2,14,11,1,44,23,21,53
Glenavon,8794,3,9,10,7,53,44,9,37
Linfield,8794,4,10,5,11,37,37,0,35
Cliftonville,8794,5,10,4,12,33,31,2,34
Ballymena,8794,6,8,4,14,26,47,-21,28
Glentoran,8794,7,6,6,10,24,32,-8,24
Dungannon,8794,8,2,4,16,14,47,-33,10
Crusaders,8795,1,17,6,3,64,30,34,57
Coleraine,8795,2,14,10,2,45,25,20,52
Glenavon,8795,3,10,9,7,55,45,10,39
Linfield,8795,4,11,5,10,41,38,3,38
Cliftonville,8795,5,9,4,13,34,35,-1,31
Ballymena,8795,6,7,4,15,25,50,-25,25
Glentoran,8795,7,6,6,10,24,32,-8,24
Dungannon,8795,8,2,4,16,14,47,-33,10
Crusaders,8796,1,17,6,3,64,30,34,57
Coleraine,8796,2,15,10,1,48,25,23,55
Linfield,8796,3,11,5,10,38,36,2,38
Glenavon,8796,4,9,9,8,55,48,7,36
Cliftonville,8796,5,9,4,13,32,32,0,31
Ballymena,8796,6,7,4,15,25,50,-25,25
Glentoran,8796,7,6,6,10,24,32,-8,24
Dungannon,8796,8,2,4,16,14,47,-33,10
Crusaders,8797,1,17,6,3,63,30,33,57
Coleraine,8797,2,14,10,2,43,27,16,52
Glenavon,8797,3,10,9,7,57,43,14,39
Linfield,8797,4,11,5,10,40,36,4,38
Cliftonville,8797,5,9,4,13,32,34,-2,31
Ballymena,8797,6,7,4,15,25,49,-24,25
Glentoran,8797,7,6,6,10,24,32,-8,24
Dungannon,8797,8,2,4,16,14,47,-33,10
Coleraine,8798,1,15,10,1,45,23,22,55
Crusaders,8798,2,16,6,4,62,33,29,54
Linfield,8798,3,11,5,10,39,37,2,38
Glenavon,8798,4,9,9,8,53,45,8,36
Cliftonville,8798,5,9,4,13,33,33,0,31
Ballymena,8798,6,8,4,14,28,48,-20,28
Glentoran,8798,7,6,6,10,24,32,-8,24
Dungannon,8798,8,2,4,16,14,47,-33,10
Crusaders,8799,1,17,6,3,64,31,33,57
Coleraine,8799,2,14,11,1,45,24,21,53
Linfield,8799,3,11,5,10,39,36,3,38
Glenavon,8799,4,9,10,7,54,45,9,37
Cliftonville,8799,5,9,4,13,32,33,-1,31
Ballymena,8799,6,7,4,15,26,50,-24,25
Glentoran,8799,7,6,6,10,24,32,-8,24
Dungannon,8799,8,2,4,16,14,47,-33,10
Crusaders,8800,1,16,6,4,61,31,30,54
Coleraine,8800,2,14,11,1,44,23,21,53
Glenavon,8800,3,9,10,7,53,44,9,37
Linfield,8800,4,10,5,11,37,39,-2,35
Cliftonville,8800,5,10,4,12,35,31,4,34
Ballymena,8800,6,8,4,14,26,47,-21,28
Glentoran,8800,7,6,6,10,24,32,-8,24
Dungannon,8800,8,2,4,16,14,47,-33,10
Crusaders,8801,1,17,6,3,65,31,34,57
Coleraine,8801,2,14,11,1,44,23,21,53
Glenavon,8801,3,9,10,7,53,44,9,37
Linfield,8801,4,10,5,11,37,37,0,35
Cliftonville,8801,5,10,4,12,33,31,2,34
Ballymena,8801,6,7,4,15,26,51,-25,25
Glentoran,8801,7,6,6,10,24,32,-8,24
Dungannon,8801,8,2,4,16,14,47,-33,10
Crusaders,8802,1,17,6,3,62,30,32,57
Coleraine,8802,2,15,10,1,45,23,22,55
Linfield,8802,3,11,5,10,42,36,6,38
Glenavon,8802,4,9,9,8,53,45,8,36
Cliftonville,8802,5,9,4,13,32,36,-4,31
Ballymena,8802,6,7,4,15,25,48,-23,25
Glentoran,8802,7,6,6,10,24,32,-8,24
Dungannon,8802,8,2,4,16,14,47,-33,10
Crusaders,8803,1,17,6,3,66,30,36,57
Coleraine,8803,2,14,10,2,43,23,20,52
Glenavon,8803,3,10,9,7,53,43,10,39
Linfield,8803,4,10,5,11,37,37,0,35
Cliftonville,8803,5,10,4,12,33,31,2,34
Ballymena,8803,6,7,4,15,25,52,-27,25
Glentoran,8803,7,6,6,10,24,32,-8,24
Dungannon,8803,8,2,4,16,14,47,-33,10
Crusaders,8804,1,16,7,3,63,32,31,55
Coleraine,8804,2,14,10,2,44,25,19,52
Glenavon,8804,3,10,9,7,55,44,11,39
Linfield,8804,4,10,5,11,38,38,0,35
Cliftonville,8804,5,10,4,12,34,32,2,34
Ballymena,8804,6,7,5,14,27,49,-22,26
Glentoran,8804,7,6,6,10,24,32,-8,24
Dungannon,8804,8,2,4,16,14,47,-33,10
Crusaders,8805,1,16,7,3,62,31,31,55
Coleraine,8805,2,14,11,1,43,22,21,53
Glenavon,8805,3,9,10,7,52,43,9,37
Linfield,8805,4,10,6,10,38,37,1,36
Cliftonville,8805,5,9,5,12,33,32,1,32
Ballymena,8805,6,7,5,14,26,48,-22,26
Glentoran,8805,7,6,6,10,24,32,-8,24
Dungannon,8805,8,2,4,16,14,47,-33,10
Crusaders,8806,1,16,7,3,62,31,31,55
Coleraine,8806,2,15,10,1,47,23,24,55
Glenavon,8806,3,9,9,8,53,47,6,36
Linfield,8806,4,10,5,11,38,38,0,35
Cliftonville,8806,5,10,4,12,34,32,2,34
Ballymena,8806,6,7,5,14,26,48,-22,26
Glentoran,8806,7,6,6,10,24,32,-8,24
Dungannon,8806,8,2,4,16,14,47,-33,10
Crusaders,8807,1,17,6,3,66,32,34,57
Coleraine,8807,2,15,10,1,44,22,22,55
Glenavon,8807,3,9,9,8,52,44,8,36
Linfield,8807,4,10,5,11,38,38,0,35
Cliftonville,8807,5,10,4,12,34,32,2,34
Ballymena,8807,6,7,4,15,27,52,-25,25
Glentoran,8807,7,6,6,10,24,32,-8,24
Dungannon,8807,8,2,4,16,14,47,-33,10
Crusaders,8808,1,17,6,3,64,30,34,57
Coleraine,8808,2,15,10,1,46,23,23,55
Linfield,8808,3,11,5,10,39,36,3,38
Glenavon,8808,4,9,9,8,53,46,7,36
Cliftonville,8808,5,9,4,13,32,33,-1,31
Ballymena,8808,6,7,4,15,25,50,-25,25
Glentoran,8808,7,6,6,10,24,32,-8,24
Dungannon,8808,8,2,4,16,14,47,-33,10
Crusaders,8809,1,16,6,4,61,31,30,54
Coleraine,8809,2,14,10,2,43,24,19,52
Glenavon,8809,3,10,9,7,54,43,11,39
Linfield,8809,4,10,6,10,38,37,1,36
Cliftonville,8809,5,9,5,12,33,32,1,32
Ballymena,8809,6,8,4,14,26,47,-21,28
Glentoran,8809,7,6,6,10,24,32,-8,24
Dungannon,8809,8,2,4,16,14,47,-33,10
Crusaders,8810,1,16,7,3,63,32,31,55
Coleraine,8810,2,14,10,2,44,24,20,52
Glenavon,8810,3,10,9,7,54,44,10,39
Linfield,8810,4,11,5,10,40,38,2,38
Cliftonville,8810,5,9,4,13,34,34,0,31
Ballymena,8810,6,7,5,14,27,49,-22,26
Glentoran,8810,7,6,6,10,24,32,-8,24
Dungannon,8810,8,2,4,16,14,47,-33,10
Coleraine,8811,1,15,10,1,46,22,24,55
Crusaders,8811,2,16,6,4,63,35,28,54
Linfield,8811,3,11,5,10,39,37,2,38
Glenavon,8811,4,9,9,8,52,46,6,36
Cliftonville,8811,5,9,4,13,33,33,0,31
Ballymena,8811,6,8,4,14,30,49,-19,28
Glentoran,8811,7,6,6,10,24,32,-8,24
Dungannon,8811,8,2,4,16,14,47,-33,10
Crusaders,8812,1,16,6,4,61,33,28,54
Coleraine,8812,2,14,11,1,45,24,21,53
Glenavon,8812,3,9,10,7,54,45,9,37
Linfield,8812,4,10,5,11,38,38,0,35
Cliftonville,8812,5,10,4,12,34,32,2,34
Ballymena,8812,6,8,4,14,28,47,-19,28
Glentoran,8812,7,6,6,10,24,32,-8,24
Dungannon,8812,8,2,4,16,14,47,-33,10
Crusaders,8813,1,17,6,3,64,32,32,57
Coleraine,8813,2,14,11,1,45,24,21,53
Glenavon,8813,3,9,10,7,54,45,9,37
Linfield,8813,4,10,6,10,38,37,1,36
Cliftonville,8813,5,9,5,12,33,32,1,32
Ballymena,8813,6,7,4,15,27,50,-23,25
Glentoran,8813,7,6,6,10,24,32,-8,24
Dungannon,8813,8,2,4,16,14,47,-33,10
Crusaders,8814,1,17,6,3,66,31,35,57
Coleraine,8814,2,14,11,1,45,24,21,53
Glenavon,8814,3,9,10,7,54,45,9,37
Linfield,8814,4,10,6,10,39,38,1,36
Cliftonville,8814,5,9,5,12,34,33,1,32
Ballymena,8814,6,7,4,15,26,52,-26,25
Glentoran,8814,7,6,6,10,24,32,-8,24
Dungannon,8814,8,2,4,16,14,47,-33,10
Crusaders,8815,1,17,6,3,66,30,36,57
Coleraine,8815,2,14,10,2,46,26,20,52
Glenavon,8815,3,10,9,7,56,46,10,39
Linfield,8815,4,11,5,10,41,36,5,38
Cliftonville,8815,5,9,4,13,32,35,-3,31
Ballymena,8815,6,7,4,15,25,52,-27,25
Glentoran,8815,7,6,6,10,24,32,-8,24
Dungannon,8815,8,2,4,16,14,47,-33,10
Crusaders,8816,1,17,6,3,66,31,35,57
Coleraine,8816,2,14,11,1,44,23,21,53
Glenavon,8816,3,9,10,7,53,44,9,37
Linfield,8816,4,10,5,11,37,40,-3,35
Cliftonville,8816,5,10,4,12,36,31,5,34
Ballymena,8816,6,7,4,15,26,52,-26,25
Glentoran,8816,7,6,6,10,24,32,-8,24
Dungannon,8816,8,2,4,16,14,47,-33,10
Crusaders,8817,1,16,6,4,61,32,29,54
Coleraine,8817,2,14,11,1,44,23,21,53
Linfield,8817,3,11,5,10,41,37,4,38
Glenavon,8817,4,9,10,7,53,44,9,37
Cliftonville,8817,5,9,4,13,33,35,-2,31
Ballymena,8817,6,8,4,14,27,47,-20,28
Glentoran,8817,7,6,6,10,24,32,-8,24
Dungannon,8817,8,2,4,16,14,47,-33,10
Crusaders,8818,1,16,6,4,62,32,30,54
Coleraine,8818,2,14,10,2,43,25,18,52
Glenavon,8818,3,10,9,7,55,43,12,39
Linfield,8818,4,10,6,10,38,37,1,36
Cliftonville,8818,5,9,5,12,33,32,1,32
Ballymena,8818,6,8,4,14,27,48,-21,28
Glentoran,8818,7,6,6,10,24,32,-8,24
Dungannon,8818,8,2,4,16,14,47,-33,10
Crusaders,8819,1,16,7,3,63,32,31,55
Coleraine,8819,2,14,11,1,43,22,21,53
Linfield,8819,3,11,5,10,39,37,2,38
Glenavon,8819,4,9,10,7,52,43,9,37
Cliftonville,8819,5,9,4,13,33,33,0,31
Ballymena,8819,6,7,5,14,27,49,-22,26
Glentoran,8819,7,6,6,10,24,32,-8,24
Dungannon,8819,8,2,4,16,14,47,-33,10
Crusaders,8820,1,17,6,3,63,30,33,57
Coleraine,8820,2,14,10,2,43,25,18,52
Glenavon,8820,3,10,9,7,55,43,12,39
Linfield,8820,4,10,5,11,38,38,0,35
Cliftonville,8820,5,10,4,12,34,32,2,34
Ballymena,8820,6,7,4,15,25,49,-24,25
Glentoran,8820,7,6,6,10,24,32,-8,24
Dungannon,8820,8,2,4,16,14,47,-33,10
Coleraine,8821,1,15,10,1,45,23,22,55
Crusaders,8821,2,16,6,4,61,31,30,54
Glenavon,8821,3,9,9,8,53,45,8,36
Linfield,8821,4,10,6,10,37,36,1,36
Cliftonville,8821,5,9,5,12,32,31,1,32
Ballymena,8821,6,8,4,14,26,47,-21,28
Glentoran,8821,7,6,6,10,24,32,-8,24
Dungannon,8821,8,2,4,16,14,47,-33,10
Crusaders,8822,1,16,6,4,61,34,27,54
Coleraine,8822,2,14,10,2,44,25,19,52
Glenavon,8822,3,10,9,7,55,44,11,39
Linfield,8822,4,10,6,10,37,36,1,36
Cliftonville,8822,5,9,5,12,32,31,1,32
Ballymena,8822,6,8,4,14,29,47,-18,28
Glentoran,8822,7,6,6,10,24,32,-8,24
Dungannon,8822,8,2,4,16,14,47,-33,10
Crusaders,8823,1,16,7,3,64,33,31,55
Coleraine,8823,2,14,10,2,43,23,20,52
Glenavon,8823,3,10,9,7,53,43,10,39
Linfield,8823,4,10,6,10,37,36,1,36
Cliftonville,8823,5,9,5,12,32,31,1,32
Ballymena,8823,6,7,5,14,28,50,-22,26
Glentoran,8823,7,6,6,10,24,32,-8,24
Dungannon,8823,8,2,4,16,14,47,-33,10
Crusaders,8824,1,16,7,3,62,31,31,55
Coleraine,8824,2,14,11,1,45,24,21,53
Glenavon,8824,3,9,10,7,54,45,9,37
Linfield,8824,4,10,6,10,37,36,1,36
Cliftonville,8824,5,9,5,12,32,31,1,32
Ballymena,8824,6,7,5,14,26,48,-22,26
Glentoran,8824,7,6,6,10,24,32,-8,24
Dungannon,8824,8,2,4,16,14,47,-33,10
Crusaders,8825,1,16,7,3,62,31,31,55
Coleraine,8825,2,15,10,1,45,23,22,55
Linfield,8825,3,11,5,10,39,36,3,38
Glenavon,8825,4,9,9,8,53,45,8,36
Cliftonville,8825,5,9,4,13,32,33,-1,31
Ballymena,8825,6,7,5,14,26,48,-22,26
Glentoran,8825,7,6,6,10,24,32,-8,24
Dungannon,8825,8,2,4,16,14,47,-33,10
Crusaders,8826,1,17,6,3,64,30,34,57
Coleraine,8826,2,14,10,2,43,23,20,52
Glenavon,8826,3,10,9,7,53,43,10,39
Linfield,8826,4,11,5,10,39,37,2,38
Cliftonville,8826,5,9,4,13,33,33,0,31
Ballymena,8826,6,7,4,15,25,50,-25,25
Glentoran,8826,7,6,6,10,24,32,-8,24
Dungannon,8826,8,2,4,16,14,47,-33,10
Crusaders,8827,1,16,7,3,64,33,31,55
Coleraine,8827,2,15,10,1,45,22,23,55
Glenavon,8827,3,9,9,8,52,45,7,36
Linfield,8827,4,10,6,10,37,36,1,36
Cliftonville,8827,5,9,5,12,32,31,1,32
Ballymena,8827,6,7,5,14,28,50,-22,26
Glentoran,8827,7,6,6,10,24,32,-8,24
Dungannon,8827,8,2,4,16,14,47,-33,10
Crusaders,8828,1,16,6,4,61,31,30,54
Coleraine,8828,2,14,10,2,44,24,20,52
Glenavon,8828,3,10,9,7,54,44,10,39
Linfield,8828,4,10,6,10,38,37,1,36
Cliftonville,8828,5,9,5,12,33,32,1,32
Ballymena,8828,6,8,4,14,26,47,-21,28
Glentoran,8828,7,6,6,10,24,32,-8,24
Dungannon,8828,8,2,4,16,14,47,-33,10
Coleraine,8829,1,15,10,1,46,23,23,55
Crusaders,8829,2,16,6,4,63,33,30,54
Linfield,8829,3,11,5,10,39,37,2,38
Glenavon,8829,4,9,9,8,53,46,7,36
Cliftonville,8829,5,9,4,13,33,33,0,31
Ballymena,8829,6,8,4,14,28,49,-21,28
Glentoran,8829,7,6,6,10,24,32,-8,24
Dungannon,8829,8,2,4,16,14,47,-33,10
Crusaders,8830,1,17,6,3,64,32,32,57
Coleraine,8830,2,14,10,2,43,23,20,52
Glenavon,8830,3,10,9,7,53,43,10,39
Linfield,8830,4,10,5,11,37,37,0,35
Cliftonville,8830,5,10,4,12,33,31,2,34
Ballymena,8830,6,7,4,15,27,50,-23,25
Glentoran,8830,7,6,6,10,24,32,-8,24
Dungannon,8830,8,2,4,16,14,47,-33,10
Crusaders,8831,1,17,6,3,65,30,35,57
Coleraine,8831,2,14,11,1,44,23,21,53
Glenavon,8831,3,9,10,7,53,44,9,37
Linfield,8831,4,10,5,11,37,37,0,35
Cliftonville,8831,5,10,4,12,33,31,2,34
Ballymena,8831,6,7,4,15,25,51,-26,25
Glentoran,8831,7,6,6,10,24,32,-8,24
Dungannon,8831,8,2,4,16,14,47,-33,10
Crusaders,8832,1,17,6,3,63,31,32,57
Coleraine,8832,2,14,11,1,44,23,21,53
Linfield,8832,3,11,5,10,40,36,4,38
Glenavon,8832,4,9,10,7,53,44,9,37
Cliftonville,8832,5,9,4,13,32,34,-2,31
Ballymena,8832,6,7,4,15,26,49,-23,25
Glentoran,8832,7,6,6,10,24,32,-8,24
Dungannon,8832,8,2,4,16,14,47,-33,10
Crusaders,8833,1,17,6,3,63,30,33,57
Coleraine,8833,2,14,10,2,44,25,19,52
Glenavon,8833,3,10,9,7,55,44,11,39
Linfield,8833,4,10,6,10,38,37,1,36
Cliftonville,8833,5,9,5,12,33,32,1,32
Ballymena,8833,6,7,4,15,25,49,-24,25
Glentoran,8833,7,6,6,10,24,32,-8,24
Dungannon,8833,8,2,4,16,14,47,-33,10
Crusaders,8834,1,17,6,3,62,30,32,57
Coleraine,8834,2,14,11,1,45,24,21,53
Linfield,8834,3,11,5,10,38,36,2,38
Glenavon,8834,4,9,10,7,54,45,9,37
Cliftonville,8834,5,9,4,13,32,32,0,31
Ballymena,8834,6,7,4,15,25,48,-23,25
Glentoran,8834,7,6,6,10,24,32,-8,24
Dungannon,8834,8,2,4,16,14,47,-33,10
Crusaders,8835,1,17,6,3,63,30,33,57
Coleraine,8835,2,14,11,1,44,23,21,53
Linfield,8835,3,11,5,10,39,36,3,38
Glenavon,8835,4,9,10,7,53,44,9,37
Cliftonville,8835,5,9,4,13,32,33,-1,31
Ballymena,8835,6,7,4,15,25,49,-24,25
Glentoran,8835,7,6,6,10,24,32,-8,24
Dungannon,8835,8,2,4,16,14,47,-33,10
Crusaders,8836,1,16,7,3,62,31,31,55
Coleraine,8836,2,15,10,1,48,23,25,55
Linfield,8836,3,11,5,10,40,37,3,38
Glenavon,8836,4,9,9,8,53,48,5,36
Cliftonville,8836,5,9,4,13,33,34,-1,31
Ballymena,8836,6,7,5,14,26,48,-22,26
Glentoran,8836,7,6,6,10,24,32,-8,24
Dungannon,8836,8,2,4,16,14,47,-33,10
Crusaders,8837,1,17,6,3,62,30,32,57
Coleraine,8837,2,14,10,2,44,24,20,52
Glenavon,8837,3,10,9,7,54,44,10,39
Linfield,8837,4,10,6,10,37,36,1,36
Cliftonville,8837,5,9,5,12,32,31,1,32
Ballymena,8837,6,7,4,15,25,48,-23,25
Glentoran,8837,7,6,6,10,24,32,-8,24
Dungannon,8837,8,2,4,16,14,47,-33,10
Crusaders,8838,1,17,6,3,64,31,33,57
Coleraine,8838,2,14,10,2,44,24,20,52
Glenavon,8838,3,10,9,7,54,44,10,39
Linfield,8838,4,10,6,10,38,37,1,36
Cliftonville,8838,5,9,5,12,33,32,1,32
Ballymena,8838,6,7,4,15,26,50,-24,25
Glentoran,8838,7,6,6,10,24,32,-8,24
Dungannon,8838,8,2,4,16,14,47,-33,10
Crusaders,8839,1,16,6,4,61,32,29,54
Coleraine,8839,2,14,10,2,44,26,18,52
Glenavon,8839,3,10,9,7,56,44,12,39
Linfield,8839,4,10,5,11,37,37,0,35
Cliftonville,8839,5,10,4,12,33,31,2,34
Ballymena,8839,6,8,4,14,27,47,-20,28
Glentoran,8839,7,6,6,10,24,32,-8,24
Dungannon,8839,8,2,4,16,14,47,-33,10
Crusaders,8840,1,16,6,4,61,31,30,54
Coleraine,8840,2,14,11,1,45,24,21,53
Glenavon,8840,3,9,10,7,54,45,9,37
Linfield,8840,4,10,5,11,37,37,0,35
Cliftonville,8840,5,10,4,12,33,31,2,34
Ballymena,8840,6,8,4,14,26,47,-21,28
Glentoran,8840,7,6,6,10,24,32,-8,24
Dungannon,8840,8,2,4,16,14,47,-33,10
Crusaders,8841,1,17,6,3,62,30,32,57
Coleraine,8841,2,15,10,1,45,23,22,55
Glenavon,8841,3,9,9,8,53,45,8,36
Linfield,8841,4,10,5,11,38,39,-1,35
Cliftonville,8841,5,10,4,12,35,32,3,34
Ballymena,8841,6,7,4,15,25,48,-23,25
Glentoran,8841,7,6,6,10,24,32,-8,24
Dungannon,8841,8,2,4,16,14,47,-33,10
Crusaders,8842,1,17,6,3,63,31,32,57
Coleraine,8842,2,14,11,1,46,25,21,53
Glenavon,8842,3,9,10,7,55,46,9,37
Linfield,8842,4,10,5,11,37,37,0,35
Cliftonville,8842,5,10,4,12,33,31,2,34
Ballymena,8842,6,7,4,15,26,49,-23,25
Glentoran,8842,7,6,6,10,24,32,-8,24
Dungannon,8842,8,2,4,16,14,47,-33,10
Crusaders,8843,1,17,6,3,65,30,35,57
Coleraine,8843,2,15,10,1,48,26,22,55
Glenavon,8843,3,9,9,8,56,48,8,36
Linfield,8843,4,10,6,10,38,37,1,36
Cliftonville,8843,5,9,5,12,33,32,1,32
Ballymena,8843,6,7,4,15,25,51,-26,25
Glentoran,8843,7,6,6,10,24,32,-8,24
Dungannon,8843,8,2,4,16,14,47,-33,10
Crusaders,8844,1,17,6,3,63,30,33,57
Coleraine,8844,2,14,10,2,43,26,17,52
Glenavon,8844,3,10,9,7,56,43,13,39
Linfield,8844,4,10,6,10,37,36,1,36
Cliftonville,8844,5,9,5,12,32,31,1,32
Ballymena,8844,6,7,4,15,25,49,-24,25
Glentoran,8844,7,6,6,10,24,32,-8,24
Dungannon,8844,8,2,4,16,14,47,-33,10
Crusaders,8845,1,16,6,4,61,31,30,54
Coleraine,8845,2,14,10,2,44,28,16,52
Glenavon,8845,3,10,9,7,58,44,14,39
Linfield,8845,4,10,5,11,38,38,0,35
Cliftonville,8845,5,10,4,12,34,32,2,34
Ballymena,8845,6,8,4,14,26,47,-21,28
Glentoran,8845,7,6,6,10,24,32,-8,24
Dungannon,8845,8,2,4,16,14,47,-33,10
Crusaders,8846,1,16,7,3,63,32,31,55
Coleraine,8846,2,15,10,1,44,22,22,55
Glenavon,8846,3,9,9,8,52,44,8,36
Linfield,8846,4,10,5,11,38,38,0,35
Cliftonville,8846,5,10,4,12,34,32,2,34
Ballymena,8846,6,7,5,14,27,49,-22,26
Glentoran,8846,7,6,6,10,24,32,-8,24
Dungannon,8846,8,2,4,16,14,47,-33,10
Crusaders,8847,1,17,6,3,64,30,34,57
Coleraine,8847,2,15,10,1,45,22,23,55
Glenavon,8847,3,9,9,8,52,45,7,36
Linfield,8847,4,10,6,10,37,36,1,36
Cliftonville,8847,5,9,5,12,32,31,1,32
Ballymena,8847,6,7,4,15,25,50,-25,25
Glentoran,8847,7,6,6,10,24,32,-8,24
Dungannon,8847,8,2,4,16,14,47,-33,10
Crusaders,8848,1,16,6,4,62,33,29,54
Coleraine,8848,2,14,10,2,43,24,19,52
Glenavon,8848,3,10,9,7,54,43,11,39
Linfield,8848,4,10,6,10,37,36,1,36
Cliftonville,8848,5,9,5,12,32,31,1,32
Ballymena,8848,6,8,4,14,28,48,-20,28
Glentoran,8848,7,6,6,10,24,32,-8,24
Dungannon,8848,8,2,4,16,14,47,-33,10
Crusaders,8849,1,16,6,4,62,32,30,54
Coleraine,8849,2,14,10,2,44,24,20,52
Glenavon,8849,3,10,9,7,54,44,10,39
Linfield,8849,4,10,5,11,37,37,0,35
Cliftonville,8849,5,10,4,12,33,31,2,34
Ballymena,8849,6,8,4,14,27,48,-21,28
Glentoran,8849,7,6,6,10,24,32,-8,24
Dungannon,8849,8,2,4,16,14,47,-33,10
Crusaders,8850,1,17,6,3,64,31,33,57
Coleraine,8850,2,15,10,1,45,23,22,55
Glenavon,8850,3,9,9,8,53,45,8,36
Linfield,8850,4,10,6,10,38,37,1,36
Cliftonville,8850,5,9,5,12,33,32,1,32
Ballymena,8850,6,7,4,15,26,50,-24,25
Glentoran,8850,7,6,6,10,24,32,-8,24
Dungannon,8850,8,2,4,16,14,47,-33,10
Crusaders,8851,1,17,6,3,65,33,32,57
Coleraine,8851,2,14,11,1,45,24,21,53
Glenavon,8851,3,9,10,7,54,45,9,37
Linfield,8851,4,10,6,10,38,37,1,36
Cliftonville,8851,5,9,5,12,33,32,1,32
Ballymena,8851,6,7,4,15,28,51,-23,25
Glentoran,8851,7,6,6,10,24,32,-8,24
Dungannon,8851,8,2,4,16,14,47,-33,10
Crusaders,8852,1,16,7,3,62,31,31,55
Coleraine,8852,2,15,10,1,45,23,22,55
Glenavon,8852,3,9,9,8,53,45,8,36
Linfield,8852,4,10,6,10,38,37,1,36
Cliftonville,8852,5,9,5,12,33,32,1,32
Ballymena,8852,6,7,5,14,26,48,-22,26
Glentoran,8852,7,6,6,10,24,32,-8,24
Dungannon,8852,8,2,4,16,14,47,-33,10
Crusaders,8853,1,17,6,3,64,32,32,57
Coleraine,8853,2,15,10,1,44,22,22,55
Linfield,8853,3,11,5,10,40,36,4,38
Glenavon,8853,4,9,9,8,52,44,8,36
Cliftonville,8853,5,9,4,13,32,34,-2,31
Ballymena,8853,6,7,4,15,27,50,-23,25
Glentoran,8853,7,6,6,10,24,32,-8,24
Dungannon,8853,8,2,4,16,14,47,-33,10
Crusaders,8854,1,17,6,3,62,30,32,57
Coleraine,8854,2,14,10,2,44,24,20,52
Glenavon,8854,3,10,9,7,54,44,10,39
Linfield,8854,4,10,6,10,37,36,1,36
Cliftonville,8854,5,9,5,12,32,31,1,32
Ballymena,8854,6,7,4,15,25,48,-23,25
Glentoran,8854,7,6,6,10,24,32,-8,24
Dungannon,8854,8,2,4,16,14,47,-33,10
Crusaders,8855,1,17,6,3,63,30,33,57
Coleraine,8855,2,14,10,2,43,24,19,52
Glenavon,8855,3,10,9,7,54,43,11,39
Linfield,8855,4,11,5,10,39,36,3,38
Cliftonville,8855,5,9,4,13,32,33,-1,31
Ballymena,8855,6,7,4,15,25,49,-24,25
Glentoran,8855,7,6,6,10,24,32,-8,24
Dungannon,8855,8,2,4,16,14,47,-33,10
Crusaders,8856,1,16,7,3,62,31,31,55
Coleraine,8856,2,14,11,1,45,24,21,53
Glenavon,8856,3,9,10,7,54,45,9,37
Linfield,8856,4,10,6,10,38,37,1,36
Cliftonville,8856,5,9,5,12,33,32,1,32
Ballymena,8856,6,7,5,14,26,48,-22,26
Glentoran,8856,7,6,6,10,24,32,-8,24
Dungannon,8856,8,2,4,16,14,47,-33,10
Crusaders,8857,1,17,6,3,64,30,34,57
Coleraine,8857,2,14,10,2,45,26,19,52
Glenavon,8857,3,10,9,7,56,45,11,39
Linfield,8857,4,10,5,11,40,42,-2,35
Cliftonville,8857,5,10,4,12,38,34,4,34
Ballymena,8857,6,7,4,15,25,50,-25,25
Glentoran,8857,7,6,6,10,24,32,-8,24
Dungannon,8857,8,2,4,16,14,47,-33,10
Crusaders,8858,1,16,6,4,61,35,26,54
Coleraine,8858,2,14,10,2,43,23,20,52
Glenavon,8858,3,10,9,7,53,43,10,39
Linfield,8858,4,10,5,11,39,39,0,35
Cliftonville,8858,5,10,4,12,35,33,2,34
Ballymena,8858,6,8,4,14,30,47,-17,28
Glentoran,8858,7,6,6,10,24,32,-8,24
Dungannon,8858,8,2,4,16,14,47,-33,10
Crusaders,8859,1,17,6,3,63,31,32,57
Coleraine,8859,2,14,10,2,44,24,20,52
Glenavon,8859,3,10,9,7,54,44,10,39
Linfield,8859,4,11,5,10,41,36,5,38
Cliftonville,8859,5,9,4,13,32,35,-3,31
Ballymena,8859,6,7,4,15,26,49,-23,25
Glentoran,8859,7,6,6,10,24,32,-8,24
Dungannon,8859,8,2,4,16,14,47,-33,10
Crusaders,8860,1,16,6,4,61,33,28,54
Coleraine,8860,2,14,10,2,46,26,20,52
Glenavon,8860,3,10,9,7,56,46,10,39
Linfield,8860,4,11,5,10,39,37,2,38
Cliftonville,8860,5,9,4,13,33,33,0,31
Ballymena,8860,6,8,4,14,28,47,-19,28
Glentoran,8860,7,6,6,10,24,32,-8,24
Dungannon,8860,8,2,4,16,14,47,-33,10
Crusaders,8861,1,16,6,4,61,31,30,54
Coleraine,8861,2,14,10,2,43,24,19,52
Glenavon,8861,3,10,9,7,54,43,11,39
Linfield,8861,4,10,6,10,38,37,1,36
Cliftonville,8861,5,9,5,12,33,32,1,32
Ballymena,8861,6,8,4,14,26,47,-21,28
Glentoran,8861,7,6,6,10,24,32,-8,24
Dungannon,8861,8,2,4,16,14,47,-33,10
Crusaders,8862,1,17,6,3,63,31,32,57
Coleraine,8862,2,14,11,1,44,23,21,53
Glenavon,8862,3,9,10,7,53,44,9,37
Linfield,8862,4,10,5,11,37,37,0,35
Cliftonville,8862,5,10,4,12,33,31,2,34
Ballymena,8862,6,7,4,15,26,49,-23,25
Glentoran,8862,7,6,6,10,24,32,-8,24
Dungannon,8862,8,2,4,16,14,47,-33,10
Crusaders,8863,1,17,6,3,67,32,35,57
Coleraine,8863,2,15,10,1,44,22,22,55
Glenavon,8863,3,9,9,8,52,44,8,36
Linfield,8863,4,10,6,10,38,37,1,36
Cliftonville,8863,5,9,5,12,33,32,1,32
Ballymena,8863,6,7,4,15,27,53,-26,25
Glentoran,8863,7,6,6,10,24,32,-8,24
Dungannon,8863,8,2,4,16,14,47,-33,10
Crusaders,8864,1,16,6,4,62,38,24,54
Coleraine,8864,2,14,10,2,43,23,20,52
Glenavon,8864,3,10,9,7,53,43,10,39
Linfield,8864,4,10,6,10,39,38,1,36
Cliftonville,8864,5,9,5,12,34,33,1,32
Ballymena,8864,6,8,4,14,33,48,-15,28
Glentoran,8864,7,6,6,10,24,32,-8,24
Dungannon,8864,8,2,4,16,14,47,-33,10
Crusaders,8865,1,17,6,3,63,31,32,57
Coleraine,8865,2,14,11,1,43,22,21,53
Linfield,8865,3,11,5,10,40,36,4,38
Glenavon,8865,4,9,10,7,52,43,9,37
Cliftonville,8865,5,9,4,13,32,34,-2,31
Ballymena,8865,6,7,4,15,26,49,-23,25
Glentoran,8865,7,6,6,10,24,32,-8,24
Dungannon,8865,8,2,4,16,14,47,-33,10
Crusaders,8866,1,17,6,3,64,32,32,57
Coleraine,8866,2,14,10,2,44,25,19,52
Glenavon,8866,3,10,9,7,55,44,11,39
Linfield,8866,4,11,5,10,41,39,2,38
Cliftonville,8866,5,9,4,13,35,35,0,31
Ballymena,8866,6,7,4,15,27,50,-23,25
Glentoran,8866,7,6,6,10,24,32,-8,24
Dungannon,8866,8,2,4,16,14,47,-33,10
Crusaders,8867,1,17,6,3,63,31,32,57
Coleraine,8867,2,14,10,2,44,24,20,52
Glenavon,8867,3,10,9,7,54,44,10,39
Linfield,8867,4,11,5,10,41,38,3,38
Cliftonville,8867,5,9,4,13,34,35,-1,31
Ballymena,8867,6,7,4,15,26,49,-23,25
Glentoran,8867,7,6,6,10,24,32,-8,24
Dungannon,8867,8,2,4,16,14,47,-33,10
Crusaders,8868,1,17,6,3,65,31,34,57
Coleraine,8868,2,14,10,2,44,26,18,52
Glenavon,8868,3,10,9,7,56,44,12,39
Linfield,8868,4,11,5,10,40,36,4,38
Cliftonville,8868,5,9,4,13,32,34,-2,31
Ballymena,8868,6,7,4,15,26,51,-25,25
Glentoran,8868,7,6,6,10,24,32,-8,24
Dungannon,8868,8,2,4,16,14,47,-33,10
Coleraine,8869,1,15,10,1,45,23,22,55
Crusaders,8869,2,16,6,4,62,32,30,54
Linfield,8869,3,11,5,10,40,37,3,38
Glenavon,8869,4,9,9,8,53,45,8,36
Cliftonville,8869,5,9,4,13,33,34,-1,31
Ballymena,8869,6,8,4,14,27,48,-21,28
Glentoran,8869,7,6,6,10,24,32,-8,24
Dungannon,8869,8,2,4,16,14,47,-33,10
Crusaders,8870,1,17,6,3,64,31,33,57
Coleraine,8870,2,15,10,1,47,24,23,55
Glenavon,8870,3,9,9,8,54,47,7,36
Linfield,8870,4,10,6,10,37,36,1,36
Cliftonville,8870,5,9,5,12,32,31,1,32
Ballymena,8870,6,7,4,15,26,50,-24,25
Glentoran,8870,7,6,6,10,24,32,-8,24
Dungannon,8870,8,2,4,16,14,47,-33,10
Crusaders,8871,1,16,7,3,63,32,31,55
Coleraine,8871,2,14,10,2,44,25,19,52
Glenavon,8871,3,10,9,7,55,44,11,39
Linfield,8871,4,10,6,10,38,37,1,36
Cliftonville,8871,5,9,5,12,33,32,1,32
Ballymena,8871,6,7,5,14,27,49,-22,26
Glentoran,8871,7,6,6,10,24,32,-8,24
Dungannon,8871,8,2,4,16,14,47,-33,10
Crusaders,8872,1,17,6,3,64,31,33,57
Coleraine,8872,2,14,11,1,43,22,21,53
Linfield,8872,3,11,5,10,39,37,2,38
Glenavon,8872,4,9,10,7,52,43,9,37
Cliftonville,8872,5,9,4,13,33,33,0,31
Ballymena,8872,6,7,4,15,26,50,-24,25
Glentoran,8872,7,6,6,10,24,32,-8,24
Dungannon,8872,8,2,4,16,14,47,-33,10
Crusaders,8873,1,17,6,3,64,31,33,57
Coleraine,8873,2,15,10,1,45,23,22,55
Glenavon,8873,3,9,9,8,53,45,8,36
Linfield,8873,4,10,6,10,38,37,1,36
Cliftonville,8873,5,9,5,12,33,32,1,32
Ballymena,8873,6,7,4,15,26,50,-24,25
Glentoran,8873,7,6,6,10,24,32,-8,24
Dungannon,8873,8,2,4,16,14,47,-33,10
Crusaders,8874,1,16,6,4,62,32,30,54
Coleraine,8874,2,14,11,1,44,23,21,53
Linfield,8874,3,11,5,10,38,36,2,38
Glenavon,8874,4,9,10,7,53,44,9,37
Cliftonville,8874,5,9,4,13,32,32,0,31
Ballymena,8874,6,8,4,14,27,48,-21,28
Glentoran,8874,7,6,6,10,24,32,-8,24
Dungannon,8874,8,2,4,16,14,47,-33,10
Crusaders,8875,1,17,6,3,65,32,33,57
Coleraine,8875,2,15,10,1,44,22,22,55
Glenavon,8875,3,9,9,8,52,44,8,36
Linfield,8875,4,10,6,10,38,37,1,36
Cliftonville,8875,5,9,5,12,33,32,1,32
Ballymena,8875,6,7,4,15,27,51,-24,25
Glentoran,8875,7,6,6,10,24,32,-8,24
Dungannon,8875,8,2,4,16,14,47,-33,10
Crusaders,8876,1,16,7,3,62,31,31,55
Coleraine,8876,2,14,10,2,43,23,20,52
Glenavon,8876,3,10,9,7,53,43,10,39
Linfield,8876,4,11,5,10,40,37,3,38
Cliftonville,8876,5,9,4,13,33,34,-1,31
Ballymena,8876,6,7,5,14,26,48,-22,26
Glentoran,8876,7,6,6,10,24,32,-8,24
Dungannon,8876,8,2,4,16,14,47,-33,10
Crusaders,8877,1,17,6,3,64,30,34,57
Coleraine,8877,2,15,10,1,46,23,23,55
Linfield,8877,3,11,5,10,38,36,2,38
Glenavon,8877,4,9,9,8,53,46,7,36
Cliftonville,8877,5,9,4,13,32,32,0,31
Ballymena,8877,6,7,4,15,25,50,-25,25
Glentoran,8877,7,6,6,10,24,32,-8,24
Dungannon,8877,8,2,4,16,14,47,-33,10
Crusaders,8878,1,17,6,3,65,31,34,57
Coleraine,8878,2,14,10,2,44,24,20,52
Glenavon,8878,3,10,9,7,54,44,10,39
Linfield,8878,4,10,6,10,39,38,1,36
Cliftonville,8878,5,9,5,12,34,33,1,32
Ballymena,8878,6,7,4,15,26,51,-25,25
Glentoran,8878,7,6,6,10,24,32,-8,24
Dungannon,8878,8,2,4,16,14,47,-33,10
Coleraine,8879,1,15,10,1,46,24,22,55
Crusaders,8879,2,16,6,4,61,31,30,54
Linfield,8879,3,11,5,10,39,37,2,38
Glenavon,8879,4,9,9,8,54,46,8,36
Cliftonville,8879,5,9,4,13,33,33,0,31
Ballymena,8879,6,8,4,14,26,47,-21,28
Glentoran,8879,7,6,6,10,24,32,-8,24
Dungannon,8879,8,2,4,16,14,47,-33,10
Crusaders,8880,1,16,6,4,62,32,30,54
Coleraine,8880,2,14,10,2,44,25,19,52
Glenavon,8880,3,10,9,7,55,44,11,39
Linfield,8880,4,11,5,10,39,37,2,38
Cliftonville,8880,5,9,4,13,33,33,0,31
Ballymena,8880,6,8,4,14,27,48,-21,28
Glentoran,8880,7,6,6,10,24,32,-8,24
Dungannon,8880,8,2,4,16,14,47,-33,10
Crusaders,8881,1,16,6,4,61,31,30,54
Coleraine,8881,2,14,10,2,43,24,19,52
Glenavon,8881,3,10,9,7,54,43,11,39
Linfield,8881,4,11,5,10,39,37,2,38
Cliftonville,8881,5,9,4,13,33,33,0,31
Ballymena,8881,6,8,4,14,26,47,-21,28
Glentoran,8881,7,6,6,10,24,32,-8,24
Dungannon,8881,8,2,4,16,14,47,-33,10
Coleraine,8882,1,15,10,1,45,23,22,55
Crusaders,8882,2,16,6,4,61,31,30,54
Glenavon,8882,3,9,9,8,53,45,8,36
Linfield,8882,4,10,5,11,37,38,-1,35
Cliftonville,8882,5,10,4,12,34,31,3,34
Ballymena,8882,6,8,4,14,26,47,-21,28
Glentoran,8882,7,6,6,10,24,32,-8,24
Dungannon,8882,8,2,4,16,14,47,-33,10
Crusaders,8883,1,16,6,4,62,33,29,54
Coleraine,8883,2,14,11,1,43,22,21,53
Glenavon,8883,3,9,10,7,52,43,9,37
Linfield,8883,4,10,6,10,38,37,1,36
Cliftonville,8883,5,9,5,12,33,32,1,32
Ballymena,8883,6,8,4,14,28,48,-20,28
Glentoran,8883,7,6,6,10,24,32,-8,24
Dungannon,8883,8,2,4,16,14,47,-33,10
Crusaders,8884,1,17,6,3,64,31,33,57
Coleraine,8884,2,14,10,2,43,24,19,52
Glenavon,8884,3,10,9,7,54,43,11,39
Linfield,8884,4,11,5,10,39,37,2,38
Cliftonville,8884,5,9,4,13,33,33,0,31
Ballymena,8884,6,7,4,15,26,50,-24,25
Glentoran,8884,7,6,6,10,24,32,-8,24
Dungannon,8884,8,2,4,16,14,47,-33,10
Crusaders,8885,1,16,6,4,61,32,29,54
Coleraine,8885,2,14,11,1,44,23,21,53
Glenavon,8885,3,9,10,7,53,44,9,37
Linfield,8885,4,10,6,10,38,37,1,36
Cliftonville,8885,5,9,5,12,33,32,1,32
Ballymena,8885,6,8,4,14,27,47,-20,28
Glentoran,8885,7,6,6,10,24,32,-8,24
Dungannon,8885,8,2,4,16,14,47,-33,10
Crusaders,8886,1,17,6,3,62,30,32,57
Coleraine,8886,2,15,10,1,47,23,24,55
Glenavon,8886,3,9,9,8,53,47,6,36
Linfield,8886,4,10,5,11,37,37,0,35
Cliftonville,8886,5,10,4,12,33,31,2,34
Ballymena,8886,6,7,4,15,25,48,-23,25
Glentoran,8886,7,6,6,10,24,32,-8,24
Dungannon,8886,8,2,4,16,14,47,-33,10
Crusaders,8887,1,16,6,4,63,34,29,54
Coleraine,8887,2,14,10,2,45,25,20,52
Glenavon,8887,3,10,9,7,55,45,10,39
Linfield,8887,4,10,5,11,39,40,-1,35
Cliftonville,8887,5,10,4,12,36,33,3,34
Ballymena,8887,6,8,4,14,29,49,-20,28
Glentoran,8887,7,6,6,10,24,32,-8,24
Dungannon,8887,8,2,4,16,14,47,-33,10
Coleraine,8888,1,15,10,1,45,22,23,55
Crusaders,8888,2,16,6,4,62,33,29,54
Glenavon,8888,3,9,9,8,52,45,7,36
Linfield,8888,4,10,5,11,38,38,0,35
Cliftonville,8888,5,10,4,12,34,32,2,34
Ballymena,8888,6,8,4,14,28,48,-20,28
Glentoran,8888,7,6,6,10,24,32,-8,24
Dungannon,8888,8,2,4,16,14,47,-33,10
Crusaders,8889,1,16,6,4,62,33,29,54
Coleraine,8889,2,14,11,1,44,23,21,53
Glenavon,8889,3,9,10,7,53,44,9,37
Linfield,8889,4,10,6,10,38,37,1,36
Cliftonville,8889,5,9,5,12,33,32,1,32
Ballymena,8889,6,8,4,14,28,48,-20,28
Glentoran,8889,7,6,6,10,24,32,-8,24
Dungannon,8889,8,2,4,16,14,47,-33,10
Crusaders,8890,1,17,6,3,62,30,32,57
Coleraine,8890,2,15,10,1,44,22,22,55
Glenavon,8890,3,9,9,8,52,44,8,36
Linfield,8890,4,10,6,10,40,39,1,36
Cliftonville,8890,5,9,5,12,35,34,1,32
Ballymena,8890,6,7,4,15,25,48,-23,25
Glentoran,8890,7,6,6,10,24,32,-8,24
Dungannon,8890,8,2,4,16,14,47,-33,10
Crusaders,8891,1,17,6,3,63,30,33,57
Coleraine,8891,2,15,10,1,46,23,23,55
Linfield,8891,3,11,5,10,39,36,3,38
Glenavon,8891,4,9,9,8,53,46,7,36
Cliftonville,8891,5,9,4,13,32,33,-1,31
Ballymena,8891,6,7,4,15,25,49,-24,25
Glentoran,8891,7,6,6,10,24,32,-8,24
Dungannon,8891,8,2,4,16,14,47,-33,10
Crusaders,8892,1,16,7,3,64,33,31,55
Coleraine,8892,2,14,10,2,44,27,17,52
Glenavon,8892,3,10,9,7,57,44,13,39
Linfield,8892,4,10,5,11,37,37,0,35
Cliftonville,8892,5,10,4,12,33,31,2,34
Ballymena,8892,6,7,5,14,28,50,-22,26
Glentoran,8892,7,6,6,10,24,32,-8,24
Dungannon,8892,8,2,4,16,14,47,-33,10
Crusaders,8893,1,16,6,4,61,32,29,54
Coleraine,8893,2,14,10,2,44,25,19,52
Glenavon,8893,3,10,9,7,55,44,11,39
Linfield,8893,4,10,5,11,38,38,0,35
Cliftonville,8893,5,10,4,12,34,32,2,34
Ballymena,8893,6,8,4,14,27,47,-20,28
Glentoran,8893,7,6,6,10,24,32,-8,24
Dungannon,8893,8,2,4,16,14,47,-33,10
Crusaders,8894,1,17,6,3,65,31,34,57
Coleraine,8894,2,15,10,1,45,23,22,55
Glenavon,8894,3,9,9,8,53,45,8,36
Linfield,8894,4,10,5,11,37,38,-1,35
Cliftonville,8894,5,10,4,12,34,31,3,34
Ballymena,8894,6,7,4,15,26,51,-25,25
Glentoran,8894,7,6,6,10,24,32,-8,24
Dungannon,8894,8,2,4,16,14,47,-33,10
Crusaders,8895,1,17,6,3,64,30,34,57
Coleraine,8895,2,14,10,2,43,24,19,52
Glenavon,8895,3,10,9,7,54,43,11,39
Linfield,8895,4,10,5,11,37,38,-1,35
Cliftonville,8895,5,10,4,12,34,31,3,34
Ballymena,8895,6,7,4,15,25,50,-25,25
Glentoran,8895,7,6,6,10,24,32,-8,24
Dungannon,8895,8,2,4,16,14,47,-33,10
Crusaders,8896,1,16,7,3,64,33,31,55
Coleraine,8896,2,14,10,2,44,25,19,52
Glenavon,8896,3,10,9,7,55,44,11,39
Linfield,8896,4,11,5,10,41,38,3,38
Cliftonville,8896,5,9,4,13,34,35,-1,31
Ballymena,8896,6,7,5,14,28,50,-22,26
Glentoran,8896,7,6,6,10,24,32,-8,24
Dungannon,8896,8,2,4,16,14,47,-33,10
Crusaders,8897,1,16,6,4,62,33,29,54
Coleraine,8897,2,14,10,2,44,25,19,52
Glenavon,8897,3,10,9,7,55,44,11,39
Linfield,8897,4,11,5,10,38,36,2,38
Cliftonville,8897,5,9,4,13,32,32,0,31
Ballymena,8897,6,8,4,14,28,48,-20,28
Glentoran,8897,7,6,6,10,24,32,-8,24
Dungannon,8897,8,2,4,16,14,47,-33,10
Crusaders,8898,1,16,6,4,61,31,30,54
Coleraine,8898,2,14,10,2,43,25,18,52
Glenavon,8898,3,10,9,7,55,43,12,39
Linfield,8898,4,11,5,10,38,36,2,38
Cliftonville,8898,5,9,4,13,32,32,0,31
Ballymena,8898,6,8,4,14,26,47,-21,28
Glentoran,8898,7,6,6,10,24,32,-8,24
Dungannon,8898,8,2,4,16,14,47,-33,10
Crusaders,8899,1,17,6,3,64,31,33,57
Coleraine,8899,2,14,10,2,43,26,17,52
Glenavon,8899,3,10,9,7,56,43,13,39
Linfield,8899,4,11,5,10,39,36,3,38
Cliftonville,8899,5,9,4,13,32,33,-1,31
Ballymena,8899,6,7,4,15,26,50,-24,25
Glentoran,8899,7,6,6,10,24,32,-8,24
Dungannon,8899,8,2,4,16,14,47,-33,10
Crusaders,8900,1,17,6,3,62,30,32,57
Coleraine,8900,2,15,10,1,46,24,22,55
Linfield,8900,3,11,5,10,38,36,2,38
Glenavon,8900,4,9,9,8,54,46,8,36
Cliftonville,8900,5,9,4,13,32,32,0,31
Ballymena,8900,6,7,4,15,25,48,-23,25
Glentoran,8900,7,6,6,10,24,32,-8,24
Dungannon,8900,8,2,4,16,14,47,-33,10
Crusaders,8901,1,17,6,3,65,32,33,57
Coleraine,8901,2,14,11,1,43,22,21,53
Linfield,8901,3,11,5,10,39,37,2,38
Glenavon,8901,4,9,10,7,52,43,9,37
Cliftonville,8901,5,9,4,13,33,33,0,31
Ballymena,8901,6,7,4,15,27,51,-24,25
Glentoran,8901,7,6,6,10,24,32,-8,24
Dungannon,8901,8,2,4,16,14,47,-33,10
Coleraine,8902,1,15,10,1,45,22,23,55
Crusaders,8902,2,16,6,4,62,32,30,54
Glenavon,8902,3,9,9,8,52,45,7,36
Linfield,8902,4,10,5,11,37,38,-1,35
Cliftonville,8902,5,10,4,12,34,31,3,34
Ballymena,8902,6,8,4,14,27,48,-21,28
Glentoran,8902,7,6,6,10,24,32,-8,24
Dungannon,8902,8,2,4,16,14,47,-33,10
Crusaders,8903,1,16,7,3,62,31,31,55
Coleraine,8903,2,15,10,1,44,22,22,55
Glenavon,8903,3,9,9,8,52,44,8,36
Linfield,8903,4,10,6,10,37,36,1,36
Cliftonville,8903,5,9,5,12,32,31,1,32
Ballymena,8903,6,7,5,14,26,48,-22,26
Glentoran,8903,7,6,6,10,24,32,-8,24
Dungannon,8903,8,2,4,16,14,47,-33,10
Crusaders,8904,1,16,6,4,63,33,30,54
Coleraine,8904,2,14,10,2,45,27,18,52
Glenavon,8904,3,10,9,7,57,45,12,39
Linfield,8904,4,11,5,10,38,36,2,38
Cliftonville,8904,5,9,4,13,32,32,0,31
Ballymena,8904,6,8,4,14,28,49,-21,28
Glentoran,8904,7,6,6,10,24,32,-8,24
Dungannon,8904,8,2,4,16,14,47,-33,10
Crusaders,8905,1,17,6,3,66,34,32,57
Coleraine,8905,2,14,10,2,43,23,20,52
Glenavon,8905,3,10,9,7,53,43,10,39
Linfield,8905,4,11,5,10,38,36,2,38
Cliftonville,8905,5,9,4,13,32,32,0,31
Ballymena,8905,6,7,4,15,29,52,-23,25
Glentoran,8905,7,6,6,10,24,32,-8,24
Dungannon,8905,8,2,4,16,14,47,-33,10
Crusaders,8906,1,16,6,4,62,33,29,54
Coleraine,8906,2,14,10,2,43,23,20,52
Glenavon,8906,3,10,9,7,53,43,10,39
Linfield,8906,4,11,5,10,38,36,2,38
Cliftonville,8906,5,9,4,13,32,32,0,31
Ballymena,8906,6,8,4,14,28,48,-20,28
Glentoran,8906,7,6,6,10,24,32,-8,24
Dungannon,8906,8,2,4,16,14,47,-33,10
Crusaders,8907,1,17,6,3,64,31,33,57
Coleraine,8907,2,14,10,2,43,23,20,52
Glenavon,8907,3,10,9,7,53,43,10,39
Linfield,8907,4,11,5,10,41,37,4,38
Cliftonville,8907,5,9,4,13,33,35,-2,31
Ballymena,8907,6,7,4,15,26,50,-24,25
Glentoran,8907,7,6,6,10,24,32,-8,24
Dungannon,8907,8,2,4,16,14,47,-33,10
Crusaders,8908,1,16,6,4,61,31,30,54
Coleraine,8908,2,14,10,2,43,25,18,52
Glenavon,8908,3,10,9,7,55,43,12,39
Linfield,8908,4,11,5,10,38,36,2,38
Cliftonville,8908,5,9,4,13,32,32,0,31
Ballymena,8908,6,8,4,14,26,47,-21,28
Glentoran,8908,7,6,6,10,24,32,-8,24
Dungannon,8908,8,2,4,16,14,47,-33,10
Crusaders,8909,1,16,7,3,63,32,31,55
Coleraine,8909,2,14,10,2,44,26,18,52
Glenavon,8909,3,10,9,7,56,44,12,39
Linfield,8909,4,11,5,10,39,36,3,38
Cliftonville,8909,5,9,4,13,32,33,-1,31
Ballymena,8909,6,7,5,14,27,49,-22,26
Glentoran,8909,7,6,6,10,24,32,-8,24
Dungannon,8909,8,2,4,16,14,47,-33,10
Crusaders,8910,1,17,6,3,63,31,32,57
Coleraine,8910,2,14,11,1,45,24,21,53
Linfield,8910,3,11,5,10,39,36,3,38
Glenavon,8910,4,9,10,7,54,45,9,37
Cliftonville,8910,5,9,4,13,32,33,-1,31
Ballymena,8910,6,7,4,15,26,49,-23,25
Glentoran,8910,7,6,6,10,24,32,-8,24
Dungannon,8910,8,2,4,16,14,47,-33,10
Crusaders,8911,1,16,7,3,61,30,31,55
Coleraine,8911,2,14,10,2,45,25,20,52
Glenavon,8911,3,10,9,7,55,45,10,39
Linfield,8911,4,10,5,11,37,39,-2,35
Cliftonville,8911,5,10,4,12,35,31,4,34
Ballymena,8911,6,7,5,14,25,47,-22,26
Glentoran,8911,7,6,6,10,24,32,-8,24
Dungannon,8911,8,2,4,16,14,47,-33,10
Coleraine,8912,1,15,10,1,44,22,22,55
Crusaders,8912,2,16,6,4,61,31,30,54
Linfield,8912,3,11,5,10,39,37,2,38
Glenavon,8912,4,9,9,8,52,44,8,36
Cliftonville,8912,5,9,4,13,33,33,0,31
Ballymena,8912,6,8,4,14,26,47,-21,28
Glentoran,8912,7,6,6,10,24,32,-8,24
Dungannon,8912,8,2,4,16,14,47,-33,10
Crusaders,8913,1,17,6,3,63,31,32,57
Coleraine,8913,2,14,11,1,44,23,21,53
Linfield,8913,3,11,5,10,40,36,4,38
Glenavon,8913,4,9,10,7,53,44,9,37
Cliftonville,8913,5,9,4,13,32,34,-2,31
Ballymena,8913,6,7,4,15,26,49,-23,25
Glentoran,8913,7,6,6,10,24,32,-8,24
Dungannon,8913,8,2,4,16,14,47,-33,10
Crusaders,8914,1,16,6,4,61,31,30,54
Coleraine,8914,2,14,10,2,44,26,18,52
Glenavon,8914,3,10,9,7,56,44,12,39
Linfield,8914,4,10,5,11,39,39,0,35
Cliftonville,8914,5,10,4,12,35,33,2,34
Ballymena,8914,6,8,4,14,26,47,-21,28
Glentoran,8914,7,6,6,10,24,32,-8,24
Dungannon,8914,8,2,4,16,14,47,-33,10
Crusaders,8915,1,17,6,3,66,30,36,57
Coleraine,8915,2,15,10,1,44,22,22,55
Linfield,8915,3,11,5,10,39,36,3,38
Glenavon,8915,4,9,9,8,52,44,8,36
Cliftonville,8915,5,9,4,13,32,33,-1,31
Ballymena,8915,6,7,4,15,25,52,-27,25
Glentoran,8915,7,6,6,10,24,32,-8,24
Dungannon,8915,8,2,4,16,14,47,-33,10
Crusaders,8916,1,16,7,3,63,32,31,55
Coleraine,8916,2,14,11,1,45,24,21,53
Linfield,8916,3,11,5,10,39,36,3,38
Glenavon,8916,4,9,10,7,54,45,9,37
Cliftonville,8916,5,9,4,13,32,33,-1,31
Ballymena,8916,6,7,5,14,27,49,-22,26
Glentoran,8916,7,6,6,10,24,32,-8,24
Dungannon,8916,8,2,4,16,14,47,-33,10
Coleraine,8917,1,15,10,1,46,23,23,55
Crusaders,8917,2,16,6,4,62,33,29,54
Linfield,8917,3,11,5,10,40,37,3,38
Glenavon,8917,4,9,9,8,53,46,7,36
Cliftonville,8917,5,9,4,13,33,34,-1,31
Ballymena,8917,6,8,4,14,28,48,-20,28
Glentoran,8917,7,6,6,10,24,32,-8,24
Dungannon,8917,8,2,4,16,14,47,-33,10
Crusaders,8918,1,17,6,3,64,32,32,57
Coleraine,8918,2,14,10,2,43,25,18,52
Glenavon,8918,3,10,9,7,55,43,12,39
Linfield,8918,4,11,5,10,40,37,3,38
Cliftonville,8918,5,9,4,13,33,34,-1,31
Ballymena,8918,6,7,4,15,27,50,-23,25
Glentoran,8918,7,6,6,10,24,32,-8,24
Dungannon,8918,8,2,4,16,14,47,-33,10
Crusaders,8919,1,16,6,4,62,32,30,54
Coleraine,8919,2,14,10,2,44,25,19,52
Glenavon,8919,3,10,9,7,55,44,11,39
Linfield,8919,4,11,5,10,40,37,3,38
Cliftonville,8919,5,9,4,13,33,34,-1,31
Ballymena,8919,6,8,4,14,27,48,-21,28
Glentoran,8919,7,6,6,10,24,32,-8,24
Dungannon,8919,8,2,4,16,14,47,-33,10
Crusaders,8920,1,17,6,3,65,32,33,57
Coleraine,8920,2,15,10,1,45,23,22,55
Glenavon,8920,3,9,9,8,53,45,8,36
Linfield,8920,4,10,6,10,39,38,1,36
Cliftonville,8920,5,9,5,12,34,33,1,32
Ballymena,8920,6,7,4,15,27,51,-24,25
Glentoran,8920,7,6,6,10,24,32,-8,24
Dungannon,8920,8,2,4,16,14,47,-33,10
Crusaders,8921,1,16,6,4,62,32,30,54
Coleraine,8921,2,14,10,2,43,25,18,52
Glenavon,8921,3,10,9,7,55,43,12,39
Linfield,8921,4,10,5,11,38,38,0,35
Cliftonville,8921,5,10,4,12,34,32,2,34
Ballymena,8921,6,8,4,14,27,48,-21,28
Glentoran,8921,7,6,6,10,24,32,-8,24
Dungannon,8921,8,2,4,16,14,47,-33,10
Crusaders,8922,1,17,6,3,62,30,32,57
Coleraine,8922,2,14,10,2,44,24,20,52
Glenavon,8922,3,10,9,7,54,44,10,39
Linfield,8922,4,11,5,10,38,36,2,38
Cliftonville,8922,5,9,4,13,32,32,0,31
Ballymena,8922,6,7,4,15,25,48,-23,25
Glentoran,8922,7,6,6,10,24,32,-8,24
Dungannon,8922,8,2,4,16,14,47,-33,10
Crusaders,8923,1,17,6,3,63,30,33,57
Coleraine,8923,2,14,11,1,45,24,21,53
Glenavon,8923,3,9,10,7,54,45,9,37
Linfield,8923,4,10,5,11,37,37,0,35
Cliftonville,8923,5,10,4,12,33,31,2,34
Ballymena,8923,6,7,4,15,25,49,-24,25
Glentoran,8923,7,6,6,10,24,32,-8,24
Dungannon,8923,8,2,4,16,14,47,-33,10
Crusaders,8924,1,17,6,3,62,30,32,57
Coleraine,8924,2,14,10,2,43,23,20,52
Glenavon,8924,3,10,9,7,53,43,10,39
Linfield,8924,4,10,6,10,38,37,1,36
Cliftonville,8924,5,9,5,12,33,32,1,32
Ballymena,8924,6,7,4,15,25,48,-23,25
Glentoran,8924,7,6,6,10,24,32,-8,24
Dungannon,8924,8,2,4,16,14,47,-33,10
Crusaders,8925,1,17,6,3,64,30,34,57
Coleraine,8925,2,14,10,2,43,24,19,52
Glenavon,8925,3,10,9,7,54,43,11,39
Linfield,8925,4,11,5,10,40,37,3,38
Cliftonville,8925,5,9,4,13,33,34,-1,31
Ballymena,8925,6,7,4,15,25,50,-25,25
Glentoran,8925,7,6,6,10,24,32,-8,24
Dungannon,8925,8,2,4,16,14,47,-33,10
Crusaders,8926,1,17,6,3,64,32,32,57
Coleraine,8926,2,14,10,2,44,24,20,52
Glenavon,8926,3,10,9,7,54,44,10,39
Linfield,8926,4,10,6,10,38,37,1,36
Cliftonville,8926,5,9,5,12,33,32,1,32
Ballymena,8926,6,7,4,15,27,50,-23,25
Glentoran,8926,7,6,6,10,24,32,-8,24
Dungannon,8926,8,2,4,16,14,47,-33,10
Crusaders,8927,1,17,6,3,63,31,32,57
Coleraine,8927,2,15,10,1,44,22,22,55
Glenavon,8927,3,9,9,8,52,44,8,36
Linfield,8927,4,10,6,10,38,37,1,36
Cliftonville,8927,5,9,5,12,33,32,1,32
Ballymena,8927,6,7,4,15,26,49,-23,25
Glentoran,8927,7,6,6,10,24,32,-8,24
Dungannon,8927,8,2,4,16,14,47,-33,10
Crusaders,8928,1,16,6,4,62,33,29,54
Coleraine,8928,2,14,10,2,45,25,20,52
Glenavon,8928,3,10,9,7,55,45,10,39
Linfield,8928,4,10,6,10,38,37,1,36
Cliftonville,8928,5,9,5,12,33,32,1,32
Ballymena,8928,6,8,4,14,28,48,-20,28
Glentoran,8928,7,6,6,10,24,32,-8,24
Dungannon,8928,8,2,4,16,14,47,-33,10
Crusaders,8929,1,16,6,4,63,34,29,54
Coleraine,8929,2,14,11,1,43,22,21,53
Glenavon,8929,3,9,10,7,52,43,9,37
Linfield,8929,4,10,5,11,38,38,0,35
Cliftonville,8929,5,10,4,12,34,32,2,34
Ballymena,8929,6,8,4,14,29,49,-20,28
Glentoran,8929,7,6,6,10,24,32,-8,24
Dungannon,8929,8,2,4,16,14,47,-33,10
Crusaders,8930,1,16,7,3,63,32,31,55
Coleraine,8930,2,15,10,1,45,22,23,55
Glenavon,8930,3,9,9,8,52,45,7,36
Linfield,8930,4,10,5,11,39,39,0,35
Cliftonville,8930,5,10,4,12,35,33,2,34
Ballymena,8930,6,7,5,14,27,49,-22,26
Glentoran,8930,7,6,6,10,24,32,-8,24
Dungannon,8930,8,2,4,16,14,47,-33,10
Crusaders,8931,1,16,6,4,61,32,29,54
Coleraine,8931,2,14,10,2,44,24,20,52
Glenavon,8931,3,10,9,7,54,44,10,39
Linfield,8931,4,10,6,10,38,37,1,36
Cliftonville,8931,5,9,5,12,33,32,1,32
Ballymena,8931,6,8,4,14,27,47,-20,28
Glentoran,8931,7,6,6,10,24,32,-8,24
Dungannon,8931,8,2,4,16,14,47,-33,10
Crusaders,8932,1,17,6,3,64,32,32,57
Coleraine,8932,2,14,10,2,44,24,20,52
Glenavon,8932,3,10,9,7,54,44,10,39
Linfield,8932,4,10,6,10,38,37,1,36
Cliftonville,8932,5,9,5,12,33,32,1,32
Ballymena,8932,6,7,4,15,27,50,-23,25
Glentoran,8932,7,6,6,10,24,32,-8,24
Dungannon,8932,8,2,4,16,14,47,-33,10
Crusaders,8933,1,17,6,3,63,30,33,57
Coleraine,8933,2,15,10,1,46,24,22,55
Linfield,8933,3,11,5,10,40,36,4,38
Glenavon,8933,4,9,9,8,54,46,8,36
Cliftonville,8933,5,9,4,13,32,34,-2,31
Ballymena,8933,6,7,4,15,25,49,-24,25
Glentoran,8933,7,6,6,10,24,32,-8,24
Dungannon,8933,8,2,4,16,14,47,-33,10
Crusaders,8934,1,16,6,4,64,34,30,54
Coleraine,8934,2,14,10,2,45,26,19,52
Glenavon,8934,3,10,9,7,56,45,11,39
Linfield,8934,4,11,5,10,38,36,2,38
Cliftonville,8934,5,9,4,13,32,32,0,31
Ballymena,8934,6,8,4,14,29,50,-21,28
Glentoran,8934,7,6,6,10,24,32,-8,24
Dungannon,8934,8,2,4,16,14,47,-33,10
Crusaders,8935,1,16,7,3,62,31,31,55
Coleraine,8935,2,15,10,1,44,22,22,55
Glenavon,8935,3,9,9,8,52,44,8,36
Linfield,8935,4,10,6,10,37,36,1,36
Cliftonville,8935,5,9,5,12,32,31,1,32
Ballymena,8935,6,7,5,14,26,48,-22,26
Glentoran,8935,7,6,6,10,24,32,-8,24
Dungannon,8935,8,2,4,16,14,47,-33,10
Crusaders,8936,1,17,6,3,64,32,32,57
Coleraine,8936,2,15,10,1,44,22,22,55
Glenavon,8936,3,9,9,8,52,44,8,36
Linfield,8936,4,10,5,11,38,38,0,35
Cliftonville,8936,5,10,4,12,34,32,2,34
Ballymena,8936,6,7,4,15,27,50,-23,25
Glentoran,8936,7,6,6,10,24,32,-8,24
Dungannon,8936,8,2,4,16,14,47,-33,10
Coleraine,8937,1,15,10,1,44,22,22,55
Crusaders,8937,2,16,6,4,61,34,27,54
Linfield,8937,3,11,5,10,39,37,2,38
Glenavon,8937,4,9,9,8,52,44,8,36
Cliftonville,8937,5,9,4,13,33,33,0,31
Ballymena,8937,6,8,4,14,29,47,-18,28
Glentoran,8937,7,6,6,10,24,32,-8,24
Dungannon,8937,8,2,4,16,14,47,-33,10
Crusaders,8938,1,17,6,3,64,31,33,57
Coleraine,8938,2,14,10,2,43,23,20,52
Glenavon,8938,3,10,9,7,53,43,10,39
Linfield,8938,4,11,5,10,40,37,3,38
Cliftonville,8938,5,9,4,13,33,34,-1,31
Ballymena,8938,6,7,4,15,26,50,-24,25
Glentoran,8938,7,6,6,10,24,32,-8,24
Dungannon,8938,8,2,4,16,14,47,-33,10
Crusaders,8939,1,17,6,3,62,30,32,57
Coleraine,8939,2,14,11,1,46,25,21,53
Glenavon,8939,3,9,10,7,55,46,9,37
Linfield,8939,4,10,6,10,37,36,1,36
Cliftonville,8939,5,9,5,12,32,31,1,32
Ballymena,8939,6,7,4,15,25,48,-23,25
Glentoran,8939,7,6,6,10,24,32,-8,24
Dungannon,8939,8,2,4,16,14,47,-33,10
Crusaders,8940,1,16,7,3,63,32,31,55
Coleraine,8940,2,14,11,1,44,23,21,53
Glenavon,8940,3,9,10,7,53,44,9,37
Linfield,8940,4,10,5,11,38,38,0,35
Cliftonville,8940,5,10,4,12,34,32,2,34
Ballymena,8940,6,7,5,14,27,49,-22,26
Glentoran,8940,7,6,6,10,24,32,-8,24
Dungannon,8940,8,2,4,16,14,47,-33,10
Crusaders,8941,1,17,6,3,65,31,34,57
Coleraine,8941,2,15,10,1,44,22,22,55
Linfield,8941,3,11,5,10,39,37,2,38
Glenavon,8941,4,9,9,8,52,44,8,36
Cliftonville,8941,5,9,4,13,33,33,0,31
Ballymena,8941,6,7,4,15,26,51,-25,25
Glentoran,8941,7,6,6,10,24,32,-8,24
Dungannon,8941,8,2,4,16,14,47,-33,10
Crusaders,8942,1,16,6,4,62,32,30,54
Coleraine,8942,2,14,10,2,44,25,19,52
Glenavon,8942,3,10,9,7,55,44,11,39
Linfield,8942,4,11,5,10,40,36,4,38
Cliftonville,8942,5,9,4,13,32,34,-2,31
Ballymena,8942,6,8,4,14,27,48,-21,28
Glentoran,8942,7,6,6,10,24,32,-8,24
Dungannon,8942,8,2,4,16,14,47,-33,10
Coleraine,8943,1,15,10,1,45,23,22,55
Crusaders,8943,2,16,6,4,62,32,30,54
Glenavon,8943,3,9,9,8,53,45,8,36
Linfield,8943,4,10,6,10,37,36,1,36
Cliftonville,8943,5,9,5,12,32,31,1,32
Ballymena,8943,6,8,4,14,27,48,-21,28
Glentoran,8943,7,6,6,10,24,32,-8,24
Dungannon,8943,8,2,4,16,14,47,-33,10
Crusaders,8944,1,17,6,3,62,30,32,57
Coleraine,8944,2,14,10,2,43,24,19,52
Glenavon,8944,3,10,9,7,54,43,11,39
Linfield,8944,4,11,5,10,40,37,3,38
Cliftonville,8944,5,9,4,13,33,34,-1,31
Ballymena,8944,6,7,4,15,25,48,-23,25
Glentoran,8944,7,6,6,10,24,32,-8,24
Dungannon,8944,8,2,4,16,14,47,-33,10
Crusaders,8945,1,16,6,4,63,33,30,54
Coleraine,8945,2,14,10,2,43,25,18,52
Glenavon,8945,3,10,9,7,55,43,12,39
Linfield,8945,4,11,5,10,40,37,3,38
Cliftonville,8945,5,9,4,13,33,34,-1,31
Ballymena,8945,6,8,4,14,28,49,-21,28
Glentoran,8945,7,6,6,10,24,32,-8,24
Dungannon,8945,8,2,4,16,14,47,-33,10
Crusaders,8946,1,17,6,3,64,30,34,57
Coleraine,8946,2,15,10,1,45,22,23,55
Glenavon,8946,3,9,9,8,52,45,7,36
Linfield,8946,4,10,6,10,38,37,1,36
Cliftonville,8946,5,9,5,12,33,32,1,32
Ballymena,8946,6,7,4,15,25,50,-25,25
Glentoran,8946,7,6,6,10,24,32,-8,24
Dungannon,8946,8,2,4,16,14,47,-33,10
Crusaders,8947,1,17,6,3,64,30,34,57
Coleraine,8947,2,14,10,2,44,24,20,52
Glenavon,8947,3,10,9,7,54,44,10,39
Linfield,8947,4,10,6,10,37,36,1,36
Cliftonville,8947,5,9,5,12,32,31,1,32
Ballymena,8947,6,7,4,15,25,50,-25,25
Glentoran,8947,7,6,6,10,24,32,-8,24
Dungannon,8947,8,2,4,16,14,47,-33,10
Coleraine,8948,1,15,10,1,45,22,23,55
Crusaders,8948,2,16,6,4,61,32,29,54
Glenavon,8948,3,9,9,8,52,45,7,36
Linfield,8948,4,10,6,10,37,36,1,36
Cliftonville,8948,5,9,5,12,32,31,1,32
Ballymena,8948,6,8,4,14,27,47,-20,28
Glentoran,8948,7,6,6,10,24,32,-8,24
Dungannon,8948,8,2,4,16,14,47,-33,10
Crusaders,8949,1,17,6,3,64,31,33,57
Coleraine,8949,2,14,10,2,44,24,20,52
Glenavon,8949,3,10,9,7,54,44,10,39
Linfield,8949,4,11,5,10,39,37,2,38
Cliftonville,8949,5,9,4,13,33,33,0,31
Ballymena,8949,6,7,4,15,26,50,-24,25
Glentoran,8949,7,6,6,10,24,32,-8,24
Dungannon,8949,8,2,4,16,14,47,-33,10
Crusaders,8950,1,17,6,3,62,30,32,57
Coleraine,8950,2,14,10,2,43,23,20,52
Glenavon,8950,3,10,9,7,53,43,10,39
Linfield,8950,4,11,5,10,39,36,3,38
Cliftonville,8950,5,9,4,13,32,33,-1,31
Ballymena,8950,6,7,4,15,25,48,-23,25
Glentoran,8950,7,6,6,10,24,32,-8,24
Dungannon,8950,8,2,4,16,14,47,-33,10
Crusaders,8951,1,16,6,4,61,31,30,54
Coleraine,8951,2,14,10,2,43,23,20,52
Glenavon,8951,3,10,9,7,53,43,10,39
Linfield,8951,4,11,5,10,39,36,3,38
Cliftonville,8951,5,9,4,13,32,33,-1,31
Ballymena,8951,6,8,4,14,26,47,-21,28
Glentoran,8951,7,6,6,10,24,32,-8,24
Dungannon,8951,8,2,4,16,14,47,-33,10
Crusaders,8952,1,17,6,3,64,31,33,57
Coleraine,8952,2,14,10,2,44,25,19,52
Glenavon,8952,3,10,9,7,55,44,11,39
Linfield,8952,4,10,5,11,38,38,0,35
Cliftonville,8952,5,10,4,12,34,32,2,34
Ballymena,8952,6,7,4,15,26,50,-24,25
Glentoran,8952,7,6,6,10,24,32,-8,24
Dungannon,8952,8,2,4,16,14,47,-33,10
Crusaders,8953,1,17,6,3,65,30,35,57
Coleraine,8953,2,15,10,1,45,23,22,55
Linfield,8953,3,11,5,10,39,37,2,38
Glenavon,8953,4,9,9,8,53,45,8,36
Cliftonville,8953,5,9,4,13,33,33,0,31
Ballymena,8953,6,7,4,15,25,51,-26,25
Glentoran,8953,7,6,6,10,24,32,-8,24
Dungannon,8953,8,2,4,16,14,47,-33,10
Crusaders,8954,1,16,6,4,63,33,30,54
Coleraine,8954,2,14,10,2,45,25,20,52
Glenavon,8954,3,10,9,7,55,45,10,39
Linfield,8954,4,10,6,10,37,36,1,36
Cliftonville,8954,5,9,5,12,32,31,1,32
Ballymena,8954,6,8,4,14,28,49,-21,28
Glentoran,8954,7,6,6,10,24,32,-8,24
Dungannon,8954,8,2,4,16,14,47,-33,10
Crusaders,8955,1,17,6,3,65,32,33,57
Coleraine,8955,2,15,10,1,48,23,25,55
Linfield,8955,3,11,5,10,39,37,2,38
Glenavon,8955,4,9,9,8,53,48,5,36
Cliftonville,8955,5,9,4,13,33,33,0,31
Ballymena,8955,6,7,4,15,27,51,-24,25
Glentoran,8955,7,6,6,10,24,32,-8,24
Dungannon,8955,8,2,4,16,14,47,-33,10
Coleraine,8956,1,15,10,1,47,23,24,55
Crusaders,8956,2,16,6,4,62,34,28,54
Linfield,8956,3,11,5,10,38,36,2,38
Glenavon,8956,4,9,9,8,53,47,6,36
Cliftonville,8956,5,9,4,13,32,32,0,31
Ballymena,8956,6,8,4,14,29,48,-19,28
Glentoran,8956,7,6,6,10,24,32,-8,24
Dungannon,8956,8,2,4,16,14,47,-33,10
Crusaders,8957,1,16,7,3,63,32,31,55
Coleraine,8957,2,14,10,2,44,24,20,52
Glenavon,8957,3,10,9,7,54,44,10,39
Linfield,8957,4,10,5,11,37,37,0,35
Cliftonville,8957,5,10,4,12,33,31,2,34
Ballymena,8957,6,7,5,14,27,49,-22,26
Glentoran,8957,7,6,6,10,24,32,-8,24
Dungannon,8957,8,2,4,16,14,47,-33,10
Crusaders,8958,1,17,6,3,63,30,33,57
Coleraine,8958,2,14,11,1,46,25,21,53
Linfield,8958,3,11,5,10,39,36,3,38
Glenavon,8958,4,9,10,7,55,46,9,37
Cliftonville,8958,5,9,4,13,32,33,-1,31
Ballymena,8958,6,7,4,15,25,49,-24,25
Glentoran,8958,7,6,6,10,24,32,-8,24
Dungannon,8958,8,2,4,16,14,47,-33,10
Crusaders,8959,1,16,6,4,62,34,28,54
Coleraine,8959,2,14,10,2,44,24,20,52
Glenavon,8959,3,10,9,7,54,44,10,39
Linfield,8959,4,11,5,10,40,36,4,38
Cliftonville,8959,5,9,4,13,32,34,-2,31
Ballymena,8959,6,8,4,14,29,48,-19,28
Glentoran,8959,7,6,6,10,24,32,-8,24
Dungannon,8959,8,2,4,16,14,47,-33,10
Crusaders,8960,1,16,7,3,63,32,31,55
Coleraine,8960,2,15,10,1,49,25,24,55
Glenavon,8960,3,9,9,8,55,49,6,36
Linfield,8960,4,10,6,10,37,36,1,36
Cliftonville,8960,5,9,5,12,32,31,1,32
Ballymena,8960,6,7,5,14,27,49,-22,26
Glentoran,8960,7,6,6,10,24,32,-8,24
Dungannon,8960,8,2,4,16,14,47,-33,10
Crusaders,8961,1,16,7,3,63,32,31,55
Coleraine,8961,2,14,10,2,43,23,20,52
Glenavon,8961,3,10,9,7,53,43,10,39
Linfield,8961,4,10,5,11,38,39,-1,35
Cliftonville,8961,5,10,4,12,35,32,3,34
Ballymena,8961,6,7,5,14,27,49,-22,26
Glentoran,8961,7,6,6,10,24,32,-8,24
Dungannon,8961,8,2,4,16,14,47,-33,10
Crusaders,8962,1,17,6,3,65,32,33,57
Coleraine,8962,2,14,11,1,45,24,21,53
Glenavon,8962,3,9,10,7,54,45,9,37
Linfield,8962,4,10,5,11,38,38,0,35
Cliftonville,8962,5,10,4,12,34,32,2,34
Ballymena,8962,6,7,4,15,27,51,-24,25
Glentoran,8962,7,6,6,10,24,32,-8,24
Dungannon,8962,8,2,4,16,14,47,-33,10
Crusaders,8963,1,17,6,3,64,30,34,57
Coleraine,8963,2,14,10,2,45,26,19,52
Glenavon,8963,3,10,9,7,56,45,11,39
Linfield,8963,4,11,5,10,39,37,2,38
Cliftonville,8963,5,9,4,13,33,33,0,31
Ballymena,8963,6,7,4,15,25,50,-25,25
Glentoran,8963,7,6,6,10,24,32,-8,24
Dungannon,8963,8,2,4,16,14,47,-33,10
Crusaders,8964,1,17,6,3,66,33,33,57
Coleraine,8964,2,15,10,1,45,23,22,55
Glenavon,8964,3,9,9,8,53,45,8,36
Linfield,8964,4,10,6,10,37,36,1,36
Cliftonville,8964,5,9,5,12,32,31,1,32
Ballymena,8964,6,7,4,15,28,52,-24,25
Glentoran,8964,7,6,6,10,24,32,-8,24
Dungannon,8964,8,2,4,16,14,47,-33,10
Crusaders,8965,1,17,6,3,63,30,33,57
Coleraine,8965,2,14,10,2,44,24,20,52
Glenavon,8965,3,10,9,7,54,44,10,39
Linfield,8965,4,11,5,10,39,37,2,38
Cliftonville,8965,5,9,4,13,33,33,0,31
Ballymena,8965,6,7,4,15,25,49,-24,25
Glentoran,8965,7,6,6,10,24,32,-8,24
Dungannon,8965,8,2,4,16,14,47,-33,10
Crusaders,8966,1,16,6,4,61,31,30,54
Coleraine,8966,2,14,11,1,44,23,21,53
Linfield,8966,3,11,5,10,40,36,4,38
Glenavon,8966,4,9,10,7,53,44,9,37
Cliftonville,8966,5,9,4,13,32,34,-2,31
Ballymena,8966,6,8,4,14,26,47,-21,28
Glentoran,8966,7,6,6,10,24,32,-8,24
Dungannon,8966,8,2,4,16,14,47,-33,10
Crusaders,8967,1,16,7,3,63,32,31,55
Coleraine,8967,2,14,10,2,46,27,19,52
Glenavon,8967,3,10,9,7,57,46,11,39
Linfield,8967,4,11,5,10,39,37,2,38
Cliftonville,8967,5,9,4,13,33,33,0,31
Ballymena,8967,6,7,5,14,27,49,-22,26
Glentoran,8967,7,6,6,10,24,32,-8,24
Dungannon,8967,8,2,4,16,14,47,-33,10
Coleraine,8968,1,15,10,1,47,23,24,55
Crusaders,8968,2,16,6,4,62,32,30,54
Linfield,8968,3,11,5,10,41,38,3,38
Glenavon,8968,4,9,9,8,53,47,6,36
Cliftonville,8968,5,9,4,13,34,35,-1,31
Ballymena,8968,6,8,4,14,27,48,-21,28
Glentoran,8968,7,6,6,10,24,32,-8,24
Dungannon,8968,8,2,4,16,14,47,-33,10
Crusaders,8969,1,16,7,3,64,33,31,55
Coleraine,8969,2,14,10,2,43,23,20,52
Glenavon,8969,3,10,9,7,53,43,10,39
Linfield,8969,4,10,5,11,37,38,-1,35
Cliftonville,8969,5,10,4,12,34,31,3,34
Ballymena,8969,6,7,5,14,28,50,-22,26
Glentoran,8969,7,6,6,10,24,32,-8,24
Dungannon,8969,8,2,4,16,14,47,-33,10
Crusaders,8970,1,17,6,3,64,30,34,57
Coleraine,8970,2,14,10,2,44,25,19,52
Glenavon,8970,3,10,9,7,55,44,11,39
Linfield,8970,4,11,5,10,40,37,3,38
Cliftonville,8970,5,9,4,13,33,34,-1,31
Ballymena,8970,6,7,4,15,25,50,-25,25
Glentoran,8970,7,6,6,10,24,32,-8,24
Dungannon,8970,8,2,4,16,14,47,-33,10
Crusaders,8971,1,17,6,3,63,31,32,57
Coleraine,8971,2,14,11,1,43,22,21,53
Linfield,8971,3,11,5,10,38,36,2,38
Glenavon,8971,4,9,10,7,52,43,9,37
Cliftonville,8971,5,9,4,13,32,32,0,31
Ballymena,8971,6,7,4,15,26,49,-23,25
Glentoran,8971,7,6,6,10,24,32,-8,24
Dungannon,8971,8,2,4,16,14,47,-33,10
Crusaders,8972,1,17,6,3,64,32,32,57
Coleraine,8972,2,14,10,2,44,25,19,52
Glenavon,8972,3,10,9,7,55,44,11,39
Linfield,8972,4,10,5,11,37,37,0,35
Cliftonville,8972,5,10,4,12,33,31,2,34
Ballymena,8972,6,7,4,15,27,50,-23,25
Glentoran,8972,7,6,6,10,24,32,-8,24
Dungannon,8972,8,2,4,16,14,47,-33,10
Crusaders,8973,1,17,6,3,65,31,34,57
Coleraine,8973,2,14,10,2,43,24,19,52
Glenavon,8973,3,10,9,7,54,43,11,39
Linfield,8973,4,11,5,10,39,37,2,38
Cliftonville,8973,5,9,4,13,33,33,0,31
Ballymena,8973,6,7,4,15,26,51,-25,25
Glentoran,8973,7,6,6,10,24,32,-8,24
Dungannon,8973,8,2,4,16,14,47,-33,10
Crusaders,8974,1,16,7,3,62,31,31,55
Coleraine,8974,2,14,10,2,45,25,20,52
Glenavon,8974,3,10,9,7,55,45,10,39
Linfield,8974,4,10,5,11,37,37,0,35
Cliftonville,8974,5,10,4,12,33,31,2,34
Ballymena,8974,6,7,5,14,26,48,-22,26
Glentoran,8974,7,6,6,10,24,32,-8,24
Dungannon,8974,8,2,4,16,14,47,-33,10
Crusaders,8975,1,17,6,3,64,31,33,57
Coleraine,8975,2,14,10,2,43,23,20,52
Glenavon,8975,3,10,9,7,53,43,10,39
Linfield,8975,4,10,5,11,37,38,-1,35
Cliftonville,8975,5,10,4,12,34,31,3,34
Ballymena,8975,6,7,4,15,26,50,-24,25
Glentoran,8975,7,6,6,10,24,32,-8,24
Dungannon,8975,8,2,4,16,14,47,-33,10
Crusaders,8976,1,17,6,3,64,32,32,57
Coleraine,8976,2,14,11,1,45,24,21,53
Glenavon,8976,3,9,10,7,54,45,9,37
Linfield,8976,4,10,5,11,39,39,0,35
Cliftonville,8976,5,10,4,12,35,33,2,34
Ballymena,8976,6,7,4,15,27,50,-23,25
Glentoran,8976,7,6,6,10,24,32,-8,24
Dungannon,8976,8,2,4,16,14,47,-33,10
Crusaders,8977,1,17,6,3,63,30,33,57
Coleraine,8977,2,14,10,2,45,25,20,52
Glenavon,8977,3,10,9,7,55,45,10,39
Linfield,8977,4,11,5,10,39,37,2,38
Cliftonville,8977,5,9,4,13,33,33,0,31
Ballymena,8977,6,7,4,15,25,49,-24,25
Glentoran,8977,7,6,6,10,24,32,-8,24
Dungannon,8977,8,2,4,16,14,47,-33,10
Crusaders,8978,1,17,6,3,64,30,34,57
Coleraine,8978,2,14,10,2,43,24,19,52
Glenavon,8978,3,10,9,7,54,43,11,39
Linfield,8978,4,11,5,10,41,37,4,38
Cliftonville,8978,5,9,4,13,33,35,-2,31
Ballymena,8978,6,7,4,15,25,50,-25,25
Glentoran,8978,7,6,6,10,24,32,-8,24
Dungannon,8978,8,2,4,16,14,47,-33,10
Crusaders,8979,1,16,6,4,61,34,27,54
Coleraine,8979,2,14,10,2,43,26,17,52
Glenavon,8979,3,10,9,7,56,43,13,39
Linfield,8979,4,11,5,10,38,36,2,38
Cliftonville,8979,5,9,4,13,32,32,0,31
Ballymena,8979,6,8,4,14,29,47,-18,28
Glentoran,8979,7,6,6,10,24,32,-8,24
Dungannon,8979,8,2,4,16,14,47,-33,10
Crusaders,8980,1,17,6,3,66,31,35,57
Coleraine,8980,2,15,10,1,44,22,22,55
Glenavon,8980,3,9,9,8,52,44,8,36
Linfield,8980,4,10,5,11,38,38,0,35
Cliftonville,8980,5,10,4,12,34,32,2,34
Ballymena,8980,6,7,4,15,26,52,-26,25
Glentoran,8980,7,6,6,10,24,32,-8,24
Dungannon,8980,8,2,4,16,14,47,-33,10
Coleraine,8981,1,15,10,1,45,23,22,55
Crusaders,8981,2,16,6,4,62,32,30,54
Glenavon,8981,3,9,9,8,53,45,8,36
Linfield,8981,4,10,5,11,37,37,0,35
Cliftonville,8981,5,10,4,12,33,31,2,34
Ballymena,8981,6,8,4,14,27,48,-21,28
Glentoran,8981,7,6,6,10,24,32,-8,24
Dungannon,8981,8,2,4,16,14,47,-33,10
Crusaders,8982,1,16,7,3,62,31,31,55
Coleraine,8982,2,14,11,1,43,22,21,53
Linfield,8982,3,11,5,10,40,36,4,38
Glenavon,8982,4,9,10,7,52,43,9,37
Cliftonville,8982,5,9,4,13,32,34,-2,31
Ballymena,8982,6,7,5,14,26,48,-22,26
Glentoran,8982,7,6,6,10,24,32,-8,24
Dungannon,8982,8,2,4,16,14,47,-33,10
Crusaders,8983,1,17,6,3,66,30,36,57
Coleraine,8983,2,14,11,1,44,23,21,53
Glenavon,8983,3,9,10,7,53,44,9,37
Linfield,8983,4,10,6,10,37,36,1,36
Cliftonville,8983,5,9,5,12,32,31,1,32
Ballymena,8983,6,7,4,15,25,52,-27,25
Glentoran,8983,7,6,6,10,24,32,-8,24
Dungannon,8983,8,2,4,16,14,47,-33,10
Crusaders,8984,1,17,6,3,63,31,32,57
Coleraine,8984,2,15,10,1,45,23,22,55
Glenavon,8984,3,9,9,8,53,45,8,36
Linfield,8984,4,10,6,10,37,36,1,36
Cliftonville,8984,5,9,5,12,32,31,1,32
Ballymena,8984,6,7,4,15,26,49,-23,25
Glentoran,8984,7,6,6,10,24,32,-8,24
Dungannon,8984,8,2,4,16,14,47,-33,10
Crusaders,8985,1,17,6,3,64,31,33,57
Coleraine,8985,2,15,10,1,45,22,23,55
Glenavon,8985,3,9,9,8,52,45,7,36
Linfield,8985,4,10,5,11,37,37,0,35
Cliftonville,8985,5,10,4,12,33,31,2,34
Ballymena,8985,6,7,4,15,26,50,-24,25
Glentoran,8985,7,6,6,10,24,32,-8,24
Dungannon,8985,8,2,4,16,14,47,-33,10
Crusaders,8986,1,17,6,3,62,30,32,57
Coleraine,8986,2,15,10,1,46,23,23,55
Linfield,8986,3,11,5,10,40,37,3,38
Glenavon,8986,4,9,9,8,53,46,7,36
Cliftonville,8986,5,9,4,13,33,34,-1,31
Ballymena,8986,6,7,4,15,25,48,-23,25
Glentoran,8986,7,6,6,10,24,32,-8,24
Dungannon,8986,8,2,4,16,14,47,-33,10
Crusaders,8987,1,17,6,3,63,31,32,57
Coleraine,8987,2,14,10,2,43,23,20,52
Glenavon,8987,3,10,9,7,53,43,10,39
Linfield,8987,4,10,5,11,38,39,-1,35
Cliftonville,8987,5,10,4,12,35,32,3,34
Ballymena,8987,6,7,4,15,26,49,-23,25
Glentoran,8987,7,6,6,10,24,32,-8,24
Dungannon,8987,8,2,4,16,14,47,-33,10
Crusaders,8988,1,17,6,3,64,32,32,57
Coleraine,8988,2,14,11,1,43,22,21,53
Glenavon,8988,3,9,10,7,52,43,9,37
Linfield,8988,4,10,6,10,38,37,1,36
Cliftonville,8988,5,9,5,12,33,32,1,32
Ballymena,8988,6,7,4,15,27,50,-23,25
Glentoran,8988,7,6,6,10,24,32,-8,24
Dungannon,8988,8,2,4,16,14,47,-33,10
Crusaders,8989,1,17,6,3,63,30,33,57
Coleraine,8989,2,14,11,1,45,24,21,53
Linfield,8989,3,11,5,10,38,36,2,38
Glenavon,8989,4,9,10,7,54,45,9,37
Cliftonville,8989,5,9,4,13,32,32,0,31
Ballymena,8989,6,7,4,15,25,49,-24,25
Glentoran,8989,7,6,6,10,24,32,-8,24
Dungannon,8989,8,2,4,16,14,47,-33,10
Crusaders,8990,1,17,6,3,63,30,33,57
Coleraine,8990,2,14,10,2,44,24,20,52
Glenavon,8990,3,10,9,7,54,44,10,39
Linfield,8990,4,10,5,11,37,37,0,35
Cliftonville,8990,5,10,4,12,33,31,2,34
Ballymena,8990,6,7,4,15,25,49,-24,25
Glentoran,8990,7,6,6,10,24,32,-8,24
Dungannon,8990,8,2,4,16,14,47,-33,10
Crusaders,8991,1,16,7,3,62,31,31,55
Coleraine,8991,2,14,10,2,45,25,20,52
Glenavon,8991,3,10,9,7,55,45,10,39
Linfield,8991,4,10,6,10,37,36,1,36
Cliftonville,8991,5,9,5,12,32,31,1,32
Ballymena,8991,6,7,5,14,26,48,-22,26
Glentoran,8991,7,6,6,10,24,32,-8,24
Dungannon,8991,8,2,4,16,14,47,-33,10
Crusaders,8992,1,16,6,4,63,34,29,54
Coleraine,8992,2,14,10,2,43,24,19,52
Glenavon,8992,3,10,9,7,54,43,11,39
Linfield,8992,4,10,5,11,37,38,-1,35
Cliftonville,8992,5,10,4,12,34,31,3,34
Ballymena,8992,6,8,4,14,29,49,-20,28
Glentoran,8992,7,6,6,10,24,32,-8,24
Dungannon,8992,8,2,4,16,14,47,-33,10
Crusaders,8993,1,16,6,4,62,32,30,54
Coleraine,8993,2,14,11,1,45,24,21,53
Glenavon,8993,3,9,10,7,54,45,9,37
Linfield,8993,4,10,6,10,38,37,1,36
Cliftonville,8993,5,9,5,12,33,32,1,32
Ballymena,8993,6,8,4,14,27,48,-21,28
Glentoran,8993,7,6,6,10,24,32,-8,24
Dungannon,8993,8,2,4,16,14,47,-33,10
Crusaders,8994,1,17,6,3,62,30,32,57
Coleraine,8994,2,14,10,2,44,25,19,52
Glenavon,8994,3,10,9,7,55,44,11,39
Linfield,8994,4,11,5,10,38,36,2,38
Cliftonville,8994,5,9,4,13,32,32,0,31
Ballymena,8994,6,7,4,15,25,48,-23,25
Glentoran,8994,7,6,6,10,24,32,-8,24
Dungannon,8994,8,2,4,16,14,47,-33,10
Crusaders,8995,1,17,6,3,63,30,33,57
Coleraine,8995,2,15,10,1,46,23,23,55
Glenavon,8995,3,9,9,8,53,46,7,36
Linfield,8995,4,10,5,11,38,38,0,35
Cliftonville,8995,5,10,4,12,34,32,2,34
Ballymena,8995,6,7,4,15,25,49,-24,25
Glentoran,8995,7,6,6,10,24,32,-8,24
Dungannon,8995,8,2,4,16,14,47,-33,10
Crusaders,8996,1,17,6,3,65,33,32,57
Coleraine,8996,2,14,11,1,46,25,21,53
Linfield,8996,3,11,5,10,39,37,2,38
Glenavon,8996,4,9,10,7,55,46,9,37
Cliftonville,8996,5,9,4,13,33,33,0,31
Ballymena,8996,6,7,4,15,28,51,-23,25
Glentoran,8996,7,6,6,10,24,32,-8,24
Dungannon,8996,8,2,4,16,14,47,-33,10
Crusaders,8997,1,17,6,3,62,30,32,57
Coleraine,8997,2,14,10,2,46,26,20,52
Glenavon,8997,3,10,9,7,56,46,10,39
Linfield,8997,4,10,5,11,37,37,0,35
Cliftonville,8997,5,10,4,12,33,31,2,34
Ballymena,8997,6,7,4,15,25,48,-23,25
Glentoran,8997,7,6,6,10,24,32,-8,24
Dungannon,8997,8,2,4,16,14,47,-33,10
Crusaders,8998,1,17,6,3,65,32,33,57
Coleraine,8998,2,14,10,2,44,24,20,52
Glenavon,8998,3,10,9,7,54,44,10,39
Linfield,8998,4,10,6,10,38,37,1,36
Cliftonville,8998,5,9,5,12,33,32,1,32
Ballymena,8998,6,7,4,15,27,51,-24,25
Glentoran,8998,7,6,6,10,24,32,-8,24
Dungannon,8998,8,2,4,16,14,47,-33,10
Crusaders,8999,1,17,6,3,63,30,33,57
Coleraine,8999,2,15,10,1,45,23,22,55
Linfield,8999,3,11,5,10,41,36,5,38
Glenavon,8999,4,9,9,8,53,45,8,36
Cliftonville,8999,5,9,4,13,32,35,-3,31
Ballymena,8999,6,7,4,15,25,49,-24,25
Glentoran,8999,7,6,6,10,24,32,-8,24
Dungannon,8999,8,2,4,16,14,47,-33,10
Crusaders,9000,1,16,7,3,62,31,31,55
Coleraine,9000,2,14,10,2,43,24,19,52
Glenavon,9000,3,10,9,7,54,43,11,39
Linfield,9000,4,10,6,10,37,36,1,36
Cliftonville,9000,5,9,5,12,32,31,1,32
Ballymena,9000,6,7,5,14,26,48,-22,26
Glentoran,9000,7,6,6,10,24,32,-8,24
Dungannon,9000,8,2,4,16,14,47,-33,10
Crusaders,9001,1,16,6,4,61,31,30,54
Coleraine,9001,2,14,10,2,43,28,15,52
Glenavon,9001,3,10,9,7,58,43,15,39
Linfield,9001,4,11,5,10,39,36,3,38
Cliftonville,9001,5,9,4,13,32,33,-1,31
Ballymena,9001,6,8,4,14,26,47,-21,28
Glentoran,9001,7,6,6,10,24,32,-8,24
Dungannon,9001,8,2,4,16,14,47,-33,10
Crusaders,9002,1,17,6,3,64,30,34,57
Coleraine,9002,2,14,10,2,44,26,18,52
Glenavon,9002,3,10,9,7,56,44,12,39
Linfield,9002,4,10,5,11,37,37,0,35
Cliftonville,9002,5,10,4,12,33,31,2,34
Ballymena,9002,6,7,4,15,25,50,-25,25
Glentoran,9002,7,6,6,10,24,32,-8,24
Dungannon,9002,8,2,4,16,14,47,-33,10
Crusaders,9003,1,17,6,3,62,30,32,57
Coleraine,9003,2,14,11,1,44,23,21,53
Linfield,9003,3,11,5,10,39,36,3,38
Glenavon,9003,4,9,10,7,53,44,9,37
Cliftonville,9003,5,9,4,13,32,33,-1,31
Ballymena,9003,6,7,4,15,25,48,-23,25
Glentoran,9003,7,6,6,10,24,32,-8,24
Dungannon,9003,8,2,4,16,14,47,-33,10
Coleraine,9004,1,15,10,1,48,23,25,55
Crusaders,9004,2,16,6,4,61,31,30,54
Linfield,9004,3,11,5,10,39,37,2,38
Glenavon,9004,4,9,9,8,53,48,5,36
Cliftonville,9004,5,9,4,13,33,33,0,31
Ballymena,9004,6,8,4,14,26,47,-21,28
Glentoran,9004,7,6,6,10,24,32,-8,24
Dungannon,9004,8,2,4,16,14,47,-33,10
Crusaders,9005,1,17,6,3,64,30,34,57
Coleraine,9005,2,14,11,1,45,24,21,53
Glenavon,9005,3,9,10,7,54,45,9,37
Linfield,9005,4,10,6,10,37,36,1,36
Cliftonville,9005,5,9,5,12,32,31,1,32
Ballymena,9005,6,7,4,15,25,50,-25,25
Glentoran,9005,7,6,6,10,24,32,-8,24
Dungannon,9005,8,2,4,16,14,47,-33,10
Crusaders,9006,1,17,6,3,66,30,36,57
Coleraine,9006,2,14,10,2,43,25,18,52
Glenavon,9006,3,10,9,7,55,43,12,39
Linfield,9006,4,10,5,11,37,37,0,35
Cliftonville,9006,5,10,4,12,33,31,2,34
Ballymena,9006,6,7,4,15,25,52,-27,25
Glentoran,9006,7,6,6,10,24,32,-8,24
Dungannon,9006,8,2,4,16,14,47,-33,10
Crusaders,9007,1,16,6,4,61,33,28,54
Coleraine,9007,2,14,10,2,45,25,20,52
Glenavon,9007,3,10,9,7,55,45,10,39
Linfield,9007,4,10,5,11,37,37,0,35
Cliftonville,9007,5,10,4,12,33,31,2,34
Ballymena,9007,6,8,4,14,28,47,-19,28
Glentoran,9007,7,6,6,10,24,32,-8,24
Dungannon,9007,8,2,4,16,14,47,-33,10
Coleraine,9008,1,15,10,1,47,24,23,55
Crusaders,9008,2,16,6,4,62,32,30,54
Glenavon,9008,3,9,9,8,54,47,7,36
Linfield,9008,4,10,6,10,38,37,1,36
Cliftonville,9008,5,9,5,12,33,32,1,32
Ballymena,9008,6,8,4,14,27,48,-21,28
Glentoran,9008,7,6,6,10,24,32,-8,24
Dungannon,9008,8,2,4,16,14,47,-33,10
Crusaders,9009,1,17,6,3,62,30,32,57
Coleraine,9009,2,15,10,1,45,22,23,55
Glenavon,9009,3,9,9,8,52,45,7,36
Linfield,9009,4,10,5,11,39,39,0,35
Cliftonville,9009,5,10,4,12,35,33,2,34
Ballymena,9009,6,7,4,15,25,48,-23,25
Glentoran,9009,7,6,6,10,24,32,-8,24
Dungannon,9009,8,2,4,16,14,47,-33,10
Coleraine,9010,1,15,10,1,50,26,24,55
Crusaders,9010,2,16,6,4,62,32,30,54
Linfield,9010,3,11,5,10,40,36,4,38
Glenavon,9010,4,9,9,8,56,50,6,36
Cliftonville,9010,5,9,4,13,32,34,-2,31
Ballymena,9010,6,8,4,14,27,48,-21,28
Glentoran,9010,7,6,6,10,24,32,-8,24
Dungannon,9010,8,2,4,16,14,47,-33,10
Crusaders,9011,1,17,6,3,64,30,34,57
Coleraine,9011,2,14,11,1,45,24,21,53
Linfield,9011,3,11,5,10,39,37,2,38
Glenavon,9011,4,9,10,7,54,45,9,37
Cliftonville,9011,5,9,4,13,33,33,0,31
Ballymena,9011,6,7,4,15,25,50,-25,25
Glentoran,9011,7,6,6,10,24,32,-8,24
Dungannon,9011,8,2,4,16,14,47,-33,10
Crusaders,9012,1,17,6,3,65,31,34,57
Coleraine,9012,2,15,10,1,44,22,22,55
Glenavon,9012,3,9,9,8,52,44,8,36
Linfield,9012,4,10,6,10,37,36,1,36
Cliftonville,9012,5,9,5,12,32,31,1,32
Ballymena,9012,6,7,4,15,26,51,-25,25
Glentoran,9012,7,6,6,10,24,32,-8,24
Dungannon,9012,8,2,4,16,14,47,-33,10
Crusaders,9013,1,17,6,3,62,30,32,57
Coleraine,9013,2,14,10,2,44,24,20,52
Glenavon,9013,3,10,9,7,54,44,10,39
Linfield,9013,4,10,5,11,37,38,-1,35
Cliftonville,9013,5,10,4,12,34,31,3,34
Ballymena,9013,6,7,4,15,25,48,-23,25
Glentoran,9013,7,6,6,10,24,32,-8,24
Dungannon,9013,8,2,4,16,14,47,-33,10
Crusaders,9014,1,16,7,3,63,32,31,55
Coleraine,9014,2,15,10,1,46,23,23,55
Glenavon,9014,3,9,9,8,53,46,7,36
Linfield,9014,4,10,5,11,37,37,0,35
Cliftonville,9014,5,10,4,12,33,31,2,34
Ballymena,9014,6,7,5,14,27,49,-22,26
Glentoran,9014,7,6,6,10,24,32,-8,24
Dungannon,9014,8,2,4,16,14,47,-33,10
Crusaders,9015,1,16,6,4,63,33,30,54
Coleraine,9015,2,14,10,2,45,26,19,52
Glenavon,9015,3,10,9,7,56,45,11,39
Linfield,9015,4,11,5,10,41,36,5,38
Cliftonville,9015,5,9,4,13,32,35,-3,31
Ballymena,9015,6,8,4,14,28,49,-21,28
Glentoran,9015,7,6,6,10,24,32,-8,24
Dungannon,9015,8,2,4,16,14,47,-33,10
Crusaders,9016,1,17,6,3,63,31,32,57
Coleraine,9016,2,14,11,1,44,23,21,53
Glenavon,9016,3,9,10,7,53,44,9,37
Linfield,9016,4,10,5,11,38,38,0,35
Cliftonville,9016,5,10,4,12,34,32,2,34
Ballymena,9016,6,7,4,15,26,49,-23,25
Glentoran,9016,7,6,6,10,24,32,-8,24
Dungannon,9016,8,2,4,16,14,47,-33,10
Crusaders,9017,1,17,6,3,64,30,34,57
Coleraine,9017,2,15,10,1,44,22,22,55
Glenavon,9017,3,9,9,8,52,44,8,36
Linfield,9017,4,10,6,10,37,36,1,36
Cliftonville,9017,5,9,5,12,32,31,1,32
Ballymena,9017,6,7,4,15,25,50,-25,25
Glentoran,9017,7,6,6,10,24,32,-8,24
Dungannon,9017,8,2,4,16,14,47,-33,10
Crusaders,9018,1,16,7,3,61,30,31,55
Coleraine,9018,2,14,10,2,43,28,15,52
Glenavon,9018,3,10,9,7,58,43,15,39
Linfield,9018,4,11,5,10,41,36,5,38
Cliftonville,9018,5,9,4,13,32,35,-3,31
Ballymena,9018,6,7,5,14,25,47,-22,26
Glentoran,9018,7,6,6,10,24,32,-8,24
Dungannon,9018,8,2,4,16,14,47,-33,10
Crusaders,9019,1,16,7,3,63,32,31,55
Coleraine,9019,2,15,10,1,46,23,23,55
Glenavon,9019,3,9,9,8,53,46,7,36
Linfield,9019,4,10,6,10,38,37,1,36
Cliftonville,9019,5,9,5,12,33,32,1,32
Ballymena,9019,6,7,5,14,27,49,-22,26
Glentoran,9019,7,6,6,10,24,32,-8,24
Dungannon,9019,8,2,4,16,14,47,-33,10
Crusaders,9020,1,17,6,3,64,31,33,57
Coleraine,9020,2,15,10,1,46,23,23,55
Linfield,9020,3,11,5,10,40,36,4,38
Glenavon,9020,4,9,9,8,53,46,7,36
Cliftonville,9020,5,9,4,13,32,34,-2,31
Ballymena,9020,6,7,4,15,26,50,-24,25
Glentoran,9020,7,6,6,10,24,32,-8,24
Dungannon,9020,8,2,4,16,14,47,-33,10
Crusaders,9021,1,17,6,3,63,31,32,57
Coleraine,9021,2,14,10,2,44,25,19,52
Glenavon,9021,3,10,9,7,55,44,11,39
Linfield,9021,4,11,5,10,40,37,3,38
Cliftonville,9021,5,9,4,13,33,34,-1,31
Ballymena,9021,6,7,4,15,26,49,-23,25
Glentoran,9021,7,6,6,10,24,32,-8,24
Dungannon,9021,8,2,4,16,14,47,-33,10
Crusaders,9022,1,17,6,3,65,33,32,57
Coleraine,9022,2,14,11,1,44,23,21,53
Glenavon,9022,3,9,10,7,53,44,9,37
Linfield,9022,4,10,6,10,37,36,1,36
Cliftonville,9022,5,9,5,12,32,31,1,32
Ballymena,9022,6,7,4,15,28,51,-23,25
Glentoran,9022,7,6,6,10,24,32,-8,24
Dungannon,9022,8,2,4,16,14,47,-33,10
Crusaders,9023,1,17,6,3,63,31,32,57
Coleraine,9023,2,14,11,1,43,22,21,53
Glenavon,9023,3,9,10,7,52,43,9,37
Linfield,9023,4,10,5,11,38,38,0,35
Cliftonville,9023,5,10,4,12,34,32,2,34
Ballymena,9023,6,7,4,15,26,49,-23,25
Glentoran,9023,7,6,6,10,24,32,-8,24
Dungannon,9023,8,2,4,16,14,47,-33,10
Crusaders,9024,1,17,6,3,62,30,32,57
Coleraine,9024,2,14,10,2,43,24,19,52
Glenavon,9024,3,10,9,7,54,43,11,39
Linfield,9024,4,11,5,10,41,39,2,38
Cliftonville,9024,5,9,4,13,35,35,0,31
Ballymena,9024,6,7,4,15,25,48,-23,25
Glentoran,9024,7,6,6,10,24,32,-8,24
Dungannon,9024,8,2,4,16,14,47,-33,10
Crusaders,9025,1,17,6,3,63,31,32,57
Coleraine,9025,2,14,11,1,45,24,21,53
Linfield,9025,3,11,5,10,40,38,2,38
Glenavon,9025,4,9,10,7,54,45,9,37
Cliftonville,9025,5,9,4,13,34,34,0,31
Ballymena,9025,6,7,4,15,26,49,-23,25
Glentoran,9025,7,6,6,10,24,32,-8,24
Dungannon,9025,8,2,4,16,14,47,-33,10
Crusaders,9026,1,17,6,3,64,32,32,57
Coleraine,9026,2,15,10,1,45,22,23,55
Linfield,9026,3,11,5,10,41,38,3,38
Glenavon,9026,4,9,9,8,52,45,7,36
Cliftonville,9026,5,9,4,13,34,35,-1,31
Ballymena,9026,6,7,4,15,27,50,-23,25
Glentoran,9026,7,6,6,10,24,32,-8,24
Dungannon,9026,8,2,4,16,14,47,-33,10
Crusaders,9027,1,17,6,3,62,30,32,57
Coleraine,9027,2,15,10,1,44,22,22,55
Glenavon,9027,3,9,9,8,52,44,8,36
Linfield,9027,4,10,5,11,38,38,0,35
Cliftonville,9027,5,10,4,12,34,32,2,34
Ballymena,9027,6,7,4,15,25,48,-23,25
Glentoran,9027,7,6,6,10,24,32,-8,24
Dungannon,9027,8,2,4,16,14,47,-33,10
Crusaders,9028,1,17,6,3,63,31,32,57
Coleraine,9028,2,14,10,2,43,23,20,52
Glenavon,9028,3,10,9,7,53,43,10,39
Linfield,9028,4,11,5,10,39,37,2,38
Cliftonville,9028,5,9,4,13,33,33,0,31
Ballymena,9028,6,7,4,15,26,49,-23,25
Glentoran,9028,7,6,6,10,24,32,-8,24
Dungannon,9028,8,2,4,16,14,47,-33,10
Crusaders,9029,1,16,6,4,63,34,29,54
Coleraine,9029,2,14,11,1,45,24,21,53
Glenavon,9029,3,9,10,7,54,45,9,37
Linfield,9029,4,10,6,10,37,36,1,36
Cliftonville,9029,5,9,5,12,32,31,1,32
Ballymena,9029,6,8,4,14,29,49,-20,28
Glentoran,9029,7,6,6,10,24,32,-8,24
Dungannon,9029,8,2,4,16,14,47,-33,10
Crusaders,9030,1,17,6,3,66,30,36,57
Coleraine,9030,2,14,10,2,43,25,18,52
Glenavon,9030,3,10,9,7,55,43,12,39
Linfield,9030,4,11,5,10,39,37,2,38
Cliftonville,9030,5,9,4,13,33,33,0,31
Ballymena,9030,6,7,4,15,25,52,-27,25
Glentoran,9030,7,6,6,10,24,32,-8,24
Dungannon,9030,8,2,4,16,14,47,-33,10
Crusaders,9031,1,16,6,4,61,32,29,54
Coleraine,9031,2,14,10,2,43,23,20,52
Glenavon,9031,3,10,9,7,53,43,10,39
Linfield,9031,4,10,6,10,38,37,1,36
Cliftonville,9031,5,9,5,12,33,32,1,32
Ballymena,9031,6,8,4,14,27,47,-20,28
Glentoran,9031,7,6,6,10,24,32,-8,24
Dungannon,9031,8,2,4,16,14,47,-33,10
Crusaders,9032,1,17,6,3,64,32,32,57
Coleraine,9032,2,15,10,1,45,22,23,55
Glenavon,9032,3,9,9,8,52,45,7,36
Linfield,9032,4,10,5,11,38,39,-1,35
Cliftonville,9032,5,10,4,12,35,32,3,34
Ballymena,9032,6,7,4,15,27,50,-23,25
Glentoran,9032,7,6,6,10,24,32,-8,24
Dungannon,9032,8,2,4,16,14,47,-33,10
Crusaders,9033,1,16,6,4,61,33,28,54
Coleraine,9033,2,14,10,2,43,23,20,52
Glenavon,9033,3,10,9,7,53,43,10,39
Linfield,9033,4,10,6,10,37,36,1,36
Cliftonville,9033,5,9,5,12,32,31,1,32
Ballymena,9033,6,8,4,14,28,47,-19,28
Glentoran,9033,7,6,6,10,24,32,-8,24
Dungannon,9033,8,2,4,16,14,47,-33,10
Crusaders,9034,1,16,7,3,62,31,31,55
Coleraine,9034,2,14,10,2,44,25,19,52
Glenavon,9034,3,10,9,7,55,44,11,39
Linfield,9034,4,11,5,10,39,37,2,38
Cliftonville,9034,5,9,4,13,33,33,0,31
Ballymena,9034,6,7,5,14,26,48,-22,26
Glentoran,9034,7,6,6,10,24,32,-8,24
Dungannon,9034,8,2,4,16,14,47,-33,10
Coleraine,9035,1,15,10,1,46,22,24,55
Crusaders,9035,2,16,6,4,61,32,29,54
Glenavon,9035,3,9,9,8,52,46,6,36
Linfield,9035,4,10,6,10,38,37,1,36
Cliftonville,9035,5,9,5,12,33,32,1,32
Ballymena,9035,6,8,4,14,27,47,-20,28
Glentoran,9035,7,6,6,10,24,32,-8,24
Dungannon,9035,8,2,4,16,14,47,-33,10
Crusaders,9036,1,16,6,4,61,34,27,54
Coleraine,9036,2,14,10,2,44,24,20,52
Glenavon,9036,3,10,9,7,54,44,10,39
Linfield,9036,4,10,6,10,39,38,1,36
Cliftonville,9036,5,9,5,12,34,33,1,32
Ballymena,9036,6,8,4,14,29,47,-18,28
Glentoran,9036,7,6,6,10,24,32,-8,24
Dungannon,9036,8,2,4,16,14,47,-33,10
Crusaders,9037,1,16,7,3,62,31,31,55
Coleraine,9037,2,14,11,1,43,22,21,53
Linfield,9037,3,11,5,10,41,38,3,38
Glenavon,9037,4,9,10,7,52,43,9,37
Cliftonville,9037,5,9,4,13,34,35,-1,31
Ballymena,9037,6,7,5,14,26,48,-22,26
Glentoran,9037,7,6,6,10,24,32,-8,24
Dungannon,9037,8,2,4,16,14,47,-33,10
Crusaders,9038,1,17,6,3,63,31,32,57
Coleraine,9038,2,14,11,1,45,24,21,53
Glenavon,9038,3,9,10,7,54,45,9,37
Linfield,9038,4,10,6,10,38,37,1,36
Cliftonville,9038,5,9,5,12,33,32,1,32
Ballymena,9038,6,7,4,15,26,49,-23,25
Glentoran,9038,7,6,6,10,24,32,-8,24
Dungannon,9038,8,2,4,16,14,47,-33,10
Crusaders,9039,1,17,6,3,62,30,32,57
Coleraine,9039,2,14,10,2,44,24,20,52
Glenavon,9039,3,10,9,7,54,44,10,39
Linfield,9039,4,11,5,10,38,36,2,38
Cliftonville,9039,5,9,4,13,32,32,0,31
Ballymena,9039,6,7,4,15,25,48,-23,25
Glentoran,9039,7,6,6,10,24,32,-8,24
Dungannon,9039,8,2,4,16,14,47,-33,10
Crusaders,9040,1,17,6,3,63,30,33,57
Coleraine,9040,2,15,10,1,45,23,22,55
Linfield,9040,3,11,5,10,40,37,3,38
Glenavon,9040,4,9,9,8,53,45,8,36
Cliftonville,9040,5,9,4,13,33,34,-1,31
Ballymena,9040,6,7,4,15,25,49,-24,25
Glentoran,9040,7,6,6,10,24,32,-8,24
Dungannon,9040,8,2,4,16,14,47,-33,10
Crusaders,9041,1,17,6,3,63,30,33,57
Coleraine,9041,2,14,10,2,44,24,20,52
Glenavon,9041,3,10,9,7,54,44,10,39
Linfield,9041,4,11,5,10,41,37,4,38
Cliftonville,9041,5,9,4,13,33,35,-2,31
Ballymena,9041,6,7,4,15,25,49,-24,25
Glentoran,9041,7,6,6,10,24,32,-8,24
Dungannon,9041,8,2,4,16,14,47,-33,10
Crusaders,9042,1,17,6,3,64,31,33,57
Coleraine,9042,2,14,11,1,44,23,21,53
Glenavon,9042,3,9,10,7,53,44,9,37
Linfield,9042,4,10,5,11,37,38,-1,35
Cliftonville,9042,5,10,4,12,34,31,3,34
Ballymena,9042,6,7,4,15,26,50,-24,25
Glentoran,9042,7,6,6,10,24,32,-8,24
Dungannon,9042,8,2,4,16,14,47,-33,10
Crusaders,9043,1,16,6,4,61,32,29,54
Coleraine,9043,2,14,10,2,43,24,19,52
Glenavon,9043,3,10,9,7,54,43,11,39
Linfield,9043,4,10,6,10,39,38,1,36
Cliftonville,9043,5,9,5,12,34,33,1,32
Ballymena,9043,6,8,4,14,27,47,-20,28
Glentoran,9043,7,6,6,10,24,32,-8,24
Dungannon,9043,8,2,4,16,14,47,-33,10
Crusaders,9044,1,17,6,3,62,30,32,57
Coleraine,9044,2,15,10,1,46,23,23,55
Linfield,9044,3,11,5,10,40,37,3,38
Glenavon,9044,4,9,9,8,53,46,7,36
Cliftonville,9044,5,9,4,13,33,34,-1,31
Ballymena,9044,6,7,4,15,25,48,-23,25
Glentoran,9044,7,6,6,10,24,32,-8,24
Dungannon,9044,8,2,4,16,14,47,-33,10
Crusaders,9045,1,17,6,3,63,30,33,57
Coleraine,9045,2,15,10,1,45,22,23,55
Linfield,9045,3,11,5,10,43,36,7,38
Glenavon,9045,4,9,9,8,52,45,7,36
Cliftonville,9045,5,9,4,13,32,37,-5,31
Ballymena,9045,6,7,4,15,25,49,-24,25
Glentoran,9045,7,6,6,10,24,32,-8,24
Dungannon,9045,8,2,4,16,14,47,-33,10
Crusaders,9046,1,16,7,3,63,32,31,55
Coleraine,9046,2,14,10,2,46,26,20,52
Glenavon,9046,3,10,9,7,56,46,10,39
Linfield,9046,4,10,6,10,38,37,1,36
Cliftonville,9046,5,9,5,12,33,32,1,32
Ballymena,9046,6,7,5,14,27,49,-22,26
Glentoran,9046,7,6,6,10,24,32,-8,24
Dungannon,9046,8,2,4,16,14,47,-33,10
Crusaders,9047,1,17,6,3,64,31,33,57
Coleraine,9047,2,14,10,2,43,23,20,52
Glenavon,9047,3,10,9,7,53,43,10,39
Linfield,9047,4,11,5,10,38,36,2,38
Cliftonville,9047,5,9,4,13,32,32,0,31
Ballymena,9047,6,7,4,15,26,50,-24,25
Glentoran,9047,7,6,6,10,24,32,-8,24
Dungannon,9047,8,2,4,16,14,47,-33,10
Coleraine,9048,1,15,10,1,48,24,24,55
Crusaders,9048,2,16,6,4,61,32,29,54
Glenavon,9048,3,9,9,8,54,48,6,36
Linfield,9048,4,10,5,11,37,41,-4,35
Cliftonville,9048,5,10,4,12,37,31,6,34
Ballymena,9048,6,8,4,14,27,47,-20,28
Glentoran,9048,7,6,6,10,24,32,-8,24
Dungannon,9048,8,2,4,16,14,47,-33,10
Crusaders,9049,1,17,6,3,67,33,34,57
Coleraine,9049,2,14,11,1,44,23,21,53
Glenavon,9049,3,9,10,7,53,44,9,37
Linfield,9049,4,10,5,11,38,38,0,35
Cliftonville,9049,5,10,4,12,34,32,2,34
Ballymena,9049,6,7,4,15,28,53,-25,25
Glentoran,9049,7,6,6,10,24,32,-8,24
Dungannon,9049,8,2,4,16,14,47,-33,10
Coleraine,9050,1,15,10,1,45,22,23,55
Crusaders,9050,2,16,6,4,61,33,28,54
Linfield,9050,3,11,5,10,39,36,3,38
Glenavon,9050,4,9,9,8,52,45,7,36
Cliftonville,9050,5,9,4,13,32,33,-1,31
Ballymena,9050,6,8,4,14,28,47,-19,28
Glentoran,9050,7,6,6,10,24,32,-8,24
Dungannon,9050,8,2,4,16,14,47,-33,10
Crusaders,9051,1,17,6,3,62,30,32,57
Coleraine,9051,2,14,10,2,44,24,20,52
Glenavon,9051,3,10,9,7,54,44,10,39
Linfield,9051,4,11,5,10,39,37,2,38
Cliftonville,9051,5,9,4,13,33,33,0,31
Ballymena,9051,6,7,4,15,25,48,-23,25
Glentoran,9051,7,6,6,10,24,32,-8,24
Dungannon,9051,8,2,4,16,14,47,-33,10
Crusaders,9052,1,17,6,3,65,30,35,57
Coleraine,9052,2,14,11,1,45,24,21,53
Linfield,9052,3,11,5,10,39,37,2,38
Glenavon,9052,4,9,10,7,54,45,9,37
Cliftonville,9052,5,9,4,13,33,33,0,31
Ballymena,9052,6,7,4,15,25,51,-26,25
Glentoran,9052,7,6,6,10,24,32,-8,24
Dungannon,9052,8,2,4,16,14,47,-33,10
Crusaders,9053,1,16,7,3,63,32,31,55
Coleraine,9053,2,15,10,1,45,22,23,55
Glenavon,9053,3,9,9,8,52,45,7,36
Linfield,9053,4,10,5,11,37,38,-1,35
Cliftonville,9053,5,10,4,12,34,31,3,34
Ballymena,9053,6,7,5,14,27,49,-22,26
Glentoran,9053,7,6,6,10,24,32,-8,24
Dungannon,9053,8,2,4,16,14,47,-33,10
Coleraine,9054,1,15,10,1,44,22,22,55
Crusaders,9054,2,16,6,4,63,33,30,54
Glenavon,9054,3,9,9,8,52,44,8,36
Linfield,9054,4,10,6,10,38,37,1,36
Cliftonville,9054,5,9,5,12,33,32,1,32
Ballymena,9054,6,8,4,14,28,49,-21,28
Glentoran,9054,7,6,6,10,24,32,-8,24
Dungannon,9054,8,2,4,16,14,47,-33,10
Crusaders,9055,1,17,6,3,65,31,34,57
Coleraine,9055,2,15,10,1,45,22,23,55
Linfield,9055,3,11,5,10,39,36,3,38
Glenavon,9055,4,9,9,8,52,45,7,36
Cliftonville,9055,5,9,4,13,32,33,-1,31
Ballymena,9055,6,7,4,15,26,51,-25,25
Glentoran,9055,7,6,6,10,24,32,-8,24
Dungannon,9055,8,2,4,16,14,47,-33,10
Crusaders,9056,1,16,7,3,62,31,31,55
Coleraine,9056,2,14,11,1,45,24,21,53
Glenavon,9056,3,9,10,7,54,45,9,37
Linfield,9056,4,10,5,11,37,37,0,35
Cliftonville,9056,5,10,4,12,33,31,2,34
Ballymena,9056,6,7,5,14,26,48,-22,26
Glentoran,9056,7,6,6,10,24,32,-8,24
Dungannon,9056,8,2,4,16,14,47,-33,10
Crusaders,9057,1,16,7,3,62,31,31,55
Coleraine,9057,2,15,10,1,45,22,23,55
Linfield,9057,3,11,5,10,38,36,2,38
Glenavon,9057,4,9,9,8,52,45,7,36
Cliftonville,9057,5,9,4,13,32,32,0,31
Ballymena,9057,6,7,5,14,26,48,-22,26
Glentoran,9057,7,6,6,10,24,32,-8,24
Dungannon,9057,8,2,4,16,14,47,-33,10
Crusaders,9058,1,16,6,4,61,32,29,54
Coleraine,9058,2,14,11,1,45,24,21,53
Linfield,9058,3,11,5,10,39,37,2,38
Glenavon,9058,4,9,10,7,54,45,9,37
Cliftonville,9058,5,9,4,13,33,33,0,31
Ballymena,9058,6,8,4,14,27,47,-20,28
Glentoran,9058,7,6,6,10,24,32,-8,24
Dungannon,9058,8,2,4,16,14,47,-33,10
Crusaders,9059,1,17,6,3,65,31,34,57
Coleraine,9059,2,15,10,1,45,23,22,55
Glenavon,9059,3,9,9,8,53,45,8,36
Linfield,9059,4,10,6,10,38,37,1,36
Cliftonville,9059,5,9,5,12,33,32,1,32
Ballymena,9059,6,7,4,15,26,51,-25,25
Glentoran,9059,7,6,6,10,24,32,-8,24
Dungannon,9059,8,2,4,16,14,47,-33,10
Crusaders,9060,1,17,6,3,63,30,33,57
Coleraine,9060,2,15,10,1,45,22,23,55
Glenavon,9060,3,9,9,8,52,45,7,36
Linfield,9060,4,10,5,11,38,39,-1,35
Cliftonville,9060,5,10,4,12,35,32,3,34
Ballymena,9060,6,7,4,15,25,49,-24,25
Glentoran,9060,7,6,6,10,24,32,-8,24
Dungannon,9060,8,2,4,16,14,47,-33,10
Crusaders,9061,1,16,6,4,62,33,29,54
Coleraine,9061,2,14,10,2,44,25,19,52
Glenavon,9061,3,10,9,7,55,44,11,39
Linfield,9061,4,11,5,10,38,36,2,38
Cliftonville,9061,5,9,4,13,32,32,0,31
Ballymena,9061,6,8,4,14,28,48,-20,28
Glentoran,9061,7,6,6,10,24,32,-8,24
Dungannon,9061,8,2,4,16,14,47,-33,10
Crusaders,9062,1,16,7,3,61,30,31,55
Coleraine,9062,2,14,11,1,44,23,21,53
Glenavon,9062,3,9,10,7,53,44,9,37
Linfield,9062,4,10,5,11,37,37,0,35
Cliftonville,9062,5,10,4,12,33,31,2,34
Ballymena,9062,6,7,5,14,25,47,-22,26
Glentoran,9062,7,6,6,10,24,32,-8,24
Dungannon,9062,8,2,4,16,14,47,-33,10
Crusaders,9063,1,17,6,3,63,31,32,57
Coleraine,9063,2,15,10,1,45,22,23,55
Linfield,9063,3,11,5,10,40,38,2,38
Glenavon,9063,4,9,9,8,52,45,7,36
Cliftonville,9063,5,9,4,13,34,34,0,31
Ballymena,9063,6,7,4,15,26,49,-23,25
Glentoran,9063,7,6,6,10,24,32,-8,24
Dungannon,9063,8,2,4,16,14,47,-33,10
Crusaders,9064,1,17,6,3,64,32,32,57
Coleraine,9064,2,14,11,1,44,23,21,53
Glenavon,9064,3,9,10,7,53,44,9,37
Linfield,9064,4,10,5,11,37,38,-1,35
Cliftonville,9064,5,10,4,12,34,31,3,34
Ballymena,9064,6,7,4,15,27,50,-23,25
Glentoran,9064,7,6,6,10,24,32,-8,24
Dungannon,9064,8,2,4,16,14,47,-33,10
Coleraine,9065,1,15,10,1,44,22,22,55
Crusaders,9065,2,16,6,4,62,32,30,54
Glenavon,9065,3,9,9,8,52,44,8,36
Linfield,9065,4,10,6,10,38,37,1,36
Cliftonville,9065,5,9,5,12,33,32,1,32
Ballymena,9065,6,8,4,14,27,48,-21,28
Glentoran,9065,7,6,6,10,24,32,-8,24
Dungannon,9065,8,2,4,16,14,47,-33,10
Crusaders,9066,1,16,6,4,62,33,29,54
Coleraine,9066,2,14,10,2,45,26,19,52
Glenavon,9066,3,10,9,7,56,45,11,39
Linfield,9066,4,11,5,10,39,36,3,38
Cliftonville,9066,5,9,4,13,32,33,-1,31
Ballymena,9066,6,8,4,14,28,48,-20,28
Glentoran,9066,7,6,6,10,24,32,-8,24
Dungannon,9066,8,2,4,16,14,47,-33,10
Crusaders,9067,1,17,6,3,62,30,32,57
Coleraine,9067,2,15,10,1,44,22,22,55
Glenavon,9067,3,9,9,8,52,44,8,36
Linfield,9067,4,10,6,10,38,37,1,36
Cliftonville,9067,5,9,5,12,33,32,1,32
Ballymena,9067,6,7,4,15,25,48,-23,25
Glentoran,9067,7,6,6,10,24,32,-8,24
Dungannon,9067,8,2,4,16,14,47,-33,10
Crusaders,9068,1,16,7,3,63,32,31,55
Coleraine,9068,2,14,10,2,43,23,20,52
Glenavon,9068,3,10,9,7,53,43,10,39
Linfield,9068,4,11,5,10,40,38,2,38
Cliftonville,9068,5,9,4,13,34,34,0,31
Ballymena,9068,6,7,5,14,27,49,-22,26
Glentoran,9068,7,6,6,10,24,32,-8,24
Dungannon,9068,8,2,4,16,14,47,-33,10
Crusaders,9069,1,17,6,3,64,30,34,57
Coleraine,9069,2,15,10,1,47,24,23,55
Glenavon,9069,3,9,9,8,54,47,7,36
Linfield,9069,4,10,6,10,38,37,1,36
Cliftonville,9069,5,9,5,12,33,32,1,32
Ballymena,9069,6,7,4,15,25,50,-25,25
Glentoran,9069,7,6,6,10,24,32,-8,24
Dungannon,9069,8,2,4,16,14,47,-33,10
Crusaders,9070,1,16,7,3,61,30,31,55
Coleraine,9070,2,14,10,2,43,24,19,52
Glenavon,9070,3,10,9,7,54,43,11,39
Linfield,9070,4,11,5,10,38,36,2,38
Cliftonville,9070,5,9,4,13,32,32,0,31
Ballymena,9070,6,7,5,14,25,47,-22,26
Glentoran,9070,7,6,6,10,24,32,-8,24
Dungannon,9070,8,2,4,16,14,47,-33,10
Crusaders,9071,1,17,6,3,63,31,32,57
Coleraine,9071,2,15,10,1,45,22,23,55
Glenavon,9071,3,9,9,8,52,45,7,36
Linfield,9071,4,10,5,11,37,38,-1,35
Cliftonville,9071,5,10,4,12,34,31,3,34
Ballymena,9071,6,7,4,15,26,49,-23,25
Glentoran,9071,7,6,6,10,24,32,-8,24
Dungannon,9071,8,2,4,16,14,47,-33,10
Coleraine,9072,1,15,10,1,46,24,22,55
Crusaders,9072,2,16,6,4,61,32,29,54
Glenavon,9072,3,9,9,8,54,46,8,36
Linfield,9072,4,10,5,11,37,37,0,35
Cliftonville,9072,5,10,4,12,33,31,2,34
Ballymena,9072,6,8,4,14,27,47,-20,28
Glentoran,9072,7,6,6,10,24,32,-8,24
Dungannon,9072,8,2,4,16,14,47,-33,10
Crusaders,9073,1,17,6,3,62,30,32,57
Coleraine,9073,2,14,10,2,43,23,20,52
Glenavon,9073,3,10,9,7,53,43,10,39
Linfield,9073,4,10,5,11,37,37,0,35
Cliftonville,9073,5,10,4,12,33,31,2,34
Ballymena,9073,6,7,4,15,25,48,-23,25
Glentoran,9073,7,6,6,10,24,32,-8,24
Dungannon,9073,8,2,4,16,14,47,-33,10
Crusaders,9074,1,17,6,3,64,30,34,57
Coleraine,9074,2,14,10,2,43,23,20,52
Glenavon,9074,3,10,9,7,53,43,10,39
Linfield,9074,4,10,5,11,37,37,0,35
Cliftonville,9074,5,10,4,12,33,31,2,34
Ballymena,9074,6,7,4,15,25,50,-25,25
Glentoran,9074,7,6,6,10,24,32,-8,24
Dungannon,9074,8,2,4,16,14,47,-33,10
Crusaders,9075,1,17,6,3,62,30,32,57
Coleraine,9075,2,14,11,1,44,23,21,53
Glenavon,9075,3,9,10,7,53,44,9,37
Linfield,9075,4,10,6,10,38,37,1,36
Cliftonville,9075,5,9,5,12,33,32,1,32
Ballymena,9075,6,7,4,15,25,48,-23,25
Glentoran,9075,7,6,6,10,24,32,-8,24
Dungannon,9075,8,2,4,16,14,47,-33,10
Crusaders,9076,1,16,7,3,63,32,31,55
Coleraine,9076,2,14,10,2,44,25,19,52
Glenavon,9076,3,10,9,7,55,44,11,39
Linfield,9076,4,11,5,10,38,36,2,38
Cliftonville,9076,5,9,4,13,32,32,0,31
Ballymena,9076,6,7,5,14,27,49,-22,26
Glentoran,9076,7,6,6,10,24,32,-8,24
Dungannon,9076,8,2,4,16,14,47,-33,10
Coleraine,9077,1,15,10,1,45,23,22,55
Crusaders,9077,2,16,6,4,63,33,30,54
Glenavon,9077,3,9,9,8,53,45,8,36
Linfield,9077,4,10,6,10,37,36,1,36
Cliftonville,9077,5,9,5,12,32,31,1,32
Ballymena,9077,6,8,4,14,28,49,-21,28
Glentoran,9077,7,6,6,10,24,32,-8,24
Dungannon,9077,8,2,4,16,14,47,-33,10
Crusaders,9078,1,17,6,3,62,30,32,57
Coleraine,9078,2,14,10,2,43,24,19,52
Glenavon,9078,3,10,9,7,54,43,11,39
Linfield,9078,4,10,6,10,37,36,1,36
Cliftonville,9078,5,9,5,12,32,31,1,32
Ballymena,9078,6,7,4,15,25,48,-23,25
Glentoran,9078,7,6,6,10,24,32,-8,24
Dungannon,9078,8,2,4,16,14,47,-33,10
Crusaders,9079,1,17,6,3,66,31,35,57
Coleraine,9079,2,14,10,2,43,23,20,52
Glenavon,9079,3,10,9,7,53,43,10,39
Linfield,9079,4,11,5,10,40,37,3,38
Cliftonville,9079,5,9,4,13,33,34,-1,31
Ballymena,9079,6,7,4,15,26,52,-26,25
Glentoran,9079,7,6,6,10,24,32,-8,24
Dungannon,9079,8,2,4,16,14,47,-33,10
Crusaders,9080,1,16,6,4,62,32,30,54
Coleraine,9080,2,14,10,2,43,24,19,52
Glenavon,9080,3,10,9,7,54,43,11,39
Linfield,9080,4,11,5,10,39,37,2,38
Cliftonville,9080,5,9,4,13,33,33,0,31
Ballymena,9080,6,8,4,14,27,48,-21,28
Glentoran,9080,7,6,6,10,24,32,-8,24
Dungannon,9080,8,2,4,16,14,47,-33,10
Crusaders,9081,1,16,7,3,62,31,31,55
Coleraine,9081,2,14,10,2,45,25,20,52
Glenavon,9081,3,10,9,7,55,45,10,39
Linfield,9081,4,11,5,10,40,38,2,38
Cliftonville,9081,5,9,4,13,34,34,0,31
Ballymena,9081,6,7,5,14,26,48,-22,26
Glentoran,9081,7,6,6,10,24,32,-8,24
Dungannon,9081,8,2,4,16,14,47,-33,10
Crusaders,9082,1,17,6,3,63,31,32,57
Coleraine,9082,2,14,10,2,43,23,20,52
Glenavon,9082,3,10,9,7,53,43,10,39
Linfield,9082,4,10,5,11,38,38,0,35
Cliftonville,9082,5,10,4,12,34,32,2,34
Ballymena,9082,6,7,4,15,26,49,-23,25
Glentoran,9082,7,6,6,10,24,32,-8,24
Dungannon,9082,8,2,4,16,14,47,-33,10
Crusaders,9083,1,16,6,4,63,35,28,54
Coleraine,9083,2,14,10,2,45,25,20,52
Glenavon,9083,3,10,9,7,55,45,10,39
Linfield,9083,4,11,5,10,40,36,4,38
Cliftonville,9083,5,9,4,13,32,34,-2,31
Ballymena,9083,6,8,4,14,30,49,-19,28
Glentoran,9083,7,6,6,10,24,32,-8,24
Dungannon,9083,8,2,4,16,14,47,-33,10
Crusaders,9084,1,17,6,3,63,30,33,57
Coleraine,9084,2,15,10,1,45,23,22,55
Linfield,9084,3,11,5,10,39,36,3,38
Glenavon,9084,4,9,9,8,53,45,8,36
Cliftonville,9084,5,9,4,13,32,33,-1,31
Ballymena,9084,6,7,4,15,25,49,-24,25
Glentoran,9084,7,6,6,10,24,32,-8,24
Dungannon,9084,8,2,4,16,14,47,-33,10
Crusaders,9085,1,16,6,4,64,34,30,54
Coleraine,9085,2,14,10,2,43,24,19,52
Glenavon,9085,3,10,9,7,54,43,11,39
Linfield,9085,4,11,5,10,39,36,3,38
Cliftonville,9085,5,9,4,13,32,33,-1,31
Ballymena,9085,6,8,4,14,29,50,-21,28
Glentoran,9085,7,6,6,10,24,32,-8,24
Dungannon,9085,8,2,4,16,14,47,-33,10
Crusaders,9086,1,17,6,3,62,30,32,57
Coleraine,9086,2,14,10,2,43,23,20,52
Glenavon,9086,3,10,9,7,53,43,10,39
Linfield,9086,4,11,5,10,39,36,3,38
Cliftonville,9086,5,9,4,13,32,33,-1,31
Ballymena,9086,6,7,4,15,25,48,-23,25
Glentoran,9086,7,6,6,10,24,32,-8,24
Dungannon,9086,8,2,4,16,14,47,-33,10
Crusaders,9087,1,16,6,4,62,32,30,54
Coleraine,9087,2,14,10,2,46,26,20,52
Glenavon,9087,3,10,9,7,56,46,10,39
Linfield,9087,4,10,5,11,37,37,0,35
Cliftonville,9087,5,10,4,12,33,31,2,34
Ballymena,9087,6,8,4,14,27,48,-21,28
Glentoran,9087,7,6,6,10,24,32,-8,24
Dungannon,9087,8,2,4,16,14,47,-33,10
Crusaders,9088,1,17,6,3,62,30,32,57
Coleraine,9088,2,14,10,2,45,25,20,52
Glenavon,9088,3,10,9,7,55,45,10,39
Linfield,9088,4,11,5,10,40,36,4,38
Cliftonville,9088,5,9,4,13,32,34,-2,31
Ballymena,9088,6,7,4,15,25,48,-23,25
Glentoran,9088,7,6,6,10,24,32,-8,24
Dungannon,9088,8,2,4,16,14,47,-33,10
Crusaders,9089,1,17,6,3,63,31,32,57
Coleraine,9089,2,14,10,2,45,25,20,52
Glenavon,9089,3,10,9,7,55,45,10,39
Linfield,9089,4,10,5,11,37,37,0,35
Cliftonville,9089,5,10,4,12,33,31,2,34
Ballymena,9089,6,7,4,15,26,49,-23,25
Glentoran,9089,7,6,6,10,24,32,-8,24
Dungannon,9089,8,2,4,16,14,47,-33,10
Crusaders,9090,1,16,6,4,61,33,28,54
Coleraine,9090,2,14,11,1,46,25,21,53
Glenavon,9090,3,9,10,7,55,46,9,37
Linfield,9090,4,10,6,10,39,38,1,36
Cliftonville,9090,5,9,5,12,34,33,1,32
Ballymena,9090,6,8,4,14,28,47,-19,28
Glentoran,9090,7,6,6,10,24,32,-8,24
Dungannon,9090,8,2,4,16,14,47,-33,10
Crusaders,9091,1,17,6,3,66,32,34,57
Coleraine,9091,2,14,10,2,44,24,20,52
Glenavon,9091,3,10,9,7,54,44,10,39
Linfield,9091,4,11,5,10,38,36,2,38
Cliftonville,9091,5,9,4,13,32,32,0,31
Ballymena,9091,6,7,4,15,27,52,-25,25
Glentoran,9091,7,6,6,10,24,32,-8,24
Dungannon,9091,8,2,4,16,14,47,-33,10
Crusaders,9092,1,16,6,4,62,32,30,54
Coleraine,9092,2,14,10,2,43,23,20,52
Glenavon,9092,3,10,9,7,53,43,10,39
Linfield,9092,4,11,5,10,39,37,2,38
Cliftonville,9092,5,9,4,13,33,33,0,31
Ballymena,9092,6,8,4,14,27,48,-21,28
Glentoran,9092,7,6,6,10,24,32,-8,24
Dungannon,9092,8,2,4,16,14,47,-33,10
Crusaders,9093,1,17,6,3,63,31,32,57
Coleraine,9093,2,15,10,1,46,23,23,55
Glenavon,9093,3,9,9,8,53,46,7,36
Linfield,9093,4,10,5,11,38,38,0,35
Cliftonville,9093,5,10,4,12,34,32,2,34
Ballymena,9093,6,7,4,15,26,49,-23,25
Glentoran,9093,7,6,6,10,24,32,-8,24
Dungannon,9093,8,2,4,16,14,47,-33,10
Crusaders,9094,1,16,7,3,63,32,31,55
Coleraine,9094,2,14,10,2,45,25,20,52
Glenavon,9094,3,10,9,7,55,45,10,39
Linfield,9094,4,10,5,11,37,37,0,35
Cliftonville,9094,5,10,4,12,33,31,2,34
Ballymena,9094,6,7,5,14,27,49,-22,26
Glentoran,9094,7,6,6,10,24,32,-8,24
Dungannon,9094,8,2,4,16,14,47,-33,10
Crusaders,9095,1,17,6,3,63,30,33,57
Coleraine,9095,2,14,11,1,46,25,21,53
Glenavon,9095,3,9,10,7,55,46,9,37
Linfield,9095,4,10,6,10,39,38,1,36
Cliftonville,9095,5,9,5,12,34,33,1,32
Ballymena,9095,6,7,4,15,25,49,-24,25
Glentoran,9095,7,6,6,10,24,32,-8,24
Dungannon,9095,8,2,4,16,14,47,-33,10
Coleraine,9096,1,15,10,1,44,22,22,55
Crusaders,9096,2,16,6,4,64,34,30,54
Glenavon,9096,3,9,9,8,52,44,8,36
Linfield,9096,4,10,5,11,37,37,0,35
Cliftonville,9096,5,10,4,12,33,31,2,34
Ballymena,9096,6,8,4,14,29,50,-21,28
Glentoran,9096,7,6,6,10,24,32,-8,24
Dungannon,9096,8,2,4,16,14,47,-33,10
Crusaders,9097,1,16,6,4,61,31,30,54
Coleraine,9097,2,14,11,1,45,24,21,53
Linfield,9097,3,11,5,10,39,36,3,38
Glenavon,9097,4,9,10,7,54,45,9,37
Cliftonville,9097,5,9,4,13,32,33,-1,31
Ballymena,9097,6,8,4,14,26,47,-21,28
Glentoran,9097,7,6,6,10,24,32,-8,24
Dungannon,9097,8,2,4,16,14,47,-33,10
Crusaders,9098,1,17,6,3,63,30,33,57
Coleraine,9098,2,15,10,1,48,23,25,55
Glenavon,9098,3,9,9,8,53,48,5,36
Linfield,9098,4,10,5,11,37,37,0,35
Cliftonville,9098,5,10,4,12,33,31,2,34
Ballymena,9098,6,7,4,15,25,49,-24,25
Glentoran,9098,7,6,6,10,24,32,-8,24
Dungannon,9098,8,2,4,16,14,47,-33,10
Crusaders,9099,1,16,7,3,62,31,31,55
Coleraine,9099,2,15,10,1,45,22,23,55
Linfield,9099,3,11,5,10,38,36,2,38
Glenavon,9099,4,9,9,8,52,45,7,36
Cliftonville,9099,5,9,4,13,32,32,0,31
Ballymena,9099,6,7,5,14,26,48,-22,26
Glentoran,9099,7,6,6,10,24,32,-8,24
Dungannon,9099,8,2,4,16,14,47,-33,10
Crusaders,9100,1,16,7,3,61,30,31,55
Coleraine,9100,2,14,11,1,44,23,21,53
Glenavon,9100,3,9,10,7,53,44,9,37
Linfield,9100,4,10,6,10,38,37,1,36
Cliftonville,9100,5,9,5,12,33,32,1,32
Ballymena,9100,6,7,5,14,25,47,-22,26
Glentoran,9100,7,6,6,10,24,32,-8,24
Dungannon,9100,8,2,4,16,14,47,-33,10
Crusaders,9101,1,16,6,4,61,31,30,54
Coleraine,9101,2,14,11,1,44,23,21,53
Linfield,9101,3,11,5,10,39,36,3,38
Glenavon,9101,4,9,10,7,53,44,9,37
Cliftonville,9101,5,9,4,13,32,33,-1,31
Ballymena,9101,6,8,4,14,26,47,-21,28
Glentoran,9101,7,6,6,10,24,32,-8,24
Dungannon,9101,8,2,4,16,14,47,-33,10
Crusaders,9102,1,17,6,3,64,31,33,57
Coleraine,9102,2,14,10,2,45,25,20,52
Glenavon,9102,3,10,9,7,55,45,10,39
Linfield,9102,4,11,5,10,40,37,3,38
Cliftonville,9102,5,9,4,13,33,34,-1,31
Ballymena,9102,6,7,4,15,26,50,-24,25
Glentoran,9102,7,6,6,10,24,32,-8,24
Dungannon,9102,8,2,4,16,14,47,-33,10
Crusaders,9103,1,17,6,3,65,32,33,57
Coleraine,9103,2,15,10,1,45,22,23,55
Glenavon,9103,3,9,9,8,52,45,7,36
Linfield,9103,4,10,5,11,37,38,-1,35
Cliftonville,9103,5,10,4,12,34,31,3,34
Ballymena,9103,6,7,4,15,27,51,-24,25
Glentoran,9103,7,6,6,10,24,32,-8,24
Dungannon,9103,8,2,4,16,14,47,-33,10
Crusaders,9104,1,17,6,3,63,31,32,57
Coleraine,9104,2,14,11,1,43,22,21,53
Glenavon,9104,3,9,10,7,52,43,9,37
Linfield,9104,4,10,6,10,38,37,1,36
Cliftonville,9104,5,9,5,12,33,32,1,32
Ballymena,9104,6,7,4,15,26,49,-23,25
Glentoran,9104,7,6,6,10,24,32,-8,24
Dungannon,9104,8,2,4,16,14,47,-33,10
Crusaders,9105,1,17,6,3,62,30,32,57
Coleraine,9105,2,14,11,1,44,23,21,53
Linfield,9105,3,11,5,10,39,37,2,38
Glenavon,9105,4,9,10,7,53,44,9,37
Cliftonville,9105,5,9,4,13,33,33,0,31
Ballymena,9105,6,7,4,15,25,48,-23,25
Glentoran,9105,7,6,6,10,24,32,-8,24
Dungannon,9105,8,2,4,16,14,47,-33,10
Crusaders,9106,1,16,6,4,61,31,30,54
Coleraine,9106,2,14,10,2,43,24,19,52
Glenavon,9106,3,10,9,7,54,43,11,39
Linfield,9106,4,10,6,10,39,38,1,36
Cliftonville,9106,5,9,5,12,34,33,1,32
Ballymena,9106,6,8,4,14,26,47,-21,28
Glentoran,9106,7,6,6,10,24,32,-8,24
Dungannon,9106,8,2,4,16,14,47,-33,10
Crusaders,9107,1,17,6,3,63,31,32,57
Coleraine,9107,2,15,10,1,44,22,22,55
Glenavon,9107,3,9,9,8,52,44,8,36
Linfield,9107,4,10,6,10,38,37,1,36
Cliftonville,9107,5,9,5,12,33,32,1,32
Ballymena,9107,6,7,4,15,26,49,-23,25
Glentoran,9107,7,6,6,10,24,32,-8,24
Dungannon,9107,8,2,4,16,14,47,-33,10
Crusaders,9108,1,17,6,3,63,30,33,57
Coleraine,9108,2,15,10,1,44,22,22,55
Linfield,9108,3,11,5,10,39,36,3,38
Glenavon,9108,4,9,9,8,52,44,8,36
Cliftonville,9108,5,9,4,13,32,33,-1,31
Ballymena,9108,6,7,4,15,25,49,-24,25
Glentoran,9108,7,6,6,10,24,32,-8,24
Dungannon,9108,8,2,4,16,14,47,-33,10
Crusaders,9109,1,17,6,3,63,31,32,57
Coleraine,9109,2,15,10,1,46,23,23,55
Glenavon,9109,3,9,9,8,53,46,7,36
Linfield,9109,4,10,5,11,39,39,0,35
Cliftonville,9109,5,10,4,12,35,33,2,34
Ballymena,9109,6,7,4,15,26,49,-23,25
Glentoran,9109,7,6,6,10,24,32,-8,24
Dungannon,9109,8,2,4,16,14,47,-33,10
Crusaders,9110,1,16,6,4,61,31,30,54
Coleraine,9110,2,14,10,2,43,23,20,52
Glenavon,9110,3,10,9,7,53,43,10,39
Linfield,9110,4,10,6,10,38,37,1,36
Cliftonville,9110,5,9,5,12,33,32,1,32
Ballymena,9110,6,8,4,14,26,47,-21,28
Glentoran,9110,7,6,6,10,24,32,-8,24
Dungannon,9110,8,2,4,16,14,47,-33,10
Crusaders,9111,1,16,7,3,62,31,31,55
Coleraine,9111,2,15,10,1,45,22,23,55
Linfield,9111,3,11,5,10,40,38,2,38
Glenavon,9111,4,9,9,8,52,45,7,36
Cliftonville,9111,5,9,4,13,34,34,0,31
Ballymena,9111,6,7,5,14,26,48,-22,26
Glentoran,9111,7,6,6,10,24,32,-8,24
Dungannon,9111,8,2,4,16,14,47,-33,10
Crusaders,9112,1,16,7,3,62,31,31,55
Coleraine,9112,2,15,10,1,45,23,22,55
Glenavon,9112,3,9,9,8,53,45,8,36
Linfield,9112,4,10,6,10,37,36,1,36
Cliftonville,9112,5,9,5,12,32,31,1,32
Ballymena,9112,6,7,5,14,26,48,-22,26
Glentoran,9112,7,6,6,10,24,32,-8,24
Dungannon,9112,8,2,4,16,14,47,-33,10
Crusaders,9113,1,17,6,3,64,31,33,57
Coleraine,9113,2,14,11,1,46,25,21,53
Glenavon,9113,3,9,10,7,55,46,9,37
Linfield,9113,4,10,6,10,38,37,1,36
Cliftonville,9113,5,9,5,12,33,32,1,32
Ballymena,9113,6,7,4,15,26,50,-24,25
Glentoran,9113,7,6,6,10,24,32,-8,24
Dungannon,9113,8,2,4,16,14,47,-33,10
Coleraine,9114,1,15,10,1,47,24,23,55
Crusaders,9114,2,16,6,4,63,33,30,54
Glenavon,9114,3,9,9,8,54,47,7,36
Linfield,9114,4,10,5,11,37,39,-2,35
Cliftonville,9114,5,10,4,12,35,31,4,34
Ballymena,9114,6,8,4,14,28,49,-21,28
Glentoran,9114,7,6,6,10,24,32,-8,24
Dungannon,9114,8,2,4,16,14,47,-33,10
Crusaders,9115,1,17,6,3,67,31,36,57
Coleraine,9115,2,14,11,1,44,23,21,53
Linfield,9115,3,11,5,10,38,36,2,38
Glenavon,9115,4,9,10,7,53,44,9,37
Cliftonville,9115,5,9,4,13,32,32,0,31
Ballymena,9115,6,7,4,15,26,53,-27,25
Glentoran,9115,7,6,6,10,24,32,-8,24
Dungannon,9115,8,2,4,16,14,47,-33,10
Crusaders,9116,1,16,7,3,62,31,31,55
Coleraine,9116,2,14,11,1,46,25,21,53
Linfield,9116,3,11,5,10,39,37,2,38
Glenavon,9116,4,9,10,7,55,46,9,37
Cliftonville,9116,5,9,4,13,33,33,0,31
Ballymena,9116,6,7,5,14,26,48,-22,26
Glentoran,9116,7,6,6,10,24,32,-8,24
Dungannon,9116,8,2,4,16,14,47,-33,10
Crusaders,9117,1,17,6,3,65,32,33,57
Coleraine,9117,2,14,10,2,43,24,19,52
Glenavon,9117,3,10,9,7,54,43,11,39
Linfield,9117,4,10,6,10,37,36,1,36
Cliftonville,9117,5,9,5,12,32,31,1,32
Ballymena,9117,6,7,4,15,27,51,-24,25
Glentoran,9117,7,6,6,10,24,32,-8,24
Dungannon,9117,8,2,4,16,14,47,-33,10
Crusaders,9118,1,16,7,3,62,31,31,55
Coleraine,9118,2,14,10,2,43,23,20,52
Glenavon,9118,3,10,9,7,53,43,10,39
Linfield,9118,4,10,6,10,38,37,1,36
Cliftonville,9118,5,9,5,12,33,32,1,32
Ballymena,9118,6,7,5,14,26,48,-22,26
Glentoran,9118,7,6,6,10,24,32,-8,24
Dungannon,9118,8,2,4,16,14,47,-33,10
Crusaders,9119,1,16,7,3,63,32,31,55
Coleraine,9119,2,15,10,1,44,22,22,55
Linfield,9119,3,11,5,10,38,36,2,38
Glenavon,9119,4,9,9,8,52,44,8,36
Cliftonville,9119,5,9,4,13,32,32,0,31
Ballymena,9119,6,7,5,14,27,49,-22,26
Glentoran,9119,7,6,6,10,24,32,-8,24
Dungannon,9119,8,2,4,16,14,47,-33,10
Crusaders,9120,1,17,6,3,65,31,34,57
Coleraine,9120,2,14,11,1,45,24,21,53
Linfield,9120,3,11,5,10,40,37,3,38
Glenavon,9120,4,9,10,7,54,45,9,37
Cliftonville,9120,5,9,4,13,33,34,-1,31
Ballymena,9120,6,7,4,15,26,51,-25,25
Glentoran,9120,7,6,6,10,24,32,-8,24
Dungannon,9120,8,2,4,16,14,47,-33,10
Crusaders,9121,1,17,6,3,63,31,32,57
Coleraine,9121,2,14,10,2,43,23,20,52
Glenavon,9121,3,10,9,7,53,43,10,39
Linfield,9121,4,10,5,11,38,39,-1,35
Cliftonville,9121,5,10,4,12,35,32,3,34
Ballymena,9121,6,7,4,15,26,49,-23,25
Glentoran,9121,7,6,6,10,24,32,-8,24
Dungannon,9121,8,2,4,16,14,47,-33,10
Crusaders,9122,1,16,7,3,63,32,31,55
Coleraine,9122,2,14,11,1,44,23,21,53
Glenavon,9122,3,9,10,7,53,44,9,37
Linfield,9122,4,10,6,10,38,37,1,36
Cliftonville,9122,5,9,5,12,33,32,1,32
Ballymena,9122,6,7,5,14,27,49,-22,26
Glentoran,9122,7,6,6,10,24,32,-8,24
Dungannon,9122,8,2,4,16,14,47,-33,10
Crusaders,9123,1,17,6,3,63,30,33,57
Coleraine,9123,2,14,10,2,43,24,19,52
Glenavon,9123,3,10,9,7,54,43,11,39
Linfield,9123,4,10,6,10,38,37,1,36
Cliftonville,9123,5,9,5,12,33,32,1,32
Ballymena,9123,6,7,4,15,25,49,-24,25
Glentoran,9123,7,6,6,10,24,32,-8,24
Dungannon,9123,8,2,4,16,14,47,-33,10
Coleraine,9124,1,15,10,1,46,24,22,55
Crusaders,9124,2,16,6,4,61,31,30,54
Glenavon,9124,3,9,9,8,54,46,8,36
Linfield,9124,4,10,5,11,37,39,-2,35
Cliftonville,9124,5,10,4,12,35,31,4,34
Ballymena,9124,6,8,4,14,26,47,-21,28
Glentoran,9124,7,6,6,10,24,32,-8,24
Dungannon,9124,8,2,4,16,14,47,-33,10
Crusaders,9125,1,17,6,3,63,31,32,57
Coleraine,9125,2,14,10,2,45,26,19,52
Glenavon,9125,3,10,9,7,56,45,11,39
Linfield,9125,4,10,5,11,37,37,0,35
Cliftonville,9125,5,10,4,12,33,31,2,34
Ballymena,9125,6,7,4,15,26,49,-23,25
Glentoran,9125,7,6,6,10,24,32,-8,24
Dungannon,9125,8,2,4,16,14,47,-33,10
Crusaders,9126,1,17,6,3,65,30,35,57
Coleraine,9126,2,15,10,1,46,24,22,55
Linfield,9126,3,11,5,10,39,36,3,38
Glenavon,9126,4,9,9,8,54,46,8,36
Cliftonville,9126,5,9,4,13,32,33,-1,31
Ballymena,9126,6,7,4,15,25,51,-26,25
Glentoran,9126,7,6,6,10,24,32,-8,24
Dungannon,9126,8,2,4,16,14,47,-33,10
Crusaders,9127,1,16,7,3,63,32,31,55
Coleraine,9127,2,14,11,1,44,23,21,53
Glenavon,9127,3,9,10,7,53,44,9,37
Linfield,9127,4,10,6,10,37,36,1,36
Cliftonville,9127,5,9,5,12,32,31,1,32
Ballymena,9127,6,7,5,14,27,49,-22,26
Glentoran,9127,7,6,6,10,24,32,-8,24
Dungannon,9127,8,2,4,16,14,47,-33,10
Crusaders,9128,1,16,7,3,62,31,31,55
Coleraine,9128,2,15,10,1,46,22,24,55
Linfield,9128,3,11,5,10,40,38,2,38
Glenavon,9128,4,9,9,8,52,46,6,36
Cliftonville,9128,5,9,4,13,34,34,0,31
Ballymena,9128,6,7,5,14,26,48,-22,26
Glentoran,9128,7,6,6,10,24,32,-8,24
Dungannon,9128,8,2,4,16,14,47,-33,10
Crusaders,9129,1,17,6,3,63,31,32,57
Coleraine,9129,2,14,10,2,44,24,20,52
Glenavon,9129,3,10,9,7,54,44,10,39
Linfield,9129,4,11,5,10,40,36,4,38
Cliftonville,9129,5,9,4,13,32,34,-2,31
Ballymena,9129,6,7,4,15,26,49,-23,25
Glentoran,9129,7,6,6,10,24,32,-8,24
Dungannon,9129,8,2,4,16,14,47,-33,10
Coleraine,9130,1,15,10,1,45,23,22,55
Crusaders,9130,2,16,6,4,62,32,30,54
Glenavon,9130,3,9,9,8,53,45,8,36
Linfield,9130,4,10,5,11,37,37,0,35
Cliftonville,9130,5,10,4,12,33,31,2,34
Ballymena,9130,6,8,4,14,27,48,-21,28
Glentoran,9130,7,6,6,10,24,32,-8,24
Dungannon,9130,8,2,4,16,14,47,-33,10
Crusaders,9131,1,17,6,3,63,31,32,57
Coleraine,9131,2,15,10,1,45,23,22,55
Glenavon,9131,3,9,9,8,53,45,8,36
Linfield,9131,4,10,6,10,37,36,1,36
Cliftonville,9131,5,9,5,12,32,31,1,32
Ballymena,9131,6,7,4,15,26,49,-23,25
Glentoran,9131,7,6,6,10,24,32,-8,24
Dungannon,9131,8,2,4,16,14,47,-33,10
Crusaders,9132,1,16,7,3,63,32,31,55
Coleraine,9132,2,14,10,2,45,25,20,52
Glenavon,9132,3,10,9,7,55,45,10,39
Linfield,9132,4,11,5,10,41,36,5,38
Cliftonville,9132,5,9,4,13,32,35,-3,31
Ballymena,9132,6,7,5,14,27,49,-22,26
Glentoran,9132,7,6,6,10,24,32,-8,24
Dungannon,9132,8,2,4,16,14,47,-33,10
Crusaders,9133,1,17,6,3,63,31,32,57
Coleraine,9133,2,14,11,1,44,23,21,53
Glenavon,9133,3,9,10,7,53,44,9,37
Linfield,9133,4,10,5,11,37,38,-1,35
Cliftonville,9133,5,10,4,12,34,31,3,34
Ballymena,9133,6,7,4,15,26,49,-23,25
Glentoran,9133,7,6,6,10,24,32,-8,24
Dungannon,9133,8,2,4,16,14,47,-33,10
Crusaders,9134,1,17,6,3,64,32,32,57
Coleraine,9134,2,15,10,1,47,23,24,55
Glenavon,9134,3,9,9,8,53,47,6,36
Linfield,9134,4,10,5,11,39,39,0,35
Cliftonville,9134,5,10,4,12,35,33,2,34
Ballymena,9134,6,7,4,15,27,50,-23,25
Glentoran,9134,7,6,6,10,24,32,-8,24
Dungannon,9134,8,2,4,16,14,47,-33,10
Crusaders,9135,1,16,6,4,62,33,29,54
Coleraine,9135,2,14,11,1,43,22,21,53
Glenavon,9135,3,9,10,7,52,43,9,37
Linfield,9135,4,10,6,10,38,37,1,36
Cliftonville,9135,5,9,5,12,33,32,1,32
Ballymena,9135,6,8,4,14,28,48,-20,28
Glentoran,9135,7,6,6,10,24,32,-8,24
Dungannon,9135,8,2,4,16,14,47,-33,10
Crusaders,9136,1,17,6,3,64,31,33,57
Coleraine,9136,2,14,11,1,45,24,21,53
Glenavon,9136,3,9,10,7,54,45,9,37
Linfield,9136,4,10,5,11,38,39,-1,35
Cliftonville,9136,5,10,4,12,35,32,3,34
Ballymena,9136,6,7,4,15,26,50,-24,25
Glentoran,9136,7,6,6,10,24,32,-8,24
Dungannon,9136,8,2,4,16,14,47,-33,10
Crusaders,9137,1,17,6,3,63,31,32,57
Coleraine,9137,2,14,10,2,44,26,18,52
Glenavon,9137,3,10,9,7,56,44,12,39
Linfield,9137,4,11,5,10,39,37,2,38
Cliftonville,9137,5,9,4,13,33,33,0,31
Ballymena,9137,6,7,4,15,26,49,-23,25
Glentoran,9137,7,6,6,10,24,32,-8,24
Dungannon,9137,8,2,4,16,14,47,-33,10
Crusaders,9138,1,16,7,3,62,31,31,55
Coleraine,9138,2,14,10,2,43,24,19,52
Glenavon,9138,3,10,9,7,54,43,11,39
Linfield,9138,4,11,5,10,40,37,3,38
Cliftonville,9138,5,9,4,13,33,34,-1,31
Ballymena,9138,6,7,5,14,26,48,-22,26
Glentoran,9138,7,6,6,10,24,32,-8,24
Dungannon,9138,8,2,4,16,14,47,-33,10
Crusaders,9139,1,17,6,3,64,32,32,57
Coleraine,9139,2,14,11,1,45,24,21,53
Linfield,9139,3,11,5,10,38,36,2,38
Glenavon,9139,4,9,10,7,54,45,9,37
Cliftonville,9139,5,9,4,13,32,32,0,31
Ballymena,9139,6,7,4,15,27,50,-23,25
Glentoran,9139,7,6,6,10,24,32,-8,24
Dungannon,9139,8,2,4,16,14,47,-33,10
Coleraine,9140,1,15,10,1,47,22,25,55
Crusaders,9140,2,16,6,4,61,32,29,54
Linfield,9140,3,11,5,10,39,37,2,38
Glenavon,9140,4,9,9,8,52,47,5,36
Cliftonville,9140,5,9,4,13,33,33,0,31
Ballymena,9140,6,8,4,14,27,47,-20,28
Glentoran,9140,7,6,6,10,24,32,-8,24
Dungannon,9140,8,2,4,16,14,47,-33,10
Crusaders,9141,1,16,6,4,62,32,30,54
Coleraine,9141,2,14,10,2,44,25,19,52
Glenavon,9141,3,10,9,7,55,44,11,39
Linfield,9141,4,10,5,11,37,38,-1,35
Cliftonville,9141,5,10,4,12,34,31,3,34
Ballymena,9141,6,8,4,14,27,48,-21,28
Glentoran,9141,7,6,6,10,24,32,-8,24
Dungannon,9141,8,2,4,16,14,47,-33,10
Crusaders,9142,1,17,6,3,64,31,33,57
Coleraine,9142,2,15,10,1,45,23,22,55
Glenavon,9142,3,9,9,8,53,45,8,36
Linfield,9142,4,10,5,11,38,38,0,35
Cliftonville,9142,5,10,4,12,34,32,2,34
Ballymena,9142,6,7,4,15,26,50,-24,25
Glentoran,9142,7,6,6,10,24,32,-8,24
Dungannon,9142,8,2,4,16,14,47,-33,10
Crusaders,9143,1,17,6,3,64,32,32,57
Coleraine,9143,2,15,10,1,44,22,22,55
Glenavon,9143,3,9,9,8,52,44,8,36
Linfield,9143,4,10,5,11,38,38,0,35
Cliftonville,9143,5,10,4,12,34,32,2,34
Ballymena,9143,6,7,4,15,27,50,-23,25
Glentoran,9143,7,6,6,10,24,32,-8,24
Dungannon,9143,8,2,4,16,14,47,-33,10
Crusaders,9144,1,17,6,3,65,32,33,57
Coleraine,9144,2,15,10,1,44,22,22,55
Linfield,9144,3,11,5,10,41,37,4,38
Glenavon,9144,4,9,9,8,52,44,8,36
Cliftonville,9144,5,9,4,13,33,35,-2,31
Ballymena,9144,6,7,4,15,27,51,-24,25
Glentoran,9144,7,6,6,10,24,32,-8,24
Dungannon,9144,8,2,4,16,14,47,-33,10
Crusaders,9145,1,17,6,3,62,30,32,57
Coleraine,9145,2,14,11,1,43,22,21,53
Glenavon,9145,3,9,10,7,52,43,9,37
Linfield,9145,4,10,6,10,38,37,1,36
Cliftonville,9145,5,9,5,12,33,32,1,32
Ballymena,9145,6,7,4,15,25,48,-23,25
Glentoran,9145,7,6,6,10,24,32,-8,24
Dungannon,9145,8,2,4,16,14,47,-33,10
Crusaders,9146,1,17,6,3,67,31,36,57
Coleraine,9146,2,14,11,1,43,22,21,53
Linfield,9146,3,11,5,10,39,36,3,38
Glenavon,9146,4,9,10,7,52,43,9,37
Cliftonville,9146,5,9,4,13,32,33,-1,31
Ballymena,9146,6,7,4,15,26,53,-27,25
Glentoran,9146,7,6,6,10,24,32,-8,24
Dungannon,9146,8,2,4,16,14,47,-33,10
Crusaders,9147,1,17,6,3,63,31,32,57
Coleraine,9147,2,15,10,1,45,23,22,55
Linfield,9147,3,11,5,10,39,36,3,38
Glenavon,9147,4,9,9,8,53,45,8,36
Cliftonville,9147,5,9,4,13,32,33,-1,31
Ballymena,9147,6,7,4,15,26,49,-23,25
Glentoran,9147,7,6,6,10,24,32,-8,24
Dungannon,9147,8,2,4,16,14,47,-33,10
Crusaders,9148,1,16,7,3,61,30,31,55
Coleraine,9148,2,14,10,2,43,28,15,52
Glenavon,9148,3,10,9,7,58,43,15,39
Linfield,9148,4,10,6,10,38,37,1,36
Cliftonville,9148,5,9,5,12,33,32,1,32
Ballymena,9148,6,7,5,14,25,47,-22,26
Glentoran,9148,7,6,6,10,24,32,-8,24
Dungannon,9148,8,2,4,16,14,47,-33,10
Crusaders,9149,1,16,7,3,61,30,31,55
Coleraine,9149,2,14,11,1,44,23,21,53
Linfield,9149,3,11,5,10,40,37,3,38
Glenavon,9149,4,9,10,7,53,44,9,37
Cliftonville,9149,5,9,4,13,33,34,-1,31
Ballymena,9149,6,7,5,14,25,47,-22,26
Glentoran,9149,7,6,6,10,24,32,-8,24
Dungannon,9149,8,2,4,16,14,47,-33,10
Crusaders,9150,1,17,6,3,62,30,32,57
Coleraine,9150,2,14,10,2,43,25,18,52
Glenavon,9150,3,10,9,7,55,43,12,39
Linfield,9150,4,11,5,10,41,38,3,38
Cliftonville,9150,5,9,4,13,34,35,-1,31
Ballymena,9150,6,7,4,15,25,48,-23,25
Glentoran,9150,7,6,6,10,24,32,-8,24
Dungannon,9150,8,2,4,16,14,47,-33,10
Coleraine,9151,1,15,10,1,45,22,23,55
Crusaders,9151,2,16,6,4,61,33,28,54
Glenavon,9151,3,9,9,8,52,45,7,36
Linfield,9151,4,10,5,11,38,39,-1,35
Cliftonville,9151,5,10,4,12,35,32,3,34
Ballymena,9151,6,8,4,14,28,47,-19,28
Glentoran,9151,7,6,6,10,24,32,-8,24
Dungannon,9151,8,2,4,16,14,47,-33,10
Crusaders,9152,1,16,6,4,62,32,30,54
Coleraine,9152,2,14,11,1,44,23,21,53
Linfield,9152,3,11,5,10,40,36,4,38
Glenavon,9152,4,9,10,7,53,44,9,37
Cliftonville,9152,5,9,4,13,32,34,-2,31
Ballymena,9152,6,8,4,14,27,48,-21,28
Glentoran,9152,7,6,6,10,24,32,-8,24
Dungannon,9152,8,2,4,16,14,47,-33,10
Crusaders,9153,1,16,7,3,61,30,31,55
Coleraine,9153,2,15,10,1,47,22,25,55
Linfield,9153,3,11,5,10,39,37,2,38
Glenavon,9153,4,9,9,8,52,47,5,36
Cliftonville,9153,5,9,4,13,33,33,0,31
Ballymena,9153,6,7,5,14,25,47,-22,26
Glentoran,9153,7,6,6,10,24,32,-8,24
Dungannon,9153,8,2,4,16,14,47,-33,10
Crusaders,9154,1,17,6,3,63,31,32,57
Coleraine,9154,2,14,10,2,43,24,19,52
Glenavon,9154,3,10,9,7,54,43,11,39
Linfield,9154,4,11,5,10,39,36,3,38
Cliftonville,9154,5,9,4,13,32,33,-1,31
Ballymena,9154,6,7,4,15,26,49,-23,25
Glentoran,9154,7,6,6,10,24,32,-8,24
Dungannon,9154,8,2,4,16,14,47,-33,10
Coleraine,9155,1,15,10,1,45,23,22,55
Crusaders,9155,2,16,6,4,63,33,30,54
Glenavon,9155,3,9,9,8,53,45,8,36
Linfield,9155,4,10,5,11,37,37,0,35
Cliftonville,9155,5,10,4,12,33,31,2,34
Ballymena,9155,6,8,4,14,28,49,-21,28
Glentoran,9155,7,6,6,10,24,32,-8,24
Dungannon,9155,8,2,4,16,14,47,-33,10
Coleraine,9156,1,15,10,1,45,22,23,55
Crusaders,9156,2,16,6,4,61,32,29,54
Glenavon,9156,3,9,9,8,52,45,7,36
Linfield,9156,4,10,6,10,38,37,1,36
Cliftonville,9156,5,9,5,12,33,32,1,32
Ballymena,9156,6,8,4,14,27,47,-20,28
Glentoran,9156,7,6,6,10,24,32,-8,24
Dungannon,9156,8,2,4,16,14,47,-33,10
Crusaders,9157,1,17,6,3,65,32,33,57
Coleraine,9157,2,15,10,1,47,25,22,55
Glenavon,9157,3,9,9,8,55,47,8,36
Linfield,9157,4,10,6,10,38,37,1,36
Cliftonville,9157,5,9,5,12,33,32,1,32
Ballymena,9157,6,7,4,15,27,51,-24,25
Glentoran,9157,7,6,6,10,24,32,-8,24
Dungannon,9157,8,2,4,16,14,47,-33,10
Crusaders,9158,1,16,7,3,62,31,31,55
Coleraine,9158,2,15,10,1,45,22,23,55
Linfield,9158,3,11,5,10,39,36,3,38
Glenavon,9158,4,9,9,8,52,45,7,36
Cliftonville,9158,5,9,4,13,32,33,-1,31
Ballymena,9158,6,7,5,14,26,48,-22,26
Glentoran,9158,7,6,6,10,24,32,-8,24
Dungannon,9158,8,2,4,16,14,47,-33,10
Crusaders,9159,1,17,6,3,62,30,32,57
Coleraine,9159,2,14,11,1,44,23,21,53
Glenavon,9159,3,9,10,7,53,44,9,37
Linfield,9159,4,10,5,11,38,38,0,35
Cliftonville,9159,5,10,4,12,34,32,2,34
Ballymena,9159,6,7,4,15,25,48,-23,25
Glentoran,9159,7,6,6,10,24,32,-8,24
Dungannon,9159,8,2,4,16,14,47,-33,10
Coleraine,9160,1,15,10,1,45,23,22,55
Crusaders,9160,2,16,6,4,61,31,30,54
Glenavon,9160,3,9,9,8,53,45,8,36
Linfield,9160,4,10,5,11,37,37,0,35
Cliftonville,9160,5,10,4,12,33,31,2,34
Ballymena,9160,6,8,4,14,26,47,-21,28
Glentoran,9160,7,6,6,10,24,32,-8,24
Dungannon,9160,8,2,4,16,14,47,-33,10
Coleraine,9161,1,15,10,1,45,23,22,55
Crusaders,9161,2,16,6,4,61,31,30,54
Glenavon,9161,3,9,9,8,53,45,8,36
Linfield,9161,4,10,6,10,37,36,1,36
Cliftonville,9161,5,9,5,12,32,31,1,32
Ballymena,9161,6,8,4,14,26,47,-21,28
Glentoran,9161,7,6,6,10,24,32,-8,24
Dungannon,9161,8,2,4,16,14,47,-33,10
Crusaders,9162,1,17,6,3,62,30,32,57
Coleraine,9162,2,14,10,2,44,26,18,52
Glenavon,9162,3,10,9,7,56,44,12,39
Linfield,9162,4,10,6,10,38,37,1,36
Cliftonville,9162,5,9,5,12,33,32,1,32
Ballymena,9162,6,7,4,15,25,48,-23,25
Glentoran,9162,7,6,6,10,24,32,-8,24
Dungannon,9162,8,2,4,16,14,47,-33,10
Crusaders,9163,1,17,6,3,63,30,33,57
Coleraine,9163,2,14,11,1,43,22,21,53
Linfield,9163,3,11,5,10,38,36,2,38
Glenavon,9163,4,9,10,7,52,43,9,37
Cliftonville,9163,5,9,4,13,32,32,0,31
Ballymena,9163,6,7,4,15,25,49,-24,25
Glentoran,9163,7,6,6,10,24,32,-8,24
Dungannon,9163,8,2,4,16,14,47,-33,10
Crusaders,9164,1,16,6,4,61,31,30,54
Coleraine,9164,2,14,10,2,43,25,18,52
Glenavon,9164,3,10,9,7,55,43,12,39
Linfield,9164,4,11,5,10,39,36,3,38
Cliftonville,9164,5,9,4,13,32,33,-1,31
Ballymena,9164,6,8,4,14,26,47,-21,28
Glentoran,9164,7,6,6,10,24,32,-8,24
Dungannon,9164,8,2,4,16,14,47,-33,10
Crusaders,9165,1,17,6,3,62,30,32,57
Coleraine,9165,2,15,10,1,45,22,23,55
Glenavon,9165,3,9,9,8,52,45,7,36
Linfield,9165,4,10,6,10,40,39,1,36
Cliftonville,9165,5,9,5,12,35,34,1,32
Ballymena,9165,6,7,4,15,25,48,-23,25
Glentoran,9165,7,6,6,10,24,32,-8,24
Dungannon,9165,8,2,4,16,14,47,-33,10
Crusaders,9166,1,16,6,4,61,31,30,54
Coleraine,9166,2,14,11,1,44,23,21,53
Linfield,9166,3,11,5,10,38,36,2,38
Glenavon,9166,4,9,10,7,53,44,9,37
Cliftonville,9166,5,9,4,13,32,32,0,31
Ballymena,9166,6,8,4,14,26,47,-21,28
Glentoran,9166,7,6,6,10,24,32,-8,24
Dungannon,9166,8,2,4,16,14,47,-33,10
Crusaders,9167,1,16,6,4,61,32,29,54
Coleraine,9167,2,14,10,2,43,24,19,52
Glenavon,9167,3,10,9,7,54,43,11,39
Linfield,9167,4,10,5,11,37,37,0,35
Cliftonville,9167,5,10,4,12,33,31,2,34
Ballymena,9167,6,8,4,14,27,47,-20,28
Glentoran,9167,7,6,6,10,24,32,-8,24
Dungannon,9167,8,2,4,16,14,47,-33,10
Crusaders,9168,1,17,6,3,64,30,34,57
Coleraine,9168,2,14,10,2,44,25,19,52
Glenavon,9168,3,10,9,7,55,44,11,39
Linfield,9168,4,10,6,10,37,36,1,36
Cliftonville,9168,5,9,5,12,32,31,1,32
Ballymena,9168,6,7,4,15,25,50,-25,25
Glentoran,9168,7,6,6,10,24,32,-8,24
Dungannon,9168,8,2,4,16,14,47,-33,10
Crusaders,9169,1,17,6,3,64,32,32,57
Coleraine,9169,2,14,10,2,44,25,19,52
Glenavon,9169,3,10,9,7,55,44,11,39
Linfield,9169,4,11,5,10,38,36,2,38
Cliftonville,9169,5,9,4,13,32,32,0,31
Ballymena,9169,6,7,4,15,27,50,-23,25
Glentoran,9169,7,6,6,10,24,32,-8,24
Dungannon,9169,8,2,4,16,14,47,-33,10
Crusaders,9170,1,17,6,3,63,31,32,57
Coleraine,9170,2,14,11,1,46,25,21,53
Linfield,9170,3,11,5,10,38,36,2,38
Glenavon,9170,4,9,10,7,55,46,9,37
Cliftonville,9170,5,9,4,13,32,32,0,31
Ballymena,9170,6,7,4,15,26,49,-23,25
Glentoran,9170,7,6,6,10,24,32,-8,24
Dungannon,9170,8,2,4,16,14,47,-33,10
Crusaders,9171,1,17,6,3,64,30,34,57
Coleraine,9171,2,14,10,2,46,28,18,52
Glenavon,9171,3,10,9,7,58,46,12,39
Linfield,9171,4,10,6,10,38,37,1,36
Cliftonville,9171,5,9,5,12,33,32,1,32
Ballymena,9171,6,7,4,15,25,50,-25,25
Glentoran,9171,7,6,6,10,24,32,-8,24
Dungannon,9171,8,2,4,16,14,47,-33,10
Crusaders,9172,1,17,6,3,63,30,33,57
Coleraine,9172,2,15,10,1,46,22,24,55
Glenavon,9172,3,9,9,8,52,46,6,36
Linfield,9172,4,10,6,10,38,37,1,36
Cliftonville,9172,5,9,5,12,33,32,1,32
Ballymena,9172,6,7,4,15,25,49,-24,25
Glentoran,9172,7,6,6,10,24,32,-8,24
Dungannon,9172,8,2,4,16,14,47,-33,10
Crusaders,9173,1,17,6,3,63,31,32,57
Coleraine,9173,2,14,11,1,45,24,21,53
Linfield,9173,3,11,5,10,39,37,2,38
Glenavon,9173,4,9,10,7,54,45,9,37
Cliftonville,9173,5,9,4,13,33,33,0,31
Ballymena,9173,6,7,4,15,26,49,-23,25
Glentoran,9173,7,6,6,10,24,32,-8,24
Dungannon,9173,8,2,4,16,14,47,-33,10
Crusaders,9174,1,17,6,3,64,30,34,57
Coleraine,9174,2,14,10,2,44,25,19,52
Glenavon,9174,3,10,9,7,55,44,11,39
Linfield,9174,4,11,5,10,38,36,2,38
Cliftonville,9174,5,9,4,13,32,32,0,31
Ballymena,9174,6,7,4,15,25,50,-25,25
Glentoran,9174,7,6,6,10,24,32,-8,24
Dungannon,9174,8,2,4,16,14,47,-33,10
Crusaders,9175,1,17,6,3,63,30,33,57
Coleraine,9175,2,14,11,1,45,24,21,53
Glenavon,9175,3,9,10,7,54,45,9,37
Linfield,9175,4,10,6,10,38,37,1,36
Cliftonville,9175,5,9,5,12,33,32,1,32
Ballymena,9175,6,7,4,15,25,49,-24,25
Glentoran,9175,7,6,6,10,24,32,-8,24
Dungannon,9175,8,2,4,16,14,47,-33,10
Crusaders,9176,1,17,6,3,63,31,32,57
Coleraine,9176,2,14,10,2,44,25,19,52
Glenavon,9176,3,10,9,7,55,44,11,39
Linfield,9176,4,10,6,10,38,37,1,36
Cliftonville,9176,5,9,5,12,33,32,1,32
Ballymena,9176,6,7,4,15,26,49,-23,25
Glentoran,9176,7,6,6,10,24,32,-8,24
Dungannon,9176,8,2,4,16,14,47,-33,10
Crusaders,9177,1,17,6,3,65,32,33,57
Coleraine,9177,2,15,10,1,44,22,22,55
Linfield,9177,3,11,5,10,40,38,2,38
Glenavon,9177,4,9,9,8,52,44,8,36
Cliftonville,9177,5,9,4,13,34,34,0,31
Ballymena,9177,6,7,4,15,27,51,-24,25
Glentoran,9177,7,6,6,10,24,32,-8,24
Dungannon,9177,8,2,4,16,14,47,-33,10
Crusaders,9178,1,17,6,3,64,31,33,57
Coleraine,9178,2,15,10,1,45,23,22,55
Glenavon,9178,3,9,9,8,53,45,8,36
Linfield,9178,4,10,6,10,37,36,1,36
Cliftonville,9178,5,9,5,12,32,31,1,32
Ballymena,9178,6,7,4,15,26,50,-24,25
Glentoran,9178,7,6,6,10,24,32,-8,24
Dungannon,9178,8,2,4,16,14,47,-33,10
Crusaders,9179,1,17,6,3,65,31,34,57
Coleraine,9179,2,14,10,2,44,26,18,52
Glenavon,9179,3,10,9,7,56,44,12,39
Linfield,9179,4,11,5,10,40,37,3,38
Cliftonville,9179,5,9,4,13,33,34,-1,31
Ballymena,9179,6,7,4,15,26,51,-25,25
Glentoran,9179,7,6,6,10,24,32,-8,24
Dungannon,9179,8,2,4,16,14,47,-33,10
Crusaders,9180,1,17,6,3,63,30,33,57
Coleraine,9180,2,14,10,2,44,26,18,52
Glenavon,9180,3,10,9,7,56,44,12,39
Linfield,9180,4,11,5,10,38,36,2,38
Cliftonville,9180,5,9,4,13,32,32,0,31
Ballymena,9180,6,7,4,15,25,49,-24,25
Glentoran,9180,7,6,6,10,24,32,-8,24
Dungannon,9180,8,2,4,16,14,47,-33,10
Crusaders,9181,1,17,6,3,63,31,32,57
Coleraine,9181,2,15,10,1,48,23,25,55
Glenavon,9181,3,9,9,8,53,48,5,36
Linfield,9181,4,10,6,10,37,36,1,36
Cliftonville,9181,5,9,5,12,32,31,1,32
Ballymena,9181,6,7,4,15,26,49,-23,25
Glentoran,9181,7,6,6,10,24,32,-8,24
Dungannon,9181,8,2,4,16,14,47,-33,10
Crusaders,9182,1,16,7,3,62,31,31,55
Coleraine,9182,2,14,11,1,45,24,21,53
Linfield,9182,3,11,5,10,40,37,3,38
Glenavon,9182,4,9,10,7,54,45,9,37
Cliftonville,9182,5,9,4,13,33,34,-1,31
Ballymena,9182,6,7,5,14,26,48,-22,26
Glentoran,9182,7,6,6,10,24,32,-8,24
Dungannon,9182,8,2,4,16,14,47,-33,10
Crusaders,9183,1,16,7,3,62,31,31,55
Coleraine,9183,2,14,10,2,43,24,19,52
Glenavon,9183,3,10,9,7,54,43,11,39
Linfield,9183,4,10,5,11,37,39,-2,35
Cliftonville,9183,5,10,4,12,35,31,4,34
Ballymena,9183,6,7,5,14,26,48,-22,26
Glentoran,9183,7,6,6,10,24,32,-8,24
Dungannon,9183,8,2,4,16,14,47,-33,10
Crusaders,9184,1,17,6,3,63,30,33,57
Coleraine,9184,2,14,10,2,44,24,20,52
Glenavon,9184,3,10,9,7,54,44,10,39
Linfield,9184,4,11,5,10,39,37,2,38
Cliftonville,9184,5,9,4,13,33,33,0,31
Ballymena,9184,6,7,4,15,25,49,-24,25
Glentoran,9184,7,6,6,10,24,32,-8,24
Dungannon,9184,8,2,4,16,14,47,-33,10
Crusaders,9185,1,17,6,3,65,31,34,57
Coleraine,9185,2,14,10,2,44,24,20,52
Glenavon,9185,3,10,9,7,54,44,10,39
Linfield,9185,4,10,6,10,38,37,1,36
Cliftonville,9185,5,9,5,12,33,32,1,32
Ballymena,9185,6,7,4,15,26,51,-25,25
Glentoran,9185,7,6,6,10,24,32,-8,24
Dungannon,9185,8,2,4,16,14,47,-33,10
Crusaders,9186,1,17,6,3,65,30,35,57
Coleraine,9186,2,14,10,2,44,24,20,52
Glenavon,9186,3,10,9,7,54,44,10,39
Linfield,9186,4,10,5,11,37,37,0,35
Cliftonville,9186,5,10,4,12,33,31,2,34
Ballymena,9186,6,7,4,15,25,51,-26,25
Glentoran,9186,7,6,6,10,24,32,-8,24
Dungannon,9186,8,2,4,16,14,47,-33,10
Crusaders,9187,1,17,6,3,64,31,33,57
Coleraine,9187,2,15,10,1,44,22,22,55
Glenavon,9187,3,9,9,8,52,44,8,36
Linfield,9187,4,10,5,11,37,37,0,35
Cliftonville,9187,5,10,4,12,33,31,2,34
Ballymena,9187,6,7,4,15,26,50,-24,25
Glentoran,9187,7,6,6,10,24,32,-8,24
Dungannon,9187,8,2,4,16,14,47,-33,10
Crusaders,9188,1,17,6,3,63,31,32,57
Coleraine,9188,2,14,10,2,45,25,20,52
Glenavon,9188,3,10,9,7,55,45,10,39
Linfield,9188,4,10,5,11,37,37,0,35
Cliftonville,9188,5,10,4,12,33,31,2,34
Ballymena,9188,6,7,4,15,26,49,-23,25
Glentoran,9188,7,6,6,10,24,32,-8,24
Dungannon,9188,8,2,4,16,14,47,-33,10
Crusaders,9189,1,17,6,3,63,30,33,57
Coleraine,9189,2,14,10,2,44,25,19,52
Glenavon,9189,3,10,9,7,55,44,11,39
Linfield,9189,4,10,6,10,39,38,1,36
Cliftonville,9189,5,9,5,12,34,33,1,32
Ballymena,9189,6,7,4,15,25,49,-24,25
Glentoran,9189,7,6,6,10,24,32,-8,24
Dungannon,9189,8,2,4,16,14,47,-33,10
Crusaders,9190,1,17,6,3,64,31,33,57
Coleraine,9190,2,14,10,2,43,27,16,52
Glenavon,9190,3,10,9,7,57,43,14,39
Linfield,9190,4,10,5,11,37,38,-1,35
Cliftonville,9190,5,10,4,12,34,31,3,34
Ballymena,9190,6,7,4,15,26,50,-24,25
Glentoran,9190,7,6,6,10,24,32,-8,24
Dungannon,9190,8,2,4,16,14,47,-33,10
Crusaders,9191,1,17,6,3,64,31,33,57
Coleraine,9191,2,14,10,2,43,25,18,52
Glenavon,9191,3,10,9,7,55,43,12,39
Linfield,9191,4,10,6,10,37,36,1,36
Cliftonville,9191,5,9,5,12,32,31,1,32
Ballymena,9191,6,7,4,15,26,50,-24,25
Glentoran,9191,7,6,6,10,24,32,-8,24
Dungannon,9191,8,2,4,16,14,47,-33,10
Crusaders,9192,1,17,6,3,64,32,32,57
Coleraine,9192,2,15,10,1,45,22,23,55
Glenavon,9192,3,9,9,8,52,45,7,36
Linfield,9192,4,10,5,11,37,38,-1,35
Cliftonville,9192,5,10,4,12,34,31,3,34
Ballymena,9192,6,7,4,15,27,50,-23,25
Glentoran,9192,7,6,6,10,24,32,-8,24
Dungannon,9192,8,2,4,16,14,47,-33,10
Crusaders,9193,1,16,6,4,61,32,29,54
Coleraine,9193,2,14,10,2,44,25,19,52
Glenavon,9193,3,10,9,7,55,44,11,39
Linfield,9193,4,11,5,10,41,36,5,38
Cliftonville,9193,5,9,4,13,32,35,-3,31
Ballymena,9193,6,8,4,14,27,47,-20,28
Glentoran,9193,7,6,6,10,24,32,-8,24
Dungannon,9193,8,2,4,16,14,47,-33,10
Crusaders,9194,1,16,7,3,61,30,31,55
Coleraine,9194,2,15,10,1,45,23,22,55
Glenavon,9194,3,9,9,8,53,45,8,36
Linfield,9194,4,10,5,11,38,38,0,35
Cliftonville,9194,5,10,4,12,34,32,2,34
Ballymena,9194,6,7,5,14,25,47,-22,26
Glentoran,9194,7,6,6,10,24,32,-8,24
Dungannon,9194,8,2,4,16,14,47,-33,10
Crusaders,9195,1,17,6,3,66,32,34,57
Coleraine,9195,2,15,10,1,46,23,23,55
Glenavon,9195,3,9,9,8,53,46,7,36
Linfield,9195,4,10,5,11,37,38,-1,35
Cliftonville,9195,5,10,4,12,34,31,3,34
Ballymena,9195,6,7,4,15,27,52,-25,25
Glentoran,9195,7,6,6,10,24,32,-8,24
Dungannon,9195,8,2,4,16,14,47,-33,10
Crusaders,9196,1,16,7,3,64,33,31,55
Coleraine,9196,2,14,10,2,43,25,18,52
Glenavon,9196,3,10,9,7,55,43,12,39
Linfield,9196,4,10,5,11,37,37,0,35
Cliftonville,9196,5,10,4,12,33,31,2,34
Ballymena,9196,6,7,5,14,28,50,-22,26
Glentoran,9196,7,6,6,10,24,32,-8,24
Dungannon,9196,8,2,4,16,14,47,-33,10
Crusaders,9197,1,17,6,3,63,30,33,57
Coleraine,9197,2,14,10,2,43,25,18,52
Glenavon,9197,3,10,9,7,55,43,12,39
Linfield,9197,4,10,5,11,38,39,-1,35
Cliftonville,9197,5,10,4,12,35,32,3,34
Ballymena,9197,6,7,4,15,25,49,-24,25
Glentoran,9197,7,6,6,10,24,32,-8,24
Dungannon,9197,8,2,4,16,14,47,-33,10
Crusaders,9198,1,17,6,3,64,31,33,57
Coleraine,9198,2,15,10,1,44,22,22,55
Glenavon,9198,3,9,9,8,52,44,8,36
Linfield,9198,4,10,6,10,38,37,1,36
Cliftonville,9198,5,9,5,12,33,32,1,32
Ballymena,9198,6,7,4,15,26,50,-24,25
Glentoran,9198,7,6,6,10,24,32,-8,24
Dungannon,9198,8,2,4,16,14,47,-33,10
Crusaders,9199,1,16,7,3,64,33,31,55
Coleraine,9199,2,15,10,1,47,25,22,55
Glenavon,9199,3,9,9,8,55,47,8,36
Linfield,9199,4,10,5,11,39,39,0,35
Cliftonville,9199,5,10,4,12,35,33,2,34
Ballymena,9199,6,7,5,14,28,50,-22,26
Glentoran,9199,7,6,6,10,24,32,-8,24
Dungannon,9199,8,2,4,16,14,47,-33,10
Crusaders,9200,1,17,6,3,63,31,32,57
Coleraine,9200,2,14,10,2,44,26,18,52
Glenavon,9200,3,10,9,7,56,44,12,39
Linfield,9200,4,11,5,10,40,38,2,38
Cliftonville,9200,5,9,4,13,34,34,0,31
Ballymena,9200,6,7,4,15,26,49,-23,25
Glentoran,9200,7,6,6,10,24,32,-8,24
Dungannon,9200,8,2,4,16,14,47,-33,10
Crusaders,9201,1,16,7,3,62,31,31,55
Coleraine,9201,2,14,10,2,43,24,19,52
Glenavon,9201,3,10,9,7,54,43,11,39
Linfield,9201,4,11,5,10,39,37,2,38
Cliftonville,9201,5,9,4,13,33,33,0,31
Ballymena,9201,6,7,5,14,26,48,-22,26
Glentoran,9201,7,6,6,10,24,32,-8,24
Dungannon,9201,8,2,4,16,14,47,-33,10
Coleraine,9202,1,15,10,1,44,22,22,55
Crusaders,9202,2,16,6,4,61,31,30,54
Glenavon,9202,3,9,9,8,52,44,8,36
Linfield,9202,4,10,6,10,38,37,1,36
Cliftonville,9202,5,9,5,12,33,32,1,32
Ballymena,9202,6,8,4,14,26,47,-21,28
Glentoran,9202,7,6,6,10,24,32,-8,24
Dungannon,9202,8,2,4,16,14,47,-33,10
Crusaders,9203,1,17,6,3,65,30,35,57
Coleraine,9203,2,15,10,1,45,23,22,55
Linfield,9203,3,11,5,10,38,36,2,38
Glenavon,9203,4,9,9,8,53,45,8,36
Cliftonville,9203,5,9,4,13,32,32,0,31
Ballymena,9203,6,7,4,15,25,51,-26,25
Glentoran,9203,7,6,6,10,24,32,-8,24
Dungannon,9203,8,2,4,16,14,47,-33,10
Crusaders,9204,1,17,6,3,65,32,33,57
Coleraine,9204,2,14,11,1,43,22,21,53
Linfield,9204,3,11,5,10,41,36,5,38
Glenavon,9204,4,9,10,7,52,43,9,37
Cliftonville,9204,5,9,4,13,32,35,-3,31
Ballymena,9204,6,7,4,15,27,51,-24,25
Glentoran,9204,7,6,6,10,24,32,-8,24
Dungannon,9204,8,2,4,16,14,47,-33,10
Crusaders,9205,1,16,7,3,62,31,31,55
Coleraine,9205,2,14,10,2,43,23,20,52
Glenavon,9205,3,10,9,7,53,43,10,39
Linfield,9205,4,11,5,10,39,36,3,38
Cliftonville,9205,5,9,4,13,32,33,-1,31
Ballymena,9205,6,7,5,14,26,48,-22,26
Glentoran,9205,7,6,6,10,24,32,-8,24
Dungannon,9205,8,2,4,16,14,47,-33,10
Crusaders,9206,1,17,6,3,63,31,32,57
Coleraine,9206,2,14,10,2,44,24,20,52
Glenavon,9206,3,10,9,7,54,44,10,39
Linfield,9206,4,10,6,10,39,38,1,36
Cliftonville,9206,5,9,5,12,34,33,1,32
Ballymena,9206,6,7,4,15,26,49,-23,25
Glentoran,9206,7,6,6,10,24,32,-8,24
Dungannon,9206,8,2,4,16,14,47,-33,10
Crusaders,9207,1,17,6,3,64,30,34,57
Coleraine,9207,2,14,11,1,45,24,21,53
Linfield,9207,3,11,5,10,40,36,4,38
Glenavon,9207,4,9,10,7,54,45,9,37
Cliftonville,9207,5,9,4,13,32,34,-2,31
Ballymena,9207,6,7,4,15,25,50,-25,25
Glentoran,9207,7,6,6,10,24,32,-8,24
Dungannon,9207,8,2,4,16,14,47,-33,10
Crusaders,9208,1,17,6,3,63,30,33,57
Coleraine,9208,2,15,10,1,45,22,23,55
Glenavon,9208,3,9,9,8,52,45,7,36
Linfield,9208,4,10,5,11,38,38,0,35
Cliftonville,9208,5,10,4,12,34,32,2,34
Ballymena,9208,6,7,4,15,25,49,-24,25
Glentoran,9208,7,6,6,10,24,32,-8,24
Dungannon,9208,8,2,4,16,14,47,-33,10
Crusaders,9209,1,17,6,3,64,30,34,57
Coleraine,9209,2,14,10,2,43,25,18,52
Glenavon,9209,3,10,9,7,55,43,12,39
Linfield,9209,4,11,5,10,38,36,2,38
Cliftonville,9209,5,9,4,13,32,32,0,31
Ballymena,9209,6,7,4,15,25,50,-25,25
Glentoran,9209,7,6,6,10,24,32,-8,24
Dungannon,9209,8,2,4,16,14,47,-33,10
Coleraine,9210,1,15,10,1,45,22,23,55
Crusaders,9210,2,16,6,4,62,35,27,54
Linfield,9210,3,11,5,10,39,37,2,38
Glenavon,9210,4,9,9,8,52,45,7,36
Cliftonville,9210,5,9,4,13,33,33,0,31
Ballymena,9210,6,8,4,14,30,48,-18,28
Glentoran,9210,7,6,6,10,24,32,-8,24
Dungannon,9210,8,2,4,16,14,47,-33,10
Crusaders,9211,1,16,7,3,62,31,31,55
Coleraine,9211,2,14,10,2,44,24,20,52
Glenavon,9211,3,10,9,7,54,44,10,39
Linfield,9211,4,11,5,10,40,36,4,38
Cliftonville,9211,5,9,4,13,32,34,-2,31
Ballymena,9211,6,7,5,14,26,48,-22,26
Glentoran,9211,7,6,6,10,24,32,-8,24
Dungannon,9211,8,2,4,16,14,47,-33,10
Crusaders,9212,1,17,6,3,65,30,35,57
Coleraine,9212,2,14,10,2,43,25,18,52
Glenavon,9212,3,10,9,7,55,43,12,39
Linfield,9212,4,10,5,11,37,37,0,35
Cliftonville,9212,5,10,4,12,33,31,2,34
Ballymena,9212,6,7,4,15,25,51,-26,25
Glentoran,9212,7,6,6,10,24,32,-8,24
Dungannon,9212,8,2,4,16,14,47,-33,10
Crusaders,9213,1,17,6,3,64,31,33,57
Coleraine,9213,2,14,10,2,43,23,20,52
Glenavon,9213,3,10,9,7,53,43,10,39
Linfield,9213,4,10,6,10,37,36,1,36
Cliftonville,9213,5,9,5,12,32,31,1,32
Ballymena,9213,6,7,4,15,26,50,-24,25
Glentoran,9213,7,6,6,10,24,32,-8,24
Dungannon,9213,8,2,4,16,14,47,-33,10
Crusaders,9214,1,17,6,3,63,30,33,57
Coleraine,9214,2,14,11,1,44,23,21,53
Glenavon,9214,3,9,10,7,53,44,9,37
Linfield,9214,4,10,6,10,38,37,1,36
Cliftonville,9214,5,9,5,12,33,32,1,32
Ballymena,9214,6,7,4,15,25,49,-24,25
Glentoran,9214,7,6,6,10,24,32,-8,24
Dungannon,9214,8,2,4,16,14,47,-33,10
Crusaders,9215,1,17,6,3,64,31,33,57
Coleraine,9215,2,14,10,2,43,24,19,52
Glenavon,9215,3,10,9,7,54,43,11,39
Linfield,9215,4,11,5,10,40,38,2,38
Cliftonville,9215,5,9,4,13,34,34,0,31
Ballymena,9215,6,7,4,15,26,50,-24,25
Glentoran,9215,7,6,6,10,24,32,-8,24
Dungannon,9215,8,2,4,16,14,47,-33,10
Crusaders,9216,1,16,7,3,62,31,31,55
Coleraine,9216,2,14,11,1,45,24,21,53
Linfield,9216,3,11,5,10,39,36,3,38
Glenavon,9216,4,9,10,7,54,45,9,37
Cliftonville,9216,5,9,4,13,32,33,-1,31
Ballymena,9216,6,7,5,14,26,48,-22,26
Glentoran,9216,7,6,6,10,24,32,-8,24
Dungannon,9216,8,2,4,16,14,47,-33,10
Coleraine,9217,1,15,10,1,45,23,22,55
Crusaders,9217,2,16,6,4,62,33,29,54
Glenavon,9217,3,9,9,8,53,45,8,36
Linfield,9217,4,10,5,11,39,39,0,35
Cliftonville,9217,5,10,4,12,35,33,2,34
Ballymena,9217,6,8,4,14,28,48,-20,28
Glentoran,9217,7,6,6,10,24,32,-8,24
Dungannon,9217,8,2,4,16,14,47,-33,10
Crusaders,9218,1,17,6,3,63,30,33,57
Coleraine,9218,2,14,10,2,44,24,20,52
Glenavon,9218,3,10,9,7,54,44,10,39
Linfield,9218,4,11,5,10,39,36,3,38
Cliftonville,9218,5,9,4,13,32,33,-1,31
Ballymena,9218,6,7,4,15,25,49,-24,25
Glentoran,9218,7,6,6,10,24,32,-8,24
Dungannon,9218,8,2,4,16,14,47,-33,10
Crusaders,9219,1,17,6,3,62,30,32,57
Coleraine,9219,2,15,10,1,44,22,22,55
Glenavon,9219,3,9,9,8,52,44,8,36
Linfield,9219,4,10,5,11,37,37,0,35
Cliftonville,9219,5,10,4,12,33,31,2,34
Ballymena,9219,6,7,4,15,25,48,-23,25
Glentoran,9219,7,6,6,10,24,32,-8,24
Dungannon,9219,8,2,4,16,14,47,-33,10
Crusaders,9220,1,17,6,3,64,32,32,57
Coleraine,9220,2,14,10,2,43,25,18,52
Glenavon,9220,3,10,9,7,55,43,12,39
Linfield,9220,4,10,5,11,38,38,0,35
Cliftonville,9220,5,10,4,12,34,32,2,34
Ballymena,9220,6,7,4,15,27,50,-23,25
Glentoran,9220,7,6,6,10,24,32,-8,24
Dungannon,9220,8,2,4,16,14,47,-33,10
Crusaders,9221,1,17,6,3,64,32,32,57
Coleraine,9221,2,14,11,1,45,24,21,53
Glenavon,9221,3,9,10,7,54,45,9,37
Linfield,9221,4,10,5,11,37,38,-1,35
Cliftonville,9221,5,10,4,12,34,31,3,34
Ballymena,9221,6,7,4,15,27,50,-23,25
Glentoran,9221,7,6,6,10,24,32,-8,24
Dungannon,9221,8,2,4,16,14,47,-33,10
Crusaders,9222,1,16,7,3,62,31,31,55
Coleraine,9222,2,14,10,2,45,25,20,52
Glenavon,9222,3,10,9,7,55,45,10,39
Linfield,9222,4,10,5,11,38,38,0,35
Cliftonville,9222,5,10,4,12,34,32,2,34
Ballymena,9222,6,7,5,14,26,48,-22,26
Glentoran,9222,7,6,6,10,24,32,-8,24
Dungannon,9222,8,2,4,16,14,47,-33,10
Crusaders,9223,1,16,7,3,63,32,31,55
Coleraine,9223,2,14,11,1,45,24,21,53
Glenavon,9223,3,9,10,7,54,45,9,37
Linfield,9223,4,10,5,11,38,38,0,35
Cliftonville,9223,5,10,4,12,34,32,2,34
Ballymena,9223,6,7,5,14,27,49,-22,26
Glentoran,9223,7,6,6,10,24,32,-8,24
Dungannon,9223,8,2,4,16,14,47,-33,10
Crusaders,9224,1,17,6,3,66,31,35,57
Coleraine,9224,2,14,11,1,44,23,21,53
Glenavon,9224,3,9,10,7,53,44,9,37
Linfield,9224,4,10,5,11,37,37,0,35
Cliftonville,9224,5,10,4,12,33,31,2,34
Ballymena,9224,6,7,4,15,26,52,-26,25
Glentoran,9224,7,6,6,10,24,32,-8,24
Dungannon,9224,8,2,4,16,14,47,-33,10
Crusaders,9225,1,16,6,4,61,33,28,54
Coleraine,9225,2,14,10,2,45,25,20,52
Glenavon,9225,3,10,9,7,55,45,10,39
Linfield,9225,4,10,6,10,37,36,1,36
Cliftonville,9225,5,9,5,12,32,31,1,32
Ballymena,9225,6,8,4,14,28,47,-19,28
Glentoran,9225,7,6,6,10,24,32,-8,24
Dungannon,9225,8,2,4,16,14,47,-33,10
Crusaders,9226,1,17,6,3,63,30,33,57
Coleraine,9226,2,14,10,2,44,25,19,52
Glenavon,9226,3,10,9,7,55,44,11,39
Linfield,9226,4,10,5,11,37,38,-1,35
Cliftonville,9226,5,10,4,12,34,31,3,34
Ballymena,9226,6,7,4,15,25,49,-24,25
Glentoran,9226,7,6,6,10,24,32,-8,24
Dungannon,9226,8,2,4,16,14,47,-33,10
Crusaders,9227,1,16,6,4,62,32,30,54
Coleraine,9227,2,14,10,2,45,25,20,52
Glenavon,9227,3,10,9,7,55,45,10,39
Linfield,9227,4,10,6,10,38,37,1,36
Cliftonville,9227,5,9,5,12,33,32,1,32
Ballymena,9227,6,8,4,14,27,48,-21,28
Glentoran,9227,7,6,6,10,24,32,-8,24
Dungannon,9227,8,2,4,16,14,47,-33,10
Crusaders,9228,1,16,6,4,62,32,30,54
Coleraine,9228,2,14,10,2,44,24,20,52
Glenavon,9228,3,10,9,7,54,44,10,39
Linfield,9228,4,10,6,10,38,37,1,36
Cliftonville,9228,5,9,5,12,33,32,1,32
Ballymena,9228,6,8,4,14,27,48,-21,28
Glentoran,9228,7,6,6,10,24,32,-8,24
Dungannon,9228,8,2,4,16,14,47,-33,10
Crusaders,9229,1,16,6,4,61,31,30,54
Coleraine,9229,2,14,10,2,44,24,20,52
Glenavon,9229,3,10,9,7,54,44,10,39
Linfield,9229,4,11,5,10,41,37,4,38
Cliftonville,9229,5,9,4,13,33,35,-2,31
Ballymena,9229,6,8,4,14,26,47,-21,28
Glentoran,9229,7,6,6,10,24,32,-8,24
Dungannon,9229,8,2,4,16,14,47,-33,10
Crusaders,9230,1,16,6,4,62,32,30,54
Coleraine,9230,2,14,10,2,43,25,18,52
Glenavon,9230,3,10,9,7,55,43,12,39
Linfield,9230,4,10,5,11,38,38,0,35
Cliftonville,9230,5,10,4,12,34,32,2,34
Ballymena,9230,6,8,4,14,27,48,-21,28
Glentoran,9230,7,6,6,10,24,32,-8,24
Dungannon,9230,8,2,4,16,14,47,-33,10
Crusaders,9231,1,17,6,3,62,30,32,57
Coleraine,9231,2,14,10,2,45,27,18,52
Glenavon,9231,3,10,9,7,57,45,12,39
Linfield,9231,4,11,5,10,40,36,4,38
Cliftonville,9231,5,9,4,13,32,34,-2,31
Ballymena,9231,6,7,4,15,25,48,-23,25
Glentoran,9231,7,6,6,10,24,32,-8,24
Dungannon,9231,8,2,4,16,14,47,-33,10
Crusaders,9232,1,17,6,3,64,30,34,57
Coleraine,9232,2,14,10,2,43,23,20,52
Glenavon,9232,3,10,9,7,53,43,10,39
Linfield,9232,4,10,5,11,37,38,-1,35
Cliftonville,9232,5,10,4,12,34,31,3,34
Ballymena,9232,6,7,4,15,25,50,-25,25
Glentoran,9232,7,6,6,10,24,32,-8,24
Dungannon,9232,8,2,4,16,14,47,-33,10
Crusaders,9233,1,17,6,3,63,30,33,57
Coleraine,9233,2,14,10,2,43,25,18,52
Glenavon,9233,3,10,9,7,55,43,12,39
Linfield,9233,4,10,5,11,38,38,0,35
Cliftonville,9233,5,10,4,12,34,32,2,34
Ballymena,9233,6,7,4,15,25,49,-24,25
Glentoran,9233,7,6,6,10,24,32,-8,24
Dungannon,9233,8,2,4,16,14,47,-33,10
Crusaders,9234,1,16,6,4,61,31,30,54
Coleraine,9234,2,14,10,2,44,25,19,52
Glenavon,9234,3,10,9,7,55,44,11,39
Linfield,9234,4,10,5,11,37,37,0,35
Cliftonville,9234,5,10,4,12,33,31,2,34
Ballymena,9234,6,8,4,14,26,47,-21,28
Glentoran,9234,7,6,6,10,24,32,-8,24
Dungannon,9234,8,2,4,16,14,47,-33,10
Crusaders,9235,1,17,6,3,67,33,34,57
Coleraine,9235,2,14,10,2,45,25,20,52
Glenavon,9235,3,10,9,7,55,45,10,39
Linfield,9235,4,10,6,10,39,38,1,36
Cliftonville,9235,5,9,5,12,34,33,1,32
Ballymena,9235,6,7,4,15,28,53,-25,25
Glentoran,9235,7,6,6,10,24,32,-8,24
Dungannon,9235,8,2,4,16,14,47,-33,10
Crusaders,9236,1,17,6,3,63,31,32,57
Coleraine,9236,2,15,10,1,47,23,24,55
Glenavon,9236,3,9,9,8,53,47,6,36
Linfield,9236,4,10,5,11,37,37,0,35
Cliftonville,9236,5,10,4,12,33,31,2,34
Ballymena,9236,6,7,4,15,26,49,-23,25
Glentoran,9236,7,6,6,10,24,32,-8,24
Dungannon,9236,8,2,4,16,14,47,-33,10
Crusaders,9237,1,16,6,4,61,33,28,54
Coleraine,9237,2,14,11,1,46,25,21,53
Glenavon,9237,3,9,10,7,55,46,9,37
Linfield,9237,4,10,6,10,37,36,1,36
Cliftonville,9237,5,9,5,12,32,31,1,32
Ballymena,9237,6,8,4,14,28,47,-19,28
Glentoran,9237,7,6,6,10,24,32,-8,24
Dungannon,9237,8,2,4,16,14,47,-33,10
Crusaders,9238,1,17,6,3,63,31,32,57
Coleraine,9238,2,15,10,1,46,22,24,55
Glenavon,9238,3,9,9,8,52,46,6,36
Linfield,9238,4,10,6,10,37,36,1,36
Cliftonville,9238,5,9,5,12,32,31,1,32
Ballymena,9238,6,7,4,15,26,49,-23,25
Glentoran,9238,7,6,6,10,24,32,-8,24
Dungannon,9238,8,2,4,16,14,47,-33,10
Crusaders,9239,1,16,6,4,61,31,30,54
Coleraine,9239,2,14,11,1,46,25,21,53
Glenavon,9239,3,9,10,7,55,46,9,37
Linfield,9239,4,10,6,10,37,36,1,36
Cliftonville,9239,5,9,5,12,32,31,1,32
Ballymena,9239,6,8,4,14,26,47,-21,28
Glentoran,9239,7,6,6,10,24,32,-8,24
Dungannon,9239,8,2,4,16,14,47,-33,10
Crusaders,9240,1,16,6,4,62,33,29,54
Coleraine,9240,2,14,11,1,46,25,21,53
Glenavon,9240,3,9,10,7,55,46,9,37
Linfield,9240,4,10,5,11,38,39,-1,35
Cliftonville,9240,5,10,4,12,35,32,3,34
Ballymena,9240,6,8,4,14,28,48,-20,28
Glentoran,9240,7,6,6,10,24,32,-8,24
Dungannon,9240,8,2,4,16,14,47,-33,10
Crusaders,9241,1,16,7,3,62,31,31,55
Coleraine,9241,2,14,10,2,43,24,19,52
Glenavon,9241,3,10,9,7,54,43,11,39
Linfield,9241,4,10,5,11,37,37,0,35
Cliftonville,9241,5,10,4,12,33,31,2,34
Ballymena,9241,6,7,5,14,26,48,-22,26
Glentoran,9241,7,6,6,10,24,32,-8,24
Dungannon,9241,8,2,4,16,14,47,-33,10
Crusaders,9242,1,17,6,3,64,31,33,57
Coleraine,9242,2,14,11,1,44,23,21,53
Glenavon,9242,3,9,10,7,53,44,9,37
Linfield,9242,4,10,5,11,38,40,-2,35
Cliftonville,9242,5,10,4,12,36,32,4,34
Ballymena,9242,6,7,4,15,26,50,-24,25
Glentoran,9242,7,6,6,10,24,32,-8,24
Dungannon,9242,8,2,4,16,14,47,-33,10
Crusaders,9243,1,16,6,4,61,31,30,54
Coleraine,9243,2,14,11,1,43,22,21,53
Glenavon,9243,3,9,10,7,52,43,9,37
Linfield,9243,4,10,6,10,40,39,1,36
Cliftonville,9243,5,9,5,12,35,34,1,32
Ballymena,9243,6,8,4,14,26,47,-21,28
Glentoran,9243,7,6,6,10,24,32,-8,24
Dungannon,9243,8,2,4,16,14,47,-33,10
Crusaders,9244,1,17,6,3,66,32,34,57
Coleraine,9244,2,14,10,2,44,24,20,52
Glenavon,9244,3,10,9,7,54,44,10,39
Linfield,9244,4,11,5,10,40,37,3,38
Cliftonville,9244,5,9,4,13,33,34,-1,31
Ballymena,9244,6,7,4,15,27,52,-25,25
Glentoran,9244,7,6,6,10,24,32,-8,24
Dungannon,9244,8,2,4,16,14,47,-33,10
Crusaders,9245,1,16,6,4,63,35,28,54
Coleraine,9245,2,14,10,2,43,26,17,52
Glenavon,9245,3,10,9,7,56,43,13,39
Linfield,9245,4,11,5,10,39,36,3,38
Cliftonville,9245,5,9,4,13,32,33,-1,31
Ballymena,9245,6,8,4,14,30,49,-19,28
Glentoran,9245,7,6,6,10,24,32,-8,24
Dungannon,9245,8,2,4,16,14,47,-33,10
Crusaders,9246,1,17,6,3,63,31,32,57
Coleraine,9246,2,14,11,1,45,24,21,53
Linfield,9246,3,11,5,10,43,38,5,38
Glenavon,9246,4,9,10,7,54,45,9,37
Cliftonville,9246,5,9,4,13,34,37,-3,31
Ballymena,9246,6,7,4,15,26,49,-23,25
Glentoran,9246,7,6,6,10,24,32,-8,24
Dungannon,9246,8,2,4,16,14,47,-33,10
Crusaders,9247,1,17,6,3,63,30,33,57
Coleraine,9247,2,14,10,2,44,25,19,52
Glenavon,9247,3,10,9,7,55,44,11,39
Linfield,9247,4,11,5,10,40,36,4,38
Cliftonville,9247,5,9,4,13,32,34,-2,31
Ballymena,9247,6,7,4,15,25,49,-24,25
Glentoran,9247,7,6,6,10,24,32,-8,24
Dungannon,9247,8,2,4,16,14,47,-33,10
Crusaders,9248,1,17,6,3,62,30,32,57
Coleraine,9248,2,14,10,2,43,26,17,52
Glenavon,9248,3,10,9,7,56,43,13,39
Linfield,9248,4,11,5,10,40,37,3,38
Cliftonville,9248,5,9,4,13,33,34,-1,31
Ballymena,9248,6,7,4,15,25,48,-23,25
Glentoran,9248,7,6,6,10,24,32,-8,24
Dungannon,9248,8,2,4,16,14,47,-33,10
Crusaders,9249,1,17,6,3,62,30,32,57
Coleraine,9249,2,15,10,1,45,22,23,55
Linfield,9249,3,11,5,10,40,37,3,38
Glenavon,9249,4,9,9,8,52,45,7,36
Cliftonville,9249,5,9,4,13,33,34,-1,31
Ballymena,9249,6,7,4,15,25,48,-23,25
Glentoran,9249,7,6,6,10,24,32,-8,24
Dungannon,9249,8,2,4,16,14,47,-33,10
Coleraine,9250,1,15,10,1,46,24,22,55
Crusaders,9250,2,16,6,4,61,31,30,54
Glenavon,9250,3,9,9,8,54,46,8,36
Linfield,9250,4,10,6,10,38,37,1,36
Cliftonville,9250,5,9,5,12,33,32,1,32
Ballymena,9250,6,8,4,14,26,47,-21,28
Glentoran,9250,7,6,6,10,24,32,-8,24
Dungannon,9250,8,2,4,16,14,47,-33,10
Crusaders,9251,1,17,6,3,64,31,33,57
Coleraine,9251,2,15,10,1,45,23,22,55
Linfield,9251,3,11,5,10,42,36,6,38
Glenavon,9251,4,9,9,8,53,45,8,36
Cliftonville,9251,5,9,4,13,32,36,-4,31
Ballymena,9251,6,7,4,15,26,50,-24,25
Glentoran,9251,7,6,6,10,24,32,-8,24
Dungannon,9251,8,2,4,16,14,47,-33,10
Crusaders,9252,1,17,6,3,65,31,34,57
Coleraine,9252,2,14,11,1,46,25,21,53
Glenavon,9252,3,9,10,7,55,46,9,37
Linfield,9252,4,10,5,11,37,39,-2,35
Cliftonville,9252,5,10,4,12,35,31,4,34
Ballymena,9252,6,7,4,15,26,51,-25,25
Glentoran,9252,7,6,6,10,24,32,-8,24
Dungannon,9252,8,2,4,16,14,47,-33,10
Crusaders,9253,1,17,6,3,63,31,32,57
Coleraine,9253,2,14,10,2,44,24,20,52
Glenavon,9253,3,10,9,7,54,44,10,39
Linfield,9253,4,11,5,10,40,37,3,38
Cliftonville,9253,5,9,4,13,33,34,-1,31
Ballymena,9253,6,7,4,15,26,49,-23,25
Glentoran,9253,7,6,6,10,24,32,-8,24
Dungannon,9253,8,2,4,16,14,47,-33,10
Crusaders,9254,1,16,6,4,62,32,30,54
Coleraine,9254,2,14,10,2,44,25,19,52
Glenavon,9254,3,10,9,7,55,44,11,39
Linfield,9254,4,10,5,11,38,38,0,35
Cliftonville,9254,5,10,4,12,34,32,2,34
Ballymena,9254,6,8,4,14,27,48,-21,28
Glentoran,9254,7,6,6,10,24,32,-8,24
Dungannon,9254,8,2,4,16,14,47,-33,10
Crusaders,9255,1,17,6,3,64,30,34,57
Coleraine,9255,2,14,11,1,45,24,21,53
Linfield,9255,3,11,5,10,38,36,2,38
Glenavon,9255,4,9,10,7,54,45,9,37
Cliftonville,9255,5,9,4,13,32,32,0,31
Ballymena,9255,6,7,4,15,25,50,-25,25
Glentoran,9255,7,6,6,10,24,32,-8,24
Dungannon,9255,8,2,4,16,14,47,-33,10
Crusaders,9256,1,17,6,3,66,32,34,57
Coleraine,9256,2,14,11,1,46,25,21,53
Linfield,9256,3,11,5,10,40,37,3,38
Glenavon,9256,4,9,10,7,55,46,9,37
Cliftonville,9256,5,9,4,13,33,34,-1,31
Ballymena,9256,6,7,4,15,27,52,-25,25
Glentoran,9256,7,6,6,10,24,32,-8,24
Dungannon,9256,8,2,4,16,14,47,-33,10
Crusaders,9257,1,16,7,3,64,33,31,55
Coleraine,9257,2,14,11,1,45,24,21,53
Glenavon,9257,3,9,10,7,54,45,9,37
Linfield,9257,4,10,6,10,38,37,1,36
Cliftonville,9257,5,9,5,12,33,32,1,32
Ballymena,9257,6,7,5,14,28,50,-22,26
Glentoran,9257,7,6,6,10,24,32,-8,24
Dungannon,9257,8,2,4,16,14,47,-33,10
Crusaders,9258,1,16,6,4,61,31,30,54
Coleraine,9258,2,14,11,1,44,23,21,53
Linfield,9258,3,11,5,10,38,36,2,38
Glenavon,9258,4,9,10,7,53,44,9,37
Cliftonville,9258,5,9,4,13,32,32,0,31
Ballymena,9258,6,8,4,14,26,47,-21,28
Glentoran,9258,7,6,6,10,24,32,-8,24
Dungannon,9258,8,2,4,16,14,47,-33,10
Crusaders,9259,1,17,6,3,65,32,33,57
Coleraine,9259,2,15,10,1,47,24,23,55
Glenavon,9259,3,9,9,8,54,47,7,36
Linfield,9259,4,10,6,10,38,37,1,36
Cliftonville,9259,5,9,5,12,33,32,1,32
Ballymena,9259,6,7,4,15,27,51,-24,25
Glentoran,9259,7,6,6,10,24,32,-8,24
Dungannon,9259,8,2,4,16,14,47,-33,10
Crusaders,9260,1,17,6,3,65,30,35,57
Coleraine,9260,2,15,10,1,45,22,23,55
Linfield,9260,3,11,5,10,40,37,3,38
Glenavon,9260,4,9,9,8,52,45,7,36
Cliftonville,9260,5,9,4,13,33,34,-1,31
Ballymena,9260,6,7,4,15,25,51,-26,25
Glentoran,9260,7,6,6,10,24,32,-8,24
Dungannon,9260,8,2,4,16,14,47,-33,10
Coleraine,9261,1,15,10,1,49,23,26,55
Crusaders,9261,2,16,6,4,63,33,30,54
Glenavon,9261,3,9,9,8,53,49,4,36
Linfield,9261,4,10,5,11,37,37,0,35
Cliftonville,9261,5,10,4,12,33,31,2,34
Ballymena,9261,6,8,4,14,28,49,-21,28
Glentoran,9261,7,6,6,10,24,32,-8,24
Dungannon,9261,8,2,4,16,14,47,-33,10
Crusaders,9262,1,17,6,3,65,32,33,57
Coleraine,9262,2,14,10,2,43,25,18,52
Glenavon,9262,3,10,9,7,55,43,12,39
Linfield,9262,4,10,5,11,37,37,0,35
Cliftonville,9262,5,10,4,12,33,31,2,34
Ballymena,9262,6,7,4,15,27,51,-24,25
Glentoran,9262,7,6,6,10,24,32,-8,24
Dungannon,9262,8,2,4,16,14,47,-33,10
Crusaders,9263,1,16,6,4,61,32,29,54
Coleraine,9263,2,14,11,1,46,25,21,53
Glenavon,9263,3,9,10,7,55,46,9,37
Linfield,9263,4,10,5,11,37,38,-1,35
Cliftonville,9263,5,10,4,12,34,31,3,34
Ballymena,9263,6,8,4,14,27,47,-20,28
Glentoran,9263,7,6,6,10,24,32,-8,24
Dungannon,9263,8,2,4,16,14,47,-33,10
Crusaders,9264,1,17,6,3,64,31,33,57
Coleraine,9264,2,15,10,1,48,24,24,55
Linfield,9264,3,11,5,10,38,36,2,38
Glenavon,9264,4,9,9,8,54,48,6,36
Cliftonville,9264,5,9,4,13,32,32,0,31
Ballymena,9264,6,7,4,15,26,50,-24,25
Glentoran,9264,7,6,6,10,24,32,-8,24
Dungannon,9264,8,2,4,16,14,47,-33,10
Crusaders,9265,1,17,6,3,63,30,33,57
Coleraine,9265,2,15,10,1,44,22,22,55
Glenavon,9265,3,9,9,8,52,44,8,36
Linfield,9265,4,10,6,10,41,40,1,36
Cliftonville,9265,5,9,5,12,36,35,1,32
Ballymena,9265,6,7,4,15,25,49,-24,25
Glentoran,9265,7,6,6,10,24,32,-8,24
Dungannon,9265,8,2,4,16,14,47,-33,10
Crusaders,9266,1,17,6,3,64,31,33,57
Coleraine,9266,2,14,11,1,44,23,21,53
Glenavon,9266,3,9,10,7,53,44,9,37
Linfield,9266,4,10,6,10,38,37,1,36
Cliftonville,9266,5,9,5,12,33,32,1,32
Ballymena,9266,6,7,4,15,26,50,-24,25
Glentoran,9266,7,6,6,10,24,32,-8,24
Dungannon,9266,8,2,4,16,14,47,-33,10
Crusaders,9267,1,17,6,3,63,30,33,57
Coleraine,9267,2,14,11,1,45,24,21,53
Linfield,9267,3,11,5,10,39,37,2,38
Glenavon,9267,4,9,10,7,54,45,9,37
Cliftonville,9267,5,9,4,13,33,33,0,31
Ballymena,9267,6,7,4,15,25,49,-24,25
Glentoran,9267,7,6,6,10,24,32,-8,24
Dungannon,9267,8,2,4,16,14,47,-33,10
Crusaders,9268,1,17,6,3,64,31,33,57
Coleraine,9268,2,15,10,1,46,23,23,55
Glenavon,9268,3,9,9,8,53,46,7,36
Linfield,9268,4,10,5,11,37,37,0,35
Cliftonville,9268,5,10,4,12,33,31,2,34
Ballymena,9268,6,7,4,15,26,50,-24,25
Glentoran,9268,7,6,6,10,24,32,-8,24
Dungannon,9268,8,2,4,16,14,47,-33,10
Crusaders,9269,1,17,6,3,65,31,34,57
Coleraine,9269,2,15,10,1,44,22,22,55
Glenavon,9269,3,9,9,8,52,44,8,36
Linfield,9269,4,10,6,10,37,36,1,36
Cliftonville,9269,5,9,5,12,32,31,1,32
Ballymena,9269,6,7,4,15,26,51,-25,25
Glentoran,9269,7,6,6,10,24,32,-8,24
Dungannon,9269,8,2,4,16,14,47,-33,10
Crusaders,9270,1,17,6,3,65,30,35,57
Coleraine,9270,2,14,11,1,44,23,21,53
Linfield,9270,3,11,5,10,40,36,4,38
Glenavon,9270,4,9,10,7,53,44,9,37
Cliftonville,9270,5,9,4,13,32,34,-2,31
Ballymena,9270,6,7,4,15,25,51,-26,25
Glentoran,9270,7,6,6,10,24,32,-8,24
Dungannon,9270,8,2,4,16,14,47,-33,10
Crusaders,9271,1,16,7,3,62,31,31,55
Coleraine,9271,2,14,10,2,44,24,20,52
Glenavon,9271,3,10,9,7,54,44,10,39
Linfield,9271,4,11,5,10,39,37,2,38
Cliftonville,9271,5,9,4,13,33,33,0,31
Ballymena,9271,6,7,5,14,26,48,-22,26
Glentoran,9271,7,6,6,10,24,32,-8,24
Dungannon,9271,8,2,4,16,14,47,-33,10
Crusaders,9272,1,16,7,3,62,31,31,55
Coleraine,9272,2,15,10,1,47,23,24,55
Linfield,9272,3,11,5,10,38,36,2,38
Glenavon,9272,4,9,9,8,53,47,6,36
Cliftonville,9272,5,9,4,13,32,32,0,31
Ballymena,9272,6,7,5,14,26,48,-22,26
Glentoran,9272,7,6,6,10,24,32,-8,24
Dungannon,9272,8,2,4,16,14,47,-33,10
Crusaders,9273,1,17,6,3,64,31,33,57
Coleraine,9273,2,14,10,2,43,23,20,52
Glenavon,9273,3,10,9,7,53,43,10,39
Linfield,9273,4,10,5,11,37,37,0,35
Cliftonville,9273,5,10,4,12,33,31,2,34
Ballymena,9273,6,7,4,15,26,50,-24,25
Glentoran,9273,7,6,6,10,24,32,-8,24
Dungannon,9273,8,2,4,16,14,47,-33,10
Crusaders,9274,1,17,6,3,62,30,32,57
Coleraine,9274,2,15,10,1,47,22,25,55
Linfield,9274,3,11,5,10,39,36,3,38
Glenavon,9274,4,9,9,8,52,47,5,36
Cliftonville,9274,5,9,4,13,32,33,-1,31
Ballymena,9274,6,7,4,15,25,48,-23,25
Glentoran,9274,7,6,6,10,24,32,-8,24
Dungannon,9274,8,2,4,16,14,47,-33,10
Crusaders,9275,1,17,6,3,63,30,33,57
Coleraine,9275,2,14,10,2,44,26,18,52
Glenavon,9275,3,10,9,7,56,44,12,39
Linfield,9275,4,11,5,10,39,37,2,38
Cliftonville,9275,5,9,4,13,33,33,0,31
Ballymena,9275,6,7,4,15,25,49,-24,25
Glentoran,9275,7,6,6,10,24,32,-8,24
Dungannon,9275,8,2,4,16,14,47,-33,10
Crusaders,9276,1,16,7,3,63,32,31,55
Coleraine,9276,2,14,11,1,45,24,21,53
Glenavon,9276,3,9,10,7,54,45,9,37
Linfield,9276,4,10,6,10,37,36,1,36
Cliftonville,9276,5,9,5,12,32,31,1,32
Ballymena,9276,6,7,5,14,27,49,-22,26
Glentoran,9276,7,6,6,10,24,32,-8,24
Dungannon,9276,8,2,4,16,14,47,-33,10
Crusaders,9277,1,17,6,3,64,32,32,57
Coleraine,9277,2,14,11,1,45,24,21,53
Linfield,9277,3,11,5,10,40,36,4,38
Glenavon,9277,4,9,10,7,54,45,9,37
Cliftonville,9277,5,9,4,13,32,34,-2,31
Ballymena,9277,6,7,4,15,27,50,-23,25
Glentoran,9277,7,6,6,10,24,32,-8,24
Dungannon,9277,8,2,4,16,14,47,-33,10
Crusaders,9278,1,17,6,3,65,31,34,57
Coleraine,9278,2,14,10,2,43,23,20,52
Glenavon,9278,3,10,9,7,53,43,10,39
Linfield,9278,4,11,5,10,40,37,3,38
Cliftonville,9278,5,9,4,13,33,34,-1,31
Ballymena,9278,6,7,4,15,26,51,-25,25
Glentoran,9278,7,6,6,10,24,32,-8,24
Dungannon,9278,8,2,4,16,14,47,-33,10
Crusaders,9279,1,17,6,3,65,31,34,57
Coleraine,9279,2,14,10,2,43,25,18,52
Glenavon,9279,3,10,9,7,55,43,12,39
Linfield,9279,4,10,6,10,40,39,1,36
Cliftonville,9279,5,9,5,12,35,34,1,32
Ballymena,9279,6,7,4,15,26,51,-25,25
Glentoran,9279,7,6,6,10,24,32,-8,24
Dungannon,9279,8,2,4,16,14,47,-33,10
Crusaders,9280,1,17,6,3,63,30,33,57
Coleraine,9280,2,14,10,2,45,25,20,52
Glenavon,9280,3,10,9,7,55,45,10,39
Linfield,9280,4,10,5,11,38,39,-1,35
Cliftonville,9280,5,10,4,12,35,32,3,34
Ballymena,9280,6,7,4,15,25,49,-24,25
Glentoran,9280,7,6,6,10,24,32,-8,24
Dungannon,9280,8,2,4,16,14,47,-33,10
Crusaders,9281,1,16,7,3,61,30,31,55
Coleraine,9281,2,15,10,1,46,23,23,55
Glenavon,9281,3,9,9,8,53,46,7,36
Linfield,9281,4,10,6,10,39,38,1,36
Cliftonville,9281,5,9,5,12,34,33,1,32
Ballymena,9281,6,7,5,14,25,47,-22,26
Glentoran,9281,7,6,6,10,24,32,-8,24
Dungannon,9281,8,2,4,16,14,47,-33,10
Coleraine,9282,1,15,10,1,48,24,24,55
Crusaders,9282,2,16,6,4,61,32,29,54
Glenavon,9282,3,9,9,8,54,48,6,36
Linfield,9282,4,10,6,10,38,37,1,36
Cliftonville,9282,5,9,5,12,33,32,1,32
Ballymena,9282,6,8,4,14,27,47,-20,28
Glentoran,9282,7,6,6,10,24,32,-8,24
Dungannon,9282,8,2,4,16,14,47,-33,10
Crusaders,9283,1,17,6,3,62,30,32,57
Coleraine,9283,2,15,10,1,45,23,22,55
Glenavon,9283,3,9,9,8,53,45,8,36
Linfield,9283,4,10,6,10,38,37,1,36
Cliftonville,9283,5,9,5,12,33,32,1,32
Ballymena,9283,6,7,4,15,25,48,-23,25
Glentoran,9283,7,6,6,10,24,32,-8,24
Dungannon,9283,8,2,4,16,14,47,-33,10
Crusaders,9284,1,17,6,3,62,30,32,57
Coleraine,9284,2,15,10,1,44,22,22,55
Glenavon,9284,3,9,9,8,52,44,8,36
Linfield,9284,4,10,5,11,37,37,0,35
Cliftonville,9284,5,10,4,12,33,31,2,34
Ballymena,9284,6,7,4,15,25,48,-23,25
Glentoran,9284,7,6,6,10,24,32,-8,24
Dungannon,9284,8,2,4,16,14,47,-33,10
Crusaders,9285,1,16,6,4,62,33,29,54
Coleraine,9285,2,14,11,1,44,23,21,53
Linfield,9285,3,11,5,10,38,36,2,38
Glenavon,9285,4,9,10,7,53,44,9,37
Cliftonville,9285,5,9,4,13,32,32,0,31
Ballymena,9285,6,8,4,14,28,48,-20,28
Glentoran,9285,7,6,6,10,24,32,-8,24
Dungannon,9285,8,2,4,16,14,47,-33,10
Crusaders,9286,1,16,6,4,61,32,29,54
Coleraine,9286,2,14,10,2,43,25,18,52
Glenavon,9286,3,10,9,7,55,43,12,39
Linfield,9286,4,11,5,10,39,37,2,38
Cliftonville,9286,5,9,4,13,33,33,0,31
Ballymena,9286,6,8,4,14,27,47,-20,28
Glentoran,9286,7,6,6,10,24,32,-8,24
Dungannon,9286,8,2,4,16,14,47,-33,10
Crusaders,9287,1,17,6,3,63,30,33,57
Coleraine,9287,2,15,10,1,45,23,22,55
Glenavon,9287,3,9,9,8,53,45,8,36
Linfield,9287,4,10,6,10,38,37,1,36
Cliftonville,9287,5,9,5,12,33,32,1,32
Ballymena,9287,6,7,4,15,25,49,-24,25
Glentoran,9287,7,6,6,10,24,32,-8,24
Dungannon,9287,8,2,4,16,14,47,-33,10
Crusaders,9288,1,17,6,3,63,30,33,57
Coleraine,9288,2,14,10,2,46,26,20,52
Glenavon,9288,3,10,9,7,56,46,10,39
Linfield,9288,4,11,5,10,39,37,2,38
Cliftonville,9288,5,9,4,13,33,33,0,31
Ballymena,9288,6,7,4,15,25,49,-24,25
Glentoran,9288,7,6,6,10,24,32,-8,24
Dungannon,9288,8,2,4,16,14,47,-33,10
Crusaders,9289,1,17,6,3,62,30,32,57
Coleraine,9289,2,14,10,2,45,25,20,52
Glenavon,9289,3,10,9,7,55,45,10,39
Linfield,9289,4,11,5,10,39,37,2,38
Cliftonville,9289,5,9,4,13,33,33,0,31
Ballymena,9289,6,7,4,15,25,48,-23,25
Glentoran,9289,7,6,6,10,24,32,-8,24
Dungannon,9289,8,2,4,16,14,47,-33,10
Crusaders,9290,1,17,6,3,65,30,35,57
Coleraine,9290,2,14,11,1,45,24,21,53
Glenavon,9290,3,9,10,7,54,45,9,37
Linfield,9290,4,10,5,11,37,37,0,35
Cliftonville,9290,5,10,4,12,33,31,2,34
Ballymena,9290,6,7,4,15,25,51,-26,25
Glentoran,9290,7,6,6,10,24,32,-8,24
Dungannon,9290,8,2,4,16,14,47,-33,10
Crusaders,9291,1,17,6,3,65,30,35,57
Coleraine,9291,2,15,10,1,45,23,22,55
Glenavon,9291,3,9,9,8,53,45,8,36
Linfield,9291,4,10,5,11,39,39,0,35
Cliftonville,9291,5,10,4,12,35,33,2,34
Ballymena,9291,6,7,4,15,25,51,-26,25
Glentoran,9291,7,6,6,10,24,32,-8,24
Dungannon,9291,8,2,4,16,14,47,-33,10
Crusaders,9292,1,17,6,3,62,30,32,57
Coleraine,9292,2,15,10,1,46,23,23,55
Linfield,9292,3,11,5,10,38,36,2,38
Glenavon,9292,4,9,9,8,53,46,7,36
Cliftonville,9292,5,9,4,13,32,32,0,31
Ballymena,9292,6,7,4,15,25,48,-23,25
Glentoran,9292,7,6,6,10,24,32,-8,24
Dungannon,9292,8,2,4,16,14,47,-33,10
Crusaders,9293,1,17,6,3,65,30,35,57
Coleraine,9293,2,14,11,1,45,24,21,53
Linfield,9293,3,11,5,10,39,36,3,38
Glenavon,9293,4,9,10,7,54,45,9,37
Cliftonville,9293,5,9,4,13,32,33,-1,31
Ballymena,9293,6,7,4,15,25,51,-26,25
Glentoran,9293,7,6,6,10,24,32,-8,24
Dungannon,9293,8,2,4,16,14,47,-33,10
Crusaders,9294,1,17,6,3,67,31,36,57
Coleraine,9294,2,14,10,2,44,24,20,52
Glenavon,9294,3,10,9,7,54,44,10,39
Linfield,9294,4,11,5,10,40,37,3,38
Cliftonville,9294,5,9,4,13,33,34,-1,31
Ballymena,9294,6,7,4,15,26,53,-27,25
Glentoran,9294,7,6,6,10,24,32,-8,24
Dungannon,9294,8,2,4,16,14,47,-33,10
Crusaders,9295,1,17,6,3,62,30,32,57
Coleraine,9295,2,15,10,1,44,22,22,55
Glenavon,9295,3,9,9,8,52,44,8,36
Linfield,9295,4,10,5,11,38,38,0,35
Cliftonville,9295,5,10,4,12,34,32,2,34
Ballymena,9295,6,7,4,15,25,48,-23,25
Glentoran,9295,7,6,6,10,24,32,-8,24
Dungannon,9295,8,2,4,16,14,47,-33,10
Crusaders,9296,1,17,6,3,62,30,32,57
Coleraine,9296,2,14,10,2,43,25,18,52
Glenavon,9296,3,10,9,7,55,43,12,39
Linfield,9296,4,11,5,10,38,36,2,38
Cliftonville,9296,5,9,4,13,32,32,0,31
Ballymena,9296,6,7,4,15,25,48,-23,25
Glentoran,9296,7,6,6,10,24,32,-8,24
Dungannon,9296,8,2,4,16,14,47,-33,10
Crusaders,9297,1,17,6,3,64,32,32,57
Coleraine,9297,2,14,10,2,43,23,20,52
Glenavon,9297,3,10,9,7,53,43,10,39
Linfield,9297,4,10,5,11,38,38,0,35
Cliftonville,9297,5,10,4,12,34,32,2,34
Ballymena,9297,6,7,4,15,27,50,-23,25
Glentoran,9297,7,6,6,10,24,32,-8,24
Dungannon,9297,8,2,4,16,14,47,-33,10
Crusaders,9298,1,16,6,4,61,33,28,54
Coleraine,9298,2,14,10,2,47,27,20,52
Glenavon,9298,3,10,9,7,57,47,10,39
Linfield,9298,4,11,5,10,39,37,2,38
Cliftonville,9298,5,9,4,13,33,33,0,31
Ballymena,9298,6,8,4,14,28,47,-19,28
Glentoran,9298,7,6,6,10,24,32,-8,24
Dungannon,9298,8,2,4,16,14,47,-33,10
Crusaders,9299,1,17,6,3,64,30,34,57
Coleraine,9299,2,14,10,2,44,25,19,52
Glenavon,9299,3,10,9,7,55,44,11,39
Linfield,9299,4,11,5,10,41,36,5,38
Cliftonville,9299,5,9,4,13,32,35,-3,31
Ballymena,9299,6,7,4,15,25,50,-25,25
Glentoran,9299,7,6,6,10,24,32,-8,24
Dungannon,9299,8,2,4,16,14,47,-33,10
Crusaders,9300,1,17,6,3,65,31,34,57
Coleraine,9300,2,15,10,1,46,24,22,55
Glenavon,9300,3,9,9,8,54,46,8,36
Linfield,9300,4,10,6,10,37,36,1,36
Cliftonville,9300,5,9,5,12,32,31,1,32
Ballymena,9300,6,7,4,15,26,51,-25,25
Glentoran,9300,7,6,6,10,24,32,-8,24
Dungannon,9300,8,2,4,16,14,47,-33,10
Crusaders,9301,1,16,6,4,61,32,29,54
Coleraine,9301,2,14,10,2,43,24,19,52
Glenavon,9301,3,10,9,7,54,43,11,39
Linfield,9301,4,10,5,11,37,38,-1,35
Cliftonville,9301,5,10,4,12,34,31,3,34
Ballymena,9301,6,8,4,14,27,47,-20,28
Glentoran,9301,7,6,6,10,24,32,-8,24
Dungannon,9301,8,2,4,16,14,47,-33,10
Crusaders,9302,1,17,6,3,65,33,32,57
Coleraine,9302,2,14,11,1,45,24,21,53
Glenavon,9302,3,9,10,7,54,45,9,37
Linfield,9302,4,10,5,11,37,37,0,35
Cliftonville,9302,5,10,4,12,33,31,2,34
Ballymena,9302,6,7,4,15,28,51,-23,25
Glentoran,9302,7,6,6,10,24,32,-8,24
Dungannon,9302,8,2,4,16,14,47,-33,10
Crusaders,9303,1,16,6,4,62,33,29,54
Coleraine,9303,2,14,10,2,44,25,19,52
Glenavon,9303,3,10,9,7,55,44,11,39
Linfield,9303,4,10,6,10,37,36,1,36
Cliftonville,9303,5,9,5,12,32,31,1,32
Ballymena,9303,6,8,4,14,28,48,-20,28
Glentoran,9303,7,6,6,10,24,32,-8,24
Dungannon,9303,8,2,4,16,14,47,-33,10
Crusaders,9304,1,17,6,3,64,32,32,57
Coleraine,9304,2,14,11,1,44,23,21,53
Linfield,9304,3,11,5,10,38,36,2,38
Glenavon,9304,4,9,10,7,53,44,9,37
Cliftonville,9304,5,9,4,13,32,32,0,31
Ballymena,9304,6,7,4,15,27,50,-23,25
Glentoran,9304,7,6,6,10,24,32,-8,24
Dungannon,9304,8,2,4,16,14,47,-33,10
Crusaders,9305,1,17,6,3,65,31,34,57
Coleraine,9305,2,14,10,2,43,23,20,52
Glenavon,9305,3,10,9,7,53,43,10,39
Linfield,9305,4,11,5,10,41,36,5,38
Cliftonville,9305,5,9,4,13,32,35,-3,31
Ballymena,9305,6,7,4,15,26,51,-25,25
Glentoran,9305,7,6,6,10,24,32,-8,24
Dungannon,9305,8,2,4,16,14,47,-33,10
Crusaders,9306,1,17,6,3,63,31,32,57
Coleraine,9306,2,15,10,1,47,24,23,55
Glenavon,9306,3,9,9,8,54,47,7,36
Linfield,9306,4,10,6,10,37,36,1,36
Cliftonville,9306,5,9,5,12,32,31,1,32
Ballymena,9306,6,7,4,15,26,49,-23,25
Glentoran,9306,7,6,6,10,24,32,-8,24
Dungannon,9306,8,2,4,16,14,47,-33,10
Crusaders,9307,1,16,7,3,62,31,31,55
Coleraine,9307,2,14,11,1,44,23,21,53
Linfield,9307,3,11,5,10,40,37,3,38
Glenavon,9307,4,9,10,7,53,44,9,37
Cliftonville,9307,5,9,4,13,33,34,-1,31
Ballymena,9307,6,7,5,14,26,48,-22,26
Glentoran,9307,7,6,6,10,24,32,-8,24
Dungannon,9307,8,2,4,16,14,47,-33,10
Crusaders,9308,1,17,6,3,63,31,32,57
Coleraine,9308,2,15,10,1,45,23,22,55
Linfield,9308,3,11,5,10,38,36,2,38
Glenavon,9308,4,9,9,8,53,45,8,36
Cliftonville,9308,5,9,4,13,32,32,0,31
Ballymena,9308,6,7,4,15,26,49,-23,25
Glentoran,9308,7,6,6,10,24,32,-8,24
Dungannon,9308,8,2,4,16,14,47,-33,10
Crusaders,9309,1,17,6,3,65,31,34,57
Coleraine,9309,2,15,10,1,47,23,24,55
Linfield,9309,3,11,5,10,41,36,5,38
Glenavon,9309,4,9,9,8,53,47,6,36
Cliftonville,9309,5,9,4,13,32,35,-3,31
Ballymena,9309,6,7,4,15,26,51,-25,25
Glentoran,9309,7,6,6,10,24,32,-8,24
Dungannon,9309,8,2,4,16,14,47,-33,10
Crusaders,9310,1,17,6,3,64,30,34,57
Coleraine,9310,2,15,10,1,45,23,22,55
Glenavon,9310,3,9,9,8,53,45,8,36
Linfield,9310,4,10,6,10,37,36,1,36
Cliftonville,9310,5,9,5,12,32,31,1,32
Ballymena,9310,6,7,4,15,25,50,-25,25
Glentoran,9310,7,6,6,10,24,32,-8,24
Dungannon,9310,8,2,4,16,14,47,-33,10
Crusaders,9311,1,17,6,3,65,30,35,57
Coleraine,9311,2,15,10,1,45,22,23,55
Glenavon,9311,3,9,9,8,52,45,7,36
Linfield,9311,4,10,5,11,38,39,-1,35
Cliftonville,9311,5,10,4,12,35,32,3,34
Ballymena,9311,6,7,4,15,25,51,-26,25
Glentoran,9311,7,6,6,10,24,32,-8,24
Dungannon,9311,8,2,4,16,14,47,-33,10
Crusaders,9312,1,16,7,3,61,30,31,55
Coleraine,9312,2,15,10,1,47,25,22,55
Glenavon,9312,3,9,9,8,55,47,8,36
Linfield,9312,4,10,5,11,38,39,-1,35
Cliftonville,9312,5,10,4,12,35,32,3,34
Ballymena,9312,6,7,5,14,25,47,-22,26
Glentoran,9312,7,6,6,10,24,32,-8,24
Dungannon,9312,8,2,4,16,14,47,-33,10
Coleraine,9313,1,15,10,1,46,22,24,55
Crusaders,9313,2,16,6,4,62,32,30,54
Glenavon,9313,3,9,9,8,52,46,6,36
Linfield,9313,4,10,5,11,37,39,-2,35
Cliftonville,9313,5,10,4,12,35,31,4,34
Ballymena,9313,6,8,4,14,27,48,-21,28
Glentoran,9313,7,6,6,10,24,32,-8,24
Dungannon,9313,8,2,4,16,14,47,-33,10
Coleraine,9314,1,15,10,1,45,23,22,55
Crusaders,9314,2,16,6,4,61,32,29,54
Glenavon,9314,3,9,9,8,53,45,8,36
Linfield,9314,4,10,5,11,38,38,0,35
Cliftonville,9314,5,10,4,12,34,32,2,34
Ballymena,9314,6,8,4,14,27,47,-20,28
Glentoran,9314,7,6,6,10,24,32,-8,24
Dungannon,9314,8,2,4,16,14,47,-33,10
Crusaders,9315,1,16,7,3,64,33,31,55
Coleraine,9315,2,14,10,2,43,25,18,52
Glenavon,9315,3,10,9,7,55,43,12,39
Linfield,9315,4,10,5,11,38,38,0,35
Cliftonville,9315,5,10,4,12,34,32,2,34
Ballymena,9315,6,7,5,14,28,50,-22,26
Glentoran,9315,7,6,6,10,24,32,-8,24
Dungannon,9315,8,2,4,16,14,47,-33,10
Crusaders,9316,1,17,6,3,63,31,32,57
Coleraine,9316,2,15,10,1,45,22,23,55
Linfield,9316,3,11,5,10,39,37,2,38
Glenavon,9316,4,9,9,8,52,45,7,36
Cliftonville,9316,5,9,4,13,33,33,0,31
Ballymena,9316,6,7,4,15,26,49,-23,25
Glentoran,9316,7,6,6,10,24,32,-8,24
Dungannon,9316,8,2,4,16,14,47,-33,10
Crusaders,9317,1,17,6,3,63,30,33,57
Coleraine,9317,2,15,10,1,44,22,22,55
Linfield,9317,3,11,5,10,38,36,2,38
Glenavon,9317,4,9,9,8,52,44,8,36
Cliftonville,9317,5,9,4,13,32,32,0,31
Ballymena,9317,6,7,4,15,25,49,-24,25
Glentoran,9317,7,6,6,10,24,32,-8,24
Dungannon,9317,8,2,4,16,14,47,-33,10
Crusaders,9318,1,16,7,3,62,31,31,55
Coleraine,9318,2,14,10,2,45,26,19,52
Glenavon,9318,3,10,9,7,56,45,11,39
Linfield,9318,4,11,5,10,40,36,4,38
Cliftonville,9318,5,9,4,13,32,34,-2,31
Ballymena,9318,6,7,5,14,26,48,-22,26
Glentoran,9318,7,6,6,10,24,32,-8,24
Dungannon,9318,8,2,4,16,14,47,-33,10
Crusaders,9319,1,16,7,3,63,32,31,55
Coleraine,9319,2,14,10,2,44,25,19,52
Glenavon,9319,3,10,9,7,55,44,11,39
Linfield,9319,4,11,5,10,41,36,5,38
Cliftonville,9319,5,9,4,13,32,35,-3,31
Ballymena,9319,6,7,5,14,27,49,-22,26
Glentoran,9319,7,6,6,10,24,32,-8,24
Dungannon,9319,8,2,4,16,14,47,-33,10
Crusaders,9320,1,16,7,3,63,32,31,55
Coleraine,9320,2,15,10,1,44,22,22,55
Linfield,9320,3,11,5,10,38,36,2,38
Glenavon,9320,4,9,9,8,52,44,8,36
Cliftonville,9320,5,9,4,13,32,32,0,31
Ballymena,9320,6,7,5,14,27,49,-22,26
Glentoran,9320,7,6,6,10,24,32,-8,24
Dungannon,9320,8,2,4,16,14,47,-33,10
Crusaders,9321,1,17,6,3,64,32,32,57
Coleraine,9321,2,15,10,1,44,22,22,55
Linfield,9321,3,11,5,10,40,37,3,38
Glenavon,9321,4,9,9,8,52,44,8,36
Cliftonville,9321,5,9,4,13,33,34,-1,31
Ballymena,9321,6,7,4,15,27,50,-23,25
Glentoran,9321,7,6,6,10,24,32,-8,24
Dungannon,9321,8,2,4,16,14,47,-33,10
Crusaders,9322,1,16,6,4,62,32,30,54
Coleraine,9322,2,14,10,2,45,26,19,52
Glenavon,9322,3,10,9,7,56,45,11,39
Linfield,9322,4,11,5,10,38,36,2,38
Cliftonville,9322,5,9,4,13,32,32,0,31
Ballymena,9322,6,8,4,14,27,48,-21,28
Glentoran,9322,7,6,6,10,24,32,-8,24
Dungannon,9322,8,2,4,16,14,47,-33,10
Crusaders,9323,1,16,7,3,62,31,31,55
Coleraine,9323,2,14,10,2,44,26,18,52
Glenavon,9323,3,10,9,7,56,44,12,39
Linfield,9323,4,11,5,10,40,36,4,38
Cliftonville,9323,5,9,4,13,32,34,-2,31
Ballymena,9323,6,7,5,14,26,48,-22,26
Glentoran,9323,7,6,6,10,24,32,-8,24
Dungannon,9323,8,2,4,16,14,47,-33,10
Crusaders,9324,1,17,6,3,65,32,33,57
Coleraine,9324,2,15,10,1,45,23,22,55
Linfield,9324,3,11,5,10,38,36,2,38
Glenavon,9324,4,9,9,8,53,45,8,36
Cliftonville,9324,5,9,4,13,32,32,0,31
Ballymena,9324,6,7,4,15,27,51,-24,25
Glentoran,9324,7,6,6,10,24,32,-8,24
Dungannon,9324,8,2,4,16,14,47,-33,10
Crusaders,9325,1,17,6,3,65,32,33,57
Coleraine,9325,2,15,10,1,46,22,24,55
Linfield,9325,3,11,5,10,41,36,5,38
Glenavon,9325,4,9,9,8,52,46,6,36
Cliftonville,9325,5,9,4,13,32,35,-3,31
Ballymena,9325,6,7,4,15,27,51,-24,25
Glentoran,9325,7,6,6,10,24,32,-8,24
Dungannon,9325,8,2,4,16,14,47,-33,10
Crusaders,9326,1,17,6,3,63,31,32,57
Coleraine,9326,2,14,10,2,44,24,20,52
Glenavon,9326,3,10,9,7,54,44,10,39
Linfield,9326,4,11,5,10,39,37,2,38
Cliftonville,9326,5,9,4,13,33,33,0,31
Ballymena,9326,6,7,4,15,26,49,-23,25
Glentoran,9326,7,6,6,10,24,32,-8,24
Dungannon,9326,8,2,4,16,14,47,-33,10
Crusaders,9327,1,16,7,3,62,31,31,55
Coleraine,9327,2,14,10,2,44,25,19,52
Glenavon,9327,3,10,9,7,55,44,11,39
Linfield,9327,4,11,5,10,38,36,2,38
Cliftonville,9327,5,9,4,13,32,32,0,31
Ballymena,9327,6,7,5,14,26,48,-22,26
Glentoran,9327,7,6,6,10,24,32,-8,24
Dungannon,9327,8,2,4,16,14,47,-33,10
Crusaders,9328,1,17,6,3,63,30,33,57
Coleraine,9328,2,15,10,1,46,22,24,55
Linfield,9328,3,11,5,10,39,37,2,38
Glenavon,9328,4,9,9,8,52,46,6,36
Cliftonville,9328,5,9,4,13,33,33,0,31
Ballymena,9328,6,7,4,15,25,49,-24,25
Glentoran,9328,7,6,6,10,24,32,-8,24
Dungannon,9328,8,2,4,16,14,47,-33,10
Crusaders,9329,1,16,6,4,61,31,30,54
Coleraine,9329,2,14,11,1,44,23,21,53
Linfield,9329,3,11,5,10,39,36,3,38
Glenavon,9329,4,9,10,7,53,44,9,37
Cliftonville,9329,5,9,4,13,32,33,-1,31
Ballymena,9329,6,8,4,14,26,47,-21,28
Glentoran,9329,7,6,6,10,24,32,-8,24
Dungannon,9329,8,2,4,16,14,47,-33,10
Crusaders,9330,1,16,7,3,62,31,31,55
Coleraine,9330,2,14,10,2,43,26,17,52
Glenavon,9330,3,10,9,7,56,43,13,39
Linfield,9330,4,10,5,11,38,38,0,35
Cliftonville,9330,5,10,4,12,34,32,2,34
Ballymena,9330,6,7,5,14,26,48,-22,26
Glentoran,9330,7,6,6,10,24,32,-8,24
Dungannon,9330,8,2,4,16,14,47,-33,10
Crusaders,9331,1,17,6,3,64,32,32,57
Coleraine,9331,2,14,10,2,43,25,18,52
Glenavon,9331,3,10,9,7,55,43,12,39
Linfield,9331,4,10,5,11,37,37,0,35
Cliftonville,9331,5,10,4,12,33,31,2,34
Ballymena,9331,6,7,4,15,27,50,-23,25
Glentoran,9331,7,6,6,10,24,32,-8,24
Dungannon,9331,8,2,4,16,14,47,-33,10
Coleraine,9332,1,15,10,1,44,22,22,55
Crusaders,9332,2,16,6,4,62,32,30,54
Linfield,9332,3,11,5,10,41,36,5,38
Glenavon,9332,4,9,9,8,52,44,8,36
Cliftonville,9332,5,9,4,13,32,35,-3,31
Ballymena,9332,6,8,4,14,27,48,-21,28
Glentoran,9332,7,6,6,10,24,32,-8,24
Dungannon,9332,8,2,4,16,14,47,-33,10
Crusaders,9333,1,16,7,3,64,33,31,55
Coleraine,9333,2,14,11,1,43,22,21,53
Linfield,9333,3,11,5,10,39,37,2,38
Glenavon,9333,4,9,10,7,52,43,9,37
Cliftonville,9333,5,9,4,13,33,33,0,31
Ballymena,9333,6,7,5,14,28,50,-22,26
Glentoran,9333,7,6,6,10,24,32,-8,24
Dungannon,9333,8,2,4,16,14,47,-33,10
Crusaders,9334,1,17,6,3,63,31,32,57
Coleraine,9334,2,14,10,2,44,24,20,52
Glenavon,9334,3,10,9,7,54,44,10,39
Linfield,9334,4,10,6,10,37,36,1,36
Cliftonville,9334,5,9,5,12,32,31,1,32
Ballymena,9334,6,7,4,15,26,49,-23,25
Glentoran,9334,7,6,6,10,24,32,-8,24
Dungannon,9334,8,2,4,16,14,47,-33,10
Crusaders,9335,1,16,6,4,62,32,30,54
Coleraine,9335,2,14,10,2,44,25,19,52
Glenavon,9335,3,10,9,7,55,44,11,39
Linfield,9335,4,10,6,10,38,37,1,36
Cliftonville,9335,5,9,5,12,33,32,1,32
Ballymena,9335,6,8,4,14,27,48,-21,28
Glentoran,9335,7,6,6,10,24,32,-8,24
Dungannon,9335,8,2,4,16,14,47,-33,10
Crusaders,9336,1,16,6,4,63,35,28,54
Coleraine,9336,2,14,10,2,44,26,18,52
Glenavon,9336,3,10,9,7,56,44,12,39
Linfield,9336,4,11,5,10,39,37,2,38
Cliftonville,9336,5,9,4,13,33,33,0,31
Ballymena,9336,6,8,4,14,30,49,-19,28
Glentoran,9336,7,6,6,10,24,32,-8,24
Dungannon,9336,8,2,4,16,14,47,-33,10
Crusaders,9337,1,17,6,3,62,30,32,57
Coleraine,9337,2,15,10,1,46,24,22,55
Linfield,9337,3,11,5,10,38,36,2,38
Glenavon,9337,4,9,9,8,54,46,8,36
Cliftonville,9337,5,9,4,13,32,32,0,31
Ballymena,9337,6,7,4,15,25,48,-23,25
Glentoran,9337,7,6,6,10,24,32,-8,24
Dungannon,9337,8,2,4,16,14,47,-33,10
Crusaders,9338,1,17,6,3,65,32,33,57
Coleraine,9338,2,14,10,2,44,26,18,52
Glenavon,9338,3,10,9,7,56,44,12,39
Linfield,9338,4,10,5,11,37,37,0,35
Cliftonville,9338,5,10,4,12,33,31,2,34
Ballymena,9338,6,7,4,15,27,51,-24,25
Glentoran,9338,7,6,6,10,24,32,-8,24
Dungannon,9338,8,2,4,16,14,47,-33,10
Crusaders,9339,1,16,7,3,62,31,31,55
Coleraine,9339,2,14,10,2,44,24,20,52
Glenavon,9339,3,10,9,7,54,44,10,39
Linfield,9339,4,11,5,10,38,36,2,38
Cliftonville,9339,5,9,4,13,32,32,0,31
Ballymena,9339,6,7,5,14,26,48,-22,26
Glentoran,9339,7,6,6,10,24,32,-8,24
Dungannon,9339,8,2,4,16,14,47,-33,10
Crusaders,9340,1,17,6,3,63,30,33,57
Coleraine,9340,2,14,10,2,45,25,20,52
Glenavon,9340,3,10,9,7,55,45,10,39
Linfield,9340,4,10,6,10,37,36,1,36
Cliftonville,9340,5,9,5,12,32,31,1,32
Ballymena,9340,6,7,4,15,25,49,-24,25
Glentoran,9340,7,6,6,10,24,32,-8,24
Dungannon,9340,8,2,4,16,14,47,-33,10
Crusaders,9341,1,16,7,3,63,32,31,55
Coleraine,9341,2,14,10,2,44,26,18,52
Glenavon,9341,3,10,9,7,56,44,12,39
Linfield,9341,4,10,6,10,37,36,1,36
Cliftonville,9341,5,9,5,12,32,31,1,32
Ballymena,9341,6,7,5,14,27,49,-22,26
Glentoran,9341,7,6,6,10,24,32,-8,24
Dungannon,9341,8,2,4,16,14,47,-33,10
Crusaders,9342,1,17,6,3,63,30,33,57
Coleraine,9342,2,14,11,1,45,24,21,53
Linfield,9342,3,11,5,10,39,37,2,38
Glenavon,9342,4,9,10,7,54,45,9,37
Cliftonville,9342,5,9,4,13,33,33,0,31
Ballymena,9342,6,7,4,15,25,49,-24,25
Glentoran,9342,7,6,6,10,24,32,-8,24
Dungannon,9342,8,2,4,16,14,47,-33,10
Crusaders,9343,1,17,6,3,63,30,33,57
Coleraine,9343,2,14,10,2,43,23,20,52
Glenavon,9343,3,10,9,7,53,43,10,39
Linfield,9343,4,10,5,11,37,39,-2,35
Cliftonville,9343,5,10,4,12,35,31,4,34
Ballymena,9343,6,7,4,15,25,49,-24,25
Glentoran,9343,7,6,6,10,24,32,-8,24
Dungannon,9343,8,2,4,16,14,47,-33,10
Crusaders,9344,1,17,6,3,64,31,33,57
Coleraine,9344,2,14,10,2,44,27,17,52
Glenavon,9344,3,10,9,7,57,44,13,39
Linfield,9344,4,10,6,10,38,37,1,36
Cliftonville,9344,5,9,5,12,33,32,1,32
Ballymena,9344,6,7,4,15,26,50,-24,25
Glentoran,9344,7,6,6,10,24,32,-8,24
Dungannon,9344,8,2,4,16,14,47,-33,10
Crusaders,9345,1,17,6,3,62,30,32,57
Coleraine,9345,2,14,10,2,44,24,20,52
Glenavon,9345,3,10,9,7,54,44,10,39
Linfield,9345,4,11,5,10,40,37,3,38
Cliftonville,9345,5,9,4,13,33,34,-1,31
Ballymena,9345,6,7,4,15,25,48,-23,25
Glentoran,9345,7,6,6,10,24,32,-8,24
Dungannon,9345,8,2,4,16,14,47,-33,10
Crusaders,9346,1,17,6,3,64,30,34,57
Coleraine,9346,2,14,10,2,43,23,20,52
Glenavon,9346,3,10,9,7,53,43,10,39
Linfield,9346,4,11,5,10,39,37,2,38
Cliftonville,9346,5,9,4,13,33,33,0,31
Ballymena,9346,6,7,4,15,25,50,-25,25
Glentoran,9346,7,6,6,10,24,32,-8,24
Dungannon,9346,8,2,4,16,14,47,-33,10
Crusaders,9347,1,17,6,3,63,30,33,57
Coleraine,9347,2,14,10,2,43,27,16,52
Glenavon,9347,3,10,9,7,57,43,14,39
Linfield,9347,4,11,5,10,39,36,3,38
Cliftonville,9347,5,9,4,13,32,33,-1,31
Ballymena,9347,6,7,4,15,25,49,-24,25
Glentoran,9347,7,6,6,10,24,32,-8,24
Dungannon,9347,8,2,4,16,14,47,-33,10
Crusaders,9348,1,16,7,3,63,32,31,55
Coleraine,9348,2,15,10,1,45,23,22,55
Linfield,9348,3,11,5,10,39,36,3,38
Glenavon,9348,4,9,9,8,53,45,8,36
Cliftonville,9348,5,9,4,13,32,33,-1,31
Ballymena,9348,6,7,5,14,27,49,-22,26
Glentoran,9348,7,6,6,10,24,32,-8,24
Dungannon,9348,8,2,4,16,14,47,-33,10
Crusaders,9349,1,17,6,3,65,30,35,57
Coleraine,9349,2,14,10,2,43,25,18,52
Glenavon,9349,3,10,9,7,55,43,12,39
Linfield,9349,4,11,5,10,40,36,4,38
Cliftonville,9349,5,9,4,13,32,34,-2,31
Ballymena,9349,6,7,4,15,25,51,-26,25
Glentoran,9349,7,6,6,10,24,32,-8,24
Dungannon,9349,8,2,4,16,14,47,-33,10
Crusaders,9350,1,16,7,3,65,34,31,55
Coleraine,9350,2,14,10,2,45,27,18,52
Glenavon,9350,3,10,9,7,57,45,12,39
Linfield,9350,4,11,5,10,39,37,2,38
Cliftonville,9350,5,9,4,13,33,33,0,31
Ballymena,9350,6,7,5,14,29,51,-22,26
Glentoran,9350,7,6,6,10,24,32,-8,24
Dungannon,9350,8,2,4,16,14,47,-33,10
Crusaders,9351,1,17,6,3,64,30,34,57
Coleraine,9351,2,14,10,2,47,27,20,52
Glenavon,9351,3,10,9,7,57,47,10,39
Linfield,9351,4,10,5,11,37,37,0,35
Cliftonville,9351,5,10,4,12,33,31,2,34
Ballymena,9351,6,7,4,15,25,50,-25,25
Glentoran,9351,7,6,6,10,24,32,-8,24
Dungannon,9351,8,2,4,16,14,47,-33,10
Crusaders,9352,1,17,6,3,64,31,33,57
Coleraine,9352,2,15,10,1,46,24,22,55
Linfield,9352,3,11,5,10,38,36,2,38
Glenavon,9352,4,9,9,8,54,46,8,36
Cliftonville,9352,5,9,4,13,32,32,0,31
Ballymena,9352,6,7,4,15,26,50,-24,25
Glentoran,9352,7,6,6,10,24,32,-8,24
Dungannon,9352,8,2,4,16,14,47,-33,10
Crusaders,9353,1,17,6,3,64,32,32,57
Coleraine,9353,2,15,10,1,45,23,22,55
Linfield,9353,3,11,5,10,40,37,3,38
Glenavon,9353,4,9,9,8,53,45,8,36
Cliftonville,9353,5,9,4,13,33,34,-1,31
Ballymena,9353,6,7,4,15,27,50,-23,25
Glentoran,9353,7,6,6,10,24,32,-8,24
Dungannon,9353,8,2,4,16,14,47,-33,10
Crusaders,9354,1,17,6,3,62,30,32,57
Coleraine,9354,2,15,10,1,45,23,22,55
Linfield,9354,3,11,5,10,39,36,3,38
Glenavon,9354,4,9,9,8,53,45,8,36
Cliftonville,9354,5,9,4,13,32,33,-1,31
Ballymena,9354,6,7,4,15,25,48,-23,25
Glentoran,9354,7,6,6,10,24,32,-8,24
Dungannon,9354,8,2,4,16,14,47,-33,10
Crusaders,9355,1,17,6,3,62,30,32,57
Coleraine,9355,2,14,11,1,44,23,21,53
Linfield,9355,3,11,5,10,41,37,4,38
Glenavon,9355,4,9,10,7,53,44,9,37
Cliftonville,9355,5,9,4,13,33,35,-2,31
Ballymena,9355,6,7,4,15,25,48,-23,25
Glentoran,9355,7,6,6,10,24,32,-8,24
Dungannon,9355,8,2,4,16,14,47,-33,10
Coleraine,9356,1,15,10,1,45,22,23,55
Crusaders,9356,2,16,6,4,62,32,30,54
Linfield,9356,3,11,5,10,39,36,3,38
Glenavon,9356,4,9,9,8,52,45,7,36
Cliftonville,9356,5,9,4,13,32,33,-1,31
Ballymena,9356,6,8,4,14,27,48,-21,28
Glentoran,9356,7,6,6,10,24,32,-8,24
Dungannon,9356,8,2,4,16,14,47,-33,10
Coleraine,9357,1,15,10,1,46,24,22,55
Crusaders,9357,2,16,6,4,62,32,30,54
Linfield,9357,3,11,5,10,39,37,2,38
Glenavon,9357,4,9,9,8,54,46,8,36
Cliftonville,9357,5,9,4,13,33,33,0,31
Ballymena,9357,6,8,4,14,27,48,-21,28
Glentoran,9357,7,6,6,10,24,32,-8,24
Dungannon,9357,8,2,4,16,14,47,-33,10
Crusaders,9358,1,17,6,3,66,33,33,57
Coleraine,9358,2,14,11,1,45,24,21,53
Glenavon,9358,3,9,10,7,54,45,9,37
Linfield,9358,4,10,5,11,37,37,0,35
Cliftonville,9358,5,10,4,12,33,31,2,34
Ballymena,9358,6,7,4,15,28,52,-24,25
Glentoran,9358,7,6,6,10,24,32,-8,24
Dungannon,9358,8,2,4,16,14,47,-33,10
Crusaders,9359,1,16,7,3,62,31,31,55
Coleraine,9359,2,14,10,2,45,25,20,52
Glenavon,9359,3,10,9,7,55,45,10,39
Linfield,9359,4,11,5,10,40,37,3,38
Cliftonville,9359,5,9,4,13,33,34,-1,31
Ballymena,9359,6,7,5,14,26,48,-22,26
Glentoran,9359,7,6,6,10,24,32,-8,24
Dungannon,9359,8,2,4,16,14,47,-33,10
Crusaders,9360,1,17,6,3,62,30,32,57
Coleraine,9360,2,14,10,2,43,25,18,52
Glenavon,9360,3,10,9,7,55,43,12,39
Linfield,9360,4,11,5,10,38,36,2,38
Cliftonville,9360,5,9,4,13,32,32,0,31
Ballymena,9360,6,7,4,15,25,48,-23,25
Glentoran,9360,7,6,6,10,24,32,-8,24
Dungannon,9360,8,2,4,16,14,47,-33,10
Crusaders,9361,1,17,6,3,64,31,33,57
Coleraine,9361,2,15,10,1,46,24,22,55
Linfield,9361,3,11,5,10,38,36,2,38
Glenavon,9361,4,9,9,8,54,46,8,36
Cliftonville,9361,5,9,4,13,32,32,0,31
Ballymena,9361,6,7,4,15,26,50,-24,25
Glentoran,9361,7,6,6,10,24,32,-8,24
Dungannon,9361,8,2,4,16,14,47,-33,10
Crusaders,9362,1,17,6,3,64,30,34,57
Coleraine,9362,2,15,10,1,44,22,22,55
Linfield,9362,3,11,5,10,39,37,2,38
Glenavon,9362,4,9,9,8,52,44,8,36
Cliftonville,9362,5,9,4,13,33,33,0,31
Ballymena,9362,6,7,4,15,25,50,-25,25
Glentoran,9362,7,6,6,10,24,32,-8,24
Dungannon,9362,8,2,4,16,14,47,-33,10
Crusaders,9363,1,17,6,3,64,31,33,57
Coleraine,9363,2,14,10,2,44,25,19,52
Glenavon,9363,3,10,9,7,55,44,11,39
Linfield,9363,4,10,5,11,37,37,0,35
Cliftonville,9363,5,10,4,12,33,31,2,34
Ballymena,9363,6,7,4,15,26,50,-24,25
Glentoran,9363,7,6,6,10,24,32,-8,24
Dungannon,9363,8,2,4,16,14,47,-33,10
Crusaders,9364,1,17,6,3,66,32,34,57
Coleraine,9364,2,14,10,2,44,26,18,52
Glenavon,9364,3,10,9,7,56,44,12,39
Linfield,9364,4,10,6,10,38,37,1,36
Cliftonville,9364,5,9,5,12,33,32,1,32
Ballymena,9364,6,7,4,15,27,52,-25,25
Glentoran,9364,7,6,6,10,24,32,-8,24
Dungannon,9364,8,2,4,16,14,47,-33,10
Crusaders,9365,1,17,6,3,63,30,33,57
Coleraine,9365,2,14,11,1,44,23,21,53
Linfield,9365,3,11,5,10,41,37,4,38
Glenavon,9365,4,9,10,7,53,44,9,37
Cliftonville,9365,5,9,4,13,33,35,-2,31
Ballymena,9365,6,7,4,15,25,49,-24,25
Glentoran,9365,7,6,6,10,24,32,-8,24
Dungannon,9365,8,2,4,16,14,47,-33,10
Crusaders,9366,1,16,7,3,64,33,31,55
Coleraine,9366,2,14,11,1,44,23,21,53
Linfield,9366,3,11,5,10,39,37,2,38
Glenavon,9366,4,9,10,7,53,44,9,37
Cliftonville,9366,5,9,4,13,33,33,0,31
Ballymena,9366,6,7,5,14,28,50,-22,26
Glentoran,9366,7,6,6,10,24,32,-8,24
Dungannon,9366,8,2,4,16,14,47,-33,10
Crusaders,9367,1,17,6,3,63,31,32,57
Coleraine,9367,2,14,10,2,44,26,18,52
Glenavon,9367,3,10,9,7,56,44,12,39
Linfield,9367,4,11,5,10,40,36,4,38
Cliftonville,9367,5,9,4,13,32,34,-2,31
Ballymena,9367,6,7,4,15,26,49,-23,25
Glentoran,9367,7,6,6,10,24,32,-8,24
Dungannon,9367,8,2,4,16,14,47,-33,10
Crusaders,9368,1,16,7,3,62,31,31,55
Coleraine,9368,2,14,11,1,46,25,21,53
Glenavon,9368,3,9,10,7,55,46,9,37
Linfield,9368,4,10,6,10,37,36,1,36
Cliftonville,9368,5,9,5,12,32,31,1,32
Ballymena,9368,6,7,5,14,26,48,-22,26
Glentoran,9368,7,6,6,10,24,32,-8,24
Dungannon,9368,8,2,4,16,14,47,-33,10
Crusaders,9369,1,17,6,3,65,30,35,57
Coleraine,9369,2,14,10,2,45,25,20,52
Glenavon,9369,3,10,9,7,55,45,10,39
Linfield,9369,4,10,6,10,37,36,1,36
Cliftonville,9369,5,9,5,12,32,31,1,32
Ballymena,9369,6,7,4,15,25,51,-26,25
Glentoran,9369,7,6,6,10,24,32,-8,24
Dungannon,9369,8,2,4,16,14,47,-33,10
Crusaders,9370,1,17,6,3,65,32,33,57
Coleraine,9370,2,15,10,1,46,24,22,55
Linfield,9370,3,11,5,10,39,37,2,38
Glenavon,9370,4,9,9,8,54,46,8,36
Cliftonville,9370,5,9,4,13,33,33,0,31
Ballymena,9370,6,7,4,15,27,51,-24,25
Glentoran,9370,7,6,6,10,24,32,-8,24
Dungannon,9370,8,2,4,16,14,47,-33,10
Crusaders,9371,1,17,6,3,62,30,32,57
Coleraine,9371,2,14,10,2,44,25,19,52
Glenavon,9371,3,10,9,7,55,44,11,39
Linfield,9371,4,10,5,11,37,37,0,35
Cliftonville,9371,5,10,4,12,33,31,2,34
Ballymena,9371,6,7,4,15,25,48,-23,25
Glentoran,9371,7,6,6,10,24,32,-8,24
Dungannon,9371,8,2,4,16,14,47,-33,10
Crusaders,9372,1,17,6,3,65,30,35,57
Coleraine,9372,2,14,11,1,45,24,21,53
Linfield,9372,3,11,5,10,39,37,2,38
Glenavon,9372,4,9,10,7,54,45,9,37
Cliftonville,9372,5,9,4,13,33,33,0,31
Ballymena,9372,6,7,4,15,25,51,-26,25
Glentoran,9372,7,6,6,10,24,32,-8,24
Dungannon,9372,8,2,4,16,14,47,-33,10
Crusaders,9373,1,17,6,3,63,30,33,57
Coleraine,9373,2,15,10,1,45,23,22,55
Glenavon,9373,3,9,9,8,53,45,8,36
Linfield,9373,4,10,6,10,38,37,1,36
Cliftonville,9373,5,9,5,12,33,32,1,32
Ballymena,9373,6,7,4,15,25,49,-24,25
Glentoran,9373,7,6,6,10,24,32,-8,24
Dungannon,9373,8,2,4,16,14,47,-33,10
Crusaders,9374,1,17,6,3,63,31,32,57
Coleraine,9374,2,15,10,1,45,23,22,55
Linfield,9374,3,11,5,10,38,36,2,38
Glenavon,9374,4,9,9,8,53,45,8,36
Cliftonville,9374,5,9,4,13,32,32,0,31
Ballymena,9374,6,7,4,15,26,49,-23,25
Glentoran,9374,7,6,6,10,24,32,-8,24
Dungannon,9374,8,2,4,16,14,47,-33,10
Crusaders,9375,1,17,6,3,63,31,32,57
Coleraine,9375,2,14,11,1,45,24,21,53
Linfield,9375,3,11,5,10,39,36,3,38
Glenavon,9375,4,9,10,7,54,45,9,37
Cliftonville,9375,5,9,4,13,32,33,-1,31
Ballymena,9375,6,7,4,15,26,49,-23,25
Glentoran,9375,7,6,6,10,24,32,-8,24
Dungannon,9375,8,2,4,16,14,47,-33,10
Crusaders,9376,1,16,7,3,62,31,31,55
Coleraine,9376,2,15,10,1,44,22,22,55
Glenavon,9376,3,9,9,8,52,44,8,36
Linfield,9376,4,10,5,11,38,39,-1,35
Cliftonville,9376,5,10,4,12,35,32,3,34
Ballymena,9376,6,7,5,14,26,48,-22,26
Glentoran,9376,7,6,6,10,24,32,-8,24
Dungannon,9376,8,2,4,16,14,47,-33,10
Crusaders,9377,1,17,6,3,65,32,33,57
Coleraine,9377,2,14,10,2,43,23,20,52
Glenavon,9377,3,10,9,7,53,43,10,39
Linfield,9377,4,10,5,11,37,37,0,35
Cliftonville,9377,5,10,4,12,33,31,2,34
Ballymena,9377,6,7,4,15,27,51,-24,25
Glentoran,9377,7,6,6,10,24,32,-8,24
Dungannon,9377,8,2,4,16,14,47,-33,10
Crusaders,9378,1,16,7,3,63,32,31,55
Coleraine,9378,2,15,10,1,46,22,24,55
Glenavon,9378,3,9,9,8,52,46,6,36
Linfield,9378,4,10,6,10,38,37,1,36
Cliftonville,9378,5,9,5,12,33,32,1,32
Ballymena,9378,6,7,5,14,27,49,-22,26
Glentoran,9378,7,6,6,10,24,32,-8,24
Dungannon,9378,8,2,4,16,14,47,-33,10
Crusaders,9379,1,17,6,3,63,30,33,57
Coleraine,9379,2,14,10,2,43,26,17,52
Glenavon,9379,3,10,9,7,56,43,13,39
Linfield,9379,4,11,5,10,38,36,2,38
Cliftonville,9379,5,9,4,13,32,32,0,31
Ballymena,9379,6,7,4,15,25,49,-24,25
Glentoran,9379,7,6,6,10,24,32,-8,24
Dungannon,9379,8,2,4,16,14,47,-33,10
Crusaders,9380,1,17,6,3,62,30,32,57
Coleraine,9380,2,14,11,1,43,22,21,53
Glenavon,9380,3,9,10,7,52,43,9,37
Linfield,9380,4,10,6,10,37,36,1,36
Cliftonville,9380,5,9,5,12,32,31,1,32
Ballymena,9380,6,7,4,15,25,48,-23,25
Glentoran,9380,7,6,6,10,24,32,-8,24
Dungannon,9380,8,2,4,16,14,47,-33,10
Crusaders,9381,1,17,6,3,63,30,33,57
Coleraine,9381,2,14,10,2,44,24,20,52
Glenavon,9381,3,10,9,7,54,44,10,39
Linfield,9381,4,10,6,10,38,37,1,36
Cliftonville,9381,5,9,5,12,33,32,1,32
Ballymena,9381,6,7,4,15,25,49,-24,25
Glentoran,9381,7,6,6,10,24,32,-8,24
Dungannon,9381,8,2,4,16,14,47,-33,10
Crusaders,9382,1,17,6,3,63,30,33,57
Coleraine,9382,2,14,10,2,44,24,20,52
Glenavon,9382,3,10,9,7,54,44,10,39
Linfield,9382,4,10,5,11,37,38,-1,35
Cliftonville,9382,5,10,4,12,34,31,3,34
Ballymena,9382,6,7,4,15,25,49,-24,25
Glentoran,9382,7,6,6,10,24,32,-8,24
Dungannon,9382,8,2,4,16,14,47,-33,10
Crusaders,9383,1,16,7,3,63,32,31,55
Coleraine,9383,2,14,10,2,43,23,20,52
Glenavon,9383,3,10,9,7,53,43,10,39
Linfield,9383,4,11,5,10,39,36,3,38
Cliftonville,9383,5,9,4,13,32,33,-1,31
Ballymena,9383,6,7,5,14,27,49,-22,26
Glentoran,9383,7,6,6,10,24,32,-8,24
Dungannon,9383,8,2,4,16,14,47,-33,10
Coleraine,9384,1,15,10,1,47,22,25,55
Crusaders,9384,2,16,6,4,62,33,29,54
Linfield,9384,3,11,5,10,40,36,4,38
Glenavon,9384,4,9,9,8,52,47,5,36
Cliftonville,9384,5,9,4,13,32,34,-2,31
Ballymena,9384,6,8,4,14,28,48,-20,28
Glentoran,9384,7,6,6,10,24,32,-8,24
Dungannon,9384,8,2,4,16,14,47,-33,10
Crusaders,9385,1,16,7,3,63,32,31,55
Coleraine,9385,2,14,10,2,44,24,20,52
Glenavon,9385,3,10,9,7,54,44,10,39
Linfield,9385,4,10,5,11,37,38,-1,35
Cliftonville,9385,5,10,4,12,34,31,3,34
Ballymena,9385,6,7,5,14,27,49,-22,26
Glentoran,9385,7,6,6,10,24,32,-8,24
Dungannon,9385,8,2,4,16,14,47,-33,10
Crusaders,9386,1,17,6,3,63,31,32,57
Coleraine,9386,2,15,10,1,45,23,22,55
Linfield,9386,3,11,5,10,39,36,3,38
Glenavon,9386,4,9,9,8,53,45,8,36
Cliftonville,9386,5,9,4,13,32,33,-1,31
Ballymena,9386,6,7,4,15,26,49,-23,25
Glentoran,9386,7,6,6,10,24,32,-8,24
Dungannon,9386,8,2,4,16,14,47,-33,10
Crusaders,9387,1,17,6,3,63,30,33,57
Coleraine,9387,2,14,10,2,44,24,20,52
Glenavon,9387,3,10,9,7,54,44,10,39
Linfield,9387,4,11,5,10,40,37,3,38
Cliftonville,9387,5,9,4,13,33,34,-1,31
Ballymena,9387,6,7,4,15,25,49,-24,25
Glentoran,9387,7,6,6,10,24,32,-8,24
Dungannon,9387,8,2,4,16,14,47,-33,10
Crusaders,9388,1,17,6,3,63,30,33,57
Coleraine,9388,2,14,10,2,45,27,18,52
Glenavon,9388,3,10,9,7,57,45,12,39
Linfield,9388,4,10,5,11,37,39,-2,35
Cliftonville,9388,5,10,4,12,35,31,4,34
Ballymena,9388,6,7,4,15,25,49,-24,25
Glentoran,9388,7,6,6,10,24,32,-8,24
Dungannon,9388,8,2,4,16,14,47,-33,10
Crusaders,9389,1,17,6,3,64,32,32,57
Coleraine,9389,2,14,10,2,44,24,20,52
Glenavon,9389,3,10,9,7,54,44,10,39
Linfield,9389,4,11,5,10,38,36,2,38
Cliftonville,9389,5,9,4,13,32,32,0,31
Ballymena,9389,6,7,4,15,27,50,-23,25
Glentoran,9389,7,6,6,10,24,32,-8,24
Dungannon,9389,8,2,4,16,14,47,-33,10
Coleraine,9390,1,15,10,1,46,24,22,55
Crusaders,9390,2,16,6,4,63,33,30,54
Linfield,9390,3,11,5,10,38,36,2,38
Glenavon,9390,4,9,9,8,54,46,8,36
Cliftonville,9390,5,9,4,13,32,32,0,31
Ballymena,9390,6,8,4,14,28,49,-21,28
Glentoran,9390,7,6,6,10,24,32,-8,24
Dungannon,9390,8,2,4,16,14,47,-33,10
Crusaders,9391,1,17,6,3,64,30,34,57
Coleraine,9391,2,14,10,2,44,24,20,52
Glenavon,9391,3,10,9,7,54,44,10,39
Linfield,9391,4,10,5,11,38,38,0,35
Cliftonville,9391,5,10,4,12,34,32,2,34
Ballymena,9391,6,7,4,15,25,50,-25,25
Glentoran,9391,7,6,6,10,24,32,-8,24
Dungannon,9391,8,2,4,16,14,47,-33,10
Crusaders,9392,1,16,7,3,63,32,31,55
Coleraine,9392,2,14,10,2,44,24,20,52
Glenavon,9392,3,10,9,7,54,44,10,39
Linfield,9392,4,11,5,10,39,37,2,38
Cliftonville,9392,5,9,4,13,33,33,0,31
Ballymena,9392,6,7,5,14,27,49,-22,26
Glentoran,9392,7,6,6,10,24,32,-8,24
Dungannon,9392,8,2,4,16,14,47,-33,10
Crusaders,9393,1,16,6,4,63,34,29,54
Coleraine,9393,2,14,10,2,43,23,20,52
Glenavon,9393,3,10,9,7,53,43,10,39
Linfield,9393,4,11,5,10,38,36,2,38
Cliftonville,9393,5,9,4,13,32,32,0,31
Ballymena,9393,6,8,4,14,29,49,-20,28
Glentoran,9393,7,6,6,10,24,32,-8,24
Dungannon,9393,8,2,4,16,14,47,-33,10
Crusaders,9394,1,17,6,3,65,31,34,57
Coleraine,9394,2,15,10,1,48,23,25,55
Linfield,9394,3,11,5,10,43,38,5,38
Glenavon,9394,4,9,9,8,53,48,5,36
Cliftonville,9394,5,9,4,13,34,37,-3,31
Ballymena,9394,6,7,4,15,26,51,-25,25
Glentoran,9394,7,6,6,10,24,32,-8,24
Dungannon,9394,8,2,4,16,14,47,-33,10
Coleraine,9395,1,15,10,1,45,22,23,55
Crusaders,9395,2,16,6,4,62,32,30,54
Glenavon,9395,3,9,9,8,52,45,7,36
Linfield,9395,4,10,5,11,38,38,0,35
Cliftonville,9395,5,10,4,12,34,32,2,34
Ballymena,9395,6,8,4,14,27,48,-21,28
Glentoran,9395,7,6,6,10,24,32,-8,24
Dungannon,9395,8,2,4,16,14,47,-33,10
Crusaders,9396,1,17,6,3,63,31,32,57
Coleraine,9396,2,15,10,1,45,23,22,55
Linfield,9396,3,11,5,10,39,37,2,38
Glenavon,9396,4,9,9,8,53,45,8,36
Cliftonville,9396,5,9,4,13,33,33,0,31
Ballymena,9396,6,7,4,15,26,49,-23,25
Glentoran,9396,7,6,6,10,24,32,-8,24
Dungannon,9396,8,2,4,16,14,47,-33,10
Coleraine,9397,1,15,10,1,46,24,22,55
Crusaders,9397,2,16,6,4,62,33,29,54
Linfield,9397,3,11,5,10,40,37,3,38
Glenavon,9397,4,9,9,8,54,46,8,36
Cliftonville,9397,5,9,4,13,33,34,-1,31
Ballymena,9397,6,8,4,14,28,48,-20,28
Glentoran,9397,7,6,6,10,24,32,-8,24
Dungannon,9397,8,2,4,16,14,47,-33,10
Crusaders,9398,1,16,7,3,63,32,31,55
Coleraine,9398,2,15,10,1,45,22,23,55
Linfield,9398,3,11,5,10,39,37,2,38
Glenavon,9398,4,9,9,8,52,45,7,36
Cliftonville,9398,5,9,4,13,33,33,0,31
Ballymena,9398,6,7,5,14,27,49,-22,26
Glentoran,9398,7,6,6,10,24,32,-8,24
Dungannon,9398,8,2,4,16,14,47,-33,10
Crusaders,9399,1,17,6,3,62,30,32,57
Coleraine,9399,2,14,10,2,43,24,19,52
Glenavon,9399,3,10,9,7,54,43,11,39
Linfield,9399,4,11,5,10,40,37,3,38
Cliftonville,9399,5,9,4,13,33,34,-1,31
Ballymena,9399,6,7,4,15,25,48,-23,25
Glentoran,9399,7,6,6,10,24,32,-8,24
Dungannon,9399,8,2,4,16,14,47,-33,10
Crusaders,9400,1,16,7,3,61,30,31,55
Coleraine,9400,2,15,10,1,48,24,24,55
Glenavon,9400,3,9,9,8,54,48,6,36
Linfield,9400,4,10,6,10,38,37,1,36
Cliftonville,9400,5,9,5,12,33,32,1,32
Ballymena,9400,6,7,5,14,25,47,-22,26
Glentoran,9400,7,6,6,10,24,32,-8,24
Dungannon,9400,8,2,4,16,14,47,-33,10
Crusaders,9401,1,16,6,4,62,32,30,54
Coleraine,9401,2,14,10,2,43,23,20,52
Glenavon,9401,3,10,9,7,53,43,10,39
Linfield,9401,4,10,6,10,37,36,1,36
Cliftonville,9401,5,9,5,12,32,31,1,32
Ballymena,9401,6,8,4,14,27,48,-21,28
Glentoran,9401,7,6,6,10,24,32,-8,24
Dungannon,9401,8,2,4,16,14,47,-33,10
Crusaders,9402,1,17,6,3,64,30,34,57
Coleraine,9402,2,14,10,2,43,24,19,52
Glenavon,9402,3,10,9,7,54,43,11,39
Linfield,9402,4,11,5,10,40,36,4,38
Cliftonville,9402,5,9,4,13,32,34,-2,31
Ballymena,9402,6,7,4,15,25,50,-25,25
Glentoran,9402,7,6,6,10,24,32,-8,24
Dungannon,9402,8,2,4,16,14,47,-33,10
Crusaders,9403,1,16,7,3,61,30,31,55
Coleraine,9403,2,14,10,2,43,23,20,52
Glenavon,9403,3,10,9,7,53,43,10,39
Linfield,9403,4,10,5,11,37,37,0,35
Cliftonville,9403,5,10,4,12,33,31,2,34
Ballymena,9403,6,7,5,14,25,47,-22,26
Glentoran,9403,7,6,6,10,24,32,-8,24
Dungannon,9403,8,2,4,16,14,47,-33,10
Crusaders,9404,1,17,6,3,62,30,32,57
Coleraine,9404,2,14,10,2,44,24,20,52
Glenavon,9404,3,10,9,7,54,44,10,39
Linfield,9404,4,11,5,10,39,37,2,38
Cliftonville,9404,5,9,4,13,33,33,0,31
Ballymena,9404,6,7,4,15,25,48,-23,25
Glentoran,9404,7,6,6,10,24,32,-8,24
Dungannon,9404,8,2,4,16,14,47,-33,10
Coleraine,9405,1,15,10,1,45,23,22,55
Crusaders,9405,2,16,6,4,61,31,30,54
Linfield,9405,3,11,5,10,40,37,3,38
Glenavon,9405,4,9,9,8,53,45,8,36
Cliftonville,9405,5,9,4,13,33,34,-1,31
Ballymena,9405,6,8,4,14,26,47,-21,28
Glentoran,9405,7,6,6,10,24,32,-8,24
Dungannon,9405,8,2,4,16,14,47,-33,10
Crusaders,9406,1,17,6,3,64,30,34,57
Coleraine,9406,2,14,11,1,44,23,21,53
Linfield,9406,3,11,5,10,39,37,2,38
Glenavon,9406,4,9,10,7,53,44,9,37
Cliftonville,9406,5,9,4,13,33,33,0,31
Ballymena,9406,6,7,4,15,25,50,-25,25
Glentoran,9406,7,6,6,10,24,32,-8,24
Dungannon,9406,8,2,4,16,14,47,-33,10
Crusaders,9407,1,16,7,3,62,31,31,55
Coleraine,9407,2,15,10,1,47,22,25,55
Glenavon,9407,3,9,9,8,52,47,5,36
Linfield,9407,4,10,6,10,37,36,1,36
Cliftonville,9407,5,9,5,12,32,31,1,32
Ballymena,9407,6,7,5,14,26,48,-22,26
Glentoran,9407,7,6,6,10,24,32,-8,24
Dungannon,9407,8,2,4,16,14,47,-33,10
Crusaders,9408,1,17,6,3,65,30,35,57
Coleraine,9408,2,14,10,2,43,28,15,52
Glenavon,9408,3,10,9,7,58,43,15,39
Linfield,9408,4,10,5,11,39,39,0,35
Cliftonville,9408,5,10,4,12,35,33,2,34
Ballymena,9408,6,7,4,15,25,51,-26,25
Glentoran,9408,7,6,6,10,24,32,-8,24
Dungannon,9408,8,2,4,16,14,47,-33,10
Coleraine,9409,1,15,10,1,44,22,22,55
Crusaders,9409,2,16,6,4,62,34,28,54
Glenavon,9409,3,9,9,8,52,44,8,36
Linfield,9409,4,10,6,10,38,37,1,36
Cliftonville,9409,5,9,5,12,33,32,1,32
Ballymena,9409,6,8,4,14,29,48,-19,28
Glentoran,9409,7,6,6,10,24,32,-8,24
Dungannon,9409,8,2,4,16,14,47,-33,10
Crusaders,9410,1,17,6,3,63,31,32,57
Coleraine,9410,2,14,11,1,44,23,21,53
Glenavon,9410,3,9,10,7,53,44,9,37
Linfield,9410,4,10,6,10,37,36,1,36
Cliftonville,9410,5,9,5,12,32,31,1,32
Ballymena,9410,6,7,4,15,26,49,-23,25
Glentoran,9410,7,6,6,10,24,32,-8,24
Dungannon,9410,8,2,4,16,14,47,-33,10
Crusaders,9411,1,16,6,4,61,33,28,54
Coleraine,9411,2,14,11,1,43,22,21,53
Linfield,9411,3,11,5,10,39,36,3,38
Glenavon,9411,4,9,10,7,52,43,9,37
Cliftonville,9411,5,9,4,13,32,33,-1,31
Ballymena,9411,6,8,4,14,28,47,-19,28
Glentoran,9411,7,6,6,10,24,32,-8,24
Dungannon,9411,8,2,4,16,14,47,-33,10
Crusaders,9412,1,17,6,3,63,30,33,57
Coleraine,9412,2,15,10,1,45,23,22,55
Linfield,9412,3,11,5,10,39,36,3,38
Glenavon,9412,4,9,9,8,53,45,8,36
Cliftonville,9412,5,9,4,13,32,33,-1,31
Ballymena,9412,6,7,4,15,25,49,-24,25
Glentoran,9412,7,6,6,10,24,32,-8,24
Dungannon,9412,8,2,4,16,14,47,-33,10
Crusaders,9413,1,16,7,3,62,31,31,55
Coleraine,9413,2,14,11,1,44,23,21,53
Glenavon,9413,3,9,10,7,53,44,9,37
Linfield,9413,4,10,6,10,38,37,1,36
Cliftonville,9413,5,9,5,12,33,32,1,32
Ballymena,9413,6,7,5,14,26,48,-22,26
Glentoran,9413,7,6,6,10,24,32,-8,24
Dungannon,9413,8,2,4,16,14,47,-33,10
Crusaders,9414,1,17,6,3,63,31,32,57
Coleraine,9414,2,15,10,1,44,22,22,55
Glenavon,9414,3,9,9,8,52,44,8,36
Linfield,9414,4,10,5,11,37,37,0,35
Cliftonville,9414,5,10,4,12,33,31,2,34
Ballymena,9414,6,7,4,15,26,49,-23,25
Glentoran,9414,7,6,6,10,24,32,-8,24
Dungannon,9414,8,2,4,16,14,47,-33,10
Crusaders,9415,1,16,7,3,61,30,31,55
Coleraine,9415,2,15,10,1,46,23,23,55
Linfield,9415,3,11,5,10,38,36,2,38
Glenavon,9415,4,9,9,8,53,46,7,36
Cliftonville,9415,5,9,4,13,32,32,0,31
Ballymena,9415,6,7,5,14,25,47,-22,26
Glentoran,9415,7,6,6,10,24,32,-8,24
Dungannon,9415,8,2,4,16,14,47,-33,10
Crusaders,9416,1,17,6,3,65,31,34,57
Coleraine,9416,2,15,10,1,48,25,23,55
Linfield,9416,3,11,5,10,38,36,2,38
Glenavon,9416,4,9,9,8,55,48,7,36
Cliftonville,9416,5,9,4,13,32,32,0,31
Ballymena,9416,6,7,4,15,26,51,-25,25
Glentoran,9416,7,6,6,10,24,32,-8,24
Dungannon,9416,8,2,4,16,14,47,-33,10
Crusaders,9417,1,16,6,4,63,33,30,54
Coleraine,9417,2,14,10,2,43,23,20,52
Glenavon,9417,3,10,9,7,53,43,10,39
Linfield,9417,4,11,5,10,39,37,2,38
Cliftonville,9417,5,9,4,13,33,33,0,31
Ballymena,9417,6,8,4,14,28,49,-21,28
Glentoran,9417,7,6,6,10,24,32,-8,24
Dungannon,9417,8,2,4,16,14,47,-33,10
Crusaders,9418,1,17,6,3,64,32,32,57
Coleraine,9418,2,14,10,2,45,25,20,52
Glenavon,9418,3,10,9,7,55,45,10,39
Linfield,9418,4,10,5,11,37,37,0,35
Cliftonville,9418,5,10,4,12,33,31,2,34
Ballymena,9418,6,7,4,15,27,50,-23,25
Glentoran,9418,7,6,6,10,24,32,-8,24
Dungannon,9418,8,2,4,16,14,47,-33,10
Coleraine,9419,1,15,10,1,46,23,23,55
Crusaders,9419,2,16,6,4,61,31,30,54
Glenavon,9419,3,9,9,8,53,46,7,36
Linfield,9419,4,10,6,10,38,37,1,36
Cliftonville,9419,5,9,5,12,33,32,1,32
Ballymena,9419,6,8,4,14,26,47,-21,28
Glentoran,9419,7,6,6,10,24,32,-8,24
Dungannon,9419,8,2,4,16,14,47,-33,10
Crusaders,9420,1,17,6,3,68,31,37,57
Coleraine,9420,2,14,10,2,43,25,18,52
Glenavon,9420,3,10,9,7,55,43,12,39
Linfield,9420,4,11,5,10,41,37,4,38
Cliftonville,9420,5,9,4,13,33,35,-2,31
Ballymena,9420,6,7,4,15,26,54,-28,25
Glentoran,9420,7,6,6,10,24,32,-8,24
Dungannon,9420,8,2,4,16,14,47,-33,10
Crusaders,9421,1,16,7,3,61,30,31,55
Coleraine,9421,2,14,10,2,44,25,19,52
Glenavon,9421,3,10,9,7,55,44,11,39
Linfield,9421,4,11,5,10,40,37,3,38
Cliftonville,9421,5,9,4,13,33,34,-1,31
Ballymena,9421,6,7,5,14,25,47,-22,26
Glentoran,9421,7,6,6,10,24,32,-8,24
Dungannon,9421,8,2,4,16,14,47,-33,10
Crusaders,9422,1,16,7,3,63,32,31,55
Coleraine,9422,2,14,10,2,45,25,20,52
Glenavon,9422,3,10,9,7,55,45,10,39
Linfield,9422,4,11,5,10,40,38,2,38
Cliftonville,9422,5,9,4,13,34,34,0,31
Ballymena,9422,6,7,5,14,27,49,-22,26
Glentoran,9422,7,6,6,10,24,32,-8,24
Dungannon,9422,8,2,4,16,14,47,-33,10
Crusaders,9423,1,16,7,3,62,31,31,55
Coleraine,9423,2,15,10,1,45,23,22,55
Linfield,9423,3,11,5,10,40,38,2,38
Glenavon,9423,4,9,9,8,53,45,8,36
Cliftonville,9423,5,9,4,13,34,34,0,31
Ballymena,9423,6,7,5,14,26,48,-22,26
Glentoran,9423,7,6,6,10,24,32,-8,24
Dungannon,9423,8,2,4,16,14,47,-33,10
Crusaders,9424,1,17,6,3,64,31,33,57
Coleraine,9424,2,14,11,1,44,23,21,53
Glenavon,9424,3,9,10,7,53,44,9,37
Linfield,9424,4,10,6,10,39,38,1,36
Cliftonville,9424,5,9,5,12,34,33,1,32
Ballymena,9424,6,7,4,15,26,50,-24,25
Glentoran,9424,7,6,6,10,24,32,-8,24
Dungannon,9424,8,2,4,16,14,47,-33,10
Crusaders,9425,1,17,6,3,62,30,32,57
Coleraine,9425,2,15,10,1,44,22,22,55
Linfield,9425,3,11,5,10,39,37,2,38
Glenavon,9425,4,9,9,8,52,44,8,36
Cliftonville,9425,5,9,4,13,33,33,0,31
Ballymena,9425,6,7,4,15,25,48,-23,25
Glentoran,9425,7,6,6,10,24,32,-8,24
Dungannon,9425,8,2,4,16,14,47,-33,10
Crusaders,9426,1,17,6,3,64,32,32,57
Coleraine,9426,2,14,10,2,44,24,20,52
Glenavon,9426,3,10,9,7,54,44,10,39
Linfield,9426,4,10,5,11,38,39,-1,35
Cliftonville,9426,5,10,4,12,35,32,3,34
Ballymena,9426,6,7,4,15,27,50,-23,25
Glentoran,9426,7,6,6,10,24,32,-8,24
Dungannon,9426,8,2,4,16,14,47,-33,10
Crusaders,9427,1,17,6,3,65,30,35,57
Coleraine,9427,2,14,10,2,44,25,19,52
Glenavon,9427,3,10,9,7,55,44,11,39
Linfield,9427,4,10,5,11,37,38,-1,35
Cliftonville,9427,5,10,4,12,34,31,3,34
Ballymena,9427,6,7,4,15,25,51,-26,25
Glentoran,9427,7,6,6,10,24,32,-8,24
Dungannon,9427,8,2,4,16,14,47,-33,10
Crusaders,9428,1,17,6,3,64,32,32,57
Coleraine,9428,2,14,10,2,44,26,18,52
Glenavon,9428,3,10,9,7,56,44,12,39
Linfield,9428,4,10,5,11,38,39,-1,35
Cliftonville,9428,5,10,4,12,35,32,3,34
Ballymena,9428,6,7,4,15,27,50,-23,25
Glentoran,9428,7,6,6,10,24,32,-8,24
Dungannon,9428,8,2,4,16,14,47,-33,10
Coleraine,9429,1,15,10,1,46,23,23,55
Crusaders,9429,2,16,6,4,64,35,29,54
Glenavon,9429,3,9,9,8,53,46,7,36
Linfield,9429,4,10,5,11,38,38,0,35
Cliftonville,9429,5,10,4,12,34,32,2,34
Ballymena,9429,6,8,4,14,30,50,-20,28
Glentoran,9429,7,6,6,10,24,32,-8,24
Dungannon,9429,8,2,4,16,14,47,-33,10
Crusaders,9430,1,16,7,3,64,33,31,55
Coleraine,9430,2,14,10,2,44,26,18,52
Glenavon,9430,3,10,9,7,56,44,12,39
Linfield,9430,4,11,5,10,39,37,2,38
Cliftonville,9430,5,9,4,13,33,33,0,31
Ballymena,9430,6,7,5,14,28,50,-22,26
Glentoran,9430,7,6,6,10,24,32,-8,24
Dungannon,9430,8,2,4,16,14,47,-33,10
Crusaders,9431,1,17,6,3,67,31,36,57
Coleraine,9431,2,14,10,2,44,24,20,52
Glenavon,9431,3,10,9,7,54,44,10,39
Linfield,9431,4,11,5,10,40,37,3,38
Cliftonville,9431,5,9,4,13,33,34,-1,31
Ballymena,9431,6,7,4,15,26,53,-27,25
Glentoran,9431,7,6,6,10,24,32,-8,24
Dungannon,9431,8,2,4,16,14,47,-33,10
Crusaders,9432,1,17,6,3,66,32,34,57
Coleraine,9432,2,14,11,1,43,22,21,53
Glenavon,9432,3,9,10,7,52,43,9,37
Linfield,9432,4,10,5,11,37,40,-3,35
Cliftonville,9432,5,10,4,12,36,31,5,34
Ballymena,9432,6,7,4,15,27,52,-25,25
Glentoran,9432,7,6,6,10,24,32,-8,24
Dungannon,9432,8,2,4,16,14,47,-33,10
Crusaders,9433,1,16,6,4,63,34,29,54
Coleraine,9433,2,14,10,2,44,25,19,52
Glenavon,9433,3,10,9,7,55,44,11,39
Linfield,9433,4,10,6,10,37,36,1,36
Cliftonville,9433,5,9,5,12,32,31,1,32
Ballymena,9433,6,8,4,14,29,49,-20,28
Glentoran,9433,7,6,6,10,24,32,-8,24
Dungannon,9433,8,2,4,16,14,47,-33,10
Crusaders,9434,1,16,6,4,62,32,30,54
Coleraine,9434,2,14,10,2,43,23,20,52
Glenavon,9434,3,10,9,7,53,43,10,39
Linfield,9434,4,10,5,11,37,37,0,35
Cliftonville,9434,5,10,4,12,33,31,2,34
Ballymena,9434,6,8,4,14,27,48,-21,28
Glentoran,9434,7,6,6,10,24,32,-8,24
Dungannon,9434,8,2,4,16,14,47,-33,10
Crusaders,9435,1,16,6,4,61,31,30,54
Coleraine,9435,2,14,10,2,46,26,20,52
Glenavon,9435,3,10,9,7,56,46,10,39
Linfield,9435,4,11,5,10,39,36,3,38
Cliftonville,9435,5,9,4,13,32,33,-1,31
Ballymena,9435,6,8,4,14,26,47,-21,28
Glentoran,9435,7,6,6,10,24,32,-8,24
Dungannon,9435,8,2,4,16,14,47,-33,10
Crusaders,9436,1,16,7,3,62,31,31,55
Coleraine,9436,2,14,10,2,44,25,19,52
Glenavon,9436,3,10,9,7,55,44,11,39
Linfield,9436,4,11,5,10,40,37,3,38
Cliftonville,9436,5,9,4,13,33,34,-1,31
Ballymena,9436,6,7,5,14,26,48,-22,26
Glentoran,9436,7,6,6,10,24,32,-8,24
Dungannon,9436,8,2,4,16,14,47,-33,10
Crusaders,9437,1,16,6,4,62,34,28,54
Coleraine,9437,2,14,10,2,44,24,20,52
Glenavon,9437,3,10,9,7,54,44,10,39
Linfield,9437,4,10,6,10,38,37,1,36
Cliftonville,9437,5,9,5,12,33,32,1,32
Ballymena,9437,6,8,4,14,29,48,-19,28
Glentoran,9437,7,6,6,10,24,32,-8,24
Dungannon,9437,8,2,4,16,14,47,-33,10
Crusaders,9438,1,17,6,3,64,31,33,57
Coleraine,9438,2,15,10,1,46,23,23,55
Glenavon,9438,3,9,9,8,53,46,7,36
Linfield,9438,4,10,5,11,38,38,0,35
Cliftonville,9438,5,10,4,12,34,32,2,34
Ballymena,9438,6,7,4,15,26,50,-24,25
Glentoran,9438,7,6,6,10,24,32,-8,24
Dungannon,9438,8,2,4,16,14,47,-33,10
Crusaders,9439,1,17,6,3,64,31,33,57
Coleraine,9439,2,15,10,1,47,22,25,55
Linfield,9439,3,11,5,10,39,37,2,38
Glenavon,9439,4,9,9,8,52,47,5,36
Cliftonville,9439,5,9,4,13,33,33,0,31
Ballymena,9439,6,7,4,15,26,50,-24,25
Glentoran,9439,7,6,6,10,24,32,-8,24
Dungannon,9439,8,2,4,16,14,47,-33,10
Crusaders,9440,1,17,6,3,62,30,32,57
Coleraine,9440,2,14,11,1,44,23,21,53
Linfield,9440,3,11,5,10,40,37,3,38
Glenavon,9440,4,9,10,7,53,44,9,37
Cliftonville,9440,5,9,4,13,33,34,-1,31
Ballymena,9440,6,7,4,15,25,48,-23,25
Glentoran,9440,7,6,6,10,24,32,-8,24
Dungannon,9440,8,2,4,16,14,47,-33,10
Crusaders,9441,1,17,6,3,65,31,34,57
Coleraine,9441,2,14,11,1,45,24,21,53
Linfield,9441,3,11,5,10,39,37,2,38
Glenavon,9441,4,9,10,7,54,45,9,37
Cliftonville,9441,5,9,4,13,33,33,0,31
Ballymena,9441,6,7,4,15,26,51,-25,25
Glentoran,9441,7,6,6,10,24,32,-8,24
Dungannon,9441,8,2,4,16,14,47,-33,10
Crusaders,9442,1,17,6,3,65,32,33,57
Coleraine,9442,2,15,10,1,46,23,23,55
Linfield,9442,3,11,5,10,39,36,3,38
Glenavon,9442,4,9,9,8,53,46,7,36
Cliftonville,9442,5,9,4,13,32,33,-1,31
Ballymena,9442,6,7,4,15,27,51,-24,25
Glentoran,9442,7,6,6,10,24,32,-8,24
Dungannon,9442,8,2,4,16,14,47,-33,10
Crusaders,9443,1,16,6,4,61,31,30,54
Coleraine,9443,2,14,10,2,44,25,19,52
Glenavon,9443,3,10,9,7,55,44,11,39
Linfield,9443,4,10,5,11,37,37,0,35
Cliftonville,9443,5,10,4,12,33,31,2,34
Ballymena,9443,6,8,4,14,26,47,-21,28
Glentoran,9443,7,6,6,10,24,32,-8,24
Dungannon,9443,8,2,4,16,14,47,-33,10
Crusaders,9444,1,17,6,3,63,30,33,57
Coleraine,9444,2,14,10,2,44,25,19,52
Glenavon,9444,3,10,9,7,55,44,11,39
Linfield,9444,4,10,6,10,39,38,1,36
Cliftonville,9444,5,9,5,12,34,33,1,32
Ballymena,9444,6,7,4,15,25,49,-24,25
Glentoran,9444,7,6,6,10,24,32,-8,24
Dungannon,9444,8,2,4,16,14,47,-33,10
Crusaders,9445,1,17,6,3,64,31,33,57
Coleraine,9445,2,15,10,1,45,23,22,55
Linfield,9445,3,11,5,10,38,36,2,38
Glenavon,9445,4,9,9,8,53,45,8,36
Cliftonville,9445,5,9,4,13,32,32,0,31
Ballymena,9445,6,7,4,15,26,50,-24,25
Glentoran,9445,7,6,6,10,24,32,-8,24
Dungannon,9445,8,2,4,16,14,47,-33,10
Coleraine,9446,1,15,10,1,45,22,23,55
Crusaders,9446,2,16,6,4,63,34,29,54
Glenavon,9446,3,9,9,8,52,45,7,36
Linfield,9446,4,10,6,10,37,36,1,36
Cliftonville,9446,5,9,5,12,32,31,1,32
Ballymena,9446,6,8,4,14,29,49,-20,28
Glentoran,9446,7,6,6,10,24,32,-8,24
Dungannon,9446,8,2,4,16,14,47,-33,10
Crusaders,9447,1,17,6,3,65,30,35,57
Coleraine,9447,2,14,10,2,44,24,20,52
Glenavon,9447,3,10,9,7,54,44,10,39
Linfield,9447,4,10,6,10,37,36,1,36
Cliftonville,9447,5,9,5,12,32,31,1,32
Ballymena,9447,6,7,4,15,25,51,-26,25
Glentoran,9447,7,6,6,10,24,32,-8,24
Dungannon,9447,8,2,4,16,14,47,-33,10
Crusaders,9448,1,16,7,3,63,32,31,55
Coleraine,9448,2,15,10,1,45,23,22,55
Glenavon,9448,3,9,9,8,53,45,8,36
Linfield,9448,4,10,6,10,39,38,1,36
Cliftonville,9448,5,9,5,12,34,33,1,32
Ballymena,9448,6,7,5,14,27,49,-22,26
Glentoran,9448,7,6,6,10,24,32,-8,24
Dungannon,9448,8,2,4,16,14,47,-33,10
Crusaders,9449,1,17,6,3,63,31,32,57
Coleraine,9449,2,14,10,2,46,26,20,52
Glenavon,9449,3,10,9,7,56,46,10,39
Linfield,9449,4,10,5,11,37,38,-1,35
Cliftonville,9449,5,10,4,12,34,31,3,34
Ballymena,9449,6,7,4,15,26,49,-23,25
Glentoran,9449,7,6,6,10,24,32,-8,24
Dungannon,9449,8,2,4,16,14,47,-33,10
Crusaders,9450,1,16,6,4,61,33,28,54
Coleraine,9450,2,14,11,1,44,23,21,53
Linfield,9450,3,11,5,10,39,37,2,38
Glenavon,9450,4,9,10,7,53,44,9,37
Cliftonville,9450,5,9,4,13,33,33,0,31
Ballymena,9450,6,8,4,14,28,47,-19,28
Glentoran,9450,7,6,6,10,24,32,-8,24
Dungannon,9450,8,2,4,16,14,47,-33,10
Crusaders,9451,1,17,6,3,65,31,34,57
Coleraine,9451,2,15,10,1,46,22,24,55
Glenavon,9451,3,9,9,8,52,46,6,36
Linfield,9451,4,10,5,11,37,38,-1,35
Cliftonville,9451,5,10,4,12,34,31,3,34
Ballymena,9451,6,7,4,15,26,51,-25,25
Glentoran,9451,7,6,6,10,24,32,-8,24
Dungannon,9451,8,2,4,16,14,47,-33,10
Crusaders,9452,1,16,7,3,63,32,31,55
Coleraine,9452,2,15,10,1,46,24,22,55
Glenavon,9452,3,9,9,8,54,46,8,36
Linfield,9452,4,10,5,11,37,37,0,35
Cliftonville,9452,5,10,4,12,33,31,2,34
Ballymena,9452,6,7,5,14,27,49,-22,26
Glentoran,9452,7,6,6,10,24,32,-8,24
Dungannon,9452,8,2,4,16,14,47,-33,10
Crusaders,9453,1,17,6,3,66,30,36,57
Coleraine,9453,2,14,10,2,43,24,19,52
Glenavon,9453,3,10,9,7,54,43,11,39
Linfield,9453,4,10,5,11,39,40,-1,35
Cliftonville,9453,5,10,4,12,36,33,3,34
Ballymena,9453,6,7,4,15,25,52,-27,25
Glentoran,9453,7,6,6,10,24,32,-8,24
Dungannon,9453,8,2,4,16,14,47,-33,10
Crusaders,9454,1,17,6,3,64,30,34,57
Coleraine,9454,2,15,10,1,44,22,22,55
Linfield,9454,3,11,5,10,40,38,2,38
Glenavon,9454,4,9,9,8,52,44,8,36
Cliftonville,9454,5,9,4,13,34,34,0,31
Ballymena,9454,6,7,4,15,25,50,-25,25
Glentoran,9454,7,6,6,10,24,32,-8,24
Dungannon,9454,8,2,4,16,14,47,-33,10
Crusaders,9455,1,17,6,3,63,30,33,57
Coleraine,9455,2,15,10,1,46,24,22,55
Linfield,9455,3,11,5,10,38,36,2,38
Glenavon,9455,4,9,9,8,54,46,8,36
Cliftonville,9455,5,9,4,13,32,32,0,31
Ballymena,9455,6,7,4,15,25,49,-24,25
Glentoran,9455,7,6,6,10,24,32,-8,24
Dungannon,9455,8,2,4,16,14,47,-33,10
Crusaders,9456,1,17,6,3,64,32,32,57
Coleraine,9456,2,15,10,1,45,23,22,55
Glenavon,9456,3,9,9,8,53,45,8,36
Linfield,9456,4,10,6,10,38,37,1,36
Cliftonville,9456,5,9,5,12,33,32,1,32
Ballymena,9456,6,7,4,15,27,50,-23,25
Glentoran,9456,7,6,6,10,24,32,-8,24
Dungannon,9456,8,2,4,16,14,47,-33,10
Crusaders,9457,1,17,6,3,64,30,34,57
Coleraine,9457,2,14,10,2,44,24,20,52
Glenavon,9457,3,10,9,7,54,44,10,39
Linfield,9457,4,11,5,10,40,36,4,38
Cliftonville,9457,5,9,4,13,32,34,-2,31
Ballymena,9457,6,7,4,15,25,50,-25,25
Glentoran,9457,7,6,6,10,24,32,-8,24
Dungannon,9457,8,2,4,16,14,47,-33,10
Crusaders,9458,1,16,7,3,61,30,31,55
Coleraine,9458,2,14,10,2,43,24,19,52
Glenavon,9458,3,10,9,7,54,43,11,39
Linfield,9458,4,10,6,10,37,36,1,36
Cliftonville,9458,5,9,5,12,32,31,1,32
Ballymena,9458,6,7,5,14,25,47,-22,26
Glentoran,9458,7,6,6,10,24,32,-8,24
Dungannon,9458,8,2,4,16,14,47,-33,10
Crusaders,9459,1,16,7,3,63,32,31,55
Coleraine,9459,2,14,10,2,44,25,19,52
Glenavon,9459,3,10,9,7,55,44,11,39
Linfield,9459,4,11,5,10,40,36,4,38
Cliftonville,9459,5,9,4,13,32,34,-2,31
Ballymena,9459,6,7,5,14,27,49,-22,26
Glentoran,9459,7,6,6,10,24,32,-8,24
Dungannon,9459,8,2,4,16,14,47,-33,10
Crusaders,9460,1,17,6,3,65,31,34,57
Coleraine,9460,2,15,10,1,44,22,22,55
Glenavon,9460,3,9,9,8,52,44,8,36
Linfield,9460,4,10,6,10,38,37,1,36
Cliftonville,9460,5,9,5,12,33,32,1,32
Ballymena,9460,6,7,4,15,26,51,-25,25
Glentoran,9460,7,6,6,10,24,32,-8,24
Dungannon,9460,8,2,4,16,14,47,-33,10
Crusaders,9461,1,16,6,4,61,33,28,54
Coleraine,9461,2,14,10,2,43,23,20,52
Glenavon,9461,3,10,9,7,53,43,10,39
Linfield,9461,4,11,5,10,38,36,2,38
Cliftonville,9461,5,9,4,13,32,32,0,31
Ballymena,9461,6,8,4,14,28,47,-19,28
Glentoran,9461,7,6,6,10,24,32,-8,24
Dungannon,9461,8,2,4,16,14,47,-33,10
Crusaders,9462,1,17,6,3,63,31,32,57
Coleraine,9462,2,14,11,1,45,24,21,53
Linfield,9462,3,11,5,10,38,36,2,38
Glenavon,9462,4,9,10,7,54,45,9,37
Cliftonville,9462,5,9,4,13,32,32,0,31
Ballymena,9462,6,7,4,15,26,49,-23,25
Glentoran,9462,7,6,6,10,24,32,-8,24
Dungannon,9462,8,2,4,16,14,47,-33,10
Crusaders,9463,1,16,7,3,62,31,31,55
Coleraine,9463,2,15,10,1,45,22,23,55
Linfield,9463,3,11,5,10,38,36,2,38
Glenavon,9463,4,9,9,8,52,45,7,36
Cliftonville,9463,5,9,4,13,32,32,0,31
Ballymena,9463,6,7,5,14,26,48,-22,26
Glentoran,9463,7,6,6,10,24,32,-8,24
Dungannon,9463,8,2,4,16,14,47,-33,10
Crusaders,9464,1,17,6,3,63,31,32,57
Coleraine,9464,2,15,10,1,46,23,23,55
Glenavon,9464,3,9,9,8,53,46,7,36
Linfield,9464,4,10,6,10,38,37,1,36
Cliftonville,9464,5,9,5,12,33,32,1,32
Ballymena,9464,6,7,4,15,26,49,-23,25
Glentoran,9464,7,6,6,10,24,32,-8,24
Dungannon,9464,8,2,4,16,14,47,-33,10
Coleraine,9465,1,15,10,1,47,24,23,55
Crusaders,9465,2,16,6,4,62,36,26,54
Linfield,9465,3,11,5,10,38,36,2,38
Glenavon,9465,4,9,9,8,54,47,7,36
Cliftonville,9465,5,9,4,13,32,32,0,31
Ballymena,9465,6,8,4,14,31,48,-17,28
Glentoran,9465,7,6,6,10,24,32,-8,24
Dungannon,9465,8,2,4,16,14,47,-33,10
Crusaders,9466,1,17,6,3,63,30,33,57
Coleraine,9466,2,14,10,2,44,24,20,52
Glenavon,9466,3,10,9,7,54,44,10,39
Linfield,9466,4,11,5,10,39,37,2,38
Cliftonville,9466,5,9,4,13,33,33,0,31
Ballymena,9466,6,7,4,15,25,49,-24,25
Glentoran,9466,7,6,6,10,24,32,-8,24
Dungannon,9466,8,2,4,16,14,47,-33,10
Crusaders,9467,1,17,6,3,65,32,33,57
Coleraine,9467,2,14,10,2,44,24,20,52
Glenavon,9467,3,10,9,7,54,44,10,39
Linfield,9467,4,11,5,10,41,39,2,38
Cliftonville,9467,5,9,4,13,35,35,0,31
Ballymena,9467,6,7,4,15,27,51,-24,25
Glentoran,9467,7,6,6,10,24,32,-8,24
Dungannon,9467,8,2,4,16,14,47,-33,10
Crusaders,9468,1,16,7,3,63,32,31,55
Coleraine,9468,2,14,11,1,44,23,21,53
Linfield,9468,3,11,5,10,40,36,4,38
Glenavon,9468,4,9,10,7,53,44,9,37
Cliftonville,9468,5,9,4,13,32,34,-2,31
Ballymena,9468,6,7,5,14,27,49,-22,26
Glentoran,9468,7,6,6,10,24,32,-8,24
Dungannon,9468,8,2,4,16,14,47,-33,10
Crusaders,9469,1,17,6,3,64,30,34,57
Coleraine,9469,2,15,10,1,46,23,23,55
Glenavon,9469,3,9,9,8,53,46,7,36
Linfield,9469,4,10,6,10,39,38,1,36
Cliftonville,9469,5,9,5,12,34,33,1,32
Ballymena,9469,6,7,4,15,25,50,-25,25
Glentoran,9469,7,6,6,10,24,32,-8,24
Dungannon,9469,8,2,4,16,14,47,-33,10
Crusaders,9470,1,16,6,4,62,32,30,54
Coleraine,9470,2,14,11,1,45,24,21,53
Linfield,9470,3,11,5,10,38,36,2,38
Glenavon,9470,4,9,10,7,54,45,9,37
Cliftonville,9470,5,9,4,13,32,32,0,31
Ballymena,9470,6,8,4,14,27,48,-21,28
Glentoran,9470,7,6,6,10,24,32,-8,24
Dungannon,9470,8,2,4,16,14,47,-33,10
Crusaders,9471,1,16,6,4,61,34,27,54
Coleraine,9471,2,14,10,2,44,24,20,52
Glenavon,9471,3,10,9,7,54,44,10,39
Linfield,9471,4,10,6,10,38,37,1,36
Cliftonville,9471,5,9,5,12,33,32,1,32
Ballymena,9471,6,8,4,14,29,47,-18,28
Glentoran,9471,7,6,6,10,24,32,-8,24
Dungannon,9471,8,2,4,16,14,47,-33,10
Crusaders,9472,1,17,6,3,65,33,32,57
Coleraine,9472,2,14,10,2,45,25,20,52
Glenavon,9472,3,10,9,7,55,45,10,39
Linfield,9472,4,10,5,11,37,37,0,35
Cliftonville,9472,5,10,4,12,33,31,2,34
Ballymena,9472,6,7,4,15,28,51,-23,25
Glentoran,9472,7,6,6,10,24,32,-8,24
Dungannon,9472,8,2,4,16,14,47,-33,10
Crusaders,9473,1,17,6,3,64,31,33,57
Coleraine,9473,2,15,10,1,46,23,23,55
Linfield,9473,3,11,5,10,41,38,3,38
Glenavon,9473,4,9,9,8,53,46,7,36
Cliftonville,9473,5,9,4,13,34,35,-1,31
Ballymena,9473,6,7,4,15,26,50,-24,25
Glentoran,9473,7,6,6,10,24,32,-8,24
Dungannon,9473,8,2,4,16,14,47,-33,10
Crusaders,9474,1,16,7,3,63,32,31,55
Coleraine,9474,2,14,11,1,44,23,21,53
Linfield,9474,3,11,5,10,39,37,2,38
Glenavon,9474,4,9,10,7,53,44,9,37
Cliftonville,9474,5,9,4,13,33,33,0,31
Ballymena,9474,6,7,5,14,27,49,-22,26
Glentoran,9474,7,6,6,10,24,32,-8,24
Dungannon,9474,8,2,4,16,14,47,-33,10
Crusaders,9475,1,17,6,3,65,30,35,57
Coleraine,9475,2,14,11,1,45,24,21,53
Glenavon,9475,3,9,10,7,54,45,9,37
Linfield,9475,4,10,5,11,38,38,0,35
Cliftonville,9475,5,10,4,12,34,32,2,34
Ballymena,9475,6,7,4,15,25,51,-26,25
Glentoran,9475,7,6,6,10,24,32,-8,24
Dungannon,9475,8,2,4,16,14,47,-33,10
Crusaders,9476,1,16,6,4,63,33,30,54
Coleraine,9476,2,14,10,2,45,26,19,52
Glenavon,9476,3,10,9,7,56,45,11,39
Linfield,9476,4,10,6,10,38,37,1,36
Cliftonville,9476,5,9,5,12,33,32,1,32
Ballymena,9476,6,8,4,14,28,49,-21,28
Glentoran,9476,7,6,6,10,24,32,-8,24
Dungannon,9476,8,2,4,16,14,47,-33,10
Crusaders,9477,1,17,6,3,64,31,33,57
Coleraine,9477,2,14,10,2,44,25,19,52
Glenavon,9477,3,10,9,7,55,44,11,39
Linfield,9477,4,11,5,10,39,37,2,38
Cliftonville,9477,5,9,4,13,33,33,0,31
Ballymena,9477,6,7,4,15,26,50,-24,25
Glentoran,9477,7,6,6,10,24,32,-8,24
Dungannon,9477,8,2,4,16,14,47,-33,10
Crusaders,9478,1,17,6,3,67,30,37,57
Coleraine,9478,2,15,10,1,46,22,24,55
Linfield,9478,3,11,5,10,42,37,5,38
Glenavon,9478,4,9,9,8,52,46,6,36
Cliftonville,9478,5,9,4,13,33,36,-3,31
Ballymena,9478,6,7,4,15,25,53,-28,25
Glentoran,9478,7,6,6,10,24,32,-8,24
Dungannon,9478,8,2,4,16,14,47,-33,10
Crusaders,9479,1,17,6,3,65,31,34,57
Coleraine,9479,2,14,10,2,43,25,18,52
Glenavon,9479,3,10,9,7,55,43,12,39
Linfield,9479,4,10,6,10,38,37,1,36
Cliftonville,9479,5,9,5,12,33,32,1,32
Ballymena,9479,6,7,4,15,26,51,-25,25
Glentoran,9479,7,6,6,10,24,32,-8,24
Dungannon,9479,8,2,4,16,14,47,-33,10
Crusaders,9480,1,17,6,3,63,31,32,57
Coleraine,9480,2,14,10,2,43,24,19,52
Glenavon,9480,3,10,9,7,54,43,11,39
Linfield,9480,4,10,6,10,37,36,1,36
Cliftonville,9480,5,9,5,12,32,31,1,32
Ballymena,9480,6,7,4,15,26,49,-23,25
Glentoran,9480,7,6,6,10,24,32,-8,24
Dungannon,9480,8,2,4,16,14,47,-33,10
Crusaders,9481,1,17,6,3,63,30,33,57
Coleraine,9481,2,14,10,2,43,23,20,52
Glenavon,9481,3,10,9,7,53,43,10,39
Linfield,9481,4,11,5,10,39,37,2,38
Cliftonville,9481,5,9,4,13,33,33,0,31
Ballymena,9481,6,7,4,15,25,49,-24,25
Glentoran,9481,7,6,6,10,24,32,-8,24
Dungannon,9481,8,2,4,16,14,47,-33,10
Crusaders,9482,1,17,6,3,63,31,32,57
Coleraine,9482,2,14,10,2,43,23,20,52
Glenavon,9482,3,10,9,7,53,43,10,39
Linfield,9482,4,11,5,10,41,36,5,38
Cliftonville,9482,5,9,4,13,32,35,-3,31
Ballymena,9482,6,7,4,15,26,49,-23,25
Glentoran,9482,7,6,6,10,24,32,-8,24
Dungannon,9482,8,2,4,16,14,47,-33,10
Crusaders,9483,1,17,6,3,63,30,33,57
Coleraine,9483,2,14,11,1,44,23,21,53
Linfield,9483,3,11,5,10,40,36,4,38
Glenavon,9483,4,9,10,7,53,44,9,37
Cliftonville,9483,5,9,4,13,32,34,-2,31
Ballymena,9483,6,7,4,15,25,49,-24,25
Glentoran,9483,7,6,6,10,24,32,-8,24
Dungannon,9483,8,2,4,16,14,47,-33,10
Crusaders,9484,1,16,6,4,61,31,30,54
Coleraine,9484,2,14,11,1,44,23,21,53
Linfield,9484,3,11,5,10,38,36,2,38
Glenavon,9484,4,9,10,7,53,44,9,37
Cliftonville,9484,5,9,4,13,32,32,0,31
Ballymena,9484,6,8,4,14,26,47,-21,28
Glentoran,9484,7,6,6,10,24,32,-8,24
Dungannon,9484,8,2,4,16,14,47,-33,10
Coleraine,9485,1,15,10,1,46,23,23,55
Crusaders,9485,2,16,6,4,62,32,30,54
Linfield,9485,3,11,5,10,40,36,4,38
Glenavon,9485,4,9,9,8,53,46,7,36
Cliftonville,9485,5,9,4,13,32,34,-2,31
Ballymena,9485,6,8,4,14,27,48,-21,28
Glentoran,9485,7,6,6,10,24,32,-8,24
Dungannon,9485,8,2,4,16,14,47,-33,10
Coleraine,9486,1,15,10,1,46,23,23,55
Crusaders,9486,2,16,6,4,62,33,29,54
Linfield,9486,3,11,5,10,40,36,4,38
Glenavon,9486,4,9,9,8,53,46,7,36
Cliftonville,9486,5,9,4,13,32,34,-2,31
Ballymena,9486,6,8,4,14,28,48,-20,28
Glentoran,9486,7,6,6,10,24,32,-8,24
Dungannon,9486,8,2,4,16,14,47,-33,10
Crusaders,9487,1,16,7,3,62,31,31,55
Coleraine,9487,2,14,11,1,44,23,21,53
Linfield,9487,3,11,5,10,39,36,3,38
Glenavon,9487,4,9,10,7,53,44,9,37
Cliftonville,9487,5,9,4,13,32,33,-1,31
Ballymena,9487,6,7,5,14,26,48,-22,26
Glentoran,9487,7,6,6,10,24,32,-8,24
Dungannon,9487,8,2,4,16,14,47,-33,10
Crusaders,9488,1,17,6,3,64,32,32,57
Coleraine,9488,2,15,10,1,44,22,22,55
Linfield,9488,3,11,5,10,39,37,2,38
Glenavon,9488,4,9,9,8,52,44,8,36
Cliftonville,9488,5,9,4,13,33,33,0,31
Ballymena,9488,6,7,4,15,27,50,-23,25
Glentoran,9488,7,6,6,10,24,32,-8,24
Dungannon,9488,8,2,4,16,14,47,-33,10
Coleraine,9489,1,15,10,1,45,23,22,55
Crusaders,9489,2,16,6,4,62,33,29,54
Glenavon,9489,3,9,9,8,53,45,8,36
Linfield,9489,4,10,5,11,38,38,0,35
Cliftonville,9489,5,10,4,12,34,32,2,34
Ballymena,9489,6,8,4,14,28,48,-20,28
Glentoran,9489,7,6,6,10,24,32,-8,24
Dungannon,9489,8,2,4,16,14,47,-33,10
Crusaders,9490,1,16,7,3,63,32,31,55
Coleraine,9490,2,14,10,2,44,24,20,52
Glenavon,9490,3,10,9,7,54,44,10,39
Linfield,9490,4,11,5,10,39,36,3,38
Cliftonville,9490,5,9,4,13,32,33,-1,31
Ballymena,9490,6,7,5,14,27,49,-22,26
Glentoran,9490,7,6,6,10,24,32,-8,24
Dungannon,9490,8,2,4,16,14,47,-33,10
Crusaders,9491,1,17,6,3,63,31,32,57
Coleraine,9491,2,14,11,1,44,23,21,53
Linfield,9491,3,11,5,10,40,38,2,38
Glenavon,9491,4,9,10,7,53,44,9,37
Cliftonville,9491,5,9,4,13,34,34,0,31
Ballymena,9491,6,7,4,15,26,49,-23,25
Glentoran,9491,7,6,6,10,24,32,-8,24
Dungannon,9491,8,2,4,16,14,47,-33,10
Crusaders,9492,1,17,6,3,65,33,32,57
Coleraine,9492,2,15,10,1,45,23,22,55
Glenavon,9492,3,9,9,8,53,45,8,36
Linfield,9492,4,10,5,11,37,37,0,35
Cliftonville,9492,5,10,4,12,33,31,2,34
Ballymena,9492,6,7,4,15,28,51,-23,25
Glentoran,9492,7,6,6,10,24,32,-8,24
Dungannon,9492,8,2,4,16,14,47,-33,10
Crusaders,9493,1,17,6,3,64,31,33,57
Coleraine,9493,2,14,10,2,44,24,20,52
Glenavon,9493,3,10,9,7,54,44,10,39
Linfield,9493,4,10,5,11,37,38,-1,35
Cliftonville,9493,5,10,4,12,34,31,3,34
Ballymena,9493,6,7,4,15,26,50,-24,25
Glentoran,9493,7,6,6,10,24,32,-8,24
Dungannon,9493,8,2,4,16,14,47,-33,10
Crusaders,9494,1,17,6,3,66,30,36,57
Coleraine,9494,2,14,10,2,43,26,17,52
Glenavon,9494,3,10,9,7,56,43,13,39
Linfield,9494,4,11,5,10,39,36,3,38
Cliftonville,9494,5,9,4,13,32,33,-1,31
Ballymena,9494,6,7,4,15,25,52,-27,25
Glentoran,9494,7,6,6,10,24,32,-8,24
Dungannon,9494,8,2,4,16,14,47,-33,10
Crusaders,9495,1,17,6,3,62,30,32,57
Coleraine,9495,2,15,10,1,47,24,23,55
Glenavon,9495,3,9,9,8,54,47,7,36
Linfield,9495,4,10,5,11,37,37,0,35
Cliftonville,9495,5,10,4,12,33,31,2,34
Ballymena,9495,6,7,4,15,25,48,-23,25
Glentoran,9495,7,6,6,10,24,32,-8,24
Dungannon,9495,8,2,4,16,14,47,-33,10
Crusaders,9496,1,17,6,3,63,31,32,57
Coleraine,9496,2,14,10,2,44,26,18,52
Glenavon,9496,3,10,9,7,56,44,12,39
Linfield,9496,4,10,5,11,37,39,-2,35
Cliftonville,9496,5,10,4,12,35,31,4,34
Ballymena,9496,6,7,4,15,26,49,-23,25
Glentoran,9496,7,6,6,10,24,32,-8,24
Dungannon,9496,8,2,4,16,14,47,-33,10
Crusaders,9497,1,17,6,3,63,30,33,57
Coleraine,9497,2,14,11,1,44,23,21,53
Linfield,9497,3,11,5,10,39,37,2,38
Glenavon,9497,4,9,10,7,53,44,9,37
Cliftonville,9497,5,9,4,13,33,33,0,31
Ballymena,9497,6,7,4,15,25,49,-24,25
Glentoran,9497,7,6,6,10,24,32,-8,24
Dungannon,9497,8,2,4,16,14,47,-33,10
Crusaders,9498,1,17,6,3,65,32,33,57
Coleraine,9498,2,14,11,1,44,23,21,53
Glenavon,9498,3,9,10,7,53,44,9,37
Linfield,9498,4,10,6,10,37,36,1,36
Cliftonville,9498,5,9,5,12,32,31,1,32
Ballymena,9498,6,7,4,15,27,51,-24,25
Glentoran,9498,7,6,6,10,24,32,-8,24
Dungannon,9498,8,2,4,16,14,47,-33,10
Crusaders,9499,1,16,6,4,61,32,29,54
Coleraine,9499,2,14,10,2,43,23,20,52
Glenavon,9499,3,10,9,7,53,43,10,39
Linfield,9499,4,10,6,10,38,37,1,36
Cliftonville,9499,5,9,5,12,33,32,1,32
Ballymena,9499,6,8,4,14,27,47,-20,28
Glentoran,9499,7,6,6,10,24,32,-8,24
Dungannon,9499,8,2,4,16,14,47,-33,10
Crusaders,9500,1,17,6,3,63,31,32,57
Coleraine,9500,2,14,10,2,44,24,20,52
Glenavon,9500,3,10,9,7,54,44,10,39
Linfield,9500,4,10,5,11,38,38,0,35
Cliftonville,9500,5,10,4,12,34,32,2,34
Ballymena,9500,6,7,4,15,26,49,-23,25
Glentoran,9500,7,6,6,10,24,32,-8,24
Dungannon,9500,8,2,4,16,14,47,-33,10
Crusaders,9501,1,17,6,3,64,31,33,57
Coleraine,9501,2,14,11,1,44,23,21,53
Glenavon,9501,3,9,10,7,53,44,9,37
Linfield,9501,4,10,6,10,37,36,1,36
Cliftonville,9501,5,9,5,12,32,31,1,32
Ballymena,9501,6,7,4,15,26,50,-24,25
Glentoran,9501,7,6,6,10,24,32,-8,24
Dungannon,9501,8,2,4,16,14,47,-33,10
Crusaders,9502,1,17,6,3,65,31,34,57
Coleraine,9502,2,14,10,2,44,24,20,52
Glenavon,9502,3,10,9,7,54,44,10,39
Linfield,9502,4,10,5,11,37,37,0,35
Cliftonville,9502,5,10,4,12,33,31,2,34
Ballymena,9502,6,7,4,15,26,51,-25,25
Glentoran,9502,7,6,6,10,24,32,-8,24
Dungannon,9502,8,2,4,16,14,47,-33,10
Crusaders,9503,1,16,7,3,63,32,31,55
Coleraine,9503,2,14,10,2,44,24,20,52
Glenavon,9503,3,10,9,7,54,44,10,39
Linfield,9503,4,10,5,11,37,37,0,35
Cliftonville,9503,5,10,4,12,33,31,2,34
Ballymena,9503,6,7,5,14,27,49,-22,26
Glentoran,9503,7,6,6,10,24,32,-8,24
Dungannon,9503,8,2,4,16,14,47,-33,10
Crusaders,9504,1,16,6,4,62,32,30,54
Coleraine,9504,2,14,10,2,43,23,20,52
Glenavon,9504,3,10,9,7,53,43,10,39
Linfield,9504,4,10,6,10,38,37,1,36
Cliftonville,9504,5,9,5,12,33,32,1,32
Ballymena,9504,6,8,4,14,27,48,-21,28
Glentoran,9504,7,6,6,10,24,32,-8,24
Dungannon,9504,8,2,4,16,14,47,-33,10
Crusaders,9505,1,17,6,3,62,30,32,57
Coleraine,9505,2,14,10,2,44,24,20,52
Glenavon,9505,3,10,9,7,54,44,10,39
Linfield,9505,4,11,5,10,40,38,2,38
Cliftonville,9505,5,9,4,13,34,34,0,31
Ballymena,9505,6,7,4,15,25,48,-23,25
Glentoran,9505,7,6,6,10,24,32,-8,24
Dungannon,9505,8,2,4,16,14,47,-33,10
Coleraine,9506,1,15,10,1,46,23,23,55
Crusaders,9506,2,16,6,4,61,31,30,54
Linfield,9506,3,11,5,10,38,36,2,38
Glenavon,9506,4,9,9,8,53,46,7,36
Cliftonville,9506,5,9,4,13,32,32,0,31
Ballymena,9506,6,8,4,14,26,47,-21,28
Glentoran,9506,7,6,6,10,24,32,-8,24
Dungannon,9506,8,2,4,16,14,47,-33,10
Crusaders,9507,1,17,6,3,64,31,33,57
Coleraine,9507,2,14,10,2,45,27,18,52
Glenavon,9507,3,10,9,7,57,45,12,39
Linfield,9507,4,11,5,10,41,37,4,38
Cliftonville,9507,5,9,4,13,33,35,-2,31
Ballymena,9507,6,7,4,15,26,50,-24,25
Glentoran,9507,7,6,6,10,24,32,-8,24
Dungannon,9507,8,2,4,16,14,47,-33,10
Crusaders,9508,1,17,6,3,63,31,32,57
Coleraine,9508,2,15,10,1,45,22,23,55
Linfield,9508,3,11,5,10,40,36,4,38
Glenavon,9508,4,9,9,8,52,45,7,36
Cliftonville,9508,5,9,4,13,32,34,-2,31
Ballymena,9508,6,7,4,15,26,49,-23,25
Glentoran,9508,7,6,6,10,24,32,-8,24
Dungannon,9508,8,2,4,16,14,47,-33,10
Crusaders,9509,1,16,7,3,62,31,31,55
Coleraine,9509,2,15,10,1,47,22,25,55
Linfield,9509,3,11,5,10,39,36,3,38
Glenavon,9509,4,9,9,8,52,47,5,36
Cliftonville,9509,5,9,4,13,32,33,-1,31
Ballymena,9509,6,7,5,14,26,48,-22,26
Glentoran,9509,7,6,6,10,24,32,-8,24
Dungannon,9509,8,2,4,16,14,47,-33,10
Crusaders,9510,1,17,6,3,63,31,32,57
Coleraine,9510,2,14,10,2,44,24,20,52
Glenavon,9510,3,10,9,7,54,44,10,39
Linfield,9510,4,11,5,10,40,37,3,38
Cliftonville,9510,5,9,4,13,33,34,-1,31
Ballymena,9510,6,7,4,15,26,49,-23,25
Glentoran,9510,7,6,6,10,24,32,-8,24
Dungannon,9510,8,2,4,16,14,47,-33,10
Crusaders,9511,1,17,6,3,65,31,34,57
Coleraine,9511,2,14,10,2,43,25,18,52
Glenavon,9511,3,10,9,7,55,43,12,39
Linfield,9511,4,10,5,11,37,37,0,35
Cliftonville,9511,5,10,4,12,33,31,2,34
Ballymena,9511,6,7,4,15,26,51,-25,25
Glentoran,9511,7,6,6,10,24,32,-8,24
Dungannon,9511,8,2,4,16,14,47,-33,10
Crusaders,9512,1,17,6,3,65,31,34,57
Coleraine,9512,2,15,10,1,46,22,24,55
Linfield,9512,3,11,5,10,39,36,3,38
Glenavon,9512,4,9,9,8,52,46,6,36
Cliftonville,9512,5,9,4,13,32,33,-1,31
Ballymena,9512,6,7,4,15,26,51,-25,25
Glentoran,9512,7,6,6,10,24,32,-8,24
Dungannon,9512,8,2,4,16,14,47,-33,10
Crusaders,9513,1,17,6,3,63,30,33,57
Coleraine,9513,2,14,10,2,45,25,20,52
Glenavon,9513,3,10,9,7,55,45,10,39
Linfield,9513,4,10,5,11,38,38,0,35
Cliftonville,9513,5,10,4,12,34,32,2,34
Ballymena,9513,6,7,4,15,25,49,-24,25
Glentoran,9513,7,6,6,10,24,32,-8,24
Dungannon,9513,8,2,4,16,14,47,-33,10
Crusaders,9514,1,17,6,3,63,30,33,57
Coleraine,9514,2,14,10,2,44,24,20,52
Glenavon,9514,3,10,9,7,54,44,10,39
Linfield,9514,4,11,5,10,39,37,2,38
Cliftonville,9514,5,9,4,13,33,33,0,31
Ballymena,9514,6,7,4,15,25,49,-24,25
Glentoran,9514,7,6,6,10,24,32,-8,24
Dungannon,9514,8,2,4,16,14,47,-33,10
Crusaders,9515,1,17,6,3,64,30,34,57
Coleraine,9515,2,15,10,1,46,22,24,55
Glenavon,9515,3,9,9,8,52,46,6,36
Linfield,9515,4,10,5,11,37,38,-1,35
Cliftonville,9515,5,10,4,12,34,31,3,34
Ballymena,9515,6,7,4,15,25,50,-25,25
Glentoran,9515,7,6,6,10,24,32,-8,24
Dungannon,9515,8,2,4,16,14,47,-33,10
Crusaders,9516,1,17,6,3,63,30,33,57
Coleraine,9516,2,15,10,1,46,24,22,55
Linfield,9516,3,11,5,10,38,36,2,38
Glenavon,9516,4,9,9,8,54,46,8,36
Cliftonville,9516,5,9,4,13,32,32,0,31
Ballymena,9516,6,7,4,15,25,49,-24,25
Glentoran,9516,7,6,6,10,24,32,-8,24
Dungannon,9516,8,2,4,16,14,47,-33,10
Crusaders,9517,1,16,6,4,61,33,28,54
Coleraine,9517,2,14,10,2,43,24,19,52
Glenavon,9517,3,10,9,7,54,43,11,39
Linfield,9517,4,11,5,10,38,36,2,38
Cliftonville,9517,5,9,4,13,32,32,0,31
Ballymena,9517,6,8,4,14,28,47,-19,28
Glentoran,9517,7,6,6,10,24,32,-8,24
Dungannon,9517,8,2,4,16,14,47,-33,10
Crusaders,9518,1,16,7,3,63,32,31,55
Coleraine,9518,2,14,10,2,43,24,19,52
Glenavon,9518,3,10,9,7,54,43,11,39
Linfield,9518,4,11,5,10,38,36,2,38
Cliftonville,9518,5,9,4,13,32,32,0,31
Ballymena,9518,6,7,5,14,27,49,-22,26
Glentoran,9518,7,6,6,10,24,32,-8,24
Dungannon,9518,8,2,4,16,14,47,-33,10
Crusaders,9519,1,16,7,3,63,32,31,55
Coleraine,9519,2,14,11,1,45,24,21,53
Linfield,9519,3,11,5,10,40,36,4,38
Glenavon,9519,4,9,10,7,54,45,9,37
Cliftonville,9519,5,9,4,13,32,34,-2,31
Ballymena,9519,6,7,5,14,27,49,-22,26
Glentoran,9519,7,6,6,10,24,32,-8,24
Dungannon,9519,8,2,4,16,14,47,-33,10
Crusaders,9520,1,16,6,4,64,34,30,54
Coleraine,9520,2,14,11,1,46,25,21,53
Glenavon,9520,3,9,10,7,55,46,9,37
Linfield,9520,4,10,6,10,37,36,1,36
Cliftonville,9520,5,9,5,12,32,31,1,32
Ballymena,9520,6,8,4,14,29,50,-21,28
Glentoran,9520,7,6,6,10,24,32,-8,24
Dungannon,9520,8,2,4,16,14,47,-33,10
Crusaders,9521,1,17,6,3,63,30,33,57
Coleraine,9521,2,14,10,2,44,25,19,52
Glenavon,9521,3,10,9,7,55,44,11,39
Linfield,9521,4,11,5,10,40,38,2,38
Cliftonville,9521,5,9,4,13,34,34,0,31
Ballymena,9521,6,7,4,15,25,49,-24,25
Glentoran,9521,7,6,6,10,24,32,-8,24
Dungannon,9521,8,2,4,16,14,47,-33,10
Crusaders,9522,1,17,6,3,65,32,33,57
Coleraine,9522,2,14,10,2,43,23,20,52
Glenavon,9522,3,10,9,7,53,43,10,39
Linfield,9522,4,11,5,10,38,36,2,38
Cliftonville,9522,5,9,4,13,32,32,0,31
Ballymena,9522,6,7,4,15,27,51,-24,25
Glentoran,9522,7,6,6,10,24,32,-8,24
Dungannon,9522,8,2,4,16,14,47,-33,10
Crusaders,9523,1,16,6,4,61,31,30,54
Coleraine,9523,2,14,10,2,44,25,19,52
Glenavon,9523,3,10,9,7,55,44,11,39
Linfield,9523,4,10,6,10,39,38,1,36
Cliftonville,9523,5,9,5,12,34,33,1,32
Ballymena,9523,6,8,4,14,26,47,-21,28
Glentoran,9523,7,6,6,10,24,32,-8,24
Dungannon,9523,8,2,4,16,14,47,-33,10
Crusaders,9524,1,16,7,3,62,31,31,55
Coleraine,9524,2,14,10,2,43,24,19,52
Glenavon,9524,3,10,9,7,54,43,11,39
Linfield,9524,4,11,5,10,39,36,3,38
Cliftonville,9524,5,9,4,13,32,33,-1,31
Ballymena,9524,6,7,5,14,26,48,-22,26
Glentoran,9524,7,6,6,10,24,32,-8,24
Dungannon,9524,8,2,4,16,14,47,-33,10
Crusaders,9525,1,16,7,3,62,31,31,55
Coleraine,9525,2,14,10,2,44,24,20,52
Glenavon,9525,3,10,9,7,54,44,10,39
Linfield,9525,4,11,5,10,38,36,2,38
Cliftonville,9525,5,9,4,13,32,32,0,31
Ballymena,9525,6,7,5,14,26,48,-22,26
Glentoran,9525,7,6,6,10,24,32,-8,24
Dungannon,9525,8,2,4,16,14,47,-33,10
Crusaders,9526,1,17,6,3,65,31,34,57
Coleraine,9526,2,15,10,1,44,22,22,55
Glenavon,9526,3,9,9,8,52,44,8,36
Linfield,9526,4,10,6,10,37,36,1,36
Cliftonville,9526,5,9,5,12,32,31,1,32
Ballymena,9526,6,7,4,15,26,51,-25,25
Glentoran,9526,7,6,6,10,24,32,-8,24
Dungannon,9526,8,2,4,16,14,47,-33,10
Coleraine,9527,1,15,10,1,46,24,22,55
Crusaders,9527,2,16,6,4,61,31,30,54
Linfield,9527,3,11,5,10,41,36,5,38
Glenavon,9527,4,9,9,8,54,46,8,36
Cliftonville,9527,5,9,4,13,32,35,-3,31
Ballymena,9527,6,8,4,14,26,47,-21,28
Glentoran,9527,7,6,6,10,24,32,-8,24
Dungannon,9527,8,2,4,16,14,47,-33,10
Crusaders,9528,1,17,6,3,64,31,33,57
Coleraine,9528,2,14,10,2,45,25,20,52
Glenavon,9528,3,10,9,7,55,45,10,39
Linfield,9528,4,10,5,11,37,37,0,35
Cliftonville,9528,5,10,4,12,33,31,2,34
Ballymena,9528,6,7,4,15,26,50,-24,25
Glentoran,9528,7,6,6,10,24,32,-8,24
Dungannon,9528,8,2,4,16,14,47,-33,10
Crusaders,9529,1,17,6,3,63,30,33,57
Coleraine,9529,2,15,10,1,44,22,22,55
Glenavon,9529,3,9,9,8,52,44,8,36
Linfield,9529,4,10,6,10,38,37,1,36
Cliftonville,9529,5,9,5,12,33,32,1,32
Ballymena,9529,6,7,4,15,25,49,-24,25
Glentoran,9529,7,6,6,10,24,32,-8,24
Dungannon,9529,8,2,4,16,14,47,-33,10
Crusaders,9530,1,17,6,3,65,31,34,57
Coleraine,9530,2,14,10,2,46,26,20,52
Glenavon,9530,3,10,9,7,56,46,10,39
Linfield,9530,4,11,5,10,39,37,2,38
Cliftonville,9530,5,9,4,13,33,33,0,31
Ballymena,9530,6,7,4,15,26,51,-25,25
Glentoran,9530,7,6,6,10,24,32,-8,24
Dungannon,9530,8,2,4,16,14,47,-33,10
Crusaders,9531,1,17,6,3,62,30,32,57
Coleraine,9531,2,15,10,1,47,23,24,55
Glenavon,9531,3,9,9,8,53,47,6,36
Linfield,9531,4,10,6,10,38,37,1,36
Cliftonville,9531,5,9,5,12,33,32,1,32
Ballymena,9531,6,7,4,15,25,48,-23,25
Glentoran,9531,7,6,6,10,24,32,-8,24
Dungannon,9531,8,2,4,16,14,47,-33,10
Crusaders,9532,1,16,7,3,63,32,31,55
Coleraine,9532,2,14,11,1,45,24,21,53
Glenavon,9532,3,9,10,7,54,45,9,37
Linfield,9532,4,10,5,11,39,39,0,35
Cliftonville,9532,5,10,4,12,35,33,2,34
Ballymena,9532,6,7,5,14,27,49,-22,26
Glentoran,9532,7,6,6,10,24,32,-8,24
Dungannon,9532,8,2,4,16,14,47,-33,10
Crusaders,9533,1,17,6,3,64,32,32,57
Coleraine,9533,2,15,10,1,45,23,22,55
Linfield,9533,3,11,5,10,39,36,3,38
Glenavon,9533,4,9,9,8,53,45,8,36
Cliftonville,9533,5,9,4,13,32,33,-1,31
Ballymena,9533,6,7,4,15,27,50,-23,25
Glentoran,9533,7,6,6,10,24,32,-8,24
Dungannon,9533,8,2,4,16,14,47,-33,10
Crusaders,9534,1,17,6,3,63,31,32,57
Coleraine,9534,2,14,10,2,44,24,20,52
Glenavon,9534,3,10,9,7,54,44,10,39
Linfield,9534,4,10,5,11,37,38,-1,35
Cliftonville,9534,5,10,4,12,34,31,3,34
Ballymena,9534,6,7,4,15,26,49,-23,25
Glentoran,9534,7,6,6,10,24,32,-8,24
Dungannon,9534,8,2,4,16,14,47,-33,10
Crusaders,9535,1,17,6,3,63,31,32,57
Coleraine,9535,2,14,11,1,45,24,21,53
Linfield,9535,3,11,5,10,41,36,5,38
Glenavon,9535,4,9,10,7,54,45,9,37
Cliftonville,9535,5,9,4,13,32,35,-3,31
Ballymena,9535,6,7,4,15,26,49,-23,25
Glentoran,9535,7,6,6,10,24,32,-8,24
Dungannon,9535,8,2,4,16,14,47,-33,10
Crusaders,9536,1,16,7,3,62,31,31,55
Coleraine,9536,2,14,10,2,44,24,20,52
Glenavon,9536,3,10,9,7,54,44,10,39
Linfield,9536,4,10,5,11,37,40,-3,35
Cliftonville,9536,5,10,4,12,36,31,5,34
Ballymena,9536,6,7,5,14,26,48,-22,26
Glentoran,9536,7,6,6,10,24,32,-8,24
Dungannon,9536,8,2,4,16,14,47,-33,10
Crusaders,9537,1,16,7,3,64,33,31,55
Coleraine,9537,2,15,10,1,45,23,22,55
Glenavon,9537,3,9,9,8,53,45,8,36
Linfield,9537,4,10,5,11,38,38,0,35
Cliftonville,9537,5,10,4,12,34,32,2,34
Ballymena,9537,6,7,5,14,28,50,-22,26
Glentoran,9537,7,6,6,10,24,32,-8,24
Dungannon,9537,8,2,4,16,14,47,-33,10
Crusaders,9538,1,17,6,3,65,31,34,57
Coleraine,9538,2,14,10,2,43,25,18,52
Glenavon,9538,3,10,9,7,55,43,12,39
Linfield,9538,4,11,5,10,39,37,2,38
Cliftonville,9538,5,9,4,13,33,33,0,31
Ballymena,9538,6,7,4,15,26,51,-25,25
Glentoran,9538,7,6,6,10,24,32,-8,24
Dungannon,9538,8,2,4,16,14,47,-33,10
Crusaders,9539,1,16,7,3,62,31,31,55
Coleraine,9539,2,15,10,1,45,23,22,55
Linfield,9539,3,11,5,10,39,37,2,38
Glenavon,9539,4,9,9,8,53,45,8,36
Cliftonville,9539,5,9,4,13,33,33,0,31
Ballymena,9539,6,7,5,14,26,48,-22,26
Glentoran,9539,7,6,6,10,24,32,-8,24
Dungannon,9539,8,2,4,16,14,47,-33,10
Crusaders,9540,1,16,6,4,61,32,29,54
Coleraine,9540,2,14,10,2,44,24,20,52
Glenavon,9540,3,10,9,7,54,44,10,39
Linfield,9540,4,11,5,10,38,36,2,38
Cliftonville,9540,5,9,4,13,32,32,0,31
Ballymena,9540,6,8,4,14,27,47,-20,28
Glentoran,9540,7,6,6,10,24,32,-8,24
Dungannon,9540,8,2,4,16,14,47,-33,10
Crusaders,9541,1,17,6,3,65,30,35,57
Coleraine,9541,2,14,10,2,44,24,20,52
Glenavon,9541,3,10,9,7,54,44,10,39
Linfield,9541,4,10,6,10,38,37,1,36
Cliftonville,9541,5,9,5,12,33,32,1,32
Ballymena,9541,6,7,4,15,25,51,-26,25
Glentoran,9541,7,6,6,10,24,32,-8,24
Dungannon,9541,8,2,4,16,14,47,-33,10
Crusaders,9542,1,17,6,3,64,31,33,57
Coleraine,9542,2,14,10,2,43,23,20,52
Glenavon,9542,3,10,9,7,53,43,10,39
Linfield,9542,4,10,5,11,38,38,0,35
Cliftonville,9542,5,10,4,12,34,32,2,34
Ballymena,9542,6,7,4,15,26,50,-24,25
Glentoran,9542,7,6,6,10,24,32,-8,24
Dungannon,9542,8,2,4,16,14,47,-33,10
Crusaders,9543,1,16,6,4,61,31,30,54
Coleraine,9543,2,14,10,2,44,24,20,52
Glenavon,9543,3,10,9,7,54,44,10,39
Linfield,9543,4,10,5,11,38,40,-2,35
Cliftonville,9543,5,10,4,12,36,32,4,34
Ballymena,9543,6,8,4,14,26,47,-21,28
Glentoran,9543,7,6,6,10,24,32,-8,24
Dungannon,9543,8,2,4,16,14,47,-33,10
Crusaders,9544,1,16,6,4,62,34,28,54
Coleraine,9544,2,14,11,1,43,22,21,53
Glenavon,9544,3,9,10,7,52,43,9,37
Linfield,9544,4,10,5,11,37,39,-2,35
Cliftonville,9544,5,10,4,12,35,31,4,34
Ballymena,9544,6,8,4,14,29,48,-19,28
Glentoran,9544,7,6,6,10,24,32,-8,24
Dungannon,9544,8,2,4,16,14,47,-33,10
Crusaders,9545,1,16,6,4,62,32,30,54
Coleraine,9545,2,14,10,2,43,23,20,52
Glenavon,9545,3,10,9,7,53,43,10,39
Linfield,9545,4,10,5,11,37,38,-1,35
Cliftonville,9545,5,10,4,12,34,31,3,34
Ballymena,9545,6,8,4,14,27,48,-21,28
Glentoran,9545,7,6,6,10,24,32,-8,24
Dungannon,9545,8,2,4,16,14,47,-33,10
Crusaders,9546,1,16,7,3,62,31,31,55
Coleraine,9546,2,14,10,2,43,23,20,52
Glenavon,9546,3,10,9,7,53,43,10,39
Linfield,9546,4,11,5,10,39,37,2,38
Cliftonville,9546,5,9,4,13,33,33,0,31
Ballymena,9546,6,7,5,14,26,48,-22,26
Glentoran,9546,7,6,6,10,24,32,-8,24
Dungannon,9546,8,2,4,16,14,47,-33,10
Crusaders,9547,1,16,7,3,63,32,31,55
Coleraine,9547,2,14,11,1,45,24,21,53
Glenavon,9547,3,9,10,7,54,45,9,37
Linfield,9547,4,10,6,10,39,38,1,36
Cliftonville,9547,5,9,5,12,34,33,1,32
Ballymena,9547,6,7,5,14,27,49,-22,26
Glentoran,9547,7,6,6,10,24,32,-8,24
Dungannon,9547,8,2,4,16,14,47,-33,10
Crusaders,9548,1,17,6,3,63,30,33,57
Coleraine,9548,2,15,10,1,48,22,26,55
Glenavon,9548,3,9,9,8,52,48,4,36
Linfield,9548,4,10,5,11,39,40,-1,35
Cliftonville,9548,5,10,4,12,36,33,3,34
Ballymena,9548,6,7,4,15,25,49,-24,25
Glentoran,9548,7,6,6,10,24,32,-8,24
Dungannon,9548,8,2,4,16,14,47,-33,10
Crusaders,9549,1,17,6,3,64,31,33,57
Coleraine,9549,2,15,10,1,46,23,23,55
Glenavon,9549,3,9,9,8,53,46,7,36
Linfield,9549,4,10,6,10,39,38,1,36
Cliftonville,9549,5,9,5,12,34,33,1,32
Ballymena,9549,6,7,4,15,26,50,-24,25
Glentoran,9549,7,6,6,10,24,32,-8,24
Dungannon,9549,8,2,4,16,14,47,-33,10
Crusaders,9550,1,16,6,4,62,32,30,54
Coleraine,9550,2,14,11,1,44,23,21,53
Glenavon,9550,3,9,10,7,53,44,9,37
Linfield,9550,4,10,5,11,37,37,0,35
Cliftonville,9550,5,10,4,12,33,31,2,34
Ballymena,9550,6,8,4,14,27,48,-21,28
Glentoran,9550,7,6,6,10,24,32,-8,24
Dungannon,9550,8,2,4,16,14,47,-33,10
Crusaders,9551,1,17,6,3,62,30,32,57
Coleraine,9551,2,14,10,2,45,25,20,52
Glenavon,9551,3,10,9,7,55,45,10,39
Linfield,9551,4,11,5,10,40,36,4,38
Cliftonville,9551,5,9,4,13,32,34,-2,31
Ballymena,9551,6,7,4,15,25,48,-23,25
Glentoran,9551,7,6,6,10,24,32,-8,24
Dungannon,9551,8,2,4,16,14,47,-33,10
Crusaders,9552,1,17,6,3,64,32,32,57
Coleraine,9552,2,14,11,1,43,22,21,53
Linfield,9552,3,11,5,10,39,36,3,38
Glenavon,9552,4,9,10,7,52,43,9,37
Cliftonville,9552,5,9,4,13,32,33,-1,31
Ballymena,9552,6,7,4,15,27,50,-23,25
Glentoran,9552,7,6,6,10,24,32,-8,24
Dungannon,9552,8,2,4,16,14,47,-33,10
Crusaders,9553,1,17,6,3,65,33,32,57
Coleraine,9553,2,14,11,1,45,24,21,53
Glenavon,9553,3,9,10,7,54,45,9,37
Linfield,9553,4,10,6,10,38,37,1,36
Cliftonville,9553,5,9,5,12,33,32,1,32
Ballymena,9553,6,7,4,15,28,51,-23,25
Glentoran,9553,7,6,6,10,24,32,-8,24
Dungannon,9553,8,2,4,16,14,47,-33,10
Crusaders,9554,1,16,6,4,62,32,30,54
Coleraine,9554,2,14,11,1,46,25,21,53
Linfield,9554,3,11,5,10,41,38,3,38
Glenavon,9554,4,9,10,7,55,46,9,37
Cliftonville,9554,5,9,4,13,34,35,-1,31
Ballymena,9554,6,8,4,14,27,48,-21,28
Glentoran,9554,7,6,6,10,24,32,-8,24
Dungannon,9554,8,2,4,16,14,47,-33,10
Crusaders,9555,1,17,6,3,63,30,33,57
Coleraine,9555,2,15,10,1,47,25,22,55
Glenavon,9555,3,9,9,8,55,47,8,36
Linfield,9555,4,10,6,10,37,36,1,36
Cliftonville,9555,5,9,5,12,32,31,1,32
Ballymena,9555,6,7,4,15,25,49,-24,25
Glentoran,9555,7,6,6,10,24,32,-8,24
Dungannon,9555,8,2,4,16,14,47,-33,10
Crusaders,9556,1,17,6,3,62,30,32,57
Coleraine,9556,2,15,10,1,46,23,23,55
Linfield,9556,3,11,5,10,41,38,3,38
Glenavon,9556,4,9,9,8,53,46,7,36
Cliftonville,9556,5,9,4,13,34,35,-1,31
Ballymena,9556,6,7,4,15,25,48,-23,25
Glentoran,9556,7,6,6,10,24,32,-8,24
Dungannon,9556,8,2,4,16,14,47,-33,10
Crusaders,9557,1,16,7,3,63,32,31,55
Coleraine,9557,2,15,10,1,46,23,23,55
Glenavon,9557,3,9,9,8,53,46,7,36
Linfield,9557,4,10,5,11,37,38,-1,35
Cliftonville,9557,5,10,4,12,34,31,3,34
Ballymena,9557,6,7,5,14,27,49,-22,26
Glentoran,9557,7,6,6,10,24,32,-8,24
Dungannon,9557,8,2,4,16,14,47,-33,10
Crusaders,9558,1,17,6,3,64,31,33,57
Coleraine,9558,2,15,10,1,45,22,23,55
Glenavon,9558,3,9,9,8,52,45,7,36
Linfield,9558,4,10,6,10,38,37,1,36
Cliftonville,9558,5,9,5,12,33,32,1,32
Ballymena,9558,6,7,4,15,26,50,-24,25
Glentoran,9558,7,6,6,10,24,32,-8,24
Dungannon,9558,8,2,4,16,14,47,-33,10
Crusaders,9559,1,16,7,3,63,32,31,55
Coleraine,9559,2,14,10,2,44,26,18,52
Glenavon,9559,3,10,9,7,56,44,12,39
Linfield,9559,4,10,6,10,37,36,1,36
Cliftonville,9559,5,9,5,12,32,31,1,32
Ballymena,9559,6,7,5,14,27,49,-22,26
Glentoran,9559,7,6,6,10,24,32,-8,24
Dungannon,9559,8,2,4,16,14,47,-33,10
Crusaders,9560,1,16,6,4,62,32,30,54
Coleraine,9560,2,14,10,2,43,29,14,52
Glenavon,9560,3,10,9,7,59,43,16,39
Linfield,9560,4,11,5,10,39,37,2,38
Cliftonville,9560,5,9,4,13,33,33,0,31
Ballymena,9560,6,8,4,14,27,48,-21,28
Glentoran,9560,7,6,6,10,24,32,-8,24
Dungannon,9560,8,2,4,16,14,47,-33,10
Crusaders,9561,1,16,6,4,61,33,28,54
Coleraine,9561,2,14,11,1,44,23,21,53
Linfield,9561,3,11,5,10,38,36,2,38
Glenavon,9561,4,9,10,7,53,44,9,37
Cliftonville,9561,5,9,4,13,32,32,0,31
Ballymena,9561,6,8,4,14,28,47,-19,28
Glentoran,9561,7,6,6,10,24,32,-8,24
Dungannon,9561,8,2,4,16,14,47,-33,10
Crusaders,9562,1,17,6,3,65,32,33,57
Coleraine,9562,2,14,11,1,44,23,21,53
Glenavon,9562,3,9,10,7,53,44,9,37
Linfield,9562,4,10,5,11,37,38,-1,35
Cliftonville,9562,5,10,4,12,34,31,3,34
Ballymena,9562,6,7,4,15,27,51,-24,25
Glentoran,9562,7,6,6,10,24,32,-8,24
Dungannon,9562,8,2,4,16,14,47,-33,10
Crusaders,9563,1,17,6,3,62,30,32,57
Coleraine,9563,2,14,11,1,45,24,21,53
Glenavon,9563,3,9,10,7,54,45,9,37
Linfield,9563,4,10,5,11,37,38,-1,35
Cliftonville,9563,5,10,4,12,34,31,3,34
Ballymena,9563,6,7,4,15,25,48,-23,25
Glentoran,9563,7,6,6,10,24,32,-8,24
Dungannon,9563,8,2,4,16,14,47,-33,10
Crusaders,9564,1,17,6,3,65,31,34,57
Coleraine,9564,2,14,10,2,43,25,18,52
Glenavon,9564,3,10,9,7,55,43,12,39
Linfield,9564,4,11,5,10,39,37,2,38
Cliftonville,9564,5,9,4,13,33,33,0,31
Ballymena,9564,6,7,4,15,26,51,-25,25
Glentoran,9564,7,6,6,10,24,32,-8,24
Dungannon,9564,8,2,4,16,14,47,-33,10
Crusaders,9565,1,17,6,3,62,30,32,57
Coleraine,9565,2,14,11,1,44,23,21,53
Linfield,9565,3,11,5,10,38,36,2,38
Glenavon,9565,4,9,10,7,53,44,9,37
Cliftonville,9565,5,9,4,13,32,32,0,31
Ballymena,9565,6,7,4,15,25,48,-23,25
Glentoran,9565,7,6,6,10,24,32,-8,24
Dungannon,9565,8,2,4,16,14,47,-33,10
Crusaders,9566,1,17,6,3,63,30,33,57
Coleraine,9566,2,14,10,2,44,25,19,52
Glenavon,9566,3,10,9,7,55,44,11,39
Linfield,9566,4,11,5,10,39,37,2,38
Cliftonville,9566,5,9,4,13,33,33,0,31
Ballymena,9566,6,7,4,15,25,49,-24,25
Glentoran,9566,7,6,6,10,24,32,-8,24
Dungannon,9566,8,2,4,16,14,47,-33,10
Coleraine,9567,1,15,10,1,44,22,22,55
Crusaders,9567,2,16,6,4,62,33,29,54
Linfield,9567,3,11,5,10,39,37,2,38
Glenavon,9567,4,9,9,8,52,44,8,36
Cliftonville,9567,5,9,4,13,33,33,0,31
Ballymena,9567,6,8,4,14,28,48,-20,28
Glentoran,9567,7,6,6,10,24,32,-8,24
Dungannon,9567,8,2,4,16,14,47,-33,10
Crusaders,9568,1,16,6,4,62,33,29,54
Coleraine,9568,2,14,11,1,46,25,21,53
Linfield,9568,3,11,5,10,38,36,2,38
Glenavon,9568,4,9,10,7,55,46,9,37
Cliftonville,9568,5,9,4,13,32,32,0,31
Ballymena,9568,6,8,4,14,28,48,-20,28
Glentoran,9568,7,6,6,10,24,32,-8,24
Dungannon,9568,8,2,4,16,14,47,-33,10
Crusaders,9569,1,17,6,3,64,31,33,57
Coleraine,9569,2,14,11,1,44,23,21,53
Linfield,9569,3,11,5,10,39,37,2,38
Glenavon,9569,4,9,10,7,53,44,9,37
Cliftonville,9569,5,9,4,13,33,33,0,31
Ballymena,9569,6,7,4,15,26,50,-24,25
Glentoran,9569,7,6,6,10,24,32,-8,24
Dungannon,9569,8,2,4,16,14,47,-33,10
Crusaders,9570,1,16,6,4,62,32,30,54
Coleraine,9570,2,14,10,2,44,24,20,52
Glenavon,9570,3,10,9,7,54,44,10,39
Linfield,9570,4,10,5,11,38,38,0,35
Cliftonville,9570,5,10,4,12,34,32,2,34
Ballymena,9570,6,8,4,14,27,48,-21,28
Glentoran,9570,7,6,6,10,24,32,-8,24
Dungannon,9570,8,2,4,16,14,47,-33,10
Coleraine,9571,1,15,10,1,47,25,22,55
Crusaders,9571,2,16,6,4,63,34,29,54
Glenavon,9571,3,9,9,8,55,47,8,36
Linfield,9571,4,10,5,11,39,40,-1,35
Cliftonville,9571,5,10,4,12,36,33,3,34
Ballymena,9571,6,8,4,14,29,49,-20,28
Glentoran,9571,7,6,6,10,24,32,-8,24
Dungannon,9571,8,2,4,16,14,47,-33,10
Crusaders,9572,1,17,6,3,64,31,33,57
Coleraine,9572,2,14,11,1,43,22,21,53
Linfield,9572,3,11,5,10,38,36,2,38
Glenavon,9572,4,9,10,7,52,43,9,37
Cliftonville,9572,5,9,4,13,32,32,0,31
Ballymena,9572,6,7,4,15,26,50,-24,25
Glentoran,9572,7,6,6,10,24,32,-8,24
Dungannon,9572,8,2,4,16,14,47,-33,10
Crusaders,9573,1,17,6,3,63,31,32,57
Coleraine,9573,2,14,10,2,43,24,19,52
Glenavon,9573,3,10,9,7,54,43,11,39
Linfield,9573,4,10,5,11,38,38,0,35
Cliftonville,9573,5,10,4,12,34,32,2,34
Ballymena,9573,6,7,4,15,26,49,-23,25
Glentoran,9573,7,6,6,10,24,32,-8,24
Dungannon,9573,8,2,4,16,14,47,-33,10
Crusaders,9574,1,17,6,3,64,31,33,57
Coleraine,9574,2,14,11,1,45,24,21,53
Glenavon,9574,3,9,10,7,54,45,9,37
Linfield,9574,4,10,5,11,38,38,0,35
Cliftonville,9574,5,10,4,12,34,32,2,34
Ballymena,9574,6,7,4,15,26,50,-24,25
Glentoran,9574,7,6,6,10,24,32,-8,24
Dungannon,9574,8,2,4,16,14,47,-33,10
Crusaders,9575,1,17,6,3,62,30,32,57
Coleraine,9575,2,15,10,1,45,22,23,55
Glenavon,9575,3,9,9,8,52,45,7,36
Linfield,9575,4,10,6,10,37,36,1,36
Cliftonville,9575,5,9,5,12,32,31,1,32
Ballymena,9575,6,7,4,15,25,48,-23,25
Glentoran,9575,7,6,6,10,24,32,-8,24
Dungannon,9575,8,2,4,16,14,47,-33,10
Crusaders,9576,1,16,7,3,61,30,31,55
Coleraine,9576,2,15,10,1,46,22,24,55
Glenavon,9576,3,9,9,8,52,46,6,36
Linfield,9576,4,10,6,10,37,36,1,36
Cliftonville,9576,5,9,5,12,32,31,1,32
Ballymena,9576,6,7,5,14,25,47,-22,26
Glentoran,9576,7,6,6,10,24,32,-8,24
Dungannon,9576,8,2,4,16,14,47,-33,10
Crusaders,9577,1,17,6,3,65,32,33,57
Coleraine,9577,2,15,10,1,45,23,22,55
Glenavon,9577,3,9,9,8,53,45,8,36
Linfield,9577,4,10,6,10,37,36,1,36
Cliftonville,9577,5,9,5,12,32,31,1,32
Ballymena,9577,6,7,4,15,27,51,-24,25
Glentoran,9577,7,6,6,10,24,32,-8,24
Dungannon,9577,8,2,4,16,14,47,-33,10
Crusaders,9578,1,17,6,3,63,30,33,57
Coleraine,9578,2,14,10,2,43,23,20,52
Glenavon,9578,3,10,9,7,53,43,10,39
Linfield,9578,4,11,5,10,40,36,4,38
Cliftonville,9578,5,9,4,13,32,34,-2,31
Ballymena,9578,6,7,4,15,25,49,-24,25
Glentoran,9578,7,6,6,10,24,32,-8,24
Dungannon,9578,8,2,4,16,14,47,-33,10
Crusaders,9579,1,17,6,3,64,30,34,57
Coleraine,9579,2,14,10,2,45,26,19,52
Glenavon,9579,3,10,9,7,56,45,11,39
Linfield,9579,4,11,5,10,41,36,5,38
Cliftonville,9579,5,9,4,13,32,35,-3,31
Ballymena,9579,6,7,4,15,25,50,-25,25
Glentoran,9579,7,6,6,10,24,32,-8,24
Dungannon,9579,8,2,4,16,14,47,-33,10
Crusaders,9580,1,17,6,3,66,30,36,57
Coleraine,9580,2,15,10,1,46,23,23,55
Glenavon,9580,3,9,9,8,53,46,7,36
Linfield,9580,4,10,5,11,38,39,-1,35
Cliftonville,9580,5,10,4,12,35,32,3,34
Ballymena,9580,6,7,4,15,25,52,-27,25
Glentoran,9580,7,6,6,10,24,32,-8,24
Dungannon,9580,8,2,4,16,14,47,-33,10
Crusaders,9581,1,17,6,3,63,30,33,57
Coleraine,9581,2,14,11,1,45,24,21,53
Glenavon,9581,3,9,10,7,54,45,9,37
Linfield,9581,4,10,6,10,37,36,1,36
Cliftonville,9581,5,9,5,12,32,31,1,32
Ballymena,9581,6,7,4,15,25,49,-24,25
Glentoran,9581,7,6,6,10,24,32,-8,24
Dungannon,9581,8,2,4,16,14,47,-33,10
Crusaders,9582,1,16,7,3,63,32,31,55
Coleraine,9582,2,14,10,2,44,26,18,52
Glenavon,9582,3,10,9,7,56,44,12,39
Linfield,9582,4,11,5,10,39,37,2,38
Cliftonville,9582,5,9,4,13,33,33,0,31
Ballymena,9582,6,7,5,14,27,49,-22,26
Glentoran,9582,7,6,6,10,24,32,-8,24
Dungannon,9582,8,2,4,16,14,47,-33,10
Crusaders,9583,1,16,6,4,61,31,30,54
Coleraine,9583,2,14,10,2,44,27,17,52
Glenavon,9583,3,10,9,7,57,44,13,39
Linfield,9583,4,10,6,10,37,36,1,36
Cliftonville,9583,5,9,5,12,32,31,1,32
Ballymena,9583,6,8,4,14,26,47,-21,28
Glentoran,9583,7,6,6,10,24,32,-8,24
Dungannon,9583,8,2,4,16,14,47,-33,10
Coleraine,9584,1,15,10,1,46,22,24,55
Crusaders,9584,2,16,6,4,61,31,30,54
Glenavon,9584,3,9,9,8,52,46,6,36
Linfield,9584,4,10,5,11,37,39,-2,35
Cliftonville,9584,5,10,4,12,35,31,4,34
Ballymena,9584,6,8,4,14,26,47,-21,28
Glentoran,9584,7,6,6,10,24,32,-8,24
Dungannon,9584,8,2,4,16,14,47,-33,10
Crusaders,9585,1,16,7,3,63,32,31,55
Coleraine,9585,2,15,10,1,46,23,23,55
Linfield,9585,3,11,5,10,38,36,2,38
Glenavon,9585,4,9,9,8,53,46,7,36
Cliftonville,9585,5,9,4,13,32,32,0,31
Ballymena,9585,6,7,5,14,27,49,-22,26
Glentoran,9585,7,6,6,10,24,32,-8,24
Dungannon,9585,8,2,4,16,14,47,-33,10
Coleraine,9586,1,15,10,1,46,24,22,55
Crusaders,9586,2,16,6,4,61,31,30,54
Glenavon,9586,3,9,9,8,54,46,8,36
Linfield,9586,4,10,5,11,37,38,-1,35
Cliftonville,9586,5,10,4,12,34,31,3,34
Ballymena,9586,6,8,4,14,26,47,-21,28
Glentoran,9586,7,6,6,10,24,32,-8,24
Dungannon,9586,8,2,4,16,14,47,-33,10
Crusaders,9587,1,16,6,4,62,32,30,54
Coleraine,9587,2,14,10,2,44,24,20,52
Glenavon,9587,3,10,9,7,54,44,10,39
Linfield,9587,4,10,6,10,39,38,1,36
Cliftonville,9587,5,9,5,12,34,33,1,32
Ballymena,9587,6,8,4,14,27,48,-21,28
Glentoran,9587,7,6,6,10,24,32,-8,24
Dungannon,9587,8,2,4,16,14,47,-33,10
Coleraine,9588,1,15,10,1,46,23,23,55
Crusaders,9588,2,16,6,4,61,31,30,54
Glenavon,9588,3,9,9,8,53,46,7,36
Linfield,9588,4,10,5,11,37,39,-2,35
Cliftonville,9588,5,10,4,12,35,31,4,34
Ballymena,9588,6,8,4,14,26,47,-21,28
Glentoran,9588,7,6,6,10,24,32,-8,24
Dungannon,9588,8,2,4,16,14,47,-33,10
Crusaders,9589,1,16,6,4,62,32,30,54
Coleraine,9589,2,14,10,2,45,25,20,52
Glenavon,9589,3,10,9,7,55,45,10,39
Linfield,9589,4,11,5,10,40,36,4,38
Cliftonville,9589,5,9,4,13,32,34,-2,31
Ballymena,9589,6,8,4,14,27,48,-21,28
Glentoran,9589,7,6,6,10,24,32,-8,24
Dungannon,9589,8,2,4,16,14,47,-33,10
Crusaders,9590,1,16,6,4,62,32,30,54
Coleraine,9590,2,14,10,2,43,25,18,52
Glenavon,9590,3,10,9,7,55,43,12,39
Linfield,9590,4,10,6,10,38,37,1,36
Cliftonville,9590,5,9,5,12,33,32,1,32
Ballymena,9590,6,8,4,14,27,48,-21,28
Glentoran,9590,7,6,6,10,24,32,-8,24
Dungannon,9590,8,2,4,16,14,47,-33,10
Crusaders,9591,1,17,6,3,64,31,33,57
Coleraine,9591,2,14,11,1,45,24,21,53
Glenavon,9591,3,9,10,7,54,45,9,37
Linfield,9591,4,10,6,10,37,36,1,36
Cliftonville,9591,5,9,5,12,32,31,1,32
Ballymena,9591,6,7,4,15,26,50,-24,25
Glentoran,9591,7,6,6,10,24,32,-8,24
Dungannon,9591,8,2,4,16,14,47,-33,10
Crusaders,9592,1,17,6,3,65,31,34,57
Coleraine,9592,2,15,10,1,44,22,22,55
Linfield,9592,3,11,5,10,39,37,2,38
Glenavon,9592,4,9,9,8,52,44,8,36
Cliftonville,9592,5,9,4,13,33,33,0,31
Ballymena,9592,6,7,4,15,26,51,-25,25
Glentoran,9592,7,6,6,10,24,32,-8,24
Dungannon,9592,8,2,4,16,14,47,-33,10
Crusaders,9593,1,16,6,4,63,33,30,54
Coleraine,9593,2,14,11,1,44,23,21,53
Glenavon,9593,3,9,10,7,53,44,9,37
Linfield,9593,4,10,6,10,39,38,1,36
Cliftonville,9593,5,9,5,12,34,33,1,32
Ballymena,9593,6,8,4,14,28,49,-21,28
Glentoran,9593,7,6,6,10,24,32,-8,24
Dungannon,9593,8,2,4,16,14,47,-33,10
Crusaders,9594,1,16,7,3,62,31,31,55
Coleraine,9594,2,14,10,2,44,25,19,52
Glenavon,9594,3,10,9,7,55,44,11,39
Linfield,9594,4,10,5,11,37,37,0,35
Cliftonville,9594,5,10,4,12,33,31,2,34
Ballymena,9594,6,7,5,14,26,48,-22,26
Glentoran,9594,7,6,6,10,24,32,-8,24
Dungannon,9594,8,2,4,16,14,47,-33,10
Coleraine,9595,1,15,10,1,45,23,22,55
Crusaders,9595,2,16,6,4,61,32,29,54
Glenavon,9595,3,9,9,8,53,45,8,36
Linfield,9595,4,10,5,11,37,37,0,35
Cliftonville,9595,5,10,4,12,33,31,2,34
Ballymena,9595,6,8,4,14,27,47,-20,28
Glentoran,9595,7,6,6,10,24,32,-8,24
Dungannon,9595,8,2,4,16,14,47,-33,10
Crusaders,9596,1,17,6,3,63,31,32,57
Coleraine,9596,2,15,10,1,45,23,22,55
Linfield,9596,3,11,5,10,38,36,2,38
Glenavon,9596,4,9,9,8,53,45,8,36
Cliftonville,9596,5,9,4,13,32,32,0,31
Ballymena,9596,6,7,4,15,26,49,-23,25
Glentoran,9596,7,6,6,10,24,32,-8,24
Dungannon,9596,8,2,4,16,14,47,-33,10
Crusaders,9597,1,17,6,3,63,30,33,57
Coleraine,9597,2,15,10,1,48,22,26,55
Linfield,9597,3,11,5,10,40,38,2,38
Glenavon,9597,4,9,9,8,52,48,4,36
Cliftonville,9597,5,9,4,13,34,34,0,31
Ballymena,9597,6,7,4,15,25,49,-24,25
Glentoran,9597,7,6,6,10,24,32,-8,24
Dungannon,9597,8,2,4,16,14,47,-33,10
Crusaders,9598,1,16,6,4,62,32,30,54
Coleraine,9598,2,14,10,2,43,26,17,52
Glenavon,9598,3,10,9,7,56,43,13,39
Linfield,9598,4,11,5,10,40,37,3,38
Cliftonville,9598,5,9,4,13,33,34,-1,31
Ballymena,9598,6,8,4,14,27,48,-21,28
Glentoran,9598,7,6,6,10,24,32,-8,24
Dungannon,9598,8,2,4,16,14,47,-33,10
Crusaders,9599,1,17,6,3,62,30,32,57
Coleraine,9599,2,14,11,1,46,25,21,53
Linfield,9599,3,11,5,10,39,37,2,38
Glenavon,9599,4,9,10,7,55,46,9,37
Cliftonville,9599,5,9,4,13,33,33,0,31
Ballymena,9599,6,7,4,15,25,48,-23,25
Glentoran,9599,7,6,6,10,24,32,-8,24
Dungannon,9599,8,2,4,16,14,47,-33,10
Crusaders,9600,1,16,6,4,61,31,30,54
Coleraine,9600,2,14,10,2,45,27,18,52
Glenavon,9600,3,10,9,7,57,45,12,39
Linfield,9600,4,11,5,10,40,37,3,38
Cliftonville,9600,5,9,4,13,33,34,-1,31
Ballymena,9600,6,8,4,14,26,47,-21,28
Glentoran,9600,7,6,6,10,24,32,-8,24
Dungannon,9600,8,2,4,16,14,47,-33,10
Crusaders,9601,1,17,6,3,62,30,32,57
Coleraine,9601,2,14,11,1,45,24,21,53
Glenavon,9601,3,9,10,7,54,45,9,37
Linfield,9601,4,10,5,11,38,39,-1,35
Cliftonville,9601,5,10,4,12,35,32,3,34
Ballymena,9601,6,7,4,15,25,48,-23,25
Glentoran,9601,7,6,6,10,24,32,-8,24
Dungannon,9601,8,2,4,16,14,47,-33,10
Crusaders,9602,1,16,7,3,63,32,31,55
Coleraine,9602,2,15,10,1,45,22,23,55
Glenavon,9602,3,9,9,8,52,45,7,36
Linfield,9602,4,10,5,11,37,38,-1,35
Cliftonville,9602,5,10,4,12,34,31,3,34
Ballymena,9602,6,7,5,14,27,49,-22,26
Glentoran,9602,7,6,6,10,24,32,-8,24
Dungannon,9602,8,2,4,16,14,47,-33,10
Crusaders,9603,1,17,6,3,65,30,35,57
Coleraine,9603,2,15,10,1,47,23,24,55
Linfield,9603,3,11,5,10,38,36,2,38
Glenavon,9603,4,9,9,8,53,47,6,36
Cliftonville,9603,5,9,4,13,32,32,0,31
Ballymena,9603,6,7,4,15,25,51,-26,25
Glentoran,9603,7,6,6,10,24,32,-8,24
Dungannon,9603,8,2,4,16,14,47,-33,10
Crusaders,9604,1,17,6,3,63,31,32,57
Coleraine,9604,2,15,10,1,45,22,23,55
Glenavon,9604,3,9,9,8,52,45,7,36
Linfield,9604,4,10,5,11,38,38,0,35
Cliftonville,9604,5,10,4,12,34,32,2,34
Ballymena,9604,6,7,4,15,26,49,-23,25
Glentoran,9604,7,6,6,10,24,32,-8,24
Dungannon,9604,8,2,4,16,14,47,-33,10
Crusaders,9605,1,17,6,3,63,30,33,57
Coleraine,9605,2,14,10,2,44,24,20,52
Glenavon,9605,3,10,9,7,54,44,10,39
Linfield,9605,4,10,6,10,37,36,1,36
Cliftonville,9605,5,9,5,12,32,31,1,32
Ballymena,9605,6,7,4,15,25,49,-24,25
Glentoran,9605,7,6,6,10,24,32,-8,24
Dungannon,9605,8,2,4,16,14,47,-33,10
Crusaders,9606,1,17,6,3,64,30,34,57
Coleraine,9606,2,15,10,1,46,24,22,55
Linfield,9606,3,11,5,10,39,37,2,38
Glenavon,9606,4,9,9,8,54,46,8,36
Cliftonville,9606,5,9,4,13,33,33,0,31
Ballymena,9606,6,7,4,15,25,50,-25,25
Glentoran,9606,7,6,6,10,24,32,-8,24
Dungannon,9606,8,2,4,16,14,47,-33,10
Crusaders,9607,1,17,6,3,64,31,33,57
Coleraine,9607,2,15,10,1,50,23,27,55
Linfield,9607,3,11,5,10,39,37,2,38
Glenavon,9607,4,9,9,8,53,50,3,36
Cliftonville,9607,5,9,4,13,33,33,0,31
Ballymena,9607,6,7,4,15,26,50,-24,25
Glentoran,9607,7,6,6,10,24,32,-8,24
Dungannon,9607,8,2,4,16,14,47,-33,10
Crusaders,9608,1,17,6,3,62,30,32,57
Coleraine,9608,2,14,10,2,43,23,20,52
Glenavon,9608,3,10,9,7,53,43,10,39
Linfield,9608,4,10,6,10,37,36,1,36
Cliftonville,9608,5,9,5,12,32,31,1,32
Ballymena,9608,6,7,4,15,25,48,-23,25
Glentoran,9608,7,6,6,10,24,32,-8,24
Dungannon,9608,8,2,4,16,14,47,-33,10
Crusaders,9609,1,17,6,3,68,32,36,57
Coleraine,9609,2,14,11,1,44,23,21,53
Linfield,9609,3,11,5,10,41,37,4,38
Glenavon,9609,4,9,10,7,53,44,9,37
Cliftonville,9609,5,9,4,13,33,35,-2,31
Ballymena,9609,6,7,4,15,27,54,-27,25
Glentoran,9609,7,6,6,10,24,32,-8,24
Dungannon,9609,8,2,4,16,14,47,-33,10
Crusaders,9610,1,17,6,3,64,30,34,57
Coleraine,9610,2,14,10,2,43,27,16,52
Glenavon,9610,3,10,9,7,57,43,14,39
Linfield,9610,4,10,6,10,39,38,1,36
Cliftonville,9610,5,9,5,12,34,33,1,32
Ballymena,9610,6,7,4,15,25,50,-25,25
Glentoran,9610,7,6,6,10,24,32,-8,24
Dungannon,9610,8,2,4,16,14,47,-33,10
Crusaders,9611,1,17,6,3,63,30,33,57
Coleraine,9611,2,15,10,1,46,23,23,55
Linfield,9611,3,11,5,10,40,38,2,38
Glenavon,9611,4,9,9,8,53,46,7,36
Cliftonville,9611,5,9,4,13,34,34,0,31
Ballymena,9611,6,7,4,15,25,49,-24,25
Glentoran,9611,7,6,6,10,24,32,-8,24
Dungannon,9611,8,2,4,16,14,47,-33,10
Crusaders,9612,1,17,6,3,64,32,32,57
Coleraine,9612,2,14,11,1,44,23,21,53
Linfield,9612,3,11,5,10,38,36,2,38
Glenavon,9612,4,9,10,7,53,44,9,37
Cliftonville,9612,5,9,4,13,32,32,0,31
Ballymena,9612,6,7,4,15,27,50,-23,25
Glentoran,9612,7,6,6,10,24,32,-8,24
Dungannon,9612,8,2,4,16,14,47,-33,10
Crusaders,9613,1,16,6,4,62,32,30,54
Coleraine,9613,2,14,10,2,45,25,20,52
Glenavon,9613,3,10,9,7,55,45,10,39
Linfield,9613,4,10,5,11,37,37,0,35
Cliftonville,9613,5,10,4,12,33,31,2,34
Ballymena,9613,6,8,4,14,27,48,-21,28
Glentoran,9613,7,6,6,10,24,32,-8,24
Dungannon,9613,8,2,4,16,14,47,-33,10
Crusaders,9614,1,17,6,3,63,30,33,57
Coleraine,9614,2,15,10,1,45,23,22,55
Linfield,9614,3,11,5,10,42,37,5,38
Glenavon,9614,4,9,9,8,53,45,8,36
Cliftonville,9614,5,9,4,13,33,36,-3,31
Ballymena,9614,6,7,4,15,25,49,-24,25
Glentoran,9614,7,6,6,10,24,32,-8,24
Dungannon,9614,8,2,4,16,14,47,-33,10
Crusaders,9615,1,17,6,3,62,30,32,57
Coleraine,9615,2,14,10,2,43,24,19,52
Glenavon,9615,3,10,9,7,54,43,11,39
Linfield,9615,4,10,6,10,39,38,1,36
Cliftonville,9615,5,9,5,12,34,33,1,32
Ballymena,9615,6,7,4,15,25,48,-23,25
Glentoran,9615,7,6,6,10,24,32,-8,24
Dungannon,9615,8,2,4,16,14,47,-33,10
Crusaders,9616,1,17,6,3,63,31,32,57
Coleraine,9616,2,14,11,1,45,24,21,53
Glenavon,9616,3,9,10,7,54,45,9,37
Linfield,9616,4,10,5,11,38,38,0,35
Cliftonville,9616,5,10,4,12,34,32,2,34
Ballymena,9616,6,7,4,15,26,49,-23,25
Glentoran,9616,7,6,6,10,24,32,-8,24
Dungannon,9616,8,2,4,16,14,47,-33,10
Crusaders,9617,1,17,6,3,63,30,33,57
Coleraine,9617,2,15,10,1,45,22,23,55
Linfield,9617,3,11,5,10,39,36,3,38
Glenavon,9617,4,9,9,8,52,45,7,36
Cliftonville,9617,5,9,4,13,32,33,-1,31
Ballymena,9617,6,7,4,15,25,49,-24,25
Glentoran,9617,7,6,6,10,24,32,-8,24
Dungannon,9617,8,2,4,16,14,47,-33,10
Crusaders,9618,1,17,6,3,63,31,32,57
Coleraine,9618,2,15,10,1,46,23,23,55
Glenavon,9618,3,9,9,8,53,46,7,36
Linfield,9618,4,10,6,10,38,37,1,36
Cliftonville,9618,5,9,5,12,33,32,1,32
Ballymena,9618,6,7,4,15,26,49,-23,25
Glentoran,9618,7,6,6,10,24,32,-8,24
Dungannon,9618,8,2,4,16,14,47,-33,10
Crusaders,9619,1,16,6,4,62,32,30,54
Coleraine,9619,2,14,11,1,45,24,21,53
Linfield,9619,3,11,5,10,40,37,3,38
Glenavon,9619,4,9,10,7,54,45,9,37
Cliftonville,9619,5,9,4,13,33,34,-1,31
Ballymena,9619,6,8,4,14,27,48,-21,28
Glentoran,9619,7,6,6,10,24,32,-8,24
Dungannon,9619,8,2,4,16,14,47,-33,10
Crusaders,9620,1,17,6,3,65,30,35,57
Coleraine,9620,2,14,11,1,44,23,21,53
Linfield,9620,3,11,5,10,39,36,3,38
Glenavon,9620,4,9,10,7,53,44,9,37
Cliftonville,9620,5,9,4,13,32,33,-1,31
Ballymena,9620,6,7,4,15,25,51,-26,25
Glentoran,9620,7,6,6,10,24,32,-8,24
Dungannon,9620,8,2,4,16,14,47,-33,10
Coleraine,9621,1,15,10,1,48,26,22,55
Crusaders,9621,2,16,6,4,61,31,30,54
Linfield,9621,3,11,5,10,38,36,2,38
Glenavon,9621,4,9,9,8,56,48,8,36
Cliftonville,9621,5,9,4,13,32,32,0,31
Ballymena,9621,6,8,4,14,26,47,-21,28
Glentoran,9621,7,6,6,10,24,32,-8,24
Dungannon,9621,8,2,4,16,14,47,-33,10
Crusaders,9622,1,16,6,4,61,31,30,54
Coleraine,9622,2,14,10,2,46,26,20,52
Glenavon,9622,3,10,9,7,56,46,10,39
Linfield,9622,4,10,6,10,38,37,1,36
Cliftonville,9622,5,9,5,12,33,32,1,32
Ballymena,9622,6,8,4,14,26,47,-21,28
Glentoran,9622,7,6,6,10,24,32,-8,24
Dungannon,9622,8,2,4,16,14,47,-33,10
Crusaders,9623,1,17,6,3,63,30,33,57
Coleraine,9623,2,15,10,1,47,23,24,55
Linfield,9623,3,11,5,10,39,37,2,38
Glenavon,9623,4,9,9,8,53,47,6,36
Cliftonville,9623,5,9,4,13,33,33,0,31
Ballymena,9623,6,7,4,15,25,49,-24,25
Glentoran,9623,7,6,6,10,24,32,-8,24
Dungannon,9623,8,2,4,16,14,47,-33,10
Crusaders,9624,1,17,6,3,63,30,33,57
Coleraine,9624,2,14,10,2,43,24,19,52
Glenavon,9624,3,10,9,7,54,43,11,39
Linfield,9624,4,11,5,10,44,38,6,38
Cliftonville,9624,5,9,4,13,34,38,-4,31
Ballymena,9624,6,7,4,15,25,49,-24,25
Glentoran,9624,7,6,6,10,24,32,-8,24
Dungannon,9624,8,2,4,16,14,47,-33,10
Crusaders,9625,1,17,6,3,64,32,32,57
Coleraine,9625,2,15,10,1,47,22,25,55
Linfield,9625,3,11,5,10,38,36,2,38
Glenavon,9625,4,9,9,8,52,47,5,36
Cliftonville,9625,5,9,4,13,32,32,0,31
Ballymena,9625,6,7,4,15,27,50,-23,25
Glentoran,9625,7,6,6,10,24,32,-8,24
Dungannon,9625,8,2,4,16,14,47,-33,10
Coleraine,9626,1,15,10,1,47,24,23,55
Crusaders,9626,2,16,6,4,61,31,30,54
Linfield,9626,3,11,5,10,42,36,6,38
Glenavon,9626,4,9,9,8,54,47,7,36
Cliftonville,9626,5,9,4,13,32,36,-4,31
Ballymena,9626,6,8,4,14,26,47,-21,28
Glentoran,9626,7,6,6,10,24,32,-8,24
Dungannon,9626,8,2,4,16,14,47,-33,10
Crusaders,9627,1,17,6,3,65,31,34,57
Coleraine,9627,2,14,11,1,45,24,21,53
Linfield,9627,3,11,5,10,39,36,3,38
Glenavon,9627,4,9,10,7,54,45,9,37
Cliftonville,9627,5,9,4,13,32,33,-1,31
Ballymena,9627,6,7,4,15,26,51,-25,25
Glentoran,9627,7,6,6,10,24,32,-8,24
Dungannon,9627,8,2,4,16,14,47,-33,10
Crusaders,9628,1,16,7,3,64,33,31,55
Coleraine,9628,2,14,11,1,44,23,21,53
Linfield,9628,3,11,5,10,38,36,2,38
Glenavon,9628,4,9,10,7,53,44,9,37
Cliftonville,9628,5,9,4,13,32,32,0,31
Ballymena,9628,6,7,5,14,28,50,-22,26
Glentoran,9628,7,6,6,10,24,32,-8,24
Dungannon,9628,8,2,4,16,14,47,-33,10
Crusaders,9629,1,17,6,3,64,30,34,57
Coleraine,9629,2,14,11,1,45,24,21,53
Linfield,9629,3,11,5,10,40,37,3,38
Glenavon,9629,4,9,10,7,54,45,9,37
Cliftonville,9629,5,9,4,13,33,34,-1,31
Ballymena,9629,6,7,4,15,25,50,-25,25
Glentoran,9629,7,6,6,10,24,32,-8,24
Dungannon,9629,8,2,4,16,14,47,-33,10
Crusaders,9630,1,16,6,4,62,32,30,54
Coleraine,9630,2,14,10,2,43,24,19,52
Glenavon,9630,3,10,9,7,54,43,11,39
Linfield,9630,4,10,5,11,38,38,0,35
Cliftonville,9630,5,10,4,12,34,32,2,34
Ballymena,9630,6,8,4,14,27,48,-21,28
Glentoran,9630,7,6,6,10,24,32,-8,24
Dungannon,9630,8,2,4,16,14,47,-33,10
Crusaders,9631,1,16,7,3,63,32,31,55
Coleraine,9631,2,15,10,1,46,24,22,55
Glenavon,9631,3,9,9,8,54,46,8,36
Linfield,9631,4,10,5,11,37,38,-1,35
Cliftonville,9631,5,10,4,12,34,31,3,34
Ballymena,9631,6,7,5,14,27,49,-22,26
Glentoran,9631,7,6,6,10,24,32,-8,24
Dungannon,9631,8,2,4,16,14,47,-33,10
Crusaders,9632,1,16,7,3,62,31,31,55
Coleraine,9632,2,14,10,2,44,24,20,52
Glenavon,9632,3,10,9,7,54,44,10,39
Linfield,9632,4,10,5,11,37,38,-1,35
Cliftonville,9632,5,10,4,12,34,31,3,34
Ballymena,9632,6,7,5,14,26,48,-22,26
Glentoran,9632,7,6,6,10,24,32,-8,24
Dungannon,9632,8,2,4,16,14,47,-33,10
Crusaders,9633,1,17,6,3,64,31,33,57
Coleraine,9633,2,14,11,1,45,24,21,53
Linfield,9633,3,11,5,10,38,36,2,38
Glenavon,9633,4,9,10,7,54,45,9,37
Cliftonville,9633,5,9,4,13,32,32,0,31
Ballymena,9633,6,7,4,15,26,50,-24,25
Glentoran,9633,7,6,6,10,24,32,-8,24
Dungannon,9633,8,2,4,16,14,47,-33,10
Crusaders,9634,1,17,6,3,65,32,33,57
Coleraine,9634,2,14,11,1,44,23,21,53
Linfield,9634,3,11,5,10,40,37,3,38
Glenavon,9634,4,9,10,7,53,44,9,37
Cliftonville,9634,5,9,4,13,33,34,-1,31
Ballymena,9634,6,7,4,15,27,51,-24,25
Glentoran,9634,7,6,6,10,24,32,-8,24
Dungannon,9634,8,2,4,16,14,47,-33,10
Crusaders,9635,1,16,6,4,61,32,29,54
Coleraine,9635,2,14,10,2,43,24,19,52
Glenavon,9635,3,10,9,7,54,43,11,39
Linfield,9635,4,10,6,10,38,37,1,36
Cliftonville,9635,5,9,5,12,33,32,1,32
Ballymena,9635,6,8,4,14,27,47,-20,28
Glentoran,9635,7,6,6,10,24,32,-8,24
Dungannon,9635,8,2,4,16,14,47,-33,10
Crusaders,9636,1,16,7,3,62,31,31,55
Coleraine,9636,2,14,11,1,45,24,21,53
Linfield,9636,3,11,5,10,39,37,2,38
Glenavon,9636,4,9,10,7,54,45,9,37
Cliftonville,9636,5,9,4,13,33,33,0,31
Ballymena,9636,6,7,5,14,26,48,-22,26
Glentoran,9636,7,6,6,10,24,32,-8,24
Dungannon,9636,8,2,4,16,14,47,-33,10
Crusaders,9637,1,17,6,3,66,30,36,57
Coleraine,9637,2,15,10,1,44,22,22,55
Glenavon,9637,3,9,9,8,52,44,8,36
Linfield,9637,4,10,5,11,37,37,0,35
Cliftonville,9637,5,10,4,12,33,31,2,34
Ballymena,9637,6,7,4,15,25,52,-27,25
Glentoran,9637,7,6,6,10,24,32,-8,24
Dungannon,9637,8,2,4,16,14,47,-33,10
Crusaders,9638,1,17,6,3,68,32,36,57
Coleraine,9638,2,14,11,1,45,24,21,53
Linfield,9638,3,11,5,10,38,36,2,38
Glenavon,9638,4,9,10,7,54,45,9,37
Cliftonville,9638,5,9,4,13,32,32,0,31
Ballymena,9638,6,7,4,15,27,54,-27,25
Glentoran,9638,7,6,6,10,24,32,-8,24
Dungannon,9638,8,2,4,16,14,47,-33,10
Crusaders,9639,1,16,7,3,63,32,31,55
Coleraine,9639,2,14,10,2,43,24,19,52
Glenavon,9639,3,10,9,7,54,43,11,39
Linfield,9639,4,11,5,10,39,37,2,38
Cliftonville,9639,5,9,4,13,33,33,0,31
Ballymena,9639,6,7,5,14,27,49,-22,26
Glentoran,9639,7,6,6,10,24,32,-8,24
Dungannon,9639,8,2,4,16,14,47,-33,10
Crusaders,9640,1,16,6,4,62,32,30,54
Coleraine,9640,2,14,11,1,46,25,21,53
Linfield,9640,3,11,5,10,39,36,3,38
Glenavon,9640,4,9,10,7,55,46,9,37
Cliftonville,9640,5,9,4,13,32,33,-1,31
Ballymena,9640,6,8,4,14,27,48,-21,28
Glentoran,9640,7,6,6,10,24,32,-8,24
Dungannon,9640,8,2,4,16,14,47,-33,10
Crusaders,9641,1,17,6,3,62,30,32,57
Coleraine,9641,2,15,10,1,45,22,23,55
Glenavon,9641,3,9,9,8,52,45,7,36
Linfield,9641,4,10,6,10,38,37,1,36
Cliftonville,9641,5,9,5,12,33,32,1,32
Ballymena,9641,6,7,4,15,25,48,-23,25
Glentoran,9641,7,6,6,10,24,32,-8,24
Dungannon,9641,8,2,4,16,14,47,-33,10
Coleraine,9642,1,15,10,1,44,22,22,55
Crusaders,9642,2,16,6,4,62,32,30,54
Glenavon,9642,3,9,9,8,52,44,8,36
Linfield,9642,4,10,5,11,37,37,0,35
Cliftonville,9642,5,10,4,12,33,31,2,34
Ballymena,9642,6,8,4,14,27,48,-21,28
Glentoran,9642,7,6,6,10,24,32,-8,24
Dungannon,9642,8,2,4,16,14,47,-33,10
Crusaders,9643,1,17,6,3,64,30,34,57
Coleraine,9643,2,14,10,2,45,25,20,52
Glenavon,9643,3,10,9,7,55,45,10,39
Linfield,9643,4,11,5,10,40,37,3,38
Cliftonville,9643,5,9,4,13,33,34,-1,31
Ballymena,9643,6,7,4,15,25,50,-25,25
Glentoran,9643,7,6,6,10,24,32,-8,24
Dungannon,9643,8,2,4,16,14,47,-33,10
Crusaders,9644,1,17,6,3,63,31,32,57
Coleraine,9644,2,14,10,2,45,26,19,52
Glenavon,9644,3,10,9,7,56,45,11,39
Linfield,9644,4,10,6,10,37,36,1,36
Cliftonville,9644,5,9,5,12,32,31,1,32
Ballymena,9644,6,7,4,15,26,49,-23,25
Glentoran,9644,7,6,6,10,24,32,-8,24
Dungannon,9644,8,2,4,16,14,47,-33,10
Crusaders,9645,1,17,6,3,65,31,34,57
Coleraine,9645,2,14,10,2,44,26,18,52
Glenavon,9645,3,10,9,7,56,44,12,39
Linfield,9645,4,10,6,10,37,36,1,36
Cliftonville,9645,5,9,5,12,32,31,1,32
Ballymena,9645,6,7,4,15,26,51,-25,25
Glentoran,9645,7,6,6,10,24,32,-8,24
Dungannon,9645,8,2,4,16,14,47,-33,10
Crusaders,9646,1,17,6,3,63,30,33,57
Coleraine,9646,2,14,10,2,43,23,20,52
Glenavon,9646,3,10,9,7,53,43,10,39
Linfield,9646,4,10,6,10,37,36,1,36
Cliftonville,9646,5,9,5,12,32,31,1,32
Ballymena,9646,6,7,4,15,25,49,-24,25
Glentoran,9646,7,6,6,10,24,32,-8,24
Dungannon,9646,8,2,4,16,14,47,-33,10
Crusaders,9647,1,17,6,3,65,32,33,57
Coleraine,9647,2,14,10,2,44,24,20,52
Glenavon,9647,3,10,9,7,54,44,10,39
Linfield,9647,4,11,5,10,38,36,2,38
Cliftonville,9647,5,9,4,13,32,32,0,31
Ballymena,9647,6,7,4,15,27,51,-24,25
Glentoran,9647,7,6,6,10,24,32,-8,24
Dungannon,9647,8,2,4,16,14,47,-33,10
Crusaders,9648,1,17,6,3,64,31,33,57
Coleraine,9648,2,14,10,2,43,23,20,52
Glenavon,9648,3,10,9,7,53,43,10,39
Linfield,9648,4,10,6,10,39,38,1,36
Cliftonville,9648,5,9,5,12,34,33,1,32
Ballymena,9648,6,7,4,15,26,50,-24,25
Glentoran,9648,7,6,6,10,24,32,-8,24
Dungannon,9648,8,2,4,16,14,47,-33,10
Crusaders,9649,1,16,6,4,61,31,30,54
Coleraine,9649,2,14,11,1,44,23,21,53
Glenavon,9649,3,9,10,7,53,44,9,37
Linfield,9649,4,10,6,10,38,37,1,36
Cliftonville,9649,5,9,5,12,33,32,1,32
Ballymena,9649,6,8,4,14,26,47,-21,28
Glentoran,9649,7,6,6,10,24,32,-8,24
Dungannon,9649,8,2,4,16,14,47,-33,10
Crusaders,9650,1,16,7,3,62,31,31,55
Coleraine,9650,2,15,10,1,47,22,25,55
Linfield,9650,3,11,5,10,41,37,4,38
Glenavon,9650,4,9,9,8,52,47,5,36
Cliftonville,9650,5,9,4,13,33,35,-2,31
Ballymena,9650,6,7,5,14,26,48,-22,26
Glentoran,9650,7,6,6,10,24,32,-8,24
Dungannon,9650,8,2,4,16,14,47,-33,10
Crusaders,9651,1,16,7,3,62,31,31,55
Coleraine,9651,2,14,11,1,43,22,21,53
Glenavon,9651,3,9,10,7,52,43,9,37
Linfield,9651,4,10,5,11,38,38,0,35
Cliftonville,9651,5,10,4,12,34,32,2,34
Ballymena,9651,6,7,5,14,26,48,-22,26
Glentoran,9651,7,6,6,10,24,32,-8,24
Dungannon,9651,8,2,4,16,14,47,-33,10
Coleraine,9652,1,15,10,1,46,23,23,55
Crusaders,9652,2,16,6,4,62,33,29,54
Glenavon,9652,3,9,9,8,53,46,7,36
Linfield,9652,4,10,6,10,40,39,1,36
Cliftonville,9652,5,9,5,12,35,34,1,32
Ballymena,9652,6,8,4,14,28,48,-20,28
Glentoran,9652,7,6,6,10,24,32,-8,24
Dungannon,9652,8,2,4,16,14,47,-33,10
Crusaders,9653,1,16,7,3,63,32,31,55
Coleraine,9653,2,15,10,1,46,22,24,55
Linfield,9653,3,11,5,10,39,36,3,38
Glenavon,9653,4,9,9,8,52,46,6,36
Cliftonville,9653,5,9,4,13,32,33,-1,31
Ballymena,9653,6,7,5,14,27,49,-22,26
Glentoran,9653,7,6,6,10,24,32,-8,24
Dungannon,9653,8,2,4,16,14,47,-33,10
Crusaders,9654,1,17,6,3,63,30,33,57
Coleraine,9654,2,14,10,2,44,25,19,52
Glenavon,9654,3,10,9,7,55,44,11,39
Linfield,9654,4,11,5,10,40,37,3,38
Cliftonville,9654,5,9,4,13,33,34,-1,31
Ballymena,9654,6,7,4,15,25,49,-24,25
Glentoran,9654,7,6,6,10,24,32,-8,24
Dungannon,9654,8,2,4,16,14,47,-33,10
Coleraine,9655,1,15,10,1,45,23,22,55
Crusaders,9655,2,16,6,4,61,31,30,54
Linfield,9655,3,11,5,10,39,36,3,38
Glenavon,9655,4,9,9,8,53,45,8,36
Cliftonville,9655,5,9,4,13,32,33,-1,31
Ballymena,9655,6,8,4,14,26,47,-21,28
Glentoran,9655,7,6,6,10,24,32,-8,24
Dungannon,9655,8,2,4,16,14,47,-33,10
Crusaders,9656,1,17,6,3,62,30,32,57
Coleraine,9656,2,14,11,1,44,23,21,53
Glenavon,9656,3,9,10,7,53,44,9,37
Linfield,9656,4,10,5,11,37,38,-1,35
Cliftonville,9656,5,10,4,12,34,31,3,34
Ballymena,9656,6,7,4,15,25,48,-23,25
Glentoran,9656,7,6,6,10,24,32,-8,24
Dungannon,9656,8,2,4,16,14,47,-33,10
Coleraine,9657,1,15,10,1,47,24,23,55
Crusaders,9657,2,16,6,4,61,35,26,54
Linfield,9657,3,11,5,10,39,36,3,38
Glenavon,9657,4,9,9,8,54,47,7,36
Cliftonville,9657,5,9,4,13,32,33,-1,31
Ballymena,9657,6,8,4,14,30,47,-17,28
Glentoran,9657,7,6,6,10,24,32,-8,24
Dungannon,9657,8,2,4,16,14,47,-33,10
Crusaders,9658,1,17,6,3,63,31,32,57
Coleraine,9658,2,14,11,1,44,23,21,53
Linfield,9658,3,11,5,10,39,36,3,38
Glenavon,9658,4,9,10,7,53,44,9,37
Cliftonville,9658,5,9,4,13,32,33,-1,31
Ballymena,9658,6,7,4,15,26,49,-23,25
Glentoran,9658,7,6,6,10,24,32,-8,24
Dungannon,9658,8,2,4,16,14,47,-33,10
Crusaders,9659,1,16,7,3,62,31,31,55
Coleraine,9659,2,14,10,2,44,24,20,52
Glenavon,9659,3,10,9,7,54,44,10,39
Linfield,9659,4,11,5,10,39,37,2,38
Cliftonville,9659,5,9,4,13,33,33,0,31
Ballymena,9659,6,7,5,14,26,48,-22,26
Glentoran,9659,7,6,6,10,24,32,-8,24
Dungannon,9659,8,2,4,16,14,47,-33,10
Crusaders,9660,1,17,6,3,64,30,34,57
Coleraine,9660,2,15,10,1,47,23,24,55
Glenavon,9660,3,9,9,8,53,47,6,36
Linfield,9660,4,10,6,10,38,37,1,36
Cliftonville,9660,5,9,5,12,33,32,1,32
Ballymena,9660,6,7,4,15,25,50,-25,25
Glentoran,9660,7,6,6,10,24,32,-8,24
Dungannon,9660,8,2,4,16,14,47,-33,10
Crusaders,9661,1,16,7,3,62,31,31,55
Coleraine,9661,2,14,11,1,44,23,21,53
Glenavon,9661,3,9,10,7,53,44,9,37
Linfield,9661,4,10,5,11,37,37,0,35
Cliftonville,9661,5,10,4,12,33,31,2,34
Ballymena,9661,6,7,5,14,26,48,-22,26
Glentoran,9661,7,6,6,10,24,32,-8,24
Dungannon,9661,8,2,4,16,14,47,-33,10
Crusaders,9662,1,17,6,3,66,31,35,57
Coleraine,9662,2,14,10,2,43,23,20,52
Glenavon,9662,3,10,9,7,53,43,10,39
Linfield,9662,4,11,5,10,41,37,4,38
Cliftonville,9662,5,9,4,13,33,35,-2,31
Ballymena,9662,6,7,4,15,26,52,-26,25
Glentoran,9662,7,6,6,10,24,32,-8,24
Dungannon,9662,8,2,4,16,14,47,-33,10
Coleraine,9663,1,15,10,1,46,23,23,55
Crusaders,9663,2,16,6,4,61,35,26,54
Linfield,9663,3,11,5,10,39,36,3,38
Glenavon,9663,4,9,9,8,53,46,7,36
Cliftonville,9663,5,9,4,13,32,33,-1,31
Ballymena,9663,6,8,4,14,30,47,-17,28
Glentoran,9663,7,6,6,10,24,32,-8,24
Dungannon,9663,8,2,4,16,14,47,-33,10
Crusaders,9664,1,16,7,3,62,31,31,55
Coleraine,9664,2,14,10,2,44,24,20,52
Glenavon,9664,3,10,9,7,54,44,10,39
Linfield,9664,4,11,5,10,41,37,4,38
Cliftonville,9664,5,9,4,13,33,35,-2,31
Ballymena,9664,6,7,5,14,26,48,-22,26
Glentoran,9664,7,6,6,10,24,32,-8,24
Dungannon,9664,8,2,4,16,14,47,-33,10
Crusaders,9665,1,17,6,3,63,30,33,57
Coleraine,9665,2,14,10,2,47,27,20,52
Glenavon,9665,3,10,9,7,57,47,10,39
Linfield,9665,4,10,6,10,37,36,1,36
Cliftonville,9665,5,9,5,12,32,31,1,32
Ballymena,9665,6,7,4,15,25,49,-24,25
Glentoran,9665,7,6,6,10,24,32,-8,24
Dungannon,9665,8,2,4,16,14,47,-33,10
Crusaders,9666,1,16,7,3,62,31,31,55
Coleraine,9666,2,14,11,1,43,22,21,53
Glenavon,9666,3,9,10,7,52,43,9,37
Linfield,9666,4,10,6,10,38,37,1,36
Cliftonville,9666,5,9,5,12,33,32,1,32
Ballymena,9666,6,7,5,14,26,48,-22,26
Glentoran,9666,7,6,6,10,24,32,-8,24
Dungannon,9666,8,2,4,16,14,47,-33,10
Crusaders,9667,1,16,7,3,61,30,31,55
Coleraine,9667,2,15,10,1,46,22,24,55
Linfield,9667,3,11,5,10,39,37,2,38
Glenavon,9667,4,9,9,8,52,46,6,36
Cliftonville,9667,5,9,4,13,33,33,0,31
Ballymena,9667,6,7,5,14,25,47,-22,26
Glentoran,9667,7,6,6,10,24,32,-8,24
Dungannon,9667,8,2,4,16,14,47,-33,10
Crusaders,9668,1,16,7,3,63,32,31,55
Coleraine,9668,2,15,10,1,44,22,22,55
Linfield,9668,3,11,5,10,39,37,2,38
Glenavon,9668,4,9,9,8,52,44,8,36
Cliftonville,9668,5,9,4,13,33,33,0,31
Ballymena,9668,6,7,5,14,27,49,-22,26
Glentoran,9668,7,6,6,10,24,32,-8,24
Dungannon,9668,8,2,4,16,14,47,-33,10
Crusaders,9669,1,17,6,3,63,31,32,57
Coleraine,9669,2,15,10,1,44,22,22,55
Linfield,9669,3,11,5,10,40,37,3,38
Glenavon,9669,4,9,9,8,52,44,8,36
Cliftonville,9669,5,9,4,13,33,34,-1,31
Ballymena,9669,6,7,4,15,26,49,-23,25
Glentoran,9669,7,6,6,10,24,32,-8,24
Dungannon,9669,8,2,4,16,14,47,-33,10
Crusaders,9670,1,16,7,3,61,30,31,55
Coleraine,9670,2,14,10,2,43,23,20,52
Glenavon,9670,3,10,9,7,53,43,10,39
Linfield,9670,4,10,6,10,37,36,1,36
Cliftonville,9670,5,9,5,12,32,31,1,32
Ballymena,9670,6,7,5,14,25,47,-22,26
Glentoran,9670,7,6,6,10,24,32,-8,24
Dungannon,9670,8,2,4,16,14,47,-33,10
Crusaders,9671,1,16,7,3,63,32,31,55
Coleraine,9671,2,14,11,1,44,23,21,53
Glenavon,9671,3,9,10,7,53,44,9,37
Linfield,9671,4,10,5,11,39,40,-1,35
Cliftonville,9671,5,10,4,12,36,33,3,34
Ballymena,9671,6,7,5,14,27,49,-22,26
Glentoran,9671,7,6,6,10,24,32,-8,24
Dungannon,9671,8,2,4,16,14,47,-33,10
Coleraine,9672,1,15,10,1,45,22,23,55
Crusaders,9672,2,16,6,4,61,32,29,54
Glenavon,9672,3,9,9,8,52,45,7,36
Linfield,9672,4,10,5,11,38,38,0,35
Cliftonville,9672,5,10,4,12,34,32,2,34
Ballymena,9672,6,8,4,14,27,47,-20,28
Glentoran,9672,7,6,6,10,24,32,-8,24
Dungannon,9672,8,2,4,16,14,47,-33,10
Crusaders,9673,1,17,6,3,65,32,33,57
Coleraine,9673,2,15,10,1,45,22,23,55
Glenavon,9673,3,9,9,8,52,45,7,36
Linfield,9673,4,10,5,11,37,38,-1,35
Cliftonville,9673,5,10,4,12,34,31,3,34
Ballymena,9673,6,7,4,15,27,51,-24,25
Glentoran,9673,7,6,6,10,24,32,-8,24
Dungannon,9673,8,2,4,16,14,47,-33,10
Crusaders,9674,1,17,6,3,64,32,32,57
Coleraine,9674,2,14,10,2,43,24,19,52
Glenavon,9674,3,10,9,7,54,43,11,39
Linfield,9674,4,11,5,10,38,36,2,38
Cliftonville,9674,5,9,4,13,32,32,0,31
Ballymena,9674,6,7,4,15,27,50,-23,25
Glentoran,9674,7,6,6,10,24,32,-8,24
Dungannon,9674,8,2,4,16,14,47,-33,10
Crusaders,9675,1,17,6,3,64,30,34,57
Coleraine,9675,2,15,10,1,46,24,22,55
Linfield,9675,3,11,5,10,38,36,2,38
Glenavon,9675,4,9,9,8,54,46,8,36
Cliftonville,9675,5,9,4,13,32,32,0,31
Ballymena,9675,6,7,4,15,25,50,-25,25
Glentoran,9675,7,6,6,10,24,32,-8,24
Dungannon,9675,8,2,4,16,14,47,-33,10
Crusaders,9676,1,16,7,3,61,30,31,55
Coleraine,9676,2,14,11,1,43,22,21,53
Linfield,9676,3,11,5,10,39,37,2,38
Glenavon,9676,4,9,10,7,52,43,9,37
Cliftonville,9676,5,9,4,13,33,33,0,31
Ballymena,9676,6,7,5,14,25,47,-22,26
Glentoran,9676,7,6,6,10,24,32,-8,24
Dungannon,9676,8,2,4,16,14,47,-33,10
Crusaders,9677,1,16,7,3,61,30,31,55
Coleraine,9677,2,15,10,1,45,22,23,55
Glenavon,9677,3,9,9,8,52,45,7,36
Linfield,9677,4,10,6,10,39,38,1,36
Cliftonville,9677,5,9,5,12,34,33,1,32
Ballymena,9677,6,7,5,14,25,47,-22,26
Glentoran,9677,7,6,6,10,24,32,-8,24
Dungannon,9677,8,2,4,16,14,47,-33,10
Crusaders,9678,1,17,6,3,65,30,35,57
Coleraine,9678,2,14,10,2,43,23,20,52
Glenavon,9678,3,10,9,7,53,43,10,39
Linfield,9678,4,11,5,10,40,37,3,38
Cliftonville,9678,5,9,4,13,33,34,-1,31
Ballymena,9678,6,7,4,15,25,51,-26,25
Glentoran,9678,7,6,6,10,24,32,-8,24
Dungannon,9678,8,2,4,16,14,47,-33,10
Crusaders,9679,1,16,7,3,63,32,31,55
Coleraine,9679,2,14,11,1,45,24,21,53
Glenavon,9679,3,9,10,7,54,45,9,37
Linfield,9679,4,10,5,11,37,37,0,35
Cliftonville,9679,5,10,4,12,33,31,2,34
Ballymena,9679,6,7,5,14,27,49,-22,26
Glentoran,9679,7,6,6,10,24,32,-8,24
Dungannon,9679,8,2,4,16,14,47,-33,10
Crusaders,9680,1,17,6,3,63,31,32,57
Coleraine,9680,2,15,10,1,46,23,23,55
Glenavon,9680,3,9,9,8,53,46,7,36
Linfield,9680,4,10,6,10,38,37,1,36
Cliftonville,9680,5,9,5,12,33,32,1,32
Ballymena,9680,6,7,4,15,26,49,-23,25
Glentoran,9680,7,6,6,10,24,32,-8,24
Dungannon,9680,8,2,4,16,14,47,-33,10
Crusaders,9681,1,17,6,3,64,30,34,57
Coleraine,9681,2,14,10,2,46,26,20,52
Glenavon,9681,3,10,9,7,56,46,10,39
Linfield,9681,4,10,5,11,37,38,-1,35
Cliftonville,9681,5,10,4,12,34,31,3,34
Ballymena,9681,6,7,4,15,25,50,-25,25
Glentoran,9681,7,6,6,10,24,32,-8,24
Dungannon,9681,8,2,4,16,14,47,-33,10
Coleraine,9682,1,15,10,1,45,23,22,55
Crusaders,9682,2,16,6,4,62,33,29,54
Linfield,9682,3,11,5,10,39,36,3,38
Glenavon,9682,4,9,9,8,53,45,8,36
Cliftonville,9682,5,9,4,13,32,33,-1,31
Ballymena,9682,6,8,4,14,28,48,-20,28
Glentoran,9682,7,6,6,10,24,32,-8,24
Dungannon,9682,8,2,4,16,14,47,-33,10
Crusaders,9683,1,17,6,3,63,30,33,57
Coleraine,9683,2,14,10,2,44,24,20,52
Glenavon,9683,3,10,9,7,54,44,10,39
Linfield,9683,4,10,6,10,38,37,1,36
Cliftonville,9683,5,9,5,12,33,32,1,32
Ballymena,9683,6,7,4,15,25,49,-24,25
Glentoran,9683,7,6,6,10,24,32,-8,24
Dungannon,9683,8,2,4,16,14,47,-33,10
Crusaders,9684,1,17,6,3,64,32,32,57
Coleraine,9684,2,15,10,1,44,22,22,55
Linfield,9684,3,11,5,10,39,36,3,38
Glenavon,9684,4,9,9,8,52,44,8,36
Cliftonville,9684,5,9,4,13,32,33,-1,31
Ballymena,9684,6,7,4,15,27,50,-23,25
Glentoran,9684,7,6,6,10,24,32,-8,24
Dungannon,9684,8,2,4,16,14,47,-33,10
Crusaders,9685,1,16,7,3,61,30,31,55
Coleraine,9685,2,14,11,1,43,22,21,53
Glenavon,9685,3,9,10,7,52,43,9,37
Linfield,9685,4,10,6,10,38,37,1,36
Cliftonville,9685,5,9,5,12,33,32,1,32
Ballymena,9685,6,7,5,14,25,47,-22,26
Glentoran,9685,7,6,6,10,24,32,-8,24
Dungannon,9685,8,2,4,16,14,47,-33,10
Crusaders,9686,1,17,6,3,64,31,33,57
Coleraine,9686,2,14,10,2,43,23,20,52
Glenavon,9686,3,10,9,7,53,43,10,39
Linfield,9686,4,11,5,10,39,37,2,38
Cliftonville,9686,5,9,4,13,33,33,0,31
Ballymena,9686,6,7,4,15,26,50,-24,25
Glentoran,9686,7,6,6,10,24,32,-8,24
Dungannon,9686,8,2,4,16,14,47,-33,10
Crusaders,9687,1,17,6,3,65,32,33,57
Coleraine,9687,2,14,10,2,43,25,18,52
Glenavon,9687,3,10,9,7,55,43,12,39
Linfield,9687,4,11,5,10,40,37,3,38
Cliftonville,9687,5,9,4,13,33,34,-1,31
Ballymena,9687,6,7,4,15,27,51,-24,25
Glentoran,9687,7,6,6,10,24,32,-8,24
Dungannon,9687,8,2,4,16,14,47,-33,10
Coleraine,9688,1,15,10,1,45,23,22,55
Crusaders,9688,2,16,6,4,63,36,27,54
Glenavon,9688,3,9,9,8,53,45,8,36
Linfield,9688,4,10,6,10,38,37,1,36
Cliftonville,9688,5,9,5,12,33,32,1,32
Ballymena,9688,6,8,4,14,31,49,-18,28
Glentoran,9688,7,6,6,10,24,32,-8,24
Dungannon,9688,8,2,4,16,14,47,-33,10
Crusaders,9689,1,17,6,3,62,30,32,57
Coleraine,9689,2,15,10,1,44,22,22,55
Glenavon,9689,3,9,9,8,52,44,8,36
Linfield,9689,4,10,5,11,38,38,0,35
Cliftonville,9689,5,10,4,12,34,32,2,34
Ballymena,9689,6,7,4,15,25,48,-23,25
Glentoran,9689,7,6,6,10,24,32,-8,24
Dungannon,9689,8,2,4,16,14,47,-33,10
Crusaders,9690,1,16,7,3,63,32,31,55
Coleraine,9690,2,15,10,1,46,22,24,55
Glenavon,9690,3,9,9,8,52,46,6,36
Linfield,9690,4,10,5,11,37,38,-1,35
Cliftonville,9690,5,10,4,12,34,31,3,34
Ballymena,9690,6,7,5,14,27,49,-22,26
Glentoran,9690,7,6,6,10,24,32,-8,24
Dungannon,9690,8,2,4,16,14,47,-33,10
Crusaders,9691,1,17,6,3,64,30,34,57
Coleraine,9691,2,15,10,1,47,23,24,55
Linfield,9691,3,11,5,10,39,37,2,38
Glenavon,9691,4,9,9,8,53,47,6,36
Cliftonville,9691,5,9,4,13,33,33,0,31
Ballymena,9691,6,7,4,15,25,50,-25,25
Glentoran,9691,7,6,6,10,24,32,-8,24
Dungannon,9691,8,2,4,16,14,47,-33,10
Crusaders,9692,1,17,6,3,64,30,34,57
Coleraine,9692,2,14,11,1,43,22,21,53
Glenavon,9692,3,9,10,7,52,43,9,37
Linfield,9692,4,10,5,11,37,39,-2,35
Cliftonville,9692,5,10,4,12,35,31,4,34
Ballymena,9692,6,7,4,15,25,50,-25,25
Glentoran,9692,7,6,6,10,24,32,-8,24
Dungannon,9692,8,2,4,16,14,47,-33,10
Crusaders,9693,1,17,6,3,65,30,35,57
Coleraine,9693,2,14,10,2,45,26,19,52
Glenavon,9693,3,10,9,7,56,45,11,39
Linfield,9693,4,10,5,11,37,37,0,35
Cliftonville,9693,5,10,4,12,33,31,2,34
Ballymena,9693,6,7,4,15,25,51,-26,25
Glentoran,9693,7,6,6,10,24,32,-8,24
Dungannon,9693,8,2,4,16,14,47,-33,10
Crusaders,9694,1,17,6,3,62,30,32,57
Coleraine,9694,2,15,10,1,46,22,24,55
Linfield,9694,3,11,5,10,38,36,2,38
Glenavon,9694,4,9,9,8,52,46,6,36
Cliftonville,9694,5,9,4,13,32,32,0,31
Ballymena,9694,6,7,4,15,25,48,-23,25
Glentoran,9694,7,6,6,10,24,32,-8,24
Dungannon,9694,8,2,4,16,14,47,-33,10
Crusaders,9695,1,17,6,3,63,31,32,57
Coleraine,9695,2,14,11,1,45,24,21,53
Glenavon,9695,3,9,10,7,54,45,9,37
Linfield,9695,4,10,5,11,37,37,0,35
Cliftonville,9695,5,10,4,12,33,31,2,34
Ballymena,9695,6,7,4,15,26,49,-23,25
Glentoran,9695,7,6,6,10,24,32,-8,24
Dungannon,9695,8,2,4,16,14,47,-33,10
Crusaders,9696,1,17,6,3,63,30,33,57
Coleraine,9696,2,14,11,1,45,24,21,53
Linfield,9696,3,11,5,10,38,36,2,38
Glenavon,9696,4,9,10,7,54,45,9,37
Cliftonville,9696,5,9,4,13,32,32,0,31
Ballymena,9696,6,7,4,15,25,49,-24,25
Glentoran,9696,7,6,6,10,24,32,-8,24
Dungannon,9696,8,2,4,16,14,47,-33,10
Coleraine,9697,1,15,10,1,49,22,27,55
Crusaders,9697,2,16,6,4,61,31,30,54
Glenavon,9697,3,9,9,8,52,49,3,36
Linfield,9697,4,10,6,10,37,36,1,36
Cliftonville,9697,5,9,5,12,32,31,1,32
Ballymena,9697,6,8,4,14,26,47,-21,28
Glentoran,9697,7,6,6,10,24,32,-8,24
Dungannon,9697,8,2,4,16,14,47,-33,10
Coleraine,9698,1,15,10,1,47,23,24,55
Crusaders,9698,2,16,6,4,61,32,29,54
Glenavon,9698,3,9,9,8,53,47,6,36
Linfield,9698,4,10,6,10,37,36,1,36
Cliftonville,9698,5,9,5,12,32,31,1,32
Ballymena,9698,6,8,4,14,27,47,-20,28
Glentoran,9698,7,6,6,10,24,32,-8,24
Dungannon,9698,8,2,4,16,14,47,-33,10
Crusaders,9699,1,17,6,3,63,31,32,57
Coleraine,9699,2,14,10,2,43,25,18,52
Glenavon,9699,3,10,9,7,55,43,12,39
Linfield,9699,4,11,5,10,38,36,2,38
Cliftonville,9699,5,9,4,13,32,32,0,31
Ballymena,9699,6,7,4,15,26,49,-23,25
Glentoran,9699,7,6,6,10,24,32,-8,24
Dungannon,9699,8,2,4,16,14,47,-33,10
Coleraine,9700,1,15,10,1,46,24,22,55
Crusaders,9700,2,16,6,4,62,33,29,54
Glenavon,9700,3,9,9,8,54,46,8,36
Linfield,9700,4,10,6,10,37,36,1,36
Cliftonville,9700,5,9,5,12,32,31,1,32
Ballymena,9700,6,8,4,14,28,48,-20,28
Glentoran,9700,7,6,6,10,24,32,-8,24
Dungannon,9700,8,2,4,16,14,47,-33,10
Crusaders,9701,1,17,6,3,64,32,32,57
Coleraine,9701,2,14,10,2,44,24,20,52
Glenavon,9701,3,10,9,7,54,44,10,39
Linfield,9701,4,10,5,11,37,37,0,35
Cliftonville,9701,5,10,4,12,33,31,2,34
Ballymena,9701,6,7,4,15,27,50,-23,25
Glentoran,9701,7,6,6,10,24,32,-8,24
Dungannon,9701,8,2,4,16,14,47,-33,10
Crusaders,9702,1,16,7,3,62,31,31,55
Coleraine,9702,2,14,10,2,43,23,20,52
Glenavon,9702,3,10,9,7,53,43,10,39
Linfield,9702,4,10,5,11,39,39,0,35
Cliftonville,9702,5,10,4,12,35,33,2,34
Ballymena,9702,6,7,5,14,26,48,-22,26
Glentoran,9702,7,6,6,10,24,32,-8,24
Dungannon,9702,8,2,4,16,14,47,-33,10
Crusaders,9703,1,16,7,3,62,31,31,55
Coleraine,9703,2,14,10,2,43,23,20,52
Glenavon,9703,3,10,9,7,53,43,10,39
Linfield,9703,4,11,5,10,38,36,2,38
Cliftonville,9703,5,9,4,13,32,32,0,31
Ballymena,9703,6,7,5,14,26,48,-22,26
Glentoran,9703,7,6,6,10,24,32,-8,24
Dungannon,9703,8,2,4,16,14,47,-33,10
Crusaders,9704,1,17,6,3,63,30,33,57
Coleraine,9704,2,15,10,1,45,22,23,55
Glenavon,9704,3,9,9,8,52,45,7,36
Linfield,9704,4,10,5,11,39,39,0,35
Cliftonville,9704,5,10,4,12,35,33,2,34
Ballymena,9704,6,7,4,15,25,49,-24,25
Glentoran,9704,7,6,6,10,24,32,-8,24
Dungannon,9704,8,2,4,16,14,47,-33,10
Crusaders,9705,1,17,6,3,64,31,33,57
Coleraine,9705,2,15,10,1,45,23,22,55
Linfield,9705,3,11,5,10,41,36,5,38
Glenavon,9705,4,9,9,8,53,45,8,36
Cliftonville,9705,5,9,4,13,32,35,-3,31
Ballymena,9705,6,7,4,15,26,50,-24,25
Glentoran,9705,7,6,6,10,24,32,-8,24
Dungannon,9705,8,2,4,16,14,47,-33,10
Crusaders,9706,1,16,7,3,62,31,31,55
Coleraine,9706,2,14,10,2,43,23,20,52
Glenavon,9706,3,10,9,7,53,43,10,39
Linfield,9706,4,11,5,10,40,38,2,38
Cliftonville,9706,5,9,4,13,34,34,0,31
Ballymena,9706,6,7,5,14,26,48,-22,26
Glentoran,9706,7,6,6,10,24,32,-8,24
Dungannon,9706,8,2,4,16,14,47,-33,10
Crusaders,9707,1,17,6,3,63,30,33,57
Coleraine,9707,2,14,10,2,43,24,19,52
Glenavon,9707,3,10,9,7,54,43,11,39
Linfield,9707,4,10,5,11,37,37,0,35
Cliftonville,9707,5,10,4,12,33,31,2,34
Ballymena,9707,6,7,4,15,25,49,-24,25
Glentoran,9707,7,6,6,10,24,32,-8,24
Dungannon,9707,8,2,4,16,14,47,-33,10
Crusaders,9708,1,17,6,3,63,30,33,57
Coleraine,9708,2,14,11,1,44,23,21,53
Glenavon,9708,3,9,10,7,53,44,9,37
Linfield,9708,4,10,6,10,38,37,1,36
Cliftonville,9708,5,9,5,12,33,32,1,32
Ballymena,9708,6,7,4,15,25,49,-24,25
Glentoran,9708,7,6,6,10,24,32,-8,24
Dungannon,9708,8,2,4,16,14,47,-33,10
Crusaders,9709,1,17,6,3,62,30,32,57
Coleraine,9709,2,14,11,1,45,24,21,53
Linfield,9709,3,11,5,10,40,37,3,38
Glenavon,9709,4,9,10,7,54,45,9,37
Cliftonville,9709,5,9,4,13,33,34,-1,31
Ballymena,9709,6,7,4,15,25,48,-23,25
Glentoran,9709,7,6,6,10,24,32,-8,24
Dungannon,9709,8,2,4,16,14,47,-33,10
Crusaders,9710,1,17,6,3,62,30,32,57
Coleraine,9710,2,15,10,1,47,22,25,55
Linfield,9710,3,11,5,10,38,36,2,38
Glenavon,9710,4,9,9,8,52,47,5,36
Cliftonville,9710,5,9,4,13,32,32,0,31
Ballymena,9710,6,7,4,15,25,48,-23,25
Glentoran,9710,7,6,6,10,24,32,-8,24
Dungannon,9710,8,2,4,16,14,47,-33,10
Crusaders,9711,1,17,6,3,63,31,32,57
Coleraine,9711,2,14,11,1,45,24,21,53
Glenavon,9711,3,9,10,7,54,45,9,37
Linfield,9711,4,10,5,11,38,38,0,35
Cliftonville,9711,5,10,4,12,34,32,2,34
Ballymena,9711,6,7,4,15,26,49,-23,25
Glentoran,9711,7,6,6,10,24,32,-8,24
Dungannon,9711,8,2,4,16,14,47,-33,10
Crusaders,9712,1,16,7,3,61,30,31,55
Coleraine,9712,2,14,10,2,45,25,20,52
Glenavon,9712,3,10,9,7,55,45,10,39
Linfield,9712,4,10,6,10,37,36,1,36
Cliftonville,9712,5,9,5,12,32,31,1,32
Ballymena,9712,6,7,5,14,25,47,-22,26
Glentoran,9712,7,6,6,10,24,32,-8,24
Dungannon,9712,8,2,4,16,14,47,-33,10
Crusaders,9713,1,16,7,3,62,31,31,55
Coleraine,9713,2,14,11,1,43,22,21,53
Glenavon,9713,3,9,10,7,52,43,9,37
Linfield,9713,4,10,5,11,39,39,0,35
Cliftonville,9713,5,10,4,12,35,33,2,34
Ballymena,9713,6,7,5,14,26,48,-22,26
Glentoran,9713,7,6,6,10,24,32,-8,24
Dungannon,9713,8,2,4,16,14,47,-33,10
Crusaders,9714,1,17,6,3,65,32,33,57
Coleraine,9714,2,14,10,2,43,26,17,52
Glenavon,9714,3,10,9,7,56,43,13,39
Linfield,9714,4,11,5,10,39,36,3,38
Cliftonville,9714,5,9,4,13,32,33,-1,31
Ballymena,9714,6,7,4,15,27,51,-24,25
Glentoran,9714,7,6,6,10,24,32,-8,24
Dungannon,9714,8,2,4,16,14,47,-33,10
Crusaders,9715,1,16,6,4,61,32,29,54
Coleraine,9715,2,14,11,1,44,23,21,53
Linfield,9715,3,11,5,10,40,36,4,38
Glenavon,9715,4,9,10,7,53,44,9,37
Cliftonville,9715,5,9,4,13,32,34,-2,31
Ballymena,9715,6,8,4,14,27,47,-20,28
Glentoran,9715,7,6,6,10,24,32,-8,24
Dungannon,9715,8,2,4,16,14,47,-33,10
Crusaders,9716,1,16,7,3,63,32,31,55
Coleraine,9716,2,15,10,1,48,25,23,55
Linfield,9716,3,11,5,10,40,37,3,38
Glenavon,9716,4,9,9,8,55,48,7,36
Cliftonville,9716,5,9,4,13,33,34,-1,31
Ballymena,9716,6,7,5,14,27,49,-22,26
Glentoran,9716,7,6,6,10,24,32,-8,24
Dungannon,9716,8,2,4,16,14,47,-33,10
Crusaders,9717,1,17,6,3,64,31,33,57
Coleraine,9717,2,14,10,2,44,25,19,52
Glenavon,9717,3,10,9,7,55,44,11,39
Linfield,9717,4,10,6,10,39,38,1,36
Cliftonville,9717,5,9,5,12,34,33,1,32
Ballymena,9717,6,7,4,15,26,50,-24,25
Glentoran,9717,7,6,6,10,24,32,-8,24
Dungannon,9717,8,2,4,16,14,47,-33,10
Crusaders,9718,1,17,6,3,68,32,36,57
Coleraine,9718,2,14,10,2,43,23,20,52
Glenavon,9718,3,10,9,7,53,43,10,39
Linfield,9718,4,10,5,11,37,37,0,35
Cliftonville,9718,5,10,4,12,33,31,2,34
Ballymena,9718,6,7,4,15,27,54,-27,25
Glentoran,9718,7,6,6,10,24,32,-8,24
Dungannon,9718,8,2,4,16,14,47,-33,10
Crusaders,9719,1,17,6,3,63,31,32,57
Coleraine,9719,2,14,10,2,43,23,20,52
Glenavon,9719,3,10,9,7,53,43,10,39
Linfield,9719,4,11,5,10,41,36,5,38
Cliftonville,9719,5,9,4,13,32,35,-3,31
Ballymena,9719,6,7,4,15,26,49,-23,25
Glentoran,9719,7,6,6,10,24,32,-8,24
Dungannon,9719,8,2,4,16,14,47,-33,10
Crusaders,9720,1,16,7,3,63,32,31,55
Coleraine,9720,2,14,10,2,44,24,20,52
Glenavon,9720,3,10,9,7,54,44,10,39
Linfield,9720,4,10,5,11,37,37,0,35
Cliftonville,9720,5,10,4,12,33,31,2,34
Ballymena,9720,6,7,5,14,27,49,-22,26
Glentoran,9720,7,6,6,10,24,32,-8,24
Dungannon,9720,8,2,4,16,14,47,-33,10
Crusaders,9721,1,16,7,3,62,31,31,55
Coleraine,9721,2,14,10,2,45,25,20,52
Glenavon,9721,3,10,9,7,55,45,10,39
Linfield,9721,4,11,5,10,39,36,3,38
Cliftonville,9721,5,9,4,13,32,33,-1,31
Ballymena,9721,6,7,5,14,26,48,-22,26
Glentoran,9721,7,6,6,10,24,32,-8,24
Dungannon,9721,8,2,4,16,14,47,-33,10
Crusaders,9722,1,17,6,3,64,32,32,57
Coleraine,9722,2,14,10,2,43,24,19,52
Glenavon,9722,3,10,9,7,54,43,11,39
Linfield,9722,4,11,5,10,41,38,3,38
Cliftonville,9722,5,9,4,13,34,35,-1,31
Ballymena,9722,6,7,4,15,27,50,-23,25
Glentoran,9722,7,6,6,10,24,32,-8,24
Dungannon,9722,8,2,4,16,14,47,-33,10
Crusaders,9723,1,17,6,3,66,31,35,57
Coleraine,9723,2,14,10,2,43,24,19,52
Glenavon,9723,3,10,9,7,54,43,11,39
Linfield,9723,4,11,5,10,38,36,2,38
Cliftonville,9723,5,9,4,13,32,32,0,31
Ballymena,9723,6,7,4,15,26,52,-26,25
Glentoran,9723,7,6,6,10,24,32,-8,24
Dungannon,9723,8,2,4,16,14,47,-33,10
Crusaders,9724,1,17,6,3,62,30,32,57
Coleraine,9724,2,15,10,1,44,22,22,55
Linfield,9724,3,11,5,10,39,36,3,38
Glenavon,9724,4,9,9,8,52,44,8,36
Cliftonville,9724,5,9,4,13,32,33,-1,31
Ballymena,9724,6,7,4,15,25,48,-23,25
Glentoran,9724,7,6,6,10,24,32,-8,24
Dungannon,9724,8,2,4,16,14,47,-33,10
Crusaders,9725,1,16,7,3,62,31,31,55
Coleraine,9725,2,15,10,1,44,22,22,55
Linfield,9725,3,11,5,10,38,36,2,38
Glenavon,9725,4,9,9,8,52,44,8,36
Cliftonville,9725,5,9,4,13,32,32,0,31
Ballymena,9725,6,7,5,14,26,48,-22,26
Glentoran,9725,7,6,6,10,24,32,-8,24
Dungannon,9725,8,2,4,16,14,47,-33,10
Crusaders,9726,1,17,6,3,63,31,32,57
Coleraine,9726,2,15,10,1,46,23,23,55
Glenavon,9726,3,9,9,8,53,46,7,36
Linfield,9726,4,10,6,10,37,36,1,36
Cliftonville,9726,5,9,5,12,32,31,1,32
Ballymena,9726,6,7,4,15,26,49,-23,25
Glentoran,9726,7,6,6,10,24,32,-8,24
Dungannon,9726,8,2,4,16,14,47,-33,10
Crusaders,9727,1,17,6,3,63,31,32,57
Coleraine,9727,2,15,10,1,47,25,22,55
Glenavon,9727,3,9,9,8,55,47,8,36
Linfield,9727,4,10,5,11,37,37,0,35
Cliftonville,9727,5,10,4,12,33,31,2,34
Ballymena,9727,6,7,4,15,26,49,-23,25
Glentoran,9727,7,6,6,10,24,32,-8,24
Dungannon,9727,8,2,4,16,14,47,-33,10
Crusaders,9728,1,17,6,3,65,32,33,57
Coleraine,9728,2,15,10,1,45,22,23,55
Linfield,9728,3,11,5,10,41,36,5,38
Glenavon,9728,4,9,9,8,52,45,7,36
Cliftonville,9728,5,9,4,13,32,35,-3,31
Ballymena,9728,6,7,4,15,27,51,-24,25
Glentoran,9728,7,6,6,10,24,32,-8,24
Dungannon,9728,8,2,4,16,14,47,-33,10
Crusaders,9729,1,17,6,3,64,32,32,57
Coleraine,9729,2,14,10,2,44,24,20,52
Glenavon,9729,3,10,9,7,54,44,10,39
Linfield,9729,4,11,5,10,39,36,3,38
Cliftonville,9729,5,9,4,13,32,33,-1,31
Ballymena,9729,6,7,4,15,27,50,-23,25
Glentoran,9729,7,6,6,10,24,32,-8,24
Dungannon,9729,8,2,4,16,14,47,-33,10
Crusaders,9730,1,17,6,3,62,30,32,57
Coleraine,9730,2,15,10,1,45,23,22,55
Glenavon,9730,3,9,9,8,53,45,8,36
Linfield,9730,4,10,6,10,38,37,1,36
Cliftonville,9730,5,9,5,12,33,32,1,32
Ballymena,9730,6,7,4,15,25,48,-23,25
Glentoran,9730,7,6,6,10,24,32,-8,24
Dungannon,9730,8,2,4,16,14,47,-33,10
Crusaders,9731,1,17,6,3,66,32,34,57
Coleraine,9731,2,15,10,1,45,22,23,55
Glenavon,9731,3,9,9,8,52,45,7,36
Linfield,9731,4,10,5,11,37,39,-2,35
Cliftonville,9731,5,10,4,12,35,31,4,34
Ballymena,9731,6,7,4,15,27,52,-25,25
Glentoran,9731,7,6,6,10,24,32,-8,24
Dungannon,9731,8,2,4,16,14,47,-33,10
Coleraine,9732,1,15,10,1,46,24,22,55
Crusaders,9732,2,16,6,4,61,31,30,54
Linfield,9732,3,11,5,10,42,37,5,38
Glenavon,9732,4,9,9,8,54,46,8,36
Cliftonville,9732,5,9,4,13,33,36,-3,31
Ballymena,9732,6,8,4,14,26,47,-21,28
Glentoran,9732,7,6,6,10,24,32,-8,24
Dungannon,9732,8,2,4,16,14,47,-33,10
Crusaders,9733,1,17,6,3,64,31,33,57
Coleraine,9733,2,14,11,1,45,24,21,53
Linfield,9733,3,11,5,10,39,36,3,38
Glenavon,9733,4,9,10,7,54,45,9,37
Cliftonville,9733,5,9,4,13,32,33,-1,31
Ballymena,9733,6,7,4,15,26,50,-24,25
Glentoran,9733,7,6,6,10,24,32,-8,24
Dungannon,9733,8,2,4,16,14,47,-33,10
Crusaders,9734,1,17,6,3,63,30,33,57
Coleraine,9734,2,15,10,1,45,23,22,55
Glenavon,9734,3,9,9,8,53,45,8,36
Linfield,9734,4,10,6,10,37,36,1,36
Cliftonville,9734,5,9,5,12,32,31,1,32
Ballymena,9734,6,7,4,15,25,49,-24,25
Glentoran,9734,7,6,6,10,24,32,-8,24
Dungannon,9734,8,2,4,16,14,47,-33,10
Crusaders,9735,1,16,7,3,62,31,31,55
Coleraine,9735,2,14,11,1,45,24,21,53
Glenavon,9735,3,9,10,7,54,45,9,37
Linfield,9735,4,10,5,11,37,37,0,35
Cliftonville,9735,5,10,4,12,33,31,2,34
Ballymena,9735,6,7,5,14,26,48,-22,26
Glentoran,9735,7,6,6,10,24,32,-8,24
Dungannon,9735,8,2,4,16,14,47,-33,10
Crusaders,9736,1,16,6,4,62,32,30,54
Coleraine,9736,2,14,10,2,45,25,20,52
Glenavon,9736,3,10,9,7,55,45,10,39
Linfield,9736,4,11,5,10,38,36,2,38
Cliftonville,9736,5,9,4,13,32,32,0,31
Ballymena,9736,6,8,4,14,27,48,-21,28
Glentoran,9736,7,6,6,10,24,32,-8,24
Dungannon,9736,8,2,4,16,14,47,-33,10
Crusaders,9737,1,16,6,4,61,33,28,54
Coleraine,9737,2,14,11,1,45,24,21,53
Glenavon,9737,3,9,10,7,54,45,9,37
Linfield,9737,4,10,5,11,37,40,-3,35
Cliftonville,9737,5,10,4,12,36,31,5,34
Ballymena,9737,6,8,4,14,28,47,-19,28
Glentoran,9737,7,6,6,10,24,32,-8,24
Dungannon,9737,8,2,4,16,14,47,-33,10
Crusaders,9738,1,17,6,3,68,31,37,57
Coleraine,9738,2,14,11,1,46,25,21,53
Linfield,9738,3,11,5,10,42,36,6,38
Glenavon,9738,4,9,10,7,55,46,9,37
Cliftonville,9738,5,9,4,13,32,36,-4,31
Ballymena,9738,6,7,4,15,26,54,-28,25
Glentoran,9738,7,6,6,10,24,32,-8,24
Dungannon,9738,8,2,4,16,14,47,-33,10
Crusaders,9739,1,16,7,3,63,32,31,55
Coleraine,9739,2,14,11,1,44,23,21,53
Glenavon,9739,3,9,10,7,53,44,9,37
Linfield,9739,4,10,5,11,37,38,-1,35
Cliftonville,9739,5,10,4,12,34,31,3,34
Ballymena,9739,6,7,5,14,27,49,-22,26
Glentoran,9739,7,6,6,10,24,32,-8,24
Dungannon,9739,8,2,4,16,14,47,-33,10
Crusaders,9740,1,16,6,4,62,32,30,54
Coleraine,9740,2,14,10,2,43,24,19,52
Glenavon,9740,3,10,9,7,54,43,11,39
Linfield,9740,4,10,6,10,37,36,1,36
Cliftonville,9740,5,9,5,12,32,31,1,32
Ballymena,9740,6,8,4,14,27,48,-21,28
Glentoran,9740,7,6,6,10,24,32,-8,24
Dungannon,9740,8,2,4,16,14,47,-33,10
Crusaders,9741,1,17,6,3,64,31,33,57
Coleraine,9741,2,14,10,2,46,26,20,52
Glenavon,9741,3,10,9,7,56,46,10,39
Linfield,9741,4,10,6,10,37,36,1,36
Cliftonville,9741,5,9,5,12,32,31,1,32
Ballymena,9741,6,7,4,15,26,50,-24,25
Glentoran,9741,7,6,6,10,24,32,-8,24
Dungannon,9741,8,2,4,16,14,47,-33,10
Crusaders,9742,1,17,6,3,62,30,32,57
Coleraine,9742,2,15,10,1,46,24,22,55
Linfield,9742,3,11,5,10,38,36,2,38
Glenavon,9742,4,9,9,8,54,46,8,36
Cliftonville,9742,5,9,4,13,32,32,0,31
Ballymena,9742,6,7,4,15,25,48,-23,25
Glentoran,9742,7,6,6,10,24,32,-8,24
Dungannon,9742,8,2,4,16,14,47,-33,10
Coleraine,9743,1,15,10,1,46,23,23,55
Crusaders,9743,2,16,6,4,63,33,30,54
Linfield,9743,3,11,5,10,38,36,2,38
Glenavon,9743,4,9,9,8,53,46,7,36
Cliftonville,9743,5,9,4,13,32,32,0,31
Ballymena,9743,6,8,4,14,28,49,-21,28
Glentoran,9743,7,6,6,10,24,32,-8,24
Dungannon,9743,8,2,4,16,14,47,-33,10
Crusaders,9744,1,17,6,3,63,31,32,57
Coleraine,9744,2,14,10,2,44,26,18,52
Glenavon,9744,3,10,9,7,56,44,12,39
Linfield,9744,4,11,5,10,39,36,3,38
Cliftonville,9744,5,9,4,13,32,33,-1,31
Ballymena,9744,6,7,4,15,26,49,-23,25
Glentoran,9744,7,6,6,10,24,32,-8,24
Dungannon,9744,8,2,4,16,14,47,-33,10
Crusaders,9745,1,17,6,3,65,31,34,57
Coleraine,9745,2,14,10,2,43,23,20,52
Glenavon,9745,3,10,9,7,53,43,10,39
Linfield,9745,4,11,5,10,42,38,4,38
Cliftonville,9745,5,9,4,13,34,36,-2,31
Ballymena,9745,6,7,4,15,26,51,-25,25
Glentoran,9745,7,6,6,10,24,32,-8,24
Dungannon,9745,8,2,4,16,14,47,-33,10
Crusaders,9746,1,16,7,3,62,31,31,55
Coleraine,9746,2,14,10,2,43,24,19,52
Glenavon,9746,3,10,9,7,54,43,11,39
Linfield,9746,4,10,6,10,37,36,1,36
Cliftonville,9746,5,9,5,12,32,31,1,32
Ballymena,9746,6,7,5,14,26,48,-22,26
Glentoran,9746,7,6,6,10,24,32,-8,24
Dungannon,9746,8,2,4,16,14,47,-33,10
Crusaders,9747,1,17,6,3,65,31,34,57
Coleraine,9747,2,14,10,2,43,24,19,52
Glenavon,9747,3,10,9,7,54,43,11,39
Linfield,9747,4,10,6,10,38,37,1,36
Cliftonville,9747,5,9,5,12,33,32,1,32
Ballymena,9747,6,7,4,15,26,51,-25,25
Glentoran,9747,7,6,6,10,24,32,-8,24
Dungannon,9747,8,2,4,16,14,47,-33,10
Crusaders,9748,1,17,6,3,64,32,32,57
Coleraine,9748,2,14,10,2,43,25,18,52
Glenavon,9748,3,10,9,7,55,43,12,39
Linfield,9748,4,10,6,10,37,36,1,36
Cliftonville,9748,5,9,5,12,32,31,1,32
Ballymena,9748,6,7,4,15,27,50,-23,25
Glentoran,9748,7,6,6,10,24,32,-8,24
Dungannon,9748,8,2,4,16,14,47,-33,10
Crusaders,9749,1,16,6,4,62,34,28,54
Coleraine,9749,2,14,11,1,43,22,21,53
Linfield,9749,3,11,5,10,38,36,2,38
Glenavon,9749,4,9,10,7,52,43,9,37
Cliftonville,9749,5,9,4,13,32,32,0,31
Ballymena,9749,6,8,4,14,29,48,-19,28
Glentoran,9749,7,6,6,10,24,32,-8,24
Dungannon,9749,8,2,4,16,14,47,-33,10
Coleraine,9750,1,15,10,1,46,24,22,55
Crusaders,9750,2,16,6,4,62,34,28,54
Linfield,9750,3,11,5,10,39,37,2,38
Glenavon,9750,4,9,9,8,54,46,8,36
Cliftonville,9750,5,9,4,13,33,33,0,31
Ballymena,9750,6,8,4,14,29,48,-19,28
Glentoran,9750,7,6,6,10,24,32,-8,24
Dungannon,9750,8,2,4,16,14,47,-33,10
Crusaders,9751,1,17,6,3,63,31,32,57
Coleraine,9751,2,14,11,1,44,23,21,53
Glenavon,9751,3,9,10,7,53,44,9,37
Linfield,9751,4,10,6,10,39,38,1,36
Cliftonville,9751,5,9,5,12,34,33,1,32
Ballymena,9751,6,7,4,15,26,49,-23,25
Glentoran,9751,7,6,6,10,24,32,-8,24
Dungannon,9751,8,2,4,16,14,47,-33,10
Crusaders,9752,1,17,6,3,63,31,32,57
Coleraine,9752,2,14,10,2,44,24,20,52
Glenavon,9752,3,10,9,7,54,44,10,39
Linfield,9752,4,10,6,10,38,37,1,36
Cliftonville,9752,5,9,5,12,33,32,1,32
Ballymena,9752,6,7,4,15,26,49,-23,25
Glentoran,9752,7,6,6,10,24,32,-8,24
Dungannon,9752,8,2,4,16,14,47,-33,10
Crusaders,9753,1,17,6,3,63,31,32,57
Coleraine,9753,2,14,10,2,46,26,20,52
Glenavon,9753,3,10,9,7,56,46,10,39
Linfield,9753,4,10,5,11,38,38,0,35
Cliftonville,9753,5,10,4,12,34,32,2,34
Ballymena,9753,6,7,4,15,26,49,-23,25
Glentoran,9753,7,6,6,10,24,32,-8,24
Dungannon,9753,8,2,4,16,14,47,-33,10
Crusaders,9754,1,17,6,3,63,30,33,57
Coleraine,9754,2,15,10,1,44,22,22,55
Linfield,9754,3,11,5,10,39,37,2,38
Glenavon,9754,4,9,9,8,52,44,8,36
Cliftonville,9754,5,9,4,13,33,33,0,31
Ballymena,9754,6,7,4,15,25,49,-24,25
Glentoran,9754,7,6,6,10,24,32,-8,24
Dungannon,9754,8,2,4,16,14,47,-33,10
Crusaders,9755,1,17,6,3,63,30,33,57
Coleraine,9755,2,15,10,1,47,23,24,55
Linfield,9755,3,11,5,10,39,36,3,38
Glenavon,9755,4,9,9,8,53,47,6,36
Cliftonville,9755,5,9,4,13,32,33,-1,31
Ballymena,9755,6,7,4,15,25,49,-24,25
Glentoran,9755,7,6,6,10,24,32,-8,24
Dungannon,9755,8,2,4,16,14,47,-33,10
Crusaders,9756,1,17,6,3,64,30,34,57
Coleraine,9756,2,14,10,2,43,26,17,52
Glenavon,9756,3,10,9,7,56,43,13,39
Linfield,9756,4,10,5,11,39,39,0,35
Cliftonville,9756,5,10,4,12,35,33,2,34
Ballymena,9756,6,7,4,15,25,50,-25,25
Glentoran,9756,7,6,6,10,24,32,-8,24
Dungannon,9756,8,2,4,16,14,47,-33,10
Coleraine,9757,1,15,10,1,45,22,23,55
Crusaders,9757,2,16,6,4,61,31,30,54
Glenavon,9757,3,9,9,8,52,45,7,36
Linfield,9757,4,10,5,11,37,37,0,35
Cliftonville,9757,5,10,4,12,33,31,2,34
Ballymena,9757,6,8,4,14,26,47,-21,28
Glentoran,9757,7,6,6,10,24,32,-8,24
Dungannon,9757,8,2,4,16,14,47,-33,10
Crusaders,9758,1,16,6,4,61,31,30,54
Coleraine,9758,2,14,10,2,44,24,20,52
Glenavon,9758,3,10,9,7,54,44,10,39
Linfield,9758,4,10,5,11,38,39,-1,35
Cliftonville,9758,5,10,4,12,35,32,3,34
Ballymena,9758,6,8,4,14,26,47,-21,28
Glentoran,9758,7,6,6,10,24,32,-8,24
Dungannon,9758,8,2,4,16,14,47,-33,10
Crusaders,9759,1,17,6,3,63,31,32,57
Coleraine,9759,2,14,10,2,44,24,20,52
Glenavon,9759,3,10,9,7,54,44,10,39
Linfield,9759,4,11,5,10,42,38,4,38
Cliftonville,9759,5,9,4,13,34,36,-2,31
Ballymena,9759,6,7,4,15,26,49,-23,25
Glentoran,9759,7,6,6,10,24,32,-8,24
Dungannon,9759,8,2,4,16,14,47,-33,10
Crusaders,9760,1,17,6,3,62,30,32,57
Coleraine,9760,2,14,10,2,44,24,20,52
Glenavon,9760,3,10,9,7,54,44,10,39
Linfield,9760,4,11,5,10,41,36,5,38
Cliftonville,9760,5,9,4,13,32,35,-3,31
Ballymena,9760,6,7,4,15,25,48,-23,25
Glentoran,9760,7,6,6,10,24,32,-8,24
Dungannon,9760,8,2,4,16,14,47,-33,10
Coleraine,9761,1,15,10,1,46,24,22,55
Crusaders,9761,2,16,6,4,61,31,30,54
Linfield,9761,3,11,5,10,38,36,2,38
Glenavon,9761,4,9,9,8,54,46,8,36
Cliftonville,9761,5,9,4,13,32,32,0,31
Ballymena,9761,6,8,4,14,26,47,-21,28
Glentoran,9761,7,6,6,10,24,32,-8,24
Dungannon,9761,8,2,4,16,14,47,-33,10
Crusaders,9762,1,17,6,3,64,31,33,57
Coleraine,9762,2,14,11,1,45,24,21,53
Glenavon,9762,3,9,10,7,54,45,9,37
Linfield,9762,4,10,6,10,38,37,1,36
Cliftonville,9762,5,9,5,12,33,32,1,32
Ballymena,9762,6,7,4,15,26,50,-24,25
Glentoran,9762,7,6,6,10,24,32,-8,24
Dungannon,9762,8,2,4,16,14,47,-33,10
Crusaders,9763,1,16,6,4,61,32,29,54
Coleraine,9763,2,14,11,1,43,22,21,53
Glenavon,9763,3,9,10,7,52,43,9,37
Linfield,9763,4,10,6,10,38,37,1,36
Cliftonville,9763,5,9,5,12,33,32,1,32
Ballymena,9763,6,8,4,14,27,47,-20,28
Glentoran,9763,7,6,6,10,24,32,-8,24
Dungannon,9763,8,2,4,16,14,47,-33,10
Crusaders,9764,1,16,6,4,62,32,30,54
Coleraine,9764,2,14,10,2,45,27,18,52
Glenavon,9764,3,10,9,7,57,45,12,39
Linfield,9764,4,11,5,10,38,36,2,38
Cliftonville,9764,5,9,4,13,32,32,0,31
Ballymena,9764,6,8,4,14,27,48,-21,28
Glentoran,9764,7,6,6,10,24,32,-8,24
Dungannon,9764,8,2,4,16,14,47,-33,10
Crusaders,9765,1,16,7,3,61,30,31,55
Coleraine,9765,2,14,10,2,44,24,20,52
Glenavon,9765,3,10,9,7,54,44,10,39
Linfield,9765,4,10,5,11,37,37,0,35
Cliftonville,9765,5,10,4,12,33,31,2,34
Ballymena,9765,6,7,5,14,25,47,-22,26
Glentoran,9765,7,6,6,10,24,32,-8,24
Dungannon,9765,8,2,4,16,14,47,-33,10
Crusaders,9766,1,16,7,3,64,33,31,55
Coleraine,9766,2,14,11,1,45,24,21,53
Glenavon,9766,3,9,10,7,54,45,9,37
Linfield,9766,4,10,6,10,38,37,1,36
Cliftonville,9766,5,9,5,12,33,32,1,32
Ballymena,9766,6,7,5,14,28,50,-22,26
Glentoran,9766,7,6,6,10,24,32,-8,24
Dungannon,9766,8,2,4,16,14,47,-33,10
Crusaders,9767,1,16,7,3,63,32,31,55
Coleraine,9767,2,14,10,2,43,25,18,52
Glenavon,9767,3,10,9,7,55,43,12,39
Linfield,9767,4,11,5,10,40,36,4,38
Cliftonville,9767,5,9,4,13,32,34,-2,31
Ballymena,9767,6,7,5,14,27,49,-22,26
Glentoran,9767,7,6,6,10,24,32,-8,24
Dungannon,9767,8,2,4,16,14,47,-33,10
Crusaders,9768,1,17,6,3,63,31,32,57
Coleraine,9768,2,15,10,1,44,22,22,55
Linfield,9768,3,11,5,10,40,36,4,38
Glenavon,9768,4,9,9,8,52,44,8,36
Cliftonville,9768,5,9,4,13,32,34,-2,31
Ballymena,9768,6,7,4,15,26,49,-23,25
Glentoran,9768,7,6,6,10,24,32,-8,24
Dungannon,9768,8,2,4,16,14,47,-33,10
Crusaders,9769,1,17,6,3,65,31,34,57
Coleraine,9769,2,15,10,1,47,23,24,55
Linfield,9769,3,11,5,10,39,37,2,38
Glenavon,9769,4,9,9,8,53,47,6,36
Cliftonville,9769,5,9,4,13,33,33,0,31
Ballymena,9769,6,7,4,15,26,51,-25,25
Glentoran,9769,7,6,6,10,24,32,-8,24
Dungannon,9769,8,2,4,16,14,47,-33,10
Crusaders,9770,1,17,6,3,63,31,32,57
Coleraine,9770,2,14,11,1,45,24,21,53
Linfield,9770,3,11,5,10,38,36,2,38
Glenavon,9770,4,9,10,7,54,45,9,37
Cliftonville,9770,5,9,4,13,32,32,0,31
Ballymena,9770,6,7,4,15,26,49,-23,25
Glentoran,9770,7,6,6,10,24,32,-8,24
Dungannon,9770,8,2,4,16,14,47,-33,10
Crusaders,9771,1,17,6,3,63,30,33,57
Coleraine,9771,2,14,10,2,43,23,20,52
Glenavon,9771,3,10,9,7,53,43,10,39
Linfield,9771,4,10,5,11,38,38,0,35
Cliftonville,9771,5,10,4,12,34,32,2,34
Ballymena,9771,6,7,4,15,25,49,-24,25
Glentoran,9771,7,6,6,10,24,32,-8,24
Dungannon,9771,8,2,4,16,14,47,-33,10
Coleraine,9772,1,15,10,1,48,26,22,55
Crusaders,9772,2,16,6,4,61,31,30,54
Glenavon,9772,3,9,9,8,56,48,8,36
Linfield,9772,4,10,5,11,38,39,-1,35
Cliftonville,9772,5,10,4,12,35,32,3,34
Ballymena,9772,6,8,4,14,26,47,-21,28
Glentoran,9772,7,6,6,10,24,32,-8,24
Dungannon,9772,8,2,4,16,14,47,-33,10
Crusaders,9773,1,16,7,3,62,31,31,55
Coleraine,9773,2,15,10,1,45,23,22,55
Linfield,9773,3,11,5,10,41,37,4,38
Glenavon,9773,4,9,9,8,53,45,8,36
Cliftonville,9773,5,9,4,13,33,35,-2,31
Ballymena,9773,6,7,5,14,26,48,-22,26
Glentoran,9773,7,6,6,10,24,32,-8,24
Dungannon,9773,8,2,4,16,14,47,-33,10
Crusaders,9774,1,16,6,4,61,32,29,54
Coleraine,9774,2,14,10,2,43,23,20,52
Glenavon,9774,3,10,9,7,53,43,10,39
Linfield,9774,4,11,5,10,39,37,2,38
Cliftonville,9774,5,9,4,13,33,33,0,31
Ballymena,9774,6,8,4,14,27,47,-20,28
Glentoran,9774,7,6,6,10,24,32,-8,24
Dungannon,9774,8,2,4,16,14,47,-33,10
Crusaders,9775,1,16,7,3,63,32,31,55
Coleraine,9775,2,15,10,1,47,23,24,55
Linfield,9775,3,11,5,10,40,36,4,38
Glenavon,9775,4,9,9,8,53,47,6,36
Cliftonville,9775,5,9,4,13,32,34,-2,31
Ballymena,9775,6,7,5,14,27,49,-22,26
Glentoran,9775,7,6,6,10,24,32,-8,24
Dungannon,9775,8,2,4,16,14,47,-33,10
Crusaders,9776,1,17,6,3,64,31,33,57
Coleraine,9776,2,14,10,2,45,25,20,52
Glenavon,9776,3,10,9,7,55,45,10,39
Linfield,9776,4,11,5,10,40,36,4,38
Cliftonville,9776,5,9,4,13,32,34,-2,31
Ballymena,9776,6,7,4,15,26,50,-24,25
Glentoran,9776,7,6,6,10,24,32,-8,24
Dungannon,9776,8,2,4,16,14,47,-33,10
Crusaders,9777,1,17,6,3,64,31,33,57
Coleraine,9777,2,14,11,1,44,23,21,53
Glenavon,9777,3,9,10,7,53,44,9,37
Linfield,9777,4,10,6,10,37,36,1,36
Cliftonville,9777,5,9,5,12,32,31,1,32
Ballymena,9777,6,7,4,15,26,50,-24,25
Glentoran,9777,7,6,6,10,24,32,-8,24
Dungannon,9777,8,2,4,16,14,47,-33,10
Crusaders,9778,1,17,6,3,62,30,32,57
Coleraine,9778,2,14,10,2,43,25,18,52
Glenavon,9778,3,10,9,7,55,43,12,39
Linfield,9778,4,11,5,10,38,36,2,38
Cliftonville,9778,5,9,4,13,32,32,0,31
Ballymena,9778,6,7,4,15,25,48,-23,25
Glentoran,9778,7,6,6,10,24,32,-8,24
Dungannon,9778,8,2,4,16,14,47,-33,10
Crusaders,9779,1,17,6,3,64,31,33,57
Coleraine,9779,2,14,10,2,44,26,18,52
Glenavon,9779,3,10,9,7,56,44,12,39
Linfield,9779,4,11,5,10,38,36,2,38
Cliftonville,9779,5,9,4,13,32,32,0,31
Ballymena,9779,6,7,4,15,26,50,-24,25
Glentoran,9779,7,6,6,10,24,32,-8,24
Dungannon,9779,8,2,4,16,14,47,-33,10
Crusaders,9780,1,16,6,4,61,33,28,54
Coleraine,9780,2,14,10,2,45,26,19,52
Glenavon,9780,3,10,9,7,56,45,11,39
Linfield,9780,4,10,6,10,38,37,1,36
Cliftonville,9780,5,9,5,12,33,32,1,32
Ballymena,9780,6,8,4,14,28,47,-19,28
Glentoran,9780,7,6,6,10,24,32,-8,24
Dungannon,9780,8,2,4,16,14,47,-33,10
Crusaders,9781,1,17,6,3,64,30,34,57
Coleraine,9781,2,15,10,1,45,23,22,55
Glenavon,9781,3,9,9,8,53,45,8,36
Linfield,9781,4,10,5,11,37,38,-1,35
Cliftonville,9781,5,10,4,12,34,31,3,34
Ballymena,9781,6,7,4,15,25,50,-25,25
Glentoran,9781,7,6,6,10,24,32,-8,24
Dungannon,9781,8,2,4,16,14,47,-33,10
Crusaders,9782,1,17,6,3,64,31,33,57
Coleraine,9782,2,14,10,2,43,25,18,52
Glenavon,9782,3,10,9,7,55,43,12,39
Linfield,9782,4,10,5,11,38,38,0,35
Cliftonville,9782,5,10,4,12,34,32,2,34
Ballymena,9782,6,7,4,15,26,50,-24,25
Glentoran,9782,7,6,6,10,24,32,-8,24
Dungannon,9782,8,2,4,16,14,47,-33,10
Crusaders,9783,1,17,6,3,64,30,34,57
Coleraine,9783,2,14,10,2,44,24,20,52
Glenavon,9783,3,10,9,7,54,44,10,39
Linfield,9783,4,11,5,10,39,36,3,38
Cliftonville,9783,5,9,4,13,32,33,-1,31
Ballymena,9783,6,7,4,15,25,50,-25,25
Glentoran,9783,7,6,6,10,24,32,-8,24
Dungannon,9783,8,2,4,16,14,47,-33,10
Crusaders,9784,1,16,6,4,61,31,30,54
Coleraine,9784,2,14,11,1,46,25,21,53
Glenavon,9784,3,9,10,7,55,46,9,37
Linfield,9784,4,10,5,11,39,39,0,35
Cliftonville,9784,5,10,4,12,35,33,2,34
Ballymena,9784,6,8,4,14,26,47,-21,28
Glentoran,9784,7,6,6,10,24,32,-8,24
Dungannon,9784,8,2,4,16,14,47,-33,10
Crusaders,9785,1,17,6,3,62,30,32,57
Coleraine,9785,2,14,11,1,43,22,21,53
Glenavon,9785,3,9,10,7,52,43,9,37
Linfield,9785,4,10,5,11,38,39,-1,35
Cliftonville,9785,5,10,4,12,35,32,3,34
Ballymena,9785,6,7,4,15,25,48,-23,25
Glentoran,9785,7,6,6,10,24,32,-8,24
Dungannon,9785,8,2,4,16,14,47,-33,10
Crusaders,9786,1,17,6,3,63,31,32,57
Coleraine,9786,2,14,10,2,43,23,20,52
Glenavon,9786,3,10,9,7,53,43,10,39
Linfield,9786,4,10,5,11,38,38,0,35
Cliftonville,9786,5,10,4,12,34,32,2,34
Ballymena,9786,6,7,4,15,26,49,-23,25
Glentoran,9786,7,6,6,10,24,32,-8,24
Dungannon,9786,8,2,4,16,14,47,-33,10
Crusaders,9787,1,16,6,4,61,31,30,54
Coleraine,9787,2,14,10,2,43,26,17,52
Glenavon,9787,3,10,9,7,56,43,13,39
Linfield,9787,4,10,6,10,39,38,1,36
Cliftonville,9787,5,9,5,12,34,33,1,32
Ballymena,9787,6,8,4,14,26,47,-21,28
Glentoran,9787,7,6,6,10,24,32,-8,24
Dungannon,9787,8,2,4,16,14,47,-33,10
Crusaders,9788,1,16,6,4,61,33,28,54
Coleraine,9788,2,14,11,1,44,23,21,53
Glenavon,9788,3,9,10,7,53,44,9,37
Linfield,9788,4,10,6,10,38,37,1,36
Cliftonville,9788,5,9,5,12,33,32,1,32
Ballymena,9788,6,8,4,14,28,47,-19,28
Glentoran,9788,7,6,6,10,24,32,-8,24
Dungannon,9788,8,2,4,16,14,47,-33,10
Crusaders,9789,1,16,7,3,61,30,31,55
Coleraine,9789,2,14,11,1,44,23,21,53
Glenavon,9789,3,9,10,7,53,44,9,37
Linfield,9789,4,10,5,11,37,40,-3,35
Cliftonville,9789,5,10,4,12,36,31,5,34
Ballymena,9789,6,7,5,14,25,47,-22,26
Glentoran,9789,7,6,6,10,24,32,-8,24
Dungannon,9789,8,2,4,16,14,47,-33,10
Crusaders,9790,1,17,6,3,64,31,33,57
Coleraine,9790,2,15,10,1,45,22,23,55
Linfield,9790,3,11,5,10,39,37,2,38
Glenavon,9790,4,9,9,8,52,45,7,36
Cliftonville,9790,5,9,4,13,33,33,0,31
Ballymena,9790,6,7,4,15,26,50,-24,25
Glentoran,9790,7,6,6,10,24,32,-8,24
Dungannon,9790,8,2,4,16,14,47,-33,10
Crusaders,9791,1,17,6,3,63,31,32,57
Coleraine,9791,2,14,11,1,44,23,21,53
Glenavon,9791,3,9,10,7,53,44,9,37
Linfield,9791,4,10,6,10,37,36,1,36
Cliftonville,9791,5,9,5,12,32,31,1,32
Ballymena,9791,6,7,4,15,26,49,-23,25
Glentoran,9791,7,6,6,10,24,32,-8,24
Dungannon,9791,8,2,4,16,14,47,-33,10
Crusaders,9792,1,16,7,3,61,30,31,55
Coleraine,9792,2,14,10,2,44,24,20,52
Glenavon,9792,3,10,9,7,54,44,10,39
Linfield,9792,4,11,5,10,41,36,5,38
Cliftonville,9792,5,9,4,13,32,35,-3,31
Ballymena,9792,6,7,5,14,25,47,-22,26
Glentoran,9792,7,6,6,10,24,32,-8,24
Dungannon,9792,8,2,4,16,14,47,-33,10
Crusaders,9793,1,17,6,3,64,30,34,57
Coleraine,9793,2,14,10,2,44,24,20,52
Glenavon,9793,3,10,9,7,54,44,10,39
Linfield,9793,4,10,5,11,37,38,-1,35
Cliftonville,9793,5,10,4,12,34,31,3,34
Ballymena,9793,6,7,4,15,25,50,-25,25
Glentoran,9793,7,6,6,10,24,32,-8,24
Dungannon,9793,8,2,4,16,14,47,-33,10
Coleraine,9794,1,15,10,1,45,23,22,55
Crusaders,9794,2,16,6,4,64,35,29,54
Glenavon,9794,3,9,9,8,53,45,8,36
Linfield,9794,4,10,5,11,37,37,0,35
Cliftonville,9794,5,10,4,12,33,31,2,34
Ballymena,9794,6,8,4,14,30,50,-20,28
Glentoran,9794,7,6,6,10,24,32,-8,24
Dungannon,9794,8,2,4,16,14,47,-33,10
Crusaders,9795,1,16,6,4,61,33,28,54
Coleraine,9795,2,14,10,2,46,26,20,52
Glenavon,9795,3,10,9,7,56,46,10,39
Linfield,9795,4,10,6,10,37,36,1,36
Cliftonville,9795,5,9,5,12,32,31,1,32
Ballymena,9795,6,8,4,14,28,47,-19,28
Glentoran,9795,7,6,6,10,24,32,-8,24
Dungannon,9795,8,2,4,16,14,47,-33,10
Crusaders,9796,1,16,7,3,61,30,31,55
Coleraine,9796,2,14,10,2,45,26,19,52
Glenavon,9796,3,10,9,7,56,45,11,39
Linfield,9796,4,11,5,10,40,37,3,38
Cliftonville,9796,5,9,4,13,33,34,-1,31
Ballymena,9796,6,7,5,14,25,47,-22,26
Glentoran,9796,7,6,6,10,24,32,-8,24
Dungannon,9796,8,2,4,16,14,47,-33,10
Crusaders,9797,1,16,6,4,62,32,30,54
Coleraine,9797,2,14,11,1,48,27,21,53
Glenavon,9797,3,9,10,7,57,48,9,37
Linfield,9797,4,10,6,10,37,36,1,36
Cliftonville,9797,5,9,5,12,32,31,1,32
Ballymena,9797,6,8,4,14,27,48,-21,28
Glentoran,9797,7,6,6,10,24,32,-8,24
Dungannon,9797,8,2,4,16,14,47,-33,10
Crusaders,9798,1,16,7,3,63,32,31,55
Coleraine,9798,2,15,10,1,47,24,23,55
Linfield,9798,3,11,5,10,39,37,2,38
Glenavon,9798,4,9,9,8,54,47,7,36
Cliftonville,9798,5,9,4,13,33,33,0,31
Ballymena,9798,6,7,5,14,27,49,-22,26
Glentoran,9798,7,6,6,10,24,32,-8,24
Dungannon,9798,8,2,4,16,14,47,-33,10
Crusaders,9799,1,17,6,3,62,30,32,57
Coleraine,9799,2,15,10,1,47,23,24,55
Glenavon,9799,3,9,9,8,53,47,6,36
Linfield,9799,4,10,5,11,37,38,-1,35
Cliftonville,9799,5,10,4,12,34,31,3,34
Ballymena,9799,6,7,4,15,25,48,-23,25
Glentoran,9799,7,6,6,10,24,32,-8,24
Dungannon,9799,8,2,4,16,14,47,-33,10
Crusaders,9800,1,16,6,4,63,34,29,54
Coleraine,9800,2,14,11,1,45,24,21,53
Glenavon,9800,3,9,10,7,54,45,9,37
Linfield,9800,4,10,6,10,38,37,1,36
Cliftonville,9800,5,9,5,12,33,32,1,32
Ballymena,9800,6,8,4,14,29,49,-20,28
Glentoran,9800,7,6,6,10,24,32,-8,24
Dungannon,9800,8,2,4,16,14,47,-33,10
Crusaders,9801,1,16,7,3,62,31,31,55
Coleraine,9801,2,14,11,1,45,24,21,53
Glenavon,9801,3,9,10,7,54,45,9,37
Linfield,9801,4,10,5,11,38,38,0,35
Cliftonville,9801,5,10,4,12,34,32,2,34
Ballymena,9801,6,7,5,14,26,48,-22,26
Glentoran,9801,7,6,6,10,24,32,-8,24
Dungannon,9801,8,2,4,16,14,47,-33,10
Crusaders,9802,1,17,6,3,62,30,32,57
Coleraine,9802,2,14,10,2,44,25,19,52
Glenavon,9802,3,10,9,7,55,44,11,39
Linfield,9802,4,10,6,10,40,39,1,36
Cliftonville,9802,5,9,5,12,35,34,1,32
Ballymena,9802,6,7,4,15,25,48,-23,25
Glentoran,9802,7,6,6,10,24,32,-8,24
Dungannon,9802,8,2,4,16,14,47,-33,10
Crusaders,9803,1,17,6,3,64,31,33,57
Coleraine,9803,2,15,10,1,48,23,25,55
Glenavon,9803,3,9,9,8,53,48,5,36
Linfield,9803,4,10,5,11,37,37,0,35
Cliftonville,9803,5,10,4,12,33,31,2,34
Ballymena,9803,6,7,4,15,26,50,-24,25
Glentoran,9803,7,6,6,10,24,32,-8,24
Dungannon,9803,8,2,4,16,14,47,-33,10
Crusaders,9804,1,17,6,3,65,31,34,57
Coleraine,9804,2,14,10,2,43,23,20,52
Glenavon,9804,3,10,9,7,53,43,10,39
Linfield,9804,4,11,5,10,40,37,3,38
Cliftonville,9804,5,9,4,13,33,34,-1,31
Ballymena,9804,6,7,4,15,26,51,-25,25
Glentoran,9804,7,6,6,10,24,32,-8,24
Dungannon,9804,8,2,4,16,14,47,-33,10
Crusaders,9805,1,17,6,3,62,30,32,57
Coleraine,9805,2,15,10,1,46,24,22,55
Glenavon,9805,3,9,9,8,54,46,8,36
Linfield,9805,4,10,5,11,37,37,0,35
Cliftonville,9805,5,10,4,12,33,31,2,34
Ballymena,9805,6,7,4,15,25,48,-23,25
Glentoran,9805,7,6,6,10,24,32,-8,24
Dungannon,9805,8,2,4,16,14,47,-33,10
Coleraine,9806,1,15,10,1,45,23,22,55
Crusaders,9806,2,16,6,4,64,35,29,54
Glenavon,9806,3,9,9,8,53,45,8,36
Linfield,9806,4,10,5,11,37,37,0,35
Cliftonville,9806,5,10,4,12,33,31,2,34
Ballymena,9806,6,8,4,14,30,50,-20,28
Glentoran,9806,7,6,6,10,24,32,-8,24
Dungannon,9806,8,2,4,16,14,47,-33,10
Crusaders,9807,1,16,6,4,62,33,29,54
Coleraine,9807,2,14,10,2,44,24,20,52
Glenavon,9807,3,10,9,7,54,44,10,39
Linfield,9807,4,11,5,10,39,36,3,38
Cliftonville,9807,5,9,4,13,32,33,-1,31
Ballymena,9807,6,8,4,14,28,48,-20,28
Glentoran,9807,7,6,6,10,24,32,-8,24
Dungannon,9807,8,2,4,16,14,47,-33,10
Coleraine,9808,1,15,10,1,45,22,23,55
Crusaders,9808,2,16,6,4,63,33,30,54
Linfield,9808,3,11,5,10,41,37,4,38
Glenavon,9808,4,9,9,8,52,45,7,36
Cliftonville,9808,5,9,4,13,33,35,-2,31
Ballymena,9808,6,8,4,14,28,49,-21,28
Glentoran,9808,7,6,6,10,24,32,-8,24
Dungannon,9808,8,2,4,16,14,47,-33,10
Crusaders,9809,1,17,6,3,64,31,33,57
Coleraine,9809,2,14,10,2,43,24,19,52
Glenavon,9809,3,10,9,7,54,43,11,39
Linfield,9809,4,11,5,10,39,37,2,38
Cliftonville,9809,5,9,4,13,33,33,0,31
Ballymena,9809,6,7,4,15,26,50,-24,25
Glentoran,9809,7,6,6,10,24,32,-8,24
Dungannon,9809,8,2,4,16,14,47,-33,10
Crusaders,9810,1,17,6,3,63,30,33,57
Coleraine,9810,2,14,11,1,46,25,21,53
Linfield,9810,3,11,5,10,38,36,2,38
Glenavon,9810,4,9,10,7,55,46,9,37
Cliftonville,9810,5,9,4,13,32,32,0,31
Ballymena,9810,6,7,4,15,25,49,-24,25
Glentoran,9810,7,6,6,10,24,32,-8,24
Dungannon,9810,8,2,4,16,14,47,-33,10
Crusaders,9811,1,17,6,3,62,30,32,57
Coleraine,9811,2,15,10,1,44,22,22,55
Glenavon,9811,3,9,9,8,52,44,8,36
Linfield,9811,4,10,6,10,37,36,1,36
Cliftonville,9811,5,9,5,12,32,31,1,32
Ballymena,9811,6,7,4,15,25,48,-23,25
Glentoran,9811,7,6,6,10,24,32,-8,24
Dungannon,9811,8,2,4,16,14,47,-33,10
Crusaders,9812,1,16,7,3,62,31,31,55
Coleraine,9812,2,15,10,1,48,24,24,55
Linfield,9812,3,11,5,10,39,36,3,38
Glenavon,9812,4,9,9,8,54,48,6,36
Cliftonville,9812,5,9,4,13,32,33,-1,31
Ballymena,9812,6,7,5,14,26,48,-22,26
Glentoran,9812,7,6,6,10,24,32,-8,24
Dungannon,9812,8,2,4,16,14,47,-33,10
Crusaders,9813,1,17,6,3,62,30,32,57
Coleraine,9813,2,14,11,1,45,24,21,53
Linfield,9813,3,11,5,10,39,36,3,38
Glenavon,9813,4,9,10,7,54,45,9,37
Cliftonville,9813,5,9,4,13,32,33,-1,31
Ballymena,9813,6,7,4,15,25,48,-23,25
Glentoran,9813,7,6,6,10,24,32,-8,24
Dungannon,9813,8,2,4,16,14,47,-33,10
Crusaders,9814,1,17,6,3,64,31,33,57
Coleraine,9814,2,14,11,1,44,23,21,53
Linfield,9814,3,11,5,10,39,36,3,38
Glenavon,9814,4,9,10,7,53,44,9,37
Cliftonville,9814,5,9,4,13,32,33,-1,31
Ballymena,9814,6,7,4,15,26,50,-24,25
Glentoran,9814,7,6,6,10,24,32,-8,24
Dungannon,9814,8,2,4,16,14,47,-33,10
Crusaders,9815,1,16,6,4,61,34,27,54
Coleraine,9815,2,14,11,1,45,24,21,53
Glenavon,9815,3,9,10,7,54,45,9,37
Linfield,9815,4,10,5,11,37,37,0,35
Cliftonville,9815,5,10,4,12,33,31,2,34
Ballymena,9815,6,8,4,14,29,47,-18,28
Glentoran,9815,7,6,6,10,24,32,-8,24
Dungannon,9815,8,2,4,16,14,47,-33,10
Crusaders,9816,1,17,6,3,64,32,32,57
Coleraine,9816,2,14,10,2,44,24,20,52
Glenavon,9816,3,10,9,7,54,44,10,39
Linfield,9816,4,10,5,11,37,37,0,35
Cliftonville,9816,5,10,4,12,33,31,2,34
Ballymena,9816,6,7,4,15,27,50,-23,25
Glentoran,9816,7,6,6,10,24,32,-8,24
Dungannon,9816,8,2,4,16,14,47,-33,10
Crusaders,9817,1,16,7,3,61,30,31,55
Coleraine,9817,2,14,10,2,44,25,19,52
Glenavon,9817,3,10,9,7,55,44,11,39
Linfield,9817,4,11,5,10,38,36,2,38
Cliftonville,9817,5,9,4,13,32,32,0,31
Ballymena,9817,6,7,5,14,25,47,-22,26
Glentoran,9817,7,6,6,10,24,32,-8,24
Dungannon,9817,8,2,4,16,14,47,-33,10
Crusaders,9818,1,17,6,3,64,31,33,57
Coleraine,9818,2,14,11,1,43,22,21,53
Glenavon,9818,3,9,10,7,52,43,9,37
Linfield,9818,4,10,6,10,37,36,1,36
Cliftonville,9818,5,9,5,12,32,31,1,32
Ballymena,9818,6,7,4,15,26,50,-24,25
Glentoran,9818,7,6,6,10,24,32,-8,24
Dungannon,9818,8,2,4,16,14,47,-33,10
Crusaders,9819,1,17,6,3,63,31,32,57
Coleraine,9819,2,14,11,1,44,23,21,53
Glenavon,9819,3,9,10,7,53,44,9,37
Linfield,9819,4,10,6,10,37,36,1,36
Cliftonville,9819,5,9,5,12,32,31,1,32
Ballymena,9819,6,7,4,15,26,49,-23,25
Glentoran,9819,7,6,6,10,24,32,-8,24
Dungannon,9819,8,2,4,16,14,47,-33,10
Crusaders,9820,1,17,6,3,64,30,34,57
Coleraine,9820,2,14,10,2,43,25,18,52
Glenavon,9820,3,10,9,7,55,43,12,39
Linfield,9820,4,11,5,10,38,36,2,38
Cliftonville,9820,5,9,4,13,32,32,0,31
Ballymena,9820,6,7,4,15,25,50,-25,25
Glentoran,9820,7,6,6,10,24,32,-8,24
Dungannon,9820,8,2,4,16,14,47,-33,10
Crusaders,9821,1,16,7,3,62,31,31,55
Coleraine,9821,2,14,10,2,44,26,18,52
Glenavon,9821,3,10,9,7,56,44,12,39
Linfield,9821,4,10,5,11,37,37,0,35
Cliftonville,9821,5,10,4,12,33,31,2,34
Ballymena,9821,6,7,5,14,26,48,-22,26
Glentoran,9821,7,6,6,10,24,32,-8,24
Dungannon,9821,8,2,4,16,14,47,-33,10
Crusaders,9822,1,17,6,3,65,32,33,57
Coleraine,9822,2,14,11,1,44,23,21,53
Glenavon,9822,3,9,10,7,53,44,9,37
Linfield,9822,4,10,6,10,38,37,1,36
Cliftonville,9822,5,9,5,12,33,32,1,32
Ballymena,9822,6,7,4,15,27,51,-24,25
Glentoran,9822,7,6,6,10,24,32,-8,24
Dungannon,9822,8,2,4,16,14,47,-33,10
Crusaders,9823,1,17,6,3,64,32,32,57
Coleraine,9823,2,14,10,2,44,26,18,52
Glenavon,9823,3,10,9,7,56,44,12,39
Linfield,9823,4,10,6,10,38,37,1,36
Cliftonville,9823,5,9,5,12,33,32,1,32
Ballymena,9823,6,7,4,15,27,50,-23,25
Glentoran,9823,7,6,6,10,24,32,-8,24
Dungannon,9823,8,2,4,16,14,47,-33,10
Crusaders,9824,1,16,6,4,61,31,30,54
Coleraine,9824,2,14,10,2,45,25,20,52
Glenavon,9824,3,10,9,7,55,45,10,39
Linfield,9824,4,10,6,10,38,37,1,36
Cliftonville,9824,5,9,5,12,33,32,1,32
Ballymena,9824,6,8,4,14,26,47,-21,28
Glentoran,9824,7,6,6,10,24,32,-8,24
Dungannon,9824,8,2,4,16,14,47,-33,10
Crusaders,9825,1,16,6,4,61,31,30,54
Coleraine,9825,2,14,11,1,46,25,21,53
Glenavon,9825,3,9,10,7,55,46,9,37
Linfield,9825,4,10,6,10,39,38,1,36
Cliftonville,9825,5,9,5,12,34,33,1,32
Ballymena,9825,6,8,4,14,26,47,-21,28
Glentoran,9825,7,6,6,10,24,32,-8,24
Dungannon,9825,8,2,4,16,14,47,-33,10
Crusaders,9826,1,17,6,3,63,31,32,57
Coleraine,9826,2,14,10,2,43,23,20,52
Glenavon,9826,3,10,9,7,53,43,10,39
Linfield,9826,4,11,5,10,39,36,3,38
Cliftonville,9826,5,9,4,13,32,33,-1,31
Ballymena,9826,6,7,4,15,26,49,-23,25
Glentoran,9826,7,6,6,10,24,32,-8,24
Dungannon,9826,8,2,4,16,14,47,-33,10
Crusaders,9827,1,17,6,3,64,31,33,57
Coleraine,9827,2,14,10,2,43,27,16,52
Glenavon,9827,3,10,9,7,57,43,14,39
Linfield,9827,4,11,5,10,39,36,3,38
Cliftonville,9827,5,9,4,13,32,33,-1,31
Ballymena,9827,6,7,4,15,26,50,-24,25
Glentoran,9827,7,6,6,10,24,32,-8,24
Dungannon,9827,8,2,4,16,14,47,-33,10
Crusaders,9828,1,17,6,3,66,32,34,57
Coleraine,9828,2,14,10,2,45,27,18,52
Glenavon,9828,3,10,9,7,57,45,12,39
Linfield,9828,4,10,6,10,38,37,1,36
Cliftonville,9828,5,9,5,12,33,32,1,32
Ballymena,9828,6,7,4,15,27,52,-25,25
Glentoran,9828,7,6,6,10,24,32,-8,24
Dungannon,9828,8,2,4,16,14,47,-33,10
Crusaders,9829,1,17,6,3,63,31,32,57
Coleraine,9829,2,15,10,1,45,22,23,55
Glenavon,9829,3,9,9,8,52,45,7,36
Linfield,9829,4,10,6,10,38,37,1,36
Cliftonville,9829,5,9,5,12,33,32,1,32
Ballymena,9829,6,7,4,15,26,49,-23,25
Glentoran,9829,7,6,6,10,24,32,-8,24
Dungannon,9829,8,2,4,16,14,47,-33,10
Crusaders,9830,1,17,6,3,64,31,33,57
Coleraine,9830,2,14,10,2,44,24,20,52
Glenavon,9830,3,10,9,7,54,44,10,39
Linfield,9830,4,11,5,10,39,37,2,38
Cliftonville,9830,5,9,4,13,33,33,0,31
Ballymena,9830,6,7,4,15,26,50,-24,25
Glentoran,9830,7,6,6,10,24,32,-8,24
Dungannon,9830,8,2,4,16,14,47,-33,10
Crusaders,9831,1,17,6,3,63,30,33,57
Coleraine,9831,2,14,11,1,45,24,21,53
Glenavon,9831,3,9,10,7,54,45,9,37
Linfield,9831,4,10,5,11,39,39,0,35
Cliftonville,9831,5,10,4,12,35,33,2,34
Ballymena,9831,6,7,4,15,25,49,-24,25
Glentoran,9831,7,6,6,10,24,32,-8,24
Dungannon,9831,8,2,4,16,14,47,-33,10
Crusaders,9832,1,17,6,3,64,32,32,57
Coleraine,9832,2,14,11,1,45,24,21,53
Linfield,9832,3,11,5,10,39,37,2,38
Glenavon,9832,4,9,10,7,54,45,9,37
Cliftonville,9832,5,9,4,13,33,33,0,31
Ballymena,9832,6,7,4,15,27,50,-23,25
Glentoran,9832,7,6,6,10,24,32,-8,24
Dungannon,9832,8,2,4,16,14,47,-33,10
Crusaders,9833,1,17,6,3,63,30,33,57
Coleraine,9833,2,15,10,1,46,23,23,55
Linfield,9833,3,11,5,10,39,37,2,38
Glenavon,9833,4,9,9,8,53,46,7,36
Cliftonville,9833,5,9,4,13,33,33,0,31
Ballymena,9833,6,7,4,15,25,49,-24,25
Glentoran,9833,7,6,6,10,24,32,-8,24
Dungannon,9833,8,2,4,16,14,47,-33,10
Crusaders,9834,1,17,6,3,67,33,34,57
Coleraine,9834,2,14,11,1,44,23,21,53
Linfield,9834,3,11,5,10,38,36,2,38
Glenavon,9834,4,9,10,7,53,44,9,37
Cliftonville,9834,5,9,4,13,32,32,0,31
Ballymena,9834,6,7,4,15,28,53,-25,25
Glentoran,9834,7,6,6,10,24,32,-8,24
Dungannon,9834,8,2,4,16,14,47,-33,10
Crusaders,9835,1,17,6,3,63,30,33,57
Coleraine,9835,2,14,11,1,44,23,21,53
Linfield,9835,3,11,5,10,38,36,2,38
Glenavon,9835,4,9,10,7,53,44,9,37
Cliftonville,9835,5,9,4,13,32,32,0,31
Ballymena,9835,6,7,4,15,25,49,-24,25
Glentoran,9835,7,6,6,10,24,32,-8,24
Dungannon,9835,8,2,4,16,14,47,-33,10
Crusaders,9836,1,17,6,3,63,31,32,57
Coleraine,9836,2,15,10,1,46,22,24,55
Linfield,9836,3,11,5,10,38,36,2,38
Glenavon,9836,4,9,9,8,52,46,6,36
Cliftonville,9836,5,9,4,13,32,32,0,31
Ballymena,9836,6,7,4,15,26,49,-23,25
Glentoran,9836,7,6,6,10,24,32,-8,24
Dungannon,9836,8,2,4,16,14,47,-33,10
Crusaders,9837,1,17,6,3,62,30,32,57
Coleraine,9837,2,14,10,2,44,24,20,52
Glenavon,9837,3,10,9,7,54,44,10,39
Linfield,9837,4,11,5,10,39,37,2,38
Cliftonville,9837,5,9,4,13,33,33,0,31
Ballymena,9837,6,7,4,15,25,48,-23,25
Glentoran,9837,7,6,6,10,24,32,-8,24
Dungannon,9837,8,2,4,16,14,47,-33,10
Crusaders,9838,1,17,6,3,62,30,32,57
Coleraine,9838,2,14,11,1,44,23,21,53
Glenavon,9838,3,9,10,7,53,44,9,37
Linfield,9838,4,10,6,10,39,38,1,36
Cliftonville,9838,5,9,5,12,34,33,1,32
Ballymena,9838,6,7,4,15,25,48,-23,25
Glentoran,9838,7,6,6,10,24,32,-8,24
Dungannon,9838,8,2,4,16,14,47,-33,10
Crusaders,9839,1,17,6,3,65,31,34,57
Coleraine,9839,2,14,10,2,43,25,18,52
Glenavon,9839,3,10,9,7,55,43,12,39
Linfield,9839,4,10,5,11,37,37,0,35
Cliftonville,9839,5,10,4,12,33,31,2,34
Ballymena,9839,6,7,4,15,26,51,-25,25
Glentoran,9839,7,6,6,10,24,32,-8,24
Dungannon,9839,8,2,4,16,14,47,-33,10
Crusaders,9840,1,17,6,3,65,33,32,57
Coleraine,9840,2,15,10,1,45,23,22,55
Linfield,9840,3,11,5,10,40,37,3,38
Glenavon,9840,4,9,9,8,53,45,8,36
Cliftonville,9840,5,9,4,13,33,34,-1,31
Ballymena,9840,6,7,4,15,28,51,-23,25
Glentoran,9840,7,6,6,10,24,32,-8,24
Dungannon,9840,8,2,4,16,14,47,-33,10
Crusaders,9841,1,17,6,3,65,31,34,57
Coleraine,9841,2,14,10,2,43,25,18,52
Glenavon,9841,3,10,9,7,55,43,12,39
Linfield,9841,4,11,5,10,38,36,2,38
Cliftonville,9841,5,9,4,13,32,32,0,31
Ballymena,9841,6,7,4,15,26,51,-25,25
Glentoran,9841,7,6,6,10,24,32,-8,24
Dungannon,9841,8,2,4,16,14,47,-33,10
Crusaders,9842,1,17,6,3,64,31,33,57
Coleraine,9842,2,14,11,1,43,22,21,53
Glenavon,9842,3,9,10,7,52,43,9,37
Linfield,9842,4,10,6,10,38,37,1,36
Cliftonville,9842,5,9,5,12,33,32,1,32
Ballymena,9842,6,7,4,15,26,50,-24,25
Glentoran,9842,7,6,6,10,24,32,-8,24
Dungannon,9842,8,2,4,16,14,47,-33,10
Crusaders,9843,1,17,6,3,64,31,33,57
Coleraine,9843,2,14,11,1,44,23,21,53
Glenavon,9843,3,9,10,7,53,44,9,37
Linfield,9843,4,10,5,11,38,38,0,35
Cliftonville,9843,5,10,4,12,34,32,2,34
Ballymena,9843,6,7,4,15,26,50,-24,25
Glentoran,9843,7,6,6,10,24,32,-8,24
Dungannon,9843,8,2,4,16,14,47,-33,10
Crusaders,9844,1,16,7,3,62,31,31,55
Coleraine,9844,2,14,10,2,44,24,20,52
Glenavon,9844,3,10,9,7,54,44,10,39
Linfield,9844,4,10,5,11,38,38,0,35
Cliftonville,9844,5,10,4,12,34,32,2,34
Ballymena,9844,6,7,5,14,26,48,-22,26
Glentoran,9844,7,6,6,10,24,32,-8,24
Dungannon,9844,8,2,4,16,14,47,-33,10
Crusaders,9845,1,17,6,3,63,30,33,57
Coleraine,9845,2,14,10,2,43,24,19,52
Glenavon,9845,3,10,9,7,54,43,11,39
Linfield,9845,4,11,5,10,38,36,2,38
Cliftonville,9845,5,9,4,13,32,32,0,31
Ballymena,9845,6,7,4,15,25,49,-24,25
Glentoran,9845,7,6,6,10,24,32,-8,24
Dungannon,9845,8,2,4,16,14,47,-33,10
Crusaders,9846,1,17,6,3,63,31,32,57
Coleraine,9846,2,14,10,2,45,25,20,52
Glenavon,9846,3,10,9,7,55,45,10,39
Linfield,9846,4,10,6,10,38,37,1,36
Cliftonville,9846,5,9,5,12,33,32,1,32
Ballymena,9846,6,7,4,15,26,49,-23,25
Glentoran,9846,7,6,6,10,24,32,-8,24
Dungannon,9846,8,2,4,16,14,47,-33,10
Crusaders,9847,1,16,6,4,62,32,30,54
Coleraine,9847,2,14,11,1,44,23,21,53
Linfield,9847,3,11,5,10,38,36,2,38
Glenavon,9847,4,9,10,7,53,44,9,37
Cliftonville,9847,5,9,4,13,32,32,0,31
Ballymena,9847,6,8,4,14,27,48,-21,28
Glentoran,9847,7,6,6,10,24,32,-8,24
Dungannon,9847,8,2,4,16,14,47,-33,10
Crusaders,9848,1,17,6,3,63,30,33,57
Coleraine,9848,2,15,10,1,44,22,22,55
Glenavon,9848,3,9,9,8,52,44,8,36
Linfield,9848,4,10,6,10,39,38,1,36
Cliftonville,9848,5,9,5,12,34,33,1,32
Ballymena,9848,6,7,4,15,25,49,-24,25
Glentoran,9848,7,6,6,10,24,32,-8,24
Dungannon,9848,8,2,4,16,14,47,-33,10
Coleraine,9849,1,15,10,1,45,23,22,55
Crusaders,9849,2,16,6,4,61,35,26,54
Glenavon,9849,3,9,9,8,53,45,8,36
Linfield,9849,4,10,6,10,39,38,1,36
Cliftonville,9849,5,9,5,12,34,33,1,32
Ballymena,9849,6,8,4,14,30,47,-17,28
Glentoran,9849,7,6,6,10,24,32,-8,24
Dungannon,9849,8,2,4,16,14,47,-33,10
Crusaders,9850,1,17,6,3,65,30,35,57
Coleraine,9850,2,15,10,1,47,24,23,55
Glenavon,9850,3,9,9,8,54,47,7,36
Linfield,9850,4,10,5,11,38,39,-1,35
Cliftonville,9850,5,10,4,12,35,32,3,34
Ballymena,9850,6,7,4,15,25,51,-26,25
Glentoran,9850,7,6,6,10,24,32,-8,24
Dungannon,9850,8,2,4,16,14,47,-33,10
Crusaders,9851,1,17,6,3,65,30,35,57
Coleraine,9851,2,14,10,2,44,25,19,52
Glenavon,9851,3,10,9,7,55,44,11,39
Linfield,9851,4,11,5,10,38,36,2,38
Cliftonville,9851,5,9,4,13,32,32,0,31
Ballymena,9851,6,7,4,15,25,51,-26,25
Glentoran,9851,7,6,6,10,24,32,-8,24
Dungannon,9851,8,2,4,16,14,47,-33,10
Coleraine,9852,1,15,10,1,46,22,24,55
Crusaders,9852,2,16,6,4,61,31,30,54
Linfield,9852,3,11,5,10,39,37,2,38
Glenavon,9852,4,9,9,8,52,46,6,36
Cliftonville,9852,5,9,4,13,33,33,0,31
Ballymena,9852,6,8,4,14,26,47,-21,28
Glentoran,9852,7,6,6,10,24,32,-8,24
Dungannon,9852,8,2,4,16,14,47,-33,10
Crusaders,9853,1,17,6,3,63,31,32,57
Coleraine,9853,2,14,11,1,43,22,21,53
Glenavon,9853,3,9,10,7,52,43,9,37
Linfield,9853,4,10,5,11,37,38,-1,35
Cliftonville,9853,5,10,4,12,34,31,3,34
Ballymena,9853,6,7,4,15,26,49,-23,25
Glentoran,9853,7,6,6,10,24,32,-8,24
Dungannon,9853,8,2,4,16,14,47,-33,10
Crusaders,9854,1,17,6,3,64,31,33,57
Coleraine,9854,2,14,10,2,45,25,20,52
Glenavon,9854,3,10,9,7,55,45,10,39
Linfield,9854,4,11,5,10,38,36,2,38
Cliftonville,9854,5,9,4,13,32,32,0,31
Ballymena,9854,6,7,4,15,26,50,-24,25
Glentoran,9854,7,6,6,10,24,32,-8,24
Dungannon,9854,8,2,4,16,14,47,-33,10
Crusaders,9855,1,16,6,4,61,33,28,54
Coleraine,9855,2,14,10,2,44,29,15,52
Glenavon,9855,3,10,9,7,59,44,15,39
Linfield,9855,4,10,5,11,37,37,0,35
Cliftonville,9855,5,10,4,12,33,31,2,34
Ballymena,9855,6,8,4,14,28,47,-19,28
Glentoran,9855,7,6,6,10,24,32,-8,24
Dungannon,9855,8,2,4,16,14,47,-33,10
Crusaders,9856,1,16,7,3,62,31,31,55
Coleraine,9856,2,14,10,2,44,24,20,52
Glenavon,9856,3,10,9,7,54,44,10,39
Linfield,9856,4,10,6,10,38,37,1,36
Cliftonville,9856,5,9,5,12,33,32,1,32
Ballymena,9856,6,7,5,14,26,48,-22,26
Glentoran,9856,7,6,6,10,24,32,-8,24
Dungannon,9856,8,2,4,16,14,47,-33,10
Crusaders,9857,1,16,6,4,61,31,30,54
Coleraine,9857,2,14,10,2,44,24,20,52
Glenavon,9857,3,10,9,7,54,44,10,39
Linfield,9857,4,10,6,10,38,37,1,36
Cliftonville,9857,5,9,5,12,33,32,1,32
Ballymena,9857,6,8,4,14,26,47,-21,28
Glentoran,9857,7,6,6,10,24,32,-8,24
Dungannon,9857,8,2,4,16,14,47,-33,10
Crusaders,9858,1,17,6,3,64,31,33,57
Coleraine,9858,2,15,10,1,45,23,22,55
Linfield,9858,3,11,5,10,39,37,2,38
Glenavon,9858,4,9,9,8,53,45,8,36
Cliftonville,9858,5,9,4,13,33,33,0,31
Ballymena,9858,6,7,4,15,26,50,-24,25
Glentoran,9858,7,6,6,10,24,32,-8,24
Dungannon,9858,8,2,4,16,14,47,-33,10
Crusaders,9859,1,16,6,4,63,33,30,54
Coleraine,9859,2,14,10,2,43,23,20,52
Glenavon,9859,3,10,9,7,53,43,10,39
Linfield,9859,4,11,5,10,38,36,2,38
Cliftonville,9859,5,9,4,13,32,32,0,31
Ballymena,9859,6,8,4,14,28,49,-21,28
Glentoran,9859,7,6,6,10,24,32,-8,24
Dungannon,9859,8,2,4,16,14,47,-33,10
Coleraine,9860,1,15,10,1,48,23,25,55
Crusaders,9860,2,16,6,4,61,31,30,54
Linfield,9860,3,11,5,10,39,36,3,38
Glenavon,9860,4,9,9,8,53,48,5,36
Cliftonville,9860,5,9,4,13,32,33,-1,31
Ballymena,9860,6,8,4,14,26,47,-21,28
Glentoran,9860,7,6,6,10,24,32,-8,24
Dungannon,9860,8,2,4,16,14,47,-33,10
Crusaders,9861,1,16,6,4,62,33,29,54
Coleraine,9861,2,14,11,1,44,23,21,53
Linfield,9861,3,11,5,10,38,36,2,38
Glenavon,9861,4,9,10,7,53,44,9,37
Cliftonville,9861,5,9,4,13,32,32,0,31
Ballymena,9861,6,8,4,14,28,48,-20,28
Glentoran,9861,7,6,6,10,24,32,-8,24
Dungannon,9861,8,2,4,16,14,47,-33,10
Crusaders,9862,1,17,6,3,62,30,32,57
Coleraine,9862,2,15,10,1,46,23,23,55
Linfield,9862,3,11,5,10,39,36,3,38
Glenavon,9862,4,9,9,8,53,46,7,36
Cliftonville,9862,5,9,4,13,32,33,-1,31
Ballymena,9862,6,7,4,15,25,48,-23,25
Glentoran,9862,7,6,6,10,24,32,-8,24
Dungannon,9862,8,2,4,16,14,47,-33,10
Crusaders,9863,1,17,6,3,65,30,35,57
Coleraine,9863,2,14,11,1,44,23,21,53
Linfield,9863,3,11,5,10,40,37,3,38
Glenavon,9863,4,9,10,7,53,44,9,37
Cliftonville,9863,5,9,4,13,33,34,-1,31
Ballymena,9863,6,7,4,15,25,51,-26,25
Glentoran,9863,7,6,6,10,24,32,-8,24
Dungannon,9863,8,2,4,16,14,47,-33,10
Crusaders,9864,1,17,6,3,64,32,32,57
Coleraine,9864,2,15,10,1,45,22,23,55
Glenavon,9864,3,9,9,8,52,45,7,36
Linfield,9864,4,10,6,10,40,39,1,36
Cliftonville,9864,5,9,5,12,35,34,1,32
Ballymena,9864,6,7,4,15,27,50,-23,25
Glentoran,9864,7,6,6,10,24,32,-8,24
Dungannon,9864,8,2,4,16,14,47,-33,10
Coleraine,9865,1,15,10,1,46,24,22,55
Crusaders,9865,2,16,6,4,61,31,30,54
Glenavon,9865,3,9,9,8,54,46,8,36
Linfield,9865,4,10,5,11,37,39,-2,35
Cliftonville,9865,5,10,4,12,35,31,4,34
Ballymena,9865,6,8,4,14,26,47,-21,28
Glentoran,9865,7,6,6,10,24,32,-8,24
Dungannon,9865,8,2,4,16,14,47,-33,10
Crusaders,9866,1,17,6,3,65,33,32,57
Coleraine,9866,2,14,10,2,43,26,17,52
Glenavon,9866,3,10,9,7,56,43,13,39
Linfield,9866,4,11,5,10,38,36,2,38
Cliftonville,9866,5,9,4,13,32,32,0,31
Ballymena,9866,6,7,4,15,28,51,-23,25
Glentoran,9866,7,6,6,10,24,32,-8,24
Dungannon,9866,8,2,4,16,14,47,-33,10
Crusaders,9867,1,17,6,3,67,30,37,57
Coleraine,9867,2,15,10,1,45,23,22,55
Glenavon,9867,3,9,9,8,53,45,8,36
Linfield,9867,4,10,6,10,39,38,1,36
Cliftonville,9867,5,9,5,12,34,33,1,32
Ballymena,9867,6,7,4,15,25,53,-28,25
Glentoran,9867,7,6,6,10,24,32,-8,24
Dungannon,9867,8,2,4,16,14,47,-33,10
Crusaders,9868,1,16,6,4,63,33,30,54
Coleraine,9868,2,14,10,2,45,26,19,52
Glenavon,9868,3,10,9,7,56,45,11,39
Linfield,9868,4,10,5,11,37,37,0,35
Cliftonville,9868,5,10,4,12,33,31,2,34
Ballymena,9868,6,8,4,14,28,49,-21,28
Glentoran,9868,7,6,6,10,24,32,-8,24
Dungannon,9868,8,2,4,16,14,47,-33,10
Crusaders,9869,1,16,7,3,62,31,31,55
Coleraine,9869,2,15,10,1,45,23,22,55
Glenavon,9869,3,9,9,8,53,45,8,36
Linfield,9869,4,10,5,11,37,37,0,35
Cliftonville,9869,5,10,4,12,33,31,2,34
Ballymena,9869,6,7,5,14,26,48,-22,26
Glentoran,9869,7,6,6,10,24,32,-8,24
Dungannon,9869,8,2,4,16,14,47,-33,10
Crusaders,9870,1,17,6,3,62,30,32,57
Coleraine,9870,2,14,11,1,44,23,21,53
Linfield,9870,3,11,5,10,39,37,2,38
Glenavon,9870,4,9,10,7,53,44,9,37
Cliftonville,9870,5,9,4,13,33,33,0,31
Ballymena,9870,6,7,4,15,25,48,-23,25
Glentoran,9870,7,6,6,10,24,32,-8,24
Dungannon,9870,8,2,4,16,14,47,-33,10
Crusaders,9871,1,17,6,3,62,30,32,57
Coleraine,9871,2,14,10,2,43,27,16,52
Glenavon,9871,3,10,9,7,57,43,14,39
Linfield,9871,4,10,5,11,37,38,-1,35
Cliftonville,9871,5,10,4,12,34,31,3,34
Ballymena,9871,6,7,4,15,25,48,-23,25
Glentoran,9871,7,6,6,10,24,32,-8,24
Dungannon,9871,8,2,4,16,14,47,-33,10
Crusaders,9872,1,16,7,3,64,33,31,55
Coleraine,9872,2,14,11,1,45,24,21,53
Linfield,9872,3,11,5,10,39,36,3,38
Glenavon,9872,4,9,10,7,54,45,9,37
Cliftonville,9872,5,9,4,13,32,33,-1,31
Ballymena,9872,6,7,5,14,28,50,-22,26
Glentoran,9872,7,6,6,10,24,32,-8,24
Dungannon,9872,8,2,4,16,14,47,-33,10
Crusaders,9873,1,17,6,3,63,30,33,57
Coleraine,9873,2,14,11,1,46,25,21,53
Linfield,9873,3,11,5,10,39,37,2,38
Glenavon,9873,4,9,10,7,55,46,9,37
Cliftonville,9873,5,9,4,13,33,33,0,31
Ballymena,9873,6,7,4,15,25,49,-24,25
Glentoran,9873,7,6,6,10,24,32,-8,24
Dungannon,9873,8,2,4,16,14,47,-33,10
Crusaders,9874,1,16,6,4,63,36,27,54
Coleraine,9874,2,14,10,2,44,24,20,52
Glenavon,9874,3,10,9,7,54,44,10,39
Linfield,9874,4,10,6,10,38,37,1,36
Cliftonville,9874,5,9,5,12,33,32,1,32
Ballymena,9874,6,8,4,14,31,49,-18,28
Glentoran,9874,7,6,6,10,24,32,-8,24
Dungannon,9874,8,2,4,16,14,47,-33,10
Crusaders,9875,1,16,7,3,62,31,31,55
Coleraine,9875,2,14,10,2,43,24,19,52
Glenavon,9875,3,10,9,7,54,43,11,39
Linfield,9875,4,11,5,10,39,36,3,38
Cliftonville,9875,5,9,4,13,32,33,-1,31
Ballymena,9875,6,7,5,14,26,48,-22,26
Glentoran,9875,7,6,6,10,24,32,-8,24
Dungannon,9875,8,2,4,16,14,47,-33,10
Crusaders,9876,1,17,6,3,65,30,35,57
Coleraine,9876,2,15,10,1,44,22,22,55
Linfield,9876,3,11,5,10,41,36,5,38
Glenavon,9876,4,9,9,8,52,44,8,36
Cliftonville,9876,5,9,4,13,32,35,-3,31
Ballymena,9876,6,7,4,15,25,51,-26,25
Glentoran,9876,7,6,6,10,24,32,-8,24
Dungannon,9876,8,2,4,16,14,47,-33,10
Crusaders,9877,1,16,6,4,61,32,29,54
Coleraine,9877,2,14,11,1,45,24,21,53
Linfield,9877,3,11,5,10,40,37,3,38
Glenavon,9877,4,9,10,7,54,45,9,37
Cliftonville,9877,5,9,4,13,33,34,-1,31
Ballymena,9877,6,8,4,14,27,47,-20,28
Glentoran,9877,7,6,6,10,24,32,-8,24
Dungannon,9877,8,2,4,16,14,47,-33,10
Crusaders,9878,1,17,6,3,62,30,32,57
Coleraine,9878,2,14,10,2,44,24,20,52
Glenavon,9878,3,10,9,7,54,44,10,39
Linfield,9878,4,10,6,10,38,37,1,36
Cliftonville,9878,5,9,5,12,33,32,1,32
Ballymena,9878,6,7,4,15,25,48,-23,25
Glentoran,9878,7,6,6,10,24,32,-8,24
Dungannon,9878,8,2,4,16,14,47,-33,10
Crusaders,9879,1,17,6,3,64,31,33,57
Coleraine,9879,2,15,10,1,44,22,22,55
Glenavon,9879,3,9,9,8,52,44,8,36
Linfield,9879,4,10,5,11,37,37,0,35
Cliftonville,9879,5,10,4,12,33,31,2,34
Ballymena,9879,6,7,4,15,26,50,-24,25
Glentoran,9879,7,6,6,10,24,32,-8,24
Dungannon,9879,8,2,4,16,14,47,-33,10
Crusaders,9880,1,16,7,3,62,31,31,55
Coleraine,9880,2,14,11,1,45,24,21,53
Glenavon,9880,3,9,10,7,54,45,9,37
Linfield,9880,4,10,6,10,39,38,1,36
Cliftonville,9880,5,9,5,12,34,33,1,32
Ballymena,9880,6,7,5,14,26,48,-22,26
Glentoran,9880,7,6,6,10,24,32,-8,24
Dungannon,9880,8,2,4,16,14,47,-33,10
Crusaders,9881,1,17,6,3,63,30,33,57
Coleraine,9881,2,14,10,2,44,27,17,52
Glenavon,9881,3,10,9,7,57,44,13,39
Linfield,9881,4,10,5,11,38,39,-1,35
Cliftonville,9881,5,10,4,12,35,32,3,34
Ballymena,9881,6,7,4,15,25,49,-24,25
Glentoran,9881,7,6,6,10,24,32,-8,24
Dungannon,9881,8,2,4,16,14,47,-33,10
Crusaders,9882,1,16,6,4,62,34,28,54
Coleraine,9882,2,14,11,1,47,26,21,53
Linfield,9882,3,11,5,10,38,36,2,38
Glenavon,9882,4,9,10,7,56,47,9,37
Cliftonville,9882,5,9,4,13,32,32,0,31
Ballymena,9882,6,8,4,14,29,48,-19,28
Glentoran,9882,7,6,6,10,24,32,-8,24
Dungannon,9882,8,2,4,16,14,47,-33,10
Crusaders,9883,1,16,6,4,61,32,29,54
Coleraine,9883,2,14,10,2,45,25,20,52
Glenavon,9883,3,10,9,7,55,45,10,39
Linfield,9883,4,10,5,11,37,39,-2,35
Cliftonville,9883,5,10,4,12,35,31,4,34
Ballymena,9883,6,8,4,14,27,47,-20,28
Glentoran,9883,7,6,6,10,24,32,-8,24
Dungannon,9883,8,2,4,16,14,47,-33,10
Crusaders,9884,1,16,7,3,64,33,31,55
Coleraine,9884,2,14,10,2,44,24,20,52
Glenavon,9884,3,10,9,7,54,44,10,39
Linfield,9884,4,10,6,10,38,37,1,36
Cliftonville,9884,5,9,5,12,33,32,1,32
Ballymena,9884,6,7,5,14,28,50,-22,26
Glentoran,9884,7,6,6,10,24,32,-8,24
Dungannon,9884,8,2,4,16,14,47,-33,10
Crusaders,9885,1,17,6,3,64,31,33,57
Coleraine,9885,2,15,10,1,45,22,23,55
Glenavon,9885,3,9,9,8,52,45,7,36
Linfield,9885,4,10,5,11,40,40,0,35
Cliftonville,9885,5,10,4,12,36,34,2,34
Ballymena,9885,6,7,4,15,26,50,-24,25
Glentoran,9885,7,6,6,10,24,32,-8,24
Dungannon,9885,8,2,4,16,14,47,-33,10
Crusaders,9886,1,16,6,4,63,33,30,54
Coleraine,9886,2,14,11,1,43,22,21,53
Glenavon,9886,3,9,10,7,52,43,9,37
Linfield,9886,4,10,5,11,37,37,0,35
Cliftonville,9886,5,10,4,12,33,31,2,34
Ballymena,9886,6,8,4,14,28,49,-21,28
Glentoran,9886,7,6,6,10,24,32,-8,24
Dungannon,9886,8,2,4,16,14,47,-33,10
Crusaders,9887,1,17,6,3,66,33,33,57
Coleraine,9887,2,14,10,2,45,27,18,52
Glenavon,9887,3,10,9,7,57,45,12,39
Linfield,9887,4,11,5,10,39,37,2,38
Cliftonville,9887,5,9,4,13,33,33,0,31
Ballymena,9887,6,7,4,15,28,52,-24,25
Glentoran,9887,7,6,6,10,24,32,-8,24
Dungannon,9887,8,2,4,16,14,47,-33,10
Crusaders,9888,1,17,6,3,63,30,33,57
Coleraine,9888,2,15,10,1,46,23,23,55
Linfield,9888,3,11,5,10,39,36,3,38
Glenavon,9888,4,9,9,8,53,46,7,36
Cliftonville,9888,5,9,4,13,32,33,-1,31
Ballymena,9888,6,7,4,15,25,49,-24,25
Glentoran,9888,7,6,6,10,24,32,-8,24
Dungannon,9888,8,2,4,16,14,47,-33,10
Crusaders,9889,1,17,6,3,62,30,32,57
Coleraine,9889,2,15,10,1,45,22,23,55
Linfield,9889,3,11,5,10,40,38,2,38
Glenavon,9889,4,9,9,8,52,45,7,36
Cliftonville,9889,5,9,4,13,34,34,0,31
Ballymena,9889,6,7,4,15,25,48,-23,25
Glentoran,9889,7,6,6,10,24,32,-8,24
Dungannon,9889,8,2,4,16,14,47,-33,10
Crusaders,9890,1,16,7,3,62,31,31,55
Coleraine,9890,2,14,10,2,43,23,20,52
Glenavon,9890,3,10,9,7,53,43,10,39
Linfield,9890,4,10,6,10,37,36,1,36
Cliftonville,9890,5,9,5,12,32,31,1,32
Ballymena,9890,6,7,5,14,26,48,-22,26
Glentoran,9890,7,6,6,10,24,32,-8,24
Dungannon,9890,8,2,4,16,14,47,-33,10
Crusaders,9891,1,16,7,3,62,31,31,55
Coleraine,9891,2,14,10,2,44,24,20,52
Glenavon,9891,3,10,9,7,54,44,10,39
Linfield,9891,4,11,5,10,39,36,3,38
Cliftonville,9891,5,9,4,13,32,33,-1,31
Ballymena,9891,6,7,5,14,26,48,-22,26
Glentoran,9891,7,6,6,10,24,32,-8,24
Dungannon,9891,8,2,4,16,14,47,-33,10
Crusaders,9892,1,16,6,4,62,32,30,54
Coleraine,9892,2,14,10,2,45,25,20,52
Glenavon,9892,3,10,9,7,55,45,10,39
Linfield,9892,4,11,5,10,40,37,3,38
Cliftonville,9892,5,9,4,13,33,34,-1,31
Ballymena,9892,6,8,4,14,27,48,-21,28
Glentoran,9892,7,6,6,10,24,32,-8,24
Dungannon,9892,8,2,4,16,14,47,-33,10
Crusaders,9893,1,17,6,3,63,31,32,57
Coleraine,9893,2,14,10,2,43,24,19,52
Glenavon,9893,3,10,9,7,54,43,11,39
Linfield,9893,4,11,5,10,38,36,2,38
Cliftonville,9893,5,9,4,13,32,32,0,31
Ballymena,9893,6,7,4,15,26,49,-23,25
Glentoran,9893,7,6,6,10,24,32,-8,24
Dungannon,9893,8,2,4,16,14,47,-33,10
Coleraine,9894,1,15,10,1,45,23,22,55
Crusaders,9894,2,16,6,4,63,33,30,54
Linfield,9894,3,11,5,10,39,37,2,38
Glenavon,9894,4,9,9,8,53,45,8,36
Cliftonville,9894,5,9,4,13,33,33,0,31
Ballymena,9894,6,8,4,14,28,49,-21,28
Glentoran,9894,7,6,6,10,24,32,-8,24
Dungannon,9894,8,2,4,16,14,47,-33,10
Crusaders,9895,1,17,6,3,63,30,33,57
Coleraine,9895,2,15,10,1,45,22,23,55
Glenavon,9895,3,9,9,8,52,45,7,36
Linfield,9895,4,10,5,11,37,38,-1,35
Cliftonville,9895,5,10,4,12,34,31,3,34
Ballymena,9895,6,7,4,15,25,49,-24,25
Glentoran,9895,7,6,6,10,24,32,-8,24
Dungannon,9895,8,2,4,16,14,47,-33,10
Crusaders,9896,1,17,6,3,63,31,32,57
Coleraine,9896,2,15,10,1,44,22,22,55
Linfield,9896,3,11,5,10,40,36,4,38
Glenavon,9896,4,9,9,8,52,44,8,36
Cliftonville,9896,5,9,4,13,32,34,-2,31
Ballymena,9896,6,7,4,15,26,49,-23,25
Glentoran,9896,7,6,6,10,24,32,-8,24
Dungannon,9896,8,2,4,16,14,47,-33,10
Coleraine,9897,1,15,10,1,46,23,23,55
Crusaders,9897,2,16,6,4,62,33,29,54
Linfield,9897,3,11,5,10,38,36,2,38
Glenavon,9897,4,9,9,8,53,46,7,36
Cliftonville,9897,5,9,4,13,32,32,0,31
Ballymena,9897,6,8,4,14,28,48,-20,28
Glentoran,9897,7,6,6,10,24,32,-8,24
Dungannon,9897,8,2,4,16,14,47,-33,10
Crusaders,9898,1,17,6,3,63,31,32,57
Coleraine,9898,2,14,10,2,44,24,20,52
Glenavon,9898,3,10,9,7,54,44,10,39
Linfield,9898,4,11,5,10,40,37,3,38
Cliftonville,9898,5,9,4,13,33,34,-1,31
Ballymena,9898,6,7,4,15,26,49,-23,25
Glentoran,9898,7,6,6,10,24,32,-8,24
Dungannon,9898,8,2,4,16,14,47,-33,10
Crusaders,9899,1,17,6,3,64,31,33,57
Coleraine,9899,2,14,10,2,44,24,20,52
Glenavon,9899,3,10,9,7,54,44,10,39
Linfield,9899,4,11,5,10,40,36,4,38
Cliftonville,9899,5,9,4,13,32,34,-2,31
Ballymena,9899,6,7,4,15,26,50,-24,25
Glentoran,9899,7,6,6,10,24,32,-8,24
Dungannon,9899,8,2,4,16,14,47,-33,10
Crusaders,9900,1,16,7,3,63,32,31,55
Coleraine,9900,2,14,10,2,45,25,20,52
Glenavon,9900,3,10,9,7,55,45,10,39
Linfield,9900,4,10,5,11,39,40,-1,35
Cliftonville,9900,5,10,4,12,36,33,3,34
Ballymena,9900,6,7,5,14,27,49,-22,26
Glentoran,9900,7,6,6,10,24,32,-8,24
Dungannon,9900,8,2,4,16,14,47,-33,10
Crusaders,9901,1,17,6,3,63,31,32,57
Coleraine,9901,2,15,10,1,45,22,23,55
Glenavon,9901,3,9,9,8,52,45,7,36
Linfield,9901,4,10,5,11,37,38,-1,35
Cliftonville,9901,5,10,4,12,34,31,3,34
Ballymena,9901,6,7,4,15,26,49,-23,25
Glentoran,9901,7,6,6,10,24,32,-8,24
Dungannon,9901,8,2,4,16,14,47,-33,10
Crusaders,9902,1,16,7,3,63,32,31,55
Coleraine,9902,2,14,10,2,44,25,19,52
Glenavon,9902,3,10,9,7,55,44,11,39
Linfield,9902,4,11,5,10,40,37,3,38
Cliftonville,9902,5,9,4,13,33,34,-1,31
Ballymena,9902,6,7,5,14,27,49,-22,26
Glentoran,9902,7,6,6,10,24,32,-8,24
Dungannon,9902,8,2,4,16,14,47,-33,10
Crusaders,9903,1,17,6,3,62,30,32,57
Coleraine,9903,2,14,10,2,43,23,20,52
Glenavon,9903,3,10,9,7,53,43,10,39
Linfield,9903,4,11,5,10,39,37,2,38
Cliftonville,9903,5,9,4,13,33,33,0,31
Ballymena,9903,6,7,4,15,25,48,-23,25
Glentoran,9903,7,6,6,10,24,32,-8,24
Dungannon,9903,8,2,4,16,14,47,-33,10
Coleraine,9904,1,15,10,1,48,22,26,55
Crusaders,9904,2,16,6,4,62,33,29,54
Glenavon,9904,3,9,9,8,52,48,4,36
Linfield,9904,4,10,5,11,37,37,0,35
Cliftonville,9904,5,10,4,12,33,31,2,34
Ballymena,9904,6,8,4,14,28,48,-20,28
Glentoran,9904,7,6,6,10,24,32,-8,24
Dungannon,9904,8,2,4,16,14,47,-33,10
Crusaders,9905,1,16,6,4,62,32,30,54
Coleraine,9905,2,14,11,1,44,23,21,53
Glenavon,9905,3,9,10,7,53,44,9,37
Linfield,9905,4,10,6,10,37,36,1,36
Cliftonville,9905,5,9,5,12,32,31,1,32
Ballymena,9905,6,8,4,14,27,48,-21,28
Glentoran,9905,7,6,6,10,24,32,-8,24
Dungannon,9905,8,2,4,16,14,47,-33,10
Crusaders,9906,1,17,6,3,67,31,36,57
Coleraine,9906,2,15,10,1,46,22,24,55
Linfield,9906,3,11,5,10,38,36,2,38
Glenavon,9906,4,9,9,8,52,46,6,36
Cliftonville,9906,5,9,4,13,32,32,0,31
Ballymena,9906,6,7,4,15,26,53,-27,25
Glentoran,9906,7,6,6,10,24,32,-8,24
Dungannon,9906,8,2,4,16,14,47,-33,10
Coleraine,9907,1,15,10,1,44,22,22,55
Crusaders,9907,2,16,6,4,61,32,29,54
Glenavon,9907,3,9,9,8,52,44,8,36
Linfield,9907,4,10,6,10,37,36,1,36
Cliftonville,9907,5,9,5,12,32,31,1,32
Ballymena,9907,6,8,4,14,27,47,-20,28
Glentoran,9907,7,6,6,10,24,32,-8,24
Dungannon,9907,8,2,4,16,14,47,-33,10
Crusaders,9908,1,16,6,4,61,31,30,54
Coleraine,9908,2,14,10,2,44,28,16,52
Glenavon,9908,3,10,9,7,58,44,14,39
Linfield,9908,4,11,5,10,40,36,4,38
Cliftonville,9908,5,9,4,13,32,34,-2,31
Ballymena,9908,6,8,4,14,26,47,-21,28
Glentoran,9908,7,6,6,10,24,32,-8,24
Dungannon,9908,8,2,4,16,14,47,-33,10
Crusaders,9909,1,17,6,3,64,30,34,57
Coleraine,9909,2,14,10,2,43,23,20,52
Glenavon,9909,3,10,9,7,53,43,10,39
Linfield,9909,4,11,5,10,38,36,2,38
Cliftonville,9909,5,9,4,13,32,32,0,31
Ballymena,9909,6,7,4,15,25,50,-25,25
Glentoran,9909,7,6,6,10,24,32,-8,24
Dungannon,9909,8,2,4,16,14,47,-33,10
Crusaders,9910,1,17,6,3,63,31,32,57
Coleraine,9910,2,14,10,2,44,24,20,52
Glenavon,9910,3,10,9,7,54,44,10,39
Linfield,9910,4,10,6,10,38,37,1,36
Cliftonville,9910,5,9,5,12,33,32,1,32
Ballymena,9910,6,7,4,15,26,49,-23,25
Glentoran,9910,7,6,6,10,24,32,-8,24
Dungannon,9910,8,2,4,16,14,47,-33,10
Crusaders,9911,1,16,6,4,63,34,29,54
Coleraine,9911,2,14,11,1,45,24,21,53
Linfield,9911,3,11,5,10,38,36,2,38
Glenavon,9911,4,9,10,7,54,45,9,37
Cliftonville,9911,5,9,4,13,32,32,0,31
Ballymena,9911,6,8,4,14,29,49,-20,28
Glentoran,9911,7,6,6,10,24,32,-8,24
Dungannon,9911,8,2,4,16,14,47,-33,10
Crusaders,9912,1,17,6,3,63,31,32,57
Coleraine,9912,2,15,10,1,44,22,22,55
Linfield,9912,3,11,5,10,41,36,5,38
Glenavon,9912,4,9,9,8,52,44,8,36
Cliftonville,9912,5,9,4,13,32,35,-3,31
Ballymena,9912,6,7,4,15,26,49,-23,25
Glentoran,9912,7,6,6,10,24,32,-8,24
Dungannon,9912,8,2,4,16,14,47,-33,10
Crusaders,9913,1,17,6,3,65,32,33,57
Coleraine,9913,2,15,10,1,44,22,22,55
Glenavon,9913,3,9,9,8,52,44,8,36
Linfield,9913,4,10,6,10,37,36,1,36
Cliftonville,9913,5,9,5,12,32,31,1,32
Ballymena,9913,6,7,4,15,27,51,-24,25
Glentoran,9913,7,6,6,10,24,32,-8,24
Dungannon,9913,8,2,4,16,14,47,-33,10
Crusaders,9914,1,16,7,3,62,31,31,55
Coleraine,9914,2,14,11,1,44,23,21,53
Linfield,9914,3,11,5,10,38,36,2,38
Glenavon,9914,4,9,10,7,53,44,9,37
Cliftonville,9914,5,9,4,13,32,32,0,31
Ballymena,9914,6,7,5,14,26,48,-22,26
Glentoran,9914,7,6,6,10,24,32,-8,24
Dungannon,9914,8,2,4,16,14,47,-33,10
Crusaders,9915,1,16,7,3,61,30,31,55
Coleraine,9915,2,14,11,1,46,25,21,53
Linfield,9915,3,11,5,10,38,36,2,38
Glenavon,9915,4,9,10,7,55,46,9,37
Cliftonville,9915,5,9,4,13,32,32,0,31
Ballymena,9915,6,7,5,14,25,47,-22,26
Glentoran,9915,7,6,6,10,24,32,-8,24
Dungannon,9915,8,2,4,16,14,47,-33,10
Crusaders,9916,1,17,6,3,66,33,33,57
Coleraine,9916,2,14,10,2,44,24,20,52
Glenavon,9916,3,10,9,7,54,44,10,39
Linfield,9916,4,11,5,10,39,36,3,38
Cliftonville,9916,5,9,4,13,32,33,-1,31
Ballymena,9916,6,7,4,15,28,52,-24,25
Glentoran,9916,7,6,6,10,24,32,-8,24
Dungannon,9916,8,2,4,16,14,47,-33,10
Coleraine,9917,1,15,10,1,45,22,23,55
Crusaders,9917,2,16,6,4,63,33,30,54
Linfield,9917,3,11,5,10,39,36,3,38
Glenavon,9917,4,9,9,8,52,45,7,36
Cliftonville,9917,5,9,4,13,32,33,-1,31
Ballymena,9917,6,8,4,14,28,49,-21,28
Glentoran,9917,7,6,6,10,24,32,-8,24
Dungannon,9917,8,2,4,16,14,47,-33,10
Crusaders,9918,1,16,6,4,63,33,30,54
Coleraine,9918,2,14,11,1,44,23,21,53
Glenavon,9918,3,9,10,7,53,44,9,37
Linfield,9918,4,10,5,11,38,38,0,35
Cliftonville,9918,5,10,4,12,34,32,2,34
Ballymena,9918,6,8,4,14,28,49,-21,28
Glentoran,9918,7,6,6,10,24,32,-8,24
Dungannon,9918,8,2,4,16,14,47,-33,10
Crusaders,9919,1,16,7,3,62,31,31,55
Coleraine,9919,2,14,10,2,43,24,19,52
Glenavon,9919,3,10,9,7,54,43,11,39
Linfield,9919,4,11,5,10,39,37,2,38
Cliftonville,9919,5,9,4,13,33,33,0,31
Ballymena,9919,6,7,5,14,26,48,-22,26
Glentoran,9919,7,6,6,10,24,32,-8,24
Dungannon,9919,8,2,4,16,14,47,-33,10
Crusaders,9920,1,16,7,3,61,30,31,55
Coleraine,9920,2,14,11,1,44,23,21,53
Glenavon,9920,3,9,10,7,53,44,9,37
Linfield,9920,4,10,6,10,37,36,1,36
Cliftonville,9920,5,9,5,12,32,31,1,32
Ballymena,9920,6,7,5,14,25,47,-22,26
Glentoran,9920,7,6,6,10,24,32,-8,24
Dungannon,9920,8,2,4,16,14,47,-33,10
Crusaders,9921,1,17,6,3,63,31,32,57
Coleraine,9921,2,14,11,1,45,24,21,53
Glenavon,9921,3,9,10,7,54,45,9,37
Linfield,9921,4,10,6,10,39,38,1,36
Cliftonville,9921,5,9,5,12,34,33,1,32
Ballymena,9921,6,7,4,15,26,49,-23,25
Glentoran,9921,7,6,6,10,24,32,-8,24
Dungannon,9921,8,2,4,16,14,47,-33,10
Crusaders,9922,1,16,6,4,61,32,29,54
Coleraine,9922,2,14,11,1,45,24,21,53
Linfield,9922,3,11,5,10,39,36,3,38
Glenavon,9922,4,9,10,7,54,45,9,37
Cliftonville,9922,5,9,4,13,32,33,-1,31
Ballymena,9922,6,8,4,14,27,47,-20,28
Glentoran,9922,7,6,6,10,24,32,-8,24
Dungannon,9922,8,2,4,16,14,47,-33,10
Crusaders,9923,1,17,6,3,62,30,32,57
Coleraine,9923,2,15,10,1,44,22,22,55
Linfield,9923,3,11,5,10,40,38,2,38
Glenavon,9923,4,9,9,8,52,44,8,36
Cliftonville,9923,5,9,4,13,34,34,0,31
Ballymena,9923,6,7,4,15,25,48,-23,25
Glentoran,9923,7,6,6,10,24,32,-8,24
Dungannon,9923,8,2,4,16,14,47,-33,10
Crusaders,9924,1,16,6,4,61,33,28,54
Coleraine,9924,2,14,10,2,44,24,20,52
Glenavon,9924,3,10,9,7,54,44,10,39
Linfield,9924,4,11,5,10,38,36,2,38
Cliftonville,9924,5,9,4,13,32,32,0,31
Ballymena,9924,6,8,4,14,28,47,-19,28
Glentoran,9924,7,6,6,10,24,32,-8,24
Dungannon,9924,8,2,4,16,14,47,-33,10
Crusaders,9925,1,16,6,4,61,31,30,54
Coleraine,9925,2,14,11,1,44,23,21,53
Glenavon,9925,3,9,10,7,53,44,9,37
Linfield,9925,4,10,6,10,38,37,1,36
Cliftonville,9925,5,9,5,12,33,32,1,32
Ballymena,9925,6,8,4,14,26,47,-21,28
Glentoran,9925,7,6,6,10,24,32,-8,24
Dungannon,9925,8,2,4,16,14,47,-33,10
Crusaders,9926,1,17,6,3,62,30,32,57
Coleraine,9926,2,14,10,2,44,24,20,52
Glenavon,9926,3,10,9,7,54,44,10,39
Linfield,9926,4,10,5,11,38,38,0,35
Cliftonville,9926,5,10,4,12,34,32,2,34
Ballymena,9926,6,7,4,15,25,48,-23,25
Glentoran,9926,7,6,6,10,24,32,-8,24
Dungannon,9926,8,2,4,16,14,47,-33,10
Crusaders,9927,1,16,7,3,61,30,31,55
Coleraine,9927,2,15,10,1,45,23,22,55
Glenavon,9927,3,9,9,8,53,45,8,36
Linfield,9927,4,10,6,10,38,37,1,36
Cliftonville,9927,5,9,5,12,33,32,1,32
Ballymena,9927,6,7,5,14,25,47,-22,26
Glentoran,9927,7,6,6,10,24,32,-8,24
Dungannon,9927,8,2,4,16,14,47,-33,10
Crusaders,9928,1,17,6,3,65,31,34,57
Coleraine,9928,2,14,10,2,43,24,19,52
Glenavon,9928,3,10,9,7,54,43,11,39
Linfield,9928,4,10,5,11,38,38,0,35
Cliftonville,9928,5,10,4,12,34,32,2,34
Ballymena,9928,6,7,4,15,26,51,-25,25
Glentoran,9928,7,6,6,10,24,32,-8,24
Dungannon,9928,8,2,4,16,14,47,-33,10
Crusaders,9929,1,16,7,3,62,31,31,55
Coleraine,9929,2,14,11,1,45,24,21,53
Glenavon,9929,3,9,10,7,54,45,9,37
Linfield,9929,4,10,6,10,40,39,1,36
Cliftonville,9929,5,9,5,12,35,34,1,32
Ballymena,9929,6,7,5,14,26,48,-22,26
Glentoran,9929,7,6,6,10,24,32,-8,24
Dungannon,9929,8,2,4,16,14,47,-33,10
Crusaders,9930,1,17,6,3,63,30,33,57
Coleraine,9930,2,15,10,1,47,24,23,55
Linfield,9930,3,11,5,10,39,36,3,38
Glenavon,9930,4,9,9,8,54,47,7,36
Cliftonville,9930,5,9,4,13,32,33,-1,31
Ballymena,9930,6,7,4,15,25,49,-24,25
Glentoran,9930,7,6,6,10,24,32,-8,24
Dungannon,9930,8,2,4,16,14,47,-33,10
Crusaders,9931,1,16,6,4,63,33,30,54
Coleraine,9931,2,14,11,1,46,25,21,53
Linfield,9931,3,11,5,10,38,36,2,38
Glenavon,9931,4,9,10,7,55,46,9,37
Cliftonville,9931,5,9,4,13,32,32,0,31
Ballymena,9931,6,8,4,14,28,49,-21,28
Glentoran,9931,7,6,6,10,24,32,-8,24
Dungannon,9931,8,2,4,16,14,47,-33,10
Crusaders,9932,1,16,7,3,63,32,31,55
Coleraine,9932,2,14,11,1,45,24,21,53
Glenavon,9932,3,9,10,7,54,45,9,37
Linfield,9932,4,10,5,11,39,39,0,35
Cliftonville,9932,5,10,4,12,35,33,2,34
Ballymena,9932,6,7,5,14,27,49,-22,26
Glentoran,9932,7,6,6,10,24,32,-8,24
Dungannon,9932,8,2,4,16,14,47,-33,10
Crusaders,9933,1,17,6,3,64,30,34,57
Coleraine,9933,2,14,11,1,43,22,21,53
Linfield,9933,3,11,5,10,40,37,3,38
Glenavon,9933,4,9,10,7,52,43,9,37
Cliftonville,9933,5,9,4,13,33,34,-1,31
Ballymena,9933,6,7,4,15,25,50,-25,25
Glentoran,9933,7,6,6,10,24,32,-8,24
Dungannon,9933,8,2,4,16,14,47,-33,10
Crusaders,9934,1,16,7,3,62,31,31,55
Coleraine,9934,2,14,10,2,43,23,20,52
Glenavon,9934,3,10,9,7,53,43,10,39
Linfield,9934,4,10,5,11,37,37,0,35
Cliftonville,9934,5,10,4,12,33,31,2,34
Ballymena,9934,6,7,5,14,26,48,-22,26
Glentoran,9934,7,6,6,10,24,32,-8,24
Dungannon,9934,8,2,4,16,14,47,-33,10
Crusaders,9935,1,17,6,3,64,30,34,57
Coleraine,9935,2,15,10,1,46,24,22,55
Glenavon,9935,3,9,9,8,54,46,8,36
Linfield,9935,4,10,5,11,38,38,0,35
Cliftonville,9935,5,10,4,12,34,32,2,34
Ballymena,9935,6,7,4,15,25,50,-25,25
Glentoran,9935,7,6,6,10,24,32,-8,24
Dungannon,9935,8,2,4,16,14,47,-33,10
Crusaders,9936,1,16,7,3,63,32,31,55
Coleraine,9936,2,14,10,2,44,24,20,52
Glenavon,9936,3,10,9,7,54,44,10,39
Linfield,9936,4,11,5,10,39,37,2,38
Cliftonville,9936,5,9,4,13,33,33,0,31
Ballymena,9936,6,7,5,14,27,49,-22,26
Glentoran,9936,7,6,6,10,24,32,-8,24
Dungannon,9936,8,2,4,16,14,47,-33,10
Crusaders,9937,1,17,6,3,66,30,36,57
Coleraine,9937,2,14,10,2,43,25,18,52
Glenavon,9937,3,10,9,7,55,43,12,39
Linfield,9937,4,10,5,11,37,38,-1,35
Cliftonville,9937,5,10,4,12,34,31,3,34
Ballymena,9937,6,7,4,15,25,52,-27,25
Glentoran,9937,7,6,6,10,24,32,-8,24
Dungannon,9937,8,2,4,16,14,47,-33,10
Crusaders,9938,1,17,6,3,64,31,33,57
Coleraine,9938,2,14,10,2,43,26,17,52
Glenavon,9938,3,10,9,7,56,43,13,39
Linfield,9938,4,10,5,11,37,38,-1,35
Cliftonville,9938,5,10,4,12,34,31,3,34
Ballymena,9938,6,7,4,15,26,50,-24,25
Glentoran,9938,7,6,6,10,24,32,-8,24
Dungannon,9938,8,2,4,16,14,47,-33,10
Crusaders,9939,1,16,6,4,61,32,29,54
Coleraine,9939,2,14,10,2,43,23,20,52
Glenavon,9939,3,10,9,7,53,43,10,39
Linfield,9939,4,10,6,10,38,37,1,36
Cliftonville,9939,5,9,5,12,33,32,1,32
Ballymena,9939,6,8,4,14,27,47,-20,28
Glentoran,9939,7,6,6,10,24,32,-8,24
Dungannon,9939,8,2,4,16,14,47,-33,10
Crusaders,9940,1,17,6,3,64,32,32,57
Coleraine,9940,2,14,11,1,44,23,21,53
Glenavon,9940,3,9,10,7,53,44,9,37
Linfield,9940,4,10,6,10,40,39,1,36
Cliftonville,9940,5,9,5,12,35,34,1,32
Ballymena,9940,6,7,4,15,27,50,-23,25
Glentoran,9940,7,6,6,10,24,32,-8,24
Dungannon,9940,8,2,4,16,14,47,-33,10
Crusaders,9941,1,16,7,3,62,31,31,55
Coleraine,9941,2,14,11,1,43,22,21,53
Glenavon,9941,3,9,10,7,52,43,9,37
Linfield,9941,4,10,5,11,38,39,-1,35
Cliftonville,9941,5,10,4,12,35,32,3,34
Ballymena,9941,6,7,5,14,26,48,-22,26
Glentoran,9941,7,6,6,10,24,32,-8,24
Dungannon,9941,8,2,4,16,14,47,-33,10
Coleraine,9942,1,15,10,1,45,22,23,55
Crusaders,9942,2,16,6,4,61,32,29,54
Glenavon,9942,3,9,9,8,52,45,7,36
Linfield,9942,4,10,5,11,37,37,0,35
Cliftonville,9942,5,10,4,12,33,31,2,34
Ballymena,9942,6,8,4,14,27,47,-20,28
Glentoran,9942,7,6,6,10,24,32,-8,24
Dungannon,9942,8,2,4,16,14,47,-33,10
Crusaders,9943,1,17,6,3,64,31,33,57
Coleraine,9943,2,14,10,2,43,25,18,52
Glenavon,9943,3,10,9,7,55,43,12,39
Linfield,9943,4,10,6,10,37,36,1,36
Cliftonville,9943,5,9,5,12,32,31,1,32
Ballymena,9943,6,7,4,15,26,50,-24,25
Glentoran,9943,7,6,6,10,24,32,-8,24
Dungannon,9943,8,2,4,16,14,47,-33,10
Crusaders,9944,1,17,6,3,64,32,32,57
Coleraine,9944,2,14,11,1,44,23,21,53
Linfield,9944,3,11,5,10,39,37,2,38
Glenavon,9944,4,9,10,7,53,44,9,37
Cliftonville,9944,5,9,4,13,33,33,0,31
Ballymena,9944,6,7,4,15,27,50,-23,25
Glentoran,9944,7,6,6,10,24,32,-8,24
Dungannon,9944,8,2,4,16,14,47,-33,10
Crusaders,9945,1,17,6,3,62,30,32,57
Coleraine,9945,2,15,10,1,47,22,25,55
Glenavon,9945,3,9,9,8,52,47,5,36
Linfield,9945,4,10,5,11,37,37,0,35
Cliftonville,9945,5,10,4,12,33,31,2,34
Ballymena,9945,6,7,4,15,25,48,-23,25
Glentoran,9945,7,6,6,10,24,32,-8,24
Dungannon,9945,8,2,4,16,14,47,-33,10
Crusaders,9946,1,17,6,3,63,31,32,57
Coleraine,9946,2,14,10,2,43,24,19,52
Glenavon,9946,3,10,9,7,54,43,11,39
Linfield,9946,4,10,5,11,38,38,0,35
Cliftonville,9946,5,10,4,12,34,32,2,34
Ballymena,9946,6,7,4,15,26,49,-23,25
Glentoran,9946,7,6,6,10,24,32,-8,24
Dungannon,9946,8,2,4,16,14,47,-33,10
Crusaders,9947,1,17,6,3,64,30,34,57
Coleraine,9947,2,15,10,1,44,22,22,55
Glenavon,9947,3,9,9,8,52,44,8,36
Linfield,9947,4,10,5,11,37,38,-1,35
Cliftonville,9947,5,10,4,12,34,31,3,34
Ballymena,9947,6,7,4,15,25,50,-25,25
Glentoran,9947,7,6,6,10,24,32,-8,24
Dungannon,9947,8,2,4,16,14,47,-33,10
Crusaders,9948,1,17,6,3,64,30,34,57
Coleraine,9948,2,14,10,2,44,26,18,52
Glenavon,9948,3,10,9,7,56,44,12,39
Linfield,9948,4,10,5,11,38,40,-2,35
Cliftonville,9948,5,10,4,12,36,32,4,34
Ballymena,9948,6,7,4,15,25,50,-25,25
Glentoran,9948,7,6,6,10,24,32,-8,24
Dungannon,9948,8,2,4,16,14,47,-33,10
Crusaders,9949,1,17,6,3,65,33,32,57
Coleraine,9949,2,15,10,1,44,22,22,55
Glenavon,9949,3,9,9,8,52,44,8,36
Linfield,9949,4,10,6,10,38,37,1,36
Cliftonville,9949,5,9,5,12,33,32,1,32
Ballymena,9949,6,7,4,15,28,51,-23,25
Glentoran,9949,7,6,6,10,24,32,-8,24
Dungannon,9949,8,2,4,16,14,47,-33,10
Crusaders,9950,1,16,6,4,62,32,30,54
Coleraine,9950,2,14,11,1,45,24,21,53
Glenavon,9950,3,9,10,7,54,45,9,37
Linfield,9950,4,10,6,10,37,36,1,36
Cliftonville,9950,5,9,5,12,32,31,1,32
Ballymena,9950,6,8,4,14,27,48,-21,28
Glentoran,9950,7,6,6,10,24,32,-8,24
Dungannon,9950,8,2,4,16,14,47,-33,10
Coleraine,9951,1,15,10,1,45,23,22,55
Crusaders,9951,2,16,6,4,62,32,30,54
Glenavon,9951,3,9,9,8,53,45,8,36
Linfield,9951,4,10,5,11,39,39,0,35
Cliftonville,9951,5,10,4,12,35,33,2,34
Ballymena,9951,6,8,4,14,27,48,-21,28
Glentoran,9951,7,6,6,10,24,32,-8,24
Dungannon,9951,8,2,4,16,14,47,-33,10
Crusaders,9952,1,17,6,3,62,30,32,57
Coleraine,9952,2,14,10,2,43,23,20,52
Glenavon,9952,3,10,9,7,53,43,10,39
Linfield,9952,4,11,5,10,38,36,2,38
Cliftonville,9952,5,9,4,13,32,32,0,31
Ballymena,9952,6,7,4,15,25,48,-23,25
Glentoran,9952,7,6,6,10,24,32,-8,24
Dungannon,9952,8,2,4,16,14,47,-33,10
Crusaders,9953,1,16,7,3,62,31,31,55
Coleraine,9953,2,14,10,2,44,24,20,52
Glenavon,9953,3,10,9,7,54,44,10,39
Linfield,9953,4,11,5,10,39,36,3,38
Cliftonville,9953,5,9,4,13,32,33,-1,31
Ballymena,9953,6,7,5,14,26,48,-22,26
Glentoran,9953,7,6,6,10,24,32,-8,24
Dungannon,9953,8,2,4,16,14,47,-33,10
Crusaders,9954,1,17,6,3,67,30,37,57
Coleraine,9954,2,14,10,2,43,23,20,52
Glenavon,9954,3,10,9,7,53,43,10,39
Linfield,9954,4,10,5,11,37,37,0,35
Cliftonville,9954,5,10,4,12,33,31,2,34
Ballymena,9954,6,7,4,15,25,53,-28,25
Glentoran,9954,7,6,6,10,24,32,-8,24
Dungannon,9954,8,2,4,16,14,47,-33,10
Crusaders,9955,1,16,6,4,63,34,29,54
Coleraine,9955,2,14,11,1,44,23,21,53
Linfield,9955,3,11,5,10,43,37,6,38
Glenavon,9955,4,9,10,7,53,44,9,37
Cliftonville,9955,5,9,4,13,33,37,-4,31
Ballymena,9955,6,8,4,14,29,49,-20,28
Glentoran,9955,7,6,6,10,24,32,-8,24
Dungannon,9955,8,2,4,16,14,47,-33,10
Coleraine,9956,1,15,10,1,46,24,22,55
Crusaders,9956,2,16,6,4,61,34,27,54
Glenavon,9956,3,9,9,8,54,46,8,36
Linfield,9956,4,10,5,11,38,39,-1,35
Cliftonville,9956,5,10,4,12,35,32,3,34
Ballymena,9956,6,8,4,14,29,47,-18,28
Glentoran,9956,7,6,6,10,24,32,-8,24
Dungannon,9956,8,2,4,16,14,47,-33,10
Crusaders,9957,1,16,7,3,62,31,31,55
Coleraine,9957,2,14,10,2,45,26,19,52
Glenavon,9957,3,10,9,7,56,45,11,39
Linfield,9957,4,11,5,10,39,37,2,38
Cliftonville,9957,5,9,4,13,33,33,0,31
Ballymena,9957,6,7,5,14,26,48,-22,26
Glentoran,9957,7,6,6,10,24,32,-8,24
Dungannon,9957,8,2,4,16,14,47,-33,10
Crusaders,9958,1,16,6,4,62,33,29,54
Coleraine,9958,2,14,10,2,45,25,20,52
Glenavon,9958,3,10,9,7,55,45,10,39
Linfield,9958,4,10,5,11,37,39,-2,35
Cliftonville,9958,5,10,4,12,35,31,4,34
Ballymena,9958,6,8,4,14,28,48,-20,28
Glentoran,9958,7,6,6,10,24,32,-8,24
Dungannon,9958,8,2,4,16,14,47,-33,10
Crusaders,9959,1,17,6,3,63,30,33,57
Coleraine,9959,2,15,10,1,48,24,24,55
Linfield,9959,3,11,5,10,40,36,4,38
Glenavon,9959,4,9,9,8,54,48,6,36
Cliftonville,9959,5,9,4,13,32,34,-2,31
Ballymena,9959,6,7,4,15,25,49,-24,25
Glentoran,9959,7,6,6,10,24,32,-8,24
Dungannon,9959,8,2,4,16,14,47,-33,10
Crusaders,9960,1,16,7,3,64,33,31,55
Coleraine,9960,2,15,10,1,46,23,23,55
Linfield,9960,3,11,5,10,38,36,2,38
Glenavon,9960,4,9,9,8,53,46,7,36
Cliftonville,9960,5,9,4,13,32,32,0,31
Ballymena,9960,6,7,5,14,28,50,-22,26
Glentoran,9960,7,6,6,10,24,32,-8,24
Dungannon,9960,8,2,4,16,14,47,-33,10
Crusaders,9961,1,16,7,3,63,32,31,55
Coleraine,9961,2,15,10,1,46,23,23,55
Linfield,9961,3,11,5,10,38,36,2,38
Glenavon,9961,4,9,9,8,53,46,7,36
Cliftonville,9961,5,9,4,13,32,32,0,31
Ballymena,9961,6,7,5,14,27,49,-22,26
Glentoran,9961,7,6,6,10,24,32,-8,24
Dungannon,9961,8,2,4,16,14,47,-33,10
Crusaders,9962,1,17,6,3,64,31,33,57
Coleraine,9962,2,15,10,1,47,24,23,55
Glenavon,9962,3,9,9,8,54,47,7,36
Linfield,9962,4,10,6,10,38,37,1,36
Cliftonville,9962,5,9,5,12,33,32,1,32
Ballymena,9962,6,7,4,15,26,50,-24,25
Glentoran,9962,7,6,6,10,24,32,-8,24
Dungannon,9962,8,2,4,16,14,47,-33,10
Crusaders,9963,1,16,7,3,63,32,31,55
Coleraine,9963,2,15,10,1,48,23,25,55
Glenavon,9963,3,9,9,8,53,48,5,36
Linfield,9963,4,10,6,10,38,37,1,36
Cliftonville,9963,5,9,5,12,33,32,1,32
Ballymena,9963,6,7,5,14,27,49,-22,26
Glentoran,9963,7,6,6,10,24,32,-8,24
Dungannon,9963,8,2,4,16,14,47,-33,10
Crusaders,9964,1,17,6,3,64,32,32,57
Coleraine,9964,2,15,10,1,46,22,24,55
Linfield,9964,3,11,5,10,38,36,2,38
Glenavon,9964,4,9,9,8,52,46,6,36
Cliftonville,9964,5,9,4,13,32,32,0,31
Ballymena,9964,6,7,4,15,27,50,-23,25
Glentoran,9964,7,6,6,10,24,32,-8,24
Dungannon,9964,8,2,4,16,14,47,-33,10
Crusaders,9965,1,16,7,3,62,31,31,55
Coleraine,9965,2,14,10,2,43,23,20,52
Glenavon,9965,3,10,9,7,53,43,10,39
Linfield,9965,4,10,6,10,38,37,1,36
Cliftonville,9965,5,9,5,12,33,32,1,32
Ballymena,9965,6,7,5,14,26,48,-22,26
Glentoran,9965,7,6,6,10,24,32,-8,24
Dungannon,9965,8,2,4,16,14,47,-33,10
Crusaders,9966,1,17,6,3,63,31,32,57
Coleraine,9966,2,14,11,1,46,25,21,53
Linfield,9966,3,11,5,10,40,36,4,38
Glenavon,9966,4,9,10,7,55,46,9,37
Cliftonville,9966,5,9,4,13,32,34,-2,31
Ballymena,9966,6,7,4,15,26,49,-23,25
Glentoran,9966,7,6,6,10,24,32,-8,24
Dungannon,9966,8,2,4,16,14,47,-33,10
Crusaders,9967,1,17,6,3,64,30,34,57
Coleraine,9967,2,14,10,2,44,25,19,52
Glenavon,9967,3,10,9,7,55,44,11,39
Linfield,9967,4,11,5,10,39,36,3,38
Cliftonville,9967,5,9,4,13,32,33,-1,31
Ballymena,9967,6,7,4,15,25,50,-25,25
Glentoran,9967,7,6,6,10,24,32,-8,24
Dungannon,9967,8,2,4,16,14,47,-33,10
Crusaders,9968,1,16,6,4,62,35,27,54
Coleraine,9968,2,14,10,2,45,25,20,52
Glenavon,9968,3,10,9,7,55,45,10,39
Linfield,9968,4,10,6,10,40,39,1,36
Cliftonville,9968,5,9,5,12,35,34,1,32
Ballymena,9968,6,8,4,14,30,48,-18,28
Glentoran,9968,7,6,6,10,24,32,-8,24
Dungannon,9968,8,2,4,16,14,47,-33,10
Crusaders,9969,1,17,6,3,64,31,33,57
Coleraine,9969,2,14,10,2,43,23,20,52
Glenavon,9969,3,10,9,7,53,43,10,39
Linfield,9969,4,10,6,10,39,38,1,36
Cliftonville,9969,5,9,5,12,34,33,1,32
Ballymena,9969,6,7,4,15,26,50,-24,25
Glentoran,9969,7,6,6,10,24,32,-8,24
Dungannon,9969,8,2,4,16,14,47,-33,10
Crusaders,9970,1,17,6,3,62,30,32,57
Coleraine,9970,2,15,10,1,45,22,23,55
Glenavon,9970,3,9,9,8,52,45,7,36
Linfield,9970,4,10,5,11,38,38,0,35
Cliftonville,9970,5,10,4,12,34,32,2,34
Ballymena,9970,6,7,4,15,25,48,-23,25
Glentoran,9970,7,6,6,10,24,32,-8,24
Dungannon,9970,8,2,4,16,14,47,-33,10
Coleraine,9971,1,15,10,1,45,23,22,55
Crusaders,9971,2,16,6,4,62,32,30,54
Linfield,9971,3,11,5,10,38,36,2,38
Glenavon,9971,4,9,9,8,53,45,8,36
Cliftonville,9971,5,9,4,13,32,32,0,31
Ballymena,9971,6,8,4,14,27,48,-21,28
Glentoran,9971,7,6,6,10,24,32,-8,24
Dungannon,9971,8,2,4,16,14,47,-33,10
Crusaders,9972,1,16,6,4,61,32,29,54
Coleraine,9972,2,14,11,1,43,22,21,53
Linfield,9972,3,11,5,10,39,37,2,38
Glenavon,9972,4,9,10,7,52,43,9,37
Cliftonville,9972,5,9,4,13,33,33,0,31
Ballymena,9972,6,8,4,14,27,47,-20,28
Glentoran,9972,7,6,6,10,24,32,-8,24
Dungannon,9972,8,2,4,16,14,47,-33,10
Crusaders,9973,1,16,7,3,63,32,31,55
Coleraine,9973,2,14,10,2,44,24,20,52
Glenavon,9973,3,10,9,7,54,44,10,39
Linfield,9973,4,10,5,11,37,37,0,35
Cliftonville,9973,5,10,4,12,33,31,2,34
Ballymena,9973,6,7,5,14,27,49,-22,26
Glentoran,9973,7,6,6,10,24,32,-8,24
Dungannon,9973,8,2,4,16,14,47,-33,10
Crusaders,9974,1,17,6,3,63,31,32,57
Coleraine,9974,2,14,10,2,43,23,20,52
Glenavon,9974,3,10,9,7,53,43,10,39
Linfield,9974,4,11,5,10,40,36,4,38
Cliftonville,9974,5,9,4,13,32,34,-2,31
Ballymena,9974,6,7,4,15,26,49,-23,25
Glentoran,9974,7,6,6,10,24,32,-8,24
Dungannon,9974,8,2,4,16,14,47,-33,10
Crusaders,9975,1,17,6,3,66,34,32,57
Coleraine,9975,2,14,10,2,44,24,20,52
Glenavon,9975,3,10,9,7,54,44,10,39
Linfield,9975,4,11,5,10,38,36,2,38
Cliftonville,9975,5,9,4,13,32,32,0,31
Ballymena,9975,6,7,4,15,29,52,-23,25
Glentoran,9975,7,6,6,10,24,32,-8,24
Dungannon,9975,8,2,4,16,14,47,-33,10
Crusaders,9976,1,16,6,4,62,35,27,54
Coleraine,9976,2,14,11,1,45,24,21,53
Glenavon,9976,3,9,10,7,54,45,9,37
Linfield,9976,4,10,5,11,37,37,0,35
Cliftonville,9976,5,10,4,12,33,31,2,34
Ballymena,9976,6,8,4,14,30,48,-18,28
Glentoran,9976,7,6,6,10,24,32,-8,24
Dungannon,9976,8,2,4,16,14,47,-33,10
Crusaders,9977,1,17,6,3,63,31,32,57
Coleraine,9977,2,14,10,2,45,25,20,52
Glenavon,9977,3,10,9,7,55,45,10,39
Linfield,9977,4,11,5,10,39,36,3,38
Cliftonville,9977,5,9,4,13,32,33,-1,31
Ballymena,9977,6,7,4,15,26,49,-23,25
Glentoran,9977,7,6,6,10,24,32,-8,24
Dungannon,9977,8,2,4,16,14,47,-33,10
Crusaders,9978,1,17,6,3,64,32,32,57
Coleraine,9978,2,14,11,1,45,24,21,53
Glenavon,9978,3,9,10,7,54,45,9,37
Linfield,9978,4,10,6,10,37,36,1,36
Cliftonville,9978,5,9,5,12,32,31,1,32
Ballymena,9978,6,7,4,15,27,50,-23,25
Glentoran,9978,7,6,6,10,24,32,-8,24
Dungannon,9978,8,2,4,16,14,47,-33,10
Coleraine,9979,1,15,10,1,44,22,22,55
Crusaders,9979,2,16,6,4,63,33,30,54
Glenavon,9979,3,9,9,8,52,44,8,36
Linfield,9979,4,10,5,11,37,37,0,35
Cliftonville,9979,5,10,4,12,33,31,2,34
Ballymena,9979,6,8,4,14,28,49,-21,28
Glentoran,9979,7,6,6,10,24,32,-8,24
Dungannon,9979,8,2,4,16,14,47,-33,10
Crusaders,9980,1,17,6,3,63,31,32,57
Coleraine,9980,2,14,10,2,44,26,18,52
Glenavon,9980,3,10,9,7,56,44,12,39
Linfield,9980,4,10,5,11,37,40,-3,35
Cliftonville,9980,5,10,4,12,36,31,5,34
Ballymena,9980,6,7,4,15,26,49,-23,25
Glentoran,9980,7,6,6,10,24,32,-8,24
Dungannon,9980,8,2,4,16,14,47,-33,10
Crusaders,9981,1,17,6,3,63,31,32,57
Coleraine,9981,2,14,10,2,43,23,20,52
Glenavon,9981,3,10,9,7,53,43,10,39
Linfield,9981,4,11,5,10,39,37,2,38
Cliftonville,9981,5,9,4,13,33,33,0,31
Ballymena,9981,6,7,4,15,26,49,-23,25
Glentoran,9981,7,6,6,10,24,32,-8,24
Dungannon,9981,8,2,4,16,14,47,-33,10
Crusaders,9982,1,17,6,3,64,30,34,57
Coleraine,9982,2,15,10,1,46,23,23,55
Glenavon,9982,3,9,9,8,53,46,7,36
Linfield,9982,4,10,5,11,37,38,-1,35
Cliftonville,9982,5,10,4,12,34,31,3,34
Ballymena,9982,6,7,4,15,25,50,-25,25
Glentoran,9982,7,6,6,10,24,32,-8,24
Dungannon,9982,8,2,4,16,14,47,-33,10
Crusaders,9983,1,17,6,3,62,30,32,57
Coleraine,9983,2,14,11,1,44,23,21,53
Glenavon,9983,3,9,10,7,53,44,9,37
Linfield,9983,4,10,6,10,37,36,1,36
Cliftonville,9983,5,9,5,12,32,31,1,32
Ballymena,9983,6,7,4,15,25,48,-23,25
Glentoran,9983,7,6,6,10,24,32,-8,24
Dungannon,9983,8,2,4,16,14,47,-33,10
Crusaders,9984,1,16,6,4,62,34,28,54
Coleraine,9984,2,14,10,2,43,27,16,52
Glenavon,9984,3,10,9,7,57,43,14,39
Linfield,9984,4,10,5,11,38,38,0,35
Cliftonville,9984,5,10,4,12,34,32,2,34
Ballymena,9984,6,8,4,14,29,48,-19,28
Glentoran,9984,7,6,6,10,24,32,-8,24
Dungannon,9984,8,2,4,16,14,47,-33,10
Coleraine,9985,1,15,10,1,45,22,23,55
Crusaders,9985,2,16,6,4,62,32,30,54
Linfield,9985,3,11,5,10,38,36,2,38
Glenavon,9985,4,9,9,8,52,45,7,36
Cliftonville,9985,5,9,4,13,32,32,0,31
Ballymena,9985,6,8,4,14,27,48,-21,28
Glentoran,9985,7,6,6,10,24,32,-8,24
Dungannon,9985,8,2,4,16,14,47,-33,10
Crusaders,9986,1,17,6,3,63,31,32,57
Coleraine,9986,2,15,10,1,45,23,22,55
Glenavon,9986,3,9,9,8,53,45,8,36
Linfield,9986,4,10,5,11,37,37,0,35
Cliftonville,9986,5,10,4,12,33,31,2,34
Ballymena,9986,6,7,4,15,26,49,-23,25
Glentoran,9986,7,6,6,10,24,32,-8,24
Dungannon,9986,8,2,4,16,14,47,-33,10
Crusaders,9987,1,16,7,3,62,31,31,55
Coleraine,9987,2,14,11,1,44,23,21,53
Linfield,9987,3,11,5,10,40,37,3,38
Glenavon,9987,4,9,10,7,53,44,9,37
Cliftonville,9987,5,9,4,13,33,34,-1,31
Ballymena,9987,6,7,5,14,26,48,-22,26
Glentoran,9987,7,6,6,10,24,32,-8,24
Dungannon,9987,8,2,4,16,14,47,-33,10
Crusaders,9988,1,17,6,3,64,30,34,57
Coleraine,9988,2,14,10,2,43,28,15,52
Glenavon,9988,3,10,9,7,58,43,15,39
Linfield,9988,4,10,5,11,37,38,-1,35
Cliftonville,9988,5,10,4,12,34,31,3,34
Ballymena,9988,6,7,4,15,25,50,-25,25
Glentoran,9988,7,6,6,10,24,32,-8,24
Dungannon,9988,8,2,4,16,14,47,-33,10
Coleraine,9989,1,15,10,1,44,22,22,55
Crusaders,9989,2,16,6,4,61,31,30,54
Glenavon,9989,3,9,9,8,52,44,8,36
Linfield,9989,4,10,5,11,37,38,-1,35
Cliftonville,9989,5,10,4,12,34,31,3,34
Ballymena,9989,6,8,4,14,26,47,-21,28
Glentoran,9989,7,6,6,10,24,32,-8,24
Dungannon,9989,8,2,4,16,14,47,-33,10
Crusaders,9990,1,17,6,3,62,30,32,57
Coleraine,9990,2,15,10,1,45,22,23,55
Linfield,9990,3,11,5,10,40,37,3,38
Glenavon,9990,4,9,9,8,52,45,7,36
Cliftonville,9990,5,9,4,13,33,34,-1,31
Ballymena,9990,6,7,4,15,25,48,-23,25
Glentoran,9990,7,6,6,10,24,32,-8,24
Dungannon,9990,8,2,4,16,14,47,-33,10
Crusaders,9991,1,17,6,3,67,31,36,57
Coleraine,9991,2,15,10,1,45,23,22,55
Linfield,9991,3,11,5,10,38,36,2,38
Glenavon,9991,4,9,9,8,53,45,8,36
Cliftonville,9991,5,9,4,13,32,32,0,31
Ballymena,9991,6,7,4,15,26,53,-27,25
Glentoran,9991,7,6,6,10,24,32,-8,24
Dungannon,9991,8,2,4,16,14,47,-33,10
Crusaders,9992,1,16,6,4,61,32,29,54
Coleraine,9992,2,14,11,1,44,23,21,53
Glenavon,9992,3,9,10,7,53,44,9,37
Linfield,9992,4,10,6,10,39,38,1,36
Cliftonville,9992,5,9,5,12,34,33,1,32
Ballymena,9992,6,8,4,14,27,47,-20,28
Glentoran,9992,7,6,6,10,24,32,-8,24
Dungannon,9992,8,2,4,16,14,47,-33,10
Crusaders,9993,1,16,6,4,63,33,30,54
Coleraine,9993,2,14,10,2,43,26,17,52
Glenavon,9993,3,10,9,7,56,43,13,39
Linfield,9993,4,10,6,10,39,38,1,36
Cliftonville,9993,5,9,5,12,34,33,1,32
Ballymena,9993,6,8,4,14,28,49,-21,28
Glentoran,9993,7,6,6,10,24,32,-8,24
Dungannon,9993,8,2,4,16,14,47,-33,10
Crusaders,9994,1,16,6,4,61,31,30,54
Coleraine,9994,2,14,10,2,45,25,20,52
Glenavon,9994,3,10,9,7,55,45,10,39
Linfield,9994,4,11,5,10,40,38,2,38
Cliftonville,9994,5,9,4,13,34,34,0,31
Ballymena,9994,6,8,4,14,26,47,-21,28
Glentoran,9994,7,6,6,10,24,32,-8,24
Dungannon,9994,8,2,4,16,14,47,-33,10
Crusaders,9995,1,16,6,4,61,32,29,54
Coleraine,9995,2,14,10,2,43,23,20,52
Glenavon,9995,3,10,9,7,53,43,10,39
Linfield,9995,4,10,6,10,38,37,1,36
Cliftonville,9995,5,9,5,12,33,32,1,32
Ballymena,9995,6,8,4,14,27,47,-20,28
Glentoran,9995,7,6,6,10,24,32,-8,24
Dungannon,9995,8,2,4,16,14,47,-33,10
Coleraine,9996,1,15,10,1,45,23,22,55
Crusaders,9996,2,16,6,4,61,33,28,54
Glenavon,9996,3,9,9,8,53,45,8,36
Linfield,9996,4,10,6,10,38,37,1,36
Cliftonville,9996,5,9,5,12,33,32,1,32
Ballymena,9996,6,8,4,14,28,47,-19,28
Glentoran,9996,7,6,6,10,24,32,-8,24
Dungannon,9996,8,2,4,16,14,47,-33,10
Crusaders,9997,1,17,6,3,62,30,32,57
Coleraine,9997,2,14,10,2,43,26,17,52
Glenavon,9997,3,10,9,7,56,43,13,39
Linfield,9997,4,10,6,10,38,37,1,36
Cliftonville,9997,5,9,5,12,33,32,1,32
Ballymena,9997,6,7,4,15,25,48,-23,25
Glentoran,9997,7,6,6,10,24,32,-8,24
Dungannon,9997,8,2,4,16,14,47,-33,10
Crusaders,9998,1,17,6,3,64,30,34,57
Coleraine,9998,2,15,10,1,46,23,23,55
Glenavon,9998,3,9,9,8,53,46,7,36
Linfield,9998,4,10,6,10,37,36,1,36
Cliftonville,9998,5,9,5,12,32,31,1,32
Ballymena,9998,6,7,4,15,25,50,-25,25
Glentoran,9998,7,6,6,10,24,32,-8,24
Dungannon,9998,8,2,4,16,14,47,-33,10
Crusaders,9999,1,16,7,3,62,31,31,55
Coleraine,9999,2,14,10,2,44,26,18,52
Glenavon,9999,3,10,9,7,56,44,12,39
Linfield,9999,4,11,5,10,38,36,2,38
Cliftonville,9999,5,9,4,13,32,32,0,31
Ballymena,9999,6,7,5,14,26,48,-22,26
Glentoran,9999,7,6,6,10,24,32,-8,24
Dungannon,9999,8,2,4,16,14,47,-33,10
